date,sid,name,open,high,low,close,amplitude,amplitude_ratio,capacity,transaction,turnover,foreign_dealers_buy,foreign_dealers_sell,foreign_dealers_total,investment_trust_buy,investment_trust_sell,investment_trust_total,dealer_buy,dealer_sell,dealer_total,institutional_investors_total
20200212,0050,元大台灣50,92.00,92.90,92.00,92.65,+0.90,0.98,5640117,2845,521567062,1247054,371000,876054,0,0,0,1197000,1318000,-121000,755054
20200212,0051,元大中型100,34.96,35.28,34.96,35.28,+0.47,1.35,13300,11,467685,1000,1000,0,0,0,0,3000,1000,2000,2000
20200212,0052,富邦科技,73.00,73.25,72.80,72.80,+0.20,0.28,53076,44,3869280,3000,3000,0,0,0,0,22000,22000,0,0
20200212,0053,元大電子,41.25,41.68,41.25,41.68,+0.59,1.44,7011,8,291545,0,0,0,0,0,0,1000,0,1000,1000
20200212,0054,元大台商50,23.71,23.73,23.71,23.73,+0.27,1.15,12000,2,284740,0,0,0,0,0,0,12000,0,12000,12000
20200212,0055,元大MSCI金融,19.04,19.04,18.91,18.91,0.00,0.00,6058,7,115112,0,0,0,0,0,0,0,1000,-1000,-1000
20200212,0056,元大高股息,28.36,28.57,28.36,28.56,+0.22,0.78,12239828,4730,348673622,6069,2000,4069,0,0,0,5267000,140000,5127000,5131069
20200212,0057,富邦摩台,60.65,60.70,60.65,60.70,+0.50,0.83,22000,4,1335300,0,0,0,0,0,0,20000,22000,-2000,-2000
20200212,0061,元大寶滬深,17.84,18.00,17.80,18.00,+0.15,0.84,1188498,335,21283838,286000,0,286000,0,0,0,110000,259000,-149000,137000
20200212,006203,元大MSCI台灣,43.15,43.18,43.15,43.18,+0.18,0.42,4000,4,172650,2000,0,2000,0,0,0,1000,0,1000,3000
20200212,006204,永豐臺灣加權,58.50,58.50,58.50,58.50,+0.50,0.86,1136,3,66456,0,0,0,0,0,0,1000,0,1000,1000
20200212,006205,富邦上証,29.98,30.06,29.88,30.06,+0.08,0.27,2981786,977,89462415,581000,0,581000,0,0,0,1975125,1655000,320125,901125
20200212,006206,元大上證50,31.31,31.44,31.31,31.44,+0.10,0.32,252764,80,7930183,8000,8000,0,0,0,0,143000,4000,139000,139000
20200212,006207,FH滬深,23.33,23.40,23.28,23.40,+0.07,0.3,398666,71,9316060,5000,0,5000,0,0,0,368000,40000,328000,333000
20200212,006208,富邦台50,52.60,53.10,52.60,53.05,+0.60,1.14,667615,223,35336840,0,0,0,0,0,0,543000,424000,119000,119000
20200212,00625K,富邦上証+R,7.05,7.05,6.97,6.97,-0.04,-0.57,55000,3,387350,0,0,0,0,0,0,55000,50000,5000,5000
20200212,00631L,元大台灣50正2,50.75,51.70,50.75,51.45,+0.80,1.58,1889058,701,96767001,484000,0,484000,0,0,0,661000,182000,479000,963000
20200212,00632R,元大台灣50反1,10.20,10.20,10.09,10.11,-0.09,-0.88,64910202,6353,657660943,31000,655000,-624000,0,0,0,4949000,32718000,-27769000,-28393000
20200212,00633L,富邦上証正2,43.32,43.48,42.95,43.35,-0.18,-0.41,13147280,2629,568254164,525000,4676000,-4151000,0,0,0,2489000,2720000,-231000,-4382000
20200212,00634R,富邦上証反1,5.89,5.92,5.87,5.87,0.00,0.00,5135000,480,30239580,1383000,1000,1382000,0,0,0,769000,980000,-211000,1171000
20200212,00635U,元大S&P黃金,22.35,22.35,22.31,22.32,-0.04,-0.18,734030,182,16385190,4000,0,4000,0,0,0,421000,46000,375000,379000
20200212,00636,國泰中國A50,20.93,20.99,20.88,20.96,+0.03,0.14,1166333,410,24416836,0,0,0,0,0,0,143000,612000,-469000,-469000
20200212,00636K,國泰中國A50+U,6.98,6.98,6.98,6.98,+0.03,0.43,100,1,698,0,0,0,0,0,0,100,100,0,0
20200212,00637L,元大滬深300正2,16.62,16.68,16.48,16.64,-0.06,-0.36,69935949,7476,1160066876,123000,13662000,-13539000,0,0,0,9035000,27952000,-18917000,-32456000
20200212,00638R,元大滬深300反1,11.90,11.95,11.86,11.86,-0.02,-0.17,3047000,489,36244750,1143000,101000,1042000,0,0,0,100000,65000,35000,1077000
20200212,00639,富邦深100,11.34,11.42,11.31,11.42,+0.07,0.62,2415473,313,27460723,818000,0,818000,0,0,0,1189000,1232000,-43000,775000
20200212,00640L,富邦日本正2,22.41,22.53,22.38,22.49,-0.23,-1.01,619000,67,13897400,3000,55000,-52000,0,0,0,410000,463000,-53000,-105000
20200212,00641R,富邦日本反1,13.54,13.54,13.50,13.53,+0.08,0.59,327000,35,4421590,90000,0,90000,0,0,0,232000,100000,132000,222000
20200212,00642U,元大S&P石油,14.72,14.88,14.72,14.85,+0.12,0.81,19908800,4257,295020837,28000,239000,-211000,0,0,0,717000,17319000,-16602000,-16813000
20200212,00643,群益深証中小,13.82,13.99,13.77,13.99,+0.17,1.23,1381655,326,19181031,719000,0,719000,0,0,0,278000,691000,-413000,306000
20200212,00643K,群益深証中小+R,,,,,0.00,0.00,0,0,0,0,0,0,0,0,0,0,0,0,0
20200212,00645,富邦日本,22.22,22.27,22.22,22.23,-0.08,-0.36,67000,8,1489470,0,0,0,0,0,0,63000,64000,-1000,-1000
20200212,00646,元大S&P500,30.74,30.78,30.71,30.78,-0.01,-0.03,311356,128,9571305,2000,119000,-117000,0,0,0,0,112000,-112000,-229000
20200212,00647L,元大S&P500正2,45.40,45.55,45.34,45.46,+0.01,0.02,116000,22,5264340,0,1000,-1000,0,0,0,92000,0,92000,91000
20200212,00648R,元大S&P500反1,10.58,10.58,10.53,10.53,-0.05,-0.47,869000,103,9181300,0,0,0,0,0,0,147000,46000,101000,101000
20200212,00650L,FH香港正2,29.10,29.56,29.05,29.49,+0.42,1.44,423000,112,12379710,0,0,0,0,0,0,279000,163000,116000,116000
20200212,00651R,FH香港反1,8.14,8.15,8.09,8.11,-0.06,-0.73,578000,96,4693250,4000,0,4000,0,0,0,178000,395000,-217000,-213000
20200212,00652,富邦印度,23.73,23.86,23.73,23.86,+0.10,0.42,37402,22,890026,12000,0,12000,0,0,0,20000,0,20000,32000
20200212,00653L,富邦印度正2,29.34,29.75,29.28,29.71,+0.33,1.12,249000,77,7348000,195000,0,195000,0,0,0,25000,59000,-34000,161000
20200212,00654R,富邦印度反1,13.01,13.01,12.92,12.95,-0.06,-0.46,40000,13,518420,0,16000,-16000,0,0,0,15000,0,15000,-1000
20200212,00655L,國泰中國A50正2,31.48,31.58,31.18,31.53,-0.04,-0.13,5294368,1282,166215411,92000,90000,2000,0,0,0,1436000,3774368,-2338368,-2336368
20200212,00656R,國泰中國A50反1,10.81,10.88,10.80,10.82,-0.01,-0.09,1448000,166,15693820,91000,0,91000,0,0,0,527000,491000,36000,127000
20200212,00657,國泰日經225,29.57,29.57,29.50,29.50,-0.21,-0.71,130000,4,3837100,0,0,0,0,0,0,125000,130000,-5000,-5000
20200212,00657K,國泰日經225+U,9.86,9.86,9.86,9.86,-0.02,-0.2,100,1,986,0,0,0,0,0,0,100,100,0,0
20200212,00660,元大歐洲50,,,,,0.00,0.00,70,2,1890,0,0,0,0,0,0,0,0,0,0
20200212,00661,元大日經225,,,,,0.00,0.00,0,0,0,0,0,0,0,0,0,0,0,0,0
20200212,00662,富邦NASDAQ,36.80,36.80,36.72,36.79,-0.11,-0.3,115330,71,4241139,0,0,0,0,0,0,4000,79000,-75000,-75000
20200212,00663L,國泰臺灣加權正2,45.31,45.80,45.24,45.80,+1.00,2.23,37000,17,1686060,0,0,0,0,0,0,28000,1000,27000,27000
20200212,00664R,國泰臺灣加權反1,11.60,11.60,11.50,11.53,-0.09,-0.77,1901000,356,21938330,0,0,0,0,0,0,143000,1233000,-1090000,-1090000
20200212,00665L,富邦恒生國企正2,26.08,26.30,25.92,26.28,+0.25,0.96,180000,51,4702800,9000,0,9000,0,0,0,126000,33000,93000,102000
20200212,00666R,富邦恒生國企反1,12.82,12.83,12.74,12.74,-0.10,-0.78,96000,12,1227500,0,0,0,0,0,0,88000,16000,72000,72000
20200212,00668,國泰美國道瓊,31.78,31.78,31.73,31.73,-0.09,-0.28,27000,10,857370,0,0,0,0,0,0,0,6000,-6000,-6000
20200212,00668K,國泰美國道瓊+U,10.60,10.60,10.60,10.60,-0.01,-0.09,100,1,1060,0,0,0,0,0,0,100,100,0,0
20200212,00669R,國泰美國道瓊反1,11.10,11.11,11.07,11.08,+0.01,0.09,1188000,107,13170790,0,0,0,0,0,0,750000,422000,328000,328000
20200212,00670L,富邦NASDAQ正2,51.65,52.00,51.60,52.00,-0.10,-0.19,253000,118,13104000,0,41000,-41000,0,0,0,47000,161000,-114000,-155000
20200212,00671R,富邦NASDAQ反1,10.00,10.00,9.94,9.96,+0.01,0.1,1079000,120,10757910,9000,0,9000,0,0,0,448000,72000,376000,385000
20200212,00672L,元大S&P原油正2,11.70,11.93,11.70,11.92,+0.26,2.23,199700356,21783,2358678140,2625000,17440000,-14815000,0,0,0,7375000,90053000,-82678000,-97493000
20200212,00673R,元大S&P原油反1,15.82,15.83,15.64,15.67,-0.14,-0.89,4950008,641,77818915,681000,415000,266000,0,0,0,2344000,136000,2208000,2474000
20200212,00674R,元大S&P黃金反1,16.04,16.05,16.04,16.04,+0.01,0.06,19000,9,304850,0,0,0,0,0,0,0,19000,-19000,-19000
20200212,00675L,富邦臺灣加權正2,19.53,19.91,19.53,19.83,+0.35,1.8,192000,89,3785380,38000,0,38000,0,0,0,132000,2000,130000,168000
20200212,00676R,富邦臺灣加權反1,6.28,6.28,6.23,6.24,-0.06,-0.95,1893600,187,11845300,0,94000,-94000,0,0,0,90000,1291000,-1201000,-1295000
20200212,00677U,富邦VIX,2.60,2.61,2.57,2.58,0.00,0.00,69545400,3304,179906028,6761000,2324000,4437000,0,0,0,3673000,700000,2973000,7410000
20200212,00678,群益NBI生技,23.80,23.80,23.70,23.76,-0.04,-0.17,482000,25,11451030,0,0,0,0,0,0,463000,450000,13000,13000
20200212,00680L,元大美債20正2,25.88,25.88,25.75,25.77,-0.30,-1.15,125000,53,3226600,0,0,0,0,0,0,0,55000,-55000,-55000
20200212,00681R,元大美債20反1,15.14,15.14,15.14,15.14,+0.07,0.46,2000,1,30280,0,0,0,0,0,0,2000,0,2000,2000
20200212,00682U,元大美元指數,19.62,19.62,19.50,19.50,-0.03,-0.15,46000,6,897600,0,0,0,0,0,0,40000,42000,-2000,-2000
20200212,00683L,元大美元指數正2,19.92,19.93,19.92,19.92,-0.07,-0.35,84000,12,1673520,0,0,0,0,0,0,80000,40000,40000,40000
20200212,00684R,元大美元指數反1,18.15,18.15,18.15,18.15,+0.03,0.17,40000,2,726000,0,0,0,0,0,0,40000,40000,0,0
20200212,00685L,群益臺灣加權正2,17.35,17.58,17.35,17.58,+0.39,2.27,17000,17,297110,0,0,0,0,0,0,14000,10000,4000,4000
20200212,00686R,群益臺灣加權反1,6.85,6.85,6.80,6.80,-0.07,-1.02,102000,20,696010,0,0,0,0,0,0,30000,72000,-42000,-42000
20200212,00688L,國泰20年美債正2,26.08,26.08,26.04,26.08,-0.31,-1.17,161000,24,4197030,0,0,0,0,0,0,123000,125000,-2000,-2000
20200212,00689R,國泰20年美債反1,15.46,15.46,15.46,15.46,+0.09,0.59,110000,3,1700600,0,0,0,0,0,0,100000,100000,0,0
20200212,00690,兆豐藍籌30,23.60,23.75,23.60,23.74,+0.27,1.15,47450,33,1122492,0,0,0,0,0,0,38000,0,38000,38000
20200212,00691R,兆豐藍籌30反1,13.95,13.95,13.79,13.86,0.00,0.00,7000,3,96760,0,0,0,0,0,0,6000,2000,4000,4000
20200212,00692,富邦公司治理,23.58,23.78,23.58,23.73,+0.18,0.76,2408277,680,57062329,0,0,0,0,0,0,1896000,1303000,593000,593000
20200212,00693U,街口S&P黃豆,14.53,14.54,14.47,14.50,-0.04,-0.28,570027,210,8266682,0,0,0,0,0,0,0,297000,-297000,-297000
20200212,00700,富邦恒生國企,20.28,20.32,20.26,20.32,+0.11,0.54,107000,7,2168010,0,0,0,0,0,0,107000,100000,7000,7000
20200212,00701,國泰股利精選30,21.80,21.92,21.80,21.90,+0.11,0.5,4679368,1559,102421342,0,320000,-320000,0,0,0,0,3082000,-3082000,-3402000
20200212,00702,國泰標普低波高息,21.13,21.13,21.12,21.13,-0.06,-0.28,9000,5,190110,0,0,0,0,0,0,7000,1000,6000,6000
20200212,00703,台新MSCI中國,21.36,21.38,21.30,21.38,+0.09,0.42,81000,31,1729320,0,0,0,0,0,0,70000,8000,62000,62000
20200212,00706L,元大S&P日圓正2,16.99,17.02,16.99,17.02,+0.01,0.06,21000,5,357090,0,0,0,0,0,0,0,6000,-6000,-6000
20200212,00707R,元大S&P日圓反1,20.14,20.14,20.14,20.14,+0.01,0.05,1000,1,20140,0,0,0,0,0,0,1000,1000,0,0
20200212,00708L,元大S&P黃金正2,23.72,23.75,23.67,23.69,-0.03,-0.13,3225000,391,76457810,0,0,0,0,0,0,747000,1660000,-913000,-913000
20200212,00709,富邦歐洲,21.46,21.46,21.40,21.40,-0.13,-0.6,103000,5,2209320,0,0,0,0,0,0,100000,101000,-1000,-1000
20200212,00710B,FH彭博高收益債,20.24,20.25,20.21,20.23,+0.01,0.05,317050,165,6412495,0,0,0,0,0,0,26000,261000,-235000,-235000
20200212,00711B,FH彭博新興債,22.77,22.77,22.76,22.76,-0.02,-0.09,114000,6,2594780,0,0,0,0,0,0,113000,111000,2000,2000
20200212,00712,FH富時不動產,19.00,19.03,18.96,18.97,-0.04,-0.21,177742,55,3374825,1000,0,1000,0,0,0,137000,17000,120000,121000
20200212,00713,元大台灣高息低波,31.70,31.79,31.70,31.77,+0.15,0.47,241130,83,7654695,0,210000,-210000,0,0,0,117000,9000,108000,-102000
20200212,00714,群益道瓊美國地產,23.00,23.01,22.99,23.01,+0.13,0.57,115000,9,2644020,5000,0,5000,0,0,0,107000,100000,7000,12000
20200212,00715L,街口布蘭特油正2,16.65,17.00,16.65,16.96,+0.33,1.98,518000,231,8777130,0,0,0,0,0,0,1000,350000,-349000,-349000
20200212,00717,富邦美國特別股,19.67,19.67,19.65,19.67,0.00,0.00,1849732,387,36360575,1000,0,1000,0,0,0,432000,968000,-536000,-535000
20200212,00728,第一金工業30,20.20,20.39,20.20,20.38,+0.21,1.04,776800,129,15805682,0,0,0,0,0,0,641000,547000,94000,94000
20200212,00730,富邦臺灣優質高息,18.16,18.28,18.16,18.26,+0.10,0.55,408391,158,7448502,0,0,0,0,0,0,283000,208000,75000,75000
20200212,00731,FH富時高息低波,47.49,47.58,47.47,47.57,+0.21,0.44,240020,46,11409711,0,0,0,0,0,0,195000,231000,-36000,-36000
20200212,00732,國泰RMB短期報酬,38.66,38.66,38.66,38.66,+0.02,0.05,100000,2,3866000,0,0,0,0,0,0,100000,100000,0,0
20200212,00733,富邦臺灣中小,20.82,21.04,20.82,21.02,+0.33,1.59,264600,37,5551040,0,0,0,0,0,0,230000,216000,14000,14000
20200212,00735,國泰臺韓科技,21.60,21.63,21.52,21.57,+0.14,0.65,104000,5,2243270,0,0,0,0,0,0,104000,102000,2000,2000
20200212,00736,國泰新興市場,20.26,20.29,20.23,20.29,+0.04,0.2,113000,6,2289680,0,0,0,0,0,0,112000,113000,-1000,-1000
20200212,00737,國泰AI+Robo,23.89,23.98,23.89,23.95,+0.18,0.76,250918,85,6002814,0,0,0,0,0,0,147000,141000,6000,6000
20200212,00738U,元大道瓊白銀,19.72,19.72,19.62,19.65,-0.16,-0.81,750200,232,14761130,1000,276000,-275000,0,0,0,19000,132000,-113000,-388000
20200212,00739,元大MSCI A股,21.00,21.18,20.99,21.18,+0.08,0.38,1115402,155,23559221,614000,0,614000,0,0,0,356000,446000,-90000,524000
20200212,00742,新光內需收益,20.34,20.35,20.28,20.34,+0.04,0.2,10000,6,203340,0,0,0,0,0,0,1000,9000,-8000,-8000
20200212,00743,國泰中國A150,21.25,21.30,21.19,21.28,+0.03,0.14,63994,25,1359235,41000,0,41000,0,0,0,17000,31000,-14000,27000
20200212,00752,中信中國50,24.66,24.98,24.66,24.93,+0.29,1.18,1078481,520,26813902,120,0,120,0,0,0,444000,511000,-67000,-66880
20200212,00753L,中信中國50正2,27.23,27.62,27.10,27.62,+0.52,1.92,128000,85,3503280,0,0,0,0,0,0,80000,53000,27000,27000
20200212,00757,統一FANG+,27.27,27.28,27.23,27.24,-0.04,-0.15,420000,56,11446050,0,0,0,0,0,0,202000,409000,-207000,-207000
20200212,00762,元大全球AI,27.50,27.79,27.50,27.78,+0.30,1.09,463073,172,12821661,0,0,0,0,0,0,10000,296000,-286000,-286000
20200212,00763U,街口道瓊銅,17.98,18.04,17.98,18.04,0.00,0.00,71000,13,1279090,0,0,0,0,0,0,0,65000,-65000,-65000
20200212,00766L,台新MSCI中國正2,10.70,10.85,10.70,10.83,+0.13,1.21,384000,65,4136550,0,0,0,0,0,0,316000,31000,285000,285000
20200212,00767,FH美國金融股,24.10,24.10,24.10,24.10,+0.02,0.08,1000,1,24100,0,0,0,0,0,0,1000,0,1000,1000
20200212,00770,國泰北美科技,26.78,26.78,26.72,26.76,-0.13,-0.48,7000,7,187250,1000,0,1000,0,0,0,1000,6000,-5000,-4000
20200212,00771,元大US高息特別股,20.88,20.88,20.85,20.86,-0.02,-0.1,351105,94,7327316,0,0,0,0,0,0,158000,8000,150000,150000
20200212,00774B,新光中國政金綠債,40.30,40.30,40.30,40.30,0.00,0.00,2000,2,80600,0,0,0,0,0,0,2000,2000,0,0
20200212,00774C,新光中政金綠債+R,9.31,9.31,9.31,9.31,-0.02,-0.21,1000,1,9310,0,0,0,0,0,0,1000,1000,0,0
20200212,00775B,新光投等債15+,46.35,46.39,46.35,46.39,-0.15,-0.32,3000,3,139090,0,0,0,0,0,0,2000,3000,-1000,-1000
20200212,00776,新光ICE美國權值,23.71,23.71,23.71,23.71,+0.01,0.04,1000,1,23710,0,0,0,0,0,0,1000,1000,0,0
20200212,00783,富邦中証500,18.32,18.62,18.25,18.61,+0.16,0.87,2299408,161,42579218,887000,0,887000,0,0,0,1356000,1912000,-556000,331000
20200212,008201,BP上證50,100.70,101.05,100.70,101.05,0.00,0.00,1400,8,141345,0,0,0,0,0,0,1300,0,1300,1300
20200212,00830,國泰費城半導體,18.23,18.35,18.23,18.33,+0.24,1.33,524446,164,9601063,43000,0,43000,0,0,0,167000,115000,52000,95000
20200212,00850,元大臺灣ESG永續,22.87,23.08,22.87,23.03,+0.18,0.79,3135310,1296,72129805,4000,0,4000,0,0,0,1782000,333000,1449000,1453000
20200212,00851,台新全球AI,23.03,23.09,23.03,23.08,+0.05,0.22,64000,22,1474940,0,0,0,0,0,0,34000,54000,-20000,-20000
20200212,00852L,國泰美國道瓊正2,18.32,18.41,18.32,18.40,-0.04,-0.22,148000,27,2717960,0,0,0,0,0,0,58000,132000,-74000,-74000
20200212,00861,元大全球未來通訊,21.22,21.34,21.22,21.33,+0.32,1.52,15007521,3847,319534156,651000,2000,649000,0,0,0,5550000,1597000,3953000,4602000
20200212,00865B,國泰US短期公債,39.32,39.32,39.31,39.32,-0.04,-0.1,21000,5,825700,0,0,0,0,0,0,18000,0,18000,18000
20200212,00866,新光Shiller CAPE,20.88,20.89,20.88,20.88,-0.02,-0.1,34000,8,710180,0,0,0,0,0,0,33000,30000,3000,3000
20200212,01001T,土銀富邦R1,16.27,16.27,16.23,16.25,-0.03,-0.18,57000,8,925910,0,0,0,0,0,0,0,0,0,0
20200212,01002T,土銀國泰R1,17.80,17.80,17.80,17.80,-0.09,-0.5,6000,6,106800,0,0,0,0,0,0,0,0,0,0
20200212,01003T,兆豐新光R1,18.00,18.00,18.00,18.00,0.00,0.00,6302000,5,113436000,3901000,0,3901000,0,0,0,0,0,0,3901000
20200212,01004T,土銀富邦R2,13.96,13.99,13.96,13.97,+0.02,0.14,44000,18,615080,0,0,0,0,0,0,0,0,0,0
20200212,01007T,兆豐國泰R2,17.36,17.36,17.31,17.35,-0.01,-0.06,133000,72,2305640,2000,0,2000,0,0,0,0,0,0,2000
20200212,01009T,王道圓滿R1,9.68,9.68,9.68,9.68,0.00,0.00,54000,14,522720,0,0,0,0,0,0,0,0,0,0
20200212,01010T,京城樂富R1,10.19,10.19,10.16,10.16,-0.03,-0.29,109000,27,1108100,0,0,0,0,0,0,0,0,0,0
20200212,020000,富邦特選蘋果N,5.49,5.56,5.49,5.56,+0.09,1.65,1168000,90,6454920,0,0,0,0,0,0,1130000,7000,1123000,1123000
20200212,020002,元富新中國N,,,,,0.00,0.00,0,0,0,0,0,0,0,0,0,0,0,0,0
20200212,020004,兆豐電菁英30N,,,,,0.00,0.00,0,0,0,0,0,0,0,0,0,0,0,0,0
20200212,020005,永豐外資50N,,,,,0.00,0.00,0,0,0,0,0,0,0,0,0,0,0,0,0
20200212,020006,永昌中小300N,,,,,0.00,0.00,0,0,0,0,0,0,0,0,0,0,0,0,0
20200212,020007,凱基臺灣500N,,,,,0.00,0.00,0,0,0,0,0,0,0,0,0,0,0,0,0
20200212,020008,元大特股高息N,10.52,10.54,10.51,10.54,+0.02,0.19,81000,20,852290,0,0,0,0,0,0,49000,32000,17000,17000
20200212,020011,統一微波高息20N,4.99,4.99,4.99,4.99,+0.02,0.4,7000,2,34930,0,0,0,0,0,0,0,7000,-7000,-7000
20200212,020012,富邦行動通訊N,4.90,4.94,4.90,4.93,+0.04,0.82,704000,120,3467050,0,0,0,0,0,0,7000,7000,0,0
20200212,03001P,宏達電兆豐92售02,,,,,0.00,0.00,0,0,0,0,0,0,0,0,0,0,0,0,0
20200212,03002P,漢唐國票92售01,,,,,0.00,0.00,0,0,0,0,0,0,0,0,0,0,0,0,0
20200212,03004P,鴻海凱基93售05,,,,,0.00,0.00,0,0,0,0,0,0,0,0,0,0,0,0,0
20200212,03005P,華新科凱基93售04,,,,,0.00,0.00,0,0,0,0,0,0,0,0,0,0,0,0,0
20200212,03005X,元展05,,,,,0.00,0.00,0,0,0,0,0,0,0,0,0,0,0,0,0
20200212,03006P,華新科凱基93售05,,,,,0.00,0.00,0,0,0,0,0,0,0,0,0,0,0,0,0
20200212,03006X,元展06,31.40,31.40,31.40,31.40,0.00,0.00,5000,1,157000,0,0,0,0,0,0,5000,0,5000,5000
20200212,03007X,元展07,,,,,0.00,0.00,814000,1,18339420,0,0,0,0,0,0,814000,0,814000,814000
20200212,03009X,元展09,,,,,0.00,0.00,0,0,0,0,0,0,0,0,0,0,0,0,0
20200212,03010X,元展10,32.00,32.00,32.00,32.00,0.00,0.00,10000,1,320000,0,0,0,0,0,0,10000,0,10000,10000
20200212,03012X,元展12,11.60,11.60,11.60,11.60,+0.20,1.75,2000,2,23200,0,0,0,0,0,0,0,2000,-2000,-2000
20200212,03013X,元展13,,,,,0.00,0.00,0,0,0,0,0,0,0,0,0,0,0,0,0
20200212,03014X,元展14,,,,,0.00,0.00,0,0,0,0,0,0,0,0,0,0,0,0,0
20200212,03015X,元展15,,,,,0.00,0.00,0,0,0,0,0,0,0,0,0,0,0,0,0
20200212,03016P,臺股指中信94售01,0.05,0.05,0.02,0.02,-0.01,-33.33,702000,81,14140,0,0,0,0,0,0,0,692000,-692000,-692000
20200212,03016X,元展16,,,,,0.00,0.00,0,0,0,0,0,0,0,0,0,0,0,0,0
20200212,03017X,元展17,,,,,0.00,0.00,0,0,0,0,0,0,0,0,0,0,0,0,0
20200212,03019X,元展19,,,,,0.00,0.00,0,0,0,0,0,0,0,0,0,0,0,0,0
20200212,03020X,元展20,6.25,6.25,6.25,6.25,0.00,0.00,22000,3,137500,0,0,0,0,0,0,22000,0,22000,22000
20200212,03021P,T50反1凱基94售01,1.36,1.39,1.36,1.39,+0.07,5.3,3059000,12,4179470,0,0,0,0,0,0,11000,3048000,-3037000,-3037000
20200212,03022X,富展01,16.30,16.70,16.30,16.70,+0.50,3.09,2000,2,33000,0,0,0,0,0,0,1000,0,1000,1000
20200212,03025P,群創凱基93售07,0.08,0.08,0.08,0.08,0.00,0.00,22000,1,1760,0,0,0,0,0,0,22000,0,22000,22000
20200212,03025X,元展22,,,,,0.00,0.00,0,0,0,0,0,0,0,0,0,0,0,0,0
20200212,03026P,群創凱基93售08,,,,,0.00,0.00,0,0,0,0,0,0,0,0,0,0,0,0,0
20200212,03026X,元展23,4.67,4.74,4.67,4.74,+0.02,0.42,14000,6,65560,0,0,0,0,0,0,4000,9000,-5000,-5000
20200212,03027P,康控凱基93售01,0.72,0.73,0.72,0.73,-0.07,-8.75,113000,2,81990,0,0,0,0,0,0,113000,0,113000,113000
20200212,03027X,元展24,,,,,0.00,0.00,0,0,0,0,0,0,0,0,0,0,0,0,0
20200212,03028X,元展25,,,,,0.00,0.00,0,0,0,0,0,0,0,0,0,0,0,0,0
20200212,03029X,元展26,14.90,14.90,14.90,14.90,+0.10,0.68,1000,1,14900,0,0,0,0,0,0,0,0,0,0
20200212,03033P,台積電中信95售05,0.05,0.05,0.04,0.04,0.00,0.00,4175000,276,169600,0,0,0,0,0,0,0,2949000,-2949000,-2949000
20200212,03033X,元展30,,,,,0.00,0.00,0,0,0,0,0,0,0,0,0,0,0,0,0
20200212,03035X,元展32,,,,,0.00,0.00,0,0,0,0,0,0,0,0,0,0,0,0,0
20200212,03038P,智邦兆豐93售03,,,,,0.00,0.00,0,0,0,0,0,0,0,0,0,0,0,0,0
20200212,03038X,元展35,,,,,0.00,0.00,0,0,0,0,0,0,0,0,0,0,0,0,0
20200212,03039P,欣興兆豐93售03,,,,,0.00,0.00,0,0,0,0,0,0,0,0,0,0,0,0,0
20200212,03039X,元展36,,,,,0.00,0.00,0,0,0,0,0,0,0,0,0,0,0,0,0
20200212,03040P,貿聯兆豐92售03,,,,,0.00,0.00,0,0,0,0,0,0,0,0,0,0,0,0,0
20200212,03041P,國巨群益92售03,,,,,0.00,0.00,0,0,0,0,0,0,0,0,0,0,0,0,0
20200212,03046X,元展43,,,,,0.00,0.00,0,0,0,0,0,0,0,0,0,0,0,0,0
20200212,03047P,台光電凱基93售02,,,,,0.00,0.00,0,0,0,0,0,0,0,0,0,0,0,0,0
20200212,03047X,元展44,,,,,0.00,0.00,0,0,0,0,0,0,0,0,0,0,0,0,0
20200212,03048P,美律凱基93售02,,,,,0.00,0.00,0,0,0,0,0,0,0,0,0,0,0,0,0
20200212,03049X,元展46,,,,,0.00,0.00,0,0,0,0,0,0,0,0,0,0,0,0,0
20200212,03050X,元展47,1.78,1.81,1.78,1.81,+0.01,0.56,285000,9,508350,0,0,0,0,0,0,250000,27000,223000,223000
20200212,03052X,元展49,,,,,0.00,0.00,0,0,0,0,0,0,0,0,0,0,0,0,0
20200212,03055X,元展52,,,,,0.00,0.00,0,0,0,0,0,0,0,0,0,0,0,0,0
20200212,03059P,國巨國泰92售03,,,,,0.00,0.00,0,0,0,0,0,0,0,0,0,0,0,0,0
20200212,03059X,元展54,,,,,0.00,0.00,0,0,0,0,0,0,0,0,0,0,0,0,0
20200212,03060P,臺股指元大92售03,,,,,0.00,0.00,0,0,0,0,0,0,0,0,0,0,0,0,0
20200212,03060X,元展55,,,,,0.00,0.00,0,0,0,0,0,0,0,0,0,0,0,0,0
20200212,03061P,臺股指元大92售04,,,,,0.00,0.00,0,0,0,0,0,0,0,0,0,0,0,0,0
20200212,03062P,臺股指元大92售05,,,,,0.00,0.00,0,0,0,0,0,0,0,0,0,0,0,0,0
20200212,03063P,臺股指元大92售06,,,,,0.00,0.00,0,0,0,0,0,0,0,0,0,0,0,0,0
20200212,03063X,元展58,,,,,0.00,0.00,0,0,0,0,0,0,0,0,0,0,0,0,0
20200212,03064P,元油2X中信94售02,,,,,0.00,0.00,0,0,0,0,0,0,0,0,0,0,0,0,0
20200212,03064X,元展59,,,,,0.00,0.00,0,0,0,0,0,0,0,0,0,0,0,0,0
20200212,03066P,上銀國票92售01,,,,,0.00,0.00,0,0,0,0,0,0,0,0,0,0,0,0,0
20200212,03071X,元展66,,,,,0.00,0.00,0,0,0,0,0,0,0,0,0,0,0,0,0
20200212,03072P,華新科群益92售02,,,,,0.00,0.00,0,0,0,0,0,0,0,0,0,0,0,0,0
20200212,03074P,台光電統一92售01,,,,,0.00,0.00,0,0,0,0,0,0,0,0,0,0,0,0,0
20200212,03074X,元展69,,,,,0.00,0.00,0,0,0,0,0,0,0,0,0,0,0,0,0
20200212,03075P,京元電統一92售01,,,,,0.00,0.00,0,0,0,0,0,0,0,0,0,0,0,0,0
20200212,03075X,元展70,,,,,0.00,0.00,0,0,0,0,0,0,0,0,0,0,0,0,0
20200212,03077X,元展72,,,,,0.00,0.00,0,0,0,0,0,0,0,0,0,0,0,0,0
20200212,03078X,元展73,,,,,0.00,0.00,0,0,0,0,0,0,0,0,0,0,0,0,0
20200212,03083P,華通凱基93售02,,,,,0.00,0.00,0,0,0,0,0,0,0,0,0,0,0,0,0
20200212,03085P,美律凱基93售03,0.70,0.70,0.70,0.70,-0.11,-13.58,105000,1,73500,0,0,0,0,0,0,105000,0,105000,105000
20200212,03086P,美律凱基93售04,,,,,0.00,0.00,0,0,0,0,0,0,0,0,0,0,0,0,0
20200212,03087P,矽創凱基93售02,,,,,0.00,0.00,0,0,0,0,0,0,0,0,0,0,0,0,0
20200212,03088P,世紀鋼凱基93售04,,,,,0.00,0.00,0,0,0,0,0,0,0,0,0,0,0,0,0
20200212,03090X,元展84,,,,,0.00,0.00,0,0,0,0,0,0,0,0,0,0,0,0,0
20200212,03091P,TPK群益92售02,,,,,0.00,0.00,0,0,0,0,0,0,0,0,0,0,0,0,0
20200212,03091X,元展85,,,,,0.00,0.00,0,0,0,0,0,0,0,0,0,0,0,0,0
20200212,03092P,超眾群益92售01,,,,,0.00,0.00,0,0,0,0,0,0,0,0,0,0,0,0,0
20200212,03093X,永豐金元大61展01,,,,,0.00,0.00,0,0,0,0,0,0,0,0,0,0,0,0,0
20200212,03094X,大立光元大68展08,,,,,0.00,0.00,0,0,0,0,0,0,0,0,0,0,0,0,0
20200212,03097P,華邦電凱基92售02,,,,,0.00,0.00,0,0,0,0,0,0,0,0,0,0,0,0,0
20200212,03098P,技嘉凱基93售01,,,,,0.00,0.00,0,0,0,0,0,0,0,0,0,0,0,0,0
20200212,03100P,緯創凱基93售01,,,,,0.00,0.00,0,0,0,0,0,0,0,0,0,0,0,0,0
20200212,03101P,泰鼎凱基93售01,,,,,0.00,0.00,0,0,0,0,0,0,0,0,0,0,0,0,0
20200212,03102P,瑞儀凱基93售03,0.45,0.45,0.45,0.45,0.00,0.00,10000,1,4500,0,0,0,0,0,0,0,10000,-10000,-10000
20200212,03103P,超眾凱基93售02,,,,,0.00,0.00,0,0,0,0,0,0,0,0,0,0,0,0,0
20200212,03107P,台積電亞東92售01,,,,,0.00,0.00,0,0,0,0,0,0,0,0,0,0,0,0,0
20200212,03108P,旺宏國泰93售02,,,,,0.00,0.00,0,0,0,0,0,0,0,0,0,0,0,0,0
20200212,03109P,聯茂國泰93售01,0.14,0.14,0.12,0.12,0.00,0.00,150000,10,20400,0,0,0,0,0,0,0,150000,-150000,-150000
20200212,03110P,台表科國泰93售02,,,,,0.00,0.00,0,0,0,0,0,0,0,0,0,0,0,0,0
20200212,03111P,元油2X富邦97售01,,,,,0.00,0.00,0,0,0,0,0,0,0,0,0,0,0,0,0
20200212,03118P,創意國票93售01,,,,,0.00,0.00,0,0,0,0,0,0,0,0,0,0,0,0,0
20200212,03119P,欣興群益93售01,,,,,0.00,0.00,0,0,0,0,0,0,0,0,0,0,0,0,0
20200212,03125P,台積電兆豐93售02,,,,,0.00,0.00,0,0,0,0,0,0,0,0,0,0,0,0,0
20200212,03126P,滬深2X凱基93售02,0.56,0.56,0.56,0.56,-0.02,-3.45,3000,1,1680,0,0,0,0,0,0,0,3000,-3000,-3000
20200212,03127P,亞泥凱基93售01,,,,,0.00,0.00,0,0,0,0,0,0,0,0,0,0,0,0,0
20200212,03128P,華通凱基93售04,,,,,0.00,0.00,0,0,0,0,0,0,0,0,0,0,0,0,0
20200212,03129P,廣宇凱基93售01,,,,,0.00,0.00,0,0,0,0,0,0,0,0,0,0,0,0,0
20200212,03135P,健策凱基93售03,,,,,0.00,0.00,0,0,0,0,0,0,0,0,0,0,0,0,0
20200212,03136P,台表科凱基93售03,,,,,0.00,0.00,0,0,0,0,0,0,0,0,0,0,0,0,0
20200212,03144P,美律國票93售01,,,,,0.00,0.00,0,0,0,0,0,0,0,0,0,0,0,0,0
20200212,03145P,揚明光國票93售01,,,,,0.00,0.00,0,0,0,0,0,0,0,0,0,0,0,0,0
20200212,03146P,南電國票93售01,0.34,0.34,0.27,0.27,-0.12,-30.77,50000,3,15500,0,0,0,0,0,0,0,50000,-50000,-50000
20200212,03147P,台積電國泰93售02,,,,,0.00,0.00,0,0,0,0,0,0,0,0,0,0,0,0,0
20200212,03148P,大立光國泰93售02,0.03,0.03,0.03,0.03,-0.02,-40.0,400000,1,12000,0,0,0,0,0,0,400000,0,400000,400000
20200212,03149P,超眾國泰93售04,,,,,0.00,0.00,0,0,0,0,0,0,0,0,0,0,0,0,0
20200212,03152P,台光電凱基93售05,,,,,0.00,0.00,0,0,0,0,0,0,0,0,0,0,0,0,0
20200212,03153P,玉山金凱基93售02,,,,,0.00,0.00,0,0,0,0,0,0,0,0,0,0,0,0,0
20200212,03154P,瑞儀凱基93售04,0.34,0.34,0.34,0.34,0.00,0.00,10000,1,3400,0,0,0,0,0,0,0,10000,-10000,-10000
20200212,03155P,GIS凱基93售01,,,,,0.00,0.00,0,0,0,0,0,0,0,0,0,0,0,0,0
20200212,03162P,華邦電中信96售02,,,,,0.00,0.00,0,0,0,0,0,0,0,0,0,0,0,0,0
20200212,03163P,旺宏群益93售02,,,,,0.00,0.00,0,0,0,0,0,0,0,0,0,0,0,0,0
20200212,03165P,元油2X凱基93售01,,,,,0.00,0.00,0,0,0,0,0,0,0,0,0,0,0,0,0
20200212,03166P,聯電凱基93售01,,,,,0.00,0.00,0,0,0,0,0,0,0,0,0,0,0,0,0
20200212,03171P,元油2X國票93售03,0.11,0.11,0.11,0.11,-0.02,-15.38,10000,1,1100,0,0,0,0,0,0,0,10000,-10000,-10000
20200212,03177P,大立光統一93售01,,,,,0.00,0.00,0,0,0,0,0,0,0,0,0,0,0,0,0
20200212,03179P,力成統一93售01,0.05,0.05,0.05,0.05,0.00,0.00,5000,1,250,0,0,0,0,0,0,5000,0,5000,5000
20200212,03180P,華邦電國泰93售01,1.17,1.17,1.11,1.15,-0.19,-14.18,28000,3,31880,0,0,0,0,0,0,0,28000,-28000,-28000
20200212,03181P,道瓊指中信96售01,0.06,0.06,0.06,0.06,0.00,0.00,2000,1,120,0,0,0,0,0,0,2000,0,2000,2000
20200212,03183P,玉晶光中信93售01,0.01,0.02,0.01,0.02,0.00,0.00,399000,37,6780,0,0,0,0,0,0,20000,179000,-159000,-159000
20200212,03184P,瀚宇博統一93售01,,,,,0.00,0.00,0,0,0,0,0,0,0,0,0,0,0,0,0
20200212,03186P,玉晶光群益93售02,,,,,0.00,0.00,0,0,0,0,0,0,0,0,0,0,0,0,0
20200212,03189P,滬深2X凱基93售03,0.24,0.24,0.24,0.24,-0.03,-11.11,20000,2,4800,0,0,0,0,0,0,20000,0,20000,20000
20200212,03191P,玉晶光凱基93售03,,,,,0.00,0.00,0,0,0,0,0,0,0,0,0,0,0,0,0
20200212,03197P,欣興富邦93售02,0.22,0.22,0.18,0.18,-0.05,-21.74,91000,3,19080,0,0,0,0,0,0,31000,90000,-59000,-59000
20200212,03199P,玉晶光元大93售02,0.03,0.03,0.03,0.03,-0.02,-40.0,760000,8,22800,0,0,0,0,0,0,710000,20000,690000,690000
20200212,03202P,揚明光群益94售01,,,,,0.00,0.00,0,0,0,0,0,0,0,0,0,0,0,0,0
20200212,03203P,卜蜂凱基93售02,,,,,0.00,0.00,0,0,0,0,0,0,0,0,0,0,0,0,0
20200212,03204P,聯電凱基93售02,,,,,0.00,0.00,0,0,0,0,0,0,0,0,0,0,0,0,0
20200212,03206P,國巨凱基93售02,,,,,0.00,0.00,0,0,0,0,0,0,0,0,0,0,0,0,0
20200212,03208P,大立光凱基93售01,,,,,0.00,0.00,0,0,0,0,0,0,0,0,0,0,0,0,0
20200212,03219P,華邦電富邦93售01,,,,,0.00,0.00,0,0,0,0,0,0,0,0,0,0,0,0,0
20200212,03223P,玉晶光元大93售04,,,,,0.00,0.00,0,0,0,0,0,0,0,0,0,0,0,0,0
20200212,03227P,創意國票93售02,,,,,0.00,0.00,0,0,0,0,0,0,0,0,0,0,0,0,0
20200212,03237P,玉晶光凱基94售01,0.22,0.22,0.22,0.22,-0.05,-18.52,2000,2,440,0,0,0,0,0,0,0,2000,-2000,-2000
20200212,03240P,鴻海統一93售01,0.03,0.03,0.03,0.03,-0.03,-50.0,50000,2,1500,0,0,0,0,0,0,0,50000,-50000,-50000
20200212,03242P,玉晶光國泰94售02,0.11,0.11,0.10,0.11,-0.03,-21.43,262000,8,28700,0,0,0,0,0,0,0,250000,-250000,-250000
20200212,03243P,TPK富邦94售01,,,,,0.00,0.00,0,0,0,0,0,0,0,0,0,0,0,0,0
20200212,03247P,旺宏元大93售03,,,,,0.00,0.00,0,0,0,0,0,0,0,0,0,0,0,0,0
20200212,03250P,玉晶光元大93售05,,,,,0.00,0.00,0,0,0,0,0,0,0,0,0,0,0,0,0
20200212,03252P,玉晶光群益95售02,0.34,0.34,0.32,0.32,0.00,0.00,66000,4,21320,0,0,0,0,0,0,0,66000,-66000,-66000
20200212,03253P,玉晶光群益96售01,0.22,0.23,0.21,0.21,-0.04,-16.0,597000,10,128920,0,0,0,0,0,0,377000,210000,167000,167000
20200212,03257P,臺股指元大93售03,,,,,0.00,0.00,0,0,0,0,0,0,0,0,0,0,0,0,0
20200212,03258P,臺股指元大93售04,,,,,0.00,0.00,0,0,0,0,0,0,0,0,0,0,0,0,0
20200212,03259P,臺股指元大93售05,,,,,0.00,0.00,0,0,0,0,0,0,0,0,0,0,0,0,0
20200212,03260P,臺股指元大93售06,,,,,0.00,0.00,0,0,0,0,0,0,0,0,0,0,0,0,0
20200212,03261P,臺股指元大93售07,,,,,0.00,0.00,0,0,0,0,0,0,0,0,0,0,0,0,0
20200212,03266P,欣興國票93售01,0.12,0.12,0.09,0.09,-0.04,-30.77,530000,7,52700,0,0,0,0,0,0,110000,420000,-310000,-310000
20200212,03267P,玉晶光國票95售01,0.14,0.14,0.11,0.11,-0.04,-26.67,932000,19,108460,0,0,0,0,0,0,220000,712000,-492000,-492000
20200212,03269P,聯詠兆豐93售01,,,,,0.00,0.00,0,0,0,0,0,0,0,0,0,0,0,0,0
20200212,03275P,華通國票93售01,,,,,0.00,0.00,0,0,0,0,0,0,0,0,0,0,0,0,0
20200212,03276P,聯茂國票93售01,,,,,0.00,0.00,0,0,0,0,0,0,0,0,0,0,0,0,0
20200212,03292P,美律中信94售01,,,,,0.00,0.00,0,0,0,0,0,0,0,0,0,0,0,0,0
20200212,03296P,康控群益94售01,0.30,0.30,0.29,0.29,-0.05,-14.71,18000,3,5230,0,0,0,0,0,0,17000,1000,16000,16000
20200212,03298P,元油2X凱基95售01,,,,,0.00,0.00,0,0,0,0,0,0,0,0,0,0,0,0,0
20200212,03304P,元油2X富邦93售02,,,,,0.00,0.00,0,0,0,0,0,0,0,0,0,0,0,0,0
20200212,03305P,鴻海富邦93售03,0.03,0.03,0.02,0.03,-0.01,-25.0,50000,5,1400,0,0,0,0,0,0,50000,0,50000,50000
20200212,03307P,元油2X元大95售03,1.11,1.11,1.11,1.11,0.00,0.00,5000,1,5550,0,0,0,0,0,0,5000,0,5000,5000
20200212,03314P,滬深2X群益96售02,0.51,0.52,0.50,0.51,+0.01,2.0,262000,6,131820,0,0,0,0,0,0,222000,40000,182000,182000
20200212,03316P,鴻海台新93售01,,,,,0.00,0.00,0,0,0,0,0,0,0,0,0,0,0,0,0
20200212,03321P,大立光凱基93售08,,,,,0.00,0.00,0,0,0,0,0,0,0,0,0,0,0,0,0
20200212,03322P,大立光凱基93售11,,,,,0.00,0.00,0,0,0,0,0,0,0,0,0,0,0,0,0
20200212,03330P,欣興國票93售02,,,,,0.00,0.00,0,0,0,0,0,0,0,0,0,0,0,0,0
20200212,03331P,揚明光國票93售02,,,,,0.00,0.00,0,0,0,0,0,0,0,0,0,0,0,0,0
20200212,03332P,南電國票93售02,,,,,0.00,0.00,0,0,0,0,0,0,0,0,0,0,0,0,0
20200212,03334P,元油2X凱基95售02,,,,,0.00,0.00,0,0,0,0,0,0,0,0,0,0,0,0,0
20200212,03337P,瑞昱凱基93售01,,,,,0.00,0.00,0,0,0,0,0,0,0,0,0,0,0,0,0
20200212,03347P,國巨元大93售06,,,,,0.00,0.00,0,0,0,0,0,0,0,0,0,0,0,0,0
20200212,03351P,瑞儀兆豐93售04,0.62,0.64,0.61,0.61,-0.03,-4.69,222000,13,140750,0,0,0,0,0,0,7000,215000,-208000,-208000
20200212,03357P,大立光凱基93售12,,,,,0.00,0.00,0,0,0,0,0,0,0,0,0,0,0,0,0
20200212,03359P,元油2X群益93售01,,,,,0.00,0.00,0,0,0,0,0,0,0,0,0,0,0,0,0
20200212,03362P,大立光群益93售03,,,,,0.00,0.00,0,0,0,0,0,0,0,0,0,0,0,0,0
20200212,03363P,嘉晶國票93售01,,,,,0.00,0.00,0,0,0,0,0,0,0,0,0,0,0,0,0
20200212,03365P,元油2X富邦98售01,,,,,0.00,0.00,0,0,0,0,0,0,0,0,0,0,0,0,0
20200212,03366P,元油2X元大95售05,,,,,0.00,0.00,0,0,0,0,0,0,0,0,0,0,0,0,0
20200212,03367P,國巨元大93售07,,,,,0.00,0.00,0,0,0,0,0,0,0,0,0,0,0,0,0
20200212,03368P,宏達電元大93售06,,,,,0.00,0.00,0,0,0,0,0,0,0,0,0,0,0,0,0
20200212,03370P,台積電第一92售01,,,,,0.00,0.00,0,0,0,0,0,0,0,0,0,0,0,0,0
20200212,03371P,鴻海國票93售01,,,,,0.00,0.00,0,0,0,0,0,0,0,0,0,0,0,0,0
20200212,03372P,華邦電國票93售01,0.29,0.29,0.26,0.26,-0.10,-27.78,30000,3,8200,0,0,0,0,0,0,10000,20000,-10000,-10000
20200212,03373P,易華電國票93售02,,,,,0.00,0.00,0,0,0,0,0,0,0,0,0,0,0,0,0
20200212,03374P,A50群益92售01,,,,,0.00,0.00,0,0,0,0,0,0,0,0,0,0,0,0,0
20200212,03375P,元油2X群益93售02,,,,,0.00,0.00,0,0,0,0,0,0,0,0,0,0,0,0,0
20200212,03376P,台積電群益92售09,,,,,0.00,0.00,0,0,0,0,0,0,0,0,0,0,0,0,0
20200212,03377P,聯發科群益92售01,,,,,0.00,0.00,0,0,0,0,0,0,0,0,0,0,0,0,0
20200212,03378P,可成群益92售05,,,,,0.00,0.00,0,0,0,0,0,0,0,0,0,0,0,0,0
20200212,03379P,國泰金台新92售01,,,,,0.00,0.00,0,0,0,0,0,0,0,0,0,0,0,0,0
20200212,03380P,為升凱基92售04,,,,,0.00,0.00,0,0,0,0,0,0,0,0,0,0,0,0,0
20200212,03381P,台積電凱基92售12,,,,,0.00,0.00,0,0,0,0,0,0,0,0,0,0,0,0,0
20200212,03382P,瑞昱凱基93售02,,,,,0.00,0.00,0,0,0,0,0,0,0,0,0,0,0,0,0
20200212,03383P,南電凱基93售03,,,,,0.00,0.00,0,0,0,0,0,0,0,0,0,0,0,0,0
20200212,03384P,華邦電統一92售04,,,,,0.00,0.00,0,0,0,0,0,0,0,0,0,0,0,0,0
20200212,03385P,臺股指統一92售01,,,,,0.00,0.00,0,0,0,0,0,0,0,0,0,0,0,0,0
20200212,03386P,臺股指統一92售02,,,,,0.00,0.00,0,0,0,0,0,0,0,0,0,0,0,0,0
20200212,03387P,元油2X元富94售02,1.08,1.08,1.08,1.08,0.00,0.00,3000,1,3240,0,0,0,0,0,0,0,3000,-3000,-3000
20200212,03388P,元油2X元富98售02,0.56,0.56,0.55,0.55,-0.04,-6.78,10000,2,5550,0,0,0,0,0,0,0,10000,-10000,-10000
20200212,03389P,鴻海元富92售05,,,,,0.00,0.00,0,0,0,0,0,0,0,0,0,0,0,0,0
20200212,03390P,台積電元富92售03,,,,,0.00,0.00,0,0,0,0,0,0,0,0,0,0,0,0,0
20200212,03391P,智邦元富92售01,,,,,0.00,0.00,0,0,0,0,0,0,0,0,0,0,0,0,0
20200212,03392P,技嘉元富92售01,,,,,0.00,0.00,0,0,0,0,0,0,0,0,0,0,0,0,0
20200212,03393P,可成元富92售02,,,,,0.00,0.00,0,0,0,0,0,0,0,0,0,0,0,0,0
20200212,03394P,裕隆元大92售01,,,,,0.00,0.00,0,0,0,0,0,0,0,0,0,0,0,0,0
20200212,03395P,華新科元大93售05,,,,,0.00,0.00,0,0,0,0,0,0,0,0,0,0,0,0,0
20200212,03396P,大立光元大92售13,,,,,0.00,0.00,0,0,0,0,0,0,0,0,0,0,0,0,0
20200212,03397P,智易元大92售02,,,,,0.00,0.00,0,0,0,0,0,0,0,0,0,0,0,0,0
20200212,03398P,大立光兆豐93售02,,,,,0.00,0.00,0,0,0,0,0,0,0,0,0,0,0,0,0
20200212,03399P,A50正2中信94售01,0.34,0.36,0.33,0.33,-0.01,-2.94,106000,8,36050,0,0,0,0,0,0,5000,101000,-96000,-96000
20200212,03400P,聯發科中信93售01,,,,,0.00,0.00,0,0,0,0,0,0,0,0,0,0,0,0,0
20200212,03401P,台泥凱基92售01,,,,,0.00,0.00,0,0,0,0,0,0,0,0,0,0,0,0,0
20200212,03402P,台達電凱基92售01,,,,,0.00,0.00,0,0,0,0,0,0,0,0,0,0,0,0,0
20200212,03403P,華邦電凱基92售03,,,,,0.00,0.00,0,0,0,0,0,0,0,0,0,0,0,0,0
20200212,03404P,友達凱基92售03,,,,,0.00,0.00,0,0,0,0,0,0,0,0,0,0,0,0,0
20200212,03405P,義隆凱基92售01,,,,,0.00,0.00,0,0,0,0,0,0,0,0,0,0,0,0,0
20200212,03406P,台表科凱基92售01,,,,,0.00,0.00,0,0,0,0,0,0,0,0,0,0,0,0,0
20200212,03407P,華邦電亞東93售01,,,,,0.00,0.00,0,0,0,0,0,0,0,0,0,0,0,0,0
20200212,03408P,智邦國票93售01,,,,,0.00,0.00,0,0,0,0,0,0,0,0,0,0,0,0,0
20200212,03409P,南亞科國票93售01,,,,,0.00,0.00,0,0,0,0,0,0,0,0,0,0,0,0,0
20200212,03410P,欣興國票93售03,,,,,0.00,0.00,0,0,0,0,0,0,0,0,0,0,0,0,0
20200212,03411P,瑞儀國票93售01,0.36,0.36,0.36,0.36,0.00,0.00,60000,1,21600,0,0,0,0,0,0,0,60000,-60000,-60000
20200212,03412P,滬深2X群益98售01,0.54,0.56,0.53,0.53,-0.01,-1.85,590000,14,318720,0,0,0,0,0,0,329000,261000,68000,68000
20200212,03413B,臺股指凱基94熊19,0.92,0.92,0.80,0.81,-0.13,-13.83,3113000,123,2672280,0,0,0,0,0,0,776000,2050000,-1274000,-1274000
20200212,03413P,儒鴻群益92售02,,,,,0.00,0.00,0,0,0,0,0,0,0,0,0,0,0,0,0
20200212,03414B,臺股指凱基99熊01,1.74,1.74,1.64,1.64,-0.11,-6.29,430000,37,725070,0,0,0,0,0,0,20000,407000,-387000,-387000
20200212,03414P,裕隆群益92售03,,,,,0.00,0.00,0,0,0,0,0,0,0,0,0,0,0,0,0
20200212,03415B,臺股指元大93熊49,1.29,1.30,1.21,1.23,-0.10,-7.52,290000,18,360280,0,0,0,0,0,0,24000,250000,-226000,-226000
20200212,03415P,超眾群益92售03,,,,,0.00,0.00,0,0,0,0,0,0,0,0,0,0,0,0,0
20200212,03416B,臺股指凱基95熊05,2.76,2.76,1.49,2.76,+1.15,71.43,40000,9,64810,0,0,0,0,0,0,3000,35000,-32000,-32000
20200212,03416P,滬深2X國泰93售02,,,,,0.00,0.00,0,0,0,0,0,0,0,0,0,0,0,0,0
20200212,03417B,臺股指凱基95熊19,1.59,1.61,1.55,1.55,-0.10,-6.06,67000,8,106190,0,0,0,0,0,0,0,67000,-67000,-67000
20200212,03417P,智邦國泰93售02,,,,,0.00,0.00,0,0,0,0,0,0,0,0,0,0,0,0,0
20200212,03418B,臺股指元大95熊20,1.69,1.69,1.60,1.64,-0.09,-5.2,516000,24,855350,0,0,0,0,0,0,386000,125000,261000,261000
20200212,03418P,台積電統一94售01,,,,,0.00,0.00,0,0,0,0,0,0,0,0,0,0,0,0,0
20200212,03419B,臺股指元富99熊03,,,,,0.00,0.00,0,0,0,0,0,0,0,0,0,0,0,0,0
20200212,03419P,台光電統一92售05,0.17,0.17,0.17,0.17,0.00,0.00,10000,1,1700,0,0,0,0,0,0,10000,0,10000,10000
20200212,03420B,臺股指元大95熊31,2.08,2.08,1.99,1.99,-0.11,-5.24,78000,7,159070,0,0,0,0,0,0,13000,65000,-52000,-52000
20200212,03420P,聯茂統一92售01,,,,,0.00,0.00,0,0,0,0,0,0,0,0,0,0,0,0,0
20200212,03421B,臺股指元大99熊01,2.74,2.74,2.65,2.65,-0.12,-4.33,260000,13,702320,0,0,0,0,0,0,0,260000,-260000,-260000
20200212,03421P,智邦元大92售08,,,,,0.00,0.00,0,0,0,0,0,0,0,0,0,0,0,0,0
20200212,03422B,臺股指凱基96熊28,,,,,0.00,0.00,0,0,0,0,0,0,0,0,0,0,0,0,0
20200212,03422P,全新元大92售03,,,,,0.00,0.00,0,0,0,0,0,0,0,0,0,0,0,0,0
20200212,03423B,臺股指元大94熊29,,,,,0.00,0.00,0,0,0,0,0,0,0,0,0,0,0,0,0
20200212,03423P,華新科元大93售06,,,,,0.00,0.00,0,0,0,0,0,0,0,0,0,0,0,0,0
20200212,03424B,臺股指元大96熊26,2.20,2.20,2.20,2.20,0.00,0.00,9000,5,19800,0,0,0,0,0,0,0,9000,-9000,-9000
20200212,03424P,大立光元大93售09,,,,,0.00,0.00,0,0,0,0,0,0,0,0,0,0,0,0,0
20200212,03425B,臺股指元大9A熊01,2.87,2.87,2.86,2.86,0.00,0.00,15000,2,42950,0,0,0,0,0,0,0,15000,-15000,-15000
20200212,03425P,台勝科元大92售01,,,,,0.00,0.00,0,0,0,0,0,0,0,0,0,0,0,0,0
20200212,03426B,臺股指元大95熊33,,,,,0.00,0.00,0,0,0,0,0,0,0,0,0,0,0,0,0
20200212,03426P,台積電兆豐93售04,,,,,0.00,0.00,0,0,0,0,0,0,0,0,0,0,0,0,0
20200212,03427B,臺股指元大9A熊02,3.03,3.03,3.03,3.03,0.00,0.00,5000,1,15150,0,0,0,0,0,0,0,5000,-5000,-5000
20200212,03427P,滬深2X中信94售02,,,,,0.00,0.00,0,0,0,0,0,0,0,0,0,0,0,0,0
20200212,03428B,臺股指凱基97熊18,,,,,0.00,0.00,0,0,0,0,0,0,0,0,0,0,0,0,0
20200212,03428P,道瓊指中信94售02,,,,,0.00,0.00,0,0,0,0,0,0,0,0,0,0,0,0,0
20200212,03429B,臺股指元富97熊07,2.71,2.71,2.63,2.65,-0.09,-3.28,166000,6,438480,0,0,0,0,0,0,100000,66000,34000,34000
20200212,03429P,旺宏國票92售01,,,,,0.00,0.00,0,0,0,0,0,0,0,0,0,0,0,0,0
20200212,03430B,臺股指元大9B熊01,2.23,2.23,2.22,2.22,-0.12,-5.13,14000,2,31120,0,0,0,0,0,0,0,14000,-14000,-14000
20200212,03430P,創意國票92售01,,,,,0.00,0.00,0,0,0,0,0,0,0,0,0,0,0,0,0
20200212,03431B,元油2X凱基9B熊03,,,,,0.00,0.00,0,0,0,0,0,0,0,0,0,0,0,0,0
20200212,03431P,超眾國票92售03,,,,,0.00,0.00,0,0,0,0,0,0,0,0,0,0,0,0,0
20200212,03432P,鴻海凱基93售11,,,,,0.00,0.00,0,0,0,0,0,0,0,0,0,0,0,0,0
20200212,03433P,台積電凱基92售15,,,,,0.00,0.00,0,0,0,0,0,0,0,0,0,0,0,0,0
20200212,03434P,智邦凱基92售03,,,,,0.00,0.00,0,0,0,0,0,0,0,0,0,0,0,0,0
20200212,03435P,全新凱基92售02,,,,,0.00,0.00,0,0,0,0,0,0,0,0,0,0,0,0,0
20200212,03436P,力成凱基93售03,,,,,0.00,0.00,0,0,0,0,0,0,0,0,0,0,0,0,0
20200212,03437P,欣興群益93售02,,,,,0.00,0.00,0,0,0,0,0,0,0,0,0,0,0,0,0
20200212,03438P,群創群益98售03,,,,,0.00,0.00,0,0,0,0,0,0,0,0,0,0,0,0,0
20200212,03439P,健策群益92售01,,,,,0.00,0.00,0,0,0,0,0,0,0,0,0,0,0,0,0
20200212,03440P,亞光康和92售01,,,,,0.00,0.00,0,0,0,0,0,0,0,0,0,0,0,0,0
20200212,03441P,友達國泰93售03,,,,,0.00,0.00,0,0,0,0,0,0,0,0,0,0,0,0,0
20200212,03442P,滬深2X統一92售02,,,,,0.00,0.00,0,0,0,0,0,0,0,0,0,0,0,0,0
20200212,03443P,元油2X統一92售01,,,,,0.00,0.00,0,0,0,0,0,0,0,0,0,0,0,0,0
20200212,03444P,裕隆統一93售02,0.92,0.93,0.82,0.83,-0.17,-17.0,114000,70,96550,0,0,0,0,0,0,108000,6000,102000,102000
20200212,03445P,台積電統一92售05,,,,,0.00,0.00,0,0,0,0,0,0,0,0,0,0,0,0,0
20200212,03446P,南亞科統一93售02,,,,,0.00,0.00,0,0,0,0,0,0,0,0,0,0,0,0,0
20200212,03447P,可成統一92售05,,,,,0.00,0.00,0,0,0,0,0,0,0,0,0,0,0,0,0
20200212,03448P,聯詠統一92售02,,,,,0.00,0.00,0,0,0,0,0,0,0,0,0,0,0,0,0
20200212,03449P,臺股指統一93售05,,,,,0.00,0.00,0,0,0,0,0,0,0,0,0,0,0,0,0
20200212,03450P,元油2X元富98售05,1.36,1.36,1.36,1.36,-0.06,-4.23,100000,1,136000,0,0,0,0,0,0,100000,0,100000,100000
20200212,03451P,台光電元富92售01,,,,,0.00,0.00,0,0,0,0,0,0,0,0,0,0,0,0,0
20200212,03452P,美律元富92售02,,,,,0.00,0.00,0,0,0,0,0,0,0,0,0,0,0,0,0
20200212,03453P,聯茂元富92售01,,,,,0.00,0.00,0,0,0,0,0,0,0,0,0,0,0,0,0
20200212,03454P,元油2X元大95售06,0.51,0.52,0.50,0.50,-0.03,-5.66,120000,3,60900,0,0,0,0,0,0,50000,70000,-20000,-20000
20200212,03455P,台積電元大92售16,,,,,0.00,0.00,0,0,0,0,0,0,0,0,0,0,0,0,0
20200212,03456P,智邦元大92售09,,,,,0.00,0.00,0,0,0,0,0,0,0,0,0,0,0,0,0
20200212,03457P,大立光元大92售14,,,,,0.00,0.00,0,0,0,0,0,0,0,0,0,0,0,0,0
20200212,03458P,臻鼎元大92售04,,,,,0.00,0.00,0,0,0,0,0,0,0,0,0,0,0,0,0
20200212,03461P,GIS中信92售01,,,,,0.00,0.00,0,0,0,0,0,0,0,0,0,0,0,0,0
20200212,03462P,創意國票92售02,,,,,0.00,0.00,0,0,0,0,0,0,0,0,0,0,0,0,0
20200212,03463P,正文國票93售01,,,,,0.00,0.00,0,0,0,0,0,0,0,0,0,0,0,0,0
20200212,03464P,臺股指國票92售01,,,,,0.00,0.00,0,0,0,0,0,0,0,0,0,0,0,0,0
20200212,03465P,臺股指國票92售02,,,,,0.00,0.00,0,0,0,0,0,0,0,0,0,0,0,0,0
20200212,03466P,臺股指國票92售03,,,,,0.00,0.00,0,0,0,0,0,0,0,0,0,0,0,0,0
20200212,03467P,臺股指國票92售04,,,,,0.00,0.00,0,0,0,0,0,0,0,0,0,0,0,0,0
20200212,03468P,臺股指國票92售05,,,,,0.00,0.00,0,0,0,0,0,0,0,0,0,0,0,0,0
20200212,03469P,道瓊指群益92售01,,,,,0.00,0.00,0,0,0,0,0,0,0,0,0,0,0,0,0
20200212,03470P,亞德客群益92售03,,,,,0.00,0.00,0,0,0,0,0,0,0,0,0,0,0,0,0
20200212,03471P,臺股指群益92售07,,,,,0.00,0.00,0,0,0,0,0,0,0,0,0,0,0,0,0
20200212,03472P,臺股指群益92售08,,,,,0.00,0.00,0,0,0,0,0,0,0,0,0,0,0,0,0
20200212,03473P,臺股指群益92售09,,,,,0.00,0.00,0,0,0,0,0,0,0,0,0,0,0,0,0
20200212,03474P,臺股指群益92售10,,,,,0.00,0.00,0,0,0,0,0,0,0,0,0,0,0,0,0
20200212,03475P,臺股指群益92售11,,,,,0.00,0.00,0,0,0,0,0,0,0,0,0,0,0,0,0
20200212,03476P,臺股指群益92售12,,,,,0.00,0.00,0,0,0,0,0,0,0,0,0,0,0,0,0
20200212,03477P,臺股指兆豐92售02,,,,,0.00,0.00,0,0,0,0,0,0,0,0,0,0,0,0,0
20200212,03478P,臺股指兆豐92售03,,,,,0.00,0.00,0,0,0,0,0,0,0,0,0,0,0,0,0
20200212,03479P,台積電凱基92售17,,,,,0.00,0.00,0,0,0,0,0,0,0,0,0,0,0,0,0
20200212,03480P,大立光凱基92售04,,,,,0.00,0.00,0,0,0,0,0,0,0,0,0,0,0,0,0
20200212,03481P,聯茂凱基93售05,,,,,0.00,0.00,0,0,0,0,0,0,0,0,0,0,0,0,0
20200212,03482P,臺股指凱基92售01,,,,,0.00,0.00,0,0,0,0,0,0,0,0,0,0,0,0,0
20200212,03483P,臺股指凱基92售02,,,,,0.00,0.00,0,0,0,0,0,0,0,0,0,0,0,0,0
20200212,03484P,臺股指凱基92售03,,,,,0.00,0.00,0,0,0,0,0,0,0,0,0,0,0,0,0
20200212,03485P,臺股指凱基92售04,,,,,0.00,0.00,0,0,0,0,0,0,0,0,0,0,0,0,0
20200212,03486P,臺股指凱基92售05,,,,,0.00,0.00,0,0,0,0,0,0,0,0,0,0,0,0,0
20200212,03487P,臺股指凱基92售06,,,,,0.00,0.00,0,0,0,0,0,0,0,0,0,0,0,0,0
20200212,03488P,臺股指凱基92售07,,,,,0.00,0.00,0,0,0,0,0,0,0,0,0,0,0,0,0
20200212,03489P,臺股指凱基92售08,,,,,0.00,0.00,0,0,0,0,0,0,0,0,0,0,0,0,0
20200212,03490P,臺股指永昌92售03,,,,,0.00,0.00,0,0,0,0,0,0,0,0,0,0,0,0,0
20200212,03491P,臺股指永昌92售04,,,,,0.00,0.00,0,0,0,0,0,0,0,0,0,0,0,0,0
20200212,03492P,大立光國泰94售04,0.04,0.04,0.04,0.04,0.00,0.00,10000,1,400,0,0,0,0,0,0,0,10000,-10000,-10000
20200212,03493P,臺股指富邦92售03,,,,,0.00,0.00,0,0,0,0,0,0,0,0,0,0,0,0,0
20200212,03494P,臺股指富邦92售04,,,,,0.00,0.00,0,0,0,0,0,0,0,0,0,0,0,0,0
20200212,03495P,臺股指富邦92售05,,,,,0.00,0.00,0,0,0,0,0,0,0,0,0,0,0,0,0
20200212,03496P,臺股指統一92售04,,,,,0.00,0.00,0,0,0,0,0,0,0,0,0,0,0,0,0
20200212,03497P,滬深2X元富95售02,0.88,0.92,0.88,0.89,0.00,0.00,265000,7,236020,0,0,0,0,0,0,238000,27000,211000,211000
20200212,03498P,國巨元富94售01,0.01,0.02,0.01,0.02,+0.01,100.0,120000,3,2000,0,0,0,0,0,0,0,0,0,0
20200212,03499P,大立光元富92售04,,,,,0.00,0.00,0,0,0,0,0,0,0,0,0,0,0,0,0
20200212,03500P,大立光元富92售05,,,,,0.00,0.00,0,0,0,0,0,0,0,0,0,0,0,0,0
20200212,03501P,緯穎元富94售01,0.01,0.01,0.01,0.01,0.00,0.00,10000,2,100,0,0,0,0,0,0,10000,0,10000,10000
20200212,03502P,臺股指元富92售04,0.01,0.01,0.01,0.01,0.00,0.00,40000,1,400,0,0,0,0,0,0,0,0,0,0
20200212,03503P,臺股指元富92售05,,,,,0.00,0.00,0,0,0,0,0,0,0,0,0,0,0,0,0
20200212,03504P,臺股指元富92售06,,,,,0.00,0.00,0,0,0,0,0,0,0,0,0,0,0,0,0
20200212,03505P,臺股指元富92售07,,,,,0.00,0.00,0,0,0,0,0,0,0,0,0,0,0,0,0
20200212,03506P,臺股指元富92售08,,,,,0.00,0.00,0,0,0,0,0,0,0,0,0,0,0,0,0
20200212,03507P,臺股指元富92售09,,,,,0.00,0.00,0,0,0,0,0,0,0,0,0,0,0,0,0
20200212,03508P,臺股指元富92售10,,,,,0.00,0.00,0,0,0,0,0,0,0,0,0,0,0,0,0
20200212,03509P,和大元大92售02,,,,,0.00,0.00,0,0,0,0,0,0,0,0,0,0,0,0,0
20200212,03510P,台積電元大92售19,,,,,0.00,0.00,0,0,0,0,0,0,0,0,0,0,0,0,0
20200212,03511P,台光電元大92售08,,,,,0.00,0.00,0,0,0,0,0,0,0,0,0,0,0,0,0
20200212,03512P,友達元大92售04,,,,,0.00,0.00,0,0,0,0,0,0,0,0,0,0,0,0,0
20200212,03513P,可成元大92售08,,,,,0.00,0.00,0,0,0,0,0,0,0,0,0,0,0,0,0
20200212,03514P,健鼎元大92售02,,,,,0.00,0.00,0,0,0,0,0,0,0,0,0,0,0,0,0
20200212,03515P,群創元大92售05,,,,,0.00,0.00,0,0,0,0,0,0,0,0,0,0,0,0,0
20200212,03516P,日月光元大92售01,,,,,0.00,0.00,0,0,0,0,0,0,0,0,0,0,0,0,0
20200212,03517P,臺股指元大93售13,,,,,0.00,0.00,0,0,0,0,0,0,0,0,0,0,0,0,0
20200212,03518P,臺股指元大93售14,,,,,0.00,0.00,0,0,0,0,0,0,0,0,0,0,0,0,0
20200212,03519P,臺股指元大93售15,,,,,0.00,0.00,0,0,0,0,0,0,0,0,0,0,0,0,0
20200212,03520P,臺股指元大93售16,,,,,0.00,0.00,0,0,0,0,0,0,0,0,0,0,0,0,0
20200212,03521P,T50正2中信92售01,,,,,0.00,0.00,0,0,0,0,0,0,0,0,0,0,0,0,0
20200212,03522P,道瓊指中信92售01,,,,,0.00,0.00,0,0,0,0,0,0,0,0,0,0,0,0,0
20200212,03523P,台光電群益92售02,,,,,0.00,0.00,0,0,0,0,0,0,0,0,0,0,0,0,0
20200212,03524P,致新凱基92售02,,,,,0.00,0.00,0,0,0,0,0,0,0,0,0,0,0,0,0
20200212,03525P,和大國票93售01,,,,,0.00,0.00,0,0,0,0,0,0,0,0,0,0,0,0,0
20200212,03526P,大立光國票93售01,,,,,0.00,0.00,0,0,0,0,0,0,0,0,0,0,0,0,0
20200212,035274,華新台新97購01,0.50,0.50,0.50,0.50,0.00,0.00,46000,1,23000,0,0,0,0,0,0,0,46000,-46000,-46000
20200212,035275,台積電台新97購01,33.30,33.90,33.30,33.90,+1.20,3.67,13000,4,436500,0,0,0,0,0,0,13000,0,13000,13000
20200212,035276,南亞科台新97購01,,,,,0.00,0.00,0,0,0,0,0,0,0,0,0,0,0,0,0
20200212,035277,景碩台新97購01,6.30,7.85,6.15,7.30,+0.95,14.96,74000,20,477750,0,0,0,0,0,0,51000,23000,28000,28000
20200212,03527P,大立光國票93售02,0.01,0.01,0.01,0.01,0.00,0.00,998000,11,9980,0,0,0,0,0,0,0,0,0,0
20200212,03528P,超眾國票93售02,,,,,0.00,0.00,0,0,0,0,0,0,0,0,0,0,0,0,0
20200212,03529P,瑞昱永豐92售01,,,,,0.00,0.00,0,0,0,0,0,0,0,0,0,0,0,0,0
20200212,03530P,正文永豐92售02,,,,,0.00,0.00,0,0,0,0,0,0,0,0,0,0,0,0,0
20200212,03531P,同欣電永豐92售01,,,,,0.00,0.00,0,0,0,0,0,0,0,0,0,0,0,0,0
20200212,03532P,美律元大92售08,,,,,0.00,0.00,0,0,0,0,0,0,0,0,0,0,0,0,0
20200212,03533P,致伸元大92售03,,,,,0.00,0.00,0,0,0,0,0,0,0,0,0,0,0,0,0
20200212,03534P,臻鼎元大92售06,,,,,0.00,0.00,0,0,0,0,0,0,0,0,0,0,0,0,0
20200212,03535P,聯茂元大92售08,,,,,0.00,0.00,0,0,0,0,0,0,0,0,0,0,0,0,0
20200212,03536P,臺股指元大92售15,,,,,0.00,0.00,0,0,0,0,0,0,0,0,0,0,0,0,0
20200212,03537P,台積電統一92售06,,,,,0.00,0.00,0,0,0,0,0,0,0,0,0,0,0,0,0
20200212,03538P,健鼎統一92售01,,,,,0.00,0.00,0,0,0,0,0,0,0,0,0,0,0,0,0
20200212,03539P,京元電元富92售02,,,,,0.00,0.00,0,0,0,0,0,0,0,0,0,0,0,0,0
20200212,03540P,冠德元富92售01,,,,,0.00,0.00,0,0,0,0,0,0,0,0,0,0,0,0,0
20200212,03541P,日月光元富92售01,,,,,0.00,0.00,0,0,0,0,0,0,0,0,0,0,0,0,0
20200212,03542P,矽力元富92售01,,,,,0.00,0.00,0,0,0,0,0,0,0,0,0,0,0,0,0
20200212,03543P,T50正2中信95售02,0.10,0.10,0.09,0.09,0.00,0.00,420000,3,39800,0,0,0,0,0,0,0,420000,-420000,-420000
20200212,03544P,貿聯國票93售01,1.03,1.03,0.98,0.98,-0.12,-10.91,35000,2,35950,0,0,0,0,0,0,35000,0,35000,35000
20200212,03545P,臻鼎群益92售01,,,,,0.00,0.00,0,0,0,0,0,0,0,0,0,0,0,0,0
20200212,03546P,上銀兆豐93售03,,,,,0.00,0.00,0,0,0,0,0,0,0,0,0,0,0,0,0
20200212,03547P,和大凱基92售01,,,,,0.00,0.00,0,0,0,0,0,0,0,0,0,0,0,0,0
20200212,03548P,台積電凱基92售19,,,,,0.00,0.00,0,0,0,0,0,0,0,0,0,0,0,0,0
20200212,03549P,強茂凱基92售01,,,,,0.00,0.00,0,0,0,0,0,0,0,0,0,0,0,0,0
20200212,03550P,大立光凱基92售07,,,,,0.00,0.00,0,0,0,0,0,0,0,0,0,0,0,0,0
20200212,03551P,大立光凱基92售08,,,,,0.00,0.00,0,0,0,0,0,0,0,0,0,0,0,0,0
20200212,03552P,台表科統一92售01,,,,,0.00,0.00,0,0,0,0,0,0,0,0,0,0,0,0,0
20200212,03553P,上銀富邦94售01,,,,,0.00,0.00,0,0,0,0,0,0,0,0,0,0,0,0,0
20200212,03554P,台積電富邦92售02,,,,,0.00,0.00,0,0,0,0,0,0,0,0,0,0,0,0,0
20200212,03555P,台積電富邦95售01,0.02,0.02,0.01,0.02,0.00,0.00,371000,7,7410,0,0,0,0,0,0,0,0,0,0
20200212,03556P,聯發科元大92售13,,,,,0.00,0.00,0,0,0,0,0,0,0,0,0,0,0,0,0
20200212,03557P,大立光元大93售12,0.13,0.14,0.13,0.13,-0.03,-18.75,330000,4,43000,0,0,0,0,0,0,0,310000,-310000,-310000
20200212,03558P,揚明光元大92售02,,,,,0.00,0.00,0,0,0,0,0,0,0,0,0,0,0,0,0
20200212,03559P,東元中信92售01,,,,,0.00,0.00,0,0,0,0,0,0,0,0,0,0,0,0,0
20200212,03560P,中鋼中信94售02,,,,,0.00,0.00,0,0,0,0,0,0,0,0,0,0,0,0,0
20200212,03561P,聯發科中信93售02,,,,,0.00,0.00,0,0,0,0,0,0,0,0,0,0,0,0,0
20200212,03562P,卜蜂群益92售02,,,,,0.00,0.00,0,0,0,0,0,0,0,0,0,0,0,0,0
20200212,03563P,鴻海群益93售03,0.03,0.03,0.03,0.03,0.00,0.00,12000,1,360,0,0,0,0,0,0,12000,0,12000,12000
20200212,03564P,致茂群益94售01,0.39,0.40,0.39,0.40,0.00,0.00,100000,2,39500,0,0,0,0,0,0,50000,50000,0,0
20200212,03565P,大立光群益92售06,,,,,0.00,0.00,0,0,0,0,0,0,0,0,0,0,0,0,0
20200212,03566P,群創群益96售01,,,,,0.00,0.00,0,0,0,0,0,0,0,0,0,0,0,0,0
20200212,03567P,百和群益94售02,1.16,1.16,1.16,1.16,-0.01,-0.85,60000,2,69600,0,0,0,0,0,0,30000,30000,0,0
20200212,03568P,台積電日盛92售02,0.01,0.01,0.01,0.01,0.00,0.00,250000,1,2500,0,0,0,0,0,0,250000,0,250000,250000
20200212,03569P,強茂凱基92售02,,,,,0.00,0.00,0,0,0,0,0,0,0,0,0,0,0,0,0
20200212,03570P,力山永豐92售03,,,,,0.00,0.00,0,0,0,0,0,0,0,0,0,0,0,0,0
20200212,03571P,聯發科永豐92售02,,,,,0.00,0.00,0,0,0,0,0,0,0,0,0,0,0,0,0
20200212,03572P,強茂永豐92售02,,,,,0.00,0.00,0,0,0,0,0,0,0,0,0,0,0,0,0
20200212,03573P,華新科永豐92售01,,,,,0.00,0.00,0,0,0,0,0,0,0,0,0,0,0,0,0
20200212,03574P,健策永豐92售02,,,,,0.00,0.00,0,0,0,0,0,0,0,0,0,0,0,0,0
20200212,03575P,嘉聯益永豐92售03,,,,,0.00,0.00,0,0,0,0,0,0,0,0,0,0,0,0,0
20200212,03576P,聯發科統一94售02,0.21,0.21,0.18,0.18,-0.08,-30.77,595000,15,108700,0,0,0,0,0,0,15000,580000,-565000,-565000
20200212,03577P,大立光統一92售04,,,,,0.00,0.00,0,0,0,0,0,0,0,0,0,0,0,0,0
20200212,03578P,欣興統一92售03,,,,,0.00,0.00,0,0,0,0,0,0,0,0,0,0,0,0,0
20200212,03579P,台勝科統一92售02,,,,,0.00,0.00,0,0,0,0,0,0,0,0,0,0,0,0,0
20200212,03580P,欣興元富92售03,,,,,0.00,0.00,0,0,0,0,0,0,0,0,0,0,0,0,0
20200212,03581P,超眾元富92售02,,,,,0.00,0.00,0,0,0,0,0,0,0,0,0,0,0,0,0
20200212,03582P,台表科元富92售01,,,,,0.00,0.00,0,0,0,0,0,0,0,0,0,0,0,0,0
20200212,03583P,聯發科富邦94售02,0.23,0.23,0.23,0.23,-0.07,-23.33,1000,1,230,0,0,0,0,0,0,0,1000,-1000,-1000
20200212,03584P,鴻海元大92售12,,,,,0.00,0.00,0,0,0,0,0,0,0,0,0,0,0,0,0
20200212,03585P,鴻海元大92售13,,,,,0.00,0.00,0,0,0,0,0,0,0,0,0,0,0,0,0
20200212,03586P,台積電元大92售22,,,,,0.00,0.00,0,0,0,0,0,0,0,0,0,0,0,0,0
20200212,03587P,台積電元大92售23,,,,,0.00,0.00,0,0,0,0,0,0,0,0,0,0,0,0,0
20200212,03588P,台積電元大92售24,,,,,0.00,0.00,0,0,0,0,0,0,0,0,0,0,0,0,0
20200212,03589P,京元電元大92售06,,,,,0.00,0.00,0,0,0,0,0,0,0,0,0,0,0,0,0
20200212,03590P,台郡元大92售05,,,,,0.00,0.00,0,0,0,0,0,0,0,0,0,0,0,0,0
20200212,03591P,中環中信94售01,1.34,1.39,1.34,1.39,+0.08,6.11,88000,4,120670,0,0,0,0,0,0,28000,60000,-32000,-32000
20200212,03592P,國巨群益92售06,,,,,0.00,0.00,0,0,0,0,0,0,0,0,0,0,0,0,0
20200212,03593P,智邦群益92售03,,,,,0.00,0.00,0,0,0,0,0,0,0,0,0,0,0,0,0
20200212,03594P,聯發科群益92售05,,,,,0.00,0.00,0,0,0,0,0,0,0,0,0,0,0,0,0
20200212,03595C,滬深2X元富92牛01,,,,,0.00,0.00,0,0,0,0,0,0,0,0,0,0,0,0,0
20200212,03595P,智易群益94售01,,,,,0.00,0.00,0,0,0,0,0,0,0,0,0,0,0,0,0
20200212,03596P,京元電永豐92售02,,,,,0.00,0.00,0,0,0,0,0,0,0,0,0,0,0,0,0
20200212,03597P,康控永豐92售02,,,,,0.00,0.00,0,0,0,0,0,0,0,0,0,0,0,0,0
20200212,03598P,中磊永豐92售01,,,,,0.00,0.00,0,0,0,0,0,0,0,0,0,0,0,0,0
20200212,03599P,聯發科凱基92售05,,,,,0.00,0.00,0,0,0,0,0,0,0,0,0,0,0,0,0
20200212,03600P,聯發科凱基92售06,,,,,0.00,0.00,0,0,0,0,0,0,0,0,0,0,0,0,0
20200212,03601P,聯發科凱基92售07,,,,,0.00,0.00,0,0,0,0,0,0,0,0,0,0,0,0,0
20200212,03602C,臺股指元大93牛01,,,,,0.00,0.00,0,0,0,0,0,0,0,0,0,0,0,0,0
20200212,03602P,大立光凱基92售10,,,,,0.00,0.00,0,0,0,0,0,0,0,0,0,0,0,0,0
20200212,03603P,群創凱基98售04,,,,,0.00,0.00,0,0,0,0,0,0,0,0,0,0,0,0,0
20200212,03604P,群創凱基98售05,,,,,0.00,0.00,0,0,0,0,0,0,0,0,0,0,0,0,0
20200212,036053,道瓊反中信92購01,,,,,0.00,0.00,0,0,0,0,0,0,0,0,0,0,0,0,0
20200212,03605P,美利達統一92售01,,,,,0.00,0.00,0,0,0,0,0,0,0,0,0,0,0,0,0
20200212,03606P,奇力新元富92售02,,,,,0.00,0.00,0,0,0,0,0,0,0,0,0,0,0,0,0
20200212,03607P,滬深2X富邦95售01,,,,,0.00,0.00,0,0,0,0,0,0,0,0,0,0,0,0,0
20200212,036084,台灣50台新98購01,,,,,0.00,0.00,0,0,0,0,0,0,0,0,0,0,0,0,0
20200212,03608P,鴻海元大92售14,,,,,0.00,0.00,0,0,0,0,0,0,0,0,0,0,0,0,0
20200212,03609P,華泰元大92售01,,,,,0.00,0.00,0,0,0,0,0,0,0,0,0,0,0,0,0
20200212,03610P,台積電元大92售28,,,,,0.00,0.00,0,0,0,0,0,0,0,0,0,0,0,0,0
20200212,03611P,台積電元大92售29,,,,,0.00,0.00,0,0,0,0,0,0,0,0,0,0,0,0,0
20200212,03612C,臺股指元大95牛01,2.74,2.82,2.74,2.80,+0.11,4.09,12000,3,33020,0,0,0,0,0,0,0,12000,-12000,-12000
20200212,03612P,台積電元大92售30,,,,,0.00,0.00,0,0,0,0,0,0,0,0,0,0,0,0,0
20200212,03613P,聯發科元大92售17,,,,,0.00,0.00,0,0,0,0,0,0,0,0,0,0,0,0,0
20200212,03614P,聯發科元大92售18,,,,,0.00,0.00,0,0,0,0,0,0,0,0,0,0,0,0,0
20200212,03615C,臺股指元大94牛01,,,,,0.00,0.00,0,0,0,0,0,0,0,0,0,0,0,0,0
20200212,03615P,大立光元大92售21,,,,,0.00,0.00,0,0,0,0,0,0,0,0,0,0,0,0,0
20200212,03616P,大立光元大92售24,,,,,0.00,0.00,0,0,0,0,0,0,0,0,0,0,0,0,0
20200212,03617P,景碩元大92售01,,,,,0.00,0.00,0,0,0,0,0,0,0,0,0,0,0,0,0
20200212,03618C,高股息凱基95牛01,2.41,2.42,2.41,2.42,0.00,0.00,10000,2,24150,0,0,0,0,0,0,5000,5000,0,0
20200212,03618P,嘉澤元大92售03,,,,,0.00,0.00,0,0,0,0,0,0,0,0,0,0,0,0,0
20200212,03619C,臺股指元大95牛02,,,,,0.00,0.00,0,0,0,0,0,0,0,0,0,0,0,0,0
20200212,03619P,臻鼎元大92售11,,,,,0.00,0.00,0,0,0,0,0,0,0,0,0,0,0,0,0
20200212,03620P,GIS元大92售06,,,,,0.00,0.00,0,0,0,0,0,0,0,0,0,0,0,0,0
20200212,03621P,旺宏第一92售01,,,,,0.00,0.00,0,0,0,0,0,0,0,0,0,0,0,0,0
20200212,03622P,台光電中信92售01,0.29,0.29,0.26,0.26,-0.13,-33.33,44000,3,12470,0,0,0,0,0,0,44000,44000,0,0
20200212,03623P,台積電群益93售03,,,,,0.00,0.00,0,0,0,0,0,0,0,0,0,0,0,0,0
20200212,03624P,聯發科群益92售07,,,,,0.00,0.00,0,0,0,0,0,0,0,0,0,0,0,0,0
20200212,03625P,欣興群益92售04,,,,,0.00,0.00,0,0,0,0,0,0,0,0,0,0,0,0,0
20200212,03626P,可成兆豐93售03,,,,,0.00,0.00,0,0,0,0,0,0,0,0,0,0,0,0,0
20200212,036271,道瓊反元富92購01,,,,,0.00,0.00,0,0,0,0,0,0,0,0,0,0,0,0,0
20200212,03627P,大立光兆豐93售03,,,,,0.00,0.00,0,0,0,0,0,0,0,0,0,0,0,0,0
20200212,03628C,臺股指元大93牛02,,,,,0.00,0.00,0,0,0,0,0,0,0,0,0,0,0,0,0
20200212,03628P,聯發科日盛92售02,,,,,0.00,0.00,0,0,0,0,0,0,0,0,0,0,0,0,0
20200212,03629C,元油2X元富98牛06,1.01,1.03,1.01,1.03,+0.06,6.19,94000,4,95440,0,0,0,0,0,0,79000,15000,64000,64000
20200212,03629P,台積電麥證92售02,,,,,0.00,0.00,0,0,0,0,0,0,0,0,0,0,0,0,0
20200212,03630C,臺股指元富93牛02,,,,,0.00,0.00,0,0,0,0,0,0,0,0,0,0,0,0,0
20200212,03630P,大立光麥證92售01,,,,,0.00,0.00,0,0,0,0,0,0,0,0,0,0,0,0,0
20200212,03631C,臺股指凱基92牛12,,,,,0.00,0.00,0,0,0,0,0,0,0,0,0,0,0,0,0
20200212,03631P,鴻海凱基93售13,,,,,0.00,0.00,0,0,0,0,0,0,0,0,0,0,0,0,0
20200212,03632C,臺股指元大95牛03,,,,,0.00,0.00,0,0,0,0,0,0,0,0,0,0,0,0,0
20200212,03632P,台積電凱基92售22,,,,,0.00,0.00,0,0,0,0,0,0,0,0,0,0,0,0,0
20200212,03633C,臺股指凱基93牛19,,,,,0.00,0.00,0,0,0,0,0,0,0,0,0,0,0,0,0
20200212,03633P,智邦凱基92售06,,,,,0.00,0.00,0,0,0,0,0,0,0,0,0,0,0,0,0
20200212,03634P,瑞昱凱基92售04,,,,,0.00,0.00,0,0,0,0,0,0,0,0,0,0,0,0,0
20200212,03635C,滬深2X元富99牛01,2.39,2.40,2.34,2.37,-0.03,-1.25,151000,8,358170,0,0,0,0,0,0,26000,125000,-99000,-99000
20200212,03635P,聯發科凱基92售09,,,,,0.00,0.00,0,0,0,0,0,0,0,0,0,0,0,0,0
20200212,03636C,元油2X元富04牛01,2.27,2.34,2.27,2.34,+0.09,4.0,482000,11,1108720,0,0,0,0,0,0,55000,422000,-367000,-367000
20200212,03636P,可成凱基92售10,,,,,0.00,0.00,0,0,0,0,0,0,0,0,0,0,0,0,0
20200212,03637C,臺股指凱基94牛18,,,,,0.00,0.00,0,0,0,0,0,0,0,0,0,0,0,0,0
20200212,03637P,大立光凱基92售13,,,,,0.00,0.00,0,0,0,0,0,0,0,0,0,0,0,0,0
20200212,03638C,T50反1元大94牛03,0.59,0.59,0.53,0.53,-0.08,-13.11,4996000,33,2688280,0,0,0,0,0,0,4268000,698000,3570000,3570000
20200212,03638P,嘉晶凱基93售03,,,,,0.00,0.00,0,0,0,0,0,0,0,0,0,0,0,0,0
20200212,03639C,元油2X元大9B牛01,1.52,1.60,1.52,1.60,+0.10,6.67,327000,18,508050,0,0,0,0,0,0,103000,224000,-121000,-121000
20200212,03639P,祥碩凱基93售05,0.30,0.30,0.30,0.30,-0.16,-34.78,64000,1,19200,0,0,0,0,0,0,64000,0,64000,64000
20200212,03640P,百和凱基93售05,,,,,0.00,0.00,0,0,0,0,0,0,0,0,0,0,0,0,0
20200212,03641C,臺股指凱基95牛18,1.74,1.76,1.74,1.76,+0.13,7.98,40000,3,69900,0,0,0,0,0,0,0,40000,-40000,-40000
20200212,03641P,台表科康和92售01,,,,,0.00,0.00,0,0,0,0,0,0,0,0,0,0,0,0,0
20200212,03642C,臺股指元大94牛27,1.84,1.92,1.84,1.92,+0.11,6.08,415000,6,794600,0,0,0,0,0,0,225000,190000,35000,35000
20200212,03642P,上銀永豐92售02,,,,,0.00,0.00,0,0,0,0,0,0,0,0,0,0,0,0,0
20200212,03643C,臺股指元富99牛04,1.44,1.52,1.44,1.52,+0.09,6.29,315000,6,475950,0,0,0,0,0,0,40000,275000,-235000,-235000
20200212,03643P,燿華永豐92售02,,,,,0.00,0.00,0,0,0,0,0,0,0,0,0,0,0,0,0
20200212,03644C,臺股指元大94牛28,1.40,1.41,1.40,1.41,+0.03,2.17,11000,2,15410,0,0,0,0,0,0,11000,0,11000,11000
20200212,03644P,建準永豐92售02,,,,,0.00,0.00,0,0,0,0,0,0,0,0,0,0,0,0,0
20200212,03645C,臺股指凱基96牛27,1.39,1.39,1.39,1.39,+0.02,1.46,20000,1,27800,0,0,0,0,0,0,20000,0,20000,20000
20200212,03645P,群創統一92售01,,,,,0.00,0.00,0,0,0,0,0,0,0,0,0,0,0,0,0
20200212,03646C,臺股指元大95牛32,,,,,0.00,0.00,0,0,0,0,0,0,0,0,0,0,0,0,0
20200212,03646P,智易統一92售01,,,,,0.00,0.00,0,0,0,0,0,0,0,0,0,0,0,0,0
20200212,03647C,T50反1元富99牛02,,,,,0.00,0.00,0,0,0,0,0,0,0,0,0,0,0,0,0
20200212,03647P,京元電元富95售02,0.95,0.95,0.95,0.95,-0.12,-11.21,15000,1,14250,0,0,0,0,0,0,0,15000,-15000,-15000
20200212,03648C,T50反1元大96牛07,1.67,1.67,1.62,1.62,-0.07,-4.14,480000,3,800790,0,0,0,0,0,0,460000,20000,440000,440000
20200212,03648P,健策元富92售01,,,,,0.00,0.00,0,0,0,0,0,0,0,0,0,0,0,0,0
20200212,03649C,T50反1凱基99牛05,,,,,0.00,0.00,0,0,0,0,0,0,0,0,0,0,0,0,0
20200212,03649P,聯發科國泰93售02,,,,,0.00,0.00,0,0,0,0,0,0,0,0,0,0,0,0,0
20200212,03650C,T50反1元大98牛05,1.78,1.78,1.77,1.77,-0.03,-1.67,1380000,3,2451800,0,0,0,0,0,0,1380000,0,1380000,1380000
20200212,03650P,群創國泰93售03,,,,,0.00,0.00,0,0,0,0,0,0,0,0,0,0,0,0,0
20200212,03651C,臺股指凱基97牛17,1.14,1.22,1.14,1.22,+0.11,9.91,99000,12,115950,0,0,0,0,0,0,49000,47000,2000,2000
20200212,03651P,統一元大92售01,,,,,0.00,0.00,0,0,0,0,0,0,0,0,0,0,0,0,0
20200212,03652C,臺股指元大03牛01,2.28,2.28,2.28,2.28,+0.12,5.56,15000,1,34200,0,0,0,0,0,0,0,15000,-15000,-15000
20200212,03652P,台積電元大92售31,,,,,0.00,0.00,0,0,0,0,0,0,0,0,0,0,0,0,0
20200212,03653C,臺股指元大95牛34,,,,,0.00,0.00,0,0,0,0,0,0,0,0,0,0,0,0,0
20200212,03653P,國泰金元大92售04,,,,,0.00,0.00,0,0,0,0,0,0,0,0,0,0,0,0,0
20200212,03654C,元油2X凱基9B牛02,,,,,0.00,0.00,0,0,0,0,0,0,0,0,0,0,0,0,0
20200212,03654P,GIS元大92售07,,,,,0.00,0.00,0,0,0,0,0,0,0,0,0,0,0,0,0
20200212,03655C,元油2X凱基02牛01,,,,,0.00,0.00,0,0,0,0,0,0,0,0,0,0,0,0,0
20200212,03655P,臺股指元大92售17,,,,,0.00,0.00,0,0,0,0,0,0,0,0,0,0,0,0,0
20200212,03656P,臺股指元大92售18,,,,,0.00,0.00,0,0,0,0,0,0,0,0,0,0,0,0,0
20200212,03657P,臺股指元大92售19,,,,,0.00,0.00,0,0,0,0,0,0,0,0,0,0,0,0,0
20200212,03658P,臺股指元大92售20,,,,,0.00,0.00,0,0,0,0,0,0,0,0,0,0,0,0,0
20200212,03659P,臺股指元大92售21,,,,,0.00,0.00,0,0,0,0,0,0,0,0,0,0,0,0,0
20200212,03660P,台積電中信93售01,,,,,0.00,0.00,0,0,0,0,0,0,0,0,0,0,0,0,0
20200212,03661P,智邦兆豐92售01,,,,,0.00,0.00,0,0,0,0,0,0,0,0,0,0,0,0,0
20200212,036628,統一台新99購01,4.54,4.54,4.51,4.51,-0.12,-2.59,18000,4,81480,0,0,0,0,0,0,18000,0,18000,18000
20200212,036629,智邦台新99購01,,,,,0.00,0.00,0,0,0,0,0,0,0,0,0,0,0,0,0
20200212,03662P,聯發科兆豐92售03,,,,,0.00,0.00,0,0,0,0,0,0,0,0,0,0,0,0,0
20200212,036630,玉山金台新99購01,,,,,0.00,0.00,0,0,0,0,0,0,0,0,0,0,0,0,0
20200212,03663P,聯電群益92售01,,,,,0.00,0.00,0,0,0,0,0,0,0,0,0,0,0,0,0
20200212,03664P,南茂康和92售01,,,,,0.00,0.00,0,0,0,0,0,0,0,0,0,0,0,0,0
20200212,03665P,華邦電永豐92售01,0.34,0.34,0.32,0.32,-0.13,-28.89,60000,32,19670,0,0,0,0,0,0,60000,0,60000,60000
20200212,03666P,晶技永豐92售02,,,,,0.00,0.00,0,0,0,0,0,0,0,0,0,0,0,0,0
20200212,03667P,鴻海凱基93售14,,,,,0.00,0.00,0,0,0,0,0,0,0,0,0,0,0,0,0
20200212,036681,SP黃豆元富93購01,,,,,0.00,0.00,0,0,0,0,0,0,0,0,0,0,0,0,0
20200212,03668P,台積電凱基92售24,,,,,0.00,0.00,0,0,0,0,0,0,0,0,0,0,0,0,0
20200212,03669P,智邦凱基92售07,,,,,0.00,0.00,0,0,0,0,0,0,0,0,0,0,0,0,0
20200212,03670P,可成凱基92售12,,,,,0.00,0.00,0,0,0,0,0,0,0,0,0,0,0,0,0
20200212,03671P,大立光凱基95售02,0.42,0.42,0.42,0.42,-0.04,-8.7,35000,2,14700,0,0,0,0,0,0,0,35000,-35000,-35000
20200212,03672P,聯詠凱基92售10,,,,,0.00,0.00,0,0,0,0,0,0,0,0,0,0,0,0,0
20200212,03673P,康控元富92售02,,,,,0.00,0.00,0,0,0,0,0,0,0,0,0,0,0,0,0
20200212,03674P,同欣電元富92售03,,,,,0.00,0.00,0,0,0,0,0,0,0,0,0,0,0,0,0
20200212,03675P,旺宏統一92售02,,,,,0.00,0.00,0,0,0,0,0,0,0,0,0,0,0,0,0
20200212,03676P,大立光國泰93售03,,,,,0.00,0.00,0,0,0,0,0,0,0,0,0,0,0,0,0
20200212,03677P,聯發科元大92售21,,,,,0.00,0.00,0,0,0,0,0,0,0,0,0,0,0,0,0
20200212,03678P,欣興元大92售09,,,,,0.00,0.00,0,0,0,0,0,0,0,0,0,0,0,0,0
20200212,03679P,健策元大92售07,,,,,0.00,0.00,0,0,0,0,0,0,0,0,0,0,0,0,0
20200212,036804,國巨元富93購01,0.99,0.99,0.91,0.98,+0.08,8.89,348000,14,342740,0,0,0,0,0,0,333000,15000,318000,318000
20200212,036805,國巨元富93購02,1.20,1.25,1.18,1.25,+0.11,9.65,429000,22,521000,0,0,0,0,0,0,184000,235000,-51000,-51000
20200212,03680P,矽創元大92售05,,,,,0.00,0.00,0,0,0,0,0,0,0,0,0,0,0,0,0
20200212,03681P,臺股指元大92售28,,,,,0.00,0.00,0,0,0,0,0,0,0,0,0,0,0,0,0
20200212,03682P,台積電群益93售04,,,,,0.00,0.00,0,0,0,0,0,0,0,0,0,0,0,0,0
20200212,03683P,電子類群益93售02,,,,,0.00,0.00,0,0,0,0,0,0,0,0,0,0,0,0,0
20200212,03684P,台積電凱基93售02,,,,,0.00,0.00,0,0,0,0,0,0,0,0,0,0,0,0,0
20200212,03685P,同欣電凱基93售01,,,,,0.00,0.00,0,0,0,0,0,0,0,0,0,0,0,0,0
20200212,03686P,大立光統一98售02,0.37,0.37,0.34,0.35,-0.06,-14.63,580000,26,206850,0,0,0,0,0,0,358000,187000,171000,171000
20200212,03687P,旺宏元富93售01,,,,,0.00,0.00,0,0,0,0,0,0,0,0,0,0,0,0,0
20200212,03688P,全新元富93售01,,,,,0.00,0.00,0,0,0,0,0,0,0,0,0,0,0,0,0
20200212,03689P,TPK元富93售01,1.19,1.19,1.19,1.19,-0.06,-4.8,6000,1,7140,0,0,0,0,0,0,0,6000,-6000,-6000
20200212,03690P,亞德客永豐93售01,,,,,0.00,0.00,0,0,0,0,0,0,0,0,0,0,0,0,0
20200212,03691P,漢唐永豐93售01,,,,,0.00,0.00,0,0,0,0,0,0,0,0,0,0,0,0,0
20200212,03692P,欣興永豐93售01,,,,,0.00,0.00,0,0,0,0,0,0,0,0,0,0,0,0,0
20200212,03693P,上緯控永豐93售01,,,,,0.00,0.00,0,0,0,0,0,0,0,0,0,0,0,0,0
20200212,03694P,嘉聯益永豐93售01,0.39,0.39,0.39,0.39,0.00,0.00,150000,1,58500,0,0,0,0,0,0,0,150000,-150000,-150000
20200212,03695P,台表科永豐93售01,,,,,0.00,0.00,0,0,0,0,0,0,0,0,0,0,0,0,0
20200212,03696P,國巨元大93售09,,,,,0.00,0.00,0,0,0,0,0,0,0,0,0,0,0,0,0
20200212,03697P,台積電元大93售05,,,,,0.00,0.00,0,0,0,0,0,0,0,0,0,0,0,0,0
20200212,03698P,瑞昱元大93售01,,,,,0.00,0.00,0,0,0,0,0,0,0,0,0,0,0,0,0
20200212,03699P,義隆元大93售01,,,,,0.00,0.00,0,0,0,0,0,0,0,0,0,0,0,0,0
20200212,03700P,貿聯元大93售01,,,,,0.00,0.00,0,0,0,0,0,0,0,0,0,0,0,0,0
20200212,03701P,祥碩元大93售01,,,,,0.00,0.00,0,0,0,0,0,0,0,0,0,0,0,0,0
20200212,03702P,中磊元大93售02,,,,,0.00,0.00,0,0,0,0,0,0,0,0,0,0,0,0,0
20200212,03703P,台郡元大93售02,0.02,0.02,0.02,0.02,0.00,0.00,1000,1,20,0,0,0,0,0,0,0,1000,-1000,-1000
20200212,03704P,同欣電元大93售01,,,,,0.00,0.00,0,0,0,0,0,0,0,0,0,0,0,0,0
20200212,03705P,臺股指元大93售21,,,,,0.00,0.00,0,0,0,0,0,0,0,0,0,0,0,0,0
20200212,03706P,上銀群益93售03,,,,,0.00,0.00,0,0,0,0,0,0,0,0,0,0,0,0,0
20200212,03707P,祥碩群益93售01,,,,,0.00,0.00,0,0,0,0,0,0,0,0,0,0,0,0,0
20200212,03708P,鴻海亞東93售01,,,,,0.00,0.00,0,0,0,0,0,0,0,0,0,0,0,0,0
20200212,03709P,鴻海凱基93售16,,,,,0.00,0.00,0,0,0,0,0,0,0,0,0,0,0,0,0
20200212,03710P,台郡凱基93售01,,,,,0.00,0.00,0,0,0,0,0,0,0,0,0,0,0,0,0
20200212,03711P,同欣電凱基93售02,,,,,0.00,0.00,0,0,0,0,0,0,0,0,0,0,0,0,0
20200212,03712P,京元電統一93售02,,,,,0.00,0.00,0,0,0,0,0,0,0,0,0,0,0,0,0
20200212,03713P,GIS元富93售02,,,,,0.00,0.00,0,0,0,0,0,0,0,0,0,0,0,0,0
20200212,03714P,台積電台新93售02,,,,,0.00,0.00,0,0,0,0,0,0,0,0,0,0,0,0,0
20200212,03715P,元油2X永豐93售03,,,,,0.00,0.00,0,0,0,0,0,0,0,0,0,0,0,0,0
20200212,03716P,大成鋼永豐93售01,,,,,0.00,0.00,0,0,0,0,0,0,0,0,0,0,0,0,0
20200212,03717P,奇力新永豐93售01,,,,,0.00,0.00,0,0,0,0,0,0,0,0,0,0,0,0,0
20200212,03718P,訊芯永豐93售01,,,,,0.00,0.00,0,0,0,0,0,0,0,0,0,0,0,0,0
20200212,03719P,矽創永豐93售01,,,,,0.00,0.00,0,0,0,0,0,0,0,0,0,0,0,0,0
20200212,03720P,元油2X富邦95售01,,,,,0.00,0.00,0,0,0,0,0,0,0,0,0,0,0,0,0
20200212,03721P,卜蜂元大93售01,,,,,0.00,0.00,0,0,0,0,0,0,0,0,0,0,0,0,0
20200212,03722P,華通元大93售04,0.01,0.01,0.01,0.01,0.00,0.00,88000,1,880,0,0,0,0,0,0,0,0,0,0
20200212,03723P,國巨元大93售10,,,,,0.00,0.00,0,0,0,0,0,0,0,0,0,0,0,0,0
20200212,03724P,台積電元大93售06,,,,,0.00,0.00,0,0,0,0,0,0,0,0,0,0,0,0,0
20200212,03725P,台積電元大93售07,,,,,0.00,0.00,0,0,0,0,0,0,0,0,0,0,0,0,0
20200212,03726P,台積電元大93售08,,,,,0.00,0.00,0,0,0,0,0,0,0,0,0,0,0,0,0
20200212,03727P,致茂元大93售01,,,,,0.00,0.00,0,0,0,0,0,0,0,0,0,0,0,0,0
20200212,03728P,瑞昱元大93售03,,,,,0.00,0.00,0,0,0,0,0,0,0,0,0,0,0,0,0
20200212,03729P,瑞昱元大93售04,,,,,0.00,0.00,0,0,0,0,0,0,0,0,0,0,0,0,0
20200212,03730P,京元電元大93售01,,,,,0.00,0.00,0,0,0,0,0,0,0,0,0,0,0,0,0
20200212,03731P,大立光元大93售15,,,,,0.00,0.00,0,0,0,0,0,0,0,0,0,0,0,0,0
20200212,03732P,大立光元大93售16,,,,,0.00,0.00,0,0,0,0,0,0,0,0,0,0,0,0,0
20200212,03733P,大立光元大93售17,,,,,0.00,0.00,0,0,0,0,0,0,0,0,0,0,0,0,0
20200212,03734P,新日興元大93售01,,,,,0.00,0.00,0,0,0,0,0,0,0,0,0,0,0,0,0
20200212,03735P,訊芯元大93售02,0.02,0.03,0.02,0.03,0.00,0.00,60000,6,1700,0,0,0,0,0,0,0,60000,-60000,-60000
20200212,03736P,南電元大93售02,,,,,0.00,0.00,0,0,0,0,0,0,0,0,0,0,0,0,0
20200212,03737P,臺股指中信95售01,0.01,0.01,0.01,0.01,0.00,0.00,410000,13,4100,0,0,0,0,0,0,0,0,0,0
20200212,03738P,旺宏群益93售04,,,,,0.00,0.00,0,0,0,0,0,0,0,0,0,0,0,0,0
20200212,03739P,瑞昱群益93售01,,,,,0.00,0.00,0,0,0,0,0,0,0,0,0,0,0,0,0
20200212,03740P,奇鋐群益94售01,,,,,0.00,0.00,0,0,0,0,0,0,0,0,0,0,0,0,0
20200212,03741P,鴻海凱基93售19,,,,,0.00,0.00,0,0,0,0,0,0,0,0,0,0,0,0,0
20200212,03742P,台積電凱基93售05,,,,,0.00,0.00,0,0,0,0,0,0,0,0,0,0,0,0,0
20200212,03743P,台積電凱基93售06,,,,,0.00,0.00,0,0,0,0,0,0,0,0,0,0,0,0,0
20200212,03744P,致茂凱基93售01,,,,,0.00,0.00,0,0,0,0,0,0,0,0,0,0,0,0,0
20200212,03745P,瑞昱凱基93售04,,,,,0.00,0.00,0,0,0,0,0,0,0,0,0,0,0,0,0
20200212,03746P,聯發科凱基93售07,,,,,0.00,0.00,0,0,0,0,0,0,0,0,0,0,0,0,0
20200212,03747P,聯發科凱基93售08,,,,,0.00,0.00,0,0,0,0,0,0,0,0,0,0,0,0,0
20200212,03748P,大立光凱基93售14,,,,,0.00,0.00,0,0,0,0,0,0,0,0,0,0,0,0,0
20200212,03749P,禾伸堂凱基93售01,,,,,0.00,0.00,0,0,0,0,0,0,0,0,0,0,0,0,0
20200212,03750P,臻鼎凱基93售04,,,,,0.00,0.00,0,0,0,0,0,0,0,0,0,0,0,0,0
20200212,03751P,旺宏富邦95售01,,,,,0.00,0.00,0,0,0,0,0,0,0,0,0,0,0,0,0
20200212,03752P,臺股指康和93售03,,,,,0.00,0.00,0,0,0,0,0,0,0,0,0,0,0,0,0
20200212,037536,道瓊反元富93購01,,,,,0.00,0.00,0,0,0,0,0,0,0,0,0,0,0,0,0
20200212,03753P,臺股指康和93售04,,,,,0.00,0.00,0,0,0,0,0,0,0,0,0,0,0,0,0
20200212,03754P,致茂永豐93售01,,,,,0.00,0.00,0,0,0,0,0,0,0,0,0,0,0,0,0
20200212,03755P,義隆永豐93售01,,,,,0.00,0.00,0,0,0,0,0,0,0,0,0,0,0,0,0
20200212,03756P,創意永豐93售01,,,,,0.00,0.00,0,0,0,0,0,0,0,0,0,0,0,0,0
20200212,03757P,麗豐永豐93售01,0.55,0.55,0.55,0.55,0.00,0.00,45000,1,24750,0,0,0,0,0,0,0,45000,-45000,-45000
20200212,03758P,GIS永豐93售01,,,,,0.00,0.00,0,0,0,0,0,0,0,0,0,0,0,0,0
20200212,03759P,世紀鋼永豐93售01,,,,,0.00,0.00,0,0,0,0,0,0,0,0,0,0,0,0,0
20200212,03760P,華通統一93售01,,,,,0.00,0.00,0,0,0,0,0,0,0,0,0,0,0,0,0
20200212,03761P,旺宏統一93售03,,,,,0.00,0.00,0,0,0,0,0,0,0,0,0,0,0,0,0
20200212,03762P,旺宏元富93售03,,,,,0.00,0.00,0,0,0,0,0,0,0,0,0,0,0,0,0
20200212,03763P,聯發科元富96售01,0.37,0.37,0.34,0.34,-0.10,-22.73,48000,3,17610,0,0,0,0,0,0,0,48000,-48000,-48000
20200212,03764P,大立光元富93售01,,,,,0.00,0.00,0,0,0,0,0,0,0,0,0,0,0,0,0
20200212,03765P,大立光元富96售01,0.33,0.33,0.28,0.28,-0.06,-17.65,70000,4,21250,0,0,0,0,0,0,25000,45000,-20000,-20000
20200212,03766P,台積電元大93售09,,,,,0.00,0.00,0,0,0,0,0,0,0,0,0,0,0,0,0
20200212,03767P,瑞昱元大93售05,,,,,0.00,0.00,0,0,0,0,0,0,0,0,0,0,0,0,0
20200212,03768P,聯發科元大93售03,,,,,0.00,0.00,0,0,0,0,0,0,0,0,0,0,0,0,0
20200212,03769P,聯發科元大93售04,0.26,0.26,0.20,0.21,-0.19,-47.5,1241000,18,299640,0,0,0,0,0,0,671000,570000,101000,101000
20200212,03770P,聯發科元大93售05,0.13,0.13,0.13,0.13,-0.12,-48.0,200000,1,26000,0,0,0,0,0,0,200000,200000,0,0
20200212,03771P,中磊元大93售03,,,,,0.00,0.00,0,0,0,0,0,0,0,0,0,0,0,0,0
20200212,03772P,聯茂元大93售02,0.16,0.22,0.16,0.22,0.00,0.00,205000,2,33100,0,0,0,0,0,0,0,205000,-205000,-205000
20200212,03773P,南茂元大93售01,,,,,0.00,0.00,0,0,0,0,0,0,0,0,0,0,0,0,0
20200212,03774P,臺股指元大93售24,,,,,0.00,0.00,0,0,0,0,0,0,0,0,0,0,0,0,0
20200212,03775P,臺股指元大93售25,,,,,0.00,0.00,0,0,0,0,0,0,0,0,0,0,0,0,0
20200212,03776P,臺股指元大93售26,,,,,0.00,0.00,0,0,0,0,0,0,0,0,0,0,0,0,0
20200212,03777P,華通中信95售01,0.08,0.08,0.05,0.05,-0.04,-44.44,482000,9,29760,0,0,0,0,0,0,0,482000,-482000,-482000
20200212,03778P,聯發科麥證93售01,0.09,0.09,0.09,0.09,0.00,0.00,50000,1,4500,50000,0,50000,0,0,0,50000,0,50000,50000
20200212,03779P,力山凱基93售01,,,,,0.00,0.00,0,0,0,0,0,0,0,0,0,0,0,0,0
20200212,03780P,台積電凱基93售08,,,,,0.00,0.00,0,0,0,0,0,0,0,0,0,0,0,0,0
20200212,03781P,智邦凱基93售03,,,,,0.00,0.00,0,0,0,0,0,0,0,0,0,0,0,0,0
20200212,03782P,聯發科凱基93售09,,,,,0.00,0.00,0,0,0,0,0,0,0,0,0,0,0,0,0
20200212,037839,T50反1群益93購01,,,,,0.00,0.00,0,0,0,0,0,0,0,0,0,0,0,0,0
20200212,03783P,大立光凱基93售16,,,,,0.00,0.00,0,0,0,0,0,0,0,0,0,0,0,0,0
20200212,03784P,致伸凱基93售02,,,,,0.00,0.00,0,0,0,0,0,0,0,0,0,0,0,0,0
20200212,03785P,臻鼎凱基93售05,,,,,0.00,0.00,0,0,0,0,0,0,0,0,0,0,0,0,0
20200212,03786P,鴻海群益94售02,0.02,0.02,0.02,0.02,0.00,0.00,100000,2,2000,0,0,0,0,0,0,0,0,0,0
20200212,03787P,台積電群益94售02,,,,,0.00,0.00,0,0,0,0,0,0,0,0,0,0,0,0,0
20200212,03788P,聯發科群益94售02,0.15,0.15,0.13,0.15,-0.06,-28.57,75000,3,10150,0,0,0,0,0,0,55000,20000,35000,35000
20200212,03789P,臺股指群益93售01,,,,,0.00,0.00,0,0,0,0,0,0,0,0,0,0,0,0,0
20200212,03790P,臺股指群益93售02,,,,,0.00,0.00,0,0,0,0,0,0,0,0,0,0,0,0,0
20200212,03791P,臺股指群益93售03,,,,,0.00,0.00,0,0,0,0,0,0,0,0,0,0,0,0,0
20200212,03792P,台光電永豐93售01,,,,,0.00,0.00,0,0,0,0,0,0,0,0,0,0,0,0,0
20200212,03793P,超眾永豐93售01,,,,,0.00,0.00,0,0,0,0,0,0,0,0,0,0,0,0,0
20200212,03794P,臺股指永豐93售02,,,,,0.00,0.00,0,0,0,0,0,0,0,0,0,0,0,0,0
20200212,03795P,智邦元大93售03,,,,,0.00,0.00,0,0,0,0,0,0,0,0,0,0,0,0,0
20200212,03796P,宏碁元大93售01,,,,,0.00,0.00,0,0,0,0,0,0,0,0,0,0,0,0,0
20200212,03797P,瑞昱元大93售06,,,,,0.00,0.00,0,0,0,0,0,0,0,0,0,0,0,0,0
20200212,03798P,台光電元大93售02,,,,,0.00,0.00,0,0,0,0,0,0,0,0,0,0,0,0,0
20200212,03799P,京元電元大94售01,0.82,0.82,0.82,0.82,-0.21,-20.39,100000,1,82000,0,0,0,0,0,0,100000,0,100000,100000
20200212,03800P,景碩元大93售01,,,,,0.00,0.00,0,0,0,0,0,0,0,0,0,0,0,0,0
20200212,03801P,智伸科元大93售02,,,,,0.00,0.00,0,0,0,0,0,0,0,0,0,0,0,0,0
20200212,03802P,GIS元大93售07,,,,,0.00,0.00,0,0,0,0,0,0,0,0,0,0,0,0,0
20200212,03803P,瑞昱統一93售03,,,,,0.00,0.00,0,0,0,0,0,0,0,0,0,0,0,0,0
20200212,03804P,聯發科統一93售01,,,,,0.00,0.00,0,0,0,0,0,0,0,0,0,0,0,0,0
20200212,03805P,可成元富93售02,,,,,0.00,0.00,0,0,0,0,0,0,0,0,0,0,0,0,0
20200212,03806P,聯詠元富93售02,,,,,0.00,0.00,0,0,0,0,0,0,0,0,0,0,0,0,0
20200212,03807P,康友元富93售02,,,,,0.00,0.00,0,0,0,0,0,0,0,0,0,0,0,0,0
20200212,03808P,旺宏國泰94售02,,,,,0.00,0.00,0,0,0,0,0,0,0,0,0,0,0,0,0
20200212,038095,T50反1群益93購02,,,,,0.00,0.00,0,0,0,0,0,0,0,0,0,0,0,0,0
20200212,03809P,鴻海永昌93售04,,,,,0.00,0.00,0,0,0,0,0,0,0,0,0,0,0,0,0
20200212,03810P,大立光富邦98售01,,,,,0.00,0.00,0,0,0,0,0,0,0,0,0,0,0,0,0
20200212,03811P,鴻海群益93售06,,,,,0.00,0.00,0,0,0,0,0,0,0,0,0,0,0,0,0
20200212,03812P,國巨群益93售04,,,,,0.00,0.00,0,0,0,0,0,0,0,0,0,0,0,0,0
20200212,03813P,可成麥證93售02,,,,,0.00,0.00,0,0,0,0,0,0,0,0,0,0,0,0,0
20200212,03814P,鴻海凱基93售22,,,,,0.00,0.00,0,0,0,0,0,0,0,0,0,0,0,0,0
20200212,03815P,嘉聯益凱基93售03,,,,,0.00,0.00,0,0,0,0,0,0,0,0,0,0,0,0,0
20200212,03816P,GIS凱基93售03,,,,,0.00,0.00,0,0,0,0,0,0,0,0,0,0,0,0,0
20200212,03817P,台積電永豐93售02,,,,,0.00,0.00,0,0,0,0,0,0,0,0,0,0,0,0,0
20200212,03818P,智易永豐93售01,,,,,0.00,0.00,0,0,0,0,0,0,0,0,0,0,0,0,0
20200212,03819P,聯詠統一93售03,,,,,0.00,0.00,0,0,0,0,0,0,0,0,0,0,0,0,0
20200212,03820P,聯詠統一93售04,,,,,0.00,0.00,0,0,0,0,0,0,0,0,0,0,0,0,0
20200212,03821P,上海銀統一95售01,0.65,0.65,0.64,0.64,-0.02,-3.03,60000,53,38460,0,0,0,0,0,0,60000,0,60000,60000
20200212,03822P,創意元富93售02,,,,,0.00,0.00,0,0,0,0,0,0,0,0,0,0,0,0,0
20200212,03823P,嘉澤元富93售01,0.05,0.05,0.05,0.05,0.00,0.00,10000,1,500,0,0,0,0,0,0,10000,0,10000,10000
20200212,03824P,燿華元大94售01,,,,,0.00,0.00,0,0,0,0,0,0,0,0,0,0,0,0,0
20200212,03825P,聯詠元大93售02,,,,,0.00,0.00,0,0,0,0,0,0,0,0,0,0,0,0,0
20200212,03826P,瀚宇博元大95售01,1.22,1.22,1.19,1.19,-0.04,-3.25,74000,2,88960,0,0,0,0,0,0,0,74000,-74000,-74000
20200212,03827P,矽創國票94售01,0.51,0.51,0.50,0.50,-0.21,-29.58,18000,16,9150,0,0,0,0,0,0,18000,0,18000,18000
20200212,03828P,致茂中信95售01,0.64,0.64,0.62,0.62,-0.10,-13.89,65000,2,41500,0,0,0,0,0,0,0,65000,-65000,-65000
20200212,03829P,元大金中信95售01,,,,,0.00,0.00,0,0,0,0,0,0,0,0,0,0,0,0,0
20200212,03830P,緯創中信95售01,,,,,0.00,0.00,0,0,0,0,0,0,0,0,0,0,0,0,0
20200212,03831P,臺股指中信95售02,0.17,0.17,0.15,0.15,-0.03,-16.67,42000,4,6810,0,0,0,0,0,0,0,42000,-42000,-42000
20200212,03832P,臺股指中信95售03,0.15,0.15,0.15,0.15,-0.01,-6.25,3000,1,450,0,0,0,0,0,0,0,3000,-3000,-3000
20200212,03833P,台光電群益93售01,,,,,0.00,0.00,0,0,0,0,0,0,0,0,0,0,0,0,0
20200212,03834P,漢唐群益93售03,,,,,0.00,0.00,0,0,0,0,0,0,0,0,0,0,0,0,0
20200212,03835P,台郡永豐93售01,,,,,0.00,0.00,0,0,0,0,0,0,0,0,0,0,0,0,0
20200212,03836P,華泰凱基93售02,,,,,0.00,0.00,0,0,0,0,0,0,0,0,0,0,0,0,0
20200212,03837P,台積電凱基93售10,,,,,0.00,0.00,0,0,0,0,0,0,0,0,0,0,0,0,0
20200212,03838P,臺股指凱基93售03,,,,,0.00,0.00,0,0,0,0,0,0,0,0,0,0,0,0,0
20200212,03839P,華通統一93售02,0.05,0.05,0.02,0.02,-0.04,-66.67,200000,20,4300,0,0,0,0,0,0,0,200000,-200000,-200000
20200212,03840P,台積電統一99售02,0.25,0.28,0.25,0.26,-0.02,-7.14,2442000,62,626500,0,0,0,0,0,0,28000,936000,-908000,-908000
20200212,03841P,聯發科統一93售02,0.10,0.10,0.10,0.10,-0.11,-52.38,16000,16,1600,0,0,0,0,0,0,16000,0,16000,16000
20200212,03842P,鴻海元富93售02,,,,,0.00,0.00,0,0,0,0,0,0,0,0,0,0,0,0,0
20200212,03843P,台積電元富93售03,,,,,0.00,0.00,0,0,0,0,0,0,0,0,0,0,0,0,0
20200212,03844P,康友元富93售03,,,,,0.00,0.00,0,0,0,0,0,0,0,0,0,0,0,0,0
20200212,038455,群臺反群益94購01,,,,,0.00,0.00,0,0,0,0,0,0,0,0,0,0,0,0,0
20200212,03845P,台積電元大93售13,,,,,0.00,0.00,0,0,0,0,0,0,0,0,0,0,0,0,0
20200212,03846P,旺宏元大93售05,,,,,0.00,0.00,0,0,0,0,0,0,0,0,0,0,0,0,0
20200212,03847P,大立光元大93售18,,,,,0.00,0.00,0,0,0,0,0,0,0,0,0,0,0,0,0
20200212,038489,T50反1台新9A購01,0.12,0.12,0.10,0.12,0.00,0.00,302000,6,34240,0,0,0,0,0,0,0,121000,-121000,-121000
20200212,03848P,聯發科群益93售06,,,,,0.00,0.00,0,0,0,0,0,0,0,0,0,0,0,0,0
20200212,03849P,大成鋼凱基93售03,,,,,0.00,0.00,0,0,0,0,0,0,0,0,0,0,0,0,0
20200212,03850P,鴻海凱基93售25,,,,,0.00,0.00,0,0,0,0,0,0,0,0,0,0,0,0,0
20200212,03851P,台積電凱基93售11,,,,,0.00,0.00,0,0,0,0,0,0,0,0,0,0,0,0,0
20200212,03852P,華邦電凱基93售05,0.76,0.76,0.74,0.74,-0.19,-20.43,6000,6,4480,0,0,0,0,0,0,6000,0,6000,6000
20200212,03853P,可成凱基93售04,,,,,0.00,0.00,0,0,0,0,0,0,0,0,0,0,0,0,0
20200212,03854P,群創兆豐93售02,,,,,0.00,0.00,0,0,0,0,0,0,0,0,0,0,0,0,0
20200212,03855P,大立光台新93售01,,,,,0.00,0.00,0,0,0,0,0,0,0,0,0,0,0,0,0
20200212,03856P,易華電永豐93售01,,,,,0.00,0.00,0,0,0,0,0,0,0,0,0,0,0,0,0
20200212,03857P,聯發科元富99售02,0.39,0.39,0.36,0.36,-0.08,-18.18,571000,14,207210,0,0,0,0,0,0,331000,238000,93000,93000
20200212,03858P,可成元富93售04,,,,,0.00,0.00,0,0,0,0,0,0,0,0,0,0,0,0,0
20200212,03859P,聯詠元富93售04,,,,,0.00,0.00,0,0,0,0,0,0,0,0,0,0,0,0,0
20200212,03860P,群創元富97售01,,,,,0.00,0.00,0,0,0,0,0,0,0,0,0,0,0,0,0
20200212,03861P,群創元富99售01,,,,,0.00,0.00,0,0,0,0,0,0,0,0,0,0,0,0,0
20200212,03862P,台積電麥證93售02,,,,,0.00,0.00,0,0,0,0,0,0,0,0,0,0,0,0,0
20200212,03863P,臺股指麥證93售01,,,,,0.00,0.00,0,0,0,0,0,0,0,0,0,0,0,0,0
20200212,03864P,台積電元大93售15,,,,,0.00,0.00,0,0,0,0,0,0,0,0,0,0,0,0,0
20200212,03865P,聯發科元大93售09,,,,,0.00,0.00,0,0,0,0,0,0,0,0,0,0,0,0,0
20200212,03866P,聯發科元大93售10,,,,,0.00,0.00,0,0,0,0,0,0,0,0,0,0,0,0,0
20200212,03867P,樺漢元大93售02,,,,,0.00,0.00,0,0,0,0,0,0,0,0,0,0,0,0,0
20200212,03868P,統一凱基93售02,0.32,0.32,0.32,0.32,-0.01,-3.03,1000,1,320,0,0,0,0,0,0,1000,0,1000,1000
20200212,03869P,和大群益93售02,,,,,0.00,0.00,0,0,0,0,0,0,0,0,0,0,0,0,0
20200212,03870P,台積電群益93售06,0.01,0.01,0.01,0.01,0.00,0.00,105000,7,1050,0,0,0,0,0,0,0,0,0,0
20200212,03871P,智邦群益93售02,0.18,0.20,0.18,0.19,0.00,0.00,50000,5,9400,0,0,0,0,0,0,0,50000,-50000,-50000
20200212,03872P,聯詠群益93售02,,,,,0.00,0.00,0,0,0,0,0,0,0,0,0,0,0,0,0
20200212,03873P,智伸科群益93售03,,,,,0.00,0.00,0,0,0,0,0,0,0,0,0,0,0,0,0
20200212,03874P,臺股指群益95售01,0.24,0.24,0.20,0.21,-0.06,-22.22,223000,13,48590,0,0,0,0,0,0,20000,203000,-183000,-183000
20200212,03875P,滬深2X國票05售01,0.76,0.76,0.75,0.75,+0.01,1.35,260000,2,195600,0,0,0,0,0,0,260000,0,260000,260000
20200212,03876P,台積電國票93售04,,,,,0.00,0.00,0,0,0,0,0,0,0,0,0,0,0,0,0
20200212,03877P,台光電國票94售01,,,,,0.00,0.00,0,0,0,0,0,0,0,0,0,0,0,0,0
20200212,03878P,康控國票93售01,,,,,0.00,0.00,0,0,0,0,0,0,0,0,0,0,0,0,0
20200212,03879P,智邦永豐93售01,,,,,0.00,0.00,0,0,0,0,0,0,0,0,0,0,0,0,0
20200212,03880P,華新科永豐93售01,,,,,0.00,0.00,0,0,0,0,0,0,0,0,0,0,0,0,0
20200212,03881P,易華電永豐93售02,,,,,0.00,0.00,0,0,0,0,0,0,0,0,0,0,0,0,0
20200212,03882P,鴻海元大93售10,0.16,0.16,0.13,0.13,-0.10,-43.48,1842000,11,289800,0,0,0,0,0,0,1741000,1501000,240000,240000
20200212,03883P,鴻海元大93售11,,,,,0.00,0.00,0,0,0,0,0,0,0,0,0,0,0,0,0
20200212,03884P,大立光元大93售21,,,,,0.00,0.00,0,0,0,0,0,0,0,0,0,0,0,0,0
20200212,03885P,華新科統一96售01,,,,,0.00,0.00,0,0,0,0,0,0,0,0,0,0,0,0,0
20200212,03886P,國泰金元富93售01,,,,,0.00,0.00,0,0,0,0,0,0,0,0,0,0,0,0,0
20200212,03887P,大立光元富93售02,,,,,0.00,0.00,0,0,0,0,0,0,0,0,0,0,0,0,0
20200212,03888P,大立光元富93售03,,,,,0.00,0.00,0,0,0,0,0,0,0,0,0,0,0,0,0
20200212,03889P,國巨國泰94售04,,,,,0.00,0.00,0,0,0,0,0,0,0,0,0,0,0,0,0
20200212,03890P,聯詠國泰94售02,0.15,0.15,0.15,0.15,-0.03,-16.67,46000,5,6900,0,0,0,0,0,0,0,46000,-46000,-46000
20200212,03891P,晶技國泰94售02,0.50,0.50,0.50,0.50,0.00,0.00,20000,1,10000,0,0,0,0,0,0,0,20000,-20000,-20000
20200212,03892P,元油2X中信95售01,1.54,1.54,1.53,1.53,-0.04,-2.55,20000,2,30700,0,0,0,0,0,0,20000,20000,0,0
20200212,03893P,為升凱基93售03,,,,,0.00,0.00,0,0,0,0,0,0,0,0,0,0,0,0,0
20200212,03894P,鴻海凱基94售05,,,,,0.00,0.00,0,0,0,0,0,0,0,0,0,0,0,0,0
20200212,03895P,聯發科凱基93售11,,,,,0.00,0.00,0,0,0,0,0,0,0,0,0,0,0,0,0
20200212,03896P,長榮航凱基95售01,1.96,1.96,1.92,1.93,-0.07,-3.5,189000,22,366260,0,0,0,0,0,0,110000,55000,55000,55000
20200212,03897P,聯詠凱基93售01,,,,,0.00,0.00,0,0,0,0,0,0,0,0,0,0,0,0,0
20200212,03898P,新日興凱基93售02,,,,,0.00,0.00,0,0,0,0,0,0,0,0,0,0,0,0,0
20200212,03899P,滬深2X群益95售03,1.03,1.03,1.03,1.03,-0.01,-0.96,10000,2,10300,0,0,0,0,0,0,0,10000,-10000,-10000
20200212,03900P,瀚宇博群益93售03,,,,,0.00,0.00,0,0,0,0,0,0,0,0,0,0,0,0,0
20200212,03901P,台積電國票93售05,,,,,0.00,0.00,0,0,0,0,0,0,0,0,0,0,0,0,0
20200212,03902P,義隆國票94售01,,,,,0.00,0.00,0,0,0,0,0,0,0,0,0,0,0,0,0
20200212,03903P,美律永豐93售01,,,,,0.00,0.00,0,0,0,0,0,0,0,0,0,0,0,0,0
20200212,03904P,啟碁統一93售01,1.59,1.61,1.59,1.59,-0.13,-7.56,19000,9,30350,0,0,0,0,0,0,7000,12000,-5000,-5000
20200212,03905P,華通元富93售01,,,,,0.00,0.00,0,0,0,0,0,0,0,0,0,0,0,0,0
20200212,03906P,漢唐元富93售01,,,,,0.00,0.00,0,0,0,0,0,0,0,0,0,0,0,0,0
20200212,03907P,易華電國泰94售03,,,,,0.00,0.00,0,0,0,0,0,0,0,0,0,0,0,0,0
20200212,03908P,致茂元大93售03,0.59,0.59,0.59,0.59,0.00,0.00,50000,1,29500,0,0,0,0,0,0,0,50000,-50000,-50000
20200212,03909P,奇鋐元大93售04,,,,,0.00,0.00,0,0,0,0,0,0,0,0,0,0,0,0,0
20200212,03910P,GIS元大93售09,,,,,0.00,0.00,0,0,0,0,0,0,0,0,0,0,0,0,0
20200212,03911P,臺股指元大93售35,,,,,0.00,0.00,0,0,0,0,0,0,0,0,0,0,0,0,0
20200212,03912P,臺股指元大93售36,0.11,0.11,0.11,0.11,0.00,0.00,10000,1,1100,0,0,0,0,0,0,0,10000,-10000,-10000
20200212,03913P,臺股指元大93售37,0.09,0.09,0.09,0.09,0.00,0.00,10000,1,900,0,0,0,0,0,0,0,10000,-10000,-10000
20200212,03914P,臺股指元大93售38,,,,,0.00,0.00,0,0,0,0,0,0,0,0,0,0,0,0,0
20200212,03915P,金融類元大93售01,,,,,0.00,0.00,0,0,0,0,0,0,0,0,0,0,0,0,0
20200212,03916P,亞德客凱基93售03,,,,,0.00,0.00,0,0,0,0,0,0,0,0,0,0,0,0,0
20200212,03917P,鴻海凱基94售07,0.08,0.08,0.08,0.08,-0.05,-38.46,200000,1,16000,0,0,0,0,0,0,200000,0,200000,200000
20200212,03918P,國巨凱基93售05,,,,,0.00,0.00,0,0,0,0,0,0,0,0,0,0,0,0,0
20200212,03919P,可成凱基93售07,,,,,0.00,0.00,0,0,0,0,0,0,0,0,0,0,0,0,0
20200212,03920P,大立光凱基93售20,,,,,0.00,0.00,0,0,0,0,0,0,0,0,0,0,0,0,0
20200212,039212,台達電台新9A購01,1.06,1.15,1.06,1.15,+0.06,5.5,119000,6,129450,0,0,0,0,0,0,1000,118000,-117000,-117000
20200212,03921P,亞光凱基94售01,0.79,0.79,0.77,0.77,-0.12,-13.48,80000,3,62300,0,0,0,0,0,0,0,80000,-80000,-80000
20200212,03922P,中磊凱基93售01,,,,,0.00,0.00,0,0,0,0,0,0,0,0,0,0,0,0,0
20200212,03923P,台積電群益93售07,,,,,0.00,0.00,0,0,0,0,0,0,0,0,0,0,0,0,0
20200212,03924P,聯發科群益93售07,,,,,0.00,0.00,0,0,0,0,0,0,0,0,0,0,0,0,0
20200212,03925P,大立光群益93售08,,,,,0.00,0.00,0,0,0,0,0,0,0,0,0,0,0,0,0
20200212,03926P,麗豐元大93售02,,,,,0.00,0.00,0,0,0,0,0,0,0,0,0,0,0,0,0
20200212,03927P,旺宏台新94售01,,,,,0.00,0.00,0,0,0,0,0,0,0,0,0,0,0,0,0
20200212,03928P,鎧勝康和93售01,,,,,0.00,0.00,0,0,0,0,0,0,0,0,0,0,0,0,0
20200212,03929P,元油2X永豐93售04,,,,,0.00,0.00,0,0,0,0,0,0,0,0,0,0,0,0,0
20200212,03930P,華通永豐93售02,,,,,0.00,0.00,0,0,0,0,0,0,0,0,0,0,0,0,0
20200212,039319,華新科國泰92購01,,,,,0.00,0.00,0,0,0,0,0,0,0,0,0,0,0,0,0
20200212,03931P,聯發科永豐93售02,,,,,0.00,0.00,0,0,0,0,0,0,0,0,0,0,0,0,0
20200212,03932P,欣興統一93售01,0.53,0.53,0.53,0.53,-0.23,-30.26,53000,3,28090,0,0,0,0,0,0,0,53000,-53000,-53000
20200212,03933P,台積電永昌93售06,,,,,0.00,0.00,0,0,0,0,0,0,0,0,0,0,0,0,0
20200212,03934P,大立光永昌93售06,,,,,0.00,0.00,0,0,0,0,0,0,0,0,0,0,0,0,0
20200212,03935P,可成富邦95售01,0.51,0.51,0.51,0.51,0.00,0.00,5000,1,2550,0,0,0,0,0,0,0,5000,-5000,-5000
20200212,03936P,上銀元大93售06,,,,,0.00,0.00,0,0,0,0,0,0,0,0,0,0,0,0,0
20200212,03937P,聯詠元大93售08,,,,,0.00,0.00,0,0,0,0,0,0,0,0,0,0,0,0,0
20200212,039382,聯發科國泰92購01,,,,,0.00,0.00,0,0,0,0,0,0,0,0,0,0,0,0,0
20200212,03938P,聯鈞元大93售01,,,,,0.00,0.00,0,0,0,0,0,0,0,0,0,0,0,0,0
20200212,03939P,康控元大95售02,0.65,0.65,0.65,0.65,0.00,0.00,1000,1,650,0,0,0,0,0,0,1000,0,1000,1000
20200212,03940P,訊芯元大93售05,,,,,0.00,0.00,0,0,0,0,0,0,0,0,0,0,0,0,0
20200212,03941P,電子類元大93售01,,,,,0.00,0.00,0,0,0,0,0,0,0,0,0,0,0,0,0
20200212,03942P,電子類元大93售02,,,,,0.00,0.00,0,0,0,0,0,0,0,0,0,0,0,0,0
20200212,03943P,可成群益93售01,0.32,0.32,0.32,0.32,0.00,0.00,5000,1,1600,0,0,0,0,0,0,0,5000,-5000,-5000
20200212,03944P,聯詠群益93售03,,,,,0.00,0.00,0,0,0,0,0,0,0,0,0,0,0,0,0
20200212,03945P,欣興群益94售01,0.93,0.93,0.81,0.81,-0.24,-22.86,363000,11,320000,0,0,0,0,0,0,62000,301000,-239000,-239000
20200212,03946P,麗豐群益93售02,0.69,0.69,0.68,0.68,-0.15,-18.07,60000,22,41210,0,0,0,0,0,0,60000,0,60000,60000
20200212,03947P,新光金國泰94售01,0.41,0.41,0.41,0.41,0.00,0.00,24000,1,9840,0,0,0,0,0,0,0,24000,-24000,-24000
20200212,03948P,台積電中信93售02,,,,,0.00,0.00,0,0,0,0,0,0,0,0,0,0,0,0,0
20200212,03949P,旺宏中信93售01,,,,,0.00,0.00,0,0,0,0,0,0,0,0,0,0,0,0,0
20200212,03950P,聯發科中信93售03,,,,,0.00,0.00,0,0,0,0,0,0,0,0,0,0,0,0,0
20200212,03951P,新光金凱基95售01,,,,,0.00,0.00,0,0,0,0,0,0,0,0,0,0,0,0,0
20200212,03952P,晶技凱基93售02,,,,,0.00,0.00,0,0,0,0,0,0,0,0,0,0,0,0,0
20200212,03953P,易華電凱基94售01,2.47,2.47,2.47,2.47,-0.04,-1.59,15000,1,37050,0,0,0,0,0,0,15000,0,15000,15000
20200212,03954P,臺股指凱基93售05,,,,,0.00,0.00,0,0,0,0,0,0,0,0,0,0,0,0,0
20200212,039550,滬深反凱基94購01,0.13,0.14,0.12,0.12,0.00,0.00,152000,3,18270,0,0,0,0,0,0,150000,2000,148000,148000
20200212,03955P,華通統一93售04,0.07,0.07,0.07,0.07,-0.05,-41.67,2000,1,140,0,0,0,0,0,0,0,2000,-2000,-2000
20200212,03956P,欣興統一93售02,0.88,0.88,0.68,0.68,-0.27,-28.42,151000,12,126300,0,0,0,0,0,0,50000,101000,-51000,-51000
20200212,03957P,創意統一94售02,0.63,0.63,0.63,0.63,0.00,0.00,2000,2,1260,0,0,0,0,0,0,0,2000,-2000,-2000
20200212,03958P,嘉聯益統一93售01,0.58,0.58,0.57,0.57,-0.07,-10.94,220000,49,126400,0,0,0,0,0,0,120000,100000,20000,20000
20200212,03959P,義隆元富96售01,1.12,1.17,1.12,1.14,-0.17,-12.98,106000,15,122050,0,0,0,0,0,0,10000,96000,-86000,-86000
20200212,03960P,新日興元富96售02,0.88,0.91,0.86,0.90,+0.01,1.12,170000,10,152000,0,0,0,0,0,0,124000,46000,78000,78000
20200212,03961P,GIS元富93售04,,,,,0.00,0.00,0,0,0,0,0,0,0,0,0,0,0,0,0
20200212,03962P,聯發科台新93售02,,,,,0.00,0.00,0,0,0,0,0,0,0,0,0,0,0,0,0
20200212,03963P,啟碁康和93售01,,,,,0.00,0.00,0,0,0,0,0,0,0,0,0,0,0,0,0
20200212,03964P,國巨永豐93售03,,,,,0.00,0.00,0,0,0,0,0,0,0,0,0,0,0,0,0
20200212,03965P,上銀國票94售01,,,,,0.00,0.00,0,0,0,0,0,0,0,0,0,0,0,0,0
20200212,03966P,台積電國票93售06,0.02,0.02,0.02,0.02,0.00,0.00,10000,10,200,0,0,0,0,0,0,0,0,0,0
20200212,03967P,聯發科國票93售04,,,,,0.00,0.00,0,0,0,0,0,0,0,0,0,0,0,0,0
20200212,03968P,聯發科國票93售05,,,,,0.00,0.00,0,0,0,0,0,0,0,0,0,0,0,0,0
20200212,03969P,華新科國票94售01,,,,,0.00,0.00,0,0,0,0,0,0,0,0,0,0,0,0,0
20200212,03970P,奇鋐國票93售01,1.34,1.34,1.34,1.34,0.00,0.00,27000,1,36180,0,0,0,0,0,0,0,27000,-27000,-27000
20200212,03971P,智邦亞東93售01,,,,,0.00,0.00,0,0,0,0,0,0,0,0,0,0,0,0,0
20200212,03972P,可成元大93售07,0.27,0.27,0.27,0.27,0.00,0.00,5000,1,1350,0,0,0,0,0,0,0,5000,-5000,-5000
20200212,03973P,高鐵元大93售01,0.45,0.46,0.41,0.41,-0.04,-8.89,96000,4,42600,0,0,0,0,0,0,0,96000,-96000,-96000
20200212,03974P,大立光元大93售25,,,,,0.00,0.00,0,0,0,0,0,0,0,0,0,0,0,0,0
20200212,03975P,大立光元大94售02,,,,,0.00,0.00,0,0,0,0,0,0,0,0,0,0,0,0,0
20200212,03976P,智原元大93售02,,,,,0.00,0.00,0,0,0,0,0,0,0,0,0,0,0,0,0
20200212,03977P,上海銀元大93售01,,,,,0.00,0.00,0,0,0,0,0,0,0,0,0,0,0,0,0
20200212,03978P,瑞儀元大93售01,1.45,1.46,1.45,1.46,0.00,0.00,110000,3,159600,0,0,0,0,0,0,0,110000,-110000,-110000
20200212,03979P,台積電凱基93售16,,,,,0.00,0.00,0,0,0,0,0,0,0,0,0,0,0,0,0
20200212,03980P,群創凱基95售02,,,,,0.00,0.00,0,0,0,0,0,0,0,0,0,0,0,0,0
20200212,03981P,嘉澤凱基93售02,,,,,0.00,0.00,0,0,0,0,0,0,0,0,0,0,0,0,0
20200212,03982P,智易國票94售02,,,,,0.00,0.00,0,0,0,0,0,0,0,0,0,0,0,0,0
20200212,03983P,健策國票93售01,,,,,0.00,0.00,0,0,0,0,0,0,0,0,0,0,0,0,0
20200212,03984P,上銀群益93售05,,,,,0.00,0.00,0,0,0,0,0,0,0,0,0,0,0,0,0
20200212,03985P,聯發科群益93售09,,,,,0.00,0.00,0,0,0,0,0,0,0,0,0,0,0,0,0
20200212,03986P,大立光群益93售10,,,,,0.00,0.00,0,0,0,0,0,0,0,0,0,0,0,0,0
20200212,03987P,亞光群益93售02,,,,,0.00,0.00,0,0,0,0,0,0,0,0,0,0,0,0,0
20200212,03988P,上海銀群益93售01,,,,,0.00,0.00,0,0,0,0,0,0,0,0,0,0,0,0,0
20200212,03989P,同欣電群益93售02,,,,,0.00,0.00,0,0,0,0,0,0,0,0,0,0,0,0,0
20200212,039900,上証2X國泰92購01,,,,,0.00,0.00,0,0,0,0,0,0,0,0,0,0,0,0,0
20200212,039901,國巨國泰92購01,5.95,5.95,5.95,5.95,0.00,0.00,5000,1,29750,0,0,0,0,0,0,5000,0,5000,5000
20200212,039908,元油反富邦92購01,,,,,0.00,0.00,0,0,0,0,0,0,0,0,0,0,0,0,0
20200212,03990P,嘉澤永豐93售01,,,,,0.00,0.00,0,0,0,0,0,0,0,0,0,0,0,0,0
20200212,03991P,台積電統一93售03,,,,,0.00,0.00,0,0,0,0,0,0,0,0,0,0,0,0,0
20200212,03992P,臺股指統一93售06,,,,,0.00,0.00,0,0,0,0,0,0,0,0,0,0,0,0,0
20200212,03993P,滬深2X中信94售03,,,,,0.00,0.00,0,0,0,0,0,0,0,0,0,0,0,0,0
20200212,03994P,台積電中信93售03,,,,,0.00,0.00,0,0,0,0,0,0,0,0,0,0,0,0,0
20200212,03995P,滬深2X國泰95售01,1.49,1.49,1.49,1.49,0.00,0.00,90000,1,134100,0,0,0,0,0,0,90000,0,90000,90000
20200212,03996P,旺宏國泰95售01,,,,,0.00,0.00,0,0,0,0,0,0,0,0,0,0,0,0,0
20200212,03997P,台郡群益93售03,,,,,0.00,0.00,0,0,0,0,0,0,0,0,0,0,0,0,0
20200212,03998P,GIS群益93售01,,,,,0.00,0.00,0,0,0,0,0,0,0,0,0,0,0,0,0
20200212,03999P,鴻海凱基94售11,0.15,0.15,0.12,0.12,-0.09,-42.86,350000,4,48500,0,0,0,0,0,0,0,350000,-350000,-350000
20200212,04000P,台積電凱基93售18,,,,,0.00,0.00,0,0,0,0,0,0,0,0,0,0,0,0,0
20200212,04001P,聯發科凱基93售15,,,,,0.00,0.00,0,0,0,0,0,0,0,0,0,0,0,0,0
20200212,04002P,大立光凱基93售23,,,,,0.00,0.00,0,0,0,0,0,0,0,0,0,0,0,0,0
20200212,04003P,麗豐凱基94售03,,,,,0.00,0.00,0,0,0,0,0,0,0,0,0,0,0,0,0
20200212,04004P,智伸科凱基93售06,,,,,0.00,0.00,0,0,0,0,0,0,0,0,0,0,0,0,0
20200212,04005P,樺漢凱基93售02,,,,,0.00,0.00,0,0,0,0,0,0,0,0,0,0,0,0,0
20200212,04006P,滬深2X國票9B售01,,,,,0.00,0.00,0,0,0,0,0,0,0,0,0,0,0,0,0
20200212,04007P,國巨國票93售03,0.01,0.01,0.01,0.01,0.00,0.00,56000,1,560,0,0,0,0,0,0,56000,0,56000,56000
20200212,04008P,京元電國票93售01,,,,,0.00,0.00,0,0,0,0,0,0,0,0,0,0,0,0,0
20200212,04009P,可成國票93售03,,,,,0.00,0.00,0,0,0,0,0,0,0,0,0,0,0,0,0
20200212,04010P,上銀元大93售07,,,,,0.00,0.00,0,0,0,0,0,0,0,0,0,0,0,0,0
20200212,04011P,台積電元大93售22,,,,,0.00,0.00,0,0,0,0,0,0,0,0,0,0,0,0,0
20200212,04012P,台積電元大93售23,,,,,0.00,0.00,0,0,0,0,0,0,0,0,0,0,0,0,0
20200212,04013P,漢唐元大93售05,,,,,0.00,0.00,0,0,0,0,0,0,0,0,0,0,0,0,0
20200212,04014P,聯發科元大93售18,0.42,0.42,0.42,0.42,-0.12,-22.22,300000,1,126000,0,0,0,0,0,0,300000,300000,0,0
20200212,04015P,可成元大93售10,0.46,0.46,0.39,0.39,-0.18,-31.58,1371000,17,601660,0,0,0,0,0,0,845000,526000,319000,319000
20200212,040160,SP黃豆元富95購01,0.28,0.28,0.28,0.28,-0.03,-9.68,1627000,9,455560,0,0,0,0,0,0,1627000,0,1627000,1627000
20200212,04016P,台積電兆豐93售06,,,,,0.00,0.00,0,0,0,0,0,0,0,0,0,0,0,0,0
20200212,04017P,臺股指麥證93售02,,,,,0.00,0.00,0,0,0,0,0,0,0,0,0,0,0,0,0
20200212,04018P,亞光永豐93售01,0.35,0.35,0.35,0.35,0.00,0.00,7000,1,2450,0,0,0,0,0,0,0,7000,-7000,-7000
20200212,04019P,聯茂永豐93售01,0.43,0.43,0.30,0.30,-0.22,-42.31,381000,8,142510,0,0,0,0,0,0,82000,299000,-217000,-217000
20200212,04020P,南茂永豐93售02,,,,,0.00,0.00,0,0,0,0,0,0,0,0,0,0,0,0,0
20200212,040215,上証反凱基95購01,0.14,0.16,0.14,0.14,-0.01,-6.67,315000,3,49720,0,0,0,0,0,0,34000,281000,-247000,-247000
20200212,04021P,寶滬深元富93售01,0.51,0.51,0.49,0.49,-0.10,-16.95,80000,3,39500,0,0,0,0,0,0,80000,0,80000,80000
20200212,04022P,群創元富96售04,,,,,0.00,0.00,0,0,0,0,0,0,0,0,0,0,0,0,0
20200212,04023P,臺股指元富99售02,0.32,0.32,0.30,0.30,-0.03,-9.09,830000,15,256750,0,0,0,0,0,0,10000,820000,-810000,-810000
20200212,04024P,志超康和93售01,,,,,0.00,0.00,0,0,0,0,0,0,0,0,0,0,0,0,0
20200212,04025P,宏達電國泰94售01,0.81,0.81,0.80,0.80,-0.06,-6.98,139000,20,112200,0,0,0,0,0,0,39000,100000,-61000,-61000
20200212,04026P,燿華國票93售01,,,,,0.00,0.00,0,0,0,0,0,0,0,0,0,0,0,0,0
20200212,04027P,亞德客凱基93售05,,,,,0.00,0.00,0,0,0,0,0,0,0,0,0,0,0,0,0
20200212,04028P,燿華凱基94售02,0.87,0.88,0.87,0.88,0.00,0.00,50000,2,43900,0,0,0,0,0,0,0,50000,-50000,-50000
20200212,04029P,聯發科凱基93售16,,,,,0.00,0.00,0,0,0,0,0,0,0,0,0,0,0,0,0
20200212,04030P,聯發科凱基93售19,,,,,0.00,0.00,0,0,0,0,0,0,0,0,0,0,0,0,0
20200212,04031P,聯發科凱基93售20,,,,,0.00,0.00,0,0,0,0,0,0,0,0,0,0,0,0,0
20200212,04032P,聯茂凱基94售02,1.44,1.44,1.44,1.44,-0.12,-7.69,36000,1,51840,0,0,0,0,0,0,36000,0,36000,36000
20200212,04033P,啟碁凱基93售04,4.12,4.15,4.12,4.15,-0.30,-6.74,4000,4,16540,0,0,0,0,0,0,4000,0,4000,4000
20200212,04034P,技嘉群益93售03,0.31,0.31,0.31,0.31,-0.04,-11.43,118000,3,36580,0,0,0,0,0,0,118000,0,118000,118000
20200212,04035P,全新群益93售03,0.25,0.25,0.18,0.18,-0.13,-41.94,410000,19,86300,0,0,0,0,0,0,0,410000,-410000,-410000
20200212,04036P,臻鼎群益93售03,,,,,0.00,0.00,0,0,0,0,0,0,0,0,0,0,0,0,0
20200212,04037P,中磊群益93售02,,,,,0.00,0.00,0,0,0,0,0,0,0,0,0,0,0,0,0
20200212,040380,SP黃豆元富95購02,,,,,0.00,0.00,0,0,0,0,0,0,0,0,0,0,0,0,0
20200212,040381,元金2X元富95購01,,,,,0.00,0.00,0,0,0,0,0,0,0,0,0,0,0,0,0
20200212,04038P,聯茂群益93售03,1.58,1.58,1.36,1.36,-0.41,-23.16,2000,2,2940,0,0,0,0,0,0,2000,0,2000,2000
20200212,04039P,台積電統一93售04,,,,,0.00,0.00,0,0,0,0,0,0,0,0,0,0,0,0,0
20200212,04040P,大立光統一93售09,,,,,0.00,0.00,0,0,0,0,0,0,0,0,0,0,0,0,0
20200212,04041P,大立光統一94售03,,,,,0.00,0.00,0,0,0,0,0,0,0,0,0,0,0,0,0
20200212,04042P,臺股指統一93售07,,,,,0.00,0.00,0,0,0,0,0,0,0,0,0,0,0,0,0
20200212,04043P,復盛元富93售02,0.52,0.56,0.52,0.56,-0.01,-1.75,78000,5,41680,0,0,0,0,0,0,0,78000,-78000,-78000
20200212,04044P,鴻海元大93售18,0.03,0.03,0.03,0.03,0.00,0.00,100000,10,3000,0,0,0,0,0,0,0,100000,-100000,-100000
20200212,04045P,鴻海元大93售19,,,,,0.00,0.00,0,0,0,0,0,0,0,0,0,0,0,0,0
20200212,04046P,台積電元大93售24,0.01,0.01,0.01,0.01,0.00,0.00,1000,1,10,0,0,0,0,0,0,1000,0,1000,1000
20200212,04047P,華邦電元大94售03,1.95,1.95,1.95,1.95,0.00,0.00,2000,1,3900,0,0,0,0,0,0,2000,0,2000,2000
20200212,04048P,大立光元大93售26,,,,,0.00,0.00,0,0,0,0,0,0,0,0,0,0,0,0,0
20200212,04049P,大立光元大95售02,0.54,0.54,0.48,0.48,-0.08,-14.29,1462000,47,731660,0,0,0,0,0,0,107000,1342000,-1235000,-1235000
20200212,040508,上証2X國泰93購01,,,,,0.00,0.00,0,0,0,0,0,0,0,0,0,0,0,0,0
20200212,04050P,創意元大93售05,0.42,0.42,0.40,0.40,0.00,0.00,150000,7,62000,0,0,0,0,0,0,0,150000,-150000,-150000
20200212,04051P,友達中信94售02,,,,,0.00,0.00,0,0,0,0,0,0,0,0,0,0,0,0,0
20200212,04052P,上銀國泰94售01,0.36,0.36,0.36,0.36,-0.03,-7.69,2000,1,720,0,0,0,0,0,0,2000,0,2000,2000
20200212,04053P,聯茂國泰94售01,1.46,1.46,1.29,1.29,0.00,0.00,72000,3,101380,0,0,0,0,0,0,70000,2000,68000,68000
20200212,04054P,滬深2X富邦96售02,2.69,2.69,2.69,2.69,0.00,0.00,6000,1,16140,0,0,0,0,0,0,6000,0,6000,6000
20200212,04055P,奇力新群益93售04,,,,,0.00,0.00,0,0,0,0,0,0,0,0,0,0,0,0,0
20200212,04056P,臺股指群益93售10,,,,,0.00,0.00,0,0,0,0,0,0,0,0,0,0,0,0,0
20200212,040578,SP黃豆元富95購03,0.22,0.22,0.21,0.21,0.00,0.00,550000,3,119500,0,0,0,0,0,0,150000,400000,-250000,-250000
20200212,04057P,臺股指群益93售11,,,,,0.00,0.00,0,0,0,0,0,0,0,0,0,0,0,0,0
20200212,04058P,臺股指群益93售12,,,,,0.00,0.00,0,0,0,0,0,0,0,0,0,0,0,0,0
20200212,04059P,臺股指群益93售13,,,,,0.00,0.00,0,0,0,0,0,0,0,0,0,0,0,0,0
20200212,04060P,臺股指群益93售14,,,,,0.00,0.00,0,0,0,0,0,0,0,0,0,0,0,0,0
20200212,04061P,臺股指群益93售15,,,,,0.00,0.00,0,0,0,0,0,0,0,0,0,0,0,0,0
20200212,04062P,可成兆豐93售04,,,,,0.00,0.00,0,0,0,0,0,0,0,0,0,0,0,0,0
20200212,04063P,臺股指兆豐93售02,,,,,0.00,0.00,0,0,0,0,0,0,0,0,0,0,0,0,0
20200212,04064P,臺股指兆豐93售03,,,,,0.00,0.00,0,0,0,0,0,0,0,0,0,0,0,0,0
20200212,04065P,台積電凱基93售20,,,,,0.00,0.00,0,0,0,0,0,0,0,0,0,0,0,0,0
20200212,04066P,京元電凱基93售02,,,,,0.00,0.00,0,0,0,0,0,0,0,0,0,0,0,0,0
20200212,04067P,聯發科凱基93售24,,,,,0.00,0.00,0,0,0,0,0,0,0,0,0,0,0,0,0
20200212,04068P,大立光凱基93售27,,,,,0.00,0.00,0,0,0,0,0,0,0,0,0,0,0,0,0
20200212,04069P,聯詠凱基93售05,,,,,0.00,0.00,0,0,0,0,0,0,0,0,0,0,0,0,0
20200212,04070P,臺股指凱基93售06,,,,,0.00,0.00,0,0,0,0,0,0,0,0,0,0,0,0,0
20200212,04071P,臺股指凱基93售07,,,,,0.00,0.00,0,0,0,0,0,0,0,0,0,0,0,0,0
20200212,04072P,臺股指凱基93售08,,,,,0.00,0.00,0,0,0,0,0,0,0,0,0,0,0,0,0
20200212,04073P,臺股指凱基93售09,,,,,0.00,0.00,0,0,0,0,0,0,0,0,0,0,0,0,0
20200212,040744,滬深2X國票94購01,,,,,0.00,0.00,0,0,0,0,0,0,0,0,0,0,0,0,0
20200212,040745,滬深2X群益92購01,,,,,0.00,0.00,0,0,0,0,0,0,0,0,0,0,0,0,0
20200212,04074P,臺股指凱基93售10,,,,,0.00,0.00,0,0,0,0,0,0,0,0,0,0,0,0,0
20200212,04075P,臺股指凱基93售11,,,,,0.00,0.00,0,0,0,0,0,0,0,0,0,0,0,0,0
20200212,040760,T50反1凱基95購01,0.47,0.50,0.45,0.45,-0.06,-11.76,731000,26,343630,0,0,0,0,0,0,0,541000,-541000,-541000
20200212,040761,T50反1凱基95購02,,,,,0.00,0.00,0,0,0,0,0,0,0,0,0,0,0,0,0
20200212,040762,滬深2X凱基92購01,,,,,0.00,0.00,0,0,0,0,0,0,0,0,0,0,0,0,0
20200212,04076P,臺股指凱基93售12,0.11,0.11,0.11,0.11,0.00,0.00,25000,1,2750,0,0,0,0,0,0,25000,0,25000,25000
20200212,040772,滬深2X元富92購02,,,,,0.00,0.00,0,0,0,0,0,0,0,0,0,0,0,0,0
20200212,04077P,臺股指凱基93售13,,,,,0.00,0.00,0,0,0,0,0,0,0,0,0,0,0,0,0
20200212,04078P,臺股指凱基93售14,,,,,0.00,0.00,0,0,0,0,0,0,0,0,0,0,0,0,0
20200212,040792,臺指反元大92購01,,,,,0.00,0.00,0,0,0,0,0,0,0,0,0,0,0,0,0
20200212,04079P,燿華元大93售04,,,,,0.00,0.00,0,0,0,0,0,0,0,0,0,0,0,0,0
20200212,04080P,可成元大93售11,,,,,0.00,0.00,0,0,0,0,0,0,0,0,0,0,0,0,0
20200212,04081P,聯詠元大93售11,,,,,0.00,0.00,0,0,0,0,0,0,0,0,0,0,0,0,0
20200212,040820,禾伸堂群益92購01,,,,,0.00,0.00,0,0,0,0,0,0,0,0,0,0,0,0,0
20200212,04082P,智邦統一93售03,,,,,0.00,0.00,0,0,0,0,0,0,0,0,0,0,0,0,0
20200212,04083P,欣興統一94售01,0.90,0.90,0.76,0.76,-0.17,-18.28,30000,7,25700,0,0,0,0,0,0,18000,12000,6000,6000
20200212,04084P,台表科統一93售01,0.05,0.05,0.04,0.04,0.00,0.00,100000,10,4500,0,0,0,0,0,0,0,100000,-100000,-100000
20200212,040855,滬深2X永昌92購01,,,,,0.00,0.00,0,0,0,0,0,0,0,0,0,0,0,0,0
20200212,04085P,欣興元富93售01,0.78,0.78,0.60,0.60,-0.24,-28.57,109000,8,77820,0,0,0,0,0,0,20000,89000,-69000,-69000
20200212,04086P,臺股指元富93售04,,,,,0.00,0.00,0,0,0,0,0,0,0,0,0,0,0,0,0
20200212,04087P,臺股指元富93售05,,,,,0.00,0.00,0,0,0,0,0,0,0,0,0,0,0,0,0
20200212,04088P,臺股指元富93售06,,,,,0.00,0.00,0,0,0,0,0,0,0,0,0,0,0,0,0
20200212,04089P,臺股指元富93售07,,,,,0.00,0.00,0,0,0,0,0,0,0,0,0,0,0,0,0
20200212,04090P,臺股指元富93售08,,,,,0.00,0.00,0,0,0,0,0,0,0,0,0,0,0,0,0
20200212,04091P,臺股指元富93售09,,,,,0.00,0.00,0,0,0,0,0,0,0,0,0,0,0,0,0
20200212,04092P,臺股指元富93售10,,,,,0.00,0.00,0,0,0,0,0,0,0,0,0,0,0,0,0
20200212,04093P,上銀國票94售02,,,,,0.00,0.00,0,0,0,0,0,0,0,0,0,0,0,0,0
20200212,04094P,臺股指國票93售01,,,,,0.00,0.00,0,0,0,0,0,0,0,0,0,0,0,0,0
20200212,04095P,臺股指國票93售02,,,,,0.00,0.00,0,0,0,0,0,0,0,0,0,0,0,0,0
20200212,04096P,臺股指國票93售03,,,,,0.00,0.00,0,0,0,0,0,0,0,0,0,0,0,0,0
20200212,04097P,臺股指國票93售04,,,,,0.00,0.00,0,0,0,0,0,0,0,0,0,0,0,0,0
20200212,040987,上証2X凱基92購01,,,,,0.00,0.00,0,0,0,0,0,0,0,0,0,0,0,0,0
20200212,040988,滬深反凱基92購01,,,,,0.00,0.00,0,0,0,0,0,0,0,0,0,0,0,0,0
20200212,04098P,臺股指國票93售05,,,,,0.00,0.00,0,0,0,0,0,0,0,0,0,0,0,0,0
20200212,04099P,臺股指國票93售06,,,,,0.00,0.00,0,0,0,0,0,0,0,0,0,0,0,0,0
20200212,04100P,臺股指國票93售07,,,,,0.00,0.00,0,0,0,0,0,0,0,0,0,0,0,0,0
20200212,04101P,臺股指國票93售08,,,,,0.00,0.00,0,0,0,0,0,0,0,0,0,0,0,0,0
20200212,04102P,臺股指國票93售09,0.48,0.48,0.43,0.44,-0.17,-27.87,157000,8,70370,0,0,0,0,0,0,45000,127000,-82000,-82000
20200212,04103P,臺股指國票93售10,0.52,0.53,0.45,0.45,-0.16,-26.23,237000,10,120140,0,0,0,0,0,0,17000,220000,-203000,-203000
20200212,041040,SP黃豆群益92購01,,,,,0.00,0.00,0,0,0,0,0,0,0,0,0,0,0,0,0
20200212,041042,美律群益92購01,0.03,0.03,0.03,0.03,0.00,0.00,314000,3,9420,0,0,0,0,0,0,314000,0,314000,314000
20200212,04104P,臺股指國票93售11,0.79,0.79,0.63,0.63,-0.22,-25.88,101000,13,73210,0,0,0,0,0,0,0,101000,-101000,-101000
20200212,04105P,東陽康和93售03,,,,,0.00,0.00,0,0,0,0,0,0,0,0,0,0,0,0,0
20200212,04106P,滬深2X永豐93售02,0.37,0.37,0.35,0.35,-0.09,-20.45,16000,2,5900,0,0,0,0,0,0,16000,0,16000,16000
20200212,04107P,元黃金中信94售01,,,,,0.00,0.00,0,0,0,0,0,0,0,0,0,0,0,0,0
20200212,04108P,臺股指永昌93售03,,,,,0.00,0.00,0,0,0,0,0,0,0,0,0,0,0,0,0
20200212,04109P,臺股指永昌93售04,,,,,0.00,0.00,0,0,0,0,0,0,0,0,0,0,0,0,0
20200212,04110P,臺股指富邦93售03,,,,,0.00,0.00,0,0,0,0,0,0,0,0,0,0,0,0,0
20200212,04111P,臺股指富邦93售04,,,,,0.00,0.00,0,0,0,0,0,0,0,0,0,0,0,0,0
20200212,04112P,臺股指富邦93售05,,,,,0.00,0.00,0,0,0,0,0,0,0,0,0,0,0,0,0
20200212,04113P,臺股指富邦93售06,,,,,0.00,0.00,0,0,0,0,0,0,0,0,0,0,0,0,0
20200212,04114P,電子類富邦93售02,,,,,0.00,0.00,0,0,0,0,0,0,0,0,0,0,0,0,0
20200212,04115P,欣興群益93售06,,,,,0.00,0.00,0,0,0,0,0,0,0,0,0,0,0,0,0
20200212,04116P,京元電元大94售02,0.55,0.55,0.50,0.51,0.00,0.00,34000,3,17800,0,0,0,0,0,0,20000,14000,6000,6000
20200212,04117P,聯發科元大93售21,0.66,0.66,0.64,0.64,-0.22,-25.58,208000,4,137130,0,0,0,0,0,0,201000,207000,-6000,-6000
20200212,04118P,上銀凱基93售06,,,,,0.00,0.00,0,0,0,0,0,0,0,0,0,0,0,0,0
20200212,04119P,旺宏凱基93售06,,,,,0.00,0.00,0,0,0,0,0,0,0,0,0,0,0,0,0
20200212,041206,樺漢統一92購01,,,,,0.00,0.00,0,0,0,0,0,0,0,0,0,0,0,0,0
20200212,04120P,智邦凱基93售09,0.84,0.84,0.84,0.84,-0.15,-15.15,81000,2,68040,0,0,0,0,0,0,81000,0,81000,81000
20200212,041210,群創元富93購01,1.56,1.56,1.51,1.51,+0.01,0.67,30000,9,45910,0,0,0,0,0,0,0,25000,-25000,-25000
20200212,04121P,宏碁凱基93售02,0.70,0.70,0.70,0.70,-0.02,-2.78,1000,1,700,0,0,0,0,0,0,1000,0,1000,1000
20200212,04122P,瑞昱凱基93售09,,,,,0.00,0.00,0,0,0,0,0,0,0,0,0,0,0,0,0
20200212,04123P,可成凱基93售11,,,,,0.00,0.00,0,0,0,0,0,0,0,0,0,0,0,0,0
20200212,04124P,可成凱基93售12,,,,,0.00,0.00,0,0,0,0,0,0,0,0,0,0,0,0,0
20200212,04125P,健策凱基93售05,,,,,0.00,0.00,0,0,0,0,0,0,0,0,0,0,0,0,0
20200212,04126P,滬深2X國票95售02,,,,,0.00,0.00,0,0,0,0,0,0,0,0,0,0,0,0,0
20200212,04127P,聯茂國票93售02,,,,,0.00,0.00,0,0,0,0,0,0,0,0,0,0,0,0,0
20200212,04128P,台積電統一93售05,,,,,0.00,0.00,0,0,0,0,0,0,0,0,0,0,0,0,0
20200212,04129P,亞德客永豐93售04,,,,,0.00,0.00,0,0,0,0,0,0,0,0,0,0,0,0,0
20200212,041308,群創群益92購01,,,,,0.00,0.00,0,0,0,0,0,0,0,0,0,0,0,0,0
20200212,04130P,台積電永豐93售03,,,,,0.00,0.00,0,0,0,0,0,0,0,0,0,0,0,0,0
20200212,04131P,裕隆群益93售01,0.42,0.42,0.37,0.37,-0.09,-19.57,352000,30,141350,0,0,0,0,0,0,252000,100000,152000,152000
20200212,04132P,瑞昱群益93售04,0.36,0.36,0.36,0.36,-0.08,-18.18,22000,2,7920,0,0,0,0,0,0,0,22000,-22000,-22000
20200212,04133P,友達群益93售01,,,,,0.00,0.00,0,0,0,0,0,0,0,0,0,0,0,0,0
20200212,04134P,華新科群益93售02,,,,,0.00,0.00,0,0,0,0,0,0,0,0,0,0,0,0,0
20200212,04135P,亞德客元大93售04,,,,,0.00,0.00,0,0,0,0,0,0,0,0,0,0,0,0,0
20200212,04136P,智邦元大93售09,0.68,0.79,0.63,0.77,-0.11,-12.5,264000,9,184330,0,0,0,0,0,0,204000,109000,95000,95000
20200212,04137P,元油反國票97售01,0.14,0.14,0.14,0.14,0.00,0.00,96000,1,13440,0,0,0,0,0,0,0,96000,-96000,-96000
20200212,04138P,智邦國票93售02,0.37,0.46,0.37,0.46,-0.01,-2.13,20000,2,8300,0,0,0,0,0,0,10000,10000,0,0
20200212,04139P,大立光國票93售03,,,,,0.00,0.00,0,0,0,0,0,0,0,0,0,0,0,0,0
20200212,041409,創意中信93購01,0.37,0.38,0.35,0.35,-0.09,-20.45,6000,6,2160,0,0,0,0,0,0,6000,0,6000,6000
20200212,04140P,聯茂國票93售03,,,,,0.00,0.00,0,0,0,0,0,0,0,0,0,0,0,0,0
20200212,04141P,啟碁國票93售01,,,,,0.00,0.00,0,0,0,0,0,0,0,0,0,0,0,0,0
20200212,041421,滬深2X凱基93購01,,,,,0.00,0.00,0,0,0,0,0,0,0,0,0,0,0,0,0
20200212,041427,滬深2X國票93購01,0.06,0.06,0.06,0.06,+0.01,20.0,100000,2,6000,0,0,0,0,0,0,0,100000,-100000,-100000
20200212,04142P,元油反凱基99售01,,,,,0.00,0.00,0,0,0,0,0,0,0,0,0,0,0,0,0
20200212,04143P,鴻海凱基93售31,,,,,0.00,0.00,0,0,0,0,0,0,0,0,0,0,0,0,0
20200212,04144P,瑞昱凱基93售10,0.33,0.33,0.33,0.33,0.00,0.00,20000,2,6600,0,0,0,0,0,0,0,20000,-20000,-20000
20200212,041452,滬深2X元富93購01,0.81,0.81,0.76,0.80,-0.07,-8.05,32000,3,25150,0,0,0,0,0,0,0,32000,-32000,-32000
20200212,041453,國巨元富93購03,,,,,0.00,0.00,0,0,0,0,0,0,0,0,0,0,0,0,0
20200212,041454,國巨元富93購04,,,,,0.00,0.00,0,0,0,0,0,0,0,0,0,0,0,0,0
20200212,041455,國巨元富93購05,,,,,0.00,0.00,0,0,0,0,0,0,0,0,0,0,0,0,0
20200212,04145P,聯發科凱基93售28,,,,,0.00,0.00,0,0,0,0,0,0,0,0,0,0,0,0,0
20200212,041462,揚明光元大93購01,,,,,0.00,0.00,0,0,0,0,0,0,0,0,0,0,0,0,0
20200212,04146P,可成凱基93售14,0.98,0.98,0.88,0.88,-0.24,-21.43,600000,2,558000,0,0,0,0,0,0,300000,300000,0,0
20200212,041473,滬深2X群益93購01,,,,,0.00,0.00,0,0,0,0,0,0,0,0,0,0,0,0,0
20200212,04147P,大立光凱基93售30,,,,,0.00,0.00,0,0,0,0,0,0,0,0,0,0,0,0,0
20200212,04148P,GIS凱基93售05,0.91,0.91,0.91,0.91,-0.18,-16.51,6000,6,5460,0,0,0,0,0,0,6000,0,6000,6000
20200212,04149P,景碩台新93售02,,,,,0.00,0.00,0,0,0,0,0,0,0,0,0,0,0,0,0
20200212,04150P,燿華康和93售01,,,,,0.00,0.00,0,0,0,0,0,0,0,0,0,0,0,0,0
20200212,04151P,日電貿康和93售01,,,,,0.00,0.00,0,0,0,0,0,0,0,0,0,0,0,0,0
20200212,041527,T50反1中信96購01,0.66,0.66,0.61,0.63,-0.06,-8.7,1167000,26,744630,0,0,0,0,0,0,135000,1012000,-877000,-877000
20200212,041528,國泰金中信93購01,0.90,0.91,0.90,0.90,+0.02,2.27,23000,10,20730,0,0,0,0,0,0,23000,0,23000,23000
20200212,04152P,喬山永豐93售02,0.55,0.57,0.55,0.57,0.00,0.00,50000,5,27700,0,0,0,0,0,0,0,50000,-50000,-50000
20200212,041534,T50反1凱基96購01,,,,,0.00,0.00,0,0,0,0,0,0,0,0,0,0,0,0,0
20200212,04153P,旺宏永豐93售03,,,,,0.00,0.00,0,0,0,0,0,0,0,0,0,0,0,0,0
20200212,041546,群創統一93購01,,,,,0.00,0.00,0,0,0,0,0,0,0,0,0,0,0,0,0
20200212,04154P,南亞科永豐93售02,,,,,0.00,0.00,0,0,0,0,0,0,0,0,0,0,0,0,0
20200212,041551,道瓊反元大93購01,,,,,0.00,0.00,0,0,0,0,0,0,0,0,0,0,0,0,0
20200212,04155P,全新永豐93售01,,,,,0.00,0.00,0,0,0,0,0,0,0,0,0,0,0,0,0
20200212,04156P,大立光永豐93售02,,,,,0.00,0.00,0,0,0,0,0,0,0,0,0,0,0,0,0
20200212,04157P,鎧勝永豐93售02,1.25,1.25,1.25,1.25,-0.04,-3.1,1000,1,1250,0,0,0,0,0,0,1000,0,1000,1000
20200212,04158P,南電永豐93售04,0.45,0.45,0.43,0.43,-0.23,-34.85,50000,2,22300,0,0,0,0,0,0,50000,0,50000,50000
20200212,041596,S&P反1中信94購01,,,,,0.00,0.00,0,0,0,0,0,0,0,0,0,0,0,0,0
20200212,041597,A50正2中信93購01,,,,,0.00,0.00,0,0,0,0,0,0,0,0,0,0,0,0,0
20200212,04159P,滬深2X中信95售08,0.75,0.75,0.73,0.73,0.00,0.00,12000,2,8800,0,0,0,0,0,0,12000,0,12000,12000
20200212,041602,T50反1台新93購01,,,,,0.00,0.00,0,0,0,0,0,0,0,0,0,0,0,0,0
20200212,04160P,儒鴻中信93售01,0.53,0.54,0.52,0.54,+0.03,5.88,115000,4,61220,0,0,0,0,0,0,59000,56000,3000,3000
20200212,04161P,全新國泰94售01,,,,,0.00,0.00,0,0,0,0,0,0,0,0,0,0,0,0,0
20200212,04162P,南亞科統一94售02,1.01,1.01,1.00,1.00,-0.09,-8.26,10000,10,10060,0,0,0,0,0,0,10000,0,10000,10000
20200212,04163P,可成統一93售03,0.52,0.52,0.41,0.41,-0.18,-30.51,158000,15,78030,0,0,0,0,0,0,125000,33000,92000,92000
20200212,04164P,滬深2X元富93售03,1.30,1.32,1.22,1.25,-0.05,-3.85,70000,25,87710,0,0,0,0,0,0,41000,29000,12000,12000
20200212,04165P,南亞科元富95售03,0.97,0.97,0.97,0.97,-0.08,-7.62,10000,1,9700,0,0,0,0,0,0,10000,0,10000,10000
20200212,04166P,美利達元富93售03,,,,,0.00,0.00,0,0,0,0,0,0,0,0,0,0,0,0,0
20200212,04167P,滬深反凱基99售01,,,,,0.00,0.00,0,0,0,0,0,0,0,0,0,0,0,0,0
20200212,04168P,元金2X凱基99售01,0.53,0.53,0.53,0.53,0.00,0.00,60000,2,31800,0,0,0,0,0,0,0,60000,-60000,-60000
20200212,04169P,鴻海凱基93售34,,,,,0.00,0.00,0,0,0,0,0,0,0,0,0,0,0,0,0
20200212,04170P,台積電凱基93售24,,,,,0.00,0.00,0,0,0,0,0,0,0,0,0,0,0,0,0
20200212,04171P,旺宏凱基93售07,0.16,0.16,0.16,0.16,0.00,0.00,20000,1,3200,0,0,0,0,0,0,0,20000,-20000,-20000
20200212,041727,台灣50元大93購02,,,,,0.00,0.00,0,0,0,0,0,0,0,0,0,0,0,0,0
20200212,04172P,大立光凱基93售34,,,,,0.00,0.00,0,0,0,0,0,0,0,0,0,0,0,0,0
20200212,04173P,上海銀凱基93售02,0.45,0.45,0.45,0.45,0.00,0.00,20000,1,9000,0,0,0,0,0,0,20000,0,20000,20000
20200212,04174P,上銀群益93售06,,,,,0.00,0.00,0,0,0,0,0,0,0,0,0,0,0,0,0
20200212,04175P,台積電群益94售05,,,,,0.00,0.00,0,0,0,0,0,0,0,0,0,0,0,0,0
20200212,04176P,台達電元大94售01,1.49,1.49,1.49,1.49,-0.09,-5.7,1000,1,1490,0,0,0,0,0,0,1000,0,1000,1000
20200212,04177P,富邦金元大94售01,1.08,1.08,1.08,1.08,0.00,0.00,10000,1,10800,0,0,0,0,0,0,0,10000,-10000,-10000
20200212,04178P,聯茂元大93售07,1.34,1.34,1.34,1.34,-0.33,-19.76,10000,1,13400,0,0,0,0,0,0,10000,0,10000,10000
20200212,041799,T50反1富邦93購01,,,,,0.00,0.00,0,0,0,0,0,0,0,0,0,0,0,0,0
20200212,04179P,滬深2X國票93售03,1.14,1.14,1.14,1.14,0.00,0.00,1000,1,1140,0,0,0,0,0,0,0,1000,-1000,-1000
20200212,04180P,華新科國票93售01,,,,,0.00,0.00,0,0,0,0,0,0,0,0,0,0,0,0,0
20200212,04181P,嘉晶國票93售04,,,,,0.00,0.00,0,0,0,0,0,0,0,0,0,0,0,0,0
20200212,041824,元油2X國票96購01,0.31,0.34,0.31,0.34,+0.03,9.68,210000,5,67130,0,0,0,0,0,0,0,209000,-209000,-209000
20200212,04182P,祥碩國票93售01,,,,,0.00,0.00,0,0,0,0,0,0,0,0,0,0,0,0,0
20200212,041832,T50反1統一94購01,,,,,0.00,0.00,0,0,0,0,0,0,0,0,0,0,0,0,0
20200212,04183P,大成鋼統一93售03,,,,,0.00,0.00,0,0,0,0,0,0,0,0,0,0,0,0,0
20200212,041844,台積電富邦93購01,,,,,0.00,0.00,0,0,0,0,0,0,0,0,0,0,0,0,0
20200212,041848,T50正2元大93購01,,,,,0.00,0.00,0,0,0,0,0,0,0,0,0,0,0,0,0
20200212,04184P,台積電統一93售06,,,,,0.00,0.00,0,0,0,0,0,0,0,0,0,0,0,0,0
20200212,04185P,欣興統一93售05,1.41,1.41,1.41,1.41,0.00,0.00,1000,1,1410,0,0,0,0,0,0,0,1000,-1000,-1000
20200212,04186P,創意元富93售04,0.59,0.64,0.57,0.57,+0.04,7.55,167000,11,98090,0,0,0,0,0,0,81000,86000,-5000,-5000
20200212,041870,A50正2凱基96購01,0.81,0.86,0.81,0.86,-0.03,-3.37,14000,5,11860,0,0,0,0,0,0,1000,13000,-12000,-12000
20200212,04187P,麗豐元富93售02,0.91,0.92,0.91,0.91,-0.06,-6.19,6000,6,5500,0,0,0,0,0,0,6000,0,6000,6000
20200212,04188P,康控元富93售03,1.23,1.25,1.20,1.25,0.00,0.00,18000,3,22080,0,0,0,0,0,0,0,18000,-18000,-18000
20200212,04189P,台積電兆豐94售02,,,,,0.00,0.00,0,0,0,0,0,0,0,0,0,0,0,0,0
20200212,041900,元油2X富邦96購01,0.24,0.24,0.21,0.23,+0.02,9.52,379000,31,86070,0,0,0,0,0,0,0,0,0,0
20200212,04190P,大立光兆豐94售03,,,,,0.00,0.00,0,0,0,0,0,0,0,0,0,0,0,0,0
20200212,041916,大立光中信93購01,1.84,1.95,1.84,1.95,+0.27,16.07,42000,5,79580,0,0,0,0,0,0,22000,40000,-18000,-18000
20200212,04191P,儒鴻永豐93售02,0.38,0.39,0.37,0.39,0.00,0.00,238000,5,90440,0,0,0,0,0,0,235000,3000,232000,232000
20200212,041921,台灣50凱基93購04,,,,,0.00,0.00,0,0,0,0,0,0,0,0,0,0,0,0,0
20200212,04192P,漢唐永豐93售03,,,,,0.00,0.00,0,0,0,0,0,0,0,0,0,0,0,0,0
20200212,04193P,智原永豐93售01,,,,,0.00,0.00,0,0,0,0,0,0,0,0,0,0,0,0,0
20200212,04194P,欣興永豐93售05,0.56,0.56,0.54,0.54,-0.18,-25.0,30000,2,16400,0,0,0,0,0,0,20000,10000,10000,10000
20200212,04195P,上海銀永豐93售01,,,,,0.00,0.00,0,0,0,0,0,0,0,0,0,0,0,0,0
20200212,04196P,東陽中信93售02,,,,,0.00,0.00,0,0,0,0,0,0,0,0,0,0,0,0,0
20200212,041973,台灣50中信94購01,1.26,1.51,1.26,1.47,+0.27,22.5,1930000,96,2542190,0,0,0,0,0,0,1506000,165000,1341000,1341000
20200212,041978,貿聯中信93購01,0.23,0.27,0.23,0.27,+0.04,17.39,263000,9,63250,0,0,0,0,0,0,263000,0,263000,263000
20200212,04197P,台積電亞東94售01,,,,,0.00,0.00,0,0,0,0,0,0,0,0,0,0,0,0,0
20200212,04198P,滬深2X群益95售04,0.88,0.88,0.84,0.84,-0.02,-2.33,420000,3,353400,0,0,0,0,0,0,400000,20000,380000,380000
20200212,041990,A50正2國票97購01,,,,,0.00,0.00,0,0,0,0,0,0,0,0,0,0,0,0,0
20200212,041991,元油2X國票98購01,0.45,0.47,0.45,0.47,+0.02,4.44,195000,6,89900,0,0,0,0,0,0,175000,20000,155000,155000
20200212,04199P,國巨群益93售05,,,,,0.00,0.00,0,0,0,0,0,0,0,0,0,0,0,0,0
20200212,04200P,奇力新群益93售07,,,,,0.00,0.00,0,0,0,0,0,0,0,0,0,0,0,0,0
20200212,04201P,智原群益93售01,,,,,0.00,0.00,0,0,0,0,0,0,0,0,0,0,0,0,0
20200212,042028,滬深反凱基93購01,,,,,0.00,0.00,0,0,0,0,0,0,0,0,0,0,0,0,0
20200212,04202P,華新科元大93售10,,,,,0.00,0.00,0,0,0,0,0,0,0,0,0,0,0,0,0
20200212,042037,台灣50群益93購03,5.50,6.00,5.50,6.00,+0.95,18.81,2000,2,11500,0,0,0,0,0,0,2000,0,2000,2000
20200212,04203P,超眾元大93售04,0.63,0.63,0.63,0.63,-0.01,-1.56,50000,2,31500,0,0,0,0,0,0,50000,0,50000,50000
20200212,042040,大立光群益93購01,2.48,2.55,2.48,2.55,+0.40,18.6,8000,2,20050,0,0,0,0,0,0,0,8000,-8000,-8000
20200212,04204P,臺股指元大93售44,,,,,0.00,0.00,0,0,0,0,0,0,0,0,0,0,0,0,0
20200212,04205P,臺股指元大93售45,,,,,0.00,0.00,0,0,0,0,0,0,0,0,0,0,0,0,0
20200212,042068,台灣50富邦93購02,,,,,0.00,0.00,0,0,0,0,0,0,0,0,0,0,0,0,0
20200212,042069,T50正2富邦93購01,,,,,0.00,0.00,0,0,0,0,0,0,0,0,0,0,0,0,0
20200212,04206P,臺股指元大93售46,,,,,0.00,0.00,0,0,0,0,0,0,0,0,0,0,0,0,0
20200212,04207P,臺股指元大93售47,,,,,0.00,0.00,0,0,0,0,0,0,0,0,0,0,0,0,0
20200212,042080,揚明光元大93購02,,,,,0.00,0.00,0,0,0,0,0,0,0,0,0,0,0,0,0
20200212,042085,台灣50凱基92購02,,,,,0.00,0.00,0,0,0,0,0,0,0,0,0,0,0,0,0
20200212,042088,台灣50中信93購04,,,,,0.00,0.00,0,0,0,0,0,0,0,0,0,0,0,0,0
20200212,042089,台灣50中信94購03,4.40,4.56,4.40,4.56,+0.50,12.32,88000,5,395310,0,0,0,0,0,0,88000,28000,60000,60000
20200212,04208P,臺股指元大93售48,,,,,0.00,0.00,0,0,0,0,0,0,0,0,0,0,0,0,0
20200212,042093,台灣50群益94購02,2.85,3.12,2.85,3.12,+0.43,15.99,13000,3,39910,0,0,0,0,0,0,12000,0,12000,12000
20200212,04209P,臺股指日盛93售01,,,,,0.00,0.00,0,0,0,0,0,0,0,0,0,0,0,0,0
20200212,04210P,鴻海凱基93售36,,,,,0.00,0.00,0,0,0,0,0,0,0,0,0,0,0,0,0
20200212,042115,台灣50國票92購06,,,,,0.00,0.00,0,0,0,0,0,0,0,0,0,0,0,0,0
20200212,042116,元油2X國票97購01,0.41,0.43,0.41,0.43,+0.03,7.5,116000,4,49670,0,0,0,0,0,0,10000,106000,-96000,-96000
20200212,04211P,台積電凱基93售25,,,,,0.00,0.00,0,0,0,0,0,0,0,0,0,0,0,0,0
20200212,042126,欣興統一92購01,,,,,0.00,0.00,0,0,0,0,0,0,0,0,0,0,0,0,0
20200212,04212P,微星凱基93售03,,,,,0.00,0.00,0,0,0,0,0,0,0,0,0,0,0,0,0
20200212,042131,國巨富邦93購01,,,,,0.00,0.00,0,0,0,0,0,0,0,0,0,0,0,0,0
20200212,042135,台灣50元大93購05,,,,,0.00,0.00,0,0,0,0,0,0,0,0,0,0,0,0,0
20200212,042136,台灣50元大93購08,,,,,0.00,0.00,0,0,0,0,0,0,0,0,0,0,0,0,0
20200212,042137,元油2X元大93購01,,,,,0.00,0.00,0,0,0,0,0,0,0,0,0,0,0,0,0
20200212,042139,國巨元大92購02,,,,,0.00,0.00,0,0,0,0,0,0,0,0,0,0,0,0,0
20200212,04213P,台光電凱基93售11,1.40,1.41,1.40,1.41,0.00,0.00,10000,2,14050,0,0,0,0,0,0,0,10000,-10000,-10000
20200212,042143,奇鋐元大92購01,,,,,0.00,0.00,0,0,0,0,0,0,0,0,0,0,0,0,0
20200212,04214P,美利達凱基93售04,0.90,0.90,0.90,0.90,0.00,0.00,7000,1,6300,0,0,0,0,0,0,0,7000,-7000,-7000
20200212,04215P,鴻海國票93售02,0.03,0.03,0.03,0.03,0.00,0.00,170000,2,5100,0,0,0,0,0,0,0,0,0,0
20200212,042160,健策中信92購01,,,,,0.00,0.00,0,0,0,0,0,0,0,0,0,0,0,0,0
20200212,042168,台灣50凱基96購01,7.95,8.10,7.95,8.10,+0.70,9.46,3000,2,24000,0,0,0,0,0,0,1000,2000,-1000,-1000
20200212,042169,元油2X凱基92購03,,,,,0.00,0.00,0,0,0,0,0,0,0,0,0,0,0,0,0
20200212,04216P,燿華國票93售02,,,,,0.00,0.00,0,0,0,0,0,0,0,0,0,0,0,0,0
20200212,042173,台灣50永豐93購01,,,,,0.00,0.00,0,0,0,0,0,0,0,0,0,0,0,0,0
20200212,04217P,漢唐國票93售01,,,,,0.00,0.00,0,0,0,0,0,0,0,0,0,0,0,0,0
20200212,042181,易華電統一92購01,,,,,0.00,0.00,0,0,0,0,0,0,0,0,0,0,0,0,0
20200212,04218P,正文國票93售03,,,,,0.00,0.00,0,0,0,0,0,0,0,0,0,0,0,0,0
20200212,042191,元油2X富邦93購01,0.03,0.03,0.03,0.03,0.00,0.00,65000,2,1950,0,0,0,0,0,0,65000,0,65000,65000
20200212,042194,揚明光富邦93購01,,,,,0.00,0.00,0,0,0,0,0,0,0,0,0,0,0,0,0
20200212,042195,元石油元大93購01,,,,,0.00,0.00,0,0,0,0,0,0,0,0,0,0,0,0,0
20200212,042196,元油2X元大93購02,0.19,0.19,0.18,0.19,+0.03,18.75,421000,5,79980,0,0,0,0,0,0,1000,420000,-419000,-419000
20200212,04219P,鴻海兆豐93售02,0.07,0.07,0.06,0.06,-0.02,-25.0,12000,3,740,0,0,0,0,0,0,0,12000,-12000,-12000
20200212,04220P,聯發科兆豐93售04,,,,,0.00,0.00,0,0,0,0,0,0,0,0,0,0,0,0,0
20200212,04221P,大立光兆豐93售05,,,,,0.00,0.00,0,0,0,0,0,0,0,0,0,0,0,0,0
20200212,042227,元油2X永豐93購01,,,,,0.00,0.00,0,0,0,0,0,0,0,0,0,0,0,0,0
20200212,04222P,台積電統一93售08,,,,,0.00,0.00,0,0,0,0,0,0,0,0,0,0,0,0,0
20200212,042234,S&P反1國泰92購01,,,,,0.00,0.00,0,0,0,0,0,0,0,0,0,0,0,0,0
20200212,042237,鴻海永昌93購01,,,,,0.00,0.00,0,0,0,0,0,0,0,0,0,0,0,0,0
20200212,042238,台積電永昌93購01,,,,,0.00,0.00,0,0,0,0,0,0,0,0,0,0,0,0,0
20200212,042239,大立光永昌93購01,,,,,0.00,0.00,0,0,0,0,0,0,0,0,0,0,0,0,0
20200212,04223P,友達統一93售05,0.12,0.12,0.12,0.12,+0.01,9.09,1000,1,120,0,0,0,0,0,0,1000,0,1000,1000
20200212,042244,元油2X凱基92購04,,,,,0.00,0.00,0,0,0,0,0,0,0,0,0,0,0,0,0
20200212,04224P,群創統一93售05,,,,,0.00,0.00,0,0,0,0,0,0,0,0,0,0,0,0,0
20200212,042255,群創國票92購01,0.52,0.52,0.50,0.50,0.00,0.00,18000,2,9100,0,0,0,0,0,0,18000,0,18000,18000
20200212,04225P,台積電元富94售02,,,,,0.00,0.00,0,0,0,0,0,0,0,0,0,0,0,0,0
20200212,04226P,宏達電元富93售01,,,,,0.00,0.00,0,0,0,0,0,0,0,0,0,0,0,0,0
20200212,04227P,滬深2X永豐94售04,0.47,0.47,0.45,0.46,0.00,0.00,445000,3,204550,0,0,0,0,0,0,415000,30000,385000,385000
20200212,042280,元石油富邦96購01,,,,,0.00,0.00,0,0,0,0,0,0,0,0,0,0,0,0,0
20200212,042281,元油2X富邦96購02,0.31,0.32,0.31,0.32,+0.03,10.34,47000,4,15030,0,0,0,0,0,0,0,47000,-47000,-47000
20200212,042283,南電富邦92購01,,,,,0.00,0.00,0,0,0,0,0,0,0,0,0,0,0,0,0
20200212,042287,台灣50元大93購10,,,,,0.00,0.00,0,0,0,0,0,0,0,0,0,0,0,0,0
20200212,042288,元油2X元大93購03,,,,,0.00,0.00,0,0,0,0,0,0,0,0,0,0,0,0,0
20200212,04228P,貿聯永豐93售03,0.81,0.82,0.80,0.80,-0.05,-5.88,102000,3,82900,0,0,0,0,0,0,102000,0,102000,102000
20200212,042295,大立光元大92購04,,,,,0.00,0.00,0,0,0,0,0,0,0,0,0,0,0,0,0
20200212,042298,群創元大92購01,,,,,0.00,0.00,0,0,0,0,0,0,0,0,0,0,0,0,0
20200212,04229P,臺股指中信95售05,0.02,0.02,0.02,0.02,0.00,0.00,210000,3,4200,0,0,0,0,0,0,170000,10000,160000,160000
20200212,04230P,臺股指中信95售06,0.33,0.33,0.30,0.30,-0.03,-9.09,262000,10,80310,0,0,0,0,0,0,100000,162000,-62000,-62000
20200212,042315,T50反1台新96購01,,,,,0.00,0.00,0,0,0,0,0,0,0,0,0,0,0,0,0
20200212,042317,台灣50永豐96購01,4.92,5.40,4.92,5.30,+0.58,12.29,129000,25,661080,0,0,0,0,0,0,123000,5000,118000,118000
20200212,04231P,聯發科亞東93售03,,,,,0.00,0.00,0,0,0,0,0,0,0,0,0,0,0,0,0
20200212,042326,元油2X國票94購01,0.15,0.16,0.15,0.16,+0.02,14.29,900000,6,143000,0,0,0,0,0,0,0,900000,-900000,-900000
20200212,04232P,可成亞東93售02,,,,,0.00,0.00,0,0,0,0,0,0,0,0,0,0,0,0,0
20200212,04233P,儒鴻兆豐93售01,1.14,1.21,1.14,1.15,-0.01,-0.86,185000,17,212600,0,0,0,0,0,0,131000,54000,77000,77000
20200212,042346,創意富邦92購01,,,,,0.00,0.00,0,0,0,0,0,0,0,0,0,0,0,0,0
20200212,04234P,華通群益94售02,0.39,0.39,0.39,0.39,-0.05,-11.36,5000,1,1950,0,0,0,0,0,0,5000,0,5000,5000
20200212,042350,力山元大92購01,,,,,0.00,0.00,0,0,0,0,0,0,0,0,0,0,0,0,0
20200212,04235P,鴻海群益93售08,0.32,0.32,0.24,0.24,-0.19,-44.19,145000,4,38300,0,0,0,0,0,0,10000,135000,-125000,-125000
20200212,042366,元油2X國票92購01,,,,,0.00,0.00,0,0,0,0,0,0,0,0,0,0,0,0,0
20200212,04236P,華新科群益93售03,,,,,0.00,0.00,0,0,0,0,0,0,0,0,0,0,0,0,0
20200212,042379,T50反1群益93購03,,,,,0.00,0.00,0,0,0,0,0,0,0,0,0,0,0,0,0
20200212,04237P,超眾群益93售02,0.59,0.59,0.58,0.58,-0.06,-9.38,16000,3,9380,0,0,0,0,0,0,10000,6000,4000,4000
20200212,042387,台積電永昌93購02,21.70,23.00,21.70,23.00,+2.70,13.3,7000,6,156000,0,0,0,0,0,0,4000,2000,2000,2000
20200212,042388,大立光永昌93購02,2.89,2.98,2.89,2.98,0.00,0.00,16000,2,46960,0,0,0,0,0,0,0,16000,-16000,-16000
20200212,042389,台灣50富邦92購02,,,,,0.00,0.00,0,0,0,0,0,0,0,0,0,0,0,0,0
20200212,04238P,滬深2X日盛93售01,,,,,0.00,0.00,0,0,0,0,0,0,0,0,0,0,0,0,0
20200212,042396,台灣50元富92購04,,,,,0.00,0.00,0,0,0,0,0,0,0,0,0,0,0,0,0
20200212,04239P,上銀凱基93售08,,,,,0.00,0.00,0,0,0,0,0,0,0,0,0,0,0,0,0
20200212,04240P,台積電凱基93售27,,,,,0.00,0.00,0,0,0,0,0,0,0,0,0,0,0,0,0
20200212,042414,漢唐元大92購01,1.39,1.39,1.39,1.39,+0.03,2.21,10000,1,13900,0,0,0,0,0,0,10000,0,10000,10000
20200212,04241P,欣興國泰95售02,1.22,1.24,1.04,1.04,-0.21,-16.8,69000,8,78980,0,0,0,0,0,0,10000,59000,-49000,-49000
20200212,04242P,台積電永昌93售08,,,,,0.00,0.00,0,0,0,0,0,0,0,0,0,0,0,0,0
20200212,042433,元油2X永豐96購01,0.20,0.20,0.20,0.20,0.00,0.00,55000,2,11000,0,0,0,0,0,0,0,55000,-55000,-55000
20200212,04243P,大立光永昌93售08,0.78,0.78,0.78,0.78,-0.18,-18.75,7000,7,5460,0,0,0,0,0,0,7000,0,7000,7000
20200212,042445,上証2X凱基92購04,,,,,0.00,0.00,0,0,0,0,0,0,0,0,0,0,0,0,0
20200212,04244P,可成元大93售12,,,,,0.00,0.00,0,0,0,0,0,0,0,0,0,0,0,0,0
20200212,04245P,上海銀元大93售03,,,,,0.00,0.00,0,0,0,0,0,0,0,0,0,0,0,0,0
20200212,04246P,義隆永豐93售03,,,,,0.00,0.00,0,0,0,0,0,0,0,0,0,0,0,0,0
20200212,042470,元油2X元大93購04,0.12,0.13,0.12,0.13,0.00,0.00,110000,2,14200,0,0,0,0,0,0,0,110000,-110000,-110000
20200212,04247P,宏達電永豐93售02,,,,,0.00,0.00,0,0,0,0,0,0,0,0,0,0,0,0,0
20200212,042481,嘉聯益統一92購01,,,,,0.00,0.00,0,0,0,0,0,0,0,0,0,0,0,0,0
20200212,04248P,臺股指永豐93售03,,,,,0.00,0.00,0,0,0,0,0,0,0,0,0,0,0,0,0
20200212,04249P,大立光統一94售04,0.47,0.47,0.47,0.47,-0.05,-9.62,100000,1,47000,0,0,0,0,0,0,0,100000,-100000,-100000
20200212,042501,台灣50凱基96購06,7.30,7.65,7.30,7.65,+0.45,6.25,4000,4,29900,0,0,0,0,0,0,4000,0,4000,4000
20200212,042502,上銀凱基93購01,0.97,0.99,0.24,0.97,+0.03,3.19,80000,5,71050,0,0,0,0,0,0,50000,30000,20000,20000
20200212,04250P,嘉晶統一95售02,,,,,0.00,0.00,0,0,0,0,0,0,0,0,0,0,0,0,0
20200212,042516,健策凱基93購01,2.53,2.53,2.48,2.51,+0.09,3.72,39000,16,98100,0,0,0,0,0,0,39000,0,39000,39000
20200212,04251P,欣興統一93售06,,,,,0.00,0.00,0,0,0,0,0,0,0,0,0,0,0,0,0
20200212,042527,台灣50永豐94購01,,,,,0.00,0.00,0,0,0,0,0,0,0,0,0,0,0,0,0
20200212,04252P,台達電元富93售02,0.75,0.76,0.73,0.76,-0.04,-5.0,14000,4,10480,0,0,0,0,0,0,2000,12000,-10000,-10000
20200212,042538,新光金國泰92購01,0.92,0.92,0.92,0.92,+0.02,2.22,11000,2,10120,0,0,0,0,0,0,11000,0,11000,11000
20200212,04253P,聯發科元富93售01,0.30,0.30,0.28,0.28,-0.13,-31.71,2000,2,580,0,0,0,0,0,0,2000,0,2000,2000
20200212,042542,台灣50元大93購14,,,,,0.00,0.00,0,0,0,0,0,0,0,0,0,0,0,0,0
20200212,042547,國巨元大92購03,,,,,0.00,0.00,0,0,0,0,0,0,0,0,0,0,0,0,0
20200212,04254P,亞德客國票93售03,,,,,0.00,0.00,0,0,0,0,0,0,0,0,0,0,0,0,0
20200212,042556,台灣50中信96購04,3.39,3.58,3.39,3.58,+0.25,7.51,48000,9,168080,0,0,0,0,0,0,42000,20000,22000,22000
20200212,042557,中石化中信92購01,,,,,0.00,0.00,0,0,0,0,0,0,0,0,0,0,0,0,0
20200212,042558,瑞昱中信94購01,0.72,0.76,0.72,0.76,+0.06,8.57,52000,4,38890,0,0,0,0,0,0,51000,1000,50000,50000
20200212,04255P,台積電國票94售03,,,,,0.00,0.00,0,0,0,0,0,0,0,0,0,0,0,0,0
20200212,042560,康控兆豐92購01,,,,,0.00,0.00,0,0,0,0,0,0,0,0,0,0,0,0,0
20200212,042561,南電兆豐92購01,0.56,0.70,0.49,0.70,+0.17,32.08,563000,63,312360,0,0,0,0,0,0,533000,30000,503000,503000
20200212,04256P,美律國票93售03,,,,,0.00,0.00,0,0,0,0,0,0,0,0,0,0,0,0,0
20200212,04257P,景碩國票93售01,,,,,0.00,0.00,0,0,0,0,0,0,0,0,0,0,0,0,0
20200212,04258P,健策國票94售01,,,,,0.00,0.00,0,0,0,0,0,0,0,0,0,0,0,0,0
20200212,042593,S&P反1統一92購01,,,,,0.00,0.00,0,0,0,0,0,0,0,0,0,0,0,0,0
20200212,04259P,滬深2X群益93售03,3.06,3.06,3.06,3.06,-0.05,-1.61,6000,1,18360,0,0,0,0,0,0,6000,0,6000,6000
20200212,042604,國泰金富邦92購01,,,,,0.00,0.00,0,0,0,0,0,0,0,0,0,0,0,0,0
20200212,04260P,亞德客群益93售01,,,,,0.00,0.00,0,0,0,0,0,0,0,0,0,0,0,0,0
20200212,042618,台灣50群益92購04,,,,,0.00,0.00,0,0,0,0,0,0,0,0,0,0,0,0,0
20200212,04261P,大立光群益93售12,0.29,0.29,0.29,0.29,-0.06,-17.14,140000,3,40600,0,0,0,0,0,0,0,140000,-140000,-140000
20200212,04262P,景碩群益93售03,0.24,0.24,0.24,0.24,-0.05,-17.24,10000,1,2400,0,0,0,0,0,0,0,10000,-10000,-10000
20200212,04263P,南電群益93售03,0.81,0.81,0.81,0.81,-0.09,-10.0,5000,1,4050,0,0,0,0,0,0,0,5000,-5000,-5000
20200212,042643,智易兆豐92購01,,,,,0.00,0.00,0,0,0,0,0,0,0,0,0,0,0,0,0
20200212,042644,貿聯兆豐92購01,0.05,0.05,0.05,0.05,+0.01,25.0,20000,2,1000,0,0,0,0,0,0,20000,0,20000,20000
20200212,04264P,宏碁統一93售01,1.59,1.59,1.59,1.59,-0.02,-1.24,1000,1,1590,0,0,0,0,0,0,1000,0,1000,1000
20200212,042650,台灣50元富92購05,,,,,0.00,0.00,0,0,0,0,0,0,0,0,0,0,0,0,0
20200212,042655,臺指反凱基92購01,,,,,0.00,0.00,0,0,0,0,0,0,0,0,0,0,0,0,0
20200212,04265P,滬深2X元富93售04,2.01,2.01,1.91,1.91,+0.02,1.06,83000,9,163730,0,0,0,0,0,0,83000,83000,0,0
20200212,04266P,華新科元富93售02,,,,,0.00,0.00,0,0,0,0,0,0,0,0,0,0,0,0,0
20200212,042674,大成鋼富邦92購01,,,,,0.00,0.00,0,0,0,0,0,0,0,0,0,0,0,0,0
20200212,042676,臺指反元大93購01,,,,,0.00,0.00,0,0,0,0,0,0,0,0,0,0,0,0,0
20200212,042679,群創元大92購02,0.83,0.83,0.83,0.83,-0.05,-5.68,100000,1,83000,0,0,0,0,0,0,100000,0,100000,100000
20200212,04267P,康控元富93售04,1.47,1.49,1.43,1.49,-0.19,-11.31,28000,4,40840,0,0,0,0,0,0,0,28000,-28000,-28000
20200212,042681,嘉聯益元大92購01,,,,,0.00,0.00,0,0,0,0,0,0,0,0,0,0,0,0,0
20200212,04268P,南電元富93售03,,,,,0.00,0.00,0,0,0,0,0,0,0,0,0,0,0,0,0
20200212,042692,台灣50凱基96購09,,,,,0.00,0.00,0,0,0,0,0,0,0,0,0,0,0,0,0
20200212,04269P,華通國票93售03,,,,,0.00,0.00,0,0,0,0,0,0,0,0,0,0,0,0,0
20200212,042705,台積電亞東93購01,7.40,7.55,7.40,7.55,+0.35,4.86,6000,2,44550,0,0,0,0,0,0,0,6000,-6000,-6000
20200212,04270P,台光電國票93售03,,,,,0.00,0.00,0,0,0,0,0,0,0,0,0,0,0,0,0
20200212,042711,台灣50國票93購01,,,,,0.00,0.00,0,0,0,0,0,0,0,0,0,0,0,0,0
20200212,042712,元石油國票95購01,,,,,0.00,0.00,0,0,0,0,0,0,0,0,0,0,0,0,0
20200212,042719,臺指反群益93購01,,,,,0.00,0.00,0,0,0,0,0,0,0,0,0,0,0,0,0
20200212,04271P,南亞科國票93售03,,,,,0.00,0.00,0,0,0,0,0,0,0,0,0,0,0,0,0
20200212,042724,群創群益93購01,0.98,0.98,0.97,0.97,0.00,0.00,125000,3,121300,0,0,0,0,0,0,125000,0,125000,125000
20200212,04272P,元上證凱基94售01,0.27,0.27,0.26,0.26,-0.01,-3.7,25000,5,6650,0,0,0,0,0,0,0,12000,-12000,-12000
20200212,042734,大立光兆豐92購02,,,,,0.00,0.00,0,0,0,0,0,0,0,0,0,0,0,0,0
20200212,042735,TPK兆豐92購01,0.03,0.03,0.03,0.03,0.00,0.00,300000,1,9000,0,0,0,0,0,0,300000,0,300000,300000
20200212,04273P,上証反凱基99售01,,,,,0.00,0.00,0,0,0,0,0,0,0,0,0,0,0,0,0
20200212,04274P,滬深2X凱基94售01,0.78,0.78,0.74,0.74,0.00,0.00,21000,2,15580,0,0,0,0,0,0,21000,0,21000,21000
20200212,042752,台灣50元大96購03,7.80,8.45,7.80,8.30,+0.85,11.41,32000,7,259300,0,0,0,0,0,0,20000,12000,8000,8000
20200212,042754,元黃金元大93購01,,,,,0.00,0.00,0,0,0,0,0,0,0,0,0,0,0,0,0
20200212,04275P,南亞科凱基93售08,,,,,0.00,0.00,0,0,0,0,0,0,0,0,0,0,0,0,0
20200212,042767,世紀鋼元大92購01,,,,,0.00,0.00,0,0,0,0,0,0,0,0,0,0,0,0,0
20200212,04276P,聯發科凱基93售33,0.71,0.71,0.71,0.71,-0.18,-20.22,1000,1,710,0,0,0,0,0,0,0,1000,-1000,-1000
20200212,04277P,奇力新凱基93售05,,,,,0.00,0.00,0,0,0,0,0,0,0,0,0,0,0,0,0
20200212,042784,上銀兆豐93購01,,,,,0.00,0.00,0,0,0,0,0,0,0,0,0,0,0,0,0
20200212,042787,新日興兆豐93購01,1.93,1.93,1.90,1.90,-0.13,-6.4,73000,10,140710,0,0,0,0,0,0,73000,0,73000,73000
20200212,04278P,大立光凱基93售38,,,,,0.00,0.00,0,0,0,0,0,0,0,0,0,0,0,0,0
20200212,042792,T50反1台新9C購01,0.49,0.49,0.48,0.48,0.00,0.00,15000,2,7250,0,0,0,0,0,0,0,15000,-15000,-15000
20200212,042793,台積電台新9C購01,21.50,21.60,21.50,21.60,+1.00,4.85,4000,2,86300,0,0,0,0,0,0,4000,0,4000,4000
20200212,042796,永冠元大93購01,,,,,0.00,0.00,0,0,0,0,0,0,0,0,0,0,0,0,0
20200212,04279P,超眾凱基93售07,,,,,0.00,0.00,0,0,0,0,0,0,0,0,0,0,0,0,0
20200212,042801,達邁元大93購01,0.21,0.26,0.21,0.25,0.00,0.00,465000,26,111300,0,0,0,0,0,0,178000,284000,-106000,-106000
20200212,042803,天鈺元大93購01,0.12,0.12,0.12,0.12,+0.01,9.09,2000,1,240,0,0,0,0,0,0,2000,0,2000,2000
20200212,042805,智邦統一93購01,,,,,0.00,0.00,0,0,0,0,0,0,0,0,0,0,0,0,0
20200212,04280P,宏達電台新93售01,,,,,0.00,0.00,0,0,0,0,0,0,0,0,0,0,0,0,0
20200212,04281P,旺宏永豐93售05,,,,,0.00,0.00,0,0,0,0,0,0,0,0,0,0,0,0,0
20200212,042826,欣興兆豐93購01,1.09,1.09,1.09,1.09,+0.22,25.29,1000,1,1090,0,0,0,0,0,0,1000,0,1000,1000
20200212,04282P,微星永豐93售02,,,,,0.00,0.00,0,0,0,0,0,0,0,0,0,0,0,0,0
20200212,04283P,麗豐永豐93售03,,,,,0.00,0.00,0,0,0,0,0,0,0,0,0,0,0,0,0
20200212,04284P,瀚宇博永豐93售01,,,,,0.00,0.00,0,0,0,0,0,0,0,0,0,0,0,0,0
20200212,042857,臺指反國票93購01,,,,,0.00,0.00,0,0,0,0,0,0,0,0,0,0,0,0,0
20200212,04285P,超眾永豐93售04,,,,,0.00,0.00,0,0,0,0,0,0,0,0,0,0,0,0,0
20200212,04286P,滬深2X中信96售01,,,,,0.00,0.00,0,0,0,0,0,0,0,0,0,0,0,0,0
20200212,04287P,A50正2中信96售01,0.62,0.65,0.62,0.64,+0.01,1.59,46000,4,28950,0,0,0,0,0,0,15000,31000,-16000,-16000
20200212,04288P,台積電中信95售06,0.08,0.08,0.07,0.07,-0.01,-12.5,400000,4,30000,0,0,0,0,0,0,0,370000,-370000,-370000
20200212,042895,鴻海永昌93購03,,,,,0.00,0.00,0,0,0,0,0,0,0,0,0,0,0,0,0
20200212,042896,台積電永昌93購04,,,,,0.00,0.00,0,0,0,0,0,0,0,0,0,0,0,0,0
20200212,042897,大立光永昌93購04,,,,,0.00,0.00,0,0,0,0,0,0,0,0,0,0,0,0,0
20200212,04289P,臺股指中信95售07,0.27,0.27,0.24,0.24,-0.04,-14.29,1107000,20,281490,0,0,0,0,0,0,121000,986000,-865000,-865000
20200212,042901,中纖元大94購01,,,,,0.00,0.00,0,0,0,0,0,0,0,0,0,0,0,0,0
20200212,042902,光寶科元大94購01,0.84,0.87,0.84,0.87,-0.01,-1.14,131000,5,112910,0,0,0,0,0,0,0,131000,-131000,-131000
20200212,042903,金寶元大94購01,2.17,2.20,2.10,2.20,+0.04,1.85,349000,27,734700,0,0,0,0,0,0,233000,130000,103000,103000
20200212,042904,金寶元大94購02,2.17,2.25,2.12,2.23,-0.11,-4.7,25000,7,54170,0,0,0,0,0,0,20000,5000,15000,15000
20200212,042909,順德元大94購01,0.50,0.51,0.50,0.51,+0.02,4.08,1030000,10,518100,0,0,0,0,0,0,1030000,0,1030000,1030000
20200212,04290P,滬深2X富邦96售03,,,,,0.00,0.00,0,0,0,0,0,0,0,0,0,0,0,0,0
20200212,042912,凌陽元大94購01,0.53,0.53,0.53,0.53,0.00,0.00,659000,2,349270,0,0,0,0,0,0,398000,261000,137000,137000
20200212,042915,大立光元大93購01,1.65,1.68,1.65,1.68,+0.18,12.0,2000,2,3330,0,0,0,0,0,0,2000,0,2000,2000
20200212,042916,佐登元大94購01,0.15,0.18,0.15,0.18,+0.03,20.0,441000,8,74570,0,0,0,0,0,0,380000,61000,319000,319000
20200212,042918,矽格元大94購01,1.87,1.87,1.87,1.87,0.00,0.00,1000,1,1870,0,0,0,0,0,0,0,1000,-1000,-1000
20200212,042919,GIS元大93購01,0.27,0.27,0.27,0.27,+0.01,3.85,5000,1,1350,0,0,0,0,0,0,0,5000,-5000,-5000
20200212,04291P,鴻海富邦93售04,0.42,0.42,0.29,0.29,-0.13,-30.95,25000,3,7510,0,0,0,0,0,0,23000,2000,21000,21000
20200212,042927,道瓊反中信94購01,0.11,0.11,0.11,0.11,0.00,0.00,1000,1,110,0,0,0,0,0,0,0,0,0,0
20200212,042928,台積電中信95購01,,,,,0.00,0.00,0,0,0,0,0,0,0,0,0,0,0,0,0
20200212,042929,台積電中信95購02,5.85,5.90,5.70,5.90,+0.30,5.36,20000,12,116950,0,0,0,0,0,0,0,20000,-20000,-20000
20200212,04292P,台積電富邦93售04,,,,,0.00,0.00,0,0,0,0,0,0,0,0,0,0,0,0,0
20200212,042930,大立光中信94購01,1.11,1.14,1.11,1.14,+0.15,15.15,11000,3,12290,0,0,0,0,0,0,11000,0,11000,11000
20200212,042931,啟碁中信95購01,,,,,0.00,0.00,0,0,0,0,0,0,0,0,0,0,0,0,0
20200212,04293P,滬深2X元大96售02,1.65,1.65,1.65,1.65,0.00,0.00,20000,1,33000,0,0,0,0,0,0,0,20000,-20000,-20000
20200212,042941,永冠國票93購01,0.50,0.50,0.50,0.50,-0.02,-3.85,6000,1,3000,0,0,0,0,0,0,6000,0,6000,6000
20200212,042942,永冠國票94購01,,,,,0.00,0.00,0,0,0,0,0,0,0,0,0,0,0,0,0
20200212,04294P,台積電元大95售01,0.14,0.14,0.12,0.13,-0.02,-13.33,785000,13,100770,0,0,0,0,0,0,249000,536000,-287000,-287000
20200212,042953,鴻海台新01購01,5.25,5.90,5.25,5.90,+0.65,12.38,136000,15,744500,0,0,0,0,0,0,15000,121000,-106000,-106000
20200212,04295P,智邦元大93售10,0.19,0.22,0.19,0.22,0.00,0.00,80000,2,15500,0,0,0,0,0,0,80000,0,80000,80000
20200212,04296P,技嘉元大93售01,0.55,0.55,0.55,0.55,-0.05,-8.33,2000,2,1100,0,0,0,0,0,0,2000,0,2000,2000
20200212,04297P,微星元大93售03,,,,,0.00,0.00,0,0,0,0,0,0,0,0,0,0,0,0,0
20200212,04298P,祥碩元大93售02,0.03,0.03,0.03,0.03,0.00,0.00,200000,1,6000,0,0,0,0,0,0,200000,0,200000,200000
20200212,042993,葡萄王元大94購01,0.19,0.19,0.19,0.19,-0.01,-5.0,20000,1,3800,0,0,0,0,0,0,20000,0,20000,20000
20200212,042994,葡萄王元大94購02,0.47,0.47,0.47,0.47,0.00,0.00,30000,2,14100,0,0,0,0,0,0,0,30000,-30000,-30000
20200212,042997,新光鋼元大94購01,0.33,0.33,0.32,0.33,-0.01,-2.94,610000,4,200300,0,0,0,0,0,0,310000,300000,10000,10000
20200212,04299P,卜蜂中信93售02,0.33,0.33,0.33,0.33,0.00,0.00,100000,1,33000,0,0,0,0,0,0,0,100000,-100000,-100000
20200212,04300P,華通中信93售02,,,,,0.00,0.00,0,0,0,0,0,0,0,0,0,0,0,0,0
20200212,043018,新光金元大93購01,0.09,0.10,0.09,0.10,0.00,0.00,66000,4,6440,0,0,0,0,0,0,16000,50000,-34000,-34000
20200212,043019,華晶科元大94購01,,,,,0.00,0.00,0,0,0,0,0,0,0,0,0,0,0,0,0
20200212,04301P,微星中信93售01,0.46,0.52,0.45,0.52,-0.02,-3.7,52000,5,24590,0,0,0,0,0,0,39000,13000,26000,26000
20200212,043023,康普元大94購01,,,,,0.00,0.00,0,0,0,0,0,0,0,0,0,0,0,0,0
20200212,043029,S&P反1統一93購01,,,,,0.00,0.00,0,0,0,0,0,0,0,0,0,0,0,0,0
20200212,04302P,和碩中信93售01,,,,,0.00,0.00,0,0,0,0,0,0,0,0,0,0,0,0,0
20200212,04303P,義隆群益93售02,,,,,0.00,0.00,0,0,0,0,0,0,0,0,0,0,0,0,0
20200212,043040,永冠元富94購01,0.13,0.13,0.13,0.13,+0.01,8.33,301000,2,39130,0,0,0,0,0,0,301000,0,301000,301000
20200212,043047,永冠國泰93購01,,,,,0.00,0.00,0,0,0,0,0,0,0,0,0,0,0,0,0
20200212,043048,金寶國泰93購01,,,,,0.00,0.00,0,0,0,0,0,0,0,0,0,0,0,0,0
20200212,043049,奇鋐國泰93購01,,,,,0.00,0.00,0,0,0,0,0,0,0,0,0,0,0,0,0
20200212,04304P,上海銀亞東93售01,,,,,0.00,0.00,0,0,0,0,0,0,0,0,0,0,0,0,0
20200212,043050,欣興國泰93購01,,,,,0.00,0.00,0,0,0,0,0,0,0,0,0,0,0,0,0
20200212,043051,天鈺國泰93購01,0.03,0.03,0.03,0.03,0.00,0.00,25000,1,750,0,0,0,0,0,0,25000,0,25000,25000
20200212,043052,矽力國泰93購01,,,,,0.00,0.00,0,0,0,0,0,0,0,0,0,0,0,0,0
20200212,04305P,A50反1凱基93售02,,,,,0.00,0.00,0,0,0,0,0,0,0,0,0,0,0,0,0
20200212,043060,欣興中信93購01,,,,,0.00,0.00,0,0,0,0,0,0,0,0,0,0,0,0,0
20200212,043066,上銀兆豐93購02,,,,,0.00,0.00,0,0,0,0,0,0,0,0,0,0,0,0,0
20200212,043068,TPK兆豐93購01,,,,,0.00,0.00,0,0,0,0,0,0,0,0,0,0,0,0,0
20200212,04306P,上銀凱基93售10,,,,,0.00,0.00,0,0,0,0,0,0,0,0,0,0,0,0,0
20200212,04307P,國巨凱基93售09,,,,,0.00,0.00,0,0,0,0,0,0,0,0,0,0,0,0,0
20200212,04308P,京元電凱基93售06,1.56,1.56,1.56,1.56,-0.15,-8.77,1000,1,1560,0,0,0,0,0,0,1000,0,1000,1000
20200212,04309P,滬深2X統一93售05,,,,,0.00,0.00,0,0,0,0,0,0,0,0,0,0,0,0,0
20200212,04310P,京元電統一93售03,1.12,1.12,1.11,1.12,0.00,0.00,18000,3,20100,0,0,0,0,0,0,0,18000,-18000,-18000
20200212,04311P,奇力新統一95售01,,,,,0.00,0.00,0,0,0,0,0,0,0,0,0,0,0,0,0
20200212,04312P,聯茂統一93售02,,,,,0.00,0.00,0,0,0,0,0,0,0,0,0,0,0,0,0
20200212,04313P,國巨元富95售03,0.10,0.10,0.10,0.10,-0.01,-9.09,240000,5,24000,0,0,0,0,0,0,0,240000,-240000,-240000
20200212,043144,台肥統一93購01,0.62,0.67,0.62,0.67,0.00,0.00,55000,6,36000,0,0,0,0,0,0,15000,30000,-15000,-15000
20200212,043148,裕隆統一93購01,,,,,0.00,0.00,0,0,0,0,0,0,0,0,0,0,0,0,0
20200212,04314P,聯茂元富93售01,1.24,1.24,1.05,1.05,-0.36,-25.53,16000,7,18740,0,0,0,0,0,0,16000,0,16000,16000
20200212,043156,大立光統一94購01,0.90,1.02,0.90,1.02,+0.15,17.24,317000,5,308300,0,0,0,0,0,0,250000,67000,183000,183000
20200212,04315P,台光電國票93售04,,,,,0.00,0.00,0,0,0,0,0,0,0,0,0,0,0,0,0
20200212,04316P,華新科國票94售05,,,,,0.00,0.00,0,0,0,0,0,0,0,0,0,0,0,0,0
20200212,043170,喬山國泰93購01,,,,,0.00,0.00,0,0,0,0,0,0,0,0,0,0,0,0,0
20200212,043171,冠德國泰93購01,,,,,0.00,0.00,0,0,0,0,0,0,0,0,0,0,0,0,0
20200212,043173,合勤控國泰93購01,,,,,0.00,0.00,0,0,0,0,0,0,0,0,0,0,0,0,0
20200212,043174,元翎國泰93購01,,,,,0.00,0.00,0,0,0,0,0,0,0,0,0,0,0,0,0
20200212,043175,傳奇國泰93購01,,,,,0.00,0.00,0,0,0,0,0,0,0,0,0,0,0,0,0
20200212,043177,致新國泰93購01,,,,,0.00,0.00,0,0,0,0,0,0,0,0,0,0,0,0,0
20200212,04317P,樺漢國票93售03,,,,,0.00,0.00,0,0,0,0,0,0,0,0,0,0,0,0,0
20200212,04318P,大成鋼永豐93售02,,,,,0.00,0.00,0,0,0,0,0,0,0,0,0,0,0,0,0
20200212,043190,宏達電元大93購01,,,,,0.00,0.00,0,0,0,0,0,0,0,0,0,0,0,0,0
20200212,043197,揚明光元大93購03,,,,,0.00,0.00,0,0,0,0,0,0,0,0,0,0,0,0,0
20200212,04319P,健策永豐93售03,,,,,0.00,0.00,0,0,0,0,0,0,0,0,0,0,0,0,0
20200212,043202,緯穎元大94購01,,,,,0.00,0.00,0,0,0,0,0,0,0,0,0,0,0,0,0
20200212,04320P,亞德客元大93售07,0.33,0.33,0.31,0.31,-0.03,-8.82,52000,3,16560,0,0,0,0,0,0,20000,32000,-12000,-12000
20200212,04321P,國巨元大93售12,,,,,0.00,0.00,0,0,0,0,0,0,0,0,0,0,0,0,0
20200212,043229,T50正2中信93購02,,,,,0.00,0.00,0,0,0,0,0,0,0,0,0,0,0,0,0
20200212,04322P,可成元大94售01,1.68,1.68,1.59,1.60,-0.27,-14.44,45000,5,73630,0,0,0,0,0,0,16000,45000,-29000,-29000
20200212,043231,鴻海中信95購01,0.40,0.50,0.39,0.50,+0.15,42.86,281000,17,120360,0,0,0,0,0,0,229000,19000,210000,210000
20200212,043234,緯穎中信93購01,,,,,0.00,0.00,0,0,0,0,0,0,0,0,0,0,0,0,0
20200212,043235,柏文中信93購01,,,,,0.00,0.00,0,0,0,0,0,0,0,0,0,0,0,0,0
20200212,043236,台灣50兆豐93購02,0.97,1.22,0.96,1.22,+0.38,45.24,21000,6,24120,0,0,0,0,0,0,3000,18000,-15000,-15000
20200212,043238,健策兆豐93購01,,,,,0.00,0.00,0,0,0,0,0,0,0,0,0,0,0,0,0
20200212,04323P,強茂元大93售02,,,,,0.00,0.00,0,0,0,0,0,0,0,0,0,0,0,0,0
20200212,04324P,新光金元大94售01,,,,,0.00,0.00,0,0,0,0,0,0,0,0,0,0,0,0,0
20200212,04325P,創意元大93售06,0.92,0.96,0.87,0.87,+0.03,3.57,113000,7,106510,0,0,0,0,0,0,71000,103000,-32000,-32000
20200212,04326P,泰鼎元大93售06,0.13,0.13,0.13,0.13,0.00,0.00,240000,1,31200,240000,0,240000,0,0,0,0,240000,-240000,0
20200212,043272,羅麗芬國泰94購01,,,,,0.00,0.00,0,0,0,0,0,0,0,0,0,0,0,0,0
20200212,043273,緯穎國泰93購01,,,,,0.00,0.00,0,0,0,0,0,0,0,0,0,0,0,0,0
20200212,04327P,台積電國泰95售01,0.21,0.21,0.20,0.20,-0.04,-16.67,60000,3,12400,0,0,0,0,0,0,0,0,0,0
20200212,04328P,台達電中信93售02,,,,,0.00,0.00,0,0,0,0,0,0,0,0,0,0,0,0,0
20200212,043290,揚明光元大94購01,,,,,0.00,0.00,0,0,0,0,0,0,0,0,0,0,0,0,0
20200212,043295,易華電元大93購01,,,,,0.00,0.00,0,0,0,0,0,0,0,0,0,0,0,0,0
20200212,043297,緯穎元大93購01,,,,,0.00,0.00,0,0,0,0,0,0,0,0,0,0,0,0,0
20200212,04329P,TPK群益93售04,3.08,3.08,3.08,3.08,0.00,0.00,6000,1,18480,0,0,0,0,0,0,0,6000,-6000,-6000
20200212,04330P,台達電亞東93售02,,,,,0.00,0.00,0,0,0,0,0,0,0,0,0,0,0,0,0
20200212,04331P,健策國票93售02,,,,,0.00,0.00,0,0,0,0,0,0,0,0,0,0,0,0,0
20200212,043324,緯穎統一93購01,,,,,0.00,0.00,0,0,0,0,0,0,0,0,0,0,0,0,0
20200212,04332P,A50正2日盛93售01,,,,,0.00,0.00,0,0,0,0,0,0,0,0,0,0,0,0,0
20200212,04333P,儒鴻凱基93售06,2.29,2.29,2.29,2.29,+0.02,0.88,11000,1,25190,0,0,0,0,0,0,11000,0,11000,11000
20200212,043344,可成富邦93購01,,,,,0.00,0.00,0,0,0,0,0,0,0,0,0,0,0,0,0
20200212,043346,TPK富邦93購01,,,,,0.00,0.00,0,0,0,0,0,0,0,0,0,0,0,0,0
20200212,043349,T50反1國票93購01,,,,,0.00,0.00,0,0,0,0,0,0,0,0,0,0,0,0,0
20200212,04334P,中石化康和93售01,,,,,0.00,0.00,0,0,0,0,0,0,0,0,0,0,0,0,0
20200212,04335P,大成鋼元大93售01,,,,,0.00,0.00,0,0,0,0,0,0,0,0,0,0,0,0,0
20200212,043360,和鑫國票93購01,,,,,0.00,0.00,0,0,0,0,0,0,0,0,0,0,0,0,0
20200212,04336P,台達電元大93售04,0.44,0.44,0.44,0.44,-0.06,-12.0,1000,1,440,0,0,0,0,0,0,1000,0,1000,1000
20200212,043378,宏達電元大93購02,,,,,0.00,0.00,0,0,0,0,0,0,0,0,0,0,0,0,0
20200212,04337P,台積電元大93售25,0.07,0.07,0.07,0.07,-0.01,-12.5,100000,1,7000,0,0,0,0,0,0,0,100000,-100000,-100000
20200212,043381,大立光元大93購02,,,,,0.00,0.00,0,0,0,0,0,0,0,0,0,0,0,0,0
20200212,04338P,亞光元大93售04,0.88,0.88,0.88,0.88,-0.05,-5.38,50000,1,44000,0,0,0,0,0,0,0,50000,-50000,-50000
20200212,043390,康控元大93購01,0.04,0.04,0.04,0.04,0.00,0.00,203000,3,8120,0,0,0,0,0,0,203000,0,203000,203000
20200212,043391,康控元大94購01,0.19,0.19,0.18,0.18,+0.02,12.5,55000,2,10400,0,0,0,0,0,0,0,50000,-50000,-50000
20200212,043394,易華電元大94購01,,,,,0.00,0.00,0,0,0,0,0,0,0,0,0,0,0,0,0
20200212,043396,世紀鋼元大93購01,0.45,0.45,0.45,0.45,0.00,0.00,1000,1,450,0,0,0,0,0,0,1000,0,1000,1000
20200212,04339P,欣興元大93售08,,,,,0.00,0.00,0,0,0,0,0,0,0,0,0,0,0,0,0
20200212,04340P,易華電元大94售02,0.92,0.92,0.91,0.92,-0.02,-2.13,116000,7,105920,0,0,0,0,0,0,70000,36000,34000,34000
20200212,04341P,美律永豐93售03,0.34,0.34,0.34,0.34,-0.08,-19.05,30000,1,10200,0,0,0,0,0,0,0,30000,-30000,-30000
20200212,04342P,揚明光永豐93售03,,,,,0.00,0.00,0,0,0,0,0,0,0,0,0,0,0,0,0
20200212,04343P,啟碁永豐93售02,,,,,0.00,0.00,0,0,0,0,0,0,0,0,0,0,0,0,0
20200212,043442,大立光台新01購01,4.45,4.59,4.44,4.59,+0.31,7.24,9000,3,40420,0,0,0,0,0,0,6000,3000,3000,3000
20200212,04344P,台達電國泰94售01,0.64,0.65,0.63,0.64,-0.05,-7.25,190000,11,121940,0,0,0,0,0,0,190000,190000,0,0
20200212,043457,鴻海元大93購01,0.18,0.18,0.18,0.18,+0.01,5.88,15000,1,2700,0,0,0,0,0,0,15000,0,15000,15000
20200212,04345P,景碩國泰94售02,0.34,0.34,0.34,0.34,-0.08,-19.05,6000,1,2040,0,0,0,0,0,0,0,6000,-6000,-6000
20200212,043460,台積電元大93購01,,,,,0.00,0.00,0,0,0,0,0,0,0,0,0,0,0,0,0
20200212,043467,全新元大93購01,1.87,1.96,1.87,1.96,+0.25,14.62,3000,2,5700,0,0,0,0,0,0,2000,1000,1000,1000
20200212,04346P,大立光兆豐95售02,0.25,0.25,0.25,0.25,0.00,0.00,40000,1,10000,0,0,0,0,0,0,0,40000,-40000,-40000
20200212,04347P,全新群益94售01,,,,,0.00,0.00,0,0,0,0,0,0,0,0,0,0,0,0,0
20200212,043481,華新群益93購01,,,,,0.00,0.00,0,0,0,0,0,0,0,0,0,0,0,0,0
20200212,043484,TPK群益93購01,,,,,0.00,0.00,0,0,0,0,0,0,0,0,0,0,0,0,0
20200212,04348P,燿華國票94售01,,,,,0.00,0.00,0,0,0,0,0,0,0,0,0,0,0,0,0
20200212,04349P,美律國票94售02,0.36,0.36,0.32,0.32,-0.17,-34.69,201000,2,72320,0,0,0,0,0,0,200000,1000,199000,199000
20200212,04350P,欣興國票94售01,1.05,1.05,1.05,1.05,-0.37,-26.06,11000,1,11550,0,0,0,0,0,0,0,11000,-11000,-11000
20200212,043511,上銀富邦93購01,,,,,0.00,0.00,0,0,0,0,0,0,0,0,0,0,0,0,0
20200212,043513,台灣50元大96購05,1.95,2.01,1.95,2.01,+0.11,5.79,25000,5,49490,0,0,0,0,0,0,25000,0,25000,25000
20200212,04351P,鴻海永豐94售01,,,,,0.00,0.00,0,0,0,0,0,0,0,0,0,0,0,0,0
20200212,043523,奇鋐元大93購01,,,,,0.00,0.00,0,0,0,0,0,0,0,0,0,0,0,0,0
20200212,04352P,國巨永豐94售01,,,,,0.00,0.00,0,0,0,0,0,0,0,0,0,0,0,0,0
20200212,043537,智伸科兆豐93購01,,,,,0.00,0.00,0,0,0,0,0,0,0,0,0,0,0,0,0
20200212,043538,元石油國票97購01,0.08,0.08,0.08,0.08,0.00,0.00,276000,6,22080,0,0,0,0,0,0,0,276000,-276000,-276000
20200212,04353P,全新永豐94售01,0.16,0.16,0.16,0.16,-0.03,-15.79,10000,1,1600,0,0,0,0,0,0,10000,0,10000,10000
20200212,04354P,華新科永豐94售01,,,,,0.00,0.00,0,0,0,0,0,0,0,0,0,0,0,0,0
20200212,04355P,大立光永豐94售02,0.29,0.29,0.29,0.29,0.00,0.00,200000,1,58000,0,0,0,0,0,0,200000,0,200000,200000
20200212,04356P,嘉晶永豐94售01,,,,,0.00,0.00,0,0,0,0,0,0,0,0,0,0,0,0,0
20200212,04357P,智易永豐94售01,,,,,0.00,0.00,0,0,0,0,0,0,0,0,0,0,0,0,0
20200212,043580,大立光元富94購01,1.67,1.79,1.67,1.79,+0.21,13.29,23000,5,39380,0,0,0,0,0,0,23000,2000,21000,21000
20200212,043585,道瓊反元大94購01,,,,,0.00,0.00,0,0,0,0,0,0,0,0,0,0,0,0,0
20200212,04358P,TPK永豐94售01,,,,,0.00,0.00,0,0,0,0,0,0,0,0,0,0,0,0,0
20200212,043590,旺宏元大93購01,,,,,0.00,0.00,0,0,0,0,0,0,0,0,0,0,0,0,0
20200212,043599,宏達電元大93購03,,,,,0.00,0.00,0,0,0,0,0,0,0,0,0,0,0,0,0
20200212,04359P,中磊永豐94售01,,,,,0.00,0.00,0,0,0,0,0,0,0,0,0,0,0,0,0
20200212,043601,亞光元大93購01,,,,,0.00,0.00,0,0,0,0,0,0,0,0,0,0,0,0,0
20200212,043605,創意元大93購01,0.63,0.63,0.63,0.63,-0.03,-4.55,1000,1,630,0,0,0,0,0,0,0,1000,-1000,-1000
20200212,043607,GIS元大93購02,,,,,0.00,0.00,0,0,0,0,0,0,0,0,0,0,0,0,0
20200212,04360P,易華電永豐94售01,,,,,0.00,0.00,0,0,0,0,0,0,0,0,0,0,0,0,0
20200212,04361P,台積電統一94售05,,,,,0.00,0.00,0,0,0,0,0,0,0,0,0,0,0,0,0
20200212,04362P,聯詠統一94售01,,,,,0.00,0.00,0,0,0,0,0,0,0,0,0,0,0,0,0
20200212,04363P,儒鴻元富94售01,1.42,1.50,1.40,1.43,+0.08,5.93,254000,19,364720,0,0,0,0,0,0,101000,153000,-52000,-52000
20200212,043641,深中小國票94購01,0.64,0.64,0.64,0.64,0.00,0.00,30000,1,19200,0,0,0,0,0,0,0,30000,-30000,-30000
20200212,043642,元金2X國票97購01,1.17,1.17,1.17,1.17,0.00,0.00,20000,1,23400,0,0,0,0,0,0,0,20000,-20000,-20000
20200212,04364P,台積電元富94售03,,,,,0.00,0.00,0,0,0,0,0,0,0,0,0,0,0,0,0
20200212,043650,喬山國泰93購02,0.33,0.33,0.33,0.33,+0.07,26.92,22000,2,7260,0,0,0,0,0,0,22000,0,22000,22000
20200212,043651,旺宏國泰93購01,,,,,0.00,0.00,0,0,0,0,0,0,0,0,0,0,0,0,0
20200212,043652,微星國泰93購01,1.12,1.12,0.90,0.92,-0.01,-1.08,265000,21,250500,0,0,0,0,0,0,15000,250000,-235000,-235000
20200212,043655,微星富邦93購01,0.91,0.91,0.80,0.80,0.00,0.00,15000,2,13100,0,0,0,0,0,0,15000,0,15000,15000
20200212,043656,上証反元大94購01,0.14,0.15,0.14,0.14,-0.08,-36.36,504000,8,70850,0,0,0,0,0,0,0,504000,-504000,-504000
20200212,04365P,台積電元富95售02,,,,,0.00,0.00,0,0,0,0,0,0,0,0,0,0,0,0,0
20200212,043660,華新科元大93購01,3.49,3.49,3.49,3.49,+0.17,5.12,4000,2,13960,0,0,0,0,0,0,4000,0,4000,4000
20200212,043661,華新科元大93購02,,,,,0.00,0.00,0,0,0,0,0,0,0,0,0,0,0,0,0
20200212,043665,和鑫元大93購01,0.16,0.17,0.16,0.17,+0.01,6.25,3000,2,490,0,0,0,0,0,0,2000,1000,1000,1000
20200212,04366P,全新元富95售01,0.87,0.87,0.81,0.81,-0.23,-22.12,26000,2,22260,0,0,0,0,0,0,20000,6000,14000,14000
20200212,043671,GIS元大93購03,,,,,0.00,0.00,0,0,0,0,0,0,0,0,0,0,0,0,0
20200212,043672,易華電元大93購02,,,,,0.00,0.00,0,0,0,0,0,0,0,0,0,0,0,0,0
20200212,043673,緯穎元大93購02,,,,,0.00,0.00,0,0,0,0,0,0,0,0,0,0,0,0,0
20200212,04367P,滬深2X凱基95售04,,,,,0.00,0.00,0,0,0,0,0,0,0,0,0,0,0,0,0
20200212,04368P,台積電凱基94售02,,,,,0.00,0.00,0,0,0,0,0,0,0,0,0,0,0,0,0
20200212,043693,為升兆豐93購01,,,,,0.00,0.00,0,0,0,0,0,0,0,0,0,0,0,0,0
20200212,043694,華新科兆豐92購01,,,,,0.00,0.00,0,0,0,0,0,0,0,0,0,0,0,0,0
20200212,043695,臻鼎兆豐92購01,0.68,1.26,0.68,0.85,+0.32,60.38,40000,4,39600,0,0,0,0,0,0,10000,20000,-10000,-10000
20200212,043696,瑞儀兆豐93購01,0.30,0.30,0.30,0.30,0.00,0.00,50000,1,15000,0,0,0,0,0,0,50000,0,50000,50000
20200212,043697,聯茂兆豐92購01,,,,,0.00,0.00,0,0,0,0,0,0,0,0,0,0,0,0,0
20200212,04369P,台光電凱基94售04,,,,,0.00,0.00,0,0,0,0,0,0,0,0,0,0,0,0,0
20200212,04370P,聯茂凱基94售05,0.61,0.61,0.44,0.44,-0.40,-47.62,16000,3,7510,0,0,0,0,0,0,1000,15000,-14000,-14000
20200212,043710,台積電群益92購04,,,,,0.00,0.00,0,0,0,0,0,0,0,0,0,0,0,0,0
20200212,043715,易華電群益93購01,,,,,0.00,0.00,0,0,0,0,0,0,0,0,0,0,0,0,0
20200212,043719,國巨統一93購02,,,,,0.00,0.00,0,0,0,0,0,0,0,0,0,0,0,0,0
20200212,04371P,臺股指凱基94售01,,,,,0.00,0.00,0,0,0,0,0,0,0,0,0,0,0,0,0
20200212,043726,T50反1國泰93購01,,,,,0.00,0.00,0,0,0,0,0,0,0,0,0,0,0,0,0
20200212,043727,力山國泰92購01,,,,,0.00,0.00,0,0,0,0,0,0,0,0,0,0,0,0,0
20200212,043728,美律國泰93購01,0.43,0.56,0.43,0.54,+0.20,58.82,158000,21,80270,0,0,0,0,0,0,0,158000,-158000,-158000
20200212,043729,和鑫國泰92購01,,,,,0.00,0.00,0,0,0,0,0,0,0,0,0,0,0,0,0
20200212,04372P,臺股指凱基94售02,0.14,0.14,0.14,0.14,-0.03,-17.65,50000,1,7000,0,0,0,0,0,0,0,50000,-50000,-50000
20200212,043730,旭富國泰93購01,0.79,1.13,0.75,1.08,+0.38,54.29,292000,68,283080,0,0,0,0,0,0,90000,202000,-112000,-112000
20200212,043731,泰鼎國泰92購01,,,,,0.00,0.00,0,0,0,0,0,0,0,0,0,0,0,0,0
20200212,043732,柏文國泰92購02,,,,,0.00,0.00,0,0,0,0,0,0,0,0,0,0,0,0,0
20200212,043733,深中小富邦92購01,,,,,0.00,0.00,0,0,0,0,0,0,0,0,0,0,0,0,0
20200212,043734,大立光富邦92購07,,,,,0.00,0.00,0,0,0,0,0,0,0,0,0,0,0,0,0
20200212,043735,元金2X元大94購01,,,,,0.00,0.00,0,0,0,0,0,0,0,0,0,0,0,0,0
20200212,043736,力山元大92購02,,,,,0.00,0.00,0,0,0,0,0,0,0,0,0,0,0,0,0
20200212,043739,國巨元大92購09,,,,,0.00,0.00,0,0,0,0,0,0,0,0,0,0,0,0,0
20200212,04373P,滬深2X元大97售01,1.19,1.26,1.19,1.21,0.00,0.00,1574000,28,1916080,0,0,0,0,0,0,1093000,821000,272000,272000
20200212,043740,國巨元大93購02,,,,,0.00,0.00,0,0,0,0,0,0,0,0,0,0,0,0,0
20200212,043744,旺宏元大92購03,,,,,0.00,0.00,0,0,0,0,0,0,0,0,0,0,0,0,0
20200212,043745,旺宏元大92購04,,,,,0.00,0.00,0,0,0,0,0,0,0,0,0,0,0,0,0
20200212,043748,漢唐元大93購01,1.13,1.19,1.11,1.17,+0.02,1.74,337000,15,394370,0,0,0,0,0,0,337000,0,337000,337000
20200212,04374P,深中小元大94售03,0.08,0.08,0.06,0.06,0.00,0.00,120000,5,8700,0,0,0,0,0,0,0,120000,-120000,-120000
20200212,043750,美律元大93購01,0.25,0.25,0.25,0.25,0.00,0.00,20000,1,5000,0,0,0,0,0,0,20000,0,20000,20000
20200212,043753,聯發科元大92購02,2.01,2.41,1.97,2.41,+0.82,51.57,86000,8,175950,0,0,0,0,0,0,86000,0,86000,86000
20200212,043757,欣興元大93購01,0.93,1.04,0.93,1.04,+0.20,23.81,214000,16,208500,0,0,0,0,0,0,135000,114000,21000,21000
20200212,043758,創意元大92購03,0.01,0.01,0.01,0.01,0.00,0.00,510000,2,5100,0,0,0,0,0,0,510000,0,510000,510000
20200212,04375P,卜蜂元大94售01,0.79,0.80,0.79,0.80,-0.05,-5.88,108000,2,85520,0,0,0,0,0,0,88000,20000,68000,68000
20200212,043763,超眾元大92購01,,,,,0.00,0.00,0,0,0,0,0,0,0,0,0,0,0,0,0
20200212,043764,康友元大92購03,,,,,0.00,0.00,0,0,0,0,0,0,0,0,0,0,0,0,0
20200212,043765,GIS元大93購04,,,,,0.00,0.00,0,0,0,0,0,0,0,0,0,0,0,0,0
20200212,04376P,漢唐元大94售04,,,,,0.00,0.00,0,0,0,0,0,0,0,0,0,0,0,0,0
20200212,043770,亞德客兆豐92購01,,,,,0.00,0.00,0,0,0,0,0,0,0,0,0,0,0,0,0
20200212,043771,鴻海兆豐92購01,0.11,0.14,0.11,0.14,0.00,0.00,15000,2,1800,0,0,0,0,0,0,15000,0,15000,15000
20200212,043772,國巨兆豐92購01,,,,,0.00,0.00,0,0,0,0,0,0,0,0,0,0,0,0,0
20200212,043773,智邦兆豐93購01,,,,,0.00,0.00,0,0,0,0,0,0,0,0,0,0,0,0,0
20200212,043774,瑞昱兆豐92購01,0.96,0.96,0.85,0.85,+0.12,16.44,13000,2,12150,0,0,0,0,0,0,0,13000,-13000,-13000
20200212,043775,友達兆豐92購01,1.30,1.30,1.15,1.15,-0.15,-11.54,193000,4,222400,0,0,0,0,0,0,193000,0,193000,193000
20200212,043776,奇力新兆豐92購01,,,,,0.00,0.00,0,0,0,0,0,0,0,0,0,0,0,0,0
20200212,043777,宏達電兆豐92購01,,,,,0.00,0.00,0,0,0,0,0,0,0,0,0,0,0,0,0
20200212,043778,智原兆豐92購01,,,,,0.00,0.00,0,0,0,0,0,0,0,0,0,0,0,0,0
20200212,04377P,大立光元大94售04,0.96,0.96,0.96,0.96,0.00,0.00,3000,1,2880,0,0,0,0,0,0,3000,0,3000,3000
20200212,043780,瑞儀中信92購01,0.01,0.01,0.01,0.01,0.00,0.00,20000,20,200,0,0,0,0,0,0,0,20000,-20000,-20000
20200212,043784,鴻海凱基94購01,1.11,1.14,1.11,1.14,+0.11,10.68,27000,4,30290,0,0,0,0,0,0,27000,0,27000,27000
20200212,04378P,大立光元大94售05,,,,,0.00,0.00,0,0,0,0,0,0,0,0,0,0,0,0,0
20200212,04379P,大立光元大94售06,0.99,0.99,0.99,0.99,+0.01,1.02,10000,1,9900,0,0,0,0,0,0,0,10000,-10000,-10000
20200212,043803,台灣50永豐92購02,,,,,0.00,0.00,0,0,0,0,0,0,0,0,0,0,0,0,0
20200212,04380P,欣興元大94售02,0.92,0.92,0.75,0.75,-0.33,-30.56,43000,12,35150,0,0,0,0,0,0,0,43000,-43000,-43000
20200212,04381P,世紀鋼元大94售01,,,,,0.00,0.00,0,0,0,0,0,0,0,0,0,0,0,0,0
20200212,043823,羅麗芬群益94購01,,,,,0.00,0.00,0,0,0,0,0,0,0,0,0,0,0,0,0
20200212,043824,世紀鋼群益92購01,,,,,0.00,0.00,0,0,0,0,0,0,0,0,0,0,0,0,0
20200212,04382P,美律國泰95售01,,,,,0.00,0.00,0,0,0,0,0,0,0,0,0,0,0,0,0
20200212,043832,SP黃豆國票95購01,,,,,0.00,0.00,0,0,0,0,0,0,0,0,0,0,0,0,0
20200212,043835,宏達電國票92購01,,,,,0.00,0.00,0,0,0,0,0,0,0,0,0,0,0,0,0
20200212,04383P,泰鼎國泰95售01,0.42,0.45,0.42,0.44,-0.05,-10.2,285000,8,121650,40000,0,40000,0,0,0,210000,75000,135000,175000
20200212,043847,台光電國泰92購01,,,,,0.00,0.00,0,0,0,0,0,0,0,0,0,0,0,0,0
20200212,043848,日月光國泰92購01,,,,,0.00,0.00,0,0,0,0,0,0,0,0,0,0,0,0,0
20200212,043849,達興國泰92購01,0.01,0.01,0.01,0.01,0.00,0.00,30000,1,300,0,0,0,0,0,0,30000,0,30000,30000
20200212,04384P,上証2X中信96售01,0.95,0.95,0.95,0.95,-0.04,-4.04,5000,1,4750,0,0,0,0,0,0,5000,0,5000,5000
20200212,043850,台表科國泰93購01,,,,,0.00,0.00,0,0,0,0,0,0,0,0,0,0,0,0,0
20200212,043851,國泰金永昌93購01,,,,,0.00,0.00,0,0,0,0,0,0,0,0,0,0,0,0,0
20200212,043853,力山富邦93購01,,,,,0.00,0.00,0,0,0,0,0,0,0,0,0,0,0,0,0
20200212,043854,華新科富邦93購01,2.18,2.18,2.18,2.18,+0.14,6.86,1000,1,2180,0,0,0,0,0,0,1000,0,1000,1000
20200212,043855,創意富邦93購01,,,,,0.00,0.00,0,0,0,0,0,0,0,0,0,0,0,0,0
20200212,043856,GIS富邦92購01,,,,,0.00,0.00,0,0,0,0,0,0,0,0,0,0,0,0,0
20200212,04385P,可成日盛94售01,,,,,0.00,0.00,0,0,0,0,0,0,0,0,0,0,0,0,0
20200212,043860,力山元大92購03,,,,,0.00,0.00,0,0,0,0,0,0,0,0,0,0,0,0,0
20200212,043862,和大元大92購01,,,,,0.00,0.00,0,0,0,0,0,0,0,0,0,0,0,0,0
20200212,043867,國巨元大92購10,,,,,0.00,0.00,0,0,0,0,0,0,0,0,0,0,0,0,0
20200212,04386P,大立光日盛94售01,0.29,0.29,0.29,0.29,0.00,0.00,599000,2,173710,0,0,0,0,0,0,599000,0,599000,599000
20200212,043870,光磊元大92購01,,,,,0.00,0.00,0,0,0,0,0,0,0,0,0,0,0,0,0
20200212,043879,貿聯元大92購01,,,,,0.00,0.00,0,0,0,0,0,0,0,0,0,0,0,0,0
20200212,04387P,玉晶光日盛94售01,,,,,0.00,0.00,0,0,0,0,0,0,0,0,0,0,0,0,0
20200212,043884,臻鼎元大92購01,1.53,1.53,1.53,1.53,+0.64,71.91,6000,2,9180,0,0,0,0,0,0,6000,0,6000,6000
20200212,043889,台表科元大93購01,1.89,1.89,1.89,1.89,0.00,0.00,1000,1,1890,0,0,0,0,0,0,1000,0,1000,1000
20200212,04388P,滬深2X凱基95售05,,,,,0.00,0.00,0,0,0,0,0,0,0,0,0,0,0,0,0
20200212,043891,羅麗芬元大94購01,0.04,0.04,0.04,0.04,0.00,0.00,12000,2,480,0,0,0,0,0,0,2000,10000,-8000,-8000
20200212,043892,矽創元大92購01,,,,,0.00,0.00,0,0,0,0,0,0,0,0,0,0,0,0,0
20200212,043894,百和元大92購01,,,,,0.00,0.00,0,0,0,0,0,0,0,0,0,0,0,0,0
20200212,043895,鴻海群益92購01,0.90,1.15,0.90,1.15,+0.52,82.54,34000,4,35850,0,0,0,0,0,0,34000,0,34000,34000
20200212,043896,台積電群益92購06,,,,,0.00,0.00,0,0,0,0,0,0,0,0,0,0,0,0,0
20200212,043898,可成群益92購02,,,,,0.00,0.00,0,0,0,0,0,0,0,0,0,0,0,0,0
20200212,04389P,台積電凱基94售04,,,,,0.00,0.00,0,0,0,0,0,0,0,0,0,0,0,0,0
20200212,043900,利勤群益92購02,,,,,0.00,0.00,0,0,0,0,0,0,0,0,0,0,0,0,0
20200212,043907,鴻海凱基93購01,0.83,1.01,0.80,1.01,+0.27,36.49,182000,8,150760,0,0,0,0,0,0,75000,107000,-32000,-32000
20200212,043908,鴻海凱基93購02,0.05,0.07,0.05,0.07,0.00,0.00,20000,2,1200,0,0,0,0,0,0,20000,0,20000,20000
20200212,043909,台光電凱基93購01,0.59,0.79,0.59,0.72,+0.17,30.91,33000,3,21370,0,0,0,0,0,0,30000,3000,27000,27000
20200212,04390P,台積電凱基94售05,,,,,0.00,0.00,0,0,0,0,0,0,0,0,0,0,0,0,0
20200212,043912,華新科凱基93購01,4.64,4.64,4.64,4.64,+0.20,4.5,25000,3,116000,0,0,0,0,0,0,25000,0,25000,25000
20200212,043913,富邦金凱基92購01,0.02,0.02,0.02,0.02,0.00,0.00,30000,1,600,0,0,0,0,0,0,30000,0,30000,30000
20200212,043916,群創凱基93購01,1.04,1.04,0.98,1.00,+0.03,3.09,286000,10,286260,0,0,0,0,0,0,263000,68000,195000,195000
20200212,04391P,玉晶光凱基95售03,0.24,0.24,0.24,0.24,-0.03,-11.11,10000,1,2400,0,0,0,0,0,0,0,10000,-10000,-10000
20200212,043920,瑞儀凱基93購01,,,,,0.00,0.00,0,0,0,0,0,0,0,0,0,0,0,0,0
20200212,043921,台表科凱基93購01,,,,,0.00,0.00,0,0,0,0,0,0,0,0,0,0,0,0,0
20200212,043924,世紀鋼凱基93購01,,,,,0.00,0.00,0,0,0,0,0,0,0,0,0,0,0,0,0
20200212,04392P,牧德凱基94售05,,,,,0.00,0.00,0,0,0,0,0,0,0,0,0,0,0,0,0
20200212,043935,力山兆豐92購01,,,,,0.00,0.00,0,0,0,0,0,0,0,0,0,0,0,0,0
20200212,043936,和大兆豐92購01,,,,,0.00,0.00,0,0,0,0,0,0,0,0,0,0,0,0,0
20200212,043937,華通兆豐92購01,,,,,0.00,0.00,0,0,0,0,0,0,0,0,0,0,0,0,0
20200212,043938,華邦電兆豐93購01,0.12,0.12,0.12,0.12,+0.04,50.0,10000,2,1200,0,0,0,0,0,0,0,10000,-10000,-10000
20200212,04393P,牧德凱基94售06,,,,,0.00,0.00,0,0,0,0,0,0,0,0,0,0,0,0,0
20200212,043940,京元電兆豐92購01,1.21,1.33,1.21,1.33,+0.20,17.7,76000,5,97920,0,0,0,0,0,0,76000,0,76000,76000
20200212,043941,華新科兆豐92購02,,,,,0.00,0.00,0,0,0,0,0,0,0,0,0,0,0,0,0
20200212,043944,欣興兆豐93購02,1.09,1.27,1.09,1.27,+0.41,47.67,77000,13,92050,0,0,0,0,0,0,0,77000,-77000,-77000
20200212,043945,智易兆豐92購02,,,,,0.00,0.00,0,0,0,0,0,0,0,0,0,0,0,0,0
20200212,043948,台表科兆豐92購01,,,,,0.00,0.00,0,0,0,0,0,0,0,0,0,0,0,0,0
20200212,04394P,臻鼎凱基94售01,,,,,0.00,0.00,0,0,0,0,0,0,0,0,0,0,0,0,0
20200212,043958,臻鼎元富94購01,0.72,0.86,0.52,0.54,+0.07,14.89,679000,37,457460,0,0,0,0,0,0,311000,363000,-52000,-52000
20200212,04395P,台積電群益94售06,0.08,0.09,0.07,0.08,-0.02,-20.0,180000,5,14710,0,0,0,0,0,0,19000,161000,-142000,-142000
20200212,043961,道瓊反國泰94購01,,,,,0.00,0.00,0,0,0,0,0,0,0,0,0,0,0,0,0
20200212,043962,亞泥國泰92購01,,,,,0.00,0.00,0,0,0,0,0,0,0,0,0,0,0,0,0
20200212,043963,台化國泰92購01,,,,,0.00,0.00,0,0,0,0,0,0,0,0,0,0,0,0,0
20200212,043964,台肥國泰92購01,,,,,0.00,0.00,0,0,0,0,0,0,0,0,0,0,0,0,0
20200212,043965,宏盛國泰92購01,,,,,0.00,0.00,0,0,0,0,0,0,0,0,0,0,0,0,0
20200212,043966,潤泰全國泰92購01,,,,,0.00,0.00,0,0,0,0,0,0,0,0,0,0,0,0,0
20200212,043967,廣越國泰92購01,,,,,0.00,0.00,0,0,0,0,0,0,0,0,0,0,0,0,0
20200212,043968,易華電國泰92購02,,,,,0.00,0.00,0,0,0,0,0,0,0,0,0,0,0,0,0
20200212,043969,美利達國泰92購01,,,,,0.00,0.00,0,0,0,0,0,0,0,0,0,0,0,0,0
20200212,04396P,玉晶光群益94售02,,,,,0.00,0.00,0,0,0,0,0,0,0,0,0,0,0,0,0
20200212,043970,為升富邦94購01,0.12,0.12,0.12,0.12,0.00,0.00,30000,1,3600,0,0,0,0,0,0,0,30000,-30000,-30000
20200212,043971,友達富邦92購01,1.25,1.25,1.20,1.20,-0.20,-14.29,3000,2,3700,0,0,0,0,0,0,2000,1000,1000,1000
20200212,043972,大立光富邦93購02,,,,,0.00,0.00,0,0,0,0,0,0,0,0,0,0,0,0,0
20200212,043973,元金2X元大94購02,,,,,0.00,0.00,0,0,0,0,0,0,0,0,0,0,0,0,0
20200212,04397P,玉晶光群益95售03,,,,,0.00,0.00,0,0,0,0,0,0,0,0,0,0,0,0,0
20200212,043980,旺宏元大92購05,,,,,0.00,0.00,0,0,0,0,0,0,0,0,0,0,0,0,0
20200212,043983,華邦電元大92購01,,,,,0.00,0.00,0,0,0,0,0,0,0,0,0,0,0,0,0
20200212,04398P,致伸群益94售02,,,,,0.00,0.00,0,0,0,0,0,0,0,0,0,0,0,0,0
20200212,043990,智易元大93購01,,,,,0.00,0.00,0,0,0,0,0,0,0,0,0,0,0,0,0
20200212,043991,TPK元大92購01,,,,,0.00,0.00,0,0,0,0,0,0,0,0,0,0,0,0,0
20200212,043992,康控元大93購02,,,,,0.00,0.00,0,0,0,0,0,0,0,0,0,0,0,0,0
20200212,04399P,樺漢群益94售01,0.90,0.90,0.90,0.90,-0.11,-10.89,6000,6,5400,0,0,0,0,0,0,6000,0,6000,6000
20200212,044003,聯發科兆豐93購01,0.75,0.88,0.75,0.87,+0.24,38.1,902000,38,746450,0,0,0,0,0,0,385000,515000,-130000,-130000
20200212,04400P,台積電兆豐95售02,,,,,0.00,0.00,0,0,0,0,0,0,0,0,0,0,0,0,0
20200212,044010,華通凱基93購01,3.35,4.73,3.35,4.45,+1.15,34.85,127000,20,541880,0,0,0,0,0,0,67000,97000,-30000,-30000
20200212,044011,鴻海凱基93購03,,,,,0.00,0.00,0,0,0,0,0,0,0,0,0,0,0,0,0
20200212,044013,友達凱基93購01,1.31,1.31,1.31,1.31,-0.22,-14.38,130000,2,170300,0,0,0,0,0,0,130000,0,130000,130000
20200212,044016,義隆凱基93購01,1.95,1.95,0.05,1.86,+0.28,17.72,233000,15,419570,0,0,0,0,0,0,182000,51000,131000,131000
20200212,04401P,玉晶光兆豐94售01,,,,,0.00,0.00,0,0,0,0,0,0,0,0,0,0,0,0,0
20200212,044022,健策凱基93購02,3.64,3.78,2.89,3.78,+0.36,10.53,111000,21,400470,0,0,0,0,0,0,107000,3000,104000,104000
20200212,044024,祥碩凱基93購01,3.15,3.46,3.15,3.46,+0.51,17.29,4000,2,13530,0,0,0,0,0,0,1000,3000,-2000,-2000
20200212,044025,台表科凱基93購02,,,,,0.00,0.00,0,0,0,0,0,0,0,0,0,0,0,0,0
20200212,044028,鴻海群益92購02,,,,,0.00,0.00,0,0,0,0,0,0,0,0,0,0,0,0,0
20200212,044029,國巨群益92購02,,,,,0.00,0.00,0,0,0,0,0,0,0,0,0,0,0,0,0
20200212,04402P,TPK兆豐95售01,,,,,0.00,0.00,0,0,0,0,0,0,0,0,0,0,0,0,0
20200212,044031,致茂群益92購01,,,,,0.00,0.00,0,0,0,0,0,0,0,0,0,0,0,0,0
20200212,044034,美律群益92購04,,,,,0.00,0.00,0,0,0,0,0,0,0,0,0,0,0,0,0
20200212,044037,大立光群益92購01,,,,,0.00,0.00,0,0,0,0,0,0,0,0,0,0,0,0,0
20200212,044038,群創群益93購02,1.78,1.79,1.78,1.79,0.00,0.00,175000,3,311750,0,0,0,0,0,0,175000,0,175000,175000
20200212,044039,康控群益93購01,0.31,0.31,0.30,0.30,0.00,0.00,17000,2,5210,0,0,0,0,0,0,0,17000,-17000,-17000
20200212,04403P,景碩國票95售01,,,,,0.00,0.00,0,0,0,0,0,0,0,0,0,0,0,0,0
20200212,044047,國巨麥證92購01,,,,,0.00,0.00,0,0,0,0,0,0,0,0,0,0,0,0,0
20200212,044049,元金2X元大94購03,,,,,0.00,0.00,0,0,0,0,0,0,0,0,0,0,0,0,0
20200212,04404P,玉晶光國票94售01,0.27,0.27,0.27,0.27,-0.05,-15.62,30000,1,8100,0,0,0,0,0,0,30000,0,30000,30000
20200212,044051,儒鴻元大92購02,,,,,0.00,0.00,0,0,0,0,0,0,0,0,0,0,0,0,0
20200212,044052,鴻海元大92購04,,,,,0.00,0.00,0,0,0,0,0,0,0,0,0,0,0,0,0
20200212,044053,國巨元大92購11,,,,,0.00,0.00,0,0,0,0,0,0,0,0,0,0,0,0,0
20200212,044054,台積電元大92購08,,,,,0.00,0.00,0,0,0,0,0,0,0,0,0,0,0,0,0
20200212,044055,智邦元大92購03,,,,,0.00,0.00,0,0,0,0,0,0,0,0,0,0,0,0,0
20200212,04405P,牧德國票95售01,,,,,0.00,0.00,0,0,0,0,0,0,0,0,0,0,0,0,0
20200212,044060,美律元大92購05,0.04,0.04,0.04,0.04,0.00,0.00,260000,1,10400,0,0,0,0,0,0,260000,0,260000,260000
20200212,044061,聯發科元大92購03,,,,,0.00,0.00,0,0,0,0,0,0,0,0,0,0,0,0,0
20200212,044062,可成元大92購02,,,,,0.00,0.00,0,0,0,0,0,0,0,0,0,0,0,0,0
20200212,044064,大立光元大92購08,,,,,0.00,0.00,0,0,0,0,0,0,0,0,0,0,0,0,0
20200212,044065,亞光元大92購02,,,,,0.00,0.00,0,0,0,0,0,0,0,0,0,0,0,0,0
20200212,044068,GIS元大92購02,,,,,0.00,0.00,0,0,0,0,0,0,0,0,0,0,0,0,0
20200212,04406P,貿聯國票94售02,,,,,0.00,0.00,0,0,0,0,0,0,0,0,0,0,0,0,0
20200212,044076,台灣50國票93購02,,,,,0.00,0.00,0,0,0,0,0,0,0,0,0,0,0,0,0
20200212,044077,元油反國票92購01,,,,,0.00,0.00,0,0,0,0,0,0,0,0,0,0,0,0,0
20200212,04407P,滬深2X統一94售02,,,,,0.00,0.00,0,0,0,0,0,0,0,0,0,0,0,0,0
20200212,044081,鴻海國票92購01,0.01,0.01,0.01,0.01,0.00,0.00,499000,5,4990,0,0,0,0,0,0,499000,0,499000,499000
20200212,044087,世紀鋼國票92購01,,,,,0.00,0.00,0,0,0,0,0,0,0,0,0,0,0,0,0
20200212,044088,國巨元富95購01,,,,,0.00,0.00,0,0,0,0,0,0,0,0,0,0,0,0,0
20200212,04408P,台積電統一94售06,0.04,0.05,0.04,0.05,0.00,0.00,60000,3,2800,0,0,0,0,0,0,20000,40000,-20000,-20000
20200212,044094,南亞科統一92購01,,,,,0.00,0.00,0,0,0,0,0,0,0,0,0,0,0,0,0
20200212,044095,大立光統一92購01,0.65,0.65,0.65,0.65,0.00,0.00,20000,1,13000,0,0,0,0,0,0,20000,0,20000,20000
20200212,044099,國巨國泰92購02,,,,,0.00,0.00,0,0,0,0,0,0,0,0,0,0,0,0,0
20200212,04409P,台積電統一95售01,,,,,0.00,0.00,0,0,0,0,0,0,0,0,0,0,0,0,0
20200212,044100,旺宏國泰92購02,,,,,0.00,0.00,0,0,0,0,0,0,0,0,0,0,0,0,0
20200212,044101,聯茂國泰92購01,,,,,0.00,0.00,0,0,0,0,0,0,0,0,0,0,0,0,0
20200212,044104,鴻海中信95購03,0.29,0.29,0.22,0.28,+0.08,40.0,978000,20,234980,0,0,0,0,0,0,408000,568000,-160000,-160000
20200212,044105,聯詠中信95購01,1.37,1.48,1.35,1.43,+0.13,10.0,199000,16,284100,0,0,0,0,0,0,100000,99000,1000,1000
20200212,044109,宏達電國票92購02,,,,,0.00,0.00,0,0,0,0,0,0,0,0,0,0,0,0,0
20200212,04410P,大立光統一94售05,0.78,0.80,0.77,0.80,-0.15,-15.79,41000,5,32250,0,0,0,0,0,0,15000,26000,-11000,-11000
20200212,044112,超眾國票92購01,,,,,0.00,0.00,0,0,0,0,0,0,0,0,0,0,0,0,0
20200212,044117,創意兆豐92購01,,,,,0.00,0.00,0,0,0,0,0,0,0,0,0,0,0,0,0
20200212,044118,健策兆豐93購02,,,,,0.00,0.00,0,0,0,0,0,0,0,0,0,0,0,0,0
20200212,044119,台郡兆豐92購01,1.68,1.68,1.62,1.62,+0.58,55.77,25000,4,41700,0,0,0,0,0,0,25000,0,25000,25000
20200212,04411P,智易統一96售01,,,,,0.00,0.00,0,0,0,0,0,0,0,0,0,0,0,0,0
20200212,044120,世紀鋼兆豐92購01,,,,,0.00,0.00,0,0,0,0,0,0,0,0,0,0,0,0,0
20200212,044124,燿華凱基93購01,1.38,1.38,1.36,1.36,-0.08,-5.56,94000,2,128840,0,0,0,0,0,0,94000,0,94000,94000
20200212,044125,美律凱基93購01,,,,,0.00,0.00,0,0,0,0,0,0,0,0,0,0,0,0,0
20200212,044126,奇力新凱基93購01,3.87,4.11,1.40,4.11,+0.11,2.75,56000,26,201600,0,0,0,0,0,0,47000,13000,34000,34000
20200212,044128,欣興凱基92購01,,,,,0.00,0.00,0,0,0,0,0,0,0,0,0,0,0,0,0
20200212,044129,群創凱基93購02,,,,,0.00,0.00,0,0,0,0,0,0,0,0,0,0,0,0,0
20200212,04412P,欣興元富94售01,1.65,1.71,1.58,1.58,-0.52,-24.76,136000,9,221760,0,0,0,0,0,0,50000,86000,-36000,-36000
20200212,044134,訊芯凱基93購01,0.95,1.22,0.04,1.22,+0.31,34.07,89000,6,78660,0,0,0,0,0,0,73000,16000,57000,57000
20200212,044136,百和凱基93購01,,,,,0.00,0.00,0,0,0,0,0,0,0,0,0,0,0,0,0
20200212,04413P,玉晶光元富94售01,,,,,0.00,0.00,0,0,0,0,0,0,0,0,0,0,0,0,0
20200212,044149,TPK群益92購01,,,,,0.00,0.00,0,0,0,0,0,0,0,0,0,0,0,0,0
20200212,04414P,牧德元富94售04,0.21,0.24,0.21,0.24,0.00,0.00,900000,9,199000,0,0,0,0,0,0,500000,400000,100000,100000
20200212,04415P,牧德元富94售05,,,,,0.00,0.00,0,0,0,0,0,0,0,0,0,0,0,0,0
20200212,044163,台光電元大92購01,,,,,0.00,0.00,0,0,0,0,0,0,0,0,0,0,0,0,0
20200212,044164,京元電元大92購01,,,,,0.00,0.00,0,0,0,0,0,0,0,0,0,0,0,0,0
20200212,044165,聯發科元大92購04,3.77,4.08,3.77,4.08,+0.60,17.24,21000,2,79480,0,0,0,0,0,0,20000,1000,19000,19000
20200212,044167,大立光元大93購03,1.19,1.24,1.19,1.24,0.00,0.00,102000,3,121430,0,0,0,0,0,0,0,102000,-102000,-102000
20200212,04416P,牧德元富94售06,0.05,0.05,0.05,0.05,0.00,0.00,200000,1,10000,0,0,0,0,0,0,200000,0,200000,200000
20200212,044172,易華電元大92購01,,,,,0.00,0.00,0,0,0,0,0,0,0,0,0,0,0,0,0
20200212,044173,矽創元大92購02,,,,,0.00,0.00,0,0,0,0,0,0,0,0,0,0,0,0,0
20200212,044175,亞光統一92購01,,,,,0.00,0.00,0,0,0,0,0,0,0,0,0,0,0,0,0
20200212,04417P,光罩國泰95售02,0.90,0.90,0.90,0.90,-0.04,-4.26,1000,1,900,0,0,0,0,0,0,1000,0,1000,1000
20200212,044182,鴻海元富92購01,,,,,0.00,0.00,0,0,0,0,0,0,0,0,0,0,0,0,0
20200212,044183,S&P反1國泰93購01,,,,,0.00,0.00,0,0,0,0,0,0,0,0,0,0,0,0,0
20200212,044184,南亞科國泰93購01,2.46,2.46,2.45,2.45,-0.07,-2.78,19000,2,46700,0,0,0,0,0,0,19000,0,19000,19000
20200212,044185,聯發科國泰92購02,,,,,0.00,0.00,0,0,0,0,0,0,0,0,0,0,0,0,0
20200212,044186,宏達電國泰92購01,,,,,0.00,0.00,0,0,0,0,0,0,0,0,0,0,0,0,0
20200212,044187,泰鼎國泰93購01,0.37,0.43,0.36,0.36,+0.03,9.09,258000,46,102870,0,0,0,0,0,0,85000,163000,-78000,-78000
20200212,044188,超眾國泰93購01,2.32,2.56,2.32,2.56,+0.11,4.49,374000,24,883430,0,0,0,0,0,0,350000,34000,316000,316000
20200212,04418P,燿華永豐94售01,,,,,0.00,0.00,0,0,0,0,0,0,0,0,0,0,0,0,0
20200212,044190,聯詠富邦93購01,0.45,0.50,0.45,0.49,+0.11,28.95,155000,26,74420,0,0,0,0,0,0,155000,0,155000,155000
20200212,044194,GIS兆豐92購01,,,,,0.00,0.00,0,0,0,0,0,0,0,0,0,0,0,0,0
20200212,044198,友達國票92購01,,,,,0.00,0.00,0,0,0,0,0,0,0,0,0,0,0,0,0
20200212,04419P,奇力新永豐94售01,,,,,0.00,0.00,0,0,0,0,0,0,0,0,0,0,0,0,0
20200212,044200,群創國票93購01,,,,,0.00,0.00,0,0,0,0,0,0,0,0,0,0,0,0,0
20200212,044201,群創國票95購01,0.73,0.73,0.70,0.73,-0.02,-2.67,150000,7,107330,0,0,0,0,0,0,136000,0,136000,136000
20200212,044203,國泰金亞東92購01,,,,,0.00,0.00,0,0,0,0,0,0,0,0,0,0,0,0,0
20200212,044204,TPK亞東92購01,,,,,0.00,0.00,0,0,0,0,0,0,0,0,0,0,0,0,0
20200212,044205,聯茂亞東92購01,,,,,0.00,0.00,0,0,0,0,0,0,0,0,0,0,0,0,0
20200212,04420P,奇鋐永豐94售01,1.83,1.89,1.83,1.89,+0.03,1.61,85000,9,159400,0,0,0,0,0,0,10000,75000,-65000,-65000
20200212,044212,鴻海凱基93購04,,,,,0.00,0.00,0,0,0,0,0,0,0,0,0,0,0,0,0
20200212,044216,華新科凱基93購02,,,,,0.00,0.00,0,0,0,0,0,0,0,0,0,0,0,0,0
20200212,044217,華新科凱基93購03,,,,,0.00,0.00,0,0,0,0,0,0,0,0,0,0,0,0,0
20200212,04421P,玉晶光永豐94售02,0.49,0.49,0.48,0.48,-0.13,-21.31,85000,5,40850,0,0,0,0,0,0,60000,25000,35000,35000
20200212,044221,群創凱基93購03,,,,,0.00,0.00,0,0,0,0,0,0,0,0,0,0,0,0,0
20200212,044224,超眾凱基93購01,0.61,0.72,0.04,0.72,+0.07,10.77,107000,16,62960,0,0,0,0,0,0,74000,33000,41000,41000
20200212,044225,世紀鋼凱基93購02,,,,,0.00,0.00,0,0,0,0,0,0,0,0,0,0,0,0,0
20200212,044227,為升群益92購01,,,,,0.00,0.00,0,0,0,0,0,0,0,0,0,0,0,0,0
20200212,04422P,玉晶光永豐94售03,0.64,0.65,0.59,0.62,-0.09,-12.68,406000,21,251180,0,0,0,0,0,0,140000,266000,-126000,-126000
20200212,04423P,牧德永豐94售01,,,,,0.00,0.00,0,0,0,0,0,0,0,0,0,0,0,0,0
20200212,044241,華新科統一92購01,,,,,0.00,0.00,0,0,0,0,0,0,0,0,0,0,0,0,0
20200212,044242,宏達電統一93購01,,,,,0.00,0.00,0,0,0,0,0,0,0,0,0,0,0,0,0
20200212,044247,道瓊反元富97購01,0.26,0.26,0.26,0.26,0.00,0.00,1000,1,260,0,0,0,0,0,0,0,1000,-1000,-1000
20200212,044249,T50反1中信94購01,,,,,0.00,0.00,0,0,0,0,0,0,0,0,0,0,0,0,0
20200212,04424P,台郡永豐94售01,,,,,0.00,0.00,0,0,0,0,0,0,0,0,0,0,0,0,0
20200212,044250,國巨中信92購01,,,,,0.00,0.00,0,0,0,0,0,0,0,0,0,0,0,0,0
20200212,044253,美律麥證92購01,,,,,0.00,0.00,0,0,0,0,0,0,0,0,0,0,0,0,0
20200212,044254,深中小元大94購01,1.01,1.09,1.01,1.09,+0.10,10.1,78000,3,78860,0,0,0,0,0,0,1000,77000,-76000,-76000
20200212,044255,群創元大93購01,0.86,0.86,0.86,0.86,-0.01,-1.15,1000,1,860,0,0,0,0,0,0,1000,0,1000,1000
20200212,044258,超眾元大92購02,0.56,0.56,0.56,0.56,-0.02,-3.45,1000,1,560,0,0,0,0,0,0,1000,0,1000,1000
20200212,04425P,中環康和94售01,,,,,0.00,0.00,0,0,0,0,0,0,0,0,0,0,0,0,0
20200212,044260,滬深2X國泰92購02,,,,,0.00,0.00,0,0,0,0,0,0,0,0,0,0,0,0,0
20200212,044262,致伸國泰92購01,,,,,0.00,0.00,0,0,0,0,0,0,0,0,0,0,0,0,0
20200212,044263,T50反1富邦92購01,,,,,0.00,0.00,0,0,0,0,0,0,0,0,0,0,0,0,0
20200212,044264,大立光富邦93購03,1.10,1.10,1.10,1.10,+0.12,12.24,10000,1,11000,0,0,0,0,0,0,10000,0,10000,10000
20200212,044265,滬深2X中信95購05,0.10,0.10,0.10,0.10,0.00,0.00,30000,1,3000,0,0,0,0,0,0,0,30000,-30000,-30000
20200212,044269,群創中信95購01,0.64,0.65,0.61,0.62,-0.01,-1.59,1464000,33,913290,0,0,0,0,0,0,830000,628000,202000,202000
20200212,04426P,佳世達康和94售02,,,,,0.00,0.00,0,0,0,0,0,0,0,0,0,0,0,0,0
20200212,044270,群創中信95購02,0.89,0.89,0.88,0.88,0.00,0.00,97000,4,85960,0,0,0,0,0,0,91000,6000,85000,85000
20200212,044273,微星群益92購01,,,,,0.00,0.00,0,0,0,0,0,0,0,0,0,0,0,0,0
20200212,044274,華新科群益92購01,,,,,0.00,0.00,0,0,0,0,0,0,0,0,0,0,0,0,0
20200212,044275,欣興群益92購01,,,,,0.00,0.00,0,0,0,0,0,0,0,0,0,0,0,0,0
20200212,044277,彩晶群益92購01,,,,,0.00,0.00,0,0,0,0,0,0,0,0,0,0,0,0,0
20200212,04427P,滬深2X元大97售02,1.23,1.25,1.23,1.23,+0.01,0.82,182000,7,224360,0,0,0,0,0,0,10000,172000,-162000,-162000
20200212,044280,T50反1凱基94購02,,,,,0.00,0.00,0,0,0,0,0,0,0,0,0,0,0,0,0
20200212,044282,上銀凱基93購03,,,,,0.00,0.00,0,0,0,0,0,0,0,0,0,0,0,0,0
20200212,044284,聯電凱基92購01,0.59,0.59,0.59,0.59,-0.03,-4.84,28000,4,16520,0,0,0,0,0,0,18000,20000,-2000,-2000
20200212,044285,鴻海凱基93購06,0.65,0.81,0.62,0.81,+0.25,44.64,86000,12,63440,0,0,0,0,0,0,57000,69000,-12000,-12000
20200212,044289,群創凱基93購04,0.70,0.73,0.69,0.69,-0.01,-1.43,872000,18,617640,0,0,0,0,0,0,752000,120000,632000,632000
20200212,04428P,台光電元大94售02,1.53,1.53,1.35,1.35,-0.36,-21.05,102000,8,143090,0,0,0,0,0,0,32000,102000,-70000,-70000
20200212,044290,群創凱基93購05,0.45,0.45,0.44,0.44,0.00,0.00,220000,21,98800,0,0,0,0,0,0,20000,180000,-160000,-160000
20200212,044291,群創凱基93購06,0.22,0.28,0.22,0.26,0.00,0.00,1060000,33,271100,0,0,0,0,0,0,839000,0,839000,839000
20200212,044296,嘉聯益凱基93購01,0.22,0.23,0.22,0.23,+0.03,15.0,32000,5,7250,0,0,0,0,0,0,11000,0,11000,11000
20200212,044298,南電凱基93購01,1.26,1.26,1.26,1.26,+0.27,27.27,25000,1,31500,0,0,0,0,0,0,0,25000,-25000,-25000
20200212,044299,南電凱基93購02,0.42,0.52,0.42,0.52,+0.11,26.83,170000,11,83940,0,0,0,0,0,0,50000,120000,-70000,-70000
20200212,04429P,和鑫元大94售01,,,,,0.00,0.00,0,0,0,0,0,0,0,0,0,0,0,0,0
20200212,044301,台光電亞東92購01,,,,,0.00,0.00,0,0,0,0,0,0,0,0,0,0,0,0,0
20200212,044302,智邦兆豐93購02,2.68,2.68,2.68,2.68,+0.07,2.68,10000,1,26800,0,0,0,0,0,0,10000,0,10000,10000
20200212,044303,群創兆豐92購01,,,,,0.00,0.00,0,0,0,0,0,0,0,0,0,0,0,0,0
20200212,044304,臻鼎兆豐93購01,1.63,1.82,1.58,1.58,+0.31,24.41,82000,8,139760,0,0,0,0,0,0,0,82000,-82000,-82000
20200212,044305,瀚宇博兆豐93購01,,,,,0.00,0.00,0,0,0,0,0,0,0,0,0,0,0,0,0
20200212,044306,瑞儀兆豐93購02,,,,,0.00,0.00,0,0,0,0,0,0,0,0,0,0,0,0,0
20200212,044307,GIS兆豐93購01,,,,,0.00,0.00,0,0,0,0,0,0,0,0,0,0,0,0,0
20200212,04430P,晶相光元大94售04,,,,,0.00,0.00,0,0,0,0,0,0,0,0,0,0,0,0,0
20200212,044310,元黃金台新93購01,0.66,0.66,0.66,0.66,0.00,0.00,1000,1,660,0,0,0,0,0,0,1000,0,1000,1000
20200212,044312,A50正2永豐92購01,,,,,0.00,0.00,0,0,0,0,0,0,0,0,0,0,0,0,0
20200212,044315,大立光永豐92購01,,,,,0.00,0.00,0,0,0,0,0,0,0,0,0,0,0,0,0
20200212,04431P,牧德元大94售03,,,,,0.00,0.00,0,0,0,0,0,0,0,0,0,0,0,0,0
20200212,04432P,昇陽半元大94售04,,,,,0.00,0.00,0,0,0,0,0,0,0,0,0,0,0,0,0
20200212,044330,T50反1統一93購01,,,,,0.00,0.00,0,0,0,0,0,0,0,0,0,0,0,0,0
20200212,04433P,上証2X國票95售01,0.75,0.77,0.75,0.76,+0.01,1.33,1653000,6,1247640,0,0,0,0,0,0,655000,998000,-343000,-343000
20200212,044340,TPK統一93購01,,,,,0.00,0.00,0,0,0,0,0,0,0,0,0,0,0,0,0
20200212,044342,亞德客國泰92購01,,,,,0.00,0.00,0,0,0,0,0,0,0,0,0,0,0,0,0
20200212,044343,智邦國泰92購01,,,,,0.00,0.00,0,0,0,0,0,0,0,0,0,0,0,0,0
20200212,044344,傳奇國泰92購01,,,,,0.00,0.00,0,0,0,0,0,0,0,0,0,0,0,0,0
20200212,044345,世紀鋼國泰92購01,,,,,0.00,0.00,0,0,0,0,0,0,0,0,0,0,0,0,0
20200212,044346,力山富邦95購01,,,,,0.00,0.00,0,0,0,0,0,0,0,0,0,0,0,0,0
20200212,044347,上証2X元大94購01,0.14,0.14,0.14,0.14,-0.01,-6.67,30000,1,4200,0,0,0,0,0,0,0,30000,-30000,-30000
20200212,04434P,玉晶光國票96售02,0.87,0.87,0.82,0.83,-0.09,-9.78,495000,28,419150,0,0,0,0,0,0,87000,408000,-321000,-321000
20200212,044351,台光電元大92購02,0.50,0.64,0.50,0.64,0.00,0.00,307000,11,187870,0,0,0,0,0,0,12000,307000,-295000,-295000
20200212,044353,宏達電元大93購04,0.09,0.09,0.09,0.09,0.00,0.00,20000,1,1800,0,0,0,0,0,0,0,20000,-20000,-20000
20200212,044354,奇鋐元大93購02,0.15,0.15,0.15,0.15,0.00,0.00,100000,1,15000,0,0,0,0,0,0,100000,0,100000,100000
20200212,044356,創意元大92購04,,,,,0.00,0.00,0,0,0,0,0,0,0,0,0,0,0,0,0
20200212,044357,貿聯元大92購02,,,,,0.00,0.00,0,0,0,0,0,0,0,0,0,0,0,0,0
20200212,044358,TPK元大92購02,,,,,0.00,0.00,0,0,0,0,0,0,0,0,0,0,0,0,0
20200212,04435P,台積電中信95售07,,,,,0.00,0.00,0,0,0,0,0,0,0,0,0,0,0,0,0
20200212,044362,元油2X中信94購01,0.04,0.04,0.04,0.04,0.00,0.00,110000,4,4400,0,0,0,0,0,0,0,10000,-10000,-10000
20200212,044364,超眾中信94購01,0.27,0.30,0.25,0.30,+0.03,11.11,221000,6,59450,0,0,0,0,0,0,185000,36000,149000,149000
20200212,044365,旺宏亞東92購01,,,,,0.00,0.00,0,0,0,0,0,0,0,0,0,0,0,0,0
20200212,04436P,聯發科中信96售02,0.43,0.43,0.41,0.41,-0.08,-16.33,20000,2,8400,0,0,0,0,0,0,0,20000,-20000,-20000
20200212,044373,台積電兆豐92購01,,,,,0.00,0.00,0,0,0,0,0,0,0,0,0,0,0,0,0
20200212,044374,燿華兆豐93購01,1.74,1.74,1.74,1.74,0.00,0.00,1000,1,1740,0,0,0,0,0,0,0,1000,-1000,-1000
20200212,044375,亞光兆豐92購01,,,,,0.00,0.00,0,0,0,0,0,0,0,0,0,0,0,0,0
20200212,044376,日月光兆豐92購01,1.25,1.43,1.25,1.43,+0.32,28.83,89000,10,116410,0,0,0,0,0,0,29000,60000,-31000,-31000
20200212,044377,南茂兆豐93購01,,,,,0.00,0.00,0,0,0,0,0,0,0,0,0,0,0,0,0
20200212,044378,T50反1群益92購01,,,,,0.00,0.00,0,0,0,0,0,0,0,0,0,0,0,0,0
20200212,044379,A50正2群益92購01,,,,,0.00,0.00,0,0,0,0,0,0,0,0,0,0,0,0,0
20200212,04437P,滬深2X群益98售03,,,,,0.00,0.00,0,0,0,0,0,0,0,0,0,0,0,0,0
20200212,044382,嘉聯益群益94購01,0.52,0.54,0.52,0.52,+0.04,8.33,51000,4,27120,0,0,0,0,0,0,0,51000,-51000,-51000
20200212,04438P,微星群益94售01,0.46,0.46,0.46,0.46,-0.07,-13.21,35000,4,16100,0,0,0,0,0,0,0,35000,-35000,-35000
20200212,044391,力山凱基92購01,,,,,0.00,0.00,0,0,0,0,0,0,0,0,0,0,0,0,0
20200212,044393,為升凱基92購01,,,,,0.00,0.00,0,0,0,0,0,0,0,0,0,0,0,0,0
20200212,044394,國巨凱基92購02,,,,,0.00,0.00,0,0,0,0,0,0,0,0,0,0,0,0,0
20200212,044396,燿華凱基93購02,1.11,1.11,1.11,1.11,+0.07,6.73,1000,1,1110,0,0,0,0,0,0,1000,0,1000,1000
20200212,044397,微星凱基92購01,0.42,0.42,0.42,0.42,0.00,0.00,10000,1,4200,0,0,0,0,0,0,0,10000,-10000,-10000
20200212,04439P,聯發科群益94售04,1.32,1.32,1.16,1.18,-0.40,-25.32,312000,20,377150,0,0,0,0,0,0,109000,203000,-94000,-94000
20200212,044400,大立光凱基92購01,,,,,0.00,0.00,0,0,0,0,0,0,0,0,0,0,0,0,0
20200212,044401,亞光凱基93購01,0.48,0.55,0.48,0.53,+0.08,17.78,12000,3,6510,0,0,0,0,0,0,1000,11000,-10000,-10000
20200212,044402,景碩凱基93購01,1.70,2.23,1.66,2.02,+0.36,21.69,269000,44,539050,0,0,0,0,0,0,68000,201000,-133000,-133000
20200212,044403,新日興凱基92購01,1.56,1.56,1.56,1.56,-0.17,-9.83,20000,2,31200,0,0,0,0,0,0,20000,0,20000,20000
20200212,044405,材料凱基93購01,0.27,0.29,0.27,0.29,+0.02,7.41,40000,4,11200,0,0,0,0,0,0,40000,0,40000,40000
20200212,044406,臻鼎凱基92購01,,,,,0.00,0.00,0,0,0,0,0,0,0,0,0,0,0,0,0
20200212,044407,聯茂凱基93購01,0.64,0.87,0.64,0.87,+0.37,74.0,264000,19,193780,0,0,0,0,0,0,254000,0,254000,254000
20200212,044408,聯茂凱基93購02,0.79,1.15,0.79,0.99,+0.32,47.76,549000,25,538490,0,0,0,0,0,0,213000,36000,177000,177000
20200212,04440P,訊芯群益94售01,0.26,0.26,0.26,0.26,0.00,0.00,10000,1,2600,0,0,0,0,0,0,0,10000,-10000,-10000
20200212,044410,宏達電麥證92購01,,,,,0.00,0.00,0,0,0,0,0,0,0,0,0,0,0,0,0
20200212,044411,A50正2統一93購01,,,,,0.00,0.00,0,0,0,0,0,0,0,0,0,0,0,0,0
20200212,04441P,台積電台新95售01,,,,,0.00,0.00,0,0,0,0,0,0,0,0,0,0,0,0,0
20200212,044423,元油2X國泰92購01,,,,,0.00,0.00,0,0,0,0,0,0,0,0,0,0,0,0,0
20200212,044424,儒鴻國泰92購01,,,,,0.00,0.00,0,0,0,0,0,0,0,0,0,0,0,0,0
20200212,044425,友達國泰92購01,,,,,0.00,0.00,0,0,0,0,0,0,0,0,0,0,0,0,0
20200212,044426,欣興國泰93購02,0.51,0.63,0.51,0.63,+0.17,36.96,205000,22,117030,0,0,0,0,0,0,15000,205000,-190000,-190000
20200212,044427,群創國泰93購01,,,,,0.00,0.00,0,0,0,0,0,0,0,0,0,0,0,0,0
20200212,044428,卜蜂富邦92購01,,,,,0.00,0.00,0,0,0,0,0,0,0,0,0,0,0,0,0
20200212,044429,元金2X元大94購04,0.17,0.18,0.17,0.18,0.00,0.00,151000,2,25680,0,0,0,0,0,0,150000,1000,149000,149000
20200212,04442P,矽格康和94售02,,,,,0.00,0.00,0,0,0,0,0,0,0,0,0,0,0,0,0
20200212,044430,上銀元大92購03,,,,,0.00,0.00,0,0,0,0,0,0,0,0,0,0,0,0,0
20200212,044431,國巨元大92購12,,,,,0.00,0.00,0,0,0,0,0,0,0,0,0,0,0,0,0
20200212,044433,華新科元大92購06,4.23,4.23,3.96,4.06,+0.16,4.1,29000,7,119660,0,0,0,0,0,0,26000,3000,23000,23000
20200212,044436,健策元大92購02,,,,,0.00,0.00,0,0,0,0,0,0,0,0,0,0,0,0,0
20200212,044437,台郡元大92購02,2.52,2.52,2.52,2.52,+1.35,115.38,11000,1,27720,0,0,0,0,0,0,11000,0,11000,11000
20200212,044438,GIS元大92購03,,,,,0.00,0.00,0,0,0,0,0,0,0,0,0,0,0,0,0
20200212,044439,南電元大93購01,0.43,0.43,0.43,0.43,0.00,0.00,25000,1,10750,0,0,0,0,0,0,25000,0,25000,25000
20200212,04443P,台積電永豐94售01,,,,,0.00,0.00,0,0,0,0,0,0,0,0,0,0,0,0,0
20200212,044440,臺股指元大92購07,,,,,0.00,0.00,0,0,0,0,0,0,0,0,0,0,0,0,0
20200212,044441,臺股指元大92購08,,,,,0.00,0.00,0,0,0,0,0,0,0,0,0,0,0,0,0
20200212,044442,臺股指元大92購09,,,,,0.00,0.00,0,0,0,0,0,0,0,0,0,0,0,0,0
20200212,044443,臺股指元大92購10,,,,,0.00,0.00,0,0,0,0,0,0,0,0,0,0,0,0,0
20200212,04444P,玉晶光永豐94售06,0.23,0.23,0.23,0.23,-0.08,-25.81,40000,1,9200,0,0,0,0,0,0,40000,0,40000,40000
20200212,044457,滬深2X國票97購01,0.15,0.15,0.14,0.14,-0.01,-6.67,128000,10,18580,0,0,0,0,0,0,0,128000,-128000,-128000
20200212,04445P,台積電日盛94售01,,,,,0.00,0.00,0,0,0,0,0,0,0,0,0,0,0,0,0
20200212,044461,滬深2X兆豐93購01,,,,,0.00,0.00,0,0,0,0,0,0,0,0,0,0,0,0,0
20200212,044462,漢唐兆豐93購01,0.94,0.99,0.94,0.99,+0.07,7.61,84000,4,80620,0,0,0,0,0,0,10000,74000,-64000,-64000
20200212,044463,全新兆豐93購01,0.37,0.51,0.37,0.51,+0.21,70.0,364000,25,168760,0,0,0,0,0,0,28000,336000,-308000,-308000
20200212,044464,滬深2X群益95購01,0.07,0.07,0.07,0.07,0.00,0.00,642000,3,44940,0,0,0,0,0,0,642000,0,642000,642000
20200212,044465,元油2X群益97購01,0.31,0.34,0.31,0.34,+0.04,13.33,97000,5,30930,0,0,0,0,0,0,0,97000,-97000,-97000
20200212,044466,和大群益93購01,,,,,0.00,0.00,0,0,0,0,0,0,0,0,0,0,0,0,0
20200212,044468,台積電群益93購01,6.15,6.15,6.15,6.15,+0.50,8.85,6000,4,36900,0,0,0,0,0,0,6000,6000,0,0
20200212,04446P,元油2X凱基94售03,,,,,0.00,0.00,0,0,0,0,0,0,0,0,0,0,0,0,0
20200212,044475,國巨元富95購02,,,,,0.00,0.00,0,0,0,0,0,0,0,0,0,0,0,0,0
20200212,044478,友達統一93購01,,,,,0.00,0.00,0,0,0,0,0,0,0,0,0,0,0,0,0
20200212,04447P,上銀凱基94售02,,,,,0.00,0.00,0,0,0,0,0,0,0,0,0,0,0,0,0
20200212,044487,元油2X元大94購01,0.11,0.11,0.11,0.11,+0.01,10.0,500000,3,55000,0,0,0,0,0,0,300000,200000,100000,100000
20200212,04448P,台積電凱基94售07,,,,,0.00,0.00,0,0,0,0,0,0,0,0,0,0,0,0,0
20200212,044493,京元電元大92購02,0.80,0.80,0.75,0.75,-0.04,-5.06,42000,2,32600,0,0,0,0,0,0,42000,0,42000,42000
20200212,044496,群創元大93購02,0.98,0.99,0.95,0.97,+0.02,2.11,135000,16,131090,0,0,0,0,0,0,66000,130000,-64000,-64000
20200212,04449P,智邦凱基94售01,0.32,0.40,0.32,0.40,-0.03,-6.98,86000,5,29360,0,0,0,0,0,0,0,86000,-86000,-86000
20200212,044500,超眾元大92購03,,,,,0.00,0.00,0,0,0,0,0,0,0,0,0,0,0,0,0
20200212,044501,滬深2X凱基92購02,,,,,0.00,0.00,0,0,0,0,0,0,0,0,0,0,0,0,0
20200212,044504,國巨凱基92購03,,,,,0.00,0.00,0,0,0,0,0,0,0,0,0,0,0,0,0
20200212,044507,燿華凱基93購03,1.29,1.29,1.29,1.29,-0.05,-3.73,9000,1,11610,0,0,0,0,0,0,9000,0,9000,9000
20200212,044508,微星凱基92購02,0.53,0.57,0.53,0.54,-0.05,-8.47,30000,3,16400,0,0,0,0,0,0,10000,20000,-10000,-10000
20200212,044509,台光電凱基93購03,0.42,0.43,0.42,0.42,+0.12,40.0,23000,4,9730,0,0,0,0,0,0,16000,7000,9000,9000
20200212,04450P,京元電凱基94售01,1.41,1.41,1.41,1.41,0.00,0.00,2000,1,2820,0,0,0,0,0,0,2000,0,2000,2000
20200212,044510,台光電凱基93購04,0.52,0.55,0.52,0.55,+0.17,44.74,42000,4,22020,0,0,0,0,0,0,30000,12000,18000,18000
20200212,044511,全新凱基92購01,0.61,0.88,0.61,0.88,+0.36,69.23,20000,2,14900,0,0,0,0,0,0,10000,10000,0,0
20200212,044512,奇力新凱基93購02,2.66,2.75,2.66,2.75,+0.02,0.73,72000,27,192240,0,0,0,0,0,0,62000,10000,52000,52000
20200212,044513,義隆凱基93購02,,,,,0.00,0.00,0,0,0,0,0,0,0,0,0,0,0,0,0
20200212,044514,亞光凱基93購02,0.40,0.40,0.14,0.17,+0.04,30.77,87000,5,20970,0,0,0,0,0,0,0,57000,-57000,-57000
20200212,044516,景碩凱基93購02,1.23,1.55,1.20,1.46,+0.25,20.66,42000,22,57860,0,0,0,0,0,0,24000,30000,-6000,-6000
20200212,044518,京鼎凱基92購01,1.87,2.26,1.85,2.26,+0.72,46.75,23000,11,45750,0,0,0,0,0,0,10000,13000,-3000,-3000
20200212,04451P,可成凱基94售04,,,,,0.00,0.00,0,0,0,0,0,0,0,0,0,0,0,0,0
20200212,044522,TPK凱基93購01,,,,,0.00,0.00,0,0,0,0,0,0,0,0,0,0,0,0,0
20200212,044524,瑞儀凱基93購02,,,,,0.00,0.00,0,0,0,0,0,0,0,0,0,0,0,0,0
20200212,044526,訊芯凱基93購02,0.85,0.85,0.85,0.85,+0.05,6.25,1000,1,850,0,0,0,0,0,0,1000,0,1000,1000
20200212,044527,易華電凱基93購01,,,,,0.00,0.00,0,0,0,0,0,0,0,0,0,0,0,0,0
20200212,044528,元油2X國泰92購02,,,,,0.00,0.00,0,0,0,0,0,0,0,0,0,0,0,0,0
20200212,044529,國巨富邦92購02,,,,,0.00,0.00,0,0,0,0,0,0,0,0,0,0,0,0,0
20200212,04452P,超眾國泰95售01,1.24,1.24,1.20,1.20,-0.04,-3.23,21000,5,25780,0,0,0,0,0,0,13000,8000,5000,5000
20200212,044530,台積電富邦94購01,3.60,3.60,3.60,3.60,+0.17,4.96,1000,1,3600,0,0,0,0,0,0,1000,0,1000,1000
20200212,044531,欣興富邦93購01,0.22,0.27,0.22,0.26,+0.06,30.0,369000,19,93220,0,0,0,0,0,0,341000,0,341000,341000
20200212,044532,康控富邦93購01,,,,,0.00,0.00,0,0,0,0,0,0,0,0,0,0,0,0,0
20200212,044533,S&P反1中信94購02,,,,,0.00,0.00,0,0,0,0,0,0,0,0,0,0,0,0,0
20200212,044534,南亞科麥證92購01,,,,,0.00,0.00,0,0,0,0,0,0,0,0,0,0,0,0,0
20200212,044535,華新科麥證93購01,,,,,0.00,0.00,0,0,0,0,0,0,0,0,0,0,0,0,0
20200212,044536,深中小群益92購01,,,,,0.00,0.00,0,0,0,0,0,0,0,0,0,0,0,0,0
20200212,044537,上銀群益92購01,,,,,0.00,0.00,0,0,0,0,0,0,0,0,0,0,0,0,0
20200212,04453P,聯發科富邦94售04,1.20,1.20,1.17,1.17,-0.32,-21.48,45000,3,52740,0,0,0,0,0,0,43000,2000,41000,41000
20200212,044543,揚明光群益92購01,,,,,0.00,0.00,0,0,0,0,0,0,0,0,0,0,0,0,0
20200212,04454P,大立光富邦98售02,0.64,0.64,0.64,0.64,-0.05,-7.25,15000,1,9600,0,0,0,0,0,0,15000,0,15000,15000
20200212,04455P,台積電統一94售07,,,,,0.00,0.00,0,0,0,0,0,0,0,0,0,0,0,0,0
20200212,044562,元油2X凱基92購05,,,,,0.00,0.00,0,0,0,0,0,0,0,0,0,0,0,0,0
20200212,044563,亞德客凱基92購01,3.43,3.67,3.35,3.59,-0.24,-6.27,92000,20,323520,0,0,0,0,0,0,92000,0,92000,92000
20200212,044564,喬山凱基92購01,,,,,0.00,0.00,0,0,0,0,0,0,0,0,0,0,0,0,0
20200212,044567,華通凱基93購03,3.52,4.65,3.52,4.59,+1.24,37.01,42000,10,178840,0,0,0,0,0,0,30000,32000,-2000,-2000
20200212,044569,華邦電凱基92購01,,,,,0.00,0.00,0,0,0,0,0,0,0,0,0,0,0,0,0
20200212,04456P,日月光統一94售01,0.98,0.98,0.88,0.88,-0.15,-14.56,176000,113,159520,0,0,0,0,0,0,135000,41000,94000,94000
20200212,044574,潤泰全凱基93購01,,,,,0.00,0.00,0,0,0,0,0,0,0,0,0,0,0,0,0
20200212,044578,緯創凱基93購02,0.88,0.88,0.88,0.88,+0.05,6.02,30000,1,26400,0,0,0,0,0,0,30000,0,30000,30000
20200212,044579,臻鼎凱基92購02,,,,,0.00,0.00,0,0,0,0,0,0,0,0,0,0,0,0,0
20200212,04457P,同欣電統一94售01,0.49,0.49,0.49,0.49,-0.03,-5.77,14000,1,6860,0,0,0,0,0,0,0,14000,-14000,-14000
20200212,044582,GIS凱基92購01,,,,,0.00,0.00,0,0,0,0,0,0,0,0,0,0,0,0,0
20200212,044583,易華電凱基93購02,,,,,0.00,0.00,0,0,0,0,0,0,0,0,0,0,0,0,0
20200212,044584,世紀鋼凱基93購05,,,,,0.00,0.00,0,0,0,0,0,0,0,0,0,0,0,0,0
20200212,044588,元金2X統一93購01,0.80,0.80,0.79,0.79,-0.02,-2.47,42000,5,33330,0,0,0,0,0,0,15000,20000,-5000,-5000
20200212,044589,國巨統一93購03,9.20,9.20,9.20,9.20,0.00,0.00,2000,1,18400,0,0,0,0,0,0,2000,0,2000,2000
20200212,04458P,世紀鋼統一96售01,,,,,0.00,0.00,0,0,0,0,0,0,0,0,0,0,0,0,0
20200212,044592,元油2X國票93購02,,,,,0.00,0.00,0,0,0,0,0,0,0,0,0,0,0,0,0
20200212,044597,可成亞東92購01,,,,,0.00,0.00,0,0,0,0,0,0,0,0,0,0,0,0,0
20200212,044598,臻鼎亞東92購01,,,,,0.00,0.00,0,0,0,0,0,0,0,0,0,0,0,0,0
20200212,044599,矽創亞東92購01,,,,,0.00,0.00,0,0,0,0,0,0,0,0,0,0,0,0,0
20200212,04459P,元油2X元富94售08,,,,,0.00,0.00,0,0,0,0,0,0,0,0,0,0,0,0,0
20200212,044600,上銀國泰93購01,2.57,2.57,2.57,2.57,+0.14,5.76,15000,1,38550,0,0,0,0,0,0,15000,0,15000,15000
20200212,044601,旺宏國泰93購03,,,,,0.00,0.00,0,0,0,0,0,0,0,0,0,0,0,0,0
20200212,044602,大立光國泰93購01,0.99,1.11,0.99,1.11,+0.17,18.09,252000,11,270750,0,0,0,0,0,0,217000,35000,182000,182000
20200212,044603,健策國泰92購01,,,,,0.00,0.00,0,0,0,0,0,0,0,0,0,0,0,0,0
20200212,044604,嘉聯益國泰93購01,0.58,0.58,0.58,0.58,0.00,0.00,1000,1,580,0,0,0,0,0,0,1000,0,1000,1000
20200212,044605,超眾國泰93購02,0.62,0.74,0.62,0.74,+0.06,8.82,332000,27,225650,0,0,0,0,0,0,282000,65000,217000,217000
20200212,044606,鈺齊國泰92購01,,,,,0.00,0.00,0,0,0,0,0,0,0,0,0,0,0,0,0
20200212,044608,奇力新富邦93購01,,,,,0.00,0.00,0,0,0,0,0,0,0,0,0,0,0,0,0
20200212,044609,T50反1兆豐92購01,,,,,0.00,0.00,0,0,0,0,0,0,0,0,0,0,0,0,0
20200212,04460P,元油2X元富96售04,,,,,0.00,0.00,0,0,0,0,0,0,0,0,0,0,0,0,0
20200212,044610,A50正2兆豐93購01,,,,,0.00,0.00,0,0,0,0,0,0,0,0,0,0,0,0,0
20200212,044611,正崴兆豐92購01,0.91,0.92,0.91,0.92,+0.03,3.37,22000,6,20170,0,0,0,0,0,0,22000,0,22000,22000
20200212,044612,創意兆豐93購01,,,,,0.00,0.00,0,0,0,0,0,0,0,0,0,0,0,0,0
20200212,044613,智易兆豐94購01,,,,,0.00,0.00,0,0,0,0,0,0,0,0,0,0,0,0,0
20200212,044614,聯茂兆豐92購02,0.30,0.47,0.21,0.21,+0.12,133.33,64000,6,22040,0,0,0,0,0,0,0,34000,-34000,-34000
20200212,044615,聯茂兆豐93購01,0.33,0.33,0.33,0.33,0.00,0.00,6000,1,1980,0,0,0,0,0,0,6000,0,6000,6000
20200212,044616,柏文兆豐92購01,,,,,0.00,0.00,0,0,0,0,0,0,0,0,0,0,0,0,0
20200212,044617,T50反1元大92購01,,,,,0.00,0.00,0,0,0,0,0,0,0,0,0,0,0,0,0
20200212,044618,T50反1元大92購02,,,,,0.00,0.00,0,0,0,0,0,0,0,0,0,0,0,0,0
20200212,044619,T50反1元大92購03,0.02,0.03,0.02,0.03,0.00,0.00,23000,2,470,0,0,0,0,0,0,0,0,0,0
20200212,04461P,燿華元富94售01,,,,,0.00,0.00,0,0,0,0,0,0,0,0,0,0,0,0,0
20200212,044620,上銀元大92購04,0.16,0.16,0.16,0.16,-0.01,-5.88,1000,1,160,0,0,0,0,0,0,1000,0,1000,1000
20200212,044621,國巨元大92購13,,,,,0.00,0.00,0,0,0,0,0,0,0,0,0,0,0,0,0
20200212,044622,旺宏元大92購06,,,,,0.00,0.00,0,0,0,0,0,0,0,0,0,0,0,0,0
20200212,044623,奇力新元大92購01,,,,,0.00,0.00,0,0,0,0,0,0,0,0,0,0,0,0,0
20200212,044624,華新科元大92購07,,,,,0.00,0.00,0,0,0,0,0,0,0,0,0,0,0,0,0
20200212,044625,宏達電元大92購03,,,,,0.00,0.00,0,0,0,0,0,0,0,0,0,0,0,0,0
20200212,044626,欣興元大92購03,,,,,0.00,0.00,0,0,0,0,0,0,0,0,0,0,0,0,0
20200212,044628,揚明光元大92購01,,,,,0.00,0.00,0,0,0,0,0,0,0,0,0,0,0,0,0
20200212,04462P,全新元富96售01,0.82,0.82,0.80,0.80,-0.18,-18.37,26000,2,20820,0,0,0,0,0,0,26000,0,26000,26000
20200212,044631,聯茂元大92購02,,,,,0.00,0.00,0,0,0,0,0,0,0,0,0,0,0,0,0
20200212,044633,台郡元大92購03,2.52,2.52,2.52,2.52,+1.01,66.89,22000,2,55440,0,0,0,0,0,0,22000,0,22000,22000
20200212,044635,世紀鋼元大92購02,,,,,0.00,0.00,0,0,0,0,0,0,0,0,0,0,0,0,0
20200212,044636,創意統一94購01,0.26,0.29,0.26,0.27,-0.04,-12.9,916000,10,247320,0,0,0,0,0,0,0,916000,-916000,-916000
20200212,044637,滬深2X元富94購01,,,,,0.00,0.00,0,0,0,0,0,0,0,0,0,0,0,0,0
20200212,044639,京元電元富94購01,0.76,0.86,0.75,0.85,+0.05,6.25,654000,46,516840,0,0,0,0,0,0,456000,230000,226000,226000
20200212,04463P,可成元富94售03,1.52,1.57,1.45,1.45,-0.22,-13.17,68000,8,102820,0,0,0,0,0,0,10000,58000,-48000,-48000
20200212,044641,上証2X國票93購02,0.02,0.02,0.02,0.02,0.00,0.00,50000,1,1000,0,0,0,0,0,0,0,50000,-50000,-50000
20200212,044643,滬深2X群益96購01,0.22,0.22,0.22,0.22,+0.01,4.76,150000,3,33000,0,0,0,0,0,0,150000,0,150000,150000
20200212,044645,元金2X群益93購01,0.56,0.56,0.56,0.56,0.00,0.00,70000,1,39200,0,0,0,0,0,0,70000,0,70000,70000
20200212,044646,旺宏群益93購01,,,,,0.00,0.00,0,0,0,0,0,0,0,0,0,0,0,0,0
20200212,044648,奇鋐群益93購01,,,,,0.00,0.00,0,0,0,0,0,0,0,0,0,0,0,0,0
20200212,04464P,可成元富94售04,1.58,1.58,1.58,1.58,-0.14,-8.14,10000,1,15800,0,0,0,0,0,0,10000,0,10000,10000
20200212,044650,百和群益93購01,,,,,0.00,0.00,0,0,0,0,0,0,0,0,0,0,0,0,0
20200212,044651,旺宏台新93購01,,,,,0.00,0.00,0,0,0,0,0,0,0,0,0,0,0,0,0
20200212,04465P,大立光元富94售03,0.50,0.50,0.44,0.44,0.00,0.00,50000,3,23600,0,0,0,0,0,0,0,50000,-50000,-50000
20200212,044665,京鼎國泰93購01,,,,,0.00,0.00,0,0,0,0,0,0,0,0,0,0,0,0,0
20200212,044666,創意國泰93購01,,,,,0.00,0.00,0,0,0,0,0,0,0,0,0,0,0,0,0
20200212,044667,滬深2X永昌93購01,,,,,0.00,0.00,0,0,0,0,0,0,0,0,0,0,0,0,0
20200212,04466P,大立光元富94售04,1.07,1.07,0.99,0.99,-0.22,-18.18,21000,3,21590,0,0,0,0,0,0,10000,11000,-1000,-1000
20200212,044671,台積電兆豐93購01,4.48,4.56,4.35,4.56,+0.40,9.62,65000,5,290800,0,0,0,0,0,0,35000,30000,5000,5000
20200212,044673,上銀凱基93購04,2.02,2.07,1.96,1.96,0.00,0.00,85000,4,168900,0,0,0,0,0,0,20000,65000,-45000,-45000
20200212,044675,廣宇凱基93購02,,,,,0.00,0.00,0,0,0,0,0,0,0,0,0,0,0,0,0
20200212,04467P,元油2X元大94售03,,,,,0.00,0.00,0,0,0,0,0,0,0,0,0,0,0,0,0
20200212,044680,華新科凱基93購06,,,,,0.00,0.00,0,0,0,0,0,0,0,0,0,0,0,0,0
20200212,044682,和鑫凱基93購01,,,,,0.00,0.00,0,0,0,0,0,0,0,0,0,0,0,0,0
20200212,044683,聯鈞凱基93購01,0.73,0.73,0.73,0.73,0.00,0.00,30000,1,21900,0,0,0,0,0,0,0,30000,-30000,-30000
20200212,044687,南寶凱基93購01,,,,,0.00,0.00,0,0,0,0,0,0,0,0,0,0,0,0,0
20200212,044688,傳奇凱基93購01,,,,,0.00,0.00,0,0,0,0,0,0,0,0,0,0,0,0,0
20200212,044689,超眾凱基93購03,0.35,0.40,0.01,0.40,+0.04,11.11,200000,17,71520,0,0,0,0,0,0,90000,110000,-20000,-20000
20200212,04468P,元油2X元大94售04,,,,,0.00,0.00,0,0,0,0,0,0,0,0,0,0,0,0,0
20200212,044693,滬深2X元大94購01,0.34,0.36,0.34,0.35,-0.01,-2.78,140000,5,49300,0,0,0,0,0,0,60000,80000,-20000,-20000
20200212,044694,道瓊反元大94購02,,,,,0.00,0.00,0,0,0,0,0,0,0,0,0,0,0,0,0
20200212,044695,國巨元大93購03,,,,,0.00,0.00,0,0,0,0,0,0,0,0,0,0,0,0,0
20200212,044697,美律元大93購02,0.17,0.17,0.17,0.17,+0.03,21.43,10000,1,1700,0,0,0,0,0,0,10000,0,10000,10000
20200212,044698,奇力新元大93購01,3.00,3.00,3.00,3.00,-0.02,-0.66,7000,2,21000,0,0,0,0,0,0,7000,0,7000,7000
20200212,04469P,元油2X元大94售05,,,,,0.00,0.00,0,0,0,0,0,0,0,0,0,0,0,0,0
20200212,044705,群創元大93購03,1.75,1.76,1.72,1.72,+0.01,0.58,17000,4,29600,0,0,0,0,0,0,17000,17000,0,0
20200212,044706,智易元大93購02,,,,,0.00,0.00,0,0,0,0,0,0,0,0,0,0,0,0,0
20200212,044707,合勤控元大93購01,,,,,0.00,0.00,0,0,0,0,0,0,0,0,0,0,0,0,0
20200212,04470P,為升元大94售01,,,,,0.00,0.00,0,0,0,0,0,0,0,0,0,0,0,0,0
20200212,044710,中磊元大93購01,,,,,0.00,0.00,0,0,0,0,0,0,0,0,0,0,0,0,0
20200212,044711,台郡元大93購01,2.13,2.17,2.10,2.13,+0.70,48.95,68000,10,145010,0,0,0,0,0,0,52000,10000,42000,42000
20200212,044716,上銀麥證93購01,,,,,0.00,0.00,0,0,0,0,0,0,0,0,0,0,0,0,0
20200212,044717,旺宏統一94購01,1.14,1.19,1.13,1.13,-0.02,-1.74,238000,5,280980,0,0,0,0,0,0,228000,10000,218000,218000
20200212,044718,宏達電統一93購02,,,,,0.00,0.00,0,0,0,0,0,0,0,0,0,0,0,0,0
20200212,044719,欣興亞東93購01,,,,,0.00,0.00,0,0,0,0,0,0,0,0,0,0,0,0,0
20200212,04471P,華通元大95售03,0.32,0.32,0.29,0.29,-0.14,-32.56,173000,6,52860,0,0,0,0,0,0,0,173000,-173000,-173000
20200212,044720,創意亞東93購01,,,,,0.00,0.00,0,0,0,0,0,0,0,0,0,0,0,0,0
20200212,044721,創意台新93購01,,,,,0.00,0.00,0,0,0,0,0,0,0,0,0,0,0,0,0
20200212,044722,滬深2X永豐93購01,,,,,0.00,0.00,0,0,0,0,0,0,0,0,0,0,0,0,0
20200212,04472P,中環元大94售01,1.41,1.47,1.41,1.47,+0.14,10.53,55000,8,78260,0,0,0,0,0,0,47000,8000,39000,39000
20200212,044734,台積電國泰93購01,,,,,0.00,0.00,0,0,0,0,0,0,0,0,0,0,0,0,0
20200212,044735,光磊國泰93購01,0.16,0.16,0.15,0.16,0.00,0.00,90000,14,14370,0,0,0,0,0,0,90000,0,90000,90000
20200212,044736,聯發科國泰93購01,,,,,0.00,0.00,0,0,0,0,0,0,0,0,0,0,0,0,0
20200212,044737,奇鋐國泰93購02,,,,,0.00,0.00,0,0,0,0,0,0,0,0,0,0,0,0,0
20200212,044738,緯穎國泰93購02,,,,,0.00,0.00,0,0,0,0,0,0,0,0,0,0,0,0,0
20200212,044739,美利達國泰93購01,,,,,0.00,0.00,0,0,0,0,0,0,0,0,0,0,0,0,0
20200212,04473P,國巨元大94售03,,,,,0.00,0.00,0,0,0,0,0,0,0,0,0,0,0,0,0
20200212,044741,玉山金富邦93購01,,,,,0.00,0.00,0,0,0,0,0,0,0,0,0,0,0,0,0
20200212,044742,國巨群益93購01,,,,,0.00,0.00,0,0,0,0,0,0,0,0,0,0,0,0,0
20200212,044746,智易群益93購01,,,,,0.00,0.00,0,0,0,0,0,0,0,0,0,0,0,0,0
20200212,044747,健策群益93購01,,,,,0.00,0.00,0,0,0,0,0,0,0,0,0,0,0,0,0
20200212,04474P,聯發科元大94售03,0.33,0.33,0.27,0.28,-0.15,-34.88,200000,9,57900,0,0,0,0,0,0,60000,140000,-80000,-80000
20200212,044750,鴻海凱基93購07,0.42,0.56,0.42,0.56,+0.20,55.56,362000,9,164600,0,0,0,0,0,0,21000,341000,-320000,-320000
20200212,044751,鴻海凱基93購08,0.04,0.04,0.03,0.03,-0.01,-25.0,110000,6,3400,0,0,0,0,0,0,0,0,0,0
20200212,044756,強茂凱基93購01,0.01,0.01,0.01,0.01,0.00,0.00,40000,1,400,0,0,0,0,0,0,40000,0,40000,40000
20200212,044757,益航凱基93購01,,,,,0.00,0.00,0,0,0,0,0,0,0,0,0,0,0,0,0
20200212,044758,玉山金凱基93購01,,,,,0.00,0.00,0,0,0,0,0,0,0,0,0,0,0,0,0
20200212,044759,新日興凱基93購01,0.86,0.88,0.01,0.79,-0.16,-16.84,237000,13,195260,0,0,0,0,0,0,182000,55000,127000,127000
20200212,04475P,欣興元大94售03,1.11,1.11,0.95,0.95,-0.22,-18.8,162000,8,163620,0,0,0,0,0,0,0,162000,-162000,-162000
20200212,044762,元翎凱基93購01,,,,,0.00,0.00,0,0,0,0,0,0,0,0,0,0,0,0,0
20200212,044763,瀚宇博凱基93購01,1.43,1.65,1.20,1.65,+0.18,12.24,60000,7,86380,0,0,0,0,0,0,50000,10000,40000,40000
20200212,044764,聯茂凱基93購03,,,,,0.00,0.00,0,0,0,0,0,0,0,0,0,0,0,0,0
20200212,044767,世紀鋼凱基93購06,,,,,0.00,0.00,0,0,0,0,0,0,0,0,0,0,0,0,0
20200212,044768,深中小元大94購02,0.79,0.79,0.79,0.79,+0.07,9.72,80000,2,63200,0,0,0,0,0,0,80000,0,80000,80000
20200212,04476P,玉晶光元大94售05,0.20,0.20,0.20,0.20,-0.04,-16.67,100000,1,20000,0,0,0,0,0,0,100000,0,100000,100000
20200212,044770,漢唐元大93購02,,,,,0.00,0.00,0,0,0,0,0,0,0,0,0,0,0,0,0
20200212,044773,創意元大93購02,,,,,0.00,0.00,0,0,0,0,0,0,0,0,0,0,0,0,0
20200212,044775,TPK元大93購01,,,,,0.00,0.00,0,0,0,0,0,0,0,0,0,0,0,0,0
20200212,044777,超眾元大93購01,,,,,0.00,0.00,0,0,0,0,0,0,0,0,0,0,0,0,0
20200212,044779,GIS元大93購05,,,,,0.00,0.00,0,0,0,0,0,0,0,0,0,0,0,0,0
20200212,04477P,南電元大94售04,1.54,1.54,1.34,1.39,-0.28,-16.77,100000,5,143300,0,0,0,0,0,0,30000,70000,-40000,-40000
20200212,044780,緯穎元大93購03,,,,,0.00,0.00,0,0,0,0,0,0,0,0,0,0,0,0,0
20200212,044784,華邦電中信96購01,0.31,0.32,0.30,0.30,+0.03,11.11,227000,8,70270,0,0,0,0,0,0,5000,222000,-217000,-217000
20200212,044785,台達電亞東93購01,0.32,0.32,0.32,0.32,0.00,0.00,1000,1,320,0,0,0,0,0,0,0,1000,-1000,-1000
20200212,044787,上銀群益93購01,,,,,0.00,0.00,0,0,0,0,0,0,0,0,0,0,0,0,0
20200212,04478P,元油2X中信95售03,1.08,1.08,1.08,1.08,-0.03,-2.7,10000,1,10800,0,0,0,0,0,0,10000,10000,0,0
20200212,044790,智易群益93購02,,,,,0.00,0.00,0,0,0,0,0,0,0,0,0,0,0,0,0
20200212,044792,康友群益93購01,2.05,2.08,2.05,2.08,0.00,0.00,15000,2,30900,0,0,0,0,0,0,5000,10000,-5000,-5000
20200212,044798,鴻海凱基93購09,,,,,0.00,0.00,0,0,0,0,0,0,0,0,0,0,0,0,0
20200212,044799,華邦電凱基93購01,,,,,0.00,0.00,0,0,0,0,0,0,0,0,0,0,0,0,0
20200212,04479P,同欣電中信96售02,0.25,0.25,0.25,0.25,0.00,0.00,100000,1,25000,0,0,0,0,0,0,0,100000,-100000,-100000
20200212,044800,華邦電凱基93購02,,,,,0.00,0.00,0,0,0,0,0,0,0,0,0,0,0,0,0
20200212,044801,微星凱基93購01,1.68,1.68,1.36,1.36,-0.06,-4.23,20000,3,30400,0,0,0,0,0,0,10000,10000,0,0
20200212,044805,旭富凱基93購01,0.85,0.85,0.62,0.62,+0.08,14.81,68000,9,52040,0,0,0,0,0,0,0,68000,-68000,-68000
20200212,044806,利勤凱基93購01,,,,,0.00,0.00,0,0,0,0,0,0,0,0,0,0,0,0,0
20200212,044809,道瓊反國票93購01,,,,,0.00,0.00,0,0,0,0,0,0,0,0,0,0,0,0,0
20200212,04480P,微星兆豐94售01,,,,,0.00,0.00,0,0,0,0,0,0,0,0,0,0,0,0,0
20200212,044810,為升國票93購01,,,,,0.00,0.00,0,0,0,0,0,0,0,0,0,0,0,0,0
20200212,044813,為升兆豐93購02,,,,,0.00,0.00,0,0,0,0,0,0,0,0,0,0,0,0,0
20200212,044814,華邦電兆豐93購02,,,,,0.00,0.00,0,0,0,0,0,0,0,0,0,0,0,0,0
20200212,044815,宏碁兆豐93購01,,,,,0.00,0.00,0,0,0,0,0,0,0,0,0,0,0,0,0
20200212,044816,漢唐兆豐93購02,0.89,0.89,0.89,0.89,0.00,0.00,45000,1,40050,0,0,0,0,0,0,0,45000,-45000,-45000
20200212,044817,可成兆豐93購01,0.45,0.49,0.43,0.49,+0.10,25.64,139000,8,62880,0,0,0,0,0,0,10000,129000,-119000,-119000
20200212,044818,可成兆豐93購02,0.27,0.27,0.27,0.27,+0.07,35.0,6000,1,1620,0,0,0,0,0,0,0,6000,-6000,-6000
20200212,044819,新日興兆豐93購02,0.84,0.84,0.78,0.78,-0.11,-12.36,128000,15,104970,0,0,0,0,0,0,71000,57000,14000,14000
20200212,04481P,聯發科日盛94售01,,,,,0.00,0.00,0,0,0,0,0,0,0,0,0,0,0,0,0
20200212,044820,臻鼎兆豐93購02,0.59,0.66,0.46,0.48,+0.08,20.0,66000,8,35340,0,0,0,0,0,0,14000,52000,-38000,-38000
20200212,044821,瑞儀兆豐93購03,,,,,0.00,0.00,0,0,0,0,0,0,0,0,0,0,0,0,0
20200212,044822,南電兆豐93購01,0.25,0.25,0.25,0.25,0.00,0.00,155000,3,38750,0,0,0,0,0,0,0,155000,-155000,-155000
20200212,044823,華邦電台新93購01,,,,,0.00,0.00,0,0,0,0,0,0,0,0,0,0,0,0,0
20200212,044824,元油2X永豐93購02,,,,,0.00,0.00,0,0,0,0,0,0,0,0,0,0,0,0,0
20200212,04482P,臺股指日盛94售01,,,,,0.00,0.00,0,0,0,0,0,0,0,0,0,0,0,0,0
20200212,044834,旺宏元大93購02,0.96,0.96,0.96,0.96,-0.05,-4.95,4000,1,3840,0,0,0,0,0,0,4000,0,4000,4000
20200212,044836,宏達電元大93購05,,,,,0.00,0.00,0,0,0,0,0,0,0,0,0,0,0,0,0
20200212,04483P,元油2X凱基97售04,,,,,0.00,0.00,0,0,0,0,0,0,0,0,0,0,0,0,0
20200212,044844,國巨統一93購04,,,,,0.00,0.00,0,0,0,0,0,0,0,0,0,0,0,0,0
20200212,044846,旺宏統一93購01,,,,,0.00,0.00,0,0,0,0,0,0,0,0,0,0,0,0,0
20200212,044848,華邦電統一94購01,0.16,0.16,0.16,0.16,0.00,0.00,24000,6,3840,0,0,0,0,0,0,0,24000,-24000,-24000
20200212,04484P,台積電凱基94售09,,,,,0.00,0.00,0,0,0,0,0,0,0,0,0,0,0,0,0
20200212,044850,南亞科統一94購01,1.88,1.89,1.86,1.89,+0.04,2.16,39000,3,73230,0,0,0,0,0,0,38000,1000,37000,37000
20200212,044852,華邦電國泰93購02,0.32,0.33,0.32,0.32,+0.08,33.33,380000,6,122750,0,0,0,0,0,0,0,380000,-380000,-380000
20200212,044853,亞光國泰93購01,0.50,0.60,0.50,0.60,+0.15,33.33,222000,9,128430,0,0,0,0,0,0,35000,187000,-152000,-152000
20200212,044854,智易國泰93購01,,,,,0.00,0.00,0,0,0,0,0,0,0,0,0,0,0,0,0
20200212,044855,南電國泰93購01,,,,,0.00,0.00,0,0,0,0,0,0,0,0,0,0,0,0,0
20200212,044858,儒鴻亞東93購01,,,,,0.00,0.00,0,0,0,0,0,0,0,0,0,0,0,0,0
20200212,044859,南電亞東93購01,,,,,0.00,0.00,0,0,0,0,0,0,0,0,0,0,0,0,0
20200212,04485P,台積電凱基94售10,,,,,0.00,0.00,0,0,0,0,0,0,0,0,0,0,0,0,0
20200212,044860,元油2X中信93購01,,,,,0.00,0.00,0,0,0,0,0,0,0,0,0,0,0,0,0
20200212,044861,玉晶光兆豐93購01,0.91,1.05,0.91,1.05,+0.28,36.36,31000,7,29030,0,0,0,0,0,0,19000,12000,7000,7000
20200212,044862,台表科兆豐93購01,1.44,1.65,1.44,1.65,+0.22,15.38,30000,3,45600,0,0,0,0,0,0,10000,20000,-10000,-10000
20200212,044863,矽創兆豐93購01,0.35,0.55,0.35,0.55,+0.19,52.78,220000,25,109420,0,0,0,0,0,0,16000,204000,-188000,-188000
20200212,044864,道瓊反國票96購01,0.05,0.05,0.05,0.05,0.00,0.00,215000,2,10750,0,0,0,0,0,0,0,215000,-215000,-215000
20200212,044869,易華電國票93購01,,,,,0.00,0.00,0,0,0,0,0,0,0,0,0,0,0,0,0
20200212,04486P,台光電凱基94售05,,,,,0.00,0.00,0,0,0,0,0,0,0,0,0,0,0,0,0
20200212,044871,國巨統一93購05,,,,,0.00,0.00,0,0,0,0,0,0,0,0,0,0,0,0,0
20200212,044872,旺宏統一93購02,,,,,0.00,0.00,0,0,0,0,0,0,0,0,0,0,0,0,0
20200212,044875,玉晶光統一93購01,1.15,1.15,1.12,1.12,+0.10,9.8,14000,3,15800,0,0,0,0,0,0,14000,0,14000,14000
20200212,044878,元上證群益93購01,,,,,0.00,0.00,0,0,0,0,0,0,0,0,0,0,0,0,0
20200212,044879,上証2X群益93購01,0.17,0.17,0.17,0.17,+0.01,6.25,1000,1,170,0,0,0,0,0,0,0,1000,-1000,-1000
20200212,04487P,南亞科凱基94售01,,,,,0.00,0.00,0,0,0,0,0,0,0,0,0,0,0,0,0
20200212,044883,玉晶光群益93購01,2.38,2.38,2.38,2.38,0.00,0.00,30000,1,71400,0,0,0,0,0,0,30000,0,30000,30000
20200212,044884,嘉澤群益93購01,,,,,0.00,0.00,0,0,0,0,0,0,0,0,0,0,0,0,0
20200212,044885,智易群益93購03,,,,,0.00,0.00,0,0,0,0,0,0,0,0,0,0,0,0,0
20200212,044887,亞光麥證93購01,,,,,0.00,0.00,0,0,0,0,0,0,0,0,0,0,0,0,0
20200212,04488P,聯發科凱基94售05,,,,,0.00,0.00,0,0,0,0,0,0,0,0,0,0,0,0,0
20200212,044890,卜蜂凱基93購01,,,,,0.00,0.00,0,0,0,0,0,0,0,0,0,0,0,0,0
20200212,044896,國巨凱基93購01,,,,,0.00,0.00,0,0,0,0,0,0,0,0,0,0,0,0,0
20200212,044898,旺宏凱基93購01,1.68,1.71,1.55,1.55,-0.15,-8.82,133000,6,219570,0,0,0,0,0,0,128000,5000,123000,123000
20200212,04489P,大立光凱基94售03,,,,,0.00,0.00,0,0,0,0,0,0,0,0,0,0,0,0,0
20200212,044900,建準凱基93購01,0.84,0.85,0.84,0.85,-0.02,-2.3,11000,2,9250,0,0,0,0,0,0,11000,0,11000,11000
20200212,044901,聯發科凱基93購01,5.05,5.05,5.05,5.05,+0.49,10.75,20000,2,101000,0,0,0,0,0,0,20000,0,20000,20000
20200212,044908,玉晶光凱基93購01,3.76,4.18,1.31,4.06,+0.48,13.41,64000,5,229010,0,0,0,0,0,0,50000,8000,42000,42000
20200212,044909,玉晶光凱基93購02,,,,,0.00,0.00,0,0,0,0,0,0,0,0,0,0,0,0,0
20200212,04490P,聯發科台新94售02,0.45,0.45,0.44,0.44,-0.19,-30.16,6000,2,2690,0,0,0,0,0,0,0,6000,-6000,-6000
20200212,044913,寶成凱基93購01,,,,,0.00,0.00,0,0,0,0,0,0,0,0,0,0,0,0,0
20200212,04491P,光磊康和94售01,0.68,0.71,0.68,0.71,-0.01,-1.39,250000,5,175400,0,0,0,0,0,0,70000,180000,-110000,-110000
20200212,044922,玉晶光永豐93購01,1.34,1.34,1.34,1.34,+0.29,27.62,10000,1,13400,0,0,0,0,0,0,10000,0,10000,10000
20200212,044925,漢唐國泰93購01,1.03,1.03,1.03,1.03,0.00,0.00,1000,1,1030,0,0,0,0,0,0,1000,0,1000,1000
20200212,044926,聯詠國泰93購01,2.68,2.68,2.60,2.60,0.00,0.00,50000,5,131600,0,0,0,0,0,0,0,50000,-50000,-50000
20200212,044927,聯詠國泰94購01,2.39,2.39,2.39,2.39,+0.30,14.35,40000,1,95600,0,0,0,0,0,0,40000,0,40000,40000
20200212,044928,玉晶光國泰93購01,2.38,2.38,2.38,2.38,+0.18,8.18,23000,1,54740,0,0,0,0,0,0,23000,0,23000,23000
20200212,044929,康控國泰93購01,,,,,0.00,0.00,0,0,0,0,0,0,0,0,0,0,0,0,0
20200212,04492P,元油2X永豐94售03,,,,,0.00,0.00,0,0,0,0,0,0,0,0,0,0,0,0,0
20200212,044930,元黃金富邦93購01,,,,,0.00,0.00,0,0,0,0,0,0,0,0,0,0,0,0,0
20200212,044932,國巨元大93購04,,,,,0.00,0.00,0,0,0,0,0,0,0,0,0,0,0,0,0
20200212,044934,玉晶光元大93購01,1.26,1.42,1.20,1.40,+0.25,21.74,349000,21,455440,86000,0,86000,0,0,0,180000,169000,11000,97000
20200212,044935,玉晶光元大93購03,1.57,1.71,1.57,1.71,+0.25,17.12,3000,3,4960,0,0,0,0,0,0,1000,2000,-1000,-1000
20200212,044938,國巨亞東93購01,,,,,0.00,0.00,0,0,0,0,0,0,0,0,0,0,0,0,0
20200212,044939,亞光亞東93購01,,,,,0.00,0.00,0,0,0,0,0,0,0,0,0,0,0,0,0
20200212,04493P,漢唐永豐94售01,,,,,0.00,0.00,0,0,0,0,0,0,0,0,0,0,0,0,0
20200212,044941,鴻海群益93購01,0.60,0.68,0.60,0.68,+0.29,74.36,6000,2,3760,0,0,0,0,0,0,6000,0,6000,6000
20200212,044942,國巨群益94購01,,,,,0.00,0.00,0,0,0,0,0,0,0,0,0,0,0,0,0
20200212,044943,旺宏群益93購03,,,,,0.00,0.00,0,0,0,0,0,0,0,0,0,0,0,0,0
20200212,044944,技嘉群益93購01,,,,,0.00,0.00,0,0,0,0,0,0,0,0,0,0,0,0,0
20200212,04494P,台積電國票94售04,,,,,0.00,0.00,0,0,0,0,0,0,0,0,0,0,0,0,0
20200212,044950,玉晶光群益94購01,2.79,3.12,2.79,3.04,+0.37,13.86,128000,15,383090,0,0,0,0,0,0,55000,73000,-18000,-18000
20200212,044958,鎧勝凱基93購01,,,,,0.00,0.00,0,0,0,0,0,0,0,0,0,0,0,0,0
20200212,04495P,台積電國票95售01,,,,,0.00,0.00,0,0,0,0,0,0,0,0,0,0,0,0,0
20200212,044960,京元電兆豐93購01,0.63,0.72,0.63,0.72,+0.09,14.29,821000,45,547300,0,0,0,0,0,0,821000,0,821000,821000
20200212,044961,聯電中信94購01,1.08,1.23,1.07,1.23,+0.11,9.82,198000,29,220660,0,0,0,0,0,0,93000,102000,-9000,-9000
20200212,044963,台積電中信96購01,3.36,3.47,3.31,3.47,+0.22,6.77,63000,14,211940,0,0,0,0,0,0,34000,28000,6000,6000
20200212,044964,旺宏中信94購01,0.50,0.53,0.47,0.48,-0.02,-4.0,593000,18,285600,0,0,0,0,0,0,340000,243000,97000,97000
20200212,044965,大立光中信95購01,0.53,0.56,0.53,0.56,+0.08,16.67,110000,6,61190,0,0,0,0,0,0,110000,0,110000,110000
20200212,044966,台表科中信94購01,0.69,0.71,0.69,0.71,+0.07,10.94,40000,5,28050,0,0,0,0,0,0,0,40000,-40000,-40000
20200212,04496P,國巨國泰96售02,0.10,0.11,0.10,0.11,-0.01,-8.33,80000,5,8550,0,0,0,0,0,0,0,0,0,0
20200212,044972,元金2X國票96購01,1.00,1.00,1.00,1.00,-0.02,-1.96,4000,2,4000,0,0,0,0,0,0,0,4000,-4000,-4000
20200212,044974,鴻海國票94購01,0.04,0.04,0.03,0.04,0.00,0.00,1160000,22,35910,0,0,0,0,0,0,0,0,0,0
20200212,044976,台積電國票93購01,,,,,0.00,0.00,0,0,0,0,0,0,0,0,0,0,0,0,0
20200212,04497P,元油2X富邦97售03,,,,,0.00,0.00,0,0,0,0,0,0,0,0,0,0,0,0,0
20200212,044983,玉晶光國票93購01,,,,,0.00,0.00,0,0,0,0,0,0,0,0,0,0,0,0,0
20200212,044984,群創國票93購02,,,,,0.00,0.00,0,0,0,0,0,0,0,0,0,0,0,0,0
20200212,044987,宏達電統一94購01,,,,,0.00,0.00,0,0,0,0,0,0,0,0,0,0,0,0,0
20200212,044988,玉晶光統一95購01,2.55,2.63,2.45,2.63,+0.25,10.5,85000,11,216150,0,0,0,0,0,0,25000,60000,-35000,-35000
20200212,04498P,台積電富邦94售04,,,,,0.00,0.00,0,0,0,0,0,0,0,0,0,0,0,0,0
20200212,044991,T50反1國泰93購02,,,,,0.00,0.00,0,0,0,0,0,0,0,0,0,0,0,0,0
20200212,044992,力山國泰94購01,,,,,0.00,0.00,0,0,0,0,0,0,0,0,0,0,0,0,0
20200212,044993,友達國泰93購01,,,,,0.00,0.00,0,0,0,0,0,0,0,0,0,0,0,0,0
20200212,044994,宏達電國泰93購01,,,,,0.00,0.00,0,0,0,0,0,0,0,0,0,0,0,0,0
20200212,044995,大立光國泰94購01,0.87,0.91,0.85,0.91,+0.15,19.74,311000,6,268470,0,0,0,0,0,0,311000,200000,111000,111000
20200212,044996,嘉晶國泰95購01,0.58,0.65,0.58,0.62,0.00,0.00,469000,14,283580,0,0,0,0,0,0,10000,459000,-449000,-449000
20200212,044997,信邦國泰93購01,,,,,0.00,0.00,0,0,0,0,0,0,0,0,0,0,0,0,0
20200212,044998,玉晶光國泰94購01,,,,,0.00,0.00,0,0,0,0,0,0,0,0,0,0,0,0,0
20200212,044999,滬深2X永昌93購02,,,,,0.00,0.00,0,0,0,0,0,0,0,0,0,0,0,0,0
20200212,04499P,滬深2X統一94售03,1.00,1.02,1.00,1.01,0.00,0.00,41000,11,41280,0,0,0,0,0,0,34000,7000,27000,27000
20200212,045000,鴻海富邦93購01,0.01,0.01,0.01,0.01,0.00,0.00,250000,2,2500,0,0,0,0,0,0,250000,0,250000,250000
20200212,045001,旺宏富邦94購01,,,,,0.00,0.00,0,0,0,0,0,0,0,0,0,0,0,0,0
20200212,04500P,燿華統一94售01,1.13,1.13,1.13,1.13,0.00,0.00,6000,1,6780,0,0,0,0,0,0,0,6000,-6000,-6000
20200212,045013,大立光元大93購04,1.20,1.26,1.20,1.26,+0.21,20.0,6000,2,7500,0,0,0,0,0,0,6000,0,6000,6000
20200212,045014,和鑫元大93購02,,,,,0.00,0.00,0,0,0,0,0,0,0,0,0,0,0,0,0
20200212,045015,玉晶光元大94購01,1.39,1.48,1.36,1.48,+0.18,13.85,132000,11,187620,0,0,0,0,0,0,52000,81000,-29000,-29000
20200212,045016,創意元大94購01,0.16,0.16,0.15,0.15,-0.06,-28.57,16000,3,2500,0,0,0,0,0,0,16000,0,16000,16000
20200212,045018,矽創元大93購01,0.76,1.04,0.76,1.04,+0.29,38.67,63000,3,58420,0,0,0,0,0,0,53000,10000,43000,43000
20200212,04501P,元油2X元富98售07,,,,,0.00,0.00,0,0,0,0,0,0,0,0,0,0,0,0,0
20200212,045021,臺股指中信94購02,,,,,0.00,0.00,0,0,0,0,0,0,0,0,0,0,0,0,0
20200212,045022,聯電亞東93購01,1.58,1.58,1.58,1.58,-0.16,-9.2,81000,4,127980,0,0,0,0,0,0,81000,0,81000,81000
20200212,045023,聯發科亞東93購01,2.06,2.06,2.06,2.06,0.00,0.00,1000,1,2060,0,0,0,0,0,0,1000,0,1000,1000
20200212,045024,宏達電兆豐93購01,,,,,0.00,0.00,0,0,0,0,0,0,0,0,0,0,0,0,0
20200212,04502P,元油2X元富98售08,,,,,0.00,0.00,0,0,0,0,0,0,0,0,0,0,0,0,0
20200212,045031,上銀群益93購02,0.27,0.27,0.27,0.27,0.00,0.00,5000,1,1350,0,0,0,0,0,0,5000,0,5000,5000
20200212,045035,潤泰全群益93購01,,,,,0.00,0.00,0,0,0,0,0,0,0,0,0,0,0,0,0
20200212,045036,TPK群益93購02,,,,,0.00,0.00,0,0,0,0,0,0,0,0,0,0,0,0,0
20200212,045038,臻鼎群益93購01,1.13,1.13,1.13,1.13,+0.51,82.26,10000,1,11300,0,0,0,0,0,0,10000,0,10000,10000
20200212,04503P,元油2X元富98售09,2.64,2.64,2.62,2.62,-0.07,-2.6,152000,3,401240,0,0,0,0,0,0,152000,0,152000,152000
20200212,045043,台達電凱基93購01,,,,,0.00,0.00,0,0,0,0,0,0,0,0,0,0,0,0,0
20200212,04504P,台積電元富94售04,,,,,0.00,0.00,0,0,0,0,0,0,0,0,0,0,0,0,0
20200212,045050,新唐凱基93購01,,,,,0.00,0.00,0,0,0,0,0,0,0,0,0,0,0,0,0
20200212,045053,聯發科元富98購01,1.10,1.23,1.10,1.20,+0.19,18.81,618000,52,728550,5000,0,5000,0,0,0,263000,298000,-35000,-30000
20200212,045054,聯發科元富98購02,1.54,1.70,1.54,1.67,+0.26,18.44,719000,59,1174120,0,0,0,0,0,0,378000,319000,59000,59000
20200212,045055,聯發科元富98購03,2.65,2.86,2.65,2.83,+0.35,14.11,124000,16,343060,0,0,0,0,0,0,81000,43000,38000,38000
20200212,045058,華邦電國泰94購01,,,,,0.00,0.00,0,0,0,0,0,0,0,0,0,0,0,0,0
20200212,045059,同欣電國泰93購01,,,,,0.00,0.00,0,0,0,0,0,0,0,0,0,0,0,0,0
20200212,04505P,佳世達元富96售03,1.00,1.00,1.00,1.00,0.00,0.00,6000,1,6000,0,0,0,0,0,0,0,6000,-6000,-6000
20200212,045060,世紀鋼富邦93購01,0.02,0.02,0.02,0.02,0.00,0.00,30000,1,600,0,0,0,0,0,0,30000,0,30000,30000
20200212,045061,聯茂台新93購01,,,,,0.00,0.00,0,0,0,0,0,0,0,0,0,0,0,0,0
20200212,045069,美律元大93購03,0.46,0.55,0.46,0.55,+0.14,34.15,169000,9,82230,0,0,0,0,0,0,55000,114000,-59000,-59000
20200212,04506P,旺宏元大94售06,0.32,0.34,0.32,0.34,0.00,0.00,110000,3,35300,0,0,0,0,0,0,5000,105000,-100000,-100000
20200212,045070,全新元大93購02,0.24,0.28,0.24,0.28,+0.07,33.33,110000,2,30400,0,0,0,0,0,0,10000,100000,-90000,-90000
20200212,045071,奇力新元大94購01,,,,,0.00,0.00,0,0,0,0,0,0,0,0,0,0,0,0,0
20200212,045073,可成元大93購01,0.60,0.74,0.60,0.74,+0.17,29.82,321000,12,205340,0,0,0,0,0,0,300000,21000,279000,279000
20200212,045074,華新科元大93購03,3.35,3.35,3.35,3.35,+0.16,5.02,7000,2,23450,0,0,0,0,0,0,7000,0,7000,7000
20200212,045079,大立光元大93購05,0.38,0.38,0.38,0.38,0.00,0.00,1000,1,380,0,0,0,0,0,0,0,1000,-1000,-1000
20200212,04507P,台光電元大94售03,,,,,0.00,0.00,0,0,0,0,0,0,0,0,0,0,0,0,0
20200212,045080,大立光元大93購06,0.77,0.77,0.77,0.77,0.00,0.00,100000,1,77000,0,0,0,0,0,0,0,100000,-100000,-100000
20200212,045081,大立光元大93購07,1.06,1.06,1.06,1.06,0.00,0.00,100000,1,106000,0,0,0,0,0,0,0,100000,-100000,-100000
20200212,045084,欣興元大93購02,,,,,0.00,0.00,0,0,0,0,0,0,0,0,0,0,0,0,0
20200212,045086,玉晶光元大94購02,1.47,1.59,1.42,1.59,+0.20,14.39,195000,33,286360,0,0,0,0,0,0,176000,21000,155000,155000
20200212,045087,玉晶光元大95購01,1.84,1.94,1.84,1.94,+0.16,8.99,7000,3,13440,0,0,0,0,0,0,7000,0,7000,7000
20200212,045088,康控元大94購02,0.44,0.49,0.44,0.49,+0.07,16.67,276000,8,134570,0,0,0,0,0,0,20000,256000,-236000,-236000
20200212,045089,中磊元大94購01,,,,,0.00,0.00,0,0,0,0,0,0,0,0,0,0,0,0,0
20200212,04508P,臺股指元大94售03,,,,,0.00,0.00,0,0,0,0,0,0,0,0,0,0,0,0,0
20200212,045090,瀚宇博元大93購01,,,,,0.00,0.00,0,0,0,0,0,0,0,0,0,0,0,0,0
20200212,045093,台表科元大93購02,1.41,1.53,1.40,1.53,+0.21,15.91,210000,6,296150,0,0,0,0,0,0,200000,10000,190000,190000
20200212,045095,緯穎元大94購02,,,,,0.00,0.00,0,0,0,0,0,0,0,0,0,0,0,0,0
20200212,04509P,臺股指元大94售04,,,,,0.00,0.00,0,0,0,0,0,0,0,0,0,0,0,0,0
20200212,045100,亞光中信93購01,,,,,0.00,0.00,0,0,0,0,0,0,0,0,0,0,0,0,0
20200212,045101,玉晶光中信94購01,0.60,0.67,0.60,0.66,+0.09,15.79,499000,19,321970,0,0,0,0,0,0,252000,247000,5000,5000
20200212,045102,京元電亞東93購01,,,,,0.00,0.00,0,0,0,0,0,0,0,0,0,0,0,0,0
20200212,045103,上海銀亞東94購01,,,,,0.00,0.00,0,0,0,0,0,0,0,0,0,0,0,0,0
20200212,045106,玉晶光群益95購01,1.87,2.02,1.87,2.02,+0.22,12.22,108000,11,212570,0,0,0,0,0,0,19000,89000,-70000,-70000
20200212,045108,康友群益93購02,2.04,2.04,2.04,2.04,+0.22,12.09,2000,2,4080,0,0,0,0,0,0,0,0,0,0
20200212,04510P,臺股指元大94售05,,,,,0.00,0.00,0,0,0,0,0,0,0,0,0,0,0,0,0
20200212,045114,玉晶光永豐93購02,1.85,1.85,1.85,1.85,0.00,0.00,10000,1,18500,0,0,0,0,0,0,10000,0,10000,10000
20200212,045115,玉晶光永豐94購01,1.61,1.67,1.59,1.67,+0.16,10.6,49000,3,78830,0,0,0,0,0,0,49000,1000,48000,48000
20200212,04511P,臺股指元大94售06,0.26,0.26,0.23,0.23,-0.09,-28.12,554000,4,143140,0,0,0,0,0,0,0,554000,-554000,-554000
20200212,045121,康控元大93購03,0.31,0.31,0.31,0.31,0.00,0.00,10000,1,3100,0,0,0,0,0,0,0,10000,-10000,-10000
20200212,045122,臺股指元大93購08,,,,,0.00,0.00,0,0,0,0,0,0,0,0,0,0,0,0,0
20200212,045123,臺股指元大93購09,,,,,0.00,0.00,0,0,0,0,0,0,0,0,0,0,0,0,0
20200212,045124,臺股指元大93購10,,,,,0.00,0.00,0,0,0,0,0,0,0,0,0,0,0,0,0
20200212,045125,臺股指元大93購11,,,,,0.00,0.00,0,0,0,0,0,0,0,0,0,0,0,0,0
20200212,045126,臺股指元大93購12,,,,,0.00,0.00,0,0,0,0,0,0,0,0,0,0,0,0,0
20200212,04512P,臺股指元大94售07,,,,,0.00,0.00,0,0,0,0,0,0,0,0,0,0,0,0,0
20200212,04513P,元石油中信94售01,,,,,0.00,0.00,0,0,0,0,0,0,0,0,0,0,0,0,0
20200212,045140,玉晶光兆豐93購02,,,,,0.00,0.00,0,0,0,0,0,0,0,0,0,0,0,0,0
20200212,045142,聯茂兆豐93購02,0.04,0.05,0.04,0.05,0.00,0.00,2058000,23,82420,0,0,0,0,0,0,2010000,38000,1972000,1972000
20200212,045149,聯發科凱基93購02,4.30,4.56,4.30,4.56,+0.74,19.37,70000,3,308800,0,0,0,0,0,0,70000,0,70000,70000
20200212,04514P,元石油中信97售01,0.90,0.90,0.89,0.89,-0.03,-3.26,23000,5,20640,0,0,0,0,0,0,18000,5000,13000,13000
20200212,045150,聯發科凱基93購03,3.31,3.31,0.03,0.03,-2.92,-98.98,62000,4,171940,0,0,0,0,0,0,52000,22000,30000,30000
20200212,045151,大立光凱基93購02,,,,,0.00,0.00,0,0,0,0,0,0,0,0,0,0,0,0,0
20200212,045152,大立光凱基93購03,,,,,0.00,0.00,0,0,0,0,0,0,0,0,0,0,0,0,0
20200212,045153,大立光凱基93購04,,,,,0.00,0.00,0,0,0,0,0,0,0,0,0,0,0,0,0
20200212,04515P,元油2X群益97售02,,,,,0.00,0.00,0,0,0,0,0,0,0,0,0,0,0,0,0
20200212,045161,玉晶光國泰94購03,1.73,1.83,1.69,1.83,+0.19,11.59,362000,9,644860,0,0,0,0,0,0,362000,0,362000,362000
20200212,045162,玉晶光國泰94購04,2.12,2.12,2.12,2.12,+0.17,8.72,10000,1,21200,0,0,0,0,0,0,10000,0,10000,10000
20200212,045163,瀚宇博國泰93購01,0.47,0.59,0.46,0.59,+0.09,18.0,71000,19,37210,0,0,0,0,0,0,71000,0,71000,71000
20200212,045165,台虹國泰93購01,0.28,0.28,0.28,0.28,+0.05,21.74,100000,1,28000,0,0,0,0,0,0,100000,0,100000,100000
20200212,045168,欣興中信93購02,0.56,0.70,0.56,0.70,+0.19,37.25,384000,14,248190,0,0,0,0,0,0,27000,357000,-330000,-330000
20200212,04516P,台積電群益94售07,,,,,0.00,0.00,0,0,0,0,0,0,0,0,0,0,0,0,0
20200212,045172,欣興兆豐94購01,1.26,1.50,1.26,1.50,+0.33,28.21,230000,7,293800,0,0,0,0,0,0,225000,0,225000,225000
20200212,045173,A50正2國票95購01,0.13,0.13,0.13,0.13,-0.01,-7.14,30000,2,3900,0,0,0,0,0,0,0,30000,-30000,-30000
20200212,04517P,宏達電群益95售01,1.80,1.81,1.80,1.81,-0.12,-6.22,6000,6,10850,0,0,0,0,0,0,6000,0,6000,6000
20200212,045184,京元電統一93購01,0.30,0.30,0.30,0.30,-0.04,-11.76,10000,2,3000,0,0,0,0,0,0,10000,0,10000,10000
20200212,045185,致伸統一94購01,,,,,0.00,0.00,0,0,0,0,0,0,0,0,0,0,0,0,0
20200212,045189,大立光元富98購01,1.69,1.87,1.69,1.86,+0.20,12.05,406000,31,739380,0,0,0,0,0,0,375000,33000,342000,342000
20200212,04518P,高鐵群益95售01,1.09,1.09,1.08,1.08,-0.05,-4.42,58000,2,63210,0,0,0,0,0,0,0,58000,-58000,-58000
20200212,045193,聯發科群益93購01,,,,,0.00,0.00,0,0,0,0,0,0,0,0,0,0,0,0,0
20200212,04519P,國泰金群益94售01,,,,,0.00,0.00,0,0,0,0,0,0,0,0,0,0,0,0,0
20200212,045206,創意國泰93購02,0.58,0.66,0.53,0.64,-0.10,-13.51,319000,56,192780,0,0,0,0,0,0,165000,144000,21000,21000
20200212,045207,智易國泰93購02,0.07,0.07,0.07,0.07,+0.03,75.0,10000,1,700,0,0,0,0,0,0,10000,0,10000,10000
20200212,045208,力成國泰94購01,,,,,0.00,0.00,0,0,0,0,0,0,0,0,0,0,0,0,0
20200212,045209,T50反1富邦94購01,,,,,0.00,0.00,0,0,0,0,0,0,0,0,0,0,0,0,0
20200212,04520P,欣興群益94售02,1.31,1.31,1.20,1.20,-0.28,-18.92,55000,4,71200,0,0,0,0,0,0,30000,25000,5000,5000
20200212,045210,鴻海富邦93購02,,,,,0.00,0.00,0,0,0,0,0,0,0,0,0,0,0,0,0
20200212,045212,T50反1元大93購01,,,,,0.00,0.00,0,0,0,0,0,0,0,0,0,0,0,0,0
20200212,045213,A50正2元大95購01,0.47,0.47,0.47,0.47,-0.01,-2.08,230000,2,108100,0,0,0,0,0,0,210000,20000,190000,190000
20200212,045216,鴻海元大93購02,0.65,0.93,0.65,0.93,+0.30,47.62,228000,10,181960,0,0,0,0,0,0,21000,208000,-187000,-187000
20200212,045217,國巨元大93購05,,,,,0.00,0.00,0,0,0,0,0,0,0,0,0,0,0,0,0
20200212,04521P,元油2X日盛94售02,,,,,0.00,0.00,0,0,0,0,0,0,0,0,0,0,0,0,0
20200212,045220,漢唐元大94購01,1.72,1.76,1.72,1.76,+0.07,4.14,43000,5,74480,0,0,0,0,0,0,43000,0,43000,43000
20200212,045223,潤泰全元大93購01,0.81,0.81,0.81,0.81,0.00,0.00,10000,1,8100,0,0,0,0,0,0,0,10000,-10000,-10000
20200212,045226,TPK元大93購02,,,,,0.00,0.00,0,0,0,0,0,0,0,0,0,0,0,0,0
20200212,045227,致伸元大93購01,,,,,0.00,0.00,0,0,0,0,0,0,0,0,0,0,0,0,0
20200212,045228,泰鼎元大93購01,0.34,0.35,0.32,0.35,0.00,0.00,31000,4,10350,0,0,0,0,0,0,20000,11000,9000,9000
20200212,04522P,卜蜂凱基94售02,,,,,0.00,0.00,0,0,0,0,0,0,0,0,0,0,0,0,0
20200212,045230,嘉聯益元大93購01,,,,,0.00,0.00,0,0,0,0,0,0,0,0,0,0,0,0,0
20200212,045231,南電元大94購01,0.87,1.04,0.85,1.01,+0.15,17.44,283000,21,257520,0,0,0,0,0,0,283000,12000,271000,271000
20200212,045235,致茂中信93購01,0.47,0.58,0.47,0.58,+0.13,28.89,628000,39,330340,0,0,0,0,0,0,265000,363000,-98000,-98000
20200212,04523P,亞德客凱基94售02,,,,,0.00,0.00,0,0,0,0,0,0,0,0,0,0,0,0,0
20200212,045249,亞德客凱基93購01,,,,,0.00,0.00,0,0,0,0,0,0,0,0,0,0,0,0,0
20200212,04524P,台積電凱基94售13,,,,,0.00,0.00,0,0,0,0,0,0,0,0,0,0,0,0,0
20200212,045250,華通凱基94購01,,,,,0.00,0.00,0,0,0,0,0,0,0,0,0,0,0,0,0
20200212,045252,國巨凱基93購03,,,,,0.00,0.00,0,0,0,0,0,0,0,0,0,0,0,0,0
20200212,045255,華邦電凱基93購03,,,,,0.00,0.00,0,0,0,0,0,0,0,0,0,0,0,0,0
20200212,045258,漢唐凱基93購01,,,,,0.00,0.00,0,0,0,0,0,0,0,0,0,0,0,0,0
20200212,04525P,台積電凱基94售14,,,,,0.00,0.00,0,0,0,0,0,0,0,0,0,0,0,0,0
20200212,045265,和鑫凱基94購01,,,,,0.00,0.00,0,0,0,0,0,0,0,0,0,0,0,0,0
20200212,04526P,美律凱基94售03,,,,,0.00,0.00,0,0,0,0,0,0,0,0,0,0,0,0,0
20200212,045271,元油2X統一93購01,,,,,0.00,0.00,0,0,0,0,0,0,0,0,0,0,0,0,0
20200212,045272,元油2X統一94購01,,,,,0.00,0.00,0,0,0,0,0,0,0,0,0,0,0,0,0
20200212,045279,元石油富邦93購01,,,,,0.00,0.00,0,0,0,0,0,0,0,0,0,0,0,0,0
20200212,04527P,大立光凱基94售04,,,,,0.00,0.00,0,0,0,0,0,0,0,0,0,0,0,0,0
20200212,045280,儒鴻富邦94購01,0.29,0.33,0.29,0.33,+0.02,6.45,65000,7,19700,0,0,0,0,0,0,0,65000,-65000,-65000
20200212,045287,元油2X元大95購01,0.08,0.10,0.08,0.10,+0.01,11.11,60000,2,5800,0,0,0,0,0,0,10000,50000,-40000,-40000
20200212,045288,元油2X元大95購02,0.11,0.11,0.11,0.11,+0.01,10.0,50000,1,5500,0,0,0,0,0,0,0,50000,-50000,-50000
20200212,04528P,智原凱基94售01,1.04,1.04,1.04,1.04,-0.04,-3.7,11000,2,11440,0,0,0,0,0,0,11000,0,11000,11000
20200212,045290,華通元大93購01,4.38,4.59,4.36,4.59,+0.49,11.95,30000,4,133300,0,0,0,0,0,0,20000,10000,10000,10000
20200212,045292,鴻海元大93購03,1.48,1.48,1.48,1.48,+0.01,0.68,10000,1,14800,0,0,0,0,0,0,10000,0,10000,10000
20200212,045293,鴻海元大94購01,1.55,1.89,1.55,1.89,+0.39,26.0,265000,28,466900,0,0,0,0,0,0,233000,136000,97000,97000
20200212,045295,台積電元大93購02,3.43,3.45,3.43,3.45,0.00,0.00,15000,2,51730,0,0,0,0,0,0,15000,0,15000,15000
20200212,045296,台積電元大93購03,3.73,3.73,3.73,3.73,0.00,0.00,1000,1,3730,0,0,0,0,0,0,1000,0,1000,1000
20200212,045297,台積電元大93購04,,,,,0.00,0.00,0,0,0,0,0,0,0,0,0,0,0,0,0
20200212,045298,旺宏元大94購01,,,,,0.00,0.00,0,0,0,0,0,0,0,0,0,0,0,0,0
20200212,04529P,正文凱基94售04,,,,,0.00,0.00,0,0,0,0,0,0,0,0,0,0,0,0,0
20200212,045307,群創元大93購04,,,,,0.00,0.00,0,0,0,0,0,0,0,0,0,0,0,0,0
20200212,045308,泰鼎元大93購02,0.49,0.53,0.49,0.53,+0.10,23.26,256000,11,128900,0,0,0,0,0,0,106000,150000,-44000,-44000
20200212,04530P,上海銀凱基94售03,,,,,0.00,0.00,0,0,0,0,0,0,0,0,0,0,0,0,0
20200212,045311,GIS元大94購01,0.21,0.23,0.21,0.23,+0.03,15.0,20000,2,4400,0,0,0,0,0,0,20000,0,20000,20000
20200212,045312,矽創元大93購02,1.72,1.89,1.72,1.89,+0.52,37.96,20000,2,36100,0,0,0,0,0,0,0,20000,-20000,-20000
20200212,045317,GIS中信93購01,,,,,0.00,0.00,0,0,0,0,0,0,0,0,0,0,0,0,0
20200212,04531P,台郡凱基94售02,,,,,0.00,0.00,0,0,0,0,0,0,0,0,0,0,0,0,0
20200212,045325,元油2X永豐94購01,,,,,0.00,0.00,0,0,0,0,0,0,0,0,0,0,0,0,0
20200212,045329,富邦金亞東93購01,,,,,0.00,0.00,0,0,0,0,0,0,0,0,0,0,0,0,0
20200212,04532P,臺股指凱基94售04,0.22,0.22,0.21,0.21,-0.03,-12.5,105000,2,22100,0,0,0,0,0,0,0,105000,-105000,-105000
20200212,045330,百和亞東93購01,,,,,0.00,0.00,0,0,0,0,0,0,0,0,0,0,0,0,0
20200212,045331,旺宏群益94購01,,,,,0.00,0.00,0,0,0,0,0,0,0,0,0,0,0,0,0
20200212,045337,滬深2X凱基95購01,,,,,0.00,0.00,0,0,0,0,0,0,0,0,0,0,0,0,0
20200212,04533P,臺股指凱基94售05,,,,,0.00,0.00,0,0,0,0,0,0,0,0,0,0,0,0,0
20200212,045341,華邦電凱基93購04,,,,,0.00,0.00,0,0,0,0,0,0,0,0,0,0,0,0,0
20200212,045347,大立光凱基93購05,4.30,4.39,4.30,4.39,0.00,0.00,20000,2,86900,0,0,0,0,0,0,0,20000,-20000,-20000
20200212,045348,大立光凱基93購06,,,,,0.00,0.00,0,0,0,0,0,0,0,0,0,0,0,0,0
20200212,045349,大立光凱基93購07,,,,,0.00,0.00,0,0,0,0,0,0,0,0,0,0,0,0,0
20200212,04534P,臻鼎元富94售03,0.13,0.13,0.13,0.13,-0.15,-53.57,10000,1,1300,0,0,0,0,0,0,0,10000,-10000,-10000
20200212,045350,大立光凱基93購09,,,,,0.00,0.00,0,0,0,0,0,0,0,0,0,0,0,0,0
20200212,045351,大立光凱基93購10,,,,,0.00,0.00,0,0,0,0,0,0,0,0,0,0,0,0,0
20200212,04535P,華新統一94售01,1.99,1.99,1.99,1.99,0.00,0.00,8000,2,15920,0,0,0,0,0,0,0,8000,-8000,-8000
20200212,045361,鈺齊凱基93購01,3.70,4.26,3.70,4.26,+0.51,13.6,50000,6,198900,0,0,0,0,0,0,10000,40000,-30000,-30000
20200212,045362,A50正2兆豐93購02,0.35,0.35,0.34,0.34,-0.01,-2.86,68000,7,23620,0,0,0,0,0,0,0,68000,-68000,-68000
20200212,045365,智邦兆豐93購04,,,,,0.00,0.00,0,0,0,0,0,0,0,0,0,0,0,0,0
20200212,045369,康控兆豐93購01,0.57,0.62,0.57,0.62,+0.10,19.23,64000,15,37580,0,0,0,0,0,0,0,64000,-64000,-64000
20200212,04536P,長榮航統一94售01,,,,,0.00,0.00,0,0,0,0,0,0,0,0,0,0,0,0,0
20200212,045371,元石油元大95購01,0.13,0.13,0.13,0.13,0.00,0.00,290000,1,37700,0,0,0,0,0,0,290000,0,290000,290000
20200212,045376,友訊元大93購01,,,,,0.00,0.00,0,0,0,0,0,0,0,0,0,0,0,0,0
20200212,045377,華邦電元大93購01,0.69,0.69,0.69,0.69,0.00,0.00,147000,2,101430,0,0,0,0,0,0,0,147000,-147000,-147000
20200212,045379,智邦元大93購01,3.39,3.53,3.39,3.53,+0.25,7.62,6000,4,20860,0,0,0,0,0,0,2000,4000,-2000,-2000
20200212,04537P,新光金統一94售01,0.34,0.36,0.34,0.36,-0.01,-2.7,18000,4,6360,0,0,0,0,0,0,0,18000,-18000,-18000
20200212,045380,漢唐元大93購03,2.81,2.88,2.81,2.88,+0.05,1.77,30000,3,85000,0,0,0,0,0,0,30000,0,30000,30000
20200212,045385,華新科元大93購04,4.36,4.36,4.36,4.36,+0.22,5.31,7000,2,30520,0,0,0,0,0,0,7000,0,7000,7000
20200212,045386,新光金元大93購02,1.53,1.53,1.51,1.51,+0.01,0.67,2000,2,3040,0,0,0,0,0,0,2000,0,2000,2000
20200212,045388,群創元大93購05,,,,,0.00,0.00,0,0,0,0,0,0,0,0,0,0,0,0,0
20200212,045389,TPK元大93購03,,,,,0.00,0.00,0,0,0,0,0,0,0,0,0,0,0,0,0
20200212,04538P,TPK台新94售01,,,,,0.00,0.00,0,0,0,0,0,0,0,0,0,0,0,0,0
20200212,045391,台表科元大93購03,,,,,0.00,0.00,0,0,0,0,0,0,0,0,0,0,0,0,0
20200212,045392,滬深2X國泰93購01,,,,,0.00,0.00,0,0,0,0,0,0,0,0,0,0,0,0,0
20200212,045393,寶齡國泰93購01,0.24,0.24,0.22,0.22,0.00,0.00,37000,3,8180,0,0,0,0,0,0,37000,0,37000,37000
20200212,045394,國巨國泰93購01,,,,,0.00,0.00,0,0,0,0,0,0,0,0,0,0,0,0,0
20200212,045395,華新科國泰93購01,,,,,0.00,0.00,0,0,0,0,0,0,0,0,0,0,0,0,0
20200212,045396,群創國泰94購01,,,,,0.00,0.00,0,0,0,0,0,0,0,0,0,0,0,0,0
20200212,045397,元油2X富邦93購03,,,,,0.00,0.00,0,0,0,0,0,0,0,0,0,0,0,0,0
20200212,045399,康控富邦93購02,,,,,0.00,0.00,0,0,0,0,0,0,0,0,0,0,0,0,0
20200212,04539P,力山永豐94售02,,,,,0.00,0.00,0,0,0,0,0,0,0,0,0,0,0,0,0
20200212,045400,康友富邦93購01,1.33,1.35,1.32,1.32,+0.09,7.32,9000,4,11980,0,0,0,0,0,0,9000,0,9000,9000
20200212,045401,大立光兆豐93購01,1.00,1.04,1.00,1.04,+0.11,11.83,60000,7,60900,0,0,0,0,0,0,60000,0,60000,60000
20200212,045409,台積電群益93購02,,,,,0.00,0.00,0,0,0,0,0,0,0,0,0,0,0,0,0
20200212,04540P,聯詠永豐94售02,,,,,0.00,0.00,0,0,0,0,0,0,0,0,0,0,0,0,0
20200212,045410,華邦電群益94購01,0.09,0.09,0.08,0.08,+0.02,33.33,30000,2,2600,0,0,0,0,0,0,0,30000,-30000,-30000
20200212,045412,宏達電群益93購01,,,,,0.00,0.00,0,0,0,0,0,0,0,0,0,0,0,0,0
20200212,045414,康控群益94購02,0.49,0.57,0.49,0.53,+0.05,10.42,310000,19,168170,0,0,0,0,0,0,136000,169000,-33000,-33000
20200212,045417,華新凱基93購01,0.21,0.21,0.21,0.21,0.00,0.00,200000,1,42000,0,0,0,0,0,0,200000,0,200000,200000
20200212,045419,國巨凱基93購04,,,,,0.00,0.00,0,0,0,0,0,0,0,0,0,0,0,0,0
20200212,04541P,智易永豐94售03,,,,,0.00,0.00,0,0,0,0,0,0,0,0,0,0,0,0,0
20200212,045426,TPK凱基93購02,,,,,0.00,0.00,0,0,0,0,0,0,0,0,0,0,0,0,0
20200212,045428,彩晶凱基94購01,,,,,0.00,0.00,0,0,0,0,0,0,0,0,0,0,0,0,0
20200212,04542P,致伸永豐94售01,,,,,0.00,0.00,0,0,0,0,0,0,0,0,0,0,0,0,0
20200212,045430,百和凱基93購02,,,,,0.00,0.00,0,0,0,0,0,0,0,0,0,0,0,0,0
20200212,045435,鴻海統一94購01,2.72,2.87,2.72,2.87,+0.37,14.8,35000,5,97470,0,0,0,0,0,0,15000,25000,-10000,-10000
20200212,045436,友達統一93購02,3.92,3.92,3.77,3.77,-0.10,-2.58,6000,2,23070,0,0,0,0,0,0,3000,3000,0,0
20200212,045437,大立光統一94購02,,,,,0.00,0.00,0,0,0,0,0,0,0,0,0,0,0,0,0
20200212,045438,台郡統一94購01,2.88,2.98,2.83,2.98,+1.03,52.82,18000,6,52690,0,0,0,0,0,0,6000,12000,-6000,-6000
20200212,04543P,鴻海富邦95售03,0.26,0.26,0.23,0.23,0.00,0.00,40000,2,9800,0,0,0,0,0,0,0,40000,-40000,-40000
20200212,045443,群創元富98購01,,,,,0.00,0.00,0,0,0,0,0,0,0,0,0,0,0,0,0
20200212,045444,群創元富98購02,3.03,3.03,3.03,3.03,0.00,0.00,1000,1,3030,0,0,0,0,0,0,1000,0,1000,1000
20200212,045445,鴻海國泰93購01,,,,,0.00,0.00,0,0,0,0,0,0,0,0,0,0,0,0,0
20200212,045446,鴻海國泰94購01,,,,,0.00,0.00,0,0,0,0,0,0,0,0,0,0,0,0,0
20200212,045447,鴻海國泰94購02,1.43,1.43,1.43,1.43,0.00,0.00,20000,1,28600,0,0,0,0,0,0,20000,0,20000,20000
20200212,045448,宏達電國泰93購02,0.77,0.78,0.72,0.73,+0.04,5.8,105000,21,78270,0,0,0,0,0,0,75000,30000,45000,45000
20200212,045449,嘉聯益國泰94購01,1.53,1.59,1.53,1.53,+0.16,11.68,142000,6,224260,0,0,0,0,0,0,3000,142000,-139000,-139000
20200212,04544P,欣興富邦96售02,1.54,1.54,1.34,1.34,-0.22,-14.1,257000,6,365800,0,0,0,0,0,0,211000,46000,165000,165000
20200212,045450,元油2X富邦93購04,,,,,0.00,0.00,0,0,0,0,0,0,0,0,0,0,0,0,0
20200212,045451,聯發科富邦93購01,2.39,2.49,2.39,2.49,+0.32,14.75,2000,2,4880,0,0,0,0,0,0,2000,0,2000,2000
20200212,045454,上銀元大93購01,2.05,2.05,2.05,2.05,+0.10,5.13,20000,2,41000,0,0,0,0,0,0,20000,0,20000,20000
20200212,045456,鴻海元大93購04,1.13,1.63,1.13,1.63,+0.54,49.54,179000,11,239360,0,0,0,0,0,0,90000,99000,-9000,-9000
20200212,045457,光磊元大93購01,,,,,0.00,0.00,0,0,0,0,0,0,0,0,0,0,0,0,0
20200212,04545P,國巨元大94售05,0.01,0.02,0.01,0.02,0.00,0.00,120000,2,1400,0,0,0,0,0,0,0,0,0,0
20200212,045462,美律元大93購04,0.31,0.39,0.31,0.39,0.00,0.00,125000,3,41000,0,0,0,0,0,0,0,125000,-125000,-125000
20200212,045467,智易元大93購03,0.01,0.01,0.01,0.01,0.00,0.00,30000,1,300,0,0,0,0,0,0,30000,0,30000,30000
20200212,045468,健策元大94購01,,,,,0.00,0.00,0,0,0,0,0,0,0,0,0,0,0,0,0
20200212,04546P,台積電元大94售09,0.16,0.16,0.16,0.16,0.00,0.00,22000,1,3520,0,0,0,0,0,0,0,22000,-22000,-22000
20200212,045470,康控元大94購03,0.49,0.55,0.49,0.53,+0.08,17.78,54000,9,27900,0,0,0,0,0,0,40000,14000,26000,26000
20200212,045471,鎧勝元大93購01,0.04,0.04,0.04,0.04,0.00,0.00,5000,1,200,0,0,0,0,0,0,5000,0,5000,5000
20200212,045472,嘉聯益元大93購02,,,,,0.00,0.00,0,0,0,0,0,0,0,0,0,0,0,0,0
20200212,045478,世紀鋼元大93購02,,,,,0.00,0.00,0,0,0,0,0,0,0,0,0,0,0,0,0
20200212,045479,T50反1中信95購01,0.05,0.05,0.05,0.05,-0.01,-16.67,52000,4,2600,0,0,0,0,0,0,0,20000,-20000,-20000
20200212,04547P,高鐵元大94售01,1.43,1.43,1.39,1.39,-0.05,-3.47,17000,2,24270,0,0,0,0,0,0,0,17000,-17000,-17000
20200212,045480,滬深2X中信94購01,,,,,0.00,0.00,0,0,0,0,0,0,0,0,0,0,0,0,0
20200212,045481,友達中信93購01,,,,,0.00,0.00,0,0,0,0,0,0,0,0,0,0,0,0,0
20200212,045482,滬深2X兆豐93購02,,,,,0.00,0.00,0,0,0,0,0,0,0,0,0,0,0,0,0
20200212,045484,聯電亞東94購01,1.79,1.90,1.79,1.90,+0.02,1.06,347000,18,629290,0,0,0,0,0,0,327000,0,327000,327000
20200212,045485,中磊亞東93購01,,,,,0.00,0.00,0,0,0,0,0,0,0,0,0,0,0,0,0
20200212,04548P,大立光元大94售14,1.45,1.45,1.36,1.36,-0.14,-9.33,110000,2,158600,0,0,0,0,0,0,100000,10000,90000,90000
20200212,045490,統一凱基93購01,,,,,0.00,0.00,0,0,0,0,0,0,0,0,0,0,0,0,0
20200212,04549P,茂林元大94售02,,,,,0.00,0.00,0,0,0,0,0,0,0,0,0,0,0,0,0
20200212,045500,聯發科凱基93購04,2.37,2.74,2.37,2.74,+0.71,34.98,104000,13,265800,0,0,0,0,0,0,89000,15000,74000,74000
20200212,045503,群創凱基93購09,,,,,0.00,0.00,0,0,0,0,0,0,0,0,0,0,0,0,0
20200212,045504,群創凱基94購01,,,,,0.00,0.00,0,0,0,0,0,0,0,0,0,0,0,0,0
20200212,04550P,超眾元大94售01,1.33,1.33,1.33,1.33,-0.01,-0.75,50000,2,66500,0,0,0,0,0,0,50000,0,50000,50000
20200212,045514,南茂凱基93購01,0.29,0.30,0.29,0.30,0.00,0.00,45000,2,13300,0,0,0,0,0,0,45000,0,45000,45000
20200212,045516,聯茂統一94購01,0.31,0.53,0.31,0.53,+0.33,165.0,525000,13,222570,0,0,0,0,0,0,0,525000,-525000,-525000
20200212,045517,元油2X元富98購01,0.49,0.52,0.49,0.52,+0.02,4.0,121000,4,60690,0,0,0,0,0,0,20000,101000,-81000,-81000
20200212,04551P,台表科元大94售02,,,,,0.00,0.00,0,0,0,0,0,0,0,0,0,0,0,0,0
20200212,045522,滬深2X永豐94購01,0.32,0.32,0.29,0.31,0.00,0.00,209000,5,64890,0,0,0,0,0,0,84000,125000,-41000,-41000
20200212,04552P,南電元大94售06,,,,,0.00,0.00,0,0,0,0,0,0,0,0,0,0,0,0,0
20200212,045534,深中小群益94購01,,,,,0.00,0.00,0,0,0,0,0,0,0,0,0,0,0,0,0
20200212,045535,A50正2群益94購01,0.43,0.43,0.43,0.43,0.00,0.00,600000,3,258000,0,0,0,0,0,0,0,600000,-600000,-600000
20200212,045537,華新群益94購01,0.62,0.63,0.62,0.63,+0.05,8.62,9000,5,5650,0,0,0,0,0,0,6000,8000,-2000,-2000
20200212,04553P,S&P正2中信95售01,,,,,0.00,0.00,0,0,0,0,0,0,0,0,0,0,0,0,0
20200212,045541,大立光群益93購02,,,,,0.00,0.00,0,0,0,0,0,0,0,0,0,0,0,0,0
20200212,045542,鎧勝群益93購01,,,,,0.00,0.00,0,0,0,0,0,0,0,0,0,0,0,0,0
20200212,045543,百和群益94購01,,,,,0.00,0.00,0,0,0,0,0,0,0,0,0,0,0,0,0
20200212,045546,T50反1國票93購02,0.01,0.01,0.01,0.01,0.00,0.00,610000,4,6100,0,0,0,0,0,0,0,0,0,0
20200212,045547,滬深2X國票95購01,0.25,0.26,0.25,0.26,-0.01,-3.7,50000,2,12700,0,0,0,0,0,0,30000,20000,10000,10000
20200212,045549,國巨國票93購01,,,,,0.00,0.00,0,0,0,0,0,0,0,0,0,0,0,0,0
20200212,04554P,可成中信94售01,,,,,0.00,0.00,0,0,0,0,0,0,0,0,0,0,0,0,0
20200212,045552,台積電國票93購02,,,,,0.00,0.00,0,0,0,0,0,0,0,0,0,0,0,0,0
20200212,045555,友達國票93購01,,,,,0.00,0.00,0,0,0,0,0,0,0,0,0,0,0,0,0
20200212,045556,可成國票93購01,,,,,0.00,0.00,0,0,0,0,0,0,0,0,0,0,0,0,0
20200212,04555P,元油2X群益95售01,1.56,1.56,1.56,1.56,-0.06,-3.7,30000,1,46800,0,0,0,0,0,0,30000,0,30000,30000
20200212,045562,群創國票93購03,,,,,0.00,0.00,0,0,0,0,0,0,0,0,0,0,0,0,0
20200212,045564,GIS國票93購01,,,,,0.00,0.00,0,0,0,0,0,0,0,0,0,0,0,0,0
20200212,045565,元油2X國泰93購01,,,,,0.00,0.00,0,0,0,0,0,0,0,0,0,0,0,0,0
20200212,045566,南寶國泰93購01,,,,,0.00,0.00,0,0,0,0,0,0,0,0,0,0,0,0,0
20200212,045567,滬深2X富邦93購01,0.21,0.21,0.20,0.21,-0.02,-8.7,100000,5,20750,0,0,0,0,0,0,0,100000,-100000,-100000
20200212,045568,上証2X元大95購01,0.64,0.64,0.61,0.61,-0.05,-7.58,70000,2,44200,0,0,0,0,0,0,20000,50000,-30000,-30000
20200212,04556P,大成鋼群益94售02,,,,,0.00,0.00,0,0,0,0,0,0,0,0,0,0,0,0,0
20200212,045571,元油2X元大95購04,0.12,0.12,0.12,0.12,0.00,0.00,100000,1,12000,0,0,0,0,0,0,0,100000,-100000,-100000
20200212,045572,元油2X元大98購01,0.45,0.47,0.44,0.47,+0.04,9.3,680000,16,313000,0,0,0,0,0,0,220000,460000,-240000,-240000
20200212,045579,全新元大93購03,0.42,0.56,0.42,0.56,+0.21,60.0,31000,4,15250,0,0,0,0,0,0,10000,21000,-11000,-11000
20200212,04557P,茂林群益94售03,0.24,0.24,0.24,0.24,-0.05,-17.24,30000,1,7200,0,0,0,0,0,0,0,30000,-30000,-30000
20200212,045582,大立光元大93購08,,,,,0.00,0.00,0,0,0,0,0,0,0,0,0,0,0,0,0
20200212,045584,奇鋐元大93購03,,,,,0.00,0.00,0,0,0,0,0,0,0,0,0,0,0,0,0
20200212,045585,欣興元大93購03,0.60,0.77,0.58,0.77,+0.17,28.33,249000,14,162380,0,0,0,0,0,0,213000,36000,177000,177000
20200212,045586,創意元大93購03,,,,,0.00,0.00,0,0,0,0,0,0,0,0,0,0,0,0,0
20200212,045587,智易元大93購04,,,,,0.00,0.00,0,0,0,0,0,0,0,0,0,0,0,0,0
20200212,045588,健策元大93購01,,,,,0.00,0.00,0,0,0,0,0,0,0,0,0,0,0,0,0
20200212,04558P,瑞昱日盛94售01,0.21,0.21,0.21,0.21,0.00,0.00,177000,1,37170,0,0,0,0,0,0,177000,0,177000,177000
20200212,045591,彩晶元大93購01,,,,,0.00,0.00,0,0,0,0,0,0,0,0,0,0,0,0,0
20200212,045594,緯穎元大93購04,,,,,0.00,0.00,0,0,0,0,0,0,0,0,0,0,0,0,0
20200212,045595,明泰兆豐92購01,,,,,0.00,0.00,0,0,0,0,0,0,0,0,0,0,0,0,0
20200212,045596,和碩兆豐92購01,,,,,0.00,0.00,0,0,0,0,0,0,0,0,0,0,0,0,0
20200212,045597,聯發科第一92購01,,,,,0.00,0.00,0,0,0,0,0,0,0,0,0,0,0,0,0
20200212,045598,上証2X中信94購02,,,,,0.00,0.00,0,0,0,0,0,0,0,0,0,0,0,0,0
20200212,045599,神基中信92購01,,,,,0.00,0.00,0,0,0,0,0,0,0,0,0,0,0,0,0
20200212,04559P,華通凱基94售03,,,,,0.00,0.00,0,0,0,0,0,0,0,0,0,0,0,0,0
20200212,045600,道瓊指國票95購01,,,,,0.00,0.00,0,0,0,0,0,0,0,0,0,0,0,0,0
20200212,045601,正文國票92購01,,,,,0.00,0.00,0,0,0,0,0,0,0,0,0,0,0,0,0
20200212,045602,致伸國票92購01,,,,,0.00,0.00,0,0,0,0,0,0,0,0,0,0,0,0,0
20200212,045603,傳奇國票92購01,,,,,0.00,0.00,0,0,0,0,0,0,0,0,0,0,0,0,0
20200212,045604,元油2X群益92購02,,,,,0.00,0.00,0,0,0,0,0,0,0,0,0,0,0,0,0
20200212,045605,儒鴻群益92購01,,,,,0.00,0.00,0,0,0,0,0,0,0,0,0,0,0,0,0
20200212,045606,喬山群益92購01,,,,,0.00,0.00,0,0,0,0,0,0,0,0,0,0,0,0,0
20200212,045607,裕隆群益92購02,,,,,0.00,0.00,0,0,0,0,0,0,0,0,0,0,0,0,0
20200212,045608,鴻海群益93購02,4.29,4.55,4.29,4.55,0.00,0.00,30000,2,133900,0,0,0,0,0,0,0,30000,-30000,-30000
20200212,045609,國巨群益93購02,,,,,0.00,0.00,0,0,0,0,0,0,0,0,0,0,0,0,0
20200212,04560P,台積電凱基94售16,,,,,0.00,0.00,0,0,0,0,0,0,0,0,0,0,0,0,0
20200212,045610,大立光群益93購04,,,,,0.00,0.00,0,0,0,0,0,0,0,0,0,0,0,0,0
20200212,045611,明泰群益92購01,,,,,0.00,0.00,0,0,0,0,0,0,0,0,0,0,0,0,0
20200212,045612,麗豐群益92購01,,,,,0.00,0.00,0,0,0,0,0,0,0,0,0,0,0,0,0
20200212,045613,祥碩群益92購01,8.15,8.15,8.15,8.15,0.00,0.00,5000,1,40750,0,0,0,0,0,0,5000,0,5000,5000
20200212,045614,瀚宇博群益92購01,,,,,0.00,0.00,0,0,0,0,0,0,0,0,0,0,0,0,0
20200212,045615,樺漢群益92購01,,,,,0.00,0.00,0,0,0,0,0,0,0,0,0,0,0,0,0
20200212,045616,冠德台新92購01,,,,,0.00,0.00,0,0,0,0,0,0,0,0,0,0,0,0,0
20200212,045617,日電貿台新92購01,,,,,0.00,0.00,0,0,0,0,0,0,0,0,0,0,0,0,0
20200212,045618,元油2X永豐98購01,0.41,0.43,0.41,0.43,+0.04,10.26,340000,17,143090,0,0,0,0,0,0,244000,66000,178000,178000
20200212,045619,強茂永豐92購01,,,,,0.00,0.00,0,0,0,0,0,0,0,0,0,0,0,0,0
20200212,04561P,台積電凱基94售17,,,,,0.00,0.00,0,0,0,0,0,0,0,0,0,0,0,0,0
20200212,045620,傳奇永豐92購01,,,,,0.00,0.00,0,0,0,0,0,0,0,0,0,0,0,0,0
20200212,045621,超眾永豐92購02,,,,,0.00,0.00,0,0,0,0,0,0,0,0,0,0,0,0,0
20200212,045622,康舒永豐92購01,,,,,0.00,0.00,0,0,0,0,0,0,0,0,0,0,0,0,0
20200212,045623,羅麗芬永豐92購01,,,,,0.00,0.00,0,0,0,0,0,0,0,0,0,0,0,0,0
20200212,045624,緯穎永豐92購01,,,,,0.00,0.00,0,0,0,0,0,0,0,0,0,0,0,0,0
20200212,045625,鴻海麥證92購01,1.34,1.34,1.34,1.34,0.00,0.00,2000,1,2680,0,2000,-2000,0,0,0,0,2000,-2000,-2000
20200212,045626,上銀凱基93購05,,,,,0.00,0.00,0,0,0,0,0,0,0,0,0,0,0,0,0
20200212,045627,聯電凱基93購03,2.37,2.56,2.37,2.52,+0.09,3.7,407000,20,982460,0,0,0,0,0,0,346000,33000,313000,313000
20200212,045628,台積電凱基92購11,,,,,0.00,0.00,0,0,0,0,0,0,0,0,0,0,0,0,0
20200212,045629,智邦凱基92購01,,,,,0.00,0.00,0,0,0,0,0,0,0,0,0,0,0,0,0
20200212,04562P,南亞科凱基94售02,,,,,0.00,0.00,0,0,0,0,0,0,0,0,0,0,0,0,0
20200212,045630,技嘉凱基93購02,2.89,3.02,0.98,2.80,-0.05,-1.75,191000,24,538250,0,0,0,0,0,0,117000,68000,49000,49000
20200212,045631,台光電凱基93購06,,,,,0.00,0.00,0,0,0,0,0,0,0,0,0,0,0,0,0
20200212,045632,正崴凱基93購01,1.11,1.11,1.07,1.07,-0.06,-5.31,37000,12,40760,0,0,0,0,0,0,37000,0,37000,37000
20200212,045633,南亞科凱基92購02,,,,,0.00,0.00,0,0,0,0,0,0,0,0,0,0,0,0,0
20200212,045634,友達凱基93購02,,,,,0.00,0.00,0,0,0,0,0,0,0,0,0,0,0,0,0
20200212,045635,建準凱基93購02,,,,,0.00,0.00,0,0,0,0,0,0,0,0,0,0,0,0,0
20200212,045636,京元電凱基92購03,,,,,0.00,0.00,0,0,0,0,0,0,0,0,0,0,0,0,0
20200212,045637,可成凱基92購08,,,,,0.00,0.00,0,0,0,0,0,0,0,0,0,0,0,0,0
20200212,045638,強茂凱基93購02,,,,,0.00,0.00,0,0,0,0,0,0,0,0,0,0,0,0,0
20200212,045639,冠德凱基93購01,,,,,0.00,0.00,0,0,0,0,0,0,0,0,0,0,0,0,0
20200212,04563P,可成凱基94售05,,,,,0.00,0.00,0,0,0,0,0,0,0,0,0,0,0,0,0
20200212,045640,嘉晶凱基93購01,1.67,1.81,1.67,1.81,+0.12,7.1,23000,3,39750,0,0,0,0,0,0,17000,6000,11000,11000
20200212,045641,聯詠凱基92購05,,,,,0.00,0.00,0,0,0,0,0,0,0,0,0,0,0,0,0
20200212,045642,致伸凱基92購02,,,,,0.00,0.00,0,0,0,0,0,0,0,0,0,0,0,0,0
20200212,045643,臻鼎凱基93購01,1.60,1.98,1.60,1.98,+0.88,80.0,121000,7,213040,0,0,0,0,0,0,116000,2000,114000,114000
20200212,045644,祥碩凱基92購01,,,,,0.00,0.00,0,0,0,0,0,0,0,0,0,0,0,0,0
20200212,045645,祥碩凱基93購03,,,,,0.00,0.00,0,0,0,0,0,0,0,0,0,0,0,0,0
20200212,045646,瑞儀凱基93購05,,,,,0.00,0.00,0,0,0,0,0,0,0,0,0,0,0,0,0
20200212,045647,聯茂凱基92購05,,,,,0.00,0.00,0,0,0,0,0,0,0,0,0,0,0,0,0
20200212,045648,聯茂凱基93購04,,,,,0.00,0.00,0,0,0,0,0,0,0,0,0,0,0,0,0
20200212,045649,超眾凱基93購04,,,,,0.00,0.00,0,0,0,0,0,0,0,0,0,0,0,0,0
20200212,04564P,大立光凱基94售06,,,,,0.00,0.00,0,0,0,0,0,0,0,0,0,0,0,0,0
20200212,045650,超眾凱基93購05,,,,,0.00,0.00,0,0,0,0,0,0,0,0,0,0,0,0,0
20200212,045651,力成凱基93購01,9.85,10.00,9.85,10.00,0.00,0.00,16000,3,158500,0,0,0,0,0,0,0,16000,-16000,-16000
20200212,045652,緯穎凱基92購01,,,,,0.00,0.00,0,0,0,0,0,0,0,0,0,0,0,0,0
20200212,045653,南茂凱基93購02,,,,,0.00,0.00,0,0,0,0,0,0,0,0,0,0,0,0,0
20200212,045654,志超凱基93購01,,,,,0.00,0.00,0,0,0,0,0,0,0,0,0,0,0,0,0
20200212,045655,美利達凱基92購01,,,,,0.00,0.00,0,0,0,0,0,0,0,0,0,0,0,0,0
20200212,045656,滬深2X永昌93購03,,,,,0.00,0.00,0,0,0,0,0,0,0,0,0,0,0,0,0
20200212,045657,T50反1國泰94購01,,,,,0.00,0.00,0,0,0,0,0,0,0,0,0,0,0,0,0
20200212,045658,儒鴻國泰93購01,0.30,0.32,0.30,0.30,-0.06,-16.67,13000,9,3990,0,0,0,0,0,0,10000,3000,7000,7000
20200212,045659,華新科國泰94購01,,,,,0.00,0.00,0,0,0,0,0,0,0,0,0,0,0,0,0
20200212,04565P,聯詠凱基94售01,0.40,0.40,0.40,0.40,0.00,0.00,10000,1,4000,0,0,0,0,0,0,0,10000,-10000,-10000
20200212,045660,欣興富邦93購03,,,,,0.00,0.00,0,0,0,0,0,0,0,0,0,0,0,0,0
20200212,045661,T50反1統一93購02,,,,,0.00,0.00,0,0,0,0,0,0,0,0,0,0,0,0,0
20200212,045662,華邦電統一94購02,0.45,0.50,0.45,0.46,+0.06,15.0,141000,20,66780,0,0,0,0,0,0,5000,136000,-131000,-131000
20200212,045663,元油2X元富94購01,0.29,0.32,0.29,0.32,+0.03,10.34,1207000,13,362480,0,0,0,0,0,0,504000,703000,-199000,-199000
20200212,045664,元油2X元富96購01,0.34,0.34,0.34,0.34,+0.02,6.25,80000,1,27200,0,0,0,0,0,0,80000,0,80000,80000
20200212,045665,聯電元富92購01,,,,,0.00,0.00,0,0,0,0,0,0,0,0,0,0,0,0,0
20200212,045666,鴻海元富92購04,,,,,0.00,0.00,0,0,0,0,0,0,0,0,0,0,0,0,0
20200212,045667,台積電元富93購01,,,,,0.00,0.00,0,0,0,0,0,0,0,0,0,0,0,0,0
20200212,045668,奇力新元富92購01,,,,,0.00,0.00,0,0,0,0,0,0,0,0,0,0,0,0,0
20200212,045669,華通元大93購02,4.80,5.90,4.78,5.90,+1.20,25.53,142000,26,759450,0,0,0,0,0,0,57000,108000,-51000,-51000
20200212,04566P,GIS凱基94售04,,,,,0.00,0.00,0,0,0,0,0,0,0,0,0,0,0,0,0
20200212,045670,鴻海元大92購09,0.31,0.31,0.31,0.31,0.00,0.00,60000,1,18600,0,0,0,0,0,0,60000,60000,0,0
20200212,045671,鴻海元大92購10,,,,,0.00,0.00,0,0,0,0,0,0,0,0,0,0,0,0,0
20200212,045672,台積電元大92購15,,,,,0.00,0.00,0,0,0,0,0,0,0,0,0,0,0,0,0
20200212,045673,燿華元大92購03,,,,,0.00,0.00,0,0,0,0,0,0,0,0,0,0,0,0,0
20200212,045674,友達元大92購03,,,,,0.00,0.00,0,0,0,0,0,0,0,0,0,0,0,0,0
20200212,045675,友達元大93購01,,,,,0.00,0.00,0,0,0,0,0,0,0,0,0,0,0,0,0
20200212,045676,京元電元大92購03,,,,,0.00,0.00,0,0,0,0,0,0,0,0,0,0,0,0,0
20200212,045677,聯發科元大92購10,,,,,0.00,0.00,0,0,0,0,0,0,0,0,0,0,0,0,0
20200212,045678,華新科元大95購01,,,,,0.00,0.00,0,0,0,0,0,0,0,0,0,0,0,0,0
20200212,045679,欣興元大94購01,0.48,0.48,0.48,0.48,+0.12,33.33,30000,1,14400,0,0,0,0,0,0,30000,0,30000,30000
20200212,04567P,臺股指凱基95售01,,,,,0.00,0.00,0,0,0,0,0,0,0,0,0,0,0,0,0
20200212,045680,創意元大92購06,,,,,0.00,0.00,0,0,0,0,0,0,0,0,0,0,0,0,0
20200212,045681,正文元大92購02,,,,,0.00,0.00,0,0,0,0,0,0,0,0,0,0,0,0,0
20200212,045682,致伸元大92購01,,,,,0.00,0.00,0,0,0,0,0,0,0,0,0,0,0,0,0
20200212,045683,泰鼎元大93購03,,,,,0.00,0.00,0,0,0,0,0,0,0,0,0,0,0,0,0
20200212,045684,和碩元大92購02,,,,,0.00,0.00,0,0,0,0,0,0,0,0,0,0,0,0,0
20200212,045685,康控元大95購01,0.62,0.67,0.62,0.66,+0.07,11.86,215000,15,142980,0,0,0,0,0,0,42000,126000,-84000,-84000
20200212,045686,臻鼎元大92購02,,,,,0.00,0.00,0,0,0,0,0,0,0,0,0,0,0,0,0
20200212,045687,達興元大92購02,,,,,0.00,0.00,0,0,0,0,0,0,0,0,0,0,0,0,0
20200212,045688,祥碩元大92購01,,,,,0.00,0.00,0,0,0,0,0,0,0,0,0,0,0,0,0
20200212,045689,聯茂元大92購06,,,,,0.00,0.00,0,0,0,0,0,0,0,0,0,0,0,0,0
20200212,04568P,瑞昱兆豐94售02,0.36,0.36,0.36,0.36,-0.05,-12.2,100000,2,36000,0,0,0,0,0,0,0,100000,-100000,-100000
20200212,045690,啟碁元大92購01,,,,,0.00,0.00,0,0,0,0,0,0,0,0,0,0,0,0,0
20200212,045691,南茂元大92購03,,,,,0.00,0.00,0,0,0,0,0,0,0,0,0,0,0,0,0
20200212,045692,南茂元大92購04,,,,,0.00,0.00,0,0,0,0,0,0,0,0,0,0,0,0,0
20200212,045693,台達電兆豐92購02,,,,,0.00,0.00,0,0,0,0,0,0,0,0,0,0,0,0,0
20200212,045694,智邦兆豐93購05,0.83,0.94,0.67,0.74,+0.04,5.71,238000,18,195120,0,0,0,0,0,0,220000,193000,27000,27000
20200212,045695,英業達兆豐93購01,,,,,0.00,0.00,0,0,0,0,0,0,0,0,0,0,0,0,0
20200212,045696,瑞昱兆豐92購04,,,,,0.00,0.00,0,0,0,0,0,0,0,0,0,0,0,0,0
20200212,045697,聯詠兆豐92購01,,,,,0.00,0.00,0,0,0,0,0,0,0,0,0,0,0,0,0
20200212,045698,致伸兆豐93購01,,,,,0.00,0.00,0,0,0,0,0,0,0,0,0,0,0,0,0
20200212,045699,GIS兆豐92購02,,,,,0.00,0.00,0,0,0,0,0,0,0,0,0,0,0,0,0
20200212,04569P,聯詠兆豐94售01,,,,,0.00,0.00,0,0,0,0,0,0,0,0,0,0,0,0,0
20200212,045700,道瓊指中信94購01,,,,,0.00,0.00,0,0,0,0,0,0,0,0,0,0,0,0,0
20200212,045701,聯發科中信92購02,,,,,0.00,0.00,0,0,0,0,0,0,0,0,0,0,0,0,0
20200212,045702,冠德中信92購01,,,,,0.00,0.00,0,0,0,0,0,0,0,0,0,0,0,0,0
20200212,045703,技嘉日盛92購01,1.96,1.96,1.71,1.71,-0.13,-7.07,100000,12,184690,0,0,0,0,0,0,67000,33000,34000,34000
20200212,045704,微星日盛92購01,,,,,0.00,0.00,0,0,0,0,0,0,0,0,0,0,0,0,0
20200212,045705,冠德日盛92購01,,,,,0.00,0.00,0,0,0,0,0,0,0,0,0,0,0,0,0
20200212,045706,健鼎日盛92購01,,,,,0.00,0.00,0,0,0,0,0,0,0,0,0,0,0,0,0
20200212,045707,明泰日盛92購01,,,,,0.00,0.00,0,0,0,0,0,0,0,0,0,0,0,0,0
20200212,045708,元油2X凱基93購02,,,,,0.00,0.00,0,0,0,0,0,0,0,0,0,0,0,0,0
20200212,045709,味全凱基92購02,,,,,0.00,0.00,0,0,0,0,0,0,0,0,0,0,0,0,0
20200212,04570P,台積電國票94售05,,,,,0.00,0.00,0,0,0,0,0,0,0,0,0,0,0,0,0
20200212,045710,儒鴻凱基92購02,,,,,0.00,0.00,0,0,0,0,0,0,0,0,0,0,0,0,0
20200212,045711,亞德客凱基92購02,,,,,0.00,0.00,0,0,0,0,0,0,0,0,0,0,0,0,0
20200212,045712,寶齡凱基92購01,,,,,0.00,0.00,0,0,0,0,0,0,0,0,0,0,0,0,0
20200212,045713,台達電凱基93購02,0.10,0.10,0.10,0.10,0.00,0.00,3000,1,300,0,0,0,0,0,0,0,3000,-3000,-3000
20200212,045714,台積電凱基92購13,,,,,0.00,0.00,0,0,0,0,0,0,0,0,0,0,0,0,0
20200212,045715,華邦電凱基92購04,,,,,0.00,0.00,0,0,0,0,0,0,0,0,0,0,0,0,0
20200212,045716,智邦凱基92購02,1.24,1.24,1.20,1.20,+0.02,1.69,2000,2,2440,0,0,0,0,0,0,2000,0,2000,2000
20200212,045717,微星凱基92購03,2.06,2.06,2.06,2.06,+0.34,19.77,10000,2,20600,0,0,0,0,0,0,10000,0,10000,10000
20200212,045718,瑞昱凱基92購01,0.80,0.92,0.80,0.92,+0.14,17.95,20000,3,17200,0,0,0,0,0,0,10000,10000,0,0
20200212,045719,台光電凱基92購04,,,,,0.00,0.00,0,0,0,0,0,0,0,0,0,0,0,0,0
20200212,04571P,華新科國泰95售03,,,,,0.00,0.00,0,0,0,0,0,0,0,0,0,0,0,0,0
20200212,045720,台光電凱基93購07,,,,,0.00,0.00,0,0,0,0,0,0,0,0,0,0,0,0,0
20200212,045721,中信金凱基92購01,1.54,1.54,1.54,1.54,0.00,0.00,1000,1,1540,0,0,0,0,0,0,0,0,0,0
20200212,045722,揚明光凱基92購03,,,,,0.00,0.00,0,0,0,0,0,0,0,0,0,0,0,0,0
20200212,045723,利勤凱基92購01,,,,,0.00,0.00,0,0,0,0,0,0,0,0,0,0,0,0,0
20200212,045724,豐祥凱基92購01,,,,,0.00,0.00,0,0,0,0,0,0,0,0,0,0,0,0,0
20200212,045725,羅麗芬凱基92購01,,,,,0.00,0.00,0,0,0,0,0,0,0,0,0,0,0,0,0
20200212,045726,矽創凱基92購01,,,,,0.00,0.00,0,0,0,0,0,0,0,0,0,0,0,0,0
20200212,045727,宏碁亞東93購01,,,,,0.00,0.00,0,0,0,0,0,0,0,0,0,0,0,0,0
20200212,045728,大立光亞東93購01,,,,,0.00,0.00,0,0,0,0,0,0,0,0,0,0,0,0,0
20200212,045729,日月光亞東93購01,,,,,0.00,0.00,0,0,0,0,0,0,0,0,0,0,0,0,0
20200212,04572P,T50反1統一94售06,,,,,0.00,0.00,0,0,0,0,0,0,0,0,0,0,0,0,0
20200212,045730,鴻海第一92購01,,,,,0.00,0.00,0,0,0,0,0,0,0,0,0,0,0,0,0
20200212,045731,智易第一92購01,,,,,0.00,0.00,0,0,0,0,0,0,0,0,0,0,0,0,0
20200212,045732,儒鴻國票93購01,0.58,0.71,0.58,0.71,0.00,0.00,290000,7,176750,0,0,0,0,0,0,285000,5000,280000,280000
20200212,045733,瑞昱國票93購01,3.17,3.17,3.17,3.17,0.00,0.00,100000,1,317000,0,0,0,0,0,0,0,100000,-100000,-100000
20200212,045734,全新國票93購01,1.10,1.54,1.10,1.54,+0.62,67.39,95000,17,125050,0,0,0,0,0,0,21000,74000,-53000,-53000
20200212,045735,新光金國票92購01,,,,,0.00,0.00,0,0,0,0,0,0,0,0,0,0,0,0,0
20200212,045736,台積電群益94購01,,,,,0.00,0.00,0,0,0,0,0,0,0,0,0,0,0,0,0
20200212,045737,友達群益94購01,,,,,0.00,0.00,0,0,0,0,0,0,0,0,0,0,0,0,0
20200212,045738,強茂群益92購01,,,,,0.00,0.00,0,0,0,0,0,0,0,0,0,0,0,0,0
20200212,045739,宏達電群益92購02,,,,,0.00,0.00,0,0,0,0,0,0,0,0,0,0,0,0,0
20200212,04573P,聯電統一94售02,,,,,0.00,0.00,0,0,0,0,0,0,0,0,0,0,0,0,0
20200212,045740,大立光群益92購05,,,,,0.00,0.00,0,0,0,0,0,0,0,0,0,0,0,0,0
20200212,045741,嘉晶群益92購01,0.01,0.02,0.01,0.02,0.00,0.00,259000,2,3590,0,0,0,0,0,0,259000,0,259000,259000
20200212,045742,合勤控群益92購01,,,,,0.00,0.00,0,0,0,0,0,0,0,0,0,0,0,0,0
20200212,045743,台郡群益93購01,3.61,3.61,3.57,3.57,+1.70,90.91,17000,2,61130,0,0,0,0,0,0,11000,6000,5000,5000
20200212,045744,為升台新92購01,,,,,0.00,0.00,0,0,0,0,0,0,0,0,0,0,0,0,0
20200212,045745,TPK台新92購01,,,,,0.00,0.00,0,0,0,0,0,0,0,0,0,0,0,0,0
20200212,045746,燿華永豐92購01,,,,,0.00,0.00,0,0,0,0,0,0,0,0,0,0,0,0,0
20200212,045747,嘉聯益永豐92購02,,,,,0.00,0.00,0,0,0,0,0,0,0,0,0,0,0,0,0
20200212,045748,臺股指永豐92購01,5.05,5.05,5.05,5.05,0.00,0.00,3000,1,15150,0,0,0,0,0,0,3000,0,3000,3000
20200212,045749,智邦富邦93購01,0.30,0.34,0.23,0.25,-0.02,-7.41,260000,21,81830,0,0,0,0,0,0,210000,50000,160000,160000
20200212,04574P,台達電統一94售05,0.61,0.61,0.57,0.57,-0.11,-16.18,13000,5,7490,0,0,0,0,0,0,13000,0,13000,13000
20200212,045750,鈺齊富邦94購01,,,,,0.00,0.00,0,0,0,0,0,0,0,0,0,0,0,0,0
20200212,045751,智邦國泰93購01,,,,,0.00,0.00,0,0,0,0,0,0,0,0,0,0,0,0,0
20200212,045752,全新國泰93購01,1.05,1.39,1.05,1.39,+0.47,51.09,167000,32,200000,0,0,0,0,0,0,62000,105000,-43000,-43000
20200212,045753,大立光國泰94購02,1.74,1.81,1.74,1.81,0.00,0.00,20000,4,35600,0,0,0,0,0,0,20000,0,20000,20000
20200212,045754,大立光國泰94購03,,,,,0.00,0.00,0,0,0,0,0,0,0,0,0,0,0,0,0
20200212,045755,嘉澤國泰93購01,,,,,0.00,0.00,0,0,0,0,0,0,0,0,0,0,0,0,0
20200212,045756,智伸科國泰93購01,,,,,0.00,0.00,0,0,0,0,0,0,0,0,0,0,0,0,0
20200212,045757,台表科國泰93購03,1.97,2.03,1.94,2.03,+0.12,6.28,87000,6,172710,0,0,0,0,0,0,42000,45000,-3000,-3000
20200212,045758,易華電國泰94購01,,,,,0.00,0.00,0,0,0,0,0,0,0,0,0,0,0,0,0
20200212,045759,T50反1統一94購02,,,,,0.00,0.00,0,0,0,0,0,0,0,0,0,0,0,0,0
20200212,04575P,新日興統一94售02,0.55,0.58,0.54,0.58,+0.04,7.41,83000,4,45840,0,0,0,0,0,0,50000,33000,17000,17000
20200212,045760,鴻海統一93購02,1.52,1.77,1.52,1.77,+0.37,26.43,244000,10,399400,0,0,0,0,0,0,80000,194000,-114000,-114000
20200212,045761,國巨統一92購02,,,,,0.00,0.00,0,0,0,0,0,0,0,0,0,0,0,0,0
20200212,045762,微星統一92購01,1.29,1.29,1.29,1.29,0.00,0.00,10000,1,12900,0,0,0,0,0,0,0,10000,-10000,-10000
20200212,045763,南亞科統一93購01,0.79,0.79,0.77,0.77,-0.06,-7.23,227000,5,177130,0,0,0,0,0,0,127000,100000,27000,27000
20200212,045764,智易統一94購01,,,,,0.00,0.00,0,0,0,0,0,0,0,0,0,0,0,0,0
20200212,045765,康控統一92購01,,,,,0.00,0.00,0,0,0,0,0,0,0,0,0,0,0,0,0
20200212,045766,上証2X元富92購01,,,,,0.00,0.00,0,0,0,0,0,0,0,0,0,0,0,0,0
20200212,045767,大立光元富95購01,,,,,0.00,0.00,0,0,0,0,0,0,0,0,0,0,0,0,0
20200212,045768,大立光元富95購02,5.15,5.80,5.15,5.80,+0.75,14.85,49000,12,275350,0,0,0,0,0,0,47000,4000,43000,43000
20200212,045769,喬山元大92購02,,,,,0.00,0.00,0,0,0,0,0,0,0,0,0,0,0,0,0
20200212,04576P,上海銀統一94售04,1.90,1.90,1.90,1.90,0.00,0.00,12000,1,22800,0,0,0,0,0,0,12000,0,12000,12000
20200212,045770,華通元大93購03,,,,,0.00,0.00,0,0,0,0,0,0,0,0,0,0,0,0,0
20200212,045771,國巨元大93購08,,,,,0.00,0.00,0,0,0,0,0,0,0,0,0,0,0,0,0
20200212,045772,台光電元大93購01,,,,,0.00,0.00,0,0,0,0,0,0,0,0,0,0,0,0,0
20200212,045773,奇力新元大92購02,,,,,0.00,0.00,0,0,0,0,0,0,0,0,0,0,0,0,0
20200212,045774,義隆元大92購02,0.34,0.34,0.34,0.34,0.00,0.00,130000,2,44200,0,0,0,0,0,0,130000,0,130000,130000
20200212,045775,可成元大92購06,,,,,0.00,0.00,0,0,0,0,0,0,0,0,0,0,0,0,0
20200212,045776,可成元大92購07,,,,,0.00,0.00,0,0,0,0,0,0,0,0,0,0,0,0,0
20200212,045777,強茂元大92購02,,,,,0.00,0.00,0,0,0,0,0,0,0,0,0,0,0,0,0
20200212,045778,大立光元大93購10,,,,,0.00,0.00,0,0,0,0,0,0,0,0,0,0,0,0,0
20200212,045779,大立光元大93購11,,,,,0.00,0.00,0,0,0,0,0,0,0,0,0,0,0,0,0
20200212,04577P,康友元富94售02,,,,,0.00,0.00,0,0,0,0,0,0,0,0,0,0,0,0,0
20200212,045780,奇鋐元大94購01,,,,,0.00,0.00,0,0,0,0,0,0,0,0,0,0,0,0,0
20200212,045781,聯詠元大92購03,,,,,0.00,0.00,0,0,0,0,0,0,0,0,0,0,0,0,0
20200212,045782,欣興元大93購04,0.62,0.80,0.59,0.80,+0.18,29.03,701000,20,491190,0,0,0,0,0,0,600000,101000,499000,499000
20200212,045783,明泰元大92購01,,,,,0.00,0.00,0,0,0,0,0,0,0,0,0,0,0,0,0
20200212,045784,晶睿元大92購02,0.01,0.01,0.01,0.01,0.00,0.00,10000,10,100,0,0,0,0,0,0,0,0,0,0
20200212,045785,揚明光元大93購04,,,,,0.00,0.00,0,0,0,0,0,0,0,0,0,0,0,0,0
20200212,045786,台勝科元大92購02,,,,,0.00,0.00,0,0,0,0,0,0,0,0,0,0,0,0,0
20200212,045787,TPK元大93購04,,,,,0.00,0.00,0,0,0,0,0,0,0,0,0,0,0,0,0
20200212,045788,南寶元大93購01,,,,,0.00,0.00,0,0,0,0,0,0,0,0,0,0,0,0,0
20200212,045789,致伸元大92購02,,,,,0.00,0.00,0,0,0,0,0,0,0,0,0,0,0,0,0
20200212,04578P,微星富邦96售01,0.44,0.44,0.44,0.44,-0.04,-8.33,10000,1,4400,0,0,0,0,0,0,10000,0,10000,10000
20200212,045790,瀚宇博元大92購01,,,,,0.00,0.00,0,0,0,0,0,0,0,0,0,0,0,0,0
20200212,045791,台表科元大93購04,2.66,2.70,2.66,2.70,+0.05,1.89,10000,2,26800,0,0,0,0,0,0,10000,0,10000,10000
20200212,045792,鴻海兆豐92購04,,,,,0.00,0.00,0,0,0,0,0,0,0,0,0,0,0,0,0
20200212,045793,台積電兆豐93購03,,,,,0.00,0.00,0,0,0,0,0,0,0,0,0,0,0,0,0
20200212,045794,奇力新兆豐93購01,,,,,0.00,0.00,0,0,0,0,0,0,0,0,0,0,0,0,0
20200212,045795,瀚宇博兆豐94購01,0.39,0.40,0.39,0.40,+0.05,14.29,294000,6,115050,0,0,0,0,0,0,294000,0,294000,294000
20200212,045796,廣達中信93購01,0.62,0.68,0.62,0.68,+0.02,3.03,116000,5,76800,0,0,0,0,0,0,82000,34000,48000,48000
20200212,045797,健策中信93購01,1.50,1.60,1.41,1.60,+0.19,13.48,257000,31,388550,0,0,0,0,0,0,177000,50000,127000,127000
20200212,045798,華邦電亞東93購02,,,,,0.00,0.00,0,0,0,0,0,0,0,0,0,0,0,0,0
20200212,045799,微星亞東93購01,,,,,0.00,0.00,0,0,0,0,0,0,0,0,0,0,0,0,0
20200212,04579P,聯茂台新94售01,,,,,0.00,0.00,0,0,0,0,0,0,0,0,0,0,0,0,0
20200212,045800,漢唐亞東93購01,,,,,0.00,0.00,0,0,0,0,0,0,0,0,0,0,0,0,0
20200212,045801,緯穎第一92購01,,,,,0.00,0.00,0,0,0,0,0,0,0,0,0,0,0,0,0
20200212,045802,國巨國票92購02,,,,,0.00,0.00,0,0,0,0,0,0,0,0,0,0,0,0,0
20200212,045803,旺宏國票93購01,,,,,0.00,0.00,0,0,0,0,0,0,0,0,0,0,0,0,0
20200212,045804,聯發科國票92購01,,,,,0.00,0.00,0,0,0,0,0,0,0,0,0,0,0,0,0
20200212,045805,強茂國票92購01,,,,,0.00,0.00,0,0,0,0,0,0,0,0,0,0,0,0,0
20200212,045806,宏達電國票92購04,,,,,0.00,0.00,0,0,0,0,0,0,0,0,0,0,0,0,0
20200212,045807,上緯控國票93購01,,,,,0.00,0.00,0,0,0,0,0,0,0,0,0,0,0,0,0
20200212,045808,台表科國票92購02,,,,,0.00,0.00,0,0,0,0,0,0,0,0,0,0,0,0,0
20200212,045809,羅麗芬國票92購01,,,,,0.00,0.00,0,0,0,0,0,0,0,0,0,0,0,0,0
20200212,04580P,楠梓電康和94售02,,,,,0.00,0.00,0,0,0,0,0,0,0,0,0,0,0,0,0
20200212,045810,緯穎國票92購01,10.80,10.80,10.80,10.80,+0.50,4.85,50000,1,540000,0,0,0,0,0,0,50000,0,50000,50000
20200212,045811,緯穎國票92購02,,,,,0.00,0.00,0,0,0,0,0,0,0,0,0,0,0,0,0
20200212,045812,緯穎國票92購03,,,,,0.00,0.00,0,0,0,0,0,0,0,0,0,0,0,0,0
20200212,045813,緯穎國票92購04,,,,,0.00,0.00,0,0,0,0,0,0,0,0,0,0,0,0,0
20200212,045814,可成麥證93購01,1.15,1.32,1.15,1.32,+0.24,22.22,155000,17,195380,20000,135000,-115000,0,0,0,20000,135000,-115000,-115000
20200212,045815,力山日盛92購01,,,,,0.00,0.00,0,0,0,0,0,0,0,0,0,0,0,0,0
20200212,045816,緯穎日盛92購01,,,,,0.00,0.00,0,0,0,0,0,0,0,0,0,0,0,0,0
20200212,045817,滬深2X凱基95購02,0.65,0.65,0.65,0.65,0.00,0.00,10000,1,6500,0,0,0,0,0,0,0,10000,-10000,-10000
20200212,045818,鴻海凱基93購10,2.35,2.45,2.35,2.45,+0.31,14.49,20000,2,48000,0,0,0,0,0,0,10000,10000,0,0
20200212,045819,台積電凱基92購14,5.10,5.10,5.10,5.10,0.00,0.00,1000,1,5100,0,0,0,0,0,0,1000,0,1000,1000
20200212,04581P,楠梓電康和94售03,,,,,0.00,0.00,0,0,0,0,0,0,0,0,0,0,0,0,0
20200212,045820,京元電凱基92購04,1.01,1.23,1.01,1.23,+0.29,30.85,60000,2,62800,0,0,0,0,0,0,50000,10000,40000,40000
20200212,045821,聯詠凱基92購06,,,,,0.00,0.00,0,0,0,0,0,0,0,0,0,0,0,0,0
20200212,045822,TPK凱基93購03,,,,,0.00,0.00,0,0,0,0,0,0,0,0,0,0,0,0,0
20200212,045823,康普凱基92購02,,,,,0.00,0.00,0,0,0,0,0,0,0,0,0,0,0,0,0
20200212,045824,嘉聯益凱基93購02,0.56,0.59,0.56,0.59,+0.06,11.32,201000,2,118560,0,0,0,0,0,0,201000,0,201000,201000
20200212,045825,力成凱基93購02,8.85,9.15,8.85,9.15,0.00,0.00,20000,4,180000,0,0,0,0,0,0,0,20000,-20000,-20000
20200212,045826,樺漢凱基92購02,,,,,0.00,0.00,0,0,0,0,0,0,0,0,0,0,0,0,0
20200212,045827,緯穎凱基92購02,,,,,0.00,0.00,0,0,0,0,0,0,0,0,0,0,0,0,0
20200212,045828,緯穎凱基92購03,,,,,0.00,0.00,0,0,0,0,0,0,0,0,0,0,0,0,0
20200212,045829,滬深2X群益95購02,0.14,0.15,0.14,0.15,-0.01,-6.25,422000,4,59100,0,0,0,0,0,0,0,422000,-422000,-422000
20200212,04582P,燿華康和94售01,,,,,0.00,0.00,0,0,0,0,0,0,0,0,0,0,0,0,0
20200212,045830,亞德客群益92購02,,,,,0.00,0.00,0,0,0,0,0,0,0,0,0,0,0,0,0
20200212,045831,國巨群益92購05,,,,,0.00,0.00,0,0,0,0,0,0,0,0,0,0,0,0,0
20200212,045832,建準群益92購01,,,,,0.00,0.00,0,0,0,0,0,0,0,0,0,0,0,0,0
20200212,045833,京元電群益92購02,,,,,0.00,0.00,0,0,0,0,0,0,0,0,0,0,0,0,0
20200212,045834,兆豐金群益92購01,,,,,0.00,0.00,0,0,0,0,0,0,0,0,0,0,0,0,0
20200212,045835,奇鋐群益92購01,,,,,0.00,0.00,0,0,0,0,0,0,0,0,0,0,0,0,0
20200212,045836,群創群益98購01,,,,,0.00,0.00,0,0,0,0,0,0,0,0,0,0,0,0,0
20200212,045837,群創群益98購02,,,,,0.00,0.00,0,0,0,0,0,0,0,0,0,0,0,0,0
20200212,045838,揚明光群益93購01,,,,,0.00,0.00,0,0,0,0,0,0,0,0,0,0,0,0,0
20200212,045839,台郡群益92購01,,,,,0.00,0.00,0,0,0,0,0,0,0,0,0,0,0,0,0
20200212,04583P,滬深2X永豐94售06,,,,,0.00,0.00,0,0,0,0,0,0,0,0,0,0,0,0,0
20200212,045840,緯穎群益92購01,,,,,0.00,0.00,0,0,0,0,0,0,0,0,0,0,0,0,0
20200212,045841,巨大群益92購01,,,,,0.00,0.00,0,0,0,0,0,0,0,0,0,0,0,0,0
20200212,045842,T50反1台新98購01,0.12,0.12,0.12,0.12,0.00,0.00,710000,14,85200,0,0,0,0,0,0,0,710000,-710000,-710000
20200212,045843,燿華台新92購01,1.90,1.90,1.90,1.90,-0.01,-0.52,10000,1,19000,0,0,0,0,0,0,0,10000,-10000,-10000
20200212,045844,臻鼎台新92購01,,,,,0.00,0.00,0,0,0,0,0,0,0,0,0,0,0,0,0
20200212,045845,台塑康和92購01,,,,,0.00,0.00,0,0,0,0,0,0,0,0,0,0,0,0,0
20200212,045846,喬山康和92購01,,,,,0.00,0.00,0,0,0,0,0,0,0,0,0,0,0,0,0
20200212,045847,智伸科康和92購01,,,,,0.00,0.00,0,0,0,0,0,0,0,0,0,0,0,0,0
20200212,045848,光磊永豐92購01,,,,,0.00,0.00,0,0,0,0,0,0,0,0,0,0,0,0,0
20200212,045849,可成永豐92購01,,,,,0.00,0.00,0,0,0,0,0,0,0,0,0,0,0,0,0
20200212,04584P,楠梓電永豐94售01,,,,,0.00,0.00,0,0,0,0,0,0,0,0,0,0,0,0,0
20200212,045850,嘉澤永豐92購01,,,,,0.00,0.00,0,0,0,0,0,0,0,0,0,0,0,0,0
20200212,045851,健策永豐92購01,1.30,1.32,1.12,1.32,+0.29,28.16,110000,6,139680,0,0,0,0,0,0,110000,20000,90000,90000
20200212,045852,正文永豐92購01,,,,,0.00,0.00,0,0,0,0,0,0,0,0,0,0,0,0,0
20200212,045853,緯穎永豐92購02,,,,,0.00,0.00,0,0,0,0,0,0,0,0,0,0,0,0,0
20200212,045854,貿聯富邦93購01,0.17,0.20,0.17,0.20,+0.05,33.33,61000,5,11130,0,0,0,0,0,0,61000,0,61000,61000
20200212,045855,緯穎富邦93購01,2.29,2.29,2.29,2.29,0.00,0.00,5000,1,11450,0,0,0,0,0,0,0,0,0,0
20200212,045856,南亞科國泰94購01,,,,,0.00,0.00,0,0,0,0,0,0,0,0,0,0,0,0,0
20200212,045857,友達國泰93購02,,,,,0.00,0.00,0,0,0,0,0,0,0,0,0,0,0,0,0
20200212,045858,元油2X統一94購02,0.14,0.14,0.14,0.14,0.00,0.00,518000,5,72520,0,0,0,0,0,0,0,498000,-498000,-498000
20200212,045859,華通統一92購01,,,,,0.00,0.00,0,0,0,0,0,0,0,0,0,0,0,0,0
20200212,04585P,楠梓電永豐94售02,,,,,0.00,0.00,0,0,0,0,0,0,0,0,0,0,0,0,0
20200212,045860,鴻海統一93購03,1.98,1.98,1.98,1.98,0.00,0.00,10000,1,19800,0,0,0,0,0,0,0,10000,-10000,-10000
20200212,045861,智邦統一93購02,1.15,1.25,0.94,0.94,0.00,0.00,667000,35,723920,0,0,0,0,0,0,605000,12000,593000,593000
20200212,045862,大立光統一93購02,,,,,0.00,0.00,0,0,0,0,0,0,0,0,0,0,0,0,0
20200212,045863,健策統一92購01,,,,,0.00,0.00,0,0,0,0,0,0,0,0,0,0,0,0,0
20200212,045864,致伸統一93購01,,,,,0.00,0.00,0,0,0,0,0,0,0,0,0,0,0,0,0
20200212,045865,緯穎統一93購02,,,,,0.00,0.00,0,0,0,0,0,0,0,0,0,0,0,0,0
20200212,045866,南茂統一94購01,0.91,0.94,0.90,0.93,-0.02,-2.11,94000,11,86450,0,0,0,0,0,0,94000,0,94000,94000
20200212,045867,臺股指統一93購03,,,,,0.00,0.00,0,0,0,0,0,0,0,0,0,0,0,0,0
20200212,045868,臺股指統一93購04,,,,,0.00,0.00,0,0,0,0,0,0,0,0,0,0,0,0,0
20200212,045869,滬深2X元富95購01,0.33,0.33,0.33,0.33,0.00,0.00,90000,1,29700,0,0,0,0,0,0,0,90000,-90000,-90000
20200212,04586P,光罩永豐94售02,0.54,0.54,0.54,0.54,-0.07,-11.48,101000,2,54540,0,0,0,0,0,0,1000,100000,-99000,-99000
20200212,045870,元油2X元富96購02,0.29,0.30,0.29,0.30,+0.02,7.14,724000,9,212160,0,0,0,0,0,0,504000,212000,292000,292000
20200212,045871,元油2X元富96購03,0.37,0.39,0.37,0.39,+0.02,5.41,225000,17,85000,0,0,0,0,0,0,140000,25000,115000,115000
20200212,045872,元油2X元富98購03,0.28,0.30,0.27,0.30,+0.01,3.45,5402000,131,1553620,0,0,0,0,0,0,1144000,3342000,-2198000,-2198000
20200212,045873,元油2X元富98購04,0.74,0.80,0.74,0.80,+0.07,9.59,536000,29,417990,0,0,0,0,0,0,170000,329000,-159000,-159000
20200212,045874,東元元富92購01,,,,,0.00,0.00,0,0,0,0,0,0,0,0,0,0,0,0,0
20200212,045875,仁寶元富92購01,,,,,0.00,0.00,0,0,0,0,0,0,0,0,0,0,0,0,0
20200212,045876,英業達元富92購01,,,,,0.00,0.00,0,0,0,0,0,0,0,0,0,0,0,0,0
20200212,045877,友達元富95購01,,,,,0.00,0.00,0,0,0,0,0,0,0,0,0,0,0,0,0
20200212,045878,欣興元富92購02,,,,,0.00,0.00,0,0,0,0,0,0,0,0,0,0,0,0,0
20200212,045879,致伸元富92購01,,,,,0.00,0.00,0,0,0,0,0,0,0,0,0,0,0,0,0
20200212,04587P,聯發科永豐94售02,,,,,0.00,0.00,0,0,0,0,0,0,0,0,0,0,0,0,0
20200212,045880,超眾元富92購01,,,,,0.00,0.00,0,0,0,0,0,0,0,0,0,0,0,0,0
20200212,045881,同欣電元富92購01,,,,,0.00,0.00,0,0,0,0,0,0,0,0,0,0,0,0,0
20200212,045882,滬深2X元大95購01,,,,,0.00,0.00,0,0,0,0,0,0,0,0,0,0,0,0,0
20200212,045883,元油2X元大95購07,0.07,0.07,0.07,0.07,+0.01,16.67,65000,3,4550,0,0,0,0,0,0,0,65000,-65000,-65000
20200212,045884,力山元大92購05,,,,,0.00,0.00,0,0,0,0,0,0,0,0,0,0,0,0,0
20200212,045885,台積電元大92購17,,,,,0.00,0.00,0,0,0,0,0,0,0,0,0,0,0,0,0
20200212,045886,華邦電元大92購04,,,,,0.00,0.00,0,0,0,0,0,0,0,0,0,0,0,0,0
20200212,045887,台光電元大92購07,0.03,0.03,0.03,0.03,+0.01,50.0,10000,1,300,0,0,0,0,0,0,10000,0,10000,10000
20200212,045888,宏達電元大92購04,,,,,0.00,0.00,0,0,0,0,0,0,0,0,0,0,0,0,0
20200212,045889,宏盛元大92購01,,,,,0.00,0.00,0,0,0,0,0,0,0,0,0,0,0,0,0
20200212,04588P,茂林永豐94售04,0.08,0.08,0.08,0.08,0.00,0.00,100000,1,8000,0,0,0,0,0,0,100000,0,100000,100000
20200212,045890,欣興元大92購06,,,,,0.00,0.00,0,0,0,0,0,0,0,0,0,0,0,0,0
20200212,045891,健鼎元大92購01,0.11,0.34,0.11,0.30,+0.24,400.0,719000,6,201760,0,0,0,0,0,0,235000,484000,-249000,-249000
20200212,045892,和鑫元大93購03,,,,,0.00,0.00,0,0,0,0,0,0,0,0,0,0,0,0,0
20200212,045893,貿聯元大92購04,0.04,0.08,0.04,0.08,+0.03,60.0,90000,2,6000,0,0,0,0,0,0,30000,60000,-30000,-30000
20200212,045894,智伸科元大92購01,,,,,0.00,0.00,0,0,0,0,0,0,0,0,0,0,0,0,0
20200212,045895,智伸科元大92購02,,,,,0.00,0.00,0,0,0,0,0,0,0,0,0,0,0,0,0
20200212,045896,正文元大92購03,,,,,0.00,0.00,0,0,0,0,0,0,0,0,0,0,0,0,0
20200212,045897,泰鼎元大93購04,,,,,0.00,0.00,0,0,0,0,0,0,0,0,0,0,0,0,0
20200212,045898,康控元大93購04,0.38,0.42,0.37,0.42,+0.08,23.53,104000,3,40010,0,0,0,0,0,0,104000,84000,20000,20000
20200212,045899,臻鼎元大92購03,0.33,0.33,0.23,0.23,0.00,0.00,299000,2,93670,0,0,0,0,0,0,50000,249000,-199000,-199000
20200212,04589P,祥碩永豐94售01,0.08,0.08,0.06,0.06,-0.02,-25.0,770000,10,49200,0,0,0,0,0,0,380000,0,380000,380000
20200212,045900,臻鼎元大92購05,,,,,0.00,0.00,0,0,0,0,0,0,0,0,0,0,0,0,0
20200212,045901,中磊元大92購01,,,,,0.00,0.00,0,0,0,0,0,0,0,0,0,0,0,0,0
20200212,045902,GIS元大92購05,,,,,0.00,0.00,0,0,0,0,0,0,0,0,0,0,0,0,0
20200212,045903,緯穎元大92購02,,,,,0.00,0.00,0,0,0,0,0,0,0,0,0,0,0,0,0
20200212,045904,勤誠元大92購01,,,,,0.00,0.00,0,0,0,0,0,0,0,0,0,0,0,0,0
20200212,045905,志超元大92購01,,,,,0.00,0.00,0,0,0,0,0,0,0,0,0,0,0,0,0
20200212,045906,鴻海中信94購01,2.03,2.32,2.00,2.32,+0.31,15.42,74000,8,158080,0,0,0,0,0,0,40000,34000,6000,6000
20200212,045907,鴻海中信94購02,2.74,3.19,2.69,3.19,+0.52,19.48,70000,7,201600,0,0,0,0,0,0,30000,40000,-10000,-10000
20200212,045908,矽創中信92購01,0.36,0.50,0.36,0.50,+0.17,51.52,134000,6,52440,0,0,0,0,0,0,94000,40000,54000,54000
20200212,045909,美律第一92購01,,,,,0.00,0.00,0,0,0,0,0,0,0,0,0,0,0,0,0
20200212,04590P,元石油元大97售01,,,,,0.00,0.00,0,0,0,0,0,0,0,0,0,0,0,0,0
20200212,045910,華通國票92購01,1.80,2.48,1.80,2.48,0.00,0.00,28000,2,55840,0,0,0,0,0,0,8000,0,8000,8000
20200212,045911,廣達國票92購01,,,,,0.00,0.00,0,0,0,0,0,0,0,0,0,0,0,0,0
20200212,045912,潤泰全國票92購01,,,,,0.00,0.00,0,0,0,0,0,0,0,0,0,0,0,0,0
20200212,045913,正文國票92購02,,,,,0.00,0.00,0,0,0,0,0,0,0,0,0,0,0,0,0
20200212,045914,超眾國票93購01,0.26,0.28,0.25,0.27,+0.01,3.85,60000,10,15830,0,0,0,0,0,0,60000,0,60000,60000
20200212,045915,樺漢國票92購01,,,,,0.00,0.00,0,0,0,0,0,0,0,0,0,0,0,0,0
20200212,045916,臺股指國票92購06,,,,,0.00,0.00,0,0,0,0,0,0,0,0,0,0,0,0,0
20200212,045917,臺股指國票92購07,,,,,0.00,0.00,0,0,0,0,0,0,0,0,0,0,0,0,0
20200212,045918,臺股指國票92購08,,,,,0.00,0.00,0,0,0,0,0,0,0,0,0,0,0,0,0
20200212,045919,臺股指國票92購09,,,,,0.00,0.00,0,0,0,0,0,0,0,0,0,0,0,0,0
20200212,04591P,上銀元大94售01,,,,,0.00,0.00,0,0,0,0,0,0,0,0,0,0,0,0,0
20200212,045920,臺股指國票92購10,,,,,0.00,0.00,0,0,0,0,0,0,0,0,0,0,0,0,0
20200212,045921,臺股指國票92購11,,,,,0.00,0.00,0,0,0,0,0,0,0,0,0,0,0,0,0
20200212,045922,臺股指國票92購12,,,,,0.00,0.00,0,0,0,0,0,0,0,0,0,0,0,0,0
20200212,045923,統一台新92購01,,,,,0.00,0.00,0,0,0,0,0,0,0,0,0,0,0,0,0
20200212,045924,鴻海台新92購01,,,,,0.00,0.00,0,0,0,0,0,0,0,0,0,0,0,0,0
20200212,045925,健策康和92購01,,,,,0.00,0.00,0,0,0,0,0,0,0,0,0,0,0,0,0
20200212,045926,康控康和92購01,,,,,0.00,0.00,0,0,0,0,0,0,0,0,0,0,0,0,0
20200212,045927,鴻海永豐92購01,,,,,0.00,0.00,0,0,0,0,0,0,0,0,0,0,0,0,0
20200212,045928,奇力新永豐92購01,,,,,0.00,0.00,0,0,0,0,0,0,0,0,0,0,0,0,0
20200212,045929,信邦永豐92購01,,,,,0.00,0.00,0,0,0,0,0,0,0,0,0,0,0,0,0
20200212,04592P,台積電元大94售10,0.21,0.21,0.21,0.21,-0.05,-19.23,5000,1,1050,0,0,0,0,0,0,0,5000,-5000,-5000
20200212,045930,康控永豐92購01,,,,,0.00,0.00,0,0,0,0,0,0,0,0,0,0,0,0,0
20200212,045931,緯穎永豐93購01,,,,,0.00,0.00,0,0,0,0,0,0,0,0,0,0,0,0,0
20200212,045932,亞泥群益92購01,,,,,0.00,0.00,0,0,0,0,0,0,0,0,0,0,0,0,0
20200212,045933,華通群益92購02,,,,,0.00,0.00,0,0,0,0,0,0,0,0,0,0,0,0,0
20200212,045934,燿華群益93購01,3.00,3.38,3.00,3.38,+0.28,9.03,42000,4,132260,0,0,0,0,0,0,12000,30000,-18000,-18000
20200212,045935,台光電群益92購01,,,,,0.00,0.00,0,0,0,0,0,0,0,0,0,0,0,0,0
20200212,045936,富邦金群益94購01,0.40,0.40,0.40,0.40,+0.06,17.65,169000,4,67600,0,0,0,0,0,0,0,99000,-99000,-99000
20200212,045937,臻鼎群益93購02,0.43,0.43,0.27,0.27,0.00,0.00,125000,4,41150,0,0,0,0,0,0,125000,0,125000,125000
20200212,045938,緯穎群益92購02,,,,,0.00,0.00,0,0,0,0,0,0,0,0,0,0,0,0,0
20200212,045939,緯穎群益92購03,,,,,0.00,0.00,0,0,0,0,0,0,0,0,0,0,0,0,0
20200212,04593P,台積電元大94售11,,,,,0.00,0.00,0,0,0,0,0,0,0,0,0,0,0,0,0
20200212,045940,臺股指群益92購01,,,,,0.00,0.00,0,0,0,0,0,0,0,0,0,0,0,0,0
20200212,045941,臺股指群益92購02,,,,,0.00,0.00,0,0,0,0,0,0,0,0,0,0,0,0,0
20200212,045942,臺股指群益92購03,,,,,0.00,0.00,0,0,0,0,0,0,0,0,0,0,0,0,0
20200212,045943,臺股指群益92購04,,,,,0.00,0.00,0,0,0,0,0,0,0,0,0,0,0,0,0
20200212,045944,臺股指群益92購05,,,,,0.00,0.00,0,0,0,0,0,0,0,0,0,0,0,0,0
20200212,045945,臺股指群益92購06,,,,,0.00,0.00,0,0,0,0,0,0,0,0,0,0,0,0,0
20200212,045946,華通兆豐92購02,,,,,0.00,0.00,0,0,0,0,0,0,0,0,0,0,0,0,0
20200212,045947,欣興兆豐93購04,0.28,0.33,0.28,0.33,0.00,0.00,10000,2,3050,0,0,0,0,0,0,10000,0,10000,10000
20200212,045948,臺股指兆豐92購01,,,,,0.00,0.00,0,0,0,0,0,0,0,0,0,0,0,0,0
20200212,045949,貿聯日盛92購01,0.37,0.37,0.37,0.37,0.00,0.00,1000,1,370,0,0,0,0,0,0,1000,0,1000,1000
20200212,04594P,緯穎元大94售04,,,,,0.00,0.00,0,0,0,0,0,0,0,0,0,0,0,0,0
20200212,045950,智伸科日盛92購01,,,,,0.00,0.00,0,0,0,0,0,0,0,0,0,0,0,0,0
20200212,045951,南寶日盛92購01,,,,,0.00,0.00,0,0,0,0,0,0,0,0,0,0,0,0,0
20200212,045952,台郡日盛92購01,,,,,0.00,0.00,0,0,0,0,0,0,0,0,0,0,0,0,0
20200212,045953,力山凱基92購02,,,,,0.00,0.00,0,0,0,0,0,0,0,0,0,0,0,0,0
20200212,045954,台積電凱基92購16,,,,,0.00,0.00,0,0,0,0,0,0,0,0,0,0,0,0,0
20200212,045955,宏碁凱基93購01,,,,,0.00,0.00,0,0,0,0,0,0,0,0,0,0,0,0,0
20200212,045956,英業達凱基93購01,,,,,0.00,0.00,0,0,0,0,0,0,0,0,0,0,0,0,0
20200212,045957,技嘉凱基93購03,2.19,2.25,2.05,2.05,-0.04,-1.91,112000,19,243080,0,0,0,0,0,0,69000,11000,58000,58000
20200212,045958,技嘉凱基93購04,0.95,1.01,0.89,0.89,-0.01,-1.11,382000,20,341150,0,0,0,0,0,0,26000,356000,-330000,-330000
20200212,045959,京元電凱基92購05,,,,,0.00,0.00,0,0,0,0,0,0,0,0,0,0,0,0,0
20200212,04595P,臺股指元大94售13,0.35,0.36,0.31,0.31,-0.09,-22.5,820000,4,271000,0,20000,-20000,0,0,0,420000,400000,20000,0
20200212,045960,聯發科凱基92購01,,,,,0.00,0.00,0,0,0,0,0,0,0,0,0,0,0,0,0
20200212,045961,宏達電凱基92購03,,,,,0.00,0.00,0,0,0,0,0,0,0,0,0,0,0,0,0
20200212,045962,高鐵凱基92購02,,,,,0.00,0.00,0,0,0,0,0,0,0,0,0,0,0,0,0
20200212,045963,新光金凱基93購01,1.14,1.14,1.14,1.14,+0.02,1.79,1000,1,1140,0,0,0,0,0,0,1000,0,1000,1000
20200212,045964,大立光凱基92購02,,,,,0.00,0.00,0,0,0,0,0,0,0,0,0,0,0,0,0
20200212,045965,大立光凱基92購03,,,,,0.00,0.00,0,0,0,0,0,0,0,0,0,0,0,0,0
20200212,045966,聯詠凱基92購07,,,,,0.00,0.00,0,0,0,0,0,0,0,0,0,0,0,0,0
20200212,045967,日電貿凱基92購01,2.07,2.07,1.96,2.07,+0.65,45.77,42000,4,83530,0,0,0,0,0,0,40000,2000,38000,38000
20200212,045968,貿聯凱基92購03,,,,,0.00,0.00,0,0,0,0,0,0,0,0,0,0,0,0,0
20200212,045969,合勤控凱基92購01,,,,,0.00,0.00,0,0,0,0,0,0,0,0,0,0,0,0,0
20200212,04596P,臺股指元大94售14,0.57,0.57,0.53,0.53,-0.12,-18.46,30000,2,16300,0,0,0,0,0,0,20000,10000,10000,10000
20200212,045970,日月光凱基92購02,,,,,0.00,0.00,0,0,0,0,0,0,0,0,0,0,0,0,0
20200212,045971,智伸科凱基92購01,,,,,0.00,0.00,0,0,0,0,0,0,0,0,0,0,0,0,0
20200212,045972,致伸凱基92購03,,,,,0.00,0.00,0,0,0,0,0,0,0,0,0,0,0,0,0
20200212,045973,臻鼎凱基92購03,,,,,0.00,0.00,0,0,0,0,0,0,0,0,0,0,0,0,0
20200212,045974,傳奇凱基93購02,,,,,0.00,0.00,0,0,0,0,0,0,0,0,0,0,0,0,0
20200212,045975,祥碩凱基93購04,,,,,0.00,0.00,0,0,0,0,0,0,0,0,0,0,0,0,0
20200212,045976,啟碁凱基92購01,,,,,0.00,0.00,0,0,0,0,0,0,0,0,0,0,0,0,0
20200212,045977,緯穎凱基92購04,,,,,0.00,0.00,0,0,0,0,0,0,0,0,0,0,0,0,0
20200212,045978,緯穎凱基92購05,,,,,0.00,0.00,0,0,0,0,0,0,0,0,0,0,0,0,0
20200212,045979,巨大凱基93購01,,,,,0.00,0.00,0,0,0,0,0,0,0,0,0,0,0,0,0
20200212,04597P,為升凱基94售02,2.42,2.42,2.42,2.42,-0.07,-2.81,10000,1,24200,0,0,0,0,0,0,0,10000,-10000,-10000
20200212,045980,百和凱基93購03,,,,,0.00,0.00,0,0,0,0,0,0,0,0,0,0,0,0,0
20200212,045981,臺股指凱基92購09,,,,,0.00,0.00,0,0,0,0,0,0,0,0,0,0,0,0,0
20200212,045982,臺股指凱基92購10,,,,,0.00,0.00,0,0,0,0,0,0,0,0,0,0,0,0,0
20200212,045983,臺股指凱基92購11,,,,,0.00,0.00,0,0,0,0,0,0,0,0,0,0,0,0,0
20200212,045984,亞光麥證93購02,0.37,0.40,0.36,0.37,0.00,0.00,30000,7,11080,15000,15000,0,0,0,0,15000,15000,0,0
20200212,045985,台達電永昌93購01,,,,,0.00,0.00,0,0,0,0,0,0,0,0,0,0,0,0,0
20200212,045986,南亞科永昌93購01,,,,,0.00,0.00,0,0,0,0,0,0,0,0,0,0,0,0,0
20200212,045987,臺股指永昌92購01,,,,,0.00,0.00,0,0,0,0,0,0,0,0,0,0,0,0,0
20200212,045988,臺股指永昌92購02,,,,,0.00,0.00,0,0,0,0,0,0,0,0,0,0,0,0,0
20200212,045989,緯穎國泰93購03,,,,,0.00,0.00,0,0,0,0,0,0,0,0,0,0,0,0,0
20200212,04598P,光罩凱基94售03,1.12,1.12,1.12,1.12,-0.12,-9.68,1000,1,1120,0,0,0,0,0,0,1000,0,1000,1000
20200212,045990,元石油富邦93購02,,,,,0.00,0.00,0,0,0,0,0,0,0,0,0,0,0,0,0
20200212,045991,為升富邦95購01,,,,,0.00,0.00,0,0,0,0,0,0,0,0,0,0,0,0,0
20200212,045992,鴻海富邦94購01,,,,,0.00,0.00,0,0,0,0,0,0,0,0,0,0,0,0,0
20200212,045993,美律富邦93購01,0.18,0.20,0.18,0.20,0.00,0.00,286000,7,55240,0,0,0,0,0,0,0,286000,-286000,-286000
20200212,045994,康控富邦94購01,0.42,0.45,0.42,0.43,+0.05,13.16,764000,19,332960,0,0,0,0,0,0,10000,744000,-734000,-734000
20200212,045995,台表科富邦93購01,,,,,0.00,0.00,0,0,0,0,0,0,0,0,0,0,0,0,0
20200212,045996,南電富邦94購01,0.74,0.90,0.70,0.90,+0.25,38.46,58000,12,46190,0,0,0,0,0,0,6000,52000,-46000,-46000
20200212,045997,臺股指富邦92購01,,,,,0.00,0.00,0,0,0,0,0,0,0,0,0,0,0,0,0
20200212,045998,臺股指富邦92購02,,,,,0.00,0.00,0,0,0,0,0,0,0,0,0,0,0,0,0
20200212,045999,華通統一92購02,,,,,0.00,0.00,0,0,0,0,0,0,0,0,0,0,0,0,0
20200212,04599P,南亞科凱基94售03,0.65,0.65,0.65,0.65,-0.06,-8.45,60000,1,39000,0,0,0,0,0,0,60000,60000,0,0
20200212,046000,台光電統一92購06,,,,,0.00,0.00,0,0,0,0,0,0,0,0,0,0,0,0,0
20200212,046001,友達統一93購03,,,,,0.00,0.00,0,0,0,0,0,0,0,0,0,0,0,0,0
20200212,046002,美律統一93購01,0.26,0.33,0.26,0.33,+0.11,50.0,761000,62,234080,0,0,0,0,0,0,56000,683000,-627000,-627000
20200212,046003,欣興統一92購02,0.55,0.69,0.55,0.67,+0.28,71.79,320000,21,204900,0,0,0,0,0,0,120000,200000,-80000,-80000
20200212,046004,群創統一93購02,,,,,0.00,0.00,0,0,0,0,0,0,0,0,0,0,0,0,0
20200212,046005,健策統一92購02,6.30,6.30,6.30,6.30,0.00,0.00,2000,1,12600,0,0,0,0,0,0,2000,0,2000,2000
20200212,046006,和碩統一92購01,,,,,0.00,0.00,0,0,0,0,0,0,0,0,0,0,0,0,0
20200212,046007,緯穎統一92購02,,,,,0.00,0.00,0,0,0,0,0,0,0,0,0,0,0,0,0
20200212,046008,臺股指統一92購03,,,,,0.00,0.00,0,0,0,0,0,0,0,0,0,0,0,0,0
20200212,046009,大立光元富92購02,,,,,0.00,0.00,0,0,0,0,0,0,0,0,0,0,0,0,0
20200212,04600P,可成凱基94售07,2.40,2.40,2.13,2.13,-0.51,-19.32,9000,4,20820,0,0,0,0,0,0,4000,7000,-3000,-3000
20200212,046010,大立光元富92購03,,,,,0.00,0.00,0,0,0,0,0,0,0,0,0,0,0,0,0
20200212,046011,欣興元富95購01,1.01,1.26,1.00,1.25,+0.30,31.58,815000,42,935910,0,0,0,0,0,0,279000,496000,-217000,-217000
20200212,046012,智易元富92購01,,,,,0.00,0.00,0,0,0,0,0,0,0,0,0,0,0,0,0
20200212,046013,緯穎元富92購01,,,,,0.00,0.00,0,0,0,0,0,0,0,0,0,0,0,0,0
20200212,046014,緯穎元富92購02,,,,,0.00,0.00,0,0,0,0,0,0,0,0,0,0,0,0,0
20200212,046015,緯穎元富92購03,,,,,0.00,0.00,0,0,0,0,0,0,0,0,0,0,0,0,0
20200212,046016,緯穎元富92購04,,,,,0.00,0.00,0,0,0,0,0,0,0,0,0,0,0,0,0
20200212,046017,臺股指元富92購01,,,,,0.00,0.00,0,0,0,0,0,0,0,0,0,0,0,0,0
20200212,046018,臺股指元富92購02,,,,,0.00,0.00,0,0,0,0,0,0,0,0,0,0,0,0,0
20200212,046019,臺股指元富92購03,,,,,0.00,0.00,0,0,0,0,0,0,0,0,0,0,0,0,0
20200212,04601P,大立光凱基94售07,,,,,0.00,0.00,0,0,0,0,0,0,0,0,0,0,0,0,0
20200212,046020,滬深2X元大95購02,,,,,0.00,0.00,0,0,0,0,0,0,0,0,0,0,0,0,0
20200212,046021,台泥元大92購01,2.44,2.44,2.44,2.44,-0.05,-2.01,10000,2,24400,0,0,0,0,0,0,10000,0,10000,10000
20200212,046022,國喬元大92購01,,,,,0.00,0.00,0,0,0,0,0,0,0,0,0,0,0,0,0
20200212,046023,大成鋼元大92購02,,,,,0.00,0.00,0,0,0,0,0,0,0,0,0,0,0,0,0
20200212,046024,鴻海元大92購11,4.23,4.85,4.23,4.85,+0.65,15.48,33000,4,146050,0,0,0,0,0,0,20000,13000,7000,7000
20200212,046025,台積電元大92購18,10.20,10.20,10.20,10.20,0.00,0.00,3000,1,30600,0,0,0,0,0,0,3000,0,3000,3000
20200212,046026,友訊元大92購01,0.38,0.38,0.34,0.34,0.00,0.00,364000,3,127760,0,0,0,0,0,0,234000,130000,104000,104000
20200212,046027,旺宏元大92購08,,,,,0.00,0.00,0,0,0,0,0,0,0,0,0,0,0,0,0
20200212,046028,微星元大92購01,,,,,0.00,0.00,0,0,0,0,0,0,0,0,0,0,0,0,0
20200212,046029,微星元大92購02,,,,,0.00,0.00,0,0,0,0,0,0,0,0,0,0,0,0,0
20200212,04602P,聯詠凱基94售02,,,,,0.00,0.00,0,0,0,0,0,0,0,0,0,0,0,0,0
20200212,046030,南亞科元大92購04,0.72,0.72,0.68,0.68,-0.11,-13.92,195000,4,136320,0,0,0,0,0,0,98000,97000,1000,1000
20200212,046031,建準元大92購03,,,,,0.00,0.00,0,0,0,0,0,0,0,0,0,0,0,0,0
20200212,046032,全新元大92購04,,,,,0.00,0.00,0,0,0,0,0,0,0,0,0,0,0,0,0
20200212,046033,義隆元大92購03,,,,,0.00,0.00,0,0,0,0,0,0,0,0,0,0,0,0,0
20200212,046034,可成元大92購09,2.48,2.68,2.48,2.68,0.00,0.00,11000,2,27480,0,0,0,0,0,0,0,11000,-11000,-11000
20200212,046035,冠德元大92購03,,,,,0.00,0.00,0,0,0,0,0,0,0,0,0,0,0,0,0
20200212,046036,大立光元大92購15,,,,,0.00,0.00,0,0,0,0,0,0,0,0,0,0,0,0,0
20200212,046037,大立光元大92購16,,,,,0.00,0.00,0,0,0,0,0,0,0,0,0,0,0,0,0
20200212,046038,欣興元大92購07,0.08,0.08,0.08,0.08,0.00,0.00,982000,9,78560,0,0,0,0,0,0,0,982000,-982000,-982000
20200212,046039,新日興元大92購02,2.08,2.08,2.08,2.08,-0.16,-7.14,16000,2,33280,0,0,0,0,0,0,16000,0,16000,16000
20200212,04603P,訊芯凱基94售03,0.87,0.87,0.85,0.85,-0.12,-12.37,80000,2,69200,0,0,0,0,0,0,0,80000,-80000,-80000
20200212,046040,晶睿元大92購03,,,,,0.00,0.00,0,0,0,0,0,0,0,0,0,0,0,0,0
20200212,046041,群創元大92購06,,,,,0.00,0.00,0,0,0,0,0,0,0,0,0,0,0,0,0
20200212,046042,台勝科元大92購03,,,,,0.00,0.00,0,0,0,0,0,0,0,0,0,0,0,0,0
20200212,046043,日月光元大92購02,0.82,0.99,0.82,0.99,+0.30,43.48,75000,4,71150,0,0,0,0,0,0,0,75000,-75000,-75000
20200212,046044,達興元大92購03,,,,,0.00,0.00,0,0,0,0,0,0,0,0,0,0,0,0,0
20200212,046045,聯茂元大92購07,0.17,0.22,0.17,0.22,0.00,0.00,30000,2,5600,0,0,0,0,0,0,30000,0,30000,30000
20200212,046046,世紀鋼元大93購03,,,,,0.00,0.00,0,0,0,0,0,0,0,0,0,0,0,0,0
20200212,046047,臺股指元大93購17,,,,,0.00,0.00,0,0,0,0,0,0,0,0,0,0,0,0,0
20200212,046048,臺股指元大93購18,,,,,0.00,0.00,0,0,0,0,0,0,0,0,0,0,0,0,0
20200212,046049,臺股指元大93購19,,,,,0.00,0.00,0,0,0,0,0,0,0,0,0,0,0,0,0
20200212,04604P,華新科國票95售01,0.05,0.06,0.05,0.06,-0.01,-14.29,150000,2,8000,0,0,0,0,0,0,100000,50000,50000,50000
20200212,046050,臺股指元大93購20,,,,,0.00,0.00,0,0,0,0,0,0,0,0,0,0,0,0,0
20200212,046051,華通亞東93購01,,,,,0.00,0.00,0,0,0,0,0,0,0,0,0,0,0,0,0
20200212,046052,國巨中信93購01,,,,,0.00,0.00,0,0,0,0,0,0,0,0,0,0,0,0,0
20200212,046053,滬深2X群益94購01,0.39,0.39,0.39,0.39,+0.01,2.63,1000,1,390,0,0,0,0,0,0,0,1000,-1000,-1000
20200212,046054,冠德群益93購01,,,,,0.00,0.00,0,0,0,0,0,0,0,0,0,0,0,0,0
20200212,046055,欣興群益92購02,,,,,0.00,0.00,0,0,0,0,0,0,0,0,0,0,0,0,0
20200212,046056,材料群益92購01,,,,,0.00,0.00,0,0,0,0,0,0,0,0,0,0,0,0,0
20200212,046057,致伸群益92購01,,,,,0.00,0.00,0,0,0,0,0,0,0,0,0,0,0,0,0
20200212,046058,訊芯群益92購01,,,,,0.00,0.00,0,0,0,0,0,0,0,0,0,0,0,0,0
20200212,046059,京元電日盛92購01,,,,,0.00,0.00,0,0,0,0,0,0,0,0,0,0,0,0,0
20200212,04605P,台積電兆豐94售03,0.13,0.13,0.13,0.13,-0.02,-13.33,10000,1,1300,0,0,0,0,0,0,0,10000,-10000,-10000
20200212,046060,台塑凱基92購01,,,,,0.00,0.00,0,0,0,0,0,0,0,0,0,0,0,0,0
20200212,046061,中石化凱基98購01,0.74,0.74,0.74,0.74,-0.02,-2.63,60000,2,44400,0,0,0,0,0,0,60000,0,60000,60000
20200212,046062,遠東新凱基92購02,0.40,0.40,0.39,0.39,-0.05,-11.36,40000,4,15800,0,0,0,0,0,0,10000,30000,-20000,-20000
20200212,046063,台積電凱基92購18,,,,,0.00,0.00,0,0,0,0,0,0,0,0,0,0,0,0,0
20200212,046064,中工凱基94購01,,,,,0.00,0.00,0,0,0,0,0,0,0,0,0,0,0,0,0
20200212,046065,益航凱基93購02,,,,,0.00,0.00,0,0,0,0,0,0,0,0,0,0,0,0,0
20200212,046066,長榮航凱基94購01,0.68,0.74,0.68,0.74,+0.06,8.82,254000,6,184320,0,0,0,0,0,0,204000,50000,154000,154000
20200212,046067,富邦金凱基92購02,1.91,1.91,1.91,1.91,+0.34,21.66,10000,1,19100,0,0,0,0,0,0,0,10000,-10000,-10000
20200212,046068,國泰金凱基92購02,0.96,0.98,0.96,0.98,+0.06,6.52,20000,2,19400,0,0,0,0,0,0,10000,10000,0,0
20200212,046069,禾伸堂凱基92購01,3.87,3.87,3.68,3.87,-0.21,-5.15,23000,4,87110,0,0,0,0,0,0,12000,11000,1000,1000
20200212,04606P,高股息中信96售01,,,,,0.00,0.00,0,0,0,0,0,0,0,0,0,0,0,0,0
20200212,046070,景碩凱基92購03,7.85,7.85,7.85,7.85,+1.55,24.6,19000,1,149150,0,0,0,0,0,0,19000,0,19000,19000
20200212,046071,晶睿凱基92購02,,,,,0.00,0.00,0,0,0,0,0,0,0,0,0,0,0,0,0
20200212,046072,台勝科凱基92購03,,,,,0.00,0.00,0,0,0,0,0,0,0,0,0,0,0,0,0
20200212,046073,日月光凱基92購03,,,,,0.00,0.00,0,0,0,0,0,0,0,0,0,0,0,0,0
20200212,046074,佐登凱基92購01,,,,,0.00,0.00,0,0,0,0,0,0,0,0,0,0,0,0,0
20200212,046075,廣越凱基92購01,,,,,0.00,0.00,0,0,0,0,0,0,0,0,0,0,0,0,0
20200212,046076,拓凱凱基92購01,,,,,0.00,0.00,0,0,0,0,0,0,0,0,0,0,0,0,0
20200212,046077,南寶凱基92購02,,,,,0.00,0.00,0,0,0,0,0,0,0,0,0,0,0,0,0
20200212,046078,致伸凱基92購04,,,,,0.00,0.00,0,0,0,0,0,0,0,0,0,0,0,0,0
20200212,046079,瑞儀凱基92購03,,,,,0.00,0.00,0,0,0,0,0,0,0,0,0,0,0,0,0
20200212,04607P,A50中信94售01,,,,,0.00,0.00,0,0,0,0,0,0,0,0,0,0,0,0,0
20200212,046080,同欣電凱基92購03,2.06,2.06,2.06,2.06,-0.04,-1.9,20000,1,41200,0,0,0,0,0,0,20000,0,20000,20000
20200212,046081,康舒凱基92購01,,,,,0.00,0.00,0,0,0,0,0,0,0,0,0,0,0,0,0
20200212,046082,矽力凱基92購01,4.22,4.66,3.99,4.66,+0.83,21.67,55000,6,242200,0,0,0,0,0,0,10000,45000,-35000,-35000
20200212,046083,緯穎凱基92購06,,,,,0.00,0.00,0,0,0,0,0,0,0,0,0,0,0,0,0
20200212,046084,美利達凱基92購02,,,,,0.00,0.00,0,0,0,0,0,0,0,0,0,0,0,0,0
20200212,046085,儒鴻麥證92購01,,,,,0.00,0.00,0,0,0,0,0,0,0,0,0,0,0,0,0
20200212,046086,鴻海麥證92購02,,,,,0.00,0.00,0,0,0,0,0,0,0,0,0,0,0,0,0
20200212,046087,亞德客兆豐93購01,,,,,0.00,0.00,0,0,0,0,0,0,0,0,0,0,0,0,0
20200212,046088,台光電兆豐92購02,0.01,0.01,0.01,0.01,0.00,0.00,50000,1,500,0,0,0,0,0,0,50000,0,50000,50000
20200212,046089,南亞科兆豐92購01,,,,,0.00,0.00,0,0,0,0,0,0,0,0,0,0,0,0,0
20200212,04608P,晶相光永豐94售02,,,,,0.00,0.00,0,0,0,0,0,0,0,0,0,0,0,0,0
20200212,046090,冠德兆豐92購01,,,,,0.00,0.00,0,0,0,0,0,0,0,0,0,0,0,0,0
20200212,046091,健鼎兆豐92購01,0.01,0.01,0.01,0.01,0.00,0.00,10000,1,100,0,0,0,0,0,0,10000,0,10000,10000
20200212,046092,智伸科兆豐92購01,,,,,0.00,0.00,0,0,0,0,0,0,0,0,0,0,0,0,0
20200212,046093,啟碁兆豐92購01,,,,,0.00,0.00,0,0,0,0,0,0,0,0,0,0,0,0,0
20200212,046094,南茂兆豐92購01,,,,,0.00,0.00,0,0,0,0,0,0,0,0,0,0,0,0,0
20200212,046095,鴻海國票92購02,,,,,0.00,0.00,0,0,0,0,0,0,0,0,0,0,0,0,0
20200212,046096,建準國票92購01,,,,,0.00,0.00,0,0,0,0,0,0,0,0,0,0,0,0,0
20200212,046097,冠德國票92購02,,,,,0.00,0.00,0,0,0,0,0,0,0,0,0,0,0,0,0
20200212,046098,南茂國票92購01,,,,,0.00,0.00,0,0,0,0,0,0,0,0,0,0,0,0,0
20200212,046099,台積電永豐92購02,,,,,0.00,0.00,0,0,0,0,0,0,0,0,0,0,0,0,0
20200212,04609P,健策永豐94售01,,,,,0.00,0.00,0,0,0,0,0,0,0,0,0,0,0,0,0
20200212,046100,京元電永豐92購01,,,,,0.00,0.00,0,0,0,0,0,0,0,0,0,0,0,0,0
20200212,046101,大立光永豐92購04,,,,,0.00,0.00,0,0,0,0,0,0,0,0,0,0,0,0,0
20200212,046102,健鼎永豐92購01,0.03,0.03,0.03,0.03,0.00,0.00,3000,1,90,0,0,0,0,0,0,3000,0,3000,3000
20200212,046103,麗豐永豐92購01,,,,,0.00,0.00,0,0,0,0,0,0,0,0,0,0,0,0,0
20200212,046104,智伸科永豐92購02,,,,,0.00,0.00,0,0,0,0,0,0,0,0,0,0,0,0,0
20200212,046105,同欣電永豐92購02,,,,,0.00,0.00,0,0,0,0,0,0,0,0,0,0,0,0,0
20200212,046106,致新永豐92購01,,,,,0.00,0.00,0,0,0,0,0,0,0,0,0,0,0,0,0
20200212,046107,勤誠永豐92購01,,,,,0.00,0.00,0,0,0,0,0,0,0,0,0,0,0,0,0
20200212,046108,A50正2元大95購02,0.50,0.50,0.49,0.49,0.00,0.00,42000,4,20980,0,0,0,0,0,0,2000,40000,-38000,-38000
20200212,046109,遠東新元大92購01,,,,,0.00,0.00,0,0,0,0,0,0,0,0,0,0,0,0,0
20200212,04610P,世紀鋼永豐94售03,1.35,1.35,1.35,1.35,0.00,0.00,22000,1,29700,0,0,0,0,0,0,0,22000,-22000,-22000
20200212,046110,中環元大92購01,,,,,0.00,0.00,0,0,0,0,0,0,0,0,0,0,0,0,0
20200212,046111,台積電元大92購20,,,,,0.00,0.00,0,0,0,0,0,0,0,0,0,0,0,0,0
20200212,046112,台積電元大92購21,,,,,0.00,0.00,0,0,0,0,0,0,0,0,0,0,0,0,0
20200212,046113,旺宏元大93購04,3.10,3.10,3.04,3.04,+0.05,1.67,65000,3,200300,0,0,0,0,0,0,65000,0,65000,65000
20200212,046114,燿華元大92購04,,,,,0.00,0.00,0,0,0,0,0,0,0,0,0,0,0,0,0
20200212,046115,京元電元大92購04,,,,,0.00,0.00,0,0,0,0,0,0,0,0,0,0,0,0,0
20200212,046116,京元電元大92購05,0.36,0.39,0.35,0.36,+0.06,20.0,428000,4,165920,0,0,0,0,0,0,398000,30000,368000,368000
20200212,046117,強茂元大92購03,,,,,0.00,0.00,0,0,0,0,0,0,0,0,0,0,0,0,0
20200212,046118,高鐵元大92購01,,,,,0.00,0.00,0,0,0,0,0,0,0,0,0,0,0,0,0
20200212,046119,國泰金元大92購02,1.59,1.59,1.59,1.59,+0.23,16.91,10000,1,15900,0,0,0,0,0,0,0,10000,-10000,-10000
20200212,04611P,元油2X群益98售02,,,,,0.00,0.00,0,0,0,0,0,0,0,0,0,0,0,0,0
20200212,046120,大立光元大92購17,,,,,0.00,0.00,0,0,0,0,0,0,0,0,0,0,0,0,0
20200212,046121,大立光元大92購18,,,,,0.00,0.00,0,0,0,0,0,0,0,0,0,0,0,0,0
20200212,046122,晶技元大92購01,0.66,0.66,0.66,0.66,+0.04,6.45,77000,1,50820,0,0,0,0,0,0,77000,0,77000,77000
20200212,046123,嘉澤元大92購02,,,,,0.00,0.00,0,0,0,0,0,0,0,0,0,0,0,0,0
20200212,046124,健策元大92購04,6.65,7.00,6.60,7.00,+0.95,15.7,22000,6,147450,0,0,0,0,0,0,16000,6000,10000,10000
20200212,046125,致伸元大92購04,,,,,0.00,0.00,0,0,0,0,0,0,0,0,0,0,0,0,0
20200212,046126,致伸元大92購05,,,,,0.00,0.00,0,0,0,0,0,0,0,0,0,0,0,0,0
20200212,046127,臻鼎元大92購07,0.36,0.52,0.36,0.52,0.00,0.00,398000,3,177960,0,0,0,0,0,0,0,398000,-398000,-398000
20200212,046128,台表科元大92購02,,,,,0.00,0.00,0,0,0,0,0,0,0,0,0,0,0,0,0
20200212,046129,易華電元大92購02,,,,,0.00,0.00,0,0,0,0,0,0,0,0,0,0,0,0,0
20200212,04612P,上銀群益94售01,,,,,0.00,0.00,0,0,0,0,0,0,0,0,0,0,0,0,0
20200212,046130,緯穎元大92購03,,,,,0.00,0.00,0,0,0,0,0,0,0,0,0,0,0,0,0
20200212,046131,矽創元大92購03,,,,,0.00,0.00,0,0,0,0,0,0,0,0,0,0,0,0,0
20200212,046132,致新元大92購01,0.36,0.36,0.36,0.36,0.00,0.00,3000,1,1080,0,0,0,0,0,0,3000,0,3000,3000
20200212,046133,臺股指元大92購16,,,,,0.00,0.00,0,0,0,0,0,0,0,0,0,0,0,0,0
20200212,046134,致新國泰93購02,0.43,0.43,0.40,0.43,-0.01,-2.27,228000,24,96760,0,0,0,0,0,0,228000,0,228000,228000
20200212,046135,南亞科富邦92購01,0.95,0.95,0.95,0.95,0.00,0.00,1000,1,950,0,0,0,0,0,0,0,1000,-1000,-1000
20200212,046136,南茂富邦92購01,,,,,0.00,0.00,0,0,0,0,0,0,0,0,0,0,0,0,0
20200212,046137,遠東新統一92購01,0.51,0.51,0.51,0.51,-0.07,-12.07,2000,1,1020,0,0,0,0,0,0,2000,0,2000,2000
20200212,046138,鴻海統一92購07,,,,,0.00,0.00,0,0,0,0,0,0,0,0,0,0,0,0,0
20200212,046139,京元電統一92購04,,,,,0.00,0.00,0,0,0,0,0,0,0,0,0,0,0,0,0
20200212,04613P,台積電群益94售10,,,,,0.00,0.00,0,0,0,0,0,0,0,0,0,0,0,0,0
20200212,046140,景碩統一92購01,,,,,0.00,0.00,0,0,0,0,0,0,0,0,0,0,0,0,0
20200212,046141,康控統一92購02,,,,,0.00,0.00,0,0,0,0,0,0,0,0,0,0,0,0,0
20200212,046142,康舒統一93購01,,,,,0.00,0.00,0,0,0,0,0,0,0,0,0,0,0,0,0
20200212,046143,京元電元富92購01,,,,,0.00,0.00,0,0,0,0,0,0,0,0,0,0,0,0,0
20200212,046144,康控元富92購01,,,,,0.00,0.00,0,0,0,0,0,0,0,0,0,0,0,0,0
20200212,046145,矽力元富95購01,,,,,0.00,0.00,0,0,0,0,0,0,0,0,0,0,0,0,0
20200212,046146,南亞科第一92購01,,,,,0.00,0.00,0,0,0,0,0,0,0,0,0,0,0,0,0
20200212,046147,道瓊指中信96購02,0.86,0.86,0.85,0.85,0.00,0.00,22000,3,18870,0,0,0,0,0,0,0,22000,-22000,-22000
20200212,046148,友達中信94購01,,,,,0.00,0.00,0,0,0,0,0,0,0,0,0,0,0,0,0
20200212,046149,宏達電國票93購01,0.30,0.30,0.30,0.30,+0.03,11.11,60000,2,18000,0,0,0,0,0,0,60000,0,60000,60000
20200212,04614P,光罩群益94售02,0.48,0.48,0.44,0.44,-0.10,-18.52,161000,3,76880,0,0,0,0,0,0,11000,150000,-139000,-139000
20200212,046150,欣興國票92購02,,,,,0.00,0.00,0,0,0,0,0,0,0,0,0,0,0,0,0
20200212,046151,矽創國票92購02,,,,,0.00,0.00,0,0,0,0,0,0,0,0,0,0,0,0,0
20200212,046152,廣宇亞東92購01,,,,,0.00,0.00,0,0,0,0,0,0,0,0,0,0,0,0,0
20200212,046153,京元電亞東92購01,,,,,0.00,0.00,0,0,0,0,0,0,0,0,0,0,0,0,0
20200212,046154,道瓊指群益94購01,,,,,0.00,0.00,0,0,0,0,0,0,0,0,0,0,0,0,0
20200212,046155,道瓊反群益94購01,,,,,0.00,0.00,0,0,0,0,0,0,0,0,0,0,0,0,0
20200212,046156,光磊群益92購01,,,,,0.00,0.00,0,0,0,0,0,0,0,0,0,0,0,0,0
20200212,046157,美律群益92購05,,,,,0.00,0.00,0,0,0,0,0,0,0,0,0,0,0,0,0
20200212,046158,聯發科群益92購02,0.15,0.25,0.15,0.25,+0.14,127.27,50000,5,9500,0,0,0,0,0,0,50000,0,50000,50000
20200212,046159,群創群益98購04,2.09,2.09,2.09,2.09,+0.06,2.96,10000,1,20900,0,0,0,0,0,0,10000,0,10000,10000
20200212,04615P,華新科群益94售03,0.22,0.22,0.22,0.22,-0.05,-18.52,20000,1,4400,0,0,0,0,0,0,20000,0,20000,20000
20200212,046160,啟碁群益92購01,,,,,0.00,0.00,0,0,0,0,0,0,0,0,0,0,0,0,0
20200212,046161,易華電群益93購02,,,,,0.00,0.00,0,0,0,0,0,0,0,0,0,0,0,0,0
20200212,046162,致新群益92購01,,,,,0.00,0.00,0,0,0,0,0,0,0,0,0,0,0,0,0
20200212,046163,友達兆豐92購02,,,,,0.00,0.00,0,0,0,0,0,0,0,0,0,0,0,0,0
20200212,046164,健策兆豐93購03,,,,,0.00,0.00,0,0,0,0,0,0,0,0,0,0,0,0,0
20200212,046165,中磊兆豐93購01,,,,,0.00,0.00,0,0,0,0,0,0,0,0,0,0,0,0,0
20200212,046166,嘉聯益兆豐93購01,0.20,0.20,0.20,0.20,0.00,0.00,50000,2,10000,0,0,0,0,0,0,0,50000,-50000,-50000
20200212,046167,樺漢兆豐92購01,,,,,0.00,0.00,0,0,0,0,0,0,0,0,0,0,0,0,0
20200212,046168,國巨台新92購01,,,,,0.00,0.00,0,0,0,0,0,0,0,0,0,0,0,0,0
20200212,046169,大立光台新92購02,,,,,0.00,0.00,0,0,0,0,0,0,0,0,0,0,0,0,0
20200212,04616P,臺股指群益95售02,0.28,0.28,0.24,0.24,-0.06,-20.0,552000,9,137910,0,0,0,0,0,0,250000,302000,-52000,-52000
20200212,046170,力山永豐92購02,,,,,0.00,0.00,0,0,0,0,0,0,0,0,0,0,0,0,0
20200212,046171,中環永豐92購01,,,,,0.00,0.00,0,0,0,0,0,0,0,0,0,0,0,0,0
20200212,046172,美律永豐92購01,,,,,0.00,0.00,0,0,0,0,0,0,0,0,0,0,0,0,0
20200212,046173,聯發科永豐92購01,,,,,0.00,0.00,0,0,0,0,0,0,0,0,0,0,0,0,0
20200212,046174,高鐵永豐92購01,,,,,0.00,0.00,0,0,0,0,0,0,0,0,0,0,0,0,0
20200212,046175,瀚宇博永豐92購02,,,,,0.00,0.00,0,0,0,0,0,0,0,0,0,0,0,0,0
20200212,046176,GIS永豐92購01,,,,,0.00,0.00,0,0,0,0,0,0,0,0,0,0,0,0,0
20200212,046177,矽創永豐92購01,,,,,0.00,0.00,0,0,0,0,0,0,0,0,0,0,0,0,0
20200212,046178,聯發科日盛92購01,1.63,1.96,1.63,1.91,+0.53,38.41,39000,7,71420,0,0,0,0,0,0,39000,21000,18000,18000
20200212,046179,超眾日盛92購01,,,,,0.00,0.00,0,0,0,0,0,0,0,0,0,0,0,0,0
20200212,04617P,臺股指群益95售03,0.28,0.28,0.25,0.25,0.00,0.00,1330000,23,344700,0,0,0,0,0,0,20000,1310000,-1290000,-1290000
20200212,046180,裕隆凱基93購01,0.33,0.39,0.33,0.39,+0.06,18.18,111000,3,42680,0,0,0,0,0,0,10000,101000,-91000,-91000
20200212,046181,智邦凱基92購04,,,,,0.00,0.00,0,0,0,0,0,0,0,0,0,0,0,0,0
20200212,046182,燿華凱基93購04,0.98,1.17,0.98,1.17,+0.11,10.38,18000,2,18780,0,0,0,0,0,0,12000,6000,6000,6000
20200212,046183,瑞昱凱基92購02,,,,,0.00,0.00,0,0,0,0,0,0,0,0,0,0,0,0,0
20200212,046184,台光電凱基93購08,0.66,0.80,0.66,0.72,+0.22,44.0,93000,17,66360,0,0,0,0,0,0,0,93000,-93000,-93000
20200212,046185,正崴凱基93購02,2.26,2.26,2.25,2.25,0.00,0.00,6000,4,13540,0,0,0,0,0,0,6000,0,6000,6000
20200212,046186,南亞科凱基92購03,0.66,0.66,0.66,0.66,-0.10,-13.16,20000,1,13200,0,0,0,0,0,0,20000,0,20000,20000
20200212,046187,友達凱基93購03,,,,,0.00,0.00,0,0,0,0,0,0,0,0,0,0,0,0,0
20200212,046188,京元電凱基92購06,0.18,0.18,0.18,0.18,0.00,0.00,1000,1,180,0,0,0,0,0,0,1000,0,1000,1000
20200212,046189,聯發科凱基92購02,,,,,0.00,0.00,0,0,0,0,0,0,0,0,0,0,0,0,0
20200212,04618P,電子類群益94售02,,,,,0.00,0.00,0,0,0,0,0,0,0,0,0,0,0,0,0
20200212,046190,宏盛凱基92購01,,,,,0.00,0.00,0,0,0,0,0,0,0,0,0,0,0,0,0
20200212,046191,新光金凱基98購01,1.33,1.34,1.33,1.34,+0.03,2.29,188000,35,251420,0,0,0,0,0,0,154000,10000,144000,144000
20200212,046192,大立光凱基92購05,,,,,0.00,0.00,0,0,0,0,0,0,0,0,0,0,0,0,0
20200212,046193,大立光凱基92購06,3.03,3.03,3.03,3.03,0.00,0.00,10000,1,30300,0,0,0,0,0,0,0,10000,-10000,-10000
20200212,046194,禾伸堂凱基92購02,3.74,3.74,3.51,3.73,-0.26,-6.52,25000,4,91190,0,0,0,0,0,0,14000,11000,3000,3000
20200212,046195,聯詠凱基92購08,1.25,1.25,1.18,1.18,+0.07,6.31,40000,2,49300,0,0,0,0,0,0,30000,10000,20000,20000
20200212,046196,欣興凱基92購04,,,,,0.00,0.00,0,0,0,0,0,0,0,0,0,0,0,0,0
20200212,046197,日月光凱基92購04,1.86,2.15,1.86,2.15,+0.58,36.94,60000,6,118800,0,0,0,0,0,0,20000,40000,-20000,-20000
20200212,046198,正文凱基92購01,,,,,0.00,0.00,0,0,0,0,0,0,0,0,0,0,0,0,0
20200212,046199,致伸凱基92購05,,,,,0.00,0.00,0,0,0,0,0,0,0,0,0,0,0,0,0
20200212,04619P,華新統一94售02,1.55,1.55,1.52,1.52,-0.07,-4.4,3000,3,4620,0,0,0,0,0,0,0,3000,-3000,-3000
20200212,046200,上海銀凱基93購01,,,,,0.00,0.00,0,0,0,0,0,0,0,0,0,0,0,0,0
20200212,046201,台郡凱基92購01,1.18,1.30,1.18,1.30,+0.90,225.0,61000,3,72100,0,0,0,0,0,0,61000,0,61000,61000
20200212,046202,台表科凱基93購04,,,,,0.00,0.00,0,0,0,0,0,0,0,0,0,0,0,0,0
20200212,046203,GIS凱基93購02,,,,,0.00,0.00,0,0,0,0,0,0,0,0,0,0,0,0,0
20200212,046204,致新凱基93購01,0.29,0.30,0.28,0.30,+0.04,15.38,26000,10,7540,0,0,0,0,0,0,26000,0,26000,26000
20200212,046205,明基材凱基93購01,,,,,0.00,0.00,0,0,0,0,0,0,0,0,0,0,0,0,0
20200212,046206,為升國泰93購01,,,,,0.00,0.00,0,0,0,0,0,0,0,0,0,0,0,0,0
20200212,046207,群創國泰94購02,,,,,0.00,0.00,0,0,0,0,0,0,0,0,0,0,0,0,0
20200212,046208,滬深2X元富95購03,0.64,0.65,0.64,0.64,+0.02,3.23,103000,3,65930,0,0,0,0,0,0,0,103000,-103000,-103000
20200212,046209,全新元富92購01,0.80,1.11,0.80,1.11,+0.44,65.67,30000,3,28400,0,0,0,0,0,0,10000,20000,-10000,-10000
20200212,04620P,聯電統一94售04,,,,,0.00,0.00,0,0,0,0,0,0,0,0,0,0,0,0,0
20200212,046210,TPK元富92購01,,,,,0.00,0.00,0,0,0,0,0,0,0,0,0,0,0,0,0
20200212,046211,南電元富92購01,,,,,0.00,0.00,0,0,0,0,0,0,0,0,0,0,0,0,0
20200212,046212,台積電統一92購07,,,,,0.00,0.00,0,0,0,0,0,0,0,0,0,0,0,0,0
20200212,046213,可成統一92購06,2.95,2.95,2.95,2.95,0.00,0.00,10000,1,29500,0,0,0,0,0,0,0,10000,-10000,-10000
20200212,046214,潤泰全統一92購01,,,,,0.00,0.00,0,0,0,0,0,0,0,0,0,0,0,0,0
20200212,046215,大立光統一92購03,,,,,0.00,0.00,0,0,0,0,0,0,0,0,0,0,0,0,0
20200212,046216,滬深2X富邦93購02,,,,,0.00,0.00,0,0,0,0,0,0,0,0,0,0,0,0,0
20200212,046217,康友富邦94購01,,,,,0.00,0.00,0,0,0,0,0,0,0,0,0,0,0,0,0
20200212,046218,T50反1元大93購02,,,,,0.00,0.00,0,0,0,0,0,0,0,0,0,0,0,0,0
20200212,046219,T50反1元大93購03,,,,,0.00,0.00,0,0,0,0,0,0,0,0,0,0,0,0,0
20200212,04621P,楠梓電統一94售02,,,,,0.00,0.00,0,0,0,0,0,0,0,0,0,0,0,0,0
20200212,046220,滬深2X元大95購03,0.24,0.24,0.24,0.24,-0.02,-7.69,10000,1,2400,0,0,0,0,0,0,0,10000,-10000,-10000
20200212,046221,台化元大92購02,0.46,0.47,0.46,0.47,+0.03,6.82,250000,2,116500,0,0,0,0,0,0,250000,0,250000,250000
20200212,046222,上銀元大92購08,3.24,3.24,3.11,3.11,+0.05,1.63,50000,3,159400,0,0,0,0,0,0,50000,0,50000,50000
20200212,046223,華通元大92購04,4.05,5.20,4.03,5.20,+1.48,39.78,22000,5,90980,0,0,0,0,0,0,20000,2000,18000,18000
20200212,046224,中環元大92購02,,,,,0.00,0.00,0,0,0,0,0,0,0,0,0,0,0,0,0
20200212,046225,南亞科元大92購05,1.64,1.64,1.62,1.62,+0.05,3.18,51000,2,82640,0,0,0,0,0,0,1000,50000,-49000,-49000
20200212,046226,聯發科元大92購11,1.30,1.30,1.28,1.28,+0.21,19.63,20000,2,25800,0,0,0,0,0,0,20000,0,20000,20000
20200212,046227,聯發科元大92購12,0.39,0.39,0.39,0.39,0.00,0.00,10000,1,3900,0,0,0,0,0,0,0,10000,-10000,-10000
20200212,046228,神基元大92購01,,,,,0.00,0.00,0,0,0,0,0,0,0,0,0,0,0,0,0
20200212,046229,大立光元大92購19,,,,,0.00,0.00,0,0,0,0,0,0,0,0,0,0,0,0,0
20200212,04622P,臺股指統一94售01,,,,,0.00,0.00,0,0,0,0,0,0,0,0,0,0,0,0,0
20200212,046230,亞光元大92購03,,,,,0.00,0.00,0,0,0,0,0,0,0,0,0,0,0,0,0
20200212,046231,創意元大92購07,0.63,0.68,0.63,0.68,-0.13,-16.05,72000,4,48460,0,0,0,0,0,0,52000,62000,-10000,-10000
20200212,046232,智易元大93購05,,,,,0.00,0.00,0,0,0,0,0,0,0,0,0,0,0,0,0
20200212,046233,臻鼎元大92購08,0.44,0.44,0.44,0.44,0.00,0.00,249000,1,109560,0,0,0,0,0,0,0,249000,-249000,-249000
20200212,046234,彩晶元大92購01,,,,,0.00,0.00,0,0,0,0,0,0,0,0,0,0,0,0,0
20200212,046235,台表科元大92購03,2.10,2.10,2.10,2.10,+0.06,2.94,12000,1,25200,0,0,0,0,0,0,12000,0,12000,12000
20200212,046236,緯穎元大93購05,,,,,0.00,0.00,0,0,0,0,0,0,0,0,0,0,0,0,0
20200212,046237,南電元大92購02,,,,,0.00,0.00,0,0,0,0,0,0,0,0,0,0,0,0,0
20200212,046238,嘉澤第一92購01,,,,,0.00,0.00,0,0,0,0,0,0,0,0,0,0,0,0,0
20200212,046239,中石化中信92購02,,,,,0.00,0.00,0,0,0,0,0,0,0,0,0,0,0,0,0
20200212,04623P,台積電元大94售13,,,,,0.00,0.00,0,0,0,0,0,0,0,0,0,0,0,0,0
20200212,046240,中鋼中信94購01,1.01,1.04,1.01,1.04,-0.02,-1.89,98000,13,100280,0,0,0,0,0,0,50000,48000,2000,2000
20200212,046241,聯發科中信94購02,0.35,0.40,0.35,0.40,+0.09,29.03,380000,10,136110,0,0,0,0,0,0,370000,10000,360000,360000
20200212,046242,大立光中信93購02,3.86,3.86,3.86,3.86,+0.08,2.12,20000,2,77200,0,0,0,0,0,0,0,20000,-20000,-20000
20200212,046243,麗豐中信92購01,,,,,0.00,0.00,0,0,0,0,0,0,0,0,0,0,0,0,0
20200212,046244,大成鋼亞東93購01,,,,,0.00,0.00,0,0,0,0,0,0,0,0,0,0,0,0,0
20200212,046245,奇力新亞東93購01,,,,,0.00,0.00,0,0,0,0,0,0,0,0,0,0,0,0,0
20200212,046246,嘉聯益亞東93購01,,,,,0.00,0.00,0,0,0,0,0,0,0,0,0,0,0,0,0
20200212,046247,南電亞東93購02,,,,,0.00,0.00,0,0,0,0,0,0,0,0,0,0,0,0,0
20200212,046248,技嘉群益93購02,0.59,0.64,0.52,0.58,-0.01,-1.69,495000,22,297440,0,0,0,0,0,0,98000,397000,-299000,-299000
20200212,046249,聯發科群益92購03,,,,,0.00,0.00,0,0,0,0,0,0,0,0,0,0,0,0,0
20200212,04624P,台積電元大94售14,,,,,0.00,0.00,0,0,0,0,0,0,0,0,0,0,0,0,0
20200212,046250,全新群益92購04,,,,,0.00,0.00,0,0,0,0,0,0,0,0,0,0,0,0,0
20200212,046251,宏達電群益92購03,,,,,0.00,0.00,0,0,0,0,0,0,0,0,0,0,0,0,0
20200212,046252,冠德群益92購01,,,,,0.00,0.00,0,0,0,0,0,0,0,0,0,0,0,0,0
20200212,046253,聯茂群益92購03,,,,,0.00,0.00,0,0,0,0,0,0,0,0,0,0,0,0,0
20200212,046254,台表科群益92購02,,,,,0.00,0.00,0,0,0,0,0,0,0,0,0,0,0,0,0
20200212,046255,GIS群益92購02,,,,,0.00,0.00,0,0,0,0,0,0,0,0,0,0,0,0,0
20200212,046256,緯穎群益92購04,,,,,0.00,0.00,0,0,0,0,0,0,0,0,0,0,0,0,0
20200212,046257,A50正2國票94購01,0.26,0.27,0.25,0.27,0.00,0.00,35000,5,9100,0,0,0,0,0,0,32000,3000,29000,29000
20200212,046258,華通國票92購02,,,,,0.00,0.00,0,0,0,0,0,0,0,0,0,0,0,0,0
20200212,046259,和大凱基92購02,1.27,1.27,1.27,1.27,0.00,0.00,3000,2,3810,0,0,0,0,0,0,0,3000,-3000,-3000
20200212,04625P,燿華元大94售03,1.19,1.19,1.18,1.18,0.00,0.00,50000,2,59200,0,0,0,0,0,0,0,50000,-50000,-50000
20200212,046260,大成鋼凱基92購01,,,,,0.00,0.00,0,0,0,0,0,0,0,0,0,0,0,0,0
20200212,046261,中環凱基93購01,,,,,0.00,0.00,0,0,0,0,0,0,0,0,0,0,0,0,0
20200212,046262,國巨凱基92購05,,,,,0.00,0.00,0,0,0,0,0,0,0,0,0,0,0,0,0
20200212,046263,智邦凱基92購05,0.41,0.41,0.32,0.32,0.00,0.00,17000,3,6480,0,0,0,0,0,0,17000,0,17000,17000
20200212,046264,美律凱基93購05,0.68,0.73,0.66,0.72,0.00,0.00,97000,10,68330,0,0,0,0,0,0,62000,92000,-30000,-30000
20200212,046265,高鐵凱基92購03,,,,,0.00,0.00,0,0,0,0,0,0,0,0,0,0,0,0,0
20200212,046266,兆豐金凱基92購01,,,,,0.00,0.00,0,0,0,0,0,0,0,0,0,0,0,0,0
20200212,046267,大立光凱基92購09,,,,,0.00,0.00,0,0,0,0,0,0,0,0,0,0,0,0,0
20200212,046268,嘉晶凱基93購02,0.62,0.65,0.62,0.65,0.00,0.00,156000,4,97050,0,0,0,0,0,0,0,156000,-156000,-156000
20200212,046269,禾伸堂凱基92購03,4.86,4.86,4.67,4.86,+0.08,1.67,47000,8,225430,0,0,0,0,0,0,35000,12000,23000,23000
20200212,04626P,聯發科元大94售07,1.01,1.01,0.99,1.00,-0.27,-21.26,112000,4,111100,0,0,0,0,0,0,0,112000,-112000,-112000
20200212,046270,智易凱基92購02,,,,,0.00,0.00,0,0,0,0,0,0,0,0,0,0,0,0,0
20200212,046271,日月光凱基92購05,,,,,0.00,0.00,0,0,0,0,0,0,0,0,0,0,0,0,0
20200212,046272,致伸凱基92購06,,,,,0.00,0.00,0,0,0,0,0,0,0,0,0,0,0,0,0
20200212,046273,和碩凱基92購02,,,,,0.00,0.00,0,0,0,0,0,0,0,0,0,0,0,0,0
20200212,046274,鎧勝凱基92購01,,,,,0.00,0.00,0,0,0,0,0,0,0,0,0,0,0,0,0
20200212,046275,台表科凱基94購01,2.41,2.65,2.41,2.62,+0.34,14.91,47000,9,121110,0,0,0,0,0,0,22000,37000,-15000,-15000
20200212,046276,台積電台新92購03,,,,,0.00,0.00,0,0,0,0,0,0,0,0,0,0,0,0,0
20200212,046277,可成台新92購01,,,,,0.00,0.00,0,0,0,0,0,0,0,0,0,0,0,0,0
20200212,046278,緯創台新92購01,,,,,0.00,0.00,0,0,0,0,0,0,0,0,0,0,0,0,0
20200212,046279,群創康和92購02,,,,,0.00,0.00,0,0,0,0,0,0,0,0,0,0,0,0,0
20200212,04627P,聯發科元大94售08,,,,,0.00,0.00,0,0,0,0,0,0,0,0,0,0,0,0,0
20200212,046280,國巨永豐92購03,,,,,0.00,0.00,0,0,0,0,0,0,0,0,0,0,0,0,0
20200212,046281,正崴永豐92購01,,,,,0.00,0.00,0,0,0,0,0,0,0,0,0,0,0,0,0
20200212,046282,全新永豐92購01,,,,,0.00,0.00,0,0,0,0,0,0,0,0,0,0,0,0,0
20200212,046283,TPK永豐92購01,,,,,0.00,0.00,0,0,0,0,0,0,0,0,0,0,0,0,0
20200212,046284,世紀鋼永豐92購01,,,,,0.00,0.00,0,0,0,0,0,0,0,0,0,0,0,0,0
20200212,046285,國巨兆豐93購01,,,,,0.00,0.00,0,0,0,0,0,0,0,0,0,0,0,0,0
20200212,046286,高鐵兆豐93購01,,,,,0.00,0.00,0,0,0,0,0,0,0,0,0,0,0,0,0
20200212,046287,禾伸堂兆豐92購01,2.46,2.46,2.42,2.42,-0.05,-2.02,20000,2,48800,0,0,0,0,0,0,10000,10000,0,0
20200212,046288,創意兆豐92購03,,,,,0.00,0.00,0,0,0,0,0,0,0,0,0,0,0,0,0
20200212,046289,群創兆豐92購03,,,,,0.00,0.00,0,0,0,0,0,0,0,0,0,0,0,0,0
20200212,04628P,欣興元大95售01,1.92,1.92,1.92,1.92,-0.44,-18.64,1000,1,1920,0,0,0,0,0,0,0,1000,-1000,-1000
20200212,046290,儒鴻統一93購01,0.44,0.46,0.41,0.46,-0.02,-4.17,323000,14,141070,0,0,0,0,0,0,193000,116000,77000,77000
20200212,046291,友達統一94購01,2.80,2.80,2.80,2.80,-0.12,-4.11,10000,1,28000,0,0,0,0,0,0,0,10000,-10000,-10000
20200212,046292,聯發科統一92購02,1.93,2.23,1.93,2.23,+0.57,34.34,30000,3,63200,0,0,0,0,0,0,10000,20000,-10000,-10000
20200212,046293,聯發科統一94購01,1.17,1.41,1.17,1.41,+0.41,41.0,749000,45,988640,0,0,0,0,0,0,577000,600000,-23000,-23000
20200212,046294,台勝科統一92購01,,,,,0.00,0.00,0,0,0,0,0,0,0,0,0,0,0,0,0
20200212,046295,超眾統一92購01,,,,,0.00,0.00,0,0,0,0,0,0,0,0,0,0,0,0,0
20200212,046296,上銀元富92購01,,,,,0.00,0.00,0,0,0,0,0,0,0,0,0,0,0,0,0
20200212,046297,國巨元富92購01,,,,,0.00,0.00,0,0,0,0,0,0,0,0,0,0,0,0,0
20200212,046298,聯發科富邦94購01,0.80,0.91,0.79,0.89,+0.19,27.14,620000,26,521390,0,0,0,0,0,0,541000,69000,472000,472000
20200212,046299,大立光富邦93購04,2.07,2.09,2.07,2.09,+0.13,6.63,30000,3,62400,0,0,0,0,0,0,0,30000,-30000,-30000
20200212,04629P,康控元大94售05,1.05,1.05,0.98,0.99,-0.11,-10.0,154000,7,154930,0,0,0,0,0,0,104000,50000,54000,54000
20200212,046300,嘉聯益富邦94購01,0.63,0.67,0.62,0.64,+0.04,6.67,17000,7,10860,0,0,0,0,0,0,16000,1000,15000,15000
20200212,046301,亞泥元大92購02,,,,,0.00,0.00,0,0,0,0,0,0,0,0,0,0,0,0,0
20200212,046302,亞德客元大92購02,5.20,5.50,5.20,5.50,+0.20,3.77,12000,2,63000,0,0,0,0,0,0,12000,0,12000,12000
20200212,046303,台積電元大92購25,6.05,6.10,6.05,6.10,+0.20,3.39,50000,3,304500,0,0,0,0,0,0,30000,20000,10000,10000
20200212,046304,台積電元大92購26,,,,,0.00,0.00,0,0,0,0,0,0,0,0,0,0,0,0,0
20200212,046305,台積電元大92購27,10.10,10.30,10.10,10.30,0.00,0.00,16000,2,163200,0,0,0,0,0,0,0,16000,-16000,-16000
20200212,046306,瑞昱元大92購02,2.17,2.17,2.17,2.17,0.00,0.00,10000,1,21700,0,0,0,0,0,0,0,10000,-10000,-10000
20200212,046307,瑞昱元大92購03,,,,,0.00,0.00,0,0,0,0,0,0,0,0,0,0,0,0,0
20200212,046308,廣達元大92購02,2.84,2.93,2.84,2.93,-0.05,-1.68,20000,2,57700,0,0,0,0,0,0,20000,0,20000,20000
20200212,046309,聯發科元大92購14,,,,,0.00,0.00,0,0,0,0,0,0,0,0,0,0,0,0,0
20200212,04630P,嘉聯益元大95售02,0.94,0.95,0.94,0.95,-0.03,-3.06,208000,4,196020,0,0,0,0,0,0,155000,53000,102000,102000
20200212,046310,聯發科元大92購15,0.58,0.71,0.58,0.71,+0.25,54.35,11000,2,6510,0,0,0,0,0,0,10000,1000,9000,9000
20200212,046311,聯發科元大92購16,,,,,0.00,0.00,0,0,0,0,0,0,0,0,0,0,0,0,0
20200212,046312,可成元大92購10,1.03,1.24,1.03,1.24,0.00,0.00,21000,3,22840,0,0,0,0,0,0,10000,11000,-1000,-1000
20200212,046313,華新科元大92購11,,,,,0.00,0.00,0,0,0,0,0,0,0,0,0,0,0,0,0
20200212,046314,宏達電元大92購05,0.40,0.40,0.37,0.37,-0.02,-5.13,200000,3,76100,0,0,0,0,0,0,100000,100000,0,0
20200212,046315,淘帝元大92購01,,,,,0.00,0.00,0,0,0,0,0,0,0,0,0,0,0,0,0
20200212,046316,大立光元大92購20,,,,,0.00,0.00,0,0,0,0,0,0,0,0,0,0,0,0,0
20200212,046317,亞光元大92購04,0.56,0.71,0.56,0.71,+0.16,29.09,165000,8,98800,0,0,0,0,0,0,150000,15000,135000,135000
20200212,046318,聯詠元大92購04,1.55,1.79,1.55,1.79,+0.37,26.06,30000,4,50100,0,0,0,0,0,0,20000,10000,10000,10000
20200212,046319,新日興元大92購03,1.02,1.07,0.88,0.88,-0.29,-24.79,28000,6,26990,0,0,0,0,0,0,28000,0,28000,28000
20200212,04631P,臺股指中信95售08,,,,,0.00,0.00,0,0,0,0,0,0,0,0,0,0,0,0,0
20200212,046320,明泰元大92購02,0.10,0.10,0.10,0.10,0.00,0.00,50000,1,5000,0,0,0,0,0,0,50000,0,50000,50000
20200212,046321,群創元大92購07,,,,,0.00,0.00,0,0,0,0,0,0,0,0,0,0,0,0,0
20200212,046322,群創元大92購08,,,,,0.00,0.00,0,0,0,0,0,0,0,0,0,0,0,0,0
20200212,046323,群創元大92購09,,,,,0.00,0.00,0,0,0,0,0,0,0,0,0,0,0,0,0
20200212,046324,健策元大92購05,4.84,5.60,4.84,5.60,+1.28,29.63,22000,6,108830,0,0,0,0,0,0,17000,5000,12000,12000
20200212,046325,日月光元大92購03,2.28,2.38,2.28,2.38,0.00,0.00,20000,2,46600,0,0,0,0,0,0,0,20000,-20000,-20000
20200212,046326,智伸科元大92購03,,,,,0.00,0.00,0,0,0,0,0,0,0,0,0,0,0,0,0
20200212,046327,康控元大92購01,,,,,0.00,0.00,0,0,0,0,0,0,0,0,0,0,0,0,0
20200212,046328,臻鼎元大92購09,0.90,0.96,0.61,0.61,+0.17,38.64,304000,5,204660,0,0,0,0,0,0,3000,301000,-298000,-298000
20200212,046329,臻鼎元大92購10,,,,,0.00,0.00,0,0,0,0,0,0,0,0,0,0,0,0,0
20200212,04632P,台積電群益94售11,,,,,0.00,0.00,0,0,0,0,0,0,0,0,0,0,0,0,0
20200212,046330,祥碩元大92購02,,,,,0.00,0.00,0,0,0,0,0,0,0,0,0,0,0,0,0
20200212,046331,聯茂元大92購09,,,,,0.00,0.00,0,0,0,0,0,0,0,0,0,0,0,0,0
20200212,046332,同欣電元大92購01,0.70,0.75,0.70,0.75,+0.08,11.94,110000,6,81600,0,0,0,0,0,0,100000,10000,90000,90000
20200212,046333,康友元大92購05,0.97,0.97,0.88,0.88,0.00,0.00,78000,2,73140,0,0,0,0,0,0,0,78000,-78000,-78000
20200212,046334,緯穎元大92購05,,,,,0.00,0.00,0,0,0,0,0,0,0,0,0,0,0,0,0
20200212,046335,矽創元大92購04,0.12,0.12,0.12,0.12,+0.04,50.0,40000,3,4800,0,0,0,0,0,0,40000,0,40000,40000
20200212,046336,致新元大92購02,,,,,0.00,0.00,0,0,0,0,0,0,0,0,0,0,0,0,0
20200212,046337,智原第一92購01,,,,,0.00,0.00,0,0,0,0,0,0,0,0,0,0,0,0,0
20200212,046338,致伸中信92購01,,,,,0.00,0.00,0,0,0,0,0,0,0,0,0,0,0,0,0
20200212,046339,訊芯中信92購01,1.46,1.67,1.46,1.67,+0.25,17.61,40000,3,62200,0,0,0,0,0,0,20000,20000,0,0
20200212,04633P,旺宏群益96售04,,,,,0.00,0.00,0,0,0,0,0,0,0,0,0,0,0,0,0
20200212,046340,滬深2X國票96購01,,,,,0.00,0.00,0,0,0,0,0,0,0,0,0,0,0,0,0
20200212,046341,A50正2國票93購01,,,,,0.00,0.00,0,0,0,0,0,0,0,0,0,0,0,0,0
20200212,046342,聯發科國票92購02,,,,,0.00,0.00,0,0,0,0,0,0,0,0,0,0,0,0,0
20200212,046343,和鑫國票93購02,,,,,0.00,0.00,0,0,0,0,0,0,0,0,0,0,0,0,0
20200212,046344,超眾國票94購01,0.53,0.60,0.53,0.60,+0.04,7.14,197000,11,109750,0,0,0,0,0,0,147000,87000,60000,60000
20200212,046345,世紀鋼國票93購01,,,,,0.00,0.00,0,0,0,0,0,0,0,0,0,0,0,0,0
20200212,046346,旺宏兆豐92購02,,,,,0.00,0.00,0,0,0,0,0,0,0,0,0,0,0,0,0
20200212,046347,奇力新兆豐93購02,,,,,0.00,0.00,0,0,0,0,0,0,0,0,0,0,0,0,0
20200212,046348,嘉澤兆豐93購01,,,,,0.00,0.00,0,0,0,0,0,0,0,0,0,0,0,0,0
20200212,046349,康控兆豐93購02,0.16,0.18,0.16,0.18,0.00,0.00,104000,2,17720,0,0,0,0,0,0,50000,54000,-4000,-4000
20200212,04634P,臺股指群益94售09,0.25,0.26,0.23,0.23,0.00,0.00,542000,6,140190,0,0,0,0,0,0,0,542000,-542000,-542000
20200212,046350,上銀群益92購02,,,,,0.00,0.00,0,0,0,0,0,0,0,0,0,0,0,0,0
20200212,046351,智邦群益92購01,1.71,1.71,1.71,1.71,+0.18,11.76,1000,1,1710,0,0,0,0,0,0,1000,0,1000,1000
20200212,046352,智邦群益92購02,,,,,0.00,0.00,0,0,0,0,0,0,0,0,0,0,0,0,0
20200212,046353,聯發科群益92購04,1.11,1.11,1.11,1.11,0.00,0.00,1000,1,1110,0,0,0,0,0,0,1000,0,1000,1000
20200212,046354,聯詠群益92購02,,,,,0.00,0.00,0,0,0,0,0,0,0,0,0,0,0,0,0
20200212,046355,欣興群益92購03,,,,,0.00,0.00,0,0,0,0,0,0,0,0,0,0,0,0,0
20200212,046356,智伸科群益93購01,1.65,1.66,1.65,1.66,0.00,0.00,50000,4,82600,0,0,0,0,0,0,30000,20000,10000,10000
20200212,046357,聯發科台新92購01,0.32,0.32,0.32,0.32,0.00,0.00,9000,2,2880,0,0,0,0,0,0,9000,0,9000,9000
20200212,046358,義隆台新92購01,,,,,0.00,0.00,0,0,0,0,0,0,0,0,0,0,0,0,0
20200212,046359,宏達電台新92購01,,,,,0.00,0.00,0,0,0,0,0,0,0,0,0,0,0,0,0
20200212,04635P,臺股指群益94售10,,,,,0.00,0.00,0,0,0,0,0,0,0,0,0,0,0,0,0
20200212,046360,儒鴻永豐92購01,,,,,0.00,0.00,0,0,0,0,0,0,0,0,0,0,0,0,0
20200212,046361,東元永豐92購01,,,,,0.00,0.00,0,0,0,0,0,0,0,0,0,0,0,0,0
20200212,046362,華通永豐92購02,1.08,2.12,0.99,2.04,+0.99,94.29,324000,36,431730,0,0,0,0,0,0,214000,110000,104000,104000
20200212,046363,華泰永豐92購01,,,,,0.00,0.00,0,0,0,0,0,0,0,0,0,0,0,0,0
20200212,046364,淘帝永豐92購01,,,,,0.00,0.00,0,0,0,0,0,0,0,0,0,0,0,0,0
20200212,046365,禾伸堂永豐92購02,,,,,0.00,0.00,0,0,0,0,0,0,0,0,0,0,0,0,0
20200212,046366,上緯控永豐92購02,,,,,0.00,0.00,0,0,0,0,0,0,0,0,0,0,0,0,0
20200212,046367,康普永豐92購01,,,,,0.00,0.00,0,0,0,0,0,0,0,0,0,0,0,0,0
20200212,046368,嘉聯益永豐92購04,,,,,0.00,0.00,0,0,0,0,0,0,0,0,0,0,0,0,0
20200212,046369,同欣電日盛92購01,0.95,1.20,0.95,1.20,+0.26,27.66,494000,31,516920,0,0,0,0,0,0,400000,94000,306000,306000
20200212,04636P,臺股指群益94售11,0.30,0.30,0.30,0.30,0.00,0.00,2000,1,600,0,0,0,0,0,0,0,2000,-2000,-2000
20200212,046370,全新麥證93購01,1.06,1.27,1.06,1.27,+0.40,45.98,214000,18,258490,0,214000,-214000,0,0,0,0,214000,-214000,-214000
20200212,046371,儒鴻凱基92購03,,,,,0.00,0.00,0,0,0,0,0,0,0,0,0,0,0,0,0
20200212,046372,東元凱基92購01,,,,,0.00,0.00,0,0,0,0,0,0,0,0,0,0,0,0,0
20200212,046373,國巨凱基92購06,,,,,0.00,0.00,0,0,0,0,0,0,0,0,0,0,0,0,0
20200212,046374,台積電凱基92購20,8.40,8.40,8.40,8.40,+1.30,18.31,10000,1,84000,0,0,0,0,0,0,0,10000,-10000,-10000
20200212,046375,友達凱基98購01,,,,,0.00,0.00,0,0,0,0,0,0,0,0,0,0,0,0,0
20200212,046376,建準凱基92購01,,,,,0.00,0.00,0,0,0,0,0,0,0,0,0,0,0,0,0
20200212,046377,聯發科凱基92購03,2.60,2.89,2.57,2.89,+0.74,34.42,40000,3,106300,0,0,0,0,0,0,30000,10000,20000,20000
20200212,046378,聯發科凱基92購04,,,,,0.00,0.00,0,0,0,0,0,0,0,0,0,0,0,0,0
20200212,046379,奇力新凱基93購03,7.60,7.60,7.60,7.60,-0.15,-1.94,45000,17,342000,0,0,0,0,0,0,45000,0,45000,45000
20200212,04637P,臺股指群益94售12,,,,,0.00,0.00,0,0,0,0,0,0,0,0,0,0,0,0,0
20200212,046380,神基凱基93購01,0.39,0.39,0.39,0.39,0.00,0.00,165000,1,64350,0,0,0,0,0,0,0,165000,-165000,-165000
20200212,046381,緯創凱基93購03,,,,,0.00,0.00,0,0,0,0,0,0,0,0,0,0,0,0,0
20200212,046382,明泰凱基93購01,,,,,0.00,0.00,0,0,0,0,0,0,0,0,0,0,0,0,0
20200212,046383,群創凱基98購01,,,,,0.00,0.00,0,0,0,0,0,0,0,0,0,0,0,0,0
20200212,046384,群創凱基98購02,,,,,0.00,0.00,0,0,0,0,0,0,0,0,0,0,0,0,0
20200212,046385,群創凱基98購03,,,,,0.00,0.00,0,0,0,0,0,0,0,0,0,0,0,0,0
20200212,046386,揚明光凱基92購04,,,,,0.00,0.00,0,0,0,0,0,0,0,0,0,0,0,0,0
20200212,046387,臻鼎凱基92購04,0.62,0.62,0.62,0.62,0.00,0.00,10000,1,6200,0,0,0,0,0,0,0,10000,-10000,-10000
20200212,046388,GIS凱基92購02,,,,,0.00,0.00,0,0,0,0,0,0,0,0,0,0,0,0,0
20200212,046389,百和凱基93購04,,,,,0.00,0.00,0,0,0,0,0,0,0,0,0,0,0,0,0
20200212,04638P,臺股指群益94售13,0.34,0.34,0.34,0.34,0.00,0.00,30000,1,10200,0,0,0,0,0,0,0,30000,-30000,-30000
20200212,046390,旺宏統一94購02,,,,,0.00,0.00,0,0,0,0,0,0,0,0,0,0,0,0,0
20200212,046391,上海銀統一94購01,2.37,2.42,2.37,2.42,+0.01,0.41,11000,2,26120,0,0,0,0,0,0,11000,0,11000,11000
20200212,046392,國巨元富92購02,,,,,0.00,0.00,0,0,0,0,0,0,0,0,0,0,0,0,0
20200212,046393,瀚宇博元富92購01,,,,,0.00,0.00,0,0,0,0,0,0,0,0,0,0,0,0,0
20200212,046394,台表科元富92購02,,,,,0.00,0.00,0,0,0,0,0,0,0,0,0,0,0,0,0
20200212,046395,友達國泰93購04,,,,,0.00,0.00,0,0,0,0,0,0,0,0,0,0,0,0,0
20200212,046396,矽創國泰93購01,0.55,0.75,0.54,0.75,+0.20,36.36,123000,27,83370,0,0,0,0,0,0,15000,108000,-93000,-93000
20200212,046397,力山富邦94購01,,,,,0.00,0.00,0,0,0,0,0,0,0,0,0,0,0,0,0
20200212,046398,群創富邦93購01,,,,,0.00,0.00,0,0,0,0,0,0,0,0,0,0,0,0,0
20200212,046399,力山元大92購06,,,,,0.00,0.00,0,0,0,0,0,0,0,0,0,0,0,0,0
20200212,04639P,臺股指群益94售14,2.52,2.52,2.10,2.17,-0.52,-19.33,296000,40,674520,0,0,0,0,0,0,28000,268000,-240000,-240000
20200212,046400,國巨元大92購17,,,,,0.00,0.00,0,0,0,0,0,0,0,0,0,0,0,0,0
20200212,046401,華泰元大92購02,,,,,0.00,0.00,0,0,0,0,0,0,0,0,0,0,0,0,0
20200212,046402,華泰元大92購03,,,,,0.00,0.00,0,0,0,0,0,0,0,0,0,0,0,0,0
20200212,046403,技嘉元大92購01,0.67,0.72,0.58,0.63,+0.02,3.28,104000,10,68120,0,0,0,0,0,0,70000,34000,36000,36000
20200212,046404,友達元大93購02,2.35,2.35,2.35,2.35,0.00,0.00,20000,2,47000,0,0,0,0,0,0,0,20000,-20000,-20000
20200212,046405,京元電元大92購07,,,,,0.00,0.00,0,0,0,0,0,0,0,0,0,0,0,0,0
20200212,046406,奇力新元大92購03,,,,,0.00,0.00,0,0,0,0,0,0,0,0,0,0,0,0,0
20200212,046407,華新科元大93購07,,,,,0.00,0.00,0,0,0,0,0,0,0,0,0,0,0,0,0
20200212,046408,宏達電元大92購06,,,,,0.00,0.00,0,0,0,0,0,0,0,0,0,0,0,0,0
20200212,046409,富邦金元大92購02,1.56,1.67,1.56,1.67,+0.38,29.46,22000,5,35350,0,0,0,0,0,0,9000,10000,-1000,-1000
20200212,04640P,上銀凱基94售05,,,,,0.00,0.00,0,0,0,0,0,0,0,0,0,0,0,0,0
20200212,046410,國泰金元大92購03,0.23,0.23,0.23,0.23,0.00,0.00,1000,1,230,0,0,0,0,0,0,1000,0,1000,1000
20200212,046411,新光金元大92購01,1.14,1.14,1.14,1.14,+0.03,2.7,1000,1,1140,0,0,0,0,0,0,1000,0,1000,1000
20200212,046412,潤泰全元大92購02,,,,,0.00,0.00,0,0,0,0,0,0,0,0,0,0,0,0,0
20200212,046413,大立光元大92購22,,,,,0.00,0.00,0,0,0,0,0,0,0,0,0,0,0,0,0
20200212,046414,大立光元大92購23,,,,,0.00,0.00,0,0,0,0,0,0,0,0,0,0,0,0,0
20200212,046415,嘉晶元大92購03,,,,,0.00,0.00,0,0,0,0,0,0,0,0,0,0,0,0,0
20200212,046416,聯詠元大92購05,1.52,1.52,1.52,1.52,+0.23,17.83,20000,3,30400,0,0,0,0,0,0,20000,0,20000,20000
20200212,046417,聯詠元大92購06,3.44,3.65,3.44,3.65,+0.37,11.28,25000,3,87950,0,0,0,0,0,0,25000,0,25000,25000
20200212,046418,智原元大92購02,,,,,0.00,0.00,0,0,0,0,0,0,0,0,0,0,0,0,0
20200212,046419,聯鈞元大92購01,0.80,0.80,0.80,0.80,0.00,0.00,1000,1,800,0,0,0,0,0,0,0,1000,-1000,-1000
20200212,04641P,台積電凱基94售19,,,,,0.00,0.00,0,0,0,0,0,0,0,0,0,0,0,0,0
20200212,046420,群創元大92購10,,,,,0.00,0.00,0,0,0,0,0,0,0,0,0,0,0,0,0
20200212,046421,群創元大92購11,,,,,0.00,0.00,0,0,0,0,0,0,0,0,0,0,0,0,0
20200212,046422,健策元大92購06,2.54,2.72,2.54,2.72,+0.40,17.24,23000,6,59970,0,0,0,0,0,0,7000,16000,-9000,-9000
20200212,046423,元翎元大92購01,,,,,0.00,0.00,0,0,0,0,0,0,0,0,0,0,0,0,0
20200212,046424,正文元大92購04,,,,,0.00,0.00,0,0,0,0,0,0,0,0,0,0,0,0,0
20200212,046425,臻鼎元大92購12,0.49,0.49,0.49,0.49,0.00,0.00,80000,1,39200,0,0,0,0,0,0,0,80000,-80000,-80000
20200212,046426,臻鼎元大92購13,0.98,1.05,0.98,1.05,+0.46,77.97,18000,6,17860,0,0,0,0,0,0,13000,5000,8000,8000
20200212,046427,樺漢元大92購02,,,,,0.00,0.00,0,0,0,0,0,0,0,0,0,0,0,0,0
20200212,046428,矽力元大92購02,4.67,5.10,4.38,5.10,+0.79,18.33,109000,13,499800,0,0,0,0,0,0,77000,99000,-22000,-22000
20200212,046429,矽力元大92購03,,,,,0.00,0.00,0,0,0,0,0,0,0,0,0,0,0,0,0
20200212,04642P,台積電凱基94售20,,,,,0.00,0.00,0,0,0,0,0,0,0,0,0,0,0,0,0
20200212,046430,奇鋐國票92購02,,,,,0.00,0.00,0,0,0,0,0,0,0,0,0,0,0,0,0
20200212,046431,中環第一92購01,0.01,0.01,0.01,0.01,0.00,0.00,50000,1,500,0,0,0,0,0,0,50000,0,50000,50000
20200212,046432,宏達電中信94購01,,,,,0.00,0.00,0,0,0,0,0,0,0,0,0,0,0,0,0
20200212,046433,康友中信92購01,2.64,2.68,2.64,2.68,+0.03,1.13,40000,4,106100,0,0,0,0,0,0,20000,20000,0,0
20200212,046434,國巨群益93購03,,,,,0.00,0.00,0,0,0,0,0,0,0,0,0,0,0,0,0
20200212,046435,聯發科群益92購06,,,,,0.00,0.00,0,0,0,0,0,0,0,0,0,0,0,0,0
20200212,046436,新光金群益92購02,,,,,0.00,0.00,0,0,0,0,0,0,0,0,0,0,0,0,0
20200212,046437,大立光群益93購05,,,,,0.00,0.00,0,0,0,0,0,0,0,0,0,0,0,0,0
20200212,046438,群創群益95購01,,,,,0.00,0.00,0,0,0,0,0,0,0,0,0,0,0,0,0
20200212,046439,嘉聯益群益92購01,,,,,0.00,0.00,0,0,0,0,0,0,0,0,0,0,0,0,0
20200212,04643P,京元電凱基94售02,,,,,0.00,0.00,0,0,0,0,0,0,0,0,0,0,0,0,0
20200212,046440,義隆亞東93購01,0.80,0.80,0.80,0.80,0.00,0.00,5000,1,4000,0,0,0,0,0,0,0,5000,-5000,-5000
20200212,046441,儒鴻兆豐92購01,,,,,0.00,0.00,0,0,0,0,0,0,0,0,0,0,0,0,0
20200212,046442,聯茂兆豐93購03,0.16,0.16,0.16,0.16,0.00,0.00,45000,1,7200,0,0,0,0,0,0,0,45000,-45000,-45000
20200212,046443,超眾兆豐93購01,0.50,0.51,0.49,0.50,-0.01,-1.96,282000,17,139370,0,0,0,0,0,0,282000,0,282000,282000
20200212,046444,矽力日盛92購01,,,,,0.00,0.00,0,0,0,0,0,0,0,0,0,0,0,0,0
20200212,046445,台化麥證92購01,0.04,0.04,0.04,0.04,0.00,0.00,10000,1,400,10000,0,10000,0,0,0,10000,0,10000,10000
20200212,046446,技嘉麥證92購01,0.19,0.19,0.19,0.19,-0.03,-13.64,34000,1,6460,34000,0,34000,0,0,0,34000,0,34000,34000
20200212,046447,儒鴻凱基92購04,,,,,0.00,0.00,0,0,0,0,0,0,0,0,0,0,0,0,0
20200212,046448,亞德客凱基92購03,4.53,4.79,4.45,4.70,-0.24,-4.86,103000,22,474970,0,0,0,0,0,0,103000,0,103000,103000
20200212,046449,台達電凱基92購02,,,,,0.00,0.00,0,0,0,0,0,0,0,0,0,0,0,0,0
20200212,04644P,全新凱基94售01,0.83,0.83,0.80,0.80,-0.31,-27.93,61000,26,49700,0,0,0,0,0,0,61000,0,61000,61000
20200212,046450,鴻海凱基93購12,2.35,2.35,2.35,2.35,+0.42,21.76,35000,1,82250,0,0,0,0,0,0,35000,0,35000,35000
20200212,046451,中環凱基93購02,,,,,0.00,0.00,0,0,0,0,0,0,0,0,0,0,0,0,0
20200212,046452,國巨凱基92購07,,,,,0.00,0.00,0,0,0,0,0,0,0,0,0,0,0,0,0
20200212,046453,台積電凱基92購21,13.50,13.50,13.50,13.50,+1.30,10.66,10000,1,135000,0,0,0,0,0,0,10000,0,10000,10000
20200212,046454,微星凱基92購04,0.10,0.10,0.10,0.10,0.00,0.00,1000,1,100,0,0,0,0,0,0,0,1000,-1000,-1000
20200212,046455,瑞昱凱基92購03,0.31,0.31,0.28,0.28,0.00,0.00,20000,2,5900,0,0,0,0,0,0,0,20000,-20000,-20000
20200212,046456,聯發科凱基92購08,,,,,0.00,0.00,0,0,0,0,0,0,0,0,0,0,0,0,0
20200212,046457,可成凱基92購09,0.51,0.64,0.51,0.64,+0.20,45.45,16000,2,8940,0,0,0,0,0,0,0,16000,-16000,-16000
20200212,046458,大立光凱基92購11,,,,,0.00,0.00,0,0,0,0,0,0,0,0,0,0,0,0,0
20200212,046459,大立光凱基92購12,,,,,0.00,0.00,0,0,0,0,0,0,0,0,0,0,0,0,0
20200212,04645P,禾伸堂凱基94售03,0.52,0.54,0.52,0.54,-0.01,-1.82,13000,2,6820,0,0,0,0,0,0,13000,0,13000,13000
20200212,046460,聯鈞凱基93購02,1.00,1.11,1.00,1.09,+0.21,23.86,221000,4,223210,0,0,0,0,0,0,198000,23000,175000,175000
20200212,046461,揚明光凱基92購05,,,,,0.00,0.00,0,0,0,0,0,0,0,0,0,0,0,0,0
20200212,046462,康控凱基92購01,,,,,0.00,0.00,0,0,0,0,0,0,0,0,0,0,0,0,0
20200212,046463,臻鼎凱基92購05,,,,,0.00,0.00,0,0,0,0,0,0,0,0,0,0,0,0,0
20200212,046464,鎧勝凱基92購02,,,,,0.00,0.00,0,0,0,0,0,0,0,0,0,0,0,0,0
20200212,046465,GIS凱基95購01,0.47,0.51,0.47,0.51,+0.05,10.87,5000,4,2430,0,0,0,0,0,0,4000,1000,3000,3000
20200212,046466,台虹凱基92購01,,,,,0.00,0.00,0,0,0,0,0,0,0,0,0,0,0,0,0
20200212,046467,台虹凱基92購02,,,,,0.00,0.00,0,0,0,0,0,0,0,0,0,0,0,0,0
20200212,046468,日月光台新92購01,,,,,0.00,0.00,0,0,0,0,0,0,0,0,0,0,0,0,0
20200212,046469,瀚宇博台新92購01,,,,,0.00,0.00,0,0,0,0,0,0,0,0,0,0,0,0,0
20200212,04646P,TPK凱基94售03,,,,,0.00,0.00,0,0,0,0,0,0,0,0,0,0,0,0,0
20200212,046470,裕隆康和92購02,,,,,0.00,0.00,0,0,0,0,0,0,0,0,0,0,0,0,0
20200212,046471,冠德永豐92購01,,,,,0.00,0.00,0,0,0,0,0,0,0,0,0,0,0,0,0
20200212,046472,亞光永豐92購01,,,,,0.00,0.00,0,0,0,0,0,0,0,0,0,0,0,0,0
20200212,046473,晶技永豐92購01,,,,,0.00,0.00,0,0,0,0,0,0,0,0,0,0,0,0,0
20200212,046474,創意永豐92購03,0.37,0.42,0.36,0.41,-0.13,-24.07,215000,32,84360,0,0,0,0,0,0,165000,50000,115000,115000
20200212,046475,元翎永豐92購01,,,,,0.00,0.00,0,0,0,0,0,0,0,0,0,0,0,0,0
20200212,046476,鴻海統一96購01,2.18,2.65,2.14,2.65,+0.51,23.83,662000,39,1546510,0,0,0,0,0,0,341000,429000,-88000,-88000
20200212,046477,台積電統一94購02,,,,,0.00,0.00,0,0,0,0,0,0,0,0,0,0,0,0,0
20200212,046478,奇鋐統一92購01,,,,,0.00,0.00,0,0,0,0,0,0,0,0,0,0,0,0,0
20200212,046479,群創元富94購01,,,,,0.00,0.00,0,0,0,0,0,0,0,0,0,0,0,0,0
20200212,04647P,上海銀凱基94售04,,,,,0.00,0.00,0,0,0,0,0,0,0,0,0,0,0,0,0
20200212,046480,群創元富96購01,1.57,1.58,1.54,1.55,-0.01,-0.64,185000,6,289410,0,0,0,0,0,0,90000,95000,-5000,-5000
20200212,046481,智易元富92購02,,,,,0.00,0.00,0,0,0,0,0,0,0,0,0,0,0,0,0
20200212,046482,超眾元富92購03,,,,,0.00,0.00,0,0,0,0,0,0,0,0,0,0,0,0,0
20200212,046483,華通國泰93購01,,,,,0.00,0.00,0,0,0,0,0,0,0,0,0,0,0,0,0
20200212,046484,華泰國泰93購01,,,,,0.00,0.00,0,0,0,0,0,0,0,0,0,0,0,0,0
20200212,046485,群創國泰93購02,,,,,0.00,0.00,0,0,0,0,0,0,0,0,0,0,0,0,0
20200212,046486,樺漢國泰94購01,0.63,0.66,0.62,0.66,+0.04,6.45,257000,18,161860,0,0,0,0,0,0,104000,153000,-49000,-49000
20200212,046487,鴻海永昌92購01,1.48,1.61,1.48,1.61,+0.22,15.83,54000,2,80440,0,0,0,0,0,0,4000,54000,-50000,-50000
20200212,046488,台積電永昌92購01,,,,,0.00,0.00,0,0,0,0,0,0,0,0,0,0,0,0,0
20200212,046489,大立光永昌92購01,,,,,0.00,0.00,0,0,0,0,0,0,0,0,0,0,0,0,0
20200212,04648P,臺股指凱基94售07,,,,,0.00,0.00,0,0,0,0,0,0,0,0,0,0,0,0,0
20200212,046490,臻鼎永昌92購01,,,,,0.00,0.00,0,0,0,0,0,0,0,0,0,0,0,0,0
20200212,046491,滬深2X富邦95購02,,,,,0.00,0.00,0,0,0,0,0,0,0,0,0,0,0,0,0
20200212,046492,旺宏富邦94購02,,,,,0.00,0.00,0,0,0,0,0,0,0,0,0,0,0,0,0
20200212,046493,緯創富邦93購01,0.58,0.58,0.58,0.58,0.00,0.00,10000,1,5800,0,0,0,0,0,0,0,10000,-10000,-10000
20200212,046494,力山元大92購07,,,,,0.00,0.00,0,0,0,0,0,0,0,0,0,0,0,0,0
20200212,046495,鴻海元大92購15,3.31,3.78,3.31,3.78,+0.49,14.89,30000,3,106000,0,0,0,0,0,0,20000,10000,10000,10000
20200212,046496,鴻海元大92購16,,,,,0.00,0.00,0,0,0,0,0,0,0,0,0,0,0,0,0
20200212,046497,鴻海元大92購17,,,,,0.00,0.00,0,0,0,0,0,0,0,0,0,0,0,0,0
20200212,046498,國巨元大92購18,,,,,0.00,0.00,0,0,0,0,0,0,0,0,0,0,0,0,0
20200212,046499,技嘉元大92購02,0.92,0.97,0.81,0.86,-0.02,-2.27,824000,26,716850,0,0,0,0,0,0,459000,315000,144000,144000
20200212,04649P,臺股指凱基94售08,0.29,0.29,0.29,0.29,-0.04,-12.12,3000,1,870,0,0,0,0,0,0,3000,0,3000,3000
20200212,046500,技嘉元大92購03,,,,,0.00,0.00,0,0,0,0,0,0,0,0,0,0,0,0,0
20200212,046501,友達元大92購05,,,,,0.00,0.00,0,0,0,0,0,0,0,0,0,0,0,0,0
20200212,046502,建準元大92購04,,,,,0.00,0.00,0,0,0,0,0,0,0,0,0,0,0,0,0
20200212,046503,京元電元大92購08,0.23,0.23,0.23,0.23,+0.09,64.29,1000,1,230,0,0,0,0,0,0,1000,0,1000,1000
20200212,046504,聯發科元大92購19,0.34,0.40,0.34,0.40,0.00,0.00,30000,3,11300,0,0,0,0,0,0,0,30000,-30000,-30000
20200212,046505,聯發科元大92購20,1.26,1.29,1.26,1.29,+0.62,92.54,2000,2,2550,0,0,0,0,0,0,0,2000,-2000,-2000
20200212,046506,全新元大92購05,0.63,0.63,0.63,0.63,+0.22,53.66,10000,1,6300,0,0,0,0,0,0,0,10000,-10000,-10000
20200212,046507,宏達電元大92購07,,,,,0.00,0.00,0,0,0,0,0,0,0,0,0,0,0,0,0
20200212,046508,冠德元大92購04,,,,,0.00,0.00,0,0,0,0,0,0,0,0,0,0,0,0,0
20200212,046509,中壽元大92購01,0.73,0.76,0.73,0.73,-0.01,-1.35,50000,3,37100,0,0,0,0,0,0,30000,20000,10000,10000
20200212,04650P,臺股指凱基94售09,0.37,0.37,0.32,0.32,0.00,0.00,20000,5,6700,0,0,0,0,0,0,0,20000,-20000,-20000
20200212,046510,大立光元大92購25,1.18,1.18,1.18,1.18,0.00,0.00,10000,1,11800,0,0,0,0,0,0,0,10000,-10000,-10000
20200212,046511,欣興元大92購08,0.30,0.30,0.30,0.30,0.00,0.00,100000,1,30000,0,0,0,0,0,0,100000,0,100000,100000
20200212,046512,和鑫元大92購01,,,,,0.00,0.00,0,0,0,0,0,0,0,0,0,0,0,0,0
20200212,046513,景碩元大92購02,5.05,5.05,5.05,5.05,+0.38,8.14,20000,2,101000,0,0,0,0,0,0,20000,0,20000,20000
20200212,046514,群創元大92購12,,,,,0.00,0.00,0,0,0,0,0,0,0,0,0,0,0,0,0
20200212,046515,嘉澤元大92購04,,,,,0.00,0.00,0,0,0,0,0,0,0,0,0,0,0,0,0
20200212,046516,TPK元大92購03,,,,,0.00,0.00,0,0,0,0,0,0,0,0,0,0,0,0,0
20200212,046517,南寶元大92購02,,,,,0.00,0.00,0,0,0,0,0,0,0,0,0,0,0,0,0
20200212,046518,致伸元大92購06,,,,,0.00,0.00,0,0,0,0,0,0,0,0,0,0,0,0,0
20200212,046519,鎧勝元大92購01,,,,,0.00,0.00,0,0,0,0,0,0,0,0,0,0,0,0,0
20200212,04651P,臺股指凱基94售10,,,,,0.00,0.00,0,0,0,0,0,0,0,0,0,0,0,0,0
20200212,046520,瀚宇博元大92購02,,,,,0.00,0.00,0,0,0,0,0,0,0,0,0,0,0,0,0
20200212,046521,台郡元大92購06,3.11,3.19,3.11,3.19,+1.50,88.76,31000,2,98810,0,0,0,0,0,0,31000,0,31000,31000
20200212,046522,樺漢元大92購03,0.32,0.32,0.32,0.32,0.00,0.00,40000,1,12800,0,0,0,0,0,0,40000,0,40000,40000
20200212,046523,臺股指元大92購22,,,,,0.00,0.00,0,0,0,0,0,0,0,0,0,0,0,0,0
20200212,046524,臺股指元大92購23,,,,,0.00,0.00,0,0,0,0,0,0,0,0,0,0,0,0,0
20200212,046525,臺股指元大92購24,,,,,0.00,0.00,0,0,0,0,0,0,0,0,0,0,0,0,0
20200212,046526,臺股指元大92購25,,,,,0.00,0.00,0,0,0,0,0,0,0,0,0,0,0,0,0
20200212,046527,臺股指元大92購26,,,,,0.00,0.00,0,0,0,0,0,0,0,0,0,0,0,0,0
20200212,046528,聯詠中信94購01,2.33,2.50,2.30,2.39,+0.21,9.63,95000,9,229000,0,0,0,0,0,0,75000,20000,55000,55000
20200212,046529,臻鼎中信92購01,,,,,0.00,0.00,0,0,0,0,0,0,0,0,0,0,0,0,0
20200212,04652P,臺股指凱基94售11,0.48,0.48,0.42,0.42,-0.10,-19.23,50000,4,21900,0,0,0,0,0,0,30000,20000,10000,10000
20200212,046530,聯發科兆豐92購02,0.27,0.27,0.27,0.27,0.00,0.00,280000,1,75600,0,0,0,0,0,0,280000,280000,0,0
20200212,046531,臻鼎兆豐92購02,0.08,0.08,0.05,0.05,0.00,0.00,255000,7,16100,0,0,0,0,0,0,245000,10000,235000,235000
20200212,046532,元石油群益93購01,,,,,0.00,0.00,0,0,0,0,0,0,0,0,0,0,0,0,0
20200212,046533,為升群益92購02,,,,,0.00,0.00,0,0,0,0,0,0,0,0,0,0,0,0,0
20200212,046534,鴻海群益92購05,,,,,0.00,0.00,0,0,0,0,0,0,0,0,0,0,0,0,0
20200212,046535,宏碁群益92購01,,,,,0.00,0.00,0,0,0,0,0,0,0,0,0,0,0,0,0
20200212,046536,聯發科群益92購08,,,,,0.00,0.00,0,0,0,0,0,0,0,0,0,0,0,0,0
20200212,046537,聯發科群益93購02,2.70,3.04,2.68,2.98,+0.56,23.14,115000,15,317440,0,0,0,0,0,0,76000,36000,40000,40000
20200212,046538,大立光群益93購06,1.93,2.01,1.93,2.01,+0.33,19.64,19000,2,37470,0,0,0,0,0,0,9000,19000,-10000,-10000
20200212,046539,奇鋐群益92購02,,,,,0.00,0.00,0,0,0,0,0,0,0,0,0,0,0,0,0
20200212,04653P,臺股指凱基94售12,,,,,0.00,0.00,0,0,0,0,0,0,0,0,0,0,0,0,0
20200212,046540,創意群益92購04,,,,,0.00,0.00,0,0,0,0,0,0,0,0,0,0,0,0,0
20200212,046541,超眾群益93購01,,,,,0.00,0.00,0,0,0,0,0,0,0,0,0,0,0,0,0
20200212,046542,技嘉台新92購01,,,,,0.00,0.00,0,0,0,0,0,0,0,0,0,0,0,0,0
20200212,046543,京元電台新92購01,,,,,0.00,0.00,0,0,0,0,0,0,0,0,0,0,0,0,0
20200212,046544,奇鋐台新92購01,,,,,0.00,0.00,0,0,0,0,0,0,0,0,0,0,0,0,0
20200212,046545,大成鋼永豐92購01,,,,,0.00,0.00,0,0,0,0,0,0,0,0,0,0,0,0,0
20200212,046546,義隆永豐92購03,0.01,0.01,0.01,0.01,0.00,0.00,55000,3,550,0,0,0,0,0,0,55000,0,55000,55000
20200212,046547,大立光永豐92購05,1.20,1.20,1.20,1.20,0.00,0.00,2000,1,2400,0,0,0,0,0,0,2000,0,2000,2000
20200212,046548,傳奇永豐92購02,,,,,0.00,0.00,0,0,0,0,0,0,0,0,0,0,0,0,0
20200212,046549,康友永豐92購02,2.17,2.30,2.17,2.30,+0.19,9.0,20000,2,44700,0,0,0,0,0,0,0,20000,-20000,-20000
20200212,04654P,臺股指凱基94售13,0.50,0.50,0.40,0.40,-0.14,-25.93,21000,3,8700,0,0,0,0,0,0,0,21000,-21000,-21000
20200212,046550,燿華日盛92購01,,,,,0.00,0.00,0,0,0,0,0,0,0,0,0,0,0,0,0
20200212,046551,聯發科麥證92購02,,,,,0.00,0.00,0,0,0,0,0,0,0,0,0,0,0,0,0
20200212,046552,晶技麥證92購01,0.08,0.08,0.08,0.08,0.00,0.00,25000,3,2000,0,25000,-25000,0,0,0,0,25000,-25000,-25000
20200212,046553,元石油凱基92購01,,,,,0.00,0.00,0,0,0,0,0,0,0,0,0,0,0,0,0
20200212,046554,S&P反1凱基92購01,,,,,0.00,0.00,0,0,0,0,0,0,0,0,0,0,0,0,0
20200212,046555,A50反1凱基92購01,,,,,0.00,0.00,0,0,0,0,0,0,0,0,0,0,0,0,0
20200212,046556,道瓊指凱基92購01,0.31,0.31,0.31,0.31,-0.04,-11.43,2000,2,620,0,0,0,0,0,0,0,2000,-2000,-2000
20200212,046557,亞泥凱基93購02,0.93,0.93,0.93,0.93,+0.02,2.2,1000,1,930,0,0,0,0,0,0,0,0,0,0
20200212,046558,儒鴻凱基92購05,,,,,0.00,0.00,0,0,0,0,0,0,0,0,0,0,0,0,0
20200212,046559,台積電凱基92購23,,,,,0.00,0.00,0,0,0,0,0,0,0,0,0,0,0,0,0
20200212,04655P,臺股指凱基94售14,0.43,0.43,0.32,0.32,-0.12,-27.27,361000,22,130220,0,0,0,0,0,0,0,300000,-300000,-300000
20200212,046560,南亞科凱基92購04,,,,,0.00,0.00,0,0,0,0,0,0,0,0,0,0,0,0,0
20200212,046561,可成凱基92購11,0.32,0.40,0.32,0.40,0.00,0.00,16000,2,5600,0,0,0,0,0,0,0,16000,-16000,-16000
20200212,046562,大立光凱基95購01,,,,,0.00,0.00,0,0,0,0,0,0,0,0,0,0,0,0,0
20200212,046563,奇鋐凱基92購01,,,,,0.00,0.00,0,0,0,0,0,0,0,0,0,0,0,0,0
20200212,046564,聯詠凱基92購09,1.70,1.83,1.66,1.81,+0.25,16.03,90000,8,155900,0,0,0,0,0,0,70000,20000,50000,50000
20200212,046565,康控凱基92購02,,,,,0.00,0.00,0,0,0,0,0,0,0,0,0,0,0,0,0
20200212,046566,臻鼎凱基92購06,,,,,0.00,0.00,0,0,0,0,0,0,0,0,0,0,0,0,0
20200212,046567,正崴元富92購01,,,,,0.00,0.00,0,0,0,0,0,0,0,0,0,0,0,0,0
20200212,046568,臻鼎元富95購01,0.94,1.06,0.74,0.76,+0.12,18.75,421000,32,373520,0,0,0,0,0,0,16000,405000,-389000,-389000
20200212,046569,同欣電元富92購02,,,,,0.00,0.00,0,0,0,0,0,0,0,0,0,0,0,0,0
20200212,04656P,台郡台新94售02,,,,,0.00,0.00,0,0,0,0,0,0,0,0,0,0,0,0,0
20200212,046570,旺宏國泰94購01,,,,,0.00,0.00,0,0,0,0,0,0,0,0,0,0,0,0,0
20200212,046571,瑞昱國泰93購01,3.40,3.40,3.40,3.40,0.00,0.00,15000,1,51000,0,0,0,0,0,0,0,15000,-15000,-15000
20200212,046572,貿聯國泰94購01,0.71,0.83,0.71,0.83,+0.13,18.57,256000,21,194400,0,0,0,0,0,0,210000,56000,154000,154000
20200212,046573,上緯控國泰94購01,0.44,0.44,0.44,0.44,0.00,0.00,117000,1,51480,0,0,0,0,0,0,0,117000,-117000,-117000
20200212,046574,泰鼎國泰94購01,0.66,0.72,0.63,0.63,+0.07,12.5,401000,44,270420,0,0,0,0,0,0,129000,271000,-142000,-142000
20200212,046575,GIS國泰93購01,0.18,0.19,0.18,0.19,+0.04,26.67,30000,4,5550,0,0,0,0,0,0,0,30000,-30000,-30000
20200212,046576,S&P反1富邦93購01,,,,,0.00,0.00,0,0,0,0,0,0,0,0,0,0,0,0,0
20200212,046577,東元元大92購02,,,,,0.00,0.00,0,0,0,0,0,0,0,0,0,0,0,0,0
20200212,046578,聯電元大92購01,2.71,2.96,2.71,2.91,-0.01,-0.34,18000,6,50480,0,0,0,0,0,0,4000,14000,-10000,-10000
20200212,046579,台積電元大92購32,11.80,11.90,11.80,11.90,+0.40,3.48,35000,3,415800,0,0,0,0,0,0,21000,14000,7000,7000
20200212,04657P,國巨永豐94售03,,,,,0.00,0.00,0,0,0,0,0,0,0,0,0,0,0,0,0
20200212,046580,正崴元大92購01,,,,,0.00,0.00,0,0,0,0,0,0,0,0,0,0,0,0,0
20200212,046581,聯發科元大92購22,,,,,0.00,0.00,0,0,0,0,0,0,0,0,0,0,0,0,0
20200212,046582,聯發科元大92購23,2.91,2.91,2.91,2.91,+0.68,30.49,1000,1,2910,0,0,0,0,0,0,0,1000,-1000,-1000
20200212,046583,聯發科元大92購24,1.54,1.76,1.54,1.76,+0.49,38.58,21000,4,34460,0,0,0,0,0,0,10000,11000,-1000,-1000
20200212,046584,可成元大92購11,1.31,1.47,1.31,1.47,0.00,0.00,21000,3,28070,0,0,0,0,0,0,0,21000,-21000,-21000
20200212,046585,潤泰全元大92購03,,,,,0.00,0.00,0,0,0,0,0,0,0,0,0,0,0,0,0
20200212,046586,大立光元大92購26,,,,,0.00,0.00,0,0,0,0,0,0,0,0,0,0,0,0,0
20200212,046587,大立光元大92購27,,,,,0.00,0.00,0,0,0,0,0,0,0,0,0,0,0,0,0
20200212,046588,大立光元大93購13,,,,,0.00,0.00,0,0,0,0,0,0,0,0,0,0,0,0,0
20200212,046589,康控元大92購03,,,,,0.00,0.00,0,0,0,0,0,0,0,0,0,0,0,0,0
20200212,04658P,臺股指永昌94售02,,,,,0.00,0.00,0,0,0,0,0,0,0,0,0,0,0,0,0
20200212,046590,同欣電元大92購02,2.40,2.40,2.40,2.40,0.00,0.00,10000,1,24000,0,0,0,0,0,0,0,10000,-10000,-10000
20200212,046591,康舒元大92購01,,,,,0.00,0.00,0,0,0,0,0,0,0,0,0,0,0,0,0
20200212,046592,南電元大92購03,,,,,0.00,0.00,0,0,0,0,0,0,0,0,0,0,0,0,0
20200212,046593,臺股指元大92購27,,,,,0.00,0.00,0,0,0,0,0,0,0,0,0,0,0,0,0
20200212,046594,東元中信93購01,,,,,0.00,0.00,0,0,0,0,0,0,0,0,0,0,0,0,0
20200212,046595,奇鋐第一93購01,,,,,0.00,0.00,0,0,0,0,0,0,0,0,0,0,0,0,0
20200212,046596,TPK第一93購01,0.01,0.01,0.01,0.01,0.00,0.00,1000,1,10,0,0,0,0,0,0,1000,0,1000,1000
20200212,046597,可成亞東93購01,2.24,2.39,2.24,2.39,0.00,0.00,30000,3,69000,0,0,0,0,0,0,0,30000,-30000,-30000
20200212,046598,T50反1群益93購04,,,,,0.00,0.00,0,0,0,0,0,0,0,0,0,0,0,0,0
20200212,046599,S&P反1群益93購01,,,,,0.00,0.00,0,0,0,0,0,0,0,0,0,0,0,0,0
20200212,04659P,臺股指永昌94售03,,,,,0.00,0.00,0,0,0,0,0,0,0,0,0,0,0,0,0
20200212,046600,鴻海群益94購01,3.24,3.58,3.24,3.58,+0.46,14.74,65000,8,221220,0,0,0,0,0,0,5000,65000,-60000,-60000
20200212,046601,奇力新群益93購01,,,,,0.00,0.00,0,0,0,0,0,0,0,0,0,0,0,0,0
20200212,046602,新日興群益94購01,1.44,1.47,1.33,1.36,-0.14,-9.33,503000,40,705130,0,0,0,0,0,0,335000,171000,164000,164000
20200212,046603,貿聯群益93購01,,,,,0.00,0.00,0,0,0,0,0,0,0,0,0,0,0,0,0
20200212,046604,康控群益93購02,0.39,0.44,0.39,0.42,+0.06,16.67,72000,19,29890,0,0,0,0,0,0,10000,62000,-52000,-52000
20200212,046605,瀚宇博群益93購01,,,,,0.00,0.00,0,0,0,0,0,0,0,0,0,0,0,0,0
20200212,046606,世紀鋼群益93購01,,,,,0.00,0.00,0,0,0,0,0,0,0,0,0,0,0,0,0
20200212,046607,電子類群益93購01,,,,,0.00,0.00,0,0,0,0,0,0,0,0,0,0,0,0,0
20200212,046608,超眾兆豐93購02,0.13,0.15,0.13,0.15,+0.03,25.0,3000,3,420,0,0,0,0,0,0,2000,1000,1000,1000
20200212,046609,深中小國票93購01,,,,,0.00,0.00,0,0,0,0,0,0,0,0,0,0,0,0,0
20200212,04660P,臺股指富邦94售03,,,,,0.00,0.00,0,0,0,0,0,0,0,0,0,0,0,0,0
20200212,046610,義隆國票93購01,0.27,0.33,0.27,0.33,0.00,0.00,201000,2,66270,0,0,0,0,0,0,201000,0,201000,201000
20200212,046611,樺漢日盛93購01,,,,,0.00,0.00,0,0,0,0,0,0,0,0,0,0,0,0,0
20200212,046612,群創麥證93購01,,,,,0.00,0.00,0,0,0,0,0,0,0,0,0,0,0,0,0
20200212,046613,元石油凱基93購01,,,,,0.00,0.00,0,0,0,0,0,0,0,0,0,0,0,0,0
20200212,046614,儒鴻凱基93購01,,,,,0.00,0.00,0,0,0,0,0,0,0,0,0,0,0,0,0
20200212,046615,大成鋼凱基93購01,,,,,0.00,0.00,0,0,0,0,0,0,0,0,0,0,0,0,0
20200212,046616,中橡凱基93購01,,,,,0.00,0.00,0,0,0,0,0,0,0,0,0,0,0,0,0
20200212,046617,台積電凱基93購01,16.10,16.10,16.10,16.10,0.00,0.00,5000,1,80500,0,0,0,0,0,0,5000,0,5000,5000
20200212,046618,南亞科凱基93購01,2.17,2.17,2.06,2.12,-0.16,-7.02,30000,3,63500,0,0,0,0,0,0,10000,20000,-10000,-10000
20200212,046619,可成凱基93購01,0.44,0.60,0.44,0.60,+0.19,46.34,36000,3,17000,0,0,0,0,0,0,20000,16000,4000,4000
20200212,04661P,臺股指富邦94售04,,,,,0.00,0.00,0,0,0,0,0,0,0,0,0,0,0,0,0
20200212,046620,智伸科凱基93購01,1.26,1.27,1.26,1.27,-0.02,-1.55,13000,2,16410,0,0,0,0,0,0,10000,3000,7000,7000
20200212,046621,智伸科凱基93購02,0.56,0.56,0.56,0.56,-0.04,-6.67,10000,1,5600,0,0,0,0,0,0,10000,0,10000,10000
20200212,046622,正文凱基93購01,,,,,0.00,0.00,0,0,0,0,0,0,0,0,0,0,0,0,0
20200212,046623,臻鼎凱基93購02,1.24,1.24,1.01,1.01,+0.27,36.49,30000,2,34900,0,0,0,0,0,0,20000,10000,10000,10000
20200212,046624,彩晶凱基94購02,,,,,0.00,0.00,0,0,0,0,0,0,0,0,0,0,0,0,0
20200212,046625,勤誠凱基93購01,,,,,0.00,0.00,0,0,0,0,0,0,0,0,0,0,0,0,0
20200212,046626,台光電統一94購01,0.38,0.51,0.38,0.51,+0.16,45.71,615000,12,276230,0,0,0,0,0,0,37000,578000,-541000,-541000
20200212,046627,高鐵統一95購01,0.71,0.71,0.71,0.71,0.00,0.00,10000,1,7100,0,0,0,0,0,0,0,10000,-10000,-10000
20200212,046628,大立光統一98購01,4.01,4.23,4.01,4.23,+0.34,8.74,92000,8,375950,0,0,0,0,0,0,53000,39000,14000,14000
20200212,046629,群創統一98購01,2.24,2.24,2.20,2.20,0.00,0.00,40000,4,88700,0,0,0,0,0,0,0,40000,-40000,-40000
20200212,04662P,臺股指國票94售01,,,,,0.00,0.00,0,0,0,0,0,0,0,0,0,0,0,0,0
20200212,046630,京元電元富95購03,1.08,1.17,1.07,1.16,+0.09,8.41,238000,27,260830,0,0,0,0,0,0,228000,10000,218000,218000
20200212,046631,創意元富93購01,1.44,1.44,1.44,1.44,-0.43,-22.99,8000,2,11520,0,0,0,0,0,0,8000,0,8000,8000
20200212,046632,智易元富93購01,,,,,0.00,0.00,0,0,0,0,0,0,0,0,0,0,0,0,0
20200212,046633,健策元富93購01,4.66,4.66,4.62,4.62,+0.56,13.79,6000,3,27920,0,0,0,0,0,0,6000,0,6000,6000
20200212,046634,GIS元富93購01,,,,,0.00,0.00,0,0,0,0,0,0,0,0,0,0,0,0,0
20200212,046635,華通台新93購01,,,,,0.00,0.00,0,0,0,0,0,0,0,0,0,0,0,0,0
20200212,046636,亞德客永豐93購02,,,,,0.00,0.00,0,0,0,0,0,0,0,0,0,0,0,0,0
20200212,046637,國巨永豐93購01,,,,,0.00,0.00,0,0,0,0,0,0,0,0,0,0,0,0,0
20200212,046638,台積電永豐93購01,,,,,0.00,0.00,0,0,0,0,0,0,0,0,0,0,0,0,0
20200212,046639,嘉晶永豐93購01,0.46,0.53,0.46,0.53,0.00,0.00,88000,5,41700,0,0,0,0,0,0,0,88000,-88000,-88000
20200212,04663P,臺股指國票94售02,,,,,0.00,0.00,0,0,0,0,0,0,0,0,0,0,0,0,0
20200212,046640,揚明光永豐93購01,0.14,0.14,0.14,0.14,0.00,0.00,5000,1,700,0,0,0,0,0,0,5000,0,5000,5000
20200212,046641,新唐永豐93購01,,,,,0.00,0.00,0,0,0,0,0,0,0,0,0,0,0,0,0
20200212,046642,南電永豐93購01,0.93,1.25,0.88,1.25,+0.28,28.87,60000,22,61310,0,0,0,0,0,0,60000,0,60000,60000
20200212,046643,臺股指永豐93購01,5.80,6.15,5.80,6.15,0.00,0.00,740000,26,4510500,0,0,0,0,0,0,740000,740000,0,0
20200212,046644,台達電國泰93購01,0.39,0.43,0.39,0.43,+0.04,10.26,201000,3,82390,0,0,0,0,0,0,201000,0,201000,201000
20200212,046645,技嘉國泰94購01,1.04,1.19,0.98,1.02,0.00,0.00,1504000,60,1554000,0,0,0,0,0,0,710000,666000,44000,44000
20200212,046646,冠德國泰94購01,0.44,0.44,0.44,0.44,+0.04,10.0,50000,1,22000,0,0,0,0,0,0,0,50000,-50000,-50000
20200212,046647,高鐵國泰93購01,0.58,0.58,0.58,0.58,-0.06,-9.38,98000,1,56840,0,0,0,0,0,0,98000,0,98000,98000
20200212,046648,和鑫國泰94購01,,,,,0.00,0.00,0,0,0,0,0,0,0,0,0,0,0,0,0
20200212,046649,致伸國泰94購01,0.35,0.37,0.35,0.37,+0.02,5.71,170000,2,61900,0,0,0,0,0,0,50000,120000,-70000,-70000
20200212,04664P,臺股指國票94售03,,,,,0.00,0.00,0,0,0,0,0,0,0,0,0,0,0,0,0
20200212,046650,台表科國泰94購01,1.89,2.03,1.89,2.01,+0.20,11.05,476000,10,931960,0,0,0,0,0,0,83000,476000,-393000,-393000
20200212,046651,TPK富邦94購02,,,,,0.00,0.00,0,0,0,0,0,0,0,0,0,0,0,0,0
20200212,046652,上銀元大93購02,2.00,2.00,2.00,2.00,+0.21,11.73,104000,3,208000,0,0,0,0,0,0,54000,50000,4000,4000
20200212,046653,鴻海元大93購05,4.30,4.48,4.30,4.48,+0.20,4.67,20000,2,87800,0,0,0,0,0,0,20000,0,20000,20000
20200212,046654,鴻海元大93購06,3.97,4.66,3.97,4.66,+0.72,18.27,33000,5,140380,0,0,0,0,0,0,20000,13000,7000,7000
20200212,046655,華泰元大93購01,,,,,0.00,0.00,0,0,0,0,0,0,0,0,0,0,0,0,0
20200212,046656,華邦電元大93購02,0.49,0.49,0.49,0.49,+0.11,28.95,1000,1,490,0,0,0,0,0,0,1000,0,1000,1000
20200212,046657,燿華元大93購01,1.59,1.70,1.59,1.70,-0.05,-2.86,67000,5,110630,0,0,0,0,0,0,7000,60000,-53000,-53000
20200212,046658,微星元大93購01,,,,,0.00,0.00,0,0,0,0,0,0,0,0,0,0,0,0,0
20200212,046659,瑞昱元大93購02,3.89,4.03,3.85,3.85,0.00,0.00,15000,6,58370,0,0,0,0,0,0,0,15000,-15000,-15000
20200212,04665P,臺股指國票94售04,,,,,0.00,0.00,0,0,0,0,0,0,0,0,0,0,0,0,0
20200212,046660,宏達電元大93購07,0.89,0.92,0.89,0.92,0.00,0.00,130000,3,116600,0,0,0,0,0,0,30000,100000,-70000,-70000
20200212,046661,冠德元大93購01,,,,,0.00,0.00,0,0,0,0,0,0,0,0,0,0,0,0,0
20200212,046662,大立光元大93購14,,,,,0.00,0.00,0,0,0,0,0,0,0,0,0,0,0,0,0
20200212,046663,亞光元大93購02,0.26,0.26,0.26,0.26,+0.09,52.94,1000,1,260,0,0,0,0,0,0,1000,0,1000,1000
20200212,046664,聯詠元大93購01,1.91,2.10,1.91,2.06,+0.37,21.89,30000,4,60700,0,0,0,0,0,0,30000,0,30000,30000
20200212,046665,智原元大93購01,,,,,0.00,0.00,0,0,0,0,0,0,0,0,0,0,0,0,0
20200212,046666,欣興元大93購05,0.04,0.06,0.04,0.06,0.00,0.00,3000,3,150,0,0,0,0,0,0,3000,0,3000,3000
20200212,046667,晶技元大93購01,0.43,0.43,0.42,0.42,0.00,0.00,11000,2,4720,0,0,0,0,0,0,1000,10000,-9000,-9000
20200212,046668,嘉澤元大93購01,1.35,1.48,1.17,1.17,-0.16,-12.03,180000,20,245950,0,0,0,0,0,0,80000,100000,-20000,-20000
20200212,046669,新唐元大93購01,,,,,0.00,0.00,0,0,0,0,0,0,0,0,0,0,0,0,0
20200212,04666P,臺股指國票94售05,,,,,0.00,0.00,0,0,0,0,0,0,0,0,0,0,0,0,0
20200212,046670,彩晶元大93購02,,,,,0.00,0.00,0,0,0,0,0,0,0,0,0,0,0,0,0
20200212,046671,彩晶元大93購03,0.39,0.39,0.36,0.37,-0.01,-2.63,145000,8,54570,0,0,0,0,0,0,130000,15000,115000,115000
20200212,046672,聯茂元大93購01,0.54,0.71,0.54,0.71,0.00,0.00,448000,7,312840,0,0,0,0,0,0,4000,448000,-444000,-444000
20200212,046673,樺漢元大93購01,,,,,0.00,0.00,0,0,0,0,0,0,0,0,0,0,0,0,0
20200212,046674,訊芯元大93購01,2.43,2.96,2.43,2.96,+0.52,21.31,44000,6,121310,0,0,0,0,0,0,11000,33000,-22000,-22000
20200212,046675,GIS元大93購06,,,,,0.00,0.00,0,0,0,0,0,0,0,0,0,0,0,0,0
20200212,046676,羅麗芬元大93購01,0.03,0.03,0.03,0.03,0.00,0.00,299000,1,8970,0,0,0,0,0,0,299000,0,299000,299000
20200212,046677,矽創元大93購03,0.21,0.21,0.21,0.21,0.00,0.00,1000,1,210,0,0,0,0,0,0,1000,0,1000,1000
20200212,046678,臺股指元大93購22,,,,,0.00,0.00,0,0,0,0,0,0,0,0,0,0,0,0,0
20200212,046679,卜蜂中信93購01,,,,,0.00,0.00,0,0,0,0,0,0,0,0,0,0,0,0,0
20200212,04667P,臺股指國票94售06,0.54,0.54,0.45,0.46,0.00,0.00,287000,8,135330,0,0,0,0,0,0,9000,287000,-278000,-278000
20200212,046680,上証反群益95購01,,,,,0.00,0.00,0,0,0,0,0,0,0,0,0,0,0,0,0
20200212,046681,漢唐群益93購01,,,,,0.00,0.00,0,0,0,0,0,0,0,0,0,0,0,0,0
20200212,046682,聯發科群益93購03,2.56,2.56,2.56,2.56,0.00,0.00,1000,1,2560,0,0,0,0,0,0,0,1000,-1000,-1000
20200212,046683,宏達電群益93購02,,,,,0.00,0.00,0,0,0,0,0,0,0,0,0,0,0,0,0
20200212,046684,致伸群益93購01,,,,,0.00,0.00,0,0,0,0,0,0,0,0,0,0,0,0,0
20200212,046685,世紀鋼群益93購02,0.60,0.62,0.59,0.59,-0.07,-10.61,1321000,9,801740,0,0,0,0,0,0,1321000,0,1321000,1321000
20200212,046686,上銀國票93購01,,,,,0.00,0.00,0,0,0,0,0,0,0,0,0,0,0,0,0
20200212,046687,TPK國票93購01,,,,,0.00,0.00,0,0,0,0,0,0,0,0,0,0,0,0,0
20200212,046688,超眾國票93購03,0.31,0.34,0.31,0.33,+0.06,22.22,60000,10,19160,0,0,0,0,0,0,60000,0,60000,60000
20200212,046689,台積電麥證93購01,,,,,0.00,0.00,0,0,0,0,0,0,0,0,0,0,0,0,0
20200212,04668P,臺股指國票94售07,0.76,0.76,0.72,0.72,0.00,0.00,16000,2,11920,0,0,0,0,0,0,0,16000,-16000,-16000
20200212,046690,元油2X凱基93購03,,,,,0.00,0.00,0,0,0,0,0,0,0,0,0,0,0,0,0
20200212,046691,儒鴻凱基93購02,,,,,0.00,0.00,0,0,0,0,0,0,0,0,0,0,0,0,0
20200212,046692,鴻海凱基93購15,2.72,3.31,2.72,3.31,+0.83,33.47,70000,6,211400,0,0,0,0,0,0,30000,40000,-10000,-10000
20200212,046693,台積電凱基93購03,19.10,19.10,19.10,19.10,0.00,0.00,15000,2,286500,0,0,0,0,0,0,15000,15000,0,0
20200212,046694,智邦凱基93購01,1.10,1.22,1.04,1.13,+0.25,28.41,154000,20,170880,0,0,0,0,0,0,148000,7000,141000,141000
20200212,046695,瑞昱凱基93購03,0.97,1.16,0.97,1.08,+0.06,5.88,30000,3,32100,0,0,0,0,0,0,10000,20000,-10000,-10000
20200212,046696,可成凱基93購02,,,,,0.00,0.00,0,0,0,0,0,0,0,0,0,0,0,0,0
20200212,046697,麗豐凱基94購01,,,,,0.00,0.00,0,0,0,0,0,0,0,0,0,0,0,0,0
20200212,046698,致伸凱基93購01,,,,,0.00,0.00,0,0,0,0,0,0,0,0,0,0,0,0,0
20200212,046699,臻鼎凱基93購03,1.36,1.61,1.36,1.61,+0.73,82.95,29000,6,40280,0,0,0,0,0,0,25000,4000,21000,21000
20200212,04669P,臺股指國票94售08,0.76,0.76,0.64,0.64,-0.18,-21.95,300000,8,197500,0,0,0,0,0,0,65000,235000,-170000,-170000
20200212,046700,台郡凱基93購02,4.69,4.84,4.69,4.81,+2.33,93.95,36000,12,170630,0,0,0,0,0,0,25000,11000,14000,14000
20200212,046701,T50反1統一93購03,,,,,0.00,0.00,0,0,0,0,0,0,0,0,0,0,0,0,0
20200212,046702,旺宏元富93購02,,,,,0.00,0.00,0,0,0,0,0,0,0,0,0,0,0,0,0
20200212,046703,瑞昱元富95購01,2.51,2.73,2.51,2.63,+0.18,7.35,174000,15,458960,0,0,0,0,0,0,102000,76000,26000,26000
20200212,046704,智原元富93購01,0.06,0.06,0.06,0.06,0.00,0.00,100000,1,6000,0,0,0,0,0,0,0,100000,-100000,-100000
20200212,046705,台積電台新93購01,,,,,0.00,0.00,0,0,0,0,0,0,0,0,0,0,0,0,0
20200212,046706,智邦台新93購01,1.07,1.07,1.07,1.07,+0.27,33.75,1000,1,1070,0,0,0,0,0,0,0,1000,-1000,-1000
20200212,046707,友達康和93購01,2.85,2.85,2.85,2.85,-0.05,-1.72,20000,2,57000,0,0,0,0,0,0,0,20000,-20000,-20000
20200212,046708,寶齡永豐93購01,,,,,0.00,0.00,0,0,0,0,0,0,0,0,0,0,0,0,0
20200212,046709,瑞昱永豐93購01,,,,,0.00,0.00,0,0,0,0,0,0,0,0,0,0,0,0,0
20200212,04670P,臺股指國票94售09,1.06,1.09,0.97,0.97,-0.20,-17.09,262000,10,273150,0,0,0,0,0,0,201000,161000,40000,40000
20200212,046710,利勤永豐93購01,,,,,0.00,0.00,0,0,0,0,0,0,0,0,0,0,0,0,0
20200212,046711,中磊永豐93購01,,,,,0.00,0.00,0,0,0,0,0,0,0,0,0,0,0,0,0
20200212,046712,勤誠永豐93購01,0.41,0.49,0.38,0.45,-0.16,-26.23,70000,6,30920,0,0,0,0,0,0,40000,30000,10000,10000
20200212,046713,鴻海國泰93購02,,,,,0.00,0.00,0,0,0,0,0,0,0,0,0,0,0,0,0
20200212,046714,國巨國泰93購02,,,,,0.00,0.00,0,0,0,0,0,0,0,0,0,0,0,0,0
20200212,046715,美律國泰94購01,0.82,0.97,0.80,0.96,+0.22,29.73,163000,37,148100,0,0,0,0,0,0,21000,153000,-132000,-132000
20200212,046716,欣興國泰93購03,1.03,1.29,1.03,1.29,+0.28,27.72,263000,26,294830,0,0,0,0,0,0,120000,143000,-23000,-23000
20200212,046717,世紀鋼國泰94購01,0.67,0.68,0.66,0.67,-0.03,-4.29,68000,17,45640,0,0,0,0,0,0,68000,0,68000,68000
20200212,046718,群創富邦93購02,,,,,0.00,0.00,0,0,0,0,0,0,0,0,0,0,0,0,0
20200212,046719,元石油元大95購02,,,,,0.00,0.00,0,0,0,0,0,0,0,0,0,0,0,0,0
20200212,04671P,華通統一94售01,,,,,0.00,0.00,0,0,0,0,0,0,0,0,0,0,0,0,0
20200212,046720,元油2X元大95購08,,,,,0.00,0.00,0,0,0,0,0,0,0,0,0,0,0,0,0
20200212,046721,中鋼元大93購01,,,,,0.00,0.00,0,0,0,0,0,0,0,0,0,0,0,0,0
20200212,046722,智邦元大93購02,1.66,1.73,1.28,1.28,-0.14,-9.86,112000,4,147990,0,0,0,0,0,0,11000,101000,-90000,-90000
20200212,046723,聯發科元大93購01,3.16,3.16,3.16,3.16,0.00,0.00,1000,1,3160,0,0,0,0,0,0,0,1000,-1000,-1000
20200212,046724,聯發科元大93購02,1.90,2.13,1.85,2.13,+0.51,31.48,47000,7,89330,0,0,0,0,0,0,45000,2000,43000,43000
20200212,046725,可成元大93購02,2.34,2.80,2.34,2.80,0.00,0.00,6000,2,14500,0,0,0,0,0,0,5000,1000,4000,4000
20200212,046726,台新金元大93購01,,,,,0.00,0.00,0,0,0,0,0,0,0,0,0,0,0,0,0
20200212,046727,新光金元大93購03,0.70,0.70,0.69,0.69,-0.01,-1.43,344000,12,237990,0,0,0,0,0,0,311000,33000,278000,278000
20200212,046728,明泰元大93購01,,,,,0.00,0.00,0,0,0,0,0,0,0,0,0,0,0,0,0
20200212,046729,智伸科元大93購01,0.78,0.80,0.78,0.80,-0.01,-1.23,90000,2,70700,0,0,0,0,0,0,65000,25000,40000,40000
20200212,04672P,台積電統一94售09,0.18,0.18,0.16,0.16,-0.04,-20.0,380000,14,66620,0,0,0,0,0,0,8000,290000,-282000,-282000
20200212,046730,瀚宇博元大93購02,,,,,0.00,0.00,0,0,0,0,0,0,0,0,0,0,0,0,0
20200212,046731,嘉聯益元大93購03,,,,,0.00,0.00,0,0,0,0,0,0,0,0,0,0,0,0,0
20200212,046732,啟碁元大93購01,,,,,0.00,0.00,0,0,0,0,0,0,0,0,0,0,0,0,0
20200212,046733,鴻海亞東94購01,,,,,0.00,0.00,0,0,0,0,0,0,0,0,0,0,0,0,0
20200212,046734,華通國票93購02,0.47,1.26,0.47,1.26,+0.77,157.14,166000,5,176220,0,0,0,0,0,0,106000,60000,46000,46000
20200212,046735,聯發科國票93購01,,,,,0.00,0.00,0,0,0,0,0,0,0,0,0,0,0,0,0
20200212,046736,儒鴻群益93購01,0.63,0.63,0.60,0.60,0.00,0.00,20000,2,12300,0,0,0,0,0,0,20000,0,20000,20000
20200212,046737,鴻海群益93購04,0.56,0.95,0.56,0.95,+0.50,111.11,49000,8,30320,0,0,0,0,0,0,48000,0,48000,48000
20200212,046738,台積電群益93購05,19.80,19.80,19.50,19.80,0.00,0.00,25000,3,493500,0,0,0,0,0,0,25000,0,25000,25000
20200212,046739,全新群益93購01,,,,,0.00,0.00,0,0,0,0,0,0,0,0,0,0,0,0,0
20200212,04673P,友達統一94售04,,,,,0.00,0.00,0,0,0,0,0,0,0,0,0,0,0,0,0
20200212,046740,大立光群益95購01,5.35,5.50,5.35,5.50,+0.80,17.02,21000,3,114300,0,0,0,0,0,0,21000,0,21000,21000
20200212,046741,GIS群益94購01,0.21,0.22,0.21,0.22,0.00,0.00,16000,3,3460,0,0,0,0,0,0,0,16000,-16000,-16000
20200212,046742,智原日盛93購01,,,,,0.00,0.00,0,0,0,0,0,0,0,0,0,0,0,0,0
20200212,046743,啟碁日盛93購01,,,,,0.00,0.00,0,0,0,0,0,0,0,0,0,0,0,0,0
20200212,046744,元油2X凱基94購01,,,,,0.00,0.00,0,0,0,0,0,0,0,0,0,0,0,0,0
20200212,046745,國喬凱基93購01,,,,,0.00,0.00,0,0,0,0,0,0,0,0,0,0,0,0,0
20200212,046746,儒鴻凱基93購03,0.28,0.28,0.28,0.28,-0.08,-22.22,20000,1,5600,0,0,0,0,0,0,20000,0,20000,20000
20200212,046747,華新凱基93購02,,,,,0.00,0.00,0,0,0,0,0,0,0,0,0,0,0,0,0
20200212,046748,喬山凱基93購01,,,,,0.00,0.00,0,0,0,0,0,0,0,0,0,0,0,0,0
20200212,046749,為升凱基93購01,,,,,0.00,0.00,0,0,0,0,0,0,0,0,0,0,0,0,0
20200212,04674P,全新統一95售01,1.03,1.03,1.03,1.03,-0.13,-11.21,19000,1,19570,0,0,0,0,0,0,0,19000,-19000,-19000
20200212,046750,鴻海凱基93購17,1.79,1.92,1.79,1.88,0.00,0.00,30000,6,55700,0,0,0,0,0,0,0,30000,-30000,-30000
20200212,046751,鴻海凱基93購18,,,,,0.00,0.00,0,0,0,0,0,0,0,0,0,0,0,0,0
20200212,046752,華泰凱基93購01,,,,,0.00,0.00,0,0,0,0,0,0,0,0,0,0,0,0,0
20200212,046753,台積電凱基93購04,5.00,5.60,5.00,5.60,+0.93,19.91,29000,8,154150,0,0,0,0,0,0,19000,4000,15000,15000
20200212,046754,技嘉凱基93購05,,,,,0.00,0.00,0,0,0,0,0,0,0,0,0,0,0,0,0
20200212,046755,瑞昱凱基93購05,2.40,2.60,2.40,2.60,+0.27,11.59,40000,4,98800,0,0,0,0,0,0,20000,20000,0,0
20200212,046756,廣達凱基93購01,1.19,1.28,1.19,1.28,-0.05,-3.76,40000,3,48500,0,0,0,0,0,0,40000,0,40000,40000
20200212,046757,漢唐凱基93購02,,,,,0.00,0.00,0,0,0,0,0,0,0,0,0,0,0,0,0
20200212,046758,聯發科凱基93購05,,,,,0.00,0.00,0,0,0,0,0,0,0,0,0,0,0,0,0
20200212,046759,聯發科凱基93購06,,,,,0.00,0.00,0,0,0,0,0,0,0,0,0,0,0,0,0
20200212,04675P,華新科統一94售05,,,,,0.00,0.00,0,0,0,0,0,0,0,0,0,0,0,0,0
20200212,046760,冠德凱基93購02,,,,,0.00,0.00,0,0,0,0,0,0,0,0,0,0,0,0,0
20200212,046761,淘帝凱基93購01,,,,,0.00,0.00,0,0,0,0,0,0,0,0,0,0,0,0,0
20200212,046762,大立光凱基93購13,1.89,1.89,1.89,1.89,0.00,0.00,10000,1,18900,0,0,0,0,0,0,0,10000,-10000,-10000
20200212,046763,奇鋐凱基93購01,,,,,0.00,0.00,0,0,0,0,0,0,0,0,0,0,0,0,0
20200212,046764,亞光凱基93購03,,,,,0.00,0.00,0,0,0,0,0,0,0,0,0,0,0,0,0
20200212,046765,明泰凱基93購02,,,,,0.00,0.00,0,0,0,0,0,0,0,0,0,0,0,0,0
20200212,046766,智易凱基93購01,,,,,0.00,0.00,0,0,0,0,0,0,0,0,0,0,0,0,0
20200212,046767,南茂凱基93購03,0.44,0.47,0.43,0.47,+0.01,2.17,50000,17,22350,0,0,0,0,0,0,40000,10000,30000,30000
20200212,046768,柏文凱基93購01,,,,,0.00,0.00,0,0,0,0,0,0,0,0,0,0,0,0,0
20200212,046769,百和凱基93購06,,,,,0.00,0.00,0,0,0,0,0,0,0,0,0,0,0,0,0
20200212,04676P,彩晶統一94售03,,,,,0.00,0.00,0,0,0,0,0,0,0,0,0,0,0,0,0
20200212,046770,聯發科國泰94購01,1.70,1.96,1.67,1.93,+0.44,29.53,441000,35,815560,0,0,0,0,0,0,252000,289000,-37000,-37000
20200212,046771,聯發科國泰94購02,1.16,1.35,1.14,1.26,+0.28,28.57,200000,33,250150,0,0,0,0,0,0,130000,150000,-20000,-20000
20200212,046772,台積電富邦93購02,,,,,0.00,0.00,0,0,0,0,0,0,0,0,0,0,0,0,0
20200212,046773,GIS富邦94購01,,,,,0.00,0.00,0,0,0,0,0,0,0,0,0,0,0,0,0
20200212,046774,瑞昱台新93購01,2.48,2.48,2.48,2.48,+0.23,10.22,10000,1,24800,0,0,0,0,0,0,0,10000,-10000,-10000
20200212,046775,聯發科台新93購01,0.77,0.77,0.77,0.77,+0.26,50.98,1000,1,770,0,0,0,0,0,0,0,1000,-1000,-1000
20200212,046776,聯詠台新93購01,,,,,0.00,0.00,0,0,0,0,0,0,0,0,0,0,0,0,0
20200212,046777,明泰康和93購01,,,,,0.00,0.00,0,0,0,0,0,0,0,0,0,0,0,0,0
20200212,046778,臺股指康和93購01,,,,,0.00,0.00,0,0,0,0,0,0,0,0,0,0,0,0,0
20200212,046779,臺股指康和93購02,,,,,0.00,0.00,0,0,0,0,0,0,0,0,0,0,0,0,0
20200212,04677P,臺股指統一94售02,,,,,0.00,0.00,0,0,0,0,0,0,0,0,0,0,0,0,0
20200212,046780,FB上証永豐93購01,,,,,0.00,0.00,0,0,0,0,0,0,0,0,0,0,0,0,0
20200212,046781,A50永豐93購01,,,,,0.00,0.00,0,0,0,0,0,0,0,0,0,0,0,0,0
20200212,046782,建準永豐93購01,,,,,0.00,0.00,0,0,0,0,0,0,0,0,0,0,0,0,0
20200212,046783,奇力新永豐93購02,,,,,0.00,0.00,0,0,0,0,0,0,0,0,0,0,0,0,0
20200212,046784,嘉晶永豐93購02,,,,,0.00,0.00,0,0,0,0,0,0,0,0,0,0,0,0,0
20200212,046785,禾伸堂永豐93購01,0.96,0.96,0.88,0.92,-0.10,-9.8,80000,35,74000,0,0,0,0,0,0,53000,27000,26000,26000
20200212,046786,欣興永豐93購02,,,,,0.00,0.00,0,0,0,0,0,0,0,0,0,0,0,0,0
20200212,046787,和鑫永豐93購01,0.12,0.12,0.12,0.12,+0.01,9.09,50000,1,6000,0,0,0,0,0,0,50000,0,50000,50000
20200212,046788,貿聯永豐93購01,,,,,0.00,0.00,0,0,0,0,0,0,0,0,0,0,0,0,0
20200212,046789,祥碩永豐93購01,,,,,0.00,0.00,0,0,0,0,0,0,0,0,0,0,0,0,0
20200212,04678P,臺股指統一94售03,,,,,0.00,0.00,0,0,0,0,0,0,0,0,0,0,0,0,0
20200212,046790,康友永豐93購01,0.55,0.63,0.55,0.63,+0.08,14.55,136000,4,78920,0,0,0,0,0,0,0,136000,-136000,-136000
20200212,046791,台郡統一96購01,2.36,2.53,2.30,2.53,+0.85,50.6,122000,30,291490,0,0,0,0,0,0,63000,34000,29000,29000
20200212,046792,京元電元富96購01,0.87,0.98,0.87,0.93,+0.01,1.09,366000,37,335630,0,0,0,0,0,0,172000,194000,-22000,-22000
20200212,046793,聯發科元富99購01,1.17,1.33,1.17,1.32,+0.22,20.0,737000,22,932130,0,0,0,0,0,0,365000,312000,53000,53000
20200212,046794,智伸科元富93購01,0.26,0.26,0.26,0.26,-0.01,-3.7,1000,1,260,0,0,0,0,0,0,1000,0,1000,1000
20200212,046795,瀚宇博元富93購01,0.44,0.59,0.44,0.59,+0.12,25.53,570000,28,288890,0,0,0,0,0,0,346000,204000,142000,142000
20200212,046796,南電元富93購01,,,,,0.00,0.00,0,0,0,0,0,0,0,0,0,0,0,0,0
20200212,046797,T50反1元大96購01,0.11,0.11,0.09,0.09,-0.03,-25.0,720000,7,70400,0,0,0,0,0,0,380000,220000,160000,160000
20200212,046798,元油2X元大96購01,0.19,0.19,0.19,0.19,+0.01,5.56,10000,1,1900,0,0,0,0,0,0,0,10000,-10000,-10000
20200212,046799,儒鴻元大93購01,0.43,0.52,0.42,0.52,-0.03,-5.45,111000,6,50040,0,0,0,0,0,0,57000,54000,3000,3000
20200212,04679P,臺股指統一94售04,,,,,0.00,0.00,0,0,0,0,0,0,0,0,0,0,0,0,0
20200212,046800,儒鴻元大93購02,0.35,0.35,0.32,0.32,-0.05,-13.51,410000,4,131520,0,0,0,0,0,0,410000,0,410000,410000
20200212,046801,中橡元大93購01,,,,,0.00,0.00,0,0,0,0,0,0,0,0,0,0,0,0,0
20200212,046802,聯電元大93購01,3.21,3.46,3.21,3.41,0.00,0.00,22000,6,72320,0,0,0,0,0,0,8000,14000,-6000,-6000
20200212,046803,可成元大93購03,4.22,4.45,4.22,4.45,0.00,0.00,21000,3,89450,0,0,0,0,0,0,0,21000,-21000,-21000
20200212,046804,群創元大94購01,1.44,1.44,1.44,1.44,-0.06,-4.0,108000,2,155520,0,0,0,0,0,0,108000,0,108000,108000
20200212,046805,TPK元大93購05,,,,,0.00,0.00,0,0,0,0,0,0,0,0,0,0,0,0,0
20200212,046806,瀚宇博元大93購03,0.67,0.82,0.67,0.82,+0.10,13.89,112000,3,82540,0,0,0,0,0,0,62000,50000,12000,12000
20200212,046807,臺股指元大93購27,,,,,0.00,0.00,0,0,0,0,0,0,0,0,0,0,0,0,0
20200212,046808,臺股指元大93購28,,,,,0.00,0.00,0,0,0,0,0,0,0,0,0,0,0,0,0
20200212,046809,臺股指元大93購29,,,,,0.00,0.00,0,0,0,0,0,0,0,0,0,0,0,0,0
20200212,04680P,臺股指統一94售05,,,,,0.00,0.00,0,0,0,0,0,0,0,0,0,0,0,0,0
20200212,046810,瑞昱第一93購01,,,,,0.00,0.00,0,0,0,0,0,0,0,0,0,0,0,0,0
20200212,046811,和大凱基93購01,,,,,0.00,0.00,0,0,0,0,0,0,0,0,0,0,0,0,0
20200212,046812,為升凱基93購02,,,,,0.00,0.00,0,0,0,0,0,0,0,0,0,0,0,0,0
20200212,046813,聯電凱基96購01,3.63,3.79,3.63,3.77,+0.12,3.29,64000,14,234700,0,0,0,0,0,0,43000,21000,22000,22000
20200212,046814,鴻海凱基93購20,2.93,3.51,0.02,3.51,+0.82,30.48,90000,8,251300,0,0,0,0,0,0,40000,50000,-10000,-10000
20200212,046815,台積電凱基93購07,,,,,0.00,0.00,0,0,0,0,0,0,0,0,0,0,0,0,0
20200212,046816,智邦凱基93購02,,,,,0.00,0.00,0,0,0,0,0,0,0,0,0,0,0,0,0
20200212,046817,台光電凱基93購09,,,,,0.00,0.00,0,0,0,0,0,0,0,0,0,0,0,0,0
20200212,046818,奇力新凱基93購04,8.45,8.55,6.20,8.35,-0.25,-2.91,42000,26,353300,0,0,0,0,0,0,41000,1000,40000,40000
20200212,046819,台中銀凱基93購01,,,,,0.00,0.00,0,0,0,0,0,0,0,0,0,0,0,0,0
20200212,04681P,臺股指統一94售06,,,,,0.00,0.00,0,0,0,0,0,0,0,0,0,0,0,0,0
20200212,046820,大立光凱基93購15,,,,,0.00,0.00,0,0,0,0,0,0,0,0,0,0,0,0,0
20200212,046821,奇鋐凱基93購02,,,,,0.00,0.00,0,0,0,0,0,0,0,0,0,0,0,0,0
20200212,046822,亞光凱基93購04,,,,,0.00,0.00,0,0,0,0,0,0,0,0,0,0,0,0,0
20200212,046823,揚明光凱基93購01,,,,,0.00,0.00,0,0,0,0,0,0,0,0,0,0,0,0,0
20200212,046824,祥碩凱基93購06,,,,,0.00,0.00,0,0,0,0,0,0,0,0,0,0,0,0,0
20200212,046825,瀚宇博凱基93購02,,,,,0.00,0.00,0,0,0,0,0,0,0,0,0,0,0,0,0
20200212,046826,統一群益94購01,,,,,0.00,0.00,0,0,0,0,0,0,0,0,0,0,0,0,0
20200212,046827,漢唐群益93購02,,,,,0.00,0.00,0,0,0,0,0,0,0,0,0,0,0,0,0
20200212,046828,聯發科群益94購01,1.01,1.01,0.98,0.98,0.00,0.00,11000,2,10810,0,0,0,0,0,0,10000,1000,9000,9000
20200212,046829,義隆群益93購01,0.48,0.50,0.48,0.50,0.00,0.00,63000,4,30340,0,0,0,0,0,0,63000,0,63000,63000
20200212,04682P,臺股指統一96售01,0.17,0.17,0.15,0.15,-0.03,-16.67,698000,14,108750,0,0,0,0,0,0,9000,629000,-620000,-620000
20200212,046830,大立光群益93購07,,,,,0.00,0.00,0,0,0,0,0,0,0,0,0,0,0,0,0
20200212,046831,大立光群益94購01,3.49,3.98,3.49,3.98,+0.80,25.16,30000,5,114120,0,0,0,0,0,0,0,30000,-30000,-30000
20200212,046832,嘉晶群益93購01,,,,,0.00,0.00,0,0,0,0,0,0,0,0,0,0,0,0,0
20200212,046833,晶技群益93購01,,,,,0.00,0.00,0,0,0,0,0,0,0,0,0,0,0,0,0
20200212,046834,致伸群益93購02,,,,,0.00,0.00,0,0,0,0,0,0,0,0,0,0,0,0,0
20200212,046835,傳奇群益93購01,,,,,0.00,0.00,0,0,0,0,0,0,0,0,0,0,0,0,0
20200212,046836,聯茂群益93購01,0.16,0.20,0.16,0.16,0.00,0.00,30000,4,5300,0,0,0,0,0,0,30000,0,30000,30000
20200212,046837,易華電群益93購03,,,,,0.00,0.00,0,0,0,0,0,0,0,0,0,0,0,0,0
20200212,046838,勤誠群益93購01,,,,,0.00,0.00,0,0,0,0,0,0,0,0,0,0,0,0,0
20200212,046839,喬山台新93購01,,,,,0.00,0.00,0,0,0,0,0,0,0,0,0,0,0,0,0
20200212,04683P,南亞科元大94售04,,,,,0.00,0.00,0,0,0,0,0,0,0,0,0,0,0,0,0
20200212,046840,晶技台新93購01,,,,,0.00,0.00,0,0,0,0,0,0,0,0,0,0,0,0,0
20200212,046841,智伸科台新93購01,,,,,0.00,0.00,0,0,0,0,0,0,0,0,0,0,0,0,0
20200212,046842,喬山永豐93購01,,,,,0.00,0.00,0,0,0,0,0,0,0,0,0,0,0,0,0
20200212,046843,上銀永豐93購01,,,,,0.00,0.00,0,0,0,0,0,0,0,0,0,0,0,0,0
20200212,046844,旺宏永豐93購01,,,,,0.00,0.00,0,0,0,0,0,0,0,0,0,0,0,0,0
20200212,046845,燿華永豐93購01,,,,,0.00,0.00,0,0,0,0,0,0,0,0,0,0,0,0,0
20200212,046846,智伸科永豐93購01,,,,,0.00,0.00,0,0,0,0,0,0,0,0,0,0,0,0,0
20200212,046847,志超永豐93購01,,,,,0.00,0.00,0,0,0,0,0,0,0,0,0,0,0,0,0
20200212,046848,和大元大93購01,,,,,0.00,0.00,0,0,0,0,0,0,0,0,0,0,0,0,0
20200212,046849,台積電元大93購10,,,,,0.00,0.00,0,0,0,0,0,0,0,0,0,0,0,0,0
20200212,04684P,欣興元大94售07,,,,,0.00,0.00,0,0,0,0,0,0,0,0,0,0,0,0,0
20200212,046850,台積電元大93購11,,,,,0.00,0.00,0,0,0,0,0,0,0,0,0,0,0,0,0
20200212,046851,台積電元大93購12,,,,,0.00,0.00,0,0,0,0,0,0,0,0,0,0,0,0,0
20200212,046852,燿華元大93購02,0.45,0.61,0.45,0.61,+0.09,17.31,523000,4,277050,0,0,0,0,0,0,20000,503000,-483000,-483000
20200212,046853,友達元大93購03,,,,,0.00,0.00,0,0,0,0,0,0,0,0,0,0,0,0,0
20200212,046854,可成元大93購04,3.55,3.81,3.55,3.81,+0.82,27.42,21000,3,75410,0,0,0,0,0,0,0,21000,-21000,-21000
20200212,046855,嘉晶元大94購01,0.35,0.44,0.35,0.40,+0.07,21.21,439000,4,191060,0,0,0,0,0,0,10000,429000,-419000,-419000
20200212,046856,健鼎元大93購01,0.33,0.48,0.33,0.48,+0.32,200.0,83000,2,29640,0,0,0,0,0,0,15000,68000,-53000,-53000
20200212,046857,群創元大93購06,,,,,0.00,0.00,0,0,0,0,0,0,0,0,0,0,0,0,0
20200212,046858,群創元大94購02,1.33,1.33,1.27,1.29,-0.02,-1.53,517000,11,664820,0,0,0,0,0,0,517000,24000,493000,493000
20200212,046859,智伸科元大93購03,0.51,0.51,0.51,0.51,-0.02,-3.77,59000,1,30090,0,0,0,0,0,0,59000,0,59000,59000
20200212,04685P,訊芯元大94售02,1.33,1.33,1.26,1.26,-0.19,-13.1,20000,4,25530,0,0,0,0,0,0,1000,19000,-18000,-18000
20200212,046860,致伸元大93購02,,,,,0.00,0.00,0,0,0,0,0,0,0,0,0,0,0,0,0
20200212,046861,和碩元大93購01,7.40,7.40,7.30,7.30,-0.25,-3.31,17000,3,125100,0,0,0,0,0,0,17000,0,17000,17000
20200212,046862,台郡元大94購01,3.40,3.48,3.40,3.48,+1.50,75.76,12000,2,40880,0,0,0,0,0,0,12000,0,12000,12000
20200212,046863,康友元大93購01,0.87,1.03,0.87,0.90,-0.03,-3.23,227000,7,210600,0,0,0,0,0,0,20000,207000,-187000,-187000
20200212,046864,和大統一97購01,0.75,0.76,0.70,0.76,-0.01,-1.3,472000,20,351000,0,0,0,0,0,0,154000,306000,-152000,-152000
20200212,046865,鴻海統一95購01,,,,,0.00,0.00,0,0,0,0,0,0,0,0,0,0,0,0,0
20200212,046866,台積電統一94購03,3.93,4.00,3.90,3.98,+0.15,3.92,35000,9,138450,0,0,0,0,0,0,30000,0,30000,30000
20200212,046867,瑞昱統一93購01,,,,,0.00,0.00,0,0,0,0,0,0,0,0,0,0,0,0,0
20200212,046868,瑞昱統一93購02,,,,,0.00,0.00,0,0,0,0,0,0,0,0,0,0,0,0,0
20200212,046869,聯發科統一95購01,0.67,0.75,0.67,0.72,+0.15,26.32,458000,9,331260,0,0,0,0,0,0,108000,350000,-242000,-242000
20200212,04686P,台積電凱基94售23,,,,,0.00,0.00,0,0,0,0,0,0,0,0,0,0,0,0,0
20200212,046870,大立光統一95購01,1.94,1.94,1.94,1.94,+0.22,12.79,9000,1,17460,0,0,0,0,0,0,9000,0,9000,9000
20200212,046871,美律元富93購01,,,,,0.00,0.00,0,0,0,0,0,0,0,0,0,0,0,0,0
20200212,046872,全新元富93購02,1.17,1.17,1.17,1.17,+0.14,13.59,18000,2,21060,0,0,0,0,0,0,18000,0,18000,18000
20200212,046873,可成元富93購01,,,,,0.00,0.00,0,0,0,0,0,0,0,0,0,0,0,0,0
20200212,046874,聯詠元富93購01,,,,,0.00,0.00,0,0,0,0,0,0,0,0,0,0,0,0,0
20200212,046875,康友元富93購01,2.99,3.14,2.99,3.14,0.00,0.00,12000,2,36480,0,0,0,0,0,0,12000,0,12000,12000
20200212,046876,國巨國泰94購01,,,,,0.00,0.00,0,0,0,0,0,0,0,0,0,0,0,0,0
20200212,046877,燿華國泰94購01,0.88,1.02,0.88,1.00,+0.14,16.28,464000,19,454940,0,0,0,0,0,0,102000,444000,-342000,-342000
20200212,046878,康友國泰94購01,2.13,2.13,2.13,2.13,+0.09,4.41,10000,1,21300,0,0,0,0,0,0,10000,0,10000,10000
20200212,046879,T50反1永昌93購01,,,,,0.00,0.00,0,0,0,0,0,0,0,0,0,0,0,0,0
20200212,04687P,全新凱基94售02,0.84,0.84,0.77,0.77,-0.35,-31.25,75000,26,60480,0,0,0,0,0,0,23000,51000,-28000,-28000
20200212,046880,瑞昱永昌93購01,2.84,2.84,2.84,2.84,0.00,0.00,10000,1,28400,0,0,0,0,0,0,0,10000,-10000,-10000
20200212,046881,智原富邦99購01,0.64,0.68,0.63,0.68,+0.03,4.62,84000,16,55560,0,0,0,0,0,0,44000,40000,4000,4000
20200212,046882,智易富邦97購01,0.15,0.19,0.15,0.15,0.00,0.00,107000,4,16100,0,0,0,0,0,0,105000,2000,103000,103000
20200212,046883,友達第一93購01,,,,,0.00,0.00,0,0,0,0,0,0,0,0,0,0,0,0,0
20200212,046884,元油反群益95購01,0.61,0.61,0.61,0.61,0.00,0.00,5000,1,3050,0,0,0,0,0,0,5000,0,5000,5000
20200212,046885,卜蜂群益93購01,,,,,0.00,0.00,0,0,0,0,0,0,0,0,0,0,0,0,0
20200212,046886,喬山群益93購01,,,,,0.00,0.00,0,0,0,0,0,0,0,0,0,0,0,0,0
20200212,046887,華通群益93購01,,,,,0.00,0.00,0,0,0,0,0,0,0,0,0,0,0,0,0
20200212,046888,鴻海群益93購05,0.10,0.10,0.10,0.10,0.00,0.00,50000,1,5000,0,0,0,0,0,0,50000,0,50000,50000
20200212,046889,燿華群益93購02,,,,,0.00,0.00,0,0,0,0,0,0,0,0,0,0,0,0,0
20200212,04688P,大立光凱基94售09,,,,,0.00,0.00,0,0,0,0,0,0,0,0,0,0,0,0,0
20200212,046890,瑞昱群益93購02,2.04,2.04,2.04,2.04,+0.26,14.61,10000,1,20400,0,0,0,0,0,0,0,10000,-10000,-10000
20200212,046891,南亞科群益93購01,,,,,0.00,0.00,0,0,0,0,0,0,0,0,0,0,0,0,0
20200212,046892,聯發科群益93購04,,,,,0.00,0.00,0,0,0,0,0,0,0,0,0,0,0,0,0
20200212,046893,華新科群益94購01,,,,,0.00,0.00,0,0,0,0,0,0,0,0,0,0,0,0,0
20200212,046894,日月光群益93購01,1.15,1.44,1.15,1.44,+0.38,35.85,4000,4,5170,0,0,0,0,0,0,4000,0,4000,4000
20200212,046895,智伸科群益93購02,,,,,0.00,0.00,0,0,0,0,0,0,0,0,0,0,0,0,0
20200212,046896,臻鼎群益94購01,0.62,0.62,0.62,0.62,+0.10,19.23,40000,2,24800,0,0,0,0,0,0,40000,0,40000,40000
20200212,046897,康舒群益93購01,,,,,0.00,0.00,0,0,0,0,0,0,0,0,0,0,0,0,0
20200212,046898,南茂麥證93購01,,,,,0.00,0.00,0,0,0,0,0,0,0,0,0,0,0,0,0
20200212,046899,鴻海凱基93購21,,,,,0.00,0.00,0,0,0,0,0,0,0,0,0,0,0,0,0
20200212,04689P,台積電中信94售03,,,,,0.00,0.00,0,0,0,0,0,0,0,0,0,0,0,0,0
20200212,046900,旺宏凱基93購02,,,,,0.00,0.00,0,0,0,0,0,0,0,0,0,0,0,0,0
20200212,046901,英業達凱基93購02,0.37,0.37,0.37,0.37,-0.05,-11.9,10000,1,3700,0,0,0,0,0,0,0,10000,-10000,-10000
20200212,046902,台光電凱基93購10,,,,,0.00,0.00,0,0,0,0,0,0,0,0,0,0,0,0,0
20200212,046903,友達凱基99購01,,,,,0.00,0.00,0,0,0,0,0,0,0,0,0,0,0,0,0
20200212,046904,大毅凱基93購01,,,,,0.00,0.00,0,0,0,0,0,0,0,0,0,0,0,0,0
20200212,046905,新光金凱基99購01,1.59,1.60,1.58,1.59,+0.03,1.92,114000,24,181430,0,0,0,0,0,0,64000,50000,14000,14000
20200212,046906,新光金凱基99購02,1.20,1.20,1.18,1.20,+0.02,1.69,28000,16,33520,0,0,0,0,0,0,28000,0,28000,28000
20200212,046907,華晶科凱基93購01,,,,,0.00,0.00,0,0,0,0,0,0,0,0,0,0,0,0,0
20200212,046908,達運凱基93購01,,,,,0.00,0.00,0,0,0,0,0,0,0,0,0,0,0,0,0
20200212,046909,聯茂凱基93購06,,,,,0.00,0.00,0,0,0,0,0,0,0,0,0,0,0,0,0
20200212,04690P,國巨群益94售06,0.09,0.11,0.09,0.10,-0.02,-16.67,130000,11,12600,0,0,0,0,0,0,50000,50000,0,0
20200212,046910,超眾凱基93購06,,,,,0.00,0.00,0,0,0,0,0,0,0,0,0,0,0,0,0
20200212,046911,達方凱基93購01,,,,,0.00,0.00,0,0,0,0,0,0,0,0,0,0,0,0,0
20200212,046912,巨大凱基93購02,,,,,0.00,0.00,0,0,0,0,0,0,0,0,0,0,0,0,0
20200212,046913,世紀鋼凱基93購07,,,,,0.00,0.00,0,0,0,0,0,0,0,0,0,0,0,0,0
20200212,046914,友達台新96購01,,,,,0.00,0.00,0,0,0,0,0,0,0,0,0,0,0,0,0
20200212,046915,禾伸堂台新93購01,2.04,2.04,1.96,1.99,-0.34,-14.59,16000,7,31900,0,0,0,0,0,0,6000,10000,-4000,-4000
20200212,046916,欣興台新93購01,,,,,0.00,0.00,0,0,0,0,0,0,0,0,0,0,0,0,0
20200212,046917,力山永豐93購01,,,,,0.00,0.00,0,0,0,0,0,0,0,0,0,0,0,0,0
20200212,046918,台光電永豐93購02,,,,,0.00,0.00,0,0,0,0,0,0,0,0,0,0,0,0,0
20200212,046919,大毅永豐93購01,3.56,3.56,3.28,3.28,-0.13,-3.81,18000,6,63660,0,0,0,0,0,0,17000,1000,16000,16000
20200212,04691P,智邦群益94售02,1.01,1.07,1.01,1.07,+0.04,3.88,81000,4,82690,0,0,0,0,0,0,0,81000,-81000,-81000
20200212,046920,華晶科永豐93購01,,,,,0.00,0.00,0,0,0,0,0,0,0,0,0,0,0,0,0
20200212,046921,日電貿永豐93購01,0.51,0.53,0.48,0.49,0.00,0.00,264000,20,130340,0,0,0,0,0,0,244000,20000,224000,224000
20200212,046922,國巨國泰94購02,,,,,0.00,0.00,0,0,0,0,0,0,0,0,0,0,0,0,0
20200212,046923,友達國泰94購01,,,,,0.00,0.00,0,0,0,0,0,0,0,0,0,0,0,0,0
20200212,046924,華新科國泰94購02,,,,,0.00,0.00,0,0,0,0,0,0,0,0,0,0,0,0,0
20200212,046925,華新科國泰94購03,,,,,0.00,0.00,0,0,0,0,0,0,0,0,0,0,0,0,0
20200212,046926,易華電國泰94購02,,,,,0.00,0.00,0,0,0,0,0,0,0,0,0,0,0,0,0
20200212,046927,上銀富邦95購01,,,,,0.00,0.00,0,0,0,0,0,0,0,0,0,0,0,0,0
20200212,046928,奇鋐富邦97購01,0.32,0.34,0.32,0.34,0.00,0.00,105000,3,34700,0,0,0,0,0,0,0,105000,-105000,-105000
20200212,046929,大立光統一93購03,3.69,3.73,3.69,3.73,+0.57,18.04,13000,2,48090,0,0,0,0,0,0,13000,0,13000,13000
20200212,04692P,大立光群益94售06,0.60,0.60,0.58,0.60,-0.11,-15.49,25000,3,14900,0,0,0,0,0,0,0,25000,-25000,-25000
20200212,046930,亞光統一93購01,,,,,0.00,0.00,0,0,0,0,0,0,0,0,0,0,0,0,0
20200212,046931,聯詠統一93購01,1.17,1.29,1.17,1.29,+0.20,18.35,703000,38,877660,0,0,0,0,0,0,509000,194000,315000,315000
20200212,046932,聯詠統一93購02,2.39,2.51,2.39,2.51,+0.39,18.4,49000,13,119870,0,0,0,0,0,0,49000,1000,48000,48000
20200212,046933,台泥元富93購01,1.52,1.62,1.52,1.60,+0.02,1.27,184000,3,286520,0,0,0,0,0,0,184000,0,184000,184000
20200212,046934,智邦元富96購01,0.83,0.92,0.76,0.76,-0.05,-6.17,442000,22,378170,0,0,0,0,0,0,268000,174000,94000,94000
20200212,046935,義隆元富93購01,,,,,0.00,0.00,0,0,0,0,0,0,0,0,0,0,0,0,0
20200212,046936,祥碩元富93購01,,,,,0.00,0.00,0,0,0,0,0,0,0,0,0,0,0,0,0
20200212,046937,聯電元大99購01,3.36,3.55,3.36,3.51,+0.03,0.86,34000,8,115570,0,0,0,0,0,0,20000,27000,-7000,-7000
20200212,046938,致茂元大93購02,1.05,1.40,1.05,1.40,+0.44,45.83,75000,6,80460,0,0,0,0,0,0,69000,6000,63000,63000
20200212,046939,燿華元大96購01,1.62,1.86,1.62,1.84,+0.17,10.18,131000,19,230270,0,0,0,0,0,0,29000,107000,-78000,-78000
20200212,04693P,超眾群益95售01,0.99,0.99,0.99,0.99,-0.03,-2.94,11000,2,10890,0,0,0,0,0,0,11000,0,11000,11000
20200212,046940,瑞昱元大93購07,4.11,4.37,4.06,4.06,+0.51,14.37,19000,8,79260,0,0,0,0,0,0,0,19000,-19000,-19000
20200212,046941,瑞昱元大93購08,3.97,4.19,3.91,3.91,+0.53,15.68,15000,6,59600,0,0,0,0,0,0,0,15000,-15000,-15000
20200212,046942,友達元大99購01,3.11,3.11,3.11,3.11,+0.07,2.3,2000,1,6220,0,0,0,0,0,0,0,2000,-2000,-2000
20200212,046943,聯發科元大93購06,0.88,0.90,0.88,0.90,+0.33,57.89,2000,2,1780,0,0,0,0,0,0,0,2000,-2000,-2000
20200212,046944,奇力新元大96購01,8.45,8.60,8.40,8.60,+0.45,5.52,89000,28,754250,0,0,0,0,0,0,81000,73000,8000,8000
20200212,046945,大毅元大93購01,,,,,0.00,0.00,0,0,0,0,0,0,0,0,0,0,0,0,0
20200212,046946,益航元大94購01,0.19,0.19,0.19,0.19,+0.03,18.75,6000,1,1140,0,0,0,0,0,0,6000,0,6000,6000
20200212,046947,禾伸堂元大93購01,3.39,3.41,3.26,3.41,-0.02,-0.58,26000,7,86860,0,0,0,0,0,0,15000,11000,4000,4000
20200212,046948,聯詠元大93購03,1.21,1.31,1.21,1.31,+0.27,25.96,30000,4,37300,0,0,0,0,0,0,20000,10000,10000,10000
20200212,046949,群創元大99購01,1.96,1.97,1.92,1.93,0.00,0.00,142000,23,276580,0,0,0,0,0,0,106000,135000,-29000,-29000
20200212,04694P,TPK台新94售02,,,,,0.00,0.00,0,0,0,0,0,0,0,0,0,0,0,0,0
20200212,046950,隆達元大93購01,0.75,0.75,0.75,0.75,+0.04,5.63,200000,1,150000,0,0,0,0,0,0,200000,0,200000,200000
20200212,046951,GIS元大93購08,0.78,0.78,0.78,0.78,0.00,0.00,7000,1,5460,0,0,0,0,0,0,0,7000,-7000,-7000
20200212,046952,南茂元大93購02,,,,,0.00,0.00,0,0,0,0,0,0,0,0,0,0,0,0,0
20200212,046953,嘉聯益國票94購01,,,,,0.00,0.00,0,0,0,0,0,0,0,0,0,0,0,0,0
20200212,046954,同欣電國票93購01,1.98,2.50,1.98,2.50,+0.53,26.9,183000,15,404620,0,0,0,0,0,0,77000,106000,-29000,-29000
20200212,046955,康舒國票93購01,,,,,0.00,0.00,0,0,0,0,0,0,0,0,0,0,0,0,0
20200212,046956,矽力國票93購01,6.05,6.05,6.05,6.05,0.00,0.00,5000,1,30250,0,0,0,0,0,0,0,5000,-5000,-5000
20200212,046957,台達電中信93購01,,,,,0.00,0.00,0,0,0,0,0,0,0,0,0,0,0,0,0
20200212,046958,鴻海中信93購01,0.31,0.34,0.31,0.34,0.00,0.00,187000,11,60280,0,0,0,0,0,0,0,187000,-187000,-187000
20200212,046959,技嘉中信93購01,1.16,1.16,0.94,0.96,-0.09,-8.57,25000,3,24800,0,0,0,0,0,0,5000,20000,-15000,-15000
20200212,04695P,正崴康和94售01,0.65,0.65,0.65,0.65,-0.04,-5.8,245000,4,159250,0,0,0,0,0,0,0,245000,-245000,-245000
20200212,046960,台新金中信95購01,0.57,0.57,0.57,0.57,0.00,0.00,30000,1,17100,0,0,0,0,0,0,30000,0,30000,30000
20200212,046961,大立光中信95購02,3.36,3.69,3.36,3.67,+0.37,11.21,96000,19,344640,0,0,0,0,0,0,65000,61000,4000,4000
20200212,046962,群創中信95購03,1.68,1.68,1.68,1.68,+0.02,1.2,10000,1,16800,0,0,0,0,0,0,10000,0,10000,10000
20200212,046963,利勤中信93購01,,,,,0.00,0.00,0,0,0,0,0,0,0,0,0,0,0,0,0
20200212,046964,祥碩中信93購01,,,,,0.00,0.00,0,0,0,0,0,0,0,0,0,0,0,0,0
20200212,046965,復盛中信93購01,2.00,2.00,1.91,1.94,-0.09,-4.43,122000,21,237010,0,0,0,0,0,0,122000,0,122000,122000
20200212,046966,南茂中信93購01,,,,,0.00,0.00,0,0,0,0,0,0,0,0,0,0,0,0,0
20200212,046967,元油反群益93購01,,,,,0.00,0.00,0,0,0,0,0,0,0,0,0,0,0,0,0
20200212,046968,台積電群益94購03,3.17,3.43,3.08,3.43,+0.39,12.83,47000,11,153400,0,0,0,0,0,0,37000,17000,20000,20000
20200212,046969,聯發科群益93購05,0.76,0.76,0.76,0.76,+0.19,33.33,10000,1,7600,0,0,0,0,0,0,10000,0,10000,10000
20200212,04696P,亞德客國泰95售02,0.85,0.85,0.82,0.82,-0.01,-1.2,106000,2,87100,0,0,0,0,0,0,100000,6000,94000,94000
20200212,046970,聯詠群益93購01,0.35,0.35,0.35,0.35,+0.05,16.67,35000,1,12250,0,0,0,0,0,0,35000,0,35000,35000
20200212,046971,致伸群益93購03,,,,,0.00,0.00,0,0,0,0,0,0,0,0,0,0,0,0,0
20200212,046972,同欣電群益93購01,2.45,2.97,2.45,2.97,+0.55,22.73,22000,4,60140,0,0,0,0,0,0,10000,12000,-2000,-2000
20200212,046973,矽力群益93購01,4.71,5.10,4.71,5.10,+0.56,12.33,17000,3,80670,0,0,0,0,0,0,15000,2000,13000,13000
20200212,046974,上銀台新93購01,,,,,0.00,0.00,0,0,0,0,0,0,0,0,0,0,0,0,0
20200212,046975,元金2X永豐93購01,,,,,0.00,0.00,0,0,0,0,0,0,0,0,0,0,0,0,0
20200212,046976,國巨永豐93購02,,,,,0.00,0.00,0,0,0,0,0,0,0,0,0,0,0,0,0
20200212,046977,潤泰全永豐93購01,,,,,0.00,0.00,0,0,0,0,0,0,0,0,0,0,0,0,0
20200212,046978,復盛永豐93購01,0.29,0.29,0.27,0.27,0.00,0.00,7000,6,1970,0,0,0,0,0,0,7000,0,7000,7000
20200212,046979,台泥兆豐93購01,,,,,0.00,0.00,0,0,0,0,0,0,0,0,0,0,0,0,0
20200212,04697P,臺股指元富94售03,0.81,0.81,0.73,0.73,-0.14,-16.09,20000,2,15400,0,0,0,0,0,0,10000,10000,0,0
20200212,046980,智邦兆豐94購01,0.73,0.84,0.61,0.64,-0.04,-5.88,96000,17,72090,0,0,0,0,0,0,44000,51000,-7000,-7000
20200212,046981,智伸科兆豐94購01,1.12,1.12,1.12,1.12,+0.02,1.82,10000,1,11200,0,0,0,0,0,0,10000,0,10000,10000
20200212,046982,瀚宇博兆豐94購02,0.35,0.35,0.35,0.35,0.00,0.00,56000,2,19600,0,0,0,0,0,0,56000,0,56000,56000
20200212,046983,南茂兆豐94購01,0.33,0.33,0.33,0.33,-0.03,-8.33,50000,1,16500,0,0,0,0,0,0,50000,0,50000,50000
20200212,046984,友達日盛93購01,,,,,0.00,0.00,0,0,0,0,0,0,0,0,0,0,0,0,0
20200212,046985,大成鋼凱基93購02,,,,,0.00,0.00,0,0,0,0,0,0,0,0,0,0,0,0,0
20200212,046986,台積電凱基93購09,8.35,8.55,8.35,8.55,+1.10,14.77,20000,2,169000,0,0,0,0,0,0,0,20000,-20000,-20000
20200212,046987,智邦凱基93購04,0.80,0.98,0.01,0.60,-0.25,-29.41,128000,15,102040,0,0,0,0,0,0,96000,32000,64000,64000
20200212,046988,南亞科凱基93購02,0.78,0.78,0.78,0.78,-0.09,-10.34,30000,1,23400,0,0,0,0,0,0,30000,0,30000,30000
20200212,046989,可成凱基93購03,2.16,2.51,2.16,2.51,+0.60,31.41,29000,6,67970,0,0,0,0,0,0,0,29000,-29000,-29000
20200212,04698P,臺股指元富94售04,,,,,0.00,0.00,0,0,0,0,0,0,0,0,0,0,0,0,0
20200212,046990,奇鋐凱基93購03,,,,,0.00,0.00,0,0,0,0,0,0,0,0,0,0,0,0,0
20200212,046991,健策凱基93購04,4.90,4.90,4.77,4.77,+0.19,4.15,148000,22,715530,0,0,0,0,0,0,138000,40000,98000,98000
20200212,046992,智伸科凱基93購03,,,,,0.00,0.00,0,0,0,0,0,0,0,0,0,0,0,0,0
20200212,046993,世紀鋼凱基93購08,,,,,0.00,0.00,0,0,0,0,0,0,0,0,0,0,0,0,0
20200212,046994,臺股指凱基93購01,,,,,0.00,0.00,0,0,0,0,0,0,0,0,0,0,0,0,0
20200212,046995,臺股指凱基93購02,,,,,0.00,0.00,0,0,0,0,0,0,0,0,0,0,0,0,0
20200212,046996,國巨國泰94購03,,,,,0.00,0.00,0,0,0,0,0,0,0,0,0,0,0,0,0
20200212,046997,國巨國泰95購01,,,,,0.00,0.00,0,0,0,0,0,0,0,0,0,0,0,0,0
20200212,046998,同欣電國泰94購01,1.85,1.94,1.79,1.94,+0.20,11.49,42000,15,79020,0,0,0,0,0,0,24000,18000,6000,6000
20200212,046999,康控富邦99購01,0.36,0.39,0.36,0.38,+0.04,11.76,753000,18,280990,0,0,0,0,0,0,439000,304000,135000,135000
20200212,04699P,臺股指元富94售05,,,,,0.00,0.00,0,0,0,0,0,0,0,0,0,0,0,0,0
20200212,047000,和大統一93購01,0.08,0.08,0.08,0.08,-0.01,-11.11,100000,3,8000,0,0,0,0,0,0,0,100000,-100000,-100000
20200212,047001,大成鋼統一93購01,,,,,0.00,0.00,0,0,0,0,0,0,0,0,0,0,0,0,0
20200212,047002,鴻海統一93購04,1.98,2.35,1.98,2.35,+0.52,28.42,80000,4,162400,0,0,0,0,0,0,60000,20000,40000,40000
20200212,047003,鴻海統一93購05,1.41,1.96,1.41,1.96,+0.64,48.48,687000,22,1066780,0,0,0,0,0,0,228000,459000,-231000,-231000
20200212,047004,台積電統一99購01,4.06,4.16,4.05,4.16,+0.20,5.05,197000,20,807720,0,0,0,0,0,0,122000,65000,57000,57000
20200212,047005,南亞科統一93購03,1.65,1.65,1.65,1.65,-0.12,-6.78,10000,1,16500,0,0,0,0,0,0,10000,0,10000,10000
20200212,047006,大立光統一93購04,2.11,2.11,2.11,2.11,0.00,0.00,1000,1,2110,0,0,0,0,0,0,0,1000,-1000,-1000
20200212,047007,大立光統一93購05,1.29,1.40,1.29,1.40,+0.36,34.62,115000,11,153140,0,0,0,0,0,0,0,115000,-115000,-115000
20200212,047008,大立光統一93購06,,,,,0.00,0.00,0,0,0,0,0,0,0,0,0,0,0,0,0
20200212,047009,大立光統一93購07,2.80,2.87,2.80,2.87,0.00,0.00,16000,2,45360,0,0,0,0,0,0,0,16000,-16000,-16000
20200212,04700P,臺股指元富94售06,,,,,0.00,0.00,0,0,0,0,0,0,0,0,0,0,0,0,0
20200212,047010,聯詠統一93購05,0.63,0.72,0.60,0.70,+0.13,22.81,451000,37,309260,0,0,0,0,0,0,283000,168000,115000,115000
20200212,047011,鴻海元富93購01,,,,,0.00,0.00,0,0,0,0,0,0,0,0,0,0,0,0,0
20200212,047012,台積電元富93購02,,,,,0.00,0.00,0,0,0,0,0,0,0,0,0,0,0,0,0
20200212,047013,超眾元富96購01,0.30,0.30,0.30,0.30,-0.01,-3.23,30000,1,9000,0,0,0,0,0,0,0,30000,-30000,-30000
20200212,047014,元油反元大99購01,1.18,1.18,1.18,1.18,-0.06,-4.84,5000,1,5900,0,0,0,0,0,0,5000,0,5000,5000
20200212,047015,上銀元大93購03,3.46,3.46,3.46,3.46,+0.25,7.79,30000,2,103800,0,0,0,0,0,0,30000,0,30000,30000
20200212,047016,鴻海元大93購07,2.60,3.74,2.60,3.68,+1.09,42.08,139000,17,470880,0,0,0,0,0,0,120000,119000,1000,1000
20200212,047017,鴻海元大93購08,4.12,4.37,4.12,4.37,+0.90,25.94,13000,3,54310,0,0,0,0,0,0,0,13000,-13000,-13000
20200212,047018,鴻海元大93購09,4.35,4.99,4.35,4.99,+0.67,15.51,33000,5,152170,0,0,0,0,0,0,20000,13000,7000,7000
20200212,047019,台積電元大93購14,10.50,10.70,10.50,10.70,+0.50,4.9,37000,5,390900,0,0,0,0,0,0,12000,25000,-13000,-13000
20200212,04701P,臺股指元富94售07,,,,,0.00,0.00,0,0,0,0,0,0,0,0,0,0,0,0,0
20200212,047020,智邦元大93購04,1.83,1.92,1.79,1.92,+0.37,23.87,89000,8,165050,0,0,0,0,0,0,51000,38000,13000,13000
20200212,047021,台光電元大93購03,,,,,0.00,0.00,0,0,0,0,0,0,0,0,0,0,0,0,0
20200212,047022,聯發科元大93購07,,,,,0.00,0.00,0,0,0,0,0,0,0,0,0,0,0,0,0
20200212,047023,聯發科元大93購08,0.52,0.58,0.52,0.58,+0.22,61.11,22000,3,11550,0,0,0,0,0,0,20000,2000,18000,18000
20200212,047024,奇力新元大95購01,,,,,0.00,0.00,0,0,0,0,0,0,0,0,0,0,0,0,0
20200212,047025,可成元大93購05,0.77,0.77,0.77,0.77,0.00,0.00,1000,1,770,0,0,0,0,0,0,0,1000,-1000,-1000
20200212,047026,大毅元大93購02,,,,,0.00,0.00,0,0,0,0,0,0,0,0,0,0,0,0,0
20200212,047027,新光金元大95購01,1.06,1.08,1.06,1.08,+0.04,3.85,23000,2,24400,0,0,0,0,0,0,22000,1000,21000,21000
20200212,047028,新日興元大93購02,0.68,0.68,0.59,0.59,-0.22,-27.16,532000,11,340130,0,0,0,0,0,0,329000,199000,130000,130000
20200212,047029,日月光元大93購01,1.08,1.27,1.08,1.27,+0.40,45.98,51000,4,59080,0,0,0,0,0,0,0,51000,-51000,-51000
20200212,04702P,臺股指元富94售08,0.05,0.05,0.05,0.05,-0.03,-37.5,100000,1,5000,0,0,0,0,0,0,100000,0,100000,100000
20200212,047030,日月光元大93購02,1.82,2.10,1.79,2.10,+0.38,22.09,179000,11,339950,0,0,0,0,0,0,54000,125000,-71000,-71000
20200212,047031,麗豐元大93購01,,,,,0.00,0.00,0,0,0,0,0,0,0,0,0,0,0,0,0
20200212,047032,台虹元大93購01,0.59,0.63,0.59,0.61,0.00,0.00,233000,7,140850,0,0,0,0,0,0,18000,233000,-215000,-215000
20200212,047033,日月光中信95購01,2.37,2.69,2.32,2.67,+0.54,25.35,78000,10,193360,0,0,0,0,0,0,34000,44000,-10000,-10000
20200212,047034,東陽群益93購01,,,,,0.00,0.00,0,0,0,0,0,0,0,0,0,0,0,0,0
20200212,047035,華邦電群益94購02,0.19,0.23,0.19,0.22,0.00,0.00,45000,6,9650,0,0,0,0,0,0,0,45000,-45000,-45000
20200212,047036,台光電群益93購02,,,,,0.00,0.00,0,0,0,0,0,0,0,0,0,0,0,0,0
20200212,047037,奇力新群益93購02,,,,,0.00,0.00,0,0,0,0,0,0,0,0,0,0,0,0,0
20200212,047038,亞光群益93購01,,,,,0.00,0.00,0,0,0,0,0,0,0,0,0,0,0,0,0
20200212,047039,晶技群益93購02,1.02,1.08,1.02,1.08,+0.13,13.68,20000,2,21000,0,0,0,0,0,0,10000,10000,0,0
20200212,04703P,樺漢統一95售01,0.97,0.97,0.96,0.96,-0.07,-6.8,21000,13,20310,0,0,0,0,0,0,18000,3000,15000,15000
20200212,047040,台勝科群益93購01,0.84,0.84,0.82,0.82,-0.06,-6.82,38000,3,31440,0,0,0,0,0,0,28000,10000,18000,18000
20200212,047041,貿聯群益93購02,,,,,0.00,0.00,0,0,0,0,0,0,0,0,0,0,0,0,0
20200212,047042,佐登群益93購01,0.08,0.08,0.08,0.08,+0.02,33.33,30000,1,2400,0,0,0,0,0,0,30000,0,30000,30000
20200212,047043,廣越群益93購01,0.03,0.03,0.03,0.03,0.00,0.00,10000,1,300,0,0,0,0,0,0,0,10000,-10000,-10000
20200212,047044,傳奇群益93購02,,,,,0.00,0.00,0,0,0,0,0,0,0,0,0,0,0,0,0
20200212,047045,台積電國票93購03,,,,,0.00,0.00,0,0,0,0,0,0,0,0,0,0,0,0,0
20200212,047046,台積電國票94購01,6.75,6.80,6.60,6.75,+0.40,6.3,23000,4,155050,0,0,0,0,0,0,18000,5000,13000,13000
20200212,047047,旺宏國票95購01,2.77,2.84,2.60,2.61,-0.15,-5.43,170000,21,467030,0,0,0,0,0,0,137000,33000,104000,104000
20200212,047048,華邦電國票93購02,0.11,0.11,0.11,0.11,0.00,0.00,90000,2,9900,0,0,0,0,0,0,0,90000,-90000,-90000
20200212,047049,聯發科國票94購01,2.05,2.42,2.05,2.31,+0.50,27.62,187000,23,403970,0,0,0,0,0,0,156000,31000,125000,125000
20200212,04704P,臺股指統一95售01,,,,,0.00,0.00,0,0,0,0,0,0,0,0,0,0,0,0,0
20200212,047050,可成國票93購02,,,,,0.00,0.00,0,0,0,0,0,0,0,0,0,0,0,0,0
20200212,047051,可成國票94購01,2.45,2.80,2.32,2.80,+0.65,30.23,124000,20,314980,0,0,0,0,0,0,10000,114000,-104000,-104000
20200212,047052,大毅國票93購01,,,,,0.00,0.00,0,0,0,0,0,0,0,0,0,0,0,0,0
20200212,047053,益航國票93購01,,,,,0.00,0.00,0,0,0,0,0,0,0,0,0,0,0,0,0
20200212,047054,聯詠國票93購01,,,,,0.00,0.00,0,0,0,0,0,0,0,0,0,0,0,0,0
20200212,047055,旭富國票93購01,1.57,2.38,1.53,2.21,+0.80,56.74,169000,20,337690,0,0,0,0,0,0,47000,116000,-69000,-69000
20200212,047056,正文國票93購02,,,,,0.00,0.00,0,0,0,0,0,0,0,0,0,0,0,0,0
20200212,047057,瀚宇博國票93購01,0.30,0.38,0.30,0.38,+0.08,26.67,180000,3,57000,0,0,0,0,0,0,150000,30000,120000,120000
20200212,047058,聯茂國票94購01,0.49,0.64,0.49,0.64,0.00,0.00,73000,10,41890,0,0,0,0,0,0,0,73000,-73000,-73000
20200212,047059,智邦日盛93購01,0.79,0.92,0.79,0.87,+0.06,7.41,20000,8,17290,0,0,0,0,0,0,20000,0,20000,20000
20200212,04705P,臺股指統一95售02,,,,,0.00,0.00,0,0,0,0,0,0,0,0,0,0,0,0,0
20200212,047060,智易日盛93購01,,,,,0.00,0.00,0,0,0,0,0,0,0,0,0,0,0,0,0
20200212,047061,鴻海凱基93購23,,,,,0.00,0.00,0,0,0,0,0,0,0,0,0,0,0,0,0
20200212,047062,鴻海凱基93購24,,,,,0.00,0.00,0,0,0,0,0,0,0,0,0,0,0,0,0
20200212,047063,漢唐凱基95購01,2.08,2.08,2.08,2.08,+0.14,7.22,25000,1,52000,0,0,0,0,0,0,25000,0,25000,25000
20200212,047064,致伸凱基93購03,,,,,0.00,0.00,0,0,0,0,0,0,0,0,0,0,0,0,0
20200212,047065,聯茂凱基93購07,,,,,0.00,0.00,0,0,0,0,0,0,0,0,0,0,0,0,0
20200212,047066,力成凱基93購04,7.55,8.00,7.55,8.00,+1.65,25.98,30000,6,233500,0,0,0,0,0,0,0,30000,-30000,-30000
20200212,047067,啟碁凱基93購01,,,,,0.00,0.00,0,0,0,0,0,0,0,0,0,0,0,0,0
20200212,047068,南電凱基93購04,0.38,0.42,0.37,0.42,0.00,0.00,70000,12,27980,0,0,0,0,0,0,0,70000,-70000,-70000
20200212,047069,T50反1兆豐93購01,,,,,0.00,0.00,0,0,0,0,0,0,0,0,0,0,0,0,0
20200212,04706P,力山元大95售01,,,,,0.00,0.00,0,0,0,0,0,0,0,0,0,0,0,0,0
20200212,047070,華通兆豐93購01,3.10,3.10,3.10,3.10,+1.09,54.23,5000,1,15500,0,0,0,0,0,0,5000,0,5000,5000
20200212,047071,台積電兆豐93購05,,,,,0.00,0.00,0,0,0,0,0,0,0,0,0,0,0,0,0
20200212,047072,義隆兆豐94購01,0.83,0.86,0.80,0.86,+0.15,21.13,408000,10,343290,0,0,0,0,0,0,177000,231000,-54000,-54000
20200212,047073,大立光兆豐94購01,,,,,0.00,0.00,0,0,0,0,0,0,0,0,0,0,0,0,0
20200212,047074,大立光兆豐94購02,,,,,0.00,0.00,0,0,0,0,0,0,0,0,0,0,0,0,0
20200212,047075,群創兆豐93購01,1.78,1.78,1.78,1.78,+0.07,4.09,160000,1,284800,0,0,0,0,0,0,160000,0,160000,160000
20200212,047076,TPK兆豐94購01,,,,,0.00,0.00,0,0,0,0,0,0,0,0,0,0,0,0,0
20200212,047077,日月光兆豐93購01,0.65,0.79,0.62,0.76,0.00,0.00,230000,13,163450,0,0,0,0,0,0,0,230000,-230000,-230000
20200212,047078,上海銀兆豐93購01,,,,,0.00,0.00,0,0,0,0,0,0,0,0,0,0,0,0,0
20200212,047079,GIS兆豐94購01,0.31,0.33,0.31,0.33,+0.02,6.45,11000,3,3430,0,0,0,0,0,0,0,11000,-11000,-11000
20200212,04707P,喬山元大94售01,,,,,0.00,0.00,0,0,0,0,0,0,0,0,0,0,0,0,0
20200212,047080,仁寶康和93購01,0.58,0.58,0.58,0.58,-0.01,-1.69,20000,2,11600,0,0,0,0,0,0,0,20000,-20000,-20000
20200212,047081,晶技康和93購01,,,,,0.00,0.00,0,0,0,0,0,0,0,0,0,0,0,0,0
20200212,047082,元上證永豐93購01,0.10,0.10,0.10,0.10,-0.01,-9.09,6000,2,600,0,0,0,0,0,0,6000,0,6000,6000
20200212,047083,大立光永豐93購01,,,,,0.00,0.00,0,0,0,0,0,0,0,0,0,0,0,0,0
20200212,047084,嘉聯益永豐93購02,,,,,0.00,0.00,0,0,0,0,0,0,0,0,0,0,0,0,0
20200212,047085,柏文永豐93購01,,,,,0.00,0.00,0,0,0,0,0,0,0,0,0,0,0,0,0
20200212,047086,群創統一93購03,,,,,0.00,0.00,0,0,0,0,0,0,0,0,0,0,0,0,0
20200212,047087,亞泥元富93購01,0.53,0.53,0.53,0.53,0.00,0.00,10000,1,5300,0,0,0,0,0,0,0,10000,-10000,-10000
20200212,047088,可成元富93購03,,,,,0.00,0.00,0,0,0,0,0,0,0,0,0,0,0,0,0
20200212,047089,聯詠元富93購03,1.10,1.17,1.07,1.09,+0.15,15.96,137000,26,154960,0,0,0,0,0,0,107000,30000,77000,77000
20200212,04708P,國巨元大94售11,,,,,0.00,0.00,0,0,0,0,0,0,0,0,0,0,0,0,0
20200212,047090,緯創元富93購01,1.27,1.30,1.27,1.30,0.00,0.00,100000,2,127300,0,0,0,0,0,0,90000,10000,80000,80000
20200212,047091,南茂元富93購01,,,,,0.00,0.00,0,0,0,0,0,0,0,0,0,0,0,0,0
20200212,047092,志超元富93購01,,,,,0.00,0.00,0,0,0,0,0,0,0,0,0,0,0,0,0
20200212,047093,寶成元富93購01,,,,,0.00,0.00,0,0,0,0,0,0,0,0,0,0,0,0,0
20200212,047094,聯發科麥證93購02,0.35,0.43,0.32,0.42,+0.16,61.54,776000,28,301710,687000,17000,670000,0,0,0,687000,617000,70000,70000
20200212,047095,聯詠麥證93購01,0.74,0.79,0.67,0.78,+0.13,20.0,160000,26,120820,110000,50000,60000,0,0,0,110000,50000,60000,60000
20200212,047096,元油反國泰96購01,,,,,0.00,0.00,0,0,0,0,0,0,0,0,0,0,0,0,0
20200212,047097,旺宏國泰94購03,,,,,0.00,0.00,0,0,0,0,0,0,0,0,0,0,0,0,0
20200212,047098,大毅國泰94購01,4.01,4.01,4.01,4.01,-0.21,-4.98,1000,1,4010,0,0,0,0,0,0,0,1000,-1000,-1000
20200212,047099,華通富邦94購01,3.20,3.20,3.20,3.20,0.00,0.00,5000,1,16000,0,0,0,0,0,0,0,5000,-5000,-5000
20200212,04709P,台積電元大94售15,,,,,0.00,0.00,0,0,0,0,0,0,0,0,0,0,0,0,0
20200212,047100,台積電富邦93購03,,,,,0.00,0.00,0,0,0,0,0,0,0,0,0,0,0,0,0
20200212,047101,南亞科富邦93購01,,,,,0.00,0.00,0,0,0,0,0,0,0,0,0,0,0,0,0
20200212,047102,潤泰全富邦95購01,,,,,0.00,0.00,0,0,0,0,0,0,0,0,0,0,0,0,0
20200212,047103,台苯元大93購01,,,,,0.00,0.00,0,0,0,0,0,0,0,0,0,0,0,0,0
20200212,047104,和大元大93購02,0.20,0.23,0.20,0.23,0.00,0.00,2000,2,430,0,0,0,0,0,0,0,2000,-2000,-2000
20200212,047105,和大元大94購01,1.58,1.58,1.58,1.58,0.00,0.00,3000,2,4740,0,0,0,0,0,0,0,3000,-3000,-3000
20200212,047106,喬山元大93購01,,,,,0.00,0.00,0,0,0,0,0,0,0,0,0,0,0,0,0
20200212,047107,上銀元大93購04,3.70,3.70,3.70,3.70,+0.23,6.63,20000,2,74000,0,0,0,0,0,0,20000,0,20000,20000
20200212,047108,華邦電元大93購03,,,,,0.00,0.00,0,0,0,0,0,0,0,0,0,0,0,0,0
20200212,047109,華邦電元大94購01,0.68,0.76,0.68,0.74,+0.13,21.31,112000,5,81140,0,0,0,0,0,0,8000,111000,-103000,-103000
20200212,04710P,台積電元大94售16,0.19,0.19,0.19,0.19,0.00,0.00,65000,1,12350,0,0,0,0,0,0,0,65000,-65000,-65000
20200212,047110,智邦元大93購05,1.48,1.61,1.48,1.61,+0.37,29.84,91000,5,142170,0,0,0,0,0,0,30000,61000,-31000,-31000
20200212,047111,台光電元大93購04,,,,,0.00,0.00,0,0,0,0,0,0,0,0,0,0,0,0,0
20200212,047112,聯發科元大93購11,1.86,2.00,1.81,2.00,+0.44,28.21,60000,9,112380,0,0,0,0,0,0,60000,0,60000,60000
20200212,047113,聯發科元大93購12,0.71,0.83,0.70,0.83,+0.24,40.68,124000,5,90470,0,0,0,0,0,0,72000,52000,20000,20000
20200212,047114,全新元大94購01,2.92,3.49,2.85,3.49,+0.86,32.7,182000,12,543840,0,0,0,0,0,0,139000,50000,89000,89000
20200212,047115,可成元大93購06,1.00,1.37,1.00,1.33,+0.39,41.49,262000,15,313940,0,0,0,0,0,0,241000,262000,-21000,-21000
20200212,047116,大立光元大93購19,,,,,0.00,0.00,0,0,0,0,0,0,0,0,0,0,0,0,0
20200212,047117,禾伸堂元大93購02,1.53,1.53,1.42,1.53,0.00,0.00,44000,5,67100,0,0,0,0,0,0,43000,1000,42000,42000
20200212,047118,欣興元大93購06,0.51,0.51,0.51,0.51,0.00,0.00,223000,2,113730,0,0,0,0,0,0,0,223000,-223000,-223000
20200212,047119,臻鼎元大93購01,3.21,3.37,2.47,2.47,+0.21,9.29,14000,9,43540,0,0,0,0,0,0,6000,8000,-2000,-2000
20200212,04711P,台光電元大94售05,,,,,0.00,0.00,0,0,0,0,0,0,0,0,0,0,0,0,0
20200212,047120,啟碁元大93購02,0.12,0.12,0.12,0.12,0.00,0.00,31000,1,3720,0,0,0,0,0,0,31000,0,31000,31000
20200212,047121,訊芯元大93購03,1.68,1.98,1.68,1.98,+0.37,22.98,2000,2,3660,0,0,0,0,0,0,1000,1000,0,0
20200212,047122,康友元大93購02,,,,,0.00,0.00,0,0,0,0,0,0,0,0,0,0,0,0,0
20200212,047123,中石化中信95購01,0.37,0.37,0.37,0.37,0.00,0.00,10000,1,3700,0,0,0,0,0,0,0,10000,-10000,-10000
20200212,047124,華新中信93購01,,,,,0.00,0.00,0,0,0,0,0,0,0,0,0,0,0,0,0
20200212,047125,為升中信93購01,,,,,0.00,0.00,0,0,0,0,0,0,0,0,0,0,0,0,0
20200212,047126,拓凱中信93購01,,,,,0.00,0.00,0,0,0,0,0,0,0,0,0,0,0,0,0
20200212,047127,臻鼎中信95購01,2.61,2.97,2.58,2.97,+1.00,50.76,36000,4,97380,0,0,0,0,0,0,20000,16000,4000,4000
20200212,047128,新日興日盛93購01,1.37,1.37,1.31,1.31,-0.24,-15.48,97000,14,129140,0,0,0,0,0,0,97000,0,97000,97000
20200212,047129,T50反1凱基93購01,,,,,0.00,0.00,0,0,0,0,0,0,0,0,0,0,0,0,0
20200212,04712P,國泰金元大94售01,,,,,0.00,0.00,0,0,0,0,0,0,0,0,0,0,0,0,0
20200212,047130,台達電凱基93購03,,,,,0.00,0.00,0,0,0,0,0,0,0,0,0,0,0,0,0
20200212,047131,鴻海凱基94購03,0.31,0.46,0.31,0.46,+0.16,53.33,350000,8,129760,0,0,0,0,0,0,100000,250000,-150000,-150000
20200212,047132,台積電凱基93購12,,,,,0.00,0.00,0,0,0,0,0,0,0,0,0,0,0,0,0
20200212,047133,旺宏凱基93購03,,,,,0.00,0.00,0,0,0,0,0,0,0,0,0,0,0,0,0
20200212,047134,聯發科凱基93購10,,,,,0.00,0.00,0,0,0,0,0,0,0,0,0,0,0,0,0
20200212,047135,可成凱基93購05,0.45,0.47,0.45,0.47,+0.04,9.3,30000,2,13700,0,0,0,0,0,0,20000,10000,10000,10000
20200212,047136,潤泰全凱基94購01,,,,,0.00,0.00,0,0,0,0,0,0,0,0,0,0,0,0,0
20200212,047137,健策凱基94購01,6.55,6.55,6.45,6.50,+0.90,16.07,15000,4,98100,0,0,0,0,0,0,13000,2000,11000,11000
20200212,047138,智伸科凱基93購04,0.87,0.87,0.87,0.87,0.00,0.00,2000,1,1740,0,0,0,0,0,0,0,2000,-2000,-2000
20200212,047139,啟碁凱基93購02,,,,,0.00,0.00,0,0,0,0,0,0,0,0,0,0,0,0,0
20200212,04713P,創意元大95售01,0.84,0.87,0.84,0.87,0.00,0.00,6000,4,5110,0,0,0,0,0,0,3000,3000,0,0
20200212,047140,滬深2X兆豐94購01,,,,,0.00,0.00,0,0,0,0,0,0,0,0,0,0,0,0,0
20200212,047141,宏達電兆豐94購01,0.34,0.34,0.34,0.34,0.00,0.00,20000,1,6800,0,0,0,0,0,0,20000,0,20000,20000
20200212,047142,中磊兆豐93購02,0.20,0.20,0.20,0.20,0.00,0.00,44000,1,8800,0,0,0,0,0,0,44000,0,44000,44000
20200212,047143,為升群益93購01,,,,,0.00,0.00,0,0,0,0,0,0,0,0,0,0,0,0,0
20200212,047144,華通群益94購01,2.62,4.03,2.62,3.91,+1.41,56.4,148000,30,494790,0,0,0,0,0,0,48000,100000,-52000,-52000
20200212,047145,鴻海群益95購01,,,,,0.00,0.00,0,0,0,0,0,0,0,0,0,0,0,0,0
20200212,047146,智邦群益93購01,1.51,1.51,1.09,1.09,-0.21,-16.15,40000,3,55600,0,0,0,0,0,0,20000,20000,0,0
20200212,047147,嘉晶群益93購02,,,,,0.00,0.00,0,0,0,0,0,0,0,0,0,0,0,0,0
20200212,047148,和鑫群益93購01,,,,,0.00,0.00,0,0,0,0,0,0,0,0,0,0,0,0,0
20200212,047149,聯鈞群益93購01,1.03,1.17,1.03,1.17,+0.31,36.05,17000,3,18150,0,0,0,0,0,0,0,17000,-17000,-17000
20200212,04714P,上海銀元大94售01,,,,,0.00,0.00,0,0,0,0,0,0,0,0,0,0,0,0,0
20200212,047150,啟碁群益93購01,,,,,0.00,0.00,0,0,0,0,0,0,0,0,0,0,0,0,0
20200212,047151,台積電國票94購02,12.70,13.10,12.70,12.90,+1.10,9.32,48000,4,624400,0,0,0,0,0,0,1000,47000,-46000,-46000
20200212,047152,旺宏國票93購02,,,,,0.00,0.00,0,0,0,0,0,0,0,0,0,0,0,0,0
20200212,047153,聯發科國票93購02,,,,,0.00,0.00,0,0,0,0,0,0,0,0,0,0,0,0,0
20200212,047154,新光金國票95購01,0.94,0.94,0.93,0.94,+0.02,2.17,60000,15,56390,0,0,0,0,0,0,60000,0,60000,60000
20200212,047155,智原國票93購01,,,,,0.00,0.00,0,0,0,0,0,0,0,0,0,0,0,0,0
20200212,047156,群創國票94購01,,,,,0.00,0.00,0,0,0,0,0,0,0,0,0,0,0,0,0
20200212,047157,智伸科國票93購01,,,,,0.00,0.00,0,0,0,0,0,0,0,0,0,0,0,0,0
20200212,047158,致伸國票93購01,,,,,0.00,0.00,0,0,0,0,0,0,0,0,0,0,0,0,0
20200212,047159,中磊國票94購01,,,,,0.00,0.00,0,0,0,0,0,0,0,0,0,0,0,0,0
20200212,04715P,聯茂元大94售06,2.10,2.15,2.10,2.15,0.00,0.00,5000,2,10650,0,0,0,0,0,0,0,5000,-5000,-5000
20200212,047160,台郡國票94購01,1.86,2.13,1.86,2.13,+1.07,100.94,661000,31,1324660,0,0,0,0,0,0,627000,6000,621000,621000
20200212,047161,世紀鋼國票94購01,,,,,0.00,0.00,0,0,0,0,0,0,0,0,0,0,0,0,0
20200212,047162,華通台新93購02,,,,,0.00,0.00,0,0,0,0,0,0,0,0,0,0,0,0,0
20200212,047163,義隆台新93購01,0.41,0.41,0.41,0.41,0.00,0.00,5000,1,2050,0,0,0,0,0,0,5000,0,5000,5000
20200212,047164,亞光台新93購01,0.40,0.40,0.40,0.40,0.00,0.00,1000,1,400,0,0,0,0,0,0,1000,0,1000,1000
20200212,047165,東陽康和93購01,,,,,0.00,0.00,0,0,0,0,0,0,0,0,0,0,0,0,0
20200212,047166,台達電康和93購01,,,,,0.00,0.00,0,0,0,0,0,0,0,0,0,0,0,0,0
20200212,047167,農林康和93購01,0.55,0.55,0.54,0.54,-0.04,-6.9,30000,4,16400,0,0,0,0,0,0,0,30000,-30000,-30000
20200212,047168,廣越康和93購01,,,,,0.00,0.00,0,0,0,0,0,0,0,0,0,0,0,0,0
20200212,047169,滬深2X永豐95購01,,,,,0.00,0.00,0,0,0,0,0,0,0,0,0,0,0,0,0
20200212,04716P,中石化凱基94售01,1.64,1.64,1.64,1.64,0.00,0.00,11000,1,18040,0,0,0,0,0,0,0,11000,-11000,-11000
20200212,047170,廣宇永豐93購01,,,,,0.00,0.00,0,0,0,0,0,0,0,0,0,0,0,0,0
20200212,047171,聯發科永豐93購01,,,,,0.00,0.00,0,0,0,0,0,0,0,0,0,0,0,0,0
20200212,047172,創意永豐93購02,,,,,0.00,0.00,0,0,0,0,0,0,0,0,0,0,0,0,0
20200212,047173,群創永豐93購01,,,,,0.00,0.00,0,0,0,0,0,0,0,0,0,0,0,0,0
20200212,047174,百和永豐93購01,,,,,0.00,0.00,0,0,0,0,0,0,0,0,0,0,0,0,0
20200212,047175,台塑元大93購01,,,,,0.00,0.00,0,0,0,0,0,0,0,0,0,0,0,0,0
20200212,047176,力山元大93購01,,,,,0.00,0.00,0,0,0,0,0,0,0,0,0,0,0,0,0
20200212,047177,上銀元大93購05,1.94,1.94,1.73,1.73,-0.02,-1.14,121000,6,234200,0,0,0,0,0,0,68000,53000,15000,15000
20200212,047178,台積電元大93購16,,,,,0.00,0.00,0,0,0,0,0,0,0,0,0,0,0,0,0
20200212,047179,台積電元大93購17,12.20,12.20,12.20,12.20,0.00,0.00,3000,1,36600,0,0,0,0,0,0,3000,0,3000,3000
20200212,04717P,和大凱基94售02,,,,,0.00,0.00,0,0,0,0,0,0,0,0,0,0,0,0,0
20200212,047180,台積電元大93購18,10.00,10.00,10.00,10.00,0.00,0.00,8000,1,80000,0,0,0,0,0,0,0,8000,-8000,-8000
20200212,047181,智邦元大93購06,0.64,0.69,0.62,0.69,+0.20,40.82,141000,9,96060,0,0,0,0,0,0,90000,51000,39000,39000
20200212,047182,智邦元大93購07,2.76,2.96,2.24,2.24,-0.18,-7.44,68000,7,162630,0,0,0,0,0,0,12000,56000,-44000,-44000
20200212,047183,台光電元大93購05,,,,,0.00,0.00,0,0,0,0,0,0,0,0,0,0,0,0,0
20200212,047184,漢唐元大94購02,,,,,0.00,0.00,0,0,0,0,0,0,0,0,0,0,0,0,0
20200212,047185,益航元大94購02,,,,,0.00,0.00,0,0,0,0,0,0,0,0,0,0,0,0,0
20200212,047186,大立光元大93購20,2.42,2.45,2.42,2.45,0.00,0.00,19000,2,46250,0,0,0,0,0,0,0,19000,-19000,-19000
20200212,047187,亞光元大94購01,1.06,1.23,1.04,1.23,+0.22,21.78,491000,31,557280,0,0,0,0,0,0,146000,378000,-232000,-232000
20200212,047188,聯詠元大93購04,1.66,1.80,1.66,1.80,+0.37,25.87,21000,3,36260,0,0,0,0,0,0,11000,10000,1000,1000
20200212,047189,聯詠元大93購05,2.49,2.49,2.49,2.49,+0.30,13.7,20000,3,49800,0,0,0,0,0,0,20000,0,20000,20000
20200212,04718P,亞德客凱基94售03,,,,,0.00,0.00,0,0,0,0,0,0,0,0,0,0,0,0,0
20200212,047190,聯茂元大93購03,,,,,0.00,0.00,0,0,0,0,0,0,0,0,0,0,0,0,0
20200212,047191,同欣電元大93購02,3.27,3.27,3.27,3.27,0.00,0.00,2000,2,6540,0,0,0,0,0,0,0,2000,-2000,-2000
20200212,047192,啟碁元大93購03,,,,,0.00,0.00,0,0,0,0,0,0,0,0,0,0,0,0,0
20200212,047193,南電元大94購02,1.72,1.72,1.72,1.72,-0.05,-2.82,29000,2,49880,0,0,0,0,0,0,29000,0,29000,29000
20200212,047194,世紀鋼元大96購01,1.52,1.55,1.51,1.54,+0.03,1.99,160000,13,243700,0,0,0,0,0,0,160000,3000,157000,157000
20200212,047195,滬深2X統一93購01,,,,,0.00,0.00,0,0,0,0,0,0,0,0,0,0,0,0,0
20200212,047196,上銀統一97購01,1.96,1.96,1.85,1.89,+0.01,0.53,834000,47,1596520,0,0,0,0,0,0,561000,303000,258000,258000
20200212,047197,美律統一94購01,0.28,0.34,0.27,0.34,+0.09,36.0,672000,37,204390,0,0,0,0,0,0,50000,567000,-517000,-517000
20200212,047198,奇鋐統一93購01,,,,,0.00,0.00,0,0,0,0,0,0,0,0,0,0,0,0,0
20200212,047199,鴻海元富93購03,,,,,0.00,0.00,0,0,0,0,0,0,0,0,0,0,0,0,0
20200212,04719P,台達電凱基94售09,,,,,0.00,0.00,0,0,0,0,0,0,0,0,0,0,0,0,0
20200212,047200,鴻海元富93購04,,,,,0.00,0.00,0,0,0,0,0,0,0,0,0,0,0,0,0
20200212,047201,鴻海元富93購05,,,,,0.00,0.00,0,0,0,0,0,0,0,0,0,0,0,0,0
20200212,047202,欣興元富96購01,0.90,1.07,0.90,1.07,+0.24,28.92,118000,6,119260,0,0,0,0,0,0,42000,76000,-34000,-34000
20200212,047203,TPK元富93購02,,,,,0.00,0.00,0,0,0,0,0,0,0,0,0,0,0,0,0
20200212,047204,啟碁元富93購01,,,,,0.00,0.00,0,0,0,0,0,0,0,0,0,0,0,0,0
20200212,047205,GIS元富93購03,,,,,0.00,0.00,0,0,0,0,0,0,0,0,0,0,0,0,0
20200212,047206,元金2X國泰94購01,,,,,0.00,0.00,0,0,0,0,0,0,0,0,0,0,0,0,0
20200212,047207,晶技國泰94購01,1.20,1.20,1.20,1.20,+0.07,6.19,10000,1,12000,0,0,0,0,0,0,10000,0,10000,10000
20200212,047208,智易國泰94購01,,,,,0.00,0.00,0,0,0,0,0,0,0,0,0,0,0,0,0
20200212,047209,滬深2X富邦96購01,,,,,0.00,0.00,0,0,0,0,0,0,0,0,0,0,0,0,0
20200212,04720P,台積電凱基94售25,,,,,0.00,0.00,0,0,0,0,0,0,0,0,0,0,0,0,0
20200212,047210,漢唐富邦95購01,1.83,1.83,1.83,1.83,0.00,0.00,6000,1,10980,0,0,0,0,0,0,0,6000,-6000,-6000
20200212,047211,華新科富邦99購01,,,,,0.00,0.00,0,0,0,0,0,0,0,0,0,0,0,0,0
20200212,047212,宏達電富邦97購01,0.60,0.60,0.58,0.59,+0.03,5.36,282000,15,166480,0,0,0,0,0,0,272000,10000,262000,262000
20200212,047213,新日興富邦97購01,1.60,1.64,1.53,1.53,-0.10,-6.13,236000,34,372540,0,0,0,0,0,0,138000,108000,30000,30000
20200212,047214,啟碁富邦97購01,0.40,0.40,0.40,0.40,0.00,0.00,5000,1,2000,0,0,0,0,0,0,0,5000,-5000,-5000
20200212,047215,華新科第一93購01,2.27,2.27,2.27,2.27,0.00,0.00,20000,1,45400,0,0,0,0,0,0,20000,0,20000,20000
20200212,047216,欣興第一93購01,0.11,0.11,0.11,0.11,0.00,0.00,10000,1,1100,0,0,0,0,0,0,10000,0,10000,10000
20200212,047217,臺股指中信93購05,,,,,0.00,0.00,0,0,0,0,0,0,0,0,0,0,0,0,0
20200212,047218,南茂日盛93購01,,,,,0.00,0.00,0,0,0,0,0,0,0,0,0,0,0,0,0
20200212,047219,美律麥證94購01,0.64,0.79,0.64,0.78,+0.18,30.0,787000,67,581940,78000,675000,-597000,0,0,0,271000,675000,-404000,-404000
20200212,04721P,正崴凱基94售02,,,,,0.00,0.00,0,0,0,0,0,0,0,0,0,0,0,0,0
20200212,047220,華新科麥證93購02,,,,,0.00,0.00,0,0,0,0,0,0,0,0,0,0,0,0,0
20200212,047221,日月光麥證93購01,0.56,0.70,0.56,0.68,+0.22,47.83,179000,29,111870,10000,169000,-159000,0,0,0,10000,169000,-159000,-159000
20200212,047222,鴻海凱基94購04,1.32,1.76,1.32,1.73,+0.50,40.65,124000,8,175500,0,0,0,0,0,0,103000,21000,82000,82000
20200212,047223,台積電凱基93購13,,,,,0.00,0.00,0,0,0,0,0,0,0,0,0,0,0,0,0
20200212,047224,台光電凱基94購01,0.45,0.50,0.45,0.48,+0.17,54.84,25000,4,12370,0,0,0,0,0,0,9000,5000,4000,4000
20200212,047225,京元電凱基93購01,,,,,0.00,0.00,0,0,0,0,0,0,0,0,0,0,0,0,0
20200212,047226,義隆凱基94購01,,,,,0.00,0.00,0,0,0,0,0,0,0,0,0,0,0,0,0
20200212,047227,華新科凱基94購01,,,,,0.00,0.00,0,0,0,0,0,0,0,0,0,0,0,0,0
20200212,047228,大立光凱基93購17,,,,,0.00,0.00,0,0,0,0,0,0,0,0,0,0,0,0,0
20200212,047229,大立光凱基93購18,,,,,0.00,0.00,0,0,0,0,0,0,0,0,0,0,0,0,0
20200212,04722P,南亞科凱基94售05,,,,,0.00,0.00,0,0,0,0,0,0,0,0,0,0,0,0,0
20200212,047230,大立光凱基93購19,,,,,0.00,0.00,0,0,0,0,0,0,0,0,0,0,0,0,0
20200212,047231,大立光凱基95購03,0.58,0.69,0.58,0.69,+0.10,16.95,122000,12,78230,0,0,0,0,0,0,69000,51000,18000,18000
20200212,047232,禾伸堂凱基93購02,0.91,0.91,0.85,0.89,-0.18,-16.82,54000,22,47800,0,0,0,0,0,0,54000,0,54000,54000
20200212,047233,智原凱基93購01,,,,,0.00,0.00,0,0,0,0,0,0,0,0,0,0,0,0,0
20200212,047234,晶技凱基93購01,,,,,0.00,0.00,0,0,0,0,0,0,0,0,0,0,0,0,0
20200212,047235,嘉澤凱基93購01,2.00,2.00,2.00,2.00,+0.11,5.82,10000,1,20000,0,0,0,0,0,0,10000,0,10000,10000
20200212,047236,智伸科凱基93購05,,,,,0.00,0.00,0,0,0,0,0,0,0,0,0,0,0,0,0
20200212,047237,正文凱基93購02,,,,,0.00,0.00,0,0,0,0,0,0,0,0,0,0,0,0,0
20200212,047238,傳奇凱基94購01,,,,,0.00,0.00,0,0,0,0,0,0,0,0,0,0,0,0,0
20200212,047239,瀚宇博凱基94購01,0.98,1.18,0.98,1.18,+0.17,16.83,638000,25,706090,0,0,0,0,0,0,129000,509000,-380000,-380000
20200212,04723P,美律凱基94售06,,,,,0.00,0.00,0,0,0,0,0,0,0,0,0,0,0,0,0
20200212,047240,樺漢凱基93購01,,,,,0.00,0.00,0,0,0,0,0,0,0,0,0,0,0,0,0
20200212,047241,力山群益93購01,,,,,0.00,0.00,0,0,0,0,0,0,0,0,0,0,0,0,0
20200212,047242,上銀群益93購04,1.70,1.70,1.54,1.54,-0.20,-11.49,49000,6,80530,0,0,0,0,0,0,16000,33000,-17000,-17000
20200212,047243,為升群益93購02,,,,,0.00,0.00,0,0,0,0,0,0,0,0,0,0,0,0,0
20200212,047244,華泰群益93購01,,,,,0.00,0.00,0,0,0,0,0,0,0,0,0,0,0,0,0
20200212,047245,聯發科群益94購03,1.01,1.14,1.01,1.08,+0.18,20.0,162000,4,179200,0,0,0,0,0,0,161000,1000,160000,160000
20200212,047246,華新科群益93購01,5.05,5.10,4.84,4.94,+0.20,4.22,93000,16,457700,0,0,0,0,0,0,51000,30000,21000,21000
20200212,047247,淘帝群益93購01,,,,,0.00,0.00,0,0,0,0,0,0,0,0,0,0,0,0,0
20200212,047248,奇鋐群益95購01,0.19,0.19,0.19,0.19,0.00,0.00,10000,1,1900,0,0,0,0,0,0,0,10000,-10000,-10000
20200212,047249,欣興群益93購03,,,,,0.00,0.00,0,0,0,0,0,0,0,0,0,0,0,0,0
20200212,04724P,可成凱基94售08,1.55,1.55,1.55,1.55,-0.29,-15.76,13000,1,20150,0,0,0,0,0,0,13000,13000,0,0
20200212,047250,日月光群益94購01,2.57,2.87,2.50,2.87,+0.48,20.08,264000,14,709700,0,0,0,0,0,0,91000,173000,-82000,-82000
20200212,047251,麗豐群益93購01,0.24,0.24,0.23,0.23,0.00,0.00,30000,2,7000,0,0,0,0,0,0,30000,0,30000,30000
20200212,047252,元翎群益93購01,,,,,0.00,0.00,0,0,0,0,0,0,0,0,0,0,0,0,0
20200212,047253,新唐群益93購01,,,,,0.00,0.00,0,0,0,0,0,0,0,0,0,0,0,0,0
20200212,047254,瀚宇博群益93購02,,,,,0.00,0.00,0,0,0,0,0,0,0,0,0,0,0,0,0
20200212,047255,訊芯群益93購01,1.80,2.35,1.80,2.35,+0.53,29.12,44000,10,87790,0,0,0,0,0,0,21000,23000,-2000,-2000
20200212,047256,矽創群益93購01,,,,,0.00,0.00,0,0,0,0,0,0,0,0,0,0,0,0,0
20200212,047257,南茂群益93購01,,,,,0.00,0.00,0,0,0,0,0,0,0,0,0,0,0,0,0
20200212,047258,亞德客國票93購01,,,,,0.00,0.00,0,0,0,0,0,0,0,0,0,0,0,0,0
20200212,047259,國巨國票93購02,,,,,0.00,0.00,0,0,0,0,0,0,0,0,0,0,0,0,0
20200212,04725P,華新科凱基94售07,,,,,0.00,0.00,0,0,0,0,0,0,0,0,0,0,0,0,0
20200212,047260,嘉晶國票93購02,,,,,0.00,0.00,0,0,0,0,0,0,0,0,0,0,0,0,0
20200212,047261,聯詠國票93購02,1.14,1.20,1.10,1.20,+0.30,33.33,21000,10,24020,0,0,0,0,0,0,15000,6000,9000,9000
20200212,047262,欣興國票93購04,0.05,0.05,0.05,0.05,0.00,0.00,5000,1,250,0,0,0,0,0,0,0,5000,-5000,-5000
20200212,047263,揚明光國票94購01,0.08,0.08,0.08,0.08,0.00,0.00,50000,1,4000,0,0,0,0,0,0,50000,0,50000,50000
20200212,047264,貿聯國票93購02,,,,,0.00,0.00,0,0,0,0,0,0,0,0,0,0,0,0,0
20200212,047265,致伸國票93購02,,,,,0.00,0.00,0,0,0,0,0,0,0,0,0,0,0,0,0
20200212,047266,嘉聯益國票94購02,0.48,0.48,0.48,0.48,+0.08,20.0,6000,1,2880,0,0,0,0,0,0,0,6000,-6000,-6000
20200212,047267,瀚宇博台新93購01,,,,,0.00,0.00,0,0,0,0,0,0,0,0,0,0,0,0,0
20200212,047268,嘉聯益台新93購01,,,,,0.00,0.00,0,0,0,0,0,0,0,0,0,0,0,0,0
20200212,047269,同欣電康和93購01,1.55,1.55,1.55,1.55,0.00,0.00,10000,1,15500,0,0,0,0,0,0,0,10000,-10000,-10000
20200212,04726P,TPK凱基94售04,,,,,0.00,0.00,0,0,0,0,0,0,0,0,0,0,0,0,0
20200212,047270,元油2X永豐94購02,0.03,0.04,0.03,0.04,0.00,0.00,15000,2,550,0,5000,-5000,0,0,0,0,10000,-10000,-15000
20200212,047271,華通永豐93購01,0.22,0.52,0.20,0.52,+0.29,126.09,173000,37,70700,0,0,0,0,0,0,30000,143000,-113000,-113000
20200212,047272,技嘉永豐93購01,,,,,0.00,0.00,0,0,0,0,0,0,0,0,0,0,0,0,0
20200212,047273,奇力新永豐93購03,3.81,3.81,3.81,3.81,-0.13,-3.3,26000,14,99060,0,0,0,0,0,0,26000,0,26000,26000
20200212,047274,華新科永豐93購02,2.33,2.33,2.33,2.33,+0.17,7.87,52000,1,121160,0,0,0,0,0,0,52000,0,52000,52000
20200212,047275,宏達電永豐93購01,,,,,0.00,0.00,0,0,0,0,0,0,0,0,0,0,0,0,0
20200212,047276,中工永豐93購01,,,,,0.00,0.00,0,0,0,0,0,0,0,0,0,0,0,0,0
20200212,047277,晶技永豐93購01,,,,,0.00,0.00,0,0,0,0,0,0,0,0,0,0,0,0,0
20200212,047278,和鑫永豐93購02,,,,,0.00,0.00,0,0,0,0,0,0,0,0,0,0,0,0,0
20200212,047279,日月光永豐93購01,0.05,0.05,0.05,0.05,0.00,0.00,7000,1,350,0,0,0,0,0,0,7000,0,7000,7000
20200212,04727P,臺股指凱基96售03,0.24,0.24,0.23,0.23,0.00,0.00,4000,2,940,0,0,0,0,0,0,0,4000,-4000,-4000
20200212,047280,泰鼎永豐93購01,0.38,0.44,0.38,0.41,+0.07,20.59,198000,39,84200,0,0,0,0,0,0,24000,174000,-150000,-150000
20200212,047281,超眾永豐93購02,,,,,0.00,0.00,0,0,0,0,0,0,0,0,0,0,0,0,0
20200212,047282,啟碁永豐93購01,,,,,0.00,0.00,0,0,0,0,0,0,0,0,0,0,0,0,0
20200212,047283,世紀鋼永豐93購02,,,,,0.00,0.00,0,0,0,0,0,0,0,0,0,0,0,0,0
20200212,047284,華通統一93購03,2.60,3.39,2.60,3.39,+1.18,53.39,173000,12,512170,0,0,0,0,0,0,31000,142000,-111000,-111000
20200212,047285,鴻海統一95購02,0.20,0.30,0.20,0.30,+0.11,57.89,1153000,39,281280,0,0,0,0,0,0,660000,492000,168000,168000
20200212,047286,美律統一93購02,0.04,0.08,0.04,0.07,+0.04,133.33,76000,13,5120,0,0,0,0,0,0,18000,68000,-50000,-50000
20200212,047287,貿聯統一95購01,0.64,0.64,0.64,0.64,+0.01,1.59,5000,1,3200,0,0,0,0,0,0,0,5000,-5000,-5000
20200212,047288,台郡統一93購01,3.39,3.58,3.39,3.49,+1.65,89.67,66000,20,227170,0,0,0,0,0,0,27000,36000,-9000,-9000
20200212,047289,啟碁統一97購01,0.71,0.71,0.71,0.71,+0.03,4.41,32000,1,22720,0,0,0,0,0,0,0,32000,-32000,-32000
20200212,04728P,美律亞東94售02,,,,,0.00,0.00,0,0,0,0,0,0,0,0,0,0,0,0,0
20200212,047290,台積電元富93購04,7.20,7.20,7.20,7.20,+0.35,5.11,10000,1,72000,0,0,0,0,0,0,10000,0,10000,10000
20200212,047291,台積電元富93購05,8.10,8.25,8.10,8.25,0.00,0.00,22000,2,181200,0,0,0,0,0,0,22000,0,22000,22000
20200212,047292,台光電元富96購01,0.37,0.45,0.37,0.43,+0.11,34.38,361000,23,151240,0,0,0,0,0,0,78000,229000,-151000,-151000
20200212,047293,全新元富93購03,1.06,1.55,1.06,1.50,+0.64,74.42,306000,54,386130,0,0,0,0,0,0,114000,192000,-78000,-78000
20200212,047294,大立光元富93購04,,,,,0.00,0.00,0,0,0,0,0,0,0,0,0,0,0,0,0
20200212,047295,欣興元富96購02,0.60,0.76,0.60,0.76,+0.18,31.03,892000,17,616840,0,0,0,0,0,0,84000,808000,-724000,-724000
20200212,047296,日月光元富96購01,0.94,1.03,0.93,1.03,+0.15,17.05,123000,9,119940,0,0,0,0,0,0,107000,16000,91000,91000
20200212,047297,康控元富93購01,,,,,0.00,0.00,0,0,0,0,0,0,0,0,0,0,0,0,0
20200212,047298,聯茂元富96購01,0.43,0.59,0.43,0.55,+0.20,57.14,201000,34,106760,0,0,0,0,0,0,15000,186000,-171000,-171000
20200212,047299,樺漢元富93購01,,,,,0.00,0.00,0,0,0,0,0,0,0,0,0,0,0,0,0
20200212,04729P,臺股指中信96售01,0.03,0.03,0.03,0.03,0.00,0.00,25000,3,750,0,0,0,0,0,0,0,20000,-20000,-20000
20200212,047300,志超元富93購02,,,,,0.00,0.00,0,0,0,0,0,0,0,0,0,0,0,0,0
20200212,047301,啟碁國泰94購01,0.60,0.61,0.60,0.61,+0.02,3.39,50000,5,30100,0,0,0,0,0,0,0,50000,-50000,-50000
20200212,047302,為升富邦97購01,,,,,0.00,0.00,0,0,0,0,0,0,0,0,0,0,0,0,0
20200212,047303,寶滬深元大96購01,0.82,0.82,0.82,0.82,+0.03,3.8,5000,1,4100,0,0,0,0,0,0,5000,0,5000,5000
20200212,047304,元油2X元大96購02,0.31,0.32,0.31,0.32,+0.03,10.34,150000,2,47000,0,0,0,0,0,0,0,150000,-150000,-150000
20200212,047305,卜蜂元大93購02,,,,,0.00,0.00,0,0,0,0,0,0,0,0,0,0,0,0,0
20200212,047306,儒鴻元大93購03,,,,,0.00,0.00,0,0,0,0,0,0,0,0,0,0,0,0,0
20200212,047307,儒鴻元大93購04,0.33,0.33,0.30,0.30,-0.07,-18.92,21000,2,6630,0,0,0,0,0,0,21000,0,21000,21000
20200212,047308,鴻海元大93購12,3.60,4.33,3.60,4.33,+0.78,21.97,33000,4,126290,0,0,0,0,0,0,20000,13000,7000,7000
20200212,047309,鴻海元大93購13,2.09,3.22,2.09,3.22,+1.38,75.0,118000,16,332880,0,0,0,0,0,0,65000,108000,-43000,-43000
20200212,04730P,臺股指中信96售02,0.23,0.23,0.22,0.22,-0.04,-15.38,35000,2,7950,0,0,0,0,0,0,0,35000,-35000,-35000
20200212,047310,鴻海元大93購14,3.50,4.32,3.50,4.32,+0.89,25.95,23000,4,88860,0,0,0,0,0,0,10000,13000,-3000,-3000
20200212,047311,台積電元大93購19,,,,,0.00,0.00,0,0,0,0,0,0,0,0,0,0,0,0,0
20200212,047312,聯發科元大93購13,0.43,0.51,0.43,0.43,+0.13,43.33,57000,7,27010,0,0,0,0,0,0,27000,30000,-3000,-3000
20200212,047313,華新科元大93購08,,,,,0.00,0.00,0,0,0,0,0,0,0,0,0,0,0,0,0
20200212,047314,大立光元大93購22,2.32,2.32,2.32,2.32,+0.32,16.0,53000,2,122960,0,0,0,0,0,0,3000,50000,-47000,-47000
20200212,047315,大立光元大93購23,2.70,2.70,2.70,2.70,0.00,0.00,9000,1,24300,0,0,0,0,0,0,0,9000,-9000,-9000
20200212,047316,大立光元大94購01,2.95,3.07,2.95,3.07,0.00,0.00,51000,2,150570,0,0,0,0,0,0,0,51000,-51000,-51000
20200212,047317,聯詠元大93購06,2.67,2.67,2.67,2.67,+0.32,13.62,10000,2,26700,0,0,0,0,0,0,10000,0,10000,10000
20200212,047318,聯詠元大93購07,1.29,1.42,1.29,1.39,+0.22,18.8,32000,5,42410,0,0,0,0,0,0,21000,11000,10000,10000
20200212,047319,晶技元大93購02,0.32,0.32,0.32,0.32,0.00,0.00,68000,2,21760,0,0,0,0,0,0,0,68000,-68000,-68000
20200212,04731P,臺股指中信96售03,0.61,0.61,0.57,0.58,-0.04,-6.45,130000,9,77250,0,0,0,0,0,0,0,130000,-130000,-130000
20200212,047320,健策元大93購02,,,,,0.00,0.00,0,0,0,0,0,0,0,0,0,0,0,0,0
20200212,047321,日月光元大93購03,0.46,0.55,0.46,0.55,+0.18,48.65,50000,4,24700,0,0,0,0,0,0,20000,30000,-10000,-10000
20200212,047322,日月光元大93購04,0.78,0.93,0.78,0.93,+0.25,36.76,115000,6,99550,0,0,0,0,0,0,10000,105000,-95000,-95000
20200212,047323,利勤元大93購01,,,,,0.00,0.00,0,0,0,0,0,0,0,0,0,0,0,0,0
20200212,047324,康普元大93購01,,,,,0.00,0.00,0,0,0,0,0,0,0,0,0,0,0,0,0
20200212,047325,材料元大93購01,0.22,0.22,0.22,0.22,0.00,0.00,750000,2,165000,0,0,0,0,0,0,0,750000,-750000,-750000
20200212,047326,致伸元大93購03,,,,,0.00,0.00,0,0,0,0,0,0,0,0,0,0,0,0,0
20200212,047327,中磊元大93購04,0.13,0.13,0.13,0.13,0.00,0.00,98000,1,12740,0,0,0,0,0,0,98000,0,98000,98000
20200212,047328,瀚宇博元大93購04,,,,,0.00,0.00,0,0,0,0,0,0,0,0,0,0,0,0,0
20200212,047329,聯茂元大93購04,0.31,0.32,0.31,0.32,+0.15,88.24,99000,2,31000,0,0,0,0,0,0,31000,68000,-37000,-37000
20200212,04732P,聯茂群益94售01,1.52,1.52,1.52,1.52,0.00,0.00,10000,1,15200,0,0,0,0,0,0,0,10000,-10000,-10000
20200212,047330,康舒元大93購01,,,,,0.00,0.00,0,0,0,0,0,0,0,0,0,0,0,0,0
20200212,047331,啟碁元大93購04,,,,,0.00,0.00,0,0,0,0,0,0,0,0,0,0,0,0,0
20200212,047332,訊芯元大93購04,1.06,1.41,1.06,1.31,+0.20,18.02,209000,12,263560,0,0,0,0,0,0,111000,98000,13000,13000
20200212,047333,易華電元大93購03,,,,,0.00,0.00,0,0,0,0,0,0,0,0,0,0,0,0,0
20200212,047334,南茂元大93購03,,,,,0.00,0.00,0,0,0,0,0,0,0,0,0,0,0,0,0
20200212,047335,臺股指元大93購30,,,,,0.00,0.00,0,0,0,0,0,0,0,0,0,0,0,0,0
20200212,047336,臺股指元大93購31,5.70,5.70,5.70,5.70,+0.30,5.56,1000,1,5700,0,0,0,0,0,0,1000,0,1000,1000
20200212,047337,臺股指元大93購32,,,,,0.00,0.00,0,0,0,0,0,0,0,0,0,0,0,0,0
20200212,047338,臺股指元大93購33,,,,,0.00,0.00,0,0,0,0,0,0,0,0,0,0,0,0,0
20200212,047339,臺股指元大93購34,4.93,4.99,4.93,4.99,+0.23,4.83,3000,2,14910,0,0,0,0,0,0,3000,0,3000,3000
20200212,04733P,康控兆豐95售01,0.78,0.78,0.78,0.78,-0.09,-10.34,8000,1,6240,0,0,0,0,0,0,8000,0,8000,8000
20200212,047340,金融類元大93購02,,,,,0.00,0.00,0,0,0,0,0,0,0,0,0,0,0,0,0
20200212,047341,貿聯第一93購01,0.17,0.17,0.17,0.17,0.00,0.00,80000,1,13600,0,0,0,0,0,0,80000,0,80000,80000
20200212,047342,T50反1中信99購01,0.31,0.31,0.31,0.31,0.00,0.00,20000,2,6200,0,0,0,0,0,0,0,20000,-20000,-20000
20200212,047343,台達電中信95購01,0.70,0.72,0.68,0.72,+0.02,2.86,291000,9,201850,0,0,0,0,0,0,138000,153000,-15000,-15000
20200212,047344,亞德客凱基93購02,,,,,0.00,0.00,0,0,0,0,0,0,0,0,0,0,0,0,0
20200212,047345,鴻海凱基94購06,,,,,0.00,0.00,0,0,0,0,0,0,0,0,0,0,0,0,0
20200212,047346,國巨凱基93購06,,,,,0.00,0.00,0,0,0,0,0,0,0,0,0,0,0,0,0
20200212,047347,台積電凱基93購14,4.30,4.50,4.30,4.50,+0.68,17.8,31000,4,136600,0,0,0,0,0,0,11000,20000,-9000,-9000
20200212,047348,台光電凱基94購02,0.23,0.23,0.23,0.23,0.00,0.00,45000,1,10350,0,0,0,0,0,0,0,45000,-45000,-45000
20200212,047349,可成凱基93購06,,,,,0.00,0.00,0,0,0,0,0,0,0,0,0,0,0,0,0
20200212,04734P,上海銀兆豐94售02,0.48,0.48,0.48,0.48,0.00,0.00,10000,1,4800,0,0,0,0,0,0,0,10000,-10000,-10000
20200212,047350,華新科凱基94購02,,,,,0.00,0.00,0,0,0,0,0,0,0,0,0,0,0,0,0
20200212,047351,聯詠凱基93購02,1.00,1.00,1.00,1.00,0.00,0.00,2000,1,2000,0,0,0,0,0,0,2000,2000,0,0
20200212,047352,和鑫凱基94購02,,,,,0.00,0.00,0,0,0,0,0,0,0,0,0,0,0,0,0
20200212,047353,台郡凱基93購03,1.98,2.04,1.98,2.04,+1.09,114.74,12000,7,24170,0,0,0,0,0,0,6000,6000,0,0
20200212,047354,訊芯凱基94購01,1.05,1.32,1.05,1.32,+0.26,24.53,196000,10,233250,0,0,0,0,0,0,149000,47000,102000,102000
20200212,047355,世紀鋼凱基94購01,0.53,0.53,0.53,0.53,-0.02,-3.64,20000,1,10600,0,0,0,0,0,0,0,20000,-20000,-20000
20200212,047356,貿聯兆豐94購01,0.61,0.67,0.61,0.67,+0.07,11.67,148000,5,96960,0,0,0,0,0,0,0,148000,-148000,-148000
20200212,047357,欣興麥證93購01,0.11,0.17,0.11,0.17,+0.08,88.89,374000,8,52610,363000,11000,352000,0,0,0,363000,11000,352000,352000
20200212,047358,儒鴻群益93購02,,,,,0.00,0.00,0,0,0,0,0,0,0,0,0,0,0,0,0
20200212,047359,台達電群益93購01,,,,,0.00,0.00,0,0,0,0,0,0,0,0,0,0,0,0,0
20200212,04735P,聯茂兆豐94售01,0.39,0.40,0.31,0.33,-0.14,-29.79,143000,8,46530,0,0,0,0,0,0,69000,74000,-5000,-5000
20200212,047360,鴻海群益95購02,0.44,0.44,0.44,0.44,0.00,0.00,15000,1,6600,0,0,0,0,0,0,15000,0,15000,15000
20200212,047361,致茂群益93購01,0.16,0.16,0.16,0.16,0.00,0.00,1000,1,160,0,0,0,0,0,0,1000,0,1000,1000
20200212,047362,奇力新群益93購03,,,,,0.00,0.00,0,0,0,0,0,0,0,0,0,0,0,0,0
20200212,047363,奇鋐群益93購02,,,,,0.00,0.00,0,0,0,0,0,0,0,0,0,0,0,0,0
20200212,047364,欣興群益93購04,0.14,0.14,0.14,0.14,0.00,0.00,1000,1,140,0,0,0,0,0,0,1000,0,1000,1000
20200212,047365,隆達群益93購01,,,,,0.00,0.00,0,0,0,0,0,0,0,0,0,0,0,0,0
20200212,047366,台表科群益93購01,,,,,0.00,0.00,0,0,0,0,0,0,0,0,0,0,0,0,0
20200212,047367,易華電群益93購04,,,,,0.00,0.00,0,0,0,0,0,0,0,0,0,0,0,0,0
20200212,047368,南電群益93購01,0.52,0.81,0.52,0.77,+0.16,26.23,251000,47,175700,0,0,0,0,0,0,54000,197000,-143000,-143000
20200212,047369,漢唐國票94購01,2.26,2.32,2.26,2.32,0.00,0.00,30000,2,69000,0,0,0,0,0,0,0,30000,-30000,-30000
20200212,04736P,台積電永豐94售03,,,,,0.00,0.00,0,0,0,0,0,0,0,0,0,0,0,0,0
20200212,047370,聯發科國票93購03,,,,,0.00,0.00,0,0,0,0,0,0,0,0,0,0,0,0,0
20200212,047371,明泰國票93購01,,,,,0.00,0.00,0,0,0,0,0,0,0,0,0,0,0,0,0
20200212,047372,創意國票94購01,0.40,0.42,0.34,0.39,-0.11,-22.0,815000,24,290830,0,0,0,0,0,0,775000,140000,635000,635000
20200212,047373,TPK國票94購01,0.07,0.07,0.07,0.07,0.00,0.00,150000,1,10500,0,0,0,0,0,0,0,150000,-150000,-150000
20200212,047374,麗豐國票93購01,,,,,0.00,0.00,0,0,0,0,0,0,0,0,0,0,0,0,0
20200212,047375,GIS國票93購02,,,,,0.00,0.00,0,0,0,0,0,0,0,0,0,0,0,0,0
20200212,047376,南電國票94購01,0.66,0.83,0.64,0.83,+0.30,56.6,143000,6,107980,0,0,0,0,0,0,60000,83000,-23000,-23000
20200212,047377,T50反1元大93購04,,,,,0.00,0.00,0,0,0,0,0,0,0,0,0,0,0,0,0
20200212,047378,T50反1元大93購05,,,,,0.00,0.00,0,0,0,0,0,0,0,0,0,0,0,0,0
20200212,047379,元油2X元大96購03,0.11,0.12,0.11,0.12,+0.01,9.09,255000,5,28150,0,0,0,0,0,0,0,255000,-255000,-255000
20200212,04737P,正崴永豐94售02,0.81,0.81,0.81,0.81,-0.04,-4.71,92000,1,74520,0,0,0,0,0,0,92000,0,92000,92000
20200212,047380,統一元大93購01,0.71,0.72,0.71,0.72,-0.05,-6.49,50000,5,35700,0,0,0,0,0,0,50000,0,50000,50000
20200212,047381,台化元大93購01,,,,,0.00,0.00,0,0,0,0,0,0,0,0,0,0,0,0,0
20200212,047382,鴻海元大93購15,3.45,3.96,3.45,3.96,+0.56,16.47,30000,3,110800,0,0,0,0,0,0,20000,10000,10000,10000
20200212,047383,鴻海元大95購01,3.76,4.44,3.76,4.44,+0.78,21.31,46000,11,189710,0,0,0,0,0,0,19000,28000,-9000,-9000
20200212,047384,台積電元大93購20,,,,,0.00,0.00,0,0,0,0,0,0,0,0,0,0,0,0,0
20200212,047385,華邦電元大94購02,0.36,0.36,0.36,0.36,+0.07,24.14,40000,1,14400,0,0,0,0,0,0,40000,0,40000,40000
20200212,047386,南亞科元大93購01,0.81,0.81,0.77,0.81,-0.06,-6.9,150000,4,120900,0,0,0,0,0,0,150000,0,150000,150000
20200212,047387,美律元大93購05,0.73,0.88,0.73,0.88,+0.30,51.72,118000,6,98430,0,0,0,0,0,0,0,118000,-118000,-118000
20200212,047388,京元電元大95購01,0.59,0.67,0.58,0.64,+0.03,4.92,256000,12,156380,0,0,0,0,0,0,136000,120000,16000,16000
20200212,047389,義隆元大94購01,0.86,0.86,0.76,0.80,+0.13,19.4,270000,7,219800,0,0,0,0,0,0,204000,65000,139000,139000
20200212,04738P,揚明光永豐94售03,,,,,0.00,0.00,0,0,0,0,0,0,0,0,0,0,0,0,0
20200212,047390,富邦金元大93購01,0.44,0.44,0.44,0.44,+0.08,22.22,168000,3,73920,0,0,0,0,0,0,0,168000,-168000,-168000
20200212,047391,潤泰全元大93購02,,,,,0.00,0.00,0,0,0,0,0,0,0,0,0,0,0,0,0
20200212,047392,大立光元大93購24,,,,,0.00,0.00,0,0,0,0,0,0,0,0,0,0,0,0,0
20200212,047393,景碩元大93購02,4.17,4.76,4.17,4.67,0.00,0.00,90000,9,406000,0,0,0,0,0,0,0,90000,-90000,-90000
20200212,047394,合勤控元大93購02,0.04,0.04,0.04,0.04,0.00,0.00,299000,1,11960,0,0,0,0,0,0,299000,0,299000,299000
20200212,047395,聯茂元大94購01,0.74,1.08,0.74,0.98,+0.31,46.27,101000,14,97420,0,0,0,0,0,0,26000,75000,-49000,-49000
20200212,047396,力成元大93購01,7.65,7.65,7.65,7.65,0.00,0.00,1000,1,7650,0,0,0,0,0,0,0,1000,-1000,-1000
20200212,047397,啟碁元大93購05,,,,,0.00,0.00,0,0,0,0,0,0,0,0,0,0,0,0,0
20200212,047398,智易台新93購01,,,,,0.00,0.00,0,0,0,0,0,0,0,0,0,0,0,0,0
20200212,047399,華通康和93購01,0.46,0.81,0.46,0.81,+0.34,72.34,406000,20,251170,0,0,0,0,0,0,143000,263000,-120000,-120000
20200212,04739P,泰鼎永豐94售02,,,,,0.00,0.00,0,0,0,0,0,0,0,0,0,0,0,0,0
20200212,047400,欣興永豐93購03,0.01,0.01,0.01,0.01,0.00,0.00,5000,1,50,0,0,0,0,0,0,5000,0,5000,5000
20200212,047401,南茂永豐93購01,,,,,0.00,0.00,0,0,0,0,0,0,0,0,0,0,0,0,0
20200212,047402,T50反1統一94購03,,,,,0.00,0.00,0,0,0,0,0,0,0,0,0,0,0,0,0
20200212,047403,香港2X統一93購01,0.26,0.26,0.26,0.26,+0.03,13.04,10000,1,2600,0,0,0,0,0,0,0,10000,-10000,-10000
20200212,047404,香港2X統一94購01,,,,,0.00,0.00,0,0,0,0,0,0,0,0,0,0,0,0,0
20200212,047405,香港2X統一96購01,1.47,1.47,1.47,1.47,+0.02,1.38,100000,1,147000,0,0,0,0,0,0,100000,0,100000,100000
20200212,047406,香港反統一94購01,,,,,0.00,0.00,0,0,0,0,0,0,0,0,0,0,0,0,0
20200212,047407,台積電統一93購02,,,,,0.00,0.00,0,0,0,0,0,0,0,0,0,0,0,0,0
20200212,047408,嘉晶統一95購01,0.29,0.34,0.29,0.32,+0.06,23.08,187000,4,63270,0,0,0,0,0,0,3000,184000,-181000,-181000
20200212,047409,寶成統一93購01,,,,,0.00,0.00,0,0,0,0,0,0,0,0,0,0,0,0,0
20200212,04740P,台積電富邦95售02,,,,,0.00,0.00,0,0,0,0,0,0,0,0,0,0,0,0,0
20200212,047410,上銀元富96購01,2.31,2.31,2.19,2.19,0.00,0.00,512000,15,1151140,0,0,0,0,0,0,302000,210000,92000,92000
20200212,047411,康控元富93購02,,,,,0.00,0.00,0,0,0,0,0,0,0,0,0,0,0,0,0
20200212,047412,鴻海永昌93購05,0.22,0.36,0.22,0.36,0.00,0.00,235000,6,56950,0,0,0,0,0,0,30000,235000,-205000,-205000
20200212,047413,台積電永昌93購05,2.19,2.52,2.19,2.52,+0.46,22.33,2000,2,4710,0,0,0,0,0,0,1000,1000,0,0
20200212,047414,智邦永昌93購01,,,,,0.00,0.00,0,0,0,0,0,0,0,0,0,0,0,0,0
20200212,047415,欣興永昌93購01,,,,,0.00,0.00,0,0,0,0,0,0,0,0,0,0,0,0,0
20200212,047416,台泥富邦94購01,0.78,0.82,0.78,0.82,0.00,0.00,218000,7,177960,0,0,0,0,0,0,218000,0,218000,218000
20200212,047417,台塑富邦97購01,0.57,0.60,0.57,0.60,+0.03,5.26,40000,6,23030,0,0,0,0,0,0,1000,39000,-38000,-38000
20200212,047418,智邦富邦97購01,1.10,1.20,0.99,1.03,-0.04,-3.74,588000,54,630980,0,0,0,0,0,0,284000,376000,-92000,-92000
20200212,047419,聯發科富邦95購01,0.56,0.61,0.55,0.59,+0.12,25.53,330000,8,185700,0,0,0,0,0,0,70000,230000,-160000,-160000
20200212,04741P,台積電統一94售10,,,,,0.00,0.00,0,0,0,0,0,0,0,0,0,0,0,0,0
20200212,047420,全新富邦97購01,0.94,1.04,0.90,1.04,0.00,0.00,55000,6,51950,0,0,0,0,0,0,40000,15000,25000,25000
20200212,047421,聯茂富邦97購01,0.39,0.55,0.39,0.47,+0.11,30.56,1652000,37,782120,0,0,0,0,0,0,696000,956000,-260000,-260000
20200212,047422,滬深2X兆豐94購02,,,,,0.00,0.00,0,0,0,0,0,0,0,0,0,0,0,0,0
20200212,047423,華新亞東93購01,,,,,0.00,0.00,0,0,0,0,0,0,0,0,0,0,0,0,0
20200212,047424,南亞科亞東93購01,,,,,0.00,0.00,0,0,0,0,0,0,0,0,0,0,0,0,0
20200212,047425,聯發科亞東93購02,,,,,0.00,0.00,0,0,0,0,0,0,0,0,0,0,0,0,0
20200212,047426,創意亞東93購02,,,,,0.00,0.00,0,0,0,0,0,0,0,0,0,0,0,0,0
20200212,047427,貿聯亞東93購01,,,,,0.00,0.00,0,0,0,0,0,0,0,0,0,0,0,0,0
20200212,047428,臻鼎亞東93購01,0.96,0.96,0.96,0.96,0.00,0.00,10000,1,9600,0,0,0,0,0,0,10000,0,10000,10000
20200212,047429,聯茂亞東93購01,,,,,0.00,0.00,0,0,0,0,0,0,0,0,0,0,0,0,0
20200212,04742P,瑞昱統一94售01,0.73,0.75,0.73,0.75,-0.09,-10.71,98000,5,71800,0,0,0,0,0,0,33000,75000,-42000,-42000
20200212,047430,儒鴻元大93購05,,,,,0.00,0.00,0,0,0,0,0,0,0,0,0,0,0,0,0
20200212,047431,儒鴻元大93購06,0.50,0.60,0.50,0.60,0.00,0.00,859000,9,477200,0,0,0,0,0,0,448000,401000,47000,47000
20200212,047432,台達電元大93購01,,,,,0.00,0.00,0,0,0,0,0,0,0,0,0,0,0,0,0
20200212,047433,鴻海元大93購16,0.93,1.38,0.91,1.38,+0.48,53.33,292000,20,321610,0,0,0,0,0,0,215000,262000,-47000,-47000
20200212,047434,台積電元大93購21,7.95,8.15,7.95,8.15,+1.25,18.12,25000,2,201750,0,0,0,0,0,0,0,25000,-25000,-25000
20200212,047435,台積電元大94購01,10.70,10.70,10.70,10.70,+0.70,7.0,1000,1,10700,0,0,0,0,0,0,1000,0,1000,1000
20200212,047436,台積電元大94購02,10.10,10.10,10.10,10.10,0.00,0.00,1000,1,10100,0,0,0,0,0,0,1000,1000,0,0
20200212,047437,旺宏元大94購02,3.69,3.82,3.48,3.48,-0.18,-4.92,67000,16,244310,0,0,0,0,0,0,52000,27000,25000,25000
20200212,047438,台光電元大93購06,0.08,0.08,0.08,0.08,0.00,0.00,125000,1,10000,0,0,0,0,0,0,125000,0,125000,125000
20200212,047439,漢唐元大95購01,,,,,0.00,0.00,0,0,0,0,0,0,0,0,0,0,0,0,0
20200212,04743P,台積電元富94售07,,,,,0.00,0.00,0,0,0,0,0,0,0,0,0,0,0,0,0
20200212,047440,聯發科元大93購14,,,,,0.00,0.00,0,0,0,0,0,0,0,0,0,0,0,0,0
20200212,047441,聯發科元大93購15,1.00,1.20,0.97,1.20,+0.38,46.34,171000,13,189530,0,0,0,0,0,0,150000,21000,129000,129000
20200212,047442,聯詠元大93購09,2.56,2.88,2.56,2.64,+0.20,8.2,94000,7,258360,0,0,0,0,0,0,94000,0,94000,94000
20200212,047443,智原元大94購01,0.13,0.13,0.12,0.13,+0.01,8.33,60000,3,7700,0,0,0,0,0,0,40000,20000,20000,20000
20200212,047444,晶技元大93購03,0.98,1.01,0.98,1.00,+0.03,3.09,125000,3,125950,0,0,0,0,0,0,125000,0,125000,125000
20200212,047445,創意元大93購04,0.99,1.05,0.94,1.05,-0.16,-13.22,41000,5,39570,0,0,0,0,0,0,39000,11000,28000,28000
20200212,047446,TPK元大94購01,,,,,0.00,0.00,0,0,0,0,0,0,0,0,0,0,0,0,0
20200212,047447,台郡元大94購02,2.58,2.64,2.58,2.64,+1.15,77.18,33000,3,85260,0,0,0,0,0,0,33000,0,33000,33000
20200212,047448,啟碁元大93購06,0.22,0.22,0.21,0.21,0.00,0.00,136000,2,29560,0,0,0,0,0,0,136000,0,136000,136000
20200212,047449,南茂元大93購04,,,,,0.00,0.00,0,0,0,0,0,0,0,0,0,0,0,0,0
20200212,04744P,臻鼎元富94售04,0.42,0.49,0.42,0.49,-0.13,-20.97,98000,6,46040,0,0,0,0,0,0,0,98000,-98000,-98000
20200212,047450,南茂元大93購05,0.51,0.54,0.49,0.53,-0.02,-3.64,347000,18,178090,0,0,0,0,0,0,347000,94000,253000,253000
20200212,047451,世紀鋼元大93購04,,,,,0.00,0.00,0,0,0,0,0,0,0,0,0,0,0,0,0
20200212,047452,電子類元大93購03,,,,,0.00,0.00,0,0,0,0,0,0,0,0,0,0,0,0,0
20200212,047453,電子類元大93購04,,,,,0.00,0.00,0,0,0,0,0,0,0,0,0,0,0,0,0
20200212,047454,滬深2X群益96購03,0.07,0.07,0.07,0.07,0.00,0.00,499000,1,34930,0,0,0,0,0,0,0,499000,-499000,-499000
20200212,047455,儒鴻群益93購03,,,,,0.00,0.00,0,0,0,0,0,0,0,0,0,0,0,0,0
20200212,047456,力山群益93購02,,,,,0.00,0.00,0,0,0,0,0,0,0,0,0,0,0,0,0
20200212,047457,旺宏群益95購01,2.88,2.97,2.88,2.97,+0.11,3.85,51000,4,149660,0,0,0,0,0,0,40000,11000,29000,29000
20200212,047458,聯發科群益93購08,0.51,0.63,0.51,0.60,+0.14,30.43,230000,10,142320,0,0,0,0,0,0,190000,40000,150000,150000
20200212,047459,全新群益93購02,2.19,2.19,2.19,2.19,+0.25,12.89,18000,3,39420,0,0,0,0,0,0,18000,0,18000,18000
20200212,04745P,祥碩元大94售04,0.17,0.17,0.15,0.15,-0.04,-21.05,350000,4,56500,0,0,0,0,0,0,0,350000,-350000,-350000
20200212,047460,富邦金群益95購01,0.33,0.34,0.33,0.34,+0.04,13.33,10000,2,3350,0,0,0,0,0,0,10000,0,10000,10000
20200212,047461,大立光群益93購09,0.66,0.79,0.66,0.79,+0.16,25.4,45000,4,33850,0,0,0,0,0,0,20000,25000,-5000,-5000
20200212,047462,和鑫群益93購02,,,,,0.00,0.00,0,0,0,0,0,0,0,0,0,0,0,0,0
20200212,047463,中磊群益93購01,,,,,0.00,0.00,0,0,0,0,0,0,0,0,0,0,0,0,0
20200212,047464,啟碁群益93購02,,,,,0.00,0.00,0,0,0,0,0,0,0,0,0,0,0,0,0
20200212,047465,滬深2X國泰94購01,,,,,0.00,0.00,0,0,0,0,0,0,0,0,0,0,0,0,0
20200212,047466,新光金國泰95購01,0.70,0.71,0.69,0.70,+0.01,1.45,549000,42,388320,0,0,0,0,0,0,517000,21000,496000,496000
20200212,047467,滬深2X中信95購06,,,,,0.00,0.00,0,0,0,0,0,0,0,0,0,0,0,0,0
20200212,047468,為升中信95購01,,,,,0.00,0.00,0,0,0,0,0,0,0,0,0,0,0,0,0
20200212,047469,華通中信93購01,0.92,1.60,0.92,1.44,+0.53,58.24,435000,52,519370,0,0,0,0,0,0,152000,252000,-100000,-100000
20200212,04746P,臺股指元大94售17,0.41,0.41,0.35,0.35,-0.09,-20.45,719000,11,270030,0,0,0,0,0,0,0,719000,-719000,-719000
20200212,047470,聯發科中信94購03,0.07,0.10,0.07,0.10,+0.03,42.86,490000,6,42160,0,0,0,0,0,0,293000,160000,133000,133000
20200212,047471,志超中信93購01,,,,,0.00,0.00,0,0,0,0,0,0,0,0,0,0,0,0,0
20200212,047472,華通日盛93購01,,,,,0.00,0.00,0,0,0,0,0,0,0,0,0,0,0,0,0
20200212,047473,T50反1凱基93購02,,,,,0.00,0.00,0,0,0,0,0,0,0,0,0,0,0,0,0
20200212,047474,T50反1凱基93購03,,,,,0.00,0.00,0,0,0,0,0,0,0,0,0,0,0,0,0
20200212,047475,為升凱基93購04,,,,,0.00,0.00,0,0,0,0,0,0,0,0,0,0,0,0,0
20200212,047476,鴻海凱基94購08,3.47,3.83,3.47,3.83,+0.63,19.69,20000,2,73000,0,0,0,0,0,0,10000,10000,0,0
20200212,047477,台積電凱基93購15,,,,,0.00,0.00,0,0,0,0,0,0,0,0,0,0,0,0,0
20200212,047478,旺宏凱基93購04,,,,,0.00,0.00,0,0,0,0,0,0,0,0,0,0,0,0,0
20200212,047479,美律凱基94購01,0.53,0.55,0.53,0.54,0.00,0.00,45000,5,24350,0,0,0,0,0,0,0,45000,-45000,-45000
20200212,04747P,臺股指元大94售22,0.70,0.71,0.60,0.62,-0.11,-15.07,1474000,76,951690,0,0,0,0,0,0,107000,1361000,-1254000,-1254000
20200212,047480,全新凱基93購01,1.69,2.03,1.65,2.03,+0.48,30.97,194000,8,332180,0,0,0,0,0,0,170000,33000,137000,137000
20200212,047481,可成凱基93購08,2.04,2.08,2.04,2.08,+0.42,25.3,25000,3,51300,0,0,0,0,0,0,5000,20000,-15000,-15000
20200212,047482,新光金凱基99購03,0.94,0.96,0.94,0.96,+0.01,1.05,184000,40,174770,0,0,0,0,0,0,184000,0,184000,184000
20200212,047483,新光金凱基99購04,0.78,0.79,0.77,0.79,+0.02,2.6,642000,21,503560,0,0,0,0,0,0,540000,102000,438000,438000
20200212,047484,聯詠凱基93購03,0.60,0.60,0.60,0.60,+0.04,7.14,25000,1,15000,0,0,0,0,0,0,25000,0,25000,25000
20200212,047485,景碩凱基94購01,2.49,3.15,2.43,3.02,+0.56,22.76,166000,38,485960,0,0,0,0,0,0,7000,159000,-152000,-152000
20200212,047486,上海銀凱基94購01,,,,,0.00,0.00,0,0,0,0,0,0,0,0,0,0,0,0,0
20200212,047487,南電凱基94購01,0.53,0.54,0.53,0.54,+0.15,38.46,113000,2,60490,0,0,0,0,0,0,0,113000,-113000,-113000
20200212,047488,臺股指凱基93購04,,,,,0.00,0.00,0,0,0,0,0,0,0,0,0,0,0,0,0
20200212,047489,滬深2X統一93購02,,,,,0.00,0.00,0,0,0,0,0,0,0,0,0,0,0,0,0
20200212,04748P,臺股指元大94售23,0.66,0.66,0.56,0.58,-0.13,-18.31,530000,18,317250,0,0,0,0,0,0,0,530000,-530000,-530000
20200212,047490,元油反統一93購01,,,,,0.00,0.00,0,0,0,0,0,0,0,0,0,0,0,0,0
20200212,047491,旺宏統一94購03,,,,,0.00,0.00,0,0,0,0,0,0,0,0,0,0,0,0,0
20200212,047492,儒鴻元富93購01,,,,,0.00,0.00,0,0,0,0,0,0,0,0,0,0,0,0,0
20200212,047493,旺宏元富96購01,1.76,1.83,1.72,1.72,-0.06,-3.37,472000,8,838040,0,0,0,0,0,0,296000,176000,120000,120000
20200212,047494,華邦電元富96購01,0.60,0.62,0.60,0.60,+0.09,17.65,71000,11,42970,0,0,0,0,0,0,0,51000,-51000,-51000
20200212,047495,新日興元富96購01,1.65,1.70,1.56,1.57,-0.12,-7.1,1046000,66,1688800,0,0,0,0,0,0,753000,295000,458000,458000
20200212,047496,旺宏台新93購02,,,,,0.00,0.00,0,0,0,0,0,0,0,0,0,0,0,0,0
20200212,047497,聯發科康和93購01,,,,,0.00,0.00,0,0,0,0,0,0,0,0,0,0,0,0,0
20200212,047498,力成康和93購01,2.10,2.24,2.10,2.24,0.00,0.00,39000,8,84020,0,0,0,0,0,0,0,39000,-39000,-39000
20200212,047499,鑽全永豐93購01,,,,,0.00,0.00,0,0,0,0,0,0,0,0,0,0,0,0,0
20200212,04749P,臺股指元大94售25,,,,,0.00,0.00,0,0,0,0,0,0,0,0,0,0,0,0,0
20200212,047500,裕隆永豐93購01,,,,,0.00,0.00,0,0,0,0,0,0,0,0,0,0,0,0,0
20200212,047501,合勤控永豐93購01,,,,,0.00,0.00,0,0,0,0,0,0,0,0,0,0,0,0,0
20200212,047502,超眾永豐93購03,,,,,0.00,0.00,0,0,0,0,0,0,0,0,0,0,0,0,0
20200212,047503,T50反1國票93購03,,,,,0.00,0.00,0,0,0,0,0,0,0,0,0,0,0,0,0
20200212,047504,滬深2X國票9A購01,0.24,0.25,0.23,0.25,0.00,0.00,50000,3,12000,0,0,0,0,0,0,40000,10000,30000,30000
20200212,047505,元金2X國票9B購01,0.66,0.66,0.66,0.66,-0.02,-2.94,1000,1,660,0,0,0,0,0,0,0,1000,-1000,-1000
20200212,047506,卜蜂國票93購01,,,,,0.00,0.00,0,0,0,0,0,0,0,0,0,0,0,0,0
20200212,047507,台塑國票93購01,0.55,0.55,0.55,0.55,+0.02,3.77,42000,1,23100,0,0,0,0,0,0,0,42000,-42000,-42000
20200212,047508,旺宏國票94購01,,,,,0.00,0.00,0,0,0,0,0,0,0,0,0,0,0,0,0
20200212,047509,技嘉國票93購01,1.03,1.07,0.82,0.85,-0.04,-4.49,473000,26,458210,0,0,0,0,0,0,149000,294000,-145000,-145000
20200212,04750P,臺股指元大94售26,0.44,0.44,0.38,0.38,-0.09,-19.15,315000,5,128760,0,0,0,0,0,0,113000,202000,-89000,-89000
20200212,047510,奇力新國票94購01,,,,,0.00,0.00,0,0,0,0,0,0,0,0,0,0,0,0,0
20200212,047511,義隆國票93購02,1.07,1.11,0.97,1.04,+0.26,33.33,177000,16,182130,0,0,0,0,0,0,12000,165000,-153000,-153000
20200212,047512,宏達電國票94購01,,,,,0.00,0.00,0,0,0,0,0,0,0,0,0,0,0,0,0
20200212,047513,嘉晶國票93購03,,,,,0.00,0.00,0,0,0,0,0,0,0,0,0,0,0,0,0
20200212,047514,亞光國票94購01,0.36,0.46,0.36,0.44,+0.12,37.5,265000,12,113270,0,0,0,0,0,0,10000,255000,-245000,-245000
20200212,047515,智易國票94購01,,,,,0.00,0.00,0,0,0,0,0,0,0,0,0,0,0,0,0
20200212,047516,深中小第一93購01,0.70,0.70,0.70,0.70,+0.06,9.38,5000,1,3500,0,0,0,0,0,0,0,5000,-5000,-5000
20200212,047517,元油反元大96購01,,,,,0.00,0.00,0,0,0,0,0,0,0,0,0,0,0,0,0
20200212,047518,儒鴻元大93購07,0.40,0.44,0.35,0.44,-0.04,-8.33,224000,14,91540,0,0,0,0,0,0,67000,157000,-90000,-90000
20200212,047519,台達電元大93購02,0.84,0.90,0.80,0.90,+0.04,4.65,208000,7,179120,0,0,0,0,0,0,98000,110000,-12000,-12000
20200212,04751P,智邦兆豐95售02,0.93,1.00,0.89,0.99,-0.01,-1.0,658000,26,622980,0,0,0,0,0,0,355000,346000,9000,9000
20200212,047520,鴻海元大93購17,4.28,5.05,4.28,5.05,+0.82,19.39,33000,5,151350,0,0,0,0,0,0,20000,13000,7000,7000
20200212,047521,台積電元大94購03,8.60,8.65,8.60,8.65,+0.85,10.9,4000,4,34450,0,0,0,0,0,0,3000,4000,-1000,-1000
20200212,047522,微星元大93購02,,,,,0.00,0.00,0,0,0,0,0,0,0,0,0,0,0,0,0
20200212,047523,瑞昱元大93購09,2.43,2.85,2.43,2.85,+0.44,18.26,53000,9,134280,0,0,0,0,0,0,35000,18000,17000,17000
20200212,047524,瑞昱元大93購10,2.98,3.33,2.98,3.11,+0.26,9.12,26000,12,83290,0,0,0,0,0,0,10000,26000,-16000,-16000
20200212,047525,漢唐元大93購04,,,,,0.00,0.00,0,0,0,0,0,0,0,0,0,0,0,0,0
20200212,047526,可成元大93購08,1.61,1.85,1.61,1.85,0.00,0.00,79000,9,135710,0,0,0,0,0,0,0,79000,-79000,-79000
20200212,047527,高鐵元大93購02,,,,,0.00,0.00,0,0,0,0,0,0,0,0,0,0,0,0,0
20200212,047528,高鐵元大93購03,0.91,0.95,0.91,0.95,0.00,0.00,108000,7,100360,0,0,0,0,0,0,6000,108000,-102000,-102000
20200212,047529,嘉晶元大94購02,0.43,0.48,0.43,0.47,+0.07,17.5,71000,7,33360,0,0,0,0,0,0,68000,3000,65000,65000
20200212,04752P,大立光群益94售07,0.02,0.02,0.02,0.02,-0.03,-60.0,5000,5,100,0,0,0,0,0,0,5000,0,5000,5000
20200212,047530,智伸科元大93購04,,,,,0.00,0.00,0,0,0,0,0,0,0,0,0,0,0,0,0
20200212,047531,新唐元大93購02,,,,,0.00,0.00,0,0,0,0,0,0,0,0,0,0,0,0,0
20200212,047532,上海銀元大93購02,,,,,0.00,0.00,0,0,0,0,0,0,0,0,0,0,0,0,0
20200212,047533,瑞儀元大93購02,,,,,0.00,0.00,0,0,0,0,0,0,0,0,0,0,0,0,0
20200212,047534,聯茂元大93購05,,,,,0.00,0.00,0,0,0,0,0,0,0,0,0,0,0,0,0
20200212,047535,台光電日盛93購01,,,,,0.00,0.00,0,0,0,0,0,0,0,0,0,0,0,0,0
20200212,047536,正崴日盛93購01,1.16,1.17,1.13,1.17,-0.04,-3.31,313000,27,362190,0,0,0,0,0,0,313000,0,313000,313000
20200212,047537,聯發科日盛93購01,0.28,0.33,0.28,0.33,+0.10,43.48,85000,5,27900,0,0,0,0,0,0,3000,82000,-79000,-79000
20200212,047538,訊芯日盛93購01,,,,,0.00,0.00,0,0,0,0,0,0,0,0,0,0,0,0,0
20200212,047539,鴻海麥證93購01,,,,,0.00,0.00,0,0,0,0,0,0,0,0,0,0,0,0,0
20200212,04753P,台積電統一94售11,,,,,0.00,0.00,0,0,0,0,0,0,0,0,0,0,0,0,0
20200212,047540,技嘉麥證93購01,1.21,1.31,1.12,1.18,-0.02,-1.67,1673000,61,2017210,1128000,545000,583000,0,0,0,1128000,545000,583000,583000
20200212,047541,深中小凱基94購01,1.20,1.27,1.20,1.27,+0.07,5.83,71000,5,86310,0,0,0,0,0,0,64000,7000,57000,57000
20200212,047542,華通凱基94購02,0.64,1.04,0.09,0.93,+0.30,47.62,221000,18,173780,0,0,0,0,0,0,172000,89000,83000,83000
20200212,047543,鴻海凱基94購09,2.57,2.57,2.57,2.57,+0.25,10.78,32000,2,82240,0,0,0,0,0,0,32000,1000,31000,31000
20200212,047544,台積電凱基93購17,5.85,5.85,5.85,5.85,+0.50,9.35,1000,1,5850,0,0,0,0,0,0,1000,0,1000,1000
20200212,047545,智邦凱基93購05,2.10,2.29,2.01,2.24,+0.22,10.89,25000,15,54100,0,0,0,0,0,0,23000,2000,21000,21000
20200212,047546,瑞昱凱基93購06,2.00,2.06,2.00,2.06,+0.03,1.48,59000,3,119440,0,0,0,0,0,0,35000,24000,11000,11000
20200212,047547,友達凱基99購02,2.58,2.58,2.58,2.58,-0.15,-5.49,10000,1,25800,0,0,0,0,0,0,0,10000,-10000,-10000
20200212,047548,友達凱基99購03,2.08,2.08,2.08,2.08,-0.19,-8.37,5000,1,10400,0,0,0,0,0,0,0,5000,-5000,-5000
20200212,047549,聯發科凱基93購12,0.55,0.59,0.55,0.58,+0.13,28.89,100000,22,56860,0,0,0,0,0,0,100000,0,100000,100000
20200212,04754P,宏達電元富94售02,,,,,0.00,0.00,0,0,0,0,0,0,0,0,0,0,0,0,0
20200212,047550,聯發科凱基93購13,0.38,0.38,0.38,0.38,0.00,0.00,200000,1,76000,0,0,0,0,0,0,0,200000,-200000,-200000
20200212,047551,聯發科凱基93購14,,,,,0.00,0.00,0,0,0,0,0,0,0,0,0,0,0,0,0
20200212,047552,潤泰全凱基94購02,,,,,0.00,0.00,0,0,0,0,0,0,0,0,0,0,0,0,0
20200212,047553,大立光凱基93購21,,,,,0.00,0.00,0,0,0,0,0,0,0,0,0,0,0,0,0
20200212,047554,聯詠凱基93購04,,,,,0.00,0.00,0,0,0,0,0,0,0,0,0,0,0,0,0
20200212,047555,欣興凱基93購01,0.40,0.41,0.40,0.41,0.00,0.00,118000,3,47780,0,0,0,0,0,0,0,118000,-118000,-118000
20200212,047556,群創凱基95購01,,,,,0.00,0.00,0,0,0,0,0,0,0,0,0,0,0,0,0
20200212,047557,麗豐凱基94購02,1.32,1.43,0.51,1.36,+0.09,7.09,401000,16,526890,0,0,0,0,0,0,333000,101000,232000,232000
20200212,047558,臻鼎凱基93購06,2.30,2.61,0.24,1.98,+0.30,17.86,90000,8,185520,0,0,0,0,0,0,76000,20000,56000,56000
20200212,047559,彩晶凱基94購03,0.70,0.70,0.70,0.70,-0.02,-2.78,1000,1,700,0,0,0,0,0,0,0,1000,-1000,-1000
20200212,04755P,大立光元富94售07,1.02,1.02,0.96,0.96,-0.19,-16.52,9000,2,9000,0,0,0,0,0,0,6000,3000,3000,3000
20200212,047560,超眾凱基94購01,,,,,0.00,0.00,0,0,0,0,0,0,0,0,0,0,0,0,0
20200212,047561,啟碁凱基93購03,,,,,0.00,0.00,0,0,0,0,0,0,0,0,0,0,0,0,0
20200212,047562,志超凱基94購01,,,,,0.00,0.00,0,0,0,0,0,0,0,0,0,0,0,0,0
20200212,047563,柏文凱基93購02,,,,,0.00,0.00,0,0,0,0,0,0,0,0,0,0,0,0,0
20200212,047564,滬深2X國票99購01,,,,,0.00,0.00,0,0,0,0,0,0,0,0,0,0,0,0,0
20200212,047565,美律國票93購02,0.50,0.56,0.50,0.56,0.00,0.00,98000,2,52600,0,0,0,0,0,0,0,98000,-98000,-98000
20200212,047566,華新科國票94購02,,,,,0.00,0.00,0,0,0,0,0,0,0,0,0,0,0,0,0
20200212,047567,欣興國票93購05,0.37,0.37,0.37,0.37,0.00,0.00,60000,1,22200,0,0,0,0,0,0,0,60000,-60000,-60000
20200212,047568,創意國票93購03,0.29,0.29,0.29,0.29,-0.17,-36.96,50000,1,14500,0,0,0,0,0,0,50000,0,50000,50000
20200212,047569,世紀鋼國票94購02,0.42,0.42,0.42,0.42,-0.06,-12.5,75000,1,31500,0,0,0,0,0,0,75000,0,75000,75000
20200212,04756P,大立光元富94售08,1.32,1.32,1.30,1.30,-0.26,-16.67,13000,4,17040,0,0,0,0,0,0,0,13000,-13000,-13000
20200212,047570,元上證群益93購02,0.02,0.02,0.02,0.02,0.00,0.00,3000,3,60,0,0,0,0,0,0,0,3000,-3000,-3000
20200212,047571,滬深2X群益99購01,0.23,0.24,0.23,0.24,-0.01,-4.0,289000,11,67190,0,0,0,0,0,0,2000,287000,-285000,-285000
20200212,047572,深中小群益95購01,0.83,0.89,0.82,0.89,+0.10,12.66,151000,4,125270,0,0,0,0,0,0,70000,81000,-11000,-11000
20200212,047573,儒鴻群益93購04,,,,,0.00,0.00,0,0,0,0,0,0,0,0,0,0,0,0,0
20200212,047574,和大群益93購03,0.52,0.54,0.48,0.54,-0.01,-1.82,80000,12,40780,0,0,0,0,0,0,0,80000,-80000,-80000
20200212,047575,台積電群益93購08,,,,,0.00,0.00,0,0,0,0,0,0,0,0,0,0,0,0,0
20200212,047576,技嘉群益94購01,1.61,1.72,1.52,1.69,+0.08,4.97,506000,30,827030,0,0,0,0,0,0,149000,357000,-208000,-208000
20200212,047577,宏達電群益93購03,,,,,0.00,0.00,0,0,0,0,0,0,0,0,0,0,0,0,0
20200212,047578,新光金群益93購01,0.15,0.15,0.15,0.15,-0.01,-6.25,30000,2,4500,0,0,0,0,0,0,30000,0,30000,30000
20200212,047579,大立光群益94購02,4.30,4.30,4.30,4.30,0.00,0.00,2000,2,8600,0,0,0,0,0,0,2000,0,2000,2000
20200212,04757P,元油2X凱基94售04,,,,,0.00,0.00,0,0,0,0,0,0,0,0,0,0,0,0,0
20200212,047580,TPK群益94購01,,,,,0.00,0.00,0,0,0,0,0,0,0,0,0,0,0,0,0
20200212,047581,康控台新93購01,,,,,0.00,0.00,0,0,0,0,0,0,0,0,0,0,0,0,0
20200212,047582,滬深2X永豐95購02,,,,,0.00,0.00,0,0,0,0,0,0,0,0,0,0,0,0,0
20200212,047583,深中小永豐94購01,,,,,0.00,0.00,0,0,0,0,0,0,0,0,0,0,0,0,0
20200212,047584,元金2X永豐95購01,0.35,0.35,0.35,0.35,-0.02,-5.41,20000,1,7000,0,0,0,0,0,0,0,20000,-20000,-20000
20200212,047585,微星永豐93購01,,,,,0.00,0.00,0,0,0,0,0,0,0,0,0,0,0,0,0
20200212,047586,聯發科永豐94購01,0.10,0.13,0.10,0.12,+0.04,50.0,787000,9,93740,0,0,0,0,0,0,585000,202000,383000,383000
20200212,047587,義隆永豐93購02,,,,,0.00,0.00,0,0,0,0,0,0,0,0,0,0,0,0,0
20200212,047588,大立光永豐94購01,1.74,1.74,1.74,1.74,+0.08,4.82,68000,1,118320,0,0,0,0,0,0,0,68000,-68000,-68000
20200212,047589,奇鋐永豐93購01,,,,,0.00,0.00,0,0,0,0,0,0,0,0,0,0,0,0,0
20200212,04758P,國巨凱基94售03,0.09,0.09,0.09,0.09,-0.02,-18.18,215000,3,19350,0,0,0,0,0,0,210000,0,210000,210000
20200212,047590,健策永豐93購01,2.61,2.61,2.61,2.61,0.00,0.00,20000,1,52200,0,0,0,0,0,0,20000,20000,0,0
20200212,047591,訊芯永豐93購02,0.32,0.45,0.32,0.45,+0.12,36.36,158000,12,65070,0,0,0,0,0,0,11000,147000,-136000,-136000
20200212,047592,長華永豐93購01,,,,,0.00,0.00,0,0,0,0,0,0,0,0,0,0,0,0,0
20200212,047593,百和永豐93購02,,,,,0.00,0.00,0,0,0,0,0,0,0,0,0,0,0,0,0
20200212,047594,滬深2X元富93購02,,,,,0.00,0.00,0,0,0,0,0,0,0,0,0,0,0,0,0
20200212,047595,元石油元富97購01,0.42,0.42,0.42,0.42,+0.01,2.44,100000,1,42000,0,0,0,0,0,0,100000,0,100000,100000
20200212,047596,元油反元富97購01,1.26,1.26,1.26,1.26,-0.07,-5.26,30000,1,37800,0,0,0,0,0,0,30000,0,30000,30000
20200212,047597,滬深2X統一93購03,,,,,0.00,0.00,0,0,0,0,0,0,0,0,0,0,0,0,0
20200212,047598,深中小統一94購01,1.07,1.11,1.07,1.11,+0.08,7.77,220000,4,240000,0,0,0,0,0,0,190000,30000,160000,160000
20200212,047599,大立光統一93購08,3.05,3.31,3.05,3.31,+0.74,28.79,20000,2,63600,0,0,0,0,0,0,10000,10000,0,0
20200212,04759P,台積電凱基94售27,,,,,0.00,0.00,0,0,0,0,0,0,0,0,0,0,0,0,0
20200212,047600,富邦金中信93購01,,,,,0.00,0.00,0,0,0,0,0,0,0,0,0,0,0,0,0
20200212,047601,上海銀中信93購01,,,,,0.00,0.00,0,0,0,0,0,0,0,0,0,0,0,0,0
20200212,047602,GIS中信93購02,0.23,0.23,0.23,0.23,0.00,0.00,45000,1,10350,0,0,0,0,0,0,0,45000,-45000,-45000
20200212,047603,瑞昱國泰94購01,,,,,0.00,0.00,0,0,0,0,0,0,0,0,0,0,0,0,0
20200212,047604,智原國泰95購01,0.33,0.36,0.33,0.36,+0.05,16.13,1230000,17,426100,0,0,0,0,0,0,650000,380000,270000,270000
20200212,047605,滬深2X富邦93購03,,,,,0.00,0.00,0,0,0,0,0,0,0,0,0,0,0,0,0
20200212,047606,元油反富邦94購01,,,,,0.00,0.00,0,0,0,0,0,0,0,0,0,0,0,0,0
20200212,047607,上海銀富邦93購01,,,,,0.00,0.00,0,0,0,0,0,0,0,0,0,0,0,0,0
20200212,047608,聯發科第一95購01,0.86,0.86,0.86,0.86,+0.18,26.47,56000,1,48160,0,0,0,0,0,0,0,56000,-56000,-56000
20200212,047609,奇力新第一93購01,,,,,0.00,0.00,0,0,0,0,0,0,0,0,0,0,0,0,0
20200212,04760P,旺宏凱基94售02,0.57,0.57,0.57,0.57,-0.03,-5.0,26000,3,14820,0,0,0,0,0,0,6000,26000,-20000,-20000
20200212,047610,致伸第一93購01,,,,,0.00,0.00,0,0,0,0,0,0,0,0,0,0,0,0,0
20200212,047611,滬深2X群益93購02,0.03,0.03,0.03,0.03,0.00,0.00,100000,2,3000,0,0,0,0,0,0,0,100000,-100000,-100000
20200212,047612,瑞昱群益93購03,2.55,2.73,2.55,2.64,+0.27,11.39,83000,7,218030,0,0,0,0,0,0,15000,68000,-53000,-53000
20200212,047613,健策群益93購02,,,,,0.00,0.00,0,0,0,0,0,0,0,0,0,0,0,0,0
20200212,047614,台郡群益93購02,1.62,1.66,1.53,1.66,+0.90,118.42,146000,16,231000,0,0,0,0,0,0,105000,20000,85000,85000
20200212,047615,為升凱基93購05,,,,,0.00,0.00,0,0,0,0,0,0,0,0,0,0,0,0,0
20200212,047616,鴻海凱基94購10,0.97,1.06,0.97,1.06,+0.27,34.18,204000,5,207080,0,0,0,0,0,0,68000,136000,-68000,-68000
20200212,047617,瑞昱凱基93購07,1.44,1.44,1.44,1.44,+0.06,4.35,10000,1,14400,0,0,0,0,0,0,10000,0,10000,10000
20200212,047618,義隆凱基94購02,1.57,1.57,1.43,1.43,+0.16,12.6,93000,4,144330,0,0,0,0,0,0,83000,10000,73000,73000
20200212,047619,大立光凱基93購22,,,,,0.00,0.00,0,0,0,0,0,0,0,0,0,0,0,0,0
20200212,04761P,可成凱基94售09,,,,,0.00,0.00,0,0,0,0,0,0,0,0,0,0,0,0,0
20200212,047620,貿聯凱基93購01,0.18,0.19,0.18,0.19,+0.03,18.75,10000,2,1850,0,0,0,0,0,0,0,10000,-10000,-10000
20200212,047621,TPK凱基94購01,,,,,0.00,0.00,0,0,0,0,0,0,0,0,0,0,0,0,0
20200212,047622,中磊凱基93購02,,,,,0.00,0.00,0,0,0,0,0,0,0,0,0,0,0,0,0
20200212,047623,世紀鋼凱基94購02,,,,,0.00,0.00,0,0,0,0,0,0,0,0,0,0,0,0,0
20200212,047624,台達電國票93購01,0.01,0.01,0.01,0.01,0.00,0.00,20000,1,200,0,0,0,0,0,0,0,0,0,0
20200212,047625,友達國票94購01,,,,,0.00,0.00,0,0,0,0,0,0,0,0,0,0,0,0,0
20200212,047626,全新國票94購01,1.77,2.11,1.77,2.11,+0.51,31.88,18000,4,33850,0,0,0,0,0,0,18000,0,18000,18000
20200212,047627,華新科國票94購03,,,,,0.00,0.00,0,0,0,0,0,0,0,0,0,0,0,0,0
20200212,047628,新光金國票95購02,0.44,0.44,0.43,0.43,0.00,0.00,65000,15,28520,0,0,0,0,0,0,65000,0,65000,65000
20200212,047629,深中小元大96購01,0.82,0.88,0.82,0.88,+0.11,14.29,478000,7,395540,0,0,0,0,0,0,110000,368000,-258000,-258000
20200212,04762P,聯詠凱基94售03,,,,,0.00,0.00,0,0,0,0,0,0,0,0,0,0,0,0,0
20200212,047630,元油反元大96購02,,,,,0.00,0.00,0,0,0,0,0,0,0,0,0,0,0,0,0
20200212,047631,味全元大93購01,,,,,0.00,0.00,0,0,0,0,0,0,0,0,0,0,0,0,0
20200212,047632,儒鴻元大93購08,0.12,0.12,0.12,0.12,-0.03,-20.0,10000,1,1200,0,0,0,0,0,0,0,10000,-10000,-10000
20200212,047633,力山元大94購01,,,,,0.00,0.00,0,0,0,0,0,0,0,0,0,0,0,0,0
20200212,047634,亞德客元大93購01,,,,,0.00,0.00,0,0,0,0,0,0,0,0,0,0,0,0,0
20200212,047635,華新元大93購01,0.57,0.59,0.57,0.57,+0.04,7.55,8000,5,4600,0,0,0,0,0,0,5000,7000,-2000,-2000
20200212,047636,台達電元大93購03,0.84,0.90,0.84,0.90,+0.01,1.12,220000,6,189300,0,0,0,0,0,0,10000,210000,-200000,-200000
20200212,047637,旺宏元大94購03,1.88,1.94,1.78,1.82,-0.04,-2.15,339000,19,621000,0,0,0,0,0,0,127000,217000,-90000,-90000
20200212,047638,瑞昱元大93購11,2.94,3.38,2.94,3.38,+0.40,13.42,13000,4,39500,0,0,0,0,0,0,10000,3000,7000,7000
20200212,047639,聯發科元大93購16,0.31,0.37,0.31,0.37,+0.13,54.17,43000,4,14230,0,0,0,0,0,0,43000,0,43000,43000
20200212,04763P,臺股指凱基96售05,0.27,0.27,0.27,0.27,-0.06,-18.18,80000,1,21600,0,0,0,0,0,0,80000,0,80000,80000
20200212,047640,聯發科元大93購17,1.51,1.68,1.51,1.68,+0.34,25.37,12000,3,18440,0,0,0,0,0,0,10000,2000,8000,8000
20200212,047641,可成元大93購09,0.61,0.81,0.61,0.81,0.00,0.00,220000,10,163760,0,0,0,0,0,0,74000,200000,-126000,-126000
20200212,047642,宏達電元大93購08,0.39,0.39,0.37,0.37,+0.02,5.71,68000,4,25660,0,0,0,0,0,0,68000,0,68000,68000
20200212,047643,新光金元大95購02,0.61,0.61,0.60,0.60,-0.01,-1.64,100000,8,60400,0,0,0,0,0,0,100000,0,100000,100000
20200212,047644,揚明光元大94購02,0.19,0.19,0.19,0.19,0.00,0.00,10000,1,1900,0,0,0,0,0,0,10000,0,10000,10000
20200212,047645,健策元大93購03,,,,,0.00,0.00,0,0,0,0,0,0,0,0,0,0,0,0,0
20200212,047646,貿聯元大94購01,0.57,0.58,0.57,0.58,-0.02,-3.33,319000,2,182650,0,0,0,0,0,0,0,319000,-319000,-319000
20200212,047647,麗豐元大93購03,1.05,1.16,1.05,1.12,+0.09,8.74,69000,5,78500,0,0,0,0,0,0,17000,59000,-42000,-42000
20200212,047648,智伸科元大93購05,,,,,0.00,0.00,0,0,0,0,0,0,0,0,0,0,0,0,0
20200212,047649,啟碁元大93購07,,,,,0.00,0.00,0,0,0,0,0,0,0,0,0,0,0,0,0
20200212,04764P,台光電台新94售01,,,,,0.00,0.00,0,0,0,0,0,0,0,0,0,0,0,0,0
20200212,047650,矽力元大93購01,7.65,7.65,7.65,7.65,0.00,0.00,10000,1,76500,0,0,0,0,0,0,0,10000,-10000,-10000
20200212,047651,復盛元大93購01,0.91,0.91,0.86,0.86,-0.09,-9.47,200000,9,175000,0,0,0,0,0,0,200000,0,200000,200000
20200212,047652,滬深2X兆豐94購03,0.95,0.95,0.95,0.95,0.00,0.00,18000,1,17100,0,0,0,0,0,0,18000,0,18000,18000
20200212,047653,上銀兆豐94購01,1.23,1.23,1.18,1.18,0.00,0.00,61000,4,74220,0,0,0,0,0,0,51000,10000,41000,41000
20200212,047654,鴻海兆豐93購01,1.45,1.65,1.45,1.65,+0.32,24.06,70000,5,105600,0,0,0,0,0,0,30000,40000,-10000,-10000
20200212,047655,聯發科兆豐93購02,0.50,0.57,0.49,0.57,+0.17,42.5,165000,15,83000,0,0,0,0,0,0,95000,70000,25000,25000
20200212,047656,聯詠兆豐93購02,,,,,0.00,0.00,0,0,0,0,0,0,0,0,0,0,0,0,0
20200212,047657,智易兆豐94購02,,,,,0.00,0.00,0,0,0,0,0,0,0,0,0,0,0,0,0
20200212,047658,全新麥證93購02,0.63,0.78,0.62,0.78,+0.24,44.44,249000,40,174440,54000,195000,-141000,0,0,0,54000,195000,-141000,-141000
20200212,047659,大立光麥證93購01,,,,,0.00,0.00,0,0,0,0,0,0,0,0,0,0,0,0,0
20200212,04765P,宏達電永豐94售02,,,,,0.00,0.00,0,0,0,0,0,0,0,0,0,0,0,0,0
20200212,047660,南茂麥證93購02,,,,,0.00,0.00,0,0,0,0,0,0,0,0,0,0,0,0,0
20200212,047661,滬深2X永豐96購01,,,,,0.00,0.00,0,0,0,0,0,0,0,0,0,0,0,0,0
20200212,047662,東陽永豐93購01,0.01,0.01,0.01,0.01,0.00,0.00,11000,11,110,0,0,0,0,0,0,0,11000,-11000,-11000
20200212,047663,亞德客永豐93購03,1.56,1.85,1.54,1.76,+0.06,3.53,346000,27,587950,0,0,0,0,0,0,306000,57000,249000,249000
20200212,047664,智邦永豐93購02,,,,,0.00,0.00,0,0,0,0,0,0,0,0,0,0,0,0,0
20200212,047665,智易永豐93購02,,,,,0.00,0.00,0,0,0,0,0,0,0,0,0,0,0,0,0
20200212,047666,利勤永豐93購02,,,,,0.00,0.00,0,0,0,0,0,0,0,0,0,0,0,0,0
20200212,047667,新唐永豐93購02,,,,,0.00,0.00,0,0,0,0,0,0,0,0,0,0,0,0,0
20200212,047668,聯茂永豐93購02,,,,,0.00,0.00,0,0,0,0,0,0,0,0,0,0,0,0,0
20200212,047669,台表科永豐93購02,,,,,0.00,0.00,0,0,0,0,0,0,0,0,0,0,0,0,0
20200212,04766P,緯穎永豐94售02,0.08,0.08,0.08,0.08,0.00,0.00,210000,2,16800,0,0,0,0,0,0,200000,10000,190000,190000
20200212,047670,矽力永豐93購01,2.38,2.58,2.28,2.58,+0.38,17.27,76000,8,181280,0,0,0,0,0,0,20000,56000,-36000,-36000
20200212,047671,T50反1統一93購04,,,,,0.00,0.00,0,0,0,0,0,0,0,0,0,0,0,0,0
20200212,047672,欣興統一93購03,,,,,0.00,0.00,0,0,0,0,0,0,0,0,0,0,0,0,0
20200212,047673,瑞昱元富96購01,1.29,1.40,1.29,1.31,+0.08,6.5,314000,11,420440,0,0,0,0,0,0,216000,98000,118000,118000
20200212,047674,群創元富96購02,,,,,0.00,0.00,0,0,0,0,0,0,0,0,0,0,0,0,0
20200212,047675,群創元富96購03,,,,,0.00,0.00,0,0,0,0,0,0,0,0,0,0,0,0,0
20200212,047676,臺股指元富99購01,2.65,2.99,2.65,2.99,+0.42,16.34,25000,3,69650,0,0,0,0,0,0,20000,5000,15000,15000
20200212,047677,亞德客台新93購01,,,,,0.00,0.00,0,0,0,0,0,0,0,0,0,0,0,0,0
20200212,047678,景碩台新93購01,1.31,1.90,1.23,1.75,+0.45,34.62,310000,68,481400,0,0,0,0,0,0,40000,270000,-230000,-230000
20200212,047679,中磊台新93購01,,,,,0.00,0.00,0,0,0,0,0,0,0,0,0,0,0,0,0
20200212,04767P,台積電國泰95售04,,,,,0.00,0.00,0,0,0,0,0,0,0,0,0,0,0,0,0
20200212,047680,上証反中信96購01,,,,,0.00,0.00,0,0,0,0,0,0,0,0,0,0,0,0,0
20200212,047681,滬深反中信95購01,0.64,0.66,0.62,0.62,-0.02,-3.12,740000,17,474400,0,0,0,0,0,0,429000,311000,118000,118000
20200212,047682,滬深2X國泰94購02,,,,,0.00,0.00,0,0,0,0,0,0,0,0,0,0,0,0,0
20200212,047683,亞德客國泰95購01,,,,,0.00,0.00,0,0,0,0,0,0,0,0,0,0,0,0,0
20200212,047684,景碩國泰94購01,3.75,4.45,3.68,4.45,+0.68,18.04,53000,10,201760,0,0,0,0,0,0,53000,0,53000,53000
20200212,047685,嘉聯益國泰95購01,1.62,1.72,1.57,1.72,+0.20,13.16,64000,19,104750,0,0,0,0,0,0,34000,50000,-16000,-16000
20200212,047686,元油反富邦94購02,,,,,0.00,0.00,0,0,0,0,0,0,0,0,0,0,0,0,0
20200212,047687,元金2X富邦96購01,,,,,0.00,0.00,0,0,0,0,0,0,0,0,0,0,0,0,0
20200212,047688,亞德客富邦95購01,2.30,2.40,2.29,2.36,-0.11,-4.45,42000,16,98560,0,0,0,0,0,0,42000,0,42000,42000
20200212,047689,瑞昱富邦97購01,1.32,1.45,1.32,1.39,+0.10,7.75,548000,24,764430,0,0,0,0,0,0,315000,212000,103000,103000
20200212,04768P,大立光國泰96售03,1.09,1.09,1.08,1.08,-0.12,-10.0,160000,4,174000,0,0,0,0,0,0,100000,60000,40000,40000
20200212,047690,美律富邦97購01,0.45,0.52,0.45,0.51,+0.09,21.43,1267000,61,621550,0,0,0,0,0,0,180000,1052000,-872000,-872000
20200212,047691,群創第一93購01,,,,,0.00,0.00,0,0,0,0,0,0,0,0,0,0,0,0,0
20200212,047692,T50反1國票94購01,,,,,0.00,0.00,0,0,0,0,0,0,0,0,0,0,0,0,0
20200212,047693,T50反1國票95購01,,,,,0.00,0.00,0,0,0,0,0,0,0,0,0,0,0,0,0
20200212,047694,SP黃豆國票9B購01,0.47,0.47,0.47,0.47,0.00,0.00,10000,1,4700,0,0,0,0,0,0,0,10000,-10000,-10000
20200212,047695,聯發科國票93購06,1.37,1.49,1.32,1.49,+0.41,37.96,52000,11,71710,0,0,0,0,0,0,42000,10000,32000,32000
20200212,047696,聯發科國票94購02,0.89,1.03,0.86,0.95,+0.29,43.94,215000,14,197350,0,0,0,0,0,0,165000,50000,115000,115000
20200212,047697,台郡國票94購02,4.74,4.84,4.74,4.84,+1.67,52.68,24000,9,115200,0,0,0,0,0,0,12000,12000,0,0
20200212,047698,瑞儀日盛93購01,,,,,0.00,0.00,0,0,0,0,0,0,0,0,0,0,0,0,0
20200212,047699,亞德客凱基93購04,3.60,3.75,3.60,3.70,-0.17,-4.39,61000,11,221510,0,0,0,0,0,0,61000,0,61000,61000
20200212,04769P,高股息元大94售01,,,,,0.00,0.00,0,0,0,0,0,0,0,0,0,0,0,0,0
20200212,047700,華新凱基94購01,,,,,0.00,0.00,0,0,0,0,0,0,0,0,0,0,0,0,0
20200212,047701,鴻海凱基94購12,3.86,3.86,3.86,3.86,+0.27,7.52,10000,1,38600,0,0,0,0,0,0,10000,0,10000,10000
20200212,047702,鴻海凱基94購13,0.41,0.51,0.41,0.51,+0.19,59.38,139000,4,59210,0,0,0,0,0,0,0,139000,-139000,-139000
20200212,047703,台積電凱基93購19,3.76,3.76,3.76,3.76,+0.15,4.16,13000,2,48880,0,0,0,0,0,0,13000,0,13000,13000
20200212,047704,智邦凱基93購06,1.69,1.81,0.40,1.73,+0.20,13.07,97000,15,156430,0,0,0,0,0,0,65000,43000,22000,22000
20200212,047705,燿華凱基94購01,,,,,0.00,0.00,0,0,0,0,0,0,0,0,0,0,0,0,0
20200212,047706,燿華凱基95購01,,,,,0.00,0.00,0,0,0,0,0,0,0,0,0,0,0,0,0
20200212,047707,南亞科凱基93購03,0.40,0.40,0.40,0.40,0.00,0.00,68000,1,27200,0,0,0,0,0,0,0,68000,-68000,-68000
20200212,047708,聯發科凱基93購17,,,,,0.00,0.00,0,0,0,0,0,0,0,0,0,0,0,0,0
20200212,047709,聯發科凱基93購18,0.01,0.01,0.01,0.01,0.00,0.00,3000,1,30,0,0,0,0,0,0,3000,0,3000,3000
20200212,04770P,鴻海元大94售09,0.08,0.08,0.06,0.06,-0.04,-40.0,350000,5,24000,0,0,0,0,0,0,50000,300000,-250000,-250000
20200212,047710,聯發科凱基93購21,,,,,0.00,0.00,0,0,0,0,0,0,0,0,0,0,0,0,0
20200212,047711,華新科凱基94購03,7.25,7.30,7.25,7.30,+0.40,5.8,7000,3,50850,0,0,0,0,0,0,7000,7000,0,0
20200212,047712,宏達電凱基93購01,,,,,0.00,0.00,0,0,0,0,0,0,0,0,0,0,0,0,0
20200212,047713,大立光凱基93購24,,,,,0.00,0.00,0,0,0,0,0,0,0,0,0,0,0,0,0
20200212,047714,禾伸堂凱基93購03,3.18,3.37,3.18,3.37,-0.24,-6.65,18000,9,60200,0,0,0,0,0,0,16000,1000,15000,15000
20200212,047715,欣興凱基93購02,,,,,0.00,0.00,0,0,0,0,0,0,0,0,0,0,0,0,0
20200212,047716,晶技凱基93購03,0.64,0.65,0.64,0.65,0.00,0.00,10000,2,6450,0,0,0,0,0,0,10000,0,10000,10000
20200212,047717,致伸凱基93購04,,,,,0.00,0.00,0,0,0,0,0,0,0,0,0,0,0,0,0
20200212,047718,達興凱基94購01,,,,,0.00,0.00,0,0,0,0,0,0,0,0,0,0,0,0,0
20200212,047719,聯茂凱基94購01,0.19,0.24,0.19,0.23,0.00,0.00,225000,4,49950,0,0,0,0,0,0,0,225000,-225000,-225000
20200212,04771P,友達元大96售02,,,,,0.00,0.00,0,0,0,0,0,0,0,0,0,0,0,0,0
20200212,047720,聯茂凱基94購03,0.12,0.14,0.12,0.14,0.00,0.00,62000,3,8650,0,0,0,0,0,0,2000,60000,-58000,-58000
20200212,047721,GIS凱基93購04,0.40,0.40,0.40,0.40,+0.05,14.29,94000,7,37600,0,0,0,0,0,0,0,94000,-94000,-94000
20200212,047722,南電凱基94購02,0.77,0.99,0.68,0.96,+0.17,21.52,744000,37,651370,0,0,0,0,0,0,476000,314000,162000,162000
20200212,047723,廣宇群益94購01,0.09,0.09,0.09,0.09,+0.01,12.5,10000,1,900,0,0,0,0,0,0,0,10000,-10000,-10000
20200212,047724,智邦群益93購03,0.92,0.92,0.69,0.72,-0.03,-4.0,128000,5,99870,0,0,0,0,0,0,30000,98000,-68000,-68000
20200212,047725,廣達群益93購01,2.13,2.13,2.13,2.13,-0.10,-4.48,77000,3,164010,0,0,0,0,0,0,77000,0,77000,77000
20200212,047726,友達群益94購02,1.92,1.92,1.92,1.92,0.00,0.00,20000,1,38400,0,0,0,0,0,0,20000,0,20000,20000
20200212,047727,拓凱群益94購01,,,,,0.00,0.00,0,0,0,0,0,0,0,0,0,0,0,0,0
20200212,047728,嘉聯益群益93購01,,,,,0.00,0.00,0,0,0,0,0,0,0,0,0,0,0,0,0
20200212,047729,聯茂群益93購02,,,,,0.00,0.00,0,0,0,0,0,0,0,0,0,0,0,0,0
20200212,04772P,欣興元大94售08,2.61,2.61,2.55,2.55,-0.60,-19.05,80000,4,205700,0,0,0,0,0,0,0,80000,-80000,-80000
20200212,047730,矽力群益93購02,4.59,4.95,4.53,4.93,+0.55,12.56,52000,7,246930,0,0,0,0,0,0,40000,41000,-1000,-1000
20200212,047731,志超群益93購01,,,,,0.00,0.00,0,0,0,0,0,0,0,0,0,0,0,0,0
20200212,047732,美利達群益93購01,,,,,0.00,0.00,0,0,0,0,0,0,0,0,0,0,0,0,0
20200212,047733,友達兆豐95購01,,,,,0.00,0.00,0,0,0,0,0,0,0,0,0,0,0,0,0
20200212,047734,欣興兆豐94購02,0.29,0.30,0.29,0.30,+0.03,11.11,300000,3,89500,0,0,0,0,0,0,200000,100000,100000,100000
20200212,047735,華邦電台新94購01,0.23,0.23,0.23,0.23,0.00,0.00,15000,1,3450,0,0,0,0,0,0,0,15000,-15000,-15000
20200212,047736,聯發科台新94購01,1.41,1.41,1.36,1.36,+0.29,27.1,124000,3,170540,0,0,0,0,0,0,124000,0,124000,124000
20200212,047737,義隆麥證94購01,0.93,0.93,0.84,0.89,+0.16,21.92,677000,26,585420,620000,57000,563000,0,0,0,620000,57000,563000,563000
20200212,047738,美律永豐93購02,,,,,0.00,0.00,0,0,0,0,0,0,0,0,0,0,0,0,0
20200212,047739,致伸永豐93購01,,,,,0.00,0.00,0,0,0,0,0,0,0,0,0,0,0,0,0
20200212,04773P,金融類元大94售01,,,,,0.00,0.00,0,0,0,0,0,0,0,0,0,0,0,0,0
20200212,047740,樺漢永豐93購01,,,,,0.00,0.00,0,0,0,0,0,0,0,0,0,0,0,0,0
20200212,047741,鴻海統一93購06,2.09,2.73,2.09,2.73,+0.68,33.17,193000,17,434340,0,0,0,0,0,0,57000,136000,-79000,-79000
20200212,047742,友達統一93購04,,,,,0.00,0.00,0,0,0,0,0,0,0,0,0,0,0,0,0
20200212,047743,亞德客元富93購01,,,,,0.00,0.00,0,0,0,0,0,0,0,0,0,0,0,0,0
20200212,047744,大成鋼元富93購01,,,,,0.00,0.00,0,0,0,0,0,0,0,0,0,0,0,0,0
20200212,047745,廣宇元富93購01,0.08,0.10,0.08,0.10,0.00,0.00,30000,3,2800,0,0,0,0,0,0,0,30000,-30000,-30000
20200212,047746,宏碁元富93購01,,,,,0.00,0.00,0,0,0,0,0,0,0,0,0,0,0,0,0
20200212,047747,致茂元富93購01,1.07,1.07,1.07,1.07,+0.05,4.9,10000,9,10700,0,0,0,0,0,0,10000,0,10000,10000
20200212,047748,漢唐元富93購02,4.44,4.57,4.44,4.44,+0.27,6.47,30000,3,134500,0,0,0,0,0,0,10000,20000,-10000,-10000
20200212,047749,富邦金元富93購01,1.57,1.59,1.57,1.59,+0.23,16.91,44000,3,69580,0,0,0,0,0,0,34000,10000,24000,24000
20200212,04774P,金融類元大94售02,,,,,0.00,0.00,0,0,0,0,0,0,0,0,0,0,0,0,0
20200212,047750,開發金元富93購01,0.37,0.37,0.37,0.37,-0.02,-5.13,50000,3,18500,0,0,0,0,0,0,0,50000,-50000,-50000
20200212,047751,玉山金元富93購01,,,,,0.00,0.00,0,0,0,0,0,0,0,0,0,0,0,0,0
20200212,047752,健鼎元富93購01,0.94,1.39,0.94,1.39,0.00,0.00,186000,37,230720,0,0,0,0,0,0,4000,182000,-178000,-178000
20200212,047753,景碩元富93購01,2.74,3.61,2.74,3.08,0.00,0.00,355000,19,1073570,0,0,0,0,0,0,0,355000,-355000,-355000
20200212,047754,嘉澤元富93購02,,,,,0.00,0.00,0,0,0,0,0,0,0,0,0,0,0,0,0
20200212,047755,麗豐元富93購01,0.45,0.46,0.45,0.46,-0.01,-2.13,30000,4,13600,0,0,0,0,0,0,20000,10000,10000,10000
20200212,047756,利勤元富93購01,,,,,0.00,0.00,0,0,0,0,0,0,0,0,0,0,0,0,0
20200212,047757,達運元富93購01,,,,,0.00,0.00,0,0,0,0,0,0,0,0,0,0,0,0,0
20200212,047758,康舒元富93購01,,,,,0.00,0.00,0,0,0,0,0,0,0,0,0,0,0,0,0
20200212,047759,復盛元富93購01,1.30,1.32,1.24,1.27,-0.07,-5.22,524000,29,670910,0,0,0,0,0,0,404000,120000,284000,284000
20200212,04775P,台積電凱基94售29,,,,,0.00,0.00,0,0,0,0,0,0,0,0,0,0,0,0,0
20200212,047760,元油反元大96購03,,,,,0.00,0.00,0,0,0,0,0,0,0,0,0,0,0,0,0
20200212,047761,亞德客元大93購02,4.63,4.63,4.59,4.63,-0.47,-9.22,25000,4,115350,0,0,0,0,0,0,25000,0,25000,25000
20200212,047762,華新元大93購02,,,,,0.00,0.00,0,0,0,0,0,0,0,0,0,0,0,0,0
20200212,047763,旺宏元大94購04,2.58,2.75,2.50,2.50,-0.12,-4.58,109000,9,282970,0,50000,-50000,0,0,0,59000,59000,0,-50000
20200212,047764,燿華元大93購03,0.40,0.40,0.40,0.40,0.00,0.00,10000,1,4000,0,0,0,0,0,0,0,10000,-10000,-10000
20200212,047765,瑞昱元大93購12,,,,,0.00,0.00,0,0,0,0,0,0,0,0,0,0,0,0,0
20200212,047766,聯發科元大93購19,1.15,1.32,1.12,1.32,+0.30,29.41,187000,18,230840,0,0,0,0,0,0,176000,12000,164000,164000
20200212,047767,聯發科元大93購20,1.28,1.45,1.25,1.45,+0.33,29.46,203000,17,274740,0,0,0,0,0,0,201000,63000,138000,138000
20200212,047768,大立光元大95購01,4.09,4.26,4.09,4.26,+0.48,12.7,69000,6,292440,0,0,0,0,0,0,59000,69000,-10000,-10000
20200212,047769,大立光元大96購01,,,,,0.00,0.00,0,0,0,0,0,0,0,0,0,0,0,0,0
20200212,04776P,聯發科凱基94售06,0.31,0.31,0.26,0.26,-0.12,-31.58,82000,8,22780,0,0,0,0,0,0,0,82000,-82000,-82000
20200212,047770,聯詠元大93購10,0.72,0.79,0.69,0.75,+0.17,29.31,166000,6,122920,0,0,0,0,0,0,11000,155000,-144000,-144000
20200212,047771,緯創元大93購01,0.80,0.80,0.80,0.80,0.00,0.00,1000,1,800,0,0,0,0,0,0,1000,0,1000,1000
20200212,047772,泰鼎元大93購05,1.56,1.70,1.50,1.50,0.00,0.00,175000,10,273720,0,0,0,0,0,0,10000,165000,-155000,-155000
20200212,047773,超眾元大96購01,0.82,0.90,0.82,0.90,+0.08,9.76,52000,6,43970,0,0,0,0,0,0,42000,35000,7000,7000
20200212,047774,台表科元大95購01,1.78,1.93,1.78,1.93,+0.18,10.29,124000,14,229240,0,0,0,0,0,0,114000,90000,24000,24000
20200212,047775,緯穎元大95購01,,,,,0.00,0.00,0,0,0,0,0,0,0,0,0,0,0,0,0
20200212,047776,志超元大93購01,,,,,0.00,0.00,0,0,0,0,0,0,0,0,0,0,0,0,0
20200212,047777,寶成元大93購01,,,,,0.00,0.00,0,0,0,0,0,0,0,0,0,0,0,0,0
20200212,047778,美利達元大93購01,,,,,0.00,0.00,0,0,0,0,0,0,0,0,0,0,0,0,0
20200212,047779,台化中信93購01,,,,,0.00,0.00,0,0,0,0,0,0,0,0,0,0,0,0,0
20200212,04777P,聯發科凱基94售10,,,,,0.00,0.00,0,0,0,0,0,0,0,0,0,0,0,0,0
20200212,047780,友達中信96購01,2.22,2.22,2.10,2.10,-0.07,-3.23,61000,6,132820,0,0,0,0,0,0,31000,30000,1000,1000
20200212,047781,上銀國泰94購02,3.61,3.61,3.61,3.61,+0.18,5.25,23000,1,83030,0,0,0,0,0,0,23000,0,23000,23000
20200212,047782,燿華國泰95購01,0.57,0.57,0.55,0.56,+0.06,12.0,95000,15,53510,0,0,0,0,0,0,30000,65000,-35000,-35000
20200212,047783,聯茂國泰94購02,0.59,0.63,0.50,0.57,+0.23,67.65,158000,32,87870,0,0,0,0,0,0,0,138000,-138000,-138000
20200212,047784,元油反富邦94購03,,,,,0.00,0.00,0,0,0,0,0,0,0,0,0,0,0,0,0
20200212,047785,嘉聯益第一93購01,0.28,0.33,0.28,0.33,+0.05,17.86,11000,3,3580,0,0,0,0,0,0,1000,10000,-9000,-9000
20200212,047786,燿華群益93購03,,,,,0.00,0.00,0,0,0,0,0,0,0,0,0,0,0,0,0
20200212,047787,正崴群益93購01,0.76,0.76,0.73,0.73,-0.05,-6.41,121000,7,88460,0,0,0,0,0,0,121000,0,121000,121000
20200212,047788,欣興群益93購05,0.16,0.28,0.16,0.28,+0.11,64.71,1257000,22,255780,0,0,0,0,0,0,467000,790000,-323000,-323000
20200212,047789,景碩群益93購01,0.90,1.43,0.90,1.34,+0.40,42.55,391000,51,459470,0,0,0,0,0,0,50000,341000,-291000,-291000
20200212,04778P,可成凱基94售10,1.32,1.32,1.29,1.29,-0.18,-12.24,68000,3,87840,0,0,0,0,0,0,68000,68000,0,0
20200212,047790,致伸群益93購04,,,,,0.00,0.00,0,0,0,0,0,0,0,0,0,0,0,0,0
20200212,047791,聯茂群益93購04,,,,,0.00,0.00,0,0,0,0,0,0,0,0,0,0,0,0,0
20200212,047792,美利達群益93購02,,,,,0.00,0.00,0,0,0,0,0,0,0,0,0,0,0,0,0
20200212,047793,臺股指群益93購04,,,,,0.00,0.00,0,0,0,0,0,0,0,0,0,0,0,0,0
20200212,047794,臺股指群益93購05,,,,,0.00,0.00,0,0,0,0,0,0,0,0,0,0,0,0,0
20200212,047795,臺股指群益93購06,,,,,0.00,0.00,0,0,0,0,0,0,0,0,0,0,0,0,0
20200212,047796,臺股指群益93購07,,,,,0.00,0.00,0,0,0,0,0,0,0,0,0,0,0,0,0
20200212,047797,臺股指群益93購08,,,,,0.00,0.00,0,0,0,0,0,0,0,0,0,0,0,0,0
20200212,047798,臺股指群益93購09,1.72,1.72,1.71,1.71,+0.24,16.33,9000,2,15440,0,0,0,0,0,0,9000,0,9000,9000
20200212,047799,技嘉兆豐93購01,0.55,0.60,0.52,0.52,-0.05,-8.77,162000,18,91270,0,0,0,0,0,0,112000,30000,82000,82000
20200212,04779P,大立光凱基94售10,,,,,0.00,0.00,0,0,0,0,0,0,0,0,0,0,0,0,0
20200212,047800,大立光兆豐93購04,,,,,0.00,0.00,0,0,0,0,0,0,0,0,0,0,0,0,0
20200212,047801,臺股指兆豐93購01,4.85,4.85,4.85,4.85,+0.34,7.54,50000,1,242500,0,0,0,0,0,0,50000,50000,0,0
20200212,047802,滬深2X凱基95購03,0.07,0.07,0.06,0.07,0.00,0.00,225000,8,15450,0,0,0,0,0,0,175000,0,175000,175000
20200212,047803,卜蜂凱基93購03,,,,,0.00,0.00,0,0,0,0,0,0,0,0,0,0,0,0,0
20200212,047804,鴻海凱基93購26,1.43,1.55,1.43,1.55,+0.38,32.48,31000,5,47030,0,0,0,0,0,0,3000,28000,-25000,-25000
20200212,047805,台積電凱基93購21,3.27,3.27,3.27,3.27,0.00,0.00,5000,1,16350,0,0,0,0,0,0,5000,0,5000,5000
20200212,047806,旺宏凱基93購05,2.44,2.57,2.38,2.40,0.00,0.00,12000,6,28990,0,0,0,0,0,0,3000,4000,-1000,-1000
20200212,047807,華邦電凱基93購06,0.12,0.12,0.12,0.12,0.00,0.00,1000,1,120,0,0,0,0,0,0,1000,0,1000,1000
20200212,047808,智邦凱基93購07,0.83,0.93,0.68,0.68,-0.06,-8.11,81000,16,62780,0,0,0,0,0,0,81000,70000,11000,11000
20200212,047809,瑞昱凱基93購08,2.18,2.49,2.18,2.43,+0.22,9.95,76000,8,173920,0,0,0,0,0,0,76000,8000,68000,68000
20200212,04780P,大立光凱基94售11,,,,,0.00,0.00,0,0,0,0,0,0,0,0,0,0,0,0,0
20200212,047810,聯發科凱基93購22,,,,,0.00,0.00,0,0,0,0,0,0,0,0,0,0,0,0,0
20200212,047811,聯發科凱基93購23,,,,,0.00,0.00,0,0,0,0,0,0,0,0,0,0,0,0,0
20200212,047812,可成凱基93購09,,,,,0.00,0.00,0,0,0,0,0,0,0,0,0,0,0,0,0
20200212,047813,華新科凱基93購07,,,,,0.00,0.00,0,0,0,0,0,0,0,0,0,0,0,0,0
20200212,047814,宏達電凱基93購02,,,,,0.00,0.00,0,0,0,0,0,0,0,0,0,0,0,0,0
20200212,047815,大立光凱基93購25,,,,,0.00,0.00,0,0,0,0,0,0,0,0,0,0,0,0,0
20200212,047816,大立光凱基93購26,,,,,0.00,0.00,0,0,0,0,0,0,0,0,0,0,0,0,0
20200212,047817,聯茂凱基93購08,,,,,0.00,0.00,0,0,0,0,0,0,0,0,0,0,0,0,0
20200212,047818,台郡凱基93購04,2.44,2.55,2.36,2.55,+1.43,127.68,75000,24,185730,0,0,0,0,0,0,53000,17000,36000,36000
20200212,047819,南茂凱基93購04,,,,,0.00,0.00,0,0,0,0,0,0,0,0,0,0,0,0,0
20200212,04781P,欣興凱基94售06,,,,,0.00,0.00,0,0,0,0,0,0,0,0,0,0,0,0,0
20200212,047820,世紀鋼凱基93購09,,,,,0.00,0.00,0,0,0,0,0,0,0,0,0,0,0,0,0
20200212,047821,臺股指凱基93購15,,,,,0.00,0.00,0,0,0,0,0,0,0,0,0,0,0,0,0
20200212,047822,臺股指凱基93購16,1.90,2.02,1.90,2.02,+0.50,32.89,6000,3,11880,0,0,0,0,0,0,6000,0,6000,6000
20200212,047823,臺股指凱基93購17,,,,,0.00,0.00,0,0,0,0,0,0,0,0,0,0,0,0,0
20200212,047824,臺股指凱基93購18,0.23,0.34,0.23,0.33,+0.10,43.48,1646000,25,460580,0,0,0,0,0,0,1603000,0,1603000,1603000
20200212,047825,道瓊反元大96購01,,,,,0.00,0.00,0,0,0,0,0,0,0,0,0,0,0,0,0
20200212,047826,台泥元大93購01,1.75,1.85,1.75,1.85,+0.01,0.54,70000,3,126280,0,0,0,0,0,0,70000,45000,25000,25000
20200212,047827,東陽元大93購01,,,,,0.00,0.00,0,0,0,0,0,0,0,0,0,0,0,0,0
20200212,047828,華新元大93購03,0.34,0.37,0.34,0.37,+0.04,12.12,104000,6,35460,0,0,0,0,0,0,1000,103000,-102000,-102000
20200212,047829,旺宏元大93購06,,,,,0.00,0.00,0,0,0,0,0,0,0,0,0,0,0,0,0
20200212,04782P,智伸科統一96售01,1.16,1.20,1.16,1.19,0.00,0.00,187000,5,222430,0,0,0,0,0,0,86000,101000,-15000,-15000
20200212,047830,智邦元大93購08,1.14,1.20,1.08,1.08,+0.09,9.09,126000,8,141360,0,0,0,0,0,0,115000,56000,59000,59000
20200212,047831,台光電元大93購07,,,,,0.00,0.00,0,0,0,0,0,0,0,0,0,0,0,0,0
20200212,047832,漢唐元大94購03,1.75,1.75,1.75,1.75,-0.01,-0.57,30000,3,52500,0,0,0,0,0,0,30000,0,30000,30000
20200212,047833,全新元大94購02,1.37,1.62,1.34,1.62,+0.38,30.65,185000,12,273350,0,0,0,0,0,0,86000,92000,-6000,-6000
20200212,047834,義隆元大93購02,0.53,0.53,0.45,0.45,0.00,0.00,149000,3,72530,0,0,0,0,0,0,80000,69000,11000,11000
20200212,047835,華新科元大93購09,,,,,0.00,0.00,0,0,0,0,0,0,0,0,0,0,0,0,0
20200212,047836,國泰金元大93購01,0.31,0.31,0.31,0.31,+0.03,10.71,1000,1,310,0,0,0,0,0,0,1000,0,1000,1000
20200212,047837,嘉晶元大93購01,,,,,0.00,0.00,0,0,0,0,0,0,0,0,0,0,0,0,0
20200212,047838,亞光元大93購03,0.74,0.92,0.73,0.92,+0.22,31.43,310000,11,252100,0,0,0,0,0,0,100000,210000,-110000,-110000
20200212,047839,景碩元大93購03,2.48,3.08,2.32,3.08,+0.75,32.19,237000,19,610780,0,0,0,0,0,0,120000,117000,3000,3000
20200212,04783P,貿聯元富94售01,,,,,0.00,0.00,0,0,0,0,0,0,0,0,0,0,0,0,0
20200212,047840,新日興元大93購03,3.79,3.79,3.79,3.79,+0.15,4.12,4000,2,15160,0,0,0,0,0,0,4000,0,4000,4000
20200212,047841,致伸元大94購01,,,,,0.00,0.00,0,0,0,0,0,0,0,0,0,0,0,0,0
20200212,047842,聯茂元大93購06,,,,,0.00,0.00,0,0,0,0,0,0,0,0,0,0,0,0,0
20200212,047843,超眾元大93購02,,,,,0.00,0.00,0,0,0,0,0,0,0,0,0,0,0,0,0
20200212,047844,台虹元大93購02,,,,,0.00,0.00,0,0,0,0,0,0,0,0,0,0,0,0,0
20200212,047845,美利達元大93購02,0.33,0.33,0.33,0.33,0.00,0.00,68000,1,22440,0,0,0,0,0,0,68000,0,68000,68000
20200212,047846,滬深2X統一93購04,0.12,0.12,0.12,0.12,0.00,0.00,10000,1,1200,0,0,0,0,0,0,0,10000,-10000,-10000
20200212,047847,鴻海統一93購07,1.35,1.51,1.35,1.51,+0.26,20.8,431000,4,621540,0,0,0,0,0,0,232000,199000,33000,33000
20200212,047848,可成統一93購01,0.62,0.76,0.61,0.76,+0.19,33.33,565000,18,388760,0,0,0,0,0,0,84000,481000,-397000,-397000
20200212,047849,中工統一93購01,,,,,0.00,0.00,0,0,0,0,0,0,0,0,0,0,0,0,0
20200212,04784P,超眾元富94售01,1.07,1.10,0.98,0.98,-0.11,-10.09,320000,10,336720,0,0,0,0,0,0,100000,220000,-120000,-120000
20200212,047850,彩晶統一94購01,,,,,0.00,0.00,0,0,0,0,0,0,0,0,0,0,0,0,0
20200212,047851,智易元富93購02,,,,,0.00,0.00,0,0,0,0,0,0,0,0,0,0,0,0,0
20200212,047852,矽創元富93購01,0.22,0.36,0.22,0.36,+0.12,50.0,556000,29,165310,0,0,0,0,0,0,105000,451000,-346000,-346000
20200212,047853,臺股指元富93購03,,,,,0.00,0.00,0,0,0,0,0,0,0,0,0,0,0,0,0
20200212,047854,滬深2X國票96購02,,,,,0.00,0.00,0,0,0,0,0,0,0,0,0,0,0,0,0
20200212,047855,美律國票94購01,0.43,0.57,0.43,0.55,+0.16,41.03,167000,24,79310,0,0,0,0,0,0,22000,145000,-123000,-123000
20200212,047856,GIS國票94購01,0.87,0.87,0.87,0.87,0.00,0.00,126000,3,109620,0,0,0,0,0,0,0,126000,-126000,-126000
20200212,047857,臺股指國票93購12,,,,,0.00,0.00,0,0,0,0,0,0,0,0,0,0,0,0,0
20200212,047858,臺股指國票93購13,,,,,0.00,0.00,0,0,0,0,0,0,0,0,0,0,0,0,0
20200212,047859,臺股指國票93購14,,,,,0.00,0.00,0,0,0,0,0,0,0,0,0,0,0,0,0
20200212,04785P,鴻海永豐94售03,0.39,0.39,0.35,0.35,-0.10,-22.22,60000,3,22000,0,0,0,0,0,0,30000,30000,0,0
20200212,047860,臺股指國票93購15,4.63,5.35,4.63,5.35,+0.79,17.32,11000,2,58130,0,0,0,0,0,0,1000,10000,-9000,-9000
20200212,047861,臺股指國票93購16,,,,,0.00,0.00,0,0,0,0,0,0,0,0,0,0,0,0,0
20200212,047862,超眾台新93購01,0.19,0.24,0.19,0.24,+0.02,9.09,335000,23,70880,0,0,0,0,0,0,329000,6000,323000,323000
20200212,047863,東陽康和93購02,,,,,0.00,0.00,0,0,0,0,0,0,0,0,0,0,0,0,0
20200212,047864,信邦康和93購01,0.86,0.91,0.84,0.90,0.00,0.00,424000,31,361450,0,0,0,0,0,0,418000,6000,412000,412000
20200212,047865,健鼎康和93購01,0.28,0.39,0.28,0.39,+0.16,69.57,100000,10,32800,0,0,0,0,0,0,0,100000,-100000,-100000
20200212,047866,得力永豐93購01,0.02,0.02,0.02,0.02,-0.01,-33.33,100000,2,2000,0,0,0,0,0,0,100000,0,100000,100000
20200212,047867,旺宏永豐93購02,0.84,0.90,0.82,0.83,-0.04,-4.6,393000,8,332550,0,0,0,0,0,0,41000,352000,-311000,-311000
20200212,047868,欣興永豐93購04,,,,,0.00,0.00,0,0,0,0,0,0,0,0,0,0,0,0,0
20200212,047869,景碩永豐93購01,0.27,0.36,0.27,0.33,0.00,0.00,288000,16,83040,0,0,0,0,0,0,0,288000,-288000,-288000
20200212,04786P,鴻海永昌96售01,0.21,0.21,0.15,0.15,-0.08,-34.78,186000,14,30010,0,0,0,0,0,0,100000,76000,24000,24000
20200212,047870,嘉澤永豐93購02,0.72,0.74,0.72,0.74,+0.04,5.71,30000,4,21900,0,0,0,0,0,0,0,30000,-30000,-30000
20200212,047871,健策永豐93購02,2.29,2.49,2.13,2.49,+0.34,15.81,356000,35,826030,0,0,0,0,0,0,286000,90000,196000,196000
20200212,047872,貿聯永豐93購02,0.05,0.06,0.05,0.06,0.00,0.00,40000,4,2100,0,0,0,0,0,0,0,30000,-30000,-30000
20200212,047873,上緯控永豐93購02,,,,,0.00,0.00,0,0,0,0,0,0,0,0,0,0,0,0,0
20200212,047874,易華電永豐93購03,,,,,0.00,0.00,0,0,0,0,0,0,0,0,0,0,0,0,0
20200212,047875,南電永豐93購02,,,,,0.00,0.00,0,0,0,0,0,0,0,0,0,0,0,0,0
20200212,047876,美利達永豐93購01,,,,,0.00,0.00,0,0,0,0,0,0,0,0,0,0,0,0,0
20200212,047877,滬深2X中信95購07,,,,,0.00,0.00,0,0,0,0,0,0,0,0,0,0,0,0,0
20200212,047879,台積電中信93購04,6.55,6.55,6.55,6.55,+0.35,5.65,20000,2,131000,0,0,0,0,0,0,20000,0,20000,20000
20200212,04787P,台積電永昌96售04,0.59,0.60,0.56,0.57,-0.05,-8.06,1310000,32,758000,0,0,0,0,0,0,753000,414000,339000,339000
20200212,047880,聯發科國泰94購03,0.85,0.96,0.85,0.91,+0.15,19.74,787000,5,715360,0,0,0,0,0,0,700000,87000,613000,613000
20200212,047881,和鑫國泰95購01,,,,,0.00,0.00,0,0,0,0,0,0,0,0,0,0,0,0,0
20200212,047882,超眾國泰94購01,0.79,0.98,0.79,0.98,+0.11,12.64,1176000,60,1027520,0,0,0,0,0,0,755000,476000,279000,279000
20200212,047883,臺股指永昌93購01,,,,,0.00,0.00,0,0,0,0,0,0,0,0,0,0,0,0,0
20200212,047884,臺股指永昌93購02,,,,,0.00,0.00,0,0,0,0,0,0,0,0,0,0,0,0,0
20200212,047885,元金2X富邦99購01,0.71,0.73,0.71,0.73,-0.01,-1.35,33000,4,23830,0,0,0,0,0,0,10000,23000,-13000,-13000
20200212,047886,京元電富邦95購01,0.65,0.72,0.62,0.69,+0.10,16.95,900000,46,599940,0,0,0,0,0,0,744000,156000,588000,588000
20200212,047887,智原富邦97購01,,,,,0.00,0.00,0,0,0,0,0,0,0,0,0,0,0,0,0
20200212,047888,臺股指富邦93購01,,,,,0.00,0.00,0,0,0,0,0,0,0,0,0,0,0,0,0
20200212,047889,臺股指富邦93購02,,,,,0.00,0.00,0,0,0,0,0,0,0,0,0,0,0,0,0
20200212,04788P,台積電永昌96售05,,,,,0.00,0.00,0,0,0,0,0,0,0,0,0,0,0,0,0
20200212,047890,電子類富邦93購01,,,,,0.00,0.00,0,0,0,0,0,0,0,0,0,0,0,0,0
20200212,047891,滬深2X第一93購01,,,,,0.00,0.00,0,0,0,0,0,0,0,0,0,0,0,0,0
20200212,047892,康控兆豐94購01,0.11,0.11,0.11,0.11,+0.01,10.0,1000,1,110,0,0,0,0,0,0,0,1000,-1000,-1000
20200212,047893,嘉聯益兆豐94購01,0.52,0.58,0.52,0.55,+0.06,12.24,320000,5,173960,0,0,0,0,0,0,188000,132000,56000,56000
20200212,047894,大成鋼群益93購01,0.01,0.01,0.01,0.01,0.00,0.00,20000,20,200,0,0,0,0,0,0,0,0,0,0
20200212,047895,台積電群益94購04,9.90,10.40,9.80,10.30,+0.85,8.99,135000,40,1358100,0,0,0,0,0,0,75000,134000,-59000,-59000
20200212,047896,京元電群益93購01,0.93,1.00,0.91,1.00,+0.09,9.89,33000,15,31340,0,0,0,0,0,0,23000,10000,13000,13000
20200212,047897,可成群益94購01,1.81,2.11,1.72,2.11,+0.50,31.06,428000,16,836290,0,0,0,0,0,0,321000,117000,204000,204000
20200212,047898,嘉澤群益93購02,4.00,4.26,3.68,3.68,-0.23,-5.88,90000,16,356100,0,0,0,0,0,0,40000,50000,-10000,-10000
20200212,047899,貿聯群益93購03,,,,,0.00,0.00,0,0,0,0,0,0,0,0,0,0,0,0,0
20200212,04789P,台積電富邦95售03,,,,,0.00,0.00,0,0,0,0,0,0,0,0,0,0,0,0,0
20200212,047900,TPK群益93購03,,,,,0.00,0.00,0,0,0,0,0,0,0,0,0,0,0,0,0
20200212,047901,復盛群益93購01,0.72,0.74,0.72,0.74,+0.01,1.37,59000,12,42600,0,0,0,0,0,0,59000,0,59000,59000
20200212,047902,美利達群益93購03,,,,,0.00,0.00,0,0,0,0,0,0,0,0,0,0,0,0,0
20200212,047903,滬深2X元大96購01,,,,,0.00,0.00,0,0,0,0,0,0,0,0,0,0,0,0,0
20200212,047904,臺指反元大96購01,0.11,0.11,0.10,0.10,-0.01,-9.09,250000,3,26000,0,0,0,0,0,0,0,250000,-250000,-250000
20200212,047905,元油反元大96購04,,,,,0.00,0.00,0,0,0,0,0,0,0,0,0,0,0,0,0
20200212,047906,中石化元大94購01,,,,,0.00,0.00,0,0,0,0,0,0,0,0,0,0,0,0,0
20200212,047907,燿華元大93購05,,,,,0.00,0.00,0,0,0,0,0,0,0,0,0,0,0,0,0
20200212,047908,南亞科元大93購02,1.10,1.10,1.05,1.08,-0.08,-6.9,250000,7,272340,0,0,0,0,0,0,152000,98000,54000,54000
20200212,047909,超眾元大93購03,0.53,0.61,0.53,0.61,+0.05,8.93,20000,2,12120,0,0,0,0,0,0,20000,0,20000,20000
20200212,04790P,台積電元大94售19,,,,,0.00,0.00,0,0,0,0,0,0,0,0,0,0,0,0,0
20200212,047910,全新麥證94購01,0.75,0.92,0.73,0.92,+0.29,46.03,328000,39,274360,92000,236000,-144000,0,0,0,92000,236000,-144000,-144000
20200212,047911,晶技麥證94購01,0.73,0.75,0.73,0.75,+0.04,5.63,20000,2,14800,20000,0,20000,0,0,0,20000,0,20000,20000
20200212,047912,台郡麥證94購01,1.13,1.25,1.04,1.25,+0.54,76.06,1014000,73,1133690,773000,203000,570000,0,0,0,773000,203000,570000,570000
20200212,047913,美利達麥證93購01,,,,,0.00,0.00,0,0,0,0,0,0,0,0,0,0,0,0,0
20200212,047914,華新凱基93購03,,,,,0.00,0.00,0,0,0,0,0,0,0,0,0,0,0,0,0
20200212,047915,鴻海凱基93購27,,,,,0.00,0.00,0,0,0,0,0,0,0,0,0,0,0,0,0
20200212,047916,台積電凱基93購22,6.20,6.90,6.20,6.90,+0.95,15.97,4000,4,26200,0,0,0,0,0,0,4000,0,4000,4000
20200212,047917,台積電凱基94購01,6.85,6.85,6.85,6.85,+0.95,16.1,3000,1,20550,0,0,0,0,0,0,3000,0,3000,3000
20200212,047918,智邦凱基93購08,0.50,0.50,0.35,0.35,-0.08,-18.6,88000,3,33800,0,0,0,0,0,0,20000,68000,-48000,-48000
20200212,047919,技嘉凱基93購06,0.50,0.54,0.48,0.48,-0.03,-5.88,21000,4,10880,0,0,0,0,0,0,20000,1000,19000,19000
20200212,04791P,台積電元大94售20,,,,,0.00,0.00,0,0,0,0,0,0,0,0,0,0,0,0,0
20200212,047920,南亞科凱基93購04,,,,,0.00,0.00,0,0,0,0,0,0,0,0,0,0,0,0,0
20200212,047921,南亞科凱基93購05,0.61,0.61,0.61,0.61,-0.09,-12.86,260000,2,158600,0,0,0,0,0,0,200000,60000,140000,140000
20200212,047922,聯發科凱基94購01,0.31,0.31,0.31,0.31,+0.11,55.0,100000,1,31000,0,0,0,0,0,0,100000,0,100000,100000
20200212,047923,聯發科凱基94購02,0.18,0.21,0.18,0.21,+0.07,50.0,180000,4,35900,0,0,0,0,0,0,130000,50000,80000,80000
20200212,047924,可成凱基93購10,0.28,0.28,0.28,0.28,0.00,0.00,16000,2,4480,0,0,0,0,0,0,10000,6000,4000,4000
20200212,047925,可成凱基94購01,1.53,1.53,1.53,1.53,+0.11,7.75,10000,1,15300,0,0,0,0,0,0,10000,0,10000,10000
20200212,047926,可成凱基94購02,,,,,0.00,0.00,0,0,0,0,0,0,0,0,0,0,0,0,0
20200212,047927,宏達電凱基93購03,,,,,0.00,0.00,0,0,0,0,0,0,0,0,0,0,0,0,0
20200212,047928,禾伸堂凱基93購04,1.44,1.47,0.04,0.04,-1.50,-97.4,50000,10,58180,0,0,0,0,0,0,40000,10000,30000,30000
20200212,047929,景碩凱基93購03,1.17,1.69,1.09,1.61,+0.45,38.79,82000,19,119170,0,0,0,0,0,0,18000,64000,-46000,-46000
20200212,04792P,智邦元大94售06,1.52,1.72,1.48,1.72,-0.07,-3.91,628000,16,995320,0,0,0,0,0,0,379000,249000,130000,130000
20200212,047930,嘉澤凱基93購03,,,,,0.00,0.00,0,0,0,0,0,0,0,0,0,0,0,0,0
20200212,047931,日月光凱基93購01,0.73,0.87,0.73,0.87,+0.37,74.0,16000,2,12520,0,0,0,0,0,0,0,16000,-16000,-16000
20200212,047932,麗豐凱基93購01,,,,,0.00,0.00,0,0,0,0,0,0,0,0,0,0,0,0,0
20200212,047933,瑞儀凱基93購06,,,,,0.00,0.00,0,0,0,0,0,0,0,0,0,0,0,0,0
20200212,047934,GIS凱基94購01,,,,,0.00,0.00,0,0,0,0,0,0,0,0,0,0,0,0,0
20200212,047935,美利達凱基93購01,,,,,0.00,0.00,0,0,0,0,0,0,0,0,0,0,0,0,0
20200212,047936,美利達凱基93購02,,,,,0.00,0.00,0,0,0,0,0,0,0,0,0,0,0,0,0
20200212,047937,元金2X國票97購02,1.11,1.11,1.11,1.11,0.00,0.00,10000,1,11100,0,0,0,0,0,0,0,10000,-10000,-10000
20200212,047938,台化國票93購01,0.26,0.26,0.26,0.26,0.00,0.00,25000,1,6500,0,0,0,0,0,0,25000,0,25000,25000
20200212,047939,亞德客國票93購02,4.89,5.45,4.89,5.30,-0.15,-2.75,191000,18,971000,0,0,0,0,0,0,165000,26000,139000,139000
20200212,04793P,台光電元大94售07,,,,,0.00,0.00,0,0,0,0,0,0,0,0,0,0,0,0,0
20200212,047940,台光電國票93購01,0.24,0.32,0.24,0.32,0.00,0.00,92000,3,24560,0,0,0,0,0,0,0,92000,-92000,-92000
20200212,047941,義隆國票94購02,0.72,0.72,0.69,0.69,+0.09,15.0,90000,2,63600,0,0,0,0,0,0,90000,0,90000,90000
20200212,047942,華新科國票94購04,,,,,0.00,0.00,0,0,0,0,0,0,0,0,0,0,0,0,0
20200212,047943,欣興國票93購06,,,,,0.00,0.00,0,0,0,0,0,0,0,0,0,0,0,0,0
20200212,047944,中石化元富96購01,0.08,0.08,0.08,0.08,+0.01,14.29,25000,1,2000,0,0,0,0,0,0,0,25000,-25000,-25000
20200212,047945,滬深2X統一94購01,0.29,0.29,0.29,0.29,0.00,0.00,3000,1,870,0,0,0,0,0,0,0,3000,-3000,-3000
20200212,047946,南亞科統一93購04,,,,,0.00,0.00,0,0,0,0,0,0,0,0,0,0,0,0,0
20200212,047947,欣興統一93購04,0.16,0.16,0.16,0.16,0.00,0.00,20000,1,3200,0,0,0,0,0,0,20000,0,20000,20000
20200212,047948,瑞儀統一93購01,,,,,0.00,0.00,0,0,0,0,0,0,0,0,0,0,0,0,0
20200212,047949,燿華台新93購01,,,,,0.00,0.00,0,0,0,0,0,0,0,0,0,0,0,0,0
20200212,04794P,友達元大96售03,,,,,0.00,0.00,0,0,0,0,0,0,0,0,0,0,0,0,0
20200212,047950,滬深2X永豐94購02,0.05,0.05,0.05,0.05,0.00,0.00,1000,1,50,0,0,0,0,0,0,0,1000,-1000,-1000
20200212,047951,元油反永豐94購01,,,,,0.00,0.00,0,0,0,0,0,0,0,0,0,0,0,0,0
20200212,047952,華通永豐93購03,0.33,0.44,0.33,0.38,0.00,0.00,201000,19,73930,0,0,0,0,0,0,0,201000,-201000,-201000
20200212,047953,台積電永豐93購04,,,,,0.00,0.00,0,0,0,0,0,0,0,0,0,0,0,0,0
20200212,047954,漢唐永豐93購02,0.41,0.41,0.41,0.41,0.00,0.00,50000,1,20500,0,0,0,0,0,0,0,50000,-50000,-50000
20200212,047955,南亞科永豐93購01,,,,,0.00,0.00,0,0,0,0,0,0,0,0,0,0,0,0,0
20200212,047956,麗豐永豐93購02,,,,,0.00,0.00,0,0,0,0,0,0,0,0,0,0,0,0,0
20200212,047957,鎧勝永豐93購01,,,,,0.00,0.00,0,0,0,0,0,0,0,0,0,0,0,0,0
20200212,047958,矽創永豐93購02,,,,,0.00,0.00,0,0,0,0,0,0,0,0,0,0,0,0,0
20200212,047959,南電永豐93購03,,,,,0.00,0.00,0,0,0,0,0,0,0,0,0,0,0,0,0
20200212,04795P,聯發科元大94售09,,,,,0.00,0.00,0,0,0,0,0,0,0,0,0,0,0,0,0
20200212,047960,鈺齊永豐93購01,1.74,1.99,1.74,1.99,+0.32,19.16,11000,2,19390,0,0,0,0,0,0,10000,1000,9000,9000
20200212,047961,百和永豐93購03,,,,,0.00,0.00,0,0,0,0,0,0,0,0,0,0,0,0,0
20200212,047962,T50反1中信96購02,,,,,0.00,0.00,0,0,0,0,0,0,0,0,0,0,0,0,0
20200212,047963,滬深2X中信94購04,,,,,0.00,0.00,0,0,0,0,0,0,0,0,0,0,0,0,0
20200212,047964,元油反中信95購01,,,,,0.00,0.00,0,0,0,0,0,0,0,0,0,0,0,0,0
20200212,047965,景碩中信93購01,0.31,0.47,0.31,0.37,+0.08,27.59,1010000,39,364510,0,0,0,0,0,0,36000,944000,-908000,-908000
20200212,047966,華通國泰94購01,,,,,0.00,0.00,0,0,0,0,0,0,0,0,0,0,0,0,0
20200212,047967,南亞科國泰95購01,0.93,0.97,0.90,0.96,-0.02,-2.04,441000,22,414480,0,0,0,0,0,0,236000,295000,-59000,-59000
20200212,047968,南電國泰94購01,0.55,0.69,0.52,0.68,+0.13,23.64,660000,38,399590,0,0,0,0,0,0,411000,313000,98000,98000
20200212,047969,台達電富邦97購01,0.56,0.59,0.54,0.59,+0.03,5.36,707000,20,390880,0,0,0,0,0,0,600000,97000,503000,503000
20200212,04796P,聯發科元大94售10,0.40,0.40,0.36,0.36,-0.12,-25.0,110000,5,41600,0,0,0,0,0,0,0,0,0,0
20200212,047970,鴻海富邦95購01,,,,,0.00,0.00,0,0,0,0,0,0,0,0,0,0,0,0,0
20200212,047971,南亞科富邦95購01,,,,,0.00,0.00,0,0,0,0,0,0,0,0,0,0,0,0,0
20200212,047972,康控富邦95購01,0.12,0.12,0.12,0.12,+0.01,9.09,1000,1,120,0,0,0,0,0,0,0,1000,-1000,-1000
20200212,047973,華通兆豐94購01,1.47,2.11,1.47,2.11,+0.64,43.54,781000,27,1361860,6000,0,6000,0,0,0,475000,297000,178000,184000
20200212,047974,新光金兆豐93購01,0.32,0.32,0.31,0.31,0.00,0.00,295000,42,94160,0,0,0,0,0,0,230000,65000,165000,165000
20200212,047975,緯創兆豐93購01,0.97,1.02,0.97,1.02,+0.07,7.37,32000,4,31640,0,0,0,0,0,0,20000,12000,8000,8000
20200212,047976,台光電亞東93購01,,,,,0.00,0.00,0,0,0,0,0,0,0,0,0,0,0,0,0
20200212,047977,南電亞東93購03,,,,,0.00,0.00,0,0,0,0,0,0,0,0,0,0,0,0,0
20200212,047978,元油反群益97購01,,,,,0.00,0.00,0,0,0,0,0,0,0,0,0,0,0,0,0
20200212,047979,中石化群益95購01,0.05,0.05,0.05,0.05,0.00,0.00,30000,1,1500,0,0,0,0,0,0,0,30000,-30000,-30000
20200212,04797P,華新科元大94售04,,,,,0.00,0.00,0,0,0,0,0,0,0,0,0,0,0,0,0
20200212,047980,東陽群益93購02,,,,,0.00,0.00,0,0,0,0,0,0,0,0,0,0,0,0,0
20200212,047981,南亞科群益93購02,0.24,0.24,0.24,0.24,-0.07,-22.58,11000,1,2640,0,0,0,0,0,0,11000,0,11000,11000
20200212,047982,奇力新群益93購05,4.70,4.70,4.70,4.70,-0.14,-2.89,3000,3,14100,0,0,0,0,0,0,3000,0,3000,3000
20200212,047983,宏達電群益93購04,0.07,0.07,0.07,0.07,0.00,0.00,299000,1,20930,0,0,0,0,0,0,0,299000,-299000,-299000
20200212,047984,禾伸堂群益93購01,3.07,3.20,3.07,3.20,-0.11,-3.32,23000,5,72150,0,0,0,0,0,0,1000,12000,-11000,-11000
20200212,047985,欣興群益93購07,0.10,0.10,0.10,0.10,0.00,0.00,20000,1,2000,0,0,0,0,0,0,0,20000,-20000,-20000
20200212,047986,明泰群益93購01,0.37,0.37,0.37,0.37,0.00,0.00,111000,3,41070,0,0,0,0,0,0,0,111000,-111000,-111000
20200212,047987,力成群益93購01,,,,,0.00,0.00,0,0,0,0,0,0,0,0,0,0,0,0,0
20200212,047988,志超群益93購02,0.58,0.59,0.58,0.59,+0.07,13.46,2000,2,1170,0,0,0,0,0,0,0,2000,-2000,-2000
20200212,047989,深中小元大96購02,0.73,0.78,0.73,0.78,+0.10,14.71,433000,7,321680,0,0,0,0,0,0,80000,353000,-273000,-273000
20200212,04798P,牧德元大95售02,,,,,0.00,0.00,0,0,0,0,0,0,0,0,0,0,0,0,0
20200212,047990,臺指反元大96購02,,,,,0.00,0.00,0,0,0,0,0,0,0,0,0,0,0,0,0
20200212,047991,元油反元大96購05,,,,,0.00,0.00,0,0,0,0,0,0,0,0,0,0,0,0,0
20200212,047992,東陽元大96購01,0.46,0.49,0.46,0.49,0.00,0.00,565000,4,272740,0,0,0,0,0,0,37000,528000,-491000,-491000
20200212,047993,鑽全元大96購01,0.86,0.87,0.86,0.87,0.00,0.00,83000,2,72060,0,0,0,0,0,0,0,83000,-83000,-83000
20200212,047994,亞德客元大93購03,4.65,5.05,4.61,5.05,+0.18,3.7,28000,4,135200,0,0,0,0,0,0,15000,13000,2000,2000
20200212,047995,台達電元大96購01,1.42,1.48,1.42,1.48,+0.11,8.03,225000,9,320700,0,0,0,0,0,0,95000,130000,-35000,-35000
20200212,047996,華邦電元大93購04,,,,,0.00,0.00,0,0,0,0,0,0,0,0,0,0,0,0,0
20200212,047997,南亞科元大93購03,0.81,0.81,0.78,0.78,-0.02,-2.5,218000,5,172660,0,0,0,0,0,0,147000,71000,76000,76000
20200212,047998,美律元大93購06,1.06,1.31,1.06,1.28,+0.30,30.61,144000,14,174810,0,0,0,0,0,0,43000,144000,-101000,-101000
20200212,047999,聯發科元大93購22,0.46,0.52,0.46,0.52,+0.17,48.57,180000,11,90000,0,0,0,0,0,0,145000,30000,115000,115000
20200212,04799P,健策元大94售03,,,,,0.00,0.00,0,0,0,0,0,0,0,0,0,0,0,0,0
20200212,048000,義隆元大93購03,1.37,1.37,1.20,1.28,+0.23,21.9,617000,21,767660,0,0,0,0,0,0,425000,176000,249000,249000
20200212,048001,中工元大96購01,0.88,0.89,0.86,0.89,+0.02,2.3,26000,11,22640,0,0,0,0,0,0,23000,23000,0,0
20200212,048002,景碩元大93購04,1.68,2.20,1.65,2.20,+0.53,31.74,155000,12,295420,0,0,0,0,0,0,48000,127000,-79000,-79000
20200212,048003,旭富元大93購01,2.11,2.83,2.06,2.06,+0.20,10.75,98000,20,219520,0,0,0,0,0,0,84000,13000,71000,71000
20200212,048004,康控元大93購05,,,,,0.00,0.00,0,0,0,0,0,0,0,0,0,0,0,0,0
20200212,048005,鎧勝元大93購02,,,,,0.00,0.00,0,0,0,0,0,0,0,0,0,0,0,0,0
20200212,048006,瑞儀元大93購03,,,,,0.00,0.00,0,0,0,0,0,0,0,0,0,0,0,0,0
20200212,048007,明基材元大96購01,1.02,1.02,1.00,1.00,0.00,0.00,170000,8,171300,0,0,0,0,0,0,120000,50000,70000,70000
20200212,048008,聯發科富邦95購02,,,,,0.00,0.00,0,0,0,0,0,0,0,0,0,0,0,0,0
20200212,048009,中壽富邦94購01,,,,,0.00,0.00,0,0,0,0,0,0,0,0,0,0,0,0,0
20200212,04800P,聯茂元大94售08,2.33,2.33,2.33,2.33,0.00,0.00,1000,1,2330,0,0,0,0,0,0,0,1000,-1000,-1000
20200212,048010,嘉聯益富邦97購01,0.68,0.74,0.68,0.71,+0.04,5.97,591000,48,423160,0,0,0,0,0,0,288000,283000,5000,5000
20200212,048011,滬深2X國票93購02,,,,,0.00,0.00,0,0,0,0,0,0,0,0,0,0,0,0,0
20200212,048012,嘉晶國票94購01,0.59,0.68,0.59,0.68,0.00,0.00,38000,7,24200,0,0,0,0,0,0,0,38000,-38000,-38000
20200212,048013,智易國票93購01,,,,,0.00,0.00,0,0,0,0,0,0,0,0,0,0,0,0,0
20200212,048014,貿聯國票93購03,0.33,0.33,0.33,0.33,0.00,0.00,10000,1,3300,0,0,0,0,0,0,10000,0,10000,10000
20200212,048015,致伸國票93購03,,,,,0.00,0.00,0,0,0,0,0,0,0,0,0,0,0,0,0
20200212,048016,啟碁國票94購01,,,,,0.00,0.00,0,0,0,0,0,0,0,0,0,0,0,0,0
20200212,048017,美利達國票93購01,,,,,0.00,0.00,0,0,0,0,0,0,0,0,0,0,0,0,0
20200212,048018,南亞科麥證93購01,0.69,0.69,0.66,0.66,-0.04,-5.71,50000,5,33700,30000,20000,10000,0,0,0,30000,20000,10000,10000
20200212,048019,GIS麥證94購01,0.55,0.62,0.55,0.62,+0.07,12.73,41000,9,24920,2000,39000,-37000,0,0,0,11000,40000,-29000,-29000
20200212,04801P,矽力元大94售02,0.46,0.80,0.46,0.80,+0.22,37.93,5000,2,2640,0,0,0,0,0,0,4000,0,4000,4000
20200212,048020,滬深2X凱基96購02,,,,,0.00,0.00,0,0,0,0,0,0,0,0,0,0,0,0,0
20200212,048021,滬深反凱基93購02,,,,,0.00,0.00,0,0,0,0,0,0,0,0,0,0,0,0,0
20200212,048022,儒鴻凱基93購04,0.29,0.29,0.29,0.29,-0.03,-9.38,30000,1,8700,0,0,0,0,0,0,30000,0,30000,30000
20200212,048023,鴻海凱基93購28,,,,,0.00,0.00,0,0,0,0,0,0,0,0,0,0,0,0,0
20200212,048024,鴻海凱基93購29,,,,,0.00,0.00,0,0,0,0,0,0,0,0,0,0,0,0,0
20200212,048025,鴻海凱基93購30,0.12,0.18,0.12,0.17,0.00,0.00,98000,11,15960,0,0,0,0,0,0,30000,98000,-68000,-68000
20200212,048026,瑞昱凱基94購01,1.46,1.72,1.46,1.66,+0.25,17.73,164000,15,250340,0,0,0,0,0,0,154000,31000,123000,123000
20200212,048027,京元電凱基93購03,1.52,1.70,1.44,1.70,+0.12,7.59,263000,21,405390,0,0,0,0,0,0,263000,0,263000,263000
20200212,048028,聯發科凱基93購25,1.20,1.20,1.18,1.18,+0.17,16.83,110000,3,130800,0,0,0,0,0,0,110000,0,110000,110000
20200212,048029,聯發科凱基93購26,,,,,0.00,0.00,0,0,0,0,0,0,0,0,0,0,0,0,0
20200212,04802P,國巨凱基94售07,,,,,0.00,0.00,0,0,0,0,0,0,0,0,0,0,0,0,0
20200212,048030,聯發科凱基93購27,,,,,0.00,0.00,0,0,0,0,0,0,0,0,0,0,0,0,0
20200212,048031,全新凱基93購02,0.52,0.73,0.52,0.73,+0.28,62.22,595000,28,378080,0,0,0,0,0,0,33000,577000,-544000,-544000
20200212,048032,可成凱基93購13,,,,,0.00,0.00,0,0,0,0,0,0,0,0,0,0,0,0,0
20200212,048033,大立光凱基93購28,2.38,2.41,2.38,2.41,+0.42,21.11,66000,4,157750,0,0,0,0,0,0,66000,57000,9000,9000
20200212,048034,大立光凱基93購29,,,,,0.00,0.00,0,0,0,0,0,0,0,0,0,0,0,0,0
20200212,048035,聯詠凱基93購06,2.02,2.21,2.02,2.17,+0.33,17.93,140000,17,299390,0,0,0,0,0,0,20000,120000,-100000,-100000
20200212,048036,隆達凱基93購01,,,,,0.00,0.00,0,0,0,0,0,0,0,0,0,0,0,0,0
20200212,048037,台表科凱基93購05,1.64,1.78,1.61,1.78,+0.27,17.88,27000,4,46320,0,0,0,0,0,0,12000,17000,-5000,-5000
20200212,048038,樺漢凱基93購03,,,,,0.00,0.00,0,0,0,0,0,0,0,0,0,0,0,0,0
20200212,048039,矽創凱基93購03,,,,,0.00,0.00,0,0,0,0,0,0,0,0,0,0,0,0,0
20200212,04803P,台積電凱基94售30,,,,,0.00,0.00,0,0,0,0,0,0,0,0,0,0,0,0,0
20200212,048040,百和凱基93購07,,,,,0.00,0.00,0,0,0,0,0,0,0,0,0,0,0,0,0
20200212,048041,元油反台新94購01,,,,,0.00,0.00,0,0,0,0,0,0,0,0,0,0,0,0,0
20200212,048042,廣越康和93購02,0.51,0.51,0.51,0.51,0.00,0.00,94000,1,47940,0,0,0,0,0,0,94000,0,94000,94000
20200212,048043,滬深2X永豐94購03,,,,,0.00,0.00,0,0,0,0,0,0,0,0,0,0,0,0,0
20200212,048044,儒鴻永豐93購01,,,,,0.00,0.00,0,0,0,0,0,0,0,0,0,0,0,0,0
20200212,048045,上銀永豐93購02,0.22,0.22,0.20,0.20,0.00,0.00,283000,5,62100,0,0,0,0,0,0,8000,275000,-267000,-267000
20200212,048046,正崴永豐93購01,,,,,0.00,0.00,0,0,0,0,0,0,0,0,0,0,0,0,0
20200212,048047,全新永豐93購02,0.11,0.11,0.11,0.11,0.00,0.00,20000,1,2200,0,0,0,0,0,0,0,20000,-20000,-20000
20200212,048048,大立光永豐93購03,,,,,0.00,0.00,0,0,0,0,0,0,0,0,0,0,0,0,0
20200212,048049,滬深反中信96購01,0.43,0.43,0.41,0.42,-0.01,-2.33,41000,4,17420,0,0,0,0,0,0,30000,1000,29000,29000
20200212,04804P,聯發科凱基94售12,,,,,0.00,0.00,0,0,0,0,0,0,0,0,0,0,0,0,0
20200212,048050,元油反中信93購01,,,,,0.00,0.00,0,0,0,0,0,0,0,0,0,0,0,0,0
20200212,048051,大立光中信94購03,2.26,2.34,2.26,2.34,+0.15,6.85,20000,2,46000,0,0,0,0,0,0,20000,0,20000,20000
20200212,048052,力成中信93購01,0.90,1.14,0.90,1.13,+0.38,50.67,220000,25,220170,0,0,0,0,0,0,1000,217000,-216000,-216000
20200212,048053,美利達中信93購01,,,,,0.00,0.00,0,0,0,0,0,0,0,0,0,0,0,0,0
20200212,048054,鴻海國泰95購01,2.39,2.39,2.39,2.39,+0.40,20.1,1000,1,2390,0,0,0,0,0,0,1000,0,1000,1000
20200212,048055,燿華國泰95購02,0.63,0.67,0.63,0.65,+0.08,14.04,116000,23,76110,0,0,0,0,0,0,0,116000,-116000,-116000
20200212,048056,全新國泰94購02,0.92,1.08,0.92,1.08,+0.25,30.12,357000,20,354190,0,0,0,0,0,0,165000,192000,-27000,-27000
20200212,048057,宏達電國泰94購02,,,,,0.00,0.00,0,0,0,0,0,0,0,0,0,0,0,0,0
20200212,048058,大立光國泰95購01,,,,,0.00,0.00,0,0,0,0,0,0,0,0,0,0,0,0,0
20200212,048059,欣興國泰95購01,0.54,0.63,0.54,0.63,+0.13,26.0,178000,16,107830,0,0,0,0,0,0,80000,98000,-18000,-18000
20200212,04805P,創意元富94售01,0.79,0.82,0.75,0.75,+0.04,5.63,29000,9,23160,0,0,0,0,0,0,10000,19000,-9000,-9000
20200212,048060,台達電統一93購01,0.51,0.51,0.51,0.51,0.00,0.00,10000,1,5100,0,0,0,0,0,0,0,10000,-10000,-10000
20200212,048061,鴻海統一95購03,1.31,1.44,1.31,1.44,+0.22,18.03,218000,10,300220,0,0,0,0,0,0,70000,148000,-78000,-78000
20200212,048062,南亞科統一93購05,,,,,0.00,0.00,0,0,0,0,0,0,0,0,0,0,0,0,0
20200212,048063,聯發科統一93購03,0.65,0.72,0.64,0.64,+0.20,45.45,32000,4,22180,0,0,0,0,0,0,20000,12000,8000,8000
20200212,048064,可成統一93購02,0.74,0.85,0.74,0.85,0.00,0.00,13000,3,9910,0,0,0,0,0,0,1000,12000,-11000,-11000
20200212,048065,群創統一93購04,,,,,0.00,0.00,0,0,0,0,0,0,0,0,0,0,0,0,0
20200212,048066,樺漢統一93購01,0.34,0.34,0.33,0.33,0.00,0.00,100000,11,33560,0,0,0,0,0,0,100000,0,100000,100000
20200212,048067,台光電元富93購01,0.11,0.12,0.11,0.12,0.00,0.00,34000,2,3880,0,0,0,0,0,0,34000,0,34000,34000
20200212,048068,南亞科元富95購01,1.85,1.85,1.80,1.82,-0.03,-1.62,40000,7,72730,0,0,0,0,0,0,16000,29000,-13000,-13000
20200212,048069,南亞科元富95購02,0.95,0.95,0.95,0.95,0.00,0.00,10000,1,9500,0,0,0,0,0,0,0,10000,-10000,-10000
20200212,04806P,臻鼎元富94售06,0.99,1.27,0.99,1.27,-0.25,-16.45,264000,12,325880,0,0,0,0,0,0,10000,254000,-244000,-244000
20200212,048070,聯發科元富99購03,0.85,0.90,0.85,0.90,+0.16,21.62,35000,3,30650,0,0,0,0,0,0,35000,0,35000,35000
20200212,048071,創意元富93購03,,,,,0.00,0.00,0,0,0,0,0,0,0,0,0,0,0,0,0
20200212,048072,GIS元富93購05,0.25,0.28,0.25,0.28,0.00,0.00,30000,6,8000,0,0,0,0,0,0,0,30000,-30000,-30000
20200212,048073,南電元富93購02,0.47,0.66,0.45,0.65,+0.16,32.65,924000,76,504410,0,0,0,0,0,0,645000,269000,376000,376000
20200212,048074,美利達元富93購01,,,,,0.00,0.00,0,0,0,0,0,0,0,0,0,0,0,0,0
20200212,048075,美利達元富93購02,0.61,0.61,0.61,0.61,0.00,0.00,1000,1,610,0,0,0,0,0,0,1000,0,1000,1000
20200212,048076,亞光第一94購01,1.01,1.06,1.01,1.03,0.00,0.00,78000,6,80440,0,0,0,0,0,0,0,78000,-78000,-78000
20200212,048077,中磊亞東93購02,,,,,0.00,0.00,0,0,0,0,0,0,0,0,0,0,0,0,0
20200212,048078,嘉聯益亞東93購02,,,,,0.00,0.00,0,0,0,0,0,0,0,0,0,0,0,0,0
20200212,048079,燿華日盛93購01,,,,,0.00,0.00,0,0,0,0,0,0,0,0,0,0,0,0,0
20200212,04807P,聯茂元富94售01,2.01,2.01,1.77,1.77,-0.45,-20.27,97000,10,179770,0,0,0,0,0,0,37000,60000,-23000,-23000
20200212,048080,元石油凱基96購01,0.20,0.21,0.20,0.21,+0.02,10.53,65000,3,13100,0,0,0,0,0,0,0,65000,-65000,-65000
20200212,048081,元油反凱基96購01,,,,,0.00,0.00,0,0,0,0,0,0,0,0,0,0,0,0,0
20200212,048082,台苯凱基93購01,,,,,0.00,0.00,0,0,0,0,0,0,0,0,0,0,0,0,0
20200212,048083,台達電凱基93購04,0.66,0.66,0.66,0.66,+0.02,3.12,10000,1,6600,0,0,0,0,0,0,10000,0,10000,10000
20200212,048084,華通凱基93購05,1.17,2.17,1.17,1.92,+0.72,60.0,196000,35,354250,0,0,0,0,0,0,147000,74000,73000,73000
20200212,048085,鴻海凱基93購32,,,,,0.00,0.00,0,0,0,0,0,0,0,0,0,0,0,0,0
20200212,048086,鴻海凱基93購33,1.05,1.22,1.05,1.22,+0.40,48.78,35000,5,39280,0,0,0,0,0,0,9000,25000,-16000,-16000
20200212,048087,國巨凱基93購07,,,,,0.00,0.00,0,0,0,0,0,0,0,0,0,0,0,0,0
20200212,048088,台積電凱基93購23,,,,,0.00,0.00,0,0,0,0,0,0,0,0,0,0,0,0,0
20200212,048089,智邦凱基93購10,0.76,0.84,0.71,0.71,+0.12,20.34,44000,11,33290,0,0,0,0,0,0,39000,5000,34000,34000
20200212,04808P,訊芯永豐94售02,0.81,0.81,0.81,0.81,0.00,0.00,52000,2,42120,0,0,0,0,0,0,0,52000,-52000,-52000
20200212,048090,正崴凱基93購03,,,,,0.00,0.00,0,0,0,0,0,0,0,0,0,0,0,0,0
20200212,048091,漢唐凱基93購03,1.97,1.97,1.97,1.97,+0.13,7.07,87000,1,171390,0,0,0,0,0,0,87000,0,87000,87000
20200212,048092,聯發科凱基93購29,0.83,0.96,0.83,0.96,+0.23,31.51,46000,8,43380,0,0,0,0,0,0,6000,40000,-34000,-34000
20200212,048093,聯發科凱基93購30,,,,,0.00,0.00,0,0,0,0,0,0,0,0,0,0,0,0,0
20200212,048094,大立光凱基93購31,,,,,0.00,0.00,0,0,0,0,0,0,0,0,0,0,0,0,0
20200212,048095,大立光凱基93購32,,,,,0.00,0.00,0,0,0,0,0,0,0,0,0,0,0,0,0
20200212,048096,大立光凱基93購33,,,,,0.00,0.00,0,0,0,0,0,0,0,0,0,0,0,0,0
20200212,048097,聯詠凱基93購07,2.78,2.81,2.71,2.77,0.00,0.00,50000,5,138100,0,0,0,0,0,0,0,50000,-50000,-50000
20200212,048098,嘉澤凱基93購04,,,,,0.00,0.00,0,0,0,0,0,0,0,0,0,0,0,0,0
20200212,048099,健策凱基93購06,2.86,3.04,2.80,3.04,+0.36,13.43,137000,23,389780,0,0,0,0,0,0,116000,21000,95000,95000
20200212,04809P,台光電群益94售04,1.13,1.16,1.02,1.02,-0.34,-25.0,80000,16,86560,0,0,0,0,0,0,12000,68000,-56000,-56000
20200212,048100,貿聯凱基93購02,0.69,0.79,0.69,0.79,+0.06,8.22,184000,16,135920,0,0,0,0,0,0,105000,59000,46000,46000
20200212,048101,致伸凱基93購05,,,,,0.00,0.00,0,0,0,0,0,0,0,0,0,0,0,0,0
20200212,048102,矽力凱基94購01,3.66,3.92,3.59,3.92,+0.87,28.52,31000,4,117290,0,0,0,0,0,0,11000,20000,-9000,-9000
20200212,048103,GIS凱基93購06,,,,,0.00,0.00,0,0,0,0,0,0,0,0,0,0,0,0,0
20200212,048104,易華電凱基93購03,0.10,0.10,0.10,0.10,0.00,0.00,40000,4,4000,0,0,0,0,0,0,0,40000,-40000,-40000
20200212,048105,滬深2X群益99購02,,,,,0.00,0.00,0,0,0,0,0,0,0,0,0,0,0,0,0
20200212,048106,臺指反群益93購02,0.02,0.02,0.01,0.01,0.00,0.00,4700000,11,48000,0,0,0,0,0,0,4700000,0,4700000,4700000
20200212,048107,華通群益93購02,3.24,4.95,3.24,4.85,+1.76,56.96,113000,16,440840,0,0,0,0,0,0,43000,70000,-27000,-27000
20200212,048108,鴻海群益93購07,,,,,0.00,0.00,0,0,0,0,0,0,0,0,0,0,0,0,0
20200212,048109,旺宏群益94購02,,,,,0.00,0.00,0,0,0,0,0,0,0,0,0,0,0,0,0
20200212,04810P,亞德客元大94售01,,,,,0.00,0.00,0,0,0,0,0,0,0,0,0,0,0,0,0
20200212,048110,京元電群益94購01,,,,,0.00,0.00,0,0,0,0,0,0,0,0,0,0,0,0,0
20200212,048111,奇力新群益93購06,3.42,3.53,3.42,3.53,+0.37,11.71,595000,18,2038250,0,0,0,0,0,0,5000,590000,-585000,-585000
20200212,048112,宏達電群益93購05,0.11,0.11,0.11,0.11,0.00,0.00,20000,1,2200,0,0,0,0,0,0,20000,0,20000,20000
20200212,048113,欣興群益93購08,,,,,0.00,0.00,0,0,0,0,0,0,0,0,0,0,0,0,0
20200212,048114,景碩群益93購02,1.48,2.26,1.47,2.06,+0.57,38.26,402000,51,722360,0,0,0,0,0,0,91000,310000,-219000,-219000
20200212,048115,樺漢群益93購01,,,,,0.00,0.00,0,0,0,0,0,0,0,0,0,0,0,0,0
20200212,048116,矽創群益93購02,0.05,0.05,0.05,0.05,0.00,0.00,60000,2,3000,0,0,0,0,0,0,0,60000,-60000,-60000
20200212,048117,南電群益93購02,0.36,0.38,0.36,0.37,0.00,0.00,72000,13,26640,0,0,0,0,0,0,0,72000,-72000,-72000
20200212,048118,百和群益94購03,,,,,0.00,0.00,0,0,0,0,0,0,0,0,0,0,0,0,0
20200212,048119,臺指反元大96購03,,,,,0.00,0.00,0,0,0,0,0,0,0,0,0,0,0,0,0
20200212,04811P,上銀元大94售02,,,,,0.00,0.00,0,0,0,0,0,0,0,0,0,0,0,0,0
20200212,048120,台泥元大93購02,,,,,0.00,0.00,0,0,0,0,0,0,0,0,0,0,0,0,0
20200212,048121,亞德客元大93購05,4.15,4.60,4.15,4.60,+0.34,7.98,16000,3,68650,0,0,0,0,0,0,11000,5000,6000,6000
20200212,048122,台達電元大96購02,1.04,1.09,1.04,1.09,+0.09,9.0,326000,11,342140,0,0,0,0,0,0,163000,163000,0,0
20200212,048123,大立光元大93購27,,,,,0.00,0.00,0,0,0,0,0,0,0,0,0,0,0,0,0
20200212,048124,大立光元大95購03,2.10,2.10,2.10,2.10,0.00,0.00,18000,1,37800,0,0,0,0,0,0,0,18000,-18000,-18000
20200212,048125,和鑫元大96購01,0.31,0.31,0.31,0.31,0.00,0.00,68000,2,21080,0,0,0,0,0,0,68000,0,68000,68000
20200212,048126,TPK元大94購02,,,,,0.00,0.00,0,0,0,0,0,0,0,0,0,0,0,0,0
20200212,048127,麗豐元大94購01,0.55,0.59,0.53,0.56,+0.05,9.8,762000,24,429830,0,0,0,0,0,0,410000,352000,58000,58000
20200212,048128,超眾元大95購01,0.74,0.81,0.74,0.80,+0.04,5.26,86000,6,67460,0,0,0,0,0,0,75000,36000,39000,39000
20200212,048129,力成元大93購02,5.70,5.95,5.55,5.80,+0.82,16.47,33000,6,191650,0,0,0,0,0,0,0,33000,-33000,-33000
20200212,04812P,國巨元大95售03,,,,,0.00,0.00,0,0,0,0,0,0,0,0,0,0,0,0,0
20200212,048130,美利達元大96購01,1.08,1.08,1.08,1.08,-0.01,-0.92,24000,2,25920,0,0,0,0,0,0,24000,0,24000,24000
20200212,048131,全新國票94購02,0.17,0.25,0.17,0.25,+0.11,78.57,71000,5,13580,0,0,0,0,0,0,6000,65000,-59000,-59000
20200212,048132,冠德國票94購01,0.39,0.39,0.39,0.39,+0.05,14.71,50000,1,19500,0,0,0,0,0,0,0,50000,-50000,-50000
20200212,048133,臻鼎國票94購01,2.11,2.32,1.98,1.98,+0.87,78.38,58000,5,125040,0,0,0,0,0,0,20000,38000,-18000,-18000
20200212,048134,祥碩國票93購02,,,,,0.00,0.00,0,0,0,0,0,0,0,0,0,0,0,0,0
20200212,048135,瀚宇博國票94購01,0.64,0.64,0.64,0.64,0.00,0.00,10000,1,6400,0,0,0,0,0,0,0,10000,-10000,-10000
20200212,048136,聯茂國票93購04,,,,,0.00,0.00,0,0,0,0,0,0,0,0,0,0,0,0,0
20200212,048137,力成國票93購01,4.68,4.92,4.68,4.92,+0.78,18.84,24000,4,115200,0,0,0,0,0,0,0,24000,-24000,-24000
20200212,048138,羅麗芬國票94購01,,,,,0.00,0.00,0,0,0,0,0,0,0,0,0,0,0,0,0
20200212,048139,南電國票94購02,0.43,0.58,0.43,0.58,+0.15,34.88,128000,14,61920,0,0,0,0,0,0,60000,68000,-8000,-8000
20200212,04813P,智邦元大94售07,1.26,1.38,1.24,1.38,-0.04,-2.82,321000,6,426140,0,0,0,0,0,0,131000,221000,-90000,-90000
20200212,048140,T50反1統一93購05,,,,,0.00,0.00,0,0,0,0,0,0,0,0,0,0,0,0,0
20200212,048141,大成鋼統一93購02,,,,,0.00,0.00,0,0,0,0,0,0,0,0,0,0,0,0,0
20200212,048142,聯電統一93購01,1.99,2.10,1.99,2.10,-0.02,-0.94,254000,24,505900,0,0,0,0,0,0,254000,0,254000,254000
20200212,048143,聯發科統一94購03,0.77,0.88,0.77,0.86,+0.20,30.3,929000,19,737310,0,0,0,0,0,0,596000,333000,263000,263000
20200212,048144,華固統一93購01,,,,,0.00,0.00,0,0,0,0,0,0,0,0,0,0,0,0,0
20200212,048145,大立光統一93購10,,,,,0.00,0.00,0,0,0,0,0,0,0,0,0,0,0,0,0
20200212,048146,大立光統一93購11,0.10,0.10,0.10,0.10,0.00,0.00,10000,1,1000,0,0,0,0,0,0,10000,0,10000,10000
20200212,048147,元油反元富95購01,,,,,0.00,0.00,0,0,0,0,0,0,0,0,0,0,0,0,0
20200212,048148,欣興元富93購02,0.05,0.05,0.05,0.05,0.00,0.00,1000,1,50,0,0,0,0,0,0,0,1000,-1000,-1000
20200212,048149,泰鼎元富95購01,1.83,1.91,1.75,1.75,0.00,0.00,947000,35,1693160,0,0,0,0,0,0,61000,886000,-825000,-825000
20200212,04814P,健策元大96售01,0.16,0.16,0.16,0.16,0.00,0.00,10000,1,1600,0,0,0,0,0,0,0,10000,-10000,-10000
20200212,048150,矽力元富93購01,,,,,0.00,0.00,0,0,0,0,0,0,0,0,0,0,0,0,0
20200212,048151,世紀鋼元富93購01,,,,,0.00,0.00,0,0,0,0,0,0,0,0,0,0,0,0,0
20200212,048152,力山兆豐94購01,,,,,0.00,0.00,0,0,0,0,0,0,0,0,0,0,0,0,0
20200212,048153,台積電兆豐94購01,9.80,10.30,9.65,10.30,+0.80,8.42,128000,5,1257250,0,0,0,0,0,0,63000,65000,-2000,-2000
20200212,048154,旺宏兆豐94購01,1.49,1.50,1.41,1.41,-0.06,-4.08,68000,4,100100,0,0,0,0,0,0,34000,34000,0,0
20200212,048155,瑞昱兆豐93購01,0.99,1.11,0.98,1.05,+0.17,19.32,111000,19,116650,0,0,0,0,0,0,20000,91000,-71000,-71000
20200212,048156,正崴兆豐93購01,0.72,0.76,0.69,0.74,0.00,0.00,589000,54,427990,0,0,0,0,0,0,589000,0,589000,589000
20200212,048157,美律兆豐93購01,0.24,0.31,0.24,0.31,+0.10,47.62,530000,48,146630,0,0,0,0,0,0,110000,420000,-310000,-310000
20200212,048158,大立光兆豐95購01,0.82,0.82,0.82,0.82,+0.04,5.13,125000,3,102500,0,0,0,0,0,0,120000,5000,115000,115000
20200212,048159,聯詠兆豐93購03,1.41,1.51,1.27,1.47,+0.25,20.49,147000,24,211510,0,0,0,0,0,0,86000,61000,25000,25000
20200212,04815P,致伸元大94售04,,,,,0.00,0.00,0,0,0,0,0,0,0,0,0,0,0,0,0
20200212,048160,GIS兆豐95購01,0.29,0.29,0.29,0.29,0.00,0.00,6000,1,1740,0,0,0,0,0,0,0,6000,-6000,-6000
20200212,048161,旺宏麥證94購01,,,,,0.00,0.00,0,0,0,0,0,0,0,0,0,0,0,0,0
20200212,048162,矽力麥證93購01,4.48,4.57,4.33,4.57,+0.38,9.07,30000,3,133800,10000,20000,-10000,0,0,0,10000,20000,-10000,-10000
20200212,048163,南亞科台新93購01,0.72,0.72,0.72,0.72,-0.01,-1.37,49000,1,35280,0,0,0,0,0,0,49000,0,49000,49000
20200212,048164,台光電康和93購01,,,,,0.00,0.00,0,0,0,0,0,0,0,0,0,0,0,0,0
20200212,048165,嘉澤康和93購01,,,,,0.00,0.00,0,0,0,0,0,0,0,0,0,0,0,0,0
20200212,048166,滬深2X永豐96購02,,,,,0.00,0.00,0,0,0,0,0,0,0,0,0,0,0,0,0
20200212,048167,旺宏永豐93購04,0.50,0.50,0.43,0.43,-0.05,-10.42,834000,4,373420,0,0,0,0,0,0,824000,10000,814000,814000
20200212,048168,致茂永豐93購02,0.17,0.17,0.17,0.17,0.00,0.00,1000,1,170,0,0,0,0,0,0,1000,0,1000,1000
20200212,048169,瑞昱永豐93購02,,,,,0.00,0.00,0,0,0,0,0,0,0,0,0,0,0,0,0
20200212,04816P,台積電兆豐94售06,,,,,0.00,0.00,0,0,0,0,0,0,0,0,0,0,0,0,0
20200212,048170,智原永豐93購02,,,,,0.00,0.00,0,0,0,0,0,0,0,0,0,0,0,0,0
20200212,048171,創意永豐93購03,,,,,0.00,0.00,0,0,0,0,0,0,0,0,0,0,0,0,0
20200212,048172,祥碩永豐93購02,,,,,0.00,0.00,0,0,0,0,0,0,0,0,0,0,0,0,0
20200212,048173,上海銀永豐93購02,,,,,0.00,0.00,0,0,0,0,0,0,0,0,0,0,0,0,0
20200212,048174,東陽中信93購01,,,,,0.00,0.00,0,0,0,0,0,0,0,0,0,0,0,0,0
20200212,048175,矽力國泰95購01,,,,,0.00,0.00,0,0,0,0,0,0,0,0,0,0,0,0,0
20200212,048176,美利達國泰94購01,0.42,0.42,0.41,0.41,-0.01,-2.38,6000,2,2470,0,0,0,0,0,0,1000,5000,-4000,-4000
20200212,048177,臺指反富邦99購01,0.20,0.20,0.20,0.20,0.00,0.00,102000,2,20400,0,0,0,0,0,0,100000,2000,98000,98000
20200212,048178,上銀富邦95購02,0.93,0.93,0.87,0.89,+0.01,1.14,979000,46,883540,0,0,0,0,0,0,656000,413000,243000,243000
20200212,048179,臻鼎富邦97購01,1.01,1.13,0.90,0.90,+0.09,11.11,109000,9,109330,0,0,0,0,0,0,17000,92000,-75000,-75000
20200212,04817P,創意國票95售02,2.37,2.37,2.37,2.37,0.00,0.00,10000,1,23700,0,0,0,0,0,0,0,10000,-10000,-10000
20200212,048180,聯茂亞東93購02,0.12,0.16,0.12,0.16,0.00,0.00,25000,5,3500,0,0,0,0,0,0,0,25000,-25000,-25000
20200212,048181,A50正2群益95購01,,,,,0.00,0.00,0,0,0,0,0,0,0,0,0,0,0,0,0
20200212,048182,祥碩群益93購02,,,,,0.00,0.00,0,0,0,0,0,0,0,0,0,0,0,0,0
20200212,048183,上海銀群益94購01,,,,,0.00,0.00,0,0,0,0,0,0,0,0,0,0,0,0,0
20200212,048184,達運群益93購01,0.26,0.26,0.26,0.26,+0.01,4.0,2000,1,520,0,0,0,0,0,0,2000,0,2000,2000
20200212,048185,台郡群益93購04,0.78,0.86,0.73,0.82,+0.35,74.47,205000,24,159830,0,0,0,0,0,0,114000,0,114000,114000
20200212,048186,元黃金元大96購01,,,,,0.00,0.00,0,0,0,0,0,0,0,0,0,0,0,0,0
20200212,048187,臺指反元大96購04,,,,,0.00,0.00,0,0,0,0,0,0,0,0,0,0,0,0,0
20200212,048188,臺指反元大96購05,,,,,0.00,0.00,0,0,0,0,0,0,0,0,0,0,0,0,0
20200212,048189,臺指反元大96購06,0.24,0.24,0.24,0.24,0.00,0.00,100000,1,24000,0,0,0,0,0,0,100000,0,100000,100000
20200212,04818P,華新科永豐94售03,,,,,0.00,0.00,0,0,0,0,0,0,0,0,0,0,0,0,0
20200212,048190,道瓊反元大96購02,,,,,0.00,0.00,0,0,0,0,0,0,0,0,0,0,0,0,0
20200212,048191,亞德客元大93購06,6.05,6.05,6.05,6.05,-0.10,-1.63,20000,2,121000,0,0,0,0,0,0,20000,0,20000,20000
20200212,048192,華通元大96購01,3.15,4.07,3.05,3.95,+0.83,26.6,517000,74,1824010,0,0,0,0,0,0,448000,215000,233000,233000
20200212,048193,旺宏元大94購05,4.03,4.17,3.90,3.90,-0.11,-2.74,21000,6,84690,0,0,0,0,0,0,21000,6000,15000,15000
20200212,048194,華邦電元大94購04,,,,,0.00,0.00,0,0,0,0,0,0,0,0,0,0,0,0,0
20200212,048195,聯發科元大93購23,0.55,0.62,0.55,0.59,+0.19,47.5,64000,10,37310,0,0,0,0,0,0,3000,61000,-58000,-58000
20200212,048196,聯發科元大93購24,0.91,1.07,0.88,1.03,+0.26,33.77,277000,20,276270,0,0,0,0,0,0,246000,31000,215000,215000
20200212,048197,義隆元大93購04,1.91,1.91,1.63,1.78,+0.32,21.92,127000,10,220860,0,0,0,0,0,0,84000,52000,32000,32000
20200212,048198,大立光元大93購28,,,,,0.00,0.00,0,0,0,0,0,0,0,0,0,0,0,0,0
20200212,048199,大立光元大94購03,2.14,2.21,2.14,2.21,0.00,0.00,48000,4,103980,0,0,0,0,0,0,30000,18000,12000,12000
20200212,04819P,嘉澤永豐94售01,0.36,0.36,0.36,0.36,0.00,0.00,1000,1,360,0,0,0,0,0,0,1000,0,1000,1000
20200212,048200,欣興元大93購07,,,,,0.00,0.00,0,0,0,0,0,0,0,0,0,0,0,0,0
20200212,048201,智易元大93購06,,,,,0.00,0.00,0,0,0,0,0,0,0,0,0,0,0,0,0
20200212,048202,瑞儀元大93購04,,,,,0.00,0.00,0,0,0,0,0,0,0,0,0,0,0,0,0
20200212,048203,矽力元大93購02,5.35,5.60,5.05,5.60,+0.60,12.0,92000,6,486250,0,0,0,0,0,0,91000,1000,90000,90000
20200212,048204,訊芯元大93購06,1.27,1.55,1.27,1.55,+0.33,27.05,12000,3,18250,0,0,0,0,0,0,1000,11000,-10000,-10000
20200212,048205,臺股指元大93購39,,,,,0.00,0.00,0,0,0,0,0,0,0,0,0,0,0,0,0
20200212,048206,臺股指元大93購40,,,,,0.00,0.00,0,0,0,0,0,0,0,0,0,0,0,0,0
20200212,048207,臺股指元大93購41,,,,,0.00,0.00,0,0,0,0,0,0,0,0,0,0,0,0,0
20200212,048208,臺股指元大93購42,,,,,0.00,0.00,0,0,0,0,0,0,0,0,0,0,0,0,0
20200212,048209,臺股指元大93購43,,,,,0.00,0.00,0,0,0,0,0,0,0,0,0,0,0,0,0
20200212,04820P,聯茂永豐94售02,1.05,1.07,0.87,0.91,-0.22,-19.47,66000,6,65770,0,0,0,0,0,0,56000,10000,46000,46000
20200212,048210,鴻海日盛93購01,1.71,1.78,1.71,1.78,+0.23,14.84,148000,5,259930,0,0,0,0,0,0,39000,109000,-70000,-70000
20200212,048211,大立光日盛93購01,1.00,1.00,1.00,1.00,+0.09,9.89,90000,1,90000,0,0,0,0,0,0,0,90000,-90000,-90000
20200212,048212,美利達日盛93購01,,,,,0.00,0.00,0,0,0,0,0,0,0,0,0,0,0,0,0
20200212,048213,群創麥證93購02,,,,,0.00,0.00,0,0,0,0,0,0,0,0,0,0,0,0,0
20200212,048214,滬深2X凱基96購03,,,,,0.00,0.00,0,0,0,0,0,0,0,0,0,0,0,0,0
20200212,048215,A50正2凱基95購01,,,,,0.00,0.00,0,0,0,0,0,0,0,0,0,0,0,0,0
20200212,048216,元油反凱基93購01,,,,,0.00,0.00,0,0,0,0,0,0,0,0,0,0,0,0,0
20200212,048217,亞德客凱基93購06,3.33,3.50,3.23,3.43,-0.24,-6.54,87000,14,295250,0,0,0,0,0,0,87000,0,87000,87000
20200212,048218,上銀凱基93購07,0.65,0.69,0.63,0.63,-0.03,-4.55,278000,4,181340,0,0,0,0,0,0,178000,100000,78000,78000
20200212,048219,為升凱基93購06,,,,,0.00,0.00,0,0,0,0,0,0,0,0,0,0,0,0,0
20200212,04821P,臺股指永豐94售01,0.26,0.26,0.22,0.22,-0.06,-21.43,361000,16,89120,0,0,0,0,0,0,40000,321000,-281000,-281000
20200212,048220,鴻海凱基93購35,4.25,4.37,4.25,4.37,+0.40,10.08,30000,3,129600,0,0,0,0,0,0,10000,20000,-10000,-10000
20200212,048221,鴻海凱基95購01,4.67,4.85,4.67,4.85,+0.47,10.73,45000,5,212350,0,0,0,0,0,0,30000,10000,20000,20000
20200212,048222,台積電凱基93購26,,,,,0.00,0.00,0,0,0,0,0,0,0,0,0,0,0,0,0
20200212,048223,微星凱基93購02,0.33,0.33,0.27,0.27,-0.03,-10.0,95000,5,26840,0,0,0,0,0,0,44000,51000,-7000,-7000
20200212,048224,聯發科凱基93購31,0.03,0.03,0.03,0.03,0.00,0.00,50000,1,1500,0,0,0,0,0,0,50000,0,50000,50000
20200212,048225,全新凱基93購03,0.18,0.25,0.18,0.25,+0.10,66.67,81000,8,17960,0,0,0,0,0,0,1000,80000,-79000,-79000
20200212,048226,大立光凱基93購35,0.36,0.40,0.36,0.40,+0.09,29.03,16000,2,5800,0,0,0,0,0,0,15000,1000,14000,14000
20200212,048227,亞光凱基93購05,1.61,1.92,1.61,1.92,+0.35,22.29,109000,5,180090,0,0,0,0,0,0,94000,15000,79000,79000
20200212,048228,和鑫凱基93購02,,,,,0.00,0.00,0,0,0,0,0,0,0,0,0,0,0,0,0
20200212,048229,華晶科凱基93購02,,,,,0.00,0.00,0,0,0,0,0,0,0,0,0,0,0,0,0
20200212,04822P,台積電元富94售08,,,,,0.00,0.00,0,0,0,0,0,0,0,0,0,0,0,0,0
20200212,048230,瀚宇博凱基93購03,,,,,0.00,0.00,0,0,0,0,0,0,0,0,0,0,0,0,0
20200212,048231,台表科凱基93購06,1.21,1.29,1.21,1.27,+0.11,9.48,230000,4,282680,0,0,0,0,0,0,159000,71000,88000,88000
20200212,048232,GIS凱基93購07,,,,,0.00,0.00,0,0,0,0,0,0,0,0,0,0,0,0,0
20200212,048233,南電凱基93購05,,,,,0.00,0.00,0,0,0,0,0,0,0,0,0,0,0,0,0
20200212,048234,美利達凱基93購03,0.48,0.48,0.48,0.48,0.00,0.00,300000,1,144000,0,0,0,0,0,0,300000,0,300000,300000
20200212,048235,滬深2X國票93購04,,,,,0.00,0.00,0,0,0,0,0,0,0,0,0,0,0,0,0
20200212,048236,A50正2國票97購02,0.46,0.46,0.46,0.46,0.00,0.00,10000,1,4600,0,0,0,0,0,0,0,10000,-10000,-10000
20200212,048237,致茂國票94購01,0.94,1.19,0.94,1.19,+0.34,40.0,150000,23,155800,0,0,0,0,0,0,45000,105000,-60000,-60000
20200212,048238,奇鋐國票94購01,,,,,0.00,0.00,0,0,0,0,0,0,0,0,0,0,0,0,0
20200212,048239,嘉澤國票93購01,2.40,2.40,2.40,2.40,-0.13,-5.14,6000,1,14400,0,0,0,0,0,0,0,6000,-6000,-6000
20200212,04823P,台積電元富94售09,,,,,0.00,0.00,0,0,0,0,0,0,0,0,0,0,0,0,0
20200212,048240,嘉聯益國票94購03,,,,,0.00,0.00,0,0,0,0,0,0,0,0,0,0,0,0,0
20200212,048241,樺漢國票93購01,,,,,0.00,0.00,0,0,0,0,0,0,0,0,0,0,0,0,0
20200212,048242,統一兆豐93購01,,,,,0.00,0.00,0,0,0,0,0,0,0,0,0,0,0,0,0
20200212,048243,儒鴻兆豐94購01,0.29,0.30,0.29,0.29,-0.05,-14.71,145000,4,42150,0,0,0,0,0,0,130000,15000,115000,115000
20200212,048244,廣宇兆豐93購01,0.13,0.14,0.13,0.14,0.00,0.00,30000,2,4000,0,0,0,0,0,0,30000,0,30000,30000
20200212,048245,台積電兆豐93購07,6.20,6.20,6.20,6.20,+0.65,11.71,56000,1,347200,0,0,0,0,0,0,56000,0,56000,56000
20200212,048246,京元電兆豐93購02,0.53,0.58,0.53,0.58,+0.05,9.43,498000,30,273360,0,0,0,0,0,0,395000,10000,385000,385000
20200212,048247,聯發科兆豐93購03,0.81,0.88,0.80,0.87,+0.22,33.85,297000,8,246750,0,0,0,0,0,0,143000,154000,-11000,-11000
20200212,048248,聯發科兆豐95購01,0.52,0.58,0.52,0.58,+0.15,34.88,88000,9,49280,0,0,0,0,0,0,28000,60000,-32000,-32000
20200212,048249,嘉澤兆豐94購01,1.17,1.20,1.12,1.12,-0.01,-0.88,196000,7,233730,0,0,0,0,0,0,13000,183000,-170000,-170000
20200212,04824P,亞泥中信94售02,0.40,0.40,0.40,0.40,-0.03,-6.98,20000,1,8000,0,0,0,0,0,0,0,20000,-20000,-20000
20200212,048250,矽創兆豐93購02,0.30,0.31,0.30,0.31,0.00,0.00,160000,4,48600,0,0,0,0,0,0,0,160000,-160000,-160000
20200212,048251,T50反1統一93購06,,,,,0.00,0.00,0,0,0,0,0,0,0,0,0,0,0,0,0
20200212,048252,T50反1統一93購07,,,,,0.00,0.00,0,0,0,0,0,0,0,0,0,0,0,0,0
20200212,048253,T50反1統一93購08,,,,,0.00,0.00,0,0,0,0,0,0,0,0,0,0,0,0,0
20200212,048254,深中小統一93購01,1.15,1.23,1.15,1.23,0.00,0.00,240000,3,292800,0,0,0,0,0,0,210000,30000,180000,180000
20200212,048255,臺指反統一94購01,,,,,0.00,0.00,0,0,0,0,0,0,0,0,0,0,0,0,0
20200212,048256,鴻海統一93購08,2.18,2.30,2.18,2.30,+0.19,9.0,51000,6,115050,0,0,0,0,0,0,31000,21000,10000,10000
20200212,048257,台積電統一93購07,,,,,0.00,0.00,0,0,0,0,0,0,0,0,0,0,0,0,0
20200212,048258,國泰金統一93購01,1.56,1.56,1.52,1.56,0.00,0.00,166000,7,256860,0,0,0,0,0,0,121000,45000,76000,76000
20200212,048259,新日興統一93購01,1.47,1.50,1.43,1.50,-0.01,-0.66,360000,28,523760,0,0,0,0,0,0,360000,3000,357000,357000
20200212,04825P,元大金中信94售01,,,,,0.00,0.00,0,0,0,0,0,0,0,0,0,0,0,0,0
20200212,048260,鴻海元富93購06,0.42,0.60,0.42,0.60,+0.28,87.5,364000,23,179400,0,0,0,0,0,0,0,364000,-364000,-364000
20200212,048261,鴻海元富95購01,1.06,1.34,1.06,1.34,+0.35,35.35,68000,10,74120,0,0,0,0,0,0,7000,61000,-54000,-54000
20200212,048262,台積電元富94購01,,,,,0.00,0.00,0,0,0,0,0,0,0,0,0,0,0,0,0
20200212,048263,台積電元富95購01,5.20,5.20,5.20,5.20,+0.15,2.97,19000,3,98800,0,0,0,0,0,0,19000,0,19000,19000
20200212,048264,華新科元富93購01,,,,,0.00,0.00,0,0,0,0,0,0,0,0,0,0,0,0,0
20200212,048265,創意元富93購05,1.50,1.66,1.50,1.66,-0.21,-11.23,137000,18,220780,0,0,0,0,0,0,82000,54000,28000,28000
20200212,048266,臺指反中信95購01,,,,,0.00,0.00,0,0,0,0,0,0,0,0,0,0,0,0,0
20200212,048267,元金反中信93購01,,,,,0.00,0.00,0,0,0,0,0,0,0,0,0,0,0,0,0
20200212,048268,長榮航中信95購01,0.29,0.30,0.29,0.30,0.00,0.00,15000,2,4450,0,0,0,0,0,0,5000,10000,-5000,-5000
20200212,048269,瀚宇博國泰95購01,0.66,0.76,0.66,0.76,+0.06,8.57,482000,23,345840,0,0,0,0,0,0,22000,460000,-438000,-438000
20200212,04826P,華新科麥證95售01,0.34,0.34,0.33,0.33,-0.03,-8.33,399000,11,132170,199000,200000,-1000,0,0,0,199000,200000,-1000,-1000
20200212,048270,T50反1富邦99購01,0.33,0.33,0.33,0.33,-0.02,-5.71,100000,1,33000,0,0,0,0,0,0,0,100000,-100000,-100000
20200212,048271,可成富邦95購02,0.41,0.49,0.41,0.49,+0.13,36.11,222000,8,97530,0,0,0,0,0,0,50000,102000,-52000,-52000
20200212,048272,新光金富邦98購01,0.74,0.75,0.73,0.75,+0.01,1.35,348000,41,256910,0,0,0,0,0,0,300000,37000,263000,263000
20200212,048273,南電富邦97購01,0.69,0.80,0.66,0.79,+0.11,16.18,110000,31,80700,0,0,0,0,0,0,80000,37000,43000,43000
20200212,048274,矽力台新93購01,,,,,0.00,0.00,0,0,0,0,0,0,0,0,0,0,0,0,0
20200212,048275,A50正2永豐93購01,,,,,0.00,0.00,0,0,0,0,0,0,0,0,0,0,0,0,0
20200212,048276,旺宏永豐94購01,0.80,0.82,0.80,0.82,+0.07,9.33,180000,2,144600,0,0,0,0,0,0,0,180000,-180000,-180000
20200212,048277,建準永豐93購02,,,,,0.00,0.00,0,0,0,0,0,0,0,0,0,0,0,0,0
20200212,048278,聯發科永豐93購03,0.01,0.02,0.01,0.02,0.00,0.00,150000,3,1600,0,0,0,0,0,0,140000,0,140000,140000
20200212,048279,聯鈞永豐93購01,0.37,0.45,0.37,0.45,+0.17,60.71,31000,4,11730,0,0,0,0,0,0,2000,29000,-27000,-27000
20200212,04827P,國巨凱基94售09,,,,,0.00,0.00,0,0,0,0,0,0,0,0,0,0,0,0,0
20200212,048280,康普永豐93購01,,,,,0.00,0.00,0,0,0,0,0,0,0,0,0,0,0,0,0
20200212,048281,矽力永豐93購02,1.21,1.45,1.17,1.45,+0.32,28.32,244000,19,330810,0,0,0,0,0,0,130000,114000,16000,16000
20200212,048282,世紀鋼永豐94購01,,,,,0.00,0.00,0,0,0,0,0,0,0,0,0,0,0,0,0
20200212,048283,亞德客中信94購01,1.77,1.94,1.75,1.94,+0.20,11.49,44000,9,80290,0,0,0,0,0,0,31000,13000,18000,18000
20200212,048284,臺股指中信95購04,0.59,0.59,0.59,0.59,+0.10,20.41,1000,1,590,0,0,0,0,0,0,1000,0,1000,1000
20200212,048285,華新科亞東93購01,,,,,0.00,0.00,0,0,0,0,0,0,0,0,0,0,0,0,0
20200212,048286,滬深2X兆豐94購04,0.80,0.83,0.80,0.83,-0.01,-1.19,10000,2,8150,0,0,0,0,0,0,0,10000,-10000,-10000
20200212,048287,嘉晶兆豐94購01,,,,,0.00,0.00,0,0,0,0,0,0,0,0,0,0,0,0,0
20200212,048288,T50反1群益93購05,0.05,0.05,0.04,0.04,-0.01,-20.0,54000,4,2300,0,0,0,0,0,0,0,54000,-54000,-54000
20200212,048289,臺指反群益95購01,,,,,0.00,0.00,0,0,0,0,0,0,0,0,0,0,0,0,0
20200212,04828P,聯發科凱基94售15,0.62,0.63,0.56,0.57,-0.17,-22.97,130000,4,74960,0,0,0,0,0,0,12000,118000,-106000,-106000
20200212,048290,國巨群益93購06,,,,,0.00,0.00,0,0,0,0,0,0,0,0,0,0,0,0,0
20200212,048291,台積電群益93購09,5.45,5.80,5.35,5.80,+0.55,10.48,357000,56,1945850,0,0,0,0,0,0,254000,324000,-70000,-70000
20200212,048292,微星群益93購01,,,,,0.00,0.00,0,0,0,0,0,0,0,0,0,0,0,0,0
20200212,048293,聯詠群益93購04,2.65,2.79,2.52,2.52,+0.28,12.5,51000,5,136870,0,0,0,0,0,0,31000,20000,11000,11000
20200212,048294,智原群益93購02,,,,,0.00,0.00,0,0,0,0,0,0,0,0,0,0,0,0,0
20200212,048295,泰鼎群益93購01,1.63,1.85,1.63,1.64,+0.14,9.33,192000,28,337120,0,0,0,0,0,0,55000,172000,-117000,-117000
20200212,048296,康控群益93購03,0.07,0.09,0.07,0.09,+0.01,12.5,40000,2,3200,0,0,0,0,0,0,0,40000,-40000,-40000
20200212,048297,GIS群益93購02,,,,,0.00,0.00,0,0,0,0,0,0,0,0,0,0,0,0,0
20200212,048298,華通麥證94購01,1.59,2.11,1.58,2.02,+0.46,29.49,345000,32,631180,180000,165000,15000,0,0,0,186000,165000,21000,21000
20200212,048299,聯詠麥證93購02,,,,,0.00,0.00,0,0,0,0,0,0,0,0,0,0,0,0,0
20200212,04829P,大立光凱基94售14,,,,,0.00,0.00,0,0,0,0,0,0,0,0,0,0,0,0,0
20200212,048300,FB上証凱基93購01,,,,,0.00,0.00,0,0,0,0,0,0,0,0,0,0,0,0,0
20200212,048301,元上證凱基93購01,,,,,0.00,0.00,0,0,0,0,0,0,0,0,0,0,0,0,0
20200212,048302,上証反凱基93購01,,,,,0.00,0.00,0,0,0,0,0,0,0,0,0,0,0,0,0
20200212,048303,A50凱基96購01,,,,,0.00,0.00,0,0,0,0,0,0,0,0,0,0,0,0,0
20200212,048304,滬深2X凱基93購04,,,,,0.00,0.00,0,0,0,0,0,0,0,0,0,0,0,0,0
20200212,048305,深100凱基96購01,0.62,0.62,0.62,0.62,+0.02,3.33,77000,2,47740,0,0,0,0,0,0,0,77000,-77000,-77000
20200212,048306,A50反1凱基93購01,,,,,0.00,0.00,0,0,0,0,0,0,0,0,0,0,0,0,0
20200212,048307,道瓊指凱基93購01,,,,,0.00,0.00,0,0,0,0,0,0,0,0,0,0,0,0,0
20200212,048308,儒鴻凱基93購05,0.10,0.12,0.10,0.12,-0.02,-14.29,120000,2,14000,0,0,0,0,0,0,120000,0,120000,120000
20200212,048309,寶齡凱基93購01,0.37,0.37,0.37,0.37,0.00,0.00,2000,1,740,0,0,0,0,0,0,2000,0,2000,2000
20200212,04830P,大立光凱基94售15,,,,,0.00,0.00,0,0,0,0,0,0,0,0,0,0,0,0,0
20200212,048310,台達電凱基93購05,,,,,0.00,0.00,0,0,0,0,0,0,0,0,0,0,0,0,0
20200212,048311,台積電凱基93購28,,,,,0.00,0.00,0,0,0,0,0,0,0,0,0,0,0,0,0
20200212,048312,致茂凱基93購02,0.35,0.36,0.35,0.36,0.00,0.00,140000,3,49400,0,0,0,0,0,0,0,140000,-140000,-140000
20200212,048313,南亞科凱基93購06,,,,,0.00,0.00,0,0,0,0,0,0,0,0,0,0,0,0,0
20200212,048314,京元電凱基93購04,0.33,0.35,0.30,0.35,+0.02,6.06,281000,34,94250,0,0,0,0,0,0,281000,0,281000,281000
20200212,048315,聯發科凱基93購32,1.18,1.33,1.18,1.33,+0.32,31.68,163000,6,200460,0,0,0,0,0,0,123000,44000,79000,79000
20200212,048316,可成凱基93購15,0.08,0.08,0.08,0.08,0.00,0.00,10000,1,800,0,0,0,0,0,0,10000,0,10000,10000
20200212,048317,大立光凱基93購36,,,,,0.00,0.00,0,0,0,0,0,0,0,0,0,0,0,0,0
20200212,048318,大立光凱基93購37,,,,,0.00,0.00,0,0,0,0,0,0,0,0,0,0,0,0,0
20200212,048319,嘉晶凱基93購04,,,,,0.00,0.00,0,0,0,0,0,0,0,0,0,0,0,0,0
20200212,04831P,聯詠富邦96售01,,,,,0.00,0.00,0,0,0,0,0,0,0,0,0,0,0,0,0
20200212,048320,聯詠凱基93購08,2.70,2.92,2.70,2.88,+0.48,20.0,29000,17,79750,0,0,0,0,0,0,29000,0,29000,29000
20200212,048321,欣興凱基93購03,0.39,0.42,0.39,0.42,0.00,0.00,121000,3,50790,0,0,0,0,0,0,0,121000,-121000,-121000
20200212,048322,康控凱基93購02,,,,,0.00,0.00,0,0,0,0,0,0,0,0,0,0,0,0,0
20200212,048323,聯茂凱基93購09,0.11,0.11,0.11,0.11,0.00,0.00,60000,1,6600,0,0,0,0,0,0,0,60000,-60000,-60000
20200212,048324,訊芯凱基93購03,0.93,0.93,0.93,0.93,-0.01,-1.06,26000,2,24180,0,0,0,0,0,0,26000,0,26000,26000
20200212,048325,美利達凱基93購05,,,,,0.00,0.00,0,0,0,0,0,0,0,0,0,0,0,0,0
20200212,048326,滬深2X國泰94購03,,,,,0.00,0.00,0,0,0,0,0,0,0,0,0,0,0,0,0
20200212,048327,緯穎國泰94購01,,,,,0.00,0.00,0,0,0,0,0,0,0,0,0,0,0,0,0
20200212,048328,滬深2X永昌94購01,,,,,0.00,0.00,0,0,0,0,0,0,0,0,0,0,0,0,0
20200212,048329,台積電永昌93購07,5.85,6.05,5.85,6.05,+0.60,11.01,53000,4,319650,0,0,0,0,0,0,53000,2000,51000,51000
20200212,04832P,為升元大94售09,,,,,0.00,0.00,0,0,0,0,0,0,0,0,0,0,0,0,0
20200212,048330,大立光永昌93購07,1.05,1.05,1.05,1.05,0.00,0.00,48000,1,50400,0,0,0,0,0,0,0,48000,-48000,-48000
20200212,048331,臺指反富邦97購01,0.11,0.11,0.11,0.11,-0.01,-8.33,50000,1,5500,0,0,0,0,0,0,0,50000,-50000,-50000
20200212,048332,台積電富邦94購02,4.49,4.49,4.49,4.49,+0.24,5.65,3000,2,13470,0,0,0,0,0,0,3000,3000,0,0
20200212,048333,大立光富邦95購01,1.32,1.40,1.32,1.40,+0.18,14.75,656000,4,898130,0,0,0,0,0,0,1000,655000,-654000,-654000
20200212,048334,A50正2元大96購01,0.45,0.45,0.43,0.45,-0.01,-2.17,175000,5,78650,0,0,0,0,0,0,120000,55000,65000,65000
20200212,048335,和大元大93購03,1.26,1.26,1.26,1.26,-0.01,-0.79,70000,1,88200,0,0,0,0,0,0,70000,0,70000,70000
20200212,048336,光磊元大93購02,0.39,0.39,0.36,0.36,-0.04,-10.0,204000,10,77300,0,0,0,0,0,0,204000,8000,196000,196000
20200212,048337,致茂元大93購04,0.70,0.93,0.70,0.93,+0.29,45.31,206000,7,145320,0,0,0,0,0,0,200000,6000,194000,194000
20200212,048338,正崴元大93購01,1.76,1.82,1.76,1.82,+0.03,1.68,122000,5,221080,0,0,0,0,0,0,122000,10000,112000,112000
20200212,048339,友達元大95購01,2.37,2.37,2.25,2.33,-0.10,-4.12,65000,7,149650,0,0,0,0,0,0,0,65000,-65000,-65000
20200212,04833P,鴻海元大94售16,0.98,0.98,0.81,0.81,-0.28,-25.69,401000,10,371190,0,0,0,0,0,0,160000,240000,-80000,-80000
20200212,048340,聯發科元大93購25,0.83,0.93,0.82,0.93,+0.25,36.76,245000,7,214900,0,0,0,0,0,0,155000,90000,65000,65000
20200212,048341,全新元大94購03,0.40,0.52,0.40,0.51,+0.17,50.0,197000,7,95400,0,0,0,0,0,0,10000,147000,-137000,-137000
20200212,048342,強茂元大93購01,,,,,0.00,0.00,0,0,0,0,0,0,0,0,0,0,0,0,0
20200212,048343,大立光元大93購29,,,,,0.00,0.00,0,0,0,0,0,0,0,0,0,0,0,0,0
20200212,048344,大立光元大93購30,1.97,1.97,1.97,1.97,0.00,0.00,34000,1,66980,0,0,0,0,0,0,0,34000,-34000,-34000
20200212,048345,緯創元大94購01,2.71,2.77,2.71,2.77,+0.04,1.47,36000,4,98100,0,0,0,0,0,0,17000,19000,-2000,-2000
20200212,048346,智易元大95購01,0.41,0.47,0.41,0.46,+0.10,27.78,375000,7,175790,0,0,0,0,0,0,16000,359000,-343000,-343000
20200212,048347,康普元大93購02,,,,,0.00,0.00,0,0,0,0,0,0,0,0,0,0,0,0,0
20200212,048348,矽力元大93購03,4.26,4.35,4.26,4.35,-0.15,-3.33,6000,2,26010,0,0,0,0,0,0,0,6000,-6000,-6000
20200212,048349,美利達元大96購02,1.39,1.39,1.37,1.37,-0.01,-0.72,40000,2,55520,0,0,0,0,0,0,40000,0,40000,40000
20200212,04834P,鴻海元大94售17,0.44,0.44,0.36,0.36,-0.19,-34.55,160000,2,67200,0,0,0,0,0,0,120000,40000,80000,80000
20200212,048350,世紀鋼元大95購01,0.81,0.83,0.80,0.80,-0.05,-5.88,71000,4,57200,0,0,0,0,0,0,71000,0,71000,71000
20200212,048351,旺宏台新94購02,1.64,1.64,1.64,1.64,+0.15,10.07,1000,1,1640,0,0,0,0,0,0,1000,0,1000,1000
20200212,048352,嘉澤台新93購01,,,,,0.00,0.00,0,0,0,0,0,0,0,0,0,0,0,0,0
20200212,048353,嘉聯益台新93購02,,,,,0.00,0.00,0,0,0,0,0,0,0,0,0,0,0,0,0
20200212,048354,滬深2X永豐93購03,,,,,0.00,0.00,0,0,0,0,0,0,0,0,0,0,0,0,0
20200212,048355,國巨永豐93購04,,,,,0.00,0.00,0,0,0,0,0,0,0,0,0,0,0,0,0
20200212,048356,華泰永豐93購01,,,,,0.00,0.00,0,0,0,0,0,0,0,0,0,0,0,0,0
20200212,048357,漢唐永豐93購04,,,,,0.00,0.00,0,0,0,0,0,0,0,0,0,0,0,0,0
20200212,048358,嘉晶永豐93購03,,,,,0.00,0.00,0,0,0,0,0,0,0,0,0,0,0,0,0
20200212,048359,奇鋐永豐93購02,0.19,0.19,0.19,0.19,0.00,0.00,60000,1,11400,0,0,0,0,0,0,60000,0,60000,60000
20200212,04835P,鴻海元大94售18,0.69,0.69,0.61,0.61,-0.33,-35.11,60000,7,39250,0,0,0,0,0,0,0,60000,-60000,-60000
20200212,048360,華晶科永豐93購02,,,,,0.00,0.00,0,0,0,0,0,0,0,0,0,0,0,0,0
20200212,048361,揚明光永豐93購02,,,,,0.00,0.00,0,0,0,0,0,0,0,0,0,0,0,0,0
20200212,048362,康控永豐93購01,,,,,0.00,0.00,0,0,0,0,0,0,0,0,0,0,0,0,0
20200212,048363,中磊永豐93購02,,,,,0.00,0.00,0,0,0,0,0,0,0,0,0,0,0,0,0
20200212,048364,臺股指永豐93購04,2.17,2.17,2.17,2.17,0.00,0.00,30000,2,65100,0,0,0,0,0,0,30000,0,30000,30000
20200212,048365,T50反1統一93購09,,,,,0.00,0.00,0,0,0,0,0,0,0,0,0,0,0,0,0
20200212,048366,深中小統一93購02,,,,,0.00,0.00,0,0,0,0,0,0,0,0,0,0,0,0,0
20200212,048367,華邦電統一93購01,0.22,0.23,0.22,0.22,0.00,0.00,58000,12,12860,0,0,0,0,0,0,0,58000,-58000,-58000
20200212,048368,燿華統一93購01,,,,,0.00,0.00,0,0,0,0,0,0,0,0,0,0,0,0,0
20200212,048369,友達統一93購06,,,,,0.00,0.00,0,0,0,0,0,0,0,0,0,0,0,0,0
20200212,04836P,台積電元大94售22,,,,,0.00,0.00,0,0,0,0,0,0,0,0,0,0,0,0,0
20200212,048370,可成統一93購04,0.40,0.43,0.40,0.43,0.00,0.00,280000,9,115270,0,0,0,0,0,0,0,280000,-280000,-280000
20200212,048371,華固統一93購02,,,,,0.00,0.00,0,0,0,0,0,0,0,0,0,0,0,0,0
20200212,048372,美利達統一93購01,,,,,0.00,0.00,0,0,0,0,0,0,0,0,0,0,0,0,0
20200212,048373,A50正2元富95購01,,,,,0.00,0.00,0,0,0,0,0,0,0,0,0,0,0,0,0
20200212,048374,味全元富94購01,,,,,0.00,0.00,0,0,0,0,0,0,0,0,0,0,0,0,0
20200212,048375,儒鴻元富93購02,,,,,0.00,0.00,0,0,0,0,0,0,0,0,0,0,0,0,0
20200212,048376,台達電元富93購01,0.50,0.50,0.50,0.50,0.00,0.00,10000,1,5000,0,0,0,0,0,0,0,10000,-10000,-10000
20200212,048377,燿華元富93購01,,,,,0.00,0.00,0,0,0,0,0,0,0,0,0,0,0,0,0
20200212,048378,貿聯元富93購01,0.54,0.69,0.54,0.69,+0.15,27.78,55000,17,32670,0,0,0,0,0,0,17000,38000,-21000,-21000
20200212,048379,台郡元富96購01,2.15,2.36,2.12,2.36,+0.97,69.78,192000,44,414740,0,0,0,0,0,0,49000,121000,-72000,-72000
20200212,04837P,華新科元大94售05,,,,,0.00,0.00,0,0,0,0,0,0,0,0,0,0,0,0,0
20200212,048380,T50反1國票94購02,0.10,0.10,0.10,0.10,0.00,0.00,30000,1,3000,0,0,0,0,0,0,0,30000,-30000,-30000
20200212,048381,T50反1國票94購03,0.25,0.25,0.21,0.21,-0.05,-19.23,227000,4,54870,0,0,0,0,0,0,0,227000,-227000,-227000
20200212,048382,T50反1國票96購01,,,,,0.00,0.00,0,0,0,0,0,0,0,0,0,0,0,0,0
20200212,048383,元金2X國票99購01,,,,,0.00,0.00,0,0,0,0,0,0,0,0,0,0,0,0,0
20200212,048384,遠東新國票94購01,,,,,0.00,0.00,0,0,0,0,0,0,0,0,0,0,0,0,0
20200212,048385,亞德客國票94購01,,,,,0.00,0.00,0,0,0,0,0,0,0,0,0,0,0,0,0
20200212,048386,華新國票94購01,,,,,0.00,0.00,0,0,0,0,0,0,0,0,0,0,0,0,0
20200212,048387,台達電國票94購01,0.95,0.98,0.92,0.98,+0.11,12.64,74000,6,70120,0,0,0,0,0,0,0,74000,-74000,-74000
20200212,048388,華通國票94購01,0.77,1.27,0.77,1.27,+0.47,58.75,102000,16,100100,0,0,0,0,0,0,60000,42000,18000,18000
20200212,048389,國巨國票94購01,18.90,18.90,18.90,18.90,0.00,0.00,1000,1,18900,0,0,0,0,0,0,1000,0,1000,1000
20200212,04838P,宏達電元大95售02,2.28,2.28,2.28,2.28,0.00,0.00,3000,1,6840,0,0,0,0,0,0,0,3000,-3000,-3000
20200212,048390,國巨國票94購02,27.10,27.60,27.10,27.60,+1.50,5.75,3000,3,82200,0,0,0,0,0,0,3000,0,3000,3000
20200212,048391,友訊國票94購01,1.46,1.49,1.42,1.46,-0.07,-4.58,139000,5,201760,0,0,0,0,0,0,20000,119000,-99000,-99000
20200212,048392,宏碁國票94購01,,,,,0.00,0.00,0,0,0,0,0,0,0,0,0,0,0,0,0
20200212,048393,台光電國票93購02,,,,,0.00,0.00,0,0,0,0,0,0,0,0,0,0,0,0,0
20200212,048394,正崴國票94購01,1.05,1.10,1.05,1.10,+0.01,0.92,141000,6,151150,0,0,0,0,0,0,141000,60000,81000,81000
20200212,048395,南亞科國票93購02,0.04,0.04,0.04,0.04,0.00,0.00,1000,1,40,0,0,0,0,0,0,1000,0,1000,1000
20200212,048396,奇力新國票94購02,,,,,0.00,0.00,0,0,0,0,0,0,0,0,0,0,0,0,0
20200212,048397,TPK國票94購02,,,,,0.00,0.00,0,0,0,0,0,0,0,0,0,0,0,0,0
20200212,048398,康普國票94購01,,,,,0.00,0.00,0,0,0,0,0,0,0,0,0,0,0,0,0
20200212,048399,祥碩國票94購01,,,,,0.00,0.00,0,0,0,0,0,0,0,0,0,0,0,0,0
20200212,04839P,大立光元大94售17,,,,,0.00,0.00,0,0,0,0,0,0,0,0,0,0,0,0,0
20200212,048400,矽創國票93購01,,,,,0.00,0.00,0,0,0,0,0,0,0,0,0,0,0,0,0
20200212,048401,南電國票93購03,0.42,0.57,0.41,0.55,+0.22,66.67,102000,15,48350,0,0,0,0,0,0,60000,42000,18000,18000
20200212,048402,聯茂兆豐95購01,0.10,0.10,0.10,0.10,+0.04,66.67,271000,4,27100,0,0,0,0,0,0,250000,21000,229000,229000
20200212,048403,聯發科群益93購10,0.39,0.44,0.39,0.40,+0.12,42.86,80000,5,32200,0,0,0,0,0,0,10000,70000,-60000,-60000
20200212,048404,大立光群益93購11,1.31,1.37,1.31,1.37,+0.25,22.32,139000,5,183230,0,0,0,0,0,0,0,139000,-139000,-139000
20200212,048405,嘉晶群益93購03,,,,,0.00,0.00,0,0,0,0,0,0,0,0,0,0,0,0,0
20200212,048406,欣興群益93購09,0.28,0.31,0.28,0.31,0.00,0.00,46000,11,13320,0,0,0,0,0,0,0,46000,-46000,-46000
20200212,048407,貿聯群益93購04,0.59,0.62,0.59,0.62,0.00,0.00,15000,5,8950,0,0,0,0,0,0,0,15000,-15000,-15000
20200212,048408,正文群益93購01,,,,,0.00,0.00,0,0,0,0,0,0,0,0,0,0,0,0,0
20200212,048409,致伸群益93購05,,,,,0.00,0.00,0,0,0,0,0,0,0,0,0,0,0,0,0
20200212,04840P,大立光元大94售18,,,,,0.00,0.00,0,0,0,0,0,0,0,0,0,0,0,0,0
20200212,048410,和碩群益93購01,1.56,1.79,1.56,1.79,+0.06,3.47,60000,4,103200,0,0,0,0,0,0,40000,20000,20000,20000
20200212,048411,嘉聯益群益93購02,,,,,0.00,0.00,0,0,0,0,0,0,0,0,0,0,0,0,0
20200212,048412,台勝科亞東93購01,,,,,0.00,0.00,0,0,0,0,0,0,0,0,0,0,0,0,0
20200212,048413,國巨第一93購01,,,,,0.00,0.00,0,0,0,0,0,0,0,0,0,0,0,0,0
20200212,048414,滬深2X統一98購01,,,,,0.00,0.00,0,0,0,0,0,0,0,0,0,0,0,0,0
20200212,048415,深中小統一93購03,,,,,0.00,0.00,0,0,0,0,0,0,0,0,0,0,0,0,0
20200212,048416,台達電統一93購02,1.14,1.22,1.11,1.22,+0.08,7.02,40000,4,46500,0,0,0,0,0,0,10000,30000,-20000,-20000
20200212,048417,國巨統一94購01,,,,,0.00,0.00,0,0,0,0,0,0,0,0,0,0,0,0,0
20200212,048418,瑞昱統一93購04,0.61,0.72,0.61,0.63,+0.04,6.78,220000,3,150600,0,0,0,0,0,0,170000,50000,120000,120000
20200212,048419,智易統一93購01,,,,,0.00,0.00,0,0,0,0,0,0,0,0,0,0,0,0,0
20200212,04841P,群創元大94售04,,,,,0.00,0.00,0,0,0,0,0,0,0,0,0,0,0,0,0
20200212,048420,祥碩統一93購01,,,,,0.00,0.00,0,0,0,0,0,0,0,0,0,0,0,0,0
20200212,048421,聯茂統一93購01,0.17,0.20,0.15,0.20,0.00,0.00,324000,6,57300,0,0,0,0,0,0,0,324000,-324000,-324000
20200212,048422,瑞昱元富96購02,1.25,1.39,1.25,1.35,+0.15,12.5,276000,7,363810,0,0,0,0,0,0,138000,138000,0,0
20200212,048423,聯發科元富93購02,0.24,0.24,0.24,0.24,0.00,0.00,100000,1,24000,0,0,0,0,0,0,100000,0,100000,100000
20200212,048424,揚明光元富95購01,0.46,0.46,0.46,0.46,+0.05,12.2,50000,1,23000,0,0,0,0,0,0,0,50000,-50000,-50000
20200212,048425,聯茂元富96購02,0.26,0.30,0.26,0.28,0.00,0.00,100000,17,28180,0,0,0,0,0,0,0,100000,-100000,-100000
20200212,048426,超眾元富93購01,0.50,0.58,0.48,0.58,+0.07,13.73,974000,42,514550,0,0,0,0,0,0,493000,438000,55000,55000
20200212,048427,百和元富95購01,2.78,2.78,2.77,2.77,-0.03,-1.07,17000,2,47160,0,0,0,0,0,0,10000,7000,3000,3000
20200212,048428,滬深2X國票93購05,0.27,0.27,0.27,0.27,-0.07,-20.59,144000,1,38880,0,0,0,0,0,0,144000,0,144000,144000
20200212,048429,旺宏國票94購02,1.15,1.21,1.05,1.10,-0.07,-5.98,896000,14,976740,0,0,0,0,0,0,616000,280000,336000,336000
20200212,04842P,群創元大96售02,0.17,0.17,0.17,0.17,0.00,0.00,150000,1,25500,0,0,0,0,0,0,150000,0,150000,150000
20200212,048430,瑞昱國票93購02,0.40,0.40,0.40,0.40,+0.11,37.93,1000,1,400,0,0,0,0,0,0,1000,0,1000,1000
20200212,048431,瑞昱國票94購01,1.39,1.61,1.39,1.39,+0.13,10.32,64000,6,94220,0,0,0,0,0,0,8000,56000,-48000,-48000
20200212,048432,全新國票95購01,0.64,0.84,0.63,0.84,+0.27,47.37,340000,19,243590,0,0,0,0,0,0,26000,314000,-288000,-288000
20200212,048433,聯詠國票94購01,,,,,0.00,0.00,0,0,0,0,0,0,0,0,0,0,0,0,0
20200212,048434,樺漢國票93購02,,,,,0.00,0.00,0,0,0,0,0,0,0,0,0,0,0,0,0
20200212,048435,致新國票93購01,0.46,0.48,0.46,0.47,-0.04,-7.84,84000,5,39750,0,0,0,0,0,0,84000,0,84000,84000
20200212,048436,聯茂日盛93購01,0.18,0.26,0.18,0.20,0.00,0.00,961000,18,224420,0,0,0,0,0,0,400000,561000,-161000,-161000
20200212,048437,義隆麥證93購01,0.45,0.45,0.45,0.45,+0.06,15.38,10000,1,4500,10000,0,10000,0,0,0,10000,0,10000,10000
20200212,048438,台表科麥證94購01,,,,,0.00,0.00,0,0,0,0,0,0,0,0,0,0,0,0,0
20200212,048439,上銀凱基93購09,1.20,1.20,1.20,1.20,+0.55,84.62,20000,1,24000,0,0,0,0,0,0,0,0,0,0
20200212,04843P,致新元大94售02,1.42,1.42,1.42,1.42,0.00,0.00,100000,1,142000,0,0,0,0,0,0,0,100000,-100000,-100000
20200212,048440,國巨凱基93購08,,,,,0.00,0.00,0,0,0,0,0,0,0,0,0,0,0,0,0
20200212,048441,台積電凱基93購29,7.15,7.15,7.15,7.15,+0.55,8.33,30000,2,214500,0,0,0,0,0,0,30000,0,30000,30000
20200212,048442,友訊凱基94購01,0.98,0.99,0.94,0.96,-0.03,-3.03,529000,10,509790,0,0,0,0,0,0,174000,355000,-181000,-181000
20200212,048443,旺宏凱基93購08,1.68,1.68,1.63,1.63,-0.07,-4.12,2000,2,3310,0,0,0,0,0,0,2000,2000,0,0
20200212,048444,燿華凱基93購05,,,,,0.00,0.00,0,0,0,0,0,0,0,0,0,0,0,0,0
20200212,048445,瑞昱凱基93購11,0.53,0.66,0.53,0.66,+0.18,37.5,136000,2,80920,0,0,0,0,0,0,68000,68000,0,0
20200212,048446,南亞科凱基93購07,0.88,0.88,0.88,0.88,-0.05,-5.38,152000,2,133760,0,0,0,0,0,0,152000,0,152000,152000
20200212,048447,美律凱基93購06,,,,,0.00,0.00,0,0,0,0,0,0,0,0,0,0,0,0,0
20200212,048448,京元電凱基93購05,,,,,0.00,0.00,0,0,0,0,0,0,0,0,0,0,0,0,0
20200212,048449,強茂凱基93購03,,,,,0.00,0.00,0,0,0,0,0,0,0,0,0,0,0,0,0
20200212,04844P,京元電亞東94售01,,,,,0.00,0.00,0,0,0,0,0,0,0,0,0,0,0,0,0
20200212,048450,聯詠凱基93購09,3.38,3.52,3.38,3.52,+0.41,13.18,28000,7,96880,0,0,0,0,0,0,18000,25000,-7000,-7000
20200212,048451,智原凱基93購02,,,,,0.00,0.00,0,0,0,0,0,0,0,0,0,0,0,0,0
20200212,048452,緯創凱基93購04,,,,,0.00,0.00,0,0,0,0,0,0,0,0,0,0,0,0,0
20200212,048453,嘉澤凱基93購05,2.58,2.58,2.58,2.58,+0.15,6.17,3000,1,7740,0,0,0,0,0,0,3000,3000,0,0
20200212,048454,合勤控凱基94購01,,,,,0.00,0.00,0,0,0,0,0,0,0,0,0,0,0,0,0
20200212,048455,上緯控凱基94購01,0.45,0.45,0.44,0.44,-0.02,-4.35,300000,2,132500,0,0,0,0,0,0,300000,0,300000,300000
20200212,048456,利勤凱基95購01,,,,,0.00,0.00,0,0,0,0,0,0,0,0,0,0,0,0,0
20200212,048457,康普凱基93購01,,,,,0.00,0.00,0,0,0,0,0,0,0,0,0,0,0,0,0
20200212,048458,中磊凱基93購03,,,,,0.00,0.00,0,0,0,0,0,0,0,0,0,0,0,0,0
20200212,048459,嘉聯益凱基93購04,0.04,0.04,0.04,0.04,0.00,0.00,20000,1,800,0,0,0,0,0,0,20000,0,20000,20000
20200212,04845P,台積電凱基94售33,,,,,0.00,0.00,0,0,0,0,0,0,0,0,0,0,0,0,0
20200212,048460,盛群凱基94購01,1.01,1.02,1.01,1.02,+0.01,0.99,70000,3,71000,0,0,0,0,0,0,30000,40000,-10000,-10000
20200212,048461,緯穎凱基93購01,,,,,0.00,0.00,0,0,0,0,0,0,0,0,0,0,0,0,0
20200212,048462,南電凱基93購06,0.32,0.32,0.32,0.32,0.00,0.00,60000,1,19200,0,0,0,0,0,0,0,60000,-60000,-60000
20200212,048463,美利達凱基93購06,,,,,0.00,0.00,0,0,0,0,0,0,0,0,0,0,0,0,0
20200212,048464,康控台新94購01,0.30,0.30,0.30,0.30,0.00,0.00,59000,1,17700,0,0,0,0,0,0,0,59000,-59000,-59000
20200212,048465,南電台新93購01,0.21,0.34,0.21,0.32,+0.08,33.33,480000,36,131920,0,0,0,0,0,0,270000,210000,60000,60000
20200212,048466,卜蜂康和93購01,,,,,0.00,0.00,0,0,0,0,0,0,0,0,0,0,0,0,0
20200212,048467,南電康和93購01,,,,,0.00,0.00,0,0,0,0,0,0,0,0,0,0,0,0,0
20200212,048468,光磊永豐93購01,,,,,0.00,0.00,0,0,0,0,0,0,0,0,0,0,0,0,0
20200212,048469,微星永豐93購03,,,,,0.00,0.00,0,0,0,0,0,0,0,0,0,0,0,0,0
20200212,04846P,旺宏凱基94售07,,,,,0.00,0.00,0,0,0,0,0,0,0,0,0,0,0,0,0
20200212,048470,神基永豐93購01,,,,,0.00,0.00,0,0,0,0,0,0,0,0,0,0,0,0,0
20200212,048471,旭富永豐93購01,0.37,0.49,0.37,0.38,+0.06,18.75,294000,37,132220,0,0,0,0,0,0,5000,289000,-284000,-284000
20200212,048472,傳奇永豐93購01,,,,,0.00,0.00,0,0,0,0,0,0,0,0,0,0,0,0,0
20200212,048473,瀚宇博永豐93購02,,,,,0.00,0.00,0,0,0,0,0,0,0,0,0,0,0,0,0
20200212,048474,嘉聯益永豐93購03,,,,,0.00,0.00,0,0,0,0,0,0,0,0,0,0,0,0,0
20200212,048475,台郡永豐93購02,1.19,1.36,1.19,1.36,+0.77,130.51,518000,31,671700,0,0,0,0,0,0,117000,355000,-238000,-238000
20200212,048476,同欣電永豐93購01,0.62,0.73,0.62,0.73,+0.11,17.74,224000,30,152910,0,0,0,0,0,0,101000,123000,-22000,-22000
20200212,048477,易華電永豐93購04,,,,,0.00,0.00,0,0,0,0,0,0,0,0,0,0,0,0,0
20200212,048478,羅麗芬永豐94購01,,,,,0.00,0.00,0,0,0,0,0,0,0,0,0,0,0,0,0
20200212,048479,寶成永豐93購01,,,,,0.00,0.00,0,0,0,0,0,0,0,0,0,0,0,0,0
20200212,04847P,聯發科凱基94售17,,,,,0.00,0.00,0,0,0,0,0,0,0,0,0,0,0,0,0
20200212,048480,FB上証中信94購01,0.19,0.20,0.18,0.19,0.00,0.00,356000,13,67140,0,0,0,0,0,0,0,356000,-356000,-356000
20200212,048481,瑞儀中信93購01,,,,,0.00,0.00,0,0,0,0,0,0,0,0,0,0,0,0,0
20200212,048482,柏文中信94購01,,,,,0.00,0.00,0,0,0,0,0,0,0,0,0,0,0,0,0
20200212,048483,可成國泰95購01,1.22,1.41,1.22,1.41,+0.26,22.61,321000,26,423890,0,0,0,0,0,0,44000,281000,-237000,-237000
20200212,048484,大立光國泰95購02,1.58,1.75,1.58,1.75,+0.21,13.64,262000,9,429820,0,0,0,0,0,0,32000,242000,-210000,-210000
20200212,048485,泰鼎國泰94購02,2.96,3.02,2.96,3.02,+0.38,14.39,13000,4,38640,0,0,0,0,0,0,0,13000,-13000,-13000
20200212,048486,傳奇國泰95購01,,,,,0.00,0.00,0,0,0,0,0,0,0,0,0,0,0,0,0
20200212,048487,華邦電富邦93購02,,,,,0.00,0.00,0,0,0,0,0,0,0,0,0,0,0,0,0
20200212,048488,大立光富邦93購05,3.91,3.91,3.91,3.91,+0.46,13.33,11000,2,43010,0,0,0,0,0,0,0,11000,-11000,-11000
20200212,048489,明泰富邦93購01,0.65,0.65,0.65,0.65,0.00,0.00,1000,1,650,0,0,0,0,0,0,0,1000,-1000,-1000
20200212,04848P,康控凱基94售02,1.44,1.44,0.79,0.79,-0.70,-46.98,69000,2,92860,0,0,0,0,0,0,59000,10000,49000,49000
20200212,048490,寶成富邦93購01,,,,,0.00,0.00,0,0,0,0,0,0,0,0,0,0,0,0,0
20200212,048491,A50元大93購01,,,,,0.00,0.00,0,0,0,0,0,0,0,0,0,0,0,0,0
20200212,048492,國巨元大93購11,,,,,0.00,0.00,0,0,0,0,0,0,0,0,0,0,0,0,0
20200212,048493,微星元大93購04,0.69,0.69,0.52,0.52,-0.05,-8.77,20000,2,12100,0,0,0,0,0,0,10000,10000,0,0
20200212,048494,瑞昱元大93購13,0.98,1.28,0.98,1.28,+0.27,26.73,152000,10,172050,0,0,0,0,0,0,75000,84000,-9000,-9000
20200212,048495,南亞科元大93購04,0.76,0.76,0.74,0.74,+0.03,4.23,30000,2,22500,0,0,0,0,0,0,0,30000,-30000,-30000
20200212,048496,南亞科元大93購05,0.45,0.45,0.44,0.44,-0.04,-8.33,288000,6,128400,0,0,0,0,0,0,68000,220000,-152000,-152000
20200212,048497,京元電元大93購02,,,,,0.00,0.00,0,0,0,0,0,0,0,0,0,0,0,0,0
20200212,048498,嘉澤元大94購01,3.14,3.18,2.82,2.82,-0.07,-2.42,76000,8,235270,0,0,0,0,0,0,64000,26000,38000,38000
20200212,048499,達運元大96購01,0.52,0.54,0.51,0.52,+0.01,1.96,795000,8,411940,0,0,0,0,0,0,368000,427000,-59000,-59000
20200212,04849P,GIS中信94售01,1.09,1.09,1.09,1.09,0.00,0.00,10000,1,10900,0,0,0,0,0,0,0,10000,-10000,-10000
20200212,048500,樺漢元大93購03,1.59,1.59,1.59,1.59,+0.18,12.77,5000,1,7950,0,0,0,0,0,0,5000,0,5000,5000
20200212,048501,GIS元大94購02,,,,,0.00,0.00,0,0,0,0,0,0,0,0,0,0,0,0,0
20200212,048502,百和元大93購01,,,,,0.00,0.00,0,0,0,0,0,0,0,0,0,0,0,0,0
20200212,048503,百和元大93購02,,,,,0.00,0.00,0,0,0,0,0,0,0,0,0,0,0,0,0
20200212,048504,A50正2中信95購01,,,,,0.00,0.00,0,0,0,0,0,0,0,0,0,0,0,0,0
20200212,048505,滬深2X群益99購03,0.68,0.68,0.68,0.68,0.00,0.00,5000,1,3400,0,0,0,0,0,0,5000,0,5000,5000
20200212,048506,華通群益94購03,2.12,3.20,2.12,2.89,+0.83,40.29,247000,34,687800,0,0,0,0,0,0,110000,136000,-26000,-26000
20200212,048507,聯茂群益93購05,,,,,0.00,0.00,0,0,0,0,0,0,0,0,0,0,0,0,0
20200212,048508,元上證凱基94購02,0.23,0.23,0.23,0.23,-0.01,-4.17,40000,4,9200,0,0,0,0,0,0,0,40000,-40000,-40000
20200212,048509,上証反凱基99購02,0.37,0.37,0.34,0.34,-0.02,-5.56,177000,4,60480,0,0,0,0,0,0,157000,10000,147000,147000
20200212,04850P,全新永豐94售03,,,,,0.00,0.00,0,0,0,0,0,0,0,0,0,0,0,0,0
20200212,048510,滬深2X凱基93購05,,,,,0.00,0.00,0,0,0,0,0,0,0,0,0,0,0,0,0
20200212,048511,美律凱基93購07,0.68,0.84,0.68,0.84,+0.23,37.7,257000,71,195820,0,0,0,0,0,0,110000,147000,-37000,-37000
20200212,048512,全新凱基93購04,0.47,0.67,0.46,0.65,+0.24,58.54,1058000,35,595480,0,0,0,0,0,0,592000,476000,116000,116000
20200212,048513,欣興凱基93購04,0.29,0.29,0.29,0.29,0.00,0.00,60000,1,17400,0,0,0,0,0,0,0,60000,-60000,-60000
20200212,048514,嘉澤凱基93購06,1.61,1.61,1.45,1.45,-0.03,-2.03,32000,2,46720,0,0,0,0,0,0,32000,2000,30000,30000
20200212,048515,貿聯凱基93購03,0.18,0.18,0.18,0.18,0.00,0.00,5000,1,900,0,0,0,0,0,0,0,5000,-5000,-5000
20200212,048516,麗豐凱基93購02,0.45,0.51,0.45,0.48,+0.04,9.09,108000,3,54240,0,0,0,0,0,0,8000,90000,-82000,-82000
20200212,048517,致伸凱基93購06,,,,,0.00,0.00,0,0,0,0,0,0,0,0,0,0,0,0,0
20200212,048518,聯茂凱基93購10,,,,,0.00,0.00,0,0,0,0,0,0,0,0,0,0,0,0,0
20200212,048519,緯穎凱基93購02,,,,,0.00,0.00,0,0,0,0,0,0,0,0,0,0,0,0,0
20200212,04851P,創意永豐94售02,1.02,1.08,1.02,1.03,0.00,0.00,62000,8,65010,0,0,0,0,0,0,0,62000,-62000,-62000
20200212,048520,柏文凱基93購03,,,,,0.00,0.00,0,0,0,0,0,0,0,0,0,0,0,0,0
20200212,048521,華通統一93購05,2.21,3.10,2.21,3.10,+1.03,49.76,220000,19,602330,0,0,0,0,0,0,35000,185000,-150000,-150000
20200212,048522,A50正2元富95購02,,,,,0.00,0.00,0,0,0,0,0,0,0,0,0,0,0,0,0
20200212,048523,TPK元富94購01,,,,,0.00,0.00,0,0,0,0,0,0,0,0,0,0,0,0,0
20200212,048524,GIS元富94購01,0.46,0.49,0.46,0.49,0.00,0.00,58000,12,27480,0,0,0,0,0,0,0,58000,-58000,-58000
20200212,048525,華通國票94購02,1.45,2.22,1.45,2.22,+0.73,48.99,182000,9,353480,0,0,0,0,0,0,122000,60000,62000,62000
20200212,048526,鴻海國票93購03,,,,,0.00,0.00,0,0,0,0,0,0,0,0,0,0,0,0,0
20200212,048527,鴻海國票94購02,0.89,1.26,0.89,1.26,+0.43,51.81,146000,17,148040,0,0,0,0,0,0,53000,93000,-40000,-40000
20200212,048528,華泰國票94購01,,,,,0.00,0.00,0,0,0,0,0,0,0,0,0,0,0,0,0
20200212,048529,京元電國票94購01,0.19,0.19,0.18,0.18,-0.01,-5.26,90000,10,16700,0,0,0,0,0,0,90000,0,90000,90000
20200212,04852P,臻鼎永豐94售02,0.63,0.69,0.63,0.69,-0.08,-10.39,82000,6,54620,0,0,0,0,0,0,2000,80000,-78000,-78000
20200212,048530,大立光國票93購04,2.15,2.28,2.15,2.28,+0.31,15.74,64000,3,140560,0,0,0,0,0,0,0,64000,-64000,-64000
20200212,048531,大立光國票93購05,,,,,0.00,0.00,0,0,0,0,0,0,0,0,0,0,0,0,0
20200212,048532,大立光國票93購06,,,,,0.00,0.00,0,0,0,0,0,0,0,0,0,0,0,0,0
20200212,048533,景碩國票94購01,2.77,3.33,2.70,3.33,+0.54,19.35,110000,24,323000,0,0,0,0,0,0,52000,58000,-6000,-6000
20200212,048534,貿聯國票94購01,1.13,1.31,1.13,1.31,+0.14,11.97,49000,9,58050,0,0,0,0,0,0,10000,43000,-33000,-33000
20200212,048535,超眾國票94購02,0.35,0.35,0.33,0.34,-0.03,-8.11,85000,9,29000,0,0,0,0,0,0,75000,10000,65000,65000
20200212,048536,南電國票93購04,0.80,0.99,0.78,0.99,+0.23,30.26,257000,9,235040,0,0,0,0,0,0,180000,77000,103000,103000
20200212,048537,柏文國票94購01,,,,,0.00,0.00,0,0,0,0,0,0,0,0,0,0,0,0,0
20200212,048538,美利達國票94購01,,,,,0.00,0.00,0,0,0,0,0,0,0,0,0,0,0,0,0
20200212,048539,巨大國票94購01,,,,,0.00,0.00,0,0,0,0,0,0,0,0,0,0,0,0,0
20200212,04853P,易華電永豐94售03,1.54,1.54,1.54,1.54,-0.01,-0.65,27000,1,41580,0,0,0,0,0,0,27000,0,27000,27000
20200212,048540,百和國票93購01,,,,,0.00,0.00,0,0,0,0,0,0,0,0,0,0,0,0,0
20200212,048541,緯穎台新93購01,,,,,0.00,0.00,0,0,0,0,0,0,0,0,0,0,0,0,0
20200212,048542,美利達台新93購01,,,,,0.00,0.00,0,0,0,0,0,0,0,0,0,0,0,0,0
20200212,048543,統一永豐93購01,,,,,0.00,0.00,0,0,0,0,0,0,0,0,0,0,0,0,0
20200212,048544,欣興永豐94購01,,,,,0.00,0.00,0,0,0,0,0,0,0,0,0,0,0,0,0
20200212,048545,嘉澤永豐93購03,0.60,0.62,0.60,0.62,0.00,0.00,122000,3,74940,0,0,0,0,0,0,58000,64000,-6000,-6000
20200212,048546,廣越永豐93購01,,,,,0.00,0.00,0,0,0,0,0,0,0,0,0,0,0,0,0
20200212,048547,訊芯永豐93購03,0.29,0.29,0.29,0.29,+0.05,20.83,5000,1,1450,0,0,0,0,0,0,5000,0,5000,5000
20200212,048548,緯穎永豐93購02,5.55,6.05,5.55,6.05,+0.45,8.04,129000,8,724450,0,0,0,0,0,0,98000,31000,67000,67000
20200212,048549,滬深2X元大96購03,,,,,0.00,0.00,0,0,0,0,0,0,0,0,0,0,0,0,0
20200212,04854P,鴻海國泰96售04,0.86,0.86,0.70,0.71,-0.23,-24.47,930000,52,735550,0,0,0,0,0,0,326000,587000,-261000,-261000
20200212,048550,中鴻元大96購01,0.70,0.73,0.70,0.73,0.00,0.00,2000,2,1430,0,0,0,0,0,0,0,2000,-2000,-2000
20200212,048551,鴻海元大94購02,4.45,5.05,4.45,5.05,+0.61,13.74,13000,3,59650,0,0,0,0,0,0,10000,3000,7000,7000
20200212,048552,鴻海元大94購03,4.59,5.30,4.59,5.30,+0.79,17.52,29000,6,139060,0,0,0,0,0,0,25000,4000,21000,21000
20200212,048553,光磊元大93購03,0.46,0.46,0.43,0.43,-0.05,-10.42,102000,2,44370,0,0,0,0,0,0,102000,102000,0,0
20200212,048554,燿華元大93購06,,,,,0.00,0.00,0,0,0,0,0,0,0,0,0,0,0,0,0
20200212,048555,技嘉元大93購02,1.72,1.79,1.53,1.60,-0.06,-3.61,424000,35,708320,0,0,0,0,0,0,242000,177000,65000,65000
20200212,048556,技嘉元大93購03,1.09,1.14,0.94,1.01,-0.06,-5.61,379000,27,401480,0,0,0,0,0,0,338000,41000,297000,297000
20200212,048557,瑞昱元大94購01,2.93,3.26,2.93,3.10,+0.21,7.27,66000,21,205390,0,0,0,0,0,0,49000,56000,-7000,-7000
20200212,048558,漢唐元大93購06,2.23,2.31,2.23,2.31,+0.04,1.76,76000,5,173160,0,0,0,0,0,0,76000,0,76000,76000
20200212,048559,京元電元大93購03,0.46,0.47,0.42,0.47,+0.03,6.82,447000,13,206190,0,0,0,0,0,0,447000,0,447000,447000
20200212,04855P,上証2X元富94售02,1.83,1.91,1.83,1.91,+0.02,1.06,50000,3,94500,0,0,0,0,0,0,50000,0,50000,50000
20200212,048560,聯發科元大94購01,1.07,1.22,1.04,1.22,+0.32,35.56,173000,11,198750,0,0,0,0,0,0,76000,97000,-21000,-21000
20200212,048561,可成元大93購13,0.80,0.93,0.80,0.93,0.00,0.00,132000,7,118360,0,0,0,0,0,0,62000,132000,-70000,-70000
20200212,048562,宏達電元大95購01,0.67,0.68,0.67,0.68,0.00,0.00,21000,2,14270,0,0,0,0,0,0,20000,1000,19000,19000
20200212,048563,明泰元大94購01,0.60,0.65,0.60,0.65,+0.09,16.07,706000,7,434310,0,0,0,0,0,0,0,705000,-705000,-705000
20200212,048564,智易元大94購01,0.44,0.53,0.44,0.52,0.00,0.00,62000,8,30050,0,0,0,0,0,0,59000,2000,57000,57000
20200212,048565,康控元大94購04,0.22,0.22,0.22,0.22,0.00,0.00,25000,1,5500,0,0,0,0,0,0,25000,0,25000,25000
20200212,048566,上海銀元大93購04,0.71,0.71,0.71,0.71,-0.05,-6.58,2000,1,1420,0,0,0,0,0,0,2000,0,2000,2000
20200212,048567,台郡元大93購03,5.10,5.10,5.10,5.10,+1.78,53.61,20000,2,102000,0,0,0,0,0,0,20000,0,20000,20000
20200212,048568,緯穎元大93購06,10.00,10.70,9.85,10.70,+0.50,4.9,43000,10,449250,0,0,0,0,0,0,43000,43000,0,0
20200212,048569,台虹元大93購03,1.30,1.37,1.29,1.34,+0.18,15.52,226000,13,299910,0,0,0,0,0,0,97000,176000,-79000,-79000
20200212,04856P,光磊元富94售01,1.39,1.41,1.39,1.41,-0.03,-2.08,11000,3,15490,0,0,0,0,0,0,1000,10000,-9000,-9000
20200212,048570,鈺齊元大93購01,2.31,2.57,2.31,2.57,+0.29,12.72,11000,2,28010,0,0,0,0,0,0,1000,10000,-9000,-9000
20200212,048571,美利達元大96購03,,,,,0.00,0.00,0,0,0,0,0,0,0,0,0,0,0,0,0
20200212,048572,美利達元大96購04,1.51,1.51,1.51,1.51,+0.01,0.67,33000,1,49830,0,0,0,0,0,0,33000,0,33000,33000
20200212,048573,世紀鋼元大93購05,0.40,0.40,0.40,0.40,0.00,0.00,100000,1,40000,0,0,0,0,0,0,100000,0,100000,100000
20200212,048574,台積電國泰95購02,18.20,18.20,18.20,18.20,0.00,0.00,5000,1,91000,0,0,0,0,0,0,5000,0,5000,5000
20200212,048575,旺宏國泰94購04,,,,,0.00,0.00,0,0,0,0,0,0,0,0,0,0,0,0,0
20200212,048576,義隆國泰95購01,1.41,1.41,1.28,1.36,+0.18,15.25,408000,27,536200,0,0,0,0,0,0,388000,26000,362000,362000
20200212,048577,GIS國泰94購01,0.61,0.69,0.61,0.69,+0.08,13.11,55000,18,36960,0,0,0,0,0,0,13000,48000,-35000,-35000
20200212,048578,滬深2X富邦93購04,,,,,0.00,0.00,0,0,0,0,0,0,0,0,0,0,0,0,0
20200212,048579,華新富邦93購01,1.56,1.69,1.56,1.69,+0.09,5.62,3000,3,4940,0,0,0,0,0,0,1000,2000,-1000,-1000
20200212,04857P,美律元富94售01,1.07,1.07,0.96,0.96,-0.21,-17.95,28000,14,28400,0,0,0,0,0,0,22000,6000,16000,16000
20200212,048580,台達電富邦93購01,,,,,0.00,0.00,0,0,0,0,0,0,0,0,0,0,0,0,0
20200212,048581,南亞科富邦93購02,,,,,0.00,0.00,0,0,0,0,0,0,0,0,0,0,0,0,0
20200212,048582,國泰金富邦93購01,2.21,2.23,2.13,2.23,+0.09,4.21,192000,27,415540,0,0,0,0,0,0,144000,48000,96000,96000
20200212,048583,智原富邦98購01,0.27,0.27,0.27,0.27,+0.02,8.0,1000,1,270,0,0,0,0,0,0,0,1000,-1000,-1000
20200212,048584,欣興富邦95購01,0.53,0.60,0.53,0.60,+0.16,36.36,327000,9,186860,0,0,0,0,0,0,0,327000,-327000,-327000
20200212,048585,瑞儀富邦93購01,,,,,0.00,0.00,0,0,0,0,0,0,0,0,0,0,0,0,0
20200212,048586,美利達富邦93購01,0.64,0.64,0.64,0.64,-0.01,-1.54,11000,2,7040,0,0,0,0,0,0,11000,0,11000,11000
20200212,048587,康控中信93購01,0.07,0.07,0.07,0.07,0.00,0.00,1000,1,70,0,0,0,0,0,0,0,0,0,0
20200212,048588,世紀鋼中信94購01,,,,,0.00,0.00,0,0,0,0,0,0,0,0,0,0,0,0,0
20200212,048589,國巨兆豐96購01,,,,,0.00,0.00,0,0,0,0,0,0,0,0,0,0,0,0,0
20200212,04858P,健策元富94售01,,,,,0.00,0.00,0,0,0,0,0,0,0,0,0,0,0,0,0
20200212,048590,貿聯兆豐94購02,0.48,0.55,0.48,0.54,+0.08,17.39,847000,12,451930,0,0,0,0,0,0,675000,172000,503000,503000
20200212,048591,台郡兆豐94購01,1.52,1.61,1.52,1.54,+0.59,62.11,246000,22,381820,0,0,0,0,0,0,163000,0,163000,163000
20200212,048592,漢唐群益93購04,1.24,1.30,1.24,1.27,0.00,0.00,54000,7,67950,0,0,0,0,0,0,39000,15000,24000,24000
20200212,048593,華新科群益93購04,6.85,6.85,6.50,6.65,+0.20,3.1,18000,8,118550,0,0,0,0,0,0,18000,18000,0,0
20200212,048594,泰鼎群益93購02,1.64,1.77,1.64,1.77,+0.29,19.59,79000,19,134020,0,0,0,0,0,0,28000,79000,-51000,-51000
20200212,048595,儒鴻國票96購01,0.54,0.59,0.48,0.59,-0.01,-1.67,559000,19,295330,0,0,0,0,0,0,133000,426000,-293000,-293000
20200212,048596,力山國票94購01,,,,,0.00,0.00,0,0,0,0,0,0,0,0,0,0,0,0,0
20200212,048597,台達電國票93購02,,,,,0.00,0.00,0,0,0,0,0,0,0,0,0,0,0,0,0
20200212,048598,瑞昱國票93購03,1.66,1.66,1.66,1.66,+0.46,38.33,10000,1,16600,0,0,0,0,0,0,10000,0,10000,10000
20200212,048599,和鑫國票96購01,0.30,0.32,0.30,0.32,+0.03,10.34,66000,11,19920,0,0,0,0,0,0,60000,6000,54000,54000
20200212,04859P,台達電群益94售04,0.63,0.63,0.57,0.57,-0.06,-9.52,8000,8,4690,0,0,0,0,0,0,8000,0,8000,8000
20200212,048600,嘉澤國票94購01,3.72,3.72,3.72,3.72,-0.07,-1.85,10000,1,37200,0,0,0,0,0,0,0,10000,-10000,-10000
20200212,048601,智易國票94購03,,,,,0.00,0.00,0,0,0,0,0,0,0,0,0,0,0,0,0
20200212,048602,上緯控國票96購01,0.63,0.63,0.63,0.63,+0.01,1.61,33000,2,20790,0,0,0,0,0,0,33000,0,33000,33000
20200212,048603,中磊國票94購02,1.07,1.07,1.07,1.07,-0.04,-3.6,9000,1,9630,0,0,0,0,0,0,9000,9000,0,0
20200212,048604,美利達國票94購02,,,,,0.00,0.00,0,0,0,0,0,0,0,0,0,0,0,0,0
20200212,048605,百和國票93購02,,,,,0.00,0.00,0,0,0,0,0,0,0,0,0,0,0,0,0
20200212,048606,聯發科日盛93購02,0.70,0.81,0.70,0.81,+0.24,42.11,281000,29,212460,0,0,0,0,0,0,181000,100000,81000,81000
20200212,048607,上銀凱基93購11,,,,,0.00,0.00,0,0,0,0,0,0,0,0,0,0,0,0,0
20200212,048608,燿華凱基93購06,,,,,0.00,0.00,0,0,0,0,0,0,0,0,0,0,0,0,0
20200212,048609,京元電凱基93購07,0.22,0.25,0.22,0.25,-0.01,-3.85,276000,26,64280,0,0,0,0,0,0,276000,0,276000,276000
20200212,04860P,鴻海群益94售07,,,,,0.00,0.00,0,0,0,0,0,0,0,0,0,0,0,0,0
20200212,048610,華新科凱基94購04,3.01,3.01,3.01,3.01,+0.08,2.73,4000,1,12040,0,0,0,0,0,0,4000,0,4000,4000
20200212,048611,宏達電凱基93購04,0.43,0.44,0.43,0.43,+0.04,10.26,31000,7,13420,0,0,0,0,0,0,31000,0,31000,31000
20200212,048612,嘉晶凱基93購05,,,,,0.00,0.00,0,0,0,0,0,0,0,0,0,0,0,0,0
20200212,048613,智原凱基93購03,,,,,0.00,0.00,0,0,0,0,0,0,0,0,0,0,0,0,0
20200212,048614,欣興凱基93購05,0.61,0.61,0.59,0.60,+0.21,53.85,125000,5,74490,0,0,0,0,0,0,0,125000,-125000,-125000
20200212,048615,貿聯凱基93購04,,,,,0.00,0.00,0,0,0,0,0,0,0,0,0,0,0,0,0
20200212,048616,智伸科凱基93購07,0.98,0.99,0.98,0.99,+0.02,2.06,28000,2,27470,0,0,0,0,0,0,25000,3000,22000,22000
20200212,048617,瀚宇博凱基93購04,,,,,0.00,0.00,0,0,0,0,0,0,0,0,0,0,0,0,0
20200212,048618,超眾凱基93購08,0.50,0.52,0.49,0.52,+0.03,6.12,8000,6,4030,0,0,0,0,0,0,8000,0,8000,8000
20200212,048619,台表科凱基93購07,2.38,2.62,2.38,2.62,+0.24,10.08,25000,6,62760,0,0,0,0,0,0,14000,25000,-11000,-11000
20200212,04861P,中磊群益94售02,,,,,0.00,0.00,0,0,0,0,0,0,0,0,0,0,0,0,0
20200212,048620,易華電凱基94購02,,,,,0.00,0.00,0,0,0,0,0,0,0,0,0,0,0,0,0
20200212,048621,緯穎凱基93購03,,,,,0.00,0.00,0,0,0,0,0,0,0,0,0,0,0,0,0
20200212,048622,南電凱基93購07,0.30,0.37,0.29,0.37,+0.08,27.59,228000,20,72290,0,0,0,0,0,0,100000,128000,-28000,-28000
20200212,048623,世紀鋼凱基94購03,,,,,0.00,0.00,0,0,0,0,0,0,0,0,0,0,0,0,0
20200212,048624,美律台新93購01,0.20,0.30,0.20,0.29,+0.11,61.11,519000,20,130780,0,0,0,0,0,0,23000,509000,-486000,-486000
20200212,048625,GIS台新93購01,0.31,0.32,0.31,0.32,0.00,0.00,18000,3,5640,0,0,0,0,0,0,0,18000,-18000,-18000
20200212,048626,矽創台新93購01,0.41,0.58,0.40,0.58,+0.18,45.0,370000,28,188600,0,0,0,0,0,0,107000,243000,-136000,-136000
20200212,048627,T50反1元大96購02,0.16,0.17,0.14,0.14,-0.03,-17.65,109000,7,17240,0,0,0,0,0,0,9000,100000,-91000,-91000
20200212,048628,T50反1元大96購03,0.15,0.15,0.13,0.14,-0.02,-12.5,925000,10,128950,0,0,0,0,0,0,0,925000,-925000,-925000
20200212,048629,滬深2X元大96購04,0.52,0.55,0.52,0.55,+0.01,1.85,41000,4,21450,0,0,0,0,0,0,0,41000,-41000,-41000
20200212,04862P,台積電元大94售26,0.46,0.46,0.46,0.46,0.00,0.00,210000,1,96600,0,0,0,0,0,0,0,210000,-210000,-210000
20200212,048630,南亞元大93購01,1.10,1.12,1.10,1.12,-0.02,-1.75,20000,2,22200,0,0,0,0,0,0,20000,0,20000,20000
20200212,048631,遠東新元大93購01,0.72,0.72,0.72,0.72,-0.02,-2.7,30000,1,21600,0,0,0,0,0,0,0,30000,-30000,-30000
20200212,048632,大成鋼元大93購02,0.08,0.08,0.08,0.08,0.00,0.00,60000,1,4800,0,0,0,0,0,0,60000,0,60000,60000
20200212,048633,台達電元大94購02,2.43,2.53,2.43,2.53,+0.09,3.69,83000,6,203190,0,0,0,0,0,0,3000,80000,-77000,-77000
20200212,048634,華通元大94購01,3.03,4.42,2.89,4.42,+1.50,51.37,521000,60,1906210,0,0,0,0,0,0,453000,259000,194000,194000
20200212,048635,鴻海元大94購04,3.89,4.35,3.89,4.35,+0.60,16.0,31000,5,128410,0,0,0,0,0,0,13000,21000,-8000,-8000
20200212,048636,鴻海元大94購05,3.82,4.26,3.82,4.26,+0.55,14.82,46000,7,184870,0,0,0,0,0,0,18000,30000,-12000,-12000
20200212,048637,鴻海元大96購01,,,,,0.00,0.00,0,0,0,0,0,0,0,0,0,0,0,0,0
20200212,048638,台光電元大94購01,0.93,1.22,0.93,1.22,+0.29,31.18,84000,9,95680,0,0,0,0,0,0,20000,64000,-44000,-44000
20200212,048639,漢唐元大93購07,1.70,1.70,1.70,1.70,-0.04,-2.3,7000,1,11900,0,0,0,0,0,0,7000,0,7000,7000
20200212,04863P,技嘉元大94售02,0.78,0.85,0.77,0.81,-0.05,-5.81,333000,28,265390,0,0,0,0,0,0,174000,156000,18000,18000
20200212,048640,南亞科元大93購06,0.41,0.41,0.39,0.40,+0.01,2.56,236000,4,93770,0,0,0,0,0,0,73000,163000,-90000,-90000
20200212,048641,美律元大94購01,0.64,0.78,0.64,0.78,+0.21,36.84,331000,23,229100,0,0,0,0,0,0,155000,183000,-28000,-28000
20200212,048642,聯發科元大94購02,1.47,1.64,1.44,1.62,+0.35,27.56,669000,43,1031070,0,0,0,0,0,0,405000,589000,-184000,-184000
20200212,048643,強茂元大94購01,,,,,0.00,0.00,0,0,0,0,0,0,0,0,0,0,0,0,0
20200212,048644,華固元大93購01,2.52,2.52,2.52,2.52,0.00,0.00,9000,1,22680,0,0,0,0,0,0,0,9000,-9000,-9000
20200212,048645,創意元大94購02,1.48,1.59,1.42,1.51,-0.20,-11.7,255000,16,382500,0,0,0,0,0,0,157000,108000,49000,49000
20200212,048646,上緯控元大93購01,0.29,0.29,0.29,0.29,-0.01,-3.33,1000,1,290,0,0,0,0,0,0,1000,0,1000,1000
20200212,048647,正文元大93購01,,,,,0.00,0.00,0,0,0,0,0,0,0,0,0,0,0,0,0
20200212,048648,祥碩元大93購03,,,,,0.00,0.00,0,0,0,0,0,0,0,0,0,0,0,0,0
20200212,048649,瀚宇博元大93購05,,,,,0.00,0.00,0,0,0,0,0,0,0,0,0,0,0,0,0
20200212,04864P,欣興元大94售10,2.45,2.50,2.45,2.50,-0.53,-17.49,50000,2,122550,0,0,0,0,0,0,50000,0,50000,50000
20200212,048650,台表科元大93購05,3.21,3.53,3.10,3.53,+0.39,12.42,196000,26,643250,0,0,0,0,0,0,116000,100000,16000,16000
20200212,048651,美利達元大96購05,0.90,0.90,0.90,0.90,+0.06,7.14,56000,2,50400,0,0,0,0,0,0,56000,0,56000,56000
20200212,048652,巨大元大96購01,0.99,1.00,0.99,1.00,0.00,0.00,106000,3,104980,0,0,0,0,0,0,100000,6000,94000,94000
20200212,048653,巨大元大96購02,1.04,1.05,1.03,1.05,-0.01,-0.94,230000,6,238500,0,0,0,0,0,0,100000,110000,-10000,-10000
20200212,048654,滬深2X元富93購05,,,,,0.00,0.00,0,0,0,0,0,0,0,0,0,0,0,0,0
20200212,048655,A50正2元富96購01,0.77,0.77,0.72,0.76,-0.02,-2.56,5000,3,3740,0,0,0,0,0,0,1000,4000,-3000,-3000
20200212,048656,大立光元富93購05,0.75,0.94,0.75,0.93,+0.21,29.17,196000,18,170080,0,0,0,0,0,0,15000,181000,-166000,-166000
20200212,048657,大成鋼統一93購04,,,,,0.00,0.00,0,0,0,0,0,0,0,0,0,0,0,0,0
20200212,048658,鴻海統一93購09,0.45,0.62,0.45,0.62,+0.34,121.43,12000,3,7240,0,0,0,0,0,0,12000,0,12000,12000
20200212,048659,國巨統一94購02,,,,,0.00,0.00,0,0,0,0,0,0,0,0,0,0,0,0,0
20200212,04865P,台積電亞東95售01,,,,,0.00,0.00,0,0,0,0,0,0,0,0,0,0,0,0,0
20200212,048660,台積電統一93購09,,,,,0.00,0.00,0,0,0,0,0,0,0,0,0,0,0,0,0
20200212,048661,瑞昱統一93購05,1.47,1.47,1.47,1.47,+0.19,14.84,10000,1,14700,0,0,0,0,0,0,0,10000,-10000,-10000
20200212,048662,京元電統一93購04,0.64,0.72,0.60,0.72,+0.06,9.09,366000,34,237830,0,0,0,0,0,0,304000,50000,254000,254000
20200212,048663,聯發科統一96購01,0.56,0.56,0.56,0.56,+0.06,12.0,1000,1,560,0,0,0,0,0,0,1000,0,1000,1000
20200212,048664,華新科統一94購01,3.56,3.59,3.56,3.59,+0.12,3.46,13000,2,46370,0,0,0,0,0,0,10000,13000,-3000,-3000
20200212,048665,欣興統一93購07,0.48,0.67,0.48,0.67,+0.28,71.79,479000,11,270580,0,0,0,0,0,0,10000,469000,-459000,-459000
20200212,048666,康控統一93購01,0.06,0.06,0.06,0.06,+0.01,20.0,20000,1,1200,0,0,0,0,0,0,20000,0,20000,20000
20200212,048667,旺宏永豐94購02,1.31,1.40,1.29,1.31,-0.04,-2.96,67000,12,89060,0,0,0,0,0,0,48000,22000,26000,26000
20200212,048668,奇力新永豐93購04,4.62,5.10,4.58,5.00,+0.19,3.95,175000,40,827520,0,0,0,0,0,0,72000,103000,-31000,-31000
20200212,048669,強茂永豐93購01,,,,,0.00,0.00,0,0,0,0,0,0,0,0,0,0,0,0,0
20200212,04866P,台積電統一95售02,,,,,0.00,0.00,0,0,0,0,0,0,0,0,0,0,0,0,0
20200212,048670,華新科永豐93購03,1.78,1.78,1.64,1.72,+0.06,3.61,378000,42,644830,0,0,0,0,0,0,280000,113000,167000,167000
20200212,048671,大立光永豐93購04,,,,,0.00,0.00,0,0,0,0,0,0,0,0,0,0,0,0,0
20200212,048672,日電貿永豐93購02,,,,,0.00,0.00,0,0,0,0,0,0,0,0,0,0,0,0,0
20200212,048673,智伸科永豐93購02,,,,,0.00,0.00,0,0,0,0,0,0,0,0,0,0,0,0,0
20200212,048674,易華電永豐93購05,,,,,0.00,0.00,0,0,0,0,0,0,0,0,0,0,0,0,0
20200212,048675,台達電國泰94購02,,,,,0.00,0.00,0,0,0,0,0,0,0,0,0,0,0,0,0
20200212,048676,和鑫國泰94購02,0.55,0.60,0.55,0.60,+0.08,15.38,161000,25,91000,0,0,0,0,0,0,100000,61000,39000,39000
20200212,048677,智伸科國泰94購01,,,,,0.00,0.00,0,0,0,0,0,0,0,0,0,0,0,0,0
20200212,048678,統一富邦93購01,1.53,1.53,1.49,1.49,-0.09,-5.7,53000,4,79970,0,0,0,0,0,0,53000,23000,30000,30000
20200212,048679,大成鋼富邦93購01,,,,,0.00,0.00,0,0,0,0,0,0,0,0,0,0,0,0,0
20200212,04867P,美律統一94售03,0.95,0.95,0.87,0.87,-0.22,-20.18,39000,25,35130,0,0,0,0,0,0,24000,15000,9000,9000
20200212,048680,智邦富邦93購02,,,,,0.00,0.00,0,0,0,0,0,0,0,0,0,0,0,0,0
20200212,048681,漢唐富邦96購01,1.32,1.32,1.32,1.32,0.00,0.00,1000,1,1320,0,0,0,0,0,0,1000,0,1000,1000
20200212,048682,奇力新富邦96購01,9.65,9.65,9.55,9.55,-0.20,-2.05,15000,13,143450,0,0,0,0,0,0,15000,0,15000,15000
20200212,048683,日月光富邦93購01,2.98,3.18,2.98,3.18,0.00,0.00,22000,3,67960,0,0,0,0,0,0,0,22000,-22000,-22000
20200212,048684,上海銀富邦93購02,0.99,0.99,0.99,0.99,-0.05,-4.81,2000,2,1980,0,0,0,0,0,0,2000,0,2000,2000
20200212,048685,T50反1第一94購01,,,,,0.00,0.00,0,0,0,0,0,0,0,0,0,0,0,0,0
20200212,048686,滬深2X中信95購09,,,,,0.00,0.00,0,0,0,0,0,0,0,0,0,0,0,0,0
20200212,048687,旺宏群益96購01,1.45,1.45,1.42,1.42,-0.02,-1.39,20000,2,28700,0,0,0,0,0,0,10000,10000,0,0
20200212,048688,瑞昱群益94購01,0.77,0.83,0.77,0.79,+0.12,17.91,246000,3,193540,0,0,0,0,0,0,186000,60000,126000,126000
20200212,048689,台光電群益94購01,0.40,0.63,0.40,0.58,+0.19,48.72,217000,41,114730,0,0,0,0,0,0,16000,201000,-185000,-185000
20200212,04868P,可成統一94售03,,,,,0.00,0.00,0,0,0,0,0,0,0,0,0,0,0,0,0
20200212,048690,美律群益94購01,0.05,0.05,0.05,0.05,0.00,0.00,1000,1,50,0,0,0,0,0,0,1000,0,1000,1000
20200212,048691,智伸科群益94購01,1.66,1.68,1.64,1.64,-0.07,-4.09,96000,5,160240,0,0,0,0,0,0,66000,30000,36000,36000
20200212,048692,致伸群益94購01,,,,,0.00,0.00,0,0,0,0,0,0,0,0,0,0,0,0,0
20200212,048693,GIS群益94購02,0.61,0.63,0.61,0.63,0.00,0.00,39000,7,23990,0,0,0,0,0,0,0,39000,-39000,-39000
20200212,048694,緯穎群益94購01,,,,,0.00,0.00,0,0,0,0,0,0,0,0,0,0,0,0,0
20200212,048695,滬深2X國票95購03,,,,,0.00,0.00,0,0,0,0,0,0,0,0,0,0,0,0,0
20200212,048696,台達電國票96購01,,,,,0.00,0.00,0,0,0,0,0,0,0,0,0,0,0,0,0
20200212,048697,華新科國票94購06,15.80,16.50,15.80,16.00,+1.20,8.11,29000,13,463800,0,0,0,0,0,0,17000,12000,5000,5000
20200212,048698,宏達電國票95購01,0.43,0.43,0.41,0.42,+0.01,2.44,120000,14,50700,0,0,0,0,0,0,95000,20000,75000,75000
20200212,048699,嘉晶國票95購01,1.28,1.40,1.28,1.40,0.00,0.00,134000,5,173650,0,0,0,0,0,0,5000,129000,-124000,-124000
20200212,04869P,鴻海元富95售02,0.78,0.78,0.66,0.67,-0.20,-22.99,319000,25,228840,0,0,0,0,0,0,109000,307000,-198000,-198000
20200212,048700,和鑫國票95購01,0.68,0.70,0.67,0.70,+0.03,4.48,167000,26,114080,0,0,0,0,0,0,52000,115000,-63000,-63000
20200212,048701,健策國票95購01,,,,,0.00,0.00,0,0,0,0,0,0,0,0,0,0,0,0,0
20200212,048702,正文國票95購01,,,,,0.00,0.00,0,0,0,0,0,0,0,0,0,0,0,0,0
20200212,048703,康控國票95購01,0.71,0.78,0.71,0.77,+0.15,24.19,288000,8,209030,0,0,0,0,0,0,11000,277000,-266000,-266000
20200212,048704,台表科國票95購01,4.80,5.35,4.64,5.35,+0.81,17.84,36000,7,182300,0,0,0,0,0,0,16000,20000,-4000,-4000
20200212,048705,GIS國票95購01,0.99,1.03,0.99,1.03,+0.12,13.19,234000,6,234130,0,0,0,0,0,0,60000,174000,-114000,-114000
20200212,048706,緯穎國票94購01,19.00,19.20,19.00,19.20,-0.30,-1.54,12000,2,230000,0,0,0,0,0,0,12000,0,12000,12000
20200212,048707,南電國票95購01,0.40,0.51,0.38,0.51,+0.18,54.55,120000,12,54330,0,0,0,0,0,0,60000,60000,0,0
20200212,048708,智邦亞東94購01,1.60,1.60,1.60,1.60,+0.28,21.21,17000,1,27200,0,0,0,0,0,0,17000,0,17000,17000
20200212,048709,瑞昱亞東94購01,1.07,1.07,1.07,1.07,0.00,0.00,9000,1,9630,0,0,0,0,0,0,9000,0,9000,9000
20200212,04870P,大立光元富94售11,,,,,0.00,0.00,0,0,0,0,0,0,0,0,0,0,0,0,0
20200212,048710,奇力新台新94購01,,,,,0.00,0.00,0,0,0,0,0,0,0,0,0,0,0,0,0
20200212,048711,台郡台新94購01,4.42,4.58,4.41,4.52,+2.15,90.72,36000,15,161740,0,0,0,0,0,0,20000,16000,4000,4000
20200212,048712,樺漢台新94購01,1.15,1.17,1.15,1.17,+0.18,18.18,14000,2,16120,0,0,0,0,0,0,0,14000,-14000,-14000
20200212,048713,美利達康和94購01,,,,,0.00,0.00,0,0,0,0,0,0,0,0,0,0,0,0,0
20200212,048714,巨大康和94購01,0.33,0.33,0.33,0.33,0.00,0.00,20000,1,6600,0,0,0,0,0,0,0,20000,-20000,-20000
20200212,048715,A50正2永豐94購01,,,,,0.00,0.00,0,0,0,0,0,0,0,0,0,0,0,0,0
20200212,048716,力山永豐94購01,,,,,0.00,0.00,0,0,0,0,0,0,0,0,0,0,0,0,0
20200212,048717,鴻海永豐94購02,,,,,0.00,0.00,0,0,0,0,0,0,0,0,0,0,0,0,0
20200212,048718,台光電永豐94購01,,,,,0.00,0.00,0,0,0,0,0,0,0,0,0,0,0,0,0
20200212,048719,亞光永豐94購01,1.14,1.38,1.14,1.35,+0.21,18.42,123000,20,160210,0,0,0,0,0,0,56000,105000,-49000,-49000
20200212,04871P,力成元富94售02,0.47,0.47,0.41,0.41,0.00,0.00,21000,2,8670,0,0,0,0,0,0,0,21000,-21000,-21000
20200212,048720,智易永豐94購02,,,,,0.00,0.00,0,0,0,0,0,0,0,0,0,0,0,0,0
20200212,048721,正文永豐94購01,0.14,0.14,0.14,0.14,0.00,0.00,10000,1,1400,0,0,0,0,0,0,10000,0,10000,10000
20200212,048722,台表科永豐94購01,,,,,0.00,0.00,0,0,0,0,0,0,0,0,0,0,0,0,0
20200212,048723,世紀鋼永豐94購02,,,,,0.00,0.00,0,0,0,0,0,0,0,0,0,0,0,0,0
20200212,048724,台達電日盛94購01,0.67,0.67,0.67,0.67,0.00,0.00,5000,1,3350,0,0,0,0,0,0,5000,0,5000,5000
20200212,048725,京元電日盛94購01,0.55,0.64,0.54,0.62,+0.04,6.9,674000,33,395990,0,0,0,0,0,0,416000,258000,158000,158000
20200212,048726,儒鴻麥證95購01,0.35,0.39,0.31,0.36,-0.03,-7.69,310000,29,105540,178000,122000,56000,0,0,0,178000,122000,56000,56000
20200212,048727,大成鋼麥證94購01,,,,,0.00,0.00,0,0,0,0,0,0,0,0,0,0,0,0,0
20200212,048728,台達電麥證94購01,1.14,1.22,1.10,1.22,+0.07,6.09,90000,7,104500,40000,50000,-10000,0,0,0,40000,50000,-10000,-10000
20200212,048729,鴻海麥證94購01,1.35,1.35,1.35,1.35,0.00,0.00,2000,1,2700,2000,0,2000,0,0,0,2000,0,2000,2000
20200212,04872P,高股息中信94售01,,,,,0.00,0.00,0,0,0,0,0,0,0,0,0,0,0,0,0
20200212,048730,智原麥證94購01,,,,,0.00,0.00,0,0,0,0,0,0,0,0,0,0,0,0,0
20200212,048731,創意麥證94購01,0.43,0.46,0.36,0.45,-0.08,-15.09,266000,29,110640,158000,105000,53000,0,0,0,158000,105000,53000,53000
20200212,048732,台勝科麥證95購01,,,,,0.00,0.00,0,0,0,0,0,0,0,0,0,0,0,0,0
20200212,048733,台勝科麥證95購02,1.47,1.53,1.47,1.49,-0.01,-0.67,510000,17,759720,217000,243000,-26000,0,0,0,217000,243000,-26000,-26000
20200212,048734,美利達麥證94購01,,,,,0.00,0.00,0,0,0,0,0,0,0,0,0,0,0,0,0
20200212,048735,美利達麥證95購01,0.58,0.58,0.58,0.58,+0.01,1.75,11000,2,6380,11000,0,11000,0,0,0,11000,0,11000,11000
20200212,048736,台達電統一94購01,0.85,0.86,0.83,0.86,0.00,0.00,86000,3,73560,0,0,0,0,0,0,66000,10000,56000,56000
20200212,048737,國巨統一94購03,,,,,0.00,0.00,0,0,0,0,0,0,0,0,0,0,0,0,0
20200212,048738,台積電統一94購04,,,,,0.00,0.00,0,0,0,0,0,0,0,0,0,0,0,0,0
20200212,048739,華新科統一94購02,,,,,0.00,0.00,0,0,0,0,0,0,0,0,0,0,0,0,0
20200212,048740,富邦金統一94購01,1.21,1.24,1.21,1.24,+0.16,14.81,42000,3,51770,0,0,0,0,0,0,0,42000,-42000,-42000
20200212,048741,欣興統一94購02,0.22,0.22,0.21,0.21,0.00,0.00,61000,2,12820,0,0,0,0,0,0,0,61000,-61000,-61000
20200212,048742,瀚宇博統一94購01,0.62,0.66,0.62,0.66,+0.01,1.54,37000,11,23920,0,0,0,0,0,0,27000,10000,17000,17000
20200212,048743,美利達統一94購01,0.31,0.31,0.31,0.31,-0.01,-3.12,219000,3,67890,0,0,0,0,0,0,219000,0,219000,219000
20200212,048744,儒鴻元富97購01,0.31,0.31,0.28,0.30,-0.03,-9.09,563000,10,167770,0,0,0,0,0,0,108000,455000,-347000,-347000
20200212,048745,儒鴻元富97購02,0.42,0.44,0.39,0.42,-0.01,-2.33,541000,24,221960,0,0,0,0,0,0,168000,363000,-195000,-195000
20200212,048746,台達電元富94購01,,,,,0.00,0.00,0,0,0,0,0,0,0,0,0,0,0,0,0
20200212,048747,華通元富97購01,2.52,3.35,2.52,3.16,+0.70,28.46,350000,49,1039970,0,0,0,0,0,0,156000,288000,-132000,-132000
20200212,048748,國巨元富96購01,,,,,0.00,0.00,0,0,0,0,0,0,0,0,0,0,0,0,0
20200212,048749,京元電元富94購02,,,,,0.00,0.00,0,0,0,0,0,0,0,0,0,0,0,0,0
20200212,04874P,高股息中信97售01,0.30,0.30,0.30,0.30,-0.02,-6.25,5000,1,1500,0,0,0,0,0,0,0,5000,-5000,-5000
20200212,048750,智原元富94購01,,,,,0.00,0.00,0,0,0,0,0,0,0,0,0,0,0,0,0
20200212,048751,京鼎元富96購01,,,,,0.00,0.00,0,0,0,0,0,0,0,0,0,0,0,0,0
20200212,048752,廣越元富95購01,0.50,0.51,0.50,0.51,0.00,0.00,11000,3,5540,0,0,0,0,0,0,11000,0,11000,11000
20200212,048753,智伸科元富94購01,,,,,0.00,0.00,0,0,0,0,0,0,0,0,0,0,0,0,0
20200212,048754,瀚宇博元富97購01,0.49,0.56,0.49,0.56,+0.05,9.8,604000,12,317720,0,0,0,0,0,0,155000,449000,-294000,-294000
20200212,048755,志超元富96購01,0.94,0.99,0.94,0.99,+0.06,6.45,31000,5,30440,0,0,0,0,0,0,15000,16000,-1000,-1000
20200212,048756,志超元富96購02,,,,,0.00,0.00,0,0,0,0,0,0,0,0,0,0,0,0,0
20200212,048757,美利達元富96購01,1.06,1.06,1.06,1.06,-0.01,-0.93,11000,2,11660,0,0,0,0,0,0,11000,0,11000,11000
20200212,048758,美利達元富96購02,0.74,0.74,0.74,0.74,0.00,0.00,1000,1,740,0,0,0,0,0,0,1000,0,1000,1000
20200212,048759,巨大元富96購01,,,,,0.00,0.00,0,0,0,0,0,0,0,0,0,0,0,0,0
20200212,04875P,台積電中信94售04,0.11,0.11,0.11,0.11,-0.01,-8.33,799000,6,87890,0,0,0,0,0,0,0,799000,-799000,-799000
20200212,048760,S&P反1凱基94購01,,,,,0.00,0.00,0,0,0,0,0,0,0,0,0,0,0,0,0
20200212,048761,力山凱基94購01,,,,,0.00,0.00,0,0,0,0,0,0,0,0,0,0,0,0,0
20200212,048762,寶齡凱基94購01,0.53,0.53,0.53,0.53,+0.07,15.22,5000,1,2650,0,0,0,0,0,0,5000,0,5000,5000
20200212,048763,台積電凱基94購03,,,,,0.00,0.00,0,0,0,0,0,0,0,0,0,0,0,0,0
20200212,048764,台光電凱基94購03,0.39,0.39,0.39,0.39,+0.14,56.0,10000,3,3900,0,0,0,0,0,0,0,10000,-10000,-10000
20200212,048765,奇力新凱基94購01,7.00,7.00,6.85,7.00,-0.15,-2.1,55000,21,384850,0,0,0,0,0,0,55000,0,55000,55000
20200212,048766,禾伸堂凱基94購01,4.42,4.50,4.36,4.50,-0.04,-0.88,34000,13,151120,0,0,0,0,0,0,23000,11000,12000,12000
20200212,048767,欣興凱基94購01,0.57,0.84,0.57,0.84,+0.25,42.37,312000,8,252200,0,0,0,0,0,0,40000,302000,-262000,-262000
20200212,048768,景碩凱基94購02,2.45,3.45,0.03,3.13,+0.71,29.34,288000,80,806720,0,0,0,0,0,0,41000,249000,-208000,-208000
20200212,048769,聯鈞凱基94購01,1.98,2.35,1.98,2.35,+0.63,36.63,103000,5,212290,0,0,0,0,0,0,93000,20000,73000,73000
20200212,04876P,台光電中信94售02,0.48,0.48,0.48,0.48,-0.16,-25.0,30000,1,14400,0,0,0,0,0,0,30000,0,30000,30000
20200212,048770,揚明光凱基94購01,,,,,0.00,0.00,0,0,0,0,0,0,0,0,0,0,0,0,0
20200212,048771,嘉澤凱基94購01,,,,,0.00,0.00,0,0,0,0,0,0,0,0,0,0,0,0,0
20200212,048772,智易凱基94購01,,,,,0.00,0.00,0,0,0,0,0,0,0,0,0,0,0,0,0
20200212,048773,貿聯凱基94購01,0.81,0.96,0.81,0.96,0.00,0.00,65000,6,59370,0,0,0,0,0,0,42000,23000,19000,19000
20200212,048774,麗豐凱基94購04,,,,,0.00,0.00,0,0,0,0,0,0,0,0,0,0,0,0,0
20200212,048775,智伸科凱基94購01,,,,,0.00,0.00,0,0,0,0,0,0,0,0,0,0,0,0,0
20200212,048776,正文凱基94購01,,,,,0.00,0.00,0,0,0,0,0,0,0,0,0,0,0,0,0
20200212,048777,瀚宇博凱基94購02,,,,,0.00,0.00,0,0,0,0,0,0,0,0,0,0,0,0,0
20200212,048778,聯茂凱基94購04,0.19,0.24,0.19,0.19,+0.09,90.0,340000,7,69850,0,0,0,0,0,0,0,340000,-340000,-340000
20200212,048779,美利達凱基94購01,0.32,0.32,0.32,0.32,-0.01,-3.03,1000,1,320,0,0,0,0,0,0,1000,0,1000,1000
20200212,04877P,聯發科麥證94售04,0.41,0.41,0.41,0.41,0.00,0.00,2000,1,820,2000,0,2000,0,0,0,2000,0,2000,2000
20200212,048780,臺股指凱基94購03,2.26,2.54,2.26,2.54,+0.36,16.51,147000,8,356330,0,0,0,0,0,0,25000,122000,-97000,-97000
20200212,048781,臺股指凱基96購01,1.16,1.38,1.14,1.38,+0.24,21.05,393000,16,469740,0,0,0,0,0,0,272000,121000,151000,151000
20200212,048782,亞泥元大94購01,1.91,1.93,1.91,1.93,+0.02,1.05,5000,2,9610,0,0,0,0,0,0,5000,5000,0,0
20200212,048783,國巨元大94購01,,,,,0.00,0.00,0,0,0,0,0,0,0,0,0,0,0,0,0
20200212,048784,台積電元大94購04,8.20,8.65,8.20,8.65,+0.70,8.81,273000,67,2257500,0,0,0,0,0,0,273000,232000,41000,41000
20200212,048785,台積電元大96購01,,,,,0.00,0.00,0,0,0,0,0,0,0,0,0,0,0,0,0
20200212,048786,瑞昱元大94購02,1.87,2.12,1.85,2.00,+0.18,9.89,240000,28,481960,0,0,0,0,0,0,159000,125000,34000,34000
20200212,048787,義隆元大94購02,1.62,1.63,1.38,1.50,+0.26,20.97,996000,21,1408730,0,0,0,0,0,0,931000,65000,866000,866000
20200212,048788,華新科元大95購02,8.85,8.85,8.55,8.70,+0.15,1.75,85000,29,738100,0,0,0,0,0,0,74000,65000,9000,9000
20200212,048789,大立光元大95購04,,,,,0.00,0.00,0,0,0,0,0,0,0,0,0,0,0,0,0
20200212,04878P,國巨康和94售02,,,,,0.00,0.00,0,0,0,0,0,0,0,0,0,0,0,0,0
20200212,048790,大立光元大95購05,2.59,2.59,2.59,2.59,+0.32,14.1,19000,1,49210,0,0,0,0,0,0,0,19000,-19000,-19000
20200212,048791,智原元大94購02,0.34,0.38,0.34,0.38,+0.05,15.15,213000,11,73140,0,0,0,0,0,0,200000,13000,187000,187000
20200212,048792,瑞儀元大94購01,,,,,0.00,0.00,0,0,0,0,0,0,0,0,0,0,0,0,0
20200212,048793,超眾元大95購02,1.01,1.19,1.01,1.16,+0.07,6.42,208000,21,230530,0,0,0,0,0,0,131000,97000,34000,34000
20200212,048794,易華電元大97購01,0.87,0.91,0.87,0.91,0.00,0.00,115000,4,104400,0,0,0,0,0,0,10000,105000,-95000,-95000
20200212,048795,復盛元大94購01,2.87,2.87,2.84,2.84,+0.12,4.41,12000,3,34230,0,0,0,0,0,0,12000,0,12000,12000
20200212,048796,國巨國泰95購02,,,,,0.00,0.00,0,0,0,0,0,0,0,0,0,0,0,0,0
20200212,048797,美律國泰95購02,1.15,1.38,1.12,1.38,+0.34,32.69,377000,38,470540,0,0,0,0,0,0,117000,332000,-215000,-215000
20200212,048798,華新科國泰95購01,,,,,0.00,0.00,0,0,0,0,0,0,0,0,0,0,0,0,0
20200212,048799,台積電富邦94購03,,,,,0.00,0.00,0,0,0,0,0,0,0,0,0,0,0,0,0
20200212,04879P,康控永豐94售02,,,,,0.00,0.00,0,0,0,0,0,0,0,0,0,0,0,0,0
20200212,048800,瑞昱富邦94購01,,,,,0.00,0.00,0,0,0,0,0,0,0,0,0,0,0,0,0
20200212,048801,漢唐富邦96購02,,,,,0.00,0.00,0,0,0,0,0,0,0,0,0,0,0,0,0
20200212,048802,聯發科富邦94購03,3.07,3.36,3.07,3.36,+0.54,19.15,35000,4,110700,0,0,0,0,0,0,25000,10000,15000,15000
20200212,048803,大立光富邦96購01,0.44,0.44,0.44,0.44,+0.05,12.82,10000,1,4400,0,0,0,0,0,0,10000,0,10000,10000
20200212,048804,和碩富邦94購01,,,,,0.00,0.00,0,0,0,0,0,0,0,0,0,0,0,0,0
20200212,048805,瀚宇博富邦95購01,,,,,0.00,0.00,0,0,0,0,0,0,0,0,0,0,0,0,0
20200212,048806,光磊中信94購01,,,,,0.00,0.00,0,0,0,0,0,0,0,0,0,0,0,0,0
20200212,048807,崇越中信94購01,0.24,0.29,0.24,0.29,+0.07,31.82,202000,7,54390,0,0,0,0,0,0,0,202000,-202000,-202000
20200212,048808,美律亞東94購01,,,,,0.00,0.00,0,0,0,0,0,0,0,0,0,0,0,0,0
20200212,048809,創意亞東94購01,,,,,0.00,0.00,0,0,0,0,0,0,0,0,0,0,0,0,0
20200212,04880P,GIS永豐94售02,,,,,0.00,0.00,0,0,0,0,0,0,0,0,0,0,0,0,0
20200212,048810,玉晶光第一94購01,0.92,1.02,0.92,1.01,+0.19,23.17,210000,11,205420,0,0,0,0,0,0,0,210000,-210000,-210000
20200212,048811,鴻海日盛94購01,2.48,3.00,2.42,2.89,+0.58,25.11,168000,13,435310,0,0,0,0,0,0,65000,103000,-38000,-38000
20200212,048812,上証2X凱基96購01,,,,,0.00,0.00,0,0,0,0,0,0,0,0,0,0,0,0,0
20200212,048813,元黃金凱基94購01,0.29,0.30,0.29,0.29,-0.01,-3.33,505000,3,146500,0,0,0,0,0,0,0,505000,-505000,-505000
20200212,048814,上銀凱基94購01,2.43,2.46,0.03,0.03,-2.27,-98.7,65000,3,135300,0,0,0,0,0,0,55000,10000,45000,45000
20200212,048815,川湖凱基94購01,,,,,0.00,0.00,0,0,0,0,0,0,0,0,0,0,0,0,0
20200212,048816,光寶科凱基94購01,,,,,0.00,0.00,0,0,0,0,0,0,0,0,0,0,0,0,0
20200212,048817,光寶科凱基94購02,,,,,0.00,0.00,0,0,0,0,0,0,0,0,0,0,0,0,0
20200212,048818,台達電凱基94購01,,,,,0.00,0.00,0,0,0,0,0,0,0,0,0,0,0,0,0
20200212,048819,國巨凱基94購01,,,,,0.00,0.00,0,0,0,0,0,0,0,0,0,0,0,0,0
20200212,04881P,高股息凱基96售01,,,,,0.00,0.00,0,0,0,0,0,0,0,0,0,0,0,0,0
20200212,048820,台積電凱基94購06,4.95,4.95,4.95,4.95,0.00,0.00,1000,1,4950,0,0,0,0,0,0,1000,0,1000,1000
20200212,048821,光磊凱基95購01,0.70,0.70,0.64,0.67,-0.02,-2.9,189000,19,129600,0,0,0,0,0,0,109000,80000,29000,29000
20200212,048822,燿華凱基94購03,,,,,0.00,0.00,0,0,0,0,0,0,0,0,0,0,0,0,0
20200212,048823,漢唐凱基94購01,0.92,0.92,0.92,0.92,0.00,0.00,4000,1,3680,0,0,0,0,0,0,4000,0,4000,4000
20200212,048824,聯發科凱基94購03,0.92,1.13,0.92,1.13,+0.36,46.75,137000,24,133640,0,0,0,0,0,0,117000,20000,97000,97000
20200212,048825,華新科凱基94購05,4.89,4.89,4.71,4.77,+0.12,2.58,24000,10,114900,0,0,0,0,0,0,18000,7000,11000,11000
20200212,048826,宏達電凱基94購01,,,,,0.00,0.00,0,0,0,0,0,0,0,0,0,0,0,0,0
20200212,048827,大立光凱基94購01,,,,,0.00,0.00,0,0,0,0,0,0,0,0,0,0,0,0,0
20200212,048828,禾伸堂凱基94購02,0.76,0.79,0.73,0.78,0.00,0.00,275000,27,208250,0,0,0,0,0,0,200000,79000,121000,121000
20200212,048829,欣興凱基94購02,0.89,1.10,0.89,1.10,+0.32,41.03,298000,18,318430,0,0,0,0,0,0,35000,298000,-263000,-263000
20200212,04882P,鴻海凱基94售19,,,,,0.00,0.00,0,0,0,0,0,0,0,0,0,0,0,0,0
20200212,048830,和鑫凱基94購03,,,,,0.00,0.00,0,0,0,0,0,0,0,0,0,0,0,0,0
20200212,048831,玉晶光凱基95購01,,,,,0.00,0.00,0,0,0,0,0,0,0,0,0,0,0,0,0
20200212,048832,玉晶光凱基95購02,4.12,4.18,4.12,4.18,+0.39,10.29,12000,2,49560,0,0,0,0,0,0,0,12000,-12000,-12000
20200212,048833,揚明光凱基94購02,,,,,0.00,0.00,0,0,0,0,0,0,0,0,0,0,0,0,0
20200212,048834,牧德凱基94購01,3.52,3.54,3.27,3.27,-0.16,-4.66,23000,4,81070,0,0,0,0,0,0,23000,0,23000,23000
20200212,048835,牧德凱基94購02,3.91,3.91,3.91,3.91,+0.13,3.44,7000,3,27370,0,0,0,0,0,0,7000,0,7000,7000
20200212,048836,牧德凱基94購03,3.36,3.45,1.24,3.16,-0.15,-4.53,69000,10,212000,0,0,0,0,0,0,40000,29000,11000,11000
20200212,048837,牧德凱基94購04,4.45,4.46,0.21,4.28,-0.06,-1.38,57000,8,209530,0,0,0,0,0,0,47000,10000,37000,37000
20200212,048838,牧德凱基94購07,4.17,4.17,4.17,4.17,+0.10,2.46,4000,2,16680,0,0,0,0,0,0,4000,0,4000,4000
20200212,048839,牧德凱基95購01,4.19,4.19,4.19,4.19,+0.12,2.95,19000,2,79610,0,0,0,0,0,0,19000,0,19000,19000
20200212,04883P,台積電凱基94售35,,,,,0.00,0.00,0,0,0,0,0,0,0,0,0,0,0,0,0
20200212,048840,上海銀凱基94購02,0.06,0.06,0.06,0.06,0.00,0.00,300000,1,18000,0,0,0,0,0,0,300000,0,300000,300000
20200212,048841,聯茂凱基94購06,0.61,0.61,0.61,0.61,0.00,0.00,10000,3,6100,0,0,0,0,0,0,0,10000,-10000,-10000
20200212,048842,矽格凱基94購01,1.23,1.30,1.23,1.30,+0.15,13.04,236000,9,304960,0,0,0,0,0,0,10000,226000,-216000,-216000
20200212,048843,台郡凱基94購01,3.14,3.24,2.99,3.16,+1.33,72.68,60000,18,189350,0,0,0,0,0,0,48000,13000,35000,35000
20200212,048844,訊芯凱基94購02,2.22,2.65,2.22,2.54,+0.43,20.38,42000,6,108200,0,0,0,0,0,0,1000,41000,-40000,-40000
20200212,048845,GIS凱基94購02,,,,,0.00,0.00,0,0,0,0,0,0,0,0,0,0,0,0,0
20200212,048846,緯穎凱基94購01,,,,,0.00,0.00,0,0,0,0,0,0,0,0,0,0,0,0,0
20200212,048847,A50群益98購01,0.68,0.70,0.68,0.70,+0.02,2.94,402000,8,276480,0,0,0,0,0,0,231000,171000,60000,60000
20200212,048848,滬深2X群益98購02,1.29,1.29,1.27,1.29,0.00,0.00,289000,6,372590,0,0,0,0,0,0,209000,80000,129000,129000
20200212,048849,光寶科群益94購01,0.40,0.40,0.40,0.40,0.00,0.00,22000,2,8800,0,0,0,0,0,0,0,22000,-22000,-22000
20200212,04884P,聯發科凱基94售20,0.11,0.11,0.10,0.10,-0.05,-33.33,40000,2,4200,0,0,0,0,0,0,0,40000,-40000,-40000
20200212,048850,聯電群益96購01,1.89,2.05,1.89,1.96,0.00,0.00,89000,15,172230,0,0,0,0,0,0,35000,54000,-19000,-19000
20200212,048851,台達電群益94購01,0.80,0.91,0.80,0.91,+0.04,4.6,95000,7,80700,0,0,0,0,0,0,36000,59000,-23000,-23000
20200212,048852,旺宏群益96購02,,,,,0.00,0.00,0,0,0,0,0,0,0,0,0,0,0,0,0
20200212,048853,凌陽群益94購01,,,,,0.00,0.00,0,0,0,0,0,0,0,0,0,0,0,0,0
20200212,048854,凌陽群益94購02,,,,,0.00,0.00,0,0,0,0,0,0,0,0,0,0,0,0,0
20200212,048855,華新科群益94購02,3.49,3.63,3.31,3.47,+0.13,3.89,185000,28,643180,0,0,0,0,0,0,131000,89000,42000,42000
20200212,048856,高鐵群益94購01,0.82,0.87,0.82,0.86,+0.02,2.38,21000,4,17630,0,0,0,0,0,0,19000,10000,9000,9000
20200212,048857,晶豪科群益94購01,0.84,0.84,0.82,0.82,0.00,0.00,112000,5,92120,0,0,0,0,0,0,0,112000,-112000,-112000
20200212,048858,大立光群益94購03,0.58,0.58,0.58,0.58,0.00,0.00,98000,1,56840,0,0,0,0,0,0,0,98000,-98000,-98000
20200212,048859,玉晶光群益96購02,2.29,2.29,2.29,2.29,+0.06,2.69,6000,2,13740,0,0,0,0,0,0,6000,0,6000,6000
20200212,04885P,大立光凱基94售19,0.22,0.22,0.21,0.21,-0.07,-25.0,15000,2,3200,0,0,0,0,0,0,10000,5000,5000,5000
20200212,048860,玉晶光群益96購03,3.59,3.88,3.54,3.82,+0.41,12.02,77000,15,287600,0,0,0,0,0,0,22000,50000,-28000,-28000
20200212,048861,牧德群益94購01,1.10,1.12,1.01,1.01,-0.08,-7.34,46000,7,50010,0,0,0,0,0,0,16000,30000,-14000,-14000
20200212,048862,中磊群益94購01,,,,,0.00,0.00,0,0,0,0,0,0,0,0,0,0,0,0,0
20200212,048863,超眾群益94購01,0.25,0.29,0.24,0.29,+0.03,11.54,91000,20,23030,0,0,0,0,0,0,80000,11000,69000,69000
20200212,048864,昇陽半群益94購01,0.75,0.82,0.75,0.76,0.00,0.00,44000,6,34620,0,0,0,0,0,0,44000,32000,12000,12000
20200212,048865,世紀鋼群益94購01,0.26,0.26,0.26,0.26,-0.05,-16.13,34000,4,8840,0,0,0,0,0,0,34000,0,34000,34000
20200212,048866,滬深2X兆豐95購01,,,,,0.00,0.00,0,0,0,0,0,0,0,0,0,0,0,0,0
20200212,048867,台積電兆豐95購01,5.45,5.75,5.40,5.75,+0.60,11.65,42000,5,229500,0,0,0,0,0,0,20000,22000,-2000,-2000
20200212,048868,劍麟國票94購01,,,,,0.00,0.00,0,0,0,0,0,0,0,0,0,0,0,0,0
20200212,048869,光罩國票94購01,0.97,1.07,0.97,1.05,+0.18,20.69,187000,21,190260,0,0,0,0,0,0,30000,157000,-127000,-127000
20200212,04886P,臺股指凱基94售20,0.46,0.47,0.46,0.47,-0.05,-9.62,324000,6,149140,0,0,0,0,0,0,0,284000,-284000,-284000
20200212,048870,義隆國票96購01,1.16,1.17,1.12,1.14,+0.22,23.91,50000,4,57900,0,0,0,0,0,0,10000,40000,-30000,-30000
20200212,048871,晶豪科國票94購01,1.26,1.31,1.26,1.28,0.00,0.00,18000,3,23100,0,0,0,0,0,0,0,18000,-18000,-18000
20200212,048872,玉晶光國票94購02,2.55,3.05,2.55,2.96,+0.41,16.08,220000,21,628270,0,0,0,0,0,0,128000,105000,23000,23000
20200212,048873,玉晶光國票95購02,3.83,4.05,3.83,4.05,+0.41,11.26,24000,2,94340,0,0,0,0,0,0,13000,11000,2000,2000
20200212,048874,玉晶光國票96購01,4.75,5.20,4.75,5.20,+0.56,12.07,61000,7,302950,0,0,0,0,0,0,21000,40000,-19000,-19000
20200212,048875,晶相光國票94購01,0.95,1.01,0.95,1.01,+0.14,16.09,22000,4,21440,0,0,0,0,0,0,0,22000,-22000,-22000
20200212,048876,牧德國票95購02,6.25,6.45,6.10,6.45,+0.25,4.03,13000,6,80700,0,0,0,0,0,0,12000,1000,11000,11000
20200212,048877,茂林國票94購01,,,,,0.00,0.00,0,0,0,0,0,0,0,0,0,0,0,0,0
20200212,048878,康控國票95購02,0.66,0.78,0.66,0.76,+0.11,16.92,287000,18,209900,0,0,0,0,0,0,27000,260000,-233000,-233000
20200212,048879,瀚宇博國票95購01,,,,,0.00,0.00,0,0,0,0,0,0,0,0,0,0,0,0,0
20200212,04887P,臺股指凱基94售21,,,,,0.00,0.00,0,0,0,0,0,0,0,0,0,0,0,0,0
20200212,048880,昇陽半國票94購01,0.67,0.67,0.67,0.67,+0.12,21.82,60000,1,40200,0,0,0,0,0,0,0,60000,-60000,-60000
20200212,048881,美律統一94購02,0.20,0.27,0.20,0.27,+0.09,50.0,323000,19,79070,0,0,0,0,0,0,18000,305000,-287000,-287000
20200212,048882,智原統一96購01,0.35,0.35,0.35,0.35,0.00,0.00,12000,9,4200,0,0,0,0,0,0,12000,0,12000,12000
20200212,048883,玉晶光統一94購01,1.94,2.05,1.94,2.05,+0.25,13.89,49000,3,99500,0,0,0,0,0,0,49000,0,49000,49000
20200212,048884,川湖元富94購01,,,,,0.00,0.00,0,0,0,0,0,0,0,0,0,0,0,0,0
20200212,048885,中環元富94購01,,,,,0.00,0.00,0,0,0,0,0,0,0,0,0,0,0,0,0
20200212,048886,慧洋元富94購01,,,,,0.00,0.00,0,0,0,0,0,0,0,0,0,0,0,0,0
20200212,048887,牧德元富94購01,3.92,3.92,3.92,3.92,+0.03,0.77,20000,1,78400,0,0,0,0,0,0,20000,0,20000,20000
20200212,048888,牧德元富94購02,3.92,3.92,3.68,3.68,-0.15,-3.92,40000,3,153000,0,0,0,0,0,0,30000,10000,20000,20000
20200212,048889,牧德元富94購03,3.10,3.21,3.04,3.09,+0.07,2.32,89000,10,281590,0,0,0,0,0,0,76000,13000,63000,63000
20200212,04888P,臺股指凱基95售03,0.53,0.53,0.46,0.47,-0.08,-14.55,649000,28,315530,0,0,0,0,0,0,194000,445000,-251000,-251000
20200212,048890,傳奇元富97購01,,,,,0.00,0.00,0,0,0,0,0,0,0,0,0,0,0,0,0
20200212,048891,傳奇元富97購02,,,,,0.00,0.00,0,0,0,0,0,0,0,0,0,0,0,0,0
20200212,048892,台郡元富97購01,3.44,3.67,3.44,3.67,+1.26,52.28,25000,10,89400,0,0,0,0,0,0,24000,0,24000,24000
20200212,048893,南電元富94購01,0.37,0.51,0.37,0.51,+0.17,50.0,887000,39,394840,0,0,0,0,0,0,281000,606000,-325000,-325000
20200212,048894,光罩國泰94購01,0.86,0.99,0.84,0.94,+0.09,10.59,1187000,37,1099980,0,0,0,0,0,0,305000,882000,-577000,-577000
20200212,048895,光罩國泰95購01,0.98,1.10,0.97,1.06,+0.08,8.16,168000,20,172640,0,0,0,0,0,0,63000,105000,-42000,-42000
20200212,048896,凌陽國泰95購01,,,,,0.00,0.00,0,0,0,0,0,0,0,0,0,0,0,0,0
20200212,048897,日電貿國泰95購01,1.73,1.73,1.64,1.71,+0.15,9.62,190000,28,319730,0,0,0,0,0,0,185000,5000,180000,180000
20200212,048898,晶相光國泰96購01,1.05,1.16,1.05,1.06,+0.03,2.91,689000,29,739640,0,0,0,0,0,0,484000,203000,281000,281000
20200212,048899,茂林國泰95購01,,,,,0.00,0.00,0,0,0,0,0,0,0,0,0,0,0,0,0
20200212,04889P,華通元大94售03,0.58,0.58,0.49,0.49,-0.20,-28.99,55000,8,27890,0,0,0,0,0,0,0,50000,-50000,-50000
20200212,048900,精成科國泰95購01,,,,,0.00,0.00,0,0,0,0,0,0,0,0,0,0,0,0,0
20200212,048901,矽格國泰95購01,1.13,1.24,1.13,1.24,+0.13,11.71,64000,22,77570,0,0,0,0,0,0,14000,54000,-40000,-40000
20200212,048902,昇陽半國泰96購01,0.88,0.93,0.87,0.88,0.00,0.00,314000,34,281760,0,0,0,0,0,0,72000,274000,-202000,-202000
20200212,048903,華通富邦95購01,,,,,0.00,0.00,0,0,0,0,0,0,0,0,0,0,0,0,0
20200212,048904,鴻海富邦94購02,,,,,0.00,0.00,0,0,0,0,0,0,0,0,0,0,0,0,0
20200212,048905,旺宏富邦96購01,1.95,2.01,1.86,1.86,-0.07,-3.63,45000,8,86490,0,0,0,0,0,0,43000,25000,18000,18000
20200212,048906,強茂富邦95購01,0.20,0.20,0.20,0.20,+0.01,5.26,10000,2,2000,0,0,0,0,0,0,0,10000,-10000,-10000
20200212,048907,高鐵富邦94購01,,,,,0.00,0.00,0,0,0,0,0,0,0,0,0,0,0,0,0
20200212,048908,慧洋富邦95購01,,,,,0.00,0.00,0,0,0,0,0,0,0,0,0,0,0,0,0
20200212,048909,聯詠富邦94購01,4.81,5.00,4.81,5.00,+0.64,14.68,34000,4,167200,0,0,0,0,0,0,34000,0,34000,34000
20200212,04890P,台積電元大95售05,0.07,0.07,0.07,0.07,-0.02,-22.22,448000,9,31360,0,0,0,0,0,0,0,448000,-448000,-448000
20200212,048910,和鑫富邦98購01,0.54,0.57,0.54,0.56,+0.03,5.66,114000,30,62280,0,0,0,0,0,0,58000,56000,2000,2000
20200212,048911,玉晶光富邦96購01,1.28,1.30,1.28,1.30,+0.14,12.07,3000,2,3860,0,0,0,0,0,0,0,3000,-3000,-3000
20200212,048912,牧德富邦94購01,1.60,1.60,1.60,1.60,0.00,0.00,5000,1,8000,0,0,0,0,0,0,5000,0,5000,5000
20200212,048913,傳奇富邦94購01,,,,,0.00,0.00,0,0,0,0,0,0,0,0,0,0,0,0,0
20200212,048914,川湖台新94購01,0.75,0.75,0.75,0.75,-0.05,-6.25,10000,1,7500,0,0,0,0,0,0,10000,0,10000,10000
20200212,048915,國巨台新94購01,,,,,0.00,0.00,0,0,0,0,0,0,0,0,0,0,0,0,0
20200212,048916,華新科台新94購01,,,,,0.00,0.00,0,0,0,0,0,0,0,0,0,0,0,0,0
20200212,048917,和鑫台新94購01,0.14,0.14,0.14,0.14,0.00,0.00,40000,1,5600,0,0,0,0,0,0,40000,0,40000,40000
20200212,048918,上証2X永豐94購01,0.10,0.10,0.09,0.09,-0.01,-10.0,33000,3,3000,0,0,0,0,0,0,0,33000,-33000,-33000
20200212,048919,堤維西永豐94購01,,,,,0.00,0.00,0,0,0,0,0,0,0,0,0,0,0,0,0
20200212,04891P,友達元大94售01,0.10,0.10,0.10,0.10,+0.01,11.11,34000,1,3400,0,0,0,0,0,0,34000,0,34000,34000
20200212,048920,川湖永豐94購01,,,,,0.00,0.00,0,0,0,0,0,0,0,0,0,0,0,0,0
20200212,048921,劍麟永豐94購01,,,,,0.00,0.00,0,0,0,0,0,0,0,0,0,0,0,0,0
20200212,048922,光寶科永豐94購01,,,,,0.00,0.00,0,0,0,0,0,0,0,0,0,0,0,0,0
20200212,048923,國巨永豐94購02,6.65,6.65,5.95,6.40,+0.50,8.47,148000,28,931500,0,0,0,0,0,0,42000,98000,-56000,-56000
20200212,048924,光罩永豐94購01,0.29,0.29,0.29,0.29,+0.02,7.41,20000,2,5800,0,0,0,0,0,0,20000,0,20000,20000
20200212,048925,佳世達永豐94購01,,,,,0.00,0.00,0,0,0,0,0,0,0,0,0,0,0,0,0
20200212,048926,燿華永豐95購01,0.12,0.12,0.12,0.12,+0.02,20.0,5000,1,600,0,0,0,0,0,0,0,5000,-5000,-5000
20200212,048927,兆赫永豐94購01,,,,,0.00,0.00,0,0,0,0,0,0,0,0,0,0,0,0,0
20200212,048928,華新科永豐94購02,1.10,1.10,1.01,1.06,+0.02,1.92,540000,35,573770,0,0,0,0,0,0,503000,33000,470000,470000
20200212,048929,裕民永豐94購01,,,,,0.00,0.00,0,0,0,0,0,0,0,0,0,0,0,0,0
20200212,04892P,聯發科元大94售14,,,,,0.00,0.00,0,0,0,0,0,0,0,0,0,0,0,0,0
20200212,048930,慧洋永豐94購01,,,,,0.00,0.00,0,0,0,0,0,0,0,0,0,0,0,0,0
20200212,048931,晶華永豐94購01,,,,,0.00,0.00,0,0,0,0,0,0,0,0,0,0,0,0,0
20200212,048932,美食永豐94購01,,,,,0.00,0.00,0,0,0,0,0,0,0,0,0,0,0,0,0
20200212,048933,晶豪科永豐94購01,0.31,0.33,0.31,0.33,0.00,0.00,146000,5,46130,0,0,0,0,0,0,106000,40000,66000,66000
20200212,048934,日電貿永豐94購01,,,,,0.00,0.00,0,0,0,0,0,0,0,0,0,0,0,0,0
20200212,048935,玉晶光永豐94購04,1.34,1.51,1.34,1.51,+0.27,21.77,459000,10,645800,0,0,0,0,0,0,191000,268000,-77000,-77000
20200212,048936,玉晶光永豐94購05,1.19,1.34,1.19,1.34,+0.21,18.58,508000,17,635710,0,0,0,0,0,0,164000,344000,-180000,-180000
20200212,048937,玉晶光永豐95購01,1.63,1.78,1.63,1.77,+0.22,14.19,1238000,26,2101140,0,0,0,0,0,0,404000,836000,-432000,-432000
20200212,048938,玉晶光永豐95購02,1.77,1.84,1.77,1.84,+0.13,7.6,2000,2,3610,0,0,0,0,0,0,1000,2000,-1000,-1000
20200212,048939,華擎永豐94購01,2.74,2.74,2.74,2.74,+0.03,1.11,8000,1,21920,0,0,0,0,0,0,0,8000,-8000,-8000
20200212,04893P,創意元大94售03,0.89,0.91,0.89,0.89,+0.08,9.88,151000,4,136390,0,0,0,0,0,0,50000,151000,-101000,-101000
20200212,048940,晶相光永豐94購01,0.27,0.30,0.26,0.26,+0.01,4.0,260000,3,70130,0,0,0,0,0,0,0,260000,-260000,-260000
20200212,048941,牧德永豐94購02,1.57,1.67,1.54,1.57,0.00,0.00,88000,15,141150,0,0,0,0,0,0,59000,28000,31000,31000
20200212,048942,上緯控永豐94購01,0.40,0.40,0.40,0.40,0.00,0.00,68000,1,27200,0,0,0,0,0,0,0,68000,-68000,-68000
20200212,048943,智伸科永豐94購01,,,,,0.00,0.00,0,0,0,0,0,0,0,0,0,0,0,0,0
20200212,048944,茂林永豐94購01,4.99,5.05,4.99,4.99,+0.13,2.67,20000,6,100820,0,0,0,0,0,0,20000,0,20000,20000
20200212,048945,訊連永豐94購01,0.78,0.84,0.74,0.74,-0.04,-5.13,94000,9,73320,0,0,0,0,0,0,63000,31000,32000,32000
20200212,048946,崇越永豐94購01,0.61,0.67,0.61,0.67,+0.10,17.54,302000,11,187720,0,0,0,0,0,0,13000,279000,-266000,-266000
20200212,048947,凌華永豐94購01,,,,,0.00,0.00,0,0,0,0,0,0,0,0,0,0,0,0,0
20200212,048948,巨路永豐94購01,,,,,0.00,0.00,0,0,0,0,0,0,0,0,0,0,0,0,0
20200212,048949,昇陽半永豐94購01,,,,,0.00,0.00,0,0,0,0,0,0,0,0,0,0,0,0,0
20200212,04894P,世紀鋼元大94售02,1.00,1.00,1.00,1.00,0.00,0.00,20000,1,20000,0,0,0,0,0,0,0,20000,-20000,-20000
20200212,048950,達方永豐94購01,,,,,0.00,0.00,0,0,0,0,0,0,0,0,0,0,0,0,0
20200212,048951,宏全永豐94購01,0.29,0.31,0.29,0.31,-0.01,-3.12,268000,3,79720,0,0,0,0,0,0,168000,100000,68000,68000
20200212,048952,川湖康和94購01,0.71,0.71,0.71,0.71,-0.01,-1.39,70000,1,49700,0,0,0,0,0,0,70000,0,70000,70000
20200212,048953,佳世達康和94購01,,,,,0.00,0.00,0,0,0,0,0,0,0,0,0,0,0,0,0
20200212,048954,裕民康和94購01,,,,,0.00,0.00,0,0,0,0,0,0,0,0,0,0,0,0,0
20200212,048955,慧洋康和94購01,,,,,0.00,0.00,0,0,0,0,0,0,0,0,0,0,0,0,0
20200212,048956,美食康和94購01,,,,,0.00,0.00,0,0,0,0,0,0,0,0,0,0,0,0,0
20200212,048957,玉晶光康和94購01,,,,,0.00,0.00,0,0,0,0,0,0,0,0,0,0,0,0,0
20200212,048958,傳奇康和95購01,,,,,0.00,0.00,0,0,0,0,0,0,0,0,0,0,0,0,0
20200212,048959,凌華康和94購01,0.87,0.88,0.87,0.87,+0.02,2.35,85000,4,74720,0,0,0,0,0,0,8000,77000,-69000,-69000
20200212,048960,矽格康和94購01,0.44,0.47,0.44,0.47,0.00,0.00,9000,2,4140,0,0,0,0,0,0,3000,6000,-3000,-3000
20200212,048961,矽創康和94購01,0.30,0.31,0.29,0.31,0.00,0.00,31000,6,9230,0,0,0,0,0,0,0,31000,-31000,-31000
20200212,048962,宏全康和94購01,0.80,0.83,0.78,0.83,-0.01,-1.19,155000,4,126080,0,0,0,0,0,0,85000,70000,15000,15000
20200212,048963,川湖元大94購01,2.09,2.09,2.09,2.09,0.00,0.00,10000,1,20900,0,0,0,0,0,0,10000,0,10000,10000
20200212,048964,劍麟元大94購01,0.22,0.22,0.22,0.22,+0.02,10.0,2000,1,440,0,0,0,0,0,0,2000,0,2000,2000
20200212,048965,佳世達元大94購01,0.70,0.70,0.70,0.70,-0.01,-1.41,9000,1,6300,0,0,0,0,0,0,9000,9000,0,0
20200212,048966,佳世達元大95購01,,,,,0.00,0.00,0,0,0,0,0,0,0,0,0,0,0,0,0
20200212,048967,凌陽元大95購01,,,,,0.00,0.00,0,0,0,0,0,0,0,0,0,0,0,0,0
20200212,048968,可成元大94購02,0.40,0.46,0.40,0.46,0.00,0.00,61000,3,26960,0,0,0,0,0,0,41000,20000,21000,21000
20200212,048969,兆赫元大94購01,,,,,0.00,0.00,0,0,0,0,0,0,0,0,0,0,0,0,0
20200212,04896P,上証2X中信95售01,1.45,1.45,1.45,1.45,-0.11,-7.05,8000,1,11600,0,0,0,0,0,0,0,8000,-8000,-8000
20200212,048970,裕民元大94購01,0.82,0.82,0.82,0.82,0.00,0.00,68000,1,55760,0,0,0,0,0,0,0,68000,-68000,-68000
20200212,048971,美食元大94購01,0.16,0.16,0.16,0.16,0.00,0.00,1000,1,160,0,0,0,0,0,0,1000,0,1000,1000
20200212,048972,晶豪科元大94購01,2.80,2.89,2.80,2.89,0.00,0.00,57000,7,161930,0,0,0,0,0,0,30000,57000,-27000,-27000
20200212,048973,禾伸堂元大94購01,1.58,1.67,1.49,1.67,+0.15,9.87,29000,11,45200,0,0,0,0,0,0,25000,4000,21000,21000
20200212,048974,日電貿元大94購01,2.59,2.59,2.44,2.50,+0.18,7.76,103000,13,256720,0,0,0,0,0,0,94000,19000,75000,75000
20200212,048975,玉晶光元大94購03,4.83,5.00,4.83,4.96,+0.66,15.35,27000,4,132480,0,0,0,0,0,0,10000,17000,-7000,-7000
20200212,048976,華擎元大94購01,,,,,0.00,0.00,0,0,0,0,0,0,0,0,0,0,0,0,0
20200212,048977,晶相光元大94購01,0.91,0.97,0.91,0.94,+0.06,6.82,106000,3,97810,0,0,0,0,0,0,106000,0,106000,106000
20200212,048978,晶相光元大94購02,1.23,1.30,1.23,1.23,+0.04,3.36,203000,9,257170,0,0,0,0,0,0,83000,135000,-52000,-52000
20200212,048979,晶相光元大94購03,1.52,1.67,1.48,1.55,+0.09,6.16,231000,25,353910,0,0,0,0,0,0,153000,84000,69000,69000
20200212,04897P,喬山中信94售01,,,,,0.00,0.00,0,0,0,0,0,0,0,0,0,0,0,0,0
20200212,048980,嘉澤元大94購02,2.88,2.88,2.49,2.49,-0.03,-1.19,31000,4,86990,0,0,0,0,0,0,23000,31000,-8000,-8000
20200212,048981,牧德元大94購01,4.59,4.59,4.59,4.59,0.00,0.00,1000,1,4590,0,0,0,0,0,0,1000,0,1000,1000
20200212,048982,牧德元大94購02,5.10,5.30,5.10,5.25,+0.10,1.94,23000,4,120800,0,0,0,0,0,0,3000,20000,-17000,-17000
20200212,048983,牧德元大95購01,4.99,5.10,4.99,5.05,0.00,0.00,32000,6,162000,0,0,0,0,0,0,22000,10000,12000,12000
20200212,048984,上緯控元大94購01,0.32,0.32,0.32,0.32,0.00,0.00,68000,1,21760,0,0,0,0,0,0,0,68000,-68000,-68000
20200212,048985,茂林元大94購01,9.15,9.15,9.00,9.00,+0.25,2.86,23000,5,207600,0,0,0,0,0,0,4000,19000,-15000,-15000
20200212,048986,訊連元大94購01,4.05,4.05,3.84,3.84,-0.33,-7.91,4000,3,15990,0,0,0,0,0,0,3000,1000,2000,2000
20200212,048987,崇越元大94購01,4.75,4.75,4.75,4.75,0.00,0.00,10000,1,47500,0,0,0,0,0,0,0,10000,-10000,-10000
20200212,048988,聯茂元大94購02,0.46,0.68,0.46,0.68,+0.40,142.86,431000,12,287920,0,0,0,0,0,0,0,411000,-411000,-411000
20200212,048989,矽格元大94購02,2.56,2.76,2.56,2.76,+0.37,15.48,38000,8,100970,0,0,0,0,0,0,15000,28000,-13000,-13000
20200212,04898P,瑞儀中信95售01,1.08,1.11,1.07,1.07,-0.02,-1.83,434000,56,471320,0,0,0,0,0,0,164000,270000,-106000,-106000
20200212,048990,台表科元大94購01,4.51,4.90,4.44,4.90,+0.48,10.86,83000,15,388550,0,0,0,0,0,0,42000,61000,-19000,-19000
20200212,048991,昇陽半元大94購01,0.60,0.64,0.60,0.64,+0.04,6.67,55000,4,33430,0,0,0,0,0,0,55000,12000,43000,43000
20200212,048992,昇陽半元大94購02,0.95,1.01,0.94,1.00,+0.07,7.53,188000,17,184350,0,0,0,0,0,0,165000,36000,129000,129000
20200212,048993,昇陽半元大94購03,0.37,0.37,0.37,0.37,0.00,0.00,4000,1,1480,0,0,0,0,0,0,4000,0,4000,4000
20200212,048994,南電元大94購03,0.67,0.67,0.65,0.65,+0.16,32.65,70000,2,45540,0,0,0,0,0,0,70000,2000,68000,68000
20200212,048995,宏全元大94購01,3.30,3.37,3.20,3.37,-0.07,-2.03,24000,7,79240,0,0,0,0,0,0,12000,12000,0,0
20200212,048996,中環第一94購01,0.10,0.10,0.10,0.10,-0.01,-9.09,20000,1,2000,0,0,0,0,0,0,0,20000,-20000,-20000
20200212,048997,智原國票95購01,,,,,0.00,0.00,0,0,0,0,0,0,0,0,0,0,0,0,0
20200212,048998,玉晶光國票95購03,3.81,4.33,3.74,4.25,+0.61,16.76,189000,21,764650,0,0,0,0,0,0,148000,169000,-21000,-21000
20200212,048999,康普國票95購01,,,,,0.00,0.00,0,0,0,0,0,0,0,0,0,0,0,0,0
20200212,04899P,力成中信94售02,,,,,0.00,0.00,0,0,0,0,0,0,0,0,0,0,0,0,0
20200212,049000,元油2X中信95購02,0.29,0.30,0.29,0.30,0.00,0.00,205000,3,59500,0,0,0,0,0,0,200000,5000,195000,195000
20200212,049001,川湖中信94購01,,,,,0.00,0.00,0,0,0,0,0,0,0,0,0,0,0,0,0
20200212,049002,光寶科中信94購01,,,,,0.00,0.00,0,0,0,0,0,0,0,0,0,0,0,0,0
20200212,049003,智邦中信95購01,0.66,0.76,0.66,0.76,+0.16,26.67,20000,9,14390,0,0,0,0,0,0,19000,0,19000,19000
20200212,049004,聯發科中信96購01,1.00,1.11,1.00,1.10,+0.18,19.57,407000,19,440000,0,0,0,0,0,0,398000,9000,389000,389000
20200212,049005,可成中信95購01,0.37,0.37,0.37,0.37,0.00,0.00,50000,1,18500,0,0,0,0,0,0,50000,0,50000,50000
20200212,049006,和鑫中信94購01,0.04,0.05,0.04,0.04,0.00,0.00,56000,7,2340,0,0,0,0,0,0,0,56000,-56000,-56000
20200212,049007,玉晶光中信96購01,1.16,1.21,1.13,1.20,+0.11,10.09,507000,19,601140,0,0,0,0,0,0,32000,469000,-437000,-437000
20200212,049008,傳奇中信95購01,,,,,0.00,0.00,0,0,0,0,0,0,0,0,0,0,0,0,0
20200212,049009,南亞科麥證94購01,0.64,0.64,0.64,0.64,-0.04,-5.88,10000,1,6400,10000,0,10000,0,0,0,10000,0,10000,10000
20200212,04900P,矽格中信94售02,,,,,0.00,0.00,0,0,0,0,0,0,0,0,0,0,0,0,0
20200212,049010,台表科麥證95購01,,,,,0.00,0.00,0,0,0,0,0,0,0,0,0,0,0,0,0
20200212,049011,元油2X群益94購01,,,,,0.00,0.00,0,0,0,0,0,0,0,0,0,0,0,0,0
20200212,049012,大成鋼群益94購01,,,,,0.00,0.00,0,0,0,0,0,0,0,0,0,0,0,0,0
20200212,049013,川湖群益94購01,0.48,0.48,0.48,0.48,0.00,0.00,11000,2,5280,0,0,0,0,0,0,11000,0,11000,11000
20200212,049014,台達電群益94購02,1.11,1.12,1.08,1.12,+0.05,4.67,52000,7,57260,0,0,0,0,0,0,32000,32000,0,0
20200212,049015,鴻海群益94購03,,,,,0.00,0.00,0,0,0,0,0,0,0,0,0,0,0,0,0
20200212,049016,國巨群益94購02,25.70,27.30,25.60,27.30,+3.60,15.19,15000,9,387000,0,0,0,0,0,0,14000,14000,0,0
20200212,049017,旺宏群益96購03,3.76,3.91,3.68,3.68,-0.08,-2.13,62000,10,232780,0,0,0,0,0,0,16000,46000,-30000,-30000
20200212,049018,光罩群益94購01,0.68,0.81,0.67,0.75,+0.07,10.29,336000,21,242880,0,0,0,0,0,0,116000,220000,-104000,-104000
20200212,049019,美律群益94購02,0.81,1.00,0.81,0.99,+0.26,35.62,470000,50,432540,0,0,0,0,0,0,80000,395000,-315000,-315000
20200212,04901P,臺股指麥證94售02,,,,,0.00,0.00,0,0,0,0,0,0,0,0,0,0,0,0,0
20200212,049020,可成群益94購02,0.57,0.59,0.57,0.59,0.00,0.00,8000,3,4580,0,0,0,0,0,0,0,8000,-8000,-8000
20200212,049021,慧洋群益94購01,,,,,0.00,0.00,0,0,0,0,0,0,0,0,0,0,0,0,0
20200212,049022,聯詠群益94購01,2.26,2.42,2.15,2.35,+0.30,14.63,413000,15,950130,0,0,0,0,0,0,330000,83000,247000,247000
20200212,049023,玉晶光群益96購04,1.01,1.10,1.00,1.07,+0.12,12.63,427000,22,447580,0,0,0,0,0,0,276000,135000,141000,141000
20200212,049024,玉晶光群益97購01,4.28,4.62,4.26,4.54,+0.48,11.82,87000,13,382650,0,0,0,0,0,0,11000,76000,-65000,-65000
20200212,049025,華擎群益94購01,2.56,2.56,2.34,2.34,-0.04,-1.68,23000,2,58220,0,0,0,0,0,0,23000,0,23000,23000
20200212,049026,晶相光群益94購01,0.62,0.69,0.62,0.67,+0.07,11.67,94000,8,62270,0,0,0,0,0,0,1000,93000,-92000,-92000
20200212,049027,智易群益94購02,,,,,0.00,0.00,0,0,0,0,0,0,0,0,0,0,0,0,0
20200212,049028,麗豐群益94購01,0.60,0.63,0.59,0.63,+0.07,12.5,250000,10,148940,0,0,0,0,0,0,247000,3000,244000,244000
20200212,049029,茂林群益94購01,,,,,0.00,0.00,0,0,0,0,0,0,0,0,0,0,0,0,0
20200212,04902P,國巨台新94售04,,,,,0.00,0.00,0,0,0,0,0,0,0,0,0,0,0,0,0
20200212,049030,凌華群益94購01,1.37,1.41,1.37,1.41,+0.04,2.92,83000,8,114860,0,0,0,0,0,0,62000,21000,41000,41000
20200212,049031,矽格群益94購01,1.25,1.31,1.25,1.31,+0.18,15.93,79000,8,100330,0,0,0,0,0,0,11000,68000,-57000,-57000
20200212,049032,百和群益94購04,,,,,0.00,0.00,0,0,0,0,0,0,0,0,0,0,0,0,0
20200212,049033,大成鋼兆豐94購01,,,,,0.00,0.00,0,0,0,0,0,0,0,0,0,0,0,0,0
20200212,049034,台達電兆豐94購01,0.70,0.76,0.69,0.76,+0.10,15.15,40000,4,28900,0,0,0,0,0,0,10000,30000,-20000,-20000
20200212,049035,中環兆豐94購01,,,,,0.00,0.00,0,0,0,0,0,0,0,0,0,0,0,0,0
20200212,049036,燿華兆豐95購01,0.27,0.27,0.27,0.27,+0.02,8.0,7000,1,1890,0,0,0,0,0,0,7000,0,7000,7000
20200212,049037,可成兆豐94購01,0.20,0.20,0.20,0.20,0.00,0.00,100000,1,20000,0,0,0,0,0,0,0,100000,-100000,-100000
20200212,049038,高鐵兆豐94購01,0.54,0.54,0.51,0.51,-0.02,-3.77,172000,4,91290,0,0,0,0,0,0,127000,45000,82000,82000
20200212,049039,富邦金兆豐94購01,0.48,0.48,0.48,0.48,+0.10,26.32,141000,2,67680,0,0,0,0,0,0,0,141000,-141000,-141000
20200212,04903P,全新永豐94售05,,,,,0.00,0.00,0,0,0,0,0,0,0,0,0,0,0,0,0
20200212,049040,亞光兆豐95購01,1.06,1.18,1.06,1.16,+0.16,16.0,324000,14,362630,0,0,0,0,0,0,1000,323000,-322000,-322000
20200212,049041,和鑫兆豐94購01,,,,,0.00,0.00,0,0,0,0,0,0,0,0,0,0,0,0,0
20200212,049042,玉晶光兆豐95購01,1.32,1.41,1.29,1.39,+0.24,20.87,456000,14,619790,0,0,0,0,0,0,97000,359000,-262000,-262000
20200212,049043,新唐兆豐94購01,,,,,0.00,0.00,0,0,0,0,0,0,0,0,0,0,0,0,0
20200212,049044,和碩兆豐94購01,,,,,0.00,0.00,0,0,0,0,0,0,0,0,0,0,0,0,0
20200212,049045,上海銀兆豐94購01,,,,,0.00,0.00,0,0,0,0,0,0,0,0,0,0,0,0,0
20200212,049046,同欣電兆豐94購01,1.00,1.15,1.00,1.10,+0.10,10.0,277000,41,290680,0,0,0,0,0,0,192000,40000,152000,152000
20200212,049047,台達電台新94購01,0.81,0.90,0.81,0.90,+0.09,11.11,188000,2,160740,0,0,0,0,0,0,94000,94000,0,0
20200212,049048,玉晶光台新94購01,1.34,1.47,1.34,1.47,+0.21,16.67,165000,4,228290,0,0,0,0,0,0,38000,127000,-89000,-89000
20200212,049049,玉晶光康和94購02,1.49,1.68,1.49,1.68,+0.28,20.0,165000,6,251730,0,0,0,0,0,0,129000,36000,93000,93000
20200212,04904P,奇力新永豐94售05,,,,,0.00,0.00,0,0,0,0,0,0,0,0,0,0,0,0,0
20200212,049050,崇越康和94購01,0.68,0.76,0.68,0.75,+0.07,10.29,278000,23,203300,0,0,0,0,0,0,50000,228000,-178000,-178000
20200212,049051,滬深2X永豐94購05,,,,,0.00,0.00,0,0,0,0,0,0,0,0,0,0,0,0,0
20200212,049052,台積電永豐94購02,2.20,2.33,2.20,2.33,+0.26,12.56,56000,2,130350,0,0,0,0,0,0,1000,55000,-54000,-54000
20200212,049053,可成永豐94購01,0.06,0.07,0.04,0.04,-0.01,-20.0,331000,4,13610,0,0,0,0,0,0,315000,16000,299000,299000
20200212,049054,禾伸堂永豐94購01,0.37,0.37,0.34,0.37,-0.01,-2.63,318000,18,111380,0,0,0,0,0,0,82000,236000,-154000,-154000
20200212,049055,聯詠永豐94購01,0.51,0.56,0.50,0.55,+0.10,22.22,230000,8,122190,0,0,0,0,0,0,162000,68000,94000,94000
20200212,049056,玉晶光永豐95購03,0.85,0.95,0.85,0.95,+0.14,17.28,337000,10,302220,0,0,0,0,0,0,172000,165000,7000,7000
20200212,049057,元翎永豐94購01,,,,,0.00,0.00,0,0,0,0,0,0,0,0,0,0,0,0,0
20200212,049058,茂林永豐94購02,4.75,4.75,4.58,4.58,0.00,0.00,110000,8,517540,0,0,0,0,0,0,110000,0,110000,110000
20200212,049059,超眾永豐94購01,0.44,0.50,0.44,0.50,-0.03,-5.66,423000,23,206400,0,0,0,0,0,0,423000,0,423000,423000
20200212,04905P,國巨國票94售04,,,,,0.00,0.00,0,0,0,0,0,0,0,0,0,0,0,0,0
20200212,049060,易華電永豐94購02,,,,,0.00,0.00,0,0,0,0,0,0,0,0,0,0,0,0,0
20200212,049061,元油2X日盛94購01,,,,,0.00,0.00,0,0,0,0,0,0,0,0,0,0,0,0,0
20200212,049062,華新科日盛94購01,4.30,4.42,4.26,4.26,+0.14,3.4,63000,10,274020,0,0,0,0,0,0,59000,4000,55000,55000
20200212,049063,緯穎日盛94購01,,,,,0.00,0.00,0,0,0,0,0,0,0,0,0,0,0,0,0
20200212,049064,T50反1凱基96購03,,,,,0.00,0.00,0,0,0,0,0,0,0,0,0,0,0,0,0
20200212,049065,T50反1凱基96購04,,,,,0.00,0.00,0,0,0,0,0,0,0,0,0,0,0,0,0
20200212,049066,元石油凱基97購01,0.17,0.18,0.17,0.18,0.00,0.00,130000,6,22500,0,0,0,0,0,0,0,130000,-130000,-130000
20200212,049067,元油2X凱基94購02,0.27,0.35,0.27,0.35,+0.10,40.0,110000,3,37700,0,0,0,0,0,0,0,10000,-10000,-10000
20200212,049068,元油2X凱基95購03,,,,,0.00,0.00,0,0,0,0,0,0,0,0,0,0,0,0,0
20200212,049069,元油2X凱基95購04,,,,,0.00,0.00,0,0,0,0,0,0,0,0,0,0,0,0,0
20200212,04906P,欣興國票95售01,,,,,0.00,0.00,0,0,0,0,0,0,0,0,0,0,0,0,0
20200212,049070,力山凱基94購02,,,,,0.00,0.00,0,0,0,0,0,0,0,0,0,0,0,0,0
20200212,049071,台達電凱基94購02,0.69,0.69,0.69,0.69,0.00,0.00,10000,1,6900,0,0,0,0,0,0,0,10000,-10000,-10000
20200212,049072,台積電凱基94購08,3.99,4.12,3.99,4.12,+0.32,8.42,3000,2,12100,0,0,0,0,0,0,3000,0,3000,3000
20200212,049073,光罩凱基94購01,,,,,0.00,0.00,0,0,0,0,0,0,0,0,0,0,0,0,0
20200212,049074,光罩凱基94購02,0.69,0.77,0.68,0.77,+0.11,16.67,67000,11,47780,0,0,0,0,0,0,27000,40000,-13000,-13000
20200212,049075,光磊凱基94購01,0.28,0.28,0.28,0.28,-0.02,-6.67,47000,2,13160,0,0,0,0,0,0,0,47000,-47000,-47000
20200212,049076,佳世達凱基94購01,,,,,0.00,0.00,0,0,0,0,0,0,0,0,0,0,0,0,0
20200212,049077,佳世達凱基94購02,,,,,0.00,0.00,0,0,0,0,0,0,0,0,0,0,0,0,0
20200212,049078,瑞昱凱基94購02,0.77,0.88,0.77,0.81,+0.04,5.19,212000,12,180020,0,0,0,0,0,0,180000,32000,148000,148000
20200212,049079,聯發科凱基94購04,0.48,0.53,0.48,0.51,+0.11,27.5,143000,26,71950,0,0,0,0,0,0,143000,0,143000,143000
20200212,04907P,超眾國票95售01,1.23,1.27,1.18,1.18,-0.17,-12.59,25000,3,30860,0,0,0,0,0,0,0,25000,-25000,-25000
20200212,049080,可成凱基94購03,,,,,0.00,0.00,0,0,0,0,0,0,0,0,0,0,0,0,0
20200212,049081,兆赫凱基94購01,,,,,0.00,0.00,0,0,0,0,0,0,0,0,0,0,0,0,0
20200212,049082,晶豪科凱基94購01,0.75,0.81,0.75,0.81,+0.10,14.08,50000,4,39600,0,0,0,0,0,0,50000,0,50000,50000
20200212,049083,大立光凱基94購02,0.59,0.59,0.59,0.59,+0.14,31.11,2000,1,1180,0,0,0,0,0,0,2000,0,2000,2000
20200212,049084,欣興凱基94購03,0.65,0.70,0.65,0.70,+0.24,52.17,84000,5,57960,0,0,0,0,0,0,0,84000,-84000,-84000
20200212,049085,揚明光凱基94購03,,,,,0.00,0.00,0,0,0,0,0,0,0,0,0,0,0,0,0
20200212,049086,晶相光凱基94購01,0.88,0.88,0.86,0.86,+0.06,7.5,60000,2,52600,0,0,0,0,0,0,0,60000,-60000,-60000
20200212,049087,晶相光凱基94購02,,,,,0.00,0.00,0,0,0,0,0,0,0,0,0,0,0,0,0
20200212,049088,上緯控凱基94購02,,,,,0.00,0.00,0,0,0,0,0,0,0,0,0,0,0,0,0
20200212,049089,正文凱基94購02,,,,,0.00,0.00,0,0,0,0,0,0,0,0,0,0,0,0,0
20200212,04908P,南電國票95售03,,,,,0.00,0.00,0,0,0,0,0,0,0,0,0,0,0,0,0
20200212,049090,茂林凱基94購01,,,,,0.00,0.00,0,0,0,0,0,0,0,0,0,0,0,0,0
20200212,049091,訊連凱基94購01,2.42,2.66,2.16,2.16,-0.45,-17.24,27000,5,59340,0,0,0,0,0,0,26000,1000,25000,25000
20200212,049092,聯茂凱基94購07,0.22,0.28,0.22,0.24,0.00,0.00,380000,8,93900,0,0,0,0,0,0,0,380000,-380000,-380000
20200212,049093,昇陽半凱基94購01,0.71,0.71,0.71,0.71,0.00,0.00,11000,1,7810,0,0,0,0,0,0,11000,11000,0,0
20200212,049094,昇陽半凱基94購02,,,,,0.00,0.00,0,0,0,0,0,0,0,0,0,0,0,0,0
20200212,049095,昇陽半凱基94購03,,,,,0.00,0.00,0,0,0,0,0,0,0,0,0,0,0,0,0
20200212,049096,南茂凱基94購01,,,,,0.00,0.00,0,0,0,0,0,0,0,0,0,0,0,0,0
20200212,049097,國巨國泰95購03,,,,,0.00,0.00,0,0,0,0,0,0,0,0,0,0,0,0,0
20200212,049098,國巨國泰96購01,,,,,0.00,0.00,0,0,0,0,0,0,0,0,0,0,0,0,0
20200212,049099,華新科國泰95購02,,,,,0.00,0.00,0,0,0,0,0,0,0,0,0,0,0,0,0
20200212,04909P,鴻海統一94售10,,,,,0.00,0.00,0,0,0,0,0,0,0,0,0,0,0,0,0
20200212,049100,華新科國泰96購01,,,,,0.00,0.00,0,0,0,0,0,0,0,0,0,0,0,0,0
20200212,049101,聯詠國泰95購01,,,,,0.00,0.00,0,0,0,0,0,0,0,0,0,0,0,0,0
20200212,049102,智伸科國泰96購01,0.79,0.79,0.79,0.79,0.00,0.00,44000,1,34760,0,0,0,0,0,0,0,44000,-44000,-44000
20200212,049103,易華電國泰96購01,,,,,0.00,0.00,0,0,0,0,0,0,0,0,0,0,0,0,0
20200212,049104,元油2X富邦97購02,0.58,0.58,0.58,0.58,0.00,0.00,402000,2,233160,0,0,0,0,0,0,0,402000,-402000,-402000
20200212,049105,亞泥富邦94購01,,,,,0.00,0.00,0,0,0,0,0,0,0,0,0,0,0,0,0
20200212,049106,大立光富邦94購01,,,,,0.00,0.00,0,0,0,0,0,0,0,0,0,0,0,0,0
20200212,049107,緯創富邦94購01,3.05,3.05,3.05,3.05,0.00,0.00,1000,1,3050,0,0,0,0,0,0,1000,0,1000,1000
20200212,049108,玉晶光富邦96購02,0.88,0.89,0.80,0.85,+0.08,10.39,230000,16,191710,0,0,0,0,0,0,59000,168000,-109000,-109000
20200212,049109,嘉澤富邦95購01,,,,,0.00,0.00,0,0,0,0,0,0,0,0,0,0,0,0,0
20200212,04910P,台積電統一94售12,,,,,0.00,0.00,0,0,0,0,0,0,0,0,0,0,0,0,0
20200212,049110,臻鼎富邦94購01,2.48,2.58,1.89,1.89,0.00,0.00,6000,6,14540,0,0,0,0,0,0,1000,5000,-4000,-4000
20200212,049111,元油2X統一94購03,0.18,0.19,0.18,0.19,+0.02,11.76,140000,3,26500,0,0,0,0,0,0,130000,10000,120000,120000
20200212,049112,可成統一94購01,0.12,0.12,0.12,0.12,0.00,0.00,57000,2,6840,0,0,0,0,0,0,57000,0,57000,57000
20200212,049113,大立光統一94購06,0.94,1.12,0.94,1.10,+0.19,20.88,226000,6,239500,0,0,0,0,0,0,16000,210000,-194000,-194000
20200212,049114,玉晶光統一94購02,0.82,0.89,0.76,0.85,+0.12,16.44,3362000,92,2755400,0,0,0,0,0,0,1216000,2245000,-1029000,-1029000
20200212,049115,創意統一94購03,0.41,0.44,0.37,0.41,-0.09,-18.0,402000,23,160340,0,0,0,0,0,0,257000,121000,136000,136000
20200212,049116,瑞儀統一94購01,,,,,0.00,0.00,0,0,0,0,0,0,0,0,0,0,0,0,0
20200212,049117,矽格統一96購01,1.32,1.38,1.30,1.38,+0.12,9.52,135000,25,181020,0,0,0,0,0,0,76000,59000,17000,17000
20200212,049118,元油2X元富94購03,1.86,2.00,1.86,2.00,+0.20,11.11,100000,14,192920,0,0,0,0,0,0,41000,49000,-8000,-8000
20200212,049119,元油2X元富94購04,1.18,1.29,1.18,1.29,+0.13,11.21,166000,14,205880,0,0,0,0,0,0,44000,122000,-78000,-78000
20200212,04911P,美律元富94售02,,,,,0.00,0.00,0,0,0,0,0,0,0,0,0,0,0,0,0
20200212,049120,元油2X元富94購05,0.82,0.86,0.82,0.86,+0.04,4.88,130000,4,109200,0,0,0,0,0,0,70000,60000,10000,10000
20200212,049121,元油2X元富94購06,,,,,0.00,0.00,0,0,0,0,0,0,0,0,0,0,0,0,0
20200212,049122,元油2X元富94購07,0.05,0.05,0.05,0.05,+0.01,25.0,249000,4,12450,0,0,0,0,0,0,0,249000,-249000,-249000
20200212,049123,可成元富94購01,0.63,0.78,0.63,0.78,+0.23,41.82,26000,4,18260,0,0,0,0,0,0,10000,16000,-6000,-6000
20200212,049124,可成元富94購02,0.73,0.73,0.70,0.70,0.00,0.00,36000,2,25380,0,0,0,0,0,0,30000,6000,24000,24000
20200212,049125,禾伸堂元富94購01,0.35,0.38,0.32,0.38,+0.01,2.7,572000,23,195690,0,0,0,0,0,0,308000,264000,44000,44000
20200212,049126,玉晶光元富94購02,3.64,4.04,3.64,3.92,+0.40,11.36,153000,34,586760,0,0,0,0,0,0,67000,81000,-14000,-14000
20200212,049127,上海銀元富94購01,0.34,0.34,0.34,0.34,0.00,0.00,10000,1,3400,0,0,0,0,0,0,10000,10000,0,0
20200212,049128,滬深2X元大97購03,0.49,0.49,0.49,0.49,-0.01,-2.0,20000,1,9800,0,0,0,0,0,0,20000,0,20000,20000
20200212,049129,S&P反1元大97購01,,,,,0.00,0.00,0,0,0,0,0,0,0,0,0,0,0,0,0
20200212,04912P,可成元富94售06,,,,,0.00,0.00,0,0,0,0,0,0,0,0,0,0,0,0,0
20200212,049130,臺指反元大98購01,0.23,0.23,0.23,0.23,-0.02,-8.0,20000,2,4600,0,0,0,0,0,0,0,20000,-20000,-20000
20200212,049131,元油2X元大94購02,,,,,0.00,0.00,0,0,0,0,0,0,0,0,0,0,0,0,0
20200212,049132,大成鋼元大94購01,0.33,0.36,0.33,0.36,+0.02,5.88,11000,2,3660,0,0,0,0,0,0,11000,0,11000,11000
20200212,049133,為升元大94購02,,,,,0.00,0.00,0,0,0,0,0,0,0,0,0,0,0,0,0
20200212,049134,為升元大95購01,0.64,0.65,0.62,0.65,+0.03,4.84,302000,8,192300,0,0,0,0,0,0,202000,134000,68000,68000
20200212,049135,台達電元大94購03,1.58,1.63,1.58,1.63,-0.04,-2.4,67000,3,106360,0,0,0,0,0,0,0,67000,-67000,-67000
20200212,049136,華通元大95購01,1.55,2.16,1.48,2.16,+0.64,42.11,748000,64,1371720,0,0,0,0,0,0,579000,288000,291000,291000
20200212,049137,華通元大95購02,1.75,2.28,1.68,2.28,+0.56,32.56,460000,33,886070,0,0,0,0,0,0,430000,63000,367000,367000
20200212,049138,台積電元大94購05,5.95,6.20,5.85,6.20,+0.75,13.76,178000,23,1061750,0,0,0,0,0,0,149000,156000,-7000,-7000
20200212,049139,台積電元大94購06,6.80,7.30,6.80,7.20,+0.55,8.27,220000,49,1521500,0,0,0,0,0,0,220000,217000,3000,3000
20200212,04913P,聯詠元富94售02,0.87,0.91,0.87,0.89,-0.20,-18.35,42000,5,37400,0,0,0,0,0,0,0,42000,-42000,-42000
20200212,049140,台積電元大94購07,6.40,6.70,6.40,6.70,+0.60,9.84,40000,21,258400,0,0,0,0,0,0,40000,37000,3000,3000
20200212,049141,旺宏元大95購01,2.67,2.67,2.67,2.67,0.00,0.00,4000,1,10680,0,0,0,0,0,0,4000,0,4000,4000
20200212,049142,智邦元大94購01,2.07,2.15,1.90,1.94,+0.14,7.78,107000,7,211620,0,0,0,0,0,0,21000,86000,-65000,-65000
20200212,049143,智邦元大94購02,2.20,2.34,1.92,1.92,-0.03,-1.54,121000,17,265060,0,0,0,0,0,0,90000,39000,51000,51000
20200212,049144,瑞昱元大94購03,1.41,1.74,1.39,1.74,+0.34,24.29,243000,17,376790,0,0,0,0,0,0,148000,95000,53000,53000
20200212,049145,南亞科元大94購01,1.82,1.82,1.76,1.81,-0.07,-3.72,183000,15,329810,0,0,0,0,0,0,116000,73000,43000,43000
20200212,049146,南亞科元大94購02,1.31,1.31,1.26,1.29,-0.07,-5.15,195000,10,254220,0,0,0,0,0,0,194000,14000,180000,180000
20200212,049147,美律元大94購02,,,,,0.00,0.00,0,0,0,0,0,0,0,0,0,0,0,0,0
20200212,049148,全新元大95購01,0.60,0.76,0.57,0.72,+0.19,35.85,307000,23,202840,0,0,0,0,0,0,213000,94000,119000,119000
20200212,049149,華新科元大95購03,3.20,3.20,3.04,3.12,+0.07,2.3,131000,25,408420,0,0,0,0,0,0,111000,76000,35000,35000
20200212,04914P,國巨國泰95售06,,,,,0.00,0.00,0,0,0,0,0,0,0,0,0,0,0,0,0
20200212,049150,新光金元大96購01,1.06,1.06,1.05,1.06,0.00,0.00,66000,9,69630,0,0,0,0,0,0,43000,22000,21000,21000
20200212,049151,大立光元大94購07,0.65,0.76,0.65,0.76,0.00,0.00,103000,3,67200,0,0,0,0,0,0,0,103000,-103000,-103000
20200212,049152,大立光元大95購06,0.69,0.76,0.69,0.76,+0.09,13.43,103000,10,75930,0,0,0,0,0,0,96000,7000,89000,89000
20200212,049153,大立光元大96購02,0.59,0.66,0.59,0.66,+0.07,11.86,225000,13,144020,0,0,0,0,0,0,186000,40000,146000,146000
20200212,049154,玉晶光元大95購02,2.24,2.41,2.20,2.38,+0.31,14.98,199000,20,452810,0,0,0,0,0,0,97000,102000,-5000,-5000
20200212,049155,同欣電元大94購01,2.63,2.63,2.31,2.31,0.00,0.00,32000,5,79960,0,0,0,0,0,0,0,32000,-32000,-32000
20200212,049156,緯穎元大96購01,5.55,5.75,5.55,5.75,+0.25,4.55,11000,2,63050,0,0,0,0,0,0,1000,11000,-10000,-10000
20200212,049157,矽創元大95購01,0.98,1.26,0.98,1.26,+0.30,31.25,102000,9,106980,0,0,0,0,0,0,81000,20000,61000,61000
20200212,049158,元油2X中信94購03,,,,,0.00,0.00,0,0,0,0,0,0,0,0,0,0,0,0,0
20200212,049159,同欣電中信96購01,1.43,1.62,1.40,1.60,+0.14,9.59,859000,56,1285070,0,0,0,0,0,0,421000,391000,30000,30000
20200212,04915P,鴻海永昌96售02,1.31,1.31,1.14,1.14,-0.26,-18.57,257000,11,312750,0,0,0,0,0,0,222000,255000,-33000,-33000
20200212,049160,鴻海第一95購01,,,,,0.00,0.00,0,0,0,0,0,0,0,0,0,0,0,0,0
20200212,049161,聯發科亞東94購01,,,,,0.00,0.00,0,0,0,0,0,0,0,0,0,0,0,0,0
20200212,049162,聯詠亞東94購01,,,,,0.00,0.00,0,0,0,0,0,0,0,0,0,0,0,0,0
20200212,049163,欣興亞東94購01,,,,,0.00,0.00,0,0,0,0,0,0,0,0,0,0,0,0,0
20200212,049164,滬深2X日盛94購01,,,,,0.00,0.00,0,0,0,0,0,0,0,0,0,0,0,0,0
20200212,049165,元油2X凱基97購01,,,,,0.00,0.00,0,0,0,0,0,0,0,0,0,0,0,0,0
20200212,049166,元油2X凱基97購02,0.51,0.51,0.51,0.51,+0.02,4.08,3000,1,1530,0,0,0,0,0,0,0,3000,-3000,-3000
20200212,049167,元油2X凱基97購03,0.39,0.41,0.39,0.41,+0.03,7.89,103000,11,41330,0,0,0,0,0,0,0,87000,-87000,-87000
20200212,049168,卜蜂凱基94購01,,,,,0.00,0.00,0,0,0,0,0,0,0,0,0,0,0,0,0
20200212,049169,統一凱基94購01,,,,,0.00,0.00,0,0,0,0,0,0,0,0,0,0,0,0,0
20200212,04916P,大立光永昌96售02,2.00,2.00,2.00,2.00,0.00,0.00,5000,1,10000,0,0,0,0,0,0,0,5000,-5000,-5000
20200212,049170,亞德客凱基94購01,4.94,5.50,0.52,5.50,-0.10,-1.79,103000,19,483350,0,0,0,0,0,0,93000,26000,67000,67000
20200212,049171,台達電凱基94購03,,,,,0.00,0.00,0,0,0,0,0,0,0,0,0,0,0,0,0
20200212,049172,鴻海凱基94購14,5.80,7.15,5.80,7.00,+1.50,27.27,110000,11,727500,0,0,0,0,0,0,90000,70000,20000,20000
20200212,049173,鴻海凱基94購15,3.06,3.59,3.06,3.54,+0.91,34.6,133000,14,443180,0,0,0,0,0,0,73000,110000,-37000,-37000
20200212,049174,台積電凱基94購11,,,,,0.00,0.00,0,0,0,0,0,0,0,0,0,0,0,0,0
20200212,049175,台積電凱基94購12,4.22,4.49,4.22,4.49,+0.49,12.25,5000,5,21770,0,0,0,0,0,0,5000,0,5000,5000
20200212,049176,漢唐凱基94購02,,,,,0.00,0.00,0,0,0,0,0,0,0,0,0,0,0,0,0
20200212,049177,美律凱基94購02,0.44,0.53,0.44,0.53,+0.15,39.47,77000,22,36620,0,0,0,0,0,0,45000,32000,13000,13000
20200212,049178,宏達電凱基94購02,,,,,0.00,0.00,0,0,0,0,0,0,0,0,0,0,0,0,0
20200212,049179,高鐵凱基94購01,,,,,0.00,0.00,0,0,0,0,0,0,0,0,0,0,0,0,0
20200212,04917P,台積電凱基94售37,,,,,0.00,0.00,0,0,0,0,0,0,0,0,0,0,0,0,0
20200212,049180,TPK凱基94購02,,,,,0.00,0.00,0,0,0,0,0,0,0,0,0,0,0,0,0
20200212,049181,正文凱基94購03,,,,,0.00,0.00,0,0,0,0,0,0,0,0,0,0,0,0,0
20200212,049182,新唐凱基94購01,,,,,0.00,0.00,0,0,0,0,0,0,0,0,0,0,0,0,0
20200212,049183,鎧勝凱基94購01,,,,,0.00,0.00,0,0,0,0,0,0,0,0,0,0,0,0,0
20200212,049184,啟碁凱基94購01,,,,,0.00,0.00,0,0,0,0,0,0,0,0,0,0,0,0,0
20200212,049185,南電凱基94購03,0.18,0.28,0.18,0.22,+0.06,37.5,1382000,9,309970,0,0,0,0,0,0,1297000,70000,1227000,1227000
20200212,049186,寶成凱基94購01,,,,,0.00,0.00,0,0,0,0,0,0,0,0,0,0,0,0,0
20200212,049187,義隆台新94購01,1.13,1.17,1.08,1.15,+0.23,25.0,297000,30,334950,0,0,0,0,0,0,0,297000,-297000,-297000
20200212,049188,可成台新94購01,0.49,0.52,0.49,0.52,+0.12,30.0,162000,4,81180,0,0,0,0,0,0,0,162000,-162000,-162000
20200212,049189,訊芯康和94購01,0.73,0.85,0.73,0.85,+0.13,18.06,172000,18,138550,0,0,0,0,0,0,44000,88000,-44000,-44000
20200212,04918P,華新科凱基94售12,,,,,0.00,0.00,0,0,0,0,0,0,0,0,0,0,0,0,0
20200212,049190,元油2X永豐94購04,0.10,0.11,0.10,0.11,0.00,0.00,1018000,3,102000,0,0,0,0,0,0,998000,20000,978000,978000
20200212,049191,元油2X永豐95購01,,,,,0.00,0.00,0,0,0,0,0,0,0,0,0,0,0,0,0
20200212,049192,元油2X永豐96購02,,,,,0.00,0.00,0,0,0,0,0,0,0,0,0,0,0,0,0
20200212,049193,元油2X永豐97購01,,,,,0.00,0.00,0,0,0,0,0,0,0,0,0,0,0,0,0
20200212,049194,卜蜂永豐94購01,0.35,0.35,0.35,0.35,0.00,0.00,44000,2,15400,0,0,0,0,0,0,0,44000,-44000,-44000
20200212,049195,全新永豐94購02,,,,,0.00,0.00,0,0,0,0,0,0,0,0,0,0,0,0,0
20200212,049196,奇力新永豐94購02,,,,,0.00,0.00,0,0,0,0,0,0,0,0,0,0,0,0,0
20200212,049197,信邦永豐94購01,0.32,0.35,0.32,0.34,-0.01,-2.86,275000,21,90990,0,0,0,0,0,0,205000,70000,135000,135000
20200212,049198,聯鈞永豐94購01,1.85,2.08,1.84,2.08,+0.40,23.81,297000,22,581260,0,0,0,0,0,0,110000,137000,-27000,-27000
20200212,049199,茂林永豐95購01,,,,,0.00,0.00,0,0,0,0,0,0,0,0,0,0,0,0,0
20200212,04919P,聯詠凱基94售05,0.66,0.66,0.66,0.66,-0.05,-7.04,10000,1,6600,0,0,0,0,0,0,0,10000,-10000,-10000
20200212,049200,元黃金群益98購01,,,,,0.00,0.00,0,0,0,0,0,0,0,0,0,0,0,0,0
20200212,049201,劍麟群益94購01,,,,,0.00,0.00,0,0,0,0,0,0,0,0,0,0,0,0,0
20200212,049202,國巨群益94購03,,,,,0.00,0.00,0,0,0,0,0,0,0,0,0,0,0,0,0
20200212,049203,智邦群益94購01,0.63,0.63,0.63,0.63,+0.15,31.25,32000,1,20160,0,0,0,0,0,0,32000,0,32000,32000
20200212,049204,京元電群益94購02,0.67,0.69,0.66,0.68,0.00,0.00,29000,15,19420,0,0,0,0,0,0,29000,0,29000,29000
20200212,049205,聯發科群益94購05,0.16,0.18,0.15,0.18,+0.01,5.88,1642000,14,258280,0,0,0,0,0,0,1622000,0,1622000,1622000
20200212,049206,大立光群益94購04,,,,,0.00,0.00,0,0,0,0,0,0,0,0,0,0,0,0,0
20200212,049207,茂林群益94購02,,,,,0.00,0.00,0,0,0,0,0,0,0,0,0,0,0,0,0
20200212,049208,台郡群益94購01,,,,,0.00,0.00,0,0,0,0,0,0,0,0,0,0,0,0,0
20200212,049209,GIS群益94購03,0.61,0.64,0.61,0.64,0.00,0.00,20000,6,12500,0,0,0,0,0,0,0,20000,-20000,-20000
20200212,04920P,智易凱基94售05,2.27,2.27,2.27,2.27,0.00,0.00,3000,1,6810,0,0,0,0,0,0,0,3000,-3000,-3000
20200212,049210,昇陽半群益94購02,0.62,0.67,0.62,0.67,+0.05,8.06,25000,4,16030,0,0,0,0,0,0,25000,12000,13000,13000
20200212,049211,昇陽半群益94購03,,,,,0.00,0.00,0,0,0,0,0,0,0,0,0,0,0,0,0
20200212,049212,T50反1國票94購04,0.34,0.34,0.30,0.30,-0.06,-16.67,782000,29,241140,0,0,0,0,0,0,0,712000,-712000,-712000
20200212,049213,滬深2X國票94購02,0.60,0.60,0.60,0.60,0.00,0.00,30000,1,18000,0,0,0,0,0,0,0,30000,-30000,-30000
20200212,049214,台達電國票95購01,1.07,1.16,1.02,1.16,+0.20,20.83,1571000,51,1815060,0,0,0,0,0,0,1561000,10000,1551000,1551000
20200212,049215,國巨國票94購03,,,,,0.00,0.00,0,0,0,0,0,0,0,0,0,0,0,0,0
20200212,049216,華邦電國票95購01,0.07,0.08,0.07,0.08,+0.01,14.29,401000,4,31270,0,0,0,0,0,0,401000,0,401000,401000
20200212,049217,智邦國票95購01,1.72,1.95,1.39,1.39,-0.35,-20.11,44000,4,64060,0,0,0,0,0,0,6000,38000,-32000,-32000
20200212,049218,燿華國票94購02,,,,,0.00,0.00,0,0,0,0,0,0,0,0,0,0,0,0,0
20200212,049219,聯發科國票95購01,0.51,0.67,0.51,0.64,+0.24,60.0,456000,16,272190,0,0,0,0,0,0,343000,113000,230000,230000
20200212,04921P,TPK凱基94售05,,,,,0.00,0.00,0,0,0,0,0,0,0,0,0,0,0,0,0
20200212,049220,聯發科國票95購02,1.30,1.43,1.25,1.38,+0.25,22.12,96000,16,129980,0,0,0,0,0,0,36000,60000,-24000,-24000
20200212,049221,健策國票95購02,,,,,0.00,0.00,0,0,0,0,0,0,0,0,0,0,0,0,0
20200212,049222,和碩國票94購01,,,,,0.00,0.00,0,0,0,0,0,0,0,0,0,0,0,0,0
20200212,049223,鎧勝國票95購01,,,,,0.00,0.00,0,0,0,0,0,0,0,0,0,0,0,0,0
20200212,049224,致新國票95購01,0.37,0.39,0.36,0.37,-0.03,-7.5,124000,6,46610,0,0,0,0,0,0,64000,60000,4000,4000
20200212,049225,達方國票94購01,0.60,0.63,0.60,0.63,+0.04,6.78,110000,2,66300,0,0,0,0,0,0,100000,10000,90000,90000
20200212,049226,元石油富邦95購01,0.54,0.56,0.54,0.56,+0.03,5.66,301000,8,164660,0,0,0,0,0,0,191000,110000,81000,81000
20200212,049227,元油2X富邦96購03,,,,,0.00,0.00,0,0,0,0,0,0,0,0,0,0,0,0,0
20200212,049228,台塑富邦94購01,1.97,2.03,1.97,2.01,+0.03,1.52,75000,6,150550,0,0,0,0,0,0,30000,45000,-15000,-15000
20200212,049229,台化富邦94購01,1.13,1.13,1.13,1.13,+0.04,3.67,10000,1,11300,0,0,0,0,0,0,10000,0,10000,10000
20200212,04922P,日月光凱基94售02,1.20,1.20,1.20,1.20,-0.21,-14.89,7000,1,8400,0,0,0,0,0,0,7000,0,7000,7000
20200212,049230,台達電富邦96購01,0.66,0.66,0.64,0.66,+0.02,3.12,50000,3,32800,0,0,0,0,0,0,30000,20000,10000,10000
20200212,049231,鴻海富邦95購02,4.75,5.80,4.75,5.80,+1.39,31.52,30000,5,150350,0,0,0,0,0,0,9000,21000,-12000,-12000
20200212,049232,元油2X統一94購04,0.12,0.12,0.12,0.12,0.00,0.00,50000,1,6000,0,0,0,0,0,0,0,50000,-50000,-50000
20200212,049233,聯發科統一94購04,3.13,3.50,3.07,3.50,+0.79,29.15,235000,16,769520,0,0,0,0,0,0,87000,148000,-61000,-61000
20200212,049234,可成統一94購02,0.29,0.30,0.29,0.30,0.00,0.00,120000,2,35400,0,0,0,0,0,0,0,120000,-120000,-120000
20200212,049235,元油2X元富96購05,3.28,3.35,3.27,3.35,0.00,0.00,192000,8,633780,0,0,0,0,0,0,0,192000,-192000,-192000
20200212,049236,元油2X元富96購06,0.93,1.02,0.93,1.02,+0.09,9.68,395000,19,386530,0,0,0,0,0,0,298000,87000,211000,211000
20200212,049237,元油2X元富96購07,0.69,0.75,0.69,0.75,+0.05,7.14,71000,5,50590,0,0,0,0,0,0,46000,20000,26000,26000
20200212,049238,元油2X元富96購08,0.51,0.51,0.51,0.51,+0.04,8.51,5000,1,2550,0,0,0,0,0,0,5000,0,5000,5000
20200212,049239,卜蜂元富94購01,,,,,0.00,0.00,0,0,0,0,0,0,0,0,0,0,0,0,0
20200212,04923P,GIS凱基94售06,,,,,0.00,0.00,0,0,0,0,0,0,0,0,0,0,0,0,0
20200212,049240,華通元富94購01,0.84,1.55,0.84,1.42,+0.60,73.17,719000,52,875190,0,0,0,0,0,0,162000,557000,-395000,-395000
20200212,049241,智邦元富94購01,1.79,1.79,1.26,1.26,-0.13,-9.35,307000,23,428990,0,0,0,0,0,0,224000,83000,141000,141000
20200212,049242,佳世達元富96購01,0.64,0.64,0.63,0.64,-0.01,-1.54,105000,5,66800,0,0,0,0,0,0,0,105000,-105000,-105000
20200212,049243,佳世達元富96購02,0.33,0.33,0.33,0.33,0.00,0.00,268000,2,88440,0,0,0,0,0,0,268000,0,268000,268000
20200212,049244,亞光元富94購01,1.29,1.39,1.29,1.35,0.00,0.00,292000,18,386670,0,0,0,0,0,0,0,292000,-292000,-292000
20200212,049245,和鑫元富95購01,0.33,0.35,0.33,0.35,+0.04,12.9,543000,20,184190,0,0,0,0,0,0,143000,400000,-257000,-257000
20200212,049246,大成鋼元大94購02,0.49,0.54,0.47,0.54,+0.03,5.88,21000,4,10380,0,0,0,0,0,0,21000,10000,11000,11000
20200212,049247,光寶科元大94購02,1.28,1.32,1.28,1.32,+0.04,3.12,21000,4,27640,0,0,0,0,0,0,0,21000,-21000,-21000
20200212,049248,台達電元大94購04,1.30,1.35,1.30,1.35,0.00,0.00,69000,3,90200,0,0,0,0,0,0,0,69000,-69000,-69000
20200212,049249,台達電元大94購05,2.46,2.59,2.46,2.59,+0.03,1.17,68000,4,169280,0,0,0,0,0,0,0,68000,-68000,-68000
20200212,04924P,元油2X元大94售12,,,,,0.00,0.00,0,0,0,0,0,0,0,0,0,0,0,0,0
20200212,049250,華通元大95購04,2.20,3.17,2.04,3.17,+1.05,49.53,366000,41,932280,0,0,0,0,0,0,299000,139000,160000,160000
20200212,049251,國巨元大95購02,,,,,0.00,0.00,0,0,0,0,0,0,0,0,0,0,0,0,0
20200212,049252,國巨元大96購01,,,,,0.00,0.00,0,0,0,0,0,0,0,0,0,0,0,0,0
20200212,049253,台積電元大94購08,,,,,0.00,0.00,0,0,0,0,0,0,0,0,0,0,0,0,0
20200212,049254,台積電元大96購02,5.35,5.35,5.35,5.35,0.00,0.00,1000,1,5350,0,0,0,0,0,0,1000,0,1000,1000
20200212,049255,旺宏元大97購02,4.10,4.23,3.95,3.95,-0.11,-2.71,27000,12,109570,0,0,0,0,0,0,25000,12000,13000,13000
20200212,049256,瑞昱元大94購04,1.61,1.94,1.58,1.82,+0.23,14.47,252000,20,439030,0,0,0,0,0,0,149000,129000,20000,20000
20200212,049257,南亞科元大94購03,2.11,2.11,2.09,2.09,+0.04,1.95,51000,3,107550,0,0,0,0,0,0,51000,3000,48000,48000
20200212,049258,美律元大94購03,0.28,0.28,0.28,0.28,+0.06,27.27,5000,1,1400,0,0,0,0,0,0,0,5000,-5000,-5000
20200212,049259,聯發科元大94購04,0.66,0.91,0.66,0.90,+0.30,50.0,694000,42,565580,0,0,0,0,0,0,399000,200000,199000,199000
20200212,04925P,和碩元大94售03,,,,,0.00,0.00,0,0,0,0,0,0,0,0,0,0,0,0,0
20200212,049260,華新科元大96購01,3.95,3.95,3.81,3.92,+0.26,7.1,43000,16,167500,0,0,0,0,0,0,33000,21000,12000,12000
20200212,049261,大立光元大94購08,1.19,1.26,1.19,1.26,0.00,0.00,244000,2,301140,0,0,0,0,0,0,154000,90000,64000,64000
20200212,049262,大立光元大94購09,1.43,1.51,1.43,1.51,+0.16,11.85,15000,2,21850,0,0,0,0,0,0,15000,0,15000,15000
20200212,049263,大立光元大94購10,,,,,0.00,0.00,0,0,0,0,0,0,0,0,0,0,0,0,0
20200212,049264,奇鋐元大95購01,0.30,0.31,0.30,0.31,0.00,0.00,203000,3,61900,0,0,0,0,0,0,0,203000,-203000,-203000
20200212,049265,揚明光元大94購03,0.39,0.39,0.39,0.39,+0.04,11.43,5000,1,1950,0,0,0,0,0,0,5000,0,5000,5000
20200212,049266,和碩元大94購01,4.43,4.43,4.43,4.43,+0.05,1.14,10000,1,44300,0,0,0,0,0,0,10000,0,10000,10000
20200212,049267,瀚宇博元大95購02,1.10,1.25,1.10,1.25,+0.11,9.65,227000,19,264060,0,0,0,0,0,0,100000,137000,-37000,-37000
20200212,049268,聯茂元大94購03,0.52,0.76,0.52,0.71,+0.27,61.36,409000,17,283030,0,0,0,0,0,0,37000,389000,-352000,-352000
20200212,049269,超眾元大96購02,0.80,0.88,0.80,0.88,+0.02,2.33,66000,7,56510,0,0,0,0,0,0,27000,64000,-37000,-37000
20200212,04926P,聯發科凱基95售03,,,,,0.00,0.00,0,0,0,0,0,0,0,0,0,0,0,0,0
20200212,049270,台表科元大95購02,2.62,2.87,2.62,2.87,+0.41,16.67,129000,16,364170,0,0,0,0,0,0,0,126000,-126000,-126000
20200212,049271,百和元大94購01,,,,,0.00,0.00,0,0,0,0,0,0,0,0,0,0,0,0,0
20200212,049272,世紀鋼元大96購02,0.59,0.59,0.59,0.59,0.00,0.00,5000,1,2950,0,0,0,0,0,0,5000,0,5000,5000
20200212,049273,臺股指元大94購08,3.70,3.76,3.70,3.76,+0.26,7.43,5000,3,18600,0,0,0,0,0,0,5000,0,5000,5000
20200212,049274,臺股指元大94購09,4.14,4.38,4.11,4.31,+0.38,9.67,18000,13,76890,0,0,0,0,0,0,5000,13000,-8000,-8000
20200212,049275,臺股指元大94購10,,,,,0.00,0.00,0,0,0,0,0,0,0,0,0,0,0,0,0
20200212,049276,臺股指元大94購11,,,,,0.00,0.00,0,0,0,0,0,0,0,0,0,0,0,0,0
20200212,049277,臺股指元大94購12,5.05,5.05,5.05,5.05,+1.05,26.25,1000,1,5050,0,0,0,0,0,0,1000,0,1000,1000
20200212,049278,南亞科亞東94購01,,,,,0.00,0.00,0,0,0,0,0,0,0,0,0,0,0,0,0
20200212,049279,元油2X國票94購02,0.11,0.13,0.11,0.13,+0.02,18.18,541000,4,59530,0,0,0,0,0,0,490000,1000,489000,489000
20200212,04927P,大立光凱基95售06,1.17,1.19,1.15,1.15,-0.16,-12.21,30000,3,35100,0,0,0,0,0,0,0,30000,-30000,-30000
20200212,049280,創意國票95購01,0.46,0.51,0.42,0.51,-0.10,-16.39,87000,7,39750,0,0,0,0,0,0,87000,0,87000,87000
20200212,049281,嘉聯益國票95購01,0.21,0.21,0.21,0.21,+0.06,40.0,30000,1,6300,0,0,0,0,0,0,0,30000,-30000,-30000
20200212,049282,易華電國票95購01,,,,,0.00,0.00,0,0,0,0,0,0,0,0,0,0,0,0,0
20200212,049283,滬深2X中信95購10,0.73,0.75,0.73,0.75,-0.01,-1.32,102000,3,74500,0,0,0,0,0,0,100000,2000,98000,98000
20200212,049284,瑞昱中信94購02,0.98,0.98,0.90,0.90,+0.04,4.65,60000,2,55840,0,0,0,0,0,0,0,60000,-60000,-60000
20200212,049285,宏碁兆豐94購01,0.38,0.40,0.38,0.39,+0.03,8.33,183000,7,71940,0,0,0,0,0,0,110000,73000,37000,37000
20200212,049286,美律兆豐94購01,0.21,0.25,0.21,0.24,0.00,0.00,310000,8,72150,0,0,0,0,0,0,100000,210000,-110000,-110000
20200212,049287,可成兆豐95購01,0.49,0.50,0.49,0.50,0.00,0.00,20000,3,9950,0,0,0,0,0,0,10000,10000,0,0
20200212,049288,聯茂兆豐95購02,0.23,0.25,0.23,0.25,0.00,0.00,85000,3,20850,0,0,0,0,0,0,25000,60000,-35000,-35000
20200212,049289,樺漢兆豐94購01,0.47,0.50,0.47,0.50,+0.06,13.64,274000,5,130810,0,0,0,0,0,0,221000,53000,168000,168000
20200212,04928P,大立光凱基95售07,,,,,0.00,0.00,0,0,0,0,0,0,0,0,0,0,0,0,0
20200212,049290,元油2X群益94購02,0.51,0.53,0.51,0.53,+0.05,10.42,199000,3,102490,0,0,0,0,0,0,0,199000,-199000,-199000
20200212,049291,華通群益94購04,2.03,2.27,2.01,2.27,+0.35,18.23,43000,6,87750,0,0,0,0,0,0,43000,1000,42000,42000
20200212,049292,鴻海群益94購04,,,,,0.00,0.00,0,0,0,0,0,0,0,0,0,0,0,0,0
20200212,049293,友訊群益95購01,1.44,1.49,1.41,1.42,-0.06,-4.05,140000,7,205000,0,0,0,0,0,0,95000,45000,50000,50000
20200212,049294,南亞科群益94購01,1.23,1.38,1.23,1.32,-0.14,-9.59,41000,6,54530,0,0,0,0,0,0,29000,19000,10000,10000
20200212,049295,全新群益94購02,,,,,0.00,0.00,0,0,0,0,0,0,0,0,0,0,0,0,0
20200212,049296,義隆群益96購01,0.45,0.49,0.44,0.44,0.00,0.00,310000,14,144450,0,0,0,0,0,0,190000,100000,90000,90000
20200212,049297,日電貿群益95購01,2.73,2.80,2.70,2.78,+0.03,1.09,177000,19,487710,0,0,0,0,0,0,167000,10000,157000,157000
20200212,049298,矽格群益95購01,2.65,2.77,2.65,2.77,+0.30,12.15,84000,13,226860,0,0,0,0,0,0,32000,55000,-23000,-23000
20200212,049299,矽創群益94購01,0.68,0.91,0.68,0.91,+0.22,31.88,422000,32,327120,0,0,0,0,0,0,173000,249000,-76000,-76000
20200212,04929P,同欣電凱基95售01,0.70,0.70,0.69,0.70,-0.05,-6.67,13000,4,9090,0,0,0,0,0,0,10000,3000,7000,7000
20200212,049300,南電群益94購01,0.34,0.38,0.34,0.38,0.00,0.00,98000,19,35430,0,0,0,0,0,0,0,98000,-98000,-98000
20200212,049301,致新群益95購01,0.28,0.29,0.27,0.29,-0.01,-3.33,109000,5,31550,0,0,0,0,0,0,109000,0,109000,109000
20200212,049302,聯茂日盛94購01,0.21,0.28,0.21,0.28,+0.15,115.38,361000,26,94170,0,0,0,0,0,0,0,361000,-361000,-361000
20200212,049303,S&P反1凱基94購02,,,,,0.00,0.00,0,0,0,0,0,0,0,0,0,0,0,0,0
20200212,049304,元油2X凱基95購05,0.51,0.51,0.51,0.51,+0.03,6.25,4000,1,2040,0,0,0,0,0,0,0,4000,-4000,-4000
20200212,049305,元油2X凱基95購06,,,,,0.00,0.00,0,0,0,0,0,0,0,0,0,0,0,0,0
20200212,049306,元油2X凱基96購01,0.63,0.66,0.63,0.66,+0.06,10.0,143000,8,92520,0,0,0,0,0,0,3000,137000,-134000,-134000
20200212,049307,上銀凱基94購03,1.94,1.94,0.06,1.84,0.00,0.00,160000,11,286500,0,0,0,0,0,0,80000,80000,0,0
20200212,049308,台達電凱基94購04,,,,,0.00,0.00,0,0,0,0,0,0,0,0,0,0,0,0,0
20200212,049309,台達電凱基94購05,0.58,0.59,0.58,0.59,-0.03,-4.84,121000,5,70710,0,0,0,0,0,0,121000,0,121000,121000
20200212,04930P,國巨統一94售08,0.14,0.14,0.12,0.12,-0.04,-25.0,374000,8,49780,0,0,0,0,0,0,4000,370000,-366000,-366000
20200212,049310,台積電凱基94購15,3.24,3.40,3.21,3.40,+0.42,14.09,32000,9,105260,0,0,0,0,0,0,10000,22000,-12000,-12000
20200212,049311,漢唐凱基94購03,2.09,2.09,2.09,2.09,+0.20,10.58,94000,2,196460,0,0,0,0,0,0,94000,0,94000,94000
20200212,049312,亞光凱基94購02,1.31,1.69,1.31,1.63,+0.31,23.48,125000,9,186070,0,0,0,0,0,0,96000,39000,57000,57000
20200212,049313,晶技凱基94購01,1.54,1.54,1.54,1.54,+0.08,5.48,25000,1,38500,0,0,0,0,0,0,25000,0,25000,25000
20200212,049314,京鼎凱基94購01,,,,,0.00,0.00,0,0,0,0,0,0,0,0,0,0,0,0,0
20200212,049315,上緯控凱基94購03,0.49,0.49,0.47,0.47,-0.03,-6.0,300000,2,142000,0,0,0,0,0,0,300000,0,300000,300000
20200212,049316,茂林凱基94購02,4.88,5.10,4.80,5.00,+0.22,4.6,63000,20,312170,0,0,0,0,0,0,51000,10000,41000,41000
20200212,049317,啟碁凱基94購02,,,,,0.00,0.00,0,0,0,0,0,0,0,0,0,0,0,0,0
20200212,049318,樺漢凱基94購01,1.11,1.15,1.11,1.15,+0.05,4.55,182000,11,208300,0,0,0,0,0,0,182000,0,182000,182000
20200212,049319,GIS凱基94購03,0.90,0.90,0.90,0.90,+0.03,3.45,15000,6,13500,0,0,0,0,0,0,15000,0,15000,15000
20200212,04931P,臻鼎元富94售09,1.30,1.52,1.19,1.52,-0.18,-10.59,74000,11,103640,0,0,0,0,0,0,8000,66000,-58000,-58000
20200212,049320,羅麗芬凱基94購01,,,,,0.00,0.00,0,0,0,0,0,0,0,0,0,0,0,0,0
20200212,049321,緯穎凱基94購02,14.70,14.70,14.70,14.70,+0.80,5.76,10000,1,147000,0,0,0,0,0,0,10000,0,10000,10000
20200212,049322,志超凱基94購02,,,,,0.00,0.00,0,0,0,0,0,0,0,0,0,0,0,0,0
20200212,049323,百和凱基94購01,,,,,0.00,0.00,0,0,0,0,0,0,0,0,0,0,0,0,0
20200212,049324,臺股指凱基94購06,1.54,1.80,1.54,1.80,+0.29,19.21,93000,7,144950,0,0,0,0,0,0,93000,0,93000,93000
20200212,049325,智邦元富94購02,0.78,0.88,0.64,0.70,+0.05,7.69,652000,28,483480,0,0,0,0,0,0,363000,301000,62000,62000
20200212,049326,聯發科元富94購01,,,,,0.00,0.00,0,0,0,0,0,0,0,0,0,0,0,0,0
20200212,049327,台郡元富94購01,1.17,1.28,1.17,1.28,+0.62,93.94,246000,34,306020,0,0,0,0,0,0,47000,60000,-13000,-13000
20200212,049328,元上證統一94購01,,,,,0.00,0.00,0,0,0,0,0,0,0,0,0,0,0,0,0
20200212,049329,元上證統一94購02,,,,,0.00,0.00,0,0,0,0,0,0,0,0,0,0,0,0,0
20200212,04932P,香港2X中信96售01,0.75,0.75,0.72,0.72,-0.05,-6.49,75000,5,55300,0,0,0,0,0,0,0,75000,-75000,-75000
20200212,049330,元上證統一94購03,,,,,0.00,0.00,0,0,0,0,0,0,0,0,0,0,0,0,0
20200212,049331,元石油統一94購01,0.53,0.53,0.52,0.52,0.00,0.00,330000,7,174700,0,0,0,0,0,0,320000,0,320000,320000
20200212,049332,深中小統一94購02,,,,,0.00,0.00,0,0,0,0,0,0,0,0,0,0,0,0,0
20200212,049333,深中小統一94購03,2.79,2.85,2.79,2.85,+0.09,3.26,30000,3,84300,0,0,0,0,0,0,10000,20000,-10000,-10000
20200212,049334,上銀統一94購01,4.27,4.27,4.27,4.27,+0.23,5.69,10000,1,42700,0,0,0,0,0,0,10000,0,10000,10000
20200212,049335,聯電統一97購01,3.19,3.34,3.19,3.34,+0.06,1.83,36000,7,117660,0,0,0,0,0,0,26000,10000,16000,16000
20200212,049336,台達電統一94購02,,,,,0.00,0.00,0,0,0,0,0,0,0,0,0,0,0,0,0
20200212,049337,台達電統一94購03,1.39,1.43,1.37,1.43,+0.02,1.42,70000,4,97700,0,0,0,0,0,0,40000,30000,10000,10000
20200212,049338,台達電統一94購04,1.88,1.97,1.84,1.97,+0.06,3.14,80000,5,150900,0,0,0,0,0,0,40000,40000,0,0
20200212,049339,鴻海統一94購02,,,,,0.00,0.00,0,0,0,0,0,0,0,0,0,0,0,0,0
20200212,04933P,中石化中信96售01,1.33,1.33,1.33,1.33,0.00,0.00,13000,1,17290,0,0,0,0,0,0,0,13000,-13000,-13000
20200212,049340,鴻海統一94購03,4.40,4.75,4.40,4.75,+0.62,15.01,63000,7,281750,0,0,0,0,0,0,33000,30000,3000,3000
20200212,049341,旺宏統一95購01,1.66,1.66,1.58,1.58,-0.06,-3.66,55000,4,91120,0,0,0,0,0,0,4000,53000,-49000,-49000
20200212,049342,聯發科統一94購05,0.94,1.15,0.93,1.11,+0.31,38.75,180000,26,186040,0,0,0,0,0,0,170000,10000,160000,160000
20200212,049343,華新科統一94購03,3.53,3.53,3.39,3.39,+0.10,3.04,106000,8,369130,0,0,0,0,0,0,93000,41000,52000,52000
20200212,049344,華固統一94購01,,,,,0.00,0.00,0,0,0,0,0,0,0,0,0,0,0,0,0
20200212,049345,富邦金統一94購02,2.08,2.09,2.08,2.09,+0.16,8.29,40000,3,83300,0,0,0,0,0,0,30000,10000,20000,20000
20200212,049346,新光金統一95購01,1.32,1.33,1.31,1.33,+0.03,2.31,359000,45,475150,0,0,0,0,0,0,200000,159000,41000,41000
20200212,049347,群創統一95購01,,,,,0.00,0.00,0,0,0,0,0,0,0,0,0,0,0,0,0
20200212,049348,瑞昱台新94購01,0.92,0.92,0.92,0.92,0.00,0.00,38000,1,34960,0,0,0,0,0,0,0,38000,-38000,-38000
20200212,049349,國巨康和94購01,,,,,0.00,0.00,0,0,0,0,0,0,0,0,0,0,0,0,0
20200212,04934P,鴻海中信94售05,0.45,0.45,0.45,0.45,0.00,0.00,20000,1,9000,0,0,0,0,0,0,0,20000,-20000,-20000
20200212,049350,麗豐康和94購01,,,,,0.00,0.00,0,0,0,0,0,0,0,0,0,0,0,0,0
20200212,049351,揚明光永豐94購01,0.36,0.36,0.36,0.36,0.00,0.00,100000,1,36000,0,0,0,0,0,0,0,100000,-100000,-100000
20200212,049352,泰鼎永豐95購01,2.05,2.16,2.02,2.02,+0.15,8.02,138000,21,289200,0,0,0,0,0,0,20000,118000,-98000,-98000
20200212,049353,茂林永豐94購03,,,,,0.00,0.00,0,0,0,0,0,0,0,0,0,0,0,0,0
20200212,049354,致新永豐94購01,,,,,0.00,0.00,0,0,0,0,0,0,0,0,0,0,0,0,0
20200212,049355,元油2X富邦96購04,0.58,0.62,0.58,0.62,+0.06,10.71,258000,4,156140,0,0,0,0,0,0,0,258000,-258000,-258000
20200212,049356,台積電富邦94購05,,,,,0.00,0.00,0,0,0,0,0,0,0,0,0,0,0,0,0
20200212,049357,微星富邦94購01,2.57,2.61,2.15,2.15,-0.05,-2.27,61000,8,145950,0,0,0,0,0,0,11000,50000,-39000,-39000
20200212,049358,可成富邦94購01,,,,,0.00,0.00,0,0,0,0,0,0,0,0,0,0,0,0,0
20200212,049359,台達電元大94購06,2.58,2.70,2.58,2.70,+0.03,1.12,69000,4,179820,0,0,0,0,0,0,0,69000,-69000,-69000
20200212,04935P,鴻海中信96售01,0.41,0.41,0.34,0.34,-0.10,-22.73,128000,10,48690,0,0,0,0,0,0,33000,95000,-62000,-62000
20200212,049360,台達電元大94購07,,,,,0.00,0.00,0,0,0,0,0,0,0,0,0,0,0,0,0
20200212,049361,華通元大94購02,1.09,1.50,1.08,1.50,+0.42,38.89,435000,23,521170,0,0,0,0,0,0,435000,55000,380000,380000
20200212,049362,國巨元大94購04,,,,,0.00,0.00,0,0,0,0,0,0,0,0,0,0,0,0,0
20200212,049363,旺宏元大94購07,1.30,1.34,1.23,1.26,-0.03,-2.33,120000,11,156300,0,0,0,0,0,0,17000,109000,-92000,-92000
20200212,049364,燿華元大94購02,0.14,0.16,0.14,0.16,0.00,0.00,580000,5,92600,0,0,0,0,0,0,430000,150000,280000,280000
20200212,049365,美律元大94購04,0.59,0.74,0.59,0.70,0.00,0.00,81000,12,56250,0,0,0,0,0,0,2000,81000,-79000,-79000
20200212,049366,聯發科元大94購05,0.64,0.76,0.64,0.76,+0.23,43.4,260000,10,183800,0,0,0,0,0,0,190000,70000,120000,120000
20200212,049367,全新元大96購01,0.69,0.83,0.67,0.83,+0.23,38.33,658000,17,500300,0,0,0,0,0,0,497000,161000,336000,336000
20200212,049368,奇力新元大94購02,,,,,0.00,0.00,0,0,0,0,0,0,0,0,0,0,0,0,0
20200212,049369,義隆元大95購01,0.52,0.52,0.50,0.50,+0.10,25.0,3000,2,1520,0,0,0,0,0,0,0,3000,-3000,-3000
20200212,04936P,大立光中信95售03,,,,,0.00,0.00,0,0,0,0,0,0,0,0,0,0,0,0,0
20200212,049370,可成元大94購03,0.81,1.01,0.81,1.01,+0.29,40.28,241000,16,232570,0,0,0,0,0,0,126000,241000,-115000,-115000
20200212,049371,可成元大94購04,,,,,0.00,0.00,0,0,0,0,0,0,0,0,0,0,0,0,0
20200212,049372,華新科元大95購04,1.94,2.00,1.88,1.94,+0.08,4.3,213000,28,409370,0,0,0,0,0,0,147000,82000,65000,65000
20200212,049373,大立光元大94購11,1.05,1.05,1.05,1.05,0.00,0.00,68000,1,71400,0,0,0,0,0,0,0,68000,-68000,-68000
20200212,049374,大立光元大94購12,1.76,1.82,1.76,1.82,+0.15,8.98,15000,2,27240,0,0,0,0,0,0,0,15000,-15000,-15000
20200212,049375,大立光元大94購13,1.25,1.30,1.25,1.30,+0.26,25.0,40000,2,51000,0,0,0,0,0,0,40000,0,40000,40000
20200212,049376,奇鋐元大94購02,,,,,0.00,0.00,0,0,0,0,0,0,0,0,0,0,0,0,0
20200212,049377,聯詠元大94購01,3.30,3.62,3.30,3.54,+0.45,14.56,83000,10,286980,0,0,0,0,0,0,63000,6000,57000,57000
20200212,049378,聯詠元大94購02,3.66,3.66,3.66,3.66,+0.33,9.91,10000,2,36600,0,0,0,0,0,0,10000,0,10000,10000
20200212,049379,智原元大95購01,0.16,0.19,0.16,0.19,+0.03,18.75,110000,2,20000,0,0,0,0,0,0,30000,80000,-50000,-50000
20200212,049380,欣興元大94購04,0.40,0.56,0.40,0.56,+0.20,55.56,488000,11,248540,0,0,0,0,0,0,38000,450000,-412000,-412000
20200212,049381,欣興元大94購05,0.43,0.66,0.41,0.65,+0.21,47.73,888000,36,463400,0,0,0,0,0,0,533000,340000,193000,193000
20200212,049382,牧德元大94購04,,,,,0.00,0.00,0,0,0,0,0,0,0,0,0,0,0,0,0
20200212,049383,健策元大95購01,,,,,0.00,0.00,0,0,0,0,0,0,0,0,0,0,0,0,0
20200212,049384,致伸元大94購02,0.12,0.13,0.12,0.13,+0.01,8.33,110000,2,13300,0,0,0,0,0,0,0,110000,-110000,-110000
20200212,049385,茂林元大94購03,5.95,6.25,5.95,6.10,+0.40,7.02,10000,5,61000,0,0,0,0,0,0,1000,9000,-8000,-8000
20200212,049386,嘉聯益元大95購01,0.34,0.36,0.33,0.34,+0.02,6.25,679000,17,239350,0,0,0,0,0,0,649000,30000,619000,619000
20200212,049387,緯穎元大94購03,10.50,11.40,10.20,11.40,+0.60,5.56,14000,5,147200,0,0,0,0,0,0,14000,14000,0,0
20200212,049388,南電元大94購05,0.28,0.28,0.28,0.28,0.00,0.00,1000,1,280,0,0,0,0,0,0,1000,0,1000,1000
20200212,049389,元石油中信97購02,0.64,0.68,0.64,0.67,+0.02,3.08,284000,15,187880,0,0,0,0,0,0,16000,256000,-240000,-240000
20200212,04938P,亞德客國票95售01,0.88,0.91,0.88,0.91,-0.02,-2.15,15000,2,13500,0,0,0,0,0,0,0,15000,-15000,-15000
20200212,049390,元油2X中信96購01,,,,,0.00,0.00,0,0,0,0,0,0,0,0,0,0,0,0,0
20200212,049391,廣宇中信94購01,,,,,0.00,0.00,0,0,0,0,0,0,0,0,0,0,0,0,0
20200212,049392,臺股指麥證94購01,,,,,0.00,0.00,0,0,0,0,0,0,0,0,0,0,0,0,0
20200212,049393,世紀鋼第一94購01,,,,,0.00,0.00,0,0,0,0,0,0,0,0,0,0,0,0,0
20200212,049394,T50反1群益94購01,,,,,0.00,0.00,0,0,0,0,0,0,0,0,0,0,0,0,0
20200212,049395,元油2X群益94購03,,,,,0.00,0.00,0,0,0,0,0,0,0,0,0,0,0,0,0
20200212,049396,元油2X群益97購03,0.64,0.69,0.64,0.69,+0.06,9.52,12000,3,8030,0,0,0,0,0,0,10000,2000,8000,8000
20200212,049397,台達電群益94購03,1.06,1.12,1.03,1.12,+0.13,13.13,36000,4,38320,0,0,0,0,0,0,10000,26000,-16000,-16000
20200212,049398,微星群益94購02,2.29,2.29,2.21,2.21,-0.04,-1.78,30000,3,67100,0,0,0,0,0,0,10000,30000,-20000,-20000
20200212,049399,台光電群益94購02,0.26,0.35,0.26,0.31,0.00,0.00,93000,18,31300,0,0,0,0,0,0,0,93000,-93000,-93000
20200212,04939P,國巨國票95售03,0.42,0.43,0.39,0.40,-0.07,-14.89,186000,6,75210,0,0,0,0,0,0,80000,106000,-26000,-26000
20200212,049400,可成群益94購03,,,,,0.00,0.00,0,0,0,0,0,0,0,0,0,0,0,0,0
20200212,049401,可成群益94購04,0.04,0.04,0.04,0.04,0.00,0.00,20000,1,800,0,0,0,0,0,0,20000,0,20000,20000
20200212,049402,奇鋐群益95購02,,,,,0.00,0.00,0,0,0,0,0,0,0,0,0,0,0,0,0
20200212,049403,欣興群益94購03,,,,,0.00,0.00,0,0,0,0,0,0,0,0,0,0,0,0,0
20200212,049404,訊芯群益94購02,0.56,0.66,0.56,0.62,+0.11,21.57,374000,7,227590,0,0,0,0,0,0,158000,216000,-58000,-58000
20200212,049405,羅麗芬群益94購02,,,,,0.00,0.00,0,0,0,0,0,0,0,0,0,0,0,0,0
20200212,049406,T50反1日盛97購01,0.15,0.16,0.15,0.15,-0.02,-11.76,205000,6,30760,0,0,0,0,0,0,0,205000,-205000,-205000
20200212,049407,台積電日盛94購02,2.23,2.29,2.23,2.29,+0.24,11.71,141000,2,321810,0,0,0,0,0,0,0,141000,-141000,-141000
20200212,049408,旺宏日盛94購01,1.61,1.63,1.52,1.53,-0.06,-3.77,347000,20,550640,0,0,0,0,0,0,258000,89000,169000,169000
20200212,049409,滬深2X凱基96購04,,,,,0.00,0.00,0,0,0,0,0,0,0,0,0,0,0,0,0
20200212,04940P,台積電國票95售02,,,,,0.00,0.00,0,0,0,0,0,0,0,0,0,0,0,0,0
20200212,049410,統一凱基94購02,1.41,1.45,0.03,1.42,-0.02,-1.39,205000,10,163110,0,0,0,0,0,0,100000,105000,-5000,-5000
20200212,049411,大成鋼凱基94購01,,,,,0.00,0.00,0,0,0,0,0,0,0,0,0,0,0,0,0
20200212,049412,為升凱基94購01,,,,,0.00,0.00,0,0,0,0,0,0,0,0,0,0,0,0,0
20200212,049413,台達電凱基94購06,1.12,1.22,1.12,1.22,+0.12,10.91,108000,3,126560,0,0,0,0,0,0,48000,60000,-12000,-12000
20200212,049414,台積電凱基94購18,1.18,1.18,1.18,1.18,+0.01,0.85,2000,1,2360,0,0,0,0,0,0,2000,0,2000,2000
20200212,049415,智邦凱基94購02,0.78,0.86,0.69,0.69,+0.03,4.55,38000,10,29260,0,0,0,0,0,0,38000,7000,31000,31000
20200212,049416,美律凱基94購04,,,,,0.00,0.00,0,0,0,0,0,0,0,0,0,0,0,0,0
20200212,049417,奇力新凱基94購02,2.28,2.37,2.25,2.37,+0.02,0.85,141000,28,321760,0,0,0,0,0,0,129000,12000,117000,117000
20200212,049418,大立光凱基94購05,1.91,1.95,1.91,1.95,+0.28,16.77,52000,4,101110,0,0,0,0,0,0,52000,52000,0,0
20200212,049419,欣興凱基94購04,0.41,0.44,0.41,0.44,0.00,0.00,74000,4,32530,0,0,0,0,0,0,0,74000,-74000,-74000
20200212,04941P,台達電台新94售02,0.49,0.49,0.48,0.48,-0.04,-7.69,22000,18,10580,0,0,0,0,0,0,22000,0,22000,22000
20200212,049420,日電貿凱基94購01,0.84,0.86,0.75,0.83,+0.10,13.7,467000,28,385010,0,0,0,0,0,0,338000,0,338000,338000
20200212,049421,鎧勝凱基94購02,,,,,0.00,0.00,0,0,0,0,0,0,0,0,0,0,0,0,0
20200212,049422,矽創凱基94購01,0.07,0.07,0.07,0.07,0.00,0.00,20000,1,1400,0,0,0,0,0,0,20000,0,20000,20000
20200212,049423,臺股指凱基95購02,1.28,1.60,1.27,1.60,+0.34,26.98,70000,13,97580,0,0,0,0,0,0,47000,23000,24000,24000
20200212,049424,中石化兆豐94購01,,,,,0.00,0.00,0,0,0,0,0,0,0,0,0,0,0,0,0
20200212,049425,喬山兆豐95購01,0.32,0.32,0.29,0.29,+0.04,16.0,280000,4,85100,0,0,0,0,0,0,150000,130000,20000,20000
20200212,049426,為升兆豐95購01,,,,,0.00,0.00,0,0,0,0,0,0,0,0,0,0,0,0,0
20200212,049427,瑞昱兆豐94購01,0.55,0.63,0.55,0.60,+0.08,15.38,247000,7,146590,0,0,0,0,0,0,0,247000,-247000,-247000
20200212,049428,力山國票94購02,,,,,0.00,0.00,0,0,0,0,0,0,0,0,0,0,0,0,0
20200212,049429,國巨國票95購01,,,,,0.00,0.00,0,0,0,0,0,0,0,0,0,0,0,0,0
20200212,04942P,台積電台新94售01,,,,,0.00,0.00,0,0,0,0,0,0,0,0,0,0,0,0,0
20200212,049430,國巨國票95購02,17.90,18.10,17.20,17.70,+0.40,2.31,82000,25,1450100,0,0,0,0,0,0,82000,71000,11000,11000
20200212,049431,光罩國票96購01,0.71,0.72,0.70,0.72,0.00,0.00,90000,3,63480,0,0,0,0,0,0,0,90000,-90000,-90000
20200212,049432,聯詠國票95購01,2.49,2.49,2.32,2.44,+0.30,14.02,129000,10,308740,0,0,0,0,0,0,28000,101000,-73000,-73000
20200212,049433,健策國票95購03,,,,,0.00,0.00,0,0,0,0,0,0,0,0,0,0,0,0,0
20200212,049434,茂林國票95購01,8.70,9.10,8.30,8.85,+0.50,5.99,109000,22,960000,0,0,0,0,0,0,69000,37000,32000,32000
20200212,049435,S&P反1國泰96購01,,,,,0.00,0.00,0,0,0,0,0,0,0,0,0,0,0,0,0
20200212,049436,義隆國泰96購02,1.32,1.32,1.19,1.25,+0.18,16.82,120000,23,150490,0,0,0,0,0,0,115000,5000,110000,110000
20200212,049437,可成國泰96購01,0.61,0.73,0.61,0.73,+0.16,28.07,301000,20,200420,0,0,0,0,0,0,91000,271000,-180000,-180000
20200212,049438,嘉晶國泰96購01,0.62,0.74,0.62,0.70,+0.09,14.75,623000,33,442840,0,0,0,0,0,0,430000,183000,247000,247000
20200212,049439,牧德國泰96購01,,,,,0.00,0.00,0,0,0,0,0,0,0,0,0,0,0,0,0
20200212,04943P,臻鼎康和94售01,,,,,0.00,0.00,0,0,0,0,0,0,0,0,0,0,0,0,0
20200212,049440,T50反1統一94購04,0.33,0.33,0.30,0.30,-0.04,-11.76,340000,3,105000,0,0,0,0,0,0,240000,100000,140000,140000
20200212,049441,T50反1統一94購05,,,,,0.00,0.00,0,0,0,0,0,0,0,0,0,0,0,0,0
20200212,049442,滬深2X統一99購01,,,,,0.00,0.00,0,0,0,0,0,0,0,0,0,0,0,0,0
20200212,049443,元石油統一94購02,,,,,0.00,0.00,0,0,0,0,0,0,0,0,0,0,0,0,0
20200212,049444,元石油統一94購03,0.40,0.40,0.40,0.40,+0.02,5.26,1000,1,400,0,0,0,0,0,0,1000,0,1000,1000
20200212,049445,遠東新統一94購01,1.03,1.03,1.02,1.02,-0.02,-1.92,30000,2,30700,0,0,0,0,0,0,30000,0,30000,30000
20200212,049446,為升統一94購01,,,,,0.00,0.00,0,0,0,0,0,0,0,0,0,0,0,0,0
20200212,049447,聯電統一94購01,3.30,3.59,3.30,3.59,+0.13,3.76,160000,22,563100,0,0,0,0,0,0,20000,140000,-120000,-120000
20200212,049448,光磊統一94購01,0.84,0.84,0.77,0.80,-0.03,-3.61,245000,20,199170,0,0,0,0,0,0,233000,2000,231000,231000
20200212,049449,宏碁統一94購01,0.80,0.80,0.80,0.80,0.00,0.00,10000,1,8000,0,0,0,0,0,0,0,10000,-10000,-10000
20200212,04944P,元油2X永豐94售06,2.34,2.34,2.31,2.31,0.00,0.00,2000,2,4650,0,0,0,0,0,0,0,2000,-2000,-2000
20200212,049450,友達統一94購02,,,,,0.00,0.00,0,0,0,0,0,0,0,0,0,0,0,0,0
20200212,049451,富邦金統一94購03,2.06,2.16,2.06,2.16,+0.23,11.92,226000,12,473710,0,0,0,0,0,0,204000,22000,182000,182000
20200212,049452,新光金統一94購02,0.97,0.98,0.94,0.98,+0.03,3.16,464000,31,445660,0,0,0,0,0,0,426000,30000,396000,396000
20200212,049453,新日興統一94購01,2.70,2.70,2.61,2.61,-0.08,-2.97,88000,11,232080,0,0,0,0,0,0,88000,0,88000,88000
20200212,049454,群創統一94購01,,,,,0.00,0.00,0,0,0,0,0,0,0,0,0,0,0,0,0
20200212,049455,上海銀統一94購02,0.83,0.83,0.83,0.83,-0.04,-4.6,20000,2,16600,0,0,0,0,0,0,20000,0,20000,20000
20200212,049456,上海銀統一94購03,1.27,1.27,1.27,1.27,-0.03,-2.31,10000,1,12700,0,0,0,0,0,0,10000,0,10000,10000
20200212,049457,彩晶統一94購02,,,,,0.00,0.00,0,0,0,0,0,0,0,0,0,0,0,0,0
20200212,049458,SP黃豆元富96購01,,,,,0.00,0.00,0,0,0,0,0,0,0,0,0,0,0,0,0
20200212,049459,全新元富95購02,0.85,1.06,0.85,1.03,+0.31,43.06,471000,77,438980,0,0,0,0,0,0,180000,299000,-119000,-119000
20200212,04945P,鴻海永豐94售06,,,,,0.00,0.00,0,0,0,0,0,0,0,0,0,0,0,0,0
20200212,049460,宏達電元富94購01,,,,,0.00,0.00,0,0,0,0,0,0,0,0,0,0,0,0,0
20200212,049461,嘉聯益元富94購01,,,,,0.00,0.00,0,0,0,0,0,0,0,0,0,0,0,0,0
20200212,049462,康友元富94購01,4.92,5.25,4.92,5.25,+0.29,5.85,51000,4,260370,0,0,0,0,0,0,4000,47000,-43000,-43000
20200212,049463,華新科富邦97購01,2.36,2.36,2.26,2.31,+0.06,2.67,205000,39,473100,0,0,0,0,0,0,164000,106000,58000,58000
20200212,049464,燿華台新95購01,,,,,0.00,0.00,0,0,0,0,0,0,0,0,0,0,0,0,0
20200212,049465,美律台新94購01,0.21,0.25,0.21,0.25,0.00,0.00,475000,8,108400,0,0,0,0,0,0,0,475000,-475000,-475000
20200212,049466,創意台新94購01,0.54,0.55,0.47,0.52,-0.13,-20.0,366000,22,186100,0,0,0,0,0,0,201000,81000,120000,120000
20200212,049467,致伸台新94購01,,,,,0.00,0.00,0,0,0,0,0,0,0,0,0,0,0,0,0
20200212,049468,楠梓電康和94購01,,,,,0.00,0.00,0,0,0,0,0,0,0,0,0,0,0,0,0
20200212,049469,元金2X永豐94購01,0.82,0.82,0.81,0.81,-0.02,-2.41,30000,2,24500,0,0,0,0,0,0,30000,0,30000,30000
20200212,04946P,華通元大94售04,0.53,0.53,0.46,0.46,-0.13,-22.03,229000,11,114440,0,0,0,0,0,0,100000,129000,-29000,-29000
20200212,049470,楠梓電永豐94購03,,,,,0.00,0.00,0,0,0,0,0,0,0,0,0,0,0,0,0
20200212,049471,楠梓電永豐94購04,,,,,0.00,0.00,0,0,0,0,0,0,0,0,0,0,0,0,0
20200212,049472,楠梓電永豐95購01,0.06,0.06,0.06,0.06,0.00,0.00,30000,1,1800,0,0,0,0,0,0,30000,0,30000,30000
20200212,049473,光罩永豐94購03,0.07,0.08,0.07,0.07,-0.03,-30.0,222000,9,15640,0,0,0,0,0,0,142000,80000,62000,62000
20200212,049474,台光電永豐94購02,,,,,0.00,0.00,0,0,0,0,0,0,0,0,0,0,0,0,0
20200212,049475,高鐵永豐94購01,0.23,0.23,0.23,0.23,0.00,0.00,15000,1,3450,0,0,0,0,0,0,15000,0,15000,15000
20200212,049476,美食永豐94購02,,,,,0.00,0.00,0,0,0,0,0,0,0,0,0,0,0,0,0
20200212,049477,泰鼎永豐94購01,1.67,1.84,1.63,1.65,+0.10,6.45,251000,48,443060,0,0,0,0,0,0,30000,221000,-191000,-191000
20200212,049478,祥碩永豐94購02,,,,,0.00,0.00,0,0,0,0,0,0,0,0,0,0,0,0,0
20200212,049479,矽格永豐94購01,0.42,0.44,0.42,0.44,+0.06,15.79,110000,3,48200,0,0,0,0,0,0,10000,100000,-90000,-90000
20200212,04947P,聯詠元大94售05,,,,,0.00,0.00,0,0,0,0,0,0,0,0,0,0,0,0,0
20200212,049480,同欣電永豐94購01,0.34,0.38,0.31,0.31,-0.02,-6.06,11000,5,3990,0,0,0,0,0,0,9000,2000,7000,7000
20200212,049481,為升元大94購03,,,,,0.00,0.00,0,0,0,0,0,0,0,0,0,0,0,0,0
20200212,049482,國巨元大94購06,,,,,0.00,0.00,0,0,0,0,0,0,0,0,0,0,0,0,0
20200212,049483,台積電元大94購12,,,,,0.00,0.00,0,0,0,0,0,0,0,0,0,0,0,0,0
20200212,049484,台積電元大95購02,5.65,5.75,5.65,5.75,+0.35,6.48,5000,2,28450,0,0,0,0,0,0,5000,0,5000,5000
20200212,049485,台積電元大96購03,,,,,0.00,0.00,0,0,0,0,0,0,0,0,0,0,0,0,0
20200212,049486,旺宏元大94購08,1.77,1.82,1.69,1.69,-0.06,-3.43,25000,7,44000,0,0,0,0,0,0,25000,5000,20000,20000
20200212,049487,智邦元大94購03,1.56,1.67,1.30,1.37,+0.05,3.79,177000,16,273260,0,0,0,0,0,0,55000,122000,-67000,-67000
20200212,049488,智邦元大95購01,1.43,1.48,1.16,1.27,+0.06,4.96,60000,10,83940,0,0,0,0,0,0,48000,32000,16000,16000
20200212,049489,美律元大94購05,1.01,1.14,1.01,1.14,+0.32,39.02,56000,9,61220,0,0,0,0,0,0,10000,46000,-36000,-36000
20200212,04948P,瑞儀元大94售03,2.43,2.48,2.43,2.47,-0.02,-0.8,71000,4,175430,0,0,0,0,0,0,1000,70000,-69000,-69000
20200212,049490,京元電元大95購02,1.79,1.92,1.71,1.87,+0.13,7.47,686000,39,1246890,0,0,0,0,0,0,347000,489000,-142000,-142000
20200212,049491,聯發科元大95購01,1.49,1.69,1.48,1.67,+0.34,25.56,555000,30,874680,0,0,0,0,0,0,475000,539000,-64000,-64000
20200212,049492,聯發科元大95購02,1.62,1.82,1.60,1.82,+0.39,27.27,479000,39,817660,0,0,0,0,0,0,408000,385000,23000,23000
20200212,049493,可成元大94購05,0.47,0.60,0.46,0.60,+0.17,39.53,193000,12,95450,0,0,0,0,0,0,1000,192000,-191000,-191000
20200212,049494,華新科元大95購05,3.19,3.19,3.07,3.10,0.00,0.00,76000,13,238230,0,0,0,0,0,0,76000,9000,67000,67000
20200212,049495,欣興元大94購06,0.42,0.42,0.39,0.40,0.00,0.00,120000,4,47800,0,0,0,0,0,0,0,120000,-120000,-120000
20200212,049496,和鑫元大95購01,0.48,0.49,0.48,0.49,+0.04,8.89,372000,3,182260,0,0,0,0,0,0,2000,370000,-368000,-368000
20200212,049497,茂林元大94購04,5.00,5.15,5.00,5.00,+0.28,5.93,23000,9,115250,0,0,0,0,0,0,20000,23000,-3000,-3000
20200212,049498,茂林元大95購01,5.80,5.95,5.55,5.80,+0.30,5.45,82000,23,476350,0,0,0,0,0,0,75000,48000,27000,27000
20200212,049499,康控元大96購01,0.47,0.52,0.47,0.52,+0.06,13.04,56000,12,27550,0,0,0,0,0,0,22000,34000,-12000,-12000
20200212,04949P,致新元大94售04,0.90,0.90,0.88,0.88,-0.01,-1.12,164000,3,144920,0,0,0,0,0,0,34000,130000,-96000,-96000
20200212,049500,聯茂元大94購04,0.34,0.41,0.34,0.34,0.00,0.00,135000,4,47330,0,0,0,0,0,0,66000,69000,-3000,-3000
20200212,049501,台郡元大95購01,2.91,2.96,2.91,2.96,+0.99,50.25,32000,4,93620,0,0,0,0,0,0,32000,0,32000,32000
20200212,049502,訊芯元大94購01,1.16,1.36,1.16,1.36,0.00,0.00,121000,6,143940,0,0,0,0,0,0,0,121000,-121000,-121000
20200212,049503,矽創元大94購01,0.26,0.34,0.26,0.34,+0.09,36.0,220000,4,73900,0,0,0,0,0,0,10000,210000,-200000,-200000
20200212,049504,臺股指元大94購15,2.45,2.45,2.45,2.45,+0.06,2.51,1000,1,2450,0,0,0,0,0,0,1000,0,1000,1000
20200212,049505,臺股指元大94購16,,,,,0.00,0.00,0,0,0,0,0,0,0,0,0,0,0,0,0
20200212,049506,可成日盛94購02,,,,,0.00,0.00,0,0,0,0,0,0,0,0,0,0,0,0,0
20200212,049507,和大凱基94購01,1.37,1.37,1.37,1.37,-0.03,-2.14,3000,2,4110,0,0,0,0,0,0,0,3000,-3000,-3000
20200212,049508,上銀凱基94購04,3.29,3.32,0.55,3.22,+0.08,2.55,116000,8,353190,0,0,0,0,0,0,81000,35000,46000,46000
20200212,049509,台達電凱基94購07,,,,,0.00,0.00,0,0,0,0,0,0,0,0,0,0,0,0,0
20200212,04950P,上証2X中信96售02,0.51,0.52,0.51,0.52,+0.01,1.96,40000,3,20700,0,0,0,0,0,0,40000,0,40000,40000
20200212,049510,楠梓電凱基94購01,,,,,0.00,0.00,0,0,0,0,0,0,0,0,0,0,0,0,0
20200212,049511,奇力新凱基94購03,3.02,3.18,2.03,3.18,+0.11,3.58,187000,34,571580,0,0,0,0,0,0,53000,134000,-81000,-81000
20200212,049512,可成凱基94購06,,,,,0.00,0.00,0,0,0,0,0,0,0,0,0,0,0,0,0
20200212,049513,宏達電凱基94購03,,,,,0.00,0.00,0,0,0,0,0,0,0,0,0,0,0,0,0
20200212,049514,奇鋐凱基94購01,,,,,0.00,0.00,0,0,0,0,0,0,0,0,0,0,0,0,0
20200212,049515,同欣電凱基94購01,0.97,1.15,0.97,1.11,+0.15,15.62,81000,18,89320,0,0,0,0,0,0,71000,10000,61000,61000
20200212,049516,光罩國票94購02,0.64,0.73,0.64,0.71,+0.12,20.34,58000,9,40480,0,0,0,0,0,0,0,58000,-58000,-58000
20200212,049517,台光電國票94購02,0.68,0.80,0.66,0.80,+0.27,50.94,228000,6,170580,0,0,0,0,0,0,3000,225000,-222000,-222000
20200212,049518,宏達電國票95購02,0.22,0.22,0.22,0.22,+0.02,10.0,10000,2,2200,0,0,0,0,0,0,8000,2000,6000,6000
20200212,049519,新光金國票95購03,0.63,0.64,0.63,0.64,+0.02,3.23,140000,9,89100,0,0,0,0,0,0,60000,80000,-20000,-20000
20200212,04951P,緯創中信94售01,,,,,0.00,0.00,0,0,0,0,0,0,0,0,0,0,0,0,0
20200212,049520,TPK國票95購01,,,,,0.00,0.00,0,0,0,0,0,0,0,0,0,0,0,0,0
20200212,049521,致伸國票95購01,,,,,0.00,0.00,0,0,0,0,0,0,0,0,0,0,0,0,0
20200212,049522,華通兆豐94購02,0.84,1.29,0.84,1.28,+0.46,56.1,469000,21,493630,0,0,0,0,0,0,202000,260000,-58000,-58000
20200212,049523,微星兆豐94購02,1.46,1.50,1.31,1.31,-0.04,-2.96,152000,11,215800,0,0,0,0,0,0,86000,60000,26000,26000
20200212,049524,可成兆豐95購02,0.11,0.13,0.11,0.13,0.00,0.00,132000,5,15890,0,0,0,0,0,0,32000,100000,-68000,-68000
20200212,049525,華新科兆豐94購01,2.51,2.55,2.51,2.55,+0.15,6.25,26000,3,65660,0,0,0,0,0,0,0,26000,-26000,-26000
20200212,049526,緯穎兆豐95購01,,,,,0.00,0.00,0,0,0,0,0,0,0,0,0,0,0,0,0
20200212,049527,國巨中信95購01,5.00,5.00,4.89,4.95,+0.33,7.14,24000,6,119130,0,0,0,0,0,0,13000,11000,2000,2000
20200212,049528,台積電中信94購01,2.78,2.78,2.72,2.72,+0.08,3.03,50000,4,138100,0,0,0,0,0,0,30000,20000,10000,10000
20200212,049529,華新科中信95購01,2.34,2.35,2.21,2.26,+0.06,2.73,483000,33,1104500,0,0,0,0,0,0,254000,246000,8000,8000
20200212,04952P,台光電亞東94售01,,,,,0.00,0.00,0,0,0,0,0,0,0,0,0,0,0,0,0
20200212,049530,上銀台新94購01,,,,,0.00,0.00,0,0,0,0,0,0,0,0,0,0,0,0,0
20200212,049531,聯詠台新94購01,,,,,0.00,0.00,0,0,0,0,0,0,0,0,0,0,0,0,0
20200212,049532,同欣電台新94購01,1.33,1.42,1.25,1.42,+0.19,15.45,482000,29,643840,0,0,0,0,0,0,219000,210000,9000,9000
20200212,049533,美食永豐94購03,,,,,0.00,0.00,0,0,0,0,0,0,0,0,0,0,0,0,0
20200212,049534,華擎永豐94購02,2.21,2.21,2.21,2.21,+0.01,0.45,2000,1,4420,0,0,0,0,0,0,2000,0,2000,2000
20200212,049535,臻鼎永豐94購01,0.43,0.46,0.39,0.40,+0.09,29.03,88000,7,36600,0,0,0,0,0,0,20000,68000,-48000,-48000
20200212,049536,T50反1群益94購02,0.05,0.05,0.05,0.05,0.00,0.00,20000,2,1000,0,0,0,0,0,0,0,20000,-20000,-20000
20200212,049537,元石油群益97購01,0.59,0.62,0.59,0.62,+0.03,5.08,4000,4,2420,0,0,0,0,0,0,0,4000,-4000,-4000
20200212,049538,元油2X群益98購01,1.04,1.11,1.04,1.11,+0.08,7.77,882000,15,945880,0,0,0,0,0,0,712000,170000,542000,542000
20200212,049539,元油2X群益9A購01,0.98,1.03,0.98,1.03,+0.07,7.29,234000,24,233570,0,0,0,0,0,0,51000,177000,-126000,-126000
20200212,04953P,台積電群益94售13,0.58,0.59,0.55,0.55,-0.09,-14.06,246000,15,140040,0,0,0,0,0,0,0,246000,-246000,-246000
20200212,049540,楠梓電群益94購01,,,,,0.00,0.00,0,0,0,0,0,0,0,0,0,0,0,0,0
20200212,049541,楠梓電群益94購02,,,,,0.00,0.00,0,0,0,0,0,0,0,0,0,0,0,0,0
20200212,049542,鴻海群益94購05,,,,,0.00,0.00,0,0,0,0,0,0,0,0,0,0,0,0,0
20200212,049543,國巨群益94購04,,,,,0.00,0.00,0,0,0,0,0,0,0,0,0,0,0,0,0
20200212,049544,台積電群益94購08,,,,,0.00,0.00,0,0,0,0,0,0,0,0,0,0,0,0,0
20200212,049545,台積電群益94購09,1.00,1.09,0.95,1.07,+0.12,12.63,470000,16,468840,0,0,0,0,0,0,355000,124000,231000,231000
20200212,049546,正崴群益94購01,0.81,0.81,0.81,0.81,-0.01,-1.22,11000,1,8910,0,0,0,0,0,0,11000,0,11000,11000
20200212,049547,新光金群益94購01,0.89,0.89,0.89,0.89,+0.05,5.95,30000,3,26700,0,0,0,0,0,0,0,30000,-30000,-30000
20200212,049548,群創群益94購01,,,,,0.00,0.00,0,0,0,0,0,0,0,0,0,0,0,0,0
20200212,049549,瀚宇博群益94購01,0.46,0.54,0.46,0.54,+0.06,12.5,114000,7,55260,0,0,0,0,0,0,100000,14000,86000,86000
20200212,04954P,健策國票96售01,0.24,0.24,0.24,0.24,0.00,0.00,15000,1,3600,0,0,0,0,0,0,0,15000,-15000,-15000
20200212,049550,柏文群益94購01,0.07,0.07,0.07,0.07,0.00,0.00,410000,2,28700,0,0,0,0,0,0,410000,0,410000,410000
20200212,049551,電子類群益94購01,,,,,0.00,0.00,0,0,0,0,0,0,0,0,0,0,0,0,0
20200212,049552,鴻海國泰96購01,,,,,0.00,0.00,0,0,0,0,0,0,0,0,0,0,0,0,0
20200212,049553,鴻海國泰96購02,,,,,0.00,0.00,0,0,0,0,0,0,0,0,0,0,0,0,0
20200212,049554,禾伸堂富邦96購01,1.04,1.04,0.99,1.04,-0.01,-0.95,120000,16,121340,0,0,0,0,0,0,50000,69000,-19000,-19000
20200212,049555,台表科富邦94購01,,,,,0.00,0.00,0,0,0,0,0,0,0,0,0,0,0,0,0
20200212,049556,智易元富94購01,,,,,0.00,0.00,0,0,0,0,0,0,0,0,0,0,0,0,0
20200212,049557,南電元富94購02,0.23,0.32,0.21,0.31,+0.08,34.78,499000,28,143370,0,0,0,0,0,0,160000,339000,-179000,-179000
20200212,049558,深中小統一94購04,,,,,0.00,0.00,0,0,0,0,0,0,0,0,0,0,0,0,0
20200212,049559,香港反統一94購02,,,,,0.00,0.00,0,0,0,0,0,0,0,0,0,0,0,0,0
20200212,04955P,大立光日盛94售02,,,,,0.00,0.00,0,0,0,0,0,0,0,0,0,0,0,0,0
20200212,049560,香港反統一95購01,,,,,0.00,0.00,0,0,0,0,0,0,0,0,0,0,0,0,0
20200212,049561,道瓊銀統一96購01,0.50,0.50,0.48,0.48,-0.06,-11.11,199000,3,96910,0,0,0,0,0,0,0,199000,-199000,-199000
20200212,049562,和大統一94購01,1.63,1.63,1.63,1.63,0.00,0.00,10000,1,16300,0,0,0,0,0,0,0,10000,-10000,-10000
20200212,049563,華新統一95購01,1.30,1.37,1.30,1.37,+0.09,7.03,732000,17,963960,0,0,0,0,0,0,386000,356000,30000,30000
20200212,049564,聯電統一94購03,3.79,3.79,3.79,3.79,-0.10,-2.57,20000,9,75800,0,0,0,0,0,0,20000,0,20000,20000
20200212,049565,楠梓電統一94購01,,,,,0.00,0.00,0,0,0,0,0,0,0,0,0,0,0,0,0
20200212,049566,鴻海統一94購04,3.45,3.58,3.45,3.58,0.00,0.00,20000,2,70300,0,0,0,0,0,0,0,20000,-20000,-20000
20200212,049567,鴻海統一94購05,4.02,4.40,4.02,4.40,+0.43,10.83,292000,17,1214380,0,0,0,0,0,0,133000,159000,-26000,-26000
20200212,049568,台積電統一94購08,,,,,0.00,0.00,0,0,0,0,0,0,0,0,0,0,0,0,0
20200212,049569,光磊統一94購02,1.17,1.18,1.14,1.14,-0.07,-5.79,91000,10,106930,0,0,0,0,0,0,91000,0,91000,91000
20200212,04956P,臺股指日盛94售02,1.88,1.89,1.65,1.66,-0.40,-19.42,254000,15,458240,0,0,0,0,0,0,171000,83000,88000,88000
20200212,049570,華新科統一94購04,2.02,2.14,2.00,2.05,+0.09,4.59,377000,23,768680,0,0,0,0,0,0,345000,32000,313000,313000
20200212,049571,華固統一94購02,2.96,2.96,2.96,2.96,+0.06,2.07,10000,1,29600,0,0,0,0,0,0,10000,0,10000,10000
20200212,049572,華固統一94購03,,,,,0.00,0.00,0,0,0,0,0,0,0,0,0,0,0,0,0
20200212,049573,長榮航統一95購01,,,,,0.00,0.00,0,0,0,0,0,0,0,0,0,0,0,0,0
20200212,049574,新日興統一94購03,3.61,3.61,3.48,3.48,-0.10,-2.79,36000,8,126540,0,0,0,0,0,0,36000,0,36000,36000
20200212,049575,美食康和94購02,,,,,0.00,0.00,0,0,0,0,0,0,0,0,0,0,0,0,0
20200212,049576,元油2X元大94購06,0.43,0.48,0.43,0.48,+0.05,11.63,779000,10,356250,0,0,0,0,0,0,629000,144000,485000,485000
20200212,049577,台達電元大94購08,2.65,2.79,2.65,2.79,+0.04,1.45,80000,5,214100,0,0,0,0,0,0,0,80000,-80000,-80000
20200212,049578,台達電元大94購09,1.06,1.06,1.06,1.06,0.00,0.00,10000,1,10600,0,0,0,0,0,0,0,10000,-10000,-10000
20200212,049579,鴻海元大94購06,,,,,0.00,0.00,0,0,0,0,0,0,0,0,0,0,0,0,0
20200212,04957P,上証2X凱基96售02,1.70,1.70,1.70,1.70,+0.08,4.94,3000,1,5100,0,0,0,0,0,0,3000,0,3000,3000
20200212,049580,國巨元大94購07,6.35,6.35,6.10,6.10,+0.25,4.27,5000,4,31200,0,0,0,0,0,0,5000,0,5000,5000
20200212,049581,國巨元大94購08,,,,,0.00,0.00,0,0,0,0,0,0,0,0,0,0,0,0,0
20200212,049582,台積電元大95購03,,,,,0.00,0.00,0,0,0,0,0,0,0,0,0,0,0,0,0
20200212,049583,台積電元大95購04,3.89,4.09,3.89,4.09,+0.27,7.07,294000,72,1158810,0,0,0,0,0,0,284000,260000,24000,24000
20200212,049584,台積電元大96購04,3.70,3.81,3.70,3.81,+0.24,6.72,194000,10,725300,0,0,0,0,0,0,139000,186000,-47000,-47000
20200212,049585,旺宏元大95購02,1.76,1.81,1.66,1.70,-0.03,-1.73,240000,11,414630,0,0,0,0,0,0,130000,115000,15000,15000
20200212,049586,正崴元大94購01,1.30,1.34,1.30,1.33,-0.03,-2.21,42000,5,55750,0,0,0,0,0,0,42000,13000,29000,29000
20200212,049587,美律元大95購01,0.66,0.76,0.66,0.76,+0.16,26.67,350000,18,245920,0,0,0,0,0,0,20000,337000,-317000,-317000
20200212,049588,聯發科元大94購06,1.35,1.51,1.32,1.51,+0.35,30.17,275000,21,386490,0,0,0,0,0,0,259000,184000,75000,75000
20200212,049589,奇力新元大95購02,3.14,3.20,3.06,3.20,+0.03,0.95,27000,12,84570,0,0,0,0,0,0,17000,11000,6000,6000
20200212,04958P,和大凱基94售04,1.01,1.06,0.98,0.98,-0.03,-2.97,62000,10,63160,0,0,0,0,0,0,12000,50000,-38000,-38000
20200212,049590,華新科元大94購01,6.00,6.00,5.70,5.85,+0.20,3.54,105000,30,613050,0,0,0,0,0,0,73000,84000,-11000,-11000
20200212,049591,開發金元大98購01,0.73,0.73,0.73,0.73,-0.01,-1.35,1000,1,730,0,0,0,0,0,0,0,1000,-1000,-1000
20200212,049592,欣興元大96購01,,,,,0.00,0.00,0,0,0,0,0,0,0,0,0,0,0,0,0
20200212,049593,群創元大9A購01,1.89,1.89,1.85,1.87,+0.01,0.54,219000,23,408220,0,0,0,0,0,0,179000,219000,-40000,-40000
20200212,049594,揚明光元大95購01,,,,,0.00,0.00,0,0,0,0,0,0,0,0,0,0,0,0,0
20200212,049595,麗豐元大95購01,0.68,0.73,0.67,0.70,+0.05,7.69,310000,14,215480,0,0,0,0,0,0,185000,192000,-7000,-7000
20200212,049596,智伸科元大95購01,0.67,0.67,0.62,0.63,0.00,0.00,42000,6,26670,0,0,0,0,0,0,18000,24000,-6000,-6000
20200212,049597,泰鼎元大96購01,2.03,2.11,1.94,1.98,+0.08,4.21,34000,16,69050,0,0,0,0,0,0,16000,29000,-13000,-13000
20200212,049598,超眾元大95購03,0.48,0.51,0.48,0.49,+0.02,4.26,240000,5,121600,0,0,0,0,0,0,20000,220000,-200000,-200000
20200212,049599,樺漢元大95購01,1.64,1.64,1.64,1.64,+0.04,2.5,9000,1,14760,0,0,0,0,0,0,9000,0,9000,9000
20200212,04959P,可成凱基94售14,,,,,0.00,0.00,0,0,0,0,0,0,0,0,0,0,0,0,0
20200212,049600,緯穎元大95購02,4.81,5.10,4.81,5.10,+0.30,6.25,11000,2,55810,0,0,0,0,0,0,11000,10000,1000,1000
20200212,049601,矽創元大95購02,0.43,0.55,0.43,0.55,+0.14,34.15,597000,17,293500,0,0,0,0,0,0,280000,312000,-32000,-32000
20200212,049602,南電元大95購01,,,,,0.00,0.00,0,0,0,0,0,0,0,0,0,0,0,0,0
20200212,049603,富邦金亞東94購01,,,,,0.00,0.00,0,0,0,0,0,0,0,0,0,0,0,0,0
20200212,049604,創意亞東94購02,0.41,0.41,0.41,0.41,0.00,0.00,40000,1,16400,0,0,0,0,0,0,0,40000,-40000,-40000
20200212,049605,旺宏第一94購01,,,,,0.00,0.00,0,0,0,0,0,0,0,0,0,0,0,0,0
20200212,049606,可成第一94購01,,,,,0.00,0.00,0,0,0,0,0,0,0,0,0,0,0,0,0
20200212,049607,台積電兆豐94購04,2.70,2.84,2.62,2.80,+0.29,11.55,98000,9,267900,0,0,0,0,0,0,48000,50000,-2000,-2000
20200212,049608,旺宏兆豐94購02,,,,,0.00,0.00,0,0,0,0,0,0,0,0,0,0,0,0,0
20200212,049609,全新兆豐95購01,0.38,0.45,0.38,0.45,+0.11,32.35,546000,10,220050,0,0,0,0,0,0,251000,295000,-44000,-44000
20200212,04960P,大立光凱基96售04,0.25,0.25,0.25,0.25,0.00,0.00,10000,1,2500,0,0,0,0,0,0,0,10000,-10000,-10000
20200212,049610,奇力新兆豐95購01,,,,,0.00,0.00,0,0,0,0,0,0,0,0,0,0,0,0,0
20200212,049611,緯穎兆豐95購02,,,,,0.00,0.00,0,0,0,0,0,0,0,0,0,0,0,0,0
20200212,049612,香港反中信96購01,0.35,0.35,0.34,0.34,-0.02,-5.56,170000,5,58100,0,0,0,0,0,0,130000,20000,110000,110000
20200212,049613,華通中信94購01,1.64,2.09,1.62,2.01,+0.38,23.31,230000,21,414980,0,0,0,0,0,0,99000,129000,-30000,-30000
20200212,049614,聯茂中信94購01,0.22,0.32,0.22,0.27,0.00,0.00,301000,27,82070,0,0,0,0,0,0,0,301000,-301000,-301000
20200212,049615,香港2X群益98購01,0.83,0.83,0.83,0.83,+0.02,2.47,21000,2,17430,0,0,0,0,0,0,21000,0,21000,21000
20200212,049616,卜蜂群益94購01,0.74,0.74,0.74,0.74,0.00,0.00,10000,1,7400,0,0,0,0,0,0,0,10000,-10000,-10000
20200212,049617,光罩群益94購03,0.73,0.84,0.72,0.84,+0.12,16.67,190000,22,149640,0,0,0,0,0,0,66000,124000,-58000,-58000
20200212,049618,美律群益94購03,0.86,1.05,0.86,1.02,+0.25,32.47,237000,30,223400,0,0,0,0,0,0,126000,168000,-42000,-42000
20200212,049619,宏達電群益95購02,0.19,0.19,0.19,0.19,+0.01,5.56,50000,1,9500,0,0,0,0,0,0,0,50000,-50000,-50000
20200212,04961P,貿聯凱基94售03,1.15,1.15,1.15,1.15,0.00,0.00,6000,1,6900,0,0,0,0,0,0,6000,0,6000,6000
20200212,049620,美食群益94購01,0.03,0.03,0.03,0.03,+0.01,50.0,300000,3,9000,0,0,0,0,0,0,0,300000,-300000,-300000
20200212,049621,美食群益94購02,0.03,0.03,0.03,0.03,0.00,0.00,15000,1,450,0,0,0,0,0,0,0,15000,-15000,-15000
20200212,049622,聯詠群益94購02,2.84,2.93,2.77,2.77,+0.28,11.24,50000,4,144000,0,0,0,0,0,0,30000,20000,10000,10000
20200212,049623,創意群益94購01,0.56,0.61,0.51,0.57,-0.13,-18.57,539000,32,299720,0,0,0,0,0,0,340000,198000,142000,142000
20200212,049624,嘉澤群益94購01,0.65,0.65,0.59,0.59,-0.07,-10.61,54000,4,33510,0,0,0,0,0,0,33000,21000,12000,12000
20200212,049625,智易群益95購01,0.58,0.74,0.58,0.71,+0.15,26.79,323000,38,204410,0,0,0,0,0,0,50000,268000,-218000,-218000
20200212,049626,健策群益94購01,,,,,0.00,0.00,0,0,0,0,0,0,0,0,0,0,0,0,0
20200212,049627,嘉聯益群益94購02,0.19,0.19,0.19,0.19,+0.02,11.76,73000,2,13870,0,0,0,0,0,0,73000,0,73000,73000
20200212,049628,臺股指群益94購01,7.00,7.00,7.00,7.00,0.00,0.00,1000,1,7000,0,0,0,0,0,0,1000,0,1000,1000
20200212,049629,臺股指群益94購02,6.20,6.30,6.20,6.30,+0.35,5.88,3000,2,18800,0,0,0,0,0,0,2000,1000,1000,1000
20200212,04962P,易華電凱基96售01,0.90,0.92,0.90,0.91,-0.03,-3.19,94000,4,84910,0,0,0,0,0,0,79000,15000,64000,64000
20200212,049630,臺股指群益94購03,,,,,0.00,0.00,0,0,0,0,0,0,0,0,0,0,0,0,0
20200212,049631,臺股指群益94購04,7.50,7.50,7.50,7.50,+0.90,13.64,10000,1,75000,0,0,0,0,0,0,10000,0,10000,10000
20200212,049632,臺股指群益94購05,,,,,0.00,0.00,0,0,0,0,0,0,0,0,0,0,0,0,0
20200212,049633,臺股指群益94購06,,,,,0.00,0.00,0,0,0,0,0,0,0,0,0,0,0,0,0
20200212,049634,臺股指群益94購07,,,,,0.00,0.00,0,0,0,0,0,0,0,0,0,0,0,0,0
20200212,049635,臺股指群益94購08,5.60,5.60,5.60,5.60,+0.35,6.67,1000,1,5600,0,0,0,0,0,0,1000,0,1000,1000
20200212,049636,上証反凱基9A購01,0.52,0.52,0.52,0.52,-0.02,-3.7,200000,1,104000,0,0,0,0,0,0,200000,0,200000,200000
20200212,049637,元石油凱基94購01,,,,,0.00,0.00,0,0,0,0,0,0,0,0,0,0,0,0,0
20200212,049638,A50反1凱基94購01,,,,,0.00,0.00,0,0,0,0,0,0,0,0,0,0,0,0,0
20200212,049639,力山凱基94購03,,,,,0.00,0.00,0,0,0,0,0,0,0,0,0,0,0,0,0
20200212,04963P,鴻海元大94售25,1.46,1.46,1.23,1.23,-0.37,-23.12,174000,17,235500,0,0,0,0,0,0,30000,144000,-114000,-114000
20200212,049640,大成鋼凱基94購02,,,,,0.00,0.00,0,0,0,0,0,0,0,0,0,0,0,0,0
20200212,049641,台達電凱基94購08,2.16,2.23,2.16,2.23,+0.04,1.83,179000,5,393730,0,0,0,0,0,0,172000,7000,165000,165000
20200212,049642,鴻海凱基94購16,0.62,0.62,0.62,0.62,0.00,0.00,10000,2,6200,0,0,0,0,0,0,0,10000,-10000,-10000
20200212,049643,華泰凱基94購01,,,,,0.00,0.00,0,0,0,0,0,0,0,0,0,0,0,0,0
20200212,049644,台積電凱基94購21,1.13,1.13,1.11,1.12,+0.19,20.43,44000,5,49480,0,0,0,0,0,0,4000,40000,-36000,-36000
20200212,049645,台積電凱基94購22,,,,,0.00,0.00,0,0,0,0,0,0,0,0,0,0,0,0,0
20200212,049646,旺宏凱基94購01,1.81,1.81,1.81,1.81,+0.04,2.26,1000,1,1810,0,0,0,0,0,0,1000,1000,0,0
20200212,049647,美食凱基94購01,,,,,0.00,0.00,0,0,0,0,0,0,0,0,0,0,0,0,0
20200212,049648,大立光凱基94購08,,,,,0.00,0.00,0,0,0,0,0,0,0,0,0,0,0,0,0
20200212,049649,信邦凱基94購01,0.71,0.73,0.71,0.73,-0.04,-5.19,167000,5,119390,0,0,0,0,0,0,126000,41000,85000,85000
20200212,04964P,鴻海元大94售26,1.28,1.28,1.18,1.18,-0.42,-26.25,12000,2,15160,0,0,0,0,0,0,0,12000,-12000,-12000
20200212,049650,啟碁凱基94購03,,,,,0.00,0.00,0,0,0,0,0,0,0,0,0,0,0,0,0
20200212,049651,訊芯凱基94購04,0.70,0.84,0.70,0.84,+0.18,27.27,72000,4,54240,0,0,0,0,0,0,1000,71000,-70000,-70000
20200212,049652,GIS凱基94購05,0.61,0.61,0.61,0.61,0.00,0.00,237000,6,144570,0,0,0,0,0,0,10000,227000,-217000,-217000
20200212,049653,緯穎凱基94購03,6.60,6.60,6.60,6.60,-0.15,-2.22,22000,2,145200,0,0,0,0,0,0,22000,0,22000,22000
20200212,049654,臺股指凱基94購15,,,,,0.00,0.00,0,0,0,0,0,0,0,0,0,0,0,0,0
20200212,049655,臺股指凱基94購16,,,,,0.00,0.00,0,0,0,0,0,0,0,0,0,0,0,0,0
20200212,049656,臺股指凱基94購17,3.38,3.44,3.38,3.44,+0.23,7.17,5000,3,17020,0,0,0,0,0,0,1000,4000,-3000,-3000
20200212,049657,滬深2X台新94購01,0.15,0.15,0.15,0.15,0.00,0.00,77000,1,11550,0,0,0,0,0,0,0,77000,-77000,-77000
20200212,049658,國巨台新95購01,,,,,0.00,0.00,0,0,0,0,0,0,0,0,0,0,0,0,0
20200212,049659,旺宏台新95購01,,,,,0.00,0.00,0,0,0,0,0,0,0,0,0,0,0,0,0
20200212,04965P,日月光元大94售02,2.05,2.05,2.05,2.05,0.00,0.00,18000,2,36900,0,0,0,0,0,0,0,18000,-18000,-18000
20200212,049660,奇鋐台新94購01,,,,,0.00,0.00,0,0,0,0,0,0,0,0,0,0,0,0,0
20200212,049661,喬山永豐94購01,,,,,0.00,0.00,0,0,0,0,0,0,0,0,0,0,0,0,0
20200212,049662,燿華永豐95購02,,,,,0.00,0.00,0,0,0,0,0,0,0,0,0,0,0,0,0
20200212,049663,正崴永豐94購01,0.12,0.12,0.12,0.12,0.00,0.00,450000,1,54000,0,0,0,0,0,0,0,450000,-450000,-450000
20200212,049664,聯發科永豐94購03,0.47,0.48,0.47,0.48,+0.13,37.14,136000,2,64600,0,0,0,0,0,0,68000,68000,0,0
20200212,049665,TPK永昌95購01,0.38,0.38,0.38,0.38,0.00,0.00,7000,1,2660,0,0,0,0,0,0,7000,7000,0,0
20200212,049666,臺股指永昌94購01,,,,,0.00,0.00,0,0,0,0,0,0,0,0,0,0,0,0,0
20200212,049667,大立光國泰96購01,1.40,1.57,1.40,1.57,+0.19,13.77,61000,5,91010,0,0,0,0,0,0,30000,31000,-1000,-1000
20200212,049668,大立光國泰96購02,1.94,2.19,1.94,2.19,+0.28,14.66,285000,10,600920,0,0,0,0,0,0,200000,264000,-64000,-64000
20200212,049669,訊芯國泰95購01,1.17,1.46,1.17,1.41,+0.19,15.57,40000,17,54580,0,0,0,0,0,0,14000,24000,-10000,-10000
20200212,04966P,台表科元大94售04,,,,,0.00,0.00,0,0,0,0,0,0,0,0,0,0,0,0,0
20200212,049670,鈺齊國泰96購01,3.24,3.38,3.24,3.38,+0.27,8.68,42000,6,139650,0,0,0,0,0,0,40000,0,40000,40000
20200212,049671,上証2X富邦95購01,,,,,0.00,0.00,0,0,0,0,0,0,0,0,0,0,0,0,0
20200212,049672,臺股指富邦94購01,1.64,1.68,1.64,1.68,+0.15,9.8,6000,3,9920,0,0,0,0,0,0,0,6000,-6000,-6000
20200212,049673,臺股指富邦94購02,,,,,0.00,0.00,0,0,0,0,0,0,0,0,0,0,0,0,0
20200212,049674,國巨元富94購02,,,,,0.00,0.00,0,0,0,0,0,0,0,0,0,0,0,0,0
20200212,049675,台光電國票95購01,0.85,1.15,0.85,1.15,+0.34,41.98,120000,18,121300,0,0,0,0,0,0,0,120000,-120000,-120000
20200212,049676,美食國票94購01,,,,,0.00,0.00,0,0,0,0,0,0,0,0,0,0,0,0,0
20200212,049677,臺股指國票94購10,,,,,0.00,0.00,0,0,0,0,0,0,0,0,0,0,0,0,0
20200212,049678,臺股指國票94購11,,,,,0.00,0.00,0,0,0,0,0,0,0,0,0,0,0,0,0
20200212,049679,臺股指國票94購12,7.10,7.10,7.00,7.00,0.00,0.00,8000,2,56500,0,0,0,0,0,0,8000,0,8000,8000
20200212,04967P,台表科永豐94售04,,,,,0.00,0.00,0,0,0,0,0,0,0,0,0,0,0,0,0
20200212,049680,臺股指國票94購13,,,,,0.00,0.00,0,0,0,0,0,0,0,0,0,0,0,0,0
20200212,049681,旺宏統一94購04,2.03,2.05,1.97,1.97,-0.05,-2.48,94000,4,190900,0,0,0,0,0,0,50000,44000,6000,6000
20200212,049682,友達統一94購03,,,,,0.00,0.00,0,0,0,0,0,0,0,0,0,0,0,0,0
20200212,049683,美食統一94購01,,,,,0.00,0.00,0,0,0,0,0,0,0,0,0,0,0,0,0
20200212,049684,彩晶統一95購01,,,,,0.00,0.00,0,0,0,0,0,0,0,0,0,0,0,0,0
20200212,049685,T50反1元大94購01,0.05,0.05,0.05,0.05,-0.03,-37.5,50000,1,2500,0,0,0,0,0,0,50000,0,50000,50000
20200212,049686,T50反1元大94購02,0.08,0.08,0.07,0.07,-0.03,-30.0,70000,2,5100,0,0,0,0,0,0,0,70000,-70000,-70000
20200212,049687,國巨元大94購09,,,,,0.00,0.00,0,0,0,0,0,0,0,0,0,0,0,0,0
20200212,049688,台光電元大94購04,0.79,1.03,0.79,0.98,+0.18,22.5,314000,23,300590,0,0,0,0,0,0,51000,293000,-242000,-242000
20200212,049689,正崴元大94購02,,,,,0.00,0.00,0,0,0,0,0,0,0,0,0,0,0,0,0
20200212,04968P,台積電富邦94售06,,,,,0.00,0.00,0,0,0,0,0,0,0,0,0,0,0,0,0
20200212,049690,義隆元大95購02,0.68,0.69,0.59,0.65,+0.11,20.37,86000,6,58680,0,0,0,0,0,0,32000,54000,-22000,-22000
20200212,049691,可成元大94購06,0.95,1.14,0.95,1.14,+0.25,28.09,82000,10,84130,0,0,0,0,0,0,42000,40000,2000,2000
20200212,049692,可成元大94購07,0.42,0.54,0.42,0.54,+0.15,38.46,88000,4,43420,0,0,0,0,0,0,68000,63000,5000,5000
20200212,049693,可成元大94購08,0.65,0.71,0.65,0.71,0.00,0.00,21000,3,13810,0,0,0,0,0,0,0,21000,-21000,-21000
20200212,049694,華新科元大95購06,3.14,3.14,3.14,3.14,+0.12,3.97,7000,2,21980,0,0,0,0,0,0,7000,0,7000,7000
20200212,049695,新光金元大9A購01,1.00,1.00,0.99,0.99,+0.01,1.02,125000,9,124750,0,0,0,0,0,0,125000,0,125000,125000
20200212,049696,欣興元大95購02,0.63,0.63,0.63,0.63,0.00,0.00,10000,1,6300,0,0,0,0,0,0,10000,0,10000,10000
20200212,049697,群創元大98購01,1.59,1.60,1.55,1.58,+0.02,1.28,178000,26,279420,0,0,0,0,0,0,108000,166000,-58000,-58000
20200212,049698,TPK元大95購01,,,,,0.00,0.00,0,0,0,0,0,0,0,0,0,0,0,0,0
20200212,049699,祥碩元大94購01,,,,,0.00,0.00,0,0,0,0,0,0,0,0,0,0,0,0,0
20200212,04969P,道瓊銀統一94售02,,,,,0.00,0.00,0,0,0,0,0,0,0,0,0,0,0,0,0
20200212,049700,瀚宇博元大97購01,2.00,2.23,2.00,2.23,+0.18,8.78,116000,13,244310,0,0,0,0,0,0,71000,62000,9000,9000
20200212,049701,聯茂元大94購05,0.38,0.41,0.38,0.38,0.00,0.00,131000,3,51220,0,0,0,0,0,0,15000,116000,-101000,-101000
20200212,049702,台表科元大95購03,,,,,0.00,0.00,0,0,0,0,0,0,0,0,0,0,0,0,0
20200212,049703,訊芯元大95購01,1.04,1.24,1.04,1.23,+0.19,18.27,280000,11,314130,0,0,0,0,0,0,23000,257000,-234000,-234000
20200212,049704,羅麗芬元大95購01,0.18,0.18,0.18,0.18,0.00,0.00,20000,1,3600,0,0,0,0,0,0,20000,0,20000,20000
20200212,049705,緯穎元大94購05,9.15,9.15,8.80,8.80,+0.20,2.33,15000,2,135500,0,0,0,0,0,0,15000,0,15000,15000
20200212,049706,世紀鋼元大95購02,0.40,0.40,0.40,0.40,-0.01,-2.44,20000,2,8000,0,0,0,0,0,0,0,20000,-20000,-20000
20200212,049707,華通麥證94購02,1.10,1.31,1.10,1.31,+0.27,25.96,73000,7,86840,30000,43000,-13000,0,0,0,33000,43000,-10000,-10000
20200212,049708,滬深2X凱基94購02,0.57,0.57,0.57,0.57,-0.02,-3.39,10000,1,5700,0,0,0,0,0,0,10000,0,10000,10000
20200212,049709,力山凱基94購04,,,,,0.00,0.00,0,0,0,0,0,0,0,0,0,0,0,0,0
20200212,04970P,中環元富94售02,2.02,2.04,2.01,2.04,+0.11,5.7,81000,4,163610,0,0,0,0,0,0,81000,0,81000,81000
20200212,049710,大成鋼凱基94購03,,,,,0.00,0.00,0,0,0,0,0,0,0,0,0,0,0,0,0
20200212,049711,劍麟凱基94購01,,,,,0.00,0.00,0,0,0,0,0,0,0,0,0,0,0,0,0
20200212,049712,為升凱基94購03,,,,,0.00,0.00,0,0,0,0,0,0,0,0,0,0,0,0,0
20200212,049713,鴻海凱基94購17,3.67,4.17,0.51,4.17,+0.81,24.11,124000,6,433980,0,0,0,0,0,0,79000,45000,34000,34000
20200212,049714,國巨凱基94購02,6.05,6.50,6.05,6.50,+0.45,7.44,132000,18,821500,0,0,0,0,0,0,132000,122000,10000,10000
20200212,049715,華泰凱基94購02,,,,,0.00,0.00,0,0,0,0,0,0,0,0,0,0,0,0,0
20200212,049716,台積電凱基94購24,,,,,0.00,0.00,0,0,0,0,0,0,0,0,0,0,0,0,0
20200212,049717,微星凱基94購01,1.11,1.12,0.99,0.99,-0.03,-2.94,32000,5,34490,0,0,0,0,0,0,22000,10000,12000,12000
20200212,049718,南亞科凱基94購04,,,,,0.00,0.00,0,0,0,0,0,0,0,0,0,0,0,0,0
20200212,049719,義隆凱基94購03,0.71,0.71,0.67,0.67,+0.08,13.56,200000,3,134400,0,0,0,0,0,0,200000,0,200000,200000
20200212,04971P,矽力元富94售02,0.56,0.56,0.51,0.51,-0.06,-10.53,15000,2,8150,0,0,0,0,0,0,10000,5000,5000,5000
20200212,049720,欣興凱基94購05,0.81,1.10,0.81,1.10,+0.42,61.76,107000,15,108020,0,0,0,0,0,0,35000,106000,-71000,-71000
20200212,049721,晶技凱基94購02,0.81,0.81,0.81,0.81,0.00,0.00,12000,1,9720,0,0,0,0,0,0,12000,0,12000,12000
20200212,049722,易華電凱基94購03,,,,,0.00,0.00,0,0,0,0,0,0,0,0,0,0,0,0,0
20200212,049723,緯穎凱基94購04,,,,,0.00,0.00,0,0,0,0,0,0,0,0,0,0,0,0,0
20200212,049724,南電第一94購01,0.20,0.30,0.20,0.30,+0.08,36.36,368000,23,99680,0,0,0,0,0,0,89000,279000,-190000,-190000
20200212,049725,台郡國票94購03,3.62,3.65,3.52,3.65,+1.96,115.98,98000,18,352000,0,0,0,0,0,0,36000,62000,-26000,-26000
20200212,049726,道瓊反中信96購01,,,,,0.00,0.00,0,0,0,0,0,0,0,0,0,0,0,0,0
20200212,049727,台積電中信94購02,2.15,2.21,2.15,2.21,+0.24,12.18,44000,4,96500,0,0,0,0,0,0,24000,20000,4000,4000
20200212,049728,正崴中信94購01,0.11,0.11,0.11,0.11,0.00,0.00,500000,2,55000,0,0,0,0,0,0,0,500000,-500000,-500000
20200212,049729,日月光中信94購01,,,,,0.00,0.00,0,0,0,0,0,0,0,0,0,0,0,0,0
20200212,04972P,緯穎元富94售03,0.38,0.39,0.37,0.37,0.00,0.00,251000,5,95280,0,0,0,0,0,0,141000,110000,31000,31000
20200212,049730,滬深2X群益94購02,,,,,0.00,0.00,0,0,0,0,0,0,0,0,0,0,0,0,0
20200212,049731,A50正2群益94購02,0.06,0.06,0.06,0.06,0.00,0.00,100000,2,6000,0,0,0,0,0,0,0,100000,-100000,-100000
20200212,049732,國巨群益94購05,,,,,0.00,0.00,0,0,0,0,0,0,0,0,0,0,0,0,0
20200212,049733,旺宏群益94購03,1.79,1.79,1.79,1.79,+0.13,7.83,11000,1,19690,0,0,0,0,0,0,0,11000,-11000,-11000
20200212,049734,瑞昱群益94購02,1.29,1.48,1.28,1.30,+0.10,8.33,171000,10,224250,0,0,0,0,0,0,78000,93000,-15000,-15000
20200212,049735,台光電群益94購03,0.68,0.96,0.68,0.91,+0.26,40.0,659000,55,539900,0,0,0,0,0,0,263000,396000,-133000,-133000
20200212,049736,宏達電群益95購03,0.15,0.15,0.15,0.15,+0.03,25.0,150000,1,22500,0,0,0,0,0,0,150000,0,150000,150000
20200212,049737,美食群益94購03,0.12,0.12,0.12,0.12,0.00,0.00,149000,8,17880,0,0,0,0,0,0,0,149000,-149000,-149000
20200212,049738,神基群益94購01,1.15,1.21,1.15,1.21,+0.01,0.83,92000,12,107160,0,0,0,0,0,0,28000,64000,-36000,-36000
20200212,049739,大立光群益94購05,0.30,0.31,0.29,0.31,+0.07,29.17,320000,9,95500,0,0,0,0,0,0,240000,40000,200000,200000
20200212,04973P,台積電凱基94售41,,,,,0.00,0.00,0,0,0,0,0,0,0,0,0,0,0,0,0
20200212,049740,禾伸堂群益94購01,1.36,1.44,1.32,1.44,+0.05,3.6,168000,19,226440,0,0,0,0,0,0,127000,40000,87000,87000
20200212,049741,創意群益94購02,0.36,0.40,0.31,0.39,-0.06,-13.33,236000,15,82250,0,0,0,0,0,0,138000,106000,32000,32000
20200212,049742,日月光群益94購02,0.73,0.87,0.72,0.84,+0.17,25.37,83000,18,66810,0,0,0,0,0,0,21000,61000,-40000,-40000
20200212,049743,全新台新94購01,0.65,0.85,0.63,0.85,+0.25,41.67,448000,28,348360,0,0,0,0,0,0,121000,296000,-175000,-175000
20200212,049744,亞德客永豐94購01,1.18,1.37,1.16,1.31,+0.02,1.55,639000,40,813100,0,0,0,0,0,0,625000,113000,512000,512000
20200212,049745,國巨永豐94購04,2.59,2.84,2.59,2.81,+0.27,10.63,296000,40,810610,0,0,0,0,0,0,166000,129000,37000,37000
20200212,049746,全新永豐95購01,,,,,0.00,0.00,0,0,0,0,0,0,0,0,0,0,0,0,0
20200212,049747,嘉晶永豐94購02,,,,,0.00,0.00,0,0,0,0,0,0,0,0,0,0,0,0,0
20200212,049748,智原永豐94購01,,,,,0.00,0.00,0,0,0,0,0,0,0,0,0,0,0,0,0
20200212,049749,創意永豐94購01,,,,,0.00,0.00,0,0,0,0,0,0,0,0,0,0,0,0,0
20200212,04974P,聯發科凱基96售02,1.38,1.42,0.69,1.35,-0.19,-12.34,181000,6,242480,0,0,0,0,0,0,150000,31000,119000,119000
20200212,049750,揚明光永豐94購02,,,,,0.00,0.00,0,0,0,0,0,0,0,0,0,0,0,0,0
20200212,049751,牧德永豐95購01,2.05,2.05,2.05,2.05,-0.08,-3.76,2000,1,4100,0,0,0,0,0,0,2000,0,2000,2000
20200212,049752,上緯控永豐94購02,,,,,0.00,0.00,0,0,0,0,0,0,0,0,0,0,0,0,0
20200212,049753,傳奇永豐94購01,,,,,0.00,0.00,0,0,0,0,0,0,0,0,0,0,0,0,0
20200212,049754,豐祥永豐94購01,0.20,0.20,0.20,0.20,0.00,0.00,31000,2,6200,0,0,0,0,0,0,31000,0,31000,31000
20200212,049755,中磊永豐94購02,0.06,0.06,0.06,0.06,0.00,0.00,10000,1,600,0,0,0,0,0,0,0,10000,-10000,-10000
20200212,049756,瀚宇博永豐94購01,,,,,0.00,0.00,0,0,0,0,0,0,0,0,0,0,0,0,0
20200212,049757,聯茂永豐94購01,,,,,0.00,0.00,0,0,0,0,0,0,0,0,0,0,0,0,0
20200212,049758,GIS永豐94購01,,,,,0.00,0.00,0,0,0,0,0,0,0,0,0,0,0,0,0
20200212,049759,元黃金富邦9A購01,,,,,0.00,0.00,0,0,0,0,0,0,0,0,0,0,0,0,0
20200212,04975P,華新科凱基96售02,,,,,0.00,0.00,0,0,0,0,0,0,0,0,0,0,0,0,0
20200212,049760,滬深2X國泰95購02,,,,,0.00,0.00,0,0,0,0,0,0,0,0,0,0,0,0,0
20200212,049761,亞德客國泰95購03,4.55,4.72,4.50,4.72,-0.24,-4.84,210000,6,982930,0,0,0,0,0,0,210000,0,210000,210000
20200212,049762,華邦電國泰95購01,0.99,1.09,0.99,1.03,+0.10,10.75,284000,31,296400,0,0,0,0,0,0,131000,165000,-34000,-34000
20200212,049763,美食國泰96購01,0.21,0.27,0.21,0.24,+0.05,26.32,1535000,14,389750,0,0,0,0,0,0,850000,685000,165000,165000
20200212,049764,TPK國泰95購01,,,,,0.00,0.00,0,0,0,0,0,0,0,0,0,0,0,0,0
20200212,049765,上証2X元富94購01,,,,,0.00,0.00,0,0,0,0,0,0,0,0,0,0,0,0,0
20200212,049766,滬深2X元富94購02,0.85,0.87,0.81,0.87,0.00,0.00,426000,7,358270,0,0,0,0,0,0,311000,426000,-115000,-115000
20200212,049767,奇力新元富94購01,,,,,0.00,0.00,0,0,0,0,0,0,0,0,0,0,0,0,0
20200212,049768,奇鋐元富94購01,,,,,0.00,0.00,0,0,0,0,0,0,0,0,0,0,0,0,0
20200212,049769,和鑫元富96購01,0.55,0.57,0.55,0.57,+0.05,9.62,49000,14,27540,0,0,0,0,0,0,7000,42000,-35000,-35000
20200212,04976P,中磊凱基94售01,,,,,0.00,0.00,0,0,0,0,0,0,0,0,0,0,0,0,0
20200212,049770,康控元富95購01,0.30,0.32,0.30,0.31,+0.05,19.23,225000,8,70330,0,0,0,0,0,0,10000,210000,-200000,-200000
20200212,049771,GIS元富94購02,0.58,0.62,0.58,0.60,+0.11,22.45,96000,23,57450,0,0,0,0,0,0,1000,96000,-95000,-95000
20200212,049772,臺股指元富94購01,,,,,0.00,0.00,0,0,0,0,0,0,0,0,0,0,0,0,0
20200212,049773,臺股指元富94購02,1.73,1.98,1.73,1.98,+0.44,28.57,57000,9,101850,0,0,0,0,0,0,45000,12000,33000,33000
20200212,049774,元油2X統一94購05,,,,,0.00,0.00,0,0,0,0,0,0,0,0,0,0,0,0,0
20200212,049775,旺宏統一95購02,2.01,2.06,2.01,2.06,+0.04,1.98,42000,3,84470,0,0,0,0,0,0,42000,2000,40000,40000
20200212,049776,全新統一95購02,0.43,0.54,0.43,0.52,+0.13,33.33,247000,17,125120,0,0,0,0,0,0,214000,30000,184000,184000
20200212,049777,華新科統一94購06,,,,,0.00,0.00,0,0,0,0,0,0,0,0,0,0,0,0,0
20200212,049778,宏達電統一94購02,0.25,0.25,0.25,0.25,+0.01,4.17,1000,1,250,0,0,0,0,0,0,1000,0,1000,1000
20200212,049779,創意統一95購01,0.33,0.33,0.30,0.30,-0.08,-21.05,106000,26,34170,0,0,0,0,0,0,106000,0,106000,106000
20200212,04977P,力成凱基96售01,0.39,0.39,0.38,0.38,-0.07,-15.56,13000,3,5050,0,0,0,0,0,0,3000,10000,-7000,-7000
20200212,049780,智易統一94購02,0.59,0.73,0.59,0.67,+0.18,36.73,410000,31,269720,0,0,0,0,0,0,204000,206000,-2000,-2000
20200212,049781,台表科統一94購01,,,,,0.00,0.00,0,0,0,0,0,0,0,0,0,0,0,0,0
20200212,049782,世紀鋼統一94購01,,,,,0.00,0.00,0,0,0,0,0,0,0,0,0,0,0,0,0
20200212,049783,元油2X兆豐95購01,0.24,0.30,0.24,0.30,+0.07,30.43,2047000,12,521880,0,0,0,0,0,0,2016000,2047000,-31000,-31000
20200212,049784,台積電兆豐94購05,5.95,5.95,5.95,5.95,0.00,0.00,3000,1,17850,0,0,0,0,0,0,3000,0,3000,3000
20200212,049785,華新科兆豐95購01,1.72,1.79,1.66,1.72,+0.06,3.61,188000,20,326960,0,0,0,0,0,0,174000,14000,160000,160000
20200212,049786,奇鋐兆豐94購01,,,,,0.00,0.00,0,0,0,0,0,0,0,0,0,0,0,0,0
20200212,049787,麗豐兆豐94購01,,,,,0.00,0.00,0,0,0,0,0,0,0,0,0,0,0,0,0
20200212,049788,智伸科兆豐95購01,0.63,0.63,0.63,0.63,0.00,0.00,50000,1,31500,0,0,0,0,0,0,50000,0,50000,50000
20200212,049789,世紀鋼兆豐94購01,,,,,0.00,0.00,0,0,0,0,0,0,0,0,0,0,0,0,0
20200212,04978P,台表科凱基94售02,,,,,0.00,0.00,0,0,0,0,0,0,0,0,0,0,0,0,0
20200212,049790,滬深2X元大97購04,,,,,0.00,0.00,0,0,0,0,0,0,0,0,0,0,0,0,0
20200212,049791,元油2X元大94購07,,,,,0.00,0.00,0,0,0,0,0,0,0,0,0,0,0,0,0
20200212,049792,元油2X元大94購08,0.43,0.43,0.43,0.43,+0.04,10.26,300000,2,129000,0,0,0,0,0,0,300000,0,300000,300000
20200212,049793,為升元大94購04,0.60,0.63,0.60,0.63,-0.02,-3.08,110000,2,66300,0,0,0,0,0,0,10000,110000,-100000,-100000
20200212,049794,台達電元大94購10,2.03,2.15,2.03,2.15,+0.02,0.94,72000,4,147960,0,0,0,0,0,0,0,72000,-72000,-72000
20200212,049795,華通元大96購02,0.72,0.98,0.70,0.97,+0.32,49.23,1207000,51,1039620,0,0,0,0,0,0,826000,417000,409000,409000
20200212,049796,國巨元大94購10,,,,,0.00,0.00,0,0,0,0,0,0,0,0,0,0,0,0,0
20200212,049797,台積電元大94購17,3.49,3.53,3.49,3.53,+0.14,4.13,18000,10,63500,0,0,0,0,0,0,18000,18000,0,0
20200212,049798,台積電元大94購18,2.03,2.14,1.98,2.14,+0.19,9.74,357000,22,727110,0,0,0,0,0,0,321000,125000,196000,196000
20200212,049799,旺宏元大96購01,1.67,1.74,1.66,1.66,-0.03,-1.78,6000,6,10160,0,0,0,0,0,0,6000,5000,1000,1000
20200212,04979P,臺股指凱基96售07,0.62,0.62,0.60,0.60,-0.11,-15.49,60000,2,36200,0,0,0,0,0,0,10000,50000,-40000,-40000
20200212,049800,瑞昱元大94購05,2.54,2.86,2.54,2.79,+0.23,8.98,49000,14,134240,0,0,0,0,0,0,15000,39000,-24000,-24000
20200212,049801,可成元大94購09,,,,,0.00,0.00,0,0,0,0,0,0,0,0,0,0,0,0,0
20200212,049802,可成元大94購10,0.47,0.50,0.47,0.50,0.00,0.00,11000,2,5200,0,0,0,0,0,0,0,11000,-11000,-11000
20200212,049803,華新科元大95購07,2.18,2.18,2.13,2.14,+0.04,1.9,13000,4,28000,0,0,0,0,0,0,13000,0,13000,13000
20200212,049804,華固元大94購01,,,,,0.00,0.00,0,0,0,0,0,0,0,0,0,0,0,0,0
20200212,049805,美食元大94購02,,,,,0.00,0.00,0,0,0,0,0,0,0,0,0,0,0,0,0
20200212,049806,臺企銀元大94購01,,,,,0.00,0.00,0,0,0,0,0,0,0,0,0,0,0,0,0
20200212,049807,新光金元大96購02,0.51,0.51,0.51,0.51,-0.01,-1.92,45000,1,22950,0,0,0,0,0,0,45000,0,45000,45000
20200212,049808,聯詠元大94購03,4.06,4.26,4.06,4.26,+0.36,9.23,23000,3,94780,0,0,0,0,0,0,23000,0,23000,23000
20200212,049809,聯詠元大94購04,4.36,4.55,4.36,4.55,+0.38,9.11,6000,4,26710,0,0,0,0,0,0,5000,5000,0,0
20200212,04980P,臺股指凱基96售08,0.55,0.55,0.50,0.50,-0.07,-12.28,1826000,69,958410,0,0,0,0,0,0,305000,1299000,-994000,-994000
20200212,049810,欣興元大95購03,,,,,0.00,0.00,0,0,0,0,0,0,0,0,0,0,0,0,0
20200212,049811,聯鈞元大94購01,2.42,2.71,2.41,2.71,+0.44,19.38,55000,11,139450,0,0,0,0,0,0,20000,25000,-5000,-5000
20200212,049812,致伸元大94購03,0.52,0.54,0.51,0.54,+0.02,3.85,397000,5,205060,0,0,0,0,0,0,310000,100000,210000,210000
20200212,049813,康控元大96購02,0.27,0.27,0.27,0.27,0.00,0.00,100000,1,27000,0,0,0,0,0,0,100000,0,100000,100000
20200212,049814,超眾元大95購04,0.52,0.60,0.52,0.60,+0.05,9.09,350000,4,206920,0,0,0,0,0,0,101000,249000,-148000,-148000
20200212,049815,緯穎元大94購06,9.85,10.50,9.85,10.50,+0.75,7.69,16000,4,160750,0,0,0,0,0,0,16000,6000,10000,10000
20200212,049816,緯穎元大94購07,9.95,10.00,9.85,9.85,-0.15,-1.5,12000,3,119800,0,0,0,0,0,0,12000,2000,10000,10000
20200212,049817,南電元大94購07,0.37,0.37,0.37,0.37,0.00,0.00,50000,1,18500,0,0,0,0,0,0,0,50000,-50000,-50000
20200212,049818,柏文元大94購01,,,,,0.00,0.00,0,0,0,0,0,0,0,0,0,0,0,0,0
20200212,049819,百和元大94購02,,,,,0.00,0.00,0,0,0,0,0,0,0,0,0,0,0,0,0
20200212,04981P,華新科亞東94售01,,,,,0.00,0.00,0,0,0,0,0,0,0,0,0,0,0,0,0
20200212,049820,世紀鋼元大96購03,0.55,0.55,0.55,0.55,-0.01,-1.79,6000,3,3300,0,0,0,0,0,0,5000,1000,4000,4000
20200212,049821,中石化凱基94購02,,,,,0.00,0.00,0,0,0,0,0,0,0,0,0,0,0,0,0
20200212,049822,大成鋼凱基94購04,,,,,0.00,0.00,0,0,0,0,0,0,0,0,0,0,0,0,0
20200212,049823,為升凱基94購04,,,,,0.00,0.00,0,0,0,0,0,0,0,0,0,0,0,0,0
20200212,049824,鴻海凱基94購18,0.14,0.19,0.14,0.19,+0.05,35.71,97000,12,15470,0,0,0,0,0,0,0,97000,-97000,-97000
20200212,049825,台積電凱基94購26,0.83,0.90,0.83,0.90,+0.12,15.38,110000,6,94200,0,0,0,0,0,0,90000,0,90000,90000
20200212,049826,光磊凱基94購02,0.43,0.45,0.43,0.45,-0.04,-8.16,115000,7,50460,0,0,0,0,0,0,115000,0,115000,115000
20200212,049827,正崴凱基94購01,,,,,0.00,0.00,0,0,0,0,0,0,0,0,0,0,0,0,0
20200212,049828,華新科凱基94購06,3.42,3.42,3.28,3.32,+0.12,3.75,33000,7,110160,0,0,0,0,0,0,28000,7000,21000,21000
20200212,049829,裕民凱基94購01,,,,,0.00,0.00,0,0,0,0,0,0,0,0,0,0,0,0,0
20200212,04982P,臺股指中信94售03,,,,,0.00,0.00,0,0,0,0,0,0,0,0,0,0,0,0,0
20200212,049830,智易凱基94購02,0.30,0.30,0.28,0.30,0.00,0.00,200000,4,58650,0,0,0,0,0,0,100000,100000,0,0
20200212,049831,日月光凱基94購01,0.20,0.26,0.20,0.26,+0.07,36.84,75000,4,18900,0,0,0,0,0,0,15000,60000,-45000,-45000
20200212,049832,麗豐凱基94購05,,,,,0.00,0.00,0,0,0,0,0,0,0,0,0,0,0,0,0
20200212,049833,正文凱基94購05,0.34,0.34,0.34,0.34,+0.01,3.03,30000,1,10200,0,0,0,0,0,0,0,30000,-30000,-30000
20200212,049834,康控凱基94購01,0.31,0.31,0.31,0.31,0.00,0.00,6000,1,1860,0,0,0,0,0,0,0,6000,-6000,-6000
20200212,049835,緯穎凱基94購05,5.05,5.40,4.96,5.40,+0.20,3.85,53000,9,267360,0,0,0,0,0,0,53000,29000,24000,24000
20200212,049836,矽創凱基94購02,0.61,0.61,0.61,0.61,+0.18,41.86,6000,1,3660,0,0,0,0,0,0,0,6000,-6000,-6000
20200212,049837,臺股指凱基96購02,0.95,1.02,0.95,1.02,+0.21,25.93,30000,4,29640,0,0,0,0,0,0,0,30000,-30000,-30000
20200212,049838,友達亞東94購01,,,,,0.00,0.00,0,0,0,0,0,0,0,0,0,0,0,0,0
20200212,049839,聯發科亞東94購02,,,,,0.00,0.00,0,0,0,0,0,0,0,0,0,0,0,0,0
20200212,04983P,臺股指康和94售03,0.29,0.29,0.29,0.29,0.00,0.00,70000,2,20300,0,0,0,0,0,0,70000,0,70000,70000
20200212,049840,亞光亞東94購01,,,,,0.00,0.00,0,0,0,0,0,0,0,0,0,0,0,0,0
20200212,049841,國巨第一94購01,,,,,0.00,0.00,0,0,0,0,0,0,0,0,0,0,0,0,0
20200212,049842,道瓊反中信98購01,,,,,0.00,0.00,0,0,0,0,0,0,0,0,0,0,0,0,0
20200212,049843,康友中信95購01,1.54,1.67,1.54,1.60,0.00,0.00,242000,31,395880,0,0,0,0,0,0,77000,206000,-129000,-129000
20200212,049844,國巨麥證94購01,,,,,0.00,0.00,0,0,0,0,0,0,0,0,0,0,0,0,0
20200212,049845,台積電麥證94購01,2.71,2.80,2.71,2.80,+0.26,10.24,50000,3,136400,40000,10000,30000,0,0,0,40000,10000,30000,30000
20200212,049846,台泥群益94購01,1.57,1.57,1.57,1.57,+0.03,1.95,10000,2,15700,0,0,0,0,0,0,10000,0,10000,10000
20200212,049847,旺宏群益94購04,3.63,3.74,3.63,3.74,+0.24,6.86,20000,2,73700,0,0,0,0,0,0,10000,10000,0,0
20200212,049848,聯發科群益94購06,1.73,2.15,1.71,2.03,+0.61,42.96,348000,39,666630,0,0,0,0,0,0,190000,153000,37000,37000
20200212,049849,欣興群益94購04,0.33,0.37,0.31,0.37,+0.05,15.62,180000,5,60000,0,0,0,0,0,0,160000,0,160000,160000
20200212,04984P,臺股指康和94售04,0.36,0.36,0.34,0.34,-0.08,-19.05,40000,2,14200,0,0,0,0,0,0,0,40000,-40000,-40000
20200212,049850,上緯控群益94購01,,,,,0.00,0.00,0,0,0,0,0,0,0,0,0,0,0,0,0
20200212,049851,致伸群益94購03,0.16,0.16,0.16,0.16,+0.03,23.08,20000,1,3200,0,0,0,0,0,0,20000,0,20000,20000
20200212,049852,康控群益94購03,0.22,0.22,0.22,0.22,+0.02,10.0,100000,1,22000,0,0,0,0,0,0,100000,0,100000,100000
20200212,049853,上海銀群益94購02,0.28,0.28,0.27,0.27,0.00,0.00,157000,2,42460,0,0,0,0,0,0,157000,0,157000,157000
20200212,049854,超眾群益94購02,0.44,0.46,0.42,0.46,+0.01,2.22,125000,17,53600,0,0,0,0,0,0,115000,10000,105000,105000
20200212,049855,台表科群益94購01,3.78,4.16,3.77,4.16,+0.42,11.23,179000,11,701340,0,0,0,0,0,0,39000,140000,-101000,-101000
20200212,049856,緯穎群益94購02,,,,,0.00,0.00,0,0,0,0,0,0,0,0,0,0,0,0,0
20200212,049857,緯穎群益94購03,9.90,10.70,9.90,10.60,+1.15,12.17,31000,8,317900,0,0,0,0,0,0,21000,31000,-10000,-10000
20200212,049858,百和群益94購05,1.51,1.51,1.51,1.51,-0.09,-5.62,15000,2,22650,0,0,0,0,0,0,0,15000,-15000,-15000
20200212,049859,味全兆豐95購01,,,,,0.00,0.00,0,0,0,0,0,0,0,0,0,0,0,0,0
20200212,04985P,景碩永豐94售02,,,,,0.00,0.00,0,0,0,0,0,0,0,0,0,0,0,0,0
20200212,049860,亞德客兆豐94購01,1.66,1.66,1.66,1.66,+0.01,0.61,10000,1,16600,0,0,0,0,0,0,10000,0,10000,10000
20200212,049861,正崴兆豐94購01,0.50,0.50,0.49,0.49,-0.01,-2.0,147000,2,73030,0,0,0,0,0,0,147000,0,147000,147000
20200212,049862,南亞科兆豐94購01,,,,,0.00,0.00,0,0,0,0,0,0,0,0,0,0,0,0,0
20200212,049863,京元電兆豐94購01,0.46,0.50,0.46,0.48,+0.04,9.09,432000,33,205390,0,0,0,0,0,0,326000,0,326000,326000
20200212,049864,聯發科兆豐94購01,1.09,1.14,1.08,1.14,+0.17,17.53,266000,5,293770,0,0,0,0,0,0,166000,100000,66000,66000
20200212,049865,和鑫兆豐95購01,,,,,0.00,0.00,0,0,0,0,0,0,0,0,0,0,0,0,0
20200212,049866,景碩兆豐94購01,1.05,1.24,1.02,1.21,+0.20,19.8,247000,30,264950,0,0,0,0,0,0,205000,42000,163000,163000
20200212,049867,日月光兆豐94購01,0.54,0.61,0.54,0.61,+0.13,27.08,293000,8,171400,0,0,0,0,0,0,0,293000,-293000,-293000
20200212,049868,傳奇兆豐94購01,,,,,0.00,0.00,0,0,0,0,0,0,0,0,0,0,0,0,0
20200212,049869,訊芯兆豐94購01,0.29,0.38,0.29,0.38,+0.08,26.67,1050000,36,362040,0,0,0,0,0,0,474000,523000,-49000,-49000
20200212,04986P,茂林永豐94售05,,,,,0.00,0.00,0,0,0,0,0,0,0,0,0,0,0,0,0
20200212,049870,南電兆豐94購01,0.25,0.25,0.25,0.25,+0.06,31.58,1000,1,250,0,0,0,0,0,0,0,1000,-1000,-1000
20200212,049871,T50反1台新9A購02,0.30,0.30,0.30,0.30,0.00,0.00,5000,1,1500,0,0,0,0,0,0,0,5000,-5000,-5000
20200212,049872,聯發科台新94購03,1.69,1.82,1.69,1.82,+0.33,22.15,11000,3,19630,0,0,0,0,0,0,3000,8000,-5000,-5000
20200212,049873,華新科台新94購02,,,,,0.00,0.00,0,0,0,0,0,0,0,0,0,0,0,0,0
20200212,049874,全新康和94購01,0.38,0.49,0.38,0.49,+0.16,48.48,98000,21,41820,0,0,0,0,0,0,29000,69000,-40000,-40000
20200212,049875,台積電永豐94購04,1.48,1.59,1.48,1.56,+0.12,8.33,370000,30,567900,0,0,0,0,0,0,214000,144000,70000,70000
20200212,049876,智邦永豐94購01,,,,,0.00,0.00,0,0,0,0,0,0,0,0,0,0,0,0,0
20200212,049877,南亞科永豐94購01,1.37,1.38,1.33,1.35,-0.07,-4.93,140000,7,190160,0,0,0,0,0,0,72000,68000,4000,4000
20200212,049878,宏達電永豐94購01,0.37,0.37,0.37,0.37,+0.02,5.71,50000,1,18500,0,0,0,0,0,0,50000,0,50000,50000
20200212,049879,奇鋐永豐94購02,,,,,0.00,0.00,0,0,0,0,0,0,0,0,0,0,0,0,0
20200212,04987P,昇陽半永豐94售04,,,,,0.00,0.00,0,0,0,0,0,0,0,0,0,0,0,0,0
20200212,049880,健策永豐94購02,2.65,2.81,2.52,2.81,+0.31,12.4,421000,56,1120650,0,0,0,0,0,0,211000,222000,-11000,-11000
20200212,049881,TPK永豐94購02,,,,,0.00,0.00,0,0,0,0,0,0,0,0,0,0,0,0,0
20200212,049882,康控永豐94購01,,,,,0.00,0.00,0,0,0,0,0,0,0,0,0,0,0,0,0
20200212,049883,台表科永豐94購02,,,,,0.00,0.00,0,0,0,0,0,0,0,0,0,0,0,0,0
20200212,049884,訊芯永豐94購01,0.18,0.18,0.18,0.18,+0.04,28.57,50000,1,9000,0,0,0,0,0,0,0,50000,-50000,-50000
20200212,049885,緯穎永豐94購01,2.83,3.09,2.72,3.09,+0.24,8.42,121000,15,348290,0,0,0,0,0,0,86000,35000,51000,51000
20200212,049886,華通永昌95購01,2.98,3.72,2.98,3.72,0.00,0.00,5000,2,15640,0,0,0,0,0,0,0,5000,-5000,-5000
20200212,049887,嘉聯益永昌95購01,,,,,0.00,0.00,0,0,0,0,0,0,0,0,0,0,0,0,0
20200212,049888,智邦國泰96購01,1.71,1.83,1.57,1.60,+0.09,5.96,179000,24,294730,0,0,0,0,0,0,33000,135000,-102000,-102000
20200212,049889,欣興國泰96購01,0.68,0.70,0.68,0.70,+0.16,29.63,7000,2,4780,0,1000,-1000,0,0,0,7000,0,7000,6000
20200212,04988P,楠梓電元大94售01,,,,,0.00,0.00,0,0,0,0,0,0,0,0,0,0,0,0,0
20200212,049890,嘉澤國泰95購01,3.03,3.17,3.03,3.17,-0.01,-0.31,51000,3,156650,0,0,0,0,0,0,35000,16000,19000,19000
20200212,049891,T50反1富邦94購02,0.15,0.15,0.15,0.15,-0.02,-11.76,222000,4,33300,0,0,0,0,0,0,132000,90000,42000,42000
20200212,049892,國巨富邦96購01,2.97,3.04,2.92,3.04,+0.15,5.19,177000,17,526750,0,0,0,0,0,0,158000,5000,153000,153000
20200212,049893,日月光富邦98購01,0.89,0.95,0.89,0.93,+0.09,10.71,241000,12,224650,0,0,0,0,0,0,202000,31000,171000,171000
20200212,049894,嘉聯益富邦98購01,0.52,0.55,0.51,0.53,+0.02,3.92,316000,18,170540,0,0,0,0,0,0,200000,116000,84000,84000
20200212,049895,國巨統一94購04,,,,,0.00,0.00,0,0,0,0,0,0,0,0,0,0,0,0,0
20200212,049896,聯發科統一94購06,1.71,1.92,1.71,1.88,+0.35,22.88,159000,5,284640,0,0,0,0,0,0,96000,63000,33000,33000
20200212,049897,華新科統一94購07,2.99,3.02,2.93,2.93,+0.09,3.17,90000,9,267480,0,0,0,0,0,0,72000,18000,54000,54000
20200212,049898,緯穎統一95購01,3.82,4.01,3.82,4.01,+0.27,7.22,10000,2,39150,0,0,0,0,0,0,10000,0,10000,10000
20200212,049899,台積電元富94購05,2.82,2.93,2.78,2.92,+0.20,7.35,298000,18,852460,0,0,0,0,0,0,140000,158000,-18000,-18000
20200212,04989P,國巨元大94售15,,,,,0.00,0.00,0,0,0,0,0,0,0,0,0,0,0,0,0
20200212,049900,台積電元富94購06,2.62,2.74,2.55,2.74,+0.26,10.48,2616000,23,7034360,0,0,0,0,0,0,2048000,958000,1090000,1090000
20200212,049901,瑞昱元富94購01,3.38,3.78,3.38,3.41,+0.23,7.23,194000,9,713530,0,0,0,0,0,0,6000,188000,-182000,-182000
20200212,049902,大立光元富94購05,1.36,1.36,1.36,1.36,+0.25,22.52,81000,1,110160,0,0,0,0,0,0,81000,0,81000,81000
20200212,049903,大立光元富94購06,1.61,1.68,1.61,1.68,+0.33,24.44,61000,3,102010,0,0,0,0,0,0,6000,55000,-49000,-49000
20200212,049904,矽力元富94購01,3.61,4.04,3.61,4.04,+0.55,15.76,18000,3,67520,0,0,0,0,0,0,10000,8000,2000,2000
20200212,049905,為升元大94購05,,,,,0.00,0.00,0,0,0,0,0,0,0,0,0,0,0,0,0
20200212,049906,光寶科元大94購03,1.22,1.25,1.22,1.25,+0.03,2.46,52000,3,64940,0,0,0,0,0,0,0,52000,-52000,-52000
20200212,049907,鴻海元大94購07,4.53,4.87,4.53,4.81,+0.41,9.32,16000,3,74220,0,0,0,0,0,0,15000,1000,14000,14000
20200212,049908,鴻海元大94購08,4.79,4.83,4.79,4.83,+0.45,10.27,11000,2,53090,0,0,0,0,0,0,0,11000,-11000,-11000
20200212,049909,國巨元大95購01,3.21,3.22,3.15,3.22,+0.22,7.33,28000,5,89090,0,0,0,0,0,0,8000,20000,-12000,-12000
20200212,04990P,臻鼎元大94售04,2.44,2.68,2.44,2.68,0.00,0.00,107000,5,274780,0,0,0,0,0,0,0,107000,-107000,-107000
20200212,049910,智邦元大94購04,0.41,0.46,0.40,0.44,+0.11,33.33,222000,9,94920,0,0,0,0,0,0,121000,101000,20000,20000
20200212,049911,智邦元大94購05,0.98,1.08,0.79,0.86,+0.05,6.17,194000,21,191570,0,0,0,0,0,0,102000,104000,-2000,-2000
20200212,049912,燿華元大94購04,0.31,0.33,0.31,0.33,0.00,0.00,362000,4,119420,0,0,0,0,0,0,0,362000,-362000,-362000
20200212,049913,微星元大94購01,2.35,2.38,2.04,2.07,-0.02,-0.96,172000,18,377110,0,0,0,0,0,0,127000,111000,16000,16000
20200212,049914,瑞昱元大94購06,1.90,2.26,1.87,2.14,+0.29,15.68,133000,17,281980,0,0,0,0,0,0,80000,53000,27000,27000
20200212,049915,瑞昱元大94購07,2.03,2.39,2.00,2.15,+0.15,7.5,129000,24,288030,0,0,0,0,0,0,119000,22000,97000,97000
20200212,049916,台光電元大94購06,1.21,1.62,1.21,1.62,+0.42,35.0,287000,16,403970,0,0,0,0,0,0,30000,257000,-227000,-227000
20200212,049917,華新科元大94購02,5.10,5.10,4.91,5.05,+0.20,4.12,127000,29,635040,0,0,0,0,0,0,118000,47000,71000,71000
20200212,049918,宏達電元大94購01,,,,,0.00,0.00,0,0,0,0,0,0,0,0,0,0,0,0,0
20200212,049919,美食元大94購03,,,,,0.00,0.00,0,0,0,0,0,0,0,0,0,0,0,0,0
20200212,04991P,台表科元大94售05,0.70,0.70,0.70,0.70,-0.02,-2.78,5000,1,3500,0,0,0,0,0,0,5000,0,5000,5000
20200212,049920,大立光元大94購15,,,,,0.00,0.00,0,0,0,0,0,0,0,0,0,0,0,0,0
20200212,049921,大立光元大94購16,2.20,2.23,2.19,2.23,+0.32,16.75,57000,4,126850,0,0,0,0,0,0,57000,52000,5000,5000
20200212,049922,禾伸堂元大95購01,0.88,0.90,0.83,0.90,+0.04,4.65,819000,39,719530,0,0,0,0,0,0,392000,584000,-192000,-192000
20200212,049923,智原元大95購02,0.34,0.34,0.34,0.34,0.00,0.00,10000,2,3400,0,0,0,0,0,0,5000,5000,0,0
20200212,049924,欣興元大95購04,0.33,0.36,0.33,0.36,0.00,0.00,350000,3,124800,0,0,0,0,0,0,340000,10000,330000,330000
20200212,049925,創意元大95購02,0.36,0.37,0.36,0.37,-0.05,-11.9,75000,3,27650,0,0,0,0,0,0,10000,65000,-55000,-55000
20200212,049926,智易元大95購02,0.33,0.33,0.33,0.33,+0.09,37.5,150000,6,49500,0,0,0,0,0,0,0,150000,-150000,-150000
20200212,049927,健策元大94購02,9.30,9.35,9.00,9.00,+0.50,5.88,63000,10,581200,0,0,0,0,0,0,63000,12000,51000,51000
20200212,049928,祥碩元大94購02,,,,,0.00,0.00,0,0,0,0,0,0,0,0,0,0,0,0,0
20200212,049929,祥碩元大94購03,,,,,0.00,0.00,0,0,0,0,0,0,0,0,0,0,0,0,0
20200212,04992P,元油2X富邦97售04,,,,,0.00,0.00,0,0,0,0,0,0,0,0,0,0,0,0,0
20200212,049930,上海銀元大94購02,,,,,0.00,0.00,0,0,0,0,0,0,0,0,0,0,0,0,0
20200212,049931,矽力元大94購01,4.70,4.80,4.46,4.80,+0.55,12.94,41000,7,188800,0,0,0,0,0,0,39000,1000,38000,38000
20200212,049932,GIS元大94購03,,,,,0.00,0.00,0,0,0,0,0,0,0,0,0,0,0,0,0
20200212,049933,GIS元大95購01,0.50,0.51,0.50,0.51,+0.06,13.33,366000,8,185650,0,0,0,0,0,0,2000,366000,-364000,-364000
20200212,049934,緯穎元大94購08,8.95,9.85,8.70,9.75,+0.55,5.98,71000,17,662550,0,0,0,0,0,0,71000,68000,3000,3000
20200212,049935,南電元大94購08,0.59,0.78,0.57,0.75,+0.13,20.97,437000,18,307130,0,0,0,0,0,0,207000,236000,-29000,-29000
20200212,049936,柏文元大94購02,,,,,0.00,0.00,0,0,0,0,0,0,0,0,0,0,0,0,0
20200212,049937,臺股指元大94購18,3.80,3.93,3.80,3.93,+0.38,10.7,5000,3,19220,0,0,0,0,0,0,3000,2000,1000,1000
20200212,049938,臺股指元大94購19,,,,,0.00,0.00,0,0,0,0,0,0,0,0,0,0,0,0,0
20200212,049939,臺股指元大94購20,,,,,0.00,0.00,0,0,0,0,0,0,0,0,0,0,0,0,0
20200212,04993P,上銀兆豐96售01,0.57,0.58,0.57,0.58,-0.01,-1.69,172000,5,99040,0,0,0,0,0,0,50000,122000,-72000,-72000
20200212,049940,臺股指元大94購21,3.45,3.45,3.45,3.45,+0.15,4.55,3000,1,10350,0,0,0,0,0,0,3000,0,3000,3000
20200212,049941,臺股指元大94購24,2.93,2.93,2.93,2.93,0.00,0.00,20000,1,58600,0,0,0,0,0,0,20000,0,20000,20000
20200212,049942,奇力新亞東94購01,,,,,0.00,0.00,0,0,0,0,0,0,0,0,0,0,0,0,0
20200212,049943,聯詠第一94購01,,,,,0.00,0.00,0,0,0,0,0,0,0,0,0,0,0,0,0
20200212,049944,日月光第一94購01,,,,,0.00,0.00,0,0,0,0,0,0,0,0,0,0,0,0,0
20200212,049945,樺漢第一94購01,,,,,0.00,0.00,0,0,0,0,0,0,0,0,0,0,0,0,0
20200212,049946,智邦兆豐95購01,0.63,0.70,0.57,0.57,-0.02,-3.39,152000,10,93030,0,0,0,0,0,0,7000,145000,-138000,-138000
20200212,049947,S&P反1中信97購01,,,,,0.00,0.00,0,0,0,0,0,0,0,0,0,0,0,0,0
20200212,049948,聯發科麥證94購01,0.50,0.60,0.49,0.59,+0.16,37.21,81000,15,44970,36000,40000,-4000,0,0,0,36000,40000,-4000,-4000
20200212,049949,燿華群益96購01,0.39,0.47,0.39,0.47,+0.06,14.63,124000,10,55840,0,0,0,0,0,0,0,124000,-124000,-124000
20200212,04994P,大成鋼凱基95售01,,,,,0.00,0.00,0,0,0,0,0,0,0,0,0,0,0,0,0
20200212,049950,南亞科群益94購02,1.50,1.53,1.48,1.48,-0.04,-2.63,63000,6,94120,0,0,0,0,0,0,41000,27000,14000,14000
20200212,049951,全新群益94購03,0.30,0.43,0.30,0.43,+0.17,65.38,122000,27,46300,0,0,0,0,0,0,8000,114000,-106000,-106000
20200212,049952,強茂群益94購01,0.31,0.31,0.31,0.31,+0.02,6.9,22000,2,6820,0,0,0,0,0,0,0,22000,-22000,-22000
20200212,049953,華新科群益94購04,,,,,0.00,0.00,0,0,0,0,0,0,0,0,0,0,0,0,0
20200212,049954,健策群益95購01,,,,,0.00,0.00,0,0,0,0,0,0,0,0,0,0,0,0,0
20200212,049955,崇越群益95購01,3.90,4.17,3.90,4.17,0.00,0.00,35000,4,143250,0,0,0,0,0,0,0,35000,-35000,-35000
20200212,049956,國巨統一94購05,6.05,6.05,6.05,6.05,+0.60,11.01,18000,1,108900,0,0,0,0,0,0,18000,0,18000,18000
20200212,049957,智邦統一94購01,0.77,0.83,0.74,0.80,+0.15,23.08,292000,30,231300,0,0,0,0,0,0,250000,12000,238000,238000
20200212,049958,華新科統一94購08,5.05,5.10,5.05,5.10,+0.15,3.03,15000,2,76000,0,0,0,0,0,0,15000,0,15000,15000
20200212,049959,創意統一95購02,0.18,0.18,0.18,0.18,-0.02,-10.0,30000,1,5400,0,0,0,0,0,0,0,30000,-30000,-30000
20200212,04995P,台達電凱基96售03,1.05,1.05,0.99,0.99,-0.10,-9.17,114000,4,119460,0,0,0,0,0,0,114000,0,114000,114000
20200212,049960,嘉聯益統一94購01,0.40,0.40,0.38,0.38,+0.07,22.58,107000,3,42760,0,0,0,0,0,0,0,107000,-107000,-107000
20200212,049961,GIS統一94購01,0.20,0.22,0.20,0.22,0.00,0.00,220000,14,45220,0,0,0,0,0,0,6000,220000,-214000,-214000
20200212,049962,台光電元富94購01,0.35,0.51,0.35,0.51,+0.19,59.38,833000,43,344670,0,0,0,0,0,0,200000,623000,-423000,-423000
20200212,049963,聯發科元富94購02,2.11,2.34,2.11,2.34,+0.44,23.16,446000,11,992630,0,0,0,0,0,0,76000,405000,-329000,-329000
20200212,049964,強茂元富94購01,0.34,0.34,0.34,0.34,+0.02,6.25,50000,1,17000,0,0,0,0,0,0,0,50000,-50000,-50000
20200212,049965,矽創元富94購01,0.46,0.59,0.46,0.59,+0.14,31.11,175000,21,95900,0,0,0,0,0,0,96000,79000,17000,17000
20200212,049966,旺宏國票95購02,2.32,2.38,2.20,2.20,-0.09,-3.93,135000,4,304000,0,0,0,0,0,0,25000,110000,-85000,-85000
20200212,049967,華新科國票94購07,8.40,8.70,8.00,8.40,+0.45,5.66,205000,27,1714900,0,0,0,0,0,0,142000,63000,79000,79000
20200212,049968,麗豐國票95購01,0.45,0.45,0.45,0.45,+0.01,2.27,30000,1,13500,0,0,0,0,0,0,30000,0,30000,30000
20200212,049969,泰鼎國票95購01,2.32,2.32,2.32,2.32,+0.20,9.43,5000,1,11600,0,0,0,0,0,0,5000,0,5000,5000
20200212,04996P,台積電凱基95售02,,,,,0.00,0.00,0,0,0,0,0,0,0,0,0,0,0,0,0
20200212,049970,康控國票95購03,0.27,0.28,0.27,0.28,0.00,0.00,80000,2,21800,0,0,0,0,0,0,0,80000,-80000,-80000
20200212,049971,台郡國票95購01,5.45,6.00,5.25,5.55,+1.94,53.74,122000,18,685450,0,0,0,0,0,0,47000,50000,-3000,-3000
20200212,049972,南電國票95購02,0.31,0.31,0.31,0.31,0.00,0.00,72000,2,22320,0,0,0,0,0,0,0,72000,-72000,-72000
20200212,049973,T50反1日盛9A購01,,,,,0.00,0.00,0,0,0,0,0,0,0,0,0,0,0,0,0
20200212,049974,聯發科日盛94購02,1.08,1.30,1.08,1.21,+0.28,30.11,418000,27,498400,0,0,0,0,0,0,217000,201000,16000,16000
20200212,049975,力山凱基94購05,,,,,0.00,0.00,0,0,0,0,0,0,0,0,0,0,0,0,0
20200212,049976,台積電凱基94購28,1.03,1.03,1.03,1.03,+0.07,7.29,10000,1,10300,0,0,0,0,0,0,10000,0,10000,10000
20200212,049977,瑞昱凱基94購03,1.06,1.27,1.06,1.17,+0.09,8.33,371000,15,410900,0,0,0,0,0,0,200000,180000,20000,20000
20200212,049978,瑞昱凱基94購04,0.81,0.95,0.81,0.84,+0.04,5.0,134000,7,119020,0,0,0,0,0,0,73000,66000,7000,7000
20200212,049979,美律凱基94購07,0.29,0.29,0.29,0.29,0.00,0.00,10000,2,2900,0,0,0,0,0,0,0,10000,-10000,-10000
20200212,04997P,燿華台新95售02,,,,,0.00,0.00,0,0,0,0,0,0,0,0,0,0,0,0,0
20200212,049980,奇力新凱基94購04,5.40,5.85,5.40,5.85,+0.25,4.46,60000,14,340950,0,0,0,0,0,0,38000,39000,-1000,-1000
20200212,049981,臺企銀凱基94購01,0.25,0.25,0.25,0.25,-0.01,-3.85,90000,2,22500,0,0,0,0,0,0,0,90000,-90000,-90000
20200212,049982,嘉晶凱基94購01,0.92,1.14,0.92,1.14,+0.21,22.58,137000,16,144630,0,0,0,0,0,0,43000,124000,-81000,-81000
20200212,049983,智原凱基94購02,0.48,0.49,0.47,0.48,+0.01,2.13,90000,9,43040,0,0,0,0,0,0,90000,0,90000,90000
20200212,049984,揚明光凱基94購04,0.41,0.41,0.41,0.41,0.00,0.00,50000,1,20500,0,0,0,0,0,0,0,50000,-50000,-50000
20200212,049985,華擎凱基94購01,4.68,4.88,4.32,4.32,-0.22,-4.85,61000,11,279920,0,0,0,0,0,0,41000,20000,21000,21000
20200212,049986,嘉澤凱基94購02,2.21,2.30,2.04,2.04,-0.12,-5.56,51000,10,109630,0,0,0,0,0,0,16000,36000,-20000,-20000
20200212,049987,智易凱基94購03,,,,,0.00,0.00,0,0,0,0,0,0,0,0,0,0,0,0,0
20200212,049988,貿聯凱基94購02,0.49,0.60,0.48,0.60,+0.09,17.65,345000,19,193300,0,0,0,0,0,0,135000,200000,-65000,-65000
20200212,049989,臻鼎凱基94購02,0.28,0.28,0.28,0.28,+0.07,33.33,4000,1,1120,0,0,0,0,0,0,0,0,0,0
20200212,04998P,京元電永豐95售01,0.59,0.59,0.56,0.56,-0.05,-8.2,20000,2,11500,0,0,0,0,0,0,0,20000,-20000,-20000
20200212,049990,志超凱基94購03,,,,,0.00,0.00,0,0,0,0,0,0,0,0,0,0,0,0,0
20200212,049991,臺股指凱基96購04,1.04,1.04,1.04,1.04,0.00,0.00,1000,1,1040,0,0,0,0,0,0,1000,0,1000,1000
20200212,049992,國巨台新94購02,,,,,0.00,0.00,0,0,0,0,0,0,0,0,0,0,0,0,0
20200212,049993,奇力新台新94購02,,,,,0.00,0.00,0,0,0,0,0,0,0,0,0,0,0,0,0
20200212,049994,聯茂台新94購02,0.61,0.89,0.61,0.83,+0.37,80.43,276000,15,211160,0,0,0,0,0,0,78000,198000,-120000,-120000
20200212,049995,GIS台新94購01,0.28,0.28,0.28,0.28,0.00,0.00,1000,1,280,0,0,0,0,0,0,0,1000,-1000,-1000
20200212,049996,元油2X永豐94購05,0.37,0.39,0.37,0.39,+0.04,11.43,60000,4,23250,0,0,0,0,0,0,50000,10000,40000,40000
20200212,049997,聯發科永豐94購04,0.76,0.89,0.76,0.87,+0.23,35.94,786000,14,635930,0,0,0,0,0,0,178000,608000,-430000,-430000
20200212,049998,奇力新永豐94購03,3.45,3.63,3.38,3.63,+0.15,4.31,138000,37,478730,0,0,0,0,0,0,118000,20000,98000,98000
20200212,049999,義隆永豐94購01,,,,,0.00,0.00,0,0,0,0,0,0,0,0,0,0,0,0,0
20200212,04999P,南電永豐95售01,1.53,1.53,1.53,1.53,-0.22,-12.57,10000,1,15300,0,0,0,0,0,0,10000,0,10000,10000
20200212,050000,盟立永豐94購01,,,,,0.00,0.00,0,0,0,0,0,0,0,0,0,0,0,0,0
20200212,050001,奇鋐永豐94購03,,,,,0.00,0.00,0,0,0,0,0,0,0,0,0,0,0,0,0
20200212,050002,智原永豐94購02,0.31,0.33,0.31,0.33,0.00,0.00,150000,2,47500,0,0,0,0,0,0,0,150000,-150000,-150000
20200212,050003,景碩永豐94購01,0.70,0.95,0.68,0.84,+0.13,18.31,836000,61,655350,0,0,0,0,0,0,268000,568000,-300000,-300000
20200212,050004,明泰永豐94購01,0.11,0.11,0.11,0.11,0.00,0.00,99000,1,10890,0,0,0,0,0,0,99000,0,99000,99000
20200212,050005,京鼎永豐94購01,1.33,1.57,1.33,1.53,+0.32,26.45,358000,37,525090,0,0,0,0,0,0,44000,304000,-260000,-260000
20200212,050006,華擎永豐94購03,1.79,1.94,1.70,1.82,-0.06,-3.19,750000,36,1336620,0,0,0,0,0,0,138000,611000,-473000,-473000
20200212,050007,貿聯永豐94購01,0.33,0.33,0.33,0.33,0.00,0.00,20000,1,6600,0,0,0,0,0,0,20000,0,20000,20000
20200212,050008,超眾永豐94購02,0.20,0.23,0.20,0.22,0.00,0.00,105000,20,22640,0,0,0,0,0,0,105000,0,105000,105000
20200212,050009,昇陽半永豐94購02,0.14,0.14,0.13,0.13,0.00,0.00,60000,2,8300,0,0,0,0,0,0,0,60000,-60000,-60000
20200212,05000P,臺股指永豐95售01,0.66,0.66,0.57,0.59,-0.15,-20.27,395000,17,253760,0,0,0,0,0,0,10000,385000,-375000,-375000
20200212,050010,鈺齊永豐94購01,0.51,0.57,0.51,0.57,+0.06,11.76,109000,4,61380,0,0,0,0,0,0,79000,30000,49000,49000
20200212,050011,S&P反1國泰95購01,,,,,0.00,0.00,0,0,0,0,0,0,0,0,0,0,0,0,0
20200212,050012,台積電國泰95購03,12.20,12.20,12.20,12.20,+0.40,3.39,23000,2,280600,0,0,0,0,0,0,23000,0,23000,23000
20200212,050013,淘帝國泰95購01,0.71,0.71,0.71,0.71,0.00,0.00,60000,6,42600,0,0,0,0,0,0,0,60000,-60000,-60000
20200212,050014,國巨富邦98購01,3.60,3.78,3.50,3.78,+0.48,14.55,6000,5,21580,0,0,0,0,0,0,0,0,0,0
20200212,050015,友達富邦95購01,,,,,0.00,0.00,0,0,0,0,0,0,0,0,0,0,0,0,0
20200212,050016,緯穎富邦95購01,1.69,1.81,1.63,1.81,+0.13,7.74,79000,15,133730,0,0,0,0,0,0,69000,24000,45000,45000
20200212,050017,百和富邦94購01,,,,,0.00,0.00,0,0,0,0,0,0,0,0,0,0,0,0,0
20200212,050018,高股息元大94購02,0.82,0.85,0.82,0.85,+0.07,8.97,16000,3,13350,0,0,0,0,0,0,16000,0,16000,16000
20200212,050019,T50反1元大94購04,,,,,0.00,0.00,0,0,0,0,0,0,0,0,0,0,0,0,0
20200212,05001P,華通統一95售01,,,,,0.00,0.00,0,0,0,0,0,0,0,0,0,0,0,0,0
20200212,050020,為升元大94購06,,,,,0.00,0.00,0,0,0,0,0,0,0,0,0,0,0,0,0
20200212,050021,鴻海元大94購10,5.10,5.25,5.10,5.10,+0.52,11.35,18000,3,92100,0,0,0,0,0,0,2000,18000,-16000,-16000
20200212,050022,鴻海元大94購11,5.05,5.65,5.05,5.35,+0.37,7.43,17000,3,88550,0,0,0,0,0,0,17000,2000,15000,15000
20200212,050023,國巨元大94購12,10.30,10.60,10.20,10.60,+0.85,8.72,15000,9,155700,0,0,0,0,0,0,9000,15000,-6000,-6000
20200212,050024,旺宏元大94購09,4.61,4.86,4.51,4.51,-0.14,-3.01,8000,6,37320,0,0,0,0,0,0,8000,8000,0,0
20200212,050025,燿華元大94購05,,,,,0.00,0.00,0,0,0,0,0,0,0,0,0,0,0,0,0
20200212,050026,友達元大96購01,2.04,2.04,1.95,1.97,-0.13,-6.19,214000,7,417640,0,0,0,0,0,0,200000,12000,188000,188000
20200212,050027,義隆元大94購03,0.86,0.86,0.71,0.80,+0.17,26.98,41000,5,32000,0,0,0,0,0,0,30000,11000,19000,19000
20200212,050028,華新科元大94購03,8.20,8.20,7.90,8.05,+0.20,2.55,54000,10,435000,0,0,0,0,0,0,54000,25000,29000,29000
20200212,050029,美食元大94購04,,,,,0.00,0.00,0,0,0,0,0,0,0,0,0,0,0,0,0
20200212,05002P,台積電統一95售03,0.41,0.41,0.38,0.38,-0.09,-19.15,39000,5,15350,0,0,0,0,0,0,0,39000,-39000,-39000
20200212,050030,嘉晶元大94購03,0.95,1.10,0.95,1.03,+0.14,15.73,237000,13,241620,0,0,0,0,0,0,93000,144000,-51000,-51000
20200212,050031,嘉澤元大95購01,1.55,1.55,1.39,1.42,-0.02,-1.39,141000,8,213900,0,0,0,0,0,0,108000,53000,55000,55000
20200212,050032,TPK元大94購03,,,,,0.00,0.00,0,0,0,0,0,0,0,0,0,0,0,0,0
20200212,050033,日月光元大94購01,1.20,1.41,1.20,1.37,+0.26,23.42,146000,10,187280,0,0,0,0,0,0,0,146000,-146000,-146000
20200212,050034,智伸科元大94購01,1.39,1.39,1.39,1.39,+0.02,1.46,36000,1,50040,0,0,0,0,0,0,36000,0,36000,36000
20200212,050035,聯茂元大94購07,1.23,1.72,1.23,1.58,+0.41,35.04,252000,21,359260,0,0,0,0,0,0,86000,167000,-81000,-81000
20200212,050036,矽格元大94購03,1.98,2.15,1.98,2.15,+0.23,11.98,199000,15,413850,0,0,0,0,0,0,28000,175000,-147000,-147000
20200212,050037,金融類元大94購03,1.71,1.74,1.71,1.74,-0.03,-1.69,10000,2,17250,0,0,0,0,0,0,5000,5000,0,0
20200212,050038,金融類元大94購04,,,,,0.00,0.00,0,0,0,0,0,0,0,0,0,0,0,0,0
20200212,050039,鴻海中信94購03,2.91,3.36,2.86,3.36,+0.49,17.07,112000,12,344570,0,0,0,0,0,0,60000,52000,8000,8000
20200212,050040,鴻海中信94購04,1.88,2.33,1.88,2.33,+0.50,27.32,33000,5,65940,0,0,0,0,0,0,11000,23000,-12000,-12000
20200212,050041,中石化亞東94購01,,,,,0.00,0.00,0,0,0,0,0,0,0,0,0,0,0,0,0
20200212,050042,台表科亞東94購01,,,,,0.00,0.00,0,0,0,0,0,0,0,0,0,0,0,0,0
20200212,050043,GIS亞東94購01,0.32,0.34,0.32,0.34,0.00,0.00,73000,3,24100,0,0,0,0,0,0,0,73000,-73000,-73000
20200212,050044,聯詠兆豐94購02,1.82,1.85,1.72,1.85,+0.22,13.5,120000,12,216000,0,0,0,0,0,0,50000,70000,-20000,-20000
20200212,050045,祥碩兆豐94購01,,,,,0.00,0.00,0,0,0,0,0,0,0,0,0,0,0,0,0
20200212,050046,矽力兆豐94購01,1.48,1.48,1.48,1.48,+0.16,12.12,18000,3,26640,0,0,0,0,0,0,0,18000,-18000,-18000
20200212,050047,奇鋐國票95購01,,,,,0.00,0.00,0,0,0,0,0,0,0,0,0,0,0,0,0
20200212,050048,百和國票94購01,1.19,1.19,1.19,1.19,-0.02,-1.65,20000,1,23800,0,0,0,0,0,0,20000,0,20000,20000
20200212,050049,華通群益96購01,2.29,3.26,2.29,3.22,+1.00,45.05,767000,17,2351960,0,0,0,0,0,0,699000,68000,631000,631000
20200212,05004P,健策統一95售01,0.14,0.14,0.12,0.12,-0.04,-25.0,998000,13,122320,0,0,0,0,0,0,534000,464000,70000,70000
20200212,050050,國泰金群益94購02,0.55,0.58,0.55,0.58,+0.04,7.41,46000,4,25820,0,0,0,0,0,0,14000,32000,-18000,-18000
20200212,050051,智原群益94購01,,,,,0.00,0.00,0,0,0,0,0,0,0,0,0,0,0,0,0
20200212,050052,致伸群益94購04,,,,,0.00,0.00,0,0,0,0,0,0,0,0,0,0,0,0,0
20200212,050053,訊芯群益94購03,0.30,0.33,0.30,0.33,+0.07,26.92,131000,3,42630,0,0,0,0,0,0,20000,111000,-91000,-91000
20200212,050054,緯穎群益94購04,,,,,0.00,0.00,0,0,0,0,0,0,0,0,0,0,0,0,0
20200212,050055,道瓊反凱基95購01,,,,,0.00,0.00,0,0,0,0,0,0,0,0,0,0,0,0,0
20200212,050056,國巨凱基94購04,5.25,5.80,5.25,5.80,+0.55,10.48,21000,3,121250,0,0,0,0,0,0,21000,0,21000,21000
20200212,050057,國巨凱基94購05,,,,,0.00,0.00,0,0,0,0,0,0,0,0,0,0,0,0,0
20200212,050058,國巨凱基94購06,6.70,6.70,6.65,6.65,+0.50,8.13,20000,2,133500,0,0,0,0,0,0,20000,0,20000,20000
20200212,050059,旺宏凱基94購03,2.75,2.83,2.69,2.69,-0.04,-1.47,13000,4,36430,0,0,0,0,0,0,13000,3000,10000,10000
20200212,05005P,台表科統一95售01,0.80,0.80,0.72,0.73,-0.08,-9.88,79000,22,59410,0,0,0,0,0,0,56000,23000,33000,33000
20200212,050060,光磊凱基94購03,,,,,0.00,0.00,0,0,0,0,0,0,0,0,0,0,0,0,0
20200212,050061,聯發科凱基94購07,1.99,2.24,0.28,2.24,+0.44,24.44,364000,28,738330,0,0,0,0,0,0,329000,174000,155000,155000
20200212,050062,聯發科凱基94購08,1.54,1.71,1.54,1.71,+0.45,35.71,14000,3,22240,0,0,0,0,0,0,14000,0,14000,14000
20200212,050063,聯發科凱基94購09,0.92,1.09,0.92,1.09,+0.36,49.32,115000,3,107950,0,0,0,0,0,0,105000,10000,95000,95000
20200212,050064,華新科凱基94購08,3.93,3.93,3.78,3.83,+0.29,8.19,29000,10,111420,0,0,0,0,0,0,23000,7000,16000,16000
20200212,050065,冠德凱基94購01,,,,,0.00,0.00,0,0,0,0,0,0,0,0,0,0,0,0,0
20200212,050066,華固凱基94購01,,,,,0.00,0.00,0,0,0,0,0,0,0,0,0,0,0,0,0
20200212,050067,美食凱基94購02,,,,,0.00,0.00,0,0,0,0,0,0,0,0,0,0,0,0,0
20200212,050068,美食凱基94購03,,,,,0.00,0.00,0,0,0,0,0,0,0,0,0,0,0,0,0
20200212,050069,禾伸堂凱基94購04,2.29,2.39,2.29,2.34,+0.03,1.3,38000,14,88250,0,0,0,0,0,0,17000,21000,-4000,-4000
20200212,05006P,華通元富95售01,1.11,1.11,0.77,0.77,-0.36,-31.86,164000,14,146150,0,0,0,0,0,0,75000,89000,-14000,-14000
20200212,050070,欣興凱基94購07,,,,,0.00,0.00,0,0,0,0,0,0,0,0,0,0,0,0,0
20200212,050071,明泰凱基94購01,0.51,0.56,0.51,0.56,0.00,0.00,160000,4,84600,0,0,0,0,0,0,0,160000,-160000,-160000
20200212,050072,京鼎凱基94購02,3.67,4.25,3.67,4.25,+0.97,29.57,87000,30,348220,0,0,0,0,0,0,6000,85000,-79000,-79000
20200212,050073,傳奇凱基94購02,,,,,0.00,0.00,0,0,0,0,0,0,0,0,0,0,0,0,0
20200212,050074,訊芯凱基94購05,0.26,0.26,0.26,0.26,0.00,0.00,6000,2,1560,0,0,0,0,0,0,0,6000,-6000,-6000
20200212,050075,南電凱基94購04,0.21,0.26,0.21,0.25,+0.08,47.06,174000,5,39850,0,0,0,0,0,0,104000,70000,34000,34000
20200212,050076,百和凱基94購02,,,,,0.00,0.00,0,0,0,0,0,0,0,0,0,0,0,0,0
20200212,050077,臺股指凱基99購02,1.50,1.69,1.49,1.69,+0.23,15.75,810000,10,1236800,0,0,0,0,0,0,0,810000,-810000,-810000
20200212,050078,臺指反統一97購01,,,,,0.00,0.00,0,0,0,0,0,0,0,0,0,0,0,0,0
20200212,050079,元油2X統一94購06,0.62,0.63,0.62,0.63,+0.02,3.28,51000,4,32030,0,0,0,0,0,0,41000,0,41000,41000
20200212,05007P,旺宏元富95售01,,,,,0.00,0.00,0,0,0,0,0,0,0,0,0,0,0,0,0
20200212,050080,國巨統一94購06,,,,,0.00,0.00,0,0,0,0,0,0,0,0,0,0,0,0,0
20200212,050081,聯發科統一94購07,2.25,2.47,2.23,2.47,+0.51,26.02,241000,11,565350,0,0,0,0,0,0,143000,98000,45000,45000
20200212,050082,聯發科統一94購08,,,,,0.00,0.00,0,0,0,0,0,0,0,0,0,0,0,0,0
20200212,050083,旺宏元富94購01,3.16,3.16,3.16,3.16,0.00,0.00,50000,1,158000,0,0,0,0,0,0,0,50000,-50000,-50000
20200212,050084,宏達電元富94購03,,,,,0.00,0.00,0,0,0,0,0,0,0,0,0,0,0,0,0
20200212,050085,國泰金元富94購01,1.05,1.06,1.01,1.06,+0.02,1.92,70000,27,72800,0,0,0,0,0,0,50000,20000,30000,30000
20200212,050086,國巨台新94購03,,,,,0.00,0.00,0,0,0,0,0,0,0,0,0,0,0,0,0
20200212,050087,美食台新94購01,0.19,0.19,0.18,0.18,+0.05,38.46,420000,9,78850,0,0,0,0,0,0,0,370000,-370000,-370000
20200212,050088,禾伸堂台新94購01,1.45,1.45,1.45,1.45,0.00,0.00,94000,1,136300,0,0,0,0,0,0,0,94000,-94000,-94000
20200212,050089,臻鼎台新94購01,0.45,0.45,0.38,0.38,0.00,0.00,88000,2,36100,0,0,0,0,0,0,0,88000,-88000,-88000
20200212,05008P,大立光元富95售05,,,,,0.00,0.00,0,0,0,0,0,0,0,0,0,0,0,0,0
20200212,050090,鈺齊康和94購01,,,,,0.00,0.00,0,0,0,0,0,0,0,0,0,0,0,0,0
20200212,050091,喬山永豐94購02,1.09,1.23,1.09,1.21,+0.18,17.48,91000,9,107020,0,0,0,0,0,0,5000,86000,-81000,-81000
20200212,050092,鴻海永豐94購04,1.22,1.49,1.22,1.49,+0.36,31.86,152000,9,194820,0,0,0,0,0,0,63000,89000,-26000,-26000
20200212,050093,國巨永豐94購05,3.27,3.33,3.21,3.33,+0.24,7.77,140000,15,457750,0,0,0,0,0,0,105000,35000,70000,70000
20200212,050094,T50反1國泰95購01,,,,,0.00,0.00,0,0,0,0,0,0,0,0,0,0,0,0,0
20200212,050095,國巨國泰95購04,,,,,0.00,0.00,0,0,0,0,0,0,0,0,0,0,0,0,0
20200212,050096,國巨國泰95購05,,,,,0.00,0.00,0,0,0,0,0,0,0,0,0,0,0,0,0
20200212,050097,可成國泰96購02,1.20,1.37,1.19,1.37,+0.27,24.55,109000,10,140820,0,0,0,0,0,0,57000,99000,-42000,-42000
20200212,050098,嘉聯益國泰95購02,0.33,0.36,0.33,0.34,+0.02,6.25,678000,15,229140,0,0,0,0,0,0,502000,296000,206000,206000
20200212,050099,台積電永昌96購01,4.61,4.72,4.61,4.72,+0.26,5.83,190000,12,888050,0,0,0,0,0,0,179000,30000,149000,149000
20200212,05009P,大立光元富95售06,2.01,2.01,2.01,2.01,-0.36,-15.19,10000,1,20100,0,0,0,0,0,0,0,10000,-10000,-10000
20200212,050100,台積電永昌96購02,4.11,4.24,4.02,4.24,+0.25,6.27,1554000,59,6382870,0,0,0,0,0,0,1143000,626000,517000,517000
20200212,050101,台積電永昌96購03,3.42,3.42,3.36,3.42,+0.18,5.56,137000,6,468360,0,0,0,0,0,0,137000,0,137000,137000
20200212,050102,鴻海富邦95購04,,,,,0.00,0.00,0,0,0,0,0,0,0,0,0,0,0,0,0
20200212,050103,群創富邦94購01,,,,,0.00,0.00,0,0,0,0,0,0,0,0,0,0,0,0,0
20200212,050104,元石油元大97購02,0.59,0.61,0.59,0.61,+0.04,7.02,252000,11,152280,0,0,0,0,0,0,110000,142000,-32000,-32000
20200212,050105,力山元大95購02,,,,,0.00,0.00,0,0,0,0,0,0,0,0,0,0,0,0,0
20200212,050106,台達電元大94購11,2.95,3.01,2.89,2.89,-0.02,-0.69,150000,6,438300,0,0,0,0,0,0,150000,0,150000,150000
20200212,050107,鴻海元大94購12,4.32,5.25,4.32,5.25,+1.20,29.63,102000,13,503400,0,0,0,0,0,0,87000,60000,27000,27000
20200212,050108,鴻海元大94購13,4.92,5.60,4.92,5.60,0.00,0.00,23000,6,116620,0,0,0,0,0,0,1000,22000,-21000,-21000
20200212,050109,國巨元大94購13,,,,,0.00,0.00,0,0,0,0,0,0,0,0,0,0,0,0,0
20200212,05010P,台郡元富95售01,0.28,0.28,0.27,0.27,-0.23,-46.0,80000,8,21700,0,0,0,0,0,0,0,80000,-80000,-80000
20200212,050110,京元電元大94購03,0.99,0.99,0.98,0.98,+0.03,3.16,56000,3,54980,0,0,0,0,0,0,56000,0,56000,56000
20200212,050111,全新元大95購02,1.13,1.39,1.10,1.39,+0.38,37.62,182000,14,218850,0,0,0,0,0,0,139000,43000,96000,96000
20200212,050112,高鐵元大94購02,1.66,1.78,1.66,1.78,+0.05,2.89,69000,3,121560,0,0,0,0,0,0,69000,1000,68000,68000
20200212,050113,欣興元大95購05,0.46,0.46,0.46,0.46,0.00,0.00,227000,1,104420,0,0,0,0,0,0,0,227000,-227000,-227000
20200212,050114,群創元大95購01,2.12,2.13,2.09,2.11,+0.01,0.48,58000,12,122400,0,0,0,0,0,0,28000,58000,-30000,-30000
20200212,050115,群創元大96購01,1.95,1.96,1.92,1.93,-0.01,-0.52,10000,5,19380,0,0,0,0,0,0,6000,10000,-4000,-4000
20200212,050116,嘉澤元大94購03,1.56,1.56,1.56,1.56,0.00,0.00,1000,1,1560,0,0,0,0,0,0,0,1000,-1000,-1000
20200212,050117,麗豐元大96購02,0.46,0.48,0.46,0.46,+0.03,6.98,275000,3,131480,0,0,0,0,0,0,6000,269000,-263000,-263000
20200212,050118,臻鼎元大94購01,0.75,0.95,0.75,0.75,+0.30,66.67,121000,6,94120,0,0,0,0,0,0,20000,101000,-81000,-81000
20200212,050119,瀚宇博元大95購03,0.74,0.77,0.74,0.76,+0.09,13.43,61000,5,46750,0,0,0,0,0,0,4000,57000,-53000,-53000
20200212,05011P,南電國泰96售01,1.84,1.84,1.76,1.76,-0.16,-8.33,39000,5,70480,0,0,0,0,0,0,2000,37000,-35000,-35000
20200212,050120,GIS元大95購02,0.42,0.43,0.42,0.43,0.00,0.00,577000,3,243140,0,0,0,0,0,0,0,577000,-577000,-577000
20200212,050121,南電元大95購02,1.02,1.26,1.00,1.23,+0.17,16.04,301000,27,342700,0,0,0,0,0,0,215000,110000,105000,105000
20200212,050122,臺指反凱基96購01,,,,,0.00,0.00,0,0,0,0,0,0,0,0,0,0,0,0,0
20200212,050123,群臺反凱基96購01,0.23,0.23,0.23,0.23,0.00,0.00,30000,1,6900,0,0,0,0,0,0,0,30000,-30000,-30000
20200212,050124,元金2X凱基95購01,,,,,0.00,0.00,0,0,0,0,0,0,0,0,0,0,0,0,0
20200212,050125,中環凱基94購01,,,,,0.00,0.00,0,0,0,0,0,0,0,0,0,0,0,0,0
20200212,050126,國巨凱基94購08,,,,,0.00,0.00,0,0,0,0,0,0,0,0,0,0,0,0,0
20200212,050127,台積電凱基94購31,,,,,0.00,0.00,0,0,0,0,0,0,0,0,0,0,0,0,0
20200212,050128,旺宏凱基94購04,1.56,1.56,1.56,1.56,+0.06,4.0,1000,1,1560,0,0,0,0,0,0,1000,1000,0,0
20200212,050129,聯發科凱基94購11,0.58,0.66,0.57,0.66,+0.21,46.67,28000,11,17420,0,0,0,0,0,0,28000,0,28000,28000
20200212,05012P,台積電元大95售07,0.38,0.38,0.38,0.38,-0.04,-9.52,40000,2,15200,0,0,0,0,0,0,20000,20000,0,0
20200212,050130,華新科凱基94購09,2.76,2.76,2.66,2.69,+0.12,4.67,28000,11,75590,0,0,0,0,0,0,22000,7000,15000,15000
20200212,050131,新光金凱基94購01,0.56,0.57,0.55,0.56,+0.02,3.7,266000,46,149100,0,0,0,0,0,0,232000,34000,198000,198000
20200212,050132,日電貿凱基94購02,,,,,0.00,0.00,0,0,0,0,0,0,0,0,0,0,0,0,0
20200212,050133,鈺齊凱基94購01,0.81,0.96,0.81,0.96,+0.14,17.07,156000,5,138610,0,0,0,0,0,0,56000,100000,-44000,-44000
20200212,050134,世紀鋼凱基94購04,,,,,0.00,0.00,0,0,0,0,0,0,0,0,0,0,0,0,0
20200212,050135,禾伸堂兆豐95購01,1.03,1.06,1.00,1.06,+0.01,0.95,254000,11,260110,0,0,0,0,0,0,139000,125000,14000,14000
20200212,050136,柏文兆豐94購01,,,,,0.00,0.00,0,0,0,0,0,0,0,0,0,0,0,0,0
20200212,050137,臺指反國票96購01,0.29,0.29,0.26,0.26,-0.04,-13.33,315000,5,87050,0,0,0,0,0,0,200000,115000,85000,85000
20200212,050138,台表科國票95購02,,,,,0.00,0.00,0,0,0,0,0,0,0,0,0,0,0,0,0
20200212,050139,華通亞東94購01,,,,,0.00,0.00,0,0,0,0,0,0,0,0,0,0,0,0,0
20200212,05013P,台積電元大96售05,0.44,0.46,0.43,0.43,-0.05,-10.42,152000,12,66940,0,0,0,0,0,0,32000,120000,-88000,-88000
20200212,050140,台郡第一94購01,1.96,2.02,1.96,2.02,0.00,0.00,12000,2,23880,0,0,0,0,0,0,0,12000,-12000,-12000
20200212,050141,國巨統一94購07,5.45,5.80,5.45,5.80,+0.50,9.43,25000,3,142250,0,0,0,0,0,0,25000,0,25000,25000
20200212,050142,聯發科元富9A購01,1.20,1.34,1.20,1.31,+0.16,13.91,498000,38,638770,0,0,0,0,0,0,344000,98000,246000,246000
20200212,050143,臻鼎元富94購05,0.35,0.45,0.30,0.31,0.00,0.00,100000,10,37100,0,0,0,0,0,0,0,100000,-100000,-100000
20200212,050144,宏達電台新95購01,0.61,0.61,0.61,0.61,0.00,0.00,38000,1,23180,0,0,0,0,0,0,0,38000,-38000,-38000
20200212,050145,矽創台新94購01,,,,,0.00,0.00,0,0,0,0,0,0,0,0,0,0,0,0,0
20200212,050146,訊芯康和94購02,,,,,0.00,0.00,0,0,0,0,0,0,0,0,0,0,0,0,0
20200212,050147,為升永豐94購01,,,,,0.00,0.00,0,0,0,0,0,0,0,0,0,0,0,0,0
20200212,050148,啟碁永豐94購01,,,,,0.00,0.00,0,0,0,0,0,0,0,0,0,0,0,0,0
20200212,050149,東元群益94購01,0.71,0.72,0.71,0.72,0.00,0.00,206000,2,148220,0,0,0,0,0,0,206000,0,206000,206000
20200212,05014P,臺股指元大95售05,0.89,0.89,0.89,0.89,-0.09,-9.18,10000,1,8900,0,0,0,0,0,0,10000,0,10000,10000
20200212,050150,國巨群益95購01,5.55,5.60,5.50,5.60,+0.45,8.74,10000,3,55400,0,0,0,0,0,0,10000,0,10000,10000
20200212,050151,台積電群益94購12,6.15,6.45,6.05,6.45,+0.60,10.26,212000,29,1336550,0,0,0,0,0,0,211000,46000,165000,165000
20200212,050152,聯發科群益94購07,0.65,0.74,0.65,0.74,+0.20,37.04,109000,4,75760,0,0,0,0,0,0,50000,59000,-9000,-9000
20200212,050153,義隆群益94購01,,,,,0.00,0.00,0,0,0,0,0,0,0,0,0,0,0,0,0
20200212,050154,可成群益94購05,,,,,0.00,0.00,0,0,0,0,0,0,0,0,0,0,0,0,0
20200212,050155,華新科群益95購01,4.07,4.14,4.07,4.13,+0.20,5.09,49000,8,202090,0,0,0,0,0,0,49000,28000,21000,21000
20200212,050156,潤泰全群益94購01,,,,,0.00,0.00,0,0,0,0,0,0,0,0,0,0,0,0,0
20200212,050157,臻鼎群益94購02,0.50,0.78,0.50,0.52,0.00,0.00,176000,12,100340,0,0,0,0,0,0,0,126000,-126000,-126000
20200212,050158,上海銀群益96購01,0.49,0.51,0.48,0.51,0.00,0.00,164000,7,81970,0,0,0,0,0,0,100000,63000,37000,37000
20200212,050159,超眾群益94購03,0.33,0.36,0.33,0.36,0.00,0.00,91000,18,30550,0,0,0,0,0,0,91000,0,91000,91000
20200212,05015P,臺股指元大95售06,0.46,0.46,0.39,0.39,-0.10,-20.41,508000,24,210120,0,0,0,0,0,0,86000,422000,-336000,-336000
20200212,050160,中石化國泰95購01,,,,,0.00,0.00,0,0,0,0,0,0,0,0,0,0,0,0,0
20200212,050161,鴻海國泰96購03,2.43,2.43,2.43,2.43,+0.30,14.08,9000,1,21870,0,0,0,0,0,0,9000,0,9000,9000
20200212,050162,中環國泰95購01,0.26,0.26,0.25,0.25,-0.04,-13.79,80000,4,20400,0,0,0,0,0,0,0,80000,-80000,-80000
20200212,050163,群創國泰95購01,,,,,0.00,0.00,0,0,0,0,0,0,0,0,0,0,0,0,0
20200212,050164,揚明光國泰95購01,,,,,0.00,0.00,0,0,0,0,0,0,0,0,0,0,0,0,0
20200212,050165,泰鼎國泰95購02,2.11,2.11,2.11,2.11,0.00,0.00,2000,1,4220,0,0,0,0,0,0,2000,0,2000,2000
20200212,050166,彩晶國泰95購01,,,,,0.00,0.00,0,0,0,0,0,0,0,0,0,0,0,0,0
20200212,050167,T50反1富邦96購01,,,,,0.00,0.00,0,0,0,0,0,0,0,0,0,0,0,0,0
20200212,050168,緯創富邦95購01,0.44,0.46,0.44,0.46,+0.01,2.22,56000,2,24740,0,0,0,0,0,0,56000,0,56000,56000
20200212,050169,臺指反元大97購01,0.31,0.31,0.31,0.31,-0.05,-13.89,10000,1,3100,0,0,0,0,0,0,0,10000,-10000,-10000
20200212,05016P,臺股指元大95售07,0.51,0.51,0.51,0.51,-0.07,-12.07,50000,1,25500,0,0,0,0,0,0,0,50000,-50000,-50000
20200212,050170,臺指反元大97購02,0.28,0.28,0.25,0.25,-0.05,-16.67,120000,5,31800,0,0,0,0,0,0,0,120000,-120000,-120000
20200212,050171,臺指反元大97購03,0.46,0.46,0.42,0.42,-0.05,-10.64,260000,9,114000,0,0,0,0,0,0,40000,220000,-180000,-180000
20200212,050172,臺指反元大98購02,0.60,0.61,0.57,0.58,-0.05,-7.94,1291000,37,755400,0,0,0,0,0,0,45000,1246000,-1201000,-1201000
20200212,050173,旺宏元大96購02,1.51,1.56,1.47,1.47,-0.03,-2.0,56000,13,83110,0,0,0,0,0,0,25000,35000,-10000,-10000
20200212,050174,技嘉元大94購01,3.46,3.55,3.18,3.26,-0.11,-3.26,398000,30,1316600,0,0,0,0,0,0,170000,236000,-66000,-66000
20200212,050175,台光電元大94購08,0.58,0.76,0.58,0.72,+0.16,28.57,784000,34,533690,0,0,0,0,0,0,219000,724000,-505000,-505000
20200212,050176,正崴元大94購03,0.76,0.80,0.76,0.80,+0.03,3.9,13000,3,10000,0,0,0,0,0,0,13000,10000,3000,3000
20200212,050177,聯發科元大94購11,2.39,2.64,2.30,2.64,+0.58,28.16,386000,17,941430,0,0,0,0,0,0,350000,134000,216000,216000
20200212,050178,聯發科元大94購12,,,,,0.00,0.00,0,0,0,0,0,0,0,0,0,0,0,0,0
20200212,050179,全新元大96購02,0.98,1.15,0.94,1.15,+0.28,32.18,268000,23,281160,0,0,0,0,0,0,175000,93000,82000,82000
20200212,05017P,臺股指元大95售08,0.58,0.58,0.58,0.58,0.00,0.00,30000,1,17400,0,0,0,0,0,0,0,30000,-30000,-30000
20200212,050180,華新科元大95購08,2.98,2.98,2.98,2.98,+0.10,3.47,7000,2,20860,0,0,0,0,0,0,7000,0,7000,7000
20200212,050181,富邦金元大94購02,1.63,1.63,1.62,1.63,+0.17,11.64,62000,4,101040,0,0,0,0,0,0,13000,49000,-36000,-36000
20200212,050182,淘帝元大94購01,0.56,0.56,0.56,0.56,0.00,0.00,10000,1,5600,0,0,0,0,0,0,0,10000,-10000,-10000
20200212,050183,奇鋐元大96購01,,,,,0.00,0.00,0,0,0,0,0,0,0,0,0,0,0,0,0
20200212,050184,信邦元大94購01,2.33,2.42,2.33,2.42,-0.11,-4.35,26000,8,61970,0,0,0,0,0,0,26000,0,26000,26000
20200212,050185,和鑫元大95購02,0.58,0.59,0.58,0.59,+0.05,9.26,500000,3,294990,0,0,0,0,0,0,1000,499000,-498000,-498000
20200212,050186,京鼎元大94購01,4.34,4.66,4.34,4.66,0.00,0.00,19000,8,85490,0,0,0,0,0,0,0,19000,-19000,-19000
20200212,050187,群創元大94購03,,,,,0.00,0.00,0,0,0,0,0,0,0,0,0,0,0,0,0
20200212,050188,貿聯元大96購01,1.03,1.15,1.03,1.15,+0.13,12.75,113000,9,127050,0,0,0,0,0,0,5000,113000,-108000,-108000
20200212,050189,旭富元大94購01,2.88,3.62,2.82,3.24,+0.59,22.26,71000,30,213170,0,0,0,0,0,0,56000,13000,43000,43000
20200212,05018P,臺股指元大95售09,0.64,0.64,0.56,0.56,-0.14,-20.0,48000,3,27120,0,0,0,0,0,0,45000,3000,42000,42000
20200212,050190,麗豐元大95購02,0.44,0.47,0.44,0.45,+0.04,9.76,348000,5,161970,0,0,0,0,0,0,0,348000,-348000,-348000
20200212,050191,和碩元大94購02,3.44,3.79,3.44,3.79,+0.04,1.07,28000,3,101920,0,0,0,0,0,0,22000,6000,16000,16000
20200212,050192,康控元大97購01,0.39,0.39,0.38,0.38,0.00,0.00,40000,2,15400,0,0,0,0,0,0,20000,20000,0,0
20200212,050193,臻鼎元大94購02,1.68,1.75,1.68,1.75,+0.65,59.09,54000,7,90900,0,0,0,0,0,0,21000,33000,-12000,-12000
20200212,050194,臻鼎元大94購03,1.34,1.41,1.34,1.41,+0.56,65.88,7000,6,9550,0,0,0,0,0,0,3000,4000,-1000,-1000
20200212,050195,上海銀元大94購03,1.21,1.21,1.21,1.21,0.00,0.00,68000,1,82280,0,0,0,0,0,0,0,68000,-68000,-68000
20200212,050196,嘉聯益元大97購01,0.39,0.41,0.39,0.41,+0.04,10.81,450000,3,184300,0,0,0,0,0,0,1000,449000,-448000,-448000
20200212,050197,矽格元大94購04,1.71,1.83,1.71,1.83,+0.21,12.96,50000,6,90310,0,0,0,0,0,0,8000,42000,-34000,-34000
20200212,050198,緯穎元大94購09,9.80,10.10,9.80,10.10,+0.10,1.0,3000,3,29800,0,0,0,0,0,0,3000,2000,1000,1000
20200212,050199,南電元大94購09,0.61,0.78,0.60,0.76,+0.14,22.58,256000,15,165380,0,0,0,0,0,0,256000,6000,250000,250000
20200212,05019P,喬山中信95售01,,,,,0.00,0.00,0,0,0,0,0,0,0,0,0,0,0,0,0
20200212,050200,致新元大94購01,1.73,1.73,1.66,1.66,-0.10,-5.68,52000,4,87320,0,0,0,0,0,0,52000,0,52000,52000
20200212,050201,光磊群益94購01,0.82,0.82,0.80,0.82,-0.02,-2.38,39000,5,31920,0,0,0,0,0,0,39000,0,39000,39000
20200212,050202,建準群益95購01,2.83,2.83,2.74,2.83,+0.03,1.07,39000,4,109180,0,0,0,0,0,0,28000,23000,5000,5000
20200212,050203,美律群益94購04,0.44,0.58,0.44,0.56,+0.17,43.59,252000,27,131670,0,0,0,0,0,0,25000,227000,-202000,-202000
20200212,050204,華新科群益94購05,7.10,7.10,6.85,7.05,+0.25,3.68,98000,15,691100,0,0,0,0,0,0,80000,47000,33000,33000
20200212,050205,牧德群益94購02,2.25,2.27,2.11,2.11,-0.07,-3.21,64000,11,142040,0,0,0,0,0,0,36000,28000,8000,8000
20200212,050206,寶成群益94購01,,,,,0.00,0.00,0,0,0,0,0,0,0,0,0,0,0,0,0
20200212,050207,百和群益95購01,,,,,0.00,0.00,0,0,0,0,0,0,0,0,0,0,0,0,0
20200212,050208,燿華兆豐95購02,,,,,0.00,0.00,0,0,0,0,0,0,0,0,0,0,0,0,0
20200212,050209,華通國票95購01,0.54,0.98,0.54,0.88,+0.31,54.39,208000,15,166290,0,0,0,0,0,0,60000,148000,-88000,-88000
20200212,05020P,廣達中信95售01,,,,,0.00,0.00,0,0,0,0,0,0,0,0,0,0,0,0,0
20200212,050210,華新科國票94購08,8.90,8.90,8.65,8.65,+0.50,6.13,12000,3,105900,0,0,0,0,0,0,9000,3000,6000,6000
20200212,050211,貿聯國票95購01,1.87,2.10,1.87,2.10,+0.18,9.37,50000,10,97600,0,0,0,0,0,0,10000,40000,-30000,-30000
20200212,050212,瀚宇博國票95購02,,,,,0.00,0.00,0,0,0,0,0,0,0,0,0,0,0,0,0
20200212,050213,華新科台新94購03,,,,,0.00,0.00,0,0,0,0,0,0,0,0,0,0,0,0,0
20200212,050214,嘉晶台新94購01,,,,,0.00,0.00,0,0,0,0,0,0,0,0,0,0,0,0,0
20200212,050215,TPK台新96購01,,,,,0.00,0.00,0,0,0,0,0,0,0,0,0,0,0,0,0
20200212,050216,奇力新永豐94購04,,,,,0.00,0.00,0,0,0,0,0,0,0,0,0,0,0,0,0
20200212,050217,健策永豐94購03,,,,,0.00,0.00,0,0,0,0,0,0,0,0,0,0,0,0,0
20200212,050218,世紀鋼統一94購02,0.79,0.82,0.78,0.78,-0.03,-3.7,165000,23,131450,0,0,0,0,0,0,140000,25000,115000,115000
20200212,050219,台積電元富95購03,2.57,2.67,2.57,2.67,+0.18,7.23,33000,7,85640,0,0,0,0,0,0,33000,10000,23000,23000
20200212,05021P,瑞昱凱基95售01,0.29,0.29,0.29,0.29,-0.01,-3.33,3000,1,870,0,0,0,0,0,0,3000,0,3000,3000
20200212,050220,台積電元富96購01,1.99,2.08,1.99,2.07,+0.17,8.95,184000,13,375930,0,0,0,0,0,0,159000,13000,146000,146000
20200212,050221,TPK元富94購02,,,,,0.00,0.00,0,0,0,0,0,0,0,0,0,0,0,0,0
20200212,050222,瑞儀元富94購01,,,,,0.00,0.00,0,0,0,0,0,0,0,0,0,0,0,0,0
20200212,050223,聯茂元富94購02,0.22,0.31,0.22,0.28,+0.14,100.0,222000,40,58870,0,0,0,0,0,0,0,222000,-222000,-222000
20200212,050224,台泥中信94購01,0.55,0.55,0.55,0.55,-0.03,-5.17,40000,1,22000,0,0,0,0,0,0,40000,0,40000,40000
20200212,050225,亞泥中信94購01,,,,,0.00,0.00,0,0,0,0,0,0,0,0,0,0,0,0,0
20200212,050226,華新科中信94購01,1.60,1.61,1.49,1.54,+0.04,2.67,264000,26,408250,0,0,0,0,0,0,150000,113000,37000,37000
20200212,050227,大立光中信96購01,1.20,1.20,1.20,1.20,0.00,0.00,10000,1,12000,0,0,0,0,0,0,0,10000,-10000,-10000
20200212,050228,中磊中信96購01,,,,,0.00,0.00,0,0,0,0,0,0,0,0,0,0,0,0,0
20200212,050229,鴻海麥證94購02,1.51,1.80,1.51,1.80,+0.34,23.29,130000,19,213790,30000,100000,-70000,0,0,0,35000,100000,-65000,-65000
20200212,05022P,智易凱基95售01,,,,,0.00,0.00,0,0,0,0,0,0,0,0,0,0,0,0,0
20200212,050230,聯發科麥證94購02,1.91,2.13,1.90,2.07,+0.36,21.05,321000,14,657150,271000,50000,221000,0,0,0,271000,50000,221000,221000
20200212,050231,聯發科麥證94購03,1.84,2.07,1.84,2.05,+0.41,25.0,242000,8,494970,232000,10000,222000,0,0,0,232000,10000,222000,222000
20200212,050232,奇鋐麥證95購01,,,,,0.00,0.00,0,0,0,0,0,0,0,0,0,0,0,0,0
20200212,050233,香港2X凱基96購01,1.06,1.09,1.06,1.09,+0.05,4.81,14000,3,14960,0,0,0,0,0,0,14000,0,14000,14000
20200212,050234,國巨凱基94購10,3.84,3.89,3.64,3.89,+0.29,8.06,40000,8,150550,0,0,0,0,0,0,40000,10000,30000,30000
20200212,050235,國巨凱基94購11,,,,,0.00,0.00,0,0,0,0,0,0,0,0,0,0,0,0,0
20200212,050236,旺宏凱基94購06,1.88,1.88,1.84,1.84,0.00,0.00,2000,2,3720,0,0,0,0,0,0,2000,2000,0,0
20200212,050237,智邦凱基94購03,0.41,0.47,0.41,0.47,+0.11,30.56,6000,5,2620,0,0,0,0,0,0,5000,0,5000,5000
20200212,050238,瑞昱凱基94購05,1.09,1.31,1.09,1.19,+0.08,7.21,262000,17,336480,0,0,0,0,0,0,251000,27000,224000,224000
20200212,050239,廣達凱基94購01,1.92,2.07,0.31,2.07,+0.08,4.02,92000,6,162610,0,0,0,0,0,0,72000,34000,38000,38000
20200212,05023P,和碩凱基95售01,,,,,0.00,0.00,0,0,0,0,0,0,0,0,0,0,0,0,0
20200212,050240,聯發科凱基94購13,1.36,1.52,1.36,1.52,+0.31,25.62,164000,7,245640,0,0,0,0,0,0,124000,2000,122000,122000
20200212,050241,聯發科凱基94購14,0.61,0.62,0.61,0.62,0.00,0.00,30000,3,18500,0,0,0,0,0,0,30000,0,30000,30000
20200212,050242,義隆凱基94購04,,,,,0.00,0.00,0,0,0,0,0,0,0,0,0,0,0,0,0
20200212,050243,華新科凱基94購10,3.10,3.22,3.10,3.22,+0.16,5.23,198000,11,619080,0,0,0,0,0,0,178000,17000,161000,161000
20200212,050244,富邦金凱基94購01,0.27,0.27,0.27,0.27,0.00,0.00,1000,1,270,0,0,0,0,0,0,0,1000,-1000,-1000
20200212,050245,大立光凱基94購12,2.56,2.69,2.56,2.69,0.00,0.00,12000,2,30980,0,0,0,0,0,0,2000,12000,-10000,-10000
20200212,050246,大立光凱基94購13,,,,,0.00,0.00,0,0,0,0,0,0,0,0,0,0,0,0,0
20200212,050247,智易凱基94購04,,,,,0.00,0.00,0,0,0,0,0,0,0,0,0,0,0,0,0
20200212,050248,臻鼎凱基94購03,0.65,0.69,0.06,0.55,+0.09,19.57,121000,5,71470,0,0,0,0,0,0,71000,50000,21000,21000
20200212,050249,瑞儀凱基94購01,,,,,0.00,0.00,0,0,0,0,0,0,0,0,0,0,0,0,0
20200212,05024P,華通國票96售01,1.20,1.20,0.87,0.87,-0.37,-29.84,197000,10,188410,0,0,0,0,0,0,10000,187000,-177000,-177000
20200212,050250,台郡凱基94購03,7.15,7.50,6.85,7.50,+2.74,57.56,33000,16,237100,0,0,0,0,0,0,30000,1000,29000,29000
20200212,050251,樺漢凱基94購02,2.03,2.14,0.31,2.14,+0.15,7.54,80000,7,146860,0,0,0,0,0,0,40000,40000,0,0
20200212,050252,聯發科國泰95購01,3.93,4.37,3.92,4.27,+0.72,20.28,382000,28,1590690,0,0,0,0,0,0,297000,169000,128000,128000
20200212,050253,百和國泰96購01,,,,,0.00,0.00,0,0,0,0,0,0,0,0,0,0,0,0,0
20200212,050254,大立光富邦96購02,1.39,1.41,1.39,1.41,+0.13,10.16,3000,2,4210,0,0,0,0,0,0,2000,3000,-1000,-1000
20200212,050255,GIS富邦95購01,,,,,0.00,0.00,0,0,0,0,0,0,0,0,0,0,0,0,0
20200212,050256,臺指反元大98購03,,,,,0.00,0.00,0,0,0,0,0,0,0,0,0,0,0,0,0
20200212,050257,為升元大94購07,0.56,0.59,0.56,0.59,-0.01,-1.67,355000,2,199100,0,0,0,0,0,0,10000,355000,-345000,-345000
20200212,050258,為升元大94購08,0.80,0.81,0.78,0.81,+0.03,3.85,266000,9,211180,0,0,0,0,0,0,166000,156000,10000,10000
20200212,050259,鴻海元大94購14,4.05,4.17,4.05,4.17,+0.58,16.16,4000,2,16560,0,0,0,0,0,0,0,4000,-4000,-4000
20200212,05025P,聯發科群益95售02,3.51,3.51,3.23,3.23,-0.60,-15.67,13000,6,42860,0,0,0,0,0,0,6000,7000,-1000,-1000
20200212,050260,鴻海元大94購15,2.89,3.94,2.89,3.88,+1.02,35.66,341000,30,1191930,0,0,0,0,0,0,278000,341000,-63000,-63000
20200212,050261,國巨元大95購04,2.71,2.72,2.57,2.71,+0.17,6.69,121000,14,319070,0,0,0,0,0,0,116000,20000,96000,96000
20200212,050262,台積電元大94購21,,,,,0.00,0.00,0,0,0,0,0,0,0,0,0,0,0,0,0
20200212,050263,旺宏元大94購10,4.00,4.15,3.83,3.83,-0.13,-3.28,30000,10,118280,0,0,0,0,0,0,30000,17000,13000,13000
20200212,050264,聯發科元大94購13,2.77,3.10,2.71,3.10,+0.72,30.25,311000,17,901370,0,0,0,0,0,0,283000,268000,15000,15000
20200212,050265,美食元大94購05,0.31,0.33,0.31,0.32,0.00,0.00,645000,5,210330,0,0,0,0,0,0,0,645000,-645000,-645000
20200212,050266,兆豐金元大94購01,,,,,0.00,0.00,0,0,0,0,0,0,0,0,0,0,0,0,0
20200212,050267,奇鋐元大94購03,,,,,0.00,0.00,0,0,0,0,0,0,0,0,0,0,0,0,0
20200212,050268,智原元大95購03,0.44,0.47,0.44,0.47,+0.04,9.3,295000,6,138350,0,0,0,0,0,0,10000,285000,-275000,-275000
20200212,050269,欣興元大94購09,0.70,0.96,0.69,0.96,+0.28,41.18,403000,25,327630,0,0,0,0,0,0,202000,213000,-11000,-11000
20200212,05026P,貿聯群益95售01,1.62,1.62,1.62,1.62,-0.04,-2.41,16000,2,25920,0,0,0,0,0,0,11000,5000,6000,6000
20200212,050270,景碩元大94購01,3.24,3.89,3.15,3.56,+0.42,13.38,326000,58,1152100,0,0,0,0,0,0,230000,312000,-82000,-82000
20200212,050271,上緯控元大96購01,,,,,0.00,0.00,0,0,0,0,0,0,0,0,0,0,0,0,0
20200212,050272,訊芯元大94購03,0.36,0.42,0.36,0.42,0.00,0.00,317000,2,129060,0,0,0,0,0,0,0,317000,-317000,-317000
20200212,050273,GIS元大94購04,0.31,0.31,0.31,0.31,0.00,0.00,68000,1,21080,0,0,0,0,0,0,0,68000,-68000,-68000
20200212,050274,GIS元大94購05,0.37,0.38,0.37,0.38,0.00,0.00,115000,2,42710,0,0,0,0,0,0,0,115000,-115000,-115000
20200212,050275,緯穎元大94購10,,,,,0.00,0.00,0,0,0,0,0,0,0,0,0,0,0,0,0
20200212,050276,百和元大94購03,,,,,0.00,0.00,0,0,0,0,0,0,0,0,0,0,0,0,0
20200212,050277,上銀亞東94購01,,,,,0.00,0.00,0,0,0,0,0,0,0,0,0,0,0,0,0
20200212,050278,上証2X第一94購01,,,,,0.00,0.00,0,0,0,0,0,0,0,0,0,0,0,0,0
20200212,050279,彩晶第一94購01,,,,,0.00,0.00,0,0,0,0,0,0,0,0,0,0,0,0,0
20200212,05027P,南電群益95售01,2.13,2.14,2.13,2.14,-0.46,-17.69,12000,2,25570,0,0,0,0,0,0,11000,1000,10000,10000
20200212,050280,國巨日盛94購01,3.42,3.42,3.33,3.38,+0.20,6.29,89000,8,301710,0,0,0,0,0,0,89000,0,89000,89000
20200212,050281,台積電日盛94購03,1.81,1.86,1.79,1.86,+0.21,12.73,157000,4,284460,0,0,0,0,0,0,149000,8000,141000,141000
20200212,050282,T50反1凱基97購01,0.53,0.53,0.51,0.51,-0.05,-8.93,254000,5,131850,0,0,0,0,0,0,77000,177000,-100000,-100000
20200212,050283,T50反1凱基9A購01,0.37,0.37,0.34,0.34,-0.04,-10.53,40000,4,14200,0,0,0,0,0,0,0,40000,-40000,-40000
20200212,050284,台泥凱基94購01,0.34,0.34,0.34,0.34,-0.02,-5.56,100000,2,34000,0,0,0,0,0,0,100000,0,100000,100000
20200212,050285,力山凱基94購06,,,,,0.00,0.00,0,0,0,0,0,0,0,0,0,0,0,0,0
20200212,050286,為升凱基94購05,0.34,0.34,0.34,0.34,-0.01,-2.86,305000,2,103700,0,0,0,0,0,0,305000,0,305000,305000
20200212,050287,台達電凱基94購10,0.57,0.57,0.57,0.57,+0.01,1.79,10000,1,5700,0,0,0,0,0,0,10000,0,10000,10000
20200212,050288,台積電凱基94購32,,,,,0.00,0.00,0,0,0,0,0,0,0,0,0,0,0,0,0
20200212,050289,光磊凱基94購04,,,,,0.00,0.00,0,0,0,0,0,0,0,0,0,0,0,0,0
20200212,05028P,康控永豐95售02,1.61,1.61,1.58,1.58,-0.20,-11.24,147000,4,235740,0,0,0,0,0,0,127000,20000,107000,107000
20200212,050290,南亞科凱基94購06,,,,,0.00,0.00,0,0,0,0,0,0,0,0,0,0,0,0,0
20200212,050291,聯發科凱基94購16,1.20,1.28,1.20,1.28,+0.27,26.73,43000,4,52770,0,0,0,0,0,0,43000,0,43000,43000
20200212,050292,可成凱基94購11,0.73,0.76,0.09,0.76,+0.08,11.76,88000,3,58140,0,0,0,0,0,0,68000,20000,48000,48000
20200212,050293,強茂凱基94購01,,,,,0.00,0.00,0,0,0,0,0,0,0,0,0,0,0,0,0
20200212,050294,宏達電凱基94購04,0.13,0.13,0.13,0.13,0.00,0.00,5000,1,650,0,0,0,0,0,0,5000,0,5000,5000
20200212,050295,大立光凱基94購16,1.29,1.29,1.29,1.29,0.00,0.00,70000,1,90300,0,0,0,0,0,0,0,70000,-70000,-70000
20200212,050296,亞光凱基94購03,1.26,1.34,1.25,1.25,+0.25,25.0,55000,11,72190,0,0,0,0,0,0,15000,55000,-40000,-40000
20200212,050297,欣興凱基94購08,0.26,0.29,0.26,0.29,+0.08,38.1,101000,2,26290,0,0,0,0,0,0,100000,1000,99000,99000
20200212,050298,智伸科凱基94購02,0.92,0.92,0.92,0.92,0.00,0.00,98000,1,90160,0,0,0,0,0,0,98000,0,98000,98000
20200212,050299,康普凱基94購01,,,,,0.00,0.00,0,0,0,0,0,0,0,0,0,0,0,0,0
20200212,05029P,鴻海元富95售04,0.82,0.82,0.69,0.69,-0.22,-24.18,137000,22,110210,0,0,0,0,0,0,5000,132000,-127000,-127000
20200212,050300,康控凱基94購03,,,,,0.00,0.00,0,0,0,0,0,0,0,0,0,0,0,0,0
20200212,050301,矽創凱基94購03,0.56,0.72,0.56,0.72,+0.17,30.91,108000,5,68260,0,0,0,0,0,0,100000,8000,92000,92000
20200212,050302,百和凱基94購03,,,,,0.00,0.00,0,0,0,0,0,0,0,0,0,0,0,0,0
20200212,050303,S&P反1中信96購01,,,,,0.00,0.00,0,0,0,0,0,0,0,0,0,0,0,0,0
20200212,050304,台光電中信94購01,0.22,0.33,0.22,0.32,+0.11,52.38,1701000,52,489290,0,0,0,0,0,0,626000,875000,-249000,-249000
20200212,050305,正崴中信95購01,0.12,0.12,0.12,0.12,0.00,0.00,10000,2,1200,0,0,0,0,0,0,0,10000,-10000,-10000
20200212,050306,聯發科中信97購01,0.93,1.02,0.92,1.02,+0.16,18.6,322000,13,319820,0,0,0,0,0,0,92000,230000,-138000,-138000
20200212,050307,欣興中信95購01,0.34,0.38,0.34,0.38,+0.08,26.67,135000,7,48450,0,0,0,0,0,0,90000,45000,45000,45000
20200212,050308,矽創中信97購01,0.31,0.31,0.31,0.31,0.00,0.00,10000,1,3100,0,0,0,0,0,0,10000,0,10000,10000
20200212,050309,亞泥兆豐94購01,0.60,0.60,0.60,0.60,+0.03,5.26,38000,1,22800,0,0,0,0,0,0,0,38000,-38000,-38000
20200212,05030P,台積電元富95售04,,,,,0.00,0.00,0,0,0,0,0,0,0,0,0,0,0,0,0
20200212,050310,卜蜂兆豐94購01,0.48,0.48,0.48,0.48,0.00,0.00,10000,1,4800,0,0,0,0,0,0,10000,0,10000,10000
20200212,050311,上銀兆豐95購01,,,,,0.00,0.00,0,0,0,0,0,0,0,0,0,0,0,0,0
20200212,050312,大立光兆豐94購04,0.75,0.83,0.75,0.83,+0.08,10.67,142000,2,112260,0,0,0,0,0,0,70000,72000,-2000,-2000
20200212,050313,大立光兆豐94購05,0.67,0.71,0.67,0.71,+0.08,12.7,20000,3,13700,0,0,0,0,0,0,20000,0,20000,20000
20200212,050314,晶技兆豐94購01,0.90,0.91,0.90,0.90,+0.01,1.12,149000,5,134470,0,0,0,0,0,0,49000,100000,-51000,-51000
20200212,050315,和碩兆豐95購01,1.36,1.38,1.36,1.38,-0.05,-3.5,126000,5,173730,0,0,0,0,0,0,116000,10000,106000,106000
20200212,050316,上証2X國票98購01,,,,,0.00,0.00,0,0,0,0,0,0,0,0,0,0,0,0,0
20200212,050317,和鑫國票95購02,0.53,0.55,0.53,0.55,+0.04,7.84,84000,19,45200,0,0,0,0,0,0,18000,66000,-48000,-48000
20200212,050318,景碩國票94購02,2.74,3.11,2.68,3.11,+0.42,15.61,93000,21,264620,0,0,0,0,0,0,43000,63000,-20000,-20000
20200212,050319,康控國票95購04,0.14,0.15,0.14,0.15,0.00,0.00,1000000,6,142000,0,0,0,0,0,0,800000,200000,600000,600000
20200212,05031P,台光電元富95售01,0.57,0.57,0.51,0.51,-0.17,-25.0,200000,67,106220,0,0,0,0,0,0,140000,60000,80000,80000
20200212,050320,台表科國票94購01,5.20,5.50,5.20,5.50,+0.45,8.91,17000,2,90800,0,0,0,0,0,0,0,17000,-17000,-17000
20200212,050321,GIS國票95購02,,,,,0.00,0.00,0,0,0,0,0,0,0,0,0,0,0,0,0
20200212,050322,世紀鋼國票95購01,0.76,0.76,0.75,0.75,-0.07,-8.54,36000,6,27290,0,0,0,0,0,0,36000,0,36000,36000
20200212,050323,嘉聯益台新94購01,,,,,0.00,0.00,0,0,0,0,0,0,0,0,0,0,0,0,0
20200212,050324,訊芯台新94購01,0.37,0.37,0.37,0.37,+0.08,27.59,49000,2,18130,0,0,0,0,0,0,0,49000,-49000,-49000
20200212,050325,台積電永豐94購05,,,,,0.00,0.00,0,0,0,0,0,0,0,0,0,0,0,0,0
20200212,050326,正崴永豐94購03,,,,,0.00,0.00,0,0,0,0,0,0,0,0,0,0,0,0,0
20200212,050327,泰鼎永豐94購03,1.15,1.26,1.10,1.10,+0.06,5.77,359000,65,432990,0,0,0,0,0,0,36000,303000,-267000,-267000
20200212,050328,臻鼎永豐94購03,,,,,0.00,0.00,0,0,0,0,0,0,0,0,0,0,0,0,0
20200212,050329,超眾永豐94購03,0.18,0.21,0.18,0.20,-0.01,-4.76,105000,20,20580,0,0,0,0,0,0,105000,0,105000,105000
20200212,05032P,台積電國泰96售05,0.98,0.98,0.95,0.95,0.00,0.00,50000,4,48000,0,0,0,0,0,0,0,50000,-50000,-50000
20200212,050330,南電永豐94購01,,,,,0.00,0.00,0,0,0,0,0,0,0,0,0,0,0,0,0
20200212,050331,鈺齊永豐94購02,,,,,0.00,0.00,0,0,0,0,0,0,0,0,0,0,0,0,0
20200212,050332,鴻海國泰96購05,2.07,2.45,2.03,2.45,+0.50,25.64,134000,5,276090,0,0,0,0,0,0,134000,3000,131000,131000
20200212,050333,鴻海國泰96購06,2.61,2.90,2.61,2.90,+0.51,21.34,27000,4,75520,0,0,0,0,0,0,27000,0,27000,27000
20200212,050334,鴻海國泰96購07,3.25,3.40,3.25,3.40,+0.46,15.65,4000,3,13260,0,0,0,0,0,0,4000,0,4000,4000
20200212,050335,正崴國泰96購01,0.73,0.73,0.72,0.72,0.00,0.00,96000,11,69940,0,0,0,0,0,0,96000,0,96000,96000
20200212,050336,緯穎國泰94購02,,,,,0.00,0.00,0,0,0,0,0,0,0,0,0,0,0,0,0
20200212,050337,南電國泰95購01,0.55,0.69,0.53,0.69,+0.14,25.45,234000,42,142940,0,0,0,0,0,0,121000,113000,8000,8000
20200212,050338,TPK富邦96購01,,,,,0.00,0.00,0,0,0,0,0,0,0,0,0,0,0,0,0
20200212,050339,鴻海統一94購06,1.05,1.05,1.05,1.05,0.00,0.00,1000,1,1050,0,0,0,0,0,0,0,1000,-1000,-1000
20200212,05033P,T50反1元大98售01,,,,,0.00,0.00,0,0,0,0,0,0,0,0,0,0,0,0,0
20200212,050340,鴻海統一94購07,2.75,2.83,2.67,2.83,+0.31,12.3,171000,13,467610,0,0,0,0,0,0,154000,17000,137000,137000
20200212,050341,光寶科元富94購01,1.11,1.13,1.11,1.13,-0.02,-1.74,12000,3,13520,0,0,0,0,0,0,0,12000,-12000,-12000
20200212,050342,華通元富94購02,0.27,0.60,0.27,0.59,+0.30,103.45,605000,42,274770,0,0,0,0,0,0,297000,373000,-76000,-76000
20200212,050343,鴻海元富94購01,1.91,2.18,1.91,2.18,+0.39,21.79,38000,8,76560,0,0,0,0,0,0,18000,28000,-10000,-10000
20200212,050344,鴻海元富96購01,2.06,2.41,2.06,2.41,+0.48,24.87,197000,16,423160,0,0,0,0,0,0,102000,95000,7000,7000
20200212,050345,創意元富94購02,0.54,0.54,0.52,0.52,-0.08,-13.33,6000,4,3190,0,0,0,0,0,0,6000,0,6000,6000
20200212,050346,康友元富94購03,4.80,5.05,4.80,5.05,+0.25,5.21,8000,4,39140,0,0,0,0,0,0,5000,5000,0,0
20200212,050347,上証2X群益98購01,0.57,0.57,0.57,0.57,0.00,0.00,50000,1,28500,0,0,0,0,0,0,0,50000,-50000,-50000
20200212,050348,鴻海群益94購06,3.05,3.05,3.05,3.05,0.00,0.00,10000,1,30500,0,0,0,0,0,0,10000,0,10000,10000
20200212,050349,中環群益94購01,,,,,0.00,0.00,0,0,0,0,0,0,0,0,0,0,0,0,0
20200212,05034P,台積電元大95售08,0.62,0.62,0.58,0.58,-0.10,-14.71,703000,6,431860,0,0,0,0,0,0,701000,2000,699000,699000
20200212,050350,全新群益94購04,0.47,0.64,0.47,0.64,+0.21,48.84,281000,30,161720,0,0,0,0,0,0,172000,109000,63000,63000
20200212,050351,華新科群益95購02,8.20,8.40,7.95,8.20,+0.35,4.46,467000,22,3868150,0,0,0,0,0,0,437000,65000,372000,372000
20200212,050352,欣興群益95購01,0.30,0.30,0.30,0.30,+0.05,20.0,75000,1,22500,0,0,0,0,0,0,75000,0,75000,75000
20200212,050353,華擎群益95購01,3.59,3.69,3.42,3.42,+0.04,1.18,23000,6,82060,0,0,0,0,0,0,10000,13000,-3000,-3000
20200212,050354,瀚宇博群益94購02,,,,,0.00,0.00,0,0,0,0,0,0,0,0,0,0,0,0,0
20200212,050355,瑞儀群益94購01,,,,,0.00,0.00,0,0,0,0,0,0,0,0,0,0,0,0,0
20200212,050356,緯穎群益94購05,7.80,8.90,7.75,8.85,+0.50,5.99,57000,16,474850,0,0,0,0,0,0,57000,57000,0,0
20200212,050357,南電群益94購02,0.20,0.20,0.20,0.20,0.00,0.00,1000,1,200,0,0,0,0,0,0,0,1000,-1000,-1000
20200212,050358,致新群益94購01,0.41,0.43,0.40,0.43,+0.01,2.38,235000,16,94750,0,0,0,0,0,0,224000,11000,213000,213000
20200212,050359,T50反1元大94購05,0.11,0.11,0.11,0.11,-0.04,-26.67,59000,1,6490,0,0,0,0,0,0,59000,0,59000,59000
20200212,05035P,聯發科元大95售06,1.63,1.64,1.49,1.51,-0.31,-17.03,653000,31,1023840,0,0,0,0,0,0,435000,523000,-88000,-88000
20200212,050360,T50反1元大94購06,0.15,0.15,0.14,0.14,-0.02,-12.5,58000,4,8670,0,0,0,0,0,0,50000,8000,42000,42000
20200212,050361,T50反1元大94購07,,,,,0.00,0.00,0,0,0,0,0,0,0,0,0,0,0,0,0
20200212,050362,深中小元大94購04,,,,,0.00,0.00,0,0,0,0,0,0,0,0,0,0,0,0,0
20200212,050363,臺指反元大98購04,0.56,0.56,0.51,0.51,-0.07,-12.07,1239000,22,656610,0,0,0,0,0,0,68000,1163000,-1095000,-1095000
20200212,050364,卜蜂元大94購02,,,,,0.00,0.00,0,0,0,0,0,0,0,0,0,0,0,0,0
20200212,050365,中石化元大94購02,,,,,0.00,0.00,0,0,0,0,0,0,0,0,0,0,0,0,0
20200212,050366,鴻海元大94購19,3.72,3.94,3.72,3.94,+0.56,16.57,11000,3,43120,0,0,0,0,0,0,0,11000,-11000,-11000
20200212,050367,鴻海元大94購20,2.98,3.52,2.98,3.52,+1.03,41.37,299000,22,924160,0,0,0,0,0,0,293000,299000,-6000,-6000
20200212,050368,國巨元大94購14,3.20,3.23,3.10,3.23,+0.30,10.24,150000,12,475500,0,0,0,0,0,0,140000,0,140000,140000
20200212,050369,台積電元大94購23,,,,,0.00,0.00,0,0,0,0,0,0,0,0,0,0,0,0,0
20200212,05036P,義隆元大95售03,1.32,1.35,1.32,1.35,-0.17,-11.18,5000,5,6670,0,0,0,0,0,0,0,5000,-5000,-5000
20200212,050370,台積電元大94購24,5.00,5.05,5.00,5.05,+0.23,4.77,39000,16,196900,0,0,0,0,0,0,39000,29000,10000,10000
20200212,050371,台積電元大94購25,,,,,0.00,0.00,0,0,0,0,0,0,0,0,0,0,0,0,0
20200212,050372,全新元大96購03,0.60,0.72,0.59,0.71,+0.14,24.56,456000,20,301590,0,0,0,0,0,0,414000,243000,171000,171000
20200212,050373,奇鋐元大94購04,,,,,0.00,0.00,0,0,0,0,0,0,0,0,0,0,0,0,0
20200212,050374,上緯控元大95購01,0.32,0.32,0.32,0.32,-0.01,-3.03,68000,1,21760,0,0,0,0,0,0,0,68000,-68000,-68000
20200212,050375,矽創元大94購02,0.64,0.75,0.64,0.75,+0.22,41.51,43000,5,28020,0,0,0,0,0,0,2000,39000,-37000,-37000
20200212,050376,百和元大95購01,,,,,0.00,0.00,0,0,0,0,0,0,0,0,0,0,0,0,0
20200212,050377,華通第一94購01,0.57,0.89,0.57,0.88,+0.32,57.14,1260000,43,875450,0,0,0,0,0,0,665000,650000,15000,15000
20200212,050378,上証2X群益98購02,0.69,0.70,0.65,0.70,-0.02,-2.78,41000,5,27790,0,0,0,0,0,0,1000,39000,-38000,-38000
20200212,050379,易華電群益96購01,,,,,0.00,0.00,0,0,0,0,0,0,0,0,0,0,0,0,0
20200212,05037P,華新科元大95售09,0.21,0.22,0.21,0.22,-0.01,-4.35,80000,3,17100,0,0,0,0,0,0,30000,50000,-20000,-20000
20200212,050380,台積電亞東94購02,,,,,0.00,0.00,0,0,0,0,0,0,0,0,0,0,0,0,0
20200212,050381,鴻海兆豐94購01,0.94,1.04,0.94,1.04,+0.32,44.44,20000,2,19800,0,0,0,0,0,0,20000,10000,10000,10000
20200212,050382,TPK兆豐95購02,,,,,0.00,0.00,0,0,0,0,0,0,0,0,0,0,0,0,0
20200212,050383,超眾兆豐95購01,1.20,1.34,1.20,1.34,+0.10,8.06,460000,31,579430,0,0,0,0,0,0,350000,110000,240000,240000
20200212,050384,嘉澤國票94購02,,,,,0.00,0.00,0,0,0,0,0,0,0,0,0,0,0,0,0
20200212,050385,貿聯國票95購02,1.67,1.93,1.67,1.93,+0.20,11.56,59000,11,104250,0,0,0,0,0,0,11000,48000,-37000,-37000
20200212,050386,智伸科國票94購01,1.14,1.14,1.14,1.14,-0.02,-1.72,20000,1,22800,0,0,0,0,0,0,20000,0,20000,20000
20200212,050387,鴻海統一94購08,1.64,1.66,1.64,1.64,+0.34,26.15,50000,5,82400,0,0,0,0,0,0,50000,50000,0,0
20200212,050388,鴻海統一94購09,0.46,0.61,0.45,0.60,0.00,0.00,97000,15,46210,0,0,0,0,0,0,20000,77000,-57000,-57000
20200212,050389,鴻海統一95購04,,,,,0.00,0.00,0,0,0,0,0,0,0,0,0,0,0,0,0
20200212,05038P,牧德元大95售03,,,,,0.00,0.00,0,0,0,0,0,0,0,0,0,0,0,0,0
20200212,050390,聯發科統一94購09,0.74,0.83,0.74,0.83,+0.18,27.69,624000,12,483830,0,0,0,0,0,0,185000,429000,-244000,-244000
20200212,050391,大立光統一94購07,1.06,1.37,1.06,1.37,+0.32,30.48,139000,6,170480,0,0,0,0,0,0,46000,93000,-47000,-47000
20200212,050392,群創統一96購01,,,,,0.00,0.00,0,0,0,0,0,0,0,0,0,0,0,0,0
20200212,050393,樺漢統一94購01,0.90,0.93,0.86,0.93,+0.05,5.68,106000,8,96770,0,0,0,0,0,0,96000,10000,86000,86000
20200212,050394,大立光元富94購09,1.20,1.20,1.20,1.20,0.00,0.00,57000,1,68400,0,0,0,0,0,0,0,57000,-57000,-57000
20200212,050395,大立光元富94購10,1.43,1.61,1.41,1.56,+0.14,9.86,151000,5,227860,0,0,0,0,0,0,80000,71000,9000,9000
20200212,050396,欣興元富94購02,0.09,0.12,0.08,0.11,+0.03,37.5,439000,6,43200,0,0,0,0,0,0,183000,256000,-73000,-73000
20200212,050397,力成元富94購01,1.31,1.60,1.31,1.57,+0.29,22.66,598000,43,874700,0,0,0,0,0,0,352000,234000,118000,118000
20200212,050398,上証2X中信97購01,,,,,0.00,0.00,0,0,0,0,0,0,0,0,0,0,0,0,0
20200212,050399,潤泰全中信95購01,,,,,0.00,0.00,0,0,0,0,0,0,0,0,0,0,0,0,0
20200212,05039P,鴻海凱基95售10,0.49,0.49,0.46,0.46,-0.10,-17.86,67000,7,32270,0,0,0,0,0,0,35000,32000,3000,3000
20200212,050400,臻鼎中信97購01,0.26,0.26,0.18,0.18,+0.02,12.5,216000,10,49410,0,0,0,0,0,0,154000,62000,92000,92000
20200212,050401,鎧勝中信94購01,,,,,0.00,0.00,0,0,0,0,0,0,0,0,0,0,0,0,0
20200212,050402,緯穎中信96購01,1.83,1.91,1.81,1.91,+0.12,6.7,63000,6,117030,0,0,0,0,0,0,47000,16000,31000,31000
20200212,050403,台積電麥證94購02,,,,,0.00,0.00,0,0,0,0,0,0,0,0,0,0,0,0,0
20200212,050404,元大金麥證94購01,1.38,1.39,1.38,1.39,+0.02,1.46,11000,2,15280,10000,1000,9000,0,0,0,10000,1000,9000,9000
20200212,050405,新光金麥證94購01,0.57,0.57,0.55,0.57,+0.01,1.79,174000,34,97280,158000,0,158000,0,0,0,158000,0,158000,158000
20200212,050406,台積電台新95購02,3.68,3.75,3.68,3.75,0.00,0.00,11000,2,40830,0,0,0,0,0,0,5000,6000,-1000,-1000
20200212,050407,聯詠台新94購02,,,,,0.00,0.00,0,0,0,0,0,0,0,0,0,0,0,0,0
20200212,050408,臻鼎台新94購02,0.65,0.73,0.62,0.70,+0.32,84.21,53000,7,35560,0,0,0,0,0,0,47000,6000,41000,41000
20200212,050409,華通永豐94購01,0.34,0.43,0.34,0.37,+0.20,117.65,289000,10,113520,0,0,0,0,0,0,0,289000,-289000,-289000
20200212,05040P,聯發科凱基95售05,0.80,0.87,0.80,0.87,0.00,0.00,100000,2,86720,0,0,0,0,0,0,96000,0,96000,96000
20200212,050410,燿華永豐95購03,,,,,0.00,0.00,0,0,0,0,0,0,0,0,0,0,0,0,0
20200212,050411,聯發科永豐94購05,0.98,1.08,0.98,1.08,+0.23,27.06,229000,8,231960,0,0,0,0,0,0,177000,52000,125000,125000
20200212,050412,全新永豐94購04,,,,,0.00,0.00,0,0,0,0,0,0,0,0,0,0,0,0,0
20200212,050413,麗豐永豐94購01,,,,,0.00,0.00,0,0,0,0,0,0,0,0,0,0,0,0,0
20200212,050414,泰鼎永豐94購04,2.48,2.62,2.39,2.40,+0.19,8.6,248000,44,630510,0,0,0,0,0,0,50000,198000,-148000,-148000
20200212,050415,力成永豐94購01,1.12,1.27,1.08,1.27,+0.33,35.11,336000,24,395940,0,0,0,0,0,0,15000,304000,-289000,-289000
20200212,050416,高股息凱基96購02,0.59,0.59,0.59,0.59,+0.06,11.32,200000,1,118000,0,0,0,0,0,0,200000,0,200000,200000
20200212,050417,喬山凱基94購01,,,,,0.00,0.00,0,0,0,0,0,0,0,0,0,0,0,0,0
20200212,050418,為升凱基94購06,,,,,0.00,0.00,0,0,0,0,0,0,0,0,0,0,0,0,0
20200212,050419,鴻海凱基95購02,1.88,2.30,1.88,2.27,+0.43,23.37,80000,7,173600,0,0,0,0,0,0,70000,60000,10000,10000
20200212,05041P,大立光凱基95售09,0.64,0.64,0.58,0.58,-0.10,-14.71,161000,13,95820,0,0,0,0,0,0,100000,55000,45000,45000
20200212,050420,鴻海凱基95購03,,,,,0.00,0.00,0,0,0,0,0,0,0,0,0,0,0,0,0
20200212,050421,鴻海凱基95購04,0.71,0.84,0.71,0.84,+0.23,37.7,330000,5,258300,0,0,0,0,0,0,230000,100000,130000,130000
20200212,050422,鴻海凱基96購01,0.77,0.96,0.77,0.96,+0.24,33.33,280000,5,220430,0,0,0,0,0,0,189000,91000,98000,98000
20200212,050423,鴻海凱基96購02,0.74,0.74,0.74,0.74,+0.07,10.45,20000,1,14800,0,0,0,0,0,0,20000,0,20000,20000
20200212,050424,鴻海凱基96購03,0.58,0.60,0.58,0.60,0.00,0.00,101000,2,59240,0,0,0,0,0,0,0,101000,-101000,-101000
20200212,050425,國巨凱基94購12,6.30,6.40,6.10,6.40,+0.60,10.34,33000,4,207900,0,0,0,0,0,0,30000,3000,27000,27000
20200212,050426,國巨凱基94購14,6.50,6.70,6.50,6.70,0.00,0.00,100000,12,658400,0,0,0,0,0,0,100000,100000,0,0
20200212,050427,台積電凱基94購34,,,,,0.00,0.00,0,0,0,0,0,0,0,0,0,0,0,0,0
20200212,050428,光磊凱基94購05,,,,,0.00,0.00,0,0,0,0,0,0,0,0,0,0,0,0,0
20200212,050429,漢唐凱基94購04,2.39,2.39,2.39,2.39,+0.21,9.63,100000,2,239000,0,0,0,0,0,0,100000,0,100000,100000
20200212,05042P,GIS凱基95售03,0.89,0.89,0.89,0.89,0.00,0.00,10000,2,8900,0,0,0,0,0,0,0,10000,-10000,-10000
20200212,050430,京元電凱基94購03,0.35,0.37,0.33,0.36,-0.01,-2.7,240000,34,83940,0,0,0,0,0,0,223000,0,223000,223000
20200212,050431,聯發科凱基94購18,1.56,1.76,1.56,1.76,+0.39,28.47,326000,10,533680,0,0,0,0,0,0,326000,16000,310000,310000
20200212,050432,聯發科凱基94購19,1.12,1.30,1.12,1.30,+0.34,35.42,21000,3,24500,0,0,0,0,0,0,11000,11000,0,0
20200212,050433,華新科凱基94購11,2.98,2.98,2.84,2.91,+0.14,5.05,268000,9,762040,0,0,0,0,0,0,265000,7000,258000,258000
20200212,050434,富邦金凱基94購02,,,,,0.00,0.00,0,0,0,0,0,0,0,0,0,0,0,0,0
20200212,050435,大立光凱基94購17,,,,,0.00,0.00,0,0,0,0,0,0,0,0,0,0,0,0,0
20200212,050436,大立光凱基94購18,1.26,1.39,1.26,1.39,0.00,0.00,73000,2,92240,0,0,0,0,0,0,2000,71000,-69000,-69000
20200212,050437,聯詠凱基94購04,2.14,2.24,2.14,2.24,+0.28,14.29,22000,3,47280,0,0,0,0,0,0,22000,2000,20000,20000
20200212,050438,欣興凱基94購09,0.50,0.50,0.49,0.50,+0.16,47.06,62000,3,30400,0,0,0,0,0,0,0,62000,-62000,-62000
20200212,050439,新日興凱基94購01,1.66,1.66,1.54,1.54,-0.20,-11.49,217000,12,350500,0,0,0,0,0,0,217000,6000,211000,211000
20200212,05043P,佳世達元富95售01,2.05,2.05,2.05,2.05,0.00,0.00,16000,2,32800,0,0,0,0,0,0,0,16000,-16000,-16000
20200212,050440,揚明光凱基94購05,,,,,0.00,0.00,0,0,0,0,0,0,0,0,0,0,0,0,0
20200212,050441,和碩凱基94購01,,,,,0.00,0.00,0,0,0,0,0,0,0,0,0,0,0,0,0
20200212,050442,復盛凱基94購01,1.43,1.43,1.39,1.41,-0.05,-3.42,77000,12,109410,0,0,0,0,0,0,77000,8000,69000,69000
20200212,050443,復盛凱基94購02,1.18,1.18,1.09,1.09,-0.07,-6.03,77000,8,90140,0,0,0,0,0,0,77000,0,77000,77000
20200212,050444,卜蜂元大94購03,1.34,1.37,1.33,1.37,+0.02,1.48,7000,3,9420,0,0,0,0,0,0,0,7000,-7000,-7000
20200212,050445,鴻海元大94購21,1.03,1.49,0.98,1.49,+0.49,49.0,976000,37,1213370,0,0,0,0,0,0,896000,956000,-60000,-60000
20200212,050446,鴻海元大94購22,2.37,2.56,2.37,2.56,+0.24,10.34,58000,2,146580,0,0,0,0,0,0,58000,0,58000,58000
20200212,050447,廣達元大94購01,2.75,2.93,2.72,2.93,+0.12,4.27,147000,13,421200,0,0,0,0,0,0,139000,32000,107000,107000
20200212,050448,義隆元大94購04,0.94,0.94,0.89,0.89,+0.17,23.61,89000,4,80210,0,0,0,0,0,0,20000,69000,-49000,-49000
20200212,050449,宏達電元大95購03,,,,,0.00,0.00,0,0,0,0,0,0,0,0,0,0,0,0,0
20200212,05044P,亞德客永豐95售01,0.52,0.52,0.49,0.49,-0.06,-10.91,15000,2,7650,0,0,0,0,0,0,0,15000,-15000,-15000
20200212,050450,富邦金元大94購03,0.73,0.75,0.73,0.75,0.00,0.00,121000,3,90110,0,0,0,0,0,0,0,121000,-121000,-121000
20200212,050451,嘉晶元大95購01,0.77,0.85,0.77,0.81,+0.09,12.5,653000,14,537810,0,0,0,0,0,0,337000,624000,-287000,-287000
20200212,050452,智原元大95購04,0.37,0.41,0.37,0.41,+0.05,13.89,420000,6,166900,0,0,0,0,0,0,120000,300000,-180000,-180000
20200212,050453,創意元大95購03,0.70,0.74,0.67,0.72,-0.09,-11.11,299000,7,213620,0,0,0,0,0,0,131000,271000,-140000,-140000
20200212,050454,嘉澤元大94購04,1.75,1.75,1.54,1.54,-0.03,-1.91,123000,5,212410,0,0,0,0,0,0,19000,123000,-104000,-104000
20200212,050455,貿聯元大94購02,0.91,1.05,0.91,1.05,+0.14,15.38,364000,13,357430,0,0,0,0,0,0,222000,186000,36000,36000
20200212,050456,聯茂元大94購09,0.59,0.79,0.59,0.78,+0.29,59.18,302000,24,222480,0,0,0,0,0,0,175000,182000,-7000,-7000
20200212,050457,力成元大94購01,3.86,4.31,3.86,4.03,0.00,0.00,34000,8,142330,0,0,0,0,0,0,6000,33000,-27000,-27000
20200212,050458,台郡元大94購03,5.40,5.40,5.30,5.30,+1.48,38.74,21000,4,112300,0,0,0,0,0,0,11000,10000,1000,1000
20200212,050459,台表科元大94購03,3.55,3.84,3.50,3.84,+0.35,10.03,163000,21,602820,0,0,0,0,0,0,62000,121000,-59000,-59000
20200212,05045P,台積電永豐95售01,,,,,0.00,0.00,0,0,0,0,0,0,0,0,0,0,0,0,0
20200212,050460,GIS元大95購03,0.63,0.66,0.63,0.66,+0.07,11.86,504000,7,325780,0,0,0,0,0,0,109000,404000,-295000,-295000
20200212,050461,GIS元大95購04,0.82,0.82,0.82,0.82,+0.10,13.89,50000,1,41000,0,0,0,0,0,0,0,50000,-50000,-50000
20200212,050462,寶成元大94購01,0.46,0.50,0.46,0.49,-0.02,-3.92,419000,7,208330,0,0,0,0,0,0,418000,21000,397000,397000
20200212,050463,百和元大94購04,,,,,0.00,0.00,0,0,0,0,0,0,0,0,0,0,0,0,0
20200212,050464,華通國泰95購01,,,,,0.00,0.00,0,0,0,0,0,0,0,0,0,0,0,0,0
20200212,050465,神基中信94購01,,,,,0.00,0.00,0,0,0,0,0,0,0,0,0,0,0,0,0
20200212,050466,瑞儀中信94購01,,,,,0.00,0.00,0,0,0,0,0,0,0,0,0,0,0,0,0
20200212,050467,力成中信94購01,0.81,0.95,0.76,0.94,+0.25,36.23,849000,71,715090,0,0,0,0,0,0,179000,636000,-457000,-457000
20200212,050468,矽格中信94購01,0.20,0.20,0.20,0.20,+0.01,5.26,300000,3,60000,0,0,0,0,0,0,295000,0,295000,295000
20200212,050469,聯電台新94購01,2.06,2.18,2.03,2.18,-0.04,-1.8,305000,34,644640,0,0,0,0,0,0,305000,0,305000,305000
20200212,05046P,台光電永豐95售02,0.98,0.98,0.92,0.92,0.00,0.00,30000,3,28600,0,0,0,0,0,0,10000,20000,-10000,-10000
20200212,050470,智邦台新94購01,,,,,0.00,0.00,0,0,0,0,0,0,0,0,0,0,0,0,0
20200212,050471,國泰金台新94購01,0.63,0.70,0.62,0.70,0.00,0.00,222000,24,143020,0,0,0,0,0,0,189000,33000,156000,156000
20200212,050472,和大永豐94購01,0.41,0.41,0.41,0.41,-0.01,-2.38,25000,1,10250,0,0,0,0,0,0,25000,0,25000,25000
20200212,050473,劍麟永豐94購02,,,,,0.00,0.00,0,0,0,0,0,0,0,0,0,0,0,0,0
20200212,050474,鴻海永豐94購05,,,,,0.00,0.00,0,0,0,0,0,0,0,0,0,0,0,0,0
20200212,050475,揚明光永豐95購01,,,,,0.00,0.00,0,0,0,0,0,0,0,0,0,0,0,0,0
20200212,050476,瑞儀永豐94購01,,,,,0.00,0.00,0,0,0,0,0,0,0,0,0,0,0,0,0
20200212,050477,矽力永豐94購01,1.41,1.63,1.41,1.63,+0.23,16.43,75000,11,113410,0,0,0,0,0,0,10000,65000,-55000,-55000
20200212,050478,致新永豐94購02,,,,,0.00,0.00,0,0,0,0,0,0,0,0,0,0,0,0,0
20200212,050479,上証2X國票95購02,0.10,0.10,0.10,0.10,-0.02,-16.67,30000,1,3000,0,0,0,0,0,0,0,30000,-30000,-30000
20200212,05047P,強茂永豐95售02,,,,,0.00,0.00,0,0,0,0,0,0,0,0,0,0,0,0,0
20200212,050480,健策國票95購04,6.85,6.85,6.85,6.85,+0.65,10.48,19000,2,130150,0,0,0,0,0,0,19000,0,19000,19000
20200212,050481,泰鼎國票96購01,2.01,2.16,1.94,1.94,+0.11,6.01,533000,33,1083240,0,0,0,0,0,0,156000,477000,-321000,-321000
20200212,050482,台郡國票94購04,,,,,0.00,0.00,0,0,0,0,0,0,0,0,0,0,0,0,0
20200212,050483,樺漢國票94購01,2.16,2.33,2.13,2.33,+0.24,11.48,45000,4,97750,0,0,0,0,0,0,40000,5000,35000,35000
20200212,050484,世紀鋼國票95購02,0.68,0.70,0.68,0.68,-0.04,-5.56,30000,8,20540,0,0,0,0,0,0,30000,0,30000,30000
20200212,050485,國巨統一96購01,,,,,0.00,0.00,0,0,0,0,0,0,0,0,0,0,0,0,0
20200212,050486,可成元富94購05,,,,,0.00,0.00,0,0,0,0,0,0,0,0,0,0,0,0,0
20200212,050487,美食元富94購01,,,,,0.00,0.00,0,0,0,0,0,0,0,0,0,0,0,0,0
20200212,050488,美食元富94購02,,,,,0.00,0.00,0,0,0,0,0,0,0,0,0,0,0,0,0
20200212,050489,聯詠元富94購01,2.57,2.66,2.42,2.56,+0.20,8.47,147000,17,380350,0,0,0,0,0,0,86000,61000,25000,25000
20200212,05048P,同欣電永豐95售01,,,,,0.00,0.00,0,0,0,0,0,0,0,0,0,0,0,0,0
20200212,050490,上証2X國泰95購01,,,,,0.00,0.00,0,0,0,0,0,0,0,0,0,0,0,0,0
20200212,050491,旺宏國泰96購01,2.53,2.59,2.47,2.47,-0.04,-1.59,61000,8,155150,0,0,0,0,0,0,38000,25000,13000,13000
20200212,050492,漢唐國泰96購01,2.61,2.66,2.61,2.63,+0.05,1.94,15000,3,39500,0,0,0,0,0,0,15000,0,15000,15000
20200212,050493,聯發科永昌96購01,2.14,2.45,2.12,2.36,+0.46,24.21,588000,21,1358780,0,0,0,0,0,0,413000,353000,60000,60000
20200212,050494,可成永昌96購01,0.80,0.94,0.80,0.94,+0.22,30.56,427000,14,366600,0,0,0,0,0,0,72000,395000,-323000,-323000
20200212,050495,大立光永昌96購01,3.61,3.69,3.61,3.69,+0.35,10.48,62000,4,228240,0,0,0,0,0,0,0,62000,-62000,-62000
20200212,050496,鴻海富邦96購01,0.61,0.74,0.61,0.74,+0.17,29.82,106000,12,74620,0,0,0,0,0,0,80000,0,80000,80000
20200212,050497,臺指反凱基96購02,,,,,0.00,0.00,0,0,0,0,0,0,0,0,0,0,0,0,0
20200212,050498,為升凱基94購07,,,,,0.00,0.00,0,0,0,0,0,0,0,0,0,0,0,0,0
20200212,050499,台達電凱基94購11,0.38,0.40,0.38,0.40,+0.02,5.26,70000,4,27800,0,0,0,0,0,0,2000,10000,-8000,-8000
20200212,05049P,矽創永豐95售01,1.14,1.14,1.06,1.06,-0.17,-13.82,139000,6,150580,0,0,0,0,0,0,139000,0,139000,139000
20200212,050500,台積電凱基94購36,,,,,0.00,0.00,0,0,0,0,0,0,0,0,0,0,0,0,0
20200212,050501,佳世達凱基94購03,,,,,0.00,0.00,0,0,0,0,0,0,0,0,0,0,0,0,0
20200212,050502,聯發科凱基94購21,0.95,0.95,0.95,0.95,+0.29,43.94,68000,1,64600,0,0,0,0,0,0,68000,0,68000,68000
20200212,050503,聯發科凱基94購22,,,,,0.00,0.00,0,0,0,0,0,0,0,0,0,0,0,0,0
20200212,050504,全新凱基94購03,0.16,0.22,0.15,0.22,+0.08,57.14,162000,11,29110,0,0,0,0,0,0,91000,67000,24000,24000
20200212,050505,可成凱基94購12,0.26,0.28,0.26,0.28,0.00,0.00,34000,2,8920,0,0,0,0,0,0,30000,4000,26000,26000
20200212,050506,奇鋐凱基94購02,,,,,0.00,0.00,0,0,0,0,0,0,0,0,0,0,0,0,0
20200212,050507,聯詠凱基94購06,,,,,0.00,0.00,0,0,0,0,0,0,0,0,0,0,0,0,0
20200212,050508,上証2X元大97購01,,,,,0.00,0.00,0,0,0,0,0,0,0,0,0,0,0,0,0
20200212,050509,元油2X元大94購09,,,,,0.00,0.00,0,0,0,0,0,0,0,0,0,0,0,0,0
20200212,05050P,華通群益96售02,,,,,0.00,0.00,0,0,0,0,0,0,0,0,0,0,0,0,0
20200212,050510,元油2X元大94購10,,,,,0.00,0.00,0,0,0,0,0,0,0,0,0,0,0,0,0
20200212,050511,元油2X元大94購11,0.08,0.08,0.08,0.08,0.00,0.00,499000,1,39920,0,0,0,0,0,0,499000,0,499000,499000
20200212,050512,台泥元大94購01,1.91,1.98,1.91,1.98,-0.04,-1.98,73000,2,142930,0,0,0,0,0,0,73000,50000,23000,23000
20200212,050513,亞泥元大94購02,2.13,2.15,2.11,2.11,0.00,0.00,56000,3,118340,0,0,0,0,0,0,6000,56000,-50000,-50000
20200212,050514,聯電元大94購01,2.29,2.44,2.29,2.44,+0.14,6.09,4000,4,9510,0,0,0,0,0,0,1000,3000,-2000,-2000
20200212,050515,聯電元大96購01,2.12,2.28,2.09,2.21,+0.05,2.31,100000,13,217830,0,0,0,0,0,0,51000,99000,-48000,-48000
20200212,050516,華通元大95購05,0.97,1.35,0.93,1.35,+0.43,46.74,514000,39,596470,0,0,0,0,0,0,369000,204000,165000,165000
20200212,050517,台積電元大94購27,4.57,4.79,4.57,4.79,+0.45,10.37,282000,9,1310800,0,0,0,0,0,0,272000,42000,230000,230000
20200212,050518,台積電元大94購28,3.25,3.34,3.25,3.34,+0.19,6.03,59000,20,194500,0,0,0,0,0,0,59000,59000,0,0
20200212,050519,旺宏元大95購03,2.18,2.25,2.16,2.16,-0.04,-1.82,72000,7,160140,0,0,0,0,0,0,62000,72000,-10000,-10000
20200212,05051P,鴻海群益95售05,1.95,1.95,1.95,1.95,-0.50,-20.41,4000,1,7800,0,0,0,0,0,0,4000,0,4000,4000
20200212,050520,凌陽元大94購02,,,,,0.00,0.00,0,0,0,0,0,0,0,0,0,0,0,0,0
20200212,050521,聯發科元大94購15,1.25,1.42,1.24,1.42,+0.34,31.48,401000,17,539120,0,0,0,0,0,0,335000,74000,261000,261000
20200212,050522,聯發科元大95購03,2.85,3.10,2.81,3.06,+0.49,19.07,1383000,82,4106580,0,0,0,0,0,0,809000,958000,-149000,-149000
20200212,050523,義隆元大94購05,0.85,0.86,0.79,0.79,+0.12,17.91,96000,9,78120,0,0,0,0,0,0,43000,53000,-10000,-10000
20200212,050524,宏達電元大95購04,,,,,0.00,0.00,0,0,0,0,0,0,0,0,0,0,0,0,0
20200212,050525,嘉晶元大95購02,0.51,0.51,0.48,0.48,+0.07,17.07,306000,2,155880,0,0,0,0,0,0,6000,300000,-294000,-294000
20200212,050526,貿聯元大95購01,0.71,0.81,0.71,0.81,+0.11,15.71,250000,14,188630,0,0,0,0,0,0,145000,105000,40000,40000
20200212,050527,嘉聯益元大96購01,0.31,0.34,0.31,0.33,+0.02,6.45,499000,14,164070,0,0,0,0,0,0,499000,0,499000,499000
20200212,050528,瑞儀元大94購02,0.39,0.39,0.37,0.39,+0.01,2.63,136000,3,51880,0,0,0,0,0,0,68000,68000,0,0
20200212,050529,矽格元大94購05,0.92,0.92,0.92,0.92,0.00,0.00,68000,1,62560,0,0,0,0,0,0,0,68000,-68000,-68000
20200212,05052P,友達群益97售01,0.12,0.12,0.12,0.12,0.00,0.00,2000,1,240,0,0,0,0,0,0,2000,0,2000,2000
20200212,050530,台表科元大95購04,1.46,1.57,1.45,1.57,+0.17,12.14,190000,17,284410,0,0,0,0,0,0,99000,171000,-72000,-72000
20200212,050531,訊芯元大95購02,0.39,0.45,0.39,0.45,+0.08,21.62,43000,6,18590,0,0,0,0,0,0,0,43000,-43000,-43000
20200212,050532,矽創元大94購03,0.35,0.49,0.35,0.49,+0.13,36.11,62000,7,26000,0,0,0,0,0,0,10000,52000,-42000,-42000
20200212,050533,致新元大94購03,0.60,0.61,0.57,0.58,+0.01,1.75,667000,20,384760,0,0,0,0,0,0,620000,47000,573000,573000
20200212,050534,臻鼎兆豐94購01,0.22,0.22,0.14,0.14,+0.03,27.27,90000,3,13500,0,0,0,0,0,0,80000,10000,70000,70000
20200212,050535,台表科群益94購02,0.98,1.07,0.98,1.07,+0.14,15.05,400000,6,400330,0,0,0,0,0,0,24000,376000,-352000,-352000
20200212,050536,亞泥凱基95購01,0.48,0.48,0.48,0.48,+0.03,6.67,3000,1,1440,0,0,0,0,0,0,3000,0,3000,3000
20200212,050537,鴻海凱基95購05,1.74,1.74,1.74,1.74,+0.15,9.43,1000,1,1740,0,0,0,0,0,0,1000,0,1000,1000
20200212,050538,鴻海凱基95購06,0.49,0.51,0.49,0.51,+0.06,13.33,22000,4,10920,0,0,0,0,0,0,7000,12000,-5000,-5000
20200212,050539,鴻海凱基95購07,0.18,0.26,0.18,0.26,0.00,0.00,19000,6,3890,0,0,0,0,0,0,15000,3000,12000,12000
20200212,05053P,新日興群益95售01,0.31,0.31,0.31,0.31,-0.01,-3.12,110000,2,34100,0,0,0,0,0,0,110000,0,110000,110000
20200212,050540,台積電凱基94購38,2.90,2.90,2.90,2.90,0.00,0.00,2000,1,5800,0,0,0,0,0,0,2000,0,2000,2000
20200212,050541,智邦凱基94購04,0.29,0.34,0.25,0.27,-0.01,-3.57,746000,15,212890,0,0,0,0,0,0,236000,410000,-174000,-174000
20200212,050542,宏碁凱基95購01,,,,,0.00,0.00,0,0,0,0,0,0,0,0,0,0,0,0,0
20200212,050543,聯發科凱基95購01,1.76,2.00,1.76,2.00,+0.46,29.87,418000,13,796920,0,0,0,0,0,0,378000,46000,332000,332000
20200212,050544,聯發科凱基95購02,1.38,1.53,1.38,1.53,+0.45,41.67,15000,4,21450,0,0,0,0,0,0,15000,5000,10000,10000
20200212,050545,奇力新凱基95購01,7.15,7.15,7.15,7.15,+0.35,5.15,10000,1,71500,0,0,0,0,0,0,10000,0,10000,10000
20200212,050546,可成凱基94購13,0.15,0.15,0.15,0.15,0.00,0.00,100000,1,15000,0,0,0,0,0,0,100000,0,100000,100000
20200212,050547,華新科凱基95購01,4.03,4.09,4.03,4.09,+0.14,3.54,20000,5,81170,0,0,0,0,0,0,10000,20000,-10000,-10000
20200212,050548,華固凱基95購01,1.21,1.21,1.21,1.21,+0.03,2.54,299000,1,361790,0,0,0,0,0,0,299000,0,299000,299000
20200212,050549,慧洋凱基95購01,,,,,0.00,0.00,0,0,0,0,0,0,0,0,0,0,0,0,0
20200212,05054P,臻鼎群益95售02,2.18,2.50,1.92,2.50,-0.26,-9.42,143000,9,337560,0,0,0,0,0,0,10000,133000,-123000,-123000
20200212,050550,大立光凱基95購04,,,,,0.00,0.00,0,0,0,0,0,0,0,0,0,0,0,0,0
20200212,050551,大立光凱基95購05,,,,,0.00,0.00,0,0,0,0,0,0,0,0,0,0,0,0,0
20200212,050552,禾伸堂凱基94購05,1.33,1.42,1.32,1.42,+0.07,5.19,100000,13,136110,0,0,0,0,0,0,31000,71000,-40000,-40000
20200212,050553,緯穎凱基94購06,5.70,6.05,5.70,6.05,+0.20,3.42,11000,2,66200,0,0,0,0,0,0,1000,10000,-9000,-9000
20200212,050554,百和凱基95購01,,,,,0.00,0.00,0,0,0,0,0,0,0,0,0,0,0,0,0
20200212,050555,道瓊銀統一94購01,,,,,0.00,0.00,0,0,0,0,0,0,0,0,0,0,0,0,0
20200212,050556,道瓊銀統一95購01,,,,,0.00,0.00,0,0,0,0,0,0,0,0,0,0,0,0,0
20200212,050557,台積電統一94購13,1.32,1.32,1.28,1.28,+0.05,4.07,83000,3,108360,0,0,0,0,0,0,83000,0,83000,83000
20200212,050558,台積電統一94購14,2.02,2.14,2.02,2.14,+0.21,10.88,186000,5,392490,0,0,0,0,0,0,60000,126000,-66000,-66000
20200212,050559,聯發科統一94購10,0.64,0.75,0.63,0.75,+0.22,41.51,1234000,48,856840,0,0,0,0,0,0,818000,316000,502000,502000
20200212,05055P,台表科群益95售01,,,,,0.00,0.00,0,0,0,0,0,0,0,0,0,0,0,0,0
20200212,050560,聯詠統一94購02,1.07,1.13,0.99,1.09,+0.14,14.74,263000,24,284020,0,0,0,0,0,0,127000,125000,2000,2000
20200212,050561,上証2X元富97購01,0.73,0.73,0.73,0.73,+0.08,12.31,93000,7,67890,0,0,0,0,0,0,0,93000,-93000,-93000
20200212,050562,瑞昱元富94購02,1.05,1.18,1.05,1.12,+0.15,15.46,558000,23,621360,0,0,0,0,0,0,145000,416000,-271000,-271000
20200212,050563,臻鼎元富94購07,,,,,0.00,0.00,0,0,0,0,0,0,0,0,0,0,0,0,0
20200212,050564,臻鼎元富94購08,0.34,0.36,0.34,0.36,+0.19,111.76,98000,2,34280,0,0,0,0,0,0,0,98000,-98000,-98000
20200212,050565,矽格元富94購01,0.58,0.62,0.58,0.62,+0.09,16.98,103000,11,61030,0,0,0,0,0,0,50000,53000,-3000,-3000
20200212,050566,高股息中信97購02,0.85,0.86,0.85,0.86,+0.08,10.26,66000,4,56700,0,0,0,0,0,0,16000,50000,-34000,-34000
20200212,050567,道瓊銀中信96購01,,,,,0.00,0.00,0,0,0,0,0,0,0,0,0,0,0,0,0
20200212,050568,為升中信97購01,0.14,0.15,0.14,0.15,+0.01,7.14,900000,5,130500,0,0,0,0,0,0,450000,450000,0,0
20200212,050569,英業達中信94購01,0.60,0.60,0.60,0.60,+0.02,3.45,45000,1,27000,0,0,0,0,0,0,0,45000,-45000,-45000
20200212,05056P,訊芯群益95售01,1.56,1.56,1.47,1.47,-0.19,-11.45,77000,9,116250,0,0,0,0,0,0,2000,75000,-73000,-73000
20200212,050570,聯發科中信97購02,,,,,0.00,0.00,0,0,0,0,0,0,0,0,0,0,0,0,0
20200212,050571,美食中信95購01,,,,,0.00,0.00,0,0,0,0,0,0,0,0,0,0,0,0,0
20200212,050572,大立光中信97購01,0.93,1.01,0.93,1.01,+0.11,12.22,40000,3,38500,0,0,0,0,0,0,40000,0,40000,40000
20200212,050573,光寶科國票94購01,0.71,0.72,0.71,0.72,+0.02,2.86,72000,2,51620,0,0,0,0,0,0,0,72000,-72000,-72000
20200212,050574,微星國票94購01,0.98,0.98,0.91,0.92,-0.05,-5.15,80000,3,74300,0,0,0,0,0,0,70000,10000,60000,60000
20200212,050575,南亞科國票94購01,,,,,0.00,0.00,0,0,0,0,0,0,0,0,0,0,0,0,0
20200212,050576,南亞科國票95購01,2.20,2.22,2.16,2.16,-0.16,-6.9,371000,19,823160,0,0,0,0,0,0,370000,1000,369000,369000
20200212,050577,美律國票94購03,0.49,0.61,0.49,0.59,+0.16,37.21,42000,11,23140,0,0,0,0,0,0,6000,36000,-30000,-30000
20200212,050578,聯發科國票95購03,1.75,1.80,1.74,1.80,+0.52,40.62,24000,3,42150,0,0,0,0,0,0,5000,19000,-14000,-14000
20200212,050579,聯發科國票95購04,1.91,2.01,1.91,1.98,+0.25,14.45,245000,7,487150,0,0,0,0,0,0,200000,45000,155000,155000
20200212,05057P,鴻海國票96售01,1.18,1.18,1.18,1.18,0.00,0.00,12000,1,14160,0,0,0,0,0,0,0,12000,-12000,-12000
20200212,050580,強茂國票95購01,0.39,0.39,0.39,0.39,0.00,0.00,105000,3,40950,0,0,0,0,0,0,0,105000,-105000,-105000
20200212,050581,美食國票94購02,0.19,0.24,0.19,0.22,+0.04,22.22,310000,15,69360,0,0,0,0,0,0,230000,80000,150000,150000
20200212,050582,傳奇國票94購01,,,,,0.00,0.00,0,0,0,0,0,0,0,0,0,0,0,0,0
20200212,050583,瑞儀國票94購01,,,,,0.00,0.00,0,0,0,0,0,0,0,0,0,0,0,0,0
20200212,050584,瑞儀國票95購01,,,,,0.00,0.00,0,0,0,0,0,0,0,0,0,0,0,0,0
20200212,050585,矽格國票94購01,0.82,0.87,0.79,0.87,+0.09,11.54,200000,22,166830,0,0,0,0,0,0,59000,141000,-82000,-82000
20200212,050586,康友國票94購01,5.20,5.50,5.20,5.50,+0.52,10.44,2000,2,10700,0,0,0,0,0,0,2000,0,2000,2000
20200212,050587,緯穎國票94購02,8.50,9.90,8.20,9.90,+0.95,10.61,96000,14,854200,0,0,0,0,0,0,35000,61000,-26000,-26000
20200212,050588,矽創國票95購01,0.45,0.59,0.45,0.59,+0.13,28.26,158000,9,83300,0,0,0,0,0,0,60000,98000,-38000,-38000
20200212,050589,昇陽半國票94購02,,,,,0.00,0.00,0,0,0,0,0,0,0,0,0,0,0,0,0
20200212,05058P,燿華國票97售01,,,,,0.00,0.00,0,0,0,0,0,0,0,0,0,0,0,0,0
20200212,050590,晶技永豐95購01,0.95,0.95,0.95,0.95,-0.01,-1.04,24000,1,22800,0,0,0,0,0,0,24000,0,24000,24000
20200212,050591,智易永豐94購04,,,,,0.00,0.00,0,0,0,0,0,0,0,0,0,0,0,0,0
20200212,050592,矽格永豐94購02,,,,,0.00,0.00,0,0,0,0,0,0,0,0,0,0,0,0,0
20200212,050593,台表科永豐94購03,,,,,0.00,0.00,0,0,0,0,0,0,0,0,0,0,0,0,0
20200212,050594,康友永豐94購01,2.83,2.96,2.83,2.96,+0.13,4.59,15000,2,43750,0,0,0,0,0,0,5000,10000,-5000,-5000
20200212,050595,緯穎永豐94購03,2.47,2.70,2.47,2.70,+0.21,8.43,104000,9,264180,0,0,0,0,0,0,64000,40000,24000,24000
20200212,050596,昇陽半永豐94購03,0.11,0.11,0.11,0.11,0.00,0.00,210000,1,23100,0,0,0,0,0,0,210000,0,210000,210000
20200212,050597,聯電麥證94購01,2.72,2.72,2.72,2.72,0.00,0.00,1000,1,2720,0,1000,-1000,0,0,0,0,1000,-1000,-1000
20200212,050598,友達麥證94購01,,,,,0.00,0.00,0,0,0,0,0,0,0,0,0,0,0,0,0
20200212,050599,美食麥證94購01,0.07,0.07,0.07,0.07,0.00,0.00,299000,1,20930,299000,0,299000,0,0,0,299000,0,299000,299000
20200212,05059P,大立光國票96售02,,,,,0.00,0.00,0,0,0,0,0,0,0,0,0,0,0,0,0
20200212,050600,瑞儀國泰95購01,0.67,0.67,0.65,0.65,0.00,0.00,20000,2,13200,0,0,0,0,0,0,0,20000,-20000,-20000
20200212,050601,台表科國泰96購01,1.45,1.60,1.45,1.60,+0.18,12.68,301000,10,458210,0,0,0,0,0,0,229000,63000,166000,166000
20200212,050602,訊芯國泰96購01,0.48,0.58,0.48,0.57,+0.07,14.0,196000,24,107060,0,0,0,0,0,0,134000,62000,72000,72000
20200212,050603,致新國泰96購01,0.67,0.68,0.64,0.67,-0.01,-1.47,268000,26,177530,0,0,0,0,0,0,232000,36000,196000,196000
20200212,050604,上証2X永昌94購01,0.89,0.89,0.83,0.86,-0.06,-6.52,41000,5,35760,0,0,0,0,0,0,31000,10000,21000,21000
20200212,050605,上証2X元大97購02,,,,,0.00,0.00,0,0,0,0,0,0,0,0,0,0,0,0,0
20200212,050606,劍麟元大94購02,,,,,0.00,0.00,0,0,0,0,0,0,0,0,0,0,0,0,0
20200212,050607,為升元大94購10,,,,,0.00,0.00,0,0,0,0,0,0,0,0,0,0,0,0,0
20200212,050608,台達電元大94購12,1.61,1.70,1.61,1.70,+0.11,6.92,194000,8,314240,0,0,0,0,0,0,68000,126000,-58000,-58000
20200212,050609,鴻海元大94購23,,,,,0.00,0.00,0,0,0,0,0,0,0,0,0,0,0,0,0
20200212,05060P,台達電富邦97售02,0.62,0.63,0.62,0.62,0.00,0.00,351000,10,218840,0,0,0,0,0,0,329000,22000,307000,307000
20200212,050610,鴻海元大94購24,2.47,3.16,2.47,3.16,+0.77,32.22,135000,9,400950,0,0,0,0,0,0,135000,125000,10000,10000
20200212,050611,鴻海元大95購02,0.96,1.23,0.93,1.23,+0.30,32.26,806000,31,878150,0,0,0,0,0,0,759000,744000,15000,15000
20200212,050612,台積電元大95購06,2.27,2.27,2.27,2.27,0.00,0.00,10000,1,22700,0,0,0,0,0,0,0,10000,-10000,-10000
20200212,050613,台光電元大94購09,0.48,0.63,0.48,0.60,+0.13,27.66,980000,25,576870,0,0,0,0,0,0,227000,737000,-510000,-510000
20200212,050614,聯發科元大95購04,1.03,1.13,1.01,1.12,+0.21,23.08,885000,36,955090,0,0,0,0,0,0,300000,555000,-255000,-255000
20200212,050615,奇力新元大95購03,8.15,8.25,8.00,8.00,+0.15,1.91,45000,13,363500,0,0,0,0,0,0,35000,30000,5000,5000
20200212,050616,潤泰全元大94購01,,,,,0.00,0.00,0,0,0,0,0,0,0,0,0,0,0,0,0
20200212,050617,神基元大94購01,1.28,1.32,1.26,1.32,+0.03,2.33,240000,11,313880,0,0,0,0,0,0,105000,135000,-30000,-30000
20200212,050618,緯創元大95購01,2.15,2.23,2.15,2.20,+0.08,3.77,57000,5,125720,0,0,0,0,0,0,49000,8000,41000,41000
20200212,050619,TPK元大95購02,,,,,0.00,0.00,0,0,0,0,0,0,0,0,0,0,0,0,0
20200212,05061P,鴻海富邦96售03,0.70,0.70,0.64,0.64,-0.16,-20.0,72000,6,49580,0,0,0,0,0,0,52000,62000,-10000,-10000
20200212,050620,和碩元大94購04,2.69,2.89,2.56,2.79,-0.07,-2.45,82000,8,224750,0,0,0,0,0,0,58000,24000,34000,34000
20200212,050621,易華電元大95購01,,,,,0.00,0.00,0,0,0,0,0,0,0,0,0,0,0,0,0
20200212,050622,昇陽半元大94購05,,,,,0.00,0.00,0,0,0,0,0,0,0,0,0,0,0,0,0
20200212,050623,致新元大94購05,0.54,0.54,0.51,0.51,-0.01,-1.92,265000,17,137650,0,0,0,0,0,0,265000,0,265000,265000
20200212,050624,鈺齊元大94購01,1.25,1.38,1.25,1.38,+0.15,12.2,21000,3,28650,0,0,0,0,0,0,1000,20000,-19000,-19000
20200212,050625,康控第一94購01,,,,,0.00,0.00,0,0,0,0,0,0,0,0,0,0,0,0,0
20200212,050626,A50正2中信96購02,,,,,0.00,0.00,0,0,0,0,0,0,0,0,0,0,0,0,0
20200212,050627,華通中信94購02,1.15,1.55,1.13,1.48,+0.39,35.78,221000,24,290290,0,0,0,0,0,0,91000,145000,-54000,-54000
20200212,050628,美律中信94購02,0.75,0.86,0.75,0.85,+0.15,21.43,757000,65,593870,0,0,0,0,0,0,161000,570000,-409000,-409000
20200212,050629,廣宇亞東96購01,,,,,0.00,0.00,0,0,0,0,0,0,0,0,0,0,0,0,0
20200212,05062P,大立光富邦98售03,0.68,0.68,0.67,0.67,-0.04,-5.63,73000,12,49030,0,0,0,0,0,0,0,64000,-64000,-64000
20200212,050630,大立光亞東96購01,,,,,0.00,0.00,0,0,0,0,0,0,0,0,0,0,0,0,0
20200212,050631,矽創亞東94購01,,,,,0.00,0.00,0,0,0,0,0,0,0,0,0,0,0,0,0
20200212,050632,國巨群益94購07,12.90,13.30,12.90,13.30,+1.20,9.92,45000,17,582500,0,0,0,0,0,0,45000,43000,2000,2000
20200212,050633,義隆群益96購02,0.97,0.97,0.87,0.95,+0.16,20.25,368000,9,344680,0,0,0,0,0,0,302000,66000,236000,236000
20200212,050634,華新科群益96購01,5.60,5.60,5.55,5.55,+0.35,6.73,20000,2,111500,0,0,0,0,0,0,20000,0,20000,20000
20200212,050635,昇陽半群益94購04,,,,,0.00,0.00,0,0,0,0,0,0,0,0,0,0,0,0,0
20200212,050636,上証2X國票94購01,,,,,0.00,0.00,0,0,0,0,0,0,0,0,0,0,0,0,0
20200212,050637,欣興國票94購02,0.34,0.34,0.34,0.34,+0.03,9.68,60000,1,20400,0,0,0,0,0,0,0,60000,-60000,-60000
20200212,050638,創意國票94購02,,,,,0.00,0.00,0,0,0,0,0,0,0,0,0,0,0,0,0
20200212,050639,GIS國票96購01,0.34,0.36,0.34,0.36,+0.04,12.5,75000,2,25800,0,0,0,0,0,0,0,75000,-75000,-75000
20200212,05063P,聯電元大96售03,0.51,0.51,0.51,0.51,-0.01,-1.92,240000,6,122400,0,0,0,0,0,0,235000,5000,230000,230000
20200212,050640,致新國票94購01,0.26,0.26,0.24,0.25,+0.01,4.17,90000,5,23210,0,0,0,0,0,0,90000,0,90000,90000
20200212,050641,上証反凱基96購01,0.45,0.46,0.44,0.46,0.00,0.00,32000,3,14400,0,0,0,0,0,0,0,30000,-30000,-30000
20200212,050642,和大凱基94購03,0.93,0.98,0.93,0.98,-0.06,-5.77,23000,3,21540,0,0,0,0,0,0,20000,3000,17000,17000
20200212,050643,為升凱基94購08,,,,,0.00,0.00,0,0,0,0,0,0,0,0,0,0,0,0,0
20200212,050644,國巨凱基96購01,,,,,0.00,0.00,0,0,0,0,0,0,0,0,0,0,0,0,0
20200212,050645,台積電凱基94購39,2.98,2.98,2.98,2.98,0.00,0.00,30000,2,89400,0,0,0,0,0,0,30000,0,30000,30000
20200212,050646,美律凱基96購01,0.49,0.50,0.49,0.50,+0.13,35.14,16000,3,7940,0,0,0,0,0,0,0,16000,-16000,-16000
20200212,050647,聯發科凱基96購01,1.41,1.61,1.41,1.61,+0.30,22.9,323000,11,493730,0,0,0,0,0,0,267000,10000,257000,257000
20200212,050648,全新凱基96購01,0.59,0.61,0.59,0.61,+0.26,74.29,15000,3,8950,0,0,0,0,0,0,0,15000,-15000,-15000
20200212,050649,華新科凱基96購01,4.19,4.23,4.13,4.23,+0.11,2.67,51000,9,213400,0,0,0,0,0,0,50000,8000,42000,42000
20200212,05064P,台積電元大95售10,,,,,0.00,0.00,0,0,0,0,0,0,0,0,0,0,0,0,0
20200212,050650,大立光凱基96購01,2.86,2.96,2.86,2.96,+0.40,15.62,60000,5,176350,0,0,0,0,0,0,60000,59000,1000,1000
20200212,050651,大立光凱基96購02,,,,,0.00,0.00,0,0,0,0,0,0,0,0,0,0,0,0,0
20200212,050652,大立光凱基96購03,2.00,2.00,2.00,2.00,+0.20,11.11,10000,1,20000,0,0,0,0,0,0,10000,0,10000,10000
20200212,050653,聯鈞凱基96購01,2.23,2.44,0.58,2.44,+0.40,19.61,70000,3,141700,0,0,0,0,0,0,50000,20000,30000,30000
20200212,050654,鎧勝凱基96購01,,,,,0.00,0.00,0,0,0,0,0,0,0,0,0,0,0,0,0
20200212,050655,中磊凱基96購01,0.41,0.41,0.41,0.41,0.00,0.00,1000,1,410,0,0,0,0,0,0,0,1000,-1000,-1000
20200212,050656,瑞儀凱基96購01,,,,,0.00,0.00,0,0,0,0,0,0,0,0,0,0,0,0,0
20200212,050657,宏達電麥證94購01,0.43,0.43,0.42,0.42,+0.05,13.51,20000,2,8500,0,20000,-20000,0,0,0,0,20000,-20000,-20000
20200212,050658,台郡麥證96購01,,,,,0.00,0.00,0,0,0,0,0,0,0,0,0,0,0,0,0
20200212,050659,宏達電元大96購01,0.22,0.22,0.22,0.22,0.00,0.00,44000,2,9680,0,0,0,0,0,0,44000,0,44000,44000
20200212,05065P,燿華元大96售03,,,,,0.00,0.00,0,0,0,0,0,0,0,0,0,0,0,0,0
20200212,050660,欣興元大96購02,0.34,0.38,0.34,0.38,+0.08,26.67,166000,5,61960,0,0,0,0,0,0,163000,3000,160000,160000
20200212,050661,景碩元大94購02,1.81,2.27,1.70,2.02,+0.29,16.76,374000,45,735370,0,0,0,0,0,0,200000,236000,-36000,-36000
20200212,050662,智易元大96購01,0.64,0.82,0.64,0.81,+0.21,35.0,264000,9,197900,0,0,0,0,0,0,170000,144000,26000,26000
20200212,050663,麗豐元大96購03,0.56,0.61,0.56,0.59,+0.05,9.26,280000,4,169860,0,0,0,0,0,0,10000,270000,-260000,-260000
20200212,050664,全新台新94購02,0.40,0.57,0.38,0.56,+0.18,47.37,655000,27,314630,0,0,0,0,0,0,264000,391000,-127000,-127000
20200212,050665,南電台新94購01,,,,,0.00,0.00,0,0,0,0,0,0,0,0,0,0,0,0,0
20200212,050666,道瓊銀永豐94購01,,,,,0.00,0.00,0,0,0,0,0,0,0,0,0,0,0,0,0
20200212,050667,國巨永豐94購06,,,,,0.00,0.00,0,0,0,0,0,0,0,0,0,0,0,0,0
20200212,050668,京元電永豐94購01,,,,,0.00,0.00,0,0,0,0,0,0,0,0,0,0,0,0,0
20200212,050669,嘉晶永豐96購01,,,,,0.00,0.00,0,0,0,0,0,0,0,0,0,0,0,0,0
20200212,05066P,康控元大95售03,3.20,3.20,3.05,3.05,0.00,0.00,12000,2,38100,0,0,0,0,0,0,2000,10000,-8000,-8000
20200212,050670,牧德永豐94購03,3.19,3.31,3.00,3.00,-0.15,-4.76,67000,17,214350,0,0,0,0,0,0,39000,28000,11000,11000
20200212,050671,超眾永豐94購04,1.00,1.12,0.97,1.12,+0.08,7.69,910000,57,932650,0,0,0,0,0,0,803000,146000,657000,657000
20200212,050672,上証2X富邦97購01,,,,,0.00,0.00,0,0,0,0,0,0,0,0,0,0,0,0,0
20200212,050673,旺宏富邦96購02,1.43,1.48,1.39,1.40,-0.03,-2.1,36000,15,51380,0,0,0,0,0,0,17000,32000,-15000,-15000
20200212,050674,瑞昱富邦94購02,0.54,0.54,0.52,0.52,+0.05,10.64,12000,3,6460,0,0,0,0,0,0,2000,10000,-8000,-8000
20200212,050675,奇鋐富邦96購01,,,,,0.00,0.00,0,0,0,0,0,0,0,0,0,0,0,0,0
20200212,050676,道瓊銀統一96購02,0.33,0.33,0.33,0.33,-0.04,-10.81,45000,4,14850,0,0,0,0,0,0,10000,35000,-25000,-25000
20200212,050677,光寶科統一94購01,0.68,0.70,0.68,0.69,-0.02,-2.82,221000,5,152960,0,0,0,0,0,0,0,221000,-221000,-221000
20200212,050678,美律統一94購04,0.58,0.70,0.57,0.69,+0.17,32.69,393000,44,252550,0,0,0,0,0,0,48000,337000,-289000,-289000
20200212,050679,上証2X元富97購02,,,,,0.00,0.00,0,0,0,0,0,0,0,0,0,0,0,0,0
20200212,05067P,欣興兆豐96售02,1.23,1.23,1.23,1.23,0.00,0.00,1000,1,1230,0,0,0,0,0,0,0,1000,-1000,-1000
20200212,050680,上銀元富94購01,3.29,3.29,3.11,3.16,+0.02,0.64,318000,14,1022210,0,0,0,0,0,0,175000,180000,-5000,-5000
20200212,050681,南亞科元富94購01,2.36,2.36,2.31,2.31,-0.07,-2.94,31000,4,72640,0,0,0,0,0,0,21000,10000,11000,11000
20200212,050682,南亞科元富94購02,2.21,2.21,2.15,2.18,-0.04,-1.8,60000,7,131110,0,0,0,0,0,0,30000,39000,-9000,-9000
20200212,050683,智原元富94購02,,,,,0.00,0.00,0,0,0,0,0,0,0,0,0,0,0,0,0
20200212,050684,台郡元富94購02,3.99,4.23,3.99,3.99,+1.32,49.44,18000,10,73980,0,0,0,0,0,0,16000,2000,14000,14000
20200212,050685,緯穎元富94購02,2.75,3.12,2.63,3.10,+0.21,7.27,836000,37,2485910,0,0,0,0,0,0,192000,644000,-452000,-452000
20200212,050686,欣興兆豐96購01,0.58,0.68,0.58,0.68,+0.17,33.33,342000,13,215550,0,0,0,0,0,0,40000,292000,-252000,-252000
20200212,050687,上銀日盛94購01,1.21,1.21,1.13,1.15,+0.02,1.77,306000,21,357040,0,0,0,0,0,0,115000,191000,-76000,-76000
20200212,050688,大立光日盛94購03,0.93,0.94,0.92,0.94,+0.11,13.25,410000,3,385280,0,0,0,0,0,0,10000,400000,-390000,-390000
20200212,050689,力山凱基94購07,,,,,0.00,0.00,0,0,0,0,0,0,0,0,0,0,0,0,0
20200212,05068P,鴻海統一95售06,2.71,2.71,2.30,2.30,-0.54,-19.01,471000,38,1150140,0,0,0,0,0,0,191000,366000,-175000,-175000
20200212,050690,台達電凱基96購01,2.08,2.14,2.08,2.14,-0.06,-2.73,227000,6,479260,0,0,0,0,0,0,110000,117000,-7000,-7000
20200212,050691,楠梓電凱基96購01,,,,,0.00,0.00,0,0,0,0,0,0,0,0,0,0,0,0,0
20200212,050692,鴻海凱基96購04,,,,,0.00,0.00,0,0,0,0,0,0,0,0,0,0,0,0,0
20200212,050693,鴻海凱基96購05,,,,,0.00,0.00,0,0,0,0,0,0,0,0,0,0,0,0,0
20200212,050694,國巨凱基96購03,,,,,0.00,0.00,0,0,0,0,0,0,0,0,0,0,0,0,0
20200212,050695,台積電凱基94購40,3.33,3.33,3.33,3.33,0.00,0.00,2000,1,6660,0,0,0,0,0,0,0,2000,-2000,-2000
20200212,050696,台光電凱基96購01,0.26,0.26,0.25,0.25,+0.06,31.58,30000,4,7700,0,0,0,0,0,0,9000,20000,-11000,-11000
20200212,050697,冠德凱基96購01,0.26,0.28,0.26,0.28,0.00,0.00,11000,3,2940,0,0,0,0,0,0,11000,0,11000,11000
20200212,050698,明泰凱基96購01,0.62,0.67,0.62,0.67,0.00,0.00,60000,2,37700,0,0,0,0,0,0,0,60000,-60000,-60000
20200212,050699,京鼎凱基96購01,1.90,2.14,1.89,2.10,+0.47,28.83,281000,35,560610,0,0,0,0,0,0,87000,236000,-149000,-149000
20200212,05069P,鴻海統一96售03,,,,,0.00,0.00,0,0,0,0,0,0,0,0,0,0,0,0,0
20200212,050700,健策凱基96購01,1.72,1.83,0.83,1.83,+0.20,12.27,224000,14,367570,0,0,0,0,0,0,213000,183000,30000,30000
20200212,050701,上緯控凱基94購04,,,,,0.00,0.00,0,0,0,0,0,0,0,0,0,0,0,0,0
20200212,050702,崇越凱基94購01,2.34,2.45,2.34,2.45,0.00,0.00,53000,11,127870,0,0,0,0,0,0,0,53000,-53000,-53000
20200212,050703,矽格凱基94購02,0.59,0.59,0.59,0.59,0.00,0.00,12000,2,7080,0,0,0,0,0,0,0,12000,-12000,-12000
20200212,050704,復盛凱基94購03,2.19,2.19,2.11,2.11,+0.04,1.93,31000,12,66440,0,0,0,0,0,0,26000,5000,21000,21000
20200212,050705,南電凱基96購01,,,,,0.00,0.00,0,0,0,0,0,0,0,0,0,0,0,0,0
20200212,050706,柏文凱基94購01,,,,,0.00,0.00,0,0,0,0,0,0,0,0,0,0,0,0,0
20200212,050707,寶成凱基94購02,,,,,0.00,0.00,0,0,0,0,0,0,0,0,0,0,0,0,0
20200212,050708,臺股指凱基96購06,0.82,0.96,0.82,0.96,+0.15,18.52,363000,22,318040,0,0,0,0,0,0,305000,58000,247000,247000
20200212,050709,嘉聯益第一96購01,0.31,0.31,0.31,0.31,+0.05,19.23,100000,2,31000,0,0,0,0,0,0,0,100000,-100000,-100000
20200212,05070P,鴻海統一96售04,1.35,1.35,1.19,1.20,-0.25,-17.24,75000,9,98090,0,0,0,0,0,0,15000,70000,-55000,-55000
20200212,050710,元黃金中信96購01,1.03,1.03,1.03,1.03,0.00,0.00,100000,1,103000,0,0,0,0,0,0,100000,0,100000,100000
20200212,050711,TPK中信94購01,,,,,0.00,0.00,0,0,0,0,0,0,0,0,0,0,0,0,0
20200212,050712,和碩中信94購01,,,,,0.00,0.00,0,0,0,0,0,0,0,0,0,0,0,0,0
20200212,050713,矽格麥證94購01,0.52,0.54,0.52,0.54,+0.06,12.5,36000,8,18940,3000,33000,-30000,0,0,0,3000,33000,-30000,-30000
20200212,050714,深中小群益98購01,0.84,0.92,0.84,0.91,+0.05,5.81,796000,18,704480,0,0,0,0,0,0,103000,793000,-690000,-690000
20200212,050715,台積電群益96購01,1.88,2.07,1.87,2.07,+0.28,15.64,143000,20,275340,0,0,0,0,0,0,139000,63000,76000,76000
20200212,050716,可成群益96購01,0.79,0.79,0.79,0.79,+0.09,12.86,10000,1,7900,0,0,0,0,0,0,10000,0,10000,10000
20200212,050717,京鼎群益96購01,2.56,2.94,2.56,2.93,+0.60,25.75,224000,14,635770,0,0,0,0,0,0,10000,214000,-204000,-204000
20200212,050718,茂林群益94購04,,,,,0.00,0.00,0,0,0,0,0,0,0,0,0,0,0,0,0
20200212,050719,世紀鋼群益96購01,0.97,0.99,0.96,0.98,-0.01,-1.01,282000,9,273640,0,0,0,0,0,0,282000,3000,279000,279000
20200212,05071P,鴻海統一96售05,,,,,0.00,0.00,0,0,0,0,0,0,0,0,0,0,0,0,0
20200212,050720,上証2X國票94購02,,,,,0.00,0.00,0,0,0,0,0,0,0,0,0,0,0,0,0
20200212,050721,台泥國票94購01,1.55,1.63,1.55,1.63,+0.03,1.88,80000,3,128560,0,0,0,0,0,0,80000,0,80000,80000
20200212,050722,聯電國票96購01,1.97,1.97,1.97,1.97,-0.12,-5.74,60000,7,118200,0,0,0,0,0,0,60000,0,60000,60000
20200212,050723,楠梓電國票94購01,,,,,0.00,0.00,0,0,0,0,0,0,0,0,0,0,0,0,0
20200212,050724,國巨國票96購01,8.20,8.25,8.20,8.25,+0.55,7.14,8000,3,65700,0,0,0,0,0,0,8000,0,8000,8000
20200212,050725,光磊國票96購01,0.86,0.86,0.83,0.83,+0.02,2.47,183000,3,154790,0,0,0,0,0,0,183000,0,183000,183000
20200212,050726,可成國票96購01,0.66,0.69,0.66,0.69,0.00,0.00,112000,3,76980,0,0,0,0,0,0,100000,12000,88000,88000
20200212,050727,華新科國票94購09,,,,,0.00,0.00,0,0,0,0,0,0,0,0,0,0,0,0,0
20200212,050728,新日興國票94購01,,,,,0.00,0.00,0,0,0,0,0,0,0,0,0,0,0,0,0
20200212,050729,聯鈞國票94購01,2.72,3.14,2.70,3.14,+0.62,24.6,145000,24,422860,0,0,0,0,0,0,106000,137000,-31000,-31000
20200212,05072P,聯電元富95售02,0.16,0.16,0.16,0.16,-0.01,-5.88,5000,1,800,0,0,0,0,0,0,5000,0,5000,5000
20200212,050730,復盛國票94購01,2.44,2.44,2.36,2.40,-0.04,-1.64,378000,22,910080,0,0,0,0,0,0,290000,100000,190000,190000
20200212,050731,昇陽半國票96購01,,,,,0.00,0.00,0,0,0,0,0,0,0,0,0,0,0,0,0
20200212,050732,台虹國票94購01,1.28,1.32,1.26,1.29,+0.08,6.61,260000,23,335480,0,0,0,0,0,0,127000,133000,-6000,-6000
20200212,050733,寶成國票94購01,,,,,0.00,0.00,0,0,0,0,0,0,0,0,0,0,0,0,0
20200212,050734,台積電台新94購02,,,,,0.00,0.00,0,0,0,0,0,0,0,0,0,0,0,0,0
20200212,050735,亞光台新94購01,1.01,1.16,1.01,1.16,+0.20,20.83,283000,11,315390,0,0,0,0,0,0,10000,273000,-263000,-263000
20200212,050736,台積電康和94購01,,,,,0.00,0.00,0,0,0,0,0,0,0,0,0,0,0,0,0
20200212,050737,聯詠康和94購01,,,,,0.00,0.00,0,0,0,0,0,0,0,0,0,0,0,0,0
20200212,050738,臺股指康和94購01,,,,,0.00,0.00,0,0,0,0,0,0,0,0,0,0,0,0,0
20200212,050739,臺股指康和94購02,,,,,0.00,0.00,0,0,0,0,0,0,0,0,0,0,0,0,0
20200212,05073P,臺股指中信95售09,0.57,0.57,0.55,0.55,0.00,0.00,10000,2,5600,0,0,0,0,0,0,5000,5000,0,0
20200212,050740,旺宏永豐94購03,1.94,2.12,1.94,1.94,-0.08,-3.96,287000,9,581290,0,0,0,0,0,0,137000,153000,-16000,-16000
20200212,050741,奇鋐永豐94購04,,,,,0.00,0.00,0,0,0,0,0,0,0,0,0,0,0,0,0
20200212,050742,新日興永豐94購01,0.80,0.84,0.77,0.78,-0.06,-7.14,573000,25,460010,0,0,0,0,0,0,387000,187000,200000,200000
20200212,050743,京鼎永豐94購02,0.63,0.75,0.63,0.74,+0.18,32.14,345000,24,243970,0,0,0,0,0,0,79000,266000,-187000,-187000
20200212,050744,健策永豐94購04,1.58,1.69,1.49,1.69,+0.20,13.42,571000,44,898250,0,0,0,0,0,0,370000,201000,169000,169000
20200212,050745,茂林永豐94購06,,,,,0.00,0.00,0,0,0,0,0,0,0,0,0,0,0,0,0
20200212,050746,矽創永豐94購01,,,,,0.00,0.00,0,0,0,0,0,0,0,0,0,0,0,0,0
20200212,050747,道瓊銀統一94購03,,,,,0.00,0.00,0,0,0,0,0,0,0,0,0,0,0,0,0
20200212,050748,道瓊銀統一94購04,,,,,0.00,0.00,0,0,0,0,0,0,0,0,0,0,0,0,0
20200212,050749,道瓊銀統一96購03,,,,,0.00,0.00,0,0,0,0,0,0,0,0,0,0,0,0,0
20200212,05074P,鴻海麥證95售01,1.38,1.38,1.38,1.38,0.00,0.00,1000,1,1380,0,1000,-1000,0,0,0,0,1000,-1000,-1000
20200212,050750,上銀統一94購02,2.37,2.40,2.31,2.31,+0.07,3.12,172000,7,405280,0,0,0,0,0,0,112000,60000,52000,52000
20200212,050751,聯電統一94購05,1.62,1.76,1.57,1.76,+0.09,5.39,784000,39,1307460,0,0,0,0,0,0,472000,307000,165000,165000
20200212,050752,美律統一94購05,0.41,0.49,0.41,0.49,+0.12,32.43,710000,59,319400,0,0,0,0,0,0,70000,609000,-539000,-539000
20200212,050753,百和統一94購01,0.94,0.94,0.91,0.91,-0.04,-4.21,84000,3,77560,0,0,0,0,0,0,56000,28000,28000,28000
20200212,050754,元金2X元富9B購01,0.52,0.52,0.52,0.52,-0.02,-3.7,50000,3,26000,0,0,0,0,0,0,0,20000,-20000,-20000
20200212,050755,和大元富94購01,0.32,0.32,0.30,0.30,-0.05,-14.29,17000,3,5400,0,0,0,0,0,0,2000,15000,-13000,-13000
20200212,050756,京元電元富94購03,0.26,0.28,0.25,0.28,0.00,0.00,316000,23,81290,0,0,0,0,0,0,316000,0,316000,316000
20200212,050757,聯發科元富94購03,1.10,1.20,1.10,1.20,+0.32,36.36,101000,6,115520,0,0,0,0,0,0,40000,61000,-21000,-21000
20200212,050758,聯發科元富9B購01,0.84,0.84,0.81,0.81,+0.13,19.12,50000,3,41100,0,0,0,0,0,0,25000,25000,0,0
20200212,050759,貿聯元富94購02,0.92,1.10,0.92,1.10,+0.19,20.88,638000,40,641950,0,0,0,0,0,0,425000,184000,241000,241000
20200212,05075P,台積電麥證95售01,,,,,0.00,0.00,0,0,0,0,0,0,0,0,0,0,0,0,0
20200212,050760,矽力元富94購03,4.02,4.19,4.02,4.19,+0.04,0.96,27000,4,111660,0,0,0,0,0,0,10000,27000,-17000,-17000
20200212,050761,華通元大94購05,1.04,1.66,0.98,1.66,+0.66,66.0,597000,49,791720,0,0,0,0,0,0,345000,292000,53000,53000
20200212,050762,楠梓電元大94購02,,,,,0.00,0.00,0,0,0,0,0,0,0,0,0,0,0,0,0
20200212,050763,楠梓電元大94購03,0.50,0.55,0.50,0.55,0.00,0.00,342000,13,182410,0,0,0,0,0,0,0,342000,-342000,-342000
20200212,050764,鴻海元大94購27,0.73,1.03,0.71,1.03,+0.31,43.06,807000,41,677490,0,0,0,0,0,0,727000,797000,-70000,-70000
20200212,050765,鴻海元大96購02,1.15,1.46,1.11,1.46,+0.32,28.07,694000,48,887880,0,0,0,0,0,0,663000,557000,106000,106000
20200212,050766,燿華元大96購02,0.50,0.53,0.50,0.53,+0.05,10.42,240000,3,121200,0,0,0,0,0,0,0,235000,-235000,-235000
20200212,050767,京元電元大96購01,0.61,0.66,0.58,0.63,+0.03,5.0,607000,26,376150,0,0,0,0,0,0,597000,219000,378000,378000
20200212,050768,聯發科元大94購16,0.62,0.69,0.62,0.69,+0.16,30.19,101000,10,66490,0,0,0,0,0,0,20000,81000,-61000,-61000
20200212,050769,聯發科元大94購17,1.39,1.57,1.36,1.57,+0.41,35.34,189000,15,276780,0,0,0,0,0,0,157000,32000,125000,125000
20200212,05076P,深中小群益99售02,0.41,0.41,0.38,0.39,-0.02,-4.88,1846000,12,733970,0,0,0,0,0,0,1005000,841000,164000,164000
20200212,050770,全新元大94購04,0.48,0.64,0.47,0.64,+0.24,60.0,612000,14,332570,0,0,0,0,0,0,295000,317000,-22000,-22000
20200212,050771,華新科元大94購06,6.20,6.20,6.00,6.10,+0.20,3.39,94000,32,572050,0,0,0,0,0,0,93000,71000,22000,22000
20200212,050772,美食元大94購06,,,,,0.00,0.00,0,0,0,0,0,0,0,0,0,0,0,0,0
20200212,050773,京鼎元大94購02,2.14,2.53,2.14,2.46,+0.55,28.8,273000,35,633410,0,0,0,0,0,0,67000,272000,-205000,-205000
20200212,050774,健策元大96購02,2.74,2.87,2.60,2.87,+0.34,13.44,260000,24,688640,0,0,0,0,0,0,257000,219000,38000,38000
20200212,050775,TPK元大96購01,,,,,0.00,0.00,0,0,0,0,0,0,0,0,0,0,0,0,0
20200212,050776,康控元大96購03,0.36,0.42,0.36,0.41,+0.06,17.14,573000,18,225250,0,0,0,0,0,0,499000,64000,435000,435000
20200212,050777,臻鼎元大94購05,0.57,0.59,0.49,0.49,+0.20,68.97,71000,4,35070,0,0,0,0,0,0,0,71000,-71000,-71000
20200212,050778,瑞儀元大96購01,0.57,0.57,0.57,0.57,+0.01,1.79,72000,1,41040,0,0,0,0,0,0,0,72000,-72000,-72000
20200212,050779,超眾元大96購03,1.08,1.22,1.08,1.20,+0.08,7.14,608000,56,694160,0,0,0,0,0,0,452000,553000,-101000,-101000
20200212,05077P,智易群益95售02,1.28,1.28,1.28,1.28,0.00,0.00,15000,1,19200,0,0,0,0,0,0,0,15000,-15000,-15000
20200212,050780,台表科元大96購01,0.92,0.99,0.92,0.98,+0.07,7.69,44000,5,41390,0,0,0,0,0,0,43000,3000,40000,40000
20200212,050781,昇陽半元大94購06,0.35,0.35,0.35,0.35,0.00,0.00,60000,1,21000,0,0,0,0,0,0,0,60000,-60000,-60000
20200212,050782,台積電國泰96購03,10.90,11.30,10.90,11.30,+0.80,7.62,10000,2,111000,0,0,0,0,0,0,0,10000,-10000,-10000
20200212,050783,旺宏國泰96購02,3.31,3.31,3.31,3.31,+0.06,1.85,5000,1,16550,0,0,0,0,0,0,5000,0,5000,5000
20200212,050784,美律國泰96購01,1.03,1.22,1.01,1.19,+0.25,26.6,779000,81,877310,0,0,0,0,0,0,137000,666000,-529000,-529000
20200212,050785,全新國泰96購01,1.02,1.28,1.02,1.28,+0.37,40.66,374000,33,448950,0,0,0,0,0,0,273000,101000,172000,172000
20200212,050786,健策國泰96購01,5.50,5.85,5.50,5.85,+0.80,15.84,15000,3,86000,0,0,0,0,0,0,10000,10000,0,0
20200212,050787,致伸國泰96購01,,,,,0.00,0.00,0,0,0,0,0,0,0,0,0,0,0,0,0
20200212,050788,台郡國泰96購01,4.01,4.06,3.96,4.06,+1.25,44.48,44000,20,175980,0,0,0,0,0,0,26000,18000,8000,8000
20200212,050789,矽創國泰96購01,0.88,1.10,0.88,1.10,+0.20,22.22,206000,49,213690,0,0,0,0,0,0,30000,176000,-146000,-146000
20200212,05078P,義隆永豐95售01,1.01,1.07,1.01,1.07,0.00,0.00,120000,12,126520,0,0,0,0,0,0,0,120000,-120000,-120000
20200212,050790,昇陽半國泰96購02,0.84,0.89,0.84,0.86,+0.01,1.18,112000,34,96180,0,0,0,0,0,0,72000,77000,-5000,-5000
20200212,050791,聯發科富邦96購01,0.73,0.79,0.73,0.79,+0.18,29.51,93000,8,69620,0,0,0,0,0,0,75000,18000,57000,57000
20200212,050792,可成富邦96購01,0.27,0.32,0.27,0.32,+0.07,28.0,562000,17,167500,0,0,0,0,0,0,80000,482000,-402000,-402000
20200212,050793,大立光富邦96購03,,,,,0.00,0.00,0,0,0,0,0,0,0,0,0,0,0,0,0
20200212,050794,大立光富邦96購04,,,,,0.00,0.00,0,0,0,0,0,0,0,0,0,0,0,0,0
20200212,050795,超眾富邦94購01,,,,,0.00,0.00,0,0,0,0,0,0,0,0,0,0,0,0,0
20200212,050796,燿華中信95購01,,,,,0.00,0.00,0,0,0,0,0,0,0,0,0,0,0,0,0
20200212,050797,聯發科中信99購01,0.57,0.62,0.57,0.62,+0.10,19.23,70000,11,42070,0,0,0,0,0,0,23000,46000,-23000,-23000
20200212,050798,TPK中信96購01,,,,,0.00,0.00,0,0,0,0,0,0,0,0,0,0,0,0,0
20200212,050799,嘉聯益中信98購01,0.22,0.22,0.22,0.22,0.00,0.00,10000,1,2200,0,0,0,0,0,0,0,10000,-10000,-10000
20200212,05079P,可成永豐95售01,1.13,1.16,1.08,1.08,-0.17,-13.6,213000,14,245040,0,0,0,0,0,0,3000,210000,-207000,-207000
20200212,050800,百和中信95購01,,,,,0.00,0.00,0,0,0,0,0,0,0,0,0,0,0,0,0
20200212,050801,元金2X群益98購01,1.81,1.81,1.81,1.81,-0.04,-2.16,6000,2,10860,0,0,0,0,0,0,0,6000,-6000,-6000
20200212,050802,康控群益95購01,,,,,0.00,0.00,0,0,0,0,0,0,0,0,0,0,0,0,0
20200212,050803,康控兆豐96購01,,,,,0.00,0.00,0,0,0,0,0,0,0,0,0,0,0,0,0
20200212,050804,和大日盛95購01,,,,,0.00,0.00,0,0,0,0,0,0,0,0,0,0,0,0,0
20200212,050805,光寶科日盛95購01,0.26,0.26,0.26,0.26,0.00,0.00,10000,1,2600,0,0,0,0,0,0,10000,0,10000,10000
20200212,050806,華新科日盛95購01,2.43,2.50,2.40,2.42,+0.09,3.86,219000,27,535700,0,0,0,0,0,0,196000,23000,173000,173000
20200212,050807,群臺反凱基95購01,0.36,0.36,0.36,0.36,0.00,0.00,30000,1,10800,0,0,0,0,0,0,0,30000,-30000,-30000
20200212,050808,台達電凱基96購02,1.37,1.40,1.37,1.40,0.00,0.00,21000,2,29070,0,0,0,0,0,0,0,21000,-21000,-21000
20200212,050809,鴻海凱基95購08,,,,,0.00,0.00,0,0,0,0,0,0,0,0,0,0,0,0,0
20200212,05080P,亞光永豐95售02,1.20,1.20,1.17,1.17,-0.15,-11.36,35000,2,41700,0,0,0,0,0,0,25000,10000,15000,15000
20200212,050810,鴻海凱基95購09,,,,,0.00,0.00,0,0,0,0,0,0,0,0,0,0,0,0,0
20200212,050811,國巨凱基95購02,7.00,7.05,6.90,7.05,0.00,0.00,101000,15,705500,0,0,0,0,0,0,35000,98000,-63000,-63000
20200212,050812,台積電凱基95購01,,,,,0.00,0.00,0,0,0,0,0,0,0,0,0,0,0,0,0
20200212,050813,旺宏凱基96購01,3.56,3.56,3.52,3.52,0.00,0.00,21000,3,74360,0,0,0,0,0,0,1000,21000,-20000,-20000
20200212,050814,微星凱基95購01,0.80,0.80,0.80,0.80,-0.06,-6.98,22000,2,17600,0,0,0,0,0,0,12000,10000,2000,2000
20200212,050815,南亞科凱基95購01,3.05,3.05,3.05,3.05,+0.07,2.35,30000,1,91500,0,0,0,0,0,0,30000,0,30000,30000
20200212,050816,京元電凱基95購01,,,,,0.00,0.00,0,0,0,0,0,0,0,0,0,0,0,0,0
20200212,050817,可成凱基95購01,0.77,0.77,0.77,0.77,0.00,0.00,4000,1,3080,0,0,0,0,0,0,0,4000,-4000,-4000
20200212,050818,華新科凱基95購02,4.06,4.16,4.06,4.16,+0.08,1.96,33000,5,135100,0,0,0,0,0,0,33000,33000,0,0
20200212,050819,宏達電凱基95購01,0.19,0.19,0.19,0.19,0.00,0.00,1000,1,190,0,0,0,0,0,0,0,0,0,0
20200212,05081P,京鼎永豐95售01,0.46,0.46,0.46,0.46,0.00,0.00,15000,1,6900,0,0,0,0,0,0,0,15000,-15000,-15000
20200212,050820,美食凱基95購01,,,,,0.00,0.00,0,0,0,0,0,0,0,0,0,0,0,0,0
20200212,050821,國泰金凱基95購01,,,,,0.00,0.00,0,0,0,0,0,0,0,0,0,0,0,0,0
20200212,050822,亞光凱基95購01,0.87,1.06,0.87,1.03,+0.20,24.1,201000,7,193180,0,0,0,0,0,0,50000,151000,-101000,-101000
20200212,050823,信邦凱基95購01,1.29,1.37,0.60,1.37,+0.01,0.74,294000,11,382440,0,0,0,0,0,0,176000,128000,48000,48000
20200212,050824,欣興凱基95購01,,,,,0.00,0.00,0,0,0,0,0,0,0,0,0,0,0,0,0
20200212,050825,嘉澤凱基95購01,2.21,2.21,2.21,2.21,0.00,0.00,11000,1,24310,0,0,0,0,0,0,11000,11000,0,0
20200212,050826,康普凱基95購01,,,,,0.00,0.00,0,0,0,0,0,0,0,0,0,0,0,0,0
20200212,050827,致伸凱基95購01,,,,,0.00,0.00,0,0,0,0,0,0,0,0,0,0,0,0,0
20200212,050828,康控凱基95購01,0.21,0.21,0.21,0.21,0.00,0.00,50000,2,10500,0,0,0,0,0,0,0,50000,-50000,-50000
20200212,050829,臻鼎凱基96購01,0.59,0.59,0.59,0.59,+0.18,43.9,103000,2,60770,0,0,0,0,0,0,103000,0,103000,103000
20200212,05082P,健策永豐95售02,,,,,0.00,0.00,0,0,0,0,0,0,0,0,0,0,0,0,0
20200212,050830,嘉聯益凱基95購01,,,,,0.00,0.00,0,0,0,0,0,0,0,0,0,0,0,0,0
20200212,050831,超眾凱基95購01,1.27,1.37,1.27,1.37,+0.11,8.73,31000,9,40450,0,0,0,0,0,0,21000,10000,11000,11000
20200212,050832,力成凱基95購01,2.30,2.51,2.30,2.51,0.00,0.00,66000,22,159360,0,0,0,0,0,0,0,66000,-66000,-66000
20200212,050833,台郡凱基95購01,1.70,1.70,1.70,1.70,+0.73,75.26,20000,1,34000,0,0,0,0,0,0,20000,0,20000,20000
20200212,050834,啟碁凱基95購01,,,,,0.00,0.00,0,0,0,0,0,0,0,0,0,0,0,0,0
20200212,050835,GIS凱基96購01,0.32,0.32,0.32,0.32,0.00,0.00,1000,1,320,0,0,0,0,0,0,0,1000,-1000,-1000
20200212,050836,緯穎凱基95購01,2.53,2.72,2.43,2.72,+0.14,5.43,140000,7,358180,0,0,0,0,0,0,98000,42000,56000,56000
20200212,050837,力山國票95購01,,,,,0.00,0.00,0,0,0,0,0,0,0,0,0,0,0,0,0
20200212,050838,為升國票96購01,,,,,0.00,0.00,0,0,0,0,0,0,0,0,0,0,0,0,0
20200212,050839,楠梓電國票96購01,0.47,0.47,0.47,0.47,0.00,0.00,90000,2,42300,0,0,0,0,0,0,0,90000,-90000,-90000
20200212,05083P,麗豐永豐95售02,1.06,1.06,1.03,1.03,-0.06,-5.5,64000,6,66620,0,0,0,0,0,0,10000,54000,-44000,-44000
20200212,050840,中環國票96購01,,,,,0.00,0.00,0,0,0,0,0,0,0,0,0,0,0,0,0
20200212,050841,國巨國票96購02,6.80,6.80,6.50,6.70,+0.25,3.88,74000,3,494700,0,0,0,0,0,0,74000,0,74000,74000
20200212,050842,旺宏國票97購01,6.85,6.85,6.80,6.80,+0.15,2.26,8000,2,54550,0,0,0,0,0,0,3000,5000,-2000,-2000
20200212,050843,富邦金國票96購01,1.66,1.72,1.63,1.72,+0.15,9.55,90000,8,151000,0,0,0,0,0,0,20000,70000,-50000,-50000
20200212,050844,大立光國票96購01,2.25,2.25,2.25,2.25,0.00,0.00,10000,1,22500,0,0,0,0,0,0,0,10000,-10000,-10000
20200212,050845,奇鋐國票95購02,,,,,0.00,0.00,0,0,0,0,0,0,0,0,0,0,0,0,0
20200212,050846,緯創國票96購01,1.09,1.09,1.09,1.09,+0.04,3.81,20000,2,21800,0,0,0,0,0,0,10000,10000,0,0
20200212,050847,創意國票96購01,0.94,0.94,0.83,0.83,-0.19,-18.63,62000,10,56100,0,0,0,0,0,0,62000,0,62000,62000
20200212,050848,日月光國票95購01,0.83,0.99,0.81,0.99,+0.22,28.57,780000,27,678380,0,0,0,0,0,0,439000,359000,80000,80000
20200212,050849,智伸科國票95購01,1.09,1.11,1.02,1.02,-0.10,-8.93,98000,4,106830,0,0,0,0,0,0,71000,27000,44000,44000
20200212,05084P,嘉聯益永豐95售02,1.65,1.65,1.63,1.63,-0.08,-4.68,109000,4,177770,0,0,0,0,0,0,5000,104000,-99000,-99000
20200212,050850,訊連國票96購01,3.49,3.49,3.19,3.19,-0.12,-3.63,76000,4,251940,0,0,0,0,0,0,0,56000,-56000,-56000
20200212,050851,羅麗芬國票96購01,,,,,0.00,0.00,0,0,0,0,0,0,0,0,0,0,0,0,0
20200212,050852,矽創國票95購02,0.44,0.49,0.44,0.49,+0.05,11.36,216000,10,100660,0,0,0,0,0,0,60000,156000,-96000,-96000
20200212,050853,南電國票96購01,0.26,0.26,0.26,0.26,+0.09,52.94,1000,1,260,0,0,0,0,0,0,1000,0,1000,1000
20200212,050854,世紀鋼國票97購01,0.76,0.76,0.73,0.73,-0.07,-8.75,66000,4,49720,0,0,0,0,0,0,66000,0,66000,66000
20200212,050855,華通台新95購01,0.82,1.17,0.82,1.17,+0.42,56.0,119000,4,98280,0,0,0,0,0,0,0,119000,-119000,-119000
20200212,050856,智邦台新95購01,0.81,0.81,0.81,0.81,-0.02,-2.41,76000,1,61560,0,0,0,0,0,0,76000,0,76000,76000
20200212,050857,義隆台新95購01,0.73,0.73,0.73,0.73,0.00,0.00,5000,1,3650,0,0,0,0,0,0,5000,0,5000,5000
20200212,050858,欣興台新95購01,,,,,0.00,0.00,0,0,0,0,0,0,0,0,0,0,0,0,0
20200212,050859,訊芯康和95購01,,,,,0.00,0.00,0,0,0,0,0,0,0,0,0,0,0,0,0
20200212,05085P,鴻海日盛95售01,0.66,0.67,0.66,0.67,-0.13,-16.25,16000,2,10630,0,0,0,0,0,0,0,16000,-16000,-16000
20200212,050860,喬山永豐95購01,,,,,0.00,0.00,0,0,0,0,0,0,0,0,0,0,0,0,0
20200212,050861,鴻海永豐95購01,0.31,0.35,0.31,0.35,0.00,0.00,188000,3,60080,0,0,0,0,0,0,100000,88000,12000,12000
20200212,050862,燿華永豐95購04,,,,,0.00,0.00,0,0,0,0,0,0,0,0,0,0,0,0,0
20200212,050863,聯發科永豐95購01,,,,,0.00,0.00,0,0,0,0,0,0,0,0,0,0,0,0,0
20200212,050864,亞光永豐95購01,,,,,0.00,0.00,0,0,0,0,0,0,0,0,0,0,0,0,0
20200212,050865,欣興永豐95購01,0.47,0.52,0.47,0.52,+0.15,40.54,60000,4,30980,0,0,0,0,0,0,0,60000,-60000,-60000
20200212,050866,景碩永豐95購01,0.52,0.70,0.50,0.67,+0.13,24.07,493000,35,304020,0,0,0,0,0,0,220000,253000,-33000,-33000
20200212,050867,聯鈞永豐95購01,0.92,1.13,0.92,1.13,+0.29,34.52,221000,23,228940,0,0,0,0,0,0,126000,95000,31000,31000
20200212,050868,智易永豐95購01,,,,,0.00,0.00,0,0,0,0,0,0,0,0,0,0,0,0,0
20200212,050869,健策永豐95購01,1.59,1.68,1.48,1.68,+0.20,13.51,692000,55,1092610,0,0,0,0,0,0,461000,281000,180000,180000
20200212,05086P,鴻海凱基95售13,0.66,0.93,0.59,0.93,+0.20,27.4,113000,6,69290,0,0,0,0,0,0,52000,110000,-58000,-58000
20200212,050870,旭富永豐95購01,0.34,0.43,0.33,0.33,+0.03,10.0,514000,16,184870,0,0,0,0,0,0,149000,365000,-216000,-216000
20200212,050871,麗豐永豐95購01,0.11,0.11,0.11,0.11,0.00,0.00,110000,1,12100,0,0,0,0,0,0,110000,0,110000,110000
20200212,050872,致伸永豐95購01,,,,,0.00,0.00,0,0,0,0,0,0,0,0,0,0,0,0,0
20200212,050873,新唐永豐95購01,,,,,0.00,0.00,0,0,0,0,0,0,0,0,0,0,0,0,0
20200212,050874,康控永豐95購01,0.05,0.09,0.05,0.09,+0.05,125.0,311000,5,18610,0,0,0,0,0,0,0,311000,-311000,-311000
20200212,050875,訊芯永豐95購01,0.10,0.10,0.09,0.10,+0.02,25.0,79000,6,7860,0,0,0,0,0,0,0,79000,-79000,-79000
20200212,050876,復盛永豐95購01,0.80,0.80,0.78,0.79,-0.01,-1.25,163000,25,128670,0,0,0,0,0,0,127000,36000,91000,91000
20200212,050877,美律統一95購01,0.32,0.40,0.32,0.40,+0.10,33.33,438000,57,162650,0,0,0,0,0,0,55000,382000,-327000,-327000
20200212,050878,嘉聯益統一95購01,0.27,0.27,0.27,0.27,0.00,0.00,36000,3,9720,0,0,0,0,0,0,0,36000,-36000,-36000
20200212,050879,樺漢統一95購02,1.21,1.30,1.18,1.30,+0.08,6.56,212000,9,268730,0,0,0,0,0,0,187000,0,187000,187000
20200212,05087P,GIS國泰96售01,1.99,2.00,1.94,1.94,-0.14,-6.73,36000,18,70570,0,0,0,0,0,0,24000,12000,12000,12000
20200212,050880,大立光元富95購03,3.47,3.91,3.47,3.89,+0.44,12.75,224000,15,824090,0,0,0,0,0,0,65000,170000,-105000,-105000
20200212,050881,大立光元富95購04,4.51,4.51,4.51,4.51,+0.62,15.94,5000,1,22550,0,0,0,0,0,0,5000,0,5000,5000
20200212,050882,華泰國泰96購01,0.50,0.50,0.48,0.48,+0.02,4.35,20000,3,9800,0,0,0,0,0,0,0,20000,-20000,-20000
20200212,050883,嘉聯益國泰96購01,0.66,0.72,0.64,0.68,+0.05,7.94,1025000,20,715890,0,0,0,0,0,0,29000,996000,-967000,-967000
20200212,050884,聯茂國泰96購01,0.58,0.85,0.58,0.73,0.00,0.00,3195000,31,2249610,0,0,0,0,0,0,3000000,195000,2805000,2805000
20200212,050885,T50反1富邦95購01,0.32,0.32,0.32,0.32,0.00,0.00,10000,1,3200,0,0,0,0,0,0,0,10000,-10000,-10000
20200212,050886,台積電富邦95購04,,,,,0.00,0.00,0,0,0,0,0,0,0,0,0,0,0,0,0
20200212,050887,台積電富邦95購05,1.73,1.84,1.73,1.84,+0.23,14.29,40000,6,71140,0,0,0,0,0,0,30000,0,30000,30000
20200212,050888,群創富邦95購01,,,,,0.00,0.00,0,0,0,0,0,0,0,0,0,0,0,0,0
20200212,050889,健策富邦95購01,,,,,0.00,0.00,0,0,0,0,0,0,0,0,0,0,0,0,0
20200212,05088P,大立光富邦99售01,,,,,0.00,0.00,0,0,0,0,0,0,0,0,0,0,0,0,0
20200212,050890,南電富邦99購01,,,,,0.00,0.00,0,0,0,0,0,0,0,0,0,0,0,0,0
20200212,050891,喬山元大95購01,0.96,1.00,0.96,1.00,0.00,0.00,86000,5,83160,0,0,0,0,0,0,0,86000,-86000,-86000
20200212,050892,聯電元大96購02,2.20,2.37,2.20,2.37,+0.06,2.6,38000,5,84640,0,0,0,0,0,0,25000,38000,-13000,-13000
20200212,050893,鴻海元大96購03,1.32,1.58,1.32,1.58,+0.30,23.44,225000,12,334700,0,0,0,0,0,0,142000,203000,-61000,-61000
20200212,050894,旺宏元大96購03,,,,,0.00,0.00,0,0,0,0,0,0,0,0,0,0,0,0,0
20200212,050895,聯發科元大97購01,1.00,1.08,0.99,1.07,+0.16,17.58,643000,22,671440,0,0,0,0,0,0,308000,332000,-24000,-24000
20200212,050896,華新科元大96購02,7.00,7.00,6.80,6.85,+0.10,1.48,54000,11,373050,0,0,0,0,0,0,54000,14000,40000,40000
20200212,050897,嘉晶元大95購03,0.55,0.59,0.55,0.59,0.00,0.00,870000,3,496220,0,0,0,0,0,0,0,870000,-870000,-870000
20200212,050898,智原元大96購01,0.22,0.23,0.22,0.23,0.00,0.00,200000,2,45000,0,0,0,0,0,0,0,200000,-200000,-200000
20200212,050899,旭富元大95購01,1.08,1.36,1.02,1.06,+0.07,7.07,919000,82,1069500,3000,0,3000,0,0,0,515000,308000,207000,210000
20200212,05089P,亞德客元大95售01,1.12,1.12,1.06,1.08,-0.05,-4.42,433000,11,477520,0,0,0,0,0,0,410000,413000,-3000,-3000
20200212,050900,台郡元大95購02,1.62,1.67,1.55,1.67,+0.72,75.79,101000,5,158790,0,0,0,0,0,0,27000,70000,-43000,-43000
20200212,050901,樺漢元大95購02,,,,,0.00,0.00,0,0,0,0,0,0,0,0,0,0,0,0,0
20200212,050902,南電元大96購01,0.57,0.72,0.56,0.70,+0.17,32.08,375000,19,228640,0,0,0,0,0,0,355000,25000,330000,330000
20200212,050903,臺股指元大95購10,,,,,0.00,0.00,0,0,0,0,0,0,0,0,0,0,0,0,0
20200212,050904,臺股指元大95購11,,,,,0.00,0.00,0,0,0,0,0,0,0,0,0,0,0,0,0
20200212,050905,臺股指元大95購12,,,,,0.00,0.00,0,0,0,0,0,0,0,0,0,0,0,0,0
20200212,050906,臺股指元大95購13,,,,,0.00,0.00,0,0,0,0,0,0,0,0,0,0,0,0,0
20200212,050907,臺股指元大95購14,2.09,2.09,2.09,2.09,+0.07,3.47,16000,1,33440,0,0,0,0,0,0,16000,0,16000,16000
20200212,050908,TPK亞東95購01,,,,,0.00,0.00,0,0,0,0,0,0,0,0,0,0,0,0,0
20200212,050909,華夏中信95購01,0.11,0.11,0.11,0.11,0.00,0.00,2000,1,220,0,0,0,0,0,0,2000,0,2000,2000
20200212,05090P,國巨元大95售05,0.16,0.17,0.15,0.15,-0.03,-16.67,386000,13,61480,0,0,0,0,0,0,132000,244000,-112000,-112000
20200212,050910,楠梓電中信95購01,,,,,0.00,0.00,0,0,0,0,0,0,0,0,0,0,0,0,0
20200212,050911,光磊中信98購01,0.31,0.31,0.30,0.30,-0.01,-3.23,56000,2,16810,0,0,0,0,0,0,56000,0,56000,56000
20200212,050912,正崴中信95購02,,,,,0.00,0.00,0,0,0,0,0,0,0,0,0,0,0,0,0
20200212,050913,全新中信97購01,0.20,0.26,0.20,0.25,+0.06,31.58,1137000,18,285480,0,0,0,0,0,0,1034000,103000,931000,931000
20200212,050914,健鼎中信95購01,0.33,0.50,0.33,0.50,+0.25,100.0,1292000,86,582810,0,0,0,0,0,0,375000,442000,-67000,-67000
20200212,050915,健策中信98購01,1.52,1.56,1.47,1.55,+0.08,5.44,200000,25,306590,0,0,0,0,0,0,180000,20000,160000,160000
20200212,050916,聯茂中信95購01,,,,,0.00,0.00,0,0,0,0,0,0,0,0,0,0,0,0,0
20200212,050917,瀚宇博兆豐96購01,0.26,0.27,0.26,0.27,+0.03,12.5,101000,3,26790,0,0,0,0,0,0,53000,48000,5000,5000
20200212,050918,南亞科日盛95購01,1.60,1.60,1.57,1.60,0.00,0.00,148000,16,235440,0,0,0,0,0,0,43000,108000,-65000,-65000
20200212,050919,台積電凱基95購03,2.48,2.48,2.48,2.48,+0.07,2.9,16000,2,39680,0,0,0,0,0,0,16000,0,16000,16000
20200212,05091P,台積電元大95售11,0.82,0.83,0.78,0.79,-0.11,-12.22,2213000,35,1807100,0,0,0,0,0,0,845000,1845000,-1000000,-1000000
20200212,050920,旺宏凱基95購01,,,,,0.00,0.00,0,0,0,0,0,0,0,0,0,0,0,0,0
20200212,050921,旺宏凱基95購02,3.78,3.88,3.66,3.66,-0.08,-2.14,17000,10,63920,0,0,0,0,0,0,7000,17000,-10000,-10000
20200212,050922,南亞科凱基95購02,3.42,3.42,3.42,3.42,+0.08,2.4,27000,1,92340,0,0,0,0,0,0,27000,0,27000,27000
20200212,050923,南亞科凱基95購03,2.09,2.09,2.09,2.09,-0.19,-8.33,50000,1,104500,0,0,0,0,0,0,0,50000,-50000,-50000
20200212,050924,京元電凱基95購02,,,,,0.00,0.00,0,0,0,0,0,0,0,0,0,0,0,0,0
20200212,050925,可成凱基95購02,,,,,0.00,0.00,0,0,0,0,0,0,0,0,0,0,0,0,0
20200212,050926,禾伸堂凱基95購01,0.87,1.00,0.82,1.00,+0.09,9.89,38000,11,32490,0,0,0,0,0,0,27000,19000,8000,8000
20200212,050927,聯詠凱基95購01,1.62,1.77,1.62,1.74,+0.28,19.18,118000,23,193980,0,0,0,0,0,0,29000,89000,-60000,-60000
20200212,050928,日月光凱基95購01,0.79,0.87,0.79,0.85,+0.14,19.72,52000,6,43220,0,0,0,0,0,0,10000,22000,-12000,-12000
20200212,050929,中磊凱基95購01,0.71,0.71,0.71,0.71,0.00,0.00,1000,1,710,0,0,0,0,0,0,0,1000,-1000,-1000
20200212,05092P,全新元大95售03,2.23,2.23,1.92,1.92,0.00,0.00,22000,5,47060,0,0,0,0,0,0,18000,18000,0,0
20200212,050930,矽格凱基95購01,0.33,0.33,0.33,0.33,0.00,0.00,15000,1,4950,0,0,0,0,0,0,15000,0,15000,15000
20200212,050931,上証2X國票95購03,,,,,0.00,0.00,0,0,0,0,0,0,0,0,0,0,0,0,0
20200212,050932,台塑國票96購01,1.39,1.40,1.39,1.40,-0.02,-1.41,79000,2,110190,0,0,0,0,0,0,79000,0,79000,79000
20200212,050933,南亞國票95購01,0.86,0.89,0.86,0.89,-0.02,-2.2,30000,2,25950,0,0,0,0,0,0,30000,0,30000,30000
20200212,050934,喬山國票96購01,0.86,0.92,0.86,0.92,+0.09,10.84,99000,2,87480,0,0,0,0,0,0,0,99000,-99000,-99000
20200212,050935,劍麟國票96購01,,,,,0.00,0.00,0,0,0,0,0,0,0,0,0,0,0,0,0
20200212,050936,國巨國票95購04,5.40,5.65,5.10,5.65,+0.72,14.6,47000,9,249500,0,0,0,0,0,0,44000,6000,38000,38000
20200212,050937,可成國票96購02,0.62,0.62,0.62,0.62,0.00,0.00,60000,1,37200,0,0,0,0,0,0,0,60000,-60000,-60000
20200212,050938,智原國票96購01,,,,,0.00,0.00,0,0,0,0,0,0,0,0,0,0,0,0,0
20200212,050939,健鼎國票96購01,0.89,1.26,0.89,1.26,+0.54,75.0,322000,23,325510,0,0,0,0,0,0,188000,129000,59000,59000
20200212,05093P,可成元大95售03,3.77,3.77,3.74,3.74,-0.34,-8.33,2000,2,7510,0,0,0,0,0,0,1000,2000,-1000,-1000
20200212,050940,嘉澤國票95購01,2.45,2.45,2.45,2.45,0.00,0.00,6000,1,14700,0,0,0,0,0,0,0,6000,-6000,-6000
20200212,050941,T50反1群益95購01,0.17,0.17,0.15,0.15,-0.03,-16.67,1309000,8,205350,0,0,0,0,0,0,509000,800000,-291000,-291000
20200212,050942,S&P正2群益95購01,2.35,2.35,2.35,2.35,0.00,0.00,20000,2,47000,0,0,0,0,0,0,0,20000,-20000,-20000
20200212,050943,楠梓電群益96購01,0.38,0.41,0.38,0.41,0.00,0.00,55000,5,21670,0,0,0,0,0,0,0,55000,-55000,-55000
20200212,050944,智邦群益95購01,0.58,0.58,0.47,0.51,+0.02,4.08,319000,6,164420,0,0,0,0,0,0,69000,250000,-181000,-181000
20200212,050945,致茂群益95購01,1.11,1.37,1.11,1.37,+0.36,35.64,400000,39,501370,0,0,0,0,0,0,132000,268000,-136000,-136000
20200212,050946,瑞昱群益95購01,2.05,2.30,2.05,2.09,+0.17,8.85,106000,10,222020,0,0,0,0,0,0,81000,38000,43000,43000
20200212,050947,聯發科群益95購01,0.48,0.48,0.42,0.45,+0.14,45.16,71000,3,30330,0,0,0,0,0,0,70000,1000,69000,69000
20200212,050948,華固群益95購01,2.57,2.57,2.57,2.57,+0.11,4.47,2000,1,5140,0,0,0,0,0,0,0,2000,-2000,-2000
20200212,050949,亞光群益96購01,1.03,1.23,1.03,1.21,+0.24,24.74,448000,23,517680,0,0,0,0,0,0,20000,428000,-408000,-408000
20200212,05094P,大立光元大95售07,1.06,1.06,1.06,1.06,-0.14,-11.67,10000,1,10600,0,0,0,0,0,0,0,10000,-10000,-10000
20200212,050950,健鼎群益96購01,0.78,1.10,0.77,1.10,+0.46,71.87,505000,59,500530,0,0,0,0,0,0,13000,491000,-478000,-478000
20200212,050951,緯創群益96購01,0.84,0.84,0.81,0.81,+0.03,3.85,34000,3,27630,0,0,0,0,0,0,11000,23000,-12000,-12000
20200212,050952,健策群益96購01,4.99,5.10,4.78,5.05,+0.55,12.22,20000,8,100610,0,0,0,0,0,0,17000,9000,8000,8000
20200212,050953,臻鼎群益95購01,0.54,0.54,0.54,0.54,0.00,0.00,1000,1,540,0,0,0,0,0,0,1000,0,1000,1000
20200212,050954,樺漢群益95購01,0.77,0.82,0.77,0.82,+0.04,5.13,11000,2,8520,0,0,0,0,0,0,0,11000,-11000,-11000
20200212,050955,達方群益97購01,2.11,2.17,2.11,2.17,+0.14,6.9,2000,2,4280,0,0,0,0,0,0,1000,1000,0,0
20200212,050956,鈺齊群益95購01,1.46,1.67,1.46,1.67,+0.21,14.38,547000,18,869930,0,0,0,0,0,0,280000,297000,-17000,-17000
20200212,050957,T50反1台新05購01,0.48,0.48,0.46,0.46,-0.04,-8.0,200000,3,93000,0,0,0,0,0,0,0,200000,-200000,-200000
20200212,050958,日月光台新95購01,,,,,0.00,0.00,0,0,0,0,0,0,0,0,0,0,0,0,0
20200212,050959,元金2X永豐95購02,1.89,1.89,1.89,1.89,-0.02,-1.05,27000,2,51030,0,0,0,0,0,0,0,27000,-27000,-27000
20200212,05095P,景碩元大95售01,0.62,0.64,0.53,0.55,-0.17,-23.61,61000,6,33920,0,0,0,0,0,0,0,61000,-61000,-61000
20200212,050960,台光電永豐95購01,0.29,0.36,0.29,0.33,+0.08,32.0,288000,8,94030,0,0,0,0,0,0,10000,278000,-268000,-268000
20200212,050961,美律永豐95購01,,,,,0.00,0.00,0,0,0,0,0,0,0,0,0,0,0,0,0
20200212,050962,聯發科永豐95購02,,,,,0.00,0.00,0,0,0,0,0,0,0,0,0,0,0,0,0
20200212,050963,強茂永豐95購01,0.13,0.14,0.13,0.14,0.00,0.00,100000,5,13500,0,0,0,0,0,0,100000,0,100000,100000
20200212,050964,晶技永豐95購02,1.76,1.76,1.76,1.76,+0.04,2.33,20000,2,35200,0,0,0,0,0,0,10000,10000,0,0
20200212,050965,揚明光永豐96購01,0.69,0.70,0.69,0.70,+0.07,11.11,133000,2,92100,0,0,0,0,0,0,0,133000,-133000,-133000
20200212,050966,日月光永豐95購01,,,,,0.00,0.00,0,0,0,0,0,0,0,0,0,0,0,0,0
20200212,050967,嘉聯益永豐95購01,,,,,0.00,0.00,0,0,0,0,0,0,0,0,0,0,0,0,0
20200212,050968,超眾永豐95購01,0.71,0.81,0.71,0.81,+0.04,5.19,572000,34,432240,0,0,0,0,0,0,397000,132000,265000,265000
20200212,050969,台郡永豐95購01,0.49,0.52,0.49,0.52,+0.18,52.94,254000,15,130200,0,0,0,0,0,0,86000,199000,-113000,-113000
20200212,05096P,台積電日盛95售01,0.07,0.07,0.07,0.07,0.00,0.00,314000,2,21980,0,0,0,0,0,0,0,314000,-314000,-314000
20200212,050970,康舒永豐95購01,0.45,0.47,0.45,0.47,+0.02,4.44,132000,5,60760,0,0,0,0,0,0,10000,122000,-112000,-112000
20200212,050971,緯穎永豐95購01,1.35,1.58,1.32,1.57,+0.12,8.28,603000,21,891320,0,0,0,0,0,0,221000,382000,-161000,-161000
20200212,050972,台虹永豐95購01,,,,,0.00,0.00,0,0,0,0,0,0,0,0,0,0,0,0,0
20200212,050973,S&P反1統一95購01,,,,,0.00,0.00,0,0,0,0,0,0,0,0,0,0,0,0,0
20200212,050974,大成鋼統一95購01,0.98,1.05,0.98,1.05,+0.04,3.96,357000,10,368550,0,0,0,0,0,0,222000,135000,87000,87000
20200212,050975,楠梓電統一95購01,0.31,0.39,0.31,0.35,+0.06,20.69,831000,23,289610,0,0,0,0,0,0,81000,744000,-663000,-663000
20200212,050976,台光電統一95購01,0.56,0.74,0.56,0.74,+0.21,39.62,1042000,46,655400,0,0,0,0,0,0,244000,860000,-616000,-616000
20200212,050977,聯發科統一95購02,,,,,0.00,0.00,0,0,0,0,0,0,0,0,0,0,0,0,0
20200212,050978,鴻海元富95購03,0.98,1.26,0.97,1.26,+0.35,38.46,422000,16,457480,0,0,0,0,0,0,262000,250000,12000,12000
20200212,050979,鴻海元富96購02,1.35,1.65,1.35,1.65,+0.35,26.92,120000,8,184300,0,0,0,0,0,0,30000,90000,-60000,-60000
20200212,05097P,聯發科日盛95售01,0.68,0.68,0.68,0.68,0.00,0.00,10000,1,6800,0,0,0,0,0,0,0,10000,-10000,-10000
20200212,050980,欣興元富95購02,0.43,0.53,0.43,0.53,+0.18,51.43,352000,11,165540,0,0,0,0,0,0,0,352000,-352000,-352000
20200212,050981,GIS元富95購01,0.25,0.26,0.25,0.26,0.00,0.00,20000,3,5100,0,0,0,0,0,0,0,20000,-20000,-20000
20200212,050982,台積電國泰96購04,10.80,11.10,10.80,11.10,+0.90,8.82,10000,2,109500,0,0,0,0,0,0,10000,0,10000,10000
20200212,050983,新光金國泰97購01,1.04,1.05,1.03,1.05,+0.03,2.94,369000,43,382210,0,0,0,0,0,0,333000,36000,297000,297000
20200212,050984,大立光國泰97購01,3.18,3.19,3.14,3.16,+0.23,7.85,35000,5,111530,0,0,0,0,0,0,35000,0,35000,35000
20200212,050985,易華電國泰96購02,,,,,0.00,0.00,0,0,0,0,0,0,0,0,0,0,0,0,0
20200212,050986,上証2X永昌97購01,,,,,0.00,0.00,0,0,0,0,0,0,0,0,0,0,0,0,0
20200212,050987,台泥富邦95購01,0.94,0.96,0.94,0.96,0.00,0.00,110000,3,103600,0,0,0,0,0,0,100000,10000,90000,90000
20200212,050988,廣達富邦95購01,1.24,1.35,1.24,1.32,+0.05,3.94,291000,13,383330,0,0,0,0,0,0,236000,57000,179000,179000
20200212,050989,台表科富邦95購01,0.32,0.32,0.32,0.32,0.00,0.00,10000,1,3200,0,0,0,0,0,0,10000,0,10000,10000
20200212,05098P,鴻海凱基95售15,1.13,1.13,1.05,1.05,-0.21,-16.67,440000,2,462400,0,0,0,0,0,0,440000,435000,5000,5000
20200212,050990,T50反1元大95購01,0.23,0.23,0.20,0.20,-0.03,-13.04,77000,9,16080,0,0,0,0,0,0,7000,70000,-63000,-63000
20200212,050991,元油2X元大96購04,0.60,0.64,0.60,0.63,+0.04,6.78,1029000,39,635290,0,0,0,0,0,0,602000,426000,176000,176000
20200212,050992,台積電元大97購01,2.16,2.22,2.16,2.22,+0.13,6.22,32000,6,70470,0,0,0,0,0,0,26000,0,26000,26000
20200212,050993,聯發科元大95購05,0.40,0.45,0.40,0.45,+0.11,32.35,15000,3,6500,0,0,0,0,0,0,10000,5000,5000,5000
20200212,050994,欣興元大96購03,0.44,0.47,0.44,0.47,0.00,0.00,683000,4,310990,0,0,0,0,0,0,100000,583000,-483000,-483000
20200212,050995,貿聯元大95購02,1.53,1.76,1.53,1.76,+0.25,16.56,93000,7,154570,0,0,0,0,0,0,11000,87000,-76000,-76000
20200212,050996,隆達元大95購01,1.04,1.06,1.04,1.06,+0.10,10.42,6000,2,6300,0,0,0,0,0,0,0,6000,-6000,-6000
20200212,050997,麗豐元大95購03,0.52,0.59,0.52,0.55,+0.08,17.02,358000,5,205890,0,0,0,0,0,0,1000,357000,-356000,-356000
20200212,050998,訊連元大95購01,1.58,1.70,1.52,1.61,+0.02,1.26,185000,12,303520,0,0,0,0,0,0,185000,50000,135000,135000
20200212,050999,瀚宇博元大95購04,,,,,0.00,0.00,0,0,0,0,0,0,0,0,0,0,0,0,0
20200212,05099P,台積電凱基95售06,0.62,0.62,0.58,0.58,-0.07,-10.77,45000,4,27300,0,0,0,0,0,0,0,45000,-45000,-45000
20200212,051000,台郡元大96購01,1.11,1.40,1.03,1.40,+0.70,100.0,1342000,44,1480740,0,0,0,0,0,0,982000,93000,889000,889000
20200212,051001,緯穎元大96購02,2.45,2.67,2.35,2.67,+0.17,6.8,360000,35,898390,0,0,0,0,0,0,326000,202000,124000,124000
20200212,051002,華邦電亞東96購01,,,,,0.00,0.00,0,0,0,0,0,0,0,0,0,0,0,0,0
20200212,051003,中環中信97購01,0.13,0.13,0.11,0.12,-0.02,-14.29,374000,12,43980,0,0,0,0,0,0,30000,274000,-244000,-244000
20200212,051004,台新金中信95購02,0.66,0.67,0.66,0.67,-0.02,-2.9,163000,2,108580,0,0,0,0,0,0,163000,0,163000,163000
20200212,051005,緯創中信95購02,0.70,0.72,0.70,0.72,+0.01,1.41,144000,5,102240,0,0,0,0,0,0,32000,112000,-80000,-80000
20200212,051006,中磊中信95購01,0.63,0.63,0.60,0.60,0.00,0.00,42000,2,26100,0,0,0,0,0,0,0,42000,-42000,-42000
20200212,051007,台光電麥證95購01,0.42,0.57,0.42,0.54,+0.12,28.57,319000,53,165920,133000,186000,-53000,0,0,0,133000,186000,-53000,-53000
20200212,051008,大立光麥證95購01,1.21,1.33,1.21,1.33,0.00,0.00,12000,2,14760,0,12000,-12000,0,0,0,2000,12000,-10000,-10000
20200212,051009,緯創麥證95購01,0.55,0.55,0.55,0.55,+0.01,1.85,10000,1,5500,0,10000,-10000,0,0,0,0,10000,-10000,-10000
20200212,05100P,智邦凱基95售02,,,,,0.00,0.00,0,0,0,0,0,0,0,0,0,0,0,0,0
20200212,051010,美律日盛95購01,0.17,0.24,0.17,0.24,+0.08,50.0,46000,8,10660,0,0,0,0,0,0,6000,40000,-34000,-34000
20200212,051011,國巨凱基95購03,,,,,0.00,0.00,0,0,0,0,0,0,0,0,0,0,0,0,0
20200212,051012,台積電凱基95購04,,,,,0.00,0.00,0,0,0,0,0,0,0,0,0,0,0,0,0
20200212,051013,旺宏凱基95購03,1.72,1.72,1.72,1.72,0.00,0.00,5000,1,8600,0,0,0,0,0,0,5000,0,5000,5000
20200212,051014,智邦凱基95購01,0.61,0.64,0.51,0.56,+0.03,5.66,73000,8,42440,0,0,0,0,0,0,53000,48000,5000,5000
20200212,051015,南亞科凱基95購04,4.25,4.25,4.25,4.25,0.00,0.00,10000,1,42500,0,0,0,0,0,0,10000,0,10000,10000
20200212,051016,京元電凱基95購03,0.18,0.19,0.18,0.18,-0.02,-10.0,120000,9,22160,0,0,0,0,0,0,120000,0,120000,120000
20200212,051017,聯發科凱基95購04,0.55,0.55,0.52,0.52,+0.13,33.33,91000,2,47350,0,0,0,0,0,0,90000,0,90000,90000
20200212,051018,可成凱基95購03,,,,,0.00,0.00,0,0,0,0,0,0,0,0,0,0,0,0,0
20200212,051019,大立光凱基95購08,,,,,0.00,0.00,0,0,0,0,0,0,0,0,0,0,0,0,0
20200212,05101P,大立光凱基95售11,,,,,0.00,0.00,0,0,0,0,0,0,0,0,0,0,0,0,0
20200212,051020,健策凱基96購02,3.53,3.75,3.39,3.75,+0.42,12.61,519000,41,1819340,0,0,0,0,0,0,498000,450000,48000,48000
20200212,051021,啟碁凱基95購02,0.68,0.68,0.67,0.67,+0.02,3.08,30000,3,20300,0,0,0,0,0,0,0,30000,-30000,-30000
20200212,051022,GIS凱基95購02,,,,,0.00,0.00,0,0,0,0,0,0,0,0,0,0,0,0,0
20200212,051023,S&P反1統一95購02,,,,,0.00,0.00,0,0,0,0,0,0,0,0,0,0,0,0,0
20200212,051024,南亞科統一95購01,4.81,4.81,4.81,4.81,+0.22,4.79,10000,1,48100,0,0,0,0,0,0,10000,0,10000,10000
20200212,051025,晶華統一95購01,0.72,0.77,0.72,0.77,0.00,0.00,340000,8,254320,0,0,0,0,0,0,0,340000,-340000,-340000
20200212,051026,健策統一96購01,,,,,0.00,0.00,0,0,0,0,0,0,0,0,0,0,0,0,0
20200212,051027,楠梓電元富95購01,0.36,0.43,0.35,0.43,+0.07,19.44,541000,29,225230,0,0,0,0,0,0,105000,436000,-331000,-331000
20200212,051028,台光電元富95購02,0.82,1.07,0.82,1.02,+0.23,29.11,1139000,75,1069270,0,0,0,0,0,0,316000,907000,-591000,-591000
20200212,051029,緯創元富95購01,0.73,0.73,0.73,0.73,0.00,0.00,10000,1,7300,0,0,0,0,0,0,0,10000,-10000,-10000
20200212,05102P,臺股指凱基96售09,,,,,0.00,0.00,0,0,0,0,0,0,0,0,0,0,0,0,0
20200212,051030,康友元富95購01,3.31,3.49,3.31,3.45,+0.13,3.92,72000,6,247510,0,0,0,0,0,0,72000,4000,68000,68000
20200212,051031,康友元富95購02,2.26,2.45,2.26,2.32,0.00,0.00,414000,37,986990,0,0,0,0,0,0,172000,304000,-132000,-132000
20200212,051032,南電元富95購01,0.31,0.34,0.31,0.34,+0.09,36.0,3000,2,960,0,0,0,0,0,0,2000,1000,1000,1000
20200212,051033,台積電兆豐95購03,1.60,1.60,1.17,1.25,+0.18,16.82,36000,10,48970,0,0,0,0,0,0,18000,0,18000,18000
20200212,051034,正崴兆豐95購01,,,,,0.00,0.00,0,0,0,0,0,0,0,0,0,0,0,0,0
20200212,051035,百和兆豐95購01,,,,,0.00,0.00,0,0,0,0,0,0,0,0,0,0,0,0,0
20200212,051036,喬山台新95購01,0.75,0.81,0.75,0.81,0.00,0.00,90000,4,69480,0,0,0,0,0,0,0,90000,-90000,-90000
20200212,051037,大立光台新95購01,,,,,0.00,0.00,0,0,0,0,0,0,0,0,0,0,0,0,0
20200212,051038,健策台新95購01,3.21,3.21,3.15,3.21,+0.21,7.0,24000,9,76890,0,0,0,0,0,0,24000,0,24000,24000
20200212,051039,台表科康和95購01,,,,,0.00,0.00,0,0,0,0,0,0,0,0,0,0,0,0,0
20200212,05103P,臺股指凱基96售10,0.72,0.76,0.63,0.76,0.00,0.00,973000,67,650850,0,0,0,0,0,0,78000,878000,-800000,-800000
20200212,051040,漢唐永豐95購01,0.79,0.84,0.79,0.80,0.00,0.00,417000,12,339770,0,0,0,0,0,0,207000,210000,-3000,-3000
20200212,051041,大立光永豐95購01,0.84,0.86,0.84,0.86,+0.12,16.22,88000,2,75280,0,0,0,0,0,0,20000,68000,-48000,-48000
20200212,051042,中磊永豐95購01,0.82,0.85,0.82,0.85,+0.02,2.41,32000,5,26570,0,0,0,0,0,0,28000,4000,24000,24000
20200212,051043,瀚宇博永豐95購01,0.13,0.13,0.13,0.13,0.00,0.00,1000,1,130,0,0,0,0,0,0,0,1000,-1000,-1000
20200212,051044,GIS永豐95購01,,,,,0.00,0.00,0,0,0,0,0,0,0,0,0,0,0,0,0
20200212,051045,南茂永豐95購01,0.40,0.42,0.40,0.42,0.00,0.00,65000,3,27100,0,0,0,0,0,0,10000,55000,-45000,-45000
20200212,051046,寶成永豐95購01,,,,,0.00,0.00,0,0,0,0,0,0,0,0,0,0,0,0,0
20200212,051047,深中小群益99購01,1.80,1.88,1.80,1.88,+0.07,3.87,520000,9,952410,0,0,0,0,0,0,440000,180000,260000,260000
20200212,051048,臺指反群益96購01,,,,,0.00,0.00,0,0,0,0,0,0,0,0,0,0,0,0,0
20200212,051049,亞德客群益95購01,2.13,2.13,2.13,2.13,-0.04,-1.84,3000,1,6390,0,0,0,0,0,0,3000,0,3000,3000
20200212,05104P,智邦台新95售02,0.88,0.97,0.88,0.97,-0.02,-2.02,95000,3,85940,0,0,0,0,0,0,36000,59000,-23000,-23000
20200212,051050,鴻海群益95購03,1.30,1.45,1.30,1.45,0.00,0.00,2000,2,2750,0,0,0,0,0,0,2000,0,2000,2000
20200212,051051,鴻海群益95購04,0.08,0.09,0.08,0.09,+0.02,28.57,11000,3,940,0,0,0,0,0,0,0,0,0,0
20200212,051052,台積電群益95購01,3.38,3.38,3.30,3.30,+0.18,5.77,30000,3,99800,0,0,0,0,0,0,0,20000,-20000,-20000
20200212,051053,台光電群益95購01,0.75,0.95,0.75,0.90,+0.22,32.35,141000,28,122640,0,0,0,0,0,0,32000,109000,-77000,-77000
20200212,051054,正崴群益95購01,,,,,0.00,0.00,0,0,0,0,0,0,0,0,0,0,0,0,0
20200212,051055,友達群益98購01,,,,,0.00,0.00,0,0,0,0,0,0,0,0,0,0,0,0,0
20200212,051056,華新科群益95購03,0.91,0.95,0.85,0.87,-0.03,-3.33,585000,30,515420,0,0,0,0,0,0,245000,0,245000,245000
20200212,051057,信邦群益95購01,2.86,2.96,2.86,2.91,-0.14,-4.59,22000,4,64070,0,0,0,0,0,0,12000,10000,2000,2000
20200212,051058,景碩群益96購01,1.85,2.38,1.85,2.30,+0.46,25.0,376000,55,788740,0,0,0,0,0,0,100000,321000,-221000,-221000
20200212,051059,康普群益95購01,0.42,0.43,0.40,0.43,+0.04,10.26,135000,6,56150,0,0,0,0,0,0,0,135000,-135000,-135000
20200212,05105P,大立光台新95售02,,,,,0.00,0.00,0,0,0,0,0,0,0,0,0,0,0,0,0
20200212,051060,鎧勝群益95購01,,,,,0.00,0.00,0,0,0,0,0,0,0,0,0,0,0,0,0
20200212,051061,中磊群益95購01,0.83,0.86,0.82,0.82,-0.02,-2.38,46000,6,38720,0,0,0,0,0,0,19000,46000,-27000,-27000
20200212,051062,超眾群益95購02,1.06,1.20,1.04,1.20,+0.13,12.15,250000,29,274830,0,0,0,0,0,0,152000,183000,-31000,-31000
20200212,051063,台郡群益95購01,1.02,1.17,0.94,1.17,+0.62,112.73,997000,62,980250,0,0,0,0,0,0,844000,32000,812000,812000
20200212,051064,鴻海國票95購01,,,,,0.00,0.00,0,0,0,0,0,0,0,0,0,0,0,0,0
20200212,051065,台積電國票96購01,4.65,4.74,4.65,4.74,+0.44,10.23,9000,4,42570,0,0,0,0,0,0,1000,8000,-7000,-7000
20200212,051066,台積電國票96購02,2.18,2.33,2.18,2.33,+0.30,14.78,15000,4,34150,0,0,0,0,0,0,10000,5000,5000,5000
20200212,051067,台積電國票96購03,,,,,0.00,0.00,0,0,0,0,0,0,0,0,0,0,0,0,0
20200212,051068,台積電國票97購01,1.25,1.25,1.10,1.18,+0.08,7.27,120000,18,140610,0,0,0,0,0,0,15000,35000,-20000,-20000
20200212,051069,智邦國票96購01,1.50,1.68,1.27,1.27,0.00,0.00,75000,11,112110,0,0,0,0,0,0,24000,53000,-29000,-29000
20200212,05106P,鴻海永豐95售02,1.50,1.50,1.50,1.50,-0.17,-10.18,5000,1,7500,0,0,0,0,0,0,0,5000,-5000,-5000
20200212,051070,正崴國票96購01,0.46,0.46,0.45,0.45,-0.03,-6.25,90000,9,41340,0,0,0,0,0,0,90000,0,90000,90000
20200212,051071,聯發科國票96購01,0.72,0.79,0.71,0.79,+0.25,46.3,34000,4,24480,0,0,0,0,0,0,2000,32000,-30000,-30000
20200212,051072,強茂國票95購02,0.58,0.58,0.56,0.56,+0.03,5.66,154000,5,88480,0,0,0,0,0,0,20000,134000,-114000,-114000
20200212,051073,同欣電國票96購01,1.89,2.22,1.85,2.18,+0.31,16.58,237000,34,482700,0,0,0,0,0,0,108000,129000,-21000,-21000
20200212,051074,矽力國票96購01,5.10,5.10,5.10,5.10,+0.93,22.3,1000,1,5100,0,0,0,0,0,0,0,1000,-1000,-1000
20200212,051075,智邦國泰97購01,1.73,1.77,1.52,1.54,-0.01,-0.65,130000,9,217900,0,0,0,0,0,0,38000,92000,-54000,-54000
20200212,051076,緯創國泰96購01,1.36,1.36,1.36,1.36,0.00,0.00,10000,1,13600,0,0,0,0,0,0,0,10000,-10000,-10000
20200212,051077,台郡國泰96購02,2.10,2.13,1.93,2.13,+0.83,63.85,236000,47,482530,0,0,0,0,0,0,102000,163000,-61000,-61000
20200212,051078,力山富邦97購01,,,,,0.00,0.00,0,0,0,0,0,0,0,0,0,0,0,0,0
20200212,051079,鴻海富邦96購02,0.75,0.75,0.75,0.75,+0.16,27.12,6000,1,4500,0,0,0,0,0,0,6000,0,6000,6000
20200212,05107P,鴻海兆豐96售02,,,,,0.00,0.00,0,0,0,0,0,0,0,0,0,0,0,0,0
20200212,051080,全新富邦96購01,0.18,0.18,0.18,0.18,0.00,0.00,2000,1,360,0,0,0,0,0,0,0,2000,-2000,-2000
20200212,051081,聯茂富邦96購01,0.21,0.24,0.21,0.23,0.00,0.00,189000,8,43360,0,0,0,0,0,0,0,189000,-189000,-189000
20200212,051082,上証2X元大98購01,,,,,0.00,0.00,0,0,0,0,0,0,0,0,0,0,0,0,0
20200212,051083,A50正2元大98購01,0.91,0.93,0.90,0.93,-0.01,-1.06,116000,8,106710,0,0,0,0,0,0,20000,96000,-76000,-76000
20200212,051084,華通元大95購06,0.60,0.78,0.60,0.76,+0.29,61.7,602000,11,412380,0,0,0,0,0,0,200000,462000,-262000,-262000
20200212,051085,鴻海元大95購03,0.80,1.15,0.76,1.15,+0.40,53.33,922000,60,860660,0,0,0,0,0,0,781000,796000,-15000,-15000
20200212,051086,鴻海元大96購04,0.84,1.08,0.83,1.08,+0.26,31.71,653000,38,604550,0,0,0,0,0,0,649000,482000,167000,167000
20200212,051087,國巨元大97購01,4.70,4.73,4.58,4.73,+0.19,4.19,15000,4,70330,0,0,0,0,0,0,15000,0,15000,15000
20200212,051088,台積電元大95購09,4.65,4.89,4.57,4.89,+0.48,10.88,51000,8,240720,0,0,0,0,0,0,51000,29000,22000,22000
20200212,051089,旺宏元大96購04,2.27,2.32,2.19,2.20,-0.04,-1.79,61000,11,136790,0,0,0,0,0,0,61000,9000,52000,52000
20200212,05108P,欣興中信95售02,0.78,0.78,0.65,0.65,-0.14,-17.72,111000,5,80030,0,0,0,0,0,0,76000,35000,41000,41000
20200212,051090,光磊元大96購01,0.45,0.45,0.45,0.45,-0.03,-6.25,10000,1,4500,0,0,0,0,0,0,10000,0,10000,10000
20200212,051091,聯發科元大95購07,0.27,0.27,0.27,0.27,0.00,0.00,80000,1,21600,0,0,0,0,0,0,80000,0,80000,80000
20200212,051092,禾伸堂元大95購02,1.80,1.80,1.74,1.80,+0.05,2.86,173000,14,306270,0,0,0,0,0,0,152000,21000,131000,131000
20200212,051093,聯詠元大95購01,1.89,2.13,1.89,1.92,+0.08,4.35,39000,7,77400,0,0,0,0,0,0,39000,0,39000,39000
20200212,051094,健策元大96購03,6.65,7.00,6.40,6.95,+0.80,13.01,302000,38,2020300,0,0,0,0,0,0,154000,251000,-97000,-97000
20200212,051095,貿聯元大95購03,0.99,1.08,0.99,1.08,+0.11,11.34,24000,3,24900,0,0,0,0,0,0,10000,24000,-14000,-14000
20200212,051096,日月光元大95購01,0.84,0.98,0.84,0.96,+0.14,17.07,290000,8,263100,0,0,0,0,0,0,0,290000,-290000,-290000
20200212,051097,嘉聯益元大96購02,0.49,0.52,0.49,0.50,+0.04,8.7,176000,7,87270,0,0,0,0,0,0,30000,146000,-116000,-116000
20200212,051098,矽格元大95購01,0.97,1.07,0.97,1.06,0.00,0.00,152000,7,154340,0,0,0,0,0,0,0,152000,-152000,-152000
20200212,051099,台郡元大95購03,0.91,0.95,0.84,0.95,+0.45,90.0,314000,19,277890,0,0,0,0,0,0,211000,50000,161000,161000
20200212,05109P,臺股指麥證95售01,,,,,0.00,0.00,0,0,0,0,0,0,0,0,0,0,0,0,0
20200212,051100,同欣電元大95購01,2.46,2.71,2.46,2.71,+0.27,11.07,24000,4,59600,0,0,0,0,0,0,22000,2000,20000,20000
20200212,051101,台表科元大96購02,0.70,0.70,0.70,0.70,+0.02,2.94,102000,2,71400,0,0,0,0,0,0,2000,102000,-100000,-100000
20200212,051102,訊芯元大96購01,0.63,0.78,0.63,0.75,+0.14,22.95,371000,7,265630,0,0,0,0,0,0,1000,370000,-369000,-369000
20200212,051103,緯穎元大96購03,2.36,2.49,2.36,2.49,+0.08,3.32,37000,4,88960,0,0,0,0,0,0,37000,0,37000,37000
20200212,051104,鈺齊元大96購01,1.32,1.47,1.32,1.47,+0.14,10.53,153000,13,221690,0,0,0,0,0,0,76000,152000,-76000,-76000
20200212,051105,台光電國票96購01,0.55,0.55,0.55,0.55,0.00,0.00,60000,1,33000,0,0,0,0,0,0,0,60000,-60000,-60000
20200212,051106,華通統一95購02,0.54,0.62,0.54,0.58,+0.26,81.25,54000,6,31330,0,0,0,0,0,0,45000,9000,36000,36000
20200212,051107,鴻海統一95購05,0.11,0.11,0.09,0.11,0.00,0.00,3040000,42,298660,0,0,0,0,0,0,0,0,0,0
20200212,051108,鴻海統一96購02,0.64,0.69,0.64,0.69,+0.10,16.95,96000,5,62940,0,0,0,0,0,0,48000,48000,0,0
20200212,051109,美律統一95購02,0.44,0.57,0.44,0.56,+0.16,40.0,739000,60,365590,0,0,0,0,0,0,135000,599000,-464000,-464000
20200212,05110P,上銀統一95售01,1.24,1.24,1.23,1.23,0.00,0.00,11000,2,13580,0,0,0,0,0,0,0,11000,-11000,-11000
20200212,051110,可成統一95購01,,,,,0.00,0.00,0,0,0,0,0,0,0,0,0,0,0,0,0
20200212,051111,可成統一95購02,,,,,0.00,0.00,0,0,0,0,0,0,0,0,0,0,0,0,0
20200212,051112,台郡統一95購01,1.73,1.83,1.59,1.75,+0.89,103.49,391000,33,647670,0,0,0,0,0,0,310000,36000,274000,274000
20200212,051113,聯電元富95購01,1.47,1.60,1.44,1.60,+0.09,5.96,1985000,53,2926120,0,0,0,0,0,0,1953000,28000,1925000,1925000
20200212,051114,鈺齊中信95購01,0.75,0.84,0.74,0.84,+0.07,9.09,486000,10,375250,0,0,0,0,0,0,236000,250000,-14000,-14000
20200212,051115,華通麥證96購01,0.82,1.06,0.80,1.02,+0.29,39.73,220000,21,193350,172000,48000,124000,0,0,0,172000,48000,124000,124000
20200212,051116,可成麥證95購01,,,,,0.00,0.00,0,0,0,0,0,0,0,0,0,0,0,0,0
20200212,051117,臺指反群益95購02,,,,,0.00,0.00,0,0,0,0,0,0,0,0,0,0,0,0,0
20200212,051118,台塑群益95購01,0.49,0.51,0.49,0.51,+0.02,4.08,48000,5,24150,0,0,0,0,0,0,11000,37000,-26000,-26000
20200212,051119,光寶科群益95購01,1.37,1.41,1.37,1.38,-0.02,-1.43,156000,10,215810,0,0,0,0,0,0,0,156000,-156000,-156000
20200212,05111P,台積電統一95售04,0.46,0.46,0.43,0.44,-0.08,-15.38,133000,9,58990,0,0,0,0,0,0,67000,66000,1000,1000
20200212,051120,南亞科群益95購01,2.59,2.66,2.59,2.64,-0.08,-2.94,130000,17,341950,0,0,0,0,0,0,104000,55000,49000,49000
20200212,051121,裕民群益97購01,,,,,0.00,0.00,0,0,0,0,0,0,0,0,0,0,0,0,0
20200212,051122,美食群益95購01,,,,,0.00,0.00,0,0,0,0,0,0,0,0,0,0,0,0,0
20200212,051123,和鑫群益95購01,0.45,0.48,0.45,0.48,+0.06,14.29,70000,5,33100,0,0,0,0,0,0,2000,68000,-66000,-66000
20200212,051124,創意群益95購01,0.78,0.88,0.75,0.80,-0.13,-13.98,258000,24,212840,0,0,0,0,0,0,70000,187000,-117000,-117000
20200212,051125,TPK群益95購01,,,,,0.00,0.00,0,0,0,0,0,0,0,0,0,0,0,0,0
20200212,051126,訊連群益95購01,0.72,0.76,0.64,0.64,-0.09,-12.33,294000,7,207060,0,0,0,0,0,0,273000,252000,21000,21000
20200212,051127,同欣電群益95購01,0.97,1.19,0.95,0.95,-0.06,-5.94,413000,41,453360,0,0,0,0,0,0,122000,357000,-235000,-235000
20200212,051128,台表科群益95購02,0.63,0.70,0.63,0.70,+0.06,9.38,643000,14,422320,0,0,0,0,0,0,121000,522000,-401000,-401000
20200212,051129,GIS群益95購01,,,,,0.00,0.00,0,0,0,0,0,0,0,0,0,0,0,0,0
20200212,05112P,燿華統一95售01,,,,,0.00,0.00,0,0,0,0,0,0,0,0,0,0,0,0,0
20200212,051130,百和群益96購01,,,,,0.00,0.00,0,0,0,0,0,0,0,0,0,0,0,0,0
20200212,051131,玉山金台新95購01,0.86,0.87,0.86,0.87,-0.03,-3.33,78000,4,67280,0,0,0,0,0,0,20000,58000,-38000,-38000
20200212,051132,喬山永豐95購02,,,,,0.00,0.00,0,0,0,0,0,0,0,0,0,0,0,0,0
20200212,051133,台積電永豐95購02,1.11,1.18,1.08,1.16,+0.10,9.43,6131000,151,6838900,0,0,0,0,0,0,2472000,3385000,-913000,-913000
20200212,051134,燿華永豐95購05,,,,,0.00,0.00,0,0,0,0,0,0,0,0,0,0,0,0,0
20200212,051135,建準永豐95購01,,,,,0.00,0.00,0,0,0,0,0,0,0,0,0,0,0,0,0
20200212,051136,可成永豐95購02,0.04,0.07,0.04,0.07,0.00,0.00,321000,2,12870,0,0,0,0,0,0,320000,0,320000,320000
20200212,051137,聯詠永豐95購01,0.32,0.33,0.30,0.33,+0.06,22.22,100000,4,31900,0,0,0,0,0,0,40000,60000,-20000,-20000
20200212,051138,訊連永豐95購01,,,,,0.00,0.00,0,0,0,0,0,0,0,0,0,0,0,0,0
20200212,051139,康友永豐95購01,0.96,1.04,0.96,1.04,+0.11,11.83,226000,11,228950,0,0,0,0,0,0,82000,221000,-139000,-139000
20200212,05113P,臺股指元富95售01,1.58,1.58,1.57,1.57,0.00,0.00,50000,2,78700,0,0,0,0,0,0,0,50000,-50000,-50000
20200212,051140,矽創永豐95購02,,,,,0.00,0.00,0,0,0,0,0,0,0,0,0,0,0,0,0
20200212,051141,鈺齊永豐95購01,,,,,0.00,0.00,0,0,0,0,0,0,0,0,0,0,0,0,0
20200212,051142,臺股指永豐95購02,0.81,1.00,0.81,1.00,+0.20,25.0,230000,7,198400,0,0,0,0,0,0,215000,15000,200000,200000
20200212,051143,鴻海凱基95購11,0.08,0.08,0.08,0.08,0.00,0.00,20000,1,1600,0,0,0,0,0,0,0,0,0,0
20200212,051144,鴻海凱基95購12,0.07,0.08,0.07,0.07,-0.01,-12.5,107000,6,7840,0,0,0,0,0,0,0,0,0,0
20200212,051145,台積電凱基95購05,2.40,2.40,2.40,2.40,+0.31,14.83,10000,1,24000,0,0,0,0,0,0,0,10000,-10000,-10000
20200212,051146,旺宏凱基95購04,1.96,1.96,1.92,1.92,0.00,0.00,3000,3,5800,0,0,0,0,0,0,3000,3000,0,0
20200212,051147,南亞科凱基95購05,2.99,2.99,2.99,2.99,+0.10,3.46,15000,1,44850,0,0,0,0,0,0,15000,0,15000,15000
20200212,051148,聯發科凱基95購06,,,,,0.00,0.00,0,0,0,0,0,0,0,0,0,0,0,0,0
20200212,051149,可成凱基95購04,0.44,0.44,0.40,0.42,+0.10,31.25,135000,3,56800,0,0,0,0,0,0,120000,15000,105000,105000
20200212,05114P,臺股指元富95售02,1.60,1.60,1.60,1.60,0.00,0.00,10000,1,16000,0,0,0,0,0,0,0,10000,-10000,-10000
20200212,051150,宏達電凱基95購02,0.75,0.77,0.75,0.75,+0.03,4.17,165000,19,125160,0,0,0,0,0,0,165000,0,165000,165000
20200212,051151,中磊凱基95購02,,,,,0.00,0.00,0,0,0,0,0,0,0,0,0,0,0,0,0
20200212,051152,鴻海國泰97購01,1.24,1.48,1.24,1.48,+0.32,27.59,195000,14,267150,0,0,0,0,0,0,115000,80000,35000,35000
20200212,051153,鴻海國泰97購02,,,,,0.00,0.00,0,0,0,0,0,0,0,0,0,0,0,0,0
20200212,051154,國巨國泰96購03,,,,,0.00,0.00,0,0,0,0,0,0,0,0,0,0,0,0,0
20200212,051155,聯發科國泰96購01,1.17,1.32,1.17,1.32,+0.28,26.92,307000,13,389490,0,0,0,0,0,0,102000,282000,-180000,-180000
20200212,051156,鴻海富邦97購01,0.37,0.46,0.37,0.46,+0.11,31.43,53000,8,21590,0,0,0,0,0,0,49000,0,49000,49000
20200212,051157,華新科富邦98購01,2.00,2.05,1.94,1.99,+0.07,3.65,639000,82,1270900,0,0,0,0,0,0,168000,447000,-279000,-279000
20200212,051158,嘉晶富邦96購01,0.15,0.17,0.15,0.16,0.00,0.00,810000,4,124710,0,0,0,0,0,0,0,810000,-810000,-810000
20200212,051159,力山元大96購01,0.40,0.40,0.40,0.40,+0.01,2.56,36000,1,14400,0,0,0,0,0,0,36000,0,36000,36000
20200212,05115P,T50反1群益95售02,0.40,0.40,0.40,0.40,+0.02,5.26,1000,1,400,0,0,0,0,0,0,1000,0,1000,1000
20200212,051160,亞德客元大95購02,3.06,3.34,0.83,3.25,-0.12,-3.56,408000,35,1284570,0,0,0,0,0,0,383000,250000,133000,133000
20200212,051161,喬山元大95購02,1.19,1.25,1.19,1.25,0.00,0.00,122000,3,149360,0,0,0,0,0,0,0,122000,-122000,-122000
20200212,051162,楠梓電元大95購01,0.36,0.36,0.36,0.36,0.00,0.00,200000,1,72000,0,0,0,0,0,0,0,200000,-200000,-200000
20200212,051163,鴻海元大95購04,0.94,1.18,0.94,1.18,+0.32,37.21,404000,10,412610,0,0,0,0,0,0,404000,394000,10000,10000
20200212,051164,鴻海元大95購05,0.32,0.44,0.32,0.44,+0.15,51.72,89000,14,34120,0,0,0,0,0,0,6000,79000,-73000,-73000
20200212,051165,可成元大95購01,,,,,0.00,0.00,0,0,0,0,0,0,0,0,0,0,0,0,0
20200212,051166,可成元大95購02,0.44,0.52,0.44,0.52,+0.15,40.54,23000,4,10420,0,0,0,0,0,0,0,23000,-23000,-23000
20200212,051167,京鼎元大95購01,1.99,2.28,1.99,2.28,0.00,0.00,118000,19,245680,0,0,0,0,0,0,19000,99000,-80000,-80000
20200212,051168,訊連元大95購02,0.71,0.77,0.65,0.65,-0.08,-10.96,335000,10,236330,0,0,0,0,0,0,302000,178000,124000,124000
20200212,051169,瀚宇博元大95購05,,,,,0.00,0.00,0,0,0,0,0,0,0,0,0,0,0,0,0
20200212,05116P,台積電群益95售03,0.29,0.29,0.26,0.26,0.00,0.00,110000,3,31600,0,0,0,0,0,0,0,110000,-110000,-110000
20200212,051170,南電元大95購03,0.47,0.47,0.47,0.47,0.00,0.00,460000,2,216200,0,0,0,0,0,0,0,460000,-460000,-460000
20200212,051171,T50反1第一95購01,,,,,0.00,0.00,0,0,0,0,0,0,0,0,0,0,0,0,0
20200212,051172,鴻海第一96購01,,,,,0.00,0.00,0,0,0,0,0,0,0,0,0,0,0,0,0
20200212,051173,元油2X凱基98購01,0.30,0.32,0.30,0.32,+0.01,3.23,1095000,35,335140,0,0,0,0,0,0,0,839000,-839000,-839000
20200212,051174,鴻海凱基95購14,0.04,0.05,0.04,0.05,0.00,0.00,80000,7,3240,0,0,0,0,0,0,0,0,0,0
20200212,051175,國巨凱基95購04,4.87,4.95,4.67,4.95,+0.47,10.49,74000,10,356380,0,0,0,0,0,0,60000,52000,8000,8000
20200212,051176,聯發科凱基95購07,0.19,0.21,0.19,0.21,0.00,0.00,10000,2,2020,0,0,0,0,0,0,10000,0,10000,10000
20200212,051177,可成凱基95購05,,,,,0.00,0.00,0,0,0,0,0,0,0,0,0,0,0,0,0
20200212,051178,大立光凱基95購10,0.50,0.53,0.50,0.53,+0.12,29.27,54000,9,27620,0,0,0,0,0,0,42000,12000,30000,30000
20200212,051179,臺股指凱基95購04,1.29,1.46,1.29,1.46,+0.23,18.7,77000,6,107170,0,0,0,0,0,0,55000,22000,33000,33000
20200212,05117P,瑞昱群益95售02,0.42,0.44,0.42,0.44,-0.09,-16.98,72000,3,30680,0,0,0,0,0,0,0,72000,-72000,-72000
20200212,051180,喬山永豐95購03,0.17,0.17,0.17,0.17,0.00,0.00,49000,1,8330,0,0,0,0,0,0,0,49000,-49000,-49000
20200212,051181,鴻海永豐95購03,,,,,0.00,0.00,0,0,0,0,0,0,0,0,0,0,0,0,0
20200212,051182,旺宏永豐95購01,1.43,1.52,1.38,1.38,-0.07,-4.83,102000,9,146440,0,0,0,0,0,0,92000,16000,76000,76000
20200212,051183,建準永豐95購02,,,,,0.00,0.00,0,0,0,0,0,0,0,0,0,0,0,0,0
20200212,051184,聯發科永豐95購03,0.08,0.08,0.08,0.08,+0.02,33.33,1000,1,80,0,0,0,0,0,0,0,1000,-1000,-1000
20200212,051185,強茂永豐95購03,0.63,0.65,0.63,0.65,+0.05,8.33,80000,4,50800,0,0,0,0,0,0,0,80000,-80000,-80000
20200212,051186,創意永豐95購01,0.66,0.68,0.61,0.68,-0.07,-9.33,530000,41,344240,0,0,0,0,0,0,313000,217000,96000,96000
20200212,051187,晶相光永豐95購01,0.38,0.40,0.38,0.38,+0.02,5.56,256000,10,101600,0,0,0,0,0,0,10000,246000,-236000,-236000
20200212,051188,鴻海兆豐95購01,0.33,0.37,0.33,0.37,+0.13,54.17,230000,7,81600,0,0,0,0,0,0,10000,30000,-20000,-20000
20200212,051189,鴻海兆豐96購01,0.39,0.39,0.39,0.39,0.00,0.00,38000,1,14820,0,0,0,0,0,0,0,38000,-38000,-38000
20200212,05118P,超眾元大96售04,0.65,0.65,0.32,0.59,-0.05,-7.81,1021000,18,619610,0,0,0,0,0,0,938000,45000,893000,893000
20200212,051190,可成兆豐95購03,,,,,0.00,0.00,0,0,0,0,0,0,0,0,0,0,0,0,0
20200212,051191,可成兆豐96購01,0.10,0.10,0.10,0.10,0.00,0.00,150000,9,15000,0,0,0,0,0,0,0,150000,-150000,-150000
20200212,051192,緯創兆豐96購01,0.50,0.53,0.50,0.53,+0.02,3.92,178000,4,91620,0,0,0,0,0,0,46000,132000,-86000,-86000
20200212,051193,新日興兆豐96購01,1.47,1.47,1.47,1.47,-0.03,-2.0,11000,4,16170,0,0,0,0,0,0,11000,0,11000,11000
20200212,051194,大立光中信96購02,0.40,0.41,0.40,0.41,0.00,0.00,22000,2,8820,0,0,0,0,0,0,2000,20000,-18000,-18000
20200212,051195,台郡中信95購01,0.51,0.53,0.48,0.52,+0.24,85.71,272000,23,139370,0,0,0,0,0,0,39000,233000,-194000,-194000
20200212,051196,喬山麥證95購01,,,,,0.00,0.00,0,0,0,0,0,0,0,0,0,0,0,0,0
20200212,051197,光寶科麥證95購01,0.37,0.38,0.37,0.38,+0.01,2.7,22000,4,8340,0,22000,-22000,0,0,0,0,22000,-22000,-22000
20200212,051198,鴻海麥證95購02,0.40,0.43,0.40,0.43,+0.05,13.16,15000,2,6150,15000,0,15000,0,0,0,15000,0,15000,15000
20200212,051199,鴻海麥證95購03,0.38,0.38,0.38,0.38,0.00,0.00,10000,1,3800,0,10000,-10000,0,0,0,0,10000,-10000,-10000
20200212,05119P,聯發科國泰96售02,1.84,1.84,1.84,1.84,-0.16,-8.0,5000,1,9200,0,0,0,0,0,0,5000,0,5000,5000
20200212,051200,國巨麥證95購01,,,,,0.00,0.00,0,0,0,0,0,0,0,0,0,0,0,0,0
20200212,051201,台積電麥證95購02,1.61,1.65,1.57,1.65,+0.13,8.55,321000,8,519300,201000,120000,81000,0,0,0,201000,120000,81000,81000
20200212,051202,智邦麥證95購01,1.39,1.48,1.18,1.22,-0.08,-6.15,103000,18,142210,6000,97000,-91000,0,0,0,6000,97000,-91000,-91000
20200212,051203,微星麥證95購01,0.70,0.70,0.53,0.54,-0.03,-5.26,203000,10,114160,73000,130000,-57000,0,0,0,73000,130000,-57000,-57000
20200212,051204,正崴麥證95購01,0.34,0.35,0.34,0.34,-0.02,-5.56,47000,16,16240,47000,0,47000,0,0,0,47000,0,47000,47000
20200212,051205,華新科麥證95購02,3.33,3.33,3.33,3.33,+0.08,2.46,20000,1,66600,20000,0,20000,0,0,0,20000,0,20000,20000
20200212,051206,大立光麥證95購02,1.47,1.51,1.47,1.51,+0.12,8.63,12000,2,17720,0,12000,-12000,0,0,0,2000,12000,-10000,-10000
20200212,051207,聯茂麥證95購01,0.39,0.47,0.39,0.47,+0.11,30.56,40000,4,16700,40000,0,40000,0,0,0,40000,0,40000,40000
20200212,051208,GIS麥證95購01,0.22,0.23,0.22,0.23,0.00,0.00,20000,3,4500,0,20000,-20000,0,0,0,0,20000,-20000,-20000
20200212,051209,百和麥證95購01,0.95,0.95,0.95,0.95,0.00,0.00,80000,3,76000,80000,0,80000,0,0,0,80000,0,80000,80000
20200212,05120P,聯發科國泰97售01,,,,,0.00,0.00,0,0,0,0,0,0,0,0,0,0,0,0,0
20200212,051210,S&P反1統一97購01,,,,,0.00,0.00,0,0,0,0,0,0,0,0,0,0,0,0,0
20200212,051211,道瓊反統一95購01,0.27,0.27,0.27,0.27,0.00,0.00,116000,5,31320,0,0,0,0,0,0,116000,0,116000,116000
20200212,051212,國巨統一95購01,,,,,0.00,0.00,0,0,0,0,0,0,0,0,0,0,0,0,0
20200212,051213,華新科統一95購01,3.21,3.27,3.17,3.19,+0.21,7.05,82000,6,263160,0,0,0,0,0,0,66000,16000,50000,50000
20200212,051214,大立光統一95購02,1.59,1.59,1.57,1.58,+0.19,13.67,125000,4,197870,0,0,0,0,0,0,38000,87000,-49000,-49000
20200212,051215,大立光統一95購03,0.34,0.38,0.34,0.38,+0.09,31.03,254000,10,89760,0,0,0,0,0,0,135000,119000,16000,16000
20200212,051216,為升元富95購01,0.82,0.83,0.82,0.83,+0.04,5.06,50000,4,41480,0,0,0,0,0,0,50000,10000,40000,40000
20200212,051217,聯發科元富95購01,0.72,0.80,0.72,0.80,+0.24,42.86,65000,3,49300,0,0,0,0,0,0,15000,50000,-35000,-35000
20200212,051218,聯發科元富9B購02,,,,,0.00,0.00,0,0,0,0,0,0,0,0,0,0,0,0,0
20200212,051219,大立光元富95購07,,,,,0.00,0.00,0,0,0,0,0,0,0,0,0,0,0,0,0
20200212,05121P,創意國泰96售01,2.01,2.09,1.97,1.97,+0.06,3.14,66000,16,133990,0,0,0,0,0,0,49000,60000,-11000,-11000
20200212,051220,大立光元富95購08,1.21,1.21,1.21,1.21,-0.05,-3.97,12000,1,14520,0,0,0,0,0,0,12000,0,12000,12000
20200212,051221,嘉聯益元富95購01,0.34,0.34,0.34,0.34,+0.06,21.43,10000,2,3400,0,0,0,0,0,0,0,10000,-10000,-10000
20200212,051222,世紀鋼元富95購01,0.43,0.44,0.40,0.43,0.00,0.00,209000,13,89770,0,0,0,0,0,0,199000,2000,197000,197000
20200212,051223,台化群益95購01,0.37,0.38,0.37,0.38,+0.03,8.57,13000,2,4840,0,0,0,0,0,0,10000,3000,7000,7000
20200212,051224,華通群益96購03,1.39,1.81,1.39,1.75,+0.80,84.21,134000,27,222340,0,0,0,0,0,0,15000,119000,-104000,-104000
20200212,051225,台積電群益95購02,3.31,3.52,3.22,3.46,+0.29,9.15,447000,77,1473810,0,0,0,0,0,0,371000,381000,-10000,-10000
20200212,051226,英業達群益95購01,0.87,0.87,0.87,0.87,-0.02,-2.25,10000,1,8700,0,0,0,0,0,0,0,10000,-10000,-10000
20200212,051227,技嘉群益97購01,1.73,1.83,1.64,1.72,-0.03,-1.71,807000,29,1414540,0,0,0,0,0,0,440000,367000,73000,73000
20200212,051228,聯發科群益95購03,0.20,0.20,0.18,0.18,0.00,0.00,12000,2,2200,0,0,0,0,0,0,12000,0,12000,12000
20200212,051229,亞光群益95購01,1.24,1.47,1.24,1.47,+0.25,20.49,168000,11,224620,0,0,0,0,0,0,29000,147000,-118000,-118000
20200212,05122P,鴻海永昌96售06,3.47,3.47,3.22,3.22,-0.43,-11.78,211000,5,696670,0,0,0,0,0,0,191000,111000,80000,80000
20200212,051230,聯詠群益95購01,1.20,1.26,1.09,1.21,+0.19,18.63,223000,13,265080,0,0,0,0,0,0,35000,188000,-153000,-153000
20200212,051231,健策群益97購01,1.75,1.88,1.67,1.87,+0.21,12.65,1510000,72,2685990,0,0,0,0,0,0,1105000,678000,427000,427000
20200212,051232,貿聯群益95購02,1.33,1.51,1.33,1.51,+0.22,17.05,52000,8,73500,0,0,0,0,0,0,22000,44000,-22000,-22000
20200212,051233,力成群益97購01,7.85,8.85,7.85,8.70,+1.60,22.54,75000,14,612800,0,0,0,0,0,0,13000,62000,-49000,-49000
20200212,051234,南電群益95購02,0.36,0.40,0.36,0.39,0.00,0.00,90000,16,33780,0,0,0,0,0,0,0,90000,-90000,-90000
20200212,051235,鴻海元大95購06,0.12,0.16,0.12,0.16,+0.06,60.0,521000,5,65810,0,0,0,0,0,0,197000,324000,-127000,-127000
20200212,051236,鴻海元大96購05,0.87,0.91,0.87,0.91,+0.13,16.67,206000,6,180430,0,0,0,0,0,0,156000,201000,-45000,-45000
20200212,051237,鴻海元大97購01,0.94,1.19,0.91,1.19,+0.29,32.22,841000,26,879560,0,0,0,0,0,0,801000,831000,-30000,-30000
20200212,051238,中環元大96購01,0.55,0.55,0.53,0.54,-0.12,-18.18,300000,17,161900,0,0,0,0,0,0,300000,0,300000,300000
20200212,051239,國巨元大96購02,,,,,0.00,0.00,0,0,0,0,0,0,0,0,0,0,0,0,0
20200212,05123P,鴻海永昌96售07,2.56,2.56,2.14,2.14,-0.62,-22.46,1040000,24,2497420,0,0,0,0,0,0,993000,1040000,-47000,-47000
20200212,051240,台積電元大95購12,3.44,3.70,3.44,3.63,+0.36,11.01,232000,47,815710,0,0,0,0,0,0,147000,113000,34000,34000
20200212,051241,台積電元大95購13,3.06,3.27,2.99,3.27,+0.38,13.15,118000,12,362090,0,0,0,0,0,0,85000,85000,0,0
20200212,051242,台積電元大96購06,2.28,2.42,2.28,2.42,+0.14,6.14,44000,5,103890,0,0,0,0,0,0,31000,29000,2000,2000
20200212,051243,微星元大95購01,2.29,2.32,1.97,1.99,-0.05,-2.45,421000,27,881130,0,0,0,0,0,0,300000,291000,9000,9000
20200212,051244,正崴元大95購01,0.66,0.66,0.66,0.66,-0.01,-1.49,68000,1,44880,0,0,0,0,0,0,68000,0,68000,68000
20200212,051245,南亞科元大95購01,4.86,4.88,4.83,4.88,-0.02,-0.41,17000,7,82560,0,0,0,0,0,0,17000,7000,10000,10000
20200212,051246,美律元大96購01,0.44,0.53,0.44,0.53,+0.13,32.5,155000,11,72280,0,0,0,0,0,0,0,155000,-155000,-155000
20200212,051247,可成元大95購04,0.15,0.19,0.15,0.19,0.00,0.00,210000,3,36300,0,0,0,0,0,0,170000,40000,130000,130000
20200212,051248,華固元大95購01,1.15,1.15,1.15,1.15,+0.03,2.68,100000,1,115000,0,0,0,0,0,0,100000,0,100000,100000
20200212,051249,潤泰全元大95購01,0.75,0.76,0.75,0.76,-0.03,-3.8,682000,11,511770,0,0,0,0,0,0,283000,682000,-399000,-399000
20200212,05124P,華新科富邦97售02,0.31,0.31,0.31,0.31,-0.02,-6.06,70000,5,21700,0,0,0,0,0,0,0,70000,-70000,-70000
20200212,051250,大立光元大98購01,1.92,1.92,1.92,1.92,+0.18,10.34,68000,1,130560,0,0,0,0,0,0,0,68000,-68000,-68000
20200212,051251,信邦元大95購01,1.87,2.01,1.87,1.98,+0.04,2.06,165000,11,321770,0,0,0,0,0,0,88000,77000,11000,11000
20200212,051252,健鼎元大95購01,0.90,1.20,0.90,1.18,+0.42,55.26,393000,25,408610,0,0,0,0,0,0,41000,376000,-335000,-335000
20200212,051253,緯創元大95購02,0.87,0.92,0.87,0.92,+0.08,9.52,74000,11,66290,0,0,0,0,0,0,46000,34000,12000,12000
20200212,051254,健策元大96購04,3.20,3.36,3.20,3.36,+0.31,10.16,77000,11,250240,0,0,0,0,0,0,66000,58000,8000,8000
20200212,051255,康控元大96購04,0.35,0.38,0.35,0.37,+0.06,19.35,103000,7,37220,0,0,0,0,0,0,88000,15000,73000,73000
20200212,051256,中磊元大95購01,0.65,0.65,0.65,0.65,0.00,0.00,15000,1,9750,0,0,0,0,0,0,15000,0,15000,15000
20200212,051257,光寶科國泰96購01,1.16,1.18,1.15,1.17,-0.01,-0.85,80000,8,93400,0,0,0,0,0,0,10000,70000,-60000,-60000
20200212,051258,鈺齊國泰97購01,1.23,1.38,1.23,1.38,+0.16,13.11,25000,3,31800,0,0,0,0,0,0,25000,0,25000,25000
20200212,051259,鴻海永昌96購03,0.90,1.13,0.90,1.12,+0.27,31.76,8928000,130,8982140,0,0,0,0,0,0,5000000,7138000,-2138000,-2138000
20200212,05125P,鴻海群益95售06,,,,,0.00,0.00,0,0,0,0,0,0,0,0,0,0,0,0,0
20200212,051260,鴻海永昌96購04,0.53,0.67,0.53,0.67,+0.19,39.58,241000,7,136460,0,0,0,0,0,0,0,241000,-241000,-241000
20200212,051261,鴻海永昌96購05,0.31,0.40,0.31,0.40,+0.14,53.85,128000,15,46880,0,0,0,0,0,0,46000,80000,-34000,-34000
20200212,051262,A50富邦96購01,0.17,0.17,0.17,0.17,0.00,0.00,20000,1,3400,0,0,0,0,0,0,20000,0,20000,20000
20200212,051263,深中小富邦96購01,0.89,0.93,0.89,0.93,+0.08,9.41,88000,2,79040,0,0,0,0,0,0,70000,18000,52000,52000
20200212,051264,道瓊反富邦97購01,0.31,0.31,0.31,0.31,0.00,0.00,200000,1,62000,0,0,0,0,0,0,200000,200000,0,0
20200212,051265,鴻海富邦96購04,0.22,0.22,0.22,0.22,0.00,0.00,20000,1,4400,0,0,0,0,0,0,20000,0,20000,20000
20200212,051266,國巨富邦99購01,3.41,3.41,3.26,3.41,+0.19,5.9,721000,38,2383770,0,0,0,0,0,0,511000,186000,325000,325000
20200212,051267,美律富邦96購01,0.26,0.31,0.26,0.30,+0.06,25.0,306000,32,89860,0,0,0,0,0,0,45000,261000,-216000,-216000
20200212,051268,創意富邦97購01,0.61,0.64,0.58,0.62,-0.04,-6.06,850000,64,523160,0,0,0,0,0,0,408000,430000,-22000,-22000
20200212,051269,康友富邦97購01,1.29,1.29,1.27,1.27,0.00,0.00,26000,2,33340,0,0,0,0,0,0,26000,0,26000,26000
20200212,05126P,牧德群益95售01,,,,,0.00,0.00,0,0,0,0,0,0,0,0,0,0,0,0,0
20200212,051270,百和富邦95購01,,,,,0.00,0.00,0,0,0,0,0,0,0,0,0,0,0,0,0
20200212,051271,華新科群益95購04,,,,,0.00,0.00,0,0,0,0,0,0,0,0,0,0,0,0,0
20200212,051272,嘉晶群益95購01,0.56,0.72,0.56,0.66,0.00,0.00,193000,27,125740,0,0,0,0,0,0,0,193000,-193000,-193000
20200212,051273,可成亞東95購01,,,,,0.00,0.00,0,0,0,0,0,0,0,0,0,0,0,0,0
20200212,051274,華新科亞東96購01,,,,,0.00,0.00,0,0,0,0,0,0,0,0,0,0,0,0,0
20200212,051275,群創亞東95購01,,,,,0.00,0.00,0,0,0,0,0,0,0,0,0,0,0,0,0
20200212,051276,SGBR2X中信97購01,,,,,0.00,0.00,0,0,0,0,0,0,0,0,0,0,0,0,0
20200212,051277,聯發科中信9A購01,0.24,0.27,0.24,0.27,+0.05,22.73,2014000,54,517540,0,0,0,0,0,0,1079000,815000,264000,264000
20200212,051278,臻鼎中信97購02,0.16,0.16,0.12,0.12,0.00,0.00,31000,7,4420,0,0,0,0,0,0,30000,1000,29000,29000
20200212,051279,喬山兆豐96購01,0.34,0.35,0.34,0.35,+0.06,20.69,230000,2,78500,0,0,0,0,0,0,200000,30000,170000,170000
20200212,05127P,鴻海亞東96售01,0.99,0.99,0.99,0.99,0.00,0.00,250000,4,247500,0,0,0,0,0,0,250000,250000,0,0
20200212,051280,台積電兆豐95購04,0.48,0.51,0.45,0.48,+0.09,23.08,803000,48,386520,0,0,0,0,0,0,0,31000,-31000,-31000
20200212,051281,健策兆豐96購01,2.03,2.03,1.95,1.95,+0.19,10.8,16000,5,31650,0,0,0,0,0,0,16000,0,16000,16000
20200212,051282,GIS兆豐95購02,0.23,0.23,0.23,0.23,+0.03,15.0,45000,1,10350,0,0,0,0,0,0,0,45000,-45000,-45000
20200212,051283,亞德客統一95購01,2.25,2.51,2.25,2.43,+0.06,2.53,740000,33,1744160,0,0,0,0,0,0,660000,80000,580000,580000
20200212,051284,上銀統一95購02,2.22,2.22,2.13,2.16,+0.09,4.35,162000,9,353310,0,0,0,0,0,0,152000,10000,142000,142000
20200212,051285,鴻海統一95購07,0.50,0.50,0.28,0.28,0.00,0.00,21000,3,6100,0,0,0,0,0,0,20000,0,20000,20000
20200212,051286,國巨統一97購01,9.30,9.30,9.30,9.30,+0.50,5.68,16000,3,148800,0,0,0,0,0,0,16000,0,16000,16000
20200212,051287,台積電統一95購05,2.28,2.37,2.24,2.37,+0.33,16.18,39000,12,90340,0,0,0,0,0,0,28000,4000,24000,24000
20200212,051288,可成統一95購03,,,,,0.00,0.00,0,0,0,0,0,0,0,0,0,0,0,0,0
20200212,051289,大立光統一96購01,1.10,1.15,1.10,1.15,+0.11,10.58,101000,2,116100,0,0,0,0,0,0,1000,100000,-99000,-99000
20200212,05128P,聯發科中信97售03,1.40,1.40,1.35,1.36,0.00,0.00,91000,5,126390,0,0,0,0,0,0,0,91000,-91000,-91000
20200212,051290,大立光統一96購02,,,,,0.00,0.00,0,0,0,0,0,0,0,0,0,0,0,0,0
20200212,051291,聯詠統一95購01,0.98,1.08,0.96,1.05,+0.16,17.98,749000,37,768640,0,0,0,0,0,0,260000,489000,-229000,-229000
20200212,051292,牧德統一97購01,4.70,4.70,4.67,4.67,+0.14,3.09,37000,2,173390,0,0,0,0,0,0,37000,0,37000,37000
20200212,051293,鴻海元富95購05,0.32,0.38,0.32,0.38,+0.11,40.74,55000,9,18750,0,0,0,0,0,0,20000,35000,-15000,-15000
20200212,051294,鴻海元富95購06,0.31,0.31,0.31,0.31,0.00,0.00,50000,1,15500,0,0,0,0,0,0,50000,0,50000,50000
20200212,051295,國巨元富95購04,,,,,0.00,0.00,0,0,0,0,0,0,0,0,0,0,0,0,0
20200212,051296,鴻海凱基97購01,0.12,0.13,0.12,0.13,0.00,0.00,200000,7,25500,0,0,0,0,0,0,200000,0,200000,200000
20200212,051297,台積電凱基95購07,0.56,0.56,0.40,0.45,+0.06,15.38,525000,24,225130,0,0,0,0,0,0,324000,0,324000,324000
20200212,051298,智邦凱基95購03,0.73,0.79,0.63,0.63,-0.07,-10.0,67000,10,44280,0,0,0,0,0,0,67000,47000,20000,20000
20200212,051299,致茂凱基95購01,1.34,1.61,1.34,1.61,+0.35,27.78,281000,27,406880,0,0,0,0,0,0,218000,83000,135000,135000
20200212,05129P,鴻海兆豐95售02,,,,,0.00,0.00,0,0,0,0,0,0,0,0,0,0,0,0,0
20200212,051300,台光電凱基96購02,0.54,0.58,0.54,0.58,+0.15,34.88,101000,11,55670,0,0,0,0,0,0,60000,41000,19000,19000
20200212,051301,聯發科凱基95購08,0.07,0.10,0.07,0.09,-0.01,-10.0,540000,9,47900,0,0,0,0,0,0,470000,0,470000,470000
20200212,051302,可成凱基95購06,,,,,0.00,0.00,0,0,0,0,0,0,0,0,0,0,0,0,0
20200212,051303,奇鋐凱基95購01,,,,,0.00,0.00,0,0,0,0,0,0,0,0,0,0,0,0,0
20200212,051304,緯創凱基96購01,0.30,0.30,0.30,0.30,0.00,0.00,100000,1,30000,0,0,0,0,0,0,0,100000,-100000,-100000
20200212,051305,訊連凱基96購01,,,,,0.00,0.00,0,0,0,0,0,0,0,0,0,0,0,0,0
20200212,051306,嘉聯益凱基96購01,0.11,0.11,0.11,0.11,+0.01,10.0,20000,2,2200,0,0,0,0,0,0,10000,10000,0,0
20200212,051307,康舒凱基95購01,1.30,1.30,1.30,1.30,0.00,0.00,91000,2,118300,0,0,0,0,0,0,4000,87000,-83000,-83000
20200212,051308,GIS凱基95購04,,,,,0.00,0.00,0,0,0,0,0,0,0,0,0,0,0,0,0
20200212,051309,卜蜂麥證95購01,,,,,0.00,0.00,0,0,0,0,0,0,0,0,0,0,0,0,0
20200212,05130P,聯發科統一95售03,1.60,1.60,1.60,1.60,0.00,0.00,1000,1,1600,0,0,0,0,0,0,0,1000,-1000,-1000
20200212,051310,台達電麥證95購01,0.67,0.70,0.63,0.70,+0.04,6.06,140000,12,92200,88000,50000,38000,0,0,0,88000,50000,38000,38000
20200212,051311,瑞昱麥證95購01,1.08,1.27,1.08,1.21,+0.15,14.15,876000,31,1042040,452000,424000,28000,0,0,0,452000,424000,28000,28000
20200212,051312,國泰金麥證95購01,0.80,0.91,0.76,0.91,+0.06,7.06,134000,15,113740,100000,20000,80000,0,0,0,100000,20000,80000,80000
20200212,051313,緯創麥證95購02,0.99,1.02,0.99,1.02,+0.04,4.08,30000,4,30000,20000,10000,10000,0,0,0,20000,10000,10000,10000
20200212,051314,嘉聯益麥證96購01,,,,,0.00,0.00,0,0,0,0,0,0,0,0,0,0,0,0,0
20200212,051315,同欣電麥證95購01,1.64,1.82,1.62,1.67,+0.11,7.05,1046000,33,1858390,102000,944000,-842000,0,0,0,102000,944000,-842000,-842000
20200212,051316,T50反1國票95購02,0.54,0.54,0.50,0.50,-0.06,-10.71,1870000,18,947700,0,0,0,0,0,0,1510000,350000,1160000,1160000
20200212,051317,亞德客國票96購01,1.98,2.24,1.98,2.24,+0.04,1.82,62000,9,131740,0,0,0,0,0,0,49000,13000,36000,36000
20200212,051318,上銀國票96購01,3.13,3.13,3.13,3.13,+0.11,3.64,16000,1,50080,0,0,0,0,0,0,16000,0,16000,16000
20200212,051319,光磊國票96購02,1.43,1.43,1.40,1.40,+0.03,2.19,7000,2,9860,0,0,0,0,0,0,7000,0,7000,7000
20200212,05131P,聯詠統一97售01,2.17,2.21,2.17,2.19,-0.11,-4.78,30000,5,65700,0,0,0,0,0,0,0,30000,-30000,-30000
20200212,051320,燿華國票96購01,,,,,0.00,0.00,0,0,0,0,0,0,0,0,0,0,0,0,0
20200212,051321,建準國票96購01,,,,,0.00,0.00,0,0,0,0,0,0,0,0,0,0,0,0,0
20200212,051322,國泰金國票96購01,0.44,0.48,0.42,0.48,+0.03,6.67,244000,8,109020,0,0,0,0,0,0,178000,66000,112000,112000
20200212,051323,康控國票96購01,0.38,0.38,0.38,0.38,0.00,0.00,60000,1,22800,0,0,0,0,0,0,0,60000,-60000,-60000
20200212,051324,康友國票96購01,3.68,3.87,3.68,3.73,+0.02,0.54,92000,8,343300,0,0,0,0,0,0,50000,42000,8000,8000
20200212,051325,台光電台新96購01,0.83,0.96,0.83,0.96,+0.22,29.73,220000,5,208850,0,0,0,0,0,0,10000,210000,-200000,-200000
20200212,051326,聯發科台新95購01,,,,,0.00,0.00,0,0,0,0,0,0,0,0,0,0,0,0,0
20200212,051327,元油2X永豐95購02,0.38,0.39,0.38,0.39,+0.05,14.71,904000,8,349520,0,0,0,0,0,0,0,904000,-904000,-904000
20200212,051328,力山永豐95購01,,,,,0.00,0.00,0,0,0,0,0,0,0,0,0,0,0,0,0
20200212,051329,智邦永豐95購01,0.49,0.49,0.49,0.49,0.00,0.00,115000,2,56350,0,0,0,0,0,0,115000,0,115000,115000
20200212,05132P,鴻海元富95售07,,,,,0.00,0.00,0,0,0,0,0,0,0,0,0,0,0,0,0
20200212,051330,宏碁永豐95購01,,,,,0.00,0.00,0,0,0,0,0,0,0,0,0,0,0,0,0
20200212,051331,全新永豐96購01,,,,,0.00,0.00,0,0,0,0,0,0,0,0,0,0,0,0,0
20200212,051332,奇力新永豐95購01,3.12,3.35,3.11,3.35,+0.15,4.69,188000,50,609850,0,0,0,0,0,0,77000,110000,-33000,-33000
20200212,051333,義隆永豐95購02,0.26,0.26,0.26,0.26,0.00,0.00,10000,1,2600,0,0,0,0,0,0,0,10000,-10000,-10000
20200212,051334,宏達電永豐95購01,,,,,0.00,0.00,0,0,0,0,0,0,0,0,0,0,0,0,0
20200212,051335,華固永豐95購01,,,,,0.00,0.00,0,0,0,0,0,0,0,0,0,0,0,0,0
20200212,051336,智原永豐95購01,0.40,0.46,0.40,0.46,+0.05,12.2,312000,5,132360,0,0,0,0,0,0,156000,156000,0,0
20200212,051337,欣興永豐95購02,,,,,0.00,0.00,0,0,0,0,0,0,0,0,0,0,0,0,0
20200212,051338,揚明光永豐95購02,0.80,0.83,0.80,0.81,+0.06,8.0,352000,5,288850,0,0,0,0,0,0,152000,200000,-48000,-48000
20200212,051339,智易永豐95購02,0.64,0.83,0.64,0.80,+0.17,26.98,315000,27,239680,0,0,0,0,0,0,32000,283000,-251000,-251000
20200212,05133P,臺股指日盛95售01,0.49,0.49,0.41,0.41,-0.11,-21.15,938000,11,425780,0,0,0,0,0,0,5000,933000,-928000,-928000
20200212,051340,健策永豐95購03,1.08,1.15,1.02,1.15,+0.13,12.75,771000,37,828120,0,0,0,0,0,0,536000,183000,353000,353000
20200212,051341,訊連永豐95購02,,,,,0.00,0.00,0,0,0,0,0,0,0,0,0,0,0,0,0
20200212,051342,光寶科元大95購01,1.04,1.06,1.03,1.06,-0.01,-0.93,108000,7,114220,0,0,0,0,0,0,52000,108000,-56000,-56000
20200212,051343,鴻海元大95購07,0.44,0.58,0.44,0.58,+0.14,31.82,299000,22,153240,0,0,0,0,0,0,133000,128000,5000,5000
20200212,051344,鴻海元大95購08,0.54,0.63,0.54,0.62,+0.12,24.0,1240000,32,723290,0,0,0,0,0,0,965000,1110000,-145000,-145000
20200212,051345,鴻海元大95購09,0.41,0.57,0.41,0.57,+0.16,39.02,33000,5,16360,0,0,0,0,0,0,10000,23000,-13000,-13000
20200212,051346,仁寶元大95購01,0.76,0.76,0.76,0.76,0.00,0.00,102000,2,77520,0,0,0,0,0,0,2000,100000,-98000,-98000
20200212,051347,國巨元大95購06,4.93,4.93,4.93,4.93,+0.25,5.34,2000,1,9860,0,0,0,0,0,0,2000,0,2000,2000
20200212,051348,國巨元大95購07,4.80,4.80,4.80,4.80,+0.37,8.35,10000,1,48000,0,0,0,0,0,0,10000,0,10000,10000
20200212,051349,國巨元大95購08,8.75,8.75,8.75,8.75,+0.65,8.02,26000,4,227500,0,0,0,0,0,0,26000,26000,0,0
20200212,05134P,鴻海凱基96售06,,,,,0.00,0.00,0,0,0,0,0,0,0,0,0,0,0,0,0
20200212,051350,台積電元大95購14,3.37,3.47,3.31,3.47,+0.32,10.16,106000,23,358820,0,0,0,0,0,0,106000,84000,22000,22000
20200212,051351,台積電元大95購15,1.74,1.81,1.74,1.81,+0.13,7.74,67000,6,117390,0,0,0,0,0,0,55000,20000,35000,35000
20200212,051352,南亞科元大95購02,4.03,4.03,3.92,3.94,-0.14,-3.43,93000,22,368670,0,0,0,0,0,0,93000,73000,20000,20000
20200212,051353,聯發科元大95購08,0.64,0.64,0.61,0.64,+0.10,18.52,548000,7,335080,0,0,0,0,0,0,528000,20000,508000,508000
20200212,051354,聯發科元大95購09,0.57,0.57,0.53,0.55,0.00,0.00,51000,10,27370,0,0,0,0,0,0,31000,20000,11000,11000
20200212,051355,聯發科元大96購01,0.60,0.66,0.59,0.66,+0.17,34.69,283000,12,171090,0,0,0,0,0,0,106000,177000,-71000,-71000
20200212,051356,全新元大96購04,0.53,0.53,0.53,0.53,+0.16,43.24,10000,1,5300,0,0,0,0,0,0,0,10000,-10000,-10000
20200212,051357,可成元大95購05,0.29,0.34,0.29,0.34,+0.07,25.93,30000,2,9200,0,0,0,0,0,0,30000,0,30000,30000
20200212,051358,台新金元大95購01,0.76,0.76,0.76,0.76,+0.01,1.33,1000,1,760,0,0,0,0,0,0,0,1000,-1000,-1000
20200212,051359,中信金元大95購01,1.19,1.27,1.19,1.27,+0.09,7.63,1715000,21,2103210,0,0,0,0,0,0,1041000,674000,367000,367000
20200212,05135P,鴻海凱基96售07,1.75,1.75,1.75,1.75,-0.34,-16.27,10000,1,17500,0,0,0,0,0,0,10000,0,10000,10000
20200212,051360,緯創元大95購03,0.96,1.02,0.96,1.02,+0.07,7.37,136000,8,136110,0,0,0,0,0,0,120000,36000,84000,84000
20200212,051361,泰鼎元大95購01,5.05,5.20,4.90,4.91,+0.24,5.14,62000,10,312950,0,0,0,0,0,0,17000,62000,-45000,-45000
20200212,051362,台郡元大95購04,1.43,1.47,1.31,1.47,+0.68,86.08,131000,8,183530,0,0,0,0,0,0,81000,50000,31000,31000
20200212,051363,矽創元大95購03,0.76,0.97,0.76,0.97,+0.22,29.33,209000,8,182620,0,0,0,0,0,0,121000,98000,23000,23000
20200212,051364,鴻海國泰97購03,0.53,0.68,0.53,0.68,0.00,0.00,54000,6,31470,0,0,0,0,0,0,19000,35000,-16000,-16000
20200212,051365,瀚宇博國泰97購01,0.62,0.69,0.62,0.69,+0.01,1.47,149000,11,100960,0,0,0,0,0,0,119000,30000,89000,89000
20200212,051366,康友國泰97購01,2.83,3.00,2.83,2.87,+0.02,0.7,510000,30,1496990,0,0,0,0,0,0,365000,285000,80000,80000
20200212,051367,可成富邦97購01,0.14,0.18,0.14,0.18,+0.05,38.46,1004000,25,149360,0,0,0,0,0,0,332000,662000,-330000,-330000
20200212,051368,國泰金富邦97購01,0.43,0.47,0.43,0.46,+0.03,6.98,250000,17,112390,0,0,0,0,0,0,23000,226000,-203000,-203000
20200212,051369,新光金富邦9A購01,0.52,0.52,0.51,0.52,+0.01,1.96,295000,54,152670,0,0,0,0,0,0,295000,0,295000,295000
20200212,05136P,台積電凱基95售08,0.64,0.64,0.64,0.64,0.00,0.00,20000,1,12800,0,0,0,0,0,0,0,20000,-20000,-20000
20200212,051370,聯詠富邦97購01,0.59,0.63,0.57,0.62,+0.08,14.81,1049000,50,645200,0,0,0,0,0,0,590000,382000,208000,208000
20200212,051371,超眾富邦95購01,,,,,0.00,0.00,0,0,0,0,0,0,0,0,0,0,0,0,0
20200212,051372,樺漢富邦96購01,0.54,0.54,0.52,0.52,0.00,0.00,21000,3,11320,0,0,0,0,0,0,21000,0,21000,21000
20200212,051373,華新亞東95購01,0.44,0.44,0.44,0.44,0.00,0.00,100000,1,44000,0,0,0,0,0,0,0,100000,-100000,-100000
20200212,051374,國泰金亞東95購01,,,,,0.00,0.00,0,0,0,0,0,0,0,0,0,0,0,0,0
20200212,051375,道瓊反群益9A購01,0.37,0.37,0.36,0.36,+0.01,2.86,150000,15,54500,0,0,0,0,0,0,0,150000,-150000,-150000
20200212,051376,力山群益95購01,,,,,0.00,0.00,0,0,0,0,0,0,0,0,0,0,0,0,0
20200212,051377,鴻海群益95購07,0.81,0.83,0.81,0.83,0.00,0.00,20000,2,16400,0,0,0,0,0,0,0,20000,-20000,-20000
20200212,051378,奇力新群益95購01,8.10,8.55,8.10,8.55,+0.15,1.79,30000,12,247400,0,0,0,0,0,0,19000,29000,-10000,-10000
20200212,051379,新光金群益95購01,0.30,0.30,0.30,0.30,0.00,0.00,25000,2,7500,0,0,0,0,0,0,20000,5000,15000,15000
20200212,05137P,華新科凱基96售03,0.15,0.15,0.15,0.15,-0.03,-16.67,50000,1,7500,0,0,0,0,0,0,50000,0,50000,50000
20200212,051380,禾伸堂群益95購01,2.29,2.44,2.19,2.44,+0.17,7.49,38000,8,85820,0,0,0,0,0,0,37000,11000,26000,26000
20200212,051381,玉晶光群益98購01,3.71,3.95,3.66,3.89,+0.32,8.96,378000,22,1442970,0,0,0,0,0,0,127000,251000,-124000,-124000
20200212,051382,玉晶光群益98購02,6.20,6.30,6.20,6.30,+0.60,10.53,50000,3,312500,0,0,0,0,0,0,0,50000,-50000,-50000
20200212,051383,京鼎群益96購02,2.51,2.91,2.51,2.90,+0.63,27.75,137000,17,376380,0,0,0,0,0,0,1000,136000,-135000,-135000
20200212,051384,康友群益95購01,2.26,2.40,2.26,2.27,+0.02,0.89,107000,14,250730,0,0,0,0,0,0,65000,52000,13000,13000
20200212,051385,矽創群益95購01,0.46,0.57,0.46,0.57,0.00,0.00,87000,19,46270,0,0,0,0,0,0,0,87000,-87000,-87000
20200212,051386,富邦金麥證96購01,0.78,0.78,0.78,0.78,+0.11,16.42,10000,1,7800,0,10000,-10000,0,0,0,0,10000,-10000,-10000
20200212,051387,新光金麥證96購01,0.41,0.41,0.38,0.40,0.00,0.00,92000,26,36500,56000,10000,46000,0,0,0,56000,10000,46000,46000
20200212,051388,大立光麥證95購03,2.13,2.15,2.12,2.15,+0.22,11.4,25000,3,53350,15000,10000,5000,0,0,0,15000,10000,5000,5000
20200212,051389,台達電兆豐95購01,0.50,0.50,0.50,0.50,+0.03,6.38,10000,1,5000,0,0,0,0,0,0,0,10000,-10000,-10000
20200212,05138P,嘉聯益凱基96售02,,,,,0.00,0.00,0,0,0,0,0,0,0,0,0,0,0,0,0
20200212,051390,京元電兆豐95購01,0.79,0.88,0.77,0.85,+0.07,8.97,752000,35,608310,0,0,0,0,0,0,649000,153000,496000,496000
20200212,051391,聯發科兆豐95購02,0.19,0.21,0.19,0.20,+0.06,42.86,470000,8,93100,0,0,0,0,0,0,150000,320000,-170000,-170000
20200212,051392,玉山金兆豐95購01,0.91,0.92,0.91,0.92,-0.01,-1.08,231000,7,211000,0,0,0,0,0,0,126000,105000,21000,21000
20200212,051393,新光金兆豐96購01,,,,,0.00,0.00,0,0,0,0,0,0,0,0,0,0,0,0,0
20200212,051394,奇鋐兆豐95購01,0.35,0.37,0.35,0.37,+0.04,12.12,105000,3,37850,0,0,0,0,0,0,0,105000,-105000,-105000
20200212,051395,聯詠兆豐95購01,0.71,0.78,0.68,0.74,+0.07,10.45,974000,50,724730,0,0,0,0,0,0,447000,519000,-72000,-72000
20200212,051396,健鼎兆豐95購01,0.35,0.46,0.35,0.46,+0.17,58.62,791000,23,297480,0,0,0,0,0,0,6000,785000,-779000,-779000
20200212,051397,聯茂兆豐95購03,0.62,0.71,0.62,0.64,+0.18,39.13,575000,22,382760,0,0,0,0,0,0,130000,445000,-315000,-315000
20200212,051398,智原台新95購01,,,,,0.00,0.00,0,0,0,0,0,0,0,0,0,0,0,0,0
20200212,051399,玉晶光台新96購01,2.22,2.39,2.22,2.35,+0.18,8.29,44000,6,102290,0,0,0,0,0,0,11000,33000,-22000,-22000
20200212,05139P,臺股指凱基95售06,1.10,1.10,0.96,0.96,-0.18,-15.79,638000,14,677040,0,0,0,0,0,0,405000,233000,172000,172000
20200212,051400,國巨永豐95購01,4.86,4.93,4.55,4.93,+0.42,9.31,128000,13,611090,0,0,0,0,0,0,82000,46000,36000,36000
20200212,051401,華新科永豐95購01,2.23,2.23,2.10,2.15,+0.03,1.42,402000,25,871510,0,0,0,0,0,0,187000,254000,-67000,-67000
20200212,051402,玉晶光永豐95購04,2.48,2.70,2.45,2.62,+0.30,12.93,200000,15,502130,0,0,0,0,0,0,130000,70000,60000,60000
20200212,051403,玉晶光永豐95購05,3.53,3.64,3.53,3.64,0.00,0.00,13000,2,46550,0,0,0,0,0,0,0,13000,-13000,-13000
20200212,051404,牧德永豐96購01,3.40,3.53,3.40,3.53,+0.15,4.44,46000,8,158120,0,0,0,0,0,0,34000,12000,22000,22000
20200212,051405,世芯永豐95購01,0.81,0.88,0.74,0.83,-0.02,-2.35,2152000,74,1766790,0,0,0,0,0,0,1794000,353000,1441000,1441000
20200212,051406,泰鼎永豐96購01,1.28,1.41,1.28,1.29,+0.05,4.03,295000,58,403360,0,0,0,0,0,0,47000,236000,-189000,-189000
20200212,051407,南茂永豐95購02,,,,,0.00,0.00,0,0,0,0,0,0,0,0,0,0,0,0,0
20200212,051408,台積電國票95購03,2.30,2.33,2.29,2.33,+0.21,9.91,82000,4,189760,0,0,0,0,0,0,72000,12000,60000,60000
20200212,051409,美律國票96購01,1.46,1.87,1.46,1.87,+0.53,39.55,82000,14,142940,0,0,0,0,0,0,6000,76000,-70000,-70000
20200212,05140P,台表科國票96售01,1.21,1.21,1.13,1.13,-0.21,-15.67,70000,3,82900,0,0,0,0,0,0,0,70000,-70000,-70000
20200212,051410,京元電國票96購01,0.51,0.51,0.51,0.51,+0.01,2.0,5000,1,2550,0,0,0,0,0,0,5000,0,5000,5000
20200212,051411,聯發科國票95購05,0.27,0.28,0.27,0.28,+0.09,47.37,120000,4,32800,0,0,0,0,0,0,120000,0,120000,120000
20200212,051412,奇力新國票96購01,,,,,0.00,0.00,0,0,0,0,0,0,0,0,0,0,0,0,0
20200212,051413,富邦金國票96購02,0.66,0.68,0.66,0.68,+0.09,15.25,164000,3,110380,0,0,0,0,0,0,38000,126000,-88000,-88000
20200212,051414,新光金國票95購04,0.26,0.26,0.26,0.26,-0.01,-3.7,60000,14,15600,0,0,0,0,0,0,60000,0,60000,60000
20200212,051415,晶技國票96購01,1.70,1.76,1.70,1.76,0.00,0.00,24000,6,41770,0,0,0,0,0,0,3000,21000,-18000,-18000
20200212,051416,創意國票96購02,1.26,1.32,1.15,1.26,-0.17,-11.89,204000,24,253840,0,0,0,0,0,0,131000,83000,48000,48000
20200212,051417,揚明光國票96購01,,,,,0.00,0.00,0,0,0,0,0,0,0,0,0,0,0,0,0
20200212,051418,智易國票97購01,0.65,0.73,0.65,0.73,0.00,0.00,39000,2,25430,0,0,0,0,0,0,0,39000,-39000,-39000
20200212,051419,麗豐國票96購01,0.97,1.02,0.97,1.02,+0.08,8.51,129000,6,126330,0,0,0,0,0,0,89000,40000,49000,49000
20200212,05141P,華通台新96售01,1.68,1.68,1.68,1.68,-0.47,-21.86,5000,1,8400,0,0,0,0,0,0,0,5000,-5000,-5000
20200212,051420,康控國票95購05,0.42,0.43,0.42,0.43,+0.06,16.22,171000,3,72070,0,0,0,0,0,0,25000,146000,-121000,-121000
20200212,051421,彩晶國票95購01,1.06,1.06,1.06,1.06,-0.03,-2.75,22000,1,23320,0,0,0,0,0,0,22000,0,22000,22000
20200212,051422,超眾國票96購01,2.46,2.93,2.46,2.93,+0.26,9.74,131000,17,343740,0,0,0,0,0,0,78000,53000,25000,25000
20200212,051423,GIS國票97購01,1.11,1.11,1.11,1.11,+0.07,6.73,38000,1,42180,0,0,0,0,0,0,38000,0,38000,38000
20200212,051424,緯穎國票97購01,11.90,11.90,11.90,11.90,+0.40,3.48,10000,1,119000,0,0,0,0,0,0,10000,0,10000,10000
20200212,051425,昇陽半國票97購01,0.92,0.93,0.88,0.88,+0.01,1.15,131000,6,117670,0,0,0,0,0,0,71000,60000,11000,11000
20200212,051426,道瓊反統一95購02,0.41,0.41,0.41,0.41,0.00,0.00,5000,1,2050,0,0,0,0,0,0,0,5000,-5000,-5000
20200212,051427,聯發科統一95購04,0.54,0.54,0.54,0.54,+0.07,14.89,1000,1,540,0,0,0,0,0,0,1000,0,1000,1000
20200212,051428,玉晶光統一96購01,3.23,3.42,3.23,3.42,+0.34,11.04,55000,8,179930,0,0,0,0,0,0,31000,24000,7000,7000
20200212,051429,智邦元富95購01,1.70,1.83,1.51,1.54,-0.03,-1.91,954000,46,1588710,0,0,0,0,0,0,631000,350000,281000,281000
20200212,05142P,華新科台新95售01,,,,,0.00,0.00,0,0,0,0,0,0,0,0,0,0,0,0,0
20200212,051430,瑞昱元富95購02,2.19,2.28,2.19,2.23,+0.35,18.62,88000,4,198570,0,0,0,0,0,0,3000,88000,-85000,-85000
20200212,051431,群創元富99購02,1.90,1.90,1.84,1.84,+0.04,2.22,340000,34,635300,0,0,0,0,0,0,0,340000,-340000,-340000
20200212,051432,群創元富99購03,,,,,0.00,0.00,0,0,0,0,0,0,0,0,0,0,0,0,0
20200212,051433,中磊元富95購01,1.53,1.54,1.48,1.48,-0.04,-2.63,18000,5,27230,0,0,0,0,0,0,17000,18000,-1000,-1000
20200212,051434,中磊元富95購02,2.80,2.85,2.78,2.78,-0.05,-1.77,42000,8,118750,0,0,0,0,0,0,33000,17000,16000,16000
20200212,051435,聯茂元富95購01,0.92,1.17,0.92,1.03,+0.28,37.33,477000,44,502950,0,0,0,0,0,0,281000,222000,59000,59000
20200212,051436,訊芯元富95購01,0.71,0.71,0.71,0.71,0.00,0.00,10000,1,7100,0,0,0,0,0,0,0,10000,-10000,-10000
20200212,051437,百和元富95購02,,,,,0.00,0.00,0,0,0,0,0,0,0,0,0,0,0,0,0
20200212,051438,喬山元大95購03,1.15,1.27,1.15,1.21,+0.20,19.8,148000,5,176760,0,0,0,0,0,0,0,148000,-148000,-148000
20200212,051439,川湖元大95購01,1.09,1.10,1.03,1.03,-0.04,-3.74,69000,6,72560,0,0,0,0,0,0,15000,54000,-39000,-39000
20200212,05143P,臻鼎台新95售01,0.95,0.95,0.95,0.95,-0.20,-17.39,2000,1,1900,0,0,0,0,0,0,0,2000,-2000,-2000
20200212,051440,鴻海元大95購12,0.20,0.24,0.20,0.24,+0.06,33.33,100000,7,21900,0,0,0,0,0,0,10000,90000,-80000,-80000
20200212,051441,鴻海元大95購13,0.65,0.74,0.65,0.74,+0.18,32.14,140000,7,94400,0,0,0,0,0,0,90000,50000,40000,40000
20200212,051442,正崴元大95購02,0.74,0.75,0.74,0.75,+0.02,2.74,120000,4,89300,0,0,0,0,0,0,70000,50000,20000,20000
20200212,051443,聯發科元大95購10,,,,,0.00,0.00,0,0,0,0,0,0,0,0,0,0,0,0,0
20200212,051444,聯發科元大95購11,0.56,0.58,0.56,0.58,+0.17,41.46,40000,3,22800,0,0,0,0,0,0,30000,10000,20000,20000
20200212,051445,可成元大95購06,0.44,0.54,0.44,0.54,+0.14,35.0,112000,4,52080,0,0,0,0,0,0,0,112000,-112000,-112000
20200212,051446,中壽元大96購01,1.12,1.12,1.12,1.12,+0.03,2.75,155000,3,173600,0,0,0,0,0,0,155000,0,155000,155000
20200212,051447,新光金元大97購01,0.44,0.44,0.44,0.44,+0.01,2.33,1000,1,440,0,0,0,0,0,0,1000,0,1000,1000
20200212,051448,聯詠元大95購02,2.05,2.27,2.05,2.21,+0.33,17.55,233000,15,496900,0,0,0,0,0,0,124000,104000,20000,20000
20200212,051449,玉晶光元大96購01,2.32,2.44,2.32,2.44,+0.22,9.91,3000,3,7180,0,0,0,0,0,0,1000,2000,-1000,-1000
20200212,05144P,美律永豐95售02,0.88,0.88,0.88,0.88,-0.11,-11.11,1000,1,880,0,0,0,0,0,0,1000,0,1000,1000
20200212,051450,世芯元大95購02,2.48,2.70,2.43,2.62,+0.10,3.97,284000,27,729930,0,0,0,0,0,0,186000,104000,82000,82000
20200212,051451,世芯元大95購03,2.01,2.16,1.95,2.03,-0.10,-4.69,649000,45,1323710,0,0,0,0,0,0,572000,67000,505000,505000
20200212,051452,貿聯元大95購04,1.93,2.18,1.93,2.18,+0.26,13.54,170000,13,349730,0,0,0,0,0,0,56000,170000,-114000,-114000
20200212,051453,智伸科元大95購02,1.03,1.03,1.03,1.03,0.00,0.00,38000,1,39140,0,0,0,0,0,0,38000,0,38000,38000
20200212,051454,致伸元大95購01,,,,,0.00,0.00,0,0,0,0,0,0,0,0,0,0,0,0,0
20200212,051455,樺漢元大96購01,0.75,0.79,0.74,0.78,+0.05,6.85,148000,9,112940,0,0,0,0,0,0,110000,8000,102000,102000
20200212,051456,鈺齊元大95購01,1.37,1.56,1.37,1.56,+0.20,14.71,31000,4,45970,0,0,0,0,0,0,11000,20000,-9000,-9000
20200212,051457,寶成元大95購01,0.43,0.46,0.43,0.46,+0.01,2.22,420000,5,192900,0,0,0,0,0,0,419000,1000,418000,418000
20200212,051458,臺股指元大95購18,,,,,0.00,0.00,0,0,0,0,0,0,0,0,0,0,0,0,0
20200212,051459,臺股指元大95購19,1.31,1.45,1.29,1.45,+0.21,16.94,50000,7,69900,0,0,0,0,0,0,18000,32000,-14000,-14000
20200212,05145P,道瓊反元大98售01,,,,,0.00,0.00,0,0,0,0,0,0,0,0,0,0,0,0,0
20200212,051460,S&P反1國泰97購01,,,,,0.00,0.00,0,0,0,0,0,0,0,0,0,0,0,0,0
20200212,051461,聯詠國泰96購01,1.93,2.10,1.93,2.00,+0.18,9.89,96000,9,194010,0,0,0,0,0,0,39000,66000,-27000,-27000
20200212,051462,世芯國泰97購01,2.48,2.70,2.42,2.64,0.00,0.00,539000,50,1361110,0,0,0,0,0,0,428000,99000,329000,329000
20200212,051463,世芯國泰97購02,4.20,4.30,3.90,4.26,+0.06,1.43,511000,44,2119830,0,0,0,0,0,0,407000,99000,308000,308000
20200212,051464,彩晶國泰96購01,,,,,0.00,0.00,0,0,0,0,0,0,0,0,0,0,0,0,0
20200212,051465,鴻海富邦97購02,0.13,0.13,0.13,0.13,+0.03,30.0,1000,1,130,0,0,0,0,0,0,0,1000,-1000,-1000
20200212,051466,玉晶光富邦97購01,1.07,1.09,1.05,1.09,+0.13,13.54,224000,7,242310,0,0,0,0,0,0,80000,143000,-63000,-63000
20200212,051467,GIS富邦96購01,0.23,0.24,0.23,0.24,+0.02,9.09,55000,2,13100,0,0,0,0,0,0,0,55000,-55000,-55000
20200212,051468,智邦日盛95購01,0.66,0.74,0.55,0.58,-0.04,-6.45,175000,25,118960,0,0,0,0,0,0,74000,77000,-3000,-3000
20200212,051469,友達日盛9B購01,,,,,0.00,0.00,0,0,0,0,0,0,0,0,0,0,0,0,0
20200212,05146P,鴻海元大95售10,3.62,3.72,3.34,3.34,-0.58,-14.8,204000,16,734010,0,0,0,0,0,0,204000,204000,0,0
20200212,051470,玉晶光日盛95購01,1.64,1.78,1.63,1.78,+0.23,14.84,629000,33,1058430,0,0,0,0,0,0,155000,474000,-319000,-319000
20200212,051471,國巨凱基97購01,3.40,3.40,3.40,3.40,+0.12,3.66,23000,2,78200,0,0,0,0,0,0,23000,0,23000,23000
20200212,051472,台積電凱基95購09,1.39,1.45,1.39,1.45,+0.08,5.84,162000,5,231300,0,0,0,0,0,0,61000,101000,-40000,-40000
20200212,051473,台積電凱基95購10,0.51,0.54,0.51,0.54,+0.08,17.39,46000,4,24470,0,0,0,0,0,0,41000,0,41000,41000
20200212,051474,智邦凱基95購04,0.67,0.67,0.63,0.63,-0.07,-10.0,32000,3,20960,0,0,0,0,0,0,32000,32000,0,0
20200212,051475,宏碁凱基95購02,,,,,0.00,0.00,0,0,0,0,0,0,0,0,0,0,0,0,0
20200212,051476,聯發科凱基95購09,0.29,0.30,0.29,0.30,+0.09,42.86,30000,2,8800,0,0,0,0,0,0,30000,0,30000,30000
20200212,051477,可成凱基95購07,,,,,0.00,0.00,0,0,0,0,0,0,0,0,0,0,0,0,0
20200212,051478,宏達電凱基95購03,,,,,0.00,0.00,0,0,0,0,0,0,0,0,0,0,0,0,0
20200212,051479,兆豐金凱基95購01,1.16,1.16,1.16,1.16,+0.01,0.87,200000,2,232000,0,0,0,0,0,0,199000,0,199000,199000
20200212,05147P,鴻海元大95售11,3.65,3.67,3.36,3.36,-0.53,-13.62,87000,6,310590,0,0,0,0,0,0,87000,87000,0,0
20200212,051480,大立光凱基97購01,0.59,0.71,0.59,0.71,+0.12,20.34,84000,5,55360,0,0,0,0,0,0,0,84000,-84000,-84000
20200212,051481,聯詠凱基95購02,0.48,0.48,0.48,0.48,+0.03,6.67,22000,2,10560,0,0,0,0,0,0,0,22000,-22000,-22000
20200212,051482,玉晶光凱基96購01,2.41,2.64,1.17,2.62,+0.31,13.42,263000,15,565990,0,0,0,0,0,0,54000,227000,-173000,-173000
20200212,051483,玉晶光凱基96購02,2.27,2.30,2.27,2.30,+0.24,11.65,6000,3,13710,0,0,0,0,0,0,3000,6000,-3000,-3000
20200212,051484,玉晶光凱基97購01,2.25,2.40,2.25,2.40,+0.27,12.68,9000,5,21390,0,0,0,0,0,0,3000,5000,-2000,-2000
20200212,051485,玉晶光凱基97購02,3.23,3.48,3.23,3.48,+0.45,14.85,19000,3,62370,0,0,0,0,0,0,19000,18000,1000,1000
20200212,051486,玉晶光凱基97購03,2.15,2.15,2.14,2.14,+0.28,15.05,23000,3,49350,0,0,0,0,0,0,0,23000,-23000,-23000
20200212,051487,健策凱基96購03,1.63,1.85,1.56,1.85,+0.37,25.0,308000,34,494390,0,0,0,0,0,0,284000,30000,254000,254000
20200212,051488,健策凱基96購04,0.91,1.06,0.89,1.02,+0.14,15.91,828000,55,801350,0,0,0,0,0,0,535000,327000,208000,208000
20200212,051489,世芯凱基95購01,1.90,2.12,0.94,2.03,+0.06,3.05,246000,40,484680,0,0,0,0,0,0,198000,37000,161000,161000
20200212,05148P,臻鼎元大95售01,2.23,2.43,2.23,2.43,0.00,0.00,87000,5,201060,0,0,0,0,0,0,0,87000,-87000,-87000
20200212,051490,世芯凱基96購01,1.98,2.04,1.90,2.02,+0.10,5.21,118000,22,231820,0,0,0,0,0,0,118000,3000,115000,115000
20200212,051491,貿聯凱基95購01,0.62,0.65,0.62,0.65,+0.10,18.18,110000,3,70200,0,0,0,0,0,0,40000,70000,-30000,-30000
20200212,051492,臻鼎凱基95購01,0.50,0.50,0.48,0.48,+0.07,17.07,3000,2,1460,0,0,0,0,0,0,1000,2000,-1000,-1000
20200212,051493,台郡凱基95購02,0.88,0.88,0.85,0.85,+0.41,93.18,80000,7,68800,0,0,0,0,0,0,0,30000,-30000,-30000
20200212,051494,中環兆豐95購01,0.31,0.31,0.31,0.31,-0.02,-6.06,15000,1,4650,0,0,0,0,0,0,0,15000,-15000,-15000
20200212,051495,玉晶光第一95購02,1.48,1.56,1.48,1.54,+0.19,14.07,151000,11,233640,0,0,0,0,0,0,0,151000,-151000,-151000
20200212,051496,義隆亞東95購01,,,,,0.00,0.00,0,0,0,0,0,0,0,0,0,0,0,0,0
20200212,051497,中磊亞東96購01,,,,,0.00,0.00,0,0,0,0,0,0,0,0,0,0,0,0,0
20200212,051498,智易群益96購01,,,,,0.00,0.00,0,0,0,0,0,0,0,0,0,0,0,0,0
20200212,051499,康控群益95購02,0.38,0.41,0.37,0.41,+0.06,17.14,866000,16,341830,0,0,0,0,0,0,499000,367000,132000,132000
20200212,05149P,緯穎國泰96售01,0.39,0.39,0.35,0.35,-0.05,-12.5,7000,2,2650,0,0,0,0,0,0,2000,5000,-3000,-3000
20200212,051500,聯茂群益95購01,0.77,1.13,0.77,1.00,+0.30,42.86,339000,40,334040,0,0,0,0,0,0,40000,269000,-229000,-229000
20200212,051501,康友群益95購02,2.48,2.67,2.46,2.51,+0.02,0.8,345000,15,869970,0,0,0,0,0,0,25000,320000,-295000,-295000
20200212,051502,南茂群益95購01,,,,,0.00,0.00,0,0,0,0,0,0,0,0,0,0,0,0,0
20200212,051503,玉晶光統一97購01,4.92,5.00,4.81,5.00,+0.35,7.53,52000,8,256470,0,0,0,0,0,0,22000,30000,-8000,-8000
20200212,051504,TPK統一95購01,,,,,0.00,0.00,0,0,0,0,0,0,0,0,0,0,0,0,0
20200212,051505,台積電元富95購05,1.91,1.99,1.85,1.96,+0.16,8.89,5911000,71,11284950,0,0,0,0,0,0,3683000,3021000,662000,662000
20200212,051506,台積電元富95購06,1.69,1.78,1.65,1.75,+0.16,10.06,1495000,40,2516550,0,0,0,0,0,0,793000,756000,37000,37000
20200212,051507,彩晶元富95購01,0.75,0.75,0.74,0.74,+0.01,1.37,920000,9,687850,0,0,0,0,0,0,805000,115000,690000,690000
20200212,051508,元黃金中信97購01,,,,,0.00,0.00,0,0,0,0,0,0,0,0,0,0,0,0,0
20200212,051509,鴻海中信97購01,0.19,0.19,0.19,0.19,+0.02,11.76,30000,1,5700,0,0,0,0,0,0,30000,0,30000,30000
20200212,05150P,玉晶光第一95售01,,,,,0.00,0.00,0,0,0,0,0,0,0,0,0,0,0,0,0
20200212,051510,新光金中信97購01,,,,,0.00,0.00,0,0,0,0,0,0,0,0,0,0,0,0,0
20200212,051511,鈺齊中信97購01,0.51,0.59,0.51,0.59,+0.08,15.69,372000,9,197770,0,0,0,0,0,0,152000,220000,-68000,-68000
20200212,051512,超眾麥證95購01,1.32,1.46,1.29,1.46,+0.10,7.35,391000,24,516570,361000,30000,331000,0,0,0,361000,30000,331000,331000
20200212,051513,台積電凱基95購13,1.11,1.11,1.11,1.11,+0.14,14.43,1000,1,1110,0,0,0,0,0,0,1000,0,1000,1000
20200212,051514,智邦凱基95購05,0.48,0.52,0.42,0.44,+0.01,2.33,264000,5,116800,0,0,0,0,0,0,152000,112000,40000,40000
20200212,051515,聯發科凱基95購10,0.42,0.42,0.42,0.42,+0.11,35.48,22000,1,9240,0,0,0,0,0,0,22000,0,22000,22000
20200212,051516,全新凱基96購02,0.46,0.51,0.15,0.51,+0.11,27.5,512000,4,232470,0,0,0,0,0,0,500000,12000,488000,488000
20200212,051517,可成凱基95購08,,,,,0.00,0.00,0,0,0,0,0,0,0,0,0,0,0,0,0
20200212,051518,富邦金凱基95購01,1.34,1.34,1.34,1.34,+0.20,17.54,10000,1,13400,0,0,0,0,0,0,0,10000,-10000,-10000
20200212,051519,國泰金凱基95購02,1.33,1.38,1.29,1.38,+0.10,7.81,28000,10,37440,0,0,0,0,0,0,18000,10000,8000,8000
20200212,05151P,台光電群益95售02,1.51,1.51,1.32,1.32,-0.32,-19.51,14000,8,19340,0,0,0,0,0,0,6000,8000,-2000,-2000
20200212,051520,新光金凱基97購01,0.30,0.30,0.29,0.30,-0.01,-3.23,465000,39,137950,0,0,0,0,0,0,165000,300000,-135000,-135000
20200212,051521,大立光凱基96購07,0.92,0.92,0.92,0.92,0.00,0.00,58000,1,53360,0,0,0,0,0,0,58000,0,58000,58000
20200212,051522,玉晶光凱基95購05,1.86,2.07,1.86,2.07,+0.36,21.05,32000,3,65940,0,0,0,0,0,0,32000,0,32000,32000
20200212,051523,牧德凱基95購02,3.30,3.30,3.23,3.23,+0.07,2.22,20000,5,65710,0,0,0,0,0,0,13000,7000,6000,6000
20200212,051524,貿聯凱基95購02,0.78,0.90,0.78,0.90,+0.12,15.38,48000,9,37730,0,0,0,0,0,0,48000,0,48000,48000
20200212,051525,日月光凱基95購02,0.43,0.47,0.43,0.47,+0.08,20.51,12000,3,5200,0,0,0,0,0,0,1000,11000,-10000,-10000
20200212,051526,超眾凱基95購02,1.47,1.69,1.20,1.66,+0.14,9.21,317000,38,482490,0,0,0,0,0,0,253000,114000,139000,139000
20200212,051527,台郡凱基95購03,0.62,0.62,0.62,0.62,+0.35,129.63,6000,6,3720,0,0,0,0,0,0,6000,0,6000,6000
20200212,051528,亞泥國票96購01,1.43,1.43,1.43,1.43,+0.07,5.15,40000,2,57200,0,0,0,0,0,0,40000,0,40000,40000
20200212,051529,東元國票96購01,1.15,1.15,1.15,1.15,+0.03,2.68,20000,1,23000,0,0,0,0,0,0,20000,0,20000,20000
20200212,05152P,玉晶光群益96售05,0.98,0.98,0.98,0.98,-0.08,-7.55,20000,1,19600,0,0,0,0,0,0,20000,0,20000,20000
20200212,051530,鴻海國票97購01,0.14,0.16,0.14,0.16,+0.02,14.29,252000,15,37130,0,0,0,0,0,0,0,0,0,0
20200212,051531,國巨國票96購04,,,,,0.00,0.00,0,0,0,0,0,0,0,0,0,0,0,0,0
20200212,051532,潤泰全國票96購01,0.67,0.67,0.66,0.66,0.00,0.00,40000,2,26600,0,0,0,0,0,0,0,40000,-40000,-40000
20200212,051533,健鼎國票96購02,0.38,0.60,0.38,0.60,+0.28,87.5,548000,22,235360,0,0,0,0,0,0,330000,218000,112000,112000
20200212,051534,景碩國票97購01,2.36,2.83,2.33,2.81,+0.40,16.6,262000,35,654620,0,0,0,0,0,0,144000,118000,26000,26000
20200212,051535,新日興國票96購01,2.21,2.38,2.15,2.15,-0.38,-15.02,26000,9,57630,0,0,0,0,0,0,12000,14000,-2000,-2000
20200212,051536,玉晶光國票97購01,5.15,5.65,5.15,5.65,+0.66,13.23,39000,6,216250,0,0,0,0,0,0,36000,31000,5000,5000
20200212,051537,牧德國票96購01,10.60,10.80,10.50,10.70,+0.40,3.88,66000,7,700800,0,0,0,0,0,0,56000,10000,46000,46000
20200212,051538,和碩國票96購01,0.30,0.30,0.30,0.30,0.00,0.00,20000,1,6000,0,0,0,0,0,0,0,20000,-20000,-20000
20200212,051539,瀚宇博國票97購01,0.64,0.68,0.64,0.68,+0.09,15.25,39000,2,25720,0,0,0,0,0,0,19000,20000,-1000,-1000
20200212,05153P,台表科群益96售01,,,,,0.00,0.00,0,0,0,0,0,0,0,0,0,0,0,0,0
20200212,051540,力成國票95購01,3.50,3.89,3.50,3.89,+0.70,21.94,251000,11,909090,0,0,0,0,0,0,0,251000,-251000,-251000
20200212,051541,GIS國票96購02,0.89,0.95,0.89,0.95,0.00,0.00,148000,5,132020,0,0,0,0,0,0,0,148000,-148000,-148000
20200212,051542,南茂國票96購01,,,,,0.00,0.00,0,0,0,0,0,0,0,0,0,0,0,0,0
20200212,051543,鈺齊國票96購01,0.82,1.00,0.82,1.00,+0.14,16.28,468000,8,431100,0,0,0,0,0,0,48000,420000,-372000,-372000
20200212,051544,T50反1康和98購01,,,,,0.00,0.00,0,0,0,0,0,0,0,0,0,0,0,0,0
20200212,051545,裕隆康和95購01,0.48,0.55,0.48,0.54,+0.08,17.39,549000,18,276030,0,0,0,0,0,0,407000,142000,265000,265000
20200212,051546,慧洋康和95購01,0.26,0.26,0.26,0.26,0.00,0.00,10000,1,2600,0,0,0,0,0,0,10000,0,10000,10000
20200212,051547,健鼎康和95購01,0.27,0.31,0.27,0.31,+0.10,47.62,330000,6,93900,0,0,0,0,0,0,0,330000,-330000,-330000
20200212,051548,鈺齊康和95購01,0.54,0.54,0.54,0.54,+0.06,12.5,68000,1,36720,0,0,0,0,0,0,68000,0,68000,68000
20200212,051549,健鼎永豐95購01,0.28,0.28,0.28,0.28,0.00,0.00,60000,1,16800,0,0,0,0,0,0,0,60000,-60000,-60000
20200212,05154P,台積電兆豐95售05,0.36,0.36,0.34,0.34,-0.05,-12.82,140000,7,50000,0,0,0,0,0,0,20000,120000,-100000,-100000
20200212,051550,日電貿永豐95購01,1.71,1.73,1.61,1.72,+0.07,4.24,380000,33,650370,0,0,0,0,0,0,335000,45000,290000,290000
20200212,051551,新日興永豐95購01,0.58,0.58,0.55,0.57,-0.04,-6.56,356000,16,204340,0,0,0,0,0,0,335000,20000,315000,315000
20200212,051552,牧德永豐95購03,,,,,0.00,0.00,0,0,0,0,0,0,0,0,0,0,0,0,0
20200212,051553,牧德永豐96購02,3.50,3.61,3.45,3.52,+0.06,1.73,62000,10,218540,0,0,0,0,0,0,34000,28000,6000,6000
20200212,051554,鎧勝永豐95購01,,,,,0.00,0.00,0,0,0,0,0,0,0,0,0,0,0,0,0
20200212,051555,聯茂永豐95購01,0.38,0.50,0.38,0.50,0.00,0.00,117000,5,53640,0,0,0,0,0,0,0,117000,-117000,-117000
20200212,051556,台表科永豐96購01,0.63,0.69,0.63,0.69,+0.05,7.81,227000,8,148730,0,0,0,0,0,0,62000,183000,-121000,-121000
20200212,051557,昇陽半永豐96購01,,,,,0.00,0.00,0,0,0,0,0,0,0,0,0,0,0,0,0
20200212,051558,元金2X國泰97購01,2.59,2.59,2.57,2.59,-0.05,-1.89,65000,5,168250,0,0,0,0,0,0,65000,0,65000,65000
20200212,051559,宏達電國泰96購01,0.87,0.87,0.87,0.87,+0.07,8.75,1000,1,870,0,0,0,0,0,0,1000,0,1000,1000
20200212,05155P,聯發科兆豐95售03,0.98,0.98,0.96,0.96,-0.20,-17.24,25000,2,24100,0,0,0,0,0,0,20000,5000,15000,15000
20200212,051560,玉晶光國泰97購03,3.30,3.53,3.23,3.44,+0.28,8.86,658000,37,2206870,0,0,0,0,0,0,508000,251000,257000,257000
20200212,051561,玉晶光國泰97購04,,,,,0.00,0.00,0,0,0,0,0,0,0,0,0,0,0,0,0
20200212,051562,玉晶光國泰97購05,2.51,2.62,2.46,2.62,+0.24,10.08,165000,15,413460,0,0,0,0,0,0,144000,21000,123000,123000
20200212,051563,泰鼎國泰96購01,3.06,3.27,3.00,3.00,+0.02,0.67,170000,46,538440,0,0,0,0,0,0,20000,150000,-130000,-130000
20200212,051564,和碩國泰96購01,1.45,1.45,1.39,1.39,-0.12,-7.95,27000,3,38730,0,0,0,0,0,0,27000,0,27000,27000
20200212,051565,玉晶光永昌96購01,,,,,0.00,0.00,0,0,0,0,0,0,0,0,0,0,0,0,0
20200212,051566,鴻海富邦95購05,,,,,0.00,0.00,0,0,0,0,0,0,0,0,0,0,0,0,0
20200212,051567,台積電富邦95購06,0.96,1.07,0.96,1.07,+0.13,13.83,270000,7,270570,0,0,0,0,0,0,269000,51000,218000,218000
20200212,051568,智邦富邦95購01,0.45,0.49,0.40,0.40,-0.01,-2.44,345000,26,151710,0,0,0,0,0,0,203000,133000,70000,70000
20200212,051569,緯創富邦95購02,0.27,0.27,0.27,0.27,0.00,0.00,38000,1,10260,0,0,0,0,0,0,0,38000,-38000,-38000
20200212,05156P,群創兆豐95售01,,,,,0.00,0.00,0,0,0,0,0,0,0,0,0,0,0,0,0
20200212,051570,和碩富邦97購01,0.63,0.69,0.62,0.66,-0.01,-1.49,857000,27,560400,0,0,0,0,0,0,695000,147000,548000,548000
20200212,051571,南茂富邦95購01,,,,,0.00,0.00,0,0,0,0,0,0,0,0,0,0,0,0,0
20200212,051572,上銀元大95購01,4.12,4.12,3.90,3.96,+0.13,3.39,181000,35,729440,0,0,0,0,0,0,130000,99000,31000,31000
20200212,051573,鴻海元大95購15,0.18,0.24,0.18,0.24,+0.07,41.18,551000,11,108640,0,10000,-10000,0,0,0,523000,28000,495000,485000
20200212,051574,鴻海元大96購06,0.20,0.23,0.20,0.23,0.00,0.00,648000,4,136060,0,0,0,0,0,0,648000,0,648000,648000
20200212,051575,國巨元大96購03,4.47,4.52,4.24,4.52,+0.29,6.86,226000,30,990290,0,0,0,0,0,0,218000,188000,30000,30000
20200212,051576,台積電元大97購02,3.99,4.03,3.94,4.03,+0.19,4.95,69000,18,274810,0,0,0,0,0,0,69000,69000,0,0
20200212,051577,台積電元大97購03,4.23,4.27,4.19,4.27,+0.18,4.4,137000,15,579590,0,0,0,0,0,0,137000,52000,85000,85000
20200212,051578,智邦元大96購01,1.80,1.89,1.56,1.67,+0.07,4.38,196000,24,332110,0,0,0,0,0,0,83000,135000,-52000,-52000
20200212,051579,宏碁元大95購01,0.48,0.50,0.48,0.50,+0.03,6.38,127000,13,62900,0,0,0,0,0,0,26000,52000,-26000,-26000
20200212,05157P,全新台新96售01,1.61,1.61,1.44,1.47,-0.33,-18.33,120000,10,188960,0,0,0,0,0,0,0,120000,-120000,-120000
20200212,051580,宏碁元大95購02,0.87,0.91,0.87,0.89,+0.04,4.71,113000,9,101630,0,0,0,0,0,0,108000,55000,53000,53000
20200212,051581,聯發科元大95購12,0.77,0.89,0.77,0.84,+0.18,27.27,128000,5,104420,0,0,0,0,0,0,60000,68000,-8000,-8000
20200212,051582,聯發科元大97購02,1.71,1.87,1.69,1.87,+0.33,21.43,558000,48,1001490,0,0,0,0,0,0,405000,350000,55000,55000
20200212,051583,可成元大95購07,0.33,0.35,0.33,0.35,+0.09,34.62,10000,3,3320,0,0,0,0,0,0,10000,0,10000,10000
20200212,051584,可成元大95購08,0.39,0.46,0.39,0.46,+0.09,24.32,100000,7,42100,0,0,0,0,0,0,50000,50000,0,0
20200212,051585,美食元大95購01,0.23,0.30,0.23,0.26,+0.06,30.0,1033000,13,260330,0,0,0,0,0,0,877000,154000,723000,723000
20200212,051586,國泰金元大96購01,0.85,0.87,0.84,0.87,+0.04,4.82,233000,4,199290,0,0,0,0,0,0,69000,164000,-95000,-95000
20200212,051587,大立光元大95購08,1.25,1.25,1.25,1.25,0.00,0.00,68000,1,85000,0,0,0,0,0,0,0,68000,-68000,-68000
20200212,051588,聯詠元大95購03,1.97,2.07,1.97,2.07,+0.21,11.29,15000,3,30550,0,0,0,0,0,0,15000,0,15000,15000
20200212,051589,健鼎元大95購02,0.66,0.97,0.66,0.97,+0.43,79.63,514000,11,458570,0,0,0,0,0,0,0,514000,-514000,-514000
20200212,05158P,華通永豐95售01,,,,,0.00,0.00,0,0,0,0,0,0,0,0,0,0,0,0,0
20200212,051590,玉晶光元大96購02,3.95,4.22,3.87,4.13,+0.41,11.02,161000,25,645070,0,0,0,0,0,0,43000,119000,-76000,-76000
20200212,051591,玉晶光元大97購01,1.94,2.05,1.89,2.01,+0.17,9.24,238000,29,466210,0,0,0,0,0,0,154000,111000,43000,43000
20200212,051592,健策元大96購05,1.71,1.84,1.62,1.82,+0.22,13.75,662000,69,1146900,0,0,0,0,0,0,313000,493000,-180000,-180000
20200212,051593,和碩元大95購01,,,,,0.00,0.00,0,0,0,0,0,0,0,0,0,0,0,0,0
20200212,051594,和碩元大96購01,1.59,1.71,1.54,1.71,+0.03,1.79,37000,3,59690,0,0,0,0,0,0,24000,13000,11000,11000
20200212,051595,康控元大95購04,0.10,0.10,0.10,0.10,0.00,0.00,100000,1,10000,0,0,0,0,0,0,100000,0,100000,100000
20200212,051596,超眾元大95購05,1.35,1.52,1.35,1.52,+0.10,7.04,241000,27,341180,0,0,0,0,0,0,231000,96000,135000,135000
20200212,051597,T50反1中信99購02,1.40,1.40,1.36,1.36,-0.09,-6.21,180000,8,248250,0,0,0,0,0,0,0,180000,-180000,-180000
20200212,051598,瑞昱兆豐95購01,1.04,1.11,1.04,1.07,+0.09,9.18,258000,8,277940,0,0,0,0,0,0,236000,22000,214000,214000
20200212,051599,健鼎兆豐95購02,0.14,0.16,0.14,0.16,0.00,0.00,391000,9,58060,0,0,0,0,0,0,0,391000,-391000,-391000
20200212,05159P,聯發科永豐95售04,0.86,0.86,0.86,0.86,-0.23,-21.1,8000,1,6880,0,0,0,0,0,0,8000,0,8000,8000
20200212,051600,新日興兆豐96購02,1.72,1.78,1.68,1.72,-0.03,-1.71,512000,29,884450,0,0,0,0,0,0,397000,115000,282000,282000
20200212,051601,群創兆豐95購02,,,,,0.00,0.00,0,0,0,0,0,0,0,0,0,0,0,0,0
20200212,051602,南茂兆豐96購01,0.53,0.56,0.53,0.55,-0.01,-1.79,367000,8,200110,0,0,0,0,0,0,147000,220000,-73000,-73000
20200212,051603,深中小群益99購03,1.56,1.63,1.54,1.63,+0.12,7.95,893000,13,1421190,0,0,0,0,0,0,403000,590000,-187000,-187000
20200212,051604,喬山群益95購01,0.81,0.85,0.81,0.85,+0.17,25.0,182000,3,148500,0,0,0,0,0,0,0,182000,-182000,-182000
20200212,051605,奇力新群益95購02,,,,,0.00,0.00,0,0,0,0,0,0,0,0,0,0,0,0,0
20200212,051606,華新科群益95購05,,,,,0.00,0.00,0,0,0,0,0,0,0,0,0,0,0,0,0
20200212,051607,緯創群益96購02,,,,,0.00,0.00,0,0,0,0,0,0,0,0,0,0,0,0,0
20200212,051608,新日興群益96購01,3.22,3.22,3.12,3.12,-0.22,-6.59,22000,3,70240,0,0,0,0,0,0,20000,2000,18000,18000
20200212,051609,貿聯群益95購03,0.73,0.79,0.72,0.79,+0.14,21.54,221000,6,163830,0,0,0,0,0,0,0,221000,-221000,-221000
20200212,05160P,國巨國票96售03,0.50,0.50,0.50,0.50,-0.07,-12.28,20000,1,10000,0,0,0,0,0,0,0,20000,-20000,-20000
20200212,051610,GIS群益95購02,0.54,0.55,0.54,0.55,0.00,0.00,30000,5,16300,0,0,0,0,0,0,0,30000,-30000,-30000
20200212,051611,鈺齊群益95購02,0.94,1.09,0.94,1.09,+0.12,12.37,215000,9,216800,0,0,0,0,0,0,175000,40000,135000,135000
20200212,051612,緯創日盛95購01,,,,,0.00,0.00,0,0,0,0,0,0,0,0,0,0,0,0,0
20200212,051613,S&P反1凱基96購01,,,,,0.00,0.00,0,0,0,0,0,0,0,0,0,0,0,0,0
20200212,051614,元金2X凱基97購01,0.57,0.61,0.56,0.57,-0.06,-9.52,268000,8,152700,0,0,0,0,0,0,0,267000,-267000,-267000
20200212,051615,華通凱基96購01,0.43,0.43,0.43,0.43,+0.16,59.26,2000,1,860,0,0,0,0,0,0,2000,0,2000,2000
20200212,051616,鴻海凱基96購08,0.27,0.36,0.27,0.36,+0.12,50.0,45000,5,14550,0,0,0,0,0,0,5000,40000,-35000,-35000
20200212,051617,台積電凱基95購14,0.42,0.44,0.42,0.44,+0.08,22.22,47000,2,20200,0,0,0,0,0,0,47000,0,47000,47000
20200212,051618,智邦凱基95購06,1.48,1.54,1.26,1.36,+0.11,8.8,277000,42,388460,0,0,0,0,0,0,142000,225000,-83000,-83000
20200212,051619,智邦凱基95購07,1.27,1.46,1.06,1.10,+0.01,0.92,93000,15,105900,0,0,0,0,0,0,78000,37000,41000,41000
20200212,05161P,華新科國票96售01,0.43,0.43,0.43,0.43,0.00,0.00,10000,1,4300,0,0,0,0,0,0,0,10000,-10000,-10000
20200212,051620,可成凱基95購10,,,,,0.00,0.00,0,0,0,0,0,0,0,0,0,0,0,0,0
20200212,051621,欣興凱基95購02,0.63,0.72,0.63,0.72,+0.19,35.85,61000,2,43830,0,0,0,0,0,0,1000,60000,-59000,-59000
20200212,051622,和碩凱基96購01,,,,,0.00,0.00,0,0,0,0,0,0,0,0,0,0,0,0,0
20200212,051623,和碩凱基96購02,1.35,1.47,1.35,1.47,-0.02,-1.34,131000,5,180370,0,0,0,0,0,0,10000,121000,-111000,-111000
20200212,051624,智邦麥證95購02,1.99,2.16,1.78,1.86,+0.04,2.2,223000,19,448410,167000,40000,127000,0,0,0,167000,40000,127000,127000
20200212,051625,聯發科麥證95購01,0.75,0.82,0.75,0.82,+0.13,18.84,30000,3,23500,20000,10000,10000,0,0,0,20000,10000,10000,10000
20200212,051626,可成麥證95購02,,,,,0.00,0.00,0,0,0,0,0,0,0,0,0,0,0,0,0
20200212,051627,華新科麥證95購03,,,,,0.00,0.00,0,0,0,0,0,0,0,0,0,0,0,0,0
20200212,051628,瀚宇博麥證95購01,,,,,0.00,0.00,0,0,0,0,0,0,0,0,0,0,0,0,0
20200212,051629,上証2X國票95購04,,,,,0.00,0.00,0,0,0,0,0,0,0,0,0,0,0,0,0
20200212,05162P,玉晶光國票96售03,0.96,0.98,0.95,0.98,-0.16,-14.04,429000,7,414420,0,0,0,0,0,0,200000,229000,-29000,-29000
20200212,051630,力山國票96購01,,,,,0.00,0.00,0,0,0,0,0,0,0,0,0,0,0,0,0
20200212,051631,國巨國票96購06,,,,,0.00,0.00,0,0,0,0,0,0,0,0,0,0,0,0,0
20200212,051632,全新國票96購01,0.68,0.68,0.68,0.68,+0.18,36.0,38000,1,25840,0,0,0,0,0,0,38000,0,38000,38000
20200212,051633,可成國票96購03,1.11,1.24,1.07,1.24,+0.21,20.39,321000,23,359280,0,0,0,0,0,0,92000,256000,-164000,-164000
20200212,051634,大立光國票96購03,1.67,1.87,1.67,1.86,+0.33,21.57,264000,15,464960,0,0,0,0,0,0,143000,121000,22000,22000
20200212,051635,大立光國票96購04,,,,,0.00,0.00,0,0,0,0,0,0,0,0,0,0,0,0,0
20200212,051636,嘉晶國票95購02,0.92,1.05,0.92,0.99,+0.11,12.5,100000,13,100010,0,0,0,0,0,0,10000,90000,-80000,-80000
20200212,051637,嘉聯益國票96購01,1.11,1.11,1.11,1.11,+0.12,12.12,19000,1,21090,0,0,0,0,0,0,19000,19000,0,0
20200212,051638,聯茂國票96購01,1.21,1.73,1.21,1.47,+0.45,44.12,287000,23,434600,0,0,0,0,0,0,60000,227000,-167000,-167000
20200212,051639,康友國票96購02,3.21,3.44,3.21,3.25,+0.02,0.62,357000,28,1194110,0,0,0,0,0,0,174000,227000,-53000,-53000
20200212,05163P,聯發科統一96售02,1.12,1.12,1.01,1.01,-0.23,-18.55,663000,27,699970,0,0,0,0,0,0,278000,380000,-102000,-102000
20200212,051640,GIS國票96購03,0.86,0.91,0.86,0.91,+0.08,9.64,284000,11,249830,0,0,0,0,0,0,0,284000,-284000,-284000
20200212,051641,矽創國票96購01,1.72,2.11,1.72,2.11,+0.37,21.26,81000,8,147510,0,0,0,0,0,0,81000,0,81000,81000
20200212,051642,鈺齊台新95購01,0.74,0.78,0.74,0.78,+0.13,20.0,197000,5,149690,0,0,0,0,0,0,0,197000,-197000,-197000
20200212,051643,瑞昱康和95購01,1.12,1.22,1.12,1.16,+0.08,7.41,159000,9,185040,0,0,0,0,0,0,7000,152000,-145000,-145000
20200212,051644,聯茂康和95購01,0.66,0.76,0.66,0.76,0.00,0.00,357000,15,259080,0,0,0,0,0,0,0,357000,-357000,-357000
20200212,051645,光寶科永豐95購01,0.87,0.89,0.87,0.88,-0.02,-2.22,225000,9,198640,0,0,0,0,0,0,90000,135000,-45000,-45000
20200212,051646,華通永豐96購01,0.34,0.34,0.34,0.34,+0.13,61.9,5000,1,1700,0,0,0,0,0,0,5000,0,5000,5000
20200212,051647,華新科永豐95購02,3.04,3.09,3.01,3.08,+0.05,1.65,233000,17,712650,0,0,0,0,0,0,170000,103000,67000,67000
20200212,051648,TPK永豐95購01,0.35,0.35,0.35,0.35,0.00,0.00,150000,1,52500,0,0,0,0,0,0,0,150000,-150000,-150000
20200212,051649,中磊永豐95購02,0.53,0.55,0.53,0.55,+0.01,1.85,47000,5,25380,0,0,0,0,0,0,43000,4000,39000,39000
20200212,05164P,南亞科元富95售04,,,,,0.00,0.00,0,0,0,0,0,0,0,0,0,0,0,0,0
20200212,051650,矽力永豐95購01,1.14,1.14,1.14,1.14,+0.15,15.15,27000,2,30780,0,0,0,0,0,0,0,27000,-27000,-27000
20200212,051651,易華電永豐95購01,,,,,0.00,0.00,0,0,0,0,0,0,0,0,0,0,0,0,0
20200212,051652,昇陽半永豐96購02,,,,,0.00,0.00,0,0,0,0,0,0,0,0,0,0,0,0,0
20200212,051653,南電永豐95購02,,,,,0.00,0.00,0,0,0,0,0,0,0,0,0,0,0,0,0
20200212,051654,致新永豐95購01,0.45,0.47,0.44,0.47,0.00,0.00,400000,20,179740,0,0,0,0,0,0,397000,3000,394000,394000
20200212,051655,欣興元富95購04,0.86,1.10,0.84,1.10,+0.35,46.67,471000,21,426300,0,0,0,0,0,0,94000,377000,-283000,-283000
20200212,051656,嘉聯益元富95購02,0.43,0.43,0.43,0.43,+0.07,19.44,10000,2,4300,0,0,0,0,0,0,0,10000,-10000,-10000
20200212,051657,台郡元富98購01,1.01,1.12,0.98,1.09,+0.38,53.52,535000,56,540890,0,0,0,0,0,0,398000,97000,301000,301000
20200212,051658,深中小國泰97購01,,,,,0.00,0.00,0,0,0,0,0,0,0,0,0,0,0,0,0
20200212,051659,力山國泰97購01,,,,,0.00,0.00,0,0,0,0,0,0,0,0,0,0,0,0,0
20200212,05165P,欣興元富95售03,3.70,3.70,3.13,3.13,-0.72,-18.7,78000,3,258950,0,0,0,0,0,0,23000,55000,-32000,-32000
20200212,051660,緯穎國泰96購02,,,,,0.00,0.00,0,0,0,0,0,0,0,0,0,0,0,0,0
20200212,051661,華新科永昌96購01,5.55,5.55,5.55,5.55,+0.10,1.83,1000,1,5550,0,0,0,0,0,0,1000,0,1000,1000
20200212,051662,大立光永昌96購03,2.13,2.26,2.13,2.26,+0.23,11.33,205000,4,451150,0,0,0,0,0,0,205000,200000,5000,5000
20200212,051663,鴻海元大95購18,0.51,0.55,0.51,0.55,+0.13,30.95,50000,5,26500,0,0,0,0,0,0,0,50000,-50000,-50000
20200212,051664,鴻海元大96購07,0.67,0.73,0.67,0.73,+0.12,19.67,15000,3,10500,0,0,0,0,0,0,15000,0,15000,15000
20200212,051665,台積電元大96購07,2.13,2.19,2.11,2.19,+0.13,6.31,63000,4,136970,0,0,0,0,0,0,63000,10000,53000,53000
20200212,051666,旺宏元大96購05,,,,,0.00,0.00,0,0,0,0,0,0,0,0,0,0,0,0,0
20200212,051667,光磊元大96購02,1.00,1.01,0.99,0.99,-0.01,-1.0,1860000,26,1856330,0,0,0,0,0,0,920000,1161000,-241000,-241000
20200212,051668,智邦元大95購02,1.39,1.47,1.22,1.30,+0.05,4.0,300000,41,399370,0,0,0,0,0,0,267000,176000,91000,91000
20200212,051669,建準元大95購01,1.38,1.38,1.38,1.38,+0.01,0.73,4000,1,5520,0,0,0,0,0,0,0,4000,-4000,-4000
20200212,05166P,中磊元富95售03,,,,,0.00,0.00,0,0,0,0,0,0,0,0,0,0,0,0,0
20200212,051670,欣興元大95購06,0.73,0.97,0.70,0.97,+0.25,34.72,375000,35,310200,0,0,0,0,0,0,274000,132000,142000,142000
20200212,051671,和鑫元大96購02,0.68,0.70,0.68,0.70,+0.04,6.06,243000,6,168070,0,0,0,0,0,0,35000,208000,-173000,-173000
20200212,051672,玉晶光元大96購03,3.41,3.60,3.41,3.60,+0.33,10.09,4000,4,14130,0,0,0,0,0,0,1000,3000,-2000,-2000
20200212,051673,玉晶光元大96購04,2.16,2.30,2.10,2.25,+0.21,10.29,362000,46,795680,0,0,0,0,0,0,184000,212000,-28000,-28000
20200212,051674,臻鼎元大95購02,0.46,0.57,0.39,0.39,+0.04,11.43,86000,9,40250,0,0,0,0,0,0,8000,78000,-70000,-70000
20200212,051675,瑞儀元大96購02,,,,,0.00,0.00,0,0,0,0,0,0,0,0,0,0,0,0,0
20200212,051676,康舒元大95購01,1.59,1.62,1.59,1.62,0.00,0.00,136000,5,219470,0,0,0,0,0,0,62000,136000,-74000,-74000
20200212,051677,達方元大95購01,1.46,1.51,1.46,1.48,+0.06,4.23,333000,7,495860,0,0,0,0,0,0,317000,100000,217000,217000
20200212,051678,鈺齊元大95購02,0.90,1.05,0.90,1.05,+0.18,20.69,223000,7,228000,0,0,0,0,0,0,1000,222000,-221000,-221000
20200212,051679,百和元大95購02,,,,,0.00,0.00,0,0,0,0,0,0,0,0,0,0,0,0,0
20200212,05167P,百和元富95售03,0.54,0.54,0.54,0.54,0.00,0.00,60000,1,32400,0,0,0,0,0,0,60000,0,60000,60000
20200212,051680,國泰金第一95購01,0.46,0.46,0.44,0.45,-0.01,-2.17,196000,24,88640,0,0,0,0,0,0,196000,0,196000,196000
20200212,051681,日月光兆豐95購01,0.54,0.59,0.53,0.59,+0.10,20.41,55000,4,31580,0,0,0,0,0,0,10000,45000,-35000,-35000
20200212,051682,元黃金凱基97購01,,,,,0.00,0.00,0,0,0,0,0,0,0,0,0,0,0,0,0
20200212,051683,A50正2凱基97購01,0.23,0.23,0.23,0.23,-0.01,-4.17,30000,1,6900,0,0,0,0,0,0,0,30000,-30000,-30000
20200212,051684,瑞昱凱基95購02,2.50,2.82,2.50,2.71,+0.23,9.27,177000,18,478280,0,0,0,0,0,0,145000,44000,101000,101000
20200212,051685,台光電凱基95購01,0.50,0.54,0.50,0.54,+0.15,38.46,37000,8,19040,0,0,0,0,0,0,10000,27000,-17000,-17000
20200212,051686,宏達電凱基95購04,,,,,0.00,0.00,0,0,0,0,0,0,0,0,0,0,0,0,0
20200212,051687,大立光凱基95購12,0.76,0.80,0.76,0.80,+0.14,21.21,107000,5,83600,0,0,0,0,0,0,105000,2000,103000,103000
20200212,051688,大立光凱基97購02,1.26,1.38,1.26,1.37,+0.12,9.6,14000,6,18880,0,0,0,0,0,0,11000,5000,6000,6000
20200212,051689,智易凱基95購02,,,,,0.00,0.00,0,0,0,0,0,0,0,0,0,0,0,0,0
20200212,05168P,鴻海元大95售14,2.26,2.26,2.26,2.26,-0.19,-7.76,1000,1,2260,0,0,0,0,0,0,1000,0,1000,1000
20200212,051690,超眾凱基95購03,0.87,1.00,0.87,1.00,+0.10,11.11,93000,19,83760,0,0,0,0,0,0,81000,12000,69000,69000
20200212,051691,台表科凱基95購01,1.09,1.23,1.09,1.23,+0.11,9.82,90000,7,107800,0,0,0,0,0,0,10000,90000,-80000,-80000
20200212,051692,深中小統一95購01,1.67,1.67,1.67,1.67,+0.15,9.87,160000,1,267200,0,0,0,0,0,0,160000,0,160000,160000
20200212,051693,華新科統一95購02,,,,,0.00,0.00,0,0,0,0,0,0,0,0,0,0,0,0,0
20200212,051694,A50正2中信96購03,0.58,0.58,0.58,0.58,0.00,0.00,2000,1,1160,0,0,0,0,0,0,0,2000,-2000,-2000
20200212,051695,元金2X中信98購01,,,,,0.00,0.00,0,0,0,0,0,0,0,0,0,0,0,0,0
20200212,051696,新日興中信96購01,0.88,0.91,0.83,0.85,-0.06,-6.59,771000,58,657790,0,0,0,0,0,0,583000,186000,397000,397000
20200212,051697,康友中信95購02,0.72,0.77,0.72,0.73,+0.02,2.82,1207000,17,901060,0,0,0,0,0,0,449000,758000,-309000,-309000
20200212,051698,旺宏麥證95購01,,,,,0.00,0.00,0,0,0,0,0,0,0,0,0,0,0,0,0
20200212,051699,世紀鋼麥證95購01,0.36,0.36,0.36,0.36,0.00,0.00,10000,1,3600,0,10000,-10000,0,0,0,0,10000,-10000,-10000
20200212,05169P,玉晶光元大95售03,1.04,1.04,1.04,1.04,0.00,0.00,10000,1,10400,0,0,0,0,0,0,10000,0,10000,10000
20200212,051700,深中小群益99購04,1.04,1.13,1.04,1.13,+0.07,6.6,505000,10,548980,0,0,0,0,0,0,4000,501000,-497000,-497000
20200212,051701,華通群益97購01,1.32,1.87,1.32,1.71,+0.47,37.9,152000,19,237550,0,0,0,0,0,0,33000,119000,-86000,-86000
20200212,051702,鴻海群益95購08,0.48,0.52,0.48,0.52,0.00,0.00,45000,5,22550,0,0,0,0,0,0,0,45000,-45000,-45000
20200212,051703,台積電群益95購04,2.11,2.21,2.07,2.21,+0.21,10.5,72000,8,156720,0,0,0,0,0,0,69000,0,69000,69000
20200212,051704,智邦群益95購02,1.55,1.71,1.37,1.37,+0.02,1.48,208000,11,338820,0,0,0,0,0,0,152000,56000,96000,96000
20200212,051705,富邦金群益97購01,0.81,0.84,0.81,0.84,+0.11,15.07,253000,7,205250,0,0,0,0,0,0,237000,16000,221000,221000
20200212,051706,國泰金群益95購01,0.61,0.61,0.61,0.61,+0.05,8.93,11000,1,6710,0,0,0,0,0,0,0,11000,-11000,-11000
20200212,051707,欣興群益95購02,0.71,1.00,0.71,1.00,+0.26,35.14,133000,21,121930,0,0,0,0,0,0,36000,97000,-61000,-61000
20200212,051708,創意群益95購02,0.48,0.54,0.48,0.50,-0.12,-19.35,96000,9,47560,0,0,0,0,0,0,55000,41000,14000,14000
20200212,051709,TPK群益95購02,0.34,0.34,0.34,0.34,0.00,0.00,11000,1,3740,0,0,0,0,0,0,0,11000,-11000,-11000
20200212,05170P,世芯元大95售01,1.00,1.02,0.92,0.92,-0.06,-6.12,2187000,86,2129950,0,0,0,0,0,0,681000,1331000,-650000,-650000
20200212,051710,和碩群益95購01,,,,,0.00,0.00,0,0,0,0,0,0,0,0,0,0,0,0,0
20200212,051711,臻鼎群益95購03,0.39,0.39,0.39,0.39,0.00,0.00,1000,1,390,0,0,0,0,0,0,0,1000,-1000,-1000
20200212,051712,嘉聯益群益95購01,0.44,0.44,0.44,0.44,-0.01,-2.22,2000,1,880,0,0,0,0,0,0,2000,0,2000,2000
20200212,051713,大立光台新95購03,1.86,1.88,1.86,1.88,+0.10,5.62,52000,2,97240,0,0,0,0,0,0,0,52000,-52000,-52000
20200212,051714,健鼎台新95購01,0.69,0.84,0.69,0.84,+0.30,55.56,172000,35,134000,0,0,0,0,0,0,0,172000,-172000,-172000
20200212,051715,和碩台新95購01,0.58,0.58,0.58,0.58,+0.05,9.43,96000,2,55680,0,0,0,0,0,0,56000,40000,16000,16000
20200212,051716,康控康和95購01,,,,,0.00,0.00,0,0,0,0,0,0,0,0,0,0,0,0,0
20200212,051717,祥碩康和95購01,,,,,0.00,0.00,0,0,0,0,0,0,0,0,0,0,0,0,0
20200212,051718,上証2X永豐95購01,0.66,0.66,0.60,0.65,-0.03,-4.41,245000,16,155500,0,0,0,0,0,0,0,245000,-245000,-245000
20200212,051719,鴻海永豐95購04,,,,,0.00,0.00,0,0,0,0,0,0,0,0,0,0,0,0,0
20200212,05171P,臺股指元大95售15,1.31,1.31,1.16,1.19,-0.16,-11.85,177000,17,218340,0,0,0,0,0,0,14000,163000,-149000,-149000
20200212,051720,燿華永豐95購06,,,,,0.00,0.00,0,0,0,0,0,0,0,0,0,0,0,0,0
20200212,051721,玉晶光永豐96購02,2.69,2.83,2.69,2.80,+0.13,4.87,57000,7,158780,0,0,0,0,0,0,57000,0,57000,57000
20200212,051722,玉晶光永豐97購01,2.86,2.86,2.86,2.86,+0.32,12.6,3000,1,8580,0,0,0,0,0,0,0,3000,-3000,-3000
20200212,051723,嘉澤永豐95購01,0.97,0.98,0.82,0.84,-0.06,-6.67,183000,7,165550,0,0,0,0,0,0,68000,115000,-47000,-47000
20200212,051724,康控永豐95購03,,,,,0.00,0.00,0,0,0,0,0,0,0,0,0,0,0,0,0
20200212,051725,緯穎永豐95購02,2.88,3.09,2.88,3.09,+0.19,6.55,176000,10,518730,0,0,0,0,0,0,126000,50000,76000,76000
20200212,051726,南茂永豐95購03,,,,,0.00,0.00,0,0,0,0,0,0,0,0,0,0,0,0,0
20200212,051727,S&P反1國票97購01,,,,,0.00,0.00,0,0,0,0,0,0,0,0,0,0,0,0,0
20200212,051728,道瓊反國票97購01,,,,,0.00,0.00,0,0,0,0,0,0,0,0,0,0,0,0,0
20200212,051729,華新國票96購01,1.19,1.22,1.18,1.20,+0.08,7.14,62000,6,73940,0,0,0,0,0,0,42000,30000,12000,12000
20200212,05172P,臺股指元大95售16,1.26,1.26,1.17,1.17,0.00,0.00,2000,2,2430,0,0,0,0,0,0,0,2000,-2000,-2000
20200212,051730,為升國票96購02,1.26,1.26,1.26,1.26,+0.04,3.28,10000,1,12600,0,0,0,0,0,0,0,10000,-10000,-10000
20200212,051731,聯電國票96購02,,,,,0.00,0.00,0,0,0,0,0,0,0,0,0,0,0,0,0
20200212,051732,華通國票97購01,0.14,0.27,0.14,0.27,+0.12,80.0,1581000,24,378930,0,0,0,0,0,0,1276000,285000,991000,991000
20200212,051733,中環國票96購02,0.50,0.50,0.47,0.47,-0.08,-14.55,1387000,17,654460,0,0,0,0,0,0,117000,1270000,-1153000,-1153000
20200212,051734,台積電國票95購04,3.50,3.78,3.43,3.78,+0.41,12.17,511000,11,1841480,0,0,0,0,0,0,431000,272000,159000,159000
20200212,051735,台積電國票96購06,5.05,5.05,5.05,5.05,+0.33,6.99,9000,2,45450,0,0,0,0,0,0,9000,0,9000,9000
20200212,051736,旺宏國票96購01,,,,,0.00,0.00,0,0,0,0,0,0,0,0,0,0,0,0,0
20200212,051737,瑞昱國票96購01,3.44,3.68,3.44,3.68,+0.45,13.93,21000,4,74220,0,0,0,0,0,0,21000,3000,18000,18000
20200212,051738,全新國票96購02,0.70,0.89,0.70,0.89,+0.28,45.9,149000,18,118140,0,0,0,0,0,0,30000,119000,-89000,-89000
20200212,051739,奇力新國票97購01,,,,,0.00,0.00,0,0,0,0,0,0,0,0,0,0,0,0,0
20200212,05173P,臺股指元大95售17,1.35,1.35,1.22,1.22,-0.22,-15.28,119000,8,150790,0,0,0,0,0,0,16000,103000,-87000,-87000
20200212,051740,可成國票96購04,0.88,1.02,0.88,1.02,0.00,0.00,96000,6,91910,0,0,0,0,0,0,36000,96000,-60000,-60000
20200212,051741,可成國票97購01,0.38,0.45,0.37,0.45,+0.11,32.35,126000,4,50500,0,0,0,0,0,0,66000,60000,6000,6000
20200212,051742,欣興國票96購01,0.42,0.46,0.42,0.46,0.00,0.00,80000,3,34600,0,0,0,0,0,0,10000,70000,-60000,-60000
20200212,051743,揚明光國票96購02,1.21,1.24,1.21,1.24,0.00,0.00,30000,3,36600,0,0,0,0,0,0,0,30000,-30000,-30000
20200212,051744,嘉聯益國票97購01,0.97,0.97,0.97,0.97,0.00,0.00,10000,1,9700,0,0,0,0,0,0,10000,0,10000,10000
20200212,051745,玉晶光國泰97購06,,,,,0.00,0.00,0,0,0,0,0,0,0,0,0,0,0,0,0
20200212,051746,玉晶光國泰97購07,,,,,0.00,0.00,0,0,0,0,0,0,0,0,0,0,0,0,0
20200212,051747,貿聯國泰96購01,1.23,1.40,1.22,1.40,+0.18,14.75,124000,25,161320,0,0,0,0,0,0,31000,102000,-71000,-71000
20200212,051748,超眾國泰96購01,1.48,1.66,1.48,1.66,+0.08,5.06,377000,62,586120,0,0,0,0,0,0,354000,124000,230000,230000
20200212,051749,矽力國泰97購01,1.97,2.04,1.95,2.03,+0.21,11.54,290000,9,573940,0,0,0,0,0,0,239000,31000,208000,208000
20200212,05174P,元金2X富邦9B售01,0.88,0.88,0.88,0.88,+0.01,1.15,25000,3,22000,0,0,0,0,0,0,10000,5000,5000,5000
20200212,051750,華通富邦96購01,0.11,0.14,0.11,0.14,+0.04,40.0,1027000,19,131050,0,0,0,0,0,0,912000,11000,901000,901000
20200212,051751,聯茂富邦95購01,0.30,0.35,0.30,0.35,+0.17,94.44,418000,10,137120,0,0,0,0,0,0,0,418000,-418000,-418000
20200212,051752,緯穎富邦96購01,1.30,1.40,1.24,1.40,+0.10,7.69,177000,16,235290,0,0,0,0,0,0,133000,39000,94000,94000
20200212,051753,華通元大96購03,0.52,0.58,0.52,0.58,+0.22,61.11,515000,8,271140,0,0,0,0,0,0,8000,507000,-499000,-499000
20200212,051754,廣宇元大95購01,0.57,0.57,0.57,0.57,0.00,0.00,1000,1,570,0,0,0,0,0,0,0,1000,-1000,-1000
20200212,051755,台積電元大96購08,3.06,3.12,3.06,3.12,+0.12,4.0,56000,4,174390,0,0,0,0,0,0,6000,50000,-44000,-44000
20200212,051756,台積電元大97購04,4.38,4.47,4.33,4.47,+0.26,6.18,141000,25,617350,0,0,0,0,0,0,141000,138000,3000,3000
20200212,051757,佳世達元大95購02,,,,,0.00,0.00,0,0,0,0,0,0,0,0,0,0,0,0,0
20200212,051758,瑞昱元大95購01,2.20,2.47,2.20,2.39,+0.19,8.64,154000,18,345670,0,0,0,0,0,0,76000,91000,-15000,-15000
20200212,051759,全新元大95購04,0.71,0.91,0.67,0.91,+0.31,51.67,198000,10,154500,0,0,0,0,0,0,87000,111000,-24000,-24000
20200212,05175P,TPK富邦99售01,1.86,1.86,1.86,1.86,0.00,0.00,5000,1,9300,0,0,0,0,0,0,5000,0,5000,5000
20200212,051760,奇力新元大95購04,6.00,6.00,6.00,6.00,0.00,0.00,13000,3,78000,0,0,0,0,0,0,13000,0,13000,13000
20200212,051761,富邦金元大96購01,0.97,1.00,0.97,1.00,+0.11,12.36,166000,7,163380,0,0,0,0,0,0,57000,109000,-52000,-52000
20200212,051762,國泰金元大95購01,0.81,0.84,0.78,0.84,+0.07,9.09,693000,24,559400,0,0,0,0,0,0,337000,356000,-19000,-19000
20200212,051763,新光金元大98購01,0.44,0.44,0.44,0.44,0.00,0.00,1000,1,440,0,0,0,0,0,0,1000,0,1000,1000
20200212,051764,欣興元大95購07,0.58,0.58,0.58,0.58,+0.20,52.63,1000,1,580,0,0,0,0,0,0,0,1000,-1000,-1000
20200212,051765,健鼎元大95購03,0.37,0.56,0.37,0.56,+0.26,86.67,285000,5,108520,0,0,0,0,0,0,1000,284000,-283000,-283000
20200212,051766,泰鼎元大95購02,2.95,3.09,2.92,2.92,+0.03,1.04,16000,6,47500,0,0,0,0,0,0,1000,15000,-14000,-14000
20200212,051767,臻鼎元大95購03,,,,,0.00,0.00,0,0,0,0,0,0,0,0,0,0,0,0,0
20200212,051768,臻鼎元大95購04,0.32,0.32,0.32,0.32,0.00,0.00,68000,1,21760,0,0,0,0,0,0,0,68000,-68000,-68000
20200212,051769,矽力元大95購01,3.14,3.33,3.02,3.33,+0.46,16.03,34000,4,109550,0,0,0,0,0,0,2000,32000,-30000,-30000
20200212,05176P,台積電凱基95售11,0.37,0.37,0.35,0.35,-0.05,-12.5,135000,4,49750,0,0,0,0,0,0,0,135000,-135000,-135000
20200212,051770,南茂元大95購02,,,,,0.00,0.00,0,0,0,0,0,0,0,0,0,0,0,0,0
20200212,051771,上銀中信95購01,1.33,1.33,1.25,1.25,+0.02,1.63,86000,8,113330,0,0,0,0,0,0,65000,21000,44000,44000
20200212,051772,玉山金中信95購01,,,,,0.00,0.00,0,0,0,0,0,0,0,0,0,0,0,0,0
20200212,051773,元大金中信95購02,,,,,0.00,0.00,0,0,0,0,0,0,0,0,0,0,0,0,0
20200212,051774,聯茂中信96購01,0.78,1.08,0.78,1.00,+0.30,42.86,633000,48,572280,0,0,0,0,0,0,200000,428000,-228000,-228000
20200212,051775,旺宏亞東95購01,1.64,1.64,1.64,1.64,0.00,0.00,40000,1,65600,0,0,0,0,0,0,40000,0,40000,40000
20200212,051776,上証2X群益99購01,,,,,0.00,0.00,0,0,0,0,0,0,0,0,0,0,0,0,0
20200212,051777,聯發科群益95購04,1.21,1.36,1.21,1.31,+0.28,27.18,659000,22,847900,0,0,0,0,0,0,564000,95000,469000,469000
20200212,051778,全新群益95購01,,,,,0.00,0.00,0,0,0,0,0,0,0,0,0,0,0,0,0
20200212,051779,大立光群益95購02,1.50,1.87,1.50,1.87,+0.38,25.5,233000,8,420020,0,0,0,0,0,0,5000,228000,-223000,-223000
20200212,05177P,台積電凱基95售12,,,,,0.00,0.00,0,0,0,0,0,0,0,0,0,0,0,0,0
20200212,051780,矽力群益95購01,2.59,2.99,2.59,2.98,+0.39,15.06,63000,12,180350,0,0,0,0,0,0,2000,56000,-54000,-54000
20200212,051781,緯穎群益96購01,,,,,0.00,0.00,0,0,0,0,0,0,0,0,0,0,0,0,0
20200212,051782,昇陽半群益95購01,,,,,0.00,0.00,0,0,0,0,0,0,0,0,0,0,0,0,0
20200212,051783,鴻海兆豐95購03,,,,,0.00,0.00,0,0,0,0,0,0,0,0,0,0,0,0,0
20200212,051784,國巨兆豐95購01,3.35,3.38,3.35,3.38,+0.20,6.29,45000,3,150870,0,0,0,0,0,0,41000,4000,37000,37000
20200212,051785,臻鼎兆豐96購01,1.16,1.22,0.90,0.94,+0.12,14.63,170000,22,189540,0,0,0,0,0,0,16000,154000,-138000,-138000
20200212,051786,A50正2國票95購02,0.32,0.32,0.29,0.30,-0.01,-3.23,604000,5,187240,0,0,0,0,0,0,100000,400000,-300000,-300000
20200212,051787,燿華國票96購02,0.64,0.68,0.64,0.68,+0.07,11.48,137000,3,90080,0,0,0,0,0,0,0,137000,-137000,-137000
20200212,051788,奇力新國票97購02,5.20,5.45,5.10,5.40,+0.05,0.93,121000,23,636150,0,0,0,0,0,0,59000,69000,-10000,-10000
20200212,051789,嘉澤國票96購01,3.88,3.95,3.88,3.95,+0.45,12.86,11000,2,42820,0,0,0,0,0,0,0,11000,-11000,-11000
20200212,05178P,大立光凱基96售05,1.46,1.46,1.37,1.37,-0.15,-9.87,80000,3,112300,0,0,0,0,0,0,0,80000,-80000,-80000
20200212,051790,貿聯國票95購03,1.03,1.10,1.03,1.10,+0.12,12.24,76000,5,78960,0,0,0,0,0,0,16000,60000,-44000,-44000
20200212,051791,智伸科國票96購01,1.25,1.25,1.17,1.18,-0.07,-5.6,56000,5,69060,0,0,0,0,0,0,30000,26000,4000,4000
20200212,051792,泰鼎國票96購02,2.65,2.86,2.60,2.60,-0.04,-1.52,187000,29,515420,0,0,0,0,0,0,15000,171000,-156000,-156000
20200212,051793,臻鼎國票95購02,,,,,0.00,0.00,0,0,0,0,0,0,0,0,0,0,0,0,0
20200212,051794,臻鼎國票96購02,0.32,0.33,0.32,0.33,0.00,0.00,18000,2,5840,0,0,0,0,0,0,0,18000,-18000,-18000
20200212,051795,T50反1台新05購02,,,,,0.00,0.00,0,0,0,0,0,0,0,0,0,0,0,0,0
20200212,051796,和碩康和95購01,0.32,0.34,0.32,0.34,+0.01,3.03,200000,7,66000,0,0,0,0,0,0,100000,100000,0,0
20200212,051797,卜蜂永豐95購01,0.30,0.30,0.30,0.30,0.00,0.00,76000,1,22800,0,0,0,0,0,0,76000,0,76000,76000
20200212,051798,國巨永豐95購03,4.72,4.72,4.72,4.72,+0.33,7.52,8000,1,37760,0,0,0,0,0,0,8000,0,8000,8000
20200212,051799,台積電永豐96購01,2.03,2.03,2.03,2.03,+0.10,5.18,5000,1,10150,0,0,0,0,0,0,0,5000,-5000,-5000
20200212,05179P,大立光凱基96售06,0.86,0.86,0.86,0.86,0.00,0.00,10000,1,8600,0,0,0,0,0,0,10000,0,10000,10000
20200212,051800,旺宏永豐95購02,,,,,0.00,0.00,0,0,0,0,0,0,0,0,0,0,0,0,0
20200212,051801,牧德永豐95購04,3.53,3.68,3.53,3.55,+0.04,1.14,71000,13,254440,0,0,0,0,0,0,48000,23000,25000,25000
20200212,051802,同欣電永豐95購02,0.84,0.93,0.81,0.81,-0.01,-1.22,304000,38,265790,0,0,0,0,0,0,105000,209000,-104000,-104000
20200212,051803,矽創永豐95購03,0.39,0.43,0.39,0.43,+0.10,30.3,77000,4,32470,0,0,0,0,0,0,15000,62000,-47000,-47000
20200212,051804,新光金日盛95購01,0.59,0.59,0.57,0.59,+0.02,3.51,317000,38,185510,0,0,0,0,0,0,277000,40000,237000,237000
20200212,051805,元黃金凱基97購02,1.24,1.25,1.24,1.25,0.00,0.00,60000,4,74700,0,0,0,0,0,0,60000,0,60000,60000
20200212,051806,華通凱基96購02,0.12,0.15,0.12,0.13,+0.03,30.0,120000,7,15150,0,0,0,0,0,0,30000,75000,-45000,-45000
20200212,051807,瑞昱凱基95購03,0.95,1.09,0.95,0.98,0.00,0.00,176000,8,169280,0,0,0,0,0,0,7000,176000,-169000,-169000
20200212,051808,美律凱基96購02,0.55,0.55,0.55,0.55,0.00,0.00,10000,2,5500,0,0,0,0,0,0,0,10000,-10000,-10000
20200212,051809,義隆凱基96購01,,,,,0.00,0.00,0,0,0,0,0,0,0,0,0,0,0,0,0
20200212,05180P,玉晶光凱基95售04,0.28,0.28,0.27,0.27,-0.04,-12.9,160000,4,43300,0,0,0,0,0,0,50000,110000,-60000,-60000
20200212,051810,欣興凱基95購03,0.14,0.17,0.14,0.17,0.00,0.00,80000,4,12700,0,0,0,0,0,0,50000,30000,20000,20000
20200212,051811,致伸凱基95購03,,,,,0.00,0.00,0,0,0,0,0,0,0,0,0,0,0,0,0
20200212,051812,臻鼎凱基95購03,0.23,0.23,0.19,0.19,+0.04,26.67,12000,2,2360,0,0,0,0,0,0,0,12000,-12000,-12000
20200212,051813,GIS凱基96購02,,,,,0.00,0.00,0,0,0,0,0,0,0,0,0,0,0,0,0
20200212,051814,鈺齊凱基95購01,0.11,0.15,0.11,0.15,+0.02,15.38,185000,4,27250,0,0,0,0,0,0,180000,5000,175000,175000
20200212,051815,百和凱基96購01,,,,,0.00,0.00,0,0,0,0,0,0,0,0,0,0,0,0,0
20200212,051816,臺股指凱基95購07,2.30,2.32,2.30,2.30,0.00,0.00,600000,6,1384000,0,0,0,0,0,0,600000,600000,0,0
20200212,051817,元金2X統一95購01,,,,,0.00,0.00,0,0,0,0,0,0,0,0,0,0,0,0,0
20200212,051818,國巨統一95購02,8.10,8.10,8.10,8.10,+0.60,8.0,13000,1,105300,0,0,0,0,0,0,13000,0,13000,13000
20200212,051819,燿華統一96購01,,,,,0.00,0.00,0,0,0,0,0,0,0,0,0,0,0,0,0
20200212,05181P,健策凱基95售01,0.20,0.21,0.19,0.19,-0.05,-20.83,255000,5,52800,0,0,0,0,0,0,210000,45000,165000,165000
20200212,051820,道瓊反元富95購01,,,,,0.00,0.00,0,0,0,0,0,0,0,0,0,0,0,0,0
20200212,051821,京元電元富95購04,0.22,0.25,0.21,0.25,+0.02,8.7,333000,22,74300,0,0,0,0,0,0,330000,3000,327000,327000
20200212,051822,和碩元富95購01,0.52,0.58,0.52,0.58,+0.05,9.43,70000,5,38200,0,0,0,0,0,0,10000,60000,-50000,-50000
20200212,051823,矽力元富95購02,1.72,1.93,1.72,1.93,+0.24,14.2,46000,5,83300,0,0,0,0,0,0,0,46000,-46000,-46000
20200212,051824,華通元大95購07,0.53,0.79,0.50,0.79,+0.28,54.9,318000,16,195210,0,0,0,0,0,0,249000,69000,180000,180000
20200212,051825,中環元大95購01,0.80,0.80,0.78,0.78,-0.11,-12.36,132000,15,104200,0,0,0,0,0,0,132000,0,132000,132000
20200212,051826,智邦元大95購03,0.84,0.89,0.73,0.73,-0.03,-3.95,493000,42,402810,0,0,0,0,0,0,267000,407000,-140000,-140000
20200212,051827,智邦元大95購04,0.99,1.06,0.87,0.89,-0.01,-1.11,797000,71,773030,0,0,0,0,0,0,466000,574000,-108000,-108000
20200212,051828,微星元大95購03,4.19,4.19,3.75,3.75,-0.08,-2.09,5000,3,20510,0,0,0,0,0,0,4000,1000,3000,3000
20200212,051829,玉晶光元大98購02,2.41,2.51,2.40,2.46,+0.14,6.03,60000,16,148080,0,0,0,0,0,0,49000,11000,38000,38000
20200212,05182P,嘉晶統一95售03,,,,,0.00,0.00,0,0,0,0,0,0,0,0,0,0,0,0,0
20200212,051830,健策元大97購01,2.64,2.78,2.49,2.78,+0.32,13.01,694000,74,1820340,0,0,0,0,0,0,441000,394000,47000,47000
20200212,051831,緯穎元大96購04,3.96,4.19,3.96,4.19,+0.14,3.46,4000,2,16300,0,0,0,0,0,0,4000,0,4000,4000
20200212,051832,復盛元大95購01,3.83,3.83,3.69,3.74,+0.02,0.54,120000,10,446050,0,0,0,0,0,0,120000,0,120000,120000
20200212,051833,昇陽半元大96購01,0.72,0.76,0.71,0.72,+0.01,1.41,221000,18,161390,0,0,0,0,0,0,161000,79000,82000,82000
20200212,051834,南電元大96購02,0.34,0.36,0.34,0.36,+0.07,24.14,198000,3,70420,0,0,0,0,0,0,198000,0,198000,198000
20200212,051835,百和元大95購03,,,,,0.00,0.00,0,0,0,0,0,0,0,0,0,0,0,0,0
20200212,051836,華通國泰95購02,0.45,0.45,0.45,0.45,0.00,0.00,10000,1,4500,0,0,0,0,0,0,10000,0,10000,10000
20200212,051837,國巨國泰96購04,4.00,4.00,4.00,4.00,+0.35,9.59,100000,1,400000,0,0,0,0,0,0,100000,0,100000,100000
20200212,051838,國巨國泰97購01,3.75,3.75,3.75,3.75,+0.27,7.76,4000,2,15000,0,0,0,0,0,0,4000,0,4000,4000
20200212,051839,和鑫國泰96購01,0.80,0.84,0.78,0.84,+0.05,6.33,26000,12,21360,0,0,0,0,0,0,10000,16000,-6000,-6000
20200212,05183P,台積電元富95售07,0.45,0.46,0.43,0.44,-0.07,-13.73,46000,6,20560,0,0,0,0,0,0,10000,36000,-26000,-26000
20200212,051840,康友國泰97購02,1.99,2.11,1.96,2.03,+0.02,1.0,489000,28,997050,0,0,0,0,0,0,299000,260000,39000,39000
20200212,051841,南茂國泰96購01,0.80,0.81,0.78,0.78,-0.05,-6.02,171000,18,136370,0,0,0,0,0,0,171000,0,171000,171000
20200212,051842,大成鋼富邦97購01,0.58,0.62,0.56,0.62,+0.03,5.08,614000,19,361940,0,0,0,0,0,0,302000,308000,-6000,-6000
20200212,051843,聯發科富邦99購01,1.05,1.21,1.05,1.19,+0.25,26.6,1714000,65,1925710,0,0,0,0,0,0,1115000,1167000,-52000,-52000
20200212,051844,宏達電富邦96購01,0.35,0.36,0.35,0.35,+0.02,6.06,152000,9,53460,0,0,0,0,0,0,131000,21000,110000,110000
20200212,051845,世紀鋼富邦96購01,0.29,0.29,0.29,0.29,+0.01,3.57,2000,1,580,0,0,0,0,0,0,0,2000,-2000,-2000
20200212,051846,S&P反1中信96購02,0.53,0.53,0.53,0.53,0.00,0.00,25000,2,13250,0,0,0,0,0,0,0,25000,-25000,-25000
20200212,051847,香港反中信99購01,0.48,0.48,0.48,0.48,-0.01,-2.04,6000,1,2880,0,0,0,0,0,0,0,6000,-6000,-6000
20200212,051848,元金2X中信98購02,1.04,1.04,1.04,1.04,-0.02,-1.89,6000,1,6240,0,0,0,0,0,0,6000,0,6000,6000
20200212,051849,旺宏中信98購01,1.48,1.51,1.45,1.46,-0.03,-2.01,122000,10,178860,0,0,0,0,0,0,72000,50000,22000,22000
20200212,05184P,緯穎元富95售01,0.21,0.21,0.21,0.21,-0.05,-19.23,2000,1,420,0,0,0,0,0,0,2000,0,2000,2000
20200212,051850,臻鼎中信96購01,0.68,0.82,0.61,0.61,+0.10,19.61,66000,8,46190,0,0,0,0,0,0,20000,46000,-26000,-26000
20200212,051851,TPK群益95購03,0.24,0.25,0.24,0.25,0.00,0.00,20000,2,4900,0,0,0,0,0,0,0,20000,-20000,-20000
20200212,051852,啟碁群益95購01,,,,,0.00,0.00,0,0,0,0,0,0,0,0,0,0,0,0,0
20200212,051853,京元電亞東95購01,0.46,0.50,0.46,0.49,-0.03,-5.77,227000,23,112110,0,0,0,0,0,0,226000,0,226000,226000
20200212,051854,鴻海麥證95購04,0.34,0.45,0.34,0.45,+0.14,45.16,25000,5,9290,2000,23000,-21000,0,0,0,2000,23000,-21000,-21000
20200212,051855,道瓊反凱基97購01,,,,,0.00,0.00,0,0,0,0,0,0,0,0,0,0,0,0,0
20200212,051856,亞德客凱基95購01,1.40,1.56,0.23,1.56,-0.07,-4.29,176000,12,254270,0,0,0,0,0,0,166000,30000,136000,136000
20200212,051857,喬山凱基95購01,,,,,0.00,0.00,0,0,0,0,0,0,0,0,0,0,0,0,0
20200212,051858,上銀凱基95購01,0.97,0.98,0.94,0.94,-0.01,-1.05,45000,4,43550,0,0,0,0,0,0,30000,15000,15000,15000
20200212,051859,劍麟凱基96購01,,,,,0.00,0.00,0,0,0,0,0,0,0,0,0,0,0,0,0
20200212,05185P,鴻海中信95售04,,,,,0.00,0.00,0,0,0,0,0,0,0,0,0,0,0,0,0
20200212,051860,為升凱基95購01,,,,,0.00,0.00,0,0,0,0,0,0,0,0,0,0,0,0,0
20200212,051861,鴻海凱基98購01,0.34,0.42,0.33,0.42,+0.09,27.27,387000,20,146020,0,0,0,0,0,0,111000,273000,-162000,-162000
20200212,051862,旺宏凱基95購05,2.82,2.82,2.70,2.70,-0.01,-0.37,5000,5,13800,0,0,0,0,0,0,5000,5000,0,0
20200212,051863,技嘉凱基95購01,0.64,0.70,0.64,0.64,0.00,0.00,679000,38,453400,0,0,0,0,0,0,239000,390000,-151000,-151000
20200212,051864,聯發科凱基96購03,0.66,0.66,0.66,0.66,0.00,0.00,5000,1,3300,0,0,0,0,0,0,0,5000,-5000,-5000
20200212,051865,聯發科凱基96購04,,,,,0.00,0.00,0,0,0,0,0,0,0,0,0,0,0,0,0
20200212,051866,聯發科凱基96購05,0.60,0.68,0.60,0.68,+0.20,41.67,23000,6,14270,0,0,0,0,0,0,16000,5000,11000,11000
20200212,051867,潤泰全凱基95購01,,,,,0.00,0.00,0,0,0,0,0,0,0,0,0,0,0,0,0
20200212,051868,貿聯凱基96購01,0.64,0.76,0.64,0.76,+0.12,18.75,339000,12,239440,0,0,0,0,0,0,239000,100000,139000,139000
20200212,051869,康控凱基96購01,0.38,0.40,0.38,0.40,+0.05,14.29,22000,4,8700,0,0,0,0,0,0,0,22000,-22000,-22000
20200212,05186P,鈺齊中信95售02,,,,,0.00,0.00,0,0,0,0,0,0,0,0,0,0,0,0,0
20200212,051870,台郡凱基95購04,0.48,0.48,0.48,0.48,+0.27,128.57,2000,1,960,0,0,0,0,0,0,0,0,0,0
20200212,051871,同欣電凱基95購02,0.76,0.95,0.76,0.77,-0.01,-1.28,79000,27,66760,0,0,0,0,0,0,48000,31000,17000,17000
20200212,051872,矽力凱基96購01,1.33,1.33,1.33,1.33,+0.17,14.66,188000,3,250040,0,0,0,0,0,0,0,188000,-188000,-188000
20200212,051873,緯穎凱基95購02,3.15,3.42,0.50,3.42,+0.18,5.56,166000,16,504670,0,0,0,0,0,0,114000,95000,19000,19000
20200212,051874,志超凱基95購01,,,,,0.00,0.00,0,0,0,0,0,0,0,0,0,0,0,0,0
20200212,051875,聯發科兆豐95購04,0.73,0.82,0.73,0.81,+0.17,26.56,159000,4,124280,0,0,0,0,0,0,94000,65000,29000,29000
20200212,051876,宏達電國票96購01,1.88,1.88,1.85,1.85,+0.07,3.93,277000,9,516170,0,0,0,0,0,0,137000,146000,-9000,-9000
20200212,051877,嘉聯益國票97購02,1.32,1.32,1.32,1.32,+0.24,22.22,34000,1,44880,0,0,0,0,0,0,0,34000,-34000,-34000
20200212,051878,鴻海台新96購01,,,,,0.00,0.00,0,0,0,0,0,0,0,0,0,0,0,0,0
20200212,051879,健策台新96購01,2.42,2.50,2.34,2.50,+0.20,8.7,97000,21,234160,0,0,0,0,0,0,77000,0,77000,77000
20200212,05187P,力山凱基95售01,,,,,0.00,0.00,0,0,0,0,0,0,0,0,0,0,0,0,0
20200212,051880,健策康和95購01,,,,,0.00,0.00,0,0,0,0,0,0,0,0,0,0,0,0,0
20200212,051881,上証2X永豐95購02,,,,,0.00,0.00,0,0,0,0,0,0,0,0,0,0,0,0,0
20200212,051882,潤泰全永豐95購01,,,,,0.00,0.00,0,0,0,0,0,0,0,0,0,0,0,0,0
20200212,051883,智原永豐95購03,,,,,0.00,0.00,0,0,0,0,0,0,0,0,0,0,0,0,0
20200212,051884,樺漢永豐95購01,,,,,0.00,0.00,0,0,0,0,0,0,0,0,0,0,0,0,0
20200212,051885,易華電永豐95購02,0.41,0.41,0.41,0.41,+0.01,2.5,28000,1,11480,0,0,0,0,0,0,28000,0,28000,28000
20200212,051886,道瓊反統一95購03,0.47,0.47,0.45,0.45,0.00,0.00,63000,2,29350,0,0,0,0,0,0,13000,50000,-37000,-37000
20200212,051887,上証2X元富98購01,,,,,0.00,0.00,0,0,0,0,0,0,0,0,0,0,0,0,0
20200212,051888,國巨元富95購05,2.96,2.96,2.68,2.83,+0.20,7.6,1180000,99,3300390,0,0,0,0,0,0,969000,692000,277000,277000
20200212,051889,智邦元富95購02,1.24,1.34,1.07,1.18,-0.01,-0.84,501000,20,615800,0,0,0,0,0,0,298000,216000,82000,82000
20200212,05188P,可成凱基95售09,,,,,0.00,0.00,0,0,0,0,0,0,0,0,0,0,0,0,0
20200212,051890,智邦元富95購03,0.86,0.95,0.75,0.80,+0.06,8.11,386000,16,336620,0,0,0,0,0,0,312000,114000,198000,198000
20200212,051891,智邦元富95購04,0.88,0.97,0.80,0.84,+0.02,2.44,491000,29,444150,0,0,0,0,0,0,457000,24000,433000,433000
20200212,051892,台光電元富95購03,0.41,0.60,0.41,0.60,+0.19,46.34,548000,27,265620,0,0,0,0,0,0,90000,428000,-338000,-338000
20200212,051893,瀚宇博元富95購01,,,,,0.00,0.00,0,0,0,0,0,0,0,0,0,0,0,0,0
20200212,051894,嘉聯益元富95購03,0.68,0.76,0.68,0.76,+0.10,15.15,46000,8,32460,0,0,0,0,0,0,36000,10000,26000,26000
20200212,051895,聯茂元富95購02,0.42,0.61,0.42,0.56,+0.22,64.71,240000,49,131410,0,0,0,0,0,0,10000,230000,-220000,-220000
20200212,051896,柏文元富95購01,0.34,0.34,0.34,0.34,+0.03,9.68,30000,1,10200,0,0,0,0,0,0,0,30000,-30000,-30000
20200212,051897,台光電國泰97購01,1.27,1.60,1.27,1.53,+0.32,26.45,102000,15,149340,0,0,0,0,0,0,34000,82000,-48000,-48000
20200212,051898,富邦金國泰97購01,,,,,0.00,0.00,0,0,0,0,0,0,0,0,0,0,0,0,0
20200212,051899,欣興國泰97購01,0.70,0.86,0.70,0.86,+0.22,34.38,116000,11,91170,0,0,0,0,0,0,80000,31000,49000,49000
20200212,05189P,新光金凱基97售02,,,,,0.00,0.00,0,0,0,0,0,0,0,0,0,0,0,0,0
20200212,051900,臻鼎富邦95購01,0.25,0.25,0.17,0.17,0.00,0.00,75000,4,14050,0,0,0,0,0,0,0,75000,-75000,-75000
20200212,051901,嘉聯益富邦96購01,0.20,0.20,0.20,0.20,0.00,0.00,50000,1,10000,0,0,0,0,0,0,0,50000,-50000,-50000
20200212,051902,T50反1元大97購01,0.47,0.47,0.43,0.43,-0.06,-12.24,182000,6,81640,0,0,0,0,0,0,77000,105000,-28000,-28000
20200212,051903,T50反1元大97購02,0.43,0.43,0.40,0.40,-0.04,-9.09,60000,4,24700,0,0,0,0,0,0,0,60000,-60000,-60000
20200212,051904,深100元大95購01,0.65,0.66,0.65,0.66,+0.03,4.76,6000,2,3930,0,0,0,0,0,0,0,6000,-6000,-6000
20200212,051905,道瓊銀元大95購01,1.22,1.22,1.22,1.22,-0.10,-7.58,11000,1,13420,0,0,0,0,0,0,11000,11000,0,0
20200212,051906,國巨元大95購09,6.25,6.25,6.15,6.15,+0.15,2.5,18000,3,111000,0,0,0,0,0,0,18000,15000,3000,3000
20200212,051907,台積電元大97購05,2.20,2.25,2.20,2.25,+0.12,5.63,396000,20,878350,0,0,0,0,0,0,386000,21000,365000,365000
20200212,051908,國泰金元大96購02,0.86,0.86,0.86,0.86,+0.06,7.5,100000,2,86000,0,0,0,0,0,0,0,100000,-100000,-100000
20200212,051909,潤泰全元大95購02,,,,,0.00,0.00,0,0,0,0,0,0,0,0,0,0,0,0,0
20200212,05190P,鴻海國票96售02,,,,,0.00,0.00,0,0,0,0,0,0,0,0,0,0,0,0,0
20200212,051910,大立光元大97購01,1.36,1.40,1.36,1.40,+0.19,15.7,216000,5,298400,0,0,0,0,0,0,0,216000,-216000,-216000
20200212,051911,大立光元大98購02,1.53,1.63,1.53,1.63,+0.16,10.88,873000,39,1387850,0,0,0,0,0,0,817000,607000,210000,210000
20200212,051912,健鼎元大96購01,0.56,0.82,0.56,0.80,+0.28,53.85,1144000,31,830680,0,0,0,0,0,0,210000,924000,-714000,-714000
20200212,051913,緯創元大96購01,0.75,0.81,0.75,0.81,+0.06,8.0,250000,4,196500,0,0,0,0,0,0,100000,130000,-30000,-30000
20200212,051914,健策元大96購06,4.80,5.25,4.73,5.20,+0.54,11.59,288000,61,1431120,0,0,0,0,0,0,224000,224000,0,0
20200212,051915,日月光元大96購01,1.09,1.21,1.08,1.21,+0.17,16.35,507000,13,565880,0,0,0,0,0,0,436000,139000,297000,297000
20200212,051916,和碩元大95購02,0.83,0.90,0.80,0.90,+0.07,8.43,185000,5,153550,0,0,0,0,0,0,75000,145000,-70000,-70000
20200212,051917,瑞儀元大95購01,,,,,0.00,0.00,0,0,0,0,0,0,0,0,0,0,0,0,0
20200212,051918,聯茂元大95購01,1.01,1.46,1.01,1.46,+0.46,46.0,538000,45,677130,0,0,0,0,0,0,329000,355000,-26000,-26000
20200212,051919,台郡元大96購02,2.19,2.23,2.15,2.15,+0.68,46.26,57000,10,123950,0,0,0,0,0,0,53000,0,53000,53000
20200212,05191P,鴻海台新95售01,1.06,1.09,0.89,0.89,-0.30,-25.21,120000,4,122100,0,0,0,0,0,0,30000,90000,-60000,-60000
20200212,051920,南茂元大95購03,,,,,0.00,0.00,0,0,0,0,0,0,0,0,0,0,0,0,0
20200212,051921,南茂元大95購04,,,,,0.00,0.00,0,0,0,0,0,0,0,0,0,0,0,0,0
20200212,051922,鴻海亞東96購02,,,,,0.00,0.00,0,0,0,0,0,0,0,0,0,0,0,0,0
20200212,051923,聯發科日盛95購02,0.29,0.34,0.29,0.34,+0.10,41.67,32000,4,10430,0,0,0,0,0,0,1000,31000,-30000,-30000
20200212,051924,聯茂日盛95購01,0.44,0.64,0.44,0.55,+0.15,37.5,733000,43,423870,0,0,0,0,0,0,171000,566000,-395000,-395000
20200212,051925,瀚宇博第一95購01,0.25,0.25,0.25,0.25,-0.01,-3.85,1000,1,250,0,0,0,0,0,0,1000,0,1000,1000
20200212,051926,聯電中信97購01,1.31,1.41,1.28,1.41,+0.01,0.71,191000,18,252520,0,0,0,0,0,0,161000,30000,131000,131000
20200212,051927,國巨中信96購01,3.37,3.37,3.20,3.34,+0.27,8.79,101000,8,336500,0,0,0,0,0,0,96000,5000,91000,91000
20200212,051928,大立光中信96購03,0.60,0.70,0.60,0.70,+0.10,16.67,129000,11,85900,0,0,0,0,0,0,93000,36000,57000,57000
20200212,051929,GIS中信96購01,0.44,0.44,0.44,0.44,0.00,0.00,33000,2,14520,0,0,0,0,0,0,0,33000,-33000,-33000
20200212,05192P,玉晶光台新96售02,,,,,0.00,0.00,0,0,0,0,0,0,0,0,0,0,0,0,0
20200212,051930,國泰金兆豐97購01,0.61,0.61,0.61,0.61,+0.03,5.17,42000,2,25620,0,0,0,0,0,0,0,42000,-42000,-42000
20200212,051931,美律國票96購02,1.72,1.99,1.72,1.99,+0.39,24.38,184000,19,340540,0,0,0,0,0,0,21000,157000,-136000,-136000
20200212,051932,康控國票96購02,0.45,0.48,0.45,0.48,+0.06,14.29,206000,4,97220,0,0,0,0,0,0,10000,196000,-186000,-186000
20200212,051933,嘉聯益國票97購03,0.82,0.82,0.82,0.82,+0.12,17.14,2000,1,1640,0,0,0,0,0,0,2000,0,2000,2000
20200212,051934,緯穎國票96購01,9.10,9.75,9.10,9.70,+0.80,8.99,10000,4,93350,0,0,0,0,0,0,8000,2000,6000,6000
20200212,051935,味全群益95購01,,,,,0.00,0.00,0,0,0,0,0,0,0,0,0,0,0,0,0
20200212,051936,力山群益95購02,,,,,0.00,0.00,0,0,0,0,0,0,0,0,0,0,0,0,0
20200212,051937,廣達群益95購01,1.93,2.06,1.93,2.05,+0.08,4.06,146000,7,284990,0,0,0,0,0,0,136000,23000,113000,113000
20200212,051938,旭富群益95購01,2.09,2.66,2.06,2.10,+0.18,9.37,566000,56,1293050,0,0,0,0,0,0,332000,200000,132000,132000
20200212,051939,同欣電群益97購01,3.63,4.11,3.59,3.64,0.00,0.00,417000,43,1593690,0,0,0,0,0,0,313000,285000,28000,28000
20200212,05193P,台郡台新95售01,0.48,0.49,0.48,0.49,0.00,0.00,95000,2,46070,0,0,0,0,0,0,0,95000,-95000,-95000
20200212,051940,康舒群益95購01,1.57,1.60,1.57,1.59,+0.03,1.92,30000,3,47600,0,0,0,0,0,0,0,30000,-30000,-30000
20200212,051941,樺漢群益95購02,1.09,1.17,1.09,1.15,+0.01,0.88,635000,11,716750,0,0,0,0,0,0,255000,380000,-125000,-125000
20200212,051942,寶成群益95購01,,,,,0.00,0.00,0,0,0,0,0,0,0,0,0,0,0,0,0
20200212,051943,台積電麥證95購03,2.00,2.08,1.95,2.07,+0.20,10.7,1251000,14,2508210,201000,1050000,-849000,0,0,0,201000,1050000,-849000,-849000
20200212,051944,智邦統一95購02,1.91,2.08,1.75,1.77,-0.13,-6.84,128000,10,252560,0,0,0,0,0,0,3000,125000,-122000,-122000
20200212,051945,智邦統一95購03,1.46,1.55,1.28,1.28,-0.01,-0.78,155000,18,226000,0,0,0,0,0,0,91000,64000,27000,27000
20200212,051946,健策統一98購01,1.09,1.16,1.02,1.16,+0.13,12.62,1353000,51,1450190,0,0,0,0,0,0,749000,504000,245000,245000
20200212,051947,矽力統一95購01,0.95,1.03,0.95,1.03,+0.07,7.29,10000,2,9900,0,0,0,0,0,0,5000,5000,0,0
20200212,051948,滬深2X元富9B購01,0.77,0.77,0.76,0.76,-0.01,-1.3,101000,3,77260,0,0,0,0,0,0,1000,100000,-99000,-99000
20200212,051949,鴻海元富95購08,,,,,0.00,0.00,0,0,0,0,0,0,0,0,0,0,0,0,0
20200212,05194P,玉晶光康和95售01,,,,,0.00,0.00,0,0,0,0,0,0,0,0,0,0,0,0,0
20200212,051950,旺宏元富95購02,,,,,0.00,0.00,0,0,0,0,0,0,0,0,0,0,0,0,0
20200212,051951,聯發科元富95購02,0.64,0.65,0.64,0.65,0.00,0.00,100000,2,64500,0,0,0,0,0,0,0,100000,-100000,-100000
20200212,051952,聯發科元富95購03,0.93,0.93,0.93,0.93,0.00,0.00,20000,1,18600,0,0,0,0,0,0,0,20000,-20000,-20000
20200212,051953,矽力元富95購03,0.99,1.15,0.99,1.13,+0.17,17.71,637000,28,691910,0,0,0,0,0,0,344000,279000,65000,65000
20200212,051954,矽力元富95購04,1.09,1.23,1.07,1.19,+0.22,22.68,82000,12,96100,0,0,0,0,0,0,18000,34000,-16000,-16000
20200212,051955,寶成元富95購01,,,,,0.00,0.00,0,0,0,0,0,0,0,0,0,0,0,0,0
20200212,051956,滬深2X台新96購01,0.54,0.54,0.54,0.54,+0.01,1.89,1000,1,540,0,0,0,0,0,0,1000,0,1000,1000
20200212,051957,旺宏台新95購02,4.09,4.09,3.90,3.90,-0.15,-3.7,4000,4,15960,0,0,0,0,0,0,4000,0,4000,4000
20200212,051958,貿聯台新95購01,0.68,0.73,0.68,0.73,+0.12,19.67,208000,4,143250,0,0,0,0,0,0,0,208000,-208000,-208000
20200212,051959,台郡台新95購03,0.70,0.75,0.66,0.75,+0.35,87.5,673000,41,467400,0,0,0,0,0,0,588000,26000,562000,562000
20200212,05195P,南茂康和95售01,,,,,0.00,0.00,0,0,0,0,0,0,0,0,0,0,0,0,0
20200212,051960,美食永豐95購01,0.15,0.15,0.15,0.15,0.00,0.00,60000,1,9000,0,0,0,0,0,0,0,60000,-60000,-60000
20200212,051961,泰碩永豐95購01,0.23,0.23,0.23,0.23,0.00,0.00,80000,1,18400,0,0,0,0,0,0,80000,0,80000,80000
20200212,051962,晶相光永豐95購02,1.04,1.14,1.04,1.06,+0.04,3.92,187000,24,202480,0,0,0,0,0,0,27000,175000,-148000,-148000
20200212,051963,利勤永豐95購01,,,,,0.00,0.00,0,0,0,0,0,0,0,0,0,0,0,0,0
20200212,051965,傳奇永豐95購01,,,,,0.00,0.00,0,0,0,0,0,0,0,0,0,0,0,0,0
20200212,051966,台表科永豐95購01,0.89,0.98,0.88,0.98,+0.09,10.11,88000,9,81330,0,0,0,0,0,0,43000,47000,-4000,-4000
20200212,051967,康友永豐95購02,0.82,0.87,0.82,0.83,+0.07,9.21,217000,8,181860,0,0,0,0,0,0,52000,165000,-113000,-113000
20200212,051968,勤誠永豐95購01,1.29,1.29,1.17,1.27,-0.02,-1.55,177000,11,220540,0,0,0,0,0,0,10000,167000,-157000,-157000
20200212,051969,世紀鋼永豐95購01,0.89,0.94,0.89,0.92,-0.04,-4.17,128000,20,116890,0,0,0,0,0,0,128000,1000,127000,127000
20200212,05196P,台積電永豐95售03,0.38,0.39,0.38,0.38,-0.04,-9.52,1129000,4,434070,0,0,0,0,0,0,125000,1004000,-879000,-879000
20200212,051970,元黃金凱基98購01,0.62,0.62,0.62,0.62,-0.01,-1.59,10000,2,6200,0,0,0,0,0,0,0,10000,-10000,-10000
20200212,051971,元金2X凱基97購02,,,,,0.00,0.00,0,0,0,0,0,0,0,0,0,0,0,0,0
20200212,051972,廣達凱基95購02,0.38,0.38,0.38,0.38,-0.01,-2.56,60000,2,22800,0,0,0,0,0,0,0,60000,-60000,-60000
20200212,051973,華新科凱基96購04,,,,,0.00,0.00,0,0,0,0,0,0,0,0,0,0,0,0,0
20200212,051974,華新科凱基96購05,4.23,4.25,4.21,4.25,+0.18,4.42,39000,6,165510,0,0,0,0,0,0,29000,17000,12000,12000
20200212,051975,美食凱基95購02,0.15,0.16,0.15,0.16,0.00,0.00,324000,6,50190,0,0,0,0,0,0,0,324000,-324000,-324000
20200212,051976,淘帝凱基95購01,,,,,0.00,0.00,0,0,0,0,0,0,0,0,0,0,0,0,0
20200212,051977,泰碩凱基95購01,,,,,0.00,0.00,0,0,0,0,0,0,0,0,0,0,0,0,0
20200212,051978,泰碩凱基96購01,,,,,0.00,0.00,0,0,0,0,0,0,0,0,0,0,0,0,0
20200212,051979,群創凱基97購01,,,,,0.00,0.00,0,0,0,0,0,0,0,0,0,0,0,0,0
20200212,05197P,智原永豐95售02,1.28,1.28,1.28,1.28,0.00,0.00,40000,1,51200,0,0,0,0,0,0,0,40000,-40000,-40000
20200212,051980,樺漢凱基96購01,,,,,0.00,0.00,0,0,0,0,0,0,0,0,0,0,0,0,0
20200212,051981,南茂凱基96購01,0.18,0.18,0.18,0.18,0.00,0.00,150000,1,27000,0,0,0,0,0,0,150000,0,150000,150000
20200212,051982,深中小元大95購01,,,,,0.00,0.00,0,0,0,0,0,0,0,0,0,0,0,0,0
20200212,051983,道瓊反元大95購01,0.29,0.29,0.29,0.29,-0.01,-3.33,50000,1,14500,0,0,0,0,0,0,0,50000,-50000,-50000
20200212,051984,台塑元大95購01,1.44,1.44,1.44,1.44,0.00,0.00,14000,1,20160,0,0,0,0,0,0,14000,14000,0,0
20200212,051985,智邦元大95購05,1.29,1.39,1.08,1.17,+0.06,5.41,404000,40,488780,0,0,0,0,0,0,288000,263000,25000,25000
20200212,051986,燿華元大96購04,0.54,0.54,0.54,0.54,0.00,0.00,250000,1,135000,0,0,0,0,0,0,0,250000,-250000,-250000
20200212,051987,廣達元大95購01,2.00,2.15,2.00,2.15,+0.10,4.88,154000,12,322300,0,0,0,0,0,0,144000,46000,98000,98000
20200212,051988,台光電元大95購01,0.75,0.97,0.75,0.95,+0.21,28.38,497000,43,431840,0,0,0,0,0,0,163000,426000,-263000,-263000
20200212,051989,華固元大95購02,1.21,1.24,1.21,1.24,+0.05,4.2,419000,4,512990,0,0,0,0,0,0,200000,219000,-19000,-19000
20200212,05198P,牧德永豐95售02,,,,,0.00,0.00,0,0,0,0,0,0,0,0,0,0,0,0,0
20200212,051990,泰碩元大95購01,,,,,0.00,0.00,0,0,0,0,0,0,0,0,0,0,0,0,0
20200212,051991,泰碩元大95購02,0.58,0.59,0.58,0.59,0.00,0.00,44000,2,25910,0,0,0,0,0,0,5000,39000,-34000,-34000
20200212,051993,和碩元大95購03,0.38,0.44,0.38,0.44,+0.02,4.76,227000,7,90780,0,0,0,0,0,0,100000,127000,-27000,-27000
20200212,051994,瀚宇博元大96購01,0.76,0.85,0.76,0.85,+0.08,10.39,152000,4,120130,0,0,0,0,0,0,0,152000,-152000,-152000
20200212,051995,矽力元大95購03,1.55,1.76,1.55,1.76,+0.23,15.03,33000,6,53590,0,0,0,0,0,0,0,33000,-33000,-33000
20200212,051996,康友元大95購01,1.37,1.49,1.37,1.41,+0.08,6.02,466000,29,658810,0,0,0,0,0,0,173000,331000,-158000,-158000
20200212,051997,康友元大95購02,0.94,1.04,0.94,0.96,-0.02,-2.04,602000,35,603930,0,0,0,0,0,0,346000,347000,-1000,-1000
20200212,051998,昇陽半元大96購02,0.71,0.75,0.71,0.75,+0.05,7.14,83000,10,59560,0,0,0,0,0,0,83000,12000,71000,71000
20200212,051999,勤誠元大95購01,2.68,2.89,2.68,2.89,+0.17,6.25,2000,2,5570,0,0,0,0,0,0,0,2000,-2000,-2000
20200212,05199P,訊芯永豐95售02,0.91,0.91,0.89,0.89,0.00,0.00,11000,2,9810,0,0,0,0,0,0,1000,10000,-9000,-9000
20200212,052000,鈺齊元大95購03,0.65,0.74,0.65,0.74,+0.08,12.12,405000,10,291940,0,0,0,0,0,0,142000,353000,-211000,-211000
20200212,052001,寶成元大95購02,0.47,0.50,0.46,0.49,0.00,0.00,713000,10,352250,0,0,0,0,0,0,406000,307000,99000,99000
20200212,052002,滬深2X國泰96購01,,,,,0.00,0.00,0,0,0,0,0,0,0,0,0,0,0,0,0
20200212,052003,泰碩國泰97購02,0.83,0.85,0.83,0.83,-0.03,-3.49,29000,4,24230,0,0,0,0,0,0,20000,9000,11000,11000
20200212,052004,泰碩國泰97購03,0.66,0.68,0.66,0.67,-0.02,-2.9,70000,4,47100,0,0,0,0,0,0,20000,50000,-30000,-30000
20200212,052005,矽力國泰97購02,2.57,2.72,2.57,2.72,+0.20,7.94,42000,7,108630,0,0,0,0,0,0,12000,40000,-28000,-28000
20200212,052006,康友富邦98購01,0.96,1.04,0.96,1.00,+0.02,2.04,855000,42,860170,0,0,0,0,0,0,296000,771000,-475000,-475000
20200212,052007,滬深2X第一95購01,,,,,0.00,0.00,0,0,0,0,0,0,0,0,0,0,0,0,0
20200212,052008,創意第一95購01,0.37,0.38,0.34,0.36,-0.06,-14.29,325000,32,117950,0,0,0,0,0,0,295000,30000,265000,265000
20200212,052009,群創第一95購01,,,,,0.00,0.00,0,0,0,0,0,0,0,0,0,0,0,0,0
20200212,05200P,臺股指永豐95售03,0.91,0.91,0.87,0.87,0.00,0.00,125000,7,110900,0,0,0,0,0,0,0,125000,-125000,-125000
20200212,052010,兆豐金中信95購01,1.78,1.82,1.78,1.82,+0.05,2.82,103000,9,185460,0,0,0,0,0,0,70000,21000,49000,49000
20200212,052011,欣興中信96購01,0.20,0.24,0.20,0.24,+0.05,26.32,80000,7,18400,0,0,0,0,0,0,80000,0,80000,80000
20200212,052012,聯發科台新95購02,1.28,1.28,1.28,1.28,0.00,0.00,200000,2,256000,0,0,0,0,0,0,0,200000,-200000,-200000
20200212,052013,台積電永豐95購04,0.73,0.75,0.72,0.75,+0.06,8.7,884000,12,647130,0,0,0,0,0,0,620000,259000,361000,361000
20200212,052014,光罩永豐95購01,0.56,0.64,0.56,0.64,+0.08,14.29,314000,5,179840,0,0,0,0,0,0,150000,164000,-14000,-14000
20200212,052015,漢唐永豐95購02,0.61,0.62,0.61,0.62,0.00,0.00,79000,2,48940,0,0,0,0,0,0,79000,0,79000,79000
20200212,052016,神基永豐95購01,1.46,1.48,1.45,1.48,+0.05,3.5,63000,5,92570,0,0,0,0,0,0,5000,58000,-53000,-53000
20200212,052017,奇鋐永豐95購01,0.41,0.41,0.41,0.41,+0.03,7.89,165000,2,67650,0,0,0,0,0,0,0,165000,-165000,-165000
20200212,052018,京鼎永豐95購02,0.51,0.65,0.51,0.65,+0.17,35.42,400000,41,238000,0,0,0,0,0,0,53000,331000,-278000,-278000
20200212,052019,創意永豐95購02,0.41,0.41,0.41,0.41,-0.06,-12.77,4000,2,1640,0,0,0,0,0,0,4000,0,4000,4000
20200212,05201P,玉晶光國泰97售02,0.63,0.63,0.62,0.63,-0.05,-7.35,281000,6,174530,0,0,0,0,0,0,50000,231000,-181000,-181000
20200212,052020,聯茂永豐95購02,0.76,0.98,0.76,0.96,+0.25,35.21,1273000,26,1084890,0,0,0,0,0,0,905000,378000,527000,527000
20200212,052021,易華電永豐95購03,,,,,0.00,0.00,0,0,0,0,0,0,0,0,0,0,0,0,0
20200212,052022,南電永豐95購03,0.21,0.21,0.21,0.21,+0.05,31.25,18000,1,3780,0,0,0,0,0,0,18000,0,18000,18000
20200212,052023,鈺齊永豐95購02,0.30,0.30,0.30,0.30,0.00,0.00,83000,1,24900,0,0,0,0,0,0,0,83000,-83000,-83000
20200212,052024,臺股指永豐95購04,0.83,0.83,0.83,0.83,0.00,0.00,20000,1,16600,0,0,0,0,0,0,0,20000,-20000,-20000
20200212,052025,國巨群益96購01,7.25,7.25,7.05,7.20,+0.40,5.88,110000,13,781250,0,0,0,0,0,0,110000,100000,10000,10000
20200212,052026,漢唐群益95購01,2.71,2.81,2.71,2.81,+0.16,6.04,104000,5,284940,0,0,0,0,0,0,84000,20000,64000,64000
20200212,052027,智原群益95購01,0.29,0.29,0.29,0.29,+0.03,11.54,10000,1,2900,0,0,0,0,0,0,10000,0,10000,10000
20200212,052028,健策群益95購02,2.25,2.38,2.12,2.38,+0.31,14.98,321000,34,711940,0,0,0,0,0,0,267000,197000,70000,70000
20200212,052029,矽力群益95購02,,,,,0.00,0.00,0,0,0,0,0,0,0,0,0,0,0,0,0
20200212,05202P,鴻海元大95售16,2.41,2.41,2.41,2.41,-0.47,-16.32,10000,1,24100,0,0,0,0,0,0,10000,0,10000,10000
20200212,052030,GIS群益95購04,0.75,0.77,0.75,0.77,0.00,0.00,40000,9,30200,0,0,0,0,0,0,0,40000,-40000,-40000
20200212,052031,臺股指群益95購04,2.03,2.31,2.03,2.31,+0.28,13.79,9000,3,19230,0,0,0,0,0,0,6000,3000,3000,3000
20200212,052032,臺股指群益95購05,1.93,1.93,1.93,1.93,0.00,0.00,3000,1,5790,0,0,0,0,0,0,3000,0,3000,3000
20200212,052033,臺股指群益95購06,1.60,1.65,1.60,1.65,+0.15,10.0,5000,3,8090,0,0,0,0,0,0,5000,0,5000,5000
20200212,052034,臺股指群益95購07,1.56,1.56,1.56,1.56,0.00,0.00,5000,1,7800,0,0,0,0,0,0,5000,0,5000,5000
20200212,052035,臺股指群益95購08,1.57,1.57,1.57,1.57,+0.13,9.03,17000,1,26690,0,0,0,0,0,0,17000,0,17000,17000
20200212,052036,臺股指群益95購09,0.93,0.93,0.93,0.93,+0.03,3.33,60000,1,55800,0,0,0,0,0,0,60000,0,60000,60000
20200212,052037,全新國泰96購02,1.02,1.29,1.02,1.26,+0.34,36.96,192000,34,213870,0,0,0,0,0,0,87000,105000,-18000,-18000
20200212,052038,國巨永昌96購01,,,,,0.00,0.00,0,0,0,0,0,0,0,0,0,0,0,0,0
20200212,052039,聯詠永昌96購01,,,,,0.00,0.00,0,0,0,0,0,0,0,0,0,0,0,0,0
20200212,05203P,華新科元大95售10,,,,,0.00,0.00,0,0,0,0,0,0,0,0,0,0,0,0,0
20200212,052040,臺股指永昌95購01,3.93,4.11,3.93,4.11,0.00,0.00,32000,2,128640,0,0,0,0,0,0,32000,0,32000,32000
20200212,052041,鴻海日盛95購02,0.14,0.15,0.12,0.15,+0.06,66.67,403000,10,57290,0,0,0,0,0,0,328000,0,328000,328000
20200212,052042,台積電日盛95購02,2.35,2.42,2.35,2.42,+0.21,9.5,32000,6,76090,0,0,0,0,0,0,22000,10000,12000,12000
20200212,052043,瑞昱日盛95購01,0.89,1.06,0.89,0.99,+0.12,13.79,739000,39,732850,0,0,0,0,0,0,494000,383000,111000,111000
20200212,052044,華通凱基97購01,0.26,0.26,0.19,0.22,+0.08,57.14,233000,17,49560,0,0,0,0,0,0,121000,82000,39000,39000
20200212,052045,瑞昱凱基96購01,1.34,1.50,1.34,1.46,+0.15,11.45,84000,13,117930,0,0,0,0,0,0,64000,43000,21000,21000
20200212,052046,漢唐凱基96購01,,,,,0.00,0.00,0,0,0,0,0,0,0,0,0,0,0,0,0
20200212,052047,建準凱基96購01,1.12,1.12,1.08,1.08,-0.02,-1.82,5000,2,5520,0,0,0,0,0,0,0,5000,-5000,-5000
20200212,052048,景碩凱基95購01,0.54,0.77,0.08,0.67,+0.13,24.07,308000,32,192550,0,0,0,0,0,0,60000,248000,-188000,-188000
20200212,052049,緯創凱基97購01,0.35,0.35,0.35,0.35,0.00,0.00,6000,1,2100,0,0,0,0,0,0,6000,0,6000,6000
20200212,05204P,TPK元大95售03,1.14,1.14,1.07,1.07,-0.06,-5.31,19000,5,20690,0,0,0,0,0,0,0,19000,-19000,-19000
20200212,052050,明泰凱基95購01,,,,,0.00,0.00,0,0,0,0,0,0,0,0,0,0,0,0,0
20200212,052051,京鼎凱基95購01,0.77,0.88,0.77,0.88,+0.22,33.33,99000,16,81940,0,0,0,0,0,0,0,99000,-99000,-99000
20200212,052052,嘉澤凱基95購02,,,,,0.00,0.00,0,0,0,0,0,0,0,0,0,0,0,0,0
20200212,052053,泰鼎凱基96購01,1.49,1.66,1.44,1.48,+0.12,8.82,246000,22,387910,0,0,0,0,0,0,81000,165000,-84000,-84000
20200212,052054,台表科凱基96購01,0.52,0.59,0.52,0.59,0.00,0.00,160000,4,93200,0,0,0,0,0,0,10000,150000,-140000,-140000
20200212,052055,緯穎凱基95購03,3.73,3.93,3.52,3.93,+0.13,3.42,121000,11,450490,0,0,0,0,0,0,101000,95000,6000,6000
20200212,052056,緯穎凱基95購04,6.95,6.95,6.95,6.95,-0.15,-2.11,10000,1,69500,0,0,0,0,0,0,10000,0,10000,10000
20200212,052057,臺股指凱基95購15,2.65,2.97,2.63,2.97,+0.37,14.23,362000,16,995640,0,0,0,0,0,0,360000,2000,358000,358000
20200212,052058,臺股指凱基95購16,2.86,3.00,2.85,3.00,+0.17,6.01,375000,6,1094510,0,0,0,0,0,0,193000,182000,11000,11000
20200212,052059,臺股指凱基95購17,1.47,1.47,1.47,1.47,+0.17,13.08,58000,1,85260,0,0,0,0,0,0,58000,0,58000,58000
20200212,05205P,緯穎元大95售03,,,,,0.00,0.00,0,0,0,0,0,0,0,0,0,0,0,0,0
20200212,052060,旺宏國票96購02,5.10,5.10,4.87,4.96,-0.09,-1.78,33000,7,165050,0,0,0,0,0,0,16000,17000,-1000,-1000
20200212,052061,樺漢國票96購01,,,,,0.00,0.00,0,0,0,0,0,0,0,0,0,0,0,0,0
20200212,052062,臺股指國票95購09,2.90,2.90,2.90,2.90,0.00,0.00,20000,1,58000,0,0,0,0,0,0,20000,0,20000,20000
20200212,052063,臺股指國票95購10,,,,,0.00,0.00,0,0,0,0,0,0,0,0,0,0,0,0,0
20200212,052064,臺股指國票95購11,,,,,0.00,0.00,0,0,0,0,0,0,0,0,0,0,0,0,0
20200212,052065,臺股指國票95購12,1.74,1.83,1.74,1.83,+0.18,10.91,23000,3,41480,0,0,0,0,0,0,13000,10000,3000,3000
20200212,052066,華邦電兆豐96購01,0.97,1.01,0.96,0.98,+0.12,13.95,390000,10,384500,0,0,0,0,0,0,340000,50000,290000,290000
20200212,052067,中磊兆豐96購01,0.85,0.86,0.83,0.83,0.00,0.00,166000,10,141240,0,0,0,0,0,0,10000,156000,-146000,-146000
20200212,052068,瑞儀兆豐96購01,0.53,0.53,0.52,0.52,-0.01,-1.89,202000,3,106360,0,0,0,0,0,0,132000,70000,62000,62000
20200212,052069,聯茂兆豐96購01,0.51,0.67,0.51,0.61,+0.17,38.64,707000,23,416200,0,0,0,0,0,0,136000,571000,-435000,-435000
20200212,05206P,南茂元大95售01,,,,,0.00,0.00,0,0,0,0,0,0,0,0,0,0,0,0,0
20200212,052070,GIS兆豐95購03,0.55,0.57,0.55,0.57,+0.06,11.76,487000,11,272030,0,0,0,0,0,0,0,487000,-487000,-487000
20200212,052071,臺股指兆豐95購01,,,,,0.00,0.00,0,0,0,0,0,0,0,0,0,0,0,0,0
20200212,052072,健策統一95購02,2.92,3.26,2.78,3.26,+0.46,16.43,396000,43,1171280,0,0,0,0,0,0,339000,133000,206000,206000
20200212,052073,矽力統一95購03,1.88,1.99,1.88,1.99,+0.23,13.07,11000,2,20790,0,0,0,0,0,0,10000,1000,9000,9000
20200212,052074,鴻海元富95購10,,,,,0.00,0.00,0,0,0,0,0,0,0,0,0,0,0,0,0
20200212,052075,旺宏元富95購03,3.45,3.57,3.34,3.34,-0.01,-0.3,85000,4,298920,0,0,0,0,0,0,32000,53000,-21000,-21000
20200212,052076,可成元富98購01,1.47,1.62,1.47,1.62,+0.20,14.08,292000,27,450730,0,0,0,0,0,0,196000,84000,112000,112000
20200212,052077,可成元富98購02,0.89,0.97,0.89,0.97,+0.14,16.87,310000,4,294900,0,0,0,0,0,0,300000,10000,290000,290000
20200212,052078,大立光元富95購10,2.34,2.58,2.34,2.58,+0.27,11.69,48000,4,121420,0,0,0,0,0,0,11000,48000,-37000,-37000
20200212,052079,康友元富98購01,2.62,2.78,2.61,2.65,-0.01,-0.38,447000,33,1198900,0,0,0,0,0,0,154000,357000,-203000,-203000
20200212,05207P,高股息中信97售03,,,,,0.00,0.00,0,0,0,0,0,0,0,0,0,0,0,0,0
20200212,052080,康友元富98購02,2.55,2.67,2.55,2.57,0.00,0.00,199000,14,519420,0,0,0,0,0,0,39000,160000,-121000,-121000
20200212,052081,臺股指元富95購03,,,,,0.00,0.00,0,0,0,0,0,0,0,0,0,0,0,0,0
20200212,052082,臺股指元富95購04,,,,,0.00,0.00,0,0,0,0,0,0,0,0,0,0,0,0,0
20200212,052083,S&P反1元大97購02,0.18,0.18,0.18,0.18,0.00,0.00,10000,1,1800,0,0,0,0,0,0,0,10000,-10000,-10000
20200212,052084,台泥元大95購01,1.81,1.81,1.81,1.81,-0.03,-1.63,15000,1,27150,0,0,0,0,0,0,15000,15000,0,0
20200212,052085,聯電元大95購01,1.49,1.64,1.46,1.58,+0.02,1.28,211000,15,318380,0,0,0,0,0,0,164000,87000,77000,77000
20200212,052086,鴻海元大96購08,0.50,0.56,0.50,0.56,0.00,0.00,15000,6,7910,0,0,0,0,0,0,15000,0,15000,15000
20200212,052087,鴻海元大96購09,0.47,0.47,0.47,0.47,0.00,0.00,1000,1,470,0,0,0,0,0,0,0,1000,-1000,-1000
20200212,052088,漢唐元大95購02,1.51,1.58,1.51,1.58,+0.10,6.76,109000,8,169820,0,0,0,0,0,0,109000,0,109000,109000
20200212,052089,聯發科元大96購02,0.87,0.94,0.85,0.94,+0.14,17.5,255000,7,228200,0,0,0,0,0,0,215000,40000,175000,175000
20200212,05208P,TPK中信95售01,1.25,1.25,1.25,1.25,0.00,0.00,40000,1,50000,0,0,0,0,0,0,40000,0,40000,40000
20200212,052090,聯發科元大97購03,0.78,0.86,0.77,0.86,+0.15,21.13,145000,8,117290,0,0,0,0,0,0,108000,85000,23000,23000
20200212,052091,緯創元大95購04,0.85,0.85,0.85,0.85,+0.01,1.19,118000,2,100300,0,0,0,0,0,0,0,118000,-118000,-118000
20200212,052092,貿聯元大96購02,0.72,0.82,0.72,0.82,+0.10,13.89,303000,18,236040,0,0,0,0,0,0,232000,60000,172000,172000
20200212,052093,麗豐元大96購04,0.58,0.62,0.58,0.62,+0.06,10.71,260000,3,160770,0,0,0,0,0,0,10000,250000,-240000,-240000
20200212,052094,瀚宇博元大96購02,0.61,0.70,0.61,0.70,+0.07,11.11,320000,13,203500,0,0,0,0,0,0,220000,100000,120000,120000
20200212,052095,彩晶元大97購01,1.48,1.48,1.48,1.48,0.00,0.00,3000,1,4440,0,0,0,0,0,0,0,3000,-3000,-3000
20200212,052096,力成元大95購01,4.43,4.83,4.33,4.83,+1.04,27.44,49000,8,222800,0,0,0,0,0,0,31000,19000,12000,12000
20200212,052097,GIS元大95購05,0.96,1.06,0.96,1.06,+0.09,9.28,189000,11,195210,0,0,0,0,0,0,73000,167000,-94000,-94000
20200212,052098,臺股指富邦95購01,,,,,0.00,0.00,0,0,0,0,0,0,0,0,0,0,0,0,0
20200212,052099,臺股指富邦95購02,0.66,0.75,0.66,0.75,+0.11,17.19,131000,9,95500,0,0,0,0,0,0,127000,4000,123000,123000
20200212,05209P,鴻海凱基96售09,0.61,0.61,0.60,0.60,-0.13,-17.81,75000,2,45700,0,0,0,0,0,0,0,75000,-75000,-75000
20200212,052100,滬深2X永昌96購01,,,,,0.00,0.00,0,0,0,0,0,0,0,0,0,0,0,0,0
20200212,052101,滬深2X兆豐96購01,,,,,0.00,0.00,0,0,0,0,0,0,0,0,0,0,0,0,0
20200212,052102,台泥兆豐96購01,0.87,0.87,0.86,0.86,+0.04,4.88,25000,2,21700,0,0,0,0,0,0,25000,0,25000,25000
20200212,052103,台積電兆豐95購06,1.18,1.24,1.17,1.24,+0.13,11.71,243000,14,291560,0,0,0,0,0,0,145000,93000,52000,52000
20200212,052104,英業達兆豐96購01,,,,,0.00,0.00,0,0,0,0,0,0,0,0,0,0,0,0,0
20200212,052105,南亞科兆豐95購01,2.53,2.53,2.53,2.53,-0.07,-2.69,7000,1,17710,0,0,0,0,0,0,7000,0,7000,7000
20200212,052106,明泰兆豐95購01,0.49,0.49,0.49,0.49,0.00,0.00,47000,1,23030,0,0,0,0,0,0,0,47000,-47000,-47000
20200212,052107,台積電統一95購06,1.79,1.84,1.76,1.84,+0.09,5.14,764000,15,1377080,0,0,0,0,0,0,395000,369000,26000,26000
20200212,052108,鴻海元富95購11,0.24,0.31,0.24,0.30,+0.08,36.36,62000,8,16610,0,0,0,0,0,0,29000,33000,-4000,-4000
20200212,052109,可成元富95購01,,,,,0.00,0.00,0,0,0,0,0,0,0,0,0,0,0,0,0
20200212,05210P,台積電凱基95售15,,,,,0.00,0.00,0,0,0,0,0,0,0,0,0,0,0,0,0
20200212,052110,可成元富95購02,,,,,0.00,0.00,0,0,0,0,0,0,0,0,0,0,0,0,0
20200212,052111,智原元富95購01,0.33,0.33,0.33,0.33,0.00,0.00,100000,2,33000,0,0,0,0,0,0,100000,0,100000,100000
20200212,052112,滬深2X中信99購01,,,,,0.00,0.00,0,0,0,0,0,0,0,0,0,0,0,0,0
20200212,052113,漢唐中信98購01,0.68,0.71,0.68,0.71,+0.04,5.97,125000,5,86570,0,0,0,0,0,0,58000,67000,-9000,-9000
20200212,052114,華固中信95購01,0.18,0.18,0.18,0.18,+0.02,12.5,360000,22,64800,0,0,0,0,0,0,0,360000,-360000,-360000
20200212,052115,T50反1國票95購03,0.68,0.68,0.61,0.63,-0.07,-10.0,778000,21,491530,0,0,0,0,0,0,245000,533000,-288000,-288000
20200212,052116,T50反1國票97購01,,,,,0.00,0.00,0,0,0,0,0,0,0,0,0,0,0,0,0
20200212,052117,鴻海國票96購03,,,,,0.00,0.00,0,0,0,0,0,0,0,0,0,0,0,0,0
20200212,052118,鴻海國票96購04,0.18,0.18,0.18,0.18,0.00,0.00,1000,1,180,0,0,0,0,0,0,0,1000,-1000,-1000
20200212,052119,漢唐國票96購01,1.74,1.82,1.74,1.77,0.00,0.00,151000,23,270640,0,0,0,0,0,0,91000,82000,9000,9000
20200212,05211P,國巨國票96售05,,,,,0.00,0.00,0,0,0,0,0,0,0,0,0,0,0,0,0
20200212,052120,友達國票96購01,,,,,0.00,0.00,0,0,0,0,0,0,0,0,0,0,0,0,0
20200212,052121,全新國票96購03,0.80,0.97,0.80,0.97,+0.26,36.62,106000,20,94200,0,0,0,0,0,0,30000,84000,-54000,-54000
20200212,052122,新光金國票96購01,0.45,0.46,0.45,0.46,0.00,0.00,100000,5,45620,0,0,0,0,0,0,100000,0,100000,100000
20200212,052123,泰碩國票95購01,0.30,0.30,0.30,0.30,-0.03,-9.09,80000,1,24000,0,0,0,0,0,0,80000,0,80000,80000
20200212,052124,京鼎國票95購01,2.20,2.54,2.20,2.51,+0.64,34.22,173000,10,403640,0,0,0,0,0,0,20000,153000,-133000,-133000
20200212,052125,群創國票95購02,,,,,0.00,0.00,0,0,0,0,0,0,0,0,0,0,0,0,0
20200212,052126,群創國票97購01,,,,,0.00,0.00,0,0,0,0,0,0,0,0,0,0,0,0,0
20200212,052127,日月光國票96購01,0.49,0.50,0.49,0.50,+0.05,11.11,350000,2,174500,0,0,0,0,0,0,350000,0,350000,350000
20200212,052128,聯發科日盛95購03,0.34,0.38,0.34,0.38,+0.10,35.71,19000,3,7180,0,0,0,0,0,0,19000,0,19000,19000
20200212,052129,鴻海凱基97購02,0.10,0.10,0.10,0.10,0.00,0.00,90000,8,9000,0,0,0,0,0,0,0,70000,-70000,-70000
20200212,05212P,台積電國票96售04,1.14,1.15,1.14,1.15,-0.08,-6.5,10000,2,11450,0,0,0,0,0,0,5000,5000,0,0
20200212,052130,國巨凱基9B購01,3.88,3.97,3.79,3.97,+0.26,7.01,154000,48,598100,0,0,0,0,0,0,79000,43000,36000,36000
20200212,052131,台積電凱基96購01,0.55,0.61,0.55,0.61,+0.07,12.96,27000,4,15510,0,0,0,0,0,0,27000,0,27000,27000
20200212,052132,旺宏凱基9B購01,2.41,2.45,2.36,2.36,-0.05,-2.07,43000,20,103740,0,0,0,0,0,0,6000,41000,-35000,-35000
20200212,052133,華邦電凱基9B購01,0.94,0.96,0.94,0.94,+0.08,9.3,25000,5,23560,0,0,0,0,0,0,2000,23000,-21000,-21000
20200212,052134,智邦凱基95購09,1.84,1.92,1.60,1.60,+0.01,0.63,141000,14,250570,0,0,0,0,0,0,91000,64000,27000,27000
20200212,052135,聯發科凱基9B購01,1.04,1.16,1.04,1.16,+0.21,22.11,523000,21,568850,0,0,0,0,0,0,454000,55000,399000,399000
20200212,052136,瑞儀凱基95購01,0.07,0.07,0.07,0.07,0.00,0.00,10000,1,700,0,0,0,0,0,0,10000,0,10000,10000
20200212,052137,台表科凱基96購02,0.51,0.51,0.51,0.51,0.00,0.00,20000,1,10200,0,0,0,0,0,0,20000,0,20000,20000
20200212,052138,易華電凱基97購01,0.14,0.14,0.14,0.14,0.00,0.00,299000,3,41860,0,0,0,0,0,0,0,299000,-299000,-299000
20200212,052139,矽創凱基95購01,,,,,0.00,0.00,0,0,0,0,0,0,0,0,0,0,0,0,0
20200212,05213P,台積電國票96售05,0.58,0.58,0.54,0.54,-0.11,-16.92,24000,5,13080,0,0,0,0,0,0,20000,4000,16000,16000
20200212,052140,鈺齊凱基95購02,0.29,0.29,0.29,0.29,+0.02,7.41,100000,1,29000,0,0,0,0,0,0,100000,0,100000,100000
20200212,052141,百和凱基95購02,,,,,0.00,0.00,0,0,0,0,0,0,0,0,0,0,0,0,0
20200212,052142,滬深2X群益99購04,1.12,1.13,1.11,1.13,-0.01,-0.88,502000,9,564160,0,0,0,0,0,0,267000,235000,32000,32000
20200212,052143,鴻海群益95購09,0.37,0.37,0.37,0.37,0.00,0.00,98000,1,36260,0,0,0,0,0,0,0,98000,-98000,-98000
20200212,052144,鴻海群益95購10,0.05,0.06,0.05,0.06,+0.02,50.0,269000,3,14450,0,0,0,0,0,0,269000,0,269000,269000
20200212,052145,京元電群益95購02,0.64,0.66,0.61,0.65,0.00,0.00,30000,13,19190,0,0,0,0,0,0,30000,0,30000,30000
20200212,052146,泰碩群益95購01,,,,,0.00,0.00,0,0,0,0,0,0,0,0,0,0,0,0,0
20200212,052147,上緯控群益95購01,0.70,0.70,0.66,0.67,-0.02,-2.9,192000,6,130200,0,0,0,0,0,0,87000,105000,-18000,-18000
20200212,052148,康友群益95購03,1.97,2.12,1.97,2.04,+0.20,10.87,73000,11,151370,0,0,0,0,0,0,10000,73000,-63000,-63000
20200212,052149,電子類群益95購01,2.09,2.37,2.09,2.34,+0.37,18.78,190000,7,415200,0,0,0,0,0,0,170000,20000,150000,150000
20200212,05214P,台積電國票97售02,0.11,0.14,0.09,0.14,-0.02,-12.5,566000,11,53700,0,0,0,0,0,0,0,0,0,0
20200212,052150,台積電富邦95購07,0.46,0.50,0.46,0.49,+0.05,11.36,3326000,97,1581290,0,0,0,0,0,0,2295000,630000,1665000,1665000
20200212,052151,義隆富邦96購01,,,,,0.00,0.00,0,0,0,0,0,0,0,0,0,0,0,0,0
20200212,052152,創意富邦98購01,0.64,0.64,0.53,0.58,-0.06,-9.38,737000,73,412270,0,0,0,0,0,0,500000,233000,267000,267000
20200212,052153,GIS富邦96購02,0.39,0.41,0.39,0.41,0.00,0.00,469000,7,184740,0,0,0,0,0,0,0,469000,-469000,-469000
20200212,052154,緯創台新95購01,0.87,0.92,0.87,0.92,0.00,0.00,42000,2,37790,0,0,0,0,0,0,0,42000,-42000,-42000
20200212,052155,百和台新95購01,,,,,0.00,0.00,0,0,0,0,0,0,0,0,0,0,0,0,0
20200212,052156,滬深2X永豐95購03,,,,,0.00,0.00,0,0,0,0,0,0,0,0,0,0,0,0,0
20200212,052157,東元永豐95購01,,,,,0.00,0.00,0,0,0,0,0,0,0,0,0,0,0,0,0
20200212,052158,華泰永豐95購01,,,,,0.00,0.00,0,0,0,0,0,0,0,0,0,0,0,0,0
20200212,052159,瑞昱永豐95購01,1.39,1.56,1.39,1.48,+0.11,8.03,147000,22,219340,0,0,0,0,0,0,69000,115000,-46000,-46000
20200212,05215P,台積電台新95售03,0.20,0.20,0.18,0.19,-0.04,-17.39,50000,5,9810,0,0,0,0,0,0,24000,26000,-2000,-2000
20200212,052160,美律永豐95購03,0.45,0.46,0.45,0.46,0.00,0.00,90000,2,40950,0,0,0,0,0,0,0,90000,-90000,-90000
20200212,052161,義隆永豐95購03,,,,,0.00,0.00,0,0,0,0,0,0,0,0,0,0,0,0,0
20200212,052162,智伸科永豐95購01,0.42,0.42,0.42,0.42,0.00,0.00,1000,1,420,0,0,0,0,0,0,0,1000,-1000,-1000
20200212,052163,康舒永豐95購02,0.93,0.95,0.92,0.92,0.00,0.00,209000,6,196970,0,0,0,0,0,0,21000,188000,-167000,-167000
20200212,052164,啟碁永豐95購01,0.66,0.66,0.66,0.66,+0.05,8.2,25000,1,16500,0,0,0,0,0,0,0,25000,-25000,-25000
20200212,052165,訊芯永豐95購03,0.39,0.45,0.39,0.45,+0.08,21.62,70000,5,30600,0,0,0,0,0,0,0,70000,-70000,-70000
20200212,052166,元油反元大95購01,1.42,1.42,1.42,1.42,-0.10,-6.58,10000,1,14200,0,0,0,0,0,0,0,10000,-10000,-10000
20200212,052167,亞泥元大96購01,1.69,1.72,1.69,1.72,+0.03,1.78,157000,4,265460,0,0,0,0,0,0,157000,5000,152000,152000
20200212,052168,鴻海元大96購10,,,,,0.00,0.00,0,0,0,0,0,0,0,0,0,0,0,0,0
20200212,052169,鴻海元大97購02,0.44,0.54,0.44,0.54,+0.13,31.71,40000,3,19600,0,0,0,0,0,0,40000,0,40000,40000
20200212,05216P,國巨永豐95售02,,,,,0.00,0.00,0,0,0,0,0,0,0,0,0,0,0,0,0
20200212,052170,台積電元大95購20,3.31,3.50,3.31,3.47,+0.37,11.94,98000,19,329430,0,0,0,0,0,0,80000,59000,21000,21000
20200212,052171,台積電元大95購21,3.77,3.82,3.72,3.82,+0.16,4.37,185000,35,696100,0,0,0,0,0,0,185000,183000,2000,2000
20200212,052172,致茂元大95購01,1.70,1.94,1.70,1.94,+0.33,20.5,391000,10,680660,0,0,0,0,0,0,237000,154000,83000,83000
20200212,052173,廣達元大95購02,1.38,1.50,1.38,1.50,+0.08,5.63,239000,13,352620,0,0,0,0,0,0,239000,56000,183000,183000
20200212,052174,聯發科元大95購13,,,,,0.00,0.00,0,0,0,0,0,0,0,0,0,0,0,0,0
20200212,052175,可成元大95購10,0.22,0.22,0.22,0.22,0.00,0.00,100000,1,22000,0,0,0,0,0,0,100000,0,100000,100000
20200212,052176,景碩元大96購01,0.68,0.83,0.68,0.75,+0.13,20.97,719000,36,543150,0,0,0,0,0,0,114000,574000,-460000,-460000
20200212,052177,京鼎元大95購02,1.16,1.41,1.16,1.36,+0.31,29.52,916000,56,1175250,0,0,0,0,0,0,272000,869000,-597000,-597000
20200212,052178,台郡元大96購03,1.07,1.10,0.94,1.10,+0.52,89.66,243000,23,256870,0,0,0,0,0,0,210000,13000,197000,197000
20200212,052179,康友元大95購03,1.18,1.28,1.18,1.21,0.00,0.00,527000,27,657650,0,0,0,0,0,0,227000,443000,-216000,-216000
20200212,05217P,鴻海統一95售08,,,,,0.00,0.00,0,0,0,0,0,0,0,0,0,0,0,0,0
20200212,052180,緯穎元大96購05,3.44,3.71,3.27,3.66,+0.16,4.57,311000,39,1099760,0,0,0,0,0,0,288000,293000,-5000,-5000
20200212,052181,南茂元大95購05,0.37,0.39,0.37,0.39,+0.01,2.63,1784000,11,682060,0,0,0,0,0,0,1384000,400000,984000,984000
20200212,052182,鴻海群益96購01,1.14,1.24,1.14,1.24,0.00,0.00,152000,3,180280,0,0,0,0,0,0,70000,82000,-12000,-12000
20200212,052183,華邦電群益95購01,0.22,0.23,0.22,0.22,+0.05,29.41,30000,5,6720,0,0,0,0,0,0,0,30000,-30000,-30000
20200212,052184,台光電群益95購03,1.45,1.83,1.45,1.70,+0.33,24.09,365000,63,593450,0,0,0,0,0,0,91000,287000,-196000,-196000
20200212,052185,奇力新群益95購03,3.65,3.70,3.60,3.70,+0.21,6.02,8000,7,29200,0,0,0,0,0,0,8000,8000,0,0
20200212,052186,宏達電群益95購04,0.85,0.85,0.85,0.85,0.00,0.00,11000,1,9350,0,0,0,0,0,0,0,11000,-11000,-11000
20200212,052187,奇鋐群益95購03,,,,,0.00,0.00,0,0,0,0,0,0,0,0,0,0,0,0,0
20200212,052188,欣興群益95購03,,,,,0.00,0.00,0,0,0,0,0,0,0,0,0,0,0,0,0
20200212,052189,玉晶光群益96購06,,,,,0.00,0.00,0,0,0,0,0,0,0,0,0,0,0,0,0
20200212,05218P,大立光永昌96售04,3.10,3.10,2.89,2.90,-0.29,-9.09,175000,14,519400,0,0,0,0,0,0,167000,158000,9000,9000
20200212,052190,創意群益95購03,0.31,0.32,0.29,0.32,-0.04,-11.11,88000,6,26830,0,0,0,0,0,0,0,88000,-88000,-88000
20200212,052191,超眾群益96購01,4.44,4.60,4.37,4.52,+0.18,4.15,120000,24,534840,0,0,0,0,0,0,120000,43000,77000,77000
20200212,052192,SP黃豆元富95購04,0.52,0.52,0.52,0.52,0.00,0.00,20000,1,10400,0,0,0,0,0,0,0,20000,-20000,-20000
20200212,052193,國巨元富95購06,5.45,5.60,5.20,5.55,+0.40,7.77,382000,28,2046300,0,0,0,0,0,0,359000,121000,238000,238000
20200212,052194,旺宏元富95購04,2.15,2.15,2.05,2.05,-0.08,-3.76,185000,6,396650,0,0,0,0,0,0,180000,5000,175000,175000
20200212,052195,健策元富95購01,3.55,3.77,3.38,3.77,+0.44,13.21,1436000,80,5138040,0,0,0,0,0,0,891000,518000,373000,373000
20200212,052196,TPK元富95購01,0.36,0.42,0.36,0.42,+0.06,16.67,170000,3,66300,0,0,0,0,0,0,50000,120000,-70000,-70000
20200212,052197,台郡元富95購03,0.38,0.45,0.38,0.45,+0.24,114.29,536000,33,227550,0,0,0,0,0,0,154000,298000,-144000,-144000
20200212,052198,鴻海統一95購10,,,,,0.00,0.00,0,0,0,0,0,0,0,0,0,0,0,0,0
20200212,052199,鴻海統一95購11,,,,,0.00,0.00,0,0,0,0,0,0,0,0,0,0,0,0,0
20200212,05219P,鴻海元大95售17,4.10,4.10,3.67,3.67,-0.51,-12.2,365000,26,1390680,0,0,0,0,0,0,258000,359000,-101000,-101000
20200212,052200,台光電統一95購02,1.80,2.32,1.80,2.20,+0.45,25.71,826000,35,1663200,0,0,0,0,0,0,95000,752000,-657000,-657000
20200212,052201,超眾統一96購01,3.51,3.84,3.43,3.78,+0.20,5.59,250000,29,886450,0,0,0,0,0,0,233000,17000,216000,216000
20200212,052202,矽力統一96購01,,,,,0.00,0.00,0,0,0,0,0,0,0,0,0,0,0,0,0
20200212,052203,T50反1中信99購03,,,,,0.00,0.00,0,0,0,0,0,0,0,0,0,0,0,0,0
20200212,052204,台泥中信96購01,0.54,0.54,0.54,0.54,-0.03,-5.26,42000,1,22680,0,0,0,0,0,0,42000,0,42000,42000
20200212,052205,台積電中信95購09,0.96,1.02,0.96,1.02,+0.10,10.87,488000,17,481340,0,0,0,0,0,0,2000,486000,-484000,-484000
20200212,052206,燿華中信95購02,,,,,0.00,0.00,0,0,0,0,0,0,0,0,0,0,0,0,0
20200212,052207,台郡中信95購02,0.74,0.76,0.73,0.76,+0.30,65.22,214000,25,157860,0,0,0,0,0,0,30000,164000,-134000,-134000
20200212,052208,力成麥證95購01,1.48,1.54,1.36,1.47,+0.19,14.84,263000,25,383200,30000,161000,-131000,0,0,0,30000,161000,-131000,-131000
20200212,052209,深中小元大95購02,0.94,1.01,0.94,1.01,+0.14,16.09,517000,9,494290,0,0,0,0,0,0,80000,437000,-357000,-357000
20200212,05220P,台積電元大95售16,,,,,0.00,0.00,0,0,0,0,0,0,0,0,0,0,0,0,0
20200212,052210,華夏元大95購01,0.80,0.80,0.80,0.80,+0.01,1.27,38000,1,30400,0,0,0,0,0,0,38000,0,38000,38000
20200212,052211,台積電元大95購22,1.99,2.02,1.96,2.02,+0.16,8.6,90000,11,179100,0,0,0,0,0,0,59000,70000,-11000,-11000
20200212,052212,可成元大95購11,0.52,0.60,0.52,0.60,+0.10,20.0,321000,10,181740,0,0,0,0,0,0,210000,111000,99000,99000
20200212,052213,富邦金元大95購01,1.65,1.65,1.61,1.61,+0.13,8.78,126000,6,205880,0,0,0,0,0,0,50000,76000,-26000,-26000
20200212,052214,智伸科元大96購01,0.67,0.68,0.67,0.67,+0.01,1.52,105000,4,71250,0,0,0,0,0,0,100000,5000,95000,95000
20200212,052215,樺漢元大96購02,0.72,0.72,0.72,0.72,+0.02,2.86,3000,1,2160,0,0,0,0,0,0,3000,0,3000,3000
20200212,052216,康友元大96購01,1.88,2.00,1.88,1.97,+0.13,7.07,81000,6,159320,0,0,0,0,0,0,78000,3000,75000,75000
20200212,052217,台光電日盛95購01,0.54,0.75,0.54,0.71,+0.19,36.54,231000,44,155550,0,0,0,0,0,0,23000,208000,-185000,-185000
20200212,052218,大立光日盛95購01,1.52,1.52,1.52,1.52,+0.12,8.57,59000,1,89680,0,0,0,0,0,0,0,59000,-59000,-59000
20200212,052219,大立光日盛95購02,,,,,0.00,0.00,0,0,0,0,0,0,0,0,0,0,0,0,0
20200212,05221P,玉晶光元大95售04,0.22,0.22,0.21,0.21,-0.03,-12.5,20000,2,4350,0,0,0,0,0,0,0,20000,-20000,-20000
20200212,052220,T50反1凱基98購01,0.39,0.39,0.36,0.36,-0.06,-14.29,66000,5,24640,0,0,0,0,0,0,0,66000,-66000,-66000
20200212,052221,東元凱基95購01,,,,,0.00,0.00,0,0,0,0,0,0,0,0,0,0,0,0,0
20200212,052222,力山凱基95購02,,,,,0.00,0.00,0,0,0,0,0,0,0,0,0,0,0,0,0
20200212,052223,聯電凱基96購02,1.70,1.82,1.70,1.82,+0.11,6.43,76000,9,130640,0,0,0,0,0,0,60000,22000,38000,38000
20200212,052224,楠梓電凱基97購01,0.66,0.66,0.66,0.66,0.00,0.00,1000,1,660,0,0,0,0,0,0,0,1000,-1000,-1000
20200212,052225,台積電凱基96購03,0.43,0.49,0.43,0.47,+0.04,9.3,1543000,31,696910,0,0,0,0,0,0,1364000,0,1364000,1364000
20200212,052226,旺宏凱基95購06,2.23,2.27,2.15,2.15,-0.06,-2.71,14000,5,31430,0,0,0,0,0,0,14000,4000,10000,10000
20200212,052227,瑞昱凱基95購05,1.24,1.38,0.39,1.38,+0.18,15.0,258000,15,318970,0,0,0,0,0,0,248000,22000,226000,226000
20200212,052228,聯發科凱基96購06,0.78,0.89,0.10,0.89,+0.23,34.85,74000,6,18020,0,0,0,0,0,0,14000,0,14000,14000
20200212,052229,奇力新凱基96購01,2.94,3.08,2.94,3.08,+0.08,2.67,42000,16,126410,0,0,0,0,0,0,31000,10000,21000,21000
20200212,05222P,致伸凱基95售02,,,,,0.00,0.00,0,0,0,0,0,0,0,0,0,0,0,0,0
20200212,052230,大立光凱基96購09,2.38,2.78,2.38,2.78,+0.44,18.8,26000,8,70900,0,0,0,0,0,0,23000,23000,0,0
20200212,052231,景碩凱基96購01,0.99,1.29,0.96,1.25,+0.30,31.58,60000,16,72790,0,0,0,0,0,0,2000,58000,-56000,-56000
20200212,052232,貿聯凱基96購02,,,,,0.00,0.00,0,0,0,0,0,0,0,0,0,0,0,0,0
20200212,052233,台郡凱基96購01,0.27,0.45,0.27,0.44,+0.28,175.0,949000,54,292050,0,0,0,0,0,0,482000,18000,464000,464000
20200212,052234,GIS凱基97購01,,,,,0.00,0.00,0,0,0,0,0,0,0,0,0,0,0,0,0
20200212,052235,聯發科國票96購02,0.87,1.04,0.87,1.04,+0.26,33.33,28000,4,26510,0,0,0,0,0,0,18000,10000,8000,8000
20200212,052236,聯發科國票96購03,1.39,1.49,1.39,1.49,+0.27,22.13,15000,2,21350,0,0,0,0,0,0,10000,5000,5000,5000
20200212,052237,嘉澤國票96購02,,,,,0.00,0.00,0,0,0,0,0,0,0,0,0,0,0,0,0
20200212,052238,智易國票96購01,1.05,1.18,1.05,1.18,0.00,0.00,80000,3,85300,0,0,0,0,0,0,0,80000,-80000,-80000
20200212,052239,泰鼎國票97購01,2.15,2.31,2.13,2.29,+0.32,16.24,328000,40,731880,0,0,0,0,0,0,26000,302000,-276000,-276000
20200212,05223P,臻鼎凱基95售02,1.78,2.00,1.78,2.00,-0.19,-8.68,65000,6,123000,0,0,0,0,0,0,25000,40000,-15000,-15000
20200212,052240,臻鼎國票96購03,1.03,1.03,0.74,0.74,+0.17,29.82,43000,4,41080,0,0,0,0,0,0,10000,33000,-23000,-23000
20200212,052241,台郡國票96購01,3.44,3.53,3.37,3.53,+1.77,100.57,198000,17,676000,0,0,0,0,0,0,176000,22000,154000,154000
20200212,052242,台達電台新96購01,1.24,1.26,1.19,1.26,+0.04,3.28,94000,4,116910,0,0,0,0,0,0,19000,75000,-56000,-56000
20200212,052243,致茂康和95購01,0.95,1.10,0.95,1.10,+0.19,20.88,963000,38,970650,0,0,0,0,0,0,434000,524000,-90000,-90000
20200212,052244,廣達康和95購01,0.48,0.55,0.48,0.55,+0.01,1.85,196000,5,100160,0,0,0,0,0,0,90000,106000,-16000,-16000
20200212,052245,緯創康和95購01,0.33,0.33,0.33,0.33,0.00,0.00,68000,1,22440,0,0,0,0,0,0,0,68000,-68000,-68000
20200212,052246,超眾康和95購01,1.42,1.45,1.39,1.44,0.00,0.00,220000,18,313460,0,0,0,0,0,0,200000,30000,170000,170000
20200212,052247,深中小永豐95購01,1.87,1.90,1.87,1.90,+0.13,7.34,32000,3,60140,0,0,0,0,0,0,0,32000,-32000,-32000
20200212,052248,元油反永豐95購01,,,,,0.00,0.00,0,0,0,0,0,0,0,0,0,0,0,0,0
20200212,052249,大成鋼永豐95購01,0.81,0.87,0.81,0.87,+0.02,2.35,77000,7,65470,0,0,0,0,0,0,32000,47000,-15000,-15000
20200212,05224P,華通統一95售03,2.13,2.13,1.86,1.86,-0.47,-20.17,453000,21,867240,0,0,0,0,0,0,0,453000,-453000,-453000
20200212,052250,光磊永豐95購01,0.55,0.55,0.53,0.55,-0.01,-1.79,345000,19,188860,0,0,0,0,0,0,335000,10000,325000,325000
20200212,052251,台光電永豐95購03,0.53,0.66,0.53,0.66,0.00,0.00,392000,7,238070,0,0,0,0,0,0,0,392000,-392000,-392000
20200212,052252,大立光永豐95購03,2.43,2.61,2.43,2.61,+0.09,3.57,21000,2,53730,0,0,0,0,0,0,15000,6000,9000,9000
20200212,052253,康控永豐95購04,0.45,0.52,0.45,0.52,+0.07,15.56,422000,16,197440,0,0,0,0,0,0,318000,104000,214000,214000
20200212,052254,康友永豐95購03,1.68,1.79,1.68,1.79,+0.10,5.92,223000,13,389810,0,0,0,0,0,0,110000,146000,-36000,-36000
20200212,052255,T50反1國泰96購01,0.29,0.29,0.29,0.29,-0.02,-6.45,30000,1,8700,0,0,0,0,0,0,30000,0,30000,30000
20200212,052256,台泥國泰96購01,2.68,2.77,2.68,2.77,+0.02,0.73,20000,3,54500,0,0,0,0,0,0,20000,0,20000,20000
20200212,052257,燿華國泰96購01,0.55,0.60,0.55,0.60,+0.06,11.11,152000,12,86020,0,0,0,0,0,0,50000,102000,-52000,-52000
20200212,052258,滬深2X富邦96購04,,,,,0.00,0.00,0,0,0,0,0,0,0,0,0,0,0,0,0
20200212,052259,深100富邦95購01,0.53,0.53,0.53,0.53,+0.03,6.0,5000,1,2650,0,0,0,0,0,0,0,5000,-5000,-5000
20200212,05225P,鴻海統一95售09,1.41,1.44,1.35,1.35,-0.22,-14.01,342000,6,483100,0,0,0,0,0,0,300000,42000,258000,258000
20200212,052260,為升富邦97購02,0.65,0.67,0.65,0.66,+0.01,1.54,65000,4,42450,0,0,0,0,0,0,10000,25000,-15000,-15000
20200212,052261,台泥第一95購01,,,,,0.00,0.00,0,0,0,0,0,0,0,0,0,0,0,0,0
20200212,052262,華新亞東95購02,0.54,0.54,0.54,0.54,+0.04,8.0,137000,2,73980,0,0,0,0,0,0,48000,89000,-41000,-41000
20200212,052263,聯電亞東95購01,1.70,1.70,1.70,1.70,-0.11,-6.08,60000,15,102000,0,0,0,0,0,0,60000,0,60000,60000
20200212,052264,台達電亞東96購01,,,,,0.00,0.00,0,0,0,0,0,0,0,0,0,0,0,0,0
20200212,052265,聯發科亞東95購01,,,,,0.00,0.00,0,0,0,0,0,0,0,0,0,0,0,0,0
20200212,052266,義隆亞東95購02,,,,,0.00,0.00,0,0,0,0,0,0,0,0,0,0,0,0,0
20200212,052267,可成亞東95購02,0.30,0.34,0.30,0.34,0.00,0.00,108000,4,34800,0,0,0,0,0,0,0,108000,-108000,-108000
20200212,052268,新光金亞東96購01,,,,,0.00,0.00,0,0,0,0,0,0,0,0,0,0,0,0,0
20200212,052269,T50反1日盛9B購01,0.45,0.45,0.43,0.43,-0.06,-12.24,61000,7,26820,0,0,0,0,0,0,53000,8000,45000,45000
20200212,05226P,智邦統一95售01,1.16,1.16,1.16,1.16,0.00,0.00,60000,1,69600,0,0,0,0,0,0,0,60000,-60000,-60000
20200212,052270,力成日盛95購01,1.77,2.00,1.77,1.99,+0.44,28.39,420000,17,788080,0,0,0,0,0,0,1000,417000,-416000,-416000
20200212,052271,力成日盛95購02,1.30,1.44,1.29,1.38,+0.29,26.61,581000,42,785900,0,0,0,0,0,0,37000,545000,-508000,-508000
20200212,052272,T50反1群益95購03,,,,,0.00,0.00,0,0,0,0,0,0,0,0,0,0,0,0,0
20200212,052273,新光金群益95購02,0.49,0.49,0.49,0.49,+0.01,2.08,74000,1,36260,0,0,0,0,0,0,0,74000,-74000,-74000
20200212,052274,大立光群益95購03,3.02,3.17,3.00,3.17,+0.40,14.44,42000,8,129130,0,0,0,0,0,0,13000,29000,-16000,-16000
20200212,052275,日月光群益95購01,0.94,1.05,0.94,1.02,+0.31,43.66,140000,20,139340,0,0,0,0,0,0,0,140000,-140000,-140000
20200212,052276,力成群益96購01,5.55,6.15,5.55,6.10,+0.85,16.19,109000,26,631950,0,0,0,0,0,0,31000,102000,-71000,-71000
20200212,052277,台達電凱基97購01,0.90,0.91,0.90,0.91,+0.02,2.25,164000,5,147720,0,0,0,0,0,0,12000,152000,-140000,-140000
20200212,052278,國巨凱基95購06,6.65,6.75,6.40,6.75,+0.65,10.66,44000,6,292850,0,0,0,0,0,0,29000,15000,14000,14000
20200212,052279,旺宏凱基95購07,2.14,2.14,2.05,2.05,0.00,0.00,8000,4,16890,0,0,0,0,0,0,3000,8000,-5000,-5000
20200212,05227P,大立光統一95售04,,,,,0.00,0.00,0,0,0,0,0,0,0,0,0,0,0,0,0
20200212,052280,聯發科凱基95購11,1.02,1.07,1.00,1.07,+0.17,18.89,50000,4,52300,0,0,0,0,0,0,40000,10000,30000,30000
20200212,052281,全新凱基97購01,0.67,0.78,0.67,0.78,+0.21,36.84,362000,10,265450,0,0,0,0,0,0,21000,276000,-255000,-255000
20200212,052282,宏達電凱基95購05,1.05,1.05,1.05,1.05,+0.03,2.94,68000,1,71400,0,0,0,0,0,0,0,68000,-68000,-68000
20200212,052283,TPK凱基97購01,,,,,0.00,0.00,0,0,0,0,0,0,0,0,0,0,0,0,0
20200212,052284,日月光凱基96購01,0.70,0.76,0.70,0.76,+0.15,24.59,169000,3,119940,0,0,0,0,0,0,0,169000,-169000,-169000
20200212,052285,康控凱基95購02,0.40,0.40,0.40,0.40,+0.06,17.65,35000,4,14000,0,0,0,0,0,0,20000,15000,5000,5000
20200212,052286,力成凱基95購02,0.97,1.11,0.93,1.11,+0.28,33.73,127000,11,125520,0,0,0,0,0,0,85000,42000,43000,43000
20200212,052287,臺股指中信95購12,,,,,0.00,0.00,0,0,0,0,0,0,0,0,0,0,0,0,0
20200212,052288,敦南統一95購01,,,,,0.00,0.00,0,0,0,0,0,0,0,0,0,0,0,0,0
20200212,052289,為升元富95購02,1.16,1.19,1.15,1.18,+0.02,1.72,387000,8,454450,0,0,0,0,0,0,206000,181000,25000,25000
20200212,05228P,大立光元富95售09,1.64,1.64,1.62,1.62,0.00,0.00,3000,2,4900,0,0,0,0,0,0,0,3000,-3000,-3000
20200212,052290,鴻海元富97購01,0.41,0.49,0.41,0.49,+0.11,28.95,45000,4,19650,0,0,0,0,0,0,45000,0,45000,45000
20200212,052291,鴻海元富97購02,0.21,0.25,0.21,0.25,+0.07,38.89,247000,5,54860,0,0,0,0,0,0,235000,12000,223000,223000
20200212,052292,緯穎元富95購02,2.55,2.81,2.52,2.81,+0.30,11.95,15000,4,38430,0,0,0,0,0,0,7000,8000,-1000,-1000
20200212,052293,泰碩國票95購03,0.50,0.50,0.50,0.50,-0.23,-31.51,20000,1,10000,0,0,0,0,0,0,0,0,0,0
20200212,052294,創意國票96購03,1.12,1.12,1.03,1.03,-0.26,-20.16,42000,8,46300,0,0,0,0,0,0,42000,0,42000,42000
20200212,052295,揚明光國票96購03,1.24,1.24,1.24,1.24,0.00,0.00,29000,1,35960,0,0,0,0,0,0,0,29000,-29000,-29000
20200212,052296,TPK國票96購01,0.27,0.31,0.27,0.30,+0.03,11.11,2016000,12,571630,0,0,0,0,0,0,1298000,718000,580000,580000
20200212,052297,旭富國票96購01,2.22,2.85,2.18,2.26,+0.14,6.6,757000,75,1801950,0,0,0,0,0,0,182000,565000,-383000,-383000
20200212,052298,易華電國票96購01,,,,,0.00,0.00,0,0,0,0,0,0,0,0,0,0,0,0,0
20200212,052299,T50反1台新05購03,,,,,0.00,0.00,0,0,0,0,0,0,0,0,0,0,0,0,0
20200212,05229P,台積電群益95售05,0.98,1.00,0.94,0.95,-0.11,-10.38,819000,31,802930,0,0,0,0,0,0,55000,764000,-709000,-709000
20200212,052300,力成台新95購01,3.02,3.22,3.02,3.22,0.00,0.00,162000,12,508580,0,0,0,0,0,0,0,162000,-162000,-162000
20200212,052301,華通康和95購01,,,,,0.00,0.00,0,0,0,0,0,0,0,0,0,0,0,0,0
20200212,052302,鴻海永豐95購06,,,,,0.00,0.00,0,0,0,0,0,0,0,0,0,0,0,0,0
20200212,052303,聯發科永豐95購05,0.36,0.37,0.36,0.37,+0.09,32.14,30000,2,11000,0,0,0,0,0,0,10000,20000,-10000,-10000
20200212,052304,可成永豐95購03,,,,,0.00,0.00,0,0,0,0,0,0,0,0,0,0,0,0,0
20200212,052305,GIS永豐95購03,0.70,0.75,0.70,0.72,+0.03,4.35,196000,12,139220,0,0,0,0,0,0,40000,161000,-121000,-121000
20200212,052306,鴻海國泰97購05,0.14,0.24,0.14,0.24,0.00,0.00,44000,4,9460,0,0,0,0,0,0,21000,0,21000,21000
20200212,052307,潤泰全國泰96購01,0.90,0.93,0.90,0.93,-0.02,-2.11,100000,10,92000,0,0,0,0,0,0,0,100000,-100000,-100000
20200212,052308,大立光國泰97購02,1.69,1.78,1.69,1.78,0.00,0.00,69000,3,117780,0,0,0,0,0,0,60000,9000,51000,51000
20200212,052309,健策國泰97購01,2.62,2.79,2.53,2.79,+0.30,12.05,638000,60,1670750,0,0,0,0,0,0,526000,52000,474000,474000
20200212,05230P,京元電群益95售01,2.85,2.85,2.78,2.78,-0.13,-4.47,42000,7,118350,0,0,0,0,0,0,6000,36000,-30000,-30000
20200212,052310,聯電富邦95購01,1.60,1.70,1.60,1.67,-0.04,-2.34,147000,19,235370,0,0,0,0,0,0,145000,2000,143000,143000
20200212,052311,台積電富邦95購09,1.09,1.12,1.09,1.12,+0.09,8.74,88000,3,97000,0,0,0,0,0,0,88000,0,88000,88000
20200212,052312,美律富邦96購02,0.38,0.46,0.38,0.46,+0.12,35.29,767000,27,310840,0,0,0,0,0,0,76000,691000,-615000,-615000
20200212,052313,聯電元大98購01,1.86,2.00,1.84,1.95,0.00,0.00,157000,21,299090,0,0,0,0,0,0,60000,120000,-60000,-60000
20200212,052314,鴻海元大96購11,0.39,0.48,0.39,0.48,+0.09,23.08,3888000,71,1718850,0,0,0,0,0,0,3306000,307000,2999000,2999000
20200212,052315,廣宇元大95購02,0.67,0.67,0.67,0.67,0.00,0.00,1000,1,670,0,0,0,0,0,0,0,1000,-1000,-1000
20200212,052316,台積電元大96購10,1.39,1.47,1.39,1.44,+0.08,5.88,506000,23,715190,0,0,0,0,0,0,446000,70000,376000,376000
20200212,052317,台積電元大96購11,1.42,1.42,1.39,1.40,+0.06,4.48,168000,8,234170,0,0,0,0,0,0,153000,15000,138000,138000
20200212,052318,友達元大98購01,3.08,3.08,3.08,3.08,0.00,0.00,10000,1,30800,0,0,0,0,0,0,0,10000,-10000,-10000
20200212,052319,可成元大95購12,0.66,0.73,0.65,0.73,+0.13,21.67,584000,16,395380,0,0,0,0,0,0,367000,416000,-49000,-49000
20200212,05231P,GIS群益95售03,2.00,2.03,2.00,2.03,-0.18,-8.14,22000,3,44180,0,0,0,0,0,0,0,22000,-22000,-22000
20200212,052320,緯創元大95購05,1.25,1.26,1.25,1.26,0.00,0.00,39000,5,48840,0,0,0,0,0,0,27000,21000,6000,6000
20200212,052321,華擎元大95購01,6.35,6.35,5.85,5.90,-0.05,-0.84,64000,8,386650,0,0,0,0,0,0,29000,35000,-6000,-6000
20200212,052322,力成元大96購01,2.00,2.16,1.91,2.16,+0.39,22.03,1000000,65,2042650,0,0,0,0,0,0,528000,698000,-170000,-170000
20200212,052323,矽力元大95購04,2.25,2.29,2.25,2.29,0.00,0.00,2000,2,4540,0,0,0,0,0,0,0,2000,-2000,-2000
20200212,052324,康友元大96購02,2.14,2.28,2.14,2.18,0.00,0.00,392000,28,861830,0,0,0,0,0,0,161000,302000,-141000,-141000
20200212,052325,高股息中信99購01,2.71,2.75,2.71,2.75,+0.12,4.56,6000,4,16340,0,0,0,0,0,0,6000,0,6000,6000
20200212,052326,滬深反中信99購01,0.94,0.96,0.94,0.95,0.00,0.00,159000,9,151920,0,0,0,0,0,0,100000,59000,41000,41000
20200212,052327,聯詠中信95購03,0.88,0.95,0.87,0.88,+0.06,7.32,250000,12,230490,0,0,0,0,0,0,135000,115000,20000,20000
20200212,052328,台表科中信99購01,0.40,0.43,0.40,0.43,+0.02,4.88,25000,3,10600,0,0,0,0,0,0,10000,15000,-5000,-5000
20200212,052329,台積電亞東96購01,,,,,0.00,0.00,0,0,0,0,0,0,0,0,0,0,0,0,0
20200212,05232P,緯穎群益95售01,,,,,0.00,0.00,0,0,0,0,0,0,0,0,0,0,0,0,0
20200212,052330,燿華亞東95購01,,,,,0.00,0.00,0,0,0,0,0,0,0,0,0,0,0,0,0
20200212,052331,漢唐亞東97購01,1.86,1.86,1.85,1.85,0.00,0.00,40000,2,74300,0,0,0,0,0,0,0,40000,-40000,-40000
20200212,052332,美律亞東96購01,1.09,1.11,1.09,1.11,0.00,0.00,90000,2,99000,0,0,0,0,0,0,0,90000,-90000,-90000
20200212,052333,嘉聯益兆豐96購01,0.38,0.38,0.37,0.37,+0.03,8.82,154000,2,58480,0,0,0,0,0,0,0,154000,-154000,-154000
20200212,052334,大成鋼日盛95購01,,,,,0.00,0.00,0,0,0,0,0,0,0,0,0,0,0,0,0
20200212,052335,新光金日盛95購02,0.59,0.59,0.58,0.59,+0.02,3.51,369000,40,217240,0,0,0,0,0,0,329000,40000,289000,289000
20200212,052336,矽力日盛95購01,2.11,2.11,2.11,2.11,0.00,0.00,1000,1,2110,0,0,0,0,0,0,0,1000,-1000,-1000
20200212,052337,臺股指日盛95購02,0.75,0.84,0.75,0.84,+0.09,12.0,74000,5,59910,0,0,0,0,0,0,61000,13000,48000,48000
20200212,052338,道瓊反凱基97購02,,,,,0.00,0.00,0,0,0,0,0,0,0,0,0,0,0,0,0
20200212,052339,光寶科凱基95購01,0.62,0.64,0.03,0.63,+0.01,1.61,606000,9,276350,0,0,0,0,0,0,422000,184000,238000,238000
20200212,05233P,台郡台新95售02,0.46,0.47,0.44,0.44,0.00,0.00,169000,3,76830,0,0,0,0,0,0,0,169000,-169000,-169000
20200212,052340,燿華凱基96購01,,,,,0.00,0.00,0,0,0,0,0,0,0,0,0,0,0,0,0
20200212,052341,泰鼎凱基96購02,2.00,2.08,1.87,1.91,+0.17,9.77,382000,22,772790,0,0,0,0,0,0,286000,216000,70000,70000
20200212,052342,茂林凱基96購01,1.85,1.85,1.82,1.85,+0.09,5.11,76000,24,140510,0,0,0,0,0,0,56000,20000,36000,36000
20200212,052343,同欣電凱基95購03,1.49,1.74,1.49,1.50,+0.01,0.67,132000,16,212530,0,0,0,0,0,0,81000,66000,15000,15000
20200212,052344,台表科凱基98購01,0.36,0.36,0.36,0.36,+0.04,12.5,19000,4,6840,0,0,0,0,0,0,10000,9000,1000,1000
20200212,052345,矽力凱基95購01,2.21,2.38,2.21,2.38,+0.37,18.41,40000,2,90950,0,0,0,0,0,0,25000,15000,10000,10000
20200212,052346,訊芯凱基95購01,0.49,0.59,0.49,0.59,+0.12,25.53,166000,5,91070,0,0,0,0,0,0,69000,97000,-28000,-28000
20200212,052347,GIS凱基95購05,,,,,0.00,0.00,0,0,0,0,0,0,0,0,0,0,0,0,0
20200212,052348,台光電富邦95購01,0.51,0.51,0.51,0.51,0.00,0.00,13000,2,6630,0,0,0,0,0,0,0,0,0,0
20200212,052349,鴻海統一95購15,0.87,0.94,0.87,0.94,+0.10,11.9,101000,5,91590,0,0,0,0,0,0,53000,48000,5000,5000
20200212,05234P,美食康和95售01,1.20,1.20,1.09,1.15,-0.17,-12.88,617000,22,695130,0,0,0,0,0,0,416000,201000,215000,215000
20200212,052350,鴻海統一96購06,0.07,0.07,0.07,0.07,+0.03,75.0,5000,1,350,0,0,0,0,0,0,5000,0,5000,5000
20200212,052351,中環元富95購01,0.61,0.61,0.59,0.59,-0.10,-14.49,595000,44,360260,0,0,0,0,0,0,590000,0,590000,590000
20200212,052352,力成元富95購01,1.82,2.09,1.82,2.09,+0.44,26.67,60000,12,122770,0,0,0,0,0,0,0,60000,-60000,-60000
20200212,052353,高鐵群益97購01,1.23,1.25,1.20,1.25,0.00,0.00,32000,3,39280,0,0,0,0,0,0,11000,21000,-10000,-10000
20200212,052354,健策群益96購02,2.87,3.07,2.73,3.07,+0.39,14.55,428000,51,1238770,0,0,0,0,0,0,287000,336000,-49000,-49000
20200212,052355,為升永豐95購02,0.70,0.70,0.70,0.70,+0.03,4.48,45000,1,31500,0,0,0,0,0,0,45000,0,45000,45000
20200212,052356,聯詠永豐95購03,,,,,0.00,0.00,0,0,0,0,0,0,0,0,0,0,0,0,0
20200212,052357,揚明光永豐95購03,,,,,0.00,0.00,0,0,0,0,0,0,0,0,0,0,0,0,0
20200212,052358,台表科永豐95購02,,,,,0.00,0.00,0,0,0,0,0,0,0,0,0,0,0,0,0
20200212,052359,百和永豐95購01,,,,,0.00,0.00,0,0,0,0,0,0,0,0,0,0,0,0,0
20200212,05235P,健鼎康和95售02,1.01,1.01,0.85,0.86,-0.24,-21.82,181000,7,174210,0,0,0,0,0,0,33000,148000,-115000,-115000
20200212,052360,FB上証國票96購01,0.68,0.68,0.68,0.68,+0.02,3.03,8000,1,5440,0,0,0,0,0,0,0,8000,-8000,-8000
20200212,052361,大成鋼國票96購01,,,,,0.00,0.00,0,0,0,0,0,0,0,0,0,0,0,0,0
20200212,052362,瑞昱國票96購02,,,,,0.00,0.00,0,0,0,0,0,0,0,0,0,0,0,0,0
20200212,052363,廣達國票96購01,0.94,1.04,0.94,1.04,+0.07,7.22,20000,2,19800,0,0,0,0,0,0,20000,0,20000,20000
20200212,052364,全新國票95購02,1.11,1.42,1.11,1.39,+0.40,40.4,388000,20,520680,0,0,0,0,0,0,129000,240000,-111000,-111000
20200212,052365,聯詠國票95購02,0.76,0.79,0.71,0.71,+0.05,7.58,75000,7,57510,0,0,0,0,0,0,45000,30000,15000,15000
20200212,052366,聯詠國票96購01,0.89,0.94,0.89,0.93,+0.13,16.25,60000,8,55360,0,0,0,0,0,0,60000,0,60000,60000
20200212,052367,聯茂國票96購02,1.28,1.76,1.28,1.51,+0.32,26.89,1190000,36,1832060,0,0,0,0,0,0,994000,166000,828000,828000
20200212,052368,力成國票96購01,3.19,3.36,3.19,3.36,+0.34,11.26,119000,4,390140,0,0,0,0,0,0,60000,59000,1000,1000
20200212,052369,矽力國票96購02,4.44,5.05,4.44,5.00,+0.62,14.16,45000,5,214930,0,0,0,0,0,0,30000,29000,1000,1000
20200212,05236P,緯穎康和95售01,,,,,0.00,0.00,0,0,0,0,0,0,0,0,0,0,0,0,0
20200212,052370,滬深2X元大95購04,0.68,0.68,0.68,0.68,-0.04,-5.56,20000,1,13600,0,0,0,0,0,0,0,20000,-20000,-20000
20200212,052371,元金2X元大95購01,0.49,0.49,0.48,0.48,-0.01,-2.04,12000,2,5860,0,0,0,0,0,0,2000,10000,-8000,-8000
20200212,052372,台泥元大95購02,0.94,0.94,0.94,0.94,0.00,0.00,100000,2,94000,0,0,0,0,0,0,100000,0,100000,100000
20200212,052373,鴻海元大95購22,0.60,0.60,0.60,0.60,0.00,0.00,4000,1,2400,0,0,0,0,0,0,4000,0,4000,4000
20200212,052374,瑞昱元大95購02,3.15,3.61,3.15,3.34,+0.24,7.74,183000,28,613760,0,0,0,0,0,0,83000,123000,-40000,-40000
20200212,052375,奇力新元大96購02,3.03,3.15,2.91,3.15,+0.10,3.28,508000,111,1536440,0,0,0,0,0,0,491000,410000,81000,81000
20200212,052376,聯詠元大95購04,1.01,1.15,1.01,1.06,+0.07,7.07,163000,17,180580,0,0,0,0,0,0,138000,25000,113000,113000
20200212,052377,景碩元大96購02,1.49,1.77,1.41,1.65,+0.21,14.58,1051000,78,1612960,0,0,0,0,0,0,741000,720000,21000,21000
20200212,052378,矽力元大96購01,4.71,5.00,4.71,5.00,+1.02,25.63,31000,5,154310,0,0,0,0,0,0,26000,21000,5000,5000
20200212,052379,鈺齊元大95購04,0.73,0.85,0.73,0.85,+0.12,16.44,459000,9,377630,0,0,0,0,0,0,34000,458000,-424000,-424000
20200212,05237P,為升永豐95售01,0.97,0.98,0.97,0.98,-0.02,-2.0,60000,10,58620,0,0,0,0,0,0,60000,0,60000,60000
20200212,052380,臺股指元大95購21,2.25,2.25,2.25,2.25,+0.14,6.64,87000,1,195750,0,0,0,0,0,0,87000,0,87000,87000
20200212,052381,臺股指元大95購22,,,,,0.00,0.00,0,0,0,0,0,0,0,0,0,0,0,0,0
20200212,052382,臺股指元大95購23,,,,,0.00,0.00,0,0,0,0,0,0,0,0,0,0,0,0,0
20200212,052383,臺股指元大95購29,1.72,1.80,1.72,1.80,+0.20,12.5,9000,3,15920,0,0,0,0,0,0,9000,0,9000,9000
20200212,052384,臺股指元大95購30,,,,,0.00,0.00,0,0,0,0,0,0,0,0,0,0,0,0,0
20200212,052385,滬深2X群益99購05,1.51,1.51,1.44,1.49,-0.03,-1.97,480000,29,710850,0,0,0,0,0,0,315000,175000,140000,140000
20200212,052386,鴻海群益96購02,1.75,2.12,1.75,2.12,+0.42,24.71,917000,15,1797450,0,0,0,0,0,0,95000,822000,-727000,-727000
20200212,052387,台積電群益95購08,5.20,5.40,5.15,5.40,+0.30,5.88,352000,46,1833550,0,0,0,0,0,0,267000,337000,-70000,-70000
20200212,052388,旺宏群益96購05,4.85,4.93,4.71,4.71,+0.06,1.29,26000,3,125920,0,0,0,0,0,0,20000,6000,14000,14000
20200212,052389,聯發科群益95購05,0.68,0.72,0.68,0.70,+0.16,29.63,197000,3,135960,0,0,0,0,0,0,98000,99000,-1000,-1000
20200212,05238P,禾伸堂永豐95售01,0.85,0.90,0.85,0.90,0.00,0.00,156000,5,134870,0,0,0,0,0,0,116000,40000,76000,76000
20200212,052390,聯詠群益95購03,1.04,1.07,1.02,1.06,+0.17,19.1,70000,4,72940,0,0,0,0,0,0,64000,6000,58000,58000
20200212,052391,瑞儀群益95購01,0.53,0.55,0.53,0.55,0.00,0.00,33000,3,17930,0,0,0,0,0,0,0,33000,-33000,-33000
20200212,052392,台表科群益96購02,0.57,0.63,0.56,0.62,+0.06,10.71,235000,10,135240,0,0,0,0,0,0,107000,123000,-16000,-16000
20200212,052393,康友群益95購05,2.13,2.24,2.11,2.17,+0.05,2.36,89000,13,191860,0,0,0,0,0,0,71000,49000,22000,22000
20200212,052394,滬深2X日盛95購01,,,,,0.00,0.00,0,0,0,0,0,0,0,0,0,0,0,0,0
20200212,052395,上証2X凱基97購01,,,,,0.00,0.00,0,0,0,0,0,0,0,0,0,0,0,0,0
20200212,052396,台積電凱基97購01,4.26,4.38,4.26,4.38,+0.35,8.68,11000,2,48060,0,0,0,0,0,0,11000,0,11000,11000
20200212,052397,燿華凱基96購02,0.15,0.15,0.15,0.15,+0.01,7.14,20000,1,3000,0,0,0,0,0,0,0,20000,-20000,-20000
20200212,052398,瑞昱凱基95購06,1.02,1.02,0.95,0.99,+0.15,17.86,83000,6,83070,0,0,0,0,0,0,65000,23000,42000,42000
20200212,052399,台光電凱基95購03,0.56,0.75,0.56,0.70,+0.18,34.62,307000,11,199320,0,0,0,0,0,0,282000,18000,264000,264000
20200212,05239P,欣興永豐95售03,1.96,1.96,1.62,1.62,-0.42,-20.59,49000,6,90420,0,0,0,0,0,0,0,49000,-49000,-49000
20200212,052400,聯詠凱基97購01,0.69,0.73,0.69,0.73,+0.10,15.87,1164000,11,817750,0,0,0,0,0,0,1030000,14000,1016000,1016000
20200212,052401,智原凱基95購01,0.19,0.20,0.19,0.20,+0.03,17.65,2000,2,390,0,0,0,0,0,0,0,2000,-2000,-2000
20200212,052402,健策凱基97購01,1.35,1.46,1.28,1.46,+0.15,11.45,639000,29,866330,0,0,0,0,0,0,545000,494000,51000,51000
20200212,052403,麗豐凱基96購01,0.11,0.13,0.11,0.13,+0.01,8.33,132000,3,16360,0,0,0,0,0,0,127000,5000,122000,122000
20200212,052404,臻鼎凱基95購05,0.81,0.81,0.68,0.68,+0.10,17.24,170000,4,137440,0,0,0,0,0,0,168000,2000,166000,166000
20200212,052405,聯茂凱基95購01,0.52,0.53,0.52,0.53,+0.20,60.61,13000,3,6830,0,0,0,0,0,0,0,13000,-13000,-13000
20200212,052406,力成凱基95購03,1.80,1.98,1.80,1.98,0.00,0.00,25000,3,47450,0,0,0,0,0,0,5000,15000,-10000,-10000
20200212,052407,樺漢凱基95購01,0.16,0.16,0.16,0.16,+0.01,6.67,10000,1,1600,0,0,0,0,0,0,10000,0,10000,10000
20200212,052408,羅麗芬凱基95購01,,,,,0.00,0.00,0,0,0,0,0,0,0,0,0,0,0,0,0
20200212,052409,國巨亞東95購01,,,,,0.00,0.00,0,0,0,0,0,0,0,0,0,0,0,0,0
20200212,05240P,玉晶光永豐96售01,0.59,0.59,0.58,0.58,0.00,0.00,20000,2,11700,0,0,0,0,0,0,0,20000,-20000,-20000
20200212,052410,智邦亞東96購01,,,,,0.00,0.00,0,0,0,0,0,0,0,0,0,0,0,0,0
20200212,052411,嘉聯益亞東95購02,0.58,0.58,0.58,0.58,+0.03,5.45,48000,1,27840,0,0,0,0,0,0,48000,0,48000,48000
20200212,052412,上証2X中信98購01,,,,,0.00,0.00,0,0,0,0,0,0,0,0,0,0,0,0,0
20200212,052413,上証反中信97購01,1.08,1.08,1.06,1.06,-0.06,-5.36,58000,4,61960,0,0,0,0,0,0,58000,0,58000,58000
20200212,052414,聯電麥證95購01,0.82,0.97,0.80,0.92,+0.01,1.1,302000,32,259540,259000,24000,235000,0,0,0,259000,24000,235000,235000
20200212,052415,台表科麥證95購02,0.37,0.37,0.37,0.37,+0.04,12.12,10000,1,3700,10000,0,10000,0,0,0,10000,0,10000,10000
20200212,052416,滬深2X兆豐96購02,0.60,0.60,0.60,0.60,-0.02,-3.23,5000,1,3000,0,0,0,0,0,0,0,5000,-5000,-5000
20200212,052417,聯發科兆豐9B購01,1.61,1.62,1.58,1.60,+0.24,17.65,84000,8,134670,0,0,0,0,0,0,10000,74000,-64000,-64000
20200212,052418,玉晶光兆豐96購01,,,,,0.00,0.00,0,0,0,0,0,0,0,0,0,0,0,0,0
20200212,052419,上証2X國票96購02,,,,,0.00,0.00,0,0,0,0,0,0,0,0,0,0,0,0,0
20200212,05241P,鴻海國泰97售04,1.65,1.65,1.65,1.65,-0.11,-6.25,5000,1,8250,0,0,0,0,0,0,5000,5000,0,0
20200212,052420,道瓊反國票9B購01,,,,,0.00,0.00,0,0,0,0,0,0,0,0,0,0,0,0,0
20200212,052421,元油反國票9B購01,0.80,0.80,0.78,0.78,-0.05,-6.02,15000,3,11900,0,0,0,0,0,0,0,15000,-15000,-15000
20200212,052422,聯電國票96購03,1.85,1.92,1.85,1.92,-0.01,-0.52,83000,8,155160,0,0,0,0,0,0,83000,0,83000,83000
20200212,052423,宏達電國票96購02,2.02,2.02,2.02,2.02,+0.08,4.12,6000,1,12120,0,0,0,0,0,0,6000,6000,0,0
20200212,052424,泰碩國票97購01,1.12,1.12,1.12,1.12,-0.05,-4.27,63000,2,70560,0,0,0,0,0,0,23000,40000,-17000,-17000
20200212,052425,華通台新95購02,0.19,0.26,0.19,0.26,+0.09,52.94,359000,2,68350,0,0,0,0,0,0,357000,2000,355000,355000
20200212,052426,國巨台新96購01,,,,,0.00,0.00,0,0,0,0,0,0,0,0,0,0,0,0,0
20200212,052427,上証2X永豐96購01,0.21,0.21,0.21,0.21,0.00,0.00,30000,1,6300,0,0,0,0,0,0,0,30000,-30000,-30000
20200212,052428,嘉晶永豐95購01,0.86,0.96,0.86,0.96,0.00,0.00,236000,9,217600,0,0,0,0,0,0,0,236000,-236000,-236000
20200212,052429,禾伸堂永豐95購02,1.59,1.60,1.56,1.60,+0.01,0.63,99000,6,156620,0,0,0,0,0,0,69000,30000,39000,39000
20200212,05242P,群創國泰97售01,,,,,0.00,0.00,0,0,0,0,0,0,0,0,0,0,0,0,0
20200212,052430,泰碩永豐95購02,0.20,0.20,0.20,0.20,0.00,0.00,30000,1,6000,0,0,0,0,0,0,30000,0,30000,30000
20200212,052431,茂林永豐95購03,,,,,0.00,0.00,0,0,0,0,0,0,0,0,0,0,0,0,0
20200212,052432,康友永豐95購04,1.60,1.71,1.60,1.69,+0.09,5.62,149000,10,247790,0,0,0,0,0,0,47000,135000,-88000,-88000
20200212,052433,滬深2X國泰96購02,1.15,1.15,1.15,1.15,+0.04,3.6,5000,1,5750,0,0,0,0,0,0,5000,0,5000,5000
20200212,052434,茂林國泰97購01,,,,,0.00,0.00,0,0,0,0,0,0,0,0,0,0,0,0,0
20200212,052435,滬深2X富邦96購05,0.17,0.18,0.17,0.18,-0.02,-10.0,221000,7,38980,0,0,0,0,0,0,0,221000,-221000,-221000
20200212,052436,正崴富邦95購01,,,,,0.00,0.00,0,0,0,0,0,0,0,0,0,0,0,0,0
20200212,052437,聯發科富邦99購02,0.84,0.94,0.84,0.93,+0.14,17.72,166000,8,150550,0,0,0,0,0,0,71000,91000,-20000,-20000
20200212,052438,瑞儀富邦95購01,,,,,0.00,0.00,0,0,0,0,0,0,0,0,0,0,0,0,0
20200212,052439,寶成富邦97購01,0.39,0.41,0.38,0.40,0.00,0.00,431000,14,170900,0,0,0,0,0,0,311000,120000,191000,191000
20200212,05243P,鴻海元大95售19,3.53,3.63,3.17,3.17,-0.67,-17.45,262000,21,911530,0,0,0,0,0,0,240000,262000,-22000,-22000
20200212,052440,上証2X元大95購02,,,,,0.00,0.00,0,0,0,0,0,0,0,0,0,0,0,0,0
20200212,052441,亞泥元大95購01,1.78,1.79,1.76,1.76,0.00,0.00,75000,4,132130,0,0,0,0,0,0,25000,55000,-30000,-30000
20200212,052442,中環元大95購02,0.62,0.62,0.60,0.60,-0.07,-10.45,400000,20,243000,0,0,0,0,0,0,400000,0,400000,400000
20200212,052443,台積電元大95購23,2.52,2.59,2.52,2.59,+0.15,6.15,44000,2,113680,0,0,0,0,0,0,44000,4000,40000,40000
20200212,052444,友訊元大95購01,1.20,1.20,1.18,1.18,-0.05,-4.07,20000,2,23800,0,0,0,0,0,0,10000,10000,0,0
20200212,052445,南亞科元大95購05,3.36,3.36,3.29,3.32,-0.03,-0.9,63000,13,210050,0,0,0,0,0,0,63000,9000,54000,54000
20200212,052446,聯發科元大96購03,0.75,0.80,0.75,0.80,+0.14,21.21,103000,10,79970,0,0,0,0,0,0,73000,30000,43000,43000
20200212,052447,聯發科元大96購04,1.16,1.25,1.16,1.25,+0.19,17.92,84000,10,102980,0,0,0,0,0,0,24000,74000,-50000,-50000
20200212,052448,新光金元大96購03,0.79,0.79,0.79,0.79,+0.02,2.6,251000,10,198290,0,0,0,0,0,0,251000,0,251000,251000
20200212,052449,創意元大95購04,0.47,0.50,0.47,0.49,-0.04,-7.55,129000,9,61160,0,0,0,0,0,0,53000,76000,-23000,-23000
20200212,05244P,台積電元大95售17,0.93,0.93,0.88,0.88,-0.14,-13.73,1110000,24,1014250,0,0,0,0,0,0,768000,908000,-140000,-140000
20200212,052450,嘉澤元大95購03,0.99,0.99,0.86,0.88,-0.04,-4.35,133000,12,122650,0,0,0,0,0,0,33000,103000,-70000,-70000
20200212,052451,旭富元大95購02,1.19,1.51,1.13,1.19,+0.12,11.21,2051000,141,2651750,0,0,0,0,0,0,646000,1287000,-641000,-641000
20200212,052452,茂林元大95購03,2.64,2.70,2.61,2.64,+0.08,3.12,108000,27,286140,0,0,0,0,0,0,96000,84000,12000,12000
20200212,052453,崇越元大95購01,1.42,1.57,1.42,1.54,+0.17,12.41,221000,10,337280,0,0,0,0,0,0,29000,192000,-163000,-163000
20200212,052454,力成元大95購02,3.03,3.20,3.03,3.20,0.00,0.00,108000,7,330310,0,0,0,0,0,0,95000,13000,82000,82000
20200212,052455,樺漢元大96購03,0.71,0.71,0.71,0.71,+0.05,7.58,100000,1,71000,0,0,0,0,0,0,0,100000,-100000,-100000
20200212,052456,滬深2X元富9B購03,0.67,0.67,0.65,0.67,-0.02,-2.9,273000,12,182080,0,0,0,0,0,0,21000,249000,-228000,-228000
20200212,052457,日月光元富95購01,2.08,2.11,2.08,2.10,+0.23,12.3,70000,3,146400,0,0,0,0,0,0,40000,30000,10000,10000
20200212,052458,T50反1統一97購01,,,,,0.00,0.00,0,0,0,0,0,0,0,0,0,0,0,0,0
20200212,052459,道瓊反統一95購04,,,,,0.00,0.00,0,0,0,0,0,0,0,0,0,0,0,0,0
20200212,05245P,台積電元大95售18,0.72,0.74,0.68,0.68,-0.12,-15.0,467000,8,331660,0,0,0,0,0,0,230000,247000,-17000,-17000
20200212,052460,元油反統一95購01,,,,,0.00,0.00,0,0,0,0,0,0,0,0,0,0,0,0,0
20200212,052461,和大統一95購01,1.62,1.64,1.62,1.64,-0.07,-4.09,180000,2,292600,0,0,0,0,0,0,130000,50000,80000,80000
20200212,052462,上銀統一95購03,,,,,0.00,0.00,0,0,0,0,0,0,0,0,0,0,0,0,0
20200212,052463,聯電統一96購01,1.74,1.86,1.74,1.86,+0.16,9.41,129000,6,227430,0,0,0,0,0,0,0,129000,-129000,-129000
20200212,052464,大立光統一95購05,2.27,2.62,2.27,2.62,+0.39,17.49,259000,22,616300,0,0,0,0,0,0,101000,158000,-57000,-57000
20200212,052465,聯詠統一95購02,0.63,0.67,0.63,0.67,+0.08,13.56,11000,3,7330,0,0,0,0,0,0,1000,10000,-9000,-9000
20200212,052466,聯詠統一95購03,0.67,0.69,0.67,0.69,+0.07,11.29,220000,4,151420,0,0,0,0,0,0,220000,0,220000,220000
20200212,052467,嘉聯益統一96購01,0.78,0.83,0.78,0.79,+0.08,11.27,106000,4,84220,0,0,0,0,0,0,72000,48000,24000,24000
20200212,052468,超眾統一96購02,1.26,1.40,1.26,1.40,+0.05,3.7,1026000,35,1346900,0,0,0,0,0,0,573000,453000,120000,120000
20200212,052469,宏碁亞東95購01,0.62,0.62,0.62,0.62,0.00,0.00,48000,1,29760,0,0,0,0,0,0,48000,0,48000,48000
20200212,05246P,南電元大95售04,,,,,0.00,0.00,0,0,0,0,0,0,0,0,0,0,0,0,0
20200212,052470,華新科亞東97購01,,,,,0.00,0.00,0,0,0,0,0,0,0,0,0,0,0,0,0
20200212,052471,華固亞東95購01,0.59,0.59,0.59,0.59,0.00,0.00,20000,2,11800,0,0,0,0,0,0,0,20000,-20000,-20000
20200212,052472,和碩亞東95購01,,,,,0.00,0.00,0,0,0,0,0,0,0,0,0,0,0,0,0
20200212,052473,臻鼎亞東95購01,,,,,0.00,0.00,0,0,0,0,0,0,0,0,0,0,0,0,0
20200212,052474,T50反1群益95購04,,,,,0.00,0.00,0,0,0,0,0,0,0,0,0,0,0,0,0
20200212,052475,滬深2X群益99購06,,,,,0.00,0.00,0,0,0,0,0,0,0,0,0,0,0,0,0
20200212,052476,台光電群益98購01,0.72,0.86,0.72,0.82,+0.16,24.24,461000,42,372210,0,0,0,0,0,0,263000,188000,75000,75000
20200212,052477,美律群益98購01,0.74,0.88,0.74,0.85,+0.17,25.0,843000,43,680100,0,0,0,0,0,0,426000,428000,-2000,-2000
20200212,052478,大立光群益95購05,3.60,3.97,3.60,3.97,+0.49,14.08,134000,12,512360,0,0,0,0,0,0,41000,93000,-52000,-52000
20200212,052479,TPK群益95購04,,,,,0.00,0.00,0,0,0,0,0,0,0,0,0,0,0,0,0
20200212,05247P,上銀群益95售01,,,,,0.00,0.00,0,0,0,0,0,0,0,0,0,0,0,0,0
20200212,052480,麗豐群益95購01,0.32,0.32,0.31,0.31,+0.03,10.71,40000,3,12600,0,0,0,0,0,0,20000,20000,0,0
20200212,052481,利勤群益95購01,,,,,0.00,0.00,0,0,0,0,0,0,0,0,0,0,0,0,0
20200212,052482,茂林群益95購01,3.05,3.10,3.00,3.10,+0.10,3.33,42000,5,127700,0,0,0,0,0,0,30000,12000,18000,18000
20200212,052483,超眾群益95購03,1.61,1.82,1.58,1.82,+0.19,11.66,422000,45,695510,0,0,0,0,0,0,355000,119000,236000,236000
20200212,052484,矽創群益95購02,0.54,0.68,0.54,0.68,0.00,0.00,199000,24,125490,0,0,0,0,0,0,0,199000,-199000,-199000
20200212,052485,深中小國票96購01,1.94,1.94,1.94,1.94,0.00,0.00,10000,1,19400,0,0,0,0,0,0,0,10000,-10000,-10000
20200212,052486,元油反國票96購01,,,,,0.00,0.00,0,0,0,0,0,0,0,0,0,0,0,0,0
20200212,052487,國巨國票96購07,,,,,0.00,0.00,0,0,0,0,0,0,0,0,0,0,0,0,0
20200212,052488,旺宏國票96購03,,,,,0.00,0.00,0,0,0,0,0,0,0,0,0,0,0,0,0
20200212,052489,義隆國票96購02,1.52,1.53,1.45,1.53,+0.26,20.47,60000,7,88640,0,0,0,0,0,0,60000,10000,50000,50000
20200212,05248P,矽創群益96售01,1.80,1.80,1.79,1.79,-0.09,-4.79,36000,3,64450,0,0,0,0,0,0,36000,0,36000,36000
20200212,052490,禾伸堂國票95購01,,,,,0.00,0.00,0,0,0,0,0,0,0,0,0,0,0,0,0
20200212,052491,泰碩國票99購01,0.89,0.89,0.89,0.89,-0.02,-2.2,27000,1,24030,0,0,0,0,0,0,27000,0,27000,27000
20200212,052492,易華電國票96購02,,,,,0.00,0.00,0,0,0,0,0,0,0,0,0,0,0,0,0
20200212,052493,上証2X中信97購02,,,,,0.00,0.00,0,0,0,0,0,0,0,0,0,0,0,0,0
20200212,052494,百和中信95購02,0.79,0.79,0.79,0.79,0.00,0.00,30000,1,23700,0,0,0,0,0,0,0,30000,-30000,-30000
20200212,052495,滬深2X台新95購01,,,,,0.00,0.00,0,0,0,0,0,0,0,0,0,0,0,0,0
20200212,052496,華通台新96購02,0.49,0.51,0.47,0.47,0.00,0.00,195000,4,96150,0,0,0,0,0,0,0,195000,-195000,-195000
20200212,052497,楠梓電永豐96購01,0.46,0.50,0.46,0.50,0.00,0.00,154000,5,70980,0,0,0,0,0,0,0,154000,-154000,-154000
20200212,052498,台積電永豐95購06,1.51,1.57,1.51,1.57,0.00,0.00,24000,4,37500,0,0,0,0,0,0,4000,0,4000,4000
20200212,052499,合勤控永豐95購01,0.22,0.22,0.22,0.22,0.00,0.00,31000,3,6820,0,0,0,0,0,0,31000,0,31000,31000
20200212,05249P,臻鼎國票95售01,1.84,2.14,1.67,2.14,-0.40,-15.75,263000,9,514440,0,0,0,0,0,0,239000,24000,215000,215000
20200212,052500,元翎永豐95購01,0.14,0.14,0.14,0.14,+0.02,16.67,10000,1,1400,0,0,0,0,0,0,0,10000,-10000,-10000
20200212,052501,茂林永豐95購04,0.76,0.81,0.75,0.81,+0.01,1.25,186000,10,147860,0,0,0,0,0,0,136000,50000,86000,86000
20200212,052502,瀚宇博永豐95購02,0.48,0.48,0.48,0.48,0.00,0.00,48000,1,23040,0,0,0,0,0,0,0,48000,-48000,-48000
20200212,052503,大成鋼日盛95購02,,,,,0.00,0.00,0,0,0,0,0,0,0,0,0,0,0,0,0
20200212,052504,鴻海日盛95購03,0.45,0.58,0.45,0.58,+0.20,52.63,1838000,545,859110,0,0,0,0,0,0,1782000,17000,1765000,1765000
20200212,052505,友達日盛9B購02,,,,,0.00,0.00,0,0,0,0,0,0,0,0,0,0,0,0,0
20200212,052506,日月光日盛95購01,0.70,0.81,0.70,0.81,+0.16,24.62,460000,15,341330,0,0,0,0,0,0,0,460000,-460000,-460000
20200212,052507,日月光日盛95購02,0.64,0.76,0.64,0.76,0.00,0.00,364000,13,249480,0,0,0,0,0,0,0,364000,-364000,-364000
20200212,052508,矽力日盛95購02,2.22,2.51,2.17,2.51,+0.36,16.74,170000,10,395640,0,0,0,0,0,0,54000,116000,-62000,-62000
20200212,052509,鴻海凱基96購10,0.18,0.20,0.18,0.20,0.00,0.00,209000,2,41600,0,0,0,0,0,0,209000,0,209000,209000
20200212,05250P,臻鼎國票96售01,2.13,2.65,2.13,2.65,-0.43,-13.96,30000,5,69260,0,0,0,0,0,0,8000,22000,-14000,-14000
20200212,052510,聯發科凱基95購13,,,,,0.00,0.00,0,0,0,0,0,0,0,0,0,0,0,0,0
20200212,052511,聯發科凱基95購14,0.88,1.02,0.88,1.02,+0.29,39.73,136000,4,129880,0,0,0,0,0,0,68000,68000,0,0
20200212,052512,全新凱基96購03,0.81,0.86,0.81,0.86,+0.31,56.36,184000,7,155180,0,0,0,0,0,0,15000,184000,-169000,-169000
20200212,052513,大立光凱基95購13,1.38,1.38,1.38,1.38,+0.13,10.4,58000,1,80040,0,0,0,0,0,0,0,58000,-58000,-58000
20200212,052514,嘉澤凱基96購01,0.73,0.73,0.65,0.65,-0.05,-7.14,79000,4,56990,0,0,0,0,0,0,68000,4000,64000,64000
20200212,052515,矽力凱基95購02,2.31,2.31,2.31,2.31,0.00,0.00,2000,1,4620,0,0,0,0,0,0,2000,0,2000,2000
20200212,052516,臺股指凱基95購20,2.20,2.35,2.20,2.35,+0.21,9.81,370000,6,835840,0,0,0,0,0,0,191000,179000,12000,12000
20200212,052517,滬深2X元大95購05,,,,,0.00,0.00,0,0,0,0,0,0,0,0,0,0,0,0,0
20200212,052518,道瓊反元大95購02,,,,,0.00,0.00,0,0,0,0,0,0,0,0,0,0,0,0,0
20200212,052519,旺宏元大95購05,4.78,4.78,4.78,4.78,+0.03,0.63,1000,1,4780,0,0,0,0,0,0,1000,1000,0,0
20200212,05251P,喬山台新95售02,1.04,1.04,0.99,0.99,-0.09,-8.33,38000,5,39270,0,0,0,0,0,0,33000,5000,28000,28000
20200212,052520,南亞科元大95購06,,,,,0.00,0.00,0,0,0,0,0,0,0,0,0,0,0,0,0
20200212,052521,友達元大9B購01,,,,,0.00,0.00,0,0,0,0,0,0,0,0,0,0,0,0,0
20200212,052522,聯發科元大96購05,0.64,0.69,0.64,0.69,+0.13,23.21,15000,2,9850,0,0,0,0,0,0,10000,5000,5000,5000
20200212,052523,奇力新元大97購01,2.93,3.10,2.86,3.10,+0.13,4.38,484000,106,1434790,0,0,0,0,0,0,460000,444000,16000,16000
20200212,052524,新光金元大9B購01,0.55,0.55,0.55,0.55,+0.02,3.77,1000,1,550,0,0,0,0,0,0,1000,0,1000,1000
20200212,052525,聯詠元大95購06,1.11,1.22,1.11,1.20,+0.11,10.09,180000,15,206650,0,0,0,0,0,0,111000,149000,-38000,-38000
20200212,052526,智伸科元大96購02,1.00,1.00,0.96,0.96,-0.04,-4.0,135000,5,134150,0,0,0,0,0,0,15000,95000,-80000,-80000
20200212,052527,泰鼎元大96購02,1.70,1.81,1.64,1.64,+0.06,3.8,598000,57,1035140,0,0,0,0,0,0,266000,577000,-311000,-311000
20200212,052528,茂林元大95購05,1.86,1.91,1.81,1.86,+0.08,4.49,311000,32,575940,0,0,0,0,0,0,160000,217000,-57000,-57000
20200212,052529,力成元大95購03,2.87,3.11,2.87,3.11,0.00,0.00,54000,5,162790,0,0,0,0,0,0,10000,54000,-44000,-44000
20200212,05252P,華通凱基95售01,0.76,0.77,0.76,0.77,0.00,0.00,40000,3,30600,0,0,0,0,0,0,0,40000,-40000,-40000
20200212,052530,台郡元大96購04,1.71,1.75,1.62,1.75,+0.62,54.87,426000,19,714910,0,0,0,0,0,0,317000,91000,226000,226000
20200212,052531,台積電國泰96購06,,,,,0.00,0.00,0,0,0,0,0,0,0,0,0,0,0,0,0
20200212,052532,台積電國泰96購07,3.12,3.26,3.12,3.26,+0.25,8.31,27000,2,85640,0,0,0,0,0,0,17000,10000,7000,7000
20200212,052533,聯發科國泰96購03,0.77,0.86,0.77,0.85,+0.18,26.87,150000,12,120650,0,0,0,0,0,0,150000,0,150000,150000
20200212,052534,貿聯國泰96購02,1.19,1.34,1.17,1.34,+0.17,14.53,184000,22,230050,0,0,0,0,0,0,70000,114000,-44000,-44000
20200212,052535,日月光國泰96購01,1.53,1.71,1.53,1.69,+0.27,19.01,401000,14,626710,0,0,0,0,0,0,340000,61000,279000,279000
20200212,052536,聯茂國泰97購01,1.40,1.91,1.40,1.68,+0.36,27.27,207000,30,360620,0,0,0,0,0,0,54000,153000,-99000,-99000
20200212,052537,力成富邦95購01,1.07,1.21,1.07,1.21,+0.20,19.8,209000,9,243990,0,0,0,0,0,0,5000,209000,-204000,-204000
20200212,052538,和大統一95購02,1.09,1.11,1.05,1.11,0.00,0.00,101000,5,107410,0,0,0,0,0,0,16000,90000,-74000,-74000
20200212,052539,華邦電統一95購01,,,,,0.00,0.00,0,0,0,0,0,0,0,0,0,0,0,0,0
20200212,05253P,智邦凱基95售08,0.19,0.19,0.19,0.19,0.00,0.00,25000,1,4750,0,0,0,0,0,0,0,25000,-25000,-25000
20200212,052540,華新科統一95購03,2.98,2.98,2.89,2.89,+0.08,2.85,74000,6,219550,0,0,0,0,0,0,74000,0,74000,74000
20200212,052541,大立光統一95購06,,,,,0.00,0.00,0,0,0,0,0,0,0,0,0,0,0,0,0
20200212,052542,友達元富98購01,,,,,0.00,0.00,0,0,0,0,0,0,0,0,0,0,0,0,0
20200212,052543,聯詠元富95購01,0.85,0.87,0.81,0.87,+0.09,11.54,90000,4,77200,0,0,0,0,0,0,20000,70000,-50000,-50000
20200212,052544,牧德元富95購01,,,,,0.00,0.00,0,0,0,0,0,0,0,0,0,0,0,0,0
20200212,052545,康控元富95購02,0.36,0.40,0.36,0.39,0.00,0.00,348000,8,130590,0,0,0,0,0,0,0,348000,-348000,-348000
20200212,052546,友達中信98購01,2.82,2.82,2.70,2.70,-0.17,-5.92,61000,8,167140,0,0,0,0,0,0,10000,51000,-41000,-41000
20200212,052547,光磊兆豐96購01,0.58,0.58,0.58,0.58,0.00,0.00,113000,8,65540,0,0,0,0,0,0,113000,0,113000,113000
20200212,052548,旺宏亞東96購01,,,,,0.00,0.00,0,0,0,0,0,0,0,0,0,0,0,0,0
20200212,052549,喬山國票97購01,0.34,0.34,0.34,0.34,0.00,0.00,5000,1,1700,0,0,0,0,0,0,5000,0,5000,5000
20200212,05254P,瑞昱凱基95售04,,,,,0.00,0.00,0,0,0,0,0,0,0,0,0,0,0,0,0
20200212,052550,鴻海國票97購02,0.23,0.25,0.23,0.25,+0.04,19.05,454000,3,105020,0,0,0,0,0,0,424000,30000,394000,394000
20200212,052551,台積電國票97購03,2.99,3.14,2.99,3.14,0.00,0.00,28000,4,85840,0,0,0,0,0,0,28000,0,28000,28000
20200212,052552,智邦國票97購01,3.46,3.68,3.05,3.05,-0.28,-8.41,143000,8,516120,0,0,0,0,0,0,111000,32000,79000,79000
20200212,052553,技嘉國票96購01,2.72,2.72,2.39,2.46,-0.10,-3.91,639000,19,1622130,0,0,0,0,0,0,582000,47000,535000,535000
20200212,052554,正崴國票97購01,0.53,0.53,0.52,0.52,-0.04,-7.14,90000,9,47640,0,0,0,0,0,0,90000,0,90000,90000
20200212,052555,漢唐國票97購01,3.53,3.64,3.53,3.64,0.00,0.00,67000,2,242450,0,0,0,0,0,0,0,67000,-67000,-67000
20200212,052556,聯發科國票97購01,1.14,1.18,1.14,1.15,+0.20,21.05,58000,3,66900,0,0,0,0,0,0,38000,20000,18000,18000
20200212,052557,群創國票97購02,,,,,0.00,0.00,0,0,0,0,0,0,0,0,0,0,0,0,0
20200212,052558,新唐國票97購01,,,,,0.00,0.00,0,0,0,0,0,0,0,0,0,0,0,0,0
20200212,052559,茂林國票97購01,2.83,2.95,2.69,2.85,+0.14,5.17,112000,19,319300,0,0,0,0,0,0,61000,51000,10000,10000
20200212,05255P,義隆凱基95售01,0.64,0.64,0.64,0.64,0.00,0.00,4000,1,2560,0,0,0,0,0,0,4000,0,4000,4000
20200212,052560,康舒國票97購01,,,,,0.00,0.00,0,0,0,0,0,0,0,0,0,0,0,0,0
20200212,052561,矽創國票97購01,1.13,1.40,1.13,1.40,+0.27,23.89,57000,16,72500,0,0,0,0,0,0,15000,42000,-27000,-27000
20200212,052562,南亞科日盛96購01,,,,,0.00,0.00,0,0,0,0,0,0,0,0,0,0,0,0,0
20200212,052563,京元電日盛96購01,0.43,0.47,0.40,0.47,+0.02,4.44,454000,32,192240,0,0,0,0,0,0,395000,0,395000,395000
20200212,052564,美食日盛96購01,,,,,0.00,0.00,0,0,0,0,0,0,0,0,0,0,0,0,0
20200212,052565,上銀凱基96購01,3.11,3.14,0.99,3.04,+0.06,2.01,108000,5,311760,0,0,0,0,0,0,48000,60000,-12000,-12000
20200212,052566,國巨凱基96購04,4.27,4.36,4.27,4.36,+0.28,6.86,11000,4,47870,0,0,0,0,0,0,11000,10000,1000,1000
20200212,052567,台積電凱基96購05,1.85,1.95,1.85,1.95,+0.20,11.43,32000,5,61140,0,0,0,0,0,0,28000,0,28000,28000
20200212,052568,漢唐凱基96購02,1.52,1.59,1.52,1.59,+0.13,8.9,232000,4,368180,0,0,0,0,0,0,222000,10000,212000,212000
20200212,052569,聯發科凱基96購08,,,,,0.00,0.00,0,0,0,0,0,0,0,0,0,0,0,0,0
20200212,05256P,義隆凱基95售02,0.18,0.19,0.18,0.19,-0.06,-24.0,680000,4,125700,0,0,0,0,0,0,330000,350000,-20000,-20000
20200212,052570,華新科凱基96購06,5.45,5.45,5.45,5.45,+0.20,3.81,5000,1,27250,0,0,0,0,0,0,5000,5000,0,0
20200212,052571,新光金凱基98購02,0.52,0.54,0.52,0.52,-0.02,-3.7,197000,40,103620,0,0,0,0,0,0,129000,28000,101000,101000
20200212,052572,群創凱基99購01,,,,,0.00,0.00,0,0,0,0,0,0,0,0,0,0,0,0,0
20200212,052573,智伸科凱基97購01,0.52,0.52,0.52,0.52,+0.01,1.96,19000,1,9880,0,0,0,0,0,0,0,19000,-19000,-19000
20200212,052574,茂林凱基96購02,1.52,1.57,1.47,1.57,+0.13,9.03,43000,18,65790,0,0,0,0,0,0,33000,10000,23000,23000
20200212,052575,茂林凱基96購04,2.05,2.05,2.05,2.05,+0.06,3.02,10000,2,20500,0,0,0,0,0,0,10000,0,10000,10000
20200212,052576,聯茂凱基96購01,0.75,0.81,0.75,0.81,+0.28,52.83,20000,2,15600,0,0,0,0,0,0,10000,10000,0,0
20200212,052577,台積電統一96購01,2.34,2.34,2.34,2.34,+0.12,5.41,1000,1,2340,0,0,0,0,0,0,1000,0,1000,1000
20200212,052578,大立光統一97購01,2.11,2.11,2.11,2.11,0.00,0.00,2000,1,4220,0,0,0,0,0,0,2000,2000,0,0
20200212,052579,亞泥元富96購01,4.23,4.23,4.23,4.23,+0.12,2.92,10000,1,42300,0,0,0,0,0,0,10000,0,10000,10000
20200212,05257P,欣興凱基95售04,1.51,1.51,1.40,1.40,-0.35,-20.0,52000,5,77710,0,0,0,0,0,0,46000,6000,40000,40000
20200212,052580,高鐵元富96購01,4.70,4.75,4.70,4.75,+0.04,0.85,20000,2,94500,0,0,0,0,0,0,0,20000,-20000,-20000
20200212,052581,訊芯元富98購01,1.29,1.39,1.29,1.37,+0.11,8.73,85000,10,115080,0,0,0,0,0,0,49000,36000,13000,13000
20200212,052582,喬山台新96購01,,,,,0.00,0.00,0,0,0,0,0,0,0,0,0,0,0,0,0
20200212,052583,友達台新96購02,,,,,0.00,0.00,0,0,0,0,0,0,0,0,0,0,0,0,0
20200212,052584,喬山永豐96購01,,,,,0.00,0.00,0,0,0,0,0,0,0,0,0,0,0,0,0
20200212,052585,友達永豐97購01,2.14,2.14,2.14,2.14,-0.17,-7.36,213000,4,455820,0,0,0,0,0,0,213000,0,213000,213000
20200212,052586,晶豪科永豐96購01,1.03,1.10,1.03,1.10,+0.11,11.11,97000,10,104370,0,0,0,0,0,0,20000,77000,-57000,-57000
20200212,052587,景碩永豐97購01,0.48,0.64,0.48,0.60,+0.15,33.33,273000,8,148990,0,0,0,0,0,0,210000,63000,147000,147000
20200212,052588,玉晶光永豐98購01,,,,,0.00,0.00,0,0,0,0,0,0,0,0,0,0,0,0,0
20200212,052589,群創永豐97購01,1.60,1.60,1.56,1.56,+0.01,0.65,80000,3,126000,0,0,0,0,0,0,50000,30000,20000,20000
20200212,05258P,臺股指凱基96售11,0.60,0.60,0.56,0.56,-0.15,-21.13,30000,3,17500,0,0,0,0,0,0,0,30000,-30000,-30000
20200212,052590,祥碩永豐96購01,5.55,5.55,5.55,5.55,+1.14,25.85,7000,1,38850,0,0,0,0,0,0,7000,0,7000,7000
20200212,052591,康友永豐97購01,0.89,0.96,0.89,0.96,+0.05,5.49,179000,8,169450,0,0,0,0,0,0,69000,110000,-41000,-41000
20200212,052592,華通群益98購01,,,,,0.00,0.00,0,0,0,0,0,0,0,0,0,0,0,0,0
20200212,052593,台積電群益96購02,1.55,1.64,1.50,1.64,+0.17,11.56,426000,13,668830,0,0,0,0,0,0,212000,219000,-7000,-7000
20200212,052594,友訊群益98購01,1.40,1.40,1.34,1.34,-0.04,-2.9,953000,17,1311350,0,0,0,0,0,0,400000,553000,-153000,-153000
20200212,052595,奇力新群益96購01,1.55,1.64,1.46,1.62,+0.03,1.89,749000,152,1169260,0,0,0,0,0,0,241000,693000,-452000,-452000
20200212,052596,群創群益98購05,,,,,0.00,0.00,0,0,0,0,0,0,0,0,0,0,0,0,0
20200212,052597,茂林群益96購01,4.14,4.36,3.95,4.15,+0.23,5.87,85000,12,340480,0,0,0,0,0,0,21000,61000,-40000,-40000
20200212,052598,滬深2X元大96購05,0.89,0.89,0.89,0.89,0.00,0.00,12000,2,10680,0,0,0,0,0,0,0,12000,-12000,-12000
20200212,052599,S&P反1元大96購01,,,,,0.00,0.00,0,0,0,0,0,0,0,0,0,0,0,0,0
20200212,05259P,臺股指凱基96售12,0.60,0.60,0.55,0.56,-0.08,-12.5,175000,9,100150,0,0,0,0,0,0,0,175000,-175000,-175000
20200212,052600,力山元大97購01,,,,,0.00,0.00,0,0,0,0,0,0,0,0,0,0,0,0,0
20200212,052601,大成鋼元大96購01,1.38,1.48,1.35,1.48,+0.09,6.47,75000,8,106390,0,0,0,0,0,0,75000,61000,14000,14000
20200212,052602,聯電元大97購01,1.29,1.39,1.29,1.37,+0.02,1.48,261000,21,347250,0,0,0,0,0,0,161000,192000,-31000,-31000
20200212,052603,鴻海元大96購15,0.62,0.74,0.62,0.74,+0.18,32.14,100000,10,67700,0,0,0,0,0,0,10000,90000,-80000,-80000
20200212,052604,建準元大97購01,1.24,1.24,1.20,1.20,-0.02,-1.64,71000,3,87040,0,0,0,0,0,0,10000,61000,-51000,-51000
20200212,052605,聯發科元大96購06,0.47,0.49,0.47,0.49,+0.14,40.0,48000,2,23040,0,0,0,0,0,0,24000,24000,0,0
20200212,052606,聯發科元大97購04,1.18,1.30,1.15,1.30,+0.25,23.81,472000,41,588780,0,0,0,0,0,0,422000,403000,19000,19000
20200212,052607,大立光元大96購03,2.09,2.17,2.09,2.17,+0.29,15.43,94000,7,201510,0,0,0,0,0,0,69000,86000,-17000,-17000
20200212,052608,欣興元大97購01,0.50,0.64,0.49,0.64,+0.13,25.49,1179000,28,681820,0,0,0,0,0,0,599000,580000,19000,19000
20200212,052609,智易元大97購01,,,,,0.00,0.00,0,0,0,0,0,0,0,0,0,0,0,0,0
20200212,05260P,和碩元富95售02,1.03,1.03,1.01,1.01,-0.01,-0.98,9000,2,9170,0,0,0,0,0,0,0,9000,-9000,-9000
20200212,052610,貿聯元大97購01,0.62,0.69,0.62,0.69,+0.09,15.0,23000,5,15270,0,0,0,0,0,0,10000,13000,-3000,-3000
20200212,052611,力成元大96購02,2.40,2.53,2.40,2.53,0.00,0.00,13000,4,32680,0,0,0,0,0,0,0,13000,-13000,-13000
20200212,052612,康舒元大97購01,,,,,0.00,0.00,0,0,0,0,0,0,0,0,0,0,0,0,0
20200212,052613,易華電元大96購01,0.57,0.57,0.55,0.55,0.00,0.00,120000,3,66400,0,0,0,0,0,0,20000,97000,-77000,-77000
20200212,052614,聯電國泰97購01,1.96,1.96,1.92,1.92,-0.11,-5.42,60000,13,116680,0,0,0,0,0,0,60000,0,60000,60000
20200212,052615,鴻海國泰98購01,0.64,0.81,0.64,0.81,+0.25,44.64,80000,7,59900,0,0,0,0,0,0,0,80000,-80000,-80000
20200212,052616,鴻海國泰98購02,1.07,1.35,1.07,1.35,+0.35,35.0,270000,12,317100,0,0,0,0,0,0,160000,110000,50000,50000
20200212,052617,景碩國泰98購01,,,,,0.00,0.00,0,0,0,0,0,0,0,0,0,0,0,0,0
20200212,052618,群創國泰98購01,,,,,0.00,0.00,0,0,0,0,0,0,0,0,0,0,0,0,0
20200212,052619,茂林國泰99購01,1.74,1.75,1.74,1.75,0.00,0.00,10000,2,17490,0,0,0,0,0,0,10000,0,10000,10000
20200212,05261P,鴻海元大95售20,1.57,1.57,1.20,1.20,-0.43,-26.38,663000,35,933340,0,0,0,0,0,0,416000,648000,-232000,-232000
20200212,052620,上証2X富邦97購02,0.13,0.13,0.13,0.13,0.00,0.00,30000,1,3900,0,0,0,0,0,0,30000,0,30000,30000
20200212,052621,台郡富邦97購01,0.50,0.74,0.50,0.74,+0.37,100.0,149000,17,85770,0,0,0,0,0,0,18000,52000,-34000,-34000
20200212,052622,貿聯兆豐97購01,0.47,0.51,0.45,0.51,+0.08,18.6,176000,10,83400,0,0,0,0,0,0,121000,55000,66000,66000
20200212,052623,台郡兆豐96購01,0.61,0.63,0.55,0.63,+0.28,80.0,364000,33,220190,0,0,0,0,0,0,208000,151000,57000,57000
20200212,052624,微星亞東97購01,,,,,0.00,0.00,0,0,0,0,0,0,0,0,0,0,0,0,0
20200212,052625,南電亞東97購01,,,,,0.00,0.00,0,0,0,0,0,0,0,0,0,0,0,0,0
20200212,052626,上証2X中信9A購01,,,,,0.00,0.00,0,0,0,0,0,0,0,0,0,0,0,0,0
20200212,052627,中壽中信98購01,0.68,0.68,0.67,0.67,0.00,0.00,92000,5,62370,0,0,0,0,0,0,73000,19000,54000,54000
20200212,052628,樺漢中信96購01,0.30,0.30,0.30,0.30,0.00,0.00,5000,1,1500,0,0,0,0,0,0,5000,0,5000,5000
20200212,052629,訊芯中信99購01,0.43,0.48,0.43,0.47,+0.06,14.63,981000,31,447190,0,0,0,0,0,0,591000,380000,211000,211000
20200212,05262P,台積電元大95售19,0.30,0.30,0.30,0.30,-0.07,-18.92,85000,2,25500,0,0,0,0,0,0,85000,0,85000,85000
20200212,052630,滬深2X日盛96購01,,,,,0.00,0.00,0,0,0,0,0,0,0,0,0,0,0,0,0
20200212,052631,T50反1凱基98購02,,,,,0.00,0.00,0,0,0,0,0,0,0,0,0,0,0,0,0
20200212,052632,喬山凱基96購01,,,,,0.00,0.00,0,0,0,0,0,0,0,0,0,0,0,0,0
20200212,052633,國巨凱基96購05,4.27,4.27,4.27,4.27,+0.32,8.1,10000,3,42700,0,0,0,0,0,0,10000,10000,0,0
20200212,052634,華邦電凱基96購01,,,,,0.00,0.00,0,0,0,0,0,0,0,0,0,0,0,0,0
20200212,052635,奇力新凱基98購01,1.84,1.84,1.80,1.84,+0.05,2.79,44000,6,80260,0,0,0,0,0,0,44000,0,44000,44000
20200212,052636,大立光凱基96購10,,,,,0.00,0.00,0,0,0,0,0,0,0,0,0,0,0,0,0
20200212,052637,欣興凱基97購01,0.38,0.40,0.38,0.40,+0.10,33.33,196000,7,75680,0,0,0,0,0,0,166000,30000,136000,136000
20200212,052638,緯創凱基96購02,,,,,0.00,0.00,0,0,0,0,0,0,0,0,0,0,0,0,0
20200212,052639,康控凱基96購02,0.37,0.37,0.37,0.37,0.00,0.00,7000,2,2590,0,0,0,0,0,0,0,7000,-7000,-7000
20200212,05263P,台積電元大96售09,0.63,0.64,0.61,0.62,-0.05,-7.46,260000,15,161800,0,0,0,0,0,0,91000,132000,-41000,-41000
20200212,052640,台表科凱基97購01,,,,,0.00,0.00,0,0,0,0,0,0,0,0,0,0,0,0,0
20200212,052641,聯詠台新96購01,1.20,1.22,1.19,1.22,+0.31,34.07,63000,5,76480,0,0,0,0,0,0,10000,53000,-43000,-43000
20200212,052642,滬深2X永豐96購03,0.85,0.85,0.85,0.85,-0.06,-6.59,10000,1,8500,0,0,0,0,0,0,10000,0,10000,10000
20200212,052643,華通永豐96購02,,,,,0.00,0.00,0,0,0,0,0,0,0,0,0,0,0,0,0
20200212,052644,聯發科永豐96購01,0.73,0.81,0.73,0.81,+0.14,20.9,1093000,11,837390,0,0,0,0,0,0,98000,995000,-897000,-897000
20200212,052645,美食永豐96購01,,,,,0.00,0.00,0,0,0,0,0,0,0,0,0,0,0,0,0
20200212,052646,淘帝永豐96購01,,,,,0.00,0.00,0,0,0,0,0,0,0,0,0,0,0,0,0
20200212,052647,晶技永豐97購01,0.97,0.97,0.97,0.97,0.00,0.00,5000,1,4850,0,0,0,0,0,0,0,5000,-5000,-5000
20200212,052648,茂林永豐96購01,0.59,0.60,0.57,0.58,+0.01,1.75,110000,18,64710,0,0,0,0,0,0,55000,55000,0,0
20200212,052649,康控永豐96購01,0.25,0.26,0.25,0.25,+0.02,8.7,30000,3,7600,0,0,0,0,0,0,30000,0,30000,30000
20200212,05264P,微星元大95售02,,,,,0.00,0.00,0,0,0,0,0,0,0,0,0,0,0,0,0
20200212,052650,台郡永豐96購01,0.61,0.65,0.60,0.62,+0.19,44.19,244000,24,149490,0,0,0,0,0,0,144000,90000,54000,54000
20200212,052651,台表科永豐96購02,,,,,0.00,0.00,0,0,0,0,0,0,0,0,0,0,0,0,0
20200212,052652,台虹永豐96購01,0.47,0.47,0.47,0.47,+0.04,9.3,100000,10,47000,0,0,0,0,0,0,0,100000,-100000,-100000
20200212,052653,臺股指永豐97購01,0.91,1.04,0.91,1.04,+0.15,16.85,216000,13,212640,0,0,0,0,0,0,166000,50000,116000,116000
20200212,052654,友達統一97購01,,,,,0.00,0.00,0,0,0,0,0,0,0,0,0,0,0,0,0
20200212,052655,群創統一97購01,1.47,1.49,1.45,1.46,+0.02,1.39,437000,13,644230,0,0,0,0,0,0,217000,220000,-3000,-3000
20200212,052656,力山元富96購01,,,,,0.00,0.00,0,0,0,0,0,0,0,0,0,0,0,0,0
20200212,052657,友達元富96購01,,,,,0.00,0.00,0,0,0,0,0,0,0,0,0,0,0,0,0
20200212,052658,友達元富9C購01,,,,,0.00,0.00,0,0,0,0,0,0,0,0,0,0,0,0,0
20200212,052659,上証2X國票99購01,,,,,0.00,0.00,0,0,0,0,0,0,0,0,0,0,0,0,0
20200212,05265P,正崴元大95售03,,,,,0.00,0.00,0,0,0,0,0,0,0,0,0,0,0,0,0
20200212,052660,京元電國票97購01,1.91,2.04,1.87,1.98,+0.07,3.66,165000,17,325900,0,0,0,0,0,0,76000,89000,-13000,-13000
20200212,052661,奇力新國票97購03,4.16,4.26,4.01,4.26,+0.12,2.9,94000,17,391080,0,0,0,0,0,0,74000,20000,54000,54000
20200212,052662,華新科國票97購01,11.80,11.80,11.20,11.60,+0.30,2.65,31000,13,357600,0,0,0,0,0,0,31000,30000,1000,1000
20200212,052663,奇鋐國票97購01,0.80,0.84,0.80,0.81,+0.04,5.19,75000,3,61750,0,0,0,0,0,0,0,75000,-75000,-75000
20200212,052664,麗豐國票96購02,0.47,0.51,0.47,0.50,+0.04,8.7,221000,5,107300,0,0,0,0,0,0,181000,40000,141000,141000
20200212,052665,緯穎國票96購03,,,,,0.00,0.00,0,0,0,0,0,0,0,0,0,0,0,0,0
20200212,052666,瑞昱群益96購01,1.34,1.45,1.34,1.36,+0.17,14.29,27000,4,37320,0,0,0,0,0,0,0,27000,-27000,-27000
20200212,052667,漢唐群益96購01,1.63,1.72,1.60,1.63,-0.08,-4.68,263000,13,433780,0,0,0,0,0,0,215000,48000,167000,167000
20200212,052668,聯發科群益97購01,1.36,1.61,1.36,1.61,+0.37,29.84,702000,12,1052660,0,0,0,0,0,0,216000,486000,-270000,-270000
20200212,052669,群創群益98購06,1.08,1.08,1.05,1.07,0.00,0.00,249000,33,266410,0,0,0,0,0,0,89000,249000,-160000,-160000
20200212,05266P,華新科元大95售11,0.17,0.17,0.17,0.17,-0.02,-10.53,340000,7,57800,0,0,0,0,0,0,150000,190000,-40000,-40000
20200212,052670,茂林群益96購02,1.26,1.28,1.20,1.28,+0.07,5.79,108000,14,136000,0,0,0,0,0,0,35000,108000,-73000,-73000
20200212,052671,祥碩群益96購01,,,,,0.00,0.00,0,0,0,0,0,0,0,0,0,0,0,0,0
20200212,052672,世紀鋼群益96購02,,,,,0.00,0.00,0,0,0,0,0,0,0,0,0,0,0,0,0
20200212,052673,T50反1國泰97購01,,,,,0.00,0.00,0,0,0,0,0,0,0,0,0,0,0,0,0
20200212,052674,智邦國泰98購01,2.48,2.58,2.26,2.26,-0.08,-3.42,76000,10,177260,0,0,0,0,0,0,73000,1000,72000,72000
20200212,052675,新光金國泰98購01,0.79,0.79,0.78,0.79,0.00,0.00,422000,22,333220,0,0,0,0,0,0,422000,0,422000,422000
20200212,052676,聯發科永昌98購01,1.91,2.26,1.91,2.23,+0.39,21.2,1327000,45,2780270,0,0,0,0,0,0,1159000,700000,459000,459000
20200212,052677,景碩富邦97購01,0.27,0.36,0.25,0.31,+0.05,19.23,1799000,90,504820,0,0,0,0,0,0,489000,1293000,-804000,-804000
20200212,052678,群創富邦96購01,,,,,0.00,0.00,0,0,0,0,0,0,0,0,0,0,0,0,0
20200212,052679,致伸富邦98購01,0.29,0.30,0.29,0.30,+0.01,3.45,55000,3,16250,0,0,0,0,0,0,0,55000,-55000,-55000
20200212,05267P,欣興元大95售08,1.54,1.54,1.34,1.34,-0.23,-14.65,337000,48,470050,0,0,0,0,0,0,91000,246000,-155000,-155000
20200212,052680,T50反1元大96購04,0.40,0.41,0.40,0.41,0.00,0.00,213000,2,85330,0,0,0,0,0,0,200000,213000,-13000,-13000
20200212,052681,T50反1元大98購02,0.40,0.40,0.37,0.37,-0.05,-11.9,54000,4,21440,0,0,0,0,0,0,54000,0,54000,54000
20200212,052682,上銀元大97購01,3.84,3.86,3.84,3.86,+0.12,3.21,25000,3,96100,0,0,0,0,0,0,20000,5000,15000,15000
20200212,052683,鴻海元大97購03,0.63,0.63,0.63,0.63,+0.05,8.62,20000,1,12600,0,0,0,0,0,0,20000,0,20000,20000
20200212,052684,旺宏元大98購01,1.52,1.59,1.49,1.49,-0.03,-1.97,136000,15,210150,0,0,0,0,0,0,55000,90000,-35000,-35000
20200212,052685,技嘉元大96購01,2.37,2.40,2.28,2.28,+0.01,0.44,27000,7,62990,0,0,0,0,0,0,0,26000,-26000,-26000
20200212,052686,華新科元大96購03,,,,,0.00,0.00,0,0,0,0,0,0,0,0,0,0,0,0,0
20200212,052687,國泰金元大96購03,1.04,1.07,1.01,1.04,+0.04,4.0,334000,22,347750,0,0,0,0,0,0,156000,178000,-22000,-22000
20200212,052688,新日興元大96購01,2.84,2.84,2.64,2.64,-0.22,-7.69,127000,16,347280,0,0,0,0,0,0,83000,94000,-11000,-11000
20200212,052689,玉晶光元大98購03,2.50,2.78,2.29,2.29,-0.21,-8.4,51000,4,117900,0,0,0,0,0,0,48000,0,48000,48000
20200212,05268P,玉晶光元大98售01,0.75,0.76,0.72,0.73,-0.06,-7.59,742000,40,551820,0,0,0,0,0,0,213000,494000,-281000,-281000
20200212,052690,台表科元大97購01,0.70,0.78,0.70,0.78,+0.09,13.04,342000,13,255140,0,0,0,0,0,0,32000,312000,-280000,-280000
20200212,052691,GIS元大96購01,1.08,1.20,1.08,1.20,+0.11,10.09,196000,13,227590,0,0,0,0,0,0,126000,93000,33000,33000
20200212,052692,滬深2X中信99購02,,,,,0.00,0.00,0,0,0,0,0,0,0,0,0,0,0,0,0
20200212,052693,微星中信96購01,1.68,1.68,1.62,1.62,-0.01,-0.61,7000,3,11650,0,0,0,0,0,0,5000,2000,3000,3000
20200212,052694,開發金中信98購01,0.63,0.64,0.63,0.64,-0.02,-3.03,143000,6,90220,0,0,0,0,0,0,143000,0,143000,143000
20200212,052695,台表科中信98購01,0.21,0.23,0.21,0.23,+0.04,21.05,249000,8,55370,0,0,0,0,0,0,166000,79000,87000,87000
20200212,052696,玉晶光麥證97購01,5.95,6.35,5.85,6.35,+0.55,9.48,46000,9,279300,8000,38000,-30000,0,0,0,13000,38000,-25000,-25000
20200212,052697,滬深2X國票98購01,,,,,0.00,0.00,0,0,0,0,0,0,0,0,0,0,0,0,0
20200212,052698,深中小國票99購01,1.52,1.65,1.52,1.65,+0.14,9.27,228000,7,371420,0,0,0,0,0,0,210000,218000,-8000,-8000
20200212,052699,友達國票97購01,,,,,0.00,0.00,0,0,0,0,0,0,0,0,0,0,0,0,0
20200212,05269P,臻鼎元大95售05,1.45,1.65,1.38,1.65,-0.11,-6.25,173000,11,271050,0,0,0,0,0,0,0,173000,-173000,-173000
20200212,052700,奇鋐國票97購02,0.86,0.86,0.86,0.86,0.00,0.00,27000,1,23220,0,0,0,0,0,0,0,27000,-27000,-27000
20200212,052701,群創國票96購01,,,,,0.00,0.00,0,0,0,0,0,0,0,0,0,0,0,0,0
20200212,052702,群創國票97購03,1.47,1.47,1.47,1.47,+0.01,0.68,10000,1,14700,0,0,0,0,0,0,0,10000,-10000,-10000
20200212,052703,貿聯國票97購01,1.10,1.10,1.10,1.10,-0.10,-8.33,60000,6,66000,0,0,0,0,0,0,60000,0,60000,60000
20200212,052704,TPK國票97購01,0.57,0.65,0.55,0.65,+0.07,12.07,310000,19,185280,0,0,0,0,0,0,101000,209000,-108000,-108000
20200212,052705,超眾國票97購01,1.97,2.10,1.97,2.10,+0.10,5.0,156000,15,316250,0,0,0,0,0,0,156000,60000,96000,96000
20200212,052706,台虹國票97購01,1.69,1.71,1.65,1.71,+0.16,10.32,93000,4,158160,0,0,0,0,0,0,0,93000,-93000,-93000
20200212,052707,景碩台新96購01,0.74,1.09,0.74,0.95,+0.21,28.38,734000,38,642840,0,0,0,0,0,0,129000,605000,-476000,-476000
20200212,052708,楠梓電永豐97購01,0.55,0.55,0.55,0.55,0.00,0.00,4000,4,2200,0,0,0,0,0,0,0,4000,-4000,-4000
20200212,052709,光寶科日盛96購01,1.07,1.07,1.02,1.04,-0.01,-0.95,235000,12,244280,0,0,0,0,0,0,94000,141000,-47000,-47000
20200212,05270P,台表科元大95售05,,,,,0.00,0.00,0,0,0,0,0,0,0,0,0,0,0,0,0
20200212,052710,玉晶光日盛96購01,3.45,3.45,3.45,3.45,+0.37,12.01,58000,2,200100,0,0,0,0,0,0,0,58000,-58000,-58000
20200212,052711,滬深2X凱基97購01,,,,,0.00,0.00,0,0,0,0,0,0,0,0,0,0,0,0,0
20200212,052712,旺宏凱基96購02,1.39,1.44,1.38,1.38,0.00,0.00,81000,5,112700,0,0,0,0,0,0,81000,81000,0,0
20200212,052713,智邦凱基96購01,1.85,1.85,1.85,1.85,+0.23,14.2,10000,1,18500,0,0,0,0,0,0,10000,0,10000,10000
20200212,052714,義隆凱基96購02,0.69,0.69,0.03,0.68,+0.10,17.24,512000,14,240950,0,0,0,0,0,0,158000,354000,-196000,-196000
20200212,052715,可成凱基96購01,0.51,0.63,0.51,0.63,+0.13,26.0,81000,4,44550,0,0,0,0,0,0,51000,30000,21000,21000
20200212,052716,欣興凱基96購01,0.47,0.47,0.47,0.47,+0.15,46.88,1000,1,470,0,0,0,0,0,0,1000,0,1000,1000
20200212,052717,正文凱基96購01,0.18,0.18,0.18,0.18,+0.01,5.88,20000,1,3600,0,0,0,0,0,0,0,20000,-20000,-20000
20200212,052718,新唐凱基96購01,0.29,0.30,0.29,0.30,+0.02,7.14,100000,2,29500,0,0,0,0,0,0,100000,0,100000,100000
20200212,052719,致新凱基96購01,0.63,0.66,0.60,0.66,0.00,0.00,170000,16,108350,0,0,0,0,0,0,148000,0,148000,148000
20200212,05271P,國巨富邦97售01,,,,,0.00,0.00,0,0,0,0,0,0,0,0,0,0,0,0,0
20200212,052720,鴻海統一96購07,0.59,0.59,0.59,0.59,0.00,0.00,25000,1,14750,0,0,0,0,0,0,25000,0,25000,25000
20200212,052721,友達統一96購01,2.41,2.41,2.41,2.41,-0.18,-6.95,10000,1,24100,0,0,0,0,0,0,0,10000,-10000,-10000
20200212,052722,群創統一97購02,,,,,0.00,0.00,0,0,0,0,0,0,0,0,0,0,0,0,0
20200212,052723,新唐統一97購01,0.77,0.79,0.77,0.79,+0.05,6.76,115000,2,90550,0,0,0,0,0,0,115000,0,115000,115000
20200212,052724,力成統一97購01,3.18,3.39,3.18,3.39,0.00,0.00,80000,14,262780,0,0,0,0,0,0,29000,80000,-51000,-51000
20200212,052725,為升元富96購01,,,,,0.00,0.00,0,0,0,0,0,0,0,0,0,0,0,0,0
20200212,052726,鴻海元富96購03,0.35,0.44,0.34,0.44,+0.13,41.94,760000,27,292050,0,0,0,0,0,0,540000,350000,190000,190000
20200212,052727,仁寶元富96購01,1.14,1.16,1.13,1.16,+0.02,1.75,55000,5,63100,0,0,0,0,0,0,15000,55000,-40000,-40000
20200212,052728,上証2X國泰97購01,,,,,0.00,0.00,0,0,0,0,0,0,0,0,0,0,0,0,0
20200212,052729,國巨國泰97購03,,,,,0.00,0.00,0,0,0,0,0,0,0,0,0,0,0,0,0
20200212,05272P,臻鼎中信97售03,0.42,0.48,0.38,0.48,-0.04,-7.69,188000,11,86300,0,0,0,0,0,0,33000,155000,-122000,-122000
20200212,052730,華新科國泰98購01,,,,,0.00,0.00,0,0,0,0,0,0,0,0,0,0,0,0,0
20200212,052731,宏達電國泰98購01,1.24,1.24,1.21,1.21,+0.05,4.31,100000,13,121550,0,0,0,0,0,0,30000,77000,-47000,-47000
20200212,052732,新唐國泰97購01,1.22,1.28,1.20,1.28,+0.09,7.56,200000,6,243090,0,0,0,0,0,0,180000,20000,160000,160000
20200212,052733,台郡國泰97購01,2.25,2.90,2.08,2.90,+1.42,95.95,3784000,113,8318050,0,0,0,0,0,0,3253000,134000,3119000,3119000
20200212,052734,台表科國泰98購02,0.83,0.86,0.83,0.86,+0.11,14.67,1444000,17,1224790,0,0,0,0,0,0,51000,1393000,-1342000,-1342000
20200212,052735,燿華富邦98購01,,,,,0.00,0.00,0,0,0,0,0,0,0,0,0,0,0,0,0
20200212,052736,T50反1元大96購05,0.50,0.50,0.50,0.50,-0.06,-10.71,5000,1,2500,0,0,0,0,0,0,5000,0,5000,5000
20200212,052737,滬深2X元大96購06,0.69,0.69,0.69,0.69,-0.01,-1.43,20000,1,13800,0,0,0,0,0,0,0,20000,-20000,-20000
20200212,052738,聯電元大98購02,1.44,1.53,1.44,1.51,+0.07,4.86,268000,14,397320,0,0,0,0,0,0,254000,77000,177000,177000
20200212,052739,國巨元大96購04,3.58,3.58,3.58,3.58,+0.13,3.77,2000,1,7160,0,0,0,0,0,0,2000,0,2000,2000
20200212,05273P,國巨群益95售02,0.30,0.30,0.30,0.30,-0.04,-11.76,50000,1,15000,0,0,0,0,0,0,0,50000,-50000,-50000
20200212,052740,聯發科元大96購07,0.90,1.02,0.88,0.99,+0.22,28.57,311000,16,300390,0,0,0,0,0,0,150000,161000,-11000,-11000
20200212,052741,聯發科元大96購08,0.99,1.12,0.97,1.10,+0.25,29.41,331000,19,342340,0,0,0,0,0,0,186000,145000,41000,41000
20200212,052742,可成元大96購01,1.33,1.52,1.33,1.52,+0.26,20.63,526000,28,756670,0,0,0,0,0,0,301000,432000,-131000,-131000
20200212,052743,華新科元大97購01,,,,,0.00,0.00,0,0,0,0,0,0,0,0,0,0,0,0,0
20200212,052744,聯詠元大97購01,1.00,1.10,1.00,1.07,+0.07,7.0,698000,26,736920,0,0,0,0,0,0,552000,329000,223000,223000
20200212,052745,欣興元大96購04,0.66,0.85,0.64,0.85,+0.20,30.77,326000,21,245570,0,0,0,0,0,0,195000,151000,44000,44000
20200212,052746,泰碩元大97購01,,,,,0.00,0.00,0,0,0,0,0,0,0,0,0,0,0,0,0
20200212,052747,京鼎元大97購01,1.53,1.82,1.53,1.76,+0.32,22.22,860000,59,1476060,0,0,0,0,0,0,427000,512000,-85000,-85000
20200212,052748,群創元大9A購02,,,,,0.00,0.00,0,0,0,0,0,0,0,0,0,0,0,0,0
20200212,052749,日月光元大96購02,1.36,1.50,1.34,1.45,+0.16,12.4,514000,27,705270,0,0,0,0,0,0,406000,98000,308000,308000
20200212,05274P,嘉聯益亞東95售01,,,,,0.00,0.00,0,0,0,0,0,0,0,0,0,0,0,0,0
20200212,052750,臺股指元大96購04,2.21,2.22,2.21,2.22,+0.24,12.12,15000,3,33250,0,0,0,0,0,0,0,15000,-15000,-15000
20200212,052751,臺股指元大96購05,1.37,1.41,1.37,1.41,+0.21,17.5,15000,3,20850,0,0,0,0,0,0,0,15000,-15000,-15000
20200212,052752,臺股指元大96購06,0.82,0.82,0.82,0.82,0.00,0.00,50000,1,41000,0,0,0,0,0,0,50000,0,50000,50000
20200212,052753,電子類元大96購02,,,,,0.00,0.00,0,0,0,0,0,0,0,0,0,0,0,0,0
20200212,052754,上証2X群益9A購01,,,,,0.00,0.00,0,0,0,0,0,0,0,0,0,0,0,0,0
20200212,052755,滬深2X群益9A購01,0.70,0.70,0.69,0.70,-0.01,-1.41,205000,4,141500,0,0,0,0,0,0,2000,203000,-201000,-201000
20200212,052756,國巨群益96購02,4.64,4.64,4.64,4.64,+0.39,9.18,4000,1,18560,0,0,0,0,0,0,4000,4000,0,0
20200212,052757,華邦電群益96購01,0.36,0.41,0.36,0.40,+0.08,25.0,144000,8,53720,0,0,0,0,0,0,100000,44000,56000,56000
20200212,052758,友達群益99購01,,,,,0.00,0.00,0,0,0,0,0,0,0,0,0,0,0,0,0
20200212,052759,京元電群益96購01,1.62,1.62,1.54,1.54,+0.26,20.31,53000,2,81700,0,0,0,0,0,0,0,53000,-53000,-53000
20200212,05275P,國巨凱基95售05,0.50,0.50,0.21,0.21,-0.03,-12.5,85000,4,19320,0,0,0,0,0,0,0,82000,-82000,-82000
20200212,052760,盟立群益96購01,,,,,0.00,0.00,0,0,0,0,0,0,0,0,0,0,0,0,0
20200212,052761,可成群益96購02,1.90,2.28,1.90,2.28,+0.50,28.09,41000,4,84340,0,0,0,0,0,0,30000,31000,-1000,-1000
20200212,052762,欣興群益96購01,0.48,0.57,0.48,0.57,+0.21,58.33,569000,21,302520,0,0,0,0,0,0,0,569000,-569000,-569000
20200212,052763,晶技群益97購01,1.56,1.56,1.56,1.56,+0.05,3.31,109000,2,170040,0,0,0,0,0,0,98000,11000,87000,87000
20200212,052764,景碩群益98購01,1.12,1.43,1.12,1.31,+0.19,16.96,361000,51,472170,0,0,0,0,0,0,95000,302000,-207000,-207000
20200212,052765,新日興群益97購01,2.34,2.39,2.24,2.27,-0.14,-5.81,343000,29,794120,0,0,0,0,0,0,268000,167000,101000,101000
20200212,052766,玉晶光群益9A購01,9.00,9.60,9.00,9.50,+0.85,9.83,86000,15,809700,0,0,0,0,0,0,79000,73000,6000,6000
20200212,052767,智伸科群益98購01,0.64,0.64,0.64,0.64,0.00,0.00,94000,1,60160,0,0,0,0,0,0,94000,0,94000,94000
20200212,052768,泰鼎群益96購01,1.94,2.13,1.84,1.85,+0.07,3.93,526000,74,1066840,0,0,0,0,0,0,137000,475000,-338000,-338000
20200212,052769,達興群益96購01,2.43,2.51,2.43,2.51,+0.09,3.72,19000,2,46890,0,0,0,0,0,0,0,19000,-19000,-19000
20200212,05276P,GIS永豐95售02,0.86,0.86,0.86,0.86,-0.12,-12.24,2000,1,1720,0,0,0,0,0,0,0,2000,-2000,-2000
20200212,052770,聯茂群益96購02,1.22,1.62,1.22,1.54,+0.44,40.0,1683000,53,2400330,0,0,0,0,0,0,1359000,324000,1035000,1035000
20200212,052771,GIS群益96購01,1.27,1.34,1.27,1.34,+0.12,9.84,99000,12,129000,0,0,0,0,0,0,37000,62000,-25000,-25000
20200212,052772,台虹群益96購01,1.42,1.51,1.42,1.44,+0.10,7.46,107000,8,154420,0,0,0,0,0,0,33000,74000,-41000,-41000
20200212,052773,大成鋼亞東97購01,,,,,0.00,0.00,0,0,0,0,0,0,0,0,0,0,0,0,0
20200212,052774,京元電亞東96購01,0.69,0.73,0.69,0.72,+0.05,7.46,100000,22,71850,0,0,0,0,0,0,100000,0,100000,100000
20200212,052775,滬深2X國票99購02,,,,,0.00,0.00,0,0,0,0,0,0,0,0,0,0,0,0,0
20200212,052776,力山國票97購01,,,,,0.00,0.00,0,0,0,0,0,0,0,0,0,0,0,0,0
20200212,052777,燿華國票98購01,1.33,1.50,1.33,1.50,+0.14,10.29,242000,10,354470,0,0,0,0,0,0,110000,232000,-122000,-122000
20200212,052778,智原國票97購01,0.92,1.03,0.92,1.03,+0.13,14.44,220000,14,214760,0,0,0,0,0,0,128000,92000,36000,36000
20200212,052779,欣興國票97購01,1.12,1.29,1.12,1.29,+0.34,35.79,61000,2,68490,0,0,0,0,0,0,0,61000,-61000,-61000
20200212,05277P,深中小統一95售02,0.19,0.19,0.18,0.18,0.00,0.00,30000,2,5500,0,0,0,0,0,0,0,30000,-30000,-30000
20200212,052780,玉晶光國票96購04,6.35,6.35,6.35,6.35,+0.35,5.83,5000,1,31750,0,0,0,0,0,0,0,5000,-5000,-5000
20200212,052781,瀚宇博國票97購03,1.93,2.14,1.93,2.14,+0.26,13.83,61000,4,120980,0,0,0,0,0,0,61000,0,61000,61000
20200212,052782,超眾國票96購02,3.06,3.32,3.04,3.32,+0.26,8.5,86000,9,266110,0,0,0,0,0,0,78000,8000,70000,70000
20200212,052783,台郡國票97購01,2.14,2.32,2.14,2.28,+1.06,86.89,108000,17,246280,0,0,0,0,0,0,41000,62000,-21000,-21000
20200212,052784,緯穎國票97購02,7.85,8.65,7.85,8.65,+0.70,8.81,65000,7,539450,0,0,0,0,0,0,36000,29000,7000,7000
20200212,052785,滬深2X中信99購03,1.34,1.34,1.29,1.33,+0.01,0.76,286000,6,374980,0,0,0,0,0,0,70000,216000,-146000,-146000
20200212,052786,S&P500中信96購01,,,,,0.00,0.00,0,0,0,0,0,0,0,0,0,0,0,0,0
20200212,052787,國巨中信96購02,2.79,2.79,2.63,2.76,+0.28,11.29,34000,5,93670,0,0,0,0,0,0,25000,9000,16000,16000
20200212,052788,開發金中信98購02,0.57,0.58,0.57,0.57,-0.04,-6.56,215000,7,123850,0,0,0,0,0,0,215000,0,215000,215000
20200212,052789,台積電麥證96購01,,,,,0.00,0.00,0,0,0,0,0,0,0,0,0,0,0,0,0
20200212,05278P,台郡元富95售02,,,,,0.00,0.00,0,0,0,0,0,0,0,0,0,0,0,0,0
20200212,052790,智邦兆豐97購01,1.88,1.88,1.88,1.88,-0.04,-2.08,5000,1,9400,0,0,0,0,0,0,0,5000,-5000,-5000
20200212,052791,友達兆豐97購01,1.84,1.84,1.75,1.75,-0.24,-12.06,71000,8,130550,0,0,0,0,0,0,1000,70000,-69000,-69000
20200212,052792,大立光兆豐96購01,1.13,1.21,1.13,1.21,+0.08,7.08,19000,3,21850,0,0,0,0,0,0,14000,5000,9000,9000
20200212,052793,健鼎兆豐96購01,0.28,0.40,0.28,0.39,+0.17,77.27,621000,14,208200,0,0,0,0,0,0,70000,551000,-481000,-481000
20200212,052794,群創兆豐97購01,,,,,0.00,0.00,0,0,0,0,0,0,0,0,0,0,0,0,0
20200212,052795,健策兆豐97購01,2.05,2.24,2.02,2.24,+0.25,12.56,237000,30,493190,0,0,0,0,0,0,198000,39000,159000,159000
20200212,052796,和碩兆豐96購01,0.86,0.93,0.86,0.93,+0.07,8.14,55000,3,50200,0,0,0,0,0,0,30000,25000,5000,5000
20200212,052797,樺漢兆豐96購01,0.58,0.59,0.57,0.59,+0.03,5.36,60000,3,34510,0,0,0,0,0,0,50000,10000,40000,40000
20200212,052798,滬深2X元大96購07,1.06,1.06,1.06,1.06,0.00,0.00,30000,1,31800,0,0,0,0,0,0,0,30000,-30000,-30000
20200212,052799,上銀元大96購01,5.50,5.50,5.30,5.30,0.00,0.00,92000,22,497050,0,0,0,0,0,0,78000,58000,20000,20000
20200212,05279P,上銀元大95售02,0.58,0.58,0.58,0.58,0.00,0.00,4000,1,2320,0,0,0,0,0,0,0,4000,-4000,-4000
20200212,052800,國巨元大96購05,9.95,10.00,9.95,10.00,+0.40,4.17,15000,3,149750,0,0,0,0,0,0,15000,0,15000,15000
20200212,052801,友達元大9A購01,2.37,2.37,2.23,2.24,-0.17,-7.05,185000,17,422150,0,0,0,0,0,0,185000,165000,20000,20000
20200212,052802,華新科元大97購02,,,,,0.00,0.00,0,0,0,0,0,0,0,0,0,0,0,0,0
20200212,052803,冠德元大96購01,,,,,0.00,0.00,0,0,0,0,0,0,0,0,0,0,0,0,0
20200212,052804,淘帝元大96購01,,,,,0.00,0.00,0,0,0,0,0,0,0,0,0,0,0,0,0
20200212,052805,晶技元大97購01,0.80,0.83,0.80,0.83,+0.07,9.21,128000,8,105110,0,0,0,0,0,0,93000,25000,68000,68000
20200212,052806,玉晶光元大98購04,6.10,6.45,6.05,6.40,+0.60,10.34,98000,16,611150,0,0,0,0,0,0,88000,96000,-8000,-8000
20200212,052807,貿聯元大98購01,0.90,1.01,0.90,1.01,+0.12,13.48,524000,25,501030,0,0,0,0,0,0,161000,331000,-170000,-170000
20200212,052808,矽力元大96購02,2.80,2.80,2.80,2.80,0.00,0.00,1000,1,2800,0,0,0,0,0,0,0,1000,-1000,-1000
20200212,052809,訊芯元大97購01,1.40,1.64,1.40,1.58,+0.17,12.06,608000,33,933390,0,0,0,0,0,0,356000,500000,-144000,-144000
20200212,05280P,華通元大95售08,1.84,1.84,1.74,1.74,-0.40,-18.69,14000,2,24760,0,0,0,0,0,0,0,14000,-14000,-14000
20200212,052810,易華電元大96購02,0.57,0.59,0.56,0.56,-0.01,-1.75,231000,4,133710,0,0,0,0,0,0,21000,200000,-179000,-179000
20200212,052811,玉晶光台新96購03,,,,,0.00,0.00,0,0,0,0,0,0,0,0,0,0,0,0,0
20200212,052812,致伸康和96購01,,,,,0.00,0.00,0,0,0,0,0,0,0,0,0,0,0,0,0
20200212,052813,T50正2永豐96購01,1.37,1.41,1.37,1.41,+0.10,7.63,42000,7,57880,0,0,0,0,0,0,20000,22000,-2000,-2000
20200212,052814,上証2X永豐96購02,1.43,1.44,1.34,1.41,-0.06,-4.08,935000,34,1294470,0,0,0,0,0,0,339000,596000,-257000,-257000
20200212,052815,滬深2X永豐97購01,0.72,0.72,0.72,0.72,+0.01,1.41,70000,1,50400,0,0,0,0,0,0,70000,0,70000,70000
20200212,052816,上銀永豐96購01,2.06,2.09,2.02,2.04,+0.07,3.55,106000,9,219940,0,0,0,0,0,0,86000,20000,66000,66000
20200212,052817,楠梓電永豐96購02,0.62,0.72,0.62,0.68,0.00,0.00,434000,21,299410,0,0,0,0,0,0,0,434000,-434000,-434000
20200212,052818,智邦永豐96購01,1.12,1.21,1.01,1.09,+0.03,2.83,241000,22,275320,0,0,0,0,0,0,170000,117000,53000,53000
20200212,052819,義隆永豐96購01,1.45,1.45,1.33,1.43,+0.23,19.17,136000,6,189380,0,0,0,0,0,0,35000,101000,-66000,-66000
20200212,05281P,南亞科元大95售03,,,,,0.00,0.00,0,0,0,0,0,0,0,0,0,0,0,0,0
20200212,052820,宏達電永豐96購01,,,,,0.00,0.00,0,0,0,0,0,0,0,0,0,0,0,0,0
20200212,052821,晶技永豐96購01,,,,,0.00,0.00,0,0,0,0,0,0,0,0,0,0,0,0,0
20200212,052822,泰碩永豐97購01,,,,,0.00,0.00,0,0,0,0,0,0,0,0,0,0,0,0,0
20200212,052823,創意永豐96購02,0.89,0.96,0.85,0.93,-0.10,-9.71,574000,53,525400,0,0,0,0,0,0,279000,271000,8000,8000
20200212,052824,揚明光永豐96購02,,,,,0.00,0.00,0,0,0,0,0,0,0,0,0,0,0,0,0
20200212,052825,TPK永豐96購01,,,,,0.00,0.00,0,0,0,0,0,0,0,0,0,0,0,0,0
20200212,052826,嘉聯益永豐96購01,0.87,0.92,0.87,0.92,+0.08,9.52,44000,3,38780,0,0,0,0,0,0,34000,10000,24000,24000
20200212,052827,昇陽半永豐97購01,0.99,1.03,0.99,1.00,+0.01,1.01,298000,13,295570,0,0,0,0,0,0,296000,24000,272000,272000
20200212,052828,滬深2X群益9A購02,,,,,0.00,0.00,0,0,0,0,0,0,0,0,0,0,0,0,0
20200212,052829,上銀群益96購01,3.92,3.93,3.90,3.93,0.00,0.00,17000,5,66730,0,0,0,0,0,0,5000,17000,-12000,-12000
20200212,05282P,可成元大95售09,1.61,1.61,1.52,1.52,-0.22,-12.64,57000,8,90520,0,0,0,0,0,0,12000,57000,-45000,-45000
20200212,052830,台光電群益96購01,0.90,1.18,0.90,1.13,+0.25,28.41,1110000,62,1177580,10000,0,10000,0,0,0,198000,930000,-732000,-722000
20200212,052831,華固群益96購01,1.47,1.49,1.47,1.49,0.00,0.00,31000,2,45870,0,0,0,0,0,0,0,31000,-31000,-31000
20200212,052832,益航群益96購01,0.63,0.71,0.63,0.67,+0.04,6.35,494000,9,343840,0,0,0,0,0,0,141000,353000,-212000,-212000
20200212,052833,康控群益96購01,0.89,1.05,0.89,1.01,+0.12,13.48,398000,39,395110,0,0,0,0,0,0,260000,148000,112000,112000
20200212,052834,彩晶群益96購01,1.17,1.17,1.17,1.17,0.00,0.00,15000,2,17550,0,0,0,0,0,0,0,15000,-15000,-15000
20200212,052835,滬深2X國泰98購01,1.04,1.04,1.04,1.04,+0.04,4.0,2000,1,2080,0,0,0,0,0,0,2000,0,2000,2000
20200212,052836,旺宏國泰98購01,2.25,2.29,2.20,2.20,-0.03,-1.35,81000,8,182750,0,0,0,0,0,0,70000,14000,56000,56000
20200212,052837,友達國泰97購01,,,,,0.00,0.00,0,0,0,0,0,0,0,0,0,0,0,0,0
20200212,052838,新唐國泰98購01,0.91,0.91,0.91,0.91,+0.05,5.81,50000,1,45500,0,0,0,0,0,0,50000,0,50000,50000
20200212,052839,上海銀國泰97購01,1.57,1.57,1.57,1.57,-0.03,-1.88,2000,2,3140,0,0,0,0,0,0,2000,0,2000,2000
20200212,05283P,健鼎元大95售04,1.53,1.55,1.29,1.29,-0.39,-23.21,1678000,78,2400210,0,0,0,0,0,0,1581000,79000,1502000,1502000
20200212,052840,友達富邦96購01,,,,,0.00,0.00,0,0,0,0,0,0,0,0,0,0,0,0,0
20200212,052841,群創富邦96購02,1.08,1.08,1.07,1.07,+0.03,2.88,11000,2,11870,0,0,0,0,0,0,1000,10000,-9000,-9000
20200212,052842,滬深2X統一96購01,,,,,0.00,0.00,0,0,0,0,0,0,0,0,0,0,0,0,0
20200212,052843,鴻海統一96購09,0.90,0.96,0.90,0.96,0.00,0.00,49000,2,46920,0,0,0,0,0,0,2000,47000,-45000,-45000
20200212,052844,台積電統一96購02,2.22,2.26,2.22,2.26,+0.12,5.61,90000,6,200200,0,0,0,0,0,0,80000,10000,70000,70000
20200212,052845,旺宏統一97購01,3.10,3.15,3.10,3.15,+0.03,0.96,126000,2,395600,0,0,0,0,0,0,126000,0,126000,126000
20200212,052846,智邦統一97購01,,,,,0.00,0.00,0,0,0,0,0,0,0,0,0,0,0,0,0
20200212,052847,漢唐統一99購01,0.70,0.72,0.69,0.71,+0.03,4.41,598000,11,422940,0,0,0,0,0,0,233000,365000,-132000,-132000
20200212,052848,聯發科統一96購03,1.19,1.19,1.19,1.19,0.00,0.00,20000,1,23800,0,0,0,0,0,0,0,20000,-20000,-20000
20200212,052849,可成統一97購01,0.81,0.94,0.81,0.94,+0.17,22.08,582000,16,499770,0,0,0,0,0,0,39000,543000,-504000,-504000
20200212,05284P,鴻海兆豐95售04,1.08,1.08,0.84,0.84,-0.38,-31.15,102000,19,100380,0,0,0,0,0,0,5000,97000,-92000,-92000
20200212,052850,華新科統一96購02,,,,,0.00,0.00,0,0,0,0,0,0,0,0,0,0,0,0,0
20200212,052851,滬深2X元富96購02,1.02,1.04,1.01,1.04,-0.04,-3.7,89000,9,91370,0,0,0,0,0,0,10000,66000,-56000,-56000
20200212,052852,國巨元富96購02,2.80,2.90,2.55,2.85,+0.32,12.65,3505000,157,9660060,0,0,0,0,0,0,1569000,1953000,-384000,-384000
20200212,052853,友達日盛99購01,1.97,1.97,1.97,1.97,-0.12,-5.74,10000,1,19700,0,0,0,0,0,0,10000,0,10000,10000
20200212,052854,聯詠日盛96購01,0.82,0.89,0.82,0.86,+0.10,13.16,40000,17,34340,0,0,0,0,0,0,15000,25000,-10000,-10000
20200212,052855,群創日盛99購01,1.25,1.26,1.22,1.22,+0.02,1.67,90000,5,111150,0,0,0,0,0,0,70000,20000,50000,50000
20200212,052856,滬深2X凱基98購01,,,,,0.00,0.00,0,0,0,0,0,0,0,0,0,0,0,0,0
20200212,052857,大成鋼凱基96購01,0.90,0.90,0.90,0.90,-0.02,-2.17,10000,1,9000,0,0,0,0,0,0,10000,0,10000,10000
20200212,052858,華通凱基97購02,,,,,0.00,0.00,0,0,0,0,0,0,0,0,0,0,0,0,0
20200212,052859,國巨凱基96購07,3.17,3.25,3.05,3.25,+0.29,9.8,161000,11,509370,0,0,0,0,0,0,160000,1000,159000,159000
20200212,05285P,同欣電群益95售02,0.54,0.59,0.54,0.59,-0.05,-7.81,374000,18,212830,0,0,0,0,0,0,6000,368000,-362000,-362000
20200212,052860,旺宏凱基96購03,2.01,2.08,1.98,1.98,-0.05,-2.46,26000,4,52310,0,0,0,0,0,0,16000,11000,5000,5000
20200212,052861,台光電凱基96購03,0.80,1.02,0.27,1.02,+0.27,36.0,297000,23,262500,0,0,0,0,0,0,111000,209000,-98000,-98000
20200212,052862,正崴凱基96購01,0.52,0.52,0.51,0.51,-0.04,-7.27,144000,9,74700,0,0,0,0,0,0,144000,0,144000,144000
20200212,052863,友達凱基98購02,2.30,2.30,2.30,2.30,-0.19,-7.63,7000,1,16100,0,0,0,0,0,0,0,7000,-7000,-7000
20200212,052864,奇力新凱基96購02,2.35,2.49,2.35,2.49,+0.02,0.81,61000,15,147530,0,0,0,0,0,0,50000,13000,37000,37000
20200212,052865,大立光凱基96購11,,,,,0.00,0.00,0,0,0,0,0,0,0,0,0,0,0,0,0
20200212,052866,大立光凱基96購12,1.30,1.30,1.30,1.30,0.00,0.00,2000,1,2600,0,0,0,0,0,0,2000,2000,0,0
20200212,052867,晶技凱基96購01,,,,,0.00,0.00,0,0,0,0,0,0,0,0,0,0,0,0,0
20200212,052868,緯創凱基96購03,,,,,0.00,0.00,0,0,0,0,0,0,0,0,0,0,0,0,0
20200212,052869,新日興凱基96購01,2.33,2.35,0.80,2.35,+0.06,2.62,104000,8,223560,0,0,0,0,0,0,94000,10000,84000,84000
20200212,05286P,矽力統一95售02,0.94,0.95,0.91,0.91,-0.06,-6.19,88000,5,81660,0,0,0,0,0,0,48000,40000,8000,8000
20200212,052870,玉晶光凱基96購03,2.41,2.41,2.41,2.41,+0.20,9.05,14000,1,33740,0,0,0,0,0,0,14000,14000,0,0
20200212,052871,群創凱基98購07,,,,,0.00,0.00,0,0,0,0,0,0,0,0,0,0,0,0,0
20200212,052872,智易凱基96購01,0.48,0.48,0.48,0.48,0.00,0.00,60000,1,28800,0,0,0,0,0,0,0,60000,-60000,-60000
20200212,052873,新唐凱基96購02,,,,,0.00,0.00,0,0,0,0,0,0,0,0,0,0,0,0,0
20200212,052874,超眾凱基96購01,1.25,1.35,1.25,1.35,+0.11,8.87,32000,11,41120,0,0,0,0,0,0,23000,9000,14000,14000
20200212,052875,樺漢凱基96購02,,,,,0.00,0.00,0,0,0,0,0,0,0,0,0,0,0,0,0
20200212,052876,GIS凱基96購03,0.60,0.60,0.60,0.60,0.00,0.00,164000,2,98400,0,0,0,0,0,0,1000,163000,-162000,-162000
20200212,052877,矽創凱基96購01,0.67,0.88,0.67,0.88,+0.21,31.34,30000,15,23950,0,0,0,0,0,0,6000,24000,-18000,-18000
20200212,052878,台虹凱基96購01,0.73,0.75,0.72,0.75,+0.10,15.38,161000,8,118080,0,0,0,0,0,0,160000,1000,159000,159000
20200212,052879,滬深2X凱基97購02,,,,,0.00,0.00,0,0,0,0,0,0,0,0,0,0,0,0,0
20200212,05287P,鴻海元富95售09,1.92,1.92,1.72,1.72,-0.30,-14.85,399000,20,728820,0,0,0,0,0,0,50000,349000,-299000,-299000
20200212,052880,台積電凱基96購06,,,,,0.00,0.00,0,0,0,0,0,0,0,0,0,0,0,0,0
20200212,052881,康控凱基97購01,0.34,0.34,0.34,0.34,+0.05,17.24,36000,2,12240,0,0,0,0,0,0,0,36000,-36000,-36000
20200212,052882,南電凱基96購02,0.41,0.52,0.05,0.51,+0.09,21.43,404000,19,134740,0,0,0,0,0,0,110000,294000,-184000,-184000
20200212,052883,百和亞東97購01,,,,,0.00,0.00,0,0,0,0,0,0,0,0,0,0,0,0,0
20200212,052884,台積電兆豐96購01,1.73,1.79,1.72,1.79,+0.13,7.83,72000,9,125410,0,0,0,0,0,0,47000,25000,22000,22000
20200212,052885,高鐵兆豐98購01,1.13,1.14,1.12,1.14,+0.01,0.88,251000,8,283770,0,0,0,0,0,0,70000,221000,-151000,-151000
20200212,052886,世紀鋼兆豐96購01,0.90,0.90,0.89,0.89,-0.02,-2.2,80000,2,71750,0,0,0,0,0,0,80000,0,80000,80000
20200212,052887,華通中信96購01,0.87,1.00,0.87,1.00,0.00,0.00,94000,7,84250,0,0,0,0,0,0,0,94000,-94000,-94000
20200212,052888,台表科中信9A購01,0.34,0.37,0.34,0.37,+0.03,8.82,332000,8,118690,0,0,0,0,0,0,110000,222000,-112000,-112000
20200212,052889,致伸麥證97購01,0.35,0.35,0.35,0.35,+0.02,6.06,10000,1,3500,10000,0,10000,0,0,0,10000,0,10000,10000
20200212,05288P,寶成元富95售02,1.95,1.95,1.92,1.92,-0.04,-2.04,48000,5,92660,0,0,0,0,0,0,28000,20000,8000,8000
20200212,052890,FB上証群益9B購01,,,,,0.00,0.00,0,0,0,0,0,0,0,0,0,0,0,0,0
20200212,052891,台泥群益96購01,0.88,0.88,0.88,0.88,-0.04,-4.35,11000,1,9680,0,0,0,0,0,0,11000,0,11000,11000
20200212,052892,大成鋼群益96購01,1.41,1.52,1.40,1.52,+0.03,2.01,147000,6,219220,0,0,0,0,0,0,26000,121000,-95000,-95000
20200212,052893,聯電群益98購01,1.61,1.74,1.61,1.69,+0.04,2.42,485000,18,805880,0,0,0,0,0,0,441000,84000,357000,357000
20200212,052894,國巨群益96購03,4.19,4.40,4.06,4.40,+0.37,9.18,275000,33,1152400,0,0,0,0,0,0,257000,46000,211000,211000
20200212,052895,台積電群益96購04,5.65,5.80,5.65,5.80,+0.30,5.45,54000,12,305700,0,0,0,0,0,0,52000,33000,19000,19000
20200212,052896,宏達電群益96購01,2.04,2.04,1.97,2.00,+0.08,4.17,27000,3,54070,0,0,0,0,0,0,16000,17000,-1000,-1000
20200212,052897,緯創群益96購03,1.01,1.01,1.01,1.01,0.00,0.00,11000,1,11110,0,0,0,0,0,0,0,11000,-11000,-11000
20200212,052898,樺漢群益96購01,0.72,0.72,0.72,0.72,-0.01,-1.37,2000,1,1440,0,0,0,0,0,0,2000,0,2000,2000
20200212,052899,和大國票97購01,1.49,1.49,1.49,1.49,+0.01,0.68,22000,2,32780,0,0,0,0,0,0,22000,0,22000,22000
20200212,05289P,鴻海永豐95售05,1.13,1.15,0.92,0.93,-0.33,-26.19,1333000,48,1401770,0,0,0,0,0,0,444000,884000,-440000,-440000
20200212,052900,大成鋼國票97購01,0.25,0.28,0.25,0.28,+0.02,7.69,115000,4,29130,0,0,0,0,0,0,100000,15000,85000,85000
20200212,052901,台達電國票97購01,1.17,1.33,1.13,1.33,+0.16,13.68,130000,13,155600,0,0,0,0,0,0,30000,100000,-70000,-70000
20200212,052902,鴻海國票97購04,0.52,0.67,0.52,0.67,+0.20,42.55,152000,3,83340,0,0,0,0,0,0,100000,52000,48000,48000
20200212,052903,致茂國票97購01,3.08,3.63,3.08,3.63,+0.74,25.61,351000,37,1137560,0,0,0,0,0,0,71000,280000,-209000,-209000
20200212,052904,冠德國票97購01,,,,,0.00,0.00,0,0,0,0,0,0,0,0,0,0,0,0,0
20200212,052905,潤泰全國票97購01,,,,,0.00,0.00,0,0,0,0,0,0,0,0,0,0,0,0,0
20200212,052906,緯創國票97購01,0.42,0.44,0.42,0.44,+0.01,2.33,120000,3,50700,0,0,0,0,0,0,110000,10000,100000,100000
20200212,052907,嘉澤國票97購01,3.45,3.45,3.45,3.45,+0.10,2.99,57000,1,196650,0,0,0,0,0,0,0,57000,-57000,-57000
20200212,052908,大成鋼統一96購01,1.60,1.68,1.59,1.68,+0.07,4.35,104000,4,168960,0,0,0,0,0,0,44000,60000,-16000,-16000
20200212,052909,上銀統一96購01,1.92,1.92,1.84,1.84,+0.01,0.55,50000,5,93400,0,0,0,0,0,0,0,50000,-50000,-50000
20200212,05290P,國巨永豐95售04,,,,,0.00,0.00,0,0,0,0,0,0,0,0,0,0,0,0,0
20200212,052910,鴻海統一96購10,0.71,0.77,0.71,0.77,+0.11,16.67,205000,5,151840,0,0,0,0,0,0,149000,56000,93000,93000
20200212,052911,友達統一97購02,,,,,0.00,0.00,0,0,0,0,0,0,0,0,0,0,0,0,0
20200212,052912,日月光統一96購01,1.96,2.24,1.96,2.20,+0.35,18.92,49000,5,107510,0,0,0,0,0,0,2000,47000,-45000,-45000
20200212,052913,鴻海元富96購05,0.22,0.27,0.22,0.27,+0.06,28.57,895000,15,217950,0,0,0,0,0,0,835000,30000,805000,805000
20200212,052914,奇力新元富96購01,2.71,2.85,2.50,2.85,+0.17,6.34,2335000,122,6253160,0,0,0,0,0,0,1351000,942000,409000,409000
20200212,052915,創意元富96購01,1.25,1.31,1.15,1.24,-0.13,-9.49,492000,40,603370,0,0,0,0,0,0,286000,242000,44000,44000
20200212,052916,華新科富邦96購01,,,,,0.00,0.00,0,0,0,0,0,0,0,0,0,0,0,0,0
20200212,052917,大立光富邦99購02,0.83,0.90,0.83,0.88,+0.07,8.64,550000,46,476330,0,0,0,0,0,0,422000,92000,330000,330000
20200212,052918,智易富邦97購02,,,,,0.00,0.00,0,0,0,0,0,0,0,0,0,0,0,0,0
20200212,052919,鈺齊富邦98購01,0.69,0.79,0.69,0.78,+0.07,9.86,123000,16,92680,0,0,0,0,0,0,0,110000,-110000,-110000
20200212,05291P,鴻海凱基95售16,0.55,0.55,0.45,0.45,-0.19,-29.69,211000,10,97610,0,0,0,0,0,0,185000,26000,159000,159000
20200212,052920,景碩台新96購02,1.04,1.35,1.00,1.20,+0.15,14.29,814000,37,912630,0,0,0,0,0,0,328000,486000,-158000,-158000
20200212,052921,大成鋼永豐96購01,0.41,0.43,0.41,0.43,-0.01,-2.27,62000,2,26460,0,0,0,0,0,0,62000,0,62000,62000
20200212,052922,國巨永豐96購01,1.94,2.05,1.92,2.05,+0.17,9.04,223000,17,447520,0,0,0,0,0,0,59000,164000,-105000,-105000
20200212,052923,台積電永豐96購02,1.72,1.78,1.72,1.78,+0.14,8.54,347000,13,616240,0,0,0,0,0,0,290000,57000,233000,233000
20200212,052924,旺宏永豐96購01,0.89,0.89,0.85,0.85,-0.06,-6.59,210000,4,180900,0,0,0,0,0,0,110000,100000,10000,10000
20200212,052925,日電貿永豐96購01,0.75,0.75,0.70,0.75,+0.02,2.74,510000,33,370930,0,0,0,0,0,0,323000,117000,206000,206000
20200212,052926,旺宏元大98購02,1.61,1.66,1.54,1.57,-0.01,-0.63,359000,29,570480,0,0,0,0,0,0,272000,76000,196000,196000
20200212,052927,友達元大98購02,,,,,0.00,0.00,0,0,0,0,0,0,0,0,0,0,0,0,0
20200212,052928,美律元大98購01,0.67,0.75,0.67,0.75,+0.14,22.95,265000,10,185680,0,0,0,0,0,0,13000,252000,-239000,-239000
20200212,052929,可成元大96購02,0.64,0.72,0.64,0.72,+0.16,28.57,234000,5,157880,0,0,0,0,0,0,224000,209000,15000,15000
20200212,05292P,台積電凱基95售16,,,,,0.00,0.00,0,0,0,0,0,0,0,0,0,0,0,0,0
20200212,052930,華新科元大97購03,,,,,0.00,0.00,0,0,0,0,0,0,0,0,0,0,0,0,0
20200212,052931,麗豐元大97購01,0.67,0.71,0.67,0.69,+0.05,7.81,201000,5,137680,0,0,0,0,0,0,0,201000,-201000,-201000
20200212,052932,正文元大97購01,1.14,1.17,1.14,1.17,+0.03,2.63,200000,4,231000,0,0,0,0,0,0,100000,100000,0,0
20200212,052933,祥碩元大96購01,8.65,8.65,8.65,8.65,0.00,0.00,1000,1,8650,0,0,0,0,0,0,1000,0,1000,1000
20200212,052934,中磊元大96購01,1.91,1.93,1.87,1.87,+0.01,0.54,52000,7,99240,0,0,0,0,0,0,39000,40000,-1000,-1000
20200212,052935,康友元大96購03,1.64,1.72,1.64,1.64,+0.01,0.61,394000,17,666550,0,0,0,0,0,0,124000,374000,-250000,-250000
20200212,052936,華通兆豐98購01,0.95,1.22,0.95,1.20,+0.44,57.89,336000,10,359860,0,0,0,0,0,0,274000,58000,216000,216000
20200212,052937,國巨兆豐97購01,1.40,1.45,1.35,1.45,+0.14,10.69,911000,45,1287610,0,0,0,0,0,0,573000,326000,247000,247000
20200212,052938,華新科兆豐96購01,,,,,0.00,0.00,0,0,0,0,0,0,0,0,0,0,0,0,0
20200212,052939,富邦金兆豐96購01,1.80,1.81,1.80,1.81,+0.14,8.38,221000,4,398010,0,0,0,0,0,0,208000,13000,195000,195000
20200212,05293P,廣達凱基95售01,,,,,0.00,0.00,0,0,0,0,0,0,0,0,0,0,0,0,0
20200212,052940,玉晶光兆豐97購01,,,,,0.00,0.00,0,0,0,0,0,0,0,0,0,0,0,0,0
20200212,052941,康控兆豐97購01,0.55,0.59,0.55,0.58,+0.07,13.73,844000,19,481510,0,0,0,0,0,0,345000,497000,-152000,-152000
20200212,052942,聯發科中信97購04,0.39,0.44,0.39,0.44,+0.10,29.41,1071000,36,435500,0,0,0,0,0,0,966000,83000,883000,883000
20200212,052943,奇力新國票96購02,2.54,2.70,2.44,2.70,+0.11,4.25,135000,28,339950,0,0,0,0,0,0,102000,33000,69000,69000
20200212,052944,宏達電國票97購01,0.78,0.81,0.78,0.80,+0.05,6.67,205000,9,162750,0,0,0,0,0,0,180000,25000,155000,155000
20200212,052945,嘉晶國票97購01,1.31,1.32,1.31,1.32,0.00,0.00,67000,2,88140,0,0,0,0,0,0,0,67000,-67000,-67000
20200212,052946,智原國票97購02,1.01,1.13,1.01,1.13,+0.15,15.31,102000,5,108840,0,0,0,0,0,0,1000,101000,-100000,-100000
20200212,052947,晶技國票97購01,,,,,0.00,0.00,0,0,0,0,0,0,0,0,0,0,0,0,0
20200212,052948,景碩國票97購02,2.26,2.84,2.24,2.72,+0.40,17.24,295000,45,723060,0,0,0,0,0,0,159000,216000,-57000,-57000
20200212,052949,智易國票97購02,0.56,0.67,0.56,0.67,0.00,0.00,166000,4,100440,0,0,0,0,0,0,20000,146000,-126000,-126000
20200212,05294P,亞光凱基95售02,,,,,0.00,0.00,0,0,0,0,0,0,0,0,0,0,0,0,0
20200212,052950,超眾國票98購01,1.30,1.30,1.30,1.30,+0.08,6.56,10000,1,13000,0,0,0,0,0,0,0,10000,-10000,-10000
20200212,052951,GIS國票97購02,0.54,0.54,0.54,0.54,0.00,0.00,60000,1,32400,0,0,0,0,0,0,0,60000,-60000,-60000
20200212,052952,矽創國票97購02,0.97,1.20,0.97,1.20,+0.21,21.21,136000,21,146410,0,0,0,0,0,0,72000,64000,8000,8000
20200212,052953,百和國票97購01,,,,,0.00,0.00,0,0,0,0,0,0,0,0,0,0,0,0,0
20200212,052954,大成鋼日盛96購01,,,,,0.00,0.00,0,0,0,0,0,0,0,0,0,0,0,0,0
20200212,052955,國巨日盛96購01,1.74,1.74,1.70,1.74,+0.10,6.1,81000,9,139960,0,0,0,0,0,0,81000,0,81000,81000
20200212,052956,聯發科日盛96購01,0.60,0.65,0.60,0.65,+0.14,27.45,60000,10,38360,0,0,0,0,0,0,55000,5000,50000,50000
20200212,052957,T50反1凱基99購01,0.44,0.44,0.39,0.39,-0.07,-15.22,40000,6,15870,0,0,0,0,0,0,0,40000,-40000,-40000
20200212,052958,T50反1凱基99購02,0.31,0.31,0.30,0.30,0.00,0.00,25000,2,7700,0,0,0,0,0,0,0,25000,-25000,-25000
20200212,052959,聯電凱基97購01,1.10,1.23,1.10,1.23,+0.10,8.85,194000,12,219430,0,0,0,0,0,0,183000,41000,142000,142000
20200212,05295P,緯創凱基95售01,,,,,0.00,0.00,0,0,0,0,0,0,0,0,0,0,0,0,0
20200212,052960,中環凱基96購01,0.29,0.29,0.28,0.28,-0.07,-20.0,67000,3,19060,0,0,0,0,0,0,7000,60000,-53000,-53000
20200212,052961,國巨凱基97購02,2.17,2.22,2.12,2.22,+0.21,10.45,59000,11,127370,0,0,0,0,0,0,55000,14000,41000,41000
20200212,052962,台積電凱基97購03,2.13,2.13,2.00,2.11,+0.23,12.23,26000,5,53720,0,0,0,0,0,0,0,26000,-26000,-26000
20200212,052963,智邦凱基96購02,2.56,2.56,2.07,2.27,+0.03,1.34,52000,9,113740,0,0,0,0,0,0,52000,51000,1000,1000
20200212,052964,台表科凱基96購03,0.35,0.35,0.35,0.35,+0.05,16.67,20000,2,7000,0,0,0,0,0,0,0,20000,-20000,-20000
20200212,052965,廣宇群益97購01,0.73,0.75,0.73,0.75,+0.07,10.29,210000,4,153320,0,0,0,0,0,0,0,210000,-210000,-210000
20200212,052966,光磊群益96購01,0.73,0.73,0.73,0.73,+0.03,4.29,11000,1,8030,0,0,0,0,0,0,0,11000,-11000,-11000
20200212,052967,智邦群益96購01,2.30,2.48,2.00,2.03,-0.15,-6.88,156000,18,356830,0,0,0,0,0,0,131000,45000,86000,86000
20200212,052968,燿華群益98購01,1.28,1.46,1.27,1.43,+0.06,4.38,493000,32,685310,0,0,0,0,0,0,5000,493000,-488000,-488000
20200212,052969,建準群益97購01,1.64,1.65,1.59,1.59,-0.03,-1.85,26000,4,42390,0,0,0,0,0,0,16000,10000,6000,6000
20200212,05296P,牧德凱基96售01,,,,,0.00,0.00,0,0,0,0,0,0,0,0,0,0,0,0,0
20200212,052970,美律群益96購01,0.69,0.85,0.69,0.82,+0.19,30.16,595000,63,472660,0,0,0,0,0,0,81000,539000,-458000,-458000
20200212,052971,京元電群益98購01,,,,,0.00,0.00,0,0,0,0,0,0,0,0,0,0,0,0,0
20200212,052972,義隆群益96購04,1.71,1.71,1.58,1.69,+0.27,19.01,259000,16,438250,0,0,0,0,0,0,177000,82000,95000,95000
20200212,052973,冠德群益96購01,,,,,0.00,0.00,0,0,0,0,0,0,0,0,0,0,0,0,0
20200212,052974,瀚宇博群益96購01,0.74,0.77,0.74,0.77,-0.02,-2.53,113000,4,84760,0,0,0,0,0,0,12000,101000,-89000,-89000
20200212,052975,嘉聯益群益96購01,0.97,0.99,0.96,0.96,+0.07,7.87,40000,6,38470,0,0,0,0,0,0,40000,0,40000,40000
20200212,052976,台表科群益96購03,0.61,0.68,0.61,0.68,+0.13,23.64,586000,4,373600,0,0,0,0,0,0,100000,486000,-386000,-386000
20200212,052977,奇力新麥證97購01,2.16,2.31,2.13,2.31,+0.04,1.76,176000,26,388190,108000,60000,48000,0,0,0,148000,110000,38000,38000
20200212,052978,貿聯麥證97購01,0.61,0.65,0.61,0.65,+0.06,10.17,81000,9,50610,39000,42000,-3000,0,0,0,39000,42000,-3000,-3000
20200212,052979,上銀元大96購02,2.52,2.52,2.40,2.40,-0.01,-0.41,261000,21,642620,0,0,0,0,0,0,181000,91000,90000,90000
20200212,05297P,臻鼎凱基95售04,0.81,0.82,0.81,0.82,0.00,0.00,5000,2,4070,0,0,0,0,0,0,0,5000,-5000,-5000
20200212,052980,上銀元大96購03,2.61,2.64,2.54,2.57,+0.04,1.58,244000,23,625550,0,0,0,0,0,0,218000,22000,196000,196000
20200212,052981,鴻海元大97購05,0.94,1.14,0.94,1.13,+0.23,25.56,300000,14,319550,0,0,0,0,0,0,95000,255000,-160000,-160000
20200212,052982,鴻海元大97購06,0.33,0.44,0.33,0.44,+0.11,33.33,53000,7,21440,0,0,0,0,0,0,13000,30000,-17000,-17000
20200212,052983,國巨元大96購07,2.87,2.91,2.77,2.91,+0.19,6.99,115000,20,323980,0,0,0,0,0,0,88000,81000,7000,7000
20200212,052984,漢唐元大96購01,2.82,2.92,2.78,2.92,+0.09,3.18,85000,11,241260,0,0,0,0,0,0,57000,28000,29000,29000
20200212,052985,美律元大96購02,0.45,0.54,0.45,0.54,+0.12,28.57,465000,25,227150,0,0,0,0,0,0,138000,304000,-166000,-166000
20200212,052986,聯發科元大97購05,0.60,0.66,0.60,0.65,+0.11,20.37,1235000,54,789530,0,0,0,0,0,0,570000,563000,7000,7000
20200212,052987,華新科元大99購01,,,,,0.00,0.00,0,0,0,0,0,0,0,0,0,0,0,0,0
20200212,052988,智易元大96購02,0.56,0.63,0.56,0.63,+0.13,26.0,38000,7,23110,0,0,0,0,0,0,25000,13000,12000,12000
20200212,052989,麗豐元大98購01,1.05,1.12,1.03,1.09,+0.09,9.0,258000,12,278000,0,0,0,0,0,0,45000,248000,-203000,-203000
20200212,05298P,上銀元大95售03,,,,,0.00,0.00,0,0,0,0,0,0,0,0,0,0,0,0,0
20200212,052990,超眾元大97購01,1.85,2.09,1.85,2.08,+0.15,7.77,415000,45,814970,0,0,0,0,0,0,360000,299000,61000,61000
20200212,052991,台積電台新96購01,1.86,1.90,1.86,1.90,+0.12,6.74,19000,3,35580,0,0,0,0,0,0,6000,13000,-7000,-7000
20200212,052992,冠德台新96購01,,,,,0.00,0.00,0,0,0,0,0,0,0,0,0,0,0,0,0
20200212,052993,欣興台新97購01,1.02,1.19,1.02,1.19,+0.26,27.96,155000,6,166040,0,0,0,0,0,0,16000,139000,-123000,-123000
20200212,052994,群創台新99購01,,,,,0.00,0.00,0,0,0,0,0,0,0,0,0,0,0,0,0
20200212,052995,上銀康和96購01,,,,,0.00,0.00,0,0,0,0,0,0,0,0,0,0,0,0,0
20200212,052996,聯電康和96購01,0.81,0.81,0.81,0.81,-0.03,-3.57,62000,1,50220,0,0,0,0,0,0,62000,0,62000,62000
20200212,052997,國巨康和96購01,,,,,0.00,0.00,0,0,0,0,0,0,0,0,0,0,0,0,0
20200212,052998,拓凱康和96購01,0.90,0.90,0.90,0.90,+0.01,1.12,10000,1,9000,0,0,0,0,0,0,10000,0,10000,10000
20200212,052999,臺股指康和96購01,,,,,0.00,0.00,0,0,0,0,0,0,0,0,0,0,0,0,0
20200212,05299P,旺宏元大95售04,0.44,0.44,0.44,0.44,-0.01,-2.22,2000,1,880,0,0,0,0,0,0,0,2000,-2000,-2000
20200212,053000,臺股指康和96購02,1.10,1.17,1.10,1.17,+0.12,11.43,42000,4,47670,0,0,0,0,0,0,42000,0,42000,42000
20200212,053001,力山永豐96購01,0.43,0.45,0.43,0.45,+0.03,7.14,100000,2,43020,0,0,0,0,0,0,99000,1000,98000,98000
20200212,053002,鴻海永豐96購01,0.54,0.60,0.54,0.60,0.00,0.00,47000,5,27100,0,0,0,0,0,0,25000,22000,3000,3000
20200212,053003,國巨永豐96購02,2.37,2.44,2.31,2.44,+0.20,8.93,232000,9,539590,0,0,0,0,0,0,223000,9000,214000,214000
20200212,053004,燿華永豐96購01,0.52,0.52,0.52,0.52,+0.10,23.81,2000,1,1040,0,0,0,0,0,0,2000,0,2000,2000
20200212,053005,微星永豐96購01,1.80,1.80,1.51,1.51,-0.06,-3.82,331000,14,543460,0,0,0,0,0,0,186000,139000,47000,47000
20200212,053006,玉晶光永豐96購03,3.89,4.27,3.89,4.13,+0.43,11.62,98000,14,397310,0,0,0,0,0,0,27000,71000,-44000,-44000
20200212,053007,致伸永豐96購01,0.16,0.16,0.16,0.16,0.00,0.00,100000,1,16000,0,0,0,0,0,0,0,100000,-100000,-100000
20200212,053008,達方永豐96購01,0.56,0.60,0.56,0.60,+0.04,7.14,338000,5,198300,0,0,0,0,0,0,150000,188000,-38000,-38000
20200212,053009,大成鋼統一96購02,0.46,0.51,0.46,0.51,+0.04,8.51,638000,8,309320,0,0,0,0,0,0,520000,118000,402000,402000
20200212,05300P,健策元大95售02,,,,,0.00,0.00,0,0,0,0,0,0,0,0,0,0,0,0,0
20200212,053010,鴻海統一96購11,0.90,0.90,0.90,0.90,0.00,0.00,30000,1,27000,0,0,0,0,0,0,0,30000,-30000,-30000
20200212,053011,鴻海統一98購01,0.88,0.88,0.88,0.88,0.00,0.00,5000,1,4400,0,0,0,0,0,0,5000,0,5000,5000
20200212,053012,國巨統一96購03,2.48,2.48,2.35,2.47,+0.18,7.86,187000,8,450250,0,0,0,0,0,0,177000,10000,167000,167000
20200212,053013,台積電統一97購01,2.00,2.12,1.95,2.09,+0.18,9.42,248000,10,515600,0,0,0,0,0,0,238000,5000,233000,233000
20200212,053014,旺宏統一97購02,2.10,2.10,2.03,2.03,0.00,0.00,12000,2,24500,0,0,0,0,0,0,2000,12000,-10000,-10000
20200212,053015,緯創統一96購01,0.45,0.45,0.45,0.45,0.00,0.00,51000,1,22950,0,0,0,0,0,0,51000,0,51000,51000
20200212,053016,鈺齊統一96購01,0.40,0.44,0.40,0.44,+0.02,4.76,198000,4,81680,0,0,0,0,0,0,148000,50000,98000,98000
20200212,053017,世紀鋼統一96購02,1.34,1.35,1.31,1.31,-0.02,-1.5,100000,20,132690,0,0,0,0,0,0,75000,15000,60000,60000
20200212,053018,旺宏元富96購02,2.79,2.79,2.74,2.74,+0.03,1.11,109000,4,299050,0,0,0,0,0,0,109000,0,109000,109000
20200212,053019,禾伸堂元富96購01,1.75,1.79,1.72,1.79,+0.06,3.47,168000,5,292960,0,0,0,0,0,0,51000,98000,-47000,-47000
20200212,05301P,矽力元大95售02,1.05,1.05,1.05,1.05,-0.09,-7.89,60000,1,63000,0,0,0,0,0,0,60000,0,60000,60000
20200212,053020,貿聯元富96購01,0.78,0.89,0.78,0.89,+0.14,18.67,46000,10,38230,0,0,0,0,0,0,30000,16000,14000,14000
20200212,053021,國巨國泰97購04,2.95,3.06,2.89,3.06,+0.26,9.29,94000,6,274440,0,0,0,0,0,0,94000,0,94000,94000
20200212,053022,欣興國泰98購01,1.05,1.28,1.05,1.27,+0.26,25.74,354000,33,437980,0,0,0,0,0,0,214000,129000,85000,85000
20200212,053023,泰鼎國泰97購01,4.12,4.33,4.09,4.33,+0.46,11.89,38000,5,161810,0,0,0,0,0,0,14000,24000,-10000,-10000
20200212,053024,國巨富邦97購02,1.81,1.84,1.72,1.84,+0.15,8.88,373000,48,668790,0,0,0,0,0,0,187000,93000,94000,94000
20200212,053025,燿華富邦98購02,0.62,0.66,0.62,0.66,+0.05,8.2,1516000,18,967080,0,0,0,0,0,0,574000,629000,-55000,-55000
20200212,053026,奇力新富邦98購01,1.17,1.18,1.17,1.18,+0.15,14.56,14000,3,16400,0,0,0,0,0,0,0,14000,-14000,-14000
20200212,053027,玉晶光富邦98購01,1.56,1.56,1.55,1.55,0.00,0.00,3000,3,4660,0,0,0,0,0,0,3000,0,3000,3000
20200212,053028,康控富邦98購01,0.38,0.42,0.38,0.42,+0.06,16.67,377000,9,152530,0,0,0,0,0,0,12000,356000,-344000,-344000
20200212,053029,國巨第一96購01,1.26,1.30,1.23,1.30,+0.08,6.56,1050000,74,1325810,0,0,0,0,0,0,706000,171000,535000,535000
20200212,05302P,華通國泰96售01,,,,,0.00,0.00,0,0,0,0,0,0,0,0,0,0,0,0,0
20200212,053030,南亞科第一96購01,,,,,0.00,0.00,0,0,0,0,0,0,0,0,0,0,0,0,0
20200212,053031,華新科第一96購01,1.72,1.76,1.72,1.76,+0.07,4.14,4000,2,7000,0,0,0,0,0,0,4000,1000,3000,3000
20200212,053032,國巨兆豐97購02,1.53,1.58,1.50,1.58,+0.13,8.97,555000,17,848090,0,0,0,0,0,0,28000,527000,-499000,-499000
20200212,053033,智易兆豐97購01,0.49,0.54,0.49,0.54,0.00,0.00,158000,2,82970,0,0,0,0,0,0,0,158000,-158000,-158000
20200212,053034,上海銀兆豐96購01,0.64,0.67,0.64,0.67,+0.02,3.08,40000,4,26730,0,0,0,0,0,0,40000,37000,3000,3000
20200212,053035,台表科兆豐97購01,0.55,0.59,0.55,0.59,+0.04,7.27,305000,10,174070,0,0,0,0,0,0,54000,251000,-197000,-197000
20200212,053036,聯電凱基98購01,0.81,0.85,0.03,0.85,+0.01,1.19,335000,19,142030,0,0,0,0,0,0,139000,277000,-138000,-138000
20200212,053037,國巨凱基96購08,2.78,2.78,2.78,2.78,+0.21,8.17,10000,1,27800,0,0,0,0,0,0,10000,0,10000,10000
20200212,053038,華邦電凱基97購01,0.26,0.26,0.26,0.26,+0.03,13.04,50000,1,13000,0,0,0,0,0,0,50000,0,50000,50000
20200212,053039,聯發科凱基96購11,0.52,0.63,0.50,0.62,+0.17,37.78,408000,35,232010,0,0,0,0,0,0,297000,98000,199000,199000
20200212,05303P,華通國泰97售01,1.75,1.75,1.45,1.45,-0.44,-23.28,241000,7,384130,0,0,0,0,0,0,0,241000,-241000,-241000
20200212,053040,全新凱基98購01,0.81,0.81,0.81,0.81,0.00,0.00,105000,2,85050,0,0,0,0,0,0,15000,105000,-90000,-90000
20200212,053041,可成凱基96購02,,,,,0.00,0.00,0,0,0,0,0,0,0,0,0,0,0,0,0
20200212,053042,大立光凱基97購03,,,,,0.00,0.00,0,0,0,0,0,0,0,0,0,0,0,0,0
20200212,053043,嘉晶凱基96購01,0.55,0.60,0.55,0.60,+0.09,17.65,341000,9,202270,0,0,0,0,0,0,0,341000,-341000,-341000
20200212,053044,南茂凱基96購02,0.44,0.49,0.43,0.49,+0.01,2.08,235000,22,105790,0,0,0,0,0,0,161000,70000,91000,91000
20200212,053045,國巨中信97購01,1.72,1.72,1.60,1.71,+0.14,8.92,1006000,42,1649330,0,0,0,0,0,0,754000,252000,502000,502000
20200212,053046,智易中信96購01,,,,,0.00,0.00,0,0,0,0,0,0,0,0,0,0,0,0,0
20200212,053047,寶成中信97購01,,,,,0.00,0.00,0,0,0,0,0,0,0,0,0,0,0,0,0
20200212,053048,同欣電麥證96購01,1.54,1.68,1.54,1.64,+0.17,11.56,112000,21,178760,52000,60000,-8000,0,0,0,52000,60000,-8000,-8000
20200212,053049,T50反1國票98購01,0.53,0.53,0.53,0.53,0.00,0.00,20000,1,10600,0,0,0,0,0,0,0,20000,-20000,-20000
20200212,05304P,國巨國泰97售02,0.56,0.57,0.55,0.55,-0.08,-12.7,555000,5,313400,0,0,0,0,0,0,5000,550000,-545000,-545000
20200212,053050,華通國票97購02,1.16,1.25,1.16,1.25,0.00,0.00,44000,2,51130,0,0,0,0,0,0,0,44000,-44000,-44000
20200212,053051,楠梓電國票97購01,0.67,0.70,0.66,0.70,+0.01,1.45,60000,9,40110,0,0,0,0,0,0,60000,0,60000,60000
20200212,053052,旺宏國票97購02,1.31,1.31,1.23,1.25,-0.02,-1.57,104000,6,129110,0,0,0,0,0,0,50000,54000,-4000,-4000
20200212,053053,京元電國票97購02,0.56,0.65,0.56,0.65,+0.05,8.33,106000,10,64650,0,0,0,0,0,0,96000,10000,86000,86000
20200212,053054,禾伸堂國票97購01,2.10,2.14,2.05,2.14,+0.03,1.42,98000,18,203930,0,0,0,0,0,0,29000,69000,-40000,-40000
20200212,053055,聯詠國票97購01,1.82,1.88,1.76,1.88,+0.19,11.24,236000,14,437310,0,0,0,0,0,0,128000,108000,20000,20000
20200212,053056,同欣電國票97購01,2.96,3.46,2.96,3.36,+0.34,11.26,110000,19,358300,0,0,0,0,0,0,72000,38000,34000,34000
20200212,053057,聯電國泰97購02,1.33,1.45,1.33,1.45,+0.09,6.62,143000,14,194750,0,0,0,0,0,0,125000,83000,42000,42000
20200212,053058,台光電永昌99購01,,,,,0.00,0.00,0,0,0,0,0,0,0,0,0,0,0,0,0
20200212,053059,聯發科永昌99購01,1.41,1.56,1.41,1.56,+0.31,24.8,333000,16,475930,0,0,0,0,0,0,333000,53000,280000,280000
20200212,05305P,華新科國泰97售01,,,,,0.00,0.00,0,0,0,0,0,0,0,0,0,0,0,0,0
20200212,053060,大立光永昌96購05,2.95,3.19,2.95,3.14,0.00,0.00,241000,6,742200,0,0,0,0,0,0,200000,241000,-41000,-41000
20200212,053061,GIS富邦97購01,0.32,0.32,0.32,0.32,0.00,0.00,189000,4,60480,0,0,0,0,0,0,0,189000,-189000,-189000
20200212,053062,緯穎富邦97購01,1.74,1.88,1.69,1.88,+0.20,11.9,139000,15,244630,0,0,0,0,0,0,107000,52000,55000,55000
20200212,053063,力山群益98購01,0.58,0.58,0.58,0.58,-0.01,-1.69,1000,1,580,0,0,0,0,0,0,0,1000,-1000,-1000
20200212,053064,國巨群益96購04,8.00,8.20,7.90,8.20,+0.60,7.89,26000,8,207950,0,0,0,0,0,0,24000,21000,3000,3000
20200212,053065,大立光群益96購01,2.00,2.20,2.00,2.20,+0.30,15.79,140000,6,304540,0,0,0,0,0,0,21000,119000,-98000,-98000
20200212,053066,欣興群益96購02,0.97,1.30,0.97,1.30,+0.28,27.45,418000,20,484820,0,0,0,0,0,0,26000,392000,-366000,-366000
20200212,053067,牧德群益96購01,,,,,0.00,0.00,0,0,0,0,0,0,0,0,0,0,0,0,0
20200212,053068,智伸科群益96購01,1.57,1.57,1.44,1.44,-0.10,-6.49,20000,3,30450,0,0,0,0,0,0,0,20000,-20000,-20000
20200212,053069,同欣電群益98購01,1.61,1.91,1.59,1.59,-0.07,-4.22,262000,26,465290,0,0,0,0,0,0,131000,221000,-90000,-90000
20200212,05306P,泰碩國泰97售01,1.89,1.89,1.88,1.88,-0.04,-2.08,122000,4,229380,0,0,0,0,0,0,122000,0,122000,122000
20200212,053070,訊芯群益96購01,1.11,1.31,1.11,1.27,+0.16,14.41,424000,20,500700,0,0,0,0,0,0,219000,255000,-36000,-36000
20200212,053071,南電群益96購01,0.50,0.68,0.50,0.68,+0.11,19.3,689000,42,388390,0,0,0,0,0,0,340000,354000,-14000,-14000
20200212,053072,國巨台新97購01,3.01,3.01,3.01,3.01,0.00,0.00,1000,1,3010,0,0,0,0,0,0,1000,0,1000,1000
20200212,053073,技嘉康和96購01,1.12,1.15,1.02,1.08,-0.04,-3.57,1176000,79,1291610,0,0,0,0,0,0,758000,383000,375000,375000
20200212,053074,嘉晶永豐96購02,0.76,0.83,0.73,0.81,0.00,0.00,50000,7,39470,0,0,0,0,0,0,10000,40000,-30000,-30000
20200212,053075,欣興永豐96購01,0.58,0.68,0.58,0.68,+0.21,44.68,142000,7,95440,0,0,0,0,0,0,0,142000,-142000,-142000
20200212,053076,貿聯永豐96購01,0.39,0.39,0.39,0.39,+0.03,8.33,40000,1,15600,0,0,0,0,0,0,40000,0,40000,40000
20200212,053077,同欣電永豐96購01,0.80,0.93,0.80,0.92,+0.10,12.2,414000,35,367220,0,0,0,0,0,0,105000,309000,-204000,-204000
20200212,053078,昇陽半永豐97購02,0.59,0.59,0.59,0.59,+0.01,1.72,40000,1,23600,0,0,0,0,0,0,40000,0,40000,40000
20200212,053079,世紀鋼永豐96購01,0.69,0.71,0.68,0.71,-0.01,-1.39,482000,9,331360,0,0,0,0,0,0,188000,294000,-106000,-106000
20200212,05307P,光寶科中信95售01,0.70,0.72,0.70,0.72,0.00,0.00,70000,2,49200,0,0,0,0,0,0,70000,0,70000,70000
20200212,053080,力山元大96購02,,,,,0.00,0.00,0,0,0,0,0,0,0,0,0,0,0,0,0
20200212,053081,上銀元大97購02,5.20,5.20,4.90,4.95,+0.13,2.7,139000,31,704310,0,0,0,0,0,0,113000,94000,19000,19000
20200212,053082,聯電元大98購03,0.86,0.95,0.86,0.92,+0.04,4.55,730000,35,658220,0,0,0,0,0,0,477000,482000,-5000,-5000
20200212,053083,中環元大99購01,0.67,0.67,0.60,0.66,-0.05,-7.04,522000,29,345860,0,0,0,0,0,0,474000,46000,428000,428000
20200212,053084,國巨元大98購01,5.55,5.65,5.40,5.65,+0.35,6.6,92000,10,500950,0,0,0,0,0,0,90000,82000,8000,8000
20200212,053085,華新科元大97購04,6.30,6.40,6.15,6.15,+0.05,0.82,26000,4,161900,0,0,0,0,0,0,26000,5000,21000,21000
20200212,053086,宏達電元大97購01,1.51,1.51,1.51,1.51,0.00,0.00,1000,1,1510,0,0,0,0,0,0,0,1000,-1000,-1000
20200212,053087,冠德元大96購02,0.59,0.62,0.59,0.62,0.00,0.00,610000,5,369200,0,0,0,0,0,0,0,610000,-610000,-610000
20200212,053088,奇鋐元大98購01,0.43,0.45,0.43,0.45,0.00,0.00,601000,4,263420,0,0,0,0,0,0,0,601000,-601000,-601000
20200212,053089,貿聯元大97購02,1.29,1.51,1.29,1.51,+0.22,17.05,19000,6,27750,0,0,0,0,0,0,9000,10000,-1000,-1000
20200212,05308P,台積電中信95售08,0.15,0.15,0.15,0.15,0.00,0.00,250000,1,37500,0,0,0,0,0,0,250000,0,250000,250000
20200212,053090,新唐元大96購01,0.77,0.80,0.77,0.80,+0.04,5.26,125000,4,99100,0,0,0,0,0,0,55000,70000,-15000,-15000
20200212,053091,同欣電元大96購01,2.59,2.87,2.50,2.50,-0.04,-1.57,158000,30,419310,0,0,0,0,0,0,125000,64000,61000,61000
20200212,053092,台表科元大97購02,1.43,1.44,1.43,1.43,+0.10,7.52,80000,4,114420,0,0,0,0,0,0,80000,12000,68000,68000
20200212,053093,緯穎元大96購06,4.03,4.37,3.88,4.33,+0.21,5.1,272000,41,1145090,0,0,0,0,0,0,242000,253000,-11000,-11000
20200212,053094,聯電統一97購02,1.29,1.39,1.28,1.39,+0.01,0.72,455000,37,600140,0,0,0,0,0,0,306000,110000,196000,196000
20200212,053095,台光電統一98購01,0.77,0.99,0.77,0.96,+0.21,28.0,497000,11,427640,0,0,0,0,0,0,0,497000,-497000,-497000
20200212,053096,康控統一96購01,0.43,0.46,0.43,0.46,+0.08,21.05,352000,9,154660,0,0,0,0,0,0,10000,342000,-332000,-332000
20200212,053097,超眾統一96購03,1.61,1.73,1.59,1.73,+0.13,8.12,568000,26,931810,0,0,0,0,0,0,420000,148000,272000,272000
20200212,053098,國巨元富96購04,2.34,2.55,2.34,2.52,+0.18,7.69,509000,28,1256050,0,0,0,0,0,0,367000,137000,230000,230000
20200212,053099,正崴元富96購01,0.55,0.56,0.54,0.56,0.00,0.00,66000,14,36290,0,0,0,0,0,0,58000,8000,50000,50000
20200212,05309P,康友中信95售03,,,,,0.00,0.00,0,0,0,0,0,0,0,0,0,0,0,0,0
20200212,053100,美律元富96購01,0.74,0.84,0.74,0.82,+0.14,20.59,98000,15,78150,0,0,0,0,0,0,12000,88000,-76000,-76000
20200212,053101,創意元富96購03,1.50,1.55,1.41,1.52,-0.16,-9.52,313000,39,466380,0,0,0,0,0,0,228000,60000,168000,168000
20200212,053102,祥碩元富96購01,,,,,0.00,0.00,0,0,0,0,0,0,0,0,0,0,0,0,0
20200212,053103,瀚宇博元富96購01,1.01,1.16,1.01,1.16,+0.11,10.48,432000,32,472770,0,0,0,0,0,0,190000,251000,-61000,-61000
20200212,053104,台表科元富96購02,0.81,0.81,0.81,0.81,+0.06,8.0,277000,5,224370,0,0,0,0,0,0,0,277000,-277000,-277000
20200212,053105,鴻海兆豐97購01,0.49,0.53,0.49,0.53,+0.16,43.24,22000,2,11180,0,0,0,0,0,0,0,22000,-22000,-22000
20200212,053106,鴻海兆豐98購01,0.13,0.17,0.13,0.17,+0.06,54.55,286000,12,42970,0,0,0,0,0,0,242000,44000,198000,198000
20200212,053107,旺宏兆豐97購01,,,,,0.00,0.00,0,0,0,0,0,0,0,0,0,0,0,0,0
20200212,053108,南亞科兆豐96購01,2.05,2.05,2.00,2.02,-0.01,-0.49,90000,9,183000,0,0,0,0,0,0,20000,70000,-50000,-50000
20200212,053109,聯發科兆豐96購01,0.65,0.65,0.65,0.65,+0.16,32.65,3000,1,1950,0,0,0,0,0,0,3000,0,3000,3000
20200212,05310P,智原永豐95售04,1.80,1.80,1.80,1.80,-0.10,-5.26,27000,1,48600,0,0,0,0,0,0,27000,0,27000,27000
20200212,053110,大立光兆豐97購01,0.99,1.07,0.99,1.07,+0.12,12.63,75000,3,74650,0,0,0,0,0,0,75000,0,75000,75000
20200212,053111,緯創兆豐97購01,0.97,1.01,0.97,1.01,+0.04,4.12,93000,4,91820,0,0,0,0,0,0,24000,69000,-45000,-45000
20200212,053112,中磊兆豐97購01,0.93,0.96,0.93,0.96,+0.05,5.49,3000,3,2820,0,0,0,0,0,0,0,3000,-3000,-3000
20200212,053113,瀚宇博兆豐97購01,0.75,0.85,0.75,0.85,+0.08,10.39,463000,15,374810,0,0,0,0,0,0,71000,392000,-321000,-321000
20200212,053114,聯茂兆豐97購01,0.58,0.83,0.58,0.83,+0.32,62.75,666000,34,471000,0,0,0,0,0,0,287000,379000,-92000,-92000
20200212,053115,滬深2X中信97購01,0.82,0.84,0.82,0.84,-0.01,-1.18,401000,4,332830,0,0,0,0,0,0,201000,200000,1000,1000
20200212,053116,華新科中信96購01,2.36,2.40,2.32,2.40,+0.06,2.56,46000,6,108580,0,0,0,0,0,0,22000,24000,-2000,-2000
20200212,053117,大立光中信9A購02,0.83,0.92,0.83,0.92,0.00,0.00,151000,3,126940,0,0,0,0,0,0,0,151000,-151000,-151000
20200212,053118,大立光中信9C購01,1.23,1.26,1.22,1.26,+0.10,8.62,35000,5,43050,0,0,0,0,0,0,20000,15000,5000,5000
20200212,053119,日月光中信97購01,0.52,0.61,0.51,0.61,0.00,0.00,440000,7,238300,0,0,0,0,0,0,340000,100000,240000,240000
20200212,05311P,臺股指群益95售10,0.47,0.49,0.42,0.43,-0.12,-21.82,233000,16,100480,0,0,0,0,0,0,10000,223000,-213000,-213000
20200212,053120,復盛中信9A購01,0.98,0.98,0.94,0.95,-0.02,-2.06,225000,21,213010,0,0,0,0,0,0,165000,40000,125000,125000
20200212,053121,上証2X凱基9C購01,,,,,0.00,0.00,0,0,0,0,0,0,0,0,0,0,0,0,0
20200212,053122,美律凱基98購01,0.62,0.66,0.61,0.65,+0.15,30.0,215000,12,134300,0,0,0,0,0,0,151000,69000,82000,82000
20200212,053123,京元電凱基96購01,0.74,0.79,0.71,0.79,+0.05,6.76,104000,26,77490,0,0,0,0,0,0,85000,19000,66000,66000
20200212,053124,聯發科凱基96購12,0.41,0.50,0.41,0.50,+0.13,35.14,181000,18,82720,0,0,0,0,0,0,168000,2000,166000,166000
20200212,053125,宏達電凱基96購01,,,,,0.00,0.00,0,0,0,0,0,0,0,0,0,0,0,0,0
20200212,053126,健策凱基97購02,1.10,1.10,0.58,1.10,+0.09,8.91,208000,7,221620,0,0,0,0,0,0,147000,108000,39000,39000
20200212,053127,貿聯凱基97購01,0.74,0.74,0.74,0.74,-0.03,-3.9,35000,6,25900,0,0,0,0,0,0,35000,0,35000,35000
20200212,053128,瀚宇博凱基96購01,,,,,0.00,0.00,0,0,0,0,0,0,0,0,0,0,0,0,0
20200212,053129,緯穎凱基96購01,3.48,3.54,3.48,3.54,0.00,0.00,6000,2,21060,0,0,0,0,0,0,0,6000,-6000,-6000
20200212,05312P,臺股指群益95售11,2.15,2.15,1.90,1.93,-0.36,-15.72,140000,20,274830,0,0,0,0,0,0,31000,109000,-78000,-78000
20200212,053130,聯發科麥證96購01,1.22,1.34,1.22,1.34,+0.26,24.07,111000,7,144130,81000,30000,51000,0,0,0,81000,30000,51000,51000
20200212,053131,華通國票97購03,0.24,0.36,0.24,0.35,+0.15,75.0,424000,7,137960,0,0,0,0,0,0,104000,320000,-216000,-216000
20200212,053132,國巨國票97購02,3.21,3.37,3.12,3.37,+0.36,11.96,287000,22,933670,0,0,0,0,0,0,85000,202000,-117000,-117000
20200212,053133,華邦電國票97購01,0.47,0.51,0.47,0.47,+0.06,14.63,112000,13,54560,0,0,0,0,0,0,30000,82000,-52000,-52000
20200212,053134,南亞科國票97購01,3.80,3.80,3.80,3.80,+0.10,2.7,6000,1,22800,0,0,0,0,0,0,6000,6000,0,0
20200212,053135,信邦國票96購01,2.36,2.47,2.36,2.47,0.00,0.00,171000,12,405770,0,0,0,0,0,0,171000,0,171000,171000
20200212,053136,彩晶國票97購01,,,,,0.00,0.00,0,0,0,0,0,0,0,0,0,0,0,0,0
20200212,053137,旺宏富邦98購01,1.29,1.35,1.25,1.25,-0.05,-3.85,138000,14,181580,0,0,0,0,0,0,123000,19000,104000,104000
20200212,053138,華邦電富邦96購01,0.20,0.21,0.20,0.20,+0.03,17.65,433000,7,88700,0,0,0,0,0,0,220000,213000,7000,7000
20200212,053139,滬深2X永豐98購01,,,,,0.00,0.00,0,0,0,0,0,0,0,0,0,0,0,0,0
20200212,05313P,臺股指群益95售12,2.94,2.94,2.61,2.63,-0.43,-14.05,85000,11,231550,0,0,0,0,0,0,10000,75000,-65000,-65000
20200212,053140,燿華永豐96購02,,,,,0.00,0.00,0,0,0,0,0,0,0,0,0,0,0,0,0
20200212,053141,景碩永豐96購02,0.42,0.55,0.42,0.52,0.00,0.00,205000,12,96370,0,0,0,0,0,0,0,205000,-205000,-205000
20200212,053142,緯穎永豐96購01,2.22,2.44,2.10,2.44,+0.13,5.63,277000,17,616510,0,0,0,0,0,0,200000,77000,123000,123000
20200212,053143,昇陽半永豐96購03,0.87,0.92,0.87,0.92,+0.06,6.98,113000,7,100490,0,0,0,0,0,0,105000,21000,84000,84000
20200212,053144,上証2X元大96購01,,,,,0.00,0.00,0,0,0,0,0,0,0,0,0,0,0,0,0
20200212,053145,元黃金元大96購02,,,,,0.00,0.00,0,0,0,0,0,0,0,0,0,0,0,0,0
20200212,053146,滬深2X元大96購08,0.67,0.67,0.67,0.67,-0.05,-6.94,10000,1,6700,0,0,0,0,0,0,10000,10000,0,0
20200212,053147,楠梓電元大98購01,0.47,0.50,0.47,0.50,0.00,0.00,272000,4,129340,0,0,0,0,0,0,0,272000,-272000,-272000
20200212,053148,華邦電元大96購01,0.59,0.67,0.59,0.65,+0.10,18.18,1162000,25,727030,0,0,0,0,0,0,598000,630000,-32000,-32000
20200212,053149,京元電元大96購02,1.35,1.41,1.28,1.40,+0.06,4.48,315000,23,429250,0,0,0,0,0,0,285000,58000,227000,227000
20200212,05314P,臺股指群益95售13,2.95,2.95,2.75,2.75,0.00,0.00,9000,9,25790,0,0,0,0,0,0,0,9000,-9000,-9000
20200212,053150,聯發科元大96購11,1.13,1.27,1.08,1.27,+0.28,28.28,68000,13,82860,0,0,0,0,0,0,58000,12000,46000,46000
20200212,053151,華新科元大96購04,8.90,9.05,8.90,9.05,+0.25,2.84,38000,12,341300,0,0,0,0,0,0,37000,38000,-1000,-1000
20200212,053152,大立光元大99購01,1.85,1.90,1.85,1.89,+0.21,12.5,149000,6,276690,0,0,0,0,0,0,149000,30000,119000,119000
20200212,053153,大立光元大99購02,1.79,1.94,1.79,1.92,+0.20,11.63,203000,16,385340,0,0,0,0,0,0,93000,190000,-97000,-97000
20200212,053154,聯詠元大96購01,1.15,1.27,1.15,1.24,+0.11,9.73,893000,31,1081730,0,0,0,0,0,0,303000,706000,-403000,-403000
20200212,053155,晶技元大97購02,,,,,0.00,0.00,0,0,0,0,0,0,0,0,0,0,0,0,0
20200212,053156,緯創元大96購02,0.72,0.72,0.72,0.72,+0.01,1.41,21000,1,15120,0,0,0,0,0,0,0,21000,-21000,-21000
20200212,053157,日月光元大96購03,1.14,1.29,1.14,1.29,+0.26,25.24,150000,11,180530,0,0,0,0,0,0,0,150000,-150000,-150000
20200212,053158,茂林元大96購01,1.82,1.86,1.79,1.82,+0.05,2.82,79000,13,143970,5000,0,5000,0,0,0,57000,44000,13000,18000
20200212,053159,同欣電元大96購02,1.96,2.19,1.89,1.96,+0.08,4.26,72000,14,142430,0,0,0,0,0,0,67000,7000,60000,60000
20200212,05315P,鴻海永昌96售08,2.45,2.45,2.18,2.18,-0.43,-16.48,218000,12,517630,0,0,0,0,0,0,155000,63000,92000,92000
20200212,053160,台表科元大96購03,0.54,0.56,0.54,0.56,0.00,0.00,49000,2,26580,0,0,0,0,0,0,0,49000,-49000,-49000
20200212,053161,康友元大96購04,1.01,1.07,1.01,1.01,+0.07,7.45,298000,9,308860,0,0,0,0,0,0,145000,203000,-58000,-58000
20200212,053162,緯穎元大97購01,2.50,2.71,2.42,2.71,+0.15,5.86,306000,26,786670,0,0,0,0,0,0,244000,254000,-10000,-10000
20200212,053163,上証2X群益9A購02,,,,,0.00,0.00,0,0,0,0,0,0,0,0,0,0,0,0,0
20200212,053164,台光電群益96購02,0.45,0.65,0.45,0.61,+0.18,41.86,234000,51,135540,0,0,0,0,0,0,53000,181000,-128000,-128000
20200212,053165,大立光群益96購03,1.44,1.52,1.43,1.51,+0.21,16.15,138000,8,207360,0,0,0,0,0,0,53000,94000,-41000,-41000
20200212,053166,聯詠群益96購02,1.36,1.43,1.30,1.30,+0.12,10.17,295000,8,393690,0,0,0,0,0,0,172000,123000,49000,49000
20200212,053167,欣興群益96購03,,,,,0.00,0.00,0,0,0,0,0,0,0,0,0,0,0,0,0
20200212,053168,晶技群益98購01,1.46,1.52,1.46,1.52,+0.11,7.8,10000,5,14900,0,0,0,0,0,0,10000,0,10000,10000
20200212,053169,貿聯群益97購01,0.85,0.97,0.85,0.96,+0.13,15.66,122000,12,110300,0,0,0,0,0,0,20000,92000,-72000,-72000
20200212,05316P,台積電永昌96售06,0.43,0.43,0.40,0.40,-0.06,-13.04,70000,5,29100,0,0,0,0,0,0,0,60000,-60000,-60000
20200212,053170,茂林群益96購04,3.71,3.90,3.61,3.74,+0.05,1.36,530000,51,1962120,0,0,0,0,0,0,385000,237000,148000,148000
20200212,053171,中磊群益96購01,1.71,1.73,1.67,1.67,-0.04,-2.34,44000,5,74810,0,0,0,0,0,0,34000,31000,3000,3000
20200212,053172,瑞儀群益97購01,0.37,0.39,0.36,0.39,0.00,0.00,759000,14,281820,0,0,0,0,0,0,0,759000,-759000,-759000
20200212,053173,矽格群益97購01,1.58,1.68,1.58,1.68,+0.20,13.51,63000,15,102850,0,0,0,0,0,0,16000,50000,-34000,-34000
20200212,053174,同欣電群益98購02,2.64,2.86,2.64,2.86,+0.30,11.72,72000,11,195790,0,0,0,0,0,0,45000,37000,8000,8000
20200212,053175,矽力群益96購01,2.51,2.79,2.51,2.79,+0.34,13.88,239000,10,626530,0,0,0,0,0,0,111000,139000,-28000,-28000
20200212,053176,矽力群益96購02,3.50,4.24,3.50,4.24,+0.75,21.49,254000,27,1000230,0,0,0,0,0,0,74000,220000,-146000,-146000
20200212,053177,華邦電統一96購01,0.77,0.80,0.77,0.80,+0.18,29.03,176000,5,138080,0,0,0,0,0,0,0,176000,-176000,-176000
20200212,053178,南亞科統一98購01,1.83,1.84,1.80,1.84,-0.04,-2.13,558000,13,1010880,0,0,0,0,0,0,454000,104000,350000,350000
20200212,053179,大立光統一96購04,1.19,1.25,1.19,1.22,0.00,0.00,167000,10,201480,0,0,0,0,0,0,30000,137000,-107000,-107000
20200212,05317P,臺股指永昌95售02,,,,,0.00,0.00,0,0,0,0,0,0,0,0,0,0,0,0,0
20200212,053180,同欣電統一96購01,1.78,1.98,1.78,1.98,+0.20,11.24,253000,20,465670,0,0,0,0,0,0,220000,0,220000,220000
20200212,053181,滬深2X元富99購02,1.33,1.34,1.28,1.33,+0.01,0.76,245000,8,326670,0,0,0,0,0,0,220000,37000,183000,183000
20200212,053182,大立光元富96購02,1.72,1.72,1.65,1.65,+0.15,10.0,296000,5,504150,0,0,0,0,0,0,296000,0,296000,296000
20200212,053183,大立光元富96購03,1.91,2.02,1.91,2.02,+0.33,19.53,15000,3,29400,0,0,0,0,0,0,10000,5000,5000,5000
20200212,053184,世紀鋼元富96購01,1.31,1.34,1.29,1.31,+0.01,0.77,104000,26,136180,0,0,0,0,0,0,104000,0,104000,104000
20200212,053185,友達中信99購01,2.17,2.17,2.14,2.14,-0.02,-0.93,40000,3,86200,0,0,0,0,0,0,20000,20000,0,0
20200212,053186,健策中信9C購01,1.07,1.13,1.06,1.13,+0.09,8.65,262000,31,283960,0,0,0,0,0,0,222000,40000,182000,182000
20200212,053187,國巨統一96購05,2.71,2.71,2.56,2.56,+0.09,3.64,123000,7,332750,0,0,0,0,0,0,119000,4000,115000,115000
20200212,053188,旺宏統一97購03,1.60,1.60,1.60,1.60,-0.01,-0.62,20000,1,32000,0,0,0,0,0,0,20000,0,20000,20000
20200212,053189,聯發科統一96購05,1.44,1.44,1.44,1.44,+0.21,17.07,48000,1,69120,0,0,0,0,0,0,0,48000,-48000,-48000
20200212,05318P,臺股指永昌95售03,1.21,1.21,1.15,1.15,-0.21,-15.44,30000,3,35700,0,0,0,0,0,0,30000,30000,0,0
20200212,053190,聯發科統一99購01,0.40,0.44,0.40,0.44,+0.09,25.71,4000,2,1680,0,0,0,0,0,0,4000,0,4000,4000
20200212,053191,奇鋐統一96購01,0.35,0.37,0.35,0.37,0.00,0.00,105000,3,37750,0,0,0,0,0,0,0,105000,-105000,-105000
20200212,053192,創意統一96購01,1.18,1.18,1.07,1.07,-0.19,-15.08,30000,4,33150,0,0,0,0,0,0,20000,0,20000,20000
20200212,053193,超眾統一97購01,2.26,2.30,2.26,2.30,+0.01,0.44,10000,7,22720,0,0,0,0,0,0,10000,0,10000,10000
20200212,053194,緯穎統一99購01,1.97,2.20,1.97,2.20,+0.18,8.91,32000,6,64200,0,0,0,0,0,0,28000,4000,24000,24000
20200212,053195,玉晶光元富96購02,14.80,15.10,14.80,15.10,+1.40,10.22,16000,3,237700,0,0,0,0,0,0,13000,3000,10000,10000
20200212,053196,康控元富96購01,0.65,0.72,0.65,0.69,+0.09,15.0,268000,19,185540,0,0,0,0,0,0,140000,128000,12000,12000
20200212,053197,超眾元富96購02,1.26,1.41,1.26,1.40,+0.11,8.53,1564000,53,2072290,0,0,0,0,0,0,945000,609000,336000,336000
20200212,053198,亞德客日盛96購01,2.48,2.66,2.44,2.62,-0.05,-1.87,478000,33,1229180,0,0,0,0,0,0,428000,50000,378000,378000
20200212,053199,旺宏日盛96購01,1.20,1.26,1.18,1.18,-0.01,-0.84,173000,6,211320,0,0,0,0,0,0,10000,163000,-153000,-153000
20200212,05319P,上銀凱基95售02,,,,,0.00,0.00,0,0,0,0,0,0,0,0,0,0,0,0,0
20200212,053200,華邦電日盛96購01,0.21,0.22,0.21,0.21,0.00,0.00,205000,5,44050,0,0,0,0,0,0,0,205000,-205000,-205000
20200212,053201,美律日盛96購01,0.33,0.41,0.33,0.41,+0.10,32.26,439000,22,166960,0,0,0,0,0,0,62000,377000,-315000,-315000
20200212,053202,聯發科日盛96購02,,,,,0.00,0.00,0,0,0,0,0,0,0,0,0,0,0,0,0
20200212,053203,智易日盛96購01,0.48,0.55,0.48,0.55,0.00,0.00,254000,7,126480,0,0,0,0,0,0,0,254000,-254000,-254000
20200212,053204,旺宏麥證96購01,1.67,1.69,1.65,1.68,+0.03,1.82,33000,5,55120,22000,11000,11000,0,0,0,23000,13000,10000,10000
20200212,053205,台光電麥證96購01,1.37,1.75,1.37,1.66,+0.34,25.76,510000,100,816670,126000,382000,-256000,0,0,0,156000,385000,-229000,-229000
20200212,053206,聯發科麥證96購02,1.29,1.48,1.29,1.48,+0.35,30.97,115000,9,158950,60000,55000,5000,0,0,0,60000,55000,5000,5000
20200212,053207,SP黃豆凱基96購01,,,,,0.00,0.00,0,0,0,0,0,0,0,0,0,0,0,0,0
20200212,053208,鴻海凱基96購13,0.18,0.18,0.18,0.18,0.00,0.00,100000,1,18000,0,0,0,0,0,0,0,100000,-100000,-100000
20200212,053209,台積電凱基96購07,,,,,0.00,0.00,0,0,0,0,0,0,0,0,0,0,0,0,0
20200212,05320P,華通凱基96售03,1.32,1.32,1.11,1.13,-0.27,-19.29,137000,3,156980,0,0,0,0,0,0,110000,27000,83000,83000
20200212,053210,華邦電凱基97購02,0.20,0.20,0.20,0.20,+0.02,11.11,100000,2,20000,0,0,0,0,0,0,0,0,0,0
20200212,053211,漢唐凱基96購03,1.34,1.34,1.34,1.34,+0.16,13.56,66000,2,88440,0,0,0,0,0,0,66000,0,66000,66000
20200212,053212,友達凱基99購04,1.82,1.82,1.69,1.76,-0.07,-3.83,48000,6,84460,0,0,0,0,0,0,26000,20000,6000,6000
20200212,053213,建準凱基96購02,,,,,0.00,0.00,0,0,0,0,0,0,0,0,0,0,0,0,0
20200212,053214,冠德凱基96購02,,,,,0.00,0.00,0,0,0,0,0,0,0,0,0,0,0,0,0
20200212,053215,禾伸堂凱基96購01,1.19,1.22,1.16,1.22,+0.03,2.52,142000,13,168300,0,0,0,0,0,0,105000,37000,68000,68000
20200212,053216,京鼎凱基96購02,1.32,1.55,0.03,1.55,+0.39,33.62,404000,22,375990,0,0,0,0,0,0,123000,281000,-158000,-158000
20200212,053217,群創凱基99購02,,,,,0.00,0.00,0,0,0,0,0,0,0,0,0,0,0,0,0
20200212,053218,TPK凱基96購01,,,,,0.00,0.00,0,0,0,0,0,0,0,0,0,0,0,0,0
20200212,053219,祥碩凱基96購01,4.98,6.15,4.98,6.15,+1.59,34.87,22000,6,114580,0,0,0,0,0,0,9000,13000,-4000,-4000
20200212,05321P,鴻海凱基95售17,0.78,0.78,0.72,0.72,-0.11,-13.25,70000,7,53000,0,0,0,0,0,0,0,70000,-70000,-70000
20200212,053220,瀚宇博凱基98購01,,,,,0.00,0.00,0,0,0,0,0,0,0,0,0,0,0,0,0
20200212,053221,彩晶凱基98購01,,,,,0.00,0.00,0,0,0,0,0,0,0,0,0,0,0,0,0
20200212,053222,聯茂凱基96購03,0.77,0.92,0.77,0.92,+0.45,95.74,16000,3,13220,0,0,0,0,0,0,0,16000,-16000,-16000
20200212,053223,台郡凱基96購02,1.88,1.90,1.88,1.88,+0.95,102.15,29000,7,54720,0,0,0,0,0,0,10000,29000,-19000,-19000
20200212,053224,矽力凱基96購02,1.56,2.50,1.49,2.50,+1.02,68.92,46000,8,73150,0,0,0,0,0,0,44000,1000,43000,43000
20200212,053225,昇陽半凱基96購01,,,,,0.00,0.00,0,0,0,0,0,0,0,0,0,0,0,0,0
20200212,053226,國巨台新97購02,,,,,0.00,0.00,0,0,0,0,0,0,0,0,0,0,0,0,0
20200212,053227,晶技台新96購01,0.65,0.66,0.65,0.66,+0.01,1.54,39000,3,25600,0,0,0,0,0,0,39000,0,39000,39000
20200212,053228,康友台新97購01,1.48,1.59,1.46,1.53,+0.04,2.68,731000,28,1118120,0,0,0,0,0,0,234000,487000,-253000,-253000
20200212,053229,南電台新97購01,0.72,0.91,0.72,0.91,+0.15,19.74,140000,27,113210,0,0,0,0,0,0,128000,12000,116000,116000
20200212,05322P,台積電凱基95售17,,,,,0.00,0.00,0,0,0,0,0,0,0,0,0,0,0,0,0
20200212,053230,達方台新97購01,1.47,1.47,1.46,1.46,+0.04,2.82,64000,3,93980,0,0,0,0,0,0,10000,54000,-44000,-44000
20200212,053231,奇力新康和96購01,1.69,1.75,1.65,1.75,0.00,0.00,171000,25,288770,0,0,0,0,0,0,171000,0,171000,171000
20200212,053232,友達永豐97購02,1.85,1.85,1.71,1.71,-0.14,-7.57,188000,13,333720,0,0,0,0,0,0,115000,73000,42000,42000
20200212,053233,大立光永豐96購01,0.55,0.60,0.55,0.60,0.00,0.00,4000,2,2300,0,0,0,0,0,0,0,4000,-4000,-4000
20200212,053234,奇鋐永豐96購01,,,,,0.00,0.00,0,0,0,0,0,0,0,0,0,0,0,0,0
20200212,053235,智原永豐96購01,0.63,0.71,0.63,0.71,+0.08,12.7,540000,24,358480,0,0,0,0,0,0,316000,224000,92000,92000
20200212,053236,群創永豐97購02,1.29,1.29,1.27,1.27,+0.04,3.25,40000,2,51000,0,0,0,0,0,0,40000,10000,30000,30000
20200212,053237,揚明光永豐96購03,,,,,0.00,0.00,0,0,0,0,0,0,0,0,0,0,0,0,0
20200212,053238,麗豐永豐96購01,0.66,0.72,0.66,0.72,+0.03,4.35,240000,9,164530,0,0,0,0,0,0,50000,190000,-140000,-140000
20200212,053239,崇越永豐96購01,0.57,0.61,0.57,0.60,0.00,0.00,680000,15,395470,0,0,0,0,0,0,0,680000,-680000,-680000
20200212,05323P,瑞昱凱基96售02,0.89,0.89,0.89,0.89,-0.14,-13.59,30000,1,26700,0,0,0,0,0,0,30000,0,30000,30000
20200212,053240,巨路永豐96購01,,,,,0.00,0.00,0,0,0,0,0,0,0,0,0,0,0,0,0
20200212,053241,元油反國票9A購01,,,,,0.00,0.00,0,0,0,0,0,0,0,0,0,0,0,0,0
20200212,053242,聯電國票96購04,1.52,1.64,1.52,1.64,+0.02,1.23,129000,9,204480,0,0,0,0,0,0,99000,30000,69000,69000
20200212,053243,楠梓電國票97購02,0.68,0.82,0.67,0.82,+0.12,17.14,234000,13,176850,0,0,0,0,0,0,60000,174000,-114000,-114000
20200212,053244,光磊國票97購01,0.81,0.81,0.79,0.79,+0.02,2.6,188000,3,148900,0,0,0,0,0,0,188000,0,188000,188000
20200212,053245,全新國票97購01,1.31,1.54,1.31,1.54,+0.33,27.27,107000,5,153170,0,0,0,0,0,0,107000,0,107000,107000
20200212,053246,聯詠國票97購02,0.76,0.80,0.73,0.78,+0.08,11.43,343000,16,260090,0,30000,-30000,0,0,0,81000,262000,-181000,-211000
20200212,053247,麗豐國票97購01,1.19,1.20,1.19,1.20,+0.11,10.09,68000,2,81300,0,0,0,0,0,0,0,68000,-68000,-68000
20200212,053248,智伸科國票97購01,2.30,2.31,2.30,2.31,+0.03,1.32,62000,3,142760,0,0,0,0,0,0,46000,16000,30000,30000
20200212,053249,致伸國票97購02,0.95,0.99,0.95,0.99,+0.15,17.86,70000,3,68110,0,0,0,0,0,0,0,70000,-70000,-70000
20200212,05324P,臺股指凱基95售08,0.71,0.71,0.64,0.64,0.00,0.00,95000,3,66700,0,0,0,0,0,0,5000,90000,-85000,-85000
20200212,053250,百和國票97購02,2.75,2.75,2.74,2.74,+0.01,0.37,18000,2,49410,0,0,0,0,0,0,9000,9000,0,0
20200212,053251,世紀鋼國票97購02,1.19,1.21,1.17,1.17,-0.06,-4.88,38000,9,45140,0,0,0,0,0,0,28000,10000,18000,18000
20200212,053252,華邦電國泰98購01,,,,,0.00,0.00,0,0,0,0,0,0,0,0,0,0,0,0,0
20200212,053253,友達國泰97購02,,,,,0.00,0.00,0,0,0,0,0,0,0,0,0,0,0,0,0
20200212,053254,群創國泰98購02,,,,,0.00,0.00,0,0,0,0,0,0,0,0,0,0,0,0,0
20200212,053255,貿聯國泰97購01,1.61,1.80,1.60,1.79,+0.22,14.01,851000,34,1475750,0,0,0,0,0,0,560000,395000,165000,165000
20200212,053256,上銀富邦98購01,1.46,1.46,1.40,1.40,-0.01,-0.71,54000,9,77100,0,0,0,0,0,0,32000,27000,5000,5000
20200212,053257,華通富邦97購01,0.35,0.36,0.32,0.35,+0.12,52.17,120000,11,41430,0,0,0,0,0,0,50000,70000,-20000,-20000
20200212,053258,上証2X群益9A購03,1.68,1.68,1.68,1.68,-0.01,-0.59,260000,1,436800,0,0,0,0,0,0,260000,0,260000,260000
20200212,053259,卜蜂群益97購01,0.65,0.65,0.65,0.65,+0.01,1.56,25000,2,16250,0,0,0,0,0,0,0,25000,-25000,-25000
20200212,05325P,臺股指凱基95售09,0.74,0.74,0.66,0.66,-0.13,-16.46,30000,3,20900,0,0,0,0,0,0,0,30000,-30000,-30000
20200212,053260,喬山群益96購01,,,,,0.00,0.00,0,0,0,0,0,0,0,0,0,0,0,0,0
20200212,053261,國巨群益96購05,4.24,4.24,4.24,4.24,0.00,0.00,5000,1,21200,0,0,0,0,0,0,5000,0,5000,5000
20200212,053262,華邦電群益96購02,0.66,0.76,0.66,0.72,+0.13,22.03,239000,12,172380,0,0,0,0,0,0,12000,227000,-215000,-215000
20200212,053263,華邦電群益96購03,0.22,0.23,0.21,0.21,+0.03,16.67,98000,10,21520,0,0,0,0,0,0,0,98000,-98000,-98000
20200212,053264,南亞科群益96購01,2.87,2.99,2.87,2.95,-0.12,-3.91,234000,22,683960,0,0,0,0,0,0,160000,104000,56000,56000
20200212,053265,南亞科群益96購02,1.52,1.53,1.47,1.47,-0.08,-5.16,237000,15,356520,0,0,0,0,0,0,94000,151000,-57000,-57000
20200212,053266,全新群益98購01,0.83,0.97,0.83,0.96,+0.19,24.68,597000,28,535200,0,0,0,0,0,0,307000,284000,23000,23000
20200212,053267,華新科群益96購02,,,,,0.00,0.00,0,0,0,0,0,0,0,0,0,0,0,0,0
20200212,053268,日月光群益96購01,1.65,1.80,1.62,1.75,+0.19,12.18,610000,19,1015090,0,0,0,0,0,0,458000,152000,306000,306000
20200212,053269,同欣電群益96購01,1.56,1.82,1.54,1.61,+0.10,6.62,261000,33,431220,0,0,0,0,0,0,116000,150000,-34000,-34000
20200212,05326P,臺股指凱基95售10,0.76,0.79,0.69,0.69,0.00,0.00,11000,4,8210,0,0,0,0,0,0,0,11000,-11000,-11000
20200212,053270,台塑元大96購01,1.53,1.54,1.51,1.53,+0.02,1.32,154000,5,234560,0,0,0,0,0,0,109000,53000,56000,56000
20200212,053271,喬山元大97購01,1.08,1.10,1.08,1.10,0.00,0.00,171000,3,186680,0,0,0,0,0,0,3000,168000,-165000,-165000
20200212,053272,鴻海元大96購17,,,,,0.00,0.00,0,0,0,0,0,0,0,0,0,0,0,0,0
20200212,053273,國巨元大96購08,5.25,5.35,5.10,5.35,+0.47,9.63,26000,5,136300,0,0,0,0,0,0,14000,11000,3000,3000
20200212,053274,旺宏元大98購03,3.54,3.66,3.43,3.43,-0.08,-2.28,9000,7,31690,0,0,0,0,0,0,9000,9000,0,0
20200212,053275,燿華元大97購01,0.65,0.74,0.65,0.74,+0.06,8.82,95000,4,65660,0,0,0,0,0,0,24000,75000,-51000,-51000
20200212,053276,友達元大9C購01,2.33,2.33,2.17,2.17,-0.13,-5.65,110000,11,249960,0,0,0,0,0,0,70000,80000,-10000,-10000
20200212,053277,大立光元大96購04,1.33,1.43,1.33,1.43,0.00,0.00,205000,6,277870,0,0,0,0,0,0,27000,178000,-151000,-151000
20200212,053278,禾伸堂元大96購01,1.94,1.97,1.87,1.97,+0.09,4.79,225000,23,432200,0,0,0,0,0,0,77000,148000,-71000,-71000
20200212,053279,景碩元大97購01,1.42,1.66,1.35,1.53,+0.15,10.87,720000,124,1052610,2000,0,2000,0,0,0,528000,498000,30000,32000
20200212,05327P,臺股指凱基95售11,0.83,0.83,0.83,0.83,0.00,0.00,192000,1,159360,0,0,0,0,0,0,0,192000,-192000,-192000
20200212,053280,群創元大9C購01,,,,,0.00,0.00,0,0,0,0,0,0,0,0,0,0,0,0,0
20200212,053281,茂林元大96購02,1.64,1.69,1.58,1.64,+0.04,2.5,578000,52,943470,0,0,0,0,0,0,291000,336000,-45000,-45000
20200212,053282,彩晶元大9C購01,,,,,0.00,0.00,0,0,0,0,0,0,0,0,0,0,0,0,0
20200212,053283,同欣電元大96購03,2.06,2.30,2.01,2.24,+0.21,10.34,147000,27,314530,0,0,0,0,0,0,137000,44000,93000,93000
20200212,053284,樺漢元大97購01,0.85,0.85,0.82,0.82,+0.02,2.5,100000,6,83400,0,0,0,0,0,0,100000,0,100000,100000
20200212,053285,臺股指元大96購08,,,,,0.00,0.00,0,0,0,0,0,0,0,0,0,0,0,0,0
20200212,053286,臺股指元大96購14,1.90,1.98,1.90,1.98,+0.20,11.24,41000,3,78080,0,0,0,0,0,0,1000,40000,-39000,-39000
20200212,053287,臺股指元大96購15,,,,,0.00,0.00,0,0,0,0,0,0,0,0,0,0,0,0,0
20200212,053288,臺股指元大96購16,2.43,2.43,2.40,2.40,0.00,0.00,30000,3,72400,0,0,0,0,0,0,0,30000,-30000,-30000
20200212,053289,臺股指元大96購17,2.03,2.03,2.03,2.03,+0.30,17.34,2000,1,4060,0,0,0,0,0,0,0,2000,-2000,-2000
20200212,05328P,臺股指凱基95售12,1.20,1.20,1.14,1.14,-0.14,-10.94,15000,3,17450,0,0,0,0,0,0,0,15000,-15000,-15000
20200212,053290,元油反中信97購01,,,,,0.00,0.00,0,0,0,0,0,0,0,0,0,0,0,0,0
20200212,053291,旺宏中信9A購01,0.84,0.88,0.82,0.83,-0.01,-1.19,138000,17,116710,0,0,0,0,0,0,80000,58000,22000,22000
20200212,053292,美律中信98購01,1.04,1.15,1.03,1.13,+0.14,14.14,385000,35,414240,0,0,0,0,0,0,108000,277000,-169000,-169000
20200212,053293,聯發科中信9B購01,0.55,0.61,0.54,0.60,+0.09,17.65,70000,44,40290,0,0,0,0,0,0,29000,41000,-12000,-12000
20200212,053294,聯發科中信9C購01,0.56,0.60,0.56,0.60,+0.08,15.38,150000,11,86770,0,0,0,0,0,0,149000,1000,148000,148000
20200212,053295,奇力新中信96購01,1.88,1.91,1.79,1.91,+0.03,1.6,107000,32,197420,0,0,0,0,0,0,80000,27000,53000,53000
20200212,053296,貿聯中信98購01,0.95,1.05,0.95,1.05,+0.14,15.38,120000,4,123000,0,0,0,0,0,0,0,120000,-120000,-120000
20200212,053297,鎧勝中信98購01,,,,,0.00,0.00,0,0,0,0,0,0,0,0,0,0,0,0,0
20200212,053298,SP黃豆凱基99購01,0.70,0.70,0.69,0.69,-0.02,-2.82,300000,9,208100,0,0,0,0,0,0,0,300000,-300000,-300000
20200212,053299,台泥凱基96購01,0.79,0.79,0.79,0.79,-0.01,-1.25,59000,2,46610,0,0,0,0,0,0,59000,0,59000,59000
20200212,05329P,臺股指凱基95售13,1.30,1.34,1.15,1.15,-0.27,-19.01,77000,20,98310,0,0,0,0,0,0,0,69000,-69000,-69000
20200212,053300,大成鋼凱基96購02,0.64,0.66,0.64,0.66,+0.04,6.45,6000,2,3900,0,0,0,0,0,0,3000,3000,0,0
20200212,053301,華通凱基96購04,0.65,0.67,0.65,0.67,0.00,0.00,7000,2,4570,0,0,0,0,0,0,0,7000,-7000,-7000
20200212,053302,國巨凱基96購10,2.58,2.74,2.53,2.73,+0.20,7.91,326000,27,859950,0,0,0,0,0,0,266000,59000,207000,207000
20200212,053303,建準凱基96購03,0.76,0.76,0.76,0.76,-0.02,-2.56,30000,1,22800,0,0,0,0,0,0,0,30000,-30000,-30000
20200212,053304,可成凱基96購03,1.18,1.22,1.18,1.22,+0.08,7.02,78000,2,92440,0,0,0,0,0,0,68000,10000,58000,58000
20200212,053305,聯詠凱基96購02,0.91,0.98,0.91,0.98,+0.20,25.64,11000,9,10180,0,0,0,0,0,0,11000,0,11000,11000
20200212,053306,晶技凱基97購01,,,,,0.00,0.00,0,0,0,0,0,0,0,0,0,0,0,0,0
20200212,053307,泰碩凱基97購01,,,,,0.00,0.00,0,0,0,0,0,0,0,0,0,0,0,0,0
20200212,053308,智易凱基96購02,0.46,0.46,0.46,0.46,0.00,0.00,245000,5,112700,0,0,0,0,0,0,0,245000,-245000,-245000
20200212,053309,泰鼎凱基96購03,3.25,3.40,3.04,3.04,+0.11,3.75,121000,21,391140,0,0,0,0,0,0,87000,121000,-34000,-34000
20200212,05330P,臺股指凱基95售14,1.76,1.77,1.58,1.58,-0.24,-13.19,290000,20,480210,0,0,0,0,0,0,99000,191000,-92000,-92000
20200212,053310,彩晶凱基98購02,0.52,0.52,0.52,0.52,0.00,0.00,10000,1,5200,0,0,0,0,0,0,0,10000,-10000,-10000
20200212,053311,同欣電凱基96購01,0.92,1.09,0.92,0.96,+0.06,6.67,287000,23,294700,0,0,0,0,0,0,112000,175000,-63000,-63000
20200212,053312,緯穎凱基96購02,2.28,2.50,2.28,2.50,+0.15,6.38,13000,5,30920,0,0,0,0,0,0,8000,5000,3000,3000
20200212,053313,世紀鋼凱基96購01,0.75,0.75,0.75,0.75,-0.01,-1.32,1000,1,750,0,0,0,0,0,0,1000,0,1000,1000
20200212,053314,A50正2群益9A購01,1.31,1.33,1.31,1.33,0.00,0.00,8000,2,10540,0,0,0,0,0,0,0,8000,-8000,-8000
20200212,053315,漢唐群益96購02,1.05,1.07,1.04,1.04,+0.11,11.83,97000,3,101160,0,0,0,0,0,0,81000,16000,65000,65000
20200212,053316,友達群益9A購01,,,,,0.00,0.00,0,0,0,0,0,0,0,0,0,0,0,0,0
20200212,053317,友達群益9A購02,,,,,0.00,0.00,0,0,0,0,0,0,0,0,0,0,0,0,0
20200212,053318,全新群益99購01,1.52,1.76,1.51,1.74,+0.35,25.18,525000,28,875290,0,0,0,0,0,0,383000,142000,241000,241000
20200212,053319,可成群益96購04,0.55,0.65,0.55,0.65,+0.12,22.64,57000,7,34590,0,0,0,0,0,0,10000,47000,-37000,-37000
20200212,05331P,上証2X國票96售01,1.60,1.66,1.60,1.60,-0.01,-0.62,94000,16,152140,0,0,0,0,0,0,80000,14000,66000,66000
20200212,053320,華新科群益97購01,,,,,0.00,0.00,0,0,0,0,0,0,0,0,0,0,0,0,0
20200212,053321,智原群益96購02,0.39,0.44,0.39,0.44,+0.05,12.82,43000,2,17270,0,0,0,0,0,0,33000,10000,23000,23000
20200212,053322,京鼎群益97購01,1.85,2.08,1.85,2.08,+0.35,20.23,193000,15,378370,0,0,0,0,0,0,0,193000,-193000,-193000
20200212,053323,群創群益98購07,,,,,0.00,0.00,0,0,0,0,0,0,0,0,0,0,0,0,0
20200212,053324,康舒群益96購01,1.31,1.34,1.31,1.34,+0.05,3.88,15000,2,19800,0,0,0,0,0,0,0,15000,-15000,-15000
20200212,053325,GIS群益96購02,0.67,0.69,0.67,0.69,0.00,0.00,33000,3,22330,0,0,0,0,0,0,0,33000,-33000,-33000
20200212,053326,瀚宇博台新96購01,0.66,0.71,0.66,0.71,0.00,0.00,97000,2,68370,0,0,0,0,0,0,97000,0,97000,97000
20200212,053327,彩晶台新97購01,,,,,0.00,0.00,0,0,0,0,0,0,0,0,0,0,0,0,0
20200212,053328,滬深2X永豐99購01,,,,,0.00,0.00,0,0,0,0,0,0,0,0,0,0,0,0,0
20200212,053329,元油反永豐97購01,,,,,0.00,0.00,0,0,0,0,0,0,0,0,0,0,0,0,0
20200212,05332P,臺股指國票95售01,2.95,2.95,2.80,2.80,-0.31,-9.97,200000,8,568750,0,0,0,0,0,0,25000,175000,-150000,-150000
20200212,053330,燿華永豐96購03,0.92,0.99,0.92,0.99,+0.12,13.79,381000,7,371300,0,0,0,0,0,0,0,381000,-381000,-381000
20200212,053331,玉晶光永豐97購02,2.27,2.46,2.25,2.46,+0.26,11.82,768000,18,1801240,0,0,0,0,0,0,343000,432000,-89000,-89000
20200212,053332,創意永豐96購03,1.35,1.39,1.27,1.36,-0.11,-7.48,602000,58,797300,0,0,0,0,0,0,248000,369000,-121000,-121000
20200212,053333,新唐永豐96購01,0.83,0.83,0.83,0.83,+0.05,6.41,68000,1,56440,0,0,0,0,0,0,68000,0,68000,68000
20200212,053334,訊芯永豐96購01,0.57,0.66,0.57,0.65,+0.08,14.04,210000,14,136000,0,0,0,0,0,0,40000,170000,-130000,-130000
20200212,053335,易華電永豐96購01,0.65,0.68,0.65,0.67,0.00,0.00,232000,9,155490,0,0,0,0,0,0,62000,170000,-108000,-108000
20200212,053336,元油反國票9B購02,,,,,0.00,0.00,0,0,0,0,0,0,0,0,0,0,0,0,0
20200212,053337,聯電國票97購01,1.45,1.58,1.44,1.58,+0.09,6.04,191000,21,284070,0,0,0,0,0,0,117000,74000,43000,43000
20200212,053338,台光電國票97購01,1.55,2.16,1.55,2.10,+0.52,32.91,196000,22,380120,0,0,0,0,0,0,48000,148000,-100000,-100000
20200212,053339,友達國票97購02,,,,,0.00,0.00,0,0,0,0,0,0,0,0,0,0,0,0,0
20200212,05333P,臺股指國票95售02,2.36,2.36,2.15,2.15,0.00,0.00,32000,8,70500,0,0,0,0,0,0,0,32000,-32000,-32000
20200212,053340,建準國票97購01,,,,,0.00,0.00,0,0,0,0,0,0,0,0,0,0,0,0,0
20200212,053341,聯發科國票97購03,0.62,0.81,0.62,0.79,+0.25,46.3,224000,26,164710,0,0,0,0,0,0,169000,55000,114000,114000
20200212,053342,全新國票99購01,0.97,1.12,0.97,1.11,+0.23,26.14,325000,18,352500,0,0,0,0,0,0,239000,95000,144000,144000
20200212,053343,宏達電國票97購02,1.38,1.38,1.38,1.38,+0.11,8.66,10000,1,13800,0,0,0,0,0,0,10000,0,10000,10000
20200212,053344,嘉晶國票97購02,1.18,1.20,1.18,1.20,0.00,0.00,106000,6,126810,0,0,0,0,0,0,0,106000,-106000,-106000
20200212,053345,欣興國票97購02,1.57,1.92,1.57,1.92,+0.37,23.87,132000,16,232550,0,0,0,0,0,0,33000,107000,-74000,-74000
20200212,053346,群創國票97購04,1.21,1.21,1.19,1.21,+0.01,0.83,310000,5,373800,0,0,0,0,0,0,110000,200000,-90000,-90000
20200212,053347,茂林國票98購01,,,,,0.00,0.00,0,0,0,0,0,0,0,0,0,0,0,0,0
20200212,053348,彩晶國票97購02,,,,,0.00,0.00,0,0,0,0,0,0,0,0,0,0,0,0,0
20200212,053349,台郡國票97購02,2.66,3.13,2.61,2.83,+0.93,48.95,413000,11,1103870,0,0,0,0,0,0,408000,2000,406000,406000
20200212,05334P,臺股指國票95售03,,,,,0.00,0.00,0,0,0,0,0,0,0,0,0,0,0,0,0
20200212,053350,台表科國票97購02,1.04,1.20,1.04,1.20,+0.15,14.29,106000,9,118100,0,0,0,0,0,0,56000,50000,6000,6000
20200212,053351,A50正2兆豐97購01,1.20,1.20,1.20,1.20,+0.02,1.69,10000,1,12000,0,0,0,0,0,0,0,10000,-10000,-10000
20200212,053352,義隆兆豐96購01,1.52,1.56,1.42,1.54,+0.17,12.41,387000,30,581800,0,0,0,0,0,0,203000,184000,19000,19000
20200212,053353,玉晶光兆豐97購03,2.15,2.31,2.15,2.31,+0.31,15.5,216000,12,476400,0,0,0,0,0,0,8000,208000,-200000,-200000
20200212,053354,康控兆豐97購02,0.47,0.57,0.47,0.57,+0.07,14.0,452000,14,237300,0,0,0,0,0,0,193000,259000,-66000,-66000
20200212,053355,超眾兆豐97購01,1.30,1.41,1.26,1.41,+0.13,10.16,180000,25,234530,0,0,0,0,0,0,139000,41000,98000,98000
20200212,053356,聯發科統一96購07,1.66,2.04,1.66,1.99,+0.36,22.09,741000,33,1419630,0,0,0,0,0,0,537000,188000,349000,349000
20200212,053357,可成統一96購02,0.80,0.91,0.79,0.91,+0.17,22.97,1086000,22,885460,0,0,0,0,0,0,752000,326000,426000,426000
20200212,053358,晶技統一98購01,,,,,0.00,0.00,0,0,0,0,0,0,0,0,0,0,0,0,0
20200212,053359,矽力統一96購02,,,,,0.00,0.00,0,0,0,0,0,0,0,0,0,0,0,0,0
20200212,05335P,臺股指國票95售04,,,,,0.00,0.00,0,0,0,0,0,0,0,0,0,0,0,0,0
20200212,053360,上証2X元富96購01,0.42,0.45,0.42,0.45,0.00,0.00,30000,2,12900,0,0,0,0,0,0,0,30000,-30000,-30000
20200212,053361,友達元富99購01,2.23,2.23,2.15,2.15,-0.15,-6.52,38000,4,83140,0,0,0,0,0,0,18000,20000,-2000,-2000
20200212,053362,元油反國泰98購01,,,,,0.00,0.00,0,0,0,0,0,0,0,0,0,0,0,0,0
20200212,053363,旺宏國泰98購02,1.99,2.01,1.99,2.00,+0.02,1.01,122000,5,244020,0,0,0,0,0,0,82000,40000,42000,42000
20200212,053364,友達國泰98購01,,,,,0.00,0.00,0,0,0,0,0,0,0,0,0,0,0,0,0
20200212,053365,彩晶國泰98購01,,,,,0.00,0.00,0,0,0,0,0,0,0,0,0,0,0,0,0
20200212,053366,樺漢國泰98購01,0.76,0.81,0.75,0.81,+0.06,8.0,138000,15,107070,0,0,0,0,0,0,128000,107000,21000,21000
20200212,053367,元油反富邦97購01,,,,,0.00,0.00,0,0,0,0,0,0,0,0,0,0,0,0,0
20200212,053368,京元電富邦98購01,0.33,0.35,0.32,0.35,+0.04,12.9,239000,22,79540,0,0,0,0,0,0,239000,0,239000,239000
20200212,053369,T50反1元大96購06,0.51,0.51,0.46,0.46,-0.06,-11.54,272000,9,128830,0,0,0,0,0,0,0,272000,-272000,-272000
20200212,05336P,臺股指國票95售05,,,,,0.00,0.00,0,0,0,0,0,0,0,0,0,0,0,0,0
20200212,053370,上証2X元大97購03,,,,,0.00,0.00,0,0,0,0,0,0,0,0,0,0,0,0,0
20200212,053371,滬深2X元大99購01,1.06,1.06,1.04,1.05,0.00,0.00,547000,7,579610,0,0,0,0,0,0,546000,12000,534000,534000
20200212,053372,元油反元大98購01,1.05,1.05,1.05,1.05,0.00,0.00,2000,1,2100,0,0,0,0,0,0,2000,0,2000,2000
20200212,053373,台泥元大96購01,1.30,1.30,1.30,1.30,-0.01,-0.76,10000,1,13000,0,0,0,0,0,0,0,10000,-10000,-10000
20200212,053374,台達電元大96購03,1.46,1.53,1.43,1.53,+0.12,8.51,230000,11,337150,0,0,0,0,0,0,100000,130000,-30000,-30000
20200212,053375,鴻海元大96購18,1.15,1.21,1.15,1.21,+0.16,15.24,309000,8,362680,0,0,0,0,0,0,294000,309000,-15000,-15000
20200212,053376,鴻海元大96購19,1.34,1.65,1.34,1.65,+0.32,24.06,207000,10,317160,0,0,0,0,0,0,163000,188000,-25000,-25000
20200212,053377,台積電元大98購01,1.90,2.00,1.88,2.00,+0.17,9.29,325000,21,624970,0,0,0,0,0,0,312000,35000,277000,277000
20200212,053378,台積電元大98購02,3.91,4.02,3.91,4.02,+0.28,7.49,60000,7,235510,0,0,0,0,0,0,50000,49000,1000,1000
20200212,053379,南亞科元大96購01,2.02,2.03,1.98,2.03,-0.04,-1.93,111000,11,221380,0,0,0,0,0,0,60000,61000,-1000,-1000
20200212,05337P,臺股指國票95售06,,,,,0.00,0.00,0,0,0,0,0,0,0,0,0,0,0,0,0
20200212,053380,南亞科元大97購01,2.47,2.47,2.43,2.46,-0.04,-1.6,338000,27,829410,0,0,0,0,0,0,332000,68000,264000,264000
20200212,053381,友達元大9A購02,2.22,2.22,2.09,2.12,-0.17,-7.42,97000,11,208250,0,0,0,0,0,0,97000,95000,2000,2000
20200212,053382,友達元大9C購02,2.15,2.15,2.09,2.09,-0.10,-4.57,96000,13,205620,0,0,0,0,0,0,37000,96000,-59000,-59000
20200212,053383,京元電元大97購01,1.74,1.86,1.67,1.84,+0.15,8.88,444000,27,778410,0,0,0,0,0,0,422000,193000,229000,229000
20200212,053384,聯發科元大96購13,0.98,1.10,0.96,1.10,+0.23,26.44,760000,39,790940,0,0,0,0,0,0,656000,685000,-29000,-29000
20200212,053385,聯詠元大96購02,1.28,1.38,1.28,1.35,+0.13,10.66,289000,19,383700,0,0,0,0,0,0,132000,258000,-126000,-126000
20200212,053386,聯詠元大96購03,1.26,1.36,1.26,1.36,+0.18,15.25,140000,14,186890,0,0,0,0,0,0,64000,119000,-55000,-55000
20200212,053387,緯創元大97購01,0.86,0.91,0.86,0.91,+0.04,4.6,95000,3,82540,0,0,0,0,0,0,0,95000,-95000,-95000
20200212,053388,群創元大9C購02,1.37,1.37,1.37,1.37,0.00,0.00,5000,1,6850,0,0,0,0,0,0,5000,0,5000,5000
20200212,053389,彩晶元大98購01,0.88,0.88,0.86,0.86,0.00,0.00,85000,5,74000,0,0,0,0,0,0,45000,40000,5000,5000
20200212,05338P,臺股指國票95售07,,,,,0.00,0.00,0,0,0,0,0,0,0,0,0,0,0,0,0
20200212,053390,彩晶元大9A購01,,,,,0.00,0.00,0,0,0,0,0,0,0,0,0,0,0,0,0
20200212,053391,嘉聯益元大99購01,0.59,0.62,0.59,0.60,+0.03,5.26,455000,6,281000,0,0,0,0,0,0,325000,130000,195000,195000
20200212,053392,致新元大96購01,0.98,0.99,0.95,0.99,+0.02,2.06,314000,19,301710,0,0,0,0,0,0,276000,64000,212000,212000
20200212,053393,元油反中信98購01,,,,,0.00,0.00,0,0,0,0,0,0,0,0,0,0,0,0,0
20200212,053394,鴻海中信9A購01,0.47,0.47,0.47,0.47,+0.07,17.5,100000,1,47000,0,0,0,0,0,0,0,100000,-100000,-100000
20200212,053395,致茂中信96購01,1.51,1.75,1.51,1.75,+0.32,22.38,455000,44,731790,0,0,0,0,0,0,134000,301000,-167000,-167000
20200212,053396,漢唐中信9A購01,0.65,0.66,0.65,0.66,+0.03,4.76,163000,4,106630,0,0,0,0,0,0,95000,68000,27000,27000
20200212,053397,國泰金中信96購01,0.70,0.71,0.70,0.71,+0.02,2.9,22000,2,15610,0,0,0,0,0,0,1000,21000,-20000,-20000
20200212,053398,和鑫中信99購01,0.37,0.37,0.37,0.37,+0.03,8.82,60000,1,22200,0,0,0,0,0,0,0,60000,-60000,-60000
20200212,053399,創意中信96購01,0.74,0.80,0.69,0.80,-0.04,-4.76,648000,38,484530,0,0,0,0,0,0,397000,251000,146000,146000
20200212,053400,緯穎中信9A購01,1.37,1.48,1.37,1.47,+0.11,8.09,127000,14,179390,0,0,0,0,0,0,47000,60000,-13000,-13000
20200212,053401,臺股指中信99購01,1.40,1.55,1.40,1.55,+0.17,12.32,183000,14,273430,0,0,0,0,0,0,150000,33000,117000,117000
20200212,053402,A50正2群益9A購02,0.96,0.96,0.96,0.96,0.00,0.00,10000,1,9600,0,0,0,0,0,0,10000,0,10000,10000
20200212,053403,彩晶群益98購01,,,,,0.00,0.00,0,0,0,0,0,0,0,0,0,0,0,0,0
20200212,053404,致新群益96購01,1.75,1.81,1.70,1.74,-0.09,-4.92,263000,19,461430,0,0,0,0,0,0,162000,101000,61000,61000
20200212,053405,台達電兆豐96購01,4.52,4.67,4.45,4.67,+0.13,2.86,76000,7,346670,0,0,0,0,0,0,29000,41000,-12000,-12000
20200212,053406,國巨兆豐96購02,2.19,2.19,2.19,2.19,+0.16,7.88,7000,1,15330,0,0,0,0,0,0,0,7000,-7000,-7000
20200212,053407,台積電兆豐96購02,4.39,4.39,4.39,4.39,+0.19,4.52,5000,1,21950,0,0,0,0,0,0,5000,0,5000,5000
20200212,053408,友達兆豐98購01,,,,,0.00,0.00,0,0,0,0,0,0,0,0,0,0,0,0,0
20200212,053409,和碩兆豐96購02,1.24,1.31,1.23,1.26,0.00,0.00,56000,5,70560,0,0,0,0,0,0,20000,36000,-16000,-16000
20200212,05340P,臺股指國票95售08,1.20,1.20,1.04,1.04,-0.23,-18.11,65000,6,70160,0,0,0,0,0,0,30000,35000,-5000,-5000
20200212,053410,啟碁兆豐96購01,1.46,1.46,1.46,1.46,+0.07,5.04,26000,2,37960,0,0,0,0,0,0,0,26000,-26000,-26000
20200212,053411,深中小國票9B購01,1.30,1.37,1.26,1.37,+0.06,4.58,1079000,11,1399940,0,0,0,0,0,0,500000,679000,-179000,-179000
20200212,053412,台達電國票97購02,1.92,2.07,1.86,2.05,+0.10,5.13,18000,5,34640,0,0,0,0,0,0,4000,14000,-10000,-10000
20200212,053413,台積電國票99購01,2.21,2.36,2.18,2.36,+0.22,10.28,64000,12,144690,0,0,0,0,0,0,36000,28000,8000,8000
20200212,053414,臻鼎國票97購01,1.00,1.00,0.80,0.80,+0.12,17.65,12000,3,10640,0,0,0,0,0,0,5000,7000,-2000,-2000
20200212,053415,聯茂國票97購01,1.21,1.84,1.21,1.55,+0.55,55.0,508000,19,750500,0,0,0,0,0,0,400000,108000,292000,292000
20200212,053416,光磊台新97購01,,,,,0.00,0.00,0,0,0,0,0,0,0,0,0,0,0,0,0
20200212,053417,上銀永豐96購02,1.56,1.57,1.51,1.51,+0.05,3.42,165000,7,255090,0,0,0,0,0,0,142000,43000,99000,99000
20200212,053418,旺宏永豐96購02,0.57,0.61,0.55,0.56,-0.02,-3.45,706000,14,411230,0,0,0,0,0,0,365000,341000,24000,24000
20200212,053419,光罩永豐96購01,0.45,0.47,0.45,0.47,+0.03,6.82,300000,2,138000,0,0,0,0,0,0,150000,150000,0,0
20200212,05341P,臺股指兆豐95售02,,,,,0.00,0.00,0,0,0,0,0,0,0,0,0,0,0,0,0
20200212,053420,華邦電永豐96購01,0.28,0.29,0.28,0.29,0.00,0.00,61000,4,17590,0,0,0,0,0,0,0,61000,-61000,-61000
20200212,053421,南亞科永豐96購01,1.32,1.32,1.30,1.31,-0.06,-4.38,168000,6,220440,0,0,0,0,0,0,100000,68000,32000,32000
20200212,053422,可成永豐96購01,0.53,0.53,0.53,0.53,0.00,0.00,100000,1,53000,0,0,0,0,0,0,100000,0,100000,100000
20200212,053423,亞光永豐96購01,1.92,2.21,1.92,2.19,+0.27,14.06,249000,40,520400,0,0,0,0,0,0,93000,199000,-106000,-106000
20200212,053424,欣興永豐96購02,1.06,1.33,1.05,1.33,+0.31,30.39,500000,26,610060,0,0,0,0,0,0,147000,377000,-230000,-230000
20200212,053425,京鼎永豐96購01,0.60,0.69,0.60,0.69,+0.15,27.78,173000,18,110310,0,0,0,0,0,0,10000,163000,-153000,-153000
20200212,053426,創意永豐96購04,0.83,0.91,0.81,0.90,-0.09,-9.09,225000,21,197280,0,0,0,0,0,0,54000,171000,-117000,-117000
20200212,053427,鎧勝永豐96購02,0.67,0.71,0.67,0.71,+0.06,9.23,98000,5,67480,0,0,0,0,0,0,98000,0,98000,98000
20200212,053428,中磊永豐96購02,1.42,1.45,1.42,1.45,+0.02,1.4,46000,5,66140,0,0,0,0,0,0,16000,30000,-14000,-14000
20200212,053429,彩晶永豐96購01,,,,,0.00,0.00,0,0,0,0,0,0,0,0,0,0,0,0,0
20200212,05342P,臺股指兆豐95售03,,,,,0.00,0.00,0,0,0,0,0,0,0,0,0,0,0,0,0
20200212,053430,樺漢永豐96購01,,,,,0.00,0.00,0,0,0,0,0,0,0,0,0,0,0,0,0
20200212,053431,志超永豐96購01,0.92,0.92,0.91,0.91,0.00,0.00,21000,2,19120,0,0,0,0,0,0,20000,1000,19000,19000
20200212,053432,世紀鋼永豐96購02,1.21,1.24,1.18,1.21,+0.01,0.83,189000,22,228590,0,0,0,0,0,0,179000,12000,167000,167000
20200212,053433,友達日盛99購06,1.42,1.42,1.32,1.32,-0.12,-8.33,368000,11,502800,0,0,0,0,0,0,225000,143000,82000,82000
20200212,053434,國泰金日盛96購01,0.52,0.56,0.52,0.56,+0.01,1.82,348000,22,187630,0,0,0,0,0,0,170000,178000,-8000,-8000
20200212,053435,新光金日盛96購01,0.43,0.43,0.42,0.43,+0.02,4.88,179000,29,76060,0,0,0,0,0,0,179000,0,179000,179000
20200212,053436,聯茂日盛96購01,0.75,1.02,0.75,0.90,+0.24,36.36,1181000,87,1038670,0,0,0,0,0,0,556000,665000,-109000,-109000
20200212,053437,啟碁日盛96購01,0.91,0.96,0.91,0.94,+0.05,5.62,70000,5,64850,0,0,0,0,0,0,45000,25000,20000,20000
20200212,053438,玉晶光麥證97購02,0.76,0.85,0.76,0.80,+0.05,6.67,98000,17,76030,10000,81000,-71000,0,0,0,39000,81000,-42000,-42000
20200212,053439,台積電凱基96購11,1.41,1.47,1.41,1.47,+0.11,8.09,101000,2,148410,0,0,0,0,0,0,101000,0,101000,101000
20200212,05343P,臺股指統一95售03,,,,,0.00,0.00,0,0,0,0,0,0,0,0,0,0,0,0,0
20200212,053440,台積電凱基96購12,,,,,0.00,0.00,0,0,0,0,0,0,0,0,0,0,0,0,0
20200212,053441,旺宏凱基98購01,0.84,0.84,0.80,0.82,-0.01,-1.2,361000,11,294180,0,0,0,0,0,0,13000,338000,-325000,-325000
20200212,053442,光罩凱基96購01,0.53,0.53,0.53,0.53,+0.06,12.77,26000,1,13780,0,0,0,0,0,0,26000,0,26000,26000
20200212,053443,智邦凱基97購01,3.04,3.41,2.90,2.90,+0.06,2.11,77000,11,241680,0,0,0,0,0,0,46000,30000,16000,16000
20200212,053444,奇力新凱基96購03,1.09,1.17,1.08,1.17,+0.04,3.54,717000,29,798200,0,0,0,0,0,0,550000,153000,397000,397000
20200212,053445,可成凱基96購04,,,,,0.00,0.00,0,0,0,0,0,0,0,0,0,0,0,0,0
20200212,053446,欣興凱基96購02,0.43,0.59,0.43,0.58,+0.19,48.72,139000,6,78440,0,0,0,0,0,0,40000,99000,-59000,-59000
20200212,053447,京鼎凱基96購03,0.85,0.99,0.85,0.98,+0.27,38.03,46000,8,42690,0,0,0,0,0,0,0,46000,-46000,-46000
20200212,053448,智易凱基96購03,,,,,0.00,0.00,0,0,0,0,0,0,0,0,0,0,0,0,0
20200212,053449,超眾凱基98購01,1.02,1.06,1.02,1.06,+0.04,3.92,35000,3,35900,0,0,0,0,0,0,35000,30000,5000,5000
20200212,05344P,臺股指統一95售04,,,,,0.00,0.00,0,0,0,0,0,0,0,0,0,0,0,0,0
20200212,053450,同欣電凱基96購02,1.85,2.20,1.85,2.20,+0.38,20.88,39000,19,76820,0,0,0,0,0,0,30000,9000,21000,21000
20200212,053451,致新凱基96購02,0.52,0.52,0.47,0.52,-0.01,-1.89,24000,7,12430,0,0,0,0,0,0,23000,0,23000,23000
20200212,053452,臺股指凱基97購01,0.66,0.77,0.66,0.77,+0.12,18.46,1400000,14,971310,0,0,0,0,0,0,1390000,0,1390000,1390000
20200212,053453,新光金統一98購01,0.59,0.61,0.57,0.61,+0.03,5.17,288000,45,169640,0,0,0,0,0,0,238000,50000,188000,188000
20200212,053454,創意統一96購02,1.03,1.13,1.02,1.08,-0.16,-12.9,476000,34,506780,0,0,0,0,0,0,330000,142000,188000,188000
20200212,053455,台光電元富96購02,0.67,0.88,0.67,0.88,+0.24,37.5,846000,38,659690,0,0,0,0,0,0,198000,657000,-459000,-459000
20200212,053456,大立光元富96購04,1.78,1.98,1.78,1.97,+0.19,10.67,239000,7,445190,0,0,0,0,0,0,193000,48000,145000,145000
20200212,053457,旺宏國泰98購03,1.67,1.72,1.61,1.62,-0.02,-1.22,97000,12,161450,0,0,0,0,0,0,44000,60000,-16000,-16000
20200212,053458,聯詠國泰97購01,0.96,1.00,0.94,0.96,+0.10,11.63,747000,14,727500,0,0,0,0,0,0,50000,697000,-647000,-647000
20200212,053459,康控國泰97購01,0.61,0.69,0.61,0.66,+0.06,10.0,171000,23,110460,0,0,0,0,0,0,40000,131000,-91000,-91000
20200212,05345P,臺股指統一95售05,0.75,0.75,0.72,0.72,-0.07,-8.86,7000,4,5180,0,0,0,0,0,0,4000,3000,1000,1000
20200212,053460,緯穎國泰97購01,2.76,2.77,2.76,2.77,+0.09,3.36,30000,2,82900,0,0,0,0,0,0,30000,0,30000,30000
20200212,053461,台郡永昌99購01,2.00,2.75,2.00,2.75,+1.57,133.05,91000,3,185000,0,0,0,0,0,0,0,90000,-90000,-90000
20200212,053462,元油反富邦97購02,,,,,0.00,0.00,0,0,0,0,0,0,0,0,0,0,0,0,0
20200212,053463,可成富邦98購01,0.42,0.47,0.42,0.47,+0.06,14.63,854000,16,388570,0,0,0,0,0,0,673000,181000,492000,492000
20200212,053464,喬山元大96購01,0.78,0.83,0.78,0.82,0.00,0.00,152000,4,121730,0,0,0,0,0,0,44000,152000,-108000,-108000
20200212,053465,聯電元大96購05,0.79,0.87,0.79,0.87,+0.07,8.75,669000,35,556770,0,0,0,0,0,0,506000,333000,173000,173000
20200212,053466,華通元大98購01,0.80,1.17,0.80,1.12,+0.32,40.0,200000,24,209510,0,0,0,0,0,0,126000,108000,18000,18000
20200212,053467,鴻海元大96購20,1.37,1.62,1.37,1.62,+0.38,30.65,415000,22,586330,0,0,0,0,0,0,383000,405000,-22000,-22000
20200212,053468,鴻海元大98購01,0.65,0.78,0.65,0.78,+0.16,25.81,140000,13,100130,0,0,0,0,0,0,93000,47000,46000,46000
20200212,053469,光磊元大97購01,0.69,0.71,0.69,0.71,+0.05,7.58,64000,2,44240,0,0,0,0,0,0,64000,4000,60000,60000
20200212,05346P,臺股指統一95售06,0.63,0.65,0.57,0.57,-0.12,-17.39,189000,12,114010,0,0,0,0,0,0,133000,56000,77000,77000
20200212,053470,華邦電元大96購02,0.46,0.51,0.46,0.49,+0.05,11.36,952000,24,466560,0,0,0,0,0,0,551000,361000,190000,190000
20200212,053471,正崴元大96購01,0.73,0.73,0.73,0.73,+0.01,1.39,68000,1,49640,0,0,0,0,0,0,68000,0,68000,68000
20200212,053472,漢唐元大96購02,1.27,1.33,1.27,1.28,+0.05,4.07,321000,18,419340,0,0,0,0,0,0,273000,77000,196000,196000
20200212,053473,聯發科元大96購15,0.93,1.08,0.91,1.00,+0.21,26.58,222000,15,222520,0,0,0,0,0,0,161000,61000,100000,100000
20200212,053474,聯發科元大97購06,0.85,0.93,0.83,0.92,+0.14,17.95,889000,44,784050,0,0,0,0,0,0,488000,399000,89000,89000
20200212,053475,華新科元大96購05,,,,,0.00,0.00,0,0,0,0,0,0,0,0,0,0,0,0,0
20200212,053476,冠德元大96購03,0.41,0.41,0.41,0.41,0.00,0.00,49000,1,20090,0,0,0,0,0,0,0,49000,-49000,-49000
20200212,053477,大立光元大97購03,3.11,3.40,3.11,3.40,+0.39,12.96,254000,16,836090,0,0,0,0,0,0,228000,217000,11000,11000
20200212,053478,京鼎元大96購01,2.00,2.34,2.00,2.34,+0.59,33.71,220000,21,476210,0,0,0,0,0,0,103000,220000,-117000,-117000
20200212,053479,達興元大96購01,0.93,0.99,0.93,0.99,0.00,0.00,15000,2,14550,0,0,0,0,0,0,5000,10000,-5000,-5000
20200212,05347P,滬深2X元富9B售02,1.67,1.67,1.63,1.64,+0.01,0.61,144000,8,237130,0,0,0,0,0,0,84000,60000,24000,24000
20200212,053480,祥碩元大96購02,9.00,9.45,9.00,9.45,+0.95,11.18,34000,7,313200,0,0,0,0,0,0,10000,24000,-14000,-14000
20200212,053481,同欣電元大97購01,1.65,1.82,1.59,1.59,+0.01,0.63,297000,41,514370,0,0,0,0,0,0,143000,237000,-94000,-94000
20200212,053482,矽力元大96購03,2.19,2.32,2.19,2.32,0.00,0.00,46000,8,103970,0,0,0,0,0,0,0,38000,-38000,-38000
20200212,053483,嘉澤第一96購01,0.65,0.67,0.59,0.59,-0.02,-3.28,161000,10,102020,0,0,0,0,0,0,40000,121000,-81000,-81000
20200212,053484,國巨國票97購03,4.84,5.00,4.60,5.00,+0.40,8.7,145000,10,699450,0,0,0,0,0,0,70000,25000,45000,45000
20200212,053485,矽創國票97購04,1.69,2.01,1.69,2.01,+0.29,16.86,128000,21,227750,0,0,0,0,0,0,43000,85000,-42000,-42000
20200212,053486,T50反1兆豐96購01,,,,,0.00,0.00,0,0,0,0,0,0,0,0,0,0,0,0,0
20200212,053487,台泥兆豐97購01,3.01,3.02,3.01,3.02,+0.05,1.68,42000,5,126570,0,0,0,0,0,0,27000,15000,12000,12000
20200212,053488,中石化兆豐97購01,,,,,0.00,0.00,0,0,0,0,0,0,0,0,0,0,0,0,0
20200212,053489,上銀兆豐97購01,4.45,4.47,4.36,4.37,+0.03,0.69,48000,5,213390,0,0,0,0,0,0,35000,13000,22000,22000
20200212,05348P,美律元富98售01,,,,,0.00,0.00,0,0,0,0,0,0,0,0,0,0,0,0,0
20200212,053490,為升兆豐97購01,1.79,1.79,1.79,1.79,0.00,0.00,10000,1,17900,0,0,0,0,0,0,0,10000,-10000,-10000
20200212,053491,鴻海兆豐97購02,2.22,2.52,2.18,2.52,+0.40,18.87,163000,9,365160,0,0,0,0,0,0,108000,55000,53000,53000
20200212,053492,華邦電兆豐97購01,1.39,1.45,1.38,1.41,+0.14,11.02,146000,15,205600,0,0,0,0,0,0,20000,126000,-106000,-106000
20200212,053493,智邦兆豐97購02,3.44,3.64,3.20,3.20,+0.02,0.63,93000,15,329200,0,0,0,0,0,0,29000,64000,-35000,-35000
20200212,053494,南亞科兆豐96購02,5.60,5.60,5.60,5.60,+0.10,1.82,24000,2,134400,0,0,0,0,0,0,24000,0,24000,24000
20200212,053495,聯發科兆豐96購02,1.86,2.08,1.86,2.08,+0.40,23.81,70000,8,137240,0,0,0,0,0,0,36000,34000,2000,2000
20200212,053496,義隆兆豐96購02,2.80,2.85,2.72,2.76,+0.20,7.81,204000,18,566630,0,0,0,0,0,0,197000,7000,190000,190000
20200212,053497,新光金兆豐97購01,0.56,0.56,0.55,0.56,0.00,0.00,150000,39,83680,0,0,0,0,0,0,150000,0,150000,150000
20200212,053498,大立光兆豐96購03,2.30,2.30,2.30,2.30,+0.26,12.75,35000,1,80500,0,0,0,0,0,0,0,35000,-35000,-35000
20200212,053499,禾伸堂兆豐96購01,2.91,2.95,2.91,2.95,0.00,0.00,41000,4,119990,0,0,0,0,0,0,0,41000,-41000,-41000
20200212,05349P,可成元富98售03,,,,,0.00,0.00,0,0,0,0,0,0,0,0,0,0,0,0,0
20200212,053500,新日興兆豐97購01,,,,,0.00,0.00,0,0,0,0,0,0,0,0,0,0,0,0,0
20200212,053501,明泰兆豐96購01,1.72,1.84,1.72,1.84,+0.05,2.79,382000,14,680820,0,0,0,0,0,0,0,382000,-382000,-382000
20200212,053502,智伸科兆豐97購01,2.41,2.41,2.41,2.41,+0.04,1.69,10000,1,24100,0,0,0,0,0,0,10000,0,10000,10000
20200212,053503,臻鼎兆豐97購01,2.88,2.96,2.42,2.50,+0.26,11.61,153000,15,422480,0,0,0,0,0,0,48000,105000,-57000,-57000
20200212,053504,祥碩兆豐96購01,,,,,0.00,0.00,0,0,0,0,0,0,0,0,0,0,0,0,0
20200212,053505,瑞儀兆豐97購01,1.16,1.16,1.12,1.12,-0.01,-0.88,20000,2,22800,0,0,0,0,0,0,10000,10000,0,0
20200212,053506,南茂兆豐97購01,1.81,1.87,1.80,1.87,+0.02,1.08,39000,12,71020,0,0,0,0,0,0,34000,5000,29000,29000
20200212,053507,百和兆豐96購01,3.49,3.49,3.48,3.48,+0.02,0.58,82000,3,285470,0,0,0,0,0,0,71000,11000,60000,60000
20200212,053508,元油反群益9A購01,,,,,0.00,0.00,0,0,0,0,0,0,0,0,0,0,0,0,0
20200212,053509,華新群益98購01,0.83,0.86,0.83,0.86,+0.05,6.17,25000,6,21030,0,0,0,0,0,0,12000,13000,-1000,-1000
20200212,05350P,可成元富98售04,2.89,2.89,2.89,2.89,-0.19,-6.17,5000,1,14450,0,0,0,0,0,0,5000,0,5000,5000
20200212,053510,聯電群益97購01,0.71,0.80,0.71,0.80,+0.04,5.26,289000,16,212480,0,0,0,0,0,0,179000,110000,69000,69000
20200212,053511,鴻海群益96購04,1.36,1.74,1.36,1.74,0.00,0.00,76000,11,114350,0,0,0,0,0,0,0,76000,-76000,-76000
20200212,053512,台積電群益96購06,0.69,0.76,0.66,0.74,+0.08,12.12,975000,17,695350,0,0,0,0,0,0,667000,308000,359000,359000
20200212,053513,義隆群益96購05,1.41,1.41,1.26,1.35,+0.24,21.62,478000,12,655680,0,0,0,0,0,0,468000,10000,458000,458000
20200212,053514,麗豐群益96購01,0.40,0.43,0.40,0.43,-0.02,-4.44,99000,2,39630,0,0,0,0,0,0,0,99000,-99000,-99000
20200212,053515,致伸群益96購02,0.39,0.39,0.39,0.39,0.00,0.00,1000,1,390,0,0,0,0,0,0,0,1000,-1000,-1000
20200212,053516,茂林群益96購05,2.05,2.05,2.05,2.05,0.00,0.00,3000,1,6150,0,0,0,0,0,0,3000,0,3000,3000
20200212,053517,崇越群益97購01,1.34,1.55,1.34,1.50,+0.14,10.29,445000,45,652800,0,0,0,0,0,0,98000,347000,-249000,-249000
20200212,053518,聯茂群益96購03,1.80,1.80,1.80,1.80,+0.53,41.73,4000,1,7200,0,0,0,0,0,0,4000,0,4000,4000
20200212,053519,力成群益96購02,3.68,4.30,3.68,4.30,+1.02,31.1,63000,13,251920,0,0,0,0,0,0,0,63000,-63000,-63000
20200212,05351P,臺股指元富95售05,1.70,1.70,1.57,1.57,-0.19,-10.8,41000,12,67420,0,0,0,0,0,0,0,41000,-41000,-41000
20200212,053520,康友群益96購01,0.91,0.97,0.91,0.93,+0.01,1.09,152000,17,141230,0,0,0,0,0,0,137000,29000,108000,108000
20200212,053521,緯穎群益96購02,6.10,7.00,6.05,7.00,+0.50,7.69,153000,23,977100,0,0,0,0,0,0,123000,87000,36000,36000
20200212,053522,臺股指群益99購01,2.38,2.63,2.38,2.62,+0.32,13.91,367000,23,893600,0,0,0,0,0,0,59000,308000,-249000,-249000
20200212,053523,T50反1中信9A購01,1.04,1.04,0.99,0.99,-0.08,-7.48,396000,10,395740,0,0,0,0,0,0,201000,195000,6000,6000
20200212,053524,聯電中信97購02,0.66,0.71,0.64,0.71,+0.04,5.97,867000,43,584870,0,0,0,0,0,0,421000,408000,13000,13000
20200212,053525,台積電中信96購04,0.90,0.93,0.88,0.93,+0.07,8.14,135000,6,121850,0,0,0,0,0,0,125000,10000,115000,115000
20200212,053526,正崴中信96購01,0.37,0.38,0.37,0.38,+0.01,2.7,100000,2,37900,0,0,0,0,0,0,100000,0,100000,100000
20200212,053527,創意中信97購01,0.73,0.74,0.71,0.74,-0.06,-7.5,168000,20,123810,0,0,0,0,0,0,108000,60000,48000,48000
20200212,053528,南電中信9A購01,0.42,0.46,0.42,0.45,+0.07,18.42,180000,8,81500,0,0,0,0,0,0,50000,130000,-80000,-80000
20200212,053529,國巨麥證96購01,1.72,1.74,1.69,1.74,+0.13,8.07,67000,17,114550,30000,37000,-7000,0,0,0,51000,42000,9000,9000
20200212,05352P,臺股指元富95售06,,,,,0.00,0.00,0,0,0,0,0,0,0,0,0,0,0,0,0
20200212,053530,聯發科康和96購01,0.47,0.47,0.47,0.47,+0.09,23.68,1000,1,470,0,0,0,0,0,0,1000,0,1000,1000
20200212,053531,國泰金康和96購01,0.49,0.53,0.49,0.52,-0.02,-3.7,182000,12,93680,0,0,0,0,0,0,107000,75000,32000,32000
20200212,053532,台積電永豐96購03,0.84,0.91,0.84,0.91,+0.08,9.64,493000,7,438620,0,0,0,0,0,0,392000,101000,291000,291000
20200212,053533,光罩永豐96購03,0.29,0.29,0.27,0.27,+0.03,12.5,15000,2,4250,0,0,0,0,0,0,0,15000,-15000,-15000
20200212,053534,微星永豐96購02,2.69,2.69,2.40,2.40,-0.01,-0.41,203000,16,510780,0,0,0,0,0,0,131000,109000,22000,22000
20200212,053535,宏達電永豐96購02,0.93,0.93,0.91,0.91,+0.05,5.81,37000,3,33910,0,0,0,0,0,0,12000,25000,-13000,-13000
20200212,053536,明泰永豐96購01,0.70,0.74,0.70,0.74,+0.07,10.45,323000,5,231210,0,0,0,0,0,0,25000,298000,-273000,-273000
20200212,053537,玉晶光永豐98購02,1.34,1.44,1.33,1.44,+0.15,11.63,979000,9,1356080,0,0,0,0,0,0,356000,623000,-267000,-267000
20200212,053538,京鼎永豐96購03,0.40,0.42,0.39,0.40,+0.09,29.03,80000,9,31760,0,0,0,0,0,0,3000,77000,-74000,-74000
20200212,053539,智易永豐96購01,0.61,0.78,0.61,0.77,0.00,0.00,296000,24,212390,0,0,0,0,0,0,0,296000,-296000,-296000
20200212,05353P,臺股指元富95售07,,,,,0.00,0.00,0,0,0,0,0,0,0,0,0,0,0,0,0
20200212,053540,健策永豐96購01,1.14,1.23,1.04,1.23,+0.15,13.89,560000,38,624510,0,0,0,0,0,0,278000,281000,-3000,-3000
20200212,053541,泰鼎永豐96購02,3.02,3.16,2.96,2.98,+0.16,5.67,186000,22,575420,0,0,0,0,0,0,40000,146000,-106000,-106000
20200212,053542,超眾永豐96購01,1.34,1.54,1.34,1.54,+0.10,6.94,341000,38,488730,0,0,0,0,0,0,297000,71000,226000,226000
20200212,053543,臺股指永豐96購02,1.66,1.66,1.66,1.66,+0.16,10.67,1000,1,1660,0,0,0,0,0,0,1000,0,1000,1000
20200212,053544,華新凱基96購01,0.43,0.43,0.43,0.43,+0.03,7.5,2000,2,860,0,0,0,0,0,0,1000,1000,0,0
20200212,053545,上銀凱基96購03,2.60,2.60,2.60,2.60,-0.03,-1.14,50000,1,130000,0,0,0,0,0,0,0,50000,-50000,-50000
20200212,053546,台積電凱基96購13,,,,,0.00,0.00,0,0,0,0,0,0,0,0,0,0,0,0,0
20200212,053547,台積電凱基96購14,1.09,1.10,1.09,1.10,+0.08,7.84,40000,3,43700,0,0,0,0,0,0,39000,30000,9000,9000
20200212,053548,旺宏凱基96購04,1.27,1.32,1.24,1.25,0.00,0.00,188000,10,239640,0,0,0,0,0,0,131000,177000,-46000,-46000
20200212,053549,南亞科凱基96購02,,,,,0.00,0.00,0,0,0,0,0,0,0,0,0,0,0,0,0
20200212,05354P,臺股指元富95售08,1.04,1.04,0.99,0.99,0.00,0.00,120000,7,123100,0,0,0,0,0,0,0,120000,-120000,-120000
20200212,053550,聯發科凱基96購15,0.64,0.64,0.64,0.64,+0.09,16.36,3000,1,1920,0,0,0,0,0,0,3000,0,3000,3000
20200212,053551,可成凱基96購05,1.32,1.48,0.21,1.48,+0.23,18.4,135000,4,177020,0,0,0,0,0,0,64000,71000,-7000,-7000
20200212,053552,華新科凱基96購08,4.67,4.67,4.30,4.56,+0.12,2.7,52000,12,231810,0,0,0,0,0,0,37000,21000,16000,16000
20200212,053553,聯詠凱基96購03,1.43,1.50,1.43,1.50,+0.21,16.28,37000,3,54550,0,0,0,0,0,0,37000,2000,35000,35000
20200212,053554,欣興凱基97購02,0.53,0.57,0.53,0.57,+0.16,39.02,60000,7,33100,0,0,0,0,0,0,55000,0,55000,55000
20200212,053555,日月光凱基97購01,,,,,0.00,0.00,0,0,0,0,0,0,0,0,0,0,0,0,0
20200212,053556,康控凱基97購02,,,,,0.00,0.00,0,0,0,0,0,0,0,0,0,0,0,0,0
20200212,053557,聯茂凱基96購04,1.34,1.54,1.31,1.31,0.00,0.00,54000,12,75990,0,0,0,0,0,0,0,54000,-54000,-54000
20200212,053558,訊芯凱基96購02,1.07,1.17,1.07,1.17,+0.21,21.88,74000,4,82040,0,0,0,0,0,0,62000,10000,52000,52000
20200212,053559,台積電國泰98購01,1.56,1.62,1.55,1.62,+0.12,8.0,317000,21,500350,0,0,0,0,0,0,309000,3000,306000,306000
20200212,05355P,臺股指元富95售09,0.89,0.89,0.88,0.88,0.00,0.00,10000,2,8850,0,0,0,0,0,0,10000,0,10000,10000
20200212,053560,漢唐國泰98購01,1.65,1.72,1.65,1.72,+0.16,10.26,37000,3,61490,0,0,0,0,0,0,31000,6000,25000,25000
20200212,053561,玉晶光國泰98購01,2.28,2.44,2.23,2.38,+0.21,9.68,2432000,72,5736600,0,0,0,0,0,0,853000,1802000,-949000,-949000
20200212,053562,玉晶光國泰98購02,2.50,2.74,2.50,2.69,+0.22,8.91,1789000,66,4743300,0,0,0,0,0,0,481000,1348000,-867000,-867000
20200212,053563,台積電富邦97購01,0.48,0.49,0.47,0.49,+0.05,11.36,1879000,36,906940,0,0,0,0,0,0,1829000,39000,1790000,1790000
20200212,053564,台積電富邦99購01,0.45,0.47,0.43,0.46,+0.04,9.52,4474000,171,2033370,0,0,0,0,0,0,3368000,111000,3257000,3257000
20200212,053565,台光電富邦98購01,0.54,0.58,0.54,0.58,+0.11,23.4,45000,5,25400,0,0,0,0,0,0,15000,15000,0,0
20200212,053566,大立光富邦99購03,0.86,0.86,0.86,0.86,+0.09,11.69,2000,1,1720,0,0,0,0,0,0,2000,0,2000,2000
20200212,053567,群創富邦97購01,0.97,0.97,0.97,0.97,+0.04,4.3,15000,2,14550,0,0,0,0,0,0,15000,0,15000,15000
20200212,053568,智伸科富邦98購01,0.71,0.71,0.67,0.68,-0.04,-5.56,119000,3,83790,0,0,0,0,0,0,113000,19000,94000,94000
20200212,053569,漢唐統一98購01,0.63,0.65,0.63,0.65,+0.02,3.17,460000,10,298500,0,0,0,0,0,0,154000,306000,-152000,-152000
20200212,05356P,臺股指元富95售10,0.63,0.63,0.56,0.56,-0.13,-18.84,200000,12,119100,0,0,0,0,0,0,5000,195000,-190000,-190000
20200212,053570,京元電統一96購01,0.40,0.45,0.39,0.45,+0.04,9.76,432000,37,176060,0,0,0,0,0,0,384000,48000,336000,336000
20200212,053571,奇鋐統一96購02,,,,,0.00,0.00,0,0,0,0,0,0,0,0,0,0,0,0,0
20200212,053572,彩晶統一96購01,0.47,0.47,0.47,0.47,-0.01,-2.08,101000,2,47470,0,0,0,0,0,0,0,101000,-101000,-101000
20200212,053573,臺股指統一99購01,,,,,0.00,0.00,0,0,0,0,0,0,0,0,0,0,0,0,0
20200212,053574,奇力新元富99購01,2.33,2.37,2.20,2.37,+0.06,2.6,574000,57,1321570,0,0,0,0,0,0,311000,253000,58000,58000
20200212,053575,聯詠元富96購01,1.01,1.03,1.01,1.03,+0.13,14.44,30000,3,30700,0,0,0,0,0,0,10000,20000,-10000,-10000
20200212,053576,智原元富96購01,0.25,0.25,0.25,0.25,0.00,0.00,40000,1,10000,0,0,0,0,0,0,0,40000,-40000,-40000
20200212,053577,上証2X元大96購02,,,,,0.00,0.00,0,0,0,0,0,0,0,0,0,0,0,0,0
20200212,053578,華新元大98購01,0.90,0.93,0.90,0.93,+0.06,6.9,178000,9,161920,0,0,0,0,0,0,58000,120000,-62000,-62000
20200212,053579,華通元大97購01,0.51,0.71,0.51,0.69,+0.22,46.81,138000,11,87980,0,0,0,0,0,0,115000,23000,92000,92000
20200212,05357P,臺股指元富95售11,,,,,0.00,0.00,0,0,0,0,0,0,0,0,0,0,0,0,0
20200212,053580,國巨元大96購10,4.56,4.62,4.37,4.62,+0.34,7.94,227000,30,1011890,0,0,0,0,0,0,227000,195000,32000,32000
20200212,053581,台積電元大96購14,2.16,2.25,2.16,2.25,+0.23,11.39,63000,9,137730,0,0,0,0,0,0,44000,23000,21000,21000
20200212,053582,英業達元大97購01,1.91,1.91,1.91,1.91,+0.01,0.53,90000,3,171900,0,0,0,0,0,0,10000,80000,-70000,-70000
20200212,053583,漢唐元大96購03,1.44,1.50,1.44,1.48,+0.07,4.96,267000,9,395460,0,0,0,0,0,0,267000,0,267000,267000
20200212,053584,友達元大9B購02,1.99,1.99,1.99,1.99,-0.12,-5.69,207000,10,411930,0,0,0,0,0,0,90000,207000,-117000,-117000
20200212,053585,友達元大9C購03,2.23,2.23,2.11,2.11,-0.12,-5.38,203000,16,433310,0,0,0,0,0,0,172000,203000,-31000,-31000
20200212,053586,建準元大96購01,,,,,0.00,0.00,0,0,0,0,0,0,0,0,0,0,0,0,0
20200212,053587,京元電元大98購01,1.16,1.24,1.14,1.23,+0.06,5.13,694000,28,819810,0,0,0,0,0,0,574000,222000,352000,352000
20200212,053588,聯發科元大97購07,1.25,1.35,1.23,1.34,+0.26,24.07,229000,30,292320,0,0,0,0,0,0,189000,122000,67000,67000
20200212,053589,宏達電元大97購02,0.60,0.60,0.59,0.59,+0.03,5.36,101000,2,60590,0,0,0,0,0,0,100000,1000,99000,99000
20200212,05358P,大立光元大95售09,1.61,1.61,1.61,1.61,-0.14,-8.0,48000,1,77280,0,0,0,0,0,0,48000,0,48000,48000
20200212,053590,新光金元大9A購02,0.76,0.76,0.76,0.76,+0.02,2.7,6000,1,4560,0,0,0,0,0,0,6000,0,6000,6000
20200212,053591,大立光元大99購03,1.47,1.50,1.44,1.47,+0.14,10.53,75000,7,110400,0,0,0,0,0,0,65000,0,65000,65000
20200212,053592,亞光元大96購01,2.51,2.90,2.51,2.86,+0.40,16.26,280000,41,773310,0,0,0,0,0,0,74000,246000,-172000,-172000
20200212,053593,晶技元大98購01,,,,,0.00,0.00,0,0,0,0,0,0,0,0,0,0,0,0,0
20200212,053594,京鼎元大96購02,0.90,1.14,0.90,1.10,0.00,0.00,335000,17,336440,0,0,0,0,0,0,4000,331000,-327000,-327000
20200212,053595,創意元大96購02,1.27,1.34,1.21,1.28,-0.14,-9.86,365000,18,463260,0,0,0,0,0,0,84000,318000,-234000,-234000
20200212,053596,嘉澤元大96購01,2.70,2.78,2.40,2.40,-0.13,-5.14,78000,8,203050,0,0,0,0,0,0,78000,78000,0,0
20200212,053597,牧德元大99購01,2.03,2.07,2.03,2.07,0.00,0.00,3000,3,6150,0,0,0,0,0,0,3000,0,3000,3000
20200212,053598,日月光元大96購04,1.05,1.25,1.05,1.25,+0.24,23.76,178000,10,198790,0,0,0,0,0,0,0,178000,-178000,-178000
20200212,053599,崇越元大96購01,1.33,1.44,1.33,1.44,+0.13,9.92,183000,4,259240,0,0,0,0,0,0,28000,155000,-127000,-127000
20200212,05359P,嘉澤元大95售02,0.95,1.01,0.95,1.01,+0.05,5.21,225000,4,221050,0,0,0,0,0,0,0,225000,-225000,-225000
20200212,053600,同欣電元大96購04,1.10,1.27,1.06,1.12,+0.08,7.69,201000,26,232170,0,0,0,0,0,0,167000,69000,98000,98000
20200212,053601,台表科元大98購01,0.58,0.64,0.57,0.63,+0.05,8.62,937000,34,573570,0,0,0,0,0,0,372000,659000,-287000,-287000
20200212,053602,台虹元大96購01,1.03,1.08,1.03,1.08,+0.09,9.09,239000,18,252990,0,0,0,0,0,0,182000,57000,125000,125000
20200212,053603,臺股指元大96購20,1.20,1.36,1.20,1.36,+0.23,20.35,16000,3,20870,0,0,0,0,0,0,16000,0,16000,16000
20200212,053604,臺股指元大96購21,1.01,1.09,1.01,1.09,+0.11,11.22,22000,4,22560,0,0,0,0,0,0,22000,0,22000,22000
20200212,053605,臺股指永昌96購01,,,,,0.00,0.00,0,0,0,0,0,0,0,0,0,0,0,0,0
20200212,053606,臺股指永昌96購02,,,,,0.00,0.00,0,0,0,0,0,0,0,0,0,0,0,0,0
20200212,053607,大立光第一96購01,0.68,0.68,0.68,0.68,+0.06,9.68,10000,1,6800,0,0,0,0,0,0,10000,0,10000,10000
20200212,053608,彩晶第一96購01,,,,,0.00,0.00,0,0,0,0,0,0,0,0,0,0,0,0,0
20200212,053609,華新中信9A購01,0.38,0.38,0.38,0.38,0.00,0.00,2000,1,760,0,0,0,0,0,0,0,2000,-2000,-2000
20200212,05360P,健策元大95售03,,,,,0.00,0.00,0,0,0,0,0,0,0,0,0,0,0,0,0
20200212,053610,矽力中信98購01,0.96,1.02,0.91,1.02,+0.11,12.09,289000,13,269200,0,0,0,0,0,0,179000,110000,69000,69000
20200212,053611,聯茂麥證96購01,0.95,1.03,0.95,1.00,+0.17,20.48,60000,6,60200,60000,0,60000,0,0,0,60000,10000,50000,50000
20200212,053612,T50反1群益96購01,0.39,0.39,0.37,0.37,0.00,0.00,103000,3,38170,0,0,0,0,0,0,0,103000,-103000,-103000
20200212,053613,元油反群益9A購02,,,,,0.00,0.00,0,0,0,0,0,0,0,0,0,0,0,0,0
20200212,053614,台積電群益96購08,1.20,1.24,1.20,1.24,+0.08,6.9,384000,9,466700,0,0,0,0,0,0,29000,309000,-280000,-280000
20200212,053615,光罩群益96購01,0.37,0.44,0.37,0.41,+0.04,10.81,132000,17,52710,0,0,0,0,0,0,39000,93000,-54000,-54000
20200212,053616,奇力新群益97購01,3.69,4.01,3.61,3.98,+0.11,2.84,218000,67,838310,0,0,0,0,0,0,161000,196000,-35000,-35000
20200212,053617,宏達電群益96購02,,,,,0.00,0.00,0,0,0,0,0,0,0,0,0,0,0,0,0
20200212,053618,新唐群益96購01,,,,,0.00,0.00,0,0,0,0,0,0,0,0,0,0,0,0,0
20200212,053619,和碩群益96購01,0.86,0.92,0.86,0.92,-0.02,-2.13,72000,7,64920,0,0,0,0,0,0,22000,50000,-28000,-28000
20200212,05361P,聯發科富邦97售01,1.02,1.02,1.01,1.01,-0.13,-11.4,70000,2,70900,0,0,0,0,0,0,70000,0,70000,70000
20200212,053620,臺股指群益96購06,2.43,2.67,2.43,2.67,+0.36,15.58,16000,5,41580,0,0,0,0,0,0,3000,13000,-10000,-10000
20200212,053621,臺股指群益96購07,,,,,0.00,0.00,0,0,0,0,0,0,0,0,0,0,0,0,0
20200212,053622,臺股指群益96購08,,,,,0.00,0.00,0,0,0,0,0,0,0,0,0,0,0,0,0
20200212,053623,臺股指群益96購09,1.10,1.38,1.10,1.35,+0.30,28.57,126000,9,160510,0,0,0,0,0,0,106000,20000,86000,86000
20200212,053624,A50正2兆豐97購02,,,,,0.00,0.00,0,0,0,0,0,0,0,0,0,0,0,0,0
20200212,053625,國巨兆豐96購03,2.03,2.09,1.98,2.09,+0.15,7.73,467000,16,954720,0,0,0,0,0,0,101000,366000,-265000,-265000
20200212,053626,台積電兆豐96購03,1.81,1.93,1.75,1.89,+0.11,6.18,1638000,29,2989260,0,0,0,0,0,0,857000,681000,176000,176000
20200212,053627,宏碁兆豐97購01,1.13,1.17,1.13,1.17,+0.07,6.36,93000,9,108290,0,0,0,0,0,0,10000,83000,-73000,-73000
20200212,053628,微星兆豐96購01,4.59,4.59,4.14,4.14,-0.03,-0.72,42000,7,183010,0,0,0,0,0,0,22000,20000,2000,2000
20200212,053629,玉山金兆豐96購01,1.92,1.92,1.91,1.91,-0.02,-1.04,50000,4,95800,0,0,0,0,0,0,30000,20000,10000,10000
20200212,05362P,可成富邦97售02,,,,,0.00,0.00,0,0,0,0,0,0,0,0,0,0,0,0,0
20200212,053630,奇鋐兆豐97購01,1.11,1.16,1.11,1.14,+0.06,5.56,540000,11,613870,0,0,0,0,0,0,5000,535000,-530000,-530000
20200212,053631,欣興兆豐97購01,1.72,2.12,1.72,2.12,+0.38,21.84,208000,17,411760,0,0,0,0,0,0,20000,188000,-168000,-168000
20200212,053632,新唐兆豐96購01,1.49,1.54,1.49,1.54,+0.09,6.21,20000,2,30300,0,0,0,0,0,0,10000,10000,0,0
20200212,053633,臺股指兆豐96購01,,,,,0.00,0.00,0,0,0,0,0,0,0,0,0,0,0,0,0
20200212,053634,劍麟永豐96購01,0.36,0.37,0.36,0.37,+0.01,2.78,136000,2,49640,0,0,0,0,0,0,68000,68000,0,0
20200212,053635,技嘉永豐96購01,1.89,1.94,1.79,1.85,0.00,0.00,522000,69,986280,0,0,0,0,0,0,323000,168000,155000,155000
20200212,053636,全新永豐96購02,0.58,0.58,0.58,0.58,+0.10,20.83,40000,1,23200,0,0,0,0,0,0,0,40000,-40000,-40000
20200212,053637,強茂永豐96購01,1.23,1.29,1.23,1.29,+0.07,5.74,247000,11,312480,0,0,0,0,0,0,53000,189000,-136000,-136000
20200212,053638,信邦永豐96購01,0.79,0.85,0.79,0.84,+0.01,1.2,365000,17,294590,0,0,0,0,0,0,278000,87000,191000,191000
20200212,053639,禾伸堂永豐96購01,2.83,2.90,2.82,2.90,+0.04,1.4,79000,7,228670,0,0,0,0,0,0,77000,0,77000,77000
20200212,05363P,臺股指富邦95售03,0.39,0.39,0.38,0.38,-0.04,-9.52,370000,7,141000,0,0,0,0,0,0,0,370000,-370000,-370000
20200212,053640,上緯控永豐96購01,1.11,1.16,1.06,1.16,+0.03,2.65,187000,7,205100,0,0,0,0,0,0,77000,110000,-33000,-33000
20200212,053641,正文永豐96購01,0.62,0.62,0.62,0.62,-0.01,-1.59,126000,3,78120,0,0,0,0,0,0,126000,0,126000,126000
20200212,053642,瀚宇博永豐96購01,0.98,1.11,0.97,1.11,+0.09,8.82,415000,16,430580,0,0,0,0,0,0,110000,317000,-207000,-207000
20200212,053643,漢唐國票97購02,2.78,2.87,2.78,2.78,+0.12,4.51,59000,7,166850,0,0,0,0,0,0,24000,35000,-11000,-11000
20200212,053644,台表科國票97購03,0.91,0.98,0.91,0.98,+0.07,7.69,193000,5,179890,0,0,0,0,0,0,143000,50000,93000,93000
20200212,053645,臺股指國票96購08,3.20,3.53,3.20,3.53,+0.38,12.06,13000,2,43250,0,0,0,0,0,0,8000,5000,3000,3000
20200212,053646,臺股指國票96購09,,,,,0.00,0.00,0,0,0,0,0,0,0,0,0,0,0,0,0
20200212,053647,臺股指國票96購10,2.05,2.20,2.05,2.20,0.00,0.00,240000,12,504200,0,0,0,0,0,0,120000,120000,0,0
20200212,053648,台積電凱基97購04,2.51,2.55,2.51,2.55,0.00,0.00,11000,2,27650,0,0,0,0,0,0,0,11000,-11000,-11000
20200212,053649,台積電凱基97購05,0.61,0.72,0.60,0.72,+0.13,22.03,51000,7,31720,0,0,0,0,0,0,40000,6000,34000,34000
20200212,05364P,臺股指富邦95售04,0.71,0.71,0.69,0.69,-0.09,-11.54,220000,4,154800,0,0,0,0,0,0,0,220000,-220000,-220000
20200212,053650,華邦電凱基98購01,0.17,0.17,0.16,0.16,+0.02,14.29,522000,11,87560,0,0,0,0,0,0,162000,302000,-140000,-140000
20200212,053651,台光電凱基98購01,0.83,0.98,0.83,0.98,+0.20,25.64,61000,5,54860,0,0,0,0,0,0,15000,26000,-11000,-11000
20200212,053652,友達凱基98購04,,,,,0.00,0.00,0,0,0,0,0,0,0,0,0,0,0,0,0
20200212,053653,京元電凱基96購02,0.57,0.65,0.55,0.64,+0.03,4.92,230000,26,132640,0,0,0,0,0,0,133000,28000,105000,105000
20200212,053654,聯發科凱基98購01,0.82,0.96,0.09,0.96,+0.24,33.33,440000,13,309900,0,0,0,0,0,0,270000,120000,150000,150000
20200212,053655,全新凱基98購02,0.52,0.62,0.52,0.60,+0.13,27.66,57000,6,35120,0,0,0,0,0,0,5000,52000,-47000,-47000
20200212,053656,可成凱基96購06,,,,,0.00,0.00,0,0,0,0,0,0,0,0,0,0,0,0,0
20200212,053657,元大金凱基96購01,0.74,0.74,0.73,0.73,-0.05,-6.41,56000,2,41040,0,0,0,0,0,0,40000,16000,24000,24000
20200212,053658,亞光凱基96購01,2.50,2.93,0.95,2.89,+0.42,17.0,144000,18,365240,0,0,0,0,0,0,115000,61000,54000,54000
20200212,053659,智原凱基97購01,0.32,0.32,0.31,0.31,+0.01,3.33,100000,14,31010,0,0,0,0,0,0,99000,1000,98000,98000
20200212,05365P,臺股指富邦95售05,,,,,0.00,0.00,0,0,0,0,0,0,0,0,0,0,0,0,0
20200212,053660,群創凱基98購08,,,,,0.00,0.00,0,0,0,0,0,0,0,0,0,0,0,0,0
20200212,053661,嘉澤凱基97購01,1.34,1.34,1.23,1.23,-0.02,-1.6,25000,3,31800,0,0,0,0,0,0,0,25000,-25000,-25000
20200212,053662,矽力凱基97購01,2.15,2.23,2.15,2.23,+0.23,11.5,202000,6,449500,0,0,0,0,0,0,202000,0,202000,202000
20200212,053663,臺股指凱基96購24,,,,,0.00,0.00,0,0,0,0,0,0,0,0,0,0,0,0,0
20200212,053664,臺股指凱基96購25,,,,,0.00,0.00,0,0,0,0,0,0,0,0,0,0,0,0,0
20200212,053665,臺股指凱基96購26,0.61,0.71,0.61,0.71,+0.13,22.41,31000,4,20440,0,0,0,0,0,0,11000,20000,-9000,-9000
20200212,053666,臺股指凱基96購29,1.32,1.44,1.32,1.44,+0.13,9.92,219000,5,290170,0,0,0,0,0,0,194000,25000,169000,169000
20200212,053667,鴻海統一96購12,0.46,0.46,0.46,0.46,+0.05,12.2,96000,1,44160,0,0,0,0,0,0,96000,0,96000,96000
20200212,053668,鴻海統一97購01,2.36,2.36,2.36,2.36,+0.45,23.56,2000,1,4720,0,0,0,0,0,0,0,2000,-2000,-2000
20200212,053669,台積電統一96購08,1.68,1.79,1.68,1.79,+0.17,10.49,175000,5,310210,0,0,0,0,0,0,175000,0,175000,175000
20200212,05366P,鴻海元富95售12,2.71,2.71,2.63,2.63,-0.25,-8.68,178000,4,472140,0,0,0,0,0,0,108000,70000,38000,38000
20200212,053670,台積電統一96購09,0.39,0.42,0.39,0.42,+0.04,10.53,473000,8,186720,0,0,0,0,0,0,21000,449000,-428000,-428000
20200212,053671,可成統一96購03,1.37,1.41,1.37,1.39,+0.10,7.75,204000,8,281860,0,0,0,0,0,0,68000,136000,-68000,-68000
20200212,053672,嘉澤元富96購02,1.33,1.36,1.22,1.25,-0.04,-3.1,120000,9,154750,0,0,0,0,0,0,75000,45000,30000,30000
20200212,053673,超眾元富96購03,2.24,2.40,2.20,2.40,+0.17,7.62,674000,40,1542410,0,0,0,0,0,0,373000,331000,42000,42000
20200212,053674,臺股指元富96購01,,,,,0.00,0.00,0,0,0,0,0,0,0,0,0,0,0,0,0
20200212,053675,臺股指元富96購02,0.31,0.35,0.31,0.35,+0.07,25.0,1313000,16,422920,0,0,0,0,0,0,1266000,47000,1219000,1219000
20200212,053676,新光金國泰98購02,0.46,0.46,0.46,0.46,0.00,0.00,117000,31,53820,0,0,0,0,0,0,117000,27000,90000,90000
20200212,053677,同欣電國泰97購01,2.15,2.40,2.09,2.40,+0.31,14.83,72000,26,162010,0,0,0,0,0,0,36000,36000,0,0
20200212,053678,南亞科富邦97購01,,,,,0.00,0.00,0,0,0,0,0,0,0,0,0,0,0,0,0
20200212,053679,緯創富邦96購01,,,,,0.00,0.00,0,0,0,0,0,0,0,0,0,0,0,0,0
20200212,05367P,鴻海元富95售13,2.42,2.42,2.42,2.42,-0.13,-5.1,10000,1,24200,0,0,0,0,0,0,0,10000,-10000,-10000
20200212,053680,臺股指富邦96購01,0.46,0.46,0.46,0.46,+0.02,4.55,1000,1,460,0,0,0,0,0,0,0,1000,-1000,-1000
20200212,053681,臺股指富邦96購02,0.31,0.35,0.31,0.35,+0.06,20.69,78000,4,27080,0,0,0,0,0,0,78000,0,78000,78000
20200212,053682,臺股指富邦96購03,,,,,0.00,0.00,0,0,0,0,0,0,0,0,0,0,0,0,0
20200212,053683,上証2X元大96購03,,,,,0.00,0.00,0,0,0,0,0,0,0,0,0,0,0,0,0
20200212,053684,台積電元大96購17,1.87,1.87,1.87,1.87,+0.12,6.86,161000,2,301070,0,0,0,0,0,0,161000,161000,0,0
20200212,053685,台積電元大96購18,1.52,1.55,1.52,1.55,+0.13,9.15,49000,3,74780,0,0,0,0,0,0,49000,49000,0,0
20200212,053686,台積電元大97購08,1.01,1.05,1.00,1.04,+0.07,7.22,253000,25,259340,0,0,0,0,0,0,154000,69000,85000,85000
20200212,053687,智邦元大96購02,2.22,2.30,2.02,2.08,-0.01,-0.48,243000,39,520320,0,0,0,0,0,0,175000,118000,57000,57000
20200212,053688,燿華元大96購05,1.09,1.26,1.09,1.22,+0.09,7.96,289000,34,351890,0,0,0,0,0,0,132000,268000,-136000,-136000
20200212,053689,台光電元大96購01,0.82,1.10,0.82,1.04,+0.21,25.3,298000,38,304160,0,0,0,0,0,0,84000,288000,-204000,-204000
20200212,05368P,可成元富95售03,,,,,0.00,0.00,0,0,0,0,0,0,0,0,0,0,0,0,0
20200212,053690,南亞科元大96購02,2.44,2.44,2.40,2.44,-0.05,-2.01,60000,3,144160,0,0,0,0,0,0,60000,3000,57000,57000
20200212,053691,聯發科元大96購16,0.48,0.50,0.48,0.50,+0.10,25.0,277000,8,135280,0,0,0,0,0,0,210000,67000,143000,143000
20200212,053692,聯詠元大96購04,1.43,1.60,1.43,1.48,+0.15,11.28,31000,4,45800,0,0,0,0,0,0,21000,10000,11000,11000
20200212,053693,欣興元大96購05,0.88,1.09,0.85,1.09,+0.24,28.24,543000,47,539490,0,0,0,0,0,0,280000,274000,6000,6000
20200212,053694,創意元大96購03,1.87,1.97,1.78,1.87,-0.20,-9.66,216000,16,408620,0,0,0,0,0,0,55000,181000,-126000,-126000
20200212,053695,智易元大97購02,0.45,0.51,0.45,0.50,+0.11,28.21,245000,4,124790,0,0,0,0,0,0,0,245000,-245000,-245000
20200212,053696,日月光元大96購05,0.69,0.78,0.69,0.77,+0.12,18.46,372000,13,275600,0,0,0,0,0,0,0,372000,-372000,-372000
20200212,053697,臻鼎元大96購02,1.04,1.22,0.90,0.90,+0.07,8.43,127000,15,132760,0,0,0,0,0,0,30000,97000,-67000,-67000
20200212,053698,中磊元大96購02,1.20,1.22,1.18,1.18,+0.01,0.85,23000,3,27600,0,0,0,0,0,0,2000,21000,-19000,-19000
20200212,053699,臺股指元大96購22,0.62,0.74,0.62,0.74,+0.15,25.42,554000,22,385340,0,0,0,0,0,0,474000,80000,394000,394000
20200212,05369P,可成元富95售04,,,,,0.00,0.00,0,0,0,0,0,0,0,0,0,0,0,0,0
20200212,053700,臺股指元大96購23,,,,,0.00,0.00,0,0,0,0,0,0,0,0,0,0,0,0,0
20200212,053701,台積電兆豐96購05,3.69,3.92,3.63,3.92,+0.32,8.89,308000,9,1153310,0,0,0,0,0,0,109000,199000,-90000,-90000
20200212,053702,智易兆豐97購02,,,,,0.00,0.00,0,0,0,0,0,0,0,0,0,0,0,0,0
20200212,053703,緯穎兆豐96購01,3.17,3.43,3.17,3.43,+0.28,8.89,15000,3,49420,0,0,0,0,0,0,7000,8000,-1000,-1000
20200212,053704,國巨群益96購06,,,,,0.00,0.00,0,0,0,0,0,0,0,0,0,0,0,0,0
20200212,053705,滬深2X凱基99購01,0.86,0.90,0.86,0.90,-0.01,-1.1,45000,5,40000,0,0,0,0,0,0,0,45000,-45000,-45000
20200212,053706,S&P反1凱基99購01,,,,,0.00,0.00,0,0,0,0,0,0,0,0,0,0,0,0,0
20200212,053707,A50正2凱基99購02,0.74,0.74,0.74,0.74,+0.07,10.45,7000,1,5180,0,0,0,0,0,0,7000,0,7000,7000
20200212,053708,道瓊反凱基98購01,,,,,0.00,0.00,0,0,0,0,0,0,0,0,0,0,0,0,0
20200212,053709,台達電凱基96購04,0.33,0.39,0.31,0.37,+0.01,2.78,127000,8,42130,0,0,0,0,0,0,30000,97000,-67000,-67000
20200212,05370P,矽創元富95售01,1.35,1.35,1.18,1.18,-0.24,-16.9,81000,22,102690,0,0,0,0,0,0,81000,0,81000,81000
20200212,053710,華通凱基96購05,0.73,1.16,0.73,1.06,+0.40,60.61,2216000,24,2179790,0,0,0,0,0,0,2141000,115000,2026000,2026000
20200212,053711,鴻海凱基96購14,,,,,0.00,0.00,0,0,0,0,0,0,0,0,0,0,0,0,0
20200212,053712,台光電凱基96購04,1.28,1.74,1.28,1.66,+0.39,30.71,72000,15,106490,0,0,0,0,0,0,41000,43000,-2000,-2000
20200212,053713,漢唐凱基96購04,1.46,1.51,1.44,1.50,+0.03,2.04,200000,13,300700,0,0,0,0,0,0,165000,53000,112000,112000
20200212,053714,南亞科凱基96購03,,,,,0.00,0.00,0,0,0,0,0,0,0,0,0,0,0,0,0
20200212,053715,美律凱基96購04,0.23,0.31,0.23,0.31,+0.10,47.62,163000,11,44490,0,0,0,0,0,0,121000,32000,89000,89000
20200212,053716,京元電凱基97購01,0.38,0.38,0.35,0.38,-0.01,-2.56,178000,22,65580,0,0,0,0,0,0,141000,37000,104000,104000
20200212,053717,聯發科凱基96購17,0.19,0.23,0.18,0.22,+0.06,37.5,2176000,31,466700,0,0,0,0,0,0,1434000,738000,696000,696000
20200212,053718,全新凱基97購02,1.35,1.72,1.35,1.72,+0.50,40.98,252000,13,377200,0,0,0,0,0,0,72000,180000,-108000,-108000
20200212,053719,可成凱基96購08,1.89,1.89,1.89,1.89,+0.09,5.0,20000,1,37800,0,0,0,0,0,0,20000,20000,0,0
20200212,05371P,臺股指中信95售10,0.79,0.79,0.75,0.75,-0.06,-7.41,62000,3,47500,0,0,0,0,0,0,32000,30000,2000,2000
20200212,053720,宏達電凱基97購01,0.53,0.53,0.53,0.53,0.00,0.00,5000,1,2650,0,0,0,0,0,0,5000,0,5000,5000
20200212,053721,國泰金凱基97購01,0.35,0.35,0.34,0.34,+0.03,9.68,210000,2,73400,0,0,0,0,0,0,10000,200000,-190000,-190000
20200212,053722,新光金凱基9C購01,0.69,0.71,0.68,0.71,+0.01,1.43,231000,38,158520,0,0,0,0,0,0,161000,70000,91000,91000
20200212,053723,奇鋐凱基98購01,,,,,0.00,0.00,0,0,0,0,0,0,0,0,0,0,0,0,0
20200212,053724,聯詠凱基96購04,1.29,1.30,1.26,1.30,+0.19,17.12,52000,3,65900,0,0,0,0,0,0,52000,2000,50000,50000
20200212,053725,晶相光凱基96購01,1.39,1.50,1.14,1.44,+0.07,5.11,104000,8,144020,0,0,0,0,0,0,94000,26000,68000,68000
20200212,053726,TPK凱基96購02,,,,,0.00,0.00,0,0,0,0,0,0,0,0,0,0,0,0,0
20200212,053727,麗豐凱基97購01,,,,,0.00,0.00,0,0,0,0,0,0,0,0,0,0,0,0,0
20200212,053728,茂林凱基97購01,5.45,5.45,5.45,5.45,+0.10,1.87,33000,6,179850,0,0,0,0,0,0,30000,3000,27000,27000
20200212,053729,聯茂凱基96購05,2.03,2.91,2.03,2.91,+1.19,69.19,166000,10,418040,0,0,0,0,0,0,110000,56000,54000,54000
20200212,053730,樺漢凱基98購01,0.81,0.85,0.81,0.85,+0.07,8.97,46000,2,38340,0,0,0,0,0,0,19000,27000,-8000,-8000
20200212,053731,矽創凱基96購03,0.39,0.46,0.39,0.46,+0.06,15.0,11000,2,4360,0,0,0,0,0,0,11000,0,11000,11000
20200212,053732,S&P反1中信9C購01,,,,,0.00,0.00,0,0,0,0,0,0,0,0,0,0,0,0,0
20200212,053733,華邦電中信98購01,0.27,0.27,0.27,0.27,0.00,0.00,150000,3,40500,0,0,0,0,0,0,0,150000,-150000,-150000
20200212,053734,友達中信98購02,1.61,1.61,1.49,1.49,-0.13,-8.02,582000,30,908080,0,0,0,0,0,0,237000,342000,-105000,-105000
20200212,053735,矽力中信97購01,1.41,1.52,1.34,1.52,+0.20,15.15,125000,11,174850,0,0,0,0,0,0,85000,40000,45000,45000
20200212,053736,友達麥證96購01,1.42,1.45,1.32,1.32,-0.13,-8.97,323000,37,439710,153000,170000,-17000,0,0,0,153000,170000,-17000,-17000
20200212,053737,華新科麥證96購01,3.63,3.64,3.46,3.54,+0.11,3.21,94000,13,335720,61000,33000,28000,0,0,0,61000,33000,28000,28000
20200212,053738,群創麥證96購01,0.84,0.84,0.84,0.84,+0.01,1.2,27000,2,22680,17000,10000,7000,0,0,0,17000,10000,7000,7000
20200212,053739,A50正2國票9A購01,1.06,1.06,1.05,1.05,+0.09,9.37,32000,2,33860,0,0,0,0,0,0,26000,6000,20000,20000
20200212,05373P,臺股指中信95售11,,,,,0.00,0.00,0,0,0,0,0,0,0,0,0,0,0,0,0
20200212,053740,元油反國票99購01,,,,,0.00,0.00,0,0,0,0,0,0,0,0,0,0,0,0,0
20200212,053741,漢唐國票97購03,3.70,3.70,3.70,3.70,0.00,0.00,54000,1,199800,0,0,0,0,0,0,0,54000,-54000,-54000
20200212,053742,創意國票97購01,3.08,3.44,2.97,3.31,-0.58,-14.91,90000,17,281270,0,0,0,0,0,0,58000,32000,26000,26000
20200212,053743,康控國票97購02,0.69,0.83,0.69,0.83,+0.13,18.57,218000,14,167870,0,0,0,0,0,0,38000,180000,-142000,-142000
20200212,053744,台郡國票97購03,1.61,1.80,1.61,1.80,+0.89,97.8,41000,12,72020,0,0,0,0,0,0,13000,12000,1000,1000
20200212,053745,康友國票97購01,3.92,4.16,3.89,4.13,+0.19,4.82,131000,14,524650,0,0,0,0,0,0,50000,81000,-31000,-31000
20200212,053746,彰銀康和96購01,1.23,1.23,1.23,1.23,+0.01,0.82,30000,2,36900,0,0,0,0,0,0,30000,0,30000,30000
20200212,053747,滬深2X永豐96購05,0.65,0.65,0.65,0.65,+0.08,14.04,10000,1,6500,0,0,0,0,0,0,0,10000,-10000,-10000
20200212,053748,燿華永豐96購04,0.98,1.14,0.98,1.13,+0.10,9.71,215000,16,235570,0,0,0,0,0,0,12000,203000,-191000,-191000
20200212,053749,揚明光永豐97購01,0.68,0.73,0.68,0.73,+0.06,8.96,59000,4,42330,0,0,0,0,0,0,49000,10000,39000,39000
20200212,05374P,台積電國票96售07,1.03,1.05,0.99,1.00,-0.10,-9.09,69000,11,70020,0,0,0,0,0,0,2000,62000,-60000,-60000
20200212,053750,致伸永豐96購02,0.50,0.50,0.49,0.50,+0.04,8.7,162000,5,80520,0,0,0,0,0,0,64000,98000,-34000,-34000
20200212,053751,康控永豐96購02,0.51,0.54,0.51,0.54,+0.06,12.5,152000,8,79720,0,0,0,0,0,0,0,152000,-152000,-152000
20200212,053752,超眾永豐96購02,0.65,0.71,0.63,0.71,+0.03,4.41,700000,39,467300,0,0,0,0,0,0,573000,111000,462000,462000
20200212,053753,啟碁永豐96購01,1.12,1.12,1.11,1.12,+0.04,3.7,42000,3,46970,0,0,0,0,0,0,21000,42000,-21000,-21000
20200212,053754,英業達元富96購02,1.25,1.25,1.23,1.23,-0.01,-0.81,42000,2,52300,0,0,0,0,0,0,42000,0,42000,42000
20200212,053755,亞光元富96購01,2.63,3.07,2.63,3.02,+0.49,19.37,321000,28,935860,0,0,0,0,0,0,52000,285000,-233000,-233000
20200212,053756,亞光元富96購02,0.95,1.00,0.95,1.00,0.00,0.00,206000,5,202950,0,0,0,0,0,0,0,206000,-206000,-206000
20200212,053757,聯發科國泰96購04,0.98,1.13,0.98,1.13,+0.28,32.94,49000,21,50220,0,0,0,0,0,0,49000,0,49000,49000
20200212,053758,華新科國泰97購02,,,,,0.00,0.00,0,0,0,0,0,0,0,0,0,0,0,0,0
20200212,053759,晶相光國泰98購01,1.51,1.63,1.51,1.54,+0.07,4.76,66000,10,102640,0,0,0,0,0,0,26000,40000,-14000,-14000
20200212,05375P,健策國票96售02,0.34,0.35,0.30,0.30,-0.06,-16.67,588000,7,190600,0,0,0,0,0,0,438000,150000,288000,288000
20200212,053760,牧德國泰98購01,,,,,0.00,0.00,0,0,0,0,0,0,0,0,0,0,0,0,0
20200212,053761,健策國泰98購01,1.48,1.64,1.43,1.64,+0.19,13.1,1365000,92,2084350,0,0,0,0,0,0,1113000,823000,290000,290000
20200212,053762,T50反1富邦97購01,,,,,0.00,0.00,0,0,0,0,0,0,0,0,0,0,0,0,0
20200212,053763,T50反1富邦98購01,0.80,0.80,0.77,0.77,-0.06,-7.23,10000,2,7850,0,0,0,0,0,0,0,10000,-10000,-10000
20200212,053764,A50正2富邦99購01,0.56,0.60,0.56,0.60,-0.03,-4.76,80000,3,47100,0,0,0,0,0,0,10000,70000,-60000,-60000
20200212,053765,智邦富邦96購01,0.77,0.77,0.72,0.72,0.00,0.00,21000,2,15670,0,0,0,0,0,0,11000,21000,-10000,-10000
20200212,053766,友達富邦97購01,0.90,0.93,0.81,0.83,-0.11,-11.7,791000,45,691170,0,5000,-5000,0,0,0,74000,467000,-393000,-398000
20200212,053767,臻鼎富邦97購02,0.32,0.32,0.23,0.23,0.00,0.00,78000,3,24720,0,0,0,0,0,0,75000,3000,72000,72000
20200212,053768,S&P反1元大99購01,0.40,0.40,0.40,0.40,0.00,0.00,290000,3,116000,0,0,0,0,0,0,0,290000,-290000,-290000
20200212,053769,香港反元大99購01,0.65,0.67,0.65,0.67,-0.02,-2.9,6000,2,3920,0,0,0,0,0,0,0,6000,-6000,-6000
20200212,05376P,聯發科日盛95售04,0.63,0.63,0.61,0.61,0.00,0.00,30000,2,18500,0,0,0,0,0,0,30000,0,30000,30000
20200212,053770,元金2X元大98購01,1.48,1.48,1.47,1.47,-0.03,-2.0,42000,3,62060,0,0,0,0,0,0,40000,2000,38000,38000
20200212,053771,華新元大97購01,0.86,0.89,0.84,0.89,+0.04,4.71,164000,14,141870,0,0,0,0,0,0,16000,148000,-132000,-132000
20200212,053772,大成鋼元大96購02,0.48,0.48,0.48,0.48,+0.02,4.35,48000,1,23040,0,0,0,0,0,0,0,48000,-48000,-48000
20200212,053773,上銀元大96購04,5.10,5.10,4.90,4.93,+0.10,2.07,164000,37,824660,0,0,0,0,0,0,145000,82000,63000,63000
20200212,053774,台達電元大96購04,1.31,1.37,1.31,1.37,+0.02,1.48,120000,6,158100,0,0,0,0,0,0,0,120000,-120000,-120000
20200212,053775,鴻海元大96購21,,,,,0.00,0.00,0,0,0,0,0,0,0,0,0,0,0,0,0
20200212,053776,台積電元大96購19,,,,,0.00,0.00,0,0,0,0,0,0,0,0,0,0,0,0,0
20200212,053777,台積電元大96購20,1.34,1.38,1.34,1.38,+0.09,6.98,242000,6,330300,0,0,0,0,0,0,242000,77000,165000,165000
20200212,053778,旺宏元大97購03,2.31,2.39,2.21,2.22,-0.07,-3.06,183000,17,423500,0,0,0,0,0,0,179000,130000,49000,49000
20200212,053779,台光電元大96購02,0.64,0.85,0.64,0.83,+0.18,27.69,485000,21,355690,0,0,0,0,0,0,70000,400000,-330000,-330000
20200212,05377P,鴻海凱基95售18,1.15,1.15,1.15,1.15,0.00,0.00,60000,2,69000,0,0,0,0,0,0,50000,60000,-10000,-10000
20200212,053780,南亞科元大96購03,3.24,3.24,3.15,3.23,-0.05,-1.52,29000,9,92830,0,0,0,0,0,0,29000,16000,13000,13000
20200212,053781,友達元大9B購03,1.88,1.88,1.76,1.76,-0.12,-6.38,107000,14,196300,0,0,0,0,0,0,81000,26000,55000,55000
20200212,053782,京元電元大98購02,1.30,1.41,1.24,1.37,+0.05,3.79,229000,8,296150,0,0,0,0,0,0,218000,11000,207000,207000
20200212,053783,聯發科元大96購17,1.20,1.33,1.19,1.33,+0.28,26.67,62000,8,78500,0,0,0,0,0,0,52000,22000,30000,30000
20200212,053784,奇力新元大97購02,3.41,3.41,3.30,3.41,0.00,0.00,29000,4,98670,0,0,0,0,0,0,29000,0,29000,29000
20200212,053785,聯詠元大96購05,0.93,1.03,0.93,1.00,+0.14,16.28,198000,11,198870,0,0,0,0,0,0,132000,161000,-29000,-29000
20200212,053786,新日興元大96購02,2.90,2.90,2.70,2.70,-0.17,-5.92,100000,4,272100,0,0,0,0,0,0,100000,0,100000,100000
20200212,053787,健策元大97購02,2.42,2.54,2.29,2.54,+0.29,12.89,756000,72,1813610,0,0,0,0,0,0,671000,585000,86000,86000
20200212,053788,泰鼎元大97購01,2.51,2.64,2.43,2.43,+0.14,6.11,151000,27,381130,0,0,0,0,0,0,59000,143000,-84000,-84000
20200212,053789,彩晶元大9C購02,0.84,0.84,0.84,0.84,0.00,0.00,100000,2,84000,0,0,0,0,0,0,100000,0,100000,100000
20200212,05378P,台積電凱基96售02,,,,,0.00,0.00,0,0,0,0,0,0,0,0,0,0,0,0,0
20200212,053790,嘉聯益元大99購02,0.70,0.70,0.67,0.67,+0.03,4.69,120000,2,83400,0,0,0,0,0,0,20000,100000,-80000,-80000
20200212,053791,同欣電元大96購05,2.48,2.83,2.48,2.75,+0.44,19.05,31000,12,85230,0,0,0,0,0,0,22000,31000,-9000,-9000
20200212,053792,百和元大96購01,1.47,1.48,1.46,1.47,-0.01,-0.68,34000,4,49980,0,0,0,0,0,0,34000,0,34000,34000
20200212,053793,致伸兆豐96購01,,,,,0.00,0.00,0,0,0,0,0,0,0,0,0,0,0,0,0
20200212,053794,燿華亞東96購01,,,,,0.00,0.00,0,0,0,0,0,0,0,0,0,0,0,0,0
20200212,053795,群創亞東96購01,1.04,1.04,1.03,1.03,0.00,0.00,61000,4,62940,0,0,0,0,0,0,0,61000,-61000,-61000
20200212,053796,華通中信96購02,,,,,0.00,0.00,0,0,0,0,0,0,0,0,0,0,0,0,0
20200212,053797,台積電中信98購01,0.78,0.81,0.78,0.81,+0.06,8.0,156000,7,125350,0,0,0,0,0,0,123000,33000,90000,90000
20200212,053798,台積電中信98購02,0.67,0.69,0.66,0.69,+0.06,9.52,784000,12,526560,0,0,0,0,0,0,784000,0,784000,784000
20200212,053799,矽創中信9A購01,0.44,0.53,0.43,0.53,+0.08,17.78,524000,33,252080,0,0,0,0,0,0,134000,370000,-236000,-236000
20200212,05379P,可成凱基95售11,1.32,1.32,1.26,1.26,0.00,0.00,38000,3,49480,0,0,0,0,0,0,0,38000,-38000,-38000
20200212,053800,華通凱基97購03,0.94,1.32,0.94,1.24,0.00,0.00,85000,15,102460,0,0,0,0,0,0,53000,85000,-32000,-32000
20200212,053801,台積電凱基96購18,2.37,2.48,2.37,2.48,+0.23,10.22,41000,3,100080,0,0,0,0,0,0,31000,10000,21000,21000
20200212,053802,南亞科凱基96購04,1.48,1.48,1.43,1.43,0.00,0.00,31000,3,45750,0,0,0,0,0,0,31000,30000,1000,1000
20200212,053803,聯發科凱基96購18,0.14,0.14,0.14,0.14,0.00,0.00,210000,2,29400,0,0,0,0,0,0,210000,0,210000,210000
20200212,053804,富邦金凱基96購01,1.08,1.13,1.08,1.11,+0.15,15.62,53000,4,58130,0,0,0,0,0,0,40000,13000,27000,27000
20200212,053805,奇鋐凱基98購02,0.23,0.25,0.23,0.25,+0.01,4.17,25000,2,5950,0,0,0,0,0,0,25000,0,25000,25000
20200212,053806,鎧勝凱基96購02,0.62,0.62,0.62,0.62,0.00,0.00,9000,1,5580,0,0,0,0,0,0,9000,0,9000,9000
20200212,053807,T50反1群益96購02,0.77,0.77,0.74,0.74,0.00,0.00,35000,2,26800,0,0,0,0,0,0,0,35000,-35000,-35000
20200212,053808,大成鋼群益97購01,0.90,0.97,0.90,0.97,+0.02,2.11,60000,4,55680,0,0,0,0,0,0,26000,24000,2000,2000
20200212,053809,上銀群益96購02,2.89,2.89,2.84,2.84,+0.03,1.07,41000,8,117380,0,0,0,0,0,0,21000,41000,-20000,-20000
20200212,05380P,鴻海群益95售11,4.80,4.80,4.80,4.80,0.00,0.00,10000,1,48000,0,0,0,0,0,0,0,10000,-10000,-10000
20200212,053810,台達電群益96購01,1.31,1.44,1.25,1.39,+0.06,4.51,61000,6,80860,0,0,0,0,0,0,41000,30000,11000,11000
20200212,053811,國巨群益98購02,8.55,9.00,8.55,9.00,+0.60,7.14,5000,2,43650,0,0,0,0,0,0,3000,0,3000,3000
20200212,053812,台積電群益96購09,1.09,1.10,1.09,1.10,+0.07,6.8,460000,4,504380,0,0,0,0,0,0,162000,298000,-136000,-136000
20200212,053813,友達群益9A購03,1.63,1.63,1.49,1.54,-0.10,-6.1,1205000,63,1872410,0,0,0,0,0,0,401000,794000,-393000,-393000
20200212,053814,美律群益97購02,0.59,0.73,0.59,0.69,+0.16,30.19,340000,39,224500,0,0,0,0,0,0,12000,338000,-326000,-326000
20200212,053815,聯發科群益96購01,0.52,0.60,0.52,0.58,+0.13,28.89,207000,4,115560,0,0,0,0,0,0,98000,109000,-11000,-11000
20200212,053816,聯發科群益96購02,,,,,0.00,0.00,0,0,0,0,0,0,0,0,0,0,0,0,0
20200212,053817,華新科群益97購02,,,,,0.00,0.00,0,0,0,0,0,0,0,0,0,0,0,0,0
20200212,053818,富邦金群益98購01,2.32,2.35,2.31,2.35,+0.17,7.8,84000,8,196480,0,0,0,0,0,0,30000,54000,-24000,-24000
20200212,053819,大立光群益96購04,1.37,1.43,1.37,1.43,+0.25,21.19,350000,5,488360,0,0,0,0,0,0,2000,348000,-346000,-346000
20200212,05381P,聯詠群益95售02,1.55,1.60,1.55,1.57,-0.24,-13.26,52000,6,81820,0,0,0,0,0,0,0,52000,-52000,-52000
20200212,053820,大立光群益96購05,0.30,0.38,0.30,0.38,+0.10,35.71,540000,18,179750,0,0,0,0,0,0,359000,140000,219000,219000
20200212,053821,群創群益98購08,,,,,0.00,0.00,0,0,0,0,0,0,0,0,0,0,0,0,0
20200212,053822,正文群益97購01,,,,,0.00,0.00,0,0,0,0,0,0,0,0,0,0,0,0,0
20200212,053823,茂林群益96購06,,,,,0.00,0.00,0,0,0,0,0,0,0,0,0,0,0,0,0
20200212,053824,樺漢群益96購02,0.96,0.96,0.94,0.94,+0.10,11.9,46000,4,43960,0,0,0,0,0,0,0,46000,-46000,-46000
20200212,053825,南電群益96購02,0.78,0.99,0.77,0.96,+0.18,23.08,1236000,70,1128890,0,0,0,0,0,0,997000,427000,570000,570000
20200212,053826,光磊麥證97購01,0.46,0.46,0.45,0.45,-0.01,-2.17,39000,10,17930,39000,0,39000,0,0,0,39000,0,39000,39000
20200212,053827,漢唐麥證9A購01,1.10,1.14,1.07,1.13,+0.03,2.73,163000,12,179340,151000,5000,146000,0,0,0,151000,5000,146000,146000
20200212,053828,貿聯麥證96購01,0.60,0.69,0.60,0.68,+0.04,6.25,65000,16,41610,10000,55000,-45000,0,0,0,10000,55000,-45000,-45000
20200212,053829,力成麥證96購01,1.30,1.42,1.22,1.40,+0.25,21.74,223000,53,297090,20000,202000,-182000,0,0,0,20000,202000,-182000,-182000
20200212,05382P,電子類群益95售02,1.74,1.74,1.59,1.59,-0.31,-16.32,25000,6,41740,0,0,0,0,0,0,8000,17000,-9000,-9000
20200212,053830,台積電台新96購02,0.82,0.86,0.82,0.86,+0.10,13.16,75000,4,64100,0,0,0,0,0,0,65000,10000,55000,55000
20200212,053831,台積電台新97購02,,,,,0.00,0.00,0,0,0,0,0,0,0,0,0,0,0,0,0
20200212,053832,聯發科台新96購01,0.36,0.36,0.36,0.36,+0.11,44.0,10000,1,3600,0,0,0,0,0,0,10000,0,10000,10000
20200212,053833,彩晶台新97購02,0.49,0.49,0.49,0.49,0.00,0.00,5000,1,2450,0,0,0,0,0,0,0,5000,-5000,-5000
20200212,053834,卜蜂永豐96購01,0.84,0.84,0.84,0.84,0.00,0.00,68000,1,57120,0,0,0,0,0,0,0,68000,-68000,-68000
20200212,053835,南亞科永豐96購02,0.86,0.86,0.86,0.86,0.00,0.00,68000,1,58480,0,0,0,0,0,0,0,68000,-68000,-68000
20200212,053836,亞光永豐96購02,1.57,1.81,1.56,1.78,+0.24,15.58,185000,29,317450,0,0,0,0,0,0,56000,157000,-101000,-101000
20200212,053837,貿聯永豐96購02,1.06,1.19,1.06,1.19,+0.14,13.33,341000,17,384270,0,0,0,0,0,0,10000,341000,-331000,-331000
20200212,053838,正文永豐96購02,,,,,0.00,0.00,0,0,0,0,0,0,0,0,0,0,0,0,0
20200212,053839,華通統一96購01,0.64,0.92,0.64,0.90,+0.29,47.54,528000,18,432470,0,0,0,0,0,0,1000,527000,-526000,-526000
20200212,05383P,鴻海富邦95售06,1.51,1.51,1.34,1.34,-0.28,-17.28,150000,7,213800,0,0,0,0,0,0,0,150000,-150000,-150000
20200212,053840,燿華統一96購02,1.18,1.32,1.18,1.32,+0.18,15.79,176000,13,225430,0,0,0,0,0,0,0,176000,-176000,-176000
20200212,053841,美律統一96購01,0.72,0.85,0.70,0.82,+0.17,26.15,537000,51,414500,0,0,0,0,0,0,529000,0,529000,529000
20200212,053842,聯發科統一96購08,0.56,0.56,0.56,0.56,0.00,0.00,48000,1,26880,0,0,0,0,0,0,0,48000,-48000,-48000
20200212,053843,訊芯統一96購01,1.06,1.25,1.06,1.25,+0.19,17.92,471000,15,533210,0,0,0,0,0,0,190000,281000,-91000,-91000
20200212,053844,GIS統一96購01,0.61,0.65,0.61,0.65,+0.05,8.33,333000,14,209930,0,0,0,0,0,0,129000,210000,-81000,-81000
20200212,053845,和大元富96購01,0.78,0.80,0.78,0.80,-0.03,-3.61,20000,2,15800,0,0,0,0,0,0,20000,0,20000,20000
20200212,053846,友達元富99購02,1.77,1.77,1.64,1.64,-0.16,-8.89,439000,16,726560,0,0,0,0,0,0,19000,410000,-391000,-391000
20200212,053847,美律元富96購02,0.82,0.94,0.82,0.94,+0.17,22.08,202000,22,184530,0,0,0,0,0,0,10000,194000,-184000,-184000
20200212,053848,聯發科元富96購03,0.51,0.51,0.48,0.48,+0.07,17.07,45000,2,22500,0,0,0,0,0,0,45000,0,45000,45000
20200212,053849,聯發科元富96購04,,,,,0.00,0.00,0,0,0,0,0,0,0,0,0,0,0,0,0
20200212,05384P,大立光永豐95售02,,,,,0.00,0.00,0,0,0,0,0,0,0,0,0,0,0,0,0
20200212,053850,嘉澤元富96購03,1.90,1.92,1.70,1.70,-0.08,-4.49,201000,16,359530,0,0,0,0,0,0,51000,150000,-99000,-99000
20200212,053851,鴻海國泰98購03,0.52,0.61,0.52,0.61,+0.13,27.08,421000,6,236910,0,0,0,0,0,0,145000,276000,-131000,-131000
20200212,053852,南亞科國泰98購01,1.38,1.41,1.38,1.40,-0.07,-4.76,56000,7,78310,0,0,0,0,0,0,35000,16000,19000,19000
20200212,053853,康控國泰97購02,0.51,0.57,0.51,0.55,+0.07,14.58,180000,21,98180,0,0,0,0,0,0,80000,100000,-20000,-20000
20200212,053854,聯茂國泰97購02,2.41,3.19,2.41,3.01,+0.83,38.07,261000,40,749940,0,0,0,0,0,0,32000,241000,-209000,-209000
20200212,053855,康友國泰98購01,2.05,2.18,2.05,2.11,+0.02,0.96,856000,69,1829610,0,0,0,0,0,0,613000,115000,498000,498000
20200212,053856,台積電富邦98購01,0.20,0.22,0.19,0.20,+0.01,5.26,6336000,110,1294310,0,0,0,0,0,0,3289000,1276000,2013000,2013000
20200212,053857,宏達電富邦97購02,0.18,0.20,0.18,0.20,0.00,0.00,102000,3,18390,0,0,0,0,0,0,100000,1000,99000,99000
20200212,053858,台達電元大96購05,0.98,1.05,0.98,1.05,+0.08,8.25,252000,10,249300,0,0,0,0,0,0,122000,130000,-8000,-8000
20200212,053859,台積電元大97購09,2.40,2.47,2.37,2.47,+0.17,7.39,209000,8,505090,0,0,0,0,0,0,109000,159000,-50000,-50000
20200212,053860,台積電元大98購03,1.20,1.25,1.19,1.24,+0.07,5.98,594000,52,719010,0,0,0,0,0,0,340000,226000,114000,114000
20200212,053861,台光電元大98購01,1.33,1.67,1.33,1.64,+0.33,25.19,260000,33,408420,0,0,0,0,0,0,34000,241000,-207000,-207000
20200212,053862,南亞科元大97購02,1.58,1.58,1.54,1.54,-0.05,-3.14,218000,11,337860,0,0,0,0,0,0,80000,138000,-58000,-58000
20200212,053863,聯發科元大96購18,0.28,0.32,0.28,0.32,+0.08,33.33,282000,13,85790,0,0,0,0,0,0,207000,75000,132000,132000
20200212,053864,義隆元大96購01,1.41,1.47,1.32,1.41,+0.20,16.53,183000,20,255200,0,0,0,0,0,0,140000,100000,40000,40000
20200212,053865,欣興元大97購02,1.54,1.93,1.54,1.91,+0.35,22.44,500000,40,893800,0,0,0,0,0,0,105000,469000,-364000,-364000
20200212,053866,景碩元大97購02,1.94,2.35,1.81,2.13,+0.26,13.9,379000,50,775760,0,0,0,0,0,0,216000,279000,-63000,-63000
20200212,053867,創意元大96購04,2.81,2.97,2.69,2.90,-0.26,-8.23,218000,17,612790,0,0,0,0,0,0,133000,155000,-22000,-22000
20200212,053868,群創元大99購02,,,,,0.00,0.00,0,0,0,0,0,0,0,0,0,0,0,0,0
20200212,053869,嘉澤元大96購02,2.33,2.33,2.33,2.33,0.00,0.00,5000,1,11650,0,0,0,0,0,0,5000,5000,0,0
20200212,05386P,臺股指永豐95售05,,,,,0.00,0.00,0,0,0,0,0,0,0,0,0,0,0,0,0
20200212,053870,正文元大96購01,0.88,0.88,0.88,0.88,-0.01,-1.12,100000,3,88000,0,0,0,0,0,0,100000,0,100000,100000
20200212,053871,臻鼎元大96購03,1.40,1.46,1.26,1.26,+0.28,28.57,56000,7,77850,0,0,0,0,0,0,17000,44000,-27000,-27000
20200212,053872,臻鼎元大96購04,1.23,1.34,1.23,1.34,+0.51,61.45,23000,6,28990,0,0,0,0,0,0,20000,8000,12000,12000
20200212,053873,力成元大96購03,2.25,2.53,2.20,2.53,+0.56,28.43,178000,17,418370,0,0,0,0,0,0,84000,96000,-12000,-12000
20200212,053874,台表科元大96購05,0.81,0.89,0.79,0.89,+0.10,12.66,53000,6,42970,0,0,0,0,0,0,50000,3000,47000,47000
20200212,053875,GIS元大97購01,1.20,1.29,1.20,1.29,+0.06,4.88,43000,2,52050,0,0,0,0,0,0,43000,0,43000,43000
20200212,053876,可成永昌98購01,1.93,2.09,1.87,2.09,+0.30,16.76,640000,23,1236740,0,0,0,0,0,0,291000,504000,-213000,-213000
20200212,053877,奇力新亞東96購01,3.87,3.87,3.80,3.80,-0.05,-1.3,18000,4,68890,0,0,0,0,0,0,18000,0,18000,18000
20200212,053878,台表科亞東96購01,,,,,0.00,0.00,0,0,0,0,0,0,0,0,0,0,0,0,0
20200212,053879,元油反中信98購02,,,,,0.00,0.00,0,0,0,0,0,0,0,0,0,0,0,0,0
20200212,05387P,鴻海元大95售21,2.83,2.87,2.62,2.63,-0.35,-11.74,167000,5,452290,0,0,0,0,0,0,165000,124000,41000,41000
20200212,053880,智邦中信96購01,1.42,1.49,1.36,1.36,+0.12,9.68,99000,16,140390,0,0,0,0,0,0,39000,60000,-21000,-21000
20200212,053881,南亞科中信97購01,,,,,0.00,0.00,0,0,0,0,0,0,0,0,0,0,0,0,0
20200212,053882,聯發科中信98購02,0.15,0.16,0.15,0.16,+0.04,33.33,382000,14,60440,0,0,0,0,0,0,127000,245000,-118000,-118000
20200212,053883,大立光中信98購02,0.43,0.43,0.43,0.43,+0.05,13.16,52000,2,22360,0,0,0,0,0,0,52000,0,52000,52000
20200212,053884,緯穎第一96購01,1.09,1.20,1.06,1.20,+0.06,5.26,334000,34,366660,0,0,0,0,0,0,249000,85000,164000,164000
20200212,053885,全新兆豐96購01,0.50,0.63,0.49,0.61,+0.16,35.56,587000,50,324810,0,0,0,0,0,0,502000,48000,454000,454000
20200212,053886,亞光兆豐96購01,1.72,2.02,1.72,2.00,+0.29,16.96,383000,28,724640,0,0,0,0,0,0,66000,317000,-251000,-251000
20200212,053887,聯茂兆豐97購02,0.90,1.13,0.90,1.02,+0.21,25.93,2105000,68,2181960,0,0,0,0,0,0,1011000,971000,40000,40000
20200212,053888,和大群益97購01,1.43,1.49,1.40,1.49,+0.02,1.36,254000,17,363700,0,0,0,0,0,0,24000,230000,-206000,-206000
20200212,053889,致茂群益97購01,2.94,3.30,2.94,3.27,+0.60,22.47,344000,40,1052200,0,0,0,0,0,0,95000,249000,-154000,-154000
20200212,05388P,南亞科元大95售04,,,,,0.00,0.00,0,0,0,0,0,0,0,0,0,0,0,0,0
20200212,053890,華新科群益98購01,2.30,2.30,2.30,2.30,-0.04,-1.71,30000,1,69000,0,0,0,0,0,0,0,0,0,0
20200212,053891,欣興群益98購01,1.27,1.33,1.27,1.33,+0.33,33.0,7000,3,9230,0,0,0,0,0,0,7000,0,7000,7000
20200212,053892,景碩群益96購02,0.85,1.18,0.85,1.06,+0.22,26.19,269000,52,262260,0,0,0,0,0,0,86000,223000,-137000,-137000
20200212,053893,京鼎群益97購02,1.37,1.54,1.37,1.54,+0.32,26.23,236000,20,339600,0,0,0,0,0,0,0,236000,-236000,-236000
20200212,053894,創意群益96購01,2.73,2.96,2.62,2.88,-0.28,-8.86,621000,59,1701470,0,0,0,0,0,0,444000,337000,107000,107000
20200212,053895,智易群益96購02,0.45,0.58,0.45,0.55,0.00,0.00,158000,27,83480,0,0,0,0,0,0,0,158000,-158000,-158000
20200212,053896,麗豐群益97購01,1.27,1.39,1.24,1.35,-0.01,-0.74,536000,21,690670,0,0,0,0,0,0,471000,65000,406000,406000
20200212,053897,台郡群益96購01,0.91,1.00,0.82,1.00,+0.56,127.27,356000,56,318350,0,0,0,0,0,0,200000,112000,88000,88000
20200212,053898,康友群益97購01,3.19,3.31,3.19,3.31,+0.31,10.33,24000,6,78760,0,0,0,0,0,0,10000,24000,-14000,-14000
20200212,053899,矽創群益96購02,0.63,0.76,0.63,0.76,+0.19,33.33,361000,17,270660,0,0,0,0,0,0,3000,358000,-355000,-355000
20200212,053900,T50反1日盛99購01,0.40,0.40,0.40,0.40,0.00,0.00,30000,1,12000,0,0,0,0,0,0,0,30000,-30000,-30000
20200212,053901,T50反1凱基99購03,1.03,1.03,1.01,1.01,-0.03,-2.88,155000,3,158110,0,0,0,0,0,0,78000,77000,1000,1000
20200212,053902,S&P反1凱基97購01,0.26,0.26,0.26,0.26,0.00,0.00,180000,2,46800,0,0,0,0,0,0,180000,180000,0,0
20200212,053903,燿華凱基97購01,,,,,0.00,0.00,0,0,0,0,0,0,0,0,0,0,0,0,0
20200212,053904,漢唐凱基97購01,1.15,1.15,1.15,1.15,+0.10,9.52,116000,3,133400,0,0,0,0,0,0,116000,0,116000,116000
20200212,053905,華新科凱基96購10,5.80,5.85,5.80,5.85,+0.35,6.36,7000,3,40700,0,0,0,0,0,0,7000,7000,0,0
20200212,053906,宏達電凱基96購02,0.20,0.20,0.20,0.20,+0.03,17.65,1000,1,200,0,0,0,0,0,0,0,1000,-1000,-1000
20200212,053907,揚明光凱基96購01,,,,,0.00,0.00,0,0,0,0,0,0,0,0,0,0,0,0,0
20200212,053908,貿聯凱基98購01,0.53,0.53,0.52,0.52,+0.05,10.64,71000,4,36930,0,0,0,0,0,0,10000,61000,-51000,-51000
20200212,053909,致伸凱基97購01,,,,,0.00,0.00,0,0,0,0,0,0,0,0,0,0,0,0,0
20200212,05390P,康友群益95售04,,,,,0.00,0.00,0,0,0,0,0,0,0,0,0,0,0,0,0
20200212,053910,嘉聯益凱基98購01,0.59,0.65,0.59,0.64,+0.05,8.47,213000,5,133410,0,0,0,0,0,0,161000,52000,109000,109000
20200212,053911,臺股指凱基96購31,0.53,0.62,0.53,0.61,+0.09,17.31,162000,7,89500,0,0,0,0,0,0,160000,2000,158000,158000
20200212,053912,T50反1國票97購02,0.90,0.90,0.83,0.83,-0.08,-8.79,258000,14,223740,0,0,0,0,0,0,23000,235000,-212000,-212000
20200212,053913,華新國票97購01,1.04,1.05,1.03,1.04,+0.04,4.0,64000,5,66800,0,0,0,0,0,0,10000,54000,-44000,-44000
20200212,053914,國巨國票96購08,5.80,6.10,5.50,6.10,+0.80,15.09,39000,6,224850,0,0,0,0,0,0,37000,2000,35000,35000
20200212,053915,光罩國票96購02,0.56,0.57,0.55,0.57,+0.04,7.55,165000,4,93150,0,0,0,0,0,0,5000,160000,-155000,-155000
20200212,053916,漢唐國票97購04,3.89,4.02,3.89,3.92,+0.01,0.26,46000,8,182010,0,0,0,0,0,0,22000,24000,-2000,-2000
20200212,053917,友達國票97購03,1.27,1.27,1.21,1.25,-0.12,-8.76,153000,9,190000,0,0,0,0,0,0,33000,113000,-80000,-80000
20200212,053918,美律國票97購01,0.95,1.18,0.95,1.18,+0.27,29.67,193000,32,205010,0,0,0,0,0,0,60000,133000,-73000,-73000
20200212,053919,可成國票97購02,2.07,2.29,1.99,2.29,+0.38,19.9,239000,17,508910,50000,0,50000,0,0,0,62000,177000,-115000,-65000
20200212,05391P,鴻海統一95售12,,,,,0.00,0.00,0,0,0,0,0,0,0,0,0,0,0,0,0
20200212,053920,新光金國票98購01,0.45,0.45,0.44,0.45,-0.01,-2.17,66000,14,29690,0,0,0,0,0,0,66000,0,66000,66000
20200212,053921,嘉晶國票97購03,1.41,1.52,1.41,1.52,0.00,0.00,56000,8,81560,0,0,0,0,0,0,0,56000,-56000,-56000
20200212,053922,亞光國票96購01,1.65,1.91,1.65,1.88,+0.30,18.99,104000,14,194020,0,0,0,0,0,0,26000,93000,-67000,-67000
20200212,053923,亞光國票97購01,2.68,2.87,2.68,2.84,+0.54,23.48,75000,8,206050,0,0,0,0,0,0,24000,51000,-27000,-27000
20200212,053924,京鼎國票97購01,1.28,1.36,1.28,1.36,0.00,0.00,91000,2,118960,0,0,0,0,0,0,0,91000,-91000,-91000
20200212,053925,群創國票98購01,0.86,0.86,0.85,0.86,+0.01,1.18,275000,6,235500,0,0,0,0,0,0,130000,135000,-5000,-5000
20200212,053926,晶相光國票97購01,1.52,1.61,1.52,1.52,+0.07,4.83,159000,8,243120,0,0,0,0,0,0,0,159000,-159000,-159000
20200212,053927,牧德國票97購01,7.45,7.70,7.35,7.70,+0.40,5.48,25000,9,187750,0,0,0,0,0,0,14000,11000,3000,3000
20200212,053928,智易國票97購03,1.64,1.66,1.64,1.66,0.00,0.00,109000,3,179960,0,0,0,0,0,0,0,109000,-109000,-109000
20200212,053929,正文國票97購01,,,,,0.00,0.00,0,0,0,0,0,0,0,0,0,0,0,0,0
20200212,05392P,鴻海統一95售13,4.80,4.80,4.80,4.80,0.00,0.00,1000,1,4800,0,0,0,0,0,0,0,1000,-1000,-1000
20200212,053930,S&P反1統一98購01,,,,,0.00,0.00,0,0,0,0,0,0,0,0,0,0,0,0,0
20200212,053931,楠梓電統一96購01,0.49,0.56,0.48,0.56,+0.07,14.29,152000,21,80470,0,0,0,0,0,0,32000,120000,-88000,-88000
20200212,053932,華新科統一96購03,,,,,0.00,0.00,0,0,0,0,0,0,0,0,0,0,0,0,0
20200212,053933,大立光統一96購06,0.72,0.90,0.72,0.90,+0.18,25.0,121000,3,90870,0,0,0,0,0,0,100000,21000,79000,79000
20200212,053934,A50正2元富96購02,0.34,0.36,0.34,0.36,0.00,0.00,220000,5,76700,0,0,0,0,0,0,50000,170000,-120000,-120000
20200212,053935,華通元富96購02,0.41,0.69,0.41,0.65,+0.24,58.54,437000,26,245780,0,0,0,0,0,0,103000,334000,-231000,-231000
20200212,053936,旺宏元富96購04,1.10,1.12,1.09,1.09,-0.01,-0.91,103000,6,114600,0,0,0,0,0,0,21000,82000,-61000,-61000
20200212,053937,光磊元富96購01,0.71,0.71,0.69,0.69,-0.02,-2.82,52000,9,36900,0,0,0,0,0,0,52000,0,52000,52000
20200212,053938,彩晶元富96購01,,,,,0.00,0.00,0,0,0,0,0,0,0,0,0,0,0,0,0
20200212,053939,台表科元富96購03,0.45,0.45,0.45,0.45,0.00,0.00,10000,1,4500,0,0,0,0,0,0,10000,0,10000,10000
20200212,05393P,鴻海統一95售14,3.86,3.86,3.39,3.39,-0.61,-15.25,137000,11,510500,0,0,0,0,0,0,59000,78000,-19000,-19000
20200212,053940,康友元富96購01,2.07,2.16,2.07,2.07,0.00,0.00,229000,20,488230,0,0,0,0,0,0,127000,199000,-72000,-72000
20200212,053941,國巨國泰96購05,3.96,4.10,3.89,3.96,+0.26,7.03,292000,37,1156810,0,0,0,0,0,0,270000,22000,248000,248000
20200212,053942,超眾國泰96購02,0.91,1.11,0.91,1.09,+0.09,9.0,454000,57,457740,0,0,0,0,0,0,296000,220000,76000,76000
20200212,053943,元油反富邦97購03,,,,,0.00,0.00,0,0,0,0,0,0,0,0,0,0,0,0,0
20200212,053944,亞泥富邦97購01,0.58,0.58,0.58,0.58,+0.02,3.57,40000,1,23200,0,0,0,0,0,0,0,40000,-40000,-40000
20200212,053945,國巨富邦98購02,1.77,1.87,1.72,1.87,+0.17,10.0,1587000,131,2872940,55000,0,55000,0,0,0,632000,836000,-204000,-149000
20200212,053946,全新富邦97購02,0.39,0.47,0.38,0.45,+0.09,25.0,1367000,33,587990,0,0,0,0,0,0,864000,503000,361000,361000
20200212,053947,義隆富邦97購01,0.89,0.90,0.83,0.88,+0.12,15.79,219000,25,188730,0,0,0,0,0,0,90000,119000,-29000,-29000
20200212,053948,大立光富邦99購04,0.52,0.54,0.51,0.54,+0.08,17.39,257000,18,134840,0,0,0,0,0,0,191000,172000,19000,19000
20200212,053949,康控富邦9A購01,0.28,0.29,0.28,0.28,+0.01,3.7,2904000,13,826860,0,0,0,0,0,0,2902000,2000,2900000,2900000
20200212,05394P,聯詠中信95售02,,,,,0.00,0.00,0,0,0,0,0,0,0,0,0,0,0,0,0
20200212,053950,緯穎富邦97購02,1.39,1.51,1.30,1.51,+0.15,11.03,162000,36,220680,0,0,0,0,0,0,149000,13000,136000,136000
20200212,053951,T50反1台新06購02,0.64,0.64,0.62,0.63,-0.03,-4.55,153000,12,96520,0,0,0,0,0,0,0,83000,-83000,-83000
20200212,053952,南亞科台新96購01,0.95,0.96,0.95,0.96,-0.06,-5.88,54000,2,51460,0,0,0,0,0,0,16000,38000,-22000,-22000
20200212,053953,群創台新97購01,,,,,0.00,0.00,0,0,0,0,0,0,0,0,0,0,0,0,0
20200212,053954,貿聯康和96購01,0.76,0.76,0.76,0.76,+0.02,2.7,10000,1,7600,0,0,0,0,0,0,0,10000,-10000,-10000
20200212,053955,華通永豐96購04,0.62,0.66,0.62,0.66,+0.32,94.12,172000,10,111260,0,0,0,0,0,0,0,172000,-172000,-172000
20200212,053956,旺宏永豐96購04,1.29,1.36,1.25,1.25,-0.06,-4.58,68000,9,89870,0,0,0,0,0,0,32000,47000,-15000,-15000
20200212,053957,瑞昱永豐96購01,1.00,1.00,0.97,0.97,+0.15,18.29,43000,5,42850,0,0,0,0,0,0,20000,43000,-23000,-23000
20200212,053958,京元電永豐96購01,0.34,0.34,0.32,0.34,-0.03,-8.11,323000,30,109290,0,0,0,0,0,0,311000,0,311000,311000
20200212,053959,晶豪科永豐96購02,,,,,0.00,0.00,0,0,0,0,0,0,0,0,0,0,0,0,0
20200212,05395P,旺宏元大96售06,,,,,0.00,0.00,0,0,0,0,0,0,0,0,0,0,0,0,0
20200212,053960,晶技永豐96購02,,,,,0.00,0.00,0,0,0,0,0,0,0,0,0,0,0,0,0
20200212,053961,揚明光永豐96購04,0.87,0.92,0.86,0.92,+0.08,9.52,199000,4,175750,0,0,0,0,0,0,60000,139000,-79000,-79000
20200212,053962,聯茂永豐96購01,0.75,0.97,0.75,0.96,+0.26,37.14,495000,17,431240,0,0,0,0,0,0,174000,321000,-147000,-147000
20200212,053963,百和永豐96購01,,,,,0.00,0.00,0,0,0,0,0,0,0,0,0,0,0,0,0
20200212,053964,上銀元大96購05,4.36,4.36,4.09,4.13,+0.11,2.74,95000,30,402180,0,0,0,0,0,0,66000,70000,-4000,-4000
20200212,053965,聯電元大98購04,0.88,0.95,0.86,0.93,+0.02,2.2,598000,33,542750,0,0,0,0,0,0,353000,444000,-91000,-91000
20200212,053966,旺宏元大96購08,3.03,3.14,2.91,2.98,-0.02,-0.67,274000,48,827110,0,0,0,0,0,0,234000,241000,-7000,-7000
20200212,053967,華邦電元大96購03,0.46,0.50,0.44,0.48,+0.08,20.0,179000,13,85310,0,0,0,0,0,0,1000,178000,-177000,-177000
20200212,053968,華邦電元大97購01,0.47,0.53,0.47,0.51,+0.09,21.43,286000,7,145830,0,0,0,0,0,0,4000,282000,-278000,-278000
20200212,053969,瑞昱元大97購01,1.40,1.59,0.47,1.53,+0.16,11.68,401000,33,584320,0,0,0,0,0,0,190000,185000,5000,5000
20200212,05396P,台郡元大95售05,1.28,1.30,1.21,1.21,0.00,0.00,103000,13,128280,0,0,0,0,0,0,0,103000,-103000,-103000
20200212,053970,聯發科元大97購08,0.62,0.63,0.62,0.63,+0.18,40.0,20000,2,12500,0,0,0,0,0,0,20000,0,20000,20000
20200212,053971,聯發科元大97購09,0.41,0.46,0.41,0.45,+0.09,25.0,480000,10,208350,0,0,0,0,0,0,430000,50000,380000,380000
20200212,053972,華新科元大96購06,,,,,0.00,0.00,0,0,0,0,0,0,0,0,0,0,0,0,0
20200212,053973,晶豪科元大96購01,1.40,1.40,1.40,1.40,0.00,0.00,2000,2,2800,0,0,0,0,0,0,0,2000,-2000,-2000
20200212,053974,大立光元大96購10,0.91,0.95,0.91,0.95,+0.16,20.25,202000,6,187400,0,0,0,0,0,0,1000,201000,-200000,-200000
20200212,053975,大立光元大98購04,1.77,2.07,1.77,2.07,+0.30,16.95,252000,10,494680,0,0,0,0,0,0,171000,231000,-60000,-60000
20200212,053976,亞光元大96購02,1.04,1.14,1.04,1.11,+0.17,18.09,189000,24,209580,0,0,0,0,0,0,53000,176000,-123000,-123000
20200212,053977,新日興元大96購03,4.52,4.52,4.30,4.30,-0.34,-7.33,19000,5,82800,0,0,0,0,0,0,7000,12000,-5000,-5000
20200212,053978,創意元大96購05,1.42,1.46,1.35,1.45,-0.10,-6.45,155000,13,216670,0,0,0,0,0,0,75000,144000,-69000,-69000
20200212,053979,健策元大98購01,3.88,4.05,3.70,4.03,+0.36,9.81,942000,86,3615770,0,0,0,0,0,0,857000,606000,251000,251000
20200212,05397P,大立光凱基96售08,0.16,0.16,0.15,0.15,-0.04,-21.05,527000,7,84050,0,0,0,0,0,0,0,527000,-527000,-527000
20200212,053980,泰鼎元大97購02,2.50,2.70,2.40,2.40,+0.18,8.11,473000,60,1199090,0,0,0,0,0,0,437000,316000,121000,121000
20200212,053981,康控元大96購05,0.56,0.63,0.56,0.63,+0.09,16.67,28000,6,16190,0,0,0,0,0,0,20000,3000,17000,17000
20200212,053982,臻鼎元大96購05,0.77,0.92,0.72,0.72,+0.10,16.13,319000,15,268700,0,0,0,0,0,0,174000,145000,29000,29000
20200212,053983,樺漢元大97購02,1.00,1.04,0.98,1.04,+0.05,5.05,158000,10,161800,0,0,0,0,0,0,134000,126000,8000,8000
20200212,053984,康友元大96購05,3.40,3.63,3.40,3.58,+0.16,4.68,158000,13,551680,0,0,0,0,0,0,85000,108000,-23000,-23000
20200212,053985,矽創元大96購02,0.92,1.12,0.92,1.12,+0.22,24.44,320000,25,337640,0,0,0,0,0,0,194000,241000,-47000,-47000
20200212,053986,矽創第一96購01,0.33,0.41,0.33,0.39,+0.07,21.88,498000,24,181210,0,0,0,0,0,0,202000,296000,-94000,-94000
20200212,053987,宏碁亞東96購01,0.89,0.89,0.89,0.89,0.00,0.00,20000,1,17800,0,0,0,0,0,0,20000,0,20000,20000
20200212,053988,友達亞東96購01,1.12,1.12,1.12,1.12,0.00,0.00,5000,1,5600,0,0,0,0,0,0,5000,0,5000,5000
20200212,053989,奇力新兆豐97購01,2.19,2.27,2.16,2.27,+0.05,2.25,96000,20,212520,0,0,0,0,0,0,56000,43000,13000,13000
20200212,05398P,康控國票96售03,,,,,0.00,0.00,0,0,0,0,0,0,0,0,0,0,0,0,0
20200212,053990,晶技兆豐96購01,0.89,0.90,0.89,0.89,+0.02,2.3,50000,4,44540,0,0,0,0,0,0,50000,0,50000,50000
20200212,053991,鴻海群益96購05,,,,,0.00,0.00,0,0,0,0,0,0,0,0,0,0,0,0,0
20200212,053992,中環群益96購01,0.56,0.58,0.56,0.58,-0.09,-13.43,1302000,16,753280,0,0,0,0,0,0,1262000,33000,1229000,1229000
20200212,053993,旺宏群益98購02,3.88,3.96,3.77,3.82,-0.07,-1.8,161000,12,619210,0,0,0,0,0,0,61000,100000,-39000,-39000
20200212,053994,微星群益96購01,2.59,2.59,2.30,2.30,-0.05,-2.13,75000,13,188110,0,0,0,0,0,0,62000,13000,49000,49000
20200212,053995,奇力新群益97購02,,,,,0.00,0.00,0,0,0,0,0,0,0,0,0,0,0,0,0
20200212,053996,晶相光群益97購01,1.22,1.31,1.21,1.21,+0.02,1.68,679000,22,861800,0,0,0,0,0,0,456000,223000,233000,233000
20200212,053997,健策群益97購02,1.98,2.16,1.85,2.14,+0.26,13.83,782000,64,1565160,0,0,0,0,0,0,618000,347000,271000,271000
20200212,053998,泰鼎群益98購01,2.75,3.00,2.66,2.72,+0.21,8.37,236000,58,678880,0,0,0,0,0,0,131000,211000,-80000,-80000
20200212,053999,台表科群益96購06,0.51,0.55,0.51,0.55,+0.10,22.22,88000,8,46640,0,0,0,0,0,0,0,88000,-88000,-88000
20200212,05399P,GIS國票95售03,1.33,1.33,1.33,1.33,0.00,0.00,18000,1,23940,0,0,0,0,0,0,0,18000,-18000,-18000
20200212,054000,訊芯群益96購02,1.90,2.13,1.85,2.13,+0.33,18.33,335000,22,670850,0,0,0,0,0,0,139000,196000,-57000,-57000
20200212,054001,康友群益96購02,4.05,4.26,4.05,4.26,+0.28,7.04,36000,5,149380,0,0,0,0,0,0,10000,36000,-26000,-26000
20200212,054002,GIS群益96購03,0.70,0.73,0.70,0.73,0.00,0.00,17000,2,12080,0,0,0,0,0,0,0,17000,-17000,-17000
20200212,054003,鴻海統一96購13,,,,,0.00,0.00,0,0,0,0,0,0,0,0,0,0,0,0,0
20200212,054004,鴻海統一96購14,,,,,0.00,0.00,0,0,0,0,0,0,0,0,0,0,0,0,0
20200212,054005,旺宏統一97購04,,,,,0.00,0.00,0,0,0,0,0,0,0,0,0,0,0,0,0
20200212,054006,智易統一97購01,0.75,0.94,0.74,0.94,+0.21,28.77,681000,27,558090,0,0,0,0,0,0,42000,634000,-592000,-592000
20200212,054007,貿聯統一96購01,1.15,1.20,1.15,1.20,0.00,0.00,169000,4,199090,0,0,0,0,0,0,0,169000,-169000,-169000
20200212,054008,大立光元富96購06,0.84,0.96,0.84,0.96,+0.16,20.0,193000,20,180140,0,0,0,0,0,0,187000,6000,181000,181000
20200212,054009,欣興元富96購03,0.36,0.46,0.36,0.46,+0.15,48.39,344000,10,140030,0,0,0,0,0,0,80000,264000,-184000,-184000
20200212,05400P,台積電永豐95售05,0.84,0.86,0.80,0.80,-0.10,-11.11,736000,19,607770,0,0,0,0,0,0,279000,397000,-118000,-118000
20200212,054010,致伸元富96購01,,,,,0.00,0.00,0,0,0,0,0,0,0,0,0,0,0,0,0
20200212,054011,旺宏永豐96購05,1.00,1.00,0.96,0.96,-0.08,-7.69,166000,5,159410,0,0,0,0,0,0,165000,3000,162000,162000
20200212,054012,廣達永豐96購01,0.60,0.69,0.60,0.69,+0.03,4.55,398000,13,267320,0,0,0,0,0,0,392000,13000,379000,379000
20200212,054013,聯發科永豐96購02,,,,,0.00,0.00,0,0,0,0,0,0,0,0,0,0,0,0,0
20200212,054014,宏達電永豐96購04,,,,,0.00,0.00,0,0,0,0,0,0,0,0,0,0,0,0,0
20200212,054015,晶豪科永豐96購03,0.36,0.36,0.36,0.36,0.00,0.00,30000,2,10800,0,0,0,0,0,0,0,30000,-30000,-30000
20200212,054016,嘉晶永豐96購04,0.46,0.46,0.46,0.46,+0.02,4.55,10000,1,4600,0,0,0,0,0,0,10000,0,10000,10000
20200212,054017,茂林永豐96購02,1.22,1.24,1.19,1.24,+0.06,5.08,390000,23,467990,0,0,0,0,0,0,350000,40000,310000,310000
20200212,054018,華新台新96購01,0.64,0.65,0.64,0.65,0.00,0.00,161000,3,103730,0,0,0,0,0,0,0,161000,-161000,-161000
20200212,054019,燿華台新96購01,0.92,1.07,0.91,1.05,+0.13,14.13,362000,18,366280,0,0,0,0,0,0,95000,267000,-172000,-172000
20200212,05401P,聯茂永豐95售03,0.79,0.79,0.69,0.69,-0.15,-17.86,50000,6,35000,0,0,0,0,0,0,47000,3000,44000,44000
20200212,054020,技嘉台新97購01,2.76,2.76,2.48,2.65,-0.02,-0.75,359000,30,955410,0,0,0,0,0,0,321000,38000,283000,283000
20200212,054021,義隆台新96購01,0.98,1.01,0.95,0.98,+0.14,16.67,97000,13,95380,0,0,0,0,0,0,85000,12000,73000,73000
20200212,054022,南亞康和96購01,0.59,0.59,0.59,0.59,+0.02,3.51,40000,1,23600,0,0,0,0,0,0,40000,0,40000,40000
20200212,054023,和大康和96購01,0.74,0.74,0.74,0.74,0.00,0.00,5000,1,3700,0,0,0,0,0,0,5000,0,5000,5000
20200212,054024,中鋼康和96購01,,,,,0.00,0.00,0,0,0,0,0,0,0,0,0,0,0,0,0
20200212,054025,鴻海凱基96購17,1.13,1.30,1.13,1.30,0.00,0.00,75000,2,85940,0,0,0,0,0,0,0,75000,-75000,-75000
20200212,054026,台積電凱基97購08,,,,,0.00,0.00,0,0,0,0,0,0,0,0,0,0,0,0,0
20200212,054027,欣興凱基96購04,0.66,0.70,0.66,0.70,+0.15,27.27,23000,3,16060,0,0,0,0,0,0,1000,0,1000,1000
20200212,054028,臻鼎凱基96購03,1.52,1.52,1.44,1.44,+0.32,28.57,112000,2,164800,0,0,0,0,0,0,112000,0,112000,112000
20200212,054029,瀚宇博凱基96購02,0.40,0.43,0.40,0.43,+0.02,4.88,3000,3,1230,0,0,0,0,0,0,3000,0,3000,3000
20200212,05402P,台郡永豐95售02,0.50,0.52,0.50,0.51,-0.20,-28.17,101000,4,51930,0,0,0,0,0,0,2000,99000,-97000,-97000
20200212,054030,台苯中信98購01,,,,,0.00,0.00,0,0,0,0,0,0,0,0,0,0,0,0,0
20200212,054031,中鋼中信98購01,0.69,0.71,0.69,0.70,-0.04,-5.41,90000,4,63100,0,0,0,0,0,0,40000,50000,-10000,-10000
20200212,054032,上銀中信96購01,1.02,1.02,0.97,0.98,+0.06,6.52,335000,9,336340,0,0,0,0,0,0,110000,225000,-115000,-115000
20200212,054033,欣興中信96購02,,,,,0.00,0.00,0,0,0,0,0,0,0,0,0,0,0,0,0
20200212,054034,景碩中信96購01,0.39,0.46,0.36,0.46,+0.10,27.78,623000,28,251950,0,0,0,0,0,0,72000,551000,-479000,-479000
20200212,054035,聯詠麥證96購01,0.56,0.62,0.56,0.59,+0.05,9.26,103000,11,60950,72000,30000,42000,0,0,0,72000,30000,42000,42000
20200212,054036,T50反1元大96購08,,,,,0.00,0.00,0,0,0,0,0,0,0,0,0,0,0,0,0
20200212,054037,T50反1元大96購09,0.64,0.64,0.63,0.63,-0.02,-3.08,507000,3,324380,0,0,0,0,0,0,497000,10000,487000,487000
20200212,054038,T50反1元大98購04,0.63,0.63,0.62,0.62,-0.07,-10.14,71000,4,44620,0,0,0,0,0,0,60000,11000,49000,49000
20200212,054039,元油反元大96購08,,,,,0.00,0.00,0,0,0,0,0,0,0,0,0,0,0,0,0
20200212,05403P,台積電富邦95售08,0.22,0.22,0.22,0.22,-0.03,-12.0,30000,1,6600,0,0,0,0,0,0,0,30000,-30000,-30000
20200212,054040,中石化元大9C購01,0.49,0.49,0.49,0.49,0.00,0.00,50000,1,24500,0,0,0,0,0,0,0,50000,-50000,-50000
20200212,054041,鴻海元大96購22,1.16,1.26,1.16,1.26,+0.15,13.51,90000,4,111100,0,0,0,0,0,0,70000,70000,0,0
20200212,054042,華泰元大96購01,0.73,0.73,0.73,0.73,+0.04,5.8,13000,1,9490,0,0,0,0,0,0,13000,13000,0,0
20200212,054043,漢唐元大97購01,2.14,2.21,2.14,2.21,+0.11,5.24,97000,11,210820,0,0,0,0,0,0,86000,11000,75000,75000
20200212,054044,京元電元大96購03,0.69,0.75,0.66,0.73,+0.02,2.82,588000,20,413460,0,0,0,0,0,0,558000,30000,528000,528000
20200212,054045,奇力新元大97購03,3.12,3.21,1.38,3.20,+0.07,2.24,420000,85,1310560,0,0,0,0,0,0,387000,368000,19000,19000
20200212,054046,義隆元大96購02,1.17,1.17,1.06,1.11,+0.11,11.0,1718000,55,1891260,0,0,0,0,0,0,531000,1070000,-539000,-539000
20200212,054047,富邦金元大97購01,1.31,1.33,1.28,1.33,+0.12,9.92,239000,9,311560,0,0,0,0,0,0,140000,99000,41000,41000
20200212,054048,國泰金元大96購04,1.98,1.98,1.96,1.98,+0.10,5.32,86000,4,170040,0,0,0,0,0,0,24000,62000,-38000,-38000
20200212,054049,亞光元大96購03,1.69,1.91,1.66,1.91,+0.28,17.18,314000,31,575300,0,0,0,0,0,0,58000,283000,-225000,-225000
20200212,05404P,台積電群益95售06,0.19,0.19,0.17,0.17,-0.05,-22.73,6000,2,1040,0,0,0,0,0,0,6000,0,6000,6000
20200212,054050,創意元大96購06,2.33,2.48,2.27,2.43,-0.27,-10.0,233000,14,548930,0,0,0,0,0,0,103000,189000,-86000,-86000
20200212,054051,貿聯元大97購03,1.99,2.15,1.99,2.15,+0.21,10.82,54000,4,112740,0,0,0,0,0,0,32000,54000,-22000,-22000
20200212,054052,日月光元大96購06,0.82,0.95,0.82,0.93,+0.15,19.23,269000,11,242170,0,0,0,0,0,0,12000,257000,-245000,-245000
20200212,054053,聯茂元大96購01,1.57,1.95,1.57,1.85,+0.34,22.52,327000,22,592740,0,0,0,0,0,0,219000,118000,101000,101000
20200212,054054,光磊國票97購02,,,,,0.00,0.00,0,0,0,0,0,0,0,0,0,0,0,0,0
20200212,054055,全新國票99購02,1.23,1.44,1.22,1.42,+0.30,26.79,636000,26,857070,0,0,0,0,0,0,475000,169000,306000,306000
20200212,054056,華新科國票96購02,15.20,15.20,14.60,14.80,+0.50,3.5,104000,14,1545400,0,0,0,0,0,0,27000,70000,-43000,-43000
20200212,054057,晶豪科國票97購01,0.98,0.98,0.98,0.98,+0.05,5.38,39000,1,38220,0,0,0,0,0,0,39000,0,39000,39000
20200212,054058,晶豪科國票98購01,1.37,1.37,1.37,1.37,0.00,0.00,60000,1,82200,0,0,0,0,0,0,0,60000,-60000,-60000
20200212,054059,欣興國票97購03,1.59,1.69,1.58,1.69,+0.20,13.42,74000,15,119620,0,0,0,0,0,0,14000,60000,-46000,-46000
20200212,05405P,大立光群益95售04,0.28,0.28,0.24,0.24,-0.09,-27.27,113000,7,29880,0,0,0,0,0,0,0,113000,-113000,-113000
20200212,054060,晶技國票97購02,0.58,0.58,0.58,0.58,0.00,0.00,5000,1,2900,0,0,0,0,0,0,0,5000,-5000,-5000
20200212,054061,晶技國票97購03,,,,,0.00,0.00,0,0,0,0,0,0,0,0,0,0,0,0,0
20200212,054062,TPK國票96購02,0.53,0.57,0.53,0.57,+0.12,26.67,536000,4,285120,0,0,0,0,0,0,17000,519000,-502000,-502000
20200212,054063,聯茂國票97購02,2.81,3.56,2.80,3.38,+1.03,43.83,222000,21,695600,0,0,0,0,0,0,100000,122000,-22000,-22000
20200212,054064,台郡國票97購04,2.83,3.02,2.83,2.95,+1.08,57.75,190000,21,556560,0,0,0,0,0,0,15000,152000,-137000,-137000
20200212,054065,樺漢國票97購01,1.21,1.28,1.19,1.28,+0.10,8.47,62000,3,74720,0,0,0,0,0,0,62000,0,62000,62000
20200212,054066,緯穎國票97購03,6.85,6.95,6.85,6.95,-0.20,-2.8,8000,2,55100,0,0,0,0,0,0,8000,0,8000,8000
20200212,054067,百和國票97購03,,,,,0.00,0.00,0,0,0,0,0,0,0,0,0,0,0,0,0
20200212,054068,華通國泰96購02,,,,,0.00,0.00,0,0,0,0,0,0,0,0,0,0,0,0,0
20200212,054069,亞光國泰98購01,1.10,1.27,1.10,1.24,+0.17,15.89,520000,42,607410,0,0,0,0,0,0,337000,265000,72000,72000
20200212,05406P,台光電凱基95售02,0.33,0.33,0.33,0.33,-0.08,-19.51,10000,1,3300,0,0,0,0,0,0,0,10000,-10000,-10000
20200212,054070,創意國泰96購02,1.28,1.41,1.24,1.39,-0.17,-10.9,382000,43,512360,0,0,0,0,0,0,222000,234000,-12000,-12000
20200212,054071,泰鼎國泰97購02,2.59,2.75,2.47,2.52,+0.12,5.0,220000,55,580310,0,0,0,0,0,0,32000,162000,-130000,-130000
20200212,054072,台積電富邦98購02,0.76,0.80,0.75,0.79,+0.06,8.22,2478000,48,1913160,0,0,0,0,0,0,1195000,1229000,-34000,-34000
20200212,054073,群創富邦96購03,0.66,0.67,0.64,0.64,+0.01,1.59,215000,12,141480,0,0,0,0,0,0,77000,135000,-58000,-58000
20200212,054074,健策富邦98購01,0.88,0.92,0.84,0.92,+0.09,10.84,603000,16,530620,0,0,0,0,0,0,603000,4000,599000,599000
20200212,054075,GIS富邦97購02,0.26,0.26,0.26,0.26,0.00,0.00,45000,1,11700,0,0,0,0,0,0,0,45000,-45000,-45000
20200212,054076,義隆第一96購01,0.61,0.63,0.60,0.60,+0.08,15.38,234000,36,146060,0,0,0,0,0,0,184000,50000,134000,134000
20200212,054077,中石化中信98購01,,,,,0.00,0.00,0,0,0,0,0,0,0,0,0,0,0,0,0
20200212,054078,鴻海中信98購01,,,,,0.00,0.00,0,0,0,0,0,0,0,0,0,0,0,0,0
20200212,054079,鴻海中信98購02,0.55,0.62,0.55,0.62,+0.11,21.57,118000,8,72090,0,0,0,0,0,0,28000,90000,-62000,-62000
20200212,05407P,超眾凱基95售04,0.24,0.24,0.24,0.24,-0.01,-4.0,20000,1,4800,0,0,0,0,0,0,20000,0,20000,20000
20200212,054080,微星中信98購01,1.50,1.53,1.36,1.36,-0.02,-1.45,153000,16,218690,0,0,0,0,0,0,82000,71000,11000,11000
20200212,054081,聯電元富96購01,0.88,0.93,0.82,0.93,+0.05,5.68,1974000,68,1743610,20000,0,20000,0,0,0,1515000,596000,919000,939000
20200212,054082,楠梓電元富96購01,0.85,1.02,0.84,0.96,+0.12,14.29,294000,43,282160,0,0,0,0,0,0,42000,282000,-240000,-240000
20200212,054083,智伸科元富96購01,1.06,1.08,1.06,1.08,0.00,0.00,6000,2,6460,0,0,0,0,0,0,5000,1000,4000,4000
20200212,054084,旺宏統一97購05,1.46,1.47,1.43,1.44,-0.02,-1.37,158000,7,229260,0,0,0,0,0,0,128000,10000,118000,118000
20200212,054085,華新科統一96購04,2.64,2.70,2.59,2.66,+0.08,3.1,97000,5,254600,0,0,0,0,0,0,95000,2000,93000,93000
20200212,054086,日月光亞東98購01,0.70,0.79,0.70,0.79,0.00,0.00,17000,3,12080,0,0,0,0,0,0,15000,2000,13000,13000
20200212,054087,矽創亞東96購01,,,,,0.00,0.00,0,0,0,0,0,0,0,0,0,0,0,0,0
20200212,054088,華新群益98購02,0.67,0.70,0.67,0.70,+0.05,7.69,15000,5,10140,0,0,0,0,0,0,1000,14000,-13000,-13000
20200212,054089,台積電群益96購11,0.85,0.91,0.85,0.91,+0.09,10.98,341000,12,301660,0,0,0,0,0,0,150000,195000,-45000,-45000
20200212,05408P,臺股指中信95售13,,,,,0.00,0.00,0,0,0,0,0,0,0,0,0,0,0,0,0
20200212,054090,瑞昱群益97購01,2.11,2.37,2.11,2.30,+0.18,8.49,81000,17,180820,0,0,0,0,0,0,25000,56000,-31000,-31000
20200212,054091,晶豪科群益96購01,0.73,0.74,0.72,0.72,+0.07,10.77,164000,5,118280,0,0,0,0,0,0,0,164000,-164000,-164000
20200212,054092,大立光群益97購01,1.14,1.17,1.14,1.17,+0.13,12.5,208000,3,242070,0,0,0,0,0,0,10000,198000,-188000,-188000
20200212,054093,智原群益97購01,,,,,0.00,0.00,0,0,0,0,0,0,0,0,0,0,0,0,0
20200212,054094,創意群益96購02,1.85,1.94,1.61,1.83,-0.19,-9.41,465000,38,837240,0,0,0,0,0,0,338000,284000,54000,54000
20200212,054095,同欣電群益98購03,2.10,2.43,2.09,2.37,+0.31,15.05,440000,51,1003030,0,0,0,0,0,0,171000,281000,-110000,-110000
20200212,054096,佳世達國票97購01,0.90,0.91,0.90,0.91,+0.01,1.11,167000,6,150600,0,0,0,0,0,0,140000,27000,113000,113000
20200212,054097,淘帝國票97購01,1.09,1.09,1.09,1.09,+0.04,3.81,33000,1,35970,0,0,0,0,0,0,0,33000,-33000,-33000
20200212,054098,嘉晶國票97購04,1.31,1.34,1.31,1.34,0.00,0.00,79000,2,105290,0,0,0,0,0,0,0,79000,-79000,-79000
20200212,054099,TPK國票98購01,0.83,0.93,0.81,0.93,+0.11,13.41,259000,23,226460,0,0,0,0,0,0,90000,169000,-79000,-79000
20200212,05409P,京元電元富95售05,1.34,1.34,1.27,1.27,-0.08,-5.93,115000,4,151700,0,0,0,0,0,0,105000,10000,95000,95000
20200212,054100,致伸國票97購03,1.10,1.14,1.10,1.14,+0.06,5.56,567000,8,644270,0,0,0,0,0,0,67000,500000,-433000,-433000
20200212,054101,茂林國票97購04,2.60,2.66,2.53,2.60,+0.10,4.0,990000,18,2573560,0,0,0,0,0,0,790000,199000,591000,591000
20200212,054102,百和國票97購04,1.94,1.94,1.94,1.94,-0.01,-0.51,12000,1,23280,0,0,0,0,0,0,12000,0,12000,12000
20200212,054103,T50反1凱基99購04,1.25,1.25,1.25,1.25,-0.02,-1.57,218000,2,272500,0,0,0,0,0,0,218000,0,218000,218000
20200212,054104,T50反1凱基9A購02,0.89,0.89,0.85,0.85,-0.06,-6.59,88000,2,78280,0,0,0,0,0,0,88000,0,88000,88000
20200212,054105,元油反凱基9A購01,,,,,0.00,0.00,0,0,0,0,0,0,0,0,0,0,0,0,0
20200212,054106,元油反凱基9C購01,,,,,0.00,0.00,0,0,0,0,0,0,0,0,0,0,0,0,0
20200212,054107,上銀凱基97購01,2.39,2.39,2.29,2.31,+0.02,0.87,113000,4,262850,0,0,0,0,0,0,63000,81000,-18000,-18000
20200212,054108,台積電凱基96購22,0.96,1.00,0.96,1.00,+0.07,7.53,47000,3,46320,0,0,0,0,0,0,47000,0,47000,47000
20200212,054109,南亞科凱基96購05,1.30,1.30,1.28,1.28,-0.09,-6.57,10000,2,12900,0,0,0,0,0,0,5000,5000,0,0
20200212,05410P,聯發科元富95售04,,,,,0.00,0.00,0,0,0,0,0,0,0,0,0,0,0,0,0
20200212,054110,群創凱基98購09,1.26,1.26,1.25,1.26,-0.02,-1.56,120000,5,150700,0,0,0,0,0,0,120000,0,120000,120000
20200212,054111,緯穎凱基97購01,,,,,0.00,0.00,0,0,0,0,0,0,0,0,0,0,0,0,0
20200212,054112,台積電麥證96購02,0.76,0.80,0.76,0.79,+0.07,9.72,335000,7,262020,144000,170000,-26000,0,0,0,144000,170000,-26000,-26000
20200212,054113,奇力新台新97購01,2.45,2.58,2.45,2.58,+0.18,7.5,72000,9,179280,0,0,0,0,0,0,15000,56000,-41000,-41000
20200212,054114,新光金台新97購01,,,,,0.00,0.00,0,0,0,0,0,0,0,0,0,0,0,0,0
20200212,054115,台塑康和96購01,0.48,0.48,0.48,0.48,0.00,0.00,48000,1,23040,0,0,0,0,0,0,0,48000,-48000,-48000
20200212,054116,順德康和96購01,,,,,0.00,0.00,0,0,0,0,0,0,0,0,0,0,0,0,0
20200212,054117,宏全康和96購01,0.79,0.81,0.77,0.81,-0.02,-2.41,305000,5,240920,0,0,0,0,0,0,86000,219000,-133000,-133000
20200212,054118,國巨永豐96購04,1.70,1.79,1.66,1.79,+0.17,10.49,327000,17,570550,0,0,0,0,0,0,138000,174000,-36000,-36000
20200212,054119,燿華永豐96購05,0.52,0.53,0.52,0.53,+0.12,29.27,229000,5,120320,0,0,0,0,0,0,0,229000,-229000,-229000
20200212,05411P,台積電國票96售08,0.51,0.52,0.49,0.49,-0.11,-18.33,281000,11,139170,0,0,0,0,0,0,35000,246000,-211000,-211000
20200212,054120,奇力新永豐96購01,0.98,1.02,0.95,1.02,+0.04,4.08,773000,52,754960,0,0,0,0,0,0,708000,55000,653000,653000
20200212,054121,奇鋐永豐96購02,0.56,0.61,0.56,0.59,+0.01,1.72,897000,10,534510,0,0,0,0,0,0,635000,262000,373000,373000
20200212,054122,康友永豐96購01,1.10,1.18,1.10,1.17,+0.07,6.36,265000,6,309620,0,0,0,0,0,0,174000,241000,-67000,-67000
20200212,054123,易華電永豐96購03,1.14,1.16,1.13,1.13,0.00,0.00,34000,5,38910,0,0,0,0,0,0,22000,12000,10000,10000
20200212,054124,達方永豐96購02,,,,,0.00,0.00,0,0,0,0,0,0,0,0,0,0,0,0,0
20200212,054125,元油反元大96購09,,,,,0.00,0.00,0,0,0,0,0,0,0,0,0,0,0,0,0
20200212,054126,和大元大96購02,1.14,1.19,1.14,1.19,0.00,0.00,33000,7,38210,0,0,0,0,0,0,13000,20000,-7000,-7000
20200212,054127,台積電元大96購21,2.82,2.82,2.82,2.82,+0.15,5.62,49000,1,138180,0,0,0,0,0,0,49000,49000,0,0
20200212,054128,台積電元大97購10,1.77,1.83,1.77,1.83,+0.12,7.02,79000,10,140410,0,0,0,0,0,0,68000,10000,58000,58000
20200212,054129,技嘉元大96購02,2.16,2.25,2.00,2.13,-0.01,-0.47,1050000,83,2215740,0,2000,-2000,0,0,0,673000,337000,336000,334000
20200212,05412P,泰碩國票95售02,,,,,0.00,0.00,0,0,0,0,0,0,0,0,0,0,0,0,0
20200212,054130,漢唐元大97購02,1.31,1.35,1.30,1.30,0.00,0.00,289000,12,386760,0,0,0,0,0,0,279000,10000,269000,269000
20200212,054131,南亞科元大96購04,1.42,1.42,1.39,1.41,-0.01,-0.7,168000,12,235950,0,0,0,0,0,0,84000,100000,-16000,-16000
20200212,054132,聯發科元大97購10,0.70,0.75,0.69,0.74,+0.10,15.62,301000,12,215350,0,0,0,0,0,0,199000,102000,97000,97000
20200212,054133,奇力新元大97購04,4.42,4.79,4.35,4.79,+0.25,5.51,65000,18,292710,0,0,0,0,0,0,49000,37000,12000,12000
20200212,054134,強茂元大96購01,0.95,1.00,0.95,0.97,+0.05,5.43,220000,11,216950,0,0,0,0,0,0,82000,220000,-138000,-138000
20200212,054135,大立光元大97購04,2.03,2.04,2.00,2.04,+0.24,13.33,133000,5,268070,0,0,0,0,0,0,125000,125000,0,0
20200212,054136,亞光元大96購04,1.71,1.95,1.68,1.92,+0.24,14.29,405000,43,754650,0,0,0,0,0,0,65000,373000,-308000,-308000
20200212,054137,聯詠元大97購02,1.63,1.74,1.63,1.70,+0.11,6.92,658000,41,1116080,0,0,0,0,0,0,462000,444000,18000,18000
20200212,054138,晶技元大98購02,0.53,0.57,0.53,0.57,+0.04,7.55,213000,11,116110,0,0,0,0,0,0,156000,57000,99000,99000
20200212,054139,揚明光元大96購01,0.96,0.96,0.96,0.96,0.00,0.00,26000,2,24960,0,0,0,0,0,0,0,26000,-26000,-26000
20200212,05413P,台郡國票96售02,0.50,0.51,0.50,0.51,-0.24,-32.0,120000,5,60900,0,0,0,0,0,0,30000,90000,-60000,-60000
20200212,054140,智易元大97購03,0.84,1.00,0.84,1.00,0.00,0.00,166000,9,157420,0,0,0,0,0,0,150000,166000,-16000,-16000
20200212,054141,TPK元大96購02,0.37,0.43,0.37,0.43,+0.05,13.16,271000,4,114730,0,0,0,0,0,0,70000,201000,-131000,-131000
20200212,054142,致伸元大97購01,0.76,0.77,0.74,0.77,+0.05,6.94,191000,12,144250,0,0,0,0,0,0,128000,63000,65000,65000
20200212,054143,茂林元大96購04,3.95,4.03,3.91,3.95,+0.12,3.13,129000,29,511190,0,0,0,0,0,0,99000,101000,-2000,-2000
20200212,054144,康控元大97購02,0.38,0.43,0.38,0.43,+0.06,16.22,25000,6,10230,0,0,0,0,0,0,10000,15000,-5000,-5000
20200212,054145,嘉聯益元大98購01,0.58,0.58,0.57,0.57,+0.06,11.76,8000,3,4590,0,0,0,0,0,0,0,8000,-8000,-8000
20200212,054146,康友元大96購06,3.37,3.56,3.37,3.45,+0.08,2.37,166000,19,575360,0,0,0,0,0,0,83000,120000,-37000,-37000
20200212,054147,GIS元大96購02,1.21,1.31,1.21,1.31,+0.12,10.08,81000,4,102080,0,0,0,0,0,0,81000,1000,80000,80000
20200212,054148,矽創元大96購03,1.16,1.43,1.16,1.43,+0.26,22.22,178000,11,243770,0,0,0,0,0,0,133000,158000,-25000,-25000
20200212,054149,達方元大96購01,0.94,0.96,0.94,0.96,+0.06,6.67,2000,2,1900,0,0,0,0,0,0,1000,1000,0,0
20200212,05414P,台表科國票96售02,0.92,0.92,0.88,0.88,-0.06,-6.38,13000,2,11640,0,0,0,0,0,0,8000,5000,3000,3000
20200212,054150,國巨國泰97購05,,,,,0.00,0.00,0,0,0,0,0,0,0,0,0,0,0,0,0
20200212,054151,瑞昱國泰97購01,2.94,3.22,2.94,3.08,+0.18,6.21,105000,10,325250,0,0,0,0,0,0,40000,85000,-45000,-45000
20200212,054152,漢唐國泰98購02,1.38,1.44,1.38,1.38,+0.01,0.73,148000,9,205000,0,0,0,0,0,0,108000,78000,30000,30000
20200212,054153,宏達電國泰97購01,0.83,0.84,0.80,0.80,+0.04,5.26,46000,12,37380,0,0,0,0,0,0,46000,24000,22000,22000
20200212,054154,智易國泰97購01,0.60,0.75,0.60,0.71,0.00,0.00,277000,36,192230,0,0,0,0,0,0,2000,275000,-273000,-273000
20200212,054155,美律第一96購01,0.19,0.24,0.19,0.23,+0.05,27.78,749000,29,162000,0,0,0,0,0,0,316000,433000,-117000,-117000
20200212,054156,聯電亞東98購01,1.14,1.20,1.14,1.20,+0.06,5.26,20000,2,23820,0,0,0,0,0,0,0,0,0,0
20200212,054157,國巨亞東96購01,,,,,0.00,0.00,0,0,0,0,0,0,0,0,0,0,0,0,0
20200212,054158,國巨日盛99購01,2.09,2.15,2.00,2.15,+0.14,6.97,553000,28,1165880,0,0,0,0,0,0,467000,286000,181000,181000
20200212,054159,T50正2凱基99購01,1.61,1.75,1.61,1.75,+0.21,13.64,65000,6,111420,0,0,0,0,0,0,20000,45000,-25000,-25000
20200212,05415P,台積電台新95售04,0.29,0.29,0.28,0.28,-0.05,-15.15,144000,11,41160,0,0,0,0,0,0,0,144000,-144000,-144000
20200212,054160,華泰凱基98購01,,,,,0.00,0.00,0,0,0,0,0,0,0,0,0,0,0,0,0
20200212,054161,友訊凱基98購01,1.58,1.58,1.58,1.58,-0.02,-1.25,10000,1,15800,0,0,0,0,0,0,10000,0,10000,10000
20200212,054162,光罩凱基98購01,,,,,0.00,0.00,0,0,0,0,0,0,0,0,0,0,0,0,0
20200212,054163,燿華凱基97購02,0.86,0.86,0.86,0.86,+0.08,10.26,6000,1,5160,0,0,0,0,0,0,0,6000,-6000,-6000
20200212,054164,強茂凱基98購01,1.22,1.22,1.21,1.21,0.00,0.00,15000,2,18250,0,0,0,0,0,0,0,15000,-15000,-15000
20200212,054165,亞光凱基96購02,0.37,0.48,0.37,0.45,+0.09,25.0,143000,7,62280,0,0,0,0,0,0,62000,103000,-41000,-41000
20200212,054166,日電貿凱基98購01,1.33,1.33,1.21,1.26,0.00,0.00,383000,32,483030,0,0,0,0,0,0,257000,10000,247000,247000
20200212,054167,揚明光凱基98購01,0.72,0.72,0.72,0.72,0.00,0.00,20000,1,14400,0,0,0,0,0,0,0,20000,-20000,-20000
20200212,054168,貿聯凱基97購02,1.38,1.38,1.38,1.38,0.00,0.00,155000,3,213900,0,0,0,0,0,0,0,155000,-155000,-155000
20200212,054169,上緯控凱基98購01,0.98,1.03,0.97,1.00,-0.02,-1.96,203000,6,198050,0,0,0,0,0,0,200000,3000,197000,197000
20200212,05416P,喬山永豐95售04,1.74,1.74,1.74,1.74,-0.07,-3.87,50000,2,87000,0,0,0,0,0,0,50000,0,50000,50000
20200212,054170,泰鼎凱基98購01,2.57,2.79,2.54,2.55,+0.10,4.08,102000,15,273480,0,0,0,0,0,0,24000,78000,-54000,-54000
20200212,054171,台郡凱基97購01,2.18,2.21,2.12,2.21,+0.87,64.93,29000,11,63350,0,0,0,0,0,0,25000,2000,23000,23000
20200212,054172,易華電凱基98購01,1.09,1.09,1.09,1.09,+0.03,2.83,10000,1,10900,0,0,0,0,0,0,10000,0,10000,10000
20200212,054173,奇力新台新97購02,1.73,1.85,1.73,1.85,+0.08,4.52,166000,46,291590,0,0,0,0,0,0,141000,25000,116000,116000
20200212,054174,宏達電台新97購01,,,,,0.00,0.00,0,0,0,0,0,0,0,0,0,0,0,0,0
20200212,054175,高鐵台新97購01,0.77,0.80,0.77,0.80,-0.02,-2.44,107000,5,83070,0,0,0,0,0,0,13000,94000,-81000,-81000
20200212,054176,亞光台新96購01,,,,,0.00,0.00,0,0,0,0,0,0,0,0,0,0,0,0,0
20200212,054177,牧德台新97購01,5.10,5.15,5.10,5.15,+0.21,4.25,19000,2,97400,0,0,0,0,0,0,0,19000,-19000,-19000
20200212,054178,中磊台新97購01,1.23,1.23,1.23,1.23,+0.02,1.65,19000,2,23370,0,0,0,0,0,0,19000,0,19000,19000
20200212,054179,上海銀台新97購01,0.84,0.90,0.84,0.90,+0.03,3.45,62000,5,54780,0,0,0,0,0,0,12000,50000,-38000,-38000
20200212,05417P,燿華永豐95售07,,,,,0.00,0.00,0,0,0,0,0,0,0,0,0,0,0,0,0
20200212,054180,亞泥康和96購01,0.80,0.81,0.80,0.81,+0.03,3.85,57000,2,45880,0,0,0,0,0,0,0,57000,-57000,-57000
20200212,054181,華新康和96購01,,,,,0.00,0.00,0,0,0,0,0,0,0,0,0,0,0,0,0
20200212,054182,台積電康和96購01,0.88,0.88,0.88,0.88,+0.03,3.53,1000,1,880,0,0,0,0,0,0,0,1000,-1000,-1000
20200212,054183,亞光康和96購01,0.73,0.73,0.73,0.73,0.00,0.00,24000,1,17520,0,0,0,0,0,0,24000,0,24000,24000
20200212,054184,A50正2永豐96購01,,,,,0.00,0.00,0,0,0,0,0,0,0,0,0,0,0,0,0
20200212,054185,喬山永豐96購02,1.12,1.27,1.12,1.22,+0.15,14.02,106000,10,126140,0,0,0,0,0,0,0,106000,-106000,-106000
20200212,054186,高鐵永豐96購01,,,,,0.00,0.00,0,0,0,0,0,0,0,0,0,0,0,0,0
20200212,054187,亞光永豐96購03,,,,,0.00,0.00,0,0,0,0,0,0,0,0,0,0,0,0,0
20200212,054188,欣興永豐96購03,1.46,1.77,1.46,1.77,+0.36,25.53,452000,32,732680,0,0,0,0,0,0,154000,320000,-166000,-166000
20200212,054189,貿聯永豐96購03,0.72,0.83,0.72,0.83,+0.13,18.57,141000,4,106530,0,0,0,0,0,0,15000,136000,-121000,-121000
20200212,05418P,瑞昱永豐95售02,,,,,0.00,0.00,0,0,0,0,0,0,0,0,0,0,0,0,0
20200212,054190,矽創永豐96購01,0.38,0.51,0.38,0.51,+0.09,21.43,324000,21,154030,0,0,0,0,0,0,116000,208000,-92000,-92000
20200212,054191,香港2X中信98購01,,,,,0.00,0.00,0,0,0,0,0,0,0,0,0,0,0,0,0
20200212,054192,國巨中信98購01,1.66,1.66,1.54,1.63,+0.13,8.67,267000,15,430570,0,0,0,0,0,0,126000,141000,-15000,-15000
20200212,054193,鴻海麥證96購02,0.74,0.76,0.74,0.76,+0.09,13.43,7000,2,5220,0,7000,-7000,0,0,0,0,7000,-7000,-7000
20200212,054194,國巨麥證96購02,4.30,4.43,4.17,4.41,+0.35,8.62,126000,24,539410,99000,27000,72000,0,0,0,99000,27000,72000,72000
20200212,054195,亞泥國泰98購01,1.55,1.56,1.55,1.55,+0.01,0.65,130000,5,201800,0,0,0,0,0,0,50000,80000,-30000,-30000
20200212,054196,台光電國泰97購02,,,,,0.00,0.00,0,0,0,0,0,0,0,0,0,0,0,0,0
20200212,054197,台積電永昌96購07,1.38,1.45,1.36,1.43,+0.12,9.16,2118000,26,2965840,0,0,0,0,0,0,1933000,1166000,767000,767000
20200212,054198,台積電永昌96購08,1.28,1.34,1.23,1.34,+0.16,13.56,1007000,9,1287700,0,0,0,0,0,0,727000,280000,447000,447000
20200212,054199,大立光永昌96購07,1.24,1.27,1.24,1.27,0.00,0.00,128000,2,160610,0,0,0,0,0,0,0,128000,-128000,-128000
20200212,05419P,矽力永豐95售02,0.62,0.62,0.62,0.62,-0.08,-11.43,185000,3,114700,0,0,0,0,0,0,185000,0,185000,185000
20200212,054200,美律富邦97購02,0.21,0.23,0.21,0.23,+0.04,21.05,159000,8,34650,0,0,0,0,0,0,52000,105000,-53000,-53000
20200212,054201,聯詠富邦97購02,0.84,0.88,0.83,0.85,+0.06,7.59,854000,34,733840,0,0,0,0,0,0,751000,57000,694000,694000
20200212,054202,樺漢富邦97購01,0.59,0.62,0.57,0.60,+0.04,7.14,378000,20,220540,0,0,0,0,0,0,225000,177000,48000,48000
20200212,054203,滬深2X國票96購03,,,,,0.00,0.00,0,0,0,0,0,0,0,0,0,0,0,0,0
20200212,054204,元金2X國票9B購02,0.81,0.81,0.80,0.80,-0.04,-4.76,26000,2,21000,0,0,0,0,0,0,6000,20000,-14000,-14000
20200212,054205,華新國票97購02,0.66,0.66,0.64,0.64,+0.02,3.23,20000,2,13000,0,0,0,0,0,0,10000,10000,0,0
20200212,054206,鴻海國票99購01,0.24,0.31,0.24,0.31,+0.09,40.91,3946000,50,1092830,0,0,0,0,0,0,672000,3206000,-2534000,-2534000
20200212,054207,國巨國票98購01,5.45,5.55,5.45,5.55,+0.20,3.74,26000,3,143750,0,0,0,0,0,0,26000,0,26000,26000
20200212,054208,台積電國票97購07,1.99,2.02,1.95,2.02,+0.11,5.76,227000,6,453240,0,0,0,0,0,0,15000,212000,-197000,-197000
20200212,054209,台積電國票97購08,1.60,1.68,1.58,1.65,+0.09,5.77,597000,12,969650,0,0,0,0,0,0,377000,220000,157000,157000
20200212,05420P,大立光國泰97售03,0.90,0.90,0.87,0.87,-0.10,-10.31,65000,3,57150,0,0,0,0,0,0,45000,20000,25000,25000
20200212,054210,台光電國票97購03,3.21,3.96,3.21,3.96,+0.89,28.99,93000,14,333650,0,0,0,0,0,0,16000,77000,-61000,-61000
20200212,054211,奇鋐國票97購03,,,,,0.00,0.00,0,0,0,0,0,0,0,0,0,0,0,0,0
20200212,054212,聯詠國票97購03,1.90,1.96,1.80,1.94,+0.18,10.23,84000,9,160960,0,0,0,0,0,0,46000,38000,8000,8000
20200212,054213,欣興國票97購04,2.57,3.03,2.57,3.03,+0.52,20.72,151000,15,425110,0,0,0,0,0,0,84000,67000,17000,17000
20200212,054214,京鼎國票97購02,1.87,2.01,1.87,2.01,+0.41,25.63,129000,12,249600,0,0,0,0,0,0,43000,76000,-33000,-33000
20200212,054215,創意國票97購02,2.86,2.89,2.71,2.89,-0.51,-15.0,70000,14,198760,0,0,0,0,0,0,70000,0,70000,70000
20200212,054216,聯茂國票97購03,4.55,5.95,4.55,5.75,+1.83,46.68,245000,10,1344810,0,0,0,0,0,0,58000,187000,-129000,-129000
20200212,054217,台表科國票97購05,0.94,1.03,0.94,1.03,+0.07,7.29,117000,6,112340,0,0,0,0,0,0,34000,83000,-49000,-49000
20200212,054218,S&P反1統一98購02,0.84,0.84,0.83,0.83,-0.02,-2.35,30000,2,25150,0,0,0,0,0,0,30000,0,30000,30000
20200212,054219,楠梓電統一97購01,1.09,1.25,1.05,1.25,+0.20,19.05,612000,32,702990,0,0,0,0,0,0,78000,534000,-456000,-456000
20200212,05421P,鴻海元大96售12,4.32,4.35,3.77,3.77,-0.67,-15.09,371000,25,1511610,0,0,0,0,0,0,361000,371000,-10000,-10000
20200212,054220,國巨統一97購02,3.80,3.91,3.76,3.90,+0.29,8.03,55000,10,211690,0,0,0,0,0,0,35000,19000,16000,16000
20200212,054221,華新科統一96購05,3.59,3.59,3.57,3.57,+0.04,1.13,61000,2,218570,0,0,0,0,0,0,61000,0,61000,61000
20200212,054222,大立光統一98購03,0.58,0.58,0.58,0.58,+0.06,11.54,20000,1,11600,0,0,0,0,0,0,20000,0,20000,20000
20200212,054223,大立光統一98購04,,,,,0.00,0.00,0,0,0,0,0,0,0,0,0,0,0,0,0
20200212,054224,亞光統一98購01,0.38,0.42,0.38,0.41,0.00,0.00,147000,8,59550,0,0,0,0,0,0,46000,101000,-55000,-55000
20200212,054225,華新元富96購01,0.43,0.44,0.43,0.44,+0.04,10.0,4000,4,1740,0,0,0,0,0,0,1000,3000,-2000,-2000
20200212,054226,燿華元富96購02,1.05,1.15,1.05,1.14,+0.14,14.0,126000,22,140910,0,0,0,0,0,0,26000,111000,-85000,-85000
20200212,054227,宏達電元富96購02,,,,,0.00,0.00,0,0,0,0,0,0,0,0,0,0,0,0,0
20200212,054228,貿聯元富96購03,1.01,1.15,1.00,1.15,+0.15,15.0,506000,33,545090,0,0,0,0,0,0,236000,276000,-40000,-40000
20200212,054229,超眾元富96購05,1.70,1.94,1.70,1.94,+0.11,6.01,744000,37,1349150,0,0,0,0,0,0,525000,219000,306000,306000
20200212,05422P,大立光中信97售02,0.41,0.41,0.38,0.38,-0.03,-7.32,28000,4,10700,0,0,0,0,0,0,2000,26000,-24000,-24000
20200212,054230,上銀群益96購03,3.56,3.56,3.44,3.44,+0.13,3.93,24000,12,83820,0,0,0,0,0,0,24000,24000,0,0
20200212,054231,國巨群益98購03,,,,,0.00,0.00,0,0,0,0,0,0,0,0,0,0,0,0,0
20200212,054232,台積電群益96購12,0.75,0.78,0.73,0.78,+0.07,9.86,253000,9,191360,0,0,0,0,0,0,130000,125000,5000,5000
20200212,054233,聯發科群益96購04,0.62,0.74,0.62,0.69,+0.19,38.0,36000,7,23820,0,0,0,0,0,0,30000,6000,24000,24000
20200212,054234,可成群益96購05,2.17,2.44,2.08,2.44,+0.48,24.49,113000,10,249430,0,0,0,0,0,0,31000,92000,-61000,-61000
20200212,054235,欣興群益96購06,2.20,2.20,2.20,2.20,0.00,0.00,2000,1,4400,0,0,0,0,0,0,2000,0,2000,2000
20200212,054236,貿聯群益96購01,1.19,1.41,1.18,1.41,+0.26,22.61,224000,9,272360,0,0,0,0,0,0,25000,209000,-184000,-184000
20200212,054237,茂林群益97購01,1.86,1.90,1.83,1.85,+0.02,1.09,672000,34,1243160,0,0,0,0,0,0,260000,472000,-212000,-212000
20200212,054238,聯茂群益96購04,3.34,3.93,3.31,3.93,+1.64,71.62,37000,16,133770,0,0,0,0,0,0,0,37000,-37000,-37000
20200212,054239,台郡群益96購02,1.18,1.28,1.11,1.28,+0.52,68.42,805000,18,935650,0,60000,-60000,0,0,0,646000,22000,624000,564000
20200212,05423P,聯電亞東95售02,0.29,0.29,0.29,0.29,-0.02,-6.45,14000,1,4060,0,0,0,0,0,0,0,14000,-14000,-14000
20200212,054240,訊芯群益96購03,1.28,1.54,1.28,1.54,+0.27,21.26,191000,16,272060,0,0,0,0,0,0,56000,135000,-79000,-79000
20200212,054241,深中小元大98購01,,,,,0.00,0.00,0,0,0,0,0,0,0,0,0,0,0,0,0
20200212,054242,元油反元大98購02,,,,,0.00,0.00,0,0,0,0,0,0,0,0,0,0,0,0,0
20200212,054243,國喬元大96購01,0.74,0.82,0.74,0.82,+0.13,18.84,323000,9,251040,0,0,0,0,0,0,20000,293000,-273000,-273000
20200212,054244,華新元大96購01,0.67,0.71,0.67,0.71,+0.07,10.94,226000,11,152730,0,0,0,0,0,0,120000,126000,-6000,-6000
20200212,054245,鴻海元大96購23,0.89,0.98,0.89,0.98,0.00,0.00,21000,3,19230,0,0,0,0,0,0,21000,0,21000,21000
20200212,054246,國巨元大96購12,4.60,4.67,4.46,4.67,+0.36,8.35,140000,25,647340,0,0,0,0,0,0,50000,105000,-55000,-55000
20200212,054247,華邦電元大96購04,0.45,0.49,0.45,0.48,+0.08,20.0,366000,5,173350,0,0,0,0,0,0,27000,339000,-312000,-312000
20200212,054248,燿華元大97購02,1.43,1.63,1.43,1.57,+0.08,5.37,675000,34,1064740,0,0,0,0,0,0,267000,623000,-356000,-356000
20200212,054249,技嘉元大96購03,2.49,2.71,2.47,2.52,-0.02,-0.79,356000,43,923170,0,0,0,0,0,0,252000,87000,165000,165000
20200212,05424P,台達電亞東96售02,1.05,1.05,1.05,1.05,-0.05,-4.55,1000,1,1050,0,0,0,0,0,0,1000,0,1000,1000
20200212,054250,漢唐元大96購04,1.32,1.38,1.32,1.34,+0.04,3.08,38000,4,50700,0,0,0,0,0,0,38000,11000,27000,27000
20200212,054251,聯發科元大96購21,0.88,0.98,0.86,0.97,+0.19,24.36,455000,15,430000,0,0,0,0,0,0,255000,200000,55000,55000
20200212,054252,奇力新元大96購04,3.41,3.55,3.31,3.55,+0.12,3.5,559000,99,1911740,0,0,0,0,0,0,389000,451000,-62000,-62000
20200212,054253,宏達電元大97購03,0.71,0.71,0.70,0.70,+0.02,2.94,4000,2,2830,0,0,0,0,0,0,3000,1000,2000,2000
20200212,054254,晶豪科元大96購02,0.90,0.90,0.90,0.90,+0.05,5.88,2000,2,1800,0,0,0,0,0,0,0,2000,-2000,-2000
20200212,054255,亞光元大96購05,1.16,1.34,1.15,1.33,+0.22,19.82,229000,16,287830,0,0,0,0,0,0,119000,129000,-10000,-10000
20200212,054256,創意元大96購07,1.72,1.79,1.65,1.78,-0.10,-5.32,238000,14,405150,0,0,0,0,0,0,92000,235000,-143000,-143000
20200212,054257,揚明光元大96購02,0.77,0.83,0.77,0.83,+0.08,10.67,198000,4,156320,0,0,0,0,0,0,67000,131000,-64000,-64000
20200212,054258,牧德元大97購01,6.25,6.40,6.20,6.40,+0.30,4.92,10000,5,62700,0,0,0,0,0,0,5000,5000,0,0
20200212,054259,健策元大97購03,3.26,3.49,3.07,3.49,+0.45,14.8,541000,73,1790820,0,0,0,0,0,0,334000,441000,-107000,-107000
20200212,05425P,華邦電亞東96售02,,,,,0.00,0.00,0,0,0,0,0,0,0,0,0,0,0,0,0
20200212,054260,貿聯元大96購03,1.87,2.15,1.87,2.15,+0.33,18.13,134000,13,276450,0,0,0,0,0,0,15000,129000,-114000,-114000
20200212,054261,智伸科元大96購03,1.16,1.17,1.10,1.11,-0.03,-2.63,181000,10,207200,0,0,0,0,0,0,121000,100000,21000,21000
20200212,054262,瀚宇博元大96購03,1.37,1.55,1.37,1.54,+0.14,10.0,290000,39,422760,0,0,0,0,0,0,169000,280000,-111000,-111000
20200212,054263,聯茂元大96購02,2.60,3.32,2.60,3.32,+0.83,33.33,206000,23,618820,0,0,0,0,0,0,153000,78000,75000,75000
20200212,054264,超眾元大97購02,1.35,1.59,1.35,1.59,+0.13,8.9,346000,34,512790,0,0,0,0,0,0,231000,222000,9000,9000
20200212,054265,GIS元大96購03,1.09,1.20,1.09,1.20,+0.13,12.15,107000,13,123490,0,0,0,0,0,0,97000,29000,68000,68000
20200212,054266,緯穎元大96購07,5.00,5.45,4.93,5.45,+0.30,5.83,173000,28,908970,0,0,0,0,0,0,169000,133000,36000,36000
20200212,054267,上銀第一96購01,1.15,1.19,1.15,1.19,+0.08,7.21,6000,2,6940,0,0,0,0,0,0,5000,1000,4000,4000
20200212,054268,健策第一96購01,0.86,0.93,0.82,0.93,+0.13,16.25,1087000,47,935130,0,0,0,0,0,0,889000,148000,741000,741000
20200212,054269,台光電亞東98購01,,,,,0.00,0.00,0,0,0,0,0,0,0,0,0,0,0,0,0
20200212,05426P,聯發科凱基95售12,1.86,1.86,1.85,1.85,-0.33,-15.14,33000,2,61180,0,0,0,0,0,0,33000,33000,0,0
20200212,054270,寶滬深中信98購01,1.11,1.11,1.11,1.11,-0.01,-0.89,10000,1,11100,0,0,0,0,0,0,10000,0,10000,10000
20200212,054271,中石化中信99購01,,,,,0.00,0.00,0,0,0,0,0,0,0,0,0,0,0,0,0
20200212,054272,華通中信98購01,0.69,0.79,0.69,0.79,+0.18,29.51,90000,14,68340,0,0,0,0,0,0,50000,65000,-15000,-15000
20200212,054273,宏達電中信98購01,,,,,0.00,0.00,0,0,0,0,0,0,0,0,0,0,0,0,0
20200212,054274,智易中信96購02,0.67,0.74,0.67,0.74,+0.12,19.35,221000,6,157010,0,0,0,0,0,0,0,221000,-221000,-221000
20200212,054275,華通群益97購03,0.85,1.26,0.85,1.17,+0.56,91.8,134000,21,141510,0,0,0,0,0,0,0,134000,-134000,-134000
20200212,054276,國巨群益96購07,6.75,6.75,6.75,6.75,+0.40,6.3,1000,1,6750,0,0,0,0,0,0,1000,0,1000,1000
20200212,054277,亞光群益97購01,1.16,1.34,1.16,1.34,+0.19,16.52,216000,10,264760,0,0,0,0,0,0,80000,136000,-56000,-56000
20200212,054278,晶技群益97購02,,,,,0.00,0.00,0,0,0,0,0,0,0,0,0,0,0,0,0
20200212,054279,揚明光群益98購01,0.63,0.63,0.63,0.63,0.00,0.00,11000,1,6930,0,0,0,0,0,0,0,11000,-11000,-11000
20200212,05427P,聯發科凱基96售07,1.57,1.57,1.56,1.56,-0.31,-16.58,110000,4,172600,0,0,0,0,0,0,9000,101000,-92000,-92000
20200212,054280,牧德群益98購01,5.65,5.70,5.60,5.65,+0.15,2.73,61000,8,344650,0,0,0,0,0,0,41000,20000,21000,21000
20200212,054281,世芯群益97購01,2.41,2.47,2.23,2.42,-0.04,-1.63,448000,37,1060900,0,0,0,0,0,0,399000,57000,342000,342000
20200212,054282,泰鼎群益98購02,1.41,1.53,1.38,1.38,+0.04,2.99,905000,93,1304310,0,0,0,0,0,0,251000,665000,-414000,-414000
20200212,054283,元油反元大99購02,,,,,0.00,0.00,0,0,0,0,0,0,0,0,0,0,0,0,0
20200212,054284,和大元大96購03,1.71,1.71,1.71,1.71,-0.10,-5.52,11000,4,18810,0,0,0,0,0,0,5000,6000,-1000,-1000
20200212,054285,國巨元大98購02,4.55,4.55,4.39,4.55,+0.27,6.31,116000,14,515880,0,0,0,0,0,0,108000,55000,53000,53000
20200212,054286,台積電元大96購22,1.67,1.70,1.67,1.70,+0.15,9.68,49000,4,82130,0,0,0,0,0,0,49000,49000,0,0
20200212,054287,台積電元大97購11,2.21,2.21,2.21,2.21,+0.10,4.74,30000,2,66300,0,0,0,0,0,0,30000,30000,0,0
20200212,054288,華邦電元大96購05,0.92,1.00,0.88,0.97,+0.14,16.87,260000,20,251940,0,0,0,0,0,0,78000,232000,-154000,-154000
20200212,054289,聯發科元大97購11,0.75,0.75,0.72,0.74,+0.13,21.31,225000,7,165450,0,0,0,0,0,0,90000,135000,-45000,-45000
20200212,05428P,滬深2X統一95售01,,,,,0.00,0.00,0,0,0,0,0,0,0,0,0,0,0,0,0
20200212,054290,奇力新元大96購05,3.95,3.98,3.95,3.98,+0.04,1.02,11000,4,43570,0,0,0,0,0,0,7000,4000,3000,3000
20200212,054291,高鐵元大97購01,1.21,1.29,1.21,1.27,0.00,0.00,78000,6,95040,0,0,0,0,0,0,10000,78000,-68000,-68000
20200212,054292,欣興元大96購06,1.66,2.06,1.61,2.03,+0.35,20.83,1146000,77,2145780,0,0,0,0,0,0,580000,760000,-180000,-180000
20200212,054293,健策元大98購02,3.56,3.74,3.38,3.74,+0.44,13.33,1115000,67,3954350,0,0,0,0,0,0,1027000,657000,370000,370000
20200212,054294,世芯元大96購02,1.83,2.01,1.79,1.91,-0.02,-1.04,649000,34,1196640,0,0,0,0,0,0,606000,48000,558000,558000
20200212,054295,世芯元大96購03,1.61,1.75,1.56,1.67,-0.04,-2.34,868000,52,1416850,0,0,0,0,0,0,618000,242000,376000,376000
20200212,054296,世芯元大97購01,2.22,2.43,2.18,2.23,-0.02,-0.89,342000,32,778140,0,0,0,0,0,0,303000,43000,260000,260000
20200212,054297,台郡元大98購01,3.85,3.93,3.62,3.93,+1.48,60.41,333000,16,1279860,0,0,0,0,0,0,270000,53000,217000,217000
20200212,054298,台表科元大97購03,1.51,1.64,1.49,1.64,+0.15,10.07,314000,15,505060,0,0,0,0,0,0,61000,263000,-202000,-202000
20200212,054299,南電元大96購03,1.56,1.88,1.52,1.81,+0.28,18.3,826000,50,1405530,0,0,0,0,0,0,561000,367000,194000,194000
20200212,05429P,鴻海統一95售16,2.80,2.80,2.52,2.52,-0.64,-20.25,33000,4,90160,0,0,0,0,0,0,8000,33000,-25000,-25000
20200212,054300,華通凱基96購07,2.07,2.81,2.01,2.73,+0.70,34.48,75000,22,184780,0,0,0,0,0,0,72000,58000,14000,14000
20200212,054301,楠梓電凱基98購01,0.88,0.95,0.44,0.95,+0.09,10.47,101000,5,87350,0,0,0,0,0,0,90000,11000,79000,79000
20200212,054302,鴻海凱基96購18,0.56,0.67,0.56,0.67,0.00,0.00,103000,2,61530,0,0,0,0,0,0,35000,68000,-33000,-33000
20200212,054303,國巨凱基96購15,4.42,4.42,4.28,4.28,+0.19,4.65,184000,2,787660,0,0,0,0,0,0,184000,0,184000,184000
20200212,054304,台積電凱基96購23,,,,,0.00,0.00,0,0,0,0,0,0,0,0,0,0,0,0,0
20200212,054305,光磊凱基98購01,,,,,0.00,0.00,0,0,0,0,0,0,0,0,0,0,0,0,0
20200212,054306,聯發科凱基96購23,,,,,0.00,0.00,0,0,0,0,0,0,0,0,0,0,0,0,0
20200212,054307,高鐵凱基98購01,0.64,0.64,0.64,0.64,0.00,0.00,20000,1,12800,0,0,0,0,0,0,0,20000,-20000,-20000
20200212,054308,嘉晶凱基98購01,0.85,1.02,0.85,0.98,+0.14,16.67,447000,19,426230,0,0,0,0,0,0,119000,320000,-201000,-201000
20200212,054309,禾伸堂凱基98購01,2.12,2.12,2.12,2.12,-0.10,-4.5,4000,3,8480,0,0,0,0,0,0,3000,1000,2000,2000
20200212,05430P,台積電統一95售07,,,,,0.00,0.00,0,0,0,0,0,0,0,0,0,0,0,0,0
20200212,054310,牧德凱基98購01,4.26,4.26,3.99,3.99,-0.15,-3.62,46000,5,192380,0,0,0,0,0,0,46000,14000,32000,32000
20200212,054311,世芯凱基96購02,1.30,1.38,0.40,1.32,+0.04,3.12,97000,18,116800,0,0,0,0,0,0,87000,12000,75000,75000
20200212,054312,TPK凱基98購01,0.63,0.69,0.63,0.69,+0.07,11.29,286000,15,191460,0,0,0,0,0,0,98000,188000,-90000,-90000
20200212,054313,麗豐凱基96購02,,,,,0.00,0.00,0,0,0,0,0,0,0,0,0,0,0,0,0
20200212,054314,嘉聯益凱基97購01,0.86,1.26,0.86,1.26,+0.43,51.81,3000,3,3010,0,0,0,0,0,0,1000,1000,0,0
20200212,054315,訊芯凱基98購01,1.50,1.50,1.50,1.50,+0.11,7.91,30000,1,45000,0,0,0,0,0,0,0,30000,-30000,-30000
20200212,054316,矽創凱基97購01,1.14,1.45,1.14,1.45,+0.34,30.63,160000,35,217680,0,0,0,0,0,0,32000,131000,-99000,-99000
20200212,054317,昇陽半凱基98購01,1.10,1.10,1.10,1.10,0.00,0.00,42000,2,46200,0,0,0,0,0,0,12000,42000,-30000,-30000
20200212,054318,台虹凱基98購01,1.16,1.20,1.16,1.20,+0.09,8.11,236000,11,276770,0,0,0,0,0,0,153000,83000,70000,70000
20200212,054319,世紀鋼凱基96購02,0.62,0.62,0.62,0.62,-0.01,-1.59,1000,1,620,0,0,0,0,0,0,1000,0,1000,1000
20200212,05431P,台光電統一97售01,0.82,0.82,0.82,0.82,-0.11,-11.83,11000,2,9020,0,0,0,0,0,0,0,11000,-11000,-11000
20200212,054320,國喬台新96購01,,,,,0.00,0.00,0,0,0,0,0,0,0,0,0,0,0,0,0
20200212,054321,上銀台新96購01,,,,,0.00,0.00,0,0,0,0,0,0,0,0,0,0,0,0,0
20200212,054322,國巨台新96購02,2.52,2.61,2.52,2.61,+0.21,8.75,152000,3,387540,0,0,0,0,0,0,149000,0,149000,149000
20200212,054323,旺宏台新96購02,1.38,1.38,1.38,1.38,0.00,0.00,11000,1,15180,0,0,0,0,0,0,0,11000,-11000,-11000
20200212,054324,美律台新97購01,0.40,0.51,0.40,0.51,+0.16,45.71,455000,48,207820,0,0,0,0,0,0,115000,340000,-225000,-225000
20200212,054325,奇力新台新97購03,,,,,0.00,0.00,0,0,0,0,0,0,0,0,0,0,0,0,0
20200212,054326,宏達電台新97購02,,,,,0.00,0.00,0,0,0,0,0,0,0,0,0,0,0,0,0
20200212,054327,亞光台新96購02,0.69,0.77,0.69,0.75,+0.15,25.0,34000,3,25280,0,0,0,0,0,0,15000,19000,-4000,-4000
20200212,054328,台化康和96購01,0.42,0.43,0.42,0.43,0.00,0.00,103000,2,43760,0,0,0,0,0,0,53000,50000,3000,3000
20200212,054329,華新科永豐96購02,1.60,1.60,1.53,1.57,+0.07,4.67,40000,9,63080,0,0,0,0,0,0,34000,20000,14000,14000
20200212,05432P,國巨元富95售07,,,,,0.00,0.00,0,0,0,0,0,0,0,0,0,0,0,0,0
20200212,054330,世芯永豐96購02,0.75,0.78,0.71,0.78,+0.03,4.0,1190000,31,910650,0,0,0,0,0,0,1102000,20000,1082000,1082000
20200212,054331,世芯永豐96購03,0.90,1.10,0.90,1.05,-0.02,-1.87,2350000,74,2451290,0,0,0,0,0,0,1556000,784000,772000,772000
20200212,054332,世芯永豐97購01,0.98,0.99,0.90,0.95,+0.02,2.15,1122000,36,1030620,0,0,0,0,0,0,791000,212000,579000,579000
20200212,054333,茂林永豐96購03,0.96,0.97,0.92,0.96,+0.01,1.05,427000,16,404440,0,0,0,0,0,0,307000,120000,187000,187000
20200212,054334,超眾永豐96購04,0.46,0.56,0.46,0.56,+0.04,7.69,473000,32,234160,0,0,0,0,0,0,362000,102000,260000,260000
20200212,054335,緯穎永豐96購02,1.80,2.07,1.79,2.07,+0.20,10.7,299000,10,576860,0,0,0,0,0,0,168000,121000,47000,47000
20200212,054336,台積電統一96購11,2.14,2.24,2.14,2.24,+0.18,8.74,103000,2,229720,0,0,0,0,0,0,103000,0,103000,103000
20200212,054337,智邦統一96購01,3.81,3.82,3.33,3.33,-0.06,-1.77,74000,7,277660,0,0,0,0,0,0,0,74000,-74000,-74000
20200212,054338,全新統一96購01,0.99,1.20,0.98,1.20,+0.34,39.53,1197000,51,1283020,0,0,0,0,0,0,486000,711000,-225000,-225000
20200212,054339,聯詠統一96購02,1.56,1.62,1.53,1.59,+0.13,8.9,312000,18,494180,0,0,0,0,0,0,274000,38000,236000,236000
20200212,05433P,智原元富95售02,,,,,0.00,0.00,0,0,0,0,0,0,0,0,0,0,0,0,0
20200212,054340,大成鋼元富96購01,1.06,1.06,1.06,1.06,0.00,0.00,10000,1,10600,0,0,0,0,0,0,0,10000,-10000,-10000
20200212,054341,燿華元富96購03,0.92,0.99,0.92,0.98,+0.11,12.64,92000,15,88460,0,0,0,0,0,0,0,92000,-92000,-92000
20200212,054342,亞光元富99購01,0.72,0.76,0.72,0.76,+0.13,20.63,219000,4,163200,0,0,0,0,0,0,5000,214000,-209000,-209000
20200212,054343,世紀鋼元富96購02,0.82,0.84,0.80,0.80,-0.05,-5.88,123000,22,99370,0,0,0,0,0,0,123000,0,123000,123000
20200212,054344,景碩國票97購04,1.01,1.24,0.99,1.20,+0.18,17.65,444000,45,471410,0,0,0,0,0,0,298000,146000,152000,152000
20200212,054345,世芯國票96購02,1.35,1.35,1.27,1.27,-0.09,-6.62,86000,13,114960,0,0,0,0,0,0,74000,6000,68000,68000
20200212,054346,世芯國票97購01,2.85,2.99,2.62,2.86,+0.08,2.88,263000,14,726430,0,0,0,0,0,0,263000,0,263000,263000
20200212,054347,上緯控國票96購02,0.70,0.71,0.67,0.68,-0.02,-2.86,111000,4,75650,0,0,0,0,0,0,38000,73000,-35000,-35000
20200212,054348,康控國票97購03,0.72,0.86,0.72,0.86,+0.18,26.47,28000,4,22440,0,0,0,0,0,0,10000,18000,-8000,-8000
20200212,054349,同欣電國票97購02,3.37,3.94,3.37,3.47,+0.20,6.12,146000,27,519980,0,0,0,0,0,0,60000,86000,-26000,-26000
20200212,05434P,世紀鋼元富95售02,,,,,0.00,0.00,0,0,0,0,0,0,0,0,0,0,0,0,0
20200212,054350,美律國泰98購01,0.57,0.68,0.56,0.67,+0.15,28.85,742000,47,467830,0,0,0,0,0,0,397000,345000,52000,52000
20200212,054351,華新科國泰97購03,5.15,5.15,4.98,5.10,+0.11,2.2,108000,27,548530,0,0,0,0,0,0,108000,29000,79000,79000
20200212,054352,世芯國泰98購01,5.45,5.60,5.30,5.50,+0.10,1.85,312000,30,1707100,0,0,0,0,0,0,162000,65000,97000,97000
20200212,054353,世紀鋼國泰98購01,1.30,1.32,1.27,1.27,-0.03,-2.31,249000,30,322290,0,0,0,0,0,0,139000,112000,27000,27000
20200212,054354,技嘉富邦97購01,1.46,1.54,1.37,1.42,-0.02,-1.39,788000,87,1155720,0,0,0,0,0,0,467000,106000,361000,361000
20200212,054355,上海銀富邦98購01,0.33,0.35,0.33,0.35,0.00,0.00,23000,6,7780,0,0,0,0,0,0,17000,6000,11000,11000
20200212,054356,可成兆豐97購01,1.85,1.97,1.82,1.97,+0.22,12.57,214000,12,398440,0,0,0,0,0,0,42000,172000,-130000,-130000
20200212,054357,可成兆豐97購02,1.72,1.85,1.71,1.85,0.00,0.00,56000,8,98420,0,0,0,0,0,0,16000,40000,-24000,-24000
20200212,054358,矽創兆豐96購01,1.04,1.26,1.04,1.26,+0.20,18.87,296000,34,337740,0,0,0,0,0,0,116000,180000,-64000,-64000
20200212,054359,南亞科日盛96購02,1.00,1.01,0.98,1.00,-0.03,-2.91,295000,12,295000,0,0,0,0,0,0,220000,75000,145000,145000
20200212,05435P,鴻海群益95售12,4.32,4.32,4.22,4.22,-0.54,-11.34,8000,2,34460,0,0,0,0,0,0,7000,1000,6000,6000
20200212,054360,智邦凱基96購03,3.01,3.23,2.79,2.89,+0.15,5.47,121000,15,358450,0,0,0,0,0,0,105000,61000,44000,44000
20200212,054361,技嘉凱基96購01,1.53,1.61,1.48,1.52,-0.01,-0.65,529000,59,823120,0,0,0,0,0,0,337000,245000,92000,92000
20200212,054362,亞光凱基96購03,0.57,0.59,0.57,0.57,+0.11,23.91,90000,5,51750,0,0,0,0,0,0,50000,40000,10000,10000
20200212,054363,世芯凱基97購01,3.27,3.40,3.15,3.35,+0.16,5.02,206000,28,668140,0,0,0,0,0,0,196000,21000,175000,175000
20200212,054364,智伸科凱基96購01,1.62,1.68,1.57,1.57,-0.07,-4.27,735000,12,1201440,0,0,0,0,0,0,453000,282000,171000,171000
20200212,054365,遠東新中信96購01,,,,,0.00,0.00,0,0,0,0,0,0,0,0,0,0,0,0,0
20200212,054366,和大中信98購01,1.28,1.28,1.22,1.23,-0.05,-3.91,280000,5,346300,0,0,0,0,0,0,200000,80000,120000,120000
20200212,054367,鴻海中信98購03,0.41,0.46,0.41,0.46,+0.09,24.32,26000,7,11470,0,0,0,0,0,0,26000,0,26000,26000
20200212,054368,鴻海中信9A購02,,,,,0.00,0.00,0,0,0,0,0,0,0,0,0,0,0,0,0
20200212,054369,鴻海中信9C購01,0.36,0.46,0.36,0.46,+0.12,35.29,331000,26,126830,0,0,0,0,0,0,251000,79000,172000,172000
20200212,05436P,台積電群益95售07,0.75,0.75,0.70,0.70,-0.10,-12.5,15000,2,10750,0,0,0,0,0,0,0,15000,-15000,-15000
20200212,054370,台積電中信9A購01,1.70,1.75,1.67,1.75,+0.14,8.7,196000,8,331690,0,0,0,0,0,0,149000,47000,102000,102000
20200212,054371,台積電中信9C購01,1.43,1.47,1.41,1.47,+0.11,8.09,194000,25,278630,0,0,0,0,0,0,149000,45000,104000,104000
20200212,054372,南亞科中信96購01,0.66,0.66,0.66,0.66,+0.03,4.76,47000,4,31020,0,0,0,0,0,0,1000,46000,-45000,-45000
20200212,054373,富邦金中信97購01,0.63,0.66,0.63,0.65,+0.07,12.07,178000,5,114490,0,0,0,0,0,0,104000,74000,30000,30000
20200212,054374,信邦中信96購01,0.77,0.82,0.75,0.82,-0.01,-1.2,1018000,27,805270,0,0,0,0,0,0,350000,668000,-318000,-318000
20200212,054375,貿聯中信99購01,0.72,0.80,0.72,0.80,+0.09,12.68,102000,4,74100,0,0,0,0,0,0,0,102000,-102000,-102000
20200212,054376,聯茂中信97購01,0.80,1.14,0.80,1.00,+0.23,29.87,623000,42,601070,0,0,0,0,0,0,246000,377000,-131000,-131000
20200212,054377,臺股指中信99購09,0.69,0.76,0.69,0.73,+0.06,8.96,186000,27,133010,0,0,0,0,0,0,151000,34000,117000,117000
20200212,054378,楠梓電群益98購01,1.34,1.34,1.34,1.34,0.00,0.00,2000,1,2680,0,0,0,0,0,0,2000,0,2000,2000
20200212,054379,光磊群益98購01,0.63,0.65,0.62,0.62,-0.02,-3.12,504000,7,312560,0,0,0,0,0,0,6000,498000,-492000,-492000
20200212,05437P,聯詠永豐95售02,0.78,0.80,0.78,0.80,-0.04,-4.76,150000,3,118260,0,0,0,0,0,0,0,150000,-150000,-150000
20200212,054380,世芯群益97購02,2.73,2.88,2.63,2.82,+0.10,3.68,463000,33,1266390,0,0,0,0,0,0,427000,24000,403000,403000
20200212,054381,世芯群益98購01,2.30,2.42,2.23,2.42,+0.16,7.08,194000,32,443220,0,0,0,0,0,0,172000,29000,143000,143000
20200212,054382,康控群益96購03,0.90,1.04,0.89,1.01,+0.18,21.69,312000,34,305180,0,0,0,0,0,0,147000,175000,-28000,-28000
20200212,054383,傳奇群益97購01,1.25,1.25,1.22,1.22,-0.03,-2.4,164000,5,200410,0,0,0,0,0,0,59000,100000,-41000,-41000
20200212,054384,瀚宇博群益96購02,1.05,1.14,1.04,1.14,+0.04,3.64,22000,7,23620,0,0,0,0,0,0,9000,13000,-4000,-4000
20200212,054385,矽創群益98購01,1.55,1.81,1.55,1.81,+0.34,23.13,423000,46,709870,0,0,0,0,0,0,131000,292000,-161000,-161000
20200212,054386,鴻海統一98購03,0.83,1.12,0.83,1.12,+0.31,38.27,591000,12,578860,0,0,0,0,0,0,163000,428000,-265000,-265000
20200212,054387,台積電統一98購02,1.61,1.68,1.58,1.68,+0.14,9.09,546000,14,880410,0,0,0,0,0,0,221000,320000,-99000,-99000
20200212,054388,漢唐統一97購02,,,,,0.00,0.00,0,0,0,0,0,0,0,0,0,0,0,0,0
20200212,054389,為升元富96購02,0.98,0.98,0.95,0.95,-0.01,-1.04,235000,6,226950,0,0,0,0,0,0,120000,115000,5000,5000
20200212,05438P,康控永豐95售05,,,,,0.00,0.00,0,0,0,0,0,0,0,0,0,0,0,0,0
20200212,054390,智邦元富96購03,2.49,2.49,2.17,2.27,+0.07,3.18,700000,23,1604230,0,0,0,0,0,0,600000,117000,483000,483000
20200212,054391,宏達電元富96購04,,,,,0.00,0.00,0,0,0,0,0,0,0,0,0,0,0,0,0
20200212,054392,華通永豐96購05,0.29,0.50,0.29,0.46,+0.17,58.62,204000,12,95910,0,0,0,0,0,0,1000,203000,-202000,-202000
20200212,054393,漢唐永豐96購01,0.45,0.45,0.43,0.43,0.00,0.00,47000,2,21110,0,0,0,0,0,0,0,47000,-47000,-47000
20200212,054394,奇力新永豐96購03,0.69,0.73,0.69,0.73,0.00,0.00,453000,52,319060,0,0,0,0,0,0,270000,183000,87000,87000
20200212,054395,華新科永豐96購03,1.26,1.28,1.20,1.23,+0.02,1.65,788000,48,962930,0,0,0,0,0,0,346000,448000,-102000,-102000
20200212,054396,日電貿永豐96購02,0.58,0.59,0.55,0.59,+0.02,3.51,221000,23,125570,0,0,0,0,0,0,121000,99000,22000,22000
20200212,054397,創意永豐96購05,0.59,0.62,0.57,0.62,-0.11,-15.07,271000,24,163850,0,0,0,0,0,0,103000,168000,-65000,-65000
20200212,054398,牧德永豐96購03,2.11,2.12,1.90,1.91,-0.10,-4.98,182000,22,361370,0,0,0,0,0,0,74000,103000,-29000,-29000
20200212,054399,智易永豐96購03,,,,,0.00,0.00,0,0,0,0,0,0,0,0,0,0,0,0,0
20200212,05439P,聯發科國票95售06,,,,,0.00,0.00,0,0,0,0,0,0,0,0,0,0,0,0,0
20200212,054400,健策永豐96購02,0.70,0.83,0.63,0.81,+0.12,17.39,9667000,123,7037150,0,0,0,0,0,0,6351000,3569000,2782000,2782000
20200212,054401,康普永豐96購01,,,,,0.00,0.00,0,0,0,0,0,0,0,0,0,0,0,0,0
20200212,054402,康控永豐96購03,0.26,0.28,0.26,0.28,0.00,0.00,80000,6,22100,0,0,0,0,0,0,0,80000,-80000,-80000
20200212,054403,同欣電永豐96購02,0.58,0.69,0.58,0.69,+0.09,15.0,572000,34,372710,0,0,0,0,0,0,153000,419000,-266000,-266000
20200212,054404,新日興康和96購01,,,,,0.00,0.00,0,0,0,0,0,0,0,0,0,0,0,0,0
20200212,054405,樺漢康和96購01,0.72,0.72,0.72,0.72,0.00,0.00,35000,2,25200,0,0,0,0,0,0,0,35000,-35000,-35000
20200212,054406,旺宏國票98購01,2.82,2.82,2.69,2.69,+0.05,1.89,11000,2,30890,0,0,0,0,0,0,0,11000,-11000,-11000
20200212,054407,美律國票97購02,0.27,0.36,0.27,0.35,+0.11,45.83,170000,31,52290,0,0,0,0,0,0,60000,110000,-50000,-50000
20200212,054408,義隆國票98購01,1.88,1.92,1.78,1.86,+0.17,10.06,421000,30,788700,0,0,0,0,0,0,338000,83000,255000,255000
20200212,054409,亞光國票97購02,0.71,0.71,0.71,0.71,0.00,0.00,3000,1,2130,0,0,0,0,0,0,3000,0,3000,3000
20200212,05440P,緯穎國票96售02,0.38,0.38,0.38,0.38,0.00,0.00,65000,2,24700,0,0,0,0,0,0,0,65000,-65000,-65000
20200212,054410,國巨元大96購14,4.00,4.18,3.98,4.18,+0.31,8.01,230000,30,931850,0,0,0,0,0,0,196000,186000,10000,10000
20200212,054411,光磊元大97購02,1.01,1.02,0.99,0.99,+0.01,1.02,1070000,10,1090470,0,0,0,0,0,0,834000,0,834000,834000
20200212,054412,智邦元大96購03,3.20,3.30,3.20,3.30,+0.41,14.19,6000,4,19570,0,0,0,0,0,0,2000,4000,-2000,-2000
20200212,054413,台光電元大96購03,1.78,2.26,1.78,2.18,+0.42,23.86,136000,16,290550,0,0,0,0,0,0,20000,116000,-96000,-96000
20200212,054414,全新元大97購02,1.07,1.27,1.05,1.26,+0.29,29.9,327000,17,383260,0,0,0,0,0,0,156000,171000,-15000,-15000
20200212,054415,奇力新元大96購06,,,,,0.00,0.00,0,0,0,0,0,0,0,0,0,0,0,0,0
20200212,054416,禾伸堂元大97購01,2.79,2.79,2.79,2.79,0.00,0.00,1000,1,2790,0,0,0,0,0,0,0,1000,-1000,-1000
20200212,054417,牧德元大96購01,3.93,4.00,3.90,3.90,-0.02,-0.51,15000,4,59040,0,0,0,0,0,0,15000,0,15000,15000
20200212,054418,茂林元大97購01,3.99,4.08,3.95,3.99,+0.06,1.53,126000,30,504940,0,0,0,0,0,0,100000,98000,2000,2000
20200212,054419,嘉聯益元大98購02,1.91,2.02,1.91,1.95,+0.13,7.14,83000,5,165360,0,0,0,0,0,0,5000,78000,-73000,-73000
20200212,05441P,華通元大95售09,1.98,1.98,1.98,1.98,-0.53,-21.12,30000,2,59400,0,0,0,0,0,0,0,30000,-30000,-30000
20200212,054420,緯穎元大96購08,4.35,4.77,4.11,4.69,+0.25,5.63,248000,39,1116590,0,0,0,0,0,0,226000,192000,34000,34000
20200212,054421,臺股指元大99購03,,,,,0.00,0.00,0,0,0,0,0,0,0,0,0,0,0,0,0
20200212,054422,T50反1富邦9A購01,1.39,1.39,1.39,1.39,0.00,0.00,10000,1,13900,0,0,0,0,0,0,10000,0,10000,10000
20200212,054423,華新富邦96購01,,,,,0.00,0.00,0,0,0,0,0,0,0,0,0,0,0,0,0
20200212,054424,大成鋼富邦97購02,0.38,0.39,0.38,0.38,+0.01,2.7,20000,3,7700,0,0,0,0,0,0,10000,10000,0,0
20200212,054425,聯發科富邦99購03,0.51,0.57,0.51,0.57,+0.10,21.28,453000,19,241800,0,0,0,0,0,0,403000,100000,303000,303000
20200212,054426,國泰金富邦97購02,0.96,0.96,0.92,0.96,+0.02,2.13,690000,37,645430,0,0,0,0,0,0,519000,203000,316000,316000
20200212,054427,潤泰全富邦97購01,0.77,0.78,0.77,0.77,-0.02,-2.53,852000,13,658450,0,0,0,0,0,0,50000,802000,-752000,-752000
20200212,054428,禾伸堂富邦98購01,,,,,0.00,0.00,0,0,0,0,0,0,0,0,0,0,0,0,0
20200212,054429,中石化台新97購01,0.17,0.18,0.17,0.18,+0.01,5.88,200000,2,35000,0,0,0,0,0,0,100000,100000,0,0
20200212,05442P,鴻海元大96售13,3.38,3.48,3.07,3.07,-0.64,-17.25,220000,14,740750,0,0,0,0,0,0,197000,199000,-2000,-2000
20200212,054430,上銀台新96購02,1.95,1.98,1.95,1.98,+0.09,4.76,31000,4,60890,0,0,0,0,0,0,31000,0,31000,31000
20200212,054431,鴻海台新96購03,,,,,0.00,0.00,0,0,0,0,0,0,0,0,0,0,0,0,0
20200212,054432,台積電台新96購05,0.83,0.84,0.81,0.84,+0.04,5.0,81000,6,67230,0,0,0,0,0,0,71000,10000,61000,61000
20200212,054433,南亞科台新96購02,,,,,0.00,0.00,0,0,0,0,0,0,0,0,0,0,0,0,0
20200212,054434,友達台新96購03,1.39,1.39,1.30,1.30,-0.17,-11.56,28000,4,37300,0,0,0,0,0,0,3000,10000,-7000,-7000
20200212,054435,華新科台新97購02,2.62,2.62,2.54,2.58,+0.06,2.38,110000,7,284320,0,0,0,0,0,0,88000,22000,66000,66000
20200212,054436,高鐵台新97購02,0.91,0.91,0.91,0.91,0.00,0.00,16000,1,14560,0,0,0,0,0,0,0,16000,-16000,-16000
20200212,054437,欣興台新97購02,1.21,1.56,1.21,1.56,+0.28,21.88,266000,16,384200,0,0,0,0,0,0,118000,198000,-80000,-80000
20200212,054438,群創台新96購01,,,,,0.00,0.00,0,0,0,0,0,0,0,0,0,0,0,0,0
20200212,054439,健策台新96購03,1.86,2.10,1.75,2.10,+0.31,17.32,357000,31,655500,0,0,0,0,0,0,272000,47000,225000,225000
20200212,05443P,宏達電元大95售05,,,,,0.00,0.00,0,0,0,0,0,0,0,0,0,0,0,0,0
20200212,054440,TPK台新98購01,0.48,0.52,0.47,0.52,+0.05,10.64,140000,6,70210,0,0,0,0,0,0,49000,86000,-37000,-37000
20200212,054441,力成台新96購01,1.64,1.87,1.63,1.87,+0.39,26.35,444000,25,761070,0,0,0,0,0,0,34000,410000,-376000,-376000
20200212,054442,啟碁台新96購01,0.97,0.98,0.97,0.98,+0.03,3.16,62000,3,60660,0,0,0,0,0,0,62000,0,62000,62000
20200212,054443,樺漢台新96購02,0.66,0.69,0.66,0.69,0.00,0.00,100000,5,66660,0,0,0,0,0,0,0,100000,-100000,-100000
20200212,054444,緯穎台新97購01,,,,,0.00,0.00,0,0,0,0,0,0,0,0,0,0,0,0,0
20200212,054445,技嘉兆豐96購01,3.01,3.10,2.95,2.95,0.00,0.00,159000,18,475430,0,0,0,0,0,0,159000,0,159000,159000
20200212,054446,美食兆豐97購01,0.57,0.73,0.57,0.68,+0.09,15.25,612000,23,402070,0,0,0,0,0,0,297000,315000,-18000,-18000
20200212,054447,國泰金兆豐96購01,0.92,0.93,0.90,0.93,+0.03,3.33,327000,17,298760,0,0,0,0,0,0,239000,88000,151000,151000
20200212,054448,矽力兆豐96購01,3.71,3.82,3.66,3.82,+0.25,7.0,60000,5,226300,0,0,0,0,0,0,30000,30000,0,0
20200212,054449,中環第一96購01,0.46,0.47,0.44,0.46,-0.08,-14.81,657000,33,303680,0,0,0,0,0,0,637000,20000,617000,617000
20200212,05444P,大立光元大95售10,0.51,0.51,0.49,0.49,0.00,0.00,240000,5,119500,0,0,0,0,0,0,0,240000,-240000,-240000
20200212,054450,聯茂第一96購01,0.54,0.72,0.54,0.67,+0.20,42.55,371000,52,248760,20000,0,20000,0,0,0,5000,366000,-361000,-341000
20200212,054451,上銀亞東98購01,,,,,0.00,0.00,0,0,0,0,0,0,0,0,0,0,0,0,0
20200212,054452,華通亞東96購01,0.54,0.80,0.54,0.80,+0.38,90.48,248000,13,185260,0,0,0,0,0,0,2000,246000,-244000,-244000
20200212,054453,上海銀亞東96購01,0.58,0.60,0.58,0.60,0.00,0.00,50000,3,29960,0,0,0,0,0,0,2000,48000,-46000,-46000
20200212,054454,滬深2X群益96購04,,,,,0.00,0.00,0,0,0,0,0,0,0,0,0,0,0,0,0
20200212,054455,楠梓電群益98購02,,,,,0.00,0.00,0,0,0,0,0,0,0,0,0,0,0,0,0
20200212,054456,華泰群益99購01,0.70,0.72,0.70,0.72,+0.04,5.88,343000,8,245230,0,0,0,0,0,0,92000,333000,-241000,-241000
20200212,054457,強茂群益96購01,1.26,1.28,1.24,1.27,+0.06,4.96,171000,11,216860,0,0,0,0,0,0,98000,73000,25000,25000
20200212,054458,復盛群益96購01,3.65,3.69,3.57,3.61,-0.05,-1.37,174000,27,633280,0,0,0,0,0,0,164000,22000,142000,142000
20200212,054459,鈺齊群益96購01,1.20,1.36,1.18,1.36,+0.15,12.4,183000,13,229480,0,0,0,0,0,0,111000,102000,9000,9000
20200212,05445P,聯詠元大95售05,,,,,0.00,0.00,0,0,0,0,0,0,0,0,0,0,0,0,0
20200212,054460,和大凱基97購01,0.97,1.05,0.97,1.05,0.00,0.00,83000,5,83770,0,0,0,0,0,0,70000,43000,27000,27000
20200212,054461,台積電凱基97購09,1.36,1.39,1.35,1.39,+0.12,9.45,116000,3,156790,0,0,0,0,0,0,15000,116000,-101000,-101000
20200212,054462,旺宏凱基96購08,1.56,1.62,1.53,1.53,-0.03,-1.92,132000,7,206220,0,0,0,0,0,0,132000,81000,51000,51000
20200212,054463,瑞昱凱基97購01,2.59,2.59,2.49,2.49,+0.25,11.16,354000,5,886760,0,0,0,0,0,0,354000,5000,349000,349000
20200212,054464,奇力新凱基98購02,0.57,0.59,0.56,0.58,+0.01,1.75,102000,37,58270,0,0,0,0,0,0,61000,20000,41000,41000
20200212,054465,亞光凱基97購01,0.13,0.16,0.13,0.16,+0.03,23.08,857000,20,121780,0,0,0,0,0,0,260000,407000,-147000,-147000
20200212,054466,欣興凱基97購03,1.23,1.51,1.23,1.51,+0.32,26.89,37000,10,50990,0,0,0,0,0,0,13000,36000,-23000,-23000
20200212,054467,隆達凱基97購01,0.49,0.55,0.49,0.55,+0.06,12.24,119000,4,63340,0,0,0,0,0,0,118000,1000,117000,117000
20200212,054468,台郡凱基98購01,1.35,1.37,1.34,1.37,+0.50,57.47,31000,13,42210,0,0,0,0,0,0,20000,0,20000,20000
20200212,054469,同欣電凱基97購01,0.87,1.04,0.87,0.98,+0.13,15.29,40000,21,37860,0,0,0,0,0,0,20000,20000,0,0
20200212,05446P,緯穎元大95售04,0.33,0.33,0.33,0.33,-0.05,-13.16,250000,3,82500,0,0,0,0,0,0,0,250000,-250000,-250000
20200212,054470,緯穎國票97購04,6.95,7.95,6.95,7.95,+0.75,10.42,18000,8,128250,0,0,0,0,0,0,18000,0,18000,18000
20200212,054471,T50反1中信9C購01,1.70,1.70,1.66,1.66,-0.06,-3.49,13000,2,21980,0,0,0,0,0,0,0,13000,-13000,-13000
20200212,054472,道瓊反中信9A購01,,,,,0.00,0.00,0,0,0,0,0,0,0,0,0,0,0,0,0
20200212,054473,鴻海中信96購02,0.68,0.77,0.67,0.77,+0.11,16.67,322000,15,228400,0,0,0,0,0,0,322000,0,322000,322000
20200212,054474,鴻海中信96購03,0.67,0.70,0.67,0.70,+0.18,34.62,20000,2,13700,0,0,0,0,0,0,0,20000,-20000,-20000
20200212,054475,鴻海中信96購04,0.69,0.80,0.69,0.80,+0.16,25.0,166000,5,121500,0,0,0,0,0,0,80000,86000,-6000,-6000
20200212,054476,聯發科中信96購03,,,,,0.00,0.00,0,0,0,0,0,0,0,0,0,0,0,0,0
20200212,054477,聯發科中信9C購02,0.37,0.42,0.37,0.41,+0.07,20.59,166000,17,67170,0,0,0,0,0,0,39000,124000,-85000,-85000
20200212,054478,可成中信97購01,0.81,0.85,0.80,0.85,+0.11,14.86,167000,4,135140,0,0,0,0,0,0,102000,65000,37000,37000
20200212,054479,緯創中信98購01,1.15,1.18,1.14,1.18,+0.02,1.72,81000,5,94120,0,0,0,0,0,0,22000,59000,-37000,-37000
20200212,05447P,臺股指元大95售24,1.52,1.52,1.36,1.41,-0.15,-9.62,155000,37,221770,0,0,0,0,0,0,28000,127000,-99000,-99000
20200212,054480,和碩中信98購01,0.55,0.55,0.52,0.52,0.00,0.00,7000,2,3670,0,0,0,0,0,0,6000,1000,5000,5000
20200212,054481,鎧勝中信96購01,0.67,0.67,0.67,0.67,0.00,0.00,10000,1,6700,0,0,0,0,0,0,0,10000,-10000,-10000
20200212,054482,大成鋼台新96購01,0.49,0.51,0.48,0.51,+0.02,4.08,47000,4,23170,0,0,0,0,0,0,47000,0,47000,47000
20200212,054483,聯電台新96購01,0.99,1.09,0.96,1.09,+0.03,2.83,500000,38,508140,0,0,0,0,0,0,448000,0,448000,448000
20200212,054484,仁寶台新96購01,0.68,0.73,0.68,0.73,+0.05,7.35,130000,4,89400,0,0,0,0,0,0,38000,92000,-54000,-54000
20200212,054485,華邦電台新96購01,,,,,0.00,0.00,0,0,0,0,0,0,0,0,0,0,0,0,0
20200212,054486,漢唐台新96購01,0.72,0.79,0.72,0.76,+0.05,7.04,100000,6,76150,0,0,0,0,0,0,55000,45000,10000,10000
20200212,054487,京元電台新97購01,0.94,1.04,0.94,1.03,+0.02,1.98,424000,37,417250,0,0,0,0,0,0,242000,131000,111000,111000
20200212,054488,禾伸堂台新96購01,0.99,1.02,0.97,1.02,-0.02,-1.92,255000,26,249900,0,0,0,0,0,0,79000,176000,-97000,-97000
20200212,054489,牧德台新97購02,,,,,0.00,0.00,0,0,0,0,0,0,0,0,0,0,0,0,0
20200212,05448P,臺股指元大95售25,1.55,1.55,1.46,1.48,-0.22,-12.94,260000,4,383500,0,0,0,0,0,0,210000,50000,160000,160000
20200212,054490,臻鼎台新96購02,0.69,0.69,0.61,0.61,+0.09,17.31,255000,3,170030,0,0,0,0,0,0,136000,119000,17000,17000
20200212,054491,瀚宇博台新96購02,0.52,0.53,0.52,0.53,0.00,0.00,43000,3,22590,0,0,0,0,0,0,43000,0,43000,43000
20200212,054492,嘉聯益台新96購01,0.53,0.60,0.53,0.60,+0.07,13.21,199000,11,113630,0,0,0,0,0,0,78000,121000,-43000,-43000
20200212,054493,同欣電台新96購01,0.72,0.84,0.72,0.72,+0.01,1.41,780000,37,612030,0,0,0,0,0,0,243000,468000,-225000,-225000
20200212,054494,訊芯台新96購01,0.88,0.93,0.88,0.93,+0.12,14.81,25000,2,22250,0,0,0,0,0,0,20000,5000,15000,15000
20200212,054495,滬深2X永豐97購02,,,,,0.00,0.00,0,0,0,0,0,0,0,0,0,0,0,0,0
20200212,054496,為升永豐96購01,,,,,0.00,0.00,0,0,0,0,0,0,0,0,0,0,0,0,0
20200212,054497,國巨永豐96購05,1.15,1.18,1.05,1.18,+0.13,12.38,2261000,37,2528110,0,0,0,0,0,0,2051000,205000,1846000,1846000
20200212,054498,燿華永豐96購06,0.66,0.77,0.66,0.77,+0.09,13.24,152000,11,113720,0,0,0,0,0,0,12000,140000,-128000,-128000
20200212,054499,台光電永豐96購02,0.43,0.43,0.43,0.43,+0.08,22.86,78000,1,33540,0,0,0,0,0,0,78000,0,78000,78000
20200212,05449P,臺股指元大95售26,1.16,1.16,1.04,1.07,-0.16,-13.01,749000,31,823960,0,0,0,0,0,0,36000,713000,-677000,-677000
20200212,054500,美律永豐96購02,0.22,0.23,0.22,0.23,+0.06,35.29,205000,3,45150,0,0,0,0,0,0,0,205000,-205000,-205000
20200212,054501,強茂永豐96購02,0.36,0.36,0.36,0.36,+0.02,5.88,110000,3,39600,0,0,0,0,0,0,0,110000,-110000,-110000
20200212,054502,泰碩永豐96購01,,,,,0.00,0.00,0,0,0,0,0,0,0,0,0,0,0,0,0
20200212,054503,京鼎永豐96購04,0.64,0.77,0.64,0.77,+0.18,30.51,219000,17,157810,0,0,0,0,0,0,2000,217000,-215000,-215000
20200212,054504,聯鈞永豐96購01,1.26,1.55,1.26,1.54,+0.33,27.27,425000,14,613060,0,0,0,0,0,0,103000,322000,-219000,-219000
20200212,054505,揚明光永豐97購02,0.49,0.49,0.49,0.49,+0.06,13.95,2000,1,980,0,0,0,0,0,0,2000,0,2000,2000
20200212,054506,矽格永豐96購01,0.67,0.70,0.67,0.70,+0.06,9.38,38000,3,25510,0,0,0,0,0,0,36000,2000,34000,34000
20200212,054507,鈺齊永豐96購01,0.63,0.69,0.63,0.69,+0.05,7.81,170000,4,112220,0,0,0,0,0,0,120000,50000,70000,70000
20200212,054508,臺股指永豐96購04,0.92,1.07,0.92,1.07,0.00,0.00,32000,2,32740,0,0,0,0,0,0,10000,22000,-12000,-12000
20200212,054509,上証反元大99購01,0.64,0.68,0.64,0.68,+0.04,6.25,130000,6,83350,0,0,0,0,0,0,110000,19000,91000,91000
20200212,05450P,臺股指元大95售27,1.27,1.27,1.11,1.14,-0.18,-13.64,211000,14,244890,0,0,0,0,0,0,54000,157000,-103000,-103000
20200212,054510,S&P反1元大98購01,0.72,0.72,0.72,0.72,-0.01,-1.37,299000,1,215280,0,0,0,0,0,0,299000,0,299000,299000
20200212,054511,香港反元大98購01,0.85,0.85,0.82,0.85,-0.01,-1.16,29000,5,24230,0,0,0,0,0,0,0,29000,-29000,-29000
20200212,054512,元油反元大99購03,,,,,0.00,0.00,0,0,0,0,0,0,0,0,0,0,0,0,0
20200212,054513,元金2X元大96購01,,,,,0.00,0.00,0,0,0,0,0,0,0,0,0,0,0,0,0
20200212,054514,道瓊銀元大98購01,1.18,1.18,1.17,1.17,0.00,0.00,28000,2,32910,0,0,0,0,0,0,13000,28000,-15000,-15000
20200212,054515,華通元大98購02,1.58,2.19,1.51,2.19,+0.66,43.14,169000,29,311780,0,0,0,0,0,0,113000,107000,6000,6000
20200212,054516,國巨元大97購02,2.40,2.56,2.40,2.56,+0.16,6.67,210000,14,526150,0,0,0,0,0,0,165000,45000,120000,120000
20200212,054517,高鐵元大96購01,1.24,1.34,1.24,1.33,+0.05,3.91,215000,7,278120,0,0,0,0,0,0,4000,215000,-211000,-211000
20200212,054518,亞光元大97購01,0.42,0.49,0.41,0.49,+0.08,19.51,484000,17,211160,0,0,0,0,0,0,230000,254000,-24000,-24000
20200212,054519,禾伸堂元大97購02,1.56,1.56,1.54,1.54,+0.02,1.32,3000,3,4660,0,0,0,0,0,0,3000,0,3000,3000
20200212,05451P,臺股指元大95售28,,,,,0.00,0.00,0,0,0,0,0,0,0,0,0,0,0,0,0
20200212,054520,健鼎元大96購02,0.75,1.08,0.75,1.08,+0.39,56.52,723000,38,695320,0,0,0,0,0,0,225000,614000,-389000,-389000
20200212,054521,TPK元大96購03,0.36,0.43,0.35,0.43,+0.06,16.22,211000,12,76430,0,0,0,0,0,0,210000,1000,209000,209000
20200212,054522,康友元大96購07,3.39,3.54,3.39,3.53,+0.26,7.95,141000,13,491730,0,0,0,0,0,0,37000,141000,-104000,-104000
20200212,054523,GIS元大96購05,0.84,0.96,0.84,0.96,+0.14,17.07,110000,5,102840,0,0,0,0,0,0,11000,99000,-88000,-88000
20200212,054524,華通元富96購03,0.40,0.63,0.40,0.59,+0.25,73.53,275000,18,140400,0,0,0,0,0,0,100000,175000,-75000,-75000
20200212,054525,奇鋐元富96購01,0.46,0.49,0.46,0.49,+0.05,11.36,105000,3,49950,0,0,0,0,0,0,0,105000,-105000,-105000
20200212,054526,道瓊反統一98購01,,,,,0.00,0.00,0,0,0,0,0,0,0,0,0,0,0,0,0
20200212,054527,國巨統一97購03,3.62,3.63,3.55,3.63,+0.19,5.52,87000,6,314600,0,0,0,0,0,0,57000,30000,27000,27000
20200212,054528,台光電統一96購02,1.12,1.26,1.12,1.26,+0.26,26.0,107000,2,133840,0,0,0,0,0,0,107000,0,107000,107000
20200212,054529,T50反1國泰97購02,,,,,0.00,0.00,0,0,0,0,0,0,0,0,0,0,0,0,0
20200212,05452P,亞德客群益95售02,,,,,0.00,0.00,0,0,0,0,0,0,0,0,0,0,0,0,0
20200212,054530,台光電國泰97購03,,,,,0.00,0.00,0,0,0,0,0,0,0,0,0,0,0,0,0
20200212,054531,聯發科國泰97購02,0.84,0.93,0.84,0.93,+0.21,29.17,40000,3,35800,0,0,0,0,0,0,20000,20000,0,0
20200212,054532,強茂國泰98購01,0.87,0.91,0.87,0.91,+0.06,7.06,328000,27,293420,0,0,0,0,0,0,136000,212000,-76000,-76000
20200212,054533,泰碩國泰98購01,0.54,0.56,0.54,0.55,0.00,0.00,30000,3,16500,0,0,0,0,0,0,20000,10000,10000,10000
20200212,054534,台積電富邦98購03,0.51,0.55,0.50,0.53,+0.04,8.16,1318000,22,687220,0,0,0,0,0,0,165000,1133000,-968000,-968000
20200212,054535,旺宏富邦97購02,1.32,1.36,1.28,1.28,-0.04,-3.03,44000,12,57940,0,0,0,0,0,0,29000,23000,6000,6000
20200212,054536,宏達電富邦97購03,,,,,0.00,0.00,0,0,0,0,0,0,0,0,0,0,0,0,0
20200212,054537,南亞科亞東97購01,,,,,0.00,0.00,0,0,0,0,0,0,0,0,0,0,0,0,0
20200212,054538,台光電國票98購01,0.96,1.15,0.96,1.15,+0.35,43.75,71000,4,70250,0,0,0,0,0,0,1000,70000,-69000,-69000
20200212,054539,欣興國票98購01,0.95,1.20,0.95,1.19,+0.38,46.91,127000,10,129760,0,0,0,0,0,0,40000,87000,-47000,-47000
20200212,05453P,智邦群益95售03,0.91,0.96,0.91,0.96,-0.07,-6.8,173000,5,162950,0,0,0,0,0,0,0,173000,-173000,-173000
20200212,054540,泰鼎國票99購01,1.57,1.67,1.50,1.51,+0.02,1.34,219000,25,347990,0,0,0,0,0,0,105000,109000,-4000,-4000
20200212,054541,康控國票98購01,0.80,0.93,0.78,0.91,+0.12,15.19,384000,24,323870,0,0,0,0,0,0,166000,218000,-52000,-52000
20200212,054542,台表科國票98購01,1.35,1.35,1.35,1.35,+0.08,6.3,12000,1,16200,0,0,0,0,0,0,12000,0,12000,12000
20200212,054543,元金2X中信01購01,1.13,1.13,1.13,1.13,0.00,0.00,10000,1,11300,0,0,0,0,0,0,10000,0,10000,10000
20200212,054544,統一中信97購01,0.87,0.87,0.85,0.85,-0.08,-8.6,276000,6,235960,0,0,0,0,0,0,122000,154000,-32000,-32000
20200212,054545,奇力新中信98購01,0.73,0.77,0.69,0.77,+0.05,6.94,987000,71,716010,0,0,0,0,0,0,684000,259000,425000,425000
20200212,054546,玉晶光中信9B購01,0.62,0.66,0.60,0.63,+0.06,10.53,1206000,36,747340,0,0,0,0,0,0,416000,780000,-364000,-364000
20200212,054547,鴻海凱基98購02,0.93,1.21,0.93,1.21,+0.28,30.11,139000,5,143930,0,0,0,0,0,0,68000,71000,-3000,-3000
20200212,054548,鴻海凱基98購03,1.00,1.13,1.00,1.13,+0.21,22.83,138000,4,142950,0,0,0,0,0,0,70000,68000,2000,2000
20200212,054549,台積電凱基98購01,2.76,2.76,2.76,2.76,+0.14,5.34,10000,1,27600,0,0,0,0,0,0,10000,0,10000,10000
20200212,05454P,奇鋐群益95售04,2.22,2.24,2.22,2.24,0.00,0.00,21000,2,46840,0,0,0,0,0,0,0,21000,-21000,-21000
20200212,054550,旺宏凱基98購02,1.65,1.65,1.65,1.65,+0.02,1.23,1000,1,1650,0,0,0,0,0,0,1000,1000,0,0
20200212,054551,聯發科凱基98購02,0.74,0.74,0.74,0.74,+0.06,8.82,50000,1,37000,0,0,0,0,0,0,0,50000,-50000,-50000
20200212,054552,聯發科凱基98購03,0.63,0.68,0.63,0.68,+0.20,41.67,501000,14,320600,0,0,0,0,0,0,190000,311000,-121000,-121000
20200212,054553,宏達電凱基99購01,0.48,0.48,0.48,0.48,0.00,0.00,40000,1,19200,0,0,0,0,0,0,0,40000,-40000,-40000
20200212,054554,大立光凱基98購02,,,,,0.00,0.00,0,0,0,0,0,0,0,0,0,0,0,0,0
20200212,054555,欣興凱基98購01,1.19,1.42,1.19,1.42,+0.21,17.36,37000,9,49270,0,0,0,0,0,0,31000,22000,9000,9000
20200212,054556,世芯凱基99購01,0.44,0.45,0.41,0.44,-0.01,-2.22,1869000,61,817940,0,0,0,0,0,0,616000,1243000,-627000,-627000
20200212,054557,臻鼎凱基98購01,,,,,0.00,0.00,0,0,0,0,0,0,0,0,0,0,0,0,0
20200212,054558,劍麟群益99購01,0.79,0.85,0.79,0.85,+0.06,7.59,650000,17,533610,0,0,0,0,0,0,11000,639000,-628000,-628000
20200212,054559,台光電群益99購01,0.95,1.29,0.95,1.18,+0.25,26.88,260000,47,297870,0,0,0,0,0,0,33000,227000,-194000,-194000
20200212,05455P,聯詠日盛95售01,,,,,0.00,0.00,0,0,0,0,0,0,0,0,0,0,0,0,0
20200212,054560,全新群益98購03,0.89,1.19,0.89,1.19,+0.38,46.91,100000,20,104150,0,0,0,0,0,0,29000,71000,-42000,-42000
20200212,054561,奇力新群益97購03,0.93,1.20,0.92,1.20,0.00,0.00,520000,5,481290,0,0,0,0,0,0,501000,0,501000,501000
20200212,054562,亞光群益98購01,0.56,0.69,0.56,0.66,+0.12,22.22,195000,11,116630,0,0,0,0,0,0,25000,170000,-145000,-145000
20200212,054563,泰碩群益99購01,0.70,0.70,0.69,0.69,0.00,0.00,44000,2,30690,0,0,0,0,0,0,44000,0,44000,44000
20200212,054564,玉晶光群益99購01,2.10,2.28,2.10,2.22,+0.17,8.29,380000,24,828300,0,0,0,0,0,0,216000,262000,-46000,-46000
20200212,054565,玉晶光群益99購02,4.00,4.37,3.98,4.23,+0.42,11.02,107000,14,445410,0,0,0,0,0,0,58000,49000,9000,9000
20200212,054566,貿聯群益97購02,0.92,1.09,0.92,1.09,+0.17,18.48,133000,10,135670,0,0,0,0,0,0,25000,113000,-88000,-88000
20200212,054567,拓凱群益98購01,0.90,0.90,0.90,0.90,+0.02,2.27,10000,1,9000,0,0,0,0,0,0,0,10000,-10000,-10000
20200212,054568,訊芯群益97購01,0.98,1.20,0.98,1.17,+0.19,19.39,200000,14,220200,0,0,0,0,0,0,122000,78000,44000,44000
20200212,054569,GIS群益98購01,1.05,1.12,1.05,1.12,+0.08,7.69,164000,4,179170,0,0,0,0,0,0,55000,109000,-54000,-54000
20200212,05456P,鴻海凱基95售19,0.79,0.79,0.72,0.72,0.00,0.00,9000,2,6830,0,0,0,0,0,0,5000,4000,1000,1000
20200212,054570,易華電群益98購01,1.05,1.05,1.05,1.05,0.00,0.00,10000,1,10500,0,0,0,0,0,0,10000,0,10000,10000
20200212,054571,楠梓電元大99購01,1.14,1.24,1.14,1.21,0.00,0.00,353000,15,420200,0,0,0,0,0,0,239000,353000,-114000,-114000
20200212,054572,國巨元大98購03,2.61,2.64,2.50,2.64,+0.19,7.76,192000,28,494470,0,0,0,0,0,0,136000,87000,49000,49000
20200212,054573,漢唐元大98購01,1.19,1.25,1.19,1.21,+0.03,2.54,330000,16,403050,0,0,0,0,0,0,280000,50000,230000,230000
20200212,054574,美律元大99購01,0.62,0.74,0.62,0.73,+0.16,28.07,1580000,44,1079860,0,0,0,0,0,0,43000,1527000,-1484000,-1484000
20200212,054575,聯鈞元大97購01,2.07,2.46,2.07,2.43,+0.44,22.11,483000,43,1097770,0,0,0,0,0,0,208000,351000,-143000,-143000
20200212,054576,健策元大98購03,1.92,2.09,1.80,2.09,+0.28,15.47,632000,59,1218570,0,0,0,0,0,0,484000,300000,184000,184000
20200212,054577,世芯元大98購01,1.00,1.08,0.97,1.08,+0.02,1.89,675000,36,690670,0,0,0,0,0,0,292000,353000,-61000,-61000
20200212,054578,世芯元大99購01,1.14,1.25,1.11,1.18,+0.02,1.72,381000,35,443190,0,0,0,0,0,0,301000,79000,222000,222000
20200212,054579,聯茂元大97購01,2.64,3.29,2.64,3.29,+0.91,38.24,148000,15,444740,0,0,0,0,0,0,18000,130000,-112000,-112000
20200212,05457P,鴻海凱基95售20,,,,,0.00,0.00,0,0,0,0,0,0,0,0,0,0,0,0,0
20200212,054580,樺漢元大98購01,0.80,0.86,0.80,0.86,+0.08,10.26,6000,2,4860,0,0,0,0,0,0,0,6000,-6000,-6000
20200212,054581,訊芯元大97購02,0.97,1.11,0.97,1.11,+0.14,14.43,495000,26,509730,0,0,0,0,0,0,186000,358000,-172000,-172000
20200212,054582,致新元大97購01,0.99,1.03,0.98,1.03,+0.01,0.98,96000,5,96350,0,0,0,0,0,0,86000,10000,76000,76000
20200212,054583,玉晶光統一97購02,0.68,0.74,0.67,0.73,+0.10,15.87,323000,12,229230,0,0,0,0,0,0,106000,217000,-111000,-111000
20200212,054584,貿聯元富97購01,1.19,1.37,1.18,1.37,+0.20,17.09,393000,29,510040,0,0,0,0,0,0,167000,226000,-59000,-59000
20200212,054585,禾伸堂國泰99購01,,,,,0.00,0.00,0,0,0,0,0,0,0,0,0,0,0,0,0
20200212,054586,健鼎國泰99購01,1.05,1.28,0.98,1.19,+0.38,46.91,78000,14,88520,0,0,0,0,0,0,2000,76000,-74000,-74000
20200212,054587,玉晶光國泰99購01,2.58,2.75,2.55,2.72,+0.28,11.48,249000,31,657500,0,0,0,0,0,0,75000,174000,-99000,-99000
20200212,054588,玉晶光國泰99購02,1.39,1.48,1.37,1.48,+0.15,11.28,120000,14,169200,0,0,0,0,0,0,53000,67000,-14000,-14000
20200212,054589,聯鈞國泰99購01,1.66,1.90,1.66,1.90,+0.31,19.5,486000,33,855360,0,0,0,0,0,0,282000,300000,-18000,-18000
20200212,05458P,台積電凱基97售02,0.69,0.69,0.69,0.69,-0.08,-10.39,35000,2,24150,0,0,0,0,0,0,0,35000,-35000,-35000
20200212,054590,嘉聯益國泰98購01,1.15,1.23,1.12,1.17,+0.08,7.34,353000,50,412350,0,0,0,0,0,0,333000,102000,231000,231000
20200212,054591,GIS國泰98購01,0.77,0.87,0.77,0.86,+0.09,11.69,49000,16,41150,0,0,0,0,0,0,11000,41000,-30000,-30000
20200212,054592,美律永昌9A購01,0.58,0.58,0.58,0.58,0.00,0.00,10000,1,5800,0,0,0,0,0,0,0,10000,-10000,-10000
20200212,054593,滬深2X永昌9A購01,1.90,1.90,1.90,1.90,-0.10,-5.0,182000,1,345800,0,0,0,0,0,0,182000,0,182000,182000
20200212,054594,國巨麥證97購01,2.88,2.99,2.81,2.99,+0.35,13.26,107000,13,309090,67000,40000,27000,0,0,0,67000,40000,27000,27000
20200212,054595,正崴麥證97購01,,,,,0.00,0.00,0,0,0,0,0,0,0,0,0,0,0,0,0
20200212,054596,聯發科麥證97購01,0.37,0.40,0.35,0.40,+0.08,25.0,60000,3,22700,60000,0,60000,0,0,0,60000,0,60000,60000
20200212,054597,南亞台新97購01,0.52,0.52,0.52,0.52,0.00,0.00,82000,3,42640,0,0,0,0,0,0,82000,0,82000,82000
20200212,054598,鴻海台新98購01,0.21,0.21,0.21,0.21,+0.02,10.53,110000,1,23100,0,0,0,0,0,0,110000,0,110000,110000
20200212,054599,正崴台新97購01,,,,,0.00,0.00,0,0,0,0,0,0,0,0,0,0,0,0,0
20200212,05459P,聯詠凱基95售03,1.67,1.67,1.67,1.67,0.00,0.00,6000,1,10020,0,0,0,0,0,0,0,6000,-6000,-6000
20200212,054600,中壽台新97購01,0.70,0.70,0.69,0.69,-0.02,-2.82,20000,2,13900,0,0,0,0,0,0,10000,10000,0,0
20200212,054601,奇鋐台新98購01,0.39,0.44,0.39,0.42,+0.02,5.0,169000,6,70530,0,0,0,0,0,0,10000,159000,-149000,-149000
20200212,054602,聯詠台新97購01,,,,,0.00,0.00,0,0,0,0,0,0,0,0,0,0,0,0,0
20200212,054603,智易台新98購01,0.61,0.79,0.61,0.79,+0.18,29.51,418000,12,292190,0,0,0,0,0,0,55000,363000,-308000,-308000
20200212,054604,麗豐台新98購01,0.49,0.49,0.48,0.48,+0.04,9.09,20000,2,9700,0,0,0,0,0,0,0,20000,-20000,-20000
20200212,054605,鴻海永豐97購01,0.39,0.39,0.39,0.39,+0.07,21.88,30000,1,11700,0,0,0,0,0,0,30000,0,30000,30000
20200212,054606,台積電永豐97購02,0.43,0.47,0.42,0.47,+0.08,20.51,453000,10,201210,0,0,0,0,0,0,433000,18000,415000,415000
20200212,054607,台積電永豐97購03,0.97,1.00,0.97,1.00,+0.06,6.38,127000,5,124030,0,0,0,0,0,0,96000,31000,65000,65000
20200212,054608,致茂永豐97購01,0.80,0.98,0.80,0.97,+0.20,25.97,1304000,53,1164120,0,0,0,0,0,0,290000,1009000,-719000,-719000
20200212,054609,正崴永豐97購01,,,,,0.00,0.00,0,0,0,0,0,0,0,0,0,0,0,0,0
20200212,05460P,台郡凱基95售05,0.26,0.26,0.25,0.25,0.00,0.00,120000,4,30100,0,0,0,0,0,0,0,120000,-120000,-120000
20200212,054610,聯發科永豐97購01,0.48,0.50,0.48,0.50,0.00,0.00,2000,2,980,0,0,0,0,0,0,1000,1000,0,0
20200212,054611,全新永豐97購01,0.49,0.57,0.49,0.57,+0.13,29.55,115000,4,60950,0,0,0,0,0,0,10000,105000,-95000,-95000
20200212,054612,慧洋永豐97購01,,,,,0.00,0.00,0,0,0,0,0,0,0,0,0,0,0,0,0
20200212,054613,大立光永豐97購02,1.09,1.28,1.09,1.28,+0.21,19.63,83000,3,99690,0,0,0,0,0,0,13000,70000,-57000,-57000
20200212,054614,玉晶光永豐97購03,0.96,1.12,0.96,1.11,+0.17,18.09,454000,24,479960,0,0,0,0,0,0,262000,192000,70000,70000
20200212,054615,牧德永豐98購01,1.57,1.70,1.56,1.60,-0.01,-0.62,36000,6,57370,0,0,0,0,0,0,26000,10000,16000,16000
20200212,054616,智伸科永豐97購01,0.71,0.71,0.71,0.71,+0.02,2.9,70000,1,49700,0,0,0,0,0,0,70000,0,70000,70000
20200212,054617,超眾永豐97購01,0.27,0.29,0.27,0.29,0.00,0.00,411000,5,116070,0,0,0,0,0,0,321000,90000,231000,231000
20200212,054618,訊芯永豐97購01,0.40,0.46,0.40,0.45,+0.07,18.42,350000,11,157000,0,0,0,0,0,0,90000,260000,-170000,-170000
20200212,054619,昇陽半永豐97購03,,,,,0.00,0.00,0,0,0,0,0,0,0,0,0,0,0,0,0
20200212,05461P,台積電亞東97售01,0.40,0.40,0.40,0.40,-0.04,-9.09,10000,2,4000,0,0,0,0,0,0,0,10000,-10000,-10000
20200212,054620,南茂永豐97購01,0.42,0.44,0.42,0.44,0.00,0.00,27000,4,11480,0,0,0,0,0,0,17000,10000,7000,7000
20200212,054621,華新科兆豐98購01,1.59,1.59,1.53,1.55,+0.05,3.33,70000,6,108300,0,0,0,0,0,0,15000,40000,-25000,-25000
20200212,054622,漢唐第一97購01,0.52,0.55,0.52,0.55,+0.03,5.77,197000,3,105590,0,0,0,0,0,0,92000,105000,-13000,-13000
20200212,054623,華新科第一97購01,0.75,0.76,0.73,0.75,+0.03,4.17,792000,33,591250,0,0,0,0,0,0,198000,574000,-376000,-376000
20200212,054624,台積電凱基98購03,1.18,1.20,1.18,1.20,+0.07,6.19,60000,5,71400,0,0,0,0,0,0,60000,0,60000,60000
20200212,054625,旺宏凱基98購03,1.83,1.83,1.80,1.80,-0.02,-1.1,3000,3,5430,0,0,0,0,0,0,3000,3000,0,0
20200212,054626,建準凱基98購01,,,,,0.00,0.00,0,0,0,0,0,0,0,0,0,0,0,0,0
20200212,054627,義隆凱基98購01,1.20,1.20,1.16,1.16,0.00,0.00,78000,5,91400,0,0,0,0,0,0,8000,60000,-52000,-52000
20200212,054628,可成凱基98購01,1.64,1.83,1.64,1.83,+0.28,18.06,51000,4,87640,0,0,0,0,0,0,34000,7000,27000,27000
20200212,054629,華新科凱基98購01,1.71,1.71,1.62,1.68,+0.09,5.66,102000,16,169430,0,30000,-30000,0,0,0,75000,31000,44000,14000
20200212,05462P,美律亞東97售01,,,,,0.00,0.00,0,0,0,0,0,0,0,0,0,0,0,0,0
20200212,054630,聯鈞凱基98購01,1.24,1.24,1.24,1.24,+0.15,13.76,16000,2,19840,0,0,0,0,0,0,0,16000,-16000,-16000
20200212,054631,台郡凱基98購02,,,,,0.00,0.00,0,0,0,0,0,0,0,0,0,0,0,0,0
20200212,054632,緯穎凱基9A購01,0.96,1.06,0.96,1.05,+0.04,3.96,243000,7,251250,0,0,0,0,0,0,243000,0,243000,243000
20200212,054633,臺股指凱基9A購02,0.56,0.64,0.56,0.64,+0.09,16.36,254000,18,155120,0,0,0,0,0,0,150000,97000,53000,53000
20200212,054634,FB上証中信99購01,,,,,0.00,0.00,0,0,0,0,0,0,0,0,0,0,0,0,0
20200212,054635,台達電中信98購01,0.58,0.60,0.56,0.60,+0.05,9.09,131000,5,75080,0,0,0,0,0,0,20000,111000,-91000,-91000
20200212,054636,華通中信97購01,0.55,0.55,0.55,0.55,0.00,0.00,1000,1,550,0,0,0,0,0,0,0,1000,-1000,-1000
20200212,054637,智邦中信98購01,2.28,2.40,2.16,2.16,+0.15,7.46,152000,16,346010,0,0,0,0,0,0,62000,90000,-28000,-28000
20200212,054638,國泰金中信99購01,0.96,0.97,0.96,0.97,+0.05,5.43,31000,3,29910,0,0,0,0,0,0,16000,15000,1000,1000
20200212,054639,台新金中信99購01,0.70,0.70,0.70,0.70,-0.02,-2.78,40000,2,28000,0,0,0,0,0,0,40000,0,40000,40000
20200212,05463P,創意國票96售04,,,,,0.00,0.00,0,0,0,0,0,0,0,0,0,0,0,0,0
20200212,054640,健策中信9B購01,0.78,0.87,0.76,0.87,+0.10,12.99,1543000,50,1233020,0,0,0,0,0,0,1143000,400000,743000,743000
20200212,054641,祥碩中信98購01,2.58,3.15,2.58,3.15,+0.76,31.8,91000,25,253730,0,0,0,0,0,0,34000,50000,-16000,-16000
20200212,054642,訊芯中信9A購01,0.38,0.46,0.38,0.45,+0.07,18.42,246000,12,106280,0,0,0,0,0,0,230000,16000,214000,214000
20200212,054643,上証2X群益9B購01,,,,,0.00,0.00,0,0,0,0,0,0,0,0,0,0,0,0,0
20200212,054644,A50正2群益9B購01,0.50,0.53,0.50,0.53,-0.02,-3.64,23000,6,12000,0,0,0,0,0,0,11000,12000,-1000,-1000
20200212,054645,奇力新群益97購04,,,,,0.00,0.00,0,0,0,0,0,0,0,0,0,0,0,0,0
20200212,054646,華新科群益97購03,,,,,0.00,0.00,0,0,0,0,0,0,0,0,0,0,0,0,0
20200212,054647,禾伸堂群益99購01,1.25,1.30,1.22,1.30,+0.03,2.36,2111000,32,2704080,0,0,0,0,0,0,615000,1496000,-881000,-881000
20200212,054648,智原群益98購01,0.59,0.65,0.59,0.65,+0.05,8.33,577000,10,361430,0,0,0,0,0,0,348000,229000,119000,119000
20200212,054649,聯茂群益97購01,3.03,4.14,3.03,4.14,+1.44,53.33,214000,27,735970,0,0,0,0,0,0,111000,103000,8000,8000
20200212,05464P,華通康和95售02,,,,,0.00,0.00,0,0,0,0,0,0,0,0,0,0,0,0,0
20200212,054650,南亞麥證97購01,,,,,0.00,0.00,0,0,0,0,0,0,0,0,0,0,0,0,0
20200212,054651,台化麥證97購01,0.66,0.66,0.66,0.66,+0.03,4.76,10000,1,6600,10000,0,10000,0,0,0,10000,0,10000,10000
20200212,054652,裕隆麥證97購01,1.13,1.25,1.11,1.25,+0.19,17.92,130000,12,152830,82000,48000,34000,0,0,0,82000,48000,34000,34000
20200212,054653,聯發科麥證97購02,0.39,0.41,0.39,0.41,+0.08,24.24,100000,2,40600,100000,0,100000,0,0,0,100000,0,100000,100000
20200212,054654,全新麥證99購01,0.90,1.06,0.90,1.05,+0.22,26.51,44000,9,43190,3000,41000,-38000,0,0,0,3000,41000,-38000,-38000
20200212,054655,貿聯麥證98購01,0.67,0.71,0.66,0.71,+0.03,4.41,40000,4,27200,20000,20000,0,0,0,0,20000,20000,0,0
20200212,054656,深中小元大97購01,1.73,1.73,1.73,1.73,+0.10,6.13,7000,1,12110,0,0,0,0,0,0,7000,0,7000,7000
20200212,054657,道瓊銀元大97購01,,,,,0.00,0.00,0,0,0,0,0,0,0,0,0,0,0,0,0
20200212,054658,道瓊銀元大9A購01,0.56,0.56,0.56,0.56,-0.04,-6.67,60000,2,33600,0,0,0,0,0,0,0,60000,-60000,-60000
20200212,054659,亞光元大97購02,0.46,0.54,0.45,0.54,+0.10,22.73,420000,13,199890,0,0,0,0,0,0,210000,210000,0,0
20200212,05465P,台表科永豐95售03,,,,,0.00,0.00,0,0,0,0,0,0,0,0,0,0,0,0,0
20200212,054660,禾伸堂元大97購03,0.85,0.85,0.85,0.85,0.00,0.00,20000,1,17000,0,0,0,0,0,0,20000,0,20000,20000
20200212,054661,嘉聯益元大97購03,2.06,2.18,2.06,2.06,+0.13,6.74,85000,9,178400,0,0,0,0,0,0,9000,85000,-76000,-76000
20200212,054662,同欣電元大97購02,1.05,1.19,1.05,1.19,+0.17,16.67,43000,4,46550,0,0,0,0,0,0,33000,10000,23000,23000
20200212,054663,同欣電元大97購03,1.05,1.19,1.03,1.03,+0.03,3.0,122000,11,127890,0,0,0,0,0,0,79000,43000,36000,36000
20200212,054664,台表科元大97購04,0.99,1.03,0.99,1.03,0.00,0.00,11000,3,11250,0,0,0,0,0,0,11000,2000,9000,9000
20200212,054665,華通元富97購02,1.88,2.54,1.88,2.43,+0.69,39.66,335000,25,767640,0,0,0,0,0,0,22000,314000,-292000,-292000
20200212,054666,強茂元富97購01,0.74,0.76,0.74,0.76,+0.05,7.04,40000,4,30200,0,0,0,0,0,0,0,40000,-40000,-40000
20200212,054667,神基元富97購01,2.11,2.16,2.09,2.16,+0.05,2.37,113000,15,239590,0,0,0,0,0,0,62000,51000,11000,11000
20200212,054668,傳奇元富97購03,0.82,0.82,0.82,0.82,0.00,0.00,10000,1,8200,0,0,0,0,0,0,0,10000,-10000,-10000
20200212,054669,凌華元富97購01,3.61,3.69,3.61,3.68,+0.10,2.79,60000,10,218830,0,0,0,0,0,0,33000,25000,8000,8000
20200212,05466P,旺宏富邦97售01,0.57,0.57,0.57,0.57,0.00,0.00,2000,1,1140,0,0,0,0,0,0,0,2000,-2000,-2000
20200212,054670,康友元富97購01,2.92,3.13,2.92,2.98,+0.03,1.02,379000,33,1155890,0,0,0,0,0,0,72000,337000,-265000,-265000
20200212,054671,國巨國泰98購01,3.60,3.70,3.44,3.64,+0.34,10.3,983000,72,3525480,0,0,0,0,0,0,403000,650000,-247000,-247000
20200212,054672,華新科國泰99購01,4.68,4.72,4.45,4.57,+0.13,2.93,350000,30,1603130,0,0,0,0,0,0,292000,73000,219000,219000
20200212,054673,京鼎國泰98購01,1.80,2.18,1.80,2.18,+0.44,25.29,579000,37,1180340,0,0,0,0,0,0,300000,279000,21000,21000
20200212,054674,台光電台新97購01,0.43,0.58,0.43,0.58,+0.16,38.1,275000,6,155220,0,0,0,0,0,0,1000,274000,-273000,-273000
20200212,054675,美律台新98購01,0.35,0.39,0.35,0.39,+0.10,34.48,240000,5,89400,0,0,0,0,0,0,0,240000,-240000,-240000
20200212,054676,牧德台新98購01,1.81,1.81,1.74,1.74,-0.06,-3.33,21000,3,37310,0,0,0,0,0,0,18000,3000,15000,15000
20200212,054677,智易台新98購02,0.68,0.86,0.67,0.86,+0.16,22.86,434000,16,342650,0,0,0,0,0,0,33000,401000,-368000,-368000
20200212,054678,麗豐台新98購02,0.67,0.74,0.66,0.72,+0.07,10.77,80000,9,55780,0,0,0,0,0,0,49000,31000,18000,18000
20200212,054679,台積電康和99購01,1.06,1.09,1.06,1.09,+0.07,6.86,73000,2,77530,0,0,0,0,0,0,73000,0,73000,73000
20200212,05467P,聯電元大95售02,0.79,0.79,0.74,0.75,-0.05,-6.25,390000,19,296390,0,0,0,0,0,0,111000,259000,-148000,-148000
20200212,054680,華新科康和97購02,1.22,1.25,1.19,1.21,+0.03,2.54,2922000,34,3576690,0,0,0,0,0,0,2041000,920000,1121000,1121000
20200212,054681,味全永豐97購01,,,,,0.00,0.00,0,0,0,0,0,0,0,0,0,0,0,0,0
20200212,054682,東元永豐97購01,,,,,0.00,0.00,0,0,0,0,0,0,0,0,0,0,0,0,0
20200212,054683,川湖永豐97購01,0.96,0.99,0.94,0.95,-0.04,-4.04,255000,7,244650,0,0,0,0,0,0,144000,111000,33000,33000
20200212,054684,裕隆永豐97購01,0.85,0.91,0.83,0.90,+0.07,8.43,1296000,25,1138310,0,0,0,0,0,0,824000,472000,352000,352000
20200212,054685,國巨永豐97購02,0.78,0.84,0.75,0.84,+0.10,13.51,1312000,54,1050050,0,0,0,0,0,0,669000,625000,44000,44000
20200212,054686,順德永豐97購01,,,,,0.00,0.00,0,0,0,0,0,0,0,0,0,0,0,0,0
20200212,054687,建準永豐97購02,,,,,0.00,0.00,0,0,0,0,0,0,0,0,0,0,0,0,0
20200212,054688,兆赫永豐97購01,0.43,0.44,0.43,0.44,+0.02,4.76,205000,6,88650,0,0,0,0,0,0,55000,150000,-95000,-95000
20200212,054689,華新科永豐97購01,0.80,0.82,0.77,0.80,-0.02,-2.44,259000,38,209100,0,0,0,0,0,0,191000,63000,128000,128000
20200212,05468P,鴻海元大96售14,2.05,2.13,1.89,1.89,-0.38,-16.74,1001000,25,2019110,0,0,0,0,0,0,972000,804000,168000,168000
20200212,054690,新興永豐97購01,0.38,0.39,0.38,0.39,0.00,0.00,13000,2,4970,0,0,0,0,0,0,3000,10000,-7000,-7000
20200212,054691,裕民永豐97購01,,,,,0.00,0.00,0,0,0,0,0,0,0,0,0,0,0,0,0
20200212,054692,台航永豐97購01,,,,,0.00,0.00,0,0,0,0,0,0,0,0,0,0,0,0,0
20200212,054693,神基永豐97購01,1.04,1.12,1.04,1.12,+0.06,5.66,532000,6,575860,0,0,0,0,0,0,281000,484000,-203000,-203000
20200212,054694,聯鈞永豐97購01,0.70,0.92,0.69,0.92,+0.24,35.29,591000,23,464700,0,0,0,0,0,0,202000,389000,-187000,-187000
20200212,054695,世芯永豐98購01,0.82,0.87,0.77,0.84,-0.02,-2.33,737000,41,599350,0,0,0,0,0,0,522000,191000,331000,331000
20200212,054696,嘉聯益永豐97購01,0.62,0.62,0.62,0.62,+0.09,16.98,10000,2,6200,0,0,0,0,0,0,0,10000,-10000,-10000
20200212,054697,凌華永豐97購01,1.29,1.29,1.29,1.29,+0.03,2.38,1000,1,1290,0,0,0,0,0,0,1000,0,1000,1000
20200212,054698,同欣電永豐97購01,0.42,0.50,0.42,0.45,+0.02,4.65,321000,33,148110,0,0,0,0,0,0,166000,155000,11000,11000
20200212,054699,復盛永豐97購01,1.14,1.16,1.10,1.10,-0.04,-3.51,605000,40,682860,0,0,0,0,0,0,545000,60000,485000,485000
20200212,05469P,台積電元大95售24,1.55,1.57,1.50,1.50,-0.14,-8.54,874000,16,1349260,0,0,0,0,0,0,870000,871000,-1000,-1000
20200212,054700,致新永豐97購01,0.50,0.52,0.49,0.52,0.00,0.00,437000,13,220160,0,0,0,0,0,0,350000,87000,263000,263000
20200212,054701,宏全永豐97購01,0.62,0.66,0.61,0.66,-0.02,-2.94,719000,12,444080,0,0,0,0,0,0,111000,608000,-497000,-497000
20200212,054702,智邦第一97購01,0.75,0.81,0.66,0.69,-0.01,-1.43,237000,18,182940,0,0,0,0,0,0,137000,100000,37000,37000
20200212,054703,聯發科第一97購01,0.30,0.33,0.30,0.33,+0.07,26.92,8000,4,2610,0,0,0,0,0,0,1000,7000,-6000,-6000
20200212,054704,玉晶光第一97購01,0.54,0.54,0.53,0.53,+0.05,10.42,173000,7,93220,0,0,0,0,0,0,100000,73000,27000,27000
20200212,054705,欣興亞東97購01,1.47,1.47,1.47,1.47,+0.38,34.86,60000,1,88200,0,0,0,0,0,0,0,60000,-60000,-60000
20200212,054706,TPK亞東97購01,,,,,0.00,0.00,0,0,0,0,0,0,0,0,0,0,0,0,0
20200212,054707,聯茂亞東97購01,2.20,2.45,2.20,2.45,0.00,0.00,48000,8,112380,0,0,0,0,0,0,0,48000,-48000,-48000
20200212,054708,華通統一97購02,0.94,1.22,0.94,1.19,+0.33,38.37,224000,16,232740,0,0,0,0,0,0,0,224000,-224000,-224000
20200212,054709,宏達電統一97購01,0.88,0.88,0.88,0.88,0.00,0.00,57000,1,50160,0,0,0,0,0,0,0,57000,-57000,-57000
20200212,05470P,康控元大95售05,2.24,2.24,2.14,2.14,-0.24,-10.08,20000,2,44300,0,0,0,0,0,0,20000,0,20000,20000
20200212,054710,東元元富97購01,2.44,2.44,2.41,2.44,+0.03,1.24,50000,3,121700,0,0,0,0,0,0,10000,40000,-30000,-30000
20200212,054711,禾伸堂元富97購01,0.90,0.91,0.87,0.91,-0.01,-1.09,673000,38,598770,0,0,0,0,0,0,454000,219000,235000,235000
20200212,054712,上証2X中信98購02,0.51,0.51,0.51,0.51,-0.01,-1.92,1000,1,510,0,0,0,0,0,0,1000,0,1000,1000
20200212,054713,國巨中信9B購01,0.95,0.98,0.89,0.94,+0.05,5.62,1706000,98,1570620,0,0,0,0,0,0,1057000,607000,450000,450000
20200212,054714,和鑫台新98購01,0.65,0.69,0.64,0.69,+0.05,7.81,623000,41,412770,0,0,0,0,0,0,382000,241000,141000,141000
20200212,054715,中橡康和97購01,,,,,0.00,0.00,0,0,0,0,0,0,0,0,0,0,0,0,0
20200212,054716,緯穎康和97購01,1.35,1.35,1.35,1.35,+0.04,3.05,10000,1,13500,0,0,0,0,0,0,10000,0,10000,10000
20200212,054717,亞德客永豐97購01,1.60,1.78,1.58,1.74,+0.06,3.57,1116000,50,1885320,0,0,0,0,0,0,889000,346000,543000,543000
20200212,054718,可成永豐97購01,0.85,0.94,0.84,0.94,+0.16,20.51,156000,6,135960,0,0,0,0,0,0,44000,112000,-68000,-68000
20200212,054719,亞光永豐97購01,,,,,0.00,0.00,0,0,0,0,0,0,0,0,0,0,0,0,0
20200212,05471P,聯電統一95售01,0.60,0.60,0.56,0.56,-0.05,-8.2,195000,10,115770,0,0,0,0,0,0,109000,86000,23000,23000
20200212,054720,禾伸堂永豐97購01,0.56,0.58,0.56,0.58,-0.01,-1.69,199000,15,113190,0,0,0,0,0,0,10000,188000,-178000,-178000
20200212,054721,揚明光永豐97購03,,,,,0.00,0.00,0,0,0,0,0,0,0,0,0,0,0,0,0
20200212,054722,傳奇永豐97購01,,,,,0.00,0.00,0,0,0,0,0,0,0,0,0,0,0,0,0
20200212,054723,鴻海日盛97購01,0.46,0.60,0.46,0.60,+0.20,50.0,55000,5,27400,0,0,0,0,0,0,5000,50000,-45000,-45000
20200212,054724,鴻海日盛97購02,0.54,0.74,0.54,0.74,+0.22,42.31,353000,17,215100,0,0,0,0,0,0,220000,133000,87000,87000
20200212,054725,國巨日盛97購01,1.35,1.42,1.32,1.42,+0.13,10.08,39000,4,54120,0,0,0,0,0,0,39000,0,39000,39000
20200212,054726,台積電日盛97購01,0.71,0.78,0.71,0.78,+0.08,11.43,1601000,11,1173860,0,0,0,0,0,0,1120000,1031000,89000,89000
20200212,054727,台積電日盛97購02,1.05,1.11,1.02,1.10,+0.11,11.11,923000,12,990100,0,0,0,0,0,0,813000,810000,3000,3000
20200212,054728,聯發科日盛97購01,,,,,0.00,0.00,0,0,0,0,0,0,0,0,0,0,0,0,0
20200212,054729,聯發科日盛97購02,,,,,0.00,0.00,0,0,0,0,0,0,0,0,0,0,0,0,0
20200212,05472P,國巨統一96售02,0.37,0.37,0.37,0.37,-0.04,-9.76,41000,1,15170,0,0,0,0,0,0,0,41000,-41000,-41000
20200212,054730,上証2X凱基98購02,0.92,0.92,0.92,0.92,-0.02,-2.13,50000,1,46000,0,0,0,0,0,0,0,50000,-50000,-50000
20200212,054731,S&P反1凱基98購01,,,,,0.00,0.00,0,0,0,0,0,0,0,0,0,0,0,0,0
20200212,054732,台化凱基98購01,,,,,0.00,0.00,0,0,0,0,0,0,0,0,0,0,0,0,0
20200212,054733,鴻海凱基98購04,0.64,0.64,0.64,0.64,+0.05,8.47,3000,1,1920,0,0,0,0,0,0,3000,0,3000,3000
20200212,054734,燿華凱基97購03,,,,,0.00,0.00,0,0,0,0,0,0,0,0,0,0,0,0,0
20200212,054735,漢唐凱基98購01,1.00,1.01,0.28,1.01,+0.03,3.06,141000,3,133830,0,0,0,0,0,0,128000,13000,115000,115000
20200212,054736,南亞科凱基98購01,1.46,1.46,1.46,1.46,-0.03,-2.01,10000,1,14600,0,0,0,0,0,0,0,10000,-10000,-10000
20200212,054737,京元電凱基99購01,0.49,0.58,0.47,0.57,+0.05,9.62,353000,33,186540,0,0,0,0,0,0,230000,123000,107000,107000
20200212,054738,聯發科凱基97購01,,,,,0.00,0.00,0,0,0,0,0,0,0,0,0,0,0,0,0
20200212,054739,義隆凱基98購02,0.99,0.99,0.90,0.93,+0.12,14.81,346000,17,328970,0,0,0,0,0,0,206000,23000,183000,183000
20200212,05473P,聯詠統一97售02,2.03,2.05,2.03,2.03,-0.19,-8.56,60000,8,122200,0,0,0,0,0,0,0,60000,-60000,-60000
20200212,054740,強茂凱基99購01,0.85,0.85,0.85,0.85,0.00,0.00,10000,1,8500,0,0,0,0,0,0,0,10000,-10000,-10000
20200212,054741,亞光凱基99購01,0.36,0.43,0.36,0.43,+0.10,30.3,16000,5,6440,0,0,0,0,0,0,12000,0,12000,12000
20200212,054742,京鼎凱基99購01,1.78,1.89,1.78,1.89,+0.34,21.94,161000,15,299370,0,0,0,0,0,0,32000,129000,-97000,-97000
20200212,054743,聯鈞凱基99購01,0.71,0.87,0.71,0.87,+0.19,27.94,29000,5,22720,0,0,0,0,0,0,4000,25000,-21000,-21000
20200212,054744,晶相光凱基99購01,1.33,1.37,1.33,1.35,+0.06,4.65,32000,5,42820,0,0,0,0,0,0,32000,16000,16000,16000
20200212,054745,智易凱基97購01,0.47,0.47,0.47,0.47,0.00,0.00,205000,4,96350,0,0,0,0,0,0,0,205000,-205000,-205000
20200212,054746,貿聯凱基98購02,0.77,0.82,0.77,0.82,+0.09,12.33,45000,4,35160,0,0,0,0,0,0,33000,10000,23000,23000
20200212,054747,麗豐凱基98購01,,,,,0.00,0.00,0,0,0,0,0,0,0,0,0,0,0,0,0
20200212,054748,正文凱基98購01,0.58,0.58,0.58,0.58,-0.01,-1.69,191000,1,110780,0,0,0,0,0,0,191000,0,191000,191000
20200212,054749,聯茂凱基98購01,2.14,2.90,2.14,2.69,+0.79,41.58,167000,11,446550,0,0,0,0,0,0,120000,47000,73000,73000
20200212,05474P,智邦亞東95售01,,,,,0.00,0.00,0,0,0,0,0,0,0,0,0,0,0,0,0
20200212,054750,聯茂凱基98購02,1.68,2.11,1.65,2.11,+0.71,50.71,131000,10,238720,0,0,0,0,0,0,75000,46000,29000,29000
20200212,054751,GIS凱基98購01,0.79,0.79,0.79,0.79,+0.03,3.95,4000,4,3160,0,0,0,0,0,0,4000,0,4000,4000
20200212,054752,易華電凱基97購02,0.50,0.50,0.49,0.50,+0.01,2.04,658000,32,328750,0,0,0,0,0,0,68000,590000,-522000,-522000
20200212,054753,復盛凱基98購01,2.32,2.32,2.21,2.21,-0.02,-0.9,40000,4,92690,0,0,0,0,0,0,40000,0,40000,40000
20200212,054754,昇陽半凱基98購02,0.69,0.69,0.68,0.68,-0.01,-1.45,28000,2,19200,0,0,0,0,0,0,28000,28000,0,0
20200212,054755,世紀鋼凱基98購01,0.95,0.95,0.94,0.94,-0.01,-1.05,27000,3,25600,0,0,0,0,0,0,1000,26000,-25000,-25000
20200212,054756,世紀鋼凱基99購01,0.72,0.74,0.72,0.73,-0.02,-2.67,217000,23,158140,0,0,0,0,0,0,67000,140000,-73000,-73000
20200212,054757,南亞國票98購01,,,,,0.00,0.00,0,0,0,0,0,0,0,0,0,0,0,0,0
20200212,054758,南亞國票9A購01,1.82,1.82,1.82,1.82,-0.12,-6.19,12000,1,21840,0,0,0,0,0,0,12000,0,12000,12000
20200212,054759,台化國票98購01,2.12,2.18,2.12,2.18,0.00,0.00,39000,3,84360,0,0,0,0,0,0,11000,28000,-17000,-17000
20200212,05475P,聯茂亞東95售01,,,,,0.00,0.00,0,0,0,0,0,0,0,0,0,0,0,0,0
20200212,054760,台化國票9A購01,,,,,0.00,0.00,0,0,0,0,0,0,0,0,0,0,0,0,0
20200212,054761,台光電國票98購02,1.21,1.47,1.21,1.42,+0.37,35.24,58000,9,74910,0,0,0,0,0,0,13000,43000,-30000,-30000
20200212,054762,奇力新國票99購01,1.17,1.20,1.14,1.17,-0.04,-3.31,119000,14,139530,0,0,0,0,0,0,89000,30000,59000,59000
20200212,054763,宏達電國票99購01,,,,,0.00,0.00,0,0,0,0,0,0,0,0,0,0,0,0,0
20200212,054764,亞光國票98購01,0.53,0.53,0.53,0.53,+0.02,3.92,50000,1,26500,0,0,0,0,0,0,50000,0,50000,50000
20200212,054765,亞光國票98購02,0.52,0.60,0.52,0.60,+0.13,27.66,7000,4,3820,0,0,0,0,0,0,1000,6000,-5000,-5000
20200212,054766,智原國票98購01,0.59,0.67,0.59,0.67,+0.05,8.06,114000,14,69290,0,0,0,0,0,0,70000,44000,26000,26000
20200212,054767,日電貿國票98購01,1.87,1.95,1.87,1.94,+0.44,29.33,46000,4,87960,0,0,0,0,0,0,19000,27000,-8000,-8000
20200212,054768,泰碩國票99購02,0.92,0.92,0.92,0.92,-0.05,-5.15,26000,1,23920,0,0,0,0,0,0,26000,0,26000,26000
20200212,054769,創意國票98購01,2.67,2.93,2.54,2.93,-0.21,-6.69,156000,10,405850,0,0,0,0,0,0,156000,100000,56000,56000
20200212,05476P,聯發科群益95售06,2.26,2.26,2.26,2.26,-0.62,-21.53,10000,1,22600,0,0,0,0,0,0,10000,0,10000,10000
20200212,054770,健策國票98購01,2.18,2.36,2.04,2.36,+0.34,16.83,367000,19,795440,0,0,0,0,0,0,341000,26000,315000,315000
20200212,054771,茂林國票98購02,1.97,2.02,1.97,2.00,+0.08,4.17,44000,5,88080,0,0,0,0,0,0,0,44000,-44000,-44000
20200212,054772,康控國票98購02,1.12,1.15,1.12,1.15,0.00,0.00,98000,2,111560,0,0,0,0,0,0,0,98000,-98000,-98000
20200212,054773,台郡國票98購01,3.68,3.78,3.68,3.78,+1.45,62.23,72000,9,265680,0,0,0,0,0,0,60000,12000,48000,48000
20200212,054774,同欣電國票98購01,0.88,1.05,0.85,0.85,-0.06,-6.59,521000,44,493610,0,0,0,0,0,0,116000,405000,-289000,-289000
20200212,054775,復盛國票98購01,2.86,2.90,2.80,2.80,+0.05,1.82,71000,13,201720,0,0,0,0,0,0,68000,3000,65000,65000
20200212,054776,矽創國票98購01,1.77,1.77,1.77,1.77,+0.02,1.14,86000,9,152220,0,0,0,0,0,0,86000,0,86000,86000
20200212,054777,昇陽半國票98購01,1.35,1.41,1.35,1.41,+0.07,5.22,28000,2,38160,0,0,0,0,0,0,22000,6000,16000,16000
20200212,054778,世紀鋼國票99購01,2.34,2.37,2.30,2.30,-0.06,-2.54,121000,15,282210,0,0,0,0,0,0,70000,51000,19000,19000
20200212,054779,台塑群益98購01,1.16,1.19,1.16,1.18,+0.02,1.72,418000,9,489070,0,0,0,0,0,0,305000,113000,192000,192000
20200212,05477P,華新科群益95售06,,,,,0.00,0.00,0,0,0,0,0,0,0,0,0,0,0,0,0
20200212,054780,中石化群益99購01,0.33,0.33,0.33,0.33,-0.01,-2.94,3000,1,990,0,0,0,0,0,0,3000,0,3000,3000
20200212,054781,台化群益99購01,1.21,1.23,1.21,1.23,+0.05,4.24,22000,2,26840,0,0,0,0,0,0,22000,0,22000,22000
20200212,054782,國巨群益97購01,3.62,3.78,3.62,3.78,+0.37,10.85,215000,11,790700,0,0,0,0,0,0,33000,195000,-162000,-162000
20200212,054783,國巨群益98購04,2.87,2.99,2.75,2.99,+0.25,9.12,303000,13,876790,0,0,0,0,0,0,178000,125000,53000,53000
20200212,054784,順德群益9A購01,,,,,0.00,0.00,0,0,0,0,0,0,0,0,0,0,0,0,0
20200212,054785,建準群益98購01,1.68,1.68,1.65,1.65,-0.05,-2.94,31000,2,51480,0,0,0,0,0,0,11000,20000,-9000,-9000
20200212,054786,全新群益99購02,0.99,1.18,0.99,1.18,+0.25,26.88,481000,27,528860,0,0,0,0,0,0,38000,443000,-405000,-405000
20200212,054787,華新科群益97購04,,,,,0.00,0.00,0,0,0,0,0,0,0,0,0,0,0,0,0
20200212,054788,華新科群益98購02,3.80,3.86,3.64,3.76,+0.04,1.08,120000,24,450080,0,0,0,0,0,0,70000,83000,-13000,-13000
20200212,054789,高鐵群益98購01,0.72,0.72,0.72,0.72,0.00,0.00,30000,2,21600,0,0,0,0,0,0,30000,0,30000,30000
20200212,05478P,智伸科國票96售02,,,,,0.00,0.00,0,0,0,0,0,0,0,0,0,0,0,0,0
20200212,054790,禾伸堂群益98購01,1.66,1.73,1.59,1.73,+0.07,4.22,197000,11,327000,0,0,0,0,0,0,189000,8000,181000,181000
20200212,054791,泰碩群益99購02,0.87,0.87,0.84,0.85,0.00,0.00,170000,10,143720,0,0,0,0,0,0,105000,50000,55000,55000
20200212,054792,揚明光群益97購01,1.04,1.08,1.04,1.08,+0.08,8.0,44000,4,46530,0,0,0,0,0,0,0,44000,-44000,-44000
20200212,054793,牧德群益9A購01,1.89,1.94,1.78,1.78,-0.07,-3.78,286000,7,539410,0,0,0,0,0,0,261000,25000,236000,236000
20200212,054794,貿聯群益98購01,1.15,1.34,1.15,1.34,+0.20,17.54,584000,18,735810,0,0,0,0,0,0,240000,249000,-9000,-9000
20200212,054795,合勤控群益98購01,0.96,0.98,0.96,0.97,+0.04,4.3,101000,3,98730,0,0,0,0,0,0,0,101000,-101000,-101000
20200212,054796,康普群益98購01,1.12,1.12,1.12,1.12,+0.02,1.82,1000,1,1120,0,0,0,0,0,0,1000,0,1000,1000
20200212,054797,臻鼎群益97購01,1.24,1.24,1.24,1.24,+0.47,61.04,22000,3,27280,0,0,0,0,0,0,22000,0,22000,22000
20200212,054798,超眾群益97購01,0.84,0.87,0.81,0.87,+0.04,4.82,70000,19,58660,0,0,0,0,0,0,70000,0,70000,70000
20200212,054799,超眾群益98購01,0.76,0.79,0.74,0.79,+0.01,1.28,128000,18,98010,0,0,0,0,0,0,128000,11000,117000,117000
20200212,05479P,華新科台新96售01,0.22,0.23,0.22,0.23,-0.02,-8.0,172000,18,37940,0,0,0,0,0,0,0,172000,-172000,-172000
20200212,054800,訊芯群益99購01,1.12,1.24,1.12,1.24,+0.16,14.81,43000,4,51570,0,0,0,0,0,0,10000,33000,-23000,-23000
20200212,054801,康友群益97購02,3.01,3.15,3.01,3.03,+0.07,2.36,75000,13,230500,0,0,0,0,0,0,34000,69000,-35000,-35000
20200212,054802,高股息元大97購01,0.87,0.90,0.87,0.90,+0.06,7.14,20000,4,17750,0,0,0,0,0,0,5000,15000,-10000,-10000
20200212,054803,味全元大9A購01,1.35,1.35,1.32,1.34,+0.02,1.52,8000,3,10640,0,0,0,0,0,0,0,8000,-8000,-8000
20200212,054804,南亞元大9A購01,0.97,0.98,0.97,0.97,-0.01,-1.02,171000,8,166170,0,0,0,0,0,0,23000,148000,-125000,-125000
20200212,054805,台苯元大9A購01,0.77,0.79,0.77,0.79,+0.04,5.33,104000,3,81580,0,0,0,0,0,0,75000,29000,46000,46000
20200212,054806,台化元大9A購01,2.17,2.25,2.17,2.25,+0.05,2.27,60000,4,133800,0,0,0,0,0,0,50000,10000,40000,40000
20200212,054807,台化元大9A購02,1.82,1.84,1.82,1.84,+0.03,1.66,25000,2,45740,0,0,0,0,0,0,13000,12000,1000,1000
20200212,054808,東元元大9A購01,1.82,1.82,1.80,1.80,0.00,0.00,130000,3,235500,0,0,0,0,0,0,100000,30000,70000,70000
20200212,054809,大成鋼元大97購01,0.90,0.96,0.87,0.96,+0.06,6.67,143000,7,133690,0,0,0,0,0,0,142000,114000,28000,28000
20200212,05480P,滬深2X凱基96售05,2.36,2.46,2.36,2.39,+0.01,0.42,330000,34,798900,0,0,0,0,0,0,305000,305000,0,0
20200212,054810,中橡元大9A購01,,,,,0.00,0.00,0,0,0,0,0,0,0,0,0,0,0,0,0
20200212,054811,裕隆元大9A購01,1.59,1.67,1.55,1.65,+0.14,9.27,342000,15,555260,0,0,0,0,0,0,44000,298000,-254000,-254000
20200212,054812,鴻海元大97購08,1.30,1.61,1.26,1.61,+0.35,27.78,912000,40,1323370,0,0,0,0,0,0,631000,881000,-250000,-250000
20200212,054813,鴻海元大97購09,1.18,1.48,1.14,1.48,+0.30,25.42,800000,28,1059530,0,0,0,0,0,0,779000,770000,9000,9000
20200212,054814,台積電元大97購13,2.74,2.82,2.74,2.82,+0.19,7.22,111000,6,305420,0,0,0,0,0,0,111000,111000,0,0
20200212,054815,台積電元大97購14,1.01,1.06,1.01,1.06,+0.08,8.16,6000,2,6310,0,0,0,0,0,0,0,6000,-6000,-6000
20200212,054816,聯發科元大97購12,0.98,1.12,0.96,1.10,+0.21,23.6,123000,9,129500,0,0,0,0,0,0,113000,10000,103000,103000
20200212,054817,聯發科元大97購13,1.07,1.16,1.06,1.12,+0.22,24.44,170000,9,187900,0,0,0,0,0,0,130000,40000,90000,90000
20200212,054818,奇力新元大97購05,0.90,0.98,0.90,0.98,+0.06,6.52,133000,8,123460,0,0,0,0,0,0,117000,0,117000,117000
20200212,054819,裕民元大9A購01,1.63,1.63,1.63,1.63,+0.06,3.82,10000,1,16300,0,0,0,0,0,0,0,10000,-10000,-10000
20200212,05481P,鴻海凱基95售21,,,,,0.00,0.00,0,0,0,0,0,0,0,0,0,0,0,0,0
20200212,054820,新日興元大97購01,4.91,4.91,4.64,4.64,-0.16,-3.33,360000,24,1718050,0,0,0,0,0,0,54000,330000,-276000,-276000
20200212,054821,貿聯元大9A購01,0.62,0.69,0.62,0.69,+0.08,13.11,1189000,40,782990,0,0,0,0,0,0,550000,484000,66000,66000
20200212,054822,祥碩元大97購01,8.75,9.55,8.75,9.55,+1.30,15.76,62000,9,567300,0,0,0,0,0,0,16000,46000,-30000,-30000
20200212,054823,祥碩元大97購02,8.20,8.20,8.20,8.20,+0.65,8.61,10000,1,82000,0,0,0,0,0,0,10000,0,10000,10000
20200212,054824,同欣電元大97購04,1.76,1.96,1.70,1.96,+0.25,14.62,168000,21,299370,0,0,0,0,0,0,156000,19000,137000,137000
20200212,054825,康友元大97購01,2.98,3.16,2.98,3.16,+0.25,8.59,107000,9,325720,0,0,0,0,0,0,34000,107000,-73000,-73000
20200212,054826,復盛元大9A購01,4.07,4.07,3.90,3.90,-0.08,-2.01,120000,14,479300,0,0,0,0,0,0,101000,12000,89000,89000
20200212,054827,宏全元大9A購01,1.68,1.70,1.68,1.70,-0.01,-0.58,39000,4,66020,0,0,0,0,0,0,14000,25000,-11000,-11000
20200212,054828,正崴國泰99購01,0.80,0.80,0.79,0.79,-0.02,-2.47,94000,17,75140,0,0,0,0,0,0,94000,0,94000,94000
20200212,054829,亞光國泰99購01,0.68,0.73,0.68,0.72,+0.14,24.14,276000,17,195600,0,0,0,0,0,0,237000,236000,1000,1000
20200212,05482P,鴻海凱基95售22,1.69,1.69,1.69,1.69,-0.26,-13.33,50000,1,84500,0,0,0,0,0,0,50000,50000,0,0
20200212,054830,世芯國泰99購01,2.38,2.48,2.25,2.45,+0.12,5.15,298000,34,695380,0,0,0,0,0,0,233000,43000,190000,190000
20200212,054831,緯穎國泰98購01,4.10,4.41,3.91,4.35,+0.31,7.67,114000,22,468050,0,0,0,0,0,0,48000,66000,-18000,-18000
20200212,054832,興勤中信97購01,0.36,0.37,0.36,0.37,0.00,0.00,195000,4,70700,0,0,0,0,0,0,0,195000,-195000,-195000
20200212,054833,京鼎中信97購01,0.54,0.64,0.54,0.61,+0.14,29.79,517000,28,297580,0,0,0,0,0,0,30000,517000,-487000,-487000
20200212,054834,帆宣中信97購01,0.59,0.59,0.58,0.58,+0.02,3.57,3000,2,1760,0,0,0,0,0,0,2000,1000,1000,1000
20200212,054835,致新中信97購01,0.36,0.38,0.34,0.37,+0.01,2.78,377000,24,135540,0,0,0,0,0,0,377000,0,377000,377000
20200212,054836,勤誠中信97購01,1.17,1.17,1.00,1.00,-0.15,-13.04,19000,3,21100,0,0,0,0,0,0,4000,15000,-11000,-11000
20200212,054837,欣興第一97購01,0.58,0.68,0.58,0.68,+0.17,33.33,330000,19,209010,0,0,0,0,0,0,29000,320000,-291000,-291000
20200212,054838,京鼎第一97購01,0.74,0.79,0.72,0.79,+0.16,25.4,532000,18,396220,0,0,0,0,0,0,0,532000,-532000,-532000
20200212,054839,中石化亞東98購01,,,,,0.00,0.00,0,0,0,0,0,0,0,0,0,0,0,0,0
20200212,05483P,國巨凱基95售07,,,,,0.00,0.00,0,0,0,0,0,0,0,0,0,0,0,0,0
20200212,054840,T50反1兆豐98購01,,,,,0.00,0.00,0,0,0,0,0,0,0,0,0,0,0,0,0
20200212,054841,亞德客兆豐97購01,2.41,2.61,2.41,2.58,-0.01,-0.39,333000,26,844140,0,0,0,0,0,0,203000,130000,73000,73000
20200212,054842,台達電兆豐98購01,3.31,3.47,3.27,3.47,+0.16,4.83,50000,5,167400,0,0,0,0,0,0,20000,30000,-10000,-10000
20200212,054843,中環兆豐97購01,0.97,0.97,0.94,0.95,-0.12,-11.21,384000,19,366170,0,0,0,0,0,0,254000,122000,132000,132000
20200212,054844,華邦電兆豐98購01,0.66,0.68,0.66,0.67,+0.14,26.42,186000,6,124030,0,0,0,0,0,0,0,186000,-186000,-186000
20200212,054845,智邦兆豐98購01,1.78,1.91,1.62,1.63,+0.02,1.24,238000,36,417520,0,0,0,0,0,0,33000,205000,-172000,-172000
20200212,054846,瑞昱兆豐97購01,2.98,3.25,2.98,3.09,+0.30,10.75,63000,9,192980,0,0,0,0,0,0,33000,30000,3000,3000
20200212,054847,創意兆豐97購01,0.80,0.83,0.76,0.83,-0.08,-8.79,432000,39,347300,0,0,0,0,0,0,369000,50000,319000,319000
20200212,054848,群創兆豐98購01,1.21,1.22,1.18,1.18,-0.01,-0.84,297000,7,356030,0,0,0,0,0,0,285000,12000,273000,273000
20200212,054849,日月光兆豐97購01,0.82,0.88,0.79,0.88,+0.13,17.33,546000,14,441710,0,0,0,0,0,0,307000,239000,68000,68000
20200212,05484P,台積電凱基95售18,0.13,0.13,0.12,0.13,-0.02,-13.33,109000,6,13770,0,0,0,0,0,0,50000,59000,-9000,-9000
20200212,054850,上海銀兆豐97購01,1.24,1.24,1.23,1.23,-0.02,-1.6,80000,2,98500,0,0,0,0,0,0,10000,70000,-60000,-60000
20200212,054851,樺漢兆豐97購01,1.21,1.29,1.21,1.29,+0.09,7.5,118000,7,144510,0,0,0,0,0,0,77000,41000,36000,36000
20200212,054852,奇鋐國票98購01,,,,,0.00,0.00,0,0,0,0,0,0,0,0,0,0,0,0,0
20200212,054853,TPK國票98購02,0.33,0.38,0.33,0.38,+0.05,15.15,95000,4,34650,0,0,0,0,0,0,70000,25000,45000,45000
20200212,054854,台積電麥證97購01,0.88,0.93,0.88,0.92,+0.08,9.52,106000,3,97400,98000,8000,90000,0,0,0,98000,8000,90000,90000
20200212,054855,得力群益98購01,1.03,1.04,1.00,1.02,-0.02,-1.92,149000,9,152270,0,0,0,0,0,0,84000,50000,34000,34000
20200212,054856,得力群益99購01,1.12,1.12,1.12,1.12,-0.04,-3.45,10000,1,11200,0,0,0,0,0,0,10000,0,10000,10000
20200212,054857,信錦群益97購01,1.38,1.38,1.38,1.38,+0.04,2.99,11000,1,15180,0,0,0,0,0,0,0,11000,-11000,-11000
20200212,054858,台肥群益97購01,1.28,1.38,1.28,1.34,+0.05,3.88,176000,10,239490,0,0,0,0,0,0,1000,175000,-174000,-174000
20200212,054859,鴻海群益97購02,1.07,1.31,1.07,1.31,+0.29,28.43,210000,6,238190,0,0,0,0,0,0,10000,200000,-190000,-190000
20200212,05485P,旺宏凱基95售08,,,,,0.00,0.00,0,0,0,0,0,0,0,0,0,0,0,0,0
20200212,054860,台積電群益98購01,1.61,1.70,1.60,1.67,+0.12,7.74,719000,14,1176300,0,0,0,0,0,0,145000,574000,-429000,-429000
20200212,054861,智邦群益97購01,3.04,3.12,2.44,2.58,-0.13,-4.8,197000,15,529790,0,0,0,0,0,0,78000,119000,-41000,-41000
20200212,054862,群光群益97購01,,,,,0.00,0.00,0,0,0,0,0,0,0,0,0,0,0,0,0
20200212,054863,億光群益97購01,1.40,1.40,1.40,1.40,0.00,0.00,48000,3,67200,0,0,0,0,0,0,48000,0,48000,48000
20200212,054864,聯發科群益97購02,0.44,0.54,0.44,0.54,+0.15,38.46,61000,7,29620,0,0,0,0,0,0,60000,1000,59000,59000
20200212,054865,可成群益97購01,1.99,2.21,1.92,2.21,+0.37,20.11,625000,32,1296890,0,0,0,0,0,0,181000,534000,-353000,-353000
20200212,054866,宏盛群益98購01,0.74,0.75,0.74,0.74,0.00,0.00,95000,4,70320,0,0,0,0,0,0,25000,70000,-45000,-45000
20200212,054867,華航群益99購01,0.59,0.60,0.58,0.60,+0.02,3.45,204000,9,119990,0,0,0,0,0,0,80000,124000,-44000,-44000
20200212,054868,國泰金群益9A購01,0.79,0.83,0.79,0.83,+0.05,6.41,25000,3,20090,0,0,0,0,0,0,3000,22000,-19000,-19000
20200212,054869,新光金群益97購01,0.35,0.35,0.35,0.35,0.00,0.00,1000,1,350,0,0,0,0,0,0,1000,0,1000,1000
20200212,05486P,大立光凱基95售14,1.41,1.41,1.41,1.41,-0.13,-8.44,40000,1,56400,0,0,0,0,0,0,40000,0,40000,40000
20200212,054870,新日興群益98購01,2.53,2.53,2.39,2.43,-0.20,-7.6,263000,29,655770,0,0,0,0,0,0,231000,82000,149000,149000
20200212,054871,明泰群益98購01,0.86,0.91,0.86,0.91,0.00,0.00,378000,3,325630,0,0,0,0,0,0,0,378000,-378000,-378000
20200212,054872,瀚宇博群益98購01,0.92,1.06,0.92,1.06,+0.08,8.16,8000,5,7590,0,0,0,0,0,0,7000,1000,6000,6000
20200212,054873,帆宣群益99購01,1.29,1.34,1.28,1.29,+0.02,1.57,81000,10,105250,0,0,0,0,0,0,29000,52000,-23000,-23000
20200212,054874,帆宣群益99購02,1.49,1.54,1.48,1.54,+0.09,6.21,75000,6,113410,0,0,0,0,0,0,33000,42000,-9000,-9000
20200212,054875,群電群益97購01,,,,,0.00,0.00,0,0,0,0,0,0,0,0,0,0,0,0,0
20200212,054876,群電群益97購02,1.11,1.11,1.11,1.11,+0.03,2.78,38000,2,42180,0,0,0,0,0,0,38000,0,38000,38000
20200212,054877,百和群益98購01,,,,,0.00,0.00,0,0,0,0,0,0,0,0,0,0,0,0,0
20200212,054878,和大統一97購02,0.89,0.90,0.85,0.90,0.00,0.00,240000,8,210700,0,0,0,0,0,0,110000,130000,-20000,-20000
20200212,054879,大成鋼統一97購01,0.59,0.62,0.58,0.62,+0.01,1.64,178000,5,107760,0,0,0,0,0,0,50000,128000,-78000,-78000
20200212,05487P,台表科凱基95售02,,,,,0.00,0.00,0,0,0,0,0,0,0,0,0,0,0,0,0
20200212,054880,華泰統一97購01,0.92,0.96,0.89,0.94,+0.05,5.62,302000,17,280980,0,0,0,0,0,0,114000,170000,-56000,-56000
20200212,054881,光罩統一97購01,1.78,1.93,1.76,1.91,+0.18,10.4,338000,25,628330,0,0,0,0,0,0,36000,302000,-266000,-266000
20200212,054882,台光電統一97購02,0.65,0.87,0.65,0.82,+0.16,24.24,143000,28,114310,0,0,0,0,0,0,35000,143000,-108000,-108000
20200212,054883,億光統一97購01,2.18,2.27,2.18,2.18,+0.04,1.87,70000,5,155320,0,0,0,0,0,0,50000,20000,30000,30000
20200212,054884,友達統一99購01,1.25,1.25,1.14,1.14,-0.12,-9.52,651000,37,767980,0,0,0,0,0,0,124000,513000,-389000,-389000
20200212,054885,建準統一98購01,,,,,0.00,0.00,0,0,0,0,0,0,0,0,0,0,0,0,0
20200212,054886,大毅統一97購01,4.64,4.64,4.32,4.44,-0.41,-8.45,76000,6,341840,0,0,0,0,0,0,26000,50000,-24000,-24000
20200212,054887,大毅統一98購01,4.96,4.96,4.96,4.96,0.00,0.00,15000,1,74400,0,0,0,0,0,0,15000,0,15000,15000
20200212,054888,泰碩統一97購01,0.29,0.29,0.29,0.29,-0.03,-9.38,30000,1,8700,0,0,0,0,0,0,30000,0,30000,30000
20200212,054889,京鼎統一99購01,0.81,0.93,0.81,0.93,+0.19,25.68,857000,23,728560,0,0,0,0,0,0,360000,557000,-197000,-197000
20200212,05488P,臺股指凱基95售21,,,,,0.00,0.00,0,0,0,0,0,0,0,0,0,0,0,0,0
20200212,054890,聯鈞統一99購01,1.22,1.31,1.22,1.31,+0.16,13.91,381000,18,485910,0,0,0,0,0,0,10000,371000,-361000,-361000
20200212,054891,聯鈞統一99購02,0.49,0.58,0.49,0.58,+0.12,26.09,877000,15,488060,0,0,0,0,0,0,716000,161000,555000,555000
20200212,054892,彩晶統一99購01,,,,,0.00,0.00,0,0,0,0,0,0,0,0,0,0,0,0,0
20200212,054893,帆宣統一99購01,0.80,0.81,0.78,0.78,+0.02,2.63,136000,7,108540,0,0,0,0,0,0,18000,118000,-100000,-100000
20200212,054894,GIS統一97購01,0.42,0.43,0.42,0.43,0.00,0.00,293000,11,124140,0,0,0,0,0,0,80000,213000,-133000,-133000
20200212,054895,南電統一97購01,1.17,1.34,1.15,1.34,+0.23,20.72,326000,24,406780,0,0,0,0,0,0,250000,76000,174000,174000
20200212,054896,聯茂日盛97購01,1.20,1.72,1.20,1.53,+0.33,27.5,1703000,90,2543180,0,0,0,0,0,0,737000,1083000,-346000,-346000
20200212,054897,信錦康和97購01,0.64,0.64,0.64,0.64,0.00,0.00,36000,1,23040,0,0,0,0,0,0,0,36000,-36000,-36000
20200212,054898,台肥康和97購01,0.73,0.77,0.73,0.77,0.00,0.00,102000,4,76640,0,0,0,0,0,0,0,102000,-102000,-102000
20200212,054899,南港康和97購01,0.66,0.73,0.66,0.73,+0.04,5.8,108000,6,76510,0,0,0,0,0,0,4000,104000,-100000,-100000
20200212,05489P,臺股指凱基95售22,1.52,1.52,1.34,1.34,-0.22,-14.1,471000,54,676060,0,0,0,0,0,0,15000,431000,-416000,-416000
20200212,054900,金寶康和97購01,1.43,1.43,1.33,1.43,+0.01,0.7,616000,49,838610,0,0,0,0,0,0,465000,204000,261000,261000
20200212,054901,群光康和97購01,,,,,0.00,0.00,0,0,0,0,0,0,0,0,0,0,0,0,0
20200212,054902,億光康和97購01,0.91,0.91,0.88,0.88,-0.02,-2.22,138000,2,123540,0,0,0,0,0,0,70000,68000,2000,2000
20200212,054903,億光康和97購02,0.86,0.86,0.86,0.86,+0.05,6.17,59000,1,50740,0,0,0,0,0,0,59000,0,59000,59000
20200212,054904,興勤康和97購01,0.54,0.54,0.54,0.54,0.00,0.00,47000,2,25380,0,0,0,0,0,0,0,47000,-47000,-47000
20200212,054905,國揚康和97購01,1.34,1.40,1.34,1.34,-0.06,-4.29,447000,10,608360,0,0,0,0,0,0,69000,378000,-309000,-309000
20200212,054906,神達康和97購01,0.88,0.97,0.88,0.96,+0.16,20.0,209000,4,196110,0,0,0,0,0,0,68000,141000,-73000,-73000
20200212,054907,帆宣康和97購01,0.80,0.80,0.79,0.79,+0.05,6.76,45000,3,35840,0,0,0,0,0,0,1000,44000,-43000,-43000
20200212,054908,群電康和97購01,0.63,0.67,0.63,0.67,0.00,0.00,17000,2,10990,0,0,0,0,0,0,0,17000,-17000,-17000
20200212,054909,福懋科康和97購01,1.30,1.30,1.17,1.27,0.00,0.00,336000,31,412530,0,0,0,0,0,0,252000,83000,169000,169000
20200212,05490P,鴻海元大95售23,1.41,1.41,1.25,1.25,-0.20,-13.79,191000,10,249260,0,0,0,0,0,0,65000,126000,-61000,-61000
20200212,054910,信錦凱基97購01,1.32,1.32,1.32,1.32,+0.07,5.6,20000,2,26400,0,0,0,0,0,0,20000,0,20000,20000
20200212,054911,敬鵬凱基97購01,,,,,0.00,0.00,0,0,0,0,0,0,0,0,0,0,0,0,0
20200212,054912,群光凱基97購01,1.20,1.20,1.20,1.20,+0.01,0.84,4000,1,4800,0,0,0,0,0,0,0,4000,-4000,-4000
20200212,054913,億光凱基97購01,,,,,0.00,0.00,0,0,0,0,0,0,0,0,0,0,0,0,0
20200212,054914,億光凱基98購01,1.19,1.21,1.13,1.14,-0.01,-0.87,120000,8,142310,0,0,0,0,0,0,106000,12000,94000,94000
20200212,054915,興勤凱基97購01,0.67,0.67,0.67,0.67,0.00,0.00,50000,2,33500,0,0,0,0,0,0,0,50000,-50000,-50000
20200212,054916,聯發科凱基98購04,0.58,0.58,0.10,0.58,+0.07,13.73,510000,6,291000,0,0,0,0,0,0,499000,10000,489000,489000
20200212,054917,聯發科凱基98購05,,,,,0.00,0.00,0,0,0,0,0,0,0,0,0,0,0,0,0
20200212,054918,華新科凱基98購02,1.68,1.74,1.65,1.68,+0.10,6.33,148000,22,254090,0,0,0,0,0,0,38000,117000,-79000,-79000
20200212,054919,興富發凱基97購01,0.92,0.94,0.92,0.94,+0.05,5.62,150000,4,138560,0,0,0,0,0,0,150000,0,150000,150000
20200212,05491P,茂林元大95售04,1.10,1.14,1.09,1.11,-0.03,-2.63,507000,26,564070,0,0,0,0,0,0,472000,491000,-19000,-19000
20200212,054920,智原凱基98購01,0.36,0.43,0.36,0.43,+0.07,19.44,195000,25,71630,0,0,0,0,0,0,125000,70000,55000,55000
20200212,054921,文曄凱基97購01,,,,,0.00,0.00,0,0,0,0,0,0,0,0,0,0,0,0,0
20200212,054922,文曄凱基98購01,1.64,1.64,1.64,1.64,+0.12,7.89,13000,1,21320,0,0,0,0,0,0,13000,0,13000,13000
20200212,054923,晶技凱基98購01,,,,,0.00,0.00,0,0,0,0,0,0,0,0,0,0,0,0,0
20200212,054924,景碩凱基98購01,1.31,1.59,1.31,1.52,+0.19,14.29,35000,24,53350,0,0,0,0,0,0,35000,28000,7000,7000
20200212,054925,神達凱基97購01,1.06,1.23,1.06,1.23,+0.18,17.14,88000,9,98940,0,0,0,0,0,0,15000,3000,12000,12000
20200212,054926,神達凱基98購01,1.31,1.31,1.31,1.31,+0.17,14.91,28000,5,36680,0,0,0,0,0,0,10000,18000,-8000,-8000
20200212,054927,帆宣凱基97購01,1.09,1.09,1.02,1.04,+0.02,1.96,46000,4,48600,0,0,0,0,0,0,9000,46000,-37000,-37000
20200212,054928,帆宣凱基98購01,1.41,1.41,1.41,1.41,+0.09,6.82,14000,1,19740,0,0,0,0,0,0,14000,0,14000,14000
20200212,054929,群電凱基97購01,1.09,1.09,1.09,1.09,+0.04,3.81,57000,1,62130,0,0,0,0,0,0,57000,0,57000,57000
20200212,05492P,聯茂元大95售02,1.75,1.75,1.50,1.52,-0.46,-23.23,144000,7,248650,0,0,0,0,0,0,133000,27000,106000,106000
20200212,054930,群電凱基98購01,1.68,1.68,1.68,1.68,0.00,0.00,10000,1,16800,0,0,0,0,0,0,0,10000,-10000,-10000
20200212,054931,緯穎凱基98購01,1.38,1.45,1.31,1.45,+0.05,3.57,82000,4,115960,0,0,0,0,0,0,22000,60000,-38000,-38000
20200212,054932,台肥元大97購01,1.79,1.92,1.79,1.91,+0.11,6.11,345000,16,638970,0,0,0,0,0,0,214000,173000,41000,41000
20200212,054933,南港元大97購01,1.31,1.56,1.31,1.56,+0.14,9.86,425000,17,617740,0,0,0,0,0,0,261000,178000,83000,83000
20200212,054934,金寶元大97購01,2.21,2.21,2.14,2.21,-0.04,-1.78,176000,16,379600,0,0,0,0,0,0,174000,33000,141000,141000
20200212,054935,華通元大98購03,0.97,1.28,0.94,1.26,+0.36,40.0,297000,35,320170,0,0,0,0,0,0,270000,77000,193000,193000
20200212,054936,鴻海元大97購10,1.19,1.40,1.19,1.40,+0.27,23.89,247000,8,326490,0,0,0,0,0,0,237000,217000,20000,20000
20200212,054937,國巨元大97購03,1.63,1.66,1.58,1.65,+0.13,8.55,107000,14,173550,0,0,0,0,0,0,23000,84000,-61000,-61000
20200212,054938,國巨元大97購04,1.70,1.73,1.61,1.73,+0.14,8.81,281000,40,468260,0,0,0,0,0,0,174000,127000,47000,47000
20200212,054939,台積電元大97購15,2.79,2.79,2.79,2.79,+0.14,5.28,49000,2,136710,0,0,0,0,0,0,49000,49000,0,0
20200212,05493P,華新科富邦99售02,,,,,0.00,0.00,0,0,0,0,0,0,0,0,0,0,0,0,0
20200212,054940,台積電元大97購16,2.71,2.75,2.71,2.75,+0.11,4.17,59000,2,160290,0,0,0,0,0,0,59000,49000,10000,10000
20200212,054941,凱美元大97購01,1.62,1.76,1.59,1.71,+0.08,4.91,220000,19,364280,0,0,0,0,0,0,122000,113000,9000,9000
20200212,054942,凱美元大97購02,1.00,1.10,0.97,1.07,+0.08,8.08,781000,51,820670,0,0,0,0,0,0,253000,626000,-373000,-373000
20200212,054943,群光元大97購01,1.95,2.01,1.95,2.01,+0.03,1.52,220000,6,436400,0,0,0,0,0,0,80000,140000,-60000,-60000
20200212,054944,精元元大97購01,1.63,1.63,1.63,1.63,+0.14,9.4,3000,1,4890,0,0,0,0,0,0,0,3000,-3000,-3000
20200212,054945,正崴元大97購01,1.01,1.01,0.99,0.99,-0.01,-1.0,88000,3,88800,0,0,0,0,0,0,88000,0,88000,88000
20200212,054946,億光元大97購01,3.27,3.35,3.18,3.35,+0.06,1.82,65000,7,214300,0,0,0,0,0,0,65000,0,65000,65000
20200212,054947,興勤元大97購01,0.99,1.12,0.99,1.12,+0.09,8.74,732000,12,796950,0,0,0,0,0,0,202000,532000,-330000,-330000
20200212,054948,聯發科元大97購14,1.06,1.20,1.04,1.13,+0.17,17.71,198000,14,222420,0,0,0,0,0,0,188000,10000,178000,178000
20200212,054949,奇力新元大98購01,0.95,1.08,0.94,1.07,+0.13,13.83,302000,28,297060,0,0,0,0,0,0,219000,143000,76000,76000
20200212,05494P,華邦電統一95售02,,,,,0.00,0.00,0,0,0,0,0,0,0,0,0,0,0,0,0
20200212,054950,奇力新元大98購02,1.03,1.03,1.03,1.03,+0.07,7.29,12000,1,12360,0,0,0,0,0,0,12000,0,12000,12000
20200212,054951,大毅元大97購01,4.77,4.77,4.73,4.73,-0.08,-1.66,108000,3,515040,0,0,0,0,0,0,105000,108000,-3000,-3000
20200212,054952,大毅元大97購02,3.80,3.80,3.50,3.54,-0.34,-8.76,29000,8,105820,0,0,0,0,0,0,6000,23000,-17000,-17000
20200212,054953,華新科元大97購05,1.18,1.18,1.18,1.18,+0.07,6.31,2000,1,2360,0,0,0,0,0,0,2000,0,2000,2000
20200212,054954,華新科元大97購06,,,,,0.00,0.00,0,0,0,0,0,0,0,0,0,0,0,0,0
20200212,054955,宏達電元大98購01,1.07,1.07,1.07,1.07,0.00,0.00,1000,1,1070,0,0,0,0,0,0,0,1000,-1000,-1000
20200212,054956,宏盛元大97購01,1.06,1.06,1.06,1.06,0.00,0.00,10000,1,10600,0,0,0,0,0,0,0,10000,-10000,-10000
20200212,054957,興富發元大97購01,2.21,2.27,2.21,2.25,-0.04,-1.75,200000,6,447900,0,0,0,0,0,0,150000,50000,100000,100000
20200212,054958,亞光元大97購03,0.37,0.38,0.37,0.38,+0.07,22.58,28000,2,10440,0,0,0,0,0,0,28000,0,28000,28000
20200212,054959,禾伸堂元大98購01,1.24,1.24,1.24,1.24,-0.06,-4.62,4000,2,4960,0,0,0,0,0,0,4000,0,4000,4000
20200212,05495P,大立光統一95售07,1.99,1.99,1.81,1.81,-0.23,-11.27,342000,16,646640,0,0,0,0,0,0,111000,231000,-120000,-120000
20200212,054960,新日興元大97購02,2.30,2.33,2.19,2.23,-0.05,-2.19,226000,22,511620,0,0,0,0,0,0,159000,67000,92000,92000
20200212,054961,玉晶光元大99購01,0.90,0.95,0.88,0.94,+0.09,10.59,620000,44,571230,0,0,0,0,0,0,431000,145000,286000,286000
20200212,054962,玉晶光元大99購02,1.13,1.21,1.13,1.20,+0.12,11.11,262000,19,304600,0,0,0,0,0,0,42000,162000,-120000,-120000
20200212,054963,牧德元大97購02,1.21,1.28,1.15,1.15,-0.06,-4.96,592000,32,713270,0,0,0,0,0,0,225000,426000,-201000,-201000
20200212,054964,智易元大99購01,1.28,1.55,1.28,1.55,+0.29,23.02,195000,7,281420,0,0,0,0,0,0,142000,153000,-11000,-11000
20200212,054965,健策元大98購04,1.02,1.08,0.95,1.07,+0.11,11.46,617000,45,620880,0,0,0,0,0,0,541000,526000,15000,15000
20200212,054966,貿聯元大98購02,0.57,0.62,0.57,0.62,+0.09,16.98,150000,4,90300,0,0,0,0,0,0,100000,50000,50000,50000
20200212,054967,神達元大97購01,2.59,2.91,2.59,2.87,+0.37,14.8,945000,72,2685070,0,0,0,0,0,0,116000,895000,-779000,-779000
20200212,054968,佐登元大97購01,0.38,0.44,0.38,0.42,+0.03,7.69,1377000,20,577100,0,0,0,0,0,0,1339000,30000,1309000,1309000
20200212,054969,亞翔元大97購01,2.31,2.42,2.31,2.42,+0.20,9.01,56000,3,131030,0,0,0,0,0,0,0,56000,-56000,-56000
20200212,05496P,聯詠統一95售04,1.10,1.18,1.10,1.12,-0.12,-9.68,508000,21,583320,0,0,0,0,0,0,2000,506000,-504000,-504000
20200212,054970,帆宣元大97購01,2.28,2.37,2.25,2.25,+0.01,0.45,163000,10,373750,0,0,0,0,0,0,143000,28000,115000,115000
20200212,054971,帆宣元大97購02,1.80,1.90,1.80,1.82,+0.05,2.82,481000,26,888860,0,0,0,0,0,0,362000,119000,243000,243000
20200212,054972,聯茂元大97購02,1.15,1.53,1.15,1.39,+0.25,21.93,885000,53,1216850,0,0,0,0,0,0,407000,555000,-148000,-148000
20200212,054973,台郡元大98購02,1.02,1.04,0.97,1.04,+0.43,70.49,239000,9,237510,0,0,0,0,0,0,171000,68000,103000,103000
20200212,054974,台表科元大98購02,1.63,1.77,1.63,1.77,+0.16,9.94,108000,7,180020,0,0,0,0,0,0,90000,30000,60000,60000
20200212,054975,福懋科元大97購01,2.92,2.92,2.65,2.65,-0.08,-2.93,88000,11,244980,0,0,0,0,0,0,88000,0,88000,88000
20200212,054976,上証2X元富9A購01,1.29,1.29,1.29,1.29,-0.03,-2.27,10000,1,12900,0,0,0,0,0,0,0,10000,-10000,-10000
20200212,054977,SP黃豆元富9B購01,,,,,0.00,0.00,0,0,0,0,0,0,0,0,0,0,0,0,0
20200212,054978,堤維西元富97購01,0.85,0.86,0.85,0.86,+0.04,4.88,28000,4,23900,0,0,0,0,0,0,18000,10000,8000,8000
20200212,054979,南港元富97購01,0.57,0.70,0.57,0.70,+0.08,12.9,601000,45,370160,0,0,0,0,0,0,518000,57000,461000,461000
20200212,05497P,聯詠統一96售01,1.43,1.51,1.42,1.51,-0.07,-4.43,586000,14,859950,0,0,0,0,0,0,144000,442000,-298000,-298000
20200212,054980,國巨元富97購01,0.99,1.01,0.93,1.01,+0.09,9.78,1115000,53,1091850,0,0,0,0,0,0,495000,611000,-116000,-116000
20200212,054981,國巨元富97購02,0.71,0.72,0.67,0.72,+0.06,9.09,168000,14,116520,0,0,0,0,0,0,154000,9000,145000,145000
20200212,054982,國巨元富97購03,0.67,0.69,0.62,0.68,+0.06,9.68,1641000,59,1086360,0,0,0,0,0,0,803000,746000,57000,57000
20200212,054983,國巨元富97購04,0.74,0.76,0.68,0.75,+0.07,10.29,1540000,56,1101600,0,0,0,0,0,0,991000,548000,443000,443000
20200212,054984,華泰元富97購01,0.62,0.66,0.62,0.63,+0.03,5.0,210000,9,132280,0,0,0,0,0,0,114000,36000,78000,78000
20200212,054985,光罩元富97購01,1.29,1.42,1.29,1.37,+0.10,7.87,178000,18,239620,0,0,0,0,0,0,46000,132000,-86000,-86000
20200212,054986,藍天元富97購01,0.62,0.64,0.61,0.63,+0.01,1.61,152000,5,94710,0,0,0,0,0,0,147000,5000,142000,142000
20200212,054987,凱美元富97購01,0.50,0.56,0.50,0.54,+0.04,8.0,379000,11,194950,0,0,0,0,0,0,257000,117000,140000,140000
20200212,054988,凱美元富97購02,0.64,0.71,0.63,0.70,+0.04,6.06,416000,29,277680,0,0,0,0,0,0,238000,178000,60000,60000
20200212,054989,精元元富97購01,,,,,0.00,0.00,0,0,0,0,0,0,0,0,0,0,0,0,0
20200212,05498P,友達元富95售02,,,,,0.00,0.00,0,0,0,0,0,0,0,0,0,0,0,0,0
20200212,054990,凌陽元富97購01,0.68,0.69,0.68,0.69,+0.03,4.55,20000,2,13700,0,0,0,0,0,0,20000,0,20000,20000
20200212,054991,南亞科元富97購01,1.04,1.05,1.02,1.04,-0.03,-2.8,469000,15,484670,0,0,0,0,0,0,271000,219000,52000,52000
20200212,054992,南亞科元富97購02,0.72,0.72,0.72,0.72,+0.01,1.41,32000,2,23040,0,0,0,0,0,0,32000,0,32000,32000
20200212,054993,南亞科元富97購03,0.96,0.96,0.96,0.96,0.00,0.00,10000,1,9600,0,0,0,0,0,0,0,10000,-10000,-10000
20200212,054994,建準元富97購01,,,,,0.00,0.00,0,0,0,0,0,0,0,0,0,0,0,0,0
20200212,054995,宏盛元富97購01,,,,,0.00,0.00,0,0,0,0,0,0,0,0,0,0,0,0,0
20200212,054996,聯陽元富97購01,1.06,1.07,1.06,1.07,0.00,0.00,8000,2,8530,0,0,0,0,0,0,3000,5000,-2000,-2000
20200212,054997,文曄元富97購01,0.66,0.68,0.66,0.68,0.00,0.00,69000,2,46220,0,0,0,0,0,0,0,69000,-69000,-69000
20200212,054998,玉晶光元富97購02,1.55,1.68,1.55,1.64,+0.18,12.33,126000,9,204940,0,0,0,0,0,0,50000,76000,-26000,-26000
20200212,054999,玉晶光元富97購03,1.22,1.32,1.20,1.30,+0.16,14.04,430000,19,542700,0,0,0,0,0,0,140000,290000,-150000,-150000
20200212,05499P,聯詠元富95售02,0.77,0.81,0.77,0.80,-0.06,-6.98,30000,5,23880,0,0,0,0,0,0,5000,25000,-20000,-20000
20200212,055000,玉晶光元富97購04,0.99,1.06,0.98,1.06,+0.15,16.48,55000,5,55400,0,0,0,0,0,0,25000,30000,-5000,-5000
20200212,055001,京鼎元富97購01,1.10,1.33,1.10,1.32,+0.29,28.16,249000,43,310660,0,0,0,0,0,0,0,249000,-249000,-249000
20200212,055002,群創元富99購04,1.60,1.60,1.56,1.56,+0.02,1.3,332000,12,523560,0,0,0,0,0,0,240000,92000,148000,148000
20200212,055003,群創元富99購05,1.42,1.43,1.39,1.40,+0.03,2.19,328000,9,463540,0,0,0,0,0,0,272000,56000,216000,216000
20200212,055004,群創元富99購06,,,,,0.00,0.00,0,0,0,0,0,0,0,0,0,0,0,0,0
20200212,055005,晶相光元富97購01,1.52,1.58,1.49,1.49,+0.07,4.93,153000,11,234410,0,0,0,0,0,0,80000,96000,-16000,-16000
20200212,055006,晶相光元富9A購01,1.40,1.48,1.39,1.39,+0.02,1.46,168000,20,238850,0,0,0,0,0,0,48000,120000,-72000,-72000
20200212,055007,晶相光元富9A購02,1.03,1.10,1.03,1.03,+0.04,4.04,71000,8,75600,0,0,0,0,0,0,30000,41000,-11000,-11000
20200212,055008,隆達元富97購01,1.27,1.33,1.27,1.33,+0.03,2.31,456000,19,591130,0,0,0,0,0,0,206000,200000,6000,6000
20200212,055009,合勤控元富97購01,0.45,0.48,0.45,0.46,0.00,0.00,612000,7,282240,0,0,0,0,0,0,0,612000,-612000,-612000
20200212,05500P,臺股指中信96售04,1.09,1.09,1.09,1.09,0.00,0.00,10000,1,10900,0,0,0,0,0,0,0,10000,-10000,-10000
20200212,055010,佐登元富97購01,0.45,0.48,0.45,0.47,+0.07,17.5,90000,3,41600,0,0,0,0,0,0,40000,50000,-10000,-10000
20200212,055011,元翎元富97購01,0.62,0.71,0.62,0.71,+0.10,16.39,105000,8,69350,0,0,0,0,0,0,65000,40000,25000,25000
20200212,055012,茂林元富97購01,1.12,1.16,1.10,1.15,+0.02,1.77,302000,26,344060,0,0,0,0,0,0,195000,103000,92000,92000
20200212,055013,訊連元富97購01,1.20,1.37,1.19,1.23,-0.04,-3.15,421000,24,534390,0,0,0,0,0,0,120000,298000,-178000,-178000
20200212,055014,達興元富97購01,1.13,1.13,1.13,1.13,+0.01,0.89,10000,1,11300,0,0,0,0,0,0,0,10000,-10000,-10000
20200212,055015,帆宣元富97購01,1.80,1.86,1.79,1.82,+0.07,4.0,611000,19,1111370,0,0,0,0,0,0,274000,345000,-71000,-71000
20200212,055016,群電元富97購01,,,,,0.00,0.00,0,0,0,0,0,0,0,0,0,0,0,0,0
20200212,055017,緯穎元富97購01,1.73,1.90,1.73,1.90,+0.13,7.34,472000,6,876000,0,0,0,0,0,0,149000,323000,-174000,-174000
20200212,055018,緯穎元富97購02,1.31,1.44,1.23,1.42,+0.04,2.9,2971000,34,4087360,0,0,0,0,0,0,1425000,1494000,-69000,-69000
20200212,055019,福懋科元富97購01,2.73,2.73,2.38,2.56,-0.04,-1.54,362000,35,914790,0,0,0,0,0,0,285000,144000,141000,141000
20200212,05501P,健策國票97售01,0.47,0.55,0.44,0.55,+0.03,5.77,521000,20,235650,0,0,0,0,0,0,0,520000,-520000,-520000
20200212,055020,上証2X國泰98購01,,,,,0.00,0.00,0,0,0,0,0,0,0,0,0,0,0,0,0
20200212,055021,亞德客國泰98購01,2.88,3.10,2.82,3.04,-0.04,-1.3,280000,30,836830,0,0,0,0,0,0,260000,94000,166000,166000
20200212,055022,精元國泰99購01,1.24,1.29,1.24,1.29,+0.05,4.03,90000,8,113700,0,0,0,0,0,0,0,90000,-90000,-90000
20200212,055023,億光國泰98購01,2.07,2.11,1.98,2.01,-0.01,-0.5,173000,16,352320,0,0,0,0,0,0,172000,0,172000,172000
20200212,055024,興勤國泰98購01,0.98,1.07,0.98,1.07,+0.12,12.63,147000,17,150760,0,0,0,0,0,0,20000,127000,-107000,-107000
20200212,055025,華新科國泰98購02,3.21,3.22,3.06,3.11,+0.06,1.97,337000,37,1059550,0,0,0,0,0,0,337000,72000,265000,265000
20200212,055026,健和興國泰98購01,1.51,1.61,1.51,1.61,+0.13,8.78,81000,10,126510,0,0,0,0,0,0,2000,79000,-77000,-77000
20200212,055027,牧德國泰99購01,2.01,2.09,1.90,1.92,-0.07,-3.52,1161000,71,2318970,0,0,0,0,0,0,417000,704000,-287000,-287000
20200212,055028,佐登國泰98購01,1.11,1.26,1.11,1.26,+0.14,12.5,816000,19,994730,0,0,0,0,0,0,104000,712000,-608000,-608000
20200212,055029,帆宣國泰99購01,1.53,1.61,1.51,1.55,+0.01,0.65,631000,39,981190,0,0,0,0,0,0,449000,256000,193000,193000
20200212,05502P,台表科國票97售01,1.16,1.16,1.14,1.14,-0.07,-5.79,50000,3,57600,0,0,0,0,0,0,0,50000,-50000,-50000
20200212,055030,帆宣國泰99購02,1.82,1.86,1.74,1.78,+0.04,2.3,154000,17,277850,0,0,0,0,0,0,113000,96000,17000,17000
20200212,055031,南港富邦99購01,0.45,0.45,0.44,0.44,+0.03,7.32,15000,2,6700,0,0,0,0,0,0,0,15000,-15000,-15000
20200212,055032,億光富邦99購01,1.01,1.01,1.01,1.01,0.00,0.00,2000,1,2020,0,0,0,0,0,0,2000,0,2000,2000
20200212,055033,漢唐富邦98購01,0.32,0.34,0.32,0.34,+0.02,6.25,106000,9,35240,0,0,0,0,0,0,99000,6000,93000,93000
20200212,055034,建準富邦99購01,,,,,0.00,0.00,0,0,0,0,0,0,0,0,0,0,0,0,0
20200212,055035,興勤富邦98購01,,,,,0.00,0.00,0,0,0,0,0,0,0,0,0,0,0,0,0
20200212,055036,中工富邦9B購01,,,,,0.00,0.00,0,0,0,0,0,0,0,0,0,0,0,0,0
20200212,055037,宏盛富邦99購01,,,,,0.00,0.00,0,0,0,0,0,0,0,0,0,0,0,0,0
20200212,055038,華航富邦99購01,0.59,0.61,0.59,0.60,+0.02,3.45,229000,9,137110,0,0,0,0,0,0,67000,142000,-75000,-75000
20200212,055039,神達富邦99購01,0.93,1.03,0.93,1.03,+0.11,11.96,1168000,36,1156150,0,0,0,0,0,0,152000,936000,-784000,-784000
20200212,05503P,智邦日盛96售01,,,,,0.00,0.00,0,0,0,0,0,0,0,0,0,0,0,0,0
20200212,055040,台虹富邦99購01,0.75,0.76,0.74,0.74,0.00,0.00,160000,4,120600,0,0,0,0,0,0,0,160000,-160000,-160000
20200212,055041,致新富邦97購01,0.33,0.34,0.31,0.33,-0.01,-2.94,536000,26,175330,0,0,0,0,0,0,506000,0,506000,506000
20200212,055042,得力永豐97購01,0.43,0.43,0.43,0.43,-0.04,-8.51,68000,1,29240,0,0,0,0,0,0,0,68000,-68000,-68000
20200212,055043,中砂永豐97購01,,,,,0.00,0.00,0,0,0,0,0,0,0,0,0,0,0,0,0
20200212,055044,信錦永豐97購01,0.78,0.78,0.78,0.78,+0.05,6.85,29000,1,22620,0,0,0,0,0,0,0,29000,-29000,-29000
20200212,055045,台肥永豐97購01,0.65,0.70,0.65,0.70,+0.03,4.48,564000,8,387300,0,0,0,0,0,0,71000,493000,-422000,-422000
20200212,055046,上銀永豐97購01,1.14,1.14,1.14,1.14,0.00,0.00,34000,2,38760,0,0,0,0,0,0,34000,0,34000,34000
20200212,055047,南港永豐97購01,0.50,0.52,0.50,0.52,+0.04,8.33,48000,3,24030,0,0,0,0,0,0,0,48000,-48000,-48000
20200212,055048,台積電永豐97購04,0.69,0.73,0.69,0.73,+0.09,14.06,71000,4,49720,0,0,0,0,0,0,1000,70000,-69000,-69000
20200212,055049,智邦永豐97購01,0.88,0.88,0.79,0.86,+0.05,6.17,223000,7,188910,0,0,0,0,0,0,130000,95000,35000,35000
20200212,05504P,台積電凱基96售04,0.17,0.17,0.17,0.17,-0.04,-19.05,120000,2,20400,0,0,0,0,0,0,100000,20000,80000,80000
20200212,055050,敬鵬永豐97購01,0.48,0.50,0.48,0.50,0.00,0.00,91000,5,45380,0,0,0,0,0,0,10000,81000,-71000,-71000
20200212,055051,藍天永豐97購01,,,,,0.00,0.00,0,0,0,0,0,0,0,0,0,0,0,0,0
20200212,055052,凱美永豐97購01,0.69,0.71,0.69,0.71,+0.07,10.94,361000,5,250910,0,0,0,0,0,0,37000,361000,-324000,-324000
20200212,055053,瑞昱永豐97購01,0.64,0.73,0.64,0.67,+0.08,13.56,117000,9,78770,0,0,0,0,0,0,16000,101000,-85000,-85000
20200212,055054,群光永豐97購01,,,,,0.00,0.00,0,0,0,0,0,0,0,0,0,0,0,0,0
20200212,055055,精元永豐97購01,0.81,0.81,0.81,0.81,0.00,0.00,59000,1,47790,0,0,0,0,0,0,0,59000,-59000,-59000
20200212,055056,億光永豐97購01,0.99,1.01,0.96,1.01,+0.04,4.12,132000,6,130170,0,0,0,0,0,0,22000,110000,-88000,-88000
20200212,055057,興勤永豐97購01,0.50,0.50,0.50,0.50,0.00,0.00,97000,3,48500,0,0,0,0,0,0,0,97000,-97000,-97000
20200212,055058,大毅永豐97購01,2.71,2.71,2.53,2.59,-0.13,-4.78,114000,16,299810,0,0,0,0,0,0,104000,32000,72000,72000
20200212,055059,健和興永豐97購01,0.55,0.55,0.55,0.55,0.00,0.00,100000,2,55000,0,0,0,0,0,0,0,100000,-100000,-100000
20200212,05505P,聯發科凱基96售09,1.21,1.21,1.21,1.21,-0.27,-18.24,3000,1,3630,0,0,0,0,0,0,0,3000,-3000,-3000
20200212,055060,聯陽永豐97購01,,,,,0.00,0.00,0,0,0,0,0,0,0,0,0,0,0,0,0
20200212,055061,聯詠永豐97購01,0.87,0.87,0.80,0.86,+0.09,11.69,301000,7,253430,0,0,0,0,0,0,180000,121000,59000,59000
20200212,055062,文曄永豐97購01,,,,,0.00,0.00,0,0,0,0,0,0,0,0,0,0,0,0,0
20200212,055063,玉晶光永豐99購01,0.71,0.75,0.70,0.74,+0.07,10.45,502000,11,360760,0,0,0,0,0,0,112000,390000,-278000,-278000
20200212,055064,碩天永豐97購01,0.56,0.57,0.56,0.56,+0.03,5.66,11000,3,6170,0,0,0,0,0,0,10000,1000,9000,9000
20200212,055065,神達永豐97購01,0.65,0.75,0.61,0.75,+0.10,15.38,530000,27,363630,0,0,0,0,0,0,84000,446000,-362000,-362000
20200212,055066,佐登永豐97購01,0.20,0.22,0.20,0.22,+0.02,10.0,80000,2,17000,0,0,0,0,0,0,80000,0,80000,80000
20200212,055067,禾聯碩永豐97購01,0.65,0.65,0.65,0.65,-0.02,-2.99,49000,2,31850,0,0,0,0,0,0,0,0,0,0
20200212,055068,亞翔永豐97購01,0.77,0.82,0.77,0.82,+0.05,6.49,108000,4,84640,0,0,0,0,0,0,20000,88000,-68000,-68000
20200212,055069,帆宣永豐97購01,1.32,1.33,1.29,1.30,0.00,0.00,237000,8,310390,0,20000,-20000,0,0,0,184000,38000,146000,126000
20200212,05506P,茂林凱基96售03,,,,,0.00,0.00,0,0,0,0,0,0,0,0,0,0,0,0,0
20200212,055070,聯茂永豐97購01,0.62,0.82,0.62,0.80,+0.22,37.93,384000,19,281740,0,0,0,0,0,0,170000,214000,-44000,-44000
20200212,055071,群電永豐97購01,,,,,0.00,0.00,0,0,0,0,0,0,0,0,0,0,0,0,0
20200212,055072,康友永豐97購02,0.86,0.89,0.86,0.89,+0.10,12.66,62000,3,53620,0,0,0,0,0,0,0,62000,-62000,-62000
20200212,055073,易華電永豐97購01,,,,,0.00,0.00,0,0,0,0,0,0,0,0,0,0,0,0,0
20200212,055074,台虹永豐97購01,,,,,0.00,0.00,0,0,0,0,0,0,0,0,0,0,0,0,0
20200212,055075,南電永豐97購01,1.10,1.39,1.10,1.36,+0.17,14.29,327000,28,401890,0,0,0,0,0,0,256000,20000,236000,236000
20200212,055076,福懋科永豐97購01,1.12,1.12,1.05,1.08,-0.02,-1.82,397000,20,428260,0,0,0,0,0,0,315000,52000,263000,263000
20200212,055077,臺股指永豐97購02,0.54,0.58,0.54,0.58,+0.08,16.0,36000,3,19840,0,0,0,0,0,0,6000,30000,-24000,-24000
20200212,055078,亞泥中信98購01,0.68,0.69,0.68,0.69,+0.03,4.55,55000,2,37730,0,0,0,0,0,0,22000,33000,-11000,-11000
20200212,055079,台光電中信97購01,0.27,0.39,0.27,0.37,+0.10,37.04,667000,35,236200,0,0,0,0,0,0,314000,363000,-49000,-49000
20200212,05507P,聯茂凱基96售02,0.96,0.96,0.84,0.84,-0.30,-26.32,18000,3,16980,0,0,0,0,0,0,14000,18000,-4000,-4000
20200212,055080,正崴中信99購01,0.37,0.37,0.37,0.37,0.00,0.00,25000,2,9250,0,0,0,0,0,0,0,25000,-25000,-25000
20200212,055081,健鼎中信97購01,0.35,0.52,0.35,0.51,+0.24,88.89,509000,60,205080,0,0,0,0,0,0,0,509000,-509000,-509000
20200212,055082,台郡中信97購01,0.45,0.46,0.44,0.45,+0.22,95.65,400000,27,180650,0,0,0,0,0,0,101000,299000,-198000,-198000
20200212,055083,康友中信97購01,0.72,0.78,0.72,0.78,+0.10,14.71,25000,2,18240,0,0,0,0,0,0,0,25000,-25000,-25000
20200212,055084,國巨第一97購01,0.70,0.70,0.70,0.70,+0.04,6.06,1000,1,700,0,0,0,0,0,0,1000,0,1000,1000
20200212,055085,大毅國票97購01,7.20,7.35,6.95,6.95,-0.35,-4.79,39000,14,279700,0,0,0,0,0,0,27000,12000,15000,15000
20200212,055086,華邦電亞東98購01,,,,,0.00,0.00,0,0,0,0,0,0,0,0,0,0,0,0,0
20200212,055087,瑞昱亞東97購01,1.31,1.31,1.31,1.31,0.00,0.00,48000,1,62880,0,0,0,0,0,0,0,48000,-48000,-48000
20200212,055088,聯詠亞東97購01,1.18,1.18,1.18,1.18,0.00,0.00,48000,1,56640,0,0,0,0,0,0,0,48000,-48000,-48000
20200212,055089,金寶群益98購01,1.95,2.06,1.92,2.06,+0.07,3.52,207000,20,407160,0,0,0,0,0,0,124000,102000,22000,22000
20200212,05508P,華通統一97售01,1.97,1.97,1.69,1.69,-0.36,-17.56,8000,3,14120,3000,0,3000,0,0,0,0,8000,-8000,-5000
20200212,055090,國巨群益97購03,2.82,2.89,2.82,2.89,+0.22,8.24,220000,6,629800,0,0,0,0,0,0,50000,170000,-120000,-120000
20200212,055091,微星群益97購01,2.25,2.25,2.18,2.18,+0.20,10.1,51000,6,112540,0,0,0,0,0,0,11000,40000,-29000,-29000
20200212,055092,開發金群益9B購01,0.81,0.81,0.81,0.81,-0.02,-2.41,121000,5,98010,0,0,0,0,0,0,111000,10000,101000,101000
20200212,055093,京鼎群益98購01,1.92,2.22,1.92,2.22,+0.48,27.59,254000,26,529330,0,0,0,0,0,0,0,254000,-254000,-254000
20200212,055094,智易群益98購01,0.55,0.68,0.55,0.66,0.00,0.00,407000,38,245730,0,0,0,0,0,0,0,407000,-407000,-407000
20200212,055095,啟碁群益98購01,1.24,1.24,1.24,1.24,+0.06,5.08,100000,1,124000,0,0,0,0,0,0,100000,0,100000,100000
20200212,055096,緯穎群益97購01,2.05,2.41,2.04,2.41,+0.21,9.55,253000,26,568890,0,0,0,0,0,0,202000,211000,-9000,-9000
20200212,055097,福懋科群益97購01,2.03,2.05,1.85,1.97,-0.03,-1.5,285000,30,565420,0,0,0,0,0,0,247000,38000,209000,209000
20200212,055098,臺股指群益97購01,,,,,0.00,0.00,0,0,0,0,0,0,0,0,0,0,0,0,0
20200212,055099,可成日盛97購01,1.54,1.62,1.54,1.62,+0.21,14.89,90000,3,144120,0,0,0,0,0,0,7000,83000,-76000,-76000
20200212,05509P,智邦元富96售02,0.95,0.95,0.95,0.95,-0.07,-6.86,42000,2,39900,0,0,0,0,0,0,0,42000,-42000,-42000
20200212,055100,得力凱基97購01,0.42,0.42,0.42,0.42,0.00,0.00,68000,1,28560,0,0,0,0,0,0,0,68000,-68000,-68000
20200212,055101,台肥凱基97購01,0.71,0.76,0.71,0.76,+0.04,5.56,201000,3,152710,0,0,0,0,0,0,1000,200000,-199000,-199000
20200212,055102,上銀凱基98購01,2.54,2.58,1.00,2.50,+0.01,0.4,265000,16,658280,0,0,0,0,0,0,183000,199000,-16000,-16000
20200212,055103,南港凱基97購01,0.47,0.47,0.47,0.47,+0.05,11.9,1000,1,470,0,0,0,0,0,0,0,1000,-1000,-1000
20200212,055104,台達電凱基98購01,1.04,1.12,1.04,1.12,+0.10,9.8,367000,8,387920,0,0,0,0,0,0,118000,249000,-131000,-131000
20200212,055105,鴻海凱基98購05,1.37,1.37,1.37,1.37,0.00,0.00,7000,1,9590,0,0,0,0,0,0,0,7000,-7000,-7000
20200212,055106,台積電凱基98購05,0.99,1.03,0.98,1.03,+0.06,6.19,263000,14,261480,0,0,0,0,0,0,261000,2000,259000,259000
20200212,055107,旺宏凱基98購04,0.71,0.71,0.69,0.69,-0.01,-1.43,50000,4,34600,0,0,0,0,0,0,20000,10000,10000,10000
20200212,055108,智邦凱基98購01,1.78,1.84,1.76,1.84,+0.05,2.79,150000,6,266980,0,0,0,0,0,0,10000,150000,-140000,-140000
20200212,055109,正崴凱基98購01,0.64,0.64,0.63,0.63,-0.04,-5.97,196000,10,125200,0,0,0,0,0,0,196000,0,196000,196000
20200212,05510P,燿華元富96售01,,,,,0.00,0.00,0,0,0,0,0,0,0,0,0,0,0,0,0
20200212,055110,美律凱基98購02,0.56,0.58,0.56,0.58,0.00,0.00,44000,6,25140,0,0,0,0,0,0,0,44000,-44000,-44000
20200212,055111,宏盛凱基97購01,0.31,0.31,0.31,0.31,-0.04,-11.43,1000,1,310,0,0,0,0,0,0,1000,0,1000,1000
20200212,055112,晶豪科凱基98購01,,,,,0.00,0.00,0,0,0,0,0,0,0,0,0,0,0,0,0
20200212,055113,大立光凱基98購06,1.23,1.40,1.23,1.40,+0.23,19.66,121000,10,161450,0,0,0,0,0,0,51000,70000,-19000,-19000
20200212,055114,新日興凱基98購01,2.62,2.62,2.55,2.55,-0.13,-4.85,26000,14,67190,0,0,0,0,0,0,26000,3000,23000,23000
20200212,055115,日月光凱基98購01,0.93,1.01,0.92,1.01,+0.10,10.99,190000,11,184200,0,0,0,0,0,0,27000,160000,-133000,-133000
20200212,055116,康控凱基98購01,0.31,0.32,0.31,0.32,+0.06,23.08,85000,2,26750,0,0,0,0,0,0,0,85000,-85000,-85000
20200212,055117,臻鼎凱基98購02,1.01,1.01,1.01,1.01,+0.22,27.85,62000,1,62620,0,0,0,0,0,0,62000,0,62000,62000
20200212,055118,嘉聯益凱基98購02,0.61,0.64,0.61,0.62,+0.04,6.9,154000,5,96660,0,0,0,0,0,0,121000,71000,50000,50000
20200212,055119,力成凱基98購01,2.43,2.73,2.43,2.73,+0.52,23.53,37000,9,96130,0,0,0,0,0,0,27000,27000,0,0
20200212,05511P,T50反1台新06售01,,,,,0.00,0.00,0,0,0,0,0,0,0,0,0,0,0,0,0
20200212,055120,南港兆豐97購01,1.50,1.50,0.92,1.06,+0.13,13.98,985000,46,958370,0,0,0,0,0,0,233000,751000,-518000,-518000
20200212,055121,鴻海兆豐97購03,1.02,1.05,1.02,1.05,+0.14,15.38,81000,2,84900,0,0,0,0,0,0,5000,76000,-71000,-71000
20200212,055122,國巨兆豐98購01,1.77,1.80,1.72,1.80,+0.15,9.09,546000,8,953200,0,0,0,0,0,0,376000,170000,206000,206000
20200212,055123,億光兆豐97購01,1.27,1.34,1.27,1.31,-0.01,-0.76,255000,8,335340,0,0,0,0,0,0,207000,48000,159000,159000
20200212,055124,建準兆豐97購01,,,,,0.00,0.00,0,0,0,0,0,0,0,0,0,0,0,0,0
20200212,055125,智原兆豐97購01,0.52,0.53,0.52,0.53,+0.01,1.92,351000,30,183880,0,0,0,0,0,0,351000,0,351000,351000
20200212,055126,嘉澤兆豐97購01,0.75,0.77,0.68,0.70,-0.02,-2.78,243000,11,179030,0,0,0,0,0,0,110000,133000,-23000,-23000
20200212,055127,台虹兆豐97購01,1.26,1.30,1.26,1.30,+0.11,9.24,262000,10,334200,0,0,0,0,0,0,100000,162000,-62000,-62000
20200212,055128,致新兆豐97購01,0.85,0.87,0.81,0.86,+0.02,2.38,371000,31,306370,0,0,0,0,0,0,341000,30000,311000,311000
20200212,055129,鈺齊兆豐97購01,1.35,1.50,1.35,1.50,+0.13,9.49,349000,13,502300,0,0,0,0,0,0,106000,241000,-135000,-135000
20200212,05512P,華新科台新97售01,,,,,0.00,0.00,0,0,0,0,0,0,0,0,0,0,0,0,0
20200212,055130,京鼎康和97購01,1.01,1.05,1.01,1.05,0.00,0.00,240000,7,251080,0,0,0,0,0,0,0,240000,-240000,-240000
20200212,055131,茂林康和97購01,0.86,0.88,0.84,0.87,+0.03,3.57,1205000,33,1030870,0,0,0,0,0,0,993000,183000,810000,810000
20200212,055132,台虹康和97購01,0.51,0.53,0.51,0.53,0.00,0.00,132000,3,68620,0,0,0,0,0,0,0,132000,-132000,-132000
20200212,055133,致新康和97購01,0.72,0.77,0.72,0.77,+0.02,2.67,786000,23,583760,0,0,0,0,0,0,686000,100000,586000,586000
20200212,055134,元油反國泰99購01,,,,,0.00,0.00,0,0,0,0,0,0,0,0,0,0,0,0,0
20200212,055135,聯發科富邦99購05,0.62,0.62,0.62,0.62,0.00,0.00,35000,1,21700,0,0,0,0,0,0,35000,0,35000,35000
20200212,055136,聯發科富邦99購06,,,,,0.00,0.00,0,0,0,0,0,0,0,0,0,0,0,0,0
20200212,055137,GIS富邦98購01,0.23,0.24,0.23,0.24,0.00,0.00,6000,2,1420,0,0,0,0,0,0,6000,0,6000,6000
20200212,055138,大毅永豐97購02,2.34,2.34,2.14,2.18,-0.10,-4.39,206000,20,453180,0,0,0,0,0,0,120000,128000,-8000,-8000
20200212,055139,欣興永豐97購01,0.75,0.92,0.75,0.92,+0.26,39.39,197000,19,171060,0,0,0,0,0,0,36000,196000,-160000,-160000
20200212,05513P,玉山金台新96售01,,,,,0.00,0.00,0,0,0,0,0,0,0,0,0,0,0,0,0
20200212,055140,晶相光永豐97購01,0.62,0.64,0.60,0.60,+0.01,1.69,309000,10,194120,0,0,0,0,0,0,0,309000,-309000,-309000
20200212,055141,牧德永豐98購02,1.13,1.15,1.04,1.04,-0.05,-4.59,256000,21,281840,0,0,0,0,0,0,90000,166000,-76000,-76000
20200212,055142,健策永豐98購01,0.92,0.99,0.88,0.99,+0.11,12.5,1562000,65,1455480,0,0,0,0,0,0,787000,775000,12000,12000
20200212,055143,臻鼎永豐97購01,0.57,0.57,0.50,0.50,+0.05,11.11,296000,11,162080,0,0,0,0,0,0,161000,135000,26000,26000
20200212,055144,T50反1元大97購03,0.86,0.86,0.80,0.81,-0.06,-6.9,2171000,34,1827490,0,0,0,0,0,0,1558000,603000,955000,955000
20200212,055145,T50反1元大97購04,,,,,0.00,0.00,0,0,0,0,0,0,0,0,0,0,0,0,0
20200212,055146,華通元大98購04,1.16,1.53,1.14,1.51,+0.36,31.3,254000,41,336540,0,0,0,0,0,0,208000,132000,76000,76000
20200212,055147,鴻海元大97購11,1.36,1.46,1.36,1.46,+0.21,16.8,170000,9,243300,0,0,0,0,0,0,150000,170000,-20000,-20000
20200212,055148,鴻海元大98購02,1.17,1.35,1.17,1.35,+0.20,17.39,214000,13,269800,0,0,0,0,0,0,84000,130000,-46000,-46000
20200212,055149,國巨元大97購06,1.26,1.26,1.22,1.22,+0.05,4.27,52000,7,64470,0,0,0,0,0,0,32000,20000,12000,12000
20200212,05514P,康舒永豐96售01,0.86,0.87,0.86,0.87,-0.02,-2.25,2000,2,1730,0,0,0,0,0,0,0,2000,-2000,-2000
20200212,055150,台積電元大98購04,1.42,1.42,1.42,1.42,+0.09,6.77,3000,2,4260,0,0,0,0,0,0,0,3000,-3000,-3000
20200212,055151,台積電元大98購05,1.23,1.34,1.23,1.32,+0.11,9.09,393000,21,505730,0,0,0,0,0,0,315000,387000,-72000,-72000
20200212,055152,旺宏元大98購04,1.35,1.39,1.30,1.31,-0.02,-1.5,610000,44,808270,0,0,0,0,0,0,349000,472000,-123000,-123000
20200212,055153,台光電元大98購02,0.75,0.94,0.75,0.91,+0.18,24.66,558000,37,478440,0,0,0,0,0,0,232000,493000,-261000,-261000
20200212,055154,聯發科元大98購01,1.25,1.40,1.25,1.37,+0.23,20.18,615000,16,809060,0,0,0,0,0,0,510000,119000,391000,391000
20200212,055155,奇力新元大99購01,0.92,0.95,0.92,0.95,+0.08,9.2,20000,2,18700,0,0,0,0,0,0,20000,0,20000,20000
20200212,055156,華新科元大99購02,1.16,1.16,1.11,1.12,+0.03,2.75,80000,14,90310,0,0,0,0,0,0,50000,54000,-4000,-4000
20200212,055157,晶豪科元大97購01,1.08,1.15,1.08,1.14,+0.12,11.76,133000,11,147130,0,0,0,0,0,0,104000,113000,-9000,-9000
20200212,055158,亞光元大99購01,0.56,0.63,0.56,0.63,0.00,0.00,459000,5,282700,0,0,0,0,0,0,30000,429000,-399000,-399000
20200212,055159,玉晶光元大98購05,0.80,0.87,0.80,0.85,+0.08,10.39,230000,12,195150,0,0,0,0,0,0,82000,148000,-66000,-66000
20200212,05515P,台積電群益96售03,1.76,1.78,1.69,1.70,-0.16,-8.6,1103000,52,1938210,0,0,0,0,0,0,273000,850000,-577000,-577000
20200212,055160,玉晶光元大99購03,0.78,0.85,0.77,0.82,+0.07,9.33,1198000,53,972510,0,0,0,0,0,0,435000,728000,-293000,-293000
20200212,055161,貿聯元大98購03,0.95,1.06,0.95,1.06,+0.11,11.58,71000,9,73200,0,0,0,0,0,0,63000,30000,33000,33000
20200212,055162,新唐元大97購01,,,,,0.00,0.00,0,0,0,0,0,0,0,0,0,0,0,0,0
20200212,055163,訊芯元大98購01,0.86,0.96,0.86,0.94,+0.11,13.25,505000,21,466920,0,0,0,0,0,0,177000,410000,-233000,-233000
20200212,055164,矽創元大98購01,0.94,1.15,0.94,1.15,+0.23,25.0,805000,34,875740,0,0,0,0,0,0,423000,735000,-312000,-312000
20200212,055165,元油反統一98購01,,,,,0.00,0.00,0,0,0,0,0,0,0,0,0,0,0,0,0
20200212,055166,台積電統一97購05,1.46,1.50,1.43,1.49,+0.10,7.19,556000,14,804460,0,0,0,0,0,0,180000,361000,-181000,-181000
20200212,055167,友訊統一97購01,1.41,1.44,1.37,1.39,-0.01,-0.71,310000,9,435230,0,0,0,0,0,0,100000,210000,-110000,-110000
20200212,055168,光罩統一98購01,1.22,1.34,1.22,1.32,+0.12,10.0,51000,12,66400,0,0,0,0,0,0,6000,45000,-39000,-39000
20200212,055169,光罩統一99購01,0.38,0.38,0.37,0.37,+0.02,5.71,300000,4,113900,0,0,0,0,0,0,300000,0,300000,300000
20200212,05516P,台積電元大96售12,0.90,0.91,0.87,0.87,-0.09,-9.38,140000,12,124100,0,0,0,0,0,0,30000,110000,-80000,-80000
20200212,055170,光磊統一97購01,0.88,0.88,0.88,0.88,+0.01,1.15,80000,1,70400,0,0,0,0,0,0,80000,0,80000,80000
20200212,055171,凱美統一97購01,0.79,0.85,0.78,0.85,0.00,0.00,195000,17,157320,0,0,0,0,0,0,117000,78000,39000,39000
20200212,055172,凱美統一97購02,1.30,1.41,1.27,1.41,+0.07,5.22,279000,29,366420,0,0,0,0,0,0,157000,122000,35000,35000
20200212,055173,瑞昱統一97購01,2.37,2.37,2.33,2.33,+0.26,12.56,15000,2,35150,0,0,0,0,0,0,0,15000,-15000,-15000
20200212,055174,精元統一97購01,,,,,0.00,0.00,0,0,0,0,0,0,0,0,0,0,0,0,0
20200212,055175,建準統一97購01,1.14,1.14,1.14,1.14,+0.02,1.79,4000,1,4560,0,0,0,0,0,0,4000,0,4000,4000
20200212,055176,大毅統一98購02,4.55,4.55,4.14,4.27,-0.17,-3.83,46000,12,197400,0,0,0,0,0,0,21000,25000,-4000,-4000
20200212,055177,宏達電統一99購01,,,,,0.00,0.00,0,0,0,0,0,0,0,0,0,0,0,0,0
20200212,055178,晶豪科統一97購01,1.18,1.24,1.18,1.24,+0.10,8.77,228000,8,275880,0,0,0,0,0,0,76000,152000,-76000,-76000
20200212,055179,大立光統一97購04,1.78,1.97,1.78,1.97,+0.29,17.26,287000,6,533570,0,0,0,0,0,0,170000,117000,53000,53000
20200212,05517P,臻鼎元大96售01,1.80,2.11,1.80,2.11,0.00,0.00,115000,5,226900,0,0,0,0,0,0,30000,85000,-55000,-55000
20200212,055180,文曄統一97購01,1.22,1.29,1.22,1.29,0.00,0.00,143000,7,176630,0,0,0,0,0,0,0,143000,-143000,-143000
20200212,055181,日電貿統一97購01,1.06,1.08,1.05,1.08,+0.02,1.89,251000,25,266120,0,0,0,0,0,0,245000,0,245000,245000
20200212,055182,京鼎統一98購01,1.63,1.82,1.63,1.80,+0.35,24.14,285000,23,493420,0,0,0,0,0,0,29000,256000,-227000,-227000
20200212,055183,聯鈞統一97購01,1.54,1.68,1.54,1.68,+0.22,15.07,309000,15,494800,0,0,0,0,0,0,49000,260000,-211000,-211000
20200212,055184,群創統一98購02,,,,,0.00,0.00,0,0,0,0,0,0,0,0,0,0,0,0,0
20200212,055185,晶相光統一97購01,1.21,1.30,1.21,1.30,+0.14,12.07,204000,8,257700,0,0,0,0,0,0,0,204000,-204000,-204000
20200212,055186,正文統一97購01,0.82,0.82,0.82,0.82,0.00,0.00,56000,2,45920,0,0,0,0,0,0,56000,0,56000,56000
20200212,055187,彩晶統一98購01,0.69,0.70,0.69,0.70,0.00,0.00,332000,4,230230,0,0,0,0,0,0,317000,15000,302000,302000
20200212,055188,亞翔統一97購01,1.85,1.97,1.83,1.97,+0.20,11.3,143000,7,269690,0,0,0,0,0,0,22000,121000,-99000,-99000
20200212,055189,台虹統一97購01,1.08,1.13,1.08,1.12,+0.07,6.67,526000,32,585300,0,0,0,0,0,0,201000,325000,-124000,-124000
20200212,05518P,T50反1凱基98售03,,,,,0.00,0.00,0,0,0,0,0,0,0,0,0,0,0,0,0
20200212,055190,華新科元富97購01,1.07,1.08,1.01,1.04,+0.03,2.97,183000,17,191460,0,0,0,0,0,0,114000,65000,49000,49000
20200212,055191,牧德元富97購01,1.80,1.87,1.71,1.71,-0.08,-4.47,742000,26,1337350,0,0,0,0,0,0,690000,52000,638000,638000
20200212,055192,世芯元富97購01,0.81,0.86,0.74,0.86,+0.04,4.88,1352000,70,1062300,0,0,0,0,0,0,987000,317000,670000,670000
20200212,055193,世芯元富97購02,1.15,1.25,1.06,1.25,+0.10,8.7,980000,54,1123670,0,0,0,0,0,0,594000,378000,216000,216000
20200212,055194,昇陽半元富97購01,0.69,0.71,0.69,0.69,+0.02,2.99,424000,7,292960,0,0,0,0,0,0,274000,150000,124000,124000
20200212,055195,昇陽半元富97購02,0.86,0.92,0.86,0.88,+0.01,1.15,417000,17,372600,0,0,0,0,0,0,12000,405000,-393000,-393000
20200212,055196,致新元富97購01,1.12,1.13,1.08,1.13,+0.01,0.89,285000,23,314420,0,0,0,0,0,0,265000,20000,245000,245000
20200212,055197,致新元富97購02,1.28,1.30,1.25,1.25,-0.06,-4.58,153000,16,195550,0,0,0,0,0,0,153000,0,153000,153000
20200212,055198,奇力新第一97購01,0.85,0.85,0.49,0.53,+0.02,3.92,1417000,66,732900,0,0,0,0,0,0,946000,458000,488000,488000
20200212,055199,國喬群益97購01,0.52,0.56,0.52,0.56,+0.08,16.67,333000,9,183050,0,0,0,0,0,0,11000,322000,-311000,-311000
20200212,05519P,上証2X凱基98售01,1.91,1.95,1.91,1.95,+0.02,1.04,18000,2,34420,0,0,0,0,0,0,17000,1000,16000,16000
20200212,055200,和大群益98購01,1.11,1.11,1.07,1.07,-0.06,-5.31,12000,2,13240,0,0,0,0,0,0,2000,10000,-8000,-8000
20200212,055201,興勤群益98購01,0.40,0.42,0.40,0.42,0.00,0.00,321000,4,131610,0,0,0,0,0,0,0,321000,-321000,-321000
20200212,055202,神達群益97購01,1.00,1.10,1.00,1.09,+0.16,17.2,190000,31,204660,0,0,0,0,0,0,0,190000,-190000,-190000
20200212,055203,建準中信97購01,,,,,0.00,0.00,0,0,0,0,0,0,0,0,0,0,0,0,0
20200212,055204,宏達電中信99購01,0.64,0.64,0.64,0.64,0.00,0.00,5000,1,3200,0,0,0,0,0,0,5000,0,5000,5000
20200212,055205,京鼎中信99購01,0.61,0.71,0.61,0.68,+0.14,25.93,585000,25,376310,0,0,0,0,0,0,45000,540000,-495000,-495000
20200212,055206,台虹中信97購01,,,,,0.00,0.00,0,0,0,0,0,0,0,0,0,0,0,0,0
20200212,055207,致新中信99購01,0.49,0.50,0.47,0.50,0.00,0.00,412000,21,201680,0,0,0,0,0,0,412000,0,412000,412000
20200212,055208,京鼎康和97購02,0.91,0.96,0.91,0.96,+0.13,15.66,125000,4,117750,0,0,0,0,0,0,0,125000,-125000,-125000
20200212,055209,勤誠康和97購01,,,,,0.00,0.00,0,0,0,0,0,0,0,0,0,0,0,0,0
20200212,05520P,聯詠凱基96售01,1.20,1.20,1.14,1.14,-0.09,-7.32,31000,3,37140,0,0,0,0,0,0,30000,31000,-1000,-1000
20200212,055210,S&P正2凱基97購01,2.24,2.24,2.24,2.24,0.00,0.00,10000,1,22400,0,0,0,0,0,0,10000,0,10000,10000
20200212,055211,A50反1凱基9A購01,0.93,0.96,0.93,0.94,+0.01,1.08,418000,18,392520,0,0,0,0,0,0,229000,187000,42000,42000
20200212,055212,和大凱基97購02,0.33,0.38,0.33,0.38,-0.01,-2.56,72000,3,24860,0,0,0,0,0,0,72000,0,72000,72000
20200212,055213,大成鋼凱基98購01,,,,,0.00,0.00,0,0,0,0,0,0,0,0,0,0,0,0,0
20200212,055214,聯電凱基97購02,1.37,1.50,0.34,1.50,+0.14,10.29,653000,52,788000,0,0,0,0,0,0,517000,392000,125000,125000
20200212,055215,智邦凱基98購02,2.24,2.24,1.90,1.96,-0.08,-3.92,44000,9,90920,0,0,0,0,0,0,30000,20000,10000,10000
20200212,055216,友達凱基98購05,1.97,1.97,1.97,1.97,-0.14,-6.64,10000,1,19700,0,0,0,0,0,0,10000,0,10000,10000
20200212,055217,緯創凱基97購02,,,,,0.00,0.00,0,0,0,0,0,0,0,0,0,0,0,0,0
20200212,055218,彩晶凱基99購01,,,,,0.00,0.00,0,0,0,0,0,0,0,0,0,0,0,0,0
20200212,055219,啟碁凱基98購01,,,,,0.00,0.00,0,0,0,0,0,0,0,0,0,0,0,0,0
20200212,05521P,創意永豐96售01,1.64,1.70,1.62,1.63,-0.02,-1.21,534000,34,869110,0,0,0,0,0,0,0,534000,-534000,-534000
20200212,055220,緯穎凱基98購02,2.11,2.25,2.08,2.25,+0.12,5.63,157000,8,334840,0,0,0,0,0,0,143000,41000,102000,102000
20200212,055221,矽創凱基97購02,1.31,1.65,0.53,1.63,+0.33,25.38,180000,37,258540,0,0,0,0,0,0,111000,137000,-26000,-26000
20200212,055222,臺股指凱基97購05,1.05,1.09,1.05,1.09,+0.12,12.37,107000,4,112460,0,0,0,0,0,0,105000,2000,103000,103000
20200212,055223,和大國票98購01,1.37,1.39,1.29,1.29,-0.10,-7.19,50000,5,68100,0,0,0,0,0,0,20000,30000,-10000,-10000
20200212,055224,鴻海國票99購02,0.38,0.47,0.38,0.47,+0.15,46.88,1110000,8,450500,0,0,0,0,0,0,860000,250000,610000,610000
20200212,055225,華邦電國票99購01,0.40,0.40,0.40,0.40,0.00,0.00,66000,2,26400,0,0,0,0,0,0,0,66000,-66000,-66000
20200212,055226,聯發科國票97購05,1.29,1.34,1.29,1.34,+0.34,34.0,20000,2,26300,0,0,0,0,0,0,10000,10000,0,0
20200212,055227,聯發科國票98購02,1.36,1.36,1.36,1.36,0.00,0.00,10000,1,13600,0,0,0,0,0,0,0,10000,-10000,-10000
20200212,055228,聯發科國票98購03,1.76,1.89,1.76,1.89,+0.34,21.94,50000,2,91900,0,0,0,0,0,0,20000,30000,-10000,-10000
20200212,055229,大毅國票97購02,8.05,8.20,7.55,7.55,-0.40,-5.03,72000,14,578350,0,0,0,0,0,0,69000,3000,66000,66000
20200212,05522P,友達元富96售02,0.18,0.20,0.18,0.20,+0.02,11.11,260000,4,50100,0,0,0,0,0,0,160000,100000,60000,60000
20200212,055230,大毅國票98購01,7.25,7.25,6.95,6.95,-0.60,-7.95,20000,4,142850,0,0,0,0,0,0,5000,15000,-10000,-10000
20200212,055231,大毅國票98購02,4.67,4.67,4.67,4.67,-0.38,-7.52,3000,1,14010,0,0,0,0,0,0,3000,0,3000,3000
20200212,055232,泰碩國票98購01,0.84,0.88,0.84,0.87,0.00,0.00,189000,4,161860,0,0,0,0,0,0,89000,100000,-11000,-11000
20200212,055233,康友國票98購01,3.22,3.41,3.22,3.24,+0.14,4.52,180000,6,585550,0,0,0,0,0,0,0,180000,-180000,-180000
20200212,055234,昇陽半國票98購02,1.61,1.62,1.61,1.62,+0.04,2.53,26000,3,41960,0,0,0,0,0,0,20000,16000,4000,4000
20200212,055235,金寶台新98購01,1.69,1.75,1.67,1.75,+0.03,1.74,654000,35,1104900,0,0,0,0,0,0,553000,101000,452000,452000
20200212,055236,建準台新98購01,0.93,0.93,0.93,0.93,-0.03,-3.12,38000,1,35340,0,0,0,0,0,0,38000,0,38000,38000
20200212,055237,晶豪科台新97購01,0.71,0.73,0.71,0.73,+0.06,8.96,150000,2,109100,0,0,0,0,0,0,150000,0,150000,150000
20200212,055238,茂林台新97購01,1.76,1.81,1.72,1.74,+0.01,0.58,121000,20,212740,0,0,0,0,0,0,95000,26000,69000,69000
20200212,055239,帆宣台新97購01,1.26,1.32,1.21,1.26,+0.05,4.13,191000,15,243600,0,0,0,0,0,0,51000,140000,-89000,-89000
20200212,05523P,聯發科國票96售04,2.80,2.80,2.80,2.80,0.00,0.00,2000,1,5600,0,0,0,0,0,0,2000,0,2000,2000
20200212,055240,京元電元富97購01,1.11,1.14,1.00,1.13,+0.05,4.63,398000,45,428070,0,0,0,0,0,0,297000,90000,207000,207000
20200212,055241,T50反1統一99購01,0.50,0.50,0.50,0.50,0.00,0.00,1000,1,500,0,0,0,0,0,0,0,1000,-1000,-1000
20200212,055242,道瓊銀統一98購01,,,,,0.00,0.00,0,0,0,0,0,0,0,0,0,0,0,0,0
20200212,055243,國巨統一97購04,1.66,1.66,1.66,1.66,+0.10,6.41,40000,1,66400,0,0,0,0,0,0,40000,0,40000,40000
20200212,055244,國巨統一98購01,2.80,2.80,2.68,2.80,+0.21,8.11,202000,8,559210,0,0,0,0,0,0,198000,4000,194000,194000
20200212,055245,凱美統一99購01,1.42,1.47,1.38,1.47,+0.10,7.3,162000,26,227820,0,0,0,0,0,0,110000,22000,88000,88000
20200212,055246,美律統一98購01,0.42,0.47,0.42,0.47,+0.07,17.5,452000,44,200320,0,0,0,0,0,0,188000,264000,-76000,-76000
20200212,055247,聯發科統一98購01,0.99,1.06,0.99,1.06,+0.19,21.84,552000,8,568160,0,0,0,0,0,0,272000,280000,-8000,-8000
20200212,055248,可成統一97購02,2.47,2.81,2.47,2.81,+0.49,21.12,173000,6,455170,0,0,0,0,0,0,105000,68000,37000,37000
20200212,055249,大毅統一99購01,1.37,1.38,1.28,1.33,-0.03,-2.21,522000,34,690220,0,0,0,0,0,0,104000,317000,-213000,-213000
20200212,05524P,瀚宇博國票97售02,2.65,2.65,2.65,2.65,0.00,0.00,9000,1,23850,0,0,0,0,0,0,0,9000,-9000,-9000
20200212,055250,華新科統一97購02,1.19,1.21,1.14,1.17,+0.05,4.46,1069000,40,1254020,0,0,0,0,0,0,978000,61000,917000,917000
20200212,055251,華新科統一99購01,1.84,1.87,1.80,1.83,+0.04,2.23,474000,13,868690,0,0,0,0,0,0,197000,277000,-80000,-80000
20200212,055252,新光金統一98購02,0.90,0.90,0.88,0.89,-0.02,-2.2,442000,40,396270,0,0,0,0,0,0,277000,165000,112000,112000
20200212,055253,大立光統一97購06,1.91,2.04,1.90,1.97,+0.17,9.44,480000,10,958140,0,0,0,0,0,0,300000,180000,120000,120000
20200212,055254,聯詠統一97購03,2.58,2.72,2.58,2.72,+0.36,15.25,167000,13,438800,0,0,0,0,0,0,153000,14000,139000,139000
20200212,055255,欣興統一97購02,0.93,1.28,0.93,1.26,+0.29,29.9,1535000,40,1789040,0,0,0,0,0,0,680000,1043000,-363000,-363000
20200212,055256,日電貿統一99購01,2.01,2.01,1.89,1.98,+0.10,5.32,547000,33,1058830,0,0,0,0,0,0,485000,62000,423000,423000
20200212,055257,景碩統一97購01,2.39,2.89,2.33,2.89,+0.51,21.43,472000,54,1197660,0,0,0,0,0,0,166000,303000,-137000,-137000
20200212,055258,玉晶光統一97購03,1.30,1.30,1.30,1.30,0.00,0.00,30000,1,39000,0,0,0,0,0,0,0,30000,-30000,-30000
20200212,055259,玉晶光統一9A購01,1.69,1.78,1.64,1.72,+0.16,10.26,632000,24,1072670,0,0,0,0,0,0,203000,429000,-226000,-226000
20200212,05525P,奇力新群益96售02,0.45,0.45,0.45,0.45,-0.05,-10.0,30000,3,13500,0,0,0,0,0,0,0,30000,-30000,-30000
20200212,055260,晶相光統一98購01,0.48,0.52,0.48,0.49,+0.01,2.08,776000,11,383420,0,0,0,0,0,0,53000,723000,-670000,-670000
20200212,055261,帆宣統一98購01,2.08,2.13,2.05,2.05,+0.05,2.5,149000,10,308640,0,0,0,0,0,0,17000,132000,-115000,-115000
20200212,055262,台虹國泰98購01,0.88,0.94,0.88,0.94,+0.08,9.3,283000,33,263690,0,0,0,0,0,0,58000,225000,-167000,-167000
20200212,055263,華新科富邦9A購01,0.75,0.75,0.71,0.73,+0.02,2.82,356000,32,258160,0,0,0,0,0,0,188000,112000,76000,76000
20200212,055264,國巨永豐98購01,1.65,1.74,1.65,1.74,+0.26,17.57,106000,6,183130,0,0,0,0,0,0,12000,94000,-82000,-82000
20200212,055265,玉晶光永豐98購03,0.74,0.82,0.74,0.79,+0.09,12.86,161000,5,123130,0,0,0,0,0,0,73000,88000,-15000,-15000
20200212,055266,京鼎永豐97購01,0.92,1.05,0.92,1.05,+0.28,36.36,247000,17,247940,0,0,0,0,0,0,0,247000,-247000,-247000
20200212,055267,百和永豐97購01,,,,,0.00,0.00,0,0,0,0,0,0,0,0,0,0,0,0,0
20200212,055268,和大元大97購01,1.63,1.63,1.58,1.63,-0.10,-5.78,224000,7,358570,60000,60000,0,0,0,0,61000,163000,-102000,-102000
20200212,055269,和大元大97購02,1.27,1.27,1.24,1.24,-0.06,-4.62,61000,3,77380,0,0,0,0,0,0,58000,3000,55000,55000
20200212,05526P,茂林群益96售03,0.87,0.87,0.86,0.86,-0.06,-6.52,9000,2,7750,0,0,0,0,0,0,9000,0,9000,9000
20200212,055270,上銀元大97購03,3.93,3.93,3.76,3.81,+0.09,2.42,208000,23,804520,0,0,0,0,0,0,178000,82000,96000,96000
20200212,055271,鴻海元大98購03,1.28,1.36,1.28,1.36,+0.13,10.57,200000,10,266650,0,0,0,0,0,0,45000,155000,-110000,-110000
20200212,055272,國巨元大98購04,1.44,1.49,1.42,1.49,+0.10,7.19,124000,16,180120,0,0,0,0,0,0,34000,74000,-40000,-40000
20200212,055273,華泰元大97購01,0.80,0.83,0.79,0.79,+0.03,3.95,190000,8,153800,0,0,0,0,0,0,60000,130000,-70000,-70000
20200212,055274,華泰元大97購02,0.89,0.93,0.89,0.93,+0.08,9.41,86000,3,79060,0,0,0,0,0,0,13000,86000,-73000,-73000
20200212,055275,台積電元大97購19,1.35,1.43,1.35,1.43,+0.11,8.33,275000,13,379450,0,0,0,0,0,0,250000,130000,120000,120000
20200212,055276,台積電元大97購20,1.43,1.46,1.43,1.46,+0.08,5.8,235000,6,338750,0,0,0,0,0,0,135000,115000,20000,20000
20200212,055277,旺宏元大97購04,1.03,1.07,0.99,0.99,-0.02,-1.98,315000,14,319750,0,0,0,0,0,0,145000,186000,-41000,-41000
20200212,055278,旺宏元大98購05,1.25,1.32,1.23,1.23,-0.03,-2.38,394000,23,501300,0,0,0,0,0,0,259000,388000,-129000,-129000
20200212,055279,華邦電元大97購02,0.40,0.40,0.40,0.40,+0.09,29.03,70000,2,28000,0,0,0,0,0,0,0,70000,-70000,-70000
20200212,05527P,聯茂群益96售01,1.94,1.94,1.94,1.94,-0.15,-7.18,1000,1,1940,0,0,0,0,0,0,1000,0,1000,1000
20200212,055280,智邦元大97購01,4.00,4.24,3.60,3.64,+0.11,3.12,113000,37,441810,0,0,0,0,0,0,55000,102000,-47000,-47000
20200212,055281,台光電元大98購03,0.67,0.84,0.67,0.79,+0.18,29.51,477000,30,361680,0,0,0,0,0,0,24000,477000,-453000,-453000
20200212,055282,聯發科元大97購15,1.72,1.92,1.69,1.90,+0.39,25.83,949000,46,1727610,0,0,0,0,0,0,785000,431000,354000,354000
20200212,055283,聯發科元大97購16,1.40,1.55,1.39,1.54,+0.28,22.22,960000,42,1436530,0,0,0,0,0,0,634000,503000,131000,131000
20200212,055284,全新元大99購01,0.77,0.89,0.75,0.89,+0.19,27.14,580000,23,477920,0,0,0,0,0,0,381000,233000,148000,148000
20200212,055285,華新科元大99購03,1.18,1.19,1.14,1.16,+0.03,2.65,402000,43,463320,0,0,0,0,0,0,126000,263000,-137000,-137000
20200212,055286,晶技元大98購03,0.69,0.72,0.69,0.72,+0.04,5.88,110000,7,76900,0,0,0,0,0,0,100000,10000,90000,90000
20200212,055287,日電貿元大97購01,2.43,2.43,2.21,2.38,+0.12,5.31,536000,35,1261270,0,0,0,0,0,0,526000,204000,322000,322000
20200212,055288,日電貿元大97購02,2.00,2.00,1.84,1.97,+0.10,5.35,433000,38,837090,0,0,0,0,0,0,272000,258000,14000,14000
20200212,055289,泰碩元大98購01,0.49,0.49,0.48,0.48,-0.03,-5.88,57000,2,27830,0,0,0,0,0,0,57000,0,57000,57000
20200212,05528P,臺股指群益96售01,,,,,0.00,0.00,0,0,0,0,0,0,0,0,0,0,0,0,0
20200212,055290,玉晶光元大98購08,0.94,1.03,0.94,1.01,+0.12,13.48,77000,10,76390,0,0,0,0,0,0,0,77000,-77000,-77000
20200212,055291,京鼎元大97購02,2.72,3.20,2.72,3.09,0.00,0.00,170000,20,503660,0,0,0,0,0,0,52000,150000,-98000,-98000
20200212,055292,聯鈞元大97購02,1.56,1.91,1.56,1.91,+0.43,29.05,787000,34,1315630,0,0,0,0,0,0,376000,411000,-35000,-35000
20200212,055293,晶相光元大97購01,1.74,1.92,1.74,1.78,+0.05,2.89,234000,11,422980,0,0,0,0,0,0,159000,80000,79000,79000
20200212,055294,智易元大98購01,0.52,0.62,0.52,0.61,+0.11,22.0,329000,11,192450,0,0,0,0,0,0,170000,159000,11000,11000
20200212,055295,瀚宇博元大97購02,1.37,1.59,1.37,1.59,+0.17,11.97,363000,26,537210,0,0,0,0,0,0,159000,236000,-77000,-77000
20200212,055296,康舒元大97購02,1.44,1.47,1.44,1.47,+0.09,6.52,78000,3,113880,0,0,0,0,0,0,62000,78000,-16000,-16000
20200212,055297,啟碁元大97購01,2.09,2.14,2.09,2.12,+0.06,2.91,47000,6,99060,0,0,0,0,0,0,11000,36000,-25000,-25000
20200212,055298,啟碁元大97購02,1.81,1.84,1.81,1.84,+0.05,2.79,25000,2,45610,0,0,0,0,0,0,13000,12000,1000,1000
20200212,055299,康友元大97購02,2.58,2.75,2.58,2.73,+0.26,10.53,150000,12,403610,0,0,0,0,0,0,35000,140000,-105000,-105000
20200212,05529P,臺股指群益96售02,0.40,0.40,0.35,0.35,-0.09,-20.45,148000,7,56700,0,0,0,0,0,0,0,148000,-148000,-148000
20200212,055300,緯穎元大98購01,2.36,2.55,2.25,2.51,+0.11,4.58,555000,31,1334210,0,0,0,0,0,0,515000,142000,373000,373000
20200212,055301,台虹元大97購01,1.17,1.23,1.17,1.23,+0.12,10.81,326000,19,394300,0,0,0,0,0,0,278000,48000,230000,230000
20200212,055302,達方元大97購01,1.44,1.48,1.44,1.46,+0.06,4.29,259000,12,382280,0,0,0,0,0,0,153000,190000,-37000,-37000
20200212,055303,鈺齊元大97購01,1.88,2.15,1.88,2.15,+0.29,15.59,103000,4,215180,0,0,0,0,0,0,1000,102000,-101000,-101000
20200212,055304,瑞昱第一98購01,0.96,1.01,0.96,0.98,+0.06,6.52,321000,7,320890,0,0,0,0,0,0,313000,0,313000,313000
20200212,055305,旺宏群益99購01,,,,,0.00,0.00,0,0,0,0,0,0,0,0,0,0,0,0,0
20200212,055306,燿華群益97購01,0.89,0.95,0.89,0.95,+0.13,15.85,45000,8,41790,0,0,0,0,0,0,2000,45000,-43000,-43000
20200212,055307,瑞昱群益97購02,2.36,2.69,2.36,2.48,+0.13,5.53,178000,15,439770,0,0,0,0,0,0,130000,48000,82000,82000
20200212,055308,聯發科群益97購04,0.95,1.04,0.95,1.04,+0.21,25.3,705000,12,701400,0,0,0,0,0,0,116000,589000,-473000,-473000
20200212,055309,冠德群益97購01,0.38,0.40,0.38,0.40,+0.03,8.11,17000,3,6740,0,0,0,0,0,0,0,17000,-17000,-17000
20200212,05530P,臺股指群益96售03,0.57,0.57,0.57,0.57,-0.06,-9.52,5000,1,2850,0,0,0,0,0,0,0,5000,-5000,-5000
20200212,055310,聯詠群益97購02,2.07,2.19,2.01,2.15,+0.21,10.82,925000,45,1946970,0,0,0,0,0,0,543000,332000,211000,211000
20200212,055311,健策群益98購02,1.64,1.81,1.54,1.80,+0.23,14.65,772000,55,1302300,0,0,0,0,0,0,442000,585000,-143000,-143000
20200212,055312,台虹群益99購01,1.33,1.38,1.31,1.36,+0.06,4.62,392000,16,530810,0,0,0,0,0,0,164000,228000,-64000,-64000
20200212,055313,南電群益97購01,1.25,1.55,0.51,1.51,+0.19,14.39,780000,43,1097090,0,0,0,0,0,0,432000,455000,-23000,-23000
20200212,055314,華邦電中信99購01,0.92,0.96,0.92,0.94,+0.08,9.3,406000,20,381080,0,0,0,0,0,0,86000,320000,-234000,-234000
20200212,055315,晶技麥證97購01,0.60,0.60,0.60,0.60,+0.03,5.26,30000,1,18000,30000,0,30000,0,0,0,30000,0,30000,30000
20200212,055316,上銀國票98購01,3.72,3.72,3.54,3.54,-0.06,-1.67,800000,3,2904000,0,0,0,0,0,0,400000,400000,0,0
20200212,055317,金寶國票98購01,1.51,1.55,1.48,1.55,-0.01,-0.64,412000,26,619020,0,0,0,0,0,0,306000,311000,-5000,-5000
20200212,055318,華通國票98購01,1.86,2.23,1.86,2.23,0.00,0.00,469000,4,1031340,0,0,0,0,0,0,0,469000,-469000,-469000
20200212,055319,國巨國票98購03,5.10,5.25,4.79,5.25,+0.55,11.7,64000,15,325200,0,0,0,0,0,0,46000,18000,28000,28000
20200212,05531P,臺股指群益96售04,0.76,0.76,0.76,0.76,0.00,0.00,50000,2,38000,0,0,0,0,0,0,0,50000,-50000,-50000
20200212,055320,建準國票98購01,,,,,0.00,0.00,0,0,0,0,0,0,0,0,0,0,0,0,0
20200212,055321,大立光國票98購02,1.73,1.94,1.73,1.94,+0.17,9.6,75000,4,141690,0,0,0,0,0,0,0,75000,-75000,-75000
20200212,055322,欣興國票97購06,2.07,2.88,2.07,2.86,+0.73,34.27,277000,15,773020,0,0,0,0,0,0,234000,243000,-9000,-9000
20200212,055323,貿聯國票98購01,1.29,1.48,1.29,1.48,+0.20,15.62,869000,11,1191010,0,0,0,0,0,0,799000,70000,729000,729000
20200212,055324,TPK國票98購03,1.17,1.32,1.15,1.32,+0.11,9.09,92000,13,113030,0,0,0,0,0,0,36000,56000,-20000,-20000
20200212,055325,佐登國票98購01,0.78,0.88,0.75,0.86,+0.11,14.67,415000,13,333610,0,0,0,0,0,0,320000,95000,225000,225000
20200212,055326,緯穎國票97購06,5.85,6.00,5.85,6.00,0.00,0.00,9000,2,52800,0,0,0,0,0,0,9000,0,9000,9000
20200212,055327,致新國票98購01,2.25,2.31,2.17,2.27,-0.07,-2.99,141000,11,319380,0,0,0,0,0,0,74000,67000,7000,7000
20200212,055328,鈺齊國票98購01,1.06,1.27,1.04,1.27,+0.15,13.39,187000,12,206380,0,0,0,0,0,0,45000,142000,-97000,-97000
20200212,055329,百和國票98購01,1.31,1.31,1.31,1.31,-0.02,-1.5,10000,1,13100,0,0,0,0,0,0,10000,0,10000,10000
20200212,05532P,臺股指群益96售05,1.58,1.58,1.43,1.45,-0.18,-11.04,114000,15,172870,0,0,0,0,0,0,35000,79000,-44000,-44000
20200212,055330,上銀兆豐98購02,2.85,2.85,2.85,2.85,+0.03,1.06,1000,1,2850,0,0,0,0,0,0,1000,0,1000,1000
20200212,055331,國巨兆豐99購01,3.06,3.12,3.03,3.12,+0.24,8.33,87000,9,266870,0,0,0,0,0,0,45000,42000,3000,3000
20200212,055332,奇力新兆豐98購01,1.38,1.46,1.36,1.46,+0.02,1.39,211000,25,292440,0,0,0,0,0,0,137000,31000,106000,106000
20200212,055333,晶豪科兆豐97購01,1.50,1.56,1.50,1.52,+0.13,9.35,208000,9,318200,0,0,0,0,0,0,0,208000,-208000,-208000
20200212,055334,禾伸堂兆豐97購01,1.77,1.85,1.69,1.85,+0.06,3.35,337000,26,589790,0,0,0,0,0,0,287000,50000,237000,237000
20200212,055335,健策兆豐98購01,1.50,1.65,1.45,1.65,+0.25,17.86,225000,26,341450,0,0,0,0,0,0,156000,60000,96000,96000
20200212,055336,茂林兆豐98購01,1.43,1.50,1.40,1.48,+0.07,4.96,781000,57,1124790,0,0,0,0,0,0,486000,295000,191000,191000
20200212,055337,超眾兆豐98購01,0.58,0.64,0.58,0.64,+0.03,4.92,552000,25,335340,0,0,0,0,0,0,211000,341000,-130000,-130000
20200212,055338,GIS兆豐97購01,0.73,0.77,0.73,0.77,+0.09,13.24,466000,14,347950,0,0,0,0,0,0,10000,456000,-446000,-446000
20200212,055339,緯穎兆豐98購01,4.09,4.34,4.05,4.34,+0.14,3.33,48000,15,199310,0,0,0,0,0,0,31000,17000,14000,14000
20200212,05533P,滬深2X富邦97售01,,,,,0.00,0.00,0,0,0,0,0,0,0,0,0,0,0,0,0
20200212,055340,華新科日盛97購01,1.24,1.26,1.18,1.23,+0.06,5.13,4331000,83,5223140,0,0,0,0,0,0,3318000,3755000,-437000,-437000
20200212,055341,台達電凱基97購02,1.05,1.05,1.05,1.05,+0.08,8.25,20000,2,21000,0,0,0,0,0,0,0,20000,-20000,-20000
20200212,055342,鴻海凱基97購04,1.16,1.30,1.15,1.30,+0.29,28.71,110000,10,129550,0,0,0,0,0,0,55000,55000,0,0
20200212,055343,國巨凱基97購03,,,,,0.00,0.00,0,0,0,0,0,0,0,0,0,0,0,0,0
20200212,055344,國巨凱基97購04,4.18,4.31,4.11,4.31,+0.29,7.21,25000,6,104050,0,0,0,0,0,0,11000,14000,-3000,-3000
20200212,055345,國巨凱基98購01,,,,,0.00,0.00,0,0,0,0,0,0,0,0,0,0,0,0,0
20200212,055346,國巨凱基98購02,2.57,2.68,2.57,2.68,+0.23,9.39,421000,10,1085230,0,0,0,0,0,0,420000,411000,9000,9000
20200212,055347,台積電凱基97購10,,,,,0.00,0.00,0,0,0,0,0,0,0,0,0,0,0,0,0
20200212,055348,旺宏凱基97購01,1.62,1.62,1.59,1.59,-0.02,-1.24,3000,3,4800,0,0,0,0,0,0,3000,3000,0,0
20200212,055349,京元電凱基97購02,1.37,1.46,0.25,1.46,+0.06,4.29,104000,17,139280,0,0,0,0,0,0,83000,41000,42000,42000
20200212,05534P,元油反元大96售06,0.47,0.47,0.47,0.47,0.00,0.00,10000,1,4700,0,0,0,0,0,0,10000,0,10000,10000
20200212,055350,聯發科凱基97購02,1.21,1.31,1.19,1.31,+0.24,22.43,192000,11,238880,0,0,0,0,0,0,132000,62000,70000,70000
20200212,055351,聯發科凱基97購03,1.74,1.93,1.74,1.93,+0.41,26.97,16000,10,30300,0,0,0,0,0,0,16000,16000,0,0
20200212,055352,奇力新凱基97購01,1.37,1.54,1.37,1.54,+0.09,6.21,61000,20,89340,0,0,0,0,0,0,20000,40000,-20000,-20000
20200212,055353,華新科凱基98購03,3.78,3.84,3.78,3.84,+0.12,3.23,12000,4,45630,0,0,0,0,0,0,12000,12000,0,0
20200212,055354,宏達電凱基98購01,,,,,0.00,0.00,0,0,0,0,0,0,0,0,0,0,0,0,0
20200212,055355,大立光凱基97購05,1.58,1.78,1.58,1.78,+0.19,11.95,247000,10,426960,0,0,0,0,0,0,229000,79000,150000,150000
20200212,055356,大立光凱基97購06,3.50,3.54,3.50,3.54,0.00,0.00,20000,2,70400,0,0,0,0,0,0,20000,0,20000,20000
20200212,055357,欣興凱基97購04,1.37,1.64,1.37,1.64,+0.33,25.19,69000,17,109590,0,0,0,0,0,0,12000,69000,-57000,-57000
20200212,055358,臻鼎凱基97購01,1.74,1.74,1.74,1.74,+0.39,28.89,50000,1,87000,0,0,0,0,0,0,50000,0,50000,50000
20200212,055359,超眾凱基97購01,1.07,1.07,1.07,1.07,+0.07,7.0,40000,1,42800,0,0,0,0,0,0,40000,0,40000,40000
20200212,05535P,台積電元大97售06,1.43,1.45,1.41,1.41,-0.13,-8.44,664000,7,953880,0,0,0,0,0,0,664000,664000,0,0
20200212,055360,台表科凱基97購02,1.07,1.09,1.06,1.09,+0.03,2.83,23000,4,24790,0,0,0,0,0,0,23000,12000,11000,11000
20200212,055361,樺漢凱基97購01,1.07,1.07,1.07,1.07,+0.04,3.88,62000,2,66340,0,0,0,0,0,0,62000,0,62000,62000
20200212,055362,GIS凱基97購03,1.11,1.11,1.11,1.11,+0.06,5.71,71000,2,78810,0,0,0,0,0,0,71000,0,71000,71000
20200212,055363,緯穎凱基98購03,2.30,2.48,1.20,2.48,+0.20,8.77,68000,5,147550,0,0,0,0,0,0,55000,13000,42000,42000
20200212,055364,矽創凱基97購03,0.86,1.18,0.86,1.18,+0.33,38.82,89000,34,94060,0,0,0,0,0,0,33000,58000,-25000,-25000
20200212,055365,華通元大97購03,2.69,3.54,2.60,3.51,+0.90,34.48,473000,71,1441480,0,0,0,0,0,0,399000,284000,115000,115000
20200212,055366,國巨元大98購05,4.65,4.65,4.45,4.45,+0.14,3.25,23000,4,104230,0,0,0,0,0,0,23000,0,23000,23000
20200212,055367,台積電元大97購23,,,,,0.00,0.00,0,0,0,0,0,0,0,0,0,0,0,0,0
20200212,055368,台積電元大97購24,1.93,1.98,1.93,1.98,+0.14,7.61,181000,4,350830,0,0,0,0,0,0,121000,171000,-50000,-50000
20200212,055369,友訊元大97購01,1.43,1.44,1.39,1.39,-0.05,-3.47,165000,11,234510,0,0,0,0,0,0,0,155000,-155000,-155000
20200212,05536P,奇力新元大96售03,0.39,0.39,0.37,0.37,-0.03,-7.5,252000,5,96280,0,0,0,0,0,0,200000,52000,148000,148000
20200212,055370,旺宏元大97購05,1.17,1.24,1.14,1.15,-0.02,-1.71,114000,7,136260,0,0,0,0,0,0,4000,114000,-110000,-110000
20200212,055371,正崴元大97購02,1.20,1.28,1.20,1.27,+0.04,3.25,253000,9,319880,0,0,0,0,0,0,153000,112000,41000,41000
20200212,055372,宏達電元大97購04,0.61,0.61,0.61,0.61,0.00,0.00,8000,2,4880,0,0,0,0,0,0,7000,1000,6000,6000
20200212,055373,聯詠元大97購03,3.00,3.22,3.00,3.19,+0.24,8.14,220000,19,685380,0,0,0,0,0,0,161000,167000,-6000,-6000
20200212,055374,明泰元大97購01,1.84,2.00,1.84,2.00,+0.19,10.5,425000,11,821640,0,0,0,0,0,0,301000,124000,177000,177000
20200212,055375,京鼎元大97購03,1.15,1.41,1.15,1.37,+0.29,26.85,845000,35,1091800,0,0,0,0,0,0,448000,845000,-397000,-397000
20200212,055376,群創元大01購01,2.44,2.45,2.39,2.40,0.00,0.00,299000,34,724350,0,0,0,0,0,0,158000,298000,-140000,-140000
20200212,055377,揚明光元大98購01,1.15,1.21,1.15,1.21,+0.08,7.08,286000,9,340990,0,0,0,0,0,0,129000,157000,-28000,-28000
20200212,055378,晶相光元大97購02,1.28,1.37,1.28,1.30,+0.06,4.84,400000,19,519790,0,0,0,0,0,0,137000,280000,-143000,-143000
20200212,055379,牧德元大97購03,1.30,1.37,1.24,1.25,-0.04,-3.1,736000,41,966970,0,0,0,0,0,0,661000,96000,565000,565000
20200212,05537P,群創中信98售01,,,,,0.00,0.00,0,0,0,0,0,0,0,0,0,0,0,0,0
20200212,055380,智易元大98購02,1.21,1.50,1.21,1.47,+0.34,30.09,210000,14,291030,0,0,0,0,0,0,11000,199000,-188000,-188000
20200212,055381,茂林元大97購02,4.08,4.18,3.96,4.08,+0.14,3.55,262000,42,1073580,0,0,0,0,0,0,96000,233000,-137000,-137000
20200212,055382,台郡元大99購01,2.91,2.91,2.67,2.67,+0.84,45.9,18000,2,51180,0,0,0,0,0,0,13000,5000,8000,8000
20200212,055383,GIS元大97購02,1.38,1.51,1.38,1.48,+0.09,6.47,134000,5,195640,0,0,0,0,0,0,134000,79000,55000,55000
20200212,055384,緯穎元大98購02,2.60,2.82,2.47,2.79,+0.14,5.28,243000,32,650800,0,0,0,0,0,0,199000,193000,6000,6000
20200212,055385,昇陽半元大98購01,0.92,0.95,0.92,0.92,0.00,0.00,191000,13,176850,0,0,0,0,0,0,166000,56000,110000,110000
20200212,055386,致新元大97購02,1.01,1.02,0.96,0.99,-0.02,-1.98,640000,19,634770,0,0,0,0,0,0,217000,478000,-261000,-261000
20200212,055387,世紀鋼元大97購01,1.25,1.26,1.25,1.25,+0.01,0.81,86000,6,107950,0,0,0,0,0,0,86000,2000,84000,84000
20200212,055388,華通統一97購03,2.01,2.71,1.97,2.71,+0.79,41.15,473000,22,1139640,0,0,0,0,0,0,106000,367000,-261000,-261000
20200212,055389,國巨統一98購02,3.36,3.36,3.30,3.30,+0.19,6.11,70000,4,235040,0,0,0,0,0,0,68000,2000,66000,66000
20200212,05538P,玉晶光國票97售02,1.85,1.85,1.85,1.85,-0.21,-10.19,10000,1,18500,0,0,0,0,0,0,0,10000,-10000,-10000
20200212,055390,國巨統一98購03,10.50,11.10,10.40,11.10,+1.35,13.85,52000,13,565800,0,0,0,0,0,0,17000,35000,-18000,-18000
20200212,055391,光罩統一97購02,0.68,0.74,0.67,0.73,+0.05,7.35,1170000,36,822520,0,0,0,0,0,0,580000,590000,-10000,-10000
20200212,055392,凱美統一97購03,0.66,0.72,0.64,0.72,+0.05,7.46,988000,26,665800,0,0,0,0,0,0,358000,619000,-261000,-261000
20200212,055393,華新科統一97購03,,,,,0.00,0.00,0,0,0,0,0,0,0,0,0,0,0,0,0
20200212,055394,健策統一97購01,1.81,1.96,1.67,1.96,+0.35,21.74,1072000,58,1946230,0,0,0,0,0,0,476000,545000,-69000,-69000
20200212,055395,泰鼎統一97購01,1.76,1.80,1.76,1.80,+0.24,15.38,121000,11,217100,0,0,0,0,0,0,74000,21000,53000,53000
20200212,055396,瑞儀統一97購01,0.86,0.87,0.86,0.86,+0.01,1.18,232000,6,200970,0,0,0,0,0,0,145000,87000,58000,58000
20200212,055397,超眾統一97購02,0.62,0.70,0.62,0.70,+0.03,4.48,892000,27,581800,0,0,0,0,0,0,403000,489000,-86000,-86000
20200212,055398,超眾統一97購03,0.93,0.96,0.85,0.96,+0.04,4.35,557000,26,491880,0,0,0,0,0,0,470000,26000,444000,444000
20200212,055399,超眾統一99購01,0.45,0.48,0.45,0.48,+0.04,9.09,118000,2,53400,0,0,0,0,0,0,0,118000,-118000,-118000
20200212,05539P,鎧勝永豐96售01,1.38,1.38,1.38,1.38,-0.03,-2.13,1000,1,1380,0,0,0,0,0,0,1000,0,1000,1000
20200212,055400,緯穎統一97購01,3.00,3.24,3.00,3.24,+0.24,8.0,20000,3,62400,0,0,0,0,0,0,10000,10000,0,0
20200212,055401,亞光元富9A購01,0.48,0.50,0.48,0.50,+0.09,21.95,41000,3,19700,0,0,0,0,0,0,40000,1000,39000,39000
20200212,055402,正文元富97購02,0.92,0.92,0.90,0.92,0.00,0.00,16000,3,14640,0,0,0,0,0,0,16000,0,16000,16000
20200212,055403,泰鼎元富97購01,2.90,3.11,2.80,2.85,+0.13,4.78,626000,85,1873350,0,0,0,0,0,0,208000,418000,-210000,-210000
20200212,055404,超眾元富97購01,0.66,0.69,0.64,0.67,0.00,0.00,201000,19,133510,0,0,0,0,0,0,148000,23000,125000,125000
20200212,055405,華泰國泰98購01,1.01,1.01,0.98,1.01,+0.07,7.45,30000,4,30000,0,0,0,0,0,0,0,30000,-30000,-30000
20200212,055406,大毅國泰99購01,,,,,0.00,0.00,0,0,0,0,0,0,0,0,0,0,0,0,0
20200212,055407,祥碩國泰98購01,,,,,0.00,0.00,0,0,0,0,0,0,0,0,0,0,0,0,0
20200212,055408,力成國泰98購01,5.60,5.65,5.55,5.65,0.00,0.00,171000,15,961050,0,0,0,0,0,0,0,171000,-171000,-171000
20200212,055409,元黃金富邦01購01,,,,,0.00,0.00,0,0,0,0,0,0,0,0,0,0,0,0,0
20200212,05540P,亞德客凱基96售01,0.47,0.47,0.43,0.43,-0.04,-8.51,428000,14,194730,0,0,0,0,0,0,40000,378000,-338000,-338000
20200212,055410,元油反富邦9A購01,,,,,0.00,0.00,0,0,0,0,0,0,0,0,0,0,0,0,0
20200212,055411,國巨富邦9A購02,0.77,0.83,0.76,0.83,+0.07,9.21,1954000,77,1539470,0,0,0,0,0,0,861000,1038000,-177000,-177000
20200212,055412,旺宏富邦99購01,0.94,1.00,0.91,0.92,-0.01,-1.08,286000,19,269790,0,0,0,0,0,0,6000,286000,-280000,-280000
20200212,055413,全新富邦98購01,0.38,0.45,0.37,0.45,+0.10,28.57,1158000,32,473830,0,0,0,0,0,0,706000,452000,254000,254000
20200212,055414,奇力新富邦9B購01,0.77,0.81,0.76,0.81,+0.02,2.53,186000,34,144390,0,0,0,0,0,0,128000,28000,100000,100000
20200212,055415,禾伸堂富邦9B購01,0.59,0.62,0.59,0.62,0.00,0.00,539000,37,321620,0,0,0,0,0,0,387000,444000,-57000,-57000
20200212,055416,欣興富邦98購01,0.50,0.62,0.50,0.60,+0.10,20.0,464000,21,272670,0,0,0,0,0,0,150000,324000,-174000,-174000
20200212,055417,健策富邦98購02,0.46,0.53,0.46,0.53,+0.06,12.77,1138000,34,575060,0,0,0,0,0,0,688000,0,688000,688000
20200212,055418,華通永豐97購01,0.83,0.90,0.81,0.89,0.00,0.00,254000,15,215210,0,0,0,0,0,0,40000,254000,-214000,-214000
20200212,055419,國巨永豐97購03,1.72,1.72,1.72,1.72,+0.05,2.99,29000,1,49880,0,0,0,0,0,0,29000,0,29000,29000
20200212,05541P,鴻海統一96售08,,,,,0.00,0.00,0,0,0,0,0,0,0,0,0,0,0,0,0
20200212,055420,欣興永豐98購01,1.57,1.84,1.57,1.84,+0.34,22.67,614000,28,1033150,0,0,0,0,0,0,366000,300000,66000,66000
20200212,055421,玉晶光永豐98購04,1.39,1.50,1.39,1.50,+0.16,11.94,789000,14,1126450,0,0,0,0,0,0,309000,410000,-101000,-101000
20200212,055422,康控永豐97購01,0.65,0.73,0.65,0.73,+0.09,14.06,443000,15,311350,0,0,0,0,0,0,188000,255000,-67000,-67000
20200212,055423,亞光亞東99購01,,,,,0.00,0.00,0,0,0,0,0,0,0,0,0,0,0,0,0
20200212,055424,聚陽群益98購01,1.10,1.12,1.10,1.10,-0.02,-1.79,145000,7,159920,0,0,0,0,0,0,145000,0,145000,145000
20200212,055425,聚陽群益99購01,1.40,1.40,1.37,1.37,+0.02,1.48,22000,4,30510,0,0,0,0,0,0,22000,0,22000,22000
20200212,055426,旺宏群益99購02,2.35,2.35,2.32,2.32,+0.11,4.98,9000,2,21030,0,0,0,0,0,0,5000,4000,1000,1000
20200212,055427,技嘉群益98購01,2.99,3.13,2.88,2.97,0.00,0.00,281000,31,848910,0,0,0,0,0,0,256000,116000,140000,140000
20200212,055428,友達群益9C購01,,,,,0.00,0.00,0,0,0,0,0,0,0,0,0,0,0,0,0
20200212,055429,華新科群益99購01,2.69,2.75,2.59,2.67,+0.14,5.53,120000,17,320850,0,0,0,0,0,0,70000,85000,-15000,-15000
20200212,05542P,滬深2X元富96售01,,,,,0.00,0.00,0,0,0,0,0,0,0,0,0,0,0,0,0
20200212,055430,宏達電群益97購01,1.56,1.58,1.53,1.53,+0.02,1.32,102000,5,157410,0,0,0,0,0,0,81000,21000,60000,60000
20200212,055431,和鑫群益98購01,0.82,0.86,0.80,0.86,+0.06,7.5,346000,17,289510,0,0,0,0,0,0,157000,189000,-32000,-32000
20200212,055432,臻鼎群益97購02,2.53,2.73,2.22,2.22,+0.39,21.31,64000,5,156510,0,0,0,0,0,0,53000,0,53000,53000
20200212,055433,嘉聯益群益99購01,0.98,1.00,0.96,0.96,+0.07,7.87,906000,11,885980,0,0,0,0,0,0,905000,1000,904000,904000
20200212,055434,樺漢群益97購01,,,,,0.00,0.00,0,0,0,0,0,0,0,0,0,0,0,0,0
20200212,055435,佳世達中信99購01,1.18,1.20,1.18,1.20,-0.01,-0.83,120000,2,142000,0,0,0,0,0,0,120000,0,120000,120000
20200212,055436,晶豪科中信99購01,0.79,0.79,0.78,0.78,0.00,0.00,19000,3,14910,0,0,0,0,0,0,0,19000,-19000,-19000
20200212,055437,禾伸堂中信99購01,1.68,1.68,1.63,1.68,+0.03,1.82,196000,9,325380,0,0,0,0,0,0,74000,122000,-48000,-48000
20200212,055438,鴻海國票98購01,1.23,1.44,1.23,1.43,+0.36,33.64,96000,5,127110,0,0,0,0,0,0,43000,53000,-10000,-10000
20200212,055439,台表科國票98購02,,,,,0.00,0.00,0,0,0,0,0,0,0,0,0,0,0,0,0
20200212,05543P,鴻海元富96售04,2.19,2.19,2.06,2.06,-0.26,-11.21,103000,3,224180,0,0,0,0,0,0,100000,3000,97000,97000
20200212,055440,矽力國票98購01,3.37,4.06,3.37,4.06,+0.61,17.68,89000,5,330440,0,0,0,0,0,0,48000,41000,7000,7000
20200212,055441,緯穎國票98購01,4.43,4.70,4.43,4.70,+0.37,8.55,12000,2,53700,0,0,0,0,0,0,12000,0,12000,12000
20200212,055442,矽創國票98購02,1.96,2.29,1.96,2.26,+0.20,9.71,44000,13,91700,0,0,0,0,0,0,44000,0,44000,44000
20200212,055443,台虹國票98購01,1.29,1.37,1.29,1.37,+0.17,14.17,209000,13,281920,0,0,0,0,0,0,60000,149000,-89000,-89000
20200212,055444,致新台新97購01,1.00,1.09,0.98,1.09,0.00,0.00,470000,23,477930,0,0,0,0,0,0,464000,0,464000,464000
20200212,055445,旺宏統一99購01,1.61,1.61,1.56,1.56,-0.04,-2.5,73000,6,116530,0,0,0,0,0,0,48000,25000,23000,23000
20200212,055446,奇力新統一9A購01,1.47,1.56,1.42,1.54,+0.07,4.76,1056000,81,1564020,0,0,0,0,0,0,806000,216000,590000,590000
20200212,055447,華新科統一97購04,1.52,1.53,1.47,1.53,+0.05,3.38,167000,7,253880,0,0,0,0,0,0,72000,95000,-23000,-23000
20200212,055448,健策統一97購02,1.49,1.60,1.40,1.58,+0.27,20.61,342000,27,497520,0,0,0,0,0,0,302000,40000,262000,262000
20200212,055449,超眾統一9A購01,1.17,1.28,1.15,1.28,+0.08,6.67,583000,26,705800,0,0,0,0,0,0,331000,252000,79000,79000
20200212,05544P,台表科元富96售01,,,,,0.00,0.00,0,0,0,0,0,0,0,0,0,0,0,0,0
20200212,055450,台積電元富97購01,1.27,1.32,1.23,1.32,+0.12,10.0,1347000,30,1723100,0,0,0,0,0,0,782000,565000,217000,217000
20200212,055451,台積電元富97購02,0.62,0.67,0.62,0.67,+0.08,13.56,302000,8,195910,0,0,0,0,0,0,107000,195000,-88000,-88000
20200212,055452,台積電元富97購03,0.92,0.97,0.92,0.95,+0.10,11.76,155000,6,143830,0,0,0,0,0,0,57000,98000,-41000,-41000
20200212,055453,華邦電元富97購01,0.31,0.32,0.31,0.32,0.00,0.00,210000,4,66150,0,0,0,0,0,0,0,210000,-210000,-210000
20200212,055454,華邦電元富97購02,0.82,0.87,0.82,0.82,+0.13,18.84,206000,18,171160,0,0,0,0,0,0,150000,154000,-4000,-4000
20200212,055455,健策國泰98購02,1.28,1.29,1.20,1.25,+0.08,6.84,523000,29,653490,0,0,0,0,0,0,503000,129000,374000,374000
20200212,055456,上銀富邦99購01,1.80,1.80,1.79,1.80,+0.05,2.86,30000,4,53910,0,0,0,0,0,0,29000,1000,28000,28000
20200212,055457,聚陽永豐97購01,0.63,0.64,0.63,0.63,-0.03,-4.55,191000,7,120380,0,0,0,0,0,0,190000,1000,189000,189000
20200212,055458,燿華永豐98購01,1.03,1.06,1.03,1.06,+0.12,12.77,244000,7,255960,0,0,0,0,0,0,0,244000,-244000,-244000
20200212,055459,建準永豐97購03,,,,,0.00,0.00,0,0,0,0,0,0,0,0,0,0,0,0,0
20200212,05545P,台表科國泰98售01,1.55,1.55,1.50,1.50,-0.09,-5.66,59000,6,89590,0,0,0,0,0,0,19000,40000,-21000,-21000
20200212,055460,華擎永豐97購01,2.95,3.12,2.82,2.82,+0.07,2.55,57000,8,169060,0,0,0,0,0,0,53000,4000,49000,49000
20200212,055461,TPK永豐97購01,0.63,0.69,0.62,0.69,+0.07,11.29,202000,6,135590,0,0,0,0,0,0,57000,145000,-88000,-88000
20200212,055462,華邦電日盛97購01,0.59,0.64,0.59,0.63,+0.08,14.55,760000,16,479130,0,0,0,0,0,0,42000,718000,-676000,-676000
20200212,055463,國喬凱基97購01,0.76,0.76,0.76,0.76,+0.11,16.92,20000,1,15200,0,0,0,0,0,0,0,0,0,0
20200212,055464,聚陽凱基97購01,0.93,0.93,0.93,0.93,0.00,0.00,1000,1,930,0,0,0,0,0,0,0,1000,-1000,-1000
20200212,055465,和大凱基97購03,0.63,0.63,0.63,0.63,-0.03,-4.55,8000,3,5040,0,0,0,0,0,0,0,8000,-8000,-8000
20200212,055466,台達電凱基97購03,1.35,1.35,1.35,1.35,0.00,0.00,94000,2,126900,0,0,0,0,0,0,0,94000,-94000,-94000
20200212,055467,國巨凱基97購05,3.23,3.24,3.18,3.20,+0.11,3.56,103000,9,330410,0,0,0,0,0,0,103000,43000,60000,60000
20200212,055468,智邦凱基97購04,2.12,2.38,1.85,1.85,-0.27,-12.74,28000,7,59860,0,0,0,0,0,0,5000,22000,-17000,-17000
20200212,055469,台光電凱基97購01,1.02,1.45,1.02,1.30,+0.34,35.42,21000,5,26660,0,0,0,0,0,0,5000,16000,-11000,-11000
20200212,05546P,全新元大97售01,1.22,1.22,1.22,1.22,0.00,0.00,2000,1,2440,0,0,0,0,0,0,0,0,0,0
20200212,055470,南亞科凱基97購01,,,,,0.00,0.00,0,0,0,0,0,0,0,0,0,0,0,0,0
20200212,055471,聯發科凱基97購04,1.91,2.09,1.91,2.08,+0.36,20.93,110000,16,220360,0,0,0,0,0,0,60000,65000,-5000,-5000
20200212,055472,大立光凱基97購07,1.87,2.04,1.87,2.04,+0.25,13.97,69000,5,138270,0,0,0,0,0,0,69000,59000,10000,10000
20200212,055473,禾伸堂凱基97購01,1.95,1.96,1.93,1.93,+0.05,2.66,8000,4,15590,0,0,0,0,0,0,6000,1000,5000,5000
20200212,055474,欣興凱基97購05,1.47,1.78,1.47,1.77,+0.25,16.45,107000,12,179480,0,0,0,0,0,0,81000,76000,5000,5000
20200212,055475,臻鼎凱基97購02,,,,,0.00,0.00,0,0,0,0,0,0,0,0,0,0,0,0,0
20200212,055476,台郡凱基97購02,2.29,2.30,2.25,2.30,+0.82,55.41,20000,12,45680,0,0,0,0,0,0,20000,5000,15000,15000
20200212,055477,同欣電凱基98購01,1.84,2.05,1.80,1.80,-0.01,-0.55,239000,8,471270,0,0,0,0,0,0,187000,71000,116000,116000
20200212,055478,訊芯凱基97購01,1.06,1.16,1.06,1.16,+0.14,13.73,77000,4,88060,0,0,0,0,0,0,77000,0,77000,77000
20200212,055479,GIS凱基97購04,,,,,0.00,0.00,0,0,0,0,0,0,0,0,0,0,0,0,0
20200212,05547P,群創元大96售03,,,,,0.00,0.00,0,0,0,0,0,0,0,0,0,0,0,0,0
20200212,055480,元上證元大97購02,0.90,0.90,0.90,0.90,-0.04,-4.26,18000,1,16200,0,0,0,0,0,0,18000,0,18000,18000
20200212,055481,聚陽元大97購01,,,,,0.00,0.00,0,0,0,0,0,0,0,0,0,0,0,0,0
20200212,055482,聚陽元大97購02,,,,,0.00,0.00,0,0,0,0,0,0,0,0,0,0,0,0,0
20200212,055483,和大元大97購03,0.93,0.99,0.93,0.99,0.00,0.00,33000,4,31980,0,0,0,0,0,0,0,13000,-13000,-13000
20200212,055484,華通元大97購04,1.15,1.52,1.14,1.52,+0.42,38.18,305000,39,396640,0,0,0,0,0,0,257000,169000,88000,88000
20200212,055485,國巨元大97購09,2.60,2.63,2.54,2.61,+0.12,4.82,311000,18,800760,0,0,0,0,0,0,43000,248000,-205000,-205000
20200212,055486,國巨元大98購06,3.13,3.16,3.05,3.15,+0.16,5.35,187000,19,583350,0,0,0,0,0,0,178000,93000,85000,85000
20200212,055487,國巨元大98購07,3.02,3.02,3.01,3.01,+0.22,7.89,16000,2,48260,0,0,0,0,0,0,10000,6000,4000,4000
20200212,055488,華邦電元大98購01,0.85,0.94,0.85,0.90,+0.13,16.88,158000,10,143030,0,0,0,0,0,0,96000,75000,21000,21000
20200212,055489,瑞昱元大97購02,2.88,3.20,2.88,3.07,+0.23,8.1,252000,32,752930,0,0,0,0,0,0,154000,146000,8000,8000
20200212,05548P,臺股指元大96售02,,,,,0.00,0.00,0,0,0,0,0,0,0,0,0,0,0,0,0
20200212,055490,台光電元大97購01,0.84,1.15,0.84,1.15,+0.32,38.55,163000,14,174190,0,0,0,0,0,0,20000,143000,-123000,-123000
20200212,055491,奇力新元大98購03,1.95,1.98,1.86,1.98,+0.04,2.06,260000,21,496590,0,0,0,0,0,0,248000,20000,228000,228000
20200212,055492,華新科元大97購08,1.60,1.62,1.55,1.59,+0.07,4.61,695000,29,1098280,0,0,0,0,0,0,625000,100000,525000,525000
20200212,055493,華新科元大97購09,1.90,1.90,1.84,1.87,+0.05,2.75,193000,29,359870,0,0,0,0,0,0,138000,145000,-7000,-7000
20200212,055494,華新科元大98購01,2.21,2.21,2.13,2.16,+0.07,3.35,155000,28,336030,0,0,0,0,0,0,134000,58000,76000,76000
20200212,055495,長榮航元大97購01,0.68,0.73,0.68,0.73,+0.03,4.29,1315000,24,912030,0,0,0,0,0,0,948000,367000,581000,581000
20200212,055496,高鐵元大97購02,1.16,1.16,1.14,1.14,0.00,0.00,15000,2,17300,0,0,0,0,0,0,15000,0,15000,15000
20200212,055497,開發金元大97購01,,,,,0.00,0.00,0,0,0,0,0,0,0,0,0,0,0,0,0
20200212,055498,大立光元大97購07,2.72,2.81,2.72,2.81,+0.29,11.51,202000,7,562800,0,0,0,0,0,0,175000,202000,-27000,-27000
20200212,055499,大立光元大98購05,1.91,1.92,1.91,1.92,+0.16,9.09,78000,2,149080,0,0,0,0,0,0,10000,68000,-58000,-58000
20200212,05549P,臺股指元大96售03,0.87,0.87,0.80,0.80,-0.10,-11.11,352000,7,290180,0,0,0,0,0,0,150000,202000,-52000,-52000
20200212,055500,京鼎元大97購04,2.75,3.29,2.75,3.29,0.00,0.00,211000,20,637530,0,0,0,0,0,0,0,211000,-211000,-211000
20200212,055501,創意元大97購01,2.50,2.50,2.18,2.31,-0.19,-7.6,157000,24,356940,0,0,0,0,0,0,109000,64000,45000,45000
20200212,055502,群創元大9C購03,1.25,1.25,1.25,1.25,-0.10,-7.41,1000,1,1250,0,0,0,0,0,0,1000,0,1000,1000
20200212,055503,健策元大98購05,1.15,1.21,1.08,1.20,+0.12,11.11,999000,50,1136900,0,0,0,0,0,0,802000,760000,42000,42000
20200212,055504,貿聯元大98購04,0.64,0.70,0.64,0.70,0.00,0.00,52000,2,36280,0,0,0,0,0,0,0,52000,-52000,-52000
20200212,055505,新唐元大97購02,,,,,0.00,0.00,0,0,0,0,0,0,0,0,0,0,0,0,0
20200212,055506,台郡元大99購02,1.80,1.85,1.72,1.85,+0.60,48.0,605000,36,1076640,0,0,0,0,0,0,265000,392000,-127000,-127000
20200212,055507,樺漢元大98購02,1.03,1.07,1.01,1.05,+0.05,5.0,421000,23,441240,0,0,0,0,0,0,228000,342000,-114000,-114000
20200212,055508,矽力元大97購01,4.60,4.80,4.60,4.80,+0.38,8.6,7000,2,33400,0,0,0,0,0,0,6000,1000,5000,5000
20200212,055509,訊芯元大97購03,1.20,1.41,1.20,1.37,+0.18,15.13,770000,39,1012930,0,0,0,0,0,0,251000,517000,-266000,-266000
20200212,05550P,臺股指元大96售07,1.83,1.83,1.76,1.76,-0.18,-9.28,30000,3,53800,0,0,0,0,0,0,0,30000,-30000,-30000
20200212,055510,GIS元大97購03,1.81,1.98,1.81,1.98,+0.15,8.2,90000,3,165130,0,0,0,0,0,0,90000,0,90000,90000
20200212,055511,大立光兆豐97購02,0.87,0.87,0.87,0.87,+0.01,1.16,70000,1,60900,0,0,0,0,0,0,70000,0,70000,70000
20200212,055512,聯詠兆豐97購01,3.14,3.21,2.94,3.08,+0.28,10.0,90000,8,279900,0,0,0,0,0,0,40000,50000,-10000,-10000
20200212,055513,旺宏亞東98購01,,,,,0.00,0.00,0,0,0,0,0,0,0,0,0,0,0,0,0
20200212,055514,亞光麥證97購01,,,,,0.00,0.00,0,0,0,0,0,0,0,0,0,0,0,0,0
20200212,055515,聚陽中信9A購01,0.96,0.96,0.95,0.95,-0.03,-3.06,335000,8,319270,0,0,0,0,0,0,245000,70000,175000,175000
20200212,055516,上銀中信97購01,1.48,1.48,1.41,1.41,+0.02,1.44,17000,4,24760,0,0,0,0,0,0,11000,6000,5000,5000
20200212,055517,國巨中信97購03,1.18,1.20,1.12,1.20,+0.11,10.09,209000,7,239860,0,0,0,0,0,0,151000,58000,93000,93000
20200212,055518,華新科中信99購01,0.86,0.87,0.82,0.85,+0.03,3.66,941000,44,803370,0,0,0,0,0,0,593000,338000,255000,255000
20200212,055519,茂林中信99購01,1.76,1.81,1.69,1.81,+0.09,5.23,476000,30,836090,0,0,0,0,0,0,307000,169000,138000,138000
20200212,05551P,電子類元大96售01,1.20,1.20,1.07,1.11,-0.15,-11.9,1011000,66,1145290,0,0,0,0,0,0,113000,898000,-785000,-785000
20200212,055520,矽力中信97購02,1.00,1.06,0.97,1.06,+0.09,9.28,601000,20,602210,0,0,0,0,0,0,244000,347000,-103000,-103000
20200212,055521,S&P反1群益01購01,,,,,0.00,0.00,0,0,0,0,0,0,0,0,0,0,0,0,0
20200212,055522,道瓊反群益01購01,0.56,0.56,0.56,0.56,0.00,0.00,2000,1,1120,0,0,0,0,0,0,0,2000,-2000,-2000
20200212,055523,道瓊銀群益9A購01,,,,,0.00,0.00,0,0,0,0,0,0,0,0,0,0,0,0,0
20200212,055524,鴻海群益98購01,1.82,2.07,1.79,2.07,+0.45,27.78,354000,15,660350,0,0,0,0,0,0,0,354000,-354000,-354000
20200212,055525,國巨群益98購05,3.33,3.45,3.32,3.45,+0.28,8.83,433000,26,1454550,0,0,0,0,0,0,249000,274000,-25000,-25000
20200212,055526,台積電群益97購02,0.90,0.93,0.90,0.93,+0.06,6.9,123000,3,111400,0,0,0,0,0,0,103000,20000,83000,83000
20200212,055527,旺宏群益99購03,2.30,2.30,2.22,2.25,+0.02,0.9,104000,6,233150,0,0,0,0,0,0,4000,100000,-96000,-96000
20200212,055528,華邦電群益97購01,0.42,0.44,0.42,0.44,+0.08,22.22,45000,7,19430,0,0,0,0,0,0,20000,25000,-5000,-5000
20200212,055529,華邦電群益97購02,0.39,0.42,0.39,0.40,+0.08,25.0,183000,12,73660,0,0,0,0,0,0,0,183000,-183000,-183000
20200212,05552P,聯詠群益96售01,1.73,1.82,1.73,1.73,-0.18,-9.42,41000,5,72690,0,0,0,0,0,0,18000,23000,-5000,-5000
20200212,055530,聯發科群益98購01,1.48,1.64,1.48,1.64,+0.36,28.13,438000,10,675440,0,0,0,0,0,0,130000,308000,-178000,-178000
20200212,055531,華新科群益98購03,2.07,2.08,2.00,2.06,+0.07,3.52,96000,18,197200,0,0,0,0,0,0,65000,66000,-1000,-1000
20200212,055532,中工群益98購01,1.00,1.00,1.00,1.00,0.00,0.00,1000,1,1000,0,0,0,0,0,0,0,1000,-1000,-1000
20200212,055533,大立光群益97購03,1.73,2.04,1.73,2.04,+0.35,20.71,219000,5,430960,0,0,0,0,0,0,44000,175000,-131000,-131000
20200212,055534,晶技群益97購03,0.85,0.88,0.85,0.88,+0.06,7.32,196000,2,169540,0,0,0,0,0,0,98000,98000,0,0
20200212,055535,緯創群益98購01,1.04,1.10,1.04,1.10,+0.05,4.76,193000,6,208070,0,0,0,0,0,0,98000,95000,3000,3000
20200212,055536,嘉聯益群益99購02,1.06,1.09,1.06,1.09,+0.07,6.86,50000,3,53460,0,0,0,0,0,0,50000,8000,42000,42000
20200212,055537,康友群益97購03,2.20,2.31,2.20,2.20,+0.10,4.76,149000,12,332300,0,0,0,0,0,0,10000,149000,-139000,-139000
20200212,055538,鴻海日盛97購04,1.69,2.03,1.63,2.03,+0.54,36.24,338000,22,600060,0,0,0,0,0,0,240000,96000,144000,144000
20200212,055539,億光台新97購01,,,,,0.00,0.00,0,0,0,0,0,0,0,0,0,0,0,0,0
20200212,05553P,智原群益96售01,,,,,0.00,0.00,0,0,0,0,0,0,0,0,0,0,0,0,0
20200212,055540,京鼎台新97購01,1.00,1.16,0.99,1.16,+0.33,39.76,437000,14,470920,0,0,0,0,0,0,38000,399000,-361000,-361000
20200212,055541,聚陽凱基98購01,0.85,0.85,0.85,0.85,+0.01,1.19,6000,2,5100,0,0,0,0,0,0,0,6000,-6000,-6000
20200212,055542,亞德客凱基97購01,0.72,0.79,0.72,0.79,-0.01,-1.25,132000,10,103130,0,0,0,0,0,0,80000,52000,28000,28000
20200212,055543,為升凱基97購01,0.51,0.51,0.51,0.51,-0.02,-3.77,300000,1,153000,0,0,0,0,0,0,300000,0,300000,300000
20200212,055544,鴻海凱基97購05,0.52,0.52,0.52,0.52,0.00,0.00,35000,1,18200,0,0,0,0,0,0,0,0,0,0
20200212,055545,國巨凱基97購06,,,,,0.00,0.00,0,0,0,0,0,0,0,0,0,0,0,0,0
20200212,055546,台積電凱基97購12,,,,,0.00,0.00,0,0,0,0,0,0,0,0,0,0,0,0,0
20200212,055547,台積電凱基97購13,2.95,2.98,2.95,2.98,+0.16,5.67,20000,2,59300,0,0,0,0,0,0,10000,10000,0,0
20200212,055548,旺宏凱基97購02,1.83,1.90,1.80,1.80,-0.05,-2.7,13000,4,24430,0,0,0,0,0,0,13000,3000,10000,10000
20200212,055549,旺宏凱基97購03,,,,,0.00,0.00,0,0,0,0,0,0,0,0,0,0,0,0,0
20200212,05554P,群創群益96售02,,,,,0.00,0.00,0,0,0,0,0,0,0,0,0,0,0,0,0
20200212,055550,華邦電凱基97購03,0.62,0.66,0.62,0.64,+0.08,14.29,117000,8,74480,0,0,0,0,0,0,47000,57000,-10000,-10000
20200212,055551,致茂凱基98購01,1.43,1.66,1.43,1.66,+0.29,21.17,465000,32,716880,0,0,0,0,0,0,394000,79000,315000,315000
20200212,055552,瑞昱凱基97購02,1.54,1.74,1.54,1.73,+0.22,14.57,130000,7,215620,0,0,0,0,0,0,130000,5000,125000,125000
20200212,055553,聯發科凱基97購05,0.57,0.65,0.57,0.65,+0.15,30.0,118000,8,72800,0,0,0,0,0,0,108000,10000,98000,98000
20200212,055554,聯發科凱基97購06,1.80,1.97,1.80,1.97,+0.37,23.12,16000,10,30830,0,0,0,0,0,0,15000,16000,-1000,-1000
20200212,055555,全新凱基9A購01,1.04,1.24,1.04,1.24,+0.29,30.53,987000,16,1107250,0,0,0,0,0,0,697000,305000,392000,392000
20200212,055556,奇力新凱基98購03,1.01,1.01,1.01,1.01,-0.01,-0.98,12000,9,12120,0,0,0,0,0,0,12000,0,12000,12000
20200212,055557,華新科凱基97購01,3.50,3.53,3.50,3.53,+0.13,3.82,7000,3,24560,0,0,0,0,0,0,7000,7000,0,0
20200212,055558,大立光凱基97購08,3.46,3.46,3.46,3.46,0.00,0.00,10000,1,34600,0,0,0,0,0,0,10000,10000,0,0
20200212,055559,大立光凱基97購09,,,,,0.00,0.00,0,0,0,0,0,0,0,0,0,0,0,0,0
20200212,05555P,健策群益98售01,1.26,1.26,1.26,1.26,-0.13,-9.35,5000,1,6300,0,0,0,0,0,0,5000,0,5000,5000
20200212,055560,大立光凱基97購10,1.65,1.65,1.65,1.65,+0.23,16.2,1000,1,1650,0,0,0,0,0,0,1000,0,1000,1000
20200212,055561,奇鋐凱基97購01,,,,,0.00,0.00,0,0,0,0,0,0,0,0,0,0,0,0,0
20200212,055562,欣興凱基97購06,1.84,2.25,1.84,2.25,+0.37,19.68,15000,5,30000,0,0,0,0,0,0,14000,9000,5000,5000
20200212,055563,智易凱基97購02,0.71,0.79,0.71,0.79,+0.18,29.51,166000,4,131060,0,0,0,0,0,0,1000,165000,-164000,-164000
20200212,055564,茂林凱基98購01,1.54,1.56,1.50,1.56,+0.05,3.31,64000,16,98420,0,0,0,0,0,0,34000,30000,4000,4000
20200212,055565,祥碩凱基97購01,6.05,7.30,6.05,7.30,+1.65,29.2,79000,16,519900,0,0,0,0,0,0,48000,31000,17000,17000
20200212,055566,台表科凱基97購03,1.05,1.05,1.05,1.05,0.00,0.00,10000,2,10500,0,0,0,0,0,0,10000,10000,0,0
20200212,055567,訊芯凱基98購02,0.40,0.42,0.40,0.42,+0.09,27.27,330000,2,134600,0,0,0,0,0,0,330000,0,330000,330000
20200212,055568,緯穎凱基97購02,2.21,2.21,2.21,2.21,-0.10,-4.33,39000,1,86190,0,0,0,0,0,0,39000,0,39000,39000
20200212,055569,聚陽統一98購01,1.14,1.14,1.12,1.12,-0.03,-2.61,557000,12,633240,0,0,0,0,0,0,468000,69000,399000,399000
20200212,05556P,全新國票96售04,1.32,1.33,1.32,1.32,-0.21,-13.73,36000,5,47690,0,0,0,0,0,0,16000,20000,-4000,-4000
20200212,055570,華通統一98購03,1.30,1.80,1.30,1.66,+0.38,29.69,792000,30,1247490,0,0,0,0,0,0,209000,583000,-374000,-374000
20200212,055571,鴻海統一97購03,1.70,1.91,1.70,1.91,+0.48,33.57,60000,9,108700,0,0,0,0,0,0,25000,35000,-10000,-10000
20200212,055572,鴻海統一98購04,2.50,2.74,2.49,2.74,+0.37,15.61,872000,23,2214570,0,0,0,0,0,0,295000,577000,-282000,-282000
20200212,055573,國巨統一97購06,2.99,3.10,2.99,3.10,+0.26,9.15,85000,7,258450,0,0,0,0,0,0,55000,30000,25000,25000
20200212,055574,美律統一97購01,0.72,0.84,0.72,0.82,+0.17,26.15,425000,46,327260,0,0,0,0,0,0,135000,290000,-155000,-155000
20200212,055575,華新科統一98購01,1.55,1.57,1.51,1.56,+0.04,2.63,295000,15,457370,0,0,0,0,0,0,247000,48000,199000,199000
20200212,055576,嘉晶統一98購01,1.81,2.08,1.81,2.08,0.00,0.00,380000,21,720910,0,0,0,0,0,0,0,380000,-380000,-380000
20200212,055577,晶技統一97購02,0.82,0.82,0.82,0.82,0.00,0.00,1000,1,820,0,0,0,0,0,0,1000,0,1000,1000
20200212,055578,群創統一98購03,,,,,0.00,0.00,0,0,0,0,0,0,0,0,0,0,0,0,0
20200212,055579,健策統一9A購01,1.29,1.39,1.24,1.39,+0.16,13.01,1749000,63,2240960,0,0,0,0,0,0,1133000,576000,557000,557000
20200212,05557P,S&P500中信96售02,,,,,0.00,0.00,0,0,0,0,0,0,0,0,0,0,0,0,0
20200212,055580,南茂統一97購01,0.70,0.75,0.68,0.75,0.00,0.00,413000,23,295730,0,0,0,0,0,0,382000,31000,351000,351000
20200212,055581,和大元大97購04,0.89,0.89,0.89,0.89,-0.03,-3.26,68000,4,60520,0,0,0,0,0,0,65000,3000,62000,62000
20200212,055582,亞德客元大97購01,3.23,3.44,3.20,3.44,-0.04,-1.15,262000,28,864670,0,0,0,0,0,0,262000,163000,99000,99000
20200212,055583,國巨元大97購10,,,,,0.00,0.00,0,0,0,0,0,0,0,0,0,0,0,0,0
20200212,055584,國巨元大97購11,2.03,2.03,1.98,2.01,+0.10,5.24,91000,5,182840,0,0,0,0,0,0,33000,58000,-25000,-25000
20200212,055585,國巨元大98購08,2.30,2.30,2.30,2.30,+0.02,0.88,5000,1,11500,0,0,0,0,0,0,5000,0,5000,5000
20200212,055586,旺宏元大98購06,2.21,2.33,2.14,2.14,-0.09,-4.04,86000,10,193190,0,0,0,0,0,0,86000,8000,78000,78000
20200212,055587,智邦元大97購02,3.71,3.87,3.37,3.48,+0.14,4.19,169000,33,614090,0,0,0,0,0,0,93000,131000,-38000,-38000
20200212,055588,瑞昱元大97購03,1.90,2.13,1.88,2.03,+0.16,8.56,405000,35,813600,0,0,0,0,0,0,330000,97000,233000,233000
20200212,055589,台光電元大98購04,1.60,2.12,1.60,2.12,+0.54,34.18,130000,15,257960,0,0,0,0,0,0,20000,110000,-90000,-90000
20200212,05558P,鴻海麥證96售01,,,,,0.00,0.00,0,0,0,0,0,0,0,0,0,0,0,0,0
20200212,055590,聯發科元大98購02,1.68,1.86,1.67,1.83,+0.30,19.61,981000,63,1749770,0,0,0,0,0,0,853000,664000,189000,189000
20200212,055591,全新元大98購01,1.51,1.73,1.49,1.72,+0.35,25.55,304000,25,490640,0,0,0,0,0,0,143000,228000,-85000,-85000
20200212,055592,奇力新元大97購07,2.75,2.82,2.63,2.82,+0.10,3.68,316000,70,864380,0,0,0,0,0,0,284000,272000,12000,12000
20200212,055593,華新科元大97購10,1.47,1.47,1.39,1.43,+0.02,1.42,218000,18,315980,0,0,0,0,0,0,88000,162000,-74000,-74000
20200212,055594,華新科元大98購02,5.15,5.15,5.00,5.05,+0.10,2.02,83000,18,419350,0,0,0,0,0,0,65000,55000,10000,10000
20200212,055595,宏達電元大98購02,1.23,1.23,1.23,1.23,+0.04,3.36,1000,1,1230,0,0,0,0,0,0,0,1000,-1000,-1000
20200212,055596,新光金元大9B購02,1.05,1.05,1.04,1.05,+0.03,2.94,320000,11,334300,0,0,0,0,0,0,250000,70000,180000,180000
20200212,055597,禾伸堂元大98購02,2.54,2.58,2.45,2.58,+0.12,4.88,95000,15,238040,0,0,0,0,0,0,82000,13000,69000,69000
20200212,055598,欣興元大97購03,1.87,2.14,1.87,2.14,+0.47,28.14,21000,4,41850,0,0,0,0,0,0,21000,0,21000,21000
20200212,055599,TPK元大97購01,0.89,1.00,0.89,0.99,+0.08,8.79,136000,8,128990,0,0,0,0,0,0,111000,75000,36000,36000
20200212,05559P,臺股指麥證96售01,2.08,2.08,2.08,2.08,0.00,0.00,15000,1,31200,15000,0,15000,0,0,0,15000,0,15000,15000
20200212,055600,致伸元大97購02,0.64,0.65,0.62,0.64,+0.04,6.67,723000,15,456770,0,0,0,0,0,0,375000,348000,27000,27000
20200212,055601,茂林元大97購03,2.19,2.27,2.11,2.19,+0.04,1.86,1593000,159,3495900,0,0,0,0,0,0,113000,1494000,-1381000,-1381000
20200212,055602,康控元大97購03,0.75,0.83,0.74,0.83,+0.11,15.28,457000,26,363420,0,0,0,0,0,0,342000,312000,30000,30000
20200212,055603,超眾元大97購04,1.61,1.83,1.61,1.83,+0.14,8.28,181000,22,316020,0,0,0,0,0,0,113000,92000,21000,21000
20200212,055604,訊芯元大98購02,0.93,1.07,0.93,1.05,+0.10,10.53,477000,14,479890,0,0,0,0,0,0,173000,304000,-131000,-131000
20200212,055605,緯穎元大97購02,2.15,2.35,2.04,2.31,+0.10,4.52,655000,38,1451430,0,0,0,0,0,0,559000,243000,316000,316000
20200212,055606,矽創元大97購01,1.12,1.36,1.12,1.36,+0.29,27.1,397000,23,500620,0,0,0,0,0,0,170000,347000,-177000,-177000
20200212,055607,華通康和97購01,0.93,0.93,0.93,0.93,0.00,0.00,2000,2,1860,0,0,0,0,0,0,0,2000,-2000,-2000
20200212,055608,華邦電康和97購01,0.40,0.41,0.40,0.41,0.00,0.00,210000,4,85050,0,0,0,0,0,0,0,210000,-210000,-210000
20200212,055609,旺宏國票99購01,1.74,1.74,1.74,1.74,0.00,0.00,1000,1,1740,0,0,0,0,0,0,1000,0,1000,1000
20200212,05560P,友達兆豐96售01,,,,,0.00,0.00,0,0,0,0,0,0,0,0,0,0,0,0,0
20200212,055610,光磊國票98購01,0.61,0.61,0.59,0.59,-0.02,-3.28,17000,5,10300,0,0,0,0,0,0,17000,0,17000,17000
20200212,055611,燿華國票98購02,0.91,1.07,0.91,1.07,+0.16,17.58,73000,2,76030,0,0,0,0,0,0,13000,60000,-47000,-47000
20200212,055612,台光電國票97購04,2.29,2.91,2.29,2.91,+0.73,33.49,112000,3,285980,0,0,0,0,0,0,0,112000,-112000,-112000
20200212,055613,全新國票98購01,1.99,2.22,1.99,2.22,+0.45,25.42,109000,5,235170,0,0,0,0,0,0,12000,97000,-85000,-85000
20200212,055614,華新科國票97購02,5.05,5.30,4.93,5.15,+0.15,3.0,262000,21,1327900,0,0,0,0,0,0,185000,77000,108000,108000
20200212,055615,宏達電國票99購02,0.88,0.88,0.88,0.88,+0.05,6.02,6000,1,5280,0,0,0,0,0,0,6000,0,6000,6000
20200212,055616,智原國票97購03,0.95,1.01,0.95,1.01,+0.08,8.6,134000,8,132040,0,0,0,0,0,0,41000,93000,-52000,-52000
20200212,055617,TPK國票98購04,0.84,0.98,0.83,0.98,+0.09,10.11,161000,17,149630,0,0,0,0,0,0,36000,125000,-89000,-89000
20200212,055618,麗豐國票98購01,1.06,1.06,1.06,1.06,+0.08,8.16,5000,1,5300,0,0,0,0,0,0,0,5000,-5000,-5000
20200212,055619,同欣電國票98購02,2.81,2.81,2.81,2.81,+0.05,1.81,60000,10,168600,0,0,0,0,0,0,60000,0,60000,60000
20200212,05561P,大立光兆豐96售02,,,,,0.00,0.00,0,0,0,0,0,0,0,0,0,0,0,0,0
20200212,055620,樺漢國票98購01,2.55,2.58,2.53,2.58,+0.09,3.61,69000,7,176320,0,0,0,0,0,0,30000,39000,-9000,-9000
20200212,055621,國巨國泰98購03,5.80,5.95,5.50,5.85,+0.50,9.35,396000,12,2235600,0,0,0,0,0,0,190000,206000,-16000,-16000
20200212,055622,群創國泰99購01,,,,,0.00,0.00,0,0,0,0,0,0,0,0,0,0,0,0,0
20200212,055623,貿聯國泰99購01,1.78,1.97,1.77,1.97,+0.23,13.22,85000,10,157100,0,0,0,0,0,0,25000,65000,-40000,-40000
20200212,055624,聯發科富邦99購07,1.16,1.23,1.16,1.22,+0.15,14.02,535000,19,640870,0,0,0,0,0,0,454000,188000,266000,266000
20200212,055625,亞光富邦98購01,0.20,0.21,0.20,0.21,+0.02,10.53,89000,7,18600,0,0,0,0,0,0,16000,73000,-57000,-57000
20200212,055626,力山永豐97購01,,,,,0.00,0.00,0,0,0,0,0,0,0,0,0,0,0,0,0
20200212,055627,亞德客永豐97購02,1.50,1.67,1.50,1.66,-0.01,-0.6,436000,21,691290,0,0,0,0,0,0,368000,68000,300000,300000
20200212,055628,旺宏永豐97購01,1.48,1.55,1.44,1.46,-0.03,-2.01,51000,7,75000,0,0,0,0,0,0,31000,23000,8000,8000
20200212,055629,華新科永豐97購04,0.77,0.78,0.71,0.78,+0.04,5.41,750000,26,561860,0,0,0,0,0,0,575000,175000,400000,400000
20200212,05562P,鴻海元大96售16,2.04,2.04,1.87,1.87,-0.26,-12.21,65000,5,130620,0,0,0,0,0,0,58000,7000,51000,51000
20200212,055630,聯詠永豐97購02,0.48,0.53,0.48,0.52,+0.09,20.93,201000,8,101320,0,0,0,0,0,0,70000,131000,-61000,-61000
20200212,055631,創意永豐98購01,0.88,0.97,0.87,0.92,-0.15,-14.02,394000,22,352050,0,0,0,0,0,0,218000,160000,58000,58000
20200212,055632,群創永豐98購01,0.97,0.98,0.97,0.98,+0.01,1.03,16000,2,15620,0,0,0,0,0,0,16000,0,16000,16000
20200212,055633,牧德永豐97購02,1.23,1.23,1.07,1.07,-0.07,-6.14,221000,4,251430,0,0,0,0,0,0,115000,106000,9000,9000
20200212,055634,訊芯永豐97購02,0.38,0.42,0.38,0.42,+0.07,20.0,134000,6,53880,0,0,0,0,0,0,90000,44000,46000,46000
20200212,055635,緯穎永豐97購01,1.21,1.33,1.21,1.33,+0.13,10.83,192000,3,236760,0,0,0,0,0,0,124000,68000,56000,56000
20200212,055636,元油反元富97購02,1.72,1.72,1.72,1.72,0.00,0.00,4000,1,6880,0,0,0,0,0,0,4000,0,4000,4000
20200212,055637,亞德客元富97購01,,,,,0.00,0.00,0,0,0,0,0,0,0,0,0,0,0,0,0
20200212,055638,上銀元富97購01,1.42,1.42,1.34,1.35,-0.02,-1.46,262000,11,359610,0,0,0,0,0,0,206000,75000,131000,131000
20200212,055639,上銀元富97購02,2.32,2.35,2.25,2.28,+0.01,0.44,462000,16,1063480,0,0,0,0,0,0,294000,207000,87000,87000
20200212,05563P,台積電元大97售07,0.53,0.54,0.50,0.50,-0.08,-13.79,190000,18,98200,0,0,0,0,0,0,20000,170000,-150000,-150000
20200212,055640,鴻海元富97購03,1.40,1.60,1.38,1.60,+0.29,22.14,210000,8,297800,0,0,0,0,0,0,180000,20000,160000,160000
20200212,055641,鴻海元富97購04,1.66,1.90,1.66,1.90,+0.33,21.02,87000,9,155140,0,0,0,0,0,0,20000,67000,-47000,-47000
20200212,055642,廣宇元富97購01,1.72,1.72,1.72,1.72,0.00,0.00,20000,2,34400,0,0,0,0,0,0,0,20000,-20000,-20000
20200212,055643,宏碁元富97購01,0.31,0.33,0.31,0.33,0.00,0.00,15000,2,4850,0,0,0,0,0,0,10000,5000,5000,5000
20200212,055644,致茂元富97購01,1.00,1.14,1.00,1.14,+0.18,18.75,3213000,93,3383470,0,0,0,0,0,0,2127000,486000,1641000,1641000
20200212,055645,技嘉元富97購01,2.33,2.44,2.19,2.31,+0.01,0.43,1997000,119,4664250,0,0,0,0,0,0,1307000,665000,642000,642000
20200212,055646,漢唐元富97購01,0.73,0.73,0.70,0.70,+0.05,7.69,16000,2,11380,0,0,0,0,0,0,0,16000,-16000,-16000
20200212,055647,義隆元富97購01,1.20,1.20,1.12,1.12,+0.19,20.43,18000,12,21000,0,0,0,0,0,0,18000,0,18000,18000
20200212,055648,可成元富97購01,1.49,1.58,1.49,1.58,+0.17,12.06,182000,8,284040,0,0,0,0,0,0,10000,172000,-162000,-162000
20200212,055649,華新科元富97購03,2.43,2.46,2.32,2.35,+0.06,2.62,1025000,45,2412420,0,0,0,0,0,0,908000,767000,141000,141000
20200212,05564P,玉晶光元大97售02,0.48,0.48,0.47,0.47,-0.06,-11.32,169000,11,79670,0,0,0,0,0,0,0,169000,-169000,-169000
20200212,055650,華新科元富98購01,1.64,1.66,1.56,1.61,+0.05,3.21,323000,17,514780,0,0,0,0,0,0,291000,128000,163000,163000
20200212,055651,富邦金元富97購01,1.62,1.65,1.59,1.65,+0.16,10.74,75000,6,121850,0,0,0,0,0,0,35000,40000,-5000,-5000
20200212,055652,聯詠元富01購01,1.56,1.56,1.54,1.54,+0.11,7.69,290000,3,450600,0,0,0,0,0,0,290000,0,290000,290000
20200212,055653,聯詠元富01購02,1.58,1.59,1.49,1.53,+0.09,6.25,280000,7,440100,0,0,0,0,0,0,250000,30000,220000,220000
20200212,055654,景碩元富97購01,1.91,2.31,1.82,2.07,+0.23,12.5,1278000,118,2616080,0,0,0,0,0,0,302000,1101000,-799000,-799000
20200212,055655,群創元富99購07,0.79,0.79,0.77,0.78,-0.02,-2.5,409000,15,319670,0,0,0,0,0,0,94000,315000,-221000,-221000
20200212,055656,新唐元富97購01,,,,,0.00,0.00,0,0,0,0,0,0,0,0,0,0,0,0,0
20200212,055657,超眾元富97購02,1.38,1.48,1.33,1.47,+0.06,4.26,630000,29,882480,0,0,0,0,0,0,370000,260000,110000,110000
20200212,055658,南電元富97購01,1.35,1.60,1.29,1.56,+0.20,14.71,369000,49,533720,0,0,0,0,0,0,181000,180000,1000,1000
20200212,055659,百和元富97購01,0.83,0.83,0.83,0.83,-0.04,-4.6,50000,1,41500,0,0,0,0,0,0,0,50000,-50000,-50000
20200212,05565P,鎧勝元大96售01,2.49,2.49,2.49,2.49,-0.03,-1.19,1000,1,2490,0,0,0,0,0,0,1000,0,1000,1000
20200212,055660,台光電兆豐97購01,0.74,0.94,0.74,0.91,+0.19,26.39,892000,45,760140,0,0,0,0,0,0,120000,772000,-652000,-652000
20200212,055661,亞德客中信98購01,0.76,0.84,0.73,0.84,0.00,0.00,290000,22,229800,0,0,0,0,0,0,180000,110000,70000,70000
20200212,055662,上銀中信99購01,1.75,1.75,1.68,1.69,+0.06,3.68,535000,26,912930,0,0,0,0,0,0,463000,72000,391000,391000
20200212,055663,崇越中信97購01,0.53,0.56,0.51,0.55,0.00,0.00,458000,10,246770,0,0,0,0,0,0,70000,388000,-318000,-318000
20200212,055664,和大群益98購02,1.11,1.15,1.07,1.15,+0.02,1.77,105000,6,117600,0,0,0,0,0,0,0,105000,-105000,-105000
20200212,055665,亞德客群益97購01,,,,,0.00,0.00,0,0,0,0,0,0,0,0,0,0,0,0,0
20200212,055666,鴻海群益97購05,,,,,0.00,0.00,0,0,0,0,0,0,0,0,0,0,0,0,0
20200212,055667,致茂群益98購01,2.49,2.88,2.49,2.88,+0.54,23.08,363000,36,962300,0,0,0,0,0,0,108000,255000,-147000,-147000
20200212,055668,欣興群益97購01,,,,,0.00,0.00,0,0,0,0,0,0,0,0,0,0,0,0,0
20200212,055669,緯穎群益97購02,2.11,2.48,2.11,2.42,+0.14,6.14,347000,21,826060,0,0,0,0,0,0,86000,337000,-251000,-251000
20200212,05566P,景碩永豐96售01,0.90,0.91,0.80,0.80,-0.13,-13.98,26000,4,22640,0,0,0,0,0,0,26000,0,26000,26000
20200212,055670,矽創群益98購02,1.81,2.21,1.81,2.21,+0.46,26.29,401000,31,792490,0,0,0,0,0,0,124000,277000,-153000,-153000
20200212,055671,世紀鋼群益97購01,1.60,1.64,1.58,1.60,0.00,0.00,274000,17,445160,0,0,0,0,0,0,263000,16000,247000,247000
20200212,055672,國巨日盛97購02,4.35,4.50,4.26,4.50,+0.39,9.49,153000,37,668080,0,0,0,0,0,0,112000,41000,71000,71000
20200212,055673,旺宏日盛97購01,1.65,1.67,1.63,1.67,+0.07,4.38,21000,3,34530,0,0,0,0,0,0,12000,9000,3000,3000
20200212,055674,南港康和97購02,0.53,0.62,0.53,0.62,+0.06,10.71,220000,8,129260,0,0,0,0,0,0,98000,122000,-24000,-24000
20200212,055675,亞德客凱基97購02,1.00,1.08,0.98,1.08,+0.02,1.89,491000,18,501530,0,0,0,0,0,0,491000,0,491000,491000
20200212,055676,亞德客凱基97購03,1.12,1.26,1.12,1.22,-0.04,-3.17,449000,26,545160,0,0,0,0,0,0,449000,130000,319000,319000
20200212,055677,喬山凱基97購01,1.25,1.25,1.23,1.23,+0.12,10.81,43000,2,52950,0,0,0,0,0,0,40000,3000,37000,37000
20200212,055678,上銀凱基97購02,2.03,2.03,2.03,2.03,0.00,0.00,5000,1,10150,0,0,0,0,0,0,0,5000,-5000,-5000
20200212,055679,華通凱基99購01,0.77,0.77,0.74,0.76,+0.25,49.02,247000,6,188740,0,0,0,0,0,0,212000,35000,177000,177000
20200212,05567P,致伸群益96售01,,,,,0.00,0.00,0,0,0,0,0,0,0,0,0,0,0,0,0
20200212,055680,美律凱基99購01,0.86,0.96,0.86,0.96,+0.24,33.33,15000,4,13900,0,0,0,0,0,0,5000,10000,-5000,-5000
20200212,055681,奇鋐凱基98購03,0.56,0.63,0.56,0.62,+0.04,6.9,165000,8,99250,0,0,0,0,0,0,130000,35000,95000,95000
20200212,055682,智原凱基98購02,,,,,0.00,0.00,0,0,0,0,0,0,0,0,0,0,0,0,0
20200212,055683,晶技凱基99購01,0.47,0.51,0.19,0.51,+0.05,10.87,214000,6,97880,0,0,0,0,0,0,202000,12000,190000,190000
20200212,055684,京鼎凱基97購01,1.38,1.46,1.34,1.46,+0.34,30.36,183000,9,251780,0,0,0,0,0,0,145000,138000,7000,7000
20200212,055685,日月光凱基97購02,,,,,0.00,0.00,0,0,0,0,0,0,0,0,0,0,0,0,0
20200212,055686,致伸凱基97購02,,,,,0.00,0.00,0,0,0,0,0,0,0,0,0,0,0,0,0
20200212,055687,瀚宇博凱基97購01,1.19,1.20,1.19,1.20,+0.17,16.5,20000,2,23900,0,0,0,0,0,0,20000,10000,10000,10000
20200212,055688,力成凱基98購02,1.66,1.92,1.66,1.87,+0.34,22.22,770000,30,1372400,0,0,0,0,0,0,525000,139000,386000,386000
20200212,055689,台郡凱基99購01,1.55,1.55,1.54,1.54,+0.53,52.48,2000,2,3090,0,0,0,0,0,0,1000,0,1000,1000
20200212,05568P,台積電統一96售03,0.60,0.60,0.60,0.60,-0.05,-7.69,125000,1,75000,0,0,0,0,0,0,125000,0,125000,125000
20200212,055690,矽力凱基97購02,,,,,0.00,0.00,0,0,0,0,0,0,0,0,0,0,0,0,0
20200212,055691,訊芯凱基97購02,0.70,0.70,0.70,0.70,+0.10,16.67,60000,4,42000,0,0,0,0,0,0,50000,60000,-10000,-10000
20200212,055692,緯穎凱基97購03,1.23,1.36,1.23,1.36,+0.03,2.26,40000,3,50350,0,0,0,0,0,0,0,40000,-40000,-40000
20200212,055693,南茂凱基97購01,0.86,0.92,0.86,0.90,+0.03,3.45,122000,11,110120,0,0,0,0,0,0,122000,120000,2000,2000
20200212,055694,光罩國票98購01,1.43,1.57,1.42,1.52,+0.13,9.35,479000,34,710130,0,0,0,0,0,0,376000,119000,257000,257000
20200212,055695,大毅國票98購03,6.30,6.35,6.05,6.05,-0.90,-12.95,65000,4,402100,0,0,0,0,0,0,55000,10000,45000,45000
20200212,055696,華新科國票98購01,2.98,2.98,2.75,2.82,-0.02,-0.7,124000,11,357820,0,0,0,0,0,0,73000,51000,22000,22000
20200212,055697,牧德國票98購01,2.75,2.87,2.56,2.56,-0.23,-8.24,180000,12,501130,0,0,0,0,0,0,132000,48000,84000,84000
20200212,055698,茂林國票98購03,1.50,1.56,1.47,1.52,+0.05,3.4,54000,10,83090,0,0,0,0,0,0,44000,10000,34000,34000
20200212,055699,康控國票97購04,1.10,1.34,1.06,1.26,+0.21,20.0,271000,18,323710,0,0,0,0,0,0,163000,108000,55000,55000
20200212,05569P,漢唐統一97售01,0.98,0.98,0.98,0.98,-0.05,-4.85,18000,1,17640,0,0,0,0,0,0,18000,0,18000,18000
20200212,055700,緯穎國泰98購02,2.13,2.34,2.05,2.30,+0.12,5.5,345000,23,785480,0,0,0,0,0,0,45000,289000,-244000,-244000
20200212,055701,亞德客富邦99購01,1.11,1.21,1.09,1.18,-0.01,-0.84,2253000,69,2629780,0,0,0,0,0,0,2178000,178000,2000000,2000000
20200212,055702,美律富邦98購01,0.21,0.26,0.21,0.25,+0.06,31.58,197000,15,46850,0,0,0,0,0,0,45000,152000,-107000,-107000
20200212,055703,緯穎富邦98購01,0.45,0.49,0.42,0.49,+0.03,6.52,776000,39,361300,0,0,0,0,0,0,615000,125000,490000,490000
20200212,055704,亞德客永豐97購04,0.73,0.83,0.73,0.82,-0.05,-5.75,437000,22,344360,0,0,0,0,0,0,437000,0,437000,437000
20200212,055705,微星永豐97購01,1.29,1.29,1.16,1.18,-0.01,-0.84,248000,10,297430,0,0,0,0,0,0,25000,213000,-188000,-188000
20200212,055706,大立光永豐97購03,0.42,0.46,0.42,0.46,+0.07,17.95,150000,4,67300,0,0,0,0,0,0,150000,0,150000,150000
20200212,055707,聯鈞永豐98購01,0.84,0.93,0.84,0.93,0.00,0.00,283000,9,249710,0,0,0,0,0,0,84000,199000,-115000,-115000
20200212,055708,茂林永豐97購02,0.85,0.88,0.82,0.88,+0.05,6.02,216000,11,181130,0,0,0,0,0,0,121000,81000,40000,40000
20200212,055709,深中小元大97購03,0.69,0.69,0.69,0.69,0.00,0.00,77000,2,53130,0,0,0,0,0,0,0,77000,-77000,-77000
20200212,05570P,聯發科統一96售04,2.42,2.42,2.37,2.37,-0.39,-14.13,37000,6,88200,0,0,0,0,0,0,0,37000,-37000,-37000
20200212,055710,亞德客元大97購03,2.25,2.43,2.12,2.36,+0.04,1.72,203000,20,471280,0,0,0,0,0,0,181000,106000,75000,75000
20200212,055711,上銀元大97購04,2.84,2.84,2.68,2.72,+0.09,3.42,238000,25,658400,0,0,0,0,0,0,199000,174000,25000,25000
20200212,055712,金寶元大97購02,1.65,1.72,1.57,1.72,+0.04,2.38,436000,19,707500,0,0,0,0,0,0,396000,76000,320000,320000
20200212,055713,國巨元大98購09,5.85,5.95,5.70,5.95,+0.40,7.21,144000,7,826450,0,0,0,0,0,0,123000,90000,33000,33000
20200212,055714,智邦元大97購03,2.48,2.61,2.25,2.25,+0.05,2.27,142000,27,355720,0,0,0,0,0,0,91000,83000,8000,8000
20200212,055715,智邦元大97購04,4.61,4.86,4.17,4.32,+0.18,4.35,106000,33,485030,0,0,0,0,0,0,73000,87000,-14000,-14000
20200212,055716,致茂元大97購01,2.39,2.81,2.39,2.78,+0.49,21.4,384000,26,998430,0,0,0,0,0,0,185000,218000,-33000,-33000
20200212,055717,聯發科元大97購19,1.41,1.58,1.36,1.53,+0.32,26.45,337000,24,493920,0,0,0,0,0,0,297000,245000,52000,52000
20200212,055718,可成元大97購02,1.33,1.49,1.33,1.49,+0.23,18.25,454000,23,644570,0,0,0,0,0,0,231000,324000,-93000,-93000
20200212,055719,可成元大97購03,2.51,2.79,2.51,2.79,+0.46,19.74,183000,13,477850,0,0,0,0,0,0,105000,183000,-78000,-78000
20200212,05571P,大立光統一96售03,,,,,0.00,0.00,0,0,0,0,0,0,0,0,0,0,0,0,0
20200212,055720,宏達電元大97購05,0.94,0.97,0.94,0.97,+0.06,6.59,81000,2,78540,0,0,0,0,0,0,80000,1000,79000,79000
20200212,055721,聯詠元大97購04,1.18,1.30,1.18,1.28,+0.19,17.43,93000,10,113320,0,0,0,0,0,0,58000,37000,21000,21000
20200212,055722,聯鈞元大97購03,1.36,1.61,1.36,1.61,+0.36,28.8,1550000,37,2181050,0,0,0,0,0,0,218000,1345000,-1127000,-1127000
20200212,055723,康控元大97購04,0.67,0.75,0.67,0.75,+0.09,13.64,343000,17,241160,0,0,0,0,0,0,148000,233000,-85000,-85000
20200212,055724,祥碩元大97購03,8.80,9.15,8.80,9.00,+0.75,9.09,31000,4,276750,0,0,0,0,0,0,25000,6000,19000,19000
20200212,055725,嘉聯益元大98購03,1.10,1.16,1.10,1.12,+0.06,5.66,176000,6,199680,0,0,0,0,0,0,76000,100000,-24000,-24000
20200212,055726,台表科元大98購03,2.12,2.26,2.07,2.26,+0.19,9.18,378000,41,822420,0,0,0,0,0,0,175000,224000,-49000,-49000
20200212,055727,矽力元大97購02,3.64,3.84,3.64,3.84,+0.73,23.47,4000,2,15160,0,0,0,0,0,0,3000,1000,2000,2000
20200212,055728,緯穎元大97購03,1.58,1.75,1.48,1.72,+0.10,6.17,281000,26,452720,0,0,0,0,0,0,190000,97000,93000,93000
20200212,055729,金寶元富99購01,1.23,1.30,1.21,1.30,+0.02,1.56,347000,37,424060,0,0,0,0,0,0,179000,162000,17000,17000
20200212,05572P,群創統一96售02,,,,,0.00,0.00,0,0,0,0,0,0,0,0,0,0,0,0,0
20200212,055730,建準元富97購02,,,,,0.00,0.00,0,0,0,0,0,0,0,0,0,0,0,0,0
20200212,055731,美律元富97購01,0.85,0.98,0.85,0.98,+0.22,28.95,263000,29,240100,0,0,0,0,0,0,30000,233000,-203000,-203000
20200212,055732,全新元富9A購01,1.22,1.40,1.22,1.40,+0.31,28.44,225000,19,285640,0,0,0,0,0,0,92000,133000,-41000,-41000
20200212,055733,奇力新元富97購01,1.42,1.47,1.35,1.45,+0.04,2.84,1238000,93,1763970,0,0,0,0,0,0,516000,815000,-299000,-299000
20200212,055734,奇力新元富97購02,1.03,1.04,0.96,1.04,+0.04,4.0,591000,54,596280,0,0,0,0,0,0,243000,348000,-105000,-105000
20200212,055735,宏達電元富98購01,,,,,0.00,0.00,0,0,0,0,0,0,0,0,0,0,0,0,0
20200212,055736,宏達電元富99購01,0.75,0.75,0.75,0.75,0.00,0.00,175000,1,131250,0,0,0,0,0,0,175000,0,175000,175000
20200212,055737,開發金元富97購01,0.65,0.65,0.65,0.65,-0.02,-2.99,34000,1,22100,0,0,0,0,0,0,34000,0,34000,34000
20200212,055738,玉山金元富97購01,2.88,2.88,2.86,2.86,+0.02,0.7,250000,6,715400,0,0,0,0,0,0,20000,230000,-210000,-210000
20200212,055739,健鼎元富97購01,0.69,0.94,0.69,0.91,+0.31,51.67,659000,106,577400,0,0,0,0,0,0,49000,637000,-588000,-588000
20200212,05573P,仁寶元富96售02,1.22,1.22,1.19,1.19,-0.04,-3.25,398000,26,482140,0,0,0,0,0,0,6000,392000,-386000,-386000
20200212,055740,智易元富97購01,0.61,0.73,0.61,0.73,0.00,0.00,229000,46,155920,0,0,0,0,0,0,0,229000,-229000,-229000
20200212,055741,健策元富97購01,1.50,1.58,1.40,1.58,+0.18,12.86,363000,35,529430,0,0,0,0,0,0,300000,211000,89000,89000
20200212,055742,健策元富97購02,0.84,0.90,0.76,0.90,+0.16,21.62,501000,39,400870,0,0,0,0,0,0,458000,43000,415000,415000
20200212,055743,TPK元富98購01,0.50,0.56,0.49,0.56,+0.05,9.8,462000,22,243530,0,0,0,0,0,0,216000,246000,-30000,-30000
20200212,055744,茂林元富97購02,1.60,1.65,1.55,1.60,+0.07,4.58,1529000,49,2452550,0,0,0,0,0,0,135000,1394000,-1259000,-1259000
20200212,055745,臻鼎元富97購01,1.10,1.22,0.92,0.92,+0.09,10.84,218000,26,235910,0,0,0,0,0,0,20000,198000,-178000,-178000
20200212,055746,同欣電元富97購01,1.76,1.99,1.73,1.96,+0.23,13.29,439000,69,836310,0,0,0,0,0,0,210000,229000,-19000,-19000
20200212,055747,康舒元富97購01,1.45,1.45,1.44,1.44,+0.05,3.6,30000,3,43400,0,0,0,0,0,0,0,30000,-30000,-30000
20200212,055748,GIS元富97購01,0.73,0.77,0.73,0.75,+0.05,7.14,88000,16,65990,0,0,0,0,0,0,10000,88000,-78000,-78000
20200212,055749,智邦永昌9C購01,,,,,0.00,0.00,0,0,0,0,0,0,0,0,0,0,0,0,0
20200212,05574P,英業達元富96售01,1.08,1.09,1.08,1.09,-0.01,-0.91,79000,7,85610,0,0,0,0,0,0,0,79000,-79000,-79000
20200212,055750,瑞昱永昌9C購01,,,,,0.00,0.00,0,0,0,0,0,0,0,0,0,0,0,0,0
20200212,055751,南亞科永昌9C購01,,,,,0.00,0.00,0,0,0,0,0,0,0,0,0,0,0,0,0
20200212,055752,臺股指永昌97購01,,,,,0.00,0.00,0,0,0,0,0,0,0,0,0,0,0,0,0
20200212,055753,貿聯第一98購01,0.48,0.50,0.48,0.50,+0.04,8.7,4000,4,1980,0,0,0,0,0,0,0,4000,-4000,-4000
20200212,055754,和大兆豐97購01,0.60,0.62,0.59,0.62,0.00,0.00,50000,4,30100,0,0,0,0,0,0,20000,30000,-10000,-10000
20200212,055755,禾伸堂兆豐97購02,1.94,2.02,1.89,2.02,+0.09,4.66,251000,12,481210,0,0,0,0,0,0,26000,225000,-199000,-199000
20200212,055756,臺股指兆豐97購01,,,,,0.00,0.00,0,0,0,0,0,0,0,0,0,0,0,0,0
20200212,055757,大成鋼群益99購01,0.54,0.54,0.54,0.54,0.00,0.00,11000,1,5940,0,0,0,0,0,0,0,11000,-11000,-11000
20200212,055758,旺宏群益97購01,3.12,3.15,3.11,3.15,-0.04,-1.25,14000,4,43820,0,0,0,0,0,0,5000,9000,-4000,-4000
20200212,055759,技嘉群益98購02,1.91,1.91,1.70,1.79,-0.02,-1.1,469000,45,850530,0,0,0,0,0,0,193000,288000,-95000,-95000
20200212,05575P,玉晶光元富96售01,0.73,0.75,0.68,0.68,-0.14,-17.07,128000,7,90040,0,0,0,0,0,0,0,128000,-128000,-128000
20200212,055760,新日興群益98購02,2.34,2.40,2.24,2.26,-0.17,-7.0,680000,51,1573320,0,0,0,0,0,0,489000,330000,159000,159000
20200212,055761,創意群益97購01,1.92,2.07,1.70,1.95,-0.33,-14.47,519000,54,952190,0,20000,-20000,0,0,0,326000,333000,-7000,-27000
20200212,055762,智伸科群益97購01,1.38,1.38,1.35,1.35,+0.01,0.75,199000,3,271680,0,0,0,0,0,0,199000,0,199000,199000
20200212,055763,鎧勝群益97購01,0.78,0.83,0.78,0.83,+0.06,7.79,85000,2,66800,0,0,0,0,0,0,85000,0,85000,85000
20200212,055764,臺股指群益97購02,2.75,3.03,2.73,2.97,+0.29,10.82,94000,13,266130,0,0,0,0,0,0,28000,66000,-38000,-38000
20200212,055765,臺股指群益97購03,,,,,0.00,0.00,0,0,0,0,0,0,0,0,0,0,0,0,0
20200212,055766,臺股指群益97購04,,,,,0.00,0.00,0,0,0,0,0,0,0,0,0,0,0,0,0
20200212,055767,臺股指群益97購05,,,,,0.00,0.00,0,0,0,0,0,0,0,0,0,0,0,0,0
20200212,055768,臺股指群益97購06,0.91,0.92,0.91,0.92,+0.05,5.75,110000,2,101100,0,0,0,0,0,0,110000,0,110000,110000
20200212,055769,智伸科中信97購01,,,,,0.00,0.00,0,0,0,0,0,0,0,0,0,0,0,0,0
20200212,05576P,群創日盛99售02,0.26,0.26,0.26,0.26,0.00,0.00,16000,1,4160,0,0,0,0,0,0,16000,0,16000,16000
20200212,055770,欣興麥證97購01,0.71,0.85,0.71,0.84,+0.20,31.25,36000,7,28910,0,36000,-36000,0,0,0,0,36000,-36000,-36000
20200212,055771,台積電日盛97購04,0.77,0.81,0.77,0.81,+0.05,6.58,994000,7,794030,0,0,0,0,0,0,369000,625000,-256000,-256000
20200212,055772,致茂凱基97購01,0.81,0.90,0.81,0.90,0.00,0.00,62000,8,53540,0,0,0,0,0,0,4000,58000,-54000,-54000
20200212,055773,瑞昱凱基97購03,1.70,1.88,1.70,1.82,+0.33,22.15,76000,6,141740,0,0,0,0,0,0,76000,8000,68000,68000
20200212,055774,台光電凱基97購02,0.77,0.80,0.77,0.80,+0.17,26.98,40000,6,31720,0,0,0,0,0,0,20000,20000,0,0
20200212,055775,友達凱基9A購01,1.41,1.41,1.41,1.41,-0.08,-5.37,20000,2,28200,0,0,0,0,0,0,20000,0,20000,20000
20200212,055776,宏達電凱基98購02,0.82,0.82,0.81,0.82,+0.06,7.89,50000,6,40990,0,0,0,0,0,0,50000,0,50000,50000
20200212,055777,冠德凱基97購01,0.49,0.49,0.49,0.49,+0.03,6.52,32000,3,15680,0,0,0,0,0,0,32000,0,32000,32000
20200212,055778,美食凱基97購01,0.39,0.47,0.39,0.44,0.00,0.00,436000,11,187060,0,0,0,0,0,0,60000,376000,-316000,-316000
20200212,055779,國泰金凱基97購02,1.20,1.24,1.15,1.24,+0.10,8.77,19000,9,23010,0,0,0,0,0,0,9000,10000,-1000,-1000
20200212,05577P,上銀凱基96售02,,,,,0.00,0.00,0,0,0,0,0,0,0,0,0,0,0,0,0
20200212,055780,禾伸堂凱基99購01,2.64,2.64,2.57,2.57,-0.05,-1.91,8000,4,20770,0,0,0,0,0,0,8000,0,8000,8000
20200212,055781,聯詠凱基98購01,1.51,1.53,1.46,1.53,+0.24,18.6,193000,5,282670,0,0,0,0,0,0,3000,192000,-189000,-189000
20200212,055782,新日興凱基99購01,1.59,1.62,1.57,1.62,-0.04,-2.41,68000,10,108140,0,0,0,0,0,0,64000,4000,60000,60000
20200212,055783,群創凱基99購03,0.71,0.71,0.71,0.71,0.00,0.00,10000,1,7100,0,0,0,0,0,0,10000,0,10000,10000
20200212,055784,TPK凱基97購02,,,,,0.00,0.00,0,0,0,0,0,0,0,0,0,0,0,0,0
20200212,055785,祥碩凱基97購02,4.79,5.50,4.75,5.50,+1.19,27.61,33000,11,170090,0,0,0,0,0,0,22000,11000,11000,11000
20200212,055786,彩晶凱基99購02,0.38,0.38,0.38,0.38,0.00,0.00,2000,1,760,0,0,0,0,0,0,0,2000,-2000,-2000
20200212,055787,聯茂凱基99購01,1.49,1.73,1.49,1.71,+0.40,30.53,36000,4,57130,0,0,0,0,0,0,20000,16000,4000,4000
20200212,055788,緯穎凱基97購04,2.22,2.41,2.22,2.41,+0.08,3.43,40000,3,89000,0,0,0,0,0,0,39000,1000,38000,38000
20200212,055789,台虹凱基97購01,0.49,0.49,0.49,0.49,0.00,0.00,1000,1,490,0,0,0,0,0,0,0,1000,-1000,-1000
20200212,05578P,鴻海凱基96售11,,,,,0.00,0.00,0,0,0,0,0,0,0,0,0,0,0,0,0
20200212,055790,南電凱基97購01,0.76,1.00,0.76,1.00,+0.19,23.46,254000,37,223410,0,0,0,0,0,0,126000,99000,27000,27000
20200212,055791,臺股指凱基97購14,1.95,2.02,1.95,2.02,+0.14,7.45,13000,2,25420,0,0,0,0,0,0,13000,0,13000,13000
20200212,055792,臺股指凱基97購15,1.12,1.22,1.12,1.22,+0.13,11.93,33000,2,37060,0,0,0,0,0,0,32000,1000,31000,31000
20200212,055793,臺股指凱基97購16,,,,,0.00,0.00,0,0,0,0,0,0,0,0,0,0,0,0,0
20200212,055794,聯發科國泰99購01,0.62,0.65,0.62,0.65,+0.14,27.45,210000,5,132900,0,0,0,0,0,0,200000,10000,190000,190000
20200212,055795,茂林國泰98購01,1.52,1.52,1.52,1.52,+0.09,6.29,10000,1,15200,0,0,0,0,0,0,10000,0,10000,10000
20200212,055796,南電國泰98購01,0.99,1.15,0.96,1.15,+0.17,17.35,129000,21,129510,0,0,0,0,0,0,129000,0,129000,129000
20200212,055797,華通富邦98購01,0.37,0.37,0.37,0.37,+0.09,32.14,32000,3,11840,0,0,0,0,0,0,2000,30000,-28000,-28000
20200212,055798,聯茂富邦98購01,0.53,0.70,0.53,0.64,+0.14,28.0,1053000,33,639980,0,0,0,0,0,0,466000,573000,-107000,-107000
20200212,055799,致茂永豐97購02,0.42,0.53,0.42,0.52,+0.10,23.81,821000,45,393680,0,0,0,0,0,0,103000,716000,-613000,-613000
20200212,05579P,友達凱基98售03,0.19,0.19,0.18,0.18,0.00,0.00,32000,2,5780,0,0,0,0,0,0,32000,0,32000,32000
20200212,055800,欣興永豐97購02,0.44,0.66,0.44,0.65,+0.19,41.3,298000,10,180760,0,0,0,0,0,0,33000,265000,-232000,-232000
20200212,055801,景碩永豐97購02,1.12,1.40,1.05,1.23,+0.18,17.14,362000,59,432240,0,0,0,0,0,0,83000,279000,-196000,-196000
20200212,055802,新日興永豐97購01,0.85,0.85,0.80,0.82,-0.03,-3.53,1037000,34,851030,0,0,0,0,0,0,714000,323000,391000,391000
20200212,055803,鎧勝永豐97購01,,,,,0.00,0.00,0,0,0,0,0,0,0,0,0,0,0,0,0
20200212,055804,祥碩永豐97購02,3.14,3.40,3.08,3.40,+0.53,18.47,219000,18,712150,0,0,0,0,0,0,117000,72000,45000,45000
20200212,055805,矽力永豐97購01,0.56,0.59,0.56,0.59,+0.07,13.46,117000,6,67680,0,0,0,0,0,0,32000,85000,-53000,-53000
20200212,055806,致新永豐97購02,0.55,0.58,0.54,0.58,+0.01,1.75,415000,14,232860,0,0,0,0,0,0,347000,68000,279000,279000
20200212,055807,勤誠永豐97購01,0.98,0.98,0.92,0.97,+0.01,1.04,86000,8,81520,0,0,0,0,0,0,76000,10000,66000,66000
20200212,055808,世紀鋼永豐97購01,0.58,0.61,0.58,0.58,-0.07,-10.77,227000,14,135210,0,0,0,0,0,0,159000,68000,91000,91000
20200212,055809,T50反1國票98購02,,,,,0.00,0.00,0,0,0,0,0,0,0,0,0,0,0,0,0
20200212,05580P,美律凱基96售03,,,,,0.00,0.00,0,0,0,0,0,0,0,0,0,0,0,0,0
20200212,055810,T50反1國票99購01,,,,,0.00,0.00,0,0,0,0,0,0,0,0,0,0,0,0,0
20200212,055811,國巨國票98購05,3.92,4.05,3.92,4.05,+0.23,6.02,6000,4,23920,0,0,0,0,0,0,5000,1000,4000,4000
20200212,055812,台積電國票99購02,1.34,1.41,1.30,1.41,+0.14,11.02,105000,7,145070,0,0,0,0,0,0,85000,20000,65000,65000
20200212,055813,聯發科國票98購04,1.21,1.31,1.21,1.31,0.00,0.00,6000,2,7360,0,0,0,0,0,0,0,6000,-6000,-6000
20200212,055814,晶豪科國票97購02,1.79,1.84,1.79,1.83,0.00,0.00,42000,6,76420,0,0,0,0,0,0,0,42000,-42000,-42000
20200212,055815,亞光國票99購01,,,,,0.00,0.00,0,0,0,0,0,0,0,0,0,0,0,0,0
20200212,055816,新日興國票98購01,3.50,3.69,3.50,3.69,+0.12,3.36,286000,11,1035920,0,0,0,0,0,0,181000,105000,76000,76000
20200212,055817,京鼎國票99購01,1.39,1.54,1.38,1.49,+0.31,26.27,588000,15,839110,0,0,0,0,0,0,340000,248000,92000,92000
20200212,055818,晶相光國票97購02,1.20,1.29,1.20,1.22,+0.03,2.52,231000,18,288640,0,0,0,0,0,0,139000,201000,-62000,-62000
20200212,055819,晶相光國票98購01,1.87,1.93,1.87,1.93,+0.11,6.04,101000,2,192470,0,0,0,0,0,0,41000,60000,-19000,-19000
20200212,05581P,華新科凱基96售07,,,,,0.00,0.00,0,0,0,0,0,0,0,0,0,0,0,0,0
20200212,055820,矽力國票98購02,1.94,2.16,1.94,2.16,+0.51,30.91,64000,9,130120,0,0,0,0,0,0,30000,34000,-4000,-4000
20200212,055821,勤誠國票98購01,3.26,3.34,3.12,3.27,-0.09,-2.68,466000,12,1504500,0,0,0,0,0,0,126000,340000,-214000,-214000
20200212,055822,臺股指國票97購09,1.35,1.35,1.35,1.35,+0.09,7.14,6000,1,8100,0,0,0,0,0,0,6000,0,6000,6000
20200212,055823,臺股指國票97購10,0.84,0.97,0.84,0.97,+0.15,18.29,12000,4,10380,0,0,0,0,0,0,11000,1000,10000,10000
20200212,055824,臺股指國票97購11,0.84,0.93,0.84,0.93,+0.15,19.23,25000,2,21900,0,0,0,0,0,0,25000,0,25000,25000
20200212,055825,臺股指國票97購12,2.57,2.57,2.57,2.57,+0.36,16.29,2000,1,5140,0,0,0,0,0,0,2000,0,2000,2000
20200212,055826,中石化元大97購01,0.50,0.51,0.50,0.51,-0.01,-1.92,122000,2,61100,0,0,0,0,0,0,0,122000,-122000,-122000
20200212,055827,中石化元大98購01,,,,,0.00,0.00,0,0,0,0,0,0,0,0,0,0,0,0,0
20200212,055828,上銀元大97購05,3.77,3.77,3.57,3.59,+0.09,2.57,158000,30,582640,0,0,0,0,0,0,123000,70000,53000,53000
20200212,055829,上銀元大97購06,3.51,3.51,3.28,3.31,+0.10,3.12,90000,24,306640,0,0,0,0,0,0,74000,61000,13000,13000
20200212,05582P,群創凱基98售06,,,,,0.00,0.00,0,0,0,0,0,0,0,0,0,0,0,0,0
20200212,055830,上銀元大97購07,3.97,3.97,3.77,3.83,+0.13,3.51,230000,33,892740,0,0,0,0,0,0,195000,138000,57000,57000
20200212,055831,台達電元大97購01,1.10,1.16,1.08,1.16,+0.06,5.45,440000,16,486350,0,0,0,0,0,0,178000,162000,16000,16000
20200212,055832,台達電元大97購02,0.58,0.62,0.57,0.62,+0.02,3.33,483000,16,283020,0,0,0,0,0,0,61000,432000,-371000,-371000
20200212,055833,華通元大98購05,0.71,0.93,0.70,0.89,+0.19,27.14,940000,33,753370,0,0,0,0,0,0,778000,206000,572000,572000
20200212,055834,國巨元大97購13,5.45,5.55,5.30,5.55,+0.40,7.77,89000,11,479100,0,0,0,0,0,0,89000,54000,35000,35000
20200212,055835,華邦電元大97購03,0.59,0.62,0.59,0.62,+0.11,21.57,318000,3,195090,0,0,0,0,0,0,0,318000,-318000,-318000
20200212,055836,華邦電元大97購04,0.96,1.03,0.96,0.98,+0.12,13.95,138000,7,134180,0,0,0,0,0,0,57000,88000,-31000,-31000
20200212,055837,致茂元大97購02,1.23,1.48,1.23,1.48,+0.31,26.5,414000,23,568850,0,0,0,0,0,0,161000,253000,-92000,-92000
20200212,055838,致茂元大97購03,1.31,1.54,1.31,1.52,+0.28,22.58,726000,35,1023880,0,0,0,0,0,0,274000,452000,-178000,-178000
20200212,055839,瑞昱元大97購04,2.75,3.06,2.75,2.99,+0.22,7.94,36000,8,103540,0,0,0,0,0,0,19000,26000,-7000,-7000
20200212,05583P,訊芯凱基96售01,0.94,0.94,0.86,0.87,-0.11,-11.22,270000,9,238200,0,0,0,0,0,0,60000,210000,-150000,-150000
20200212,055840,南亞科元大97購03,1.32,1.32,1.28,1.31,-0.04,-2.96,357000,17,466030,0,0,0,0,0,0,315000,29000,286000,286000
20200212,055841,南亞科元大97購04,2.25,2.25,2.20,2.20,-0.05,-2.22,134000,13,299500,0,0,0,0,0,0,100000,48000,52000,52000
20200212,055842,建準元大98購01,0.73,0.73,0.70,0.70,0.00,0.00,207000,7,146270,0,0,0,0,0,0,100000,107000,-7000,-7000
20200212,055843,美律元大97購02,0.53,0.62,0.53,0.62,+0.13,26.53,123000,11,68830,0,0,0,0,0,0,0,123000,-123000,-123000
20200212,055844,大毅元大98購01,1.88,1.88,1.73,1.78,-0.04,-2.2,563000,27,1000430,0,0,0,0,0,0,499000,377000,122000,122000
20200212,055845,大立光元大97購08,,,,,0.00,0.00,0,0,0,0,0,0,0,0,0,0,0,0,0
20200212,055846,大立光元大97購09,,,,,0.00,0.00,0,0,0,0,0,0,0,0,0,0,0,0,0
20200212,055847,大立光元大97購10,,,,,0.00,0.00,0,0,0,0,0,0,0,0,0,0,0,0,0
20200212,055848,大立光元大97購11,2.07,2.07,2.07,2.07,+0.20,10.7,25000,1,51750,0,0,0,0,0,0,0,25000,-25000,-25000
20200212,055849,聯詠元大97購05,2.23,2.44,2.23,2.41,+0.30,14.22,135000,13,313120,0,0,0,0,0,0,76000,72000,4000,4000
20200212,05584P,臺股指凱基96售13,1.94,2.00,1.78,2.00,0.00,0.00,402000,16,753190,0,0,0,0,0,0,198000,203000,-5000,-5000
20200212,055850,聯詠元大97購06,2.20,2.37,2.20,2.33,+0.24,11.48,272000,19,631670,0,0,0,0,0,0,189000,194000,-5000,-5000
20200212,055851,智原元大98購01,0.34,0.37,0.33,0.37,+0.05,15.62,280000,13,100400,0,0,0,0,0,0,108000,150000,-42000,-42000
20200212,055852,聯鈞元大98購01,0.85,1.00,0.85,0.99,+0.16,19.28,1063000,56,982240,0,0,0,0,0,0,436000,413000,23000,23000
20200212,055853,群創元大98購03,,,,,0.00,0.00,0,0,0,0,0,0,0,0,0,0,0,0,0
20200212,055854,群創元大98購04,0.94,0.94,0.91,0.92,-0.01,-1.08,92000,7,85560,0,0,0,0,0,0,92000,3000,89000,89000
20200212,055855,牧德元大99購02,0.90,0.92,0.87,0.87,-0.03,-3.33,766000,26,685230,0,0,0,0,0,0,477000,276000,201000,201000
20200212,055856,新唐元大97購03,,,,,0.00,0.00,0,0,0,0,0,0,0,0,0,0,0,0,0
20200212,055857,嘉聯益元大97購04,0.76,0.80,0.76,0.78,+0.06,8.33,614000,10,478900,0,0,0,0,0,0,414000,200000,214000,214000
20200212,055858,聯茂元大97購03,0.92,1.29,0.92,1.16,+0.28,31.82,495000,45,552700,0,0,0,0,0,0,388000,385000,3000,3000
20200212,055859,啟碁元大97購03,,,,,0.00,0.00,0,0,0,0,0,0,0,0,0,0,0,0,0
20200212,05585P,臺股指凱基96售14,1.59,1.59,1.43,1.43,-0.21,-12.8,525000,40,786610,0,0,0,0,0,0,30000,495000,-465000,-465000
20200212,055860,啟碁元大97購04,1.41,1.44,1.41,1.43,+0.03,2.14,42000,8,59700,0,0,0,0,0,0,22000,32000,-10000,-10000
20200212,055861,矽力元大97購03,1.28,1.41,1.28,1.41,+0.16,12.8,141000,12,196070,0,0,0,0,0,0,56000,74000,-18000,-18000
20200212,055862,矽力元大97購04,1.49,1.59,1.44,1.59,+0.19,13.57,47000,7,71110,0,0,0,0,0,0,7000,40000,-33000,-33000
20200212,055863,緯穎元大97購05,1.11,1.19,1.04,1.19,+0.02,1.71,1457000,75,1653640,0,0,0,0,0,0,1270000,304000,966000,966000
20200212,055864,臺股指元大97購01,1.17,1.17,1.17,1.17,+0.08,7.34,5000,1,5850,0,0,0,0,0,0,5000,0,5000,5000
20200212,055865,臺股指元大97購02,1.37,1.46,1.37,1.46,+0.21,16.8,60000,3,86300,0,0,0,0,0,0,0,60000,-60000,-60000
20200212,055866,臺股指元大97購03,1.52,1.63,1.50,1.63,+0.23,16.43,1104000,14,1753520,0,0,0,0,0,0,1084000,920000,164000,164000
20200212,055867,臺股指元大97購05,1.24,1.24,1.24,1.24,0.00,0.00,60000,1,74400,0,0,0,0,0,0,60000,0,60000,60000
20200212,055868,臺股指元大97購07,0.87,0.96,0.87,0.96,+0.14,17.07,256000,4,232760,0,0,0,0,0,0,250000,6000,244000,244000
20200212,055869,臺股指元大97購08,1.27,1.27,1.27,1.27,+0.18,16.51,5000,1,6350,0,0,0,0,0,0,5000,0,5000,5000
20200212,05586P,臺股指凱基96售15,1.48,1.48,1.48,1.48,0.00,0.00,5000,1,7400,0,0,0,0,0,0,0,5000,-5000,-5000
20200212,055870,智原台新97購01,0.49,0.53,0.49,0.52,+0.03,6.12,604000,18,303680,0,0,0,0,0,0,514000,90000,424000,424000
20200212,055871,群創台新97購02,0.70,0.70,0.69,0.69,-0.06,-8.0,161000,3,111290,0,0,0,0,0,0,161000,0,161000,161000
20200212,055872,亞泥元富97購01,1.38,1.43,1.38,1.43,+0.06,4.38,132000,8,186630,0,0,0,0,0,0,96000,36000,60000,60000
20200212,055873,聚陽元富97購01,0.60,0.60,0.59,0.59,-0.03,-4.84,69000,8,41060,0,0,0,0,0,0,11000,55000,-44000,-44000
20200212,055874,中環元富9A購01,1.73,1.73,1.69,1.69,-0.14,-7.65,189000,30,326210,0,0,0,0,0,0,189000,0,189000,189000
20200212,055875,光罩元富97購02,0.85,0.88,0.85,0.85,+0.07,8.97,60000,9,51580,0,0,0,0,0,0,20000,40000,-20000,-20000
20200212,055876,美食元富9A購01,0.85,1.04,0.85,0.99,+0.12,13.79,3186000,68,3144320,0,0,0,0,0,0,840000,2288000,-1448000,-1448000
20200212,055877,奇鋐元富97購01,0.94,0.98,0.94,0.98,+0.08,8.89,122000,5,116860,0,0,0,0,0,0,40000,82000,-42000,-42000
20200212,055878,泰碩元富97購02,,,,,0.00,0.00,0,0,0,0,0,0,0,0,0,0,0,0,0
20200212,055879,神達元富97購01,1.01,1.13,1.01,1.12,0.00,0.00,145000,27,158610,0,0,0,0,0,0,0,145000,-145000,-145000
20200212,05587P,鴻海凱基96售12,3.51,3.51,3.51,3.51,-0.53,-13.12,50000,1,175500,0,0,0,0,0,0,50000,50000,0,0
20200212,055880,神達元富97購02,1.12,1.28,1.12,1.27,+0.16,14.41,125000,26,153510,0,0,0,0,0,0,10000,115000,-105000,-105000
20200212,055881,康控元富97購01,0.93,1.05,0.93,1.05,+0.15,16.67,283000,24,274240,0,0,0,0,0,0,124000,158000,-34000,-34000
20200212,055882,嘉聯益元富97購01,0.85,0.91,0.85,0.91,+0.09,10.98,95000,6,82810,0,0,0,0,0,0,86000,9000,77000,77000
20200212,055883,樺漢元富97購01,0.68,0.68,0.68,0.68,0.00,0.00,100000,1,68000,0,0,0,0,0,0,0,100000,-100000,-100000
20200212,055884,臺股指元富97購01,1.14,1.22,1.14,1.22,0.00,0.00,17000,3,20250,0,0,0,0,0,0,8000,9000,-1000,-1000
20200212,055885,大成鋼統一97購02,1.00,1.05,1.00,1.05,+0.06,6.06,245000,6,247610,0,0,0,0,0,0,235000,10000,225000,225000
20200212,055886,上銀統一97購02,2.87,2.91,2.70,2.70,-0.03,-1.1,300000,11,839540,0,0,0,0,0,0,243000,57000,186000,186000
20200212,055887,上銀統一97購03,1.34,1.34,1.32,1.32,+0.02,1.54,30000,2,39900,0,0,0,0,0,0,0,30000,-30000,-30000
20200212,055888,鴻海統一97購04,0.48,0.51,0.48,0.51,+0.16,45.71,16000,3,7840,0,0,0,0,0,0,0,16000,-16000,-16000
20200212,055889,鴻海統一97購05,1.28,1.44,1.28,1.44,+0.38,35.85,52000,3,70720,0,0,0,0,0,0,2000,50000,-48000,-48000
20200212,05588P,群創兆豐97售02,,,,,0.00,0.00,0,0,0,0,0,0,0,0,0,0,0,0,0
20200212,055890,鴻海統一99購01,1.26,1.26,1.26,1.26,+0.12,10.53,48000,1,60480,0,0,0,0,0,0,0,48000,-48000,-48000
20200212,055891,鴻海統一9A購01,1.06,1.21,1.06,1.21,+0.16,15.24,1983000,80,2253540,0,0,0,0,0,0,319000,1496000,-1177000,-1177000
20200212,055892,國巨統一99購01,3.62,3.66,3.47,3.66,+0.26,7.65,363000,15,1271890,0,0,0,0,0,0,352000,11000,341000,341000
20200212,055893,大立光統一97購07,,,,,0.00,0.00,0,0,0,0,0,0,0,0,0,0,0,0,0
20200212,055894,欣興統一97購03,0.83,0.97,0.83,0.97,+0.22,29.33,325000,9,287780,0,0,0,0,0,0,0,325000,-325000,-325000
20200212,055895,群創統一97購04,0.88,0.88,0.88,0.88,0.00,0.00,80000,1,70400,0,0,0,0,0,0,80000,0,80000,80000
20200212,055896,南電統一97購02,0.78,0.89,0.76,0.89,+0.12,15.58,582000,16,478050,0,0,0,0,0,0,555000,0,555000,555000
20200212,055897,TXFI0永昌99購01,,,,,0.00,0.00,0,0,0,0,0,0,0,0,0,0,0,0,0
20200212,055898,訊芯第一97購01,0.28,0.34,0.28,0.34,+0.06,21.43,251000,9,83030,0,0,0,0,0,0,41000,210000,-169000,-169000
20200212,055899,群創中信99購01,,,,,0.00,0.00,0,0,0,0,0,0,0,0,0,0,0,0,0
20200212,05589P,大立光中信9A售01,0.73,0.73,0.67,0.67,-0.08,-10.67,30000,3,20700,0,0,0,0,0,0,20000,10000,10000,10000
20200212,055900,瀚宇博中信97購01,0.35,0.35,0.35,0.35,-0.02,-5.41,1000,1,350,0,0,0,0,0,0,1000,0,1000,1000
20200212,055901,超眾中信97購01,0.31,0.34,0.31,0.34,-0.04,-10.53,239000,21,77530,0,0,0,0,0,0,237000,2000,235000,235000
20200212,055902,同欣電中信99購01,0.85,0.92,0.82,0.82,0.00,0.00,341000,48,297810,0,0,0,0,0,0,152000,189000,-37000,-37000
20200212,055903,鈺齊中信97購02,,,,,0.00,0.00,0,0,0,0,0,0,0,0,0,0,0,0,0
20200212,055904,貿聯亞東99購01,,,,,0.00,0.00,0,0,0,0,0,0,0,0,0,0,0,0,0
20200212,055905,可成兆豐97購03,0.77,0.82,0.77,0.82,+0.10,13.89,113000,3,89550,0,0,0,0,0,0,28000,85000,-57000,-57000
20200212,055906,大立光兆豐97購03,0.67,0.80,0.67,0.80,+0.10,14.29,423000,4,305000,0,0,0,0,0,0,400000,23000,377000,377000
20200212,055907,台虹兆豐98購01,0.79,0.82,0.79,0.82,+0.10,13.89,239000,7,192490,0,0,0,0,0,0,83000,156000,-73000,-73000
20200212,055908,GIS日盛97購01,0.91,0.97,0.91,0.95,+0.08,9.2,429000,19,401310,0,0,0,0,0,0,126000,303000,-177000,-177000
20200212,055909,大成鋼凱基98購02,,,,,0.00,0.00,0,0,0,0,0,0,0,0,0,0,0,0,0
20200212,05590P,臺股指中信96售05,0.55,0.55,0.55,0.55,0.00,0.00,5000,1,2750,0,0,0,0,0,0,0,5000,-5000,-5000
20200212,055910,瑞昱凱基98購01,1.02,1.12,1.02,1.08,+0.13,13.68,55000,6,59700,0,0,0,0,0,0,35000,25000,10000,10000
20200212,055911,可成凱基98購02,1.91,1.91,1.91,1.91,+0.09,4.95,8000,1,15280,0,0,0,0,0,0,0,8000,-8000,-8000
20200212,055912,宏達電凱基98購03,,,,,0.00,0.00,0,0,0,0,0,0,0,0,0,0,0,0,0
20200212,055913,中信金凱基97購01,0.87,0.87,0.87,0.87,+0.01,1.16,138000,2,120060,0,0,0,0,0,0,0,138000,-138000,-138000
20200212,055914,大立光凱基97購13,,,,,0.00,0.00,0,0,0,0,0,0,0,0,0,0,0,0,0
20200212,055915,大立光凱基98購07,1.03,1.10,1.03,1.10,+0.13,13.4,97000,9,104300,0,0,0,0,0,0,12000,84000,-72000,-72000
20200212,055916,奇鋐凱基99購01,0.31,0.31,0.31,0.31,0.00,0.00,10000,1,3100,0,0,0,0,0,0,0,10000,-10000,-10000
20200212,055917,禾伸堂凱基98購02,1.16,1.16,1.13,1.16,+0.04,3.57,3000,3,3450,0,0,0,0,0,0,1000,2000,-1000,-1000
20200212,055918,和鑫凱基97購01,0.47,0.50,0.06,0.50,+0.03,6.38,107000,19,46380,0,0,0,0,0,0,91000,16000,75000,75000
20200212,055919,景碩凱基98購02,2.24,2.80,2.16,2.65,+0.46,21.0,134000,24,329850,0,0,0,0,0,0,31000,103000,-72000,-72000
20200212,05591P,義隆群益96售03,0.89,0.94,0.89,0.93,0.00,0.00,6000,6,5530,0,0,0,0,0,0,0,6000,-6000,-6000
20200212,055920,智伸科凱基97購02,,,,,0.00,0.00,0,0,0,0,0,0,0,0,0,0,0,0,0
20200212,055921,新唐凱基98購01,,,,,0.00,0.00,0,0,0,0,0,0,0,0,0,0,0,0,0
20200212,055922,台郡凱基98購03,0.49,0.56,0.49,0.56,+0.30,115.38,102000,4,55980,0,0,0,0,0,0,18000,0,18000,18000
20200212,055923,矽力凱基98購01,1.18,1.18,1.18,1.18,+0.24,25.53,41000,1,48380,0,0,0,0,0,0,41000,0,41000,41000
20200212,055924,深中小群益9B購01,0.75,0.75,0.75,0.75,+0.04,5.63,30000,1,22500,0,0,0,0,0,0,30000,0,30000,30000
20200212,055925,上銀群益97購01,2.83,2.83,2.78,2.78,+0.03,1.09,17000,10,47840,0,0,0,0,0,0,17000,17000,0,0
20200212,055926,國巨群益98購06,2.83,2.89,2.80,2.89,+0.15,5.47,543000,11,1540300,0,0,0,0,0,0,383000,160000,223000,223000
20200212,055927,南亞科群益97購01,1.42,1.45,1.42,1.45,-0.03,-2.03,1627000,19,2337600,0,0,0,0,0,0,1622000,5000,1617000,1617000
20200212,055928,南亞科群益97購02,1.42,1.42,1.41,1.41,-0.07,-4.73,32000,2,45140,0,0,0,0,0,0,32000,0,32000,32000
20200212,055929,聯發科群益97購05,0.74,0.74,0.74,0.74,0.00,0.00,1000,1,740,0,0,0,0,0,0,0,1000,-1000,-1000
20200212,05592P,可成群益96售03,,,,,0.00,0.00,0,0,0,0,0,0,0,0,0,0,0,0,0
20200212,055930,可成群益98購01,1.81,2.01,1.75,2.01,+0.33,19.64,399000,17,758540,0,0,0,0,0,0,94000,393000,-299000,-299000
20200212,055931,冠德群益97購02,0.80,0.82,0.80,0.82,+0.02,2.5,200000,2,162000,0,0,0,0,0,0,100000,100000,0,0
20200212,055932,玉山金群益99購01,1.87,1.87,1.87,1.87,+0.01,0.54,190000,2,355300,0,0,0,0,0,0,0,190000,-190000,-190000
20200212,055933,欣興群益98購02,2.10,2.10,2.10,2.10,0.00,0.00,1000,1,2100,0,0,0,0,0,0,1000,0,1000,1000
20200212,055934,景碩群益98購03,2.37,2.94,2.37,2.77,+0.33,13.52,535000,73,1387920,0,0,0,0,0,0,303000,348000,-45000,-45000
20200212,055935,創意群益97購02,2.03,2.17,1.90,2.15,-0.26,-10.79,435000,36,878600,0,0,0,0,0,0,331000,244000,87000,87000
20200212,055936,彩晶群益98購02,0.45,0.45,0.45,0.45,0.00,0.00,30000,1,13500,0,0,0,0,0,0,0,30000,-30000,-30000
20200212,055937,康舒群益97購01,,,,,0.00,0.00,0,0,0,0,0,0,0,0,0,0,0,0,0
20200212,055938,矽力群益97購01,1.20,1.39,1.17,1.37,+0.17,14.17,695000,33,919010,0,0,0,0,0,0,407000,339000,68000,68000
20200212,055939,GIS群益97購01,0.35,0.36,0.35,0.36,0.00,0.00,57000,3,20030,0,0,0,0,0,0,46000,57000,-11000,-11000
20200212,05593P,鴻海國票97售03,,,,,0.00,0.00,0,0,0,0,0,0,0,0,0,0,0,0,0
20200212,055940,致新群益98購01,1.36,1.41,1.31,1.41,+0.03,2.17,489000,30,664660,0,0,0,0,0,0,489000,10000,479000,479000
20200212,055941,百和群益98購02,0.61,0.61,0.61,0.61,-0.01,-1.61,11000,1,6710,0,0,0,0,0,0,11000,0,11000,11000
20200212,055942,臺股指群益9C購01,2.14,2.37,2.14,2.37,+0.28,13.4,188000,15,418980,0,0,0,0,0,0,186000,2000,184000,184000
20200212,055943,瑞昱麥證97購01,1.26,1.41,1.26,1.35,+0.12,9.76,162000,11,218260,101000,61000,40000,0,0,0,101000,72000,29000,29000
20200212,055944,日月光麥證97購01,0.90,1.02,0.90,1.02,+0.16,18.6,526000,17,494560,300000,126000,174000,0,0,0,300000,126000,174000,174000
20200212,055945,上証2X元大97購04,,,,,0.00,0.00,0,0,0,0,0,0,0,0,0,0,0,0,0
20200212,055946,元油反元大97購02,,,,,0.00,0.00,0,0,0,0,0,0,0,0,0,0,0,0,0
20200212,055947,元油反元大98購03,,,,,0.00,0.00,0,0,0,0,0,0,0,0,0,0,0,0,0
20200212,055948,道瓊銀元大98購02,,,,,0.00,0.00,0,0,0,0,0,0,0,0,0,0,0,0,0
20200212,055949,亞德客元大97購04,2.34,2.50,2.32,2.49,-0.05,-1.97,396000,29,951280,0,0,0,0,0,0,392000,160000,232000,232000
20200212,05594P,旺宏國票96售04,,,,,0.00,0.00,0,0,0,0,0,0,0,0,0,0,0,0,0
20200212,055950,華新元大97購02,1.02,1.04,1.00,1.04,+0.08,8.33,95000,9,96660,0,0,0,0,0,0,79000,42000,37000,37000
20200212,055951,大成鋼元大97購02,0.71,0.71,0.71,0.71,0.00,0.00,35000,2,24850,0,0,0,0,0,0,35000,0,35000,35000
20200212,055952,上銀元大97購08,3.05,3.05,2.88,2.90,+0.03,1.05,204000,20,608540,0,0,0,0,0,0,157000,170000,-13000,-13000
20200212,055953,上銀元大97購09,3.14,3.14,2.95,3.01,+0.06,2.03,84000,16,258050,0,0,0,0,0,0,44000,63000,-19000,-19000
20200212,055954,南港元大97購02,0.77,0.94,0.77,0.94,+0.08,9.3,139000,6,118330,0,0,0,0,0,0,57000,96000,-39000,-39000
20200212,055955,微星元大97購01,3.46,3.50,3.09,3.11,-0.04,-1.27,286000,32,931690,0,0,0,0,0,0,218000,200000,18000,18000
20200212,055956,瑞昱元大97購05,2.11,2.31,2.11,2.29,+0.21,10.1,180000,17,386570,0,0,0,0,0,0,79000,110000,-31000,-31000
20200212,055957,瑞昱元大97購06,1.92,2.19,1.92,2.05,+0.18,9.63,217000,15,430150,0,0,0,0,0,0,92000,129000,-37000,-37000
20200212,055958,台光電元大97購02,0.77,1.01,0.77,0.97,+0.20,25.97,212000,20,198210,0,0,0,0,0,0,34000,202000,-168000,-168000
20200212,055959,美律元大97購03,0.47,0.55,0.47,0.55,0.00,0.00,178000,11,91070,0,0,0,0,0,0,0,178000,-178000,-178000
20200212,05595P,友達統一96售02,0.23,0.23,0.23,0.23,+0.01,4.55,30000,1,6900,0,0,0,0,0,0,30000,0,30000,30000
20200212,055960,義隆元大97購01,2.45,2.45,2.21,2.35,+0.35,17.5,88000,14,209270,0,0,0,0,0,0,54000,34000,20000,20000
20200212,055961,國泰金元大97購01,1.30,1.31,1.30,1.31,+0.01,0.77,116000,4,151800,0,0,0,0,0,0,16000,100000,-84000,-84000
20200212,055962,晶豪科元大97購02,1.70,1.71,1.70,1.71,0.00,0.00,9000,3,15370,0,0,0,0,0,0,0,9000,-9000,-9000
20200212,055963,欣興元大97購04,2.05,2.48,2.05,2.48,+0.41,19.81,286000,35,667190,0,0,0,0,0,0,87000,250000,-163000,-163000
20200212,055964,正文元大97購02,1.07,1.10,1.05,1.10,+0.04,3.77,200000,10,213120,0,0,0,0,0,0,168000,92000,76000,76000
20200212,055965,泰鼎元大97購03,3.00,3.11,2.79,2.79,+0.16,6.08,476000,64,1411860,0,0,0,0,0,0,352000,423000,-71000,-71000
20200212,055966,茂林元大99購01,0.99,1.02,0.96,0.99,+0.02,2.06,1007000,78,997490,0,0,0,0,0,0,344000,598000,-254000,-254000
20200212,055967,臻鼎元大97購01,0.92,1.07,0.80,0.86,+0.11,14.67,462000,29,450110,0,0,0,0,0,0,231000,271000,-40000,-40000
20200212,055968,祥碩元大97購04,6.15,7.50,6.15,7.40,+1.30,21.31,86000,23,577350,0,0,0,0,0,0,5000,81000,-76000,-76000
20200212,055969,彩晶元大99購02,0.50,0.50,0.50,0.50,0.00,0.00,30000,1,15000,0,0,0,0,0,0,0,30000,-30000,-30000
20200212,05596P,可成統一96售01,2.10,2.11,1.96,1.96,-0.23,-10.5,207000,9,428170,0,0,0,0,0,0,107000,100000,7000,7000
20200212,055970,聯茂元大97購04,1.83,2.44,1.83,2.44,+0.78,46.99,107000,16,235810,0,0,0,0,0,0,22000,85000,-63000,-63000
20200212,055971,矽力元大97購05,1.34,1.44,1.26,1.44,+0.22,18.03,64000,12,88930,0,0,0,0,0,0,33000,28000,5000,5000
20200212,055972,GIS元大97購04,0.71,0.73,0.71,0.73,0.00,0.00,208000,5,148680,0,0,0,0,0,0,1000,208000,-207000,-207000
20200212,055973,亞德客統一97購01,1.73,1.88,1.73,1.87,-0.02,-1.06,414000,31,741830,0,0,0,0,0,0,372000,39000,333000,333000
20200212,055974,上銀統一97購05,2.44,2.44,2.30,2.34,+0.06,2.63,191000,8,457580,0,0,0,0,0,0,83000,108000,-25000,-25000
20200212,055975,鴻海統一98購05,0.71,0.85,0.71,0.85,+0.16,23.19,693000,12,530670,0,0,0,0,0,0,368000,325000,43000,43000
20200212,055976,台積電統一99購03,1.25,1.32,1.23,1.32,+0.13,10.92,123000,8,156330,0,0,0,0,0,0,119000,4000,115000,115000
20200212,055977,南亞科統一97購01,2.24,2.24,2.24,2.24,+0.10,4.67,35000,1,78400,0,0,0,0,0,0,35000,0,35000,35000
20200212,055978,大立光統一98購05,1.14,1.24,1.14,1.24,+0.22,21.57,347000,9,409440,0,0,0,0,0,0,210000,137000,73000,73000
20200212,055979,聯鈞統一97購03,0.60,0.72,0.60,0.72,+0.17,30.91,216000,14,139130,0,0,0,0,0,0,23000,193000,-170000,-170000
20200212,05597P,鴻海元富96售06,2.15,2.21,1.97,1.97,-0.39,-16.53,55000,5,117250,0,0,0,0,0,0,25000,30000,-5000,-5000
20200212,055980,祥碩統一98購01,1.38,1.69,1.37,1.64,+0.36,28.13,1054000,64,1602450,0,0,0,0,0,0,322000,746000,-424000,-424000
20200212,055981,臺股指統一97購03,,,,,0.00,0.00,0,0,0,0,0,0,0,0,0,0,0,0,0
20200212,055982,T50反1元富97購01,,,,,0.00,0.00,0,0,0,0,0,0,0,0,0,0,0,0,0
20200212,055983,全新元富9A購02,1.16,1.30,1.16,1.30,+0.23,21.5,190000,27,231870,0,0,0,0,0,0,57000,133000,-76000,-76000
20200212,055984,大立光元富97購02,1.44,1.44,1.43,1.43,+0.13,10.0,48000,2,69060,0,0,0,0,0,0,6000,42000,-36000,-36000
20200212,055985,聯鈞元富97購01,1.09,1.21,1.08,1.21,+0.20,19.8,352000,20,399910,0,0,0,0,0,0,153000,229000,-76000,-76000
20200212,055986,祥碩元富97購01,2.94,3.62,2.90,3.62,+0.92,34.07,197000,31,602290,0,0,0,0,0,0,72000,117000,-45000,-45000
20200212,055987,台表科元富97購01,0.49,0.49,0.48,0.48,0.00,0.00,20000,3,9700,0,0,0,0,0,0,0,20000,-20000,-20000
20200212,055988,矽力元富97購01,1.03,1.16,1.01,1.16,+0.28,31.82,48000,9,50850,0,0,0,0,0,0,5000,43000,-38000,-38000
20200212,055989,矽力元富9A購01,1.49,1.68,1.49,1.68,+0.31,22.63,56000,8,87560,0,0,0,0,0,0,33000,23000,10000,10000
20200212,05598P,國巨元富96售03,,,,,0.00,0.00,0,0,0,0,0,0,0,0,0,0,0,0,0
20200212,055990,矽創元富97購01,1.44,1.75,1.44,1.75,+0.35,25.0,261000,66,425550,0,0,0,0,0,0,48000,213000,-165000,-165000
20200212,055991,鈺齊元富97購01,0.54,0.54,0.54,0.54,+0.09,20.0,47000,2,25380,0,0,0,0,0,0,0,47000,-47000,-47000
20200212,055992,智原台新97購02,0.63,0.71,0.63,0.71,+0.07,10.94,154000,4,100760,0,0,0,0,0,0,122000,32000,90000,90000
20200212,055993,致茂國泰99購01,1.17,1.32,1.15,1.32,+0.21,18.92,350000,41,445280,0,0,0,0,0,0,38000,306000,-268000,-268000
20200212,055994,聯發科國泰99購02,1.32,1.41,1.32,1.41,+0.20,16.53,217000,13,298000,0,0,0,0,0,0,159000,108000,51000,51000
20200212,055995,華擎國泰99購01,4.00,4.00,3.54,3.58,-0.10,-2.72,111000,6,395260,0,0,0,0,0,0,103000,8000,95000,95000
20200212,055996,矽力國泰99購01,1.37,1.44,1.29,1.44,+0.19,15.2,832000,32,1159940,0,0,0,0,0,0,446000,371000,75000,75000
20200212,055997,矽創國泰99購01,1.06,1.30,1.06,1.30,+0.24,22.64,355000,61,421820,0,0,0,0,0,0,71000,289000,-218000,-218000
20200212,055998,臺股指富邦99購01,0.27,0.29,0.27,0.29,+0.03,11.54,484000,5,139920,0,0,0,0,0,0,484000,0,484000,484000
20200212,055999,電子類富邦99購01,0.55,0.55,0.55,0.55,0.00,0.00,20000,2,11000,0,0,0,0,0,0,0,20000,-20000,-20000
20200212,05599P,欣興台新96售01,,,,,0.00,0.00,0,0,0,0,0,0,0,0,0,0,0,0,0
20200212,056000,佳世達永豐97購01,,,,,0.00,0.00,0,0,0,0,0,0,0,0,0,0,0,0,0
20200212,056001,美食永豐97購01,0.49,0.54,0.49,0.52,+0.07,15.56,1176000,18,617140,0,0,0,0,0,0,515000,661000,-146000,-146000
20200212,056002,嘉晶永豐97購01,0.56,0.59,0.56,0.59,0.00,0.00,40000,4,22900,0,0,0,0,0,0,0,40000,-40000,-40000
20200212,056003,智伸科永豐97購02,,,,,0.00,0.00,0,0,0,0,0,0,0,0,0,0,0,0,0
20200212,056004,南電永豐97購02,0.62,0.69,0.62,0.68,0.00,0.00,235000,22,154680,0,0,0,0,0,0,167000,0,167000,167000
20200212,056005,臺股指永豐97購04,0.31,0.39,0.31,0.37,+0.07,23.33,1741000,32,625230,0,0,0,0,0,0,1566000,167000,1399000,1399000
20200212,056006,義隆亞東97購01,,,,,0.00,0.00,0,0,0,0,0,0,0,0,0,0,0,0,0
20200212,056007,上銀中信97購02,0.75,0.76,0.73,0.75,+0.03,4.17,82000,4,61560,0,0,0,0,0,0,82000,0,82000,82000
20200212,056008,全新中信9B購01,0.66,0.81,0.66,0.81,+0.22,37.29,563000,27,399130,0,0,0,0,0,0,126000,437000,-311000,-311000
20200212,056009,奇力新中信98購03,1.01,1.05,0.97,1.05,+0.05,5.0,653000,51,653490,0,0,0,0,0,0,347000,306000,41000,41000
20200212,05600P,玉晶光台新96售04,0.45,0.45,0.44,0.44,-0.08,-15.38,16000,2,7140,0,0,0,0,0,0,6000,10000,-4000,-4000
20200212,056010,力成中信97購01,1.02,1.10,0.92,1.09,+0.24,28.24,1132000,59,1110650,0,0,0,0,0,0,650000,477000,173000,173000
20200212,056011,矽力中信99購01,0.72,0.78,0.69,0.75,+0.07,10.29,998000,33,712610,0,0,0,0,0,0,659000,269000,390000,390000
20200212,056012,勤誠中信99購01,,,,,0.00,0.00,0,0,0,0,0,0,0,0,0,0,0,0,0
20200212,056013,T50反1群益97購01,,,,,0.00,0.00,0,0,0,0,0,0,0,0,0,0,0,0,0
20200212,056014,上銀群益97購02,0.87,0.87,0.85,0.85,0.00,0.00,32000,3,27640,0,0,0,0,0,0,0,32000,-32000,-32000
20200212,056015,華通群益99購01,1.20,1.49,1.20,1.49,+0.34,29.57,330000,16,452860,0,0,0,0,0,0,110000,220000,-110000,-110000
20200212,056016,鴻海群益97購06,1.90,2.25,1.90,2.25,+0.51,29.31,47000,9,96540,0,0,0,0,0,0,3000,44000,-41000,-41000
20200212,056017,台積電群益97購04,3.48,3.69,3.41,3.63,+0.25,7.4,560000,52,1962260,0,0,0,0,0,0,428000,434000,-6000,-6000
20200212,056018,旺宏群益97購02,2.15,2.15,2.10,2.10,+0.09,4.48,15000,2,32000,0,0,0,0,0,0,10000,5000,5000,5000
20200212,056019,燿華群益97購02,0.65,0.67,0.65,0.67,+0.10,17.54,47000,9,31260,0,0,0,0,0,0,2000,47000,-45000,-45000
20200212,05601P,鴻海元大97售04,3.56,3.65,3.34,3.34,-0.52,-13.47,166000,15,587680,0,0,0,0,0,0,162000,166000,-4000,-4000
20200212,056020,義隆群益97購01,1.28,1.30,1.19,1.22,+0.19,18.45,269000,12,334550,0,0,0,0,0,0,204000,65000,139000,139000
20200212,056021,興富發群益97購01,1.67,1.67,1.67,1.67,-0.02,-1.18,10000,1,16700,0,0,0,0,0,0,10000,0,10000,10000
20200212,056022,新光金群益97購02,0.54,0.54,0.54,0.54,0.00,0.00,100000,2,54000,0,0,0,0,0,0,0,100000,-100000,-100000
20200212,056023,晶豪科群益97購01,1.76,1.84,1.73,1.84,+0.17,10.18,210000,13,377020,0,0,0,0,0,0,21000,189000,-168000,-168000
20200212,056024,大立光群益97購05,1.34,1.42,1.34,1.42,+0.21,17.36,783000,16,1073850,0,0,0,0,0,0,0,783000,-783000,-783000
20200212,056025,嘉晶群益97購01,1.34,1.64,1.34,1.59,0.00,0.00,357000,31,529240,0,0,0,0,0,0,10000,347000,-337000,-337000
20200212,056026,智易群益97購01,1.26,1.56,1.26,1.54,+0.35,29.41,611000,42,857410,0,0,0,0,0,0,40000,591000,-551000,-551000
20200212,056027,樺漢群益97購02,0.67,0.75,0.67,0.75,+0.11,17.19,381000,8,266860,0,0,0,0,0,0,198000,183000,15000,15000
20200212,056028,GIS群益97購02,0.86,0.90,0.86,0.90,+0.08,9.76,81000,11,71870,0,0,0,0,0,0,20000,41000,-21000,-21000
20200212,056029,國巨麥證98購01,1.86,1.94,1.83,1.94,+0.18,10.23,80000,4,148400,50000,30000,20000,0,0,0,50000,30000,20000,20000
20200212,05602P,國巨元大96售06,,,,,0.00,0.00,0,0,0,0,0,0,0,0,0,0,0,0,0
20200212,056030,華通日盛97購01,1.09,1.50,1.07,1.50,+0.48,47.06,462000,28,623250,0,0,0,0,0,0,123000,399000,-276000,-276000
20200212,056031,勤誠康和97購02,0.75,0.75,0.75,0.75,-0.09,-10.71,10000,1,7500,0,0,0,0,0,0,0,10000,-10000,-10000
20200212,056032,勤誠康和97購03,0.78,0.78,0.78,0.78,0.00,0.00,10000,1,7800,0,0,0,0,0,0,0,10000,-10000,-10000
20200212,056033,T50正2凱基99購02,1.31,1.40,1.31,1.40,+0.10,7.69,118000,4,157880,0,0,0,0,0,0,118000,0,118000,118000
20200212,056034,華通凱基98購01,1.75,2.36,1.74,2.35,+0.63,36.63,154000,17,294230,0,0,0,0,0,0,154000,54000,100000,100000
20200212,056035,鴻海凱基97購06,1.88,2.14,1.88,2.14,+0.35,19.55,381000,8,762320,0,0,0,0,0,0,381000,50000,331000,331000
20200212,056036,鴻海凱基97購07,0.83,0.83,0.83,0.83,0.00,0.00,68000,1,56440,0,0,0,0,0,0,0,68000,-68000,-68000
20200212,056037,美律凱基98購03,0.30,0.36,0.30,0.36,+0.08,28.57,389000,17,132000,0,0,0,0,0,0,228000,149000,79000,79000
20200212,056038,可成凱基97購01,,,,,0.00,0.00,0,0,0,0,0,0,0,0,0,0,0,0,0
20200212,056039,宏達電凱基97購02,0.93,0.93,0.91,0.91,+0.06,7.06,40000,17,36880,0,0,0,0,0,0,40000,0,40000,40000
20200212,05603P,聯發科元大96售09,1.67,1.69,1.63,1.63,-0.26,-13.76,279000,13,464540,0,0,0,0,0,0,145000,269000,-124000,-124000
20200212,056040,亞光凱基98購01,,,,,0.00,0.00,0,0,0,0,0,0,0,0,0,0,0,0,0
20200212,056041,禾伸堂凱基98購03,1.76,1.83,1.76,1.83,+0.13,7.65,78000,2,140780,0,0,0,0,0,0,0,78000,-78000,-78000
20200212,056042,京鼎凱基97購02,,,,,0.00,0.00,0,0,0,0,0,0,0,0,0,0,0,0,0
20200212,056043,力成凱基97購01,1.11,1.27,1.11,1.27,+0.33,35.11,324000,11,362700,0,0,0,0,0,0,293000,31000,262000,262000
20200212,056044,同欣電凱基97購03,1.01,1.20,1.01,1.06,+0.06,6.0,56000,22,61760,0,0,0,0,0,0,26000,36000,-10000,-10000
20200212,056045,勤誠凱基97購01,0.54,0.54,0.54,0.54,-0.02,-3.57,10000,1,5400,0,0,0,0,0,0,0,10000,-10000,-10000
20200212,056046,百和凱基97購01,,,,,0.00,0.00,0,0,0,0,0,0,0,0,0,0,0,0,0
20200212,056047,台積電兆豐97購02,0.88,0.94,0.88,0.94,+0.11,13.25,646000,18,574760,0,0,0,0,0,0,526000,120000,406000,406000
20200212,056048,同欣電兆豐97購01,0.52,0.63,0.52,0.62,+0.08,14.81,724000,36,415130,0,0,0,0,0,0,375000,349000,26000,26000
20200212,056049,奇力新國票98購01,1.56,1.70,1.51,1.70,+0.13,8.28,170000,20,273720,0,0,0,0,0,0,117000,53000,64000,64000
20200212,05604P,聯發科元大96售10,3.31,3.31,3.06,3.09,-0.45,-12.71,321000,28,1027020,0,0,0,0,0,0,259000,258000,1000,1000
20200212,056050,晶技國票98購01,,,,,0.00,0.00,0,0,0,0,0,0,0,0,0,0,0,0,0
20200212,056051,T50反1元大97購05,1.03,1.03,0.95,0.97,-0.08,-7.62,770000,15,784650,0,0,0,0,0,0,505000,210000,295000,295000
20200212,056052,T50反1元大97購06,0.95,0.95,0.89,0.89,-0.07,-7.29,1529000,10,1424260,0,0,0,0,0,0,976000,553000,423000,423000
20200212,056053,和大元大97購05,1.04,1.04,1.04,1.04,0.00,0.00,3000,2,3120,0,0,0,0,0,0,0,3000,-3000,-3000
20200212,056054,亞德客元大97購05,2.34,2.46,2.33,2.46,-0.11,-4.28,203000,16,491180,0,0,0,0,0,0,203000,20000,183000,183000
20200212,056055,國巨元大97購15,1.45,1.46,1.42,1.45,+0.09,6.62,384000,21,549360,0,0,0,0,0,0,2000,377000,-375000,-375000
20200212,056056,旺宏元大97購06,2.65,2.75,2.54,2.54,-0.10,-3.79,142000,40,374020,0,0,0,0,0,0,142000,142000,0,0
20200212,056057,華邦電元大97購05,0.74,0.74,0.71,0.74,+0.13,21.31,157000,4,114540,0,0,0,0,0,0,100000,57000,43000,43000
20200212,056058,建準元大97購02,,,,,0.00,0.00,0,0,0,0,0,0,0,0,0,0,0,0,0
20200212,056059,美律元大98購02,0.53,0.61,0.53,0.61,+0.13,27.08,777000,18,460340,0,0,0,0,0,0,294000,727000,-433000,-433000
20200212,05605P,嘉聯益元大97售02,0.68,0.69,0.68,0.69,-0.02,-2.82,45000,3,30950,0,0,0,0,0,0,45000,0,45000,45000
20200212,056060,宏達電元大99購01,0.57,0.57,0.57,0.57,+0.02,3.64,1000,1,570,0,0,0,0,0,0,0,1000,-1000,-1000
20200212,056061,國泰金元大97購02,1.77,1.77,1.69,1.77,+0.07,4.12,183000,14,319570,0,0,0,0,0,0,106000,155000,-49000,-49000
20200212,056062,大立光元大97購12,2.46,2.56,2.46,2.56,+0.28,12.28,111000,6,283020,0,0,0,0,0,0,104000,106000,-2000,-2000
20200212,056063,大立光元大97購13,,,,,0.00,0.00,0,0,0,0,0,0,0,0,0,0,0,0,0
20200212,056064,大立光元大97購14,2.38,2.47,2.38,2.47,+0.29,13.3,102000,6,251280,0,0,0,0,0,0,101000,101000,0,0
20200212,056065,奇鋐元大97購01,1.02,1.02,1.00,1.00,+0.06,6.38,105000,9,106310,0,0,0,0,0,0,80000,105000,-25000,-25000
20200212,056066,奇鋐元大98購02,0.50,0.50,0.48,0.48,+0.01,2.13,35000,2,17400,0,0,0,0,0,0,0,35000,-35000,-35000
20200212,056067,智原元大97購01,0.72,0.79,0.71,0.79,+0.09,12.86,434000,21,324940,0,0,0,0,0,0,388000,314000,74000,74000
20200212,056068,欣興元大97購05,2.09,2.56,2.09,2.56,+0.50,24.27,310000,33,732930,0,0,0,0,0,0,109000,274000,-165000,-165000
20200212,056069,新日興元大97購03,1.28,1.28,1.17,1.17,-0.12,-9.3,104000,16,126660,0,0,0,0,0,0,80000,25000,55000,55000
20200212,05606P,TPK國票97售02,,,,,0.00,0.00,0,0,0,0,0,0,0,0,0,0,0,0,0
20200212,056070,新日興元大97購04,1.40,1.42,1.31,1.31,-0.12,-8.39,1814000,61,2392100,0,0,0,0,0,0,248000,1587000,-1339000,-1339000
20200212,056071,創意元大97購02,1.95,2.04,1.87,1.98,-0.19,-8.76,458000,20,896990,0,0,0,0,0,0,260000,412000,-152000,-152000
20200212,056072,群創元大97購01,1.29,1.29,1.25,1.28,+0.02,1.59,160000,24,202950,0,0,0,0,0,0,109000,149000,-40000,-40000
20200212,056073,智伸科元大97購01,1.68,1.70,1.68,1.70,+0.02,1.19,119000,7,201660,0,0,0,0,0,0,119000,0,119000,119000
20200212,056074,茂林元大97購04,1.04,1.07,1.00,1.04,+0.07,7.22,1376000,139,1433650,0,0,0,0,0,0,157000,1256000,-1099000,-1099000
20200212,056075,瀚宇博元大97購03,1.72,1.99,1.72,1.96,+0.18,10.11,458000,26,868900,0,0,0,0,0,0,164000,310000,-146000,-146000
20200212,056076,超眾元大97購05,1.82,2.08,1.82,2.08,+0.20,10.64,222000,28,427510,0,0,0,0,0,0,195000,133000,62000,62000
20200212,056077,矽力元大97購07,1.31,1.48,1.29,1.48,+0.18,13.85,85000,17,119450,0,0,0,0,0,0,65000,20000,45000,45000
20200212,056078,勤誠元大97購01,0.64,0.68,0.61,0.67,-0.01,-1.47,270000,17,176090,0,0,0,0,0,0,56000,214000,-158000,-158000
20200212,056079,世紀鋼元大97購02,1.34,1.35,1.32,1.32,+0.01,0.76,152000,18,203300,0,0,0,0,0,0,152000,1000,151000,151000
20200212,05607P,華通日盛96售01,1.02,1.02,1.02,1.02,-0.36,-26.09,100000,1,102000,0,0,0,0,0,0,100000,0,100000,100000
20200212,056080,世紀鋼元大97購03,0.81,0.82,0.81,0.82,+0.02,2.5,161000,3,131820,0,0,0,0,0,0,161000,0,161000,161000
20200212,056081,T50反1統一99購02,,,,,0.00,0.00,0,0,0,0,0,0,0,0,0,0,0,0,0
20200212,056082,旺宏統一99購02,0.84,0.84,0.84,0.84,0.00,0.00,10000,1,8400,0,0,0,0,0,0,0,10000,-10000,-10000
20200212,056083,億光統一97購03,1.38,1.38,1.34,1.34,0.00,0.00,50000,3,68500,0,0,0,0,0,0,40000,10000,30000,30000
20200212,056084,漢唐統一97購03,1.39,1.44,1.39,1.44,0.00,0.00,101000,5,144110,0,0,0,0,0,0,0,101000,-101000,-101000
20200212,056085,聯發科統一97購01,2.12,2.29,2.12,2.29,+0.37,19.27,130000,5,285400,0,0,0,0,0,0,10000,120000,-110000,-110000
20200212,056086,奇力新統一98購01,0.60,0.63,0.56,0.63,+0.04,6.78,1590000,64,944540,0,0,0,0,0,0,991000,445000,546000,546000
20200212,056087,世芯統一97購01,0.56,0.60,0.52,0.57,-0.03,-5.0,914000,41,511780,0,0,0,0,0,0,876000,28000,848000,848000
20200212,056088,台郡統一97購02,1.47,1.55,1.38,1.55,+0.65,72.22,183000,35,270370,0,0,0,0,0,0,71000,111000,-40000,-40000
20200212,056089,同欣電統一98購01,0.96,1.16,0.96,0.99,-0.02,-1.98,512000,33,541740,0,0,0,0,0,0,267000,245000,22000,22000
20200212,05608P,聯發科凱基96售10,2.35,2.35,2.16,2.16,-0.68,-23.94,14000,4,32370,0,0,0,0,0,0,14000,0,14000,14000
20200212,056090,康舒統一97購01,0.56,0.58,0.56,0.58,0.00,0.00,92000,3,52400,0,0,0,0,0,0,0,92000,-92000,-92000
20200212,056091,百和統一97購01,1.28,1.28,1.25,1.25,-0.04,-3.1,84000,3,106120,0,0,0,0,0,0,56000,28000,28000,28000
20200212,056092,亞德客元富97購02,2.38,2.44,2.33,2.44,0.00,0.00,93000,12,220180,0,0,0,0,0,0,92000,22000,70000,70000
20200212,056093,大毅元富97購01,2.67,2.70,2.53,2.59,-0.08,-3.0,53000,9,139560,0,0,0,0,0,0,33000,20000,13000,13000
20200212,056094,大立光元富97購03,,,,,0.00,0.00,0,0,0,0,0,0,0,0,0,0,0,0,0
20200212,056095,臻鼎元富9A購01,1.79,1.94,1.62,1.62,+0.24,17.39,127000,11,228570,0,0,0,0,0,0,35000,92000,-57000,-57000
20200212,056096,超眾元富9A購01,1.75,1.88,1.73,1.88,+0.08,4.44,715000,37,1278360,0,0,0,0,0,0,490000,225000,265000,265000
20200212,056097,訊芯元富97購02,0.82,0.93,0.82,0.91,+0.14,18.18,42000,6,37560,0,0,0,0,0,0,10000,32000,-22000,-22000
20200212,056098,矽創元富97購02,0.98,1.23,0.98,1.23,+0.27,28.13,302000,53,339360,0,0,0,0,0,0,82000,220000,-138000,-138000
20200212,056099,上銀永豐97購02,0.74,0.74,0.67,0.70,+0.01,1.45,908000,26,630670,0,0,0,0,0,0,393000,515000,-122000,-122000
20200212,05609P,國泰金凱基96售01,0.53,0.53,0.53,0.53,-0.04,-7.02,20000,3,10600,0,0,0,0,0,0,0,19000,-19000,-19000
20200212,056100,楠梓電永豐97購02,0.65,0.75,0.62,0.70,+0.07,11.11,877000,43,614650,0,0,0,0,0,0,81000,796000,-715000,-715000
20200212,056101,光磊永豐98購01,1.02,1.05,0.99,1.01,+0.01,1.0,4699000,86,4754500,0,0,0,0,0,0,1592000,3050000,-1458000,-1458000
20200212,056102,億光永豐97購02,0.46,0.52,0.46,0.51,+0.03,6.25,130000,9,64550,0,0,0,0,0,0,103000,27000,76000,76000
20200212,056103,聯發科永豐97購03,0.85,0.91,0.85,0.91,+0.16,21.33,161000,6,140210,0,0,0,0,0,0,112000,49000,63000,63000
20200212,056104,義隆永豐97購01,0.50,0.51,0.50,0.51,+0.07,15.91,239000,2,121210,0,0,0,0,0,0,239000,0,239000,239000
20200212,056105,智原永豐97購01,0.52,0.59,0.52,0.59,+0.06,11.32,505000,25,275380,0,0,0,0,0,0,350000,155000,195000,195000
20200212,056106,晶相光永豐97購02,0.51,0.52,0.51,0.52,+0.05,10.64,210000,4,108150,0,0,0,0,0,0,0,210000,-210000,-210000
20200212,056107,智易永豐97購02,0.83,1.01,0.83,1.01,+0.21,26.25,369000,26,349580,0,0,0,0,0,0,49000,320000,-271000,-271000
20200212,056108,麗豐永豐97購01,,,,,0.00,0.00,0,0,0,0,0,0,0,0,0,0,0,0,0
20200212,056109,彩晶永豐98購01,0.85,0.85,0.83,0.83,-0.03,-3.49,11000,2,9150,0,0,0,0,0,0,0,11000,-11000,-11000
20200212,05610P,國巨群益98售01,1.02,1.02,0.99,0.99,-0.09,-8.33,28000,3,28160,0,0,0,0,0,0,15000,13000,2000,2000
20200212,056110,嘉聯益永豐97購02,1.00,1.06,0.98,1.03,+0.08,8.42,81000,7,81580,0,0,0,0,0,0,51000,30000,21000,21000
20200212,056111,力成永豐97購01,0.65,0.70,0.61,0.69,+0.13,23.21,1589000,51,1068230,0,0,0,0,0,0,205000,1384000,-1179000,-1179000
20200212,056112,勤誠永豐97購02,0.43,0.43,0.43,0.43,-0.02,-4.44,10000,1,4300,0,0,0,0,0,0,0,10000,-10000,-10000
20200212,056113,新日興兆豐98購01,1.01,1.06,0.98,0.99,-0.07,-6.6,549000,31,552550,0,0,0,0,0,0,290000,259000,31000,31000
20200212,056114,台達電群益97購02,1.35,1.35,1.31,1.31,0.00,0.00,44000,2,58960,0,0,0,0,0,0,44000,0,44000,44000
20200212,056115,奇力新群益97購06,1.80,1.98,1.73,1.96,+0.08,4.26,1029000,111,1914600,0,0,0,0,0,0,687000,881000,-194000,-194000
20200212,056116,義隆群益97購02,1.36,1.38,1.28,1.35,+0.24,21.62,183000,9,250180,0,0,0,0,0,0,125000,58000,67000,67000
20200212,056117,宏達電群益97購02,,,,,0.00,0.00,0,0,0,0,0,0,0,0,0,0,0,0,0
20200212,056118,聯詠群益97購03,1.81,1.90,1.75,1.83,+0.27,17.31,580000,14,1045100,0,0,0,0,0,0,270000,310000,-40000,-40000
20200212,056119,欣興群益97購02,,,,,0.00,0.00,0,0,0,0,0,0,0,0,0,0,0,0,0
20200212,05611P,康控群益96售02,2.77,2.77,2.77,2.77,-0.11,-3.82,10000,1,27700,0,0,0,0,0,0,10000,0,10000,10000
20200212,056120,聯茂群益97購02,2.74,3.68,2.74,3.41,+0.93,37.5,446000,50,1489000,0,0,0,0,0,0,224000,222000,2000,2000
20200212,056121,勤誠群益97購01,,,,,0.00,0.00,0,0,0,0,0,0,0,0,0,0,0,0,0
20200212,056122,勤誠群益97購02,1.57,1.57,1.57,1.57,0.00,0.00,10000,1,15700,0,0,0,0,0,0,0,10000,-10000,-10000
20200212,056123,鈺齊群益97購01,0.73,0.85,0.73,0.85,+0.11,14.86,142000,4,117470,0,0,0,0,0,0,31000,111000,-80000,-80000
20200212,056124,華通國票98購02,2.62,3.24,2.62,3.24,+1.11,52.11,50000,7,143370,0,0,0,0,0,0,0,50000,-50000,-50000
20200212,056125,旺宏國票98購02,4.10,4.10,4.08,4.08,+0.10,2.51,25000,4,102200,0,0,0,0,0,0,0,25000,-25000,-25000
20200212,056126,台郡國票98購02,3.74,3.82,3.69,3.69,+1.14,44.71,44000,8,166330,0,0,0,0,0,0,40000,4000,36000,36000
20200212,056127,致新國票98購02,0.99,1.01,0.97,1.00,-0.03,-2.91,200000,11,198980,0,0,0,0,0,0,115000,85000,30000,30000
20200212,056128,和大中信99購01,0.79,0.79,0.76,0.76,-0.03,-3.8,80000,2,62900,0,0,0,0,0,0,10000,70000,-60000,-60000
20200212,056129,義隆麥證97購01,0.86,0.86,0.78,0.82,+0.13,18.84,585000,18,473250,260000,325000,-65000,0,0,0,260000,325000,-65000,-65000
20200212,05612P,台積電元大96售13,0.47,0.47,0.44,0.44,-0.08,-15.38,965000,15,446450,0,0,0,0,0,0,600000,365000,235000,235000
20200212,056130,新日興麥證97購01,1.29,1.29,1.20,1.20,-0.09,-6.98,96000,9,119550,55000,41000,14000,0,0,0,55000,41000,14000,14000
20200212,056131,鴻海元大97購12,1.85,2.09,1.85,2.09,+0.36,20.81,62000,7,118660,0,0,0,0,0,0,20000,42000,-22000,-22000
20200212,056132,台光電元大97購03,1.99,2.54,1.99,2.54,+0.58,29.59,112000,15,261850,0,0,0,0,0,0,20000,92000,-72000,-72000
20200212,056133,可成元大97購05,2.63,2.83,2.63,2.82,+0.33,13.25,123000,12,337830,0,0,0,0,0,0,69000,114000,-45000,-45000
20200212,056134,可成元大97購06,2.10,2.24,2.08,2.22,+0.27,13.85,174000,11,373580,0,0,0,0,0,0,84000,152000,-68000,-68000
20200212,056135,緯創元大98購01,2.47,2.55,2.45,2.55,+0.09,3.66,68000,4,171250,0,0,0,0,0,0,59000,9000,50000,50000
20200212,056136,京鼎元大98購01,0.82,0.98,0.82,0.96,+0.17,21.52,235000,18,211290,0,0,0,0,0,0,21000,214000,-193000,-193000
20200212,056137,聯鈞元大9A購01,1.29,1.48,1.29,1.48,0.00,0.00,487000,20,665260,0,0,0,0,0,0,182000,305000,-123000,-123000
20200212,056138,群創元大9B購01,,,,,0.00,0.00,0,0,0,0,0,0,0,0,0,0,0,0,0
20200212,056139,貿聯元大97購04,1.31,1.51,1.31,1.50,+0.20,15.38,617000,35,883280,0,0,0,0,0,0,155000,385000,-230000,-230000
20200212,05613P,臻鼎台新96售01,0.83,0.86,0.83,0.86,-0.16,-15.69,282000,4,234750,0,0,0,0,0,0,0,282000,-282000,-282000
20200212,056140,康控元大98購01,0.83,0.94,0.82,0.91,+0.08,9.64,952000,48,860220,0,0,0,0,0,0,586000,911000,-325000,-325000
20200212,056141,聯茂元大97購05,1.72,2.14,1.72,2.05,+0.43,26.54,197000,23,388050,0,0,0,0,0,0,65000,155000,-90000,-90000
20200212,056142,超眾元大97購06,0.82,0.90,0.82,0.90,+0.07,8.43,202000,10,175430,0,0,0,0,0,0,55000,172000,-117000,-117000
20200212,056143,訊芯元大97購04,1.29,1.53,1.29,1.51,+0.22,17.05,216000,9,311890,0,0,0,0,0,0,35000,181000,-146000,-146000
20200212,056144,GIS元大98購01,1.30,1.39,1.30,1.39,+0.11,8.59,161000,5,219860,0,0,0,0,0,0,11000,151000,-140000,-140000
20200212,056145,緯穎元大98購03,1.57,1.71,1.49,1.68,+0.08,5.0,311000,26,497360,0,0,0,0,0,0,164000,197000,-33000,-33000
20200212,056146,台虹元大98購01,1.33,1.39,1.33,1.39,+0.14,11.2,176000,4,238200,0,0,0,0,0,0,74000,102000,-28000,-28000
20200212,056147,鴻海日盛97購05,0.68,0.92,0.68,0.91,+0.26,40.0,2365000,30,1885170,0,0,0,0,0,0,2277000,1848000,429000,429000
20200212,056148,臺股指日盛97購03,1.00,1.00,1.00,1.00,0.00,0.00,140000,1,140000,0,0,0,0,0,0,140000,0,140000,140000
20200212,056149,亞光康和97購01,,,,,0.00,0.00,0,0,0,0,0,0,0,0,0,0,0,0,0
20200212,05614P,臺股指康和96售03,,,,,0.00,0.00,0,0,0,0,0,0,0,0,0,0,0,0,0
20200212,056150,台光電凱基98購02,1.14,1.28,1.14,1.22,+0.33,37.08,11000,3,13000,0,0,0,0,0,0,1000,10000,-9000,-9000
20200212,056151,建準凱基97購01,,,,,0.00,0.00,0,0,0,0,0,0,0,0,0,0,0,0,0
20200212,056152,可成凱基97購02,,,,,0.00,0.00,0,0,0,0,0,0,0,0,0,0,0,0,0
20200212,056153,華新科凱基97購02,4.18,4.22,4.18,4.22,+0.14,3.43,7000,3,29340,0,0,0,0,0,0,7000,7000,0,0
20200212,056154,宏達電凱基97購03,1.27,1.27,0.34,1.26,+0.07,5.88,76000,19,86610,0,0,0,0,0,0,66000,10000,56000,56000
20200212,056155,嘉晶凱基97購01,0.64,0.67,0.64,0.67,0.00,0.00,123000,5,80060,0,0,0,0,0,0,0,123000,-123000,-123000
20200212,056156,禾伸堂凱基98購04,1.83,1.86,1.77,1.86,+0.08,4.49,41000,6,73620,0,0,0,0,0,0,13000,28000,-15000,-15000
20200212,056157,聯詠凱基97購03,1.98,2.06,1.97,2.06,+0.23,12.57,40000,5,79180,0,0,0,0,0,0,22000,20000,2000,2000
20200212,056158,新日興凱基98購02,1.06,1.10,1.01,1.01,-0.12,-10.62,105000,10,110880,0,0,0,0,0,0,105000,0,105000,105000
20200212,056159,牧德凱基99購01,0.71,0.80,0.69,0.80,+0.11,15.94,202000,5,139510,0,0,0,0,0,0,201000,0,201000,201000
20200212,05615P,臺股指康和96售04,0.68,0.68,0.67,0.68,-0.10,-12.82,35000,3,23700,0,0,0,0,0,0,15000,20000,-5000,-5000
20200212,056160,智易凱基97購03,0.95,1.05,0.95,1.05,+0.30,40.0,73000,10,75650,0,0,0,0,0,0,0,73000,-73000,-73000
20200212,056161,康控凱基98購02,1.04,1.07,1.04,1.07,+0.11,11.46,11000,2,11740,0,0,0,0,0,0,0,1000,-1000,-1000
20200212,056162,祥碩凱基97購03,3.65,4.61,3.65,4.61,+1.31,39.7,197000,37,787250,0,0,0,0,0,0,26000,188000,-162000,-162000
20200212,056163,嘉聯益凱基98購03,0.82,0.86,0.36,0.85,+0.06,7.59,442000,8,363720,0,0,0,0,0,0,432000,10000,422000,422000
20200212,056164,聯茂凱基98購03,2.42,3.18,2.42,3.18,+1.12,54.37,35000,8,98030,0,0,0,0,0,0,10000,25000,-15000,-15000
20200212,056165,矽力凱基98購02,0.76,0.83,0.76,0.83,+0.09,12.16,58000,3,46280,0,0,0,0,0,0,18000,20000,-2000,-2000
20200212,056166,微星台新97購01,1.26,1.26,1.11,1.13,0.00,0.00,289000,18,335000,0,0,0,0,0,0,218000,71000,147000,147000
20200212,056167,力成台新97購01,,,,,0.00,0.00,0,0,0,0,0,0,0,0,0,0,0,0,0
20200212,056168,鴻海元富97購07,1.94,2.22,1.91,2.22,+0.43,24.02,69000,10,143960,0,0,0,0,0,0,15000,54000,-39000,-39000
20200212,056169,鴻海元富97購08,1.63,1.92,1.63,1.92,+0.41,27.15,75000,13,136250,0,0,0,0,0,0,2000,73000,-71000,-71000
20200212,05616P,台光電永豐96售01,0.69,0.69,0.69,0.69,-0.16,-18.82,10000,1,6900,0,0,0,0,0,0,10000,0,10000,10000
20200212,056170,鴻海元富97購09,2.09,2.36,2.09,2.36,+0.44,22.92,90000,11,198710,0,0,0,0,0,0,27000,70000,-43000,-43000
20200212,056171,鴻海元富97購10,1.91,2.25,1.91,2.25,+0.41,22.28,1861000,57,3838440,0,0,0,0,0,0,650000,1211000,-561000,-561000
20200212,056172,鴻海元富97購11,1.49,1.62,1.49,1.62,+0.34,26.56,24000,3,37660,0,0,0,0,0,0,0,24000,-24000,-24000
20200212,056173,廣達元富97購01,1.40,1.50,1.40,1.50,+0.08,5.63,221000,7,323730,0,0,0,0,0,0,195000,26000,169000,169000
20200212,056174,億光元富97購01,,,,,0.00,0.00,0,0,0,0,0,0,0,0,0,0,0,0,0
20200212,056175,可成元富97購03,1.94,2.08,1.89,2.08,+0.29,16.2,254000,14,513500,0,0,0,0,0,0,10000,244000,-234000,-234000
20200212,056176,創意元富97購01,0.54,0.57,0.49,0.53,-0.08,-13.11,448000,36,230140,0,0,0,0,0,0,356000,139000,217000,217000
20200212,056177,嘉澤元富97購01,1.49,1.53,1.42,1.42,-0.02,-1.39,53000,6,77730,0,0,0,0,0,0,31000,22000,9000,9000
20200212,056178,嘉澤元富97購02,1.59,1.59,1.59,1.59,+0.02,1.27,6000,1,9540,0,0,0,0,0,0,0,6000,-6000,-6000
20200212,056179,康友元富97購02,2.68,2.86,2.68,2.71,+0.01,0.37,408000,29,1121700,0,0,0,0,0,0,56000,369000,-313000,-313000
20200212,05617P,大立光統一97售02,1.05,1.05,0.93,0.93,-0.15,-13.89,648000,17,636130,0,0,0,0,0,0,474000,598000,-124000,-124000
20200212,056180,南茂元富97購01,0.72,0.76,0.71,0.76,+0.01,1.33,128000,19,93790,0,0,0,0,0,0,97000,41000,56000,56000
20200212,056181,百和元富97購02,,,,,0.00,0.00,0,0,0,0,0,0,0,0,0,0,0,0,0
20200212,056182,台光電統一97購03,1.32,1.38,1.32,1.38,+0.20,16.95,110000,3,151300,0,0,0,0,0,0,110000,0,110000,110000
20200212,056183,南亞科統一97購02,,,,,0.00,0.00,0,0,0,0,0,0,0,0,0,0,0,0,0
20200212,056184,南亞科統一97購03,,,,,0.00,0.00,0,0,0,0,0,0,0,0,0,0,0,0,0
20200212,056185,全新統一98購01,0.69,0.81,0.68,0.81,+0.19,30.65,827000,37,610610,0,0,0,0,0,0,327000,478000,-151000,-151000
20200212,056186,智原統一97購01,0.35,0.37,0.35,0.37,+0.03,8.82,155000,21,54450,0,0,0,0,0,0,155000,0,155000,155000
20200212,056187,京鼎統一97購01,0.68,0.79,0.68,0.77,+0.15,24.19,680000,23,501490,0,0,0,0,0,0,37000,638000,-601000,-601000
20200212,056188,晶相光統一99購01,0.44,0.45,0.43,0.43,+0.03,7.5,369000,8,164900,0,0,0,0,0,0,0,369000,-369000,-369000
20200212,056189,樺漢統一97購02,1.05,1.16,1.04,1.16,+0.08,7.41,363000,14,416100,0,0,0,0,0,0,306000,57000,249000,249000
20200212,05618P,聯發科元富96售02,1.59,1.59,1.43,1.48,-0.31,-17.32,395000,18,590660,0,0,0,0,0,0,299000,96000,203000,203000
20200212,056190,昇陽半統一97購01,1.40,1.44,1.39,1.41,-0.01,-0.7,245000,23,347560,0,0,0,0,0,0,207000,38000,169000,169000
20200212,056191,世紀鋼統一97購01,1.48,1.50,1.47,1.50,-0.06,-3.85,486000,15,719010,0,0,0,0,0,0,486000,0,486000,486000
20200212,056192,智邦富邦98購01,0.82,0.83,0.75,0.75,+0.02,2.74,540000,25,416950,0,0,0,0,0,0,55000,483000,-428000,-428000
20200212,056193,聯發科富邦99購08,1.05,1.14,1.03,1.14,+0.17,17.53,1473000,52,1580800,0,0,0,0,0,0,1127000,353000,774000,774000
20200212,056194,聯發科富邦9B購01,1.48,1.62,1.48,1.62,+0.25,18.25,474000,26,740070,0,0,0,0,0,0,323000,159000,164000,164000
20200212,056195,群創富邦98購01,0.75,0.75,0.73,0.73,+0.01,1.39,10000,2,7380,0,0,0,0,0,0,10000,10000,0,0
20200212,056196,聯茂富邦98購02,0.43,0.58,0.43,0.55,+0.14,34.15,778000,22,391250,0,0,0,0,0,0,259000,519000,-260000,-260000
20200212,056197,友訊永豐97購01,0.54,0.54,0.54,0.54,0.00,0.00,68000,1,36720,0,0,0,0,0,0,68000,0,68000,68000
20200212,056198,台光電永豐97購02,0.72,0.88,0.72,0.85,+0.13,18.06,386000,25,317040,0,0,0,0,0,0,124000,344000,-220000,-220000
20200212,056199,美律永豐97購01,0.65,0.73,0.65,0.72,+0.13,22.03,327000,14,221620,0,0,0,0,0,0,1000,326000,-325000,-325000
20200212,05619P,創意元富96售02,1.67,1.75,1.60,1.66,-0.02,-1.19,70000,12,117480,0,0,0,0,0,0,0,70000,-70000,-70000
20200212,056200,大毅永豐98購01,1.45,1.45,1.36,1.40,-0.07,-4.76,421000,38,591520,0,0,0,0,0,0,206000,286000,-80000,-80000
20200212,056201,華新科永豐98購01,1.16,1.16,1.15,1.15,+0.02,1.77,26000,2,30060,0,0,0,0,0,0,16000,10000,6000,6000
20200212,056202,國揚永豐97購01,0.50,0.50,0.48,0.49,+0.01,2.08,244000,5,118520,0,0,0,0,0,0,0,244000,-244000,-244000
20200212,056203,興富發永豐97購01,,,,,0.00,0.00,0,0,0,0,0,0,0,0,0,0,0,0,0
20200212,056204,嘉澤永豐97購01,0.65,0.65,0.57,0.57,-0.04,-6.56,144000,6,85350,0,0,0,0,0,0,25000,119000,-94000,-94000
20200212,056205,貿聯永豐97購01,0.47,0.54,0.47,0.54,+0.06,12.5,40000,4,20860,0,0,0,0,0,0,24000,16000,8000,8000
20200212,056206,泰鼎永豐97購01,1.14,1.25,1.10,1.10,+0.10,10.0,430000,28,515430,0,0,0,0,0,0,18000,412000,-394000,-394000
20200212,056207,茂林永豐97購03,0.66,0.68,0.63,0.67,+0.02,3.08,416000,17,273800,0,0,0,0,0,0,276000,95000,181000,181000
20200212,056208,崇越永豐97購01,0.61,0.64,0.61,0.64,0.00,0.00,614000,7,381230,0,0,0,0,0,0,0,614000,-614000,-614000
20200212,056209,超眾永豐97購02,1.20,1.36,1.20,1.35,+0.08,6.3,534000,41,670420,0,0,0,0,0,0,486000,61000,425000,425000
20200212,05620P,大立光富邦9B售01,0.59,0.59,0.57,0.58,-0.04,-6.45,200000,23,116640,0,0,0,0,0,0,80000,75000,5000,5000
20200212,056210,矽創永豐97購02,0.55,0.72,0.55,0.72,+0.14,24.14,612000,33,388470,0,0,0,0,0,0,327000,285000,42000,42000
20200212,056211,南港國票98購01,1.09,1.26,1.08,1.26,+0.16,14.55,265000,13,317120,0,0,0,0,0,0,29000,236000,-207000,-207000
20200212,056212,台光電國票98購03,2.53,3.05,2.53,3.03,+0.52,20.72,159000,20,441020,0,0,0,0,0,0,44000,115000,-71000,-71000
20200212,056213,建準國票98購02,,,,,0.00,0.00,0,0,0,0,0,0,0,0,0,0,0,0,0
20200212,056214,義隆國票99購01,1.79,1.82,1.78,1.82,+0.22,13.75,247000,7,440180,0,0,0,0,0,0,239000,8000,231000,231000
20200212,056215,華新科國票97購03,,,,,0.00,0.00,0,0,0,0,0,0,0,0,0,0,0,0,0
20200212,056216,智原第一97購01,0.39,0.40,0.39,0.39,0.00,0.00,100000,17,39200,0,0,0,0,0,0,100000,0,100000,100000
20200212,056217,A50正2中信99購02,,,,,0.00,0.00,0,0,0,0,0,0,0,0,0,0,0,0,0
20200212,056218,億光中信98購01,,,,,0.00,0.00,0,0,0,0,0,0,0,0,0,0,0,0,0
20200212,056219,T50反1日盛02購01,0.86,0.86,0.86,0.86,0.00,0.00,1000,1,860,0,0,0,0,0,0,0,1000,-1000,-1000
20200212,05621P,聯電中信96售01,0.85,0.85,0.80,0.80,-0.06,-6.98,191000,44,157380,0,0,0,0,0,0,48000,143000,-95000,-95000
20200212,056220,上証2X凱基99購01,,,,,0.00,0.00,0,0,0,0,0,0,0,0,0,0,0,0,0
20200212,056221,鴻海凱基99購01,0.74,0.79,0.74,0.79,+0.11,16.18,163000,2,124020,0,0,0,0,0,0,68000,95000,-27000,-27000
20200212,056222,台積電凱基9A購01,4.28,4.28,4.28,4.28,+0.32,8.08,2000,1,8560,0,0,0,0,0,0,0,2000,-2000,-2000
20200212,056223,華邦電凱基97購04,,,,,0.00,0.00,0,0,0,0,0,0,0,0,0,0,0,0,0
20200212,056224,聯發科凱基97購08,1.14,1.21,1.14,1.21,+0.26,27.37,15000,3,17430,0,0,0,0,0,0,11000,4000,7000,7000
20200212,056225,聯發科凱基97購09,2.22,2.42,2.22,2.42,+0.41,20.4,12000,6,28840,0,0,0,0,0,0,12000,12000,0,0
20200212,056226,聯發科凱基97購10,1.42,1.42,1.40,1.40,+0.33,30.84,92000,4,129200,0,0,0,0,0,0,72000,24000,48000,48000
20200212,056227,奇力新凱基98購04,0.97,1.01,0.96,1.01,+0.02,2.02,58000,11,56630,0,0,0,0,0,0,40000,12000,28000,28000
20200212,056228,可成凱基97購03,1.53,1.68,1.52,1.66,+0.20,13.7,103000,7,166060,0,0,0,0,0,0,21000,102000,-81000,-81000
20200212,056229,可成凱基97購04,1.67,1.69,0.58,1.69,+0.11,6.96,98000,3,153160,0,0,0,0,0,0,88000,30000,58000,58000
20200212,05622P,台積電中信96售02,,,,,0.00,0.00,0,0,0,0,0,0,0,0,0,0,0,0,0
20200212,056230,可成凱基98購03,1.67,1.70,0.58,1.68,+0.09,5.66,89000,4,139430,0,0,0,0,0,0,70000,39000,31000,31000
20200212,056231,嘉聯益凱基97購02,1.26,1.37,1.26,1.37,+0.13,10.48,71000,10,95370,0,0,0,0,0,0,49000,22000,27000,27000
20200212,056232,瑞儀凱基98購01,0.72,0.73,0.71,0.73,+0.03,4.29,50000,3,36000,0,0,0,0,0,0,10000,40000,-30000,-30000
20200212,056233,超眾凱基97購02,2.64,2.81,2.57,2.81,+0.15,5.64,49000,18,129670,0,0,0,0,0,0,36000,13000,23000,23000
20200212,056234,GIS麥證97購01,0.93,0.95,0.93,0.95,+0.10,11.76,21000,3,19730,1000,20000,-19000,0,0,0,1000,21000,-20000,-20000
20200212,056235,鴻海群益97購07,0.69,0.85,0.69,0.85,+0.19,28.79,231000,4,168070,0,0,0,0,0,0,98000,133000,-35000,-35000
20200212,056236,台積電群益97購06,1.25,1.25,1.16,1.24,+0.10,8.77,2185000,29,2607170,0,0,0,0,0,0,1213000,950000,263000,263000
20200212,056237,智邦群益97購02,3.32,3.37,2.83,2.99,+0.01,0.34,120000,10,388000,0,0,0,0,0,0,81000,39000,42000,42000
20200212,056238,聯發科群益98購02,1.95,2.21,1.93,2.21,+0.41,22.78,245000,7,508680,0,0,0,0,0,0,141000,104000,37000,37000
20200212,056239,宏達電群益98購01,0.85,0.85,0.84,0.85,+0.02,2.41,210000,4,177490,0,0,0,0,0,0,188000,22000,166000,166000
20200212,05623P,台積電中信96售03,,,,,0.00,0.00,0,0,0,0,0,0,0,0,0,0,0,0,0
20200212,056240,嘉晶群益97購02,0.61,0.75,0.61,0.70,+0.08,12.9,842000,51,584080,0,0,0,0,0,0,224000,618000,-394000,-394000
20200212,056241,緯創群益97購01,1.16,1.18,1.16,1.18,+0.04,3.51,22000,2,25740,0,0,0,0,0,0,11000,11000,0,0
20200212,056242,緯創群益9A購01,1.05,1.11,1.05,1.10,+0.05,4.76,101000,6,110560,0,0,0,0,0,0,75000,26000,49000,49000
20200212,056243,創意群益97購03,1.81,1.97,1.73,1.90,-0.24,-11.21,477000,30,894240,0,0,0,0,0,0,346000,291000,55000,55000
20200212,056244,群創群益98購09,0.85,0.85,0.83,0.84,+0.01,1.2,70000,6,58810,0,0,0,0,0,0,70000,20000,50000,50000
20200212,056245,嘉澤群益97購01,1.73,1.78,1.72,1.72,0.00,0.00,152000,7,266860,0,0,0,0,0,0,128000,24000,104000,104000
20200212,056246,祥碩群益97購01,4.60,5.00,4.60,5.00,+0.77,18.2,195000,23,958020,0,0,0,0,0,0,6000,195000,-189000,-189000
20200212,056247,台郡群益97購01,1.40,1.44,1.33,1.42,+0.53,59.55,189000,27,266190,0,0,0,0,0,0,109000,80000,29000,29000
20200212,056248,康友群益97購04,4.08,4.37,4.08,4.37,+0.27,6.59,51000,7,217400,0,0,0,0,0,0,15000,46000,-31000,-31000
20200212,056249,鴻海兆豐97購05,0.77,0.77,0.77,0.77,+0.05,6.94,104000,1,80080,0,0,0,0,0,0,0,104000,-104000,-104000
20200212,05624P,同欣電中信98售01,,,,,0.00,0.00,0,0,0,0,0,0,0,0,0,0,0,0,0
20200212,056250,瑞昱兆豐97購02,0.71,0.80,0.71,0.77,+0.06,8.45,679000,15,524630,0,0,0,0,0,0,143000,536000,-393000,-393000
20200212,056251,聯發科兆豐97購02,,,,,0.00,0.00,0,0,0,0,0,0,0,0,0,0,0,0,0
20200212,056252,聯發科兆豐97購03,0.86,0.92,0.86,0.92,0.00,0.00,182000,3,164440,0,0,0,0,0,0,5000,177000,-172000,-172000
20200212,056253,京鼎兆豐98購01,0.53,0.57,0.53,0.57,+0.09,18.75,97000,5,53570,0,0,0,0,0,0,0,97000,-97000,-97000
20200212,056254,為升元富97購01,0.86,0.86,0.86,0.86,-0.02,-2.27,58000,1,49880,0,0,0,0,0,0,0,58000,-58000,-58000
20200212,056255,華新科元富97購05,2.85,2.86,2.68,2.77,+0.14,5.32,967000,57,2676180,0,0,0,0,0,0,927000,31000,896000,896000
20200212,056256,聯茂元富97購03,0.96,1.15,0.96,1.07,+0.21,24.42,194000,17,207120,0,0,0,0,0,0,106000,154000,-48000,-48000
20200212,056257,聯茂元富97購04,1.06,1.29,1.06,1.22,+0.28,29.79,222000,26,267160,0,0,0,0,0,0,139000,183000,-44000,-44000
20200212,056258,訊芯元富97購04,0.62,0.63,0.62,0.63,0.00,0.00,12000,2,7500,0,0,0,0,0,0,0,12000,-12000,-12000
20200212,056259,T50反1統一9A購01,,,,,0.00,0.00,0,0,0,0,0,0,0,0,0,0,0,0,0
20200212,05625P,國巨國票97售01,0.51,0.51,0.51,0.51,-0.06,-10.53,40000,1,20400,0,0,0,0,0,0,40000,0,40000,40000
20200212,056260,鴻海統一98購07,0.81,0.81,0.81,0.81,+0.04,5.19,48000,1,38880,0,0,0,0,0,0,0,48000,-48000,-48000
20200212,056261,台積電統一97購07,,,,,0.00,0.00,0,0,0,0,0,0,0,0,0,0,0,0,0
20200212,056262,台積電統一98購04,,,,,0.00,0.00,0,0,0,0,0,0,0,0,0,0,0,0,0
20200212,056263,友訊統一99購01,1.16,1.16,1.16,1.16,0.00,0.00,48000,2,55680,0,0,0,0,0,0,48000,0,48000,48000
20200212,056264,聯發科統一98購02,1.27,1.38,1.27,1.38,+0.29,26.61,146000,4,192840,0,0,0,0,0,0,48000,98000,-50000,-50000
20200212,056265,國泰金統一97購01,0.87,0.93,0.87,0.93,+0.05,5.68,358000,18,322750,0,0,0,0,0,0,358000,0,358000,358000
20200212,056266,開發金統一9A購01,1.01,1.01,1.01,1.01,-0.04,-3.81,205000,3,207050,0,0,0,0,0,0,205000,0,205000,205000
20200212,056267,文曄統一97購02,1.40,1.48,1.40,1.48,+0.06,4.23,196000,7,278870,0,0,0,0,0,0,0,196000,-196000,-196000
20200212,056268,新日興統一97購01,2.14,2.14,2.07,2.12,-0.11,-4.93,135000,16,284250,0,0,0,0,0,0,130000,5000,125000,125000
20200212,056269,新日興統一98購01,1.74,1.77,1.66,1.71,-0.05,-2.84,443000,27,752680,0,0,0,0,0,0,423000,20000,403000,403000
20200212,05626P,景碩國票97售03,2.16,2.18,2.13,2.18,0.00,0.00,50000,6,107950,0,0,0,0,0,0,30000,20000,10000,10000
20200212,056270,群創統一98購04,0.82,0.82,0.79,0.79,0.00,0.00,315000,10,249470,0,0,0,0,0,0,17000,298000,-281000,-281000
20200212,056271,嘉澤統一97購01,1.71,1.80,1.71,1.80,+0.15,9.09,73000,4,128700,0,0,0,0,0,0,57000,16000,41000,41000
20200212,056272,嘉澤統一99購01,1.93,1.93,1.77,1.77,-0.08,-4.32,35000,3,64350,0,0,0,0,0,0,0,35000,-35000,-35000
20200212,056273,祥碩統一97購02,3.80,4.26,3.80,4.26,+0.76,21.71,287000,20,1151080,0,0,0,0,0,0,76000,201000,-125000,-125000
20200212,056274,彩晶統一98購02,,,,,0.00,0.00,0,0,0,0,0,0,0,0,0,0,0,0,0
20200212,056275,國巨國泰98購04,3.56,3.70,3.51,3.66,+0.24,7.02,874000,39,3156360,0,0,0,0,0,0,447000,410000,37000,37000
20200212,056276,同欣電國泰98購01,1.37,1.53,1.33,1.53,+0.19,14.18,68000,22,97600,0,0,0,0,0,0,22000,46000,-24000,-24000
20200212,056277,上銀富邦99購02,1.32,1.32,1.25,1.27,0.00,0.00,811000,43,1044720,0,0,0,0,0,0,651000,159000,492000,492000
20200212,056278,全新富邦98購02,0.44,0.54,0.43,0.53,+0.13,32.5,716000,38,335470,0,0,0,0,0,0,342000,374000,-32000,-32000
20200212,056279,新日興富邦99購01,0.84,0.85,0.81,0.81,-0.05,-5.81,128000,25,105950,0,0,0,0,0,0,80000,48000,32000,32000
20200212,05627P,致伸國票97售01,,,,,0.00,0.00,0,0,0,0,0,0,0,0,0,0,0,0,0
20200212,056280,上証2X永豐98購01,,,,,0.00,0.00,0,0,0,0,0,0,0,0,0,0,0,0,0
20200212,056281,深中小永豐97購01,1.60,1.60,1.60,1.60,+0.07,4.58,44000,1,70400,0,0,0,0,0,0,44000,0,44000,44000
20200212,056282,S&P反1永豐97購01,,,,,0.00,0.00,0,0,0,0,0,0,0,0,0,0,0,0,0
20200212,056283,鴻海永豐97購03,,,,,0.00,0.00,0,0,0,0,0,0,0,0,0,0,0,0,0
20200212,056284,台積電永豐97購06,0.86,0.86,0.86,0.86,+0.08,10.26,68000,1,58480,0,0,0,0,0,0,0,68000,-68000,-68000
20200212,056285,可成永豐97購02,0.61,0.61,0.61,0.61,+0.12,24.49,15000,1,9150,0,0,0,0,0,0,15000,0,15000,15000
20200212,056286,奇鋐永豐97購01,0.58,0.66,0.58,0.66,0.00,0.00,91000,4,57530,0,0,0,0,0,0,2000,89000,-87000,-87000
20200212,056287,亞光永豐97購02,1.33,1.55,1.33,1.52,+0.20,15.15,112000,20,163560,0,0,0,0,0,0,63000,89000,-26000,-26000
20200212,056288,健鼎永豐97購01,0.72,0.92,0.72,0.91,+0.23,33.82,1338000,33,1100700,0,0,0,0,0,0,159000,1179000,-1020000,-1020000
20200212,056289,合勤控永豐97購01,,,,,0.00,0.00,0,0,0,0,0,0,0,0,0,0,0,0,0
20200212,05628P,茂林國票97售02,,,,,0.00,0.00,0,0,0,0,0,0,0,0,0,0,0,0,0
20200212,056290,正文永豐98購01,0.84,0.87,0.84,0.87,+0.02,2.35,91000,5,76910,0,0,0,0,0,0,84000,7000,77000,77000
20200212,056291,聯茂永豐97購03,0.84,1.11,0.84,1.04,+0.23,28.4,1103000,36,1082880,0,0,0,0,0,0,559000,544000,15000,15000
20200212,056292,統一元大97購01,2.77,2.77,2.75,2.75,-0.04,-1.43,48000,4,132120,0,0,0,0,0,0,28000,43000,-15000,-15000
20200212,056293,上銀元大97購10,2.75,2.75,2.60,2.63,+0.05,1.94,146000,12,390530,0,0,0,0,0,0,71000,96000,-25000,-25000
20200212,056294,上銀元大97購11,2.08,2.08,1.99,1.99,+0.04,2.05,215000,16,440080,0,0,0,0,0,0,66000,152000,-86000,-86000
20200212,056295,國巨元大97購16,4.87,4.87,4.71,4.77,+0.22,4.84,42000,9,200640,0,0,0,0,0,0,38000,6000,32000,32000
20200212,056296,旺宏元大97購07,1.45,1.52,1.43,1.43,-0.03,-2.05,82000,7,121100,0,0,0,0,0,0,44000,42000,2000,2000
20200212,056297,台光電元大97購04,0.95,1.20,0.95,1.12,+0.17,17.89,478000,52,519050,0,0,0,0,0,0,187000,444000,-257000,-257000
20200212,056298,億光元大97購02,1.39,1.44,1.39,1.42,+0.04,2.9,122000,7,170670,0,0,0,0,0,0,122000,0,122000,122000
20200212,056299,友達元大9B購04,2.04,2.04,1.98,2.01,-0.13,-6.07,96000,8,194530,0,0,0,0,0,0,56000,96000,-40000,-40000
20200212,05629P,聯發科永昌99售02,,,,,0.00,0.00,0,0,0,0,0,0,0,0,0,0,0,0,0
20200212,056300,聯發科元大97購23,2.17,2.36,2.14,2.33,+0.37,18.88,508000,30,1148220,0,0,0,0,0,0,483000,325000,158000,158000
20200212,056301,開發金元大9A購01,,,,,0.00,0.00,0,0,0,0,0,0,0,0,0,0,0,0,0
20200212,056302,大立光元大97購17,2.18,2.18,2.18,2.18,0.00,0.00,50000,2,109000,0,0,0,0,0,0,0,50000,-50000,-50000
20200212,056303,亞光元大97購04,1.09,1.20,1.09,1.20,0.00,0.00,182000,15,213210,0,0,0,0,0,0,99000,82000,17000,17000
20200212,056304,創意元大97購03,1.11,1.16,1.05,1.13,-0.12,-9.6,31000,4,34060,0,0,0,0,0,0,20000,21000,-1000,-1000
20200212,056305,群創元大9A購03,1.80,1.81,1.77,1.77,0.00,0.00,1305000,44,2337510,0,0,0,0,0,0,735000,705000,30000,30000
20200212,056306,晶相光元大98購01,1.32,1.40,1.32,1.34,+0.06,4.69,313000,10,424540,0,0,0,0,0,0,63000,266000,-203000,-203000
20200212,056307,貿聯元大97購05,1.27,1.48,1.25,1.46,+0.21,16.8,1170000,82,1626850,0,0,0,0,0,0,978000,21000,957000,957000
20200212,056308,TPK元大97購02,1.54,1.72,1.54,1.71,+0.12,7.55,289000,20,471570,0,0,0,0,0,0,167000,133000,34000,34000
20200212,056309,合勤控元大97購01,1.43,1.43,1.43,1.43,+0.03,2.14,68000,1,97240,0,0,0,0,0,0,68000,0,68000,68000
20200212,05630P,大立光永昌96售06,2.22,2.22,2.06,2.07,-0.22,-9.61,127000,16,267930,0,0,0,0,0,0,127000,100000,27000,27000
20200212,056310,神達元大97購02,1.88,2.07,1.88,2.02,0.00,0.00,959000,92,1934380,0,0,0,0,0,0,63000,959000,-896000,-896000
20200212,056311,泰鼎元大98購01,1.54,1.73,1.54,1.55,+0.10,6.9,1251000,59,2075470,0,0,0,0,0,0,951000,421000,530000,530000
20200212,056312,茂林元大98購01,1.13,1.15,1.08,1.13,+0.02,1.8,3311000,213,3745720,0,0,0,0,0,0,184000,3067000,-2883000,-2883000
20200212,056313,聯茂元大98購01,1.20,1.51,1.20,1.37,+0.23,20.18,660000,53,921130,0,0,0,0,0,0,229000,581000,-352000,-352000
20200212,056314,力成元大97購01,3.13,3.45,3.13,3.45,+0.55,18.97,45000,6,150250,0,0,0,0,0,0,1000,44000,-43000,-43000
20200212,056315,同欣電元大97購05,1.12,1.24,1.09,1.10,+0.02,1.85,870000,53,1018210,0,0,0,0,0,0,553000,572000,-19000,-19000
20200212,056316,訊芯元大98購03,0.83,0.95,0.83,0.95,+0.13,15.85,222000,6,197930,0,0,0,0,0,0,11000,211000,-200000,-200000
20200212,056317,華通群益99購02,0.70,0.95,0.70,0.95,+0.27,39.71,19000,6,16300,0,0,0,0,0,0,0,19000,-19000,-19000
20200212,056318,鴻海群益98購02,0.96,1.11,0.96,1.11,+0.18,19.35,414000,10,412900,0,0,0,0,0,0,27000,387000,-360000,-360000
20200212,056319,智原群益98購02,0.40,0.40,0.40,0.40,0.00,0.00,33000,1,13200,0,0,0,0,0,0,33000,0,33000,33000
20200212,05631P,國巨富邦9A售01,0.53,0.54,0.52,0.52,-0.03,-5.45,302000,7,160060,0,0,0,0,0,0,172000,20000,152000,152000
20200212,056320,京鼎群益99購01,1.63,1.81,1.62,1.81,+0.33,22.3,415000,16,719120,0,0,0,0,0,0,311000,104000,207000,207000
20200212,056321,創意群益98購02,1.53,1.59,1.43,1.59,-0.17,-9.66,503000,31,778560,0,0,0,0,0,0,358000,304000,54000,54000
20200212,056322,臺股指群益98購01,,,,,0.00,0.00,0,0,0,0,0,0,0,0,0,0,0,0,0
20200212,056323,旺宏兆豐98購01,,,,,0.00,0.00,0,0,0,0,0,0,0,0,0,0,0,0,0
20200212,056324,南亞科兆豐98購01,,,,,0.00,0.00,0,0,0,0,0,0,0,0,0,0,0,0,0
20200212,056325,群創兆豐9A購01,1.00,1.01,1.00,1.00,+0.01,1.01,25000,3,25110,0,0,0,0,0,0,25000,0,25000,25000
20200212,056326,TPK兆豐98購01,0.65,0.73,0.64,0.73,+0.08,12.31,610000,32,411130,0,0,0,0,0,0,455000,155000,300000,300000
20200212,056327,樺漢兆豐98購01,1.22,1.26,1.22,1.26,+0.08,6.78,40000,4,50000,0,0,0,0,0,0,10000,30000,-20000,-20000
20200212,056328,訊芯兆豐98購01,0.78,0.87,0.77,0.87,+0.12,16.0,969000,22,799920,0,0,0,0,0,0,362000,607000,-245000,-245000
20200212,056329,上銀國票98購02,2.80,2.80,2.66,2.66,0.00,0.00,8000,2,21840,0,0,0,0,0,0,0,8000,-8000,-8000
20200212,05632P,大立光群益96售02,,,,,0.00,0.00,0,0,0,0,0,0,0,0,0,0,0,0,0
20200212,056330,玉晶光國票99購03,1.86,1.86,1.86,1.86,+0.08,4.49,20000,1,37200,0,0,0,0,0,0,20000,0,20000,20000
20200212,056331,聯鈞國票99購01,0.77,0.89,0.77,0.89,0.00,0.00,633000,20,517670,0,0,0,0,0,0,128000,518000,-390000,-390000
20200212,056332,台郡國票99購01,3.52,3.54,3.42,3.54,+1.11,45.68,65000,13,227330,0,0,0,0,0,0,26000,38000,-12000,-12000
20200212,056333,台積電日盛9B購01,2.77,2.82,2.77,2.82,+0.23,8.88,586000,4,1623270,0,0,0,0,0,0,585000,576000,9000,9000
20200212,056334,台積電凱基98購06,3.77,3.99,3.77,3.99,0.00,0.00,2000,2,7760,0,0,0,0,0,0,0,2000,-2000,-2000
20200212,056335,微星凱基98購01,1.27,1.27,0.54,1.17,-0.02,-1.68,320000,21,384140,0,0,0,0,0,0,300000,165000,135000,135000
20200212,056336,南亞科凱基98購02,1.85,1.85,1.85,1.85,0.00,0.00,43000,1,79550,0,0,0,0,0,0,43000,0,43000,43000
20200212,056337,聯發科凱基98購06,1.42,1.50,1.42,1.50,+0.35,30.43,19000,4,27640,0,0,0,0,0,0,13000,9000,4000,4000
20200212,056338,聯發科凱基99購01,2.68,2.89,2.66,2.89,+0.49,20.42,42000,12,115240,0,0,0,0,0,0,42000,15000,27000,27000
20200212,056339,聯發科凱基99購02,2.58,2.85,2.55,2.85,+0.53,22.84,107000,14,290910,0,0,0,0,0,0,98000,23000,75000,75000
20200212,05633P,台表科群益96售04,2.96,2.96,2.81,2.81,-0.24,-7.87,44000,4,127140,0,0,0,0,0,0,42000,2000,40000,40000
20200212,056340,可成凱基98購04,2.33,2.52,2.32,2.52,+0.30,13.51,78000,6,190830,0,0,0,0,0,0,20000,78000,-58000,-58000
20200212,056341,宏達電凱基9A購01,0.56,0.56,0.55,0.55,+0.03,5.77,37000,3,20400,0,0,0,0,0,0,0,37000,-37000,-37000
20200212,056342,中工凱基98購01,,,,,0.00,0.00,0,0,0,0,0,0,0,0,0,0,0,0,0
20200212,056343,高鐵凱基98購02,,,,,0.00,0.00,0,0,0,0,0,0,0,0,0,0,0,0,0
20200212,056344,嘉晶凱基98購02,0.91,0.94,0.91,0.94,0.00,0.00,204000,7,186670,0,0,0,0,0,0,0,204000,-204000,-204000
20200212,056345,嘉聯益凱基99購01,0.68,0.70,0.33,0.70,+0.04,6.06,325000,8,217500,0,0,0,0,0,0,315000,10000,305000,305000
20200212,056346,聯茂凱基99購02,0.68,0.76,0.25,0.73,+0.22,43.14,203000,6,139260,0,0,0,0,0,0,68000,135000,-67000,-67000
20200212,056347,GIS凱基9A購01,,,,,0.00,0.00,0,0,0,0,0,0,0,0,0,0,0,0,0
20200212,056348,S&P反1元大9A購01,,,,,0.00,0.00,0,0,0,0,0,0,0,0,0,0,0,0,0
20200212,056349,道瓊銀元大9B購01,,,,,0.00,0.00,0,0,0,0,0,0,0,0,0,0,0,0,0
20200212,05634P,玉晶光台新97售01,,,,,0.00,0.00,0,0,0,0,0,0,0,0,0,0,0,0,0
20200212,056350,上銀元大98購02,2.56,2.56,2.38,2.40,+0.04,1.69,109000,11,275590,0,0,0,0,0,0,57000,63000,-6000,-6000
20200212,056351,鴻海元大98購06,1.82,1.98,1.82,1.98,+0.33,20.0,65000,5,119500,0,0,0,0,0,0,0,65000,-65000,-65000
20200212,056352,鴻海元大99購01,2.00,2.24,2.00,2.24,+0.38,20.43,101000,6,208060,0,0,0,0,0,0,67000,34000,33000,33000
20200212,056353,鴻海元大99購02,1.47,1.64,1.45,1.64,+0.26,18.84,149000,13,228260,0,0,0,0,0,0,25000,122000,-97000,-97000
20200212,056354,國巨元大98購10,5.40,5.40,5.40,5.40,+0.10,1.89,33000,1,178200,0,0,0,0,0,0,33000,33000,0,0
20200212,056355,台積電元大98購08,,,,,0.00,0.00,0,0,0,0,0,0,0,0,0,0,0,0,0
20200212,056356,台積電元大99購01,1.75,1.81,1.72,1.79,+0.09,5.29,353000,19,622920,0,0,0,0,0,0,258000,95000,163000,163000
20200212,056357,台積電元大9A購01,2.41,2.47,2.41,2.47,+0.15,6.47,150000,3,366500,0,0,0,0,0,0,100000,100000,0,0
20200212,056358,友訊元大99購01,1.64,1.64,1.64,1.64,0.00,0.00,4000,1,6560,0,0,0,0,0,0,4000,0,4000,4000
20200212,056359,旺宏元大9A購01,1.37,1.41,1.33,1.33,-0.04,-2.92,226000,17,312130,0,0,0,0,0,0,97000,136000,-39000,-39000
20200212,05635P,健策台新96售02,0.56,0.56,0.56,0.56,0.00,0.00,10000,1,5600,0,0,0,0,0,0,0,10000,-10000,-10000
20200212,056360,智邦元大98購01,2.96,3.11,2.64,2.78,+0.12,4.51,118000,23,341110,0,0,0,0,0,0,81000,69000,12000,12000
20200212,056361,美律元大99購02,0.75,0.85,0.74,0.84,+0.14,20.0,616000,44,490380,0,0,0,0,0,0,82000,540000,-458000,-458000
20200212,056362,聯發科元大99購01,1.62,1.73,1.60,1.71,+0.21,14.0,1134000,52,1881880,0,0,0,0,0,0,690000,480000,210000,210000
20200212,056363,華新科元大99購04,3.68,3.68,3.59,3.63,+0.07,1.97,125000,19,453880,0,0,0,0,0,0,62000,100000,-38000,-38000
20200212,056364,亞光元大99購02,0.88,0.96,0.88,0.96,0.00,0.00,350000,5,320000,0,0,0,0,0,0,0,350000,-350000,-350000
20200212,056365,欣興元大98購01,2.60,3.22,2.60,3.17,+0.61,23.83,202000,40,593330,0,0,0,0,0,0,111000,187000,-76000,-76000
20200212,056366,玉晶光元大99購04,2.82,3.01,2.82,3.01,+0.34,12.73,65000,8,190150,0,0,0,0,0,0,1000,64000,-63000,-63000
20200212,056367,祥碩元大98購01,5.30,6.45,5.30,6.45,+1.49,30.04,152000,33,865650,0,0,0,0,0,0,69000,142000,-73000,-73000
20200212,056368,祥碩元大98購02,4.42,5.25,4.40,5.10,+0.97,23.49,282000,42,1323570,0,0,0,0,0,0,108000,267000,-159000,-159000
20200212,056369,彩晶元大01購01,,,,,0.00,0.00,0,0,0,0,0,0,0,0,0,0,0,0,0
20200212,05636P,國巨永豐96售03,0.49,0.49,0.48,0.48,-0.03,-5.88,150000,2,73000,0,0,0,0,0,0,0,150000,-150000,-150000
20200212,056370,台郡元大98購03,1.63,1.66,1.55,1.63,+0.53,48.18,432000,5,693520,0,0,0,0,0,0,417000,65000,352000,352000
20200212,056371,樺漢元大98購03,1.73,1.78,1.70,1.78,+0.11,6.59,155000,10,270400,0,0,0,0,0,0,42000,148000,-106000,-106000
20200212,056372,訊芯元大98購04,0.75,0.84,0.75,0.84,+0.10,13.51,153000,4,122320,0,0,0,0,0,0,2000,151000,-149000,-149000
20200212,056373,上銀統一99購02,1.29,1.29,1.23,1.23,+0.01,0.82,187000,4,235830,0,0,0,0,0,0,55000,132000,-77000,-77000
20200212,056374,聯發科統一9B購01,1.75,1.90,1.75,1.89,+0.26,15.95,204000,7,371700,0,0,0,0,0,0,111000,93000,18000,18000
20200212,056375,玉晶光統一01購01,1.08,1.11,1.07,1.11,+0.08,7.77,190000,6,206650,0,0,0,0,0,0,20000,170000,-150000,-150000
20200212,056376,玉晶光統一98購01,1.29,1.39,1.29,1.36,+0.13,10.57,574000,21,762780,0,0,0,0,0,0,58000,516000,-458000,-458000
20200212,056377,智伸科統一9A購01,0.49,0.49,0.49,0.49,0.00,0.00,10000,1,4900,0,0,0,0,0,0,0,10000,-10000,-10000
20200212,056378,欣興元富98購01,2.09,2.50,2.09,2.50,+0.49,24.38,370000,21,843510,0,0,0,0,0,0,100000,270000,-170000,-170000
20200212,056379,玉晶光元富98購01,3.57,3.75,3.57,3.75,+0.26,7.45,33000,4,121810,0,0,0,0,0,0,3000,30000,-27000,-27000
20200212,05637P,聯電元大96售04,0.83,0.83,0.79,0.80,-0.04,-4.76,160000,9,128820,0,0,0,0,0,0,69000,91000,-22000,-22000
20200212,056380,麗豐元富98購01,1.14,1.21,1.11,1.21,+0.12,11.01,271000,15,310010,0,0,0,0,0,0,210000,61000,149000,149000
20200212,056381,台虹元富98購01,0.99,1.02,0.99,1.02,+0.09,9.68,163000,13,164370,0,0,0,0,0,0,109000,54000,55000,55000
20200212,056382,道瓊反國泰9A購01,,,,,0.00,0.00,0,0,0,0,0,0,0,0,0,0,0,0,0
20200212,056383,上銀國泰99購01,,,,,0.00,0.00,0,0,0,0,0,0,0,0,0,0,0,0,0
20200212,056384,玉晶光國泰9A購02,1.34,1.42,1.32,1.41,+0.14,11.02,1671000,30,2294880,0,0,0,0,0,0,304000,1442000,-1138000,-1138000
20200212,056385,創意國泰99購01,1.59,1.68,1.52,1.63,-0.14,-7.91,420000,32,664650,0,0,0,0,0,0,362000,58000,304000,304000
20200212,056386,TPK國泰99購01,1.65,1.83,1.65,1.83,+0.19,11.59,411000,53,716360,0,0,0,0,0,0,224000,243000,-19000,-19000
20200212,056387,智伸科國泰99購01,,,,,0.00,0.00,0,0,0,0,0,0,0,0,0,0,0,0,0
20200212,056388,勤誠國泰99購01,1.00,1.01,0.94,0.99,+0.04,4.21,207000,6,206620,0,0,0,0,0,0,182000,25000,157000,157000
20200212,056389,鴻海富邦99購01,0.64,0.64,0.64,0.64,0.00,0.00,6000,1,3840,0,0,0,0,0,0,0,6000,-6000,-6000
20200212,05638P,國巨統一96售04,0.79,0.87,0.79,0.80,-0.10,-11.11,1640000,141,1354110,0,0,0,0,0,0,731000,1396000,-665000,-665000
20200212,056390,台積電富邦9B購01,0.82,0.84,0.81,0.84,+0.04,5.0,557000,15,459120,0,0,0,0,0,0,416000,24000,392000,392000
20200212,056391,大立光富邦9C購01,0.46,0.50,0.46,0.50,+0.06,13.64,115000,10,55410,0,0,0,0,0,0,75000,40000,35000,35000
20200212,056392,玉晶光富邦9C購01,0.72,0.76,0.72,0.75,+0.07,10.29,301000,7,218840,0,0,0,0,0,0,10000,291000,-281000,-281000
20200212,056393,精元永豐98購01,,,,,0.00,0.00,0,0,0,0,0,0,0,0,0,0,0,0,0
20200212,056394,晶豪科永豐98購01,1.25,1.28,1.24,1.28,+0.13,11.3,187000,10,234960,0,0,0,0,0,0,0,187000,-187000,-187000
20200212,056395,玉晶光永豐9B購01,1.20,1.30,1.20,1.29,+0.15,13.16,159000,6,200090,0,0,0,0,0,0,82000,77000,5000,5000
20200212,056396,祥碩永豐98購01,1.75,2.31,1.75,2.29,+0.63,37.95,677000,24,1355460,0,0,0,0,0,0,413000,17000,396000,396000
20200212,056397,彩晶永豐99購01,,,,,0.00,0.00,0,0,0,0,0,0,0,0,0,0,0,0,0
20200212,056398,南茂永豐98購01,1.40,1.45,1.36,1.44,0.00,0.00,585000,26,821460,0,0,0,0,0,0,292000,293000,-1000,-1000
20200212,056399,上証2X群益9C購01,2.50,2.50,2.50,2.50,0.00,0.00,4000,1,10000,0,0,0,0,0,0,0,4000,-4000,-4000
20200212,05639P,欣興統一97售01,2.21,2.21,2.05,2.08,-0.21,-9.17,65000,6,137150,0,0,0,0,0,0,20000,45000,-25000,-25000
20200212,056400,道瓊反群益9C購01,0.83,0.83,0.82,0.82,0.00,0.00,3000,3,2470,0,0,0,0,0,0,3000,0,3000,3000
20200212,056401,國巨群益98購07,6.00,6.10,6.00,6.05,+0.50,9.01,6000,3,36200,0,0,0,0,0,0,6000,4000,2000,2000
20200212,056402,智易群益98購02,2.35,2.92,2.35,2.80,+0.45,19.15,758000,49,2017150,0,0,0,0,0,0,87000,735000,-648000,-648000
20200212,056403,茂林群益98購01,2.10,2.18,2.02,2.13,+0.09,4.41,609000,50,1297180,0,0,0,0,0,0,377000,350000,27000,27000
20200212,056404,嘉聯益群益9A購01,1.60,1.70,1.60,1.63,+0.08,5.16,17000,3,27620,0,0,0,0,0,0,14000,3000,11000,11000
20200212,056405,聯茂群益98購01,3.80,4.93,3.80,4.93,+1.50,43.73,236000,19,999120,0,0,0,0,0,0,180000,56000,124000,124000
20200212,056406,建準國票99購01,2.22,2.22,2.22,2.22,+0.04,1.83,20000,1,44400,0,0,0,0,0,0,20000,0,20000,20000
20200212,056407,嘉晶國票99購01,3.63,4.01,3.63,4.01,+0.43,12.01,85000,11,325110,0,0,0,0,0,0,30000,55000,-25000,-25000
20200212,056408,奇鋐國票99購01,1.45,1.46,1.45,1.46,-0.01,-0.68,61000,2,88650,0,0,0,0,0,0,61000,0,61000,61000
20200212,056409,麗豐國票99購01,2.15,2.33,2.15,2.27,+0.06,2.71,500000,13,1087180,0,0,0,0,0,0,34000,466000,-432000,-432000
20200212,05640P,旺宏元富96售03,,,,,0.00,0.00,0,0,0,0,0,0,0,0,0,0,0,0,0
20200212,056410,康控國票99購01,3.77,4.15,3.74,4.15,+0.50,13.7,110000,11,442200,0,0,0,0,0,0,36000,74000,-38000,-38000
20200212,056411,緯穎國票99購01,4.45,4.97,4.45,4.95,+0.66,15.38,116000,15,547750,0,0,0,0,0,0,35000,81000,-46000,-46000
20200212,056412,上証2X中信9A購02,1.67,1.67,1.67,1.67,0.00,0.00,1000,1,1670,0,0,0,0,0,0,1000,0,1000,1000
20200212,056413,上証反中信9A購01,0.46,0.46,0.45,0.45,-0.01,-2.17,90000,3,40600,0,0,0,0,0,0,80000,10000,70000,70000
20200212,056414,國巨中信98購02,1.24,1.26,1.21,1.26,+0.11,9.57,73000,14,89650,0,0,0,0,0,0,60000,13000,47000,47000
20200212,056415,聯發科中信98購04,0.84,0.87,0.84,0.87,+0.08,10.13,92000,3,79580,0,0,0,0,0,0,22000,70000,-48000,-48000
20200212,056416,華新科中信98購01,1.17,1.18,1.14,1.15,+0.02,1.77,203000,20,233800,0,0,0,0,0,0,68000,135000,-67000,-67000
20200212,056417,欣興中信98購01,0.74,0.74,0.74,0.74,+0.04,5.71,122000,1,90280,0,0,0,0,0,0,0,122000,-122000,-122000
20200212,056418,台光電元富98購01,1.40,1.75,1.40,1.67,+0.29,21.01,436000,20,688820,0,0,0,0,0,0,153000,310000,-157000,-157000
20200212,056419,欣興元富98購02,2.92,3.56,2.92,3.56,+0.59,19.87,427000,30,1390660,0,0,0,0,0,0,111000,360000,-249000,-249000
20200212,05641P,貿聯元富96售02,2.42,2.42,2.42,2.42,-0.04,-1.63,10000,1,24200,0,0,0,0,0,0,10000,0,10000,10000
20200212,056420,台表科元富98購01,0.89,0.98,0.89,0.98,+0.09,10.11,227000,11,208390,0,0,0,0,0,0,113000,114000,-1000,-1000
20200212,056421,鴻海統一98購08,1.56,1.73,1.56,1.73,+0.18,11.61,168000,11,269290,0,0,0,0,0,0,72000,96000,-24000,-24000
20200212,056422,全新統一98購02,1.80,2.06,1.80,2.06,+0.37,21.89,179000,10,351520,0,0,0,0,0,0,179000,0,179000,179000
20200212,056423,奇鋐統一98購01,1.00,1.09,0.99,1.06,+0.04,3.92,517000,14,543010,0,0,0,0,0,0,80000,449000,-369000,-369000
20200212,056424,泰碩統一98購01,1.72,1.76,1.70,1.70,-0.05,-2.86,365000,15,629700,0,0,0,0,0,0,113000,252000,-139000,-139000
20200212,056425,聯發科日盛9A購01,2.21,2.41,2.21,2.41,+0.36,17.56,54000,7,123430,0,0,0,0,0,0,23000,31000,-8000,-8000
20200212,056426,上証2X凱基9A購01,2.98,2.98,2.98,2.98,+0.03,1.02,2000,1,5960,0,0,0,0,0,0,0,2000,-2000,-2000
20200212,056427,上銀凱基98購03,,,,,0.00,0.00,0,0,0,0,0,0,0,0,0,0,0,0,0
20200212,056428,台達電凱基99購01,1.71,1.77,1.71,1.77,+0.09,5.36,194000,8,335310,0,0,0,0,0,0,90000,104000,-14000,-14000
20200212,056429,華通凱基98購02,2.13,2.70,2.13,2.64,+0.55,26.32,147000,17,338140,0,0,0,0,0,0,146000,54000,92000,92000
20200212,05642P,玉晶光兆豐97售02,0.58,0.58,0.56,0.58,-0.06,-9.38,106000,5,61080,0,0,0,0,0,0,30000,76000,-46000,-46000
20200212,056430,鴻海凱基98購06,1.94,2.12,1.94,2.12,+0.38,21.84,33000,5,67540,0,0,0,0,0,0,0,33000,-33000,-33000
20200212,056431,鴻海凱基98購07,1.37,1.52,0.38,1.52,+0.23,17.83,223000,12,304210,0,0,0,0,0,0,186000,87000,99000,99000
20200212,056432,鴻海凱基98購08,2.55,2.88,2.55,2.88,+0.45,18.52,9000,3,24110,0,0,0,0,0,0,2000,7000,-5000,-5000
20200212,056433,鴻海凱基98購09,,,,,0.00,0.00,0,0,0,0,0,0,0,0,0,0,0,0,0
20200212,056434,國巨凱基98購03,6.30,6.40,6.30,6.40,+0.30,4.92,26000,2,165400,0,0,0,0,0,0,26000,0,26000,26000
20200212,056435,台積電凱基98購09,,,,,0.00,0.00,0,0,0,0,0,0,0,0,0,0,0,0,0
20200212,056436,台積電凱基98購10,2.88,2.88,2.88,2.88,+0.11,3.97,10000,1,28800,0,0,0,0,0,0,10000,0,10000,10000
20200212,056437,台積電凱基98購11,3.91,3.91,3.91,3.91,+0.22,5.96,20000,2,78200,0,0,0,0,0,0,0,20000,-20000,-20000
20200212,056438,旺宏凱基98購05,2.25,2.25,2.22,2.22,-0.02,-0.89,3000,3,6690,0,0,0,0,0,0,3000,3000,0,0
20200212,056439,華邦電凱基98購02,1.76,1.78,1.72,1.72,+0.14,8.86,978000,17,1713150,0,0,0,0,0,0,917000,21000,896000,896000
20200212,05643P,大立光中信98售01,,,,,0.00,0.00,0,0,0,0,0,0,0,0,0,0,0,0,0
20200212,056440,智邦凱基98購03,3.76,3.83,3.58,3.58,+0.13,3.77,34000,12,128550,0,0,0,0,0,0,14000,24000,-10000,-10000
20200212,056441,燿華凱基98購01,1.75,1.77,1.75,1.77,-0.02,-1.12,17000,2,29950,0,0,0,0,0,0,7000,10000,-3000,-3000
20200212,056442,瑞昱凱基98購02,1.68,1.86,1.68,1.79,+0.12,7.19,131000,18,235950,0,0,0,0,0,0,74000,57000,17000,17000
20200212,056443,南亞科凱基98購03,2.75,2.75,2.73,2.73,-0.05,-1.8,35000,3,96150,0,0,0,0,0,0,35000,30000,5000,5000
20200212,056444,南亞科凱基99購01,3.40,3.40,3.40,3.40,0.00,0.00,76000,2,258400,0,0,0,0,0,0,76000,0,76000,76000
20200212,056445,聯發科凱基98購07,3.04,3.28,3.02,3.28,+0.51,18.41,117000,22,373420,0,0,0,0,0,0,63000,74000,-11000,-11000
20200212,056446,聯發科凱基98購08,1.49,1.61,1.49,1.61,+0.26,19.26,63000,15,100120,0,0,0,0,0,0,17000,63000,-46000,-46000
20200212,056447,聯發科凱基98購09,2.85,3.13,2.85,3.13,+0.59,23.23,50000,20,150380,0,0,0,0,0,0,37000,34000,3000,3000
20200212,056448,全新凱基99購01,2.40,2.54,2.40,2.50,+0.63,33.69,22000,3,54080,0,0,0,0,0,0,10000,22000,-12000,-12000
20200212,056449,義隆凱基98購03,1.58,1.63,1.40,1.59,+0.17,11.97,403000,16,642700,0,0,0,0,0,0,326000,107000,219000,219000
20200212,05644P,大立光中信9A售03,,,,,0.00,0.00,0,0,0,0,0,0,0,0,0,0,0,0,0
20200212,056450,可成凱基98購05,2.23,2.45,0.92,2.43,+0.29,13.55,131000,8,290030,0,0,0,0,0,0,64000,87000,-23000,-23000
20200212,056451,可成凱基99購01,1.91,1.92,1.88,1.90,+0.08,4.4,32000,4,60880,0,0,0,0,0,0,24000,28000,-4000,-4000
20200212,056452,亞光凱基98購02,1.66,1.89,1.66,1.89,+0.28,17.39,68000,7,119170,0,0,0,0,0,0,52000,31000,21000,21000
20200212,056453,禾伸堂凱基99購02,1.99,1.99,1.95,1.98,+0.02,1.02,69000,6,135760,0,0,0,0,0,0,44000,35000,9000,9000
20200212,056454,欣興凱基98購02,2.18,2.67,2.16,2.67,+0.43,19.2,25000,7,59570,0,0,0,0,0,0,20000,15000,5000,5000
20200212,056455,群創凱基9A購01,2.02,2.02,2.02,2.02,0.00,0.00,7000,1,14140,0,0,0,0,0,0,0,7000,-7000,-7000
20200212,056456,群創凱基9B購01,1.70,1.70,1.70,1.70,0.00,0.00,10000,1,17000,0,0,0,0,0,0,0,10000,-10000,-10000
20200212,056457,嘉澤凱基98購01,2.02,2.02,2.00,2.00,+0.06,3.09,54000,2,108080,0,0,0,0,0,0,4000,54000,-50000,-50000
20200212,056458,日月光凱基98購02,2.42,2.65,2.40,2.65,+0.27,11.34,342000,15,841960,0,0,0,0,0,0,312000,30000,282000,282000
20200212,056459,茂林凱基99購01,1.75,1.79,1.75,1.75,+0.04,2.34,105000,6,183950,0,0,0,0,0,0,14000,91000,-77000,-77000
20200212,05645P,聯發科凱基96售13,3.06,3.06,3.04,3.04,-0.58,-16.02,24000,2,73220,0,0,0,0,0,0,24000,24000,0,0
20200212,056460,同欣電凱基99購01,1.67,1.93,1.64,1.64,-0.06,-3.53,61000,17,107930,0,0,0,0,0,0,25000,36000,-11000,-11000
20200212,056461,樺漢凱基98購02,2.02,2.08,2.02,2.08,+0.13,6.67,86000,8,174740,0,0,0,0,0,0,24000,62000,-38000,-38000
20200212,056462,訊芯凱基98購03,1.42,1.42,1.42,1.42,+0.05,3.65,1000,1,1420,0,0,0,0,0,0,1000,0,1000,1000
20200212,056463,台虹凱基98購02,1.25,1.27,1.25,1.27,+0.07,5.83,248000,6,312640,0,0,0,0,0,0,212000,36000,176000,176000
20200212,056464,臺股指凱基99購06,0.96,0.99,0.96,0.99,+0.07,7.61,52000,3,50280,0,0,0,0,0,0,52000,0,52000,52000
20200212,056465,臺股指凱基99購07,,,,,0.00,0.00,0,0,0,0,0,0,0,0,0,0,0,0,0
20200212,056466,臺股指凱基99購08,,,,,0.00,0.00,0,0,0,0,0,0,0,0,0,0,0,0,0
20200212,056467,上証2X元大98購02,2.31,2.31,2.23,2.29,0.00,0.00,28000,6,64180,0,0,0,0,0,0,23000,5000,18000,18000
20200212,056468,鴻海元大98購07,2.31,2.58,2.31,2.58,+0.30,13.16,588000,35,1440270,0,0,0,0,0,0,21000,576000,-555000,-555000
20200212,056469,國巨元大99購01,4.42,4.46,4.22,4.44,+0.18,4.23,264000,28,1154410,0,0,0,0,0,0,217000,142000,75000,75000
20200212,05646P,聯發科國票96售05,,,,,0.00,0.00,0,0,0,0,0,0,0,0,0,0,0,0,0
20200212,056470,旺宏元大99購01,3.05,3.11,2.95,2.95,-0.05,-1.67,28000,6,85200,0,0,0,0,0,0,28000,4000,24000,24000
20200212,056471,台光電元大99購01,2.13,2.69,2.13,2.69,+0.58,27.49,103000,15,252300,0,0,0,0,0,0,10000,93000,-83000,-83000
20200212,056472,美律元大99購03,1.56,1.72,1.56,1.70,+0.22,14.86,531000,40,876480,0,0,0,0,0,0,174000,369000,-195000,-195000
20200212,056473,奇力新元大99購02,1.93,2.01,1.13,2.00,+0.04,2.04,557000,64,1080620,0,0,0,0,0,0,479000,267000,212000,212000
20200212,056474,華新科元大99購05,4.32,4.32,4.21,4.27,+0.13,3.14,154000,33,657150,0,0,0,0,0,0,94000,97000,-3000,-3000
20200212,056475,宏達電元大99購02,3.02,3.02,2.96,3.00,+0.07,2.39,57000,12,171480,0,0,0,0,0,0,25000,43000,-18000,-18000
20200212,056476,智原元大98購02,1.84,1.95,1.81,1.95,+0.17,9.55,692000,66,1283190,0,0,0,0,0,0,458000,407000,51000,51000
20200212,056477,欣興元大98購02,2.18,2.58,2.18,2.57,+0.40,18.43,287000,37,686730,0,0,0,0,0,0,92000,260000,-168000,-168000
20200212,056478,晶技元大99購01,0.85,0.85,0.85,0.85,0.00,0.00,100000,1,85000,0,0,0,0,0,0,0,100000,-100000,-100000
20200212,056479,玉晶光元大99購05,3.17,3.35,3.17,3.31,+0.32,10.7,95000,12,311230,0,0,0,0,0,0,17000,78000,-61000,-61000
20200212,05647P,聯發科國票97售02,,,,,0.00,0.00,0,0,0,0,0,0,0,0,0,0,0,0,0
20200212,056480,京鼎元大98購02,1.90,2.18,1.90,2.16,+0.39,22.03,260000,17,529230,0,0,0,0,0,0,4000,260000,-256000,-256000
20200212,056481,創意元大98購01,2.22,2.33,2.12,2.33,-0.23,-8.98,102000,7,223370,0,0,0,0,0,0,23000,89000,-66000,-66000
20200212,056482,貿聯元大99購01,1.47,1.65,1.47,1.65,+0.20,13.79,685000,45,1079800,0,0,0,0,0,0,275000,369000,-94000,-94000
20200212,056483,TPK元大98購01,2.24,2.47,2.24,2.47,+0.25,11.26,176000,18,418810,0,0,0,0,0,0,66000,131000,-65000,-65000
20200212,056484,聯茂元大98購02,3.08,3.78,3.08,3.78,+0.89,30.8,185000,18,629640,0,0,0,0,0,0,93000,92000,1000,1000
20200212,056485,同欣電元大98購01,1.42,1.56,1.37,1.37,-0.02,-1.44,687000,45,1005900,0,0,0,0,0,0,534000,561000,-27000,-27000
20200212,056486,樺漢元大98購04,2.48,2.55,2.46,2.53,+0.15,6.3,97000,10,242000,0,0,0,0,0,0,50000,47000,3000,3000
20200212,056487,康友元大98購01,2.22,2.39,2.22,2.28,+0.02,0.88,465000,47,1067290,0,0,0,0,0,0,155000,343000,-188000,-188000
20200212,056488,致新元大99購01,1.23,1.23,1.19,1.19,-0.03,-2.46,119000,9,143330,0,0,0,0,0,0,119000,50000,69000,69000
20200212,056489,S&P反1國泰9A購01,,,,,0.00,0.00,0,0,0,0,0,0,0,0,0,0,0,0,0
20200212,05648P,康控國票97售01,,,,,0.00,0.00,0,0,0,0,0,0,0,0,0,0,0,0,0
20200212,056490,台積電國泰99購01,2.83,3.02,2.83,3.02,+0.19,6.71,97000,4,290680,0,0,0,0,0,0,87000,10000,77000,77000
20200212,056491,南亞科國泰99購01,2.62,2.67,2.60,2.66,+0.01,0.38,131000,6,343740,0,0,0,0,0,0,110000,21000,89000,89000
20200212,056492,全新國泰9A購01,2.33,2.66,2.33,2.66,+0.48,22.02,40000,8,100240,0,0,0,0,0,0,16000,24000,-8000,-8000
20200212,056493,晶技國泰99購01,2.51,2.58,2.51,2.58,+0.10,4.03,63000,7,160630,0,0,0,0,0,0,13000,63000,-50000,-50000
20200212,056494,緯創國泰99購01,2.22,2.23,2.22,2.23,+0.04,1.83,20000,2,44500,0,0,0,0,0,0,10000,10000,0,0
20200212,056495,泰鼎國泰99購01,1.99,2.12,1.91,1.91,-0.03,-1.55,301000,47,601790,0,0,0,0,0,0,20000,281000,-261000,-261000
20200212,056496,康控國泰99購01,1.93,2.12,1.93,2.12,+0.24,12.77,151000,18,304720,0,0,0,0,0,0,38000,133000,-95000,-95000
20200212,056497,GIS國泰99購01,1.73,1.87,1.73,1.87,+0.17,10.0,56000,15,101550,0,0,0,0,0,0,29000,35000,-6000,-6000
20200212,056498,A50正2富邦9B購01,1.62,1.62,1.57,1.57,+0.01,0.64,122000,3,197040,0,0,0,0,0,0,0,122000,-122000,-122000
20200212,056499,鴻海富邦98購02,1.30,1.38,1.28,1.38,+0.17,14.05,309000,8,408420,0,0,0,0,0,0,0,309000,-309000,-309000
20200212,05649P,矽創國票97售03,2.33,2.33,2.17,2.17,-0.59,-21.38,73000,30,161410,0,0,0,0,0,0,73000,0,73000,73000
20200212,056500,大立光富邦9B購02,0.66,0.73,0.66,0.73,+0.07,10.61,140000,17,98810,0,0,0,0,0,0,51000,79000,-28000,-28000
20200212,056501,貿聯富邦99購01,0.76,0.86,0.75,0.86,+0.11,14.67,787000,25,623620,0,0,0,0,0,0,383000,479000,-96000,-96000
20200212,056502,A50正2永豐98購01,3.64,3.64,3.51,3.60,-0.09,-2.44,57000,11,205620,0,0,0,0,0,0,47000,10000,37000,37000
20200212,056503,楠梓電永豐98購01,2.05,2.31,2.05,2.31,+0.37,19.07,275000,42,601980,0,0,0,0,0,0,0,275000,-275000,-275000
20200212,056504,國巨永豐98購02,3.02,3.02,2.90,3.01,+0.17,5.99,110000,6,326190,0,0,0,0,0,0,107000,3000,104000,104000
20200212,056505,聯發科永豐98購01,1.49,1.65,1.49,1.63,+0.28,20.74,3829000,68,5985940,0,0,0,0,0,0,3131000,2891000,240000,240000
20200212,056506,晶豪科永豐98購02,1.92,1.98,1.92,1.98,+0.15,8.2,50000,5,97300,0,0,0,0,0,0,20000,30000,-10000,-10000
20200212,056507,創意永豐98購02,1.48,1.62,1.46,1.56,-0.13,-7.69,614000,70,944500,0,0,0,0,0,0,305000,317000,-12000,-12000
20200212,056508,揚明光永豐98購01,1.84,1.85,1.84,1.85,+0.10,5.71,175000,6,322870,0,0,0,0,0,0,0,175000,-175000,-175000
20200212,056509,晶相光永豐98購01,1.53,1.63,1.53,1.60,+0.08,5.26,210000,9,339470,0,0,0,0,0,0,110000,116000,-6000,-6000
20200212,05650P,台積電富邦96售01,0.15,0.16,0.14,0.15,-0.01,-6.25,376000,8,57230,0,0,0,0,0,0,0,371000,-371000,-371000
20200212,056510,正文永豐98購02,0.76,0.76,0.76,0.76,-0.01,-1.3,60000,2,45600,0,0,0,0,0,0,60000,0,60000,60000
20200212,056511,超眾永豐98購01,1.38,1.53,1.35,1.53,+0.09,6.25,519000,32,722680,0,0,0,0,0,0,441000,50000,391000,391000
20200212,056512,易華電永豐98購01,2.11,2.14,2.11,2.14,+0.01,0.47,33000,3,69960,0,0,0,0,0,0,0,33000,-33000,-33000
20200212,056513,臻鼎亞東99購01,,,,,0.00,0.00,0,0,0,0,0,0,0,0,0,0,0,0,0
20200212,056514,訊芯亞東99購01,1.31,1.36,1.31,1.34,+0.16,13.56,168000,5,224780,0,0,0,0,0,0,0,168000,-168000,-168000
20200212,056515,燿華兆豐99購01,1.00,1.09,1.00,1.09,+0.06,5.83,351000,12,371540,0,0,0,0,0,0,20000,331000,-311000,-311000
20200212,056516,晶豪科兆豐98購01,1.37,1.40,1.35,1.40,+0.11,8.53,439000,12,604480,0,0,0,0,0,0,23000,439000,-416000,-416000
20200212,056517,茂林兆豐99購01,1.20,1.25,1.17,1.22,+0.05,4.27,305000,30,370990,0,0,0,0,0,0,100000,205000,-105000,-105000
20200212,056518,美律國票99購01,3.05,3.47,3.05,3.41,+0.54,18.82,160000,20,521240,0,0,0,0,0,0,40000,120000,-80000,-80000
20200212,056519,創意國票99購01,3.79,3.87,3.47,3.84,-0.33,-7.91,98000,20,363090,0,0,0,0,0,0,58000,36000,22000,22000
20200212,05651P,大立光元大97售02,2.11,2.11,2.06,2.06,-0.18,-8.04,100000,3,208500,0,0,0,0,0,0,0,100000,-100000,-100000
20200212,056520,鴻海日盛99購01,3.11,3.57,3.11,3.57,+0.61,20.61,30000,7,98740,0,0,0,0,0,0,14000,16000,-2000,-2000
20200212,056521,群創日盛98購01,,,,,0.00,0.00,0,0,0,0,0,0,0,0,0,0,0,0,0
20200212,056522,T50反1中信9B購01,,,,,0.00,0.00,0,0,0,0,0,0,0,0,0,0,0,0,0
20200212,056523,光寶科中信98購01,1.79,1.82,1.78,1.82,0.00,0.00,163000,7,292930,0,0,0,0,0,0,33000,130000,-97000,-97000
20200212,056524,欣興中信98購02,0.76,0.77,0.76,0.76,+0.03,4.11,160000,5,121800,0,0,0,0,0,0,32000,128000,-96000,-96000
20200212,056525,T50反1凱基99購06,0.74,0.74,0.70,0.70,-0.06,-7.89,201000,5,147510,0,0,0,0,0,0,187000,9000,178000,178000
20200212,056526,力山凱基98購01,,,,,0.00,0.00,0,0,0,0,0,0,0,0,0,0,0,0,0
20200212,056527,大成鋼凱基98購03,,,,,0.00,0.00,0,0,0,0,0,0,0,0,0,0,0,0,0
20200212,056528,為升凱基98購01,2.42,2.52,2.42,2.52,+0.02,0.8,40000,2,99800,0,0,0,0,0,0,30000,40000,-10000,-10000
20200212,056529,中環凱基98購01,1.63,1.63,1.62,1.62,-0.19,-10.5,20000,12,32420,0,0,0,0,0,0,18000,0,18000,18000
20200212,05652P,臻鼎群益96售01,1.76,2.03,1.61,2.02,-0.28,-12.17,378000,28,710820,0,0,0,0,0,0,45000,333000,-288000,-288000
20200212,056530,旺宏凱基98購06,2.47,2.47,2.43,2.43,-0.02,-0.82,3000,3,7330,0,0,0,0,0,0,3000,3000,0,0
20200212,056531,佳世達凱基98購01,,,,,0.00,0.00,0,0,0,0,0,0,0,0,0,0,0,0,0
20200212,056532,技嘉凱基98購01,3.23,3.37,3.07,3.14,-0.04,-1.26,159000,24,515850,0,0,0,0,0,0,117000,50000,67000,67000
20200212,056533,友達凱基9A購02,1.41,1.41,1.41,1.41,-0.14,-9.03,52000,2,73320,0,0,0,0,0,0,0,52000,-52000,-52000
20200212,056534,京元電凱基98購01,4.34,4.53,2.77,4.53,+0.16,3.66,81000,23,344390,0,0,0,0,0,0,68000,13000,55000,55000
20200212,056535,全新凱基99購02,2.24,2.63,2.24,2.59,+0.57,28.22,126000,12,312880,0,0,0,0,0,0,65000,96000,-31000,-31000
20200212,056536,義隆凱基98購04,2.40,2.40,2.28,2.28,+0.27,13.43,85000,11,200340,0,0,0,0,0,0,65000,20000,45000,45000
20200212,056537,冠德凱基98購01,2.78,2.78,2.78,2.78,-0.03,-1.07,30000,1,83400,0,0,0,0,0,0,0,30000,-30000,-30000
20200212,056538,國泰金凱基98購01,2.29,2.32,2.21,2.32,+0.08,3.57,55000,8,124610,0,0,0,0,0,0,25000,30000,-5000,-5000
20200212,056539,新光金凱基9A購01,1.02,1.02,1.01,1.01,0.00,0.00,96000,24,97060,0,0,0,0,0,0,86000,10000,76000,76000
20200212,05653P,華邦電統一96售02,1.81,1.82,1.72,1.74,-0.17,-8.9,146000,12,262190,0,2000,-2000,0,0,0,92000,54000,38000,36000
20200212,056540,聯詠凱基98購02,2.69,2.77,2.64,2.77,+0.44,18.88,42000,6,112140,0,0,0,0,0,0,2000,42000,-40000,-40000
20200212,056541,智原凱基98購03,0.56,0.60,0.55,0.60,+0.04,7.14,350000,29,198240,0,0,0,0,0,0,297000,50000,247000,247000
20200212,056542,緯創凱基98購01,1.91,1.91,1.91,1.91,-0.02,-1.04,10000,1,19100,0,0,0,0,0,0,0,10000,-10000,-10000
20200212,056543,京鼎凱基98購01,2.17,2.35,2.17,2.35,+0.44,23.04,80000,16,179530,0,0,0,0,0,0,26000,54000,-28000,-28000
20200212,056544,貿聯凱基98購03,,,,,0.00,0.00,0,0,0,0,0,0,0,0,0,0,0,0,0
20200212,056545,TPK凱基98購02,1.81,1.98,0.77,1.98,+0.20,11.24,247000,28,460840,0,0,0,0,0,0,79000,168000,-89000,-89000
20200212,056546,致伸凱基98購01,2.93,2.93,2.87,2.90,+0.11,3.94,276000,14,802060,0,0,0,0,0,0,34000,242000,-208000,-208000
20200212,056547,臻鼎凱基99購01,2.07,2.07,0.82,0.82,-0.82,-50.0,60000,4,113950,0,0,0,0,0,0,50000,10000,40000,40000
20200212,056548,瀚宇博凱基98購02,2.76,2.84,2.74,2.84,+0.21,7.98,40000,4,111300,0,0,0,0,0,0,40000,40000,0,0
20200212,056549,嘉聯益凱基98購04,1.03,1.06,1.03,1.06,+0.08,8.16,80000,4,83930,0,0,0,0,0,0,51000,29000,22000,22000
20200212,05654P,台光電統一96售01,1.25,1.25,1.05,1.07,-0.24,-18.32,217000,18,251530,0,0,0,0,0,0,151000,66000,85000,85000
20200212,056550,瑞儀凱基99購01,1.16,1.17,1.14,1.17,+0.01,0.86,66000,5,75550,0,0,0,0,0,0,51000,14000,37000,37000
20200212,056551,台郡凱基98購04,3.70,3.72,3.70,3.72,+1.07,40.38,16000,7,59500,0,0,0,0,0,0,16000,0,16000,16000
20200212,056552,台表科凱基99購01,1.78,1.78,1.78,1.78,+0.03,1.71,10000,2,17800,0,0,0,0,0,0,10000,10000,0,0
20200212,056553,啟碁凱基98購02,,,,,0.00,0.00,0,0,0,0,0,0,0,0,0,0,0,0,0
20200212,056554,GIS凱基99購01,,,,,0.00,0.00,0,0,0,0,0,0,0,0,0,0,0,0,0
20200212,056555,矽創凱基98購01,2.13,2.57,0.98,2.56,+0.46,21.9,566000,35,1358540,0,0,0,0,0,0,69000,519000,-450000,-450000
20200212,056556,南電凱基98購01,2.39,2.89,2.38,2.80,+0.40,16.67,225000,48,599290,0,0,0,0,0,0,124000,192000,-68000,-68000
20200212,056557,世紀鋼凱基98購02,2.22,2.26,2.20,2.23,0.00,0.00,42000,19,93280,0,0,0,0,0,0,42000,4000,38000,38000
20200212,056558,台達電群益98購01,1.99,2.03,1.96,1.98,+0.01,0.51,62000,6,122960,0,0,0,0,0,0,20000,42000,-22000,-22000
20200212,056559,華通群益98購02,0.77,0.89,0.75,0.87,+0.21,31.82,115000,8,89890,0,0,0,0,0,0,93000,35000,58000,58000
20200212,05655P,南亞科統一96售01,1.05,1.06,1.05,1.05,0.00,0.00,50000,3,52700,0,0,0,0,0,0,0,50000,-50000,-50000
20200212,056560,旺宏群益98購03,4.52,4.64,4.39,4.39,-0.02,-0.45,26000,5,118390,0,0,0,0,0,0,10000,16000,-6000,-6000
20200212,056561,台光電群益98購02,2.30,3.05,2.30,2.87,+0.55,23.71,381000,64,1034780,0,0,0,0,0,0,57000,324000,-267000,-267000
20200212,056562,奇力新群益98購01,1.85,1.98,1.80,1.96,+0.07,3.7,1361000,99,2576440,0,0,0,0,0,0,897000,838000,59000,59000
20200212,056563,華新科群益98購04,6.50,6.50,6.35,6.50,+0.15,2.36,63000,14,406800,0,0,0,0,0,0,52000,51000,1000,1000
20200212,056564,亞光群益98購02,0.75,0.87,0.75,0.87,+0.12,16.0,117000,11,98710,0,0,0,0,0,0,11000,106000,-95000,-95000
20200212,056565,欣興群益98購03,2.33,2.80,2.32,2.80,+0.41,17.15,171000,23,445620,0,0,0,0,0,0,55000,145000,-90000,-90000
20200212,056566,臻鼎群益98購01,3.01,3.23,2.69,2.69,+0.29,12.08,135000,9,416840,0,0,0,0,0,0,130000,5000,125000,125000
20200212,056567,瀚宇博群益98購02,2.19,2.46,2.19,2.46,+0.15,6.49,116000,20,268540,0,0,0,0,0,0,49000,67000,-18000,-18000
20200212,056568,台表科群益98購01,1.97,2.12,1.94,2.12,+0.23,12.17,795000,32,1649260,0,0,0,0,0,0,54000,741000,-687000,-687000
20200212,056569,T50正2元大9B購02,1.60,1.60,1.60,1.60,0.00,0.00,10000,3,16000,0,0,0,0,0,0,1000,9000,-8000,-8000
20200212,05656P,台表科統一96售01,,,,,0.00,0.00,0,0,0,0,0,0,0,0,0,0,0,0,0
20200212,056570,旺宏元大98購07,1.42,1.48,1.40,1.41,-0.02,-1.4,19000,11,27390,0,0,0,0,0,0,9000,15000,-6000,-6000
20200212,056571,燿華元大98購02,2.59,2.91,2.59,2.88,+0.20,7.46,416000,37,1178240,0,0,0,0,0,0,308000,407000,-99000,-99000
20200212,056572,義隆元大99購01,1.81,1.81,1.68,1.75,+0.19,12.18,535000,27,926290,0,0,0,0,0,0,365000,180000,185000,185000
20200212,056573,華新科元大99購06,3.00,3.00,2.92,2.95,+0.07,2.43,134000,21,397510,0,0,0,0,0,0,74000,97000,-23000,-23000
20200212,056574,亞光元大99購03,2.82,3.14,2.82,3.14,+0.36,12.95,109000,15,332820,0,0,0,0,0,0,54000,95000,-41000,-41000
20200212,056575,禾伸堂元大99購01,3.18,3.21,3.07,3.21,+0.10,3.22,230000,31,722530,0,0,0,0,0,0,166000,139000,27000,27000
20200212,056576,晶技元大99購02,1.36,1.36,1.36,1.36,+0.02,1.49,19000,2,25840,0,0,0,0,0,0,19000,0,19000,19000
20200212,056577,玉晶光元大99購06,1.56,1.62,1.56,1.58,+0.13,8.97,108000,14,171960,0,0,0,0,0,0,62000,53000,9000,9000
20200212,056578,智易元大99購02,1.59,1.88,1.59,1.84,+0.28,17.95,350000,16,614690,0,0,0,0,0,0,212000,320000,-108000,-108000
20200212,056579,麗豐元大99購01,1.65,1.73,1.62,1.68,+0.09,5.66,358000,24,596460,0,0,0,0,0,0,137000,256000,-119000,-119000
20200212,05657P,樺漢統一97售01,1.52,1.52,1.51,1.51,-0.09,-5.62,59000,21,89440,0,0,0,0,0,0,59000,0,59000,59000
20200212,056580,泰鼎元大9A購01,1.11,1.20,1.09,1.09,+0.02,1.87,523000,56,602450,0,0,0,0,0,0,371000,504000,-133000,-133000
20200212,056581,超眾元大99購01,3.23,3.57,3.23,3.55,+0.21,6.29,180000,29,613450,0,0,0,0,0,0,122000,112000,10000,10000
20200212,056582,易華電元大98購01,2.51,2.54,2.50,2.50,+0.02,0.81,88000,5,222150,0,0,0,0,0,0,31000,87000,-56000,-56000
20200212,056583,昇陽半元大98購02,2.09,2.16,2.08,2.10,+0.05,2.44,277000,21,581780,0,0,0,0,0,0,266000,99000,167000,167000
20200212,056584,鴻海統一9B購01,2.25,2.54,2.25,2.54,+0.32,14.41,131000,14,314190,0,0,0,0,0,0,26000,105000,-79000,-79000
20200212,056585,台積電統一9A購01,1.25,1.26,1.25,1.26,+0.03,2.44,84000,5,105240,0,0,0,0,0,0,35000,49000,-14000,-14000
20200212,056586,光罩統一98購02,1.48,1.61,1.48,1.61,+0.12,8.05,487000,21,752570,0,0,0,0,0,0,147000,340000,-193000,-193000
20200212,056587,聯發科統一9A購01,1.91,2.05,1.91,2.05,+0.26,14.53,209000,5,405700,0,0,0,0,0,0,60000,149000,-89000,-89000
20200212,056588,聯發科統一9A購02,2.86,3.09,2.86,3.07,+0.38,14.13,337000,18,1004850,0,0,0,0,0,0,166000,171000,-5000,-5000
20200212,056589,康控統一98購01,1.39,1.51,1.38,1.51,+0.14,10.22,500000,17,731910,0,0,0,0,0,0,279000,221000,58000,58000
20200212,05658P,日月光元富96售02,2.92,2.92,2.70,2.72,-0.36,-11.69,204000,27,559740,0,0,0,0,0,0,6000,192000,-186000,-186000
20200212,056590,樺漢統一9A購01,1.12,1.17,1.11,1.14,+0.04,3.64,514000,19,577010,0,0,0,0,0,0,239000,255000,-16000,-16000
20200212,056591,S&P正2元富9A購01,1.00,1.01,1.00,1.01,0.00,0.00,11000,3,11050,0,0,0,0,0,0,0,11000,-11000,-11000
20200212,056592,台積電元富98購01,3.44,3.50,3.38,3.50,+0.17,5.11,274000,10,934160,0,0,0,0,0,0,59000,215000,-156000,-156000
20200212,056593,台積電元富98購02,2.60,2.71,2.58,2.69,+0.14,5.49,900000,19,2381260,0,0,0,0,0,0,561000,354000,207000,207000
20200212,056594,台積電元富98購03,1.98,2.03,1.94,2.03,+0.16,8.56,1139000,18,2236200,0,0,0,0,0,0,466000,673000,-207000,-207000
20200212,056595,台積電元富98購04,1.46,1.48,1.43,1.48,+0.10,7.25,11000,7,16140,0,0,0,0,0,0,3000,8000,-5000,-5000
20200212,056596,光磊元富98購01,2.06,2.06,2.01,2.01,-0.02,-0.99,52000,9,106940,0,0,0,0,0,0,52000,0,52000,52000
20200212,056597,宏碁元富98購01,0.99,1.02,0.99,1.02,+0.04,4.08,119000,7,118180,0,0,0,0,0,0,100000,19000,81000,81000
20200212,056598,京元電元富98購01,2.70,2.86,2.70,2.82,0.00,0.00,301000,40,837310,0,0,0,0,0,0,249000,76000,173000,173000
20200212,056599,臻鼎元富98購01,3.11,3.37,2.58,2.63,+0.17,6.91,314000,33,938330,0,0,0,0,0,0,116000,198000,-82000,-82000
20200212,05659P,A50正2中信97售01,,,,,0.00,0.00,0,0,0,0,0,0,0,0,0,0,0,0,0
20200212,056600,聯茂元富98購01,1.59,1.88,1.59,1.73,+0.29,20.14,782000,47,1343620,0,0,0,0,0,0,415000,688000,-273000,-273000
20200212,056601,鈺齊元富98購01,1.19,1.31,1.19,1.31,+0.11,9.17,200000,11,254530,0,0,0,0,0,0,130000,70000,60000,60000
20200212,056602,嘉澤國泰99購01,1.97,2.00,1.93,1.96,-0.15,-7.11,130000,5,257560,0,0,0,0,0,0,100000,30000,70000,70000
20200212,056603,嘉聯益國泰9A購01,2.68,2.68,2.62,2.62,+0.21,8.71,70000,3,184000,0,0,0,0,0,0,60000,70000,-10000,-10000
20200212,056604,鴻海富邦9A購01,0.99,1.11,0.99,1.11,0.00,0.00,147000,15,152970,0,0,0,0,0,0,40000,107000,-67000,-67000
20200212,056605,台積電富邦9B購02,0.83,0.86,0.83,0.85,+0.03,3.66,1876000,14,1559720,0,0,0,0,0,0,1854000,24000,1830000,1830000
20200212,056606,華新科富邦9A購02,1.11,1.11,1.06,1.10,+0.05,4.76,184000,18,201080,0,0,0,0,0,0,183000,11000,172000,172000
20200212,056607,貿聯富邦99購02,0.51,0.55,0.51,0.55,+0.06,12.24,33000,6,17550,0,0,0,0,0,0,30000,3000,27000,27000
20200212,056608,力山永豐98購01,1.50,1.55,1.50,1.55,-0.01,-0.64,20000,3,30500,0,0,0,0,0,0,0,20000,-20000,-20000
20200212,056609,楠梓電永豐98購02,1.78,1.98,1.78,1.98,+0.30,17.86,269000,41,511210,0,0,0,0,0,0,0,269000,-269000,-269000
20200212,05660P,玉晶光第一96售01,0.42,0.42,0.40,0.40,0.00,0.00,168000,4,69350,0,0,0,0,0,0,150000,18000,132000,132000
20200212,056610,鴻海永豐98購01,1.53,1.77,1.53,1.77,+0.29,19.59,119000,10,189530,0,0,0,0,0,0,11000,108000,-97000,-97000
20200212,056611,國巨永豐98購03,2.61,2.66,2.55,2.66,+0.15,5.98,77000,9,200530,0,0,0,0,0,0,64000,13000,51000,51000
20200212,056612,台積電永豐98購01,1.55,1.61,1.55,1.61,+0.12,8.05,985000,9,1559270,0,0,0,0,0,0,377000,608000,-231000,-231000
20200212,056613,旺宏永豐98購01,1.41,1.43,1.35,1.35,-0.05,-3.57,49000,9,67820,0,0,0,0,0,0,29000,28000,1000,1000
20200212,056614,智邦永豐98購01,1.29,1.35,1.13,1.22,+0.01,0.83,189000,28,232700,0,0,0,0,0,0,62000,174000,-112000,-112000
20200212,056615,燿華永豐98購02,1.47,1.65,1.47,1.63,+0.16,10.88,255000,22,403300,0,0,0,0,0,0,70000,255000,-185000,-185000
20200212,056616,台光電永豐98購01,1.16,1.39,1.16,1.34,+0.19,16.52,729000,33,923700,0,0,0,0,0,0,319000,579000,-260000,-260000
20200212,056617,美律永豐98購01,1.06,1.18,1.06,1.16,+0.16,16.0,636000,36,706810,0,0,0,0,0,0,186000,465000,-279000,-279000
20200212,056618,京元電永豐98購01,1.82,1.89,1.72,1.88,+0.06,3.3,826000,58,1486850,0,0,0,0,0,0,715000,202000,513000,513000
20200212,056619,強茂永豐98購01,1.19,1.21,1.19,1.20,+0.05,4.35,123000,4,146520,0,0,0,0,0,0,113000,10000,103000,103000
20200212,05661P,聯發科統一96售06,,,,,0.00,0.00,0,0,0,0,0,0,0,0,0,0,0,0,0
20200212,056620,華新科永豐98購02,1.49,1.49,1.37,1.45,+0.03,2.11,112000,11,164380,0,0,0,0,0,0,44000,98000,-54000,-54000
20200212,056621,宏達電永豐98購01,1.61,1.62,1.61,1.62,+0.04,2.53,50000,2,80750,0,0,0,0,0,0,0,50000,-50000,-50000
20200212,056622,高鐵永豐98購01,0.88,0.92,0.88,0.92,0.00,0.00,84000,2,74560,0,0,0,0,0,0,0,84000,-84000,-84000
20200212,056623,禾伸堂永豐98購01,1.81,1.91,1.78,1.91,+0.09,4.95,431000,33,784190,0,0,0,0,0,0,219000,285000,-66000,-66000
20200212,056624,景碩永豐98購01,2.21,2.58,2.12,2.48,+0.35,16.43,249000,49,577670,0,0,0,0,0,0,55000,200000,-145000,-145000
20200212,056625,致伸永豐98購01,1.02,1.04,1.01,1.04,+0.06,6.12,273000,9,278740,0,0,0,0,0,0,112000,161000,-49000,-49000
20200212,056626,同欣電永豐98購01,0.85,0.99,0.85,0.87,0.00,0.00,678000,39,626390,0,0,0,0,0,0,544000,109000,435000,435000
20200212,056627,訊芯永豐98購01,0.86,0.98,0.86,0.98,+0.14,16.67,380000,16,358000,0,0,0,0,0,0,110000,270000,-160000,-160000
20200212,056628,矽創永豐98購01,0.99,1.21,0.99,1.21,+0.25,26.04,769000,59,827360,0,0,0,0,0,0,409000,379000,30000,30000
20200212,056629,昇陽半永豐98購01,1.67,1.73,1.65,1.66,+0.01,0.61,59000,15,99270,0,0,0,0,0,0,39000,33000,6000,6000
20200212,05662P,景碩元富96售01,1.67,1.67,1.50,1.55,-0.12,-7.19,138000,7,214460,0,0,0,0,0,0,106000,32000,74000,74000
20200212,056630,臺股指永豐98購02,,,,,0.00,0.00,0,0,0,0,0,0,0,0,0,0,0,0,0
20200212,056631,臺股指永豐98購03,1.54,1.56,1.54,1.56,+0.17,12.23,4000,2,6200,0,0,0,0,0,0,4000,0,4000,4000
20200212,056632,鴻海永昌98購01,2.90,3.29,2.90,3.29,+0.49,17.5,1226000,41,3781900,0,0,0,0,0,0,674000,854000,-180000,-180000
20200212,056633,鴻海永昌98購02,2.94,3.52,2.94,3.52,+0.68,23.94,340000,26,1053400,0,0,0,0,0,0,218000,232000,-14000,-14000
20200212,056634,為升兆豐99購01,2.28,2.34,2.28,2.34,+0.07,3.08,50000,5,116200,0,0,0,0,0,0,0,50000,-50000,-50000
20200212,056635,亞德客日盛99購01,2.17,2.36,2.17,2.36,+0.09,3.96,562000,36,1282370,0,0,0,0,0,0,454000,103000,351000,351000
20200212,056636,台積電日盛9A購01,,,,,0.00,0.00,0,0,0,0,0,0,0,0,0,0,0,0,0
20200212,056637,台光電日盛9A購01,1.99,2.35,1.99,2.32,+0.36,18.37,806000,35,1776030,0,0,0,0,0,0,186000,620000,-434000,-434000
20200212,056638,臺股指日盛98購01,,,,,0.00,0.00,0,0,0,0,0,0,0,0,0,0,0,0,0
20200212,056639,國產康和98購01,1.10,1.10,1.10,1.10,-0.02,-1.79,220000,7,242000,0,0,0,0,0,0,150000,70000,80000,80000
20200212,05663P,創意元富96售04,1.71,1.78,1.66,1.70,-0.01,-0.58,437000,17,734600,0,0,0,0,0,0,0,437000,-437000,-437000
20200212,056640,元油2X凱基9A購01,,,,,0.00,0.00,0,0,0,0,0,0,0,0,0,0,0,0,0
20200212,056641,華通凱基98購03,2.79,3.65,2.79,3.54,+0.73,25.98,66000,17,226300,0,0,0,0,0,0,55000,66000,-11000,-11000
20200212,056642,旺宏凱基98購07,2.88,2.95,2.88,2.95,+0.04,1.37,6000,2,17630,0,0,0,0,0,0,1000,6000,-5000,-5000
20200212,056643,奇力新凱基99購01,1.91,2.01,1.90,2.01,+0.04,2.03,299000,15,586990,0,0,0,0,0,0,291000,61000,230000,230000
20200212,056644,宏達電凱基98購04,2.07,2.07,2.07,2.07,+0.14,7.25,1000,1,2070,0,0,0,0,0,0,0,1000,-1000,-1000
20200212,056645,大立光凱基98購12,4.07,4.08,4.07,4.08,0.00,0.00,60000,4,244560,0,0,0,0,0,0,60000,60000,0,0
20200212,056646,奇鋐凱基99購02,0.65,0.65,0.65,0.65,-0.04,-5.8,20000,1,13000,0,0,0,0,0,0,0,0,0,0
20200212,056647,晶技凱基98購02,,,,,0.00,0.00,0,0,0,0,0,0,0,0,0,0,0,0,0
20200212,056648,牧德凱基99購02,0.83,0.85,0.81,0.81,-0.01,-1.22,118000,8,98140,0,0,0,0,0,0,64000,54000,10000,10000
20200212,056649,智易凱基98購01,1.79,2.14,1.79,2.11,+0.34,19.21,189000,17,387180,0,0,0,0,0,0,140000,152000,-12000,-12000
20200212,05664P,國巨凱基96售09,0.56,0.56,0.56,0.56,-0.03,-5.08,6000,3,3360,0,0,0,0,0,0,2000,4000,-2000,-2000
20200212,056650,彩晶凱基9A購01,,,,,0.00,0.00,0,0,0,0,0,0,0,0,0,0,0,0,0
20200212,056651,聯茂凱基98購04,2.52,2.84,1.13,2.84,+0.59,26.22,66000,7,154260,0,0,0,0,0,0,46000,22000,24000,24000
20200212,056652,上証反元大9B購01,0.26,0.26,0.26,0.26,-0.01,-3.7,569000,4,147940,0,0,0,0,0,0,0,569000,-569000,-569000
20200212,056653,元石油元大98購01,0.69,0.70,0.69,0.70,0.00,0.00,62000,3,42880,0,0,0,0,0,0,0,62000,-62000,-62000
20200212,056654,元油2X元大98購02,,,,,0.00,0.00,0,0,0,0,0,0,0,0,0,0,0,0,0
20200212,056655,旺宏元大99購02,3.37,3.50,3.33,3.35,-0.03,-0.89,8000,8,27050,0,0,0,0,0,0,4000,8000,-4000,-4000
20200212,056656,華邦電元大98購02,1.71,1.81,1.71,1.76,+0.12,7.32,400000,27,704320,0,0,0,0,0,0,21000,379000,-358000,-358000
20200212,056657,華邦電元大99購01,2.79,2.87,2.76,2.79,+0.18,6.9,79000,8,222350,0,0,0,0,0,0,12000,70000,-58000,-58000
20200212,056658,美食元大98購01,2.15,2.55,2.12,2.49,+0.32,14.75,533000,29,1258910,0,0,0,0,0,0,353000,217000,136000,136000
20200212,056659,泰碩元大99購01,1.18,1.18,1.15,1.15,+0.02,1.77,29000,2,33920,0,0,0,0,0,0,0,29000,-29000,-29000
20200212,05665P,台積電凱基96售08,0.61,0.61,0.57,0.57,-0.09,-13.64,33000,4,19330,0,0,0,0,0,0,25000,8000,17000,17000
20200212,056660,臺股指元大9A購07,2.87,2.93,2.87,2.93,+0.29,10.98,311000,3,893370,0,0,0,0,0,0,297000,14000,283000,283000
20200212,056661,臺股指元大9A購08,2.82,2.82,2.82,2.82,+0.04,1.44,10000,1,28200,0,0,0,0,0,0,10000,0,10000,10000
20200212,056662,臺股指元大9A購09,2.77,2.77,2.77,2.77,+0.11,4.14,40000,2,110800,0,0,0,0,0,0,40000,0,40000,40000
20200212,056663,臺股指元大9A購10,3.36,3.36,3.31,3.31,0.00,0.00,30000,3,99900,0,0,0,0,0,0,0,30000,-30000,-30000
20200212,056664,上証反中信9B購01,0.43,0.43,0.43,0.43,0.00,0.00,50000,1,21500,0,0,0,0,0,0,0,50000,-50000,-50000
20200212,056665,上証2X國票99購02,1.45,1.49,1.45,1.49,0.00,0.00,8000,2,11800,0,0,0,0,0,0,3000,5000,-2000,-2000
20200212,056666,元油2X國票9A購01,,,,,0.00,0.00,0,0,0,0,0,0,0,0,0,0,0,0,0
20200212,056667,上銀國票99購01,,,,,0.00,0.00,0,0,0,0,0,0,0,0,0,0,0,0,0
20200212,056668,光磊國票99購01,3.88,3.88,3.88,3.88,+0.02,0.52,6000,1,23280,0,0,0,0,0,0,6000,0,6000,6000
20200212,056669,貿聯國票99購01,2.25,2.44,2.25,2.44,+0.19,8.44,88000,11,203480,0,0,0,0,0,0,35000,56000,-21000,-21000
20200212,05666P,聯發科凱基96售14,,,,,0.00,0.00,0,0,0,0,0,0,0,0,0,0,0,0,0
20200212,056670,樺漢國票99購01,2.62,2.69,2.62,2.69,+0.11,4.26,274000,8,734660,0,0,0,0,0,0,32000,242000,-210000,-210000
20200212,056671,台灣50元富9A購01,2.62,2.89,2.62,2.89,+0.35,13.78,423000,28,1145430,0,0,0,0,0,0,387000,51000,336000,336000
20200212,056672,元油2X元富98購10,2.30,2.42,2.30,2.42,+0.13,5.68,40000,7,94900,0,0,0,0,0,0,15000,25000,-10000,-10000
20200212,056673,中石化元富9B購01,,,,,0.00,0.00,0,0,0,0,0,0,0,0,0,0,0,0,0
20200212,056674,華邦電元富98購01,1.86,1.88,1.79,1.81,+0.15,9.04,116000,14,211920,0,0,0,0,0,0,67000,106000,-39000,-39000
20200212,056675,聯發科元富02購01,1.41,1.51,1.41,1.51,+0.20,15.27,35000,7,50640,0,0,0,0,0,0,11000,24000,-13000,-13000
20200212,056676,國產元富98購01,1.59,1.59,1.57,1.57,-0.08,-4.85,40000,12,63400,0,0,0,0,0,0,30000,10000,20000,20000
20200212,056677,智伸科元富98購01,2.87,2.87,2.87,2.87,0.00,0.00,10000,1,28700,0,0,0,0,0,0,0,10000,-10000,-10000
20200212,056678,力成元富98購01,1.91,2.07,1.87,2.07,+0.34,19.65,100000,15,199280,0,0,0,0,0,0,16000,84000,-68000,-68000
20200212,056679,元油2X統一98購01,1.04,1.07,1.04,1.07,+0.06,5.94,376000,6,398000,0,0,0,0,0,0,46000,330000,-284000,-284000
20200212,05667P,旺宏台新96售01,,,,,0.00,0.00,0,0,0,0,0,0,0,0,0,0,0,0,0
20200212,056680,華通統一98購04,1.09,1.30,1.09,1.30,+0.23,21.5,707000,12,838440,0,0,0,0,0,0,206000,613000,-407000,-407000
20200212,056681,鴻海統一98購09,1.35,1.41,1.35,1.41,+0.11,8.46,51000,2,71610,0,0,0,0,0,0,51000,0,51000,51000
20200212,056682,鴻海統一98購10,1.38,1.38,1.38,1.38,+0.08,6.15,46000,1,63480,0,0,0,0,0,0,46000,0,46000,46000
20200212,056683,台積電統一98購05,,,,,0.00,0.00,0,0,0,0,0,0,0,0,0,0,0,0,0
20200212,056684,旺宏統一98購02,2.67,2.67,2.67,2.67,0.00,0.00,48000,2,128160,0,0,0,0,0,0,48000,0,48000,48000
20200212,056685,光罩統一98購03,1.32,1.44,1.32,1.44,+0.10,7.46,594000,26,815300,0,0,0,0,0,0,260000,334000,-74000,-74000
20200212,056686,可成統一98購01,1.14,1.24,1.11,1.24,+0.17,15.89,604000,11,698650,0,0,0,0,0,0,0,604000,-604000,-604000
20200212,056687,元大金統一98購01,1.06,1.07,1.02,1.02,-0.06,-5.56,41000,5,42870,0,0,0,0,0,0,10000,31000,-21000,-21000
20200212,056688,聯詠統一98購01,1.12,1.22,1.12,1.20,+0.08,7.14,499000,17,592520,0,0,0,0,0,0,484000,0,484000,484000
20200212,056689,玉晶光統一9A購03,2.73,2.86,2.72,2.86,+0.25,9.58,450000,13,1257550,0,0,0,0,0,0,182000,268000,-86000,-86000
20200212,05668P,滬深2X永豐96售04,1.73,1.74,1.71,1.71,+0.02,1.18,35000,4,60550,0,0,0,0,0,0,5000,30000,-25000,-25000
20200212,056691,元油2X群益9B購01,2.13,2.21,2.13,2.21,+0.14,6.76,193000,8,418420,0,0,0,0,0,0,184000,179000,5000,5000
20200212,056692,燿華群益98購03,1.36,1.54,1.36,1.53,+0.17,12.5,268000,22,399170,0,0,0,0,0,0,105000,268000,-163000,-163000
20200212,056693,國產群益98購01,1.53,1.53,1.53,1.53,-0.04,-2.55,1000,1,1530,0,0,0,0,0,0,1000,0,1000,1000
20200212,056694,欣興群益98購04,5.05,6.00,5.00,5.95,+0.85,16.67,117000,18,652500,0,0,0,0,0,0,49000,68000,-19000,-19000
20200212,056695,景碩群益99購01,2.99,3.85,2.99,3.64,+0.56,18.18,259000,38,855750,0,0,0,0,0,0,136000,196000,-60000,-60000
20200212,056696,茂林群益98購02,1.77,1.85,1.71,1.78,+0.03,1.71,437000,47,774230,0,0,0,0,0,0,295000,255000,40000,40000
20200212,056697,緯穎群益98購01,2.98,3.32,2.91,3.26,+0.15,4.82,277000,31,882420,0,0,0,0,0,0,160000,259000,-99000,-99000
20200212,056698,T50反1國泰9A購01,0.59,0.60,0.57,0.57,-0.04,-6.56,514000,3,303260,0,0,0,0,0,0,0,514000,-514000,-514000
20200212,056699,光罩國泰99購01,,,,,0.00,0.00,0,0,0,0,0,0,0,0,0,0,0,0,0
20200212,05669P,嘉晶永豐96售03,1.68,1.68,1.68,1.68,-0.11,-6.15,1000,1,1680,0,0,0,0,0,0,0,1000,-1000,-1000
20200212,056700,華新科國泰99購03,2.74,2.74,2.67,2.74,+0.07,2.62,406000,31,1101920,0,0,0,0,0,0,406000,26000,380000,380000
20200212,056701,國產國泰9A購01,1.52,1.52,1.51,1.52,+0.02,1.33,50000,20,75990,0,0,0,0,0,0,50000,0,50000,50000
20200212,056702,欣興國泰9A購01,1.99,2.25,1.99,2.25,0.00,0.00,15000,5,32010,0,0,0,0,0,0,0,15000,-15000,-15000
20200212,056703,群創國泰9A購01,,,,,0.00,0.00,0,0,0,0,0,0,0,0,0,0,0,0,0
20200212,056704,健策國泰99購01,2.06,2.25,2.01,2.23,+0.25,12.63,1022000,86,2163090,0,0,0,0,0,0,676000,538000,138000,138000
20200212,056705,超眾國泰99購01,1.91,2.00,1.91,2.00,+0.05,2.56,140000,14,272140,0,0,0,0,0,0,140000,0,140000,140000
20200212,056706,元油2X富邦9B購01,0.82,0.82,0.82,0.82,0.00,0.00,5000,1,4100,0,0,0,0,0,0,0,5000,-5000,-5000
20200212,056707,鴻海富邦99購03,1.47,1.59,1.46,1.59,+0.19,13.57,307000,8,466000,0,0,0,0,0,0,12000,295000,-283000,-283000
20200212,056708,元油2X永豐98購02,,,,,0.00,0.00,0,0,0,0,0,0,0,0,0,0,0,0,0
20200212,056709,華通永豐98購01,1.63,2.27,1.63,2.21,+0.54,32.34,389000,28,791760,0,0,0,0,0,0,138000,282000,-144000,-144000
20200212,05670P,台積電國票98售01,0.77,0.77,0.72,0.72,-0.12,-14.29,142000,12,106070,0,0,0,0,0,0,60000,81000,-21000,-21000
20200212,056710,漢唐永豐98購01,0.86,0.87,0.86,0.87,+0.02,2.35,162000,4,140110,0,0,0,0,0,0,161000,1000,160000,160000
20200212,056711,亞光永豐98購01,1.56,1.65,1.56,1.65,0.00,0.00,174000,16,279360,0,0,0,0,0,0,35000,174000,-139000,-139000
20200212,056712,京鼎永豐98購01,1.12,1.20,1.11,1.20,+0.22,22.45,334000,23,392030,0,0,0,0,0,0,0,334000,-334000,-334000
20200212,056713,華擎永豐98購01,2.04,2.06,1.80,1.90,-0.04,-2.06,332000,38,636230,0,0,0,0,0,0,87000,215000,-128000,-128000
20200212,056714,晶相光永豐98購02,1.98,2.12,1.98,2.00,+0.07,3.63,174000,21,355520,0,0,0,0,0,0,75000,120000,-45000,-45000
20200212,056715,瀚宇博永豐98購01,1.64,1.86,1.64,1.86,+0.15,8.77,276000,22,481730,0,0,0,0,0,0,140000,194000,-54000,-54000
20200212,056716,康舒永豐98購01,1.61,1.61,1.61,1.61,0.00,0.00,63000,2,101430,0,0,0,0,0,0,0,63000,-63000,-63000
20200212,056717,康友永豐98購01,1.35,1.44,1.35,1.37,0.00,0.00,137000,8,193130,0,0,0,0,0,0,99000,115000,-16000,-16000
20200212,056718,GIS永豐98購01,1.28,1.34,1.28,1.34,+0.08,6.35,221000,12,289620,0,0,0,0,0,0,50000,171000,-121000,-121000
20200212,056719,台虹永豐98購01,1.02,1.03,1.02,1.03,0.00,0.00,3000,3,3080,0,0,0,0,0,0,0,3000,-3000,-3000
20200212,05671P,友達國泰97售03,,,,,0.00,0.00,0,0,0,0,0,0,0,0,0,0,0,0,0
20200212,056720,世紀鋼永豐98購01,1.41,1.46,1.40,1.45,+0.02,1.4,300000,30,428080,0,0,0,0,0,0,298000,6000,292000,292000
20200212,056721,台灣50永昌9A購01,3.26,3.38,3.24,3.38,+0.22,6.96,185000,7,607570,0,0,0,0,0,0,185000,30000,155000,155000
20200212,056722,滬深反中信9B購01,,,,,0.00,0.00,0,0,0,0,0,0,0,0,0,0,0,0,0
20200212,056723,國巨中信9A購01,2.14,2.14,2.09,2.13,+0.12,5.97,52000,4,110380,0,0,0,0,0,0,44000,8000,36000,36000
20200212,056724,臻鼎中信9A購01,0.82,0.92,0.73,0.75,+0.06,8.7,216000,18,173240,0,0,0,0,0,0,106000,110000,-4000,-4000
20200212,056725,鴻海國票99購03,0.68,0.80,0.68,0.80,+0.19,31.15,141000,4,112680,0,0,0,0,0,0,1000,140000,-139000,-139000
20200212,056726,友達日盛9A購01,1.60,1.60,1.56,1.59,-0.06,-3.64,255000,8,406300,0,0,0,0,0,0,100000,155000,-55000,-55000
20200212,056727,滬深反凱基9B購01,,,,,0.00,0.00,0,0,0,0,0,0,0,0,0,0,0,0,0
20200212,056728,元油2X凱基9A購02,,,,,0.00,0.00,0,0,0,0,0,0,0,0,0,0,0,0,0
20200212,056729,元油2X凱基9A購03,,,,,0.00,0.00,0,0,0,0,0,0,0,0,0,0,0,0,0
20200212,05672P,鴻海群益96售03,,,,,0.00,0.00,0,0,0,0,0,0,0,0,0,0,0,0,0
20200212,056730,元油2X凱基9A購04,1.43,1.48,1.43,1.48,+0.08,5.71,55000,4,79400,0,0,0,0,0,0,0,55000,-55000,-55000
20200212,056731,國巨凱基98購04,,,,,0.00,0.00,0,0,0,0,0,0,0,0,0,0,0,0,0
20200212,056732,國巨凱基98購07,,,,,0.00,0.00,0,0,0,0,0,0,0,0,0,0,0,0,0
20200212,056733,國巨凱基98購10,,,,,0.00,0.00,0,0,0,0,0,0,0,0,0,0,0,0,0
20200212,056734,國巨凱基99購01,,,,,0.00,0.00,0,0,0,0,0,0,0,0,0,0,0,0,0
20200212,056735,國巨凱基99購02,,,,,0.00,0.00,0,0,0,0,0,0,0,0,0,0,0,0,0
20200212,056736,國巨凱基99購03,,,,,0.00,0.00,0,0,0,0,0,0,0,0,0,0,0,0,0
20200212,056737,國巨凱基9A購01,,,,,0.00,0.00,0,0,0,0,0,0,0,0,0,0,0,0,0
20200212,056738,國巨凱基9A購02,2.67,2.67,2.67,2.67,0.00,0.00,6000,1,16020,0,0,0,0,0,0,6000,0,6000,6000
20200212,056739,美律凱基98購04,0.91,0.97,0.90,0.97,+0.17,21.25,171000,14,160450,0,0,0,0,0,0,57000,155000,-98000,-98000
20200212,05673P,台積電群益96售05,1.03,1.04,0.97,0.97,-0.22,-18.49,181000,4,185880,0,0,0,0,0,0,65000,116000,-51000,-51000
20200212,056740,大立光凱基98購13,3.62,3.62,3.62,3.62,0.00,0.00,10000,1,36200,0,0,0,0,0,0,10000,10000,0,0
20200212,056741,大立光凱基98購14,,,,,0.00,0.00,0,0,0,0,0,0,0,0,0,0,0,0,0
20200212,056742,玉晶光凱基9A購01,0.78,0.79,0.78,0.78,+0.06,8.33,69000,5,54400,0,0,0,0,0,0,35000,34000,1000,1000
20200212,056743,貿聯凱基98購04,1.68,1.74,1.68,1.74,0.00,0.00,76000,4,131020,0,0,0,0,0,0,0,76000,-76000,-76000
20200212,056744,麗豐凱基9A購01,0.81,0.84,0.80,0.84,+0.04,5.0,265000,6,220750,0,0,0,0,0,0,265000,0,265000,265000
20200212,056745,聯茂凱基99購03,,,,,0.00,0.00,0,0,0,0,0,0,0,0,0,0,0,0,0
20200212,056746,超眾凱基99購01,2.39,2.54,2.39,2.54,+0.18,7.63,43000,2,105770,0,0,0,0,0,0,23000,20000,3000,3000
20200212,056747,致新凱基99購01,1.20,1.24,1.19,1.24,+0.01,0.81,118000,13,142260,0,0,0,0,0,0,118000,0,118000,118000
20200212,056748,T50反1兆豐99購01,,,,,0.00,0.00,0,0,0,0,0,0,0,0,0,0,0,0,0
20200212,056749,滬深2X兆豐99購01,,,,,0.00,0.00,0,0,0,0,0,0,0,0,0,0,0,0,0
20200212,05674P,瑞昱群益96售02,0.92,0.95,0.92,0.95,-0.06,-5.94,53000,4,50320,0,0,0,0,0,0,0,53000,-53000,-53000
20200212,056750,元油2X兆豐9A購01,,,,,0.00,0.00,0,0,0,0,0,0,0,0,0,0,0,0,0
20200212,056751,和大兆豐98購01,0.96,0.96,0.91,0.93,-0.04,-4.12,270000,10,252800,0,0,0,0,0,0,120000,150000,-30000,-30000
20200212,056752,國巨兆豐98購02,1.53,1.57,1.53,1.57,+0.19,13.77,120000,6,184650,0,0,0,0,0,0,70000,50000,20000,20000
20200212,056753,群創兆豐98購02,0.88,0.88,0.88,0.88,+0.01,1.15,30000,1,26400,0,0,0,0,0,0,30000,0,30000,30000
20200212,056754,智易兆豐99購01,1.53,1.82,1.53,1.81,+0.29,19.08,587000,30,988220,0,0,0,0,0,0,49000,538000,-489000,-489000
20200212,056755,聯茂兆豐98購01,1.09,1.35,1.07,1.28,+0.25,24.27,729000,27,906640,0,0,0,0,0,0,590000,129000,461000,461000
20200212,056756,T50反1元大98購06,0.51,0.51,0.48,0.48,-0.04,-7.69,1363000,6,694850,0,0,0,0,0,0,1352000,11000,1341000,1341000
20200212,056757,T50反1元大98購07,,,,,0.00,0.00,0,0,0,0,0,0,0,0,0,0,0,0,0
20200212,056758,元石油元大98購02,,,,,0.00,0.00,0,0,0,0,0,0,0,0,0,0,0,0,0
20200212,056759,元油2X元大98購05,1.20,1.24,1.20,1.24,0.00,0.00,52000,4,64200,0,0,0,0,0,0,2000,50000,-48000,-48000
20200212,05675P,美律群益97售01,1.45,1.45,1.45,1.45,-0.20,-12.12,30000,2,43500,0,0,0,0,0,0,30000,0,30000,30000
20200212,056760,元油2X元大98購06,1.25,1.30,1.25,1.30,+0.09,7.44,298000,25,381450,0,0,0,0,0,0,115000,183000,-68000,-68000
20200212,056761,元油2X元大98購07,1.49,1.51,1.49,1.51,+0.07,4.86,40000,4,59800,0,0,0,0,0,0,10000,30000,-20000,-20000
20200212,056762,亞德客元大98購01,2.13,2.25,2.11,2.22,-0.05,-2.2,418000,34,911000,0,0,0,0,0,0,408000,157000,251000,251000
20200212,056763,國巨元大99購02,5.40,5.45,5.25,5.45,+0.35,6.86,96000,8,517200,0,0,0,0,0,0,66000,79000,-13000,-13000
20200212,056764,友達元大9A購03,1.76,1.76,1.76,1.76,-0.04,-2.22,34000,4,59840,0,0,0,0,0,0,24000,34000,-10000,-10000
20200212,056765,友達元大9B購05,1.79,1.79,1.68,1.68,-0.11,-6.15,64000,7,109760,0,0,0,0,0,0,64000,56000,8000,8000
20200212,056766,義隆元大98購01,2.63,2.63,2.45,2.56,+0.30,13.27,431000,40,1093540,0,0,0,0,0,0,180000,411000,-231000,-231000
20200212,056767,大毅元大99購01,1.93,1.93,1.90,1.91,-0.03,-1.55,207000,8,397190,0,0,0,0,0,0,175000,177000,-2000,-2000
20200212,056768,宏達電元大99購03,2.93,2.99,2.93,2.99,+0.20,7.17,26000,3,77440,0,0,0,0,0,0,0,26000,-26000,-26000
20200212,056769,國產元大98購01,,,,,0.00,0.00,0,0,0,0,0,0,0,0,0,0,0,0,0
20200212,05676P,欣興群益96售04,2.89,2.89,2.44,2.44,-0.54,-18.12,26000,3,66340,0,0,0,0,0,0,10000,16000,-6000,-6000
20200212,056770,國產元大98購02,,,,,0.00,0.00,0,0,0,0,0,0,0,0,0,0,0,0,0
20200212,056771,嘉晶元大99購01,4.07,4.40,4.03,4.36,0.00,0.00,167000,16,710760,0,0,0,0,0,0,45000,167000,-122000,-122000
20200212,056772,欣興元大99購01,3.45,4.27,3.45,4.27,+0.74,20.96,304000,47,1190170,0,0,0,0,0,0,113000,282000,-169000,-169000
20200212,056773,晶技元大99購03,1.15,1.18,1.14,1.17,0.00,0.00,160000,9,183840,0,0,0,0,0,0,0,160000,-160000,-160000
20200212,056774,和鑫元大98購01,1.87,1.93,1.87,1.93,+0.07,3.76,106000,4,201280,0,0,0,0,0,0,31000,76000,-45000,-45000
20200212,056775,康控元大99購01,1.53,1.65,1.52,1.61,+0.11,7.33,335000,26,534250,0,0,0,0,0,0,254000,277000,-23000,-23000
20200212,056776,聯茂元大99購01,3.90,4.77,3.90,4.67,+0.99,26.9,142000,13,591740,0,0,0,0,0,0,63000,79000,-16000,-16000
20200212,056777,矽力元大98購02,2.08,2.22,2.08,2.22,+0.22,11.0,40000,10,87600,0,0,0,0,0,0,6000,34000,-28000,-28000
20200212,056778,元石油群益9B購01,1.46,1.51,1.46,1.50,+0.05,3.45,16000,5,23960,0,0,0,0,0,0,2000,14000,-12000,-12000
20200212,056779,元油2X群益9A購02,2.35,2.38,2.35,2.37,+0.11,4.87,50000,6,118500,0,0,0,0,0,0,5000,45000,-40000,-40000
20200212,05677P,玉晶光群益98售03,0.32,0.33,0.31,0.32,-0.02,-5.88,290000,11,91230,0,0,0,0,0,0,130000,110000,20000,20000
20200212,056780,元油2X群益9A購03,,,,,0.00,0.00,0,0,0,0,0,0,0,0,0,0,0,0,0
20200212,056781,元油2X群益9B購02,,,,,0.00,0.00,0,0,0,0,0,0,0,0,0,0,0,0,0
20200212,056782,鴻海群益98購04,3.38,3.77,3.36,3.77,+0.63,20.06,161000,15,559230,0,0,0,0,0,0,48000,117000,-69000,-69000
20200212,056783,國巨群益99購01,3.79,3.91,3.79,3.91,+0.27,7.42,231000,17,885170,0,0,0,0,0,0,65000,201000,-136000,-136000
20200212,056784,南亞科群益98購01,2.15,2.20,2.15,2.20,+0.05,2.33,7000,3,15290,0,0,0,0,0,0,7000,7000,0,0
20200212,056785,可成群益99購01,2.05,2.26,1.98,2.26,+0.37,19.58,224000,13,474990,0,0,0,0,0,0,122000,192000,-70000,-70000
20200212,056786,亞光群益98購03,1.27,1.44,1.27,1.41,+0.16,12.8,328000,17,436020,0,0,0,0,0,0,167000,168000,-1000,-1000
20200212,056787,健鼎群益98購01,1.42,1.82,1.41,1.79,+0.52,40.94,369000,50,599420,0,0,0,0,0,0,24000,345000,-321000,-321000
20200212,056788,日月光群益98購01,2.04,2.22,2.04,2.22,+0.34,18.09,58000,4,120390,0,0,0,0,0,0,45000,13000,32000,32000
20200212,056789,和碩群益98購01,2.25,2.38,2.25,2.38,+0.06,2.59,38000,2,86800,0,0,0,0,0,0,28000,10000,18000,18000
20200212,05678P,群創群益97售01,,,,,0.00,0.00,0,0,0,0,0,0,0,0,0,0,0,0,0
20200212,056790,彩晶群益98購03,0.96,0.96,0.96,0.96,0.00,0.00,5000,1,4800,0,0,0,0,0,0,5000,0,5000,5000
20200212,056791,嘉聯益群益98購01,3.89,4.22,3.89,3.99,+0.24,6.4,70000,15,281650,0,0,0,0,0,0,27000,43000,-16000,-16000
20200212,056792,訊芯群益98購01,0.96,1.10,0.96,1.08,+0.12,12.5,115000,10,123190,0,0,0,0,0,0,12000,103000,-91000,-91000
20200212,056793,臺股指群益98購03,,,,,0.00,0.00,0,0,0,0,0,0,0,0,0,0,0,0,0
20200212,056794,上銀麥證98購01,2.31,2.31,2.26,2.26,+0.04,1.8,145000,6,332100,100000,45000,55000,0,0,0,100000,45000,55000,55000
20200212,056795,鴻海麥證98購01,,,,,0.00,0.00,0,0,0,0,0,0,0,0,0,0,0,0,0
20200212,056796,國巨麥證98購02,3.22,3.22,3.18,3.18,+0.26,8.9,45000,4,143400,45000,0,45000,0,0,0,45000,0,45000,45000
20200212,056797,台積電麥證98購01,3.56,3.59,3.56,3.59,+0.11,3.16,610000,7,2180000,610000,0,610000,0,0,0,610000,0,610000,610000
20200212,056798,華新科麥證98購01,,,,,0.00,0.00,0,0,0,0,0,0,0,0,0,0,0,0,0
20200212,056799,群創麥證98購01,,,,,0.00,0.00,0,0,0,0,0,0,0,0,0,0,0,0,0
20200212,05679P,台表科群益96售05,2.47,2.48,2.47,2.48,0.00,0.00,25000,3,61900,0,0,0,0,0,0,0,25000,-25000,-25000
20200212,056800,臺股指麥證98購01,,,,,0.00,0.00,0,0,0,0,0,0,0,0,0,0,0,0,0
20200212,056801,國巨台新98購01,,,,,0.00,0.00,0,0,0,0,0,0,0,0,0,0,0,0,0
20200212,056802,友達台新98購01,0.97,0.97,0.92,0.92,-0.12,-11.54,26000,4,24130,0,0,0,0,0,0,24000,1000,23000,23000
20200212,056803,群創台新99購02,0.88,0.88,0.88,0.88,+0.02,2.33,17000,1,14960,0,0,0,0,0,0,0,17000,-17000,-17000
20200212,056804,T50反1統一9A購03,,,,,0.00,0.00,0,0,0,0,0,0,0,0,0,0,0,0,0
20200212,056805,元石油統一9B購01,1.48,1.53,1.48,1.53,+0.07,4.79,61000,12,92090,0,0,0,0,0,0,21000,40000,-19000,-19000
20200212,056806,元油2X統一98購02,0.96,1.00,0.96,1.00,+0.07,7.53,174000,10,170480,5000,0,5000,0,0,0,0,174000,-174000,-169000
20200212,056807,元油2X統一9B購01,1.10,1.14,1.10,1.14,+0.07,6.54,285000,7,319710,0,0,0,0,0,0,100000,185000,-85000,-85000
20200212,056808,台積電統一98購06,1.62,1.65,1.60,1.65,+0.09,5.77,442000,8,715860,0,0,0,0,0,0,225000,217000,8000,8000
20200212,056809,旺宏統一98購03,,,,,0.00,0.00,0,0,0,0,0,0,0,0,0,0,0,0,0
20200212,05680P,聯發科元大96售12,1.78,1.79,1.76,1.76,-0.32,-15.38,70000,5,124250,0,0,0,0,0,0,35000,70000,-35000,-35000
20200212,056810,群創統一9A購01,1.37,1.37,1.37,1.37,-0.03,-2.14,30000,1,41100,0,0,0,0,0,0,30000,0,30000,30000
20200212,056811,健策統一9B購01,0.81,0.88,0.78,0.88,+0.12,15.79,788000,28,655980,0,0,0,0,0,0,440000,348000,92000,92000
20200212,056812,泰鼎統一98購01,1.35,1.46,1.33,1.38,+0.12,9.52,363000,23,501450,0,0,0,0,0,0,361000,0,361000,361000
20200212,056813,聯茂統一99購01,1.30,1.61,1.30,1.50,+0.24,19.05,641000,25,913500,0,0,0,0,0,0,225000,416000,-191000,-191000
20200212,056814,元油2X永豐98購04,,,,,0.00,0.00,0,0,0,0,0,0,0,0,0,0,0,0,0
20200212,056815,元油2X永豐98購05,,,,,0.00,0.00,0,0,0,0,0,0,0,0,0,0,0,0,0
20200212,056816,華通永豐98購02,1.21,1.63,1.21,1.58,+0.49,44.95,314000,16,434400,0,0,0,0,0,0,98000,256000,-158000,-158000
20200212,056817,國巨永豐98購04,1.73,1.73,1.73,1.73,+0.07,4.22,29000,1,50170,0,0,0,0,0,0,29000,0,29000,29000
20200212,056818,正崴永豐98購01,1.37,1.38,1.36,1.38,-0.03,-2.13,250000,21,343240,0,0,0,0,0,0,250000,3000,247000,247000
20200212,056819,奇力新永豐98購01,1.02,1.06,0.99,1.06,+0.02,1.92,631000,57,643740,0,0,0,0,0,0,470000,161000,309000,309000
20200212,05681P,大立光元大96售05,2.64,2.64,2.60,2.60,-0.24,-8.45,30000,2,79000,0,0,0,0,0,0,30000,0,30000,30000
20200212,056820,欣興永豐98購02,1.59,1.97,1.58,1.97,+0.37,23.12,295000,20,539110,0,0,0,0,0,0,81000,236000,-155000,-155000
20200212,056821,日電貿永豐98購01,1.57,1.61,1.52,1.60,+0.07,4.58,499000,36,783790,0,0,0,0,0,0,345000,154000,191000,191000
20200212,056822,佐登永豐98購01,0.85,0.96,0.85,0.93,+0.09,10.71,509000,20,463460,0,0,0,0,0,0,50000,459000,-409000,-409000
20200212,056823,智伸科永豐98購01,1.12,1.14,1.12,1.14,0.00,0.00,36000,2,40720,0,0,0,0,0,0,36000,0,36000,36000
20200212,056824,元石油富邦9B購01,0.73,0.73,0.73,0.73,0.00,0.00,50000,2,36500,0,0,0,0,0,0,50000,0,50000,50000
20200212,056825,深中小富邦9B購01,0.98,1.05,0.98,1.05,+0.11,11.7,590000,10,602900,0,0,0,0,0,0,230000,360000,-130000,-130000
20200212,056826,A50正2富邦9B購02,,,,,0.00,0.00,0,0,0,0,0,0,0,0,0,0,0,0,0
20200212,056827,元油2X富邦02購01,,,,,0.00,0.00,0,0,0,0,0,0,0,0,0,0,0,0,0
20200212,056828,國巨富邦9A購03,0.97,1.00,0.97,1.00,+0.07,7.53,16000,4,15850,0,0,0,0,0,0,10000,3000,7000,7000
20200212,056829,台積電富邦9A購01,0.91,0.93,0.89,0.92,+0.05,5.75,1188000,13,1062130,0,0,0,0,0,0,1020000,168000,852000,852000
20200212,05682P,大立光元大98售03,1.48,1.48,1.38,1.38,-0.12,-8.0,191000,12,268410,0,0,0,0,0,0,34000,147000,-113000,-113000
20200212,056830,友達富邦99購01,0.70,0.70,0.64,0.66,-0.07,-9.59,117000,11,80090,0,0,0,0,0,0,78000,39000,39000,39000
20200212,056831,元油2X元富98購11,1.62,1.70,1.62,1.70,+0.11,6.92,47000,7,77440,0,0,0,0,0,0,10000,37000,-27000,-27000
20200212,056832,元油2X元富98購12,,,,,0.00,0.00,0,0,0,0,0,0,0,0,0,0,0,0,0
20200212,056833,和大元富9B購01,1.79,1.90,1.79,1.90,+0.01,0.53,112000,3,201800,0,0,0,0,0,0,0,112000,-112000,-112000
20200212,056834,華新元富99購01,1.18,1.20,1.15,1.20,0.00,0.00,43000,7,50180,0,0,0,0,0,0,0,43000,-43000,-43000
20200212,056835,聯電元富99購01,2.28,2.37,2.28,2.37,+0.09,3.95,177000,20,415120,0,0,0,0,0,0,159000,18000,141000,141000
20200212,056836,國巨元富98購01,1.59,1.62,1.53,1.62,+0.12,8.0,387000,23,601420,0,0,0,0,0,0,186000,258000,-72000,-72000
20200212,056837,國巨元富98購02,1.79,1.84,1.78,1.84,+0.14,8.24,29000,11,52650,0,0,0,0,0,0,12000,29000,-17000,-17000
20200212,056838,旺宏元富98購01,,,,,0.00,0.00,0,0,0,0,0,0,0,0,0,0,0,0,0
20200212,056839,台光電元富98購02,1.82,2.22,1.82,2.19,+0.40,22.35,642000,28,1260070,0,0,0,0,0,0,51000,642000,-591000,-591000
20200212,05683P,矽創元大96售01,1.61,1.61,1.59,1.59,-0.03,-1.85,116000,2,186200,0,0,0,0,0,0,116000,0,116000,116000
20200212,056840,友達元富98購02,1.15,1.15,1.09,1.09,-0.11,-9.17,20000,3,22400,0,0,0,0,0,0,10000,10000,0,0
20200212,056841,友達元富98購03,0.98,0.98,0.93,0.93,-0.09,-8.82,80000,8,76900,0,0,0,0,0,0,10000,70000,-60000,-60000
20200212,056842,全新元富98購01,2.29,2.57,2.29,2.57,0.00,0.00,211000,21,508950,0,0,0,0,0,0,0,211000,-211000,-211000
20200212,056843,冠德元富98購01,,,,,0.00,0.00,0,0,0,0,0,0,0,0,0,0,0,0,0
20200212,056844,欣興元富98購03,3.67,4.21,3.67,4.21,+0.63,17.6,229000,24,907490,0,0,0,0,0,0,32000,199000,-167000,-167000
20200212,056845,揚明光元富98購01,2.52,2.58,2.52,2.58,0.00,0.00,29000,4,74220,0,0,0,0,0,0,0,29000,-29000,-29000
20200212,056846,晶相光元富98購01,3.22,3.40,3.18,3.18,+0.07,2.25,158000,14,514950,0,0,0,0,0,0,78000,105000,-27000,-27000
20200212,056847,佐登元富98購01,3.05,3.33,2.98,3.33,+0.35,11.74,270000,35,872890,0,0,0,0,0,0,74000,196000,-122000,-122000
20200212,056848,泰鼎元富98購01,1.38,1.46,1.36,1.40,+0.07,5.26,111000,33,158220,0,0,0,0,0,0,10000,101000,-91000,-91000
20200212,056849,瀚宇博元富98購01,3.16,3.45,3.16,3.44,+0.15,4.56,123000,11,414030,0,0,0,0,0,0,24000,99000,-75000,-75000
20200212,05684P,臺股指元大96售09,1.26,1.26,1.12,1.13,-0.17,-13.08,381000,23,459300,0,0,0,0,0,0,130000,251000,-121000,-121000
20200212,056850,彩晶元富99購01,,,,,0.00,0.00,0,0,0,0,0,0,0,0,0,0,0,0,0
20200212,056851,瑞儀元富98購01,2.19,2.19,2.19,2.19,+0.03,1.39,5000,1,10950,0,0,0,0,0,0,0,5000,-5000,-5000
20200212,056852,矽格元富98購01,4.10,4.24,4.08,4.24,+0.35,9.0,65000,25,271250,0,0,0,0,0,0,10000,55000,-45000,-45000
20200212,056853,元油2X中信9B購02,,,,,0.00,0.00,0,0,0,0,0,0,0,0,0,0,0,0,0
20200212,056854,友達中信9A購01,1.07,1.07,0.97,0.97,-0.11,-10.19,958000,34,974160,0,0,0,0,0,0,230000,713000,-483000,-483000
20200212,056855,祥碩中信98購02,0.88,1.09,0.88,1.08,+0.27,33.33,576000,39,556690,0,0,0,0,0,0,72000,489000,-417000,-417000
20200212,056856,華通群益9A購01,2.98,3.35,2.95,3.22,+0.51,18.82,395000,20,1215750,0,0,0,0,0,0,154000,241000,-87000,-87000
20200212,056857,國巨群益99購02,3.02,3.12,3.02,3.12,+0.19,6.48,148000,13,449120,0,0,0,0,0,0,117000,46000,71000,71000
20200212,056858,國巨群益99購03,3.45,3.56,3.42,3.56,+0.30,9.2,215000,9,751080,0,0,0,0,0,0,43000,172000,-129000,-129000
20200212,056859,台積電群益98購02,3.61,3.81,3.57,3.81,+0.28,7.93,354000,43,1276450,0,0,0,0,0,0,340000,342000,-2000,-2000
20200212,05685P,臺股指元大96售10,1.58,1.58,1.42,1.44,-0.21,-12.73,210000,14,311250,0,0,0,0,0,0,70000,140000,-70000,-70000
20200212,056860,正崴群益98購01,2.06,2.14,2.04,2.14,+0.05,2.39,155000,12,319520,0,0,0,0,0,0,155000,9000,146000,146000
20200212,056861,美律群益99購01,1.98,2.31,1.98,2.27,+0.43,23.37,347000,39,741780,0,0,0,0,0,0,55000,315000,-260000,-260000
20200212,056862,聯發科群益98購03,2.15,2.33,2.15,2.33,+0.31,15.35,191000,5,418900,0,0,0,0,0,0,154000,37000,117000,117000
20200212,056863,義隆群益98購01,3.37,3.37,3.17,3.22,+0.30,10.27,198000,17,656730,0,0,0,0,0,0,113000,85000,28000,28000
20200212,056864,新日興群益99購01,2.15,2.15,2.05,2.08,-0.15,-6.73,300000,15,633550,0,0,0,0,0,0,210000,190000,20000,20000
20200212,056865,樺漢群益98購01,2.03,2.20,2.03,2.15,+0.14,6.97,388000,11,812770,0,0,0,0,0,0,240000,148000,92000,92000
20200212,056866,矽創群益98購03,2.14,2.55,2.14,2.55,+0.46,22.01,134000,12,320870,0,0,0,0,0,0,65000,69000,-4000,-4000
20200212,056867,華通麥證98購01,1.60,2.00,1.60,1.96,0.00,0.00,100000,16,184520,0,100000,-100000,0,0,0,1000,100000,-99000,-99000
20200212,056868,奇力新麥證98購01,0.88,0.88,0.85,0.86,+0.03,3.61,86000,8,73910,61000,25000,36000,0,0,0,61000,25000,36000,36000
20200212,056869,國巨日盛99購03,2.73,2.73,2.73,2.73,+0.20,7.91,5000,1,13650,0,0,0,0,0,0,0,5000,-5000,-5000
20200212,05686P,臺股指元大96售11,1.56,1.56,1.46,1.46,-0.16,-9.88,155000,5,230700,0,0,0,0,0,0,110000,45000,65000,65000
20200212,056870,全新日盛9A購01,2.37,2.70,2.36,2.70,+0.62,29.81,550000,20,1377790,0,0,0,0,0,0,56000,494000,-438000,-438000
20200212,056871,新日興日盛99購01,2.11,2.11,2.11,2.11,-0.01,-0.47,29000,3,61190,0,0,0,0,0,0,29000,0,29000,29000
20200212,056872,旺宏凱基98購08,1.78,1.78,1.78,1.78,0.00,0.00,1000,1,1780,0,0,0,0,0,0,1000,1000,0,0
20200212,056873,友達凱基98購07,,,,,0.00,0.00,0,0,0,0,0,0,0,0,0,0,0,0,0
20200212,056874,友達凱基98購08,0.85,0.85,0.85,0.85,-0.04,-4.49,100000,2,85000,0,0,0,0,0,0,100000,0,100000,100000
20200212,056875,亞光凱基98購03,1.29,1.31,1.29,1.29,0.00,0.00,18000,4,23280,0,0,0,0,0,0,18000,15000,3000,3000
20200212,056876,群創凱基98購11,,,,,0.00,0.00,0,0,0,0,0,0,0,0,0,0,0,0,0
20200212,056877,群創凱基99購04,,,,,0.00,0.00,0,0,0,0,0,0,0,0,0,0,0,0,0
20200212,056878,元油2X國票99購02,,,,,0.00,0.00,0,0,0,0,0,0,0,0,0,0,0,0,0
20200212,056879,旺宏國票99購02,,,,,0.00,0.00,0,0,0,0,0,0,0,0,0,0,0,0,0
20200212,05687P,臺股指元大96售12,1.39,1.39,1.38,1.38,-0.14,-9.21,205000,2,284900,0,0,0,0,0,0,200000,5000,195000,195000
20200212,056880,緯穎國票98購02,3.41,3.41,3.41,3.41,+0.33,10.71,8000,1,27280,0,0,0,0,0,0,8000,0,8000,8000
20200212,056881,台灣50康和9A購01,1.52,1.59,1.52,1.59,+0.18,12.77,48000,2,73030,0,0,0,0,0,0,0,48000,-48000,-48000
20200212,056882,華邦電康和98購01,1.10,1.11,1.10,1.11,+0.11,11.0,204000,5,225160,0,0,0,0,0,0,23000,181000,-158000,-158000
20200212,056883,美食康和98購01,1.34,1.61,1.34,1.49,+0.21,16.41,491000,18,703820,0,0,0,0,0,0,118000,373000,-255000,-255000
20200212,056884,元油2X元大99購02,0.76,0.80,0.76,0.80,+0.06,8.11,212000,4,161540,0,0,0,0,0,0,200000,12000,188000,188000
20200212,056885,元油2X元大99購03,,,,,0.00,0.00,0,0,0,0,0,0,0,0,0,0,0,0,0
20200212,056886,元油2X元大99購04,,,,,0.00,0.00,0,0,0,0,0,0,0,0,0,0,0,0,0
20200212,056887,元油2X元大99購05,,,,,0.00,0.00,0,0,0,0,0,0,0,0,0,0,0,0,0
20200212,056888,元油2X元大99購06,,,,,0.00,0.00,0,0,0,0,0,0,0,0,0,0,0,0,0
20200212,056889,元油2X元大99購07,,,,,0.00,0.00,0,0,0,0,0,0,0,0,0,0,0,0,0
20200212,05688P,臺股指元大96售13,1.80,1.80,1.64,1.68,-0.16,-8.7,687000,40,1171360,0,0,0,0,0,0,264000,423000,-159000,-159000
20200212,056890,國巨元大98購11,3.32,3.33,3.29,3.33,+0.13,4.06,124000,4,409230,0,0,0,0,0,0,114000,118000,-4000,-4000
20200212,056891,國巨元大99購03,4.25,4.30,4.14,4.16,+0.10,2.46,31000,6,130620,0,0,0,0,0,0,31000,0,31000,31000
20200212,056892,旺宏元大9A購02,3.56,3.72,3.53,3.53,-0.05,-1.4,64000,7,226900,0,0,0,0,0,0,3000,64000,-61000,-61000
20200212,056893,智邦元大98購02,2.14,2.22,1.04,2.04,+0.05,2.51,192000,45,399380,0,0,0,0,0,0,122000,118000,4000,4000
20200212,056894,佳世達元大99購01,2.18,2.18,2.18,2.18,0.00,0.00,9000,1,19620,0,0,0,0,0,0,9000,9000,0,0
20200212,056895,技嘉元大98購01,4.10,4.15,3.91,3.94,-0.07,-1.75,157000,17,644170,0,0,0,0,0,0,133000,75000,58000,58000
20200212,056896,南亞科元大98購01,2.54,2.57,2.54,2.57,-0.04,-1.53,57000,3,144970,0,0,0,0,0,0,57000,8000,49000,49000
20200212,056897,南亞科元大98購02,3.37,3.37,3.31,3.36,-0.05,-1.47,55000,6,182720,0,0,0,0,0,0,55000,7000,48000,48000
20200212,056898,全新元大98購02,1.46,1.65,1.42,1.61,+0.24,17.52,267000,31,403690,0,0,0,0,0,0,157000,161000,-4000,-4000
20200212,056899,可成元大98購01,3.06,3.25,3.06,3.25,0.00,0.00,79000,6,250220,0,0,0,0,0,0,0,79000,-79000,-79000
20200212,05689P,滬深2X中信97售02,,,,,0.00,0.00,0,0,0,0,0,0,0,0,0,0,0,0,0
20200212,056900,可成元大98購02,3.12,3.37,3.12,3.33,+0.36,12.12,79000,8,260920,0,0,0,0,0,0,1000,78000,-77000,-77000
20200212,056901,華新科元大98購03,1.54,1.54,1.50,1.51,+0.02,1.34,137000,12,209650,0,0,0,0,0,0,125000,36000,89000,89000
20200212,056902,大立光元大98購12,,,,,0.00,0.00,0,0,0,0,0,0,0,0,0,0,0,0,0
20200212,056903,大立光元大99購04,2.88,2.97,2.88,2.97,+0.26,9.59,60000,4,175400,0,0,0,0,0,0,2000,58000,-56000,-56000
20200212,056904,大立光元大99購05,1.54,1.63,1.54,1.63,+0.17,11.64,22000,5,34580,0,0,0,0,0,0,1000,21000,-20000,-20000
20200212,056905,欣興元大98購03,2.85,3.39,2.84,3.39,+0.58,20.64,222000,23,674390,0,0,0,0,0,0,136000,210000,-74000,-74000
20200212,056906,玉晶光元大9B購01,1.68,1.78,1.66,1.76,+0.15,9.32,160000,16,274230,0,0,0,0,0,0,74000,66000,8000,8000
20200212,056907,群創元大9C購04,1.62,1.62,1.60,1.62,+0.02,1.25,65000,15,104970,0,0,0,0,0,0,65000,65000,0,0
20200212,056908,牧德元大99購03,1.86,1.91,1.76,1.76,-0.07,-3.83,92000,7,171910,0,0,0,0,0,0,25000,67000,-42000,-42000
20200212,056909,嘉聯益元大99購03,2.92,3.03,2.89,2.93,+0.16,5.78,70000,5,209280,0,0,0,0,0,0,1000,69000,-68000,-68000
20200212,05690P,友達中信96售02,,,,,0.00,0.00,0,0,0,0,0,0,0,0,0,0,0,0,0
20200212,056910,超眾元大99購02,2.45,2.71,2.45,2.68,+0.16,6.35,166000,25,422340,0,0,0,0,0,0,137000,113000,24000,24000
20200212,056911,緯穎元大99購01,1.54,1.67,1.54,1.66,+0.07,4.4,66000,5,106180,0,0,0,0,0,0,54000,66000,-12000,-12000
20200212,056912,臺股指元大99購04,4.19,4.21,4.17,4.21,+0.06,1.45,11000,3,46090,0,0,0,0,0,0,0,11000,-11000,-11000
20200212,056913,臺股指元大99購05,,,,,0.00,0.00,0,0,0,0,0,0,0,0,0,0,0,0,0
20200212,056914,臺股指元大99購09,5.40,5.40,5.40,5.40,+0.20,3.85,10000,1,54000,0,0,0,0,0,0,10000,0,10000,10000
20200212,056915,上銀兆豐99購01,1.09,1.09,1.05,1.05,-0.01,-0.94,232000,12,248860,0,0,0,0,0,0,101000,131000,-30000,-30000
20200212,056916,台達電兆豐98購02,1.01,1.04,0.99,1.04,+0.02,1.96,134000,5,133540,0,0,0,0,0,0,104000,30000,74000,74000
20200212,056917,國巨兆豐98購03,,,,,0.00,0.00,0,0,0,0,0,0,0,0,0,0,0,0,0
20200212,056918,台積電兆豐98購01,1.37,1.41,1.37,1.41,+0.08,6.02,129000,2,176890,0,0,0,0,0,0,0,129000,-129000,-129000
20200212,056919,英業達兆豐98購01,1.77,1.79,1.77,1.77,-0.03,-1.67,100000,3,178400,0,0,0,0,0,0,0,100000,-100000,-100000
20200212,05691P,聯發科中信98售01,,,,,0.00,0.00,0,0,0,0,0,0,0,0,0,0,0,0,0
20200212,056920,友達兆豐98購02,1.10,1.11,1.07,1.07,-0.05,-4.46,185000,5,203850,0,0,0,0,0,0,90000,95000,-5000,-5000
20200212,056921,京元電兆豐98購01,2.06,2.20,2.06,2.17,+0.04,1.88,268000,12,582260,0,0,0,0,0,0,167000,101000,66000,66000
20200212,056922,全新兆豐99購01,1.22,1.37,1.22,1.37,+0.27,24.55,1137000,27,1484380,0,0,0,0,0,0,317000,820000,-503000,-503000
20200212,056923,奇力新兆豐99購02,1.05,1.13,1.04,1.13,+0.08,7.62,530000,19,573020,0,0,0,0,0,0,240000,290000,-50000,-50000
20200212,056924,亞光兆豐98購01,0.69,0.80,0.69,0.80,+0.15,23.08,129000,4,91200,0,0,0,0,0,0,70000,59000,11000,11000
20200212,056925,群創兆豐98購03,,,,,0.00,0.00,0,0,0,0,0,0,0,0,0,0,0,0,0
20200212,056926,日月光兆豐98購01,1.57,1.63,1.57,1.63,+0.14,9.4,219000,9,350070,0,0,0,0,0,0,59000,160000,-101000,-101000
20200212,056927,T50反1台新02購01,0.69,0.69,0.69,0.69,0.00,0.00,50000,1,34500,0,0,0,0,0,0,0,50000,-50000,-50000
20200212,056928,旺宏台新98購01,0.79,0.79,0.79,0.79,+0.02,2.6,1000,1,790,0,0,0,0,0,0,0,1000,-1000,-1000
20200212,056929,華新科台新98購01,1.89,1.89,1.89,1.89,+0.01,0.53,8000,1,15120,0,0,0,0,0,0,0,8000,-8000,-8000
20200212,05692P,聯發科中信9A售02,1.10,1.12,1.10,1.12,-0.09,-7.44,85000,6,94780,0,0,0,0,0,0,80000,5000,75000,75000
20200212,056930,晶豪科台新98購01,,,,,0.00,0.00,0,0,0,0,0,0,0,0,0,0,0,0,0
20200212,056931,智原台新98購01,1.22,1.29,1.22,1.29,+0.07,5.74,178000,8,228260,0,0,0,0,0,0,63000,115000,-52000,-52000
20200212,056932,T50反1元富98購01,,,,,0.00,0.00,0,0,0,0,0,0,0,0,0,0,0,0,0
20200212,056933,國巨元富98購03,2.02,2.02,1.89,1.98,+0.19,10.61,37000,4,72420,0,0,0,0,0,0,14000,23000,-9000,-9000
20200212,056934,國巨元富98購04,1.62,1.76,1.62,1.76,0.00,0.00,129000,7,211330,0,0,0,0,0,0,0,129000,-129000,-129000
20200212,056935,華新科元富98購02,3.54,3.57,3.35,3.45,+0.08,2.37,166000,18,577100,0,0,0,0,0,0,84000,82000,2000,2000
20200212,056936,禾伸堂元富98購01,2.04,2.11,2.00,2.11,+0.02,0.96,321000,13,655430,0,0,0,0,0,0,179000,166000,13000,13000
20200212,056937,智原元富98購01,1.71,1.81,1.71,1.81,+0.11,6.47,83000,6,145250,0,0,0,0,0,0,62000,21000,41000,41000
20200212,056938,泰碩元富98購01,0.89,0.89,0.89,0.89,+0.01,1.14,52000,1,46280,0,0,0,0,0,0,52000,0,52000,52000
20200212,056939,康控元富98購01,2.17,2.35,2.17,2.33,+0.28,13.66,158000,21,354770,0,0,0,0,0,0,45000,113000,-68000,-68000
20200212,05693P,滬深2X凱基98售02,,,,,0.00,0.00,0,0,0,0,0,0,0,0,0,0,0,0,0
20200212,056940,嘉聯益元富98購01,3.24,3.39,3.24,3.39,+0.28,9.0,52000,6,174610,0,0,0,0,0,0,4000,48000,-44000,-44000
20200212,056941,台郡元富9B購01,3.12,3.14,3.01,3.14,+0.91,40.81,117000,12,360430,0,0,0,0,0,0,59000,58000,1000,1000
20200212,056942,昇陽半元富98購01,1.48,1.56,1.48,1.49,+0.01,0.68,68000,7,102160,0,0,0,0,0,0,40000,58000,-18000,-18000
20200212,056943,華通統一99購01,1.91,2.42,1.91,2.35,+0.59,33.52,144000,6,331040,0,0,0,0,0,0,141000,1000,140000,140000
20200212,056944,鴻海統一98購11,1.60,1.72,1.60,1.72,0.00,0.00,72000,13,118320,0,0,0,0,0,0,0,72000,-72000,-72000
20200212,056945,鴻海統一98購12,1.66,1.86,1.66,1.86,+0.20,12.05,198000,16,341840,0,0,0,0,0,0,63000,140000,-77000,-77000
20200212,056946,國巨統一98購05,2.04,2.04,2.04,2.04,+0.08,4.08,159000,6,324360,0,0,0,0,0,0,157000,2000,155000,155000
20200212,056947,國巨統一9A購01,2.12,2.18,2.10,2.18,+0.11,5.31,221000,3,469060,0,0,0,0,0,0,211000,10000,201000,201000
20200212,056948,旺宏統一9A購01,,,,,0.00,0.00,0,0,0,0,0,0,0,0,0,0,0,0,0
20200212,056949,義隆統一98購01,1.58,1.58,1.56,1.56,+0.15,10.64,99000,3,154940,0,0,0,0,0,0,99000,0,99000,99000
20200212,05694P,台積電凱基96售09,1.05,1.05,1.02,1.02,-0.12,-10.53,75000,3,76650,0,0,0,0,0,0,5000,70000,-65000,-65000
20200212,056950,亞光統一99購01,0.99,1.07,0.99,1.07,+0.12,12.63,230000,10,238470,0,0,0,0,0,0,10000,220000,-210000,-210000
20200212,056951,牧德統一99購01,1.19,1.19,1.17,1.19,+0.03,2.59,266000,6,316140,0,0,0,0,0,0,196000,70000,126000,126000
20200212,056952,元油2X國泰99購01,1.53,1.53,1.53,1.53,0.00,0.00,140000,4,214200,0,0,0,0,0,0,0,140000,-140000,-140000
20200212,056953,智邦富邦98購02,,,,,0.00,0.00,0,0,0,0,0,0,0,0,0,0,0,0,0
20200212,056954,聯詠富邦9A購01,1.12,1.17,1.12,1.16,+0.12,11.54,1063000,25,1221260,0,0,0,0,0,0,586000,513000,73000,73000
20200212,056955,台灣50永豐98購01,1.43,1.60,1.43,1.58,+0.23,17.04,289000,19,423000,0,0,0,0,0,0,206000,83000,123000,123000
20200212,056956,元油2X永豐99購01,,,,,0.00,0.00,0,0,0,0,0,0,0,0,0,0,0,0,0
20200212,056957,元油2X永豐9A購02,,,,,0.00,0.00,0,0,0,0,0,0,0,0,0,0,0,0,0
20200212,056958,喬山永豐98購01,1.38,1.45,1.38,1.45,0.00,0.00,94000,6,133080,0,0,0,0,0,0,0,94000,-94000,-94000
20200212,056959,鴻海永豐98購03,1.20,1.38,1.20,1.38,+0.22,18.97,19000,2,24060,0,0,0,0,0,0,0,19000,-19000,-19000
20200212,05695P,台積電凱基96售10,0.34,0.34,0.32,0.32,-0.08,-20.0,40000,2,13400,0,0,0,0,0,0,0,40000,-40000,-40000
20200212,056960,光罩永豐98購01,1.63,1.73,1.63,1.73,+0.15,9.49,132000,6,219920,0,0,0,0,0,0,56000,76000,-20000,-20000
20200212,056961,凱美永豐98購01,1.03,1.07,1.03,1.07,-0.05,-4.46,193000,5,201870,0,0,0,0,0,0,144000,116000,28000,28000
20200212,056962,技嘉永豐98購01,1.37,1.37,1.30,1.31,+0.02,1.55,126000,13,168440,0,0,0,0,0,0,74000,52000,22000,22000
20200212,056963,建準永豐98購01,,,,,0.00,0.00,0,0,0,0,0,0,0,0,0,0,0,0,0
20200212,056964,聯發科永豐98購03,1.39,1.55,1.39,1.55,+0.32,26.02,45000,12,66870,0,0,0,0,0,0,39000,38000,1000,1000
20200212,056965,全新永豐98購01,0.98,1.12,0.97,1.10,+0.18,19.57,403000,22,423100,0,0,0,0,0,0,176000,283000,-107000,-107000
20200212,056966,嘉晶永豐98購01,1.77,2.01,1.77,1.93,+0.16,9.04,251000,18,485490,0,0,0,0,0,0,14000,237000,-223000,-223000
20200212,056967,奇鋐永豐98購01,1.28,1.36,1.28,1.36,+0.07,5.43,140000,6,185880,0,0,0,0,0,0,7000,140000,-133000,-133000
20200212,056968,揚明光永豐98購02,1.36,1.42,1.36,1.42,+0.11,8.4,134000,5,187370,0,0,0,0,0,0,38000,96000,-58000,-58000
20200212,056969,智易永豐98購01,1.56,1.92,1.56,1.85,+0.30,19.35,722000,46,1246890,0,0,0,0,0,0,104000,626000,-522000,-522000
20200212,05696P,南亞科凱基96售01,,,,,0.00,0.00,0,0,0,0,0,0,0,0,0,0,0,0,0
20200212,056970,TPK永豐98購01,1.60,1.74,1.59,1.74,+0.14,8.75,133000,14,224890,0,0,0,0,0,0,29000,104000,-75000,-75000
20200212,056971,麗豐永豐98購01,1.21,1.30,1.19,1.30,+0.11,9.24,325000,13,400500,0,0,0,0,0,0,170000,182000,-12000,-12000
20200212,056972,祥碩永豐98購02,1.49,1.91,1.49,1.88,+0.49,35.25,771000,32,1262530,0,0,0,0,0,0,111000,660000,-549000,-549000
20200212,056973,T50反1永昌9C購01,,,,,0.00,0.00,0,0,0,0,0,0,0,0,0,0,0,0,0
20200212,056974,臻鼎永昌9C購01,5.00,5.10,5.00,5.00,0.00,0.00,62000,4,312000,0,0,0,0,0,0,0,62000,-62000,-62000
20200212,056975,元油2X群益98購03,,,,,0.00,0.00,0,0,0,0,0,0,0,0,0,0,0,0,0
20200212,056976,喬山群益98購01,1.40,1.43,1.40,1.43,0.00,0.00,37000,3,52280,0,0,0,0,0,0,0,37000,-37000,-37000
20200212,056977,國巨群益9A購01,3.03,3.06,3.03,3.06,0.00,0.00,160000,2,487200,0,0,0,0,0,0,0,160000,-160000,-160000
20200212,056978,技嘉群益99購01,1.93,2.01,1.84,1.88,-0.05,-2.59,73000,11,140430,0,0,0,0,0,0,22000,53000,-31000,-31000
20200212,056979,微星群益98購01,,,,,0.00,0.00,0,0,0,0,0,0,0,0,0,0,0,0,0
20200212,05697P,友達凱基96售01,,,,,0.00,0.00,0,0,0,0,0,0,0,0,0,0,0,0,0
20200212,056980,建準群益98購02,,,,,0.00,0.00,0,0,0,0,0,0,0,0,0,0,0,0,0
20200212,056981,全新群益99購03,1.65,1.79,1.65,1.79,0.00,0.00,188000,14,329330,0,0,0,0,0,0,0,188000,-188000,-188000
20200212,056982,華新科群益98購05,1.82,1.84,1.78,1.81,+0.02,1.12,1528000,43,2777440,0,0,0,0,0,0,443000,1092000,-649000,-649000
20200212,056983,大立光群益99購02,,,,,0.00,0.00,0,0,0,0,0,0,0,0,0,0,0,0,0
20200212,056984,嘉晶群益98購01,1.23,1.39,1.23,1.39,0.00,0.00,301000,16,388650,0,0,0,0,0,0,0,301000,-301000,-301000
20200212,056985,智原群益98購03,,,,,0.00,0.00,0,0,0,0,0,0,0,0,0,0,0,0,0
20200212,056986,超眾群益98購03,1.96,2.06,1.89,2.06,+0.16,8.42,72000,14,141310,0,0,0,0,0,0,56000,63000,-7000,-7000
20200212,056987,南茂群益98購01,1.60,1.61,1.60,1.61,0.00,0.00,25000,2,40140,0,0,0,0,0,0,0,25000,-25000,-25000
20200212,056988,聚陽兆豐98購01,0.99,0.99,0.98,0.99,0.00,0.00,150000,3,148200,0,0,0,0,0,0,0,150000,-150000,-150000
20200212,056989,鴻海兆豐98購02,1.06,1.06,1.06,1.06,+0.08,8.16,5000,1,5300,0,0,0,0,0,0,0,5000,-5000,-5000
20200212,05698P,群創凱基96售01,0.36,0.36,0.34,0.34,-0.02,-5.56,290000,3,101600,0,0,0,0,0,0,90000,200000,-110000,-110000
20200212,056990,聯發科兆豐98購01,,,,,0.00,0.00,0,0,0,0,0,0,0,0,0,0,0,0,0
20200212,056991,牧德兆豐98購01,1.77,1.78,1.72,1.72,0.00,0.00,39000,5,68380,0,0,0,0,0,0,0,39000,-39000,-39000
20200212,056992,祥碩兆豐98購01,1.58,1.70,1.58,1.70,+0.25,17.24,202000,7,332450,0,0,0,0,0,0,100000,102000,-2000,-2000
20200212,056993,GIS兆豐99購01,0.87,0.90,0.87,0.90,+0.06,7.14,479000,17,421310,0,0,0,0,0,0,0,479000,-479000,-479000
20200212,056994,緯穎兆豐98購02,1.05,1.07,1.05,1.07,+0.09,9.18,21000,3,22270,0,0,0,0,0,0,15000,6000,9000,9000
20200212,056995,華新科日盛99購01,2.70,2.70,2.70,2.70,0.00,0.00,6000,1,16200,0,0,0,0,0,0,0,6000,-6000,-6000
20200212,056996,矽力日盛99購01,1.02,1.11,1.02,1.11,0.00,0.00,100000,2,104700,0,0,0,0,0,0,0,100000,-100000,-100000
20200212,056997,台灣50康和9A購02,1.45,1.45,1.45,1.45,0.00,0.00,5000,1,7250,0,0,0,0,0,0,0,5000,-5000,-5000
20200212,056998,麗豐康和98購01,1.26,1.26,1.26,1.26,0.00,0.00,18000,1,22680,0,0,0,0,0,0,0,18000,-18000,-18000
20200212,056999,元油2X國票98購02,1.53,1.53,1.53,1.53,0.00,0.00,2000,1,3060,0,0,0,0,0,0,0,2000,-2000,-2000
20200212,05699P,茂林凱基96售05,0.50,0.51,0.50,0.51,-0.03,-5.56,103000,3,52480,0,0,0,0,0,0,55000,48000,7000,7000
20200212,057000,亞德客國票99購01,,,,,0.00,0.00,0,0,0,0,0,0,0,0,0,0,0,0,0
20200212,057001,華邦電國票99購02,,,,,0.00,0.00,0,0,0,0,0,0,0,0,0,0,0,0,0
20200212,057002,友達國票98購01,1.17,1.17,1.10,1.10,-0.10,-8.33,184000,8,205700,0,0,0,0,0,0,70000,114000,-44000,-44000
20200212,057003,立積國票98購01,4.10,4.29,4.10,4.29,0.00,0.00,9000,2,37470,0,0,0,0,0,0,0,9000,-9000,-9000
20200212,057004,滬深反中信9A購01,1.30,1.30,1.28,1.28,-0.02,-1.54,5000,2,6460,0,0,0,0,0,0,0,5000,-5000,-5000
20200212,057005,元油2X中信9C購01,,,,,0.00,0.00,0,0,0,0,0,0,0,0,0,0,0,0,0
20200212,057006,國巨中信98購03,0.98,0.98,0.95,0.98,+0.04,4.26,200000,4,193500,0,0,0,0,0,0,150000,50000,100000,100000
20200212,057007,奇力新中信98購04,0.90,0.93,0.88,0.93,+0.02,2.2,175000,18,159400,0,0,0,0,0,0,65000,110000,-45000,-45000
20200212,057008,華新科中信99購02,1.11,1.11,1.11,1.11,0.00,0.00,14000,1,15540,0,0,0,0,0,0,0,14000,-14000,-14000
20200212,057009,信邦中信99購01,0.94,0.99,0.94,0.98,+0.01,1.03,125000,6,120550,0,0,0,0,0,0,0,125000,-125000,-125000
20200212,05700P,臻鼎凱基96售02,,,,,0.00,0.00,0,0,0,0,0,0,0,0,0,0,0,0,0
20200212,057010,景碩中信98購01,1.33,1.33,1.33,1.33,0.00,0.00,10000,1,13300,0,0,0,0,0,0,0,10000,-10000,-10000
20200212,057011,日月光中信99購01,,,,,0.00,0.00,0,0,0,0,0,0,0,0,0,0,0,0,0
20200212,057012,康控中信98購01,0.98,0.98,0.98,0.98,+0.07,7.69,9000,2,8820,0,0,0,0,0,0,6000,3000,3000,3000
20200212,057013,聯發科麥證98購01,3.25,3.54,3.25,3.47,+0.42,13.77,46000,7,157530,14000,32000,-18000,0,0,0,14000,32000,-18000,-18000
20200212,057014,元油2X凱基9A購05,,,,,0.00,0.00,0,0,0,0,0,0,0,0,0,0,0,0,0
20200212,057015,元油2X凱基9B購04,1.70,1.70,1.70,1.70,0.00,0.00,5000,1,8500,0,0,0,0,0,0,0,5000,-5000,-5000
20200212,057016,中石化凱基9B購01,,,,,0.00,0.00,0,0,0,0,0,0,0,0,0,0,0,0,0
20200212,057017,和大凱基98購01,0.87,0.87,0.85,0.85,0.00,0.00,37000,2,31590,0,0,0,0,0,0,30000,37000,-7000,-7000
20200212,057018,亞德客凱基98購01,1.25,1.28,1.25,1.28,+0.17,15.32,32000,2,40360,0,0,0,0,0,0,20000,32000,-12000,-12000
20200212,057019,台積電凱基98購14,,,,,0.00,0.00,0,0,0,0,0,0,0,0,0,0,0,0,0
20200212,05701P,彩晶凱基96售01,,,,,0.00,0.00,0,0,0,0,0,0,0,0,0,0,0,0,0
20200212,057020,台積電凱基99購02,,,,,0.00,0.00,0,0,0,0,0,0,0,0,0,0,0,0,0
20200212,057021,台積電凱基9A購02,,,,,0.00,0.00,0,0,0,0,0,0,0,0,0,0,0,0,0
20200212,057022,智邦凱基98購04,1.92,2.02,1.71,1.83,0.00,0.00,268000,57,495540,0,0,0,0,0,0,72000,258000,-186000,-186000
20200212,057023,美律凱基99購02,2.18,2.36,2.18,2.36,0.00,0.00,26000,6,57200,0,0,0,0,0,0,0,26000,-26000,-26000
20200212,057024,義隆凱基99購01,1.39,1.39,1.32,1.35,0.00,0.00,47000,5,63620,0,0,0,0,0,0,0,47000,-47000,-47000
20200212,057025,華新科凱基98購04,,,,,0.00,0.00,0,0,0,0,0,0,0,0,0,0,0,0,0
20200212,057026,長榮航凱基98購01,0.90,0.90,0.90,0.90,0.00,0.00,56000,1,50400,0,0,0,0,0,0,0,56000,-56000,-56000
20200212,057027,祥碩凱基98購01,1.25,1.66,1.25,1.66,0.00,0.00,188000,12,269200,0,0,0,0,0,0,0,188000,-188000,-188000
20200212,057028,台郡凱基99購02,2.12,2.12,2.12,2.12,0.00,0.00,10000,1,21200,0,0,0,0,0,0,0,10000,-10000,-10000
20200212,057029,緯穎凱基98購04,,,,,0.00,0.00,0,0,0,0,0,0,0,0,0,0,0,0,0
20200212,05702P,矽創凱基96售02,,,,,0.00,0.00,0,0,0,0,0,0,0,0,0,0,0,0,0
20200212,057030,滬深反元大9B購01,0.57,0.57,0.57,0.57,0.00,0.00,20000,1,11400,0,0,0,0,0,0,0,20000,-20000,-20000
20200212,057031,滬深反元大9B購02,0.84,0.84,0.84,0.84,0.00,0.00,3000,1,2520,0,0,0,0,0,0,0,3000,-3000,-3000
20200212,057032,A50反1元大9B購01,,,,,0.00,0.00,0,0,0,0,0,0,0,0,0,0,0,0,0
20200212,057033,A50反1元大9B購02,,,,,0.00,0.00,0,0,0,0,0,0,0,0,0,0,0,0,0
20200212,057034,道瓊反元大9B購01,,,,,0.00,0.00,0,0,0,0,0,0,0,0,0,0,0,0,0
20200212,057035,元油2X元大9B購03,,,,,0.00,0.00,0,0,0,0,0,0,0,0,0,0,0,0,0
20200212,057036,元油2X元大9B購04,,,,,0.00,0.00,0,0,0,0,0,0,0,0,0,0,0,0,0
20200212,057037,元油2X元大9B購05,,,,,0.00,0.00,0,0,0,0,0,0,0,0,0,0,0,0,0
20200212,057038,元油2X元大9B購06,1.26,1.27,1.26,1.27,+0.05,4.1,45000,5,56950,0,0,0,0,0,0,0,45000,-45000,-45000
20200212,057039,元油2X元大9B購07,1.70,1.85,1.70,1.85,+0.20,12.12,152000,28,263820,0,0,0,0,0,0,20000,132000,-112000,-112000
20200212,05703P,矽力群益96售03,1.17,1.17,1.08,1.08,-0.11,-9.24,66000,5,76320,0,0,0,0,0,0,56000,10000,46000,46000
20200212,057040,國巨元大98購12,4.49,4.74,4.49,4.71,+0.22,4.9,26000,6,121550,0,0,0,0,0,0,10000,14000,-4000,-4000
20200212,057041,國巨元大99購04,2.63,2.68,2.63,2.68,0.00,0.00,35000,2,93300,0,0,0,0,0,0,0,35000,-35000,-35000
20200212,057042,台積電元大98購10,5.65,5.80,5.55,5.80,+0.30,5.45,296000,33,1656150,0,0,0,0,0,0,293000,296000,-3000,-3000
20200212,057043,台積電元大99購02,1.87,1.92,1.86,1.92,+0.09,4.92,240000,18,450620,0,0,0,0,0,0,166000,74000,92000,92000
20200212,057044,旺宏元大98購08,2.21,2.28,2.14,2.14,-0.07,-3.17,30000,6,66170,0,0,0,0,0,0,30000,5000,25000,25000
20200212,057045,美律元大99購04,2.08,2.29,2.08,2.28,0.00,0.00,106000,15,232610,0,0,0,0,0,0,25000,106000,-81000,-81000
20200212,057046,奇力新元大99購03,3.59,3.67,3.43,3.67,+0.11,3.09,614000,108,2180750,0,0,0,0,0,0,582000,588000,-6000,-6000
20200212,057047,華新科元大99購07,,,,,0.00,0.00,0,0,0,0,0,0,0,0,0,0,0,0,0
20200212,057048,新日興元大98購01,2.02,2.07,1.93,1.93,-0.10,-4.93,82000,9,162460,0,0,0,0,0,0,0,82000,-82000,-82000
20200212,057049,新日興元大98購02,1.64,1.64,1.59,1.59,-0.10,-5.92,298000,11,484920,0,0,0,0,0,0,202000,96000,106000,106000
20200212,05704P,矽力群益96售04,0.66,0.67,0.66,0.67,-0.02,-2.9,34000,7,22580,0,0,0,0,0,0,34000,0,34000,34000
20200212,057050,群創元大99購03,,,,,0.00,0.00,0,0,0,0,0,0,0,0,0,0,0,0,0
20200212,057051,群創元大9B購03,1.58,1.59,1.56,1.59,+0.02,1.27,89000,16,140980,0,0,0,0,0,0,89000,89000,0,0
20200212,057052,華擎元大98購01,1.86,1.86,1.71,1.80,-0.01,-0.55,214000,19,391960,0,0,0,0,0,0,160000,54000,106000,106000
20200212,057053,立積元大98購02,2.76,2.76,2.76,2.76,0.00,0.00,23000,2,63480,0,0,0,0,0,0,0,23000,-23000,-23000
20200212,057054,立積元大98購03,2.09,2.31,2.09,2.31,0.00,0.00,43000,4,90810,0,0,0,0,0,0,0,43000,-43000,-43000
20200212,057055,立積元大99購01,2.12,2.21,2.12,2.21,0.00,0.00,90000,4,193200,0,0,0,0,0,0,0,90000,-90000,-90000
20200212,057056,立積元大99購02,3.37,3.37,3.37,3.37,0.00,0.00,19000,2,64030,0,0,0,0,0,0,0,19000,-19000,-19000
20200212,057057,立積元大9A購01,3.45,3.45,3.45,3.45,0.00,0.00,18000,2,62100,0,0,0,0,0,0,0,18000,-18000,-18000
20200212,057058,祥碩元大98購04,2.88,3.32,2.88,3.30,+0.68,25.95,267000,27,803390,0,0,0,0,0,0,0,267000,-267000,-267000
20200212,057059,易華電元大99購01,,,,,0.00,0.00,0,0,0,0,0,0,0,0,0,0,0,0,0
20200212,05705P,上証2X永豐96售03,3.23,3.33,3.23,3.24,+0.03,0.93,73000,8,241120,0,0,0,0,0,0,73000,0,73000,73000
20200212,057060,緯穎元大98購05,1.60,1.74,1.60,1.73,+0.10,6.13,72000,5,120660,0,0,0,0,0,0,53000,67000,-14000,-14000
20200212,057061,華擎國泰9A購01,,,,,0.00,0.00,0,0,0,0,0,0,0,0,0,0,0,0,0
20200212,057062,立積國泰99購01,1.58,1.79,1.58,1.70,0.00,0.00,709000,31,1206160,0,0,0,0,0,0,3000,709000,-706000,-706000
20200212,057063,立積國泰9A購01,1.47,1.63,1.47,1.55,0.00,0.00,243000,26,377910,0,0,0,0,0,0,0,243000,-243000,-243000
20200212,057064,華新科富邦9B購01,0.95,0.96,0.92,0.94,+0.02,2.17,240000,24,223700,0,0,0,0,0,0,96000,170000,-74000,-74000
20200212,057065,牧德富邦99購01,,,,,0.00,0.00,0,0,0,0,0,0,0,0,0,0,0,0,0
20200212,057066,緯穎富邦99購01,0.57,0.58,0.57,0.58,0.00,0.00,50000,2,28600,0,0,0,0,0,0,0,50000,-50000,-50000
20200212,057067,元油2X永豐9B購01,,,,,0.00,0.00,0,0,0,0,0,0,0,0,0,0,0,0,0
20200212,057068,國巨永豐98購06,1.31,1.35,1.31,1.35,+0.08,6.3,38000,5,50180,0,0,0,0,0,0,30000,8000,22000,22000
20200212,057069,台積電永豐98購02,1.14,1.14,1.14,1.14,+0.05,4.59,10000,1,11400,0,0,0,0,0,0,10000,0,10000,10000
20200212,05706P,TPK永豐96售02,,,,,0.00,0.00,0,0,0,0,0,0,0,0,0,0,0,0,0
20200212,057070,美律永豐98購02,0.83,0.95,0.83,0.93,0.00,0.00,522000,14,474190,0,0,0,0,0,0,0,522000,-522000,-522000
20200212,057071,華擎永豐98購02,0.90,0.90,0.83,0.85,0.00,0.00,149000,11,129980,0,0,0,0,0,0,0,149000,-149000,-149000
20200212,057072,日月光永豐98購01,1.07,1.14,1.07,1.14,0.00,0.00,172000,7,190130,0,0,0,0,0,0,0,172000,-172000,-172000
20200212,057073,康控永豐98購01,1.21,1.30,1.18,1.30,+0.12,10.17,369000,23,459650,0,0,0,0,0,0,38000,361000,-323000,-323000
20200212,057074,立積永豐98購01,0.97,1.09,0.97,1.02,0.00,0.00,172000,10,171260,0,0,0,0,0,0,0,172000,-172000,-172000
20200212,057075,嘉聯益永豐98購01,1.70,1.70,1.70,1.70,0.00,0.00,10000,1,17000,0,0,0,0,0,0,10000,10000,0,0
20200212,057076,緯穎永豐98購01,0.89,1.01,0.89,1.00,0.00,0.00,13000,6,12360,0,0,0,0,0,0,0,13000,-13000,-13000
20200212,057077,國巨統一98購06,,,,,0.00,0.00,0,0,0,0,0,0,0,0,0,0,0,0,0
20200212,057078,國巨統一9A購02,1.33,1.38,1.31,1.38,+0.05,3.76,409000,16,544240,0,0,0,0,0,0,263000,146000,117000,117000
20200212,057079,台積電統一9A購02,1.45,1.51,1.45,1.51,+0.07,4.86,14000,3,20840,0,0,0,0,0,0,10000,4000,6000,6000
20200212,05707P,中磊永豐96售01,,,,,0.00,0.00,0,0,0,0,0,0,0,0,0,0,0,0,0
20200212,057080,華新科統一99購02,,,,,0.00,0.00,0,0,0,0,0,0,0,0,0,0,0,0,0
20200212,057081,大立光統一98購07,,,,,0.00,0.00,0,0,0,0,0,0,0,0,0,0,0,0,0
20200212,057082,玉晶光統一9A購04,1.51,1.55,1.51,1.55,+0.09,6.16,59000,4,91090,0,0,0,0,0,0,0,59000,-59000,-59000
20200212,057083,立積統一98購01,1.94,2.02,1.92,2.02,0.00,0.00,194000,6,382780,0,0,0,0,0,0,0,194000,-194000,-194000
20200212,057084,立積統一9B購01,1.44,1.56,1.42,1.53,+0.14,10.07,314000,21,468290,0,0,0,0,0,0,123000,184000,-61000,-61000
20200212,057085,立積統一9B購02,1.01,1.04,1.01,1.04,0.00,0.00,74000,3,75200,0,0,0,0,0,0,0,74000,-74000,-74000
20200212,057086,立積統一9C購01,,,,,0.00,0.00,0,0,0,0,0,0,0,0,0,0,0,0,0
20200212,057087,台郡統一99購01,,,,,0.00,0.00,0,0,0,0,0,0,0,0,0,0,0,0,0
20200212,057088,上銀元富98購01,1.03,1.03,1.03,1.03,+0.03,3.0,11000,2,11330,0,0,0,0,0,0,8000,3000,5000,5000
20200212,057089,奇力新元富98購01,1.36,1.43,1.31,1.41,+0.06,4.44,586000,24,804960,0,0,0,0,0,0,338000,252000,86000,86000
20200212,05708P,奇力新國票97售04,,,,,0.00,0.00,0,0,0,0,0,0,0,0,0,0,0,0,0
20200212,057090,奇力新元富98購02,1.09,1.10,1.09,1.10,0.00,0.00,81000,3,88490,0,0,0,0,0,0,0,81000,-81000,-81000
20200212,057091,華新科元富9A購01,3.07,3.07,3.01,3.03,+0.11,3.77,606000,13,1845180,0,0,0,0,0,0,10000,596000,-586000,-586000
20200212,057092,健策元富98購01,1.69,1.79,1.59,1.79,+0.25,16.23,658000,15,1081510,0,0,0,0,0,0,502000,157000,345000,345000
20200212,057093,臻鼎元富98購02,2.69,2.94,2.59,2.59,0.00,0.00,110000,13,298180,0,0,0,0,0,0,0,110000,-110000,-110000
20200212,057094,祥碩元富98購01,2.52,2.91,2.52,2.89,+0.71,32.57,69000,11,186630,0,0,0,0,0,0,0,69000,-69000,-69000
20200212,057095,祥碩元富98購02,1.40,1.64,1.38,1.64,+0.41,33.33,349000,33,517100,0,0,0,0,0,0,105000,244000,-139000,-139000
20200212,057096,緯穎元富98購01,,,,,0.00,0.00,0,0,0,0,0,0,0,0,0,0,0,0,0
20200212,057097,致新元富98購01,2.98,2.98,2.98,2.98,-0.07,-2.3,4000,2,11920,0,0,0,0,0,0,4000,0,4000,4000
20200212,057098,新光金台新98購01,0.76,0.76,0.76,0.76,0.00,0.00,50000,2,38000,0,0,0,0,0,0,0,50000,-50000,-50000
20200212,057099,元油2X中信9B購03,,,,,0.00,0.00,0,0,0,0,0,0,0,0,0,0,0,0,0
20200212,05709P,大立光國票97售01,,,,,0.00,0.00,0,0,0,0,0,0,0,0,0,0,0,0,0
20200212,057100,國巨中信9A購02,1.39,1.41,1.39,1.41,+0.28,24.78,24000,3,33560,0,0,0,0,0,0,0,24000,-24000,-24000
20200212,057101,新光金中信9A購01,,,,,0.00,0.00,0,0,0,0,0,0,0,0,0,0,0,0,0
20200212,057102,亞光中信9A購01,1.36,1.39,1.36,1.39,+0.14,11.2,54000,6,74650,0,0,0,0,0,0,0,54000,-54000,-54000
20200212,057103,禾伸堂中信9A購01,1.38,1.39,1.38,1.39,+0.09,6.92,23000,2,31940,0,0,0,0,0,0,0,23000,-23000,-23000
20200212,057104,康友中信99購01,1.20,1.20,1.20,1.20,+0.13,12.15,10000,1,12000,0,0,0,0,0,0,0,10000,-10000,-10000
20200212,057105,致茂群益9A購01,1.78,1.78,1.78,1.78,+0.10,5.95,3000,1,5340,0,0,0,0,0,0,0,3000,-3000,-3000
20200212,057106,美律群益98購03,1.30,1.51,1.30,1.48,+0.11,8.03,48000,11,69110,0,0,0,0,0,0,20000,48000,-28000,-28000
20200212,057107,華新科群益98購06,1.66,1.66,1.64,1.65,+0.29,21.32,425000,10,701380,0,0,0,0,0,0,7000,425000,-418000,-418000
20200212,057108,潤泰全群益98購01,,,,,0.00,0.00,0,0,0,0,0,0,0,0,0,0,0,0,0
20200212,057109,信邦群益98購01,,,,,0.00,0.00,0,0,0,0,0,0,0,0,0,0,0,0,0
20200212,05710P,禾伸堂國票97售02,1.19,1.19,1.19,1.19,+0.02,1.71,10000,1,11900,0,0,0,0,0,0,0,10000,-10000,-10000
20200212,057110,立積群益98購01,1.60,1.60,1.60,1.60,+0.22,15.94,100000,2,160000,0,0,0,0,0,0,0,100000,-100000,-100000
20200212,057111,立積群益98購02,2.85,2.85,2.66,2.66,+0.37,16.16,51000,2,139460,0,0,0,0,0,0,0,51000,-51000,-51000
20200212,057112,立積群益99購01,2.88,2.88,2.88,2.88,+0.49,20.5,5000,1,14400,0,0,0,0,0,0,0,5000,-5000,-5000
20200212,057113,祥碩群益98購01,2.82,3.01,2.82,3.01,-0.15,-4.75,105000,3,296910,0,0,0,0,0,0,0,105000,-105000,-105000
20200212,057114,台虹群益98購01,,,,,0.00,0.00,0,0,0,0,0,0,0,0,0,0,0,0,0
20200212,057115,元油2X日盛9A購01,,,,,0.00,0.00,0,0,0,0,0,0,0,0,0,0,0,0,0
20200212,057116,鴻海日盛9A購01,2.50,2.70,2.50,2.70,+0.35,14.89,17000,7,44270,0,0,0,0,0,0,0,17000,-17000,-17000
20200212,057117,開發金日盛9B購01,0.93,0.93,0.93,0.93,0.00,0.00,425000,5,395250,0,0,0,0,0,0,0,425000,-425000,-425000
20200212,057118,欣興日盛9A購01,2.47,2.76,2.47,2.76,+0.68,32.69,20000,7,52270,0,0,0,0,0,0,0,20000,-20000,-20000
20200212,057119,微星康和98購01,,,,,0.00,0.00,0,0,0,0,0,0,0,0,0,0,0,0,0
20200212,05711P,茂林國票97售03,1.09,1.09,1.09,1.09,0.00,0.00,33000,1,35970,0,0,0,0,0,0,0,33000,-33000,-33000
20200212,057120,茂林康和98購01,0.90,0.90,0.90,0.90,+0.04,4.65,11000,1,9900,0,0,0,0,0,0,0,11000,-11000,-11000
20200212,057121,立積康和98購01,1.14,1.14,1.14,1.14,+0.02,1.79,10000,1,11400,0,0,0,0,0,0,0,10000,-10000,-10000
20200212,057122,元油2X凱基9B購05,,,,,0.00,0.00,0,0,0,0,0,0,0,0,0,0,0,0,0
20200212,057123,上銀凱基98購05,,,,,0.00,0.00,0,0,0,0,0,0,0,0,0,0,0,0,0
20200212,057124,為升凱基98購02,1.61,1.61,1.61,1.61,-0.18,-10.06,30000,1,48300,0,0,0,0,0,0,30000,30000,0,0
20200212,057125,國巨凱基98購12,,,,,0.00,0.00,0,0,0,0,0,0,0,0,0,0,0,0,0
20200212,057126,台積電凱基99購03,,,,,0.00,0.00,0,0,0,0,0,0,0,0,0,0,0,0,0
20200212,057127,旺宏凱基98購09,,,,,0.00,0.00,0,0,0,0,0,0,0,0,0,0,0,0,0
20200212,057128,台光電凱基98購03,1.60,1.60,1.60,1.60,+0.31,24.03,1000,1,1600,0,0,0,0,0,0,0,1000,-1000,-1000
20200212,057129,聯發科凱基99購03,2.26,2.29,2.26,2.29,+0.76,49.67,45000,8,101840,0,0,0,0,0,0,10000,45000,-35000,-35000
20200212,05712P,友達統一97售03,0.30,0.31,0.30,0.31,+0.02,6.9,60000,2,18200,0,0,0,0,0,0,20000,40000,-20000,-20000
20200212,057130,全新凱基98購03,1.20,1.20,1.20,1.20,+0.33,37.93,15000,1,18000,0,0,0,0,0,0,15000,15000,0,0
20200212,057131,奇力新凱基98購05,,,,,0.00,0.00,0,0,0,0,0,0,0,0,0,0,0,0,0
20200212,057132,華新科凱基98購05,1.69,1.69,1.69,1.69,-0.05,-2.87,5000,3,8450,0,0,0,0,0,0,2000,5000,-3000,-3000
20200212,057133,京鼎凱基98購02,,,,,0.00,0.00,0,0,0,0,0,0,0,0,0,0,0,0,0
20200212,057134,茂林凱基98購02,1.43,1.43,1.43,1.43,-0.07,-4.67,6000,1,8580,0,0,0,0,0,0,0,6000,-6000,-6000
20200212,057135,立積凱基98購01,,,,,0.00,0.00,0,0,0,0,0,0,0,0,0,0,0,0,0
20200212,057136,立積凱基98購02,,,,,0.00,0.00,0,0,0,0,0,0,0,0,0,0,0,0,0
20200212,057137,鈺齊凱基98購01,1.18,1.18,1.16,1.16,0.00,0.00,30000,2,35200,0,0,0,0,0,0,0,30000,-30000,-30000
20200212,057138,亞德客兆豐98購01,,,,,0.00,0.00,0,0,0,0,0,0,0,0,0,0,0,0,0
20200212,057139,華新科兆豐98購02,1.15,1.18,1.15,1.18,0.00,0.00,11000,2,12680,0,0,0,0,0,0,0,11000,-11000,-11000
20200212,05713P,大立光統一96售05,1.06,1.06,1.04,1.04,-0.10,-8.77,78000,8,81320,0,0,0,0,0,0,20000,58000,-38000,-38000
20200212,057140,宏達電兆豐98購01,1.15,1.15,1.15,1.15,+0.09,8.49,5000,1,5750,0,0,0,0,0,0,0,5000,-5000,-5000
20200212,057141,嘉聯益兆豐99購01,,,,,0.00,0.00,0,0,0,0,0,0,0,0,0,0,0,0,0
20200212,057142,力成兆豐98購01,0.97,1.02,0.95,1.02,+0.15,17.24,197000,14,194090,0,0,0,0,0,0,0,197000,-197000,-197000
20200212,057143,台郡兆豐98購01,1.34,1.34,1.34,1.34,+0.49,57.65,1000,1,1340,0,0,0,0,0,0,0,1000,-1000,-1000
20200212,057144,南電兆豐98購01,1.22,1.22,1.22,1.22,+0.11,9.91,10000,1,12200,0,0,0,0,0,0,0,10000,-10000,-10000
20200212,057145,上銀國票98購03,3.37,3.37,3.37,3.37,-0.23,-6.39,10000,1,33700,0,0,0,0,0,0,0,10000,-10000,-10000
20200212,057146,技嘉國票98購01,,,,,0.00,0.00,0,0,0,0,0,0,0,0,0,0,0,0,0
20200212,057147,新日興國票99購01,,,,,0.00,0.00,0,0,0,0,0,0,0,0,0,0,0,0,0
20200212,057148,玉晶光國票99購04,,,,,0.00,0.00,0,0,0,0,0,0,0,0,0,0,0,0,0
20200212,057149,京鼎國票99購02,,,,,0.00,0.00,0,0,0,0,0,0,0,0,0,0,0,0,0
20200212,05714P,群創統一97售03,,,,,0.00,0.00,0,0,0,0,0,0,0,0,0,0,0,0,0
20200212,057150,貿聯國票99購02,,,,,0.00,0.00,0,0,0,0,0,0,0,0,0,0,0,0,0
20200212,057151,易華電國票99購01,,,,,0.00,0.00,0,0,0,0,0,0,0,0,0,0,0,0,0
20200212,057152,緯穎國票99購03,,,,,0.00,0.00,0,0,0,0,0,0,0,0,0,0,0,0,0
20200212,057153,祥碩國泰99購01,2.52,2.60,2.50,2.60,+0.52,25.0,9000,3,22860,0,0,0,0,0,0,0,9000,-9000,-9000
20200212,057154,易華電國泰99購01,,,,,0.00,0.00,0,0,0,0,0,0,0,0,0,0,0,0,0
20200212,057155,元油2X富邦9B購02,,,,,0.00,0.00,0,0,0,0,0,0,0,0,0,0,0,0,0
20200212,057156,元油2X富邦9C購01,0.76,0.76,0.76,0.76,+0.02,2.7,2000,1,1520,0,0,0,0,0,0,0,2000,-2000,-2000
20200212,057157,群創富邦98購02,,,,,0.00,0.00,0,0,0,0,0,0,0,0,0,0,0,0,0
20200212,057158,義隆永豐99購01,1.20,1.20,1.12,1.15,+0.16,16.16,112000,7,130050,0,0,0,0,0,0,0,112000,-112000,-112000
20200212,057159,晶技永豐98購01,,,,,0.00,0.00,0,0,0,0,0,0,0,0,0,0,0,0,0
20200212,05715P,創意元富96售05,1.20,1.25,1.20,1.25,+0.14,12.61,5000,5,6140,0,0,0,0,0,0,0,5000,-5000,-5000
20200212,057160,佐登永豐98購02,,,,,0.00,0.00,0,0,0,0,0,0,0,0,0,0,0,0,0
20200212,057161,亞德客元大98購02,,,,,0.00,0.00,0,0,0,0,0,0,0,0,0,0,0,0,0
20200212,057162,上銀元大98購03,3.09,3.09,3.09,3.09,+0.03,0.98,50000,2,154500,0,0,0,0,0,0,0,50000,-50000,-50000
20200212,057163,上銀元大98購04,1.93,1.93,1.93,1.93,+0.01,0.52,50000,2,96500,0,0,0,0,0,0,0,50000,-50000,-50000
20200212,057164,國巨元大98購14,3.64,3.68,3.64,3.66,+0.96,35.56,21000,4,76960,0,0,0,0,0,0,10000,21000,-11000,-11000
20200212,057165,國巨元大99購05,4.59,4.67,4.59,4.67,+1.30,38.58,96000,8,443640,0,0,0,0,0,0,86000,96000,-10000,-10000
20200212,057166,國巨元大99購06,,,,,0.00,0.00,0,0,0,0,0,0,0,0,0,0,0,0,0
20200212,057167,台積電元大99購03,3.45,3.45,3.45,3.45,+0.37,12.01,15000,2,51750,0,0,0,0,0,0,15000,15000,0,0
20200212,057168,旺宏元大99購03,,,,,0.00,0.00,0,0,0,0,0,0,0,0,0,0,0,0,0
20200212,057169,微星元大98購01,3.24,3.24,2.89,2.89,-0.29,-9.12,24000,2,73560,0,0,0,0,0,0,24000,24000,0,0
20200212,05716P,T50反1元大98售03,0.89,0.89,0.89,0.89,0.00,0.00,720000,2,640800,0,0,0,0,0,0,0,720000,-720000,-720000
20200212,057170,瑞昱元大98購01,2.72,2.88,2.72,2.81,-0.19,-6.33,30000,11,83970,0,0,0,0,0,0,30000,30000,0,0
20200212,057171,台光電元大9B購01,1.89,1.96,1.89,1.93,+0.32,19.88,340000,9,660800,0,0,0,0,0,0,40000,340000,-300000,-300000
20200212,057172,南亞科元大98購03,3.05,3.12,3.05,3.09,-0.07,-2.22,10000,7,30940,0,0,0,0,0,0,10000,10000,0,0
20200212,057173,南亞科元大98購04,2.54,2.57,2.54,2.57,-0.56,-17.89,6000,6,15360,0,0,0,0,0,0,6000,6000,0,0
20200212,057174,南亞科元大98購05,2.99,3.02,2.99,3.02,-0.06,-1.95,4000,4,12050,0,0,0,0,0,0,4000,4000,0,0
20200212,057175,美律元大98購03,1.05,1.15,1.05,1.15,0.00,0.00,18000,5,20100,0,0,0,0,0,0,10000,18000,-8000,-8000
20200212,057176,全新元大99購02,2.29,2.52,2.29,2.51,+0.40,18.96,41000,4,95790,0,0,0,0,0,0,40000,41000,-1000,-1000
20200212,057177,奇力新元大99購04,1.66,1.70,1.60,1.70,+0.25,17.24,142000,29,236080,0,0,0,0,0,0,105000,142000,-37000,-37000
20200212,057178,可成元大98購03,3.17,3.26,3.17,3.26,+0.11,3.49,65000,4,207850,0,0,0,0,0,0,0,65000,-65000,-65000
20200212,057179,可成元大98購04,2.92,3.16,2.92,3.16,+0.16,5.33,173000,8,528500,0,0,0,0,0,0,123000,173000,-50000,-50000
20200212,05717P,鴻海元大97售07,2.15,2.15,1.82,1.82,-0.45,-19.82,105000,15,215440,0,0,0,0,0,0,87000,92000,-5000,-5000
20200212,057180,華新科元大99購08,,,,,0.00,0.00,0,0,0,0,0,0,0,0,0,0,0,0,0
20200212,057181,亞光元大98購02,3.34,3.45,3.34,3.45,+0.32,10.22,67000,20,227610,0,0,0,0,0,0,40000,67000,-27000,-27000
20200212,057182,禾伸堂元大99購02,1.38,1.42,1.36,1.42,+0.16,12.7,95000,12,132140,0,0,0,0,0,0,35000,95000,-60000,-60000
20200212,057183,玉晶光元大99購07,1.53,1.54,1.50,1.54,+0.07,4.76,62000,4,94580,0,0,0,0,0,0,0,62000,-62000,-62000
20200212,057184,群創元大98購05,1.13,1.14,1.13,1.14,+0.05,4.59,9000,2,10200,0,0,0,0,0,0,9000,9000,0,0
20200212,057185,群創元大98購06,1.19,1.19,1.17,1.19,-0.06,-4.8,40000,11,47310,0,0,0,0,0,0,40000,40000,0,0
20200212,057186,群創元大99購04,0.77,0.77,0.77,0.77,-0.09,-10.47,6000,1,4620,0,0,0,0,0,0,6000,6000,0,0
20200212,057187,群創元大9B購04,0.92,0.92,0.92,0.92,-0.03,-3.16,16000,2,14720,0,0,0,0,0,0,6000,16000,-10000,-10000
20200212,057188,佐登元大98購01,2.11,2.23,2.11,2.23,+0.31,16.15,276000,7,612430,0,0,0,0,0,0,0,276000,-276000,-276000
20200212,057189,康控元大98購02,2.52,2.60,2.52,2.60,+0.29,12.55,55000,3,141160,0,0,0,0,0,0,55000,55000,0,0
20200212,05718P,國巨元大96售09,0.89,0.89,0.85,0.85,-0.09,-9.57,104000,19,91400,0,0,0,0,0,0,24000,70000,-46000,-46000
20200212,057190,立積元大9A購02,1.63,1.78,1.63,1.68,+0.03,1.82,19000,6,32830,0,0,0,0,0,0,0,19000,-19000,-19000
20200212,057191,祥碩元大98購05,3.50,3.87,3.50,3.87,+0.78,25.24,131000,13,470510,0,0,0,0,0,0,0,131000,-131000,-131000
20200212,057192,力成元大98購01,1.23,1.35,1.23,1.35,+0.22,19.47,479000,12,600750,0,0,0,0,0,0,50000,479000,-429000,-429000
20200212,057193,力成元大98購02,1.28,1.33,1.23,1.33,+0.19,16.67,214000,20,275950,0,0,0,0,0,0,30000,214000,-184000,-184000
20200212,057194,南電元大98購01,3.06,3.58,3.06,3.46,+0.40,13.07,195000,26,672530,0,0,0,0,0,0,195000,195000,0,0
20200212,057195,南茂元大98購01,2.32,2.33,2.32,2.33,-0.44,-15.88,19000,2,44260,0,0,0,0,0,0,18000,19000,-1000,-1000
20200212,057196,茂林台新98購01,,,,,0.00,0.00,0,0,0,0,0,0,0,0,0,0,0,0,0
20200212,057197,立積台新98購01,1.39,1.39,1.37,1.37,+0.16,13.22,9000,2,12410,0,0,0,0,0,0,0,9000,-9000,-9000
20200212,057198,智伸科統一9B購01,,,,,0.00,0.00,0,0,0,0,0,0,0,0,0,0,0,0,0
20200212,057199,台達電元富02購01,1.42,1.42,1.42,1.42,-0.01,-0.7,11000,1,15620,0,0,0,0,0,0,0,11000,-11000,-11000
20200212,05719P,可成元大96售03,2.90,2.90,2.90,2.90,-0.19,-6.15,1000,1,2900,0,0,0,0,0,0,1000,1000,0,0
20200212,057200,技嘉元富98購01,4.68,4.68,4.28,4.42,+1.11,33.53,75000,16,334600,0,0,0,0,0,0,0,75000,-75000,-75000
20200212,057201,華擎元富98購01,,,,,0.00,0.00,0,0,0,0,0,0,0,0,0,0,0,0,0
20200212,057202,TPK元富98購02,,,,,0.00,0.00,0,0,0,0,0,0,0,0,0,0,0,0,0
20200212,057203,麗豐元富98購02,1.37,1.37,1.37,1.37,+0.06,4.58,3000,1,4110,0,0,0,0,0,0,0,3000,-3000,-3000
20200212,057204,利勤元富98購01,,,,,0.00,0.00,0,0,0,0,0,0,0,0,0,0,0,0,0
20200212,057205,元翎元富98購01,,,,,0.00,0.00,0,0,0,0,0,0,0,0,0,0,0,0,0
20200212,057206,立積元富98購01,,,,,0.00,0.00,0,0,0,0,0,0,0,0,0,0,0,0,0
20200212,057207,立積元富98購02,,,,,0.00,0.00,0,0,0,0,0,0,0,0,0,0,0,0,0
20200212,057208,上海銀元富98購01,,,,,0.00,0.00,0,0,0,0,0,0,0,0,0,0,0,0,0
20200212,05720P,可成中信98售01,,,,,0.00,0.00,0,0,0,0,0,0,0,0,0,0,0,0,0
20200212,05721P,全新群益98售02,0.99,0.99,0.98,0.98,0.00,0.00,11000,2,10830,0,0,0,0,0,0,0,11000,-11000,-11000
20200212,05722P,玉晶光國票97售03,1.37,1.38,1.29,1.30,-0.13,-9.09,187000,28,247880,0,0,0,0,0,0,35000,144000,-109000,-109000
20200212,05723P,華通永豐96售03,,,,,0.00,0.00,0,0,0,0,0,0,0,0,0,0,0,0,0
20200212,05724P,致茂永豐96售01,,,,,0.00,0.00,0,0,0,0,0,0,0,0,0,0,0,0,0
20200212,05725P,嘉聯益永豐96售02,,,,,0.00,0.00,0,0,0,0,0,0,0,0,0,0,0,0,0
20200212,05726P,易華電永豐96售02,1.98,1.98,1.98,1.98,+0.01,0.51,11000,1,21780,0,0,0,0,0,0,11000,0,11000,11000
20200212,05727P,新光金日盛96售02,0.77,0.77,0.75,0.75,-0.04,-5.06,197000,23,150690,0,0,0,0,0,0,12000,185000,-173000,-173000
20200212,05728P,滬深2X凱基98售03,,,,,0.00,0.00,0,0,0,0,0,0,0,0,0,0,0,0,0
20200212,05729P,臺股指凱基97售02,1.32,1.32,1.21,1.21,-0.17,-12.32,683000,26,841610,0,0,0,0,0,0,25000,658000,-633000,-633000
20200212,05730P,臺股指凱基97售03,1.15,1.15,1.15,1.15,-0.17,-12.88,30000,1,34500,0,0,0,0,0,0,0,30000,-30000,-30000
20200212,05731P,創意統一96售03,1.35,1.35,1.26,1.26,+0.05,4.13,99000,29,126470,0,0,0,0,0,0,82000,17000,65000,65000
20200212,05732P,臺股指統一96售02,1.14,1.14,1.05,1.05,-0.18,-14.63,215000,5,242430,0,0,0,0,0,0,0,215000,-215000,-215000
20200212,05733P,臺股指統一96售03,1.41,1.41,1.36,1.39,-0.18,-11.46,70000,4,97400,0,0,0,0,0,0,50000,20000,30000,30000
20200212,05734P,臺股指統一96售04,,,,,0.00,0.00,0,0,0,0,0,0,0,0,0,0,0,0,0
20200212,05735P,臺股指統一96售05,,,,,0.00,0.00,0,0,0,0,0,0,0,0,0,0,0,0,0
20200212,05736P,臺股指統一96售06,,,,,0.00,0.00,0,0,0,0,0,0,0,0,0,0,0,0,0
20200212,05737P,臺股指統一96售07,,,,,0.00,0.00,0,0,0,0,0,0,0,0,0,0,0,0,0
20200212,05738P,臺股指統一97售01,,,,,0.00,0.00,0,0,0,0,0,0,0,0,0,0,0,0,0
20200212,05739P,臺股指統一97售02,,,,,0.00,0.00,0,0,0,0,0,0,0,0,0,0,0,0,0
20200212,05740P,宏達電元富96售01,0.89,0.90,0.89,0.90,-0.02,-2.17,3000,3,2690,0,0,0,0,0,0,3000,0,3000,3000
20200212,05741P,聯發科元大96售14,3.71,3.77,3.51,3.51,-0.69,-16.43,240000,12,877660,0,0,0,0,0,0,240000,239000,1000,1000
20200212,05742P,可成元大96售04,1.70,1.72,1.54,1.54,-0.26,-14.44,270000,30,449010,0,0,0,0,0,0,67000,270000,-203000,-203000
20200212,05743P,創意元大96售01,1.91,2.00,1.85,1.87,0.00,0.00,185000,18,354660,0,0,0,0,0,0,0,185000,-185000,-185000
20200212,05744P,台表科元大96售04,,,,,0.00,0.00,0,0,0,0,0,0,0,0,0,0,0,0,0
20200212,05745P,富邦金兆豐96售02,2.15,2.15,2.15,2.15,-0.06,-2.71,50000,1,107500,0,0,0,0,0,0,50000,0,50000,50000
20200212,05746P,台積電群益96售07,2.67,2.69,2.58,2.60,-0.19,-6.81,484000,31,1279130,0,0,0,0,0,0,226000,328000,-102000,-102000
20200212,05747P,漢唐群益96售03,1.48,1.48,1.48,1.48,-0.17,-10.3,6000,1,8880,0,0,0,0,0,0,0,6000,-6000,-6000
20200212,05748P,臺股指群益99售02,1.93,1.95,1.79,1.82,-0.21,-10.34,475000,12,909640,0,0,0,0,0,0,400000,75000,325000,325000
20200212,05749P,臺股指群益99售03,3.12,3.12,2.91,2.91,-0.26,-8.2,177000,9,543900,0,0,0,0,0,0,165000,12000,153000,153000
20200212,05750P,臺股指群益99售04,3.15,3.15,3.00,3.00,-0.34,-10.18,65000,8,199660,0,0,0,0,0,0,37000,28000,9000,9000
20200212,05751P,台積電中信96售05,,,,,0.00,0.00,0,0,0,0,0,0,0,0,0,0,0,0,0
20200212,05752P,台積電中信96售06,,,,,0.00,0.00,0,0,0,0,0,0,0,0,0,0,0,0,0
20200212,05753P,臺股指中信99售02,0.80,0.80,0.74,0.74,-0.09,-10.84,86000,7,65470,0,0,0,0,0,0,0,86000,-86000,-86000
20200212,05754P,臺股指中信99售03,,,,,0.00,0.00,0,0,0,0,0,0,0,0,0,0,0,0,0
20200212,05755P,臺股指中信99售04,0.99,0.99,0.94,0.94,-0.08,-7.84,29000,4,27990,0,0,0,0,0,0,10000,19000,-9000,-9000
20200212,05756P,臺股指中信99售05,1.65,1.65,1.65,1.65,-0.03,-1.79,5000,1,8250,0,0,0,0,0,0,0,5000,-5000,-5000
20200212,05757P,旺宏永豐96售03,1.16,1.16,1.16,1.16,+0.01,0.87,15000,1,17400,0,0,0,0,0,0,0,15000,-15000,-15000
20200212,05758P,光罩永豐96售02,1.60,1.60,1.60,1.60,-0.10,-5.88,1000,1,1600,0,0,0,0,0,0,1000,0,1000,1000
20200212,05759P,智邦永豐96售02,0.74,0.83,0.74,0.80,-0.05,-5.88,399000,11,316300,0,0,0,0,0,0,280000,119000,161000,161000
20200212,05760P,京鼎永豐96售02,1.43,1.47,1.38,1.38,-0.27,-16.36,191000,5,274250,0,0,0,0,0,0,191000,0,191000,191000
20200212,05761P,嘉澤永豐96售01,1.24,1.31,1.24,1.30,+0.03,2.36,140000,5,178760,0,0,0,0,0,0,57000,83000,-26000,-26000
20200212,05762P,昇陽半永豐96售04,1.83,1.83,1.83,1.83,0.00,0.00,20000,1,36600,0,0,0,0,0,0,0,20000,-20000,-20000
20200212,05763P,致新永豐96售01,1.15,1.15,1.15,1.15,-0.01,-0.86,150000,19,172500,0,0,0,0,0,0,34000,116000,-82000,-82000
20200212,05764P,世紀鋼永豐96售03,1.18,1.20,1.18,1.20,+0.02,1.69,33000,3,39340,0,0,0,0,0,0,20000,13000,7000,7000
20200212,05765P,臺股指永豐96售01,2.70,2.76,2.59,2.59,-0.28,-9.76,117000,18,316870,0,0,0,0,0,0,40000,77000,-37000,-37000
20200212,05766P,A50正2凱基99售01,1.22,1.27,1.22,1.26,+0.04,3.28,254000,8,317850,0,0,0,0,0,0,95000,159000,-64000,-64000
20200212,05767P,國巨凱基96售11,0.30,0.60,0.30,0.60,+0.23,62.16,21000,2,6600,0,0,0,0,0,0,20000,0,20000,20000
20200212,05768P,台積電凱基96售15,1.10,1.10,1.10,1.10,-0.11,-9.09,3000,1,3300,0,0,0,0,0,0,0,3000,-3000,-3000
20200212,05769P,台積電凱基96售16,,,,,0.00,0.00,0,0,0,0,0,0,0,0,0,0,0,0,0
20200212,05770P,聯發科凱基96售16,0.84,0.84,0.84,0.84,-0.27,-24.32,20000,1,16800,0,0,0,0,0,0,0,20000,-20000,-20000
20200212,05771P,大立光凱基96售13,,,,,0.00,0.00,0,0,0,0,0,0,0,0,0,0,0,0,0
20200212,05772P,景碩凱基96售02,0.87,0.87,0.75,0.81,-0.09,-10.0,97000,6,82100,0,0,0,0,0,0,82000,15000,67000,67000
20200212,05773P,臺股指凱基99售03,1.53,1.53,1.48,1.48,-0.09,-5.73,10000,2,15050,0,0,0,0,0,0,0,10000,-10000,-10000
20200212,05774P,臺股指凱基99售04,1.49,1.50,1.37,1.39,-0.13,-8.55,315000,43,448230,0,0,0,0,0,0,110000,204000,-94000,-94000
20200212,05775P,台積電國泰98售02,1.25,1.25,1.20,1.20,-0.10,-7.69,18000,7,21990,0,0,0,0,0,0,0,18000,-18000,-18000
20200212,05776P,鴻海統一98售02,,,,,0.00,0.00,0,0,0,0,0,0,0,0,0,0,0,0,0
20200212,05777P,台積電統一96售04,2.06,2.08,2.00,2.00,-0.25,-11.11,1679000,11,3469340,0,0,0,0,0,0,1127000,552000,575000,575000
20200212,05778P,台積電統一96售05,1.96,1.96,1.96,1.96,-0.19,-8.84,9000,1,17640,0,0,0,0,0,0,9000,0,9000,9000
20200212,05779P,台積電統一96售06,,,,,0.00,0.00,0,0,0,0,0,0,0,0,0,0,0,0,0
20200212,05780P,台積電統一96售07,1.49,1.51,1.45,1.46,-0.09,-5.81,2420000,39,3558430,0,0,0,0,0,0,965000,1468000,-503000,-503000
20200212,05781P,臺股指統一99售02,2.20,2.20,2.20,2.20,0.00,0.00,5000,1,11000,0,0,0,0,0,0,0,5000,-5000,-5000
20200212,05782P,聯詠元富96售02,1.10,1.14,1.10,1.12,-0.06,-5.08,66000,4,73120,0,0,0,0,0,0,50000,16000,34000,34000
20200212,05783P,嘉澤元富96售01,1.32,1.38,1.32,1.35,+0.06,4.65,38000,15,51910,0,0,0,0,0,0,12000,26000,-14000,-14000
20200212,05784P,臺股指元大96售18,2.38,2.38,2.25,2.25,-0.23,-9.27,32000,7,73580,0,0,0,0,0,0,2000,30000,-28000,-28000
20200212,05785P,臺股指元大96售19,1.91,1.91,1.83,1.83,-0.28,-13.27,2000,2,3740,0,0,0,0,0,0,0,2000,-2000,-2000
20200212,05786P,臺股指永昌96售03,2.35,2.35,1.90,1.96,-0.54,-21.6,490000,50,1031420,0,0,0,0,0,0,486000,490000,-4000,-4000
20200212,05787P,臺股指永昌96售04,1.99,2.02,1.66,1.67,-0.46,-21.6,365000,37,670950,0,0,0,0,0,0,360000,365000,-5000,-5000
20200212,05788P,臺股指永昌96售05,1.88,1.92,1.59,1.63,-0.42,-20.49,500000,50,873400,0,0,0,0,0,0,500000,500000,0,0
20200212,05789P,臺股指永昌96售06,1.68,1.68,1.42,1.45,-0.43,-22.87,510000,51,778000,0,0,0,0,0,0,510000,500000,10000,10000
20200212,05790P,臺股指永昌96售07,1.57,1.57,1.30,1.34,-0.38,-22.09,496000,56,700510,0,0,0,0,0,0,436000,491000,-55000,-55000
20200212,05791P,臺股指中信99售06,1.12,1.12,1.06,1.06,-0.10,-8.62,30000,2,32400,0,0,0,0,0,0,0,30000,-30000,-30000
20200212,05792P,臺股指中信99售07,1.37,1.37,1.37,1.37,0.00,0.00,20000,1,27400,0,0,0,0,0,0,0,20000,-20000,-20000
20200212,05793P,臺股指中信99售08,1.30,1.30,1.21,1.21,-0.10,-7.63,97000,4,121170,0,0,0,0,0,0,42000,55000,-13000,-13000
20200212,05794P,華邦電群益96售04,,,,,0.00,0.00,0,0,0,0,0,0,0,0,0,0,0,0,0
20200212,05795P,華邦電群益96售05,2.02,2.03,2.01,2.03,-0.16,-7.31,105000,8,212390,0,0,0,0,0,0,44000,61000,-17000,-17000
20200212,05796P,臺股指群益96售10,3.93,3.94,3.50,3.50,-0.64,-15.46,163000,18,599070,0,0,0,0,0,0,50000,113000,-63000,-63000
20200212,05797P,臺股指群益96售11,2.41,2.41,2.27,2.27,-0.24,-9.56,41000,5,96330,0,0,0,0,0,0,10000,31000,-21000,-21000
20200212,05798P,臺股指群益96售12,3.98,3.98,3.74,3.74,0.00,0.00,77000,7,293500,0,0,0,0,0,0,0,77000,-77000,-77000
20200212,05799P,臺股指群益96售13,3.24,3.24,3.00,3.00,-0.43,-12.54,38000,13,117630,0,0,0,0,0,0,0,38000,-38000,-38000
20200212,05800P,台積電兆豐96售04,3.40,3.41,3.24,3.24,-0.41,-11.23,58000,5,193780,0,0,0,0,0,0,20000,38000,-18000,-18000
20200212,05801P,正崴兆豐96售01,3.53,3.55,3.46,3.46,-0.17,-4.68,111000,3,390600,0,0,0,0,0,0,111000,0,111000,111000
20200212,05802P,臺股指兆豐96售02,,,,,0.00,0.00,0,0,0,0,0,0,0,0,0,0,0,0,0
20200212,05803P,臺股指兆豐96售03,,,,,0.00,0.00,0,0,0,0,0,0,0,0,0,0,0,0,0
20200212,05804P,美律永豐96售01,,,,,0.00,0.00,0,0,0,0,0,0,0,0,0,0,0,0,0
20200212,05805P,義隆永豐96售02,1.67,1.75,1.67,1.70,-0.17,-9.09,144000,23,247240,0,0,0,0,0,0,5000,138000,-133000,-133000
20200212,05806P,宏達電永豐96售03,2.44,2.44,2.44,2.44,0.00,0.00,25000,2,61000,0,0,0,0,0,0,5000,20000,-15000,-15000
20200212,05807P,泰鼎永豐96售03,0.84,0.89,0.83,0.88,-0.05,-5.38,822000,24,719590,0,0,0,0,0,0,91000,721000,-630000,-630000
20200212,05808P,臺股指國票96售01,4.37,4.37,4.05,4.05,-0.45,-10.0,45000,15,190960,0,0,0,0,0,0,6000,39000,-33000,-33000
20200212,05809P,臺股指國票96售02,,,,,0.00,0.00,0,0,0,0,0,0,0,0,0,0,0,0,0
20200212,05810P,臺股指國票96售03,2.44,2.44,2.37,2.37,0.00,0.00,160000,4,384000,0,0,0,0,0,0,0,160000,-160000,-160000
20200212,05811P,臺股指國票96售04,,,,,0.00,0.00,0,0,0,0,0,0,0,0,0,0,0,0,0
20200212,05812P,臺股指國票96售05,,,,,0.00,0.00,0,0,0,0,0,0,0,0,0,0,0,0,0
20200212,05813P,臺股指國票96售06,,,,,0.00,0.00,0,0,0,0,0,0,0,0,0,0,0,0,0
20200212,05814P,臺股指國票96售07,2.76,2.76,2.75,2.75,-0.24,-8.03,109000,2,300740,0,0,0,0,0,0,0,109000,-109000,-109000
20200212,05815P,台積電凱基97售06,1.66,1.66,1.57,1.57,-0.14,-8.19,220000,10,355980,0,0,0,0,0,0,220000,220000,0,0
20200212,05816P,台積電凱基97售07,,,,,0.00,0.00,0,0,0,0,0,0,0,0,0,0,0,0,0
20200212,05817P,可成凱基96售07,1.27,1.27,1.22,1.22,-0.15,-10.95,54000,2,66030,0,0,0,0,0,0,51000,54000,-3000,-3000
20200212,05818P,大立光凱基96售14,0.96,0.96,0.92,0.92,0.00,0.00,601000,3,570860,0,0,0,0,0,0,299000,302000,-3000,-3000
20200212,05819P,臺股指凱基96售16,1.23,1.23,1.09,1.09,-0.19,-14.84,193000,6,218450,0,0,0,0,0,0,0,193000,-193000,-193000
20200212,05820P,臺股指凱基96售17,2.43,2.43,2.26,2.26,-0.20,-8.13,85000,4,204560,0,0,0,0,0,0,77000,8000,69000,69000
20200212,05821P,臺股指凱基96售18,1.73,1.73,1.50,1.50,-0.30,-16.67,466000,22,751140,0,0,0,0,0,0,8000,438000,-430000,-430000
20200212,05822P,臺股指凱基96售19,1.69,1.69,1.69,1.69,-0.20,-10.58,3000,1,5070,0,0,0,0,0,0,3000,0,3000,3000
20200212,05823P,臺股指凱基96售20,1.91,1.91,1.70,1.70,-0.27,-13.71,190000,15,344200,0,0,0,0,0,0,0,190000,-190000,-190000
20200212,05824P,臺股指凱基96售21,2.11,2.11,1.88,1.88,-0.28,-12.96,54000,7,107990,0,0,0,0,0,0,0,54000,-54000,-54000
20200212,05825P,臺股指凱基96售22,2.83,2.84,2.78,2.78,-0.09,-3.14,182000,3,515100,0,0,0,0,0,0,180000,2000,178000,178000
20200212,05826P,臺股指凱基96售23,2.70,2.72,2.46,2.46,-0.30,-10.87,331000,10,873040,0,0,0,0,0,0,194000,137000,57000,57000
20200212,05827P,台積電統一96售10,,,,,0.00,0.00,0,0,0,0,0,0,0,0,0,0,0,0,0
20200212,05828P,台積電統一97售02,1.59,1.60,1.53,1.53,-0.17,-10.0,610000,16,958650,0,0,0,0,0,0,345000,465000,-120000,-120000
20200212,05829P,臺股指統一96售08,,,,,0.00,0.00,0,0,0,0,0,0,0,0,0,0,0,0,0
20200212,05830P,滬深2X元富99售03,2.32,2.37,2.31,2.32,-0.03,-1.28,120000,9,279700,0,0,0,0,0,0,60000,60000,0,0
20200212,05831P,臺股指元富96售03,,,,,0.00,0.00,0,0,0,0,0,0,0,0,0,0,0,0,0
20200212,05832P,臺股指元富96售04,,,,,0.00,0.00,0,0,0,0,0,0,0,0,0,0,0,0,0
20200212,05833P,臺股指元富96售05,,,,,0.00,0.00,0,0,0,0,0,0,0,0,0,0,0,0,0
20200212,05834P,臺股指元富96售06,,,,,0.00,0.00,0,0,0,0,0,0,0,0,0,0,0,0,0
20200212,05835P,臺股指元富96售07,0.79,0.79,0.71,0.71,-0.13,-15.48,343000,13,252330,0,0,0,0,0,0,154000,189000,-35000,-35000
20200212,05836P,臺股指元富96售08,0.80,0.80,0.80,0.80,-0.18,-18.37,25000,1,20000,0,0,0,0,0,0,25000,0,25000,25000
20200212,05837P,臺股指富邦96售04,1.16,1.16,1.16,1.16,-0.15,-11.45,6000,2,6960,0,0,0,0,0,0,0,6000,-6000,-6000
20200212,05838P,臺股指富邦96售05,,,,,0.00,0.00,0,0,0,0,0,0,0,0,0,0,0,0,0
20200212,05839P,臺股指富邦96售06,1.23,1.23,1.11,1.11,-0.15,-11.9,340000,29,396870,0,0,0,0,0,0,63000,277000,-214000,-214000
20200212,05840P,臺股指富邦96售07,0.67,0.67,0.64,0.64,-0.05,-7.25,75000,6,49720,0,0,0,0,0,0,20000,55000,-35000,-35000
20200212,05841P,華通元大96售04,1.20,1.20,1.08,1.08,-0.22,-16.92,60000,8,66680,0,0,0,0,0,0,35000,25000,10000,10000
20200212,05842P,台積電元大96售15,3.22,3.22,3.13,3.13,-0.21,-6.29,259000,7,828370,0,0,0,0,0,0,259000,250000,9000,9000
20200212,05843P,台積電元大96售16,2.64,2.69,2.59,2.59,-0.17,-6.16,189000,14,500110,0,0,0,0,0,0,159000,189000,-30000,-30000
20200212,05844P,旺宏元大96售07,1.19,1.22,1.18,1.22,+0.01,0.83,165000,7,198440,0,0,0,0,0,0,77000,165000,-88000,-88000
20200212,05845P,大立光元大96售06,,,,,0.00,0.00,0,0,0,0,0,0,0,0,0,0,0,0,0
20200212,05846P,大立光元大96售07,,,,,0.00,0.00,0,0,0,0,0,0,0,0,0,0,0,0,0
20200212,05847P,大立光元大96售08,1.99,1.99,1.88,1.88,-0.18,-8.74,75000,6,144270,0,0,0,0,0,0,40000,35000,5000,5000
20200212,05848P,臺股指元大96售24,2.85,2.85,2.64,2.67,-0.22,-7.61,349000,23,956410,0,0,0,0,0,0,0,349000,-349000,-349000
20200212,05849P,臺股指元大96售25,2.20,2.22,2.06,2.11,-0.14,-6.22,875000,28,1838260,0,0,0,0,0,0,486000,389000,97000,97000
20200212,05850P,台積電兆豐96售06,2.79,2.82,2.66,2.67,-0.26,-8.87,67000,12,182710,0,0,0,0,0,0,13000,54000,-41000,-41000
20200212,05851P,力山群益97售01,2.83,2.83,2.83,2.83,+0.02,0.71,10000,1,28300,0,0,0,0,0,0,10000,0,10000,10000
20200212,05852P,嘉晶群益96售01,,,,,0.00,0.00,0,0,0,0,0,0,0,0,0,0,0,0,0
20200212,05853P,欣興群益96售05,1.62,1.64,1.47,1.47,-0.32,-17.88,96000,14,147400,0,0,0,0,0,0,7000,89000,-82000,-82000
20200212,05854P,華新科凱基96售09,,,,,0.00,0.00,0,0,0,0,0,0,0,0,0,0,0,0,0
20200212,05855P,滬深2X中信9C售01,,,,,0.00,0.00,0,0,0,0,0,0,0,0,0,0,0,0,0
20200212,05856P,A50正2中信99售01,1.75,1.75,1.75,1.75,+0.03,1.74,10000,1,17500,0,0,0,0,0,0,10000,0,10000,10000
20200212,05857P,旺宏中信98售02,0.93,0.95,0.93,0.94,0.00,0.00,31000,3,29290,0,0,0,0,0,0,0,31000,-31000,-31000
20200212,05858P,矽力中信96售01,0.60,0.60,0.57,0.57,-0.06,-9.52,226000,7,131580,0,0,0,0,0,0,186000,40000,146000,146000
20200212,05859P,台表科國票97售04,6.15,6.15,6.15,6.15,0.00,0.00,10000,1,61500,0,0,0,0,0,0,0,10000,-10000,-10000
20200212,05860P,旺宏康和96售01,0.70,0.70,0.70,0.70,-0.04,-5.41,3000,1,2100,0,0,0,0,0,0,0,3000,-3000,-3000
20200212,05861P,瀚宇博永豐96售02,2.08,2.08,2.08,2.08,0.00,0.00,10000,1,20800,0,0,0,0,0,0,0,10000,-10000,-10000
20200212,05862P,大立光國泰98售01,1.48,1.48,1.40,1.41,-0.10,-6.62,920000,26,1330080,0,0,0,0,0,0,598000,903000,-305000,-305000
20200212,05863P,滬深2X元大96售09,1.72,1.74,1.68,1.68,0.00,0.00,45000,4,76600,0,0,0,0,0,0,35000,10000,25000,25000
20200212,05864P,元油反元大96售07,,,,,0.00,0.00,0,0,0,0,0,0,0,0,0,0,0,0,0
20200212,05865P,大立光元大96售09,3.29,3.29,3.29,3.29,-0.34,-9.37,13000,1,42770,0,0,0,0,0,0,0,13000,-13000,-13000
20200212,05866P,致伸元大96售01,,,,,0.00,0.00,0,0,0,0,0,0,0,0,0,0,0,0,0
20200212,05867P,友達兆豐97售02,0.47,0.50,0.47,0.50,+0.03,6.38,111000,9,54300,0,0,0,0,0,0,52000,59000,-7000,-7000
20200212,05868P,台積電凱基96售17,,,,,0.00,0.00,0,0,0,0,0,0,0,0,0,0,0,0,0
20200212,05869P,旺宏凱基96售05,1.26,1.26,1.25,1.25,0.00,0.00,30000,3,37700,0,0,0,0,0,0,0,30000,-30000,-30000
20200212,05870P,聯發科凱基96售19,,,,,0.00,0.00,0,0,0,0,0,0,0,0,0,0,0,0,0
20200212,05871P,全新凱基96售04,0.59,0.59,0.55,0.56,-0.10,-15.15,30000,4,16800,0,0,0,0,0,0,0,30000,-30000,-30000
20200212,05872P,大立光凱基96售15,,,,,0.00,0.00,0,0,0,0,0,0,0,0,0,0,0,0,0
20200212,05873P,華通群益97售02,,,,,0.00,0.00,0,0,0,0,0,0,0,0,0,0,0,0,0
20200212,05874P,台積電群益96售10,3.54,3.58,3.47,3.47,-0.24,-6.47,609000,14,2159290,0,0,0,0,0,0,195000,484000,-289000,-289000
20200212,05875P,旺宏群益98售01,1.45,1.45,1.45,1.45,0.00,0.00,10000,1,14500,0,0,0,0,0,0,0,10000,-10000,-10000
20200212,05876P,聯發科群益96售03,,,,,0.00,0.00,0,0,0,0,0,0,0,0,0,0,0,0,0
20200212,05877P,大立光群益96售06,2.62,2.62,2.51,2.51,-0.27,-9.71,27000,6,68790,0,0,0,0,0,0,0,27000,-27000,-27000
20200212,05878P,創意群益98售01,2.06,2.14,2.06,2.09,+0.01,0.48,25000,7,52360,0,0,0,0,0,0,0,25000,-25000,-25000
20200212,05879P,台積電台新96售03,,,,,0.00,0.00,0,0,0,0,0,0,0,0,0,0,0,0,0
20200212,05880P,創意康和96售01,0.89,0.89,0.84,0.84,+0.01,1.2,27000,2,23980,0,0,0,0,0,0,1000,26000,-25000,-25000
20200212,05881P,彩晶康和96售01,1.00,1.00,1.00,1.00,0.00,0.00,23000,1,23000,0,0,0,0,0,0,0,23000,-23000,-23000
20200212,05882P,華新科永豐96售01,,,,,0.00,0.00,0,0,0,0,0,0,0,0,0,0,0,0,0
20200212,05883P,致伸永豐96售03,,,,,0.00,0.00,0,0,0,0,0,0,0,0,0,0,0,0,0
20200212,05884P,旺宏統一96售01,1.67,1.73,1.64,1.70,-0.02,-1.16,589000,105,990280,0,0,0,0,0,0,135000,454000,-319000,-319000
20200212,05885P,牧德統一96售01,0.59,0.63,0.58,0.63,+0.01,1.61,129000,8,77500,0,0,0,0,0,0,43000,86000,-43000,-43000
20200212,05886P,華通元富96售01,2.62,2.62,2.06,2.06,-0.66,-24.26,17000,10,40190,0,0,0,0,0,0,0,17000,-17000,-17000
20200212,05887P,友達元富99售03,0.83,0.89,0.83,0.89,+0.06,7.23,51000,6,44070,0,0,0,0,0,0,30000,21000,9000,9000
20200212,05888P,友達元大97售01,0.53,0.57,0.53,0.57,+0.02,3.64,248000,11,137550,0,90000,-90000,0,0,0,202000,46000,156000,66000
20200212,05889P,群創元大98售02,0.69,0.70,0.69,0.70,+0.01,1.45,30000,3,20850,0,0,0,0,0,0,5000,25000,-20000,-20000
20200212,05890P,彩晶元大99售01,,,,,0.00,0.00,0,0,0,0,0,0,0,0,0,0,0,0,0
20200212,05891P,聯發科中信98售03,2.03,2.03,1.98,1.98,-0.17,-7.91,24000,5,47910,0,0,0,0,0,0,5000,19000,-14000,-14000
20200212,05892P,大立光中信98售03,1.83,1.83,1.83,1.83,-0.13,-6.63,10000,1,18300,0,0,0,0,0,0,0,10000,-10000,-10000
20200212,05893P,國巨兆豐96售04,0.59,0.59,0.59,0.59,-0.04,-6.35,33000,1,19470,0,0,0,0,0,0,33000,0,33000,33000
20200212,05894P,友達群益98售02,0.43,0.47,0.43,0.47,+0.02,4.44,69000,6,32060,0,0,0,0,0,0,3000,66000,-63000,-63000
20200212,05895P,奇力新群益96售03,0.87,0.89,0.83,0.83,-0.05,-5.68,195000,10,166580,0,0,0,0,0,0,40000,155000,-115000,-115000
20200212,05896P,宏達電群益96售03,,,,,0.00,0.00,0,0,0,0,0,0,0,0,0,0,0,0,0
20200212,05897P,國巨凱基96售12,0.85,0.87,0.84,0.86,-0.05,-5.49,83000,6,70570,0,0,0,0,0,0,40000,43000,-3000,-3000
20200212,05898P,旺宏凱基96售06,,,,,0.00,0.00,0,0,0,0,0,0,0,0,0,0,0,0,0
20200212,05899P,臺股指凱基96售30,1.94,1.94,1.84,1.84,-0.16,-8.0,33000,15,62110,0,0,0,0,0,0,0,33000,-33000,-33000
20200212,05900P,臺股指凱基99售05,1.19,1.19,1.19,1.19,-0.18,-13.14,3000,1,3570,0,0,0,0,0,0,0,3000,-3000,-3000
20200212,05901P,臺股指凱基9C售01,1.33,1.33,1.23,1.23,-0.12,-8.89,718000,61,907670,0,0,0,0,0,0,0,698000,-698000,-698000
20200212,05902P,華通國票96售02,3.11,3.11,3.11,3.11,-0.18,-5.47,10000,1,31100,0,0,0,0,0,0,10000,0,10000,10000
20200212,05903P,聯發科統一96售09,3.11,3.11,3.04,3.04,-0.35,-10.32,23000,4,70780,0,0,0,0,0,0,10000,13000,-3000,-3000
20200212,05904P,大立光統一96售07,2.19,2.19,2.09,2.09,-0.15,-6.7,147000,3,314770,0,0,0,0,0,0,143000,4000,139000,139000
20200212,05905P,晶技統一97售01,,,,,0.00,0.00,0,0,0,0,0,0,0,0,0,0,0,0,0
20200212,05906P,國巨元富96售05,0.62,0.62,0.62,0.62,-0.02,-3.12,5000,1,3100,0,0,0,0,0,0,0,5000,-5000,-5000
20200212,05907P,聯發科元富96售05,,,,,0.00,0.00,0,0,0,0,0,0,0,0,0,0,0,0,0
20200212,05908P,大立光元富96售05,3.15,3.15,3.15,3.15,+0.01,0.32,6000,1,18900,0,0,0,0,0,0,6000,0,6000,6000
20200212,05909P,康友元富96售02,,,,,0.00,0.00,0,0,0,0,0,0,0,0,0,0,0,0,0
20200212,05910P,力山永豐96售02,,,,,0.00,0.00,0,0,0,0,0,0,0,0,0,0,0,0,0
20200212,05911P,南亞科永豐96售03,1.01,1.03,1.01,1.03,-0.06,-5.5,27000,3,27610,0,0,0,0,0,0,10000,17000,-7000,-7000
20200212,05912P,和大元大96售01,1.81,1.81,1.81,1.81,0.00,0.00,90000,3,162900,0,0,0,0,0,0,0,90000,-90000,-90000
20200212,05913P,國巨元大96售11,1.97,1.97,1.97,1.97,+0.49,33.11,5000,1,9850,0,0,0,0,0,0,5000,0,5000,5000
20200212,05914P,友達元大96售04,0.62,0.67,0.62,0.67,+0.06,9.84,166000,11,107110,0,0,0,0,0,0,119000,47000,72000,72000
20200212,05915P,聯發科元大96售19,3.11,3.11,3.01,3.01,-0.33,-9.88,13000,3,39780,0,0,0,0,0,0,0,13000,-13000,-13000
20200212,05916P,聯發科元大96售20,4.64,4.64,4.64,4.64,-0.41,-8.12,23000,2,106720,0,0,0,0,0,0,0,23000,-23000,-23000
20200212,05917P,宏達電元大96售02,1.46,1.46,1.46,1.46,-0.05,-3.31,2000,2,2920,0,0,0,0,0,0,0,2000,-2000,-2000
20200212,05918P,大立光元大96售11,,,,,0.00,0.00,0,0,0,0,0,0,0,0,0,0,0,0,0
20200212,05919P,京鼎元大96售03,,,,,0.00,0.00,0,0,0,0,0,0,0,0,0,0,0,0,0
20200212,05920P,力成元大96售04,1.14,1.14,1.04,1.04,-0.21,-16.8,55000,7,58600,0,0,0,0,0,0,4000,51000,-47000,-47000
20200212,05921P,同欣電元大96售06,1.07,1.13,1.07,1.13,-0.06,-5.04,115000,7,125820,0,0,0,0,0,0,0,115000,-115000,-115000
20200212,05922P,京元電兆豐96售01,2.00,2.00,2.00,2.00,-0.09,-4.31,5000,1,10000,0,0,0,0,0,0,0,5000,-5000,-5000
20200212,05923P,旺宏元富96售05,1.18,1.20,1.18,1.18,-0.04,-3.28,40000,3,47400,0,0,0,0,0,0,0,40000,-40000,-40000
20200212,05924P,超眾元富96售04,2.69,2.69,2.64,2.64,-0.08,-2.94,119000,7,319080,0,0,0,0,0,0,119000,0,119000,119000
20200212,05925P,晶技永豐96售03,,,,,0.00,0.00,0,0,0,0,0,0,0,0,0,0,0,0,0
20200212,05926P,智易永豐96售02,,,,,0.00,0.00,0,0,0,0,0,0,0,0,0,0,0,0,0
20200212,05927P,正文永豐96售03,2.14,2.14,2.13,2.13,-0.04,-1.84,31000,2,66140,0,0,0,0,0,0,11000,20000,-9000,-9000
20200212,05928P,華邦電康和96售01,,,,,0.00,0.00,0,0,0,0,0,0,0,0,0,0,0,0,0
20200212,05929P,宏達電康和96售01,,,,,0.00,0.00,0,0,0,0,0,0,0,0,0,0,0,0,0
20200212,05930P,景碩康和96售01,0.97,0.97,0.97,0.97,-0.06,-5.83,5000,1,4850,0,0,0,0,0,0,0,5000,-5000,-5000
20200212,05931P,鴻海凱基96售15,5.15,5.15,4.77,4.77,-0.73,-13.27,70000,6,347850,0,0,0,0,0,0,10000,60000,-50000,-50000
20200212,05932P,鴻海凱基96售16,,,,,0.00,0.00,0,0,0,0,0,0,0,0,0,0,0,0,0
20200212,05933P,鴻海凱基97售03,,,,,0.00,0.00,0,0,0,0,0,0,0,0,0,0,0,0,0
20200212,05934P,國巨凱基96售13,0.33,0.33,0.33,0.33,-0.07,-17.5,5000,1,1650,0,0,0,0,0,0,5000,0,5000,5000
20200212,05935P,台積電凱基96售19,,,,,0.00,0.00,0,0,0,0,0,0,0,0,0,0,0,0,0
20200212,05936P,台積電凱基96售20,2.66,2.66,2.66,2.66,0.00,0.00,38000,1,101080,0,0,0,0,0,0,38000,38000,0,0
20200212,05937P,台積電凱基96售21,,,,,0.00,0.00,0,0,0,0,0,0,0,0,0,0,0,0,0
20200212,05938P,旺宏凱基96售07,,,,,0.00,0.00,0,0,0,0,0,0,0,0,0,0,0,0,0
20200212,05939P,聯發科凱基96售20,4.49,4.49,4.16,4.18,0.00,0.00,44000,5,192340,0,0,0,0,0,0,0,44000,-44000,-44000
20200212,05940P,聯發科凱基96售21,,,,,0.00,0.00,0,0,0,0,0,0,0,0,0,0,0,0,0
20200212,05941P,聯發科凱基96售22,,,,,0.00,0.00,0,0,0,0,0,0,0,0,0,0,0,0,0
20200212,05942P,奇力新凱基96售04,0.41,0.41,0.41,0.41,-0.02,-4.65,5000,1,2050,0,0,0,0,0,0,0,5000,-5000,-5000
20200212,05943P,欣興凱基96售03,1.97,1.97,1.90,1.90,-0.26,-12.04,3000,3,5830,0,0,0,0,0,0,0,3000,-3000,-3000
20200212,05944P,富邦金中信96售01,,,,,0.00,0.00,0,0,0,0,0,0,0,0,0,0,0,0,0
20200212,05945P,聯詠中信96售01,0.58,0.61,0.58,0.60,0.00,0.00,170000,4,102650,0,0,0,0,0,0,0,170000,-170000,-170000
20200212,05946P,和碩中信96售01,,,,,0.00,0.00,0,0,0,0,0,0,0,0,0,0,0,0,0
20200212,05947P,大成鋼元大96售03,,,,,0.00,0.00,0,0,0,0,0,0,0,0,0,0,0,0,0
20200212,05948P,茂林元大96售03,1.00,1.02,1.00,1.02,-0.09,-8.11,2000,2,2020,0,0,0,0,0,0,1000,1000,0,0
20200212,05949P,台積電國票96售09,2.22,2.22,2.15,2.15,-0.21,-8.9,111000,10,243670,0,0,0,0,0,0,90000,99000,-9000,-9000
20200212,05950P,台積電國票97售04,3.12,3.12,3.12,3.12,0.00,0.00,6000,1,18720,0,0,0,0,0,0,0,6000,-6000,-6000
20200212,05951P,台積電國票97售05,3.17,3.17,3.17,3.17,0.00,0.00,5000,1,15850,0,0,0,0,0,0,0,5000,-5000,-5000
20200212,05952P,台積電國票97售06,2.97,3.00,2.90,2.90,-0.18,-5.84,247000,15,730870,0,0,0,0,0,0,79000,237000,-158000,-158000
20200212,05953P,台積電國票98售02,3.16,3.16,3.05,3.05,-0.20,-6.15,85000,9,265100,0,0,0,0,0,0,15000,85000,-70000,-70000
20200212,05954P,旺宏國票97售03,2.24,2.24,2.21,2.21,-0.10,-4.33,28000,3,62120,0,0,0,0,0,0,0,28000,-28000,-28000
20200212,05955P,台光電國票97售02,,,,,0.00,0.00,0,0,0,0,0,0,0,0,0,0,0,0,0
20200212,05956P,漢唐國票96售02,,,,,0.00,0.00,0,0,0,0,0,0,0,0,0,0,0,0,0
20200212,05957P,友達國票97售04,0.49,0.49,0.49,0.49,0.00,0.00,95000,1,46550,0,0,0,0,0,0,95000,0,95000,95000
20200212,05958P,聯發科國票97售04,,,,,0.00,0.00,0,0,0,0,0,0,0,0,0,0,0,0,0
20200212,05959P,聯發科國票98售01,,,,,0.00,0.00,0,0,0,0,0,0,0,0,0,0,0,0,0
20200212,05960P,欣興統一96售01,1.70,1.70,1.50,1.50,-0.26,-14.77,241000,18,387690,0,0,0,0,0,0,35000,206000,-171000,-171000
20200212,05961P,鴻海群益97售01,3.82,3.82,3.46,3.46,-0.59,-14.57,28000,7,100880,0,0,0,0,0,0,0,28000,-28000,-28000
20200212,05962P,大立光群益96售07,,,,,0.00,0.00,0,0,0,0,0,0,0,0,0,0,0,0,0
20200212,05963P,貿聯國票97售02,2.36,2.38,2.32,2.38,-0.17,-6.67,68000,6,160640,0,0,0,0,0,0,68000,0,68000,68000
20200212,05964P,華通凱基96售06,,,,,0.00,0.00,0,0,0,0,0,0,0,0,0,0,0,0,0
20200212,05965P,健策凱基96售05,,,,,0.00,0.00,0,0,0,0,0,0,0,0,0,0,0,0,0
20200212,05966P,矽力凱基96售03,0.85,0.85,0.85,0.85,-0.17,-16.67,26000,3,22100,0,0,0,0,0,0,20000,6000,14000,14000
20200212,05967P,臺股指麥證96售02,,,,,0.00,0.00,0,0,0,0,0,0,0,0,0,0,0,0,0
20200212,05968P,鴻海台新96售02,,,,,0.00,0.00,0,0,0,0,0,0,0,0,0,0,0,0,0
20200212,05969P,台積電台新96售04,,,,,0.00,0.00,0,0,0,0,0,0,0,0,0,0,0,0,0
20200212,05970P,超眾永豐96售03,2.49,2.49,2.47,2.47,-0.02,-0.8,20000,3,49600,0,0,0,0,0,0,20000,0,20000,20000
20200212,05971P,世紀鋼永豐96售04,,,,,0.00,0.00,0,0,0,0,0,0,0,0,0,0,0,0,0
20200212,05972P,瑞昱元大96售01,1.72,1.72,1.72,1.72,-0.24,-12.24,50000,2,86000,0,0,0,0,0,0,0,50000,-50000,-50000
20200212,05973P,聯詠元大96售06,2.27,2.36,2.24,2.36,-0.11,-4.45,82000,9,186500,0,0,0,0,0,0,62000,20000,42000,42000
20200212,05974P,國巨富邦97售03,0.53,0.55,0.52,0.52,-0.03,-5.45,165000,11,87650,0,0,0,0,0,0,125000,10000,115000,115000
20200212,05975P,國巨日盛99售02,1.00,1.01,1.00,1.01,-0.03,-2.88,37000,3,37170,0,0,0,0,0,0,0,37000,-37000,-37000
20200212,05976P,國巨凱基96售14,1.65,1.65,1.65,1.65,0.00,0.00,1000,1,1650,0,0,0,0,0,0,0,1000,-1000,-1000
20200212,05977P,旺宏永豐96售06,1.14,1.14,1.14,1.14,+0.01,0.88,15000,1,17100,0,0,0,0,0,0,0,15000,-15000,-15000
20200212,05978P,麗豐永豐96售02,2.20,2.20,2.14,2.16,-0.12,-5.26,252000,6,550080,0,0,0,0,0,0,220000,32000,188000,188000
20200212,05979P,華新科中信96售02,,,,,0.00,0.00,0,0,0,0,0,0,0,0,0,0,0,0,0
20200212,05980P,台積電永昌96售09,1.34,1.37,1.30,1.31,-0.10,-7.09,4244000,56,5682650,0,0,0,0,0,0,3193000,3826000,-633000,-633000
20200212,05981P,可成永昌98售02,2.07,2.07,1.99,1.99,-0.22,-9.95,37000,5,75370,0,0,0,0,0,0,16000,37000,-21000,-21000
20200212,05982P,漢唐國票96售03,,,,,0.00,0.00,0,0,0,0,0,0,0,0,0,0,0,0,0
20200212,05983P,聯詠國票96售02,1.92,1.92,1.88,1.88,0.00,0.00,12000,2,22800,0,0,0,0,0,0,0,12000,-12000,-12000
20200212,05984P,台積電統一98售01,1.01,1.01,0.99,0.99,-0.07,-6.6,22000,4,21800,0,0,0,0,0,0,0,22000,-22000,-22000
20200212,05985P,燿華統一96售03,1.30,1.30,1.30,1.30,0.00,0.00,1000,1,1300,0,0,0,0,0,0,0,1000,-1000,-1000
20200212,05986P,大立光統一97售03,1.75,1.75,1.74,1.74,-0.12,-6.45,130000,5,227400,0,0,0,0,0,0,120000,10000,110000,110000
20200212,05987P,健策統一96售02,0.75,0.75,0.74,0.75,-0.12,-13.79,36000,7,26950,0,0,0,0,0,0,36000,0,36000,36000
20200212,05988P,光磊元富96售02,2.05,2.05,2.05,2.05,-0.05,-2.38,1000,1,2050,0,0,0,0,0,0,1000,0,1000,1000
20200212,05989P,健策元富96售01,0.80,0.80,0.79,0.79,-0.15,-15.96,20000,2,15880,0,0,0,0,0,0,0,20000,-20000,-20000
20200212,05990P,台積電群益96售13,2.04,2.04,2.04,2.04,-0.24,-10.53,5000,1,10200,0,0,0,0,0,0,0,5000,-5000,-5000
20200212,05991P,聯茂群益96售05,1.49,1.49,1.31,1.33,-0.47,-26.11,50000,4,69300,0,0,0,0,0,0,20000,30000,-10000,-10000
20200212,05992P,華通元大96售05,,,,,0.00,0.00,0,0,0,0,0,0,0,0,0,0,0,0,0
20200212,05993P,國巨元大96售13,1.12,1.12,1.10,1.10,-0.11,-9.09,80000,4,88600,0,0,0,0,0,0,50000,30000,20000,20000
20200212,05994P,奇鋐元大96售02,,,,,0.00,0.00,0,0,0,0,0,0,0,0,0,0,0,0,0
20200212,05995P,T50正2中信9C售01,2.07,2.09,2.02,2.02,-0.09,-4.27,78000,11,159980,0,0,0,0,0,0,13000,65000,-52000,-52000
20200212,05996P,華新科群益96售03,2.10,2.13,2.08,2.13,0.00,0.00,17000,3,35780,0,0,0,0,0,0,0,17000,-17000,-17000
20200212,05997P,嘉聯益群益96售02,2.60,2.61,2.60,2.60,-0.07,-2.62,105000,3,273590,0,0,0,0,0,0,59000,105000,-46000,-46000
20200212,05998P,台積電元大97售12,1.54,1.56,1.50,1.50,-0.09,-5.66,252000,25,386530,0,0,0,0,0,0,227000,225000,2000,2000
20200212,05999P,世芯元大96售01,1.76,1.79,1.67,1.67,-0.05,-2.91,241000,27,422960,0,0,0,0,0,0,70000,171000,-101000,-101000
20200212,06000P,GIS元大96售04,3.34,3.34,3.26,3.26,-0.20,-5.78,20000,2,66000,0,0,0,0,0,0,10000,10000,0,0
20200212,06001P,樺漢台新96售01,1.43,1.43,1.43,1.43,0.00,0.00,25000,1,35750,0,0,0,0,0,0,0,25000,-25000,-25000
20200212,06002P,華通康和96售01,,,,,0.00,0.00,0,0,0,0,0,0,0,0,0,0,0,0,0
20200212,06003P,亞光康和96售02,1.07,1.07,1.07,1.07,-0.02,-1.83,81000,1,86670,0,0,0,0,0,0,81000,0,81000,81000
20200212,06004P,奇力新永豐96售02,,,,,0.00,0.00,0,0,0,0,0,0,0,0,0,0,0,0,0
20200212,06005P,晶豪科永豐96售04,,,,,0.00,0.00,0,0,0,0,0,0,0,0,0,0,0,0,0
20200212,06006P,欣興永豐96售04,1.27,1.27,1.05,1.06,-0.25,-19.08,279000,17,315020,0,0,0,0,0,0,162000,117000,45000,45000
20200212,06007P,世芯永豐96售01,1.21,1.23,1.15,1.15,-0.05,-4.17,96000,8,114660,0,0,0,0,0,0,41000,55000,-14000,-14000
20200212,06008P,燿華統一96售04,,,,,0.00,0.00,0,0,0,0,0,0,0,0,0,0,0,0,0
20200212,06009P,宏達電元富96售03,,,,,0.00,0.00,0,0,0,0,0,0,0,0,0,0,0,0,0
20200212,06010P,國泰金元富96售01,2.33,2.33,2.30,2.30,-0.14,-5.74,13000,11,30020,0,0,0,0,0,0,13000,0,13000,13000
20200212,06011P,貿聯元富96售04,,,,,0.00,0.00,0,0,0,0,0,0,0,0,0,0,0,0,0
20200212,06012P,世芯國票96售01,1.88,1.98,1.84,1.89,-0.01,-0.53,421000,13,814980,0,0,0,0,0,0,165000,255000,-90000,-90000
20200212,06013P,世芯國泰97售03,1.58,1.60,1.51,1.54,-0.01,-0.65,90000,19,141100,0,0,0,0,0,0,82000,8000,74000,74000
20200212,06014P,聯發科富邦97售02,1.20,1.20,1.05,1.07,-0.19,-15.08,117000,9,129070,0,0,0,0,0,0,0,117000,-117000,-117000
20200212,06015P,大立光富邦98售04,,,,,0.00,0.00,0,0,0,0,0,0,0,0,0,0,0,0,0
20200212,06016P,京元電凱基96售03,0.70,0.73,0.70,0.73,-0.03,-3.95,35000,3,25400,0,0,0,0,0,0,25000,10000,15000,15000
20200212,06017P,亞光凱基96售04,1.58,1.58,1.56,1.56,-0.12,-7.14,51000,2,79580,0,0,0,0,0,0,0,51000,-51000,-51000
20200212,06018P,康控凱基96售03,1.15,1.15,1.15,1.15,-0.08,-6.5,141000,1,162150,0,0,0,0,0,0,141000,0,141000,141000
20200212,06019P,緯穎凱基96售03,0.70,0.70,0.64,0.64,-0.10,-13.51,21000,4,14100,0,0,0,0,0,0,11000,10000,1000,1000
20200212,06020P,燿華元富96售04,2.53,2.53,2.53,2.53,-0.09,-3.44,6000,1,15180,0,0,0,0,0,0,0,6000,-6000,-6000
20200212,06021P,世紀鋼元富96售03,,,,,0.00,0.00,0,0,0,0,0,0,0,0,0,0,0,0,0
20200212,06022P,緯穎永豐96售03,0.75,0.78,0.75,0.78,-0.06,-7.14,97000,3,73410,0,0,0,0,0,0,75000,22000,53000,53000
20200212,06023P,超眾國票96售03,3.25,3.25,3.04,3.04,-0.21,-6.46,23000,5,72690,0,0,0,0,0,0,17000,6000,11000,11000
20200212,06024P,台郡國票97售05,1.31,1.36,1.31,1.31,-0.49,-27.22,206000,8,270380,0,0,0,0,0,0,13000,193000,-180000,-180000
20200212,06025P,臺股指元大99售02,,,,,0.00,0.00,0,0,0,0,0,0,0,0,0,0,0,0,0
20200212,06026P,華通台新97售01,,,,,0.00,0.00,0,0,0,0,0,0,0,0,0,0,0,0,0
20200212,06027P,鴻海台新96售04,1.98,1.98,1.87,1.87,0.00,0.00,3000,3,5780,0,0,0,0,0,0,0,3000,-3000,-3000
20200212,06028P,智邦台新97售01,0.75,0.83,0.70,0.77,-0.05,-6.1,493000,36,378100,0,0,0,0,0,0,219000,273000,-54000,-54000
20200212,06029P,聯發科台新96售02,2.71,2.76,2.59,2.59,-0.49,-15.91,12000,6,32310,0,0,0,0,0,0,5000,7000,-2000,-2000
20200212,06030P,友達兆豐96售02,0.67,0.73,0.67,0.73,+0.07,10.61,449000,22,309500,0,0,0,0,0,0,35000,414000,-379000,-379000
20200212,06031P,新光金兆豐96售02,1.32,1.32,1.32,1.32,-0.08,-5.71,10000,1,13200,0,0,0,0,0,0,0,10000,-10000,-10000
20200212,06032P,健策群益97售03,1.00,1.00,0.96,0.96,-0.09,-8.57,51000,2,50960,0,0,0,0,0,0,1000,50000,-49000,-49000
20200212,06033P,可成凱基96售09,0.68,0.68,0.68,0.68,-0.16,-19.05,10000,1,6800,0,0,0,0,0,0,10000,0,10000,10000
20200212,06034P,世芯凱基96售03,1.34,1.37,1.29,1.31,-0.02,-1.5,630000,5,818200,0,0,0,0,0,0,600000,20000,580000,580000
20200212,06035P,同欣電凱基96售03,0.46,0.49,0.46,0.49,0.00,0.00,13000,4,6070,0,0,0,0,0,0,0,13000,-13000,-13000
20200212,06036P,台表科凱基96售04,1.38,1.39,1.26,1.26,-0.17,-11.89,114000,40,151270,0,0,0,0,0,0,77000,37000,40000,40000
20200212,06037P,超眾國票98售02,1.98,1.98,1.98,1.98,0.00,0.00,40000,1,79200,0,0,0,0,0,0,40000,0,40000,40000
20200212,06038P,國泰金台新96售01,,,,,0.00,0.00,0,0,0,0,0,0,0,0,0,0,0,0,0
20200212,06039P,亞光台新96售03,1.71,1.71,1.62,1.62,-0.18,-10.0,300000,2,499500,0,0,0,0,0,0,300000,0,300000,300000
20200212,06040P,亞光康和96售03,,,,,0.00,0.00,0,0,0,0,0,0,0,0,0,0,0,0,0
20200212,06041P,全新永豐96售03,1.27,1.27,1.20,1.20,-0.14,-10.45,89000,6,111700,0,0,0,0,0,0,75000,27000,48000,48000
20200212,06042P,華新科永豐96售04,0.50,0.52,0.50,0.52,-0.03,-5.45,130000,2,67000,0,0,0,0,0,0,100000,130000,-30000,-30000
20200212,06043P,創意永豐96售06,0.93,0.97,0.93,0.93,+0.08,9.41,221000,13,209530,0,0,0,0,0,0,1000,220000,-219000,-219000
20200212,06044P,同欣電永豐96售03,1.21,1.29,1.21,1.29,+0.01,0.78,615000,13,762710,0,0,0,0,0,0,0,615000,-615000,-615000
20200212,06045P,臺股指永豐96售03,,,,,0.00,0.00,0,0,0,0,0,0,0,0,0,0,0,0,0
20200212,06046P,健策統一96售03,1.34,1.37,1.24,1.25,-0.17,-11.97,323000,16,416610,0,0,0,0,0,0,250000,73000,177000,177000
20200212,06047P,聯發科富邦99售04,2.57,2.57,2.53,2.53,-0.47,-15.67,10000,2,25460,0,0,0,0,0,0,0,10000,-10000,-10000
20200212,06048P,大立光富邦96售05,0.97,0.97,0.97,0.97,-0.06,-5.83,1000,1,970,0,0,0,0,0,0,1000,0,1000,1000
20200212,06049P,創意亞東97售01,,,,,0.00,0.00,0,0,0,0,0,0,0,0,0,0,0,0,0
20200212,06050P,玉晶光國票98售01,4.20,4.28,4.07,4.14,-0.38,-8.41,43000,5,179040,0,0,0,0,0,0,33000,10000,23000,23000
20200212,06051P,嘉聯益國票97售04,,,,,0.00,0.00,0,0,0,0,0,0,0,0,0,0,0,0,0
20200212,06052P,台郡國票97售06,0.92,0.92,0.92,0.92,-0.70,-43.21,15000,1,13800,0,0,0,0,0,0,15000,0,15000,15000
20200212,06053P,緯穎國票97售05,0.61,0.61,0.61,0.61,0.00,0.00,20000,1,12200,0,0,0,0,0,0,0,20000,-20000,-20000
20200212,06054P,臺股指中信9A售01,1.86,1.86,1.82,1.82,-0.10,-5.21,3000,2,5500,0,0,0,0,0,0,2000,1000,1000,1000
20200212,06055P,華通凱基97售04,,,,,0.00,0.00,0,0,0,0,0,0,0,0,0,0,0,0,0
20200212,06056P,台積電凱基98售02,0.82,0.83,0.81,0.81,-0.12,-12.9,252000,4,204660,0,0,0,0,0,0,201000,51000,150000,150000
20200212,06057P,大立光凱基98售01,3.10,3.10,3.10,3.10,0.00,0.00,3000,1,9300,0,0,0,0,0,0,3000,0,3000,3000
20200212,06058P,玉晶光凱基97售04,1.52,1.52,1.43,1.48,-0.13,-8.07,18000,5,26580,0,0,0,0,0,0,11000,7000,4000,4000
20200212,06059P,泰碩元大97售02,2.88,2.88,2.88,2.88,0.00,0.00,10000,1,28800,0,0,0,0,0,0,10000,0,10000,10000
20200212,06060P,玉晶光元大97售03,2.66,2.66,2.58,2.60,-0.20,-7.14,120000,6,313500,0,0,0,0,0,0,60000,60000,0,0
20200212,06061P,訊芯統一97售01,1.80,1.80,1.65,1.67,-0.23,-12.11,75000,22,128000,0,0,0,0,0,0,25000,50000,-25000,-25000
20200212,06062P,宏達電元富97售01,,,,,0.00,0.00,0,0,0,0,0,0,0,0,0,0,0,0,0
20200212,06063P,玉晶光元富97售01,2.70,2.70,2.51,2.55,-0.27,-9.57,319000,23,829080,0,0,0,0,0,0,70000,248000,-178000,-178000
20200212,06064P,台積電台新98售01,,,,,0.00,0.00,0,0,0,0,0,0,0,0,0,0,0,0,0
20200212,06065P,大立光台新97售01,,,,,0.00,0.00,0,0,0,0,0,0,0,0,0,0,0,0,0
20200212,06066P,群創台新98售01,,,,,0.00,0.00,0,0,0,0,0,0,0,0,0,0,0,0,0
20200212,06067P,華新科康和97售01,0.72,0.72,0.72,0.72,0.00,0.00,100000,1,72000,0,0,0,0,0,0,100000,100000,0,0
20200212,06068P,玉晶光康和97售01,1.05,1.05,0.99,1.00,-0.08,-7.41,130000,10,131500,0,0,0,0,0,0,10000,120000,-110000,-110000
20200212,06069P,台積電永豐97售01,1.44,1.45,1.40,1.40,-0.10,-6.67,241000,7,338650,0,0,0,0,0,0,0,241000,-241000,-241000
20200212,06070P,漢唐永豐97售01,1.01,1.01,1.01,1.01,-0.06,-5.61,18000,1,18180,0,0,0,0,0,0,18000,0,18000,18000
20200212,06071P,大立光永豐97售01,2.11,2.11,1.94,1.94,-0.16,-7.62,125000,5,249260,0,0,0,0,0,0,108000,17000,91000,91000
20200212,06072P,牧德永豐97售01,,,,,0.00,0.00,0,0,0,0,0,0,0,0,0,0,0,0,0
20200212,06073P,健策永豐97售01,1.26,1.26,1.26,1.26,-0.18,-12.5,47000,2,59220,0,0,0,0,0,0,0,47000,-47000,-47000
20200212,06074P,台積電凱基98售04,,,,,0.00,0.00,0,0,0,0,0,0,0,0,0,0,0,0,0
20200212,06075P,智邦凱基97售02,0.71,0.76,0.63,0.75,+0.03,4.17,220000,9,149980,0,0,0,0,0,0,39000,180000,-141000,-141000
20200212,06076P,大立光凱基98售03,1.49,1.49,1.49,1.49,-0.18,-10.78,100000,1,149000,0,0,0,0,0,0,0,100000,-100000,-100000
20200212,06077P,GIS凱基97售02,,,,,0.00,0.00,0,0,0,0,0,0,0,0,0,0,0,0,0
20200212,06078P,臺股指凱基9A售01,2.19,2.19,2.04,2.04,-0.19,-8.52,415000,59,858650,0,0,0,0,0,0,0,415000,-415000,-415000
20200212,06079P,燿華群益98售02,,,,,0.00,0.00,0,0,0,0,0,0,0,0,0,0,0,0,0
20200212,06080P,景碩群益98售02,1.42,1.45,1.23,1.33,-0.12,-8.28,76000,16,106270,0,0,0,0,0,0,31000,45000,-14000,-14000
20200212,06081P,深中小元大97售02,0.58,0.58,0.54,0.54,-0.05,-8.47,320000,5,184200,0,0,0,0,0,0,280000,0,280000,280000
20200212,06082P,華通統一98售01,1.97,1.97,1.70,1.70,-0.31,-15.42,57000,7,108440,0,0,0,0,0,0,36000,27000,9000,9000
20200212,06083P,華通統一98售02,1.65,1.65,1.42,1.45,-0.27,-15.7,46000,7,69370,0,0,0,0,0,0,11000,35000,-24000,-24000
20200212,06084P,宏達電元富97售02,,,,,0.00,0.00,0,0,0,0,0,0,0,0,0,0,0,0,0
20200212,06085P,義隆台新97售01,,,,,0.00,0.00,0,0,0,0,0,0,0,0,0,0,0,0,0
20200212,06086P,台積電康和97售01,,,,,0.00,0.00,0,0,0,0,0,0,0,0,0,0,0,0,0
20200212,06087P,國巨永豐97售01,,,,,0.00,0.00,0,0,0,0,0,0,0,0,0,0,0,0,0
20200212,06088P,建準永豐97售01,1.50,1.50,1.50,1.50,-0.02,-1.32,10000,1,15000,0,0,0,0,0,0,0,10000,-10000,-10000
20200212,06089P,矽創永豐97售01,1.16,1.16,1.03,1.03,-0.22,-17.6,186000,7,199010,0,0,0,0,0,0,166000,20000,146000,146000
20200212,06090P,旺宏統一97售06,1.66,1.73,1.66,1.71,-0.01,-0.58,310000,105,528700,0,0,0,0,0,0,290000,20000,270000,270000
20200212,06091P,華新科統一97售01,1.47,1.49,1.47,1.49,-0.03,-1.97,327000,5,481370,0,0,0,0,0,0,77000,250000,-173000,-173000
20200212,06092P,嘉聯益統一97售01,1.28,1.28,1.28,1.28,-0.03,-2.29,20000,2,25600,0,0,0,0,0,0,0,20000,-20000,-20000
20200212,06093P,華通元富97售03,2.79,2.79,2.76,2.76,-1.00,-26.6,21000,3,58360,0,0,0,0,0,0,0,21000,-21000,-21000
20200212,06094P,台達電中信97售01,1.08,1.10,1.04,1.04,-0.09,-7.96,192000,7,209760,0,0,0,0,0,0,92000,100000,-8000,-8000
20200212,06095P,燿華永豐97售01,2.35,2.35,2.35,2.35,-0.10,-4.08,8000,1,18800,0,0,0,0,0,0,8000,8000,0,0
20200212,06096P,全新永豐97售02,1.31,1.31,1.25,1.25,-0.15,-10.71,90000,5,116000,0,0,0,0,0,0,50000,40000,10000,10000
20200212,06097P,茂林永豐97售01,0.74,0.74,0.74,0.74,-0.08,-9.76,1000,1,740,0,0,0,0,0,0,1000,0,1000,1000
20200212,06098P,T50反1日盛97售02,,,,,0.00,0.00,0,0,0,0,0,0,0,0,0,0,0,0,0
20200212,06099P,鴻海日盛97售03,2.18,2.18,2.07,2.07,-0.60,-22.47,30000,7,63550,0,0,0,0,0,0,15000,15000,0,0
20200212,06100P,台積電日盛97售03,1.23,1.24,1.17,1.17,-0.18,-13.33,146000,9,172780,0,0,0,0,0,0,130000,116000,14000,14000
20200212,06101P,聯發科日盛97售03,2.34,2.34,2.34,2.34,0.00,0.00,40000,1,93600,0,0,0,0,0,0,40000,0,40000,40000
20200212,06102P,智邦凱基97售03,0.79,0.89,0.77,0.89,-0.05,-5.32,161000,14,135060,0,0,0,0,0,0,118000,38000,80000,80000
20200212,06103P,漢唐凱基97售02,,,,,0.00,0.00,0,0,0,0,0,0,0,0,0,0,0,0,0
20200212,06104P,大立光凱基97售04,2.51,2.51,2.39,2.39,-0.50,-17.3,144000,6,356060,0,0,0,0,0,0,74000,70000,4000,4000
20200212,06105P,國巨國票98售02,3.34,3.34,3.34,3.34,-0.20,-5.65,5000,1,16700,0,0,0,0,0,0,5000,0,5000,5000
20200212,06106P,國巨群益97售02,2.70,2.70,2.65,2.65,-0.19,-6.69,51000,4,135720,0,0,0,0,0,0,0,51000,-51000,-51000
20200212,06107P,美律群益98售02,2.59,2.59,2.53,2.53,-0.20,-7.33,30000,3,77100,0,0,0,0,0,0,0,30000,-30000,-30000
20200212,06108P,奇力新群益97售05,1.51,1.51,1.51,1.51,-0.01,-0.66,15000,2,22650,0,0,0,0,0,0,0,15000,-15000,-15000
20200212,06109P,華新科群益97售05,2.04,2.07,2.04,2.07,-0.06,-2.82,87000,8,178280,0,0,0,0,0,0,66000,31000,35000,35000
20200212,06110P,國巨國泰98售02,1.98,2.00,1.93,1.93,-0.14,-6.76,539000,25,1065380,0,0,0,0,0,0,499000,180000,319000,319000
20200212,06111P,上銀兆豐98售01,1.84,1.88,1.84,1.88,-0.03,-1.57,154000,9,284630,0,0,0,0,0,0,12000,142000,-130000,-130000
20200212,06112P,台積電兆豐97售01,2.54,2.54,2.43,2.43,-0.29,-10.66,30000,2,75100,0,0,0,0,0,0,20000,10000,10000,10000
20200212,06113P,台積電群益97售01,3.72,3.80,3.71,3.71,-0.29,-7.25,633000,16,2388030,0,0,0,0,0,0,254000,379000,-125000,-125000
20200212,06114P,台積電統一97售03,,,,,0.00,0.00,0,0,0,0,0,0,0,0,0,0,0,0,0
20200212,06115P,台積電統一97售04,1.31,1.31,1.31,1.31,+0.06,4.8,1000,1,1310,0,0,0,0,0,0,0,1000,-1000,-1000
20200212,06116P,臺股指日盛97售01,2.48,2.48,2.48,2.48,-0.37,-12.98,4000,1,9920,0,0,0,0,0,0,0,4000,-4000,-4000
20200212,06117P,臺股指日盛97售02,3.73,3.73,3.61,3.61,-0.42,-10.42,11000,4,40070,0,0,0,0,0,0,2000,9000,-7000,-7000
20200212,06118P,上証2X凱基98售03,3.00,3.00,2.96,2.96,-0.07,-2.31,77000,3,227980,0,0,0,0,0,0,75000,2000,73000,73000
20200212,06119P,大立光凱基98售04,,,,,0.00,0.00,0,0,0,0,0,0,0,0,0,0,0,0,0
20200212,06120P,大立光凱基98售05,3.25,3.25,3.17,3.17,-0.39,-10.96,87000,6,277570,0,0,0,0,0,0,27000,60000,-33000,-33000
20200212,06121P,同欣電凱基97售02,0.32,0.32,0.32,0.32,0.00,0.00,4000,4,1280,0,0,0,0,0,0,0,4000,-4000,-4000
20200212,06122P,亞光元大98售01,1.51,1.51,1.43,1.43,-0.10,-6.54,155000,3,225750,0,0,0,0,0,0,100000,55000,45000,45000
20200212,06123P,玉晶光元大97售04,1.26,1.26,1.20,1.21,-0.10,-7.63,413000,21,504390,0,0,0,0,0,0,90000,301000,-211000,-211000
20200212,06124P,超眾元大97售03,1.39,1.40,1.31,1.32,-0.07,-5.04,83000,6,113500,0,0,0,0,0,0,60000,23000,37000,37000
20200212,06125P,楠梓電元富99售01,0.95,0.95,0.91,0.91,-0.06,-6.19,155000,3,144350,0,0,0,0,0,0,40000,115000,-75000,-75000
20200212,06126P,凌陽元富97售02,,,,,0.00,0.00,0,0,0,0,0,0,0,0,0,0,0,0,0
20200212,06127P,泰碩元富97售01,2.29,2.29,2.29,2.29,-0.01,-0.43,2000,1,4580,0,0,0,0,0,0,2000,0,2000,2000
20200212,06128P,玉晶光元富97售05,,,,,0.00,0.00,0,0,0,0,0,0,0,0,0,0,0,0,0
20200212,06129P,玉晶光元富97售06,3.00,3.00,2.86,2.91,-0.23,-7.32,166000,13,484340,0,0,0,0,0,0,30000,136000,-106000,-106000
20200212,06130P,玉晶光元富97售07,,,,,0.00,0.00,0,0,0,0,0,0,0,0,0,0,0,0,0
20200212,06131P,京鼎元富97售02,1.07,1.08,1.00,1.02,-0.17,-14.29,248000,13,263170,0,0,0,0,0,0,242000,6000,236000,236000
20200212,06132P,正文元富97售01,,,,,0.00,0.00,0,0,0,0,0,0,0,0,0,0,0,0,0
20200212,06133P,帆宣元富97售02,1.44,1.44,1.44,1.44,0.00,0.00,16000,1,23040,0,0,0,0,0,0,0,16000,-16000,-16000
20200212,06134P,緯穎元富97售03,0.45,0.45,0.45,0.45,-0.04,-8.16,32000,3,14400,0,0,0,0,0,0,2000,30000,-28000,-28000
20200212,06135P,志超元富97售01,,,,,0.00,0.00,0,0,0,0,0,0,0,0,0,0,0,0,0
20200212,06136P,華新科國泰99售02,2.13,2.19,2.10,2.14,-0.09,-4.04,793000,30,1700180,0,0,0,0,0,0,475000,682000,-207000,-207000
20200212,06137P,玉晶光永豐97售04,1.13,1.13,1.10,1.10,-0.08,-6.78,31000,3,34710,0,0,0,0,0,0,20000,11000,9000,9000
20200212,06138P,台積電中信99售01,0.85,0.85,0.85,0.85,-0.05,-5.56,3000,1,2550,0,0,0,0,0,0,3000,0,3000,3000
20200212,06139P,台積電中信99售02,0.69,0.69,0.66,0.66,-0.04,-5.71,267000,6,181330,0,0,0,0,0,0,10000,257000,-247000,-247000
20200212,06140P,華新科群益97售06,2.39,2.41,2.39,2.41,-0.15,-5.86,32000,2,76680,0,0,0,0,0,0,32000,10000,22000,22000
20200212,06141P,大立光日盛97售01,,,,,0.00,0.00,0,0,0,0,0,0,0,0,0,0,0,0,0
20200212,06142P,台虹康和97售02,,,,,0.00,0.00,0,0,0,0,0,0,0,0,0,0,0,0,0
20200212,06143P,鴻海永豐97售02,1.70,1.70,1.50,1.50,-0.29,-16.2,61000,10,97200,0,0,0,0,0,0,2000,59000,-57000,-57000
20200212,06144P,台光電永豐97售01,1.22,1.22,1.22,1.22,-0.17,-12.23,3000,1,3660,0,0,0,0,0,0,0,3000,-3000,-3000
20200212,06145P,華新科永豐97售02,1.22,1.22,1.22,1.22,-0.06,-4.69,30000,1,36600,0,0,0,0,0,0,0,30000,-30000,-30000
20200212,06146P,S&P反1元大97售03,,,,,0.00,0.00,0,0,0,0,0,0,0,0,0,0,0,0,0
20200212,06147P,國巨元大97售05,1.32,1.32,1.32,1.32,-0.06,-4.35,50000,1,66000,0,0,0,0,0,0,50000,50000,0,0
20200212,06148P,台積電元大97售17,2.99,3.01,2.91,2.91,-0.21,-6.73,200000,6,593500,0,0,0,0,0,0,200000,200000,0,0
20200212,06149P,台積電元大97售18,3.62,3.65,3.59,3.59,-0.19,-5.03,232000,10,844100,0,0,0,0,0,0,222000,231000,-9000,-9000
20200212,06150P,奇力新元大97售06,1.06,1.07,1.05,1.05,-0.02,-1.87,95000,5,100660,0,0,0,0,0,0,0,95000,-95000,-95000
20200212,06151P,華新科元大97售07,1.07,1.07,1.03,1.05,-0.03,-2.78,301000,16,317400,0,0,0,0,0,0,31000,250000,-219000,-219000
20200212,06152P,玉晶光元大98售06,1.49,1.49,1.43,1.44,-0.09,-5.88,528000,17,778940,0,0,0,0,0,0,421000,83000,338000,338000
20200212,06153P,健策元大97售04,0.83,0.83,0.74,0.74,-0.13,-14.94,110000,6,88040,0,0,0,0,0,0,40000,70000,-30000,-30000
20200212,06154P,超眾元大98售01,1.60,1.60,1.51,1.51,-0.08,-5.03,242000,13,376710,0,0,0,0,0,0,130000,112000,18000,18000
20200212,06155P,智邦統一97售02,1.81,1.88,1.70,1.88,-0.05,-2.59,208000,11,362590,0,0,0,0,0,0,183000,25000,158000,158000
20200212,06156P,大立光統一97售05,,,,,0.00,0.00,0,0,0,0,0,0,0,0,0,0,0,0,0
20200212,06157P,聯鈞統一97售02,2.02,2.02,1.92,1.92,-0.28,-12.73,10000,2,19700,0,0,0,0,0,0,5000,5000,0,0
20200212,06158P,玉晶光元富97售08,3.01,3.04,2.91,2.94,-0.19,-6.07,66000,11,196600,0,0,0,0,0,0,0,66000,-66000,-66000
20200212,06159P,牧德元富97售02,1.41,1.42,1.40,1.42,+0.03,2.16,100000,3,141000,0,0,0,0,0,0,0,100000,-100000,-100000
20200212,06160P,台達電群益97售01,2.30,2.34,2.27,2.28,-0.12,-5.0,112000,9,257110,0,0,0,0,0,0,84000,28000,56000,56000
20200212,06161P,聯發科群益97售03,4.00,4.00,3.77,3.77,-0.59,-13.53,30000,4,114800,0,0,0,0,0,0,15000,15000,0,0
20200212,06162P,大立光群益97售02,0.93,0.93,0.93,0.93,-0.13,-12.26,10000,1,9300,0,0,0,0,0,0,0,10000,-10000,-10000
20200212,06163P,聯詠群益97售01,1.97,2.03,1.97,2.00,-0.32,-13.79,78000,8,155850,0,0,0,0,0,0,0,78000,-78000,-78000
20200212,06164P,臺股指凱基97售04,3.18,3.18,3.07,3.07,-0.38,-11.01,35000,6,109700,0,0,0,0,0,0,0,35000,-35000,-35000
20200212,06165P,臺股指凱基9A售03,1.94,1.94,1.84,1.84,-0.16,-8.0,25000,7,46500,0,0,0,0,0,0,0,25000,-25000,-25000
20200212,06166P,大立光國票98售01,1.78,1.78,1.78,1.78,-0.25,-12.32,10000,1,17800,0,0,0,0,0,0,0,10000,-10000,-10000
20200212,06167P,欣興國票97售05,1.49,1.51,1.37,1.37,-0.32,-18.93,12000,4,17540,0,0,0,0,0,0,0,12000,-12000,-12000
20200212,06168P,台表科國票97售06,,,,,0.00,0.00,0,0,0,0,0,0,0,0,0,0,0,0,0
20200212,06169P,華新科元富97售02,1.56,1.61,1.56,1.58,-0.07,-4.24,56000,7,88740,0,0,0,0,0,0,26000,30000,-4000,-4000
20200212,06170P,禾伸堂元富97售02,1.11,1.13,1.10,1.13,+0.01,0.89,254000,5,282350,0,0,0,0,0,0,199000,55000,144000,144000
20200212,06171P,台積電統一97售06,2.59,2.59,2.46,2.46,-0.24,-8.89,30000,3,75500,0,0,0,0,0,0,0,30000,-30000,-30000
20200212,06172P,台虹永豐97售02,,,,,0.00,0.00,0,0,0,0,0,0,0,0,0,0,0,0,0
20200212,06173P,華通元大97售02,,,,,0.00,0.00,0,0,0,0,0,0,0,0,0,0,0,0,0
20200212,06174P,國巨元大97售07,1.78,1.80,1.74,1.74,-0.09,-4.92,167000,22,296520,0,0,0,0,0,0,25000,165000,-140000,-140000
20200212,06175P,台積電元大97售21,4.31,4.31,4.31,4.31,-0.12,-2.71,30000,1,129300,0,0,0,0,0,0,30000,0,30000,30000
20200212,06176P,台積電元大97售22,,,,,0.00,0.00,0,0,0,0,0,0,0,0,0,0,0,0,0
20200212,06177P,玉晶光元大98售07,,,,,0.00,0.00,0,0,0,0,0,0,0,0,0,0,0,0,0
20200212,06178P,大立光第一99售01,,,,,0.00,0.00,0,0,0,0,0,0,0,0,0,0,0,0,0
20200212,06179P,國巨群益97售04,2.11,2.11,2.04,2.04,-0.24,-10.53,20000,2,41500,0,0,0,0,0,0,10000,10000,0,0
20200212,06180P,禾伸堂群益97售01,1.41,1.43,1.40,1.42,-0.02,-1.39,85000,8,120180,0,0,0,0,0,0,43000,42000,1000,1000
20200212,06181P,國巨中信97售02,0.56,0.56,0.54,0.55,-0.04,-6.78,380000,17,210630,0,0,0,0,0,0,150000,230000,-80000,-80000
20200212,06182P,群創兆豐97售03,0.49,0.49,0.49,0.49,-0.01,-2.0,10000,1,4900,0,0,0,0,0,0,10000,0,10000,10000
20200212,06183P,大立光元大97售05,1.79,1.80,1.79,1.80,-0.03,-1.64,55000,2,98500,0,0,0,0,0,0,50000,5000,45000,45000
20200212,06184P,大立光元大97售06,,,,,0.00,0.00,0,0,0,0,0,0,0,0,0,0,0,0,0
20200212,06185P,台表科元大97售05,,,,,0.00,0.00,0,0,0,0,0,0,0,0,0,0,0,0,0
20200212,06186P,鴻海統一97售02,3.72,3.78,3.66,3.66,0.00,0.00,99000,6,370400,0,0,0,0,0,0,96000,99000,-3000,-3000
20200212,06187P,國巨統一97售05,,,,,0.00,0.00,0,0,0,0,0,0,0,0,0,0,0,0,0
20200212,06188P,大立光元富97售01,,,,,0.00,0.00,0,0,0,0,0,0,0,0,0,0,0,0,0
20200212,06189P,華新科永豐97售03,0.76,0.81,0.76,0.80,-0.05,-5.88,252000,6,201400,0,0,0,0,0,0,70000,182000,-112000,-112000
20200212,06190P,玉晶光永豐97售05,1.59,1.59,1.52,1.54,-0.10,-6.1,54000,9,82970,0,0,0,0,0,0,51000,3000,48000,48000
20200212,06191P,鴻海群益97售03,,,,,0.00,0.00,0,0,0,0,0,0,0,0,0,0,0,0,0
20200212,06192P,高股息中信98售01,1.62,1.62,1.62,1.62,0.00,0.00,3000,1,4860,0,0,0,0,0,0,0,3000,-3000,-3000
20200212,06193P,台積電元富97售04,1.42,1.44,1.37,1.39,-0.11,-7.33,2884000,31,4103160,0,0,0,0,0,0,1839000,1172000,667000,667000
20200212,06194P,台積電元富97售05,1.26,1.26,1.22,1.22,-0.17,-12.23,2373000,16,2957360,0,0,0,0,0,0,1189000,1064000,125000,125000
20200212,06195P,台積電元富97售06,0.76,0.77,0.71,0.73,-0.10,-12.05,2767000,26,2114780,0,0,0,0,0,0,1884000,883000,1001000,1001000
20200212,06196P,元上證元大97售01,2.16,2.16,2.12,2.12,-0.03,-1.4,10000,2,21400,0,0,0,0,0,0,0,10000,-10000,-10000
20200212,06197P,國巨元大97售08,,,,,0.00,0.00,0,0,0,0,0,0,0,0,0,0,0,0,0
20200212,06198P,台積電元大98售06,1.56,1.58,1.51,1.51,-0.10,-6.21,1111000,38,1725050,0,0,0,0,0,0,1030000,665000,365000,365000
20200212,06199P,聯發科元大97售17,,,,,0.00,0.00,0,0,0,0,0,0,0,0,0,0,0,0,0
20200212,06200P,聯發科元大97售18,,,,,0.00,0.00,0,0,0,0,0,0,0,0,0,0,0,0,0
20200212,06201P,可成元大97售01,1.82,1.82,1.79,1.79,-0.20,-10.05,15000,3,27000,0,0,0,0,0,0,3000,12000,-9000,-9000
20200212,06202P,大立光元大98售06,2.94,2.94,2.74,2.74,-0.24,-8.05,70000,2,204800,0,0,0,0,0,0,65000,5000,60000,60000
20200212,06203P,奇力新中信98售02,0.68,0.68,0.67,0.67,-0.02,-2.9,85000,3,57300,0,0,0,0,0,0,55000,30000,25000,25000
20200212,06204P,鴻海群益97售04,1.68,1.68,1.37,1.37,-0.43,-23.89,88000,7,134190,0,0,0,0,0,0,5000,83000,-78000,-78000
20200212,06205P,台積電群益97售03,1.03,1.03,1.01,1.01,-0.09,-8.18,20000,2,20400,0,0,0,0,0,0,0,20000,-20000,-20000
20200212,06206P,台積電凱基97售11,1.54,1.54,1.50,1.50,-0.10,-6.25,263000,10,395380,0,0,0,0,0,0,63000,263000,-200000,-200000
20200212,06207P,聯發科凱基97售07,2.06,2.06,2.02,2.02,-0.66,-24.63,6000,6,12200,0,0,0,0,0,0,6000,0,6000,6000
20200212,06208P,台郡凱基97售03,1.08,1.08,1.08,1.08,-0.48,-30.77,5000,1,5400,0,0,0,0,0,0,0,5000,-5000,-5000
20200212,06209P,旺宏統一97售07,2.06,2.11,2.04,2.10,-0.01,-0.47,160000,32,333020,0,0,0,0,0,0,66000,94000,-28000,-28000
20200212,06210P,元油反元大97售01,,,,,0.00,0.00,0,0,0,0,0,0,0,0,0,0,0,0,0
20200212,06211P,鴻海元大98售04,2.04,2.04,1.86,1.86,-0.35,-15.84,253000,19,488900,0,0,0,0,0,0,165000,188000,-23000,-23000
20200212,06212P,華新科元大97售11,1.24,1.28,1.23,1.25,-0.04,-3.1,428000,27,536880,0,0,0,0,0,0,296000,232000,64000,64000
20200212,06213P,大立光元大98售07,3.25,3.25,3.25,3.25,-0.04,-1.22,62000,1,201500,0,0,0,0,0,0,62000,0,62000,62000
20200212,06214P,國巨國票98售04,1.87,1.92,1.82,1.82,-0.22,-10.78,238000,16,448630,0,0,0,0,0,0,80000,158000,-78000,-78000
20200212,06215P,康控永豐97售02,1.70,1.70,1.64,1.65,-0.12,-6.78,114000,3,193100,0,0,0,0,0,0,102000,12000,90000,90000
20200212,06216P,上銀元富97售03,1.97,1.97,1.97,1.97,-0.03,-1.5,27000,23,53190,0,0,0,0,0,0,27000,0,27000,27000
20200212,06217P,鴻海元富97售05,2.38,2.38,2.16,2.16,-0.37,-14.62,679000,17,1537080,0,0,0,0,0,0,75000,604000,-529000,-529000
20200212,06218P,鴻海元富97售06,2.42,2.42,2.15,2.15,-0.52,-19.48,123000,10,284950,0,0,0,0,0,0,45000,78000,-33000,-33000
20200212,06219P,國巨元富97售05,,,,,0.00,0.00,0,0,0,0,0,0,0,0,0,0,0,0,0
20200212,06220P,廣宇元富97售02,,,,,0.00,0.00,0,0,0,0,0,0,0,0,0,0,0,0,0
20200212,06222P,致茂元富97售02,0.95,0.95,0.88,0.88,-0.16,-15.38,155000,5,145570,0,0,0,0,0,0,115000,40000,75000,75000
20200212,06223P,漢唐元富97售02,1.27,1.31,1.27,1.31,-0.10,-7.09,11000,2,14170,0,0,0,0,0,0,0,11000,-11000,-11000
20200212,06224P,可成元富97售02,,,,,0.00,0.00,0,0,0,0,0,0,0,0,0,0,0,0,0
20200212,06225P,華新科元富97售04,1.14,1.20,1.14,1.20,-0.03,-2.44,602000,14,715160,0,0,0,0,0,0,538000,54000,484000,484000
20200212,06226P,聯發科麥證97售03,2.18,2.18,2.10,2.10,-0.29,-12.13,35000,2,74300,0,35000,-35000,0,0,0,0,35000,-35000,-35000
20200212,06227P,大立光群益97售04,3.05,3.05,2.86,2.86,-0.30,-9.49,18000,3,52740,0,0,0,0,0,0,4000,14000,-10000,-10000
20200212,06228P,亞德客凱基97售04,0.86,0.86,0.83,0.85,-0.05,-5.56,75000,6,62530,0,0,0,0,0,0,65000,10000,55000,55000
20200212,06229P,欣興凱基97售07,1.20,1.20,0.98,1.01,-0.22,-17.89,734000,67,767650,0,0,0,0,0,0,134000,516000,-382000,-382000
20200212,06230P,亞德客永豐97售03,1.42,1.42,1.38,1.38,-0.04,-2.82,484000,5,682880,0,0,0,0,0,0,474000,484000,-10000,-10000
20200212,06231P,台積電永豐97售05,0.95,0.95,0.91,0.91,-0.11,-10.78,76000,6,70280,0,0,0,0,0,0,28000,56000,-28000,-28000
20200212,06232P,智易永豐97售01,,,,,0.00,0.00,0,0,0,0,0,0,0,0,0,0,0,0,0
20200212,06233P,訊芯永豐97售03,1.77,1.77,1.77,1.77,0.00,0.00,4000,1,7080,0,0,0,0,0,0,4000,0,4000,4000
20200212,06234P,亞德客元大97售02,1.46,1.46,1.39,1.39,-0.04,-2.8,372000,7,538680,0,0,0,0,0,0,372000,350000,22000,22000
20200212,06235P,國巨元大97售12,0.99,1.00,0.99,0.99,-0.06,-5.71,45000,5,44600,0,0,0,0,0,0,0,45000,-45000,-45000
20200212,06236P,台積電元大97售25,,,,,0.00,0.00,0,0,0,0,0,0,0,0,0,0,0,0,0
20200212,06237P,台積電元大97售26,4.44,4.45,4.44,4.44,0.00,0.00,160000,5,710500,0,0,0,0,0,0,70000,100000,-30000,-30000
20200212,06238P,台積電元大98售07,4.68,4.68,4.59,4.59,-0.33,-6.71,220000,3,1026800,0,0,0,0,0,0,200000,20000,180000,180000
20200212,06239P,奇力新元大97售08,2.17,2.17,2.17,2.17,-0.09,-3.98,8000,1,17360,0,0,0,0,0,0,0,8000,-8000,-8000
20200212,06240P,奇力新元富97售03,0.95,0.95,0.93,0.93,-0.02,-2.11,25000,3,23650,0,0,0,0,0,0,0,25000,-25000,-25000
20200212,06241P,大立光元富9A售01,2.11,2.11,2.07,2.07,-0.14,-6.33,30000,4,62750,0,0,0,0,0,0,0,30000,-30000,-30000
20200212,06242P,大立光元富9A售02,2.87,2.87,2.87,2.87,-0.01,-0.35,6000,1,17220,0,0,0,0,0,0,6000,0,6000,6000
20200212,06243P,亞光元富97售01,,,,,0.00,0.00,0,0,0,0,0,0,0,0,0,0,0,0,0
20200212,06244P,智易元富97售02,,,,,0.00,0.00,0,0,0,0,0,0,0,0,0,0,0,0,0
20200212,06245P,健策元富97售03,0.94,0.96,0.89,0.89,-0.13,-12.75,569000,13,524120,0,0,0,0,0,0,400000,169000,231000,231000
20200212,06246P,茂林元富97售03,1.54,1.59,1.52,1.57,-0.02,-1.26,116000,8,180960,0,0,0,0,0,0,110000,95000,15000,15000
20200212,06247P,同欣電元富97售02,1.77,1.81,1.67,1.81,+0.01,0.56,175000,33,305570,0,0,0,0,0,0,22000,153000,-131000,-131000
20200212,06248P,國巨統一97售07,2.06,2.06,2.06,2.06,-0.10,-4.63,49000,2,100940,0,0,0,0,0,0,12000,37000,-25000,-25000
20200212,06249P,億光統一97售02,2.15,2.15,2.15,2.15,-0.07,-3.15,35000,2,75250,0,0,0,0,0,0,35000,0,35000,35000
20200212,06250P,臺股指永昌97售02,,,,,0.00,0.00,0,0,0,0,0,0,0,0,0,0,0,0,0
20200212,06251P,臺股指永昌97售03,4.51,4.51,4.20,4.20,-0.61,-12.68,6000,3,26240,0,0,0,0,0,0,0,6000,-6000,-6000
20200212,06252P,臺股指兆豐97售02,,,,,0.00,0.00,0,0,0,0,0,0,0,0,0,0,0,0,0
20200212,06253P,臺股指兆豐97售03,,,,,0.00,0.00,0,0,0,0,0,0,0,0,0,0,0,0,0
20200212,06254P,臺股指群益97售07,1.23,1.23,1.23,1.23,-0.17,-12.14,50000,1,61500,0,0,0,0,0,0,0,50000,-50000,-50000
20200212,06255P,臺股指群益97售08,1.61,1.61,1.50,1.50,0.00,0.00,48000,2,76730,0,0,0,0,0,0,43000,5000,38000,38000
20200212,06256P,臺股指群益97售09,1.39,1.39,1.30,1.32,-0.16,-10.81,75000,8,98280,0,0,0,0,0,0,1000,74000,-73000,-73000
20200212,06257P,臺股指群益97售10,2.68,2.68,2.47,2.53,-0.26,-9.32,200000,6,520500,0,0,0,0,0,0,0,200000,-200000,-200000
20200212,06258P,臺股指群益97售11,3.08,3.08,2.91,2.91,0.00,0.00,15000,2,44500,0,0,0,0,0,0,10000,5000,5000,5000
20200212,06259P,臺股指群益97售12,3.45,3.45,3.18,3.18,-0.40,-11.17,33000,5,108400,0,0,0,0,0,0,6000,27000,-21000,-21000
20200212,06260P,臺股指群益97售13,4.03,4.03,3.80,3.80,-0.41,-9.74,26000,10,102150,0,0,0,0,0,0,4000,22000,-18000,-18000
20200212,06261P,上銀凱基97售03,1.06,1.06,1.06,1.06,-0.02,-1.85,34000,1,36040,0,0,0,0,0,0,0,34000,-34000,-34000
20200212,06262P,國巨凱基97售07,,,,,0.00,0.00,0,0,0,0,0,0,0,0,0,0,0,0,0
20200212,06263P,燿華凱基97售04,,,,,0.00,0.00,0,0,0,0,0,0,0,0,0,0,0,0,0
20200212,06264P,友達凱基98售06,0.79,0.79,0.79,0.79,+0.07,9.72,44000,3,34760,0,0,0,0,0,0,24000,20000,4000,4000
20200212,06265P,美律凱基97售01,1.26,1.26,1.19,1.19,-0.24,-16.78,15000,3,18120,0,0,0,0,0,0,1000,14000,-13000,-13000
20200212,06266P,大立光凱基97售11,,,,,0.00,0.00,0,0,0,0,0,0,0,0,0,0,0,0,0
20200212,06267P,大立光凱基97售12,,,,,0.00,0.00,0,0,0,0,0,0,0,0,0,0,0,0,0
20200212,06268P,聯詠凱基97售02,1.29,1.29,1.27,1.27,0.00,0.00,20000,4,25600,0,0,0,0,0,0,0,20000,-20000,-20000
20200212,06269P,群創凱基98售10,1.19,1.24,1.19,1.24,+0.02,1.64,20000,3,24200,0,0,0,0,0,0,0,20000,-20000,-20000
20200212,06270P,致伸凱基97售03,,,,,0.00,0.00,0,0,0,0,0,0,0,0,0,0,0,0,0
20200212,06271P,彩晶凱基97售01,1.11,1.11,1.11,1.11,-0.01,-0.89,25000,1,27750,0,0,0,0,0,0,25000,0,25000,25000
20200212,06272P,台郡凱基97售04,0.55,0.55,0.53,0.53,-0.39,-42.39,40000,3,21700,0,0,0,0,0,0,0,40000,-40000,-40000
20200212,06273P,台表科凱基97售04,1.48,1.48,1.48,1.48,-0.03,-1.99,16000,1,23680,0,0,0,0,0,0,16000,0,16000,16000
20200212,06274P,臺股指凱基97售06,,,,,0.00,0.00,0,0,0,0,0,0,0,0,0,0,0,0,0
20200212,06275P,臺股指凱基97售07,3.56,3.56,3.56,3.56,0.00,0.00,190000,1,676400,0,0,0,0,0,0,0,190000,-190000,-190000
20200212,06276P,臺股指凱基97售08,,,,,0.00,0.00,0,0,0,0,0,0,0,0,0,0,0,0,0
20200212,06277P,臺股指凱基97售09,3.64,3.64,3.64,3.64,0.00,0.00,194000,2,706160,0,0,0,0,0,0,0,194000,-194000,-194000
20200212,06278P,臺股指凱基97售10,4.04,4.04,3.83,3.83,-0.35,-8.37,26000,4,103480,0,0,0,0,0,0,0,26000,-26000,-26000
20200212,06279P,臺股指凱基97售11,3.71,3.71,3.71,3.71,0.00,0.00,193000,1,716030,0,0,0,0,0,0,0,193000,-193000,-193000
20200212,06280P,臺股指凱基97售12,3.38,3.38,3.38,3.38,-0.43,-11.29,89000,1,300820,0,0,0,0,0,0,0,89000,-89000,-89000
20200212,06281P,臺股指凱基97售13,4.23,4.23,3.94,3.94,-0.46,-10.45,13000,9,52960,0,0,0,0,0,0,0,13000,-13000,-13000
20200212,06282P,聯鈞永豐97售02,1.80,1.80,1.80,1.80,0.00,0.00,6000,1,10800,0,0,0,0,0,0,6000,0,6000,6000
20200212,06283P,祥碩永豐97售01,0.66,0.67,0.57,0.58,-0.13,-18.31,637000,28,397960,0,0,0,0,0,0,120000,517000,-397000,-397000
20200212,06284P,台積電國票98售03,,,,,0.00,0.00,0,0,0,0,0,0,0,0,0,0,0,0,0
20200212,06285P,台積電國票98售04,2.62,2.62,2.56,2.56,-0.24,-8.57,149000,3,388400,0,0,0,0,0,0,116000,33000,83000,83000
20200212,06286P,世芯國票97售02,1.78,1.83,1.71,1.76,-0.01,-0.56,625000,27,1109040,0,0,0,0,0,0,434000,191000,243000,243000
20200212,06287P,臺股指國票97售01,,,,,0.00,0.00,0,0,0,0,0,0,0,0,0,0,0,0,0
20200212,06288P,臺股指國票97售02,,,,,0.00,0.00,0,0,0,0,0,0,0,0,0,0,0,0,0
20200212,06289P,臺股指國票97售03,4.18,4.18,4.11,4.11,0.00,0.00,25000,2,103800,0,0,0,0,0,0,0,25000,-25000,-25000
20200212,06290P,臺股指國票97售04,,,,,0.00,0.00,0,0,0,0,0,0,0,0,0,0,0,0,0
20200212,06291P,臺股指國票97售05,,,,,0.00,0.00,0,0,0,0,0,0,0,0,0,0,0,0,0
20200212,06292P,臺股指國票97售06,4.75,4.75,4.75,4.75,-0.60,-11.21,5000,1,23750,0,0,0,0,0,0,5000,0,5000,5000
20200212,06293P,臺股指國票97售07,,,,,0.00,0.00,0,0,0,0,0,0,0,0,0,0,0,0,0
20200212,06294P,臺股指國票97售08,9.75,9.75,9.25,9.25,-1.15,-11.06,9000,5,83950,0,0,0,0,0,0,5000,4000,1000,1000
20200212,06295P,國巨元大97售14,,,,,0.00,0.00,0,0,0,0,0,0,0,0,0,0,0,0,0
20200212,06296P,燿華元大98售01,1.19,1.19,1.19,1.19,0.00,0.00,8000,1,9520,0,0,0,0,0,0,8000,0,8000,8000
20200212,06297P,美律元大97售01,,,,,0.00,0.00,0,0,0,0,0,0,0,0,0,0,0,0,0
20200212,06298P,聯發科元大97售20,,,,,0.00,0.00,0,0,0,0,0,0,0,0,0,0,0,0,0
20200212,06299P,可成元大97售04,,,,,0.00,0.00,0,0,0,0,0,0,0,0,0,0,0,0,0
20200212,06300P,緯穎元大97售04,1.17,1.17,1.11,1.11,-0.06,-5.13,198000,7,223760,0,0,0,0,0,0,38000,160000,-122000,-122000
20200212,06301P,臺股指元大97售04,3.16,3.16,2.96,2.97,-0.30,-9.17,202000,19,609340,0,0,0,0,0,0,64000,138000,-74000,-74000
20200212,06302P,臺股指元大97售06,,,,,0.00,0.00,0,0,0,0,0,0,0,0,0,0,0,0,0
20200212,06303P,臺股指元大97售09,,,,,0.00,0.00,0,0,0,0,0,0,0,0,0,0,0,0,0
20200212,06304P,臺股指元大97售10,2.87,2.87,2.87,2.87,0.00,0.00,8000,1,22960,0,0,0,0,0,0,0,8000,-8000,-8000
20200212,06305P,臺股指元大97售11,2.70,2.76,2.61,2.61,-0.28,-9.69,24000,9,64650,0,0,0,0,0,0,12000,12000,0,0
20200212,06306P,臺股指元大97售12,3.30,3.30,3.02,3.02,0.00,0.00,25000,3,79000,0,0,0,0,0,0,5000,20000,-15000,-15000
20200212,06307P,聚陽元富97售02,0.87,0.87,0.87,0.87,-0.02,-2.25,63000,4,54810,0,0,0,0,0,0,60000,0,60000,60000
20200212,06308P,國巨元富97售06,1.34,1.34,1.33,1.34,-0.08,-5.63,81000,4,108430,0,0,0,0,0,0,0,81000,-81000,-81000
20200212,06309P,光罩元富97售03,1.70,1.70,1.70,1.70,-0.10,-5.56,1000,1,1700,0,0,0,0,0,0,1000,0,1000,1000
20200212,06310P,精元元富97售02,,,,,0.00,0.00,0,0,0,0,0,0,0,0,0,0,0,0,0
20200212,06311P,嘉聯益元富97售02,1.19,1.20,1.19,1.20,0.00,0.00,42000,3,50300,0,0,0,0,0,0,30000,42000,-12000,-12000
20200212,06312P,樺漢元富97售02,,,,,0.00,0.00,0,0,0,0,0,0,0,0,0,0,0,0,0
20200212,06313P,訊芯元富97售01,1.42,1.42,1.33,1.36,-0.09,-6.21,840000,72,1139880,0,0,0,0,0,0,184000,656000,-472000,-472000
20200212,06314P,GIS元富97售02,1.09,1.09,1.07,1.07,-0.08,-6.96,33000,4,35510,0,0,0,0,0,0,0,33000,-33000,-33000
20200212,06315P,臺股指元富97售02,,,,,0.00,0.00,0,0,0,0,0,0,0,0,0,0,0,0,0
20200212,06316P,臺股指元富97售03,2.10,2.10,2.02,2.02,0.00,0.00,30000,4,61450,0,0,0,0,0,0,0,30000,-30000,-30000
20200212,06317P,臺股指元富97售04,2.08,2.08,2.03,2.03,-0.16,-7.31,15000,2,30700,0,0,0,0,0,0,10000,5000,5000,5000
20200212,06318P,臺股指元富97售05,1.93,1.93,1.85,1.85,0.00,0.00,15000,2,28550,0,0,0,0,0,0,0,15000,-15000,-15000
20200212,06319P,臺股指元富97售06,,,,,0.00,0.00,0,0,0,0,0,0,0,0,0,0,0,0,0
20200212,06320P,上銀統一97售04,1.34,1.36,1.32,1.36,-0.03,-2.16,149000,25,199880,0,0,0,0,0,0,24000,125000,-101000,-101000
20200212,06321P,台積電統一98售03,2.10,2.11,2.08,2.08,-0.26,-11.11,344000,6,723080,0,0,0,0,0,0,108000,236000,-128000,-128000
20200212,06322P,超眾統一97售04,2.97,2.97,2.90,2.90,-0.13,-4.29,156000,5,457480,0,0,0,0,0,0,88000,68000,20000,20000
20200212,06323P,台郡統一97售01,1.06,1.07,1.06,1.06,-0.43,-28.86,17000,3,18040,0,0,0,0,0,0,10000,5000,5000,5000
20200212,06324P,TXFI0永昌99售02,,,,,0.00,0.00,0,0,0,0,0,0,0,0,0,0,0,0,0
20200212,06325P,TXFI0永昌99售03,,,,,0.00,0.00,0,0,0,0,0,0,0,0,0,0,0,0,0
20200212,06326P,鴻海中信01售01,1.05,1.05,0.94,0.94,-0.12,-11.32,105000,23,105370,0,0,0,0,0,0,20000,85000,-65000,-65000
20200212,06327P,台積電中信01售01,1.16,1.16,1.13,1.13,-0.07,-5.83,21000,3,24040,0,0,0,0,0,0,10000,11000,-1000,-1000
20200212,06328P,台積電中信01售02,0.88,0.89,0.87,0.87,-0.03,-3.33,49000,11,42880,0,0,0,0,0,0,9000,39000,-30000,-30000
20200212,06329P,大立光兆豐97售04,1.24,1.24,1.24,1.24,0.00,0.00,10000,1,12400,0,0,0,0,0,0,0,10000,-10000,-10000
20200212,06330P,南亞科群益97售03,2.32,2.32,2.32,2.32,-0.16,-6.45,25000,2,58000,0,0,0,0,0,0,22000,3000,19000,19000
20200212,06331P,南亞科群益97售04,1.67,1.67,1.67,1.67,+0.02,1.21,3000,1,5010,0,0,0,0,0,0,3000,0,3000,3000
20200212,06332P,世紀鋼群益98售01,1.70,1.70,1.70,1.70,-0.03,-1.73,10000,1,17000,0,0,0,0,0,0,0,10000,-10000,-10000
20200212,06333P,臺股指群益9C售02,4.90,4.90,4.76,4.76,-0.39,-7.57,23000,4,112450,0,0,0,0,0,0,0,23000,-23000,-23000
20200212,06334P,臺股指群益9C售03,5.45,5.45,5.20,5.20,-0.45,-7.96,310000,3,1624000,0,0,0,0,0,0,30000,280000,-250000,-250000
20200212,06335P,台積電麥證97售02,1.60,1.60,1.60,1.60,-0.10,-5.88,11000,2,17600,0,11000,-11000,0,0,0,0,11000,-11000,-11000
20200212,06336P,鴻海元大98售05,1.82,1.82,1.62,1.62,-0.39,-19.4,55000,7,94890,0,0,0,0,0,0,20000,35000,-15000,-15000
20200212,06337P,祥碩元大97售05,1.24,1.25,1.08,1.08,-0.23,-17.56,638000,21,747060,0,0,0,0,0,0,477000,578000,-101000,-101000
20200212,06338P,亞德客統一97售02,1.85,1.85,1.76,1.79,0.00,0.00,427000,15,767950,0,0,0,0,0,0,73000,354000,-281000,-281000
20200212,06339P,上銀統一97售06,1.67,1.73,1.67,1.73,-0.01,-0.57,51000,5,86880,0,0,0,0,0,0,2000,49000,-47000,-47000
20200212,06340P,鴻海統一98售06,2.85,2.89,2.65,2.65,-0.35,-11.67,867000,21,2382360,0,0,0,0,0,0,850000,867000,-17000,-17000
20200212,06341P,大立光統一97售08,,,,,0.00,0.00,0,0,0,0,0,0,0,0,0,0,0,0,0
20200212,06342P,世芯統一98售01,1.35,1.35,1.35,1.35,+0.02,1.5,4000,1,5400,0,0,0,0,0,0,0,4000,-4000,-4000
20200212,06343P,臺股指統一98售01,,,,,0.00,0.00,0,0,0,0,0,0,0,0,0,0,0,0,0
20200212,06344P,臺股指統一99售03,,,,,0.00,0.00,0,0,0,0,0,0,0,0,0,0,0,0,0
20200212,06345P,臺股指統一9A售01,2.78,2.78,2.72,2.72,-0.21,-7.17,5000,2,13720,0,0,0,0,0,0,3000,2000,1000,1000
20200212,06346P,聯鈞元富97售02,,,,,0.00,0.00,0,0,0,0,0,0,0,0,0,0,0,0,0
20200212,06347P,祥碩元富97售02,0.70,0.70,0.58,0.65,-0.10,-13.33,1435000,37,862660,0,0,0,0,0,0,848000,474000,374000,374000
20200212,06348P,鈺齊元富97售02,1.23,1.23,1.19,1.19,-0.06,-4.8,5000,2,6030,0,0,0,0,0,0,5000,0,5000,5000
20200212,06349P,臺股指台新99售01,,,,,0.00,0.00,0,0,0,0,0,0,0,0,0,0,0,0,0
20200212,06350P,臺股指台新99售02,1.90,1.90,1.90,1.90,0.00,0.00,1000,1,1900,0,0,0,0,0,0,0,1000,-1000,-1000
20200212,06351P,臺股指台新99售03,,,,,0.00,0.00,0,0,0,0,0,0,0,0,0,0,0,0,0
20200212,06352P,臺股指富邦99售02,1.32,1.32,1.32,1.32,0.00,0.00,10000,1,13200,0,0,0,0,0,0,0,10000,-10000,-10000
20200212,06353P,電子類富邦99售02,0.69,0.69,0.63,0.63,-0.08,-11.27,166000,11,107790,0,0,0,0,0,0,100000,66000,34000,34000
20200212,06354P,大立光永豐97售04,2.85,2.85,2.65,2.65,-0.19,-6.69,48000,6,130380,0,0,0,0,0,0,16000,32000,-16000,-16000
20200212,06355P,聯茂永豐97售02,1.35,1.35,1.27,1.31,-0.19,-12.67,385000,9,494650,0,0,0,0,0,0,30000,355000,-325000,-325000
20200212,06356P,啟碁永豐97售01,2.13,2.13,2.11,2.11,-0.06,-2.76,2000,2,4240,0,0,0,0,0,0,0,2000,-2000,-2000
20200212,06357P,臺股指永豐97售03,,,,,0.00,0.00,0,0,0,0,0,0,0,0,0,0,0,0,0
20200212,06358P,力成中信97售02,0.65,0.66,0.62,0.62,-0.10,-13.89,337000,15,216800,0,0,0,0,0,0,145000,182000,-37000,-37000
20200212,06359P,上銀群益97售03,,,,,0.00,0.00,0,0,0,0,0,0,0,0,0,0,0,0,0
20200212,06360P,台積電群益97售05,,,,,0.00,0.00,0,0,0,0,0,0,0,0,0,0,0,0,0
20200212,06361P,聯發科群益97售06,1.34,1.38,1.32,1.32,-0.30,-18.52,364000,6,490580,0,0,0,0,0,0,335000,29000,306000,306000
20200212,06362P,臺股指麥證97售01,,,,,0.00,0.00,0,0,0,0,0,0,0,0,0,0,0,0,0
20200212,06363P,臺股指麥證97售02,5.70,5.70,5.65,5.65,0.00,0.00,101000,2,570700,101000,0,101000,0,0,0,101000,0,101000,101000
20200212,06364P,鴻海凱基97售08,1.69,1.69,1.56,1.56,-0.23,-12.85,116000,8,186870,0,0,0,0,0,0,50000,116000,-66000,-66000
20200212,06365P,鴻海凱基97售09,1.97,1.97,1.85,1.85,-0.29,-13.55,80000,2,151600,0,0,0,0,0,0,50000,80000,-30000,-30000
20200212,06366P,鴻海凱基97售10,2.29,2.29,2.25,2.27,-0.43,-15.93,35000,11,79390,0,0,0,0,0,0,30000,35000,-5000,-5000
20200212,06367P,台積電凱基97售14,1.39,1.42,1.35,1.35,-0.12,-8.16,116000,7,160280,0,0,0,0,0,0,113000,109000,4000,4000
20200212,06368P,台積電凱基97售15,4.20,4.20,4.16,4.16,-0.36,-7.96,6000,2,25160,0,0,0,0,0,0,0,6000,-6000,-6000
20200212,06369P,台積電凱基97售16,2.67,2.67,2.67,2.67,0.00,0.00,25000,3,66750,0,0,0,0,0,0,0,25000,-25000,-25000
20200212,06370P,貿聯凱基97售03,1.32,1.32,1.29,1.29,-0.03,-2.27,29000,2,37980,0,0,0,0,0,0,19000,10000,9000,9000
20200212,06371P,茂林國票98售04,2.31,2.31,2.22,2.26,-0.07,-3.0,68000,5,154880,0,0,0,0,0,0,5000,63000,-58000,-58000
20200212,06372P,聯發科元大97售21,3.73,3.74,3.71,3.71,0.00,0.00,27000,3,100770,0,0,0,0,0,0,27000,25000,2000,2000
20200212,06373P,聯發科元大97售22,,,,,0.00,0.00,0,0,0,0,0,0,0,0,0,0,0,0,0
20200212,06374P,台表科元大97售06,,,,,0.00,0.00,0,0,0,0,0,0,0,0,0,0,0,0,0
20200212,06375P,矽力元大97售06,1.38,1.43,1.34,1.36,-0.15,-9.93,101000,5,141550,0,0,0,0,0,0,99000,2000,97000,97000
20200212,06376P,上銀統一99售01,2.32,2.36,2.32,2.36,-0.07,-2.88,49000,6,114160,0,0,0,0,0,0,0,49000,-49000,-49000
20200212,06377P,華通統一97售04,2.37,2.37,2.37,2.37,-0.22,-8.49,19000,1,45030,0,0,0,0,0,0,0,19000,-19000,-19000
20200212,06378P,國巨統一97售08,2.10,2.14,2.06,2.06,-0.17,-7.62,98000,8,206880,0,0,0,0,0,0,52000,46000,6000,6000
20200212,06379P,群創統一97售05,0.66,0.66,0.65,0.65,-0.01,-1.52,145000,4,95100,0,0,0,0,0,0,60000,85000,-25000,-25000
20200212,06380P,臺股指統一98售02,,,,,0.00,0.00,0,0,0,0,0,0,0,0,0,0,0,0,0
20200212,06381P,臺股指統一98售03,,,,,0.00,0.00,0,0,0,0,0,0,0,0,0,0,0,0,0
20200212,06382P,大毅元富97售02,1.01,1.06,1.01,1.03,0.00,0.00,445000,24,457290,0,0,0,0,0,0,364000,81000,283000,283000
20200212,06383P,聯茂元富97售01,0.95,0.95,0.81,0.87,-0.16,-15.53,274000,16,234710,0,0,0,0,0,0,104000,170000,-66000,-66000
20200212,06384P,訊芯元富97售03,2.11,2.11,2.09,2.09,-0.16,-7.11,22000,3,46120,0,0,0,0,0,0,12000,10000,2000,2000
20200212,06385P,聯發科永豐97售02,1.67,1.67,1.67,1.67,-0.36,-17.73,10000,1,16700,0,0,0,0,0,0,0,10000,-10000,-10000
20200212,06386P,欣興永豐97售03,2.24,2.24,1.94,1.95,-0.30,-13.33,227000,18,461630,0,0,0,0,0,0,27000,200000,-173000,-173000
20200212,06387P,緯穎永豐97售02,1.44,1.48,1.42,1.42,-0.11,-7.19,82000,4,117960,0,0,0,0,0,0,40000,42000,-2000,-2000
20200212,06388P,鴻海兆豐97售04,2.13,2.13,1.95,1.95,0.00,0.00,15000,3,30650,0,0,0,0,0,0,0,15000,-15000,-15000
20200212,06389P,聯發科兆豐97售01,1.80,1.80,1.72,1.72,0.00,0.00,16000,4,28240,0,0,0,0,0,0,0,16000,-16000,-16000
20200212,06390P,美律國票97售03,2.40,2.41,2.40,2.41,-0.17,-6.59,19000,2,45690,0,0,0,0,0,0,9000,10000,-1000,-1000
20200212,06391P,上銀中信97售03,,,,,0.00,0.00,0,0,0,0,0,0,0,0,0,0,0,0,0
20200212,06392P,T50反1元大9A售01,,,,,0.00,0.00,0,0,0,0,0,0,0,0,0,0,0,0,0
20200212,06393P,台積電元大97售27,3.89,3.89,3.89,3.89,0.00,0.00,4000,1,15560,0,0,0,0,0,0,4000,0,4000,4000
20200212,06394P,台積電元大97售28,4.24,4.24,4.24,4.24,0.00,0.00,30000,1,127200,0,0,0,0,0,0,0,30000,-30000,-30000
20200212,06395P,台積電元大97售29,4.55,4.60,4.50,4.50,-0.39,-7.98,210000,10,955250,0,0,0,0,0,0,110000,100000,10000,10000
20200212,06396P,新日興康和97售01,,,,,0.00,0.00,0,0,0,0,0,0,0,0,0,0,0,0,0
20200212,06397P,T50反1凱基9A售03,,,,,0.00,0.00,0,0,0,0,0,0,0,0,0,0,0,0,0
20200212,06398P,禾伸堂凱基97售02,0.84,0.84,0.84,0.84,-0.01,-1.18,10000,1,8400,0,0,0,0,0,0,10000,0,10000,10000
20200212,06399P,台表科凱基97售05,1.34,1.34,1.30,1.30,-0.18,-12.16,60000,40,78790,0,0,0,0,0,0,60000,0,60000,60000
20200212,06400P,鴻海元富97售12,,,,,0.00,0.00,0,0,0,0,0,0,0,0,0,0,0,0,0
20200212,06401P,鴻海元富97售13,,,,,0.00,0.00,0,0,0,0,0,0,0,0,0,0,0,0,0
20200212,06402P,鴻海元富97售14,,,,,0.00,0.00,0,0,0,0,0,0,0,0,0,0,0,0,0
20200212,06403P,鴻海元富97售15,2.80,2.80,2.69,2.69,-0.36,-11.8,260000,2,703800,0,0,0,0,0,0,40000,220000,-180000,-180000
20200212,06404P,鴻海元富97售16,,,,,0.00,0.00,0,0,0,0,0,0,0,0,0,0,0,0,0
20200212,06405P,億光元富97售02,1.65,1.65,1.60,1.63,-0.03,-1.81,60000,4,98710,0,0,0,0,0,0,5000,55000,-50000,-50000
20200212,06406P,可成元富97售04,2.27,2.27,2.27,2.27,-0.13,-5.42,10000,1,22700,0,0,0,0,0,0,10000,0,10000,10000
20200212,06407P,創意元富97售02,2.09,2.18,2.00,2.05,+0.07,3.54,53000,26,108650,0,0,0,0,0,0,18000,35000,-17000,-17000
20200212,06408P,聯茂元富97售02,1.09,1.09,0.94,0.94,0.00,0.00,50000,5,49700,0,0,0,0,0,0,20000,50000,-30000,-30000
20200212,06409P,康友元富97售03,2.69,2.69,2.69,2.69,0.00,0.00,2000,1,5380,0,0,0,0,0,0,2000,0,2000,2000
20200212,06410P,祥碩統一97售01,0.66,0.66,0.55,0.55,-0.17,-23.61,825000,43,478790,0,0,0,0,0,0,30000,785000,-755000,-755000
20200212,06411P,晶相光永豐97售03,1.24,1.28,1.24,1.28,0.00,0.00,45000,3,56800,0,0,0,0,0,0,0,45000,-45000,-45000
20200212,06412P,南亞科日盛97售01,,,,,0.00,0.00,0,0,0,0,0,0,0,0,0,0,0,0,0
20200212,06413P,聯發科凱基97售11,,,,,0.00,0.00,0,0,0,0,0,0,0,0,0,0,0,0,0
20200212,06414P,矽力凱基97售03,,,,,0.00,0.00,0,0,0,0,0,0,0,0,0,0,0,0,0
20200212,06415P,台積電群益97售07,3.87,3.87,3.80,3.80,-0.32,-7.77,30000,4,115200,0,0,0,0,0,0,10000,20000,-10000,-10000
20200212,06416P,大立光群益97售06,1.78,1.79,1.69,1.69,-0.36,-17.56,60000,5,105100,0,0,0,0,0,0,0,60000,-60000,-60000
20200212,06417P,台積電兆豐97售03,1.14,1.14,1.12,1.12,-0.09,-7.44,35000,4,39600,0,0,0,0,0,0,0,35000,-35000,-35000
20200212,06418P,T50反1統一9A售02,,,,,0.00,0.00,0,0,0,0,0,0,0,0,0,0,0,0,0
20200212,06419P,國巨統一97售09,1.27,1.27,1.24,1.24,-0.10,-7.46,40000,3,50200,0,0,0,0,0,0,0,40000,-40000,-40000
20200212,06420P,大立光統一98售06,1.41,1.41,1.41,1.41,-0.11,-7.24,15000,2,21150,0,0,0,0,0,0,0,15000,-15000,-15000
20200212,06421P,嘉澤統一97售02,1.94,2.03,1.90,2.01,+0.03,1.52,372000,14,732600,0,0,0,0,0,0,260000,112000,148000,148000
20200212,06422P,勤誠統一98售01,1.49,1.50,1.43,1.43,-0.01,-0.69,196000,8,291120,0,0,0,0,0,0,15000,181000,-166000,-166000
20200212,06423P,亞光台新97售01,1.45,1.45,1.45,1.45,-0.08,-5.23,63000,1,91350,0,0,0,0,0,0,63000,0,63000,63000
20200212,06424P,大成鋼永豐97售01,,,,,0.00,0.00,0,0,0,0,0,0,0,0,0,0,0,0,0
20200212,06425P,TPK永豐97售02,,,,,0.00,0.00,0,0,0,0,0,0,0,0,0,0,0,0,0
20200212,06426P,T50正2元大9B售01,0.50,0.50,0.48,0.49,-0.02,-3.92,215000,19,105170,0,0,0,0,0,0,54000,161000,-107000,-107000
20200212,06427P,鴻海元大97售13,2.96,2.97,2.89,2.89,-0.25,-7.96,60000,3,175550,0,0,0,0,0,0,55000,5000,50000,50000
20200212,06428P,國巨元大97售17,1.57,1.63,1.55,1.55,-0.07,-4.32,97000,11,153190,0,0,0,0,0,0,17000,92000,-75000,-75000
20200212,06429P,大立光元大97售15,,,,,0.00,0.00,0,0,0,0,0,0,0,0,0,0,0,0,0
20200212,06430P,大立光元大97售16,,,,,0.00,0.00,0,0,0,0,0,0,0,0,0,0,0,0,0
20200212,06431P,新日興元大97售05,2.86,2.86,2.86,2.86,-0.15,-4.98,1000,1,2860,0,0,0,0,0,0,0,1000,-1000,-1000
20200212,06432P,上銀群益98售01,2.38,2.39,2.38,2.39,-0.09,-3.63,42000,4,100170,0,0,0,0,0,0,0,42000,-42000,-42000
20200212,06433P,大立光群益99售01,,,,,0.00,0.00,0,0,0,0,0,0,0,0,0,0,0,0,0
20200212,06434P,超眾群益98售02,1.54,1.54,1.50,1.50,-0.06,-3.85,23000,4,35240,0,0,0,0,0,0,11000,12000,-1000,-1000
20200212,06435P,臺股指群益98售02,3.06,3.06,3.06,3.06,-0.38,-11.05,3000,1,9180,0,0,0,0,0,0,0,3000,-3000,-3000
20200212,06436P,台光電國票98售04,2.90,2.90,2.69,2.69,-0.31,-10.33,20000,3,56200,0,0,0,0,0,0,8000,12000,-4000,-4000
20200212,06437P,玉晶光國票99售01,7.15,7.15,6.90,6.95,-0.50,-6.71,8000,4,56550,0,0,0,0,0,0,0,8000,-8000,-8000
20200212,06438P,玉晶光國票99售02,3.06,3.06,3.04,3.04,-0.18,-5.59,30000,2,91400,0,0,0,0,0,0,0,30000,-30000,-30000
20200212,06439P,上銀凱基98售02,1.39,1.41,1.39,1.41,0.00,0.00,39000,4,54530,0,0,0,0,0,0,0,39000,-39000,-39000
20200212,06440P,台積電凱基98售07,1.84,1.84,1.75,1.75,-0.12,-6.42,1178000,10,2124960,0,0,0,0,0,0,1175000,78000,1097000,1097000
20200212,06441P,台積電凱基98售08,,,,,0.00,0.00,0,0,0,0,0,0,0,0,0,0,0,0,0
20200212,06442P,台灣50群益92售01,0.01,0.01,0.01,0.01,0.00,0.00,5000,5,50,0,0,0,0,0,0,0,0,0,0
20200212,06443P,台積電凱基99售01,,,,,0.00,0.00,0,0,0,0,0,0,0,0,0,0,0,0,0
20200212,06444P,大立光凱基98售08,,,,,0.00,0.00,0,0,0,0,0,0,0,0,0,0,0,0,0
20200212,06445P,大立光凱基98售09,2.14,2.14,2.14,2.14,-0.14,-6.14,4000,1,8560,0,0,0,0,0,0,0,4000,-4000,-4000
20200212,06446P,大立光凱基98售10,6.65,6.65,6.65,6.65,-0.75,-10.14,2000,1,13300,0,0,0,0,0,0,0,2000,-2000,-2000
20200212,06447P,上銀元大98售01,,,,,0.00,0.00,0,0,0,0,0,0,0,0,0,0,0,0,0
20200212,06448P,華通元大99售01,1.60,1.60,1.42,1.42,-0.23,-13.94,180000,14,267950,0,0,0,0,0,0,0,180000,-180000,-180000
20200212,06449P,台積電元大98售09,4.29,4.29,4.20,4.20,-0.26,-5.83,4000,2,16890,0,0,0,0,0,0,3000,1000,2000,2000
20200212,06450P,聯發科元大98售03,3.08,3.08,2.92,2.95,-0.33,-10.06,20000,5,59620,0,0,0,0,0,0,0,20000,-20000,-20000
20200212,06451P,聯發科元大98售04,,,,,0.00,0.00,0,0,0,0,0,0,0,0,0,0,0,0,0
20200212,06452P,大立光元大98售08,4.18,4.18,3.94,3.94,-0.30,-7.08,123000,9,494730,0,0,0,0,0,0,112000,11000,101000,101000
20200212,06453P,群創元大9B售02,1.20,1.22,1.19,1.22,0.00,0.00,120000,5,144480,0,0,0,0,0,0,64000,56000,8000,8000
20200212,06454P,緯穎元大98售04,1.15,1.19,1.10,1.10,-0.05,-4.35,895000,16,1012450,0,0,0,0,0,0,555000,245000,310000,310000
20200212,06455P,上銀統一99售03,3.34,3.39,3.34,3.39,0.00,0.00,145000,6,488550,0,0,0,0,0,0,0,145000,-145000,-145000
20200212,06456P,聯發科統一98售03,1.38,1.38,1.38,1.38,0.00,0.00,100000,1,138000,0,0,0,0,0,0,0,100000,-100000,-100000
20200212,06457P,玉晶光統一98售02,,,,,0.00,0.00,0,0,0,0,0,0,0,0,0,0,0,0,0
20200212,06458P,玉晶光統一9A售02,1.93,1.93,1.93,1.93,0.00,0.00,10000,1,19300,0,0,0,0,0,0,10000,0,10000,10000
20200212,06459P,亞德客元富98售01,2.91,2.91,2.80,2.83,-0.05,-1.74,104000,8,299440,0,0,0,0,0,0,91000,63000,28000,28000
20200212,06460P,亞德客元富98售02,2.40,2.41,2.38,2.38,-0.18,-7.03,50000,3,119840,0,0,0,0,0,0,50000,50000,0,0
20200212,06461P,玉晶光國泰9A售01,1.97,1.97,1.90,1.92,0.00,0.00,178000,13,340760,0,0,0,0,0,0,5000,173000,-168000,-168000
20200212,06462P,鴻海富邦98售01,1.84,1.84,1.81,1.81,0.00,0.00,5000,2,9140,0,0,0,0,0,0,0,5000,-5000,-5000
20200212,06463P,大立光富邦9A售01,,,,,0.00,0.00,0,0,0,0,0,0,0,0,0,0,0,0,0
20200212,06464P,台光電亞東99售01,,,,,0.00,0.00,0,0,0,0,0,0,0,0,0,0,0,0,0
20200212,06465P,國巨統一98售04,,,,,0.00,0.00,0,0,0,0,0,0,0,0,0,0,0,0,0
20200212,06466P,台積電統一9B售01,1.12,1.12,1.07,1.07,-0.05,-4.46,65000,6,70500,0,0,0,0,0,0,0,65000,-65000,-65000
20200212,06467P,旺宏統一98售01,1.54,1.54,1.54,1.54,-0.01,-0.65,20000,1,30800,0,0,0,0,0,0,0,20000,-20000,-20000
20200212,06468P,華新科統一98售02,1.32,1.34,1.32,1.34,-0.06,-4.29,52000,3,69240,0,0,0,0,0,0,22000,30000,-8000,-8000
20200212,06469P,臺股指凱基99售09,,,,,0.00,0.00,0,0,0,0,0,0,0,0,0,0,0,0,0
20200212,06470P,臺股指凱基99售10,,,,,0.00,0.00,0,0,0,0,0,0,0,0,0,0,0,0,0
20200212,06471P,臺股指凱基99售11,1.17,1.17,1.13,1.13,-0.10,-8.13,16000,4,18550,0,0,0,0,0,0,0,16000,-16000,-16000
20200212,06472P,道瓊銀元大98售03,,,,,0.00,0.00,0,0,0,0,0,0,0,0,0,0,0,0,0
20200212,06473P,鴻海元大99售03,2.21,2.21,2.09,2.09,-0.38,-15.38,50000,4,107100,0,0,0,0,0,0,5000,45000,-40000,-40000
20200212,06474P,鴻海富邦98售03,0.93,0.94,0.92,0.92,-0.09,-8.91,30000,3,27900,0,0,0,0,0,0,0,30000,-30000,-30000
20200212,06475P,牧德永豐98售03,1.23,1.25,1.23,1.25,+0.06,5.04,116000,4,143400,0,0,0,0,0,0,0,116000,-116000,-116000
20200212,06476P,臺股指永豐98售01,0.89,0.89,0.83,0.83,-0.09,-9.78,115000,14,99880,0,0,0,0,0,0,60000,55000,5000,5000
20200212,06477P,緯穎國票99售02,1.26,1.26,1.20,1.20,-0.07,-5.51,22000,18,26860,0,0,0,0,0,0,0,22000,-22000,-22000
20200212,06478P,臺股指日盛9A售01,,,,,0.00,0.00,0,0,0,0,0,0,0,0,0,0,0,0,0
20200212,06479P,聯發科中信99售02,0.68,0.69,0.68,0.69,0.00,0.00,41000,3,28280,0,0,0,0,0,0,0,41000,-41000,-41000
20200212,06480P,上銀凱基98售04,2.27,2.27,2.27,2.27,-0.07,-2.99,45000,26,102150,0,0,0,0,0,0,45000,0,45000,45000
20200212,06481P,台積電凱基98售12,2.86,2.86,2.86,2.86,0.00,0.00,370000,5,1058200,0,0,0,0,0,0,0,370000,-370000,-370000
20200212,06482P,台積電凱基98售13,,,,,0.00,0.00,0,0,0,0,0,0,0,0,0,0,0,0,0
20200212,06483P,聯發科凱基98售10,,,,,0.00,0.00,0,0,0,0,0,0,0,0,0,0,0,0,0
20200212,06484P,聯發科凱基98售11,,,,,0.00,0.00,0,0,0,0,0,0,0,0,0,0,0,0,0
20200212,06485P,玉晶光群益9A售02,3.09,3.09,2.96,3.04,-0.18,-5.59,41000,4,124840,0,0,0,0,0,0,10000,31000,-21000,-21000
20200212,06486P,麗豐元大98售02,1.34,1.34,1.34,1.34,-0.02,-1.47,10000,1,13400,0,0,0,0,0,0,0,10000,-10000,-10000
20200212,06487P,聯發科統一99售02,,,,,0.00,0.00,0,0,0,0,0,0,0,0,0,0,0,0,0
20200212,06488P,台積電元富98售05,1.36,1.38,1.31,1.31,-0.15,-10.27,930000,11,1265300,0,0,0,0,0,0,390000,540000,-150000,-150000
20200212,06489P,台積電元富98售06,,,,,0.00,0.00,0,0,0,0,0,0,0,0,0,0,0,0,0
20200212,06490P,鴻海富邦99售02,0.67,0.68,0.60,0.60,-0.11,-15.49,476000,28,308900,0,0,0,0,0,0,144000,327000,-183000,-183000
20200212,06491P,台積電富邦99售02,,,,,0.00,0.00,0,0,0,0,0,0,0,0,0,0,0,0,0
20200212,06492P,上銀永豐98售01,1.08,1.11,1.08,1.11,-0.02,-1.77,81000,3,87960,0,0,0,0,0,0,0,81000,-81000,-81000
20200212,06493P,聯發科永豐98售02,1.10,1.10,1.04,1.04,-0.25,-19.38,201000,3,215970,0,0,0,0,0,0,99000,102000,-3000,-3000
20200212,06494P,鴻海永昌98售03,,,,,0.00,0.00,0,0,0,0,0,0,0,0,0,0,0,0,0
20200212,06495P,華新科亞東9A售01,,,,,0.00,0.00,0,0,0,0,0,0,0,0,0,0,0,0,0
20200212,06496P,台灣50日盛98售01,1.63,1.64,1.50,1.53,-0.19,-11.05,1496000,93,2382230,0,0,0,0,0,0,407000,1239000,-832000,-832000
20200212,06497P,大立光凱基98售11,,,,,0.00,0.00,0,0,0,0,0,0,0,0,0,0,0,0,0
20200212,06498P,臺股指元大9A售03,1.83,1.84,1.80,1.81,-0.17,-8.59,120000,4,218400,0,0,0,0,0,0,40000,80000,-40000,-40000
20200212,06499P,臺股指元大9A售04,1.88,1.88,1.73,1.76,-0.14,-7.37,97000,21,173460,0,0,0,0,0,0,10000,87000,-77000,-77000
20200212,06500P,臺股指元大9A售05,1.63,1.63,1.63,1.63,-0.15,-8.43,10000,1,16300,0,0,0,0,0,0,0,10000,-10000,-10000
20200212,06501P,臺股指元大9A售06,2.00,2.00,2.00,2.00,0.00,0.00,32000,1,64000,0,0,0,0,0,0,32000,0,32000,32000
20200212,06502P,A50中信98售01,0.72,0.72,0.72,0.72,0.00,0.00,30000,1,21600,0,0,0,0,0,0,30000,0,30000,30000
20200212,06503P,臺股指中信9A售02,0.77,0.77,0.75,0.75,-0.06,-7.41,47000,4,35350,0,0,0,0,0,0,0,47000,-47000,-47000
20200212,06504P,麗豐國票99售02,,,,,0.00,0.00,0,0,0,0,0,0,0,0,0,0,0,0,0
20200212,06505P,康控國票99售02,2.16,2.16,2.16,2.16,-0.09,-4.0,10000,1,21600,0,0,0,0,0,0,10000,0,10000,10000
20200212,06506P,台郡國票99售02,0.60,0.60,0.59,0.59,-0.26,-30.59,16000,4,9500,0,0,0,0,0,0,2000,14000,-12000,-12000
20200212,06507P,台表科國票99售01,,,,,0.00,0.00,0,0,0,0,0,0,0,0,0,0,0,0,0
20200212,06508P,台灣50統一98售01,0.72,0.72,0.65,0.65,-0.10,-13.33,783000,30,554360,0,0,0,0,0,0,62000,721000,-659000,-659000
20200212,06509P,鴻海群益98售03,2.14,2.14,1.97,1.97,-0.34,-14.72,48000,9,99030,0,0,0,0,0,0,0,48000,-48000,-48000
20200212,06510P,燿華永豐98售03,,,,,0.00,0.00,0,0,0,0,0,0,0,0,0,0,0,0,0
20200212,06511P,元油2X中信9B售01,,,,,0.00,0.00,0,0,0,0,0,0,0,0,0,0,0,0,0
20200212,06512P,元油2X凱基9B售01,,,,,0.00,0.00,0,0,0,0,0,0,0,0,0,0,0,0,0
20200212,06513P,鴻海凱基98售10,1.14,1.14,1.09,1.09,-0.15,-12.1,30000,2,33450,0,0,0,0,0,0,0,30000,-30000,-30000
20200212,06514P,國巨凱基98售05,,,,,0.00,0.00,0,0,0,0,0,0,0,0,0,0,0,0,0
20200212,06515P,國巨凱基98售06,,,,,0.00,0.00,0,0,0,0,0,0,0,0,0,0,0,0,0
20200212,06516P,國巨凱基98售08,1.31,1.31,1.31,1.31,-0.03,-2.24,10000,1,13100,0,0,0,0,0,0,0,10000,-10000,-10000
20200212,06517P,國巨凱基98售09,1.62,1.62,1.60,1.60,-0.08,-4.76,454000,9,732220,0,0,0,0,0,0,0,454000,-454000,-454000
20200212,06518P,奇力新兆豐99售01,,,,,0.00,0.00,0,0,0,0,0,0,0,0,0,0,0,0,0
20200212,06519P,元油2X元大98售03,,,,,0.00,0.00,0,0,0,0,0,0,0,0,0,0,0,0,0
20200212,06520P,元油2X元大98售04,,,,,0.00,0.00,0,0,0,0,0,0,0,0,0,0,0,0,0
20200212,06521P,矽力元大98售01,2.82,2.84,2.75,2.75,-0.20,-6.78,14000,3,38820,0,0,0,0,0,0,2000,12000,-10000,-10000
20200212,06522P,元油2X群益9B售03,,,,,0.00,0.00,0,0,0,0,0,0,0,0,0,0,0,0,0
20200212,06523P,台積電麥證98售02,1.18,1.18,1.14,1.14,-0.07,-5.79,30000,3,34550,0,30000,-30000,0,0,0,0,30000,-30000,-30000
20200212,06524P,臺股指麥證98售02,,,,,0.00,0.00,0,0,0,0,0,0,0,0,0,0,0,0,0
20200212,06525P,上証2X國泰99售01,,,,,0.00,0.00,0,0,0,0,0,0,0,0,0,0,0,0,0
20200212,06526P,元油2X永豐98售03,,,,,0.00,0.00,0,0,0,0,0,0,0,0,0,0,0,0,0
20200212,06527P,T50正2富邦9C售01,,,,,0.00,0.00,0,0,0,0,0,0,0,0,0,0,0,0,0
20200212,06528P,台積電富邦99售03,,,,,0.00,0.00,0,0,0,0,0,0,0,0,0,0,0,0,0
20200212,06529P,貿聯富邦99售03,1.03,1.03,1.01,1.01,-0.04,-3.81,31000,4,31620,0,0,0,0,0,0,20000,11000,9000,9000
20200212,06530P,元油2X元富98售13,,,,,0.00,0.00,0,0,0,0,0,0,0,0,0,0,0,0,0
20200212,06531P,元油2X元富98售14,,,,,0.00,0.00,0,0,0,0,0,0,0,0,0,0,0,0,0
20200212,06532P,友達元富98售04,0.87,0.90,0.87,0.90,+0.02,2.27,22000,5,19350,0,0,0,0,0,0,14000,8000,6000,6000
20200212,06533P,上証2X中信9B售01,,,,,0.00,0.00,0,0,0,0,0,0,0,0,0,0,0,0,0
20200212,06534P,聯發科群益98售04,,,,,0.00,0.00,0,0,0,0,0,0,0,0,0,0,0,0,0
20200212,06535P,可成群益99售02,2.63,2.63,2.63,2.63,0.00,0.00,2000,1,5260,0,0,0,0,0,0,0,2000,-2000,-2000
20200212,06536P,臺股指群益98售04,,,,,0.00,0.00,0,0,0,0,0,0,0,0,0,0,0,0,0
20200212,06537P,華通凱基98售04,,,,,0.00,0.00,0,0,0,0,0,0,0,0,0,0,0,0,0
20200212,06538P,國巨凱基98售11,1.66,1.66,1.60,1.60,-0.09,-5.33,83000,5,135800,0,0,0,0,0,0,3000,80000,-77000,-77000
20200212,06539P,聯發科凱基98售12,1.68,1.68,1.62,1.62,0.00,0.00,95000,6,157700,0,0,0,0,0,0,0,95000,-95000,-95000
20200212,06540P,聯發科凱基98售13,,,,,0.00,0.00,0,0,0,0,0,0,0,0,0,0,0,0,0
20200212,06541P,元油2X國票9A售02,,,,,0.00,0.00,0,0,0,0,0,0,0,0,0,0,0,0,0
20200212,06542P,台光電國票98售05,3.26,3.26,3.07,3.07,-0.27,-8.08,15000,2,47380,0,0,0,0,0,0,7000,8000,-1000,-1000
20200212,06543P,鴻海元大98售08,2.50,2.52,2.27,2.27,-0.48,-17.45,30000,7,71200,0,0,0,0,0,0,5000,25000,-20000,-20000
20200212,06544P,鴻海元大98售09,3.46,3.46,3.46,3.46,-0.31,-8.22,8000,1,27680,0,0,0,0,0,0,8000,8000,0,0
20200212,06545P,致茂元大98售01,,,,,0.00,0.00,0,0,0,0,0,0,0,0,0,0,0,0,0
20200212,06546P,聯發科元大98售05,3.06,3.07,3.06,3.07,0.00,0.00,150000,11,460250,0,0,0,0,0,0,0,150000,-150000,-150000
20200212,06547P,大立光元大98售09,4.34,4.34,4.28,4.28,-0.23,-5.1,57000,2,244080,0,0,0,0,0,0,57000,0,57000,57000
20200212,06548P,大立光元大98售10,,,,,0.00,0.00,0,0,0,0,0,0,0,0,0,0,0,0,0
20200212,06549P,大立光元大98售11,,,,,0.00,0.00,0,0,0,0,0,0,0,0,0,0,0,0,0
20200212,06550P,健策元大99售01,1.07,1.07,1.01,1.01,0.00,0.00,51000,6,53220,0,0,0,0,0,0,0,51000,-51000,-51000
20200212,06551P,貿聯元大98售05,2.54,2.54,2.54,2.54,-0.02,-0.78,50000,1,127000,0,0,0,0,0,0,50000,0,50000,50000
20200212,06552P,茂林元大99售02,1.72,1.72,1.71,1.71,-0.05,-2.84,43000,2,73940,0,0,0,0,0,0,41000,2000,39000,39000
20200212,06553P,訊芯元大98售05,1.81,1.81,1.77,1.79,-0.12,-6.28,79000,7,141910,0,0,0,0,0,0,0,79000,-79000,-79000
20200212,06554P,臺股指元大99售06,,,,,0.00,0.00,0,0,0,0,0,0,0,0,0,0,0,0,0
20200212,06555P,臺股指元大99售07,,,,,0.00,0.00,0,0,0,0,0,0,0,0,0,0,0,0,0
20200212,06556P,臺股指元大99售08,,,,,0.00,0.00,0,0,0,0,0,0,0,0,0,0,0,0,0
20200212,06557P,台積電兆豐98售02,0.97,0.98,0.97,0.98,-0.10,-9.26,100000,2,97500,0,0,0,0,0,0,50000,50000,0,0
20200212,06558P,旺宏元富98售02,,,,,0.00,0.00,0,0,0,0,0,0,0,0,0,0,0,0,0
20200212,06559P,玉晶光元富98售02,,,,,0.00,0.00,0,0,0,0,0,0,0,0,0,0,0,0,0
20200212,06560P,台積電統一98售07,,,,,0.00,0.00,0,0,0,0,0,0,0,0,0,0,0,0,0
20200212,06561P,台灣50國泰9A售01,2.96,2.96,2.78,2.81,-0.23,-7.57,196000,15,576880,0,0,0,0,0,0,0,196000,-196000,-196000
20200212,06562P,台積電國泰99售02,,,,,0.00,0.00,0,0,0,0,0,0,0,0,0,0,0,0,0
20200212,06563P,元油2X富邦02售02,,,,,0.00,0.00,0,0,0,0,0,0,0,0,0,0,0,0,0
20200212,06564P,國巨富邦9A售04,,,,,0.00,0.00,0,0,0,0,0,0,0,0,0,0,0,0,0
20200212,06565P,元油2X永豐9A售01,,,,,0.00,0.00,0,0,0,0,0,0,0,0,0,0,0,0,0
20200212,06566P,華通永豐98售03,1.17,1.17,1.01,1.01,-0.29,-22.31,73000,6,79310,0,0,0,0,0,0,0,73000,-73000,-73000
20200212,06567P,鴻海永豐98售02,,,,,0.00,0.00,0,0,0,0,0,0,0,0,0,0,0,0,0
20200212,06568P,國巨永豐98售05,,,,,0.00,0.00,0,0,0,0,0,0,0,0,0,0,0,0,0
20200212,06569P,可成永豐98售01,,,,,0.00,0.00,0,0,0,0,0,0,0,0,0,0,0,0,0
20200212,06570P,大立光永豐98售01,,,,,0.00,0.00,0,0,0,0,0,0,0,0,0,0,0,0,0
20200212,06571P,欣興永豐98售03,,,,,0.00,0.00,0,0,0,0,0,0,0,0,0,0,0,0,0
20200212,06572P,台積電永昌99售01,1.48,1.48,1.44,1.45,-0.08,-5.23,2811000,16,4119740,0,0,0,0,0,0,2295000,2811000,-516000,-516000
20200212,06573P,台積電永昌99售02,0.76,0.76,0.76,0.76,-0.05,-6.17,499000,1,379240,0,0,0,0,0,0,499000,0,499000,499000
20200212,06574P,大立光永昌99售01,,,,,0.00,0.00,0,0,0,0,0,0,0,0,0,0,0,0,0
20200212,06575P,大立光永昌99售02,,,,,0.00,0.00,0,0,0,0,0,0,0,0,0,0,0,0,0
20200212,06576P,台光電群益98售03,2.04,2.04,1.94,1.94,0.00,0.00,43000,4,85850,0,0,0,0,0,0,0,43000,-43000,-43000
20200212,06577P,聯發科日盛9A售02,2.03,2.03,1.93,1.93,0.00,0.00,8000,8,15820,0,0,0,0,0,0,0,8000,-8000,-8000
20200212,06578P,華新科國票98售02,2.36,2.40,2.35,2.39,-0.11,-4.4,36000,4,85260,0,0,0,0,0,0,30000,6000,24000,24000
20200212,06579P,臺股指麥證98售03,,,,,0.00,0.00,0,0,0,0,0,0,0,0,0,0,0,0,0
20200212,06580P,元油2X凱基9A售06,,,,,0.00,0.00,0,0,0,0,0,0,0,0,0,0,0,0,0
20200212,06581P,南亞科凱基98售04,1.59,1.59,1.59,1.59,0.00,0.00,11000,1,17490,0,0,0,0,0,0,0,11000,-11000,-11000
20200212,06582P,可成凱基98售06,1.63,1.63,1.63,1.63,0.00,0.00,8000,1,13040,0,0,0,0,0,0,0,8000,-8000,-8000
20200212,06583P,可成凱基98售07,,,,,0.00,0.00,0,0,0,0,0,0,0,0,0,0,0,0,0
20200212,06584P,欣興凱基98售03,,,,,0.00,0.00,0,0,0,0,0,0,0,0,0,0,0,0,0
20200212,06585P,鴻海元大99售04,,,,,0.00,0.00,0,0,0,0,0,0,0,0,0,0,0,0,0
20200212,06586P,鴻海元大9C售01,,,,,0.00,0.00,0,0,0,0,0,0,0,0,0,0,0,0,0
20200212,06587P,國巨元大98售13,3.26,3.26,3.22,3.22,-0.12,-3.59,28000,3,91160,0,0,0,0,0,0,25000,28000,-3000,-3000
20200212,06588P,台積電元大98售11,,,,,0.00,0.00,0,0,0,0,0,0,0,0,0,0,0,0,0
20200212,06589P,台積電元大98售12,3.35,3.35,3.35,3.35,0.00,0.00,50000,1,167500,0,0,0,0,0,0,50000,50000,0,0
20200212,06590P,大立光元大98售13,,,,,0.00,0.00,0,0,0,0,0,0,0,0,0,0,0,0,0
20200212,06591P,大立光元大98售14,,,,,0.00,0.00,0,0,0,0,0,0,0,0,0,0,0,0,0
20200212,06592P,欣興元大98售04,,,,,0.00,0.00,0,0,0,0,0,0,0,0,0,0,0,0,0
20200212,06593P,欣興元大98售05,2.23,2.23,2.07,2.07,-0.30,-12.66,22000,4,47760,0,0,0,0,0,0,10000,12000,-2000,-2000
20200212,06594P,立積元大98售01,,,,,0.00,0.00,0,0,0,0,0,0,0,0,0,0,0,0,0
20200212,06595P,祥碩元大98售03,2.17,2.17,2.00,2.00,-0.29,-12.66,203000,17,422060,0,0,0,0,0,0,10000,193000,-183000,-183000
20200212,06596P,元油2X富邦02售03,0.91,0.91,0.91,0.91,0.00,0.00,2000,1,1820,0,0,0,0,0,0,0,2000,-2000,-2000
20200212,06597P,國巨富邦9A售05,,,,,0.00,0.00,0,0,0,0,0,0,0,0,0,0,0,0,0
20200212,06598P,奇力新永豐98售02,1.16,1.16,1.16,1.16,0.00,0.00,54000,2,62640,0,0,0,0,0,0,0,54000,-54000,-54000
20200212,06599P,宏達電永豐98售02,,,,,0.00,0.00,0,0,0,0,0,0,0,0,0,0,0,0,0
20200212,06600P,貿聯永豐98售01,,,,,0.00,0.00,0,0,0,0,0,0,0,0,0,0,0,0,0
20200212,06601P,臺股指永豐98售04,1.32,1.32,1.32,1.32,0.00,0.00,10000,1,13200,0,0,0,0,0,0,0,10000,-10000,-10000
20200212,06602P,國巨統一99售02,,,,,0.00,0.00,0,0,0,0,0,0,0,0,0,0,0,0,0
20200212,06603P,立積統一99售01,,,,,0.00,0.00,0,0,0,0,0,0,0,0,0,0,0,0,0
20200212,06604P,聯發科元富02售02,,,,,0.00,0.00,0,0,0,0,0,0,0,0,0,0,0,0,0
20200212,06605P,玉晶光元富98售03,,,,,0.00,0.00,0,0,0,0,0,0,0,0,0,0,0,0,0
20200212,06606P,訊芯元富98售02,,,,,0.00,0.00,0,0,0,0,0,0,0,0,0,0,0,0,0
20200212,06607P,友達台新98售02,0.92,0.92,0.91,0.92,+0.04,4.55,81000,7,74320,0,0,0,0,0,0,20000,61000,-41000,-41000
20200212,06608P,立積群益99售02,1.09,1.09,1.09,1.09,+0.10,10.1,3000,1,3270,0,0,0,0,0,0,0,3000,-3000,-3000
20200212,06609P,元油2X凱基9B售06,,,,,0.00,0.00,0,0,0,0,0,0,0,0,0,0,0,0,0
20200212,06610P,台積電凱基9A售03,1.41,1.41,1.41,1.41,+0.21,17.5,1000,1,1410,0,0,0,0,0,0,0,1000,-1000,-1000
20200212,06611P,祥碩國票98售01,2.11,2.11,2.10,2.10,-0.37,-14.98,450000,3,946990,0,0,0,0,0,0,0,450000,-450000,-450000
20200212,06612P,元油2X富邦9B售03,,,,,0.00,0.00,0,0,0,0,0,0,0,0,0,0,0,0,0
20200212,06613P,華新科富邦9A售03,0.82,0.82,0.82,0.82,-0.04,-4.65,20000,2,16400,0,0,0,0,0,0,0,20000,-20000,-20000
20200212,06614P,祥碩永豐98售03,,,,,0.00,0.00,0,0,0,0,0,0,0,0,0,0,0,0,0
20200212,06615P,鴻海元大9C售02,,,,,0.00,0.00,0,0,0,0,0,0,0,0,0,0,0,0,0
20200212,06616P,國巨元大98售15,2.84,2.84,2.84,2.84,-0.21,-6.89,10000,1,28400,0,0,0,0,0,0,0,10000,-10000,-10000
20200212,06617P,智邦元大98售03,1.29,1.35,1.28,1.35,-0.18,-11.76,12000,3,15510,0,0,0,0,0,0,0,12000,-12000,-12000
20200212,06618P,智邦元大98售04,,,,,0.00,0.00,0,0,0,0,0,0,0,0,0,0,0,0,0
20200212,06619P,聯發科元大98售06,,,,,0.00,0.00,0,0,0,0,0,0,0,0,0,0,0,0,0
20200212,06620P,聯發科元大98售07,,,,,0.00,0.00,0,0,0,0,0,0,0,0,0,0,0,0,0
20200212,06621P,欣興元大98售06,2.84,2.84,2.70,2.70,-0.51,-15.89,7000,3,19610,0,0,0,0,0,0,0,7000,-7000,-7000
20200212,06622P,牧德元大98售01,,,,,0.00,0.00,0,0,0,0,0,0,0,0,0,0,0,0,0
20200212,06623P,立積元大98售04,,,,,0.00,0.00,0,0,0,0,0,0,0,0,0,0,0,0,0
20200212,06624P,訊芯元大98售06,,,,,0.00,0.00,0,0,0,0,0,0,0,0,0,0,0,0,0
20200212,06625P,華新科統一98售03,,,,,0.00,0.00,0,0,0,0,0,0,0,0,0,0,0,0,0
20200212,06626P,大立光統一9A售01,,,,,0.00,0.00,0,0,0,0,0,0,0,0,0,0,0,0,0
20200212,06627P,華新科元富99售01,,,,,0.00,0.00,0,0,0,0,0,0,0,0,0,0,0,0,0
20200212,06628P,訊芯元富98售03,,,,,0.00,0.00,0,0,0,0,0,0,0,0,0,0,0,0,0
20200212,07154P,台灣50群益94售01,,,,,0.00,0.00,0,0,0,0,0,0,0,0,0,0,0,0,0
20200212,07240P,台灣50台新94售01,,,,,0.00,0.00,0,0,0,0,0,0,0,0,0,0,0,0,0
20200212,07383P,聯發科群益99售06,,,,,0.00,0.00,0,0,0,0,0,0,0,0,0,0,0,0,0
20200212,07480P,FBVIX凱基94售01,1.16,1.16,1.16,1.16,-0.01,-0.85,10000,1,11600,0,0,0,0,0,0,10000,0,10000,10000
20200212,07554P,玉晶光元大9A售06,,,,,0.00,0.00,0,0,0,0,0,0,0,0,0,0,0,0,0
20200212,07656P,國巨凱基9A售15,,,,,0.00,0.00,0,0,0,0,0,0,0,0,0,0,0,0,0
20200212,07866P,上証2X國票97售01,0.06,0.07,0.06,0.06,-0.01,-14.29,802000,6,49120,0,0,0,0,0,0,702000,100000,602000,602000
20200212,07868P,健策元大9B售05,,,,,0.00,0.00,0,0,0,0,0,0,0,0,0,0,0,0,0
20200212,07883P,可成凱基9B售03,,,,,0.00,0.00,0,0,0,0,0,0,0,0,0,0,0,0,0
20200212,07893P,臺股指國票9B售03,0.01,0.01,0.01,0.01,0.00,0.00,6000,6,60,0,0,0,0,0,0,0,0,0,0
20200212,07917P,可成永豐9B售01,,,,,0.00,0.00,0,0,0,0,0,0,0,0,0,0,0,0,0
20200212,07933P,大立光富邦9C售06,,,,,0.00,0.00,0,0,0,0,0,0,0,0,0,0,0,0,0
20200212,08027P,嘉晶元大9B售03,,,,,0.00,0.00,0,0,0,0,0,0,0,0,0,0,0,0,0
20200212,08056P,華通群益9B售06,,,,,0.00,0.00,0,0,0,0,0,0,0,0,0,0,0,0,0
20200212,08070P,晶技國泰9C售02,,,,,0.00,0.00,0,0,0,0,0,0,0,0,0,0,0,0,0
20200212,08084P,台表科元大9B售06,,,,,0.00,0.00,0,0,0,0,0,0,0,0,0,0,0,0,0
20200212,08100P,台灣50元富95售01,,,,,0.00,0.00,0,0,0,0,0,0,0,0,0,0,0,0,0
20200212,08126P,臺指反元大02售15,,,,,0.00,0.00,0,0,0,0,0,0,0,0,0,0,0,0,0
20200212,08163P,T50正2中信95售01,,,,,0.00,0.00,0,0,0,0,0,0,0,0,0,0,0,0,0
20200212,08164P,滬深2X中信95售04,,,,,0.00,0.00,0,0,0,0,0,0,0,0,0,0,0,0,0
20200212,08200P,祥碩元大9B售08,,,,,0.00,0.00,0,0,0,0,0,0,0,0,0,0,0,0,0
20200212,08213P,台光電統一9B售03,,,,,0.00,0.00,0,0,0,0,0,0,0,0,0,0,0,0,0
20200212,08216P,聯發科群益9C售05,,,,,0.00,0.00,0,0,0,0,0,0,0,0,0,0,0,0,0
20200212,08217P,T50反1凱基96售02,,,,,0.00,0.00,0,0,0,0,0,0,0,0,0,0,0,0,0
20200212,08218P,滬深2X凱基96售01,0.48,0.50,0.47,0.49,0.00,0.00,1178000,16,570390,0,0,0,0,0,0,1021000,0,1021000,1021000
20200212,08282P,南六群益9C售01,,,,,0.00,0.00,0,0,0,0,0,0,0,0,0,0,0,0,0
20200212,08291P,智邦台新9C售02,,,,,0.00,0.00,0,0,0,0,0,0,0,0,0,0,0,0,0
20200212,08302P,長榮航國泰02售01,,,,,0.00,0.00,0,0,0,0,0,0,0,0,0,0,0,0,0
20200212,08322P,國巨凱基9C售08,,,,,0.00,0.00,0,0,0,0,0,0,0,0,0,0,0,0,0
20200212,08332P,智邦台新9C售03,,,,,0.00,0.00,0,0,0,0,0,0,0,0,0,0,0,0,0
20200212,08333P,大立光富邦02售03,,,,,0.00,0.00,0,0,0,0,0,0,0,0,0,0,0,0,0
20200212,08338P,台灣50凱基9C售11,,,,,0.00,0.00,0,0,0,0,0,0,0,0,0,0,0,0,0
20200212,08341P,國泰金台新9C售01,,,,,0.00,0.00,0,0,0,0,0,0,0,0,0,0,0,0,0
20200212,08350P,臺股指中信9C售06,,,,,0.00,0.00,0,0,0,0,0,0,0,0,0,0,0,0,0
20200212,08356P,聯發科元大9C售08,,,,,0.00,0.00,0,0,0,0,0,0,0,0,0,0,0,0,0
20200212,08358P,大立光元大9C售18,,,,,0.00,0.00,0,0,0,0,0,0,0,0,0,0,0,0,0
20200212,08388P,台灣50中信03售09,0.05,0.05,0.05,0.05,-0.01,-16.67,15000,2,750,0,0,0,0,0,0,0,15000,-15000,-15000
20200212,08389P,技嘉國票9C售01,,,,,0.00,0.00,0,0,0,0,0,0,0,0,0,0,0,0,0
20200212,08392P,上銀群益9C售01,,,,,0.00,0.00,0,0,0,0,0,0,0,0,0,0,0,0,0
20200212,08408P,臺股指元大9C售14,,,,,0.00,0.00,0,0,0,0,0,0,0,0,0,0,0,0,0
20200212,08416P,T50反1元大9C售07,,,,,0.00,0.00,0,0,0,0,0,0,0,0,0,0,0,0,0
20200212,08422P,玉晶光群益02售03,,,,,0.00,0.00,0,0,0,0,0,0,0,0,0,0,0,0,0
20200212,08434P,臺股指凱基03售02,,,,,0.00,0.00,0,0,0,0,0,0,0,0,0,0,0,0,0
20200212,08437P,台郡群益9C售01,,,,,0.00,0.00,0,0,0,0,0,0,0,0,0,0,0,0,0
20200212,08445P,臺股指麥證9C售03,,,,,0.00,0.00,0,0,0,0,0,0,0,0,0,0,0,0,0
20200212,08446P,台灣50富邦01售02,,,,,0.00,0.00,0,0,0,0,0,0,0,0,0,0,0,0,0
20200212,08447P,緯穎永豐9C售02,0.01,0.02,0.01,0.02,0.00,0.00,833000,11,16630,0,0,0,0,0,0,0,0,0,0
20200212,08449P,華新科群益9C售03,,,,,0.00,0.00,0,0,0,0,0,0,0,0,0,0,0,0,0
20200212,08452P,智邦台新9C售05,,,,,0.00,0.00,0,0,0,0,0,0,0,0,0,0,0,0,0
20200212,08465P,玉晶光兆豐01售02,,,,,0.00,0.00,0,0,0,0,0,0,0,0,0,0,0,0,0
20200212,08466P,旺宏統一9C售03,,,,,0.00,0.00,0,0,0,0,0,0,0,0,0,0,0,0,0
20200212,08467P,長榮航統一9C售01,,,,,0.00,0.00,0,0,0,0,0,0,0,0,0,0,0,0,0
20200212,08468P,台郡統一9C售02,,,,,0.00,0.00,0,0,0,0,0,0,0,0,0,0,0,0,0
20200212,08469P,富邦金凱基9C售01,,,,,0.00,0.00,0,0,0,0,0,0,0,0,0,0,0,0,0
20200212,08472P,和碩凱基9C售02,,,,,0.00,0.00,0,0,0,0,0,0,0,0,0,0,0,0,0
20200212,08474P,臺股指凱基9C售12,,,,,0.00,0.00,0,0,0,0,0,0,0,0,0,0,0,0,0
20200212,08476P,臺股指凱基9C售14,,,,,0.00,0.00,0,0,0,0,0,0,0,0,0,0,0,0,0
20200212,08477P,臺股指凱基9C售15,,,,,0.00,0.00,0,0,0,0,0,0,0,0,0,0,0,0,0
20200212,08478P,臺股指凱基9C售16,,,,,0.00,0.00,0,0,0,0,0,0,0,0,0,0,0,0,0
20200212,08481P,臺股指凱基9C售19,,,,,0.00,0.00,0,0,0,0,0,0,0,0,0,0,0,0,0
20200212,08484P,台灣50中信96售01,0.08,0.08,0.06,0.06,-0.03,-33.33,588000,8,37740,0,0,0,0,0,0,400000,38000,362000,362000
20200212,08486P,富邦金群益9C售02,,,,,0.00,0.00,0,0,0,0,0,0,0,0,0,0,0,0,0
20200212,08487P,同欣電群益01售01,,,,,0.00,0.00,0,0,0,0,0,0,0,0,0,0,0,0,0
20200212,08488P,臺股指群益9C售19,,,,,0.00,0.00,0,0,0,0,0,0,0,0,0,0,0,0,0
20200212,08495P,同欣電元大9C售08,,,,,0.00,0.00,0,0,0,0,0,0,0,0,0,0,0,0,0
20200212,08506P,台灣50中信96售02,,,,,0.00,0.00,0,0,0,0,0,0,0,0,0,0,0,0,0
20200212,08508P,臺股指國票9C售09,,,,,0.00,0.00,0,0,0,0,0,0,0,0,0,0,0,0,0
20200212,08519P,台灣50元大9C售46,,,,,0.00,0.00,0,0,0,0,0,0,0,0,0,0,0,0,0
20200212,08520P,和大元大9C售04,,,,,0.00,0.00,0,0,0,0,0,0,0,0,0,0,0,0,0
20200212,08525P,台灣50凱基96售02,,,,,0.00,0.00,0,0,0,0,0,0,0,0,0,0,0,0,0
20200212,08539P,元油2X國票99售01,,,,,0.00,0.00,0,0,0,0,0,0,0,0,0,0,0,0,0
20200212,08553P,嘉澤群益9C售01,,,,,0.00,0.00,0,0,0,0,0,0,0,0,0,0,0,0,0
20200212,08566P,禾伸堂群益9C售01,,,,,0.00,0.00,0,0,0,0,0,0,0,0,0,0,0,0,0
20200212,08569P,玉晶光永豐9C售09,,,,,0.00,0.00,0,0,0,0,0,0,0,0,0,0,0,0,0
20200212,08570P,台灣50凱基96售03,,,,,0.00,0.00,0,0,0,0,0,0,0,0,0,0,0,0,0
20200212,08582P,臺股指元大9C售30,,,,,0.00,0.00,0,0,0,0,0,0,0,0,0,0,0,0,0
20200212,08589P,台灣50台新9C售08,,,,,0.00,0.00,0,0,0,0,0,0,0,0,0,0,0,0,0
20200212,08590P,智邦凱基9C售04,0.01,0.01,0.01,0.01,0.00,0.00,21000,2,210,0,0,0,0,0,0,21000,0,21000,21000
20200212,08591P,台光電凱基9C售02,,,,,0.00,0.00,0,0,0,0,0,0,0,0,0,0,0,0,0
20200212,08592P,聯發科凱基01售06,,,,,0.00,0.00,0,0,0,0,0,0,0,0,0,0,0,0,0
20200212,08599P,台表科元大9C售11,,,,,0.00,0.00,0,0,0,0,0,0,0,0,0,0,0,0,0
20200212,08600P,臺股指元大9C售32,,,,,0.00,0.00,0,0,0,0,0,0,0,0,0,0,0,0,0
20200212,08602P,台灣50凱基96售04,0.09,0.12,0.09,0.12,+0.02,20.0,189000,3,17310,0,0,0,0,0,0,0,0,0,0
20200212,08609P,世紀鋼永豐9C售03,,,,,0.00,0.00,0,0,0,0,0,0,0,0,0,0,0,0,0
20200212,08612P,嘉晶凱基9C售03,,,,,0.00,0.00,0,0,0,0,0,0,0,0,0,0,0,0,0
20200212,08613P,同欣電凱基9C售04,,,,,0.00,0.00,0,0,0,0,0,0,0,0,0,0,0,0,0
20200212,08614P,聯發科統一9C售18,,,,,0.00,0.00,0,0,0,0,0,0,0,0,0,0,0,0,0
20200212,08617P,緯創元富9C售03,,,,,0.00,0.00,0,0,0,0,0,0,0,0,0,0,0,0,0
20200212,08625P,台灣50凱基96售05,,,,,0.00,0.00,0,0,0,0,0,0,0,0,0,0,0,0,0
20200212,08629P,緯創凱基9C售02,,,,,0.00,0.00,0,0,0,0,0,0,0,0,0,0,0,0,0
20200212,08631P,臺股指麥證9C售06,,,,,0.00,0.00,0,0,0,0,0,0,0,0,0,0,0,0,0
20200212,08637P,台灣50中信96售03,0.35,0.35,0.31,0.32,-0.04,-11.11,3162000,93,1025210,0,0,0,0,0,0,995000,2035000,-1040000,-1040000
20200212,08638P,泰碩國票9C售01,,,,,0.00,0.00,0,0,0,0,0,0,0,0,0,0,0,0,0
20200212,08650P,臺股指元大9C售36,,,,,0.00,0.00,0,0,0,0,0,0,0,0,0,0,0,0,0
20200212,08653P,台灣50凱基96售07,0.17,0.17,0.12,0.12,0.00,0.00,180000,10,25100,0,0,0,0,0,0,0,0,0,0
20200212,08663P,台灣50元大96售01,0.19,0.20,0.19,0.20,0.00,0.00,71000,4,13500,0,0,0,0,0,0,0,0,0,0
20200212,08671P,友訊國票01售01,0.04,0.04,0.04,0.04,-0.01,-20.0,811000,88,32440,0,0,0,0,0,0,0,811000,-811000,-811000
20200212,08672P,聯發科統一01售09,0.02,0.02,0.02,0.02,-0.01,-33.33,10000,1,200,0,0,0,0,0,0,0,10000,-10000,-10000
20200212,08674P,嘉晶元富07售02,0.22,0.22,0.18,0.20,-0.01,-4.76,182000,20,36210,0,0,0,0,0,0,0,58000,-58000,-58000
20200212,08679P,台灣50元大01售15,0.09,0.09,0.08,0.08,-0.02,-20.0,257000,11,22060,0,0,0,0,0,0,0,0,0,0
20200212,08703P,華碩凱基01售02,0.25,0.25,0.25,0.25,-0.01,-3.85,300000,1,75000,0,0,0,0,0,0,300000,0,300000,300000
20200212,08714P,華碩元富01售03,0.10,0.10,0.09,0.09,-0.01,-10.0,125000,6,12120,0,0,0,0,0,0,0,0,0,0
20200212,08749P,鴻海台新01售02,0.21,0.21,0.20,0.20,0.00,0.00,15000,2,3050,0,0,0,0,0,0,0,15000,-15000,-15000
20200212,08750P,台灣50群益01售04,0.01,0.01,0.01,0.01,0.00,0.00,10000,10,100,0,0,0,0,0,0,0,0,0,0
20200212,08751P,友達群益01售01,,,,,0.00,0.00,0,0,0,0,0,0,0,0,0,0,0,0,0
20200212,08794P,台積電兆豐01售03,,,,,0.00,0.00,0,0,0,0,0,0,0,0,0,0,0,0,0
20200212,08795P,聯發科凱基01售11,0.09,0.10,0.09,0.09,-0.03,-25.0,180000,5,17400,0,0,0,0,0,0,8000,172000,-164000,-164000
20200212,08801P,聯發科元大01售13,,,,,0.00,0.00,0,0,0,0,0,0,0,0,0,0,0,0,0
20200212,08815P,聯發科國泰03售03,,,,,0.00,0.00,0,0,0,0,0,0,0,0,0,0,0,0,0
20200212,08818P,台灣50元大97售01,0.20,0.21,0.19,0.20,-0.02,-9.09,469000,17,93990,0,0,0,0,0,0,0,0,0,0
20200212,08820P,臺股指中信93售03,,,,,0.00,0.00,0,0,0,0,0,0,0,0,0,0,0,0,0
20200212,08852P,台灣50台新01售01,0.31,0.31,0.28,0.28,-0.04,-12.5,217000,15,62460,0,0,0,0,0,0,0,0,0,0
20200212,08859P,大立光元富94售02,,,,,0.00,0.00,0,0,0,0,0,0,0,0,0,0,0,0,0
20200212,08864P,台積電中信95售03,,,,,0.00,0.00,0,0,0,0,0,0,0,0,0,0,0,0,0
20200212,08865P,台積電中信95售04,0.01,0.01,0.01,0.01,0.00,0.00,231000,4,2310,0,0,0,0,0,0,0,0,0,0
20200212,08867P,臺股指中信93售04,,,,,0.00,0.00,0,0,0,0,0,0,0,0,0,0,0,0,0
20200212,08885P,台積電群益92售05,0.01,0.01,0.01,0.01,0.00,0.00,10000,10,100,0,0,0,0,0,0,0,0,0,0
20200212,08886P,技嘉群益92售01,,,,,0.00,0.00,0,0,0,0,0,0,0,0,0,0,0,0,0
20200212,08890P,大立光富邦93售01,,,,,0.00,0.00,0,0,0,0,0,0,0,0,0,0,0,0,0
20200212,08895P,瑞昱兆豐92售02,,,,,0.00,0.00,0,0,0,0,0,0,0,0,0,0,0,0,0
20200212,08897P,鴻海凱基94售02,0.15,0.15,0.12,0.12,-0.05,-29.41,258000,7,34660,0,0,0,0,0,0,155000,103000,52000,52000
20200212,08921P,力山國票92售01,,,,,0.00,0.00,0,0,0,0,0,0,0,0,0,0,0,0,0
20200212,08922P,TPK國票92售01,,,,,0.00,0.00,0,0,0,0,0,0,0,0,0,0,0,0,0
20200212,08941P,大立光永昌93售05,,,,,0.00,0.00,0,0,0,0,0,0,0,0,0,0,0,0,0
20200212,08961P,台積電統一92售01,,,,,0.00,0.00,0,0,0,0,0,0,0,0,0,0,0,0,0
20200212,08962P,台積電統一93售01,,,,,0.00,0.00,0,0,0,0,0,0,0,0,0,0,0,0,0
20200212,08966P,臻鼎元富94售02,0.07,0.07,0.07,0.07,-0.03,-30.0,50000,1,3500,0,0,0,0,0,0,0,50000,-50000,-50000
20200212,08967P,上銀富邦93售02,,,,,0.00,0.00,0,0,0,0,0,0,0,0,0,0,0,0,0
20200212,08968P,鴻海元大92售03,,,,,0.00,0.00,0,0,0,0,0,0,0,0,0,0,0,0,0
20200212,08972P,聯發科兆豐92售01,,,,,0.00,0.00,0,0,0,0,0,0,0,0,0,0,0,0,0
20200212,08974P,祥碩凱基93售02,0.01,0.01,0.01,0.01,0.00,0.00,65000,1,650,0,0,0,0,0,0,65000,0,65000,65000
20200212,08976P,台積電元大92售09,,,,,0.00,0.00,0,0,0,0,0,0,0,0,0,0,0,0,0
20200212,08980P,華新科國票92售02,,,,,0.00,0.00,0,0,0,0,0,0,0,0,0,0,0,0,0
20200212,08981P,TPK國票92售02,,,,,0.00,0.00,0,0,0,0,0,0,0,0,0,0,0,0,0
20200212,08986P,上銀凱基93售02,,,,,0.00,0.00,0,0,0,0,0,0,0,0,0,0,0,0,0
20200212,08991P,力山元大92售04,,,,,0.00,0.00,0,0,0,0,0,0,0,0,0,0,0,0,0
20200212,08994P,臺股指統一93售01,,,,,0.00,0.00,0,0,0,0,0,0,0,0,0,0,0,0,0
20200212,08995P,臺股指統一93售02,,,,,0.00,0.00,0,0,0,0,0,0,0,0,0,0,0,0,0
20200212,08998P,台灣50國泰93售01,,,,,0.00,0.00,0,0,0,0,0,0,0,0,0,0,0,0,0
20200212,08999P,國巨兆豐92售02,,,,,0.00,0.00,0,0,0,0,0,0,0,0,0,0,0,0,0
20200212,1101,台泥,42.60,43.00,42.60,42.80,+0.20,0.47,14367529,3855,615124852,3878000,10359115,-6481115,34000,0,34000,458000,224000,234000,-6213115
20200212,1101B,台泥乙特,53.60,53.70,53.60,53.60,0.00,0.00,495303,19,26364560,422790,462790,-40000,0,0,0,0,20000,-20000,-60000
20200212,1102,亞泥,46.00,46.30,45.75,46.10,+0.10,0.22,5974096,2206,274898166,2708000,3661646,-953646,0,0,0,115000,109000,6000,-947646
20200212,1103,嘉泥,19.90,20.10,19.80,19.95,+0.05,0.25,979141,476,19550697,311000,360000,-49000,0,0,0,46000,8000,38000,-11000
20200212,1104,環泥,18.10,18.10,18.00,18.05,0.00,0.00,662027,306,11933734,4000,519000,-515000,0,0,0,0,55000,-55000,-570000
20200212,1108,幸福,7.80,7.91,7.78,7.80,+0.04,0.52,61000,32,476290,0,21000,-21000,0,0,0,0,2000,-2000,-23000
20200212,1109,信大,17.35,17.65,17.25,17.55,+0.20,1.15,426812,190,7430309,44000,32000,12000,0,0,0,13000,11000,2000,14000
20200212,1110,東泥,16.90,16.90,16.70,16.90,-0.10,-0.59,50076,22,842926,1000,9000,-8000,0,0,0,1000,0,1000,-7000
20200212,1201,味全,21.70,21.85,21.60,21.70,0.00,0.00,1398815,813,30354201,212000,696000,-484000,0,0,0,17000,0,17000,-467000
20200212,1203,味王,27.00,27.00,26.80,26.80,-0.20,-0.74,22949,41,616710,0,5000,-5000,0,0,0,0,0,0,-5000
20200212,1210,大成,40.75,40.80,40.20,40.65,+0.15,0.37,1740899,1419,70443913,389000,236000,153000,0,0,0,51000,47000,4000,157000
20200212,1213,大飲,,,,,0.00,0.00,0,0,0,0,0,0,0,0,0,0,0,0,0
20200212,1215,卜蜂,61.90,62.10,61.60,61.70,-0.20,-0.32,612115,457,37872030,161000,216000,-55000,0,70000,-70000,12000,0,12000,-113000
20200212,1216,統一,74.40,74.90,74.40,74.40,-0.20,-0.27,9192875,4131,686057315,5875000,7474048,-1599048,35000,0,35000,183000,7000,176000,-1388048
20200212,1217,愛之味,7.16,7.18,7.09,7.10,-0.01,-0.14,1169152,445,8339319,25000,51000,-26000,0,0,0,0,0,0,-26000
20200212,1218,泰山,20.10,20.15,19.95,20.05,0.00,0.00,255878,140,5123601,3000,77000,-74000,0,0,0,0,0,0,-74000
20200212,1219,福壽,17.95,18.00,17.95,18.00,+0.05,0.28,609824,33,10801138,1000,7000,-6000,0,0,0,0,0,0,-6000
20200212,1220,台榮,10.25,10.35,10.20,10.20,-0.10,-0.97,232000,57,2379250,0,1000,-1000,0,0,0,0,0,0,-1000
20200212,1225,福懋油,32.55,32.85,32.50,32.85,+0.05,0.15,55004,44,1793890,1000,6000,-5000,0,0,0,0,0,0,-5000
20200212,1227,佳格,71.10,71.50,70.50,71.00,+0.10,0.14,1856008,1145,131600749,1249000,180947,1068053,0,0,0,37000,0,37000,1105053
20200212,1229,聯華,38.00,38.45,37.80,38.00,+0.15,0.4,1805832,1072,68844572,167000,602000,-435000,0,0,0,45000,0,45000,-390000
20200212,1231,聯華食,41.05,41.10,41.00,41.05,0.00,0.00,150882,130,6194074,0,49000,-49000,0,0,0,0,0,0,-49000
20200212,1232,大統益,121.50,123.00,121.50,123.00,+1.50,1.23,86410,84,10568430,1000,10000,-9000,0,0,0,5000,0,5000,-4000
20200212,1233,天仁,38.50,38.50,38.15,38.20,0.00,0.00,29000,29,1108650,1000,2000,-1000,0,0,0,0,0,0,-1000
20200212,1234,黑松,32.90,33.00,32.80,32.90,0.00,0.00,101750,62,3347519,10000,2000,8000,0,0,0,0,0,0,8000
20200212,1235,興泰,22.05,22.30,22.00,22.20,0.00,0.00,17000,16,376100,1000,1000,0,0,0,0,0,0,0,0
20200212,1236,宏亞,13.25,13.30,13.20,13.20,0.00,0.00,16004,17,211952,0,0,0,0,0,0,0,0,0,0
20200212,1256,鮮活果汁-KY,200.00,204.50,200.00,204.00,+4.00,2.0,138750,167,28174500,18000,14000,4000,0,0,0,0,0,0,4000
20200212,1301,台塑,93.50,94.30,93.50,94.00,+0.30,0.32,3709189,2179,348752257,966000,2618932,-1652932,0,80000,-80000,184000,3000,181000,-1551932
20200212,1303,南亞,70.00,70.20,69.80,69.80,-0.20,-0.29,3439330,1715,240422100,1551808,2784562,-1232754,39000,0,39000,223000,4000,219000,-974754
20200212,1304,台聚,12.35,12.40,12.30,12.35,0.00,0.00,669250,379,8264370,84000,202000,-118000,0,0,0,2000,0,2000,-116000
20200212,1305,華夏,19.00,19.10,19.00,19.10,+0.10,0.53,655830,460,12495989,128000,126000,2000,0,0,0,29000,0,29000,31000
20200212,1307,三芳,22.00,22.10,21.95,22.00,+0.10,0.46,122264,71,2689047,16000,6000,10000,0,0,0,0,0,0,10000
20200212,1308,亞聚,14.15,14.40,14.15,14.35,+0.20,1.41,698539,308,9972118,40000,142000,-102000,0,0,0,0,5000,-5000,-107000
20200212,1309,台達化,9.65,9.79,9.62,9.73,+0.11,1.14,569361,219,5520981,73000,25000,48000,0,0,0,0,0,0,48000
20200212,1310,台苯,18.15,18.30,18.10,18.25,+0.05,0.27,1786637,724,32582361,364000,1134574,-770574,0,0,0,31000,0,31000,-739574
20200212,1312,國喬,16.70,17.15,16.70,17.15,+0.45,2.69,3324273,1365,56614319,1365000,519000,846000,0,0,0,212000,0,212000,1058000
20200212,1312A,國喬特,,,,,0.00,0.00,0,0,0,0,0,0,0,0,0,0,0,0,0
20200212,1313,聯成,10.00,10.05,10.00,10.00,-0.05,-0.5,770688,252,7726530,84000,188000,-104000,0,0,0,0,0,0,-104000
20200212,1314,中石化,8.25,8.26,8.20,8.24,-0.01,-0.12,15536216,2929,127789223,2742000,8050217,-5308217,0,0,0,198000,1178000,-980000,-6288217
20200212,1315,達新,51.90,53.40,51.10,51.50,+0.10,0.19,1031220,735,53766458,32000,186000,-154000,0,0,0,1000,0,1000,-153000
20200212,1316,上曜,12.50,12.65,12.50,12.55,+0.05,0.4,213224,119,2680508,32000,31000,1000,0,0,0,0,0,0,1000
20200212,1319,東陽,41.00,41.65,40.90,41.50,+0.65,1.59,763718,526,31557946,266000,157000,109000,0,34000,-34000,32000,5000,27000,102000
20200212,1321,大洋,32.60,33.00,32.45,32.55,-0.05,-0.15,687000,190,22349800,56000,35000,21000,0,0,0,1000,0,1000,22000
20200212,1323,永裕,33.05,33.50,33.00,33.40,+0.15,0.45,123422,74,4115817,0,3000,-3000,0,0,0,0,0,0,-3000
20200212,1324,地球,9.51,9.63,9.51,9.63,+0.12,1.26,3261,9,31165,0,0,0,0,0,0,0,0,0,0
20200212,1325,恆大,27.20,27.20,25.50,25.60,-1.55,-5.71,2921544,953,75628022,0,7000,-7000,0,0,0,0,0,0,-7000
20200212,1326,台化,83.90,85.00,83.90,84.90,+1.00,1.19,2803484,1909,237367240,1110000,1686362,-576362,31000,0,31000,173000,61000,112000,-433362
20200212,1337,再生-KY,5.30,5.34,5.27,5.30,-0.03,-0.56,542117,208,2873040,3000,70000,-67000,0,0,0,0,0,0,-67000
20200212,1338,廣華-KY,58.50,60.00,58.50,59.80,+1.40,2.4,264340,222,15717462,21000,56000,-35000,0,0,0,0,0,0,-35000
20200212,1339,昭輝,49.05,50.80,49.05,50.60,+1.55,3.16,552060,414,27676192,55000,89000,-34000,0,0,0,2000,0,2000,-32000
20200212,1340,勝悅-KY,13.15,13.50,13.10,13.45,+0.30,2.28,263458,190,3508395,31000,11000,20000,0,0,0,0,0,0,20000
20200212,1341,富林-KY,60.00,60.00,60.00,60.00,+0.80,1.35,1004,5,60240,0,0,0,0,0,0,0,0,0,0
20200212,1402,遠東新,28.50,28.65,28.50,28.60,0.00,0.00,6253236,2255,178849930,807000,5255583,-4448583,28000,0,28000,153000,10000,143000,-4277583
20200212,1409,新纖,12.50,12.55,12.30,12.35,-0.10,-0.8,2546037,1074,31510493,344000,341000,3000,0,0,0,73000,0,73000,76000
20200212,1410,南染,28.30,28.50,28.30,28.50,+0.35,1.24,15172,29,430306,0,2000,-2000,0,0,0,0,0,0,-2000
20200212,1413,宏洲,9.76,9.76,9.40,9.41,-0.29,-2.99,329913,176,3125784,0,4000,-4000,0,0,0,0,0,0,-4000
20200212,1414,東和,6.92,6.97,6.83,6.94,+0.08,1.17,378783,98,2612012,3000,8000,-5000,0,0,0,0,0,0,-5000
20200212,1416,廣豐,12.30,12.30,12.15,12.30,+0.05,0.41,85655,92,1046297,15000,2000,13000,0,0,0,1000,0,1000,14000
20200212,1418,東華,7.28,7.28,7.00,7.00,0.00,0.00,10066,13,72399,0,0,0,0,0,0,0,0,0,0
20200212,1419,新紡,40.05,40.45,39.95,40.40,+0.35,0.87,6300,15,252958,0,1000,-1000,0,0,0,0,0,0,-1000
20200212,1423,利華,10.20,10.20,10.10,10.20,+0.05,0.49,73444,18,748433,1000,1000,0,0,0,0,0,0,0,0
20200212,1432,大魯閣,5.80,5.80,5.70,5.72,-0.05,-0.87,131982,52,757507,0,4000,-4000,0,0,0,0,0,0,-4000
20200212,1434,福懋,33.65,33.80,33.65,33.65,0.00,0.00,874449,598,29468452,226000,653106,-427106,0,0,0,79000,0,79000,-348106
20200212,1435,中福,8.25,8.99,8.25,8.93,+0.71,8.64,910955,344,7905294,31000,8000,23000,0,0,0,0,0,0,23000
20200212,1436,華友聯,38.95,39.45,38.80,39.15,+0.25,0.64,127163,103,4947615,10000,9000,1000,0,0,0,0,0,0,1000
20200212,1437,勤益控,22.55,22.85,22.55,22.75,+0.20,0.89,204282,76,4634613,10000,37000,-27000,0,0,0,0,0,0,-27000
20200212,1438,裕豐,12.60,12.60,12.45,12.60,-0.10,-0.79,9096,6,114402,0,0,0,0,0,0,0,0,0,0
20200212,1439,中和,33.60,34.20,33.55,33.70,-0.15,-0.44,247000,157,8367150,27000,21000,6000,0,0,0,0,0,0,6000
20200212,1440,南紡,10.05,10.10,10.00,10.10,+0.05,0.5,1003415,322,10091262,124000,139000,-15000,0,0,0,7000,0,7000,-8000
20200212,1441,大東,9.30,9.39,9.10,9.25,0.00,0.00,474731,167,4375724,4000,7000,-3000,0,0,0,0,0,0,-3000
20200212,1442,名軒,18.20,18.50,18.20,18.50,+0.30,1.65,230000,87,4228300,1000,57000,-56000,0,0,0,0,0,0,-56000
20200212,1443,立益,9.39,9.39,9.27,9.27,0.00,0.00,7394,13,68806,0,1000,-1000,0,0,0,0,0,0,-1000
20200212,1444,力麗,9.10,9.13,9.00,9.03,-0.03,-0.33,710333,318,6426014,102000,74000,28000,0,0,0,0,0,0,28000
20200212,1445,大宇,7.16,7.24,7.16,7.21,+0.07,0.98,71001,28,510787,17000,0,17000,0,0,0,0,0,0,17000
20200212,1446,宏和,33.10,33.25,33.00,33.15,+0.10,0.3,119240,84,3951640,3000,47000,-44000,0,0,0,0,0,0,-44000
20200212,1447,力鵬,6.67,6.75,6.67,6.72,+0.02,0.3,201344,96,1350032,48000,26000,22000,0,0,0,0,0,0,22000
20200212,1449,佳和,11.85,12.30,11.85,12.30,+0.35,2.93,482545,191,5862844,77000,3000,74000,0,0,0,0,0,0,74000
20200212,1451,年興,20.55,20.70,20.50,20.65,+0.15,0.73,148115,95,3051115,7000,85000,-78000,0,0,0,0,0,0,-78000
20200212,1452,宏益,18.00,18.05,17.80,18.05,+0.05,0.28,240448,141,4303986,0,2000,-2000,0,0,0,0,0,0,-2000
20200212,1453,大將,8.14,8.14,8.14,8.14,0.00,0.00,11589,9,94337,0,0,0,0,0,0,0,0,0,0
20200212,1454,台富,7.83,7.83,7.78,7.78,-0.05,-0.64,9001,9,70148,1000,0,1000,0,0,0,0,0,0,1000
20200212,1455,集盛,7.25,7.29,7.22,7.26,-0.01,-0.14,575056,170,4168463,47000,12000,35000,0,0,0,0,0,0,35000
20200212,1456,怡華,10.65,10.70,10.65,10.70,-0.10,-0.93,23768,19,253828,0,0,0,0,0,0,0,0,0,0
20200212,1457,宜進,13.70,13.70,13.65,13.70,+0.05,0.37,238354,118,3260193,10000,25000,-15000,0,0,0,0,44000,-44000,-59000
20200212,1459,聯發,6.87,6.88,6.82,6.82,-0.02,-0.29,39200,18,268615,0,2000,-2000,0,0,0,0,0,0,-2000
20200212,1460,宏遠,8.32,8.38,8.29,8.31,0.00,0.00,313078,144,2607184,15000,41000,-26000,0,0,0,0,0,0,-26000
20200212,1463,強盛,12.65,12.80,12.65,12.80,+0.15,1.19,89010,44,1131687,0,14000,-14000,0,0,0,0,0,0,-14000
20200212,1464,得力,23.60,23.70,23.35,23.50,-0.10,-0.42,1136247,599,26652195,23000,272000,-249000,0,0,0,1000,0,1000,-248000
20200212,1465,偉全,14.95,14.95,14.75,14.75,-0.05,-0.34,47150,16,699112,0,0,0,0,0,0,0,0,0,0
20200212,1466,聚隆,7.91,7.91,7.87,7.90,+0.03,0.38,51003,24,402641,0,1000,-1000,0,0,0,0,0,0,-1000
20200212,1467,南緯,7.84,7.87,7.83,7.87,+0.06,0.77,63301,27,496658,0,0,0,0,0,0,0,0,0,0
20200212,1468,昶和,9.92,10.05,9.90,10.05,+0.06,0.6,10000,10,99630,0,0,0,0,0,0,0,0,0,0
20200212,1470,大統新創,20.95,21.00,20.95,21.00,+0.45,2.19,2000,2,41950,0,0,0,0,0,0,0,0,0,0
20200212,1471,首利,2.62,2.66,2.60,2.66,+0.04,1.53,45041,25,117470,0,0,0,0,0,0,0,0,0,0
20200212,1472,三洋紡,25.55,25.60,25.25,25.45,-0.05,-0.2,6002,8,152450,0,1000,-1000,0,0,0,0,0,0,-1000
20200212,1473,台南,27.90,28.00,27.80,27.85,+0.05,0.18,287265,143,8016956,12000,22000,-10000,0,0,0,0,0,0,-10000
20200212,1474,弘裕,10.35,10.35,10.05,10.05,-0.30,-2.9,726950,271,7382096,6000,8000,-2000,0,0,0,0,0,0,-2000
20200212,1475,本盟,11.15,11.15,10.50,10.50,-1.00,-8.7,12001,11,133160,0,0,0,0,0,0,0,0,0,0
20200212,1476,儒鴻,370.00,374.00,365.50,370.00,-0.50,-0.13,1319775,1060,487246800,247000,652282,-405282,0,118000,-118000,15000,2000,13000,-510282
20200212,1477,聚陽,150.00,150.00,148.50,148.50,-1.00,-0.67,960246,757,143249900,196000,562900,-366900,0,107000,-107000,28000,4000,24000,-449900
20200212,1503,士電,44.80,45.10,44.75,44.95,+0.10,0.22,140454,98,6312203,6000,24000,-18000,0,0,0,22000,0,22000,4000
20200212,1504,東元,26.95,27.00,26.85,26.95,+0.15,0.56,2212775,1177,59549449,1802000,1181000,621000,0,0,0,87000,8000,79000,700000
20200212,1506,正道,12.70,12.95,12.70,12.95,+0.05,0.39,271014,66,3495632,5000,0,5000,0,0,0,0,0,0,5000
20200212,1507,永大,62.40,63.30,62.10,62.30,+0.20,0.32,105280,94,6593240,20000,91000,-71000,0,0,0,15000,0,15000,-56000
20200212,1512,瑞利,3.61,3.73,3.61,3.68,-0.11,-2.9,21140,45,77210,0,0,0,0,0,0,0,0,0,0
20200212,1513,中興電,28.20,28.30,27.90,28.05,0.00,0.00,2261501,1047,63393761,644000,208000,436000,0,50000,-50000,0,44000,-44000,342000
20200212,1514,亞力,20.55,20.75,20.35,20.75,+0.25,1.22,1917363,879,39317216,203000,423000,-220000,0,0,0,0,0,0,-220000
20200212,1515,力山,61.00,62.00,61.00,61.90,+1.10,1.81,403092,300,24885031,126000,40000,86000,0,0,0,1000,1000,0,86000
20200212,1516,川飛,14.85,14.90,14.65,14.65,-0.30,-2.01,55052,43,813865,1000,0,1000,0,0,0,0,0,0,1000
20200212,1517,利奇,8.95,8.96,8.93,8.96,+0.01,0.11,86700,48,775441,0,1000,-1000,0,0,0,0,0,0,-1000
20200212,1519,華城,31.90,32.50,31.15,31.40,+0.05,0.16,3200510,1801,101780262,123000,395000,-272000,0,50000,-50000,0,0,0,-322000
20200212,1521,大億,60.90,61.00,60.70,61.00,+0.10,0.16,28000,22,1705300,2000,1000,1000,0,0,0,0,0,0,1000
20200212,1522,堤維西,25.55,25.55,25.30,25.45,+0.25,0.99,615540,367,15644674,70000,284000,-214000,0,0,0,0,0,0,-214000
20200212,1524,耿鼎,9.40,9.42,9.38,9.40,-0.02,-0.21,407542,74,3832387,0,7000,-7000,0,0,0,0,0,0,-7000
20200212,1525,江申,50.20,51.60,50.10,51.60,+1.20,2.38,31006,29,1573512,1000,0,1000,0,0,0,0,0,0,1000
20200212,1526,日馳,20.25,20.50,20.25,20.40,+0.15,0.74,130235,89,2650342,14000,2000,12000,0,0,0,0,0,0,12000
20200212,1527,鑽全,45.80,45.95,45.65,45.80,+0.15,0.33,598564,439,27424794,60000,403763,-343763,0,0,0,0,0,0,-343763
20200212,1528,恩德,8.08,8.11,8.08,8.08,0.00,0.00,126334,72,1022279,1000,1000,0,0,0,0,0,0,0,0
20200212,1529,樂士,15.00,15.35,14.90,15.25,+0.15,0.99,94330,59,1423164,5000,1000,4000,0,0,0,13000,0,13000,17000
20200212,1530,亞崴,31.00,31.20,31.00,31.20,0.00,0.00,4653,6,144843,0,0,0,0,0,0,0,0,0,0
20200212,1531,高林股,14.55,14.70,14.40,14.55,+0.05,0.34,101562,58,1475167,1000,39000,-38000,0,0,0,0,1000,-1000,-39000
20200212,1532,勤美,28.90,29.00,28.80,28.90,0.00,0.00,100233,73,2895876,10000,20000,-10000,0,0,0,0,0,0,-10000
20200212,1533,車王電,34.60,34.60,34.45,34.55,+0.20,0.58,34056,30,1175802,3000,2000,1000,0,0,0,0,0,0,1000
20200212,1535,中宇,34.20,34.35,34.00,34.20,-0.10,-0.29,27100,23,924720,1000,1000,0,0,0,0,0,0,0,0
20200212,1536,和大,118.00,118.00,116.00,118.00,0.00,0.00,1975141,1573,230883997,354000,154000,200000,0,702000,-702000,49000,21000,28000,-474000
20200212,1537,廣隆,147.50,148.50,147.50,148.00,+0.50,0.34,114170,106,16884243,30000,25000,5000,0,0,0,0,0,0,5000
20200212,1538,正峰新,4.51,4.51,4.36,4.51,0.00,0.00,9422,17,42011,0,0,0,0,0,0,0,0,0,0
20200212,1539,巨庭,18.85,19.15,18.85,19.00,+0.25,1.33,30000,22,571750,2000,2000,0,0,0,0,0,0,0,0
20200212,1540,喬福,18.15,18.30,18.15,18.25,+0.10,0.55,81007,59,1478433,0,0,0,0,0,0,0,0,0,0
20200212,1541,錩泰,37.70,38.70,37.50,37.85,-0.15,-0.39,192001,146,7315288,11000,13000,-2000,0,0,0,0,1000,-1000,-3000
20200212,1558,伸興,129.00,130.00,129.00,129.50,+1.00,0.78,97724,72,12653479,6000,30000,-24000,0,0,0,0,15000,-15000,-39000
20200212,1560,中砂,64.00,64.60,63.90,64.30,+0.60,0.94,307000,254,19743000,100000,100000,0,0,0,0,0,0,0,0
20200212,1568,倉佑,17.70,18.00,17.70,17.85,+0.25,1.42,52237,37,931113,4000,2000,2000,0,0,0,0,0,0,2000
20200212,1582,信錦,85.80,86.50,85.80,86.50,+0.70,0.82,328232,299,28310973,141000,100000,41000,0,0,0,4000,0,4000,45000
20200212,1583,程泰,60.00,60.00,60.00,60.00,-0.20,-0.33,3070,5,184200,0,1000,-1000,0,0,0,0,0,0,-1000
20200212,1587,吉茂,14.20,14.30,13.95,14.00,-0.10,-0.71,106304,40,1489706,0,0,0,0,0,0,0,0,0,0
20200212,1589,永冠-KY,57.20,58.10,57.20,57.80,+0.50,0.87,522135,277,30201465,105000,87000,18000,0,0,0,4000,25000,-21000,-3000
20200212,1590,亞德客-KY,507.00,524.00,507.00,520.00,+6.00,1.17,997092,937,516343748,389355,264229,125126,55000,5000,50000,19000,105000,-86000,89126
20200212,1592,英瑞-KY,13.80,14.40,13.80,14.30,+0.45,3.25,432075,187,6146205,200000,5000,195000,0,0,0,0,0,0,195000
20200212,1598,岱宇,37.00,37.45,36.90,37.25,+0.25,0.68,64400,69,2392967,14000,10000,4000,0,0,0,0,0,0,4000
20200212,1603,華電,27.00,27.00,26.30,26.65,0.00,0.00,42858,26,1137942,1000,3000,-2000,0,0,0,0,1000,-1000,-3000
20200212,1604,聲寶,19.55,19.65,19.50,19.55,0.00,0.00,268770,194,5256735,2000,160000,-158000,0,0,0,15000,0,15000,-143000
20200212,1605,華新,14.20,14.40,14.20,14.25,+0.10,0.71,4921846,1752,70269889,1617000,1347000,270000,0,0,0,377000,466000,-89000,181000
20200212,1608,華榮,9.07,9.10,9.07,9.08,+0.02,0.22,198628,73,1803061,2000,29000,-27000,0,0,0,0,0,0,-27000
20200212,1609,大亞,10.80,10.85,10.65,10.75,0.00,0.00,2818571,795,30286575,599760,628000,-28240,0,0,0,26000,0,26000,-2240
20200212,1611,中電,11.40,11.50,11.40,11.50,+0.05,0.44,516899,276,5924689,49000,11000,38000,0,0,0,0,0,0,38000
20200212,1612,宏泰,10.50,10.60,10.50,10.55,+0.10,0.96,181109,77,1907795,0,10000,-10000,0,0,0,0,0,0,-10000
20200212,1614,三洋電,30.00,30.80,30.00,30.70,+0.70,2.33,139376,67,4249867,18000,6000,12000,0,0,0,0,2000,-2000,10000
20200212,1615,大山,18.80,19.05,18.75,19.05,+0.25,1.33,97000,55,1835250,2000,6000,-4000,0,0,0,0,0,0,-4000
20200212,1616,億泰,4.93,4.98,4.85,4.91,-0.02,-0.41,102000,38,498950,0,1000,-1000,0,0,0,0,0,0,-1000
20200212,1617,榮星,11.60,11.70,11.60,11.70,+0.10,0.86,10000,6,116400,0,0,0,0,0,0,0,0,0,0
20200212,1618,合機,8.70,8.78,8.65,8.69,-0.06,-0.69,268500,76,2329079,0,14000,-14000,0,0,0,1000,0,1000,-13000
20200212,1626,艾美特-KY,26.60,26.75,26.50,26.60,-0.10,-0.37,154100,101,4098630,4000,31000,-27000,0,0,0,0,0,0,-27000
20200212,1701,中化,20.40,20.50,20.10,20.20,-0.20,-0.98,1496621,633,30291501,118000,58000,60000,0,0,0,0,0,0,60000
20200212,1702,南僑,48.85,48.95,48.65,48.80,-0.05,-0.1,535755,412,26136966,155000,307000,-152000,0,0,0,10000,0,10000,-142000
20200212,1707,葡萄王,189.00,190.00,188.50,188.50,0.00,0.00,245951,256,46484641,82000,183000,-101000,0,0,0,9000,0,9000,-92000
20200212,1708,東鹼,24.45,24.45,24.10,24.35,0.00,0.00,501507,283,12181483,21000,26000,-5000,0,0,0,0,0,0,-5000
20200212,1709,和益,13.15,13.30,13.15,13.25,+0.15,1.15,1047878,428,13869337,71000,248000,-177000,0,0,0,0,0,0,-177000
20200212,1710,東聯,19.20,19.45,19.20,19.35,+0.10,0.52,831096,435,16066352,154000,118000,36000,0,0,0,45000,0,45000,81000
20200212,1711,永光,15.15,15.20,15.00,15.15,-0.05,-0.33,234979,146,3555023,39000,5000,34000,0,0,0,0,0,0,34000
20200212,1712,興農,19.15,19.15,19.00,19.00,-0.05,-0.26,515419,253,9835009,4000,201000,-197000,0,0,0,0,0,0,-197000
20200212,1713,國化,18.10,18.10,17.50,17.70,+0.10,0.57,43131,29,762691,1000,1000,0,0,0,0,1000,0,1000,1000
20200212,1714,和桐,7.97,8.08,7.77,7.77,-0.13,-1.65,9167333,2471,71994121,385000,1146000,-761000,0,0,0,13000,85000,-72000,-833000
20200212,1717,長興,27.10,27.10,26.95,27.00,-0.10,-0.37,713588,418,19293076,117000,321000,-204000,0,0,0,63000,0,63000,-141000
20200212,1718,中纖,7.67,7.76,7.67,7.70,+0.03,0.39,1821526,538,14054463,159000,124000,35000,0,0,0,0,0,0,35000
20200212,1720,生達,33.65,33.75,33.55,33.65,0.00,0.00,168059,132,5654036,1000,18000,-17000,0,0,0,0,0,0,-17000
20200212,1721,三晃,10.40,10.55,10.25,10.25,-0.30,-2.84,1048507,256,10796316,0,6000,-6000,0,0,0,1000,0,1000,-5000
20200212,1722,台肥,47.35,48.10,47.35,47.80,+0.45,0.95,1747494,818,83607612,312000,172000,140000,0,0,0,71000,2000,69000,209000
20200212,1723,中碳,118.00,119.00,117.50,118.50,+0.50,0.42,168338,161,19914380,8000,69000,-61000,0,0,0,11000,0,11000,-50000
20200212,1724,台硝,12.85,12.95,12.85,12.95,+0.10,0.78,14058,16,180845,0,0,0,0,0,0,0,0,0,0
20200212,1725,元禎,14.70,14.75,14.70,14.75,+0.05,0.34,16000,7,235250,1000,1000,0,0,0,0,0,0,0,0
20200212,1726,永記,71.10,71.10,70.20,70.40,-0.70,-0.98,22101,22,1567181,5000,5000,0,0,0,0,0,0,0,0
20200212,1727,中華化,11.55,11.60,11.50,11.60,+0.05,0.43,99355,51,1146068,0,0,0,0,0,0,0,0,0,0
20200212,1730,花仙子,75.60,75.80,73.70,74.10,-0.90,-1.2,1362457,1081,101565131,52000,98000,-46000,0,0,0,0,0,0,-46000
20200212,1731,美吾華,13.95,14.10,13.80,13.85,-0.10,-0.72,638500,349,8873119,4000,3000,1000,0,0,0,0,2000,-2000,-1000
20200212,1732,毛寶,21.60,22.30,20.00,20.35,-1.25,-5.79,2364700,1429,49603812,0,4000,-4000,0,0,0,0,0,0,-4000
20200212,1733,五鼎,25.00,25.45,25.00,25.05,+0.15,0.6,212259,108,5329200,52000,37000,15000,0,0,0,2000,4000,-2000,13000
20200212,1734,杏輝,22.20,22.20,21.60,21.65,-0.35,-1.59,931984,599,20278935,6000,8000,-2000,0,0,0,0,0,0,-2000
20200212,1735,日勝化,17.60,17.65,17.60,17.65,+0.10,0.57,9025,5,158888,0,0,0,0,0,0,0,0,0,0
20200212,1736,喬山,74.80,77.50,74.50,76.60,+2.70,3.65,1450309,1119,110852388,439000,150000,289000,0,0,0,66000,8000,58000,347000
20200212,1737,臺鹽,31.80,31.95,31.75,31.90,+0.05,0.16,105636,101,3366224,2000,44000,-42000,0,0,0,0,0,0,-42000
20200212,1760,寶齡富錦,78.90,81.00,78.90,80.10,+1.50,1.91,387111,349,31020585,106000,61000,45000,0,0,0,3000,1000,2000,47000
20200212,1762,中化生,37.85,37.90,37.20,37.20,-0.30,-0.8,664122,486,24894240,36000,39000,-3000,0,0,0,0,0,0,-3000
20200212,1773,勝一,90.30,92.00,90.30,91.80,+1.50,1.66,149058,140,13606928,17000,10000,7000,0,0,0,0,0,0,7000
20200212,1776,展宇,17.75,18.40,17.05,17.55,-0.20,-1.13,128000,85,2264400,2000,1000,1000,0,0,0,3000,0,3000,4000
20200212,1783,和康生,23.00,23.05,22.85,22.95,+0.10,0.44,83004,67,1901100,1000,1000,0,0,0,0,0,0,0,0
20200212,1786,科妍,62.60,64.00,62.60,63.50,+0.40,0.63,161338,150,10251258,63000,4000,59000,0,0,0,0,5000,-5000,54000
20200212,1789,神隆,27.90,28.15,27.80,27.95,+0.20,0.72,1635366,888,45807522,668000,107000,561000,0,0,0,5000,0,5000,566000
20200212,1795,美時,91.40,93.30,91.40,92.70,+1.30,1.42,2115401,1596,196143293,299000,300000,-1000,0,0,0,0,0,0,-1000
20200212,1802,台玻,10.25,10.40,10.25,10.30,+0.05,0.49,875328,421,9018369,254000,213000,41000,0,0,0,106000,0,106000,147000
20200212,1805,寶徠,9.06,9.06,9.00,9.00,-0.03,-0.33,32000,6,288210,0,1000,-1000,0,0,0,0,0,0,-1000
20200212,1806,冠軍,6.12,6.20,6.10,6.10,-0.03,-0.49,126365,65,773697,4000,12000,-8000,0,0,0,0,0,0,-8000
20200212,1808,潤隆,59.80,60.30,59.20,60.00,+0.30,0.5,218266,177,13065960,157000,84000,73000,0,0,0,21000,1000,20000,93000
20200212,1809,中釉,10.00,10.15,9.99,10.10,+0.11,1.1,350797,174,3525381,34000,9000,25000,0,0,0,0,0,0,25000
20200212,1810,和成,7.88,7.94,7.88,7.94,+0.06,0.76,91000,33,719170,0,7000,-7000,0,0,0,0,0,0,-7000
20200212,1817,凱撒衛,33.75,33.95,33.75,33.90,+0.15,0.44,34500,26,1168775,0,3000,-3000,0,0,0,0,0,0,-3000
20200212,1902,台紙,19.85,20.00,19.85,19.85,-0.05,-0.25,294598,148,5865209,30000,47000,-17000,0,0,0,0,0,0,-17000
20200212,1903,士紙,31.55,31.55,31.10,31.40,-0.15,-0.48,28954,24,911147,0,2000,-2000,0,0,0,0,1000,-1000,-3000
20200212,1904,正隆,20.15,20.25,20.00,20.15,+0.10,0.5,2105642,916,42366066,1021000,469000,552000,0,0,0,50000,105000,-55000,497000
20200212,1905,華紙,8.92,8.96,8.85,8.89,-0.02,-0.22,1207642,481,10736426,147000,206000,-59000,0,0,0,0,0,0,-59000
20200212,1906,寶隆,12.90,12.95,12.80,12.95,+0.15,1.17,98000,52,1260350,0,1000,-1000,0,0,0,0,0,0,-1000
20200212,1907,永豐餘,13.50,13.50,13.35,13.40,-0.05,-0.37,2377001,922,31889802,225000,549000,-324000,0,0,0,77000,56000,21000,-303000
20200212,1909,榮成,14.10,14.20,14.00,14.05,-0.05,-0.35,1917006,820,26990028,323000,241000,82000,47000,0,47000,55000,0,55000,184000
20200212,2002,中鋼,23.40,23.45,23.35,23.45,0.00,0.00,5236019,2570,122596182,2027000,2980533,-953533,89000,0,89000,438000,0,438000,-426533
20200212,2002A,中鋼特,55.10,55.10,55.00,55.00,-0.10,-0.18,17100,15,941600,0,0,0,0,0,0,0,0,0,0
20200212,2006,東和鋼鐵,22.70,22.75,22.65,22.70,0.00,0.00,8631784,343,195931633,48000,237000,-189000,0,0,0,54000,0,54000,-135000
20200212,2007,燁興,3.90,3.95,3.90,3.92,+0.02,0.51,38561,26,151227,0,3000,-3000,0,0,0,0,0,0,-3000
20200212,2008,高興昌,,,,,0.00,0.00,266,1,3258,0,0,0,0,0,0,0,0,0,0
20200212,2009,第一銅,8.70,8.71,8.64,8.69,-0.01,-0.11,167672,59,1457524,1000,10000,-9000,0,0,0,0,0,0,-9000
20200212,2010,春源,10.00,10.05,10.00,10.05,0.00,0.00,347022,104,3480318,2000,23000,-21000,0,0,0,0,8000,-8000,-29000
20200212,2012,春雨,19.65,19.80,19.65,19.70,+0.10,0.51,21018,13,414053,0,4000,-4000,0,0,0,0,0,0,-4000
20200212,2013,中鋼構,23.60,23.60,23.35,23.40,-0.10,-0.43,124598,76,2921220,9000,25000,-16000,0,0,0,0,0,0,-16000
20200212,2014,中鴻,9.34,9.45,9.28,9.44,+0.15,1.61,2462620,781,23063949,520000,705000,-185000,0,0,0,60000,0,60000,-125000
20200212,2015,豐興,53.40,53.70,53.20,53.40,0.00,0.00,156484,135,8356945,21000,35000,-14000,0,0,0,30000,0,30000,16000
20200212,2017,官田鋼,6.19,6.47,6.19,6.39,+0.20,3.23,171324,94,1086005,22000,6000,16000,0,0,0,0,0,0,16000
20200212,2020,美亞,15.60,15.70,15.50,15.60,0.00,0.00,294834,92,4586764,4000,54000,-50000,0,0,0,0,0,0,-50000
20200212,2022,聚亨,4.90,4.91,4.86,4.90,+0.02,0.41,274582,94,1340415,1000,11000,-10000,0,0,0,0,0,0,-10000
20200212,2023,燁輝,9.18,9.22,9.18,9.20,+0.02,0.22,671507,292,6176617,118000,100000,18000,0,0,0,2000,0,2000,20000
20200212,2024,志聯,12.00,12.30,12.00,12.30,+0.10,0.82,101790,46,1246534,3000,3000,0,0,0,0,0,0,0,0
20200212,2025,千興,2.00,2.08,2.00,2.05,0.00,0.00,73200,24,149048,0,0,0,0,0,0,0,0,0,0
20200212,2027,大成鋼,29.70,29.95,29.50,29.85,+0.25,0.84,2234769,1096,66574698,796000,186000,610000,0,0,0,103000,318000,-215000,395000
20200212,2028,威致,9.24,9.98,9.24,9.34,+0.14,1.52,76399,47,733876,0,8000,-8000,0,0,0,2000,2000,0,-8000
20200212,2029,盛餘,19.55,19.55,19.50,19.50,0.00,0.00,62800,21,1225660,1000,3000,-2000,0,0,0,1000,0,1000,-1000
20200212,2030,彰源,11.35,11.45,11.35,11.40,0.00,0.00,164025,78,1869028,27000,20000,7000,0,0,0,1000,0,1000,8000
20200212,2031,新光鋼,29.40,29.40,29.00,29.30,0.00,0.00,972960,482,28420003,235000,435000,-200000,0,0,0,18000,9000,9000,-191000
20200212,2032,新鋼,8.83,8.88,8.81,8.87,+0.04,0.45,51181,22,451792,1000,1000,0,0,0,0,0,0,0,0
20200212,2033,佳大,8.96,9.00,8.94,8.94,-0.08,-0.89,31110,17,279571,1000,0,1000,0,0,0,0,0,0,1000
20200212,2034,允強,25.45,25.45,25.30,25.40,-0.05,-0.2,270482,181,6870837,40000,58000,-18000,0,0,0,0,0,0,-18000
20200212,2038,海光,6.88,6.95,6.88,6.95,+0.01,0.14,43000,25,297850,6000,4000,2000,0,0,0,0,0,0,2000
20200212,2049,上銀,311.00,313.00,308.00,310.00,+1.00,0.32,2190763,1811,679119530,492000,782383,-290383,0,10000,-10000,116000,60000,56000,-244383
20200212,2059,川湖,362.00,366.00,360.00,360.50,0.00,0.00,275162,253,99599982,44000,67000,-23000,0,0,0,3000,1000,2000,-21000
20200212,2062,橋椿,24.80,24.80,24.55,24.65,-0.05,-0.2,16500,19,407550,3000,2000,1000,0,0,0,0,0,0,1000
20200212,2069,運錩,16.70,16.75,16.70,16.70,0.00,0.00,64231,31,1074307,0,2000,-2000,0,0,0,0,0,0,-2000
20200212,2101,南港,43.70,45.40,43.70,45.25,+1.25,2.84,1508507,832,67529530,194000,455000,-261000,0,0,0,99000,42000,57000,-204000
20200212,2102,泰豐,11.40,11.55,11.35,11.50,+0.15,1.32,1751520,432,20049673,287000,361000,-74000,0,0,0,0,0,0,-74000
20200212,2103,台橡,21.75,22.25,21.75,22.20,+0.45,2.07,649697,448,14372765,57000,103000,-46000,0,0,0,27000,0,27000,-19000
20200212,2104,國際中橡,,,,,0.00,0.00,0,0,0,0,0,0,0,0,0,0,0,0,0
20200212,2105,正新,39.50,39.65,39.45,39.45,+0.15,0.38,1646452,912,65098912,754000,647179,106821,0,0,0,90000,0,90000,196821
20200212,2106,建大,28.80,28.85,28.65,28.75,-0.05,-0.17,227625,180,6547596,30000,93000,-63000,0,0,0,28000,0,28000,-35000
20200212,2107,厚生,18.35,18.55,18.35,18.50,+0.10,0.54,348667,194,6440517,1000,111000,-110000,0,0,0,0,0,0,-110000
20200212,2108,南帝,29.60,29.80,29.60,29.80,+0.30,1.02,427326,234,12699455,47000,47000,0,0,0,0,14000,0,14000,14000
20200212,2109,華豐,11.00,11.05,11.00,11.05,+0.05,0.45,146792,53,1619362,88000,8000,80000,0,0,0,0,0,0,80000
20200212,2114,鑫永銓,82.50,82.70,82.30,82.70,+0.20,0.24,33710,33,2781742,0,3000,-3000,0,0,0,0,0,0,-3000
20200212,2115,六暉-KY,38.00,38.00,37.50,38.00,+0.50,1.33,37159,26,1407992,0,2000,-2000,0,0,0,0,0,0,-2000
20200212,2201,裕隆,19.65,20.10,19.65,20.05,+0.40,2.04,9025679,2868,180146153,1653000,970000,683000,2000000,0,2000000,165000,193000,-28000,2655000
20200212,2204,中華,35.55,36.00,35.55,35.95,+0.40,1.13,450029,372,16134880,198000,244000,-46000,0,0,0,22000,0,22000,-24000
20200212,2206,三陽工業,20.65,20.75,20.65,20.75,+0.10,0.48,403485,164,8352250,13000,13000,0,0,0,0,0,0,0,0
20200212,2207,和泰車,625.00,640.00,623.00,630.00,+6.00,0.96,340245,315,215185595,264000,200928,63072,0,30000,-30000,17000,2000,15000,48072
20200212,2208,台船,24.60,24.80,24.30,24.50,-0.15,-0.61,1617566,825,39643613,128000,494000,-366000,0,0,0,0,0,0,-366000
20200212,2227,裕日車,264.00,266.00,264.00,265.50,+2.50,0.95,83843,92,22225656,18000,22236,-4236,0,0,0,11000,0,11000,6764
20200212,2228,劍麟,99.30,102.50,99.30,102.00,+2.80,2.82,260306,209,26445924,94000,49000,45000,0,0,0,0,0,0,45000
20200212,2231,為升,216.00,217.00,214.00,217.00,+2.00,0.93,248009,220,53524980,59980,54000,5980,0,0,0,17000,11000,6000,11980
20200212,2233,宇隆,66.20,66.80,66.00,66.80,+0.60,0.91,144214,126,9588452,7000,15000,-8000,0,0,0,0,18000,-18000,-26000
20200212,2236,百達-KY,19.85,19.90,19.80,19.80,0.00,0.00,20001,10,396669,0,0,0,0,0,0,0,0,0,0
20200212,2239,英利-KY,80.50,83.30,80.50,83.00,+2.90,3.62,123033,105,10096612,23000,3000,20000,0,0,0,0,0,0,20000
20200212,2243,宏旭-KY,13.70,14.20,13.65,14.20,+0.50,3.65,22000,15,304600,1000,1000,0,0,0,0,0,0,0,0
20200212,2301,光寶科,47.15,47.40,47.00,47.10,+0.15,0.32,4936792,2025,232703926,2527000,4429527,-1902527,0,0,0,120000,98000,22000,-1880527
20200212,2302,麗正,7.06,7.14,7.06,7.12,+0.06,0.85,54543,35,387334,13000,0,13000,0,0,0,0,0,0,13000
20200212,2303,聯電,16.65,16.95,16.60,16.90,+0.20,1.2,79548774,13223,1338051389,56953000,35958881,20994119,0,3173000,-3173000,1040000,3793000,-2753000,15068119
20200212,2305,全友,5.98,6.03,5.97,6.02,+0.04,0.67,307886,70,1842636,6000,0,6000,0,0,0,0,0,0,6000
20200212,2308,台達電,142.50,145.00,142.00,144.00,+1.50,1.05,6651708,3609,955710452,3675000,5072205,-1397205,2000,0,2000,261000,95000,166000,-1229205
20200212,2312,金寶,14.40,14.60,14.30,14.55,+0.05,0.34,6547015,1913,94465501,695000,950000,-255000,0,0,0,124000,552000,-428000,-683000
20200212,2313,華通,41.90,44.95,41.55,44.60,+2.75,6.57,38585511,17403,1697386145,13652000,5930000,7722000,2158000,55000,2103000,2714000,2298000,416000,10241000
20200212,2314,台揚,21.10,21.70,21.10,21.65,+0.55,2.61,908996,462,19486455,259000,124000,135000,0,0,0,0,0,0,135000
20200212,2316,楠梓電,32.15,33.20,31.85,32.45,+0.75,2.37,3354379,1895,109340933,345000,709000,-364000,0,0,0,491000,32000,459000,95000
20200212,2317,鴻海,83.00,85.60,83.00,85.50,+2.60,3.14,57339491,22018,4848610083,30629358,19169667,11459691,0,456000,-456000,3831000,690000,3141000,14144691
20200212,2321,東訊,1.68,1.70,1.67,1.67,-0.03,-1.76,34899,16,58570,0,0,0,0,0,0,0,0,0,0
20200212,2323,中環,9.13,9.18,9.03,9.05,-0.22,-2.37,16631989,4308,151153557,768000,4037000,-3269000,0,0,0,35000,703000,-668000,-3937000
20200212,2324,仁寶,18.50,18.55,18.45,18.55,+0.15,0.82,8315902,2619,153915089,4245000,4084564,160436,30000,0,30000,151000,216000,-65000,125436
20200212,2327,國巨,447.00,449.00,440.00,448.00,+11.00,2.52,12732741,9810,5666524968,3736000,1342996,2393004,183000,20000,163000,176000,589000,-413000,2143004
20200212,2328,廣宇,20.35,20.90,20.35,20.80,+0.45,2.21,1453956,808,29998871,285000,222000,63000,0,0,0,17000,3000,14000,77000
20200212,2329,華泰,13.40,13.45,13.25,13.40,+0.20,1.52,2029671,749,27176995,534000,161000,373000,0,0,0,154000,36000,118000,491000
20200212,2330,台積電,333.50,336.00,333.00,335.00,+3.50,1.06,37612639,17394,12593082711,21403010,16305102,5097908,136000,125000,11000,1400000,581000,819000,5927908
20200212,2331,精英,11.80,11.95,11.75,11.90,+0.15,1.28,185829,100,2198981,44000,24000,20000,0,0,0,0,0,0,20000
20200212,2332,友訊,13.60,13.70,13.50,13.60,-0.05,-0.37,2771949,803,37667155,280000,383000,-103000,0,0,0,30000,261000,-231000,-334000
20200212,2337,旺宏,39.10,39.40,38.70,38.90,+0.05,0.13,31089916,13134,1212171461,3574000,2804357,769643,0,2621000,-2621000,505000,953000,-448000,-2299357
20200212,2338,光罩,31.00,31.65,30.75,31.25,+0.70,2.29,5477940,2993,171113366,364000,442000,-78000,0,0,0,455000,175000,280000,202000
20200212,2340,光磊,23.20,23.25,22.80,23.05,0.00,0.00,2447464,971,56402328,391950,288000,103950,0,0,0,508000,353000,155000,258950
20200212,2342,茂矽,18.50,18.55,18.10,18.10,+0.10,0.56,479238,328,8785885,13000,123000,-110000,0,0,0,0,0,0,-110000
20200212,2344,華邦電,16.60,16.95,16.55,16.80,+0.40,2.44,38324274,9989,642731240,7396000,14205470,-6809470,100000,1007000,-907000,1034000,355000,679000,-7037470
20200212,2345,智邦,186.00,189.50,181.00,183.00,-1.00,-0.54,10818988,7193,1999065304,3766000,1950353,1815647,167000,0,167000,325000,359000,-34000,1948647
20200212,2347,聯強,37.60,38.00,37.50,37.70,+0.20,0.53,2909230,1237,109777837,1138000,1779087,-641087,0,0,0,332000,105000,227000,-414087
20200212,2348,海悅,54.20,55.00,54.20,54.60,+0.60,1.11,162391,124,8878745,4000,19000,-15000,0,0,0,1000,0,1000,-14000
20200212,2349,錸德,6.00,6.07,5.95,6.01,+0.01,0.17,3534720,976,21244128,1497000,118000,1379000,0,0,0,0,0,0,1379000
20200212,2351,順德,64.10,64.10,63.40,63.40,+0.40,0.63,161023,132,10244755,63000,48000,15000,20000,0,20000,5000,0,5000,40000
20200212,2352,佳世達,20.00,20.10,19.95,20.10,+0.15,0.75,3242365,1148,64891600,821000,924000,-103000,435000,0,435000,62000,0,62000,394000
20200212,2353,宏碁,16.70,17.00,16.70,17.00,+0.40,2.41,6805099,2397,114925987,4250000,2494476,1755524,0,0,0,148000,65000,83000,1838524
20200212,2354,鴻準,60.70,61.40,60.70,61.20,+0.60,0.99,3712937,1764,226872332,1351000,1881162,-530162,0,0,0,47000,2000,45000,-485162
20200212,2355,敬鵬,30.10,30.70,30.05,30.50,+0.45,1.5,1118912,751,34109464,732000,363000,369000,0,0,0,20000,0,20000,389000
20200212,2356,英業達,22.85,23.00,22.85,22.85,0.00,0.00,5799073,1922,132847289,2189000,4317271,-2128271,0,0,0,136000,245000,-109000,-2237271
20200212,2357,華碩,219.00,221.50,218.50,219.50,+0.50,0.23,1272558,922,279658468,670000,1056142,-386142,0,0,0,25000,15000,10000,-376142
20200212,2358,廷鑫,14.05,14.10,13.80,14.00,-0.05,-0.36,195626,110,2719714,14000,8000,6000,0,0,0,0,0,0,6000
20200212,2359,所羅門,19.50,20.25,19.45,20.15,+0.70,3.6,865567,459,17183491,34000,250000,-216000,0,0,0,1000,1000,0,-216000
20200212,2360,致茂,155.00,160.50,154.00,160.00,+8.00,5.26,3804231,2134,600981229,1894853,446736,1448117,0,2000,-2000,212000,31000,181000,1627117
20200212,2362,藍天,32.25,32.60,32.10,32.50,+0.35,1.09,373597,268,12091731,126000,146000,-20000,0,0,0,20000,0,20000,0
20200212,2363,矽統,7.77,8.05,7.77,7.91,+0.20,2.59,4418151,1449,35050596,366000,482000,-116000,0,0,0,0,0,0,-116000
20200212,2364,倫飛,2.02,2.10,2.02,2.10,+0.09,4.48,82301,25,171490,0,0,0,0,0,0,0,0,0,0
20200212,2365,昆盈,7.85,7.90,7.85,7.88,+0.03,0.38,329305,121,2591969,9000,60000,-51000,0,0,0,0,0,0,-51000
20200212,2367,燿華,29.25,30.15,29.10,30.00,+0.55,1.87,12149820,5202,362880900,2085000,1637000,448000,0,0,0,601000,29000,572000,1020000
20200212,2368,金像電,14.95,15.65,14.85,15.50,+0.65,4.38,45610130,10581,702024408,4547000,7179000,-2632000,3248000,0,3248000,1435000,856000,579000,1195000
20200212,2369,菱生,10.25,10.75,10.20,10.55,+0.40,3.94,5668888,1923,59859561,234000,1036000,-802000,0,0,0,11000,12000,-1000,-803000
20200212,2371,大同,21.20,21.60,21.15,21.45,+0.25,1.18,5800430,1758,124281791,3520000,912098,2607902,0,0,0,155000,0,155000,2762902
20200212,2373,震旦行,89.20,89.60,89.00,89.40,+0.40,0.45,40814,44,3643083,9000,5000,4000,0,0,0,7000,0,7000,11000
20200212,2374,佳能,13.95,14.20,13.95,14.10,+0.20,1.44,180557,149,2538598,22000,8000,14000,0,0,0,8000,0,8000,22000
20200212,2375,凱美,40.40,41.50,40.30,41.10,+0.80,1.99,3916194,2375,160291710,618000,210000,408000,0,0,0,103000,64000,39000,447000
20200212,2376,技嘉,56.40,56.80,55.40,56.00,+0.20,0.36,15665008,9238,879128130,4629000,1853000,2776000,501000,0,501000,247000,937000,-690000,2587000
20200212,2377,微星,97.00,97.20,94.10,94.20,-0.30,-0.32,5318063,3620,506272024,1973001,1605661,367340,53000,0,53000,106000,125000,-19000,401340
20200212,2379,瑞昱,248.50,256.50,248.50,252.50,+4.50,1.81,3249950,2432,822802850,1137560,1408977,-271417,81000,203000,-122000,127000,145000,-18000,-411417
20200212,2380,虹光,3.75,3.81,3.70,3.81,+0.05,1.33,137810,156,517398,0,2000,-2000,0,0,0,0,0,0,-2000
20200212,2382,廣達,63.60,64.50,63.60,64.30,+0.50,0.78,5625421,3230,362030844,2491000,2762622,-271622,20000,9000,11000,623000,257000,366000,105378
20200212,2383,台光電,121.50,128.50,121.00,127.50,+7.00,5.81,9581915,5986,1205483705,2746000,1164000,1582000,141000,1000,140000,550000,281000,269000,1991000
20200212,2385,群光,85.30,86.30,84.90,86.10,+0.70,0.82,1633717,1010,140192986,1128000,1181516,-53516,0,0,0,24000,42000,-18000,-71516
20200212,2387,精元,36.00,36.90,35.85,36.70,+0.70,1.94,939204,642,34208295,244000,195000,49000,0,0,0,12000,0,12000,61000
20200212,2388,威盛,30.80,30.80,30.40,30.65,+0.45,1.49,749295,474,22970452,60000,45000,15000,0,0,0,0,0,0,15000
20200212,2390,云辰,10.00,10.20,10.00,10.05,+0.10,1.01,931030,373,9407497,102000,16000,86000,0,0,0,0,0,0,86000
20200212,2392,正崴,38.90,39.30,38.60,39.25,+0.35,0.9,1860144,1179,72714947,263000,364000,-101000,0,0,0,115000,161000,-46000,-147000
20200212,2393,億光,35.50,36.30,35.45,36.10,+0.35,0.98,2425967,1368,87119313,830000,746000,84000,0,0,0,48000,107000,-59000,25000
20200212,2395,研華,305.00,312.00,303.00,309.00,+6.50,2.15,550601,488,170016108,401000,317464,83536,0,0,0,19000,0,19000,102536
20200212,2397,友通,80.30,82.90,80.30,82.60,+2.30,2.86,74020,69,6058652,3000,6000,-3000,0,0,0,0,1000,-1000,-4000
20200212,2399,映泰,11.00,11.25,10.80,11.00,+0.25,2.33,2727634,952,30220557,148000,295000,-147000,0,0,0,0,1000,-1000,-148000
20200212,2401,凌陽,11.90,12.05,11.85,12.00,+0.15,1.27,1064143,418,12741766,452000,152000,300000,0,0,0,17000,10000,7000,307000
20200212,2402,毅嘉,15.15,15.40,15.10,15.30,+0.30,2.0,547483,290,8359402,137000,39000,98000,0,0,0,2000,0,2000,100000
20200212,2404,漢唐,189.00,191.00,188.50,189.00,+1.00,0.53,1254705,998,237820745,506020,436000,70020,0,0,0,45000,87000,-42000,28020
20200212,2405,浩鑫,11.10,11.20,11.05,11.10,-0.15,-1.33,711464,328,7913347,0,18000,-18000,0,0,0,0,0,0,-18000
20200212,2406,國碩,11.90,12.15,11.85,11.95,+0.10,0.84,2045105,758,24498607,145000,248000,-103000,0,0,0,0,0,0,-103000
20200212,2408,南亞科,85.00,85.00,84.40,84.70,-0.40,-0.47,10126549,5760,857075468,3626000,4558267,-932267,198000,1034000,-836000,273000,383000,-110000,-1878267
20200212,2409,友達,11.30,11.35,11.10,11.10,-0.20,-1.77,88115411,13492,986932141,15936300,33306127,-17369827,2866000,0,2866000,1701000,1168000,533000,-13970827
20200212,2412,中華電,109.00,109.00,108.50,108.50,0.00,0.00,6959768,3995,756506712,2413247,3294832,-881585,36000,0,36000,217000,0,217000,-628585
20200212,2413,環科,14.40,14.75,14.30,14.55,+0.40,2.83,193043,145,2810626,10000,11000,-1000,0,0,0,0,1000,-1000,-2000
20200212,2414,精技,22.75,22.90,22.75,22.85,+0.10,0.44,71112,55,1624226,2000,7000,-5000,0,0,0,0,0,0,-5000
20200212,2415,錩新,17.55,17.55,17.50,17.55,+0.05,0.29,16534,19,289894,0,0,0,0,0,0,0,0,0,0
20200212,2417,圓剛,10.30,10.75,10.30,10.60,+0.25,2.42,2619199,997,27618850,22000,14000,8000,0,0,0,0,0,0,8000
20200212,2419,仲琦,23.70,24.05,23.55,24.00,+0.25,1.05,1093124,605,25996736,351000,85660,265340,0,0,0,7000,0,7000,272340
20200212,2420,新巨,36.40,36.45,36.30,36.35,+0.10,0.28,211490,139,7685627,2000,22000,-20000,0,0,0,2000,0,2000,-18000
20200212,2421,建準,41.75,42.30,41.70,41.90,+0.20,0.48,1785859,1136,74910168,330000,634000,-304000,0,0,0,7000,11000,-4000,-308000
20200212,2423,固緯,24.85,25.50,24.75,25.40,+0.55,2.21,344812,253,8628230,41000,6000,35000,0,0,0,0,0,0,35000
20200212,2424,隴華,31.00,31.35,31.00,31.00,+0.50,1.64,8110,9,251966,0,0,0,0,0,0,0,0,0,0
20200212,2425,承啟,30.90,31.40,30.60,30.60,+0.05,0.16,770066,493,23834056,61000,206000,-145000,0,0,0,0,0,0,-145000
20200212,2426,鼎元,13.25,13.30,13.20,13.25,+0.05,0.38,585669,288,7760024,128000,64000,64000,0,0,0,9000,0,9000,73000
20200212,2427,三商電,10.55,10.60,10.55,10.55,-0.05,-0.47,147197,52,1557777,3000,7000,-4000,0,0,0,0,0,0,-4000
20200212,2428,興勤,87.30,89.40,86.60,89.20,+2.60,3.0,770400,657,68100600,292000,91000,201000,0,0,0,21000,0,21000,222000
20200212,2429,銘旺科,34.65,36.00,34.65,34.90,-3.60,-9.35,389016,232,13683763,0,0,0,0,0,0,0,0,0,0
20200212,2430,燦坤,16.30,16.35,16.00,16.35,+0.20,1.24,75349,50,1221238,2000,0,2000,0,0,0,4000,0,4000,6000
20200212,2431,聯昌,9.28,9.43,9.26,9.28,0.00,0.00,540072,190,5019680,49000,428000,-379000,0,0,0,0,0,0,-379000
20200212,2433,互盛電,53.00,53.90,53.00,53.80,+1.40,2.67,94581,92,5069674,7000,3000,4000,0,0,0,4000,0,4000,8000
20200212,2434,統懋,7.10,7.25,7.10,7.13,+0.02,0.28,49478,13,355851,0,0,0,0,0,0,0,0,0,0
20200212,2436,偉詮電,22.80,23.05,22.80,23.00,+0.05,0.22,331307,192,7610611,26000,28000,-2000,0,0,0,5000,0,5000,3000
20200212,2438,翔耀,6.96,7.20,6.80,7.13,+0.13,1.86,115211,34,804787,0,0,0,0,0,0,0,0,0,0
20200212,2439,美律,145.50,150.50,145.50,150.00,+6.50,4.53,7690287,5182,1143529685,2135000,1668000,467000,0,27000,-27000,391000,236000,155000,595000
20200212,2440,太空梭,9.11,9.29,9.06,9.06,-0.24,-2.58,15060,13,137122,0,0,0,0,0,0,2000,0,2000,2000
20200212,2441,超豐,47.00,47.30,47.00,47.15,+0.25,0.53,471621,379,22264079,163000,130000,33000,0,0,0,17000,0,17000,50000
20200212,2442,新美齊,9.63,9.89,9.57,9.82,+0.26,2.72,792595,338,7735497,206000,25000,181000,0,0,0,8000,2000,6000,187000
20200212,2443,億麗,4.01,4.01,3.85,3.92,+0.06,1.55,286688,117,1114466,0,0,0,0,0,0,0,0,0,0
20200212,2444,兆勁,20.15,20.15,19.80,20.15,0.00,0.00,351258,161,7014946,11000,29000,-18000,0,0,0,0,0,0,-18000
20200212,2448,晶電,32.80,33.20,32.75,33.20,+0.30,0.91,16549902,6719,545578582,2122000,1593000,529000,0,2097000,-2097000,434000,120000,314000,-1254000
20200212,2449,京元電子,35.60,36.10,35.20,36.00,+0.40,1.12,12457672,4855,445453042,3213000,3946000,-733000,0,0,0,118000,1297000,-1179000,-1912000
20200212,2450,神腦,31.90,31.90,31.60,31.65,+0.05,0.16,52136,48,1652695,1000,3000,-2000,0,0,0,9000,0,9000,7000
20200212,2451,創見,79.40,81.40,79.30,80.90,+1.80,2.28,1228270,1011,99066809,605000,141118,463882,0,0,0,13000,50000,-37000,426882
20200212,2453,凌群,16.10,16.40,16.05,16.30,+0.25,1.56,494003,253,8035897,66000,46000,20000,0,0,0,0,0,0,20000
20200212,2454,聯發科,398.00,403.50,395.00,401.50,+11.50,2.95,13600808,8503,5440307816,8589951,4496911,4093040,25000,8000,17000,321000,309000,12000,4122040
20200212,2455,全新,110.50,115.50,110.00,115.00,+6.00,5.5,5656487,4048,642071505,631000,607000,24000,446000,0,446000,490000,129000,361000,831000
20200212,2456,奇力新,130.50,132.00,128.00,132.00,+2.00,1.54,11864974,8287,1544616068,887000,720000,167000,137000,0,137000,316046,782000,-465954,-161954
20200212,2457,飛宏,8.51,8.65,8.51,8.57,+0.04,0.47,309756,168,2660421,81000,49000,32000,0,0,0,0,0,0,32000
20200212,2458,義隆,89.70,90.40,88.20,89.60,+2.80,3.23,11930511,7402,1064477612,1177000,3184000,-2007000,194000,0,194000,167000,284000,-117000,-1930000
20200212,2459,敦吉,41.15,41.50,41.10,41.40,+0.25,0.61,125258,111,5170397,9000,8000,1000,0,0,0,1000,0,1000,2000
20200212,2460,建通,9.48,9.50,9.46,9.50,+0.02,0.21,117063,35,1111681,0,1000,-1000,0,0,0,0,0,0,-1000
20200212,2461,光群雷,16.95,16.95,16.55,16.75,+0.20,1.21,422673,250,7053550,48000,40000,8000,0,0,0,1000,0,1000,9000
20200212,2462,良得電,25.95,25.95,25.40,25.75,-0.05,-0.19,31670,35,809332,2000,2000,0,0,0,0,0,0,0,0
20200212,2464,盟立,35.25,35.65,35.25,35.40,+0.35,1.0,703162,373,24918369,130000,187000,-57000,0,0,0,0,0,0,-57000
20200212,2465,麗臺,11.00,11.25,10.75,10.90,+0.05,0.46,433000,241,4741435,0,3000,-3000,0,0,0,0,0,0,-3000
20200212,2466,冠西電,34.15,34.60,34.15,34.60,+0.40,1.17,61229,53,2104077,5000,1000,4000,0,0,0,0,0,0,4000
20200212,2467,志聖,23.15,23.55,23.15,23.45,+0.20,0.86,151065,111,3531845,46000,22000,24000,0,0,0,4000,0,4000,28000
20200212,2468,華經,12.75,12.95,12.75,12.90,+0.15,1.18,164035,90,2106903,4000,4000,0,0,0,0,0,0,0,0
20200212,2471,資通,18.70,18.85,18.70,18.75,+0.05,0.27,82045,67,1539213,2000,4000,-2000,0,0,0,0,0,0,-2000
20200212,2472,立隆電,38.85,39.15,38.85,39.05,+0.20,0.51,365015,249,14250736,89000,27000,62000,0,0,0,3000,1000,2000,64000
20200212,2474,可成,235.50,243.00,235.50,243.00,+8.00,3.4,5223797,3134,1255565969,3359120,1494859,1864261,0,0,0,255000,33000,222000,2086261
20200212,2476,鉅祥,22.35,22.35,22.15,22.35,+0.15,0.68,76691,59,1705123,0,27000,-27000,0,0,0,5000,0,5000,-22000
20200212,2477,美隆電,22.35,23.00,22.35,22.80,+0.25,1.11,73952,58,1682360,13000,5000,8000,0,0,0,5000,0,5000,13000
20200212,2478,大毅,76.40,76.80,74.00,75.40,0.00,0.00,13177274,8722,991015042,651000,656250,-5250,0,0,0,23000,134000,-111000,-116250
20200212,2480,敦陽科,53.50,54.10,53.50,54.00,+0.60,1.12,322874,236,17387596,55000,50000,5000,0,0,0,7000,0,7000,12000
20200212,2481,強茂,24.60,24.95,24.60,24.80,+0.30,1.22,1766633,891,43821756,460000,149000,311000,0,0,0,29000,5000,24000,335000
20200212,2482,連宇,11.70,11.90,11.70,11.85,+0.25,2.16,226800,118,2682050,2000,2000,0,0,0,0,0,0,0,0
20200212,2483,百容,20.00,20.25,20.00,20.20,+0.20,1.0,36050,30,727309,1000,4000,-3000,0,0,0,3000,0,3000,0
20200212,2484,希華,18.55,18.75,18.55,18.70,+0.15,0.81,368872,225,6873992,28000,74000,-46000,0,0,0,0,0,0,-46000
20200212,2485,兆赫,17.75,18.25,17.70,17.95,+0.30,1.7,488805,303,8762205,131000,51000,80000,0,0,0,16000,0,16000,96000
20200212,2486,一詮,8.00,8.00,7.76,7.97,+0.03,0.38,459013,132,3642845,41000,16000,25000,0,0,0,1000,0,1000,26000
20200212,2488,漢平,30.35,30.60,30.35,30.50,+0.15,0.49,130007,98,3961031,28000,8000,20000,0,0,0,0,0,0,20000
20200212,2489,瑞軒,9.70,9.87,9.70,9.86,+0.18,1.86,1478430,611,14518430,298000,349000,-51000,0,0,0,28000,0,28000,-23000
20200212,2491,吉祥全,9.75,10.00,9.68,9.68,+0.09,0.94,259999,38,2542999,0,6000,-6000,0,0,0,0,0,0,-6000
20200212,2492,華新科,242.00,244.00,241.00,242.50,+1.50,0.62,13071004,8252,3168458968,3575516,2466629,1108887,34000,72000,-38000,264000,398000,-134000,936887
20200212,2493,揚博,27.40,27.55,27.35,27.45,+0.15,0.55,99037,77,2715081,10000,26000,-16000,0,0,0,0,0,0,-16000
20200212,2495,普安,12.65,12.70,12.60,12.70,+0.05,0.4,63139,59,800404,4000,6000,-2000,0,0,0,7000,0,7000,5000
20200212,2496,卓越,67.30,68.00,66.90,67.20,0.00,0.00,73029,63,4918316,0,18000,-18000,0,0,0,0,0,0,-18000
20200212,2497,怡利電,18.80,18.80,18.75,18.80,0.00,0.00,55000,22,1033600,2000,0,2000,0,0,0,0,0,0,2000
20200212,2498,宏達電,34.50,34.50,34.05,34.15,+0.15,0.44,3437202,1888,117678720,886879,420000,466879,0,0,0,60000,80000,-20000,446879
20200212,2499,東貝,6.18,6.22,6.15,6.22,+0.05,0.81,673965,261,4168072,114000,33000,81000,0,0,0,0,0,0,81000
20200212,2501,國建,20.80,21.15,20.80,21.05,+0.10,0.48,366374,263,7716154,123000,80000,43000,0,0,0,74000,0,74000,117000
20200212,2504,國產,14.10,14.20,14.05,14.15,+0.05,0.35,4415331,1203,62360541,536000,732000,-196000,0,0,0,219000,76000,143000,-53000
20200212,2505,國揚,18.40,18.50,18.20,18.35,+0.15,0.82,1054880,428,19320052,210000,322774,-112774,0,0,0,161000,5000,156000,43226
20200212,2506,太設,10.10,10.15,10.10,10.15,+0.10,1.0,117032,34,1182820,0,0,0,0,0,0,0,0,0,0
20200212,2509,全坤建,21.50,22.35,21.30,22.35,+0.85,3.95,84218,50,1850735,0,1580,-1580,0,0,0,0,0,0,-1580
20200212,2511,太子,10.80,10.85,10.75,10.85,0.00,0.00,794899,240,8586108,102000,312000,-210000,0,0,0,11000,0,11000,-199000
20200212,2514,龍邦,13.75,13.80,13.70,13.75,0.00,0.00,88071,102,1210347,5000,3000,2000,0,0,0,0,0,0,2000
20200212,2515,中工,7.33,7.35,7.27,7.33,+0.04,0.55,2812928,790,20572015,672000,721000,-49000,0,0,0,24000,0,24000,-25000
20200212,2516,新建,5.70,5.73,5.67,5.68,-0.01,-0.18,424031,55,2412605,1000,3000,-2000,0,0,0,0,0,0,-2000
20200212,2520,冠德,27.40,27.75,27.35,27.65,+0.35,1.28,901030,533,24842977,163000,151000,12000,0,100000,-100000,25000,0,25000,-63000
20200212,2524,京城,32.50,32.95,32.30,32.45,+0.55,1.72,335276,193,10945514,26000,40000,-14000,0,0,0,0,0,0,-14000
20200212,2527,宏璟,20.55,20.55,20.15,20.35,0.00,0.00,134000,63,2709750,3000,7000,-4000,0,0,0,0,0,0,-4000
20200212,2528,皇普,20.35,20.35,20.20,20.20,+0.10,0.5,106999,53,2166979,16000,2000,14000,0,0,0,9000,1000,8000,22000
20200212,2530,華建,16.55,16.65,16.50,16.60,+0.05,0.3,20691,37,343041,1000,7000,-6000,0,0,0,0,0,0,-6000
20200212,2534,宏盛,21.00,21.10,20.90,21.00,+0.10,0.48,1126336,733,23645806,172000,54000,118000,0,0,0,1000,0,1000,119000
20200212,2535,達欣工,21.40,21.40,21.30,21.35,0.00,0.00,763949,326,16316203,20000,133000,-113000,0,0,0,0,30000,-30000,-143000
20200212,2536,宏普,22.75,22.80,22.60,22.70,0.00,0.00,407699,142,9245746,13000,204000,-191000,0,0,0,0,0,0,-191000
20200212,2537,聯上發,10.90,10.90,10.65,10.65,-0.15,-1.39,1690184,560,18124904,5000,339000,-334000,0,0,0,0,0,0,-334000
20200212,2538,基泰,11.65,11.75,11.55,11.70,+0.05,0.43,813141,227,9448974,56000,26000,30000,0,0,0,0,0,0,30000
20200212,2539,櫻花建,29.90,29.95,29.85,29.95,0.00,0.00,95100,47,2842544,0,4000,-4000,0,0,0,0,0,0,-4000
20200212,2540,愛山林,24.20,24.50,24.20,24.50,+0.10,0.41,5058,5,123580,0,0,0,0,0,0,0,0,0,0
20200212,2542,興富發,45.45,45.80,45.45,45.80,+0.45,0.99,1916138,1056,87399919,1248191,832752,415439,0,0,0,72000,21000,51000,466439
20200212,2543,皇昌,7.15,7.15,7.15,7.15,-0.02,-0.28,3006,6,21492,0,0,0,0,0,0,0,0,0,0
20200212,2545,皇翔,35.00,35.05,34.80,34.95,-0.05,-0.14,351060,204,12252764,11000,61000,-50000,0,0,0,0,0,0,-50000
20200212,2546,根基,37.95,38.35,37.95,38.20,+0.25,0.66,56111,53,2137587,2000,5000,-3000,0,0,0,0,0,0,-3000
20200212,2547,日勝生,10.25,10.45,10.20,10.40,+0.20,1.96,1020225,322,10548329,222000,191680,30320,0,0,0,0,0,0,30320
20200212,2548,華固,87.60,88.20,87.60,88.10,+0.60,0.69,527642,417,46402344,164000,238000,-74000,3000,0,3000,22000,8000,14000,-57000
20200212,2597,潤弘,62.60,63.20,62.50,63.10,+0.50,0.8,31001,27,1951663,1000,6000,-5000,0,0,0,1000,0,1000,-4000
20200212,2601,益航,9.60,9.87,9.59,9.74,+0.06,0.62,4001328,1074,39124728,74000,1098000,-1024000,0,0,0,0,8000,-8000,-1032000
20200212,2603,長榮,11.75,11.90,11.70,11.80,+0.15,1.29,10309287,2299,121732460,3832779,1307765,2525014,0,0,0,178000,0,178000,2703014
20200212,2605,新興,13.40,13.75,13.40,13.75,+0.35,2.61,1394053,679,19018065,300000,143000,157000,0,0,0,125000,0,125000,282000
20200212,2606,裕民,29.60,29.85,29.40,29.45,-0.05,-0.17,2238733,1135,66203141,597000,615000,-18000,0,0,0,26000,1000,25000,7000
20200212,2607,榮運,13.60,13.70,13.60,13.70,+0.10,0.74,626368,202,8546902,20000,161000,-141000,0,0,0,0,0,0,-141000
20200212,2608,嘉里大榮,40.80,40.80,40.05,40.05,-0.45,-1.11,197529,166,7970333,60000,54000,6000,0,0,0,27000,0,27000,33000
20200212,2609,陽明,6.48,6.57,6.48,6.53,+0.06,0.93,806624,279,5269027,152000,110000,42000,0,0,0,0,0,0,42000
20200212,2610,華航,8.28,8.40,8.26,8.38,+0.09,1.09,9780785,2027,81664132,3913000,1067259,2845741,0,0,0,221000,43000,178000,3023741
20200212,2611,志信,6.79,6.85,6.74,6.84,+0.09,1.33,378036,104,2573405,7000,1000,6000,0,0,0,0,0,0,6000
20200212,2612,中航,26.70,26.90,26.60,26.90,+0.50,1.89,147717,133,3957622,43000,40000,3000,0,0,0,0,0,0,3000
20200212,2613,中櫃,12.55,12.80,12.55,12.60,0.00,0.00,64549,44,815214,9000,14000,-5000,0,0,0,0,0,0,-5000
20200212,2614,東森,10.70,10.80,10.55,10.60,-0.05,-0.47,1327887,385,14182838,142000,130000,12000,0,0,0,2000,0,2000,14000
20200212,2615,萬海,16.90,17.10,16.90,17.05,+0.10,0.59,1119886,459,19056505,44000,362000,-318000,0,400000,-400000,71000,0,71000,-647000
20200212,2616,山隆,29.85,29.90,29.75,29.75,-0.05,-0.17,66368,91,1979890,0,23000,-23000,0,0,0,0,0,0,-23000
20200212,2617,台航,16.65,16.70,16.60,16.65,0.00,0.00,223157,120,3716914,8000,55000,-47000,0,0,0,6000,0,6000,-41000
20200212,2618,長榮航,12.25,12.40,12.25,12.40,+0.15,1.22,14187131,3133,175312222,5311000,4712622,598378,22000,0,22000,160000,519000,-359000,261378
20200212,2630,亞航,18.05,18.05,18.00,18.00,-0.05,-0.28,12000,9,216300,0,0,0,0,0,0,0,0,0,0
20200212,2633,台灣高鐵,35.80,36.15,35.70,36.00,+0.10,0.28,4795135,2568,172578304,2204000,2879528,-675528,0,0,0,100000,11000,89000,-586528
20200212,2634,漢翔,33.00,33.40,32.80,32.85,-0.10,-0.3,3719450,1693,122957737,193000,2054000,-1861000,0,0,0,30000,38000,-8000,-1869000
20200212,2636,台驊投控,23.05,23.10,23.00,23.00,-0.05,-0.22,106516,92,2451918,1000,6000,-5000,0,0,0,0,0,0,-5000
20200212,2637,慧洋-KY,27.30,27.50,27.25,27.30,+0.05,0.18,1551638,787,42453425,314000,952000,-638000,0,0,0,22000,61000,-39000,-677000
20200212,2642,宅配通,30.35,30.65,29.95,30.00,-0.45,-1.48,925480,663,27941944,45000,214000,-169000,0,0,0,0,0,0,-169000
20200212,2701,萬企,12.90,13.00,12.90,13.00,+0.10,0.78,35794,26,464079,1000,5000,-4000,0,0,0,0,0,0,-4000
20200212,2702,華園,16.35,16.40,16.10,16.35,+0.25,1.55,333585,180,5424999,46000,59000,-13000,0,0,0,0,0,0,-13000
20200212,2704,國賓,25.30,25.45,25.25,25.40,+0.10,0.4,109093,64,2764592,9000,10000,-1000,0,0,0,0,0,0,-1000
20200212,2705,六福,12.75,13.25,12.75,13.25,+0.35,2.71,119902,168,1567147,14000,3900,10100,0,0,0,0,0,0,10100
20200212,2706,第一店,14.95,15.00,14.90,15.00,+0.10,0.67,56999,29,852533,0,7000,-7000,0,0,0,0,0,0,-7000
20200212,2707,晶華,150.00,153.50,149.50,152.00,+2.50,1.67,319615,257,48555595,40000,23000,17000,0,0,0,73000,0,73000,90000
20200212,2712,遠雄來,44.95,44.95,44.15,44.15,-0.25,-0.56,2000,2,89100,0,2000,-2000,0,0,0,0,0,0,-2000
20200212,2722,夏都,25.00,25.25,25.00,25.20,-0.40,-1.56,7416,8,185933,0,0,0,0,0,0,0,0,0,0
20200212,2723,美食-KY,97.60,104.50,97.60,102.50,+5.40,5.56,2106877,1644,215440308,464000,381000,83000,0,0,0,119000,11000,108000,191000
20200212,2727,王品,67.90,69.60,67.90,69.50,+2.40,3.58,715912,619,49350721,22000,58000,-36000,0,0,0,0,0,0,-36000
20200212,2731,雄獅,71.30,72.30,71.10,71.90,+0.60,0.84,341900,269,24521020,32000,30000,2000,0,0,0,0,0,0,2000
20200212,2739,寒舍,21.75,21.90,21.75,21.80,+0.05,0.23,19001,18,414171,0,1000,-1000,0,0,0,0,0,0,-1000
20200212,2748,雲品,44.80,45.30,44.80,45.15,+0.80,1.8,108000,87,4869350,24000,3000,21000,0,1000,-1000,0,0,0,20000
20200212,2801,彰銀,22.85,23.00,22.85,23.00,+0.30,1.32,5597439,2693,128354648,1892000,2558064,-666064,44000,0,44000,277000,30000,247000,-375064
20200212,2809,京城銀,35.95,36.15,35.75,36.00,+0.15,0.42,1460473,672,52595241,245000,238000,7000,0,0,0,51000,0,51000,58000
20200212,2812,台中銀,12.25,12.30,12.20,12.25,0.00,0.00,4421030,1240,54175966,607000,1157000,-550000,19000,0,19000,168000,0,168000,-363000
20200212,2816,旺旺保,20.85,20.85,20.65,20.75,+0.10,0.48,185280,95,3838980,1000,52000,-51000,0,0,0,0,0,0,-51000
20200212,2820,華票,15.40,15.45,15.35,15.35,0.00,0.00,449833,284,6925212,125000,67000,58000,0,0,0,59000,0,59000,117000
20200212,2823,中壽,24.90,25.05,24.90,24.90,+0.05,0.2,5569302,2253,139006448,1237000,1997778,-760778,0,0,0,204000,31000,173000,-587778
20200212,2832,台產,20.70,20.80,20.70,20.75,+0.15,0.73,147102,83,3049051,50000,19000,31000,0,0,0,0,0,0,31000
20200212,2834,臺企銀,12.15,12.20,12.15,12.15,0.00,0.00,20279856,5726,246633675,2344000,10274089,-7930089,37000,0,37000,309000,0,309000,-7584089
20200212,2836,高雄銀,9.88,9.90,9.85,9.85,-0.01,-0.1,310407,185,3061221,2000,91000,-89000,0,0,0,24000,0,24000,-65000
20200212,2838,聯邦銀,11.40,11.40,11.35,11.40,0.00,0.00,1250857,519,14244797,298000,484000,-186000,0,0,0,131000,0,131000,-55000
20200212,2838A,聯邦銀甲特,55.30,55.30,55.20,55.30,+0.10,0.18,27000,11,1491300,0,0,0,0,0,0,0,0,0,0
20200212,2841,台開,7.55,7.62,7.50,7.59,+0.11,1.47,2109080,954,15943285,711000,217000,494000,0,0,0,0,0,0,494000
20200212,2845,遠東銀,11.90,12.00,11.90,11.95,+0.05,0.42,2442659,865,29154990,513000,1017000,-504000,0,0,0,90000,0,90000,-414000
20200212,2849,安泰銀,15.30,15.90,15.30,15.60,+0.30,1.96,93616,79,1458552,6000,17000,-11000,0,0,0,36000,0,36000,25000
20200212,2850,新產,39.45,39.45,39.30,39.35,-0.10,-0.25,131682,113,5183270,34000,38000,-4000,0,0,0,0,0,0,-4000
20200212,2851,中再保,20.00,20.00,19.95,20.00,+0.05,0.25,357171,203,7136174,37000,174000,-137000,0,0,0,0,0,0,-137000
20200212,2852,第一保,14.15,14.15,14.05,14.10,-0.05,-0.35,110061,62,1551825,2000,32000,-30000,0,0,0,0,0,0,-30000
20200212,2855,統一證,14.00,14.05,13.95,14.05,0.00,0.00,649095,199,9094530,137000,204000,-67000,0,0,0,0,0,0,-67000
20200212,2867,三商壽,12.35,12.50,12.30,12.45,+0.15,1.22,4302251,1046,53524047,1281000,432000,849000,0,0,0,108000,100000,8000,857000
20200212,2880,華南金,21.75,21.90,21.75,21.80,+0.05,0.23,8409213,3069,183302781,2970000,4705869,-1735869,66000,0,66000,349000,0,349000,-1320869
20200212,2881,富邦金,46.55,46.65,46.30,46.35,+0.35,0.76,19505418,5633,906755451,12637000,8244476,4392524,54000,0,54000,287000,190000,97000,4543524
20200212,2881A,富邦特,65.50,65.80,65.50,65.80,+0.10,0.15,173059,34,11385958,15000,0,15000,0,0,0,2000,0,2000,17000
20200212,2881B,富邦金乙特,64.90,65.00,64.90,65.00,+0.10,0.15,203697,58,13219993,0,0,0,0,0,0,0,0,0,0
20200212,2882,國泰金,41.90,42.05,41.65,41.80,+0.15,0.36,16604326,6218,695464907,5504968,5046236,458732,62000,0,62000,439000,230000,209000,729732
20200212,2882A,國泰特,64.60,64.70,64.60,64.60,0.00,0.00,25049,18,1618047,0,0,0,0,0,0,23000,0,23000,23000
20200212,2882B,國泰金乙特,64.30,64.50,64.30,64.50,+0.10,0.16,104102,66,6713728,0,0,0,0,0,0,51000,0,51000,51000
20200212,2883,開發金,9.34,9.39,9.34,9.35,-0.01,-0.11,19053392,4604,178524327,3352000,13091607,-9739607,101000,0,101000,578000,60000,518000,-9120607
20200212,2884,玉山金,28.75,28.85,28.70,28.75,0.00,0.00,12898189,4479,371408134,3907100,6899043,-2991943,81000,0,81000,373000,37000,336000,-2574943
20200212,2885,元大金,20.25,20.30,20.05,20.05,-0.25,-1.23,18172156,3946,366251853,4358000,10806075,-6448075,80000,60000,20000,525000,460,524540,-5903535
20200212,2886,兆豐金,32.05,32.25,32.05,32.10,-0.05,-0.16,14634974,3920,470423412,2348000,10149001,-7801001,78000,0,78000,408000,118000,290000,-7433001
20200212,2887,台新金,14.40,14.50,14.35,14.40,0.00,0.00,10941216,2917,157942157,2776000,4135765,-1359765,74000,0,74000,299000,0,299000,-986765
20200212,2887E,台新戊特,56.10,56.20,56.10,56.20,+0.10,0.18,187300,56,10522337,0,0,0,0,0,0,0,0,0,0
20200212,2887F,台新戊特二,54.90,54.90,54.70,54.80,0.00,0.00,54420,62,2976945,0,0,0,0,0,0,0,0,0,0
20200212,2888,新光金,10.00,10.05,9.97,9.98,+0.04,0.4,30363753,4759,303371357,4188000,9618532,-5430532,0,0,0,561000,2210000,-1649000,-7079532
20200212,2888A,新光金甲特,46.05,46.05,46.00,46.00,-0.05,-0.11,112942,44,5199382,0,0,0,0,0,0,0,0,0,0
20200212,2889,國票金,11.70,11.70,11.65,11.70,0.00,0.00,1676792,785,19595665,206000,312000,-106000,0,0,0,115000,0,115000,9000
20200212,2890,永豐金,13.10,13.15,13.05,13.05,-0.05,-0.38,18050899,2559,235996776,5776000,6164180,-388180,77000,4000,73000,320000,0,320000,4820
20200212,2891,中信金,22.50,22.75,22.50,22.65,+0.10,0.44,36229145,7558,819456762,18742000,14256856,4485144,138000,57000,81000,659000,1486000,-827000,3739144
20200212,2891B,中信金乙特,66.20,66.20,66.00,66.20,0.00,0.00,18742,32,1237372,0,15990,-15990,0,0,0,1000,0,1000,-14990
20200212,2891C,中信金丙特,63.60,63.60,63.50,63.60,0.00,0.00,14973,22,950694,0,7956,-7956,0,0,0,1000,0,1000,-6956
20200212,2892,第一金,24.00,24.15,24.00,24.00,-0.10,-0.41,13952022,4383,335433049,2845000,9344718,-6499718,73000,0,73000,348000,0,348000,-6078718
20200212,2897,王道銀行,7.53,7.58,7.51,7.56,+0.03,0.4,754778,326,5684618,29000,155000,-126000,0,0,0,108000,0,108000,-18000
20200212,2897A,王道銀甲特,10.60,10.65,10.60,10.65,+0.05,0.47,9000,5,95550,0,0,0,0,0,0,0,0,0,0
20200212,2901,欣欣,23.90,23.90,23.30,23.85,0.00,0.00,44000,29,1042950,2000,2000,0,0,0,0,0,0,0,0
20200212,2903,遠百,24.45,24.65,24.45,24.55,+0.05,0.2,2278073,456,55847426,336000,1440000,-1104000,0,0,0,56000,0,56000,-1048000
20200212,2904,匯僑,23.25,23.35,23.25,23.30,+0.15,0.65,26001,19,605375,0,0,0,0,0,0,0,0,0,0
20200212,2905,三商,22.40,22.60,22.35,22.45,+0.10,0.45,1056839,440,23727092,276000,55000,221000,0,0,0,28000,6000,22000,243000
20200212,2906,高林,11.20,11.20,11.10,11.10,-0.10,-0.89,109589,10,1216796,0,6000,-6000,0,0,0,0,0,0,-6000
20200212,2908,特力,20.45,20.45,20.25,20.25,-0.10,-0.49,151091,41,3067327,2000,11000,-9000,0,0,0,0,0,0,-9000
20200212,2910,統領,32.95,32.95,32.95,32.95,+1.30,4.11,1004,3,33079,0,0,0,0,0,0,0,0,0,0
20200212,2911,麗嬰房,7.11,7.43,7.10,7.41,+0.30,4.22,522806,218,3787199,8000,5000,3000,0,0,0,0,0,0,3000
20200212,2912,統一超,303.50,305.00,302.00,302.50,-1.00,-0.33,1145669,826,347342029,627516,1034356,-406840,0,0,0,28000,0,28000,-378840
20200212,2913,農林,15.85,16.00,15.85,15.90,-0.05,-0.31,508045,256,8079894,149000,96000,53000,0,0,0,45000,0,45000,98000
20200212,2915,潤泰全,67.40,68.00,67.40,67.80,+0.30,0.44,1409027,1104,95470422,202000,870328,-668328,0,0,0,53000,63000,-10000,-678328
20200212,2923,鼎固-KY,23.70,23.75,23.45,23.45,+0.10,0.43,6100,7,143865,0,0,0,0,0,0,1000,1000,0,0
20200212,2929,淘帝-KY,78.20,79.80,78.20,79.80,+1.60,2.05,994589,451,79152920,62000,178000,-116000,0,0,0,2000,0,2000,-114000
20200212,2936,客思達-KY,19.10,19.10,19.10,19.10,0.00,0.00,1000,1,19100,1000,0,1000,0,0,0,0,0,0,1000
20200212,2939,凱羿-KY,95.00,98.50,94.80,95.90,+0.90,0.95,115010,92,10985251,2000,9000,-7000,0,0,0,0,0,0,-7000
20200212,3002,歐格,10.15,10.25,10.10,10.20,+0.05,0.49,74050,37,753265,1000,3000,-2000,0,0,0,0,0,0,-2000
20200212,3003,健和興,43.00,43.75,42.80,43.50,+0.95,2.23,490114,325,21284719,145000,58000,87000,0,0,0,18000,0,18000,105000
20200212,3004,豐達科,80.20,82.00,80.10,82.00,+1.90,2.37,172051,140,13971706,54000,8000,46000,0,0,0,0,0,0,46000
20200212,3005,神基,50.00,50.40,49.95,50.40,+0.45,0.9,1394192,1003,70018572,706000,187000,519000,0,0,0,312000,135000,177000,696000
20200212,3006,晶豪科,34.60,35.35,34.55,35.15,+0.65,1.88,2001003,1229,70080005,295000,123000,172000,0,0,0,208000,19000,189000,361000
20200212,3008,大立光,4700.00,4840.00,4700.00,4840.00,+150.00,3.2,483132,625,2318883880,274237,107591,166646,0,7000,-7000,32000,8000,24000,183646
20200212,3010,華立,53.90,55.10,53.90,54.90,+0.60,1.1,330902,184,17982936,58000,56000,2000,0,0,0,7000,0,7000,9000
20200212,3011,今皓,6.35,6.35,6.25,6.25,-0.16,-2.5,212005,72,1331940,0,0,0,0,0,0,0,0,0,0
20200212,3013,晟銘電,12.10,12.25,12.10,12.25,+0.15,1.24,164000,87,1997250,21000,10000,11000,0,0,0,0,0,0,11000
20200212,3014,聯陽,41.35,42.10,41.35,41.75,+0.40,0.97,949109,568,39694383,49000,218000,-169000,0,0,0,4000,0,4000,-165000
20200212,3015,全漢,20.50,20.80,20.50,20.75,+0.30,1.47,76030,41,1576272,4000,25000,-21000,0,0,0,0,0,0,-21000
20200212,3016,嘉晶,46.85,48.70,46.70,48.20,+1.70,3.66,2954945,1969,141640145,270000,143000,127000,0,0,0,461000,31000,430000,557000
20200212,3017,奇鋐,33.55,34.20,33.10,33.80,+0.25,0.75,6618613,3641,222774052,1973000,2558000,-585000,0,0,0,169000,51000,118000,-467000
20200212,3018,同開,25.75,26.65,25.00,26.65,+1.00,3.9,2989190,1561,77052878,120000,203000,-83000,0,0,0,0,0,0,-83000
20200212,3019,亞光,86.10,88.90,85.90,88.50,+3.00,3.51,5994386,4262,527130891,213000,1059000,-846000,0,0,0,377000,42000,335000,-511000
20200212,3021,鴻名,15.00,15.35,15.00,15.25,+0.25,1.67,55000,31,835050,9000,0,9000,0,0,0,0,0,0,9000
20200212,3022,威強電,47.70,48.80,47.65,48.50,+0.80,1.68,45260,56,2187458,33000,9000,24000,0,0,0,0,0,0,24000
20200212,3023,信邦,132.50,134.50,131.00,133.50,+1.00,0.75,683913,626,91298342,95000,242000,-147000,0,1000,-1000,37000,99000,-62000,-210000
20200212,3024,憶聲,7.94,7.98,7.93,7.96,+0.02,0.25,272721,81,2166229,34000,18000,16000,0,0,0,0,0,0,16000
20200212,3025,星通,20.60,20.75,20.45,20.75,+0.15,0.73,71008,51,1465860,10000,3000,7000,0,0,0,0,0,0,7000
20200212,3026,禾伸堂,113.50,115.00,112.00,115.00,+2.50,2.22,5854170,4094,665576550,1120000,491000,629000,0,0,0,68000,40000,28000,657000
20200212,3027,盛達,8.02,8.02,7.90,7.98,-0.09,-1.12,151536,79,1201336,4000,3000,1000,0,0,0,0,0,0,1000
20200212,3028,增你強,20.30,20.50,20.30,20.45,+0.15,0.74,154389,92,3149642,6000,3000,3000,0,0,0,0,0,0,3000
20200212,3029,零壹,28.65,28.90,28.60,28.80,+0.25,0.88,437637,331,12604829,75000,48000,27000,0,0,0,0,0,0,27000
20200212,3030,德律,51.90,52.50,51.90,52.20,+0.40,0.77,524260,344,27398593,183000,411000,-228000,0,0,0,7000,0,7000,-221000
20200212,3031,佰鴻,15.10,15.40,15.10,15.20,+0.15,1.0,340843,155,5195712,103000,23000,80000,0,0,0,5000,0,5000,85000
20200212,3032,偉訓,26.30,26.50,26.30,26.40,+0.20,0.76,86017,73,2266142,5000,4000,1000,0,0,0,0,0,0,1000
20200212,3033,威健,17.10,17.30,17.05,17.15,+0.10,0.59,441888,232,7590267,47000,53000,-6000,0,0,0,0,0,0,-6000
20200212,3034,聯詠,219.00,223.00,218.00,220.50,+4.00,1.85,9727023,6256,2146759080,4443991,4014771,429220,232000,174000,58000,435000,347000,88000,575220
20200212,3035,智原,48.50,49.25,48.25,49.25,+1.20,2.5,2475487,1748,120789178,343000,161000,182000,0,0,0,71000,66000,5000,187000
20200212,3036,文曄,37.65,38.20,37.60,38.10,+0.45,1.2,2076346,930,78972310,641000,553000,88000,0,0,0,137000,27000,110000,198000
20200212,3037,欣興,40.60,42.90,40.35,42.85,+2.55,6.33,61654202,25453,2594805074,20014000,4958000,15056000,1215000,468000,747000,2013000,889000,1124000,16927000
20200212,3038,全台,15.50,15.85,15.50,15.80,+0.35,2.27,767100,356,12038819,184000,39000,145000,0,0,0,5000,0,5000,150000
20200212,3040,遠見,28.55,28.55,28.25,28.30,+0.20,0.71,32700,30,927119,0,2000,-2000,0,0,0,0,0,0,-2000
20200212,3041,揚智,15.90,16.30,15.90,16.25,+0.35,2.2,975837,625,15786024,534000,75000,459000,0,0,0,0,0,0,459000
20200212,3042,晶技,42.75,43.30,42.75,43.20,+0.45,1.05,1447272,855,62419221,597000,686000,-89000,0,0,0,39000,21000,18000,-71000
20200212,3043,科風,2.06,2.06,2.05,2.06,-0.04,-1.9,70630,22,145026,0,0,0,0,0,0,0,0,0,0
20200212,3044,健鼎,115.00,123.50,114.00,120.50,+8.00,7.11,6858808,3323,823911798,2641000,2079001,561999,0,0,0,606000,41000,565000,1126999
20200212,3045,台灣大,107.50,108.00,107.00,107.00,-0.50,-0.47,7132170,3051,766595360,1377148,4795280,-3418132,0,0,0,253000,1000,252000,-3166132
20200212,3046,建碁,14.15,14.15,14.00,14.00,+0.20,1.45,11017,28,154721,0,1000,-1000,0,0,0,0,0,0,-1000
20200212,3047,訊舟,9.20,9.32,9.20,9.28,+0.08,0.87,255027,122,2364695,113000,9000,104000,0,0,0,0,0,0,104000
20200212,3048,益登,16.55,16.70,16.50,16.65,+0.15,0.91,308619,220,5118393,73000,28000,45000,0,0,0,0,0,0,45000
20200212,3049,和鑫,12.10,12.30,12.10,12.25,+0.25,2.08,7100710,1681,86543902,1423000,399307,1023693,0,1478000,-1478000,130000,104000,26000,-428307
20200212,3050,鈺德,10.50,10.60,10.50,10.55,+0.05,0.48,218996,82,2306954,41000,4000,37000,0,0,0,0,0,0,37000
20200212,3051,力特,3.37,3.55,3.34,3.43,+0.10,3.0,242002,68,819243,0,0,0,0,0,0,0,0,0,0
20200212,3052,夆典,12.50,12.60,12.45,12.55,+0.10,0.8,437427,176,5480885,47000,73000,-26000,0,0,0,0,0,0,-26000
20200212,3054,立萬利,25.20,25.20,24.90,24.90,0.00,0.00,8002,9,200300,0,3000,-3000,0,0,0,0,0,0,-3000
20200212,3055,蔚華科,32.90,32.90,31.80,32.25,-0.65,-1.98,577289,345,18638816,87000,55000,32000,0,0,0,0,0,0,32000
20200212,3056,總太,31.65,31.85,31.40,31.75,+0.35,1.11,887670,547,28123902,135000,296000,-161000,0,0,0,8000,0,8000,-153000
20200212,3057,喬鼎,6.39,6.40,6.23,6.35,+0.03,0.47,319003,121,2014368,29000,9000,20000,0,0,0,0,0,0,20000
20200212,3058,立德,6.60,6.65,6.56,6.62,+0.02,0.3,328945,73,2173675,1000,3000,-2000,0,0,0,0,0,0,-2000
20200212,3059,華晶科,21.10,21.40,21.10,21.25,+0.25,1.19,439105,274,9354172,137000,62000,75000,0,20000,-20000,0,0,0,55000
20200212,3060,銘異,11.15,11.40,11.15,11.30,+0.15,1.35,224400,154,2527922,31000,6000,25000,0,0,0,3000,0,3000,28000
20200212,3062,建漢,15.65,15.90,15.55,15.80,+0.25,1.61,849465,420,13417310,301000,135000,166000,0,0,0,0,0,0,166000
20200212,3090,日電貿,52.50,53.30,52.00,53.00,+0.80,1.53,5353600,3509,282301799,832000,285000,547000,0,0,0,40000,279000,-239000,308000
20200212,3094,聯傑,18.25,18.70,18.15,18.40,+0.25,1.38,867124,382,15984495,111000,40000,71000,0,0,0,0,0,0,71000
20200212,3130,一零四,153.00,153.00,152.50,153.00,0.00,0.00,17868,34,2733733,0,16000,-16000,0,0,0,0,0,0,-16000
20200212,3149,正達,8.36,8.40,8.23,8.33,+0.03,0.36,259955,130,2160850,46000,3000,43000,0,0,0,0,5000,-5000,38000
20200212,3164,景岳,24.05,24.10,23.85,23.85,-0.20,-0.83,133302,79,3187714,1000,2000,-1000,0,0,0,0,3000,-3000,-4000
20200212,3167,大量,37.90,39.15,37.90,38.95,+1.05,2.77,70100,53,2708294,14000,3000,11000,0,0,0,3000,0,3000,14000
20200212,3189,景碩,51.50,54.00,51.10,52.70,+1.50,2.93,15628656,9148,820437000,5757000,1648000,4109000,239000,226000,13000,1429000,246000,1183000,5305000
20200212,3209,全科,19.70,19.70,19.45,19.60,+0.20,1.03,289049,204,5669505,67000,20000,47000,0,0,0,3000,0,3000,50000
20200212,3229,晟鈦,11.70,12.15,11.55,12.00,+0.40,3.45,72255,36,850484,0,0,0,0,0,0,0,0,0,0
20200212,3231,緯創,28.00,28.30,27.95,28.25,+0.25,0.89,7490928,2579,211205531,4795000,3000921,1794079,0,1000000,-1000000,456000,189000,267000,1061079
20200212,3257,虹冠電,55.50,56.20,55.50,55.70,+0.20,0.36,63984,58,3569399,15000,5000,10000,0,0,0,0,0,0,10000
20200212,3266,昇陽,13.70,14.10,13.70,14.00,+0.35,2.56,169000,39,2363300,5000,2000,3000,0,0,0,0,0,0,3000
20200212,3296,勝德,14.95,15.40,14.95,15.10,+0.10,0.67,159000,16,2384900,0,0,0,0,0,0,0,0,0,0
20200212,3305,昇貿,22.80,22.90,22.75,22.85,+0.10,0.44,91978,71,2097544,7000,29000,-22000,0,0,0,0,0,0,-22000
20200212,3308,聯德,5.73,5.73,5.69,5.69,-0.04,-0.7,3824,9,21868,0,0,0,0,0,0,0,0,0,0
20200212,3311,閎暉,24.70,24.70,24.55,24.70,0.00,0.00,64227,147,1579925,1000,0,1000,0,0,0,0,0,0,1000
20200212,3312,弘憶股,14.10,14.30,14.10,14.25,+0.20,1.42,332780,192,4732886,174000,21000,153000,0,0,0,0,0,0,153000
20200212,3321,同泰,12.05,12.35,12.05,12.20,+0.10,0.83,478718,194,5851679,64000,6000,58000,0,0,0,0,0,0,58000
20200212,3338,泰碩,75.20,76.60,75.20,75.60,0.00,0.00,2953531,1961,224299556,315000,416000,-101000,59000,0,59000,32000,22000,10000,-32000
20200212,3346,麗清,25.80,26.40,25.80,26.40,+0.30,1.15,148000,88,3878750,68000,4000,64000,0,0,0,0,1000,-1000,63000
20200212,3356,奇偶,25.00,25.55,25.00,25.45,+0.55,2.21,201773,159,5117330,76000,8000,68000,0,0,0,0,0,0,68000
20200212,3376,新日興,150.50,151.50,148.00,148.00,-2.50,-1.66,2420700,1831,361599600,227000,440000,-213000,74000,85000,-11000,74000,173000,-99000,-323000
20200212,3380,明泰,20.75,21.20,20.70,21.20,+0.45,2.17,2642527,1144,55440790,628000,455000,173000,0,0,0,226000,115000,111000,284000
20200212,3383,新世紀,5.96,5.96,5.40,5.62,+0.02,0.36,196114,63,1072527,0,0,0,0,0,0,0,0,0,0
20200212,3406,玉晶光,538.00,552.00,536.00,547.00,+16.00,3.01,9995410,7975,5444981270,1015000,1457000,-442000,187000,1000,186000,149000,208000,-59000,-315000
20200212,3413,京鼎,177.50,189.50,177.50,186.00,+10.00,5.68,3815832,3207,707033752,598000,287000,311000,8000,0,8000,285000,37000,248000,567000
20200212,3416,融程電,55.20,55.20,54.80,55.00,+0.10,0.18,33000,21,1813700,2000,0,2000,0,0,0,0,0,0,2000
20200212,3419,譁裕,15.25,15.45,15.25,15.40,+0.25,1.65,158134,113,2430961,37000,14000,23000,0,0,0,0,0,0,23000
20200212,3432,台端,12.10,12.20,12.05,12.05,0.00,0.00,47000,20,569050,0,0,0,0,0,0,0,0,0,0
20200212,3437,榮創,17.20,17.30,17.05,17.25,+0.35,2.07,548354,288,9432717,211000,29000,182000,0,0,0,0,0,0,182000
20200212,3443,創意,245.00,252.00,244.00,249.00,-6.00,-2.35,4210315,3315,1044150120,1094000,1054000,40000,10000,358000,-348000,22000,144000,-122000,-430000
20200212,3450,聯鈞,63.90,66.70,63.70,66.40,+3.20,5.06,5650862,3751,368761516,813000,472000,341000,288000,0,288000,271000,56000,215000,844000
20200212,3454,晶睿,86.00,87.70,86.00,87.10,+1.20,1.4,145461,140,12677519,55000,21000,34000,0,0,0,2000,0,2000,36000
20200212,3481,群創,9.38,9.43,9.32,9.34,-0.03,-0.32,94156397,12114,882099350,44392132,27920347,16471785,1105000,0,1105000,1800000,963000,837000,18413785
20200212,3494,誠研,4.42,4.48,4.38,4.39,-0.10,-2.23,259109,90,1139663,0,1000,-1000,0,0,0,0,0,0,-1000
20200212,3501,維熹,47.00,47.40,47.00,47.40,+0.40,0.85,144358,85,6813826,4000,14000,-10000,0,0,0,1000,0,1000,-9000
20200212,3504,揚明光,71.50,73.00,71.50,72.50,+1.40,1.97,556000,421,40267400,155000,38000,117000,0,0,0,35000,0,35000,152000
20200212,3515,華擎,110.50,112.00,107.50,108.00,-2.50,-2.26,3489642,2605,381372336,271000,431000,-160000,0,290000,-290000,71000,16000,55000,-395000
20200212,3518,柏騰,33.55,34.00,33.20,33.65,+0.15,0.45,497010,286,16744480,66000,92000,-26000,0,0,0,0,1000,-1000,-27000
20200212,3528,安馳,37.90,37.90,37.70,37.80,0.00,0.00,36897,26,1395396,0,4000,-4000,0,0,0,0,0,0,-4000
20200212,3530,晶相光,101.50,103.50,100.00,100.00,0.00,0.00,2533000,1919,257420500,102000,102000,0,0,0,0,86000,22000,64000,64000
20200212,3532,台勝科,115.50,117.00,115.00,116.00,+0.50,0.43,603520,498,69933560,273000,116000,157000,0,0,0,11000,66000,-55000,102000
20200212,3533,嘉澤,328.00,330.50,321.00,321.50,-2.50,-0.77,1407138,1214,456713918,486000,253000,233000,0,141000,-141000,21000,36000,-15000,77000
20200212,3535,晶彩科,19.20,19.35,19.15,19.15,+0.15,0.79,431068,261,8289503,187000,39000,148000,0,0,0,0,0,0,148000
20200212,3536,誠創,5.18,5.18,5.00,5.00,+0.14,2.88,15839,11,79272,0,0,0,0,0,0,0,0,0,0
20200212,3545,敦泰,24.90,26.15,24.85,26.05,+1.25,5.04,3956142,1833,101088656,619000,559000,60000,0,0,0,8000,3000,5000,65000
20200212,3550,聯穎,13.15,13.20,13.05,13.15,0.00,0.00,99000,42,1300450,1000,2000,-1000,0,0,0,0,0,0,-1000
20200212,3557,嘉威,54.00,54.90,51.20,54.00,+4.05,8.11,2787916,1529,150008443,25000,17749,7251,0,0,0,0,0,0,7251
20200212,3563,牧德,419.00,424.50,413.00,413.00,-4.00,-0.96,850335,726,355782195,108000,136000,-28000,35000,0,35000,58000,47000,11000,18000
20200212,3576,聯合再生,7.32,7.33,7.26,7.29,-0.03,-0.41,3244886,903,23683605,264000,54000,210000,0,0,0,0,50000,-50000,160000
20200212,3583,辛耘,57.10,57.70,56.80,57.40,+0.70,1.23,200028,157,11465730,48000,14000,34000,0,0,0,0,0,0,34000
20200212,3588,通嘉,28.05,28.50,28.05,28.25,+0.20,0.71,235007,175,6661146,70000,15000,55000,0,0,0,0,0,0,55000
20200212,3591,艾笛森,11.45,11.55,11.25,11.55,+0.10,0.87,60550,48,692520,2000,2000,0,0,0,0,0,0,0,0
20200212,3593,力銘,8.29,8.29,8.20,8.28,-0.10,-1.19,9570,24,78916,0,0,0,0,0,0,0,0,0,0
20200212,3596,智易,78.50,82.60,78.50,81.80,+3.80,4.87,3943988,2943,320213016,727000,479000,248000,20000,0,20000,448000,137000,311000,579000
20200212,3605,宏致,27.50,28.00,27.45,27.60,+0.15,0.55,949008,506,26344364,171000,150000,21000,0,0,0,3000,0,3000,24000
20200212,3607,谷崧,13.75,14.05,13.75,13.95,+0.20,1.45,287298,161,3974249,47000,2000,45000,0,0,0,0,0,0,45000
20200212,3617,碩天,103.50,105.50,103.50,105.00,+2.00,1.94,190496,166,19949826,16000,40000,-24000,0,0,0,1000,0,1000,-23000
20200212,3622,洋華,19.45,19.50,19.35,19.35,+0.10,0.52,181597,86,3528359,18000,26000,-8000,0,0,0,0,0,0,-8000
20200212,3645,達邁,41.80,43.40,41.80,43.40,+2.25,5.47,1355070,973,58005776,141000,194000,-53000,0,0,0,3000,2000,1000,-52000
20200212,3653,健策,228.00,235.00,226.00,235.00,+8.00,3.52,5929243,4379,1367175234,523000,591000,-68000,504000,0,504000,246000,391000,-145000,291000
20200212,3661,世芯-KY,223.00,229.00,220.50,229.00,+5.00,2.23,11398483,8358,2561245607,2891000,1925000,966000,0,4000,-4000,52000,289000,-237000,725000
20200212,3665,貿聯-KY,207.50,214.50,207.50,214.50,+8.00,3.87,2281675,1859,482745810,389000,348000,41000,5000,0,5000,105000,15000,90000,136000
20200212,3669,圓展,20.90,21.70,20.80,21.60,+0.60,2.86,975001,588,20749720,15000,8000,7000,25000,0,25000,0,0,0,32000
20200212,3673,TPK-KY,46.20,47.50,46.20,47.40,+1.05,2.27,2794507,1850,131502882,1196000,519000,677000,0,0,0,64000,77000,-13000,664000
20200212,3679,新至陞,61.20,63.30,61.10,63.20,+2.20,3.61,129047,109,8007875,16000,22000,-6000,0,0,0,0,0,0,-6000
20200212,3682,亞太電,7.01,7.70,7.01,7.70,+0.70,10.0,8656982,3422,64902677,168000,97000,71000,0,0,0,0,0,0,71000
20200212,3686,達能,4.35,4.35,4.31,4.34,0.00,0.00,28868,114,125077,0,0,0,0,0,0,0,0,0,0
20200212,3694,海華,14.70,15.00,14.70,14.95,+0.25,1.7,99049,67,1478536,2000,4000,-2000,0,0,0,0,0,0,-2000
20200212,3698,隆達,16.35,16.75,16.35,16.65,+0.30,1.83,930553,462,15408105,256000,135000,121000,0,0,0,14000,0,14000,135000
20200212,3701,大眾控,13.60,13.70,13.60,13.70,0.00,0.00,3998,8,54471,0,0,0,0,0,0,0,0,0,0
20200212,3702,大聯大,38.55,38.85,38.35,38.85,+0.30,0.78,3601530,1966,139316410,1819000,1342236,476764,0,0,0,358000,344000,14000,490764
20200212,3702A,大聯大甲特,52.00,52.10,52.00,52.00,0.00,0.00,425000,54,22100700,0,0,0,0,0,0,0,0,0,0
20200212,3703,欣陸,12.50,12.75,12.50,12.70,+0.15,1.2,321418,124,4054186,53000,31000,22000,0,0,0,0,0,0,22000
20200212,3704,合勤控,16.35,16.60,16.25,16.45,+0.25,1.54,1340097,619,22070699,612000,381000,231000,0,0,0,13000,0,13000,244000
20200212,3705,永信,43.60,43.80,43.55,43.60,-0.05,-0.11,211651,137,9248689,5000,15000,-10000,0,0,0,0,0,0,-10000
20200212,3706,神達,28.80,29.60,28.80,29.45,+0.75,2.61,9570852,3586,281034164,1109000,1455000,-346000,0,0,0,425000,11000,414000,68000
20200212,3708,上緯投控,73.20,73.80,72.20,73.10,0.00,0.00,564202,424,41250959,186000,205000,-19000,0,0,0,7000,0,7000,-12000
20200212,3711,日月光投控,76.50,78.50,76.50,77.50,+1.30,1.71,11489747,5623,893418717,6250944,6649231,-398287,356000,229000,127000,468000,430000,38000,-233287
20200212,3712,永崴投控,16.55,17.20,16.50,17.10,+0.50,3.01,625742,338,10457714,177000,18000,159000,0,0,0,0,2000,-2000,157000
20200212,4104,佳醫,52.90,53.00,52.70,52.90,0.00,0.00,209824,188,11095372,0,73516,-73516,0,0,0,0,0,0,-73516
20200212,4106,雃博,24.50,24.80,24.45,24.60,+0.20,0.82,155270,84,3813668,0,1000,-1000,0,0,0,0,0,0,-1000
20200212,4108,懷特,17.10,17.35,17.10,17.25,-0.05,-0.29,231110,141,3978460,0,6000,-6000,0,0,0,0,0,0,-6000
20200212,4119,旭富,116.50,123.50,114.50,116.00,+2.00,1.75,7714649,5766,915859784,962000,342000,620000,192000,0,192000,109000,76000,33000,845000
20200212,4133,亞諾法,31.30,31.90,30.75,30.80,+0.10,0.33,920410,670,28740835,7000,7000,0,0,0,0,0,0,0,0
20200212,4137,麗豐-KY,201.50,205.00,200.00,203.50,+3.50,1.75,955412,847,193774548,245024,347872,-102848,0,0,0,20000,4000,16000,-86848
20200212,4141,龍燈-KY,13.90,13.95,13.85,13.85,-0.05,-0.36,93520,43,1301230,0,16000,-16000,0,0,0,0,0,0,-16000
20200212,4142,國光生,27.65,28.05,27.00,27.00,-0.65,-2.35,13379441,6347,367335994,446000,775000,-329000,0,0,0,1000,1000,0,-329000
20200212,4144,康聯-KY,28.90,28.90,28.55,28.60,-0.30,-1.04,61800,51,1771447,2000,1000,1000,0,0,0,0,0,0,1000
20200212,4148,全宇生技-KY,37.10,37.60,37.10,37.40,+0.40,1.08,41017,36,1535324,2000,4000,-2000,0,0,0,0,0,0,-2000
20200212,4155,訊映,34.00,34.35,33.45,33.75,+0.50,1.5,955550,652,32340761,46000,146000,-100000,0,0,0,0,10000,-10000,-110000
20200212,4164,承業醫,37.10,37.20,36.90,37.00,+0.10,0.27,241274,183,8938075,9000,21000,-12000,0,0,0,0,0,0,-12000
20200212,4190,佐登-KY,90.00,93.50,90.00,93.50,+3.70,4.12,1066000,892,98417700,144000,66000,78000,0,0,0,35000,13000,22000,100000
20200212,4306,炎洲,10.85,11.00,10.80,11.00,+0.15,1.38,486688,213,5318062,96000,61000,35000,0,0,0,0,4000,-4000,31000
20200212,4414,如興,10.00,10.05,9.98,10.05,+0.05,0.5,1055606,376,10561870,401000,102000,299000,0,0,0,0,0,0,299000
20200212,4426,利勤,40.35,40.65,39.90,40.00,+0.05,0.13,586367,423,23514480,110000,336000,-226000,0,0,0,0,0,0,-226000
20200212,4438,廣越,136.00,136.50,135.00,136.50,+2.50,1.87,52106,52,7097658,21000,9000,12000,0,0,0,0,1000,-1000,11000
20200212,4439,冠星-KY,164.50,166.00,164.50,165.00,+1.50,0.92,36000,33,5944000,0,0,0,0,0,0,0,0,0,0
20200212,4526,東台,16.30,16.30,16.20,16.30,0.00,0.00,72145,58,1173776,2000,4000,-2000,0,0,0,0,0,0,-2000
20200212,4532,瑞智,21.00,21.65,21.00,21.60,+0.60,2.86,395151,262,8468683,58000,32000,26000,0,0,0,0,0,0,26000
20200212,4536,拓凱,129.50,131.50,129.50,131.00,+1.50,1.16,56150,56,7326100,12000,14000,-2000,0,0,0,4000,0,4000,2000
20200212,4540,全球傳動,45.55,46.75,45.55,46.40,+0.95,2.09,197290,142,9107742,109000,25000,84000,0,0,0,0,0,0,84000
20200212,4545,銘鈺,22.75,23.60,22.75,23.60,+0.85,3.74,41999,40,964875,19000,4000,15000,0,0,0,0,0,0,15000
20200212,4551,智伸科,172.50,174.00,169.00,170.50,-1.00,-0.58,381092,311,65214232,48000,75000,-27000,0,106000,-106000,56000,4000,52000,-81000
20200212,4552,力達-KY,34.50,35.65,34.50,35.50,+1.05,3.05,213222,180,7509812,44000,26000,18000,0,0,0,0,0,0,18000
20200212,4555,氣立,47.00,47.25,46.65,47.20,0.00,0.00,16000,15,752900,1000,2000,-1000,0,0,0,0,0,0,-1000
20200212,4557,永新-KY,68.90,69.90,68.90,69.60,+0.60,0.87,37009,30,2575730,1000,4000,-3000,0,0,0,0,0,0,-3000
20200212,4560,強信-KY,46.10,46.45,45.95,46.45,+0.45,0.98,156000,132,7202600,83000,106000,-23000,0,0,0,0,0,0,-23000
20200212,4562,穎漢,22.50,25.00,22.35,25.00,+2.25,9.89,77199,53,1845625,3000,1000,2000,0,0,0,0,0,0,2000
20200212,4564,元翎,35.95,37.35,35.90,37.05,+1.30,3.64,1384400,944,50942800,319000,97000,222000,0,0,0,0,0,0,222000
20200212,4566,時碩工業,44.20,45.10,44.00,44.80,+0.80,1.82,291000,208,12986500,97000,16000,81000,0,0,0,3000,0,3000,84000
20200212,4571,鈞興-KY,63.80,64.70,63.80,64.60,+0.60,0.94,32000,20,2060300,1000,0,1000,0,0,0,0,1000,-1000,0
20200212,4572,駐龍,109.50,111.00,109.00,109.00,0.00,0.00,125100,89,13687549,12000,3000,9000,0,0,0,0,0,0,9000
20200212,4576,大銀微系統,80.30,81.50,79.90,80.10,-0.10,-0.12,123215,115,9887881,2000,6000,-4000,0,0,0,0,0,0,-4000
20200212,4720,德淵,13.55,13.60,13.45,13.50,0.00,0.00,12219,11,165634,0,0,0,0,0,0,0,0,0,0
20200212,4722,國精化,26.40,26.65,26.40,26.55,+0.10,0.38,40701,35,1080693,0,0,0,0,0,0,0,0,0,0
20200212,4725,信昌化,11.10,12.00,11.05,12.00,+1.05,9.59,5019399,1924,58804938,1479000,122000,1357000,0,0,0,0,0,0,1357000
20200212,4737,華廣,81.30,82.50,81.30,82.40,+1.20,1.48,97228,73,7971709,13000,8000,5000,0,0,0,0,0,0,5000
20200212,4739,康普,67.80,68.30,67.60,68.20,+0.70,1.04,192970,187,13122749,67000,36000,31000,0,0,0,0,0,0,31000
20200212,4746,台耀,41.50,41.70,40.80,41.20,-0.05,-0.12,563256,429,23191799,22000,163000,-141000,0,0,0,3000,3000,0,-141000
20200212,4755,三福化,46.10,46.70,46.10,46.25,+0.15,0.33,18000,16,832900,1000,2000,-1000,0,0,0,0,0,0,-1000
20200212,4763,材料-KY,127.00,131.00,127.00,129.50,+3.00,2.37,433768,309,56091956,60000,10000,50000,0,0,0,0,0,0,50000
20200212,4764,雙鍵,70.80,71.50,70.50,70.50,+0.20,0.28,125271,65,8857404,3000,4000,-1000,0,0,0,0,0,0,-1000
20200212,4766,南寶,146.00,150.00,146.00,148.50,+2.50,1.71,207086,149,30742770,45000,13000,32000,0,0,0,5000,0,5000,37000
20200212,4807,日成-KY,28.50,28.55,28.40,28.40,+0.05,0.18,11000,9,313500,0,2000,-2000,0,0,0,0,0,0,-2000
20200212,4904,遠傳,67.10,67.40,67.00,67.00,-0.40,-0.59,4411048,2780,296017617,1349000,3662459,-2313459,0,0,0,136000,0,136000,-2177459
20200212,4906,正文,22.40,22.70,22.40,22.60,+0.20,0.89,1620708,754,36536936,436000,482000,-46000,0,0,0,12000,159000,-147000,-193000
20200212,4912,聯德控股-KY,98.80,99.00,98.00,98.50,+0.10,0.1,20395,17,2015561,3395,0,3395,0,0,0,0,0,0,3395
20200212,4915,致伸,52.50,53.10,52.20,52.80,+0.50,0.96,2952576,1653,155372899,366000,1510000,-1144000,0,0,0,28000,6000,22000,-1122000
20200212,4916,事欣科,29.30,29.60,29.25,29.55,+0.35,1.2,215301,147,6337405,43000,22000,21000,0,0,0,0,0,0,21000
20200212,4919,新唐,41.25,41.70,40.95,41.55,+0.60,1.47,615480,439,25454064,111000,70000,41000,0,0,0,12000,23000,-11000,30000
20200212,4927,泰鼎-KY,52.40,53.80,52.30,52.40,+0.40,0.77,13655274,6969,723895685,581000,812000,-231000,81000,0,81000,760000,136000,624000,474000
20200212,4930,燦星網,10.25,10.35,10.25,10.35,0.00,0.00,31497,20,324792,0,0,0,0,0,0,0,0,0,0
20200212,4934,太極,14.80,15.55,14.30,15.20,+0.60,4.11,6155330,2282,93251949,251000,223000,28000,0,0,0,0,0,0,28000
20200212,4935,茂林-KY,136.00,138.00,134.00,136.00,+1.00,0.74,3756737,2548,510929469,147000,351000,-204000,439000,0,439000,340000,122000,218000,453000
20200212,4938,和碩,65.40,66.00,64.80,65.30,-0.20,-0.31,5223695,2880,341621340,2420000,3679548,-1259548,0,442000,-442000,245000,101000,144000,-1557548
20200212,4942,嘉彰,37.00,37.65,37.00,37.40,+0.45,1.22,309300,201,11539960,30000,108000,-78000,0,0,0,0,0,0,-78000
20200212,4943,康控-KY,141.00,146.00,140.50,144.50,+4.00,2.85,2894810,2230,417522760,421000,321000,100000,0,0,0,208000,29000,179000,279000
20200212,4952,凌通,30.00,30.30,30.00,30.20,+0.20,0.67,128000,80,3857050,29000,3000,26000,0,0,0,0,0,0,26000
20200212,4956,光鋐,13.70,13.70,13.35,13.35,-0.15,-1.11,302028,199,4058149,3000,13000,-10000,0,0,0,0,0,0,-10000
20200212,4958,臻鼎-KY,128.50,135.00,126.00,127.00,+2.50,2.01,14160029,8109,1832594183,4292000,5864138,-1572138,207000,304000,-97000,806000,598000,208000,-1461138
20200212,4960,誠美材,7.15,7.17,7.06,7.11,-0.01,-0.14,413550,95,2940925,0,7000,-7000,0,0,0,0,0,0,-7000
20200212,4961,天鈺,33.40,34.20,33.40,33.90,+0.50,1.5,664261,423,22558832,196000,32000,164000,0,0,0,0,0,0,164000
20200212,4967,十銓,34.85,35.60,34.80,35.15,+0.30,0.86,3075907,1561,108325778,228000,200000,28000,200000,0,200000,56000,5000,51000,279000
20200212,4968,立積,159.50,168.50,159.00,163.50,+5.00,3.15,8157726,6064,1344586790,606000,462000,144000,0,0,0,176000,15000,161000,305000
20200212,4976,佳凌,23.30,23.85,23.30,23.60,+0.40,1.72,224600,157,5288799,67000,9000,58000,0,0,0,3000,0,3000,61000
20200212,4977,眾達-KY,112.50,114.50,111.00,113.00,-0.50,-0.44,3644072,2605,411123136,143000,610000,-467000,303000,0,303000,42000,0,42000,-122000
20200212,4989,榮科,20.30,20.70,20.30,20.60,+0.30,1.48,88000,58,1811200,16000,2000,14000,0,0,0,0,2000,-2000,12000
20200212,4994,傳奇,75.10,75.10,74.10,74.50,0.00,0.00,207040,174,15423900,31000,13000,18000,0,0,0,1000,13000,-12000,6000
20200212,4999,鑫禾,39.80,39.95,39.75,39.75,-0.05,-0.13,82301,85,3279071,0,1000,-1000,0,0,0,1000,0,1000,0
20200212,5007,三星,50.10,50.20,50.00,50.20,0.00,0.00,27179,25,1362067,0,5000,-5000,0,0,0,0,0,0,-5000
20200212,5203,訊連,112.00,116.00,111.50,112.00,-1.00,-0.88,777958,599,88262796,33000,131000,-98000,6000,0,6000,42000,10000,32000,-60000
20200212,5215,科嘉-KY,61.20,62.50,60.50,61.80,+1.40,2.32,370469,310,22877296,128000,48000,80000,0,0,0,0,0,0,80000
20200212,5225,東科-KY,46.10,47.05,46.10,46.70,+0.45,0.97,113000,85,5279450,52000,10000,42000,0,0,0,0,0,0,42000
20200212,5234,達興材料,86.30,87.30,85.80,86.60,+0.30,0.35,229349,130,19894163,123000,11000,112000,0,0,0,3000,3000,0,112000
20200212,5243,乙盛-KY,33.95,34.65,33.95,34.60,+0.65,1.91,494050,328,17000069,221000,122000,99000,0,0,0,1000,0,1000,100000
20200212,5258,虹堡,26.80,27.00,26.50,26.70,+0.20,0.75,365200,223,9770950,119000,18000,101000,0,0,0,0,0,0,101000
20200212,5264,鎧勝-KY,40.80,41.45,40.60,41.10,+0.65,1.61,802419,543,32970760,276000,325000,-49000,0,0,0,11000,15000,-4000,-53000
20200212,5269,祥碩,924.00,987.00,922.00,959.00,+49.00,5.38,1820561,1788,1732527755,626000,278000,348000,6000,61000,-55000,56000,48000,8000,301000
20200212,5283,禾聯碩,104.50,105.00,104.00,104.50,0.00,0.00,174812,126,18281164,0,8000,-8000,0,0,0,0,0,0,-8000
20200212,5284,jpp-KY,49.00,49.20,49.00,49.20,+0.20,0.41,10395,5,510034,0,0,0,0,0,0,0,0,0,0
20200212,5285,界霖,59.40,60.40,59.40,59.80,+0.40,0.67,349007,204,20920032,55000,13000,42000,0,0,0,2000,0,2000,44000
20200212,5288,豐祥-KY,116.00,118.00,116.00,116.50,+1.50,1.3,38010,35,4447670,9000,6000,3000,0,0,0,0,0,0,3000
20200212,5305,敦南,41.00,41.00,40.85,40.95,0.00,0.00,406272,195,16624371,20000,52718,-32718,0,0,0,8000,0,8000,-24718
20200212,5388,中磊,74.70,75.50,74.50,74.50,-0.20,-0.27,1105400,743,82989480,338000,503000,-165000,0,2000,-2000,13000,2000,11000,-156000
20200212,5434,崇越,108.50,111.00,107.50,110.50,+2.50,2.31,1456865,1064,160098650,406000,350000,56000,2000,0,2000,57000,1000,56000,114000
20200212,5469,瀚宇博,38.70,39.75,38.50,39.65,+0.95,2.45,5321970,2411,209754302,1435000,251000,1184000,0,0,0,294000,45000,249000,1433000
20200212,5471,松翰,33.85,34.05,33.60,33.70,-0.05,-0.15,483667,349,16325014,41000,135000,-94000,0,0,0,0,0,0,-94000
20200212,5484,慧友,8.90,9.05,8.81,9.03,+0.03,0.33,38568,66,345382,4000,0,4000,0,0,0,0,0,0,4000
20200212,5515,建國,10.00,10.05,9.99,9.99,-0.01,-0.1,384120,177,3840240,0,39000,-39000,0,0,0,0,0,0,-39000
20200212,5519,隆大,14.45,14.65,14.40,14.60,+0.25,1.74,921698,316,13390089,19000,49000,-30000,0,0,0,0,25000,-25000,-55000
20200212,5521,工信,8.51,8.53,8.44,8.50,-0.01,-0.12,852797,332,7245328,62000,188000,-126000,0,0,0,0,0,0,-126000
20200212,5522,遠雄,39.35,39.60,39.20,39.35,+0.60,1.55,1194300,737,47004130,374000,374000,0,0,0,0,50000,115000,-65000,-65000
20200212,5525,順天,20.90,21.15,20.85,21.10,+0.30,1.44,71161,61,1491344,28000,13784,14216,0,0,0,0,0,0,14216
20200212,5531,鄉林,9.40,9.40,9.28,9.35,+0.06,0.65,464181,169,4328198,23000,106000,-83000,0,0,0,2000,0,2000,-81000
20200212,5533,皇鼎,15.80,15.80,15.70,15.75,-0.05,-0.32,77000,15,1216300,0,5000,-5000,0,0,0,0,0,0,-5000
20200212,5534,長虹,82.40,82.90,82.30,82.60,+0.30,0.36,356169,305,29424470,88000,228000,-140000,0,0,0,17000,0,17000,-123000
20200212,5538,東明-KY,32.40,32.60,32.40,32.40,0.00,0.00,19000,13,617800,2000,0,2000,0,1000,-1000,0,0,0,1000
20200212,5607,遠雄港,22.40,22.75,22.30,22.45,+0.20,0.9,1304630,610,29371936,196000,464000,-268000,0,0,0,100000,0,100000,-168000
20200212,5608,四維航,6.91,6.94,6.85,6.90,0.00,0.00,101820,92,701046,3000,12000,-9000,0,0,0,0,0,0,-9000
20200212,5706,鳳凰,36.30,36.90,36.30,36.80,+0.65,1.8,230890,180,8469338,28000,3000,25000,0,0,0,0,0,0,25000
20200212,5871,中租-KY,125.50,127.00,123.50,126.00,0.00,0.00,4532998,2417,567465246,1668130,2655303,-987173,4000,0,4000,55000,0,55000,-928173
20200212,5876,上海商銀,50.70,51.10,50.60,51.00,+0.30,0.59,3600486,1694,183153186,2146000,2137956,8044,0,0,0,150000,65000,85000,93044
20200212,5880,合庫金,21.20,21.30,21.15,21.15,-0.10,-0.47,12300492,3890,260852859,2319150,7059163,-4740013,67000,0,67000,360000,2000,358000,-4315013
20200212,5906,台南-KY,17.85,18.25,17.85,18.15,+0.15,0.83,17823,21,323314,7000,2000,5000,0,0,0,0,0,0,5000
20200212,5907,大洋-KY,21.90,22.65,21.90,22.60,+0.70,3.2,368000,237,8207500,109000,13000,96000,0,0,0,1000,1000,0,96000
20200212,6005,群益證,10.10,10.15,10.05,10.05,-0.05,-0.5,2267714,565,22858416,361000,1469000,-1108000,0,0,0,0,0,0,-1108000
20200212,6024,群益期,42.40,42.70,42.35,42.65,+0.25,0.59,89490,64,3805665,3000,6000,-3000,0,0,0,0,0,0,-3000
20200212,6108,競國,23.25,23.65,23.10,23.65,+0.60,2.6,278655,191,6545665,98000,22000,76000,0,0,0,4000,0,4000,80000
20200212,6112,聚碩,33.20,33.50,33.20,33.35,+0.15,0.45,193122,157,6436867,11000,50000,-39000,0,0,0,0,0,0,-39000
20200212,6115,鎰勝,44.60,45.20,44.60,45.10,+0.60,1.35,182816,118,8218421,23000,1000,22000,0,0,0,5000,0,5000,27000
20200212,6116,彩晶,7.50,7.54,7.45,7.48,0.00,0.00,12004531,2806,89852459,1615000,2683000,-1068000,0,0,0,109000,223000,-114000,-1182000
20200212,6117,迎廣,15.00,15.00,14.70,14.95,-0.05,-0.33,6911,7,102991,0,0,0,0,0,0,0,0,0,0
20200212,6120,達運,14.20,14.40,14.20,14.25,+0.10,0.71,733457,324,10470886,215000,180000,35000,0,0,0,4000,5000,-1000,34000
20200212,6128,上福,29.80,29.95,29.55,29.80,-0.05,-0.17,43353,38,1289631,3000,8000,-5000,0,0,0,3000,0,3000,-2000
20200212,6131,鈞泰,3.20,3.45,3.20,3.25,+0.05,1.56,20003,8,66860,0,0,0,0,0,0,0,0,0,0
20200212,6133,金橋,7.52,7.69,7.52,7.65,+0.15,2.0,126001,44,960158,2000,9000,-7000,0,0,0,2000,0,2000,-5000
20200212,6136,富爾特,19.50,19.55,19.40,19.45,0.00,0.00,61376,60,1196194,0,0,0,0,0,0,3000,0,3000,3000
20200212,6139,亞翔,30.45,31.25,30.35,31.25,+0.90,2.97,895425,586,27504643,181000,106000,75000,0,0,0,31000,4000,27000,102000
20200212,6141,柏承,18.30,18.60,18.30,18.45,+0.35,1.93,611502,314,11271061,242000,88000,154000,0,0,0,0,0,0,154000
20200212,6142,友勁,6.98,7.04,6.98,7.00,0.00,0.00,111155,42,778223,0,5000,-5000,0,0,0,0,0,0,-5000
20200212,6152,百一,6.35,6.45,6.35,6.44,+0.02,0.31,213265,68,1368147,0,11000,-11000,0,0,0,0,0,0,-11000
20200212,6153,嘉聯益,32.05,32.90,32.05,32.40,+0.40,1.25,6283321,3351,204461501,873000,1064000,-191000,0,0,0,208000,246000,-38000,-229000
20200212,6155,鈞寶,26.70,27.40,26.70,27.40,+0.70,2.62,825765,484,22315771,315000,64000,251000,0,0,0,0,6000,-6000,245000
20200212,6164,華興,6.79,6.81,6.76,6.80,+0.01,0.15,86624,43,588279,0,1000,-1000,0,0,0,0,0,0,-1000
20200212,6165,捷泰,21.35,23.10,21.35,23.10,+2.10,10.0,1846744,944,41276145,155000,150000,5000,0,0,0,0,0,0,5000
20200212,6166,凌華,55.50,56.00,55.50,55.90,+0.50,0.9,1442210,965,80466913,725000,151000,574000,0,0,0,10000,5000,5000,579000
20200212,6168,宏齊,11.85,12.25,11.85,12.15,+0.30,2.53,496692,245,5984953,98000,22000,76000,0,0,0,7000,1000,6000,82000
20200212,6172,互億,19.00,19.30,18.90,19.30,+0.25,1.31,155100,40,2974510,0,3000,-3000,0,0,0,0,0,0,-3000
20200212,6176,瑞儀,105.00,105.00,103.50,104.50,0.00,0.00,2669592,1858,278613660,581000,1738000,-1157000,0,0,0,30000,61000,-31000,-1188000
20200212,6177,達麗,27.85,28.05,27.85,27.95,0.00,0.00,309276,180,8646008,47000,31599,15401,0,0,0,0,0,0,15401
20200212,6183,關貿,37.15,40.00,37.15,38.20,+1.05,2.83,468715,344,18012772,14000,17000,-3000,0,0,0,0,33000,-33000,-36000
20200212,6184,大豐電,42.10,43.00,42.00,42.75,+0.60,1.42,271459,212,11564346,19000,4000,15000,0,0,0,0,0,0,15000
20200212,6189,豐藝,34.20,34.20,34.10,34.15,+0.15,0.44,128001,97,4372581,24000,13000,11000,0,0,0,0,0,0,11000
20200212,6191,精成科,14.65,15.15,14.65,15.10,+0.45,3.07,1856355,682,27718825,243000,114000,129000,0,0,0,6000,18000,-12000,117000
20200212,6192,巨路,74.10,74.10,73.60,73.90,+1.00,1.37,62980,49,4655220,5000,10000,-5000,0,0,0,0,0,0,-5000
20200212,6196,帆宣,85.70,87.00,85.00,85.60,+0.90,1.06,4101435,3056,352502973,601000,530000,71000,0,0,0,63000,18000,45000,116000
20200212,6197,佳必琪,29.55,30.00,29.55,29.75,+0.20,0.68,288439,191,8588763,48000,41000,7000,0,0,0,0,0,0,7000
20200212,6201,亞弘電,34.60,34.80,34.60,34.80,+0.20,0.58,20000,16,694000,1000,0,1000,0,0,0,0,0,0,1000
20200212,6202,盛群,69.70,70.30,69.30,70.00,+0.50,0.72,543274,435,37936580,135000,44000,91000,0,0,0,7000,0,7000,98000
20200212,6205,詮欣,24.20,24.20,24.05,24.10,0.00,0.00,16075,14,387622,0,0,0,0,0,0,0,0,0,0
20200212,6206,飛捷,74.70,75.00,74.30,74.60,-0.10,-0.13,254300,224,18993400,58000,144000,-86000,0,0,0,0,0,0,-86000
20200212,6209,今國光,25.60,26.20,25.55,26.15,+0.80,3.16,643151,415,16720797,210000,23000,187000,0,0,0,4000,0,4000,191000
20200212,6213,聯茂,133.50,145.00,133.50,140.00,+8.00,6.06,12648597,7870,1782102080,1454000,1397000,57000,2314000,0,2314000,652000,674000,-22000,2349000
20200212,6214,精誠,80.00,80.30,79.60,80.00,0.00,0.00,459419,380,36781266,84000,82000,2000,0,0,0,15000,2000,13000,15000
20200212,6215,和椿,13.95,14.10,13.90,14.00,+0.05,0.36,69266,55,969511,2000,6000,-4000,0,0,0,0,0,0,-4000
20200212,6216,居易,27.55,27.55,27.45,27.50,+0.05,0.18,55012,50,1512598,0,1000,-1000,0,0,0,1000,0,1000,0
20200212,6224,聚鼎,63.10,64.00,63.00,63.80,+1.40,2.24,222426,181,14140090,102000,12000,90000,0,0,0,0,0,0,90000
20200212,6225,天瀚,,,,,0.00,0.00,0,0,0,0,0,0,0,0,0,0,0,0,0
20200212,6226,光鼎,7.40,7.65,7.37,7.65,+0.24,3.24,1360153,491,10224471,331000,28000,303000,0,0,0,0,0,0,303000
20200212,6230,超眾,228.00,237.00,228.00,236.50,+6.50,2.83,2265888,1942,528320395,402000,363000,39000,50000,0,50000,169000,235000,-66000,23000
20200212,6235,華孚,11.70,12.10,11.70,11.90,+0.30,2.59,309070,149,3696224,17000,12000,5000,0,0,0,0,0,0,5000
20200212,6239,力成,112.50,115.00,111.50,114.50,+5.00,4.57,11004266,6572,1249811935,5705000,2492439,3212561,295000,0,295000,469000,20000,449000,3956561
20200212,6243,迅杰,9.69,9.70,9.52,9.61,-0.09,-0.93,94081,68,902241,0,0,0,0,0,0,0,0,0,0
20200212,6251,定穎,14.40,15.75,14.40,15.45,+1.05,7.29,16010772,4964,243242221,2273000,745000,1528000,200000,0,200000,1400000,380000,1020000,2748000
20200212,6257,矽格,35.50,36.25,35.45,36.15,+0.85,2.41,4086317,2277,146963435,802000,342000,460000,0,0,0,63000,147000,-84000,376000
20200212,6269,台郡,122.50,122.50,120.00,122.50,+11.00,9.87,28223668,11255,3444460800,7810000,4126000,3684000,2065000,293000,1772000,908000,725000,183000,5639000
20200212,6271,同欣電,151.50,155.50,149.50,150.50,-0.50,-0.33,5489425,3693,834120100,315000,2810000,-2495000,75000,47000,28000,342000,301000,41000,-2426000
20200212,6277,宏正,84.80,85.00,84.50,84.90,-0.10,-0.12,55100,54,4674069,15000,3000,12000,0,0,0,3000,0,3000,15000
20200212,6278,台表科,98.30,100.50,97.30,100.00,+2.40,2.46,6454086,4554,640523800,732000,1572000,-840000,8000,905000,-897000,290000,22000,268000,-1469000
20200212,6281,全國電,67.80,68.20,67.80,68.10,+0.30,0.44,8134,11,554482,0,3000,-3000,0,0,0,0,0,0,-3000
20200212,6282,康舒,23.20,23.30,23.05,23.25,+0.15,0.65,3535057,1320,82046032,1028000,287000,741000,0,0,0,66000,5000,61000,802000
20200212,6283,淳安,25.00,25.60,25.00,25.60,+0.65,2.61,378060,220,9565848,76000,18000,58000,0,0,0,0,0,0,58000
20200212,6285,啟碁,71.30,72.40,71.30,72.20,+0.40,0.56,1079928,702,77949086,197000,296000,-99000,0,1000,-1000,20000,8000,12000,-88000
20200212,6288,聯嘉,25.70,25.95,25.50,25.55,+0.10,0.39,4244105,2201,109129385,231000,775000,-544000,0,0,0,1000,31000,-30000,-574000
20200212,6289,華上,0.90,0.92,0.89,0.89,-0.01,-1.11,51006,17,45900,0,0,0,0,0,0,0,0,0,0
20200212,6405,悅城,13.50,13.70,13.50,13.70,+0.05,0.37,12000,10,163250,0,0,0,0,0,0,0,0,0,0
20200212,6409,旭隼,713.00,737.00,713.00,735.00,+6.00,0.82,43200,48,31543600,26000,22000,4000,0,0,0,3000,0,3000,7000
20200212,6412,群電,58.00,59.80,58.00,59.50,+0.90,1.54,306996,276,18245360,177000,98000,79000,0,0,0,41000,3000,38000,117000
20200212,6414,樺漢,230.00,232.50,228.50,231.00,+2.50,1.09,457444,383,105542226,25000,38000,-13000,24000,0,24000,29000,17000,12000,23000
20200212,6415,矽力-KY,1075.00,1110.00,1060.00,1100.00,+45.00,4.27,792366,750,862568940,374000,321000,53000,9000,110000,-101000,13000,4000,9000,-39000
20200212,6416,瑞祺電通,111.00,115.00,110.50,113.50,+2.00,1.79,1713839,1221,194546222,68000,90000,-22000,0,85000,-85000,8000,9000,-1000,-108000
20200212,6431,光麗-KY,26.95,26.95,26.60,26.60,-0.35,-1.3,14000,13,373000,0,0,0,0,0,0,0,0,0,0
20200212,6442,光聖,37.00,37.20,37.00,37.00,+0.15,0.41,109050,11,4055190,0,0,0,0,0,0,0,0,0,0
20200212,6443,元晶,7.40,7.45,7.36,7.40,+0.03,0.41,1039626,347,7706114,79000,79680,-680,0,0,0,0,0,0,-680
20200212,6449,鈺邦,34.35,34.85,34.35,34.50,+0.30,0.88,114112,109,3946607,28000,23000,5000,0,0,0,1000,1000,0,5000
20200212,6451,訊芯-KY,135.00,142.00,134.50,140.00,+5.00,3.7,4300433,3309,600168266,247000,359000,-112000,129000,0,129000,106000,36000,70000,87000
20200212,6452,康友-KY,227.00,232.00,226.00,228.50,+0.50,0.22,2619588,1955,600455976,305000,405000,-100000,0,0,0,98000,26000,72000,-28000
20200212,6456,GIS-KY,99.50,101.50,99.40,101.50,+2.70,2.73,1746026,1278,176112378,560000,165000,395000,0,0,0,139000,2000,137000,532000
20200212,6464,台數科,115.00,115.00,115.00,115.00,-2.00,-1.71,1000,1,115000,0,0,0,0,0,0,0,0,0,0
20200212,6477,安集,22.45,22.80,22.40,22.55,+0.10,0.45,414025,152,9359266,114000,6000,108000,0,0,0,2000,0,2000,110000
20200212,6491,晶碩,151.50,154.00,151.50,153.00,+3.00,2.0,124054,93,19014897,2000,18000,-16000,0,0,0,0,0,0,-16000
20200212,6504,南六,163.00,166.00,159.00,161.00,0.00,0.00,1951125,1447,316058250,26000,165000,-139000,0,0,0,0,15000,-15000,-154000
20200212,6505,台塑化,88.80,90.10,88.50,90.10,+1.30,1.46,2911495,2034,260459035,1418078,1706223,-288145,0,190000,-190000,271000,120000,151000,-327145
20200212,6525,捷敏-KY,59.60,60.50,59.60,60.10,+0.70,1.18,190992,152,11490319,23000,40000,-17000,0,0,0,0,0,0,-17000
20200212,6531,愛普,103.50,106.00,101.50,104.00,+1.00,0.97,2382872,1637,246538316,77000,264000,-187000,0,0,0,82000,32000,50000,-137000
20200212,6533,晶心科,116.50,119.50,116.50,118.50,+1.00,0.85,543777,426,64449345,173000,40000,133000,0,0,0,0,0,0,133000
20200212,6541,泰福-KY,42.00,42.75,42.00,42.50,+0.50,1.19,221565,161,9398281,73000,58000,15000,0,0,0,0,0,0,15000
20200212,6552,易華電,71.50,72.60,71.40,71.70,+0.20,0.28,813330,597,58566725,253000,61030,191970,0,0,0,1000,1000,0,191970
20200212,6558,興能高,60.00,60.80,59.40,60.40,+0.20,0.33,748300,548,44930639,91000,105000,-14000,0,0,0,0,0,0,-14000
20200212,6573,虹揚-KY,21.10,21.10,20.70,20.90,0.00,0.00,109049,63,2278629,0,7000,-7000,0,0,0,0,0,0,-7000
20200212,6579,研揚,70.30,70.80,70.30,70.80,+0.70,1.0,20000,19,1411500,0,2000,-2000,0,0,0,3000,0,3000,1000
20200212,6581,鋼聯,74.60,76.20,74.60,75.60,+1.00,1.34,20000,19,1510300,1000,3000,-2000,0,0,0,0,0,0,-2000
20200212,6582,申豐,64.20,64.70,63.00,64.20,+1.50,2.39,572402,390,36671086,32000,9000,23000,0,0,0,0,0,0,23000
20200212,6591,動力-KY,50.00,51.20,49.65,50.20,+0.85,1.72,638415,511,32318133,72000,97000,-25000,0,0,0,0,0,0,-25000
20200212,6592,和潤企業,80.90,81.80,80.90,81.40,+0.50,0.62,1004152,694,81661113,16000,80000,-64000,0,0,0,0,0,0,-64000
20200212,6605,帝寶,54.50,55.20,54.50,54.90,+0.40,0.73,75955,74,4169315,6000,17000,-11000,0,0,0,0,0,0,-11000
20200212,6625,必應,40.20,40.20,40.05,40.10,-0.40,-0.99,9050,10,362875,0,0,0,0,0,0,0,0,0,0
20200212,6641,基士德-KY,65.10,66.60,65.10,66.00,+1.00,1.54,66100,34,4365050,5000,0,5000,0,0,0,0,0,0,5000
20200212,6655,科定,40.00,40.20,39.65,40.00,-0.40,-0.99,59059,41,2355560,2000,1000,1000,0,0,0,0,0,0,1000
20200212,6666,羅麗芬-KY,139.00,142.50,139.00,142.50,+4.50,3.26,79006,76,11168866,16000,3000,13000,0,0,0,0,0,0,13000
20200212,6668,中揚光,78.00,79.30,77.80,78.60,+1.00,1.29,747200,618,58740279,70000,69000,1000,0,70000,-70000,0,0,0,-69000
20200212,6669,緯穎,723.00,740.00,714.00,740.00,+17.00,2.35,1461035,1321,1066304900,811226,337096,474130,0,132000,-132000,51000,43000,8000,350130
20200212,6670,復盛應用,200.00,200.50,197.00,199.00,0.00,0.00,610850,498,121566150,281000,124000,157000,0,0,0,12000,25000,-13000,144000
20200212,6671,三能-KY,35.45,35.45,35.00,35.15,-0.35,-0.99,35000,21,1230950,2000,1000,1000,0,0,0,0,0,0,1000
20200212,6672,騰輝電子-KY,81.90,85.30,81.90,84.20,+2.80,3.44,1111012,914,93361123,119000,83000,36000,0,0,0,0,0,0,36000
20200212,6674,鋐寶科技,27.25,27.60,27.25,27.35,+0.15,0.55,54049,28,1479497,2000,3000,-1000,0,0,0,0,1000,-1000,-2000
20200212,6698,旭暉應材,71.10,73.00,71.10,72.10,+1.10,1.55,245050,219,17715124,2000,11000,-9000,6000,0,6000,15000,0,15000,12000
20200212,6706,惠特,107.00,114.50,107.00,113.00,+5.50,5.12,1643638,1342,183156769,63000,137305,-74305,54000,0,54000,81000,36000,45000,24695
20200212,6715,嘉基,109.00,109.00,105.50,106.00,-2.00,-1.85,940460,688,100420450,13000,100000,-87000,77000,0,77000,8000,10000,-2000,-12000
20200212,8011,台通,15.30,15.55,15.30,15.50,+0.15,0.98,359462,179,5546943,21000,23000,-2000,0,0,0,0,0,0,-2000
20200212,8016,矽創,158.00,166.50,157.00,166.50,+9.50,6.05,2871198,2208,469323066,509000,174000,335000,249000,0,249000,307000,18000,289000,873000
20200212,8021,尖點,20.30,20.65,20.30,20.55,+0.40,1.99,574927,358,11778037,166000,102000,64000,0,0,0,5000,0,5000,69000
20200212,8028,昇陽半導體,65.80,66.50,65.30,65.50,+0.40,0.61,1510203,1115,99408698,190000,374000,-184000,0,0,0,21000,55000,-34000,-218000
20200212,8033,雷虎,9.04,9.06,9.02,9.05,-0.01,-0.11,87018,58,786642,7000,1000,6000,0,0,0,0,0,0,6000
20200212,8039,台虹,43.30,44.20,43.30,44.10,+1.00,2.32,4420631,2225,193786935,787000,1349000,-562000,0,0,0,173000,41000,132000,-430000
20200212,8046,南電,44.80,47.40,44.80,47.00,+1.95,4.33,9017095,5423,420382315,1806000,1266000,540000,981000,0,981000,362000,390000,-28000,1493000
20200212,8070,長華,163.00,166.50,163.00,166.00,+3.50,2.15,137055,113,22622547,13000,5000,8000,0,0,0,1000,25000,-24000,-16000
20200212,8072,陞泰,20.10,20.20,20.05,20.10,-0.05,-0.25,52940,44,1064141,2000,0,2000,0,0,0,0,0,0,2000
20200212,8081,致新,119.00,121.50,119.00,120.00,-0.50,-0.41,1224631,877,147168851,95000,270000,-175000,70000,0,70000,1000,69000,-68000,-173000
20200212,8101,華冠,6.61,6.66,6.42,6.48,-0.02,-0.31,667074,213,4349626,20000,41000,-21000,0,0,0,0,0,0,-21000
20200212,8103,瀚荃,24.05,24.25,23.90,24.25,+0.45,1.89,74174,64,1788598,14000,1000,13000,0,0,0,1000,0,1000,14000
20200212,8104,錸寶,43.95,45.55,43.95,45.10,+1.30,2.97,195397,176,8740962,53000,12000,41000,0,0,0,0,0,0,41000
20200212,8105,凌巨,12.25,12.40,12.20,12.25,+0.05,0.41,746000,340,9176400,235000,116000,119000,0,0,0,14000,0,14000,133000
20200212,8110,華東,10.95,11.10,10.90,10.95,+0.05,0.46,579021,234,6355331,103000,95000,8000,0,0,0,14000,14000,0,8000
20200212,8112,至上,31.05,31.65,31.05,31.55,+0.50,1.61,1890332,1209,59430630,731000,241000,490000,0,0,0,11000,0,11000,501000
20200212,8114,振樺電,101.00,102.50,101.00,102.00,+2.00,2.0,100150,78,10153300,43000,6000,37000,0,0,0,1000,0,1000,38000
20200212,8131,福懋科,41.00,41.00,39.70,40.30,-0.10,-0.25,2947807,1773,118560355,163000,658000,-495000,0,0,0,19000,58000,-39000,-534000
20200212,8150,南茂,30.70,30.90,30.40,30.75,0.00,0.00,3827225,2140,117517746,1094000,2133000,-1039000,0,0,0,62000,172000,-110000,-1149000
20200212,8163,達方,38.20,38.55,38.20,38.35,+0.40,1.05,1377348,883,52895872,384000,308000,76000,0,0,0,30000,17000,13000,89000
20200212,8201,無敵,9.10,9.23,9.10,9.15,+0.05,0.55,41400,25,378220,1000,0,1000,0,0,0,0,0,0,1000
20200212,8210,勤誠,98.20,99.00,95.80,97.30,-0.40,-0.41,1561320,1142,152048123,388000,285000,103000,0,50000,-50000,21000,16000,5000,58000
20200212,8213,志超,33.30,33.65,33.15,33.55,+0.55,1.67,1140263,677,38188430,289000,239000,50000,0,0,0,0,0,0,50000
20200212,8215,明基材,18.25,18.25,18.00,18.15,0.00,0.00,1261435,538,22862303,241000,228000,13000,0,0,0,1000,0,1000,14000
20200212,8222,寶一,17.40,17.45,17.25,17.40,+0.20,1.16,20061,29,348917,0,0,0,0,0,0,0,0,0,0
20200212,8249,菱光,22.00,22.90,21.95,22.05,+0.55,2.56,1484110,890,33226484,25000,161000,-136000,0,0,0,0,0,0,-136000
20200212,8261,富鼎,25.25,25.90,25.25,25.75,+0.55,2.18,341799,232,8761005,140000,9000,131000,0,0,0,0,0,0,131000
20200212,8271,宇瞻,42.90,44.00,42.90,44.00,+1.45,3.41,1790500,1277,77826686,415000,86000,329000,0,0,0,0,35000,-35000,294000
20200212,8341,日友,267.50,268.00,262.00,262.50,-2.50,-0.94,155755,180,41118065,26010,31000,-4990,0,0,0,3000,0,3000,-1990
20200212,8367,建新國際,25.85,26.00,25.60,25.65,+0.20,0.79,63000,42,1621400,7000,4000,3000,0,0,0,0,0,0,3000
20200212,8374,羅昇,20.80,20.80,20.10,20.30,-0.05,-0.25,101400,55,2070718,1000,2000,-1000,0,0,0,0,0,0,-1000
20200212,8404,百和興業-KY,44.50,44.65,44.05,44.50,+0.50,1.14,256567,208,11373207,119000,103000,16000,0,0,0,0,0,0,16000
20200212,8411,福貞-KY,13.25,13.30,13.20,13.30,+0.05,0.38,58412,32,774518,0,4000,-4000,0,0,0,0,0,0,-4000
20200212,8422,可寧衛,158.00,158.00,157.50,158.00,+0.50,0.32,107459,102,16953748,8000,36000,-28000,0,0,0,4000,0,4000,-24000
20200212,8427,基勝-KY,49.10,49.10,48.50,48.50,-0.50,-1.02,3000,2,146100,0,1000,-1000,0,0,0,0,0,0,-1000
20200212,8429,金麗-KY,9.59,9.75,9.58,9.73,+0.17,1.78,231331,145,2239480,49000,4000,45000,0,0,0,0,0,0,45000
20200212,8442,威宏-KY,53.40,53.60,52.80,53.00,+0.10,0.19,51000,44,2701700,1000,15000,-14000,0,0,0,0,0,0,-14000
20200212,8443,阿瘦,10.75,10.80,10.75,10.80,+0.05,0.47,8601,19,92896,0,0,0,0,0,0,0,0,0,0
20200212,8454,富邦媒,319.50,319.50,317.00,318.50,-1.00,-0.31,31080,35,9879600,9000,14000,-5000,0,0,0,7000,0,7000,2000
20200212,8462,柏文,173.00,177.50,172.50,174.00,+1.00,0.58,138163,257,24208025,16000,27000,-11000,0,0,0,0,1000,-1000,-12000
20200212,8463,潤泰材,41.60,41.60,40.70,41.10,-0.05,-0.12,180105,143,7397809,45000,81000,-36000,0,0,0,0,0,0,-36000
20200212,8464,億豐,259.00,261.00,256.50,256.50,-3.50,-1.35,1003353,793,259796749,367000,875272,-508272,0,0,0,12000,0,12000,-496272
20200212,8466,美吉吉-KY,66.20,66.60,66.20,66.40,+0.20,0.3,19000,15,1260400,0,1000,-1000,0,0,0,0,0,0,-1000
20200212,8467,波力-KY,52.00,53.90,52.00,52.60,+1.70,3.34,26000,23,1380200,1000,2000,-1000,0,0,0,0,0,0,-1000
20200212,8473,山林水,45.80,46.45,45.70,46.10,+0.30,0.66,61271,59,2814203,9000,2000,7000,0,0,0,0,0,0,7000
20200212,8478,東哥遊艇,41.45,41.80,41.45,41.80,+0.25,0.6,17000,17,706400,2000,4000,-2000,0,0,0,0,0,0,-2000
20200212,8480,泰昇-KY,135.50,136.50,135.00,136.00,-0.50,-0.37,22072,17,3001292,6000,1000,5000,0,2000,-2000,0,0,0,3000
20200212,8481,政伸,57.30,59.20,57.30,58.90,+1.60,2.79,58386,30,3392274,49000,3000,46000,0,0,0,0,0,0,46000
20200212,8482,商億-KY,149.50,150.00,149.50,149.50,-0.50,-0.33,71000,53,10643500,66000,25000,41000,0,0,0,0,0,0,41000
20200212,8488,吉源-KY,16.70,16.75,16.70,16.75,+0.05,0.3,2000,2,33450,0,0,0,0,0,0,0,0,0,0
20200212,8497,格威傳媒,55.00,56.10,55.00,55.80,+0.80,1.45,68200,51,3781060,1000,1000,0,0,0,0,0,0,0,0
20200212,8499,鼎炫-KY,95.00,97.60,94.40,96.30,+1.30,1.37,107200,99,10310300,29000,2000,27000,0,0,0,0,0,0,27000
20200212,8926,台汽電,34.00,34.15,33.60,33.95,-0.15,-0.44,1853999,1019,62856347,305000,318000,-13000,0,0,0,151000,0,151000,138000
20200212,8940,新天地,10.60,10.70,10.60,10.60,0.00,0.00,15472,27,164796,0,1000,-1000,0,0,0,0,0,0,-1000
20200212,8996,高力,72.20,74.70,72.20,73.70,+1.50,2.08,5227636,3453,384683568,690000,435000,255000,0,0,0,21000,0,21000,276000
20200212,9103,美德醫療-DR,4.89,4.89,4.89,4.89,+0.44,9.89,3456000,627,16899840,0,0,0,0,0,0,0,0,0,0
20200212,910322,康師傅-DR,28.20,29.25,28.20,28.50,+0.40,1.42,83000,29,2399300,13000,37000,-24000,0,0,0,0,0,0,-24000
20200212,910482,聖馬丁-DR,0.35,0.36,0.34,0.36,+0.01,2.86,262010,29,91033,0,0,0,0,0,0,0,0,0,0
20200212,9105,泰金寶-DR,3.62,3.62,3.54,3.60,-0.18,-4.76,6526660,541,23334725,0,1130000,-1130000,0,0,0,0,0,0,-1130000
20200212,910861,神州-DR,7.46,7.54,7.40,7.52,+0.10,1.35,27000,9,200480,6000,3000,3000,0,0,0,0,0,0,3000
20200212,9110,越南控-DR,1.65,1.73,1.65,1.73,0.00,0.00,37000,15,63670,0,0,0,0,0,0,0,0,0,0
20200212,911608,明輝-DR,1.52,1.52,1.52,1.52,0.00,0.00,161000,38,244720,0,0,0,0,0,0,0,0,0,0
20200212,911616,杜康-DR,1.20,1.20,1.15,1.15,+0.02,1.77,19000,6,22180,0,0,0,0,0,0,0,0,0,0
20200212,911622,泰聚亨-DR,,,,,0.00,0.00,0,0,0,0,0,0,0,0,0,0,0,0,0
20200212,911868,同方友友-DR,1.03,1.16,1.03,1.16,+0.10,9.43,862000,133,986190,0,60000,-60000,0,0,0,0,0,0,-60000
20200212,912000,晨訊科-DR,1.99,2.10,1.99,2.10,+0.19,9.95,125000,18,261730,0,0,0,0,0,0,0,0,0,0
20200212,912398,友佳-DR,3.38,3.47,3.36,3.44,-0.01,-0.29,29000,12,98060,0,0,0,0,0,0,0,0,0,0
20200212,9136,巨騰-DR,7.05,7.08,7.00,7.08,-0.03,-0.42,67000,36,471100,0,43000,-43000,0,0,0,0,0,0,-43000
20200212,9188,精熙-DR,3.04,3.05,3.03,3.03,0.00,0.00,154000,35,468490,0,116000,-116000,0,0,0,0,0,0,-116000
20200212,9802,鈺齊-KY,125.00,129.50,125.00,128.50,+3.50,2.8,1119735,945,143533315,130000,309000,-179000,314000,0,314000,41000,14000,27000,162000
20200212,9902,台火,9.60,9.64,9.52,9.55,+0.03,0.32,148589,84,1422576,3000,9000,-6000,0,0,0,0,0,0,-6000
20200212,9904,寶成,34.85,35.15,34.80,34.90,+0.05,0.14,5782527,3093,202242845,1716000,4666867,-2950867,20000,0,20000,127000,1000,126000,-2804867
20200212,9905,大華,24.00,24.00,23.80,23.85,-0.05,-0.21,183212,135,4370478,7000,44000,-37000,0,0,0,0,0,0,-37000
20200212,9906,欣巴巴,20.75,20.80,20.70,20.80,+0.10,0.48,20391,18,423493,1000,1000,0,0,0,0,0,0,0,0
20200212,9907,統一實,10.65,10.80,10.65,10.75,+0.10,0.94,674878,278,7253771,128000,90000,38000,0,0,0,6000,0,6000,44000
20200212,9908,大台北,31.80,31.85,31.75,31.75,+0.05,0.16,52379,51,1664487,1000,4000,-3000,0,0,0,0,0,0,-3000
20200212,9910,豐泰,177.50,178.00,174.50,175.00,-4.00,-2.23,2749105,2093,483186480,1155000,2189855,-1034855,0,0,0,56000,0,56000,-978855
20200212,9911,櫻花,47.15,47.20,46.80,46.90,-0.10,-0.21,431298,332,20229883,103000,163000,-60000,0,50000,-50000,0,0,0,-110000
20200212,9912,偉聯,7.70,7.74,7.70,7.74,+0.04,0.52,14012,19,108245,1000,0,1000,0,0,0,0,0,0,1000
20200212,9914,美利達,164.50,165.50,163.00,165.50,+0.50,0.3,626308,371,102805281,333000,306000,27000,0,115000,-115000,20000,8000,12000,-76000
20200212,9917,中保科,89.10,89.10,88.50,88.50,-0.50,-0.56,183444,152,16283816,52000,141000,-89000,0,0,0,17000,0,17000,-72000
20200212,9918,欣天然,,,,,0.00,0.00,3,3,99,0,0,0,0,0,0,0,0,0,0
20200212,9919,康那香,17.80,18.20,16.70,17.00,-0.75,-4.23,6488244,3570,112237066,21150,12000,9150,0,0,0,5000,0,5000,14150
20200212,9921,巨大,181.00,183.00,181.00,181.50,+0.50,0.28,458277,365,83332691,185000,435680,-250680,0,0,0,14000,0,14000,-236680
20200212,9924,福興,41.70,41.80,41.65,41.65,0.00,0.00,138429,82,5778068,5000,51000,-46000,0,0,0,0,0,0,-46000
20200212,9925,新保,37.00,37.20,37.00,37.15,+0.15,0.41,75594,70,2807211,1000,26000,-25000,0,0,0,0,0,0,-25000
20200212,9926,新海,41.95,42.35,41.95,42.35,-0.25,-0.59,5047,6,212142,0,0,0,0,0,0,1000,0,1000,1000
20200212,9927,泰銘,31.00,31.00,30.80,30.90,+0.05,0.16,178844,56,5526828,6000,19000,-13000,0,0,0,0,0,0,-13000
20200212,9928,中視,4.28,4.70,4.28,4.70,0.00,0.00,8000,7,35890,0,0,0,0,0,0,0,0,0,0
20200212,9929,秋雨,12.85,12.90,12.80,12.85,0.00,0.00,17260,15,221402,0,1000,-1000,0,0,0,0,0,0,-1000
20200212,9930,中聯資源,49.10,49.30,49.10,49.25,+0.10,0.2,82953,61,4084476,10000,5000,5000,0,0,0,0,0,0,5000
20200212,9931,欣高,34.90,34.90,34.90,34.90,+0.10,0.29,2100,6,73288,0,0,0,0,0,0,0,0,0,0
20200212,9933,中鼎,37.00,37.40,37.00,37.35,+0.35,0.95,1463638,651,54476855,1012000,802000,210000,0,0,0,30000,0,30000,240000
20200212,9934,成霖,16.95,17.00,16.85,16.95,0.00,0.00,274000,140,4639850,0,126000,-126000,0,0,0,0,0,0,-126000
20200212,9935,慶豐富,35.10,37.20,34.60,36.40,+1.20,3.41,2791278,1474,101251624,193000,1084000,-891000,0,0,0,13000,101000,-88000,-979000
20200212,9937,全國,44.15,44.20,44.05,44.05,-0.50,-1.12,27462,37,1211599,0,4000,-4000,0,0,0,0,0,0,-4000
20200212,9938,百和,80.50,80.60,80.00,80.10,-0.50,-0.62,768396,633,61667377,54000,422000,-368000,0,67000,-67000,15000,11000,4000,-431000
20200212,9939,宏全,60.30,60.80,60.00,60.60,+0.20,0.33,945261,461,57080812,190000,191000,-1000,0,0,0,132000,3000,129000,128000
20200212,9940,信義,29.70,30.05,29.60,29.90,+0.15,0.5,211541,149,6328180,9000,61000,-52000,0,0,0,29000,0,29000,-23000
20200212,9941,裕融,109.00,110.00,107.50,109.50,+1.00,0.92,804485,465,87285350,67000,90000,-23000,0,0,0,11000,0,11000,-12000
20200212,9941A,裕融甲特,53.90,54.10,53.90,54.00,+0.10,0.19,41750,18,2254422,0,0,0,0,0,0,0,0,0,0
20200212,9942,茂順,67.60,67.90,67.00,67.80,+0.20,0.3,159250,135,10723850,11000,20000,-9000,0,0,0,0,0,0,-9000
20200212,9943,好樂迪,67.40,68.40,67.40,68.40,+1.10,1.63,251584,202,17126419,15000,6000,9000,0,0,0,0,0,0,9000
20200212,9944,新麗,21.50,21.75,19.75,20.00,-1.30,-6.1,2498748,1345,50872809,9000,2000,7000,0,0,0,3000,7000,-4000,3000
20200212,9945,潤泰新,42.25,42.70,42.20,42.60,+0.30,0.71,879987,584,37463526,264000,189919,74081,0,0,0,41000,4000,37000,111081
20200212,9946,三發地產,20.60,22.45,20.60,22.05,-0.80,-3.5,10892312,4433,234552164,1349000,311000,1038000,0,0,0,32000,1000,31000,1069000
20200212,9955,佳龍,18.00,18.00,17.80,17.85,-0.05,-0.28,169441,128,3030571,16000,26000,-10000,0,0,0,0,0,0,-10000
20200212,9958,世紀鋼,69.00,69.40,68.70,68.70,+0.20,0.29,1373413,899,94628497,264000,53000,211000,0,0,0,31000,191000,-160000,51000
20200212,00679B,元大美債20年,44.53,44.53,44.30,44.32,-0.32,-0.72,902000,460,40022130,2000,0,2000,0,0,0,72000,682000,-610000,-608000
20200212,00687B,國泰20年美債,46.25,46.25,45.97,46.02,-0.30,-0.65,460000,138,21176520,0,0,0,0,0,0,90000,257000,-167000,-167000
20200212,00694B,富邦美債1-3,40.05,40.05,39.98,39.98,-0.07,-0.17,389000,38,15559120,0,0,0,0,0,0,349000,383000,-34000,-34000
20200212,00695B,富邦美債7-10,39.62,39.62,39.48,39.49,-0.12,-0.3,310000,11,12245360,0,0,0,0,0,0,300000,307000,-7000,-7000
20200212,00696B,富邦美債20年,46.35,46.35,46.18,46.19,-0.32,-0.69,617000,52,28510480,0,0,0,0,0,0,400000,483000,-83000,-83000
20200212,00697B,元大美債7-10,41.98,41.98,41.92,41.92,-0.13,-0.31,116000,11,4863830,0,0,0,0,0,0,100000,113000,-13000,-13000
20200212,00718B,富邦中國政策債,20.11,20.11,20.07,20.07,-0.02,-0.1,485000,34,9740270,0,0,0,0,0,0,383000,424000,-41000,-41000
20200212,00719B,元大美債1-3,31.75,31.75,31.70,31.70,-0.09,-0.28,306000,39,9704880,0,0,0,0,0,0,105000,181000,-76000,-76000
20200212,00720B,元大投資級公司債,46.34,46.36,46.25,46.27,-0.13,-0.28,255000,95,11803060,0,0,0,0,0,0,100000,240000,-140000,-140000
20200212,00721B,元大中國債3-5,45.81,45.85,45.78,45.78,+0.06,0.13,122000,19,5592490,0,0,0,0,0,0,121000,100000,21000,21000
20200212,00722B,群益15年IG電信債,49.06,49.15,49.05,49.05,-0.14,-0.28,126000,17,6185000,0,0,0,0,0,0,101000,124000,-23000,-23000
20200212,00723B,群益15年IG科技債,45.17,45.21,45.17,45.18,-0.23,-0.51,110000,12,4972890,0,1000,-1000,0,0,0,104000,109000,-5000,-6000
20200212,00724B,群益10年IG金融債,45.07,45.07,44.95,44.95,-0.12,-0.27,165000,37,7424210,0,0,0,0,0,0,116000,161000,-45000,-45000
20200212,00725B,國泰投資級公司債,46.59,46.60,46.54,46.60,-0.20,-0.43,131000,23,6101730,0,0,0,0,0,0,104000,129000,-25000,-25000
20200212,00726B,國泰5Y+新興債,46.42,46.42,46.36,46.37,-0.05,-0.11,108000,11,5008090,0,0,0,0,0,0,101000,108000,-7000,-7000
20200212,00727B,國泰1-5Y高收債,41.66,41.66,41.62,41.63,0.00,0.0,113000,9,4703230,0,0,0,0,0,0,108000,102000,6000,6000
20200212,00734B,台新JPM新興債,22.45,22.46,22.43,22.45,0.00,0.0,1024000,13,22978220,0,0,0,0,0,0,1010000,1013000,-3000,-3000
20200212,00740B,富邦全球投等債,50.00,50.00,49.88,49.88,-0.17,-0.34,355000,16,17724200,0,0,0,0,0,0,342000,355000,-13000,-13000
20200212,00741B,富邦全球高收債,40.47,40.55,40.44,40.46,+0.06,0.15,299000,31,12105000,0,0,0,0,0,0,195000,293000,-98000,-98000
20200212,00744B,國泰中國政金債5+,41.76,41.76,41.74,41.74,-0.06,-0.14,109000,5,4549680,0,0,0,0,0,0,100000,109000,-9000,-9000
20200212,00745B,富邦中政債0-1,39.57,39.58,39.57,39.58,+0.02,0.05,110000,7,4353700,0,0,0,0,0,0,110000,110000,0,0
20200212,00746B,富邦A級公司債,47.08,47.08,46.96,47.00,-0.24,-0.51,148000,14,6955450,0,0,0,0,0,0,120000,148000,-28000,-28000
20200212,00747B,FH中國政策債,51.55,51.55,51.50,51.55,+0.05,0.1,114000,7,5871650,0,0,0,0,0,0,101000,113000,-12000,-12000
20200212,00748B,凱基中國債3-10,41.97,42.02,41.97,42.00,+0.05,0.12,102000,4,4283990,0,0,0,0,0,0,101000,101000,0,0
20200212,00749B,凱基新興債10+,48.67,48.67,48.60,48.60,+0.15,0.31,102000,6,4957320,0,0,0,0,0,0,101000,102000,-1000,-1000
20200212,00750B,凱基科技債10+,46.76,46.76,46.70,46.70,-0.30,-0.64,102000,4,4763490,0,0,0,0,0,0,101000,102000,-1000,-1000
20200212,00751B,元大AAA至A公司債,48.17,48.17,47.93,47.98,-0.22,-0.46,350000,112,16798370,0,0,0,0,0,0,109000,325000,-216000,-216000
20200212,00754B,群益AAA-AA公司債,48.97,48.97,48.82,48.85,-0.22,-0.45,151000,28,7381040,0,0,0,0,0,0,130000,149000,-19000,-19000
20200212,00755B,群益15年IG公用債,47.44,47.44,47.11,47.12,-0.32,-0.67,248000,89,11703570,0,41000,-41000,0,0,0,142000,201000,-59000,-100000
20200212,00756B,群益15年EM主權債,50.90,50.90,50.80,50.80,+0.05,0.1,138000,13,7022650,20000000,0,20000000,0,0,0,102000,138000,-36000,19964000
20200212,00758B,FH能源債,70.05,70.15,69.95,70.00,-0.15,-0.21,167000,11,11691400,0,37000,-37000,0,0,0,167000,130000,37000,0
20200212,00759B,FH製藥債,74.20,74.25,74.10,74.15,-0.10,-0.13,104000,6,7706800,0,0,0,0,0,0,102000,104000,-2000,-2000
20200212,00760B,FH新興企業債,71.50,71.55,71.45,71.45,+0.05,0.07,102000,4,7288050,0,0,0,0,0,0,101000,102000,-1000,-1000
20200212,00761B,國泰A級公司債,48.93,48.93,48.80,48.80,-0.38,-0.77,113000,12,5515660,0,0,0,0,0,0,105000,113000,-8000,-8000
20200212,00764B,群益25年美債,46.35,46.35,46.24,46.24,-0.34,-0.73,108000,9,4998540,0,0,0,0,0,0,101000,108000,-7000,-7000
20200212,00765B,群益中國政金債,39.95,40.14,39.95,40.10,+0.11,0.28,104000,5,4170350,0,0,0,0,0,0,101000,104000,-3000,-3000
20200212,00768B,FH20年美債,72.50,72.50,72.25,72.25,-0.45,-0.62,102000,4,7369850,0,0,0,0,0,0,101000,102000,-1000,-1000
20200212,00769B,FH中國信用債,61.00,61.00,60.85,60.85,-0.15,-0.25,101000,3,6146000,0,0,0,0,0,0,101000,101000,0,0
20200212,00772B,中信高評級公司債,47.86,47.88,47.72,47.74,-0.23,-0.48,728000,71,34758430,0,43000,-43000,0,0,0,610000,662000,-52000,-95000
20200212,00773B,中信優先金融債,49.02,49.02,48.83,48.87,-0.17,-0.35,743000,95,36303590,0,34000,-34000,0,0,0,610000,696000,-86000,-120000
20200212,00777B,凱基AAA至A公司債,47.20,47.20,47.16,47.16,-0.26,-0.55,103000,5,4857550,0,0,0,0,0,0,101000,103000,-2000,-2000
20200212,00778B,凱基金融債20+,48.77,48.77,48.70,48.70,-0.23,-0.47,102000,4,4967500,0,0,0,0,0,0,101000,102000,-1000,-1000
20200212,00779B,凱基美債25+,46.90,46.90,46.81,46.81,-0.46,-0.97,104000,6,4877300,0,0,0,0,0,0,100000,104000,-4000,-4000
20200212,00780B,國泰A級金融債,42.76,42.76,42.74,42.74,-0.14,-0.33,103000,5,4402240,0,0,0,0,0,0,101000,103000,-2000,-2000
20200212,00781B,國泰A級科技債,46.12,46.12,46.08,46.08,-0.46,-0.99,101000,3,4654120,0,0,0,0,0,0,100000,101000,-1000,-1000
20200212,00782B,國泰A級公用債,45.91,45.91,45.85,45.85,-0.40,-0.86,104000,6,4768470,0,0,0,0,0,0,100000,104000,-4000,-4000
20200212,00784B,富邦中國投等債,40.53,40.53,40.49,40.49,-0.16,-0.39,200000,4,8102000,0,0,0,0,0,0,200000,200000,0,0
20200212,00785B,富邦金融投等債,46.18,46.18,46.11,46.11,-0.27,-0.58,216000,8,9960980,0,0,0,0,0,0,215000,216000,-1000,-1000
20200212,00786B,元大10年IG銀行債,45.29,45.29,45.22,45.22,-0.18,-0.4,116000,9,5252480,0,0,0,0,0,0,101000,114000,-13000,-13000
20200212,00787B,元大10年IG醫療債,45.33,45.33,45.20,45.20,-0.11,-0.24,117000,9,5296840,0,0,0,0,0,0,100000,114000,-14000,-14000
20200212,00788B,元大10年IG電能債,44.00,44.00,43.88,43.93,-0.24,-0.54,109000,6,4788570,0,0,0,0,0,0,100000,106000,-6000,-6000
20200212,00789B,FH公司債A3,69.60,69.60,69.45,69.45,-0.35,-0.5,101000,3,7014600,0,0,0,0,0,0,101000,101000,0,0
20200212,00790B,FH次順位IG金融債,68.15,68.15,67.90,67.90,-0.40,-0.59,101000,3,6858150,0,0,0,0,0,0,101000,101000,0,0
20200212,00791B,FH美元信用債1-5Y,60.55,60.55,60.40,60.45,-0.05,-0.08,134000,16,8095400,0,0,0,0,0,0,101000,134000,-33000,-33000
20200212,00792B,群益A級公司債,45.86,45.86,45.79,45.79,-0.26,-0.56,110000,12,5039420,0,0,0,0,0,0,107000,110000,-3000,-3000
20200212,00793B,群益AAA-A醫療債,45.01,45.01,44.94,44.94,-0.21,-0.47,105000,6,4718800,0,0,0,0,0,0,101000,105000,-4000,-4000
20200212,00794B,群益7+中國政金債,40.45,40.45,40.42,40.42,+0.01,0.02,101000,3,4082450,0,0,0,0,0,0,101000,101000,0,0
20200212,00795B,中信美國公債20年,44.48,44.50,44.40,44.44,-0.23,-0.51,256000,35,11380270,0,0,0,0,0,0,210000,251000,-41000,-41000
20200212,00796B,中信中國債7-10,40.14,40.24,40.13,40.18,-0.08,-0.2,246000,11,9889210,0,0,0,0,0,0,244000,246000,-2000,-2000
20200212,00797B,中信中國美元IG債,41.36,41.36,41.26,41.31,-0.24,-0.58,741000,21,30617000,0,0,0,0,0,0,741000,740000,1000,1000
20200212,00798B,國泰中企A級債7+,43.22,43.22,43.22,43.22,-0.15,-0.35,100000,2,4322000,0,0,0,0,0,0,100000,100000,0,0
20200212,00799B,國泰A級醫療債,45.27,45.27,45.10,45.14,-0.30,-0.66,122000,13,5506970,0,0,0,0,0,0,112000,122000,-10000,-10000
20200212,00831B,新光美債1-3,39.48,39.48,39.48,39.48,-0.07,-0.18,50000,2,1974000,0,0,0,0,0,0,50000,50000,0,0
20200212,00832B,新光美債20+,45.21,45.21,45.20,45.20,-0.29,-0.64,51000,3,2305210,0,0,0,0,0,0,50000,51000,-1000,-1000
20200212,00833B,第一金美債20+,44.15,44.15,43.92,43.93,-0.31,-0.7,121000,11,5316340,0,0,0,0,0,0,101000,107000,-6000,-6000
20200212,00834B,第一金金融債10+,45.39,45.39,45.30,45.30,-0.24,-0.53,102000,4,4620690,0,0,0,0,0,0,101000,102000,-1000,-1000
20200212,00835B,第一金科技債10+,44.09,44.09,44.01,44.01,-0.29,-0.65,101000,3,4445090,0,0,0,0,0,0,101000,101000,0,0
20200212,00836B,永豐10年A公司債,44.02,44.02,43.99,44.01,-0.23,-0.52,101000,5,4445490,0,0,0,0,0,0,100000,101000,-1000,-1000
20200212,00837B,永豐15年金融債,43.30,43.30,43.21,43.21,-0.15,-0.35,102000,6,4408100,0,0,0,0,0,0,100000,100000,0,0
20200212,00838B,永豐7-10年中國債,39.37,39.37,39.35,39.35,-0.05,-0.13,100000,4,3936000,0,0,0,0,0,0,100000,100000,0,0
20200212,00839B,凱基醫療保健債,43.89,43.89,43.84,43.85,-0.07,-0.16,103000,5,4515590,0,0,0,0,0,0,100000,103000,-3000,-3000
20200212,00840B,凱基IG精選15+,42.95,42.95,42.84,42.84,-0.26,-0.6,103000,5,4417650,0,0,0,0,0,0,101000,103000,-2000,-2000
20200212,00841B,凱基AAA-AA公司債,43.26,43.26,43.13,43.18,-0.22,-0.51,103000,5,4447560,0,0,0,0,0,0,101000,102000,-1000,-1000
20200212,00842B,台新美元銀行債,43.10,43.11,43.10,43.10,-0.16,-0.37,144000,4,6206410,0,0,0,0,0,0,141000,2000,139000,139000
20200212,00843B,台新中國政策債,39.37,39.37,39.37,39.37,0.00,0.0,100000,2,3937000,0,0,0,0,0,0,100000,100000,0,0
20200212,00844B,新光15年IG金融債,42.91,42.93,42.91,42.93,-0.17,-0.39,3000,3,128770,0,0,0,0,0,0,2000,3000,-1000,-1000
20200212,00845B,富邦新興投等債,40.58,40.60,40.55,40.59,-0.05,-0.12,204000,8,8272360,0,0,0,0,0,0,201000,201000,0,0
20200212,00846B,富邦歐洲銀行債,40.38,40.38,40.31,40.31,-0.18,-0.44,207000,8,8350240,0,0,0,0,0,0,201000,207000,-6000,-6000
20200212,00847B,中信美國市政債,41.41,41.41,41.30,41.33,-0.11,-0.27,390000,27,16126280,0,0,0,0,0,0,264000,332000,-68000,-68000
20200212,00848B,中信新興亞洲債,40.57,40.64,40.56,40.59,-0.07,-0.17,210000,16,8526050,0,0,0,0,0,0,209000,207000,2000,2000
20200212,00849B,中信EM主權債0-5,39.12,39.13,39.07,39.10,-0.04,-0.1,214000,10,8367430,0,0,0,0,0,0,211000,212000,-1000,-1000
20200212,00853B,統一美債10年Aa-A,38.46,38.46,38.46,38.46,-0.05,-0.13,1000,1,38460,0,0,0,0,0,0,1000,1000,0,0
20200212,00854B,富邦全球保險債,41.24,41.24,41.22,41.22,-0.22,-0.53,201000,3,8285240,0,0,0,0,0,0,201000,201000,0,0
20200212,00855B,富邦全球能源債,41.13,41.13,41.05,41.08,-0.15,-0.36,254000,45,10428260,0,0,0,0,0,0,200000,253000,-53000,-53000
20200212,00856B,永豐1-3年美公債,38.99,38.99,38.98,38.98,-0.07,-0.18,101000,5,3937490,0,0,0,0,0,0,100000,101000,-1000,-1000
20200212,00857B,永豐20年美公債,39.22,39.22,39.16,39.16,-0.22,-0.56,104000,7,4072760,0,0,0,0,0,0,100000,103000,-3000,-3000
20200212,00858,永豐美國500大,22.59,22.62,22.54,22.59,+0.03,0.13,584000,29,13191900,0,0,0,450000,0,450000,117000,563000,-446000,4000
20200212,00859B,群益0-1年美債,39.21,39.21,39.08,39.08,-0.10,-0.26,104000,6,4069540,0,0,0,0,0,0,103000,102000,1000,1000
20200212,00860B,群益1-5年IG債,39.58,39.58,39.51,39.51,-0.08,-0.2,104000,6,4109170,0,0,0,0,0,0,101000,104000,-3000,-3000
20200212,00862B,中信投資級公司債,41.96,41.96,41.83,41.87,-0.15,-0.36,257000,26,10760870,0,0,0,0,0,0,243000,218000,25000,25000
20200212,00863B,中信全球電信債,41.57,41.59,41.48,41.48,-0.22,-0.53,250000,17,10381820,0,0,0,0,0,0,210000,248000,-38000,-38000
20200212,00864B,中信美國公債0-1,39.23,39.28,39.22,39.24,-0.06,-0.15,240000,17,9416520,0,0,0,0,0,0,239000,240000,-1000,-1000
20200212,00867B,新光A-BBB電信債,41.81,41.81,41.79,41.79,-0.21,-0.5,4000,4,167220,0,0,0,0,0,0,2000,4000,-2000,-2000
20200212,00868B,FT1-3年美公債,39.52,39.52,39.48,39.48,-0.15,-0.38,162000,7,6398240,0,0,0,0,0,0,160000,102000,58000,58000
20200212,00869B,FT10-25年公司債,40.37,40.37,40.32,40.32,-0.19,-0.47,102000,4,4112740,0,0,0,0,0,0,100000,102000,-2000,-2000
20200212,00870B,元大15年EM主權債,41.06,41.06,41.00,41.02,-0.01,-0.02,221000,20,9065640,0,0,0,0,0,0,200000,211000,-11000,-11000
20200212,00872B,凱基美債1-3,39.93,39.93,39.85,39.85,-0.11,-0.28,113000,6,4506220,0,0,0,0,0,0,111000,113000,-2000,-2000
20200212,00873B,凱基新興債1-5,39.97,39.97,39.85,39.85,-0.01,-0.03,105000,5,4191450,0,0,0,0,0,0,104000,102000,2000,2000
20200212,00874B,凱基BBB公司債15+,40.71,40.71,40.68,40.68,-0.03,-0.07,104000,6,4230800,0,0,0,0,0,0,102000,103000,-1000,-1000
20200212,1240,茂生農經,53.30,53.30,52.60,52.70,+0.10,0.19,93000,65,4928600,3000,1000,2000,0,0,0,0,0,0,2000
20200212,1258,其祥-KY,18.00,18.10,17.90,17.90,-0.25,-1.38,16000,15,287450,0,0,0,0,0,0,0,0,0,0
20200212,1259,安心,74.30,74.30,74.00,74.10,-0.50,-0.67,14000,8,1038200,0,0,0,0,0,0,0,0,0,0
20200212,1264,德麥,215.00,216.00,215.00,215.50,+0.50,0.23,26000,25,5595000,4000,19000,-15000,0,0,0,0,0,0,-15000
20200212,1268,漢來美食,127.50,128.50,127.50,128.50,-0.50,-0.39,28000,28,3595000,0,0,0,0,0,0,0,0,0,0
20200212,1333,恩得利,2.20,2.20,2.20,2.20,0.00,0.0,76000,7,167200,0,0,0,0,0,0,0,0,0,0
20200212,1336,台翰,14.50,14.75,14.45,14.75,+0.30,2.08,110000,38,1606850,0,0,0,0,0,0,0,0,0,0
20200212,1565,精華,410.00,412.00,409.00,410.50,+2.00,0.49,168000,142,68945500,22000,10000,12000,0,0,0,0,6000,-6000,6000
20200212,1569,濱川,18.35,20.15,18.35,20.15,+1.80,9.81,2436000,1212,48216400,122000,119000,3000,0,0,0,0,0,0,3000
20200212,1570,力肯,13.25,13.30,13.15,13.20,-0.05,-0.38,86000,34,1135050,0,0,0,0,0,0,0,0,0,0
20200212,1580,新麥,105.00,107.00,105.00,107.00,+2.50,2.39,120000,100,12784000,13000,27000,-14000,0,0,0,0,0,0,-14000
20200212,1584,精剛,8.80,8.80,8.70,8.80,+0.07,0.8,122000,30,1063790,15000,0,15000,0,0,0,0,0,0,15000
20200212,1586,和勤,39.20,39.20,38.15,38.70,0.00,0.0,638000,415,24649700,0,144211,-144211,0,0,0,0,0,0,-144211
20200212,1591,駿吉-KY,22.85,22.85,22.55,22.75,0.00,0.0,4000,4,90900,0,0,0,0,0,0,0,0,0,0
20200212,1593,祺驊,49.10,49.10,49.00,49.00,-0.15,-0.31,38000,32,1863050,0,0,0,0,0,0,0,0,0,0
20200212,1595,川寶,37.30,37.40,37.10,37.40,+0.20,0.54,20000,15,745300,4000,0,4000,0,0,0,0,0,0,4000
20200212,1597,直得,93.80,95.40,93.70,94.70,+0.90,0.96,404000,321,38223100,31000,4000,27000,0,0,0,4000,0,4000,31000
20200212,1599,宏佳騰,36.65,37.00,36.65,36.80,+0.25,0.68,70000,47,2578050,5000,1000,4000,0,0,0,0,0,0,4000
20200212,1742,台蠟,23.80,24.00,23.25,23.70,+0.05,0.21,777000,344,18352850,0,19000,-19000,0,0,0,0,0,0,-19000
20200212,1752,南光,44.45,44.45,43.50,43.50,-0.55,-1.25,772000,518,33790200,0,103000,-103000,0,0,0,0,4000,-4000,-107000
20200212,1777,生泰,79.70,79.90,78.80,79.00,-0.60,-0.75,52000,48,4120800,0,1000,-1000,0,0,0,0,0,0,-1000
20200212,1781,合世,11.20,11.35,10.70,10.70,-0.75,-6.55,318000,187,3507050,0,0,0,0,0,0,3000,2000,1000,1000
20200212,1784,訊聯,36.90,37.45,36.90,37.00,+0.30,0.82,287000,215,10660550,37000,18000,19000,0,0,0,0,0,0,19000
20200212,1785,光洋科,21.15,21.40,21.10,21.25,+0.10,0.47,793000,246,16846100,31000,44000,-13000,0,0,0,16000,0,16000,3000
20200212,1788,杏昌,105.50,105.50,105.00,105.00,0.00,0.0,31000,15,3256000,3000,0,3000,0,0,0,0,0,0,3000
20200212,1796,金穎生技,26.95,27.00,26.95,27.00,+0.05,0.19,9000,8,242900,0,0,0,0,0,0,0,0,0,0
20200212,1799,易威,10.40,10.65,10.35,10.50,+0.15,1.45,67000,38,700150,0,0,0,0,0,0,0,0,0,0
20200212,1813,寶利徠,26.55,26.55,26.20,26.30,-0.10,-0.38,54000,44,1422200,2000,0,2000,0,0,0,0,0,0,2000
20200212,1815,富喬,11.70,12.45,11.70,12.40,+0.80,6.9,4374000,1510,53171150,272000,174550,97450,0,0,0,64000,45000,19000,116450
20200212,2035,唐榮,,,,,,0.00,0,0,0,0,0,0,0,0,0,0,0,0,0
20200212,2061,風青,9.81,9.85,9.75,9.75,-0.04,-0.41,38000,16,372390,0,11000,-11000,0,0,0,0,0,0,-11000
20200212,2063,世鎧,37.75,37.80,37.70,37.80,+0.10,0.27,20000,11,755450,0,0,0,0,0,0,0,0,0,0
20200212,2064,晉椿,13.50,13.50,13.50,13.50,+0.25,1.89,1000,1,13500,0,0,0,0,0,0,0,0,0,0
20200212,2065,世豐,44.35,44.75,44.35,44.70,+0.40,0.9,186000,123,8293050,1000,1000,0,0,0,0,0,0,0,0
20200212,2066,世德,58.50,60.00,58.00,59.90,+1.50,2.57,42000,34,2469000,2000,0,2000,0,0,0,0,0,0,2000
20200212,2067,嘉鋼,11.15,11.15,10.55,10.75,-0.25,-2.27,28000,16,298100,0,0,0,0,0,0,0,0,0,0
20200212,2070,精湛,29.90,29.90,29.75,29.75,+0.05,0.17,6000,4,178850,0,0,0,0,0,0,0,0,0,0
20200212,2221,大甲,30.15,30.15,29.75,29.75,+0.20,0.68,16000,14,478450,0,0,0,0,0,0,0,0,0,0
20200212,2230,泰茂,12.00,12.70,11.95,12.70,+0.55,4.53,89000,71,1091850,3000,1000,2000,0,0,0,0,0,0,2000
20200212,2235,謚源,52.40,52.40,51.30,51.70,0.00,0.0,30000,25,1545800,0,0,0,0,15000,-15000,0,0,0,-15000
20200212,2596,綠意,21.50,21.50,21.45,21.50,+0.05,0.23,112000,41,2405500,0,0,0,0,0,0,0,18000,-18000,-18000
20200212,2640,大車隊,76.20,77.90,76.20,77.50,+0.90,1.17,37000,34,2864000,26000,0,26000,0,0,0,0,0,0,26000
20200212,2641,正德,6.34,6.49,6.33,6.41,+0.08,1.26,267000,99,1708610,0,3000,-3000,0,0,0,0,0,0,-3000
20200212,2643,捷迅,37.15,38.45,37.10,38.00,+1.05,2.84,99000,77,3755550,5000,1000,4000,0,0,0,0,0,0,4000
20200212,2718,晶悅,17.95,18.05,17.95,18.05,+0.10,0.56,4000,4,71950,0,0,0,0,0,0,0,0,0,0
20200212,2719,燦星旅,4.88,5.42,4.88,5.42,+0.49,9.94,29000,8,142840,0,0,0,0,0,0,0,0,0,0
20200212,2724,富驛-KY,,,,,,0.00,0,0,0,0,0,0,0,0,0,0,0,0,0
20200212,2726,雅茗-KY,63.00,63.90,62.50,63.20,+0.20,0.32,123000,92,7765200,0,8000,-8000,0,0,0,0,0,0,-8000
20200212,2729,瓦城,255.50,255.50,252.00,252.50,-3.50,-1.37,79000,75,20029500,5000,5000,0,0,0,0,0,0,0,0
20200212,2732,六角,160.50,168.00,160.00,163.50,+4.50,2.83,1608000,1405,264563000,10000,294000,-284000,0,0,0,176000,3000,173000,-111000
20200212,2734,易飛網,9.80,9.90,9.80,9.90,-0.05,-0.5,19000,8,186790,0,0,0,0,0,0,0,0,0,0
20200212,2736,高野,11.90,11.95,11.75,11.90,+0.25,2.15,86000,46,1021900,0,0,0,0,0,0,0,0,0,0
20200212,2740,天蔥,8.15,8.43,7.84,8.14,+0.34,4.36,4000,4,32560,0,0,0,0,0,0,0,0,0,0
20200212,2745,五福,19.65,19.65,19.60,19.60,+0.70,3.7,7000,7,137300,0,0,0,0,0,0,1000,1000,0,0
20200212,2752,豆府,108.50,112.00,108.50,111.00,+2.50,2.3,43000,38,4745000,3000,5000,-2000,0,0,0,0,0,0,-2000
20200212,2916,滿心,17.45,17.45,17.45,17.45,0.00,0.0,5000,4,87250,0,0,0,0,0,0,0,0,0,0
20200212,2924,東凌-KY,,,,,,0.00,0,0,0,0,0,0,0,0,0,0,0,0,0
20200212,2926,誠品生活,102.00,102.50,102.00,102.50,+0.50,0.49,17000,17,1738000,1000,0,1000,0,0,0,0,0,0,1000
20200212,2928,紅馬-KY,35.80,40.00,35.00,40.00,+3.60,9.89,635000,420,24186300,7000,5000,2000,0,0,0,1000,1000,0,2000
20200212,2937,集雅社,23.15,23.65,23.15,23.65,+0.35,1.5,26000,4,602400,0,0,0,0,0,0,0,0,0,0
20200212,3064,泰偉,13.00,13.10,13.00,13.00,+0.25,1.96,8000,4,104300,0,0,0,0,0,0,0,0,0,0
20200212,3066,李洲,,,,,,0.00,0,0,0,0,0,0,0,0,0,0,0,0,0
20200212,3067,全域,35.40,38.15,35.40,38.15,+3.45,9.94,279000,152,10371250,7000,0,7000,0,0,0,0,1000,-1000,6000
20200212,3071,協禧,18.20,18.20,18.00,18.15,-0.05,-0.27,169000,83,3057900,14000,4000,10000,0,0,0,0,0,0,10000
20200212,3073,凱柏實業,10.55,10.65,10.30,10.30,+0.20,1.98,29000,15,306000,0,0,0,0,0,0,0,0,0,0
20200212,3078,僑威,24.60,25.05,24.45,24.95,+0.40,1.63,587000,369,14598350,65000,195000,-130000,0,0,0,0,0,0,-130000
20200212,3081,聯亞,274.00,275.00,270.00,270.00,+2.00,0.75,1251000,991,340461500,130000,502500,-372500,5000,0,5000,20000,4000,16000,-351500
20200212,3083,網龍,78.30,78.50,77.80,78.00,-0.20,-0.26,733000,518,57229500,12101,70000,-57899,0,0,0,47000,29000,18000,-39899
20200212,3085,新零售,3.22,3.25,3.10,3.25,+0.09,2.85,27000,13,84570,0,0,0,0,0,0,0,0,0,0
20200212,3086,華義,20.65,20.75,20.65,20.75,-1.25,-5.68,3000,3,62150,0,0,0,0,0,0,0,0,0,0
20200212,3088,艾訊,56.20,56.60,56.20,56.60,+0.40,0.71,281000,166,15852400,27000,99000,-72000,0,0,0,0,0,0,-72000
20200212,3089,元炬,20.70,20.90,20.70,20.90,-0.20,-0.95,4000,3,83000,0,0,0,0,0,0,0,0,0,0
20200212,3092,鴻碩,38.95,39.40,38.95,39.30,+0.25,0.64,207000,132,8095500,20000,6000,14000,0,0,0,0,0,0,14000
20200212,3093,港建,,,,,,0.00,0,0,0,0,0,0,0,0,0,0,0,0,0
20200212,3095,及成,1.81,1.85,1.81,1.85,+0.07,3.93,33000,8,60310,0,0,0,0,0,0,0,0,0,0
20200212,3105,穩懋,304.00,320.00,302.50,316.00,+14.00,4.64,18366000,12627,5717920500,5084000,2047404,3036596,911000,3000,908000,1081000,373000,708000,4652596
20200212,3114,好德,26.35,26.70,26.30,26.60,+0.50,1.92,172000,107,4563100,28000,2000,26000,0,0,0,0,0,0,26000
20200212,3115,寶島極,11.25,11.25,11.25,11.25,0.00,0.0,2000,1,22500,0,0,0,0,0,0,0,0,0,0
20200212,3118,進階,28.05,28.20,28.05,28.15,+0.10,0.36,13000,13,365600,0,0,0,0,0,0,0,0,0,0
20200212,3122,笙泉,10.85,11.10,10.85,10.90,-0.10,-0.91,21000,15,229300,0,0,0,0,0,0,0,0,0,0
20200212,3128,昇銳,12.40,12.45,12.35,12.40,-0.05,-0.4,62000,17,768700,0,0,0,0,0,0,0,0,0,0
20200212,3131,弘塑,292.00,294.00,288.50,294.00,+7.00,2.44,1044000,922,305198000,48000,10000,38000,20000,0,20000,79000,6000,73000,131000
20200212,3141,晶宏,25.75,26.25,25.75,26.25,+0.60,2.34,165000,101,4301300,27000,4000,23000,0,0,0,0,0,0,23000
20200212,3144,新揚科,28.80,29.60,28.80,29.00,+0.40,1.4,807000,505,23588200,46000,75000,-29000,0,0,0,17000,0,17000,-12000
20200212,3147,大綜,34.95,35.80,34.95,35.40,+0.45,1.29,58000,49,2059600,6000,0,6000,0,0,0,0,0,0,6000
20200212,3152,璟德,333.00,340.50,331.50,334.50,-1.50,-0.45,714000,675,239724500,30000,176000,-146000,63000,0,63000,26000,35000,-9000,-92000
20200212,3162,精確,10.30,10.50,9.46,10.50,+0.20,1.94,44000,19,455200,0,0,0,0,0,0,0,2000,-2000,-2000
20200212,3163,波若威,38.95,39.50,38.70,39.30,+0.60,1.55,806000,565,31629950,130000,38000,92000,0,0,0,6000,77000,-71000,21000
20200212,3169,亞信,33.00,33.45,32.80,33.45,+0.65,1.98,141000,99,4659650,25000,1000,24000,0,0,0,0,0,0,24000
20200212,3171,新洲,13.45,13.55,13.45,13.50,0.00,0.0,16000,9,215650,0,0,0,0,0,0,0,0,0,0
20200212,3176,基亞,58.90,61.60,58.90,60.00,+1.00,1.69,934000,684,56526300,9000,27000,-18000,0,0,0,0,0,0,-18000
20200212,3178,公準,46.00,46.90,45.60,46.00,+0.35,0.77,734000,570,33877150,4000,22000,-18000,0,0,0,0,3000,-3000,-21000
20200212,3188,鑫龍騰,16.95,17.00,16.85,16.85,0.00,0.0,23000,17,389200,0,0,0,0,0,0,0,6000,-6000,-6000
20200212,3191,和進,37.70,38.70,37.15,38.35,+0.35,0.92,326000,252,12390500,88000,12000,76000,0,0,0,0,3000,-3000,73000
20200212,3202,樺晟,20.55,20.90,20.25,20.30,-0.15,-0.73,2312000,849,47487250,149000,94000,55000,0,0,0,0,0,0,55000
20200212,3205,佰研,43.40,44.65,43.40,44.10,+1.40,3.28,131000,115,5779200,4000,2000,2000,0,0,0,0,0,0,2000
20200212,3206,志豐,30.80,32.60,30.65,32.10,+1.50,4.9,458000,226,14573500,11000,81000,-70000,0,0,0,0,11000,-11000,-81000
20200212,3207,耀勝,12.30,12.30,12.30,12.30,+0.30,2.5,1000,1,12300,0,0,0,0,0,0,0,0,0,0
20200212,3211,順達,59.50,61.40,59.30,61.40,+2.10,3.54,1502000,1031,91401700,207000,188000,19000,0,0,0,6000,12000,-6000,13000
20200212,3213,茂訊,44.60,45.45,44.60,45.40,+0.80,1.79,96000,72,4337200,13000,1000,12000,0,0,0,0,0,0,12000
20200212,3217,優群,62.20,63.40,62.20,62.60,+0.90,1.46,979000,708,61422900,71000,56000,15000,0,0,0,118000,6000,112000,127000
20200212,3218,大學光,84.50,86.50,83.60,86.00,+1.50,1.78,3353000,2599,286255600,316000,53000,263000,0,0,0,16000,5000,11000,274000
20200212,3219,倚強股份,17.80,17.80,17.80,17.80,-0.65,-3.52,2000,2,35600,0,0,0,0,0,0,0,0,0,0
20200212,3221,台嘉碩,22.25,22.65,22.25,22.55,+0.45,2.04,585000,357,13102400,100000,33000,67000,0,0,0,0,0,0,67000
20200212,3224,三顧,55.40,55.40,53.30,53.30,-0.70,-1.3,604000,429,32983200,2000,7000,-5000,0,0,0,0,0,0,-5000
20200212,3226,至寶電,57.00,57.30,57.00,57.20,-0.50,-0.87,3000,3,171500,0,0,0,0,0,0,0,0,0,0
20200212,3227,原相,186.00,192.50,185.00,190.00,+2.50,1.33,14599000,9734,2752685000,1878379,1065100,813279,494000,11000,483000,143000,675000,-532000,764279
20200212,3228,金麗科,29.70,30.80,29.50,29.65,+0.35,1.19,414000,285,12459750,23000,18000,5000,0,0,0,0,0,0,5000
20200212,3230,錦明,5.55,5.62,5.55,5.60,-0.08,-1.41,49000,16,274290,0,0,0,0,0,0,0,0,0,0
20200212,3232,昱捷,19.00,19.50,18.65,19.25,-0.15,-0.77,574000,372,10945500,14000,4000,10000,0,0,0,0,0,0,10000
20200212,3234,光環,35.45,35.85,35.20,35.30,+0.25,0.71,1926000,1228,68266400,64000,298000,-234000,0,0,0,0,0,0,-234000
20200212,3236,千如,18.70,19.30,18.65,19.05,+0.55,2.97,357000,198,6806150,10000,3000,7000,0,0,0,0,0,0,7000
20200212,3252,海灣,16.00,16.00,15.95,15.95,0.00,0.0,30000,9,479000,0,0,0,0,0,0,0,0,0,0
20200212,3259,鑫創,14.25,14.25,13.80,13.90,-0.10,-0.71,66000,43,919900,0,0,0,0,0,0,0,0,0,0
20200212,3260,威剛,74.70,76.60,74.70,75.20,+1.30,1.76,18298000,10640,1385855100,707000,2614000,-1907000,2475000,0,2475000,828000,351000,477000,1045000
20200212,3264,欣銓,27.20,27.45,27.15,27.40,+0.50,1.86,2910000,1500,79476700,530000,909000,-379000,0,0,0,0,10000,-10000,-389000
20200212,3265,台星科,25.50,25.70,25.35,25.60,+0.20,0.79,162000,112,4139500,18000,12000,6000,0,0,0,1000,6000,-5000,1000
20200212,3268,海德威,11.50,11.50,11.20,11.45,+0.15,1.33,8000,7,90900,0,0,0,0,0,0,1000,2000,-1000,-1000
20200212,3272,東碩,26.50,26.50,26.20,26.30,+0.30,1.15,83000,63,2187850,1000,1000,0,0,0,0,0,0,0,0
20200212,3276,宇環,7.73,7.93,7.73,7.93,-0.01,-0.13,17000,7,133410,0,0,0,0,0,0,0,0,0,0
20200212,3284,太普高,13.55,13.55,13.40,13.40,-0.10,-0.74,12000,8,160950,0,4000,-4000,0,0,0,0,0,0,-4000
20200212,3285,微端,15.05,15.05,15.00,15.05,+0.05,0.33,37000,20,555700,0,0,0,0,0,0,0,0,0,0
20200212,3287,廣寰科,9.50,9.50,8.72,8.85,+0.13,1.49,15000,12,133640,0,0,0,0,0,0,1000,0,1000,1000
20200212,3288,點晶,9.98,10.35,9.95,9.95,-0.03,-0.3,12000,7,120410,0,0,0,0,0,0,0,0,0,0
20200212,3289,宜特,41.10,41.35,40.85,41.00,+0.20,0.49,539000,377,22140300,54000,45907,8093,0,0,0,0,0,0,8093
20200212,3290,東浦,14.10,14.30,14.10,14.20,+0.20,1.43,118000,65,1672550,14000,0,14000,0,0,0,0,0,0,14000
20200212,3293,鈊象,488.00,493.50,476.50,478.00,-13.00,-2.65,2072000,1857,1001589000,147150,425000,-277850,0,48000,-48000,27000,48000,-21000,-346850
20200212,3294,英濟,15.20,15.75,15.20,15.50,+0.35,2.31,153000,84,2377200,2000,0,2000,0,0,0,0,0,0,2000
20200212,3297,杭特,11.90,12.00,11.85,11.95,+0.10,0.84,6000,5,71650,0,0,0,0,0,0,0,0,0,0
20200212,3303,岱稜,23.35,23.75,23.20,23.75,+0.65,2.81,72000,53,1683550,20000,0,20000,0,0,0,0,0,0,20000
20200212,3306,鼎天,19.35,19.40,19.10,19.40,+0.20,1.04,88000,42,1689500,0,0,0,0,0,0,0,0,0,0
20200212,3310,佳穎,32.95,33.00,32.95,33.00,+0.20,0.61,81000,10,2669850,0,0,0,0,0,0,0,0,0,0
20200212,3313,斐成,15.30,16.50,15.20,16.05,+0.75,4.9,121000,65,1898100,7000,2000,5000,0,0,0,3000,4000,-1000,4000
20200212,3317,尼克森,41.95,42.70,41.70,42.30,+0.70,1.68,818000,592,34600800,148000,18000,130000,0,0,0,8000,18000,-10000,120000
20200212,3322,建舜電,7.10,7.24,7.10,7.16,+0.08,1.13,38000,24,271700,8000,0,8000,0,0,0,0,0,0,8000
20200212,3323,加百裕,28.30,28.65,28.30,28.50,+0.20,0.71,92000,68,2624000,9000,1000,8000,0,0,0,0,0,0,8000
20200212,3324,雙鴻,161.50,169.00,161.50,167.00,+4.00,2.45,4460000,3312,741953500,242000,243000,-1000,0,33000,-33000,94000,62000,32000,-2000
20200212,3325,旭品,10.85,11.15,10.85,11.05,+0.25,2.31,43000,32,474200,0,0,0,0,0,0,0,0,0,0
20200212,3332,幸康,37.05,37.10,37.05,37.10,+0.05,0.13,22000,6,815400,0,0,0,0,0,0,0,0,0,0
20200212,3339,泰谷,4.40,4.40,4.40,4.40,-0.08,-1.79,13000,4,57200,0,0,0,0,0,0,0,0,0,0
20200212,3354,律勝,14.45,15.05,14.25,14.75,+0.50,3.51,291000,156,4271050,7000,0,7000,0,0,0,0,0,0,7000
20200212,3360,尚立,16.65,16.95,16.65,16.75,+0.10,0.6,262000,132,4400600,18000,10000,8000,0,0,0,0,0,0,8000
20200212,3362,先進光,40.70,42.00,40.20,41.30,+1.20,2.99,687000,509,28357150,35000,15000,20000,0,0,0,0,0,0,20000
20200212,3363,上詮,26.50,28.15,26.40,27.90,+1.60,6.08,2038000,1373,56137800,155000,107000,48000,0,0,0,16000,10000,6000,54000
20200212,3372,典範,9.10,9.10,8.95,9.00,+0.01,0.11,50000,26,450180,0,0,0,0,0,0,0,0,0,0
20200212,3373,熱映,25.90,28.25,25.85,26.20,+0.30,1.16,4811000,3217,130240150,45000,43000,2000,0,0,0,0,0,0,2000
20200212,3374,精材,90.80,94.50,90.60,93.90,+3.60,3.99,40143000,22774,3734472000,2673000,2006000,667000,182000,0,182000,145000,124000,21000,870000
20200212,3379,彬台,9.70,9.79,9.70,9.79,+0.09,0.93,3000,3,29190,0,0,0,0,0,0,0,0,0,0
20200212,3388,崇越電,68.70,69.00,68.60,68.80,+0.20,0.29,51000,42,3503700,0,0,0,0,0,0,0,0,0,0
20200212,3390,旭軟,21.60,21.65,21.20,21.50,+0.15,0.7,36000,26,774650,0,5000,-5000,0,0,0,0,0,0,-5000
20200212,3402,漢科,30.40,31.00,30.25,30.75,+0.60,1.99,371000,240,11335300,37000,2000,35000,0,0,0,0,0,0,35000
20200212,3426,台興,35.65,36.00,35.65,35.95,-0.05,-0.14,5000,5,178950,0,0,0,0,0,0,0,0,0,0
20200212,3434,哲固,13.50,13.50,13.50,13.50,0.00,0.0,2000,2,27000,0,0,0,0,0,0,0,0,0,0
20200212,3438,類比科,38.20,39.05,37.80,38.20,+0.30,0.79,949000,672,36460850,68000,64000,4000,0,0,0,0,0,0,4000
20200212,3441,聯一光,26.00,26.35,25.80,26.00,+0.40,1.56,88000,59,2293700,1000,1000,0,0,0,0,0,0,0,0
20200212,3444,利機,31.00,31.10,30.70,31.10,0.00,0.0,25000,20,772750,0,4000,-4000,0,0,0,0,0,0,-4000
20200212,3455,由田,53.00,53.70,52.70,53.50,+1.10,2.1,318000,271,16931600,47000,17000,30000,0,0,0,8000,13000,-5000,25000
20200212,3465,進泰電子,33.00,33.00,33.00,33.00,0.00,0.0,5000,3,165000,0,0,0,0,0,0,0,0,0,0
20200212,3466,致振,18.75,18.90,18.75,18.85,+0.10,0.53,7000,5,131600,0,0,0,0,0,0,0,0,0,0
20200212,3479,安勤,75.80,75.90,74.90,75.50,+0.30,0.4,285000,246,21511900,17000,45000,-28000,0,0,0,10000,8000,2000,-26000
20200212,3483,力致,56.20,57.50,56.20,56.80,+0.60,1.07,620000,375,35240900,68000,113000,-45000,0,0,0,5000,21000,-16000,-61000
20200212,3484,崧騰,28.25,28.50,28.05,28.35,+0.10,0.35,50000,35,1414850,9000,1000,8000,0,0,0,0,0,0,8000
20200212,3489,森寶,9.55,10.45,9.45,10.45,+0.93,9.77,1121000,301,11494700,14000,0,14000,0,0,0,0,1000,-1000,13000
20200212,3490,單井,18.50,19.10,18.50,19.05,+0.45,2.42,164000,121,3100800,39000,9000,30000,0,0,0,0,0,0,30000
20200212,3491,昇達科,80.70,82.20,80.70,81.30,+1.30,1.62,669000,532,54535000,84000,46000,38000,0,0,0,5000,2000,3000,41000
20200212,3492,長盛,17.25,17.40,17.25,17.35,+0.10,0.58,35000,23,605400,0,2000,-2000,0,0,0,0,0,0,-2000
20200212,3498,陽程,25.65,27.40,25.65,26.90,+1.95,7.82,1623000,731,44035150,25000,24000,1000,0,0,0,0,0,0,1000
20200212,3499,環天科,13.10,13.20,13.05,13.10,+0.05,0.38,67000,31,879300,0,0,0,0,0,0,0,0,0,0
20200212,3508,位速,22.55,23.30,22.30,23.00,+0.45,2.0,212000,150,4837850,35000,12000,23000,0,0,0,0,0,0,23000
20200212,3511,矽瑪,34.70,35.65,34.70,35.30,+0.40,1.15,353000,261,12470500,71000,11000,60000,0,0,0,0,0,0,60000
20200212,3512,皇龍,29.45,29.65,29.35,29.35,-0.10,-0.34,30000,10,883450,0,0,0,0,0,0,0,0,0,0
20200212,3516,亞帝歐,12.05,12.05,11.50,11.70,-0.30,-2.5,168000,63,1958300,0,0,0,0,0,0,0,0,0,0
20200212,3520,振維,10.75,10.75,10.60,10.65,-0.10,-0.93,60000,36,639550,0,0,0,0,0,0,0,0,0,0
20200212,3521,鴻翊,15.75,16.60,15.75,16.55,+0.80,5.08,186000,137,3024300,31000,0,31000,0,0,0,0,0,0,31000
20200212,3522,御頂,16.30,16.30,15.90,15.90,-0.40,-2.45,109000,99,1753500,0,0,0,0,0,0,0,0,0,0
20200212,3523,迎輝,11.65,11.85,10.90,11.85,+1.05,9.72,126000,49,1479150,1000,0,1000,0,0,0,0,0,0,1000
20200212,3526,凡甲,69.60,71.00,69.60,70.90,+0.40,0.57,1637000,1065,115343800,44000,96000,-52000,0,0,0,5000,204000,-199000,-251000
20200212,3527,聚積,105.50,106.50,105.00,105.50,+0.50,0.48,715000,528,75586500,19000,92000,-73000,0,49000,-49000,3000,4000,-1000,-123000
20200212,3529,力旺,325.00,331.50,323.00,330.00,+10.00,3.12,369000,327,121234000,35000,23000,12000,40000,0,40000,25000,3000,22000,74000
20200212,3531,先益,22.70,22.70,22.50,22.55,+0.20,0.89,27000,24,608150,0,0,0,0,0,0,0,0,0,0
20200212,3537,堡達,31.30,31.45,31.20,31.45,+0.25,0.8,125000,78,3917250,13000,4000,9000,0,0,0,0,0,0,9000
20200212,3540,曜越,25.10,25.55,24.90,24.90,+1.05,4.4,823000,524,20678250,5000,26000,-21000,0,0,0,0,0,0,-21000
20200212,3541,西柏,79.40,80.10,79.10,80.10,+1.50,1.91,69000,59,5491400,11000,10000,1000,0,0,0,0,0,0,1000
20200212,3546,宇峻,111.00,114.00,109.00,111.50,-5.00,-4.29,3274000,2369,364690000,138050,151000,-12950,224000,30000,194000,46000,374000,-328000,-146950
20200212,3548,兆利,83.10,85.40,83.10,84.40,+0.20,0.24,1407000,1049,118723800,77000,78000,-1000,180000,0,180000,0,138000,-138000,41000
20200212,3551,世禾,49.00,50.40,48.50,50.20,+1.75,3.61,1433000,946,70686700,106000,52000,54000,0,0,0,101000,5000,96000,150000
20200212,3552,同致,60.60,61.40,60.60,61.20,+0.90,1.49,309000,231,18899800,29000,24000,5000,0,0,0,0,3000,-3000,2000
20200212,3555,重鵬,29.60,30.00,29.00,29.50,-0.10,-0.34,7000,7,206950,0,0,0,0,0,0,0,0,0,0
20200212,3556,禾瑞亞,46.50,47.20,46.50,46.95,+0.45,0.97,71000,60,3322150,26000,2000,24000,0,0,0,0,0,0,24000
20200212,3558,神準,113.00,114.00,112.00,113.50,+1.50,1.34,121000,104,13692500,13000,8000,5000,0,0,0,0,0,0,5000
20200212,3562,頂晶科,13.20,13.60,13.20,13.45,+0.25,1.89,198000,125,2671050,3000,0,3000,0,0,0,0,0,0,3000
20200212,3564,其陽,31.90,32.00,31.85,31.85,-0.05,-0.16,31000,20,990100,1000,0,1000,0,0,0,0,0,0,1000
20200212,3567,逸昌,22.40,22.60,22.05,22.60,+0.20,0.89,89000,52,1984150,4000,0,4000,0,0,0,0,0,0,4000
20200212,3570,大塚,94.60,96.50,93.00,95.80,+1.10,1.16,55000,55,5235300,2000,0,2000,0,0,0,0,0,0,2000
20200212,3577,泓格,33.40,33.40,33.40,33.40,-0.45,-1.33,1000,1,33400,0,0,0,0,0,0,0,0,0,0
20200212,3580,友威科,24.40,24.50,24.00,24.45,+0.40,1.66,136000,95,3309050,27000,3000,24000,0,0,0,0,0,0,24000
20200212,3581,博磊,15.40,16.10,15.40,16.00,-0.05,-0.31,34000,30,536150,0,0,0,0,0,0,0,2000,-2000,-2000
20200212,3587,閎康,72.80,72.80,71.60,72.00,+0.40,0.56,315000,264,22760300,69000,44000,25000,0,0,0,0,3000,-3000,22000
20200212,3594,磐儀,22.15,22.25,22.00,22.15,+0.05,0.23,167000,82,3697550,0,1000,-1000,0,0,0,0,0,0,-1000
20200212,3609,東林,19.85,20.20,19.60,19.70,0.00,0.0,90000,58,1790600,0,0,0,0,0,0,0,0,0,0
20200212,3611,鼎翰,215.00,230.00,215.00,225.50,+12.50,5.87,130000,126,29034500,6000,18000,-12000,0,0,0,0,0,0,-12000
20200212,3615,安可,14.55,14.70,14.30,14.50,-0.05,-0.34,64000,43,923450,0,0,0,0,0,0,0,0,0,0
20200212,3623,富晶通,20.00,20.15,19.80,20.15,+0.15,0.75,37000,23,740250,3000,0,3000,0,0,0,0,0,0,3000
20200212,3624,光頡,31.20,31.50,30.80,30.90,-0.20,-0.64,1920000,1128,59557250,41000,36000,5000,0,0,0,15000,118000,-103000,-98000
20200212,3625,西勝,17.35,17.80,17.20,17.70,+0.50,2.91,258000,182,4527200,59000,7000,52000,0,0,0,0,0,0,52000
20200212,3628,盈正,32.95,32.95,32.90,32.90,0.00,0.0,2000,2,65850,0,0,0,0,0,0,0,0,0,0
20200212,3629,地心引力,,,,,,0.00,0,0,0,0,0,0,0,0,0,0,0,0,0
20200212,3630,新鉅科,72.00,75.10,71.90,73.90,+2.30,3.21,2504000,1782,184411300,197000,251000,-54000,0,0,0,75000,7000,68000,14000
20200212,3631,晟楠,49.70,49.70,48.60,48.90,-0.10,-0.2,95000,63,4652400,1000,9000,-8000,0,0,0,0,0,0,-8000
20200212,3632,研勤,10.45,10.50,10.40,10.45,0.00,0.0,41000,22,427600,5000,0,5000,0,0,0,0,0,0,5000
20200212,3642,駿熠電,17.80,18.25,17.50,17.50,-0.20,-1.13,279000,126,5010250,20000,0,20000,0,0,0,0,0,0,20000
20200212,3646,艾恩特,16.25,16.25,16.05,16.05,-0.20,-1.23,15000,13,241500,0,0,0,0,0,0,0,0,0,0
20200212,3652,精聯,17.40,17.45,17.15,17.45,+0.35,2.05,56000,38,970600,0,0,0,0,0,0,0,0,0,0
20200212,3663,鑫科,19.65,19.90,19.65,19.85,+0.10,0.51,25000,18,494950,0,0,0,0,0,0,0,0,0,0
20200212,3664,安瑞-KY,12.80,12.80,12.40,12.75,+0.05,0.39,10000,10,125550,0,0,0,0,0,0,1000,1000,0,0
20200212,3666,光耀,17.00,17.00,16.60,16.75,-0.10,-0.59,31000,23,518750,0,1000,-1000,0,0,0,0,0,0,-1000
20200212,3672,康聯訊,13.75,13.90,13.70,13.85,+0.10,0.73,12000,7,165550,0,0,0,0,0,0,0,0,0,0
20200212,3675,德微,43.40,44.00,43.35,44.00,+0.40,0.92,28000,14,1217700,0,0,0,0,0,0,0,0,0,0
20200212,3680,家登,174.50,176.50,171.50,172.50,-1.00,-0.58,1311000,1028,228118500,20000,173000,-153000,0,0,0,0,0,0,-153000
20200212,3684,榮昌,41.20,41.45,40.85,41.30,+0.60,1.47,69000,53,2842900,0,2000,-2000,0,0,0,0,0,0,-2000
20200212,3685,元創精密,24.40,25.35,24.15,25.35,+1.00,4.11,40000,31,990150,0,0,0,0,0,0,0,0,0,0
20200212,3687,歐買尬,42.10,42.10,40.25,40.40,-1.15,-2.77,411000,328,16897000,28000,46000,-18000,0,0,0,0,0,0,-18000
20200212,3689,湧德,24.70,24.80,24.40,24.80,+0.10,0.4,224000,125,5480400,7000,0,7000,0,0,0,0,0,0,7000
20200212,3691,碩禾,126.50,127.50,124.50,126.00,+1.00,0.8,403000,329,50743500,34000,31000,3000,0,0,0,10000,3000,7000,10000
20200212,3693,營邦,39.65,39.65,38.95,39.20,+0.25,0.64,51000,35,1993250,0,0,0,0,0,0,0,0,0,0
20200212,3707,漢磊,24.40,25.05,24.40,24.85,+0.55,2.26,2733000,1460,67718050,257000,58000,199000,0,0,0,0,4000,-4000,195000
20200212,3709,鑫聯大投控,21.60,21.65,21.60,21.65,+0.45,2.12,6000,3,129850,0,0,0,0,0,0,0,0,0,0
20200212,3710,連展投控,7.11,7.22,7.11,7.15,+0.02,0.28,478000,140,3423010,92000,51000,41000,0,0,0,0,11000,-11000,30000
20200212,4102,永日,16.25,16.35,16.25,16.35,0.00,0.0,38000,26,619350,0,0,0,0,0,0,0,0,0,0
20200212,4105,東洋,78.50,80.00,78.30,78.70,+0.60,0.77,471000,367,37336700,44900,129000,-84100,0,0,0,17000,0,17000,-67100
20200212,4107,邦特,116.50,118.50,116.50,117.00,+0.50,0.43,253000,232,29676000,20000,44000,-24000,0,94000,-94000,0,0,0,-118000
20200212,4109,加捷生醫,17.50,17.55,17.30,17.40,0.00,0.0,85000,57,1481750,0,4000,-4000,0,0,0,0,0,0,-4000
20200212,4111,濟生,25.70,25.90,25.70,25.75,+0.30,1.18,120000,87,3092800,0,0,0,0,0,0,0,0,0,0
20200212,4113,聯上,16.20,16.20,15.95,16.00,-0.15,-0.93,266000,139,4251900,18000,38000,-20000,0,0,0,0,0,0,-20000
20200212,4114,健喬,23.60,23.75,23.55,23.55,-0.05,-0.21,578000,322,13636000,8000,124000,-116000,0,0,0,0,0,0,-116000
20200212,4116,明基醫,34.20,34.70,34.20,34.65,+0.75,2.21,39000,26,1349400,1000,0,1000,0,0,0,0,0,0,1000
20200212,4120,友華,51.70,52.40,51.60,51.80,+0.10,0.19,21000,13,1090600,0,0,0,0,0,0,0,0,0,0
20200212,4121,優盛,13.65,13.80,13.40,13.55,+0.05,0.37,1172000,545,15889850,0,2000,-2000,0,0,0,0,0,0,-2000
20200212,4123,晟德,50.60,51.40,50.40,50.70,+0.70,1.4,721000,552,36681800,172000,216581,-44581,0,0,0,16000,10000,6000,-38581
20200212,4126,太醫,74.10,74.50,73.80,74.10,+0.20,0.27,301000,244,22314800,2000,215000,-213000,0,0,0,0,0,0,-213000
20200212,4127,天良,11.35,11.35,11.20,11.30,0.00,0.0,121000,70,1367200,0,0,0,0,0,0,0,0,0,0
20200212,4128,中天,14.60,15.05,14.60,14.60,+0.10,0.69,1911000,964,28317700,2000,17000,-15000,0,0,0,0,0,0,-15000
20200212,4129,聯合,39.80,40.15,39.80,39.95,+0.15,0.38,79000,61,3160050,11000,2000,9000,0,0,0,0,0,0,9000
20200212,4129A,聯合甲特,52.70,52.80,52.70,52.80,+0.10,0.19,26000,18,1370300,0,0,0,0,0,0,0,0,0,0
20200212,4130,健亞,24.30,24.60,24.30,24.35,+0.05,0.21,83000,54,2026150,0,2000,-2000,0,0,0,0,0,0,-2000
20200212,4131,晶宇,,,,,,0.00,0,0,0,0,0,0,0,0,0,0,0,0,0
20200212,4138,曜亞,48.55,49.15,48.55,48.60,+0.30,0.62,14000,12,684200,0,0,0,0,0,0,0,0,0,0
20200212,4139,馬光-KY,38.60,38.70,38.35,38.70,+0.10,0.26,21000,16,809750,0,0,0,0,0,0,0,0,0,0
20200212,4147,中裕,94.80,97.70,94.50,96.50,+2.00,2.12,928000,749,89361100,55000,91000,-36000,0,0,0,0,0,0,-36000
20200212,4152,台微體,80.50,80.50,80.30,80.30,+0.10,0.12,11000,8,884000,0,0,0,0,0,0,0,0,0,0
20200212,4153,鈺緯,28.45,28.50,28.40,28.50,-0.10,-0.35,26000,21,740400,0,0,0,0,0,0,0,0,0,0
20200212,4154,康樂-KY,28.90,28.90,28.30,28.80,-0.50,-1.71,14000,10,402200,0,0,0,0,0,0,0,0,0,0
20200212,4157,太景*-KY,22.35,22.65,22.00,22.25,+0.10,0.45,3388000,1591,75563500,87000,233000,-146000,0,0,0,109000,12000,97000,-49000
20200212,4160,創源,28.30,28.35,28.30,28.35,+0.10,0.35,17000,14,481200,0,0,0,0,0,0,0,0,0,0
20200212,4161,聿新科,33.15,35.95,33.15,35.95,+3.25,9.94,564000,357,19873800,3000,13000,-10000,0,0,0,0,2000,-2000,-12000
20200212,4162,智擎,58.80,60.50,58.80,60.50,+5.50,10.0,3795000,1365,228270000,58000,32000,26000,0,0,0,0,7000,-7000,19000
20200212,4163,鐿鈦,119.00,120.50,119.00,119.50,+1.00,0.84,153000,116,18360500,13000,3000,10000,0,0,0,0,0,0,10000
20200212,4167,展旺,21.85,22.05,21.65,21.65,-0.30,-1.37,933000,422,20375900,277000,13000,264000,0,0,0,0,0,0,264000
20200212,4168,醣聯,18.55,18.90,18.55,18.85,+0.30,1.62,76000,57,1430450,1000,0,1000,0,0,0,0,0,0,1000
20200212,4171,瑞基,62.00,62.20,61.00,61.70,-0.10,-0.16,125000,106,7686700,11000,9000,2000,0,0,0,0,11000,-11000,-9000
20200212,4173,久裕,19.90,20.00,19.75,20.00,+0.30,1.52,239000,124,4755350,16000,1000,15000,0,0,0,0,0,0,15000
20200212,4174,浩鼎,119.50,122.50,119.50,122.00,+2.50,2.09,224000,191,27164000,11000,5000,6000,0,0,0,0,0,0,6000
20200212,4175,杏一,73.50,73.50,72.90,73.30,+0.30,0.41,90000,67,6583600,0,5000,-5000,0,0,0,0,0,0,-5000
20200212,4183,福永生技,20.65,20.65,20.15,20.65,+0.40,1.98,12000,9,243150,0,0,0,0,0,0,0,0,0,0
20200212,4188,安克,22.20,22.25,22.10,22.15,-0.10,-0.45,44000,20,975900,0,0,0,0,0,0,0,0,0,0
20200212,4192,杏國,29.25,29.25,28.70,28.95,+0.15,0.52,14000,9,403650,0,0,0,0,0,0,0,0,0,0
20200212,4198,環瑞醫,5.01,5.01,5.01,5.01,+0.45,9.87,28000,15,140280,0,0,0,0,0,0,0,0,0,0
20200212,4205,中華食,88.30,88.60,88.30,88.40,+0.10,0.11,14000,12,1238400,2000,0,2000,0,0,0,0,0,0,2000
20200212,4207,環泰,9.56,9.56,9.51,9.53,-0.02,-0.21,134000,41,1278890,1000,0,1000,0,0,0,0,0,0,1000
20200212,4303,信立,20.50,20.50,20.40,20.45,0.00,0.0,10000,6,204250,0,0,0,0,0,0,0,0,0,0
20200212,4304,勝昱,,,,,,0.00,0,0,0,0,0,0,0,0,0,0,0,0,0
20200212,4305,世坤,35.45,36.65,35.45,35.75,+0.25,0.7,14000,6,503650,0,0,0,0,0,0,0,0,0,0
20200212,4401,東隆興,41.10,43.50,41.10,42.30,+1.25,3.05,1134000,847,48091350,25000,4000,21000,150000,0,150000,25000,12000,13000,184000
20200212,4402,福大,5.53,5.53,5.43,5.44,-0.06,-1.09,30000,16,164320,0,0,0,0,0,0,0,0,0,0
20200212,4406,新昕纖,9.06,9.33,9.01,9.12,-0.14,-1.51,49000,23,444590,0,0,0,0,0,0,0,0,0,0
20200212,4413,飛寶企業,13.40,13.40,13.20,13.20,0.00,0.0,8000,6,106400,0,0,0,0,0,0,0,0,0,0
20200212,4416,三圓,81.00,81.00,81.00,81.00,0.00,0.0,6000,2,486000,0,0,0,0,0,0,0,0,0,0
20200212,4417,金洲,33.30,33.30,33.10,33.20,-0.10,-0.3,100000,59,3320550,0,27000,-27000,0,0,0,0,0,0,-27000
20200212,4419,元勝,,,,,,0.00,0,0,0,0,0,0,0,0,0,0,0,0,0
20200212,4420,光明,30.20,30.20,29.90,29.95,-0.25,-0.83,114000,84,3423650,4000,0,4000,0,0,0,0,0,0,4000
20200212,4429,聚紡,33.05,35.80,33.05,34.80,+1.80,5.45,93000,67,3185050,2000,2000,0,0,0,0,0,0,0,0
20200212,4430,耀億,31.80,32.05,31.70,31.90,+0.35,1.11,39000,25,1244300,0,6000,-6000,0,0,0,0,0,0,-6000
20200212,4432,銘旺實,17.40,17.50,17.40,17.45,0.00,0.0,40000,20,698750,0,0,0,0,0,0,0,0,0,0
20200212,4433,興采,30.60,30.75,30.30,30.60,+0.25,0.82,23000,23,703700,5000,1000,4000,0,0,0,0,0,0,4000
20200212,4502,健信,58.00,58.30,57.80,58.00,0.00,0.0,61000,40,3538600,0,1000,-1000,0,0,0,0,0,0,-1000
20200212,4503,金雨,20.40,20.65,20.35,20.55,+0.20,0.98,30000,24,614550,4000,0,4000,0,0,0,0,0,0,4000
20200212,4506,崇友,60.30,60.30,60.10,60.30,0.00,0.0,629000,18,37927600,0,0,0,0,0,0,0,0,0,0
20200212,4510,高鋒,11.40,11.50,11.40,11.40,0.00,0.0,56000,30,639000,0,0,0,0,0,0,0,0,0,0
20200212,4513,福裕,9.45,9.45,9.30,9.40,0.00,0.0,17000,10,158960,0,0,0,0,0,0,0,0,0,0
20200212,4523,永彰,26.60,26.70,26.00,26.65,+0.40,1.52,79000,60,2085600,9000,3000,6000,0,0,0,0,0,0,6000
20200212,4527,方土霖,23.30,23.90,23.30,23.90,+0.60,2.58,21000,12,494700,0,0,0,0,0,0,0,4000,-4000,-4000
20200212,4528,江興鍛,43.60,44.00,43.30,43.55,-0.05,-0.11,122000,69,5317050,2000,23000,-21000,0,0,0,0,0,0,-21000
20200212,4529,淳紳,13.25,13.30,13.05,13.05,+0.10,0.77,79000,63,1041000,0,16000,-16000,0,0,0,0,0,0,-16000
20200212,4530,宏易,10.60,10.60,10.15,10.25,+0.10,0.99,108000,45,1116750,0,15000,-15000,0,0,0,0,0,0,-15000
20200212,4533,協易機,11.30,11.35,11.20,11.35,+0.05,0.44,25000,7,282300,0,0,0,0,0,0,0,0,0,0
20200212,4534,慶騰,7.84,8.05,7.82,7.84,+0.03,0.38,86000,56,676600,8000,11000,-3000,0,0,0,0,2000,-2000,-5000
20200212,4535,至興,26.45,26.75,26.45,26.75,+0.30,1.13,3000,3,79650,0,0,0,0,0,0,0,0,0,0
20200212,4538,大詠城,15.90,15.90,15.60,15.75,-0.30,-1.87,56000,38,885750,0,0,0,0,0,0,0,0,0,0
20200212,4541,晟田,24.35,24.35,24.05,24.20,-0.20,-0.82,103000,49,2487350,0,0,0,0,0,0,0,0,0,0
20200212,4542,科嶠,27.00,27.00,26.85,27.00,+0.30,1.12,18000,9,485150,0,0,0,0,0,0,0,0,0,0
20200212,4543,萬在,,,,,,0.00,0,0,0,0,0,0,0,0,0,0,0,0,0
20200212,4549,桓達,81.10,81.20,80.60,81.20,+0.10,0.12,46000,37,3726300,12000,0,12000,0,0,0,0,0,0,12000
20200212,4550,長佳,30.10,30.20,29.50,29.80,+0.30,1.02,177000,111,5260600,2000,10000,-8000,0,0,0,0,0,0,-8000
20200212,4554,橙的,20.15,20.30,20.00,20.00,0.00,0.0,42000,20,842650,0,0,0,0,0,0,1000,1000,0,0
20200212,4556,旭然,33.60,33.80,33.60,33.80,+0.20,0.6,6000,3,201800,0,0,0,0,0,0,0,0,0,0
20200212,4561,健椿,24.50,24.65,24.45,24.65,+0.30,1.23,10000,9,245350,0,0,0,0,0,0,0,0,0,0
20200212,4563,百德,47.95,48.05,47.20,47.90,+0.90,1.91,32000,21,1530200,0,0,0,0,0,0,0,2000,-2000,-2000
20200212,4568,科際精密,58.50,58.50,57.60,57.70,-0.30,-0.52,16000,11,925300,0,0,0,0,0,0,0,0,0,0
20200212,4580,捷流閥業,98.60,107.00,98.50,103.00,+5.00,5.1,251000,202,25962800,0,0,0,0,0,0,0,2000,-2000,-2000
20200212,4609,唐鋒,11.85,12.05,11.85,12.05,-0.05,-0.41,5000,5,59900,0,0,0,0,0,0,0,0,0,0
20200212,4702,中美實,10.15,10.20,10.15,10.20,0.00,0.0,15000,7,152900,0,0,0,0,0,0,0,0,0,0
20200212,4706,大恭,17.95,18.20,17.95,18.15,+0.25,1.4,44000,31,794350,2000,0,2000,0,0,0,0,0,0,2000
20200212,4707,磐亞,12.30,13.25,12.30,13.20,+0.80,6.45,16781000,6120,216980900,91000,105000,-14000,0,0,0,0,0,0,-14000
20200212,4711,永純,14.15,14.40,13.90,14.00,-0.10,-0.71,87000,27,1227500,37000,37000,0,0,0,0,0,0,0,0
20200212,4712,南璋,10.75,11.20,10.75,10.80,+0.60,5.88,391000,174,4350250,8000,0,8000,0,0,0,0,0,0,8000
20200212,4714,永捷,15.30,15.50,15.25,15.45,+0.15,0.98,628000,336,9634750,10000,12000,-2000,0,0,0,0,1000,-1000,-3000
20200212,4716,大立,16.05,16.15,15.95,16.05,0.00,0.0,52000,31,834700,0,0,0,0,0,0,0,0,0,0
20200212,4721,美琪瑪,64.10,64.50,63.90,64.20,+0.30,0.47,168000,134,10804100,17000,1000,16000,0,0,0,6000,3000,3000,19000
20200212,4726,永昕,21.20,21.25,20.80,20.80,-0.10,-0.48,195000,72,4102950,3000,8000,-5000,0,0,0,0,0,0,-5000
20200212,4728,雙美,70.00,75.00,70.00,75.00,+6.80,9.97,889000,647,65526800,34000,67000,-33000,0,0,0,252000,2000,250000,217000
20200212,4729,熒茂,10.20,10.60,10.20,10.40,+0.15,1.46,43000,23,446900,0,0,0,0,0,0,0,0,0,0
20200212,4735,豪展,54.40,55.40,53.20,53.20,-1.20,-2.21,1330000,927,71784800,6000,45000,-39000,0,0,0,0,20000,-20000,-59000
20200212,4736,泰博,144.00,145.00,143.00,143.00,0.00,0.0,519000,417,74683000,162000,57000,105000,0,0,0,21000,31000,-10000,95000
20200212,4741,泓瀚,30.35,30.35,29.50,29.90,0.00,0.0,20000,4,591250,0,0,0,0,0,0,0,0,0,0
20200212,4743,合一,29.50,29.70,29.05,29.45,+0.90,3.15,819000,453,24038750,13000,3000,10000,0,0,0,0,0,0,10000
20200212,4744,皇將,36.70,37.50,36.70,37.15,+0.50,1.36,353000,219,13141250,51000,4000,47000,0,0,0,0,2000,-2000,45000
20200212,4745,合富-KY,39.30,39.85,39.30,39.85,+0.60,1.53,73000,43,2890450,9000,23600,-14600,0,0,0,0,0,0,-14600
20200212,4747,強生,38.65,38.75,38.65,38.75,+0.20,0.52,7000,5,270800,0,0,0,0,0,0,0,0,0,0
20200212,4754,國碳科,55.10,55.10,55.00,55.00,+0.20,0.36,5000,5,275300,0,0,0,0,0,0,0,0,0,0
20200212,4760,勤凱,79.00,83.00,75.30,76.90,-6.70,-8.01,821000,648,63874200,9000,45000,-36000,0,0,0,0,2000,-2000,-38000
20200212,4767,誠泰科技,24.00,24.00,23.90,23.90,-0.60,-2.45,4000,4,95700,0,0,0,0,0,0,0,0,0,0
20200212,4803,VHQ-KY,90.00,96.50,89.50,96.50,+8.70,9.91,1615000,1259,151614200,31000,27000,4000,0,0,0,183000,52000,131000,135000
20200212,4804,大略-KY,9.90,10.75,9.90,10.15,+0.25,2.53,108000,78,1113100,0,1000,-1000,0,0,0,3000,1000,2000,1000
20200212,4806,昇華,9.24,9.29,9.00,9.02,-0.25,-2.7,33000,24,299170,0,0,0,0,0,0,0,0,0,0
20200212,4903,聯光通,13.20,13.20,12.90,13.00,-0.05,-0.38,198000,113,2569800,15000,4000,11000,0,0,0,0,0,0,11000
20200212,4905,台聯電,55.60,55.60,55.60,55.60,-0.20,-0.36,1000,1,55600,0,0,0,0,0,0,0,0,0,0
20200212,4907,富宇,26.55,26.75,26.55,26.60,0.00,0.0,46000,31,1226000,0,0,0,0,0,0,0,0,0,0
20200212,4908,前鼎,39.20,42.30,39.20,41.15,+2.00,5.11,3253000,2165,133461100,193000,141000,52000,0,0,0,28000,0,28000,80000
20200212,4909,新復興,16.50,16.70,16.45,16.55,+0.10,0.61,68000,48,1125550,11000,0,11000,0,0,0,0,0,0,11000
20200212,4911,德英,35.80,35.80,35.70,35.75,-0.35,-0.97,15000,12,536550,0,0,0,0,0,0,0,0,0,0
20200212,4924,欣厚-KY,7.74,7.83,7.74,7.74,0.00,0.0,15000,6,116360,10000,0,10000,0,0,0,1000,0,1000,11000
20200212,4931,新盛力,33.85,34.80,33.80,34.30,+0.45,1.33,155000,115,5331600,10000,1000,9000,0,0,0,0,0,0,9000
20200212,4933,友輝,23.55,23.80,23.55,23.80,+0.30,1.28,97000,54,2292700,12000,16000,-4000,0,0,0,0,0,0,-4000
20200212,4939,亞電,14.55,14.90,14.50,14.85,+0.30,2.06,242000,153,3565200,49000,3000,46000,0,0,0,0,0,0,46000
20200212,4944,兆遠,11.15,12.30,11.00,12.25,+0.95,8.41,1034000,416,12075750,7000,2000,5000,0,0,0,0,0,0,5000
20200212,4946,辣椒,23.75,24.20,23.40,23.80,+0.05,0.21,53000,47,1262700,0,0,0,0,0,0,0,0,0,0
20200212,4947,昂寶-KY,222.50,222.50,222.00,222.50,+0.50,0.23,559000,186,124351000,402000,258000,144000,0,0,0,2000,0,2000,146000
20200212,4950,牧東,9.15,9.15,8.88,9.00,-0.12,-1.32,12000,6,107340,0,0,0,0,0,0,0,0,0,0
20200212,4953,緯軟,92.70,92.70,91.60,92.00,+0.30,0.33,613000,533,56514600,68000,41000,27000,0,0,0,21000,27000,-6000,21000
20200212,4966,譜瑞-KY,678.00,703.00,678.00,691.00,+18.00,2.67,1670000,1520,1156057000,230000,384230,-154230,109000,43000,66000,44000,32000,12000,-76230
20200212,4971,IET-KY,55.40,57.00,55.40,56.30,+1.40,2.55,165000,140,9317500,23000,11000,12000,0,0,0,0,0,0,12000
20200212,4972,湯石照明,29.60,29.90,29.30,29.40,+0.10,0.34,40000,34,1175900,0,0,0,0,0,0,0,0,0,0
20200212,4973,廣穎,33.25,33.95,32.80,33.30,-0.05,-0.15,4380000,2531,146059900,139000,364000,-225000,0,0,0,0,0,0,-225000
20200212,4974,亞泰,57.50,57.90,56.50,57.00,-0.30,-0.52,2360000,1591,134844900,106000,130000,-24000,0,0,0,5000,138000,-133000,-157000
20200212,4979,華星光,21.00,21.30,20.85,21.10,+0.30,1.44,1505000,706,31819300,66000,57000,9000,0,0,0,0,0,0,9000
20200212,4987,科誠,58.40,59.00,58.30,58.70,+0.30,0.51,24000,16,1405600,0,0,0,0,0,0,0,0,0,0
20200212,4991,環宇-KY,63.00,63.70,62.80,63.20,+0.70,1.12,300000,264,18989200,60000,40000,20000,0,30000,-30000,3000,6000,-3000,-13000
20200212,4995,晶達,47.90,47.90,47.90,47.90,+0.30,0.63,1000,1,47900,0,0,0,0,0,0,0,0,0,0
20200212,5009,榮剛,16.95,17.15,16.90,17.10,+0.10,0.59,440000,223,7497800,106000,9000,97000,0,100000,-100000,0,0,0,-3000
20200212,5011,久陽,14.50,14.50,14.50,14.50,0.00,0.0,1000,1,14500,0,0,0,0,0,0,0,0,0,0
20200212,5013,強新,25.00,25.10,24.45,24.45,-0.65,-2.59,14000,7,349050,0,0,0,0,0,0,0,0,0,0
20200212,5014,建錩,9.00,9.35,8.97,9.25,+0.28,3.12,580000,234,5309000,47000,0,47000,0,0,0,11000,24000,-13000,34000
20200212,5015,華祺,37.35,37.35,36.55,36.55,+0.15,0.41,18000,15,663100,0,1000,-1000,0,0,0,0,0,0,-1000
20200212,5016,松和,28.25,28.25,28.05,28.05,-0.15,-0.53,7000,6,197100,0,0,0,0,0,0,0,0,0,0
20200212,5102,富強,15.40,15.55,15.40,15.50,+0.10,0.65,38000,15,587850,0,0,0,0,0,0,0,0,0,0
20200212,5201,凱衛,30.05,30.40,29.90,29.95,-0.10,-0.33,30000,25,901350,4000,0,4000,0,0,0,0,0,0,4000
20200212,5202,力新,,,,,,0.00,0,0,0,0,0,0,0,0,0,0,0,0,0
20200212,5205,中茂,,,,,,0.00,0,0,0,0,0,0,0,0,0,0,0,0,0
20200212,5206,坤悅,17.90,18.10,17.90,17.95,+0.05,0.28,319000,156,5732100,0,42000,-42000,0,0,0,0,0,0,-42000
20200212,5209,新鼎,58.90,59.40,55.30,55.70,-3.10,-5.27,232000,198,13129700,0,3000,-3000,0,0,0,0,0,0,-3000
20200212,5210,寶碩,7.29,7.29,7.18,7.18,-0.07,-0.97,70000,34,504050,0,4000,-4000,0,0,0,0,0,0,-4000
20200212,5211,蒙恬,14.75,14.75,14.60,14.65,0.00,0.0,45000,17,659100,0,0,0,0,0,0,0,0,0,0
20200212,5212,凌網,42.90,43.30,42.25,42.70,+0.60,1.43,200000,156,8557100,41000,9000,32000,0,0,0,1000,0,1000,33000
20200212,5213,亞昕,16.35,16.45,16.35,16.45,+0.10,0.61,412000,124,6752800,1000,24000,-23000,0,0,0,0,0,0,-23000
20200212,5220,萬達光電,26.55,26.95,26.50,26.95,+0.45,1.7,221000,74,5882000,8000,2000,6000,0,0,0,0,0,0,6000
20200212,5223,安力-KY,32.70,32.70,32.00,32.00,+0.30,0.95,33000,30,1059150,4000,2000,2000,0,0,0,0,0,0,2000
20200212,5227,立凱-KY,14.55,14.85,14.55,14.70,+0.20,1.38,350000,169,5156600,8000,24000,-16000,0,0,0,0,0,0,-16000
20200212,5230,雷笛克光學,24.95,24.95,24.30,24.45,0.00,0.0,69000,44,1689600,0,1000,-1000,0,0,0,0,0,0,-1000
20200212,5245,智晶,25.10,25.70,25.10,25.55,+0.50,2.0,327000,234,8302000,6000,29846,-23846,0,0,0,0,0,0,-23846
20200212,5251,天鉞電,12.25,12.25,12.15,12.20,-0.10,-0.81,47000,26,573500,0,0,0,0,0,0,0,0,0,0
20200212,5263,智崴,153.50,155.50,153.00,155.00,+2.50,1.64,88000,85,13615500,12000,4000,8000,0,0,0,1000,0,1000,9000
20200212,5272,笙科,22.80,23.20,22.60,22.90,+0.45,2.0,263000,180,6034100,16000,8000,8000,0,0,0,0,0,0,8000
20200212,5274,信驊,939.00,946.00,930.00,937.00,+6.00,0.64,322000,313,301301000,133000,67000,66000,2000,44000,-42000,11000,1000,10000,34000
20200212,5276,達輝-KY,11.30,11.30,11.15,11.15,-0.15,-1.33,2000,2,22450,0,0,0,0,0,0,0,0,0,0
20200212,5278,尚凡,133.50,133.50,131.50,132.50,+1.00,0.76,39000,37,5170500,1000,0,1000,0,0,0,0,0,0,1000
20200212,5281,大峽谷-KY,20.55,20.80,20.50,20.75,+0.40,1.97,69000,47,1423100,1000,0,1000,0,0,0,0,0,0,1000
20200212,5287,數字,230.00,235.00,230.00,235.00,+5.00,2.17,35000,32,8156500,4000,15000,-11000,0,0,0,0,0,0,-11000
20200212,5289,宜鼎,201.00,201.00,194.00,197.00,0.00,0.0,1596000,1271,314834500,393000,368000,25000,0,0,0,32000,70000,-38000,-13000
20200212,5291,邑昇,27.05,27.65,26.80,27.25,+0.45,1.68,163000,125,4441750,25000,13000,12000,0,0,0,0,0,0,12000
20200212,5299,杰力,100.50,103.00,100.00,101.00,+1.40,1.41,553000,466,56043500,40000,1000,39000,0,0,0,0,0,0,39000
20200212,5301,寶得利,10.30,10.30,10.05,10.25,-0.10,-0.97,68000,37,689450,2000,5000,-3000,0,0,0,0,0,0,-3000
20200212,5302,太欣,6.19,6.20,5.95,5.97,-0.06,-1.0,513000,180,3109820,0,24000,-24000,0,0,0,0,0,0,-24000
20200212,5304,鼎創達,2.59,2.59,2.59,2.59,-0.16,-5.82,5000,3,12950,0,0,0,0,0,0,0,0,0,0
20200212,5306,桂盟,101.50,102.00,101.00,102.00,+1.00,0.99,25000,15,2541500,9000,0,9000,0,0,0,0,0,0,9000
20200212,5309,系統電,21.00,21.00,20.00,20.20,-0.40,-1.94,4829000,2089,98701300,29000,306281,-277281,0,0,0,0,0,0,-277281
20200212,5310,天剛,17.10,17.20,16.90,17.15,-0.25,-1.44,16000,16,272550,0,0,0,0,0,0,0,0,0,0
20200212,5312,寶島科,64.80,65.50,64.80,65.00,+0.50,0.78,27000,22,1758700,0,0,0,0,0,0,0,0,0,0
20200212,5314,世紀,5.77,5.77,5.77,5.77,-0.07,-1.2,1000,1,5770,0,0,0,0,0,0,0,0,0,0
20200212,5315,光聯,14.40,14.70,14.30,14.60,+0.20,1.39,811000,189,11834150,45000,0,45000,0,0,0,0,0,0,45000
20200212,5321,友銓,31.50,32.20,31.30,31.80,+0.10,0.32,16000,9,505950,0,0,0,0,0,0,0,0,0,0
20200212,5324,士開,9.40,9.45,9.34,9.43,+0.03,0.32,107000,50,1003170,0,0,0,0,0,0,0,0,0,0
20200212,5328,華容,9.72,9.94,9.65,9.80,-0.02,-0.2,1151000,522,11258480,123000,5000,118000,0,0,0,19000,2000,17000,135000
20200212,5340,建榮,48.05,49.10,47.75,47.75,-0.15,-0.31,598000,427,28936100,14000,35000,-21000,0,0,0,58000,46000,12000,-9000
20200212,5344,立衛,7.28,7.31,7.15,7.25,+0.02,0.28,69000,27,499830,0,3000,-3000,0,0,0,0,0,0,-3000
20200212,5345,天揚,5.32,5.79,5.32,5.71,+0.25,4.58,10000,5,54960,0,0,0,0,0,0,0,0,0,0
20200212,5347,世界,77.50,78.90,77.50,78.50,+1.50,1.95,4810000,2891,376727800,1849000,1616148,232852,28000,0,28000,19000,26000,-7000,253852
20200212,5348,系通,8.15,8.15,8.15,8.15,+0.05,0.62,1000,1,8150,0,0,0,0,0,0,0,0,0,0
20200212,5349,先豐,22.20,22.70,22.20,22.40,+0.25,1.13,457000,283,10259250,78000,36000,42000,0,0,0,0,0,0,42000
20200212,5351,鈺創,9.18,9.32,9.18,9.27,+0.13,1.42,443000,169,4097170,8000,6000,2000,0,0,0,0,0,0,2000
20200212,5353,台林,17.80,18.05,17.80,17.95,0.00,0.0,87000,39,1559950,8000,0,8000,0,0,0,0,0,0,8000
20200212,5355,佳總,4.78,4.78,4.78,4.78,+0.02,0.42,10000,2,47800,0,0,0,0,0,0,0,0,0,0
20200212,5356,協益,29.20,29.45,29.20,29.20,0.00,0.0,130000,87,3808400,17000,4000,13000,0,0,0,0,0,0,13000
20200212,5364,力麗店,,,,,,0.00,0,0,0,0,0,0,0,0,0,0,0,0,0
20200212,5371,中光電,35.70,37.60,35.70,37.45,+1.75,4.9,1881000,1226,69269250,1198000,432000,766000,0,0,0,33000,22000,11000,777000
20200212,5381,合正,3.05,3.06,3.05,3.06,0.00,0.0,10000,4,30570,0,0,0,0,0,0,0,0,0,0
20200212,5383,金利,24.70,25.00,24.55,25.00,+0.50,2.04,103000,47,2558050,0,0,0,0,0,0,0,0,0,0
20200212,5386,青雲,33.00,33.80,32.05,32.40,-0.20,-0.61,549000,426,17925550,4000,16000,-12000,0,0,0,0,0,0,-12000
20200212,5392,應華,29.80,29.85,29.55,29.75,+0.15,0.51,129000,95,3829700,6000,4000,2000,0,0,0,0,0,0,2000
20200212,5398,慕康生醫,26.90,26.90,26.70,26.75,-0.25,-0.93,13000,12,348650,0,0,0,0,0,0,0,0,0,0
20200212,5403,中菲,44.80,45.00,44.55,45.00,+0.20,0.45,77000,55,3448750,9000,0,9000,0,0,0,0,0,0,9000
20200212,5410,國眾,19.40,19.55,19.30,19.40,+0.10,0.52,148000,71,2872550,0,4000,-4000,0,0,0,0,0,0,-4000
20200212,5425,台半,46.20,46.70,45.95,46.70,+0.40,0.86,1869000,1221,86752750,430000,426000,4000,0,0,0,70000,0,70000,74000
20200212,5426,振發,11.05,11.05,10.95,11.05,0.00,0.0,30000,16,329900,0,0,0,0,0,0,0,2000,-2000,-2000
20200212,5432,達威,17.15,17.30,16.90,17.30,+0.25,1.47,17000,16,291150,0,0,0,0,0,0,0,0,0,0
20200212,5438,東友,14.30,14.30,14.10,14.15,-0.10,-0.7,188000,73,2669050,0,0,0,0,0,0,0,0,0,0
20200212,5439,高技,37.30,38.20,37.30,37.95,+0.65,1.74,237000,159,8973150,45000,15000,30000,0,0,0,0,0,0,30000
20200212,5443,均豪,19.00,19.30,19.00,19.30,+0.30,1.58,412000,184,7907800,41000,4000,37000,0,0,0,0,0,0,37000
20200212,5450,寶聯通,15.50,16.05,15.20,15.80,+0.55,3.61,28000,20,431300,0,2000,-2000,0,0,0,0,2000,-2000,-4000
20200212,5452,佶優,6.44,6.58,6.42,6.53,+0.09,1.4,172000,63,1116540,0,8000,-8000,0,0,0,0,0,0,-8000
20200212,5455,昇益,,,,,,0.00,0,0,0,0,0,0,0,0,0,0,0,0,0
20200212,5457,宣德,77.00,79.70,77.00,79.70,+1.50,1.92,3056000,2093,239655400,112000,147000,-35000,0,0,0,71000,462000,-391000,-426000
20200212,5460,同協,11.80,11.90,11.80,11.90,+0.05,0.42,40000,20,474250,0,0,0,0,0,0,0,0,0,0
20200212,5464,霖宏,13.50,13.50,13.35,13.35,-0.20,-1.48,29000,21,388650,0,0,0,0,0,0,0,0,0,0
20200212,5465,富驊,12.05,12.05,11.90,11.90,-0.15,-1.24,201000,70,2401500,0,0,0,0,0,0,0,0,0,0
20200212,5468,凱鈺,12.10,12.15,11.80,12.15,+0.85,7.52,8000,6,96350,0,0,0,0,0,0,0,0,0,0
20200212,5474,聰泰,74.10,75.10,74.00,74.50,+0.80,1.09,29000,25,2164300,1000,7000,-6000,0,0,0,5000,0,5000,-1000
20200212,5475,德宏,3.05,3.08,2.97,3.04,-0.04,-1.3,88000,34,267460,0,0,0,0,0,0,0,0,0,0
20200212,5478,智冠,81.20,81.20,80.10,80.50,0.00,0.0,118000,105,9496200,25000,25000,0,0,0,0,0,0,0,0
20200212,5481,新華,14.10,14.35,14.10,14.35,+0.25,1.77,597000,106,8533400,34000,0,34000,0,0,0,0,0,0,34000
20200212,5483,中美晶,103.50,106.00,102.50,103.50,+0.50,0.49,14679000,7987,1533512500,612000,571000,41000,0,0,0,955000,581000,374000,415000
20200212,5487,通泰,37.85,38.10,37.65,38.00,+0.10,0.26,42000,32,1589850,7000,0,7000,0,0,0,0,0,0,7000
20200212,5488,松普,6.04,6.10,6.03,6.10,+0.05,0.83,114000,36,689730,10000,0,10000,0,0,0,0,0,0,10000
20200212,5489,彩富,32.25,32.35,32.15,32.35,+0.10,0.31,34000,16,1098600,0,0,0,0,0,0,0,0,0,0
20200212,5490,同亨,30.00,30.30,29.90,30.20,+0.15,0.5,293000,175,8818200,9000,33000,-24000,0,0,0,0,0,0,-24000
20200212,5493,三聯,47.20,47.35,46.10,46.50,-0.50,-1.06,190000,116,8824200,19000,16000,3000,0,0,0,0,0,0,3000
20200212,5498,凱崴,10.90,11.25,10.75,11.15,+0.45,4.21,935000,390,10380100,72000,10000,62000,0,0,0,0,0,0,62000
20200212,5508,永信建,33.45,33.65,33.40,33.50,+0.05,0.15,34000,22,1138850,0,0,0,0,0,0,0,0,0,0
20200212,5511,德昌,29.90,30.00,29.80,30.00,+0.05,0.17,231000,54,6908150,0,4000,-4000,0,0,0,0,0,0,-4000
20200212,5512,力麒,9.90,9.93,9.88,9.90,0.00,0.0,548000,175,5425340,0,89000,-89000,0,0,0,1000,0,1000,-88000
20200212,5514,三豐,18.10,18.45,18.10,18.40,+0.30,1.66,30000,18,549800,0,0,0,0,0,0,0,2000,-2000,-2000
20200212,5516,雙喜,14.70,14.70,14.15,14.20,-0.40,-2.74,26000,21,370750,0,0,0,0,0,0,0,0,0,0
20200212,5520,力泰,32.35,32.35,32.35,32.35,+0.05,0.15,2000,2,64700,0,0,0,0,0,0,0,0,0,0
20200212,5523,豐謙,10.95,11.10,10.95,11.10,+0.15,1.37,36000,20,396100,0,0,0,0,0,0,0,0,0,0
20200212,5529,志嘉,8.23,9.04,8.23,9.04,+0.82,9.98,1403000,393,12436300,32000,1000,31000,0,0,0,0,0,0,31000
20200212,5530,龍巖,61.30,61.30,61.00,61.10,0.00,0.0,227000,170,13858600,43000,97600,-54600,0,0,0,0,0,0,-54600
20200212,5536,聖暉,174.00,175.00,173.50,175.00,+1.00,0.57,193000,152,33667000,4000,9000,-5000,0,0,0,0,0,0,-5000
20200212,5543,崇佑-KY,19.80,20.70,19.80,20.70,+0.30,1.47,14000,5,287500,0,0,0,0,0,0,0,1000,-1000,-1000
20200212,5601,台聯櫃,,,,,,0.00,0,0,0,0,0,0,0,0,0,0,0,0,0
20200212,5603,陸海,11.00,11.00,11.00,11.00,+0.15,1.38,3000,3,33000,0,0,0,0,0,0,0,0,0,0
20200212,5604,中連貨,40.35,41.85,40.35,41.75,+1.40,3.47,115000,71,4760200,0,0,0,0,0,0,0,1000,-1000,-1000
20200212,5609,中菲行,26.10,26.80,26.10,26.55,+0.45,1.72,514000,248,13610150,164000,68000,96000,0,0,0,17000,2000,15000,111000
20200212,5701,劍湖山,1.65,1.65,1.61,1.61,-0.03,-1.83,218000,17,356660,0,0,0,0,0,0,0,0,0,0
20200212,5703,亞都,25.95,25.95,25.95,25.95,+0.95,3.8,1000,1,25950,1000,0,1000,0,0,0,0,0,0,1000
20200212,5704,老爺知,,,,,,0.00,0,0,0,0,0,0,0,0,0,0,0,0,0
20200212,5820,日盛金,10.00,10.05,9.99,10.05,+0.05,0.5,1360000,591,13629800,293000,189000,104000,0,0,0,0,0,0,104000
20200212,5864,致和證,8.98,9.00,8.96,8.96,+0.02,0.22,152000,38,1364860,0,0,0,0,0,0,0,0,0,0
20200212,5878,台名,45.50,45.60,45.50,45.50,-0.05,-0.11,20000,15,910550,0,0,0,0,0,0,0,0,0,0
20200212,5902,德記,10.40,10.45,10.30,10.40,+0.10,0.97,30000,10,310100,0,0,0,0,0,0,0,0,0,0
20200212,5903,全家,218.00,219.00,218.00,218.50,+0.50,0.23,20000,18,4367500,8000,12000,-4000,0,2000,-2000,0,0,0,-6000
20200212,5904,寶雅,440.00,444.00,439.50,442.00,-1.00,-0.23,44000,41,19436000,8000,6000,2000,0,0,0,1000,0,1000,3000
20200212,5905,南仁湖,10.50,10.70,10.40,10.65,+0.35,3.4,1138000,503,12016050,182000,22000,160000,0,0,0,0,0,0,160000
20200212,6015,宏遠證,6.42,6.42,6.38,6.40,+0.02,0.31,300000,52,1920640,0,57000,-57000,0,0,0,0,0,0,-57000
20200212,6016,康和證,7.37,7.54,7.37,7.41,+0.01,0.14,173000,83,1287330,12000,59000,-47000,0,0,0,0,0,0,-47000
20200212,6020,大展證,12.65,12.65,12.65,12.65,0.00,0.0,2000,1,25300,0,0,0,0,0,0,0,0,0,0
20200212,6021,大慶證,13.50,14.00,13.50,14.00,+0.25,1.82,320000,55,4452650,0,0,0,0,0,0,0,0,0,0
20200212,6023,元大期,55.50,55.80,55.50,55.80,+0.10,0.18,168000,85,9341200,4000,1000,3000,0,0,0,0,0,0,3000
20200212,6026,福邦證,8.86,8.88,8.84,8.88,+0.03,0.34,336000,94,2977880,3000,21000,-18000,0,0,0,0,0,0,-18000
20200212,6101,寬魚國際,30.00,30.95,29.95,30.35,+0.20,0.66,61000,46,1853400,4000,0,4000,0,0,0,1000,1000,0,4000
20200212,6103,合邦,,,,,,0.00,0,0,0,0,0,0,0,0,0,0,0,0,0
20200212,6104,創惟,32.55,32.75,32.55,32.75,+0.20,0.61,365000,216,11923450,32000,12000,20000,0,0,0,0,0,0,20000
20200212,6109,亞元,10.35,10.35,10.25,10.35,0.00,0.0,10000,9,103200,0,0,0,0,0,0,0,0,0,0
20200212,6111,大宇資,91.80,92.40,91.30,91.80,0.00,0.0,307000,262,28208500,62000,14000,48000,0,0,0,0,0,0,48000
20200212,6113,亞矽,6.17,6.29,6.17,6.20,+0.01,0.16,10000,7,62040,0,0,0,0,0,0,0,0,0,0
20200212,6114,久威,29.10,29.80,29.10,29.40,+0.40,1.38,65000,57,1920200,4000,0,4000,0,0,0,0,0,0,4000
20200212,6118,建達,9.12,9.13,9.02,9.02,+0.02,0.22,64000,39,581320,0,0,0,0,0,0,0,0,0,0
20200212,6121,新普,318.50,321.50,315.50,320.00,+5.50,1.75,1379000,1208,439529500,1011000,185000,826000,0,15000,-15000,8000,31000,-23000,788000
20200212,6122,擎邦,11.65,11.65,11.50,11.60,+0.05,0.43,100000,42,1158150,0,0,0,0,0,0,0,0,0,0
20200212,6123,上奇,41.90,43.20,41.70,42.90,+1.30,3.12,473000,272,20073500,17000,5000,12000,0,0,0,20000,0,20000,32000
20200212,6124,業強,34.80,34.80,33.80,34.30,0.00,0.0,43000,31,1469400,0,3000,-3000,0,0,0,0,5000,-5000,-8000
20200212,6125,廣運,15.85,15.95,15.70,15.75,-0.05,-0.32,2033000,585,32091850,52000,58000,-6000,0,0,0,0,0,0,-6000
20200212,6126,信音,12.70,12.85,12.60,12.80,+0.20,1.59,445000,143,5658100,14000,10000,4000,0,0,0,0,0,0,4000
20200212,6127,九豪,15.55,17.00,15.55,16.80,+1.25,8.04,6892000,3270,113115050,464000,109000,355000,0,0,0,0,0,0,355000
20200212,6129,普誠,7.48,7.66,7.48,7.60,+0.13,1.74,321000,143,2439590,5000,26000,-21000,0,0,0,0,0,0,-21000
20200212,6130,星寶國際,28.60,29.70,28.55,29.45,+0.15,0.51,30000,29,875100,0,0,0,0,0,0,1000,0,1000,1000
20200212,6134,萬旭,7.71,7.79,7.54,7.67,-0.04,-0.52,39000,24,297690,0,0,0,0,0,0,0,1000,-1000,-1000
20200212,6138,茂達,71.50,72.20,71.20,71.50,+0.30,0.42,415000,300,29749300,14000,50000,-36000,0,0,0,7000,3000,4000,-32000
20200212,6140,訊達,10.15,10.90,10.15,10.70,+0.40,3.88,163000,65,1711450,5000,0,5000,0,0,0,0,0,0,5000
20200212,6143,振曜,35.10,35.90,35.10,35.70,+0.65,1.85,130000,83,4619250,23000,28000,-5000,0,0,0,0,0,0,-5000
20200212,6144,得利影,7.31,7.77,7.31,7.77,-0.21,-2.63,4000,4,30380,0,0,0,0,0,0,0,0,0,0
20200212,6146,耕興,205.00,205.50,203.50,204.00,-1.00,-0.49,47000,47,9600000,18000,12000,6000,0,4000,-4000,1000,0,1000,3000
20200212,6147,頎邦,62.00,62.30,61.70,62.00,+0.50,0.81,3454000,2188,214478900,654000,962000,-308000,0,0,0,34000,114000,-80000,-388000
20200212,6148,驊宏資,9.33,9.44,9.30,9.35,-0.04,-0.43,148000,19,1381000,0,0,0,0,0,0,0,0,0,0
20200212,6150,撼訊,64.70,65.40,63.00,63.70,+0.70,1.11,2974000,2176,190286100,10000,80000,-70000,0,0,0,0,0,0,-70000
20200212,6151,晉倫,19.00,19.15,18.95,19.10,+0.10,0.53,26000,14,494200,0,0,0,0,0,0,0,0,0,0
20200212,6154,順發,13.70,13.85,13.70,13.85,0.00,0.0,9000,9,123700,0,0,0,0,0,0,0,0,0,0
20200212,6156,松上,12.00,12.15,12.00,12.05,+0.05,0.42,85000,32,1022750,0,0,0,0,0,0,0,0,0,0
20200212,6158,禾昌,24.25,24.50,24.25,24.35,+0.10,0.41,87000,64,2118500,19000,13000,6000,0,0,0,0,0,0,6000
20200212,6160,欣技,17.50,17.60,17.40,17.55,-0.15,-0.85,89000,38,1557500,0,0,0,0,0,0,0,0,0,0
20200212,6161,捷波,19.05,19.30,19.05,19.20,+0.10,0.52,152000,72,2911700,19000,0,19000,0,0,0,0,0,0,19000
20200212,6163,華電網,14.30,14.55,14.30,14.50,+0.20,1.4,133000,86,1920550,20000,0,20000,0,0,0,0,0,0,20000
20200212,6167,久正,6.94,7.02,6.90,7.00,+0.01,0.14,375000,117,2613170,29000,1000,28000,0,0,0,0,0,0,28000
20200212,6169,昱泉,33.55,36.75,33.55,36.75,+3.30,9.87,1079000,654,38836150,20000,11000,9000,0,0,0,0,0,0,9000
20200212,6170,統振,17.00,17.75,17.00,17.45,+0.45,2.65,1396000,545,24371300,129000,22000,107000,0,0,0,2000,0,2000,109000
20200212,6171,亞銳士,22.00,22.60,22.00,22.30,+0.65,3.0,98000,57,2189100,0,5000,-5000,0,0,0,0,0,0,-5000
20200212,6173,信昌電,65.20,65.60,64.80,65.50,+0.30,0.46,3114000,2101,203162800,379000,91000,288000,0,0,0,28000,67000,-39000,249000
20200212,6174,安碁,13.70,13.70,13.70,13.70,-0.15,-1.08,2000,1,27400,0,0,0,0,0,0,0,0,0,0
20200212,6175,立敦,21.15,21.20,20.90,20.90,+0.10,0.48,150000,118,3153950,0,2000,-2000,0,0,0,0,0,0,-2000
20200212,6179,亞通,29.80,30.00,29.65,29.70,-0.30,-1.0,75000,41,2242750,0,0,0,0,24000,-24000,0,0,0,-24000
20200212,6180,橘子,58.80,58.80,57.80,58.10,-0.10,-0.17,2453000,1728,143071200,64150,113000,-48850,0,0,0,0,0,0,-48850
20200212,6182,合晶,32.50,34.15,32.45,33.60,+1.40,4.35,12935000,6821,432892900,676000,448000,228000,0,0,0,1256000,13000,1243000,1471000
20200212,6185,幃翔,18.45,18.70,18.30,18.45,0.00,0.0,552000,307,10212600,110000,35000,75000,0,0,0,0,3000,-3000,72000
20200212,6186,新潤,29.35,29.45,29.00,29.15,+0.05,0.17,101000,83,2951150,0,23000,-23000,0,0,0,17000,0,17000,-6000
20200212,6187,萬潤,41.20,41.20,40.30,40.80,-0.10,-0.24,127000,84,5144900,7000,0,7000,0,0,0,0,0,0,7000
20200212,6188,廣明,32.10,32.70,31.95,32.65,+0.75,2.35,2255000,1276,72975400,711000,304000,407000,0,0,0,72000,43000,29000,436000
20200212,6190,萬泰科,16.35,16.35,16.20,16.30,0.00,0.0,290000,92,4721050,0,2000,-2000,0,0,0,0,0,0,-2000
20200212,6194,育富,24.10,24.25,24.05,24.15,0.00,0.0,45000,32,1085900,0,1000,-1000,0,0,0,0,0,0,-1000
20200212,6195,詩肯,37.75,37.75,37.30,37.55,-0.20,-0.53,41000,34,1538150,0,0,0,0,0,0,0,0,0,0
20200212,6198,凌泰,12.70,12.70,12.70,12.70,-0.20,-1.55,2000,1,25400,0,0,0,0,0,0,0,0,0,0
20200212,6199,天品,13.25,13.25,13.25,13.25,-0.55,-3.99,1000,1,13250,0,0,0,0,0,0,0,0,0,0
20200212,006201,元大富櫃50,13.72,13.97,13.72,13.96,+0.24,1.75,76000,62,1055580,0,0,0,0,0,0,45000,0,45000,45000
20200212,6203,海韻電,40.50,41.45,40.05,40.90,+1.25,3.15,3421000,2148,139318950,62000,104000,-42000,0,0,0,0,0,0,-42000
20200212,6204,艾華,22.85,23.70,22.70,23.50,+0.65,2.84,17000,14,390350,0,0,0,0,0,0,0,0,0,0
20200212,6207,雷科,23.85,24.20,23.85,24.20,+0.35,1.47,62000,46,1493900,3000,3000,0,0,0,0,0,0,0,0
20200212,6208,日揚,25.75,26.05,25.75,25.85,+0.05,0.19,71000,47,1840200,5000,1000,4000,0,0,0,0,0,0,4000
20200212,6210,慶生,46.55,48.70,46.25,48.60,+2.05,4.4,490000,305,23596850,20000,1000,19000,0,0,0,0,0,0,19000
20200212,6212,理銘,44.30,44.30,44.30,44.30,+0.10,0.23,3000,3,132900,0,0,0,0,0,0,0,0,0,0
20200212,6217,中探針,32.85,33.75,32.85,33.45,+0.50,1.52,614000,401,20441700,43000,14000,29000,0,0,0,0,0,0,29000
20200212,6218,豪勉,20.30,20.40,20.30,20.40,+0.10,0.49,42000,10,856400,0,0,0,0,0,0,0,0,0,0
20200212,6219,富旺,16.10,16.75,16.10,16.50,+0.45,2.8,3559000,460,58112150,41000,129000,-88000,0,0,0,0,0,0,-88000
20200212,6220,岳豐,22.90,23.00,22.80,23.00,+0.10,0.44,124000,77,2837650,0,16000,-16000,0,0,0,0,0,0,-16000
20200212,6221,晉泰,40.50,40.85,40.10,40.50,0.00,0.0,20000,20,809000,0,9000,-9000,0,0,0,0,0,0,-9000
20200212,6222,上揚,14.10,14.10,14.10,14.10,-1.05,-6.93,1000,1,14100,0,0,0,0,0,0,0,0,0,0
20200212,6223,旺矽,74.00,75.10,74.00,74.20,+0.60,0.82,791000,613,58918700,33000,105000,-72000,0,0,0,20000,18000,2000,-70000
20200212,6227,茂綸,21.40,21.75,21.40,21.75,+0.15,0.69,26000,19,560500,2000,0,2000,0,0,0,0,0,0,2000
20200212,6228,全譜,6.27,6.27,6.07,6.09,-0.02,-0.33,3000,3,18430,0,0,0,0,0,0,0,0,0,0
20200212,6229,研通,13.10,13.35,13.10,13.35,+0.35,2.69,98000,51,1298200,10000,0,10000,0,0,0,0,9000,-9000,1000
20200212,6231,系微,60.60,63.00,60.60,61.60,+3.10,5.3,2436000,1947,150899000,78000,164000,-86000,0,0,0,0,0,0,-86000
20200212,6233,旺玖,11.95,12.30,11.80,12.15,+0.20,1.67,1087000,408,13183500,169000,50000,119000,0,0,0,0,0,0,119000
20200212,6234,高僑,29.65,29.65,29.00,29.45,+0.05,0.17,189000,144,5530650,0,50000,-50000,0,0,0,0,0,0,-50000
20200212,6236,康呈,,,,,,0.00,0,0,0,0,0,0,0,0,0,0,0,0,0
20200212,6237,驊訊,16.05,16.30,16.05,16.20,+0.20,1.25,101000,47,1634850,0,0,0,0,0,0,0,0,0,0
20200212,6238,勝麗,173.50,179.00,173.00,175.50,+2.00,1.15,1766000,1239,310670000,463000,95000,368000,10000,68,9932,100000,83000,17000,394932
20200212,6240,松崗,16.25,16.25,15.90,16.00,-0.15,-0.93,19000,12,305150,0,0,0,0,0,0,0,0,0,0
20200212,6241,易通展,11.40,11.65,11.30,11.40,+0.05,0.44,27000,12,307400,0,0,0,0,0,0,0,0,0,0
20200212,6242,立康,38.50,38.50,38.50,38.50,0.00,0.0,1000,1,38500,0,0,0,0,0,0,0,0,0,0
20200212,6244,茂迪,7.39,7.48,7.33,7.42,+0.02,0.27,990000,368,7338880,73000,78000,-5000,0,0,0,0,0,0,-5000
20200212,6245,立端,57.40,61.60,57.30,60.20,+3.20,5.61,1749000,1244,104239400,106000,158156,-52156,281000,0,281000,48000,0,48000,276844
20200212,6246,臺龍,8.69,8.69,8.59,8.67,+0.06,0.7,9000,7,77970,0,0,0,0,0,0,0,0,0,0
20200212,6247,淇譽電,9.83,9.83,9.83,9.83,0.00,0.0,2000,1,19660,0,0,0,0,0,0,0,0,0,0
20200212,6248,沛波,27.85,27.85,27.85,27.85,0.00,0.0,3000,1,83550,0,0,0,0,0,0,0,0,0,0
20200212,6259,百徽,2.38,2.46,2.30,2.30,0.00,0.0,24000,6,55780,0,0,0,0,0,0,0,0,0,0
20200212,6261,久元,49.35,49.95,49.30,49.60,+0.50,1.02,824000,464,40868200,122000,49000,73000,0,0,0,23000,0,23000,96000
20200212,6263,普萊德,63.50,64.00,63.50,64.00,+0.70,1.11,56000,49,3565500,3000,6676,-3676,0,0,0,9000,0,9000,5324
20200212,6264,富裔,6.10,6.10,6.10,6.10,+0.06,0.99,2000,2,12200,0,0,0,0,0,0,0,0,0,0
20200212,6265,方土昶,6.92,6.93,6.84,6.90,-0.01,-0.14,161000,84,1107860,0,0,0,0,0,0,0,0,0,0
20200212,6266,泰詠,19.50,19.95,19.50,19.75,+0.45,2.33,559000,198,11068300,10000,6000,4000,0,0,0,0,0,0,4000
20200212,6270,倍微,14.45,14.50,14.45,14.45,0.00,0.0,93000,44,1345400,6000,0,6000,0,0,0,0,0,0,6000
20200212,6274,台燿,134.00,137.50,133.00,137.50,+6.50,4.96,3693000,2316,502020000,1357000,547000,810000,20000,150000,-130000,608000,39000,569000,1249000
20200212,6275,元山,17.05,17.40,16.95,17.30,+0.10,0.58,191000,101,3291800,33000,3000,30000,0,0,0,0,0,0,30000
20200212,6276,安鈦克,16.80,17.75,16.80,16.95,+0.30,1.8,1486000,986,25595950,43000,88000,-45000,0,0,0,5000,7000,-2000,-47000
20200212,6279,胡連,88.30,91.80,88.30,91.40,+3.70,4.22,706000,608,63767400,63000,20000,43000,0,0,0,49000,37000,12000,55000
20200212,6284,佳邦,33.15,34.65,33.15,34.50,+1.35,4.07,1255000,669,42892150,132000,9000,123000,0,0,0,67000,1000,66000,189000
20200212,6287,元隆,1.70,1.80,1.70,1.80,0.00,0.0,2000,2,3500,0,0,0,0,0,0,0,0,0,0
20200212,6290,良維,60.00,60.90,59.70,60.70,+1.00,1.68,1668000,1032,100657200,233000,75000,158000,0,0,0,130000,10000,120000,278000
20200212,6291,沛亨,11.00,13.00,11.00,13.00,+1.15,9.7,2000,2,24000,0,0,0,0,0,0,0,0,0,0
20200212,6292,迅德,34.50,35.10,34.50,35.10,+0.60,1.74,90000,49,3138650,3000,0,3000,0,0,0,0,0,0,3000
20200212,6294,智基,101.00,101.50,100.50,101.00,0.00,0.0,14000,13,1414000,0,0,0,0,0,0,0,0,0,0
20200212,6404,通訊-KY,3.21,3.34,3.21,3.32,-0.06,-1.78,26000,14,85450,0,0,0,0,0,0,0,0,0,0
20200212,6411,晶焱,92.50,94.60,92.50,94.00,+2.30,2.51,1316000,1056,123518100,244000,52000,192000,0,0,0,44000,3000,41000,233000
20200212,6417,韋僑,65.60,65.90,65.60,65.80,-0.80,-1.2,7000,7,460500,0,0,0,0,0,0,0,0,0,0
20200212,6418,詠昇,15.50,15.85,15.45,15.80,+0.15,0.96,9000,8,140700,0,0,0,0,0,0,0,0,0,0
20200212,6419,京晨科,6.80,6.98,6.70,6.93,+0.13,1.91,62000,34,422390,0,0,0,0,0,0,0,0,0,0
20200212,6425,易發,25.90,25.90,25.80,25.80,0.00,0.0,24000,14,619750,0,0,0,0,0,0,0,0,0,0
20200212,6426,統新,139.00,146.00,138.50,142.00,+3.50,2.53,2184000,1723,312052500,115000,44000,71000,0,0,0,144000,18000,126000,197000
20200212,6432,今展科,32.60,32.80,31.55,31.90,-0.05,-0.16,1195000,782,38463250,18000,57000,-39000,0,0,0,7000,0,7000,-32000
20200212,6435,大中,98.00,101.00,98.00,100.00,+2.30,2.35,598000,504,59592900,13000,4000,9000,0,33000,-33000,6000,48000,-42000,-66000
20200212,6438,迅得,70.20,72.70,70.20,71.00,+1.50,2.16,1713000,1297,122732300,23000,23000,0,0,0,0,126000,21000,105000,105000
20200212,6441,廣錠,53.90,58.70,53.70,58.00,+4.50,8.41,1667000,1129,93423000,37000,60000,-23000,0,0,0,0,0,0,-23000
20200212,6446,藥華藥,102.50,103.00,101.00,103.00,+1.00,0.98,228000,172,23314000,21000,5000,16000,0,0,0,5000,0,5000,21000
20200212,6457,紘康,28.80,28.95,28.75,28.90,+0.35,1.23,94000,50,2715650,0,0,0,0,0,0,0,0,0,0
20200212,6461,益得,17.00,17.20,17.00,17.15,+0.15,0.88,96000,65,1645050,8000,0,8000,0,0,0,0,0,0,8000
20200212,6462,神盾,222.00,226.00,222.00,223.00,+3.00,1.36,3473000,2691,777366500,478000,185000,293000,82000,0,82000,52000,197000,-145000,230000
20200212,6465,威潤,46.25,47.65,45.90,46.90,+0.50,1.08,102000,78,4716250,2000,1000,1000,0,0,0,1000,1000,0,1000
20200212,6469,大樹,82.40,83.10,82.40,82.60,+0.60,0.73,68000,54,5630600,3000,1000,2000,0,0,0,0,0,0,2000
20200212,6470,宇智,45.10,45.20,44.95,45.20,+0.40,0.89,71000,58,3199050,12000,5000,7000,0,0,0,0,0,0,7000
20200212,6472,保瑞,152.50,155.00,151.50,151.50,0.00,0.0,310000,266,47442500,1000,16000,-15000,0,0,0,3000,6000,-3000,-18000
20200212,6482,弘煜科,30.85,32.55,30.85,32.50,+1.95,6.38,44000,25,1404950,3000,0,3000,0,0,0,0,0,0,3000
20200212,6485,點序,37.30,37.30,36.65,36.85,-0.15,-0.41,215000,134,7926950,7000,6000,1000,0,0,0,0,1000,-1000,0
20200212,6486,互動,75.40,75.90,75.30,75.40,+0.10,0.13,151000,104,11427200,1000,6000,-5000,0,0,0,0,0,0,-5000
20200212,6488,環球晶,425.00,431.00,423.50,429.00,+6.00,1.42,3929000,2925,1681263500,992000,529877,462123,11000,0,11000,195000,90000,105000,578123
20200212,6492,生華科,63.30,64.70,63.30,64.40,+0.40,0.62,27000,22,1736500,21000,0,21000,0,0,0,0,0,0,21000
20200212,6494,九齊,30.60,31.00,30.40,30.70,+0.25,0.82,736000,260,22623950,4000,34000,-30000,0,0,0,0,0,0,-30000
20200212,6496,科懋,35.00,35.20,35.00,35.00,0.00,0.0,40000,36,1401150,2000,3000,-1000,0,0,0,0,0,0,-1000
20200212,6497,亞獅康-KY,7.19,7.19,6.90,6.96,0.00,0.0,17000,9,117650,0,0,0,0,0,0,0,0,0,0
20200212,6499,益安,59.00,59.40,58.40,58.70,+0.50,0.86,25000,23,1473600,0,0,0,0,0,0,0,0,0,0
20200212,6506,雙邦,18.50,18.60,18.40,18.45,0.00,0.0,167000,92,3085750,0,12000,-12000,0,0,0,0,0,0,-12000
20200212,6508,惠光,29.00,29.05,28.80,29.00,+0.05,0.17,43000,31,1246350,0,0,0,0,0,0,0,0,0,0
20200212,6509,聚和,18.60,18.75,18.50,18.60,+0.10,0.54,490000,196,9121700,0,1000,-1000,0,0,0,0,0,0,-1000
20200212,6510,精測,965.00,972.00,954.00,965.00,+17.00,1.79,558000,515,538349000,31000,40000,-9000,53000,0,53000,15000,19000,-4000,40000
20200212,6512,啟發電,14.30,14.35,14.30,14.35,0.00,0.0,5000,5,71550,0,0,0,0,0,0,0,0,0,0
20200212,6514,芮特-KY,64.10,64.60,63.20,63.50,+0.40,0.63,110000,93,7014600,15000,5000,10000,0,0,0,0,0,0,10000
20200212,6516,勤崴國際,100.00,100.50,99.60,100.50,+0.50,0.5,25000,25,2503100,0,0,0,0,0,0,0,0,0,0
20200212,6523,達爾膚,82.30,86.40,82.30,85.30,+4.10,5.05,743000,639,62535400,20000,202000,-182000,0,0,0,0,0,0,-182000
20200212,6527,明達醫,69.70,69.70,68.50,69.00,-0.30,-0.43,68000,60,4691900,0,0,0,0,0,0,0,0,0,0
20200212,6530,創威,17.20,17.50,17.10,17.50,+0.40,2.34,87000,42,1499750,10000,0,10000,0,0,0,0,0,0,10000
20200212,6532,瑞耘,43.00,44.00,42.50,42.95,-0.05,-0.12,3356000,2324,145010750,14000,105000,-91000,0,0,0,0,0,0,-91000
20200212,6535,順藥,31.70,32.25,31.70,32.20,+0.50,1.58,93000,77,2979400,6000,7000,-1000,0,0,0,0,0,0,-1000
20200212,6538,倉和,226.00,236.00,224.00,230.50,+12.00,5.49,4540000,3635,1043410000,353000,151000,202000,215000,0,215000,5000,0,5000,422000
20200212,6542,隆中,57.70,57.70,55.50,55.80,+0.90,1.64,18000,14,1012400,0,2000,-2000,0,0,0,0,0,0,-2000
20200212,6547,高端疫苗,31.50,32.00,31.30,31.60,+0.15,0.48,674000,424,21294150,0,0,0,0,0,0,0,0,0,0
20200212,6548,長科*,27.00,27.20,26.75,27.20,+0.45,1.68,199000,113,5373100,58000,33000,25000,0,0,0,0,0,0,25000
20200212,6556,勝品,45.40,45.40,45.40,45.40,-0.15,-0.33,1000,1,45400,0,0,0,0,0,0,0,0,0,0
20200212,6560,欣普羅,29.50,29.85,29.35,29.50,+0.15,0.51,37000,32,1092700,0,0,0,0,0,0,0,0,0,0
20200212,6561,是方,219.00,221.00,217.50,219.00,+1.50,0.69,37000,28,8120000,16000,3000,13000,0,0,0,0,0,0,13000
20200212,6568,宏觀,143.00,148.00,143.00,146.00,+3.50,2.46,89000,85,13006500,26000,8000,18000,0,0,0,0,0,0,18000
20200212,6569,醫揚,152.00,153.00,152.00,153.00,+1.50,0.99,10000,8,1525000,0,1000,-1000,0,0,0,0,0,0,-1000
20200212,6570,維田,37.45,37.45,37.45,37.45,+0.45,1.22,1000,1,37450,0,0,0,0,0,0,0,0,0,0
20200212,6574,霈方,,,,,,0.00,0,0,0,0,0,0,0,0,0,0,0,0,0
20200212,6576,逸達,52.70,54.40,52.70,54.10,+2.50,4.84,151000,124,8095000,0,10000,-10000,0,0,0,0,0,0,-10000
20200212,6577,勁豐,65.10,65.60,65.00,65.60,+0.60,0.92,9000,9,587400,0,0,0,0,0,0,0,0,0,0
20200212,6578,達邦蛋白,20.95,21.00,20.85,20.95,0.00,0.0,14000,11,293250,0,0,0,0,0,0,0,0,0,0
20200212,6589,台康生技,28.90,28.90,28.45,28.45,-0.10,-0.35,275000,176,7862700,0,13000,-13000,0,0,0,0,0,0,-13000
20200212,6590,普鴻,31.95,32.00,31.95,32.00,0.00,0.0,9000,9,287900,2000,0,2000,0,0,0,0,0,0,2000
20200212,6593,台灣銘板,26.40,26.40,26.35,26.35,+0.05,0.19,2000,2,52750,0,0,0,0,0,0,0,0,0,0
20200212,6594,展匯科,19.70,19.85,19.50,19.50,+0.10,0.52,13000,11,254750,0,0,0,0,0,0,0,0,0,0
20200212,6596,寬宏藝術,63.30,64.80,63.30,64.40,+0.40,0.62,40000,36,2579700,3000,1000,2000,0,0,0,0,0,0,2000
20200212,6603,富強鑫,10.20,10.45,10.20,10.25,+0.15,1.49,212000,65,2182750,0,0,0,0,0,0,0,0,0,0
20200212,6609,瀧澤科,28.75,28.75,28.35,28.35,-0.05,-0.18,43000,30,1227500,0,0,0,0,0,0,0,0,0,0
20200212,6612,奈米醫材,77.40,79.70,77.40,79.00,+1.80,2.33,306000,254,24169200,25000,10000,15000,0,0,0,0,0,0,15000
20200212,6613,朋億,148.50,150.50,148.50,150.00,+0.50,0.33,72000,60,10761500,0,0,0,0,0,0,0,0,0,0
20200212,6615,慧智,64.20,65.80,64.20,65.00,+1.00,1.56,22000,18,1428400,1000,0,1000,0,0,0,0,0,0,1000
20200212,6616,特昇-KY,34.55,34.80,34.50,34.55,0.00,0.0,17000,14,587700,1000,0,1000,0,0,0,0,0,0,1000
20200212,6624,萬年清,42.50,42.50,41.95,42.35,-0.50,-1.17,14000,12,589600,0,0,0,0,0,0,0,0,0,0
20200212,6629,泰金-KY,,,,,,0.00,0,0,0,0,0,0,0,0,0,0,0,0,0
20200212,6640,均華,41.80,41.80,40.50,41.45,+0.10,0.24,17000,13,700050,0,2000,-2000,0,0,0,0,0,0,-2000
20200212,6642,富致,36.70,36.95,36.70,36.80,+0.10,0.27,31000,27,1139250,0,0,0,0,0,0,0,0,0,0
20200212,6643,M31,309.00,314.00,309.00,310.00,+2.50,0.81,315000,294,98259000,20000,7000,13000,0,5000,-5000,9000,5000,4000,12000
20200212,6649,台生材,34.30,34.60,34.20,34.50,-0.50,-1.43,16000,14,551000,1000,0,1000,0,0,0,0,0,0,1000
20200212,6654,天正國際,48.65,49.30,48.65,49.30,+0.30,0.61,31000,21,1513550,0,0,0,0,0,0,0,0,0,0
20200212,6662,樂斯科,37.65,37.65,36.95,37.00,+0.10,0.27,10000,10,371050,0,0,0,0,0,0,0,0,0,0
20200212,6664,群翊,63.30,64.40,63.00,64.40,+1.60,2.55,176000,136,11246400,17000,1000,16000,0,0,0,1000,0,1000,17000
20200212,6667,信紘科,76.50,77.70,74.70,77.70,+7.00,9.9,4303000,3084,329457800,71000,106000,-35000,0,0,0,0,0,0,-35000
20200212,6679,鈺太,161.00,175.00,160.00,171.00,+11.00,6.88,1664000,1348,279021000,70000,38000,32000,318000,0,318000,176000,1000,175000,525000
20200212,6680,鑫創電子,64.20,64.50,64.20,64.50,+0.50,0.78,2000,2,128700,0,0,0,0,0,0,0,0,0,0
20200212,6683,雍智科技,198.00,203.00,196.50,198.00,+3.00,1.54,835000,751,166780000,37000,20000,17000,0,0,0,67000,11000,56000,73000
20200212,6690,安碁資訊,105.00,109.00,105.00,109.00,+4.00,3.81,55000,52,5908000,5000,0,5000,0,0,0,0,0,0,5000
20200212,6697,東捷資訊,41.00,42.95,40.75,41.55,+1.25,3.1,346000,267,14444150,1000,5000,-4000,0,0,0,0,0,0,-4000
20200212,6803,崑鼎,214.00,217.00,214.00,217.00,+3.50,1.64,72000,67,15526000,0,6000,-6000,0,0,0,0,0,0,-6000
20200212,7402,邑錡,36.30,36.30,36.30,36.30,-1.30,-3.46,3000,3,108900,0,0,0,0,0,0,0,0,0,0
20200212,8024,佑華,10.25,10.25,10.10,10.20,0.00,0.0,32000,17,323850,0,0,0,0,0,0,0,0,0,0
20200212,8027,鈦昇,29.70,29.70,28.85,29.20,+0.05,0.17,125000,78,3670250,4000,16000,-12000,0,0,0,0,2000,-2000,-14000
20200212,8032,光菱,24.00,24.10,24.00,24.05,-0.05,-0.21,5000,4,120300,0,0,0,0,0,0,0,0,0,0
20200212,8034,榮群,16.90,16.90,16.60,16.85,+0.05,0.3,822000,442,13736800,54000,9000,45000,0,0,0,0,0,0,45000
20200212,8038,長園科,36.30,36.80,36.30,36.80,+0.80,2.22,91000,74,3327400,8000,0,8000,0,0,0,0,0,0,8000
20200212,8040,九暘,19.95,20.35,19.85,20.20,+0.35,1.76,1379000,689,27786450,206000,92000,114000,0,0,0,0,0,0,114000
20200212,8042,金山電,33.75,34.70,33.75,34.25,+0.55,1.63,152000,79,5205550,9000,2000,7000,0,0,0,0,0,0,7000
20200212,8043,蜜望實,30.30,30.55,30.25,30.40,+0.30,1.0,367000,268,11163400,26000,12000,14000,0,0,0,0,0,0,14000
20200212,8044,網家,110.00,110.50,108.00,108.50,-1.00,-0.91,2239000,1638,244668500,455000,455000,0,0,0,0,38000,71000,-33000,-33000
20200212,8047,星雲,11.60,12.00,11.35,11.90,+0.20,1.71,335000,182,3874150,45000,46000,-1000,0,0,0,1000,1000,0,-1000
20200212,8048,德勝,36.90,37.00,36.80,36.85,+0.15,0.41,63000,37,2320650,1000,0,1000,0,0,0,0,0,0,1000
20200212,8049,晶采,19.85,19.95,19.80,19.85,+0.05,0.25,297000,148,5904050,5000,58000,-53000,0,0,0,0,0,0,-53000
20200212,8050,廣積,45.20,45.20,44.65,45.00,0.00,0.0,309000,116,13864800,28000,30000,-2000,0,0,0,0,0,0,-2000
20200212,8054,安國,13.85,13.85,13.70,13.70,-0.10,-0.72,370000,177,5096400,0,115000,-115000,0,0,0,0,0,0,-115000
20200212,8059,凱碩,19.00,19.05,18.40,18.55,-0.40,-2.11,640000,298,11939350,0,126000,-126000,0,0,0,0,0,0,-126000
20200212,8064,東捷,15.85,15.90,15.70,15.80,+0.05,0.32,334000,151,5271800,0,15000,-15000,0,0,0,0,0,0,-15000
20200212,8066,來思達,74.20,75.00,74.20,75.00,+0.60,0.81,21000,20,1571900,5000,2000,3000,0,0,0,0,0,0,3000
20200212,8067,志旭,9.45,9.45,9.45,9.45,+0.26,2.83,1000,1,9450,0,0,0,0,0,0,0,0,0,0
20200212,8068,全達,39.85,39.85,39.00,39.00,-0.30,-0.76,362000,201,14180150,8000,0,8000,0,0,0,0,0,0,8000
20200212,8069,元太,29.30,29.95,29.30,29.80,+0.65,2.23,4168000,1925,123813450,718000,362000,356000,0,0,0,477000,23000,454000,810000
20200212,8071,能率網通,12.15,12.25,12.10,12.10,+0.05,0.41,148000,63,1796000,0,0,0,0,0,0,0,0,0,0
20200212,8074,鉅橡,17.40,17.40,17.15,17.15,-0.15,-0.87,149000,72,2564350,0,0,0,0,0,0,0,0,0,0
20200212,8076,伍豐,32.60,32.80,32.40,32.55,+0.05,0.15,387000,221,12609850,38000,4000,34000,0,0,0,1000,0,1000,35000
20200212,8077,洛碁,13.30,13.60,13.30,13.30,-0.50,-3.62,9000,7,120500,0,0,0,0,0,0,0,0,0,0
20200212,8080,永利聯合,3.56,3.85,3.56,3.85,+0.35,10.0,55000,23,208110,0,0,0,0,0,0,0,0,0,0
20200212,8083,瑞穎,150.50,151.00,150.00,150.50,0.00,0.0,97000,76,14618000,0,0,0,0,0,0,0,0,0,0
20200212,8084,巨虹,19.80,19.80,19.50,19.75,+0.05,0.25,9000,8,177200,0,0,0,0,0,0,0,0,0,0
20200212,8085,福華,4.16,4.18,4.14,4.18,+0.02,0.48,96000,25,398110,0,0,0,0,0,0,0,0,0,0
20200212,8086,宏捷科,101.00,103.50,100.50,101.00,,0.00,12608000,8499,1288785500,1122000,300000,822000,302000,0,302000,823000,278000,545000,1669000
20200212,8087,華鎂鑫,7.25,7.30,7.25,7.30,-0.13,-1.75,2000,2,14550,0,0,0,0,0,0,0,0,0,0
20200212,8088,品安,29.40,30.30,29.40,30.10,+0.80,2.73,9323000,4747,278844550,159000,356000,-197000,0,0,0,0,0,0,-197000
20200212,8091,翔名,59.80,61.30,59.70,61.30,+1.80,3.03,154000,113,9328300,15000,0,15000,0,0,0,0,0,0,15000
20200212,8092,建暐,7.31,7.32,7.18,7.30,-0.01,-0.14,29000,11,209970,4000,0,4000,0,0,0,0,0,0,4000
20200212,8093,保銳,5.75,5.75,5.75,5.75,+0.05,0.88,7000,4,40250,0,0,0,0,0,0,0,0,0,0
20200212,8096,擎亞,10.60,10.70,10.50,10.60,-0.10,-0.93,584000,240,6185550,11000,115000,-104000,0,0,0,0,0,0,-104000
20200212,8097,常珵,14.70,14.75,14.00,14.25,-0.15,-1.04,87000,72,1250950,0,4000,-4000,0,0,0,2000,0,2000,-2000
20200212,8099,大世科,16.95,17.00,16.95,16.95,0.00,0.0,26000,19,441000,0,0,0,0,0,0,0,0,0,0
20200212,8107,大億金茂,20.30,20.45,20.15,20.45,+0.20,0.99,85000,51,1723700,1000,0,1000,0,0,0,0,0,0,1000
20200212,8109,博大,68.50,70.00,68.50,69.60,+1.00,1.46,80000,47,5534800,7000,32000,-25000,0,0,0,0,0,0,-25000
20200212,8111,立碁,9.00,9.00,8.90,8.92,0.00,0.0,142000,44,1270100,0,12000,-12000,0,0,0,0,0,0,-12000
20200212,8121,越峰,10.10,10.40,10.10,10.20,-0.15,-1.45,211000,112,2161650,3000,9000,-6000,0,0,0,0,0,0,-6000
20200212,8147,正淩,31.75,31.75,31.10,31.35,-0.25,-0.79,32000,12,1005050,0,0,0,0,0,0,0,0,0,0
20200212,8155,博智,116.00,120.50,115.00,117.00,+2.00,1.74,3745000,2975,441413000,186000,99000,87000,0,0,0,242000,78000,164000,251000
20200212,8171,天宇,10.70,10.75,10.60,10.70,0.00,0.0,61000,15,650350,0,0,0,0,0,0,0,0,0,0
20200212,8176,智捷,10.60,10.75,10.55,10.75,+0.25,2.38,348000,178,3714950,57000,17000,40000,0,0,0,0,0,0,40000
20200212,8182,加高,26.20,26.90,26.15,26.85,+0.70,2.68,523000,343,13908950,131000,35000,96000,0,0,0,0,0,0,96000
20200212,8183,精星,20.10,20.30,19.70,19.70,-0.15,-0.76,4488000,2251,89248600,151000,133000,18000,0,0,0,0,0,0,18000
20200212,8234,新漢,24.80,25.15,24.80,25.15,+0.35,1.41,52000,39,1296400,5000,0,5000,0,0,0,0,0,0,5000
20200212,8240,華宏,26.00,26.35,25.90,26.20,+0.40,1.55,217000,126,5688050,26000,5000,21000,0,0,0,0,0,0,21000
20200212,8255,朋程,102.00,105.00,101.00,103.00,+1.00,0.98,1697000,961,175080500,24000,330000,-306000,0,0,0,61000,0,61000,-245000
20200212,8277,商丞,7.13,7.13,7.01,7.09,+0.02,0.28,94000,46,661920,16000,4000,12000,0,0,0,0,0,0,12000
20200212,8279,生展,107.00,108.50,107.00,108.50,+2.00,1.88,36000,32,3889500,2000,0,2000,0,0,0,0,0,0,2000
20200212,8287,英格爾,3.39,3.42,3.39,3.39,-0.01,-0.29,152000,35,517340,0,0,0,0,0,0,0,0,0,0
20200212,8289,泰藝,11.40,12.40,11.20,12.00,+0.70,6.19,3560000,822,41599800,99000,62000,37000,0,0,0,48000,11000,37000,74000
20200212,8291,尚茂,3.50,3.62,3.40,3.59,-0.16,-4.27,53000,17,184420,0,0,0,0,0,0,0,0,0,0
20200212,8299,群聯,324.00,327.00,322.50,324.00,+1.00,0.31,2186000,1587,710476000,289000,1002712,-713712,6000,82000,-76000,183000,74000,109000,-680712
20200212,8342,益張,44.60,44.80,44.40,44.80,+0.05,0.11,3000,3,133800,0,0,0,0,0,0,0,0,0,0
20200212,8349,恒耀,59.80,60.20,59.70,60.00,+0.10,0.17,91000,80,5459600,14000,0,14000,0,0,0,0,0,0,14000
20200212,8354,冠好,18.80,18.80,18.70,18.80,0.00,0.0,15000,10,281000,0,0,0,0,0,0,0,0,0,0
20200212,8358,金居,37.65,38.75,37.65,38.30,+0.65,1.73,4503000,2461,172603000,232000,147000,85000,1000,0,1000,423000,131000,292000,378000
20200212,8383,千附,34.20,36.90,34.15,35.80,+1.60,4.68,588000,452,20897450,4000,61000,-57000,0,0,0,0,0,0,-57000
20200212,8390,金益鼎,17.30,17.35,17.10,17.30,-0.05,-0.29,237000,135,4081000,12000,3000,9000,0,0,0,0,0,0,9000
20200212,8401,白紗科,10.95,11.10,10.95,11.10,+0.05,0.45,57000,18,628450,0,0,0,0,0,0,0,0,0,0
20200212,8403,盛弘,32.20,32.60,31.95,32.20,-0.20,-0.62,1104000,622,35546650,15000,106000,-91000,0,0,0,0,0,0,-91000
20200212,8406,金可-KY,186.00,189.00,185.00,187.00,+1.00,0.54,181000,164,33903000,53000,37000,16000,0,0,0,10000,4000,6000,22000
20200212,8409,商之器,22.60,22.60,22.60,22.60,+2.05,9.98,338000,142,7638800,0,0,0,0,0,0,0,0,0,0
20200212,8410,森田,26.30,26.35,26.05,26.35,+0.15,0.57,13000,10,341600,0,0,0,0,0,0,0,0,0,0
20200212,8415,大國鋼,28.00,28.30,27.95,28.00,0.00,0.0,348000,123,9756350,51000,19000,32000,0,0,0,0,0,0,32000
20200212,8416,實威,117.50,118.50,117.50,118.50,+1.00,0.85,25000,23,2949500,0,0,0,0,0,0,0,0,0,0
20200212,8418,捷必勝-KY,13.70,13.75,13.70,13.75,+0.05,0.36,3000,3,41200,0,2000,-2000,0,0,0,0,0,0,-2000
20200212,8420,明揚,,,,,,0.00,0,0,0,0,0,0,0,0,0,0,0,0,0
20200212,8421,旭源,10.25,10.30,10.20,10.30,+0.05,0.49,17000,14,174150,0,0,0,0,0,0,0,0,0,0
20200212,8423,保綠-KY,,,,,,0.00,0,0,0,0,0,0,0,0,0,0,0,0,0
20200212,8424,惠普,52.00,52.50,51.40,52.50,+1.20,2.34,40000,21,2087700,2000,0,2000,0,0,0,27000,0,27000,29000
20200212,8426,紅木-KY,20.55,20.55,20.55,20.55,0.00,0.0,4000,4,82200,0,0,0,0,0,0,0,0,0,0
20200212,8431,匯鑽科,50.70,52.30,49.70,51.80,+1.60,3.19,188000,156,9627600,7000,6000,1000,0,0,0,0,0,0,1000
20200212,8432,東生華,78.80,79.80,78.80,79.50,+0.60,0.76,38000,15,3015300,0,1000,-1000,0,0,0,0,0,0,-1000
20200212,8433,弘帆,52.10,52.10,51.90,52.00,-0.10,-0.19,17000,14,883900,0,0,0,0,0,0,0,0,0,0
20200212,8435,鉅邁,50.70,50.90,50.70,50.90,+0.20,0.39,80000,61,4058100,0,0,0,0,0,0,0,0,0,0
20200212,8436,大江,224.00,225.50,218.50,221.00,-0.50,-0.23,1381000,1195,306341000,251000,390822,-139822,0,0,0,3000,58000,-55000,-194822
20200212,8437,大地-KY,218.00,221.00,218.00,221.00,+4.00,1.84,45000,44,9916000,17000,14000,3000,0,0,0,0,0,0,3000
20200212,8440,綠電,13.70,13.80,13.70,13.80,+0.15,1.1,8000,6,110300,0,0,0,0,0,0,0,0,0,0
20200212,8444,綠河-KY,58.90,59.40,57.50,59.10,+2.20,3.87,58000,49,3379000,4000,0,4000,0,21000,-21000,0,0,0,-17000
20200212,8446,華研,120.00,120.50,117.00,120.00,0.00,0.0,159000,145,18837000,21000,32000,-11000,0,0,0,0,0,0,-11000
20200212,8450,霹靂,32.85,33.20,32.85,33.20,+0.20,0.61,14000,14,462000,0,0,0,0,0,0,0,0,0,0
20200212,8455,大拓-KY,25.30,25.85,25.20,25.20,-0.10,-0.4,22000,18,558100,0,0,0,0,0,0,0,0,0,0
20200212,8472,夠麻吉,26.20,26.20,26.20,26.20,-0.10,-0.38,1000,1,26200,0,0,0,0,0,0,0,0,0,0
20200212,8476,台境,21.00,22.25,21.00,22.25,+2.00,9.88,186000,78,4101600,0,6000,-6000,0,0,0,0,0,0,-6000
20200212,8477,創業家,36.00,36.00,34.75,35.40,-0.60,-1.67,13000,13,459900,0,0,0,0,0,0,0,0,0,0
20200212,8489,三貝德,81.10,86.80,81.10,84.70,+4.20,5.22,2553000,2052,214347000,11000,107000,-96000,0,161000,-161000,6000,13000,-7000,-264000
20200212,8905,裕國,15.85,15.90,15.85,15.85,+0.05,0.32,31000,17,491600,0,0,0,0,0,0,0,0,0,0
20200212,8906,花王,15.65,15.90,15.65,15.80,+0.20,1.28,98000,53,1545450,0,0,0,0,0,0,0,0,0,0
20200212,8908,欣雄,46.95,47.10,46.95,47.05,+0.10,0.21,19000,15,893650,0,0,0,0,0,0,0,0,0,0
20200212,8916,光隆,43.80,44.00,43.80,43.85,0.00,0.0,142000,82,6237700,0,111000,-111000,0,0,0,0,5000,-5000,-116000
20200212,8916A,光隆甲特,53.70,53.80,53.70,53.80,0.00,0.0,3000,3,161200,0,0,0,0,0,0,0,0,0,0
20200212,8917,欣泰,,,,,,0.00,0,0,0,0,0,0,0,0,0,0,0,0,0
20200212,8921,沈氏,,,,,,0.00,0,0,0,0,0,0,0,0,0,0,0,0,0
20200212,8923,時報,15.30,15.30,15.20,15.20,-0.05,-0.33,2000,2,30500,0,0,0,0,0,0,0,0,0,0
20200212,8924,大田,42.50,43.30,42.50,43.00,+0.75,1.78,308000,205,13228950,7000,33000,-26000,0,0,0,30000,0,30000,4000
20200212,8927,北基,,,,,,0.00,0,0,0,0,0,0,0,0,0,0,0,0,0
20200212,8928,鉅明,36.10,36.30,35.35,35.50,-0.60,-1.66,96000,62,3409350,2000,8000,-6000,0,0,0,0,0,0,-6000
20200212,8929,富堡,25.05,25.60,25.05,25.35,+0.30,1.2,58000,45,1467450,0,0,0,0,0,0,0,0,0,0
20200212,8930,青鋼,12.50,12.55,12.50,12.55,+0.15,1.21,30000,12,375150,0,0,0,0,0,0,0,0,0,0
20200212,8931,大汽電,28.65,28.65,28.00,28.00,-0.40,-1.41,73000,54,2053100,0,3000,-3000,0,0,0,0,0,0,-3000
20200212,8932,宏大,13.20,13.50,13.15,13.40,+0.30,2.29,71000,32,945650,0,2000,-2000,0,0,0,0,0,0,-2000
20200212,8933,愛地雅,6.00,6.09,5.91,6.03,+0.06,1.01,50000,27,301150,0,0,0,0,0,0,0,0,0,0
20200212,8934,衡平,,,,,,0.00,0,0,0,0,0,0,0,0,0,0,0,0,0
20200212,8935,邦泰,8.31,8.49,8.31,8.49,+0.04,0.47,2000,2,16800,0,0,0,0,0,0,0,0,0,0
20200212,8936,國統,17.70,17.80,17.60,17.80,+0.20,1.14,194000,104,3430700,18000,1000,17000,0,0,0,0,50000,-50000,-33000
20200212,8937,合騏,14.95,14.95,14.40,14.45,-0.05,-0.34,21000,12,305800,0,0,0,0,0,0,0,0,0,0
20200212,8938,明安,36.50,36.75,36.50,36.55,+0.05,0.14,249000,133,9117550,20000,117000,-97000,0,0,0,5000,0,5000,-92000
20200212,8941,關中,41.45,41.50,40.15,41.20,-0.45,-1.08,9000,8,365650,0,0,0,0,0,0,0,0,0,0
20200212,8942,森鉅,60.70,61.30,60.70,61.10,+0.50,0.83,177000,132,10795100,62000,1000,61000,0,0,0,0,0,0,61000
20200212,9949,琉園,12.75,12.85,12.65,12.85,+0.05,0.39,10000,7,126900,0,0,0,0,0,0,0,0,0,0
20200212,9950,萬國通,13.90,14.00,13.90,13.90,+0.15,1.09,28000,9,390750,0,0,0,0,0,0,0,0,0,0
20200212,9951,皇田,79.30,80.30,79.10,79.90,+0.60,0.76,483000,436,38455000,37000,186911,-149911,0,30000,-30000,0,0,0,-179911
20200212,9960,邁達康,29.90,30.45,29.90,30.30,-0.05,-0.16,5000,4,151200,0,0,0,0,0,0,0,0,0,0
20200212,9962,有益,9.65,9.68,9.63,9.68,+0.01,0.1,16000,11,154270,0,0,0,0,0,0,0,0,0,0
20200212,020001,富邦存股雙十N,5.43,5.48,5.43,5.48,+0.06,1.11,1591000,124,8680820,0,0,0,0,0,0,1516000,33000,1483000,1483000
20200212,020003,統一漲升股利150N,11.05,11.08,11.05,11.08,+0.08,0.73,25000,2,276850,0,0,0,0,0,0,25000,0,25000,25000
20200212,020009,群益A50綠碳N,,,,,,0.00,0,0,0,0,0,0,0,0,0,0,0,0,0
20200212,020010,永昌富櫃200N,10.43,10.57,10.43,10.57,+0.20,1.93,5000,5,52390,0,0,0,0,0,0,2000,0,2000,2000
20200212,020013,元富亞洲高股息N,,,,,,0.00,0,0,0,0,0,0,0,0,0,0,0,0,0
20200212,020014,元大富櫃200N,4.80,4.89,4.80,4.89,+0.09,1.88,124000,37,603300,0,0,0,0,0,0,76000,27000,49000,49000
20200212,70005X,精華元大66展02,,,,,,0.00,0,0,0,0,0,0,0,0,0,0,0,0,0
20200212,72102P,原相中信93售02,,,,,,0.00,0,0,0,0,0,0,0,0,0,0,0,0,0
20200212,72143P,環球晶中信92售01,,,,,,0.00,0,0,0,0,0,0,0,0,0,0,0,0,0
20200212,72174P,同致中信93售01,,,,,,0.00,0,0,0,0,0,0,0,0,0,0,0,0,0
20200212,72238P,神盾國泰92售02,,,,,,0.00,0,0,0,0,0,0,0,0,0,0,0,0,0
20200212,72259P,環球晶中信93售01,,,,,,0.00,0,0,0,0,0,0,0,0,0,0,0,0,0
20200212,72302P,穩懋富邦93售01,,,,,,0.00,0,0,0,0,0,0,0,0,0,0,0,0,0
20200212,72307P,世界群益93售01,,,,,,0.00,0,0,0,0,0,0,0,0,0,0,0,0,0
20200212,72323P,穩懋元大92售07,,,,,,0.00,0,0,0,0,0,0,0,0,0,0,0,0,0
20200212,72331P,穩懋凱基93售02,0.24,0.25,0.18,0.19,-0.07,-26.92,310000,31,62800,0,0,0,0,0,0,0,310000,-310000,-310000
20200212,72332P,穩懋凱基93售03,,,,,,0.00,0,0,0,0,0,0,0,0,0,0,0,0,0
20200212,72333P,大江凱基93售01,,,,,,0.00,0,0,0,0,0,0,0,0,0,0,0,0,0
20200212,72334P,穩懋凱基93售04,,,,,,0.00,0,0,0,0,0,0,0,0,0,0,0,0,0
20200212,72336P,穩懋兆豐92售01,,,,,,0.00,0,0,0,0,0,0,0,0,0,0,0,0,0
20200212,72338P,原相國票92售03,,,,,,0.00,0,0,0,0,0,0,0,0,0,0,0,0,0
20200212,72339P,頎邦群益93售01,,,,,,0.00,0,0,0,0,0,0,0,0,0,0,0,0,0
20200212,72340P,穩懋凱基93售06,,,,,,0.00,0,0,0,0,0,0,0,0,0,0,0,0,0
20200212,72341P,聯亞國票92售02,,,,,,0.00,0,0,0,0,0,0,0,0,0,0,0,0,0
20200212,72345P,大江富邦93售02,,,,,,0.00,0,0,0,0,0,0,0,0,0,0,0,0,0
20200212,72356P,雙鴻凱基93售02,,,,,,0.00,0,0,0,0,0,0,0,0,0,0,0,0,0
20200212,72358P,譜瑞凱基93售01,,,,,,0.00,0,0,0,0,0,0,0,0,0,0,0,0,0
20200212,72360P,雙鴻國泰93售01,0.28,0.29,0.28,0.29,-0.05,-14.71,15000,2,4250,0,0,0,0,0,0,0,15000,-15000,-15000
20200212,72361P,穩懋國泰92售05,,,,,,0.00,0,0,0,0,0,0,0,0,0,0,0,0,0
20200212,72362P,穩懋國泰92售06,,,,,,0.00,0,0,0,0,0,0,0,0,0,0,0,0,0
20200212,72365P,神盾統一93售01,0.35,0.35,0.35,0.35,-0.05,-12.5,5000,1,1750,0,0,0,0,0,0,5000,0,5000,5000
20200212,72366P,力旺凱基93售01,,,,,,0.00,0,0,0,0,0,0,0,0,0,0,0,0,0
20200212,72369P,緯軟元大93售03,,,,,,0.00,0,0,0,0,0,0,0,0,0,0,0,0,0
20200212,72370P,宣德國票93售01,,,,,,0.00,0,0,0,0,0,0,0,0,0,0,0,0,0
20200212,72371P,穩懋國票93售01,,,,,,0.00,0,0,0,0,0,0,0,0,0,0,0,0,0
20200212,72372P,神盾群益93售01,0.39,0.39,0.39,0.39,-0.04,-9.3,25000,3,9750,0,0,0,0,0,0,0,25000,-25000,-25000
20200212,72375P,穩懋兆豐93售02,,,,,,0.00,0,0,0,0,0,0,0,0,0,0,0,0,0
20200212,72378P,群聯國泰93售02,0.13,0.13,0.13,0.13,-0.08,-38.1,200000,1,26000,0,0,0,0,0,0,200000,200000,0,0
20200212,72379P,廣明國泰93售02,,,,,,0.00,0,0,0,0,0,0,0,0,0,0,0,0,0
20200212,72380P,頎邦國票93售01,,,,,,0.00,0,0,0,0,0,0,0,0,0,0,0,0,0
20200212,72381P,原相富邦93售02,,,,,,0.00,0,0,0,0,0,0,0,0,0,0,0,0,0
20200212,72383P,穩懋兆豐93售03,,,,,,0.00,0,0,0,0,0,0,0,0,0,0,0,0,0
20200212,72386P,台燿凱基93售03,,,,,,0.00,0,0,0,0,0,0,0,0,0,0,0,0,0
20200212,72389P,穩懋國票93售02,,,,,,0.00,0,0,0,0,0,0,0,0,0,0,0,0,0
20200212,72390P,穩懋國泰94售01,0.33,0.33,0.27,0.27,-0.09,-25.0,47000,9,13790,0,0,0,0,0,0,5000,42000,-37000,-37000
20200212,72391P,穩懋元大93售05,,,,,,0.00,0,0,0,0,0,0,0,0,0,0,0,0,0
20200212,72396P,台燿凱基93售04,,,,,,0.00,0,0,0,0,0,0,0,0,0,0,0,0,0
20200212,72397P,台燿中信93售02,,,,,,0.00,0,0,0,0,0,0,0,0,0,0,0,0,0
20200212,72400P,穩懋元大93售07,,,,,,0.00,0,0,0,0,0,0,0,0,0,0,0,0,0
20200212,72402P,中美晶兆豐94售01,0.17,0.17,0.17,0.17,-0.03,-15.0,1000,1,170,0,0,0,0,0,0,0,1000,-1000,-1000
20200212,72407P,大江元大93售02,,,,,,0.00,0,0,0,0,0,0,0,0,0,0,0,0,0
20200212,72413P,鈊象國票93售01,,,,,,0.00,0,0,0,0,0,0,0,0,0,0,0,0,0
20200212,72414P,神盾凱基92售01,,,,,,0.00,0,0,0,0,0,0,0,0,0,0,0,0,0
20200212,72415P,廣明凱基92售02,,,,,,0.00,0,0,0,0,0,0,0,0,0,0,0,0,0
20200212,72416P,台燿統一92售04,,,,,,0.00,0,0,0,0,0,0,0,0,0,0,0,0,0
20200212,72417P,昇達科永豐92售01,,,,,,0.00,0,0,0,0,0,0,0,0,0,0,0,0,0
20200212,72418P,原相永豐92售01,,,,,,0.00,0,0,0,0,0,0,0,0,0,0,0,0,0
20200212,72419P,信昌電國票93售01,,,,,,0.00,0,0,0,0,0,0,0,0,0,0,0,0,0
20200212,72420P,台燿群益92售01,,,,,,0.00,0,0,0,0,0,0,0,0,0,0,0,0,0
20200212,72421P,鈊象群益92售02,,,,,,0.00,0,0,0,0,0,0,0,0,0,0,0,0,0
20200212,72422P,穩懋凱基93售11,,,,,,0.00,0,0,0,0,0,0,0,0,0,0,0,0,0
20200212,72423P,穩懋日盛92售02,,,,,,0.00,0,0,0,0,0,0,0,0,0,0,0,0,0
20200212,72424P,力旺群益93售02,,,,,,0.00,0,0,0,0,0,0,0,0,0,0,0,0,0
20200212,72425P,信昌電群益92售01,,,,,,0.00,0,0,0,0,0,0,0,0,0,0,0,0,0
20200212,72426P,宣德群益93售02,,,,,,0.00,0,0,0,0,0,0,0,0,0,0,0,0,0
20200212,72427P,穩懋統一92售03,,,,,,0.00,0,0,0,0,0,0,0,0,0,0,0,0,0
20200212,72428P,環球晶凱基92售05,,,,,,0.00,0,0,0,0,0,0,0,0,0,0,0,0,0
20200212,72429P,穩懋元大92售15,,,,,,0.00,0,0,0,0,0,0,0,0,0,0,0,0,0
20200212,72430P,中美晶國票93售01,,,,,,0.00,0,0,0,0,0,0,0,0,0,0,0,0,0
20200212,72431P,穩懋富邦93售05,,,,,,0.00,0,0,0,0,0,0,0,0,0,0,0,0,0
20200212,72432P,威剛元大92售02,,,,,,0.00,0,0,0,0,0,0,0,0,0,0,0,0,0
20200212,72433P,精華元大92售02,,,,,,0.00,0,0,0,0,0,0,0,0,0,0,0,0,0
20200212,72434P,穩懋元大92售17,,,,,,0.00,0,0,0,0,0,0,0,0,0,0,0,0,0
20200212,72435P,晟德元大92售02,,,,,,0.00,0,0,0,0,0,0,0,0,0,0,0,0,0
20200212,72436P,威剛群益93售02,,,,,,0.00,0,0,0,0,0,0,0,0,0,0,0,0,0
20200212,72437P,晟德永豐92售01,0.66,0.66,0.66,0.66,-0.13,-16.46,1000,1,660,0,0,0,0,0,0,1000,0,1000,1000
20200212,72438P,威剛國泰93售02,,,,,,0.00,0,0,0,0,0,0,0,0,0,0,0,0,0
20200212,72439P,信昌電元大92售03,,,,,,0.00,0,0,0,0,0,0,0,0,0,0,0,0,0
20200212,72440P,原相元大92售05,,,,,,0.00,0,0,0,0,0,0,0,0,0,0,0,0,0
20200212,72441P,聯亞元大92售05,,,,,,0.00,0,0,0,0,0,0,0,0,0,0,0,0,0
20200212,72442P,中美晶元富92售01,,,,,,0.00,0,0,0,0,0,0,0,0,0,0,0,0,0
20200212,72443P,穩懋統一92售04,,,,,,0.00,0,0,0,0,0,0,0,0,0,0,0,0,0
20200212,72444P,穩懋中信94售01,,,,,,0.00,0,0,0,0,0,0,0,0,0,0,0,0,0
20200212,72445P,台燿凱基92售01,,,,,,0.00,0,0,0,0,0,0,0,0,0,0,0,0,0
20200212,72446P,穩懋凱基93售13,,,,,,0.00,0,0,0,0,0,0,0,0,0,0,0,0,0
20200212,72447P,緯軟永豐92售01,,,,,,0.00,0,0,0,0,0,0,0,0,0,0,0,0,0
20200212,72448P,神盾凱基92售04,,,,,,0.00,0,0,0,0,0,0,0,0,0,0,0,0,0
20200212,72449P,聯亞元富92售01,,,,,,0.00,0,0,0,0,0,0,0,0,0,0,0,0,0
20200212,72450P,原相元大92售06,,,,,,0.00,0,0,0,0,0,0,0,0,0,0,0,0,0
20200212,72451P,信昌電永豐92售02,,,,,,0.00,0,0,0,0,0,0,0,0,0,0,0,0,0
20200212,72452P,穩懋永豐92售02,,,,,,0.00,0,0,0,0,0,0,0,0,0,0,0,0,0
20200212,72453P,信驊元大92售03,,,,,,0.00,0,0,0,0,0,0,0,0,0,0,0,0,0
20200212,72454P,穩懋元大92售20,,,,,,0.00,0,0,0,0,0,0,0,0,0,0,0,0,0
20200212,72455P,穩懋中信94售03,,,,,,0.00,0,0,0,0,0,0,0,0,0,0,0,0,0
20200212,72456P,信驊凱基93售03,1.06,1.06,1.06,1.06,-0.05,-4.5,285000,3,302100,0,0,0,0,0,0,285000,0,285000,285000
20200212,72457P,群聯統一92售02,,,,,,0.00,0,0,0,0,0,0,0,0,0,0,0,0,0
20200212,72458P,雙鴻國泰93售03,0.88,0.89,0.85,0.86,-0.10,-10.42,77000,18,67100,0,0,0,0,0,0,58000,19000,39000,39000
20200212,72459P,威剛永豐92售02,,,,,,0.00,0,0,0,0,0,0,0,0,0,0,0,0,0
20200212,72460P,雙鴻永豐92售02,,,,,,0.00,0,0,0,0,0,0,0,0,0,0,0,0,0
20200212,72461P,穩懋元大92售21,0.14,0.14,0.14,0.14,-0.07,-33.33,5000,1,700,0,0,0,0,0,0,0,5000,-5000,-5000
20200212,72462P,穩懋凱基93售15,,,,,,0.00,0,0,0,0,0,0,0,0,0,0,0,0,0
20200212,72463P,金居康和92售01,,,,,,0.00,0,0,0,0,0,0,0,0,0,0,0,0,0
20200212,72464P,上詮永豐93售01,,,,,,0.00,0,0,0,0,0,0,0,0,0,0,0,0,0
20200212,72465P,立端永豐93售01,,,,,,0.00,0,0,0,0,0,0,0,0,0,0,0,0,0
20200212,72466P,穩懋統一93售03,0.04,0.04,0.04,0.04,-0.04,-50.0,50000,1,2000,0,0,0,0,0,0,50000,0,50000,50000
20200212,72467P,神盾元富93售01,0.61,0.61,0.56,0.59,-0.10,-14.49,30000,12,17520,0,0,0,0,0,0,20000,10000,10000,10000
20200212,72468P,晶焱永豐93售01,,,,,,0.00,0,0,0,0,0,0,0,0,0,0,0,0,0
20200212,72469P,穩懋統一93售04,,,,,,0.00,0,0,0,0,0,0,0,0,0,0,0,0,0
20200212,72470P,力旺元大93售01,0.67,0.67,0.67,0.67,-0.37,-35.58,5000,1,3350,0,0,0,0,0,0,0,5000,-5000,-5000
20200212,72471P,大中永豐93售01,,,,,,0.00,0,0,0,0,0,0,0,0,0,0,0,0,0
20200212,72472P,穩懋國票94售01,,,,,,0.00,0,0,0,0,0,0,0,0,0,0,0,0,0
20200212,72473P,建榮永豐93售03,,,,,,0.00,0,0,0,0,0,0,0,0,0,0,0,0,0
20200212,72474P,環球晶永豐93售01,,,,,,0.00,0,0,0,0,0,0,0,0,0,0,0,0,0
20200212,72475P,金居統一93售01,0.77,0.84,0.77,0.82,-0.11,-11.83,120000,7,95500,0,0,0,0,0,0,60000,60000,0,0
20200212,72476P,台半中信95售01,0.56,0.56,0.56,0.56,-0.03,-5.08,86000,2,48160,0,0,0,0,0,0,86000,0,86000,86000
20200212,72477P,信驊元大93售01,,,,,,0.00,0,0,0,0,0,0,0,0,0,0,0,0,0
20200212,72478P,直得永豐93售01,,,,,,0.00,0,0,0,0,0,0,0,0,0,0,0,0,0
20200212,72479P,原相永豐93售01,,,,,,0.00,0,0,0,0,0,0,0,0,0,0,0,0,0
20200212,72480P,緯軟永豐93售01,,,,,,0.00,0,0,0,0,0,0,0,0,0,0,0,0,0
20200212,72481P,榮剛康和93售01,,,,,,0.00,0,0,0,0,0,0,0,0,0,0,0,0,0
20200212,72482P,智擎中信93售02,0.79,0.80,0.79,0.79,-0.62,-43.97,102000,4,80590,0,0,0,0,0,0,2000,100000,-98000,-98000
20200212,72483P,穩懋元大93售11,,,,,,0.00,0,0,0,0,0,0,0,0,0,0,0,0,0
20200212,72484P,環球晶凱基93售08,,,,,,0.00,0,0,0,0,0,0,0,0,0,0,0,0,0
20200212,72485P,環球晶凱基93售10,,,,,,0.00,0,0,0,0,0,0,0,0,0,0,0,0,0
20200212,72486P,精華元富93售02,,,,,,0.00,0,0,0,0,0,0,0,0,0,0,0,0,0
20200212,72487P,穩懋亞東94售01,,,,,,0.00,0,0,0,0,0,0,0,0,0,0,0,0,0
20200212,72488P,中美晶國票94售01,,,,,,0.00,0,0,0,0,0,0,0,0,0,0,0,0,0
20200212,72489P,穩懋國票93售03,,,,,,0.00,0,0,0,0,0,0,0,0,0,0,0,0,0
20200212,72490P,廣明凱基94售02,,,,,,0.00,0,0,0,0,0,0,0,0,0,0,0,0,0
20200212,72491P,台燿統一93售02,0.46,0.47,0.46,0.47,-0.11,-18.97,69000,3,32220,0,0,0,0,0,0,0,69000,-69000,-69000
20200212,72492P,環球晶元富93售04,,,,,,0.00,0,0,0,0,0,0,0,0,0,0,0,0,0
20200212,72493P,晶焱康和93售01,,,,,,0.00,0,0,0,0,0,0,0,0,0,0,0,0,0
20200212,72494P,聯亞群益93售02,,,,,,0.00,0,0,0,0,0,0,0,0,0,0,0,0,0
20200212,72495P,神盾永豐93售03,0.62,0.62,0.60,0.62,-0.07,-10.14,260000,7,160100,0,0,0,0,0,0,85000,175000,-90000,-90000
20200212,72496P,宏捷科元大93售03,,,,,,0.00,0,0,0,0,0,0,0,0,0,0,0,0,0
20200212,72497P,群聯統一93售01,,,,,,0.00,0,0,0,0,0,0,0,0,0,0,0,0,0
20200212,72498P,台半凱基93售02,0.52,0.52,0.52,0.52,-0.04,-7.14,41000,1,21320,0,0,0,0,0,0,41000,0,41000,41000
20200212,72499P,良維康和93售01,,,,,,0.00,0,0,0,0,0,0,0,0,0,0,0,0,0
20200212,72500P,元太群益93售01,,,,,,0.00,0,0,0,0,0,0,0,0,0,0,0,0,0
20200212,72501P,大江富邦95售01,1.07,1.08,1.05,1.05,-0.02,-1.87,149000,6,159730,0,0,0,0,0,0,10000,139000,-129000,-129000
20200212,72502P,泰博永豐93售01,0.37,0.37,0.37,0.37,-0.04,-9.76,1000,1,370,0,0,0,0,0,0,0,1000,-1000,-1000
20200212,72503P,信驊群益93售01,,,,,,0.00,0,0,0,0,0,0,0,0,0,0,0,0,0
20200212,72504P,環球晶凱基93售12,,,,,,0.00,0,0,0,0,0,0,0,0,0,0,0,0,0
20200212,72505P,優群康和93售01,,,,,,0.00,0,0,0,0,0,0,0,0,0,0,0,0,0
20200212,72506P,大江永豐93售03,,,,,,0.00,0,0,0,0,0,0,0,0,0,0,0,0,0
20200212,72507P,合晶永豐93售02,,,,,,0.00,0,0,0,0,0,0,0,0,0,0,0,0,0
20200212,72508P,皇田永豐93售03,0.83,0.83,0.82,0.82,-0.03,-3.53,30000,3,24890,0,0,0,0,0,0,4000,26000,-22000,-22000
20200212,72509P,網龍統一93售01,,,,,,0.00,0,0,0,0,0,0,0,0,0,0,0,0,0
20200212,72510P,原相群益96售02,0.07,0.07,0.07,0.07,-0.01,-12.5,2000,1,140,0,0,0,0,0,0,0,2000,-2000,-2000
20200212,72511P,台燿統一93售03,,,,,,0.00,0,0,0,0,0,0,0,0,0,0,0,0,0
20200212,72512P,信驊元富93售02,0.38,0.40,0.38,0.40,+0.01,2.56,462000,6,178490,0,0,0,0,0,0,231000,231000,0,0
20200212,72513P,原相永豐93售03,,,,,,0.00,0,0,0,0,0,0,0,0,0,0,0,0,0
20200212,72514P,優群永豐93售03,,,,,,0.00,0,0,0,0,0,0,0,0,0,0,0,0,0
20200212,72515P,建榮國票93售01,0.92,0.94,0.92,0.94,-0.02,-2.08,20000,2,18500,0,0,0,0,0,0,20000,0,20000,20000
20200212,72516P,台燿元大93售05,1.15,1.15,1.13,1.13,-0.34,-23.13,18000,2,20640,0,0,0,0,0,0,18000,18000,0,0
20200212,72517P,大江凱基93售09,,,,,,0.00,0,0,0,0,0,0,0,0,0,0,0,0,0
20200212,72518P,昂寶康和93售01,,,,,,0.00,0,0,0,0,0,0,0,0,0,0,0,0,0
20200212,72519P,晶焱群益93售04,,,,,,0.00,0,0,0,0,0,0,0,0,0,0,0,0,0
20200212,72520P,台燿台新93售02,,,,,,0.00,0,0,0,0,0,0,0,0,0,0,0,0,0
20200212,72521P,台燿國票93售01,,,,,,0.00,0,0,0,0,0,0,0,0,0,0,0,0,0
20200212,72522P,大江元大93售06,,,,,,0.00,0,0,0,0,0,0,0,0,0,0,0,0,0
20200212,72523P,穩懋凱基93售17,0.55,0.55,0.49,0.49,-0.15,-23.44,100000,10,52000,0,0,0,0,0,0,0,100000,-100000,-100000
20200212,72524P,穩懋永豐93售02,,,,,,0.00,0,0,0,0,0,0,0,0,0,0,0,0,0
20200212,72525P,新普凱基93售03,,,,,,0.00,0,0,0,0,0,0,0,0,0,0,0,0,0
20200212,72526P,廣明永豐93售02,1.24,1.24,1.18,1.18,-0.11,-8.53,30000,10,36670,0,0,0,0,0,0,10000,20000,-10000,-10000
20200212,72527P,神盾國票93售02,,,,,,0.00,0,0,0,0,0,0,0,0,0,0,0,0,0
20200212,72528P,大田永豐93售02,0.58,0.58,0.58,0.58,-0.08,-12.12,51000,2,29580,0,0,0,0,0,0,0,51000,-51000,-51000
20200212,72529P,信驊永豐93售01,,,,,,0.00,0,0,0,0,0,0,0,0,0,0,0,0,0
20200212,72530P,環球晶兆豐93售02,,,,,,0.00,0,0,0,0,0,0,0,0,0,0,0,0,0
20200212,72531P,環球晶群益93售03,,,,,,0.00,0,0,0,0,0,0,0,0,0,0,0,0,0
20200212,72532P,穩懋國泰93售02,0.45,0.45,0.33,0.38,-0.12,-24.0,262000,40,101960,0,0,0,0,0,0,45000,217000,-172000,-172000
20200212,72533P,中美晶元富94售01,,,,,,0.00,0,0,0,0,0,0,0,0,0,0,0,0,0
20200212,72534P,金居元富94售01,,,,,,0.00,0,0,0,0,0,0,0,0,0,0,0,0,0
20200212,72535P,雙鴻群益95售01,,,,,,0.00,0,0,0,0,0,0,0,0,0,0,0,0,0
20200212,72536P,網龍國票93售01,,,,,,0.00,0,0,0,0,0,0,0,0,0,0,0,0,0
20200212,72537P,大江永豐93售06,1.86,1.89,1.86,1.89,-0.05,-2.58,24000,3,44850,0,0,0,0,0,0,7000,17000,-10000,-10000
20200212,72538P,碩禾永豐93售01,,,,,,0.00,0,0,0,0,0,0,0,0,0,0,0,0,0
20200212,72539P,環球晶元大93售12,,,,,,0.00,0,0,0,0,0,0,0,0,0,0,0,0,0
20200212,72540P,世界國票93售01,,,,,,0.00,0,0,0,0,0,0,0,0,0,0,0,0,0
20200212,72541P,精華國票93售01,,,,,,0.00,0,0,0,0,0,0,0,0,0,0,0,0,0
20200212,72542P,環球晶元富94售01,0.21,0.21,0.21,0.21,-0.03,-12.5,70000,2,14700,0,0,0,0,0,0,50000,20000,30000,30000
20200212,72543P,環球晶元大93售13,,,,,,0.00,0,0,0,0,0,0,0,0,0,0,0,0,0
20200212,72544P,中美晶永豐93售04,,,,,,0.00,0,0,0,0,0,0,0,0,0,0,0,0,0
20200212,72545P,緯軟永豐93售02,,,,,,0.00,0,0,0,0,0,0,0,0,0,0,0,0,0
20200212,72546P,新普元大93售04,,,,,,0.00,0,0,0,0,0,0,0,0,0,0,0,0,0
20200212,72547P,廣明元大93售04,,,,,,0.00,0,0,0,0,0,0,0,0,0,0,0,0,0
20200212,72548P,大江統一96售01,,,,,,0.00,0,0,0,0,0,0,0,0,0,0,0,0,0
20200212,72549P,穩懋統一94售03,0.92,0.92,0.92,0.92,-0.14,-13.21,10000,1,9200,0,0,0,0,0,0,0,10000,-10000,-10000
20200212,72550P,聯亞國票94售02,,,,,,0.00,0,0,0,0,0,0,0,0,0,0,0,0,0
20200212,72551P,金居國泰94售02,0.59,0.59,0.59,0.59,-0.10,-14.49,20000,1,11800,0,0,0,0,0,0,20000,0,20000,20000
20200212,72552P,良維永豐93售02,,,,,,0.00,0,0,0,0,0,0,0,0,0,0,0,0,0
20200212,72553P,金居永豐93售02,0.46,0.47,0.46,0.47,-0.11,-18.97,84000,2,39060,0,0,0,0,0,0,0,84000,-84000,-84000
20200212,72554P,神盾永豐93售04,1.31,1.31,1.31,1.31,-0.08,-5.76,6000,1,7860,0,0,0,0,0,0,0,6000,-6000,-6000
20200212,72555P,環球晶凱基94售02,,,,,,0.00,0,0,0,0,0,0,0,0,0,0,0,0,0
20200212,72556P,環球晶元富95售01,0.18,0.18,0.18,0.18,-0.02,-10.0,50000,1,9000,0,0,0,0,0,0,0,50000,-50000,-50000
20200212,72557P,晶焱元大94售01,,,,,,0.00,0,0,0,0,0,0,0,0,0,0,0,0,0
20200212,72558P,聯亞元大94售02,,,,,,0.00,0,0,0,0,0,0,0,0,0,0,0,0,0
20200212,72559P,由田永豐94售01,1.20,1.20,1.20,1.20,-0.07,-5.51,25000,1,30000,0,0,0,0,0,0,0,25000,-25000,-25000
20200212,72560P,佳邦永豐94售01,,,,,,0.00,0,0,0,0,0,0,0,0,0,0,0,0,0
20200212,72561P,昇達科永豐94售01,,,,,,0.00,0,0,0,0,0,0,0,0,0,0,0,0,0
20200212,72562P,原相永豐94售01,,,,,,0.00,0,0,0,0,0,0,0,0,0,0,0,0,0
20200212,72563P,晶焱永豐94售01,,,,,,0.00,0,0,0,0,0,0,0,0,0,0,0,0,0
20200212,72564P,新普永豐94售01,,,,,,0.00,0,0,0,0,0,0,0,0,0,0,0,0,0
20200212,72565P,台燿兆豐94售01,,,,,,0.00,0,0,0,0,0,0,0,0,0,0,0,0,0
20200212,72566P,大江群益94售03,,,,,,0.00,0,0,0,0,0,0,0,0,0,0,0,0,0
20200212,72567P,神盾群益94售03,2.90,2.95,2.90,2.95,-0.20,-6.35,17000,8,49650,0,0,0,0,0,0,7000,10000,-3000,-3000
20200212,72568P,新普群益96售01,,,,,,0.00,0,0,0,0,0,0,0,0,0,0,0,0,0
20200212,72569P,大學光元大94售04,0.09,0.09,0.09,0.09,-0.03,-25.0,3000,1,270,0,0,0,0,0,0,3000,0,3000,3000
20200212,72570P,環球晶元大94售01,,,,,,0.00,0,0,0,0,0,0,0,0,0,0,0,0,0
20200212,72571P,鐿鈦永豐94售02,1.01,1.01,1.00,1.00,-0.09,-8.26,14000,2,14060,0,6000,-6000,0,0,0,14000,0,14000,8000
20200212,72572P,網家元富96售02,1.60,1.65,1.59,1.65,+0.03,1.85,154000,9,249320,0,0,0,0,0,0,130000,24000,106000,106000
20200212,72573P,原相亞東94售01,,,,,,0.00,0,0,0,0,0,0,0,0,0,0,0,0,0
20200212,72574P,環球晶永豐94售01,,,,,,0.00,0,0,0,0,0,0,0,0,0,0,0,0,0
20200212,72575P,環球晶元富95售02,,,,,,0.00,0,0,0,0,0,0,0,0,0,0,0,0,0
20200212,72576P,緯軟元大94售05,1.43,1.43,1.43,1.43,+0.01,0.7,4000,1,5720,0,0,0,0,0,0,4000,0,4000,4000
20200212,72577P,環球晶元大94售03,0.23,0.23,0.23,0.23,-0.03,-11.54,100000,1,23000,0,0,0,0,0,0,100000,0,100000,100000
20200212,72578P,雙鴻元大95售01,1.12,1.12,1.12,1.12,0.00,0.0,10000,1,11200,0,0,0,0,0,0,0,0,0,0
20200212,72579P,穩懋元大94售02,0.36,0.36,0.36,0.36,-0.03,-7.69,10000,1,3600,0,0,0,0,0,0,10000,0,10000,10000
20200212,72580P,台燿凱基94售02,,,,,,0.00,0,0,0,0,0,0,0,0,0,0,0,0,0
20200212,72581P,穩懋元大94售03,,,,,,0.00,0,0,0,0,0,0,0,0,0,0,0,0,0
20200212,72582P,櫃200群益94售01,0.34,0.34,0.34,0.34,-0.07,-17.07,8000,8,2720,0,0,0,0,0,0,0,8000,-8000,-8000
20200212,72583P,聯亞國票95售02,,,,,,0.00,0,0,0,0,0,0,0,0,0,0,0,0,0
20200212,72584P,大江永豐94售01,,,,,,0.00,0,0,0,0,0,0,0,0,0,0,0,0,0
20200212,72585P,宏捷科永豐94售01,,,,,,0.00,0,0,0,0,0,0,0,0,0,0,0,0,0
20200212,72586P,宏捷科國泰95售02,0.33,0.33,0.30,0.33,-0.03,-8.33,215000,7,68800,0,0,0,0,0,0,85000,130000,-45000,-45000
20200212,72587P,宏捷科國票95售01,0.69,0.69,0.60,0.66,-0.08,-10.81,1024000,47,637330,0,0,0,0,0,0,540000,484000,56000,56000
20200212,72588P,大江凱基94售05,,,,,,0.00,0,0,0,0,0,0,0,0,0,0,0,0,0
20200212,72589P,櫃200第一94售02,,,,,,0.00,0,0,0,0,0,0,0,0,0,0,0,0,0
20200212,72590P,聯亞永豐94售01,,,,,,0.00,0,0,0,0,0,0,0,0,0,0,0,0,0
20200212,72591P,神盾元大95售04,1.04,1.04,1.02,1.02,-0.05,-4.67,110000,2,114200,0,0,0,0,0,0,100000,10000,90000,90000
20200212,72592P,環球晶元大94售06,0.05,0.05,0.05,0.05,-0.03,-37.5,100000,1,5000,0,0,0,0,0,0,100000,0,100000,100000
20200212,72593P,聯亞元大94售03,0.53,0.53,0.53,0.53,-0.04,-7.02,10000,1,5300,0,0,0,0,0,0,10000,0,10000,10000
20200212,72594P,雙鴻國泰96售03,,,,,,0.00,0,0,0,0,0,0,0,0,0,0,0,0,0
20200212,72595P,大江富邦96售01,,,,,,0.00,0,0,0,0,0,0,0,0,0,0,0,0,0
20200212,72596P,環球晶凱基94售04,,,,,,0.00,0,0,0,0,0,0,0,0,0,0,0,0,0
20200212,72597P,晟德凱基94售02,,,,,,0.00,0,0,0,0,0,0,0,0,0,0,0,0,0
20200212,72598P,中美晶群益94售02,,,,,,0.00,0,0,0,0,0,0,0,0,0,0,0,0,0
20200212,72599P,台燿群益94售01,,,,,,0.00,0,0,0,0,0,0,0,0,0,0,0,0,0
20200212,72600P,櫃200永昌94售03,0.57,0.57,0.54,0.54,-0.17,-23.94,60000,6,33100,0,0,0,0,0,0,0,60000,-60000,-60000
20200212,72601P,信昌電永豐94售02,0.74,0.74,0.74,0.74,-0.02,-2.63,150000,1,111000,0,0,0,0,0,0,150000,0,150000,150000
20200212,72602P,中美晶兆豐95售01,,,,,,0.00,0,0,0,0,0,0,0,0,0,0,0,0,0
20200212,72603P,櫃200富邦94售05,,,,,,0.00,0,0,0,0,0,0,0,0,0,0,0,0,0
20200212,72604P,櫃200富邦94售06,,,,,,0.00,0,0,0,0,0,0,0,0,0,0,0,0,0
20200212,72605P,凡甲統一94售02,0.78,0.78,0.75,0.75,-0.03,-3.85,426000,13,327940,0,0,0,0,0,0,0,426000,-426000,-426000
20200212,72606P,聯亞凱基94售03,,,,,,0.00,0,0,0,0,0,0,0,0,0,0,0,0,0
20200212,72607P,元太元大94售02,,,,,,0.00,0,0,0,0,0,0,0,0,0,0,0,0,0
20200212,72608P,大江台新94售02,2.22,2.22,2.22,2.22,+0.03,1.37,10000,1,22200,0,0,0,0,0,0,0,10000,-10000,-10000
20200212,72609P,環球晶台新94售01,0.20,0.20,0.20,0.20,-0.02,-9.09,20000,1,4000,0,0,0,0,0,0,0,20000,-20000,-20000
20200212,72610P,中美晶凱基94售02,,,,,,0.00,0,0,0,0,0,0,0,0,0,0,0,0,0
20200212,72611P,雙鴻凱基96售02,1.32,1.32,1.32,1.32,-0.01,-0.75,25000,1,33000,0,0,0,0,0,0,25000,0,25000,25000
20200212,72612P,環球晶永豐94售03,,,,,,0.00,0,0,0,0,0,0,0,0,0,0,0,0,0
20200212,72613P,緯軟群益95售01,,,,,,0.00,0,0,0,0,0,0,0,0,0,0,0,0,0
20200212,72614P,台燿元大94售02,,,,,,0.00,0,0,0,0,0,0,0,0,0,0,0,0,0
20200212,72615P,晶焱元大95售02,,,,,,0.00,0,0,0,0,0,0,0,0,0,0,0,0,0
20200212,72616P,環球晶元大94售07,0.42,0.42,0.42,0.42,-0.07,-14.29,15000,1,6300,0,0,0,0,0,0,0,15000,-15000,-15000
20200212,72617P,原相兆豐95售01,0.10,0.10,0.10,0.10,0.00,0.0,12000,2,1200,0,0,0,0,0,0,0,12000,-12000,-12000
20200212,72618P,台燿元大94售05,,,,,,0.00,0,0,0,0,0,0,0,0,0,0,0,0,0
20200212,72619P,環球晶元大94售08,,,,,,0.00,0,0,0,0,0,0,0,0,0,0,0,0,0
20200212,72620P,雙鴻元大94售01,3.72,3.72,3.69,3.69,-0.24,-6.11,30000,2,111000,0,0,0,0,0,0,20000,10000,10000,10000
20200212,72621P,台燿凱基94售03,,,,,,0.00,0,0,0,0,0,0,0,0,0,0,0,0,0
20200212,72622P,聯亞凱基94售04,0.38,0.38,0.38,0.38,-0.03,-7.32,1000,1,380,0,0,0,0,0,0,0,1000,-1000,-1000
20200212,72623P,穩懋富邦96售02,0.78,0.78,0.73,0.73,-0.10,-12.05,144000,5,111280,0,0,0,0,0,0,14000,130000,-116000,-116000
20200212,72624P,櫃200第一96售02,0.97,0.97,0.95,0.95,-0.06,-5.94,5000,5,4800,0,0,0,0,0,0,0,5000,-5000,-5000
20200212,72625P,雙鴻永豐94售02,1.77,1.77,1.77,1.77,-0.17,-8.76,19000,1,33630,0,0,0,0,0,0,0,19000,-19000,-19000
20200212,72626P,環球晶兆豐95售03,,,,,,0.00,0,0,0,0,0,0,0,0,0,0,0,0,0
20200212,72627P,新鉅科康和94售02,,,,,,0.00,0,0,0,0,0,0,0,0,0,0,0,0,0
20200212,72628P,宏捷科群益94售02,0.58,0.58,0.54,0.58,-0.08,-12.12,277000,16,153580,0,0,0,0,0,0,47000,230000,-183000,-183000
20200212,72629P,安勤統一94售02,,,,,,0.00,0,0,0,0,0,0,0,0,0,0,0,0,0
20200212,72630P,中美晶凱基94售04,,,,,,0.00,0,0,0,0,0,0,0,0,0,0,0,0,0
20200212,72631P,台燿元大94售07,,,,,,0.00,0,0,0,0,0,0,0,0,0,0,0,0,0
20200212,72632P,環球晶元大94售12,,,,,,0.00,0,0,0,0,0,0,0,0,0,0,0,0,0
20200212,72633P,聯亞元大95售02,,,,,,0.00,0,0,0,0,0,0,0,0,0,0,0,0,0
20200212,72634P,環球晶元富94售05,,,,,,0.00,0,0,0,0,0,0,0,0,0,0,0,0,0
20200212,72635P,安勤統一94售03,,,,,,0.00,0,0,0,0,0,0,0,0,0,0,0,0,0
20200212,72636P,安勤統一94售04,,,,,,0.00,0,0,0,0,0,0,0,0,0,0,0,0,0
20200212,72637P,穩懋永豐94售02,,,,,,0.00,0,0,0,0,0,0,0,0,0,0,0,0,0
20200212,72638P,中美晶元富95售03,0.71,0.71,0.70,0.70,-0.05,-6.67,254000,3,179890,0,0,0,0,0,0,158000,96000,62000,62000
20200212,72639P,台燿元富94售02,,,,,,0.00,0,0,0,0,0,0,0,0,0,0,0,0,0
20200212,72640P,元太凱基94售02,1.24,1.24,1.24,1.24,-0.06,-4.62,2000,1,2480,0,0,0,0,0,0,2000,0,2000,2000
20200212,72641P,環球晶群益94售06,,,,,,0.00,0,0,0,0,0,0,0,0,0,0,0,0,0
20200212,72642P,台燿永豐94售02,0.61,0.61,0.58,0.58,-0.12,-17.14,53000,2,32240,0,0,0,0,0,0,0,53000,-53000,-53000
20200212,72643P,神盾永豐94售02,2.15,2.15,2.15,2.15,-0.22,-9.28,10000,1,21500,0,0,0,0,0,0,10000,0,10000,10000
20200212,72644P,台燿元大94售08,,,,,,0.00,0,0,0,0,0,0,0,0,0,0,0,0,0
20200212,72645P,環球晶國票94售01,,,,,,0.00,0,0,0,0,0,0,0,0,0,0,0,0,0
20200212,72646P,穩懋統一94售05,1.36,1.36,1.20,1.20,-0.30,-20.0,58000,7,71130,0,0,0,0,0,0,15000,43000,-28000,-28000
20200212,72647P,中美晶凱基94售05,,,,,,0.00,0,0,0,0,0,0,0,0,0,0,0,0,0
20200212,72648P,聯亞凱基94售05,,,,,,0.00,0,0,0,0,0,0,0,0,0,0,0,0,0
20200212,72649P,大江元富94售02,2.20,2.24,2.20,2.20,-0.03,-1.35,35000,4,77500,0,0,0,0,0,0,0,35000,-35000,-35000
20200212,72650P,威剛永豐94售03,,,,,,0.00,0,0,0,0,0,0,0,0,0,0,0,0,0
20200212,72651P,世界元大94售01,,,,,,0.00,0,0,0,0,0,0,0,0,0,0,0,0,0
20200212,72652P,環球晶元大94售17,0.45,0.45,0.45,0.45,-0.06,-11.76,50000,1,22500,0,0,0,0,0,0,0,50000,-50000,-50000
20200212,72653P,宣德永豐94售02,0.67,0.67,0.67,0.67,+0.02,3.08,10000,1,6700,0,0,0,0,0,0,0,10000,-10000,-10000
20200212,72654P,環球晶中信94售02,0.18,0.18,0.18,0.18,-0.02,-10.0,1000,1,180,0,0,0,0,0,0,0,1000,-1000,-1000
20200212,72655P,穩懋統一96售03,1.92,1.92,1.68,1.72,-0.22,-11.34,182000,10,328660,0,0,0,0,0,0,40000,142000,-102000,-102000
20200212,72656P,台燿元富94售05,,,,,,0.00,0,0,0,0,0,0,0,0,0,0,0,0,0
20200212,72657P,環球晶元富94售06,,,,,,0.00,0,0,0,0,0,0,0,0,0,0,0,0,0
20200212,72658P,建榮國票95售03,1.03,1.03,1.03,1.03,-0.02,-1.9,10000,1,10300,0,0,0,0,0,0,0,10000,-10000,-10000
20200212,72659P,穩懋元大94售11,,,,,,0.00,0,0,0,0,0,0,0,0,0,0,0,0,0
20200212,72660P,穩懋統一94售08,1.24,1.24,1.05,1.10,-0.21,-16.03,146000,65,169380,0,0,0,0,0,0,64000,82000,-18000,-18000
20200212,72661P,穩懋中信96售01,,,,,,0.00,0,0,0,0,0,0,0,0,0,0,0,0,0
20200212,72662P,穩懋中信98售01,0.74,0.74,0.70,0.70,-0.07,-9.09,88000,5,64020,0,0,0,0,0,0,78000,10000,68000,68000
20200212,72663P,神盾元富96售01,,,,,,0.00,0,0,0,0,0,0,0,0,0,0,0,0,0
20200212,72664P,精華元富94售02,2.48,2.48,2.44,2.45,0.00,0.0,25000,3,61450,0,0,0,0,0,0,10000,15000,-5000,-5000
20200212,72665P,聯亞元富94售02,,,,,,0.00,0,0,0,0,0,0,0,0,0,0,0,0,0
20200212,72666P,神盾元大94售06,,,,,,0.00,0,0,0,0,0,0,0,0,0,0,0,0,0
20200212,72667P,台燿凱基94售06,,,,,,0.00,0,0,0,0,0,0,0,0,0,0,0,0,0
20200212,72668P,網龍康和94售01,0.58,0.58,0.58,0.58,-0.02,-3.33,8000,1,4640,0,0,0,0,0,0,8000,0,8000,8000
20200212,72669P,原相凱基95售01,0.20,0.21,0.19,0.19,-0.03,-13.64,3000000,28,609660,0,0,0,0,0,0,2160000,750000,1410000,1410000
20200212,72670P,環球晶凱基95售02,0.83,0.83,0.81,0.81,-0.10,-10.99,30000,4,24650,0,0,0,0,0,0,0,30000,-30000,-30000
20200212,72671P,穩懋元富95售04,0.68,0.68,0.68,0.68,-0.10,-12.82,1000,1,680,0,0,0,0,0,0,0,1000,-1000,-1000
20200212,72672P,穩懋國票96售01,,,,,,0.00,0,0,0,0,0,0,0,0,0,0,0,0,0
20200212,72673P,穩懋國泰96售01,1.78,1.78,1.51,1.57,-0.24,-13.26,153000,22,239840,0,0,0,0,0,0,20000,133000,-113000,-113000
20200212,72674P,環球晶富邦97售02,0.42,0.42,0.41,0.41,-0.02,-4.65,92000,5,37920,0,0,0,0,0,0,5000,87000,-82000,-82000
20200212,72675P,環球晶凱基95售03,0.16,0.16,0.16,0.16,-0.03,-15.79,10000,1,1600,0,0,0,0,0,0,0,10000,-10000,-10000
20200212,72676P,金居元大95售03,1.09,1.09,1.09,1.09,-0.04,-3.54,15000,1,16350,0,0,0,0,0,0,0,15000,-15000,-15000
20200212,72677P,中美晶永豐95售02,,,,,,0.00,0,0,0,0,0,0,0,0,0,0,0,0,0
20200212,72678P,穩懋永豐95售01,,,,,,0.00,0,0,0,0,0,0,0,0,0,0,0,0,0
20200212,72679P,譜瑞中信95售02,0.28,0.28,0.26,0.26,-0.07,-21.21,230000,6,62150,0,0,0,0,0,0,50000,180000,-130000,-130000
20200212,72680P,穩懋元大95售01,,,,,,0.00,0,0,0,0,0,0,0,0,0,0,0,0,0
20200212,72681P,合晶永豐95售01,1.56,1.56,1.56,1.56,-0.08,-4.88,10000,1,15600,0,0,0,0,0,0,0,10000,-10000,-10000
20200212,72682P,良維永豐95售01,1.53,1.53,1.49,1.49,-0.06,-3.87,36000,3,54440,0,0,0,0,0,0,16000,20000,-4000,-4000
20200212,72683P,碩禾永豐95售02,0.59,0.59,0.59,0.59,-0.02,-3.28,50000,8,29500,0,0,0,0,0,0,50000,0,50000,50000
20200212,72684P,大江國票96售02,,,,,,0.00,0,0,0,0,0,0,0,0,0,0,0,0,0
20200212,72685P,中美晶元富95售05,0.58,0.58,0.52,0.52,-0.11,-17.46,274000,4,156620,0,0,0,0,0,0,194000,80000,114000,114000
20200212,72686P,新普群益97售03,0.87,0.88,0.87,0.88,-0.07,-7.37,55000,5,48200,0,0,0,0,0,0,0,55000,-55000,-55000
20200212,72687P,譜瑞元大95售03,0.62,0.63,0.62,0.63,-0.09,-12.5,334000,11,209490,0,0,0,0,0,0,30000,304000,-274000,-274000
20200212,72688P,環球晶凱基95售05,1.14,1.14,1.14,1.14,-0.09,-7.32,240000,1,273600,0,0,0,0,0,0,240000,0,240000,240000
20200212,72689P,環宇國票96售01,,,,,,0.00,0,0,0,0,0,0,0,0,0,0,0,0,0
20200212,72690P,聯亞台新95售02,,,,,,0.00,0,0,0,0,0,0,0,0,0,0,0,0,0
20200212,72691P,穩懋台新95售01,,,,,,0.00,0,0,0,0,0,0,0,0,0,0,0,0,0
20200212,72692P,中美晶群益95售01,,,,,,0.00,0,0,0,0,0,0,0,0,0,0,0,0,0
20200212,72693P,環球晶凱基95售07,,,,,,0.00,0,0,0,0,0,0,0,0,0,0,0,0,0
20200212,72694P,櫃200元大95售02,,,,,,0.00,0,0,0,0,0,0,0,0,0,0,0,0,0
20200212,72695P,穩懋元大95售03,2.33,2.33,2.33,2.33,-0.34,-12.73,1000,1,2330,0,0,0,0,0,0,0,1000,-1000,-1000
20200212,72696P,穩懋兆豐95售02,0.40,0.40,0.30,0.34,-0.07,-17.07,1540000,8,484390,0,0,0,0,0,0,1490000,50000,1440000,1440000
20200212,72697P,穩懋亞東96售01,,,,,,0.00,0,0,0,0,0,0,0,0,0,0,0,0,0
20200212,72698P,環球晶凱基95售08,,,,,,0.00,0,0,0,0,0,0,0,0,0,0,0,0,0
20200212,72699P,大江元大95售03,,,,,,0.00,0,0,0,0,0,0,0,0,0,0,0,0,0
20200212,72700P,中美晶元大95售03,,,,,,0.00,0,0,0,0,0,0,0,0,0,0,0,0,0
20200212,72701P,穩懋元大95售05,1.94,1.98,1.93,1.98,-0.38,-16.1,685000,5,1331350,0,0,0,0,0,0,680000,5000,675000,675000
20200212,72702P,精華元富95售02,1.66,1.67,1.66,1.67,-0.09,-5.11,33000,4,55030,0,0,0,0,0,0,0,33000,-33000,-33000
20200212,72703P,聯亞群益96售01,,,,,,0.00,0,0,0,0,0,0,0,0,0,0,0,0,0
20200212,72704P,大江國票96售03,,,,,,0.00,0,0,0,0,0,0,0,0,0,0,0,0,0
20200212,72705P,原相永豐95售01,0.12,0.12,0.12,0.12,-0.01,-7.69,200000,3,24000,0,0,0,0,0,0,0,200000,-200000,-200000
20200212,72706P,環球晶國泰96售02,0.80,0.80,0.76,0.76,-0.08,-9.52,110000,40,85730,0,0,0,0,0,0,60000,50000,10000,10000
20200212,72707P,中美晶國票96售02,,,,,,0.00,0,0,0,0,0,0,0,0,0,0,0,0,0
20200212,72708P,環球晶群益95售03,,,,,,0.00,0,0,0,0,0,0,0,0,0,0,0,0,0
20200212,72709P,新鉅科康和95售01,1.04,1.04,0.97,0.97,-0.13,-11.82,310000,3,322050,0,0,0,0,0,0,305000,5000,300000,300000
20200212,72710P,神盾元大95售06,1.00,1.01,1.00,1.00,-0.07,-6.54,121000,4,121100,0,0,0,0,0,0,111000,10000,101000,101000
20200212,72711P,櫃200永昌96售05,,,,,,0.00,0,0,0,0,0,0,0,0,0,0,0,0,0
20200212,72712P,環球晶元大95售11,0.42,0.42,0.40,0.40,-0.04,-9.09,160000,8,65400,0,0,0,0,0,0,0,160000,-160000,-160000
20200212,72713P,櫃200元大96售01,0.59,0.59,0.57,0.57,-0.07,-10.94,13000,5,7520,0,0,0,0,0,0,0,13000,-13000,-13000
20200212,72714P,櫃200元大96售02,,,,,,0.00,0,0,0,0,0,0,0,0,0,0,0,0,0
20200212,72715P,雙鴻統一95售01,,,,,,0.00,0,0,0,0,0,0,0,0,0,0,0,0,0
20200212,72716P,穩懋統一96售04,1.77,1.77,1.59,1.59,-0.28,-14.97,64000,5,110070,0,0,0,0,0,0,0,64000,-64000,-64000
20200212,72717P,穩懋元富95售07,1.57,1.57,1.29,1.33,-0.31,-18.9,115000,13,161660,0,0,0,0,0,0,10000,105000,-95000,-95000
20200212,72718P,穩懋元富95售08,0.96,0.96,0.77,0.81,-0.17,-17.35,660000,31,562460,0,0,0,0,0,0,195000,485000,-290000,-290000
20200212,72719P,原相亞東96售02,0.15,0.15,0.15,0.15,-0.02,-11.76,20000,1,3000,0,0,0,0,0,0,0,20000,-20000,-20000
20200212,72720P,元太元大95售03,,,,,,0.00,0,0,0,0,0,0,0,0,0,0,0,0,0
20200212,72721P,宣德永豐95售02,0.82,0.82,0.82,0.82,+0.01,1.23,52000,2,42640,0,0,0,0,0,0,52000,0,52000,52000
20200212,72722P,穩懋統一95售01,,,,,,0.00,0,0,0,0,0,0,0,0,0,0,0,0,0
20200212,72723P,穩懋統一95售02,1.42,1.42,1.42,1.42,-0.23,-13.94,50000,2,71000,0,0,0,0,0,0,50000,0,50000,50000
20200212,72724P,威剛凱基95售01,,,,,,0.00,0,0,0,0,0,0,0,0,0,0,0,0,0
20200212,72725P,環球晶元大95售13,0.42,0.42,0.39,0.40,-0.05,-11.11,117000,6,46920,0,0,0,0,0,0,69000,48000,21000,21000
20200212,72726P,穩懋元大95售08,2.07,2.07,2.07,2.07,-0.37,-15.16,1000,1,2070,0,0,0,0,0,0,1000,0,1000,1000
20200212,72727P,雙鴻康和95售01,,,,,,0.00,0,0,0,0,0,0,0,0,0,0,0,0,0
20200212,72728P,穩懋元大95售09,,,,,,0.00,0,0,0,0,0,0,0,0,0,0,0,0,0
20200212,72729P,櫃200富邦95售04,,,,,,0.00,0,0,0,0,0,0,0,0,0,0,0,0,0
20200212,72730P,櫃200富邦95售05,,,,,,0.00,0,0,0,0,0,0,0,0,0,0,0,0,0
20200212,72731P,櫃200富邦95售06,0.36,0.36,0.35,0.35,-0.05,-12.5,5000,5,1770,0,0,0,0,0,0,3000,2000,1000,1000
20200212,72732P,櫃200T永昌96售05,,,,,,0.00,0,0,0,0,0,0,0,0,0,0,0,0,0
20200212,72733P,櫃200凱基96售01,,,,,,0.00,0,0,0,0,0,0,0,0,0,0,0,0,0
20200212,72734P,櫃200凱基96售02,,,,,,0.00,0,0,0,0,0,0,0,0,0,0,0,0,0
20200212,72735P,穩懋元大95售10,1.20,1.21,1.03,1.08,-0.14,-11.48,179000,25,199530,0,0,0,0,0,0,3000,176000,-173000,-173000
20200212,72736P,穩懋元大95售11,2.06,2.06,2.06,2.06,-0.28,-11.97,1000,1,2060,0,0,0,0,0,0,1000,0,1000,1000
20200212,72737P,櫃200富邦9A售03,,,,,,0.00,0,0,0,0,0,0,0,0,0,0,0,0,0
20200212,72738P,櫃200富邦9A售04,,,,,,0.00,0,0,0,0,0,0,0,0,0,0,0,0,0
20200212,72739P,中美晶永豐95售04,,,,,,0.00,0,0,0,0,0,0,0,0,0,0,0,0,0
20200212,72740P,中美晶元大95售05,,,,,,0.00,0,0,0,0,0,0,0,0,0,0,0,0,0
20200212,72741P,良維元大95售03,,,,,,0.00,0,0,0,0,0,0,0,0,0,0,0,0,0
20200212,72742P,雙鴻元大95售03,1.85,1.85,1.72,1.73,-0.09,-4.95,409000,29,729500,0,0,0,0,0,0,55000,403000,-348000,-348000
20200212,72743P,群聯永豐95售02,,,,,,0.00,0,0,0,0,0,0,0,0,0,0,0,0,0
20200212,72744P,神盾元大95售07,1.52,1.52,1.47,1.49,-0.08,-5.1,478000,13,711500,0,0,0,0,0,0,455000,473000,-18000,-18000
20200212,72745P,威剛國票96售01,0.16,0.16,0.15,0.15,-0.01,-6.25,656000,10,99480,0,0,0,0,0,0,0,656000,-656000,-656000
20200212,72746P,大江富邦97售02,,,,,,0.00,0,0,0,0,0,0,0,0,0,0,0,0,0
20200212,72747P,櫃200T永昌9C售05,,,,,,0.00,0,0,0,0,0,0,0,0,0,0,0,0,0
20200212,72748P,穩懋康和95售01,,,,,,0.00,0,0,0,0,0,0,0,0,0,0,0,0,0
20200212,72749P,金居元大95售04,1.16,1.16,1.12,1.13,-0.09,-7.38,27000,5,30770,0,0,0,0,0,0,17000,10000,7000,7000
20200212,72750P,精華元大95售04,,,,,,0.00,0,0,0,0,0,0,0,0,0,0,0,0,0
20200212,72751P,元太中信95售02,,,,,,0.00,0,0,0,0,0,0,0,0,0,0,0,0,0
20200212,72752P,環球晶凱基96售02,,,,,,0.00,0,0,0,0,0,0,0,0,0,0,0,0,0
20200212,72753P,新普永豐95售02,,,,,,0.00,0,0,0,0,0,0,0,0,0,0,0,0,0
20200212,72754P,大江群益95售02,,,,,,0.00,0,0,0,0,0,0,0,0,0,0,0,0,0
20200212,72755P,精華凱基95售02,,,,,,0.00,0,0,0,0,0,0,0,0,0,0,0,0,0
20200212,72756P,穩懋凱基95售02,0.95,0.95,0.95,0.95,-0.09,-8.65,20000,1,19000,0,0,0,0,0,0,20000,0,20000,20000
20200212,72757P,精華統一95售01,,,,,,0.00,0,0,0,0,0,0,0,0,0,0,0,0,0
20200212,72758P,環球晶凱基95售14,0.12,0.12,0.12,0.12,-0.03,-20.0,55000,1,6600,0,0,0,0,0,0,55000,0,55000,55000
20200212,72759P,精華永豐95售03,1.57,1.57,1.57,1.57,0.00,0.0,90000,2,141300,0,0,0,0,0,0,90000,0,90000,90000
20200212,72760P,精測元大95售01,1.30,1.36,1.30,1.36,-0.03,-2.16,53000,2,71900,0,0,0,0,0,0,0,53000,-53000,-53000
20200212,72761P,中美晶富邦96售01,,,,,,0.00,0,0,0,0,0,0,0,0,0,0,0,0,0
20200212,72762P,穩懋富邦97售02,0.61,0.61,0.59,0.59,-0.09,-13.24,81000,3,48390,0,0,0,0,0,0,0,81000,-81000,-81000
20200212,72763P,精測中信96售01,,,,,,0.00,0,0,0,0,0,0,0,0,0,0,0,0,0
20200212,72764P,中美晶凱基96售02,,,,,,0.00,0,0,0,0,0,0,0,0,0,0,0,0,0
20200212,72765P,精測國泰97售01,0.78,0.79,0.75,0.75,-0.05,-6.25,495000,12,381610,0,0,0,0,0,0,179000,308000,-129000,-129000
20200212,72766P,中美晶富邦97售01,,,,,,0.00,0,0,0,0,0,0,0,0,0,0,0,0,0
20200212,72767P,精測康和96售01,,,,,,0.00,0,0,0,0,0,0,0,0,0,0,0,0,0
20200212,72768P,精測凱基96售02,,,,,,0.00,0,0,0,0,0,0,0,0,0,0,0,0,0
20200212,72769P,雙鴻兆豐97售01,0.85,0.85,0.83,0.83,-0.03,-3.49,65000,3,54950,0,0,0,0,0,0,0,65000,-65000,-65000
20200212,72770P,精測永豐96售03,0.92,0.92,0.92,0.92,-0.02,-2.13,39000,1,35880,0,0,0,0,0,0,0,39000,-39000,-39000
20200212,72771P,鈊象元大96售01,0.45,0.49,0.44,0.49,+0.04,8.89,28000,3,13390,0,0,0,0,0,0,28000,0,28000,28000
20200212,72772P,同致國票97售01,,,,,,0.00,0,0,0,0,0,0,0,0,0,0,0,0,0
20200212,72773P,鈊象國票96售01,0.29,0.31,0.29,0.31,+0.03,10.71,1378000,15,415880,0,0,0,0,0,0,1373000,5000,1368000,1368000
20200212,72774P,精測群益96售02,,,,,,0.00,0,0,0,0,0,0,0,0,0,0,0,0,0
20200212,72775P,精測統一96售02,1.21,1.22,1.18,1.22,-0.03,-2.4,52000,3,63190,0,0,0,0,0,0,0,52000,-52000,-52000
20200212,72776P,精測凱基96售05,0.60,0.60,0.59,0.60,-0.03,-4.76,112000,5,66300,0,0,0,0,0,0,90000,22000,68000,68000
20200212,72777P,櫃200凱基96售04,1.24,1.24,1.15,1.15,-0.21,-15.44,24000,5,28560,0,0,0,0,0,0,2000,22000,-20000,-20000
20200212,72778P,櫃200凱基96售05,0.67,0.67,0.67,0.67,-0.08,-10.67,3000,3,2010,0,0,0,0,0,0,0,3000,-3000,-3000
20200212,72779P,鈊象凱基96售02,,,,,,0.00,0,0,0,0,0,0,0,0,0,0,0,0,0
20200212,72780P,鈊象台新96售01,,,,,,0.00,0,0,0,0,0,0,0,0,0,0,0,0,0
20200212,72781P,鈊象永豐96售02,,,,,,0.00,0,0,0,0,0,0,0,0,0,0,0,0,0
20200212,72782P,鈊象康和96售01,,,,,,0.00,0,0,0,0,0,0,0,0,0,0,0,0,0
20200212,72783P,鈊象群益96售01,0.74,0.78,0.74,0.77,+0.06,8.45,348000,15,267060,0,0,0,0,0,0,30000,318000,-288000,-288000
20200212,72784P,精測統一96售03,0.35,0.35,0.33,0.33,-0.03,-8.33,230000,9,76700,0,0,0,0,0,0,0,230000,-230000,-230000
20200212,72785P,鈊象元富96售02,0.41,0.46,0.41,0.46,+0.05,12.2,577000,6,257580,0,0,0,0,0,0,65000,512000,-447000,-447000
20200212,72786P,聯亞國票97售02,,,,,,0.00,0,0,0,0,0,0,0,0,0,0,0,0,0
20200212,72787P,精測永豐96售05,1.06,1.06,1.04,1.04,-0.08,-7.14,12000,2,12600,0,0,0,0,0,0,6000,0,6000,6000
20200212,72788P,群聯群益96售03,0.60,0.60,0.60,0.60,-0.05,-7.69,6000,1,3600,0,0,0,0,0,0,0,6000,-6000,-6000
20200212,72789P,精測群益96售03,1.11,1.11,1.08,1.08,-0.10,-8.47,102000,4,112190,0,0,0,0,0,0,21000,81000,-60000,-60000
20200212,72790P,精華群益96售01,,,,,,0.00,0,0,0,0,0,0,0,0,0,0,0,0,0
20200212,72791P,精測凱基96售06,0.53,0.53,0.53,0.53,-0.05,-8.62,450000,8,238500,0,0,0,0,0,0,250000,200000,50000,50000
20200212,72792P,穩懋國票96售04,,,,,,0.00,0,0,0,0,0,0,0,0,0,0,0,0,0
20200212,72793P,穩懋兆豐96售03,0.75,0.75,0.75,0.75,-0.14,-15.73,10000,1,7500,0,0,0,0,0,0,0,10000,-10000,-10000
20200212,72794P,穩懋兆豐97售01,0.58,0.58,0.58,0.58,-0.05,-7.94,5000,1,2900,0,0,0,0,0,0,0,5000,-5000,-5000
20200212,72795P,鈊象元大96售02,,,,,,0.00,0,0,0,0,0,0,0,0,0,0,0,0,0
20200212,72796P,穩懋統一97售02,1.01,1.04,0.86,0.89,-0.18,-16.82,769000,39,755240,0,0,0,0,0,0,283000,380000,-97000,-97000
20200212,72797P,鈊象統一97售01,,,,,,0.00,0,0,0,0,0,0,0,0,0,0,0,0,0
20200212,72798P,穩懋凱基96售08,0.75,0.75,0.75,0.75,-0.14,-15.73,110000,2,82500,0,0,0,0,0,0,100000,10000,90000,90000
20200212,72799P,世界永豐96售01,,,,,,0.00,0,0,0,0,0,0,0,0,0,0,0,0,0
20200212,72800P,鈊象元富96售03,0.57,0.64,0.57,0.64,+0.03,4.92,36000,5,22270,0,0,0,0,0,0,16000,20000,-4000,-4000
20200212,72801P,中美晶元大96售01,0.90,0.90,0.83,0.89,-0.04,-4.3,209000,7,183370,0,0,0,0,0,0,129000,179000,-50000,-50000
20200212,72802P,世界元大96售04,,,,,,0.00,0,0,0,0,0,0,0,0,0,0,0,0,0
20200212,72803P,中美晶中信98售01,,,,,,0.00,0,0,0,0,0,0,0,0,0,0,0,0,0
20200212,72804P,世界中信96售02,0.94,0.94,0.93,0.93,-0.05,-5.1,18000,2,16840,0,0,0,0,0,0,18000,0,18000,18000
20200212,72805P,鈊象元富96售04,0.58,0.66,0.58,0.66,+0.05,8.2,604000,17,382000,0,0,0,0,0,0,384000,170000,214000,214000
20200212,72806P,世界康和96售02,,,,,,0.00,0,0,0,0,0,0,0,0,0,0,0,0,0
20200212,72807P,網龍群益98售02,,,,,,0.00,0,0,0,0,0,0,0,0,0,0,0,0,0
20200212,72808P,力旺康和96售01,,,,,,0.00,0,0,0,0,0,0,0,0,0,0,0,0,0
20200212,72809P,聯亞元富96售01,1.53,1.53,1.53,1.53,-0.08,-4.97,10000,1,15300,0,0,0,0,0,0,10000,0,10000,10000
20200212,72810P,雙鴻元富96售02,2.28,2.28,2.15,2.15,-0.15,-6.52,470000,10,1033100,0,0,0,0,0,0,150000,270000,-120000,-120000
20200212,72811P,鈊象元富96售05,0.51,0.56,0.51,0.56,+0.10,21.74,545000,7,299600,0,0,0,0,0,0,11000,534000,-523000,-523000
20200212,72812P,世界統一96售01,1.19,1.19,1.19,1.19,-0.07,-5.56,3000,1,3570,0,0,0,0,0,0,3000,0,3000,3000
20200212,72813P,宣德統一97售01,0.90,0.90,0.90,0.90,+0.01,1.12,10000,1,9000,0,0,0,0,0,0,10000,0,10000,10000
20200212,72814P,世界群益98售03,,,,,,0.00,0,0,0,0,0,0,0,0,0,0,0,0,0
20200212,72815P,宣德元大96售05,2.19,2.19,2.10,2.10,+0.01,0.48,167000,9,358160,0,0,0,0,0,0,157000,136000,21000,21000
20200212,72816P,信昌電國票97售02,,,,,,0.00,0,0,0,0,0,0,0,0,0,0,0,0,0
20200212,72817P,網龍國票97售03,2.19,2.19,2.19,2.19,+0.02,0.92,10000,1,21900,0,0,0,0,0,0,0,10000,-10000,-10000
20200212,72818P,櫃200第一96售05,,,,,,0.00,0,0,0,0,0,0,0,0,0,0,0,0,0
20200212,72819P,櫃200第一96售06,,,,,,0.00,0,0,0,0,0,0,0,0,0,0,0,0,0
20200212,72820P,中美晶兆豐97售01,0.93,0.95,0.93,0.95,+0.01,1.06,42000,3,39660,0,0,0,0,0,0,37000,5000,32000,32000
20200212,72821P,櫃200永昌97售02,2.34,2.34,2.34,2.34,-0.20,-7.87,3000,1,7020,0,0,0,0,0,0,0,3000,-3000,-3000
20200212,72822P,櫃200永昌97售03,,,,,,0.00,0,0,0,0,0,0,0,0,0,0,0,0,0
20200212,72823P,櫃200永昌99售04,,,,,,0.00,0,0,0,0,0,0,0,0,0,0,0,0,0
20200212,72824P,櫃200永昌99售05,,,,,,0.00,0,0,0,0,0,0,0,0,0,0,0,0,0
20200212,72825P,緯軟永豐96售01,1.61,1.62,1.61,1.61,-0.05,-3.01,6000,3,9670,0,0,0,0,0,0,0,6000,-6000,-6000
20200212,72826P,穩懋統一96售11,1.07,1.07,0.97,0.99,-0.13,-11.61,60000,7,60750,0,0,0,0,0,0,40000,15000,25000,25000
20200212,72827P,穩懋統一96售12,,,,,,0.00,0,0,0,0,0,0,0,0,0,0,0,0,0
20200212,72828P,新普凱基96售01,,,,,,0.00,0,0,0,0,0,0,0,0,0,0,0,0,0
20200212,72829P,神盾群益98售02,0.95,0.96,0.93,0.96,-0.02,-2.04,183000,9,172520,0,0,0,0,0,0,60000,153000,-93000,-93000
20200212,72830P,櫃200永昌9B售02,,,,,,0.00,0,0,0,0,0,0,0,0,0,0,0,0,0
20200212,72831P,櫃200永昌9B售03,4.30,4.30,4.30,4.30,0.00,0.0,1000,1,4300,0,0,0,0,0,0,0,0,0,0
20200212,72832P,櫃200永昌9C售04,,,,,,0.00,0,0,0,0,0,0,0,0,0,0,0,0,0
20200212,72833P,櫃200永昌9C售05,,,,,,0.00,0,0,0,0,0,0,0,0,0,0,0,0,0
20200212,72834P,威剛元富99售01,0.83,0.84,0.80,0.82,-0.04,-4.65,85000,11,69990,0,0,0,0,0,0,0,85000,-85000,-85000
20200212,72835P,環球晶中信9A售01,0.75,0.75,0.73,0.73,-0.03,-3.95,116000,5,85690,0,0,0,0,0,0,0,116000,-116000,-116000
20200212,72836P,聯亞永豐96售02,1.32,1.34,1.32,1.34,-0.08,-5.63,9000,2,11960,0,0,0,0,0,0,4000,5000,-1000,-1000
20200212,72837P,雙鴻永豐96售01,2.73,2.73,2.73,2.73,-0.07,-2.5,7000,1,19110,0,0,0,0,0,0,0,7000,-7000,-7000
20200212,72838P,M31元大96售03,1.41,1.41,1.40,1.40,-0.07,-4.76,117000,4,163810,0,0,0,0,0,0,101000,16000,85000,85000
20200212,72839P,世界元富96售03,1.26,1.26,1.20,1.20,-0.09,-6.98,33000,4,40700,0,0,0,0,0,0,13000,20000,-7000,-7000
20200212,72840P,聖暉統一97售01,,,,,,0.00,0,0,0,0,0,0,0,0,0,0,0,0,0
20200212,72841P,環球晶凱基96售09,,,,,,0.00,0,0,0,0,0,0,0,0,0,0,0,0,0
20200212,72842P,宣德永豐96售02,1.83,1.83,1.83,1.83,-0.16,-8.04,5000,1,9150,0,0,0,0,0,0,0,5000,-5000,-5000
20200212,72843P,精測永豐96售11,1.21,1.24,1.21,1.21,-0.06,-4.72,77000,5,94610,0,0,0,0,0,0,14000,63000,-49000,-49000
20200212,72844P,精測國泰97售03,1.63,1.63,1.59,1.59,-0.08,-4.79,82000,14,132360,0,0,0,0,0,0,10000,72000,-62000,-62000
20200212,72845P,精測元大96售05,,,,,,0.00,0,0,0,0,0,0,0,0,0,0,0,0,0
20200212,72846P,穩懋元大96售08,1.03,1.03,1.03,1.03,-0.12,-10.43,5000,1,5150,0,0,0,0,0,0,5000,0,5000,5000
20200212,72847P,鈊象元大96售05,0.88,0.97,0.88,0.97,+0.07,7.78,203000,4,194180,0,0,0,0,0,0,25000,178000,-153000,-153000
20200212,72848P,信驊康和96售01,0.86,0.87,0.86,0.86,-0.02,-2.27,44000,4,38040,0,0,0,0,0,0,24000,20000,4000,4000
20200212,72849P,櫃200永昌98售03,,,,,,0.00,0,0,0,0,0,0,0,0,0,0,0,0,0
20200212,72850P,櫃200永昌98售04,,,,,,0.00,0,0,0,0,0,0,0,0,0,0,0,0,0
20200212,72851P,佳邦永豐96售02,,,,,,0.00,0,0,0,0,0,0,0,0,0,0,0,0,0
20200212,72852P,信昌電永豐96售01,,,,,,0.00,0,0,0,0,0,0,0,0,0,0,0,0,0
20200212,72853P,穩懋元大96售09,1.16,1.16,1.00,1.00,-0.19,-15.97,95000,10,103500,0,0,0,0,0,0,5000,90000,-85000,-85000
20200212,72854P,勝麗國票97售02,0.77,0.77,0.77,0.77,-0.07,-8.33,10000,1,7700,0,0,0,0,0,0,10000,0,10000,10000
20200212,72855P,精測元大96售06,1.56,1.56,1.51,1.52,-0.07,-4.4,66000,11,100880,0,0,0,0,0,0,0,66000,-66000,-66000
20200212,72856P,閎康統一96售01,,,,,,0.00,0,0,0,0,0,0,0,0,0,0,0,0,0
20200212,72857P,聯亞凱基96售02,,,,,,0.00,0,0,0,0,0,0,0,0,0,0,0,0,0
20200212,72858P,直得永豐96售02,,,,,,0.00,0,0,0,0,0,0,0,0,0,0,0,0,0
20200212,72859P,原相永豐96售02,0.31,0.31,0.27,0.29,0.00,0.0,53000,3,15510,0,0,0,0,0,0,13000,40000,-27000,-27000
20200212,72860P,環球晶永豐96售01,0.80,0.80,0.80,0.80,-0.05,-5.88,5000,1,4000,0,0,0,0,0,0,0,5000,-5000,-5000
20200212,72861P,精測群益96售07,1.83,1.83,1.83,1.83,-0.06,-3.17,28000,1,51240,0,0,0,0,0,0,0,28000,-28000,-28000
20200212,72862P,力旺國票96售01,2.14,2.14,2.04,2.04,-0.15,-6.85,50000,6,104600,0,0,0,0,0,0,0,50000,-50000,-50000
20200212,72863P,群聯元大96售05,1.85,1.85,1.79,1.79,-0.11,-5.79,31000,3,57290,0,0,0,0,0,0,1000,30000,-29000,-29000
20200212,72864P,良維永豐96售04,2.51,2.52,2.51,2.52,-0.05,-1.95,22000,2,55320,0,0,0,0,0,0,0,22000,-22000,-22000
20200212,72865P,聯亞國票97售03,,,,,,0.00,0,0,0,0,0,0,0,0,0,0,0,0,0
20200212,72866P,原相台新96售01,0.36,0.38,0.34,0.36,-0.01,-2.7,1131000,30,403060,0,0,0,0,0,0,551000,528000,23000,23000
20200212,72867P,頎邦元富96售03,,,,,,0.00,0,0,0,0,0,0,0,0,0,0,0,0,0
20200212,72868P,頎邦永豐96售01,,,,,,0.00,0,0,0,0,0,0,0,0,0,0,0,0,0
20200212,72869P,頎邦元大96售01,2.32,2.32,2.32,2.32,-0.18,-7.2,4000,1,9280,0,0,0,0,0,0,4000,0,4000,4000
20200212,72870P,頎邦群益97售03,1.61,1.61,1.61,1.61,-0.04,-2.42,10000,1,16100,0,0,0,0,0,0,10000,0,10000,10000
20200212,72871P,鈊象國票97售02,0.43,0.43,0.43,0.43,+0.02,4.88,64000,5,27520,0,0,0,0,0,0,64000,0,64000,64000
20200212,72872P,大江永豐96售04,2.71,2.77,2.71,2.77,+0.02,0.73,20000,3,54580,0,0,0,0,0,0,12000,8000,4000,4000
20200212,72873P,穩懋凱基96售14,,,,,,0.00,0,0,0,0,0,0,0,0,0,0,0,0,0
20200212,72874P,台燿元富96售01,1.71,1.71,1.63,1.63,-0.18,-9.94,20000,4,33300,0,0,0,0,0,0,0,20000,-20000,-20000
20200212,72875P,碩禾台新97售02,0.84,0.85,0.84,0.85,0.00,0.0,153000,2,129950,0,0,0,0,0,0,153000,10000,143000,143000
20200212,72876P,頎邦康和96售02,,,,,,0.00,0,0,0,0,0,0,0,0,0,0,0,0,0
20200212,72877P,環球晶統一96售03,0.88,0.88,0.84,0.84,-0.07,-7.69,195000,41,166910,0,0,0,0,0,0,65000,130000,-65000,-65000
20200212,72878P,穩懋統一96售13,1.11,1.11,1.11,1.11,-0.18,-13.95,30000,1,33300,0,0,0,0,0,0,30000,0,30000,30000
20200212,72879P,環球晶中信96售03,0.88,0.88,0.86,0.86,-0.05,-5.49,76000,5,66160,0,0,0,0,0,0,66000,10000,56000,56000
20200212,72880P,台燿凱基96售04,,,,,,0.00,0,0,0,0,0,0,0,0,0,0,0,0,0
20200212,72881P,穩懋凱基96售15,0.99,0.99,0.87,0.87,-0.18,-17.14,121000,16,108300,0,0,0,0,0,0,13000,108000,-95000,-95000
20200212,72882P,威剛國票96售02,0.62,0.64,0.62,0.62,-0.06,-8.82,141000,5,87440,0,0,0,0,0,0,20000,121000,-101000,-101000
20200212,72883P,雍智國泰97售01,1.52,1.53,1.50,1.53,-0.06,-3.77,125000,16,189850,0,0,0,0,0,0,26000,99000,-73000,-73000
20200212,72884P,中美晶元富97售01,1.24,1.24,1.17,1.20,-0.05,-4.0,127000,17,156000,0,0,0,0,0,0,115000,12000,103000,103000
20200212,72885P,晶焱永豐97售02,,,,,,0.00,0,0,0,0,0,0,0,0,0,0,0,0,0
20200212,72886P,旺矽康和97售01,,,,,,0.00,0,0,0,0,0,0,0,0,0,0,0,0,0
20200212,72887P,威剛康和97售01,,,,,,0.00,0,0,0,0,0,0,0,0,0,0,0,0,0
20200212,72888P,中美晶中信99售01,,,,,,0.00,0,0,0,0,0,0,0,0,0,0,0,0,0
20200212,72889P,合晶永豐97售02,2.11,2.11,2.11,2.11,-0.09,-4.09,10000,1,21100,0,0,0,0,0,0,0,10000,-10000,-10000
20200212,72890P,金居永豐97售01,2.54,2.54,2.54,2.54,-0.25,-8.96,169000,1,429260,0,0,0,0,0,0,169000,0,169000,169000
20200212,72891P,優群永豐97售02,1.18,1.18,1.18,1.18,-0.07,-5.6,37000,2,43660,0,0,0,0,0,0,37000,0,37000,37000
20200212,72892P,精測康和97售01,0.96,0.96,0.96,0.96,-0.02,-2.04,80000,1,76800,0,0,0,0,0,0,0,80000,-80000,-80000
20200212,72893P,櫃200群益97售03,,,,,,0.00,0,0,0,0,0,0,0,0,0,0,0,0,0
20200212,72894P,中美晶凱基97售03,0.69,0.69,0.69,0.69,-0.06,-8.0,1000,1,690,0,0,0,0,0,0,0,1000,-1000,-1000
20200212,72895P,穩懋日盛97售03,1.35,1.36,1.34,1.36,-0.39,-22.29,12000,12,16220,0,0,0,0,0,0,12000,0,12000,12000
20200212,72896P,廣明永豐97售02,,,,,,0.00,0,0,0,0,0,0,0,0,0,0,0,0,0
20200212,72897P,璟德永豐97售01,1.28,1.28,1.28,1.28,-0.02,-1.54,5000,1,6400,0,0,0,0,0,0,5000,0,5000,5000
20200212,72898P,雙鴻國票98售01,1.50,1.50,1.46,1.46,-0.01,-0.68,20000,4,29640,0,0,0,0,0,0,0,20000,-20000,-20000
20200212,72899P,中美晶群益97售02,0.99,0.99,0.95,0.98,-0.06,-5.77,47000,7,45690,0,0,0,0,0,0,12000,35000,-23000,-23000
20200212,72900P,聯亞群益97售01,2.88,2.91,2.88,2.91,-0.12,-3.96,37000,5,106930,0,0,0,0,0,0,0,37000,-37000,-37000
20200212,72901P,穩懋統一97售04,,,,,,0.00,0,0,0,0,0,0,0,0,0,0,0,0,0
20200212,72902P,精測元富97售01,1.58,1.64,1.58,1.64,-0.04,-2.38,60000,4,97120,0,0,0,0,0,0,18000,42000,-24000,-24000
20200212,72903P,中美晶國票97售03,2.08,2.11,1.97,1.97,-0.17,-7.94,36000,4,74190,0,0,0,0,0,0,10000,26000,-16000,-16000
20200212,72904P,大江群益97售03,,,,,,0.00,0,0,0,0,0,0,0,0,0,0,0,0,0
20200212,72905P,穩懋國泰98售01,1.21,1.21,1.08,1.14,-0.19,-14.29,118000,29,133810,0,0,0,0,0,0,48000,70000,-22000,-22000
20200212,72906P,穩懋國泰99售01,1.10,1.10,1.10,1.10,-0.17,-13.39,14000,1,15400,0,0,0,0,0,0,14000,0,14000,14000
20200212,72907P,穩懋兆豐98售01,1.73,1.73,1.61,1.65,-0.21,-11.29,70000,4,116300,0,0,0,0,0,0,20000,50000,-30000,-30000
20200212,72908P,原相永豐97售01,0.50,0.50,0.45,0.48,-0.01,-2.04,726000,20,342720,0,0,0,0,0,0,340000,386000,-46000,-46000
20200212,72909P,穩懋永豐97售01,,,,,,0.00,0,0,0,0,0,0,0,0,0,0,0,0,0
20200212,72910P,穩懋統一99售02,1.48,1.48,1.48,1.48,-0.19,-11.38,27000,1,39960,0,0,0,0,0,0,27000,0,27000,27000
20200212,72911P,穩懋元大97售05,1.83,1.83,1.55,1.55,-0.39,-20.1,56000,14,94720,0,0,0,0,0,0,20000,36000,-16000,-16000
20200212,72912P,原相中信99售02,0.84,0.84,0.79,0.81,-0.02,-2.41,58000,6,46920,0,0,0,0,0,0,49000,9000,40000,40000
20200212,72913P,旺矽統一97售02,1.16,1.16,1.16,1.16,-0.07,-5.69,6000,1,6960,0,0,0,0,0,0,6000,0,6000,6000
20200212,72914P,穩懋元大97售06,,,,,,0.00,0,0,0,0,0,0,0,0,0,0,0,0,0
20200212,72915P,中美晶凱基97售06,1.20,1.20,1.17,1.17,-0.06,-4.88,67000,13,80040,0,0,0,0,0,0,12000,55000,-43000,-43000
20200212,72916P,穩懋凱基97售04,0.90,0.90,0.90,0.90,-0.18,-16.67,1000,1,900,0,0,0,0,0,0,0,1000,-1000,-1000
20200212,72917P,網龍國票98售01,,,,,,0.00,0,0,0,0,0,0,0,0,0,0,0,0,0
20200212,72918P,環球晶元富97售02,1.25,1.25,1.23,1.23,-0.07,-5.38,42000,2,52440,0,0,0,0,0,0,0,42000,-42000,-42000
20200212,72919P,聯亞元富97售02,,,,,,0.00,0,0,0,0,0,0,0,0,0,0,0,0,0
20200212,72920P,雙鴻元富97售02,1.25,1.25,1.21,1.22,-0.07,-5.43,659000,21,805040,0,0,0,0,0,0,46000,659000,-613000,-613000
20200212,72921P,雙鴻元大98售01,1.30,1.30,1.29,1.29,-0.04,-3.01,20000,2,25850,0,0,0,0,0,0,15000,5000,10000,10000
20200212,72922P,原相亞東99售01,0.82,0.82,0.68,0.72,-0.08,-10.0,54000,11,38560,0,0,0,0,0,0,19000,4000,15000,15000
20200212,72923P,台燿永豐97售01,1.01,1.01,1.01,1.01,-0.14,-12.17,2000,1,2020,0,0,0,0,0,0,2000,0,2000,2000
20200212,72924P,精測凱基97售05,1.81,1.81,1.81,1.81,-0.07,-3.72,101000,2,182810,0,0,0,0,0,0,0,101000,-101000,-101000
20200212,72925P,鈊象凱基97售02,0.84,0.90,0.84,0.90,+0.07,8.43,85000,4,74610,0,0,0,0,0,0,34000,51000,-17000,-17000
20200212,72926P,精華元大97售02,3.21,3.21,3.21,3.21,-0.16,-4.75,1000,1,3210,0,0,0,0,0,0,1000,0,1000,1000
20200212,72927P,大江元富97售02,3.16,3.18,3.16,3.18,+0.06,1.92,20000,2,63400,0,0,0,0,0,0,10000,10000,0,0
20200212,72928P,宜鼎元富97售02,0.53,0.57,0.53,0.54,-0.01,-1.82,53000,15,28800,0,0,0,0,0,0,13000,34000,-21000,-21000
20200212,72929P,信驊元富97售02,2.19,2.24,2.19,2.24,-0.02,-0.88,100000,5,222000,0,0,0,0,0,0,20000,80000,-60000,-60000
20200212,72930P,威剛元富97售03,0.89,0.92,0.87,0.90,-0.07,-7.22,107000,22,96390,0,0,0,0,0,0,0,106000,-106000,-106000
20200212,72931P,新普元富97售02,1.67,1.67,1.67,1.67,-0.11,-6.18,10000,1,16700,0,0,0,0,0,0,0,10000,-10000,-10000
20200212,72932P,網家元富97售02,0.86,0.89,0.86,0.89,+0.02,2.3,78000,6,68540,0,0,0,0,0,0,55000,23000,32000,32000
20200212,72933P,碩禾永豐97售01,1.33,1.34,1.33,1.34,-0.02,-1.47,63000,10,84020,0,0,0,0,0,0,63000,0,63000,63000
20200212,72934P,晟德永豐97售01,,,,,,0.00,0,0,0,0,0,0,0,0,0,0,0,0,0
20200212,72935P,鈊象永豐97售03,1.31,1.44,1.31,1.41,+0.05,3.68,893000,21,1241890,0,0,0,0,0,0,570000,473000,97000,97000
20200212,72936P,鈊象元富97售03,1.24,1.38,1.24,1.32,+0.03,2.33,632000,29,852860,0,0,0,0,0,0,115000,509000,-394000,-394000
20200212,72937P,櫃200元大99售01,,,,,,0.00,0,0,0,0,0,0,0,0,0,0,0,0,0
20200212,72938P,櫃200元大99售02,,,,,,0.00,0,0,0,0,0,0,0,0,0,0,0,0,0
20200212,72939P,網龍元大97售02,,,,,,0.00,0,0,0,0,0,0,0,0,0,0,0,0,0
20200212,72940P,環球晶群益97售04,1.52,1.52,1.49,1.49,-0.05,-3.25,134000,4,201160,0,0,0,0,0,0,0,134000,-134000,-134000
20200212,72941P,環球晶統一97售03,1.48,1.48,1.48,1.48,-0.07,-4.52,33000,1,48840,0,0,0,0,0,0,0,33000,-33000,-33000
20200212,72942P,群聯元富97售01,2.37,2.37,2.27,2.30,-0.07,-2.95,65000,22,151260,0,0,0,0,0,0,42000,23000,19000,19000
20200212,72943P,雙鴻元富97售03,2.05,2.05,2.04,2.04,-0.12,-5.56,20000,4,40880,0,0,0,0,0,0,8000,12000,-4000,-4000
20200212,72944P,信昌電元富97售01,2.48,2.48,2.48,2.48,+0.01,0.4,10000,1,24800,0,0,0,0,0,0,10000,0,10000,10000
20200212,72945P,大江永豐97售04,2.49,2.53,2.49,2.50,-0.05,-1.96,56000,4,140090,0,0,0,0,0,0,0,56000,-56000,-56000
20200212,72946P,穩懋富邦99售02,1.18,1.18,1.04,1.07,-0.11,-9.32,389000,8,425230,0,0,0,0,0,0,239000,349000,-110000,-110000
20200212,72947P,環球晶凱基97售08,2.19,2.24,2.19,2.24,-0.10,-4.27,4000,2,8860,0,0,0,0,0,0,2000,2000,0,0
20200212,72948P,大江元大97售06,1.54,1.55,1.52,1.52,-0.02,-1.3,94000,4,145070,0,0,0,0,0,0,3000,91000,-88000,-88000
20200212,72949P,環球晶永豐97售02,1.61,1.61,1.61,1.61,-0.09,-5.29,2000,1,3220,0,0,0,0,0,0,2000,2000,0,0
20200212,72950P,中美晶元富97售02,1.80,1.81,1.80,1.80,-0.07,-3.74,33000,3,59480,0,0,0,0,0,0,8000,25000,-17000,-17000
20200212,72951P,宣德元富97售02,,,,,,0.00,0,0,0,0,0,0,0,0,0,0,0,0,0
20200212,72952P,群聯元富97售02,3.46,3.47,3.38,3.41,-0.09,-2.57,48000,18,165400,0,0,0,0,0,0,14000,34000,-20000,-20000
20200212,72953P,環球晶元富97售05,2.01,2.04,1.98,2.01,-0.10,-4.74,211000,7,423610,0,0,0,0,0,0,14000,197000,-183000,-183000
20200212,72954P,穩懋元富97售05,2.64,2.64,2.64,2.64,-0.30,-10.2,20000,1,52800,0,0,0,0,0,0,20000,0,20000,20000
20200212,72955P,中美晶元大98售02,1.45,1.45,1.39,1.45,-0.08,-5.23,224000,14,323710,0,0,0,0,0,0,114000,221000,-107000,-107000
20200212,72956P,信驊元大98售01,,,,,,0.00,0,0,0,0,0,0,0,0,0,0,0,0,0
20200212,72957P,精測元富98售01,2.13,2.14,2.13,2.13,-0.10,-4.48,51000,3,108860,0,0,0,0,0,0,28000,23000,5000,5000
20200212,72958P,威剛元大98售03,0.85,0.85,0.82,0.83,-0.05,-5.68,824000,12,694910,0,0,0,0,0,0,800000,24000,776000,776000
20200212,72959P,大江永豐98售02,1.28,1.28,1.28,1.28,+0.01,0.79,96000,3,122880,0,0,0,0,0,0,0,96000,-96000,-96000
20200212,72960P,中美晶永豐98售01,1.04,1.04,1.04,1.04,-0.05,-4.59,10000,1,10400,0,0,0,0,0,0,0,10000,-10000,-10000
20200212,72961P,環球晶國泰99售01,1.68,1.68,1.66,1.66,-0.08,-4.6,52000,4,86470,0,0,0,0,0,0,52000,52000,0,0
20200212,72962P,鈊象元富98售01,1.56,1.66,1.56,1.62,+0.02,1.25,631000,28,1033900,0,0,0,0,0,0,58000,573000,-515000,-515000
20200212,72963P,環球晶凱基98售03,,,,,,0.00,0,0,0,0,0,0,0,0,0,0,0,0,0
20200212,72964P,環球晶元大98售05,,,,,,0.00,0,0,0,0,0,0,0,0,0,0,0,0,0
20200212,72965P,環球晶元大98售06,,,,,,0.00,0,0,0,0,0,0,0,0,0,0,0,0,0
20200212,72966P,環球晶元大98售07,,,,,,0.00,0,0,0,0,0,0,0,0,0,0,0,0,0
20200212,72967P,精測國泰9A售02,1.48,1.50,1.48,1.48,-0.03,-1.99,51000,3,75880,0,0,0,0,0,0,11000,40000,-29000,-29000
20200212,72968P,大江元富98售03,2.91,2.91,2.85,2.85,-0.02,-0.7,25000,2,71730,0,0,0,0,0,0,0,25000,-25000,-25000
20200212,72969P,精測元大98售03,3.02,3.02,3.02,3.02,-0.08,-2.58,1000,1,3020,0,0,0,0,0,0,0,1000,-1000,-1000
20200212,72970P,原相永豐98售01,1.07,1.12,1.03,1.07,-0.01,-0.93,301000,12,324550,0,0,0,0,0,0,201000,100000,101000,101000
20200212,72971P,穩懋凱基98售05,1.37,1.37,1.37,1.37,-0.32,-18.93,5000,1,6850,0,0,0,0,0,0,0,5000,-5000,-5000
20200212,72972P,大江元富98售04,,,,,,0.00,0,0,0,0,0,0,0,0,0,0,0,0,0
20200212,72973P,大江富邦9A售03,,,,,,0.00,0,0,0,0,0,0,0,0,0,0,0,0,0
20200212,72974P,精測元大98售04,,,,,,0.00,0,0,0,0,0,0,0,0,0,0,0,0,0
20200212,72975P,緯軟元大9A售01,,,,,,0.00,0,0,0,0,0,0,0,0,0,0,0,0,0
20200212,72976P,環球晶元大98售08,,,,,,0.00,0,0,0,0,0,0,0,0,0,0,0,0,0
20200212,702038,中光電台新97購01,2.40,2.68,2.40,2.68,+0.42,18.58,72000,7,184720,0,0,0,0,0,0,0,72000,-72000,-72000
20200212,702039,群聯台新97購01,12.80,12.80,12.80,12.80,+0.60,4.92,1000,1,12800,0,0,0,0,0,0,1000,0,1000,1000
20200212,702968,金可群益93購01,,,,,,0.00,0,0,0,0,0,0,0,0,0,0,0,0,0
20200212,702972,富喬群益93購01,,,,,,0.00,0,0,0,0,0,0,0,0,0,0,0,0,0
20200212,703274,緯軟國泰93購01,,,,,,0.00,0,0,0,0,0,0,0,0,0,0,0,0,0
20200212,703531,昇達科群益94購01,0.24,0.24,0.24,0.24,+0.02,9.09,3000,1,720,0,0,0,0,0,0,3000,0,3000,3000
20200212,703576,由田群益94購01,,,,,,0.00,0,0,0,0,0,0,0,0,0,0,0,0,0
20200212,703643,原相中信93購01,3.62,3.77,3.51,3.69,-0.30,-7.52,206000,52,748630,0,0,0,0,0,0,206000,0,206000,206000
20200212,703942,台燿統一92購01,0.66,0.76,0.66,0.76,+0.23,43.4,45000,5,32400,0,0,0,0,0,0,15000,30000,-15000,-15000
20200212,704122,中光電元大94購01,0.46,0.57,0.46,0.57,+0.15,35.71,928000,6,440680,0,0,0,0,0,0,70000,858000,-788000,-788000
20200212,704144,穩懋元大93購01,,,,,,0.00,0,0,0,0,0,0,0,0,0,0,0,0,0
20200212,704197,神盾中信92購01,,,,,,0.00,0,0,0,0,0,0,0,0,0,0,0,0,0
20200212,704200,神盾統一92購01,,,,,,0.00,0,0,0,0,0,0,0,0,0,0,0,0,0
20200212,704207,雙鴻元大92購01,,,,,,0.00,0,0,0,0,0,0,0,0,0,0,0,0,0
20200212,704214,神盾國泰92購01,0.05,0.05,0.05,0.05,0.00,0.0,4000,1,200,0,0,0,0,0,0,4000,0,4000,4000
20200212,704221,雙鴻中信92購01,,,,,,0.00,0,0,0,0,0,0,0,0,0,0,0,0,0
20200212,704226,聯亞統一92購01,,,,,,0.00,0,0,0,0,0,0,0,0,0,0,0,0,0
20200212,704248,神盾元大93購01,0.22,0.22,0.22,0.22,+0.01,4.76,15000,1,3300,0,0,0,0,0,0,15000,0,15000,15000
20200212,704251,良維元富92購01,,,,,,0.00,0,0,0,0,0,0,0,0,0,0,0,0,0
20200212,704267,碩禾國泰92購01,,,,,,0.00,0,0,0,0,0,0,0,0,0,0,0,0,0
20200212,704269,環球晶富邦92購03,,,,,,0.00,0,0,0,0,0,0,0,0,0,0,0,0,0
20200212,704274,良維元大92購01,,,,,,0.00,0,0,0,0,0,0,0,0,0,0,0,0,0
20200212,704277,碩禾元大92購01,,,,,,0.00,0,0,0,0,0,0,0,0,0,0,0,0,0
20200212,704278,碩禾元大92購02,0.79,0.79,0.79,0.79,-0.06,-7.06,6000,1,4740,0,0,0,0,0,0,0,6000,-6000,-6000
20200212,704294,昂寶元大92購01,,,,,,0.00,0,0,0,0,0,0,0,0,0,0,0,0,0
20200212,704298,雙鴻元大92購02,,,,,,0.00,0,0,0,0,0,0,0,0,0,0,0,0,0
20200212,704300,穩懋元大92購01,,,,,,0.00,0,0,0,0,0,0,0,0,0,0,0,0,0
20200212,704310,大宇資元大93購01,,,,,,0.00,0,0,0,0,0,0,0,0,0,0,0,0,0
20200212,704312,宣德元大92購01,0.95,0.95,0.95,0.95,-0.23,-19.49,92000,1,87400,0,0,0,0,0,0,92000,0,92000,92000
20200212,704320,環球晶中信92購02,,,,,,0.00,0,0,0,0,0,0,0,0,0,0,0,0,0
20200212,704322,雙鴻凱基93購01,0.33,0.35,0.33,0.34,+0.06,21.43,50000,5,17100,0,0,0,0,0,0,0,50000,-50000,-50000
20200212,704374,晶焱元大92購01,,,,,,0.00,0,0,0,0,0,0,0,0,0,0,0,0,0
20200212,704390,三貝德元大93購01,0.06,0.06,0.06,0.06,+0.02,50.0,30000,1,1800,0,0,0,0,0,0,30000,0,30000,30000
20200212,704391,碩禾元大93購01,1.73,1.73,1.63,1.63,-0.06,-3.55,20000,2,33600,0,0,0,0,0,0,10000,10000,0,0
20200212,704402,中美晶兆豐92購01,2.29,2.46,2.29,2.46,+0.27,12.33,21000,4,49790,0,0,0,0,0,0,21000,10000,11000,11000
20200212,704404,原相兆豐92購01,,,,,,0.00,0,0,0,0,0,0,0,0,0,0,0,0,0
20200212,704428,緯軟元大93購01,0.47,0.47,0.47,0.47,+0.02,4.44,200000,2,94000,0,0,0,0,0,0,200000,0,200000,200000
20200212,704444,原相中信95購01,1.40,1.40,1.40,1.40,+0.01,0.72,5000,1,7000,0,0,0,0,0,0,5000,0,5000,5000
20200212,704460,創惟元大94購01,0.75,0.75,0.73,0.73,-0.01,-1.35,3000,2,2230,0,0,0,0,0,0,0,2000,-2000,-2000
20200212,704484,元太中信95購01,,,,,,0.00,0,0,0,0,0,0,0,0,0,0,0,0,0
20200212,704501,昇達科元大93購01,,,,,,0.00,0,0,0,0,0,0,0,0,0,0,0,0,0
20200212,704509,由田國票93購01,,,,,,0.00,0,0,0,0,0,0,0,0,0,0,0,0,0
20200212,704515,神盾國泰93購01,,,,,,0.00,0,0,0,0,0,0,0,0,0,0,0,0,0
20200212,704518,聯亞元富94購01,0.29,0.30,0.27,0.27,+0.01,3.85,240000,8,68700,0,0,0,0,0,0,120000,120000,0,0
20200212,704521,神盾元大94購01,0.38,0.38,0.37,0.37,+0.02,5.71,59000,2,22030,0,0,0,0,0,0,59000,0,59000,59000
20200212,704522,緯軟元大94購01,0.43,0.43,0.42,0.42,+0.02,5.0,202000,3,86840,0,0,0,0,0,0,200000,2000,198000,198000
20200212,704540,聯亞兆豐93購01,,,,,,0.00,0,0,0,0,0,0,0,0,0,0,0,0,0
20200212,704563,神盾元大93購02,0.08,0.09,0.08,0.09,+0.02,28.57,40000,2,3400,0,0,0,0,0,0,20000,20000,0,0
20200212,704568,雙鴻元大93購01,,,,,,0.00,0,0,0,0,0,0,0,0,0,0,0,0,0
20200212,704572,昂寶富邦93購01,,,,,,0.00,0,0,0,0,0,0,0,0,0,0,0,0,0
20200212,704588,中美晶元大93購01,0.96,1.00,0.93,1.00,+0.08,8.7,52000,4,49100,0,0,0,0,0,0,50000,2000,48000,48000
20200212,704589,由田元大94購01,0.10,0.10,0.10,0.10,0.00,0.0,5000,1,500,0,0,0,0,0,0,0,5000,-5000,-5000
20200212,704594,穩懋元大93購02,,,,,,0.00,0,0,0,0,0,0,0,0,0,0,0,0,0
20200212,704595,穩懋元大93購03,1.68,1.96,1.68,1.96,+0.41,26.45,30000,9,53240,0,0,0,0,0,0,0,30000,-30000,-30000
20200212,704629,大宇資國泰93購01,,,,,,0.00,0,0,0,0,0,0,0,0,0,0,0,0,0
20200212,704631,大江富邦93購01,,,,,,0.00,0,0,0,0,0,0,0,0,0,0,0,0,0
20200212,704632,穩懋富邦93購02,1.84,1.84,1.84,1.84,+0.35,23.49,2000,2,3680,0,0,0,0,0,0,2000,0,2000,2000
20200212,704633,中美晶元大93購02,1.55,1.61,1.55,1.61,+0.16,11.03,5000,2,7930,0,0,0,0,0,0,0,5000,-5000,-5000
20200212,704640,大宇資群益94購01,,,,,,0.00,0,0,0,0,0,0,0,0,0,0,0,0,0
20200212,704645,宣德群益93購01,0.41,0.44,0.39,0.44,-0.04,-8.33,90000,18,36800,0,0,0,0,0,0,90000,0,90000,90000
20200212,704648,中美晶元大93購03,0.61,0.61,0.61,0.61,+0.07,12.96,11000,3,6710,0,0,0,0,0,0,0,11000,-11000,-11000
20200212,704667,波若威群益94購01,0.16,0.16,0.15,0.15,+0.01,7.14,80000,4,12300,0,0,0,0,0,0,50000,30000,20000,20000
20200212,704678,泰博富邦93購01,,,,,,0.00,0,0,0,0,0,0,0,0,0,0,0,0,0
20200212,704685,杰力元大93購01,,,,,,0.00,0,0,0,0,0,0,0,0,0,0,0,0,0
20200212,704687,保瑞元大93購01,1.38,1.40,1.31,1.31,-0.04,-2.96,12000,3,15880,0,0,0,0,0,0,1000,11000,-10000,-10000
20200212,704689,緯軟元大93購02,0.44,0.44,0.43,0.43,+0.02,4.88,200000,2,87000,0,0,0,0,0,0,200000,0,200000,200000
20200212,704697,群聯國泰93購01,0.32,0.36,0.32,0.36,+0.01,2.86,120000,4,39800,0,0,0,0,0,0,120000,0,120000,120000
20200212,704698,環球晶國泰93購01,,,,,,0.00,0,0,0,0,0,0,0,0,0,0,0,0,0
20200212,704699,環球晶國泰93購02,,,,,,0.00,0,0,0,0,0,0,0,0,0,0,0,0,0
20200212,704712,三貝德群益94購01,0.03,0.03,0.03,0.03,+0.01,50.0,10000,1,300,0,0,0,0,0,0,10000,0,10000,10000
20200212,704714,譜瑞富邦93購01,1.49,1.69,1.49,1.67,+0.28,20.14,41000,11,66030,0,0,0,0,0,0,10000,31000,-21000,-21000
20200212,704718,神盾元大94購02,0.35,0.35,0.35,0.35,+0.02,6.06,35000,1,12250,0,0,0,0,0,0,35000,0,35000,35000
20200212,704725,穩懋元大93購04,1.75,2.13,1.75,2.13,+0.45,26.79,23000,8,44670,0,0,0,0,0,0,2000,16000,-14000,-14000
20200212,704732,中美晶統一92購01,,,,,,0.00,0,0,0,0,0,0,0,0,0,0,0,0,0
20200212,704736,保瑞國泰92購01,,,,,,0.00,0,0,0,0,0,0,0,0,0,0,0,0,0
20200212,704737,群聯富邦92購01,,,,,,0.00,0,0,0,0,0,0,0,0,0,0,0,0,0
20200212,704738,群聯兆豐92購01,,,,,,0.00,0,0,0,0,0,0,0,0,0,0,0,0,0
20200212,704739,鈊象兆豐93購01,,,,,,0.00,0,0,0,0,0,0,0,0,0,0,0,0,0
20200212,704751,VHQ群益94購01,0.04,0.04,0.04,0.04,+0.01,33.33,17000,2,680,0,0,0,0,0,0,15000,2000,13000,13000
20200212,704753,VHQ元大93購01,,,,,,0.00,0,0,0,0,0,0,0,0,0,0,0,0,0
20200212,704754,大江元大92購03,,,,,,0.00,0,0,0,0,0,0,0,0,0,0,0,0,0
20200212,704755,大江元大92購04,,,,,,0.00,0,0,0,0,0,0,0,0,0,0,0,0,0
20200212,704756,中美晶元大93購04,,,,,,0.00,0,0,0,0,0,0,0,0,0,0,0,0,0
20200212,704766,群聯中信93購01,0.02,0.02,0.02,0.02,0.00,0.0,20000,1,400,20000,0,20000,0,0,0,0,0,0,20000
20200212,704777,碩禾群益94購01,0.80,0.85,0.77,0.79,0.00,0.0,203000,21,161880,0,0,0,0,0,0,98000,105000,-7000,-7000
20200212,704779,鈊象群益92購01,,,,,,0.00,0,0,0,0,0,0,0,0,0,0,0,0,0
20200212,704782,大江元大92購05,,,,,,0.00,0,0,0,0,0,0,0,0,0,0,0,0,0
20200212,704783,立端元大92購01,,,,,,0.00,0,0,0,0,0,0,0,0,0,0,0,0,0
20200212,704784,合晶元大92購02,,,,,,0.00,0,0,0,0,0,0,0,0,0,0,0,0,0
20200212,704785,昂寶元大92購02,,,,,,0.00,0,0,0,0,0,0,0,0,0,0,0,0,0
20200212,704787,穩懋元大92購08,0.70,0.70,0.70,0.70,+0.13,22.81,2000,1,1400,0,0,0,0,0,0,0,0,0,0
20200212,704789,振曜國泰92購01,,,,,,0.00,0,0,0,0,0,0,0,0,0,0,0,0,0
20200212,704790,華研國泰92購01,,,,,,0.00,0,0,0,0,0,0,0,0,0,0,0,0,0
20200212,704791,鼎翰國泰92購01,,,,,,0.00,0,0,0,0,0,0,0,0,0,0,0,0,0
20200212,704792,鈊象國泰93購01,,,,,,0.00,0,0,0,0,0,0,0,0,0,0,0,0,0
20200212,704794,三貝德元大93購02,,,,,,0.00,0,0,0,0,0,0,0,0,0,0,0,0,0
20200212,704797,信昌電元大92購01,0.41,0.41,0.41,0.41,-0.08,-16.33,1000,1,410,0,0,0,0,0,0,1000,0,1000,1000
20200212,704800,精測元大92購01,,,,,,0.00,0,0,0,0,0,0,0,0,0,0,0,0,0
20200212,704811,聯亞凱基93購01,,,,,,0.00,0,0,0,0,0,0,0,0,0,0,0,0,0
20200212,704812,穩懋凱基93購01,2.82,3.31,2.74,3.31,+0.58,21.25,57000,26,163690,0,0,0,0,0,0,57000,18000,39000,39000
20200212,704813,M31群益93購01,,,,,,0.00,0,0,0,0,0,0,0,0,0,0,0,0,0
20200212,704818,元太凱基93購01,0.10,0.10,0.10,0.10,+0.01,11.11,897000,4,89700,0,0,0,0,0,0,897000,0,897000,897000
20200212,704823,穩懋凱基93購05,2.75,2.97,2.75,2.97,+0.42,16.47,2000,2,5720,0,0,0,0,0,0,2000,0,2000,2000
20200212,704825,六角台新93購01,,,,,,0.00,0,0,0,0,0,0,0,0,0,0,0,0,0
20200212,704826,六角國票92購01,,,,,,0.00,0,0,0,0,0,0,0,0,0,0,0,0,0
20200212,704828,原相國票92購02,,,,,,0.00,0,0,0,0,0,0,0,0,0,0,0,0,0
20200212,704833,宣德元大92購03,,,,,,0.00,0,0,0,0,0,0,0,0,0,0,0,0,0
20200212,704834,環球晶元大92購03,,,,,,0.00,0,0,0,0,0,0,0,0,0,0,0,0,0
20200212,704835,穩懋國泰92購01,,,,,,0.00,0,0,0,0,0,0,0,0,0,0,0,0,0
20200212,704836,穩懋國泰92購02,,,,,,0.00,0,0,0,0,0,0,0,0,0,0,0,0,0
20200212,704852,頎邦元大92購02,,,,,,0.00,0,0,0,0,0,0,0,0,0,0,0,0,0
20200212,704853,由田國票93購02,,,,,,0.00,0,0,0,0,0,0,0,0,0,0,0,0,0
20200212,704856,原相富邦93購01,,,,,,0.00,0,0,0,0,0,0,0,0,0,0,0,0,0
20200212,704867,大江凱基93購02,,,,,,0.00,0,0,0,0,0,0,0,0,0,0,0,0,0
20200212,704868,大江凱基93購03,,,,,,0.00,0,0,0,0,0,0,0,0,0,0,0,0,0
20200212,704869,大江凱基93購04,,,,,,0.00,0,0,0,0,0,0,0,0,0,0,0,0,0
20200212,704873,穩懋凱基93購07,1.90,1.90,1.90,1.90,+0.04,2.15,1000,1,1900,0,0,0,0,0,0,1000,0,1000,1000
20200212,704874,穩懋凱基93購08,3.33,4.06,3.25,3.91,+0.66,20.31,88000,24,301060,0,0,0,0,0,0,80000,9000,71000,71000
20200212,704875,穩懋中信95購01,1.26,1.48,1.25,1.44,+0.18,14.29,216000,14,290540,0,0,0,0,0,0,176000,50000,126000,126000
20200212,704878,六角國泰93購01,0.20,0.25,0.20,0.24,+0.06,33.33,160000,11,37950,0,0,0,0,0,0,0,160000,-160000,-160000
20200212,704879,晟德富邦93購01,,,,,,0.00,0,0,0,0,0,0,0,0,0,0,0,0,0
20200212,704880,元太亞東92購01,,,,,,0.00,0,0,0,0,0,0,0,0,0,0,0,0,0
20200212,704885,精測兆豐93購01,,,,,,0.00,0,0,0,0,0,0,0,0,0,0,0,0,0
20200212,704887,頎邦群益92購01,,,,,,0.00,0,0,0,0,0,0,0,0,0,0,0,0,0
20200212,704888,神盾中信94購01,,,,,,0.00,0,0,0,0,0,0,0,0,0,0,0,0,0
20200212,704889,網龍中信92購01,,,,,,0.00,0,0,0,0,0,0,0,0,0,0,0,0,0
20200212,704896,聯亞凱基93購02,,,,,,0.00,0,0,0,0,0,0,0,0,0,0,0,0,0
20200212,704900,頎邦凱基93購01,,,,,,0.00,0,0,0,0,0,0,0,0,0,0,0,0,0
20200212,704901,頎邦凱基93購02,,,,,,0.00,0,0,0,0,0,0,0,0,0,0,0,0,0
20200212,704902,智崴國泰92購01,,,,,,0.00,0,0,0,0,0,0,0,0,0,0,0,0,0
20200212,704903,廣明國泰93購01,,,,,,0.00,0,0,0,0,0,0,0,0,0,0,0,0,0
20200212,704904,晟德國泰92購01,,,,,,0.00,0,0,0,0,0,0,0,0,0,0,0,0,0
20200212,704910,鈺太元大93購01,1.20,1.20,1.20,1.20,+0.03,2.56,20000,2,24000,0,0,0,0,0,0,10000,10000,0,0
20200212,704911,台燿兆豐92購01,1.56,1.56,1.56,1.56,+0.26,20.0,2000,1,3120,0,0,0,0,0,0,2000,0,2000,2000
20200212,704912,宜鼎兆豐93購01,,,,,,0.00,0,0,0,0,0,0,0,0,0,0,0,0,0
20200212,704913,環球晶兆豐92購01,2.49,2.49,2.45,2.45,+0.20,8.89,30000,2,74300,0,0,0,0,0,0,30000,0,30000,30000
20200212,704916,晟德群益92購01,,,,,,0.00,0,0,0,0,0,0,0,0,0,0,0,0,0
20200212,704917,合晶亞東92購01,,,,,,0.00,0,0,0,0,0,0,0,0,0,0,0,0,0
20200212,704918,邦特台新92購01,,,,,,0.00,0,0,0,0,0,0,0,0,0,0,0,0,0
20200212,704921,宏捷科元大92購01,2.93,2.93,2.93,2.93,+0.33,12.69,20000,1,58600,0,0,0,0,0,0,20000,0,20000,20000
20200212,704922,宏捷科元大92購02,2.84,3.09,2.84,3.09,+0.97,45.75,20000,2,59300,0,0,0,0,0,0,0,20000,-20000,-20000
20200212,704923,宏捷科元大92購03,1.53,1.92,1.53,1.76,+0.47,36.43,466000,13,806060,0,0,0,0,0,0,436000,30000,406000,406000
20200212,704924,宏捷科元大93購02,2.86,3.21,2.79,3.00,+0.43,16.73,478000,30,1415030,0,0,0,0,0,0,439000,29000,410000,410000
20200212,704925,原相亞東93購01,,,,,,0.00,0,0,0,0,0,0,0,0,0,0,0,0,0
20200212,704929,宏捷科永豐92購01,,,,,,0.00,0,0,0,0,0,0,0,0,0,0,0,0,0
20200212,704930,宏捷科永豐92購02,1.04,1.04,1.04,1.04,+0.23,28.4,20000,1,20800,0,0,0,0,0,0,20000,0,20000,20000
20200212,704933,晟德兆豐93購01,,,,,,0.00,0,0,0,0,0,0,0,0,0,0,0,0,0
20200212,704935,昇達科群益92購01,,,,,,0.00,0,0,0,0,0,0,0,0,0,0,0,0,0
20200212,704938,大江凱基93購05,,,,,,0.00,0,0,0,0,0,0,0,0,0,0,0,0,0
20200212,704940,邦特凱基92購01,,,,,,0.00,0,0,0,0,0,0,0,0,0,0,0,0,0
20200212,704942,宣德凱基92購01,,,,,,0.00,0,0,0,0,0,0,0,0,0,0,0,0,0
20200212,704943,順達凱基92購01,0.72,0.72,0.72,0.72,+0.13,22.03,20000,2,14400,0,0,0,0,0,0,10000,10000,0,0
20200212,704944,新普凱基92購01,2.07,2.07,2.07,2.07,+0.19,10.11,30000,1,62100,0,0,0,0,0,0,30000,0,30000,30000
20200212,704947,聯亞凱基93購03,,,,,,0.00,0,0,0,0,0,0,0,0,0,0,0,0,0
20200212,704948,穩懋凱基93購09,1.28,1.56,1.28,1.56,+0.28,21.88,43000,10,63800,0,0,0,0,0,0,8000,43000,-35000,-35000
20200212,704949,大江凱基93購06,,,,,,0.00,0,0,0,0,0,0,0,0,0,0,0,0,0
20200212,704953,神盾凱基93購01,,,,,,0.00,0,0,0,0,0,0,0,0,0,0,0,0,0
20200212,704955,環球晶凱基93購01,2.20,2.33,2.20,2.33,+0.18,8.37,56000,4,128560,0,0,0,0,0,0,55000,2000,53000,53000
20200212,704956,聯亞凱基93購04,,,,,,0.00,0,0,0,0,0,0,0,0,0,0,0,0,0
20200212,704957,頎邦凱基93購03,,,,,,0.00,0,0,0,0,0,0,0,0,0,0,0,0,0
20200212,704958,台半統一93購01,0.24,0.24,0.24,0.24,-0.02,-7.69,10000,1,2400,0,0,0,0,0,0,10000,0,10000,10000
20200212,704960,M31元大93購01,0.23,0.23,0.23,0.23,0.00,0.0,10000,1,2300,0,0,0,0,0,0,10000,0,10000,10000
20200212,704961,晶焱元大92購02,,,,,,0.00,0,0,0,0,0,0,0,0,0,0,0,0,0
20200212,704965,鈊象元大92購01,,,,,,0.00,0,0,0,0,0,0,0,0,0,0,0,0,0
20200212,704970,合晶國泰93購01,0.16,0.19,0.16,0.19,+0.06,46.15,30000,2,5100,0,0,0,0,0,0,30000,0,30000,30000
20200212,704971,宏捷科國泰92購01,,,,,,0.00,0,0,0,0,0,0,0,0,0,0,0,0,0
20200212,704972,穩懋國泰92購03,1.99,2.01,1.99,2.01,+0.61,43.57,20000,2,40000,0,0,0,0,0,0,20000,0,20000,20000
20200212,704973,穩懋國泰92購04,1.45,1.50,1.45,1.50,+0.38,33.93,55000,2,81750,0,0,0,0,0,0,15000,0,15000,15000
20200212,704974,昂寶群益92購01,,,,,,0.00,0,0,0,0,0,0,0,0,0,0,0,0,0
20200212,704980,穩懋統一93購01,0.86,1.07,0.84,1.07,+0.25,30.49,702000,19,653680,0,0,0,0,0,0,277000,425000,-148000,-148000
20200212,704982,伍豐凱基93購01,,,,,,0.00,0,0,0,0,0,0,0,0,0,0,0,0,0
20200212,704989,閎康凱基92購01,,,,,,0.00,0,0,0,0,0,0,0,0,0,0,0,0,0
20200212,704990,穩懋凱基93購10,1.47,1.74,1.47,1.74,+0.27,18.37,19000,10,30130,0,0,0,0,0,0,9000,19000,-10000,-10000
20200212,704992,鐿鈦凱基93購01,,,,,,0.00,0,0,0,0,0,0,0,0,0,0,0,0,0
20200212,704993,金可兆豐92購01,,,,,,0.00,0,0,0,0,0,0,0,0,0,0,0,0,0
20200212,704997,大江國泰92購01,,,,,,0.00,0,0,0,0,0,0,0,0,0,0,0,0,0
20200212,704998,中美晶元大92購02,0.71,0.71,0.71,0.71,+0.09,14.52,50000,2,35500,0,0,0,0,0,0,0,50000,-50000,-50000
20200212,704999,神盾元大94購03,0.49,0.52,0.48,0.50,+0.04,8.7,722000,17,364090,0,0,0,0,0,0,601000,119000,482000,482000
20200212,705002,穩懋元大92購09,0.72,0.99,0.72,0.99,+0.27,37.5,93000,3,89460,0,0,0,0,0,0,88000,0,88000,88000
20200212,705009,合晶麥證92購01,,,,,,0.00,0,0,0,0,0,0,0,0,0,0,0,0,0
20200212,705010,穩懋中信95購02,0.99,1.18,0.99,1.14,+0.16,16.33,909000,51,977010,0,0,0,0,0,0,642000,206000,436000,436000
20200212,705011,中美晶統一93購01,1.43,1.43,1.43,1.43,+0.05,3.62,28000,1,40040,0,0,0,0,0,0,28000,0,28000,28000
20200212,705012,穩懋統一93購02,0.67,0.89,0.65,0.86,+0.24,38.71,1210000,41,887540,0,0,0,0,0,0,436000,774000,-338000,-338000
20200212,705015,原相凱基93購01,3.86,4.41,3.76,4.41,+0.39,9.7,241000,44,965010,0,0,0,0,0,0,219000,34000,185000,185000
20200212,705016,智擎凱基93購01,0.01,0.01,0.01,0.01,0.00,0.0,1000,1,10,0,0,0,0,0,0,0,0,0,0
20200212,705017,精華凱基93購01,,,,,,0.00,0,0,0,0,0,0,0,0,0,0,0,0,0
20200212,705018,精華凱基93購02,,,,,,0.00,0,0,0,0,0,0,0,0,0,0,0,0,0
20200212,705020,譜瑞凱基93購02,1.77,2.04,1.77,1.97,+0.22,12.57,51000,11,98020,0,0,0,0,0,0,21000,31000,-10000,-10000
20200212,705022,穩懋亞東93購01,,,,,,0.00,0,0,0,0,0,0,0,0,0,0,0,0,0
20200212,705029,大江元大93購01,,,,,,0.00,0,0,0,0,0,0,0,0,0,0,0,0,0
20200212,705034,晶焱元大93購01,,,,,,0.00,0,0,0,0,0,0,0,0,0,0,0,0,0
20200212,705039,宏捷科國泰93購02,,,,,,0.00,0,0,0,0,0,0,0,0,0,0,0,0,0
20200212,705040,穩懋兆豐93購01,0.39,0.64,0.37,0.64,+0.26,68.42,1350000,31,694650,0,0,0,0,0,0,1190000,0,1190000,1190000
20200212,705042,雙鴻群益93購01,0.85,1.04,0.85,1.00,+0.04,4.17,462000,58,450050,0,0,0,0,0,0,120000,342000,-222000,-222000
20200212,705045,欣銓凱基93購01,,,,,,0.00,0,0,0,0,0,0,0,0,0,0,0,0,0
20200212,705046,雙鴻凱基93購03,0.41,0.51,0.41,0.49,+0.02,4.26,60000,24,27850,0,0,0,0,0,0,30000,30000,0,0
20200212,705053,杰力國泰93購01,0.04,0.05,0.04,0.05,0.00,0.0,13000,3,620,0,0,0,0,0,0,13000,0,13000,13000
20200212,705054,鴻碩國泰93購01,,,,,,0.00,0,0,0,0,0,0,0,0,0,0,0,0,0
20200212,705055,雙鴻國泰93購02,1.61,1.98,1.61,1.98,+0.05,2.59,163000,37,299370,0,0,0,0,0,0,118000,45000,73000,73000
20200212,705056,穩懋富邦93購03,0.34,0.49,0.34,0.45,+0.11,32.35,1246000,31,486970,0,0,0,0,0,0,1001000,225000,776000,776000
20200212,705057,合晶兆豐93購01,,,,,,0.00,0,0,0,0,0,0,0,0,0,0,0,0,0
20200212,705059,宏捷科群益93購01,2.38,2.67,2.31,2.38,+0.26,12.26,729000,34,1765320,0,0,0,0,0,0,559000,170000,389000,389000
20200212,705060,大宇資元大94購01,,,,,,0.00,0,0,0,0,0,0,0,0,0,0,0,0,0
20200212,705061,良維元大93購01,,,,,,0.00,0,0,0,0,0,0,0,0,0,0,0,0,0
20200212,705063,神盾元大93購03,0.45,0.49,0.45,0.49,+0.07,16.67,89000,6,42570,0,0,0,0,0,0,89000,0,89000,89000
20200212,705064,聚積元大93購01,,,,,,0.00,0,0,0,0,0,0,0,0,0,0,0,0,0
20200212,705073,台燿凱基93購01,,,,,,0.00,0,0,0,0,0,0,0,0,0,0,0,0,0
20200212,705080,勝麗元大93購01,0.32,0.32,0.32,0.32,+0.07,28.0,12000,2,3840,0,0,0,0,0,0,2000,10000,-8000,-8000
20200212,705082,雙鴻元大93購02,0.36,0.42,0.36,0.42,+0.03,7.69,40000,3,15300,0,0,0,0,0,0,30000,10000,20000,20000
20200212,705084,六角國票93購01,0.28,0.33,0.28,0.30,+0.05,20.0,113000,4,34500,0,0,0,0,0,0,3000,110000,-107000,-107000
20200212,705085,神盾國票93購01,,,,,,0.00,0,0,0,0,0,0,0,0,0,0,0,0,0
20200212,705086,原相台新93購01,,,,,,0.00,0,0,0,0,0,0,0,0,0,0,0,0,0
20200212,705087,昂寶國泰93購01,,,,,,0.00,0,0,0,0,0,0,0,0,0,0,0,0,0
20200212,705088,保瑞國泰93購01,,,,,,0.00,0,0,0,0,0,0,0,0,0,0,0,0,0
20200212,705089,晶焱富邦93購01,,,,,,0.00,0,0,0,0,0,0,0,0,0,0,0,0,0
20200212,705092,環球晶群益93購01,,,,,,0.00,0,0,0,0,0,0,0,0,0,0,0,0,0
20200212,705097,聚積凱基93購01,0.14,0.14,0.14,0.14,+0.01,7.69,20000,1,2800,0,0,0,0,0,0,20000,0,20000,20000
20200212,705101,神盾台新93購01,0.11,0.11,0.11,0.11,+0.02,22.22,300000,1,33000,0,0,0,0,0,0,300000,0,300000,300000
20200212,705106,碩禾元大93購02,,,,,,0.00,0,0,0,0,0,0,0,0,0,0,0,0,0
20200212,705107,碩禾國泰93購01,,,,,,0.00,0,0,0,0,0,0,0,0,0,0,0,0,0
20200212,705108,雙美國泰93購01,,,,,,0.00,0,0,0,0,0,0,0,0,0,0,0,0,0
20200212,705113,立端兆豐93購01,,,,,,0.00,0,0,0,0,0,0,0,0,0,0,0,0,0
20200212,705114,宣德兆豐93購01,0.83,0.91,0.81,0.88,-0.03,-3.3,489000,40,420440,0,0,0,0,0,0,481000,8000,473000,473000
20200212,705120,台燿凱基93購02,0.38,0.38,0.38,0.38,+0.12,46.15,10000,1,3800,0,0,0,0,0,0,0,10000,-10000,-10000
20200212,705130,六角元大93購01,,,,,,0.00,0,0,0,0,0,0,0,0,0,0,0,0,0
20200212,705131,宣德元大93購01,,,,,,0.00,0,0,0,0,0,0,0,0,0,0,0,0,0
20200212,705134,優群元大93購01,,,,,,0.00,0,0,0,0,0,0,0,0,0,0,0,0,0
20200212,705140,伍豐國泰93購01,,,,,,0.00,0,0,0,0,0,0,0,0,0,0,0,0,0
20200212,705141,雙鴻富邦93購01,0.16,0.20,0.16,0.20,+0.02,11.11,141000,30,25740,0,0,0,0,0,0,41000,100000,-59000,-59000
20200212,705142,中光電兆豐93購01,,,,,,0.00,0,0,0,0,0,0,0,0,0,0,0,0,0
20200212,705144,晶焱兆豐94購01,0.46,0.47,0.46,0.47,+0.09,23.68,215000,9,99850,0,0,0,0,0,0,0,215000,-215000,-215000
20200212,705145,廣明兆豐93購01,,,,,,0.00,0,0,0,0,0,0,0,0,0,0,0,0,0
20200212,705149,神盾群益94購01,0.50,0.53,0.49,0.50,+0.02,4.17,577000,43,295970,0,0,0,0,0,0,552000,23000,529000,529000
20200212,705158,美琪瑪國泰94購01,,,,,,0.00,0,0,0,0,0,0,0,0,0,0,0,0,0
20200212,705163,頎邦元大93購01,0.28,0.28,0.27,0.27,+0.02,8.0,51000,3,14260,0,0,0,0,0,0,2000,49000,-47000,-47000
20200212,705164,原相富邦94購01,,,,,,0.00,0,0,0,0,0,0,0,0,0,0,0,0,0
20200212,705167,晶焱群益93購01,0.35,0.35,0.35,0.35,+0.07,25.0,1000,1,350,0,0,0,0,0,0,1000,0,1000,1000
20200212,705172,環宇凱基93購01,,,,,,0.00,0,0,0,0,0,0,0,0,0,0,0,0,0
20200212,705174,神盾元大95購01,0.58,0.62,0.57,0.59,+0.02,3.51,1334000,41,799450,0,0,0,0,0,0,1092000,507000,585000,585000
20200212,705176,碩禾元大93購03,0.17,0.17,0.17,0.17,0.00,0.0,171000,1,29070,0,0,0,0,0,0,0,171000,-171000,-171000
20200212,705177,精測元大93購01,,,,,,0.00,0,0,0,0,0,0,0,0,0,0,0,0,0
20200212,705178,環球晶元大93購01,1.39,1.39,1.35,1.35,+0.12,9.76,70000,3,96800,0,0,0,0,0,0,0,70000,-70000,-70000
20200212,705181,昇達科國泰94購01,,,,,,0.00,0,0,0,0,0,0,0,0,0,0,0,0,0
20200212,705182,智擎國泰93購01,,,,,,0.00,0,0,0,0,0,0,0,0,0,0,0,0,0
20200212,705184,台燿亞東93購01,,,,,,0.00,0,0,0,0,0,0,0,0,0,0,0,0,0
20200212,705186,雙鴻永豐93購01,0.03,0.03,0.03,0.03,0.00,0.0,20000,1,600,0,0,0,0,0,0,20000,0,20000,20000
20200212,705192,台燿中信93購01,0.70,0.76,0.70,0.76,+0.23,43.4,40000,4,29400,0,0,0,0,0,0,0,40000,-40000,-40000
20200212,705193,譜瑞中信93購01,1.65,1.84,1.63,1.80,+0.30,20.0,144000,15,254480,0,0,0,0,0,0,24000,120000,-96000,-96000
20200212,705196,聯亞富邦93購01,,,,,,0.00,0,0,0,0,0,0,0,0,0,0,0,0,0
20200212,705197,大宇資元大93購02,,,,,,0.00,0,0,0,0,0,0,0,0,0,0,0,0,0
20200212,705198,中美晶元大93購05,0.99,1.05,0.96,0.96,+0.08,9.09,80000,5,79200,0,0,0,0,0,0,20000,60000,-40000,-40000
20200212,705199,直得元大93購01,,,,,,0.00,0,0,0,0,0,0,0,0,0,0,0,0,0
20200212,705202,精測元大93購02,,,,,,0.00,0,0,0,0,0,0,0,0,0,0,0,0,0
20200212,705203,緯軟元大95購01,,,,,,0.00,0,0,0,0,0,0,0,0,0,0,0,0,0
20200212,705205,頎邦元大93購02,0.23,0.23,0.23,0.23,+0.06,35.29,2000,1,460,0,0,0,0,0,0,2000,0,2000,2000
20200212,705209,昂寶亞東93購01,,,,,,0.00,0,0,0,0,0,0,0,0,0,0,0,0,0
20200212,705211,穩懋元大93購06,1.31,1.57,1.31,1.45,+0.26,21.85,28000,6,40220,0,0,0,0,0,0,5000,23000,-18000,-18000
20200212,705215,中美晶凱基93購01,0.60,0.60,0.60,0.60,+0.09,17.65,10000,1,6000,0,0,0,0,0,0,10000,0,10000,10000
20200212,705225,晶焱群益93購02,0.47,0.49,0.47,0.49,+0.09,22.5,51000,6,24670,0,0,0,0,0,0,0,51000,-51000,-51000
20200212,705232,神盾凱基93購02,,,,,,0.00,0,0,0,0,0,0,0,0,0,0,0,0,0
20200212,705238,良維兆豐93購01,,,,,,0.00,0,0,0,0,0,0,0,0,0,0,0,0,0
20200212,705242,元太亞東93購01,,,,,,0.00,0,0,0,0,0,0,0,0,0,0,0,0,0
20200212,705247,立端元大93購01,,,,,,0.00,0,0,0,0,0,0,0,0,0,0,0,0,0
20200212,705250,穩懋元大93購08,1.34,1.54,1.30,1.54,+0.28,22.22,123000,18,170610,0,0,0,0,0,0,108000,24000,84000,84000
20200212,705254,六角富邦93購01,,,,,,0.00,0,0,0,0,0,0,0,0,0,0,0,0,0
20200212,705255,鈊象富邦93購01,,,,,,0.00,0,0,0,0,0,0,0,0,0,0,0,0,0
20200212,705258,穩懋富邦93購04,0.63,0.79,0.60,0.77,+0.18,30.51,415000,21,295810,0,0,0,0,0,0,305000,0,305000,305000
20200212,705263,信昌電凱基93購01,,,,,,0.00,0,0,0,0,0,0,0,0,0,0,0,0,0
20200212,705270,信昌電亞東93購01,,,,,,0.00,0,0,0,0,0,0,0,0,0,0,0,0,0
20200212,705277,穩懋麥證93購01,1.26,1.57,1.23,1.57,+0.30,23.62,263000,36,361880,111000,142000,-31000,0,0,0,111000,142000,-31000,-31000
20200212,705279,VHQ元大93購02,,,,,,0.00,0,0,0,0,0,0,0,0,0,0,0,0,0
20200212,705281,上詮元大93購01,,,,,,0.00,0,0,0,0,0,0,0,0,0,0,0,0,0
20200212,705283,同致元大93購01,0.23,0.23,0.23,0.23,-0.01,-4.17,60000,1,13800,0,0,0,0,0,0,60000,0,60000,60000
20200212,705285,原相元大94購01,3.59,3.76,3.49,3.56,-0.14,-3.78,71000,9,256100,0,0,0,0,0,0,70000,1000,69000,69000
20200212,705287,緯軟元大94購02,,,,,,0.00,0,0,0,0,0,0,0,0,0,0,0,0,0
20200212,705289,穩懋元大93購10,0.77,0.90,0.73,0.90,+0.16,21.62,218000,16,171160,0,0,0,0,0,0,145000,73000,72000,72000
20200212,705296,大江元大93購03,,,,,,0.00,0,0,0,0,0,0,0,0,0,0,0,0,0
20200212,705298,合晶元大93購01,,,,,,0.00,0,0,0,0,0,0,0,0,0,0,0,0,0
20200212,705299,宏觀元大94購01,0.03,0.04,0.03,0.04,+0.01,33.33,281000,2,8440,0,0,0,0,0,0,280000,1000,279000,279000
20200212,705302,宣德元大93購02,1.09,1.10,1.09,1.10,-0.12,-9.84,21000,3,22900,0,0,0,0,0,0,21000,0,21000,21000
20200212,705303,晶焱元大93購02,0.21,0.24,0.21,0.23,+0.03,15.0,676000,12,156210,0,0,0,0,0,0,170000,496000,-326000,-326000
20200212,705306,鈊象元大93購01,1.61,1.61,1.61,1.61,-0.18,-10.06,50000,1,80500,0,0,0,0,0,0,0,50000,-50000,-50000
20200212,705307,鈊象國泰93購02,2.06,2.06,1.83,1.87,-0.25,-11.79,164000,9,328480,0,0,0,0,0,0,100000,64000,36000,36000
20200212,705308,大江群益94購01,0.04,0.04,0.04,0.04,0.00,0.0,10000,1,400,0,0,0,0,0,0,10000,0,10000,10000
20200212,705311,大中凱基93購01,,,,,,0.00,0,0,0,0,0,0,0,0,0,0,0,0,0
20200212,705312,台半凱基93購01,,,,,,0.00,0,0,0,0,0,0,0,0,0,0,0,0,0
20200212,705313,台燿凱基93購05,0.20,0.20,0.20,0.20,0.00,0.0,25000,1,5000,0,0,0,0,0,0,0,0,0,0
20200212,705314,美琪瑪凱基92購02,,,,,,0.00,0,0,0,0,0,0,0,0,0,0,0,0,0
20200212,705315,廣明凱基93購01,,,,,,0.00,0,0,0,0,0,0,0,0,0,0,0,0,0
20200212,705316,M31元大93購02,0.33,0.33,0.32,0.32,+0.02,6.67,30000,2,9700,0,0,0,0,0,0,30000,0,30000,30000
20200212,705317,由田元大93購01,,,,,,0.00,0,0,0,0,0,0,0,0,0,0,0,0,0
20200212,705318,合晶元大92購04,0.39,0.39,0.39,0.39,+0.19,95.0,1000,1,390,0,0,0,0,0,0,1000,0,1000,1000
20200212,705319,金居元大94購01,0.26,0.28,0.26,0.28,+0.04,16.67,65000,5,18100,0,0,0,0,0,0,65000,0,65000,65000
20200212,705320,泰博元大93購01,0.75,0.75,0.75,0.75,+0.04,5.63,10000,2,7500,0,0,0,0,0,0,10000,0,10000,10000
20200212,705321,鈊象元大93購02,1.32,1.34,1.14,1.14,-0.24,-17.39,42000,5,52050,0,0,0,0,0,0,31000,11000,20000,20000
20200212,705322,泰博群益92購01,,,,,,0.00,0,0,0,0,0,0,0,0,0,0,0,0,0
20200212,705323,緯軟國泰93購02,,,,,,0.00,0,0,0,0,0,0,0,0,0,0,0,0,0
20200212,705324,金居永豐92購01,,,,,,0.00,0,0,0,0,0,0,0,0,0,0,0,0,0
20200212,705325,皇田永豐92購01,,,,,,0.00,0,0,0,0,0,0,0,0,0,0,0,0,0
20200212,705326,群聯永豐92購01,,,,,,0.00,0,0,0,0,0,0,0,0,0,0,0,0,0
20200212,705327,鈊象永豐92購02,0.03,0.03,0.01,0.01,-0.06,-85.71,600000,6,12600,0,0,0,0,0,0,600000,0,600000,600000
20200212,705328,大田凱基92購01,,,,,,0.00,0,0,0,0,0,0,0,0,0,0,0,0,0
20200212,705329,大田凱基92購02,,,,,,0.00,0,0,0,0,0,0,0,0,0,0,0,0,0
20200212,705330,中光電凱基92購01,,,,,,0.00,0,0,0,0,0,0,0,0,0,0,0,0,0
20200212,705331,合晶凱基92購02,,,,,,0.00,0,0,0,0,0,0,0,0,0,0,0,0,0
20200212,705332,亞泰凱基92購01,2.96,2.96,2.79,2.86,-0.04,-1.38,101000,9,293760,0,0,0,0,0,0,101000,0,101000,101000
20200212,705333,富喬凱基92購01,,,,,,0.00,0,0,0,0,0,0,0,0,0,0,0,0,0
20200212,705334,鴻碩凱基92購01,,,,,,0.00,0,0,0,0,0,0,0,0,0,0,0,0,0
20200212,705335,上詮元大94購01,,,,,,0.00,0,0,0,0,0,0,0,0,0,0,0,0,0
20200212,705336,聚積元大93購02,,,,,,0.00,0,0,0,0,0,0,0,0,0,0,0,0,0
20200212,705337,鈊象元大92購04,0.60,0.72,0.37,0.41,-0.30,-42.25,426000,9,190090,0,200000,-200000,0,0,0,424000,2000,422000,222000
20200212,705338,頎邦元大93購03,,,,,,0.00,0,0,0,0,0,0,0,0,0,0,0,0,0
20200212,705339,聯亞台新92購01,,,,,,0.00,0,0,0,0,0,0,0,0,0,0,0,0,0
20200212,705340,中美晶亞東93購01,,,,,,0.00,0,0,0,0,0,0,0,0,0,0,0,0,0
20200212,705341,碩禾永豐92購01,,,,,,0.00,0,0,0,0,0,0,0,0,0,0,0,0,0
20200212,705342,直得國票92購01,,,,,,0.00,0,0,0,0,0,0,0,0,0,0,0,0,0
20200212,705343,環球晶國票92購04,,,,,,0.00,0,0,0,0,0,0,0,0,0,0,0,0,0
20200212,705344,原相國泰93購01,,,,,,0.00,0,0,0,0,0,0,0,0,0,0,0,0,0
20200212,705345,精華兆豐93購01,,,,,,0.00,0,0,0,0,0,0,0,0,0,0,0,0,0
20200212,705346,譜瑞兆豐93購01,2.28,2.53,2.28,2.43,+0.26,11.98,117000,7,286570,0,0,0,0,0,0,10000,103000,-93000,-93000
20200212,705347,M31群益92購01,,,,,,0.00,0,0,0,0,0,0,0,0,0,0,0,0,0
20200212,705348,力旺群益93購01,0.49,0.55,0.49,0.55,+0.02,3.77,74000,4,39340,0,0,0,0,0,0,7000,67000,-60000,-60000
20200212,705349,中美晶群益92購02,3.30,3.88,3.30,3.54,+0.22,6.63,77000,9,274240,0,0,0,0,0,0,37000,40000,-3000,-3000
20200212,705350,美琪瑪群益92購01,,,,,,0.00,0,0,0,0,0,0,0,0,0,0,0,0,0
20200212,705351,泰博凱基92購02,,,,,,0.00,0,0,0,0,0,0,0,0,0,0,0,0,0
20200212,705352,穩懋統一92購02,0.45,0.77,0.45,0.72,+0.41,132.26,131000,4,67980,0,0,0,0,0,0,99000,32000,67000,67000
20200212,705353,六角元大93購02,,,,,,0.00,0,0,0,0,0,0,0,0,0,0,0,0,0
20200212,705354,邦特元大92購01,,,,,,0.00,0,0,0,0,0,0,0,0,0,0,0,0,0
20200212,705355,原相元大92購04,,,,,,0.00,0,0,0,0,0,0,0,0,0,0,0,0,0
20200212,705356,神盾元大94購04,0.41,0.42,0.41,0.42,+0.03,7.69,69000,5,28780,0,0,0,0,0,0,69000,0,69000,69000
20200212,705357,環宇元大92購01,0.13,0.13,0.13,0.13,-0.02,-13.33,1000,1,130,0,0,0,0,0,0,1000,0,1000,1000
20200212,705358,穩懋元大92購14,0.73,0.98,0.73,0.85,+0.31,57.41,131000,4,98640,0,0,0,0,0,0,124000,7000,117000,117000
20200212,705359,力旺元富92購01,,,,,,0.00,0,0,0,0,0,0,0,0,0,0,0,0,0
20200212,705360,良維元富92購03,,,,,,0.00,0,0,0,0,0,0,0,0,0,0,0,0,0
20200212,705361,M31日盛92購01,,,,,,0.00,0,0,0,0,0,0,0,0,0,0,0,0,0
20200212,705362,上詮永豐92購01,,,,,,0.00,0,0,0,0,0,0,0,0,0,0,0,0,0
20200212,705363,大田永豐92購01,,,,,,0.00,0,0,0,0,0,0,0,0,0,0,0,0,0
20200212,705364,良維永豐92購01,,,,,,0.00,0,0,0,0,0,0,0,0,0,0,0,0,0
20200212,705365,博智永豐92購01,2.93,3.26,2.93,3.04,+0.36,13.43,27000,12,82350,0,0,0,0,0,0,0,27000,-27000,-27000
20200212,705366,雙美永豐92購01,,,,,,0.00,0,0,0,0,0,0,0,0,0,0,0,0,0
20200212,705367,波若威國票92購01,,,,,,0.00,0,0,0,0,0,0,0,0,0,0,0,0,0
20200212,705368,群聯國票92購01,,,,,,0.00,0,0,0,0,0,0,0,0,0,0,0,0,0
20200212,705369,東隆興康和92購01,,,,,,0.00,0,0,0,0,0,0,0,0,0,0,0,0,0
20200212,705370,聚積康和92購01,0.01,0.01,0.01,0.01,-0.09,-90.0,50000,1,500,0,0,0,0,0,0,50000,0,50000,50000
20200212,705371,應華康和92購01,,,,,,0.00,0,0,0,0,0,0,0,0,0,0,0,0,0
20200212,705372,中美晶群益93購01,2.02,2.02,2.02,2.02,+0.42,26.25,22000,2,44440,0,0,0,0,0,0,0,22000,-22000,-22000
20200212,705373,優群群益94購01,1.03,1.10,1.03,1.10,+0.10,10.0,80000,8,86210,0,0,0,0,0,0,11000,69000,-58000,-58000
20200212,705374,環球晶群益92購02,,,,,,0.00,0,0,0,0,0,0,0,0,0,0,0,0,0
20200212,705375,環球晶統一92購02,,,,,,0.00,0,0,0,0,0,0,0,0,0,0,0,0,0
20200212,705376,力旺凱基93購02,0.73,0.73,0.01,0.72,-0.04,-5.26,86000,4,55570,0,0,0,0,0,0,76000,10000,66000,66000
20200212,705377,台半凱基92購01,,,,,,0.00,0,0,0,0,0,0,0,0,0,0,0,0,0
20200212,705378,直得凱基93購01,,,,,,0.00,0,0,0,0,0,0,0,0,0,0,0,0,0
20200212,705379,信昌電凱基92購01,1.23,1.23,1.23,1.23,-0.10,-7.52,1000,1,1230,0,0,0,0,0,0,1000,0,1000,1000
20200212,705380,保瑞凱基92購01,,,,,,0.00,0,0,0,0,0,0,0,0,0,0,0,0,0
20200212,705381,神盾凱基92購02,,,,,,0.00,0,0,0,0,0,0,0,0,0,0,0,0,0
20200212,705382,群聯凱基92購02,,,,,,0.00,0,0,0,0,0,0,0,0,0,0,0,0,0
20200212,705383,璟德凱基93購01,5.55,5.90,5.55,5.90,+0.40,7.27,18000,4,101400,0,0,0,0,0,0,18000,7000,11000,11000
20200212,705384,環球晶凱基92購04,,,,,,0.00,0,0,0,0,0,0,0,0,0,0,0,0,0
20200212,705385,禾昌永豐92購01,,,,,,0.00,0,0,0,0,0,0,0,0,0,0,0,0,0
20200212,705386,博智永豐92購02,1.82,1.82,1.49,1.49,+0.09,6.43,31000,2,46520,0,0,0,0,0,0,30000,1000,29000,29000
20200212,705387,環球晶永豐92購02,,,,,,0.00,0,0,0,0,0,0,0,0,0,0,0,0,0
20200212,705388,榮剛元大92購01,,,,,,0.00,0,0,0,0,0,0,0,0,0,0,0,0,0
20200212,705389,宏觀元富92購01,,,,,,0.00,0,0,0,0,0,0,0,0,0,0,0,0,0
20200212,705390,聚積兆豐93購01,0.47,0.49,0.47,0.47,+0.04,9.3,50000,4,23900,0,0,0,0,0,0,30000,20000,10000,10000
20200212,705391,M31康和92購01,,,,,,0.00,0,0,0,0,0,0,0,0,0,0,0,0,0
20200212,705392,六角康和92購01,,,,,,0.00,0,0,0,0,0,0,0,0,0,0,0,0,0
20200212,705393,上詮群益92購01,,,,,,0.00,0,0,0,0,0,0,0,0,0,0,0,0,0
20200212,705394,金居群益92購02,,,,,,0.00,0,0,0,0,0,0,0,0,0,0,0,0,0
20200212,705395,良維國票92購01,,,,,,0.00,0,0,0,0,0,0,0,0,0,0,0,0,0
20200212,705396,閎康國票92購02,,,,,,0.00,0,0,0,0,0,0,0,0,0,0,0,0,0
20200212,705397,優群國票92購01,,,,,,0.00,0,0,0,0,0,0,0,0,0,0,0,0,0
20200212,705398,雙美國票92購02,,,,,,0.00,0,0,0,0,0,0,0,0,0,0,0,0,0
20200212,705399,頎邦國票92購02,,,,,,0.00,0,0,0,0,0,0,0,0,0,0,0,0,0
20200212,705400,良維國泰93購01,0.47,0.49,0.47,0.49,+0.05,11.36,46000,4,22080,0,0,0,0,0,0,0,46000,-46000,-46000
20200212,705401,穩懋國泰93購01,1.63,2.05,1.58,2.02,+0.55,37.41,261000,31,461360,0,0,0,0,0,0,104000,203000,-99000,-99000
20200212,705402,智擎中信93購01,0.04,0.04,0.04,0.04,+0.02,100.0,3000,2,120,0,0,0,0,0,0,0,3000,-3000,-3000
20200212,705403,宜鼎凱基92購02,,,,,,0.00,0,0,0,0,0,0,0,0,0,0,0,0,0
20200212,705404,昂寶凱基92購02,,,,,,0.00,0,0,0,0,0,0,0,0,0,0,0,0,0
20200212,705405,智擎凱基92購02,,,,,,0.00,0,0,0,0,0,0,0,0,0,0,0,0,0
20200212,705406,精華凱基92購02,,,,,,0.00,0,0,0,0,0,0,0,0,0,0,0,0,0
20200212,705407,廣明凱基92購03,,,,,,0.00,0,0,0,0,0,0,0,0,0,0,0,0,0
20200212,705408,邦特國票92購01,,,,,,0.00,0,0,0,0,0,0,0,0,0,0,0,0,0
20200212,705409,威剛富邦94購01,,,,,,0.00,0,0,0,0,0,0,0,0,0,0,0,0,0
20200212,705410,M31元大93購03,,,,,,0.00,0,0,0,0,0,0,0,0,0,0,0,0,0
20200212,705411,禾昌元大92購01,,,,,,0.00,0,0,0,0,0,0,0,0,0,0,0,0,0
20200212,705412,良維元大92購03,,,,,,0.00,0,0,0,0,0,0,0,0,0,0,0,0,0
20200212,705413,威剛元大92購01,8.45,8.45,8.45,8.45,+0.50,6.29,10000,1,84500,0,0,0,0,0,0,10000,0,10000,10000
20200212,705414,威剛元大92購03,,,,,,0.00,0,0,0,0,0,0,0,0,0,0,0,0,0
20200212,705415,聯亞元大92購03,0.93,0.93,0.93,0.93,+0.13,16.25,10000,1,9300,0,0,0,0,0,0,10000,0,10000,10000
20200212,705416,六角兆豐93購01,0.20,0.25,0.20,0.21,+0.03,16.67,70000,7,16000,0,0,0,0,0,0,0,70000,-70000,-70000
20200212,705417,穩懋兆豐92購02,0.89,0.90,0.89,0.90,+0.11,13.92,30000,2,26800,0,0,0,0,0,0,20000,10000,10000,10000
20200212,705418,威剛群益92購01,,,,,,0.00,0,0,0,0,0,0,0,0,0,0,0,0,0
20200212,705419,威剛群益93購01,9.35,9.50,9.35,9.50,+1.00,11.76,29000,2,274000,0,0,0,0,0,0,19000,10000,9000,9000
20200212,705420,新普群益94購01,,,,,,0.00,0,0,0,0,0,0,0,0,0,0,0,0,0
20200212,705421,由田元富92購01,,,,,,0.00,0,0,0,0,0,0,0,0,0,0,0,0,0
20200212,705422,晟德台新92購01,,,,,,0.00,0,0,0,0,0,0,0,0,0,0,0,0,0
20200212,705423,信昌電永豐92購01,0.75,0.75,0.75,0.75,-0.03,-3.85,76000,1,57000,0,0,0,0,0,0,76000,0,76000,76000
20200212,705424,威剛永豐92購01,3.83,4.12,3.83,4.12,+0.47,12.88,5000,5,19870,0,0,0,0,0,0,5000,0,5000,5000
20200212,705425,環宇永豐92購01,,,,,,0.00,0,0,0,0,0,0,0,0,0,0,0,0,0
20200212,705426,晟德永豐92購02,,,,,,0.00,0,0,0,0,0,0,0,0,0,0,0,0,0
20200212,705427,威剛統一94購01,,,,,,0.00,0,0,0,0,0,0,0,0,0,0,0,0,0
20200212,705428,環球晶中信92購03,,,,,,0.00,0,0,0,0,0,0,0,0,0,0,0,0,0
20200212,705429,M31凱基93購01,,,,,,0.00,0,0,0,0,0,0,0,0,0,0,0,0,0
20200212,705430,上詮凱基93購01,,,,,,0.00,0,0,0,0,0,0,0,0,0,0,0,0,0
20200212,705431,禾昌凱基93購01,,,,,,0.00,0,0,0,0,0,0,0,0,0,0,0,0,0
20200212,705432,昂寶凱基92購03,,,,,,0.00,0,0,0,0,0,0,0,0,0,0,0,0,0
20200212,705433,威剛凱基93購01,,,,,,0.00,0,0,0,0,0,0,0,0,0,0,0,0,0
20200212,705434,神盾凱基92購03,,,,,,0.00,0,0,0,0,0,0,0,0,0,0,0,0,0
20200212,705435,網龍凱基92購01,,,,,,0.00,0,0,0,0,0,0,0,0,0,0,0,0,0
20200212,705436,環球晶凱基92購06,,,,,,0.00,0,0,0,0,0,0,0,0,0,0,0,0,0
20200212,705437,穩懋凱基93購12,1.85,2.20,0.34,2.20,+0.42,23.6,145000,12,252400,0,0,0,0,0,0,135000,19000,116000,116000
20200212,705438,中美晶國票92購01,1.81,1.81,1.81,1.81,+0.24,15.29,1000,1,1810,0,0,0,0,0,0,0,1000,-1000,-1000
20200212,705439,合晶國票93購01,0.89,1.22,0.89,1.22,+0.45,58.44,112000,12,114100,0,0,0,0,0,0,0,112000,-112000,-112000
20200212,705440,威剛國票92購01,,,,,,0.00,0,0,0,0,0,0,0,0,0,0,0,0,0
20200212,705441,原相國票94購01,,,,,,0.00,0,0,0,0,0,0,0,0,0,0,0,0,0
20200212,705442,大江國泰93購01,,,,,,0.00,0,0,0,0,0,0,0,0,0,0,0,0,0
20200212,705443,威剛國泰93購01,,,,,,0.00,0,0,0,0,0,0,0,0,0,0,0,0,0
20200212,705444,環球晶富邦94購01,,,,,,0.00,0,0,0,0,0,0,0,0,0,0,0,0,0
20200212,705445,環球晶麥證93購01,3.28,3.28,3.28,3.28,+0.15,4.79,10000,1,32800,10000,0,10000,0,0,0,10000,0,10000,10000
20200212,705446,美琪瑪元富92購01,,,,,,0.00,0,0,0,0,0,0,0,0,0,0,0,0,0
20200212,705447,神盾元富92購01,,,,,,0.00,0,0,0,0,0,0,0,0,0,0,0,0,0
20200212,705448,環球晶元富93購01,,,,,,0.00,0,0,0,0,0,0,0,0,0,0,0,0,0
20200212,705449,穩懋台新92購02,,,,,,0.00,0,0,0,0,0,0,0,0,0,0,0,0,0
20200212,705450,環球晶兆豐93購01,,,,,,0.00,0,0,0,0,0,0,0,0,0,0,0,0,0
20200212,705451,力旺元大92購02,,,,,,0.00,0,0,0,0,0,0,0,0,0,0,0,0,0
20200212,705452,三貝德元大93購03,,,,,,0.00,0,0,0,0,0,0,0,0,0,0,0,0,0
20200212,705453,台燿元大92購03,,,,,,0.00,0,0,0,0,0,0,0,0,0,0,0,0,0
20200212,705454,同致元大92購03,,,,,,0.00,0,0,0,0,0,0,0,0,0,0,0,0,0
20200212,705455,保瑞元大92購01,,,,,,0.00,0,0,0,0,0,0,0,0,0,0,0,0,0
20200212,705456,博智元大92購02,3.64,4.02,3.64,3.76,+0.46,13.94,27000,12,101900,0,0,0,0,0,0,0,27000,-27000,-27000
20200212,705457,群聯元大92購04,0.71,0.71,0.66,0.69,+0.01,1.47,121000,5,83610,0,0,0,0,0,0,66000,55000,11000,11000
20200212,705458,聯亞元大92購04,,,,,,0.00,0,0,0,0,0,0,0,0,0,0,0,0,0
20200212,705459,穩懋元大92購18,1.84,2.40,1.84,2.40,+0.79,49.07,29000,8,60030,0,0,0,0,0,0,0,29000,-29000,-29000
20200212,705460,環宇群益92購01,,,,,,0.00,0,0,0,0,0,0,0,0,0,0,0,0,0
20200212,705461,頎邦群益94購01,0.22,0.22,0.22,0.22,+0.02,10.0,10000,1,2200,0,0,0,0,0,0,10000,0,10000,10000
20200212,705462,環球晶日盛92購01,,,,,,0.00,0,0,0,0,0,0,0,0,0,0,0,0,0
20200212,705463,立端亞東93購01,,,,,,0.00,0,0,0,0,0,0,0,0,0,0,0,0,0
20200212,705464,環球晶亞東93購01,,,,,,0.00,0,0,0,0,0,0,0,0,0,0,0,0,0
20200212,705465,晶焱永豐92購01,,,,,,0.00,0,0,0,0,0,0,0,0,0,0,0,0,0
20200212,705466,榮剛永豐92購01,,,,,,0.00,0,0,0,0,0,0,0,0,0,0,0,0,0
20200212,705467,優群永豐92購02,,,,,,0.00,0,0,0,0,0,0,0,0,0,0,0,0,0
20200212,705468,均豪元大92購01,,,,,,0.00,0,0,0,0,0,0,0,0,0,0,0,0,0
20200212,705469,信驊元大92購01,,,,,,0.00,0,0,0,0,0,0,0,0,0,0,0,0,0
20200212,705470,信驊元大92購02,1.51,1.51,1.51,1.51,+0.01,0.67,5000,1,7550,0,0,0,0,0,0,0,5000,-5000,-5000
20200212,705471,美琪瑪元大92購01,,,,,,0.00,0,0,0,0,0,0,0,0,0,0,0,0,0
20200212,705472,神準元大92購01,,,,,,0.00,0,0,0,0,0,0,0,0,0,0,0,0,0
20200212,705473,新普元大92購03,,,,,,0.00,0,0,0,0,0,0,0,0,0,0,0,0,0
20200212,705474,鐿鈦元大92購01,,,,,,0.00,0,0,0,0,0,0,0,0,0,0,0,0,0
20200212,705475,穩懋麥證93購02,0.91,0.98,0.89,0.98,+0.14,16.67,70000,7,64000,50000,20000,30000,0,0,0,50000,20000,30000,30000
20200212,705476,穩懋元富92購01,0.05,0.09,0.05,0.09,+0.05,125.0,1304000,14,75440,0,0,0,0,0,0,310000,969000,-659000,-659000
20200212,705477,環球晶統一92購03,,,,,,0.00,0,0,0,0,0,0,0,0,0,0,0,0,0
20200212,705478,群聯兆豐93購01,,,,,,0.00,0,0,0,0,0,0,0,0,0,0,0,0,0
20200212,705479,聯亞兆豐93購02,0.93,0.94,0.91,0.91,+0.05,5.81,14000,3,13000,0,0,0,0,0,0,0,14000,-14000,-14000
20200212,705480,建榮康和92購01,0.54,0.54,0.49,0.49,-0.05,-9.26,20000,2,10300,0,0,0,0,0,0,10000,0,10000,10000
20200212,705481,聯亞群益92購01,,,,,,0.00,0,0,0,0,0,0,0,0,0,0,0,0,0
20200212,705482,M31中信93購01,,,,,,0.00,0,0,0,0,0,0,0,0,0,0,0,0,0
20200212,705483,中美晶凱基92購01,3.61,3.61,3.61,3.61,+0.42,13.17,10000,1,36100,0,0,0,0,0,0,0,10000,-10000,-10000
20200212,705484,兆利凱基92購01,1.26,1.26,1.22,1.22,-0.12,-8.96,32000,4,39640,0,0,0,0,0,0,32000,0,32000,32000
20200212,705485,佳邦凱基92購02,,,,,,0.00,0,0,0,0,0,0,0,0,0,0,0,0,0
20200212,705486,旺矽凱基92購01,,,,,,0.00,0,0,0,0,0,0,0,0,0,0,0,0,0
20200212,705487,直得凱基93購02,,,,,,0.00,0,0,0,0,0,0,0,0,0,0,0,0,0
20200212,705488,威剛凱基94購01,,,,,,0.00,0,0,0,0,0,0,0,0,0,0,0,0,0
20200212,705489,美琪瑪凱基92購03,,,,,,0.00,0,0,0,0,0,0,0,0,0,0,0,0,0
20200212,705490,博智凱基93購01,5.55,5.55,5.55,5.55,+0.45,8.82,10000,1,55500,0,0,0,0,0,0,10000,0,10000,10000
20200212,705491,泰博日盛92購01,,,,,,0.00,0,0,0,0,0,0,0,0,0,0,0,0,0
20200212,705492,群聯亞東94購01,,,,,,0.00,0,0,0,0,0,0,0,0,0,0,0,0,0
20200212,705493,聯亞第一92購01,,,,,,0.00,0,0,0,0,0,0,0,0,0,0,0,0,0
20200212,705494,合晶永豐92購02,0.11,0.11,0.11,0.11,+0.01,10.0,20000,1,2200,0,0,0,0,0,0,20000,0,20000,20000
20200212,705495,信驊永豐92購01,,,,,,0.00,0,0,0,0,0,0,0,0,0,0,0,0,0
20200212,705496,建榮永豐92購01,0.06,0.06,0.05,0.06,-0.03,-33.33,417000,4,24050,0,0,0,0,0,0,320000,0,320000,320000
20200212,705497,建榮永豐94購01,0.68,0.68,0.66,0.66,-0.03,-4.35,43000,3,28540,0,0,0,0,0,0,43000,0,43000,43000
20200212,705498,群翊永豐92購01,,,,,,0.00,0,0,0,0,0,0,0,0,0,0,0,0,0
20200212,705499,環球晶永豐92購03,,,,,,0.00,0,0,0,0,0,0,0,0,0,0,0,0,0
20200212,705500,聯亞永豐92購01,,,,,,0.00,0,0,0,0,0,0,0,0,0,0,0,0,0
20200212,705501,大宇資國票92購01,,,,,,0.00,0,0,0,0,0,0,0,0,0,0,0,0,0
20200212,705502,宣德國票92購01,,,,,,0.00,0,0,0,0,0,0,0,0,0,0,0,0,0
20200212,705503,保瑞國泰98購01,0.45,0.45,0.45,0.45,+0.01,2.27,30000,1,13500,0,0,0,0,0,0,30000,0,30000,30000
20200212,705504,威剛國泰93購03,,,,,,0.00,0,0,0,0,0,0,0,0,0,0,0,0,0
20200212,705505,博智國泰93購01,,,,,,0.00,0,0,0,0,0,0,0,0,0,0,0,0,0
20200212,705506,台燿統一93購01,0.34,0.35,0.34,0.35,+0.08,29.63,213000,3,73020,0,0,0,0,0,0,0,213000,-213000,-213000
20200212,705507,由田統一94購01,,,,,,0.00,0,0,0,0,0,0,0,0,0,0,0,0,0
20200212,705508,環球晶統一92購04,,,,,,0.00,0,0,0,0,0,0,0,0,0,0,0,0,0
20200212,705509,大江中信92購01,,,,,,0.00,0,0,0,0,0,0,0,0,0,0,0,0,0
20200212,705510,穩懋中信94購02,1.53,1.80,1.52,1.80,+0.36,25.0,39000,6,61840,0,0,0,0,0,0,14000,33000,-19000,-19000
20200212,705511,晟德中信92購01,,,,,,0.00,0,0,0,0,0,0,0,0,0,0,0,0,0
20200212,705512,中美晶凱基92購02,3.13,3.13,3.13,3.13,+0.22,7.56,3000,1,9390,0,0,0,0,0,0,3000,0,3000,3000
20200212,705513,信驊凱基93購01,,,,,,0.00,0,0,0,0,0,0,0,0,0,0,0,0,0
20200212,705514,信驊凱基93購02,,,,,,0.00,0,0,0,0,0,0,0,0,0,0,0,0,0
20200212,705515,環球晶凱基92購07,,,,,,0.00,0,0,0,0,0,0,0,0,0,0,0,0,0
20200212,705516,穩懋凱基93購14,1.38,1.71,1.38,1.71,+0.32,23.02,17000,8,27220,0,0,0,0,0,0,7000,17000,-10000,-10000
20200212,705517,昂寶元富92購01,,,,,,0.00,0,0,0,0,0,0,0,0,0,0,0,0,0
20200212,705518,環球晶元富93購02,,,,,,0.00,0,0,0,0,0,0,0,0,0,0,0,0,0
20200212,705519,鐿鈦國票93購01,,,,,,0.00,0,0,0,0,0,0,0,0,0,0,0,0,0
20200212,705520,台燿兆豐92購03,,,,,,0.00,0,0,0,0,0,0,0,0,0,0,0,0,0
20200212,705521,信驊群益92購01,,,,,,0.00,0,0,0,0,0,0,0,0,0,0,0,0,0
20200212,705522,原相群益92購02,,,,,,0.00,0,0,0,0,0,0,0,0,0,0,0,0,0
20200212,705523,威剛國泰94購01,,,,,,0.00,0,0,0,0,0,0,0,0,0,0,0,0,0
20200212,705524,中美晶富邦93購01,1.50,1.68,1.50,1.68,+0.24,16.67,62000,7,101140,0,0,0,0,0,0,9000,53000,-44000,-44000
20200212,705525,昇達科富邦94購01,,,,,,0.00,0,0,0,0,0,0,0,0,0,0,0,0,0
20200212,705526,神盾富邦93購01,0.10,0.10,0.10,0.10,+0.02,25.0,55000,2,5500,0,0,0,0,0,0,55000,0,55000,55000
20200212,705527,禾昌元大92購02,,,,,,0.00,0,0,0,0,0,0,0,0,0,0,0,0,0
20200212,705528,合晶元大92購05,,,,,,0.00,0,0,0,0,0,0,0,0,0,0,0,0,0
20200212,705529,昂寶元大92購03,,,,,,0.00,0,0,0,0,0,0,0,0,0,0,0,0,0
20200212,705530,是方元大92購01,,,,,,0.00,0,0,0,0,0,0,0,0,0,0,0,0,0
20200212,705531,閎康元大92購02,,,,,,0.00,0,0,0,0,0,0,0,0,0,0,0,0,0
20200212,705532,群聯元大92購05,,,,,,0.00,0,0,0,0,0,0,0,0,0,0,0,0,0
20200212,705533,網龍元大92購01,,,,,,0.00,0,0,0,0,0,0,0,0,0,0,0,0,0
20200212,705534,穩懋元大92購19,0.16,0.22,0.16,0.19,+0.07,58.33,922000,10,185540,0,0,0,0,0,0,920000,0,920000,920000
20200212,705535,譜瑞元大92購01,3.08,3.20,3.05,3.20,+0.73,29.55,14000,4,43450,0,0,0,0,0,0,0,14000,-14000,-14000
20200212,705536,廣明日盛92購01,,,,,,0.00,0,0,0,0,0,0,0,0,0,0,0,0,0
20200212,705537,M31永豐92購02,,,,,,0.00,0,0,0,0,0,0,0,0,0,0,0,0,0
20200212,705538,三貝德永豐92購02,,,,,,0.00,0,0,0,0,0,0,0,0,0,0,0,0,0
20200212,705539,上詮永豐92購02,,,,,,0.00,0,0,0,0,0,0,0,0,0,0,0,0,0
20200212,705540,大江永豐92購02,,,,,,0.00,0,0,0,0,0,0,0,0,0,0,0,0,0
20200212,705541,同致永豐92購02,,,,,,0.00,0,0,0,0,0,0,0,0,0,0,0,0,0
20200212,705542,合晶永豐92購03,,,,,,0.00,0,0,0,0,0,0,0,0,0,0,0,0,0
20200212,705543,昂寶永豐92購01,,,,,,0.00,0,0,0,0,0,0,0,0,0,0,0,0,0
20200212,705544,杰力永豐92購01,,,,,,0.00,0,0,0,0,0,0,0,0,0,0,0,0,0
20200212,705545,波若威永豐92購01,,,,,,0.00,0,0,0,0,0,0,0,0,0,0,0,0,0
20200212,705546,是方永豐92購01,,,,,,0.00,0,0,0,0,0,0,0,0,0,0,0,0,0
20200212,705547,泰博永豐92購01,,,,,,0.00,0,0,0,0,0,0,0,0,0,0,0,0,0
20200212,705548,穩懋永豐92購01,0.07,0.07,0.07,0.07,+0.03,75.0,50000,1,3500,0,0,0,0,0,0,50000,0,50000,50000
20200212,705549,神盾麥證93購01,,,,,,0.00,0,0,0,0,0,0,0,0,0,0,0,0,0
20200212,705550,是方台新92購01,,,,,,0.00,0,0,0,0,0,0,0,0,0,0,0,0,0
20200212,705551,神盾日盛92購01,,,,,,0.00,0,0,0,0,0,0,0,0,0,0,0,0,0
20200212,705552,由田永豐92購01,,,,,,0.00,0,0,0,0,0,0,0,0,0,0,0,0,0
20200212,705553,美琪瑪永豐92購01,,,,,,0.00,0,0,0,0,0,0,0,0,0,0,0,0,0
20200212,705554,神盾兆豐93購01,0.09,0.09,0.09,0.09,+0.02,28.57,50000,1,4500,0,0,0,0,0,0,50000,0,50000,50000
20200212,705555,瓦城康和92購01,0.16,0.16,0.16,0.16,-0.02,-11.11,10000,1,1600,0,0,0,0,0,0,10000,0,10000,10000
20200212,705556,神準康和92購01,,,,,,0.00,0,0,0,0,0,0,0,0,0,0,0,0,0
20200212,705557,優群康和92購01,,,,,,0.00,0,0,0,0,0,0,0,0,0,0,0,0,0
20200212,705558,旺矽群益93購01,,,,,,0.00,0,0,0,0,0,0,0,0,0,0,0,0,0
20200212,705559,環球晶群益92購03,,,,,,0.00,0,0,0,0,0,0,0,0,0,0,0,0,0
20200212,705560,力旺元大92購03,,,,,,0.00,0,0,0,0,0,0,0,0,0,0,0,0,0
20200212,705561,三貝德元大92購01,,,,,,0.00,0,0,0,0,0,0,0,0,0,0,0,0,0
20200212,705562,中美晶元大92購04,3.78,4.07,3.78,4.07,+0.45,12.43,14000,4,54790,0,0,0,0,0,0,10000,13000,-3000,-3000
20200212,705563,昂寶元大92購04,,,,,,0.00,0,0,0,0,0,0,0,0,0,0,0,0,0
20200212,705564,美琪瑪元大92購02,,,,,,0.00,0,0,0,0,0,0,0,0,0,0,0,0,0
20200212,705565,原相元大93購01,,,,,,0.00,0,0,0,0,0,0,0,0,0,0,0,0,0
20200212,705566,晶焱元大93購03,0.06,0.07,0.06,0.07,+0.01,16.67,114000,3,7480,0,0,0,0,0,0,114000,0,114000,114000
20200212,705567,群聯元大92購06,,,,,,0.00,0,0,0,0,0,0,0,0,0,0,0,0,0
20200212,705568,精華元大92購03,,,,,,0.00,0,0,0,0,0,0,0,0,0,0,0,0,0
20200212,705569,環球晶元大92購04,7.95,7.95,7.95,7.95,+0.80,11.19,10000,1,79500,0,0,0,0,0,0,0,10000,-10000,-10000
20200212,705570,譜瑞元大92購02,,,,,,0.00,0,0,0,0,0,0,0,0,0,0,0,0,0
20200212,705571,大宇資凱基94購01,,,,,,0.00,0,0,0,0,0,0,0,0,0,0,0,0,0
20200212,705572,中美晶凱基92購03,2.11,2.11,2.11,2.11,+0.46,27.88,50000,5,105500,0,0,0,0,0,0,0,50000,-50000,-50000
20200212,705573,宜鼎凱基93購01,6.70,6.70,6.70,6.70,+0.20,3.08,10000,1,67000,0,0,0,0,0,0,0,10000,-10000,-10000
20200212,705574,是方凱基93購01,,,,,,0.00,0,0,0,0,0,0,0,0,0,0,0,0,0
20200212,705575,神盾凱基92購05,,,,,,0.00,0,0,0,0,0,0,0,0,0,0,0,0,0
20200212,705576,群聯凱基92購03,,,,,,0.00,0,0,0,0,0,0,0,0,0,0,0,0,0
20200212,705577,聚積凱基92購01,,,,,,0.00,0,0,0,0,0,0,0,0,0,0,0,0,0
20200212,705578,群翊國泰93購01,0.27,0.27,0.27,0.27,+0.04,17.39,5000,1,1350,0,0,0,0,0,0,0,5000,-5000,-5000
20200212,705579,大江富邦94購01,0.09,0.10,0.09,0.10,+0.01,11.11,167000,2,15330,0,0,0,0,0,0,0,30000,-30000,-30000
20200212,705580,昂寶富邦95購01,,,,,,0.00,0,0,0,0,0,0,0,0,0,0,0,0,0
20200212,705581,群聯富邦93購01,,,,,,0.00,0,0,0,0,0,0,0,0,0,0,0,0,0
20200212,705582,穩懋永昌92購01,,,,,,0.00,0,0,0,0,0,0,0,0,0,0,0,0,0
20200212,705583,雙鴻中信94購01,0.07,0.08,0.07,0.08,+0.01,14.29,60000,5,4400,0,0,0,0,0,0,30000,20000,10000,10000
20200212,705584,中美晶凱基92購04,2.70,2.88,2.70,2.88,+0.63,28.0,22000,4,60660,0,0,0,0,0,0,2000,22000,-20000,-20000
20200212,705585,神盾國票94購01,0.36,0.39,0.36,0.37,+0.02,5.71,166000,9,61130,0,0,0,0,0,0,166000,0,166000,166000
20200212,705586,泰博國泰93購01,,,,,,0.00,0,0,0,0,0,0,0,0,0,0,0,0,0
20200212,705587,神盾國泰94購01,0.42,0.44,0.41,0.44,+0.06,15.79,136000,14,58770,0,0,0,0,0,0,46000,90000,-44000,-44000
20200212,705588,大江富邦94購02,,,,,,0.00,0,0,0,0,0,0,0,0,0,0,0,0,0
20200212,705589,建榮永豐92購02,,,,,,0.00,0,0,0,0,0,0,0,0,0,0,0,0,0
20200212,705590,神盾永豐93購01,,,,,,0.00,0,0,0,0,0,0,0,0,0,0,0,0,0
20200212,705591,勝麗永豐92購01,1.64,1.83,1.64,1.80,+0.17,10.43,37000,6,62060,0,0,0,0,0,0,37000,0,37000,37000
20200212,705592,晶焱永豐92購02,,,,,,0.00,0,0,0,0,0,0,0,0,0,0,0,0,0
20200212,705593,M31元大92購01,,,,,,0.00,0,0,0,0,0,0,0,0,0,0,0,0,0
20200212,705594,中美晶元大92購05,2.11,2.21,2.11,2.21,+0.26,13.33,6000,3,12960,0,0,0,0,0,0,0,6000,-6000,-6000
20200212,705595,宜鼎元大92購02,7.50,7.60,6.85,6.85,-0.10,-1.44,32000,6,238350,0,0,0,0,0,0,29000,3000,26000,26000
20200212,705596,旺矽元大92購01,,,,,,0.00,0,0,0,0,0,0,0,0,0,0,0,0,0
20200212,705597,雙鴻元大93購03,0.17,0.20,0.17,0.19,0.00,0.0,140000,4,27300,0,0,0,0,0,0,125000,15000,110000,110000
20200212,705598,神準康和92購02,0.03,0.03,0.03,0.03,-0.07,-70.0,30000,1,900,0,0,0,0,0,0,30000,0,30000,30000
20200212,705599,是方群益92購01,,,,,,0.00,0,0,0,0,0,0,0,0,0,0,0,0,0
20200212,705600,中美晶凱基93購02,,,,,,0.00,0,0,0,0,0,0,0,0,0,0,0,0,0
20200212,705601,合晶凱基93購01,0.41,0.46,0.41,0.46,+0.17,58.62,30000,3,13200,0,0,0,0,0,0,0,30000,-30000,-30000
20200212,705602,金居凱基93購01,,,,,,0.00,0,0,0,0,0,0,0,0,0,0,0,0,0
20200212,705603,建榮凱基93購01,,,,,,0.00,0,0,0,0,0,0,0,0,0,0,0,0,0
20200212,705604,群聯凱基93購01,,,,,,0.00,0,0,0,0,0,0,0,0,0,0,0,0,0
20200212,705605,緯軟凱基93購01,,,,,,0.00,0,0,0,0,0,0,0,0,0,0,0,0,0
20200212,705606,環球晶凱基93購02,,,,,,0.00,0,0,0,0,0,0,0,0,0,0,0,0,0
20200212,705607,大江元富93購01,,,,,,0.00,0,0,0,0,0,0,0,0,0,0,0,0,0
20200212,705608,威剛元富95購01,4.47,4.47,4.47,4.47,+0.33,7.97,10000,1,44700,0,0,0,0,0,0,10000,0,10000,10000
20200212,705609,神盾國票94購02,,,,,,0.00,0,0,0,0,0,0,0,0,0,0,0,0,0
20200212,705610,雙鴻國票93購01,0.01,0.01,0.01,0.01,0.00,0.0,50000,1,500,0,0,0,0,0,0,50000,0,50000,50000
20200212,705611,昂寶國泰94購01,,,,,,0.00,0,0,0,0,0,0,0,0,0,0,0,0,0
20200212,705612,網龍國泰94購01,1.14,1.14,1.13,1.13,0.00,0.0,52000,6,59070,0,0,0,0,0,0,50000,21000,29000,29000
20200212,705613,晶焱兆豐93購01,,,,,,0.00,0,0,0,0,0,0,0,0,0,0,0,0,0
20200212,705614,中美晶元大93購06,,,,,,0.00,0,0,0,0,0,0,0,0,0,0,0,0,0
20200212,705615,六角元大93購03,,,,,,0.00,0,0,0,0,0,0,0,0,0,0,0,0,0
20200212,705616,由田元大93購02,,,,,,0.00,0,0,0,0,0,0,0,0,0,0,0,0,0
20200212,705617,良維元大93購02,0.31,0.33,0.31,0.33,+0.02,6.45,220000,3,72300,0,0,0,0,0,0,10000,210000,-200000,-200000
20200212,705618,宜鼎元大93購01,,,,,,0.00,0,0,0,0,0,0,0,0,0,0,0,0,0
20200212,705619,直得元大93購02,,,,,,0.00,0,0,0,0,0,0,0,0,0,0,0,0,0
20200212,705620,金居元大93購01,0.17,0.18,0.17,0.18,+0.02,12.5,60000,3,10600,0,0,0,0,0,0,20000,40000,-20000,-20000
20200212,705621,泰博元大93購02,0.82,0.82,0.82,0.82,+0.05,6.49,10000,1,8200,0,0,0,0,0,0,10000,0,10000,10000
20200212,705622,群聯元大93購01,,,,,,0.00,0,0,0,0,0,0,0,0,0,0,0,0,0
20200212,705623,廣明元大93購01,,,,,,0.00,0,0,0,0,0,0,0,0,0,0,0,0,0
20200212,705624,環球晶元大93購02,,,,,,0.00,0,0,0,0,0,0,0,0,0,0,0,0,0
20200212,705625,譜瑞元大93購01,3.42,3.54,3.34,3.42,+0.60,21.28,7000,6,24190,0,0,0,0,0,0,0,7000,-7000,-7000
20200212,705626,穩懋第一93購01,0.40,0.53,0.40,0.53,+0.15,39.47,453000,18,193760,0,0,0,0,0,0,284000,169000,115000,115000
20200212,705627,宏捷科永豐93購01,3.29,3.33,3.29,3.30,+0.39,13.4,35000,4,115600,0,0,0,0,0,0,0,30000,-30000,-30000
20200212,705628,建榮永豐93購01,0.36,0.36,0.33,0.33,-0.07,-17.5,330000,2,118500,0,0,0,0,0,0,330000,10000,320000,320000
20200212,705629,建榮永豐94購02,,,,,,0.00,0,0,0,0,0,0,0,0,0,0,0,0,0
20200212,705630,網龍永豐93購01,,,,,,0.00,0,0,0,0,0,0,0,0,0,0,0,0,0
20200212,705631,優群永豐93購01,0.94,0.94,0.94,0.94,+0.08,9.3,452000,6,424880,0,0,0,0,0,0,273000,179000,94000,94000
20200212,705632,建榮中信93購01,0.08,0.08,0.07,0.07,-0.03,-30.0,325000,5,25750,0,0,0,0,0,0,325000,0,325000,325000
20200212,705633,大江凱基93購07,,,,,,0.00,0,0,0,0,0,0,0,0,0,0,0,0,0
20200212,705634,杰力凱基93購01,0.05,0.05,0.05,0.05,-0.05,-50.0,47000,2,2350,0,0,0,0,0,0,47000,0,47000,47000
20200212,705635,建榮凱基93購02,,,,,,0.00,0,0,0,0,0,0,0,0,0,0,0,0,0
20200212,705636,譜瑞凱基94購01,3.91,4.18,3.91,4.13,+0.55,15.36,76000,14,307790,0,0,0,0,0,0,33000,65000,-32000,-32000
20200212,705637,大宇資元大93購03,,,,,,0.00,0,0,0,0,0,0,0,0,0,0,0,0,0
20200212,705638,神盾元大93購04,0.07,0.07,0.07,0.07,+0.01,16.67,7000,1,490,0,0,0,0,0,0,7000,0,7000,7000
20200212,705639,環球晶元大93購03,,,,,,0.00,0,0,0,0,0,0,0,0,0,0,0,0,0
20200212,705640,雙鴻元大93購04,,,,,,0.00,0,0,0,0,0,0,0,0,0,0,0,0,0
20200212,705641,中美晶國泰93購01,,,,,,0.00,0,0,0,0,0,0,0,0,0,0,0,0,0
20200212,705642,泰博國泰93購02,,,,,,0.00,0,0,0,0,0,0,0,0,0,0,0,0,0
20200212,705643,環球晶國泰93購03,,,,,,0.00,0,0,0,0,0,0,0,0,0,0,0,0,0
20200212,705644,神盾康和93購01,,,,,,0.00,0,0,0,0,0,0,0,0,0,0,0,0,0
20200212,705645,精華群益93購01,,,,,,0.00,0,0,0,0,0,0,0,0,0,0,0,0,0
20200212,705646,大江永豐93購01,,,,,,0.00,0,0,0,0,0,0,0,0,0,0,0,0,0
20200212,705647,中美晶永豐93購01,,,,,,0.00,0,0,0,0,0,0,0,0,0,0,0,0,0
20200212,705648,旺矽永豐93購01,,,,,,0.00,0,0,0,0,0,0,0,0,0,0,0,0,0
20200212,705649,東隆興永豐93購01,,,,,,0.00,0,0,0,0,0,0,0,0,0,0,0,0,0
20200212,705650,信昌電永豐93購01,,,,,,0.00,0,0,0,0,0,0,0,0,0,0,0,0,0
20200212,705651,緯軟中信93購01,,,,,,0.00,0,0,0,0,0,0,0,0,0,0,0,0,0
20200212,705652,VHQ凱基93購01,,,,,,0.00,0,0,0,0,0,0,0,0,0,0,0,0,0
20200212,705653,大江凱基93購08,,,,,,0.00,0,0,0,0,0,0,0,0,0,0,0,0,0
20200212,705654,中美晶凱基93購03,,,,,,0.00,0,0,0,0,0,0,0,0,0,0,0,0,0
20200212,705655,宜鼎凱基93購02,3.15,3.15,3.15,3.15,+0.41,14.96,4000,1,12600,0,0,0,0,0,0,4000,0,4000,4000
20200212,705656,是方凱基93購02,,,,,,0.00,0,0,0,0,0,0,0,0,0,0,0,0,0
20200212,705657,神盾凱基93購03,,,,,,0.00,0,0,0,0,0,0,0,0,0,0,0,0,0
20200212,705658,勝麗凱基93購01,3.54,3.61,3.54,3.61,+0.10,2.85,30000,7,106440,0,0,0,0,0,0,30000,0,30000,30000
20200212,705659,是方康和93購01,,,,,,0.00,0,0,0,0,0,0,0,0,0,0,0,0,0
20200212,705660,新普康和93購01,,,,,,0.00,0,0,0,0,0,0,0,0,0,0,0,0,0
20200212,705661,大江群益95購01,0.10,0.10,0.10,0.10,-0.01,-9.09,15000,2,1500,0,0,0,0,0,0,0,15000,-15000,-15000
20200212,705662,保瑞群益94購01,0.52,0.52,0.48,0.48,+0.02,4.35,182000,7,89640,0,0,0,0,0,0,1000,181000,-180000,-180000
20200212,705663,環球晶群益94購01,13.00,13.70,13.00,13.70,+1.10,8.73,6000,4,79800,0,0,0,0,0,0,6000,6000,0,0
20200212,705664,原相麥證94購01,7.45,7.90,7.25,7.70,+0.80,11.59,69000,20,514750,50000,19000,31000,0,0,0,50000,19000,31000,31000
20200212,705665,博智元大93購01,,,,,,0.00,0,0,0,0,0,0,0,0,0,0,0,0,0
20200212,705666,環球晶元大93購04,,,,,,0.00,0,0,0,0,0,0,0,0,0,0,0,0,0
20200212,705667,建榮國泰94購01,0.81,0.81,0.79,0.79,-0.02,-2.47,13000,2,10330,0,0,0,0,0,0,13000,10000,3000,3000
20200212,705668,勝麗國泰94購01,,,,,,0.00,0,0,0,0,0,0,0,0,0,0,0,0,0
20200212,705669,鈺太國泰94購01,,,,,,0.00,0,0,0,0,0,0,0,0,0,0,0,0,0
20200212,705670,建榮國票94購01,,,,,,0.00,0,0,0,0,0,0,0,0,0,0,0,0,0
20200212,705671,由田永豐93購01,,,,,,0.00,0,0,0,0,0,0,0,0,0,0,0,0,0
20200212,705672,西柏永豐93購01,,,,,,0.00,0,0,0,0,0,0,0,0,0,0,0,0,0
20200212,705673,昇達科永豐93購01,,,,,,0.00,0,0,0,0,0,0,0,0,0,0,0,0,0
20200212,705674,保瑞永豐93購01,,,,,,0.00,0,0,0,0,0,0,0,0,0,0,0,0,0
20200212,705675,建榮永豐93購02,,,,,,0.00,0,0,0,0,0,0,0,0,0,0,0,0,0
20200212,705676,茂達永豐93購01,,,,,,0.00,0,0,0,0,0,0,0,0,0,0,0,0,0
20200212,705677,優群永豐93購02,,,,,,0.00,0,0,0,0,0,0,0,0,0,0,0,0,0
20200212,705678,穩懋永豐93購01,0.39,0.49,0.39,0.49,+0.15,44.12,175000,6,76500,0,0,0,0,0,0,0,175000,-175000,-175000
20200212,705679,鈺太永豐94購01,0.75,0.84,0.75,0.83,+0.10,13.7,187000,20,152770,0,0,0,0,0,0,27000,187000,-160000,-160000
20200212,705680,櫃200永昌93購01,,,,,,0.00,0,0,0,0,0,0,0,0,0,0,0,0,0
20200212,705681,櫃200永昌93購02,,,,,,0.00,0,0,0,0,0,0,0,0,0,0,0,0,0
20200212,705682,宏觀中信93購01,,,,,,0.00,0,0,0,0,0,0,0,0,0,0,0,0,0
20200212,705683,建榮統一95購01,0.68,0.68,0.62,0.62,-0.03,-4.62,11000,2,6880,0,0,0,0,0,0,11000,10000,1000,1000
20200212,705684,建榮統一96購01,0.65,0.65,0.65,0.65,-0.01,-1.52,10000,1,6500,0,0,0,0,0,0,0,10000,-10000,-10000
20200212,705685,建榮統一96購02,,,,,,0.00,0,0,0,0,0,0,0,0,0,0,0,0,0
20200212,705686,台燿凱基93購06,0.72,0.84,0.72,0.84,+0.22,35.48,21000,3,17320,0,0,0,0,0,0,1000,20000,-19000,-19000
20200212,705687,神盾凱基93購04,,,,,,0.00,0,0,0,0,0,0,0,0,0,0,0,0,0
20200212,705688,新普凱基93購01,,,,,,0.00,0,0,0,0,0,0,0,0,0,0,0,0,0
20200212,705689,中美晶元大93購07,,,,,,0.00,0,0,0,0,0,0,0,0,0,0,0,0,0
20200212,705690,威剛元大94購01,6.35,6.85,6.30,6.55,+0.55,9.17,65000,12,420900,0,0,0,0,0,0,20000,55000,-35000,-35000
20200212,705691,皇田元大93購01,,,,,,0.00,0,0,0,0,0,0,0,0,0,0,0,0,0
20200212,705692,新普元大93購01,3.55,3.85,3.53,3.53,+0.18,5.37,90000,9,330550,0,0,0,0,0,0,50000,30000,20000,20000
20200212,705693,聯亞元大93購01,0.74,0.74,0.74,0.74,+0.03,4.23,91000,1,67340,0,0,0,0,0,0,0,91000,-91000,-91000
20200212,705694,大中國票93購01,,,,,,0.00,0,0,0,0,0,0,0,0,0,0,0,0,0
20200212,705695,建榮國票95購01,,,,,,0.00,0,0,0,0,0,0,0,0,0,0,0,0,0
20200212,705696,鈺太國票95購01,,,,,,0.00,0,0,0,0,0,0,0,0,0,0,0,0,0
20200212,705697,建榮第一93購01,,,,,,0.00,0,0,0,0,0,0,0,0,0,0,0,0,0
20200212,705698,保瑞國泰95購01,0.94,0.94,0.89,0.89,-0.01,-1.11,54000,5,48890,0,0,0,0,0,0,52000,0,52000,52000
20200212,705699,三貝德永豐93購01,,,,,,0.00,0,0,0,0,0,0,0,0,0,0,0,0,0
20200212,705700,建榮永豐93購04,,,,,,0.00,0,0,0,0,0,0,0,0,0,0,0,0,0
20200212,705701,建榮永豐95購01,,,,,,0.00,0,0,0,0,0,0,0,0,0,0,0,0,0
20200212,705702,宣德富邦95購01,0.99,1.07,0.97,1.07,+0.01,0.94,175000,28,174970,0,0,0,0,0,0,175000,0,175000,175000
20200212,705703,智擎元富93購01,,,,,,0.00,0,0,0,0,0,0,0,0,0,0,0,0,0
20200212,705704,建榮康和93購01,,,,,,0.00,0,0,0,0,0,0,0,0,0,0,0,0,0
20200212,705705,三貝德群益93購01,,,,,,0.00,0,0,0,0,0,0,0,0,0,0,0,0,0
20200212,705706,建榮群益94購01,0.50,0.50,0.50,0.50,0.00,0.0,40000,1,20000,0,0,0,0,0,0,40000,0,40000,40000
20200212,705707,博智群益93購01,5.40,5.40,5.40,5.40,+0.15,2.86,10000,1,54000,0,0,0,0,0,0,10000,0,10000,10000
20200212,705708,智擎群益93購01,,,,,,0.00,0,0,0,0,0,0,0,0,0,0,0,0,0
20200212,705709,兆利元大93購01,2.05,2.07,1.91,2.07,-0.05,-2.36,186000,12,363310,0,0,0,0,0,0,175000,11000,164000,164000
20200212,705710,同致元大94購01,,,,,,0.00,0,0,0,0,0,0,0,0,0,0,0,0,0
20200212,705711,良維元大93購03,0.80,0.92,0.80,0.87,+0.03,3.57,252000,6,213800,0,0,0,0,0,0,200000,52000,148000,148000
20200212,705712,邦特中信94購01,,,,,,0.00,0,0,0,0,0,0,0,0,0,0,0,0,0
20200212,705713,立敦凱基93購01,,,,,,0.00,0,0,0,0,0,0,0,0,0,0,0,0,0
20200212,705714,昇達科凱基93購01,,,,,,0.00,0,0,0,0,0,0,0,0,0,0,0,0,0
20200212,705715,環球晶凱基93購03,,,,,,0.00,0,0,0,0,0,0,0,0,0,0,0,0,0
20200212,705716,元太元富93購01,0.67,0.77,0.67,0.77,+0.09,13.24,56000,11,41170,0,0,0,0,0,0,0,56000,-56000,-56000
20200212,705717,聯亞元富93購01,0.68,0.70,0.68,0.70,+0.11,18.64,20000,2,13800,0,0,0,0,0,0,20000,0,20000,20000
20200212,705718,神盾第一93購01,,,,,,0.00,0,0,0,0,0,0,0,0,0,0,0,0,0
20200212,705719,環球晶永豐93購02,,,,,,0.00,0,0,0,0,0,0,0,0,0,0,0,0,0
20200212,705720,雙鴻永豐94購01,0.16,0.16,0.16,0.16,-0.02,-11.11,30000,3,4800,0,0,0,0,0,0,30000,0,30000,30000
20200212,705721,皇田康和93購01,,,,,,0.00,0,0,0,0,0,0,0,0,0,0,0,0,0
20200212,705722,保瑞群益93購01,,,,,,0.00,0,0,0,0,0,0,0,0,0,0,0,0,0
20200212,705723,皇田群益93購01,,,,,,0.00,0,0,0,0,0,0,0,0,0,0,0,0,0
20200212,705724,緯軟群益93購01,,,,,,0.00,0,0,0,0,0,0,0,0,0,0,0,0,0
20200212,705725,昂寶日盛93購01,,,,,,0.00,0,0,0,0,0,0,0,0,0,0,0,0,0
20200212,705726,榮剛永豐93購01,,,,,,0.00,0,0,0,0,0,0,0,0,0,0,0,0,0
20200212,705727,緯軟兆豐94購01,,,,,,0.00,0,0,0,0,0,0,0,0,0,0,0,0,0
20200212,705728,西柏群益93購01,,,,,,0.00,0,0,0,0,0,0,0,0,0,0,0,0,0
20200212,705729,直得群益93購01,,,,,,0.00,0,0,0,0,0,0,0,0,0,0,0,0,0
20200212,705730,群聯元富96購01,0.95,0.98,0.95,0.96,+0.04,4.35,204000,10,198820,0,0,0,0,0,0,14000,190000,-176000,-176000
20200212,705731,神盾台新93購02,,,,,,0.00,0,0,0,0,0,0,0,0,0,0,0,0,0
20200212,705732,金居凱基93購02,,,,,,0.00,0,0,0,0,0,0,0,0,0,0,0,0,0
20200212,705733,建榮凱基93購03,,,,,,0.00,0,0,0,0,0,0,0,0,0,0,0,0,0
20200212,705734,聯亞凱基93購05,,,,,,0.00,0,0,0,0,0,0,0,0,0,0,0,0,0
20200212,705735,信昌電國泰94購01,1.62,1.62,1.62,1.62,-0.06,-3.57,20000,1,32400,0,0,0,0,0,0,0,20000,-20000,-20000
20200212,705736,建榮國泰95購01,,,,,,0.00,0,0,0,0,0,0,0,0,0,0,0,0,0
20200212,705737,原相元大93購02,,,,,,0.00,0,0,0,0,0,0,0,0,0,0,0,0,0
20200212,705738,環球晶元大93購05,,,,,,0.00,0,0,0,0,0,0,0,0,0,0,0,0,0
20200212,705739,新普中信93購01,2.13,2.29,2.13,2.23,+0.14,6.7,50000,5,111300,0,0,0,0,0,0,30000,20000,10000,10000
20200212,705740,榮剛中信94購01,,,,,,0.00,0,0,0,0,0,0,0,0,0,0,0,0,0
20200212,705741,富喬統一96購01,0.13,0.21,0.13,0.21,+0.08,61.54,212000,15,38020,0,0,0,0,0,0,112000,100000,12000,12000
20200212,705742,穩懋統一94購01,1.37,1.78,1.29,1.75,+0.45,34.62,1321000,69,1902440,0,0,0,0,0,0,971000,583000,388000,388000
20200212,705743,三貝德元大94購01,0.02,0.02,0.02,0.02,0.00,0.0,50000,5,1000,0,0,0,0,0,0,0,50000,-50000,-50000
20200212,705744,宣德元大95購01,1.22,1.29,1.21,1.28,-0.02,-1.54,189000,11,238990,0,0,0,0,0,0,189000,50000,139000,139000
20200212,705745,泰博元大93購03,,,,,,0.00,0,0,0,0,0,0,0,0,0,0,0,0,0
20200212,705746,環球晶元大93購06,,,,,,0.00,0,0,0,0,0,0,0,0,0,0,0,0,0
20200212,705747,新普元富93購01,2.76,2.87,2.73,2.79,+0.37,15.29,60000,6,168400,0,0,0,0,0,0,20000,40000,-20000,-20000
20200212,705748,新普元富93購02,1.31,1.31,1.25,1.25,+0.17,15.74,18000,2,23100,0,0,0,0,0,0,0,18000,-18000,-18000
20200212,705749,金居台新93購01,,,,,,0.00,0,0,0,0,0,0,0,0,0,0,0,0,0
20200212,705750,群聯兆豐94購01,0.61,0.65,0.61,0.64,+0.04,6.67,232000,14,145640,0,0,0,0,0,0,77000,155000,-78000,-78000
20200212,705751,兆利群益93購01,1.17,1.17,1.11,1.15,-0.12,-9.45,68000,17,77150,0,0,0,0,0,0,68000,0,68000,68000
20200212,705752,兆利國票93購01,1.11,1.11,0.99,1.07,-0.20,-15.75,90000,18,96050,0,0,0,0,0,0,90000,0,90000,90000
20200212,705753,皇田國票93購01,,,,,,0.00,0,0,0,0,0,0,0,0,0,0,0,0,0
20200212,705754,環宇國票93購01,0.01,0.01,0.01,0.01,-0.01,-50.0,56000,1,560,0,0,0,0,0,0,56000,0,56000,56000
20200212,705755,譜瑞國票93購01,3.24,3.24,3.24,3.24,+0.58,21.8,10000,1,32400,0,0,0,0,0,0,0,10000,-10000,-10000
20200212,705756,緯軟國泰94購01,,,,,,0.00,0,0,0,0,0,0,0,0,0,0,0,0,0
20200212,705757,禾昌永豐93購01,,,,,,0.00,0,0,0,0,0,0,0,0,0,0,0,0,0
20200212,705758,皇田永豐93購01,,,,,,0.00,0,0,0,0,0,0,0,0,0,0,0,0,0
20200212,705759,神盾永豐93購02,,,,,,0.00,0,0,0,0,0,0,0,0,0,0,0,0,0
20200212,705760,光頡凱基94購01,1.25,1.25,1.25,1.25,-0.15,-10.71,4000,1,5000,0,0,0,0,0,0,4000,0,4000,4000
20200212,705761,皇田凱基93購01,,,,,,0.00,0,0,0,0,0,0,0,0,0,0,0,0,0
20200212,705762,環球晶凱基93購04,,,,,,0.00,0,0,0,0,0,0,0,0,0,0,0,0,0
20200212,705763,穩懋凱基94購01,1.27,1.59,1.27,1.59,+0.32,25.2,48000,17,70390,0,0,0,0,0,0,18000,48000,-30000,-30000
20200212,705764,大江元富93購02,,,,,,0.00,0,0,0,0,0,0,0,0,0,0,0,0,0
20200212,705765,直得國票93購01,,,,,,0.00,0,0,0,0,0,0,0,0,0,0,0,0,0
20200212,705766,金可元大93購01,1.01,1.06,1.01,1.06,+0.01,0.95,100000,2,105500,0,0,0,0,0,0,100000,0,100000,100000
20200212,705767,環球晶元大95購01,,,,,,0.00,0,0,0,0,0,0,0,0,0,0,0,0,0
20200212,705768,VHQ永豐93購01,,,,,,0.00,0,0,0,0,0,0,0,0,0,0,0,0,0
20200212,705769,群翊永豐93購01,,,,,,0.00,0,0,0,0,0,0,0,0,0,0,0,0,0
20200212,705770,旺矽兆豐93購01,,,,,,0.00,0,0,0,0,0,0,0,0,0,0,0,0,0
20200212,705771,宇隆康和93購01,0.19,0.19,0.19,0.19,-0.01,-5.0,890000,11,169100,0,0,0,0,0,0,890000,0,890000,890000
20200212,705772,力旺群益93購03,0.09,0.09,0.09,0.09,-0.01,-10.0,10000,1,900,0,0,0,0,0,0,10000,0,10000,10000
20200212,705773,上詮群益93購01,,,,,,0.00,0,0,0,0,0,0,0,0,0,0,0,0,0
20200212,705774,良維群益93購01,0.06,0.06,0.06,0.06,0.00,0.0,150000,1,9000,0,0,0,0,0,0,150000,0,150000,150000
20200212,705775,宜鼎群益96購01,,,,,,0.00,0,0,0,0,0,0,0,0,0,0,0,0,0
20200212,705776,原相群益96購01,,,,,,0.00,0,0,0,0,0,0,0,0,0,0,0,0,0
20200212,705777,晶焱群益93購03,,,,,,0.00,0,0,0,0,0,0,0,0,0,0,0,0,0
20200212,705778,群聯群益93購01,0.09,0.09,0.09,0.09,+0.06,200.0,1000,1,90,0,0,0,0,0,0,0,0,0,0
20200212,705779,群翊群益93購01,,,,,,0.00,0,0,0,0,0,0,0,0,0,0,0,0,0
20200212,705780,元太中信93購01,,,,,,0.00,0,0,0,0,0,0,0,0,0,0,0,0,0
20200212,705781,群聯統一95購01,0.58,0.58,0.57,0.57,+0.01,1.79,20000,2,11500,0,0,0,0,0,0,10000,10000,0,0
20200212,705782,穩懋統一93購05,0.81,1.05,0.78,1.05,+0.31,41.89,78000,10,63870,0,0,0,0,0,0,78000,0,78000,78000
20200212,705783,穩懋統一93購06,1.28,1.52,1.26,1.52,+0.27,21.6,209000,18,288740,0,0,0,0,0,0,104000,105000,-1000,-1000
20200212,705784,穩懋統一94購02,0.76,1.00,0.75,1.00,+0.24,31.58,876000,28,731680,0,0,0,0,0,0,582000,254000,328000,328000
20200212,705785,昂寶元大93購01,,,,,,0.00,0,0,0,0,0,0,0,0,0,0,0,0,0
20200212,705786,泰博元大93購04,,,,,,0.00,0,0,0,0,0,0,0,0,0,0,0,0,0
20200212,705787,榮剛元大94購01,,,,,,0.00,0,0,0,0,0,0,0,0,0,0,0,0,0
20200212,705788,緯軟元大96購01,0.28,0.28,0.27,0.28,+0.01,3.7,210000,3,57800,0,0,0,0,0,0,200000,10000,190000,190000
20200212,705789,環球晶元大93購07,,,,,,0.00,0,0,0,0,0,0,0,0,0,0,0,0,0
20200212,705790,譜瑞元大93購02,4.43,4.61,4.35,4.43,+0.68,18.13,8000,7,35970,0,0,0,0,0,0,0,8000,-8000,-8000
20200212,705791,大江凱基94購01,0.34,0.34,0.28,0.32,0.00,0.0,1238000,18,406540,0,0,0,0,0,0,863000,365000,498000,498000
20200212,705792,台燿凱基93購07,,,,,,0.00,0,0,0,0,0,0,0,0,0,0,0,0,0
20200212,705793,建榮凱基93購04,,,,,,0.00,0,0,0,0,0,0,0,0,0,0,0,0,0
20200212,705794,皇田凱基93購02,,,,,,0.00,0,0,0,0,0,0,0,0,0,0,0,0,0
20200212,705795,環球晶凱基93購05,,,,,,0.00,0,0,0,0,0,0,0,0,0,0,0,0,0
20200212,705796,環球晶凱基93購06,,,,,,0.00,0,0,0,0,0,0,0,0,0,0,0,0,0
20200212,705797,環球晶凱基93購07,,,,,,0.00,0,0,0,0,0,0,0,0,0,0,0,0,0
20200212,705798,環球晶凱基93購09,,,,,,0.00,0,0,0,0,0,0,0,0,0,0,0,0,0
20200212,705799,聯亞凱基94購01,1.20,1.20,1.20,1.20,+0.11,10.09,103000,1,123600,0,0,0,0,0,0,103000,0,103000,103000
20200212,705800,穩懋凱基94購02,1.07,1.39,1.07,1.39,+0.31,28.7,27000,10,32940,0,0,0,0,0,0,7000,17000,-10000,-10000
20200212,705801,宏捷科國泰94購01,2.61,2.66,2.48,2.48,+0.45,22.17,73000,7,189580,0,0,0,0,0,0,15000,58000,-43000,-43000
20200212,705802,金居富邦95購01,,,,,,0.00,0,0,0,0,0,0,0,0,0,0,0,0,0
20200212,705803,原相富邦97購01,4.78,4.88,4.65,4.82,+0.34,7.59,60000,31,287690,0,0,0,0,0,0,46000,23000,23000,23000
20200212,705804,晶焱富邦95購01,,,,,,0.00,0,0,0,0,0,0,0,0,0,0,0,0,0
20200212,705805,環球晶富邦97購01,3.16,3.27,3.09,3.24,+0.15,4.85,90000,13,286150,0,0,0,0,0,0,74000,19000,55000,55000
20200212,705806,群聯麥證93購01,0.65,0.68,0.63,0.68,+0.06,9.68,40000,4,26300,10000,30000,-20000,0,0,0,10000,30000,-20000,-20000
20200212,705807,金居元富93購01,0.05,0.05,0.05,0.05,+0.01,25.0,105000,1,5250,0,0,0,0,0,0,105000,0,105000,105000
20200212,705808,精華元富93購01,,,,,,0.00,0,0,0,0,0,0,0,0,0,0,0,0,0
20200212,705809,環球晶元富93購03,,,,,,0.00,0,0,0,0,0,0,0,0,0,0,0,0,0
20200212,705810,原相兆豐94購01,,,,,,0.00,0,0,0,0,0,0,0,0,0,0,0,0,0
20200212,705811,晶焱兆豐94購02,0.26,0.26,0.26,0.26,+0.04,18.18,3000,1,780,0,0,0,0,0,0,0,3000,-3000,-3000
20200212,705812,碩禾台新93購01,0.94,0.94,0.94,0.94,-0.04,-4.08,10000,1,9400,0,0,0,0,0,0,10000,0,10000,10000
20200212,705813,環球晶台新93購01,,,,,,0.00,0,0,0,0,0,0,0,0,0,0,0,0,0
20200212,705814,宜鼎康和93購01,,,,,,0.00,0,0,0,0,0,0,0,0,0,0,0,0,0
20200212,705815,旺矽康和93購01,0.28,0.28,0.28,0.28,+0.01,3.7,40000,1,11200,0,0,0,0,0,0,40000,0,40000,40000
20200212,705816,廣明康和93購01,,,,,,0.00,0,0,0,0,0,0,0,0,0,0,0,0,0
20200212,705817,台燿群益93購01,0.25,0.26,0.25,0.26,+0.08,44.44,30000,3,7700,0,0,0,0,0,0,0,30000,-30000,-30000
20200212,705818,同致群益93購01,,,,,,0.00,0,0,0,0,0,0,0,0,0,0,0,0,0
20200212,705819,良維群益93購02,,,,,,0.00,0,0,0,0,0,0,0,0,0,0,0,0,0
20200212,705820,昇達科群益94購02,,,,,,0.00,0,0,0,0,0,0,0,0,0,0,0,0,0
20200212,705821,宣德群益93購03,0.46,0.56,0.43,0.56,-0.05,-8.2,150000,14,77790,0,0,0,0,0,0,140000,10000,130000,130000
20200212,705822,美琪瑪群益93購01,,,,,,0.00,0,0,0,0,0,0,0,0,0,0,0,0,0
20200212,705823,聚積群益93購01,,,,,,0.00,0,0,0,0,0,0,0,0,0,0,0,0,0
20200212,705824,環球晶群益93購02,7.30,7.75,7.30,7.75,+0.80,11.51,39000,5,291900,0,0,0,0,0,0,19000,22000,-3000,-3000
20200212,705825,聯亞群益93購01,,,,,,0.00,0,0,0,0,0,0,0,0,0,0,0,0,0
20200212,705826,立端亞東94購01,,,,,,0.00,0,0,0,0,0,0,0,0,0,0,0,0,0
20200212,705827,群聯第一93購01,,,,,,0.00,0,0,0,0,0,0,0,0,0,0,0,0,0
20200212,705828,大江永豐93購02,,,,,,0.00,0,0,0,0,0,0,0,0,0,0,0,0,0
20200212,705829,信昌電永豐93購02,,,,,,0.00,0,0,0,0,0,0,0,0,0,0,0,0,0
20200212,705830,威剛永豐93購01,2.57,2.96,2.57,2.81,+0.39,16.12,70000,11,190520,0,0,0,0,0,0,25000,10000,15000,15000
20200212,705831,建榮永豐94購03,,,,,,0.00,0,0,0,0,0,0,0,0,0,0,0,0,0
20200212,705832,順達永豐93購01,0.45,0.48,0.45,0.47,+0.10,27.03,39000,5,18310,0,0,0,0,0,0,18000,21000,-3000,-3000
20200212,705833,群聯永豐93購01,,,,,,0.00,0,0,0,0,0,0,0,0,0,0,0,0,0
20200212,705834,僑威永豐93購01,,,,,,0.00,0,0,0,0,0,0,0,0,0,0,0,0,0
20200212,705835,廣明永豐93購01,,,,,,0.00,0,0,0,0,0,0,0,0,0,0,0,0,0
20200212,705836,鐿鈦永豐93購01,,,,,,0.00,0,0,0,0,0,0,0,0,0,0,0,0,0
20200212,705837,穩懋國票93購04,1.77,1.94,1.77,1.94,+0.66,51.56,21000,3,40070,0,0,0,0,0,0,0,21000,-21000,-21000
20200212,705838,上詮凱基94購01,,,,,,0.00,0,0,0,0,0,0,0,0,0,0,0,0,0
20200212,705839,先豐凱基93購01,,,,,,0.00,0,0,0,0,0,0,0,0,0,0,0,0,0
20200212,705840,旺矽凱基93購01,0.36,0.36,0.34,0.34,+0.02,6.25,45000,5,15600,0,0,0,0,0,0,0,45000,-45000,-45000
20200212,705841,皇田凱基93購03,,,,,,0.00,0,0,0,0,0,0,0,0,0,0,0,0,0
20200212,705842,原相凱基93購02,5.85,5.85,5.85,5.85,+0.45,8.33,10000,1,58500,0,0,0,0,0,0,10000,0,10000,10000
20200212,705843,晶焱凱基93購01,,,,,,0.00,0,0,0,0,0,0,0,0,0,0,0,0,0
20200212,705844,群聯凱基93購02,,,,,,0.00,0,0,0,0,0,0,0,0,0,0,0,0,0
20200212,705845,廣明凱基94購01,,,,,,0.00,0,0,0,0,0,0,0,0,0,0,0,0,0
20200212,705846,台燿統一95購01,0.55,0.59,0.55,0.59,+0.12,25.53,597000,16,340630,0,0,0,0,0,0,193000,404000,-211000,-211000
20200212,705847,環球晶統一99購01,5.05,5.20,5.00,5.10,+0.16,3.24,123000,8,622500,0,0,0,0,0,0,110000,13000,97000,97000
20200212,705848,禾昌元富96購01,,,,,,0.00,0,0,0,0,0,0,0,0,0,0,0,0,0
20200212,705849,金居元富93購02,,,,,,0.00,0,0,0,0,0,0,0,0,0,0,0,0,0
20200212,705850,晶焱台新93購01,,,,,,0.00,0,0,0,0,0,0,0,0,0,0,0,0,0
20200212,705851,璟德康和93購01,1.00,1.07,1.00,1.07,-0.05,-4.46,2000,2,2070,0,0,0,0,0,0,2000,0,2000,2000
20200212,705852,M31群益93購02,,,,,,0.00,0,0,0,0,0,0,0,0,0,0,0,0,0
20200212,705853,大江群益93購01,,,,,,0.00,0,0,0,0,0,0,0,0,0,0,0,0,0
20200212,705854,閎康群益93購01,0.34,0.34,0.34,0.34,-0.04,-10.53,4000,1,1360,0,0,0,0,0,0,4000,0,4000,4000
20200212,705855,廣明第一93購01,,,,,,0.00,0,0,0,0,0,0,0,0,0,0,0,0,0
20200212,705856,M31永豐93購01,,,,,,0.00,0,0,0,0,0,0,0,0,0,0,0,0,0
20200212,705857,光頡永豐93購01,0.44,0.44,0.42,0.42,-0.13,-23.64,23000,2,10100,0,0,0,0,0,0,23000,0,23000,23000
20200212,705858,原相永豐93購02,2.29,2.58,2.24,2.38,+0.01,0.42,341000,43,802830,0,0,0,0,0,0,216000,127000,89000,89000
20200212,705859,新普永豐93購01,,,,,,0.00,0,0,0,0,0,0,0,0,0,0,0,0,0
20200212,705860,璟德永豐93購01,0.80,0.92,0.80,0.85,+0.01,1.19,549000,21,471270,0,0,0,0,0,0,269000,280000,-11000,-11000
20200212,705861,環球晶永豐93購03,2.08,2.20,2.05,2.20,+0.16,7.84,92000,8,191890,0,0,0,0,0,0,72000,20000,52000,52000
20200212,705862,M31元大93購04,,,,,,0.00,0,0,0,0,0,0,0,0,0,0,0,0,0
20200212,705863,台燿元大93購01,0.54,0.62,0.54,0.62,+0.16,34.78,64000,4,35450,0,0,0,0,0,0,51000,13000,38000,38000
20200212,705864,是方元大93購01,,,,,,0.00,0,0,0,0,0,0,0,0,0,0,0,0,0
20200212,705865,新普元大93購02,2.02,2.02,2.02,2.02,+0.28,16.09,5000,1,10100,0,0,0,0,0,0,5000,0,5000,5000
20200212,705866,新普元大93購03,,,,,,0.00,0,0,0,0,0,0,0,0,0,0,0,0,0
20200212,705867,廣明元大93購02,,,,,,0.00,0,0,0,0,0,0,0,0,0,0,0,0,0
20200212,705868,璟德元大93購01,4.22,4.22,4.22,4.22,-0.17,-3.87,9000,1,37980,0,0,0,0,0,0,9000,0,9000,9000
20200212,705869,穩懋元大96購01,2.85,3.42,2.76,3.22,+0.44,15.83,868000,123,2589860,0,0,0,0,0,0,736000,547000,189000,189000
20200212,705870,美琪瑪國票93購01,,,,,,0.00,0,0,0,0,0,0,0,0,0,0,0,0,0
20200212,705871,環球晶國票93購01,,,,,,0.00,0,0,0,0,0,0,0,0,0,0,0,0,0
20200212,705872,M31國泰94購01,0.58,0.58,0.57,0.57,+0.02,3.64,50000,2,28700,0,0,0,0,0,0,50000,0,50000,50000
20200212,705873,大江國泰94購01,0.11,0.11,0.10,0.10,0.00,0.0,220000,2,22200,0,0,0,0,0,0,200000,20000,180000,180000
20200212,705874,大江元大93購04,,,,,,0.00,0,0,0,0,0,0,0,0,0,0,0,0,0
20200212,705875,中美晶元大93購08,3.24,3.46,3.24,3.46,+0.29,9.15,7000,4,23640,0,0,0,0,0,0,1000,6000,-5000,-5000
20200212,705876,宏捷科元大94購01,2.00,2.30,1.65,2.00,+0.22,12.36,846000,50,1757750,0,0,0,0,0,0,689000,60000,629000,629000
20200212,705877,旺矽元大94購01,0.77,0.83,0.77,0.78,+0.03,4.0,423000,13,338460,0,0,0,0,0,0,56000,367000,-311000,-311000
20200212,705878,環球晶元大93購08,,,,,,0.00,0,0,0,0,0,0,0,0,0,0,0,0,0
20200212,705879,聯亞元大93購02,,,,,,0.00,0,0,0,0,0,0,0,0,0,0,0,0,0
20200212,705880,鈺太統一93購01,0.31,0.48,0.31,0.45,+0.15,50.0,75000,6,29000,0,0,0,0,0,0,45000,30000,15000,15000
20200212,705881,M31凱基94購01,,,,,,0.00,0,0,0,0,0,0,0,0,0,0,0,0,0
20200212,705882,同致凱基93購01,,,,,,0.00,0,0,0,0,0,0,0,0,0,0,0,0,0
20200212,705883,佳邦凱基93購01,0.43,0.51,0.43,0.51,+0.04,8.51,60000,8,27350,0,0,0,0,0,0,50000,10000,40000,40000
20200212,705884,杰力凱基93購02,,,,,,0.00,0,0,0,0,0,0,0,0,0,0,0,0,0
20200212,705885,原相凱基93購03,4.95,5.40,4.91,5.40,+0.45,9.09,218000,34,1105530,0,0,0,0,0,0,218000,27000,191000,191000
20200212,705886,廣明凱基94購03,,,,,,0.00,0,0,0,0,0,0,0,0,0,0,0,0,0
20200212,705887,環球晶凱基93購11,,,,,,0.00,0,0,0,0,0,0,0,0,0,0,0,0,0
20200212,705888,群聯元富93購01,,,,,,0.00,0,0,0,0,0,0,0,0,0,0,0,0,0
20200212,705889,昇達科兆豐94購01,,,,,,0.00,0,0,0,0,0,0,0,0,0,0,0,0,0
20200212,705890,泰博兆豐93購01,0.31,0.31,0.31,0.31,+0.01,3.33,1000,1,310,0,0,0,0,0,0,1000,0,1000,1000
20200212,705891,璟德台新93購01,,,,,,0.00,0,0,0,0,0,0,0,0,0,0,0,0,0
20200212,705892,宣德康和93購01,0.53,0.53,0.53,0.53,-0.09,-14.52,100000,7,53000,0,0,0,0,0,0,100000,0,100000,100000
20200212,705893,波若威群益93購01,,,,,,0.00,0,0,0,0,0,0,0,0,0,0,0,0,0
20200212,705894,新普群益94購02,2.14,2.23,2.10,2.23,+0.29,14.95,98000,13,210980,0,0,0,0,0,0,37000,74000,-37000,-37000
20200212,705895,群聯日盛93購01,,,,,,0.00,0,0,0,0,0,0,0,0,0,0,0,0,0
20200212,705896,同致第一93購01,,,,,,0.00,0,0,0,0,0,0,0,0,0,0,0,0,0
20200212,705897,佳邦永豐93購01,,,,,,0.00,0,0,0,0,0,0,0,0,0,0,0,0,0
20200212,705898,金居永豐93購01,,,,,,0.00,0,0,0,0,0,0,0,0,0,0,0,0,0
20200212,705899,鈺太永豐93購01,0.49,0.66,0.49,0.61,+0.10,19.61,156000,16,94220,0,0,0,0,0,0,31000,125000,-94000,-94000
20200212,705900,保瑞國票94購01,0.37,0.37,0.37,0.37,0.00,0.0,38000,1,14060,0,0,0,0,0,0,38000,0,38000,38000
20200212,705901,建榮國票95購02,,,,,,0.00,0,0,0,0,0,0,0,0,0,0,0,0,0
20200212,705902,緯軟國票93購01,0.01,0.01,0.01,0.01,-0.01,-50.0,10000,1,100,0,0,0,0,0,0,10000,0,10000,10000
20200212,705903,穩懋國票94購02,2.06,2.63,2.04,2.61,+0.59,29.21,179000,27,390780,0,0,0,0,0,0,113000,66000,47000,47000
20200212,705904,六角富邦97購01,0.57,0.57,0.53,0.53,+0.03,6.0,45000,5,24900,0,0,0,0,0,0,0,45000,-45000,-45000
20200212,705905,昇達科富邦97購01,,,,,,0.00,0,0,0,0,0,0,0,0,0,0,0,0,0
20200212,705906,大江凱基94購02,,,,,,0.00,0,0,0,0,0,0,0,0,0,0,0,0,0
20200212,705907,合晶凱基93購02,0.70,0.70,0.70,0.70,+0.26,59.09,10000,1,7000,0,0,0,0,0,0,0,10000,-10000,-10000
20200212,705908,杰力凱基93購03,,,,,,0.00,0,0,0,0,0,0,0,0,0,0,0,0,0
20200212,705909,群聯凱基93購03,0.13,0.13,0.13,0.13,0.00,0.0,100000,1,13000,0,0,0,0,0,0,100000,0,100000,100000
20200212,705910,廣明凱基94購04,,,,,,0.00,0,0,0,0,0,0,0,0,0,0,0,0,0
20200212,705911,晟德凱基93購01,,,,,,0.00,0,0,0,0,0,0,0,0,0,0,0,0,0
20200212,705912,昇達科國票94購01,,,,,,0.00,0,0,0,0,0,0,0,0,0,0,0,0,0
20200212,705913,勝麗國票93購01,,,,,,0.00,0,0,0,0,0,0,0,0,0,0,0,0,0
20200212,705914,穩懋國票93購05,3.58,3.89,3.58,3.89,+0.61,18.6,5000,3,18520,0,0,0,0,0,0,0,5000,-5000,-5000
20200212,705915,廣明麥證93購01,,,,,,0.00,0,0,0,0,0,0,0,0,0,0,0,0,0
20200212,705916,大江元大93購05,,,,,,0.00,0,0,0,0,0,0,0,0,0,0,0,0,0
20200212,705917,皇田元大93購02,,,,,,0.00,0,0,0,0,0,0,0,0,0,0,0,0,0
20200212,705918,廣明元大93購03,,,,,,0.00,0,0,0,0,0,0,0,0,0,0,0,0,0
20200212,705919,環球晶元大93購09,4.59,4.59,4.59,4.59,+0.42,10.07,10000,1,45900,0,0,0,0,0,0,0,10000,-10000,-10000
20200212,705920,合晶永豐93購01,0.67,0.86,0.67,0.86,+0.27,45.76,187000,10,135480,0,0,0,0,0,0,0,187000,-187000,-187000
20200212,705921,建榮永豐94購04,,,,,,0.00,0,0,0,0,0,0,0,0,0,0,0,0,0
20200212,705922,皇田永豐93購02,,,,,,0.00,0,0,0,0,0,0,0,0,0,0,0,0,0
20200212,705923,精華永豐93購01,,,,,,0.00,0,0,0,0,0,0,0,0,0,0,0,0,0
20200212,705924,大江元富96購01,0.28,0.28,0.28,0.28,+0.01,3.7,1000,1,280,0,0,0,0,0,0,1000,0,1000,1000
20200212,705925,大江台新93購01,,,,,,0.00,0,0,0,0,0,0,0,0,0,0,0,0,0
20200212,705926,六角台新94購01,0.34,0.35,0.34,0.35,+0.09,34.62,90000,2,31050,0,0,0,0,0,0,0,90000,-90000,-90000
20200212,705927,原相台新94購01,14.60,14.60,13.80,13.80,+0.60,4.55,3000,3,42600,0,0,0,0,0,0,3000,0,3000,3000
20200212,705928,皇田康和93購02,,,,,,0.00,0,0,0,0,0,0,0,0,0,0,0,0,0
20200212,705929,金居群益93購01,,,,,,0.00,0,0,0,0,0,0,0,0,0,0,0,0,0
20200212,705930,建榮群益94購02,,,,,,0.00,0,0,0,0,0,0,0,0,0,0,0,0,0
20200212,705931,廣明群益93購01,,,,,,0.00,0,0,0,0,0,0,0,0,0,0,0,0,0
20200212,705932,譜瑞群益93購01,1.91,2.24,1.88,2.24,+0.40,21.74,115000,27,242510,0,0,0,0,0,0,54000,86000,-32000,-32000
20200212,705933,中美晶亞東93購02,,,,,,0.00,0,0,0,0,0,0,0,0,0,0,0,0,0
20200212,705934,大江凱基94購03,0.37,0.37,0.34,0.34,-0.01,-2.86,162000,21,57650,0,0,0,0,0,0,152000,4000,148000,148000
20200212,705935,網龍凱基93購01,0.16,0.16,0.16,0.16,-0.02,-11.11,1000000,3,160000,0,0,0,0,0,0,1000000,0,1000000,1000000
20200212,705936,元太統一93購01,1.04,1.15,1.04,1.12,+0.07,6.67,19000,7,20520,0,0,0,0,0,0,0,19000,-19000,-19000
20200212,705937,中美晶元富95購01,,,,,,0.00,0,0,0,0,0,0,0,0,0,0,0,0,0
20200212,705938,聯亞元富93購02,0.86,0.89,0.80,0.80,+0.03,3.9,30000,5,25200,0,0,0,0,0,0,20000,10000,10000,10000
20200212,705939,良維兆豐94購01,0.51,0.55,0.51,0.52,+0.01,1.96,198000,6,103740,0,0,0,0,0,0,110000,98000,12000,12000
20200212,705940,精華康和93購01,,,,,,0.00,0,0,0,0,0,0,0,0,0,0,0,0,0
20200212,705941,信昌電群益93購01,2.23,2.23,2.19,2.19,-0.27,-10.98,21000,3,46430,0,0,0,0,0,0,21000,0,21000,21000
20200212,705942,泰博群益93購01,,,,,,0.00,0,0,0,0,0,0,0,0,0,0,0,0,0
20200212,705943,神盾群益94購02,,,,,,0.00,0,0,0,0,0,0,0,0,0,0,0,0,0
20200212,705944,台燿元大94購01,1.02,1.13,1.02,1.11,+0.19,20.65,872000,9,980160,0,0,0,0,0,0,796000,76000,720000,720000
20200212,705945,建榮元大93購01,,,,,,0.00,0,0,0,0,0,0,0,0,0,0,0,0,0
20200212,705946,建榮元大93購02,,,,,,0.00,0,0,0,0,0,0,0,0,0,0,0,0,0
20200212,705947,建榮元大94購01,,,,,,0.00,0,0,0,0,0,0,0,0,0,0,0,0,0
20200212,705948,原相元大94購02,7.05,7.45,6.95,7.25,0.00,0.0,94000,14,669800,0,0,0,0,0,0,83000,13000,70000,70000
20200212,705949,群聯元大93購02,0.53,0.53,0.53,0.53,+0.03,6.0,10000,1,5300,0,0,0,0,0,0,10000,0,10000,10000
20200212,705950,環球晶元大93購10,4.03,4.19,4.03,4.19,+0.23,5.81,13000,3,53360,0,0,0,0,0,0,13000,7000,6000,6000
20200212,705951,穩懋元大93購12,2.55,3.40,2.44,3.24,+0.74,29.6,276000,51,780880,0,0,0,0,0,0,129000,171000,-42000,-42000
20200212,705952,旺矽國票94購01,,,,,,0.00,0,0,0,0,0,0,0,0,0,0,0,0,0
20200212,705953,勝麗國票94購01,4.52,5.35,4.52,5.05,+0.59,13.23,105000,12,514430,0,0,0,0,0,0,44000,61000,-17000,-17000
20200212,705954,網龍國泰95購01,0.53,0.53,0.51,0.51,-0.02,-3.77,1055000,13,556350,0,0,0,0,0,0,40000,1015000,-975000,-975000
20200212,705955,聯亞國泰95購01,0.99,0.99,0.94,0.94,+0.05,5.62,50000,5,48600,0,0,0,0,0,0,50000,30000,20000,20000
20200212,705956,台燿永豐93購01,,,,,,0.00,0,0,0,0,0,0,0,0,0,0,0,0,0
20200212,705957,網龍永豐93購02,,,,,,0.00,0,0,0,0,0,0,0,0,0,0,0,0,0
20200212,705958,均豪永豐93購01,,,,,,0.00,0,0,0,0,0,0,0,0,0,0,0,0,0
20200212,705959,宜鼎永豐93購01,1.19,1.19,1.03,1.03,-0.05,-4.63,135000,8,156520,0,0,0,0,0,0,135000,0,135000,135000
20200212,705960,宣德永豐93購01,0.76,0.76,0.74,0.75,-0.12,-13.79,96000,16,72230,0,0,0,0,0,0,96000,0,96000,96000
20200212,705961,建榮永豐94購05,,,,,,0.00,0,0,0,0,0,0,0,0,0,0,0,0,0
20200212,705962,璟德永豐93購02,0.43,0.52,0.43,0.49,-0.04,-7.55,194000,18,93780,0,0,0,0,0,0,192000,2000,190000,190000
20200212,705963,台燿元大93購02,0.23,0.25,0.23,0.25,+0.07,38.89,76000,5,18380,0,0,0,0,0,0,76000,0,76000,76000
20200212,705964,台燿元大93購03,,,,,,0.00,0,0,0,0,0,0,0,0,0,0,0,0,0
20200212,705965,璟德元大93購02,3.18,3.34,3.18,3.34,+0.01,0.3,54000,3,173000,0,0,0,0,0,0,54000,0,54000,54000
20200212,705966,聯亞元大94購01,0.40,0.40,0.40,0.40,+0.03,8.11,50000,1,20000,0,0,0,0,0,0,50000,0,50000,50000
20200212,705967,穩懋元大93購13,2.51,3.15,2.42,3.15,+0.77,32.35,100000,30,256760,0,0,0,0,0,0,97000,29000,68000,68000
20200212,705968,台燿中信93購03,0.35,0.35,0.35,0.35,+0.10,40.0,20000,2,7000,0,0,0,0,0,0,0,20000,-20000,-20000
20200212,705969,皇田國泰95購01,,,,,,0.00,0,0,0,0,0,0,0,0,0,0,0,0,0
20200212,705970,大江凱基94購04,,,,,,0.00,0,0,0,0,0,0,0,0,0,0,0,0,0
20200212,705971,台燿凱基93購08,,,,,,0.00,0,0,0,0,0,0,0,0,0,0,0,0,0
20200212,705972,建榮凱基94購01,,,,,,0.00,0,0,0,0,0,0,0,0,0,0,0,0,0
20200212,705973,泰博凱基93購01,0.77,0.77,0.77,0.77,+0.05,6.94,10000,1,7700,0,0,0,0,0,0,10000,0,10000,10000
20200212,705974,優群麥證94購01,0.68,0.73,0.68,0.73,+0.09,14.06,60000,6,42800,0,60000,-60000,0,0,0,0,60000,-60000,-60000
20200212,705975,M31元富93購01,0.41,0.41,0.41,0.41,+0.07,20.59,50000,1,20500,0,0,0,0,0,0,50000,0,50000,50000
20200212,705976,大江元富93購03,0.05,0.05,0.05,0.05,0.00,0.0,100000,1,5000,0,0,0,0,0,0,100000,0,100000,100000
20200212,705977,宜鼎元富93購01,,,,,,0.00,0,0,0,0,0,0,0,0,0,0,0,0,0
20200212,705978,昇達科元富93購01,,,,,,0.00,0,0,0,0,0,0,0,0,0,0,0,0,0
20200212,705979,欣銓元富93購01,0.44,0.44,0.44,0.44,+0.08,22.22,10000,1,4400,0,0,0,0,0,0,0,10000,-10000,-10000
20200212,705980,閎康元富93購01,,,,,,0.00,0,0,0,0,0,0,0,0,0,0,0,0,0
20200212,705981,榮剛元富93購01,,,,,,0.00,0,0,0,0,0,0,0,0,0,0,0,0,0
20200212,705982,穩懋元富93購01,2.73,3.63,2.69,3.45,+0.68,24.55,668000,34,1965810,0,0,0,0,0,0,232000,436000,-204000,-204000
20200212,705983,信驊兆豐93購01,,,,,,0.00,0,0,0,0,0,0,0,0,0,0,0,0,0
20200212,705984,台燿台新93購01,,,,,,0.00,0,0,0,0,0,0,0,0,0,0,0,0,0
20200212,705985,世界群益93購02,1.04,1.10,1.04,1.10,+0.13,13.4,73000,6,77340,0,0,0,0,0,0,29000,44000,-15000,-15000
20200212,705986,網龍群益93購01,0.12,0.12,0.12,0.12,-0.02,-14.29,1000,1,120,0,0,0,0,0,0,1000,0,1000,1000
20200212,705987,先豐凱基93購02,,,,,,0.00,0,0,0,0,0,0,0,0,0,0,0,0,0
20200212,705988,合晶凱基93購03,0.50,0.52,0.49,0.49,+0.14,40.0,27000,5,13680,0,0,0,0,0,0,0,27000,-27000,-27000
20200212,705989,皇田凱基93購04,,,,,,0.00,0,0,0,0,0,0,0,0,0,0,0,0,0
20200212,705990,群聯凱基93購04,3.21,3.29,3.21,3.29,+0.23,7.52,35000,2,113150,0,0,0,0,0,0,25000,10000,15000,15000
20200212,705991,穩懋凱基93購16,2.03,2.26,0.01,2.21,+0.22,11.06,53000,13,85460,0,0,0,0,0,0,43000,12000,31000,31000
20200212,705992,信驊元富93購01,,,,,,0.00,0,0,0,0,0,0,0,0,0,0,0,0,0
20200212,705993,良維兆豐94購02,,,,,,0.00,0,0,0,0,0,0,0,0,0,0,0,0,0
20200212,705994,環球晶台新95購01,7.25,7.25,7.25,7.25,+0.30,4.32,2000,1,14500,0,0,0,0,0,0,2000,0,2000,2000
20200212,705995,鈺太台新93購01,1.48,1.48,1.48,1.48,+0.05,3.5,10000,1,14800,0,0,0,0,0,0,0,10000,-10000,-10000
20200212,705996,台燿康和93購01,,,,,,0.00,0,0,0,0,0,0,0,0,0,0,0,0,0
20200212,705997,朋億康和93購01,,,,,,0.00,0,0,0,0,0,0,0,0,0,0,0,0,0
20200212,705998,聯亞康和93購01,,,,,,0.00,0,0,0,0,0,0,0,0,0,0,0,0,0
20200212,705999,均豪群益93購01,,,,,,0.00,0,0,0,0,0,0,0,0,0,0,0,0,0
20200212,706000,廣明群益93購02,,,,,,0.00,0,0,0,0,0,0,0,0,0,0,0,0,0
20200212,706001,譜瑞第一93購01,,,,,,0.00,0,0,0,0,0,0,0,0,0,0,0,0,0
20200212,706002,大江永豐93購04,,,,,,0.00,0,0,0,0,0,0,0,0,0,0,0,0,0
20200212,706003,神盾國票95購01,,,,,,0.00,0,0,0,0,0,0,0,0,0,0,0,0,0
20200212,706004,台燿國泰94購01,0.91,0.91,0.91,0.91,+0.21,30.0,60000,1,54600,0,0,0,0,0,0,0,60000,-60000,-60000
20200212,706005,中美晶元大95購01,,,,,,0.00,0,0,0,0,0,0,0,0,0,0,0,0,0
20200212,706006,台燿元大93購04,0.14,0.14,0.14,0.14,+0.04,40.0,35000,2,4900,0,0,0,0,0,0,35000,0,35000,35000
20200212,706007,金居元大94購02,0.10,0.10,0.10,0.10,+0.03,42.86,1000,1,100,0,0,0,0,0,0,1000,0,1000,1000
20200212,706008,鐿鈦元大93購01,,,,,,0.00,0,0,0,0,0,0,0,0,0,0,0,0,0
20200212,706009,宜鼎統一93購01,,,,,,0.00,0,0,0,0,0,0,0,0,0,0,0,0,0
20200212,706010,穩懋統一93購07,3.20,3.20,3.20,3.20,+0.52,19.4,5000,1,16000,0,0,0,0,0,0,0,0,0,0
20200212,706011,大宇資凱基93購01,0.52,0.52,0.52,0.52,-0.01,-1.89,60000,1,31200,0,0,0,0,0,0,60000,0,60000,60000
20200212,706012,佳邦凱基93購02,,,,,,0.00,0,0,0,0,0,0,0,0,0,0,0,0,0
20200212,706013,泰博凱基93購02,,,,,,0.00,0,0,0,0,0,0,0,0,0,0,0,0,0
20200212,706014,神盾凱基93購05,,,,,,0.00,0,0,0,0,0,0,0,0,0,0,0,0,0
20200212,706015,僑威凱基93購01,0.73,0.73,0.73,0.73,+0.05,7.35,43000,1,31390,0,0,0,0,0,0,43000,0,43000,43000
20200212,706016,優群凱基93購01,0.58,0.58,0.58,0.58,+0.11,23.4,68000,1,39440,0,0,0,0,0,0,0,68000,-68000,-68000
20200212,706017,環球晶凱基93購13,,,,,,0.00,0,0,0,0,0,0,0,0,0,0,0,0,0
20200212,706018,金可永豐93購01,0.18,0.18,0.18,0.18,+0.01,5.88,1000,1,180,0,0,0,0,0,0,1000,0,1000,1000
20200212,706019,宣德永豐93購02,,,,,,0.00,0,0,0,0,0,0,0,0,0,0,0,0,0
20200212,706020,建榮元大93購03,0.01,0.01,0.01,0.01,-0.02,-66.67,11000,1,110,0,0,0,0,0,0,11000,0,11000,11000
20200212,706021,緯軟元大94購03,,,,,,0.00,0,0,0,0,0,0,0,0,0,0,0,0,0
20200212,706022,昇達科國票94購02,,,,,,0.00,0,0,0,0,0,0,0,0,0,0,0,0,0
20200212,706023,原相國票95購01,,,,,,0.00,0,0,0,0,0,0,0,0,0,0,0,0,0
20200212,706024,建榮國泰95購02,,,,,,0.00,0,0,0,0,0,0,0,0,0,0,0,0,0
20200212,706025,建榮國泰95購03,,,,,,0.00,0,0,0,0,0,0,0,0,0,0,0,0,0
20200212,706026,雙鴻國泰95購01,1.44,1.71,1.42,1.65,+0.15,10.0,300000,53,473320,0,0,0,0,0,0,148000,146000,2000,2000
20200212,706027,環球晶元富93購05,,,,,,0.00,0,0,0,0,0,0,0,0,0,0,0,0,0
20200212,706028,大宇資麥證94購01,0.35,0.36,0.35,0.36,0.00,0.0,40000,2,14300,30000,10000,20000,0,0,0,30000,10000,20000,20000
20200212,706029,由田元大93購03,,,,,,0.00,0,0,0,0,0,0,0,0,0,0,0,0,0
20200212,706030,宜鼎元大93購02,5.30,5.30,5.20,5.20,+0.24,4.84,14000,2,73200,0,0,0,0,0,0,4000,10000,-6000,-6000
20200212,706031,信昌電元大93購01,2.92,2.92,2.92,2.92,-0.20,-6.41,11000,1,32120,0,0,0,0,0,0,11000,0,11000,11000
20200212,706032,環球晶元大93購11,7.70,7.70,7.70,7.70,+0.45,6.21,1000,1,7700,0,0,0,0,0,0,1000,1000,0,0
20200212,706033,雙美元大94購01,,,,,,0.00,0,0,0,0,0,0,0,0,0,0,0,0,0
20200212,706034,穩懋元大93購14,2.25,2.93,2.16,2.71,+0.54,24.88,285000,73,685120,0,0,0,0,0,0,221000,200000,21000,21000
20200212,706035,金可中信93購01,1.02,1.09,1.02,1.09,+0.06,5.83,30000,2,31300,0,0,0,0,0,0,20000,10000,10000,10000
20200212,706036,立端統一93購01,,,,,,0.00,0,0,0,0,0,0,0,0,0,0,0,0,0
20200212,706037,旺矽統一94購01,,,,,,0.00,0,0,0,0,0,0,0,0,0,0,0,0,0
20200212,706038,中美晶凱基93購04,2.94,2.94,2.94,2.94,+0.46,18.55,10000,1,29400,0,0,0,0,0,0,0,10000,-10000,-10000
20200212,706039,佳邦凱基93購03,,,,,,0.00,0,0,0,0,0,0,0,0,0,0,0,0,0
20200212,706040,直得凱基93購03,,,,,,0.00,0,0,0,0,0,0,0,0,0,0,0,0,0
20200212,706041,原相凱基93購04,3.61,3.94,3.61,3.94,+0.20,5.35,88000,28,327100,0,0,0,0,0,0,85000,4000,81000,81000
20200212,706042,群聯凱基93購05,2.88,2.88,2.88,2.88,+0.14,5.11,5000,1,14400,0,0,0,0,0,0,5000,0,5000,5000
20200212,706043,環球晶凱基93購14,6.15,6.35,6.15,6.35,+0.85,15.45,16000,4,99150,0,0,0,0,0,0,6000,16000,-10000,-10000
20200212,706044,台半亞東93購01,,,,,,0.00,0,0,0,0,0,0,0,0,0,0,0,0,0
20200212,706045,大田永豐94購01,,,,,,0.00,0,0,0,0,0,0,0,0,0,0,0,0,0
20200212,706046,立端永豐93購02,,,,,,0.00,0,0,0,0,0,0,0,0,0,0,0,0,0
20200212,706047,良維永豐94購01,,,,,,0.00,0,0,0,0,0,0,0,0,0,0,0,0,0
20200212,706048,聯亞永豐93購01,0.15,0.16,0.15,0.15,+0.01,7.14,41000,3,6250,0,0,0,0,0,0,40000,1000,39000,39000
20200212,706049,穩懋永豐93購03,,,,,,0.00,0,0,0,0,0,0,0,0,0,0,0,0,0
20200212,706050,網龍康和93購01,0.81,0.81,0.80,0.80,-0.01,-1.23,102000,3,82320,0,0,0,0,0,0,102000,0,102000,102000
20200212,706051,三貝德群益93購02,,,,,,0.00,0,0,0,0,0,0,0,0,0,0,0,0,0
20200212,706052,光隆群益93購01,,,,,,0.00,0,0,0,0,0,0,0,0,0,0,0,0,0
20200212,706053,保瑞群益94購02,0.45,0.45,0.45,0.45,+0.05,12.5,1000,1,450,0,0,0,0,0,0,0,1000,-1000,-1000
20200212,706054,穩懋中信95購03,1.25,1.51,1.22,1.47,+0.26,21.49,218000,17,283340,0,0,0,0,0,0,125000,93000,32000,32000
20200212,706055,中美晶元富93購01,4.03,4.39,4.03,4.39,+0.80,22.28,31000,10,131220,0,0,0,0,0,0,23000,31000,-8000,-8000
20200212,706056,穩懋元富95購01,1.02,1.25,1.02,1.25,+0.32,34.41,13000,5,14070,0,0,0,0,0,0,2000,11000,-9000,-9000
20200212,706057,宜鼎台新93購01,,,,,,0.00,0,0,0,0,0,0,0,0,0,0,0,0,0
20200212,706058,穩懋台新93購01,0.88,0.88,0.88,0.88,+0.14,18.92,49000,1,43120,0,0,0,0,0,0,49000,0,49000,49000
20200212,706059,大江元大94購01,,,,,,0.00,0,0,0,0,0,0,0,0,0,0,0,0,0
20200212,706060,世界元大93購01,2.47,2.61,2.47,2.61,+0.23,9.66,87000,10,224030,0,0,0,0,0,0,0,87000,-87000,-87000
20200212,706061,昂寶元大93購02,,,,,,0.00,0,0,0,0,0,0,0,0,0,0,0,0,0
20200212,706062,中美晶兆豐94購02,2.17,2.17,2.17,2.17,+0.21,10.71,1000,1,2170,0,0,0,0,0,0,1000,0,1000,1000
20200212,706063,元太兆豐93購01,,,,,,0.00,0,0,0,0,0,0,0,0,0,0,0,0,0
20200212,706064,泰博兆豐93購02,0.84,0.84,0.82,0.82,+0.01,1.23,264000,14,220180,0,0,0,0,0,0,187000,77000,110000,110000
20200212,706065,信昌電群益93購02,0.84,0.84,0.81,0.81,-0.04,-4.71,373000,7,304780,0,0,0,0,0,0,373000,0,373000,373000
20200212,706066,元太凱基93購02,,,,,,0.00,0,0,0,0,0,0,0,0,0,0,0,0,0
20200212,706067,合晶凱基93購04,,,,,,0.00,0,0,0,0,0,0,0,0,0,0,0,0,0
20200212,706068,杰力凱基93購04,,,,,,0.00,0,0,0,0,0,0,0,0,0,0,0,0,0
20200212,706069,博智凱基93購02,2.73,3.07,2.68,2.91,+0.22,8.18,71000,10,203070,0,0,0,0,0,0,29000,41000,-12000,-12000
20200212,706070,新普凱基93購02,1.67,1.67,1.67,1.67,+0.13,8.44,10000,1,16700,0,0,0,0,0,0,0,10000,-10000,-10000
20200212,706071,環球晶凱基93購15,8.20,8.40,8.20,8.40,+1.10,15.07,9000,3,74800,0,0,0,0,0,0,9000,9000,0,0
20200212,706072,雙美凱基93購01,0.06,0.06,0.06,0.06,+0.04,200.0,1000,1,60,0,0,0,0,0,0,1000,0,1000,1000
20200212,706073,穩懋凱基93購18,,,,,,0.00,0,0,0,0,0,0,0,0,0,0,0,0,0
20200212,706074,大田永豐93購01,,,,,,0.00,0,0,0,0,0,0,0,0,0,0,0,0,0
20200212,706075,大江永豐93購05,,,,,,0.00,0,0,0,0,0,0,0,0,0,0,0,0,0
20200212,706076,六角永豐93購01,0.41,0.48,0.41,0.42,+0.05,13.51,94000,8,42500,0,0,0,0,0,0,0,94000,-94000,-94000
20200212,706077,由田永豐93購02,,,,,,0.00,0,0,0,0,0,0,0,0,0,0,0,0,0
20200212,706078,旺矽永豐94購01,1.14,1.15,1.09,1.09,+0.04,3.81,445000,22,493500,0,0,0,0,0,0,300000,145000,155000,155000
20200212,706079,茂達永豐93購02,,,,,,0.00,0,0,0,0,0,0,0,0,0,0,0,0,0
20200212,706080,優群永豐94購01,1.06,1.13,1.05,1.13,+0.12,11.88,468000,10,503910,0,0,0,0,0,0,258000,210000,48000,48000
20200212,706081,立端國票93購01,,,,,,0.00,0,0,0,0,0,0,0,0,0,0,0,0,0
20200212,706082,美琪瑪國票94購01,,,,,,0.00,0,0,0,0,0,0,0,0,0,0,0,0,0
20200212,706083,群聯國票94購01,1.63,1.74,1.63,1.70,+0.09,5.59,56000,7,94880,0,0,0,0,0,0,32000,24000,8000,8000
20200212,706084,環宇國票93購02,,,,,,0.00,0,0,0,0,0,0,0,0,0,0,0,0,0
20200212,706085,穩懋國泰94購02,0.99,1.22,0.96,1.18,+0.24,25.53,2058000,60,2142210,0,0,0,0,0,0,969000,1109000,-140000,-140000
20200212,706086,中美晶富邦94購01,,,,,,0.00,0,0,0,0,0,0,0,0,0,0,0,0,0
20200212,706087,佳邦凱基93購04,0.44,0.44,0.44,0.44,+0.08,22.22,50000,1,22000,0,0,0,0,0,0,0,50000,-50000,-50000
20200212,706088,泰博凱基93購03,1.02,1.02,1.00,1.00,+0.07,7.53,20000,2,20200,0,0,0,0,0,0,20000,0,20000,20000
20200212,706089,神盾凱基93購06,,,,,,0.00,0,0,0,0,0,0,0,0,0,0,0,0,0
20200212,706090,環球晶凱基93購16,,,,,,0.00,0,0,0,0,0,0,0,0,0,0,0,0,0
20200212,706091,晟德凱基93購02,,,,,,0.00,0,0,0,0,0,0,0,0,0,0,0,0,0
20200212,706092,原相日盛93購01,6.15,6.15,6.15,6.15,+0.05,0.82,29000,1,178350,0,0,0,0,0,0,29000,0,29000,29000
20200212,706093,環球晶元富93購06,,,,,,0.00,0,0,0,0,0,0,0,0,0,0,0,0,0
20200212,706094,緯軟台新93購01,,,,,,0.00,0,0,0,0,0,0,0,0,0,0,0,0,0
20200212,706095,中美晶永豐93購02,,,,,,0.00,0,0,0,0,0,0,0,0,0,0,0,0,0
20200212,706096,波若威永豐93購01,0.07,0.07,0.07,0.07,+0.01,16.67,30000,1,2100,0,0,0,0,0,0,30000,0,30000,30000
20200212,706097,信驊永豐93購02,0.34,0.34,0.34,0.34,-0.03,-8.11,65000,1,22100,0,0,0,0,0,0,65000,0,65000,65000
20200212,706098,勝麗兆豐93購01,,,,,,0.00,0,0,0,0,0,0,0,0,0,0,0,0,0
20200212,706099,雙鴻兆豐94購01,,,,,,0.00,0,0,0,0,0,0,0,0,0,0,0,0,0
20200212,706100,穩懋兆豐94購01,0.61,0.61,0.61,0.61,+0.07,12.96,111000,2,67710,0,0,0,0,0,0,111000,0,111000,111000
20200212,706101,鈺太康和93購01,,,,,,0.00,0,0,0,0,0,0,0,0,0,0,0,0,0
20200212,706102,良維群益93購03,0.27,0.28,0.27,0.28,+0.02,7.69,150000,2,40570,0,0,0,0,0,0,0,150000,-150000,-150000
20200212,706103,廣明群益93購03,,,,,,0.00,0,0,0,0,0,0,0,0,0,0,0,0,0
20200212,706104,宜鼎元大93購03,5.25,5.25,5.25,5.25,+0.47,9.83,4000,1,21000,0,0,0,0,0,0,4000,0,4000,4000
20200212,706105,宜鼎國票93購01,3.71,3.71,3.71,3.71,+0.07,1.92,1000,1,3710,0,0,0,0,0,0,1000,0,1000,1000
20200212,706106,信驊國票93購01,,,,,,0.00,0,0,0,0,0,0,0,0,0,0,0,0,0
20200212,706107,網龍國票94購01,,,,,,0.00,0,0,0,0,0,0,0,0,0,0,0,0,0
20200212,706108,威剛富邦97購01,3.04,3.30,3.04,3.13,+0.11,3.64,159000,33,508070,0,0,0,0,0,0,23000,136000,-113000,-113000
20200212,706109,雙鴻富邦97購01,0.37,0.41,0.37,0.40,+0.02,5.26,570000,35,223590,0,0,0,0,0,0,365000,205000,160000,160000
20200212,706110,聯亞元富93購03,,,,,,0.00,0,0,0,0,0,0,0,0,0,0,0,0,0
20200212,706111,宣德國泰93購01,1.33,1.48,1.31,1.48,-0.08,-5.13,705000,57,961500,0,0,0,0,0,0,437000,298000,139000,139000
20200212,706112,原相元大95購01,,,,,,0.00,0,0,0,0,0,0,0,0,0,0,0,0,0
20200212,706113,精華元大93購01,,,,,,0.00,0,0,0,0,0,0,0,0,0,0,0,0,0
20200212,706114,穩懋元大93購15,0.57,0.78,0.52,0.77,+0.23,42.59,214000,28,124350,0,0,0,0,0,0,138000,76000,62000,62000
20200212,706115,中美晶凱基93購05,,,,,,0.00,0,0,0,0,0,0,0,0,0,0,0,0,0
20200212,706116,宜鼎凱基93購03,2.28,2.28,2.28,2.28,-0.05,-2.15,115000,1,262200,0,0,0,0,0,0,115000,0,115000,115000
20200212,706117,泰博凱基93購04,,,,,,0.00,0,0,0,0,0,0,0,0,0,0,0,0,0
20200212,706118,緯軟凱基93購02,,,,,,0.00,0,0,0,0,0,0,0,0,0,0,0,0,0
20200212,706119,環球晶凱基93購17,4.70,5.05,4.70,5.05,+0.37,7.91,20000,8,98060,0,0,0,0,0,0,20000,20000,0,0
20200212,706120,穩懋凱基93購19,0.55,0.85,0.55,0.73,+0.21,40.38,472000,52,328680,0,0,0,0,0,0,1000,471000,-470000,-470000
20200212,706121,泰博統一93購01,1.79,1.79,1.79,1.79,+0.10,5.92,31000,2,55490,0,0,0,0,0,0,31000,0,31000,31000
20200212,706122,環球晶統一93購01,,,,,,0.00,0,0,0,0,0,0,0,0,0,0,0,0,0
20200212,706123,穩懋統一93購08,0.46,0.57,0.44,0.57,+0.16,39.02,655000,17,311270,0,0,0,0,0,0,195000,460000,-265000,-265000
20200212,706124,群聯兆豐94購02,1.40,1.42,1.39,1.39,+0.03,2.21,54000,5,75240,0,0,0,0,0,0,39000,15000,24000,24000
20200212,706125,聚積兆豐94購01,0.36,0.38,0.36,0.38,+0.01,2.7,134000,3,49230,0,0,0,0,0,0,85000,49000,36000,36000
20200212,706126,穩懋兆豐93購04,0.17,0.22,0.17,0.20,+0.06,42.86,139000,6,25230,0,0,0,0,0,0,109000,30000,79000,79000
20200212,706127,博大康和93購01,0.14,0.14,0.14,0.14,-0.01,-6.67,58000,2,8120,0,0,0,0,0,0,58000,0,58000,58000
20200212,706128,宏觀群益93購01,,,,,,0.00,0,0,0,0,0,0,0,0,0,0,0,0,0
20200212,706129,信驊群益93購02,0.97,0.97,0.97,0.97,-0.16,-14.16,15000,1,14550,0,0,0,0,0,0,15000,15000,0,0
20200212,706130,雙美群益95購01,0.24,0.25,0.24,0.25,+0.11,78.57,105000,3,25250,0,0,0,0,0,0,5000,100000,-95000,-95000
20200212,706131,聚積國票93購01,,,,,,0.00,0,0,0,0,0,0,0,0,0,0,0,0,0
20200212,706132,環球晶國票93購02,9.30,9.90,9.30,9.75,+0.75,8.33,62000,7,598000,0,0,0,0,0,0,16000,46000,-30000,-30000
20200212,706133,鈺太國票95購02,2.49,2.51,2.49,2.51,+0.33,15.14,53000,2,132830,0,0,0,0,0,0,43000,10000,33000,33000
20200212,706134,穩懋富邦95購01,0.71,0.91,0.68,0.86,+0.17,24.64,1497000,56,1101590,0,0,0,0,0,0,762000,729000,33000,33000
20200212,706135,中美晶永豐93購03,2.68,2.68,2.61,2.68,0.00,0.0,17000,3,45490,0,0,0,0,0,0,17000,1000,16000,16000
20200212,706136,由田永豐93購03,,,,,,0.00,0,0,0,0,0,0,0,0,0,0,0,0,0
20200212,706137,合晶永豐93購03,0.05,0.06,0.05,0.06,+0.01,20.0,300000,2,16500,0,0,0,0,0,0,300000,0,300000,300000
20200212,706138,昂寶永豐93購01,0.69,0.69,0.69,0.69,-0.04,-5.48,20000,1,13800,0,0,0,0,0,0,20000,0,20000,20000
20200212,706139,直得永豐93購02,0.34,0.34,0.34,0.34,-0.04,-10.53,15000,3,5100,0,0,0,0,0,0,0,15000,-15000,-15000
20200212,706140,晶焱永豐93購02,,,,,,0.00,0,0,0,0,0,0,0,0,0,0,0,0,0
20200212,706141,順達永豐93購02,0.23,0.23,0.23,0.23,+0.04,21.05,70000,1,16100,0,0,0,0,0,0,70000,0,70000,70000
20200212,706142,精華永豐93購02,,,,,,0.00,0,0,0,0,0,0,0,0,0,0,0,0,0
20200212,706143,聚積永豐93購01,,,,,,0.00,0,0,0,0,0,0,0,0,0,0,0,0,0
20200212,706144,先豐統一93購01,,,,,,0.00,0,0,0,0,0,0,0,0,0,0,0,0,0
20200212,706145,精華中信93購01,,,,,,0.00,0,0,0,0,0,0,0,0,0,0,0,0,0
20200212,706146,六角凱基93購01,0.39,0.43,0.39,0.39,+0.05,14.71,189000,5,75510,0,0,0,0,0,0,99000,90000,9000,9000
20200212,706147,金居凱基93購03,,,,,,0.00,0,0,0,0,0,0,0,0,0,0,0,0,0
20200212,706148,保瑞凱基93購01,,,,,,0.00,0,0,0,0,0,0,0,0,0,0,0,0,0
20200212,706149,群聯凱基93購06,1.68,1.68,1.66,1.66,+0.11,7.1,100000,6,166500,0,0,0,0,0,0,100000,100000,0,0
20200212,706150,聖暉凱基94購01,1.32,1.33,1.32,1.33,+0.02,1.53,136000,2,180200,0,0,0,0,0,0,68000,68000,0,0
20200212,706151,環球晶凱基93購18,,,,,,0.00,0,0,0,0,0,0,0,0,0,0,0,0,0
20200212,706152,穩懋凱基93購20,,,,,,0.00,0,0,0,0,0,0,0,0,0,0,0,0,0
20200212,706153,良維永豐93購01,,,,,,0.00,0,0,0,0,0,0,0,0,0,0,0,0,0
20200212,706154,波若威永豐94購01,,,,,,0.00,0,0,0,0,0,0,0,0,0,0,0,0,0
20200212,706155,信昌電永豐93購03,,,,,,0.00,0,0,0,0,0,0,0,0,0,0,0,0,0
20200212,706156,僑威永豐93購02,,,,,,0.00,0,0,0,0,0,0,0,0,0,0,0,0,0
20200212,706157,穩懋永豐94購01,0.63,0.63,0.63,0.63,+0.02,3.28,37000,1,23310,0,0,0,0,0,0,0,37000,-37000,-37000
20200212,706158,昂寶兆豐93購01,,,,,,0.00,0,0,0,0,0,0,0,0,0,0,0,0,0
20200212,706159,大江群益93購02,,,,,,0.00,0,0,0,0,0,0,0,0,0,0,0,0,0
20200212,706160,中美晶群益93購02,2.73,2.95,2.72,2.72,+0.35,14.77,491000,4,1411530,0,0,0,0,0,0,330000,161000,169000,169000
20200212,706161,順達群益93購01,0.83,0.92,0.83,0.92,+0.16,21.05,80000,7,71500,0,0,0,0,0,0,0,80000,-80000,-80000
20200212,706162,緯軟群益93購02,,,,,,0.00,0,0,0,0,0,0,0,0,0,0,0,0,0
20200212,706163,勝麗元大93購02,3.39,3.74,3.39,3.74,+0.40,11.98,15000,4,52430,0,0,0,0,0,0,10000,5000,5000,5000
20200212,706164,博智元大95購01,2.84,3.02,2.84,2.92,+0.23,8.55,21000,8,61270,0,0,0,0,0,0,0,21000,-21000,-21000
20200212,706165,順達元大93購01,1.55,1.64,1.55,1.64,+0.26,18.84,70000,3,112700,0,0,0,0,0,0,10000,60000,-50000,-50000
20200212,706166,神盾台新94購01,,,,,,0.00,0,0,0,0,0,0,0,0,0,0,0,0,0
20200212,706167,三貝德國票95購01,,,,,,0.00,0,0,0,0,0,0,0,0,0,0,0,0,0
20200212,706168,大田國票94購01,,,,,,0.00,0,0,0,0,0,0,0,0,0,0,0,0,0
20200212,706169,精華國票94購01,,,,,,0.00,0,0,0,0,0,0,0,0,0,0,0,0,0
20200212,706170,廣明國票94購01,,,,,,0.00,0,0,0,0,0,0,0,0,0,0,0,0,0
20200212,706171,鐿鈦國票95購01,0.54,0.54,0.54,0.54,+0.04,8.0,116000,2,62640,0,0,0,0,0,0,0,116000,-116000,-116000
20200212,706172,金居國泰94購01,0.39,0.39,0.39,0.39,+0.05,14.71,4000,1,1560,0,0,0,0,0,0,4000,0,4000,4000
20200212,706173,神盾國泰95購01,0.31,0.31,0.31,0.31,+0.03,10.71,10000,1,3100,0,0,0,0,0,0,0,10000,-10000,-10000
20200212,706174,晶焱國泰94購01,0.59,0.61,0.59,0.60,+0.08,15.38,93000,3,55730,0,0,0,0,0,0,10000,83000,-73000,-73000
20200212,706175,譜瑞國泰95購01,3.00,3.12,3.00,3.12,+0.39,14.29,11000,5,33710,0,0,0,0,0,0,4000,6000,-2000,-2000
20200212,706176,勝麗康和93購01,,,,,,0.00,0,0,0,0,0,0,0,0,0,0,0,0,0
20200212,706177,M31群益93購03,0.53,0.53,0.53,0.53,+0.06,12.77,17000,2,9010,0,0,0,0,0,0,0,17000,-17000,-17000
20200212,706178,建榮群益94購03,0.08,0.08,0.08,0.08,0.00,0.0,20000,1,1600,0,0,0,0,0,0,20000,0,20000,20000
20200212,706179,太醫中信93購01,0.05,0.05,0.04,0.04,0.00,0.0,20000,3,850,0,0,0,0,0,0,15000,5000,10000,10000
20200212,706180,宣德凱基93購01,1.37,1.45,1.33,1.45,-0.01,-0.68,168000,27,230220,0,0,0,0,0,0,163000,5000,158000,158000
20200212,706181,原相凱基93購05,3.80,4.00,2.29,4.00,+0.16,4.17,162000,35,612150,0,0,0,0,0,0,153000,13000,140000,140000
20200212,706182,閎康凱基94購01,1.35,1.35,1.35,1.35,-0.02,-1.46,3000,1,4050,0,0,0,0,0,0,3000,0,3000,3000
20200212,706183,聚積凱基94購01,0.56,0.56,0.56,0.56,+0.05,9.8,68000,1,38080,0,0,0,0,0,0,68000,0,68000,68000
20200212,706184,神盾統一94購01,0.16,0.16,0.16,0.16,+0.02,14.29,10000,1,1600,0,0,0,0,0,0,10000,0,10000,10000
20200212,706185,優群統一93購01,1.48,1.54,1.48,1.54,+0.22,16.67,62000,7,93060,0,0,0,0,0,0,0,62000,-62000,-62000
20200212,706186,中美晶元富94購02,2.86,3.27,2.86,3.27,+0.47,16.79,44000,10,134640,0,0,0,0,0,0,36000,30000,6000,6000
20200212,706187,中美晶元大93購09,3.97,4.26,3.97,4.26,+0.42,10.94,7000,4,28960,0,0,0,0,0,0,1000,6000,-5000,-5000
20200212,706188,信驊元大93購02,,,,,,0.00,0,0,0,0,0,0,0,0,0,0,0,0,0
20200212,706189,穩懋元大93購16,1.41,1.94,1.11,1.80,+0.43,31.39,452000,60,671130,0,0,0,0,0,0,316000,200000,116000,116000
20200212,706190,大江國票94購01,,,,,,0.00,0,0,0,0,0,0,0,0,0,0,0,0,0
20200212,706191,台燿國票93購02,0.52,0.55,0.52,0.55,+0.16,41.03,20000,2,10700,0,0,0,0,0,0,0,20000,-20000,-20000
20200212,706192,同致國票94購01,,,,,,0.00,0,0,0,0,0,0,0,0,0,0,0,0,0
20200212,706193,良維國票94購01,0.99,1.06,0.97,1.06,+0.04,3.92,265000,16,268450,0,0,0,0,0,0,168000,184000,-16000,-16000
20200212,706194,博智國票95購01,,,,,,0.00,0,0,0,0,0,0,0,0,0,0,0,0,0
20200212,706195,順達國票94購01,1.88,2.20,1.88,2.20,+0.40,22.22,87000,4,179960,0,0,0,0,0,0,0,87000,-87000,-87000
20200212,706196,新普國票93購01,3.84,3.84,3.84,3.84,+0.40,11.63,10000,1,38400,0,0,0,0,0,0,0,10000,-10000,-10000
20200212,706197,聯亞國票94購01,,,,,,0.00,0,0,0,0,0,0,0,0,0,0,0,0,0
20200212,706198,中美晶國泰94購01,,,,,,0.00,0,0,0,0,0,0,0,0,0,0,0,0,0
20200212,706199,昇達科國泰95購01,0.17,0.17,0.17,0.17,+0.02,13.33,250000,1,42500,0,0,0,0,0,0,250000,0,250000,250000
20200212,706200,保瑞國泰95購02,0.29,0.29,0.29,0.29,+0.02,7.41,20000,1,5800,0,0,0,0,0,0,0,20000,-20000,-20000
20200212,706201,昂寶亞東93購02,,,,,,0.00,0,0,0,0,0,0,0,0,0,0,0,0,0
20200212,706202,宏觀永豐93購01,,,,,,0.00,0,0,0,0,0,0,0,0,0,0,0,0,0
20200212,706203,欣銓永豐93購01,,,,,,0.00,0,0,0,0,0,0,0,0,0,0,0,0,0
20200212,706204,緯軟永豐93購03,,,,,,0.00,0,0,0,0,0,0,0,0,0,0,0,0,0
20200212,706205,元太元大93購01,1.46,1.63,1.46,1.63,+0.13,8.67,78000,12,124620,0,0,0,0,0,0,14000,73000,-59000,-59000
20200212,706206,佳邦元大93購01,0.52,0.62,0.52,0.62,+0.12,24.0,47000,4,28640,0,0,0,0,0,0,7000,40000,-33000,-33000
20200212,706207,直得元大94購01,2.23,2.33,2.23,2.33,-0.13,-5.28,64000,5,147950,0,0,0,0,0,0,14000,50000,-36000,-36000
20200212,706208,宣德元大93購03,2.41,2.70,2.38,2.70,+0.08,3.05,287000,22,730360,0,0,0,0,0,0,269000,71000,198000,198000
20200212,706209,美琪瑪元大93購01,,,,,,0.00,0,0,0,0,0,0,0,0,0,0,0,0,0
20200212,706210,神盾元大94購05,0.43,0.46,0.43,0.46,+0.05,12.2,70000,2,30160,0,0,0,0,0,0,0,70000,-70000,-70000
20200212,706211,精華元大93購02,,,,,,0.00,0,0,0,0,0,0,0,0,0,0,0,0,0
20200212,706212,廣明元大94購01,,,,,,0.00,0,0,0,0,0,0,0,0,0,0,0,0,0
20200212,706213,緯軟元大94購04,0.50,0.50,0.47,0.48,+0.02,4.35,400000,18,192550,0,0,0,0,0,0,400000,0,400000,400000
20200212,706214,力旺統一93購01,1.02,1.06,1.02,1.06,+0.03,2.91,27000,6,27940,0,0,0,0,0,0,7000,20000,-13000,-13000
20200212,706215,神盾統一94購02,,,,,,0.00,0,0,0,0,0,0,0,0,0,0,0,0,0
20200212,706216,群聯統一93購02,1.45,1.45,1.43,1.43,-0.01,-0.69,1044000,7,1505060,0,0,0,0,0,0,1044000,0,1044000,1044000
20200212,706217,中美晶凱基93購06,1.84,2.07,1.84,2.07,+0.36,21.05,15000,2,29900,0,0,0,0,0,0,5000,10000,-5000,-5000
20200212,706218,六角凱基93購02,0.50,0.52,0.42,0.42,+0.05,13.51,175000,10,85970,0,0,0,0,0,0,5000,170000,-165000,-165000
20200212,706219,美琪瑪凱基93購01,,,,,,0.00,0,0,0,0,0,0,0,0,0,0,0,0,0
20200212,706220,博智凱基93購03,2.37,2.64,2.37,2.64,+0.37,16.3,111000,9,269290,0,0,0,0,0,0,90000,21000,69000,69000
20200212,706221,環球晶凱基93購19,6.50,7.05,6.50,6.90,+0.70,11.29,35000,9,231850,0,0,0,0,0,0,35000,11000,24000,24000
20200212,706222,穩懋凱基93購21,0.87,1.16,0.87,1.16,+0.27,30.34,64000,9,60220,0,0,0,0,0,0,44000,26000,18000,18000
20200212,706223,立端國票94購01,0.39,0.39,0.39,0.39,+0.08,25.81,50000,1,19500,0,0,0,0,0,0,0,50000,-50000,-50000
20200212,706224,昂寶國票94購01,,,,,,0.00,0,0,0,0,0,0,0,0,0,0,0,0,0
20200212,706225,昇達科國票93購01,,,,,,0.00,0,0,0,0,0,0,0,0,0,0,0,0,0
20200212,706226,金可國票94購01,0.80,0.84,0.79,0.84,+0.07,9.09,160000,4,130300,0,0,0,0,0,0,150000,10000,140000,140000
20200212,706227,信昌電國票94購01,1.93,1.93,1.91,1.91,-0.18,-8.61,72000,3,138200,0,0,0,0,0,0,72000,0,72000,72000
20200212,706228,威剛國票94購01,4.26,4.26,4.26,4.26,+0.37,9.51,3000,1,12780,0,0,0,0,0,0,3000,0,3000,3000
20200212,706229,智擎國票94購01,0.07,0.18,0.07,0.18,+0.14,350.0,733000,14,67140,0,0,0,0,0,0,620000,0,620000,620000
20200212,706230,穩懋國票93購06,0.54,0.73,0.53,0.73,+0.25,52.08,631000,13,387960,0,0,0,0,0,0,132000,499000,-367000,-367000
20200212,706231,台燿富邦93購01,,,,,,0.00,0,0,0,0,0,0,0,0,0,0,0,0,0
20200212,706232,大宇資第一93購01,,,,,,0.00,0,0,0,0,0,0,0,0,0,0,0,0,0
20200212,706233,合晶元富93購01,0.16,0.18,0.16,0.18,+0.06,50.0,939000,9,150440,0,0,0,0,0,0,0,939000,-939000,-939000
20200212,706234,神盾元富94購01,,,,,,0.00,0,0,0,0,0,0,0,0,0,0,0,0,0
20200212,706235,環球晶元富94購02,,,,,,0.00,0,0,0,0,0,0,0,0,0,0,0,0,0
20200212,706236,M31永豐93購02,0.17,0.17,0.17,0.17,+0.01,6.25,15000,1,2550,0,0,0,0,0,0,15000,0,15000,15000
20200212,706237,台燿永豐93購02,,,,,,0.00,0,0,0,0,0,0,0,0,0,0,0,0,0
20200212,706238,佳邦永豐93購02,,,,,,0.00,0,0,0,0,0,0,0,0,0,0,0,0,0
20200212,706239,旺矽永豐93購02,0.51,0.51,0.49,0.49,+0.02,4.26,31000,2,15210,0,0,0,0,0,0,31000,0,31000,31000
20200212,706240,宣德永豐93購03,0.61,0.62,0.60,0.62,-0.13,-17.33,94000,17,57250,0,0,0,0,0,0,94000,0,94000,94000
20200212,706241,碩禾永豐94購01,,,,,,0.00,0,0,0,0,0,0,0,0,0,0,0,0,0
20200212,706242,宜鼎兆豐94購01,,,,,,0.00,0,0,0,0,0,0,0,0,0,0,0,0,0
20200212,706243,神盾兆豐94購01,0.15,0.15,0.15,0.15,+0.02,15.38,100000,1,15000,0,0,0,0,0,0,100000,0,100000,100000
20200212,706244,網龍群益94購01,,,,,,0.00,0,0,0,0,0,0,0,0,0,0,0,0,0
20200212,706245,穩懋統一94購04,0.68,0.96,0.64,0.89,+0.23,34.85,518000,36,404230,0,0,0,0,0,0,303000,101000,202000,202000
20200212,706246,譜瑞統一94購01,1.68,2.04,1.65,1.89,+0.33,21.15,930000,93,1781080,0,0,0,0,0,0,278000,461000,-183000,-183000
20200212,706247,由田凱基94購01,,,,,,0.00,0,0,0,0,0,0,0,0,0,0,0,0,0
20200212,706248,宜鼎凱基94購01,3.47,3.47,3.33,3.33,+0.24,7.77,22000,2,73400,0,0,0,0,0,0,22000,0,22000,22000
20200212,706249,美琪瑪凱基94購01,,,,,,0.00,0,0,0,0,0,0,0,0,0,0,0,0,0
20200212,706250,廣明凱基94購05,,,,,,0.00,0,0,0,0,0,0,0,0,0,0,0,0,0
20200212,706251,環球晶凱基94購01,,,,,,0.00,0,0,0,0,0,0,0,0,0,0,0,0,0
20200212,706252,穩懋凱基94購03,,,,,,0.00,0,0,0,0,0,0,0,0,0,0,0,0,0
20200212,706253,鈺太凱基94購01,,,,,,0.00,0,0,0,0,0,0,0,0,0,0,0,0,0
20200212,706254,宣德國票95購01,2.84,2.84,2.75,2.77,-0.41,-12.89,50000,16,140360,0,0,0,0,0,0,50000,0,50000,50000
20200212,706255,泰博國票95購01,1.32,1.32,1.26,1.26,+0.05,4.13,100000,8,129900,0,0,0,0,0,0,0,100000,-100000,-100000
20200212,706256,神盾富邦96購01,0.31,0.32,0.31,0.32,+0.02,6.67,61000,13,18970,0,0,0,0,0,0,60000,1000,59000,59000
20200212,706257,新普富邦94購01,,,,,,0.00,0,0,0,0,0,0,0,0,0,0,0,0,0
20200212,706258,穩懋兆豐94購02,1.86,1.86,1.86,1.86,+0.27,16.98,10000,1,18600,0,0,0,0,0,0,10000,0,10000,10000
20200212,706259,晟德兆豐95購01,0.28,0.28,0.28,0.28,+0.01,3.7,1000,1,280,0,0,0,0,0,0,1000,0,1000,1000
20200212,706260,大江群益94購02,,,,,,0.00,0,0,0,0,0,0,0,0,0,0,0,0,0
20200212,706261,神盾麥證94購01,0.53,0.59,0.53,0.59,+0.06,11.32,147000,18,83260,122000,0,122000,0,0,0,122000,0,122000,122000
20200212,706262,美琪瑪麥證95購01,,,,,,0.00,0,0,0,0,0,0,0,0,0,0,0,0,0
20200212,706263,良維元富94購01,,,,,,0.00,0,0,0,0,0,0,0,0,0,0,0,0,0
20200212,706264,中美晶台新94購01,,,,,,0.00,0,0,0,0,0,0,0,0,0,0,0,0,0
20200212,706265,合晶台新94購01,0.61,0.65,0.61,0.65,+0.11,20.37,126000,3,79500,0,0,0,0,0,0,0,126000,-126000,-126000
20200212,706266,中美晶元大94購01,4.08,4.37,4.08,4.37,+0.43,10.91,7000,4,29730,0,0,0,0,0,0,1000,6000,-5000,-5000
20200212,706267,合晶元大96購01,0.52,0.63,0.52,0.63,+0.16,34.04,604000,9,344480,0,0,0,0,0,0,5000,599000,-594000,-594000
20200212,706268,宏觀元大94購02,0.08,0.11,0.08,0.11,+0.03,37.5,115000,4,10300,0,0,0,0,0,0,105000,10000,95000,95000
20200212,706269,良維元大95購01,1.11,1.20,1.11,1.16,+0.04,3.57,373000,10,430230,0,0,0,0,0,0,120000,253000,-133000,-133000
20200212,706270,宜鼎元大95購01,6.65,6.70,6.45,6.45,+0.15,2.38,42000,8,276400,0,0,0,0,0,0,32000,10000,22000,22000
20200212,706271,昇達科元大94購01,,,,,,0.00,0,0,0,0,0,0,0,0,0,0,0,0,0
20200212,706272,杰力元大95購01,0.80,0.88,0.80,0.88,+0.10,12.82,119000,3,99520,0,0,0,0,0,0,65000,54000,11000,11000
20200212,706273,勝麗元大94購01,2.06,2.31,2.06,2.31,+0.28,13.79,14000,3,29790,0,0,0,0,0,0,10000,4000,6000,6000
20200212,706274,群聯元大95購01,1.60,1.60,1.60,1.60,+0.11,7.38,20000,2,32000,0,0,0,0,0,0,10000,20000,-10000,-10000
20200212,706275,聚積元大94購01,,,,,,0.00,0,0,0,0,0,0,0,0,0,0,0,0,0
20200212,706276,中美晶日盛94購01,2.13,2.13,2.13,2.13,+0.32,17.68,96000,3,204480,0,0,0,0,0,0,0,96000,-96000,-96000
20200212,706277,三貝德永豐94購01,,,,,,0.00,0,0,0,0,0,0,0,0,0,0,0,0,0
20200212,706278,上詮永豐94購01,,,,,,0.00,0,0,0,0,0,0,0,0,0,0,0,0,0
20200212,706279,大宇資永豐94購01,,,,,,0.00,0,0,0,0,0,0,0,0,0,0,0,0,0
20200212,706280,信昌電永豐94購01,,,,,,0.00,0,0,0,0,0,0,0,0,0,0,0,0,0
20200212,706281,原相永豐94購02,2.24,2.43,2.22,2.31,+0.01,0.43,244000,28,561440,0,0,0,0,0,0,114000,145000,-31000,-31000
20200212,706282,勝麗永豐94購01,0.74,0.87,0.74,0.78,+0.03,4.0,312000,20,251380,0,0,0,0,0,0,147000,164000,-17000,-17000
20200212,706283,緯軟永豐94購01,,,,,,0.00,0,0,0,0,0,0,0,0,0,0,0,0,0
20200212,706284,鐿鈦永豐94購01,,,,,,0.00,0,0,0,0,0,0,0,0,0,0,0,0,0
20200212,706285,金可兆豐95購01,0.84,0.84,0.82,0.84,+0.05,6.33,32000,4,26580,0,0,0,0,0,0,2000,30000,-28000,-28000
20200212,706286,緯軟兆豐95購01,0.33,0.33,0.33,0.33,+0.01,3.12,100000,2,33000,0,0,0,0,0,0,100000,0,100000,100000
20200212,706287,環球晶兆豐95購01,,,,,,0.00,0,0,0,0,0,0,0,0,0,0,0,0,0
20200212,706288,譜瑞兆豐95購01,1.43,1.55,1.43,1.49,+0.17,12.88,103000,11,152950,0,0,0,0,0,0,90000,11000,79000,79000
20200212,706289,宜鼎群益94購01,4.24,4.24,4.14,4.14,+0.44,11.89,11000,2,45640,0,0,0,0,0,0,11000,0,11000,11000
20200212,706290,信昌電群益94購01,0.32,0.32,0.32,0.32,-0.03,-8.57,75000,3,24000,0,0,0,0,0,0,65000,10000,55000,55000
20200212,706291,弘塑中信94購01,,,,,,0.00,0,0,0,0,0,0,0,0,0,0,0,0,0
20200212,706292,兆利中信94購01,0.92,1.02,0.92,1.00,-0.06,-5.66,161000,26,156880,0,0,0,0,0,0,148000,5000,143000,143000
20200212,706293,杰力中信95購01,0.20,0.20,0.20,0.20,+0.03,17.65,50000,1,10000,0,0,0,0,0,0,50000,0,50000,50000
20200212,706294,原相統一94購01,5.05,5.05,4.84,4.84,+0.25,5.45,60000,28,298420,0,0,0,0,0,0,60000,0,60000,60000
20200212,706295,雙鴻統一94購01,0.24,0.28,0.24,0.28,+0.01,3.7,246000,26,64600,0,0,0,0,0,0,141000,105000,36000,36000
20200212,706296,穩懋統一96購01,1.52,1.87,1.46,1.79,+0.33,22.6,787000,60,1221160,0,0,0,0,0,0,323000,464000,-141000,-141000
20200212,706297,大宇資凱基94購02,,,,,,0.00,0,0,0,0,0,0,0,0,0,0,0,0,0
20200212,706298,立端凱基94購01,,,,,,0.00,0,0,0,0,0,0,0,0,0,0,0,0,0
20200212,706299,宇峻凱基94購01,4.40,4.40,3.61,3.75,-0.73,-16.29,123000,16,468020,0,0,0,0,0,0,19000,103000,-84000,-84000
20200212,706300,穩懋凱基94購04,0.76,0.99,0.76,0.99,+0.27,37.5,2000,2,1750,0,0,0,0,0,0,1000,1000,0,0
20200212,706301,譜瑞凱基94購02,2.40,2.66,2.39,2.58,+0.45,21.13,120000,7,290640,0,0,0,0,0,0,98000,30000,68000,68000
20200212,706302,三貝德國票96購01,0.08,0.08,0.08,0.08,+0.02,33.33,10000,1,800,0,0,0,0,0,0,0,10000,-10000,-10000
20200212,706303,大學光國票94購01,,,,,,0.00,0,0,0,0,0,0,0,0,0,0,0,0,0
20200212,706304,迅得國票94購01,1.39,1.73,1.39,1.61,+0.23,16.67,100000,9,161100,0,0,0,0,0,0,40000,60000,-20000,-20000
20200212,706305,迅得國票94購02,2.57,2.93,2.57,2.81,+0.26,10.2,144000,17,393010,0,0,0,0,0,0,44000,100000,-56000,-56000
20200212,706306,昂寶國票95購01,,,,,,0.00,0,0,0,0,0,0,0,0,0,0,0,0,0
20200212,706307,勝麗國票95購01,2.33,2.79,2.33,2.40,0.00,0.0,212000,20,545780,0,0,0,0,0,0,90000,122000,-32000,-32000
20200212,706308,新揚科國票94購01,0.23,0.28,0.22,0.26,+0.05,23.81,90000,9,21500,0,0,0,0,0,0,40000,50000,-10000,-10000
20200212,706309,新揚科國票95購01,0.24,0.24,0.24,0.24,+0.04,20.0,10000,1,2400,0,0,0,0,0,0,0,10000,-10000,-10000
20200212,706310,聯亞國票95購01,2.13,2.13,2.13,2.13,+0.17,8.67,10000,1,21300,0,0,0,0,0,0,0,10000,-10000,-10000
20200212,706311,大學光國泰94購01,,,,,,0.00,0,0,0,0,0,0,0,0,0,0,0,0,0
20200212,706312,大學光國泰95購01,,,,,,0.00,0,0,0,0,0,0,0,0,0,0,0,0,0
20200212,706313,宇峻國泰95購01,,,,,,0.00,0,0,0,0,0,0,0,0,0,0,0,0,0
20200212,706314,安勤國泰95購01,0.64,0.64,0.64,0.64,+0.01,1.59,103000,7,65920,0,0,0,0,0,0,43000,60000,-17000,-17000
20200212,706315,晟德富邦94購01,0.55,0.55,0.55,0.55,+0.06,12.24,10000,1,5500,0,0,0,0,0,0,0,10000,-10000,-10000
20200212,706316,大學光元大94購01,7.65,8.15,7.65,8.15,+0.75,10.14,10000,4,79000,0,0,0,0,0,0,5000,7000,-2000,-2000
20200212,706317,大學光元大94購02,,,,,,0.00,0,0,0,0,0,0,0,0,0,0,0,0,0
20200212,706318,大學光元大94購03,,,,,,0.00,0,0,0,0,0,0,0,0,0,0,0,0,0
20200212,706319,六角元大94購01,1.67,1.83,1.67,1.74,+0.03,1.75,143000,11,253130,0,0,0,0,0,0,128000,143000,-15000,-15000
20200212,706320,光頡元大94購01,1.09,1.09,1.05,1.05,-0.11,-9.48,183000,10,196850,0,0,0,0,0,0,173000,10000,163000,163000
20200212,706321,宇峻元大94購01,6.70,7.00,6.45,7.00,-0.95,-11.95,31000,5,205500,0,0,0,0,0,0,1000,30000,-29000,-29000
20200212,706322,良維元大94購01,0.62,0.66,0.62,0.66,+0.07,11.86,102000,3,63290,0,0,0,0,0,0,0,102000,-102000,-102000
20200212,706323,迅得元大94購01,1.89,2.08,1.89,2.08,+0.21,11.23,68000,10,137810,0,0,0,0,0,0,12000,56000,-44000,-44000
20200212,706324,新揚科元大94購01,,,,,,0.00,0,0,0,0,0,0,0,0,0,0,0,0,0
20200212,706325,群聯元大95購02,2.15,2.27,2.15,2.27,+0.13,6.07,51000,4,113220,0,0,0,0,0,0,43000,44000,-1000,-1000
20200212,706326,網家元大94購01,0.44,0.44,0.39,0.39,-0.04,-9.3,104000,9,42730,0,0,0,0,0,0,81000,23000,58000,58000
20200212,706327,網龍元大94購01,0.36,0.36,0.36,0.36,-0.02,-5.26,10000,1,3600,0,0,0,0,0,0,10000,0,10000,10000
20200212,706328,環球晶元大94購02,,,,,,0.00,0,0,0,0,0,0,0,0,0,0,0,0,0
20200212,706329,雙美元大94購02,,,,,,0.00,0,0,0,0,0,0,0,0,0,0,0,0,0
20200212,706330,穩懋元大94購01,1.68,2.06,1.61,2.06,+0.52,33.77,265000,55,469650,0,0,0,0,0,0,181000,149000,32000,32000
20200212,706331,大學光永豐94購01,,,,,,0.00,0,0,0,0,0,0,0,0,0,0,0,0,0
20200212,706332,中美晶永豐94購01,1.16,1.22,1.05,1.05,+0.08,8.25,122000,7,144650,0,0,0,0,0,0,1000,121000,-120000,-120000
20200212,706333,光頡永豐94購01,0.41,0.41,0.41,0.41,-0.05,-10.87,104000,3,42640,0,0,0,0,0,0,84000,20000,64000,64000
20200212,706334,宇峻永豐94購01,1.59,1.59,1.43,1.53,-0.32,-17.3,65000,6,99250,0,0,0,0,0,0,40000,25000,15000,15000
20200212,706335,安勤永豐94購01,,,,,,0.00,0,0,0,0,0,0,0,0,0,0,0,0,0
20200212,706336,迅得永豐94購01,0.57,0.61,0.57,0.61,+0.10,19.61,190000,6,111000,0,0,0,0,0,0,10000,180000,-170000,-170000
20200212,706337,協益永豐94購01,,,,,,0.00,0,0,0,0,0,0,0,0,0,0,0,0,0
20200212,706338,東洋永豐94購01,0.19,0.19,0.17,0.17,0.00,0.0,60000,2,10400,0,0,0,0,0,0,0,60000,-60000,-60000
20200212,706339,長科*永豐94購01,0.05,0.05,0.05,0.05,0.00,0.0,40000,4,2000,0,0,0,0,0,0,0,40000,-40000,-40000
20200212,706340,保瑞永豐94購01,,,,,,0.00,0,0,0,0,0,0,0,0,0,0,0,0,0
20200212,706341,博智永豐94購01,2.21,2.49,2.17,2.32,+0.28,13.73,391000,42,903660,0,0,0,0,0,0,183000,208000,-25000,-25000
20200212,706342,新揚科永豐94購01,0.15,0.17,0.15,0.17,+0.03,21.43,252000,2,37840,0,0,0,0,0,0,0,252000,-252000,-252000
20200212,706343,碩禾永豐94購02,,,,,,0.00,0,0,0,0,0,0,0,0,0,0,0,0,0
20200212,706344,網家永豐94購01,,,,,,0.00,0,0,0,0,0,0,0,0,0,0,0,0,0
20200212,706345,雙鴻永豐95購01,,,,,,0.00,0,0,0,0,0,0,0,0,0,0,0,0,0
20200212,706346,弘塑康和94購01,,,,,,0.00,0,0,0,0,0,0,0,0,0,0,0,0,0
20200212,706347,安勤康和94購01,0.49,0.49,0.49,0.49,-0.01,-2.0,98000,1,48020,0,0,0,0,0,0,0,98000,-98000,-98000
20200212,706348,江興鍛康和94購01,,,,,,0.00,0,0,0,0,0,0,0,0,0,0,0,0,0
20200212,706349,長科*康和94購01,,,,,,0.00,0,0,0,0,0,0,0,0,0,0,0,0,0
20200212,706350,威剛康和94購01,,,,,,0.00,0,0,0,0,0,0,0,0,0,0,0,0,0
20200212,706351,網家康和94購01,,,,,,0.00,0,0,0,0,0,0,0,0,0,0,0,0,0
20200212,706352,穩懋日盛94購01,0.72,0.90,0.69,0.90,+0.24,36.36,803000,32,604570,0,0,0,0,0,0,487000,316000,171000,171000
20200212,706353,雙鴻第一94購01,0.20,0.23,0.20,0.23,+0.04,21.05,295000,6,63550,0,0,0,0,0,0,190000,105000,85000,85000
20200212,706354,同致元富94購01,,,,,,0.00,0,0,0,0,0,0,0,0,0,0,0,0,0
20200212,706355,新漢元富94購01,,,,,,0.00,0,0,0,0,0,0,0,0,0,0,0,0,0
20200212,706356,業強元富94購01,,,,,,0.00,0,0,0,0,0,0,0,0,0,0,0,0,0
20200212,706357,網家元富96購01,0.26,0.26,0.23,0.23,-0.03,-11.54,1473000,51,358670,0,0,0,0,0,0,598000,720000,-122000,-122000
20200212,706358,網家中信94購01,,,,,,0.00,0,0,0,0,0,0,0,0,0,0,0,0,0
20200212,706359,中美晶統一94購01,3.30,3.30,3.30,3.30,+0.53,19.13,10000,1,33000,0,0,0,0,0,0,0,10000,-10000,-10000
20200212,706360,東洋統一95購01,0.70,0.75,0.68,0.68,+0.01,1.49,190000,7,135900,0,0,0,0,0,0,0,190000,-190000,-190000
20200212,706361,環球晶統一94購01,4.00,4.00,4.00,4.00,+0.31,8.4,4000,2,16000,0,0,0,0,0,0,4000,0,4000,4000
20200212,706362,台燿凱基94購01,,,,,,0.00,0,0,0,0,0,0,0,0,0,0,0,0,0
20200212,706363,新普凱基94購01,1.05,1.05,0.97,0.97,+0.05,5.43,25000,2,25450,0,0,0,0,0,0,15000,10000,5000,5000
20200212,706364,榮剛凱基94購01,,,,,,0.00,0,0,0,0,0,0,0,0,0,0,0,0,0
20200212,706365,精華凱基94購01,,,,,,0.00,0,0,0,0,0,0,0,0,0,0,0,0,0
20200212,706366,環球晶凱基94購03,4.49,4.83,4.49,4.71,+0.37,8.53,20000,8,93320,0,0,0,0,0,0,20000,20000,0,0
20200212,706367,宇峻國票94購01,3.80,3.80,2.94,3.24,-1.28,-28.32,195000,18,644310,0,0,0,0,0,0,70000,111000,-41000,-41000
20200212,706368,廣明國票94購02,0.09,0.09,0.09,0.09,0.00,0.0,479000,1,43110,0,0,0,0,0,0,479000,0,479000,479000
20200212,706369,優群國票95購01,,,,,,0.00,0,0,0,0,0,0,0,0,0,0,0,0,0
20200212,706370,穩懋國票95購01,1.05,1.55,1.03,1.55,+0.46,42.2,222000,31,255610,0,0,0,0,0,0,135000,87000,48000,48000
20200212,706371,迅得國泰95購01,3.49,3.87,3.49,3.76,+0.42,12.57,121000,15,443460,0,0,0,0,0,0,31000,90000,-59000,-59000
20200212,706372,新揚科國泰95購01,0.60,0.63,0.60,0.61,+0.06,10.91,100000,8,61000,0,0,0,0,0,0,0,100000,-100000,-100000
20200212,706373,雙鴻國泰96購01,0.53,0.60,0.52,0.58,+0.03,5.45,796000,35,439790,0,0,0,0,0,0,382000,414000,-32000,-32000
20200212,706374,中美晶富邦95購01,,,,,,0.00,0,0,0,0,0,0,0,0,0,0,0,0,0
20200212,706375,晶焱兆豐95購01,0.48,0.50,0.48,0.50,+0.07,16.28,107000,5,52050,0,0,0,0,0,0,1000,106000,-105000,-105000
20200212,706376,合晶群益94購01,,,,,,0.00,0,0,0,0,0,0,0,0,0,0,0,0,0
20200212,706377,宇峻群益94購01,1.67,1.67,1.67,1.67,-0.44,-20.85,5000,1,8350,0,0,0,0,0,0,5000,0,5000,5000
20200212,706378,安勤群益94購01,0.41,0.41,0.41,0.41,+0.01,2.5,110000,2,45100,0,0,0,0,0,0,10000,100000,-90000,-90000
20200212,706379,宏觀群益95購01,0.17,0.17,0.16,0.16,+0.03,23.08,798000,3,134660,0,0,0,0,0,0,0,798000,-798000,-798000
20200212,706380,佳邦群益94購01,0.43,0.43,0.43,0.43,+0.03,7.5,100000,1,43000,0,0,0,0,0,0,0,100000,-100000,-100000
20200212,706381,協益群益94購01,,,,,,0.00,0,0,0,0,0,0,0,0,0,0,0,0,0
20200212,706382,皇田群益94購01,,,,,,0.00,0,0,0,0,0,0,0,0,0,0,0,0,0
20200212,706383,群聯群益96購01,4.74,4.91,4.74,4.85,+0.16,3.41,10000,4,48870,0,0,0,0,0,0,9000,1000,8000,8000
20200212,706384,網家群益94購01,0.07,0.07,0.07,0.07,-0.01,-12.5,470000,3,32900,0,0,0,0,0,0,450000,20000,430000,430000
20200212,706385,大學光永豐95購01,3.28,3.44,3.28,3.44,+0.29,9.21,31000,5,103240,0,0,0,0,0,0,0,31000,-31000,-31000
20200212,706386,迅得永豐95購01,0.73,0.80,0.73,0.80,+0.10,14.29,240000,4,185030,0,0,0,0,0,0,69000,171000,-102000,-102000
20200212,706387,新揚科永豐95購01,,,,,,0.00,0,0,0,0,0,0,0,0,0,0,0,0,0
20200212,706388,雙美永豐94購01,,,,,,0.00,0,0,0,0,0,0,0,0,0,0,0,0,0
20200212,706389,金居元富95購01,0.37,0.40,0.37,0.40,+0.04,11.11,630000,8,245450,0,0,0,0,0,0,200000,430000,-230000,-230000
20200212,706390,大江元大95購01,,,,,,0.00,0,0,0,0,0,0,0,0,0,0,0,0,0
20200212,706391,中美晶元大94購02,1.99,2.06,1.99,2.06,+0.24,13.19,2000,2,4050,0,0,0,0,0,0,1000,1000,0,0
20200212,706392,元太元大94購01,1.41,1.53,1.41,1.53,+0.13,9.29,89000,8,132670,0,0,0,0,0,0,10000,89000,-79000,-79000
20200212,706393,昇達科元大96購01,,,,,,0.00,0,0,0,0,0,0,0,0,0,0,0,0,0
20200212,706394,直得元大94購02,2.17,2.27,2.17,2.27,-0.13,-5.42,31000,6,68760,0,0,0,0,0,0,21000,10000,11000,11000
20200212,706395,威剛元大95購01,4.15,4.54,4.05,4.32,+0.36,9.09,88000,23,376730,0,0,0,0,0,0,46000,47000,-1000,-1000
20200212,706396,神盾元大95購02,,,,,,0.00,0,0,0,0,0,0,0,0,0,0,0,0,0
20200212,706397,順達元大94購01,,,,,,0.00,0,0,0,0,0,0,0,0,0,0,0,0,0
20200212,706398,優群元大95購01,1.44,1.49,1.44,1.49,+0.09,6.43,107000,13,155330,0,0,0,0,0,0,83000,35000,48000,48000
20200212,706399,環球晶元大94購04,6.65,6.90,6.50,6.85,+0.30,4.58,14000,8,94200,0,0,0,0,0,0,14000,8000,6000,6000
20200212,706400,環球晶中信94購01,2.03,2.04,1.99,2.04,+0.07,3.55,28000,4,56740,0,0,0,0,0,0,18000,10000,8000,8000
20200212,706401,大學光凱基94購01,2.31,2.31,2.31,2.31,+0.09,4.05,10000,1,23100,0,0,0,0,0,0,10000,0,10000,10000
20200212,706402,立端凱基94購02,,,,,,0.00,0,0,0,0,0,0,0,0,0,0,0,0,0
20200212,706403,穩懋凱基94購05,1.72,2.09,1.66,2.09,+0.60,40.27,248000,19,493830,0,0,0,0,0,0,228000,218000,10000,10000
20200212,706404,宏捷科元富94購01,1.88,2.15,1.88,1.94,+0.28,16.87,121000,8,233250,0,0,0,0,0,0,90000,0,90000,90000
20200212,706405,原相元富95購01,,,,,,0.00,0,0,0,0,0,0,0,0,0,0,0,0,0
20200212,706406,大中元大94購01,0.54,0.54,0.54,0.54,+0.07,14.89,100000,1,54000,0,0,0,0,0,0,0,100000,-100000,-100000
20200212,706407,中美晶元大94購03,3.21,3.59,3.12,3.12,+0.12,4.0,22000,5,74330,0,0,0,0,0,0,1000,21000,-20000,-20000
20200212,706408,昂寶元大96購01,2.04,2.04,2.04,2.04,-0.01,-0.49,10000,1,20400,0,0,0,0,0,0,0,10000,-10000,-10000
20200212,706409,金居元大95購01,0.58,0.59,0.58,0.59,+0.03,5.36,130000,9,75900,0,0,0,0,0,0,130000,0,130000,130000
20200212,706410,信昌電元大96購01,1.20,1.20,1.16,1.16,-0.03,-2.52,165000,14,194200,0,0,0,0,0,0,165000,50000,115000,115000
20200212,706411,保瑞元大95購01,0.34,0.34,0.34,0.34,+0.03,9.68,78000,1,26520,0,0,0,0,0,0,78000,0,78000,78000
20200212,706412,宣德元大95購02,1.09,1.16,1.08,1.16,-0.03,-2.52,613000,32,689210,0,0,0,0,0,0,603000,431000,172000,172000
20200212,706413,建榮元大94購02,,,,,,0.00,0,0,0,0,0,0,0,0,0,0,0,0,0
20200212,706414,晶焱元大95購01,0.90,0.90,0.90,0.90,+0.12,15.38,1000,1,900,0,0,0,0,0,0,0,1000,-1000,-1000
20200212,706415,緯軟元大96購02,0.45,0.45,0.44,0.44,+0.02,4.76,200000,2,89000,0,0,0,0,0,0,200000,0,200000,200000
20200212,706416,優群元大94購01,1.76,1.76,1.76,1.76,+0.15,9.32,10000,1,17600,0,0,0,0,0,0,0,10000,-10000,-10000
20200212,706417,雙鴻元大97購01,0.42,0.47,0.41,0.45,+0.01,2.27,1251000,24,555190,0,0,0,0,0,0,1131000,112000,1019000,1019000
20200212,706418,穩懋元大94購04,2.52,3.12,2.42,2.95,+0.51,20.9,537000,104,1431440,0,0,0,0,0,0,416000,466000,-50000,-50000
20200212,706419,鈺太元大96購01,,,,,,0.00,0,0,0,0,0,0,0,0,0,0,0,0,0
20200212,706420,宏捷科台新94購01,1.40,1.50,1.40,1.49,+0.32,27.35,125000,5,185450,0,0,0,0,0,0,5000,105000,-100000,-100000
20200212,706421,大江兆豐94購01,,,,,,0.00,0,0,0,0,0,0,0,0,0,0,0,0,0
20200212,706422,大江群益94購04,,,,,,0.00,0,0,0,0,0,0,0,0,0,0,0,0,0
20200212,706423,宏觀群益96購01,0.22,0.26,0.22,0.26,+0.06,30.0,105000,2,24700,0,0,0,0,0,0,65000,40000,25000,25000
20200212,706424,泰博群益94購01,0.84,0.87,0.83,0.83,+0.02,2.47,184000,28,154180,0,0,0,0,0,0,36000,138000,-102000,-102000
20200212,706425,新揚科群益94購01,,,,,,0.00,0,0,0,0,0,0,0,0,0,0,0,0,0
20200212,706426,群聯群益94購01,,,,,,0.00,0,0,0,0,0,0,0,0,0,0,0,0,0
20200212,706427,雙鴻群益96購01,0.42,0.51,0.42,0.50,+0.02,4.17,112000,27,53810,0,0,0,0,0,0,35000,66000,-31000,-31000
20200212,706428,鐿鈦群益95購01,,,,,,0.00,0,0,0,0,0,0,0,0,0,0,0,0,0
20200212,706429,宇峻國票95購01,,,,,,0.00,0,0,0,0,0,0,0,0,0,0,0,0,0
20200212,706430,建榮國票96購01,,,,,,0.00,0,0,0,0,0,0,0,0,0,0,0,0,0
20200212,706431,神盾國票94購03,0.12,0.12,0.12,0.12,+0.01,9.09,45000,1,5400,0,0,0,0,0,0,45000,0,45000,45000
20200212,706432,環球晶國票95購01,,,,,,0.00,0,0,0,0,0,0,0,0,0,0,0,0,0
20200212,706433,譜瑞國票94購01,4.12,4.49,4.12,4.49,+0.81,22.01,68000,9,293100,0,0,0,0,0,0,0,68000,-68000,-68000
20200212,706434,宏捷科國泰95購01,1.77,1.96,1.76,1.79,+0.17,10.49,1091000,46,1975530,0,0,0,0,0,0,882000,159000,723000,723000
20200212,706435,保瑞國泰95購03,,,,,,0.00,0,0,0,0,0,0,0,0,0,0,0,0,0
20200212,706436,穩懋富邦96購01,1.81,2.09,1.75,2.04,+0.28,15.91,1866000,117,3495450,0,0,0,0,0,0,932000,1005000,-73000,-73000
20200212,706437,新普第一94購01,,,,,,0.00,0,0,0,0,0,0,0,0,0,0,0,0,0
20200212,706438,櫃200第一94購01,,,,,,0.00,0,0,0,0,0,0,0,0,0,0,0,0,0
20200212,706439,上詮永豐94購02,,,,,,0.00,0,0,0,0,0,0,0,0,0,0,0,0,0
20200212,706440,宏捷科永豐95購01,1.03,1.20,1.00,1.09,+0.14,14.74,1302000,93,1444780,1000,0,1000,0,0,0,568000,548000,20000,21000
20200212,706441,神盾永豐94購01,,,,,,0.00,0,0,0,0,0,0,0,0,0,0,0,0,0
20200212,706442,安勤中信94購01,,,,,,0.00,0,0,0,0,0,0,0,0,0,0,0,0,0
20200212,706443,璟德統一94購01,4.58,4.85,4.58,4.74,-0.22,-4.44,127000,9,592630,0,0,0,0,0,0,107000,20000,87000,87000
20200212,706444,雙鴻統一94購02,0.08,0.08,0.08,0.08,0.00,0.0,195000,1,15600,0,0,0,0,0,0,195000,0,195000,195000
20200212,706445,緯軟麥證95購01,0.14,0.14,0.14,0.14,0.00,0.0,50000,1,7000,0,50000,-50000,0,0,0,0,50000,-50000,-50000
20200212,706446,雙鴻麥證96購01,0.36,0.40,0.35,0.39,+0.01,2.63,53000,8,20030,21000,32000,-11000,0,0,0,21000,32000,-11000,-11000
20200212,706447,中美晶元富95購02,,,,,,0.00,0,0,0,0,0,0,0,0,0,0,0,0,0
20200212,706448,威剛元富97購01,5.50,6.00,5.50,5.75,+0.30,5.5,487000,37,2783850,0,0,0,0,0,0,180000,302000,-122000,-122000
20200212,706449,大江元大94購02,0.07,0.07,0.07,0.07,0.00,0.0,290000,6,20300,0,0,0,0,0,0,0,290000,-290000,-290000
20200212,706450,中美晶元大94購04,4.09,4.35,4.09,4.35,+0.38,9.57,7000,4,29710,0,0,0,0,0,0,1000,6000,-5000,-5000
20200212,706451,中美晶元大94購05,4.46,4.71,4.46,4.71,+0.36,8.28,7000,4,32270,0,0,0,0,0,0,1000,6000,-5000,-5000
20200212,706452,保瑞元大94購01,,,,,,0.00,0,0,0,0,0,0,0,0,0,0,0,0,0
20200212,706453,美琪瑪元大95購01,,,,,,0.00,0,0,0,0,0,0,0,0,0,0,0,0,0
20200212,706454,茂達元大94購01,,,,,,0.00,0,0,0,0,0,0,0,0,0,0,0,0,0
20200212,706455,原相元大94購03,,,,,,0.00,0,0,0,0,0,0,0,0,0,0,0,0,0
20200212,706456,神盾元大95購03,0.78,0.83,0.77,0.79,+0.08,11.27,254000,22,205110,0,0,0,0,0,0,252000,7000,245000,245000
20200212,706457,晶焱元大94購02,,,,,,0.00,0,0,0,0,0,0,0,0,0,0,0,0,0
20200212,706458,群聯元大95購03,1.32,1.37,1.28,1.33,+0.03,2.31,199000,29,270120,0,0,0,0,0,0,64000,150000,-86000,-86000
20200212,706459,環球晶元大94購05,6.20,6.20,6.20,6.20,0.00,0.0,2000,1,12400,0,0,0,0,0,0,2000,0,2000,2000
20200212,706460,穩懋元大94購05,1.72,2.27,1.65,2.09,+0.45,27.44,333000,52,619190,0,0,0,0,0,0,233000,199000,34000,34000
20200212,706461,元太富邦96購01,0.66,0.72,0.66,0.72,+0.07,10.77,571000,24,392650,0,0,0,0,0,0,196000,439000,-243000,-243000
20200212,706462,鐿鈦國票95購02,,,,,,0.00,0,0,0,0,0,0,0,0,0,0,0,0,0
20200212,706463,中美晶凱基94購01,2.33,2.33,2.33,2.33,+0.43,22.63,12000,4,27960,0,0,0,0,0,0,12000,12000,0,0
20200212,706464,由田凱基94購02,,,,,,0.00,0,0,0,0,0,0,0,0,0,0,0,0,0
20200212,706465,立端凱基94購03,,,,,,0.00,0,0,0,0,0,0,0,0,0,0,0,0,0
20200212,706466,良維凱基94購01,,,,,,0.00,0,0,0,0,0,0,0,0,0,0,0,0,0
20200212,706467,迅得凱基94購01,0.91,0.93,0.89,0.89,+0.09,11.25,615000,12,561050,0,0,0,0,0,0,540000,70000,470000,470000
20200212,706468,波若威凱基94購01,,,,,,0.00,0,0,0,0,0,0,0,0,0,0,0,0,0
20200212,706469,宣德凱基94購01,1.22,1.30,1.18,1.30,-0.14,-9.72,157000,27,193770,0,0,0,0,0,0,118000,39000,79000,79000
20200212,706470,博智凱基94購01,3.19,3.63,0.76,3.39,+0.35,11.51,193000,15,619980,0,0,0,0,0,0,142000,51000,91000,91000
20200212,706471,群聯凱基94購01,,,,,,0.00,0,0,0,0,0,0,0,0,0,0,0,0,0
20200212,706472,精華凱基94購02,,,,,,0.00,0,0,0,0,0,0,0,0,0,0,0,0,0
20200212,706473,優群凱基94購01,,,,,,0.00,0,0,0,0,0,0,0,0,0,0,0,0,0
20200212,706474,聯亞凱基94購02,1.52,1.52,1.47,1.47,+0.10,7.3,47000,2,69140,0,0,0,0,0,0,0,47000,-47000,-47000
20200212,706475,元太兆豐95購01,0.41,0.43,0.41,0.43,+0.02,4.88,110000,6,46000,0,0,0,0,0,0,0,110000,-110000,-110000
20200212,706476,雙美兆豐94購01,,,,,,0.00,0,0,0,0,0,0,0,0,0,0,0,0,0
20200212,706477,雙鴻兆豐95購01,,,,,,0.00,0,0,0,0,0,0,0,0,0,0,0,0,0
20200212,706478,大田群益94購01,,,,,,0.00,0,0,0,0,0,0,0,0,0,0,0,0,0
20200212,706479,中美晶群益94購01,1.85,2.13,1.85,2.13,+0.24,12.7,153000,8,312780,0,0,0,0,0,0,11000,142000,-131000,-131000
20200212,706480,宏捷科群益94購01,0.73,0.86,0.72,0.76,+0.11,16.92,1531000,53,1185740,0,0,0,0,0,0,1038000,478000,560000,560000
20200212,706481,雙鴻群益96購02,0.29,0.35,0.29,0.35,+0.02,6.06,120000,21,39070,0,0,0,0,0,0,44000,76000,-32000,-32000
20200212,706482,中美晶亞東94購01,1.58,1.67,1.58,1.67,+0.20,13.61,15000,2,24150,0,0,0,0,0,0,0,15000,-15000,-15000
20200212,706483,元太亞東94購01,,,,,,0.00,0,0,0,0,0,0,0,0,0,0,0,0,0
20200212,706484,大江永豐94購02,,,,,,0.00,0,0,0,0,0,0,0,0,0,0,0,0,0
20200212,706485,宏觀永豐94購01,,,,,,0.00,0,0,0,0,0,0,0,0,0,0,0,0,0
20200212,706486,威剛永豐94購01,3.88,4.32,3.88,4.13,+0.41,11.02,14000,3,59470,0,0,0,0,0,0,1000,13000,-12000,-12000
20200212,706487,雙美永豐94購02,0.03,0.04,0.03,0.04,+0.03,300.0,385000,39,11600,0,0,0,0,0,0,0,385000,-385000,-385000
20200212,706488,雙鴻永豐95購02,,,,,,0.00,0,0,0,0,0,0,0,0,0,0,0,0,0
20200212,706489,譜瑞永豐94購01,0.66,0.80,0.66,0.74,+0.12,19.35,389000,26,296870,0,0,0,0,0,0,112000,316000,-204000,-204000
20200212,706490,鈺太中信94購01,1.44,1.89,1.44,1.89,+0.48,34.04,529000,36,852520,0,0,0,0,0,0,20000,509000,-489000,-489000
20200212,706491,六角凱基94購01,1.02,1.14,1.02,1.07,+0.20,22.99,124000,8,130390,0,0,0,0,0,0,57000,67000,-10000,-10000
20200212,706492,立端凱基94購04,,,,,,0.00,0,0,0,0,0,0,0,0,0,0,0,0,0
20200212,706493,合晶凱基94購01,0.36,0.36,0.36,0.36,+0.12,50.0,105000,2,37800,0,0,0,0,0,0,0,105000,-105000,-105000
20200212,706494,昇達科凱基94購01,,,,,,0.00,0,0,0,0,0,0,0,0,0,0,0,0,0
20200212,706495,新普凱基94購02,2.22,2.24,2.22,2.24,+0.17,8.21,22000,2,49040,0,0,0,0,0,0,0,22000,-22000,-22000
20200212,706496,穩懋凱基94購06,2.22,2.84,2.16,2.64,+0.50,23.36,81000,37,195000,0,0,0,0,0,0,71000,40000,31000,31000
20200212,706497,譜瑞凱基94購03,2.09,2.10,1.93,2.05,+0.32,18.5,66000,15,133720,0,0,0,0,0,0,26000,64000,-38000,-38000
20200212,706498,晟德凱基94購01,,,,,,0.00,0,0,0,0,0,0,0,0,0,0,0,0,0
20200212,706499,大中永豐94購01,,,,,,0.00,0,0,0,0,0,0,0,0,0,0,0,0,0
20200212,706500,信驊永豐94購01,0.93,0.93,0.93,0.93,-0.08,-7.92,1000,1,930,0,0,0,0,0,0,1000,0,1000,1000
20200212,706501,網龍永豐95購01,0.26,0.26,0.26,0.26,+0.03,13.04,150000,2,39000,0,0,0,0,0,0,0,150000,-150000,-150000
20200212,706502,雙鴻永豐95購03,,,,,,0.00,0,0,0,0,0,0,0,0,0,0,0,0,0
20200212,706503,鈺太永豐94購02,1.08,1.43,1.06,1.43,+0.37,34.91,127000,12,152150,0,0,0,0,0,0,37000,90000,-53000,-53000
20200212,706504,精華日盛94購01,,,,,,0.00,0,0,0,0,0,0,0,0,0,0,0,0,0
20200212,706505,雙美日盛94購01,,,,,,0.00,0,0,0,0,0,0,0,0,0,0,0,0,0
20200212,706506,元太統一94購01,0.98,1.07,0.98,1.07,+0.11,11.46,140000,6,142300,0,0,0,0,0,0,70000,70000,0,0
20200212,706507,譜瑞統一94購02,1.66,1.94,1.62,1.82,+0.26,16.67,428000,37,769500,0,0,0,0,0,0,174000,254000,-80000,-80000
20200212,706508,大江兆豐95購01,,,,,,0.00,0,0,0,0,0,0,0,0,0,0,0,0,0
20200212,706509,台燿兆豐94購02,0.45,0.47,0.45,0.47,+0.12,34.29,315000,6,145450,0,0,0,0,0,0,80000,235000,-155000,-155000
20200212,706510,新普兆豐94購01,1.29,1.30,1.19,1.19,+0.03,2.59,183000,6,235700,0,0,0,0,0,0,113000,70000,43000,43000
20200212,706511,精華兆豐95購01,,,,,,0.00,0,0,0,0,0,0,0,0,0,0,0,0,0
20200212,706512,直得群益94購01,1.58,1.68,1.58,1.64,-0.01,-0.61,43000,5,69600,0,0,0,0,0,0,23000,20000,3000,3000
20200212,706513,金居群益96購01,0.43,0.44,0.43,0.44,+0.09,25.71,22000,2,9570,0,0,0,0,0,0,0,22000,-22000,-22000
20200212,706514,鈺太元富94購01,2.46,3.17,2.46,3.17,+0.92,40.89,148000,16,396540,0,0,0,0,0,0,0,148000,-148000,-148000
20200212,706515,保瑞台新94購01,,,,,,0.00,0,0,0,0,0,0,0,0,0,0,0,0,0
20200212,706516,大田元大96購01,,,,,,0.00,0,0,0,0,0,0,0,0,0,0,0,0,0
20200212,706517,大江元大95購02,,,,,,0.00,0,0,0,0,0,0,0,0,0,0,0,0,0
20200212,706518,杰力元大96購01,0.47,0.50,0.47,0.50,+0.02,4.17,74000,5,35690,0,0,0,0,0,0,64000,10000,54000,54000
20200212,706519,雙美元大94購03,,,,,,0.00,0,0,0,0,0,0,0,0,0,0,0,0,0
20200212,706520,穩懋元大94購06,1.95,2.54,1.88,2.39,+0.50,26.46,410000,85,836360,0,0,0,0,0,0,297000,214000,83000,83000
20200212,706521,譜瑞元大94購01,3.11,3.51,3.09,3.30,+0.40,13.79,123000,22,409660,0,0,0,0,0,0,72000,85000,-13000,-13000
20200212,706522,鈺太元大94購01,3.21,3.76,3.21,3.76,+0.53,16.41,23000,3,84130,0,0,0,0,0,0,3000,20000,-17000,-17000
20200212,706523,M31國票95購01,0.40,0.40,0.40,0.40,+0.05,14.29,10000,1,4000,0,0,0,0,0,0,0,10000,-10000,-10000
20200212,706524,中美晶國票94購02,3.96,4.38,3.96,4.24,+0.80,23.26,47000,7,198700,0,0,0,0,0,0,3000,44000,-41000,-41000
20200212,706525,信昌電國票94購02,1.40,1.40,1.36,1.36,-0.10,-6.85,25000,4,34410,0,0,0,0,0,0,25000,0,25000,25000
20200212,706526,是方國票94購01,,,,,,0.00,0,0,0,0,0,0,0,0,0,0,0,0,0
20200212,706527,晶焱國票95購01,0.81,0.83,0.81,0.83,+0.10,13.7,40000,4,32800,0,0,0,0,0,0,0,40000,-40000,-40000
20200212,706528,廣明國票95購01,,,,,,0.00,0,0,0,0,0,0,0,0,0,0,0,0,0
20200212,706529,M31國泰96購01,0.45,0.49,0.45,0.49,+0.06,13.95,310000,2,140300,0,0,0,0,0,0,290000,20000,270000,270000
20200212,706530,群聯國泰96購01,,,,,,0.00,0,0,0,0,0,0,0,0,0,0,0,0,0
20200212,706531,雙鴻國泰96購02,0.30,0.35,0.30,0.35,+0.04,12.9,117000,21,39340,0,0,0,0,0,0,45000,72000,-27000,-27000
20200212,706532,勝麗凱基94購01,1.95,2.21,1.95,2.06,+0.10,5.1,171000,10,341670,0,0,0,0,0,0,161000,22000,139000,139000
20200212,706533,凡甲統一94購01,0.62,0.68,0.62,0.67,-0.03,-4.29,1386000,26,898410,0,0,0,0,0,0,1282000,30000,1252000,1252000
20200212,706534,元太統一94購02,1.46,1.59,1.46,1.59,+0.14,9.66,317000,21,473990,0,0,0,0,0,0,0,317000,-317000,-317000
20200212,706535,東洋統一94購01,0.58,0.63,0.58,0.63,+0.10,18.87,58000,2,34140,0,0,0,0,0,0,10000,48000,-38000,-38000
20200212,706536,大中元大95購01,0.83,0.84,0.83,0.84,+0.04,5.0,133000,4,110590,0,0,0,0,0,0,130000,3000,127000,127000
20200212,706537,元太元大95購01,1.41,1.49,1.41,1.49,+0.18,13.74,52000,6,75520,0,0,0,0,0,0,10000,52000,-42000,-42000
20200212,706538,宏觀元大95購01,0.09,0.09,0.09,0.09,+0.01,12.5,3000,1,270,0,0,0,0,0,0,3000,0,3000,3000
20200212,706539,信昌電元大95購01,1.92,1.92,1.84,1.84,-0.11,-5.64,123000,11,231930,0,0,0,0,0,0,123000,26000,97000,97000
20200212,706540,保瑞元大95購02,,,,,,0.00,0,0,0,0,0,0,0,0,0,0,0,0,0
20200212,706541,神盾元大95購05,,,,,,0.00,0,0,0,0,0,0,0,0,0,0,0,0,0
20200212,706542,精華元大95購01,1.19,1.19,1.16,1.19,+0.03,2.59,200000,4,236000,0,0,0,0,0,0,100000,100000,0,0
20200212,706543,聯亞元大95購01,1.39,1.41,1.36,1.36,+0.04,3.03,28000,4,38580,0,0,0,0,0,0,28000,14000,14000,14000
20200212,706544,譜瑞元大95購01,3.95,4.43,3.95,4.31,+0.71,19.72,50000,12,206090,0,0,0,0,0,0,24000,20000,4000,4000
20200212,706545,元太元富94購01,0.59,0.64,0.59,0.64,+0.09,16.36,6000,5,3690,0,0,0,0,0,0,0,6000,-6000,-6000
20200212,706546,建榮元富95購01,,,,,,0.00,0,0,0,0,0,0,0,0,0,0,0,0,0
20200212,706547,昇達科兆豐95購01,0.37,0.37,0.37,0.37,+0.04,12.12,100000,2,37000,0,0,0,0,0,0,0,100000,-100000,-100000
20200212,706548,M31國票95購02,0.24,0.24,0.24,0.24,+0.03,14.29,20000,2,4800,0,0,0,0,0,0,0,20000,-20000,-20000
20200212,706549,大江國票95購01,,,,,,0.00,0,0,0,0,0,0,0,0,0,0,0,0,0
20200212,706550,宏捷科國票95購02,1.66,1.90,1.66,1.73,+0.22,14.57,1459000,80,2583370,0,0,0,0,0,0,965000,354000,611000,611000
20200212,706551,雙鴻國票95購01,0.22,0.27,0.22,0.27,+0.02,8.0,100000,15,24330,0,0,0,0,0,0,60000,40000,20000,20000
20200212,706552,同致群益94購01,,,,,,0.00,0,0,0,0,0,0,0,0,0,0,0,0,0
20200212,706553,信驊群益94購01,3.08,3.17,3.04,3.04,-0.25,-7.6,46000,5,142740,0,0,0,0,0,0,26000,36000,-10000,-10000
20200212,706554,神盾群益96購01,0.15,0.15,0.13,0.13,0.00,0.0,35000,2,4650,0,0,0,0,0,0,30000,5000,25000,25000
20200212,706555,鈺太群益94購01,3.97,5.20,3.97,5.20,+1.33,34.37,31000,4,141870,0,0,0,0,0,0,11000,20000,-9000,-9000
20200212,706556,由田富邦96購01,,,,,,0.00,0,0,0,0,0,0,0,0,0,0,0,0,0
20200212,706557,櫃200永昌94購01,1.64,1.64,1.64,1.64,+0.22,15.49,37000,1,60680,0,0,0,0,0,0,0,37000,-37000,-37000
20200212,706558,櫃200永昌94購02,,,,,,0.00,0,0,0,0,0,0,0,0,0,0,0,0,0
20200212,706559,閎康永豐94購01,,,,,,0.00,0,0,0,0,0,0,0,0,0,0,0,0,0
20200212,706560,優群永豐94購02,1.37,1.43,1.37,1.43,+0.12,9.16,297000,8,412790,0,0,0,0,0,0,87000,210000,-123000,-123000
20200212,706561,雙美永豐95購01,,,,,,0.00,0,0,0,0,0,0,0,0,0,0,0,0,0
20200212,706562,鈺太永豐94購03,1.38,1.68,1.38,1.68,+0.35,26.32,122000,14,181780,0,0,0,0,0,0,22000,122000,-100000,-100000
20200212,706563,凡甲永豐94購01,0.27,0.27,0.27,0.27,+0.03,12.5,20000,1,5400,0,0,0,0,0,0,20000,0,20000,20000
20200212,706564,元太群益95購01,1.17,1.21,1.17,1.21,+0.03,2.54,413000,8,487710,0,0,0,0,0,0,0,413000,-413000,-413000
20200212,706565,環球晶群益94購02,5.55,5.95,5.55,5.85,+0.40,7.34,44000,12,253700,0,0,0,0,0,0,29000,33000,-4000,-4000
20200212,706566,雙美群益94購01,0.07,0.07,0.07,0.07,+0.03,75.0,350000,1,24500,0,0,0,0,0,0,350000,0,350000,350000
20200212,706567,建榮麥證94購01,,,,,,0.00,0,0,0,0,0,0,0,0,0,0,0,0,0
20200212,706568,大江台新94購01,,,,,,0.00,0,0,0,0,0,0,0,0,0,0,0,0,0
20200212,706569,金居國票95購01,0.52,0.54,0.50,0.54,+0.13,31.71,160000,7,83600,0,0,0,0,0,0,10000,150000,-140000,-140000
20200212,706570,泰博國票95購02,3.28,3.28,3.23,3.23,+0.16,5.21,58000,2,188140,0,0,0,0,0,0,58000,0,58000,58000
20200212,706571,大江元大94購03,,,,,,0.00,0,0,0,0,0,0,0,0,0,0,0,0,0
20200212,706572,宏捷科元大95購01,0.69,0.84,0.69,0.75,+0.07,10.29,2417000,134,1904850,0,0,0,0,0,0,981000,900000,81000,81000
20200212,706573,金可元大94購01,1.29,1.29,1.29,1.29,-0.01,-0.77,10000,1,12900,0,0,0,0,0,0,10000,0,10000,10000
20200212,706574,建榮元大97購01,0.40,0.40,0.40,0.40,-0.01,-2.44,2000,1,800,0,0,0,0,0,0,0,2000,-2000,-2000
20200212,706575,上詮凱基94購02,0.15,0.15,0.15,0.15,+0.01,7.14,300000,1,45000,0,0,0,0,0,0,300000,0,300000,300000
20200212,706576,金可凱基94購01,1.27,1.34,1.27,1.34,+0.13,10.74,139000,4,180810,0,0,0,0,0,0,50000,89000,-39000,-39000
20200212,706577,信昌電凱基94購01,1.46,1.46,1.43,1.43,-0.19,-11.73,30000,2,43410,0,0,0,0,0,0,30000,0,30000,30000
20200212,706578,聚積凱基94購02,1.02,1.06,1.02,1.06,+0.11,11.58,115000,10,118920,0,0,0,0,0,0,115000,0,115000,115000
20200212,706579,晟德凱基94購03,,,,,,0.00,0,0,0,0,0,0,0,0,0,0,0,0,0
20200212,706580,櫃200富邦94購01,,,,,,0.00,0,0,0,0,0,0,0,0,0,0,0,0,0
20200212,706581,櫃200富邦94購02,,,,,,0.00,0,0,0,0,0,0,0,0,0,0,0,0,0
20200212,706582,櫃200富邦94購03,,,,,,0.00,0,0,0,0,0,0,0,0,0,0,0,0,0
20200212,706583,櫃200富邦94購04,,,,,,0.00,0,0,0,0,0,0,0,0,0,0,0,0,0
20200212,706584,神盾國票95購02,,,,,,0.00,0,0,0,0,0,0,0,0,0,0,0,0,0
20200212,706585,宏捷科國泰95購03,0.62,0.73,0.62,0.70,+0.15,27.27,640000,53,446050,0,0,0,0,0,0,30000,25000,5000,5000
20200212,706586,凡甲統一95購01,0.33,0.33,0.33,0.33,-0.02,-5.71,60000,7,19800,0,0,0,0,0,0,60000,0,60000,60000
20200212,706587,凡甲統一95購02,0.37,0.39,0.37,0.38,-0.03,-7.32,81000,9,30480,0,0,0,0,0,0,81000,0,81000,81000
20200212,706588,雙美統一95購01,1.00,1.00,0.33,0.87,+0.25,40.32,6000,5,3850,0,0,0,0,0,0,0,2000,-2000,-2000
20200212,706589,VHQ凱基94購01,,,,,,0.00,0,0,0,0,0,0,0,0,0,0,0,0,0
20200212,706590,宏捷科凱基94購01,0.38,0.40,0.29,0.38,+0.03,8.57,267000,12,96810,0,0,0,0,0,0,0,0,0,0
20200212,706591,宏捷科凱基94購02,0.40,0.52,0.38,0.48,+0.12,33.33,470000,23,215640,0,0,0,0,0,0,257000,8000,249000,249000
20200212,706592,環球晶凱基94購05,5.10,5.15,5.10,5.15,+0.15,3.0,13000,5,66400,0,0,0,0,0,0,13000,13000,0,0
20200212,706593,均豪永豐94購01,,,,,,0.00,0,0,0,0,0,0,0,0,0,0,0,0,0
20200212,706594,杰力永豐94購01,,,,,,0.00,0,0,0,0,0,0,0,0,0,0,0,0,0
20200212,706595,宣德永豐94購01,0.73,0.79,0.73,0.79,-0.07,-8.14,50000,3,37100,0,0,0,0,0,0,50000,0,50000,50000
20200212,706596,建榮永豐96購01,,,,,,0.00,0,0,0,0,0,0,0,0,0,0,0,0,0
20200212,706597,神準永豐94購01,0.11,0.11,0.11,0.11,0.00,0.0,40000,2,4400,0,0,0,0,0,0,40000,0,40000,40000
20200212,706598,碩禾永豐95購01,0.70,0.70,0.65,0.65,-0.05,-7.14,176000,7,119550,0,0,0,0,0,0,95000,81000,14000,14000
20200212,706599,環宇永豐94購01,0.31,0.31,0.31,0.31,+0.02,6.9,1000,1,310,0,0,0,0,0,0,1000,0,1000,1000
20200212,706600,環球晶永豐94購02,1.04,1.13,1.04,1.13,+0.08,7.62,24000,5,26090,0,0,0,0,0,0,22000,5000,17000,17000
20200212,706601,聯亞永豐94購02,1.12,1.12,1.04,1.04,+0.05,5.05,29000,5,31330,0,0,0,0,0,0,19000,19000,0,0
20200212,706602,大江元大96購01,0.16,0.16,0.16,0.16,0.00,0.0,200000,2,32000,0,0,0,0,0,0,0,200000,-200000,-200000
20200212,706603,信驊元大94購01,,,,,,0.00,0,0,0,0,0,0,0,0,0,0,0,0,0
20200212,706604,勝麗元大95購01,2.10,2.30,2.10,2.28,+0.23,11.22,50000,8,109100,0,0,0,0,0,0,45000,5000,40000,40000
20200212,706605,環球晶元富94購03,,,,,,0.00,0,0,0,0,0,0,0,0,0,0,0,0,0
20200212,706606,M31兆豐94購01,0.10,0.10,0.10,0.10,+0.01,11.11,499000,1,49900,0,0,0,0,0,0,499000,0,499000,499000
20200212,706607,中美晶兆豐95購02,0.96,1.06,0.94,0.95,+0.01,1.06,375000,26,367060,0,0,0,0,0,0,136000,239000,-103000,-103000
20200212,706608,六角台新94購02,2.19,2.19,2.19,2.19,+0.33,17.74,2000,1,4380,0,0,0,0,0,0,2000,0,2000,2000
20200212,706609,威剛台新94購01,4.84,4.84,4.84,4.84,+0.28,6.14,3000,1,14520,0,0,0,0,0,0,0,3000,-3000,-3000
20200212,706610,昂寶群益95購01,2.60,2.60,2.60,2.60,-0.02,-0.76,10000,1,26000,0,0,0,0,0,0,0,10000,-10000,-10000
20200212,706611,杰力群益94購01,,,,,,0.00,0,0,0,0,0,0,0,0,0,0,0,0,0
20200212,706612,原相群益97購01,6.35,6.35,6.35,6.35,0.00,0.0,20000,1,127000,0,0,0,0,0,0,20000,0,20000,20000
20200212,706613,環球晶群益94購03,1.98,2.15,1.98,2.09,+0.15,7.73,42000,10,86570,0,0,0,0,0,0,32000,18000,14000,14000
20200212,706614,櫃200永昌96購01,,,,,,0.00,0,0,0,0,0,0,0,0,0,0,0,0,0
20200212,706615,櫃200永昌96購02,,,,,,0.00,0,0,0,0,0,0,0,0,0,0,0,0,0
20200212,706616,櫃200永昌96購03,,,,,,0.00,0,0,0,0,0,0,0,0,0,0,0,0,0
20200212,706617,M31中信95購01,0.11,0.11,0.11,0.11,+0.01,10.0,499000,1,54890,0,0,0,0,0,0,499000,0,499000,499000
20200212,706618,原相國泰96購01,,,,,,0.00,0,0,0,0,0,0,0,0,0,0,0,0,0
20200212,706619,環球晶國泰95購01,4.19,4.24,4.09,4.24,+0.16,3.92,28000,5,117460,0,0,0,0,0,0,28000,6000,22000,22000
20200212,706620,宜鼎凱基94購02,3.07,3.07,3.07,3.07,+0.25,8.87,14000,2,42980,0,0,0,0,0,0,14000,0,14000,14000
20200212,706621,泰博凱基94購01,1.20,1.20,1.18,1.20,+0.05,4.35,75000,3,89800,0,0,0,0,0,0,50000,25000,25000,25000
20200212,706622,優群凱基94購02,0.79,0.79,0.79,0.79,+0.07,9.72,50000,1,39500,0,0,0,0,0,0,0,50000,-50000,-50000
20200212,706623,雙鴻凱基94購01,,,,,,0.00,0,0,0,0,0,0,0,0,0,0,0,0,0
20200212,706624,雙鴻凱基96購01,0.21,0.23,0.21,0.23,+0.03,15.0,120000,3,25500,0,0,0,0,0,0,20000,100000,-80000,-80000
20200212,706625,大宇資永豐94購02,0.06,0.06,0.06,0.06,0.00,0.0,30000,1,1800,0,0,0,0,0,0,30000,0,30000,30000
20200212,706626,立端永豐94購01,,,,,,0.00,0,0,0,0,0,0,0,0,0,0,0,0,0
20200212,706627,同致永豐94購01,,,,,,0.00,0,0,0,0,0,0,0,0,0,0,0,0,0
20200212,706628,安勤永豐94購02,,,,,,0.00,0,0,0,0,0,0,0,0,0,0,0,0,0
20200212,706629,信昌電永豐94購03,0.86,0.86,0.86,0.86,-0.01,-1.15,50000,1,43000,0,0,0,0,0,0,0,50000,-50000,-50000
20200212,706630,威剛永豐94購02,,,,,,0.00,0,0,0,0,0,0,0,0,0,0,0,0,0
20200212,706631,櫃200第一96購01,,,,,,0.00,0,0,0,0,0,0,0,0,0,0,0,0,0
20200212,706632,聚積元富94購01,0.41,0.42,0.41,0.42,+0.04,10.53,54000,7,22270,0,0,0,0,0,0,54000,0,54000,54000
20200212,706633,合晶台新95購01,0.87,1.00,0.87,1.00,+0.21,26.58,168000,5,148790,0,0,0,0,0,0,5000,163000,-158000,-158000
20200212,706634,六角康和94購01,,,,,,0.00,0,0,0,0,0,0,0,0,0,0,0,0,0
20200212,706635,凡甲群益94購01,0.59,0.61,0.59,0.61,-0.03,-4.69,114000,13,67960,0,0,0,0,0,0,114000,0,114000,114000
20200212,706636,大宇資群益94購02,,,,,,0.00,0,0,0,0,0,0,0,0,0,0,0,0,0
20200212,706637,台燿群益94購02,0.41,0.48,0.41,0.48,+0.12,33.33,34000,4,15150,0,0,0,0,0,0,12000,22000,-10000,-10000
20200212,706638,美琪瑪群益94購01,,,,,,0.00,0,0,0,0,0,0,0,0,0,0,0,0,0
20200212,706639,群聯群益94購02,,,,,,0.00,0,0,0,0,0,0,0,0,0,0,0,0,0
20200212,706640,環球晶群益94購04,1.85,2.00,1.85,1.97,+0.21,11.93,24000,5,44970,0,0,0,0,0,0,24000,7000,17000,17000
20200212,706641,中美晶元大94購06,1.23,1.28,1.23,1.28,+0.09,7.56,72000,10,91390,0,0,0,0,0,0,57000,61000,-4000,-4000
20200212,706642,中美晶元大95購02,1.28,1.42,1.28,1.34,+0.05,3.88,52000,12,70190,0,0,0,0,0,0,15000,46000,-31000,-31000
20200212,706643,台燿元大94購03,1.41,1.56,1.41,1.56,+0.28,21.88,194000,10,283060,0,0,0,0,0,0,13000,183000,-170000,-170000
20200212,706644,台燿元大94購04,0.83,0.96,0.83,0.96,+0.22,29.73,101000,3,92330,0,0,0,0,0,0,1000,100000,-99000,-99000
20200212,706645,昂寶元大97購01,1.48,1.48,1.48,1.48,0.00,0.0,20000,1,29600,0,0,0,0,0,0,0,0,0,0
20200212,706646,昇達科元大96購02,0.40,0.40,0.40,0.40,+0.03,8.11,204000,2,81600,0,0,0,0,0,0,0,204000,-204000,-204000
20200212,706647,金居元大95購02,0.68,0.74,0.67,0.71,+0.05,7.58,235000,13,165610,0,0,0,0,0,0,136000,125000,11000,11000
20200212,706648,閎康元大94購01,,,,,,0.00,0,0,0,0,0,0,0,0,0,0,0,0,0
20200212,706649,新普元大94購01,,,,,,0.00,0,0,0,0,0,0,0,0,0,0,0,0,0
20200212,706650,新普元大94購02,3.38,3.59,3.38,3.59,+0.39,12.19,16000,2,57020,0,0,0,0,0,0,16000,2000,14000,14000
20200212,706651,雙美元大96購01,,,,,,0.00,0,0,0,0,0,0,0,0,0,0,0,0,0
20200212,706652,晟德元大94購01,,,,,,0.00,0,0,0,0,0,0,0,0,0,0,0,0,0
20200212,706653,環球晶麥證95購01,1.90,1.97,1.90,1.97,+0.15,8.24,31000,4,59070,21000,10000,11000,0,0,0,21000,10000,11000,11000
20200212,706654,優群元富94購01,1.26,1.38,1.26,1.38,+0.14,11.29,92000,11,122590,0,0,0,0,0,0,32000,64000,-32000,-32000
20200212,706655,環球晶元富94購04,2.60,2.77,2.60,2.77,+0.28,11.24,2000,2,5370,0,0,0,0,0,0,2000,2000,0,0
20200212,706656,緯軟兆豐95購02,0.58,0.58,0.58,0.58,-0.02,-3.33,15000,1,8700,0,0,0,0,0,0,0,15000,-15000,-15000
20200212,706657,環球晶兆豐95購02,1.76,1.85,1.76,1.81,+0.13,7.74,121000,4,217540,0,0,0,0,0,0,109000,12000,97000,97000
20200212,706658,穩懋兆豐95購01,0.37,0.48,0.37,0.46,+0.10,27.78,1895000,54,812000,0,0,0,0,0,0,1510000,385000,1125000,1125000
20200212,706659,中美晶台新95購01,2.20,2.35,2.16,2.35,+0.24,11.37,81000,5,185300,0,0,0,0,0,0,81000,0,81000,81000
20200212,706660,順達康和94購01,0.65,0.70,0.65,0.69,+0.09,15.0,30000,3,20400,0,0,0,0,0,0,20000,10000,10000,10000
20200212,706661,雙鴻康和94購01,,,,,,0.00,0,0,0,0,0,0,0,0,0,0,0,0,0
20200212,706662,中美晶群益94購03,2.66,2.81,2.66,2.81,+0.71,33.81,122000,4,327820,0,0,0,0,0,0,0,122000,-122000,-122000
20200212,706663,同致群益94購02,0.27,0.28,0.27,0.27,+0.01,3.85,115000,13,32050,0,0,0,0,0,0,5000,110000,-105000,-105000
20200212,706664,合晶群益94購02,0.61,0.81,0.61,0.79,+0.25,46.3,156000,17,108440,0,0,0,0,0,0,0,156000,-156000,-156000
20200212,706665,璟德群益94購01,4.70,5.25,4.70,5.00,-0.05,-0.99,159000,21,793630,0,0,0,0,0,0,139000,25000,114000,114000
20200212,706666,雙鴻群益95購02,,,,,,0.00,0,0,0,0,0,0,0,0,0,0,0,0,0
20200212,706667,安勤元大94購01,,,,,,0.00,0,0,0,0,0,0,0,0,0,0,0,0,0
20200212,706668,昂寶元大96購02,2.34,2.34,2.34,2.34,-0.01,-0.43,50000,1,117000,0,0,0,0,0,0,0,50000,-50000,-50000
20200212,706669,保瑞元大94購02,0.95,1.03,0.95,0.99,+0.05,5.32,108000,10,103930,0,0,0,0,0,0,103000,98000,5000,5000
20200212,706670,閎康元大94購02,1.41,1.43,1.41,1.43,-0.04,-2.72,52000,3,74320,0,0,0,0,0,0,50000,2000,48000,48000
20200212,706671,順達元大94購02,1.67,1.72,1.67,1.72,+0.27,18.62,62000,4,104140,0,0,0,0,0,0,10000,62000,-52000,-52000
20200212,706672,環球晶元大94購09,1.86,1.96,1.80,1.92,+0.11,6.08,90000,10,170530,0,0,0,0,0,0,15000,83000,-68000,-68000
20200212,706673,環球晶元大94購10,1.88,1.98,1.82,1.94,+0.12,6.59,106000,18,204630,0,0,0,0,0,0,41000,74000,-33000,-33000
20200212,706674,穩懋元大94購07,1.23,1.64,1.17,1.53,+0.34,28.57,311000,80,425430,0,0,0,0,0,0,123000,275000,-152000,-152000
20200212,706675,穩懋元大94購08,0.66,0.89,0.62,0.89,+0.27,43.55,104000,16,74150,0,0,0,0,0,0,30000,74000,-44000,-44000
20200212,706676,環球晶統一94購02,2.85,3.03,2.79,2.94,+0.18,6.52,169000,13,492390,0,0,0,0,0,0,49000,120000,-71000,-71000
20200212,706677,凡甲凱基94購01,0.72,0.74,0.71,0.74,-0.01,-1.33,112000,12,80900,0,0,0,0,0,0,112000,0,112000,112000
20200212,706678,大中凱基94購01,,,,,,0.00,0,0,0,0,0,0,0,0,0,0,0,0,0
20200212,706679,大江凱基94購06,,,,,,0.00,0,0,0,0,0,0,0,0,0,0,0,0,0
20200212,706680,旺矽凱基94購01,2.54,2.54,2.54,2.54,+0.16,6.72,6000,2,15240,0,0,0,0,0,0,0,6000,-6000,-6000
20200212,706681,順達凱基94購01,0.87,0.87,0.87,0.87,0.00,0.0,2000,1,1740,0,0,0,0,0,0,0,0,0,0
20200212,706682,網龍凱基94購01,,,,,,0.00,0,0,0,0,0,0,0,0,0,0,0,0,0
20200212,706683,環球晶凱基94購06,2.52,2.68,2.52,2.65,+0.28,11.81,60000,6,154100,0,0,0,0,0,0,9000,60000,-51000,-51000
20200212,706684,雙鴻凱基94購02,,,,,,0.00,0,0,0,0,0,0,0,0,0,0,0,0,0
20200212,706685,穩懋凱基94購07,,,,,,0.00,0,0,0,0,0,0,0,0,0,0,0,0,0
20200212,706686,安勤國票94購01,,,,,,0.00,0,0,0,0,0,0,0,0,0,0,0,0,0
20200212,706687,宣德國票94購01,1.41,1.41,1.41,1.41,+0.17,13.71,4000,1,5640,0,0,0,0,0,0,0,4000,-4000,-4000
20200212,706688,群聯國票94購02,3.55,3.60,3.55,3.60,+0.25,7.46,60000,3,214000,0,0,0,0,0,0,40000,0,40000,40000
20200212,706689,雙鴻國票94購01,0.05,0.05,0.05,0.05,+0.01,25.0,200000,2,10000,0,0,0,0,0,0,0,200000,-200000,-200000
20200212,706690,環球晶富邦98購01,1.48,1.53,1.45,1.52,+0.08,5.56,91000,12,134710,0,0,0,0,0,0,52000,42000,10000,10000
20200212,706691,大宇資第一94購01,,,,,,0.00,0,0,0,0,0,0,0,0,0,0,0,0,0
20200212,706692,六角永豐94購01,0.84,0.99,0.84,0.90,+0.08,9.76,151000,16,138520,0,0,0,0,0,0,39000,112000,-73000,-73000
20200212,706693,世界永豐94購01,1.18,1.27,1.18,1.27,+0.14,12.39,121000,11,149230,0,0,0,0,0,0,40000,81000,-41000,-41000
20200212,706694,合晶永豐94購01,0.59,0.75,0.59,0.75,+0.22,41.51,94000,5,59690,0,0,0,0,0,0,0,94000,-94000,-94000
20200212,706695,保瑞永豐94購02,0.52,0.52,0.50,0.50,+0.03,6.38,11000,2,5520,0,0,0,0,0,0,10000,1000,9000,9000
20200212,706696,聖暉永豐94購01,,,,,,0.00,0,0,0,0,0,0,0,0,0,0,0,0,0
20200212,706697,凡甲永豐94購02,,,,,,0.00,0,0,0,0,0,0,0,0,0,0,0,0,0
20200212,706698,大學光永豐95購02,1.70,1.70,1.70,1.70,+0.10,6.25,11000,2,18700,0,0,0,0,0,0,11000,0,11000,11000
20200212,706699,台燿永豐94購01,0.47,0.48,0.47,0.48,+0.09,23.08,118000,3,56060,0,0,0,0,0,0,0,118000,-118000,-118000
20200212,706700,茂達永豐94購01,,,,,,0.00,0,0,0,0,0,0,0,0,0,0,0,0,0
20200212,706701,新鉅科永豐94購01,,,,,,0.00,0,0,0,0,0,0,0,0,0,0,0,0,0
20200212,706702,合晶兆豐94購01,0.43,0.57,0.43,0.57,+0.15,35.71,416000,15,188350,0,0,0,0,0,0,121000,295000,-174000,-174000
20200212,706703,信昌電兆豐95購01,0.76,0.76,0.75,0.76,-0.01,-1.3,125000,4,94980,0,0,0,0,0,0,52000,73000,-21000,-21000
20200212,706704,保瑞兆豐95購01,0.66,0.66,0.63,0.63,+0.01,1.61,220000,5,140580,0,0,0,0,0,0,159000,61000,98000,98000
20200212,706705,建榮兆豐95購01,,,,,,0.00,0,0,0,0,0,0,0,0,0,0,0,0,0
20200212,706706,力麒康和94購01,,,,,,0.00,0,0,0,0,0,0,0,0,0,0,0,0,0
20200212,706707,台燿康和94購01,1.11,1.18,1.10,1.18,+0.21,21.65,158000,15,181340,0,0,0,0,0,0,30000,128000,-98000,-98000
20200212,706708,新鉅科康和94購01,,,,,,0.00,0,0,0,0,0,0,0,0,0,0,0,0,0
20200212,706709,茂達群益94購01,0.68,0.68,0.68,0.68,0.00,0.0,5000,1,3400,0,0,0,0,0,0,0,5000,-5000,-5000
20200212,706710,環球晶群益94購05,3.37,3.41,3.37,3.41,+0.15,4.6,20000,4,67900,0,0,0,0,0,0,20000,0,20000,20000
20200212,706711,台燿統一94購01,0.76,0.84,0.76,0.84,+0.16,23.53,352000,13,288280,0,0,0,0,0,0,128000,224000,-96000,-96000
20200212,706712,台燿統一94購02,1.00,1.10,1.00,1.09,+0.18,19.78,407000,29,429670,0,0,0,0,0,0,81000,328000,-247000,-247000
20200212,706713,安勤統一94購01,0.57,0.57,0.56,0.56,-0.01,-1.75,153000,2,86730,0,0,0,0,0,0,48000,105000,-57000,-57000
20200212,706714,新鉅科統一94購01,0.30,0.30,0.30,0.30,+0.08,36.36,20000,1,6000,0,0,0,0,0,0,20000,0,20000,20000
20200212,706715,新鉅科統一94購02,,,,,,0.00,0,0,0,0,0,0,0,0,0,0,0,0,0
20200212,706716,環球晶統一94購03,2.07,2.09,2.07,2.09,+0.29,16.11,35000,2,72670,0,0,0,0,0,0,0,35000,-35000,-35000
20200212,706717,中美晶凱基94購03,2.46,2.46,2.46,2.46,+0.33,15.49,12000,3,29520,0,0,0,0,0,0,12000,12000,0,0
20200212,706718,台燿凱基94購04,2.01,2.14,2.01,2.14,+0.42,24.42,20000,2,41500,0,0,0,0,0,0,10000,10000,0,0
20200212,706719,信驊凱基94購01,,,,,,0.00,0,0,0,0,0,0,0,0,0,0,0,0,0
20200212,706720,威剛凱基94購02,4.96,5.45,1.63,5.25,+0.53,11.23,182000,34,895240,0,0,0,0,0,0,149000,30000,119000,119000
20200212,706721,泰博凱基94購02,1.12,1.14,1.09,1.09,-0.01,-0.91,42000,7,46920,0,0,0,0,0,0,42000,0,42000,42000
20200212,706722,新鉅科凱基94購01,,,,,,0.00,0,0,0,0,0,0,0,0,0,0,0,0,0
20200212,706723,環球晶凱基94購07,1.56,1.64,1.54,1.63,+0.15,10.14,81000,5,127170,0,0,0,0,0,0,13000,71000,-58000,-58000
20200212,706724,雙鴻凱基94購03,,,,,,0.00,0,0,0,0,0,0,0,0,0,0,0,0,0
20200212,706725,穩懋凱基94購08,0.71,0.78,0.71,0.78,+0.18,30.0,20000,2,14900,0,0,0,0,0,0,0,20000,-20000,-20000
20200212,706726,M31元大96購01,0.45,0.45,0.43,0.43,+0.03,7.5,231000,4,100550,0,0,0,0,0,0,0,231000,-231000,-231000
20200212,706727,凡甲元大94購02,0.43,0.43,0.43,0.43,-0.04,-8.51,20000,1,8600,0,0,0,0,0,0,20000,20000,0,0
20200212,706728,元太元大94購03,1.41,1.51,1.41,1.51,+0.12,8.63,261000,11,378600,0,0,0,0,0,0,44000,261000,-217000,-217000
20200212,706729,台燿元大94購06,3.54,3.80,3.54,3.80,+0.50,15.15,29000,5,108640,0,0,0,0,0,0,6000,23000,-17000,-17000
20200212,706730,安勤元大94購02,0.39,0.39,0.39,0.39,-0.01,-2.5,20000,1,7800,0,0,0,0,0,0,20000,0,20000,20000
20200212,706731,良維元大97購01,0.46,0.49,0.46,0.48,+0.02,4.35,995000,14,468650,0,0,0,0,0,0,70000,925000,-855000,-855000
20200212,706732,杰力元大94購01,,,,,,0.00,0,0,0,0,0,0,0,0,0,0,0,0,0
20200212,706733,神盾元大96購01,0.47,0.48,0.47,0.48,+0.03,6.67,22000,4,10450,0,0,0,0,0,0,12000,10000,2000,2000
20200212,706734,精華元大94購01,,,,,,0.00,0,0,0,0,0,0,0,0,0,0,0,0,0
20200212,706735,精華元大94購02,,,,,,0.00,0,0,0,0,0,0,0,0,0,0,0,0,0
20200212,706736,環球晶元大94購11,2.77,2.95,2.70,2.95,+0.31,11.74,35000,11,101200,0,0,0,0,0,0,17000,35000,-18000,-18000
20200212,706737,環球晶元大94購13,1.71,1.79,1.66,1.76,+0.12,7.32,118000,14,202980,0,0,0,0,0,0,32000,104000,-72000,-72000
20200212,706738,緯軟國票94購01,0.53,0.55,0.53,0.55,+0.05,10.0,104000,2,55220,0,0,0,0,0,0,99000,5000,94000,94000
20200212,706739,新鉅科國泰95購01,0.30,0.34,0.30,0.34,+0.07,25.93,30000,3,9500,0,0,0,0,0,0,0,30000,-30000,-30000
20200212,706740,新鉅科國泰95購02,0.32,0.39,0.32,0.39,+0.07,21.88,60000,4,20600,0,0,0,0,0,0,30000,30000,0,0
20200212,706741,精華國泰95購01,0.71,0.71,0.69,0.69,+0.01,1.47,28000,3,19520,0,0,0,0,0,0,28000,10000,18000,18000
20200212,706742,群聯富邦95購01,,,,,,0.00,0,0,0,0,0,0,0,0,0,0,0,0,0
20200212,706743,台燿凱基94購05,1.20,1.29,1.20,1.29,+0.21,19.44,42000,4,52000,0,0,0,0,0,0,22000,20000,2000,2000
20200212,706744,良維凱基94購02,,,,,,0.00,0,0,0,0,0,0,0,0,0,0,0,0,0
20200212,706745,茂達凱基94購01,,,,,,0.00,0,0,0,0,0,0,0,0,0,0,0,0,0
20200212,706746,穩懋凱基94購09,0.62,0.69,0.62,0.69,+0.21,43.75,11000,2,6890,0,0,0,0,0,0,1000,10000,-9000,-9000
20200212,706747,安勤統一95購01,,,,,,0.00,0,0,0,0,0,0,0,0,0,0,0,0,0
20200212,706748,安勤統一95購02,,,,,,0.00,0,0,0,0,0,0,0,0,0,0,0,0,0
20200212,706749,大江第一94購01,,,,,,0.00,0,0,0,0,0,0,0,0,0,0,0,0,0
20200212,706750,神盾第一94購01,0.10,0.10,0.10,0.10,+0.01,11.11,10000,1,1000,0,0,0,0,0,0,10000,0,10000,10000
20200212,706751,同致國票95購01,,,,,,0.00,0,0,0,0,0,0,0,0,0,0,0,0,0
20200212,706752,波若威國票95購01,0.20,0.20,0.20,0.20,+0.01,5.26,20000,1,4000,0,0,0,0,0,0,20000,0,20000,20000
20200212,706753,台燿台新94購01,1.04,1.15,1.04,1.15,+0.21,22.34,76000,5,84440,0,0,0,0,0,0,16000,60000,-44000,-44000
20200212,706754,碩禾台新96購01,0.76,0.76,0.75,0.75,+0.01,1.35,11000,2,8350,0,0,0,0,0,0,0,11000,-11000,-11000
20200212,706755,台燿元富94購01,1.05,1.07,1.05,1.07,+0.24,28.92,90000,8,96100,0,0,0,0,0,0,0,90000,-90000,-90000
20200212,706756,茂達元富94購01,0.80,0.80,0.80,0.80,+0.06,8.11,20000,4,16000,0,0,0,0,0,0,20000,0,20000,20000
20200212,706757,茂達元富94購02,0.99,0.99,0.99,0.99,+0.09,10.0,3000,1,2970,0,0,0,0,0,0,3000,0,3000,3000
20200212,706758,六角國泰96購01,1.33,1.58,1.33,1.44,+0.13,9.92,143000,12,207640,0,0,0,0,0,0,38000,105000,-67000,-67000
20200212,706759,雙美國泰95購01,,,,,,0.00,0,0,0,0,0,0,0,0,0,0,0,0,0
20200212,706760,鈺太國泰95購01,1.88,2.11,1.85,2.11,+0.26,14.05,213000,7,419280,0,0,0,0,0,0,23000,190000,-167000,-167000
20200212,706761,鐿鈦國泰96購01,0.84,0.84,0.84,0.84,+0.06,7.69,10000,1,8400,0,0,0,0,0,0,0,10000,-10000,-10000
20200212,706762,大江兆豐95購02,0.09,0.09,0.09,0.09,+0.01,12.5,298000,21,26820,0,0,0,0,0,0,0,298000,-298000,-298000
20200212,706763,勝麗兆豐95購01,,,,,,0.00,0,0,0,0,0,0,0,0,0,0,0,0,0
20200212,706764,中美晶元大94購07,1.27,1.42,1.27,1.31,+0.03,2.34,212000,18,286870,0,0,0,0,0,0,130000,134000,-4000,-4000
20200212,706765,六角元大96購01,1.08,1.24,1.08,1.15,+0.08,7.48,703000,33,824610,0,0,0,0,0,0,359000,690000,-331000,-331000
20200212,706766,順達元大94購03,1.58,1.64,1.58,1.63,+0.24,17.27,120000,3,195200,0,0,0,0,0,0,0,120000,-120000,-120000
20200212,706767,群聯元大95購04,1.96,2.02,1.94,1.99,+0.06,3.11,147000,14,291850,0,0,0,0,0,0,113000,87000,26000,26000
20200212,706768,環球晶元大94購14,3.26,3.49,3.26,3.40,+0.24,7.59,14000,9,47110,0,0,0,0,0,0,14000,13000,1000,1000
20200212,706769,環球晶元大95購02,1.72,1.80,1.67,1.77,+0.09,5.36,83000,15,146670,0,0,0,0,0,0,28000,81000,-53000,-53000
20200212,706770,博智群益94購01,3.29,3.38,3.29,3.34,+0.25,8.09,80000,3,267100,0,0,0,0,0,0,80000,0,80000,80000
20200212,706771,新鉅科群益94購01,0.10,0.11,0.10,0.11,+0.01,10.0,50000,3,5100,0,0,0,0,0,0,10000,40000,-30000,-30000
20200212,706772,聖暉群益94購01,,,,,,0.00,0,0,0,0,0,0,0,0,0,0,0,0,0
20200212,706773,優群群益95購01,1.98,2.15,1.98,2.15,+0.20,10.26,183000,18,381390,0,0,0,0,0,0,36000,147000,-111000,-111000
20200212,706774,雙美群益96購01,0.31,0.35,0.31,0.35,+0.09,34.62,54000,3,17460,0,0,0,0,0,0,18000,0,18000,18000
20200212,706775,元太凱基94購01,,,,,,0.00,0,0,0,0,0,0,0,0,0,0,0,0,0
20200212,706776,合晶凱基94購02,0.35,0.35,0.35,0.35,+0.11,45.83,120000,2,42000,0,0,0,0,0,0,0,120000,-120000,-120000
20200212,706777,安勤凱基94購01,,,,,,0.00,0,0,0,0,0,0,0,0,0,0,0,0,0
20200212,706778,安勤凱基94購02,,,,,,0.00,0,0,0,0,0,0,0,0,0,0,0,0,0
20200212,706779,直得凱基94購01,1.63,1.63,1.63,1.63,+0.01,0.62,2000,1,3260,0,0,0,0,0,0,2000,0,2000,2000
20200212,706780,勝麗凱基94購02,3.75,3.75,3.75,3.75,+0.02,0.54,20000,2,75000,0,0,0,0,0,0,20000,0,20000,20000
20200212,706781,順達凱基94購02,,,,,,0.00,0,0,0,0,0,0,0,0,0,0,0,0,0
20200212,706782,環球晶凱基94購08,1.64,1.76,1.64,1.73,+0.16,10.19,48000,8,81580,0,0,0,0,0,0,3000,48000,-45000,-45000
20200212,706783,大江元富94購01,,,,,,0.00,0,0,0,0,0,0,0,0,0,0,0,0,0
20200212,706784,大學光群益94購01,1.05,1.18,1.05,1.15,+0.09,8.49,220000,16,247350,0,0,0,0,0,0,165000,63000,102000,102000
20200212,706785,三貝德永豐94購02,,,,,,0.00,0,0,0,0,0,0,0,0,0,0,0,0,0
20200212,706786,勝麗永豐94購02,1.25,1.41,1.25,1.27,+0.03,2.42,226000,20,294320,0,0,0,0,0,0,169000,114000,55000,55000
20200212,706787,博智國票95購02,,,,,,0.00,0,0,0,0,0,0,0,0,0,0,0,0,0
20200212,706788,大學光國泰96購01,2.52,2.52,2.52,2.52,+0.15,6.33,10000,1,25200,0,0,0,0,0,0,0,10000,-10000,-10000
20200212,706789,VHQ元大94購01,0.35,0.35,0.35,0.35,+0.08,29.63,5000,1,1750,0,0,0,0,0,0,0,5000,-5000,-5000
20200212,706790,中美晶元大94購08,1.28,1.43,1.28,1.43,+0.20,16.26,140000,10,189490,0,0,0,0,0,0,84000,109000,-25000,-25000
20200212,706791,同致元大94購02,,,,,,0.00,0,0,0,0,0,0,0,0,0,0,0,0,0
20200212,706792,威剛元大96購01,,,,,,0.00,0,0,0,0,0,0,0,0,0,0,0,0,0
20200212,706793,勝麗元大94購02,3.91,3.91,3.91,3.91,-0.02,-0.51,20000,2,78200,0,0,0,0,0,0,20000,0,20000,20000
20200212,706794,環球晶元大94購15,1.15,1.22,1.11,1.19,+0.08,7.21,203000,16,237720,0,0,0,0,0,0,52000,160000,-108000,-108000
20200212,706795,穩懋元大94購09,1.45,1.88,1.30,1.73,+0.34,24.46,491000,89,770400,0,0,0,0,0,0,242000,393000,-151000,-151000
20200212,706796,鈺太元大96購02,1.33,1.63,1.33,1.63,+0.33,25.38,437000,29,615020,0,0,0,0,0,0,52000,426000,-374000,-374000
20200212,706797,昂寶元大94購01,1.44,1.44,1.44,1.44,-0.01,-0.69,100000,1,144000,0,0,0,0,0,0,0,100000,-100000,-100000
20200212,706798,杰力元大94購02,0.19,0.19,0.19,0.19,+0.01,5.56,10000,1,1900,0,0,0,0,0,0,0,10000,-10000,-10000
20200212,706799,茂達元大94購02,0.91,0.93,0.91,0.93,+0.05,5.68,101000,4,93630,0,0,0,0,0,0,101000,0,101000,101000
20200212,706800,原相元大96購01,3.49,3.49,3.49,3.49,+0.27,8.39,2000,1,6980,0,0,0,0,0,0,2000,0,2000,2000
20200212,706801,環球晶元大94購16,1.36,1.38,1.34,1.38,+0.07,5.34,9000,4,12300,0,0,0,0,0,0,9000,2000,7000,7000
20200212,706802,環球晶統一94購04,2.68,2.85,2.68,2.85,+0.21,7.95,67000,7,184780,0,0,0,0,0,0,31000,36000,-5000,-5000
20200212,706803,環球晶中信97購01,0.67,0.71,0.67,0.70,+0.04,6.06,1938000,45,1341580,250000,200000,50000,0,0,0,996000,937000,59000,109000
20200212,706804,由田國泰96購01,0.46,0.48,0.46,0.48,+0.03,6.67,558000,3,257280,0,0,0,0,0,0,267000,291000,-24000,-24000
20200212,706805,宣德凱基94購02,1.04,1.09,1.03,1.09,-0.07,-6.03,199000,31,207280,0,0,0,0,0,0,199000,10000,189000,189000
20200212,706806,雙美凱基94購01,,,,,,0.00,0,0,0,0,0,0,0,0,0,0,0,0,0
20200212,706807,精華麥證94購01,,,,,,0.00,0,0,0,0,0,0,0,0,0,0,0,0,0
20200212,706808,泰博元富94購01,1.19,1.21,1.19,1.21,+0.05,4.31,25000,2,29950,0,0,0,0,0,0,25000,0,25000,25000
20200212,706809,神盾元富95購01,0.40,0.40,0.40,0.40,+0.04,11.11,250000,1,100000,0,0,0,0,0,0,250000,0,250000,250000
20200212,706810,緯軟元富94購01,,,,,,0.00,0,0,0,0,0,0,0,0,0,0,0,0,0
20200212,706811,環球晶元富95購03,2.13,2.21,2.13,2.21,+0.14,6.76,153000,4,332850,0,0,0,0,0,0,12000,153000,-141000,-141000
20200212,706812,凡甲台新94購01,,,,,,0.00,0,0,0,0,0,0,0,0,0,0,0,0,0
20200212,706813,台燿第一94購01,,,,,,0.00,0,0,0,0,0,0,0,0,0,0,0,0,0
20200212,706814,由田永豐94購02,,,,,,0.00,0,0,0,0,0,0,0,0,0,0,0,0,0
20200212,706815,金居永豐94購01,,,,,,0.00,0,0,0,0,0,0,0,0,0,0,0,0,0
20200212,706816,原相永豐94購03,1.84,2.00,1.74,1.93,+0.04,2.12,416000,75,765590,0,0,0,0,0,0,334000,79000,255000,255000
20200212,706817,廣明永豐94購01,,,,,,0.00,0,0,0,0,0,0,0,0,0,0,0,0,0
20200212,706818,廣積永豐94購01,0.38,0.38,0.38,0.38,-0.04,-9.52,15000,1,5700,0,0,0,0,0,0,15000,0,15000,15000
20200212,706819,優群永豐94購03,0.73,0.78,0.73,0.78,+0.09,13.04,170000,5,125500,0,0,0,0,0,0,70000,100000,-30000,-30000
20200212,706820,櫃200永豐94購01,1.64,1.64,1.64,1.64,+0.21,14.69,1000,1,1640,0,0,0,0,0,0,0,1000,-1000,-1000
20200212,706821,雙鴻永豐95購04,,,,,,0.00,0,0,0,0,0,0,0,0,0,0,0,0,0
20200212,706822,立端群益95購01,0.52,0.69,0.52,0.69,+0.22,46.81,357000,7,206030,0,0,0,0,0,0,0,357000,-357000,-357000
20200212,706823,勝麗群益94購01,3.18,3.28,3.18,3.25,+0.14,4.5,51000,5,165980,0,0,0,0,0,0,31000,20000,11000,11000
20200212,706824,群聯群益94購03,,,,,,0.00,0,0,0,0,0,0,0,0,0,0,0,0,0
20200212,706825,穩懋統一96購02,1.07,1.36,1.05,1.26,+0.23,22.33,329000,25,380810,0,0,0,0,0,0,135000,217000,-82000,-82000
20200212,706826,凡甲中信94購01,,,,,,0.00,0,0,0,0,0,0,0,0,0,0,0,0,0
20200212,706827,凡甲元大94購03,,,,,,0.00,0,0,0,0,0,0,0,0,0,0,0,0,0
20200212,706828,世界元大94購02,5.05,5.10,5.05,5.10,+0.34,7.14,40000,4,202500,0,0,0,0,0,0,0,40000,-40000,-40000
20200212,706829,台半元大94購01,0.90,0.90,0.90,0.90,0.00,0.0,67000,2,60300,0,0,0,0,0,0,67000,18000,49000,49000
20200212,706830,迅得元大95購01,1.08,1.08,1.04,1.04,+0.01,0.97,103000,2,111080,0,0,0,0,0,0,99000,4000,95000,95000
20200212,706831,聖暉元大94購01,,,,,,0.00,0,0,0,0,0,0,0,0,0,0,0,0,0
20200212,706832,環球晶元大94購18,2.72,2.83,2.72,2.83,+0.14,5.2,7000,2,19590,0,0,0,0,0,0,2000,5000,-3000,-3000
20200212,706833,鈺太元大96購03,0.87,1.10,0.86,1.04,+0.18,20.93,804000,42,767810,0,0,0,0,0,0,265000,628000,-363000,-363000
20200212,706834,昇達科永豐94購02,,,,,,0.00,0,0,0,0,0,0,0,0,0,0,0,0,0
20200212,706835,東隆興永豐94購01,,,,,,0.00,0,0,0,0,0,0,0,0,0,0,0,0,0
20200212,706836,振曜永豐94購01,,,,,,0.00,0,0,0,0,0,0,0,0,0,0,0,0,0
20200212,706837,網家永豐94購02,0.08,0.08,0.08,0.08,-0.01,-11.11,10000,1,800,0,0,0,0,0,0,0,10000,-10000,-10000
20200212,706838,聚積永豐94購01,,,,,,0.00,0,0,0,0,0,0,0,0,0,0,0,0,0
20200212,706839,鈺太永豐94購04,0.57,0.71,0.57,0.71,+0.14,24.56,112000,11,72660,0,0,0,0,0,0,0,112000,-112000,-112000
20200212,706840,良維國票95購01,,,,,,0.00,0,0,0,0,0,0,0,0,0,0,0,0,0
20200212,706841,保瑞國票95購01,1.36,1.36,1.25,1.25,-0.02,-1.57,71000,6,91690,0,0,0,0,0,0,49000,22000,27000,27000
20200212,706842,群聯國票94購03,,,,,,0.00,0,0,0,0,0,0,0,0,0,0,0,0,0
20200212,706843,碩禾國票95購01,1.75,1.90,1.71,1.79,-0.04,-2.19,151000,13,275190,0,0,0,0,0,0,54000,97000,-43000,-43000
20200212,706844,新鉅科富邦98購01,0.22,0.25,0.22,0.24,+0.03,14.29,226000,6,53800,0,0,0,0,0,0,5000,221000,-216000,-216000
20200212,706845,中美晶凱基94購06,0.99,1.15,0.99,1.15,+0.17,17.35,71000,4,71830,0,0,0,0,0,0,10000,61000,-51000,-51000
20200212,706846,金可凱基94購02,1.04,1.04,1.04,1.04,+0.08,8.33,48000,1,49920,0,0,0,0,0,0,0,48000,-48000,-48000
20200212,706847,神盾凱基94購01,,,,,,0.00,0,0,0,0,0,0,0,0,0,0,0,0,0
20200212,706848,碩禾凱基94購01,,,,,,0.00,0,0,0,0,0,0,0,0,0,0,0,0,0
20200212,706849,精華凱基94購03,,,,,,0.00,0,0,0,0,0,0,0,0,0,0,0,0,0
20200212,706850,廣明凱基94購06,,,,,,0.00,0,0,0,0,0,0,0,0,0,0,0,0,0
20200212,706851,穩懋凱基94購10,1.67,2.16,1.65,2.16,+0.53,32.52,24000,10,47220,0,0,0,0,0,0,14000,21000,-7000,-7000
20200212,706852,穩懋麥證94購01,1.22,1.63,1.19,1.55,+0.33,27.05,296000,44,410310,95000,193000,-98000,0,0,0,95000,193000,-98000,-98000
20200212,706853,神盾元富95購02,0.38,0.38,0.38,0.38,+0.04,11.76,265000,1,100700,0,0,0,0,0,0,265000,0,265000,265000
20200212,706854,聯亞台新94購01,,,,,,0.00,0,0,0,0,0,0,0,0,0,0,0,0,0
20200212,706855,原相兆豐95購02,,,,,,0.00,0,0,0,0,0,0,0,0,0,0,0,0,0
20200212,706856,環球晶兆豐95購04,1.15,1.19,1.11,1.15,+0.06,5.5,738000,25,853780,0,0,0,0,0,0,499000,219000,280000,280000
20200212,706857,凡甲康和94購01,0.30,0.30,0.30,0.30,+0.03,11.11,10000,1,3000,0,0,0,0,0,0,0,10000,-10000,-10000
20200212,706858,由田群益96購01,0.74,0.78,0.74,0.78,+0.08,11.43,108000,2,80320,0,0,0,0,0,0,98000,10000,88000,88000
20200212,706859,環球晶群益94購07,3.25,3.51,3.23,3.42,+0.18,5.56,41000,14,135700,0,0,0,0,0,0,38000,22000,16000,16000
20200212,706860,原相中信94購01,3.16,3.23,3.11,3.13,+0.21,7.19,40000,15,127080,0,0,0,0,0,0,40000,0,40000,40000
20200212,706861,金居凱基94購01,,,,,,0.00,0,0,0,0,0,0,0,0,0,0,0,0,0
20200212,706862,泰博凱基94購03,1.09,1.11,1.09,1.10,+0.07,6.8,42000,7,46570,0,0,0,0,0,0,23000,19000,4000,4000
20200212,706863,環宇凱基94購01,0.43,0.43,0.43,0.43,+0.01,2.38,100000,1,43000,0,0,0,0,0,0,0,100000,-100000,-100000
20200212,706864,環球晶凱基94購09,2.33,2.41,2.32,2.40,+0.15,6.67,39000,4,91010,0,0,0,0,0,0,39000,3000,36000,36000
20200212,706865,環球晶統一94購05,,,,,,0.00,0,0,0,0,0,0,0,0,0,0,0,0,0
20200212,706866,凡甲國票95購01,0.49,0.51,0.48,0.50,-0.04,-7.41,451000,12,221350,0,0,0,0,0,0,251000,200000,51000,51000
20200212,706867,中美晶國票95購01,,,,,,0.00,0,0,0,0,0,0,0,0,0,0,0,0,0
20200212,706868,神盾國票96購01,0.27,0.27,0.27,0.27,+0.05,22.73,40000,1,10800,0,0,0,0,0,0,40000,0,40000,40000
20200212,706869,環球晶國票95購02,3.21,3.40,3.21,3.35,+0.20,6.35,240000,6,802030,0,0,0,0,0,0,197000,40000,157000,157000
20200212,706870,原相群益97購02,5.25,5.25,5.25,5.25,-0.10,-1.87,5000,1,26250,0,0,0,0,0,0,5000,5000,0,0
20200212,706871,台半永豐94購01,0.27,0.27,0.27,0.27,+0.01,3.85,100000,1,27000,0,0,0,0,0,0,100000,0,100000,100000
20200212,706872,波若威永豐95購01,0.24,0.24,0.24,0.24,+0.02,9.09,3000,1,720,0,0,0,0,0,0,3000,0,3000,3000
20200212,706873,宣德永豐94購03,1.63,1.79,1.61,1.79,-0.01,-0.56,207000,24,349600,0,0,0,0,0,0,167000,82000,85000,85000
20200212,706874,閎康永豐94購02,,,,,,0.00,0,0,0,0,0,0,0,0,0,0,0,0,0
20200212,706875,環球晶永豐94購04,1.43,1.56,1.43,1.54,+0.10,6.94,189000,9,284630,0,0,0,0,0,0,92000,100000,-8000,-8000
20200212,706876,大宇資元大96購01,,,,,,0.00,0,0,0,0,0,0,0,0,0,0,0,0,0
20200212,706877,合晶元大95購01,0.70,0.84,0.70,0.83,+0.20,31.75,356000,10,285240,0,0,0,0,0,0,5000,351000,-346000,-346000
20200212,706878,邦特元大94購01,0.59,0.61,0.59,0.61,+0.04,7.02,44000,3,26640,0,0,0,0,0,0,39000,5000,34000,34000
20200212,706879,信昌電元大95購02,1.15,1.15,1.15,1.15,-0.07,-5.74,93000,3,106950,0,0,0,0,0,0,50000,43000,7000,7000
20200212,706880,茂達元大94購03,,,,,,0.00,0,0,0,0,0,0,0,0,0,0,0,0,0
20200212,706881,網家元大94購02,0.31,0.32,0.29,0.30,-0.02,-6.25,1049000,8,322200,0,0,0,0,0,0,599000,450000,149000,149000
20200212,706882,緯軟元大96購03,0.35,0.35,0.34,0.34,+0.01,3.03,200000,2,69000,0,0,0,0,0,0,200000,0,200000,200000
20200212,706883,環球晶元大94購19,3.68,3.87,3.57,3.80,+0.22,6.15,39000,10,144260,0,0,0,0,0,0,39000,14000,25000,25000
20200212,706884,環球晶元大95購03,4.14,4.36,4.04,4.26,+0.22,5.45,100000,8,414580,0,0,0,0,0,0,100000,8000,92000,92000
20200212,706885,環球晶台新94購02,,,,,,0.00,0,0,0,0,0,0,0,0,0,0,0,0,0
20200212,706886,台燿元富94購03,0.63,0.71,0.63,0.70,+0.14,25.0,309000,12,212150,0,0,0,0,0,0,188000,129000,59000,59000
20200212,706887,台燿元富94購04,0.95,1.06,0.95,1.06,+0.20,23.26,269000,18,275660,0,0,0,0,0,0,117000,74000,43000,43000
20200212,706888,聚積元富94購02,,,,,,0.00,0,0,0,0,0,0,0,0,0,0,0,0,0
20200212,706889,雙鴻元富96購01,0.28,0.31,0.28,0.30,+0.02,7.14,101000,12,30400,0,0,0,0,0,0,11000,90000,-79000,-79000
20200212,706890,信驊凱基95購01,,,,,,0.00,0,0,0,0,0,0,0,0,0,0,0,0,0
20200212,706891,新普凱基94購03,2.14,2.27,2.14,2.18,+0.13,6.34,103000,6,228810,0,0,0,0,0,0,45000,58000,-13000,-13000
20200212,706892,網家凱基95購01,0.63,0.63,0.01,0.01,-0.63,-98.44,60000,6,31370,0,0,0,0,0,0,50000,10000,40000,40000
20200212,706893,環球晶凱基94購10,3.62,3.85,3.62,3.82,+0.34,9.77,19000,7,70210,0,0,0,0,0,0,19000,19000,0,0
20200212,706894,M31元大95購01,0.38,0.38,0.37,0.37,+0.03,8.82,110000,6,41500,0,0,0,0,0,0,100000,10000,90000,90000
20200212,706895,凡甲元大94購04,0.68,0.70,0.65,0.70,0.00,0.0,134000,6,91420,0,0,0,0,0,0,112000,134000,-22000,-22000
20200212,706896,佳邦元大94購01,0.41,0.49,0.41,0.49,+0.09,22.5,185000,2,82650,0,0,0,0,0,0,85000,100000,-15000,-15000
20200212,706897,保瑞元大94購03,1.27,1.27,1.25,1.25,-0.02,-1.57,42000,2,53200,0,0,0,0,0,0,42000,0,42000,42000
20200212,706898,勝麗元大95購02,4.10,4.54,4.10,4.23,+0.27,6.82,223000,19,965270,0,0,0,0,0,0,163000,125000,38000,38000
20200212,706899,閎康元大95購01,0.64,0.66,0.64,0.66,-0.02,-2.94,30000,3,19650,0,0,0,0,0,0,0,30000,-30000,-30000
20200212,706900,環球晶元大94購20,3.30,3.49,3.18,3.39,+0.19,5.94,74000,13,251990,0,0,0,0,0,0,47000,42000,5000,5000
20200212,706901,穩懋元大94購10,1.05,1.41,1.00,1.28,+0.28,28.0,368000,54,413800,0,0,0,0,0,0,260000,167000,93000,93000
20200212,706902,迅得永豐95購02,0.55,0.56,0.55,0.56,+0.05,9.8,265000,5,147370,0,0,0,0,0,0,0,265000,-265000,-265000
20200212,706903,長科*永豐94購02,,,,,,0.00,0,0,0,0,0,0,0,0,0,0,0,0,0
20200212,706904,群聯永豐94購01,1.63,1.67,1.63,1.67,+0.04,2.45,20000,3,33000,0,0,0,0,0,0,10000,10000,0,0
20200212,706905,應華永豐94購01,,,,,,0.00,0,0,0,0,0,0,0,0,0,0,0,0,0
20200212,706906,大學光國票96購01,1.72,1.90,1.72,1.83,+0.13,7.65,152000,9,271110,0,0,0,0,0,0,61000,91000,-30000,-30000
20200212,706907,合晶國票95購01,0.38,0.38,0.37,0.37,+0.09,32.14,20000,2,7570,0,0,0,0,0,0,0,20000,-20000,-20000
20200212,706908,皇田國票95購01,0.26,0.26,0.26,0.26,0.00,0.0,6000,1,1560,0,0,0,0,0,0,0,6000,-6000,-6000
20200212,706909,茂達國票94購01,0.75,0.75,0.75,0.75,+0.02,2.74,20000,1,15000,0,0,0,0,0,0,20000,0,20000,20000
20200212,706910,閎康國票95購01,1.19,1.19,1.19,1.19,-0.11,-8.46,20000,1,23800,0,0,0,0,0,0,20000,0,20000,20000
20200212,706911,網龍國票94購02,0.62,0.62,0.61,0.61,-0.06,-8.96,249000,5,153870,0,0,0,0,0,0,249000,0,249000,249000
20200212,706912,鐿鈦國票96購01,0.92,0.94,0.92,0.92,+0.05,5.75,185000,16,171800,0,0,0,0,0,0,0,185000,-185000,-185000
20200212,706913,邦特元富94購01,0.30,0.30,0.29,0.30,+0.01,3.45,50000,3,14700,0,0,0,0,0,0,30000,20000,10000,10000
20200212,706914,智擎元富94購01,0.08,0.08,0.08,0.08,+0.01,14.29,60000,5,4800,0,0,0,0,0,0,0,0,0,0
20200212,706915,台半康和94購01,,,,,,0.00,0,0,0,0,0,0,0,0,0,0,0,0,0
20200212,706916,M31元大96購02,,,,,,0.00,0,0,0,0,0,0,0,0,0,0,0,0,0
20200212,706917,力旺元大94購01,1.21,1.35,1.21,1.35,+0.09,7.14,65000,5,82730,0,0,0,0,0,0,45000,35000,10000,10000
20200212,706918,大學光元大96購01,1.70,1.86,1.70,1.86,+0.11,6.29,54000,9,98220,0,0,0,0,0,0,10000,53000,-43000,-43000
20200212,706919,良維元大96購01,0.34,0.37,0.34,0.37,+0.03,8.82,812000,6,293410,0,0,0,0,0,0,68000,744000,-676000,-676000
20200212,706920,宣德元大96購01,1.27,1.40,1.26,1.40,+0.01,0.72,528000,38,687660,0,0,0,0,0,0,503000,256000,247000,247000
20200212,706921,新鉅科元大94購01,,,,,,0.00,0,0,0,0,0,0,0,0,0,0,0,0,0
20200212,706922,新鉅科元大94購02,0.21,0.21,0.21,0.21,+0.04,23.53,14000,1,2940,0,0,0,0,0,0,14000,0,14000,14000
20200212,706923,聚積元大96購01,0.28,0.28,0.28,0.28,+0.02,7.69,4000,1,1120,0,0,0,0,0,0,0,4000,-4000,-4000
20200212,706924,穩懋元大94購12,0.51,0.67,0.51,0.67,+0.19,39.58,47000,9,26490,0,0,0,0,0,0,2000,45000,-43000,-43000
20200212,706925,穩懋元大94購13,0.82,1.11,0.78,1.01,+0.29,40.28,219000,22,195010,0,0,0,0,0,0,145000,101000,44000,44000
20200212,706926,晟德元大94購02,,,,,,0.00,0,0,0,0,0,0,0,0,0,0,0,0,0
20200212,706927,上詮永豐94購03,,,,,,0.00,0,0,0,0,0,0,0,0,0,0,0,0,0
20200212,706928,大學光永豐96購01,1.46,1.54,1.46,1.54,+0.13,9.22,158000,11,235270,0,0,0,0,0,0,8000,150000,-142000,-142000
20200212,706929,昇達科永豐94購03,0.29,0.30,0.29,0.30,+0.04,15.38,20000,2,5900,0,0,0,0,0,0,0,20000,-20000,-20000
20200212,706930,穩懋永豐94購03,0.11,0.18,0.11,0.18,+0.08,80.0,219000,3,27090,0,0,0,0,0,0,159000,60000,99000,99000
20200212,706931,穩懋統一94購06,0.57,0.71,0.54,0.71,+0.18,33.96,438000,18,263000,0,0,0,0,0,0,107000,331000,-224000,-224000
20200212,706932,穩懋統一94購07,0.42,0.49,0.41,0.49,+0.08,19.51,264000,14,116660,0,0,0,0,0,0,161000,103000,58000,58000
20200212,706933,神盾中信97購01,0.10,0.11,0.10,0.11,+0.01,10.0,400000,11,43800,0,0,0,0,0,0,30000,349000,-319000,-319000
20200212,706934,環宇中信97購01,0.38,0.38,0.38,0.38,+0.01,2.7,105000,2,39900,0,0,0,0,0,0,5000,100000,-95000,-95000
20200212,706935,VHQ凱基96購01,,,,,,0.00,0,0,0,0,0,0,0,0,0,0,0,0,0
20200212,706936,台燿凱基96購01,1.35,1.39,1.35,1.39,+0.20,16.81,240000,5,324900,0,0,0,0,0,0,230000,10000,220000,220000
20200212,706937,宜鼎凱基96購01,4.04,4.04,3.96,3.96,+0.25,6.74,9000,3,36000,0,0,0,0,0,0,9000,5000,4000,4000
20200212,706938,原相凱基94購01,4.31,4.67,2.50,4.46,+0.11,2.53,265000,47,1145560,0,0,0,0,0,0,247000,58000,189000,189000
20200212,706939,環球晶凱基94購11,4.16,4.16,4.13,4.13,+0.23,5.9,4000,3,16580,0,0,0,0,0,0,4000,4000,0,0
20200212,706940,穩懋凱基96購01,0.57,0.66,0.57,0.62,+0.13,26.53,105000,11,64400,0,0,0,0,0,0,15000,90000,-75000,-75000
20200212,706941,譜瑞凱基96購01,3.86,3.99,3.74,3.93,+0.50,14.58,65000,11,250610,0,0,0,0,0,0,47000,64000,-17000,-17000
20200212,706942,大中國票96購01,0.64,0.73,0.64,0.71,+0.08,12.7,91000,11,62720,0,0,0,0,0,0,20000,71000,-51000,-51000
20200212,706943,中美晶國票94購03,3.29,3.80,3.29,3.48,+0.33,10.48,70000,7,253400,0,0,0,0,0,0,30000,40000,-10000,-10000
20200212,706944,美琪瑪國票94購02,,,,,,0.00,0,0,0,0,0,0,0,0,0,0,0,0,0
20200212,706945,碩禾國票96購01,1.77,1.88,1.70,1.77,-0.02,-1.12,279000,15,503420,0,0,0,0,0,0,106000,173000,-67000,-67000
20200212,706946,環球晶國票96購01,,,,,,0.00,0,0,0,0,0,0,0,0,0,0,0,0,0
20200212,706947,大田國泰96購01,0.47,0.47,0.47,0.47,+0.02,4.44,287000,3,134890,0,0,0,0,0,0,0,287000,-287000,-287000
20200212,706948,穩懋國泰94購03,0.91,1.21,0.87,1.14,+0.24,26.67,2073000,56,2179690,0,0,0,0,0,0,1613000,1149000,464000,464000
20200212,706949,穩懋國泰94購04,0.65,0.76,0.64,0.76,+0.14,22.58,908000,22,667800,0,0,0,0,0,0,540000,368000,172000,172000
20200212,706950,雙鴻富邦96購01,0.09,0.09,0.05,0.05,-0.04,-44.44,280000,3,24000,0,0,0,0,0,0,30000,150000,-120000,-120000
20200212,706951,新鉅科元富94購01,,,,,,0.00,0,0,0,0,0,0,0,0,0,0,0,0,0
20200212,706952,新鉅科元富96購01,,,,,,0.00,0,0,0,0,0,0,0,0,0,0,0,0,0
20200212,706953,精華元富94購01,0.64,0.65,0.64,0.65,+0.01,1.56,320000,8,206850,0,0,0,0,0,0,170000,160000,10000,10000
20200212,706954,環球晶元富94購07,2.78,2.95,2.72,2.87,+0.14,5.13,100000,7,280130,0,0,0,0,0,0,76000,30000,46000,46000
20200212,706955,穩懋台新94購01,,,,,,0.00,0,0,0,0,0,0,0,0,0,0,0,0,0
20200212,706956,原相群益96購03,,,,,,0.00,0,0,0,0,0,0,0,0,0,0,0,0,0
20200212,706957,群聯群益94購04,1.44,1.44,1.44,1.44,+0.06,4.35,1000,1,1440,0,0,0,0,0,0,1000,0,1000,1000
20200212,706958,環球晶群益94購08,1.97,2.15,1.97,2.09,+0.17,8.85,149000,20,313960,0,0,0,0,0,0,129000,29000,100000,100000
20200212,706959,廣明元大94購02,,,,,,0.00,0,0,0,0,0,0,0,0,0,0,0,0,0
20200212,706960,雙鴻元大96購01,0.15,0.15,0.15,0.15,+0.01,7.14,147000,6,22050,0,0,0,0,0,0,87000,40000,47000,47000
20200212,706961,金可中信96購01,0.47,0.47,0.47,0.47,+0.06,14.63,2000,1,940,0,0,0,0,0,0,0,2000,-2000,-2000
20200212,706962,勝麗中信97購01,1.11,1.25,1.11,1.20,+0.09,8.11,144000,15,168670,0,0,0,0,0,0,94000,50000,44000,44000
20200212,706963,群聯中信97購01,0.94,0.94,0.94,0.94,+0.03,3.3,20000,2,18800,0,0,0,0,0,0,0,20000,-20000,-20000
20200212,706964,碩禾中信94購01,0.51,0.54,0.49,0.51,-0.02,-3.77,304000,5,156600,0,0,0,0,0,0,132000,172000,-40000,-40000
20200212,706965,群聯統一96購01,2.68,2.76,2.68,2.70,+0.07,2.66,115000,5,313200,0,0,0,0,0,0,30000,85000,-55000,-55000
20200212,706966,三貝德凱基96購01,,,,,,0.00,0,0,0,0,0,0,0,0,0,0,0,0,0
20200212,706967,由田凱基94購03,,,,,,0.00,0,0,0,0,0,0,0,0,0,0,0,0,0
20200212,706968,昇達科凱基94購02,,,,,,0.00,0,0,0,0,0,0,0,0,0,0,0,0,0
20200212,706969,信驊凱基96購01,1.15,1.15,1.12,1.14,+0.01,0.88,189000,6,214660,0,0,0,0,0,0,25000,164000,-139000,-139000
20200212,706970,茂達凱基96購01,,,,,,0.00,0,0,0,0,0,0,0,0,0,0,0,0,0
20200212,706971,振曜凱基94購01,0.62,0.62,0.62,0.62,+0.03,5.08,30000,1,18600,0,0,0,0,0,0,30000,0,30000,30000
20200212,706972,環球晶凱基94購12,3.45,3.45,3.35,3.41,+0.30,9.65,29000,6,98390,0,0,0,0,0,0,9000,29000,-20000,-20000
20200212,706973,穩懋凱基96購02,0.58,0.69,0.58,0.69,+0.16,30.19,8000,4,5180,0,0,0,0,0,0,8000,0,8000,8000
20200212,706974,穩懋富邦96購03,0.27,0.35,0.25,0.31,+0.06,24.0,3274000,71,926620,0,0,0,0,0,0,2023000,1141000,882000,882000
20200212,706975,穩懋富邦96購04,0.50,0.62,0.50,0.62,+0.14,29.17,248000,7,136340,0,0,0,0,0,0,22000,226000,-204000,-204000
20200212,706976,大江國泰96購01,,,,,,0.00,0,0,0,0,0,0,0,0,0,0,0,0,0
20200212,706977,神盾國泰96購01,0.38,0.40,0.37,0.40,+0.05,14.29,380000,14,150740,0,0,0,0,0,0,60000,320000,-260000,-260000
20200212,706978,中美晶元富94購03,1.58,1.81,1.58,1.64,+0.04,2.5,299000,8,492180,0,0,0,0,0,0,204000,95000,109000,109000
20200212,706979,神盾元富94購02,,,,,,0.00,0,0,0,0,0,0,0,0,0,0,0,0,0
20200212,706980,環球晶元富94購08,2.44,2.49,2.44,2.49,+0.29,13.18,51000,2,124490,0,0,0,0,0,0,1000,51000,-50000,-50000
20200212,706981,中美晶台新94購02,1.36,1.36,1.36,1.36,+0.10,7.94,26000,1,35360,0,0,0,0,0,0,0,26000,-26000,-26000
20200212,706982,穩懋台新94購02,0.73,0.76,0.73,0.76,+0.15,24.59,264000,4,195160,0,0,0,0,0,0,150000,114000,36000,36000
20200212,706983,元太國票94購01,1.01,1.09,1.01,1.09,+0.11,11.22,94000,7,98360,0,0,0,0,0,0,0,94000,-94000,-94000
20200212,706984,合晶國票96購01,0.72,0.75,0.72,0.75,+0.11,17.19,180000,4,131640,0,0,0,0,0,0,0,180000,-180000,-180000
20200212,706985,建榮國票96購02,,,,,,0.00,0,0,0,0,0,0,0,0,0,0,0,0,0
20200212,706986,網家國票96購01,0.35,0.35,0.31,0.31,-0.03,-8.82,119000,17,40850,0,0,0,0,0,0,81000,38000,43000,43000
20200212,706987,聯亞國票94購03,,,,,,0.00,0,0,0,0,0,0,0,0,0,0,0,0,0
20200212,706988,信昌電永豐94購04,1.55,1.55,1.50,1.52,-0.12,-7.32,70000,4,107100,0,0,0,0,0,0,40000,40000,0,0
20200212,706989,博智永豐94購02,1.16,1.30,1.13,1.19,+0.11,10.19,928000,76,1101210,0,0,0,0,0,0,512000,376000,136000,136000
20200212,706990,中美晶中信97購01,1.78,1.94,1.75,1.94,+0.18,10.23,50000,6,90800,0,0,0,0,0,0,23000,30000,-7000,-7000
20200212,706991,弘塑中信97購01,2.23,2.27,2.23,2.27,+0.07,3.18,30000,3,67600,0,0,0,0,0,0,10000,20000,-10000,-10000
20200212,706992,神盾中信96購01,0.08,0.09,0.08,0.09,+0.01,12.5,20000,2,1700,0,0,0,0,0,0,0,20000,-20000,-20000
20200212,706993,環球晶中信96購01,0.85,0.88,0.83,0.88,+0.06,7.32,700000,16,605440,0,0,0,0,0,0,189000,511000,-322000,-322000
20200212,706994,譜瑞中信95購01,1.58,1.79,1.53,1.67,+0.17,11.33,544000,45,892430,0,0,0,0,0,0,133000,411000,-278000,-278000
20200212,706995,弘塑統一96購01,4.67,4.67,4.64,4.67,+0.06,1.3,11000,3,51100,0,0,0,0,0,0,11000,0,11000,11000
20200212,706996,群聯統一96購02,3.01,3.10,3.01,3.10,+0.09,2.99,20000,2,61100,0,0,0,0,0,0,0,20000,-20000,-20000
20200212,706997,環球晶統一95購01,2.00,2.08,1.95,2.08,+0.15,7.77,253000,9,499080,0,0,0,0,0,0,253000,0,253000,253000
20200212,706998,M31凱基95購01,,,,,,0.00,0,0,0,0,0,0,0,0,0,0,0,0,0
20200212,706999,中美晶凱基95購01,1.77,1.82,1.68,1.68,+0.10,6.33,93000,3,163760,0,0,0,0,0,0,0,93000,-93000,-93000
20200212,707000,台燿凱基96購02,1.17,1.28,0.42,1.28,+0.23,21.9,310000,10,357530,0,0,0,0,0,0,277000,33000,244000,244000
20200212,707001,旺矽凱基95購01,,,,,,0.00,0,0,0,0,0,0,0,0,0,0,0,0,0
20200212,707002,昂寶凱基95購01,,,,,,0.00,0,0,0,0,0,0,0,0,0,0,0,0,0
20200212,707003,神盾凱基96購01,,,,,,0.00,0,0,0,0,0,0,0,0,0,0,0,0,0
20200212,707004,廣明凱基95購01,0.45,0.47,0.45,0.47,-0.02,-4.08,30000,5,13880,0,0,0,0,0,0,30000,0,30000,30000
20200212,707005,環宇凱基95購01,0.55,0.57,0.55,0.57,0.00,0.0,140000,3,77200,0,0,0,0,0,0,30000,110000,-80000,-80000
20200212,707006,環球晶凱基95購01,2.95,2.95,2.90,2.92,+0.26,9.77,30000,5,87140,0,0,0,0,0,0,7000,30000,-23000,-23000
20200212,707007,穩懋凱基95購01,0.32,0.48,0.32,0.48,+0.20,71.43,110000,5,45600,0,0,0,0,0,0,80000,30000,50000,50000
20200212,707008,神盾元富95購03,,,,,,0.00,0,0,0,0,0,0,0,0,0,0,0,0,0
20200212,707009,群聯元富95購01,,,,,,0.00,0,0,0,0,0,0,0,0,0,0,0,0,0
20200212,707010,聯亞元富95購01,2.09,2.09,2.05,2.05,+0.11,5.67,43000,2,88550,0,0,0,0,0,0,0,43000,-43000,-43000
20200212,707011,穩懋元富95購02,0.78,1.03,0.78,0.96,+0.22,29.73,775000,19,678160,0,0,0,0,0,0,485000,340000,145000,145000
20200212,707012,穩懋元富95購03,0.43,0.45,0.43,0.45,+0.07,18.42,198000,3,87100,0,0,0,0,0,0,0,198000,-198000,-198000
20200212,707013,良維兆豐96購01,,,,,,0.00,0,0,0,0,0,0,0,0,0,0,0,0,0
20200212,707014,長科*康和95購01,,,,,,0.00,0,0,0,0,0,0,0,0,0,0,0,0,0
20200212,707015,應華康和95購01,,,,,,0.00,0,0,0,0,0,0,0,0,0,0,0,0,0
20200212,707016,大田元大95購01,,,,,,0.00,0,0,0,0,0,0,0,0,0,0,0,0,0
20200212,707017,弘塑元大95購01,3.76,3.97,3.76,3.97,+0.18,4.75,36000,6,138490,0,0,0,0,0,0,21000,3000,18000,18000
20200212,707018,合晶元大96購02,0.79,0.97,0.79,0.97,+0.29,42.65,120000,6,102220,0,0,0,0,0,0,0,120000,-120000,-120000
20200212,707019,金居元大96購01,0.81,0.89,0.81,0.89,+0.10,12.66,53000,4,45450,0,0,0,0,0,0,27000,53000,-26000,-26000
20200212,707020,信昌電元大96購02,1.94,1.97,1.89,1.94,-0.02,-1.02,279000,39,540390,0,0,0,0,0,0,174000,167000,7000,7000
20200212,707021,群聯元大95購05,,,,,,0.00,0,0,0,0,0,0,0,0,0,0,0,0,0
20200212,707022,譜瑞元大95購02,2.98,3.36,2.88,3.16,+0.38,13.67,190000,24,614220,0,0,0,0,0,0,68000,155000,-87000,-87000
20200212,707023,晟德元大95購01,,,,,,0.00,0,0,0,0,0,0,0,0,0,0,0,0,0
20200212,707024,由田國票96購01,0.41,0.41,0.41,0.41,+0.01,2.5,90000,1,36900,0,0,0,0,0,0,90000,0,90000,90000
20200212,707025,杰力國票96購01,,,,,,0.00,0,0,0,0,0,0,0,0,0,0,0,0,0
20200212,707026,晶焱國票96購01,0.93,0.97,0.93,0.96,+0.10,11.63,70000,4,66300,0,0,0,0,0,0,50000,20000,30000,30000
20200212,707027,網龍國票96購01,2.04,2.04,2.04,2.04,-0.09,-4.23,10000,1,20400,0,0,0,0,0,0,10000,0,10000,10000
20200212,707028,優群國票95購02,,,,,,0.00,0,0,0,0,0,0,0,0,0,0,0,0,0
20200212,707029,大宇資國泰97購01,0.50,0.50,0.50,0.50,-0.02,-3.85,12000,2,6000,0,0,0,0,0,0,12000,0,12000,12000
20200212,707030,建榮國泰97購01,,,,,,0.00,0,0,0,0,0,0,0,0,0,0,0,0,0
20200212,707031,中美晶第一95購01,,,,,,0.00,0,0,0,0,0,0,0,0,0,0,0,0,0
20200212,707032,大江永豐95購01,,,,,,0.00,0,0,0,0,0,0,0,0,0,0,0,0,0
20200212,707033,中光電永豐95購01,0.32,0.32,0.32,0.32,+0.06,23.08,150000,1,48000,0,0,0,0,0,0,0,150000,-150000,-150000
20200212,707034,中美晶永豐95購01,0.82,0.93,0.79,0.93,+0.14,17.72,107000,7,88450,0,0,0,0,0,0,58000,49000,9000,9000
20200212,707035,弘塑永豐95購01,2.38,2.46,2.38,2.46,+0.12,5.13,50000,5,122000,0,0,0,0,0,0,0,50000,-50000,-50000
20200212,707036,環宇永豐95購01,,,,,,0.00,0,0,0,0,0,0,0,0,0,0,0,0,0
20200212,707037,晟德永豐95購01,,,,,,0.00,0,0,0,0,0,0,0,0,0,0,0,0,0
20200212,707038,譜瑞富邦97購01,1.20,1.33,1.17,1.25,+0.08,6.84,1684000,128,2117630,0,0,0,0,0,0,734000,902000,-168000,-168000
20200212,707039,良維中信95購01,,,,,,0.00,0,0,0,0,0,0,0,0,0,0,0,0,0
20200212,707040,台半凱基95購01,,,,,,0.00,0,0,0,0,0,0,0,0,0,0,0,0,0
20200212,707041,合晶凱基95購01,,,,,,0.00,0,0,0,0,0,0,0,0,0,0,0,0,0
20200212,707042,建榮凱基95購01,,,,,,0.00,0,0,0,0,0,0,0,0,0,0,0,0,0
20200212,707043,勝麗凱基95購01,0.80,0.93,0.80,0.85,+0.04,4.94,469000,11,423870,0,0,0,0,0,0,379000,90000,289000,289000
20200212,707044,晟德凱基95購01,,,,,,0.00,0,0,0,0,0,0,0,0,0,0,0,0,0
20200212,707045,VHQ元大95購01,0.28,0.45,0.28,0.45,+0.20,80.0,363000,13,123670,0,0,0,0,0,0,135000,155000,-20000,-20000
20200212,707046,大宇資元大97購01,,,,,,0.00,0,0,0,0,0,0,0,0,0,0,0,0,0
20200212,707047,台半元大95購01,,,,,,0.00,0,0,0,0,0,0,0,0,0,0,0,0,0
20200212,707048,昇達科元大96購03,0.51,0.51,0.51,0.51,+0.05,10.87,45000,1,22950,0,0,0,0,0,0,0,45000,-45000,-45000
20200212,707049,杰力元大96購02,0.49,0.50,0.49,0.50,+0.01,2.04,120000,4,59580,0,0,0,0,0,0,120000,0,120000,120000
20200212,707050,信昌電元大96購03,1.48,1.48,1.42,1.42,-0.18,-11.25,210000,14,303800,0,0,0,0,0,0,200000,60000,140000,140000
20200212,707051,神盾元大97購01,0.48,0.52,0.48,0.50,+0.07,16.28,119000,5,58280,0,0,0,0,0,0,0,119000,-119000,-119000
20200212,707052,博智元大95購02,3.35,3.77,3.30,3.49,+0.26,8.05,154000,22,535730,0,0,0,0,0,0,83000,70000,13000,13000
20200212,707053,群聯元大96購01,,,,,,0.00,0,0,0,0,0,0,0,0,0,0,0,0,0
20200212,707054,合晶國泰97購01,0.86,1.03,0.86,1.02,+0.22,27.5,139000,17,132770,0,0,0,0,0,0,20000,119000,-99000,-99000
20200212,707055,大江國票96購01,,,,,,0.00,0,0,0,0,0,0,0,0,0,0,0,0,0
20200212,707056,台半國票96購01,0.92,0.95,0.92,0.93,-0.02,-2.11,75000,9,69690,0,0,0,0,0,0,75000,0,75000,75000
20200212,707057,弘塑國票95購01,11.40,11.40,11.40,11.40,+0.70,6.54,8000,1,91200,0,0,0,0,0,0,0,8000,-8000,-8000
20200212,707058,同致國票95購02,,,,,,0.00,0,0,0,0,0,0,0,0,0,0,0,0,0
20200212,707059,聚積國票95購01,0.42,0.42,0.42,0.42,+0.04,10.53,10000,1,4200,0,0,0,0,0,0,10000,0,10000,10000
20200212,707060,廣明國票95購02,0.53,0.54,0.53,0.53,+0.01,1.92,101000,4,54330,0,0,0,0,0,0,101000,0,101000,101000
20200212,707061,聯亞國票96購01,,,,,,0.00,0,0,0,0,0,0,0,0,0,0,0,0,0
20200212,707062,精華富邦95購01,,,,,,0.00,0,0,0,0,0,0,0,0,0,0,0,0,0
20200212,707063,中美晶兆豐96購01,0.78,0.84,0.74,0.78,+0.03,4.0,446000,28,351650,0,0,0,0,0,0,311000,152000,159000,159000
20200212,707064,弘塑康和95購01,2.49,2.49,2.47,2.47,+0.04,1.65,20000,2,49600,0,0,0,0,0,0,10000,10000,0,0
20200212,707065,新普群益97購01,2.58,2.67,2.49,2.67,+0.30,12.66,85000,13,219660,0,0,0,0,0,0,59000,65000,-6000,-6000
20200212,707066,精華群益95購01,,,,,,0.00,0,0,0,0,0,0,0,0,0,0,0,0,0
20200212,707067,精華群益95購02,0.08,0.08,0.08,0.08,0.00,0.0,40000,1,3200,0,0,0,0,0,0,0,40000,-40000,-40000
20200212,707068,譜瑞群益95購01,2.68,3.19,2.67,2.94,+0.29,10.94,265000,42,782550,0,0,0,0,0,0,125000,165000,-40000,-40000
20200212,707069,中美晶元富95購04,1.50,1.73,1.50,1.69,+0.22,14.97,274000,10,442360,0,0,0,0,0,0,50000,224000,-174000,-174000
20200212,707070,良維元富95購01,,,,,,0.00,0,0,0,0,0,0,0,0,0,0,0,0,0
20200212,707071,環球晶元富95購04,1.64,1.76,1.64,1.76,+0.14,8.64,18000,4,30680,0,0,0,0,0,0,12000,12000,0,0
20200212,707072,鈺太台新95購01,1.14,1.56,1.14,1.56,+0.44,39.29,217000,8,264420,0,0,0,0,0,0,0,217000,-217000,-217000
20200212,707073,台半永豐95購01,0.16,0.16,0.16,0.16,-0.01,-5.88,10000,1,1600,0,0,0,0,0,0,10000,0,10000,10000
20200212,707074,昂寶永豐96購01,,,,,,0.00,0,0,0,0,0,0,0,0,0,0,0,0,0
20200212,707075,廣明永豐96購01,,,,,,0.00,0,0,0,0,0,0,0,0,0,0,0,0,0
20200212,707076,東洋中信95購01,,,,,,0.00,0,0,0,0,0,0,0,0,0,0,0,0,0
20200212,707077,精華中信97購01,0.16,0.16,0.16,0.16,-0.01,-5.88,20000,1,3200,0,0,0,0,0,0,20000,0,20000,20000
20200212,707078,環宇中信97購02,0.17,0.17,0.17,0.17,+0.01,6.25,250000,1,42500,0,0,0,0,0,0,250000,0,250000,250000
20200212,707079,晟德中信97購01,0.12,0.12,0.12,0.12,+0.01,9.09,1229000,8,147480,0,0,0,0,0,0,0,1229000,-1229000,-1229000
20200212,707080,弘塑統一98購01,2.72,2.80,2.66,2.80,+0.19,7.28,284000,33,783110,0,0,0,0,0,0,64000,215000,-151000,-151000
20200212,707081,世界凱基95購01,4.06,4.06,4.06,4.06,+0.25,6.56,20000,1,81200,0,0,0,0,0,0,0,20000,-20000,-20000
20200212,707082,環球晶凱基95購04,3.90,4.13,3.90,4.10,+0.30,7.89,27000,8,107980,0,0,0,0,0,0,24000,27000,-3000,-3000
20200212,707083,大江元大96購02,0.05,0.06,0.05,0.06,+0.01,20.0,110000,2,5600,0,0,0,0,0,0,100000,10000,90000,90000
20200212,707084,原相元大97購01,6.85,6.85,6.75,6.75,+0.35,5.47,9000,9,61150,0,0,0,0,0,0,9000,7000,2000,2000
20200212,707085,群聯元大96購02,,,,,,0.00,0,0,0,0,0,0,0,0,0,0,0,0,0
20200212,707086,網龍元大95購01,1.11,1.11,1.08,1.10,-0.09,-7.56,158000,16,172090,0,0,0,0,0,0,158000,0,158000,158000
20200212,707087,環宇元大95購01,0.64,0.68,0.64,0.66,0.00,0.0,715000,10,474200,0,0,0,0,0,0,10000,705000,-695000,-695000
20200212,707088,兆利永豐95購01,1.10,1.13,1.03,1.12,-0.02,-1.75,216000,32,232660,0,0,0,0,0,0,178000,25000,153000,153000
20200212,707089,亞泰永豐95購01,0.75,0.75,0.72,0.74,-0.01,-1.33,468000,28,346360,0,0,0,0,0,0,458000,10000,448000,448000
20200212,707090,順達永豐95購01,,,,,,0.00,0,0,0,0,0,0,0,0,0,0,0,0,0
20200212,707091,緯軟永豐95購01,,,,,,0.00,0,0,0,0,0,0,0,0,0,0,0,0,0
20200212,707092,環宇永豐95購02,,,,,,0.00,0,0,0,0,0,0,0,0,0,0,0,0,0
20200212,707093,廣明國泰96購01,0.80,0.80,0.80,0.80,-0.05,-5.88,1000,1,800,0,0,0,0,0,0,1000,0,1000,1000
20200212,707094,中美晶國票96購01,3.61,3.88,3.53,3.53,+0.21,6.33,36000,8,131950,0,0,0,0,0,0,2000,34000,-32000,-32000
20200212,707095,宜鼎國票96購01,9.60,9.60,9.20,9.20,+0.25,2.79,11000,3,103200,0,0,0,0,0,0,6000,10000,-4000,-4000
20200212,707096,環宇國票95購01,,,,,,0.00,0,0,0,0,0,0,0,0,0,0,0,0,0
20200212,707097,穩懋國票96購02,1.20,1.48,1.18,1.48,+0.29,24.37,401000,29,519600,0,0,0,0,0,0,294000,107000,187000,187000
20200212,707098,台燿兆豐96購01,0.95,1.03,0.95,1.03,+0.15,17.05,494000,22,491160,0,0,0,0,0,0,146000,158000,-12000,-12000
20200212,707099,穩懋兆豐96購01,0.91,1.09,0.90,1.04,+0.15,16.85,274000,25,259930,0,0,0,0,0,0,235000,79000,156000,156000
20200212,707100,台半群益95購01,0.64,0.69,0.64,0.69,0.00,0.0,22000,6,14870,0,0,0,0,0,0,22000,0,22000,22000
20200212,707101,合晶群益95購01,0.39,0.54,0.39,0.49,+0.13,36.11,632000,25,303370,0,0,0,0,0,0,11000,621000,-610000,-610000
20200212,707102,原相群益96購04,,,,,,0.00,0,0,0,0,0,0,0,0,0,0,0,0,0
20200212,707103,合晶元富95購01,0.35,0.37,0.35,0.37,+0.08,27.59,60000,6,21500,0,0,0,0,0,0,0,60000,-60000,-60000
20200212,707104,六角兆豐96購01,0.59,0.65,0.59,0.59,+0.04,7.27,50000,5,30600,0,0,0,0,0,0,10000,40000,-30000,-30000
20200212,707105,弘塑台新95購01,,,,,,0.00,0,0,0,0,0,0,0,0,0,0,0,0,0
20200212,707106,原相台新97購01,,,,,,0.00,0,0,0,0,0,0,0,0,0,0,0,0,0
20200212,707107,聯亞台新95購01,0.52,0.52,0.50,0.50,+0.02,4.17,102000,2,51040,0,0,0,0,0,0,102000,0,102000,102000
20200212,707108,新普群益97購02,2.32,2.37,2.17,2.37,+0.23,10.75,81000,11,186690,0,0,0,0,0,0,51000,45000,6000,6000
20200212,707109,環宇群益97購01,,,,,,0.00,0,0,0,0,0,0,0,0,0,0,0,0,0
20200212,707110,環球晶群益95購01,2.69,2.84,2.64,2.78,+0.16,6.11,47000,10,129790,0,0,0,0,0,0,27000,27000,0,0
20200212,707111,元太元大95購02,0.99,1.00,0.99,1.00,-0.01,-0.99,2000,2,1990,0,0,0,0,0,0,2000,0,2000,2000
20200212,707112,台燿元大95購01,1.28,1.41,1.28,1.39,+0.22,18.8,198000,12,271210,0,0,0,0,0,0,62000,137000,-75000,-75000
20200212,707113,金居元大96購02,0.43,0.47,0.42,0.45,+0.03,7.14,210000,13,90440,0,0,0,0,0,0,204000,6000,198000,198000
20200212,707114,建榮元大96購01,,,,,,0.00,0,0,0,0,0,0,0,0,0,0,0,0,0
20200212,707115,神準元大95購01,0.30,0.31,0.30,0.31,+0.01,3.33,53000,3,15930,0,0,0,0,0,0,50000,3000,47000,47000
20200212,707116,環宇元大95購02,,,,,,0.00,0,0,0,0,0,0,0,0,0,0,0,0,0
20200212,707117,聯亞元大96購01,0.93,0.93,0.88,0.88,+0.03,3.53,20000,3,18150,0,0,0,0,0,0,5000,15000,-10000,-10000
20200212,707118,穩懋元大95購02,1.23,1.57,1.17,1.49,+0.30,25.21,406000,85,539280,0,0,0,0,0,0,284000,293000,-9000,-9000
20200212,707119,群聯凱基95購01,2.69,2.69,2.63,2.63,-0.01,-0.38,65000,5,171130,0,0,0,0,0,0,0,65000,-65000,-65000
20200212,707120,環球晶凱基95購06,2.90,3.25,2.30,3.17,+0.32,11.23,133000,21,404130,0,0,0,0,0,0,79000,54000,25000,25000
20200212,707121,大江國票97購01,0.19,0.19,0.19,0.19,-0.01,-5.0,199000,1,37810,0,0,0,0,0,0,199000,0,199000,199000
20200212,707122,昂寶國票96購01,,,,,,0.00,0,0,0,0,0,0,0,0,0,0,0,0,0
20200212,707123,保瑞國票96購01,1.52,1.53,1.46,1.46,+0.05,3.55,106000,9,160450,0,0,0,0,0,0,49000,57000,-8000,-8000
20200212,707124,環宇國泰96購01,0.41,0.41,0.41,0.41,-0.01,-2.38,175000,2,71750,0,0,0,0,0,0,50000,125000,-75000,-75000
20200212,707125,環球晶國泰96購01,3.75,3.95,3.73,3.92,+0.21,5.66,45000,10,172780,0,0,0,0,0,0,20000,35000,-15000,-15000
20200212,707126,久元永豐95購01,0.92,0.94,0.92,0.92,+0.04,4.55,145000,8,134110,0,0,0,0,0,0,30000,115000,-85000,-85000
20200212,707127,弘塑永豐95購02,1.87,1.96,1.87,1.96,+0.12,6.52,202000,22,388290,0,0,0,0,0,0,112000,90000,22000,22000
20200212,707128,神準永豐95購01,,,,,,0.00,0,0,0,0,0,0,0,0,0,0,0,0,0
20200212,707129,穩懋永豐95購02,0.43,0.43,0.43,0.43,+0.11,34.38,50000,1,21500,0,0,0,0,0,0,0,50000,-50000,-50000
20200212,707130,合晶元富95購02,0.72,0.89,0.72,0.89,+0.25,39.06,143000,17,111410,0,0,0,0,0,0,0,143000,-143000,-143000
20200212,707131,金居台新95購01,,,,,,0.00,0,0,0,0,0,0,0,0,0,0,0,0,0
20200212,707132,晟德國泰96購01,,,,,,0.00,0,0,0,0,0,0,0,0,0,0,0,0,0
20200212,707133,中光電群益96購01,1.02,1.19,1.02,1.19,+0.25,26.6,329000,16,361290,0,0,0,0,0,0,10000,319000,-309000,-309000
20200212,707134,元太群益96購01,1.06,1.06,1.06,1.06,+0.04,3.92,11000,1,11660,0,0,0,0,0,0,0,11000,-11000,-11000
20200212,707135,原相群益97購03,2.92,3.24,2.73,2.92,-0.01,-0.34,126000,29,367140,0,0,0,0,0,0,91000,15000,76000,76000
20200212,707136,群聯群益97購01,1.10,1.14,1.07,1.11,+0.03,2.78,775000,23,861760,0,0,0,0,0,0,151000,755000,-604000,-604000
20200212,707137,VHQ永豐95購01,0.10,0.10,0.10,0.10,+0.04,66.67,2000,2,200,0,0,0,0,0,0,0,2000,-2000,-2000
20200212,707138,大宇資永豐95購01,,,,,,0.00,0,0,0,0,0,0,0,0,0,0,0,0,0
20200212,707139,台星科永豐95購01,0.26,0.29,0.26,0.29,+0.03,11.54,149000,4,39640,0,0,0,0,0,0,109000,40000,69000,69000
20200212,707140,立端永豐95購01,0.54,0.73,0.54,0.73,+0.22,43.14,194000,9,118160,0,0,0,0,0,0,20000,174000,-154000,-154000
20200212,707141,合晶永豐95購02,0.57,0.72,0.57,0.72,+0.19,35.85,274000,7,170110,0,0,0,0,0,0,0,274000,-274000,-274000
20200212,707142,直得永豐95購01,1.82,1.97,1.82,1.92,+0.03,1.59,248000,13,474880,0,0,0,0,0,0,123000,125000,-2000,-2000
20200212,707143,精華永豐95購01,0.61,0.61,0.59,0.60,+0.02,3.45,243000,3,146120,0,0,0,0,0,0,168000,75000,93000,93000
20200212,707144,璟德永豐95購01,2.62,2.77,2.61,2.75,-0.05,-1.79,179000,14,482880,0,0,0,0,0,0,92000,90000,2000,2000
20200212,707145,環球晶永豐95購01,0.80,0.88,0.80,0.86,+0.08,10.26,128000,7,107720,0,0,0,0,0,0,58000,73000,-15000,-15000
20200212,707146,群聯凱基95購02,1.34,1.36,1.34,1.36,+0.10,7.94,59000,3,80060,0,0,0,0,0,0,59000,39000,20000,20000
20200212,707147,大江元大96購03,,,,,,0.00,0,0,0,0,0,0,0,0,0,0,0,0,0
20200212,707148,金可元大95購01,,,,,,0.00,0,0,0,0,0,0,0,0,0,0,0,0,0
20200212,707149,群聯元大96購03,,,,,,0.00,0,0,0,0,0,0,0,0,0,0,0,0,0
20200212,707150,網家元大95購01,0.21,0.21,0.18,0.18,-0.03,-14.29,60000,2,11700,0,0,0,0,0,0,60000,0,60000,60000
20200212,707151,環球晶元大95購04,2.83,3.00,2.83,2.91,+0.14,5.05,45000,9,129130,0,0,0,0,0,0,35000,21000,14000,14000
20200212,707152,環球晶元大95購05,2.51,2.65,2.46,2.60,+0.20,8.33,77000,9,196170,0,0,0,0,0,0,52000,33000,19000,19000
20200212,707153,櫃200元大95購01,,,,,,0.00,0,0,0,0,0,0,0,0,0,0,0,0,0
20200212,707154,雙鴻元大97購02,0.27,0.29,0.27,0.28,+0.01,3.7,45000,4,12500,0,0,0,0,0,0,15000,30000,-15000,-15000
20200212,707155,大宇資元富95購01,,,,,,0.00,0,0,0,0,0,0,0,0,0,0,0,0,0
20200212,707156,昂寶元富95購01,,,,,,0.00,0,0,0,0,0,0,0,0,0,0,0,0,0
20200212,707157,同致兆豐96購01,0.31,0.31,0.31,0.31,+0.02,6.9,4000,2,1240,0,0,0,0,0,0,4000,0,4000,4000
20200212,707158,威剛兆豐96購01,2.31,2.31,2.31,2.31,+0.12,5.48,11000,2,25410,0,0,0,0,0,0,10000,1000,9000,9000
20200212,707159,網龍兆豐96購01,0.49,0.51,0.49,0.51,+0.01,2.0,551000,11,270210,0,0,0,0,0,0,310000,240000,70000,70000
20200212,707160,環球晶群益95購02,4.05,4.33,4.01,4.25,+0.33,8.42,56000,17,235210,0,0,0,0,0,0,41000,43000,-2000,-2000
20200212,707161,元太國票96購01,,,,,,0.00,0,0,0,0,0,0,0,0,0,0,0,0,0
20200212,707162,旺矽國票96購01,,,,,,0.00,0,0,0,0,0,0,0,0,0,0,0,0,0
20200212,707163,信昌電國票96購01,2.46,2.46,2.46,2.46,-0.18,-6.82,11000,2,27060,0,0,0,0,0,0,11000,0,11000,11000
20200212,707164,宣德國票96購01,2.03,2.31,2.03,2.31,+0.02,0.87,181000,19,392060,0,0,0,0,0,0,160000,21000,139000,139000
20200212,707165,聚積國票96購01,0.52,0.52,0.52,0.52,+0.01,1.96,38000,1,19760,0,0,0,0,0,0,0,38000,-38000,-38000
20200212,707166,譜瑞國票96購01,3.05,3.55,3.05,3.40,+0.66,24.09,366000,31,1199190,0,0,0,0,0,0,46000,320000,-274000,-274000
20200212,707167,中美晶國泰96購01,2.79,2.92,2.69,2.69,+0.12,4.67,26000,4,73090,0,0,0,0,0,0,0,21000,-21000,-21000
20200212,707168,群聯國泰97購01,2.32,2.39,2.32,2.35,-0.25,-9.62,75000,11,176500,0,0,0,0,0,0,40000,75000,-35000,-35000
20200212,707169,群聯富邦96購01,0.51,0.51,0.51,0.51,+0.03,6.25,3000,1,1530,0,0,0,0,0,0,0,3000,-3000,-3000
20200212,707170,環宇富邦97購01,0.24,0.24,0.24,0.24,+0.01,4.35,2000,1,480,0,0,0,0,0,0,2000,0,2000,2000
20200212,707171,弘塑中信99購01,1.24,1.30,1.23,1.27,+0.07,5.83,491000,65,613850,0,0,0,0,0,0,129000,344000,-215000,-215000
20200212,707172,環球晶中信99購01,0.64,0.70,0.64,0.68,+0.04,6.25,279000,19,186200,0,0,0,0,0,0,213000,66000,147000,147000
20200212,707173,鈺太中信96購01,0.66,0.75,0.66,0.75,+0.11,17.19,339000,9,239800,0,0,0,0,0,0,53000,286000,-233000,-233000
20200212,707174,凡甲凱基96購01,,,,,,0.00,0,0,0,0,0,0,0,0,0,0,0,0,0
20200212,707175,大江凱基96購01,,,,,,0.00,0,0,0,0,0,0,0,0,0,0,0,0,0
20200212,707176,中美晶凱基95購02,0.83,0.91,0.83,0.89,+0.08,9.88,115000,3,100550,0,0,0,0,0,0,0,115000,-115000,-115000
20200212,707177,合晶凱基95購02,0.41,0.41,0.39,0.39,+0.12,44.44,87000,2,34470,0,0,0,0,0,0,0,87000,-87000,-87000
20200212,707178,威剛凱基97購01,3.78,4.65,1.55,3.99,+0.35,9.62,181000,21,694080,0,0,0,0,0,0,149000,39000,110000,110000
20200212,707179,神盾凱基95購01,,,,,,0.00,0,0,0,0,0,0,0,0,0,0,0,0,0
20200212,707180,新鉅科凱基95購01,,,,,,0.00,0,0,0,0,0,0,0,0,0,0,0,0,0
20200212,707181,由田永豐95購01,0.61,0.62,0.61,0.62,+0.02,3.33,158000,3,96680,0,0,0,0,0,0,158000,0,158000,158000
20200212,707182,同致永豐95購01,0.43,0.43,0.43,0.43,+0.01,2.38,148000,2,63640,0,0,0,0,0,0,80000,68000,12000,12000
20200212,707183,良維永豐95購02,,,,,,0.00,0,0,0,0,0,0,0,0,0,0,0,0,0
20200212,707184,昇達科永豐95購01,,,,,,0.00,0,0,0,0,0,0,0,0,0,0,0,0,0
20200212,707185,杰力永豐95購01,,,,,,0.00,0,0,0,0,0,0,0,0,0,0,0,0,0
20200212,707186,金可永豐95購01,,,,,,0.00,0,0,0,0,0,0,0,0,0,0,0,0,0
20200212,707187,中美晶元大95購04,1.02,1.13,0.97,1.10,+0.09,8.91,360000,20,375960,0,0,0,0,0,0,219000,141000,78000,78000
20200212,707188,六角元大95購01,0.91,1.06,0.91,0.93,+0.09,10.71,178000,12,174740,0,0,0,0,0,0,135000,178000,-43000,-43000
20200212,707189,美琪瑪元大96購01,0.44,0.44,0.44,0.44,+0.02,4.76,3000,1,1320,0,0,0,0,0,0,0,3000,-3000,-3000
20200212,707190,神盾元大96購02,0.51,0.51,0.49,0.49,+0.03,6.52,103000,2,52470,0,0,0,0,0,0,3000,100000,-97000,-97000
20200212,707191,穩懋元大95購04,0.87,1.15,0.84,1.08,+0.25,30.12,216000,29,210500,0,0,0,0,0,0,165000,86000,79000,79000
20200212,707192,穩懋元大95購06,0.65,0.71,0.62,0.71,+0.11,18.33,54000,7,36230,0,0,0,0,0,0,3000,51000,-48000,-48000
20200212,707193,穩懋元大95購07,0.58,0.73,0.56,0.73,+0.19,35.19,934000,12,597570,0,0,0,0,0,0,904000,30000,874000,874000
20200212,707194,廣明兆豐95購01,0.39,0.42,0.39,0.42,+0.01,2.44,223000,5,92160,0,0,0,0,0,0,80000,143000,-63000,-63000
20200212,707195,弘塑群益95購01,,,,,,0.00,0,0,0,0,0,0,0,0,0,0,0,0,0
20200212,707196,閎康群益96購01,1.45,1.47,1.45,1.47,-0.04,-2.65,20000,2,29200,0,0,0,0,0,0,20000,0,20000,20000
20200212,707197,順達群益96購01,,,,,,0.00,0,0,0,0,0,0,0,0,0,0,0,0,0
20200212,707198,VHQ國票96購01,0.30,0.34,0.30,0.34,+0.14,70.0,230000,5,73900,0,0,0,0,0,0,0,230000,-230000,-230000
20200212,707199,新鉅科國票95購01,,,,,,0.00,0,0,0,0,0,0,0,0,0,0,0,0,0
20200212,707200,網龍國票97購01,1.31,1.33,1.31,1.33,-0.03,-2.21,32000,3,42020,0,0,0,0,0,0,27000,5000,22000,22000
20200212,707201,環球晶國票96購02,1.92,1.92,1.92,1.92,+0.06,3.23,3000,1,5760,0,0,0,0,0,0,3000,3000,0,0
20200212,707202,聯亞國票96購02,,,,,,0.00,0,0,0,0,0,0,0,0,0,0,0,0,0
20200212,707203,晟德國票95購01,,,,,,0.00,0,0,0,0,0,0,0,0,0,0,0,0,0
20200212,707204,弘塑麥證95購01,,,,,,0.00,0,0,0,0,0,0,0,0,0,0,0,0,0
20200212,707205,大田元大95購02,,,,,,0.00,0,0,0,0,0,0,0,0,0,0,0,0,0
20200212,707206,六角元大95購02,1.06,1.28,1.06,1.18,+0.15,14.56,411000,22,496420,0,0,0,0,0,0,65000,410000,-345000,-345000
20200212,707207,宇峻元大97購01,1.75,1.75,1.60,1.73,-0.23,-11.73,132000,16,220510,0,2000,-2000,0,0,0,121000,9000,112000,110000
20200212,707208,東洋元大95購01,,,,,,0.00,0,0,0,0,0,0,0,0,0,0,0,0,0
20200212,707209,環球晶元大95購06,3.81,3.81,3.79,3.79,+0.08,2.16,15000,3,56950,0,0,0,0,0,0,15000,0,15000,15000
20200212,707210,聯亞元大95購03,1.78,1.78,1.74,1.74,+0.09,5.45,59000,4,103000,0,0,0,0,0,0,49000,59000,-10000,-10000
20200212,707211,晟德元大95購02,,,,,,0.00,0,0,0,0,0,0,0,0,0,0,0,0,0
20200212,707212,鈺太元大95購01,1.98,2.59,1.93,2.59,+0.66,34.2,201000,18,446060,0,0,0,0,0,0,39000,174000,-135000,-135000
20200212,707213,順達統一97購01,0.77,0.84,0.73,0.84,+0.09,12.0,27000,6,20770,0,0,0,0,0,0,9000,11000,-2000,-2000
20200212,707214,六角永豐95購01,0.46,0.52,0.46,0.47,+0.02,4.44,201000,5,98830,0,0,0,0,0,0,0,201000,-201000,-201000
20200212,707215,晶焱永豐95購01,1.49,1.58,1.49,1.58,+0.16,11.27,186000,4,286620,0,0,0,0,0,0,73000,113000,-40000,-40000
20200212,707216,順達永豐95購02,,,,,,0.00,0,0,0,0,0,0,0,0,0,0,0,0,0
20200212,707217,聯亞永豐95購01,1.34,1.34,1.28,1.28,+0.04,3.23,73000,6,96280,0,0,0,0,0,0,61000,29000,32000,32000
20200212,707218,鐿鈦永豐95購01,,,,,,0.00,0,0,0,0,0,0,0,0,0,0,0,0,0
20200212,707219,弘塑凱基95購01,2.10,2.14,2.03,2.14,+0.16,8.08,251000,23,524860,0,0,0,0,0,0,131000,130000,1000,1000
20200212,707220,合晶凱基95購03,0.51,0.54,0.51,0.54,+0.14,35.0,105000,2,54900,0,0,0,0,0,0,0,105000,-105000,-105000
20200212,707221,原相凱基95購02,4.48,4.74,3.23,4.59,+0.07,1.55,106000,31,474890,0,0,0,0,0,0,95000,43000,52000,52000
20200212,707222,群聯凱基95購03,1.28,1.32,1.28,1.32,+0.05,3.94,51000,5,66420,0,0,0,0,0,0,51000,41000,10000,10000
20200212,707223,緯軟凱基95購01,,,,,,0.00,0,0,0,0,0,0,0,0,0,0,0,0,0
20200212,707224,環球晶凱基95購09,1.22,1.30,1.22,1.27,+0.12,10.43,247000,12,307590,0,0,0,0,0,0,104000,105000,-1000,-1000
20200212,707225,中美晶元富95購06,1.21,1.38,1.21,1.27,+0.06,4.96,314000,8,396990,0,0,0,0,0,0,239000,75000,164000,164000
20200212,707226,精華元富95購01,,,,,,0.00,0,0,0,0,0,0,0,0,0,0,0,0,0
20200212,707227,環球晶元富95購05,1.43,1.57,1.43,1.52,+0.09,6.29,260000,9,392720,0,0,0,0,0,0,250000,10000,240000,240000
20200212,707228,穩懋元富95購05,0.66,0.80,0.66,0.80,+0.14,21.21,325000,7,224900,0,0,0,0,0,0,260000,65000,195000,195000
20200212,707229,穩懋元富95購06,0.50,0.52,0.41,0.48,+0.12,33.33,1342000,27,607460,0,0,0,0,0,0,1080000,252000,828000,828000
20200212,707230,M31台新95購01,,,,,,0.00,0,0,0,0,0,0,0,0,0,0,0,0,0
20200212,707231,大宇資康和95購01,,,,,,0.00,0,0,0,0,0,0,0,0,0,0,0,0,0
20200212,707232,大學光群益95購01,2.85,3.15,2.84,3.10,+0.25,8.77,292000,26,862550,0,0,0,0,0,0,147000,154000,-7000,-7000
20200212,707233,迅得群益97購01,4.29,4.64,4.29,4.58,+0.51,12.53,133000,17,595900,0,0,0,0,0,0,0,133000,-133000,-133000
20200212,707234,勝麗群益95購01,2.46,2.86,2.46,2.63,+0.12,4.78,252000,18,677090,0,0,0,0,0,0,152000,100000,52000,52000
20200212,707235,群聯群益96購02,1.53,1.55,1.52,1.53,+0.04,2.68,66000,8,101080,0,0,0,0,0,0,54000,43000,11000,11000
20200212,707236,聚積群益97購01,0.70,0.70,0.70,0.70,+0.03,4.48,34000,1,23800,0,0,0,0,0,0,34000,0,34000,34000
20200212,707237,雙美麥證95購01,,,,,,0.00,0,0,0,0,0,0,0,0,0,0,0,0,0
20200212,707238,合晶元富95購03,1.54,1.85,1.54,1.76,+0.35,24.82,200000,25,329550,0,0,0,0,0,0,4000,196000,-192000,-192000
20200212,707239,金可元富95購01,0.64,0.64,0.64,0.64,-0.03,-4.48,4000,1,2560,0,0,0,0,0,0,4000,0,4000,4000
20200212,707240,昂寶國票97購01,5.30,5.30,5.30,5.30,0.00,0.0,10000,1,53000,0,0,0,0,0,0,0,10000,-10000,-10000
20200212,707241,昇達科國票96購01,0.78,0.82,0.78,0.82,+0.12,17.14,102000,3,81260,0,0,0,0,0,0,0,102000,-102000,-102000
20200212,707242,信驊國票96購01,,,,,,0.00,0,0,0,0,0,0,0,0,0,0,0,0,0
20200212,707243,新普國票96購01,2.71,3.07,2.71,2.93,+0.34,13.13,15000,3,43550,0,0,0,0,0,0,5000,10000,-5000,-5000
20200212,707244,精華國票96購01,0.44,0.44,0.44,0.44,-0.02,-4.35,229000,2,100760,0,0,0,0,0,0,219000,10000,209000,209000
20200212,707245,大江元大95購04,,,,,,0.00,0,0,0,0,0,0,0,0,0,0,0,0,0
20200212,707246,弘塑元大96購01,3.06,3.15,2.99,3.15,+0.23,7.88,206000,20,628150,0,0,0,0,0,0,124000,125000,-1000,-1000
20200212,707247,安勤元大95購01,0.98,0.98,0.95,0.95,-0.02,-2.06,19000,2,18560,0,0,0,0,0,0,19000,0,19000,19000
20200212,707248,建榮元大96購02,,,,,,0.00,0,0,0,0,0,0,0,0,0,0,0,0,0
20200212,707249,群聯元大95購06,1.62,1.62,1.62,1.62,-0.01,-0.61,1000,1,1620,0,0,0,0,0,0,1000,0,1000,1000
20200212,707250,環球晶元大95購07,4.24,4.42,4.19,4.35,+0.22,5.33,92000,12,390170,0,0,0,0,0,0,92000,17000,75000,75000
20200212,707251,環球晶元大95購08,2.26,2.26,2.26,2.26,+0.17,8.13,10000,1,22600,0,0,0,0,0,0,0,10000,-10000,-10000
20200212,707252,鐿鈦元大96購01,,,,,,0.00,0,0,0,0,0,0,0,0,0,0,0,0,0
20200212,707253,穩懋亞東96購02,1.79,1.87,1.79,1.87,+0.37,24.67,33000,3,61550,0,0,0,0,0,0,2000,31000,-29000,-29000
20200212,707254,同致中信97購01,0.55,0.55,0.55,0.55,0.00,0.0,5000,1,2750,0,0,0,0,0,0,0,5000,-5000,-5000
20200212,707255,環球晶凱基95購10,1.80,1.87,0.57,1.87,+0.13,7.47,299000,9,520630,0,0,0,0,0,0,289000,11000,278000,278000
20200212,707256,環球晶凱基95購11,,,,,,0.00,0,0,0,0,0,0,0,0,0,0,0,0,0
20200212,707257,兆利永豐95購02,0.63,0.64,0.56,0.59,-0.04,-6.35,835000,34,493390,0,0,0,0,0,0,628000,116000,512000,512000
20200212,707258,信昌電永豐95購01,1.83,1.83,1.78,1.81,-0.08,-4.23,71000,6,128830,0,0,0,0,0,0,61000,20000,41000,41000
20200212,707259,信驊永豐95購01,0.85,0.86,0.83,0.86,-0.01,-1.15,184000,4,157320,0,0,0,0,0,0,66000,118000,-52000,-52000
20200212,707260,新揚科永豐95購02,,,,,,0.00,0,0,0,0,0,0,0,0,0,0,0,0,0
20200212,707261,新普永豐95購01,0.70,0.74,0.70,0.74,+0.13,21.31,71000,3,51740,0,0,0,0,0,0,0,71000,-71000,-71000
20200212,707262,大宇資凱基97購01,0.32,0.32,0.32,0.32,-0.01,-3.03,50000,1,16000,0,0,0,0,0,0,50000,0,50000,50000
20200212,707263,神盾凱基96購02,0.94,0.98,0.94,0.97,+0.03,3.19,121000,21,116440,0,0,0,0,0,0,116000,5000,111000,111000
20200212,707264,網家凱基95購02,0.16,0.16,0.15,0.15,-0.02,-11.76,174000,11,26760,0,0,0,0,0,0,164000,10000,154000,154000
20200212,707265,環球晶凱基95購12,1.94,1.94,1.94,1.94,+0.16,8.99,1000,1,1940,0,0,0,0,0,0,1000,1000,0,0
20200212,707266,宇峻永豐95購01,2.32,2.37,2.21,2.29,-0.45,-16.42,68000,7,156630,0,0,0,0,0,0,37000,30000,7000,7000
20200212,707267,邦特永豐95購01,,,,,,0.00,0,0,0,0,0,0,0,0,0,0,0,0,0
20200212,707268,皇田永豐95購01,0.56,0.57,0.56,0.57,+0.02,3.64,2000,2,1130,0,0,0,0,0,0,0,2000,-2000,-2000
20200212,707269,原相永豐95購02,2.35,2.54,2.26,2.44,+0.02,0.83,468000,61,1125110,0,0,0,0,0,0,321000,182000,139000,139000
20200212,707270,神盾永豐95購01,0.63,0.68,0.63,0.65,+0.05,8.33,110000,15,70530,0,0,0,0,0,0,104000,10000,94000,94000
20200212,707271,勝麗永豐95購01,0.86,1.01,0.86,1.01,+0.14,16.09,293000,13,274790,0,0,0,0,0,0,143000,150000,-7000,-7000
20200212,707272,廣明永豐95購01,0.47,0.50,0.46,0.50,-0.01,-1.96,82000,3,38300,0,0,0,0,0,0,81000,1000,80000,80000
20200212,707273,環球晶永豐95購02,2.29,2.53,2.29,2.50,+0.18,7.76,33000,4,78580,0,0,0,0,0,0,23000,11000,12000,12000
20200212,707274,雙鴻永豐95購05,0.35,0.35,0.35,0.35,+0.02,6.06,200000,1,70000,0,0,0,0,0,0,200000,0,200000,200000
20200212,707275,元太元大96購01,1.18,1.24,1.18,1.24,+0.07,5.98,13000,3,15440,0,0,0,0,0,0,0,13000,-13000,-13000
20200212,707276,皇田元大95購01,,,,,,0.00,0,0,0,0,0,0,0,0,0,0,0,0,0
20200212,707277,神盾元大97購02,0.65,0.68,0.64,0.65,+0.03,4.84,1572000,34,1048550,0,0,0,0,0,0,1110000,456000,654000,654000
20200212,707278,勝麗元大96購01,1.68,1.83,1.66,1.75,+0.07,4.17,355000,20,608950,0,0,0,0,0,0,318000,212000,106000,106000
20200212,707279,新鉅科元大95購01,0.43,0.48,0.43,0.48,+0.11,29.73,11000,2,4780,0,0,0,0,0,0,10000,1000,9000,9000
20200212,707280,碩禾元大96購01,1.24,1.24,1.22,1.22,-0.03,-2.4,60000,5,73980,0,0,0,0,0,0,39000,60000,-21000,-21000
20200212,707281,精華元大95購02,0.88,0.89,0.88,0.89,+0.02,2.3,38000,2,33570,0,0,0,0,0,0,38000,38000,0,0
20200212,707282,環球晶元大95購09,,,,,,0.00,0,0,0,0,0,0,0,0,0,0,0,0,0
20200212,707283,環球晶元大95購10,2.97,2.97,2.97,2.97,+0.24,8.79,10000,1,29700,0,0,0,0,0,0,0,10000,-10000,-10000
20200212,707284,晟德元大95購03,0.26,0.26,0.26,0.26,+0.03,13.04,3000,1,780,0,0,0,0,0,0,0,3000,-3000,-3000
20200212,707285,弘塑國泰97購01,,,,,,0.00,0,0,0,0,0,0,0,0,0,0,0,0,0
20200212,707286,信昌電富邦95購01,1.18,1.18,1.17,1.17,0.00,0.0,60000,2,70300,0,0,0,0,0,0,0,60000,-60000,-60000
20200212,707287,同致國票96購01,0.72,0.72,0.72,0.72,+0.02,2.86,38000,1,27360,0,0,0,0,0,0,0,38000,-38000,-38000
20200212,707288,良維國票97購01,0.52,0.52,0.52,0.52,+0.02,4.0,168000,2,87360,0,0,0,0,0,0,0,168000,-168000,-168000
20200212,707289,緯軟國票97購01,0.64,0.64,0.62,0.62,0.00,0.0,179000,2,112960,0,0,0,0,0,0,179000,0,179000,179000
20200212,707290,優群國票96購01,1.11,1.15,1.08,1.10,+0.05,4.76,190000,12,211400,0,0,0,0,0,0,50000,140000,-90000,-90000
20200212,707291,元太兆豐95購02,0.58,0.63,0.58,0.63,+0.06,10.53,192000,5,114360,0,0,0,0,0,0,0,192000,-192000,-192000
20200212,707292,金可兆豐95購02,0.64,0.69,0.64,0.67,+0.03,4.69,175000,8,115640,0,0,0,0,0,0,125000,50000,75000,75000
20200212,707293,泰博兆豐96購01,1.63,1.63,1.57,1.57,+0.03,1.95,74000,2,117020,0,0,0,0,0,0,60000,14000,46000,46000
20200212,707294,VHQ群益96購01,,,,,,0.00,0,0,0,0,0,0,0,0,0,0,0,0,0
20200212,707295,邦特群益95購01,0.47,0.48,0.46,0.46,+0.01,2.22,61000,4,29150,0,0,0,0,0,0,0,61000,-61000,-61000
20200212,707296,鈺太群益95購01,2.23,2.98,2.21,2.98,+0.85,39.91,276000,37,667700,0,0,0,0,0,0,57000,249000,-192000,-192000
20200212,707297,台燿凱基96購03,1.00,1.10,1.00,1.10,+0.19,20.88,22000,4,23250,0,0,0,0,0,0,12000,10000,2000,2000
20200212,707298,晶焱凱基95購01,0.57,0.57,0.55,0.55,+0.07,14.58,102000,3,58000,0,0,0,0,0,0,0,102000,-102000,-102000
20200212,707299,緯軟中信95購01,0.23,0.23,0.23,0.23,0.00,0.0,210000,4,48300,0,0,0,0,0,0,210000,0,210000,210000
20200212,707300,雙鴻麥證95購01,0.17,0.17,0.17,0.17,+0.02,13.33,20000,2,3400,10000,10000,0,0,0,0,10000,10000,0,0
20200212,707301,中美晶元富95購07,2.01,2.19,2.01,2.19,+0.17,8.42,78000,8,160520,0,0,0,0,0,0,13000,74000,-61000,-61000
20200212,707302,原相亞東96購01,,,,,,0.00,0,0,0,0,0,0,0,0,0,0,0,0,0
20200212,707303,群聯亞東95購01,,,,,,0.00,0,0,0,0,0,0,0,0,0,0,0,0,0
20200212,707304,杰力永豐95購02,,,,,,0.00,0,0,0,0,0,0,0,0,0,0,0,0,0
20200212,707305,波若威永豐95購02,,,,,,0.00,0,0,0,0,0,0,0,0,0,0,0,0,0
20200212,707306,保瑞永豐95購01,0.46,0.46,0.46,0.46,+0.04,9.52,10000,1,4600,0,0,0,0,0,0,10000,0,10000,10000
20200212,707307,智崴永豐95購01,,,,,,0.00,0,0,0,0,0,0,0,0,0,0,0,0,0
20200212,707308,聯亞永豐95購02,1.01,1.04,1.01,1.01,+0.05,5.21,42000,4,42890,0,0,0,0,0,0,20000,26000,-6000,-6000
20200212,707309,合晶國票96購02,1.50,1.79,1.50,1.74,+0.37,27.01,113000,14,183420,0,0,0,0,0,0,5000,108000,-103000,-103000
20200212,707310,原相國票96購01,,,,,,0.00,0,0,0,0,0,0,0,0,0,0,0,0,0
20200212,707311,昂寶國泰96購01,,,,,,0.00,0,0,0,0,0,0,0,0,0,0,0,0,0
20200212,707312,宣德兆豐95購01,1.68,1.79,1.67,1.79,+0.01,0.56,327000,30,562810,0,0,0,0,0,0,327000,0,327000,327000
20200212,707313,智崴群益95購01,,,,,,0.00,0,0,0,0,0,0,0,0,0,0,0,0,0
20200212,707314,廣明群益95購01,,,,,,0.00,0,0,0,0,0,0,0,0,0,0,0,0,0
20200212,707315,大江元大96購04,,,,,,0.00,0,0,0,0,0,0,0,0,0,0,0,0,0
20200212,707316,同致元大96購01,0.54,0.54,0.54,0.54,+0.02,3.85,69000,2,37260,0,0,0,0,0,0,59000,10000,49000,49000
20200212,707317,良維元大95購02,0.45,0.45,0.45,0.45,+0.03,7.14,26000,1,11700,0,0,0,0,0,0,0,26000,-26000,-26000
20200212,707318,金可元大95購02,0.55,0.58,0.55,0.58,+0.02,3.57,43000,2,24880,0,0,0,0,0,0,43000,0,43000,43000
20200212,707319,信驊元大95購01,,,,,,0.00,0,0,0,0,0,0,0,0,0,0,0,0,0
20200212,707320,智崴元大95購01,,,,,,0.00,0,0,0,0,0,0,0,0,0,0,0,0,0
20200212,707321,智崴元大95購02,0.67,0.69,0.67,0.69,+0.04,6.15,152000,6,104680,0,0,0,0,0,0,10000,142000,-132000,-132000
20200212,707322,新普元大95購01,1.93,1.95,1.87,1.95,+0.28,16.77,83000,3,159610,0,0,0,0,0,0,73000,11000,62000,62000
20200212,707323,環宇元大96購01,0.66,0.68,0.66,0.67,+0.02,3.08,130000,4,87500,0,0,0,0,0,0,110000,20000,90000,90000
20200212,707324,櫃200永昌96購04,3.88,4.05,3.88,4.05,+0.32,8.58,18000,3,71540,0,0,0,0,0,0,8000,10000,-2000,-2000
20200212,707325,M31中信96購01,0.41,0.41,0.40,0.40,+0.02,5.26,63000,3,25260,0,0,0,0,0,0,6000,57000,-51000,-51000
20200212,707326,穩懋中信97購01,1.39,1.47,1.39,1.47,+0.07,5.0,104000,4,148200,0,0,0,0,0,0,56000,48000,8000,8000
20200212,707327,鐿鈦中信95購01,0.19,0.19,0.19,0.19,+0.01,5.56,90000,2,17100,0,0,0,0,0,0,0,90000,-90000,-90000
20200212,707328,中美晶凱基96購01,1.61,1.70,1.61,1.67,+0.08,5.03,94000,7,154410,0,0,0,0,0,0,11000,80000,-69000,-69000
20200212,707329,環球晶凱基95購13,2.45,2.56,2.45,2.56,+0.29,12.78,67000,8,165050,0,0,0,0,0,0,7000,67000,-60000,-60000
20200212,707330,原相第一95購01,3.41,3.41,3.26,3.38,+0.26,8.33,87000,29,292560,0,0,0,0,0,0,87000,0,87000,87000
20200212,707331,中美晶永豐95購03,2.43,2.43,2.43,2.43,-0.06,-2.41,8000,1,19440,0,0,0,0,0,0,8000,0,8000,8000
20200212,707332,亞泰永豐95購02,0.68,0.68,0.65,0.65,-0.03,-4.41,391000,17,255880,0,0,0,0,0,0,391000,0,391000,391000
20200212,707333,大江國票96購04,,,,,,0.00,0,0,0,0,0,0,0,0,0,0,0,0,0
20200212,707334,合晶國票97購01,1.09,1.33,1.09,1.33,+0.28,26.67,86000,10,103840,0,0,0,0,0,0,4000,82000,-78000,-78000
20200212,707335,勝麗國票97購01,1.81,2.01,1.81,1.88,+0.06,3.3,274000,19,517340,0,0,0,0,0,0,20000,254000,-234000,-234000
20200212,707336,群聯國票96購01,,,,,,0.00,0,0,0,0,0,0,0,0,0,0,0,0,0
20200212,707337,網龍國票97購02,1.86,1.86,1.81,1.81,-0.05,-2.69,31000,3,57310,0,0,0,0,0,0,30000,1000,29000,29000
20200212,707338,環球晶國票96購03,,,,,,0.00,0,0,0,0,0,0,0,0,0,0,0,0,0
20200212,707339,晟德國票97購01,1.14,1.17,1.14,1.15,+0.09,8.49,510000,12,591220,0,0,0,0,0,0,430000,80000,350000,350000
20200212,707340,神盾國泰97購01,0.88,0.93,0.88,0.91,+0.06,7.06,168000,29,151410,0,0,0,0,0,0,102000,78000,24000,24000
20200212,707341,博智國泰97購01,2.40,2.52,2.34,2.44,+0.13,5.63,144000,29,348080,0,0,0,0,0,0,96000,58000,38000,38000
20200212,707342,原相富邦99購01,3.61,3.88,3.55,3.76,+0.06,1.62,194000,69,706580,0,0,0,0,0,0,170000,36000,134000,134000
20200212,707343,聯亞兆豐96購01,1.74,1.74,1.66,1.66,+0.05,3.11,147000,10,251380,0,0,0,0,0,0,59000,88000,-29000,-29000
20200212,707344,杰力群益95購01,,,,,,0.00,0,0,0,0,0,0,0,0,0,0,0,0,0
20200212,707345,宣德群益96購01,1.55,1.64,1.51,1.64,-0.07,-4.09,333000,26,524340,0,0,0,0,0,0,305000,88000,217000,217000
20200212,707346,皇田群益97購01,1.19,1.20,1.19,1.19,+0.04,3.48,5000,3,5960,0,0,0,0,0,0,0,5000,-5000,-5000
20200212,707347,金居元大96購03,,,,,,0.00,0,0,0,0,0,0,0,0,0,0,0,0,0
20200212,707348,保瑞元大96購01,0.52,0.52,0.52,0.52,+0.05,10.64,110000,4,57200,0,0,0,0,0,0,110000,0,110000,110000
20200212,707349,茂達元大96購01,,,,,,0.00,0,0,0,0,0,0,0,0,0,0,0,0,0
20200212,707350,優群元大96購01,1.64,1.72,1.62,1.72,+0.11,6.83,273000,34,457800,0,0,0,0,0,0,228000,267000,-39000,-39000
20200212,707351,環球晶元大96購01,2.76,2.76,2.76,2.76,+0.16,6.15,1000,1,2760,0,0,0,0,0,0,1000,1000,0,0
20200212,707352,櫃200元大96購03,0.61,0.71,0.61,0.71,+0.10,16.39,141000,6,99410,0,0,0,0,0,0,40000,100000,-60000,-60000
20200212,707353,櫃200元大96購04,,,,,,0.00,0,0,0,0,0,0,0,0,0,0,0,0,0
20200212,707354,昇達科中信97購01,,,,,,0.00,0,0,0,0,0,0,0,0,0,0,0,0,0
20200212,707355,群聯凱基95購04,0.54,0.58,0.54,0.56,+0.03,5.66,115000,12,65400,0,0,0,0,0,0,29000,85000,-56000,-56000
20200212,707356,精華凱基95購01,,,,,,0.00,0,0,0,0,0,0,0,0,0,0,0,0,0
20200212,707357,大江國票97購02,,,,,,0.00,0,0,0,0,0,0,0,0,0,0,0,0,0
20200212,707358,昂寶永豐95購01,,,,,,0.00,0,0,0,0,0,0,0,0,0,0,0,0,0
20200212,707359,宣德永豐95購01,1.67,1.72,1.67,1.69,-0.13,-7.14,57000,8,97500,0,0,0,0,0,0,56000,0,56000,56000
20200212,707360,環球晶永豐95購03,2.55,2.69,2.47,2.66,+0.16,6.4,54000,8,138750,0,0,0,0,0,0,38000,27000,11000,11000
20200212,707361,元太元大96購02,0.77,0.84,0.77,0.84,+0.09,12.0,304000,12,242950,0,0,0,0,0,0,131000,219000,-88000,-88000
20200212,707362,兆利元大95購01,2.43,2.46,2.30,2.40,-0.06,-2.44,508000,25,1196800,0,0,0,0,0,0,386000,204000,182000,182000
20200212,707363,合晶元大96購03,0.92,1.06,0.92,1.06,+0.22,26.19,173000,12,173090,0,0,0,0,0,0,0,173000,-173000,-173000
20200212,707364,邦特元大95購01,0.48,0.48,0.48,0.48,+0.04,9.09,48000,1,23040,0,0,0,0,0,0,0,48000,-48000,-48000
20200212,707365,群聯元大97購01,1.31,1.38,1.31,1.38,+0.07,5.34,30000,2,40000,0,0,0,0,0,0,0,0,0,0
20200212,707366,廣明元大96購01,0.40,0.42,0.40,0.42,+0.01,2.44,75000,8,31300,0,0,0,0,0,0,20000,55000,-35000,-35000
20200212,707367,環球晶元大95購12,,,,,,0.00,0,0,0,0,0,0,0,0,0,0,0,0,0
20200212,707368,茂達永豐96購01,,,,,,0.00,0,0,0,0,0,0,0,0,0,0,0,0,0
20200212,707369,原相永豐95購03,1.62,1.82,1.59,1.69,-0.01,-0.59,649000,75,1076410,0,0,0,0,0,0,396000,293000,103000,103000
20200212,707370,杰力國票96購02,0.75,0.80,0.75,0.80,+0.06,8.11,140000,3,111000,0,0,0,0,0,0,0,140000,-140000,-140000
20200212,707371,大江富邦97購01,0.13,0.13,0.13,0.13,-0.01,-7.14,60000,1,7800,0,0,0,0,0,0,0,60000,-60000,-60000
20200212,707372,原相凱基96購01,1.71,1.96,1.65,1.80,0.00,0.0,768000,113,1379370,0,0,0,0,0,0,511000,237000,274000,274000
20200212,707373,新普凱基95購01,,,,,,0.00,0,0,0,0,0,0,0,0,0,0,0,0,0
20200212,707374,緯軟凱基95購02,,,,,,0.00,0,0,0,0,0,0,0,0,0,0,0,0,0
20200212,707375,聯亞凱基95購01,0.64,0.64,0.64,0.64,+0.04,6.67,21000,1,13440,0,0,0,0,0,0,0,21000,-21000,-21000
20200212,707376,雙鴻凱基96購03,0.12,0.14,0.12,0.14,+0.02,16.67,430000,9,55800,0,0,0,0,0,0,190000,210000,-20000,-20000
20200212,707377,群聯麥證95購01,1.37,1.39,1.34,1.39,+0.07,5.3,24000,3,32660,10000,14000,-4000,0,0,0,14000,14000,0,0
20200212,707378,原相元富95購02,,,,,,0.00,0,0,0,0,0,0,0,0,0,0,0,0,0
20200212,707379,優群元富95購01,0.62,0.67,0.62,0.63,+0.04,6.78,423000,13,268360,0,0,0,0,0,0,80000,263000,-183000,-183000
20200212,707380,環球晶元富95購06,2.47,2.66,2.47,2.66,+0.29,12.24,3000,3,7660,0,0,0,0,0,0,3000,3000,0,0
20200212,707381,兆利台新95購01,0.93,0.97,0.89,0.97,+0.04,4.3,300000,15,278800,0,0,0,0,0,0,220000,80000,140000,140000
20200212,707382,僑威台新95購01,,,,,,0.00,0,0,0,0,0,0,0,0,0,0,0,0,0
20200212,707383,先豐元大95購01,,,,,,0.00,0,0,0,0,0,0,0,0,0,0,0,0,0
20200212,707384,皇田元大95購02,,,,,,0.00,0,0,0,0,0,0,0,0,0,0,0,0,0
20200212,707385,晶焱元大96購01,2.71,2.88,2.71,2.81,+0.22,8.49,133000,13,375010,0,0,0,0,0,0,86000,89000,-3000,-3000
20200212,707386,僑威元大95購01,,,,,,0.00,0,0,0,0,0,0,0,0,0,0,0,0,0
20200212,707387,網龍元大95購02,1.32,1.32,1.31,1.31,0.00,0.0,37000,3,48480,0,0,0,0,0,0,37000,2000,35000,35000
20200212,707388,鐿鈦元大95購01,0.57,0.57,0.57,0.57,+0.03,5.56,5000,1,2850,0,0,0,0,0,0,0,5000,-5000,-5000
20200212,707389,業強康和95購01,,,,,,0.00,0,0,0,0,0,0,0,0,0,0,0,0,0
20200212,707390,環球晶元富95購07,2.67,2.85,2.65,2.85,+0.21,7.95,6000,4,16190,0,0,0,0,0,0,6000,4000,2000,2000
20200212,707391,順達台新95購01,0.72,0.74,0.71,0.74,+0.11,17.46,62000,5,45380,0,0,0,0,0,0,20000,42000,-22000,-22000
20200212,707392,大江凱基95購01,,,,,,0.00,0,0,0,0,0,0,0,0,0,0,0,0,0
20200212,707393,同致凱基95購01,,,,,,0.00,0,0,0,0,0,0,0,0,0,0,0,0,0
20200212,707394,聯亞凱基95購02,,,,,,0.00,0,0,0,0,0,0,0,0,0,0,0,0,0
20200212,707395,大宇資群益97購01,,,,,,0.00,0,0,0,0,0,0,0,0,0,0,0,0,0
20200212,707396,亞泰群益95購01,1.35,1.35,1.26,1.28,-0.05,-3.76,321000,18,422240,0,0,0,0,0,0,311000,10000,301000,301000
20200212,707397,聯亞群益95購01,,,,,,0.00,0,0,0,0,0,0,0,0,0,0,0,0,0
20200212,707398,亞泰元大95購01,1.37,1.37,1.28,1.30,-0.03,-2.26,248000,12,325910,0,0,0,0,0,0,81000,167000,-86000,-86000
20200212,707399,信驊元大95購02,,,,,,0.00,0,0,0,0,0,0,0,0,0,0,0,0,0
20200212,707400,威剛元大96購02,3.32,3.51,3.32,3.37,+0.22,6.98,31000,11,104520,0,0,0,0,0,0,2000,29000,-27000,-27000
20200212,707401,聯亞元大95購04,2.21,2.23,2.16,2.16,+0.05,2.37,26000,4,56880,0,0,0,0,0,0,16000,26000,-10000,-10000
20200212,707402,大宇資永豐96購01,,,,,,0.00,0,0,0,0,0,0,0,0,0,0,0,0,0
20200212,707403,旺矽永豐96購01,1.22,1.25,1.21,1.21,+0.06,5.22,280000,28,343600,0,0,0,0,0,0,0,280000,-280000,-280000
20200212,707404,信驊永豐95購02,0.62,0.64,0.62,0.62,-0.01,-1.59,137000,5,85380,0,0,0,0,0,0,107000,30000,77000,77000
20200212,707405,優群永豐96購01,0.75,0.77,0.75,0.77,+0.07,10.0,77000,2,57950,0,0,0,0,0,0,0,77000,-77000,-77000
20200212,707406,M31國票96購01,0.54,0.54,0.54,0.54,+0.05,10.2,60000,1,32400,0,0,0,0,0,0,0,60000,-60000,-60000
20200212,707407,中美晶國票96購03,4.68,5.25,4.68,4.96,+0.51,11.46,48000,5,241640,0,0,0,0,0,0,48000,0,48000,48000
20200212,707408,兆利國票96購01,2.31,2.31,2.13,2.24,-0.21,-8.57,154000,21,344810,0,0,0,0,0,0,154000,0,154000,154000
20200212,707409,環球晶國票95購03,6.60,6.90,6.60,6.90,+0.60,9.52,22000,5,149400,0,0,0,0,0,0,10000,14000,-4000,-4000
20200212,707410,雙美國票96購01,,,,,,0.00,0,0,0,0,0,0,0,0,0,0,0,0,0
20200212,707411,金居富邦95購02,0.32,0.32,0.32,0.32,+0.02,6.67,10000,1,3200,0,0,0,0,0,0,10000,0,10000,10000
20200212,707412,櫃200富邦95購01,0.49,0.59,0.49,0.59,+0.11,22.92,7000,6,3840,0,0,0,0,0,0,6000,1000,5000,5000
20200212,707413,櫃200富邦95購02,0.68,0.75,0.68,0.75,+0.11,17.19,4000,3,2910,0,0,0,0,0,0,3000,1000,2000,2000
20200212,707414,櫃200富邦95購03,,,,,,0.00,0,0,0,0,0,0,0,0,0,0,0,0,0
20200212,707415,櫃200T永昌96購01,,,,,,0.00,0,0,0,0,0,0,0,0,0,0,0,0,0
20200212,707416,櫃200T永昌96購02,,,,,,0.00,0,0,0,0,0,0,0,0,0,0,0,0,0
20200212,707417,櫃200T永昌96購03,,,,,,0.00,0,0,0,0,0,0,0,0,0,0,0,0,0
20200212,707418,櫃200T永昌96購04,,,,,,0.00,0,0,0,0,0,0,0,0,0,0,0,0,0
20200212,707419,台燿凱基95購01,0.62,0.62,0.62,0.62,+0.07,12.73,88000,2,54560,0,0,0,0,0,0,88000,0,88000,88000
20200212,707420,信驊凱基95購02,0.44,0.44,0.43,0.43,-0.01,-2.27,111000,3,47850,0,0,0,0,0,0,81000,30000,51000,51000
20200212,707421,緯軟凱基96購01,0.22,0.22,0.21,0.21,0.00,0.0,200000,3,42200,0,0,0,0,0,0,200000,0,200000,200000
20200212,707422,櫃200凱基99購01,,,,,,0.00,0,0,0,0,0,0,0,0,0,0,0,0,0
20200212,707423,三貝德國票96購02,0.12,0.12,0.10,0.10,+0.03,42.86,225000,4,26900,0,0,0,0,0,0,0,225000,-225000,-225000
20200212,707424,大學光國票96購02,3.06,3.11,3.06,3.11,+0.21,7.24,9000,2,27790,0,0,0,0,0,0,9000,0,9000,9000
20200212,707425,台燿國票96購01,1.35,1.48,1.35,1.48,+0.30,25.42,199000,8,278760,0,0,0,0,0,0,20000,179000,-159000,-159000
20200212,707426,穩懋國票96購03,1.36,1.65,1.36,1.65,+0.28,20.44,253000,18,364580,0,0,0,0,0,0,204000,49000,155000,155000
20200212,707427,新普國泰96購01,2.36,2.43,2.36,2.43,+0.23,10.45,30000,3,72100,0,0,0,0,0,0,10000,20000,-10000,-10000
20200212,707428,譜瑞國泰97購01,2.34,2.61,2.28,2.50,+0.22,9.65,1943000,133,4805300,0,0,0,0,0,0,1480000,276000,1204000,1204000
20200212,707429,信驊元富95購01,1.77,1.77,1.71,1.73,+0.01,0.58,76000,8,132600,0,0,0,0,0,0,37000,39000,-2000,-2000
20200212,707430,信驊元富95購02,1.15,1.18,1.13,1.15,0.00,0.0,88000,8,102680,0,0,0,0,0,0,68000,20000,48000,48000
20200212,707431,雙鴻元富95購01,0.34,0.41,0.34,0.38,0.00,0.0,1018000,45,385740,0,0,0,0,0,0,283000,690000,-407000,-407000
20200212,707432,雙鴻台新96購01,0.44,0.51,0.44,0.51,+0.02,4.08,326000,24,156840,0,0,0,0,0,0,165000,151000,14000,14000
20200212,707433,新普元大95購02,1.12,1.14,1.10,1.13,+0.21,22.83,139000,7,156040,0,0,0,0,0,0,17000,122000,-105000,-105000
20200212,707434,環球晶元大96購02,,,,,,0.00,0,0,0,0,0,0,0,0,0,0,0,0,0
20200212,707435,雙鴻元大95購02,0.59,0.68,0.57,0.67,+0.07,11.67,1090000,51,695980,0,0,0,0,0,0,730000,403000,327000,327000
20200212,707436,譜瑞元大95購04,2.14,2.40,2.07,2.28,+0.28,14.0,289000,56,657660,0,0,0,0,0,0,107000,211000,-104000,-104000
20200212,707437,群聯兆豐96購01,1.67,1.67,1.63,1.63,0.00,0.0,44000,3,73320,0,0,0,0,0,0,44000,4000,40000,40000
20200212,707438,環球晶兆豐95購05,,,,,,0.00,0,0,0,0,0,0,0,0,0,0,0,0,0
20200212,707439,台燿群益95購01,1.46,1.64,1.46,1.64,+0.30,22.39,627000,27,988620,0,0,0,0,0,0,238000,424000,-186000,-186000
20200212,707440,昇達科群益97購01,0.82,0.86,0.82,0.86,+0.09,11.69,244000,5,202040,0,0,0,0,0,0,0,244000,-244000,-244000
20200212,707441,晶焱群益96購01,1.13,1.16,1.13,1.16,+0.14,13.73,77000,7,88110,0,0,0,0,0,0,0,77000,-77000,-77000
20200212,707442,櫃200富邦9A購01,,,,,,0.00,0,0,0,0,0,0,0,0,0,0,0,0,0
20200212,707443,櫃200富邦9A購02,,,,,,0.00,0,0,0,0,0,0,0,0,0,0,0,0,0
20200212,707444,雙鴻富邦96購02,0.18,0.21,0.18,0.21,+0.01,5.0,106000,4,19200,0,0,0,0,0,0,100000,5000,95000,95000
20200212,707445,雙鴻第一95購01,0.23,0.24,0.23,0.24,+0.03,14.29,105000,2,24750,0,0,0,0,0,0,0,105000,-105000,-105000
20200212,707446,大江永豐95購02,,,,,,0.00,0,0,0,0,0,0,0,0,0,0,0,0,0
20200212,707447,宜鼎永豐95購01,1.98,1.98,1.79,1.85,+0.01,0.54,195000,19,372440,0,0,0,0,0,0,142000,51000,91000,91000
20200212,707448,保瑞永豐95購02,0.85,0.85,0.83,0.83,+0.04,5.06,93000,3,78520,0,0,0,0,0,0,93000,0,93000,93000
20200212,707449,群聯永豐95購01,1.70,1.76,1.70,1.73,+0.04,2.37,33000,5,57030,0,0,0,0,0,0,13000,20000,-7000,-7000
20200212,707450,大江中信96購01,,,,,,0.00,0,0,0,0,0,0,0,0,0,0,0,0,0
20200212,707451,大江台新95購01,,,,,,0.00,0,0,0,0,0,0,0,0,0,0,0,0,0
20200212,707452,兆利元大96購01,1.01,1.02,0.95,1.02,-0.01,-0.97,545000,30,531600,0,0,0,0,0,0,522000,247000,275000,275000
20200212,707453,迅得元大95購02,1.09,1.15,1.09,1.15,+0.17,17.35,156000,11,173910,0,0,0,0,0,0,15000,91000,-76000,-76000
20200212,707454,博智元大95購03,1.83,1.98,1.75,1.83,+0.12,7.02,319000,38,592700,2000,0,2000,0,0,0,151000,173000,-22000,-20000
20200212,707455,神盾康和95購01,0.67,0.71,0.67,0.69,+0.03,4.55,249000,15,170910,0,0,0,0,0,0,249000,50000,199000,199000
20200212,707456,勝麗群益95購02,1.81,2.10,1.81,1.94,+0.14,7.78,828000,38,1607410,0,0,0,0,0,0,319000,509000,-190000,-190000
20200212,707457,緯軟群益96購01,0.84,0.84,0.81,0.83,+0.05,6.41,130000,4,108320,0,0,0,0,0,0,117000,13000,104000,104000
20200212,707458,金居統一95購01,0.90,0.99,0.89,0.93,+0.06,6.9,644000,26,609540,0,0,0,0,0,0,249000,395000,-146000,-146000
20200212,707459,迅得凱基98購01,1.06,1.09,1.06,1.09,+0.07,6.86,81000,4,87390,0,0,0,0,0,0,60000,21000,39000,39000
20200212,707460,邦特凱基95購01,,,,,,0.00,0,0,0,0,0,0,0,0,0,0,0,0,0
20200212,707461,信昌電凱基97購01,1.85,1.85,1.83,1.83,-0.12,-6.15,30000,2,55360,0,0,0,0,0,0,30000,0,30000,30000
20200212,707462,茂達凱基9B購01,0.94,0.94,0.91,0.91,+0.01,1.11,180000,2,164400,0,0,0,0,0,0,180000,0,180000,180000
20200212,707463,神盾凱基9B購01,1.35,1.41,1.34,1.39,+0.10,7.75,180000,7,249990,0,0,0,0,0,0,178000,2000,176000,176000
20200212,707464,勝麗凱基97購01,1.16,1.29,1.16,1.21,+0.07,6.14,46000,6,56680,0,0,0,0,0,0,10000,36000,-26000,-26000
20200212,707465,閎康凱基97購01,0.69,0.69,0.69,0.69,-0.01,-1.43,40000,2,27600,0,0,0,0,0,0,40000,0,40000,40000
20200212,707466,環宇凱基97購01,0.58,0.58,0.58,0.58,-0.01,-1.69,30000,1,17400,0,0,0,0,0,0,30000,0,30000,30000
20200212,707467,環球晶凱基96購01,5.50,5.70,5.50,5.70,+0.45,8.57,9000,6,50700,0,0,0,0,0,0,9000,7000,2000,2000
20200212,707468,穩懋凱基96購03,0.88,0.91,0.88,0.91,+0.20,28.17,20000,2,17900,0,0,0,0,0,0,10000,10000,0,0
20200212,707469,鈺太凱基97購01,1.07,1.18,1.07,1.15,+0.15,15.0,66000,5,73170,0,0,0,0,0,0,5000,66000,-61000,-61000
20200212,707470,鐿鈦凱基96購01,,,,,,0.00,0,0,0,0,0,0,0,0,0,0,0,0,0
20200212,707471,信昌電國票96購02,2.86,2.86,2.81,2.85,-0.11,-3.72,42000,5,118630,0,0,0,0,0,0,32000,10000,22000,22000
20200212,707472,晶焱國票96購02,1.21,1.29,1.21,1.29,+0.17,15.18,42000,5,52780,0,0,0,0,0,0,5000,37000,-32000,-32000
20200212,707473,群聯國票96購02,,,,,,0.00,0,0,0,0,0,0,0,0,0,0,0,0,0
20200212,707474,穩懋富邦97購01,0.81,0.97,0.79,0.92,+0.13,16.46,2962000,112,2523610,0,0,0,0,0,0,1111000,1672000,-561000,-561000
20200212,707475,光洋科永豐95購01,0.92,0.95,0.89,0.95,+0.03,3.26,164000,11,151800,0,0,0,0,0,0,16000,148000,-132000,-132000
20200212,707476,穩懋永豐95購03,0.52,0.70,0.50,0.70,+0.20,40.0,209000,6,111780,0,0,0,0,0,0,140000,69000,71000,71000
20200212,707477,網龍中信95購01,,,,,,0.00,0,0,0,0,0,0,0,0,0,0,0,0,0
20200212,707478,中美晶凱基95購03,2.68,2.73,2.68,2.73,+0.31,12.81,15000,6,40350,0,0,0,0,0,0,15000,15000,0,0
20200212,707479,晶焱凱基96購01,0.98,0.98,0.95,0.95,+0.09,10.47,22000,2,21500,0,0,0,0,0,0,22000,20000,2000,2000
20200212,707480,環球晶凱基97購01,2.05,2.17,2.05,2.16,+0.16,8.0,153000,5,324380,0,0,0,0,0,0,11000,143000,-132000,-132000
20200212,707481,三貝德永豐95購01,,,,,,0.00,0,0,0,0,0,0,0,0,0,0,0,0,0
20200212,707482,神盾永豐95購02,0.76,0.80,0.74,0.77,+0.04,5.48,1225000,34,959600,0,0,0,0,0,0,850000,473000,377000,377000
20200212,707483,環球晶永豐95購04,3.52,3.52,3.52,3.52,+0.28,8.64,7000,1,24640,0,0,0,0,0,0,0,7000,-7000,-7000
20200212,707484,大江元大96購05,0.29,0.30,0.29,0.30,+0.01,3.45,20000,2,5950,0,0,0,0,0,0,0,20000,-20000,-20000
20200212,707485,同致元大97購01,0.52,0.52,0.52,0.52,0.00,0.0,15000,4,7800,0,0,0,0,0,0,10000,5000,5000,5000
20200212,707486,昂寶元大95購01,,,,,,0.00,0,0,0,0,0,0,0,0,0,0,0,0,0
20200212,707487,迅得國票96購01,1.63,1.81,1.63,1.81,+0.25,16.03,83000,7,144020,0,0,0,0,0,0,23000,60000,-37000,-37000
20200212,707488,宜鼎國票96購02,,,,,,0.00,0,0,0,0,0,0,0,0,0,0,0,0,0
20200212,707489,美琪瑪國票96購01,,,,,,0.00,0,0,0,0,0,0,0,0,0,0,0,0,0
20200212,707490,智崴國泰96購01,0.67,0.67,0.67,0.67,0.00,0.0,20000,2,13400,0,0,0,0,0,0,0,20000,-20000,-20000
20200212,707491,櫃200T永昌9C購01,,,,,,0.00,0,0,0,0,0,0,0,0,0,0,0,0,0
20200212,707492,櫃200T永昌9C購02,,,,,,0.00,0,0,0,0,0,0,0,0,0,0,0,0,0
20200212,707493,櫃200T永昌9C購03,,,,,,0.00,0,0,0,0,0,0,0,0,0,0,0,0,0
20200212,707494,櫃200T永昌9C購04,,,,,,0.00,0,0,0,0,0,0,0,0,0,0,0,0,0
20200212,707495,穩懋康和95購02,,,,,,0.00,0,0,0,0,0,0,0,0,0,0,0,0,0
20200212,707496,精華群益95購03,,,,,,0.00,0,0,0,0,0,0,0,0,0,0,0,0,0
20200212,707497,宜鼎元大95購02,2.44,2.44,2.44,2.44,+0.13,5.63,3000,1,7320,0,0,0,0,0,0,3000,0,3000,3000
20200212,707498,旺矽元大96購01,1.83,1.83,1.80,1.80,+0.05,2.86,3000,2,5430,0,0,0,0,0,0,1000,2000,-1000,-1000
20200212,707499,精華元大95購03,,,,,,0.00,0,0,0,0,0,0,0,0,0,0,0,0,0
20200212,707500,智崴國票96購01,0.76,0.76,0.76,0.76,+0.03,4.11,509000,2,386840,0,0,0,0,0,0,0,509000,-509000,-509000
20200212,707501,閎康國票97購01,,,,,,0.00,0,0,0,0,0,0,0,0,0,0,0,0,0
20200212,707502,金可國泰97購01,0.70,0.75,0.70,0.75,+0.05,7.14,272000,9,194050,0,0,0,0,0,0,137000,135000,2000,2000
20200212,707503,精華國泰97購01,,,,,,0.00,0,0,0,0,0,0,0,0,0,0,0,0,0
20200212,707504,環球晶國泰96購03,,,,,,0.00,0,0,0,0,0,0,0,0,0,0,0,0,0
20200212,707505,穩懋國泰96購02,1.27,1.53,1.23,1.47,+0.23,18.55,1851000,82,2608930,0,0,0,0,0,0,776000,1452000,-676000,-676000
20200212,707506,穩懋統一96購05,1.70,1.94,1.66,1.94,+0.26,15.48,778000,37,1405460,0,0,0,0,0,0,299000,479000,-180000,-180000
20200212,707507,三貝德凱基96購02,,,,,,0.00,0,0,0,0,0,0,0,0,0,0,0,0,0
20200212,707508,中美晶凱基95購04,3.39,3.80,3.39,3.80,+0.53,16.21,20000,8,73110,0,0,0,0,0,0,20000,15000,5000,5000
20200212,707509,元太凱基96購01,0.24,0.25,0.24,0.25,+0.03,13.64,170000,2,41500,0,0,0,0,0,0,70000,100000,-30000,-30000
20200212,707510,昂寶凱基96購01,,,,,,0.00,0,0,0,0,0,0,0,0,0,0,0,0,0
20200212,707511,建榮凱基97購01,,,,,,0.00,0,0,0,0,0,0,0,0,0,0,0,0,0
20200212,707512,穩懋凱基96購04,0.63,0.82,0.63,0.79,+0.19,31.67,208000,7,155760,0,0,0,0,0,0,188000,20000,168000,168000
20200212,707513,元太第一95購01,0.44,0.45,0.44,0.45,+0.05,12.5,4000,3,1770,0,0,0,0,0,0,0,4000,-4000,-4000
20200212,707514,晶焱永豐95購02,1.29,1.31,1.29,1.31,+0.14,11.97,129000,5,167090,0,0,0,0,0,0,0,129000,-129000,-129000
20200212,707515,精華永豐95購02,,,,,,0.00,0,0,0,0,0,0,0,0,0,0,0,0,0
20200212,707516,聚積永豐95購01,,,,,,0.00,0,0,0,0,0,0,0,0,0,0,0,0,0
20200212,707517,穩懋兆豐96購02,0.75,0.75,0.75,0.75,+0.23,44.23,20000,1,15000,0,0,0,0,0,0,0,20000,-20000,-20000
20200212,707518,金可康和95購01,,,,,,0.00,0,0,0,0,0,0,0,0,0,0,0,0,0
20200212,707519,金可群益95購01,0.46,0.46,0.46,0.46,+0.02,4.55,299000,1,137540,0,0,0,0,0,0,0,299000,-299000,-299000
20200212,707520,優群群益97購01,0.98,1.03,0.98,1.03,+0.09,9.57,173000,9,175040,0,0,0,0,0,0,10000,163000,-153000,-153000
20200212,707521,環球晶群益95購04,,,,,,0.00,0,0,0,0,0,0,0,0,0,0,0,0,0
20200212,707522,聯亞群益95購02,2.70,2.70,2.46,2.46,+0.12,5.13,21000,3,54100,0,0,0,0,0,0,10000,10000,0,0
20200212,707523,群聯元富95購02,1.47,1.53,1.47,1.53,+0.14,10.07,20000,2,30000,0,0,0,0,0,0,20000,0,20000,20000
20200212,707524,鈺太兆豐95購01,0.81,0.89,0.80,0.89,+0.09,11.25,489000,12,409300,0,0,0,0,0,0,59000,430000,-371000,-371000
20200212,707525,泰博中信97購01,0.78,0.82,0.78,0.80,+0.03,3.9,201000,16,161620,0,0,0,0,0,0,83000,118000,-35000,-35000
20200212,707526,建榮凱基96購01,0.49,0.49,0.49,0.49,+0.01,2.08,20000,1,9800,0,0,0,0,0,0,20000,0,20000,20000
20200212,707527,新普凱基95購02,0.95,1.04,0.95,1.04,+0.12,13.04,164000,8,160440,0,0,0,0,0,0,130000,34000,96000,96000
20200212,707528,精華凱基96購01,,,,,,0.00,0,0,0,0,0,0,0,0,0,0,0,0,0
20200212,707529,精華統一97購01,,,,,,0.00,0,0,0,0,0,0,0,0,0,0,0,0,0
20200212,707530,精華統一97購02,0.42,0.42,0.42,0.42,+0.01,2.44,140000,1,58800,0,0,0,0,0,0,140000,0,140000,140000
20200212,707531,神盾國票97購01,0.55,0.59,0.55,0.57,+0.03,5.56,389000,7,222490,0,0,0,0,0,0,379000,377000,2000,2000
20200212,707532,群聯國票96購03,4.65,4.65,4.65,4.65,+0.12,2.65,449000,3,2087850,0,0,0,0,0,0,0,449000,-449000,-449000
20200212,707533,緯軟國票97購02,1.23,1.23,1.20,1.20,+0.02,1.69,151000,2,184170,0,0,0,0,0,0,151000,0,151000,151000
20200212,707534,碩禾元大98購01,1.34,1.37,1.32,1.32,-0.02,-1.49,230000,13,305840,0,0,0,0,0,0,197000,222000,-25000,-25000
20200212,707535,精華元大96購01,0.55,0.56,0.54,0.56,+0.03,5.66,360000,7,201300,0,0,0,0,0,0,355000,0,355000,355000
20200212,707536,穩懋元大95購12,1.31,1.65,1.26,1.56,+0.29,22.83,998000,117,1393980,0,0,0,0,0,0,832000,463000,369000,369000
20200212,707537,穩懋元大95購13,1.49,1.82,1.43,1.70,+0.26,18.06,762000,128,1212480,0,0,0,0,0,0,601000,436000,165000,165000
20200212,707538,世界永豐95購01,1.07,1.14,1.07,1.14,+0.11,10.68,230000,6,253700,0,0,0,0,0,0,15000,215000,-200000,-200000
20200212,707539,合晶永豐95購03,0.51,0.63,0.51,0.60,+0.14,30.43,181000,7,104590,0,0,0,0,0,0,30000,151000,-121000,-121000
20200212,707540,宇峻永豐95購02,1.55,1.55,1.43,1.49,-0.33,-18.13,110000,12,165400,0,0,0,0,0,0,80000,30000,50000,50000
20200212,707541,佳邦永豐95購01,,,,,,0.00,0,0,0,0,0,0,0,0,0,0,0,0,0
20200212,707542,金居永豐95購01,0.61,0.66,0.61,0.66,+0.09,15.79,136000,4,87590,0,0,0,0,0,0,27000,109000,-82000,-82000
20200212,707543,泰博永豐95購01,0.84,0.84,0.82,0.82,0.00,0.0,290000,5,242740,0,0,0,0,0,0,245000,45000,200000,200000
20200212,707544,勝麗永豐95購02,0.60,0.69,0.60,0.69,+0.11,18.97,308000,5,203430,0,0,0,0,0,0,40000,268000,-228000,-228000
20200212,707545,晟德永豐95購02,,,,,,0.00,0,0,0,0,0,0,0,0,0,0,0,0,0
20200212,707546,台半亞東96購01,,,,,,0.00,0,0,0,0,0,0,0,0,0,0,0,0,0
20200212,707547,世界中信96購01,1.57,1.67,1.57,1.67,+0.12,7.74,86000,4,141240,0,0,0,0,0,0,10000,76000,-66000,-66000
20200212,707548,精測中信95購01,0.95,0.98,0.94,0.98,+0.09,10.11,193000,5,183050,0,0,0,0,0,0,0,193000,-193000,-193000
20200212,707549,精測凱基96購01,1.49,1.54,1.49,1.53,+0.10,6.99,40000,8,60750,0,0,0,0,0,0,20000,30000,-10000,-10000
20200212,707550,聯亞凱基95購03,1.25,1.25,1.24,1.24,+0.08,6.9,188000,5,233750,0,0,0,0,0,0,188000,0,188000,188000
20200212,707551,穩懋凱基95購03,1.04,1.41,1.01,1.31,+0.29,28.43,184000,24,215630,0,0,0,0,0,0,116000,67000,49000,49000
20200212,707552,精測統一96購01,1.04,1.08,1.04,1.06,+0.05,4.95,142000,7,149660,0,0,0,0,0,0,142000,0,142000,142000
20200212,707553,安勤永豐95購01,0.52,0.52,0.52,0.52,-0.01,-1.89,168000,2,87360,0,0,0,0,0,0,68000,100000,-32000,-32000
20200212,707554,金可永豐95購02,,,,,,0.00,0,0,0,0,0,0,0,0,0,0,0,0,0
20200212,707555,宣德永豐95購03,1.44,1.61,1.41,1.61,0.00,0.0,218000,16,322120,0,0,0,0,0,0,177000,41000,136000,136000
20200212,707556,精測永豐96購01,1.30,1.35,1.30,1.35,+0.11,8.87,4000,2,5250,0,0,0,0,0,0,4000,4000,0,0
20200212,707557,廣明永豐95購02,,,,,,0.00,0,0,0,0,0,0,0,0,0,0,0,0,0
20200212,707558,台燿亞東95購01,,,,,,0.00,0,0,0,0,0,0,0,0,0,0,0,0,0
20200212,707559,信昌電亞東95購01,,,,,,0.00,0,0,0,0,0,0,0,0,0,0,0,0,0
20200212,707560,精測元富95購01,1.40,1.44,1.37,1.39,+0.09,6.92,1207000,26,1711230,0,0,0,0,0,0,77000,1150000,-1073000,-1073000
20200212,707561,M31國票96購02,0.46,0.46,0.46,0.46,+0.04,9.52,86000,1,39560,0,0,0,0,0,0,86000,0,86000,86000
20200212,707562,由田國票97購01,,,,,,0.00,0,0,0,0,0,0,0,0,0,0,0,0,0
20200212,707563,宇峻國票96購01,4.74,5.05,4.73,5.05,-0.70,-12.17,35000,4,169170,0,0,0,0,0,0,18000,17000,1000,1000
20200212,707564,環球晶國票96購04,,,,,,0.00,0,0,0,0,0,0,0,0,0,0,0,0,0
20200212,707565,精測國泰95購01,1.17,1.26,1.17,1.23,+0.07,6.03,859000,43,1051590,0,0,0,0,0,0,91000,768000,-677000,-677000
20200212,707566,大江元大96購06,0.27,0.27,0.27,0.27,+0.01,3.85,30000,1,8100,0,0,0,0,0,0,0,30000,-30000,-30000
20200212,707567,合晶元大96購04,0.89,1.06,0.89,1.00,+0.16,19.05,798000,18,811460,0,0,0,0,0,0,0,798000,-798000,-798000
20200212,707568,勝麗元大95購03,2.39,2.65,2.36,2.48,+0.07,2.9,155000,18,386360,0,0,0,0,0,0,127000,47000,80000,80000
20200212,707569,群聯元大95購07,3.92,4.09,3.92,4.09,+0.17,4.34,10000,2,39880,0,0,0,0,0,0,10000,0,10000,10000
20200212,707570,精測元大95購02,1.36,1.41,1.36,1.41,+0.08,6.02,459000,11,629820,0,0,0,0,0,0,359000,124000,235000,235000
20200212,707571,優群元大97購01,0.57,0.59,0.57,0.59,+0.03,5.36,276000,5,162020,0,0,0,0,0,0,66000,210000,-144000,-144000
20200212,707572,穩懋元大95購14,0.83,1.07,0.82,1.01,+0.29,40.28,172000,23,161320,0,0,0,0,0,0,79000,122000,-43000,-43000
20200212,707573,穩懋元大96購02,1.02,1.25,0.99,1.19,+0.20,20.2,1219000,70,1338710,0,0,0,0,0,0,1071000,537000,534000,534000
20200212,707574,大江富邦97購03,0.32,0.32,0.30,0.31,0.00,0.0,419000,24,130800,0,0,0,0,0,0,308000,111000,197000,197000
20200212,707575,雙鴻康和95購02,0.31,0.36,0.31,0.36,+0.02,5.88,150000,14,51380,0,0,0,0,0,0,60000,90000,-30000,-30000
20200212,707576,元太群益95購02,0.78,0.84,0.78,0.84,+0.08,10.53,67000,8,54190,0,0,0,0,0,0,0,67000,-67000,-67000
20200212,707577,神盾群益97購01,0.61,0.64,0.61,0.63,+0.03,5.0,1852000,19,1157350,0,0,0,0,0,0,1508000,344000,1164000,1164000
20200212,707578,精測群益95購01,1.82,1.84,1.77,1.81,+0.11,6.47,191000,13,346990,0,0,0,0,0,0,135000,76000,59000,59000
20200212,707579,聯亞群益95購03,1.30,1.36,1.30,1.32,+0.07,5.6,61000,3,79560,0,0,0,0,0,0,50000,11000,39000,39000
20200212,707580,雙鴻群益96購03,0.43,0.51,0.43,0.51,+0.03,6.25,123000,30,59000,0,0,0,0,0,0,34000,89000,-55000,-55000
20200212,707581,世界元大96購01,2.70,2.93,2.70,2.93,+0.27,10.15,125000,21,354900,0,0,0,0,0,0,91000,105000,-14000,-14000
20200212,707582,金可元大96購01,0.51,0.52,0.51,0.52,+0.03,6.12,549000,2,284980,0,0,0,0,0,0,50000,499000,-449000,-449000
20200212,707583,順達元大96購01,1.25,1.32,1.24,1.32,+0.20,17.86,183000,5,236090,0,0,0,0,0,0,28000,183000,-155000,-155000
20200212,707584,精測元大97購01,2.50,2.55,2.39,2.50,+0.17,7.3,129000,14,321500,0,0,0,0,0,0,35000,128000,-93000,-93000
20200212,707585,精華元大96購02,,,,,,0.00,0,0,0,0,0,0,0,0,0,0,0,0,0
20200212,707586,新鉅科元富96購02,0.49,0.52,0.49,0.52,+0.06,13.04,293000,4,150760,0,0,0,0,0,0,20000,273000,-253000,-253000
20200212,707587,精測元富96購01,2.34,2.43,2.33,2.43,+0.22,9.95,270000,8,642100,0,0,0,0,0,0,60000,210000,-150000,-150000
20200212,707588,廣明元富96購01,0.72,0.75,0.71,0.75,0.00,0.0,227000,6,162660,0,0,0,0,0,0,51000,176000,-125000,-125000
20200212,707589,宣德統一96購01,1.24,1.34,1.21,1.32,+0.01,0.76,1168000,44,1449300,0,0,0,0,0,0,1152000,14000,1138000,1138000
20200212,707590,群聯統一96購03,1.87,1.91,1.83,1.87,+0.06,3.31,245000,12,458110,0,0,0,0,0,0,124000,121000,3000,3000
20200212,707591,精測統一97購01,1.36,1.40,1.36,1.37,+0.08,6.2,191000,4,261980,0,0,0,0,0,0,48000,143000,-95000,-95000
20200212,707592,穩懋統一97購01,1.83,1.88,1.83,1.88,+0.26,16.05,108000,4,200920,0,0,0,0,0,0,40000,68000,-28000,-28000
20200212,707593,穩懋統一98購01,1.79,1.97,1.79,1.97,+0.33,20.12,460000,7,884900,0,0,0,0,0,0,400000,60000,340000,340000
20200212,707594,昂寶凱基98購01,1.03,1.03,1.03,1.03,-0.01,-0.96,25000,1,25750,0,0,0,0,0,0,0,25000,-25000,-25000
20200212,707595,精測凱基97購01,1.52,1.54,1.50,1.54,+0.11,7.69,11000,5,16810,0,0,0,0,0,0,11000,11000,0,0
20200212,707596,精測凱基97購02,1.61,1.66,0.64,1.66,+0.12,7.79,204000,8,319860,0,0,0,0,0,0,138000,143000,-5000,-5000
20200212,707597,雙鴻凱基96購04,0.23,0.23,0.23,0.23,+0.03,15.0,63000,2,14490,0,0,0,0,0,0,0,60000,-60000,-60000
20200212,707598,穩懋凱基96購05,0.70,0.85,0.70,0.85,+0.21,32.81,41000,5,31470,0,0,0,0,0,0,25000,16000,9000,9000
20200212,707599,大江永豐96購01,0.03,0.03,0.03,0.03,-0.01,-25.0,3000,1,90,0,0,0,0,0,0,3000,0,3000,3000
20200212,707600,中美晶永豐96購01,,,,,,0.00,0,0,0,0,0,0,0,0,0,0,0,0,0
20200212,707601,精測永豐96購02,1.66,1.71,1.64,1.70,+0.09,5.59,54000,10,90140,0,0,0,0,0,0,39000,27000,12000,12000
20200212,707602,精測永豐97購01,1.89,1.93,1.85,1.92,+0.10,5.49,58000,11,109780,0,0,0,0,0,0,53000,35000,18000,18000
20200212,707603,邦特國票97購01,0.73,0.73,0.73,0.73,+0.01,1.39,42000,2,30660,0,0,0,0,0,0,42000,0,42000,42000
20200212,707604,金可國票97購01,,,,,,0.00,0,0,0,0,0,0,0,0,0,0,0,0,0
20200212,707605,群聯富邦97購01,0.76,0.80,0.74,0.79,+0.04,5.33,639000,21,491790,0,0,0,0,0,0,94000,563000,-469000,-469000
20200212,707606,精測富邦96購01,0.62,0.64,0.62,0.64,+0.04,6.67,452000,14,283840,0,0,0,0,0,0,192000,452000,-260000,-260000
20200212,707607,精測兆豐97購01,2.51,2.55,2.51,2.55,+0.11,4.51,14000,4,35260,0,0,0,0,0,0,8000,6000,2000,2000
20200212,707608,東洋群益96購01,0.50,0.51,0.48,0.48,+0.01,2.13,96000,8,47290,0,0,0,0,0,0,10000,86000,-76000,-76000
20200212,707609,金居群益98購01,0.54,0.55,0.51,0.51,+0.03,6.25,80000,7,42850,0,0,0,0,0,0,5000,75000,-70000,-70000
20200212,707610,保瑞群益98購01,0.61,0.61,0.59,0.59,+0.03,5.36,115000,3,69830,0,0,0,0,0,0,115000,0,115000,115000
20200212,707611,新鉅科群益96購01,0.52,0.63,0.52,0.63,+0.15,31.25,342000,9,186060,0,0,0,0,0,0,192000,150000,42000,42000
20200212,707612,精測群益96購01,1.17,1.18,1.17,1.18,+0.07,6.31,62000,2,73110,0,0,0,0,0,0,0,62000,-62000,-62000
20200212,707613,鈊象台新97購01,,,,,,0.00,0,0,0,0,0,0,0,0,0,0,0,0,0
20200212,707614,精測中信96購02,0.81,0.83,0.81,0.83,+0.05,6.41,60000,4,49000,0,0,0,0,0,0,48000,10000,38000,38000
20200212,707615,鈊象中信96購01,1.65,1.71,1.53,1.57,-0.15,-8.72,241000,18,390470,0,0,0,0,0,0,172000,69000,103000,103000
20200212,707616,M31凱基97購01,,,,,,0.00,0,0,0,0,0,0,0,0,0,0,0,0,0
20200212,707617,宣德凱基96購01,0.53,0.57,0.52,0.57,-0.04,-6.56,191000,16,104820,0,0,0,0,0,0,191000,0,191000,191000
20200212,707618,精測凱基97購03,1.78,1.83,1.78,1.83,+0.14,8.28,10000,5,18100,0,0,0,0,0,0,10000,10000,0,0
20200212,707619,璟德凱基96購01,1.91,2.08,1.91,2.04,-0.01,-0.49,263000,18,530480,0,0,0,0,0,0,263000,0,263000,263000
20200212,707620,鐿鈦凱基96購02,,,,,,0.00,0,0,0,0,0,0,0,0,0,0,0,0,0
20200212,707621,精測統一97購02,1.59,1.64,1.56,1.62,+0.08,5.19,202000,13,325160,0,0,0,0,0,0,172000,30000,142000,142000
20200212,707622,鈊象統一96購01,3.64,3.64,3.64,3.64,-0.26,-6.67,1000,1,3640,0,0,0,0,0,0,0,1000,-1000,-1000
20200212,707623,勝麗兆豐96購01,1.18,1.31,1.18,1.27,+0.10,8.55,61000,10,75590,0,0,0,0,0,0,31000,30000,1000,1000
20200212,707624,精測康和96購02,0.68,0.68,0.68,0.68,+0.04,6.25,71000,1,48280,0,0,0,0,0,0,0,71000,-71000,-71000
20200212,707625,鈊象康和96購01,1.79,1.79,1.79,1.79,-0.25,-12.25,50000,1,89500,0,0,0,0,0,0,50000,0,50000,50000
20200212,707626,環球晶永昌99購01,,,,,,0.00,0,0,0,0,0,0,0,0,0,0,0,0,0
20200212,707627,迅得永豐97購01,0.48,0.48,0.48,0.48,+0.04,9.09,48000,1,23040,0,0,0,0,0,0,0,48000,-48000,-48000
20200212,707628,旺矽永豐97購01,1.05,1.05,1.05,1.05,+0.07,7.14,10000,1,10500,0,0,0,0,0,0,0,10000,-10000,-10000
20200212,707629,昇達科永豐97購01,,,,,,0.00,0,0,0,0,0,0,0,0,0,0,0,0,0
20200212,707630,僑威永豐96購01,,,,,,0.00,0,0,0,0,0,0,0,0,0,0,0,0,0
20200212,707631,璟德永豐96購01,1.15,1.29,1.15,1.22,-0.02,-1.61,1196000,33,1438380,0,0,0,0,0,0,915000,284000,631000,631000
20200212,707632,鈊象永豐96購01,3.70,3.70,3.50,3.50,-0.22,-5.91,50000,5,181100,0,0,0,0,0,0,0,50000,-50000,-50000
20200212,707633,鈊象永豐97購01,3.88,3.88,3.55,3.55,-0.33,-8.51,45000,5,160740,0,0,0,0,0,0,3000,42000,-39000,-39000
20200212,707634,元太元大96購03,0.52,0.52,0.52,0.52,+0.02,4.0,50000,3,26000,0,0,0,0,0,0,0,50000,-50000,-50000
20200212,707635,宣德元大96購02,0.71,0.80,0.69,0.80,-0.01,-1.23,295000,20,214800,0,0,0,0,0,0,185000,110000,75000,75000
20200212,707636,新普元大96購01,1.81,1.81,1.81,1.81,+0.39,27.46,1000,1,1810,0,0,0,0,0,0,1000,1000,0,0
20200212,707637,群聯元大97購02,,,,,,0.00,0,0,0,0,0,0,0,0,0,0,0,0,0
20200212,707638,精測元大96購01,2.69,2.84,2.66,2.77,+0.14,5.32,162000,24,446750,0,0,0,0,0,0,98000,135000,-37000,-37000
20200212,707639,鈊象元大97購01,,,,,,0.00,0,0,0,0,0,0,0,0,0,0,0,0,0
20200212,707640,波若威國票97購01,0.57,0.61,0.57,0.61,+0.04,7.02,231000,4,138280,0,0,0,0,0,0,62000,169000,-107000,-107000
20200212,707641,聯亞國票97購01,1.97,1.97,1.97,1.97,+0.08,4.23,8000,1,15760,0,0,0,0,0,0,8000,8000,0,0
20200212,707642,宣德國泰97購01,1.11,1.23,1.11,1.23,+0.02,1.65,682000,34,796450,0,0,0,0,0,0,654000,138000,516000,516000
20200212,707643,原相國泰98購01,4.23,4.23,4.23,4.23,-0.04,-0.94,2000,1,8460,0,0,0,0,0,0,2000,0,2000,2000
20200212,707644,精測國泰98購01,2.09,2.21,2.08,2.17,+0.10,4.83,1878000,50,4047170,0,0,0,0,0,0,1422000,451000,971000,971000
20200212,707645,鈊象國泰98購01,3.31,3.31,3.31,3.31,-0.25,-7.02,21000,1,69510,0,0,0,0,0,0,21000,0,21000,21000
20200212,707646,鈊象群益99購01,4.45,4.45,4.30,4.30,-0.31,-6.72,25000,2,110500,0,0,0,0,0,0,20000,5000,15000,15000
20200212,707647,鈺太中信96購02,0.63,0.71,0.63,0.71,+0.08,12.7,517000,14,349510,0,0,0,0,0,0,210000,307000,-97000,-97000
20200212,707648,雙鴻統一96購01,0.27,0.31,0.27,0.31,+0.03,10.71,256000,19,74810,0,0,0,0,0,0,106000,150000,-44000,-44000
20200212,707649,鈊象統一96購02,,,,,,0.00,0,0,0,0,0,0,0,0,0,0,0,0,0
20200212,707650,宇峻凱基98購01,0.80,0.80,0.66,0.71,-0.09,-11.25,622000,23,431080,0,0,0,0,0,0,204000,392000,-188000,-188000
20200212,707651,精測凱基96購03,1.16,1.20,1.15,1.19,+0.09,8.18,81000,8,94780,0,0,0,0,0,0,21000,70000,-49000,-49000
20200212,707652,環球晶凱基96購03,3.71,3.71,3.71,3.71,+0.24,6.92,1000,1,3710,0,0,0,0,0,0,1000,1000,0,0
20200212,707653,櫃200凱基96購03,1.09,1.30,1.09,1.30,+0.25,23.81,9000,9,10020,0,0,0,0,0,0,1000,0,1000,1000
20200212,707654,雙美凱基97購01,0.22,0.22,0.22,0.22,+0.08,57.14,1000,1,220,0,0,0,0,0,0,1000,0,1000,1000
20200212,707655,穩懋凱基96購06,1.03,1.47,1.03,1.33,+0.29,27.88,74000,15,83230,0,0,0,0,0,0,28000,27000,1000,1000
20200212,707656,鈊象凱基96購01,2.95,2.95,2.65,2.69,-0.25,-8.5,103000,8,277000,0,0,0,0,0,0,38000,60000,-22000,-22000
20200212,707657,鈊象凱基97購01,3.19,3.19,2.83,2.83,-0.32,-10.16,12000,2,37560,0,0,0,0,0,0,12000,2000,10000,10000
20200212,707658,信昌電元富96購01,1.15,1.17,1.15,1.15,-0.02,-1.71,57000,6,66220,0,0,0,0,0,0,20000,37000,-17000,-17000
20200212,707659,精測元富96購02,1.83,1.83,1.72,1.80,+0.16,9.76,67000,9,119450,0,0,0,0,0,0,56000,21000,35000,35000
20200212,707660,鈊象元富96購01,,,,,,0.00,0,0,0,0,0,0,0,0,0,0,0,0,0
20200212,707661,宣德台新96購01,0.79,0.89,0.78,0.89,-0.04,-4.3,143000,11,117050,0,0,0,0,0,0,66000,0,66000,66000
20200212,707662,凡甲國票97購01,0.77,0.82,0.77,0.81,+0.01,1.25,694000,27,555650,0,0,0,0,0,0,404000,290000,114000,114000
20200212,707663,世界國票97購01,2.66,2.77,2.66,2.77,+0.17,6.54,10000,2,27040,0,0,0,0,0,0,6000,4000,2000,2000
20200212,707664,杰力國票97購01,0.90,0.94,0.90,0.94,+0.05,5.62,38000,3,35320,0,0,0,0,0,0,0,38000,-38000,-38000
20200212,707665,原相國票98購01,4.30,4.32,4.30,4.32,+0.13,3.1,12000,2,51800,0,0,0,0,0,0,2000,10000,-8000,-8000
20200212,707666,鈊象國票96購02,11.70,11.70,10.20,10.30,-1.80,-14.88,90000,19,966900,0,0,0,0,0,0,52000,38000,14000,14000
20200212,707667,精測國泰98購02,2.53,2.63,2.53,2.63,+0.14,5.62,72000,7,187760,0,0,0,0,0,0,32000,52000,-20000,-20000
20200212,707668,合晶富邦96購01,0.62,0.62,0.62,0.62,+0.12,24.0,60000,1,37200,0,0,0,0,0,0,0,60000,-60000,-60000
20200212,707669,安勤永豐97購01,0.48,0.49,0.48,0.49,0.00,0.0,611000,3,297990,0,0,0,0,0,0,561000,50000,511000,511000
20200212,707670,閎康永豐96購01,,,,,,0.00,0,0,0,0,0,0,0,0,0,0,0,0,0
20200212,707671,精測永豐96購04,1.44,1.50,1.42,1.49,+0.14,10.37,38000,6,55960,0,0,0,0,0,0,32000,38000,-6000,-6000
20200212,707672,晶焱兆豐97購01,0.91,0.94,0.91,0.94,+0.08,9.3,333000,9,311720,0,0,0,0,0,0,10000,323000,-313000,-313000
20200212,707673,雙鴻兆豐97購02,0.37,0.42,0.37,0.42,+0.04,10.53,470000,14,186500,0,0,0,0,0,0,160000,304000,-144000,-144000
20200212,707674,合晶元大97購01,0.74,0.91,0.74,0.91,+0.20,28.17,414000,6,362260,0,0,0,0,0,0,4000,410000,-406000,-406000
20200212,707675,茂達元大97購01,,,,,,0.00,0,0,0,0,0,0,0,0,0,0,0,0,0
20200212,707676,原相元大97購02,,,,,,0.00,0,0,0,0,0,0,0,0,0,0,0,0,0
20200212,707677,勝麗元大96購02,1.27,1.41,1.25,1.30,+0.02,1.56,165000,18,221410,0,0,0,0,0,0,153000,12000,141000,141000
20200212,707678,精測元大98購01,1.70,1.76,1.69,1.76,+0.10,6.02,207000,21,355340,0,0,0,0,0,0,153000,77000,76000,76000
20200212,707679,璟德元大96購01,2.88,3.08,2.82,2.94,-0.05,-1.67,279000,29,823560,0,0,0,0,0,0,233000,48000,185000,185000
20200212,707680,鈊象元大98購01,6.30,6.30,5.90,5.90,-0.50,-7.81,3000,2,18500,0,0,0,0,0,0,3000,3000,0,0
20200212,707681,力麒康和96購01,0.61,0.61,0.61,0.61,-0.01,-1.61,50000,1,30500,0,0,0,0,0,0,0,50000,-50000,-50000
20200212,707682,精測康和96購03,,,,,,0.00,0,0,0,0,0,0,0,0,0,0,0,0,0
20200212,707683,東隆興群益96購01,0.62,0.72,0.62,0.65,+0.07,12.07,901000,10,586070,0,0,0,0,0,0,874000,27000,847000,847000
20200212,707684,金居群益98購02,0.68,0.70,0.67,0.70,+0.10,16.67,87000,8,60050,0,0,0,0,0,0,10000,77000,-67000,-67000
20200212,707685,保瑞群益98購02,1.12,1.12,1.06,1.06,-0.03,-2.75,65000,5,70330,0,0,0,0,0,0,55000,10000,45000,45000
20200212,707686,神盾群益98購01,0.47,0.47,0.45,0.45,+0.03,7.14,390000,7,175800,0,0,0,0,0,0,380000,10000,370000,370000
20200212,707687,順達群益96購02,,,,,,0.00,0,0,0,0,0,0,0,0,0,0,0,0,0
20200212,707688,緯軟統一96購01,0.64,0.64,0.62,0.62,+0.01,1.64,60000,4,37760,0,0,0,0,0,0,60000,0,60000,60000
20200212,707689,穩懋統一96購06,1.89,2.25,1.85,2.25,+0.50,28.57,65000,4,124650,0,0,0,0,0,0,57000,8000,49000,49000
20200212,707690,鈊象統一96購03,,,,,,0.00,0,0,0,0,0,0,0,0,0,0,0,0,0
20200212,707691,同致元大97購02,,,,,,0.00,0,0,0,0,0,0,0,0,0,0,0,0,0
20200212,707692,迅得元大97購01,0.57,0.60,0.57,0.60,+0.04,7.14,2000,2,1170,0,0,0,0,0,0,1000,1000,0,0
20200212,707693,晶焱元大97購01,1.29,1.40,1.29,1.36,+0.10,7.94,380000,26,518270,0,0,0,0,0,0,325000,377000,-52000,-52000
20200212,707694,群聯元大97購03,3.31,3.31,3.31,3.31,+0.02,0.61,5000,1,16550,0,0,0,0,0,0,5000,0,5000,5000
20200212,707695,優群元大97購02,0.89,0.93,0.89,0.93,+0.06,6.9,170000,5,155860,0,0,0,0,0,0,50000,122000,-72000,-72000
20200212,707696,聯亞元大97購01,2.39,2.43,2.28,2.28,+0.12,5.56,107000,10,251150,0,0,0,0,0,0,58000,102000,-44000,-44000
20200212,707697,穩懋元大96購03,2.64,3.17,2.57,2.98,+0.41,15.95,609000,113,1677600,0,0,0,0,0,0,554000,516000,38000,38000
20200212,707698,鈊象元大97購02,6.75,6.75,6.75,6.75,-0.35,-4.93,10000,1,67500,0,0,0,0,0,0,10000,0,10000,10000
20200212,707699,原相元富96購01,5.20,5.30,5.20,5.30,+0.43,8.83,20000,2,105000,0,0,0,0,0,0,20000,0,20000,20000
20200212,707700,精華元富96購01,,,,,,0.00,0,0,0,0,0,0,0,0,0,0,0,0,0
20200212,707701,環球晶元富96購01,3.88,3.88,3.88,3.88,+0.45,13.12,2000,2,7760,0,0,0,0,0,0,1000,2000,-1000,-1000
20200212,707702,鈊象台新98購01,3.66,3.66,3.66,3.66,-0.23,-5.91,14000,2,51240,0,0,0,0,0,0,0,14000,-14000,-14000
20200212,707703,M31凱基96購01,,,,,,0.00,0,0,0,0,0,0,0,0,0,0,0,0,0
20200212,707704,金可凱基97購01,0.45,0.50,0.45,0.50,+0.04,8.7,153000,2,75350,0,0,0,0,0,0,130000,23000,107000,107000
20200212,707705,金居凱基96購01,0.37,0.37,0.37,0.37,+0.06,19.35,57000,2,21090,0,0,0,0,0,0,0,57000,-57000,-57000
20200212,707706,精華凱基96購02,,,,,,0.00,0,0,0,0,0,0,0,0,0,0,0,0,0
20200212,707707,環球晶凱基96購04,,,,,,0.00,0,0,0,0,0,0,0,0,0,0,0,0,0
20200212,707708,聯亞凱基96購01,1.51,1.51,1.45,1.45,+0.06,4.32,115000,4,170150,0,0,0,0,0,0,69000,65000,4000,4000
20200212,707709,鐿鈦凱基97購01,,,,,,0.00,0,0,0,0,0,0,0,0,0,0,0,0,0
20200212,707710,大田國票97購01,1.09,1.11,1.09,1.10,+0.06,5.77,77000,3,84430,0,0,0,0,0,0,0,77000,-77000,-77000
20200212,707711,六角國票98購01,2.01,2.39,2.01,2.34,+0.35,17.59,772000,7,1825630,0,0,0,0,0,0,702000,70000,632000,632000
20200212,707712,昂寶國票97購02,4.73,4.73,4.73,4.73,-0.02,-0.42,3000,1,14190,0,0,0,0,0,0,0,3000,-3000,-3000
20200212,707713,晶焱國票97購01,1.47,1.58,1.47,1.53,+0.13,9.29,159000,14,243180,0,0,0,0,0,0,41000,118000,-77000,-77000
20200212,707714,群聯國票97購01,6.45,6.45,6.45,6.45,+0.05,0.78,8000,2,51600,0,0,0,0,0,0,0,8000,-8000,-8000
20200212,707715,大江國泰98購01,0.24,0.24,0.22,0.22,-0.02,-8.33,60000,3,13800,0,0,0,0,0,0,0,60000,-60000,-60000
20200212,707716,晶焱國泰98購01,1.26,1.33,1.26,1.32,+0.12,10.0,164000,13,214260,0,0,0,0,0,0,94000,144000,-50000,-50000
20200212,707717,穩懋國泰97購01,1.78,2.17,1.72,2.06,+0.33,19.08,1071000,110,1994580,0,0,0,0,0,0,462000,713000,-251000,-251000
20200212,707718,良維永豐96購01,0.64,0.65,0.64,0.65,+0.04,6.56,54000,2,34830,0,0,0,0,0,0,0,54000,-54000,-54000
20200212,707719,威剛永豐96購01,5.25,5.25,5.25,5.25,+0.39,8.02,3000,1,15750,0,0,0,0,0,0,3000,0,3000,3000
20200212,707720,宣德永豐97購01,,,,,,0.00,0,0,0,0,0,0,0,0,0,0,0,0,0
20200212,707721,鈊象永豐96購03,4.26,4.26,3.94,3.95,-0.48,-10.84,50000,5,203750,0,0,0,0,0,0,20000,30000,-10000,-10000
20200212,707722,三貝德群益96購01,0.14,0.14,0.14,0.14,+0.08,133.33,10000,1,1400,0,0,0,0,0,0,0,10000,-10000,-10000
20200212,707723,宜鼎群益96購02,,,,,,0.00,0,0,0,0,0,0,0,0,0,0,0,0,0
20200212,707724,長科*群益96購01,,,,,,0.00,0,0,0,0,0,0,0,0,0,0,0,0,0
20200212,707725,閎康群益97購01,0.68,0.68,0.68,0.68,-0.01,-1.45,14000,2,9520,0,0,0,0,0,0,10000,4000,6000,6000
20200212,707726,晟德群益96購01,0.93,0.93,0.93,0.93,+0.03,3.33,11000,1,10230,0,0,0,0,0,0,11000,0,11000,11000
20200212,707727,鈊象群益99購02,5.40,5.40,5.40,5.40,-0.20,-3.57,100000,1,540000,0,0,0,0,0,0,100000,0,100000,100000
20200212,707728,鈊象康和96購03,2.58,2.58,2.58,2.58,-0.05,-1.9,10000,1,25800,0,0,0,0,0,0,10000,0,10000,10000
20200212,707729,鈊象凱基98購01,3.43,3.43,3.30,3.30,-0.36,-9.84,6000,2,20320,0,0,0,0,0,0,6000,2000,4000,4000
20200212,707730,穩懋元富96購01,1.24,1.62,1.21,1.62,+0.40,32.79,554000,17,740850,0,0,0,0,0,0,159000,395000,-236000,-236000
20200212,707731,環球晶亞東97購01,,,,,,0.00,0,0,0,0,0,0,0,0,0,0,0,0,0
20200212,707732,凡甲永豐97購01,,,,,,0.00,0,0,0,0,0,0,0,0,0,0,0,0,0
20200212,707733,大宇資永豐96購02,,,,,,0.00,0,0,0,0,0,0,0,0,0,0,0,0,0
20200212,707734,元太國票97購01,1.30,1.38,1.30,1.38,+0.14,11.29,41000,7,54090,0,0,0,0,0,0,0,41000,-41000,-41000
20200212,707735,台燿國票97購01,1.66,1.82,1.66,1.79,+0.27,17.76,527000,27,912370,0,0,0,0,0,0,102000,425000,-323000,-323000
20200212,707736,信驊國票97購01,1.79,1.80,1.75,1.76,-0.17,-8.81,36000,5,64050,0,0,0,0,0,0,8000,28000,-20000,-20000
20200212,707737,新普國票97購01,1.84,1.84,1.84,1.84,+0.14,8.24,20000,1,36800,0,0,0,0,0,0,20000,0,20000,20000
20200212,707738,聖暉國泰96購01,,,,,,0.00,0,0,0,0,0,0,0,0,0,0,0,0,0
20200212,707739,網家國泰97購01,1.00,1.03,0.94,0.97,-0.03,-3.0,1160000,62,1143450,0,0,0,0,0,0,592000,412000,180000,180000
20200212,707740,金可兆豐96購01,0.51,0.54,0.51,0.54,+0.03,5.88,189000,4,100780,0,0,0,0,0,0,45000,144000,-99000,-99000
20200212,707741,胡連康和96購01,1.96,2.13,1.96,2.13,+0.18,9.23,73000,6,147960,0,0,0,0,0,0,55000,8000,47000,47000
20200212,707742,佳邦群益96購01,0.59,0.63,0.59,0.63,+0.07,12.5,380000,3,228200,0,0,0,0,0,0,0,380000,-380000,-380000
20200212,707743,旺矽群益97購01,1.19,1.19,1.18,1.18,+0.07,6.31,238000,7,281290,0,0,0,0,0,0,194000,44000,150000,150000
20200212,707744,新普群益98購01,1.79,1.87,1.78,1.87,+0.23,14.02,194000,9,349150,0,0,0,0,0,0,144000,51000,93000,93000
20200212,707745,網龍群益98購01,1.52,1.52,1.50,1.51,-0.01,-0.66,74000,4,112140,0,0,0,0,0,0,71000,3000,68000,68000
20200212,707746,由田元大96購01,,,,,,0.00,0,0,0,0,0,0,0,0,0,0,0,0,0
20200212,707747,信昌電元大97購01,3.07,3.07,2.97,2.98,-0.14,-4.49,87000,12,262230,0,0,0,0,0,0,87000,48000,39000,39000
20200212,707748,神盾元大99購01,1.05,1.09,1.04,1.04,+0.03,2.97,870000,41,929420,0,0,0,0,0,0,655000,288000,367000,367000
20200212,707749,精華元大97購01,,,,,,0.00,0,0,0,0,0,0,0,0,0,0,0,0,0
20200212,707750,穩懋元大97購01,1.69,2.06,1.65,1.95,+0.30,18.18,627000,106,1127870,0,0,0,0,0,0,534000,408000,126000,126000
20200212,707751,鈺太元大97購01,0.93,1.20,0.93,1.17,+0.25,27.17,540000,20,563780,0,0,0,0,0,0,177000,474000,-297000,-297000
20200212,707752,世界中信98購01,0.78,0.81,0.78,0.81,+0.03,3.85,24000,7,18870,0,0,0,0,0,0,24000,0,24000,24000
20200212,707753,環球晶中信99購02,1.30,1.34,1.29,1.31,+0.05,3.97,223000,16,291240,0,0,0,0,0,0,191000,32000,159000,159000
20200212,707754,環球晶統一96購01,5.75,5.75,5.75,5.75,+0.30,5.5,10000,1,57500,0,0,0,0,0,0,10000,0,10000,10000
20200212,707755,穩懋統一96購07,2.03,2.23,1.99,2.23,+0.26,13.2,312000,24,644260,0,0,0,0,0,0,251000,63000,188000,188000
20200212,707756,世界凱基96購01,0.30,0.74,0.30,0.74,+0.06,8.82,17000,3,8140,0,0,0,0,0,0,2000,5000,-3000,-3000
20200212,707757,網龍凱基97購01,,,,,,0.00,0,0,0,0,0,0,0,0,0,0,0,0,0
20200212,707758,穩懋凱基96購07,1.11,1.33,1.11,1.32,+0.22,20.0,242000,14,316090,0,0,0,0,0,0,232000,42000,190000,190000
20200212,707759,大江元大97購01,,,,,,0.00,0,0,0,0,0,0,0,0,0,0,0,0,0
20200212,707760,世界元大96購02,1.42,1.51,1.42,1.51,+0.14,10.22,170000,11,245480,0,0,0,0,0,0,24000,160000,-136000,-136000
20200212,707761,迅得元大98購01,0.57,0.60,0.56,0.56,+0.03,5.66,230000,4,131200,0,0,0,0,0,0,10000,220000,-210000,-210000
20200212,707762,宣德元大96購03,0.82,0.84,0.81,0.82,-0.09,-9.89,100000,10,82400,0,0,0,0,0,0,100000,0,100000,100000
20200212,707763,群聯元大96購04,5.50,5.55,5.45,5.55,+0.15,2.78,63000,3,346500,0,0,0,0,0,0,63000,60000,3000,3000
20200212,707764,鈊象元大96購03,,,,,,0.00,0,0,0,0,0,0,0,0,0,0,0,0,0
20200212,707765,原相永昌99購01,6.90,7.10,6.20,6.35,0.00,0.0,56000,20,359700,0,0,0,0,0,0,53000,3000,50000,50000
20200212,707766,大田永豐96購01,0.53,0.54,0.53,0.54,+0.05,10.2,118000,2,63040,0,0,0,0,0,0,0,118000,-118000,-118000
20200212,707767,中美晶永豐96購02,1.74,2.04,1.74,1.99,+0.26,15.03,227000,14,432520,0,0,0,0,0,0,51000,179000,-128000,-128000
20200212,707768,世界永豐96購02,0.70,0.75,0.70,0.75,+0.08,11.94,89000,2,65650,0,0,0,0,0,0,22000,67000,-45000,-45000
20200212,707769,光頡永豐96購01,1.28,1.28,1.24,1.24,-0.08,-6.06,153000,7,192920,0,0,0,0,0,0,120000,33000,87000,87000
20200212,707770,合晶永豐97購01,0.82,0.92,0.82,0.92,+0.17,22.67,254000,5,220510,0,0,0,0,0,0,0,254000,-254000,-254000
20200212,707771,精測永豐96購06,1.53,1.55,1.48,1.54,+0.09,6.21,97000,11,147560,0,0,0,0,0,0,81000,28000,53000,53000
20200212,707772,精測永豐96購07,1.25,1.26,1.19,1.25,+0.10,8.7,56000,7,69740,0,0,0,0,0,0,13000,56000,-43000,-43000
20200212,707773,穩懋永豐96購01,0.96,1.30,0.96,1.22,+0.24,24.49,519000,23,624250,0,0,0,0,0,0,442000,499000,-57000,-57000
20200212,707774,大宇資國票97購01,,,,,,0.00,0,0,0,0,0,0,0,0,0,0,0,0,0
20200212,707775,良維國票97購02,,,,,,0.00,0,0,0,0,0,0,0,0,0,0,0,0,0
20200212,707776,宜鼎國票97購01,5.95,5.95,5.80,5.80,+0.30,5.45,7000,3,41350,0,0,0,0,0,0,3000,4000,-1000,-1000
20200212,707777,金居國票97購01,0.45,0.49,0.45,0.47,+0.02,4.44,270000,7,125950,0,0,0,0,0,0,105000,165000,-60000,-60000
20200212,707778,信昌電國票97購01,1.93,1.97,1.93,1.97,-0.03,-1.5,46000,4,89600,0,0,0,0,0,0,25000,21000,4000,4000
20200212,707779,保瑞國票97購01,1.62,1.62,1.56,1.56,+0.04,2.63,53000,4,83420,0,0,0,0,0,0,24000,29000,-5000,-5000
20200212,707780,昇達科富邦98購01,0.61,0.63,0.61,0.62,+0.05,8.77,45000,5,27850,0,0,0,0,0,0,10000,45000,-35000,-35000
20200212,707781,宣德麥證96購01,0.61,0.67,0.60,0.67,+0.03,4.69,176000,17,112270,126000,50000,76000,0,0,0,126000,50000,76000,76000
20200212,707782,世界台新97購01,1.35,1.35,1.35,1.35,+0.12,9.76,34000,2,45900,0,0,0,0,0,0,0,34000,-34000,-34000
20200212,707783,泰博兆豐96購02,2.23,2.24,2.18,2.18,+0.06,2.83,250000,10,554470,0,0,0,0,0,0,77000,173000,-96000,-96000
20200212,707784,聚積康和96購01,0.60,0.60,0.60,0.60,+0.01,1.69,41000,1,24600,0,0,0,0,0,0,41000,0,41000,41000
20200212,707785,凡甲群益98購01,0.80,0.84,0.80,0.84,0.00,0.0,301000,22,247940,0,0,0,0,0,0,201000,191000,10000,10000
20200212,707786,中美晶群益96購01,3.65,3.89,3.65,3.89,+0.35,9.89,106000,6,402340,0,0,0,0,0,0,21000,85000,-64000,-64000
20200212,707787,合晶群益96購01,1.15,1.42,1.15,1.33,+0.28,26.67,381000,37,479530,0,0,0,0,0,0,40000,381000,-341000,-341000
20200212,707788,晶焱群益98購01,1.09,1.14,1.09,1.12,+0.10,9.8,74000,7,82970,0,0,0,0,0,0,31000,74000,-43000,-43000
20200212,707789,精測群益96購04,1.71,1.73,1.65,1.72,+0.09,5.52,160000,8,273300,0,0,0,0,0,0,120000,40000,80000,80000
20200212,707790,廣明群益96購01,,,,,,0.00,0,0,0,0,0,0,0,0,0,0,0,0,0
20200212,707791,聯亞群益96購02,,,,,,0.00,0,0,0,0,0,0,0,0,0,0,0,0,0
20200212,707792,鐿鈦群益97購01,0.52,0.56,0.52,0.55,+0.01,1.85,370000,4,202620,0,0,0,0,0,0,226000,144000,82000,82000
20200212,707793,中美晶元大96購02,1.19,1.35,1.16,1.22,+0.08,7.02,162000,13,198390,0,0,0,0,0,0,112000,87000,25000,25000
20200212,707794,世界元大96購03,1.87,1.96,1.87,1.96,+0.15,8.29,104000,7,200250,0,0,0,0,0,0,38000,69000,-31000,-31000
20200212,707795,精測元大96購02,2.95,3.04,2.88,2.99,+0.18,6.41,141000,25,421460,0,0,0,0,0,0,116000,123000,-7000,-7000
20200212,707796,聯亞元大96購02,2.06,2.10,2.02,2.02,+0.09,4.66,36000,5,73360,0,0,0,0,0,0,26000,26000,0,0
20200212,707797,鈊象元大96購04,3.61,3.61,3.35,3.40,-0.29,-7.86,18000,8,62950,0,0,0,0,0,0,1000,17000,-16000,-16000
20200212,707798,世界統一97購01,1.28,1.34,1.28,1.34,+0.11,8.94,75000,4,97460,0,0,0,0,0,0,8000,75000,-67000,-67000
20200212,707799,神盾統一98購01,1.17,1.24,1.15,1.21,+0.07,6.14,1470000,65,1778940,0,0,0,0,0,0,1115000,342000,773000,773000
20200212,707800,穩懋統一98購02,1.36,1.54,1.25,1.54,+0.22,16.67,828000,47,1177990,0,0,0,0,0,0,543000,96000,447000,447000
20200212,707801,鈊象統一97購02,,,,,,0.00,0,0,0,0,0,0,0,0,0,0,0,0,0
20200212,707802,宣德中信9A購01,0.54,0.58,0.54,0.58,+0.02,3.57,41000,2,22580,0,0,0,0,0,0,11000,30000,-19000,-19000
20200212,707803,中光電凱基96購01,0.34,0.34,0.34,0.34,+0.04,13.33,494000,5,167960,0,0,0,0,0,0,0,494000,-494000,-494000
20200212,707804,世界凱基96購02,0.30,0.35,0.30,0.35,+0.04,12.9,245000,4,80650,0,0,0,0,0,0,55000,190000,-135000,-135000
20200212,707805,旺矽凱基96購01,1.24,1.24,1.19,1.19,+0.06,5.31,220000,5,265280,0,0,0,0,0,0,70000,219000,-149000,-149000
20200212,707806,信昌電凱基97購02,,,,,,0.00,0,0,0,0,0,0,0,0,0,0,0,0,0
20200212,707807,佳邦國票97購01,0.81,0.93,0.81,0.93,+0.07,8.14,143000,8,127150,0,0,0,0,0,0,28000,115000,-87000,-87000
20200212,707808,優群國票98購01,0.61,0.61,0.61,0.61,+0.04,7.02,101000,2,61610,0,0,0,0,0,0,63000,38000,25000,25000
20200212,707809,中美晶國泰97購01,1.84,2.05,1.80,1.88,+0.01,0.53,2615000,44,5057290,0,0,0,0,0,0,1469000,1081000,388000,388000
20200212,707810,穩懋麥證96購01,1.45,1.67,1.43,1.67,+0.25,17.61,345000,29,534940,126000,219000,-93000,0,0,0,153000,236000,-83000,-83000
20200212,707811,世界元富96購01,1.48,1.55,1.48,1.55,+0.14,9.93,54000,8,81040,0,0,0,0,0,0,26000,49000,-23000,-23000
20200212,707812,茂達元富96購01,,,,,,0.00,0,0,0,0,0,0,0,0,0,0,0,0,0
20200212,707813,群聯元富96購02,3.04,3.04,3.04,3.04,+0.51,20.16,4000,1,12160,0,0,0,0,0,0,0,4000,-4000,-4000
20200212,707814,穩懋富邦98購01,1.00,1.21,0.97,1.16,+0.19,19.59,4302000,131,4494050,0,0,0,0,0,0,1700000,2605000,-905000,-905000
20200212,707815,中美晶台新97購01,1.46,1.46,1.46,1.46,+0.11,8.15,34000,2,49640,0,0,0,0,0,0,0,34000,-34000,-34000
20200212,707816,良維台新97購01,0.88,0.94,0.87,0.94,+0.04,4.44,331000,13,298390,0,0,0,0,0,0,114000,217000,-103000,-103000
20200212,707817,閎康台新96購01,0.67,0.67,0.67,0.67,0.00,0.0,14000,1,9380,0,0,0,0,0,0,14000,0,14000,14000
20200212,707818,群聯台新97購02,2.47,2.57,2.47,2.57,+0.16,6.64,9000,2,22530,0,0,0,0,0,0,0,9000,-9000,-9000
20200212,707819,碩禾台新97購01,1.57,1.62,1.55,1.58,-0.02,-1.25,226000,14,357000,0,0,0,0,0,0,89000,137000,-48000,-48000
20200212,707820,世界康和96購01,,,,,,0.00,0,0,0,0,0,0,0,0,0,0,0,0,0
20200212,707821,凡甲群益96購01,1.10,1.18,1.10,1.12,-0.09,-7.44,274000,16,314010,0,0,0,0,0,0,244000,100000,144000,144000
20200212,707822,中美晶群益96購02,3.96,3.96,3.43,3.43,+0.08,2.39,45000,4,172770,0,0,0,0,0,0,0,32000,-32000,-32000
20200212,707823,宜鼎群益97購01,3.27,3.31,3.05,3.09,+0.04,1.31,502000,28,1580670,0,0,0,0,0,0,456000,58000,398000,398000
20200212,707824,環球晶群益96購01,2.74,2.94,2.72,2.90,+0.23,8.61,145000,14,411090,0,0,0,0,0,0,81000,55000,26000,26000
20200212,707825,鈊象群益99購03,,,,,,0.00,0,0,0,0,0,0,0,0,0,0,0,0,0
20200212,707826,大江永豐96購02,,,,,,0.00,0,0,0,0,0,0,0,0,0,0,0,0,0
20200212,707827,世界永豐96購03,0.50,0.52,0.50,0.52,+0.04,8.33,20000,2,10200,0,0,0,0,0,0,10000,10000,0,0
20200212,707828,合晶永豐96購01,0.40,0.43,0.40,0.43,+0.13,43.33,105000,2,43800,0,0,0,0,0,0,0,105000,-105000,-105000
20200212,707829,博智永豐96購01,2.05,2.25,1.99,2.08,+0.11,5.58,521000,52,1089090,0,0,0,0,0,0,264000,197000,67000,67000
20200212,707830,網龍永豐96購01,0.83,0.83,0.83,0.83,-0.04,-4.6,385000,7,319550,0,0,0,0,0,0,0,385000,-385000,-385000
20200212,707831,雙美永豐97購01,0.60,0.60,0.60,0.60,+0.17,39.53,1000,1,600,0,0,0,0,0,0,0,0,0,0
20200212,707832,精測兆豐97購02,1.25,1.28,1.24,1.27,+0.08,6.72,437000,17,549770,0,0,0,0,0,0,326000,111000,215000,215000
20200212,707833,網龍兆豐97購01,1.23,1.24,1.23,1.23,-0.02,-1.6,125000,8,153840,0,0,0,0,0,0,100000,25000,75000,75000
20200212,707834,晟德兆豐97購01,0.69,0.69,0.69,0.69,+0.01,1.47,15000,1,10350,0,0,0,0,0,0,0,15000,-15000,-15000
20200212,707835,原相康和96購01,2.38,2.38,2.38,2.38,+0.33,16.1,1000,1,2380,0,0,0,0,0,0,1000,0,1000,1000
20200212,707836,力旺永豐96購01,0.44,0.44,0.44,0.44,-0.01,-2.22,10000,3,4400,0,0,0,0,0,0,10000,0,10000,10000
20200212,707837,良維永豐96購02,,,,,,0.00,0,0,0,0,0,0,0,0,0,0,0,0,0
20200212,707838,佳邦永豐96購01,0.81,0.93,0.81,0.93,+0.11,13.41,444000,13,386990,0,0,0,0,0,0,0,444000,-444000,-444000
20200212,707839,建榮永豐97購01,0.86,0.86,0.86,0.86,-0.03,-3.37,11000,1,9460,0,0,0,0,0,0,11000,0,11000,11000
20200212,707840,晶焱永豐97購01,0.78,0.78,0.78,0.78,+0.10,14.71,58000,1,45240,0,0,0,0,0,0,0,58000,-58000,-58000
20200212,707841,智崴永豐96購01,,,,,,0.00,0,0,0,0,0,0,0,0,0,0,0,0,0
20200212,707842,精測永豐96購08,0.61,0.63,0.61,0.63,+0.06,10.53,80000,4,49200,0,0,0,0,0,0,80000,0,80000,80000
20200212,707843,鈊象永豐96購04,,,,,,0.00,0,0,0,0,0,0,0,0,0,0,0,0,0
20200212,707844,中美晶元大97購01,2.63,2.63,2.63,2.63,+0.10,3.95,11000,2,28930,0,0,0,0,0,0,11000,0,11000,11000
20200212,707845,台半元大96購01,1.08,1.08,1.07,1.08,-0.07,-6.09,113000,4,121880,0,0,0,0,0,0,113000,72000,41000,41000
20200212,707846,杰力元大96購03,0.70,0.75,0.70,0.73,+0.04,5.8,373000,22,267810,0,0,0,0,0,0,195000,178000,17000,17000
20200212,707847,宣德元大96購04,1.53,1.71,1.51,1.68,-0.01,-0.59,585000,43,949570,0,0,0,0,0,0,580000,0,580000,580000
20200212,707848,精測元大96購03,1.29,1.31,1.25,1.31,+0.09,7.38,78000,10,101070,0,0,0,0,0,0,17000,72000,-55000,-55000
20200212,707849,雙鴻元大99購01,0.72,0.82,0.72,0.80,+0.07,9.59,762000,26,597520,0,0,0,0,0,0,571000,191000,380000,380000
20200212,707850,鈊象元大97購03,4.43,4.43,3.96,3.99,-0.41,-9.32,90000,22,371490,0,0,0,0,0,0,5000,89000,-84000,-84000
20200212,707851,群聯麥證96購01,2.20,2.23,2.13,2.19,+0.07,3.3,290000,11,633800,110000,180000,-70000,0,0,0,110000,180000,-70000,-70000
20200212,707852,環球晶麥證96購01,,,,,,0.00,0,0,0,0,0,0,0,0,0,0,0,0,0
20200212,707853,雙鴻麥證97購01,0.38,0.45,0.38,0.43,+0.01,2.38,186000,37,78250,104000,82000,22000,0,0,0,104000,82000,22000,22000
20200212,707854,合晶台新96購01,0.68,0.71,0.68,0.71,+0.10,16.39,111000,3,77460,0,0,0,0,0,0,0,111000,-111000,-111000
20200212,707855,良維台新97購02,0.60,0.62,0.60,0.62,+0.02,3.33,97000,2,58940,0,0,0,0,0,0,0,97000,-97000,-97000
20200212,707856,神盾台新97購01,0.81,0.87,0.81,0.87,+0.08,10.13,235000,25,196790,0,0,0,0,0,0,235000,0,235000,235000
20200212,707857,新普台新97購01,1.88,1.97,1.88,1.97,+0.21,11.93,125000,9,238090,0,0,0,0,0,0,77000,48000,29000,29000
20200212,707858,穩懋台新97購01,2.12,2.39,2.12,2.39,+0.35,17.16,49000,5,110400,0,0,0,0,0,0,23000,26000,-3000,-3000
20200212,707859,中美晶國票97購01,2.66,2.98,2.66,2.66,+0.18,7.26,104000,7,294800,0,0,0,0,0,0,0,104000,-104000,-104000
20200212,707860,同致國票97購02,,,,,,0.00,0,0,0,0,0,0,0,0,0,0,0,0,0
20200212,707861,東隆興國票96購01,0.83,0.89,0.83,0.89,+0.11,14.1,469000,11,394470,0,0,0,0,0,0,110000,359000,-249000,-249000
20200212,707862,茂達國票97購01,0.91,0.94,0.90,0.94,+0.06,6.82,23000,4,21050,0,0,0,0,0,0,23000,0,23000,23000
20200212,707863,穩懋國票97購01,2.25,2.73,2.18,2.62,+0.42,19.09,287000,19,681240,0,0,0,0,0,0,257000,99000,158000,158000
20200212,707864,M31凱基98購01,0.52,0.53,0.52,0.53,+0.04,8.16,52000,2,27060,0,0,0,0,0,0,0,52000,-52000,-52000
20200212,707865,中美晶凱基96購03,1.04,1.17,1.04,1.07,+0.10,10.31,215000,9,241410,0,0,0,0,0,0,0,215000,-215000,-215000
20200212,707866,合晶凱基96購01,0.85,0.85,0.83,0.84,+0.20,31.25,40000,4,33600,0,0,0,0,0,0,0,40000,-40000,-40000
20200212,707867,宣德凱基96購02,0.43,0.43,0.41,0.41,-0.07,-14.58,90000,8,38440,0,0,0,0,0,0,90000,0,90000,90000
20200212,707868,碩禾凱基97購01,1.35,1.35,1.30,1.30,-0.03,-2.26,15000,2,20000,0,0,0,0,0,0,0,15000,-15000,-15000
20200212,707869,精測凱基96購07,0.74,0.74,0.74,0.74,+0.04,5.71,10000,1,7400,0,0,0,0,0,0,10000,0,10000,10000
20200212,707870,聯亞凱基97購01,1.04,1.06,1.04,1.06,+0.10,10.42,110000,2,116400,0,0,0,0,0,0,100000,10000,90000,90000
20200212,707871,精測國泰97購02,1.60,1.69,1.60,1.68,+0.11,7.01,234000,18,386460,0,0,0,0,0,0,89000,175000,-86000,-86000
20200212,707872,精測國泰98購03,1.65,1.68,1.57,1.65,+0.10,6.45,350000,18,575610,0,0,0,0,0,0,124000,220000,-96000,-96000
20200212,707873,鈺太國泰98購01,0.78,0.89,0.78,0.89,+0.20,28.99,51000,5,41190,0,0,0,0,0,0,11000,10000,1000,1000
20200212,707874,世界富邦98購01,0.76,0.77,0.76,0.77,+0.07,10.0,298000,3,227480,0,0,0,0,0,0,0,298000,-298000,-298000
20200212,707875,世界群益98購01,1.61,1.68,1.61,1.68,+0.13,8.39,42000,6,69370,0,0,0,0,0,0,21000,41000,-20000,-20000
20200212,707876,世界群益98購02,1.66,1.70,1.66,1.70,+0.13,8.28,33000,3,55440,0,0,0,0,0,0,0,33000,-33000,-33000
20200212,707877,迅得群益97購02,0.98,1.06,0.98,1.06,+0.14,15.22,269000,9,270290,0,0,0,0,0,0,169000,100000,69000,69000
20200212,707878,信昌電群益96購01,0.99,0.99,0.97,0.97,-0.10,-9.35,243000,3,236590,0,0,0,0,0,0,243000,199000,44000,44000
20200212,707879,宣德群益96購02,1.24,1.38,1.23,1.38,-0.02,-1.43,446000,23,590060,0,0,0,0,0,0,363000,143000,220000,220000
20200212,707880,建榮群益97購01,,,,,,0.00,0,0,0,0,0,0,0,0,0,0,0,0,0
20200212,707881,璟德群益97購01,3.09,3.41,3.07,3.23,-0.04,-1.22,447000,28,1462480,0,0,0,0,0,0,402000,47000,355000,355000
20200212,707882,環球晶群益97購01,3.84,4.10,3.78,4.02,+0.30,8.06,276000,18,1109070,0,0,0,0,0,0,42000,246000,-204000,-204000
20200212,707883,力旺元大97購01,1.50,1.61,1.48,1.61,+0.08,5.23,200000,13,304100,0,0,0,0,0,0,150000,63000,87000,87000
20200212,707884,中美晶元大97購02,2.58,2.79,2.58,2.58,-0.02,-0.77,166000,22,441530,0,0,0,0,0,0,100000,126000,-26000,-26000
20200212,707885,台燿元大96購01,1.30,1.50,1.30,1.50,+0.28,22.95,225000,7,303850,0,0,0,0,0,0,99000,126000,-27000,-27000
20200212,707886,旺矽元大99購01,0.95,0.95,0.95,0.95,+0.04,4.4,100000,1,95000,0,0,0,0,0,0,0,100000,-100000,-100000
20200212,707887,晶焱元大97購02,0.64,0.69,0.64,0.68,+0.07,11.48,287000,12,195170,0,0,0,0,0,0,56000,277000,-221000,-221000
20200212,707888,精測元大97購02,1.17,1.21,1.15,1.20,+0.09,8.11,153000,11,179290,0,0,0,0,0,0,53000,153000,-100000,-100000
20200212,707889,璟德元大96購02,1.63,1.75,1.58,1.65,-0.04,-2.37,962000,49,1607810,0,0,0,0,0,0,822000,156000,666000,666000
20200212,707890,穩懋元大96購04,2.94,3.60,2.83,3.41,+0.56,19.65,536000,96,1666840,0,0,0,0,0,0,498000,466000,32000,32000
20200212,707891,力旺凱基96購01,0.64,0.68,0.64,0.68,+0.05,7.94,30000,3,20000,0,0,0,0,0,0,0,30000,-30000,-30000
20200212,707892,大江凱基96購02,,,,,,0.00,0,0,0,0,0,0,0,0,0,0,0,0,0
20200212,707893,保瑞凱基96購01,0.79,0.79,0.79,0.79,+0.03,3.95,12000,1,9480,0,0,0,0,0,0,12000,0,12000,12000
20200212,707894,璟德凱基96購02,0.93,1.04,0.93,1.02,0.00,0.0,51000,16,49840,0,0,0,0,0,0,51000,0,51000,51000
20200212,707895,穩懋凱基96購09,1.43,1.81,1.43,1.76,+0.32,22.22,132000,20,219940,0,0,0,0,0,0,87000,82000,5000,5000
20200212,707896,中美晶統一96購01,1.73,1.89,1.73,1.86,+0.16,9.41,72000,4,135770,0,0,0,0,0,0,1000,71000,-70000,-70000
20200212,707897,昂寶統一97購01,,,,,,0.00,0,0,0,0,0,0,0,0,0,0,0,0,0
20200212,707898,台燿兆豐97購01,0.72,0.78,0.72,0.78,+0.11,16.42,450000,21,336540,0,0,0,0,0,0,183000,273000,-90000,-90000
20200212,707899,威剛群益96購01,9.20,9.60,9.20,9.50,+0.60,6.74,17000,3,161000,0,0,0,0,0,0,0,17000,-17000,-17000
20200212,707900,宣德群益96購03,0.69,0.74,0.68,0.74,-0.04,-5.13,134000,14,95390,0,0,0,0,0,0,134000,0,134000,134000
20200212,707901,精測群益96購05,0.81,0.83,0.80,0.81,+0.06,8.0,592000,9,480070,0,0,0,0,0,0,71000,520000,-449000,-449000
20200212,707902,鈊象群益98購01,3.80,3.80,3.42,3.48,-0.37,-9.61,126000,17,467270,0,0,0,0,0,0,102000,26000,76000,76000
20200212,707903,M31永豐96購01,1.01,1.02,1.00,1.00,+0.04,4.17,130000,5,131440,0,0,0,0,0,0,62000,68000,-6000,-6000
20200212,707904,金居永豐96購01,0.32,0.32,0.32,0.32,+0.05,18.52,58000,1,18560,0,0,0,0,0,0,0,58000,-58000,-58000
20200212,707905,宣德永豐96購01,0.49,0.50,0.48,0.48,-0.09,-15.79,20000,8,9840,0,0,0,0,0,0,20000,0,20000,20000
20200212,707906,精測永豐96購09,0.84,0.89,0.84,0.89,+0.08,9.88,4000,2,3410,0,0,0,0,0,0,4000,4000,0,0
20200212,707907,璟德永豐96購02,0.69,0.73,0.68,0.72,-0.01,-1.37,260000,14,184760,0,0,0,0,0,0,200000,60000,140000,140000
20200212,707908,優群永豐96購02,0.47,0.47,0.47,0.47,+0.03,6.82,3000,1,1410,0,0,0,0,0,0,0,3000,-3000,-3000
20200212,707909,凡甲台新96購01,,,,,,0.00,0,0,0,0,0,0,0,0,0,0,0,0,0
20200212,707910,力旺國票97購01,1.06,1.23,1.04,1.21,+0.09,8.04,478000,11,569220,0,0,0,0,0,0,45000,423000,-378000,-378000
20200212,707911,杰力國票97購02,1.15,1.21,1.15,1.17,+0.03,2.63,160000,6,192720,0,0,0,0,0,0,7000,153000,-146000,-146000
20200212,707912,聚積國票97購01,1.86,1.94,1.86,1.94,+0.14,7.78,205000,12,391540,0,0,0,0,0,0,139000,66000,73000,73000
20200212,707913,鈊象國票97購01,10.10,10.10,8.85,8.85,-1.10,-11.06,61000,12,581600,0,0,0,0,0,0,60000,4000,56000,56000
20200212,707914,環球晶國泰97購01,4.39,4.39,4.39,4.39,+0.24,5.78,15000,1,65850,0,0,0,0,0,0,15000,0,15000,15000
20200212,707915,中美晶富邦97購02,0.74,0.74,0.74,0.74,+0.04,5.71,1000,1,740,0,0,0,0,0,0,1000,0,1000,1000
20200212,707916,聯亞富邦98購01,1.04,1.05,0.99,0.99,+0.03,3.12,1275000,33,1308720,0,0,0,0,0,0,292000,976000,-684000,-684000
20200212,707917,中美晶麥證96購01,1.68,1.85,1.68,1.83,+0.19,11.59,304000,20,532250,40000,264000,-224000,0,0,0,73000,264000,-191000,-191000
20200212,707918,合晶麥證96購01,0.76,0.92,0.76,0.92,+0.21,29.58,150000,17,124500,10000,140000,-130000,0,0,0,10000,140000,-130000,-130000
20200212,707919,櫃200第一96購03,,,,,,0.00,0,0,0,0,0,0,0,0,0,0,0,0,0
20200212,707920,櫃200第一96購04,,,,,,0.00,0,0,0,0,0,0,0,0,0,0,0,0,0
20200212,707921,譜瑞兆豐96購01,2.80,3.07,2.80,2.95,+0.35,13.46,713000,25,2094010,0,0,0,0,0,0,674000,33000,641000,641000
20200212,707922,雍智康和96購01,0.64,0.69,0.64,0.69,+0.05,7.81,90000,8,60570,0,0,0,0,0,0,12000,78000,-66000,-66000
20200212,707923,力旺群益97購01,1.00,1.10,1.00,1.08,+0.04,3.85,403000,16,421290,0,0,0,0,0,0,180000,295000,-115000,-115000
20200212,707924,中美晶群益97購01,0.96,1.08,0.93,0.95,+0.01,1.06,2827000,162,2840070,0,0,0,0,0,0,1339000,1789000,-450000,-450000
20200212,707925,信驊群益96購01,2.92,2.95,2.82,2.86,-0.03,-1.04,73000,9,210670,0,0,0,0,0,0,45000,37000,8000,8000
20200212,707926,雍智群益96購01,0.83,0.95,0.83,0.93,+0.12,14.81,679000,16,605630,0,0,0,0,0,0,139000,540000,-401000,-401000
20200212,707927,碩禾群益97購01,1.59,1.68,1.55,1.62,+0.03,1.89,243000,14,389740,0,0,0,0,0,0,149000,120000,29000,29000
20200212,707928,環球晶群益97購02,5.20,5.50,5.15,5.45,+0.35,6.86,87000,19,460250,0,0,0,0,0,0,73000,77000,-4000,-4000
20200212,707929,凡甲元大98購01,0.74,0.76,0.74,0.76,+0.01,1.33,85000,7,63520,0,0,0,0,0,0,52000,85000,-33000,-33000
20200212,707930,雍智元大97購01,1.99,2.20,1.99,2.15,+0.19,9.69,248000,14,513900,0,0,0,0,0,0,122000,176000,-54000,-54000
20200212,707931,力旺統一96購01,0.85,0.91,0.84,0.90,+0.04,4.65,166000,9,147240,0,0,0,0,0,0,136000,30000,106000,106000
20200212,707932,雍智統一97購01,0.85,0.89,0.85,0.89,+0.05,5.95,378000,16,331540,0,0,0,0,0,0,358000,10000,348000,348000
20200212,707933,新普中信96購01,1.26,1.32,1.25,1.29,+0.08,6.61,270000,14,350540,0,0,0,0,0,0,84000,194000,-110000,-110000
20200212,707934,雍智中信96購01,0.55,0.55,0.55,0.55,+0.01,1.85,3000,1,1650,0,0,0,0,0,0,0,3000,-3000,-3000
20200212,707935,大江國票97購03,0.21,0.23,0.20,0.23,-0.01,-4.17,260000,6,58570,0,0,0,0,0,0,60000,200000,-140000,-140000
20200212,707936,世界國票97購02,2.00,2.12,2.00,2.12,+0.18,9.28,55000,11,114010,0,0,0,0,0,0,30000,25000,5000,5000
20200212,707937,雍智國票96購01,2.16,2.51,2.16,2.34,+0.16,7.34,302000,18,683260,0,0,0,0,0,0,237000,65000,172000,172000
20200212,707938,雙鴻國票97購01,0.31,0.36,0.31,0.35,+0.03,9.38,320000,25,110510,0,0,0,0,0,0,270000,50000,220000,220000
20200212,707939,鈺太國票97購01,0.85,1.06,0.85,1.06,+0.22,26.19,222000,9,210910,0,0,0,0,0,0,0,222000,-222000,-222000
20200212,707940,弘塑凱基97購01,1.34,1.35,1.34,1.35,+0.05,3.85,20000,2,26900,0,0,0,0,0,0,0,20000,-20000,-20000
20200212,707941,同致凱基97購01,0.45,0.45,0.45,0.45,+0.01,2.27,80000,1,36000,0,0,0,0,0,0,80000,0,80000,80000
20200212,707942,神盾凱基98購01,0.69,0.71,0.68,0.70,+0.05,7.69,60000,12,41830,0,0,0,0,0,0,40000,20000,20000,20000
20200212,707943,雍智凱基96購01,0.94,1.05,0.94,1.00,+0.07,7.53,119000,5,113210,0,0,0,0,0,0,59000,60000,-1000,-1000
20200212,707944,廣明凱基96購01,,,,,,0.00,0,0,0,0,0,0,0,0,0,0,0,0,0
20200212,707945,環球晶凱基96購05,2.07,2.20,2.07,2.20,+0.16,7.84,206000,11,446950,0,0,0,0,0,0,136000,71000,65000,65000
20200212,707946,鈊象凱基96購03,,,,,,0.00,0,0,0,0,0,0,0,0,0,0,0,0,0
20200212,707947,力旺麥證96購01,0.72,0.79,0.72,0.79,+0.04,5.33,182000,11,135950,71000,111000,-40000,0,0,0,71000,111000,-40000,-40000
20200212,707948,威剛國泰97購01,5.05,5.35,5.05,5.35,+0.40,8.08,317000,32,1622750,0,0,0,0,0,0,253000,51000,202000,202000
20200212,707949,群聯國泰98購01,1.88,1.92,1.88,1.88,+0.13,7.43,255000,16,480880,0,0,0,0,0,0,40000,255000,-215000,-215000
20200212,707950,雍智國泰98購01,1.59,1.75,1.58,1.66,+0.10,6.41,658000,25,1081750,0,0,0,0,0,0,87000,571000,-484000,-484000
20200212,707951,精測元富99購01,1.01,1.01,1.01,1.01,+0.01,1.0,50000,1,50500,0,0,0,0,0,0,0,50000,-50000,-50000
20200212,707952,聯亞元富96購02,1.73,1.73,1.64,1.64,+0.07,4.46,36000,4,61040,0,0,0,0,0,0,36000,26000,10000,10000
20200212,707953,力旺台新97購01,0.97,1.04,0.97,1.03,+0.04,4.04,493000,13,493290,0,0,0,0,0,0,143000,350000,-207000,-207000
20200212,707954,世界台新97購02,1.75,1.87,1.75,1.87,+0.15,8.72,59000,3,104870,0,0,0,0,0,0,9000,50000,-41000,-41000
20200212,707955,櫃200永昌97購01,,,,,,0.00,0,0,0,0,0,0,0,0,0,0,0,0,0
20200212,707956,櫃200永昌99購01,,,,,,0.00,0,0,0,0,0,0,0,0,0,0,0,0,0
20200212,707957,櫃200永昌99購02,,,,,,0.00,0,0,0,0,0,0,0,0,0,0,0,0,0
20200212,707958,櫃200永昌99購03,,,,,,0.00,0,0,0,0,0,0,0,0,0,0,0,0,0
20200212,707959,久元永豐96購01,0.89,0.90,0.89,0.90,+0.05,5.88,174000,3,155440,0,0,0,0,0,0,0,174000,-174000,-174000
20200212,707960,立端永豐96購01,0.89,1.07,0.89,1.07,+0.28,35.44,227000,14,218790,0,0,0,0,0,0,0,227000,-227000,-227000
20200212,707961,良維永豐96購03,0.75,0.82,0.75,0.82,+0.05,6.49,94000,4,73840,0,0,0,0,0,0,27000,67000,-40000,-40000
20200212,707962,宜鼎永豐96購01,1.74,1.74,1.57,1.57,-0.04,-2.48,120000,7,205050,0,0,0,0,0,0,107000,13000,94000,94000
20200212,707963,皇田永豐96購01,0.76,0.77,0.76,0.77,+0.03,4.05,2000,2,1530,0,0,0,0,0,0,0,2000,-2000,-2000
20200212,707964,美琪瑪永豐96購01,0.95,0.95,0.95,0.95,-0.02,-2.06,48000,2,45600,0,0,0,0,0,0,48000,0,48000,48000
20200212,707965,雍智永豐96購01,0.76,0.85,0.76,0.85,+0.10,13.33,395000,9,310830,0,0,0,0,0,0,77000,318000,-241000,-241000
20200212,707966,穩懋統一96購08,1.76,2.04,1.72,2.04,+0.36,21.43,478000,33,890390,0,0,0,0,0,0,307000,171000,136000,136000
20200212,707967,穩懋統一96購09,1.94,2.48,1.94,2.33,+0.40,20.73,166000,37,345900,0,0,0,0,0,0,148000,51000,97000,97000
20200212,707968,穩懋統一96購10,2.29,2.46,2.23,2.46,+0.37,17.7,124000,10,293150,0,0,0,0,0,0,45000,79000,-34000,-34000
20200212,707969,穩懋統一97購03,1.80,2.15,1.71,2.06,+0.30,17.05,2133000,65,4010130,0,0,0,0,0,0,956000,1159000,-203000,-203000
20200212,707970,鈊象統一97購03,,,,,,0.00,0,0,0,0,0,0,0,0,0,0,0,0,0
20200212,707971,中美晶中信96購01,1.66,1.86,1.62,1.81,+0.17,10.37,309000,15,535340,0,0,0,0,0,0,104000,205000,-101000,-101000
20200212,707972,同致中信98購01,,,,,,0.00,0,0,0,0,0,0,0,0,0,0,0,0,0
20200212,707973,環球晶中信9C購01,1.50,1.54,1.50,1.54,+0.05,3.36,48000,6,72980,0,0,0,0,0,0,48000,0,48000,48000
20200212,707974,世界凱基96購03,,,,,,0.00,0,0,0,0,0,0,0,0,0,0,0,0,0
20200212,707975,金居凱基96購02,0.50,0.52,0.49,0.49,+0.04,8.89,95000,4,47650,0,0,0,0,0,0,80000,15000,65000,65000
20200212,707976,環球晶凱基96購06,6.20,6.50,6.20,6.50,+0.50,8.33,17000,5,107350,0,0,0,0,0,0,17000,8000,9000,9000
20200212,707977,穩懋凱基96購10,2.66,3.27,0.85,3.27,+0.64,24.33,122000,28,320760,0,0,0,0,0,0,83000,52000,31000,31000
20200212,707978,大江群益97購01,0.23,0.23,0.20,0.23,+0.01,4.55,264000,23,59520,0,0,0,0,0,0,23000,241000,-218000,-218000
20200212,707979,原相群益98購01,3.13,3.51,3.01,3.22,-0.03,-0.92,799000,103,2519660,0,0,0,0,0,0,558000,228000,330000,330000
20200212,707980,弘塑國票97購01,3.18,3.25,3.12,3.25,+0.17,5.52,752000,22,2390850,0,0,0,0,0,0,378000,367000,11000,11000
20200212,707981,宜鼎國票97購02,6.95,6.95,6.55,6.55,+0.55,9.17,46000,5,308650,0,0,0,0,0,0,23000,23000,0,0
20200212,707982,昂寶國票97購03,,,,,,0.00,0,0,0,0,0,0,0,0,0,0,0,0,0
20200212,707983,環球晶國票97購01,5.80,5.80,5.80,5.80,+0.40,7.41,2000,1,11600,0,0,0,0,0,0,0,2000,-2000,-2000
20200212,707984,緯軟國泰97購01,0.83,0.88,0.83,0.88,+0.05,6.02,470000,14,397900,0,0,0,0,0,0,448000,30000,418000,418000
20200212,707985,櫃200永昌9B購01,,,,,,0.00,0,0,0,0,0,0,0,0,0,0,0,0,0
20200212,707986,櫃200永昌9C購01,,,,,,0.00,0,0,0,0,0,0,0,0,0,0,0,0,0
20200212,707987,櫃200永昌9C購02,,,,,,0.00,0,0,0,0,0,0,0,0,0,0,0,0,0
20200212,707988,櫃200永昌9C購03,,,,,,0.00,0,0,0,0,0,0,0,0,0,0,0,0,0
20200212,707989,大宇資第一96購01,,,,,,0.00,0,0,0,0,0,0,0,0,0,0,0,0,0
20200212,707990,凡甲永豐96購01,,,,,,0.00,0,0,0,0,0,0,0,0,0,0,0,0,0
20200212,707991,弘塑永豐96購01,1.15,1.22,1.15,1.22,+0.08,7.02,586000,13,697400,0,0,0,0,0,0,0,586000,-586000,-586000
20200212,707992,昇達科永豐96購01,0.57,0.58,0.55,0.55,+0.02,3.77,30000,3,17000,0,0,0,0,0,0,10000,20000,-10000,-10000
20200212,707993,波若威永豐97購01,,,,,,0.00,0,0,0,0,0,0,0,0,0,0,0,0,0
20200212,707994,威剛永豐96購02,2.30,2.57,2.22,2.42,+0.19,8.52,985000,64,2447150,0,0,0,0,0,0,763000,304000,459000,459000
20200212,707995,原相永豐96購01,1.26,1.42,1.21,1.30,-0.03,-2.26,1095000,62,1412180,0,0,0,0,0,0,829000,289000,540000,540000
20200212,707996,神盾永豐96購01,0.91,1.00,0.90,0.95,+0.07,7.95,210000,27,195950,0,0,0,0,0,0,159000,58000,101000,101000
20200212,707997,網龍永豐96購02,1.47,1.47,1.47,1.47,0.00,0.0,48000,4,70560,0,0,0,0,0,0,46000,2000,44000,44000
20200212,707998,廣明永豐96購02,0.38,0.43,0.37,0.43,+0.05,13.16,151000,3,57160,0,0,0,0,0,0,150000,1000,149000,149000
20200212,707999,聯亞永豐96購01,1.75,1.80,1.70,1.70,+0.08,4.94,111000,9,194420,0,0,0,0,0,0,111000,58000,53000,53000
20200212,708000,雙鴻永豐97購01,0.31,0.31,0.31,0.31,+0.03,10.71,45000,1,13950,0,0,0,0,0,0,0,45000,-45000,-45000
20200212,708001,世界元大96購05,1.37,1.48,1.37,1.46,+0.11,8.15,335000,27,483280,0,0,0,0,0,0,109000,261000,-152000,-152000
20200212,708002,合晶元大97購02,0.50,0.63,0.50,0.61,+0.14,29.79,2063000,14,1242050,0,0,0,0,0,0,30000,2033000,-2003000,-2003000
20200212,708003,宜鼎元大96購01,2.94,2.97,2.62,2.73,-0.02,-0.73,108000,20,307310,0,0,0,0,0,0,89000,33000,56000,56000
20200212,708004,雍智元大97購02,1.13,1.22,1.12,1.16,+0.04,3.57,857000,41,1010630,0,0,0,0,0,0,418000,713000,-295000,-295000
20200212,708005,精測元大97購03,1.29,1.30,1.24,1.30,+0.10,8.33,86000,10,110520,0,0,0,0,0,0,12000,86000,-74000,-74000
20200212,708006,精華元大96購03,0.73,0.75,0.73,0.75,+0.02,2.74,372000,8,274230,0,0,0,0,0,0,68000,352000,-284000,-284000
20200212,708007,雍智元富96購01,1.24,1.41,1.24,1.38,+0.15,12.2,255000,12,342200,0,0,0,0,0,0,20000,235000,-215000,-215000
20200212,708008,精測元富96購03,1.04,1.06,1.04,1.06,+0.17,19.1,101000,3,106060,0,0,0,0,0,0,6000,95000,-89000,-89000
20200212,708009,精測台新96購01,0.54,0.56,0.52,0.55,+0.04,7.84,90000,6,48600,0,0,0,0,0,0,90000,0,90000,90000
20200212,708010,璟德台新96購01,1.75,1.75,1.75,1.75,-0.01,-0.57,4000,1,7000,0,0,0,0,0,0,0,4000,-4000,-4000
20200212,708011,良維兆豐97購01,1.81,1.88,1.81,1.88,+0.07,3.87,83000,5,154940,0,0,0,0,0,0,10000,73000,-63000,-63000
20200212,708012,聚積兆豐97購01,1.79,1.80,1.78,1.79,+0.08,4.68,80000,8,143400,0,0,0,0,0,0,40000,40000,0,0
20200212,708013,廣明兆豐96購01,0.92,0.96,0.92,0.96,+0.01,1.05,159000,4,148100,0,0,0,0,0,0,100000,59000,41000,41000
20200212,708014,聯亞兆豐97購01,3.10,3.11,3.09,3.11,+0.20,6.87,30000,3,93000,0,0,0,0,0,0,20000,10000,10000,10000
20200212,708015,鈺太康和96購01,0.70,0.88,0.70,0.88,+0.18,25.71,395000,13,311550,0,0,0,0,0,0,46000,349000,-303000,-303000
20200212,708016,新普群益98購02,1.90,1.95,1.79,1.95,+0.26,15.38,65000,12,121190,0,0,0,0,0,0,23000,55000,-32000,-32000
20200212,708017,精測群益96購06,,,,,,0.00,0,0,0,0,0,0,0,0,0,0,0,0,0
20200212,708018,雙鴻群益98購01,0.43,0.50,0.43,0.48,+0.04,9.09,284000,23,132130,0,0,0,0,0,0,128000,156000,-28000,-28000
20200212,708019,世界麥證96購01,1.86,1.95,1.82,1.95,+0.21,12.07,118000,11,221300,20000,98000,-78000,0,0,0,28000,98000,-70000,-70000
20200212,708020,世界元富96購02,,,,,,0.00,0,0,0,0,0,0,0,0,0,0,0,0,0
20200212,708021,勝麗元富96購01,0.68,0.74,0.67,0.67,+0.02,3.08,71000,9,50390,0,0,0,0,0,0,10000,61000,-51000,-51000
20200212,708022,璟德元富96購01,1.73,1.86,1.71,1.75,-0.04,-2.23,714000,35,1257220,0,0,0,0,0,0,663000,51000,612000,612000
20200212,708023,鈺太元富96購01,0.94,1.22,0.94,1.22,+0.35,40.23,132000,15,137290,0,0,0,0,0,0,0,132000,-132000,-132000
20200212,708024,金居中信9C購01,0.35,0.35,0.35,0.35,+0.02,6.06,80000,2,28000,0,0,0,0,0,0,30000,50000,-20000,-20000
20200212,708025,勝麗中信9A購01,0.58,0.66,0.58,0.64,+0.07,12.28,204000,13,124100,0,0,0,0,0,0,147000,57000,90000,90000
20200212,708026,群聯永豐96購01,0.75,0.77,0.75,0.77,+0.02,2.67,57000,3,43370,0,0,0,0,0,0,47000,10000,37000,37000
20200212,708027,精測永豐96購10,,,,,,0.00,0,0,0,0,0,0,0,0,0,0,0,0,0
20200212,708028,鈺太永豐96購01,0.65,0.86,0.65,0.86,+0.20,30.3,392000,24,297060,0,0,0,0,0,0,127000,284000,-157000,-157000
20200212,708029,旺矽國票97購01,0.58,0.58,0.58,0.58,+0.04,7.41,30000,1,17400,0,0,0,0,0,0,0,30000,-30000,-30000
20200212,708030,精華國票97購01,0.58,0.58,0.58,0.58,-0.01,-1.69,75000,1,43500,0,0,0,0,0,0,75000,0,75000,75000
20200212,708031,中美晶凱基96購04,3.02,3.11,3.02,3.11,+0.50,19.16,13000,6,39440,0,0,0,0,0,0,13000,13000,0,0
20200212,708032,六角凱基97購01,1.19,1.25,1.11,1.13,+0.02,1.8,399000,9,468190,0,0,0,0,0,0,187000,399000,-212000,-212000
20200212,708033,昂寶凱基97購01,1.43,1.43,1.43,1.43,+0.01,0.7,3000,1,4290,0,0,0,0,0,0,0,3000,-3000,-3000
20200212,708034,勝麗凱基96購01,2.15,2.50,2.15,2.37,+0.26,12.32,81000,12,196360,0,0,0,0,0,0,10000,71000,-61000,-61000
20200212,708035,博智凱基96購01,2.31,2.57,2.29,2.40,+0.22,10.09,81000,11,198590,0,0,0,0,0,0,29000,51000,-22000,-22000
20200212,708036,優群凱基98購01,0.50,0.50,0.50,0.50,+0.04,8.7,10000,1,5000,0,0,0,0,0,0,10000,0,10000,10000
20200212,708037,環球晶凱基96購07,3.85,4.10,3.85,4.06,+0.29,7.69,27000,7,105930,0,0,0,0,0,0,27000,7000,20000,20000
20200212,708038,穩懋凱基96購11,2.44,2.86,2.38,2.86,+0.50,21.19,60000,28,156340,0,0,0,0,0,0,60000,36000,24000,24000
20200212,708039,宣德國泰98購01,0.71,0.78,0.70,0.78,+0.04,5.41,551000,17,417620,0,0,0,0,0,0,161000,380000,-219000,-219000
20200212,708040,雍智國泰98購02,2.54,2.80,2.51,2.71,+0.25,10.16,646000,29,1678400,0,0,0,0,0,0,71000,575000,-504000,-504000
20200212,708041,精測國泰98購04,0.98,1.02,0.98,1.01,+0.06,6.32,121000,12,121330,0,0,0,0,0,0,30000,111000,-81000,-81000
20200212,708042,精測國泰99購01,0.99,1.01,0.99,1.01,+0.05,5.21,60000,6,60100,0,0,0,0,0,0,10000,50000,-40000,-40000
20200212,708043,精測國泰9A購01,0.98,1.01,0.97,1.01,+0.07,7.45,521000,22,522270,0,0,0,0,0,0,406000,110000,296000,296000
20200212,708044,雙鴻富邦97購02,0.22,0.22,0.22,0.22,+0.02,10.0,90000,2,19800,0,0,0,0,0,0,30000,60000,-30000,-30000
20200212,708045,大江元大97購02,0.48,0.48,0.44,0.45,+0.02,4.65,52000,5,23330,0,0,0,0,0,0,1000,51000,-50000,-50000
20200212,708046,中美晶元大96購03,1.33,1.48,1.33,1.33,+0.06,4.72,61000,3,88630,0,0,0,0,0,0,51000,60000,-9000,-9000
20200212,708047,世界元大96購06,2.06,2.23,2.06,2.23,+0.21,10.4,100000,13,215170,0,0,0,0,0,0,73000,75000,-2000,-2000
20200212,708048,合晶元大96購05,0.80,0.91,0.80,0.89,+0.18,25.35,337000,10,296520,0,0,0,0,0,0,95000,237000,-142000,-142000
20200212,708049,信驊元大96購01,1.16,1.16,1.13,1.14,+0.01,0.88,519000,13,596550,0,0,0,0,0,0,325000,174000,151000,151000
20200212,708050,雍智元大96購01,1.07,1.19,1.06,1.14,+0.10,9.62,513000,25,576360,0,0,0,0,0,0,68000,443000,-375000,-375000
20200212,708051,精測元大96購04,0.91,0.92,0.88,0.92,+0.08,9.52,63000,6,57820,0,0,0,0,0,0,12000,63000,-51000,-51000
20200212,708052,穩懋元大96購05,2.42,2.94,2.33,2.77,+0.43,18.38,630000,111,1598380,0,0,0,0,0,0,541000,484000,57000,57000
20200212,708053,鈺太元大97購02,1.30,1.60,1.30,1.60,+0.32,25.0,500000,22,709640,0,0,0,0,0,0,79000,432000,-353000,-353000
20200212,708054,力旺元富96購01,0.81,0.81,0.81,0.81,-0.01,-1.22,20000,2,16200,0,0,0,0,0,0,20000,0,20000,20000
20200212,708055,金可中信9A購01,,,,,,0.00,0,0,0,0,0,0,0,0,0,0,0,0,0
20200212,708056,聖暉統一99購01,0.47,0.47,0.47,0.47,0.00,0.0,5000,1,2350,0,0,0,0,0,0,5000,0,5000,5000
20200212,708057,大江凱基98購01,0.15,0.16,0.15,0.16,+0.02,14.29,60000,2,9400,0,0,0,0,0,0,20000,40000,-20000,-20000
20200212,708058,良維凱基98購01,,,,,,0.00,0,0,0,0,0,0,0,0,0,0,0,0,0
20200212,708059,旺矽凱基98購01,0.71,0.71,0.71,0.71,+0.06,9.23,20000,1,14200,0,0,0,0,0,0,0,20000,-20000,-20000
20200212,708060,信驊凱基96購02,0.78,0.78,0.78,0.78,-0.01,-1.27,64000,1,49920,0,0,0,0,0,0,0,64000,-64000,-64000
20200212,708061,雍智凱基98購01,,,,,,0.00,0,0,0,0,0,0,0,0,0,0,0,0,0
20200212,708062,精測凱基99購01,0.69,0.69,0.69,0.69,+0.04,6.15,100000,1,69000,0,0,0,0,0,0,0,100000,-100000,-100000
20200212,708063,緯軟凱基98購01,0.45,0.46,0.44,0.46,+0.03,6.98,211000,5,93460,0,0,0,0,0,0,210000,1000,209000,209000
20200212,708064,環球晶凱基96購08,2.81,2.95,2.81,2.95,+0.20,7.27,91000,6,261900,0,0,0,0,0,0,91000,6000,85000,85000
20200212,708065,力旺永豐96購02,0.96,1.04,0.94,1.04,+0.07,7.22,582000,21,582370,0,0,0,0,0,0,157000,496000,-339000,-339000
20200212,708066,同致永豐96購01,0.78,0.78,0.77,0.77,+0.04,5.48,74000,2,57660,0,0,0,0,0,0,6000,68000,-62000,-62000
20200212,708067,迅得永豐97購02,0.48,0.50,0.48,0.50,+0.04,8.7,16000,2,7880,0,0,0,0,0,0,16000,0,16000,16000
20200212,708068,欣銓永豐96購01,0.46,0.50,0.46,0.50,+0.03,6.38,130000,3,60900,0,0,0,0,0,0,110000,20000,90000,90000
20200212,708069,弘塑康和9C購01,1.00,1.01,0.99,1.01,+0.03,3.06,856000,26,857140,0,0,0,0,0,0,387000,457000,-70000,-70000
20200212,708070,大田群益96購01,0.78,0.79,0.77,0.77,+0.05,6.94,93000,7,72770,0,0,0,0,0,0,10000,83000,-73000,-73000
20200212,708071,合晶群益96購02,0.99,1.28,0.99,1.28,+0.32,33.33,284000,22,324910,0,0,0,0,0,0,50000,274000,-224000,-224000
20200212,708072,信昌電群益96購02,2.45,2.45,2.36,2.40,-0.09,-3.61,86000,9,206940,0,0,0,0,0,0,31000,65000,-34000,-34000
20200212,708073,茂達群益98購01,,,,,,0.00,0,0,0,0,0,0,0,0,0,0,0,0,0
20200212,708074,大宇資國票97購02,,,,,,0.00,0,0,0,0,0,0,0,0,0,0,0,0,0
20200212,708075,雙鴻國票97購02,0.41,0.47,0.41,0.45,0.00,0.0,150000,34,66440,0,0,0,0,0,0,70000,80000,-10000,-10000
20200212,708076,力旺國泰98購01,0.97,1.01,0.94,1.00,+0.06,6.38,868000,45,843820,0,0,0,0,0,0,69000,795000,-726000,-726000
20200212,708077,威剛富邦98購01,0.83,0.89,0.82,0.85,+0.06,7.59,197000,31,168250,0,0,0,0,0,0,132000,15000,117000,117000
20200212,708078,勝麗富邦97購01,0.64,0.73,0.64,0.67,+0.04,6.35,559000,29,385630,0,0,0,0,0,0,248000,365000,-117000,-117000
20200212,708079,群聯富邦98購01,0.66,0.69,0.64,0.67,+0.02,3.08,771000,41,515900,0,0,0,0,0,0,258000,403000,-145000,-145000
20200212,708080,精測富邦97購01,0.23,0.23,0.23,0.23,+0.02,9.52,2000,1,460,0,0,0,0,0,0,0,2000,-2000,-2000
20200212,708081,信驊元大96購02,,,,,,0.00,0,0,0,0,0,0,0,0,0,0,0,0,0
20200212,708082,新普元大97購01,1.73,1.75,1.67,1.72,+0.10,6.17,54000,4,92940,0,0,0,0,0,0,0,54000,-54000,-54000
20200212,708083,環球晶元大96購03,4.68,4.79,4.68,4.74,+0.30,6.76,25000,11,118400,0,0,0,0,0,0,22000,19000,3000,3000
20200212,708084,環球晶元大97購01,3.72,3.90,3.70,3.85,+0.17,4.62,156000,15,589700,0,0,0,0,0,0,105000,65000,40000,40000
20200212,708085,穩懋元大96購06,1.44,1.74,1.39,1.68,+0.29,20.86,557000,91,847070,0,0,0,0,0,0,478000,389000,89000,89000
20200212,708086,穩懋元大96購07,1.76,2.13,1.70,2.03,+0.32,18.71,770000,97,1419020,2000,0,2000,0,0,0,658000,645000,13000,15000
20200212,708087,群聯元富96購03,3.93,3.93,3.93,3.93,+0.63,19.09,3000,1,11790,0,0,0,0,0,0,0,3000,-3000,-3000
20200212,708088,群聯兆豐97購01,3.44,3.44,3.44,3.44,+0.09,2.69,13000,2,44720,0,0,0,0,0,0,0,13000,-13000,-13000
20200212,708089,精測兆豐97購03,,,,,,0.00,0,0,0,0,0,0,0,0,0,0,0,0,0
20200212,708090,穩懋兆豐96購04,1.83,2.10,1.77,2.10,+0.32,17.98,262000,30,485120,0,0,0,0,0,0,169000,93000,76000,76000
20200212,708091,久元康和96購01,0.70,0.70,0.70,0.70,+0.03,4.48,36000,2,25200,0,0,0,0,0,0,0,36000,-36000,-36000
20200212,708092,櫃200永昌98購01,0.76,0.76,0.76,0.76,0.00,0.0,1000,1,760,0,0,0,0,0,0,0,0,0,0
20200212,708093,櫃200永昌98購02,,,,,,0.00,0,0,0,0,0,0,0,0,0,0,0,0,0
20200212,708094,大學光群益98購01,1.59,1.75,1.59,1.71,+0.13,8.23,225000,22,382790,0,0,0,0,0,0,113000,118000,-5000,-5000
20200212,708095,VHQ中信96購01,0.28,0.31,0.28,0.31,+0.07,29.17,50000,5,15200,0,0,0,0,0,0,50000,0,50000,50000
20200212,708096,合晶中信9A購01,0.41,0.49,0.41,0.46,+0.08,21.05,153000,13,68900,0,0,0,0,0,0,6000,147000,-141000,-141000
20200212,708097,宣德中信9A購02,0.37,0.39,0.37,0.38,+0.01,2.7,70000,4,26040,0,0,0,0,0,0,60000,10000,50000,50000
20200212,708098,群聯中信9A購01,0.72,0.75,0.72,0.75,+0.02,2.74,81000,7,60150,0,0,0,0,0,0,61000,20000,41000,41000
20200212,708099,M31凱基97購02,0.59,0.60,0.59,0.60,+0.03,5.26,116000,3,68600,0,0,0,0,0,0,6000,110000,-104000,-104000
20200212,708100,大江凱基96購03,0.18,0.18,0.18,0.18,+0.01,5.88,50000,2,9000,0,0,0,0,0,0,0,50000,-50000,-50000
20200212,708101,合晶凱基97購01,0.64,0.76,0.64,0.74,+0.16,27.59,44000,6,32250,0,0,0,0,0,0,5000,39000,-34000,-34000
20200212,708102,良維凱基97購01,,,,,,0.00,0,0,0,0,0,0,0,0,0,0,0,0,0
20200212,708103,宜鼎凱基96購02,3.45,3.45,3.29,3.29,+0.21,6.82,19000,3,65390,0,0,0,0,0,0,4000,15000,-11000,-11000
20200212,708104,晶焱凱基98購01,0.40,0.40,0.40,0.40,+0.05,14.29,65000,3,26000,0,0,0,0,0,0,20000,45000,-25000,-25000
20200212,708105,旺矽統一97購01,,,,,,0.00,0,0,0,0,0,0,0,0,0,0,0,0,0
20200212,708106,宣德統一97購02,0.52,0.56,0.52,0.56,-0.03,-5.08,121000,8,63320,0,0,0,0,0,0,121000,0,121000,121000
20200212,708107,大江永豐96購03,0.31,0.31,0.31,0.31,0.00,0.0,136000,2,42160,0,0,0,0,0,0,136000,0,136000,136000
20200212,708108,昂寶永豐96購02,0.88,0.88,0.88,0.88,-0.01,-1.12,17000,1,14960,0,0,0,0,0,0,0,17000,-17000,-17000
20200212,708109,昇達科永豐96購02,0.96,0.97,0.96,0.96,+0.06,6.67,43000,5,41510,0,0,0,0,0,0,0,43000,-43000,-43000
20200212,708110,博智永豐96購02,0.82,0.89,0.79,0.82,+0.02,2.5,1672000,36,1408930,0,0,0,0,0,0,1124000,477000,647000,647000
20200212,708111,新鉅科永豐96購01,,,,,,0.00,0,0,0,0,0,0,0,0,0,0,0,0,0
20200212,708112,晟德永豐96購01,,,,,,0.00,0,0,0,0,0,0,0,0,0,0,0,0,0
20200212,708113,世界元大96購07,2.09,2.17,2.09,2.17,+0.22,11.28,20000,2,42600,0,0,0,0,0,0,0,20000,-20000,-20000
20200212,708114,良維元大97購02,0.47,0.47,0.47,0.47,+0.03,6.82,200000,1,94000,0,0,0,0,0,0,0,200000,-200000,-200000
20200212,708115,佳邦元大96購01,0.77,0.89,0.77,0.89,+0.12,15.58,816000,34,688590,0,0,0,0,0,0,475000,521000,-46000,-46000
20200212,708116,昂寶元大96購03,2.88,2.90,2.88,2.90,-0.02,-0.68,53000,2,153640,0,0,0,0,0,0,3000,50000,-47000,-47000
20200212,708117,廣明元大97購01,0.38,0.39,0.38,0.39,+0.02,5.41,40000,2,15500,0,0,0,0,0,0,40000,0,40000,40000
20200212,708118,環球晶元大96購04,4.43,4.67,4.43,4.64,+0.28,6.42,34000,17,154670,0,0,0,0,0,0,28000,27000,1000,1000
20200212,708119,環球晶元大97購02,2.07,2.18,2.07,2.18,+0.14,6.86,151000,8,323690,0,0,0,0,0,0,83000,69000,14000,14000
20200212,708120,穩懋元大96購10,2.13,2.65,2.00,2.52,+0.47,22.93,1260000,106,2927350,0,0,0,0,0,0,1078000,628000,450000,450000
20200212,708121,M31國票97購01,0.74,0.76,0.73,0.73,+0.02,2.82,334000,12,247360,0,0,0,0,0,0,99000,235000,-136000,-136000
20200212,708122,六角國票98購02,1.73,1.94,1.73,1.81,+0.03,1.69,263000,10,469340,0,0,0,0,0,0,43000,263000,-220000,-220000
20200212,708123,原相國票97購01,2.24,2.45,2.17,2.31,+0.03,1.32,175000,10,397050,0,0,0,0,0,0,140000,35000,105000,105000
20200212,708124,神盾國票97購02,0.93,1.01,0.93,1.01,+0.11,12.22,70000,19,67700,0,0,0,0,0,0,40000,30000,10000,10000
20200212,708125,碩禾國票97購01,2.03,2.03,1.95,1.95,0.00,0.0,36000,2,71000,0,0,0,0,0,0,10000,26000,-16000,-16000
20200212,708126,環宇國票97購01,,,,,,0.00,0,0,0,0,0,0,0,0,0,0,0,0,0
20200212,708127,昂寶國泰98購01,1.22,1.22,1.22,1.22,-0.01,-0.81,10000,1,12200,0,0,0,0,0,0,0,10000,-10000,-10000
20200212,708128,環球晶國泰97購02,4.50,4.78,4.50,4.74,+0.29,6.52,336000,20,1572510,0,0,0,0,0,0,81000,274000,-193000,-193000
20200212,708129,力旺元大96購01,0.89,0.97,0.87,0.95,+0.08,9.2,268000,29,250420,0,0,0,0,0,0,148000,200000,-52000,-52000
20200212,708130,台燿元大96購02,0.96,1.04,0.94,1.04,+0.17,19.54,273000,21,274840,0,0,0,0,0,0,67000,213000,-146000,-146000
20200212,708131,泰博元大96購01,2.16,2.19,2.16,2.16,+0.07,3.35,61000,4,131790,0,0,0,0,0,0,61000,0,61000,61000
20200212,708132,博智元大97購01,1.91,2.14,1.91,2.02,+0.21,11.6,261000,32,523100,0,0,0,0,0,0,148000,130000,18000,18000
20200212,708133,網家元大96購01,2.53,2.53,2.37,2.37,-0.13,-5.2,312000,22,749160,0,0,0,0,0,0,187000,122000,65000,65000
20200212,708134,穩懋元大96購11,2.12,2.58,2.00,2.43,+0.37,17.96,985000,112,2263350,0,0,0,0,0,0,849000,837000,12000,12000
20200212,708135,群聯群益96購04,0.88,0.88,0.88,0.88,+0.07,8.64,25000,2,22000,0,0,0,0,0,0,25000,0,25000,25000
20200212,708136,宇峻凱基98購02,1.00,1.03,1.00,1.03,-0.09,-8.04,52000,2,52060,0,0,0,0,0,0,2000,50000,-48000,-48000
20200212,708137,旺矽凱基97購01,,,,,,0.00,0,0,0,0,0,0,0,0,0,0,0,0,0
20200212,708138,原相凱基98購01,2.56,2.70,1.29,2.48,-0.08,-3.12,293000,33,724060,0,0,0,0,0,0,280000,227000,53000,53000
20200212,708139,精華凱基97購01,,,,,,0.00,0,0,0,0,0,0,0,0,0,0,0,0,0
20200212,708140,優群凱基98購02,0.47,0.47,0.47,0.47,+0.03,6.82,50000,1,23500,0,0,0,0,0,0,0,50000,-50000,-50000
20200212,708141,鈊象凱基98購02,3.13,3.13,3.04,3.04,-0.22,-6.75,10000,2,30850,0,0,0,0,0,0,0,10000,-10000,-10000
20200212,708142,宣德台新96購02,0.66,0.74,0.63,0.72,-0.07,-8.86,381000,11,269430,0,0,0,0,0,0,79000,230000,-151000,-151000
20200212,708143,大江永豐97購01,,,,,,0.00,0,0,0,0,0,0,0,0,0,0,0,0,0
20200212,708144,杰力永豐96購01,,,,,,0.00,0,0,0,0,0,0,0,0,0,0,0,0,0
20200212,708145,直得永豐96購01,1.00,1.02,1.00,1.02,-0.07,-6.42,56000,2,56940,0,0,0,0,0,0,9000,47000,-38000,-38000
20200212,708146,信昌電永豐96購02,1.98,1.98,1.98,1.98,-0.16,-7.48,10000,1,19800,0,0,0,0,0,0,10000,10000,0,0
20200212,708147,保瑞永豐96購01,0.97,0.98,0.97,0.98,+0.04,4.26,178000,3,174340,0,0,0,0,0,0,178000,0,178000,178000
20200212,708148,胡連永豐96購01,1.03,1.17,1.03,1.17,+0.12,11.43,159000,9,170830,0,0,0,0,0,0,93000,66000,27000,27000
20200212,708149,精測永豐96購12,,,,,,0.00,0,0,0,0,0,0,0,0,0,0,0,0,0
20200212,708150,聚積永豐96購01,0.81,0.81,0.79,0.81,+0.03,3.85,128000,11,102710,0,0,0,0,0,0,48000,80000,-32000,-32000
20200212,708151,雙鴻永豐97購02,,,,,,0.00,0,0,0,0,0,0,0,0,0,0,0,0,0
20200212,708152,力旺中信96購01,0.36,0.36,0.36,0.36,0.00,0.0,10000,3,3600,0,0,0,0,0,0,10000,0,10000,10000
20200212,708153,建榮統一98購01,0.68,0.68,0.67,0.67,-0.04,-5.63,50000,2,33600,0,0,0,0,0,0,0,50000,-50000,-50000
20200212,708154,大江凱基98購02,0.14,0.15,0.14,0.15,0.00,0.0,282000,12,39710,0,0,0,0,0,0,17000,230000,-213000,-213000
20200212,708155,宇峻凱基98購03,1.29,1.42,1.20,1.29,-0.25,-16.23,413000,13,533300,0,0,0,0,0,0,379000,34000,345000,345000
20200212,708156,昂寶凱基97購02,,,,,,0.00,0,0,0,0,0,0,0,0,0,0,0,0,0
20200212,708157,金居凱基97購01,,,,,,0.00,0,0,0,0,0,0,0,0,0,0,0,0,0
20200212,708158,鐿鈦凱基96購03,,,,,,0.00,0,0,0,0,0,0,0,0,0,0,0,0,0
20200212,708159,大江元大97購03,0.66,0.66,0.60,0.62,+0.02,3.33,201000,5,125260,0,0,0,0,0,0,191000,10000,181000,181000
20200212,708160,合晶元大98購01,0.69,0.81,0.69,0.79,+0.16,25.4,568000,14,438390,0,0,0,0,0,0,0,568000,-568000,-568000
20200212,708161,昂寶元大96購04,,,,,,0.00,0,0,0,0,0,0,0,0,0,0,0,0,0
20200212,708162,欣銓元大96購01,0.96,0.98,0.96,0.98,+0.05,5.38,423000,14,408660,0,0,0,0,0,0,287000,136000,151000,151000
20200212,708163,威剛元大98購01,1.23,1.35,1.19,1.29,+0.09,7.5,1651000,119,2118300,0,0,0,0,0,0,1108000,624000,484000,484000
20200212,708164,環球晶元大96購05,2.23,2.35,2.18,2.31,+0.13,5.96,466000,20,1054060,0,0,0,0,0,0,380000,118000,262000,262000
20200212,708165,環球晶元大97購03,1.91,2.00,1.88,1.96,+0.09,4.81,395000,34,767110,0,0,0,0,0,0,150000,194000,-44000,-44000
20200212,708166,凡甲永豐96購02,1.06,1.14,1.06,1.14,-0.01,-0.87,942000,19,1040790,0,0,0,0,0,0,841000,152000,689000,689000
20200212,708167,台燿永豐96購01,0.51,0.52,0.51,0.52,+0.09,20.93,128000,3,65880,0,0,0,0,0,0,0,128000,-128000,-128000
20200212,708168,波若威永豐97購02,0.50,0.50,0.50,0.50,+0.02,4.17,20000,1,10000,0,0,0,0,0,0,20000,0,20000,20000
20200212,708169,網家永豐96購01,1.41,1.42,1.39,1.42,-0.04,-2.74,306000,11,430580,0,0,0,0,0,0,238000,68000,170000,170000
20200212,708170,網龍永豐96購03,1.64,1.66,1.63,1.63,-0.03,-1.81,53000,6,87500,0,0,0,0,0,0,53000,0,53000,53000
20200212,708171,優群永豐96購03,1.04,1.07,1.04,1.07,+0.10,10.31,200000,4,209300,0,0,0,0,0,0,0,200000,-200000,-200000
20200212,708172,緯軟兆豐97購01,0.98,1.01,0.96,1.00,+0.04,4.17,712000,23,709760,0,0,0,0,0,0,100000,612000,-512000,-512000
20200212,708173,鈺太兆豐97購01,0.43,0.55,0.43,0.50,+0.11,28.21,930000,19,476250,0,0,0,0,0,0,70000,790000,-720000,-720000
20200212,708174,胡連康和96購02,1.02,1.08,1.02,1.08,+0.11,11.34,192000,6,200060,0,0,0,0,0,0,54000,138000,-84000,-84000
20200212,708175,精華群益96購02,,,,,,0.00,0,0,0,0,0,0,0,0,0,0,0,0,0
20200212,708176,中美晶國票97購02,3.29,3.29,3.29,3.29,+0.68,26.05,20000,2,65800,0,0,0,0,0,0,0,20000,-20000,-20000
20200212,708177,欣銓富邦97購01,0.24,0.25,0.24,0.25,+0.03,13.64,104000,9,25950,0,0,0,0,0,0,5000,89000,-84000,-84000
20200212,708178,鈊象富邦97購01,1.20,1.20,1.20,1.20,-0.09,-6.98,100000,2,120000,0,0,0,0,0,0,97000,0,97000,97000
20200212,708179,神盾元富98購01,0.77,0.80,0.76,0.77,+0.03,4.05,1845000,37,1432520,0,0,0,0,0,0,1480000,325000,1155000,1155000
20200212,708180,群聯元富96購04,0.56,0.61,0.56,0.58,+0.02,3.57,258000,13,152950,0,0,0,0,0,0,100000,158000,-58000,-58000
20200212,708181,VHQ統一96購01,0.54,0.55,0.41,0.55,+0.17,44.74,151000,11,81480,0,0,0,0,0,0,10000,6000,4000,4000
20200212,708182,凡甲統一96購01,1.01,1.06,1.01,1.06,+0.02,1.92,80000,12,82470,0,0,0,0,0,0,55000,25000,30000,30000
20200212,708183,中美晶凱基96購05,2.30,2.35,2.30,2.34,+0.29,14.15,18000,6,41670,0,0,0,0,0,0,18000,18000,0,0
20200212,708184,建榮凱基96購02,,,,,,0.00,0,0,0,0,0,0,0,0,0,0,0,0,0
20200212,708185,原相凱基97購01,4.10,4.50,3.86,4.13,+0.02,0.49,186000,31,765410,0,0,0,0,0,0,122000,49000,73000,73000
20200212,708186,神盾凱基96購03,0.92,0.99,0.32,0.97,+0.07,7.78,189000,37,172320,0,0,0,0,0,0,158000,31000,127000,127000
20200212,708187,金居兆豐97購01,0.97,1.05,0.97,1.00,+0.06,6.38,617000,34,621730,0,0,0,0,0,0,224000,393000,-169000,-169000
20200212,708188,威剛兆豐97購01,2.68,2.89,2.65,2.77,+0.17,6.54,248000,45,685850,0,0,0,0,0,0,114000,124000,-10000,-10000
20200212,708189,茂達群益98購02,0.85,0.85,0.85,0.85,+0.06,7.59,36000,1,30600,0,0,0,0,0,0,36000,0,36000,36000
20200212,708190,六角元大96購02,1.20,1.42,1.20,1.30,+0.12,10.17,659000,34,878860,0,0,0,0,0,0,391000,639000,-248000,-248000
20200212,708191,同致元大96購02,,,,,,0.00,0,0,0,0,0,0,0,0,0,0,0,0,0
20200212,708192,旺矽元大97購01,1.53,1.53,1.51,1.51,+0.12,8.63,42000,3,63880,0,0,0,0,0,0,42000,0,42000,42000
20200212,708193,直得元大96購01,1.11,1.18,1.11,1.16,+0.01,0.87,358000,17,411930,0,0,0,0,0,0,204000,316000,-112000,-112000
20200212,708194,宣德元大97購01,1.60,1.76,1.58,1.76,+0.01,0.57,373000,15,623880,0,0,0,0,0,0,372000,1000,371000,371000
20200212,708195,精測元大96購07,1.18,1.21,1.16,1.21,+0.09,8.04,222000,15,263420,0,0,0,0,0,0,107000,192000,-85000,-85000
20200212,708196,環宇元大96購02,1.11,1.15,1.11,1.13,+0.04,3.67,266000,8,298410,0,0,0,0,0,0,256000,93000,163000,163000
20200212,708197,合晶亞東97購01,,,,,,0.00,0,0,0,0,0,0,0,0,0,0,0,0,0
20200212,708198,三貝德永豐96購01,0.21,0.24,0.20,0.20,+0.02,11.11,330000,27,72900,0,0,0,0,0,0,40000,290000,-250000,-250000
20200212,708199,大田永豐96購02,0.74,0.78,0.74,0.77,+0.06,8.45,164000,7,124420,0,0,0,0,0,0,0,164000,-164000,-164000
20200212,708200,中美晶永豐96購03,1.09,1.11,1.09,1.11,+0.08,7.77,110000,2,120100,0,0,0,0,0,0,110000,0,110000,110000
20200212,708201,金居永豐96購02,0.91,1.00,0.91,0.95,+0.06,6.74,219000,14,207330,0,0,0,0,0,0,104000,136000,-32000,-32000
20200212,708202,碩禾永豐96購01,1.07,1.11,1.05,1.05,-0.01,-0.94,336000,11,364110,0,0,0,0,0,0,153000,183000,-30000,-30000
20200212,708203,雙鴻永豐96購02,,,,,,0.00,0,0,0,0,0,0,0,0,0,0,0,0,0
20200212,708204,昂寶元富96購01,,,,,,0.00,0,0,0,0,0,0,0,0,0,0,0,0,0
20200212,708205,力旺台新97購02,0.98,1.06,0.96,1.06,+0.04,3.92,480000,15,488920,0,0,0,0,0,0,202000,278000,-76000,-76000
20200212,708206,大江國票97購04,0.56,0.56,0.49,0.54,+0.01,1.89,75000,17,40440,0,0,0,0,0,0,40000,35000,5000,5000
20200212,708207,大學光國票98購01,2.43,2.43,2.43,2.43,+0.07,2.97,10000,1,24300,0,0,0,0,0,0,10000,0,10000,10000
20200212,708208,勝麗國票97購03,1.61,1.83,1.61,1.67,+0.12,7.74,148000,11,250920,0,0,0,0,0,0,84000,64000,20000,20000
20200212,708209,博智國票97購01,2.49,2.68,2.49,2.68,+0.23,9.39,113000,24,284520,0,0,0,0,0,0,113000,0,113000,113000
20200212,708210,閎康國票97購02,1.06,1.06,1.06,1.06,-0.08,-7.02,32000,1,33920,0,0,0,0,0,0,32000,0,32000,32000
20200212,708211,精華國票97購02,,,,,,0.00,0,0,0,0,0,0,0,0,0,0,0,0,0
20200212,708212,鈺太國泰96購01,0.90,1.20,0.89,1.18,+0.28,31.11,400000,22,417130,0,0,0,0,0,0,299000,145000,154000,154000
20200212,708213,群聯富邦97購02,0.63,0.66,0.61,0.64,+0.03,4.92,821000,18,513320,0,0,0,0,0,0,159000,643000,-484000,-484000
20200212,708214,鈺太統一99購01,0.46,0.55,0.46,0.55,+0.09,19.57,206000,12,103280,0,0,0,0,0,0,18000,188000,-170000,-170000
20200212,708215,久元凱基96購01,0.77,0.81,0.22,0.81,+0.10,14.08,89000,7,63510,0,0,0,0,0,0,79000,49000,30000,30000
20200212,708216,勝麗凱基98購01,1.00,1.12,1.00,1.12,+0.14,14.29,20000,2,21200,0,0,0,0,0,0,10000,10000,0,0
20200212,708217,碩禾凱基98購01,0.97,1.14,0.47,1.05,+0.04,3.96,158000,13,153250,0,0,0,0,0,0,85000,146000,-61000,-61000
20200212,708218,中美晶元富96購01,1.40,1.64,1.40,1.46,+0.03,2.1,765000,26,1131160,0,0,0,0,0,0,385000,364000,21000,21000
20200212,708219,新普元富96購01,3.89,4.08,3.86,4.08,+0.27,7.09,71000,10,282310,0,0,0,0,0,0,39000,41000,-2000,-2000
20200212,708220,雙鴻台新97購01,0.24,0.25,0.24,0.25,+0.02,8.7,64000,4,15980,0,0,0,0,0,0,62000,2000,60000,60000
20200212,708221,VHQ康和96購01,0.35,0.45,0.35,0.45,+0.14,45.16,13000,8,5190,0,0,0,0,0,0,6000,0,6000,6000
20200212,708222,網家康和96購01,1.39,1.39,1.29,1.30,-0.07,-5.11,537000,47,715670,0,0,0,0,0,0,283000,246000,37000,37000
20200212,708223,台半群益96購01,0.85,0.91,0.84,0.89,-0.04,-4.3,22000,8,19180,0,0,0,0,0,0,22000,0,22000,22000
20200212,708224,良維群益96購01,0.86,0.94,0.86,0.92,+0.08,9.52,526000,6,474570,0,0,0,0,0,0,98000,428000,-330000,-330000
20200212,708225,昂寶群益98購01,2.25,2.25,2.25,2.25,-0.02,-0.88,11000,2,24750,0,0,0,0,0,0,0,11000,-11000,-11000
20200212,708226,信昌電群益96購03,0.83,0.83,0.81,0.81,-0.04,-4.71,62000,2,50660,0,0,0,0,0,0,22000,40000,-18000,-18000
20200212,708227,鈊象群益99購04,4.38,4.38,4.17,4.17,-0.17,-3.92,20000,2,85500,0,0,0,0,0,0,0,20000,-20000,-20000
20200212,708228,波若威永豐96購01,,,,,,0.00,0,0,0,0,0,0,0,0,0,0,0,0,0
20200212,708229,中美晶亞東96購01,1.53,1.69,1.53,1.69,+0.22,14.97,26000,3,41540,0,0,0,0,0,0,10000,16000,-6000,-6000
20200212,708230,群聯亞東96購01,1.07,1.07,1.07,1.07,+0.03,2.88,200000,2,214000,0,0,0,0,0,0,200000,0,200000,200000
20200212,708231,六角國票98購03,0.78,0.81,0.78,0.81,+0.06,8.0,118000,2,93840,0,0,0,0,0,0,0,118000,-118000,-118000
20200212,708232,宜鼎國票97購03,5.60,5.60,5.15,5.15,+0.22,4.46,40000,6,220900,0,0,0,0,0,0,35000,5000,30000,30000
20200212,708233,宣德國票97購01,0.85,0.90,0.84,0.90,-0.05,-5.26,179000,11,159000,0,0,0,0,0,0,179000,0,179000,179000
20200212,708234,神盾國票98購01,0.98,1.04,0.98,1.04,+0.07,7.22,41000,14,41430,0,0,0,0,0,0,41000,0,41000,41000
20200212,708235,璟德國票97購01,3.20,3.47,3.18,3.45,+0.21,6.48,70000,11,235080,0,0,0,0,0,0,70000,0,70000,70000
20200212,708236,優群國票97購01,0.67,0.72,0.67,0.72,+0.06,9.09,75000,5,51550,0,0,0,0,0,0,45000,30000,15000,15000
20200212,708237,環宇國票97購02,1.39,1.41,1.39,1.41,-0.01,-0.7,105000,3,147050,0,0,0,0,0,0,85000,20000,65000,65000
20200212,708238,三貝德元大97購01,0.27,0.32,0.27,0.29,+0.06,26.09,590000,15,176500,0,0,0,0,0,0,5000,585000,-580000,-580000
20200212,708239,中美晶元大96購04,3.47,3.77,3.40,3.54,+0.20,5.99,65000,8,235930,0,0,0,0,0,0,43000,54000,-11000,-11000
20200212,708240,宇峻元大97購02,,,,,,0.00,0,0,0,0,0,0,0,0,0,0,0,0,0
20200212,708241,聯亞元大97購02,3.35,3.37,3.20,3.20,+0.13,4.23,151000,9,492250,0,0,0,0,0,0,134000,144000,-10000,-10000
20200212,708242,穩懋元大97購02,1.66,1.95,1.61,1.85,+0.24,14.91,893000,112,1539240,0,0,0,0,0,0,608000,560000,48000,48000
20200212,708243,譜瑞元大97購01,2.68,2.93,2.63,2.78,+0.22,8.59,597000,48,1688900,0,0,0,0,0,0,518000,141000,377000,377000
20200212,708244,原相國泰98購02,2.90,3.00,2.90,3.00,+0.10,3.45,10000,4,29600,0,0,0,0,0,0,7000,0,7000,7000
20200212,708245,勝麗國泰98購01,2.33,2.38,2.18,2.18,+0.20,10.1,43000,6,100390,0,0,0,0,0,0,2000,41000,-39000,-39000
20200212,708246,網家國泰97購02,2.48,2.53,2.33,2.40,-0.05,-2.04,573000,67,1393160,0,0,0,0,0,0,420000,143000,277000,277000
20200212,708247,原相第一96購01,1.50,1.61,1.47,1.55,+0.17,12.32,195000,10,297870,0,0,0,0,0,0,95000,0,95000,95000
20200212,708248,波若威凱基98購01,0.33,0.33,0.33,0.33,+0.01,3.12,50000,1,16500,0,0,0,0,0,0,50000,0,50000,50000
20200212,708249,雙鴻凱基98購01,0.21,0.23,0.21,0.21,+0.01,5.0,26000,4,5580,0,0,0,0,0,0,20000,6000,14000,14000
20200212,708250,穩懋凱基96購12,1.79,2.22,0.56,2.22,+0.44,24.72,518000,25,928490,0,0,0,0,0,0,493000,32000,461000,461000
20200212,708251,頎邦凱基97購01,1.23,1.26,1.23,1.26,+0.07,5.88,20000,13,24750,0,0,0,0,0,0,20000,0,20000,20000
20200212,708252,頎邦凱基97購02,0.91,0.94,0.91,0.94,+0.05,5.62,31000,14,28420,0,0,0,0,0,0,31000,0,31000,31000
20200212,708253,大江元富96購02,0.44,0.45,0.43,0.44,0.00,0.0,70000,24,30890,0,0,0,0,0,0,70000,0,70000,70000
20200212,708254,頎邦元富96購01,0.57,0.59,0.57,0.59,+0.03,5.36,121000,9,69990,0,0,0,0,0,0,121000,0,121000,121000
20200212,708255,頎邦元富96購02,0.77,0.80,0.77,0.80,+0.05,6.67,46000,27,35960,0,0,0,0,0,0,41000,5000,36000,36000
20200212,708256,信昌電永豐96購03,1.05,1.05,1.01,1.03,-0.03,-2.83,80000,4,82400,0,0,0,0,0,0,20000,70000,-50000,-50000
20200212,708257,頎邦永豐96購02,0.44,0.47,0.44,0.47,+0.03,6.82,93000,11,41380,0,0,0,0,0,0,88000,5000,83000,83000
20200212,708258,頎邦永豐96購03,0.90,0.94,0.90,0.94,+0.06,6.82,77000,7,69670,0,0,0,0,0,0,70000,7000,63000,63000
20200212,708259,神盾統一96購01,1.31,1.38,1.27,1.32,+0.05,3.94,804000,53,1077550,0,0,0,0,0,0,751000,51000,700000,700000
20200212,708260,群聯統一98購01,2.25,2.25,2.24,2.24,+0.07,3.23,20000,2,44900,0,0,0,0,0,0,0,20000,-20000,-20000
20200212,708261,頎邦統一96購01,0.87,0.90,0.87,0.90,+0.06,7.14,294000,36,259800,0,0,0,0,0,0,186000,108000,78000,78000
20200212,708262,合晶國票97購02,1.00,1.19,1.00,1.19,+0.28,30.77,110000,2,119500,0,0,0,0,0,0,0,110000,-110000,-110000
20200212,708263,威剛國票97購01,4.41,4.88,4.35,4.67,+0.46,10.93,454000,53,2070730,0,0,0,0,0,0,302000,152000,150000,150000
20200212,708264,宣德國票97購02,0.82,0.88,0.81,0.88,-0.09,-9.28,391000,13,337050,0,0,0,0,0,0,291000,100000,191000,191000
20200212,708265,聚積國票97購02,2.26,2.35,2.26,2.35,+0.17,7.8,92000,9,213690,0,0,0,0,0,0,43000,49000,-6000,-6000
20200212,708266,頎邦國票97購01,1.42,1.47,1.42,1.47,+0.09,6.52,167000,28,240130,0,0,0,0,0,0,127000,40000,87000,87000
20200212,708267,M31國泰98購01,1.11,1.18,1.11,1.15,+0.07,6.48,62000,7,70670,0,0,0,0,0,0,50000,12000,38000,38000
20200212,708268,聯亞國泰98購01,,,,,,0.00,0,0,0,0,0,0,0,0,0,0,0,0,0
20200212,708269,頎邦國泰97購01,1.00,1.01,0.98,1.01,+0.07,7.45,80000,30,79890,0,0,0,0,0,0,70000,10000,60000,60000
20200212,708270,昂寶富邦98購01,0.87,0.87,0.87,0.87,0.00,0.0,17000,1,14790,0,0,0,0,0,0,0,17000,-17000,-17000
20200212,708271,原相富邦98購01,1.73,1.91,1.65,1.76,+0.03,1.73,339000,82,591530,0,0,0,0,0,0,297000,84000,213000,213000
20200212,708272,頎邦富邦98購01,0.61,0.62,0.61,0.62,+0.03,5.08,620000,27,381210,0,0,0,0,0,0,520000,100000,420000,420000
20200212,708273,力旺元大96購02,1.56,1.73,1.56,1.70,+0.10,6.25,163000,18,273200,0,0,0,0,0,0,30000,139000,-109000,-109000
20200212,708274,中美晶元大96購05,3.11,3.49,3.11,3.26,+0.27,9.03,154000,13,506500,0,0,0,0,0,0,11000,143000,-132000,-132000
20200212,708275,六角元大98購01,0.79,0.92,0.79,0.92,+0.14,17.95,872000,40,753480,0,0,0,0,0,0,479000,837000,-358000,-358000
20200212,708276,台半元大96購02,,,,,,0.00,0,0,0,0,0,0,0,0,0,0,0,0,0
20200212,708277,金居元大97購01,0.59,0.61,0.58,0.61,+0.05,8.93,254000,11,151640,0,0,0,0,0,0,234000,20000,214000,214000
20200212,708278,勝麗元大96購03,1.65,1.84,1.63,1.72,+0.12,7.5,282000,25,485730,0,0,0,0,0,0,188000,133000,55000,55000
20200212,708279,頎邦元大96購02,1.10,1.11,1.08,1.11,+0.06,5.71,69000,6,75420,0,0,0,0,0,0,69000,0,69000,69000
20200212,708280,頎邦元大96購03,1.45,1.46,1.42,1.46,+0.10,7.35,110000,5,159900,0,0,0,0,0,0,110000,0,110000,110000
20200212,708281,頎邦元大97購01,0.97,0.99,0.96,0.99,+0.05,5.32,902000,26,887820,0,0,0,0,0,0,562000,369000,193000,193000
20200212,708282,兆利群益98購01,2.02,2.02,1.94,2.00,-0.09,-4.31,405000,20,800100,0,0,0,0,0,0,405000,0,405000,405000
20200212,708283,頎邦群益97購01,1.11,1.16,1.11,1.16,+0.06,5.45,318000,28,362300,0,0,0,0,0,0,127000,191000,-64000,-64000
20200212,708284,頎邦群益97購02,1.03,1.07,1.03,1.07,+0.05,4.9,161000,19,170830,0,0,0,0,0,0,132000,29000,103000,103000
20200212,708285,頎邦群益98購01,1.06,1.12,1.05,1.11,+0.05,4.72,201000,36,219490,0,0,0,0,0,0,153000,48000,105000,105000
20200212,708286,三貝德康和96購01,0.53,0.53,0.47,0.47,+0.05,11.9,160000,11,81550,0,0,0,0,0,0,0,160000,-160000,-160000
20200212,708287,兆利康和9C購01,0.81,0.83,0.80,0.83,0.00,0.0,85000,12,69160,0,0,0,0,0,0,27000,58000,-31000,-31000
20200212,708288,富喬康和96購01,0.53,0.63,0.53,0.63,+0.19,43.18,348000,5,192120,0,0,0,0,0,0,161000,187000,-26000,-26000
20200212,708289,杰力群益96購01,1.37,1.37,1.37,1.37,+0.13,10.48,65000,1,89050,0,0,0,0,0,0,65000,0,65000,65000
20200212,708290,威剛群益97購01,1.67,1.87,1.67,1.74,+0.11,6.75,1929000,97,3332550,0,0,0,0,0,0,1026000,903000,123000,123000
20200212,708291,環宇群益98購01,0.96,0.96,0.94,0.94,-0.04,-4.08,58000,2,54740,0,0,0,0,0,0,58000,0,58000,58000
20200212,708292,M31國票97購02,1.21,1.23,1.17,1.17,+0.09,8.33,770000,6,921250,0,0,0,0,0,0,365000,405000,-40000,-40000
20200212,708293,合晶國票98購01,1.34,1.41,1.34,1.40,+0.21,17.65,100000,8,138100,0,0,0,0,0,0,40000,60000,-20000,-20000
20200212,708294,良維國票97購03,0.97,1.04,0.97,1.02,+0.03,3.03,262000,14,266970,0,0,0,0,0,0,182000,206000,-24000,-24000
20200212,708295,昂寶國票97購04,,,,,,0.00,0,0,0,0,0,0,0,0,0,0,0,0,0
20200212,708296,威剛國票97購02,1.80,2.02,1.77,1.85,+0.09,5.11,672000,49,1260400,0,0,0,0,0,0,178000,484000,-306000,-306000
20200212,708297,茂達國票97購02,,,,,,0.00,0,0,0,0,0,0,0,0,0,0,0,0,0
20200212,708298,原相國票98購02,4.47,4.93,4.27,4.88,+0.87,21.7,85000,22,387490,0,0,0,0,0,0,61000,24000,37000,37000
20200212,708299,穩懋國票97購02,2.69,3.39,2.64,3.22,+0.57,21.51,385000,68,1113920,0,0,0,0,0,0,236000,249000,-13000,-13000
20200212,708300,群聯日盛96購01,0.67,0.67,0.66,0.67,+0.02,3.08,157000,5,104960,0,0,0,0,0,0,134000,123000,11000,11000
20200212,708301,優群永豐97購01,0.82,0.85,0.82,0.85,+0.09,11.84,126000,3,103620,0,0,0,0,0,0,0,126000,-126000,-126000
20200212,708302,穩懋永豐96購02,0.98,1.38,0.95,1.27,+0.26,25.74,1879000,47,2330040,0,0,0,0,0,0,1787000,1803000,-16000,-16000
20200212,708303,伍豐中信9A購01,0.38,0.38,0.38,0.38,+0.01,2.7,5000,1,1900,0,0,0,0,0,0,5000,0,5000,5000
20200212,708304,同致中信98購02,,,,,,0.00,0,0,0,0,0,0,0,0,0,0,0,0,0
20200212,708305,宜鼎中信9A購01,1.47,1.47,1.35,1.35,-0.04,-2.88,195000,8,273600,0,0,0,0,0,0,145000,50000,95000,95000
20200212,708306,閎康統一99購01,,,,,,0.00,0,0,0,0,0,0,0,0,0,0,0,0,0
20200212,708307,頎邦統一96購02,1.06,1.11,1.06,1.11,+0.07,6.73,408000,45,446690,0,0,0,0,0,0,356000,48000,308000,308000
20200212,708308,大中凱基98購01,,,,,,0.00,0,0,0,0,0,0,0,0,0,0,0,0,0
20200212,708309,大江凱基97購01,0.41,0.41,0.39,0.41,0.00,0.0,135000,28,54560,0,0,0,0,0,0,115000,20000,95000,95000
20200212,708310,兆利凱基98購01,1.21,1.21,1.15,1.18,-0.08,-6.35,167000,10,197670,0,0,0,0,0,0,167000,0,167000,167000
20200212,708311,迅得凱基97購01,,,,,,0.00,0,0,0,0,0,0,0,0,0,0,0,0,0
20200212,708312,佳邦凱基98購01,0.96,0.96,0.96,0.96,+0.10,11.63,5000,1,4800,0,0,0,0,0,0,0,5000,-5000,-5000
20200212,708313,金居凱基98購01,,,,,,0.00,0,0,0,0,0,0,0,0,0,0,0,0,0
20200212,708314,聚積凱基98購01,0.82,0.86,0.82,0.85,+0.06,7.59,230000,9,195440,0,0,0,0,0,0,157000,73000,84000,84000
20200212,708315,廣明凱基98購01,0.28,0.30,0.28,0.30,+0.03,11.11,459000,3,137320,0,0,0,0,0,0,455000,4000,451000,451000
20200212,708316,緯軟凱基98購02,0.81,0.81,0.80,0.81,+0.03,3.85,274000,7,221200,0,0,0,0,0,0,210000,10000,200000,200000
20200212,708317,環宇凱基98購01,0.75,0.75,0.75,0.75,-0.01,-1.32,60000,2,45000,0,0,0,0,0,0,10000,50000,-40000,-40000
20200212,708318,聯亞凱基98購01,1.22,1.25,1.22,1.24,+0.07,5.98,140000,4,173430,0,0,0,0,0,0,100000,40000,60000,60000
20200212,708319,穩懋凱基96購13,1.67,2.08,1.67,2.08,+0.47,29.19,36000,9,65200,0,0,0,0,0,0,6000,34000,-28000,-28000
20200212,708320,頎邦凱基96購01,0.39,0.40,0.38,0.40,+0.02,5.26,115000,34,44080,0,0,0,0,0,0,105000,10000,95000,95000
20200212,708321,大學光元大97購01,1.68,1.74,1.68,1.74,+0.09,5.45,19000,3,32520,0,0,0,0,0,0,19000,9000,10000,10000
20200212,708322,群聯元大97購04,2.36,2.36,2.36,2.36,+0.05,2.16,5000,1,11800,0,0,0,0,0,0,5000,0,5000,5000
20200212,708323,聯亞元大97購03,1.28,1.28,1.23,1.23,+0.06,5.13,56000,6,70350,0,0,0,0,0,0,24000,56000,-32000,-32000
20200212,708324,新普兆豐97購01,2.52,2.53,2.43,2.53,+0.20,8.58,51000,8,127610,0,0,0,0,0,0,32000,27000,5000,5000
20200212,708325,穩懋兆豐97購02,2.67,3.14,2.62,3.03,+0.40,15.21,647000,48,1820100,0,0,0,0,0,0,154000,511000,-357000,-357000
20200212,708326,大江日盛96購01,0.35,0.35,0.31,0.34,0.00,0.0,206000,21,69130,0,0,0,0,0,0,186000,20000,166000,166000
20200212,708327,鈊象第一96購01,1.23,1.23,1.07,1.07,-0.14,-11.57,145000,12,165280,0,0,0,0,0,0,95000,60000,35000,35000
20200212,708328,晶焱元大97購03,1.02,1.02,1.01,1.01,+0.10,10.99,125000,5,126870,0,0,0,0,0,0,125000,125000,0,0
20200212,708329,頎邦康和96購01,0.54,0.57,0.54,0.57,+0.04,7.55,153000,30,82720,0,0,0,0,0,0,153000,0,153000,153000
20200212,708330,M31群益98購01,0.89,0.89,0.87,0.87,+0.06,7.41,100000,5,88020,0,0,0,0,0,0,14000,86000,-72000,-72000
20200212,708331,中美晶群益96購03,1.12,1.34,1.12,1.16,+0.05,4.5,611000,27,766870,0,0,0,0,0,0,106000,536000,-430000,-430000
20200212,708332,六角群益98購01,0.92,0.96,0.92,0.95,+0.10,11.76,715000,22,679860,0,0,0,0,0,0,363000,715000,-352000,-352000
20200212,708333,宇峻群益98購01,1.39,1.52,1.34,1.43,-0.23,-13.86,1041000,49,1470840,0,0,0,0,0,0,360000,681000,-321000,-321000
20200212,708334,佳邦群益98購01,0.99,1.10,0.99,1.10,+0.13,13.4,186000,5,191750,0,0,0,0,0,0,1000,185000,-184000,-184000
20200212,708335,網龍群益96購01,1.17,1.17,1.17,1.17,-0.08,-6.4,23000,3,26910,0,0,0,0,0,0,23000,0,23000,23000
20200212,708336,大宇資永豐97購01,0.94,0.94,0.94,0.94,-0.01,-1.05,1000,1,940,0,0,0,0,0,0,0,1000,-1000,-1000
20200212,708337,大學光永豐96購02,,,,,,0.00,0,0,0,0,0,0,0,0,0,0,0,0,0
20200212,708338,伍豐永豐96購01,0.41,0.41,0.41,0.41,+0.01,2.5,10000,1,4100,0,0,0,0,0,0,10000,0,10000,10000
20200212,708339,旺矽永豐97購02,,,,,,0.00,0,0,0,0,0,0,0,0,0,0,0,0,0
20200212,708340,昂寶永豐97購01,0.69,0.69,0.69,0.69,-0.01,-1.43,42000,2,28980,0,0,0,0,0,0,0,42000,-42000,-42000
20200212,708341,美琪瑪永豐96購02,0.50,0.50,0.50,0.50,-0.01,-1.96,46000,2,23000,0,0,0,0,0,0,46000,0,46000,46000
20200212,708342,群聯永豐96購02,0.28,0.29,0.28,0.29,+0.03,11.54,117000,3,32810,0,0,0,0,0,0,112000,5000,107000,107000
20200212,708343,網龍永豐96購04,,,,,,0.00,0,0,0,0,0,0,0,0,0,0,0,0,0
20200212,708344,聯亞永豐96購03,0.36,0.37,0.36,0.37,+0.05,15.62,14000,2,5150,0,0,0,0,0,0,3000,11000,-8000,-8000
20200212,708345,鈊象永豐96購05,2.08,2.14,2.00,2.07,-0.28,-11.91,48000,7,100390,0,0,0,0,0,0,0,48000,-48000,-48000
20200212,708346,M31統一97購01,1.07,1.07,1.05,1.05,+0.04,3.96,109000,4,115610,0,0,0,0,0,0,58000,51000,7000,7000
20200212,708347,環球晶統一96購02,1.84,1.93,1.82,1.89,+0.11,6.18,225000,9,413280,0,0,0,0,0,0,217000,8000,209000,209000
20200212,708348,環球晶中信96購02,0.74,0.81,0.73,0.79,+0.06,8.22,94000,4,70220,0,0,0,0,0,0,82000,12000,70000,70000
20200212,708349,鈺太中信97購01,0.55,0.67,0.55,0.67,+0.17,34.0,87000,5,49030,0,0,0,0,0,0,0,87000,-87000,-87000
20200212,708350,中美晶台新97購02,,,,,,0.00,0,0,0,0,0,0,0,0,0,0,0,0,0
20200212,708351,穩懋台新97購02,1.87,1.98,1.87,1.93,+0.11,6.04,3000,3,5780,0,0,0,0,0,0,0,3000,-3000,-3000
20200212,708352,杰力凱基98購01,0.61,0.64,0.61,0.64,+0.01,1.59,84000,2,53520,0,0,0,0,0,0,84000,0,84000,84000
20200212,708353,中美晶富邦97購03,0.56,0.62,0.54,0.58,+0.02,3.57,707000,20,404740,0,0,0,0,0,0,215000,492000,-277000,-277000
20200212,708354,合晶國票99購01,1.00,1.10,1.00,1.10,+0.22,25.0,138000,3,141300,0,0,0,0,0,0,0,138000,-138000,-138000
20200212,708355,昇達科國票97購01,0.82,0.87,0.82,0.87,+0.11,14.47,30000,3,25500,0,0,0,0,0,0,0,30000,-30000,-30000
20200212,708356,信昌電國票97購03,2.07,2.07,2.07,2.07,-0.07,-3.27,2000,1,4140,0,0,0,0,0,0,0,2000,-2000,-2000
20200212,708357,神盾國票97購03,2.53,2.69,2.53,2.59,+0.24,10.21,134000,18,347810,0,0,0,0,0,0,95000,39000,56000,56000
20200212,708358,群聯國票97購02,1.38,1.38,1.38,1.38,+0.13,10.4,5000,1,6900,0,0,0,0,0,0,0,5000,-5000,-5000
20200212,708359,中美晶國泰97購02,1.95,2.10,1.94,1.94,+0.19,10.86,772000,12,1559490,0,0,0,0,0,0,1000,731000,-730000,-730000
20200212,708360,宇峻國泰97購01,1.36,1.56,1.36,1.46,-0.23,-13.61,253000,5,361980,0,0,0,0,0,0,232000,21000,211000,211000
20200212,708361,鈊象國泰98購02,3.27,3.36,3.05,3.10,-0.23,-6.91,563000,22,1799280,0,0,0,0,0,0,520000,46000,474000,474000
20200212,708362,環球晶統一96購04,3.36,3.36,3.36,3.36,+0.26,8.39,30000,1,100800,0,0,0,0,0,0,30000,0,30000,30000
20200212,708363,台燿中信98購01,0.82,0.89,0.82,0.89,+0.13,17.11,620000,29,537970,0,0,0,0,0,0,349000,275000,74000,74000
20200212,708364,新普中信98購01,1.09,1.11,1.05,1.09,+0.07,6.86,143000,10,156240,0,0,0,0,0,0,28000,115000,-87000,-87000
20200212,708365,凡甲凱基97購01,0.70,0.75,0.69,0.75,-0.02,-2.6,320000,12,235210,0,0,0,0,0,0,300000,110000,190000,190000
20200212,708366,中美晶凱基97購01,1.35,1.55,1.35,1.39,+0.09,6.92,174000,7,251660,0,0,0,0,0,0,0,174000,-174000,-174000
20200212,708367,良維凱基97購02,,,,,,0.00,0,0,0,0,0,0,0,0,0,0,0,0,0
20200212,708368,宣德凱基97購01,0.96,1.00,0.93,1.00,-0.05,-4.76,204000,25,198220,0,0,0,0,0,0,204000,0,204000,204000
20200212,708369,雙美凱基98購01,0.54,0.54,0.54,0.54,+0.20,58.82,50000,1,27000,0,0,0,0,0,0,50000,0,50000,50000
20200212,708370,中美晶元大96購06,2.21,2.42,2.16,2.42,+0.30,14.15,63000,11,146230,0,0,0,0,0,0,46000,43000,3000,3000
20200212,708371,信昌電元大96購04,0.90,0.90,0.90,0.90,+0.01,1.12,50000,2,45000,0,0,0,0,0,0,50000,0,50000,50000
20200212,708372,優群元大97購03,1.18,1.22,1.17,1.17,+0.05,4.46,691000,32,827850,0,0,0,0,0,0,631000,652000,-21000,-21000
20200212,708373,中美晶元富96購02,0.66,0.76,0.65,0.68,+0.02,3.03,1557000,67,1098510,0,0,0,0,0,0,804000,789000,15000,15000
20200212,708374,久元台新96購01,0.78,0.79,0.77,0.77,+0.01,1.32,134000,12,104710,0,0,0,0,0,0,63000,61000,2000,2000
20200212,708375,久元台新96購02,,,,,,0.00,0,0,0,0,0,0,0,0,0,0,0,0,0
20200212,708376,台半台新96購01,0.50,0.50,0.49,0.50,0.00,0.0,174000,3,86620,0,0,0,0,0,0,136000,38000,98000,98000
20200212,708377,鈊象台新96購02,2.18,2.18,2.18,2.18,-0.08,-3.54,10000,1,21800,0,0,0,0,0,0,0,10000,-10000,-10000
20200212,708378,頎邦台新97購01,0.89,0.93,0.89,0.93,+0.04,4.49,320000,28,293690,0,0,0,0,0,0,282000,30000,252000,252000
20200212,708379,穩懋亞東98購01,2.97,3.18,2.97,3.18,+0.75,30.86,25000,2,76770,0,0,0,0,0,0,0,25000,-25000,-25000
20200212,708380,台半永豐96購01,0.45,0.45,0.45,0.45,0.00,0.0,15000,1,6750,0,0,0,0,0,0,0,15000,-15000,-15000
20200212,708381,亞泰永豐96購01,0.70,0.71,0.68,0.71,+0.02,2.9,710000,5,491310,0,0,0,0,0,0,709000,0,709000,709000
20200212,708382,宜鼎永豐96購02,1.32,1.32,1.24,1.24,-0.07,-5.34,131000,6,167580,0,0,0,0,0,0,131000,0,131000,131000
20200212,708383,信昌電永豐96購04,0.73,0.73,0.73,0.73,-0.01,-1.35,60000,2,43800,0,0,0,0,0,0,0,60000,-60000,-60000
20200212,708384,雍智永豐97購01,0.51,0.57,0.51,0.57,+0.05,9.62,257000,4,141250,0,0,0,0,0,0,10000,247000,-237000,-237000
20200212,708385,碩禾永豐96購02,0.61,0.63,0.59,0.59,-0.03,-4.84,136000,5,83460,0,0,0,0,0,0,68000,68000,0,0
20200212,708386,雙鴻永豐97購03,0.24,0.24,0.24,0.24,+0.03,14.29,60000,1,14400,0,0,0,0,0,0,0,60000,-60000,-60000
20200212,708387,瓦城康和96購01,0.78,0.79,0.78,0.79,+0.03,3.95,37000,5,29050,0,0,0,0,0,0,8000,29000,-21000,-21000
20200212,708388,三貝德群益96購02,0.48,0.58,0.47,0.47,+0.09,23.68,246000,14,121200,0,0,0,0,0,0,219000,20000,199000,199000
20200212,708389,台半群益96購02,0.92,0.98,0.92,0.97,-0.03,-3.0,33000,9,31480,0,0,0,0,0,0,33000,0,33000,33000
20200212,708390,美琪瑪群益96購01,1.40,1.42,1.40,1.42,+0.03,2.16,17000,2,24120,0,0,0,0,0,0,17000,0,17000,17000
20200212,708391,原相群益98購02,2.96,3.32,2.88,3.15,+0.04,1.29,768000,76,2385340,0,0,0,0,0,0,585000,241000,344000,344000
20200212,708392,大江國票97購05,0.61,0.61,0.58,0.59,+0.02,3.51,280000,19,169350,0,0,0,0,0,0,280000,0,280000,280000
20200212,708393,信昌電國泰98購01,1.27,1.29,1.24,1.25,-0.12,-8.76,635000,19,796200,0,0,0,0,0,0,380000,595000,-215000,-215000
20200212,708394,威剛國泰98購01,1.03,1.13,1.03,1.06,+0.06,6.0,993000,55,1068730,0,0,0,0,0,0,591000,607000,-16000,-16000
20200212,708395,環球晶國泰97購03,3.98,4.22,3.98,4.19,+0.28,7.16,27000,9,110230,0,0,0,0,0,0,12000,26000,-14000,-14000
20200212,708396,信昌電富邦98購01,0.48,0.48,0.47,0.48,-0.01,-2.04,226000,6,106280,0,0,0,0,0,0,215000,10000,205000,205000
20200212,708397,群聯富邦97購03,0.24,0.24,0.22,0.24,+0.01,4.35,270000,24,63200,0,0,0,0,0,0,110000,160000,-50000,-50000
20200212,708398,環球晶富邦99購01,1.31,1.31,1.31,1.31,+0.03,2.34,10000,1,13100,0,0,0,0,0,0,10000,0,10000,10000
20200212,708399,穩懋富邦97購03,1.50,1.73,1.44,1.68,+0.23,15.86,2985000,123,4618280,0,0,0,0,0,0,1205000,2002000,-797000,-797000
20200212,708400,建榮國票98購01,,,,,,0.00,0,0,0,0,0,0,0,0,0,0,0,0,0
20200212,708401,威剛國泰98購02,4.53,4.85,4.46,4.70,+0.35,8.05,925000,51,4270140,0,0,0,0,0,0,115000,731000,-616000,-616000
20200212,708402,優群國泰99購01,0.94,0.99,0.94,0.99,+0.09,10.0,171000,8,166180,0,0,0,0,0,0,20000,151000,-131000,-131000
20200212,708403,合晶元大98購02,1.36,1.68,1.36,1.60,+0.31,24.03,346000,24,512880,0,0,0,0,0,0,63000,346000,-283000,-283000
20200212,708404,聖暉元大97購01,,,,,,0.00,0,0,0,0,0,0,0,0,0,0,0,0,0
20200212,708405,頎邦元大97購02,1.33,1.36,1.31,1.34,+0.06,4.69,156000,13,208110,0,0,0,0,0,0,146000,10000,136000,136000
20200212,708406,昂寶元富97購01,,,,,,0.00,0,0,0,0,0,0,0,0,0,0,0,0,0
20200212,708407,環球晶元富97購01,2.02,2.09,2.02,2.09,+0.12,6.09,211000,5,432340,0,0,0,0,0,0,112000,99000,13000,13000
20200212,708408,雙鴻統一97購01,,,,,,0.00,0,0,0,0,0,0,0,0,0,0,0,0,0
20200212,708409,精測中信97購01,0.40,0.41,0.40,0.41,+0.03,7.89,16000,4,6460,0,0,0,0,0,0,4000,11000,-7000,-7000
20200212,708410,頎邦中信9B購01,0.38,0.39,0.38,0.38,+0.01,2.7,70000,13,26900,0,0,0,0,0,0,70000,0,70000,70000
20200212,708411,宜鼎凱基99購01,0.77,0.77,0.70,0.71,-0.03,-4.05,229000,12,170790,0,0,0,0,0,0,110000,109000,1000,1000
20200212,708412,直得凱基98購01,0.80,0.86,0.80,0.86,+0.03,3.61,40000,3,32800,0,0,0,0,0,0,30000,10000,20000,20000
20200212,708413,信昌電凱基98購01,0.73,0.73,0.73,0.73,-0.01,-1.35,8000,1,5840,0,0,0,0,0,0,0,8000,-8000,-8000
20200212,708414,群聯凱基98購01,0.50,0.60,0.50,0.60,+0.06,11.11,183000,9,102920,0,0,0,0,0,0,161000,21000,140000,140000
20200212,708415,VHQ永豐97購01,,,,,,0.00,0,0,0,0,0,0,0,0,0,0,0,0,0
20200212,708416,大宇資永豐99購01,0.94,0.94,0.93,0.93,-0.02,-2.11,28000,2,26310,0,0,0,0,0,0,28000,0,28000,28000
20200212,708417,長科*永豐97購01,,,,,,0.00,0,0,0,0,0,0,0,0,0,0,0,0,0
20200212,708418,廣明永豐97購01,0.12,0.13,0.12,0.12,0.00,0.0,1154000,9,141480,0,0,0,0,0,0,74000,1080000,-1006000,-1006000
20200212,708419,環宇永豐98購01,0.59,0.64,0.59,0.64,+0.06,10.34,320000,4,193220,0,0,0,0,0,0,320000,0,320000,320000
20200212,708420,宜鼎群益98購01,2.35,2.35,2.10,2.10,+0.17,8.81,88000,14,196090,0,0,0,0,0,0,46000,42000,4000,4000
20200212,708421,群聯群益98購01,1.99,2.05,1.99,2.03,+0.12,6.28,261000,7,524600,0,0,0,0,0,0,161000,111000,50000,50000
20200212,708422,群聯群益99購01,1.57,1.57,1.57,1.57,+0.03,1.95,5000,1,7850,0,0,0,0,0,0,5000,0,5000,5000
20200212,708423,世界麥證97購01,0.96,0.96,0.96,0.96,+0.07,7.87,10000,1,9600,0,10000,-10000,0,0,0,0,10000,-10000,-10000
20200212,708424,原相台新97購02,2.07,2.22,1.98,2.12,-0.01,-0.47,334000,33,684120,0,0,0,0,0,0,222000,52000,170000,170000
20200212,708425,新鉅科台新98購01,0.56,0.66,0.55,0.63,+0.10,18.87,193000,7,115180,0,0,0,0,0,0,43000,150000,-107000,-107000
20200212,708426,群聯台新97購03,0.68,0.68,0.68,0.68,+0.04,6.25,5000,1,3400,0,0,0,0,0,0,5000,0,5000,5000
20200212,708427,聯亞台新97購01,0.72,0.72,0.72,0.72,+0.08,12.5,21000,1,15120,0,0,0,0,0,0,0,21000,-21000,-21000
20200212,708428,鈺太台新97購01,,,,,,0.00,0,0,0,0,0,0,0,0,0,0,0,0,0
20200212,708429,群聯統一97購01,,,,,,0.00,0,0,0,0,0,0,0,0,0,0,0,0,0
20200212,708430,兆利中信9A購01,0.55,0.58,0.55,0.56,-0.04,-6.67,195000,24,110790,0,0,0,0,0,0,195000,0,195000,195000
20200212,708431,原相中信99購01,1.92,2.06,1.89,2.02,+0.06,3.06,253000,58,490790,0,0,0,0,0,0,160000,81000,79000,79000
20200212,708432,廣明中信9B購01,0.15,0.16,0.15,0.15,0.00,0.0,50000,6,7510,0,0,0,0,0,0,8000,20000,-12000,-12000
20200212,708433,穩懋中信99購01,1.29,1.49,1.26,1.48,+0.24,19.35,162000,19,221100,0,0,0,0,0,0,78000,84000,-6000,-6000
20200212,708434,合晶凱基98購01,0.74,0.79,0.74,0.79,+0.19,31.67,30000,3,23200,0,0,0,0,0,0,0,30000,-30000,-30000
20200212,708435,勝麗凱基97購02,0.51,0.51,0.48,0.48,+0.06,14.29,65000,4,31500,0,0,0,0,0,0,0,65000,-65000,-65000
20200212,708436,博智凱基97購01,1.57,1.82,1.57,1.68,+0.20,13.51,93000,13,158530,0,0,0,0,0,0,35000,58000,-23000,-23000
20200212,708437,穩懋日盛97購01,1.34,1.65,1.31,1.65,+0.36,27.91,369000,30,530480,0,0,0,0,0,0,110000,259000,-149000,-149000
20200212,708438,中美晶亞東97購01,1.34,1.40,1.34,1.40,+0.17,13.82,48000,3,64800,0,0,0,0,0,0,0,48000,-48000,-48000
20200212,708439,合晶亞東97購02,0.86,0.86,0.86,0.86,+0.21,32.31,45000,1,38700,0,0,0,0,0,0,0,45000,-45000,-45000
20200212,708440,大田元富97購01,0.76,0.76,0.76,0.76,+0.05,7.04,10000,1,7600,0,0,0,0,0,0,0,10000,-10000,-10000
20200212,708441,榮剛元富97購01,0.75,0.77,0.75,0.77,+0.01,1.32,60000,5,45600,0,0,0,0,0,0,20000,40000,-20000,-20000
20200212,708442,聯亞台新99購01,0.74,0.75,0.71,0.71,+0.02,2.9,66000,7,48930,0,0,0,0,0,0,42000,24000,18000,18000
20200212,708443,昂寶元大9A購01,,,,,,0.00,0,0,0,0,0,0,0,0,0,0,0,0,0
20200212,708444,威剛元大99購01,1.17,1.29,1.16,1.20,+0.07,6.19,1747000,111,2138580,0,0,0,0,0,0,1113000,914000,199000,199000
20200212,708445,神盾元大99購02,0.62,0.65,0.61,0.64,+0.05,8.47,1505000,16,959140,0,0,0,0,0,0,1405000,104000,1301000,1301000
20200212,708446,聯亞元大97購04,2.10,2.10,1.95,1.95,+0.03,1.56,24000,5,49200,0,0,0,0,0,0,22000,4000,18000,18000
20200212,708447,鈺太元大99購01,0.67,0.85,0.67,0.83,+0.16,23.88,311000,17,234340,0,0,0,0,0,0,114000,221000,-107000,-107000
20200212,708448,大中永豐97購01,,,,,,0.00,0,0,0,0,0,0,0,0,0,0,0,0,0
20200212,708449,大江永豐97購02,,,,,,0.00,0,0,0,0,0,0,0,0,0,0,0,0,0
20200212,708450,六角永豐97購01,0.55,0.62,0.55,0.56,+0.05,9.8,175000,8,100800,0,0,0,0,0,0,1000,174000,-173000,-173000
20200212,708451,兆利永豐97購01,0.49,0.49,0.49,0.49,-0.08,-14.04,150000,8,73500,0,0,0,0,0,0,70000,0,70000,70000
20200212,708452,波若威永豐98購01,,,,,,0.00,0,0,0,0,0,0,0,0,0,0,0,0,0
20200212,708453,宣德永豐97購02,0.62,0.70,0.61,0.70,-0.02,-2.78,117000,17,77740,0,0,0,0,0,0,49000,67000,-18000,-18000
20200212,708454,建榮永豐99購01,1.24,1.29,1.24,1.29,+0.01,0.78,88000,2,111420,0,0,0,0,0,0,42000,46000,-4000,-4000
20200212,708455,森鉅永豐97購01,,,,,,0.00,0,0,0,0,0,0,0,0,0,0,0,0,0
20200212,708456,榮剛永豐97購01,,,,,,0.00,0,0,0,0,0,0,0,0,0,0,0,0,0
20200212,708457,廣積永豐97購01,1.00,1.01,1.00,1.01,-0.02,-1.94,20000,3,20100,0,0,0,0,0,0,18000,0,18000,18000
20200212,708458,旺矽群益9A購01,0.73,0.73,0.73,0.73,+0.06,8.96,5000,1,3650,0,0,0,0,0,0,0,5000,-5000,-5000
20200212,708459,昇達科群益98購01,0.47,0.49,0.47,0.49,+0.06,13.95,209000,3,98930,0,0,0,0,0,0,0,209000,-209000,-209000
20200212,708460,櫃200群益97購01,,,,,,0.00,0,0,0,0,0,0,0,0,0,0,0,0,0
20200212,708461,櫃200群益97購02,,,,,,0.00,0,0,0,0,0,0,0,0,0,0,0,0,0
20200212,708462,中美晶元大97購03,3.20,3.20,3.13,3.13,+0.31,10.99,30000,5,95650,0,0,0,0,0,0,30000,30000,0,0
20200212,708463,宜鼎元大97購01,2.78,2.81,2.50,2.57,-0.02,-0.77,165000,25,442040,0,0,0,0,0,0,128000,40000,88000,88000
20200212,708464,昂寶元大98購01,1.19,1.19,1.19,1.19,0.00,0.0,100000,1,119000,0,0,0,0,0,0,0,100000,-100000,-100000
20200212,708465,璟德元大97購01,1.95,2.09,1.89,2.00,-0.06,-2.91,487000,35,976380,0,0,0,0,0,0,451000,428000,23000,23000
20200212,708466,璟德元大97購02,1.76,1.90,1.73,1.90,+0.09,4.97,255000,21,464400,0,0,0,0,0,0,170000,87000,83000,83000
20200212,708467,優群元大97購04,1.02,1.10,1.01,1.07,+0.06,5.94,568000,26,599610,0,0,0,0,0,0,548000,558000,-10000,-10000
20200212,708468,兆利康和97購01,0.56,0.57,0.56,0.57,-0.01,-1.72,196000,4,110160,0,0,0,0,0,0,156000,40000,116000,116000
20200212,708469,璟德康和97購01,0.86,0.92,0.86,0.92,-0.02,-2.13,72000,7,63910,0,0,0,0,0,0,72000,0,72000,72000
20200212,708470,璟德元富97購01,1.67,1.87,1.67,1.79,+0.01,0.56,195000,27,345710,0,0,0,0,0,0,195000,0,195000,195000
20200212,708471,璟德台新97購01,0.85,0.91,0.85,0.88,-0.04,-4.35,310000,22,273520,0,0,0,0,0,0,248000,60000,188000,188000
20200212,708472,三貝德凱基99購01,0.30,0.30,0.24,0.24,-0.01,-4.0,1042000,35,275190,0,0,0,0,0,0,545000,366000,179000,179000
20200212,708473,大田凱基98購01,,,,,,0.00,0,0,0,0,0,0,0,0,0,0,0,0,0
20200212,708474,中美晶凱基97購02,1.89,1.89,1.89,1.89,+0.26,15.95,10000,1,18900,0,0,0,0,0,0,0,10000,-10000,-10000
20200212,708475,宇峻凱基9A購01,0.69,0.71,0.62,0.68,-0.10,-12.82,496000,18,332510,0,0,0,0,0,0,392000,51000,341000,341000
20200212,708476,網龍凱基98購01,0.75,0.75,0.75,0.75,-0.06,-7.41,1000,1,750,0,0,0,0,0,0,1000,0,1000,1000
20200212,708477,鈊象凱基99購01,2.25,2.28,1.13,2.10,-0.17,-7.49,124000,11,259560,0,0,0,0,0,0,52000,72000,-20000,-20000
20200212,708478,穩懋日盛97購02,1.99,2.50,1.95,2.34,+0.37,18.78,510000,41,1069520,0,0,0,0,0,0,194000,316000,-122000,-122000
20200212,708479,立端永豐97購01,0.52,0.61,0.52,0.61,+0.16,35.56,52000,2,30820,0,0,0,0,0,0,0,52000,-52000,-52000
20200212,708480,宇峻永豐97購01,0.82,0.85,0.75,0.83,-0.11,-11.7,187000,10,149750,0,0,0,0,0,0,110000,77000,33000,33000
20200212,708481,迅得永豐97購03,0.78,0.87,0.78,0.86,+0.07,8.86,460000,11,390980,0,0,0,0,0,0,128000,332000,-204000,-204000
20200212,708482,神盾永豐97購01,0.73,0.78,0.73,0.74,+0.06,8.82,316000,24,236650,0,0,0,0,0,0,90000,231000,-141000,-141000
20200212,708483,璟德永豐97購02,0.63,0.67,0.62,0.63,0.00,0.0,137000,6,88320,0,0,0,0,0,0,3000,134000,-131000,-131000
20200212,708484,璟德國泰98購01,1.66,1.78,1.63,1.70,-0.06,-3.41,396000,40,666040,0,0,0,0,0,0,346000,42000,304000,304000
20200212,708485,六角國票97購01,1.16,1.36,1.14,1.25,+0.14,12.61,304000,22,369700,0,0,0,0,0,0,142000,144000,-2000,-2000
20200212,708486,昂寶國票98購01,,,,,,0.00,0,0,0,0,0,0,0,0,0,0,0,0,0
20200212,708487,信昌電國票98購01,,,,,,0.00,0,0,0,0,0,0,0,0,0,0,0,0,0
20200212,708488,威剛國票98購01,3.14,3.43,3.11,3.33,+0.31,10.26,352000,41,1157970,0,0,0,0,0,0,130000,222000,-92000,-92000
20200212,708489,群聯國票98購01,,,,,,0.00,0,0,0,0,0,0,0,0,0,0,0,0,0
20200212,708490,雍智國票98購01,0.74,0.83,0.74,0.80,+0.07,9.59,216000,12,163300,0,0,0,0,0,0,208000,8000,200000,200000
20200212,708491,雙美國票99購01,0.58,0.58,0.58,0.58,+0.22,61.11,10000,1,5800,0,0,0,0,0,0,0,10000,-10000,-10000
20200212,708492,雙鴻國票98購02,0.31,0.37,0.31,0.37,+0.04,12.12,496000,26,181400,0,0,0,0,0,0,456000,40000,416000,416000
20200212,708493,鈊象國票98購01,10.10,10.10,9.25,9.40,-0.70,-6.93,10000,6,95850,0,0,0,0,0,0,2000,10000,-8000,-8000
20200212,708494,大江群益97購02,0.65,0.65,0.62,0.62,-0.01,-1.59,97000,18,61230,0,0,0,0,0,0,97000,0,97000,97000
20200212,708495,信昌電群益97購01,0.64,0.64,0.63,0.63,-0.01,-1.56,8000,2,5110,0,0,0,0,0,0,0,8000,-8000,-8000
20200212,708496,建榮群益99購01,,,,,,0.00,0,0,0,0,0,0,0,0,0,0,0,0,0
20200212,708497,原相群益99購01,2.12,2.38,2.10,2.21,-0.01,-0.45,1462000,110,3233250,0,0,0,0,0,0,722000,659000,63000,63000
20200212,708498,勝麗群益98購01,1.35,1.56,1.35,1.43,+0.08,5.93,299000,19,425070,0,0,0,0,0,0,147000,152000,-5000,-5000
20200212,708499,璟德群益98購01,1.90,2.07,1.90,1.99,-0.08,-3.86,443000,26,905160,0,0,0,0,0,0,323000,124000,199000,199000
20200212,708500,鈊象群益99購05,4.74,4.74,4.26,4.31,-0.34,-7.31,50000,9,227530,0,0,0,0,0,0,35000,18000,17000,17000
20200212,708501,力致元大97購01,0.80,0.80,0.79,0.79,-0.01,-1.25,147000,3,116400,0,0,0,0,0,0,147000,0,147000,147000
20200212,708502,中美晶元大97購04,2.55,2.55,2.55,2.55,+0.43,20.28,25000,4,63750,0,0,0,0,0,0,25000,25000,0,0
20200212,708503,世禾元大97購01,1.37,1.49,1.36,1.48,+0.20,15.62,703000,24,1000290,0,0,0,0,0,0,136000,617000,-481000,-481000
20200212,708504,尼克森元大97購01,0.75,0.82,0.75,0.80,+0.06,8.11,150000,4,118500,0,0,0,0,0,0,50000,100000,-50000,-50000
20200212,708505,宇峻元大97購03,2.05,2.20,2.05,2.20,-0.33,-13.04,36000,4,75750,0,0,0,0,0,0,31000,5000,26000,26000
20200212,708506,信昌電元大98購01,0.88,0.88,0.85,0.86,-0.01,-1.15,104000,8,90180,0,0,0,0,0,0,50000,54000,-4000,-4000
20200212,708507,碩禾元大98購02,0.58,0.59,0.56,0.56,-0.02,-3.45,590000,11,336550,0,0,0,0,0,0,448000,400000,48000,48000
20200212,708508,雙鴻元大99購02,0.48,0.48,0.47,0.47,+0.03,6.82,20000,3,9440,0,0,0,0,0,0,20000,0,20000,20000
20200212,708509,尼克森統一99購01,0.64,0.68,0.64,0.68,+0.05,7.94,336000,4,221280,0,0,0,0,0,0,244000,92000,152000,152000
20200212,708510,尼克森統一99購02,,,,,,0.00,0,0,0,0,0,0,0,0,0,0,0,0,0
20200212,708511,迅得統一99購01,0.65,0.70,0.65,0.70,+0.09,14.75,293000,10,198500,0,0,0,0,0,0,0,293000,-293000,-293000
20200212,708512,頎邦統一97購01,0.84,0.88,0.82,0.88,+0.06,7.32,672000,36,581710,0,0,0,0,0,0,479000,193000,286000,286000
20200212,708513,M31中信98購01,0.58,0.58,0.58,0.58,+0.07,13.73,100000,1,58000,0,0,0,0,0,0,0,100000,-100000,-100000
20200212,708514,大中中信97購01,,,,,,0.00,0,0,0,0,0,0,0,0,0,0,0,0,0
20200212,708515,宇峻中信97購01,0.84,0.87,0.73,0.80,-0.21,-20.79,810000,30,665870,0,0,0,0,0,0,328000,482000,-154000,-154000
20200212,708516,博智中信97購01,0.69,0.80,0.69,0.73,+0.07,10.61,811000,46,608880,0,0,0,0,0,0,300000,380000,-80000,-80000
20200212,708517,大中凱基98購02,,,,,,0.00,0,0,0,0,0,0,0,0,0,0,0,0,0
20200212,708518,同致凱基98購01,,,,,,0.00,0,0,0,0,0,0,0,0,0,0,0,0,0
20200212,708519,合晶凱基97購02,0.55,0.56,0.52,0.52,+0.10,23.81,125000,3,68750,0,0,0,0,0,0,20000,105000,-85000,-85000
20200212,708520,朋億凱基97購01,,,,,,0.00,0,0,0,0,0,0,0,0,0,0,0,0,0
20200212,708521,南光凱基97購01,1.35,1.35,1.27,1.27,-0.08,-5.93,234000,14,303460,0,0,0,0,0,0,166000,66000,100000,100000
20200212,708522,緯軟凱基98購03,0.41,0.41,0.41,0.41,+0.01,2.5,210000,2,86100,0,0,0,0,0,0,200000,10000,190000,190000
20200212,708523,大江兆豐97購01,0.22,0.22,0.22,0.22,0.00,0.0,620000,3,136400,0,0,0,0,0,0,620000,0,620000,620000
20200212,708524,中美晶兆豐98購01,0.45,0.52,0.45,0.46,0.00,0.0,693000,26,339520,0,0,0,0,0,0,130000,553000,-423000,-423000
20200212,708525,台燿兆豐97購02,1.08,1.17,1.08,1.17,+0.19,19.39,525000,20,588020,0,0,0,0,0,0,63000,462000,-399000,-399000
20200212,708526,精華兆豐98購01,1.85,1.88,1.85,1.86,+0.04,2.2,57000,4,106460,0,0,0,0,0,0,37000,20000,17000,17000
20200212,708527,中美晶群益97購03,0.70,0.82,0.70,0.76,+0.07,10.14,225000,22,176760,0,0,0,0,0,0,24000,225000,-201000,-201000
20200212,708528,太景*群益98購01,1.37,1.42,1.31,1.37,0.00,0.0,958000,43,1304320,0,0,0,0,0,0,476000,284000,192000,192000
20200212,708529,立端群益97購01,0.62,0.75,0.62,0.75,+0.20,36.36,482000,7,310160,0,0,0,0,0,0,0,482000,-482000,-482000
20200212,708530,朋億群益98購01,0.91,0.95,0.91,0.94,-0.02,-2.08,432000,5,405960,0,0,0,0,0,0,302000,130000,172000,172000
20200212,708531,欣銓群益98購01,0.69,0.70,0.69,0.69,+0.01,1.47,132000,4,91090,0,0,0,0,0,0,128000,4000,124000,124000
20200212,708532,群聯群益97購02,0.54,0.55,0.53,0.55,+0.02,3.77,183000,3,97850,0,0,0,0,0,0,83000,100000,-17000,-17000
20200212,708533,緯軟群益98購01,0.52,0.52,0.52,0.52,+0.03,6.12,100000,1,52000,0,0,0,0,0,0,100000,0,100000,100000
20200212,708534,環球晶群益97購03,2.01,2.20,1.99,2.13,+0.17,8.67,90000,9,189340,0,0,0,0,0,0,90000,5000,85000,85000
20200212,708535,譜瑞群益97購01,3.29,3.79,3.21,3.53,+0.31,9.63,617000,61,2175740,0,0,0,0,0,0,344000,312000,32000,32000
20200212,708536,建榮國票98購02,,,,,,0.00,0,0,0,0,0,0,0,0,0,0,0,0,0
20200212,708537,力致國泰99購01,1.07,1.10,1.06,1.06,0.00,0.0,156000,13,166750,0,0,0,0,0,0,60000,96000,-36000,-36000
20200212,708538,凡甲國泰99購01,0.71,0.75,0.71,0.75,-0.03,-3.85,278000,16,207180,0,0,0,0,0,0,278000,0,278000,278000
20200212,708539,中菲行國泰98購01,1.24,1.24,1.24,1.24,+0.03,2.48,80000,8,99200,0,0,0,0,0,0,0,80000,-80000,-80000
20200212,708540,世禾國泰98購01,1.43,1.49,1.40,1.49,+0.19,14.62,414000,22,595620,0,0,0,0,0,0,20000,394000,-374000,-374000
20200212,708541,尼克森國泰99購01,0.82,0.86,0.82,0.86,+0.05,6.17,46000,6,38760,0,0,0,0,0,0,10000,36000,-26000,-26000
20200212,708542,幃翔國泰98購01,0.82,0.82,0.82,0.82,-0.03,-3.53,20000,1,16400,0,0,0,0,0,0,20000,0,20000,20000
20200212,708543,幃翔國泰98購02,,,,,,0.00,0,0,0,0,0,0,0,0,0,0,0,0,0
20200212,708544,群聯國泰99購01,1.05,1.10,1.05,1.08,+0.08,8.0,62000,6,67070,0,0,0,0,0,0,43000,59000,-16000,-16000
20200212,708545,雙鴻國泰99購01,0.83,0.95,0.83,0.92,+0.03,3.37,148000,42,131880,0,0,0,0,0,0,87000,61000,26000,26000
20200212,708546,力致永豐97購01,,,,,,0.00,0,0,0,0,0,0,0,0,0,0,0,0,0
20200212,708547,世禾永豐97購01,0.76,0.78,0.74,0.78,+0.10,14.71,189000,8,145400,0,0,0,0,0,0,0,189000,-189000,-189000
20200212,708548,尼克森永豐97購01,0.54,0.57,0.54,0.56,+0.02,3.7,102000,4,56340,0,0,0,0,0,0,72000,30000,42000,42000
20200212,708549,立敦永豐97購01,0.48,0.48,0.48,0.48,0.00,0.0,68000,1,32640,0,0,0,0,0,0,68000,0,68000,68000
20200212,708550,同亨永豐97購01,,,,,,0.00,0,0,0,0,0,0,0,0,0,0,0,0,0
20200212,708551,直得永豐97購01,,,,,,0.00,0,0,0,0,0,0,0,0,0,0,0,0,0
20200212,708552,南光永豐97購01,0.89,0.91,0.86,0.87,-0.05,-5.43,123000,10,109080,0,0,0,0,0,0,48000,70000,-22000,-22000
20200212,708553,威剛永豐98購01,1.40,1.53,1.40,1.47,+0.10,7.3,505000,44,744980,0,0,0,0,0,0,289000,206000,83000,83000
20200212,708554,幃翔永豐97購01,,,,,,0.00,0,0,0,0,0,0,0,0,0,0,0,0,0
20200212,708555,新潤永豐97購01,0.60,0.60,0.59,0.59,0.00,0.0,200000,20,119000,0,0,0,0,0,0,0,200000,-200000,-200000
20200212,708556,網龍永豐97購01,,,,,,0.00,0,0,0,0,0,0,0,0,0,0,0,0,0
20200212,708557,緯軟永豐97購01,0.37,0.37,0.37,0.37,+0.01,2.78,160000,1,59200,0,0,0,0,0,0,160000,0,160000,160000
20200212,708558,環球晶永豐97購01,1.30,1.33,1.30,1.33,+0.15,12.71,69000,2,89730,0,0,0,0,0,0,69000,1000,68000,68000
20200212,708559,聯上永豐97購01,0.52,0.52,0.52,0.52,0.00,0.0,50000,1,26000,0,0,0,0,0,0,0,50000,-50000,-50000
20200212,708560,大中康和97購01,,,,,,0.00,0,0,0,0,0,0,0,0,0,0,0,0,0
20200212,708561,亞泰康和97購01,0.66,0.68,0.64,0.64,-0.01,-1.54,74000,14,48960,0,0,0,0,0,0,65000,9000,56000,56000
20200212,708562,博智康和97購01,1.01,1.09,0.99,1.01,+0.03,3.06,737000,34,755850,0,0,0,0,0,0,234000,475000,-241000,-241000
20200212,708563,力致元富97購01,0.62,0.64,0.61,0.61,-0.01,-1.61,343000,8,213330,0,0,0,0,0,0,273000,70000,203000,203000
20200212,708564,中菲行元富97購01,0.75,0.83,0.75,0.83,+0.08,10.67,40000,2,32400,0,0,0,0,0,0,0,40000,-40000,-40000
20200212,708565,太景*元富97購01,3.02,3.08,2.89,2.99,+0.06,2.05,311000,20,920320,0,0,0,0,0,0,186000,20000,166000,166000
20200212,708566,世禾元富97購01,1.06,1.20,1.04,1.20,+0.18,17.65,155000,14,171100,0,0,0,0,0,0,25000,130000,-105000,-105000
20200212,708567,尼克森元富97購01,0.50,0.50,0.50,0.50,+0.02,4.17,8000,1,4000,0,0,0,0,0,0,0,8000,-8000,-8000
20200212,708568,幃翔元富97購01,0.45,0.45,0.45,0.45,0.00,0.0,5000,1,2250,0,0,0,0,0,0,5000,0,5000,5000
20200212,708569,力致統一97購01,0.62,0.63,0.62,0.63,+0.04,6.78,69000,4,42870,0,0,0,0,0,0,69000,0,69000,69000
20200212,708570,力致統一97購02,0.82,0.90,0.82,0.90,+0.09,11.11,113000,7,93900,0,0,0,0,0,0,90000,23000,67000,67000
20200212,708571,環球晶統一97購01,2.40,2.58,2.40,2.48,+0.09,3.77,218000,6,541720,0,0,0,0,0,0,161000,57000,104000,104000
20200212,708572,兆利凱基98購02,0.53,0.53,0.53,0.53,-0.04,-7.02,107000,3,56710,0,0,0,0,0,0,77000,30000,47000,47000
20200212,708573,昂寶凱基98購02,,,,,,0.00,0,0,0,0,0,0,0,0,0,0,0,0,0
20200212,708574,威剛凱基99購01,1.15,1.26,1.13,1.23,+0.13,11.82,292000,32,349610,0,0,0,0,0,0,238000,4000,234000,234000
20200212,708575,精測凱基98購01,1.13,1.16,1.13,1.16,+0.08,7.41,20000,5,23020,0,0,0,0,0,0,10000,20000,-10000,-10000
20200212,708576,聯亞凱基99購01,0.33,0.34,0.32,0.32,0.00,0.0,1407000,10,466290,0,0,0,0,0,0,995000,410000,585000,585000
20200212,708577,頎邦凱基97購03,0.41,0.41,0.41,0.41,+0.02,5.13,1000,1,410,0,0,0,0,0,0,1000,0,1000,1000
20200212,708578,中美晶麥證97購01,1.33,1.49,1.33,1.49,+0.15,11.19,60000,6,84200,20000,40000,-20000,0,0,0,20000,40000,-20000,-20000
20200212,708579,原相麥證97購01,1.33,1.47,1.33,1.38,+0.03,2.22,46000,14,63170,29000,14000,15000,0,0,0,29000,16000,13000,13000
20200212,708580,神盾元富97購01,1.02,1.07,1.00,1.06,+0.12,12.77,1438000,37,1489970,0,0,0,0,0,0,1265000,76000,1189000,1189000
20200212,708581,神盾元富97購02,0.69,0.73,0.67,0.69,+0.02,2.99,2140000,59,1489390,0,0,0,0,0,0,1646000,247000,1399000,1399000
20200212,708582,宇峻元大97購04,2.17,2.17,1.92,2.09,-0.46,-18.04,94000,7,197690,0,0,0,0,0,0,22000,72000,-50000,-50000
20200212,708583,亞泰元大97購01,1.26,1.26,1.22,1.22,+0.02,1.67,62000,6,77080,0,0,0,0,0,0,62000,0,62000,62000
20200212,708584,威剛元大98購02,1.35,1.49,1.34,1.41,+0.11,8.46,1005000,74,1433200,0,0,0,0,0,0,649000,469000,180000,180000
20200212,708585,建榮元大97購02,0.97,0.98,0.97,0.98,+0.02,2.08,690000,3,673680,0,0,0,0,0,0,690000,690000,0,0
20200212,708586,原相元大98購01,2.28,2.38,2.20,2.36,+0.02,0.85,239000,38,545960,0,0,0,0,0,0,223000,40000,183000,183000
20200212,708587,原相元大99購01,2.50,2.71,2.39,2.60,+0.04,1.56,919000,85,2327190,0,0,0,0,0,0,693000,324000,369000,369000
20200212,708588,群聯元大98購01,0.89,0.89,0.89,0.89,+0.02,2.3,6000,1,5340,0,0,0,0,0,0,0,0,0,0
20200212,708589,聯亞元大98購01,0.80,0.80,0.76,0.76,+0.04,5.56,94000,7,72430,0,0,0,0,0,0,83000,31000,52000,52000
20200212,708590,雙美元大99購01,1.12,1.20,1.09,1.20,+0.34,39.53,263000,6,290430,0,0,0,0,0,0,167000,91000,76000,76000
20200212,708591,雙鴻元大99購03,0.50,0.55,0.50,0.54,+0.02,3.85,90000,10,47850,0,0,0,0,0,0,23000,67000,-44000,-44000
20200212,708592,穩懋元大97購03,3.01,3.62,2.91,3.45,+0.53,18.15,791000,88,2536210,0,0,0,0,0,0,760000,713000,47000,47000
20200212,708593,穩懋元大97購04,1.70,2.03,1.65,1.94,+0.29,17.58,470000,83,833200,0,0,0,0,0,0,425000,324000,101000,101000
20200212,708594,鈊象元大99購01,2.23,2.23,2.01,2.03,-0.18,-8.14,1098000,54,2280750,0,2000,-2000,0,0,0,521000,570000,-49000,-51000
20200212,708595,大江兆豐97購02,,,,,,0.00,0,0,0,0,0,0,0,0,0,0,0,0,0
20200212,708596,群聯兆豐98購01,0.67,0.67,0.65,0.65,+0.01,1.56,110000,6,73200,0,0,0,0,0,0,40000,60000,-20000,-20000
20200212,708597,迅得康和97購01,0.76,0.77,0.76,0.77,+0.09,13.24,79000,3,60640,0,0,0,0,0,0,0,79000,-79000,-79000
20200212,708598,六角群益98購02,0.68,0.85,0.68,0.85,+0.19,28.79,4502000,42,3380890,0,0,0,0,0,0,499000,4482000,-3983000,-3983000
20200212,708599,亞泰群益97購01,1.20,1.22,1.15,1.16,-0.05,-4.13,309000,26,366620,0,0,0,0,0,0,299000,0,299000,299000
20200212,708600,台燿亞東97購01,,,,,,0.00,0,0,0,0,0,0,0,0,0,0,0,0,0
20200212,708601,光頡永豐97購01,0.91,0.91,0.91,0.91,-0.05,-5.21,15000,1,13650,0,0,0,0,0,0,15000,0,15000,15000
20200212,708602,亞泰永豐97購01,0.47,0.49,0.47,0.49,+0.01,2.08,150000,2,71040,0,0,0,0,0,0,150000,0,150000,150000
20200212,708603,力致元富97購02,0.80,0.80,0.80,0.80,+0.03,3.9,10000,1,8000,0,0,0,0,0,0,10000,0,10000,10000
20200212,708604,鈺太元富97購01,1.03,1.40,1.03,1.35,+0.32,31.07,155000,19,180610,0,0,0,0,0,0,0,155000,-155000,-155000
20200212,708605,久元台新97購01,0.85,0.86,0.85,0.86,+0.03,3.61,134000,6,114280,0,0,0,0,0,0,0,124000,-124000,-124000
20200212,708606,大中台新97購01,0.52,0.52,0.51,0.52,+0.05,10.64,1644000,9,854830,0,0,0,0,0,0,1404000,40000,1364000,1364000
20200212,708607,晶焱台新97購01,0.80,0.81,0.80,0.81,+0.08,10.96,110000,4,88540,0,0,0,0,0,0,10000,100000,-90000,-90000
20200212,708608,光頡統一97購01,1.18,1.18,1.16,1.17,-0.06,-4.88,69000,3,81160,0,0,0,0,0,0,69000,0,69000,69000
20200212,708609,光頡統一99購01,0.66,0.66,0.66,0.66,-0.08,-10.81,18000,1,11880,0,0,0,0,0,0,18000,0,18000,18000
20200212,708610,合晶統一97購01,0.79,0.97,0.79,0.97,+0.24,32.88,444000,9,378620,0,0,0,0,0,0,0,444000,-444000,-444000
20200212,708611,大中中信99購01,,,,,,0.00,0,0,0,0,0,0,0,0,0,0,0,0,0
20200212,708612,亞泰中信97購01,,,,,,0.00,0,0,0,0,0,0,0,0,0,0,0,0,0
20200212,708613,博智中信99購01,0.97,1.07,0.95,1.00,+0.08,8.7,1002000,41,1004720,0,0,0,0,0,0,762000,240000,522000,522000
20200212,708614,緯軟中信97購01,0.26,0.26,0.26,0.26,0.00,0.0,200000,3,52000,0,0,0,0,0,0,200000,0,200000,200000
20200212,708615,台半凱基98購01,0.70,0.75,0.70,0.74,0.00,0.0,25000,5,18420,0,0,0,0,0,0,15000,10000,5000,5000
20200212,708616,兆利凱基98購03,0.58,0.58,0.58,0.58,0.00,0.0,122000,3,70760,0,0,0,0,0,0,122000,0,122000,122000
20200212,708617,宇峻凱基99購01,0.72,0.76,0.67,0.71,-0.14,-16.47,306000,17,214490,0,0,0,0,0,0,195000,111000,84000,84000
20200212,708618,新普凱基98購01,1.77,1.81,1.66,1.69,+0.04,2.42,108000,12,185580,0,0,0,0,0,0,0,108000,-108000,-108000
20200212,708619,璟德凱基98購01,1.20,1.30,1.19,1.27,-0.04,-3.05,285000,21,361950,0,0,0,0,0,0,227000,58000,169000,169000
20200212,708620,環球晶凱基97購02,2.81,2.81,2.81,2.81,+0.21,8.08,1000,1,2810,0,0,0,0,0,0,1000,1000,0,0
20200212,708621,頎邦第一97購01,0.41,0.43,0.41,0.43,+0.03,7.5,124000,12,51870,0,0,0,0,0,0,124000,0,124000,124000
20200212,708622,光頡永豐97購02,0.59,0.59,0.58,0.58,-0.04,-6.45,133000,4,77930,0,0,0,0,0,0,131000,2000,129000,129000
20200212,708623,建榮永豐98購01,,,,,,0.00,0,0,0,0,0,0,0,0,0,0,0,0,0
20200212,708624,雙美永豐98購01,0.82,0.91,0.82,0.91,+0.28,44.44,121000,9,104610,0,0,0,0,0,0,50000,71000,-21000,-21000
20200212,708625,雙鴻永豐98購01,0.62,0.71,0.62,0.68,+0.03,4.62,627000,18,416340,0,0,0,0,0,0,225000,402000,-177000,-177000
20200212,708626,亞泰國票97購01,1.36,1.41,1.30,1.36,-0.02,-1.45,279000,21,380060,0,0,0,0,0,0,259000,20000,239000,239000
20200212,708627,新普國票98購01,3.07,3.12,3.07,3.12,+0.32,11.43,33000,3,102260,0,0,0,0,0,0,23000,13000,10000,10000
20200212,708628,廣明國票98購01,1.52,1.55,1.50,1.55,-0.02,-1.27,133000,8,203240,0,0,0,0,0,0,38000,95000,-57000,-57000
20200212,708629,璟德國票98購01,2.62,2.81,2.62,2.81,+0.11,4.07,218000,3,605360,0,0,0,0,0,0,38000,180000,-142000,-142000
20200212,708630,環宇國票98購01,0.74,0.76,0.74,0.76,0.00,0.0,105000,3,78700,0,0,0,0,0,0,105000,0,105000,105000
20200212,708631,頎邦國票98購01,1.09,1.11,1.09,1.11,-0.01,-0.89,93000,28,101630,0,0,0,0,0,0,93000,0,93000,93000
20200212,708632,M31元大98購01,0.88,0.89,0.88,0.88,+0.04,4.76,267000,8,235460,0,0,0,0,0,0,0,267000,-267000,-267000
20200212,708633,昂寶元大98購02,1.22,1.22,1.21,1.21,-0.02,-1.63,120000,2,146200,0,0,0,0,0,0,20000,100000,-80000,-80000
20200212,708634,信昌電元大98購02,0.94,0.94,0.90,0.90,-0.03,-3.23,65000,4,60500,0,0,0,0,0,0,60000,5000,55000,55000
20200212,708635,建榮元大97購03,,,,,,0.00,0,0,0,0,0,0,0,0,0,0,0,0,0
20200212,708636,原相元大98購02,2.25,2.46,2.16,2.31,+0.01,0.43,1234000,95,2832910,0,0,0,0,0,0,990000,439000,551000,551000
20200212,708637,群聯元大98購02,,,,,,0.00,0,0,0,0,0,0,0,0,0,0,0,0,0
20200212,708638,精測元大97購04,1.10,1.14,1.06,1.13,+0.07,6.6,124000,16,136720,0,0,0,0,0,0,106000,50000,56000,56000
20200212,708639,網龍元大97購01,0.84,0.84,0.82,0.82,-0.08,-8.89,6000,2,4940,0,0,0,0,0,0,1000,5000,-4000,-4000
20200212,708640,璟德元大97購03,2.11,2.30,2.07,2.18,-0.08,-3.54,313000,28,685520,0,0,0,0,0,0,239000,78000,161000,161000
20200212,708641,鈊象元大98購02,2.67,2.78,2.47,2.51,-0.23,-8.39,279000,26,725870,0,0,0,0,0,0,184000,99000,85000,85000
20200212,708642,頎邦元大97購03,1.17,1.19,1.15,1.19,+0.06,5.31,176000,19,205780,0,0,0,0,0,0,150000,76000,74000,74000
20200212,708643,頎邦元大97購04,1.08,1.10,1.07,1.10,+0.05,4.76,397000,11,435300,0,0,0,0,0,0,255000,142000,113000,113000
20200212,708644,雙美國泰99購01,0.86,1.02,0.86,1.02,+0.32,45.71,133000,6,121030,0,0,0,0,0,0,0,132000,-132000,-132000
20200212,708645,聯亞兆豐98購01,0.70,0.71,0.69,0.69,+0.04,6.15,204000,8,141400,0,0,0,0,0,0,7000,197000,-190000,-190000
20200212,708646,櫃200兆豐97購01,,,,,,0.00,0,0,0,0,0,0,0,0,0,0,0,0,0
20200212,708647,泰博群益97購01,2.81,2.85,2.78,2.78,+0.04,1.46,87000,14,244490,0,0,0,0,0,0,52000,35000,17000,17000
20200212,708648,VHQ中信97購01,,,,,,0.00,0,0,0,0,0,0,0,0,0,0,0,0,0
20200212,708649,鈊象中信97購01,1.99,1.99,1.75,1.75,-0.19,-9.79,818000,34,1501750,0,0,0,0,0,0,629000,160000,469000,469000
20200212,708650,迅得麥證98購01,0.53,0.54,0.53,0.54,+0.04,8.0,2000,2,1070,0,2000,-2000,0,0,0,0,2000,-2000,-2000
20200212,708651,大學光元富99購01,2.44,2.57,2.44,2.57,+0.15,6.2,37000,4,92740,0,0,0,0,0,0,17000,27000,-10000,-10000
20200212,708652,光頡元富97購01,0.92,0.92,0.88,0.89,-0.08,-8.25,112000,3,99960,0,0,0,0,0,0,112000,0,112000,112000
20200212,708653,神盾元富97購03,1.06,1.15,1.06,1.08,+0.06,5.88,1632000,49,1802570,0,0,0,0,0,0,1495000,87000,1408000,1408000
20200212,708654,力致統一97購03,0.41,0.43,0.41,0.42,+0.01,2.44,666000,20,280560,0,0,0,0,0,0,666000,0,666000,666000
20200212,708655,波若威統一99購01,0.66,0.68,0.66,0.68,+0.04,6.25,40000,4,26900,0,0,0,0,0,0,20000,20000,0,0
20200212,708656,信昌電統一98購01,,,,,,0.00,0,0,0,0,0,0,0,0,0,0,0,0,0
20200212,708657,兆利台新97購01,0.69,0.72,0.66,0.72,+0.04,5.88,308000,13,208360,0,0,0,0,0,0,276000,32000,244000,244000
20200212,708658,神盾台新98購01,0.95,1.03,0.95,0.99,+0.08,8.79,687000,38,682810,0,0,0,0,0,0,567000,60000,507000,507000
20200212,708659,合晶凱基97購03,1.25,1.25,1.23,1.23,+0.24,24.24,30000,3,37200,0,0,0,0,0,0,0,30000,-30000,-30000
20200212,708660,宇峻凱基99購02,0.81,0.81,0.49,0.78,-0.18,-18.75,324000,7,251650,0,0,0,0,0,0,309000,10000,299000,299000
20200212,708661,良維凱基97購03,,,,,,0.00,0,0,0,0,0,0,0,0,0,0,0,0,0
20200212,708662,信昌電凱基98購02,,,,,,0.00,0,0,0,0,0,0,0,0,0,0,0,0,0
20200212,708663,茂達凱基97購01,1.18,1.18,1.18,1.18,+0.07,6.31,18000,4,21240,0,0,0,0,0,0,18000,0,18000,18000
20200212,708664,群聯凱基98購02,1.05,1.05,1.05,1.05,+0.08,8.25,8000,1,8400,0,0,0,0,0,0,8000,8000,0,0
20200212,708665,網家凱基97購01,3.12,3.13,3.04,3.04,-0.06,-1.94,125000,18,383570,0,0,0,0,0,0,115000,10000,105000,105000
20200212,708666,聚積凱基97購01,0.90,0.95,0.90,0.93,+0.06,6.9,483000,9,454200,0,0,0,0,0,0,402000,80000,322000,322000
20200212,708667,廣明凱基98購02,0.57,0.60,0.57,0.60,+0.04,7.14,111000,7,63500,0,0,0,0,0,0,9000,100000,-91000,-91000
20200212,708668,優群凱基98購03,0.74,0.74,0.74,0.74,+0.06,8.82,20000,1,14800,0,0,0,0,0,0,0,20000,-20000,-20000
20200212,708669,聯亞凱基99購02,,,,,,0.00,0,0,0,0,0,0,0,0,0,0,0,0,0
20200212,708670,鈺太凱基98購01,0.54,0.70,0.54,0.70,+0.16,29.63,314000,10,179300,0,0,0,0,0,0,74000,240000,-166000,-166000
20200212,708671,頎邦凱基97購04,1.51,1.57,1.51,1.56,+0.09,6.12,78000,18,120770,0,0,0,0,0,0,47000,48000,-1000,-1000
20200212,708672,M31元大99購01,0.78,0.78,0.77,0.77,+0.04,5.48,317000,6,246960,0,0,0,0,0,0,230000,87000,143000,143000
20200212,708673,凡甲元大98購02,,,,,,0.00,0,0,0,0,0,0,0,0,0,0,0,0,0
20200212,708674,大宇資元大98購01,0.89,0.89,0.88,0.89,-0.02,-2.2,155000,6,137150,0,0,0,0,0,0,30000,125000,-95000,-95000
20200212,708675,六角元大98購02,1.01,1.19,1.01,1.11,+0.12,12.12,154000,12,174550,0,0,0,0,0,0,142000,144000,-2000,-2000
20200212,708676,昂寶元大97購02,1.21,1.21,1.21,1.21,0.00,0.0,100000,1,121000,0,0,0,0,0,0,0,100000,-100000,-100000
20200212,708677,晶焱元大98購01,1.11,1.13,1.09,1.09,+0.09,9.0,222000,14,245260,0,0,0,0,0,0,153000,69000,84000,84000
20200212,708678,鈊象元大97購04,,,,,,0.00,0,0,0,0,0,0,0,0,0,0,0,0,0
20200212,708679,光頡國票98購01,2.04,2.11,2.00,2.11,-0.03,-1.4,74000,8,148890,0,0,0,0,0,0,74000,0,74000,74000
20200212,708680,金居國票98購01,0.64,0.65,0.64,0.65,+0.13,25.0,40000,4,25700,0,0,0,0,0,0,0,40000,-40000,-40000
20200212,708681,建榮國票99購01,,,,,,0.00,0,0,0,0,0,0,0,0,0,0,0,0,0
20200212,708682,穩懋國票98購01,3.23,4.22,3.23,3.87,+0.61,18.71,362000,49,1291020,0,0,0,0,0,0,162000,200000,-38000,-38000
20200212,708683,鈊象國票97購03,11.80,11.80,10.30,10.30,-1.50,-12.71,68000,3,759400,0,0,0,0,0,0,38000,30000,8000,8000
20200212,708684,光頡國泰98購01,2.18,2.18,2.13,2.14,-0.09,-4.04,258000,16,557020,0,0,0,0,0,0,218000,40000,178000,178000
20200212,708685,亞泰國泰98購01,1.18,1.19,1.15,1.15,-0.02,-1.71,264000,39,309500,0,0,0,0,0,0,264000,33000,231000,231000
20200212,708686,世界兆豐97購01,2.35,2.36,2.35,2.36,+0.18,8.26,11000,2,25860,0,0,0,0,0,0,0,11000,-11000,-11000
20200212,708687,同致兆豐98購01,0.72,0.72,0.72,0.72,+0.02,2.86,10000,1,7200,0,0,0,0,0,0,10000,0,10000,10000
20200212,708688,宜鼎兆豐98購01,2.91,2.91,2.70,2.72,-0.01,-0.37,129000,14,359820,0,0,0,0,0,0,70000,59000,11000,11000
20200212,708689,勝麗群益98購02,1.78,2.02,1.78,1.86,+0.06,3.33,376000,16,732330,0,0,0,0,0,0,262000,114000,148000,148000
20200212,708690,晟德群益97購01,,,,,,0.00,0,0,0,0,0,0,0,0,0,0,0,0,0
20200212,708691,穩懋永豐97購02,1.92,2.34,1.87,2.22,+0.33,17.46,1389000,59,2938160,0,0,0,0,0,0,1317000,1185000,132000,132000
20200212,708692,元太亞東97購01,,,,,,0.00,0,0,0,0,0,0,0,0,0,0,0,0,0
20200212,708693,台半中信99購01,0.57,0.60,0.57,0.60,+0.01,1.69,598000,9,352490,0,0,0,0,0,0,590000,8000,582000,582000
20200212,708694,M31統一98購01,1.35,1.37,1.35,1.35,+0.05,3.85,114000,5,154300,0,0,0,0,0,0,40000,74000,-34000,-34000
20200212,708695,波若威統一97購01,0.38,0.39,0.38,0.39,+0.01,2.63,50000,2,19200,0,0,0,0,0,0,50000,0,50000,50000
20200212,708696,建榮統一9A購01,1.92,1.92,1.86,1.86,+0.02,1.09,84000,3,158280,0,0,0,0,0,0,74000,0,74000,74000
20200212,708697,建榮統一9A購02,0.62,0.62,0.62,0.62,+0.02,3.33,5000,1,3100,0,0,0,0,0,0,5000,0,5000,5000
20200212,708698,雙鴻統一97購02,0.63,0.73,0.63,0.71,+0.05,7.58,1352000,40,939730,0,0,0,0,0,0,692000,660000,32000,32000
20200212,708699,雙鴻統一99購01,0.60,0.65,0.59,0.65,+0.03,4.84,610000,22,384830,0,0,0,0,0,0,318000,292000,26000,26000
20200212,708700,穩懋統一99購01,2.51,2.72,2.43,2.72,+0.28,11.48,406000,21,1057600,0,0,0,0,0,0,228000,178000,50000,50000
20200212,708701,建榮凱基97購02,,,,,,0.00,0,0,0,0,0,0,0,0,0,0,0,0,0
20200212,708702,原相凱基98購02,5.75,6.10,1.64,6.10,+0.20,3.39,64000,28,336460,0,0,0,0,0,0,49000,30000,19000,19000
20200212,708703,精測凱基97購04,1.77,1.79,1.77,1.79,+0.15,9.15,11000,3,19500,0,0,0,0,0,0,11000,11000,0,0
20200212,708704,環球晶凱基97購03,2.71,2.83,2.71,2.83,+0.16,5.99,59000,3,161510,0,0,0,0,0,0,34000,26000,8000,8000
20200212,708705,穩懋凱基97購01,1.96,2.27,1.91,2.27,+0.40,21.39,10000,10,21300,0,0,0,0,0,0,9000,8000,1000,1000
20200212,708706,鈺太凱基98購02,1.04,1.15,1.04,1.14,+0.16,16.33,97000,10,107390,0,0,0,0,0,0,5000,97000,-92000,-92000
20200212,708707,大江元大97購04,0.27,0.29,0.27,0.29,0.00,0.0,120000,5,34000,0,0,0,0,0,0,60000,60000,0,0
20200212,708708,光頡元大98購01,1.03,1.03,1.01,1.01,-0.06,-5.61,87000,3,88510,0,0,0,0,0,0,70000,17000,53000,53000
20200212,708709,新普元大97購02,2.42,2.60,2.42,2.60,+0.27,11.59,93000,7,237160,0,0,0,0,0,0,63000,33000,30000,30000
20200212,708710,新普元大97購03,3.77,4.04,3.77,4.00,+0.32,8.7,82000,15,326770,0,0,0,0,0,0,42000,64000,-22000,-22000
20200212,708711,群聯元大97購05,,,,,,0.00,0,0,0,0,0,0,0,0,0,0,0,0,0
20200212,708712,聯亞元大97購05,0.98,0.98,0.92,0.92,+0.04,4.55,110000,9,102900,0,0,0,0,0,0,70000,80000,-10000,-10000
20200212,708713,雙鴻元大99購04,0.74,0.85,0.74,0.83,+0.06,7.79,1347000,70,1087650,0,0,0,0,0,0,648000,932000,-284000,-284000
20200212,708714,聯亞元富97購01,,,,,,0.00,0,0,0,0,0,0,0,0,0,0,0,0,0
20200212,708715,台燿日盛97購01,1.15,1.24,1.15,1.24,+0.19,18.1,635000,28,769240,0,0,0,0,0,0,220000,415000,-195000,-195000
20200212,708716,建榮永豐97購02,,,,,,0.00,0,0,0,0,0,0,0,0,0,0,0,0,0
20200212,708717,閎康永豐97購01,1.17,1.17,1.17,1.17,-0.07,-5.65,27000,1,31590,0,0,0,0,0,0,27000,0,27000,27000
20200212,708718,譜瑞永豐97購01,1.73,1.99,1.73,1.86,+0.16,9.41,431000,53,813110,0,0,0,0,0,0,128000,348000,-220000,-220000
20200212,708719,鈊象永豐98購01,2.52,2.52,2.36,2.36,-0.18,-7.09,53000,9,129710,0,0,0,0,0,0,22000,31000,-9000,-9000
20200212,708720,力致國票97購01,,,,,,0.00,0,0,0,0,0,0,0,0,0,0,0,0,0
20200212,708721,光頡國票98購02,0.79,0.79,0.79,0.79,-0.06,-7.06,88000,1,69520,0,0,0,0,0,0,88000,0,88000,88000
20200212,708722,金居國票98購02,0.50,0.51,0.50,0.50,+0.05,11.11,131000,6,66090,0,0,0,0,0,0,0,131000,-131000,-131000
20200212,708723,威剛國票98購02,2.88,3.10,2.85,2.99,+0.17,6.03,268000,26,802330,0,0,0,0,0,0,62000,206000,-144000,-144000
20200212,708724,晶焱國票98購01,1.26,1.43,1.26,1.43,+0.25,21.19,70000,7,97000,0,0,0,0,0,0,10000,60000,-50000,-50000
20200212,708725,群聯國票98購02,1.10,1.10,1.10,1.10,+0.14,14.58,50000,1,55000,0,0,0,0,0,0,0,50000,-50000,-50000
20200212,708726,廣明國票98購02,2.54,2.64,2.54,2.64,+0.04,1.54,108000,15,278630,0,0,0,0,0,0,62000,46000,16000,16000
20200212,708727,光頡國泰99購01,1.05,1.05,1.02,1.02,-0.06,-5.56,40000,2,41700,0,0,0,0,0,0,30000,10000,20000,20000
20200212,708728,原相國泰98購03,3.43,3.55,3.28,3.55,+0.04,1.14,186000,35,641470,0,0,0,0,0,0,186000,30000,156000,156000
20200212,708729,大江富邦99購01,0.18,0.18,0.18,0.18,-0.01,-5.26,45000,2,8100,0,0,0,0,0,0,45000,0,45000,45000
20200212,708730,久元群益97購01,1.21,1.25,1.20,1.20,+0.07,6.19,133000,9,161830,0,0,0,0,0,0,0,133000,-133000,-133000
20200212,708731,聚積群益97購02,0.95,1.00,0.95,1.00,+0.14,16.28,99000,3,95770,0,0,0,0,0,0,88000,41000,47000,47000
20200212,708732,頎邦群益98購02,1.58,1.64,1.56,1.64,+0.08,5.13,317000,35,512670,0,0,0,0,0,0,223000,95000,128000,128000
20200212,708733,M31凱基99購01,,,,,,0.00,0,0,0,0,0,0,0,0,0,0,0,0,0
20200212,708734,中美晶凱基97購04,,,,,,0.00,0,0,0,0,0,0,0,0,0,0,0,0,0
20200212,708735,昇達科凱基97購01,1.23,1.23,1.15,1.15,+0.06,5.5,51000,6,61610,0,0,0,0,0,0,31000,51000,-20000,-20000
20200212,708736,聯亞凱基97購02,0.69,0.69,0.69,0.69,+0.06,9.52,10000,1,6900,0,0,0,0,0,0,0,10000,-10000,-10000
20200212,708737,雙美凱基99購01,0.59,0.59,0.59,0.59,+0.18,43.9,5000,1,2950,0,0,0,0,0,0,0,5000,-5000,-5000
20200212,708738,穩懋凱基97購02,3.56,4.13,3.54,4.13,+0.66,19.02,100000,23,379380,0,0,0,0,0,0,86000,64000,22000,22000
20200212,708739,穩懋凱基97購03,2.83,3.31,2.76,3.31,+0.58,21.25,37000,17,112340,0,0,0,0,0,0,19000,24000,-5000,-5000
20200212,708740,譜瑞凱基97購01,3.04,3.18,3.04,3.13,+0.35,12.59,99000,23,309990,0,0,0,0,0,0,30000,99000,-69000,-69000
20200212,708741,鈊象凱基98購03,2.94,3.01,2.94,3.01,+0.10,3.44,20000,2,59500,0,0,0,0,0,0,10000,10000,0,0
20200212,708742,新普麥證97購01,1.52,1.71,1.52,1.71,+0.19,12.5,88000,6,141330,50000,18000,32000,0,0,0,63000,18000,45000,45000
20200212,708743,同致元富97購01,,,,,,0.00,0,0,0,0,0,0,0,0,0,0,0,0,0
20200212,708744,金居元富97購01,0.74,0.80,0.73,0.80,+0.09,12.68,359000,16,276760,0,0,0,0,0,0,259000,100000,159000,159000
20200212,708745,原相元富97購01,2.89,3.19,2.71,2.92,-0.08,-2.67,891000,52,2588550,0,0,0,0,0,0,555000,336000,219000,219000
20200212,708746,穩懋元富97購01,2.45,2.92,2.40,2.88,+0.43,17.55,515000,25,1375390,0,0,0,0,0,0,195000,320000,-125000,-125000
20200212,708747,立端亞東98購01,,,,,,0.00,0,0,0,0,0,0,0,0,0,0,0,0,0
20200212,708748,合晶永豐97購03,0.54,0.59,0.54,0.59,+0.09,18.0,89000,4,49860,0,0,0,0,0,0,0,89000,-89000,-89000
20200212,708749,旺矽永豐97購03,0.77,0.77,0.77,0.77,+0.10,14.93,2000,1,1540,0,0,0,0,0,0,0,2000,-2000,-2000
20200212,708750,信驊永豐97購01,0.72,0.72,0.69,0.69,-0.02,-2.82,40000,3,28550,0,0,0,0,0,0,30000,10000,20000,20000
20200212,708751,聯亞永豐97購01,0.93,0.93,0.88,0.88,+0.05,6.02,82000,2,74910,0,0,0,0,0,0,82000,27000,55000,55000
20200212,708752,原相統一97購01,1.78,2.00,1.64,1.86,+0.01,0.54,798000,47,1493160,0,0,0,0,0,0,603000,176000,427000,427000
20200212,708753,廣明統一9A購01,1.01,1.05,1.00,1.05,+0.02,1.94,409000,11,416070,0,0,0,0,0,0,246000,163000,83000,83000
20200212,708754,聯亞統一98購01,0.94,0.94,0.90,0.90,+0.05,5.88,209000,4,191980,0,0,0,0,0,0,97000,112000,-15000,-15000
20200212,708755,鈊象統一99購01,1.53,1.56,1.53,1.56,-0.11,-6.59,18000,2,27630,0,0,0,0,0,0,15000,3000,12000,12000
20200212,708756,大中國票98購01,1.25,1.33,1.24,1.33,+0.12,9.92,61000,3,79090,0,0,0,0,0,0,20000,41000,-21000,-21000
20200212,708757,大江國票97購06,0.36,0.36,0.31,0.33,-0.01,-2.94,775000,19,252340,0,0,0,0,0,0,295000,480000,-185000,-185000
20200212,708758,佳邦國票98購01,1.17,1.35,1.17,1.35,+0.13,10.66,110000,12,140900,0,0,0,0,0,0,23000,87000,-64000,-64000
20200212,708759,宜鼎國票97購04,,,,,,0.00,0,0,0,0,0,0,0,0,0,0,0,0,0
20200212,708760,信昌電國票98購02,1.72,1.72,1.72,1.72,-0.11,-6.01,20000,1,34400,0,0,0,0,0,0,20000,0,20000,20000
20200212,708761,宣德國票98購01,1.13,1.23,1.11,1.23,0.00,0.0,217000,20,251100,0,0,0,0,0,0,207000,10000,197000,197000
20200212,708762,神盾國票98購02,1.64,1.64,1.64,1.64,+0.13,8.61,30000,1,49200,0,0,0,0,0,0,30000,0,30000,30000
20200212,708763,群聯國票98購03,1.23,1.26,1.23,1.23,+0.15,13.89,32000,5,39970,0,0,0,0,0,0,0,32000,-32000,-32000
20200212,708764,緯軟國票98購01,1.05,1.08,1.05,1.08,+0.01,0.93,145000,3,155220,0,0,0,0,0,0,145000,0,145000,145000
20200212,708765,威剛國泰98購03,1.55,1.75,1.55,1.63,+0.10,6.54,673000,69,1115170,0,0,0,0,0,0,384000,537000,-153000,-153000
20200212,708766,廣明國泰98購01,0.88,1.79,0.88,1.79,+0.04,2.29,107000,8,175480,0,0,0,0,0,0,90000,33000,57000,57000
20200212,708767,穩懋富邦99購01,1.64,1.92,1.59,1.84,+0.24,15.0,3387000,161,5806640,0,0,0,0,0,0,1442000,2277000,-835000,-835000
20200212,708768,六角元大97購01,1.17,1.42,1.17,1.40,+0.24,20.69,337000,16,454990,0,0,0,0,0,0,209000,314000,-105000,-105000
20200212,708769,合晶元大98購03,1.30,1.58,1.30,1.52,+0.31,25.62,327000,25,464110,0,0,0,0,0,0,96000,277000,-181000,-181000
20200212,708770,泰博元大97購01,2.24,2.27,2.24,2.24,+0.11,5.16,61000,3,138140,0,0,0,0,0,0,11000,50000,-39000,-39000
20200212,708771,精測元大97購05,1.97,1.97,1.88,1.97,+0.15,8.24,65000,9,127290,0,0,0,0,0,0,13000,65000,-52000,-52000
20200212,708772,聚積元大98購01,1.09,1.12,1.09,1.09,+0.08,7.92,207000,9,228010,0,0,0,0,0,0,149000,126000,23000,23000
20200212,708773,廣明元大97購02,1.23,1.29,1.23,1.29,0.00,0.0,80000,7,100560,0,0,0,0,0,0,76000,17000,59000,59000
20200212,708774,璟德元大97購04,1.39,1.49,1.36,1.42,-0.04,-2.74,747000,60,1061500,0,0,0,0,0,0,596000,589000,7000,7000
20200212,708775,穩懋元大97購07,1.99,2.34,1.94,2.21,+0.28,14.51,1447000,99,3058100,0,0,0,0,0,0,1359000,1341000,18000,18000
20200212,708776,穩懋元大98購01,1.91,2.19,1.87,2.13,+0.26,13.9,1110000,93,2214420,0,0,0,0,0,0,1014000,951000,63000,63000
20200212,708777,旺矽兆豐98購01,1.02,1.02,1.02,1.02,+0.03,3.03,2000,1,2040,0,0,0,0,0,0,2000,0,2000,2000
20200212,708778,環球晶兆豐98購01,1.47,1.55,1.46,1.53,+0.08,5.52,101000,11,152820,0,0,0,0,0,0,51000,50000,1000,1000
20200212,708779,雙鴻兆豐98購01,0.79,0.90,0.79,0.87,+0.01,1.16,1056000,41,899080,0,0,0,0,0,0,429000,627000,-198000,-198000
20200212,708780,穩懋兆豐97購03,1.19,1.43,1.16,1.35,+0.21,18.42,717000,31,900910,0,0,0,0,0,0,201000,516000,-315000,-315000
20200212,708781,信驊群益97購01,2.16,2.16,2.16,2.16,-0.09,-4.0,1000,1,2160,0,0,0,0,0,0,0,1000,-1000,-1000
20200212,708782,建榮群益98購01,0.76,0.76,0.75,0.75,0.00,0.0,31000,2,23510,0,0,0,0,0,0,31000,0,31000,31000
20200212,708783,優群群益99購01,1.00,1.04,1.00,1.02,+0.07,7.37,254000,11,259260,0,0,0,0,0,0,11000,243000,-232000,-232000
20200212,708784,環宇群益97購02,0.81,0.81,0.81,0.81,0.00,0.0,90000,2,72900,0,0,0,0,0,0,90000,0,90000,90000
20200212,708785,信驊中信9B購01,0.49,0.49,0.49,0.49,0.00,0.0,380000,11,186200,0,0,0,0,0,0,0,380000,-380000,-380000
20200212,708786,中美晶凱基97購05,3.70,4.23,3.70,4.12,+0.59,16.71,42000,5,169060,0,0,0,0,0,0,10000,32000,-22000,-22000
20200212,708787,同致凱基98購02,,,,,,0.00,0,0,0,0,0,0,0,0,0,0,0,0,0
20200212,708788,泰博凱基99購01,1.59,1.61,1.59,1.60,+0.04,2.56,118000,10,189240,0,0,0,0,0,0,36000,82000,-46000,-46000
20200212,708789,群聯凱基97購01,,,,,,0.00,0,0,0,0,0,0,0,0,0,0,0,0,0
20200212,708790,優群凱基98購04,,,,,,0.00,0,0,0,0,0,0,0,0,0,0,0,0,0
20200212,708791,雙美凱基99購02,0.63,0.63,0.63,0.63,+0.18,40.0,100000,1,63000,0,0,0,0,0,0,0,100000,-100000,-100000
20200212,708792,凡甲國票98購01,0.62,0.64,0.62,0.64,-0.03,-4.48,235000,10,148030,0,0,0,0,0,0,235000,0,235000,235000
20200212,708793,迅得國票98購01,2.16,2.30,2.16,2.30,+0.18,8.49,194000,8,436920,0,0,0,0,0,0,30000,164000,-134000,-134000
20200212,708794,旺矽國票98購01,,,,,,0.00,0,0,0,0,0,0,0,0,0,0,0,0,0
20200212,708795,原相國票98購03,2.84,3.15,2.76,3.15,+0.57,22.09,159000,21,466370,0,0,0,0,0,0,139000,20000,119000,119000
20200212,708796,兆利群益97購01,1.75,1.81,1.66,1.81,+0.03,1.69,507000,18,859820,0,0,0,0,0,0,507000,0,507000,507000
20200212,708797,金居群益99購01,0.65,0.71,0.65,0.71,+0.07,10.94,283000,12,191360,0,0,0,0,0,0,239000,202000,37000,37000
20200212,708798,晶焱群益99購01,0.65,0.65,0.65,0.65,+0.07,12.07,1000,1,650,0,0,0,0,0,0,0,1000,-1000,-1000
20200212,708799,閎康群益97購02,1.84,1.90,1.84,1.90,-0.08,-4.04,28000,4,52100,0,0,0,0,0,0,20000,8000,12000,12000
20200212,708800,凡甲元富99購01,0.51,0.54,0.51,0.54,-0.03,-5.26,594000,11,317930,0,0,0,0,0,0,594000,0,594000,594000
20200212,708801,六角元富97購01,0.97,1.15,0.97,1.06,+0.09,9.28,2696000,55,2971510,0,0,0,0,0,0,20000,2676000,-2656000,-2656000
20200212,708802,欣銓元富97購01,1.34,1.35,1.34,1.35,+0.08,6.3,68000,6,91510,0,0,0,0,0,0,29000,39000,-10000,-10000
20200212,708803,晶焱元富99購01,0.80,0.85,0.80,0.84,+0.07,9.09,317000,14,262280,0,0,0,0,0,0,100000,217000,-117000,-117000
20200212,708804,廣明元富99購01,1.06,1.11,1.06,1.11,0.00,0.0,150000,7,159500,0,0,0,0,0,0,50000,100000,-50000,-50000
20200212,708805,環球晶元富98購01,1.88,1.96,1.88,1.95,+0.15,8.33,230000,9,438400,0,0,0,0,0,0,65000,165000,-100000,-100000
20200212,708806,環球晶元富99購01,1.68,1.80,1.68,1.77,+0.10,5.99,1529000,36,2665520,0,0,0,0,0,0,254000,1284000,-1030000,-1030000
20200212,708807,雙美元富97購01,0.48,0.54,0.48,0.53,+0.23,76.67,235000,7,117700,0,0,0,0,0,0,100000,135000,-35000,-35000
20200212,708808,雙鴻元富97購01,0.63,0.72,0.63,0.68,+0.09,15.25,129000,23,89080,0,0,0,0,0,0,28000,101000,-73000,-73000
20200212,708809,穩懋元富97購02,3.22,4.02,3.19,3.85,+0.70,22.22,628000,27,2203240,0,0,0,0,0,0,465000,497000,-32000,-32000
20200212,708810,鈊象元富97購01,3.08,3.08,3.08,3.08,+0.06,1.99,7000,2,21560,0,0,0,0,0,0,7000,2000,5000,5000
20200212,708811,雙鴻國泰98購01,1.07,1.21,1.06,1.18,+0.07,6.31,752000,44,882820,0,0,0,0,0,0,711000,341000,370000,370000
20200212,708812,精測台新98購01,1.26,1.29,1.26,1.28,+0.04,3.23,122000,6,156560,0,0,0,0,0,0,50000,72000,-22000,-22000
20200212,708813,宇峻元大98購01,0.94,0.99,0.85,0.91,-0.17,-15.74,1218000,57,1101670,0,0,0,0,0,0,828000,353000,475000,475000
20200212,708814,建榮元大97購04,0.77,0.79,0.77,0.79,+0.02,2.6,35000,2,27150,0,0,0,0,0,0,35000,0,35000,35000
20200212,708815,泰博元大97購02,2.39,2.43,2.39,2.39,+0.05,2.14,89000,6,214710,0,0,0,0,0,0,31000,58000,-27000,-27000
20200212,708816,聯亞元大97購06,0.91,0.91,0.91,0.91,+0.05,5.81,10000,1,9100,0,0,0,0,0,0,0,10000,-10000,-10000
20200212,708817,譜瑞元大98購01,4.29,4.69,4.25,4.46,+0.38,9.31,214000,22,933680,0,0,0,0,0,0,206000,53000,153000,153000
20200212,708818,鈊象元大98購03,1.46,1.49,1.34,1.37,-0.15,-9.87,284000,28,404730,0,0,0,0,0,0,216000,154000,62000,62000
20200212,708819,合晶永豐97購04,0.97,1.11,0.97,1.11,+0.21,23.33,588000,21,604590,0,0,0,0,0,0,40000,588000,-548000,-548000
20200212,708820,威剛永豐99購01,1.06,1.15,1.04,1.11,+0.06,5.71,288000,21,319280,0,0,0,0,0,0,224000,144000,80000,80000
20200212,708821,原相永豐97購02,1.24,1.40,1.18,1.33,+0.02,1.53,999000,90,1279450,0,0,0,0,0,0,697000,331000,366000,366000
20200212,708822,泰博永豐97購01,0.85,0.85,0.83,0.83,0.00,0.0,305000,7,257890,0,0,0,0,0,0,166000,139000,27000,27000
20200212,708823,勝麗永豐97購01,0.68,0.73,0.64,0.71,+0.08,12.7,1317000,33,920390,0,0,0,0,0,0,562000,746000,-184000,-184000
20200212,708824,廣明永豐97購03,1.19,1.27,1.19,1.27,+0.07,5.83,126000,4,154580,0,0,0,0,0,0,68000,58000,10000,10000
20200212,708825,碩禾中信9A購01,0.40,0.40,0.38,0.38,-0.01,-2.56,356000,4,142070,0,0,0,0,0,0,300000,56000,244000,244000
20200212,708826,威剛統一9A購01,0.60,0.68,0.59,0.64,+0.05,8.47,1069000,43,684550,0,0,0,0,0,0,635000,383000,252000,252000
20200212,708827,群聯統一97購02,1.16,1.20,1.16,1.20,+0.05,4.35,107000,2,125800,0,0,0,0,0,0,0,107000,-107000,-107000
20200212,708828,六角凱基99購01,0.61,0.74,0.60,0.71,+0.09,14.52,48000,6,31680,0,0,0,0,0,0,38000,10000,28000,28000
20200212,708829,宜鼎凱基98購01,1.07,1.07,0.96,1.01,-0.01,-0.98,204000,15,208410,0,0,0,0,0,0,92000,65000,27000,27000
20200212,708830,信昌電凱基97購03,,,,,,0.00,0,0,0,0,0,0,0,0,0,0,0,0,0
20200212,708831,廣明凱基99購01,,,,,,0.00,0,0,0,0,0,0,0,0,0,0,0,0,0
20200212,708832,群聯台新97購04,1.04,1.04,1.04,1.04,+0.01,0.97,19000,2,19760,0,0,0,0,0,0,0,19000,-19000,-19000
20200212,708833,中美晶元大97購05,,,,,,0.00,0,0,0,0,0,0,0,0,0,0,0,0,0
20200212,708834,中美晶元大97購06,3.64,3.79,3.64,3.79,+0.06,1.61,37000,4,137610,0,0,0,0,0,0,10000,27000,-17000,-17000
20200212,708835,昂寶元大97購03,,,,,,0.00,0,0,0,0,0,0,0,0,0,0,0,0,0
20200212,708836,宣德元大97購02,2.05,2.25,2.03,2.25,+0.09,4.17,699000,34,1493750,0,0,0,0,0,0,679000,164000,515000,515000
20200212,708837,新普元大97購04,3.29,3.52,3.29,3.52,+0.42,13.55,57000,4,189680,0,0,0,0,0,0,57000,7000,50000,50000
20200212,708838,新普元大97購05,3.48,3.54,3.27,3.54,+0.36,11.32,121000,11,413580,0,0,0,0,0,0,58000,75000,-17000,-17000
20200212,708839,群聯元大97購06,,,,,,0.00,0,0,0,0,0,0,0,0,0,0,0,0,0
20200212,708840,雍智元大99購01,0.67,0.72,0.67,0.69,+0.04,6.15,425000,8,298950,0,0,0,0,0,0,170000,255000,-85000,-85000
20200212,708841,網龍元大98購01,0.68,0.68,0.67,0.67,0.00,0.0,24000,3,16090,0,0,0,0,0,0,16000,8000,8000,8000
20200212,708842,環球晶元大97購04,4.36,4.63,4.32,4.55,+0.24,5.57,119000,17,526720,0,0,0,0,0,0,104000,51000,53000,53000
20200212,708843,環球晶元大97購05,4.26,4.49,4.20,4.43,+0.22,5.23,151000,26,652870,0,0,0,0,0,0,117000,56000,61000,61000
20200212,708844,聯亞元大97購07,1.92,1.92,1.92,1.92,+0.12,6.67,10000,1,19200,0,0,0,0,0,0,0,10000,-10000,-10000
20200212,708845,雙鴻元大97購03,1.40,1.64,1.40,1.61,+0.13,8.78,623000,43,965320,0,0,0,0,0,0,323000,433000,-110000,-110000
20200212,708846,鈊象元大98購04,1.16,1.19,1.06,1.09,-0.11,-9.17,1424000,78,1608460,0,0,0,0,0,0,743000,630000,113000,113000
20200212,708847,群聯第一97購01,0.63,0.63,0.63,0.63,+0.03,5.0,5000,1,3150,0,0,0,0,0,0,5000,0,5000,5000
20200212,708848,中美晶永豐97購01,1.49,1.78,1.49,1.75,+0.18,11.46,175000,13,285540,0,0,0,0,0,0,95000,103000,-8000,-8000
20200212,708849,胡連永豐97購01,0.77,0.79,0.77,0.79,+0.06,8.22,185000,4,146050,0,0,0,0,0,0,0,185000,-185000,-185000
20200212,708850,閎康永豐97購02,,,,,,0.00,0,0,0,0,0,0,0,0,0,0,0,0,0
20200212,708851,精測永豐97購02,1.54,1.60,1.51,1.60,+0.11,7.38,22000,3,33400,0,0,0,0,0,0,22000,4000,18000,18000
20200212,708852,鈊象永豐97購02,1.63,1.63,1.41,1.44,-0.21,-12.73,131000,15,201480,0,0,0,0,0,0,6000,125000,-119000,-119000
20200212,708853,世界群益98購04,1.05,1.05,1.05,1.05,+0.09,9.37,11000,1,11550,0,0,0,0,0,0,0,11000,-11000,-11000
20200212,708854,晶焱群益99購02,1.04,1.09,1.04,1.09,+0.14,14.74,82000,8,87730,0,0,0,0,0,0,16000,82000,-66000,-66000
20200212,708855,大江元富97購01,0.55,0.55,0.54,0.54,0.00,0.0,81000,18,44500,0,0,0,0,0,0,81000,0,81000,81000
20200212,708856,台燿元富97購01,1.56,1.60,1.53,1.60,+0.26,19.4,100000,10,158700,0,0,0,0,0,0,10000,90000,-80000,-80000
20200212,708857,宜鼎元富97購01,1.53,1.53,1.36,1.41,-0.07,-4.73,1151000,43,1672540,0,0,0,0,0,0,1028000,42000,986000,986000
20200212,708858,昇達科元富97購01,0.66,0.69,0.66,0.67,+0.05,8.06,63000,4,42970,0,0,0,0,0,0,0,63000,-63000,-63000
20200212,708859,信驊元富97購01,1.36,1.36,1.31,1.32,+0.03,2.33,33000,5,43670,0,0,0,0,0,0,3000,30000,-27000,-27000
20200212,708860,威剛元富97購02,1.49,1.66,1.49,1.50,+0.06,4.17,921000,75,1449290,0,0,0,0,0,0,195000,709000,-514000,-514000
20200212,708861,新普元富97購01,1.72,1.84,1.72,1.82,+0.18,10.98,43000,3,77660,0,0,0,0,0,0,30000,13000,17000,17000
20200212,708862,網家元富97購01,2.32,2.52,2.28,2.29,-0.16,-6.53,816000,77,1945030,0,0,0,0,0,0,510000,303000,207000,207000
20200212,708863,聚積元富97購01,0.69,0.69,0.69,0.69,+0.04,6.15,10000,1,6900,0,0,0,0,0,0,10000,0,10000,10000
20200212,708864,穩懋元富97購03,1.81,2.21,1.79,2.21,+0.41,22.78,832000,29,1609210,0,0,0,0,0,0,406000,512000,-106000,-106000
20200212,708865,直得國票97購01,2.81,3.03,2.81,3.03,-0.04,-1.3,59000,6,171750,0,0,0,0,0,0,45000,14000,31000,31000
20200212,708866,原相國泰98購04,2.84,2.93,2.78,2.93,-0.02,-0.68,446000,45,1280080,0,0,0,0,0,0,396000,45000,351000,351000
20200212,708867,鈊象國泰99購01,1.52,1.53,1.37,1.40,-0.12,-7.89,1388000,78,1976420,0,0,0,0,0,0,226000,1093000,-867000,-867000
20200212,708868,鈊象中信99購01,1.06,1.06,1.00,1.01,-0.06,-5.61,167000,6,172370,0,0,0,0,0,0,61000,106000,-45000,-45000
20200212,708869,凡甲凱基98購01,0.45,0.47,0.21,0.21,-0.27,-56.25,162000,4,73250,0,0,0,0,0,0,152000,10000,142000,142000
20200212,708870,大江凱基98購03,,,,,,0.00,0,0,0,0,0,0,0,0,0,0,0,0,0
20200212,708871,信驊凱基98購01,0.84,0.84,0.84,0.84,0.00,0.0,60000,1,50400,0,0,0,0,0,0,0,60000,-60000,-60000
20200212,708872,新鉅科凱基97購01,,,,,,0.00,0,0,0,0,0,0,0,0,0,0,0,0,0
20200212,708873,精測凱基98購02,0.93,0.96,0.93,0.96,+0.07,7.87,11000,4,10450,0,0,0,0,0,0,11000,11000,0,0
20200212,708874,群聯統一97購03,1.66,1.66,1.62,1.62,+0.07,4.52,83000,3,135940,0,0,0,0,0,0,37000,46000,-9000,-9000
20200212,708875,譜瑞統一97購01,2.36,2.75,2.34,2.62,+0.28,11.97,497000,21,1288050,0,0,0,0,0,0,253000,194000,59000,59000
20200212,708876,信昌電兆豐98購01,0.58,0.58,0.56,0.56,-0.03,-5.08,134000,4,76830,0,0,0,0,0,0,134000,0,134000,134000
20200212,708877,胡連康和97購01,0.57,0.57,0.57,0.57,+0.06,11.76,12000,1,6840,0,0,0,0,0,0,0,12000,-12000,-12000
20200212,708878,台燿群益97購01,1.64,1.85,1.64,1.84,+0.32,21.05,469000,37,831720,0,0,0,0,0,0,164000,355000,-191000,-191000
20200212,708879,博智群益97購01,2.29,2.62,2.29,2.43,+0.20,8.97,764000,54,1851580,0,0,0,0,0,0,479000,285000,194000,194000
20200212,708880,雙鴻群益99購01,0.84,0.91,0.84,0.89,+0.07,8.54,345000,16,306390,0,0,0,0,0,0,0,325000,-325000,-325000
20200212,708881,金居國泰99購01,1.00,1.03,0.99,0.99,+0.06,6.45,50000,4,50400,0,0,0,0,0,0,10000,50000,-40000,-40000
20200212,708882,威剛元富97購04,1.34,1.44,1.32,1.37,+0.10,7.87,267000,28,368750,0,0,0,0,0,0,21000,246000,-225000,-225000
20200212,708883,原相元富97購02,1.55,1.69,1.46,1.55,-0.04,-2.52,722000,39,1133510,0,0,0,0,0,0,427000,231000,196000,196000
20200212,708884,聯亞元富97購03,0.77,0.77,0.77,0.77,+0.06,8.45,20000,2,15400,0,0,0,0,0,0,20000,0,20000,20000
20200212,708885,穩懋元富97購04,2.53,2.92,2.50,2.92,+0.41,16.33,482000,22,1288220,0,0,0,0,0,0,262000,296000,-34000,-34000
20200212,708886,鈊象元富97購02,1.93,1.93,1.74,1.76,-0.24,-12.0,119000,10,219260,0,0,0,0,0,0,0,99000,-99000,-99000
20200212,708887,鈊象台新97購02,1.24,1.24,1.22,1.22,-0.17,-12.23,35000,2,43200,0,0,0,0,0,0,0,35000,-35000,-35000
20200212,708888,中美晶元大97購07,2.59,2.90,2.53,2.59,+0.04,1.57,152000,12,413190,0,0,0,0,0,0,77000,116000,-39000,-39000
20200212,708889,台燿元大97購01,1.03,1.15,1.03,1.15,+0.19,19.79,540000,28,585970,0,0,0,0,0,0,145000,417000,-272000,-272000
20200212,708890,宜鼎元大97購02,2.01,2.01,1.84,1.84,-0.08,-4.17,925000,18,1769900,0,0,0,0,0,0,902000,28000,874000,874000
20200212,708891,金居元大99購01,0.47,0.50,0.47,0.49,+0.03,6.52,561000,7,271970,0,0,0,0,0,0,361000,200000,161000,161000
20200212,708892,胡連元大97購01,1.08,1.21,1.08,1.21,+0.14,13.08,979000,32,1128430,0,0,0,0,0,0,231000,748000,-517000,-517000
20200212,708893,泰博元大97購03,1.74,1.77,1.72,1.74,+0.06,3.57,314000,6,548960,0,0,0,0,0,0,214000,100000,114000,114000
20200212,708894,閎康元大97購01,,,,,,0.00,0,0,0,0,0,0,0,0,0,0,0,0,0
20200212,708895,環球晶元大97購06,3.40,3.64,3.36,3.56,+0.24,7.23,161000,11,567080,0,0,0,0,0,0,90000,81000,9000,9000
20200212,708896,環球晶元大97購07,3.52,3.60,3.52,3.60,+0.28,8.43,10000,4,35490,0,0,0,0,0,0,10000,10000,0,0
20200212,708897,櫃200元大99購03,,,,,,0.00,0,0,0,0,0,0,0,0,0,0,0,0,0
20200212,708898,櫃200元大99購04,,,,,,0.00,0,0,0,0,0,0,0,0,0,0,0,0,0
20200212,708899,頎邦元大97購05,1.85,1.88,1.81,1.88,+0.10,5.62,130000,12,240300,0,0,0,0,0,0,130000,17000,113000,113000
20200212,708900,中美晶元大97購08,2.70,2.92,2.70,2.92,+0.42,16.8,39000,6,112410,0,0,0,0,0,0,26000,39000,-13000,-13000
20200212,708901,台燿元大97購02,1.20,1.27,1.20,1.27,+0.16,14.41,506000,31,629720,0,0,0,0,0,0,108000,480000,-372000,-372000
20200212,708902,迅得元大99購01,0.63,0.63,0.62,0.62,+0.04,6.9,40000,2,24900,0,0,0,0,0,0,40000,0,40000,40000
20200212,708903,宜鼎元大97購03,1.86,1.86,1.64,1.68,-0.09,-5.08,795000,26,1400240,0,0,0,0,0,0,791000,0,791000,791000
20200212,708904,旺矽元大98購01,,,,,,0.00,0,0,0,0,0,0,0,0,0,0,0,0,0
20200212,708905,威剛元大97購01,1.68,2.13,1.62,1.78,+0.14,8.54,1723000,128,3081490,0,0,0,0,0,0,1136000,580000,556000,556000
20200212,708906,泰博元大97購04,1.25,1.29,1.25,1.27,+0.03,2.42,231000,12,294690,0,0,0,0,0,0,120000,192000,-72000,-72000
20200212,708907,精測元大97購06,2.73,2.84,2.71,2.81,+0.14,5.24,57000,14,158420,0,0,0,0,0,0,40000,41000,-1000,-1000
20200212,708908,廣明元大97購03,2.05,2.19,2.05,2.19,+0.01,0.46,100000,16,211230,0,0,0,0,0,0,78000,36000,42000,42000
20200212,708909,優群元大99購01,0.59,0.62,0.59,0.62,+0.06,10.71,282000,8,173300,0,0,0,0,0,0,18000,264000,-246000,-246000
20200212,708910,環球晶元大97購08,2.86,3.00,2.86,2.95,+0.17,6.12,100000,12,292670,0,0,0,0,0,0,41000,61000,-20000,-20000
20200212,708911,環球晶元大97購09,2.67,2.76,2.67,2.76,+0.17,6.56,40000,2,106890,0,0,0,0,0,0,40000,1000,39000,39000
20200212,708912,世界麥證97購02,1.40,1.45,1.40,1.45,+0.14,10.69,70000,7,99900,0,70000,-70000,0,0,0,0,70000,-70000,-70000
20200212,708913,大江永豐97購03,0.62,0.62,0.61,0.62,+0.01,1.64,311000,17,190790,0,0,0,0,0,0,301000,10000,291000,291000
20200212,708914,旺矽永豐97購04,,,,,,0.00,0,0,0,0,0,0,0,0,0,0,0,0,0
20200212,708915,新普永豐97購01,0.71,0.75,0.67,0.75,+0.13,20.97,77000,5,55760,0,0,0,0,0,0,25000,52000,-27000,-27000
20200212,708916,精華永豐97購01,0.58,0.58,0.58,0.58,+0.06,11.54,1000,1,580,0,0,0,0,0,0,1000,0,1000,1000
20200212,708917,原相兆豐98購01,1.20,1.31,1.11,1.20,0.00,0.0,2102000,126,2508080,0,0,0,0,0,0,1690000,630000,1060000,1060000
20200212,708918,群聯台新97購05,1.05,1.05,1.02,1.03,+0.01,0.98,49000,4,50530,0,0,0,0,0,0,34000,15000,19000,19000
20200212,708919,中美晶群益97購04,0.54,0.64,0.54,0.63,+0.12,23.53,164000,18,100540,0,0,0,0,0,0,26000,140000,-114000,-114000
20200212,708920,同致群益97購01,1.02,1.02,1.02,1.02,+0.06,6.25,25000,1,25500,0,0,0,0,0,0,25000,0,25000,25000
20200212,708921,勝麗群益97購01,1.59,1.86,1.59,1.71,+0.14,8.92,556000,39,944910,0,0,0,0,0,0,272000,284000,-12000,-12000
20200212,708922,緯軟群益98購02,0.72,0.72,0.70,0.72,+0.03,4.35,276000,7,198500,0,0,0,0,0,0,126000,165000,-39000,-39000
20200212,708923,鈊象群益97購01,3.79,3.89,3.79,3.89,+0.02,0.52,12000,2,46480,0,0,0,0,0,0,12000,0,12000,12000
20200212,708924,穩懋永昌9C購01,9.05,9.05,9.05,9.05,+0.75,9.04,25000,3,226250,0,0,0,0,0,0,9000,0,9000,9000
20200212,708925,世界統一97購02,0.66,0.66,0.66,0.66,+0.03,4.76,8000,2,5280,0,0,0,0,0,0,3000,5000,-2000,-2000
20200212,708926,胡連統一98購01,0.84,0.94,0.84,0.92,+0.11,13.58,167000,22,145870,0,0,0,0,0,0,100000,61000,39000,39000
20200212,708927,胡連統一99購01,0.45,0.48,0.44,0.48,+0.04,9.09,349000,6,160350,0,0,0,0,0,0,109000,240000,-131000,-131000
20200212,708928,環球晶統一97購02,2.16,2.22,2.16,2.22,+0.16,7.77,68000,3,148080,0,0,0,0,0,0,48000,20000,28000,28000
20200212,708929,雍智中信97購01,,,,,,0.00,0,0,0,0,0,0,0,0,0,0,0,0,0
20200212,708930,聚積中信97購01,,,,,,0.00,0,0,0,0,0,0,0,0,0,0,0,0,0
20200212,708931,VHQ凱基97購01,0.28,0.35,0.28,0.35,+0.11,45.83,420000,3,119000,0,0,0,0,0,0,300000,20000,280000,280000
20200212,708932,VHQ凱基98購01,0.24,0.38,0.24,0.38,+0.15,65.22,340000,8,93900,0,0,0,0,0,0,320000,0,320000,320000
20200212,708933,神盾凱基98購02,0.49,0.53,0.49,0.51,+0.03,6.25,620000,13,317700,0,0,0,0,0,0,620000,397000,223000,223000
20200212,708934,晶焱凱基98購02,0.74,0.76,0.74,0.74,+0.09,13.85,606000,72,454110,0,0,0,0,0,0,0,606000,-606000,-606000
20200212,708935,環球晶凱基97購04,1.66,1.72,1.66,1.72,+0.17,10.97,120000,6,201430,0,0,0,0,0,0,51000,80000,-29000,-29000
20200212,708936,環球晶凱基97購05,1.51,1.59,0.34,1.59,+0.17,11.97,180000,9,261290,0,0,0,0,0,0,169000,12000,157000,157000
20200212,708937,雙鴻富邦98購01,0.31,0.35,0.31,0.35,+0.03,9.38,209000,29,69490,0,0,0,0,0,0,95000,94000,1000,1000
20200212,708938,大宇資國票98購01,1.46,1.46,1.46,1.46,-0.09,-5.81,8000,1,11680,0,0,0,0,0,0,0,8000,-8000,-8000
20200212,708939,金居國票98購03,0.74,0.76,0.74,0.76,+0.11,16.92,80000,2,59600,0,0,0,0,0,0,0,80000,-80000,-80000
20200212,708940,碩禾國票98購01,1.22,1.29,1.17,1.24,-0.03,-2.36,115000,12,144400,0,0,0,0,0,0,36000,79000,-43000,-43000
20200212,708941,M31元富97購01,1.12,1.15,1.12,1.12,+0.10,9.8,21000,3,23550,0,0,0,0,0,0,10000,11000,-1000,-1000
20200212,708942,金居第一97購01,0.38,0.39,0.38,0.39,+0.05,14.71,120000,2,46200,0,0,0,0,0,0,0,120000,-120000,-120000
20200212,708943,M31元富97購02,1.34,1.34,1.34,1.34,+0.13,10.74,1000,1,1340,0,0,0,0,0,0,0,1000,-1000,-1000
20200212,708944,閎康元富97購01,0.47,0.47,0.47,0.47,+0.01,2.17,60000,1,28200,0,0,0,0,0,0,0,60000,-60000,-60000
20200212,708945,大田永豐97購01,0.50,0.51,0.50,0.51,+0.04,8.51,204000,2,103360,0,0,0,0,0,0,136000,68000,68000,68000
20200212,708946,六角永豐97購02,0.67,0.67,0.60,0.62,+0.05,8.77,154000,3,98120,0,0,0,0,0,0,68000,86000,-18000,-18000
20200212,708947,群聯永豐97購01,0.33,0.33,0.33,0.33,+0.02,6.45,1000,1,330,0,0,0,0,0,0,0,1000,-1000,-1000
20200212,708948,雙鴻永豐97購04,0.55,0.67,0.55,0.67,+0.05,8.06,598000,15,355240,0,0,0,0,0,0,278000,320000,-42000,-42000
20200212,708949,旺矽康和97購02,,,,,,0.00,0,0,0,0,0,0,0,0,0,0,0,0,0
20200212,708950,威剛康和97購02,0.95,0.98,0.94,0.98,+0.05,5.38,221000,11,210760,0,0,0,0,0,0,143000,78000,65000,65000
20200212,708951,合晶群益99購01,1.11,1.31,1.11,1.28,+0.25,24.27,169000,22,204250,0,0,0,0,0,0,40000,169000,-129000,-129000
20200212,708952,迅得群益98購01,0.83,0.93,0.83,0.93,+0.11,13.41,314000,13,274640,0,0,0,0,0,0,189000,125000,64000,64000
20200212,708953,宜鼎群益97購02,2.64,2.64,2.45,2.45,+0.02,0.82,77000,8,199110,0,0,0,0,0,0,57000,27000,30000,30000
20200212,708954,胡連群益97購01,1.09,1.22,1.09,1.22,+0.14,12.96,637000,18,746030,0,0,0,0,0,0,42000,615000,-573000,-573000
20200212,708955,雙美群益98購01,,,,,,0.00,0,0,0,0,0,0,0,0,0,0,0,0,0
20200212,708956,大江凱基97購02,0.29,0.29,0.26,0.27,+0.01,3.85,355000,15,96960,0,0,0,0,0,0,355000,0,355000,355000
20200212,708957,世界凱基97購01,,,,,,0.00,0,0,0,0,0,0,0,0,0,0,0,0,0
20200212,708958,台燿凱基98購01,1.71,1.85,1.71,1.85,+0.29,18.59,330000,6,590800,0,0,0,0,0,0,310000,20000,290000,290000
20200212,708959,宣德凱基98購01,1.19,1.28,1.18,1.28,-0.04,-3.03,216000,21,268850,0,0,0,0,0,0,146000,70000,76000,76000
20200212,708960,璟德凱基97購01,1.39,1.56,1.39,1.56,-0.04,-2.5,136000,14,198270,0,0,0,0,0,0,81000,55000,26000,26000
20200212,708961,環球晶凱基97購06,1.93,1.95,1.91,1.93,+0.13,7.22,88000,11,168990,0,0,0,0,0,0,8000,81000,-73000,-73000
20200212,708962,鈊象凱基98購04,1.81,1.84,1.63,1.63,-0.26,-13.76,119000,12,210730,0,0,0,0,0,0,0,119000,-119000,-119000
20200212,708963,譜瑞凱基97購02,1.85,2.08,1.85,2.05,+0.34,19.88,126000,20,250120,0,0,0,0,0,0,2000,126000,-124000,-124000
20200212,708964,信昌電國票98購03,2.06,2.06,2.06,2.06,-0.10,-4.63,17000,1,35020,0,0,0,0,0,0,17000,0,17000,17000
20200212,708965,廣明國票98購03,1.79,1.86,1.79,1.86,+0.04,2.2,102000,9,186540,0,0,0,0,0,0,40000,62000,-22000,-22000
20200212,708966,聯亞國票98購01,,,,,,0.00,0,0,0,0,0,0,0,0,0,0,0,0,0
20200212,708967,大江元大97購05,0.78,0.78,0.69,0.73,-0.01,-1.35,129000,12,96070,0,0,0,0,0,0,109000,27000,82000,82000
20200212,708968,中美晶元大97購09,1.23,1.38,1.18,1.35,+0.14,11.57,299000,35,382030,0,0,0,0,0,0,237000,119000,118000,118000
20200212,708969,宣德元大97購03,0.90,0.97,0.89,0.97,+0.03,3.19,859000,24,805310,0,0,0,0,0,0,699000,313000,386000,386000
20200212,708970,群聯元大97購07,3.53,3.62,3.49,3.57,+0.10,2.88,109000,6,384800,0,0,0,0,0,0,95000,104000,-9000,-9000
20200212,708971,精測元大97購07,2.31,2.38,2.29,2.37,+0.14,6.28,20000,6,46880,0,0,0,0,0,0,12000,20000,-8000,-8000
20200212,708972,網龍元大98購02,0.63,0.63,0.61,0.62,-0.01,-1.59,134000,12,82620,0,0,0,0,0,0,101000,33000,68000,68000
20200212,708973,聚積元大97購01,1.17,1.21,1.17,1.21,+0.11,10.0,128000,7,150560,0,0,0,0,0,0,108000,20000,88000,88000
20200212,708974,環球晶元大97購10,2.16,2.19,2.16,2.19,+0.16,7.88,65000,4,141180,0,0,0,0,0,0,6000,60000,-54000,-54000
20200212,708975,環球晶元大97購11,3.13,3.29,3.13,3.27,+0.26,8.64,116000,6,369640,0,0,0,0,0,0,116000,1000,115000,115000
20200212,708976,環球晶元大97購12,2.05,2.14,2.01,2.12,+0.11,5.47,208000,12,435380,0,0,0,0,0,0,60000,157000,-97000,-97000
20200212,708977,M31兆豐97購01,0.65,0.65,0.64,0.64,+0.03,4.92,90000,3,58100,0,0,0,0,0,0,40000,50000,-10000,-10000
20200212,708978,頎邦兆豐97購01,0.71,0.76,0.71,0.76,+0.04,5.56,382000,25,280680,0,0,0,0,0,0,294000,89000,205000,205000
20200212,708979,VHQ統一98購01,0.42,0.47,0.42,0.47,+0.17,56.67,151000,6,64880,0,0,0,0,0,0,13000,138000,-125000,-125000
20200212,708980,威剛統一98購01,2.32,2.49,2.27,2.39,+0.12,5.29,671000,42,1598030,0,0,0,0,0,0,259000,410000,-151000,-151000
20200212,708981,光頡國票98購03,,,,,,0.00,0,0,0,0,0,0,0,0,0,0,0,0,0
20200212,708982,大學光國泰99購01,1.70,1.82,1.70,1.80,+0.12,7.14,152000,19,269190,0,0,0,0,0,0,77000,92000,-15000,-15000
20200212,708983,穩懋國泰98購02,2.95,3.59,2.89,3.42,+0.53,18.34,463000,58,1444900,0,0,0,0,0,0,325000,364000,-39000,-39000
20200212,708984,大江凱基97購03,0.69,0.71,0.26,0.71,+0.05,7.58,251000,11,167140,0,0,0,0,0,0,241000,10000,231000,231000
20200212,708985,六角凱基99購02,0.81,0.85,0.81,0.85,+0.11,14.86,82000,3,69220,0,0,0,0,0,0,12000,70000,-58000,-58000
20200212,708986,旺矽凱基97購02,,,,,,0.00,0,0,0,0,0,0,0,0,0,0,0,0,0
20200212,708987,環球晶凱基97購07,1.33,1.38,1.33,1.37,+0.13,10.48,164000,5,222100,0,0,0,0,0,0,96000,69000,27000,27000
20200212,708988,雙鴻凱基98購02,1.13,1.22,1.13,1.21,+0.10,9.01,134000,16,158190,0,0,0,0,0,0,44000,94000,-50000,-50000
20200212,708989,穩懋凱基97購05,4.03,4.84,3.93,4.51,+0.60,15.35,73000,12,312100,0,0,0,0,0,0,69000,48000,21000,21000
20200212,708990,穩懋凱基98購01,3.78,4.27,3.78,4.27,+0.58,15.72,45000,7,181530,0,0,0,0,0,0,35000,35000,0,0
20200212,708991,穩懋凱基98購02,4.33,5.00,4.30,5.00,+0.97,24.07,94000,21,416530,0,0,0,0,0,0,50000,47000,3000,3000
20200212,708992,M31元大98購02,0.98,1.00,0.98,0.99,+0.04,4.21,131000,5,128600,0,0,0,0,0,0,0,131000,-131000,-131000
20200212,708993,大學光元大98購01,1.80,1.92,1.80,1.89,+0.10,5.59,224000,12,417030,0,0,0,0,0,0,129000,104000,25000,25000
20200212,708994,中美晶元大98購01,1.52,1.65,1.52,1.62,+0.13,8.72,128000,10,206110,0,0,0,0,0,0,82000,85000,-3000,-3000
20200212,708995,世界元大97購01,2.97,3.13,2.95,3.13,+0.26,9.06,81000,11,246550,0,0,0,0,0,0,20000,81000,-61000,-61000
20200212,708996,保瑞元大97購01,2.62,2.62,2.57,2.57,-0.01,-0.39,198000,6,512060,0,0,0,0,0,0,38000,160000,-122000,-122000
20200212,708997,晶焱元大99購01,0.92,0.95,0.92,0.95,+0.06,6.74,31000,2,28820,0,0,0,0,0,0,31000,21000,10000,10000
20200212,708998,大學光康和9B購01,0.75,0.79,0.75,0.78,+0.03,4.0,73000,6,56760,0,0,0,0,0,0,7000,66000,-59000,-59000
20200212,708999,泰博群益97購02,2.58,2.62,2.56,2.56,+0.10,4.07,152000,10,392220,0,0,0,0,0,0,60000,92000,-32000,-32000
20200212,709000,環球晶群益98購01,3.13,3.30,3.13,3.25,+0.23,7.62,101000,10,326450,0,0,0,0,0,0,41000,61000,-20000,-20000
20200212,709001,鈺太群益97購01,0.72,0.85,0.72,0.85,+0.20,30.77,436000,14,337400,0,0,0,0,0,0,0,436000,-436000,-436000
20200212,709002,環球晶日盛97購01,2.21,2.32,2.21,2.32,+0.23,11.0,44000,2,101530,0,0,0,0,0,0,5000,39000,-34000,-34000
20200212,709003,世禾永豐97購02,0.62,0.70,0.62,0.70,+0.12,20.69,144000,5,92720,0,0,0,0,0,0,68000,76000,-8000,-8000
20200212,709004,順達永豐97購01,0.58,0.61,0.58,0.59,+0.07,13.46,72000,5,43280,0,0,0,0,0,0,17000,55000,-38000,-38000
20200212,709005,新揚科永豐97購01,0.71,0.71,0.71,0.71,+0.06,9.23,10000,1,7100,0,0,0,0,0,0,10000,0,10000,10000
20200212,709006,穩懋永豐97購03,1.58,2.10,1.52,1.98,+0.48,32.0,1488000,63,2729830,0,0,0,0,0,0,1280000,1396000,-116000,-116000
20200212,709007,勝麗台新97購01,0.87,0.99,0.87,0.95,+0.08,9.2,432000,23,406230,0,0,0,0,0,0,182000,241000,-59000,-59000
20200212,709008,中美晶元富99購01,1.18,1.32,1.18,1.22,+0.04,3.39,932000,45,1146490,0,0,0,0,0,0,400000,504000,-104000,-104000
20200212,709009,信昌電元富97購02,2.04,2.04,2.03,2.03,-0.13,-6.02,91000,2,185040,0,0,0,0,0,0,91000,0,91000,91000
20200212,709010,宣德元富97購01,1.73,1.79,1.70,1.79,-0.11,-5.79,123000,19,211600,0,0,0,0,0,0,123000,0,123000,123000
20200212,709011,緯軟元富97購01,0.46,0.46,0.46,0.46,+0.02,4.55,150000,1,69000,0,0,0,0,0,0,150000,0,150000,150000
20200212,709012,環球晶元富97購03,1.56,1.60,1.56,1.60,+0.11,7.38,129000,5,202960,0,0,0,0,0,0,31000,98000,-67000,-67000
20200212,709013,環球晶元富97購04,,,,,,0.00,0,0,0,0,0,0,0,0,0,0,0,0,0
20200212,709014,鈊象元富97購04,3.59,3.59,3.40,3.40,-0.17,-4.76,87000,7,310010,0,0,0,0,0,0,85000,2000,83000,83000
20200212,709015,世禾統一99購01,0.59,0.61,0.59,0.61,+0.07,12.96,205000,8,122890,0,0,0,0,0,0,0,205000,-205000,-205000
20200212,709016,世禾統一9A購01,0.51,0.55,0.51,0.55,+0.06,12.24,173000,6,93670,0,0,0,0,0,0,0,173000,-173000,-173000
20200212,709017,金居統一98購01,1.93,2.05,1.92,2.05,+0.20,10.81,153000,9,304320,0,0,0,0,0,0,81000,72000,9000,9000
20200212,709018,順達統一99購01,,,,,,0.00,0,0,0,0,0,0,0,0,0,0,0,0,0
20200212,709019,中美晶凱基9A購01,1.61,1.78,1.61,1.78,+0.29,19.46,60000,2,98300,0,0,0,0,0,0,0,60000,-60000,-60000
20200212,709020,迅得凱基9A購01,0.60,0.61,0.60,0.60,+0.07,13.21,90000,3,54500,0,0,0,0,0,0,20000,70000,-50000,-50000
20200212,709021,亞泰凱基9A購01,,,,,,0.00,0,0,0,0,0,0,0,0,0,0,0,0,0
20200212,709022,保瑞凱基98購01,1.30,1.31,1.27,1.27,-0.01,-0.78,18000,6,23110,0,0,0,0,0,0,12000,6000,6000,6000
20200212,709023,新普凱基98購02,1.47,1.50,1.46,1.46,+0.08,5.8,164000,3,243780,0,0,0,0,0,0,100000,64000,36000,36000
20200212,709024,環球晶凱基98購01,1.71,1.86,1.71,1.83,+0.16,9.58,204000,11,365300,0,0,0,0,0,0,167000,39000,128000,128000
20200212,709025,環球晶凱基99購01,2.20,2.20,2.20,2.20,+0.19,9.45,1000,1,2200,0,0,0,0,0,0,1000,1000,0,0
20200212,709026,穩懋日盛98購01,2.61,3.00,2.53,3.00,+0.47,18.58,685000,46,1841040,0,0,0,0,0,0,390000,401000,-11000,-11000
20200212,709027,大江國票99購01,1.59,1.60,1.43,1.53,-0.03,-1.92,595000,47,913290,0,0,0,0,0,0,305000,290000,15000,15000
20200212,709028,凡甲富邦9A購01,0.56,0.60,0.56,0.58,0.00,0.0,1672000,48,963150,0,0,0,0,0,0,1620000,52000,1568000,1568000
20200212,709029,聯亞富邦9A購01,,,,,,0.00,0,0,0,0,0,0,0,0,0,0,0,0,0
20200212,709030,大江元大98購01,0.70,0.70,0.65,0.66,-0.01,-1.49,191000,12,128360,0,0,0,0,0,0,182000,49000,133000,133000
20200212,709031,群聯元大99購01,2.77,2.83,2.77,2.81,+0.06,2.18,108000,4,301640,0,0,0,0,0,0,90000,108000,-18000,-18000
20200212,709032,碩禾元大99購01,0.99,1.00,0.97,0.97,-0.03,-3.0,212000,8,208230,0,0,0,0,0,0,212000,164000,48000,48000
20200212,709033,優群元大99購02,0.78,0.78,0.76,0.76,+0.07,10.14,30000,2,23000,0,0,0,0,0,0,20000,10000,10000,10000
20200212,709034,環球晶元大98購01,2.23,2.37,2.23,2.37,+0.20,9.22,33000,4,74610,0,0,0,0,0,0,32000,2000,30000,30000
20200212,709035,環球晶元大98購02,3.80,3.91,3.80,3.88,+0.28,7.78,10000,6,38440,0,0,0,0,0,0,10000,10000,0,0
20200212,709036,環球晶元大98購03,2.05,2.19,2.05,2.15,+0.10,4.88,366000,14,783500,0,0,0,0,0,0,229000,141000,88000,88000
20200212,709037,聯亞元大99購01,1.00,1.00,1.00,1.00,+0.07,7.53,10000,1,10000,0,0,0,0,0,0,0,10000,-10000,-10000
20200212,709038,譜瑞元大98購02,3.52,3.86,3.42,3.68,+0.36,10.84,380000,32,1385560,0,0,0,0,0,0,216000,227000,-11000,-11000
20200212,709039,譜瑞元富98購01,1.89,2.17,1.89,2.03,+0.18,9.73,1424000,88,2954460,0,0,0,0,0,0,808000,480000,328000,328000
20200212,709040,勝麗台新98購01,0.97,1.09,0.97,1.00,+0.04,4.17,412000,25,428640,0,0,0,0,0,0,176000,236000,-60000,-60000
20200212,709041,精測台新99購01,1.23,1.25,1.23,1.25,+0.04,3.31,12000,2,14800,0,0,0,0,0,0,12000,0,12000,12000
20200212,709042,宣德兆豐98購01,0.97,1.05,0.96,1.05,-0.04,-3.67,413000,49,414760,0,0,0,0,0,0,383000,30000,353000,353000
20200212,709043,威剛群益9A購01,1.00,1.12,1.00,1.06,+0.07,7.07,285000,27,303430,0,0,0,0,0,0,136000,271000,-135000,-135000
20200212,709044,統新康和98購01,1.02,1.12,1.02,1.12,+0.15,15.46,247000,8,263320,0,0,0,0,0,0,26000,221000,-195000,-195000
20200212,709045,神盾群益9A購01,3.71,3.90,3.70,3.75,+0.12,3.31,798000,75,3022870,0,0,0,0,0,0,683000,133000,550000,550000
20200212,709046,廣明群益98購01,2.07,2.12,2.02,2.12,0.00,0.0,121000,13,249470,0,0,0,0,0,0,87000,71000,16000,16000
20200212,709047,世禾永豐98購01,1.65,1.82,1.65,1.82,+0.22,13.75,191000,16,334060,0,5000,-5000,0,0,0,18000,173000,-155000,-160000
20200212,709048,合晶永豐98購01,1.62,1.87,1.60,1.80,+0.29,19.21,766000,47,1324070,0,0,0,0,0,0,27000,766000,-739000,-739000
20200212,709049,亞泰永豐99購01,1.45,1.45,1.38,1.42,-0.01,-0.7,379000,39,533060,0,0,0,0,0,0,317000,56000,261000,261000
20200212,709050,金居永豐98購01,1.85,2.02,1.85,1.91,+0.12,6.7,334000,28,643780,0,0,0,0,0,0,144000,200000,-56000,-56000
20200212,709051,統新永豐98購01,1.01,1.15,1.01,1.07,+0.10,10.31,571000,35,610230,0,0,0,0,0,0,15000,571000,-556000,-556000
20200212,709052,鈊象永豐98購02,0.96,0.96,0.96,0.96,-0.09,-8.57,60000,4,57600,0,0,0,0,0,0,0,60000,-60000,-60000
20200212,709053,M31元大98購03,2.21,2.29,2.21,2.24,+0.06,2.75,197000,13,443980,0,0,0,0,0,0,187000,54000,133000,133000
20200212,709054,凡甲元大9A購01,1.13,1.18,1.13,1.17,-0.01,-0.85,1373000,32,1591320,0,0,0,0,0,0,1355000,215000,1140000,1140000
20200212,709055,中美晶元大99購01,2.31,2.50,2.27,2.38,+0.09,3.93,97000,15,234500,0,0,0,0,0,0,81000,59000,22000,22000
20200212,709056,群聯元大98購03,2.78,2.86,2.74,2.79,+0.07,2.57,279000,19,772210,0,0,0,0,0,0,195000,210000,-15000,-15000
20200212,709057,精測元大98購02,2.42,2.47,2.38,2.46,+0.12,5.13,1033000,27,2523020,0,0,0,0,0,0,823000,223000,600000,600000
20200212,709058,緯軟元大98購01,1.71,1.71,1.66,1.70,+0.04,2.41,374000,19,633340,0,0,0,0,0,0,354000,84000,270000,270000
20200212,709059,鈊象元大99購02,2.93,3.01,2.67,2.70,-0.28,-9.4,2527000,261,7155340,0,0,0,0,0,0,802000,1668000,-866000,-866000
20200212,709060,大江國泰9A購01,1.91,1.91,1.77,1.84,+0.04,2.22,125000,35,235100,0,0,0,0,0,0,93000,31000,62000,62000
20200212,709061,台燿國泰99購01,2.25,2.28,2.25,2.28,+0.30,15.15,20000,2,45300,0,0,0,0,0,0,0,20000,-20000,-20000
20200212,709062,合晶國泰99購01,1.96,2.23,1.96,2.23,+0.38,20.54,460000,33,952530,0,0,0,0,0,0,181000,459000,-278000,-278000
20200212,709063,雍智國票99購01,5.35,5.80,5.35,5.80,+0.45,8.41,194000,14,1090850,0,0,0,0,0,0,74000,120000,-46000,-46000
20200212,709064,網龍國票99購01,,,,,,0.00,0,0,0,0,0,0,0,0,0,0,0,0,0
20200212,709065,雙鴻國票99購01,1.38,1.55,1.38,1.53,+0.10,6.99,525000,59,775630,0,0,0,0,0,0,282000,241000,41000,41000
20200212,709066,中美晶統一98購01,2.94,2.94,2.70,2.70,+0.10,3.85,135000,17,374700,0,0,0,0,0,0,5000,130000,-125000,-125000
20200212,709067,統新統一01購01,1.35,1.35,1.35,1.35,+0.14,11.57,10000,1,13500,0,0,0,0,0,0,10000,0,10000,10000
20200212,709068,統新統一98購01,1.52,1.65,1.43,1.58,+0.17,12.06,352000,17,530030,0,0,0,0,0,0,20000,330000,-310000,-310000
20200212,709069,統新統一9B購01,0.90,1.03,0.90,0.97,+0.08,8.99,756000,27,717780,0,0,0,0,0,0,230000,526000,-296000,-296000
20200212,709070,統新統一9C購01,0.79,0.91,0.79,0.86,+0.08,10.26,337000,16,291240,0,0,0,0,0,0,5000,327000,-322000,-322000
20200212,709071,鈊象統一9A購01,2.00,2.00,1.89,1.89,-0.13,-6.44,42000,7,80220,0,0,0,0,0,0,4000,38000,-34000,-34000
20200212,709072,鈊象中信98購01,0.67,0.67,0.60,0.62,-0.05,-7.46,125000,14,76500,0,0,0,0,0,0,81000,44000,37000,37000
20200212,709073,大江凱基98購04,2.37,2.37,1.08,2.30,+0.01,0.44,208000,25,473800,0,0,0,0,0,0,176000,51000,125000,125000
20200212,709074,大學光凱基9A購01,0.88,0.92,0.88,0.92,+0.09,10.84,34000,3,30320,0,0,0,0,0,0,24000,10000,14000,14000
20200212,709075,中美晶凱基98購01,2.20,2.44,2.12,2.25,+0.08,3.69,181000,22,405600,0,0,0,0,0,0,67000,141000,-74000,-74000
20200212,709076,合晶凱基98購02,2.05,2.19,2.05,2.11,+0.34,19.21,72000,5,154260,0,0,0,0,0,0,29000,72000,-43000,-43000
20200212,709077,宜鼎凱基98購02,2.94,2.94,2.78,2.78,+0.12,4.51,43000,2,123540,0,0,0,0,0,0,25000,18000,7000,7000
20200212,709078,昇達科凱基98購01,1.94,2.00,1.94,2.00,+0.18,9.89,41000,4,80740,0,0,0,0,0,0,11000,30000,-19000,-19000
20200212,709079,信昌電凱基98購03,3.30,3.30,3.21,3.21,-0.27,-7.76,11000,2,35400,0,0,0,0,0,0,11000,10000,1000,1000
20200212,709080,宣德凱基98購02,1.60,1.73,0.89,1.73,-0.01,-0.57,141000,22,212970,0,0,0,0,0,0,122000,12000,110000,110000
20200212,709081,原相凱基98購03,3.56,3.85,1.88,3.65,+0.09,2.53,188000,27,664700,0,0,0,0,0,0,168000,54000,114000,114000
20200212,709082,精測凱基98購03,2.16,2.20,2.16,2.20,+0.13,6.28,11000,4,24080,0,0,0,0,0,0,11000,11000,0,0
20200212,709083,廣明凱基98購03,1.66,1.70,1.66,1.69,-0.01,-0.59,30000,5,50580,0,0,0,0,0,0,30000,0,30000,30000
20200212,709084,優群凱基9A購01,0.95,0.95,0.95,0.95,+0.05,5.56,5000,1,4750,0,0,0,0,0,0,0,5000,-5000,-5000
20200212,709085,環球晶凱基98購02,4.42,4.59,4.42,4.59,+0.21,4.79,22000,5,98680,0,0,0,0,0,0,17000,12000,5000,5000
20200212,709086,環球晶凱基99購02,3.10,3.21,3.10,3.17,+0.13,4.28,71000,6,223490,0,0,0,0,0,0,71000,2000,69000,69000
20200212,709087,聯亞凱基98購02,1.89,1.91,1.86,1.86,+0.07,3.91,370000,6,698300,0,0,0,0,0,0,260000,110000,150000,150000
20200212,709088,鈊象凱基9A購01,,,,,,0.00,0,0,0,0,0,0,0,0,0,0,0,0,0
20200212,709089,統新元富98購01,1.33,1.57,1.33,1.48,+0.18,13.85,354000,37,519150,0,0,0,0,0,0,25000,329000,-304000,-304000
20200212,709090,統新元富98購02,1.49,1.74,1.49,1.70,+0.25,17.24,244000,27,397640,0,0,0,0,0,0,10000,234000,-224000,-224000
20200212,709091,穩懋統一98購03,3.40,3.97,3.34,3.93,+0.74,23.2,152000,8,541720,0,0,0,0,0,0,140000,2000,138000,138000
20200212,709092,鈊象中信99購02,0.91,0.93,0.84,0.84,-0.10,-10.64,261000,15,228360,0,0,0,0,0,0,10000,251000,-241000,-241000
20200212,709093,VHQ元大99購01,1.57,2.00,1.55,2.00,+0.51,34.23,1637000,44,2868920,0,0,0,0,0,0,1517000,1041000,476000,476000
20200212,709094,大江元大99購01,1.90,1.90,1.75,1.83,-0.01,-0.54,276000,16,510170,0,0,0,0,0,0,249000,226000,23000,23000
20200212,709095,六角元大99購01,1.11,1.22,1.11,1.15,+0.10,9.52,524000,21,616550,0,0,0,0,0,0,87000,524000,-437000,-437000
20200212,709096,同致元大99購01,,,,,,0.00,0,0,0,0,0,0,0,0,0,0,0,0,0
20200212,709097,建榮元大98購01,2.62,2.70,2.61,2.66,-0.02,-0.75,197000,8,525370,0,0,0,0,0,0,197000,180000,17000,17000
20200212,709098,原相元大9A購01,3.03,3.20,2.86,2.98,-0.03,-1.0,656000,83,1960880,0,0,0,0,0,0,599000,295000,304000,304000
20200212,709099,鈊象元大99購03,1.49,1.49,1.36,1.40,-0.11,-7.28,589000,36,838780,0,0,0,0,0,0,120000,469000,-349000,-349000
20200212,709100,鈺太元大99購02,1.62,2.02,1.62,2.02,+0.39,23.93,462000,24,824040,0,0,0,0,0,0,96000,448000,-352000,-352000
20200212,709101,泰博元富98購01,1.18,1.18,1.18,1.18,+0.04,3.51,21000,2,24780,0,0,0,0,0,0,11000,10000,1000,1000
20200212,709102,三貝德群益98購01,2.37,2.76,2.33,2.34,+0.25,11.96,919000,69,2299000,0,0,0,0,0,0,383000,420000,-37000,-37000
20200212,709103,中美晶群益98購01,5.35,6.25,5.35,5.85,+0.65,12.5,256000,32,1522900,0,0,0,0,0,0,21000,237000,-216000,-216000
20200212,709104,良維群益98購01,2.50,2.66,2.45,2.66,+0.15,5.98,325000,9,834460,0,0,0,0,0,0,56000,269000,-213000,-213000
20200212,709105,宣德群益98購01,2.76,3.01,2.73,3.01,-0.05,-1.63,411000,32,1187720,0,0,0,0,0,0,338000,101000,237000,237000
20200212,709106,統新群益98購01,2.69,3.15,2.66,3.03,+0.41,15.65,488000,46,1425970,0,0,0,0,0,0,7000,478000,-471000,-471000
20200212,709107,晶焱群益98購02,0.86,0.93,0.86,0.93,+0.12,14.81,84000,9,76140,0,0,0,0,0,0,16000,84000,-68000,-68000
20200212,709108,金居國票99購01,1.12,1.15,1.09,1.15,+0.16,16.16,304000,9,336620,0,0,0,0,0,0,236000,68000,168000,168000
20200212,709109,統新國票98購01,4.89,5.40,4.89,5.35,+0.80,17.58,101000,6,519030,0,0,0,0,0,0,0,101000,-101000,-101000
20200212,709110,聯亞國票99購01,,,,,,0.00,0,0,0,0,0,0,0,0,0,0,0,0,0
20200212,709111,VHQ永豐98購01,1.38,1.75,1.36,1.74,+0.43,32.82,500000,19,816500,0,0,0,0,0,0,480000,63000,417000,417000
20200212,709112,大宇資永豐98購01,1.54,1.54,1.54,1.54,-0.02,-1.28,13000,1,20020,0,0,0,0,0,0,13000,0,13000,13000
20200212,709113,大學光永豐9A購01,0.81,0.85,0.81,0.85,+0.06,7.59,138000,3,114710,0,0,0,0,0,0,0,138000,-138000,-138000
20200212,709114,波若威永豐99購01,1.00,1.06,0.98,1.06,+0.07,7.07,739000,6,767540,0,0,0,0,0,0,739000,0,739000,739000
20200212,709115,金可永豐98購01,1.13,1.21,1.12,1.18,+0.04,3.51,128000,9,149620,0,0,0,0,0,0,47000,81000,-34000,-34000
20200212,709116,環球晶永豐98購01,1.33,1.44,1.33,1.41,+0.08,6.02,138000,10,192050,0,0,0,0,0,0,29000,99000,-70000,-70000
20200212,709117,大江凱基98購05,1.95,1.95,1.88,1.91,+0.04,2.14,236000,30,452400,0,0,0,0,0,0,147000,89000,58000,58000
20200212,709118,元太凱基98購01,1.77,1.87,1.77,1.87,+0.13,7.47,13000,7,24000,0,0,0,0,0,0,7000,13000,-6000,-6000
20200212,709119,台燿凱基98購02,2.02,2.14,2.02,2.14,+0.26,13.83,126000,4,261480,0,0,0,0,0,0,116000,10000,106000,106000
20200212,709120,同致凱基98購03,,,,,,0.00,0,0,0,0,0,0,0,0,0,0,0,0,0
20200212,709121,合晶凱基98購03,,,,,,0.00,0,0,0,0,0,0,0,0,0,0,0,0,0
20200212,709122,宜鼎凱基98購03,2.84,2.84,2.84,2.84,+0.18,6.77,1000,1,2840,0,0,0,0,0,0,1000,1000,0,0
20200212,709123,昇達科凱基98購02,1.37,1.37,1.37,1.37,+0.13,10.48,10000,1,13700,0,0,0,0,0,0,0,10000,-10000,-10000
20200212,709124,信昌電凱基98購04,1.60,1.60,1.57,1.57,-0.10,-5.99,3000,2,4740,0,0,0,0,0,0,1000,2000,-1000,-1000
20200212,709125,原相凱基98購04,5.30,5.90,2.81,5.55,-0.15,-2.63,175000,55,941850,0,0,0,0,0,0,164000,52000,112000,112000
20200212,709126,勝麗凱基98購02,2.28,2.56,2.27,2.38,+0.12,5.31,393000,26,965540,0,0,0,0,0,0,337000,293000,44000,44000
20200212,709127,群聯凱基98購03,2.67,2.71,2.61,2.70,+0.10,3.85,271000,7,717000,0,0,0,0,0,0,238000,247000,-9000,-9000
20200212,709128,廣明凱基98購04,1.82,1.86,1.82,1.85,-0.01,-0.54,30000,5,55570,0,0,0,0,0,0,30000,0,30000,30000
20200212,709129,璟德凱基98購02,2.89,3.13,1.67,3.01,-0.08,-2.59,270000,25,800580,0,0,0,0,0,0,260000,122000,138000,138000
20200212,709130,優群凱基9A購02,,,,,,0.00,0,0,0,0,0,0,0,0,0,0,0,0,0
20200212,709131,穩懋凱基98購03,2.45,2.88,2.44,2.83,+0.42,17.43,162000,21,424050,0,0,0,0,0,0,122000,68000,54000,54000
20200212,709132,穩懋凱基98購04,3.04,3.46,3.02,3.46,+0.49,16.5,56000,16,179380,0,0,0,0,0,0,54000,49000,5000,5000
20200212,709133,頎邦凱基98購01,2.45,2.49,0.91,2.49,+0.10,4.18,104000,16,241660,0,0,0,0,0,0,84000,20000,64000,64000
20200212,709134,環球晶統一98購01,1.06,1.06,1.06,1.06,+0.05,4.95,30000,1,31800,0,0,0,0,0,0,30000,0,30000,30000
20200212,709135,原相凱基99購01,1.32,1.40,1.28,1.35,+0.05,3.85,192000,32,254990,0,0,0,0,0,0,167000,23000,144000,144000
20200212,709136,群聯凱基98購04,2.17,2.17,2.12,2.13,+0.07,3.4,35000,3,74900,0,0,0,0,0,0,25000,30000,-5000,-5000
20200212,709137,碩禾凱基9A購01,,,,,,0.00,0,0,0,0,0,0,0,0,0,0,0,0,0
20200212,709138,M31元大99購02,1.13,1.13,1.13,1.13,+0.08,7.62,100000,1,113000,0,0,0,0,0,0,0,100000,-100000,-100000
20200212,709139,鈊象元大99購04,2.44,2.44,2.27,2.31,-0.18,-7.23,57000,14,132700,0,0,0,0,0,0,1000,56000,-55000,-55000
20200212,709140,泰博國票99購01,3.28,3.32,3.28,3.32,+0.21,6.75,17000,2,56040,0,0,0,0,0,0,10000,7000,3000,3000
20200212,709141,神盾國泰9A購01,2.46,2.49,2.46,2.47,+0.14,6.01,300000,26,741930,0,0,0,0,0,0,259000,25000,234000,234000
20200212,709142,宣德富邦9A購01,2.11,2.25,2.08,2.25,+0.02,0.9,288000,33,614590,0,0,0,0,0,0,283000,42000,241000,241000
20200212,709143,環球晶富邦9A購01,1.01,1.05,0.99,1.04,+0.05,5.05,287000,7,296820,0,0,0,0,0,0,21000,267000,-246000,-246000
20200212,709144,信昌電亞東99購01,0.93,0.93,0.93,0.93,-0.03,-3.12,50000,1,46500,0,0,0,0,0,0,50000,0,50000,50000
20200212,709145,大江永豐98購01,1.19,1.19,1.11,1.17,0.00,0.0,279000,28,322800,0,0,0,0,0,0,279000,95000,184000,184000
20200212,709146,同致永豐98購01,1.33,1.33,1.33,1.33,0.00,0.0,19000,2,25270,0,0,0,0,0,0,15000,4000,11000,11000
20200212,709147,合晶永豐98購02,1.24,1.39,1.24,1.39,+0.25,21.93,276000,8,350110,0,0,0,0,0,0,40000,276000,-236000,-236000
20200212,709148,良維永豐98購01,1.21,1.25,1.21,1.25,+0.10,8.7,205000,5,250180,0,0,0,0,0,0,0,205000,-205000,-205000
20200212,709149,東隆興永豐98購01,1.43,1.55,1.43,1.55,+0.21,15.67,353000,9,518340,0,0,0,0,0,0,150000,203000,-53000,-53000
20200212,709150,南光永豐98購01,0.71,0.71,0.71,0.71,0.00,0.0,71000,1,50410,0,0,0,0,0,0,71000,0,71000,71000
20200212,709151,茂達永豐98購01,1.16,1.18,1.16,1.18,+0.06,5.36,131000,4,153120,0,0,0,0,0,0,114000,17000,97000,97000
20200212,709152,新潤永豐98購01,,,,,,0.00,0,0,0,0,0,0,0,0,0,0,0,0,0
20200212,709153,大江兆豐98購01,1.09,1.13,1.05,1.08,-0.01,-0.92,891000,43,977200,0,0,0,0,0,0,550000,330000,220000,220000
20200212,709154,VHQ康和98購01,1.22,1.60,1.21,1.48,+0.31,26.5,438000,20,541610,0,0,0,0,0,0,424000,5000,419000,419000
20200212,709155,世界群益9A購01,1.97,2.05,1.97,2.05,+0.14,7.33,32000,4,64580,0,0,0,0,0,0,10000,22000,-12000,-12000
20200212,709156,台燿群益99購01,1.22,1.32,1.22,1.32,+0.17,14.78,662000,38,851710,0,0,0,0,0,0,176000,541000,-365000,-365000
20200212,709157,威剛群益9A購02,1.57,1.75,1.57,1.65,+0.11,7.14,906000,50,1471830,0,0,0,0,0,0,717000,317000,400000,400000
20200212,709158,廣明群益98購02,2.34,2.43,2.31,2.43,0.00,0.0,108000,9,253790,0,0,0,0,0,0,87000,59000,28000,28000
20200212,709159,優群群益99購02,1.11,1.15,1.10,1.11,+0.07,6.73,538000,15,602210,0,0,0,0,0,0,320000,218000,102000,102000
20200212,709160,大江元富98購01,2.06,2.06,1.99,1.99,-0.01,-0.5,142000,18,290260,0,0,0,0,0,0,127000,15000,112000,112000
20200212,709161,元太台新98購01,1.55,1.63,1.55,1.63,+0.14,9.4,94000,7,150200,0,0,0,0,0,0,0,94000,-94000,-94000
20200212,709162,鈊象台新98購02,1.07,1.07,0.98,0.99,-0.08,-7.48,121000,7,124500,0,0,0,0,0,0,61000,60000,1000,1000
20200212,709163,宇峻元大99購01,1.33,1.33,1.19,1.21,-0.30,-19.87,131000,14,164310,0,0,0,0,0,0,131000,0,131000,131000
20200212,709164,金居元大99購02,1.54,1.61,1.53,1.56,+0.07,4.7,313000,13,492380,0,0,0,0,0,0,77000,263000,-186000,-186000
20200212,709165,新鉅科元大98購01,1.95,2.22,1.95,2.15,+0.25,13.16,374000,25,776730,0,0,0,0,0,0,120000,280000,-160000,-160000
20200212,709166,上詮永豐98購01,1.07,1.16,1.07,1.16,+0.10,9.43,321000,9,362240,0,0,0,0,0,0,95000,226000,-131000,-131000
20200212,709167,光頡永豐98購01,1.06,1.06,1.05,1.05,-0.07,-6.25,62000,4,65330,0,0,0,0,0,0,58000,4000,54000,54000
20200212,709168,波若威永豐98購02,0.99,1.05,0.99,1.05,+0.05,5.0,257000,14,261090,0,0,0,0,0,0,232000,25000,207000,207000
20200212,709169,建榮永豐99購02,1.26,1.26,1.26,1.26,+0.02,1.61,70000,2,88200,0,0,0,0,0,0,0,70000,-70000,-70000
20200212,709170,健信永豐98購01,0.80,0.80,0.80,0.80,+0.02,2.56,30000,1,24000,0,0,0,0,0,0,30000,0,30000,30000
20200212,709171,璟德永豐98購01,1.57,1.71,1.55,1.71,+0.03,1.79,180000,18,298450,0,0,0,0,0,0,141000,41000,100000,100000
20200212,709172,統新國泰99購01,,,,,,0.00,0,0,0,0,0,0,0,0,0,0,0,0,0
20200212,709173,環球晶統一99購02,,,,,,0.00,0,0,0,0,0,0,0,0,0,0,0,0,0
20200212,709174,太醫中信99購01,,,,,,0.00,0,0,0,0,0,0,0,0,0,0,0,0,0
20200212,709175,環球晶中信98購01,0.66,0.66,0.66,0.66,+0.01,1.54,10000,1,6600,0,0,0,0,0,0,10000,0,10000,10000
20200212,709176,大江凱基98購06,2.00,2.00,1.91,1.96,-0.02,-1.01,227000,15,441590,0,0,0,0,0,0,201000,26000,175000,175000
20200212,709177,宣德凱基98購03,1.42,1.48,0.84,1.48,-0.04,-2.63,162000,25,226420,0,0,0,0,0,0,152000,90000,62000,62000
20200212,709178,精測凱基98購04,3.28,3.37,3.28,3.37,+0.25,8.01,9000,5,30040,0,0,0,0,0,0,9000,9000,0,0
20200212,709179,雙鴻兆豐99購01,0.77,0.86,0.77,0.84,+0.04,5.0,1360000,52,1113950,0,0,0,0,0,0,463000,896000,-433000,-433000
20200212,709180,統新康和98購02,1.51,1.65,1.49,1.65,+0.17,11.49,229000,7,353280,0,0,0,0,0,0,50000,179000,-129000,-129000
20200212,709181,太景*群益99購01,1.66,1.67,1.56,1.56,-0.04,-2.5,116000,8,189260,0,0,0,0,0,0,55000,116000,-61000,-61000
20200212,709182,大江富邦9A購01,1.57,1.57,1.46,1.52,-0.01,-0.65,677000,45,1032480,0,0,0,0,0,0,614000,63000,551000,551000
20200212,709183,原相麥證99購01,1.08,1.17,1.03,1.10,+0.02,1.85,1421000,101,1557080,751000,591000,160000,0,0,0,751000,601000,150000,150000
20200212,709184,順達麥證98購01,1.34,1.44,1.34,1.44,+0.17,13.39,156000,10,221470,10000,146000,-136000,0,0,0,10000,146000,-136000,-136000
20200212,709185,璟德麥證98購01,2.33,2.48,2.30,2.36,+0.15,6.79,307000,25,730280,207000,100000,107000,0,0,0,207000,100000,107000,107000
20200212,709186,鈊象台新98購03,,,,,,0.00,0,0,0,0,0,0,0,0,0,0,0,0,0
20200212,709187,大中元富98購01,1.65,1.77,1.65,1.77,+0.14,8.59,508000,10,878740,0,0,0,0,0,0,485000,123000,362000,362000
20200212,709188,太景*元富98購01,2.30,2.36,2.20,2.20,-0.02,-0.9,594000,20,1354540,0,0,0,0,0,0,360000,234000,126000,126000
20200212,709189,台半元富98購01,2.14,2.22,2.14,2.21,+0.09,4.25,73000,8,159930,0,0,0,0,0,0,43000,48000,-5000,-5000
20200212,709190,由田元富98購01,2.05,2.09,2.05,2.09,+0.03,1.46,20000,2,41400,0,0,0,0,0,0,10000,10000,0,0
20200212,709191,杰力元富98購01,2.19,2.19,2.19,2.19,+0.04,1.86,39000,3,85410,0,0,0,0,0,0,20000,19000,1000,1000
20200212,709192,金居元富99購01,1.10,1.18,1.10,1.16,+0.09,8.41,248000,14,282360,0,0,0,0,0,0,138000,110000,28000,28000
20200212,709193,美琪瑪元富98購01,,,,,,0.00,0,0,0,0,0,0,0,0,0,0,0,0,0
20200212,709194,統新元富98購03,2.51,2.86,2.51,2.68,+0.28,11.67,288000,35,774870,0,0,0,0,0,0,10000,278000,-268000,-268000
20200212,709195,碩禾元富9B購01,1.17,1.19,1.14,1.15,+0.01,0.88,46000,6,53450,0,0,0,0,0,0,10000,36000,-26000,-26000
20200212,709196,群聯中信99購01,,,,,,0.00,0,0,0,0,0,0,0,0,0,0,0,0,0
20200212,709197,大學光統一99購01,0.58,0.63,0.58,0.63,+0.04,6.78,26000,4,15890,0,0,0,0,0,0,5000,21000,-16000,-16000
20200212,709198,原相統一99購01,3.65,3.89,3.44,3.68,+0.03,0.82,211000,13,784010,0,0,0,0,0,0,152000,59000,93000,93000
20200212,709199,M31凱基98購02,,,,,,0.00,0,0,0,0,0,0,0,0,0,0,0,0,0
20200212,709200,中美晶凱基98購02,1.36,1.41,1.36,1.41,+0.09,6.82,233000,3,326030,0,0,0,0,0,0,0,233000,-233000,-233000
20200212,709201,建榮凱基9A購01,,,,,,0.00,0,0,0,0,0,0,0,0,0,0,0,0,0
20200212,709202,神盾凱基99購01,0.81,0.84,0.81,0.83,+0.04,5.06,256000,6,208500,0,0,0,0,0,0,232000,25000,207000,207000
20200212,709203,金可兆豐99購01,1.33,1.39,1.33,1.39,+0.07,5.3,483000,13,661270,0,0,0,0,0,0,155000,328000,-173000,-173000
20200212,709204,宣德兆豐98購02,1.43,1.48,1.43,1.48,-0.03,-1.99,293000,9,423270,0,0,0,0,0,0,209000,84000,125000,125000
20200212,709205,環球晶兆豐98購02,,,,,,0.00,0,0,0,0,0,0,0,0,0,0,0,0,0
20200212,709206,合晶群益98購01,2.09,2.37,2.09,2.37,+0.40,20.3,332000,27,740020,0,0,0,0,0,0,40000,332000,-292000,-292000
20200212,709207,原相群益9B購01,6.75,7.45,6.65,7.15,+0.35,5.15,125000,15,874250,0,0,0,0,0,0,82000,43000,39000,39000
20200212,709208,統新群益98購02,2.07,2.42,2.07,2.29,+0.25,12.25,313000,24,695650,0,0,0,0,0,0,30000,283000,-253000,-253000
20200212,709209,廣明群益98購03,1.41,1.41,1.41,1.41,-0.04,-2.76,23000,3,32430,0,0,0,0,0,0,23000,13000,10000,10000
20200212,709210,緯軟群益99購01,1.78,1.78,1.73,1.73,+0.03,1.76,139000,2,245470,0,0,0,0,0,0,139000,0,139000,139000
20200212,709211,鈺太群益98購01,1.79,2.21,1.79,2.21,+0.44,24.86,235000,18,455190,0,0,0,0,0,0,41000,204000,-163000,-163000
20200212,709212,建榮國票99購02,,,,,,0.00,0,0,0,0,0,0,0,0,0,0,0,0,0
20200212,709213,雍智國票99購02,1.43,1.54,1.40,1.54,+0.17,12.41,129000,6,186160,0,0,0,0,0,0,127000,2000,125000,125000
20200212,709214,中美晶元大99購02,2.01,2.16,1.98,2.04,+0.06,3.03,283000,36,589490,0,0,0,0,0,0,140000,200000,-60000,-60000
20200212,709215,金居元大9A購01,3.82,3.98,3.82,3.97,+0.30,8.17,79000,8,310340,0,0,0,0,0,0,51000,79000,-28000,-28000
20200212,709216,威剛元大99購02,1.17,1.26,1.17,1.20,+0.06,5.26,337000,30,409150,0,0,0,0,0,0,193000,255000,-62000,-62000
20200212,709217,宣德元大99購01,1.86,1.95,1.84,1.92,-0.03,-1.54,570000,23,1082390,0,0,0,0,0,0,570000,131000,439000,439000
20200212,709218,群聯元大98購04,2.43,2.53,2.43,2.51,+0.05,2.03,260000,11,651580,0,0,0,0,0,0,246000,252000,-6000,-6000
20200212,709219,碩禾元大99購02,2.44,2.44,2.44,2.44,-0.01,-0.41,30000,1,73200,0,0,0,0,0,0,0,30000,-30000,-30000
20200212,709220,網家元大99購01,2.47,2.47,2.33,2.35,-0.10,-4.08,497000,33,1183380,0,0,0,0,0,0,398000,489000,-91000,-91000
20200212,709221,環球晶元大98購04,2.04,2.05,2.04,2.05,+0.12,6.22,40000,2,81610,0,0,0,0,0,0,1000,40000,-39000,-39000
20200212,709222,環球晶元大99購01,2.05,2.12,2.05,2.12,+0.09,4.43,9000,3,18720,0,0,0,0,0,0,9000,1000,8000,8000
20200212,709223,雙鴻元大99購05,0.92,0.99,0.92,0.99,+0.06,6.45,345000,13,330710,0,0,0,0,0,0,159000,186000,-27000,-27000
20200212,709224,穩懋元大98購02,4.09,4.62,3.95,4.62,+0.64,16.08,554000,50,2274220,0,0,0,0,0,0,535000,478000,57000,57000
20200212,709225,穩懋元大99購01,1.84,2.12,1.80,2.05,+0.25,13.89,535000,55,1049700,0,0,0,0,0,0,437000,489000,-52000,-52000
20200212,709226,泰博國泰99購01,2.02,2.04,1.99,1.99,+0.11,5.85,62000,4,124630,0,0,0,0,0,0,25000,37000,-12000,-12000
20200212,709227,大江富邦9A購02,1.18,1.18,1.13,1.14,+0.02,1.79,415000,17,478780,0,0,0,0,0,0,272000,143000,129000,129000
20200212,709228,中美晶富邦9A購01,0.63,0.69,0.62,0.63,+0.01,1.61,369000,21,237280,0,0,0,0,0,0,111000,259000,-148000,-148000
20200212,709229,精測富邦99購01,0.63,0.63,0.63,0.63,+0.02,3.28,133000,4,83790,0,0,0,0,0,0,30000,103000,-73000,-73000
20200212,709230,環球晶富邦9B購01,0.69,0.73,0.69,0.72,+0.06,9.09,61000,3,44120,0,0,0,0,0,0,1000,61000,-60000,-60000
20200212,709231,威剛麥證98購01,1.12,1.22,1.12,1.19,+0.16,15.53,310000,10,365450,0,310000,-310000,0,0,0,0,310000,-310000,-310000
20200212,709232,群聯麥證98購01,1.21,1.21,1.21,1.21,+0.02,1.68,10000,1,12100,0,10000,-10000,0,0,0,0,10000,-10000,-10000
20200212,709233,聯亞麥證98購01,2.17,2.17,2.17,2.17,+0.15,7.43,10000,1,21700,10000,0,10000,0,0,0,10000,0,10000,10000
20200212,709234,力旺元富98購01,2.46,2.66,2.45,2.61,+0.13,5.24,788000,31,2010010,0,0,0,0,0,0,413000,728000,-315000,-315000
20200212,709235,大江元富98購02,3.80,3.80,3.56,3.64,-0.10,-2.67,108000,10,400220,0,0,0,0,0,0,58000,50000,8000,8000
20200212,709236,原相元富98購01,3.36,3.55,3.18,3.36,+0.10,3.07,674000,22,2314670,0,0,0,0,0,0,576000,319000,257000,257000
20200212,709237,新鉅科元富98購01,1.72,1.91,1.71,1.91,+0.31,19.38,151000,15,269780,0,0,0,0,0,0,14000,137000,-123000,-123000
20200212,709238,聚積元富98購01,2.47,2.52,2.47,2.52,+0.21,9.09,110000,10,274200,0,0,0,0,0,0,20000,90000,-70000,-70000
20200212,709239,環球晶第一01購01,0.96,0.97,0.95,0.96,+0.06,6.67,37000,4,35520,0,0,0,0,0,0,2000,35000,-33000,-33000
20200212,709240,M31永豐98購01,1.58,1.58,1.57,1.57,+0.12,8.28,30000,3,47300,0,0,0,0,0,0,10000,20000,-10000,-10000
20200212,709241,凡甲永豐98購01,1.26,1.29,1.25,1.27,-0.07,-5.22,417000,11,527370,0,0,0,0,0,0,322000,95000,227000,227000
20200212,709242,大中永豐98購01,1.07,1.16,1.07,1.16,+0.12,11.54,120000,4,134380,0,0,0,0,0,0,48000,72000,-24000,-24000
20200212,709243,迅得永豐98購01,1.24,1.33,1.23,1.30,+0.08,6.56,728000,22,930960,0,0,0,0,0,0,269000,459000,-190000,-190000
20200212,709244,杰力永豐98購01,1.03,1.11,1.03,1.11,+0.10,9.9,245000,5,262150,0,0,0,0,0,0,50000,195000,-145000,-145000
20200212,709245,統新永豐98購02,0.90,1.04,0.90,1.00,+0.14,16.28,703000,18,673080,0,0,0,0,0,0,45000,703000,-658000,-658000
20200212,709246,晶焱永豐98購01,1.59,1.64,1.59,1.64,+0.18,12.33,102000,4,165880,0,0,0,0,0,0,0,102000,-102000,-102000
20200212,709247,網龍永豐98購01,1.11,1.15,1.11,1.15,-0.05,-4.17,61000,2,69390,0,0,0,0,0,0,61000,0,61000,61000
20200212,709248,優群永豐98購01,1.35,1.41,1.35,1.41,+0.11,8.46,291000,8,400500,0,0,0,0,0,0,11000,280000,-269000,-269000
20200212,709249,原相台新9A購01,2.73,2.73,2.55,2.55,-0.13,-4.85,39000,3,100930,0,0,0,0,0,0,39000,0,39000,39000
20200212,709250,聯亞台新9A購01,1.57,1.59,1.55,1.55,+0.06,4.03,137000,12,214170,0,0,0,0,0,0,25000,112000,-87000,-87000
20200212,709251,前鼎統一99購01,0.89,1.01,0.89,1.01,+0.15,17.44,286000,4,265900,0,0,0,0,0,0,0,286000,-286000,-286000
20200212,709252,聯亞中信98購01,,,,,,0.00,0,0,0,0,0,0,0,0,0,0,0,0,0
20200212,709253,晶焱凱基98購03,2.15,2.15,2.15,2.15,+0.25,13.16,3000,1,6450,0,0,0,0,0,0,0,3000,-3000,-3000
20200212,709254,群聯凱基99購01,,,,,,0.00,0,0,0,0,0,0,0,0,0,0,0,0,0
20200212,709255,神盾台新98購02,1.39,1.39,1.36,1.36,+0.17,14.29,268000,4,370070,0,0,0,0,0,0,200000,68000,132000,132000
20200212,709256,精測台新99購02,1.44,1.44,1.44,1.44,+0.07,5.11,10000,1,14400,0,0,0,0,0,0,0,10000,-10000,-10000
20200212,709257,VHQ元富98購01,1.06,1.25,1.06,1.25,+0.26,26.26,189000,14,207600,0,0,0,0,0,0,107000,82000,25000,25000
20200212,709258,前鼎元富98購01,2.72,2.72,2.72,2.72,+0.05,1.87,10000,1,27200,0,0,0,0,0,0,0,10000,-10000,-10000
20200212,709259,精測元富98購02,3.09,3.09,3.09,3.09,+0.11,3.69,66000,2,203940,0,0,0,0,0,0,0,66000,-66000,-66000
20200212,709260,中美晶國票98購01,4.59,4.94,4.59,4.94,+0.69,16.24,8000,3,37640,0,0,0,0,0,0,0,8000,-8000,-8000
20200212,709261,保瑞國票98購01,,,,,,0.00,0,0,0,0,0,0,0,0,0,0,0,0,0
20200212,709262,前鼎國票99購01,,,,,,0.00,0,0,0,0,0,0,0,0,0,0,0,0,0
20200212,709263,原相國票99購01,3.68,3.95,3.58,3.58,-0.10,-2.72,31000,8,115660,0,0,0,0,0,0,12000,19000,-7000,-7000
20200212,709264,泰博國票99購02,,,,,,0.00,0,0,0,0,0,0,0,0,0,0,0,0,0
20200212,709265,統新國票99購01,1.04,1.16,1.04,1.16,+0.15,14.85,283000,10,308420,0,0,0,0,0,0,0,283000,-283000,-283000
20200212,709266,六角兆豐98購01,0.86,0.87,0.86,0.87,+0.10,12.99,60000,2,52100,0,0,0,0,0,0,0,60000,-60000,-60000
20200212,709267,宇峻群益9A購01,0.79,0.85,0.77,0.84,-0.10,-10.64,287000,11,229500,0,0,0,0,0,0,140000,147000,-7000,-7000
20200212,709268,博智群益98購01,2.32,2.60,2.32,2.44,+0.20,8.93,238000,23,585830,0,0,0,0,0,0,26000,211000,-185000,-185000
20200212,709269,網龍群益98購03,,,,,,0.00,0,0,0,0,0,0,0,0,0,0,0,0,0
20200212,709270,太景*國泰9A購01,1.35,1.36,1.27,1.28,-0.03,-2.29,335000,20,442920,0,0,0,0,0,0,80000,255000,-175000,-175000
20200212,709271,前鼎國泰99購01,1.79,2.04,1.79,2.00,+0.26,14.94,128000,11,248490,0,0,0,0,0,0,45000,128000,-83000,-83000
20200212,709272,新鉅科國泰99購01,2.00,2.13,2.00,2.13,+0.31,17.03,21000,3,42230,0,0,0,0,0,0,0,21000,-21000,-21000
20200212,709273,環宇富邦9A購01,0.99,1.01,0.99,1.01,+0.03,3.06,15000,2,14950,0,0,0,0,0,0,0,15000,-15000,-15000
20200212,709274,大江元大98購02,1.48,1.48,1.42,1.45,+0.03,2.11,353000,5,514320,0,0,0,0,0,0,273000,353000,-80000,-80000
20200212,709275,前鼎元大99購01,1.85,1.85,1.85,1.85,+0.26,16.35,5000,1,9250,0,0,0,0,0,0,0,5000,-5000,-5000
20200212,709276,威剛元大9A購01,1.14,1.23,1.14,1.20,+0.08,7.14,169000,9,202610,0,0,0,0,0,0,94000,147000,-53000,-53000
20200212,709277,神盾元大9A購01,1.86,1.94,1.86,1.91,+0.09,4.95,478000,24,918360,0,0,0,0,0,0,242000,241000,1000,1000
20200212,709278,群聯元大99購02,1.63,1.67,1.63,1.65,+0.03,1.85,460000,18,758220,0,0,0,0,0,0,67000,433000,-366000,-366000
20200212,709279,緯軟元大98購02,2.08,2.08,2.06,2.06,+0.05,2.49,200000,5,413150,0,0,0,0,0,0,200000,0,200000,200000
20200212,709280,璟德元大98購01,3.91,4.15,3.82,4.00,+0.09,2.3,22000,9,87130,0,0,0,0,0,0,19000,7000,12000,12000
20200212,709281,中美晶日盛9A購01,2.25,2.34,2.25,2.34,+0.12,5.41,18000,3,41400,0,0,0,0,0,0,0,18000,-18000,-18000
20200212,709282,伍豐永豐98購01,1.02,1.02,1.02,1.02,+0.01,0.99,23000,1,23460,0,0,0,0,0,0,0,23000,-23000,-23000
20200212,709283,兆利永豐98購01,1.28,1.33,1.28,1.31,-0.02,-1.5,28000,3,36870,0,0,0,0,0,0,11000,17000,-6000,-6000
20200212,709284,宜鼎永豐98購01,1.03,1.03,1.03,1.03,+0.05,5.1,50000,1,51500,0,0,0,0,0,0,0,50000,-50000,-50000
20200212,709285,前鼎永豐98購01,,,,,,0.00,0,0,0,0,0,0,0,0,0,0,0,0,0
20200212,709286,建榮永豐9A購01,1.01,1.01,1.01,1.01,-0.03,-2.88,54000,1,54540,0,0,0,0,0,0,54000,0,54000,54000
20200212,709287,新鉅科永豐98購01,1.02,1.13,1.02,1.13,+0.18,18.95,662000,29,692750,0,0,0,0,0,0,20000,662000,-642000,-642000
20200212,709288,聯亞永豐98購01,1.40,1.40,1.36,1.36,+0.05,3.82,26000,5,35480,0,0,0,0,0,0,16000,26000,-10000,-10000
20200212,709289,雙鴻永豐99購01,1.19,1.28,1.19,1.24,+0.07,5.98,562000,19,679880,0,0,0,0,0,0,276000,561000,-285000,-285000
20200212,709290,金居凱基98購02,2.49,2.49,2.49,2.49,+0.63,33.87,4000,1,9960,0,0,0,0,0,0,0,4000,-4000,-4000
20200212,709291,威剛凱基9A購01,1.02,1.02,1.01,1.01,+0.16,18.82,8000,2,8130,0,0,0,0,0,0,0,8000,-8000,-8000
20200212,709292,環球晶凱基98購04,2.06,2.06,2.06,2.06,+0.34,19.77,1000,1,2060,0,0,0,0,0,0,1000,1000,0,0
20200212,709293,環球晶康和98購01,1.22,1.22,1.22,1.22,+0.11,9.91,1000,1,1220,0,0,0,0,0,0,1000,1000,0,0
20200212,709294,大江群益98購01,,,,,,0.00,0,0,0,0,0,0,0,0,0,0,0,0,0
20200212,709295,宇峻群益9A購02,,,,,,0.00,0,0,0,0,0,0,0,0,0,0,0,0,0
20200212,709296,神盾群益9A購02,2.80,2.86,2.78,2.78,+0.37,15.35,14000,6,39480,0,0,0,0,0,0,5000,14000,-9000,-9000
20200212,709297,宣德國票99購01,2.78,2.78,2.78,2.78,+0.49,21.4,3000,1,8340,0,0,0,0,0,0,0,3000,-3000,-3000
20200212,709298,群聯國票99購01,,,,,,0.00,0,0,0,0,0,0,0,0,0,0,0,0,0
20200212,709299,VHQ國泰99購01,1.40,1.45,1.40,1.45,+0.08,5.84,810000,6,1154000,0,0,0,0,0,0,800000,810000,-10000,-10000
20200212,709300,宣德國泰9A購01,1.86,1.86,1.86,1.86,+0.17,10.06,191000,2,355260,0,0,0,0,0,0,0,191000,-191000,-191000
20200212,709301,大宇資永豐98購02,,,,,,0.00,0,0,0,0,0,0,0,0,0,0,0,0,0
20200212,709302,六角永豐98購01,1.34,1.36,1.30,1.30,+0.10,8.33,436000,23,584780,0,0,0,0,0,0,0,436000,-436000,-436000
20200212,709303,亞泰永豐98購01,,,,,,0.00,0,0,0,0,0,0,0,0,0,0,0,0,0
20200212,709304,信昌電永豐98購01,,,,,,0.00,0,0,0,0,0,0,0,0,0,0,0,0,0
20200212,709305,宣德永豐98購01,1.61,1.61,1.61,1.61,+0.11,7.33,6000,1,9660,0,0,0,0,0,0,0,6000,-6000,-6000
20200212,709306,原相永豐98購02,1.06,1.16,1.06,1.09,+0.18,19.78,38000,18,42540,0,0,0,0,0,0,11000,38000,-27000,-27000
20200212,709307,神盾永豐99購01,1.41,1.43,1.41,1.43,+0.15,11.72,10000,2,14200,0,0,0,0,0,0,5000,10000,-5000,-5000
20200212,709308,雙美永豐99購01,,,,,,0.00,0,0,0,0,0,0,0,0,0,0,0,0,0
20200212,709309,譜瑞永豐98購01,1.22,1.31,1.19,1.23,+0.20,19.42,131000,18,164720,0,0,0,0,0,0,11000,131000,-120000,-120000
20200212,709310,合晶元富98購01,,,,,,0.00,0,0,0,0,0,0,0,0,0,0,0,0,0
20200212,709312,大學光元大99購01,1.01,1.01,1.01,1.01,+0.03,3.06,1000,1,1010,0,0,0,0,0,0,1000,1000,0,0
20200212,709313,保瑞元大98購01,,,,,,0.00,0,0,0,0,0,0,0,0,0,0,0,0,0
20200212,709315,胡連元大98購01,1.61,1.61,1.61,1.61,+0.09,5.92,10000,1,16100,0,0,0,0,0,0,0,10000,-10000,-10000
20200212,709316,神盾元大9A購02,1.35,1.37,1.35,1.35,+0.03,2.27,38000,5,51890,0,0,0,0,0,0,5000,38000,-33000,-33000
20200212,709317,群聯元大98購05,,,,,,0.00,0,0,0,0,0,0,0,0,0,0,0,0,0
20200212,709318,環球晶元大98購09,3.18,3.22,3.18,3.22,+0.18,5.92,16000,4,50960,0,0,0,0,0,0,2000,16000,-14000,-14000
20200212,709319,環球晶元大98購10,2.22,2.27,2.22,2.27,+0.13,6.07,41000,3,91670,0,0,0,0,0,0,1000,41000,-40000,-40000
20200212,709320,雙鴻元大9A購01,1.14,1.15,1.14,1.15,+0.06,5.5,16000,2,18340,0,0,0,0,0,0,0,16000,-16000,-16000
20200212,709321,譜瑞元大98購03,3.97,4.11,3.95,3.95,+0.72,22.29,18000,6,72780,0,0,0,0,0,0,3000,18000,-15000,-15000
