date,sid,name,open,high,low,close,amplitude,amplitude_ratio,capacity,transaction,turnover,foreign_dealers_buy,foreign_dealers_sell,foreign_dealers_total,investment_trust_buy,investment_trust_sell,investment_trust_total,dealer_buy,dealer_sell,dealer_total,institutional_investors_total
20200520,0050,元大台灣50,84.00,84.20,83.50,83.80,-0.10,-0.12,9894141,8013,830898729,5402000,527000,4875000,0,0,0,2306000,5752000,-3446000,1429000
20200520,0051,元大中型100,33.73,34.06,33.73,34.04,+0.37,1.1,45000,17,1526740,0,0,0,0,0,0,31000,20000,11000,11000
20200520,0052,富邦科技,63.65,63.65,63.05,63.25,-0.30,-0.47,122137,23,7728263,0,0,0,0,0,0,119000,101000,18000,18000
20200520,0053,元大電子,38.52,38.52,38.43,38.45,+0.15,0.39,17000,12,654000,0,0,0,0,0,0,9000,6000,3000,3000
20200520,0054,元大台商50,22.78,22.82,22.75,22.75,+0.06,0.26,131000,8,2980480,0,0,0,0,0,0,129000,124000,5000,5000
20200520,0055,元大MSCI金融,17.10,17.12,17.04,17.05,-0.05,-0.29,24000,21,409910,0,0,0,0,0,0,11000,1000,10000,10000
20200520,0056,元大高股息,27.43,27.54,27.42,27.48,+0.05,0.18,11379613,6080,312825020,0,1000,-1000,0,0,0,1139000,1023000,116000,115000
20200520,0057,富邦摩台,55.40,55.40,55.25,55.25,0.00,0.00,50000,9,2766800,0,0,0,0,0,0,35000,34000,1000,1000
20200520,0061,元大寶滬深,17.52,17.59,17.43,17.54,+0.02,0.11,667300,141,11695515,459000,53000,406000,0,0,0,174000,48000,126000,532000
20200520,006203,元大MSCI台灣,39.45,39.46,39.26,39.26,-0.07,-0.18,4000,4,157470,0,0,0,0,0,0,1000,3000,-2000,-2000
20200520,006204,永豐臺灣加權,54.25,54.25,54.25,54.25,+0.25,0.46,25000,3,1356250,0,0,0,0,0,0,25000,25000,0,0
20200520,006205,富邦上証,29.20,29.24,29.10,29.24,+0.07,0.24,3130993,772,91360189,0,103000,-103000,0,0,0,3047000,2788000,259000,156000
20200520,006206,元大上證50,30.46,30.55,30.36,30.55,+0.09,0.3,530182,217,16156709,107000,1000,106000,0,0,0,402000,281000,121000,227000
20200520,006207,FH滬深,22.76,22.91,22.76,22.90,+0.07,0.31,481001,314,10989412,104000,0,104000,0,0,0,360000,444000,-84000,20000
20200520,006208,富邦台50,48.03,48.14,47.84,47.95,0.00,0.00,716166,270,34365238,0,0,0,0,0,0,449000,511000,-62000,-62000
20200520,00625K,富邦上証+R,7.01,7.01,7.01,7.01,+0.01,0.14,50000,2,350500,0,0,0,0,0,0,50000,50000,0,0
20200520,00631L,元大台灣50正2,44.20,44.39,43.72,44.00,+0.18,0.41,7080000,1972,312265740,587000,585000,2000,0,0,0,2355000,1273000,1082000,1084000
20200520,00632R,元大台灣50反1,10.27,10.32,10.24,10.29,-0.01,-0.1,71041440,6188,729813224,4757000,718000,4039000,0,0,0,10968000,41592000,-30624000,-26585000
20200520,00633L,富邦上証正2,42.01,42.40,41.93,42.25,+0.19,0.45,6788000,982,285955640,380000,276000,104000,0,0,0,2581000,2539000,42000,146000
20200520,00634R,富邦上証反1,5.74,5.74,5.71,5.72,0.00,0.00,517000,64,2956510,0,40000,-40000,0,0,0,40000,231000,-191000,-231000
20200520,00635U,元大S&P黃金,24.75,24.86,24.75,24.83,+0.22,0.89,1340715,558,33286487,1000,0,1000,0,0,0,363000,155000,208000,209000
20200520,00636,國泰中國A50,20.33,20.41,20.26,20.40,+0.09,0.44,2509726,838,51067764,175000,555000,-380000,0,0,0,2261000,1418808,842192,462192
20200520,00636K,國泰中國A50+U,6.76,6.76,6.76,6.76,+0.01,0.15,100,1,676,0,0,0,0,0,0,100,100,0,0
20200520,00637L,元大滬深300正2,16.20,16.35,16.18,16.30,+0.07,0.43,44539825,3141,724013367,4459000,250000,4209000,0,0,0,16924000,14116000,2808000,7017000
20200520,00638R,元大滬深300反1,11.56,11.56,11.49,11.49,-0.04,-0.35,386000,68,4444690,30000,9000,21000,0,0,0,124000,186000,-62000,-41000
20200520,00639,富邦深100,11.40,11.44,11.37,11.40,+0.01,0.09,3051708,531,34758160,386000,0,386000,0,0,0,2373000,1860000,513000,899000
20200520,00640L,富邦日本正2,16.76,16.97,16.73,16.89,+0.19,1.14,971000,187,16373600,0,14000,-14000,0,0,0,815000,374000,441000,427000
20200520,00641R,富邦日本反1,14.81,14.82,14.72,14.77,-0.07,-0.47,685000,99,10120060,0,2000,-2000,0,0,0,251000,458000,-207000,-209000
20200520,00642U,元大S&P石油,9.50,9.64,9.50,9.60,-0.04,-0.41,23380120,6581,224044515,42000,2000,40000,0,0,0,400000,382000,18000,58000
20200520,00643,群益深証中小,13.74,13.76,13.65,13.73,+0.08,0.59,1473860,860,20200844,145000,499000,-354000,0,0,0,1204000,534000,670000,316000
20200520,00643K,群益深証中小+R,,,,,0.00,0.00,0,0,0,0,0,0,0,0,0,0,0,0,0
20200520,00645,富邦日本,19.25,19.40,19.25,19.36,+0.16,0.83,80067,17,1551148,0,0,0,0,0,0,76000,61000,15000,15000
20200520,00646,元大S&P500,26.81,26.90,26.80,26.87,-0.10,-0.37,439070,229,11788060,18000,0,18000,0,0,0,133000,140000,-7000,11000
20200520,00647L,元大S&P500正2,31.86,32.17,31.50,32.13,-0.21,-0.65,1992000,351,63483900,11000,8000,3000,0,0,0,1203000,1659000,-456000,-453000
20200520,00648R,元大S&P500反1,11.22,11.23,11.18,11.18,+0.03,0.27,1696000,154,19000310,0,0,0,0,0,0,1100000,334000,766000,766000
20200520,00650L,FH香港正2,22.08,22.26,21.92,22.01,+0.01,0.05,248000,80,5477390,71000,22000,49000,0,0,0,78000,76000,2000,51000
20200520,00651R,FH香港反1,8.87,8.91,8.84,8.87,-0.02,-0.22,186000,33,1650430,0,2000,-2000,0,0,0,114000,119000,-5000,-7000
20200520,00652,富邦印度,16.63,16.64,16.46,16.53,-0.21,-1.25,1589665,519,26302920,1000,490000,-489000,0,0,0,118000,944000,-826000,-1315000
20200520,00653L,富邦印度正2,14.27,14.58,14.21,14.43,-0.22,-1.5,12601700,2349,180894235,608000,1123000,-515000,0,0,0,1400000,6572700,-5172700,-5687700
20200520,00654R,富邦印度反1,16.70,16.70,16.48,16.50,+0.07,0.43,160000,52,2654950,9000,29000,-20000,0,0,0,20000,47000,-27000,-47000
20200520,00655L,國泰中國A50正2,30.54,30.80,30.47,30.72,+0.15,0.49,3347000,443,102523890,264000,305000,-41000,0,0,0,1825000,1138000,687000,646000
20200520,00656R,國泰中國A50反1,10.46,10.46,10.43,10.45,-0.01,-0.1,145000,13,1513670,0,0,0,0,0,0,131000,109000,22000,22000
20200520,00657,國泰日經225,25.49,25.71,25.49,25.67,+0.22,0.86,102119,7,2621236,0,0,0,0,0,0,102000,101000,1000,1000
20200520,00657K,國泰日經225+U,8.55,8.55,8.55,8.55,+0.07,0.83,100,1,855,0,0,0,0,0,0,100,100,0,0
20200520,00660,元大歐洲50,20.60,20.65,20.56,20.65,-0.12,-0.58,19000,13,391550,0,0,0,0,0,0,9000,3000,6000,6000
20200520,00661,元大日經225,25.95,26.01,25.95,26.01,0.00,0.00,32000,3,832230,0,0,0,0,0,0,31000,31000,0,0
20200520,00662,富邦NASDAQ,35.99,36.17,35.96,36.07,-0.04,-0.11,465338,90,16775398,0,0,0,0,0,0,293000,301000,-8000,-8000
20200520,00663L,國泰臺灣加權正2,39.63,39.85,39.23,39.47,+0.08,0.2,340003,49,13477047,70000,0,70000,0,0,0,167000,110000,57000,127000
20200520,00664R,國泰臺灣加權反1,11.67,11.73,11.63,11.69,-0.01,-0.09,4620000,368,53945190,0,0,0,0,0,0,1385000,4119000,-2734000,-2734000
20200520,00665L,富邦恒生國企正2,20.80,21.20,20.80,21.01,+0.09,0.43,157000,32,3310720,0,28000,-28000,0,0,0,146000,0,146000,118000
20200520,00666R,富邦恒生國企反1,13.73,13.73,13.72,13.72,-0.01,-0.07,81000,3,1111330,0,0,0,0,0,0,81000,81000,0,0
20200520,00668,國泰美國道瓊,26.50,26.57,26.45,26.53,-0.25,-0.93,549493,178,14566032,0,0,0,0,0,0,95000,435000,-340000,-340000
20200520,00668K,國泰美國道瓊+U,8.85,8.85,8.85,8.85,0.00,0.00,100,1,885,0,0,0,0,0,0,100,100,0,0
20200520,00669R,國泰美國道瓊反1,12.32,12.32,12.27,12.29,+0.08,0.66,5006000,603,61573030,0,0,0,0,0,0,3665000,331000,3334000,3334000
20200520,00670L,富邦NASDAQ正2,45.00,45.35,44.95,45.29,+0.26,0.58,855175,255,38618846,45000,6000,39000,0,0,0,434000,284000,150000,189000
20200520,00671R,富邦NASDAQ反1,9.38,9.38,9.34,9.36,-0.01,-0.11,1483200,215,13875812,0,34000,-34000,0,0,0,202000,435000,-233000,-267000
20200520,00672L,元大S&P原油正2,2.50,2.65,2.50,2.59,-0.09,-3.36,26899194,2089,69359507,0,100000,-100000,0,0,0,200000,220000,-20000,-120000
20200520,00673R,元大S&P原油反1,38.31,38.33,37.84,37.88,-0.13,-0.34,732350,223,27885205,37000,0,37000,0,0,0,365000,272000,93000,130000
20200520,00674R,元大S&P黃金反1,13.96,13.96,13.90,13.94,-0.09,-0.64,494000,105,6878030,0,0,0,0,0,0,0,380000,-380000,-380000
20200520,00675L,富邦臺灣加權正2,17.28,17.36,17.12,17.21,+0.05,0.29,480146,202,8292080,102000,18000,84000,0,0,0,240000,40000,200000,284000
20200520,00676R,富邦臺灣加權反1,6.31,6.35,6.29,6.33,0.00,0.00,1941000,232,12251270,0,0,0,0,0,0,245000,1290000,-1045000,-1045000
20200520,00677U,富邦VIX,6.41,6.45,6.36,6.40,+0.16,2.56,147537915,10006,944102276,24623000,4522000,20101000,0,0,0,24990000,10571000,14419000,34520000
20200520,00678,群益NBI生技,25.52,25.77,25.50,25.51,-0.41,-1.58,586240,70,14993763,0,111000,-111000,0,0,0,513000,397000,116000,5000
20200520,00680L,元大美債20正2,32.07,32.14,32.05,32.11,+0.06,0.19,123000,44,3949340,0,0,0,0,0,0,58000,66000,-8000,-8000
20200520,00681R,元大美債20反1,12.76,12.76,12.72,12.72,-0.04,-0.31,4000,2,50920,0,0,0,0,0,0,3000,1000,2000,2000
20200520,00682U,元大美元指數,,,,,0.00,0.00,120,1,2349,0,0,0,0,0,0,0,0,0,0
20200520,00683L,元大美元指數正2,20.14,20.14,20.14,20.14,-0.03,-0.15,4000,2,80560,0,0,0,0,0,0,4000,0,4000,4000
20200520,00684R,元大美元指數反1,,,,,0.00,0.00,0,0,0,0,0,0,0,0,0,0,0,0,0
20200520,00685L,群益臺灣加權正2,14.69,14.82,14.64,14.64,-0.06,-0.41,16000,15,235250,0,0,0,0,0,0,14000,4000,10000,10000
20200520,00686R,群益臺灣加權反1,6.87,6.91,6.86,6.89,0.00,0.00,111000,46,763160,0,0,0,0,0,0,12000,96000,-84000,-84000
20200520,00688L,國泰20年美債正2,32.63,32.63,32.63,32.63,+0.11,0.34,100000,2,3263000,0,0,0,0,0,0,100000,100000,0,0
20200520,00689R,國泰20年美債反1,13.05,13.05,13.05,13.05,-0.02,-0.15,100000,2,1305000,0,0,0,0,0,0,100000,100000,0,0
20200520,00690,兆豐藍籌30,21.95,22.00,21.90,21.90,+0.05,0.23,182337,26,3997828,0,0,0,0,0,0,174000,157000,17000,17000
20200520,00691R,兆豐藍籌30反1,13.94,13.94,13.94,13.94,-0.06,-0.43,1000,1,13940,0,0,0,0,0,0,1000,1000,0,0
20200520,00692,富邦公司治理,21.85,21.88,21.72,21.82,+0.05,0.23,1806756,474,39429724,0,0,0,0,0,0,1299000,903000,396000,396000
20200520,00693U,街口S&P黃豆,13.71,13.76,13.70,13.73,+0.02,0.15,2058200,477,28258606,0,50000,-50000,0,0,0,197000,925000,-728000,-778000
20200520,00700,富邦恒生國企,18.55,18.55,18.48,18.55,0.00,0.00,102000,4,1892030,0,0,0,0,0,0,102000,100000,2000,2000
20200520,00701,國泰股利精選30,20.10,20.14,20.07,20.11,+0.05,0.25,1443389,542,29020995,0,0,0,0,0,0,502000,326000,176000,176000
20200520,00702,國泰標普低波高息,15.70,15.78,15.70,15.76,-0.13,-0.82,5000,5,78720,0,2000,-2000,0,0,0,0,0,0,-2000
20200520,00703,台新MSCI中國,20.86,21.02,20.86,20.92,+0.13,0.63,121000,36,2534360,0,0,0,0,0,0,58000,58000,0,0
20200520,00706L,元大S&P日圓正2,17.16,17.20,17.14,17.20,-0.12,-0.69,29000,9,497980,0,0,0,0,0,0,13000,13000,0,0
20200520,00707R,元大S&P日圓反1,19.63,19.63,19.63,19.63,+0.07,0.36,1000,1,19630,0,0,0,0,0,0,1000,1000,0,0
20200520,00708L,元大S&P黃金正2,28.45,28.70,28.45,28.59,+0.47,1.67,5869000,1295,167950990,0,0,0,0,0,0,2913000,1148000,1765000,1765000
20200520,00709,富邦歐洲,17.33,17.38,17.30,17.30,-0.12,-0.69,125549,13,2179287,0,0,0,0,0,0,121000,101000,20000,20000
20200520,00710B,FH彭博高收益債,18.17,18.17,18.11,18.12,+0.08,0.44,1355200,69,24587640,0,0,0,0,0,0,29000,23000,6000,6000
20200520,00711B,FH彭博新興債,21.10,21.16,21.10,21.16,+0.11,0.52,684000,11,14444920,0,0,0,0,0,0,100000,104000,-4000,-4000
20200520,00712,FH富時不動產,9.25,9.50,9.25,9.49,+0.17,1.82,3600896,966,33798380,810000,1000,809000,0,0,0,296000,417000,-121000,688000
20200520,00713,元大台灣高息低波,30.81,30.81,30.65,30.70,-0.01,-0.03,45018,34,1382412,1000,1000,0,0,0,0,4000,15000,-11000,-11000
20200520,00714,群益道瓊美國地產,17.04,17.05,17.01,17.05,-0.07,-0.41,7000,5,119250,0,0,0,0,0,0,0,4000,-4000,-4000
20200520,00715L,街口布蘭特油正2,5.49,5.65,5.49,5.58,-0.02,-0.36,17631400,1330,98161910,0,0,0,0,0,0,0,988000,-988000,-988000
20200520,00717,富邦美國特別股,16.23,16.29,16.23,16.29,+0.06,0.37,716537,154,11651854,107000,0,107000,0,0,0,475000,536526,-61526,45474
20200520,00728,第一金工業30,18.97,19.03,18.90,18.96,+0.07,0.37,339000,43,6426050,0,0,0,0,0,0,244000,226000,18000,18000
20200520,00730,富邦臺灣優質高息,16.70,16.70,16.61,16.63,-0.06,-0.36,429534,159,7151236,0,0,0,0,0,0,216000,298000,-82000,-82000
20200520,00731,FH富時高息低波,44.43,44.43,44.25,44.27,+0.01,0.02,420061,31,18631604,0,0,0,0,0,0,415000,412000,3000,3000
20200520,00732,國泰RMB短期報酬,38.00,38.00,38.00,38.00,-0.02,-0.05,100000,2,3800000,0,0,0,0,0,0,100000,100000,0,0
20200520,00733,富邦臺灣中小,20.37,20.55,20.35,20.47,0.00,0.00,241039,16,4947525,0,0,0,0,0,0,240000,201000,39000,39000
20200520,00735,國泰臺韓科技,19.47,19.52,19.42,19.46,+0.08,0.41,181000,15,3524380,28000,0,28000,0,0,0,150000,174000,-24000,4000
20200520,00736,國泰新興市場,17.20,17.43,17.20,17.38,+0.21,1.22,514000,49,8931730,0,334000,-334000,0,0,0,507000,165000,342000,8000
20200520,00737,國泰AI+Robo,21.67,21.89,21.60,21.87,+0.22,1.02,676646,252,14749425,242000,0,242000,0,0,0,210000,169000,41000,283000
20200520,00738U,元大道瓊白銀,19.51,19.86,19.51,19.80,+0.68,3.56,7626000,1186,150946990,15000,12000,3000,0,0,0,4293000,1082000,3211000,3214000
20200520,00739,元大MSCI A股,20.90,21.00,20.89,20.90,0.00,0.00,239000,28,4999190,0,0,0,0,0,0,232000,153000,79000,79000
20200520,00742,新光內需收益,20.28,20.30,20.27,20.30,+0.06,0.3,283000,10,5740700,0,0,0,0,0,0,282000,249000,33000,33000
20200520,00743,國泰中國A150,20.88,20.89,20.76,20.86,+0.07,0.34,58198,14,1213030,37000,0,37000,0,0,0,20000,45000,-25000,12000
20200520,00752,中信中國50,23.71,23.85,23.65,23.83,+0.27,1.15,2979664,699,70801694,1000,0,1000,0,0,0,2685000,1401000,1284000,1285000
20200520,00753L,中信中國50正2,24.55,24.80,24.45,24.53,+0.28,1.15,426000,166,10487180,90000,38000,52000,0,0,0,196000,190000,6000,58000
20200520,00757,統一FANG+,28.00,28.02,27.90,28.02,+0.17,0.61,260000,30,7282810,0,0,0,0,0,0,220000,200000,20000,20000
20200520,00762,元大全球AI,26.51,26.73,26.51,26.65,+0.31,1.18,791269,481,21095843,0,0,0,0,0,0,626000,0,626000,626000
20200520,00763U,街口道瓊銅,16.50,16.57,16.50,16.57,+0.07,0.42,98000,31,1620140,0,0,0,0,0,0,63000,4000,59000,59000
20200520,00766L,台新MSCI中國正2,9.15,9.24,9.11,9.15,+0.05,0.55,418000,62,3831510,0,0,0,0,0,0,287000,86000,201000,201000
20200520,00770,國泰北美科技,25.86,25.98,25.86,25.98,+0.16,0.62,41000,13,1062120,0,0,0,0,0,0,38000,31000,7000,7000
20200520,00771,元大US高息特別股,18.56,18.59,18.53,18.59,+0.09,0.49,71051,39,1319720,0,0,0,0,0,0,0,40010,-40010,-40010
20200520,00774B,新光中國政金綠債,39.46,39.46,39.39,39.40,-0.07,-0.18,746000,29,29409920,0,0,0,0,0,0,2000,2000,0,0
20200520,00774C,新光中政金綠債+R,,,,,0.00,0.00,0,0,0,0,0,0,0,0,0,0,0,0,0
20200520,00775B,新光投等債15+,44.68,44.80,44.68,44.80,+0.50,1.13,4000,3,178960,0,2000,-2000,0,0,0,4000,2000,2000,0
20200520,00776,新光ICE美國權值,,,,,0.00,0.00,0,0,0,0,0,0,0,0,0,0,0,0,0
20200520,00783,富邦中証500,18.35,18.45,18.31,18.33,0.00,0.00,1058200,48,19424257,0,0,0,0,0,0,1052000,821000,231000,231000
20200520,008201,BP上證50,,,,,0.00,0.00,0,0,0,0,0,0,0,0,0,0,0,0,0
20200520,00830,國泰費城半導體,16.88,17.00,16.88,16.99,+0.10,0.59,1568360,399,26592017,999000,1000,998000,0,0,0,250000,423000,-173000,825000
20200520,00850,元大臺灣ESG永續,21.11,21.15,21.00,21.07,+0.04,0.19,1235135,546,26056060,0,0,0,0,0,0,778000,147000,631000,631000
20200520,00851,台新全球AI,22.36,22.45,22.36,22.45,+0.22,0.99,329100,34,7384465,0,0,0,0,0,0,180000,200000,-20000,-20000
20200520,00852L,國泰美國道瓊正2,11.03,11.12,11.02,11.11,-0.15,-1.33,15464000,1786,171179140,0,5479000,-5479000,0,0,0,2120000,3949000,-1829000,-7308000
20200520,00861,元大全球未來通訊,19.89,19.93,19.86,19.90,+0.01,0.05,3062680,915,60951881,0,3000,-3000,0,0,0,2133000,22000,2111000,2108000
20200520,00865B,國泰US短期公債,39.55,39.55,39.54,39.54,-0.01,-0.03,114000,6,4508640,0,0,0,0,0,0,114000,100000,14000,14000
20200520,00866,新光Shiller CAPE,17.97,17.97,17.97,17.97,-0.02,-0.11,29000,3,521130,0,0,0,0,0,0,29000,26000,3000,3000
20200520,00875,國泰網路資安,22.84,22.96,22.82,22.95,+0.15,0.66,1698450,477,38888165,732000,0,732000,0,0,0,483000,550000,-67000,665000
20200520,01001T,土銀富邦R1,16.15,16.17,16.15,16.17,+0.02,0.12,6000,4,96950,0,0,0,0,0,0,0,0,0,0
20200520,01002T,土銀國泰R1,16.90,16.92,16.89,16.90,0.00,0.00,57100,22,964955,0,0,0,0,0,0,0,0,0,0
20200520,01003T,兆豐新光R1,18.71,18.80,18.71,18.75,+0.04,0.21,26702000,26,507282750,5929000,0,5929000,0,0,0,0,0,0,5929000
20200520,01004T,土銀富邦R2,14.23,14.23,14.23,14.23,0.00,0.00,6000,3,85380,0,0,0,0,0,0,0,0,0,0
20200520,01007T,兆豐國泰R2,17.51,17.51,17.34,17.51,0.00,0.00,23000,22,399430,0,0,0,0,0,0,0,0,0,0
20200520,01009T,王道圓滿R1,9.28,9.28,9.27,9.27,+0.06,0.65,10000,3,92760,0,0,0,0,0,0,0,0,0,0
20200520,01010T,京城樂富R1,9.92,9.92,9.90,9.91,-0.01,-0.1,174000,16,1725520,0,0,0,0,0,0,0,0,0,0
20200520,020000,富邦特選蘋果N,4.99,5.00,4.98,4.99,0.00,0.00,51000,11,254740,0,0,0,0,0,0,21000,30000,-9000,-9000
20200520,020002,元富新中國N,,,,,0.00,0.00,0,0,0,0,0,0,0,0,0,0,0,0,0
20200520,020004,兆豐電菁英30N,21.69,21.69,21.69,21.69,0.00,0.00,2000,1,43380,0,0,0,0,0,0,0,2000,-2000,-2000
20200520,020006,永昌中小300N,,,,,0.00,0.00,0,0,0,0,0,0,0,0,0,0,0,0,0
20200520,020007,凱基臺灣500N,,,,,0.00,0.00,0,0,0,0,0,0,0,0,0,0,0,0,0
20200520,020008,元大特股高息N,10.32,10.33,10.31,10.31,-0.01,-0.1,14000,7,144400,0,0,0,0,0,0,13000,1000,12000,12000
20200520,020011,統一微波高息20N,,,,,0.00,0.00,0,0,0,0,0,0,0,0,0,0,0,0,0
20200520,020012,富邦行動通訊N,4.97,5.00,4.96,4.97,+0.01,0.2,875000,60,4360880,0,0,0,0,0,0,835000,0,835000,835000
20200520,020015,統一MSCI美低波N,11.76,11.80,11.75,11.79,-0.07,-0.59,322000,68,3793170,0,0,0,0,0,0,2000,251000,-249000,-249000
20200520,020016,統一MSCI美科技N,12.37,12.41,12.36,12.41,+0.02,0.16,81000,29,1003160,0,0,0,0,0,0,24000,33000,-9000,-9000
20200520,02001L,富邦蘋果正二N,5.63,5.63,5.63,5.63,+0.02,0.36,1000,1,5630,0,0,0,0,0,0,1000,0,1000,1000
20200520,02001R,富邦蘋果反一N,4.67,4.71,4.65,4.71,+0.01,0.21,66000,14,309370,0,0,0,0,0,0,36000,30000,6000,6000
20200520,03005X,元展05,,,,,0.00,0.00,0,0,0,0,0,0,0,0,0,0,0,0,0
20200520,03006X,元展06,25.60,25.90,25.60,25.90,0.00,0.00,4000,2,103300,0,0,0,0,0,0,1000,3000,-2000,-2000
20200520,03007X,元展07,,,,,0.00,0.00,0,0,0,0,0,0,0,0,0,0,0,0,0
20200520,03009X,元展09,,,,,0.00,0.00,0,0,0,0,0,0,0,0,0,0,0,0,0
20200520,03010X,元展10,26.80,26.80,26.60,26.60,0.00,0.00,7000,2,187000,0,0,0,0,0,0,0,7000,-7000,-7000
20200520,03012X,元展12,10.10,10.20,10.10,10.10,0.00,0.00,3000,3,30400,0,0,0,0,0,0,0,3000,-3000,-3000
20200520,03013X,元展13,,,,,0.00,0.00,0,0,0,0,0,0,0,0,0,0,0,0,0
20200520,03014X,元展14,,,,,0.00,0.00,0,0,0,0,0,0,0,0,0,0,0,0,0
20200520,03015X,元展15,,,,,0.00,0.00,0,0,0,0,0,0,0,0,0,0,0,0,0
20200520,03016X,元展16,,,,,0.00,0.00,0,0,0,0,0,0,0,0,0,0,0,0,0
20200520,03017X,元展17,,,,,0.00,0.00,0,0,0,0,0,0,0,0,0,0,0,0,0
20200520,03019X,元展19,,,,,0.00,0.00,0,0,0,0,0,0,0,0,0,0,0,0,0
20200520,03020X,元展20,,,,,0.00,0.00,0,0,0,0,0,0,0,0,0,0,0,0,0
20200520,03022X,富展01,13.30,13.30,13.30,13.30,-0.10,-0.75,1000,1,13300,0,0,0,0,0,0,0,1000,-1000,-1000
20200520,03025X,元展22,,,,,0.00,0.00,0,0,0,0,0,0,0,0,0,0,0,0,0
20200520,03026X,元展23,,,,,0.00,0.00,0,0,0,0,0,0,0,0,0,0,0,0,0
20200520,03027X,元展24,,,,,0.00,0.00,0,0,0,0,0,0,0,0,0,0,0,0,0
20200520,03028X,元展25,,,,,0.00,0.00,0,0,0,0,0,0,0,0,0,0,0,0,0
20200520,03029X,元展26,,,,,0.00,0.00,0,0,0,0,0,0,0,0,0,0,0,0,0
20200520,03033P,台積電中信95售05,,,,,0.00,0.00,0,0,0,0,0,0,0,0,0,0,0,0,0
20200520,03033X,元展30,6.30,6.30,6.10,6.10,-0.45,-6.87,183000,10,1120550,0,0,0,0,0,0,140000,42000,98000,98000
20200520,03035X,元展32,,,,,0.00,0.00,0,0,0,0,0,0,0,0,0,0,0,0,0
20200520,03038X,元展35,8.40,8.40,8.40,8.40,0.00,0.00,1000,1,8400,0,0,0,0,0,0,1000,0,1000,1000
20200520,03039X,元展36,3.83,3.83,3.76,3.76,-0.15,-3.84,23000,4,87370,0,0,0,0,0,0,0,23000,-23000,-23000
20200520,03046X,元展43,,,,,0.00,0.00,0,0,0,0,0,0,0,0,0,0,0,0,0
20200520,03047X,元展44,,,,,0.00,0.00,0,0,0,0,0,0,0,0,0,0,0,0,0
20200520,03049X,元展46,4.78,4.78,4.66,4.66,-0.14,-2.92,4000,4,18860,0,0,0,0,0,0,0,4000,-4000,-4000
20200520,03050X,元展47,2.10,2.10,2.06,2.08,0.00,0.00,329000,27,682970,0,0,0,0,0,0,161000,149000,12000,12000
20200520,03052X,元展49,17.20,17.20,17.20,17.20,-0.20,-1.15,2000,1,34400,0,0,0,0,0,0,0,2000,-2000,-2000
20200520,03060X,元展55,,,,,0.00,0.00,0,0,0,0,0,0,0,0,0,0,0,0,0
20200520,03064X,元展59,,,,,0.00,0.00,0,0,0,0,0,0,0,0,0,0,0,0,0
20200520,03071X,元展66,42.90,42.90,42.90,42.90,+0.70,1.66,1000,1,42900,0,0,0,0,0,0,1000,0,1000,1000
20200520,03074X,元展69,,,,,0.00,0.00,0,0,0,0,0,0,0,0,0,0,0,0,0
20200520,03075X,元展70,,,,,0.00,0.00,0,0,0,0,0,0,0,0,0,0,0,0,0
20200520,03078X,元展73,,,,,0.00,0.00,0,0,0,0,0,0,0,0,0,0,0,0,0
20200520,03091X,元展85,,,,,0.00,0.00,0,0,0,0,0,0,0,0,0,0,0,0,0
20200520,03093X,永豐金元大61展01,,,,,0.00,0.00,0,0,0,0,0,0,0,0,0,0,0,0,0
20200520,03094X,大立光元大68展08,15.20,15.20,15.20,15.20,-1.30,-7.88,7000,1,106400,0,0,0,0,0,0,7000,0,7000,7000
20200520,03111P,元油2X富邦97售01,,,,,0.00,0.00,0,0,0,0,0,0,0,0,0,0,0,0,0
20200520,03162P,華邦電中信96售02,,,,,0.00,0.00,0,0,0,0,0,0,0,0,0,0,0,0,0
20200520,03181P,道瓊指中信96售01,0.01,0.01,0.01,0.01,0.00,0.00,15000,2,150,0,0,0,0,0,0,0,0,0,0
20200520,03253P,玉晶光群益96售01,,,,,0.00,0.00,0,0,0,0,0,0,0,0,0,0,0,0,0
20200520,03314P,滬深2X群益96售02,,,,,0.00,0.00,0,0,0,0,0,0,0,0,0,0,0,0,0
20200520,03365P,元油2X富邦98售01,,,,,0.00,0.00,0,0,0,0,0,0,0,0,0,0,0,0,0
20200520,03388P,元油2X元富98售02,,,,,0.00,0.00,0,0,0,0,0,0,0,0,0,0,0,0,0
20200520,03412P,滬深2X群益98售01,,,,,0.00,0.00,0,0,0,0,0,0,0,0,0,0,0,0,0
20200520,03414B,臺股指凱基99熊01,2.33,2.37,2.30,2.35,-0.01,-0.42,734000,42,1715930,20000,0,20000,0,0,0,139000,595000,-456000,-436000
20200520,03418B,臺股指元大95熊20,2.13,2.13,2.13,2.13,-0.05,-2.29,1000,1,2130,0,0,0,0,0,0,1000,0,1000,1000
20200520,03419B,臺股指元富99熊03,3.54,3.54,3.54,3.54,0.00,0.00,1000,1,3540,0,0,0,0,0,0,0,1000,-1000,-1000
20200520,03421B,臺股指元大99熊01,3.27,3.30,3.25,3.29,0.00,0.00,404000,9,1317100,0,0,0,0,0,0,202000,202000,0,0
20200520,03422B,臺股指凱基96熊28,2.68,2.68,2.68,2.68,0.00,0.00,1000,1,2680,0,0,0,0,0,0,1000,0,1000,1000
20200520,03424B,臺股指元大96熊26,,,,,0.00,0.00,0,0,0,0,0,0,0,0,0,0,0,0,0
20200520,03425B,臺股指元大9A熊01,3.50,3.50,3.50,3.50,+0.01,0.29,4000,1,14000,0,0,0,0,0,0,0,4000,-4000,-4000
20200520,03427B,臺股指元大9A熊02,,,,,0.00,0.00,0,0,0,0,0,0,0,0,0,0,0,0,0
20200520,03428B,臺股指凱基97熊18,,,,,0.00,0.00,0,0,0,0,0,0,0,0,0,0,0,0,0
20200520,03429B,臺股指元富97熊07,,,,,0.00,0.00,0,0,0,0,0,0,0,0,0,0,0,0,0
20200520,03430B,臺股指元大9B熊01,,,,,0.00,0.00,0,0,0,0,0,0,0,0,0,0,0,0,0
20200520,03431B,元油2X凱基9B熊03,,,,,0.00,0.00,0,0,0,0,0,0,0,0,0,0,0,0,0
20200520,03432B,臺股指凱基98熊13,2.75,2.78,2.75,2.78,-0.03,-1.07,6000,2,16530,0,0,0,0,0,0,0,6000,-6000,-6000
20200520,03433B,臺股指元大9C熊01,2.81,2.90,2.81,2.87,+0.02,0.7,12000,4,33870,0,0,0,0,0,0,0,2000,-2000,-2000
20200520,03434B,臺股指元大99熊10,1.82,1.82,1.82,1.82,0.00,0.00,4000,2,7280,0,0,0,0,0,0,0,4000,-4000,-4000
20200520,03437B,臺股指元富9C熊01,,,,,0.00,0.00,0,0,0,0,0,0,0,0,0,0,0,0,0
20200520,03438P,群創群益98售03,,,,,0.00,0.00,0,0,0,0,0,0,0,0,0,0,0,0,0
20200520,03442B,臺股指元大9A熊48,1.91,1.94,1.88,1.92,-0.02,-1.03,152000,15,289530,0,0,0,0,0,0,51000,101000,-50000,-50000
20200520,03443B,臺股指凱基9A熊27,1.56,1.62,1.54,1.59,-0.01,-0.62,2033000,96,3209420,0,0,0,0,0,0,899000,1098000,-199000,-199000
20200520,03444B,臺股指元大9C熊02,,,,,0.00,0.00,0,0,0,0,0,0,0,0,0,0,0,0,0
20200520,03445B,臺股指元大02熊01,2.80,2.85,2.78,2.82,-0.04,-1.4,144000,14,408240,0,0,0,0,0,0,5000,139000,-134000,-134000
20200520,03446B,臺股指元大9B熊26,2.12,2.14,2.12,2.13,-0.05,-2.29,71000,7,151070,0,0,0,0,0,0,0,71000,-71000,-71000
20200520,03447B,臺股指凱基9B熊16,,,,,0.00,0.00,0,0,0,0,0,0,0,0,0,0,0,0,0
20200520,03450P,元油2X元富98售05,,,,,0.00,0.00,0,0,0,0,0,0,0,0,0,0,0,0,0
20200520,035274,華新台新97購01,,,,,0.00,0.00,0,0,0,0,0,0,0,0,0,0,0,0,0
20200520,035275,台積電台新97購01,16.60,17.60,16.60,17.60,+0.20,1.15,4000,3,69000,0,0,0,0,0,0,1000,3000,-2000,-2000
20200520,035276,南亞科台新97購01,1.88,1.97,1.88,1.97,0.00,0.00,15000,2,28650,0,0,0,0,0,0,5000,10000,-5000,-5000
20200520,035277,景碩台新97購01,,,,,0.00,0.00,0,0,0,0,0,0,0,0,0,0,0,0,0
20200520,03566P,群創群益96售01,0.69,0.69,0.69,0.69,0.00,0.00,4000,1,2760,0,0,0,0,0,0,0,4000,-4000,-4000
20200520,03603P,群創凱基98售04,1.53,1.54,1.53,1.54,0.00,0.00,34000,2,52210,0,0,0,0,0,0,15000,19000,-4000,-4000
20200520,03604P,群創凱基98售05,1.06,1.06,1.06,1.06,0.00,0.00,28000,1,29680,0,0,0,0,0,0,0,28000,-28000,-28000
20200520,03607P,滬深2X富邦95售01,,,,,0.00,0.00,0,0,0,0,0,0,0,0,0,0,0,0,0
20200520,036084,台灣50台新98購01,,,,,0.00,0.00,0,0,0,0,0,0,0,0,0,0,0,0,0
20200520,03619C,臺股指元大95牛02,,,,,0.00,0.00,0,0,0,0,0,0,0,0,0,0,0,0,0
20200520,03647C,T50反1元富99牛02,2.10,2.10,2.10,2.10,-0.05,-2.33,114000,1,239400,0,0,0,0,0,0,0,114000,-114000,-114000
20200520,03647P,京元電元富95售02,,,,,0.00,0.00,0,0,0,0,0,0,0,0,0,0,0,0,0
20200520,03648C,T50反1元大96牛07,1.59,1.64,1.59,1.63,-0.03,-1.81,143000,6,228140,0,0,0,0,0,0,121000,0,121000,121000
20200520,03649C,T50反1凱基99牛05,,,,,0.00,0.00,0,0,0,0,0,0,0,0,0,0,0,0,0
20200520,03650C,T50反1元大98牛05,1.74,1.74,1.74,1.74,-0.01,-0.57,105000,2,182700,0,0,0,0,0,0,5000,100000,-95000,-95000
20200520,03657C,T50反1元大99牛01,1.63,1.66,1.63,1.66,0.00,0.00,313000,12,515760,0,0,0,0,0,0,215000,98000,117000,117000
20200520,03658C,T50反1元大9A牛02,1.89,1.89,1.89,1.89,0.00,0.00,5000,1,9450,0,0,0,0,0,0,0,5000,-5000,-5000
20200520,036628,統一台新99購01,,,,,0.00,0.00,0,0,0,0,0,0,0,0,0,0,0,0,0
20200520,036629,智邦台新99購01,,,,,0.00,0.00,0,0,0,0,0,0,0,0,0,0,0,0,0
20200520,03662C,FBVIX凱基03牛01,4.02,4.05,4.01,4.02,+0.15,3.88,157000,10,630360,0,0,0,0,0,0,100000,57000,43000,43000
20200520,036630,玉山金台新99購01,,,,,0.00,0.00,0,0,0,0,0,0,0,0,0,0,0,0,0
20200520,03669C,滬深2X元富09牛01,3.51,3.51,3.48,3.51,0.00,0.00,53000,3,185970,0,0,0,0,0,0,1000,52000,-51000,-51000
20200520,03670C,元油2X元富99牛01,0.94,0.94,0.93,0.93,-0.02,-2.11,61000,4,57330,0,0,0,0,0,0,60000,0,60000,60000
20200520,03671P,大立光凱基95售02,,,,,0.00,0.00,0,0,0,0,0,0,0,0,0,0,0,0,0
20200520,03674C,臺股指元富9C牛02,2.70,2.70,2.70,2.70,0.00,0.00,1000,1,2700,0,0,0,0,0,0,1000,0,1000,1000
20200520,03675C,臺股指元大04牛02,,,,,0.00,0.00,0,0,0,0,0,0,0,0,0,0,0,0,0
20200520,03676C,臺股指元大04牛03,,,,,0.00,0.00,0,0,0,0,0,0,0,0,0,0,0,0,0
20200520,03677C,臺股指元大05牛02,4.44,4.44,4.44,4.44,+0.03,0.68,2000,2,8880,0,0,0,0,0,0,2000,0,2000,2000
20200520,03678C,臺股指凱基01牛02,2.22,2.24,2.17,2.20,+0.01,0.46,257000,17,568440,0,0,0,0,0,0,247000,10000,237000,237000
20200520,03679C,臺股指元大04牛04,2.54,2.57,2.52,2.52,+0.01,0.4,43000,5,109090,0,0,0,0,0,0,42000,1000,41000,41000
20200520,03680C,臺股指凱基9A牛26,1.56,1.60,1.52,1.56,+0.01,0.65,1104000,60,1739070,0,0,0,0,0,0,733000,369000,364000,364000
20200520,03681C,台灣50凱基02牛02,2.36,2.36,2.36,2.36,0.00,0.00,1000,1,2360,0,0,0,0,0,0,0,1000,-1000,-1000
20200520,03682C,臺股指凱基9C牛07,1.30,1.30,1.30,1.30,0.00,0.00,1000,1,1300,0,0,0,0,0,0,0,1000,-1000,-1000
20200520,03686P,大立光統一98售02,0.47,0.48,0.47,0.48,-0.03,-5.88,9000,2,4300,0,0,0,0,0,0,0,9000,-9000,-9000
20200520,03720P,元油2X富邦95售01,,,,,0.00,0.00,0,0,0,0,0,0,0,0,0,0,0,0,0
20200520,03763P,聯發科元富96售01,,,,,0.00,0.00,0,0,0,0,0,0,0,0,0,0,0,0,0
20200520,03765P,大立光元富96售01,,,,,0.00,0.00,0,0,0,0,0,0,0,0,0,0,0,0,0
20200520,03810P,大立光富邦98售01,,,,,0.00,0.00,0,0,0,0,0,0,0,0,0,0,0,0,0
20200520,03840P,台積電統一99售02,0.30,0.31,0.29,0.31,0.00,0.00,110000,18,32960,0,0,0,0,0,0,0,43000,-43000,-43000
20200520,038489,T50反1台新9A購01,0.30,0.31,0.28,0.30,-0.01,-3.23,1551000,114,455690,0,0,0,0,0,0,0,640000,-640000,-640000
20200520,03857P,聯發科元富99售02,0.12,0.20,0.11,0.20,+0.08,66.67,583000,48,82050,0,0,0,0,0,0,0,220000,-220000,-220000
20200520,03860P,群創元富97售01,,,,,0.00,0.00,0,0,0,0,0,0,0,0,0,0,0,0,0
20200520,03861P,群創元富99售01,,,,,0.00,0.00,0,0,0,0,0,0,0,0,0,0,0,0,0
20200520,03875P,滬深2X國票05售01,,,,,0.00,0.00,0,0,0,0,0,0,0,0,0,0,0,0,0
20200520,03885P,華新科統一96售01,,,,,0.00,0.00,0,0,0,0,0,0,0,0,0,0,0,0,0
20200520,039212,台達電台新9A購01,0.54,0.55,0.50,0.50,-0.08,-13.79,27000,6,14550,0,0,0,0,0,0,25000,2000,23000,23000
20200520,03959P,義隆元富96售01,,,,,0.00,0.00,0,0,0,0,0,0,0,0,0,0,0,0,0
20200520,03960P,新日興元富96售02,,,,,0.00,0.00,0,0,0,0,0,0,0,0,0,0,0,0,0
20200520,04006P,滬深2X國票9B售01,1.31,1.31,1.31,1.31,0.00,0.00,10000,1,13100,0,0,0,0,0,0,0,10000,-10000,-10000
20200520,04022P,群創元富96售04,,,,,0.00,0.00,0,0,0,0,0,0,0,0,0,0,0,0,0
20200520,04023P,臺股指元富99售02,,,,,0.00,0.00,0,0,0,0,0,0,0,0,0,0,0,0,0
20200520,04054P,滬深2X富邦96售02,,,,,0.00,0.00,0,0,0,0,0,0,0,0,0,0,0,0,0
20200520,04137P,元油反國票97售01,,,,,0.00,0.00,0,0,0,0,0,0,0,0,0,0,0,0,0
20200520,04142P,元油反凱基99售01,0.75,0.77,0.75,0.76,+0.01,1.33,33000,6,24880,0,0,0,0,0,0,0,0,0,0
20200520,041527,T50反1中信96購01,0.49,0.49,0.49,0.49,0.00,0.00,60000,2,29400,0,0,0,0,0,0,60000,0,60000,60000
20200520,041534,T50反1凱基96購01,,,,,0.00,0.00,0,0,0,0,0,0,0,0,0,0,0,0,0
20200520,04159P,滬深2X中信95售08,,,,,0.00,0.00,0,0,0,0,0,0,0,0,0,0,0,0,0
20200520,04165P,南亞科元富95售03,,,,,0.00,0.00,0,0,0,0,0,0,0,0,0,0,0,0,0
20200520,04167P,滬深反凱基99售01,,,,,0.00,0.00,0,0,0,0,0,0,0,0,0,0,0,0,0
20200520,04168P,元金2X凱基99售01,,,,,0.00,0.00,0,0,0,0,0,0,0,0,0,0,0,0,0
20200520,041824,元油2X國票96購01,,,,,0.00,0.00,0,0,0,0,0,0,0,0,0,0,0,0,0
20200520,041870,A50正2凱基96購01,,,,,0.00,0.00,0,0,0,0,0,0,0,0,0,0,0,0,0
20200520,041900,元油2X富邦96購01,0.01,0.01,0.01,0.01,0.00,0.00,11000,11,110,0,0,0,0,0,0,0,0,0,0
20200520,04198P,滬深2X群益95售04,,,,,0.00,0.00,0,0,0,0,0,0,0,0,0,0,0,0,0
20200520,041990,A50正2國票97購01,0.05,0.05,0.04,0.04,0.00,0.00,120000,2,5800,0,0,0,0,0,0,0,120000,-120000,-120000
20200520,041991,元油2X國票98購01,,,,,0.00,0.00,0,0,0,0,0,0,0,0,0,0,0,0,0
20200520,042116,元油2X國票97購01,,,,,0.00,0.00,0,0,0,0,0,0,0,0,0,0,0,0,0
20200520,042168,台灣50凱基96購01,0.75,0.75,0.75,0.75,+0.03,4.17,10000,1,7500,0,0,0,0,0,0,0,10000,-10000,-10000
20200520,042280,元石油富邦96購01,,,,,0.00,0.00,0,0,0,0,0,0,0,0,0,0,0,0,0
20200520,042281,元油2X富邦96購02,,,,,0.00,0.00,0,0,0,0,0,0,0,0,0,0,0,0,0
20200520,04229P,臺股指中信95售05,,,,,0.00,0.00,0,0,0,0,0,0,0,0,0,0,0,0,0
20200520,04230P,臺股指中信95售06,,,,,0.00,0.00,0,0,0,0,0,0,0,0,0,0,0,0,0
20200520,042315,T50反1台新96購01,,,,,0.00,0.00,0,0,0,0,0,0,0,0,0,0,0,0,0
20200520,042317,台灣50永豐96購01,,,,,0.00,0.00,0,0,0,0,0,0,0,0,0,0,0,0,0
20200520,04241P,欣興國泰95售02,,,,,0.00,0.00,0,0,0,0,0,0,0,0,0,0,0,0,0
20200520,042433,元油2X永豐96購01,,,,,0.00,0.00,0,0,0,0,0,0,0,0,0,0,0,0,0
20200520,042501,台灣50凱基96購06,,,,,0.00,0.00,0,0,0,0,0,0,0,0,0,0,0,0,0
20200520,04250P,嘉晶統一95售02,0.01,0.01,0.01,0.01,0.00,0.00,185000,2,1850,0,0,0,0,0,0,185000,0,185000,185000
20200520,042556,台灣50中信96購04,,,,,0.00,0.00,0,0,0,0,0,0,0,0,0,0,0,0,0
20200520,042692,台灣50凱基96購09,,,,,0.00,0.00,0,0,0,0,0,0,0,0,0,0,0,0,0
20200520,042712,元石油國票95購01,,,,,0.00,0.00,0,0,0,0,0,0,0,0,0,0,0,0,0
20200520,04273P,上証反凱基99售01,,,,,0.00,0.00,0,0,0,0,0,0,0,0,0,0,0,0,0
20200520,042752,台灣50元大96購03,,,,,0.00,0.00,0,0,0,0,0,0,0,0,0,0,0,0,0
20200520,042792,T50反1台新9C購01,,,,,0.00,0.00,0,0,0,0,0,0,0,0,0,0,0,0,0
20200520,042793,台積電台新9C購01,11.10,12.00,11.00,12.00,0.00,0.00,14000,12,158600,0,0,0,0,0,0,0,0,0,0
20200520,04286P,滬深2X中信96售01,,,,,0.00,0.00,0,0,0,0,0,0,0,0,0,0,0,0,0
20200520,04287P,A50正2中信96售01,,,,,0.00,0.00,0,0,0,0,0,0,0,0,0,0,0,0,0
20200520,04288P,台積電中信95售06,,,,,0.00,0.00,0,0,0,0,0,0,0,0,0,0,0,0,0
20200520,04289P,臺股指中信95售07,,,,,0.00,0.00,0,0,0,0,0,0,0,0,0,0,0,0,0
20200520,04290P,滬深2X富邦96售03,,,,,0.00,0.00,0,0,0,0,0,0,0,0,0,0,0,0,0
20200520,04293P,滬深2X元大96售02,,,,,0.00,0.00,0,0,0,0,0,0,0,0,0,0,0,0,0
20200520,04294P,台積電元大95售01,,,,,0.00,0.00,0,0,0,0,0,0,0,0,0,0,0,0,0
20200520,042953,鴻海台新01購01,,,,,0.00,0.00,0,0,0,0,0,0,0,0,0,0,0,0,0
20200520,04311P,奇力新統一95售01,,,,,0.00,0.00,0,0,0,0,0,0,0,0,0,0,0,0,0
20200520,04313P,國巨元富95售03,,,,,0.00,0.00,0,0,0,0,0,0,0,0,0,0,0,0,0
20200520,04327P,台積電國泰95售01,,,,,0.00,0.00,0,0,0,0,0,0,0,0,0,0,0,0,0
20200520,043442,大立光台新01購01,1.49,1.60,1.49,1.53,+0.02,1.32,70000,12,109160,0,0,0,0,0,0,13000,51000,-38000,-38000
20200520,043513,台灣50元大96購05,,,,,0.00,0.00,0,0,0,0,0,0,0,0,0,0,0,0,0
20200520,043538,元石油國票97購01,0.02,0.02,0.01,0.02,0.00,0.00,26000,3,510,0,0,0,0,0,0,1000,0,1000,1000
20200520,043642,元金2X國票97購01,,,,,0.00,0.00,0,0,0,0,0,0,0,0,0,0,0,0,0
20200520,04373P,滬深2X元大97售01,,,,,0.00,0.00,0,0,0,0,0,0,0,0,0,0,0,0,0
20200520,04384P,上証2X中信96售01,,,,,0.00,0.00,0,0,0,0,0,0,0,0,0,0,0,0,0
20200520,04411P,智易統一96售01,,,,,0.00,0.00,0,0,0,0,0,0,0,0,0,0,0,0,0
20200520,044247,道瓊反元富97購01,0.50,0.50,0.31,0.40,+0.01,2.56,31000,6,9890,0,0,0,0,0,0,0,0,0,0
20200520,044265,滬深2X中信95購05,,,,,0.00,0.00,0,0,0,0,0,0,0,0,0,0,0,0,0
20200520,044269,群創中信95購01,,,,,0.00,0.00,0,0,0,0,0,0,0,0,0,0,0,0,0
20200520,044270,群創中信95購02,,,,,0.00,0.00,0,0,0,0,0,0,0,0,0,0,0,0,0
20200520,04427P,滬深2X元大97售02,,,,,0.00,0.00,0,0,0,0,0,0,0,0,0,0,0,0,0
20200520,044346,力山富邦95購01,,,,,0.00,0.00,0,0,0,0,0,0,0,0,0,0,0,0,0
20200520,04434P,玉晶光國票96售02,,,,,0.00,0.00,0,0,0,0,0,0,0,0,0,0,0,0,0
20200520,04436P,聯發科中信96售02,,,,,0.00,0.00,0,0,0,0,0,0,0,0,0,0,0,0,0
20200520,04437P,滬深2X群益98售03,0.59,0.59,0.59,0.59,0.00,0.00,5000,1,2950,0,0,0,0,0,0,0,5000,-5000,-5000
20200520,044457,滬深2X國票97購01,0.01,0.01,0.01,0.01,-0.01,-50.0,299000,1,2990,0,0,0,0,0,0,299000,0,299000,299000
20200520,044464,滬深2X群益95購01,,,,,0.00,0.00,0,0,0,0,0,0,0,0,0,0,0,0,0
20200520,044465,元油2X群益97購01,,,,,0.00,0.00,0,0,0,0,0,0,0,0,0,0,0,0,0
20200520,044475,國巨元富95購02,3.68,3.68,3.68,3.68,+0.26,7.6,1000,1,3680,0,0,0,0,0,0,1000,0,1000,1000
20200520,04454P,大立光富邦98售02,,,,,0.00,0.00,0,0,0,0,0,0,0,0,0,0,0,0,0
20200520,04458P,世紀鋼統一96售01,,,,,0.00,0.00,0,0,0,0,0,0,0,0,0,0,0,0,0
20200520,04460P,元油2X元富96售04,,,,,0.00,0.00,0,0,0,0,0,0,0,0,0,0,0,0,0
20200520,04462P,全新元富96售01,0.83,1.01,0.82,1.01,+0.20,24.69,318000,14,288280,0,0,0,0,0,0,235000,83000,152000,152000
20200520,044643,滬深2X群益96購01,,,,,0.00,0.00,0,0,0,0,0,0,0,0,0,0,0,0,0
20200520,044784,華邦電中信96購01,,,,,0.00,0.00,0,0,0,0,0,0,0,0,0,0,0,0,0
20200520,04479P,同欣電中信96售02,,,,,0.00,0.00,0,0,0,0,0,0,0,0,0,0,0,0,0
20200520,04483P,元油2X凱基97售04,,,,,0.00,0.00,0,0,0,0,0,0,0,0,0,0,0,0,0
20200520,044864,道瓊反國票96購01,0.12,0.35,0.12,0.35,+0.05,16.67,36000,8,7750,0,0,0,0,0,0,0,0,0,0
20200520,044963,台積電中信96購01,0.48,0.48,0.45,0.48,-0.02,-4.0,91000,4,43170,0,0,0,0,0,0,90000,53000,37000,37000
20200520,04496P,國巨國泰96售02,,,,,0.00,0.00,0,0,0,0,0,0,0,0,0,0,0,0,0
20200520,044972,元金2X國票96購01,,,,,0.00,0.00,0,0,0,0,0,0,0,0,0,0,0,0,0
20200520,04497P,元油2X富邦97售03,,,,,0.00,0.00,0,0,0,0,0,0,0,0,0,0,0,0,0
20200520,04501P,元油2X元富98售07,,,,,0.00,0.00,0,0,0,0,0,0,0,0,0,0,0,0,0
20200520,04502P,元油2X元富98售08,,,,,0.00,0.00,0,0,0,0,0,0,0,0,0,0,0,0,0
20200520,04503P,元油2X元富98售09,,,,,0.00,0.00,0,0,0,0,0,0,0,0,0,0,0,0,0
20200520,045053,聯發科元富98購01,1.87,2.08,1.87,1.97,+0.17,9.44,344000,20,694060,0,0,0,0,0,0,323000,0,323000,323000
20200520,045054,聯發科元富98購02,2.95,3.30,2.91,3.19,+0.20,6.69,134000,8,420630,0,0,0,0,0,0,134000,0,134000,134000
20200520,045055,聯發科元富98購03,4.60,5.05,4.60,4.74,+0.23,5.1,42000,9,202460,0,0,0,0,0,0,34000,1000,33000,33000
20200520,04505P,佳世達元富96售03,,,,,0.00,0.00,0,0,0,0,0,0,0,0,0,0,0,0,0
20200520,04514P,元石油中信97售01,,,,,0.00,0.00,0,0,0,0,0,0,0,0,0,0,0,0,0
20200520,04515P,元油2X群益97售02,,,,,0.00,0.00,0,0,0,0,0,0,0,0,0,0,0,0,0
20200520,045189,大立光元富98購01,0.25,0.32,0.25,0.28,-0.03,-9.68,132000,15,35640,0,0,0,0,0,0,0,90000,-90000,-90000
20200520,045443,群創元富98購01,,,,,0.00,0.00,0,0,0,0,0,0,0,0,0,0,0,0,0
20200520,045444,群創元富98購02,0.48,0.48,0.48,0.48,0.00,0.00,2000,1,960,0,0,0,0,0,0,0,0,0,0
20200520,04544P,欣興富邦96售02,,,,,0.00,0.00,0,0,0,0,0,0,0,0,0,0,0,0,0
20200520,045517,元油2X元富98購01,,,,,0.00,0.00,0,0,0,0,0,0,0,0,0,0,0,0,0
20200520,045572,元油2X元大98購01,,,,,0.00,0.00,0,0,0,0,0,0,0,0,0,0,0,0,0
20200520,045618,元油2X永豐98購01,,,,,0.00,0.00,0,0,0,0,0,0,0,0,0,0,0,0,0
20200520,045664,元油2X元富96購01,,,,,0.00,0.00,0,0,0,0,0,0,0,0,0,0,0,0,0
20200520,04578P,微星富邦96售01,,,,,0.00,0.00,0,0,0,0,0,0,0,0,0,0,0,0,0
20200520,045836,群創群益98購01,,,,,0.00,0.00,0,0,0,0,0,0,0,0,0,0,0,0,0
20200520,045837,群創群益98購02,,,,,0.00,0.00,0,0,0,0,0,0,0,0,0,0,0,0,0
20200520,045842,T50反1台新98購01,0.25,0.25,0.25,0.25,0.00,0.00,40000,1,10000,0,0,0,0,0,0,0,0,0,0
20200520,045870,元油2X元富96購02,,,,,0.00,0.00,0,0,0,0,0,0,0,0,0,0,0,0,0
20200520,045871,元油2X元富96購03,,,,,0.00,0.00,0,0,0,0,0,0,0,0,0,0,0,0,0
20200520,045872,元油2X元富98購03,0.08,0.08,0.07,0.08,-0.01,-11.11,2107000,50,157840,0,0,0,0,0,0,0,0,0,0
20200520,045873,元油2X元富98購04,0.05,0.05,0.05,0.05,0.00,0.00,40000,2,2000,0,0,0,0,0,0,0,0,0,0
20200520,04590P,元石油元大97售01,,,,,0.00,0.00,0,0,0,0,0,0,0,0,0,0,0,0,0
20200520,046061,中石化凱基98購01,0.56,0.56,0.56,0.56,+0.01,1.82,178000,21,99680,0,0,0,0,0,0,168000,0,168000,168000
20200520,04606P,高股息中信96售01,,,,,0.00,0.00,0,0,0,0,0,0,0,0,0,0,0,0,0
20200520,04611P,元油2X群益98售02,,,,,0.00,0.00,0,0,0,0,0,0,0,0,0,0,0,0,0
20200520,046147,道瓊指中信96購02,0.01,0.02,0.01,0.02,0.00,0.00,70000,2,710,0,0,0,0,0,0,0,0,0,0
20200520,046159,群創群益98購04,,,,,0.00,0.00,0,0,0,0,0,0,0,0,0,0,0,0,0
20200520,046191,新光金凱基98購01,,,,,0.00,0.00,0,0,0,0,0,0,0,0,0,0,0,0,0
20200520,04633P,旺宏群益96售04,0.59,0.61,0.59,0.61,-0.05,-7.58,91000,2,53990,0,0,0,0,0,0,91000,0,91000,91000
20200520,046340,滬深2X國票96購01,,,,,0.00,0.00,0,0,0,0,0,0,0,0,0,0,0,0,0
20200520,046375,友達凱基98購01,,,,,0.00,0.00,0,0,0,0,0,0,0,0,0,0,0,0,0
20200520,046383,群創凱基98購01,,,,,0.00,0.00,0,0,0,0,0,0,0,0,0,0,0,0,0
20200520,046384,群創凱基98購02,0.78,0.80,0.75,0.75,-0.03,-3.85,173000,5,136110,0,0,0,0,0,0,68000,121000,-53000,-53000
20200520,046385,群創凱基98購03,,,,,0.00,0.00,0,0,0,0,0,0,0,0,0,0,0,0,0
20200520,046438,群創群益95購01,,,,,0.00,0.00,0,0,0,0,0,0,0,0,0,0,0,0,0
20200520,046465,GIS凱基95購01,,,,,0.00,0.00,0,0,0,0,0,0,0,0,0,0,0,0,0
20200520,046476,鴻海統一96購01,0.14,0.14,0.14,0.14,-0.03,-17.65,12000,3,1680,0,0,0,0,0,0,7000,0,7000,7000
20200520,046480,群創元富96購01,0.01,0.01,0.01,0.01,0.00,0.00,70000,1,700,0,0,0,0,0,0,70000,0,70000,70000
20200520,046491,滬深2X富邦95購02,,,,,0.00,0.00,0,0,0,0,0,0,0,0,0,0,0,0,0
20200520,046562,大立光凱基95購01,,,,,0.00,0.00,0,0,0,0,0,0,0,0,0,0,0,0,0
20200520,046568,臻鼎元富95購01,,,,,0.00,0.00,0,0,0,0,0,0,0,0,0,0,0,0,0
20200520,046627,高鐵統一95購01,,,,,0.00,0.00,0,0,0,0,0,0,0,0,0,0,0,0,0
20200520,046628,大立光統一98購01,1.00,1.08,1.00,1.04,+0.04,4.0,160000,12,167070,0,0,0,0,0,0,56000,104000,-48000,-48000
20200520,046629,群創統一98購01,0.60,0.61,0.59,0.59,+0.01,1.72,139000,4,83590,0,0,0,0,0,0,129000,10000,119000,119000
20200520,046630,京元電元富95購03,,,,,0.00,0.00,0,0,0,0,0,0,0,0,0,0,0,0,0
20200520,046680,上証反群益95購01,,,,,0.00,0.00,0,0,0,0,0,0,0,0,0,0,0,0,0
20200520,046703,瑞昱元富95購01,,,,,0.00,0.00,0,0,0,0,0,0,0,0,0,0,0,0,0
20200520,046719,元石油元大95購02,,,,,0.00,0.00,0,0,0,0,0,0,0,0,0,0,0,0,0
20200520,046720,元油2X元大95購08,,,,,0.00,0.00,0,0,0,0,0,0,0,0,0,0,0,0,0
20200520,046791,台郡統一96購01,,,,,0.00,0.00,0,0,0,0,0,0,0,0,0,0,0,0,0
20200520,046792,京元電元富96購01,,,,,0.00,0.00,0,0,0,0,0,0,0,0,0,0,0,0,0
20200520,046793,聯發科元富99購01,2.00,2.31,1.98,2.11,+0.25,13.44,251000,13,567020,0,0,0,0,0,0,239000,11000,228000,228000
20200520,046797,T50反1元大96購01,,,,,0.00,0.00,0,0,0,0,0,0,0,0,0,0,0,0,0
20200520,046798,元油2X元大96購01,,,,,0.00,0.00,0,0,0,0,0,0,0,0,0,0,0,0,0
20200520,046813,聯電凱基96購01,,,,,0.00,0.00,0,0,0,0,0,0,0,0,0,0,0,0,0
20200520,04682P,臺股指統一96售01,,,,,0.00,0.00,0,0,0,0,0,0,0,0,0,0,0,0,0
20200520,046864,和大統一97購01,0.03,0.03,0.03,0.03,0.00,0.00,10000,1,300,0,0,0,0,0,0,0,0,0,0
20200520,046881,智原富邦99購01,0.24,0.27,0.24,0.27,+0.02,8.0,30000,19,7540,0,0,0,0,0,0,20000,10000,10000,10000
20200520,046882,智易富邦97購01,,,,,0.00,0.00,0,0,0,0,0,0,0,0,0,0,0,0,0
20200520,046903,友達凱基99購01,,,,,0.00,0.00,0,0,0,0,0,0,0,0,0,0,0,0,0
20200520,046905,新光金凱基99購01,,,,,0.00,0.00,0,0,0,0,0,0,0,0,0,0,0,0,0
20200520,046906,新光金凱基99購02,0.69,0.70,0.69,0.70,+0.01,1.45,85000,3,58890,0,0,0,0,0,0,61000,24000,37000,37000
20200520,046914,友達台新96購01,,,,,0.00,0.00,0,0,0,0,0,0,0,0,0,0,0,0,0
20200520,046928,奇鋐富邦97購01,0.21,0.21,0.21,0.21,-0.02,-8.7,102000,1,21420,0,0,0,0,0,0,102000,0,102000,102000
20200520,046934,智邦元富96購01,,,,,0.00,0.00,0,0,0,0,0,0,0,0,0,0,0,0,0
20200520,046937,聯電元大99購01,1.74,1.77,1.59,1.62,-0.07,-4.14,195000,19,325920,0,0,0,0,0,0,85000,110000,-25000,-25000
20200520,046939,燿華元大96購01,,,,,0.00,0.00,0,0,0,0,0,0,0,0,0,0,0,0,0
20200520,046942,友達元大99購01,0.89,0.93,0.87,0.87,+0.02,2.35,85000,13,76450,0,0,0,0,0,0,79000,6000,73000,73000
20200520,046944,奇力新元大96購01,1.30,1.30,1.30,1.30,0.00,0.00,10000,1,13000,0,0,0,0,0,0,10000,10000,0,0
20200520,046949,群創元大99購01,0.26,0.26,0.26,0.26,0.00,0.00,5000,5,1300,0,0,0,0,0,0,0,0,0,0
20200520,046999,康控富邦99購01,,,,,0.00,0.00,0,0,0,0,0,0,0,0,0,0,0,0,0
20200520,047004,台積電統一99購01,1.88,1.88,1.76,1.81,-0.09,-4.74,34000,7,61020,0,0,0,0,0,0,14000,0,14000,14000
20200520,047013,超眾元富96購01,,,,,0.00,0.00,0,0,0,0,0,0,0,0,0,0,0,0,0
20200520,047014,元油反元大99購01,,,,,0.00,0.00,0,0,0,0,0,0,0,0,0,0,0,0,0
20200520,047096,元油反國泰96購01,,,,,0.00,0.00,0,0,0,0,0,0,0,0,0,0,0,0,0
20200520,047194,世紀鋼元大96購01,,,,,0.00,0.00,0,0,0,0,0,0,0,0,0,0,0,0,0
20200520,047196,上銀統一97購01,0.54,0.54,0.54,0.54,-0.16,-22.86,1000,1,540,0,0,0,0,0,0,1000,0,1000,1000
20200520,047202,欣興元富96購01,,,,,0.00,0.00,0,0,0,0,0,0,0,0,0,0,0,0,0
20200520,047209,滬深2X富邦96購01,,,,,0.00,0.00,0,0,0,0,0,0,0,0,0,0,0,0,0
20200520,047211,華新科富邦99購01,1.89,1.89,1.69,1.69,-0.13,-7.14,17000,9,30860,0,0,0,0,0,0,4000,11000,-7000,-7000
20200520,047212,宏達電富邦97購01,,,,,0.00,0.00,0,0,0,0,0,0,0,0,0,0,0,0,0
20200520,047213,新日興富邦97購01,0.45,0.63,0.40,0.63,+0.14,28.57,203000,35,95860,0,0,0,0,0,0,141000,191000,-50000,-50000
20200520,047214,啟碁富邦97購01,,,,,0.00,0.00,0,0,0,0,0,0,0,0,0,0,0,0,0
20200520,04727P,臺股指凱基96售03,,,,,0.00,0.00,0,0,0,0,0,0,0,0,0,0,0,0,0
20200520,047289,啟碁統一97購01,,,,,0.00,0.00,0,0,0,0,0,0,0,0,0,0,0,0,0
20200520,047292,台光電元富96購01,,,,,0.00,0.00,0,0,0,0,0,0,0,0,0,0,0,0,0
20200520,047295,欣興元富96購02,,,,,0.00,0.00,0,0,0,0,0,0,0,0,0,0,0,0,0
20200520,047296,日月光元富96購01,,,,,0.00,0.00,0,0,0,0,0,0,0,0,0,0,0,0,0
20200520,047298,聯茂元富96購01,,,,,0.00,0.00,0,0,0,0,0,0,0,0,0,0,0,0,0
20200520,04729P,臺股指中信96售01,,,,,0.00,0.00,0,0,0,0,0,0,0,0,0,0,0,0,0
20200520,047302,為升富邦97購01,,,,,0.00,0.00,0,0,0,0,0,0,0,0,0,0,0,0,0
20200520,047303,寶滬深元大96購01,,,,,0.00,0.00,0,0,0,0,0,0,0,0,0,0,0,0,0
20200520,047304,元油2X元大96購02,,,,,0.00,0.00,0,0,0,0,0,0,0,0,0,0,0,0,0
20200520,04730P,臺股指中信96售02,,,,,0.00,0.00,0,0,0,0,0,0,0,0,0,0,0,0,0
20200520,04731P,臺股指中信96售03,0.80,0.83,0.78,0.80,-0.02,-2.44,280000,8,222950,0,0,0,0,0,0,5000,275000,-270000,-270000
20200520,047342,T50反1中信99購01,,,,,0.00,0.00,0,0,0,0,0,0,0,0,0,0,0,0,0
20200520,047379,元油2X元大96購03,,,,,0.00,0.00,0,0,0,0,0,0,0,0,0,0,0,0,0
20200520,047405,香港2X統一96購01,,,,,0.00,0.00,0,0,0,0,0,0,0,0,0,0,0,0,0
20200520,047410,上銀元富96購01,0.44,0.44,0.44,0.44,-0.05,-10.2,20000,2,8800,0,0,0,0,0,0,20000,20000,0,0
20200520,047417,台塑富邦97購01,0.10,0.13,0.10,0.13,+0.04,44.44,16000,3,2050,0,0,0,0,0,0,0,10000,-10000,-10000
20200520,047418,智邦富邦97購01,,,,,0.00,0.00,0,0,0,0,0,0,0,0,0,0,0,0,0
20200520,047420,全新富邦97購01,0.10,0.10,0.08,0.10,-0.02,-16.67,285000,7,27250,0,0,0,0,0,0,125000,160000,-35000,-35000
20200520,047421,聯茂富邦97購01,,,,,0.00,0.00,0,0,0,0,0,0,0,0,0,0,0,0,0
20200520,047454,滬深2X群益96購03,,,,,0.00,0.00,0,0,0,0,0,0,0,0,0,0,0,0,0
20200520,047482,新光金凱基99購03,,,,,0.00,0.00,0,0,0,0,0,0,0,0,0,0,0,0,0
20200520,047483,新光金凱基99購04,,,,,0.00,0.00,0,0,0,0,0,0,0,0,0,0,0,0,0
20200520,047493,旺宏元富96購01,,,,,0.00,0.00,0,0,0,0,0,0,0,0,0,0,0,0,0
20200520,047494,華邦電元富96購01,,,,,0.00,0.00,0,0,0,0,0,0,0,0,0,0,0,0,0
20200520,047495,新日興元富96購01,,,,,0.00,0.00,0,0,0,0,0,0,0,0,0,0,0,0,0
20200520,047504,滬深2X國票9A購01,,,,,0.00,0.00,0,0,0,0,0,0,0,0,0,0,0,0,0
20200520,047505,元金2X國票9B購01,1.42,1.42,1.39,1.42,0.00,0.00,24000,4,33780,0,0,0,0,0,0,0,0,0,0
20200520,047517,元油反元大96購01,,,,,0.00,0.00,0,0,0,0,0,0,0,0,0,0,0,0,0
20200520,047547,友達凱基99購02,,,,,0.00,0.00,0,0,0,0,0,0,0,0,0,0,0,0,0
20200520,047548,友達凱基99購03,,,,,0.00,0.00,0,0,0,0,0,0,0,0,0,0,0,0,0
20200520,047564,滬深2X國票99購01,0.14,0.14,0.14,0.14,0.00,0.00,1844000,15,258160,0,0,0,0,0,0,30000,1814000,-1784000,-1784000
20200520,047571,滬深2X群益99購01,,,,,0.00,0.00,0,0,0,0,0,0,0,0,0,0,0,0,0
20200520,047595,元石油元富97購01,0.01,0.01,0.01,0.01,0.00,0.00,15000,2,150,0,0,0,0,0,0,15000,0,15000,15000
20200520,047596,元油反元富97購01,,,,,0.00,0.00,0,0,0,0,0,0,0,0,0,0,0,0,0
20200520,047629,深中小元大96購01,,,,,0.00,0.00,0,0,0,0,0,0,0,0,0,0,0,0,0
20200520,047630,元油反元大96購02,,,,,0.00,0.00,0,0,0,0,0,0,0,0,0,0,0,0,0
20200520,04763P,臺股指凱基96售05,,,,,0.00,0.00,0,0,0,0,0,0,0,0,0,0,0,0,0
20200520,047661,滬深2X永豐96購01,,,,,0.00,0.00,0,0,0,0,0,0,0,0,0,0,0,0,0
20200520,047673,瑞昱元富96購01,0.71,0.77,0.64,0.64,-0.24,-27.27,399000,24,285890,0,0,0,0,0,0,345000,54000,291000,291000
20200520,047674,群創元富96購02,,,,,0.00,0.00,0,0,0,0,0,0,0,0,0,0,0,0,0
20200520,047675,群創元富96購03,0.26,0.26,0.22,0.22,0.00,0.00,225000,7,53800,0,0,0,0,0,0,0,225000,-225000,-225000
20200520,047676,臺股指元富99購01,,,,,0.00,0.00,0,0,0,0,0,0,0,0,0,0,0,0,0
20200520,047680,上証反中信96購01,0.11,0.11,0.11,0.11,0.00,0.00,20000,1,2200,0,0,0,0,0,0,20000,0,20000,20000
20200520,047687,元金2X富邦96購01,,,,,0.00,0.00,0,0,0,0,0,0,0,0,0,0,0,0,0
20200520,047689,瑞昱富邦97購01,,,,,0.00,0.00,0,0,0,0,0,0,0,0,0,0,0,0,0
20200520,04768P,大立光國泰96售03,,,,,0.00,0.00,0,0,0,0,0,0,0,0,0,0,0,0,0
20200520,047690,美律富邦97購01,0.04,0.10,0.04,0.10,0.00,0.00,31000,2,1300,0,0,0,0,0,0,30000,0,30000,30000
20200520,047694,SP黃豆國票9B購01,0.39,0.40,0.37,0.37,-0.03,-7.5,45000,3,17450,0,0,0,0,0,0,0,0,0,0
20200520,04771P,友達元大96售02,,,,,0.00,0.00,0,0,0,0,0,0,0,0,0,0,0,0,0
20200520,047760,元油反元大96購03,,,,,0.00,0.00,0,0,0,0,0,0,0,0,0,0,0,0,0
20200520,047769,大立光元大96購01,0.37,0.37,0.37,0.37,0.00,0.00,45000,1,16650,0,0,0,0,0,0,45000,0,45000,45000
20200520,047773,超眾元大96購01,,,,,0.00,0.00,0,0,0,0,0,0,0,0,0,0,0,0,0
20200520,047780,友達中信96購01,,,,,0.00,0.00,0,0,0,0,0,0,0,0,0,0,0,0,0
20200520,047825,道瓊反元大96購01,,,,,0.00,0.00,0,0,0,0,0,0,0,0,0,0,0,0,0
20200520,04782P,智伸科統一96售01,,,,,0.00,0.00,0,0,0,0,0,0,0,0,0,0,0,0,0
20200520,047854,滬深2X國票96購02,,,,,0.00,0.00,0,0,0,0,0,0,0,0,0,0,0,0,0
20200520,04786P,鴻海永昌96售01,,,,,0.00,0.00,0,0,0,0,0,0,0,0,0,0,0,0,0
20200520,04787P,台積電永昌96售04,,,,,0.00,0.00,0,0,0,0,0,0,0,0,0,0,0,0,0
20200520,047885,元金2X富邦99購01,,,,,0.00,0.00,0,0,0,0,0,0,0,0,0,0,0,0,0
20200520,047887,智原富邦97購01,,,,,0.00,0.00,0,0,0,0,0,0,0,0,0,0,0,0,0
20200520,04788P,台積電永昌96售05,,,,,0.00,0.00,0,0,0,0,0,0,0,0,0,0,0,0,0
20200520,047903,滬深2X元大96購01,,,,,0.00,0.00,0,0,0,0,0,0,0,0,0,0,0,0,0
20200520,047904,臺指反元大96購01,,,,,0.00,0.00,0,0,0,0,0,0,0,0,0,0,0,0,0
20200520,047905,元油反元大96購04,,,,,0.00,0.00,0,0,0,0,0,0,0,0,0,0,0,0,0
20200520,047937,元金2X國票97購02,,,,,0.00,0.00,0,0,0,0,0,0,0,0,0,0,0,0,0
20200520,047944,中石化元富96購01,,,,,0.00,0.00,0,0,0,0,0,0,0,0,0,0,0,0,0
20200520,04794P,友達元大96售03,,,,,0.00,0.00,0,0,0,0,0,0,0,0,0,0,0,0,0
20200520,047962,T50反1中信96購02,0.29,0.30,0.27,0.29,-0.02,-6.45,2976000,38,849060,0,0,0,0,0,0,1173000,1612000,-439000,-439000
20200520,047969,台達電富邦97購01,,,,,0.00,0.00,0,0,0,0,0,0,0,0,0,0,0,0,0
20200520,047978,元油反群益97購01,,,,,0.00,0.00,0,0,0,0,0,0,0,0,0,0,0,0,0
20200520,047979,中石化群益95購01,,,,,0.00,0.00,0,0,0,0,0,0,0,0,0,0,0,0,0
20200520,047989,深中小元大96購02,,,,,0.00,0.00,0,0,0,0,0,0,0,0,0,0,0,0,0
20200520,047990,臺指反元大96購02,,,,,0.00,0.00,0,0,0,0,0,0,0,0,0,0,0,0,0
20200520,047991,元油反元大96購05,,,,,0.00,0.00,0,0,0,0,0,0,0,0,0,0,0,0,0
20200520,047992,東陽元大96購01,,,,,0.00,0.00,0,0,0,0,0,0,0,0,0,0,0,0,0
20200520,047993,鑽全元大96購01,,,,,0.00,0.00,0,0,0,0,0,0,0,0,0,0,0,0,0
20200520,047995,台達電元大96購01,,,,,0.00,0.00,0,0,0,0,0,0,0,0,0,0,0,0,0
20200520,048001,中工元大96購01,0.20,0.21,0.20,0.20,-0.01,-4.76,61000,6,12260,0,0,0,0,0,0,61000,61000,0,0
20200520,048007,明基材元大96購01,0.04,0.04,0.04,0.04,0.00,0.00,109000,2,4360,0,0,0,0,0,0,109000,0,109000,109000
20200520,048008,聯發科富邦95購02,,,,,0.00,0.00,0,0,0,0,0,0,0,0,0,0,0,0,0
20200520,048010,嘉聯益富邦97購01,,,,,0.00,0.00,0,0,0,0,0,0,0,0,0,0,0,0,0
20200520,048020,滬深2X凱基96購02,,,,,0.00,0.00,0,0,0,0,0,0,0,0,0,0,0,0,0
20200520,048049,滬深反中信96購01,,,,,0.00,0.00,0,0,0,0,0,0,0,0,0,0,0,0,0
20200520,048054,鴻海國泰95購01,,,,,0.00,0.00,0,0,0,0,0,0,0,0,0,0,0,0,0
20200520,048055,燿華國泰95購02,,,,,0.00,0.00,0,0,0,0,0,0,0,0,0,0,0,0,0
20200520,048058,大立光國泰95購01,,,,,0.00,0.00,0,0,0,0,0,0,0,0,0,0,0,0,0
20200520,048059,欣興國泰95購01,,,,,0.00,0.00,0,0,0,0,0,0,0,0,0,0,0,0,0
20200520,048061,鴻海統一95購03,0.01,0.01,0.01,0.01,0.00,0.00,80000,1,800,0,0,0,0,0,0,80000,0,80000,80000
20200520,048068,南亞科元富95購01,,,,,0.00,0.00,0,0,0,0,0,0,0,0,0,0,0,0,0
20200520,048069,南亞科元富95購02,,,,,0.00,0.00,0,0,0,0,0,0,0,0,0,0,0,0,0
20200520,048070,聯發科元富99購03,1.20,1.44,1.20,1.29,+0.09,7.5,125000,9,168150,0,0,0,0,0,0,95000,10000,85000,85000
20200520,048080,元石油凱基96購01,,,,,0.00,0.00,0,0,0,0,0,0,0,0,0,0,0,0,0
20200520,048081,元油反凱基96購01,,,,,0.00,0.00,0,0,0,0,0,0,0,0,0,0,0,0,0
20200520,048105,滬深2X群益99購02,,,,,0.00,0.00,0,0,0,0,0,0,0,0,0,0,0,0,0
20200520,048119,臺指反元大96購03,,,,,0.00,0.00,0,0,0,0,0,0,0,0,0,0,0,0,0
20200520,048122,台達電元大96購02,,,,,0.00,0.00,0,0,0,0,0,0,0,0,0,0,0,0,0
20200520,048124,大立光元大95購03,,,,,0.00,0.00,0,0,0,0,0,0,0,0,0,0,0,0,0
20200520,048125,和鑫元大96購01,,,,,0.00,0.00,0,0,0,0,0,0,0,0,0,0,0,0,0
20200520,048128,超眾元大95購01,,,,,0.00,0.00,0,0,0,0,0,0,0,0,0,0,0,0,0
20200520,04812P,國巨元大95售03,,,,,0.00,0.00,0,0,0,0,0,0,0,0,0,0,0,0,0
20200520,048130,美利達元大96購01,,,,,0.00,0.00,0,0,0,0,0,0,0,0,0,0,0,0,0
20200520,048147,元油反元富95購01,,,,,0.00,0.00,0,0,0,0,0,0,0,0,0,0,0,0,0
20200520,048149,泰鼎元富95購01,,,,,0.00,0.00,0,0,0,0,0,0,0,0,0,0,0,0,0
20200520,04814P,健策元大96售01,,,,,0.00,0.00,0,0,0,0,0,0,0,0,0,0,0,0,0
20200520,048158,大立光兆豐95購01,,,,,0.00,0.00,0,0,0,0,0,0,0,0,0,0,0,0,0
20200520,048160,GIS兆豐95購01,,,,,0.00,0.00,0,0,0,0,0,0,0,0,0,0,0,0,0
20200520,048166,滬深2X永豐96購02,,,,,0.00,0.00,0,0,0,0,0,0,0,0,0,0,0,0,0
20200520,048175,矽力國泰95購01,,,,,0.00,0.00,0,0,0,0,0,0,0,0,0,0,0,0,0
20200520,048177,臺指反富邦99購01,,,,,0.00,0.00,0,0,0,0,0,0,0,0,0,0,0,0,0
20200520,048178,上銀富邦95購02,,,,,0.00,0.00,0,0,0,0,0,0,0,0,0,0,0,0,0
20200520,048179,臻鼎富邦97購01,0.30,0.30,0.30,0.30,0.00,0.00,10000,1,3000,0,0,0,0,0,0,0,10000,-10000,-10000
20200520,04817P,創意國票95售02,,,,,0.00,0.00,0,0,0,0,0,0,0,0,0,0,0,0,0
20200520,048181,A50正2群益95購01,,,,,0.00,0.00,0,0,0,0,0,0,0,0,0,0,0,0,0
20200520,048186,元黃金元大96購01,,,,,0.00,0.00,0,0,0,0,0,0,0,0,0,0,0,0,0
20200520,048187,臺指反元大96購04,,,,,0.00,0.00,0,0,0,0,0,0,0,0,0,0,0,0,0
20200520,048188,臺指反元大96購05,,,,,0.00,0.00,0,0,0,0,0,0,0,0,0,0,0,0,0
20200520,048189,臺指反元大96購06,0.66,0.68,0.66,0.67,-0.02,-2.9,200000,3,134000,0,0,0,0,0,0,150000,50000,100000,100000
20200520,048190,道瓊反元大96購02,,,,,0.00,0.00,0,0,0,0,0,0,0,0,0,0,0,0,0
20200520,048192,華通元大96購01,1.28,1.28,1.14,1.14,-0.14,-10.94,35000,4,42400,0,0,0,0,0,0,10000,25000,-15000,-15000
20200520,048214,滬深2X凱基96購03,,,,,0.00,0.00,0,0,0,0,0,0,0,0,0,0,0,0,0
20200520,048215,A50正2凱基95購01,,,,,0.00,0.00,0,0,0,0,0,0,0,0,0,0,0,0,0
20200520,048221,鴻海凱基95購01,0.53,0.53,0.51,0.51,0.00,0.00,8000,2,4160,0,0,0,0,0,0,8000,0,8000,8000
20200520,048236,A50正2國票97購02,0.11,0.11,0.11,0.11,0.00,0.00,4000,1,440,0,0,0,0,0,0,0,4000,-4000,-4000
20200520,048248,聯發科兆豐95購01,0.60,0.60,0.60,0.60,+0.10,20.0,10000,1,6000,0,0,0,0,0,0,10000,0,10000,10000
20200520,048261,鴻海元富95購01,,,,,0.00,0.00,0,0,0,0,0,0,0,0,0,0,0,0,0
20200520,048263,台積電元富95購01,1.00,1.00,1.00,1.00,0.00,0.00,10000,1,10000,0,0,0,0,0,0,0,0,0,0
20200520,048266,臺指反中信95購01,,,,,0.00,0.00,0,0,0,0,0,0,0,0,0,0,0,0,0
20200520,048268,長榮航中信95購01,,,,,0.00,0.00,0,0,0,0,0,0,0,0,0,0,0,0,0
20200520,048269,瀚宇博國泰95購01,,,,,0.00,0.00,0,0,0,0,0,0,0,0,0,0,0,0,0
20200520,04826P,華新科麥證95售01,,,,,0.00,0.00,0,0,0,0,0,0,0,0,0,0,0,0,0
20200520,048270,T50反1富邦99購01,0.86,0.86,0.85,0.85,-0.01,-1.16,8000,2,6830,0,0,0,0,0,0,0,8000,-8000,-8000
20200520,048271,可成富邦95購02,,,,,0.00,0.00,0,0,0,0,0,0,0,0,0,0,0,0,0
20200520,048272,新光金富邦98購01,,,,,0.00,0.00,0,0,0,0,0,0,0,0,0,0,0,0,0
20200520,048273,南電富邦97購01,1.32,1.32,1.19,1.19,-0.03,-2.46,7000,3,8510,0,0,0,0,0,0,0,7000,-7000,-7000
20200520,048284,臺股指中信95購04,,,,,0.00,0.00,0,0,0,0,0,0,0,0,0,0,0,0,0
20200520,048289,臺指反群益95購01,,,,,0.00,0.00,0,0,0,0,0,0,0,0,0,0,0,0,0
20200520,048303,A50凱基96購01,,,,,0.00,0.00,0,0,0,0,0,0,0,0,0,0,0,0,0
20200520,048305,深100凱基96購01,,,,,0.00,0.00,0,0,0,0,0,0,0,0,0,0,0,0,0
20200520,04831P,聯詠富邦96售01,0.23,0.23,0.23,0.23,-0.01,-4.17,10000,1,2300,0,0,0,0,0,0,0,10000,-10000,-10000
20200520,048331,臺指反富邦97購01,,,,,0.00,0.00,0,0,0,0,0,0,0,0,0,0,0,0,0
20200520,048333,大立光富邦95購01,,,,,0.00,0.00,0,0,0,0,0,0,0,0,0,0,0,0,0
20200520,048334,A50正2元大96購01,,,,,0.00,0.00,0,0,0,0,0,0,0,0,0,0,0,0,0
20200520,048339,友達元大95購01,,,,,0.00,0.00,0,0,0,0,0,0,0,0,0,0,0,0,0
20200520,048346,智易元大95購01,,,,,0.00,0.00,0,0,0,0,0,0,0,0,0,0,0,0,0
20200520,048349,美利達元大96購02,,,,,0.00,0.00,0,0,0,0,0,0,0,0,0,0,0,0,0
20200520,048350,世紀鋼元大95購01,,,,,0.00,0.00,0,0,0,0,0,0,0,0,0,0,0,0,0
20200520,048373,A50正2元富95購01,,,,,0.00,0.00,0,0,0,0,0,0,0,0,0,0,0,0,0
20200520,048379,台郡元富96購01,,,,,0.00,0.00,0,0,0,0,0,0,0,0,0,0,0,0,0
20200520,048382,T50反1國票96購01,,,,,0.00,0.00,0,0,0,0,0,0,0,0,0,0,0,0,0
20200520,048383,元金2X國票99購01,2.80,2.83,2.80,2.81,+0.17,6.44,900000,19,2524050,0,0,0,0,0,0,551000,349000,202000,202000
20200520,04838P,宏達電元大95售02,,,,,0.00,0.00,0,0,0,0,0,0,0,0,0,0,0,0,0
20200520,048402,聯茂兆豐95購01,,,,,0.00,0.00,0,0,0,0,0,0,0,0,0,0,0,0,0
20200520,048414,滬深2X統一98購01,0.66,0.66,0.66,0.66,-0.01,-1.49,14000,1,9240,0,0,0,0,0,0,14000,0,14000,14000
20200520,048422,瑞昱元富96購02,0.69,0.69,0.55,0.68,-0.05,-6.85,642000,28,416970,0,0,0,0,0,0,494000,128000,366000,366000
20200520,048424,揚明光元富95購01,,,,,0.00,0.00,0,0,0,0,0,0,0,0,0,0,0,0,0
20200520,048425,聯茂元富96購02,,,,,0.00,0.00,0,0,0,0,0,0,0,0,0,0,0,0,0
20200520,048427,百和元富95購01,0.01,0.01,0.01,0.01,0.00,0.00,10000,1,100,0,0,0,0,0,0,10000,0,10000,10000
20200520,04842P,群創元大96售02,,,,,0.00,0.00,0,0,0,0,0,0,0,0,0,0,0,0,0
20200520,048432,全新國票95購01,,,,,0.00,0.00,0,0,0,0,0,0,0,0,0,0,0,0,0
20200520,048456,利勤凱基95購01,,,,,0.00,0.00,0,0,0,0,0,0,0,0,0,0,0,0,0
20200520,048483,可成國泰95購01,,,,,0.00,0.00,0,0,0,0,0,0,0,0,0,0,0,0,0
20200520,048484,大立光國泰95購02,,,,,0.00,0.00,0,0,0,0,0,0,0,0,0,0,0,0,0
20200520,048486,傳奇國泰95購01,,,,,0.00,0.00,0,0,0,0,0,0,0,0,0,0,0,0,0
20200520,048499,達運元大96購01,0.02,0.02,0.02,0.02,0.00,0.00,30000,1,600,0,0,0,0,0,0,0,0,0,0
20200520,048504,A50正2中信95購01,,,,,0.00,0.00,0,0,0,0,0,0,0,0,0,0,0,0,0
20200520,048505,滬深2X群益99購03,,,,,0.00,0.00,0,0,0,0,0,0,0,0,0,0,0,0,0
20200520,048509,上証反凱基99購02,,,,,0.00,0.00,0,0,0,0,0,0,0,0,0,0,0,0,0
20200520,048522,A50正2元富95購02,,,,,0.00,0.00,0,0,0,0,0,0,0,0,0,0,0,0,0
20200520,048549,滬深2X元大96購03,,,,,0.00,0.00,0,0,0,0,0,0,0,0,0,0,0,0,0
20200520,04854P,鴻海國泰96售04,1.22,1.23,1.20,1.23,0.00,0.00,90000,9,109650,0,0,0,0,0,0,90000,15000,75000,75000
20200520,048550,中鴻元大96購01,,,,,0.00,0.00,0,0,0,0,0,0,0,0,0,0,0,0,0
20200520,048562,宏達電元大95購01,,,,,0.00,0.00,0,0,0,0,0,0,0,0,0,0,0,0,0
20200520,048571,美利達元大96購03,,,,,0.00,0.00,0,0,0,0,0,0,0,0,0,0,0,0,0
20200520,048572,美利達元大96購04,1.11,1.33,1.11,1.24,+0.34,37.78,42000,8,52590,0,0,0,0,0,0,21000,10000,11000,11000
20200520,048574,台積電國泰95購02,,,,,0.00,0.00,0,0,0,0,0,0,0,0,0,0,0,0,0
20200520,048576,義隆國泰95購01,,,,,0.00,0.00,0,0,0,0,0,0,0,0,0,0,0,0,0
20200520,048583,智原富邦98購01,,,,,0.00,0.00,0,0,0,0,0,0,0,0,0,0,0,0,0
20200520,048584,欣興富邦95購01,,,,,0.00,0.00,0,0,0,0,0,0,0,0,0,0,0,0,0
20200520,048589,國巨兆豐96購01,3.58,3.58,3.51,3.51,0.00,0.00,2000,2,7090,0,0,0,0,0,0,2000,0,2000,2000
20200520,048595,儒鴻國票96購01,,,,,0.00,0.00,0,0,0,0,0,0,0,0,0,0,0,0,0
20200520,048599,和鑫國票96購01,,,,,0.00,0.00,0,0,0,0,0,0,0,0,0,0,0,0,0
20200520,048602,上緯控國票96購01,,,,,0.00,0.00,0,0,0,0,0,0,0,0,0,0,0,0,0
20200520,048627,T50反1元大96購02,,,,,0.00,0.00,0,0,0,0,0,0,0,0,0,0,0,0,0
20200520,048628,T50反1元大96購03,,,,,0.00,0.00,0,0,0,0,0,0,0,0,0,0,0,0,0
20200520,048629,滬深2X元大96購04,,,,,0.00,0.00,0,0,0,0,0,0,0,0,0,0,0,0,0
20200520,048637,鴻海元大96購01,,,,,0.00,0.00,0,0,0,0,0,0,0,0,0,0,0,0,0
20200520,048651,美利達元大96購05,1.29,1.66,1.29,1.46,+0.30,25.86,195000,15,281850,0,0,0,0,0,0,165000,30000,135000,135000
20200520,048652,巨大元大96購01,0.96,1.33,0.96,1.26,+0.48,61.54,207000,16,248830,0,0,0,0,0,0,115000,82000,33000,33000
20200520,048653,巨大元大96購02,1.32,1.48,1.32,1.45,+0.36,33.03,38000,8,53460,0,0,0,0,0,0,19000,10000,9000,9000
20200520,048655,A50正2元富96購01,,,,,0.00,0.00,0,0,0,0,0,0,0,0,0,0,0,0,0
20200520,04865P,台積電亞東95售01,0.01,0.01,0.01,0.01,0.00,0.00,30000,1,300,0,0,0,0,0,0,0,0,0,0
20200520,048663,聯發科統一96購01,0.32,0.32,0.32,0.32,0.00,0.00,15000,1,4800,0,0,0,0,0,0,15000,0,15000,15000
20200520,04866P,台積電統一95售02,,,,,0.00,0.00,0,0,0,0,0,0,0,0,0,0,0,0,0
20200520,048681,漢唐富邦96購01,,,,,0.00,0.00,0,0,0,0,0,0,0,0,0,0,0,0,0
20200520,048682,奇力新富邦96購01,,,,,0.00,0.00,0,0,0,0,0,0,0,0,0,0,0,0,0
20200520,048687,旺宏群益96購01,0.14,0.14,0.14,0.14,0.00,0.00,10000,1,1400,0,0,0,0,0,0,10000,0,10000,10000
20200520,048696,台達電國票96購01,,,,,0.00,0.00,0,0,0,0,0,0,0,0,0,0,0,0,0
20200520,04869P,鴻海元富95售02,1.36,1.36,1.36,1.36,+0.09,7.09,10000,1,13600,0,0,0,0,0,0,0,10000,-10000,-10000
20200520,048744,儒鴻元富97購01,,,,,0.00,0.00,0,0,0,0,0,0,0,0,0,0,0,0,0
20200520,048745,儒鴻元富97購02,,,,,0.00,0.00,0,0,0,0,0,0,0,0,0,0,0,0,0
20200520,048747,華通元富97購01,0.88,0.88,0.88,0.88,0.00,0.00,25000,3,22000,0,0,0,0,0,0,25000,20000,5000,5000
20200520,048748,國巨元富96購01,,,,,0.00,0.00,0,0,0,0,0,0,0,0,0,0,0,0,0
20200520,04874P,高股息中信97售01,,,,,0.00,0.00,0,0,0,0,0,0,0,0,0,0,0,0,0
20200520,048751,京鼎元富96購01,,,,,0.00,0.00,0,0,0,0,0,0,0,0,0,0,0,0,0
20200520,048754,瀚宇博元富97購01,,,,,0.00,0.00,0,0,0,0,0,0,0,0,0,0,0,0,0
20200520,048755,志超元富96購01,,,,,0.00,0.00,0,0,0,0,0,0,0,0,0,0,0,0,0
20200520,048756,志超元富96購02,,,,,0.00,0.00,0,0,0,0,0,0,0,0,0,0,0,0,0
20200520,048757,美利達元富96購01,,,,,0.00,0.00,0,0,0,0,0,0,0,0,0,0,0,0,0
20200520,048758,美利達元富96購02,,,,,0.00,0.00,0,0,0,0,0,0,0,0,0,0,0,0,0
20200520,048759,巨大元富96購01,0.51,0.59,0.51,0.59,+0.15,34.09,640000,6,347600,0,0,0,0,0,0,200000,440000,-240000,-240000
20200520,048781,臺股指凱基96購01,,,,,0.00,0.00,0,0,0,0,0,0,0,0,0,0,0,0,0
20200520,048785,台積電元大96購01,,,,,0.00,0.00,0,0,0,0,0,0,0,0,0,0,0,0,0
20200520,048794,易華電元大97購01,,,,,0.00,0.00,0,0,0,0,0,0,0,0,0,0,0,0,0
20200520,048801,漢唐富邦96購02,,,,,0.00,0.00,0,0,0,0,0,0,0,0,0,0,0,0,0
20200520,048803,大立光富邦96購01,,,,,0.00,0.00,0,0,0,0,0,0,0,0,0,0,0,0,0
20200520,048812,上証2X凱基96購01,,,,,0.00,0.00,0,0,0,0,0,0,0,0,0,0,0,0,0
20200520,04881P,高股息凱基96售01,,,,,0.00,0.00,0,0,0,0,0,0,0,0,0,0,0,0,0
20200520,048847,A50群益98購01,,,,,0.00,0.00,0,0,0,0,0,0,0,0,0,0,0,0,0
20200520,048848,滬深2X群益98購02,0.51,0.51,0.51,0.51,0.00,0.00,52000,1,26520,0,0,0,0,0,0,52000,52000,0,0
20200520,048850,聯電群益96購01,,,,,0.00,0.00,0,0,0,0,0,0,0,0,0,0,0,0,0
20200520,048852,旺宏群益96購02,,,,,0.00,0.00,0,0,0,0,0,0,0,0,0,0,0,0,0
20200520,048859,玉晶光群益96購02,0.87,0.87,0.87,0.87,0.00,0.00,4000,1,3480,0,0,0,0,0,0,4000,0,4000,4000
20200520,048860,玉晶光群益96購03,,,,,0.00,0.00,0,0,0,0,0,0,0,0,0,0,0,0,0
20200520,048870,義隆國票96購01,0.02,0.02,0.02,0.02,0.00,0.00,5000,1,100,0,0,0,0,0,0,5000,0,5000,5000
20200520,048874,玉晶光國票96購01,0.08,0.08,0.08,0.08,+0.01,14.29,10000,1,800,0,0,0,0,0,0,0,10000,-10000,-10000
20200520,048882,智原統一96購01,,,,,0.00,0.00,0,0,0,0,0,0,0,0,0,0,0,0,0
20200520,04888P,臺股指凱基95售03,,,,,0.00,0.00,0,0,0,0,0,0,0,0,0,0,0,0,0
20200520,048890,傳奇元富97購01,,,,,0.00,0.00,0,0,0,0,0,0,0,0,0,0,0,0,0
20200520,048891,傳奇元富97購02,,,,,0.00,0.00,0,0,0,0,0,0,0,0,0,0,0,0,0
20200520,048892,台郡元富97購01,,,,,0.00,0.00,0,0,0,0,0,0,0,0,0,0,0,0,0
20200520,048898,晶相光國泰96購01,0.02,0.02,0.02,0.02,0.00,0.00,100000,1,2000,0,0,0,0,0,0,100000,0,100000,100000
20200520,048902,昇陽半國泰96購01,,,,,0.00,0.00,0,0,0,0,0,0,0,0,0,0,0,0,0
20200520,048905,旺宏富邦96購01,,,,,0.00,0.00,0,0,0,0,0,0,0,0,0,0,0,0,0
20200520,04890P,台積電元大95售05,0.01,0.01,0.01,0.01,0.00,0.00,20000,20,200,0,0,0,0,0,0,0,0,0,0
20200520,048910,和鑫富邦98購01,,,,,0.00,0.00,0,0,0,0,0,0,0,0,0,0,0,0,0
20200520,048911,玉晶光富邦96購01,,,,,0.00,0.00,0,0,0,0,0,0,0,0,0,0,0,0,0
20200520,04896P,上証2X中信95售01,,,,,0.00,0.00,0,0,0,0,0,0,0,0,0,0,0,0,0
20200520,04898P,瑞儀中信95售01,,,,,0.00,0.00,0,0,0,0,0,0,0,0,0,0,0,0,0
20200520,049004,聯發科中信96購01,1.96,2.20,1.96,2.15,+0.25,13.16,63000,6,134350,0,0,0,0,0,0,58000,0,58000,58000
20200520,049007,玉晶光中信96購01,0.16,0.23,0.16,0.23,+0.05,27.78,314000,12,62060,0,0,0,0,0,0,125000,189000,-64000,-64000
20200520,049017,旺宏群益96購03,,,,,0.00,0.00,0,0,0,0,0,0,0,0,0,0,0,0,0
20200520,049023,玉晶光群益96購04,,,,,0.00,0.00,0,0,0,0,0,0,0,0,0,0,0,0,0
20200520,049024,玉晶光群益97購01,0.86,1.06,0.86,1.06,+0.12,12.77,527000,16,528580,0,0,0,0,0,0,9000,519000,-510000,-510000
20200520,049064,T50反1凱基96購03,,,,,0.00,0.00,0,0,0,0,0,0,0,0,0,0,0,0,0
20200520,049065,T50反1凱基96購04,,,,,0.00,0.00,0,0,0,0,0,0,0,0,0,0,0,0,0
20200520,049066,元石油凱基97購01,,,,,0.00,0.00,0,0,0,0,0,0,0,0,0,0,0,0,0
20200520,04906P,欣興國票95售01,,,,,0.00,0.00,0,0,0,0,0,0,0,0,0,0,0,0,0
20200520,04907P,超眾國票95售01,,,,,0.00,0.00,0,0,0,0,0,0,0,0,0,0,0,0,0
20200520,04908P,南電國票95售03,0.11,0.19,0.11,0.15,-0.06,-28.57,212000,8,32400,0,0,0,0,0,0,152000,60000,92000,92000
20200520,049098,國巨國泰96購01,,,,,0.00,0.00,0,0,0,0,0,0,0,0,0,0,0,0,0
20200520,049100,華新科國泰96購01,,,,,0.00,0.00,0,0,0,0,0,0,0,0,0,0,0,0,0
20200520,049102,智伸科國泰96購01,,,,,0.00,0.00,0,0,0,0,0,0,0,0,0,0,0,0,0
20200520,049103,易華電國泰96購01,,,,,0.00,0.00,0,0,0,0,0,0,0,0,0,0,0,0,0
20200520,049104,元油2X富邦97購02,,,,,0.00,0.00,0,0,0,0,0,0,0,0,0,0,0,0,0
20200520,049108,玉晶光富邦96購02,0.07,0.08,0.07,0.08,0.00,0.00,10000,5,770,0,0,0,0,0,0,10000,0,10000,10000
20200520,049117,矽格統一96購01,0.95,0.97,0.95,0.97,0.00,0.00,20000,2,19200,0,0,0,0,0,0,0,0,0,0
20200520,049128,滬深2X元大97購03,,,,,0.00,0.00,0,0,0,0,0,0,0,0,0,0,0,0,0
20200520,049129,S&P反1元大97購01,,,,,0.00,0.00,0,0,0,0,0,0,0,0,0,0,0,0,0
20200520,049130,臺指反元大98購01,,,,,0.00,0.00,0,0,0,0,0,0,0,0,0,0,0,0,0
20200520,04914P,國巨國泰95售06,,,,,0.00,0.00,0,0,0,0,0,0,0,0,0,0,0,0,0
20200520,049150,新光金元大96購01,,,,,0.00,0.00,0,0,0,0,0,0,0,0,0,0,0,0,0
20200520,049153,大立光元大96購02,0.01,0.02,0.01,0.02,+0.01,100.0,40000,3,700,0,0,0,0,0,0,10000,0,10000,10000
20200520,049156,緯穎元大96購01,,,,,0.00,0.00,0,0,0,0,0,0,0,0,0,0,0,0,0
20200520,049159,同欣電中信96購01,,,,,0.00,0.00,0,0,0,0,0,0,0,0,0,0,0,0,0
20200520,04915P,鴻海永昌96售02,,,,,0.00,0.00,0,0,0,0,0,0,0,0,0,0,0,0,0
20200520,049165,元油2X凱基97購01,,,,,0.00,0.00,0,0,0,0,0,0,0,0,0,0,0,0,0
20200520,049166,元油2X凱基97購02,,,,,0.00,0.00,0,0,0,0,0,0,0,0,0,0,0,0,0
20200520,049167,元油2X凱基97購03,,,,,0.00,0.00,0,0,0,0,0,0,0,0,0,0,0,0,0
20200520,04916P,大立光永昌96售02,,,,,0.00,0.00,0,0,0,0,0,0,0,0,0,0,0,0,0
20200520,049192,元油2X永豐96購02,,,,,0.00,0.00,0,0,0,0,0,0,0,0,0,0,0,0,0
20200520,049193,元油2X永豐97購01,,,,,0.00,0.00,0,0,0,0,0,0,0,0,0,0,0,0,0
20200520,049200,元黃金群益98購01,,,,,0.00,0.00,0,0,0,0,0,0,0,0,0,0,0,0,0
20200520,049227,元油2X富邦96購03,,,,,0.00,0.00,0,0,0,0,0,0,0,0,0,0,0,0,0
20200520,049230,台達電富邦96購01,,,,,0.00,0.00,0,0,0,0,0,0,0,0,0,0,0,0,0
20200520,049235,元油2X元富96購05,,,,,0.00,0.00,0,0,0,0,0,0,0,0,0,0,0,0,0
20200520,049236,元油2X元富96購06,,,,,0.00,0.00,0,0,0,0,0,0,0,0,0,0,0,0,0
20200520,049237,元油2X元富96購07,,,,,0.00,0.00,0,0,0,0,0,0,0,0,0,0,0,0,0
20200520,049238,元油2X元富96購08,,,,,0.00,0.00,0,0,0,0,0,0,0,0,0,0,0,0,0
20200520,049242,佳世達元富96購01,,,,,0.00,0.00,0,0,0,0,0,0,0,0,0,0,0,0,0
20200520,049243,佳世達元富96購02,,,,,0.00,0.00,0,0,0,0,0,0,0,0,0,0,0,0,0
20200520,049252,國巨元大96購01,,,,,0.00,0.00,0,0,0,0,0,0,0,0,0,0,0,0,0
20200520,049254,台積電元大96購02,,,,,0.00,0.00,0,0,0,0,0,0,0,0,0,0,0,0,0
20200520,049255,旺宏元大97購02,1.51,1.51,1.51,1.51,-0.04,-2.58,68000,1,102680,0,0,0,0,0,0,0,68000,-68000,-68000
20200520,049260,華新科元大96購01,0.39,0.39,0.39,0.39,0.00,0.00,5000,1,1950,0,0,0,0,0,0,5000,0,5000,5000
20200520,049269,超眾元大96購02,0.21,0.22,0.21,0.21,0.00,0.00,140000,3,29500,0,0,0,0,0,0,110000,30000,80000,80000
20200520,04926P,聯發科凱基95售03,,,,,0.00,0.00,0,0,0,0,0,0,0,0,0,0,0,0,0
20200520,049272,世紀鋼元大96購02,0.75,0.75,0.75,0.75,-0.12,-13.79,1000,1,750,0,0,0,0,0,0,1000,0,1000,1000
20200520,04927P,大立光凱基95售06,,,,,0.00,0.00,0,0,0,0,0,0,0,0,0,0,0,0,0
20200520,04928P,大立光凱基95售07,,,,,0.00,0.00,0,0,0,0,0,0,0,0,0,0,0,0,0
20200520,049296,義隆群益96購01,,,,,0.00,0.00,0,0,0,0,0,0,0,0,0,0,0,0,0
20200520,04929P,同欣電凱基95售01,,,,,0.00,0.00,0,0,0,0,0,0,0,0,0,0,0,0,0
20200520,049306,元油2X凱基96購01,,,,,0.00,0.00,0,0,0,0,0,0,0,0,0,0,0,0,0
20200520,04932P,香港2X中信96售01,1.20,1.20,1.20,1.20,+0.07,6.19,2000,1,2400,0,0,0,0,0,0,0,2000,-2000,-2000
20200520,049335,聯電統一97購01,,,,,0.00,0.00,0,0,0,0,0,0,0,0,0,0,0,0,0
20200520,04933P,中石化中信96售01,,,,,0.00,0.00,0,0,0,0,0,0,0,0,0,0,0,0,0
20200520,049355,元油2X富邦96購04,,,,,0.00,0.00,0,0,0,0,0,0,0,0,0,0,0,0,0
20200520,04935P,鴻海中信96售01,0.37,0.37,0.37,0.37,0.00,0.00,3000,1,1110,0,0,0,0,0,0,3000,3000,0,0
20200520,049367,全新元大96購01,,,,,0.00,0.00,0,0,0,0,0,0,0,0,0,0,0,0,0
20200520,04936P,大立光中信95售03,,,,,0.00,0.00,0,0,0,0,0,0,0,0,0,0,0,0,0
20200520,049389,元石油中信97購02,0.03,0.04,0.03,0.04,-0.01,-20.0,46000,6,1490,0,0,0,0,0,0,0,0,0,0
20200520,04938P,亞德客國票95售01,,,,,0.00,0.00,0,0,0,0,0,0,0,0,0,0,0,0,0
20200520,049390,元油2X中信96購01,,,,,0.00,0.00,0,0,0,0,0,0,0,0,0,0,0,0,0
20200520,049396,元油2X群益97購03,,,,,0.00,0.00,0,0,0,0,0,0,0,0,0,0,0,0,0
20200520,04939P,國巨國票95售03,,,,,0.00,0.00,0,0,0,0,0,0,0,0,0,0,0,0,0
20200520,049406,T50反1日盛97購01,0.16,0.16,0.16,0.16,0.00,0.00,30000,1,4800,0,0,0,0,0,0,0,30000,-30000,-30000
20200520,049409,滬深2X凱基96購04,,,,,0.00,0.00,0,0,0,0,0,0,0,0,0,0,0,0,0
20200520,04940P,台積電國票95售02,,,,,0.00,0.00,0,0,0,0,0,0,0,0,0,0,0,0,0
20200520,049431,光罩國票96購01,0.01,0.01,0.01,0.01,0.00,0.00,7000,1,70,0,0,0,0,0,0,7000,0,7000,7000
20200520,049435,S&P反1國泰96購01,,,,,0.00,0.00,0,0,0,0,0,0,0,0,0,0,0,0,0
20200520,049436,義隆國泰96購02,,,,,0.00,0.00,0,0,0,0,0,0,0,0,0,0,0,0,0
20200520,049437,可成國泰96購01,,,,,0.00,0.00,0,0,0,0,0,0,0,0,0,0,0,0,0
20200520,049438,嘉晶國泰96購01,1.15,1.30,1.11,1.30,+0.35,36.84,38000,5,43590,0,0,0,0,0,0,25000,3000,22000,22000
20200520,049439,牧德國泰96購01,1.30,1.30,1.30,1.30,0.00,0.00,10000,1,13000,0,0,0,0,0,0,10000,0,10000,10000
20200520,049442,滬深2X統一99購01,,,,,0.00,0.00,0,0,0,0,0,0,0,0,0,0,0,0,0
20200520,049458,SP黃豆元富96購01,,,,,0.00,0.00,0,0,0,0,0,0,0,0,0,0,0,0,0
20200520,049463,華新科富邦97購01,0.46,0.63,0.42,0.42,-0.04,-8.7,36000,5,15730,0,0,0,0,0,0,0,35000,-35000,-35000
20200520,049485,台積電元大96購03,,,,,0.00,0.00,0,0,0,0,0,0,0,0,0,0,0,0,0
20200520,049499,康控元大96購01,,,,,0.00,0.00,0,0,0,0,0,0,0,0,0,0,0,0,0
20200520,04950P,上証2X中信96售02,0.02,0.05,0.02,0.05,-0.01,-16.67,130000,13,6200,0,0,0,0,0,0,0,130000,-130000,-130000
20200520,049537,元石油群益97購01,0.01,0.02,0.01,0.02,0.00,0.00,201000,4,2020,0,0,0,0,0,0,0,0,0,0
20200520,049538,元油2X群益98購01,,,,,0.00,0.00,0,0,0,0,0,0,0,0,0,0,0,0,0
20200520,049539,元油2X群益9A購01,0.13,0.13,0.09,0.10,-0.04,-28.57,104000,9,9700,0,0,0,0,0,0,0,0,0,0
20200520,04954P,健策國票96售01,,,,,0.00,0.00,0,0,0,0,0,0,0,0,0,0,0,0,0
20200520,049552,鴻海國泰96購01,,,,,0.00,0.00,0,0,0,0,0,0,0,0,0,0,0,0,0
20200520,049553,鴻海國泰96購02,,,,,0.00,0.00,0,0,0,0,0,0,0,0,0,0,0,0,0
20200520,049554,禾伸堂富邦96購01,,,,,0.00,0.00,0,0,0,0,0,0,0,0,0,0,0,0,0
20200520,049561,道瓊銀統一96購01,0.06,0.06,0.06,0.06,0.00,0.00,10000,1,600,0,0,0,0,0,0,0,0,0,0
20200520,04957P,上証2X凱基96售02,,,,,0.00,0.00,0,0,0,0,0,0,0,0,0,0,0,0,0
20200520,049584,台積電元大96購04,,,,,0.00,0.00,0,0,0,0,0,0,0,0,0,0,0,0,0
20200520,049591,開發金元大98購01,,,,,0.00,0.00,0,0,0,0,0,0,0,0,0,0,0,0,0
20200520,049592,欣興元大96購01,,,,,0.00,0.00,0,0,0,0,0,0,0,0,0,0,0,0,0
20200520,049593,群創元大9A購01,,,,,0.00,0.00,0,0,0,0,0,0,0,0,0,0,0,0,0
20200520,049597,泰鼎元大96購01,,,,,0.00,0.00,0,0,0,0,0,0,0,0,0,0,0,0,0
20200520,04960P,大立光凱基96售04,,,,,0.00,0.00,0,0,0,0,0,0,0,0,0,0,0,0,0
20200520,049612,香港反中信96購01,,,,,0.00,0.00,0,0,0,0,0,0,0,0,0,0,0,0,0
20200520,049615,香港2X群益98購01,0.07,0.07,0.07,0.07,0.00,0.00,171000,2,11970,0,0,0,0,0,0,171000,0,171000,171000
20200520,04962P,易華電凱基96售01,,,,,0.00,0.00,0,0,0,0,0,0,0,0,0,0,0,0,0
20200520,049636,上証反凱基9A購01,,,,,0.00,0.00,0,0,0,0,0,0,0,0,0,0,0,0,0
20200520,049667,大立光國泰96購01,,,,,0.00,0.00,0,0,0,0,0,0,0,0,0,0,0,0,0
20200520,049668,大立光國泰96購02,,,,,0.00,0.00,0,0,0,0,0,0,0,0,0,0,0,0,0
20200520,049670,鈺齊國泰96購01,,,,,0.00,0.00,0,0,0,0,0,0,0,0,0,0,0,0,0
20200520,049695,新光金元大9A購01,,,,,0.00,0.00,0,0,0,0,0,0,0,0,0,0,0,0,0
20200520,049697,群創元大98購01,0.08,0.08,0.08,0.08,0.00,0.00,60000,1,4800,0,0,0,0,0,0,60000,0,60000,60000
20200520,049700,瀚宇博元大97購01,1.41,1.42,1.39,1.41,-0.02,-1.4,275000,7,386840,0,0,0,0,0,0,137000,138000,-1000,-1000
20200520,049726,道瓊反中信96購01,,,,,0.00,0.00,0,0,0,0,0,0,0,0,0,0,0,0,0
20200520,04974P,聯發科凱基96售02,,,,,0.00,0.00,0,0,0,0,0,0,0,0,0,0,0,0,0
20200520,049759,元黃金富邦9A購01,4.10,4.22,4.10,4.22,+0.27,6.84,5000,4,20840,0,0,0,0,0,0,2000,3000,-1000,-1000
20200520,04975P,華新科凱基96售02,,,,,0.00,0.00,0,0,0,0,0,0,0,0,0,0,0,0,0
20200520,049763,美食國泰96購01,0.01,0.01,0.01,0.01,0.00,0.00,50000,1,500,0,0,0,0,0,0,50000,0,50000,50000
20200520,049769,和鑫元富96購01,,,,,0.00,0.00,0,0,0,0,0,0,0,0,0,0,0,0,0
20200520,04977P,力成凱基96售01,,,,,0.00,0.00,0,0,0,0,0,0,0,0,0,0,0,0,0
20200520,049790,滬深2X元大97購04,,,,,0.00,0.00,0,0,0,0,0,0,0,0,0,0,0,0,0
20200520,049795,華通元大96購02,0.07,0.08,0.07,0.08,-0.02,-20.0,134000,5,9400,0,0,0,0,0,0,114000,0,114000,114000
20200520,049799,旺宏元大96購01,,,,,0.00,0.00,0,0,0,0,0,0,0,0,0,0,0,0,0
20200520,04979P,臺股指凱基96售07,,,,,0.00,0.00,0,0,0,0,0,0,0,0,0,0,0,0,0
20200520,049807,新光金元大96購02,,,,,0.00,0.00,0,0,0,0,0,0,0,0,0,0,0,0,0
20200520,04980P,臺股指凱基96售08,,,,,0.00,0.00,0,0,0,0,0,0,0,0,0,0,0,0,0
20200520,049813,康控元大96購02,,,,,0.00,0.00,0,0,0,0,0,0,0,0,0,0,0,0,0
20200520,049820,世紀鋼元大96購03,0.71,0.71,0.71,0.71,0.00,0.00,5000,1,3550,0,0,0,0,0,0,0,5000,-5000,-5000
20200520,049837,臺股指凱基96購02,,,,,0.00,0.00,0,0,0,0,0,0,0,0,0,0,0,0,0
20200520,049842,道瓊反中信98購01,1.71,1.71,1.71,1.71,0.00,0.00,30000,1,51300,0,0,0,0,0,0,30000,0,30000,30000
20200520,049871,T50反1台新9A購02,,,,,0.00,0.00,0,0,0,0,0,0,0,0,0,0,0,0,0
20200520,049888,智邦國泰96購01,,,,,0.00,0.00,0,0,0,0,0,0,0,0,0,0,0,0,0
20200520,049889,欣興國泰96購01,,,,,0.00,0.00,0,0,0,0,0,0,0,0,0,0,0,0,0
20200520,049892,國巨富邦96購01,1.08,1.12,0.99,1.00,+0.12,13.64,25000,4,26550,0,0,0,0,0,0,5000,15000,-10000,-10000
20200520,049893,日月光富邦98購01,,,,,0.00,0.00,0,0,0,0,0,0,0,0,0,0,0,0,0
20200520,049894,嘉聯益富邦98購01,,,,,0.00,0.00,0,0,0,0,0,0,0,0,0,0,0,0,0
20200520,04992P,元油2X富邦97售04,,,,,0.00,0.00,0,0,0,0,0,0,0,0,0,0,0,0,0
20200520,04993P,上銀兆豐96售01,,,,,0.00,0.00,0,0,0,0,0,0,0,0,0,0,0,0,0
20200520,049947,S&P反1中信97購01,0.80,0.80,0.80,0.80,0.00,0.00,1000,1,800,0,0,0,0,0,0,1000,0,1000,1000
20200520,049949,燿華群益96購01,,,,,0.00,0.00,0,0,0,0,0,0,0,0,0,0,0,0,0
20200520,04995P,台達電凱基96售03,,,,,0.00,0.00,0,0,0,0,0,0,0,0,0,0,0,0,0
20200520,049973,T50反1日盛9A購01,,,,,0.00,0.00,0,0,0,0,0,0,0,0,0,0,0,0,0
20200520,049991,臺股指凱基96購04,,,,,0.00,0.00,0,0,0,0,0,0,0,0,0,0,0,0,0
20200520,050014,國巨富邦98購01,1.80,1.95,1.80,1.80,+0.12,7.14,111000,19,207710,0,0,0,0,0,0,12000,34000,-22000,-22000
20200520,050026,友達元大96購01,,,,,0.00,0.00,0,0,0,0,0,0,0,0,0,0,0,0,0
20200520,050049,華通群益96購01,,,,,0.00,0.00,0,0,0,0,0,0,0,0,0,0,0,0,0
20200520,050077,臺股指凱基99購02,,,,,0.00,0.00,0,0,0,0,0,0,0,0,0,0,0,0,0
20200520,050078,臺指反統一97購01,,,,,0.00,0.00,0,0,0,0,0,0,0,0,0,0,0,0,0
20200520,050097,可成國泰96購02,,,,,0.00,0.00,0,0,0,0,0,0,0,0,0,0,0,0,0
20200520,050099,台積電永昌96購01,1.02,1.02,1.02,1.02,0.00,0.00,10000,1,10200,0,0,0,0,0,0,10000,0,10000,10000
20200520,050100,台積電永昌96購02,,,,,0.00,0.00,0,0,0,0,0,0,0,0,0,0,0,0,0
20200520,050101,台積電永昌96購03,,,,,0.00,0.00,0,0,0,0,0,0,0,0,0,0,0,0,0
20200520,050104,元石油元大97購02,,,,,0.00,0.00,0,0,0,0,0,0,0,0,0,0,0,0,0
20200520,050115,群創元大96購01,,,,,0.00,0.00,0,0,0,0,0,0,0,0,0,0,0,0,0
20200520,050117,麗豐元大96購02,,,,,0.00,0.00,0,0,0,0,0,0,0,0,0,0,0,0,0
20200520,05011P,南電國泰96售01,,,,,0.00,0.00,0,0,0,0,0,0,0,0,0,0,0,0,0
20200520,050122,臺指反凱基96購01,,,,,0.00,0.00,0,0,0,0,0,0,0,0,0,0,0,0,0
20200520,050123,群臺反凱基96購01,,,,,0.00,0.00,0,0,0,0,0,0,0,0,0,0,0,0,0
20200520,050124,元金2X凱基95購01,,,,,0.00,0.00,0,0,0,0,0,0,0,0,0,0,0,0,0
20200520,050135,禾伸堂兆豐95購01,1.08,1.08,1.08,1.08,+0.05,4.85,30000,2,32400,0,0,0,0,0,0,30000,0,30000,30000
20200520,050137,臺指反國票96購01,,,,,0.00,0.00,0,0,0,0,0,0,0,0,0,0,0,0,0
20200520,050138,台表科國票95購02,,,,,0.00,0.00,0,0,0,0,0,0,0,0,0,0,0,0,0
20200520,05013P,台積電元大96售05,0.40,0.40,0.40,0.40,0.00,0.00,11000,1,4400,0,0,0,0,0,0,0,11000,-11000,-11000
20200520,050142,聯發科元富9A購01,2.10,2.34,2.08,2.14,+0.13,6.47,425000,34,909560,0,0,0,0,0,0,404000,0,404000,404000
20200520,050144,宏達電台新95購01,,,,,0.00,0.00,0,0,0,0,0,0,0,0,0,0,0,0,0
20200520,050150,國巨群益95購01,0.15,0.15,0.15,0.15,0.00,0.00,8000,1,1200,0,0,0,0,0,0,8000,0,8000,8000
20200520,050155,華新科群益95購01,,,,,0.00,0.00,0,0,0,0,0,0,0,0,0,0,0,0,0
20200520,050158,上海銀群益96購01,,,,,0.00,0.00,0,0,0,0,0,0,0,0,0,0,0,0,0
20200520,050160,中石化國泰95購01,,,,,0.00,0.00,0,0,0,0,0,0,0,0,0,0,0,0,0
20200520,050161,鴻海國泰96購03,,,,,0.00,0.00,0,0,0,0,0,0,0,0,0,0,0,0,0
20200520,050162,中環國泰95購01,,,,,0.00,0.00,0,0,0,0,0,0,0,0,0,0,0,0,0
20200520,050163,群創國泰95購01,0.01,0.01,0.01,0.01,0.00,0.00,5000,1,50,0,0,0,0,0,0,5000,0,5000,5000
20200520,050164,揚明光國泰95購01,,,,,0.00,0.00,0,0,0,0,0,0,0,0,0,0,0,0,0
20200520,050165,泰鼎國泰95購02,,,,,0.00,0.00,0,0,0,0,0,0,0,0,0,0,0,0,0
20200520,050166,彩晶國泰95購01,,,,,0.00,0.00,0,0,0,0,0,0,0,0,0,0,0,0,0
20200520,050167,T50反1富邦96購01,,,,,0.00,0.00,0,0,0,0,0,0,0,0,0,0,0,0,0
20200520,050168,緯創富邦95購01,,,,,0.00,0.00,0,0,0,0,0,0,0,0,0,0,0,0,0
20200520,050169,臺指反元大97購01,,,,,0.00,0.00,0,0,0,0,0,0,0,0,0,0,0,0,0
20200520,050170,臺指反元大97購02,0.72,0.74,0.71,0.72,-0.03,-4.0,388000,13,280980,0,0,0,0,0,0,43000,345000,-302000,-302000
20200520,050171,臺指反元大97購03,1.10,1.12,1.10,1.12,-0.04,-3.45,40000,3,44400,0,0,0,0,0,0,30000,10000,20000,20000
20200520,050172,臺指反元大98購02,,,,,0.00,0.00,0,0,0,0,0,0,0,0,0,0,0,0,0
20200520,050173,旺宏元大96購02,,,,,0.00,0.00,0,0,0,0,0,0,0,0,0,0,0,0,0
20200520,050179,全新元大96購02,,,,,0.00,0.00,0,0,0,0,0,0,0,0,0,0,0,0,0
20200520,050180,華新科元大95購08,0.16,0.16,0.16,0.16,0.00,0.00,10000,1,1600,0,0,0,0,0,0,10000,0,10000,10000
20200520,050183,奇鋐元大96購01,0.16,0.16,0.16,0.16,0.00,0.00,11000,1,1760,0,0,0,0,0,0,11000,0,11000,11000
20200520,050185,和鑫元大95購02,,,,,0.00,0.00,0,0,0,0,0,0,0,0,0,0,0,0,0
20200520,050188,貿聯元大96購01,,,,,0.00,0.00,0,0,0,0,0,0,0,0,0,0,0,0,0
20200520,050190,麗豐元大95購02,,,,,0.00,0.00,0,0,0,0,0,0,0,0,0,0,0,0,0
20200520,050192,康控元大97購01,,,,,0.00,0.00,0,0,0,0,0,0,0,0,0,0,0,0,0
20200520,050196,嘉聯益元大97購01,,,,,0.00,0.00,0,0,0,0,0,0,0,0,0,0,0,0,0
20200520,050202,建準群益95購01,,,,,0.00,0.00,0,0,0,0,0,0,0,0,0,0,0,0,0
20200520,050207,百和群益95購01,,,,,0.00,0.00,0,0,0,0,0,0,0,0,0,0,0,0,0
20200520,050208,燿華兆豐95購02,,,,,0.00,0.00,0,0,0,0,0,0,0,0,0,0,0,0,0
20200520,050209,華通國票95購01,,,,,0.00,0.00,0,0,0,0,0,0,0,0,0,0,0,0,0
20200520,050211,貿聯國票95購01,,,,,0.00,0.00,0,0,0,0,0,0,0,0,0,0,0,0,0
20200520,050212,瀚宇博國票95購02,,,,,0.00,0.00,0,0,0,0,0,0,0,0,0,0,0,0,0
20200520,050215,TPK台新96購01,,,,,0.00,0.00,0,0,0,0,0,0,0,0,0,0,0,0,0
20200520,050219,台積電元富95購03,0.20,0.21,0.20,0.21,0.00,0.00,15000,2,3050,0,0,0,0,0,0,15000,0,15000,15000
20200520,050220,台積電元富96購01,0.12,0.12,0.12,0.12,0.00,0.00,30000,11,3600,0,0,0,0,0,0,0,0,0,0
20200520,050227,大立光中信96購01,0.05,0.05,0.05,0.05,0.00,0.00,263000,1,13150,0,0,0,0,0,0,263000,0,263000,263000
20200520,050228,中磊中信96購01,,,,,0.00,0.00,0,0,0,0,0,0,0,0,0,0,0,0,0
20200520,050232,奇鋐麥證95購01,,,,,0.00,0.00,0,0,0,0,0,0,0,0,0,0,0,0,0
20200520,050233,香港2X凱基96購01,,,,,0.00,0.00,0,0,0,0,0,0,0,0,0,0,0,0,0
20200520,05024P,華通國票96售01,0.43,0.47,0.41,0.47,+0.03,6.82,20000,11,8740,0,0,0,0,0,0,8000,12000,-4000,-4000
20200520,050252,聯發科國泰95購01,8.50,8.50,8.50,8.50,+0.65,8.28,63000,2,535500,0,0,0,0,0,0,63000,61000,2000,2000
20200520,050253,百和國泰96購01,,,,,0.00,0.00,0,0,0,0,0,0,0,0,0,0,0,0,0
20200520,050254,大立光富邦96購02,,,,,0.00,0.00,0,0,0,0,0,0,0,0,0,0,0,0,0
20200520,050255,GIS富邦95購01,,,,,0.00,0.00,0,0,0,0,0,0,0,0,0,0,0,0,0
20200520,050256,臺指反元大98購03,,,,,0.00,0.00,0,0,0,0,0,0,0,0,0,0,0,0,0
20200520,050261,國巨元大95購04,0.31,0.38,0.31,0.38,+0.13,52.0,13000,2,4660,0,0,0,0,0,0,13000,0,13000,13000
20200520,050268,智原元大95購03,,,,,0.00,0.00,0,0,0,0,0,0,0,0,0,0,0,0,0
20200520,050271,上緯控元大96購01,,,,,0.00,0.00,0,0,0,0,0,0,0,0,0,0,0,0,0
20200520,050282,T50反1凱基97購01,,,,,0.00,0.00,0,0,0,0,0,0,0,0,0,0,0,0,0
20200520,050283,T50反1凱基9A購01,,,,,0.00,0.00,0,0,0,0,0,0,0,0,0,0,0,0,0
20200520,050303,S&P反1中信96購01,,,,,0.00,0.00,0,0,0,0,0,0,0,0,0,0,0,0,0
20200520,050305,正崴中信95購01,,,,,0.00,0.00,0,0,0,0,0,0,0,0,0,0,0,0,0
20200520,050306,聯發科中信97購01,1.75,1.95,1.75,1.80,+0.19,11.8,16000,6,30150,0,0,0,0,0,0,5000,0,5000,5000
20200520,050307,欣興中信95購01,,,,,0.00,0.00,0,0,0,0,0,0,0,0,0,0,0,0,0
20200520,050308,矽創中信97購01,,,,,0.00,0.00,0,0,0,0,0,0,0,0,0,0,0,0,0
20200520,050311,上銀兆豐95購01,1.02,1.02,1.02,1.02,0.00,0.00,1000,1,1020,0,0,0,0,0,0,1000,0,1000,1000
20200520,050315,和碩兆豐95購01,0.10,0.10,0.10,0.10,0.00,0.00,10000,1,1000,0,0,0,0,0,0,10000,0,10000,10000
20200520,050316,上証2X國票98購01,,,,,0.00,0.00,0,0,0,0,0,0,0,0,0,0,0,0,0
20200520,050317,和鑫國票95購02,,,,,0.00,0.00,0,0,0,0,0,0,0,0,0,0,0,0,0
20200520,050319,康控國票95購04,,,,,0.00,0.00,0,0,0,0,0,0,0,0,0,0,0,0,0
20200520,050321,GIS國票95購02,,,,,0.00,0.00,0,0,0,0,0,0,0,0,0,0,0,0,0
20200520,050322,世紀鋼國票95購01,,,,,0.00,0.00,0,0,0,0,0,0,0,0,0,0,0,0,0
20200520,05032P,台積電國泰96售05,,,,,0.00,0.00,0,0,0,0,0,0,0,0,0,0,0,0,0
20200520,050332,鴻海國泰96購05,,,,,0.00,0.00,0,0,0,0,0,0,0,0,0,0,0,0,0
20200520,050333,鴻海國泰96購06,,,,,0.00,0.00,0,0,0,0,0,0,0,0,0,0,0,0,0
20200520,050334,鴻海國泰96購07,,,,,0.00,0.00,0,0,0,0,0,0,0,0,0,0,0,0,0
20200520,050335,正崴國泰96購01,,,,,0.00,0.00,0,0,0,0,0,0,0,0,0,0,0,0,0
20200520,050337,南電國泰95購01,,,,,0.00,0.00,0,0,0,0,0,0,0,0,0,0,0,0,0
20200520,050338,TPK富邦96購01,,,,,0.00,0.00,0,0,0,0,0,0,0,0,0,0,0,0,0
20200520,05033P,T50反1元大98售01,,,,,0.00,0.00,0,0,0,0,0,0,0,0,0,0,0,0,0
20200520,050344,鴻海元富96購01,,,,,0.00,0.00,0,0,0,0,0,0,0,0,0,0,0,0,0
20200520,050347,上証2X群益98購01,,,,,0.00,0.00,0,0,0,0,0,0,0,0,0,0,0,0,0
20200520,050351,華新科群益95購02,,,,,0.00,0.00,0,0,0,0,0,0,0,0,0,0,0,0,0
20200520,050352,欣興群益95購01,,,,,0.00,0.00,0,0,0,0,0,0,0,0,0,0,0,0,0
20200520,050353,華擎群益95購01,,,,,0.00,0.00,0,0,0,0,0,0,0,0,0,0,0,0,0
20200520,050363,臺指反元大98購04,,,,,0.00,0.00,0,0,0,0,0,0,0,0,0,0,0,0,0
20200520,050372,全新元大96購03,,,,,0.00,0.00,0,0,0,0,0,0,0,0,0,0,0,0,0
20200520,050374,上緯控元大95購01,0.04,0.04,0.03,0.03,-0.01,-25.0,20000,2,700,0,0,0,0,0,0,20000,0,20000,20000
20200520,050376,百和元大95購01,,,,,0.00,0.00,0,0,0,0,0,0,0,0,0,0,0,0,0
20200520,050378,上証2X群益98購02,,,,,0.00,0.00,0,0,0,0,0,0,0,0,0,0,0,0,0
20200520,050379,易華電群益96購01,,,,,0.00,0.00,0,0,0,0,0,0,0,0,0,0,0,0,0
20200520,050382,TPK兆豐95購02,,,,,0.00,0.00,0,0,0,0,0,0,0,0,0,0,0,0,0
20200520,050383,超眾兆豐95購01,,,,,0.00,0.00,0,0,0,0,0,0,0,0,0,0,0,0,0
20200520,050385,貿聯國票95購02,,,,,0.00,0.00,0,0,0,0,0,0,0,0,0,0,0,0,0
20200520,050389,鴻海統一95購04,,,,,0.00,0.00,0,0,0,0,0,0,0,0,0,0,0,0,0
20200520,050392,群創統一96購01,,,,,0.00,0.00,0,0,0,0,0,0,0,0,0,0,0,0,0
20200520,050398,上証2X中信97購01,,,,,0.00,0.00,0,0,0,0,0,0,0,0,0,0,0,0,0
20200520,050399,潤泰全中信95購01,,,,,0.00,0.00,0,0,0,0,0,0,0,0,0,0,0,0,0
20200520,050400,臻鼎中信97購01,0.02,0.02,0.02,0.02,0.00,0.00,50000,1,1000,0,0,0,0,0,0,0,0,0,0
20200520,050402,緯穎中信96購01,,,,,0.00,0.00,0,0,0,0,0,0,0,0,0,0,0,0,0
20200520,050406,台積電台新95購02,,,,,0.00,0.00,0,0,0,0,0,0,0,0,0,0,0,0,0
20200520,050410,燿華永豐95購03,,,,,0.00,0.00,0,0,0,0,0,0,0,0,0,0,0,0,0
20200520,050416,高股息凱基96購02,0.03,0.03,0.03,0.03,0.00,0.00,110000,2,3300,0,0,0,0,0,0,110000,0,110000,110000
20200520,050419,鴻海凱基95購02,,,,,0.00,0.00,0,0,0,0,0,0,0,0,0,0,0,0,0
20200520,050420,鴻海凱基95購03,,,,,0.00,0.00,0,0,0,0,0,0,0,0,0,0,0,0,0
20200520,050421,鴻海凱基95購04,,,,,0.00,0.00,0,0,0,0,0,0,0,0,0,0,0,0,0
20200520,050422,鴻海凱基96購01,,,,,0.00,0.00,0,0,0,0,0,0,0,0,0,0,0,0,0
20200520,050423,鴻海凱基96購02,,,,,0.00,0.00,0,0,0,0,0,0,0,0,0,0,0,0,0
20200520,050424,鴻海凱基96購03,,,,,0.00,0.00,0,0,0,0,0,0,0,0,0,0,0,0,0
20200520,050449,宏達電元大95購03,,,,,0.00,0.00,0,0,0,0,0,0,0,0,0,0,0,0,0
20200520,050451,嘉晶元大95購01,1.51,1.63,1.51,1.63,0.00,0.00,8000,2,12920,0,0,0,0,0,0,8000,0,8000,8000
20200520,050452,智原元大95購04,,,,,0.00,0.00,0,0,0,0,0,0,0,0,0,0,0,0,0
20200520,050453,創意元大95購03,,,,,0.00,0.00,0,0,0,0,0,0,0,0,0,0,0,0,0
20200520,050460,GIS元大95購03,,,,,0.00,0.00,0,0,0,0,0,0,0,0,0,0,0,0,0
20200520,050461,GIS元大95購04,,,,,0.00,0.00,0,0,0,0,0,0,0,0,0,0,0,0,0
20200520,050464,華通國泰95購01,,,,,0.00,0.00,0,0,0,0,0,0,0,0,0,0,0,0,0
20200520,050475,揚明光永豐95購01,,,,,0.00,0.00,0,0,0,0,0,0,0,0,0,0,0,0,0
20200520,050479,上証2X國票95購02,,,,,0.00,0.00,0,0,0,0,0,0,0,0,0,0,0,0,0
20200520,050480,健策國票95購04,,,,,0.00,0.00,0,0,0,0,0,0,0,0,0,0,0,0,0
20200520,050481,泰鼎國票96購01,,,,,0.00,0.00,0,0,0,0,0,0,0,0,0,0,0,0,0
20200520,050484,世紀鋼國票95購02,1.12,1.12,1.12,1.12,-0.03,-2.61,30000,1,33600,0,0,0,0,0,0,30000,0,30000,30000
20200520,050485,國巨統一96購01,2.19,2.80,2.19,2.33,+0.44,23.28,462000,47,1104500,0,0,0,0,0,0,442000,462000,-20000,-20000
20200520,050490,上証2X國泰95購01,,,,,0.00,0.00,0,0,0,0,0,0,0,0,0,0,0,0,0
20200520,050491,旺宏國泰96購01,,,,,0.00,0.00,0,0,0,0,0,0,0,0,0,0,0,0,0
20200520,050492,漢唐國泰96購01,,,,,0.00,0.00,0,0,0,0,0,0,0,0,0,0,0,0,0
20200520,050493,聯發科永昌96購01,2.43,3.20,2.40,2.40,+0.14,6.19,81000,19,215600,0,0,0,0,0,0,41000,40000,1000,1000
20200520,050494,可成永昌96購01,,,,,0.00,0.00,0,0,0,0,0,0,0,0,0,0,0,0,0
20200520,050495,大立光永昌96購01,,,,,0.00,0.00,0,0,0,0,0,0,0,0,0,0,0,0,0
20200520,050496,鴻海富邦96購01,0.06,0.06,0.05,0.05,-0.02,-28.57,6000,2,330,0,0,0,0,0,0,0,6000,-6000,-6000
20200520,050497,臺指反凱基96購02,,,,,0.00,0.00,0,0,0,0,0,0,0,0,0,0,0,0,0
20200520,050508,上証2X元大97購01,,,,,0.00,0.00,0,0,0,0,0,0,0,0,0,0,0,0,0
20200520,05050P,華通群益96售02,,,,,0.00,0.00,0,0,0,0,0,0,0,0,0,0,0,0,0
20200520,050515,聯電元大96購01,0.49,0.49,0.42,0.42,-0.03,-6.67,115000,5,55090,0,0,0,0,0,0,97000,18000,79000,79000
20200520,050516,華通元大95購05,,,,,0.00,0.00,0,0,0,0,0,0,0,0,0,0,0,0,0
20200520,050519,旺宏元大95購03,,,,,0.00,0.00,0,0,0,0,0,0,0,0,0,0,0,0,0
20200520,050522,聯發科元大95購03,,,,,0.00,0.00,0,0,0,0,0,0,0,0,0,0,0,0,0
20200520,050524,宏達電元大95購04,,,,,0.00,0.00,0,0,0,0,0,0,0,0,0,0,0,0,0
20200520,050525,嘉晶元大95購02,0.14,0.19,0.14,0.19,0.00,0.00,550000,8,82000,0,0,0,0,0,0,400000,550000,-150000,-150000
20200520,050526,貿聯元大95購01,,,,,0.00,0.00,0,0,0,0,0,0,0,0,0,0,0,0,0
20200520,050527,嘉聯益元大96購01,,,,,0.00,0.00,0,0,0,0,0,0,0,0,0,0,0,0,0
20200520,05052P,友達群益97售01,0.42,0.45,0.41,0.44,0.00,0.00,142000,10,59880,0,0,0,0,0,0,102000,40000,62000,62000
20200520,050530,台表科元大95購04,1.20,1.20,1.20,1.20,0.00,0.00,5000,1,6000,0,0,0,0,0,0,5000,0,5000,5000
20200520,050531,訊芯元大95購02,,,,,0.00,0.00,0,0,0,0,0,0,0,0,0,0,0,0,0
20200520,050536,亞泥凱基95購01,,,,,0.00,0.00,0,0,0,0,0,0,0,0,0,0,0,0,0
20200520,050537,鴻海凱基95購05,,,,,0.00,0.00,0,0,0,0,0,0,0,0,0,0,0,0,0
20200520,050538,鴻海凱基95購06,,,,,0.00,0.00,0,0,0,0,0,0,0,0,0,0,0,0,0
20200520,050539,鴻海凱基95購07,,,,,0.00,0.00,0,0,0,0,0,0,0,0,0,0,0,0,0
20200520,050542,宏碁凱基95購01,,,,,0.00,0.00,0,0,0,0,0,0,0,0,0,0,0,0,0
20200520,050543,聯發科凱基95購01,,,,,0.00,0.00,0,0,0,0,0,0,0,0,0,0,0,0,0
20200520,050544,聯發科凱基95購02,,,,,0.00,0.00,0,0,0,0,0,0,0,0,0,0,0,0,0
20200520,050545,奇力新凱基95購01,,,,,0.00,0.00,0,0,0,0,0,0,0,0,0,0,0,0,0
20200520,050547,華新科凱基95購01,,,,,0.00,0.00,0,0,0,0,0,0,0,0,0,0,0,0,0
20200520,050548,華固凱基95購01,,,,,0.00,0.00,0,0,0,0,0,0,0,0,0,0,0,0,0
20200520,050549,慧洋凱基95購01,,,,,0.00,0.00,0,0,0,0,0,0,0,0,0,0,0,0,0
20200520,050550,大立光凱基95購04,,,,,0.00,0.00,0,0,0,0,0,0,0,0,0,0,0,0,0
20200520,050551,大立光凱基95購05,,,,,0.00,0.00,0,0,0,0,0,0,0,0,0,0,0,0,0
20200520,050554,百和凱基95購01,,,,,0.00,0.00,0,0,0,0,0,0,0,0,0,0,0,0,0
20200520,050556,道瓊銀統一95購01,,,,,0.00,0.00,0,0,0,0,0,0,0,0,0,0,0,0,0
20200520,050561,上証2X元富97購01,,,,,0.00,0.00,0,0,0,0,0,0,0,0,0,0,0,0,0
20200520,050566,高股息中信97購02,,,,,0.00,0.00,0,0,0,0,0,0,0,0,0,0,0,0,0
20200520,050567,道瓊銀中信96購01,0.13,0.13,0.13,0.13,0.00,0.00,50000,1,6500,0,0,0,0,0,0,50000,50000,0,0
20200520,050568,為升中信97購01,0.01,0.01,0.01,0.01,0.00,0.00,12000,2,120,0,0,0,0,0,0,12000,0,12000,12000
20200520,050570,聯發科中信97購02,0.59,0.66,0.51,0.61,+0.03,5.17,457000,33,251190,0,0,0,0,0,0,327000,0,327000,327000
20200520,050571,美食中信95購01,,,,,0.00,0.00,0,0,0,0,0,0,0,0,0,0,0,0,0
20200520,050572,大立光中信97購01,,,,,0.00,0.00,0,0,0,0,0,0,0,0,0,0,0,0,0
20200520,050576,南亞科國票95購01,,,,,0.00,0.00,0,0,0,0,0,0,0,0,0,0,0,0,0
20200520,050578,聯發科國票95購03,,,,,0.00,0.00,0,0,0,0,0,0,0,0,0,0,0,0,0
20200520,050579,聯發科國票95購04,,,,,0.00,0.00,0,0,0,0,0,0,0,0,0,0,0,0,0
20200520,05057P,鴻海國票96售01,2.12,2.12,2.12,2.12,+0.03,1.44,1000,1,2120,0,0,0,0,0,0,1000,0,1000,1000
20200520,050580,強茂國票95購01,,,,,0.00,0.00,0,0,0,0,0,0,0,0,0,0,0,0,0
20200520,050584,瑞儀國票95購01,,,,,0.00,0.00,0,0,0,0,0,0,0,0,0,0,0,0,0
20200520,050588,矽創國票95購01,,,,,0.00,0.00,0,0,0,0,0,0,0,0,0,0,0,0,0
20200520,05058P,燿華國票97售01,,,,,0.00,0.00,0,0,0,0,0,0,0,0,0,0,0,0,0
20200520,050590,晶技永豐95購01,,,,,0.00,0.00,0,0,0,0,0,0,0,0,0,0,0,0,0
20200520,05059P,大立光國票96售02,1.33,1.33,1.33,1.33,-0.05,-3.62,1000,1,1330,0,0,0,0,0,0,1000,0,1000,1000
20200520,050600,瑞儀國泰95購01,,,,,0.00,0.00,0,0,0,0,0,0,0,0,0,0,0,0,0
20200520,050601,台表科國泰96購01,1.45,2.20,1.32,1.94,+0.60,44.78,145000,28,252600,0,0,0,0,0,0,73000,30000,43000,43000
20200520,050602,訊芯國泰96購01,,,,,0.00,0.00,0,0,0,0,0,0,0,0,0,0,0,0,0
20200520,050603,致新國泰96購01,0.85,0.85,0.85,0.85,0.00,0.00,10000,1,8500,0,0,0,0,0,0,10000,0,10000,10000
20200520,050605,上証2X元大97購02,,,,,0.00,0.00,0,0,0,0,0,0,0,0,0,0,0,0,0
20200520,05060P,台達電富邦97售02,,,,,0.00,0.00,0,0,0,0,0,0,0,0,0,0,0,0,0
20200520,050611,鴻海元大95購02,,,,,0.00,0.00,0,0,0,0,0,0,0,0,0,0,0,0,0
20200520,050612,台積電元大95購06,,,,,0.00,0.00,0,0,0,0,0,0,0,0,0,0,0,0,0
20200520,050614,聯發科元大95購04,2.00,2.35,2.00,2.23,+0.40,21.86,14000,4,30520,0,0,0,0,0,0,5000,3000,2000,2000
20200520,050615,奇力新元大95購03,,,,,0.00,0.00,0,0,0,0,0,0,0,0,0,0,0,0,0
20200520,050618,緯創元大95購01,,,,,0.00,0.00,0,0,0,0,0,0,0,0,0,0,0,0,0
20200520,050619,TPK元大95購02,,,,,0.00,0.00,0,0,0,0,0,0,0,0,0,0,0,0,0
20200520,05061P,鴻海富邦96售03,,,,,0.00,0.00,0,0,0,0,0,0,0,0,0,0,0,0,0
20200520,050621,易華電元大95購01,,,,,0.00,0.00,0,0,0,0,0,0,0,0,0,0,0,0,0
20200520,050626,A50正2中信96購02,,,,,0.00,0.00,0,0,0,0,0,0,0,0,0,0,0,0,0
20200520,050629,廣宇亞東96購01,,,,,0.00,0.00,0,0,0,0,0,0,0,0,0,0,0,0,0
20200520,05062P,大立光富邦98售03,,,,,0.00,0.00,0,0,0,0,0,0,0,0,0,0,0,0,0
20200520,050630,大立光亞東96購01,,,,,0.00,0.00,0,0,0,0,0,0,0,0,0,0,0,0,0
20200520,050633,義隆群益96購02,,,,,0.00,0.00,0,0,0,0,0,0,0,0,0,0,0,0,0
20200520,050634,華新科群益96購01,0.98,0.98,0.98,0.98,0.00,0.00,5000,1,4900,0,0,0,0,0,0,5000,0,5000,5000
20200520,050639,GIS國票96購01,,,,,0.00,0.00,0,0,0,0,0,0,0,0,0,0,0,0,0
20200520,05063P,聯電元大96售03,0.10,0.10,0.10,0.10,0.00,0.00,60000,1,6000,0,0,0,0,0,0,60000,0,60000,60000
20200520,050641,上証反凱基96購01,0.35,0.35,0.35,0.35,0.00,0.00,200000,2,70000,0,0,0,0,0,0,0,200000,-200000,-200000
20200520,050644,國巨凱基96購01,,,,,0.00,0.00,0,0,0,0,0,0,0,0,0,0,0,0,0
20200520,050646,美律凱基96購01,,,,,0.00,0.00,0,0,0,0,0,0,0,0,0,0,0,0,0
20200520,050647,聯發科凱基96購01,,,,,0.00,0.00,0,0,0,0,0,0,0,0,0,0,0,0,0
20200520,050648,全新凱基96購01,,,,,0.00,0.00,0,0,0,0,0,0,0,0,0,0,0,0,0
20200520,050649,華新科凱基96購01,,,,,0.00,0.00,0,0,0,0,0,0,0,0,0,0,0,0,0
20200520,050650,大立光凱基96購01,,,,,0.00,0.00,0,0,0,0,0,0,0,0,0,0,0,0,0
20200520,050651,大立光凱基96購02,,,,,0.00,0.00,0,0,0,0,0,0,0,0,0,0,0,0,0
20200520,050652,大立光凱基96購03,,,,,0.00,0.00,0,0,0,0,0,0,0,0,0,0,0,0,0
20200520,050653,聯鈞凱基96購01,,,,,0.00,0.00,0,0,0,0,0,0,0,0,0,0,0,0,0
20200520,050654,鎧勝凱基96購01,,,,,0.00,0.00,0,0,0,0,0,0,0,0,0,0,0,0,0
20200520,050655,中磊凱基96購01,,,,,0.00,0.00,0,0,0,0,0,0,0,0,0,0,0,0,0
20200520,050656,瑞儀凱基96購01,,,,,0.00,0.00,0,0,0,0,0,0,0,0,0,0,0,0,0
20200520,050658,台郡麥證96購01,,,,,0.00,0.00,0,0,0,0,0,0,0,0,0,0,0,0,0
20200520,050659,宏達電元大96購01,,,,,0.00,0.00,0,0,0,0,0,0,0,0,0,0,0,0,0
20200520,05065P,燿華元大96售03,,,,,0.00,0.00,0,0,0,0,0,0,0,0,0,0,0,0,0
20200520,050660,欣興元大96購02,,,,,0.00,0.00,0,0,0,0,0,0,0,0,0,0,0,0,0
20200520,050662,智易元大96購01,,,,,0.00,0.00,0,0,0,0,0,0,0,0,0,0,0,0,0
20200520,050663,麗豐元大96購03,,,,,0.00,0.00,0,0,0,0,0,0,0,0,0,0,0,0,0
20200520,050669,嘉晶永豐96購01,,,,,0.00,0.00,0,0,0,0,0,0,0,0,0,0,0,0,0
20200520,050672,上証2X富邦97購01,,,,,0.00,0.00,0,0,0,0,0,0,0,0,0,0,0,0,0
20200520,050673,旺宏富邦96購02,0.55,0.55,0.55,0.55,0.00,0.00,10000,1,5500,0,0,0,0,0,0,0,10000,-10000,-10000
20200520,050675,奇鋐富邦96購01,,,,,0.00,0.00,0,0,0,0,0,0,0,0,0,0,0,0,0
20200520,050676,道瓊銀統一96購02,,,,,0.00,0.00,0,0,0,0,0,0,0,0,0,0,0,0,0
20200520,050679,上証2X元富97購02,,,,,0.00,0.00,0,0,0,0,0,0,0,0,0,0,0,0,0
20200520,05067P,欣興兆豐96售02,,,,,0.00,0.00,0,0,0,0,0,0,0,0,0,0,0,0,0
20200520,050686,欣興兆豐96購01,,,,,0.00,0.00,0,0,0,0,0,0,0,0,0,0,0,0,0
20200520,050690,台達電凱基96購01,,,,,0.00,0.00,0,0,0,0,0,0,0,0,0,0,0,0,0
20200520,050691,楠梓電凱基96購01,,,,,0.00,0.00,0,0,0,0,0,0,0,0,0,0,0,0,0
20200520,050692,鴻海凱基96購04,,,,,0.00,0.00,0,0,0,0,0,0,0,0,0,0,0,0,0
20200520,050693,鴻海凱基96購05,,,,,0.00,0.00,0,0,0,0,0,0,0,0,0,0,0,0,0
20200520,050694,國巨凱基96購03,,,,,0.00,0.00,0,0,0,0,0,0,0,0,0,0,0,0,0
20200520,050696,台光電凱基96購01,,,,,0.00,0.00,0,0,0,0,0,0,0,0,0,0,0,0,0
20200520,050697,冠德凱基96購01,,,,,0.00,0.00,0,0,0,0,0,0,0,0,0,0,0,0,0
20200520,050698,明泰凱基96購01,,,,,0.00,0.00,0,0,0,0,0,0,0,0,0,0,0,0,0
20200520,050699,京鼎凱基96購01,,,,,0.00,0.00,0,0,0,0,0,0,0,0,0,0,0,0,0
20200520,05069P,鴻海統一96售03,,,,,0.00,0.00,0,0,0,0,0,0,0,0,0,0,0,0,0
20200520,050700,健策凱基96購01,,,,,0.00,0.00,0,0,0,0,0,0,0,0,0,0,0,0,0
20200520,050705,南電凱基96購01,,,,,0.00,0.00,0,0,0,0,0,0,0,0,0,0,0,0,0
20200520,050708,臺股指凱基96購06,,,,,0.00,0.00,0,0,0,0,0,0,0,0,0,0,0,0,0
20200520,050709,嘉聯益第一96購01,,,,,0.00,0.00,0,0,0,0,0,0,0,0,0,0,0,0,0
20200520,05070P,鴻海統一96售04,,,,,0.00,0.00,0,0,0,0,0,0,0,0,0,0,0,0,0
20200520,050710,元黃金中信96購01,,,,,0.00,0.00,0,0,0,0,0,0,0,0,0,0,0,0,0
20200520,050714,深中小群益98購01,,,,,0.00,0.00,0,0,0,0,0,0,0,0,0,0,0,0,0
20200520,050715,台積電群益96購01,,,,,0.00,0.00,0,0,0,0,0,0,0,0,0,0,0,0,0
20200520,050716,可成群益96購01,,,,,0.00,0.00,0,0,0,0,0,0,0,0,0,0,0,0,0
20200520,050717,京鼎群益96購01,,,,,0.00,0.00,0,0,0,0,0,0,0,0,0,0,0,0,0
20200520,050719,世紀鋼群益96購01,,,,,0.00,0.00,0,0,0,0,0,0,0,0,0,0,0,0,0
20200520,05071P,鴻海統一96售05,,,,,0.00,0.00,0,0,0,0,0,0,0,0,0,0,0,0,0
20200520,050722,聯電國票96購01,,,,,0.00,0.00,0,0,0,0,0,0,0,0,0,0,0,0,0
20200520,050724,國巨國票96購01,,,,,0.00,0.00,0,0,0,0,0,0,0,0,0,0,0,0,0
20200520,050725,光磊國票96購01,,,,,0.00,0.00,0,0,0,0,0,0,0,0,0,0,0,0,0
20200520,050726,可成國票96購01,0.01,0.01,0.01,0.01,0.00,0.00,10000,1,100,0,0,0,0,0,0,10000,0,10000,10000
20200520,050731,昇陽半國票96購01,,,,,0.00,0.00,0,0,0,0,0,0,0,0,0,0,0,0,0
20200520,050749,道瓊銀統一96購03,,,,,0.00,0.00,0,0,0,0,0,0,0,0,0,0,0,0,0
20200520,050754,元金2X元富9B購01,1.42,1.42,1.42,1.42,+0.04,2.9,32000,3,45440,0,0,0,0,0,0,0,0,0,0
20200520,050758,聯發科元富9B購01,1.15,1.35,1.13,1.21,+0.11,10.0,210000,32,256550,0,0,0,0,0,0,178000,0,178000,178000
20200520,050765,鴻海元大96購02,,,,,0.00,0.00,0,0,0,0,0,0,0,0,0,0,0,0,0
20200520,050766,燿華元大96購02,,,,,0.00,0.00,0,0,0,0,0,0,0,0,0,0,0,0,0
20200520,050767,京元電元大96購01,,,,,0.00,0.00,0,0,0,0,0,0,0,0,0,0,0,0,0
20200520,05076P,深中小群益99售02,,,,,0.00,0.00,0,0,0,0,0,0,0,0,0,0,0,0,0
20200520,050774,健策元大96購02,0.99,0.99,0.99,0.99,0.00,0.00,60000,1,59400,0,0,0,0,0,0,0,60000,-60000,-60000
20200520,050775,TPK元大96購01,,,,,0.00,0.00,0,0,0,0,0,0,0,0,0,0,0,0,0
20200520,050776,康控元大96購03,,,,,0.00,0.00,0,0,0,0,0,0,0,0,0,0,0,0,0
20200520,050778,瑞儀元大96購01,,,,,0.00,0.00,0,0,0,0,0,0,0,0,0,0,0,0,0
20200520,050779,超眾元大96購03,,,,,0.00,0.00,0,0,0,0,0,0,0,0,0,0,0,0,0
20200520,050780,台表科元大96購01,0.53,0.53,0.53,0.53,+0.24,82.76,1000,1,530,0,0,0,0,0,0,1000,0,1000,1000
20200520,050782,台積電國泰96購03,,,,,0.00,0.00,0,0,0,0,0,0,0,0,0,0,0,0,0
20200520,050783,旺宏國泰96購02,,,,,0.00,0.00,0,0,0,0,0,0,0,0,0,0,0,0,0
20200520,050784,美律國泰96購01,,,,,0.00,0.00,0,0,0,0,0,0,0,0,0,0,0,0,0
20200520,050785,全新國泰96購01,,,,,0.00,0.00,0,0,0,0,0,0,0,0,0,0,0,0,0
20200520,050786,健策國泰96購01,,,,,0.00,0.00,0,0,0,0,0,0,0,0,0,0,0,0,0
20200520,050787,致伸國泰96購01,,,,,0.00,0.00,0,0,0,0,0,0,0,0,0,0,0,0,0
20200520,050788,台郡國泰96購01,,,,,0.00,0.00,0,0,0,0,0,0,0,0,0,0,0,0,0
20200520,050789,矽創國泰96購01,,,,,0.00,0.00,0,0,0,0,0,0,0,0,0,0,0,0,0
20200520,050790,昇陽半國泰96購02,,,,,0.00,0.00,0,0,0,0,0,0,0,0,0,0,0,0,0
20200520,050791,聯發科富邦96購01,1.48,1.48,1.48,1.48,+0.33,28.7,4000,2,5920,0,0,0,0,0,0,4000,0,4000,4000
20200520,050792,可成富邦96購01,,,,,0.00,0.00,0,0,0,0,0,0,0,0,0,0,0,0,0
20200520,050793,大立光富邦96購03,,,,,0.00,0.00,0,0,0,0,0,0,0,0,0,0,0,0,0
20200520,050794,大立光富邦96購04,,,,,0.00,0.00,0,0,0,0,0,0,0,0,0,0,0,0,0
20200520,050797,聯發科中信99購01,0.94,1.10,0.93,1.02,+0.14,15.91,272000,34,259340,0,0,0,0,0,0,257000,0,257000,257000
20200520,050798,TPK中信96購01,,,,,0.00,0.00,0,0,0,0,0,0,0,0,0,0,0,0,0
20200520,050799,嘉聯益中信98購01,,,,,0.00,0.00,0,0,0,0,0,0,0,0,0,0,0,0,0
20200520,050801,元金2X群益98購01,,,,,0.00,0.00,0,0,0,0,0,0,0,0,0,0,0,0,0
20200520,050803,康控兆豐96購01,,,,,0.00,0.00,0,0,0,0,0,0,0,0,0,0,0,0,0
20200520,050808,台達電凱基96購02,,,,,0.00,0.00,0,0,0,0,0,0,0,0,0,0,0,0,0
20200520,050813,旺宏凱基96購01,,,,,0.00,0.00,0,0,0,0,0,0,0,0,0,0,0,0,0
20200520,050829,臻鼎凱基96購01,,,,,0.00,0.00,0,0,0,0,0,0,0,0,0,0,0,0,0
20200520,050835,GIS凱基96購01,,,,,0.00,0.00,0,0,0,0,0,0,0,0,0,0,0,0,0
20200520,050838,為升國票96購01,,,,,0.00,0.00,0,0,0,0,0,0,0,0,0,0,0,0,0
20200520,050839,楠梓電國票96購01,,,,,0.00,0.00,0,0,0,0,0,0,0,0,0,0,0,0,0
20200520,050840,中環國票96購01,,,,,0.00,0.00,0,0,0,0,0,0,0,0,0,0,0,0,0
20200520,050841,國巨國票96購02,,,,,0.00,0.00,0,0,0,0,0,0,0,0,0,0,0,0,0
20200520,050842,旺宏國票97購01,1.99,2.06,1.92,1.92,-0.07,-3.52,266000,3,515410,0,0,0,0,0,0,201000,65000,136000,136000
20200520,050843,富邦金國票96購01,,,,,0.00,0.00,0,0,0,0,0,0,0,0,0,0,0,0,0
20200520,050844,大立光國票96購01,,,,,0.00,0.00,0,0,0,0,0,0,0,0,0,0,0,0,0
20200520,050846,緯創國票96購01,,,,,0.00,0.00,0,0,0,0,0,0,0,0,0,0,0,0,0
20200520,050847,創意國票96購01,,,,,0.00,0.00,0,0,0,0,0,0,0,0,0,0,0,0,0
20200520,050850,訊連國票96購01,,,,,0.00,0.00,0,0,0,0,0,0,0,0,0,0,0,0,0
20200520,050851,羅麗芬國票96購01,,,,,0.00,0.00,0,0,0,0,0,0,0,0,0,0,0,0,0
20200520,050853,南電國票96購01,0.01,0.01,0.01,0.01,-0.10,-90.91,186000,1,1860,0,0,0,0,0,0,186000,0,186000,186000
20200520,050854,世紀鋼國票97購01,0.97,0.97,0.76,0.76,0.00,0.00,66000,6,59410,0,0,0,0,0,0,40000,26000,14000,14000
20200520,05087P,GIS國泰96售01,,,,,0.00,0.00,0,0,0,0,0,0,0,0,0,0,0,0,0
20200520,050882,華泰國泰96購01,,,,,0.00,0.00,0,0,0,0,0,0,0,0,0,0,0,0,0
20200520,050883,嘉聯益國泰96購01,,,,,0.00,0.00,0,0,0,0,0,0,0,0,0,0,0,0,0
20200520,050884,聯茂國泰96購01,,,,,0.00,0.00,0,0,0,0,0,0,0,0,0,0,0,0,0
20200520,05088P,大立光富邦99售01,1.05,1.34,1.03,1.33,-0.07,-5.0,34000,9,41410,0,0,0,0,0,0,0,23000,-23000,-23000
20200520,050890,南電富邦99購01,0.67,0.67,0.55,0.58,0.00,0.00,61000,7,36650,0,0,0,0,0,0,0,61000,-61000,-61000
20200520,050892,聯電元大96購02,0.35,0.35,0.29,0.29,-0.04,-12.12,693000,12,204990,0,0,0,0,0,0,678000,15000,663000,663000
20200520,050893,鴻海元大96購03,,,,,0.00,0.00,0,0,0,0,0,0,0,0,0,0,0,0,0
20200520,050894,旺宏元大96購03,0.79,0.83,0.79,0.80,-0.04,-4.76,106000,3,85780,0,0,0,0,0,0,49000,57000,-8000,-8000
20200520,050895,聯發科元大97購01,1.85,2.08,1.77,1.77,+0.05,2.91,66000,7,125140,0,0,0,0,0,0,55000,0,55000,55000
20200520,050896,華新科元大96購02,2.00,2.00,2.00,2.00,0.00,0.00,10000,1,20000,0,0,0,0,0,0,0,10000,-10000,-10000
20200520,050898,智原元大96購01,,,,,0.00,0.00,0,0,0,0,0,0,0,0,0,0,0,0,0
20200520,050902,南電元大96購01,0.82,0.82,0.63,0.70,-0.14,-16.67,321000,10,235790,0,0,0,0,0,0,100000,221000,-121000,-121000
20200520,050911,光磊中信98購01,,,,,0.00,0.00,0,0,0,0,0,0,0,0,0,0,0,0,0
20200520,050913,全新中信97購01,,,,,0.00,0.00,0,0,0,0,0,0,0,0,0,0,0,0,0
20200520,050915,健策中信98購01,0.50,0.61,0.50,0.61,+0.07,12.96,429000,15,246780,0,0,0,0,0,0,10000,419000,-409000,-409000
20200520,050917,瀚宇博兆豐96購01,,,,,0.00,0.00,0,0,0,0,0,0,0,0,0,0,0,0,0
20200520,050932,台塑國票96購01,,,,,0.00,0.00,0,0,0,0,0,0,0,0,0,0,0,0,0
20200520,050934,喬山國票96購01,0.01,0.01,0.01,0.01,0.00,0.00,20000,1,200,0,0,0,0,0,0,20000,0,20000,20000
20200520,050935,劍麟國票96購01,,,,,0.00,0.00,0,0,0,0,0,0,0,0,0,0,0,0,0
20200520,050937,可成國票96購02,0.01,0.01,0.01,0.01,0.00,0.00,960000,2,9600,0,0,0,0,0,0,960000,0,960000,960000
20200520,050938,智原國票96購01,,,,,0.00,0.00,0,0,0,0,0,0,0,0,0,0,0,0,0
20200520,050939,健鼎國票96購01,,,,,0.00,0.00,0,0,0,0,0,0,0,0,0,0,0,0,0
20200520,050943,楠梓電群益96購01,,,,,0.00,0.00,0,0,0,0,0,0,0,0,0,0,0,0,0
20200520,050949,亞光群益96購01,,,,,0.00,0.00,0,0,0,0,0,0,0,0,0,0,0,0,0
20200520,050950,健鼎群益96購01,,,,,0.00,0.00,0,0,0,0,0,0,0,0,0,0,0,0,0
20200520,050951,緯創群益96購01,,,,,0.00,0.00,0,0,0,0,0,0,0,0,0,0,0,0,0
20200520,050952,健策群益96購01,,,,,0.00,0.00,0,0,0,0,0,0,0,0,0,0,0,0,0
20200520,050955,達方群益97購01,,,,,0.00,0.00,0,0,0,0,0,0,0,0,0,0,0,0,0
20200520,050957,T50反1台新05購01,,,,,0.00,0.00,0,0,0,0,0,0,0,0,0,0,0,0,0
20200520,050965,揚明光永豐96購01,,,,,0.00,0.00,0,0,0,0,0,0,0,0,0,0,0,0,0
20200520,050979,鴻海元富96購02,,,,,0.00,0.00,0,0,0,0,0,0,0,0,0,0,0,0,0
20200520,050982,台積電國泰96購04,,,,,0.00,0.00,0,0,0,0,0,0,0,0,0,0,0,0,0
20200520,050983,新光金國泰97購01,,,,,0.00,0.00,0,0,0,0,0,0,0,0,0,0,0,0,0
20200520,050984,大立光國泰97購01,,,,,0.00,0.00,0,0,0,0,0,0,0,0,0,0,0,0,0
20200520,050985,易華電國泰96購02,,,,,0.00,0.00,0,0,0,0,0,0,0,0,0,0,0,0,0
20200520,050986,上証2X永昌97購01,,,,,0.00,0.00,0,0,0,0,0,0,0,0,0,0,0,0,0
20200520,050991,元油2X元大96購04,,,,,0.00,0.00,0,0,0,0,0,0,0,0,0,0,0,0,0
20200520,050992,台積電元大97購01,0.45,0.45,0.45,0.45,-0.01,-2.17,5000,1,2250,0,0,0,0,0,0,0,0,0,0
20200520,050994,欣興元大96購03,,,,,0.00,0.00,0,0,0,0,0,0,0,0,0,0,0,0,0
20200520,051000,台郡元大96購01,,,,,0.00,0.00,0,0,0,0,0,0,0,0,0,0,0,0,0
20200520,051001,緯穎元大96購02,3.59,3.59,3.59,3.59,-0.28,-7.24,5000,1,17950,0,0,0,0,0,0,5000,0,5000,5000
20200520,051002,華邦電亞東96購01,,,,,0.00,0.00,0,0,0,0,0,0,0,0,0,0,0,0,0
20200520,051003,中環中信97購01,0.01,0.02,0.01,0.02,0.00,0.00,126000,11,2260,0,0,0,0,0,0,0,100000,-100000,-100000
20200520,051020,健策凱基96購02,0.46,0.46,0.46,0.46,0.00,0.00,24000,1,11040,0,0,0,0,0,0,24000,24000,0,0
20200520,051026,健策統一96購01,,,,,0.00,0.00,0,0,0,0,0,0,0,0,0,0,0,0,0
20200520,05102P,臺股指凱基96售09,,,,,0.00,0.00,0,0,0,0,0,0,0,0,0,0,0,0,0
20200520,05103P,臺股指凱基96售10,,,,,0.00,0.00,0,0,0,0,0,0,0,0,0,0,0,0,0
20200520,051047,深中小群益99購01,,,,,0.00,0.00,0,0,0,0,0,0,0,0,0,0,0,0,0
20200520,051048,臺指反群益96購01,,,,,0.00,0.00,0,0,0,0,0,0,0,0,0,0,0,0,0
20200520,051055,友達群益98購01,0.72,0.72,0.72,0.72,+0.03,4.35,62000,1,44640,0,0,0,0,0,0,62000,0,62000,62000
20200520,051058,景碩群益96購01,,,,,0.00,0.00,0,0,0,0,0,0,0,0,0,0,0,0,0
20200520,051065,台積電國票96購01,,,,,0.00,0.00,0,0,0,0,0,0,0,0,0,0,0,0,0
20200520,051066,台積電國票96購02,,,,,0.00,0.00,0,0,0,0,0,0,0,0,0,0,0,0,0
20200520,051067,台積電國票96購03,,,,,0.00,0.00,0,0,0,0,0,0,0,0,0,0,0,0,0
20200520,051068,台積電國票97購01,,,,,0.00,0.00,0,0,0,0,0,0,0,0,0,0,0,0,0
20200520,051069,智邦國票96購01,,,,,0.00,0.00,0,0,0,0,0,0,0,0,0,0,0,0,0
20200520,051070,正崴國票96購01,,,,,0.00,0.00,0,0,0,0,0,0,0,0,0,0,0,0,0
20200520,051071,聯發科國票96購01,,,,,0.00,0.00,0,0,0,0,0,0,0,0,0,0,0,0,0
20200520,051073,同欣電國票96購01,,,,,0.00,0.00,0,0,0,0,0,0,0,0,0,0,0,0,0
20200520,051074,矽力國票96購01,,,,,0.00,0.00,0,0,0,0,0,0,0,0,0,0,0,0,0
20200520,051075,智邦國泰97購01,,,,,0.00,0.00,0,0,0,0,0,0,0,0,0,0,0,0,0
20200520,051076,緯創國泰96購01,,,,,0.00,0.00,0,0,0,0,0,0,0,0,0,0,0,0,0
20200520,051077,台郡國泰96購02,,,,,0.00,0.00,0,0,0,0,0,0,0,0,0,0,0,0,0
20200520,051078,力山富邦97購01,0.22,0.22,0.21,0.21,0.00,0.00,140000,5,30400,0,0,0,0,0,0,0,40000,-40000,-40000
20200520,051079,鴻海富邦96購02,,,,,0.00,0.00,0,0,0,0,0,0,0,0,0,0,0,0,0
20200520,05107P,鴻海兆豐96售02,,,,,0.00,0.00,0,0,0,0,0,0,0,0,0,0,0,0,0
20200520,051080,全新富邦96購01,,,,,0.00,0.00,0,0,0,0,0,0,0,0,0,0,0,0,0
20200520,051081,聯茂富邦96購01,,,,,0.00,0.00,0,0,0,0,0,0,0,0,0,0,0,0,0
20200520,051082,上証2X元大98購01,,,,,0.00,0.00,0,0,0,0,0,0,0,0,0,0,0,0,0
20200520,051083,A50正2元大98購01,,,,,0.00,0.00,0,0,0,0,0,0,0,0,0,0,0,0,0
20200520,051086,鴻海元大96購04,,,,,0.00,0.00,0,0,0,0,0,0,0,0,0,0,0,0,0
20200520,051087,國巨元大97購01,,,,,0.00,0.00,0,0,0,0,0,0,0,0,0,0,0,0,0
20200520,051089,旺宏元大96購04,0.20,0.30,0.20,0.29,0.00,0.00,90000,4,20800,0,0,0,0,0,0,60000,30000,30000,30000
20200520,051090,光磊元大96購01,,,,,0.00,0.00,0,0,0,0,0,0,0,0,0,0,0,0,0
20200520,051094,健策元大96購03,,,,,0.00,0.00,0,0,0,0,0,0,0,0,0,0,0,0,0
20200520,051097,嘉聯益元大96購02,,,,,0.00,0.00,0,0,0,0,0,0,0,0,0,0,0,0,0
20200520,051101,台表科元大96購02,0.33,0.65,0.33,0.65,+0.16,32.65,55000,3,22500,0,0,0,0,0,0,55000,0,55000,55000
20200520,051102,訊芯元大96購01,,,,,0.00,0.00,0,0,0,0,0,0,0,0,0,0,0,0,0
20200520,051103,緯穎元大96購03,,,,,0.00,0.00,0,0,0,0,0,0,0,0,0,0,0,0,0
20200520,051104,鈺齊元大96購01,,,,,0.00,0.00,0,0,0,0,0,0,0,0,0,0,0,0,0
20200520,051105,台光電國票96購01,,,,,0.00,0.00,0,0,0,0,0,0,0,0,0,0,0,0,0
20200520,051108,鴻海統一96購02,,,,,0.00,0.00,0,0,0,0,0,0,0,0,0,0,0,0,0
20200520,051115,華通麥證96購01,,,,,0.00,0.00,0,0,0,0,0,0,0,0,0,0,0,0,0
20200520,051121,裕民群益97購01,,,,,0.00,0.00,0,0,0,0,0,0,0,0,0,0,0,0,0
20200520,051130,百和群益96購01,,,,,0.00,0.00,0,0,0,0,0,0,0,0,0,0,0,0,0
20200520,051152,鴻海國泰97購01,,,,,0.00,0.00,0,0,0,0,0,0,0,0,0,0,0,0,0
20200520,051153,鴻海國泰97購02,,,,,0.00,0.00,0,0,0,0,0,0,0,0,0,0,0,0,0
20200520,051154,國巨國泰96購03,,,,,0.00,0.00,0,0,0,0,0,0,0,0,0,0,0,0,0
20200520,051155,聯發科國泰96購01,2.15,2.65,2.15,2.65,+0.67,33.84,15000,3,35150,0,0,0,0,0,0,15000,0,15000,15000
20200520,051156,鴻海富邦97購01,0.01,0.03,0.01,0.03,0.00,0.00,129000,2,1470,0,0,0,0,0,0,0,0,0,0
20200520,051157,華新科富邦98購01,,,,,0.00,0.00,0,0,0,0,0,0,0,0,0,0,0,0,0
20200520,051158,嘉晶富邦96購01,0.11,0.16,0.11,0.16,+0.09,128.57,259000,4,35170,0,0,0,0,0,0,259000,0,259000,259000
20200520,051159,力山元大96購01,,,,,0.00,0.00,0,0,0,0,0,0,0,0,0,0,0,0,0
20200520,051172,鴻海第一96購01,,,,,0.00,0.00,0,0,0,0,0,0,0,0,0,0,0,0,0
20200520,051173,元油2X凱基98購01,,,,,0.00,0.00,0,0,0,0,0,0,0,0,0,0,0,0,0
20200520,051189,鴻海兆豐96購01,,,,,0.00,0.00,0,0,0,0,0,0,0,0,0,0,0,0,0
20200520,05118P,超眾元大96售04,,,,,0.00,0.00,0,0,0,0,0,0,0,0,0,0,0,0,0
20200520,051191,可成兆豐96購01,,,,,0.00,0.00,0,0,0,0,0,0,0,0,0,0,0,0,0
20200520,051192,緯創兆豐96購01,0.40,0.40,0.38,0.38,-0.03,-7.32,25000,4,9700,0,0,0,0,0,0,25000,0,25000,25000
20200520,051193,新日興兆豐96購01,0.39,0.39,0.39,0.39,-0.05,-11.36,300000,5,117000,0,0,0,0,0,0,0,300000,-300000,-300000
20200520,051194,大立光中信96購02,,,,,0.00,0.00,0,0,0,0,0,0,0,0,0,0,0,0,0
20200520,05119P,聯發科國泰96售02,,,,,0.00,0.00,0,0,0,0,0,0,0,0,0,0,0,0,0
20200520,05120P,聯發科國泰97售01,,,,,0.00,0.00,0,0,0,0,0,0,0,0,0,0,0,0,0
20200520,051210,S&P反1統一97購01,,,,,0.00,0.00,0,0,0,0,0,0,0,0,0,0,0,0,0
20200520,051218,聯發科元富9B購02,,,,,0.00,0.00,0,0,0,0,0,0,0,0,0,0,0,0,0
20200520,05121P,創意國泰96售01,,,,,0.00,0.00,0,0,0,0,0,0,0,0,0,0,0,0,0
20200520,051224,華通群益96購03,,,,,0.00,0.00,0,0,0,0,0,0,0,0,0,0,0,0,0
20200520,051227,技嘉群益97購01,,,,,0.00,0.00,0,0,0,0,0,0,0,0,0,0,0,0,0
20200520,05122P,鴻海永昌96售06,,,,,0.00,0.00,0,0,0,0,0,0,0,0,0,0,0,0,0
20200520,051231,健策群益97購01,,,,,0.00,0.00,0,0,0,0,0,0,0,0,0,0,0,0,0
20200520,051233,力成群益97購01,,,,,0.00,0.00,0,0,0,0,0,0,0,0,0,0,0,0,0
20200520,051236,鴻海元大96購05,,,,,0.00,0.00,0,0,0,0,0,0,0,0,0,0,0,0,0
20200520,051237,鴻海元大97購01,,,,,0.00,0.00,0,0,0,0,0,0,0,0,0,0,0,0,0
20200520,051238,中環元大96購01,,,,,0.00,0.00,0,0,0,0,0,0,0,0,0,0,0,0,0
20200520,051239,國巨元大96購02,,,,,0.00,0.00,0,0,0,0,0,0,0,0,0,0,0,0,0
20200520,05123P,鴻海永昌96售07,2.42,2.42,2.37,2.37,+0.16,7.24,41000,4,98170,0,0,0,0,0,0,21000,20000,1000,1000
20200520,051242,台積電元大96購06,,,,,0.00,0.00,0,0,0,0,0,0,0,0,0,0,0,0,0
20200520,051246,美律元大96購01,,,,,0.00,0.00,0,0,0,0,0,0,0,0,0,0,0,0,0
20200520,05124P,華新科富邦97售02,0.49,0.52,0.49,0.52,0.00,0.00,30000,3,15300,0,0,0,0,0,0,10000,20000,-10000,-10000
20200520,051250,大立光元大98購01,,,,,0.00,0.00,0,0,0,0,0,0,0,0,0,0,0,0,0
20200520,051254,健策元大96購04,1.38,1.38,1.38,1.38,0.00,0.00,40000,1,55200,0,0,0,0,0,0,40000,40000,0,0
20200520,051255,康控元大96購04,,,,,0.00,0.00,0,0,0,0,0,0,0,0,0,0,0,0,0
20200520,051257,光寶科國泰96購01,,,,,0.00,0.00,0,0,0,0,0,0,0,0,0,0,0,0,0
20200520,051258,鈺齊國泰97購01,,,,,0.00,0.00,0,0,0,0,0,0,0,0,0,0,0,0,0
20200520,051259,鴻海永昌96購03,,,,,0.00,0.00,0,0,0,0,0,0,0,0,0,0,0,0,0
20200520,051260,鴻海永昌96購04,0.01,0.01,0.01,0.01,0.00,0.00,3000,1,30,0,0,0,0,0,0,3000,0,3000,3000
20200520,051261,鴻海永昌96購05,,,,,0.00,0.00,0,0,0,0,0,0,0,0,0,0,0,0,0
20200520,051262,A50富邦96購01,,,,,0.00,0.00,0,0,0,0,0,0,0,0,0,0,0,0,0
20200520,051263,深中小富邦96購01,,,,,0.00,0.00,0,0,0,0,0,0,0,0,0,0,0,0,0
20200520,051264,道瓊反富邦97購01,,,,,0.00,0.00,0,0,0,0,0,0,0,0,0,0,0,0,0
20200520,051265,鴻海富邦96購04,,,,,0.00,0.00,0,0,0,0,0,0,0,0,0,0,0,0,0
20200520,051266,國巨富邦99購01,2.13,2.13,1.84,1.99,+0.15,8.15,56000,11,115020,0,0,0,0,0,0,0,50000,-50000,-50000
20200520,051267,美律富邦96購01,,,,,0.00,0.00,0,0,0,0,0,0,0,0,0,0,0,0,0
20200520,051268,創意富邦97購01,,,,,0.00,0.00,0,0,0,0,0,0,0,0,0,0,0,0,0
20200520,051269,康友富邦97購01,,,,,0.00,0.00,0,0,0,0,0,0,0,0,0,0,0,0,0
20200520,051274,華新科亞東96購01,,,,,0.00,0.00,0,0,0,0,0,0,0,0,0,0,0,0,0
20200520,051276,SGBR2X中信97購01,,,,,0.00,0.00,0,0,0,0,0,0,0,0,0,0,0,0,0
20200520,051277,聯發科中信9A購01,0.34,0.45,0.33,0.41,+0.07,20.59,2233000,140,869850,0,0,0,0,0,0,941000,0,941000,941000
20200520,051278,臻鼎中信97購02,,,,,0.00,0.00,0,0,0,0,0,0,0,0,0,0,0,0,0
20200520,051279,喬山兆豐96購01,,,,,0.00,0.00,0,0,0,0,0,0,0,0,0,0,0,0,0
20200520,05127P,鴻海亞東96售01,,,,,0.00,0.00,0,0,0,0,0,0,0,0,0,0,0,0,0
20200520,051281,健策兆豐96購01,,,,,0.00,0.00,0,0,0,0,0,0,0,0,0,0,0,0,0
20200520,051286,國巨統一97購01,,,,,0.00,0.00,0,0,0,0,0,0,0,0,0,0,0,0,0
20200520,051289,大立光統一96購01,,,,,0.00,0.00,0,0,0,0,0,0,0,0,0,0,0,0,0
20200520,05128P,聯發科中信97售03,,,,,0.00,0.00,0,0,0,0,0,0,0,0,0,0,0,0,0
20200520,051290,大立光統一96購02,,,,,0.00,0.00,0,0,0,0,0,0,0,0,0,0,0,0,0
20200520,051292,牧德統一97購01,2.08,2.58,2.08,2.50,+0.48,23.76,650000,32,1516050,0,0,0,0,0,0,95000,555000,-460000,-460000
20200520,051296,鴻海凱基97購01,,,,,0.00,0.00,0,0,0,0,0,0,0,0,0,0,0,0,0
20200520,051300,台光電凱基96購02,,,,,0.00,0.00,0,0,0,0,0,0,0,0,0,0,0,0,0
20200520,051304,緯創凱基96購01,,,,,0.00,0.00,0,0,0,0,0,0,0,0,0,0,0,0,0
20200520,051305,訊連凱基96購01,,,,,0.00,0.00,0,0,0,0,0,0,0,0,0,0,0,0,0
20200520,051306,嘉聯益凱基96購01,,,,,0.00,0.00,0,0,0,0,0,0,0,0,0,0,0,0,0
20200520,051314,嘉聯益麥證96購01,,,,,0.00,0.00,0,0,0,0,0,0,0,0,0,0,0,0,0
20200520,051317,亞德客國票96購01,,,,,0.00,0.00,0,0,0,0,0,0,0,0,0,0,0,0,0
20200520,051318,上銀國票96購01,,,,,0.00,0.00,0,0,0,0,0,0,0,0,0,0,0,0,0
20200520,051319,光磊國票96購02,,,,,0.00,0.00,0,0,0,0,0,0,0,0,0,0,0,0,0
20200520,05131P,聯詠統一97售01,1.69,1.69,1.69,1.69,+0.02,1.2,172000,3,290680,0,0,0,0,0,0,0,172000,-172000,-172000
20200520,051320,燿華國票96購01,,,,,0.00,0.00,0,0,0,0,0,0,0,0,0,0,0,0,0
20200520,051321,建準國票96購01,,,,,0.00,0.00,0,0,0,0,0,0,0,0,0,0,0,0,0
20200520,051322,國泰金國票96購01,,,,,0.00,0.00,0,0,0,0,0,0,0,0,0,0,0,0,0
20200520,051323,康控國票96購01,,,,,0.00,0.00,0,0,0,0,0,0,0,0,0,0,0,0,0
20200520,051324,康友國票96購01,,,,,0.00,0.00,0,0,0,0,0,0,0,0,0,0,0,0,0
20200520,051325,台光電台新96購01,,,,,0.00,0.00,0,0,0,0,0,0,0,0,0,0,0,0,0
20200520,051331,全新永豐96購01,,,,,0.00,0.00,0,0,0,0,0,0,0,0,0,0,0,0,0
20200520,05134P,鴻海凱基96售06,,,,,0.00,0.00,0,0,0,0,0,0,0,0,0,0,0,0,0
20200520,051355,聯發科元大96購01,0.73,0.73,0.73,0.73,+0.08,12.31,5000,1,3650,0,0,0,0,0,0,5000,0,5000,5000
20200520,051356,全新元大96購04,,,,,0.00,0.00,0,0,0,0,0,0,0,0,0,0,0,0,0
20200520,05135P,鴻海凱基96售07,2.42,2.42,2.42,2.42,0.00,0.00,7000,1,16940,0,0,0,0,0,0,7000,7000,0,0
20200520,051364,鴻海國泰97購03,,,,,0.00,0.00,0,0,0,0,0,0,0,0,0,0,0,0,0
20200520,051365,瀚宇博國泰97購01,,,,,0.00,0.00,0,0,0,0,0,0,0,0,0,0,0,0,0
20200520,051366,康友國泰97購01,,,,,0.00,0.00,0,0,0,0,0,0,0,0,0,0,0,0,0
20200520,051367,可成富邦97購01,0.01,0.01,0.01,0.01,0.00,0.00,100000,1,1000,0,0,0,0,0,0,0,0,0,0
20200520,051368,國泰金富邦97購01,,,,,0.00,0.00,0,0,0,0,0,0,0,0,0,0,0,0,0
20200520,051369,新光金富邦9A購01,,,,,0.00,0.00,0,0,0,0,0,0,0,0,0,0,0,0,0
20200520,051370,聯詠富邦97購01,,,,,0.00,0.00,0,0,0,0,0,0,0,0,0,0,0,0,0
20200520,051372,樺漢富邦96購01,,,,,0.00,0.00,0,0,0,0,0,0,0,0,0,0,0,0,0
20200520,051375,道瓊反群益9A購01,,,,,0.00,0.00,0,0,0,0,0,0,0,0,0,0,0,0,0
20200520,05137P,華新科凱基96售03,,,,,0.00,0.00,0,0,0,0,0,0,0,0,0,0,0,0,0
20200520,051381,玉晶光群益98購01,2.30,2.52,2.30,2.48,+0.15,6.44,129000,18,316300,0,0,0,0,0,0,37000,92000,-55000,-55000
20200520,051382,玉晶光群益98購02,2.79,3.23,2.79,3.23,0.00,0.00,71000,4,206510,0,0,0,0,0,0,14000,57000,-43000,-43000
20200520,051383,京鼎群益96購02,,,,,0.00,0.00,0,0,0,0,0,0,0,0,0,0,0,0,0
20200520,051386,富邦金麥證96購01,,,,,0.00,0.00,0,0,0,0,0,0,0,0,0,0,0,0,0
20200520,051387,新光金麥證96購01,,,,,0.00,0.00,0,0,0,0,0,0,0,0,0,0,0,0,0
20200520,05138P,嘉聯益凱基96售02,1.76,1.76,1.76,1.76,-0.14,-7.37,10000,2,17600,0,0,0,0,0,0,10000,0,10000,10000
20200520,051393,新光金兆豐96購01,0.02,0.02,0.02,0.02,0.00,0.00,10000,1,200,0,0,0,0,0,0,0,10000,-10000,-10000
20200520,051399,玉晶光台新96購01,,,,,0.00,0.00,0,0,0,0,0,0,0,0,0,0,0,0,0
20200520,051404,牧德永豐96購01,,,,,0.00,0.00,0,0,0,0,0,0,0,0,0,0,0,0,0
20200520,051406,泰鼎永豐96購01,1.35,1.75,1.29,1.75,+0.24,15.89,68000,9,101010,0,0,0,0,0,0,32000,36000,-4000,-4000
20200520,051409,美律國票96購01,,,,,0.00,0.00,0,0,0,0,0,0,0,0,0,0,0,0,0
20200520,05140P,台表科國票96售01,,,,,0.00,0.00,0,0,0,0,0,0,0,0,0,0,0,0,0
20200520,051410,京元電國票96購01,,,,,0.00,0.00,0,0,0,0,0,0,0,0,0,0,0,0,0
20200520,051412,奇力新國票96購01,,,,,0.00,0.00,0,0,0,0,0,0,0,0,0,0,0,0,0
20200520,051413,富邦金國票96購02,,,,,0.00,0.00,0,0,0,0,0,0,0,0,0,0,0,0,0
20200520,051415,晶技國票96購01,,,,,0.00,0.00,0,0,0,0,0,0,0,0,0,0,0,0,0
20200520,051416,創意國票96購02,,,,,0.00,0.00,0,0,0,0,0,0,0,0,0,0,0,0,0
20200520,051417,揚明光國票96購01,,,,,0.00,0.00,0,0,0,0,0,0,0,0,0,0,0,0,0
20200520,051418,智易國票97購01,,,,,0.00,0.00,0,0,0,0,0,0,0,0,0,0,0,0,0
20200520,051419,麗豐國票96購01,,,,,0.00,0.00,0,0,0,0,0,0,0,0,0,0,0,0,0
20200520,05141P,華通台新96售01,,,,,0.00,0.00,0,0,0,0,0,0,0,0,0,0,0,0,0
20200520,051422,超眾國票96購01,1.33,1.33,1.33,1.33,-0.08,-5.67,23000,1,30590,0,0,0,0,0,0,23000,0,23000,23000
20200520,051423,GIS國票97購01,,,,,0.00,0.00,0,0,0,0,0,0,0,0,0,0,0,0,0
20200520,051424,緯穎國票97購01,21.20,21.20,20.70,20.70,-2.20,-9.61,30000,3,630000,0,0,0,0,0,0,0,30000,-30000,-30000
20200520,051425,昇陽半國票97購01,,,,,0.00,0.00,0,0,0,0,0,0,0,0,0,0,0,0,0
20200520,051428,玉晶光統一96購01,0.99,1.04,0.97,1.04,+0.13,14.29,166000,13,167440,0,0,0,0,0,0,4000,166000,-162000,-162000
20200520,051431,群創元富99購02,,,,,0.00,0.00,0,0,0,0,0,0,0,0,0,0,0,0,0
20200520,051432,群創元富99購03,,,,,0.00,0.00,0,0,0,0,0,0,0,0,0,0,0,0,0
20200520,051446,中壽元大96購01,,,,,0.00,0.00,0,0,0,0,0,0,0,0,0,0,0,0,0
20200520,051447,新光金元大97購01,,,,,0.00,0.00,0,0,0,0,0,0,0,0,0,0,0,0,0
20200520,051449,玉晶光元大96購01,1.04,1.04,1.04,1.04,0.00,0.00,10000,1,10400,0,0,0,0,0,0,0,10000,-10000,-10000
20200520,051455,樺漢元大96購01,,,,,0.00,0.00,0,0,0,0,0,0,0,0,0,0,0,0,0
20200520,05145P,道瓊反元大98售01,,,,,0.00,0.00,0,0,0,0,0,0,0,0,0,0,0,0,0
20200520,051460,S&P反1國泰97購01,,,,,0.00,0.00,0,0,0,0,0,0,0,0,0,0,0,0,0
20200520,051461,聯詠國泰96購01,,,,,0.00,0.00,0,0,0,0,0,0,0,0,0,0,0,0,0
20200520,051462,世芯國泰97購01,,,,,0.00,0.00,0,0,0,0,0,0,0,0,0,0,0,0,0
20200520,051463,世芯國泰97購02,,,,,0.00,0.00,0,0,0,0,0,0,0,0,0,0,0,0,0
20200520,051464,彩晶國泰96購01,,,,,0.00,0.00,0,0,0,0,0,0,0,0,0,0,0,0,0
20200520,051465,鴻海富邦97購02,0.01,0.01,0.01,0.01,0.00,0.00,73000,1,730,0,0,0,0,0,0,0,0,0,0
20200520,051466,玉晶光富邦97購01,0.35,0.35,0.35,0.35,0.00,0.00,5000,1,1750,0,0,0,0,0,0,5000,0,5000,5000
20200520,051467,GIS富邦96購01,,,,,0.00,0.00,0,0,0,0,0,0,0,0,0,0,0,0,0
20200520,051469,友達日盛9B購01,0.42,0.42,0.42,0.42,0.00,0.00,3000,1,1260,0,0,0,0,0,0,3000,0,3000,3000
20200520,051471,國巨凱基97購01,1.63,1.63,1.45,1.45,+0.16,12.4,2000,2,3080,0,0,0,0,0,0,2000,0,2000,2000
20200520,051480,大立光凱基97購01,,,,,0.00,0.00,0,0,0,0,0,0,0,0,0,0,0,0,0
20200520,051482,玉晶光凱基96購01,,,,,0.00,0.00,0,0,0,0,0,0,0,0,0,0,0,0,0
20200520,051483,玉晶光凱基96購02,0.59,0.66,0.59,0.66,+0.01,1.54,18000,4,11030,0,0,0,0,0,0,18000,0,18000,18000
20200520,051484,玉晶光凱基97購01,,,,,0.00,0.00,0,0,0,0,0,0,0,0,0,0,0,0,0
20200520,051485,玉晶光凱基97購02,,,,,0.00,0.00,0,0,0,0,0,0,0,0,0,0,0,0,0
20200520,051486,玉晶光凱基97購03,0.55,0.60,0.55,0.57,+0.04,7.55,58000,5,32890,0,0,0,0,0,0,57000,1000,56000,56000
20200520,051487,健策凱基96購03,,,,,0.00,0.00,0,0,0,0,0,0,0,0,0,0,0,0,0
20200520,051488,健策凱基96購04,0.05,0.06,0.05,0.06,-0.02,-25.0,202000,2,10360,0,0,0,0,0,0,202000,0,202000,202000
20200520,051490,世芯凱基96購01,4.25,4.59,4.25,4.37,+0.09,2.1,158000,26,700160,0,0,0,0,0,0,158000,0,158000,158000
20200520,051497,中磊亞東96購01,,,,,0.00,0.00,0,0,0,0,0,0,0,0,0,0,0,0,0
20200520,051498,智易群益96購01,,,,,0.00,0.00,0,0,0,0,0,0,0,0,0,0,0,0,0
20200520,05149P,緯穎國泰96售01,,,,,0.00,0.00,0,0,0,0,0,0,0,0,0,0,0,0,0
20200520,051503,玉晶光統一97購01,2.45,2.51,2.40,2.51,+0.20,8.66,60000,14,148030,0,0,0,0,0,0,0,60000,-60000,-60000
20200520,051508,元黃金中信97購01,2.77,2.77,2.77,2.77,+0.11,4.14,2000,1,5540,0,0,0,0,0,0,0,2000,-2000,-2000
20200520,051509,鴻海中信97購01,,,,,0.00,0.00,0,0,0,0,0,0,0,0,0,0,0,0,0
20200520,051510,新光金中信97購01,0.04,0.04,0.04,0.04,0.00,0.00,20000,2,800,0,0,0,0,0,0,0,20000,-20000,-20000
20200520,051511,鈺齊中信97購01,,,,,0.00,0.00,0,0,0,0,0,0,0,0,0,0,0,0,0
20200520,051516,全新凱基96購02,,,,,0.00,0.00,0,0,0,0,0,0,0,0,0,0,0,0,0
20200520,051520,新光金凱基97購01,,,,,0.00,0.00,0,0,0,0,0,0,0,0,0,0,0,0,0
20200520,051521,大立光凱基96購07,,,,,0.00,0.00,0,0,0,0,0,0,0,0,0,0,0,0,0
20200520,051528,亞泥國票96購01,,,,,0.00,0.00,0,0,0,0,0,0,0,0,0,0,0,0,0
20200520,051529,東元國票96購01,,,,,0.00,0.00,0,0,0,0,0,0,0,0,0,0,0,0,0
20200520,05152P,玉晶光群益96售05,,,,,0.00,0.00,0,0,0,0,0,0,0,0,0,0,0,0,0
20200520,051530,鴻海國票97購01,0.02,0.02,0.02,0.02,-0.01,-33.33,259000,3,5180,0,0,0,0,0,0,0,0,0,0
20200520,051531,國巨國票96購04,,,,,0.00,0.00,0,0,0,0,0,0,0,0,0,0,0,0,0
20200520,051532,潤泰全國票96購01,,,,,0.00,0.00,0,0,0,0,0,0,0,0,0,0,0,0,0
20200520,051533,健鼎國票96購02,,,,,0.00,0.00,0,0,0,0,0,0,0,0,0,0,0,0,0
20200520,051534,景碩國票97購01,,,,,0.00,0.00,0,0,0,0,0,0,0,0,0,0,0,0,0
20200520,051535,新日興國票96購01,,,,,0.00,0.00,0,0,0,0,0,0,0,0,0,0,0,0,0
20200520,051536,玉晶光國票97購01,1.62,1.92,1.62,1.85,+0.12,6.94,71000,19,131050,0,0,0,0,0,0,39000,51000,-12000,-12000
20200520,051537,牧德國票96購01,,,,,0.00,0.00,0,0,0,0,0,0,0,0,0,0,0,0,0
20200520,051538,和碩國票96購01,,,,,0.00,0.00,0,0,0,0,0,0,0,0,0,0,0,0,0
20200520,051539,瀚宇博國票97購01,0.21,0.21,0.21,0.21,-0.05,-19.23,47000,1,9870,0,0,0,0,0,0,47000,0,47000,47000
20200520,05153P,台表科群益96售01,,,,,0.00,0.00,0,0,0,0,0,0,0,0,0,0,0,0,0
20200520,051541,GIS國票96購02,,,,,0.00,0.00,0,0,0,0,0,0,0,0,0,0,0,0,0
20200520,051542,南茂國票96購01,,,,,0.00,0.00,0,0,0,0,0,0,0,0,0,0,0,0,0
20200520,051543,鈺齊國票96購01,,,,,0.00,0.00,0,0,0,0,0,0,0,0,0,0,0,0,0
20200520,051544,T50反1康和98購01,0.58,0.58,0.56,0.57,-0.01,-1.72,27000,4,15420,0,0,0,0,0,0,17000,10000,7000,7000
20200520,051553,牧德永豐96購02,0.40,0.40,0.40,0.40,0.00,0.00,2000,1,800,0,0,0,0,0,0,2000,0,2000,2000
20200520,051556,台表科永豐96購01,,,,,0.00,0.00,0,0,0,0,0,0,0,0,0,0,0,0,0
20200520,051557,昇陽半永豐96購01,,,,,0.00,0.00,0,0,0,0,0,0,0,0,0,0,0,0,0
20200520,051558,元金2X國泰97購01,,,,,0.00,0.00,0,0,0,0,0,0,0,0,0,0,0,0,0
20200520,051559,宏達電國泰96購01,0.04,0.04,0.03,0.03,0.00,0.00,100000,7,3400,0,0,0,0,0,0,0,100000,-100000,-100000
20200520,051560,玉晶光國泰97購03,,,,,0.00,0.00,0,0,0,0,0,0,0,0,0,0,0,0,0
20200520,051561,玉晶光國泰97購04,1.55,1.71,1.55,1.71,+0.15,9.62,718000,29,1179730,0,0,0,0,0,0,124000,596000,-472000,-472000
20200520,051562,玉晶光國泰97購05,,,,,0.00,0.00,0,0,0,0,0,0,0,0,0,0,0,0,0
20200520,051563,泰鼎國泰96購01,,,,,0.00,0.00,0,0,0,0,0,0,0,0,0,0,0,0,0
20200520,051564,和碩國泰96購01,,,,,0.00,0.00,0,0,0,0,0,0,0,0,0,0,0,0,0
20200520,051565,玉晶光永昌96購01,,,,,0.00,0.00,0,0,0,0,0,0,0,0,0,0,0,0,0
20200520,051570,和碩富邦97購01,0.10,0.11,0.10,0.11,-0.01,-8.33,56000,6,6100,0,0,0,0,0,0,16000,40000,-24000,-24000
20200520,051574,鴻海元大96購06,,,,,0.00,0.00,0,0,0,0,0,0,0,0,0,0,0,0,0
20200520,051575,國巨元大96購03,0.65,1.28,0.65,1.28,+0.38,42.22,32000,4,38200,0,0,0,0,0,0,0,30000,-30000,-30000
20200520,051576,台積電元大97購02,,,,,0.00,0.00,0,0,0,0,0,0,0,0,0,0,0,0,0
20200520,051577,台積電元大97購03,0.67,0.75,0.67,0.75,+0.06,8.7,6000,2,4420,0,0,0,0,0,0,1000,0,1000,1000
20200520,051578,智邦元大96購01,,,,,0.00,0.00,0,0,0,0,0,0,0,0,0,0,0,0,0
20200520,05157P,全新台新96售01,,,,,0.00,0.00,0,0,0,0,0,0,0,0,0,0,0,0,0
20200520,051582,聯發科元大97購02,2.86,2.86,2.86,2.86,+0.21,7.92,90000,1,257400,0,0,0,0,0,0,90000,0,90000,90000
20200520,051586,國泰金元大96購01,,,,,0.00,0.00,0,0,0,0,0,0,0,0,0,0,0,0,0
20200520,051590,玉晶光元大96購02,,,,,0.00,0.00,0,0,0,0,0,0,0,0,0,0,0,0,0
20200520,051591,玉晶光元大97購01,0.87,0.87,0.87,0.87,0.00,0.00,10000,1,8700,0,0,0,0,0,0,10000,0,10000,10000
20200520,051592,健策元大96購05,,,,,0.00,0.00,0,0,0,0,0,0,0,0,0,0,0,0,0
20200520,051594,和碩元大96購01,0.54,0.54,0.52,0.52,-0.25,-32.47,488000,7,260360,0,0,0,0,0,0,100000,388000,-288000,-288000
20200520,051597,T50反1中信99購02,,,,,0.00,0.00,0,0,0,0,0,0,0,0,0,0,0,0,0
20200520,051600,新日興兆豐96購02,0.24,0.29,0.23,0.29,0.00,0.00,144000,5,36240,0,0,0,0,0,0,94000,50000,44000,44000
20200520,051602,南茂兆豐96購01,0.07,0.07,0.07,0.07,0.00,0.00,12000,1,840,0,0,0,0,0,0,12000,0,12000,12000
20200520,051603,深中小群益99購03,1.11,1.11,1.10,1.11,0.00,0.00,25000,4,27650,0,0,0,0,0,0,25000,0,25000,25000
20200520,051607,緯創群益96購02,0.49,0.49,0.48,0.48,0.00,0.00,70000,7,33800,0,0,0,0,0,0,0,70000,-70000,-70000
20200520,051608,新日興群益96購01,,,,,0.00,0.00,0,0,0,0,0,0,0,0,0,0,0,0,0
20200520,05160P,國巨國票96售03,0.18,0.20,0.18,0.20,-0.11,-35.48,50000,3,9200,0,0,0,0,0,0,40000,10000,30000,30000
20200520,051613,S&P反1凱基96購01,,,,,0.00,0.00,0,0,0,0,0,0,0,0,0,0,0,0,0
20200520,051614,元金2X凱基97購01,1.86,1.93,1.86,1.89,+0.21,12.5,142000,14,268650,0,0,0,0,0,0,140000,0,140000,140000
20200520,051615,華通凱基96購01,,,,,0.00,0.00,0,0,0,0,0,0,0,0,0,0,0,0,0
20200520,051616,鴻海凱基96購08,,,,,0.00,0.00,0,0,0,0,0,0,0,0,0,0,0,0,0
20200520,05161P,華新科國票96售01,,,,,0.00,0.00,0,0,0,0,0,0,0,0,0,0,0,0,0
20200520,051622,和碩凱基96購01,,,,,0.00,0.00,0,0,0,0,0,0,0,0,0,0,0,0,0
20200520,051623,和碩凱基96購02,,,,,0.00,0.00,0,0,0,0,0,0,0,0,0,0,0,0,0
20200520,05162P,玉晶光國票96售03,,,,,0.00,0.00,0,0,0,0,0,0,0,0,0,0,0,0,0
20200520,051630,力山國票96購01,0.67,0.70,0.67,0.69,-0.02,-2.82,357000,5,243750,0,0,0,0,0,0,0,357000,-357000,-357000
20200520,051631,國巨國票96購06,,,,,0.00,0.00,0,0,0,0,0,0,0,0,0,0,0,0,0
20200520,051632,全新國票96購01,,,,,0.00,0.00,0,0,0,0,0,0,0,0,0,0,0,0,0
20200520,051633,可成國票96購03,,,,,0.00,0.00,0,0,0,0,0,0,0,0,0,0,0,0,0
20200520,051634,大立光國票96購03,0.01,0.01,0.01,0.01,0.00,0.00,1015000,6,10150,0,0,0,0,0,0,815000,825000,-10000,-10000
20200520,051635,大立光國票96購04,,,,,0.00,0.00,0,0,0,0,0,0,0,0,0,0,0,0,0
20200520,051637,嘉聯益國票96購01,,,,,0.00,0.00,0,0,0,0,0,0,0,0,0,0,0,0,0
20200520,051638,聯茂國票96購01,,,,,0.00,0.00,0,0,0,0,0,0,0,0,0,0,0,0,0
20200520,051639,康友國票96購02,,,,,0.00,0.00,0,0,0,0,0,0,0,0,0,0,0,0,0
20200520,05163P,聯發科統一96售02,,,,,0.00,0.00,0,0,0,0,0,0,0,0,0,0,0,0,0
20200520,051640,GIS國票96購03,,,,,0.00,0.00,0,0,0,0,0,0,0,0,0,0,0,0,0
20200520,051641,矽創國票96購01,,,,,0.00,0.00,0,0,0,0,0,0,0,0,0,0,0,0,0
20200520,051646,華通永豐96購01,,,,,0.00,0.00,0,0,0,0,0,0,0,0,0,0,0,0,0
20200520,051652,昇陽半永豐96購02,,,,,0.00,0.00,0,0,0,0,0,0,0,0,0,0,0,0,0
20200520,051657,台郡元富98購01,,,,,0.00,0.00,0,0,0,0,0,0,0,0,0,0,0,0,0
20200520,051658,深中小國泰97購01,,,,,0.00,0.00,0,0,0,0,0,0,0,0,0,0,0,0,0
20200520,051659,力山國泰97購01,,,,,0.00,0.00,0,0,0,0,0,0,0,0,0,0,0,0,0
20200520,051660,緯穎國泰96購02,,,,,0.00,0.00,0,0,0,0,0,0,0,0,0,0,0,0,0
20200520,051661,華新科永昌96購01,,,,,0.00,0.00,0,0,0,0,0,0,0,0,0,0,0,0,0
20200520,051662,大立光永昌96購03,,,,,0.00,0.00,0,0,0,0,0,0,0,0,0,0,0,0,0
20200520,051664,鴻海元大96購07,,,,,0.00,0.00,0,0,0,0,0,0,0,0,0,0,0,0,0
20200520,051665,台積電元大96購07,,,,,0.00,0.00,0,0,0,0,0,0,0,0,0,0,0,0,0
20200520,051666,旺宏元大96購05,,,,,0.00,0.00,0,0,0,0,0,0,0,0,0,0,0,0,0
20200520,051667,光磊元大96購02,0.32,0.32,0.32,0.32,-0.01,-3.03,90000,1,28800,0,0,0,0,0,0,90000,0,90000,90000
20200520,051671,和鑫元大96購02,,,,,0.00,0.00,0,0,0,0,0,0,0,0,0,0,0,0,0
20200520,051672,玉晶光元大96購03,,,,,0.00,0.00,0,0,0,0,0,0,0,0,0,0,0,0,0
20200520,051673,玉晶光元大96購04,,,,,0.00,0.00,0,0,0,0,0,0,0,0,0,0,0,0,0
20200520,051675,瑞儀元大96購02,,,,,0.00,0.00,0,0,0,0,0,0,0,0,0,0,0,0,0
20200520,051682,元黃金凱基97購01,,,,,0.00,0.00,0,0,0,0,0,0,0,0,0,0,0,0,0
20200520,051683,A50正2凱基97購01,,,,,0.00,0.00,0,0,0,0,0,0,0,0,0,0,0,0,0
20200520,051688,大立光凱基97購02,,,,,0.00,0.00,0,0,0,0,0,0,0,0,0,0,0,0,0
20200520,051694,A50正2中信96購03,,,,,0.00,0.00,0,0,0,0,0,0,0,0,0,0,0,0,0
20200520,051695,元金2X中信98購01,2.14,2.14,2.14,2.14,0.00,0.00,11000,2,23540,0,0,0,0,0,0,11000,0,11000,11000
20200520,051696,新日興中信96購01,,,,,0.00,0.00,0,0,0,0,0,0,0,0,0,0,0,0,0
20200520,051700,深中小群益99購04,,,,,0.00,0.00,0,0,0,0,0,0,0,0,0,0,0,0,0
20200520,051701,華通群益97購01,,,,,0.00,0.00,0,0,0,0,0,0,0,0,0,0,0,0,0
20200520,051705,富邦金群益97購01,0.03,0.03,0.03,0.03,0.00,0.00,70000,1,2100,0,0,0,0,0,0,70000,0,70000,70000
20200520,051721,玉晶光永豐96購02,,,,,0.00,0.00,0,0,0,0,0,0,0,0,0,0,0,0,0
20200520,051722,玉晶光永豐97購01,1.49,1.66,1.49,1.66,+0.12,7.79,273000,28,437150,0,0,0,0,0,0,99000,172000,-73000,-73000
20200520,051727,S&P反1國票97購01,0.90,0.90,0.88,0.89,0.00,0.00,30000,3,26750,0,0,0,0,0,0,25000,5000,20000,20000
20200520,051728,道瓊反國票97購01,1.03,1.04,1.01,1.01,+0.01,1.0,108000,11,110830,0,0,0,0,0,0,100000,8000,92000,92000
20200520,051729,華新國票96購01,,,,,0.00,0.00,0,0,0,0,0,0,0,0,0,0,0,0,0
20200520,051730,為升國票96購02,,,,,0.00,0.00,0,0,0,0,0,0,0,0,0,0,0,0,0
20200520,051731,聯電國票96購02,0.98,0.98,0.87,0.87,-0.21,-19.44,97000,3,91660,0,0,0,0,0,0,47000,50000,-3000,-3000
20200520,051732,華通國票97購01,,,,,0.00,0.00,0,0,0,0,0,0,0,0,0,0,0,0,0
20200520,051733,中環國票96購02,,,,,0.00,0.00,0,0,0,0,0,0,0,0,0,0,0,0,0
20200520,051735,台積電國票96購06,0.53,0.53,0.53,0.53,0.00,0.00,2000,1,1060,0,0,0,0,0,0,0,2000,-2000,-2000
20200520,051736,旺宏國票96購01,,,,,0.00,0.00,0,0,0,0,0,0,0,0,0,0,0,0,0
20200520,051737,瑞昱國票96購01,1.75,1.75,1.75,1.75,-0.63,-26.47,18000,7,31500,0,0,0,0,0,0,18000,0,18000,18000
20200520,051738,全新國票96購02,,,,,0.00,0.00,0,0,0,0,0,0,0,0,0,0,0,0,0
20200520,051739,奇力新國票97購01,1.70,1.70,1.70,1.70,0.00,0.00,4000,1,6800,0,0,0,0,0,0,4000,0,4000,4000
20200520,051740,可成國票96購04,,,,,0.00,0.00,0,0,0,0,0,0,0,0,0,0,0,0,0
20200520,051741,可成國票97購01,0.01,0.20,0.01,0.20,0.00,0.00,4000,2,230,0,0,0,0,0,0,3000,0,3000,3000
20200520,051742,欣興國票96購01,,,,,0.00,0.00,0,0,0,0,0,0,0,0,0,0,0,0,0
20200520,051743,揚明光國票96購02,,,,,0.00,0.00,0,0,0,0,0,0,0,0,0,0,0,0,0
20200520,051744,嘉聯益國票97購01,,,,,0.00,0.00,0,0,0,0,0,0,0,0,0,0,0,0,0
20200520,051745,玉晶光國泰97購06,1.54,1.75,1.54,1.73,+0.14,8.81,749000,29,1277610,0,0,0,0,0,0,4000,748000,-744000,-744000
20200520,051746,玉晶光國泰97購07,,,,,0.00,0.00,0,0,0,0,0,0,0,0,0,0,0,0,0
20200520,051747,貿聯國泰96購01,,,,,0.00,0.00,0,0,0,0,0,0,0,0,0,0,0,0,0
20200520,051748,超眾國泰96購01,,,,,0.00,0.00,0,0,0,0,0,0,0,0,0,0,0,0,0
20200520,051749,矽力國泰97購01,,,,,0.00,0.00,0,0,0,0,0,0,0,0,0,0,0,0,0
20200520,05174P,元金2X富邦9B售01,,,,,0.00,0.00,0,0,0,0,0,0,0,0,0,0,0,0,0
20200520,051750,華通富邦96購01,,,,,0.00,0.00,0,0,0,0,0,0,0,0,0,0,0,0,0
20200520,051752,緯穎富邦96購01,2.18,2.18,2.18,2.18,+0.12,5.83,5000,1,10900,0,0,0,0,0,0,5000,0,5000,5000
20200520,051753,華通元大96購03,,,,,0.00,0.00,0,0,0,0,0,0,0,0,0,0,0,0,0
20200520,051755,台積電元大96購08,,,,,0.00,0.00,0,0,0,0,0,0,0,0,0,0,0,0,0
20200520,051756,台積電元大97購04,,,,,0.00,0.00,0,0,0,0,0,0,0,0,0,0,0,0,0
20200520,05175P,TPK富邦99售01,,,,,0.00,0.00,0,0,0,0,0,0,0,0,0,0,0,0,0
20200520,051761,富邦金元大96購01,,,,,0.00,0.00,0,0,0,0,0,0,0,0,0,0,0,0,0
20200520,051763,新光金元大98購01,,,,,0.00,0.00,0,0,0,0,0,0,0,0,0,0,0,0,0
20200520,051774,聯茂中信96購01,,,,,0.00,0.00,0,0,0,0,0,0,0,0,0,0,0,0,0
20200520,051776,上証2X群益99購01,,,,,0.00,0.00,0,0,0,0,0,0,0,0,0,0,0,0,0
20200520,051781,緯穎群益96購01,,,,,0.00,0.00,0,0,0,0,0,0,0,0,0,0,0,0,0
20200520,051785,臻鼎兆豐96購01,,,,,0.00,0.00,0,0,0,0,0,0,0,0,0,0,0,0,0
20200520,051787,燿華國票96購02,,,,,0.00,0.00,0,0,0,0,0,0,0,0,0,0,0,0,0
20200520,051788,奇力新國票97購02,,,,,0.00,0.00,0,0,0,0,0,0,0,0,0,0,0,0,0
20200520,051789,嘉澤國票96購01,7.65,7.65,7.65,7.65,-0.50,-6.13,26000,1,198900,0,0,0,0,0,0,0,26000,-26000,-26000
20200520,05178P,大立光凱基96售05,,,,,0.00,0.00,0,0,0,0,0,0,0,0,0,0,0,0,0
20200520,051791,智伸科國票96購01,0.07,0.07,0.07,0.07,0.00,0.00,6000,1,420,0,0,0,0,0,0,6000,0,6000,6000
20200520,051792,泰鼎國票96購02,,,,,0.00,0.00,0,0,0,0,0,0,0,0,0,0,0,0,0
20200520,051794,臻鼎國票96購02,,,,,0.00,0.00,0,0,0,0,0,0,0,0,0,0,0,0,0
20200520,051795,T50反1台新05購02,,,,,0.00,0.00,0,0,0,0,0,0,0,0,0,0,0,0,0
20200520,051799,台積電永豐96購01,0.31,0.32,0.31,0.32,0.00,0.00,45000,3,14100,0,0,0,0,0,0,45000,0,45000,45000
20200520,05179P,大立光凱基96售06,,,,,0.00,0.00,0,0,0,0,0,0,0,0,0,0,0,0,0
20200520,051805,元黃金凱基97購02,,,,,0.00,0.00,0,0,0,0,0,0,0,0,0,0,0,0,0
20200520,051806,華通凱基96購02,,,,,0.00,0.00,0,0,0,0,0,0,0,0,0,0,0,0,0
20200520,051808,美律凱基96購02,,,,,0.00,0.00,0,0,0,0,0,0,0,0,0,0,0,0,0
20200520,051809,義隆凱基96購01,,,,,0.00,0.00,0,0,0,0,0,0,0,0,0,0,0,0,0
20200520,051813,GIS凱基96購02,,,,,0.00,0.00,0,0,0,0,0,0,0,0,0,0,0,0,0
20200520,051815,百和凱基96購01,,,,,0.00,0.00,0,0,0,0,0,0,0,0,0,0,0,0,0
20200520,051819,燿華統一96購01,,,,,0.00,0.00,0,0,0,0,0,0,0,0,0,0,0,0,0
20200520,051829,玉晶光元大98購02,,,,,0.00,0.00,0,0,0,0,0,0,0,0,0,0,0,0,0
20200520,051830,健策元大97購01,,,,,0.00,0.00,0,0,0,0,0,0,0,0,0,0,0,0,0
20200520,051831,緯穎元大96購04,,,,,0.00,0.00,0,0,0,0,0,0,0,0,0,0,0,0,0
20200520,051833,昇陽半元大96購01,,,,,0.00,0.00,0,0,0,0,0,0,0,0,0,0,0,0,0
20200520,051834,南電元大96購02,0.23,0.23,0.23,0.23,0.00,0.00,1000,1,230,0,0,0,0,0,0,0,1000,-1000,-1000
20200520,051837,國巨國泰96購04,,,,,0.00,0.00,0,0,0,0,0,0,0,0,0,0,0,0,0
20200520,051838,國巨國泰97購01,1.60,1.60,1.60,1.60,+0.15,10.34,10000,1,16000,0,0,0,0,0,0,10000,10000,0,0
20200520,051839,和鑫國泰96購01,,,,,0.00,0.00,0,0,0,0,0,0,0,0,0,0,0,0,0
20200520,051840,康友國泰97購02,,,,,0.00,0.00,0,0,0,0,0,0,0,0,0,0,0,0,0
20200520,051841,南茂國泰96購01,,,,,0.00,0.00,0,0,0,0,0,0,0,0,0,0,0,0,0
20200520,051842,大成鋼富邦97購01,,,,,0.00,0.00,0,0,0,0,0,0,0,0,0,0,0,0,0
20200520,051843,聯發科富邦99購01,1.60,1.94,1.59,1.59,+0.05,3.25,147000,12,240660,0,0,0,0,0,0,137000,0,137000,137000
20200520,051844,宏達電富邦96購01,,,,,0.00,0.00,0,0,0,0,0,0,0,0,0,0,0,0,0
20200520,051845,世紀鋼富邦96購01,0.46,0.46,0.46,0.46,0.00,0.00,4000,1,1840,0,0,0,0,0,0,4000,0,4000,4000
20200520,051846,S&P反1中信96購02,,,,,0.00,0.00,0,0,0,0,0,0,0,0,0,0,0,0,0
20200520,051847,香港反中信99購01,0.56,0.63,0.55,0.63,+0.02,3.28,54000,4,32900,0,0,0,0,0,0,0,54000,-54000,-54000
20200520,051848,元金2X中信98購02,,,,,0.00,0.00,0,0,0,0,0,0,0,0,0,0,0,0,0
20200520,051849,旺宏中信98購01,0.56,0.56,0.54,0.54,-0.01,-1.82,230000,7,126970,0,0,0,0,0,0,123000,107000,16000,16000
20200520,051850,臻鼎中信96購01,,,,,0.00,0.00,0,0,0,0,0,0,0,0,0,0,0,0,0
20200520,051855,道瓊反凱基97購01,,,,,0.00,0.00,0,0,0,0,0,0,0,0,0,0,0,0,0
20200520,051859,劍麟凱基96購01,,,,,0.00,0.00,0,0,0,0,0,0,0,0,0,0,0,0,0
20200520,051861,鴻海凱基98購01,,,,,0.00,0.00,0,0,0,0,0,0,0,0,0,0,0,0,0
20200520,051864,聯發科凱基96購03,,,,,0.00,0.00,0,0,0,0,0,0,0,0,0,0,0,0,0
20200520,051865,聯發科凱基96購04,0.84,1.17,0.84,1.07,+0.28,35.44,81000,12,76760,0,0,0,0,0,0,50000,31000,19000,19000
20200520,051866,聯發科凱基96購05,,,,,0.00,0.00,0,0,0,0,0,0,0,0,0,0,0,0,0
20200520,051868,貿聯凱基96購01,,,,,0.00,0.00,0,0,0,0,0,0,0,0,0,0,0,0,0
20200520,051869,康控凱基96購01,,,,,0.00,0.00,0,0,0,0,0,0,0,0,0,0,0,0,0
20200520,051872,矽力凱基96購01,3.16,3.16,3.16,3.16,-0.59,-15.73,10000,2,31600,0,0,0,0,0,0,0,10000,-10000,-10000
20200520,051876,宏達電國票96購01,,,,,0.00,0.00,0,0,0,0,0,0,0,0,0,0,0,0,0
20200520,051877,嘉聯益國票97購02,,,,,0.00,0.00,0,0,0,0,0,0,0,0,0,0,0,0,0
20200520,051878,鴻海台新96購01,,,,,0.00,0.00,0,0,0,0,0,0,0,0,0,0,0,0,0
20200520,051879,健策台新96購01,,,,,0.00,0.00,0,0,0,0,0,0,0,0,0,0,0,0,0
20200520,051887,上証2X元富98購01,,,,,0.00,0.00,0,0,0,0,0,0,0,0,0,0,0,0,0
20200520,051897,台光電國泰97購01,,,,,0.00,0.00,0,0,0,0,0,0,0,0,0,0,0,0,0
20200520,051898,富邦金國泰97購01,0.82,0.82,0.82,0.82,0.00,0.00,166000,1,136120,0,0,0,0,0,0,166000,0,166000,166000
20200520,051899,欣興國泰97購01,,,,,0.00,0.00,0,0,0,0,0,0,0,0,0,0,0,0,0
20200520,05189P,新光金凱基97售02,,,,,0.00,0.00,0,0,0,0,0,0,0,0,0,0,0,0,0
20200520,051901,嘉聯益富邦96購01,,,,,0.00,0.00,0,0,0,0,0,0,0,0,0,0,0,0,0
20200520,051902,T50反1元大97購01,1.03,1.03,1.03,1.03,-0.04,-3.74,20000,1,20600,0,0,0,0,0,0,0,20000,-20000,-20000
20200520,051903,T50反1元大97購02,0.98,1.02,0.98,1.02,0.00,0.00,20000,2,20200,0,0,0,0,0,0,5000,15000,-10000,-10000
20200520,051907,台積電元大97購05,0.51,0.51,0.45,0.46,-0.08,-14.81,41000,8,19540,0,0,0,0,0,0,16000,0,16000,16000
20200520,051908,國泰金元大96購02,,,,,0.00,0.00,0,0,0,0,0,0,0,0,0,0,0,0,0
20200520,05190P,鴻海國票96售02,,,,,0.00,0.00,0,0,0,0,0,0,0,0,0,0,0,0,0
20200520,051910,大立光元大97購01,,,,,0.00,0.00,0,0,0,0,0,0,0,0,0,0,0,0,0
20200520,051911,大立光元大98購02,0.54,0.54,0.54,0.54,+0.12,28.57,1000,1,540,0,0,0,0,0,0,0,0,0,0
20200520,051912,健鼎元大96購01,,,,,0.00,0.00,0,0,0,0,0,0,0,0,0,0,0,0,0
20200520,051913,緯創元大96購01,0.12,0.12,0.11,0.11,0.00,0.00,380000,2,42800,0,0,0,0,0,0,380000,0,380000,380000
20200520,051914,健策元大96購06,1.53,1.53,1.53,1.53,0.00,0.00,100000,1,153000,0,0,0,0,0,0,100000,100000,0,0
20200520,051915,日月光元大96購01,,,,,0.00,0.00,0,0,0,0,0,0,0,0,0,0,0,0,0
20200520,051919,台郡元大96購02,0.40,0.40,0.40,0.40,0.00,0.00,10000,1,4000,0,0,0,0,0,0,0,10000,-10000,-10000
20200520,051922,鴻海亞東96購02,,,,,0.00,0.00,0,0,0,0,0,0,0,0,0,0,0,0,0
20200520,051926,聯電中信97購01,,,,,0.00,0.00,0,0,0,0,0,0,0,0,0,0,0,0,0
20200520,051927,國巨中信96購01,,,,,0.00,0.00,0,0,0,0,0,0,0,0,0,0,0,0,0
20200520,051928,大立光中信96購03,,,,,0.00,0.00,0,0,0,0,0,0,0,0,0,0,0,0,0
20200520,051929,GIS中信96購01,,,,,0.00,0.00,0,0,0,0,0,0,0,0,0,0,0,0,0
20200520,05192P,玉晶光台新96售02,,,,,0.00,0.00,0,0,0,0,0,0,0,0,0,0,0,0,0
20200520,051930,國泰金兆豐97購01,,,,,0.00,0.00,0,0,0,0,0,0,0,0,0,0,0,0,0
20200520,051931,美律國票96購02,0.16,0.16,0.16,0.16,0.00,0.00,61000,1,9760,0,0,0,0,0,0,61000,0,61000,61000
20200520,051932,康控國票96購02,,,,,0.00,0.00,0,0,0,0,0,0,0,0,0,0,0,0,0
20200520,051933,嘉聯益國票97購03,,,,,0.00,0.00,0,0,0,0,0,0,0,0,0,0,0,0,0
20200520,051934,緯穎國票96購01,,,,,0.00,0.00,0,0,0,0,0,0,0,0,0,0,0,0,0
20200520,051939,同欣電群益97購01,1.04,1.04,1.04,1.04,+0.03,2.97,2000,1,2080,0,0,0,0,0,0,2000,0,2000,2000
20200520,051946,健策統一98購01,,,,,0.00,0.00,0,0,0,0,0,0,0,0,0,0,0,0,0
20200520,051948,滬深2X元富9B購01,0.35,0.35,0.35,0.35,0.00,0.00,209000,1,73150,0,0,0,0,0,0,209000,209000,0,0
20200520,051956,滬深2X台新96購01,,,,,0.00,0.00,0,0,0,0,0,0,0,0,0,0,0,0,0
20200520,051970,元黃金凱基98購01,1.06,1.12,1.06,1.12,+0.17,17.89,21000,4,23160,0,0,0,0,0,0,0,15000,-15000,-15000
20200520,051971,元金2X凱基97購02,1.24,1.25,1.12,1.23,-0.02,-1.6,350000,40,426620,0,0,0,0,0,0,0,0,0,0
20200520,051973,華新科凱基96購04,,,,,0.00,0.00,0,0,0,0,0,0,0,0,0,0,0,0,0
20200520,051974,華新科凱基96購05,,,,,0.00,0.00,0,0,0,0,0,0,0,0,0,0,0,0,0
20200520,051978,泰碩凱基96購01,,,,,0.00,0.00,0,0,0,0,0,0,0,0,0,0,0,0,0
20200520,051979,群創凱基97購01,,,,,0.00,0.00,0,0,0,0,0,0,0,0,0,0,0,0,0
20200520,051980,樺漢凱基96購01,,,,,0.00,0.00,0,0,0,0,0,0,0,0,0,0,0,0,0
20200520,051981,南茂凱基96購01,0.01,0.01,0.01,0.01,0.00,0.00,10000,1,100,0,0,0,0,0,0,10000,0,10000,10000
20200520,051986,燿華元大96購04,,,,,0.00,0.00,0,0,0,0,0,0,0,0,0,0,0,0,0
20200520,051994,瀚宇博元大96購01,,,,,0.00,0.00,0,0,0,0,0,0,0,0,0,0,0,0,0
20200520,051998,昇陽半元大96購02,,,,,0.00,0.00,0,0,0,0,0,0,0,0,0,0,0,0,0
20200520,052002,滬深2X國泰96購01,,,,,0.00,0.00,0,0,0,0,0,0,0,0,0,0,0,0,0
20200520,052003,泰碩國泰97購02,0.93,0.93,0.85,0.85,-0.10,-10.53,504000,14,445580,0,0,0,0,0,0,407000,135000,272000,272000
20200520,052004,泰碩國泰97購03,,,,,0.00,0.00,0,0,0,0,0,0,0,0,0,0,0,0,0
20200520,052005,矽力國泰97購02,6.10,6.10,6.10,6.10,-0.20,-3.17,1000,1,6100,0,0,0,0,0,0,0,0,0,0
20200520,052006,康友富邦98購01,,,,,0.00,0.00,0,0,0,0,0,0,0,0,0,0,0,0,0
20200520,052011,欣興中信96購01,,,,,0.00,0.00,0,0,0,0,0,0,0,0,0,0,0,0,0
20200520,05201P,玉晶光國泰97售02,,,,,0.00,0.00,0,0,0,0,0,0,0,0,0,0,0,0,0
20200520,052025,國巨群益96購01,2.87,2.87,2.82,2.82,+0.33,13.25,22000,3,63090,0,0,0,0,0,0,2000,22000,-20000,-20000
20200520,052037,全新國泰96購02,,,,,0.00,0.00,0,0,0,0,0,0,0,0,0,0,0,0,0
20200520,052038,國巨永昌96購01,3.60,3.60,3.00,3.06,+0.60,24.39,23000,4,75180,0,0,0,0,0,0,10000,23000,-13000,-13000
20200520,052039,聯詠永昌96購01,,,,,0.00,0.00,0,0,0,0,0,0,0,0,0,0,0,0,0
20200520,052044,華通凱基97購01,0.01,0.01,0.01,0.01,-0.01,-50.0,1848000,16,18480,70000,0,70000,0,0,0,0,0,0,70000
20200520,052045,瑞昱凱基96購01,0.91,0.97,0.73,0.73,-0.20,-21.51,257000,29,233230,0,0,0,0,0,0,247000,0,247000,247000
20200520,052046,漢唐凱基96購01,,,,,0.00,0.00,0,0,0,0,0,0,0,0,0,0,0,0,0
20200520,052047,建準凱基96購01,1.04,1.04,1.01,1.01,-0.03,-2.88,60000,3,62040,0,0,0,0,0,0,60000,0,60000,60000
20200520,052049,緯創凱基97購01,1.23,1.24,1.22,1.22,-0.02,-1.61,92000,6,112660,0,0,0,0,0,0,40000,52000,-12000,-12000
20200520,052053,泰鼎凱基96購01,2.05,2.05,2.05,2.05,+0.11,5.67,30000,1,61500,0,0,0,0,0,0,30000,30000,0,0
20200520,052054,台表科凱基96購01,0.82,1.19,0.72,1.17,+0.42,56.0,261000,42,243600,0,0,0,0,0,0,110000,141000,-31000,-31000
20200520,052060,旺宏國票96購02,,,,,0.00,0.00,0,0,0,0,0,0,0,0,0,0,0,0,0
20200520,052061,樺漢國票96購01,,,,,0.00,0.00,0,0,0,0,0,0,0,0,0,0,0,0,0
20200520,052066,華邦電兆豐96購01,,,,,0.00,0.00,0,0,0,0,0,0,0,0,0,0,0,0,0
20200520,052067,中磊兆豐96購01,,,,,0.00,0.00,0,0,0,0,0,0,0,0,0,0,0,0,0
20200520,052068,瑞儀兆豐96購01,0.25,0.25,0.25,0.25,0.00,0.00,5000,1,1250,0,0,0,0,0,0,0,5000,-5000,-5000
20200520,052069,聯茂兆豐96購01,0.24,0.24,0.24,0.24,0.00,0.00,10000,1,2400,0,0,0,0,0,0,10000,0,10000,10000
20200520,052076,可成元富98購01,,,,,0.00,0.00,0,0,0,0,0,0,0,0,0,0,0,0,0
20200520,052077,可成元富98購02,0.48,0.48,0.45,0.45,-0.11,-19.64,203000,10,96110,0,0,0,0,0,0,149000,49000,100000,100000
20200520,052079,康友元富98購01,,,,,0.00,0.00,0,0,0,0,0,0,0,0,0,0,0,0,0
20200520,05207P,高股息中信97售03,,,,,0.00,0.00,0,0,0,0,0,0,0,0,0,0,0,0,0
20200520,052080,康友元富98購02,,,,,0.00,0.00,0,0,0,0,0,0,0,0,0,0,0,0,0
20200520,052083,S&P反1元大97購02,,,,,0.00,0.00,0,0,0,0,0,0,0,0,0,0,0,0,0
20200520,052086,鴻海元大96購08,,,,,0.00,0.00,0,0,0,0,0,0,0,0,0,0,0,0,0
20200520,052087,鴻海元大96購09,,,,,0.00,0.00,0,0,0,0,0,0,0,0,0,0,0,0,0
20200520,052089,聯發科元大96購02,1.71,1.71,1.71,1.71,+0.42,32.56,5000,1,8550,0,0,0,0,0,0,5000,0,5000,5000
20200520,052090,聯發科元大97購03,1.06,1.06,1.06,1.06,+0.23,27.71,25000,1,26500,0,0,0,0,0,0,25000,0,25000,25000
20200520,052092,貿聯元大96購02,,,,,0.00,0.00,0,0,0,0,0,0,0,0,0,0,0,0,0
20200520,052093,麗豐元大96購04,,,,,0.00,0.00,0,0,0,0,0,0,0,0,0,0,0,0,0
20200520,052094,瀚宇博元大96購02,,,,,0.00,0.00,0,0,0,0,0,0,0,0,0,0,0,0,0
20200520,052095,彩晶元大97購01,,,,,0.00,0.00,0,0,0,0,0,0,0,0,0,0,0,0,0
20200520,05209P,鴻海凱基96售09,,,,,0.00,0.00,0,0,0,0,0,0,0,0,0,0,0,0,0
20200520,052100,滬深2X永昌96購01,,,,,0.00,0.00,0,0,0,0,0,0,0,0,0,0,0,0,0
20200520,052101,滬深2X兆豐96購01,,,,,0.00,0.00,0,0,0,0,0,0,0,0,0,0,0,0,0
20200520,052102,台泥兆豐96購01,0.73,0.74,0.73,0.73,-0.06,-7.59,186000,9,136640,0,0,0,0,0,0,136000,50000,86000,86000
20200520,052104,英業達兆豐96購01,,,,,0.00,0.00,0,0,0,0,0,0,0,0,0,0,0,0,0
20200520,052112,滬深2X中信99購01,,,,,0.00,0.00,0,0,0,0,0,0,0,0,0,0,0,0,0
20200520,052113,漢唐中信98購01,0.35,0.35,0.35,0.35,-0.01,-2.78,15000,1,5250,0,0,0,0,0,0,15000,0,15000,15000
20200520,052116,T50反1國票97購01,,,,,0.00,0.00,0,0,0,0,0,0,0,0,0,0,0,0,0
20200520,052117,鴻海國票96購03,,,,,0.00,0.00,0,0,0,0,0,0,0,0,0,0,0,0,0
20200520,052118,鴻海國票96購04,,,,,0.00,0.00,0,0,0,0,0,0,0,0,0,0,0,0,0
20200520,052119,漢唐國票96購01,,,,,0.00,0.00,0,0,0,0,0,0,0,0,0,0,0,0,0
20200520,05211P,國巨國票96售05,,,,,0.00,0.00,0,0,0,0,0,0,0,0,0,0,0,0,0
20200520,052120,友達國票96購01,,,,,0.00,0.00,0,0,0,0,0,0,0,0,0,0,0,0,0
20200520,052121,全新國票96購03,,,,,0.00,0.00,0,0,0,0,0,0,0,0,0,0,0,0,0
20200520,052122,新光金國票96購01,,,,,0.00,0.00,0,0,0,0,0,0,0,0,0,0,0,0,0
20200520,052126,群創國票97購01,,,,,0.00,0.00,0,0,0,0,0,0,0,0,0,0,0,0,0
20200520,052127,日月光國票96購01,,,,,0.00,0.00,0,0,0,0,0,0,0,0,0,0,0,0,0
20200520,052129,鴻海凱基97購02,,,,,0.00,0.00,0,0,0,0,0,0,0,0,0,0,0,0,0
20200520,05212P,台積電國票96售04,2.52,2.52,2.50,2.50,0.00,0.00,49000,2,122520,0,0,0,0,0,0,0,49000,-49000,-49000
20200520,052130,國巨凱基9B購01,1.69,1.69,1.69,1.69,+0.18,11.92,1000,1,1690,0,0,0,0,0,0,1000,0,1000,1000
20200520,052131,台積電凱基96購01,,,,,0.00,0.00,0,0,0,0,0,0,0,0,0,0,0,0,0
20200520,052132,旺宏凱基9B購01,,,,,0.00,0.00,0,0,0,0,0,0,0,0,0,0,0,0,0
20200520,052133,華邦電凱基9B購01,,,,,0.00,0.00,0,0,0,0,0,0,0,0,0,0,0,0,0
20200520,052135,聯發科凱基9B購01,1.78,2.01,1.74,1.81,+0.14,8.38,1755000,35,3255630,0,0,0,0,0,0,1742000,0,1742000,1742000
20200520,052137,台表科凱基96購02,0.61,0.95,0.56,0.90,+0.36,66.67,676000,64,467090,0,0,0,0,0,0,333000,315000,18000,18000
20200520,052138,易華電凱基97購01,,,,,0.00,0.00,0,0,0,0,0,0,0,0,0,0,0,0,0
20200520,05213P,台積電國票96售05,0.61,0.61,0.61,0.61,-0.08,-11.59,21000,2,12810,0,0,0,0,0,0,1000,20000,-19000,-19000
20200520,052142,滬深2X群益99購04,,,,,0.00,0.00,0,0,0,0,0,0,0,0,0,0,0,0,0
20200520,05214P,台積電國票97售02,,,,,0.00,0.00,0,0,0,0,0,0,0,0,0,0,0,0,0
20200520,052151,義隆富邦96購01,,,,,0.00,0.00,0,0,0,0,0,0,0,0,0,0,0,0,0
20200520,052152,創意富邦98購01,0.11,0.13,0.11,0.13,0.00,0.00,413000,6,45470,0,0,0,0,0,0,405000,8000,397000,397000
20200520,052153,GIS富邦96購02,,,,,0.00,0.00,0,0,0,0,0,0,0,0,0,0,0,0,0
20200520,052167,亞泥元大96購01,0.60,0.62,0.57,0.61,-0.01,-1.61,762000,14,450580,0,0,0,0,0,0,349000,410000,-61000,-61000
20200520,052168,鴻海元大96購10,,,,,0.00,0.00,0,0,0,0,0,0,0,0,0,0,0,0,0
20200520,052169,鴻海元大97購02,,,,,0.00,0.00,0,0,0,0,0,0,0,0,0,0,0,0,0
20200520,052176,景碩元大96購01,,,,,0.00,0.00,0,0,0,0,0,0,0,0,0,0,0,0,0
20200520,052178,台郡元大96購03,,,,,0.00,0.00,0,0,0,0,0,0,0,0,0,0,0,0,0
20200520,052180,緯穎元大96購05,,,,,0.00,0.00,0,0,0,0,0,0,0,0,0,0,0,0,0
20200520,052182,鴻海群益96購01,,,,,0.00,0.00,0,0,0,0,0,0,0,0,0,0,0,0,0
20200520,052183,華邦電群益95購01,,,,,0.00,0.00,0,0,0,0,0,0,0,0,0,0,0,0,0
20200520,052184,台光電群益95購03,,,,,0.00,0.00,0,0,0,0,0,0,0,0,0,0,0,0,0
20200520,052185,奇力新群益95購03,,,,,0.00,0.00,0,0,0,0,0,0,0,0,0,0,0,0,0
20200520,052186,宏達電群益95購04,,,,,0.00,0.00,0,0,0,0,0,0,0,0,0,0,0,0,0
20200520,052187,奇鋐群益95購03,,,,,0.00,0.00,0,0,0,0,0,0,0,0,0,0,0,0,0
20200520,052188,欣興群益95購03,,,,,0.00,0.00,0,0,0,0,0,0,0,0,0,0,0,0,0
20200520,052189,玉晶光群益96購06,,,,,0.00,0.00,0,0,0,0,0,0,0,0,0,0,0,0,0
20200520,05218P,大立光永昌96售04,,,,,0.00,0.00,0,0,0,0,0,0,0,0,0,0,0,0,0
20200520,052190,創意群益95購03,,,,,0.00,0.00,0,0,0,0,0,0,0,0,0,0,0,0,0
20200520,052191,超眾群益96購01,4.70,4.70,4.70,4.70,+0.03,0.64,16000,1,75200,0,0,0,0,0,0,0,16000,-16000,-16000
20200520,052192,SP黃豆元富95購04,,,,,0.00,0.00,0,0,0,0,0,0,0,0,0,0,0,0,0
20200520,052193,國巨元富95購06,0.70,0.70,0.68,0.70,+0.24,52.17,300000,3,208000,0,0,0,0,0,0,300000,300000,0,0
20200520,052194,旺宏元富95購04,,,,,0.00,0.00,0,0,0,0,0,0,0,0,0,0,0,0,0
20200520,052195,健策元富95購01,,,,,0.00,0.00,0,0,0,0,0,0,0,0,0,0,0,0,0
20200520,052196,TPK元富95購01,,,,,0.00,0.00,0,0,0,0,0,0,0,0,0,0,0,0,0
20200520,052197,台郡元富95購03,,,,,0.00,0.00,0,0,0,0,0,0,0,0,0,0,0,0,0
20200520,052198,鴻海統一95購10,,,,,0.00,0.00,0,0,0,0,0,0,0,0,0,0,0,0,0
20200520,052199,鴻海統一95購11,,,,,0.00,0.00,0,0,0,0,0,0,0,0,0,0,0,0,0
20200520,052200,台光電統一95購02,,,,,0.00,0.00,0,0,0,0,0,0,0,0,0,0,0,0,0
20200520,052201,超眾統一96購01,,,,,0.00,0.00,0,0,0,0,0,0,0,0,0,0,0,0,0
20200520,052202,矽力統一96購01,,,,,0.00,0.00,0,0,0,0,0,0,0,0,0,0,0,0,0
20200520,052203,T50反1中信99購03,0.97,1.00,0.96,0.98,0.00,0.00,140000,12,136200,0,0,0,0,0,0,30000,110000,-80000,-80000
20200520,052204,台泥中信96購01,,,,,0.00,0.00,0,0,0,0,0,0,0,0,0,0,0,0,0
20200520,052205,台積電中信95購09,,,,,0.00,0.00,0,0,0,0,0,0,0,0,0,0,0,0,0
20200520,052206,燿華中信95購02,,,,,0.00,0.00,0,0,0,0,0,0,0,0,0,0,0,0,0
20200520,052207,台郡中信95購02,,,,,0.00,0.00,0,0,0,0,0,0,0,0,0,0,0,0,0
20200520,052208,力成麥證95購01,,,,,0.00,0.00,0,0,0,0,0,0,0,0,0,0,0,0,0
20200520,052209,深中小元大95購02,,,,,0.00,0.00,0,0,0,0,0,0,0,0,0,0,0,0,0
20200520,052210,華夏元大95購01,,,,,0.00,0.00,0,0,0,0,0,0,0,0,0,0,0,0,0
20200520,052211,台積電元大95購22,,,,,0.00,0.00,0,0,0,0,0,0,0,0,0,0,0,0,0
20200520,052212,可成元大95購11,,,,,0.00,0.00,0,0,0,0,0,0,0,0,0,0,0,0,0
20200520,052213,富邦金元大95購01,,,,,0.00,0.00,0,0,0,0,0,0,0,0,0,0,0,0,0
20200520,052214,智伸科元大96購01,0.09,0.09,0.09,0.09,0.00,0.00,5000,1,450,0,0,0,0,0,0,0,0,0,0
20200520,052215,樺漢元大96購02,0.02,0.02,0.02,0.02,+0.01,100.0,20000,1,400,0,0,0,0,0,0,20000,0,20000,20000
20200520,052216,康友元大96購01,,,,,0.00,0.00,0,0,0,0,0,0,0,0,0,0,0,0,0
20200520,052217,台光電日盛95購01,,,,,0.00,0.00,0,0,0,0,0,0,0,0,0,0,0,0,0
20200520,052218,大立光日盛95購01,,,,,0.00,0.00,0,0,0,0,0,0,0,0,0,0,0,0,0
20200520,052219,大立光日盛95購02,,,,,0.00,0.00,0,0,0,0,0,0,0,0,0,0,0,0,0
20200520,052220,T50反1凱基98購01,1.25,1.25,1.24,1.24,0.00,0.00,41000,4,51090,0,0,0,0,0,0,31000,10000,21000,21000
20200520,052221,東元凱基95購01,,,,,0.00,0.00,0,0,0,0,0,0,0,0,0,0,0,0,0
20200520,052222,力山凱基95購02,,,,,0.00,0.00,0,0,0,0,0,0,0,0,0,0,0,0,0
20200520,052223,聯電凱基96購02,0.27,0.27,0.25,0.25,-0.06,-19.35,600000,5,156000,0,0,0,0,0,0,200000,400000,-200000,-200000
20200520,052224,楠梓電凱基97購01,,,,,0.00,0.00,0,0,0,0,0,0,0,0,0,0,0,0,0
20200520,052225,台積電凱基96購03,0.01,0.01,0.01,0.01,0.00,0.00,10000,10,100,0,0,0,0,0,0,0,0,0,0
20200520,052226,旺宏凱基95購06,,,,,0.00,0.00,0,0,0,0,0,0,0,0,0,0,0,0,0
20200520,052227,瑞昱凱基95購05,,,,,0.00,0.00,0,0,0,0,0,0,0,0,0,0,0,0,0
20200520,052228,聯發科凱基96購06,,,,,0.00,0.00,0,0,0,0,0,0,0,0,0,0,0,0,0
20200520,052229,奇力新凱基96購01,0.58,0.62,0.56,0.56,+0.04,7.69,118000,5,72900,0,0,0,0,0,0,115000,3000,112000,112000
20200520,052230,大立光凱基96購09,1.01,1.02,1.01,1.02,0.00,0.00,87000,3,88280,0,0,0,0,0,0,0,87000,-87000,-87000
20200520,052231,景碩凱基96購01,,,,,0.00,0.00,0,0,0,0,0,0,0,0,0,0,0,0,0
20200520,052232,貿聯凱基96購02,,,,,0.00,0.00,0,0,0,0,0,0,0,0,0,0,0,0,0
20200520,052233,台郡凱基96購01,,,,,0.00,0.00,0,0,0,0,0,0,0,0,0,0,0,0,0
20200520,052234,GIS凱基97購01,0.95,0.96,0.95,0.96,0.00,0.00,131000,2,124970,0,0,0,0,0,0,0,131000,-131000,-131000
20200520,052235,聯發科國票96購02,2.47,3.15,2.47,2.62,+0.23,9.62,206000,16,558110,0,0,0,0,0,0,67000,139000,-72000,-72000
20200520,052236,聯發科國票96購03,,,,,0.00,0.00,0,0,0,0,0,0,0,0,0,0,0,0,0
20200520,052237,嘉澤國票96購02,,,,,0.00,0.00,0,0,0,0,0,0,0,0,0,0,0,0,0
20200520,052238,智易國票96購01,0.32,0.32,0.32,0.32,0.00,0.00,100000,1,32000,0,0,0,0,0,0,100000,0,100000,100000
20200520,052239,泰鼎國票97購01,4.03,4.41,4.03,4.41,+0.20,4.75,58000,6,244520,0,0,0,0,0,0,38000,20000,18000,18000
20200520,052240,臻鼎國票96購03,,,,,0.00,0.00,0,0,0,0,0,0,0,0,0,0,0,0,0
20200520,052241,台郡國票96購01,,,,,0.00,0.00,0,0,0,0,0,0,0,0,0,0,0,0,0
20200520,052242,台達電台新96購01,,,,,0.00,0.00,0,0,0,0,0,0,0,0,0,0,0,0,0
20200520,052243,致茂康和95購01,,,,,0.00,0.00,0,0,0,0,0,0,0,0,0,0,0,0,0
20200520,052244,廣達康和95購01,,,,,0.00,0.00,0,0,0,0,0,0,0,0,0,0,0,0,0
20200520,052245,緯創康和95購01,,,,,0.00,0.00,0,0,0,0,0,0,0,0,0,0,0,0,0
20200520,052246,超眾康和95購01,,,,,0.00,0.00,0,0,0,0,0,0,0,0,0,0,0,0,0
20200520,052247,深中小永豐95購01,,,,,0.00,0.00,0,0,0,0,0,0,0,0,0,0,0,0,0
20200520,052248,元油反永豐95購01,,,,,0.00,0.00,0,0,0,0,0,0,0,0,0,0,0,0,0
20200520,052249,大成鋼永豐95購01,,,,,0.00,0.00,0,0,0,0,0,0,0,0,0,0,0,0,0
20200520,052250,光磊永豐95購01,,,,,0.00,0.00,0,0,0,0,0,0,0,0,0,0,0,0,0
20200520,052251,台光電永豐95購03,,,,,0.00,0.00,0,0,0,0,0,0,0,0,0,0,0,0,0
20200520,052252,大立光永豐95購03,,,,,0.00,0.00,0,0,0,0,0,0,0,0,0,0,0,0,0
20200520,052253,康控永豐95購04,,,,,0.00,0.00,0,0,0,0,0,0,0,0,0,0,0,0,0
20200520,052254,康友永豐95購03,,,,,0.00,0.00,0,0,0,0,0,0,0,0,0,0,0,0,0
20200520,052255,T50反1國泰96購01,,,,,0.00,0.00,0,0,0,0,0,0,0,0,0,0,0,0,0
20200520,052256,台泥國泰96購01,,,,,0.00,0.00,0,0,0,0,0,0,0,0,0,0,0,0,0
20200520,052257,燿華國泰96購01,,,,,0.00,0.00,0,0,0,0,0,0,0,0,0,0,0,0,0
20200520,052258,滬深2X富邦96購04,0.01,0.01,0.01,0.01,0.00,0.00,20000,1,200,0,0,0,0,0,0,0,0,0,0
20200520,052259,深100富邦95購01,,,,,0.00,0.00,0,0,0,0,0,0,0,0,0,0,0,0,0
20200520,052260,為升富邦97購02,0.07,0.07,0.07,0.07,0.00,0.00,20000,1,1400,0,0,0,0,0,0,0,0,0,0
20200520,052261,台泥第一95購01,,,,,0.00,0.00,0,0,0,0,0,0,0,0,0,0,0,0,0
20200520,052262,華新亞東95購02,,,,,0.00,0.00,0,0,0,0,0,0,0,0,0,0,0,0,0
20200520,052263,聯電亞東95購01,,,,,0.00,0.00,0,0,0,0,0,0,0,0,0,0,0,0,0
20200520,052264,台達電亞東96購01,,,,,0.00,0.00,0,0,0,0,0,0,0,0,0,0,0,0,0
20200520,052265,聯發科亞東95購01,0.44,0.44,0.44,0.44,+0.13,41.94,100000,1,44000,0,0,0,0,0,0,100000,0,100000,100000
20200520,052266,義隆亞東95購02,,,,,0.00,0.00,0,0,0,0,0,0,0,0,0,0,0,0,0
20200520,052267,可成亞東95購02,,,,,0.00,0.00,0,0,0,0,0,0,0,0,0,0,0,0,0
20200520,052268,新光金亞東96購01,,,,,0.00,0.00,0,0,0,0,0,0,0,0,0,0,0,0,0
20200520,052269,T50反1日盛9B購01,0.90,0.90,0.90,0.90,+0.10,12.5,3000,1,2700,0,0,0,0,0,0,0,0,0,0
20200520,052270,力成日盛95購01,,,,,0.00,0.00,0,0,0,0,0,0,0,0,0,0,0,0,0
20200520,052271,力成日盛95購02,,,,,0.00,0.00,0,0,0,0,0,0,0,0,0,0,0,0,0
20200520,052272,T50反1群益95購03,0.29,0.29,0.29,0.29,0.00,0.00,10000,1,2900,0,0,0,0,0,0,10000,0,10000,10000
20200520,052273,新光金群益95購02,,,,,0.00,0.00,0,0,0,0,0,0,0,0,0,0,0,0,0
20200520,052274,大立光群益95購03,,,,,0.00,0.00,0,0,0,0,0,0,0,0,0,0,0,0,0
20200520,052275,日月光群益95購01,,,,,0.00,0.00,0,0,0,0,0,0,0,0,0,0,0,0,0
20200520,052276,力成群益96購01,,,,,0.00,0.00,0,0,0,0,0,0,0,0,0,0,0,0,0
20200520,052277,台達電凱基97購01,0.12,0.12,0.11,0.12,0.00,0.00,100000,14,11600,0,0,0,0,0,0,100000,0,100000,100000
20200520,052278,國巨凱基95購06,,,,,0.00,0.00,0,0,0,0,0,0,0,0,0,0,0,0,0
20200520,052279,旺宏凱基95購07,,,,,0.00,0.00,0,0,0,0,0,0,0,0,0,0,0,0,0
20200520,052280,聯發科凱基95購11,,,,,0.00,0.00,0,0,0,0,0,0,0,0,0,0,0,0,0
20200520,052281,全新凱基97購01,,,,,0.00,0.00,0,0,0,0,0,0,0,0,0,0,0,0,0
20200520,052282,宏達電凱基95購05,,,,,0.00,0.00,0,0,0,0,0,0,0,0,0,0,0,0,0
20200520,052283,TPK凱基97購01,,,,,0.00,0.00,0,0,0,0,0,0,0,0,0,0,0,0,0
20200520,052284,日月光凱基96購01,,,,,0.00,0.00,0,0,0,0,0,0,0,0,0,0,0,0,0
20200520,052285,康控凱基95購02,,,,,0.00,0.00,0,0,0,0,0,0,0,0,0,0,0,0,0
20200520,052286,力成凱基95購02,,,,,0.00,0.00,0,0,0,0,0,0,0,0,0,0,0,0,0
20200520,052287,臺股指中信95購12,,,,,0.00,0.00,0,0,0,0,0,0,0,0,0,0,0,0,0
20200520,052288,敦南統一95購01,,,,,0.00,0.00,0,0,0,0,0,0,0,0,0,0,0,0,0
20200520,052289,為升元富95購02,,,,,0.00,0.00,0,0,0,0,0,0,0,0,0,0,0,0,0
20200520,052290,鴻海元富97購01,,,,,0.00,0.00,0,0,0,0,0,0,0,0,0,0,0,0,0
20200520,052291,鴻海元富97購02,,,,,0.00,0.00,0,0,0,0,0,0,0,0,0,0,0,0,0
20200520,052292,緯穎元富95購02,,,,,0.00,0.00,0,0,0,0,0,0,0,0,0,0,0,0,0
20200520,052293,泰碩國票95購03,,,,,0.00,0.00,0,0,0,0,0,0,0,0,0,0,0,0,0
20200520,052294,創意國票96購03,,,,,0.00,0.00,0,0,0,0,0,0,0,0,0,0,0,0,0
20200520,052295,揚明光國票96購03,,,,,0.00,0.00,0,0,0,0,0,0,0,0,0,0,0,0,0
20200520,052296,TPK國票96購01,0.01,0.01,0.01,0.01,0.00,0.00,30000,1,300,0,0,0,0,0,0,30000,0,30000,30000
20200520,052297,旭富國票96購01,,,,,0.00,0.00,0,0,0,0,0,0,0,0,0,0,0,0,0
20200520,052298,易華電國票96購01,,,,,0.00,0.00,0,0,0,0,0,0,0,0,0,0,0,0,0
20200520,052299,T50反1台新05購03,,,,,0.00,0.00,0,0,0,0,0,0,0,0,0,0,0,0,0
20200520,052300,力成台新95購01,,,,,0.00,0.00,0,0,0,0,0,0,0,0,0,0,0,0,0
20200520,052301,華通康和95購01,,,,,0.00,0.00,0,0,0,0,0,0,0,0,0,0,0,0,0
20200520,052302,鴻海永豐95購06,,,,,0.00,0.00,0,0,0,0,0,0,0,0,0,0,0,0,0
20200520,052303,聯發科永豐95購05,,,,,0.00,0.00,0,0,0,0,0,0,0,0,0,0,0,0,0
20200520,052304,可成永豐95購03,,,,,0.00,0.00,0,0,0,0,0,0,0,0,0,0,0,0,0
20200520,052305,GIS永豐95購03,,,,,0.00,0.00,0,0,0,0,0,0,0,0,0,0,0,0,0
20200520,052306,鴻海國泰97購05,,,,,0.00,0.00,0,0,0,0,0,0,0,0,0,0,0,0,0
20200520,052307,潤泰全國泰96購01,,,,,0.00,0.00,0,0,0,0,0,0,0,0,0,0,0,0,0
20200520,052308,大立光國泰97購02,0.17,0.17,0.17,0.17,0.00,0.00,20000,1,3400,0,0,0,0,0,0,20000,0,20000,20000
20200520,052309,健策國泰97購01,,,,,0.00,0.00,0,0,0,0,0,0,0,0,0,0,0,0,0
20200520,052310,聯電富邦95購01,,,,,0.00,0.00,0,0,0,0,0,0,0,0,0,0,0,0,0
20200520,052311,台積電富邦95購09,,,,,0.00,0.00,0,0,0,0,0,0,0,0,0,0,0,0,0
20200520,052312,美律富邦96購02,,,,,0.00,0.00,0,0,0,0,0,0,0,0,0,0,0,0,0
20200520,052313,聯電元大98購01,0.60,0.60,0.54,0.54,-0.04,-6.9,102000,8,59020,0,0,0,0,0,0,0,102000,-102000,-102000
20200520,052314,鴻海元大96購11,,,,,0.00,0.00,0,0,0,0,0,0,0,0,0,0,0,0,0
20200520,052315,廣宇元大95購02,,,,,0.00,0.00,0,0,0,0,0,0,0,0,0,0,0,0,0
20200520,052316,台積電元大96購10,0.10,0.10,0.10,0.10,-0.02,-16.67,21000,1,2100,0,0,0,0,0,0,21000,0,21000,21000
20200520,052317,台積電元大96購11,,,,,0.00,0.00,0,0,0,0,0,0,0,0,0,0,0,0,0
20200520,052318,友達元大98購01,,,,,0.00,0.00,0,0,0,0,0,0,0,0,0,0,0,0,0
20200520,052319,可成元大95購12,,,,,0.00,0.00,0,0,0,0,0,0,0,0,0,0,0,0,0
20200520,052320,緯創元大95購05,,,,,0.00,0.00,0,0,0,0,0,0,0,0,0,0,0,0,0
20200520,052321,華擎元大95購01,,,,,0.00,0.00,0,0,0,0,0,0,0,0,0,0,0,0,0
20200520,052322,力成元大96購01,,,,,0.00,0.00,0,0,0,0,0,0,0,0,0,0,0,0,0
20200520,052323,矽力元大95購04,,,,,0.00,0.00,0,0,0,0,0,0,0,0,0,0,0,0,0
20200520,052324,康友元大96購02,,,,,0.00,0.00,0,0,0,0,0,0,0,0,0,0,0,0,0
20200520,052325,高股息中信99購01,,,,,0.00,0.00,0,0,0,0,0,0,0,0,0,0,0,0,0
20200520,052326,滬深反中信99購01,0.50,0.51,0.50,0.51,0.00,0.00,9000,2,4550,0,0,0,0,0,0,0,9000,-9000,-9000
20200520,052327,聯詠中信95購03,,,,,0.00,0.00,0,0,0,0,0,0,0,0,0,0,0,0,0
20200520,052328,台表科中信99購01,0.46,0.60,0.40,0.59,+0.19,47.5,4227000,151,1916790,0,0,0,0,0,0,2287000,1378000,909000,909000
20200520,052329,台積電亞東96購01,,,,,0.00,0.00,0,0,0,0,0,0,0,0,0,0,0,0,0
20200520,052330,燿華亞東95購01,,,,,0.00,0.00,0,0,0,0,0,0,0,0,0,0,0,0,0
20200520,052331,漢唐亞東97購01,,,,,0.00,0.00,0,0,0,0,0,0,0,0,0,0,0,0,0
20200520,052332,美律亞東96購01,,,,,0.00,0.00,0,0,0,0,0,0,0,0,0,0,0,0,0
20200520,052333,嘉聯益兆豐96購01,0.01,0.01,0.01,0.01,0.00,0.00,10000,1,100,0,0,0,0,0,0,10000,0,10000,10000
20200520,052334,大成鋼日盛95購01,,,,,0.00,0.00,0,0,0,0,0,0,0,0,0,0,0,0,0
20200520,052335,新光金日盛95購02,0.01,0.01,0.01,0.01,0.00,0.00,125000,2,1250,0,0,0,0,0,0,125000,0,125000,125000
20200520,052336,矽力日盛95購01,,,,,0.00,0.00,0,0,0,0,0,0,0,0,0,0,0,0,0
20200520,052337,臺股指日盛95購02,,,,,0.00,0.00,0,0,0,0,0,0,0,0,0,0,0,0,0
20200520,052338,道瓊反凱基97購02,,,,,0.00,0.00,0,0,0,0,0,0,0,0,0,0,0,0,0
20200520,052339,光寶科凱基95購01,,,,,0.00,0.00,0,0,0,0,0,0,0,0,0,0,0,0,0
20200520,052340,燿華凱基96購01,,,,,0.00,0.00,0,0,0,0,0,0,0,0,0,0,0,0,0
20200520,052341,泰鼎凱基96購02,,,,,0.00,0.00,0,0,0,0,0,0,0,0,0,0,0,0,0
20200520,052342,茂林凱基96購01,0.46,0.71,0.46,0.71,0.00,0.00,44000,7,29560,0,0,0,0,0,0,34000,10000,24000,24000
20200520,052343,同欣電凱基95購03,0.01,0.01,0.01,0.01,0.00,0.00,2000,1,20,0,0,0,0,0,0,2000,0,2000,2000
20200520,052344,台表科凱基98購01,0.38,0.39,0.38,0.39,+0.15,62.5,21000,2,8090,0,0,0,0,0,0,21000,0,21000,21000
20200520,052345,矽力凱基95購01,,,,,0.00,0.00,0,0,0,0,0,0,0,0,0,0,0,0,0
20200520,052346,訊芯凱基95購01,,,,,0.00,0.00,0,0,0,0,0,0,0,0,0,0,0,0,0
20200520,052347,GIS凱基95購05,,,,,0.00,0.00,0,0,0,0,0,0,0,0,0,0,0,0,0
20200520,052348,台光電富邦95購01,,,,,0.00,0.00,0,0,0,0,0,0,0,0,0,0,0,0,0
20200520,052349,鴻海統一95購15,,,,,0.00,0.00,0,0,0,0,0,0,0,0,0,0,0,0,0
20200520,052350,鴻海統一96購06,,,,,0.00,0.00,0,0,0,0,0,0,0,0,0,0,0,0,0
20200520,052351,中環元富95購01,,,,,0.00,0.00,0,0,0,0,0,0,0,0,0,0,0,0,0
20200520,052352,力成元富95購01,,,,,0.00,0.00,0,0,0,0,0,0,0,0,0,0,0,0,0
20200520,052353,高鐵群益97購01,,,,,0.00,0.00,0,0,0,0,0,0,0,0,0,0,0,0,0
20200520,052354,健策群益96購02,,,,,0.00,0.00,0,0,0,0,0,0,0,0,0,0,0,0,0
20200520,052355,為升永豐95購02,,,,,0.00,0.00,0,0,0,0,0,0,0,0,0,0,0,0,0
20200520,052356,聯詠永豐95購03,,,,,0.00,0.00,0,0,0,0,0,0,0,0,0,0,0,0,0
20200520,052357,揚明光永豐95購03,,,,,0.00,0.00,0,0,0,0,0,0,0,0,0,0,0,0,0
20200520,052358,台表科永豐95購02,,,,,0.00,0.00,0,0,0,0,0,0,0,0,0,0,0,0,0
20200520,052359,百和永豐95購01,,,,,0.00,0.00,0,0,0,0,0,0,0,0,0,0,0,0,0
20200520,052360,FB上証國票96購01,,,,,0.00,0.00,0,0,0,0,0,0,0,0,0,0,0,0,0
20200520,052361,大成鋼國票96購01,,,,,0.00,0.00,0,0,0,0,0,0,0,0,0,0,0,0,0
20200520,052362,瑞昱國票96購02,2.11,2.18,2.11,2.12,+0.07,3.41,40000,3,84480,0,0,0,0,0,0,38000,2000,36000,36000
20200520,052363,廣達國票96購01,0.20,0.20,0.20,0.20,+0.01,5.26,10000,2,2000,0,0,0,0,0,0,10000,0,10000,10000
20200520,052364,全新國票95購02,,,,,0.00,0.00,0,0,0,0,0,0,0,0,0,0,0,0,0
20200520,052365,聯詠國票95購02,,,,,0.00,0.00,0,0,0,0,0,0,0,0,0,0,0,0,0
20200520,052366,聯詠國票96購01,,,,,0.00,0.00,0,0,0,0,0,0,0,0,0,0,0,0,0
20200520,052367,聯茂國票96購02,0.55,0.56,0.52,0.56,-0.03,-5.08,42000,10,22070,0,0,0,0,0,0,41000,1000,40000,40000
20200520,052368,力成國票96購01,,,,,0.00,0.00,0,0,0,0,0,0,0,0,0,0,0,0,0
20200520,052369,矽力國票96購02,,,,,0.00,0.00,0,0,0,0,0,0,0,0,0,0,0,0,0
20200520,052370,滬深2X元大95購04,,,,,0.00,0.00,0,0,0,0,0,0,0,0,0,0,0,0,0
20200520,052371,元金2X元大95購01,1.28,1.29,1.28,1.28,0.00,0.00,42000,3,53960,0,0,0,0,0,0,42000,0,42000,42000
20200520,052372,台泥元大95購02,,,,,0.00,0.00,0,0,0,0,0,0,0,0,0,0,0,0,0
20200520,052373,鴻海元大95購22,,,,,0.00,0.00,0,0,0,0,0,0,0,0,0,0,0,0,0
20200520,052374,瑞昱元大95購02,,,,,0.00,0.00,0,0,0,0,0,0,0,0,0,0,0,0,0
20200520,052375,奇力新元大96購02,,,,,0.00,0.00,0,0,0,0,0,0,0,0,0,0,0,0,0
20200520,052376,聯詠元大95購04,,,,,0.00,0.00,0,0,0,0,0,0,0,0,0,0,0,0,0
20200520,052377,景碩元大96購02,,,,,0.00,0.00,0,0,0,0,0,0,0,0,0,0,0,0,0
20200520,052378,矽力元大96購01,,,,,0.00,0.00,0,0,0,0,0,0,0,0,0,0,0,0,0
20200520,052379,鈺齊元大95購04,,,,,0.00,0.00,0,0,0,0,0,0,0,0,0,0,0,0,0
20200520,052380,臺股指元大95購21,0.57,0.57,0.57,0.57,0.00,0.00,10000,1,5700,0,0,0,0,0,0,10000,0,10000,10000
20200520,052381,臺股指元大95購22,,,,,0.00,0.00,0,0,0,0,0,0,0,0,0,0,0,0,0
20200520,052382,臺股指元大95購23,,,,,0.00,0.00,0,0,0,0,0,0,0,0,0,0,0,0,0
20200520,052383,臺股指元大95購29,0.28,0.28,0.28,0.28,0.00,0.00,12000,1,3360,0,0,0,0,0,0,0,12000,-12000,-12000
20200520,052384,臺股指元大95購30,,,,,0.00,0.00,0,0,0,0,0,0,0,0,0,0,0,0,0
20200520,052385,滬深2X群益99購05,0.81,0.81,0.81,0.81,-0.01,-1.22,100000,1,81000,0,0,0,0,0,0,100000,100000,0,0
20200520,052386,鴻海群益96購02,,,,,0.00,0.00,0,0,0,0,0,0,0,0,0,0,0,0,0
20200520,052387,台積電群益95購08,0.11,0.11,0.11,0.11,-0.04,-26.67,10000,1,1100,0,0,0,0,0,0,10000,0,10000,10000
20200520,052388,旺宏群益96購05,,,,,0.00,0.00,0,0,0,0,0,0,0,0,0,0,0,0,0
20200520,052389,聯發科群益95購05,,,,,0.00,0.00,0,0,0,0,0,0,0,0,0,0,0,0,0
20200520,052390,聯詠群益95購03,,,,,0.00,0.00,0,0,0,0,0,0,0,0,0,0,0,0,0
20200520,052391,瑞儀群益95購01,,,,,0.00,0.00,0,0,0,0,0,0,0,0,0,0,0,0,0
20200520,052392,台表科群益96購02,,,,,0.00,0.00,0,0,0,0,0,0,0,0,0,0,0,0,0
20200520,052393,康友群益95購05,,,,,0.00,0.00,0,0,0,0,0,0,0,0,0,0,0,0,0
20200520,052394,滬深2X日盛95購01,,,,,0.00,0.00,0,0,0,0,0,0,0,0,0,0,0,0,0
20200520,052395,上証2X凱基97購01,,,,,0.00,0.00,0,0,0,0,0,0,0,0,0,0,0,0,0
20200520,052396,台積電凱基97購01,,,,,0.00,0.00,0,0,0,0,0,0,0,0,0,0,0,0,0
20200520,052397,燿華凱基96購02,,,,,0.00,0.00,0,0,0,0,0,0,0,0,0,0,0,0,0
20200520,052398,瑞昱凱基95購06,,,,,0.00,0.00,0,0,0,0,0,0,0,0,0,0,0,0,0
20200520,052399,台光電凱基95購03,,,,,0.00,0.00,0,0,0,0,0,0,0,0,0,0,0,0,0
20200520,052400,聯詠凱基97購01,,,,,0.00,0.00,0,0,0,0,0,0,0,0,0,0,0,0,0
20200520,052401,智原凱基95購01,,,,,0.00,0.00,0,0,0,0,0,0,0,0,0,0,0,0,0
20200520,052402,健策凱基97購01,,,,,0.00,0.00,0,0,0,0,0,0,0,0,0,0,0,0,0
20200520,052403,麗豐凱基96購01,,,,,0.00,0.00,0,0,0,0,0,0,0,0,0,0,0,0,0
20200520,052404,臻鼎凱基95購05,,,,,0.00,0.00,0,0,0,0,0,0,0,0,0,0,0,0,0
20200520,052405,聯茂凱基95購01,,,,,0.00,0.00,0,0,0,0,0,0,0,0,0,0,0,0,0
20200520,052406,力成凱基95購03,,,,,0.00,0.00,0,0,0,0,0,0,0,0,0,0,0,0,0
20200520,052407,樺漢凱基95購01,,,,,0.00,0.00,0,0,0,0,0,0,0,0,0,0,0,0,0
20200520,052408,羅麗芬凱基95購01,,,,,0.00,0.00,0,0,0,0,0,0,0,0,0,0,0,0,0
20200520,052409,國巨亞東95購01,,,,,0.00,0.00,0,0,0,0,0,0,0,0,0,0,0,0,0
20200520,05240P,玉晶光永豐96售01,0.16,0.16,0.16,0.16,-0.02,-11.11,15000,1,2400,0,0,0,0,0,0,0,15000,-15000,-15000
20200520,052410,智邦亞東96購01,2.95,2.95,2.95,2.95,+0.14,4.98,1000,1,2950,0,0,0,0,0,0,1000,0,1000,1000
20200520,052411,嘉聯益亞東95購02,,,,,0.00,0.00,0,0,0,0,0,0,0,0,0,0,0,0,0
20200520,052412,上証2X中信98購01,,,,,0.00,0.00,0,0,0,0,0,0,0,0,0,0,0,0,0
20200520,052413,上証反中信97購01,0.87,0.87,0.87,0.87,+0.01,1.16,85000,1,73950,0,0,0,0,0,0,85000,0,85000,85000
20200520,052414,聯電麥證95購01,,,,,0.00,0.00,0,0,0,0,0,0,0,0,0,0,0,0,0
20200520,052415,台表科麥證95購02,,,,,0.00,0.00,0,0,0,0,0,0,0,0,0,0,0,0,0
20200520,052416,滬深2X兆豐96購02,,,,,0.00,0.00,0,0,0,0,0,0,0,0,0,0,0,0,0
20200520,052417,聯發科兆豐9B購01,2.17,2.51,2.17,2.32,+0.22,10.48,69000,8,162850,0,0,0,0,0,0,69000,38000,31000,31000
20200520,052418,玉晶光兆豐96購01,1.39,1.46,1.39,1.46,0.00,0.00,6000,3,8670,0,0,0,0,0,0,6000,0,6000,6000
20200520,052419,上証2X國票96購02,,,,,0.00,0.00,0,0,0,0,0,0,0,0,0,0,0,0,0
20200520,05241P,鴻海國泰97售04,,,,,0.00,0.00,0,0,0,0,0,0,0,0,0,0,0,0,0
20200520,052420,道瓊反國票9B購01,,,,,0.00,0.00,0,0,0,0,0,0,0,0,0,0,0,0,0
20200520,052421,元油反國票9B購01,,,,,0.00,0.00,0,0,0,0,0,0,0,0,0,0,0,0,0
20200520,052422,聯電國票96購03,,,,,0.00,0.00,0,0,0,0,0,0,0,0,0,0,0,0,0
20200520,052423,宏達電國票96購02,0.49,0.49,0.48,0.48,0.00,0.00,488000,7,238220,0,0,0,0,0,0,0,488000,-488000,-488000
20200520,052424,泰碩國票97購01,,,,,0.00,0.00,0,0,0,0,0,0,0,0,0,0,0,0,0
20200520,052425,華通台新95購02,,,,,0.00,0.00,0,0,0,0,0,0,0,0,0,0,0,0,0
20200520,052426,國巨台新96購01,,,,,0.00,0.00,0,0,0,0,0,0,0,0,0,0,0,0,0
20200520,052427,上証2X永豐96購01,,,,,0.00,0.00,0,0,0,0,0,0,0,0,0,0,0,0,0
20200520,052428,嘉晶永豐95購01,1.39,1.70,1.39,1.70,0.00,0.00,14000,2,20700,0,0,0,0,0,0,14000,0,14000,14000
20200520,052429,禾伸堂永豐95購02,,,,,0.00,0.00,0,0,0,0,0,0,0,0,0,0,0,0,0
20200520,05242P,群創國泰97售01,0.81,0.85,0.80,0.85,0.00,0.00,88000,7,73130,0,0,0,0,0,0,35000,53000,-18000,-18000
20200520,052430,泰碩永豐95購02,,,,,0.00,0.00,0,0,0,0,0,0,0,0,0,0,0,0,0
20200520,052431,茂林永豐95購03,,,,,0.00,0.00,0,0,0,0,0,0,0,0,0,0,0,0,0
20200520,052432,康友永豐95購04,,,,,0.00,0.00,0,0,0,0,0,0,0,0,0,0,0,0,0
20200520,052433,滬深2X國泰96購02,,,,,0.00,0.00,0,0,0,0,0,0,0,0,0,0,0,0,0
20200520,052434,茂林國泰97購01,1.13,1.53,1.13,1.53,+0.53,53.0,348000,23,418400,0,0,0,0,0,0,82000,333000,-251000,-251000
20200520,052435,滬深2X富邦96購05,,,,,0.00,0.00,0,0,0,0,0,0,0,0,0,0,0,0,0
20200520,052436,正崴富邦95購01,,,,,0.00,0.00,0,0,0,0,0,0,0,0,0,0,0,0,0
20200520,052437,聯發科富邦99購02,1.48,1.71,1.48,1.71,+0.26,17.93,25000,5,39370,0,0,0,0,0,0,21000,0,21000,21000
20200520,052438,瑞儀富邦95購01,,,,,0.00,0.00,0,0,0,0,0,0,0,0,0,0,0,0,0
20200520,052439,寶成富邦97購01,,,,,0.00,0.00,0,0,0,0,0,0,0,0,0,0,0,0,0
20200520,052440,上証2X元大95購02,,,,,0.00,0.00,0,0,0,0,0,0,0,0,0,0,0,0,0
20200520,052441,亞泥元大95購01,,,,,0.00,0.00,0,0,0,0,0,0,0,0,0,0,0,0,0
20200520,052442,中環元大95購02,,,,,0.00,0.00,0,0,0,0,0,0,0,0,0,0,0,0,0
20200520,052443,台積電元大95購23,,,,,0.00,0.00,0,0,0,0,0,0,0,0,0,0,0,0,0
20200520,052444,友訊元大95購01,,,,,0.00,0.00,0,0,0,0,0,0,0,0,0,0,0,0,0
20200520,052445,南亞科元大95購05,,,,,0.00,0.00,0,0,0,0,0,0,0,0,0,0,0,0,0
20200520,052446,聯發科元大96購03,1.30,1.60,1.30,1.44,+0.20,16.13,59000,7,83410,0,0,0,0,0,0,59000,0,59000,59000
20200520,052447,聯發科元大96購04,3.28,3.64,3.28,3.43,+0.26,8.2,57000,4,191460,0,0,0,0,0,0,3000,54000,-51000,-51000
20200520,052448,新光金元大96購03,,,,,0.00,0.00,0,0,0,0,0,0,0,0,0,0,0,0,0
20200520,052449,創意元大95購04,,,,,0.00,0.00,0,0,0,0,0,0,0,0,0,0,0,0,0
20200520,052450,嘉澤元大95購03,,,,,0.00,0.00,0,0,0,0,0,0,0,0,0,0,0,0,0
20200520,052451,旭富元大95購02,,,,,0.00,0.00,0,0,0,0,0,0,0,0,0,0,0,0,0
20200520,052452,茂林元大95購03,0.81,0.81,0.81,0.81,+0.19,30.65,282000,3,228420,0,0,0,0,0,0,282000,0,282000,282000
20200520,052453,崇越元大95購01,,,,,0.00,0.00,0,0,0,0,0,0,0,0,0,0,0,0,0
20200520,052454,力成元大95購02,,,,,0.00,0.00,0,0,0,0,0,0,0,0,0,0,0,0,0
20200520,052455,樺漢元大96購03,,,,,0.00,0.00,0,0,0,0,0,0,0,0,0,0,0,0,0
20200520,052456,滬深2X元富9B購03,0.29,0.29,0.29,0.29,0.00,0.00,24000,1,6960,0,0,0,0,0,0,24000,0,24000,24000
20200520,052457,日月光元富95購01,,,,,0.00,0.00,0,0,0,0,0,0,0,0,0,0,0,0,0
20200520,052458,T50反1統一97購01,,,,,0.00,0.00,0,0,0,0,0,0,0,0,0,0,0,0,0
20200520,052459,道瓊反統一95購04,,,,,0.00,0.00,0,0,0,0,0,0,0,0,0,0,0,0,0
20200520,052460,元油反統一95購01,,,,,0.00,0.00,0,0,0,0,0,0,0,0,0,0,0,0,0
20200520,052461,和大統一95購01,,,,,0.00,0.00,0,0,0,0,0,0,0,0,0,0,0,0,0
20200520,052462,上銀統一95購03,,,,,0.00,0.00,0,0,0,0,0,0,0,0,0,0,0,0,0
20200520,052463,聯電統一96購01,0.49,0.49,0.47,0.47,-0.08,-14.55,199000,2,93750,0,0,0,0,0,0,0,199000,-199000,-199000
20200520,052464,大立光統一95購05,,,,,0.00,0.00,0,0,0,0,0,0,0,0,0,0,0,0,0
20200520,052465,聯詠統一95購02,,,,,0.00,0.00,0,0,0,0,0,0,0,0,0,0,0,0,0
20200520,052466,聯詠統一95購03,,,,,0.00,0.00,0,0,0,0,0,0,0,0,0,0,0,0,0
20200520,052467,嘉聯益統一96購01,,,,,0.00,0.00,0,0,0,0,0,0,0,0,0,0,0,0,0
20200520,052468,超眾統一96購02,1.23,1.25,1.23,1.25,+0.04,3.31,68000,3,84340,0,0,0,0,0,0,0,68000,-68000,-68000
20200520,052469,宏碁亞東95購01,,,,,0.00,0.00,0,0,0,0,0,0,0,0,0,0,0,0,0
20200520,052470,華新科亞東97購01,,,,,0.00,0.00,0,0,0,0,0,0,0,0,0,0,0,0,0
20200520,052471,華固亞東95購01,0.01,0.01,0.01,0.01,0.00,0.00,100000,1,1000,0,0,0,0,0,0,100000,0,100000,100000
20200520,052472,和碩亞東95購01,,,,,0.00,0.00,0,0,0,0,0,0,0,0,0,0,0,0,0
20200520,052473,臻鼎亞東95購01,,,,,0.00,0.00,0,0,0,0,0,0,0,0,0,0,0,0,0
20200520,052474,T50反1群益95購04,,,,,0.00,0.00,0,0,0,0,0,0,0,0,0,0,0,0,0
20200520,052475,滬深2X群益99購06,,,,,0.00,0.00,0,0,0,0,0,0,0,0,0,0,0,0,0
20200520,052476,台光電群益98購01,,,,,0.00,0.00,0,0,0,0,0,0,0,0,0,0,0,0,0
20200520,052477,美律群益98購01,,,,,0.00,0.00,0,0,0,0,0,0,0,0,0,0,0,0,0
20200520,052478,大立光群益95購05,,,,,0.00,0.00,0,0,0,0,0,0,0,0,0,0,0,0,0
20200520,052479,TPK群益95購04,,,,,0.00,0.00,0,0,0,0,0,0,0,0,0,0,0,0,0
20200520,052480,麗豐群益95購01,,,,,0.00,0.00,0,0,0,0,0,0,0,0,0,0,0,0,0
20200520,052481,利勤群益95購01,,,,,0.00,0.00,0,0,0,0,0,0,0,0,0,0,0,0,0
20200520,052482,茂林群益95購01,,,,,0.00,0.00,0,0,0,0,0,0,0,0,0,0,0,0,0
20200520,052483,超眾群益95購03,,,,,0.00,0.00,0,0,0,0,0,0,0,0,0,0,0,0,0
20200520,052484,矽創群益95購02,,,,,0.00,0.00,0,0,0,0,0,0,0,0,0,0,0,0,0
20200520,052485,深中小國票96購01,,,,,0.00,0.00,0,0,0,0,0,0,0,0,0,0,0,0,0
20200520,052486,元油反國票96購01,,,,,0.00,0.00,0,0,0,0,0,0,0,0,0,0,0,0,0
20200520,052487,國巨國票96購07,,,,,0.00,0.00,0,0,0,0,0,0,0,0,0,0,0,0,0
20200520,052488,旺宏國票96購03,,,,,0.00,0.00,0,0,0,0,0,0,0,0,0,0,0,0,0
20200520,052489,義隆國票96購02,,,,,0.00,0.00,0,0,0,0,0,0,0,0,0,0,0,0,0
20200520,05248P,矽創群益96售01,1.39,1.51,1.39,1.51,0.00,0.00,49000,3,70930,0,0,0,0,0,0,0,49000,-49000,-49000
20200520,052490,禾伸堂國票95購01,,,,,0.00,0.00,0,0,0,0,0,0,0,0,0,0,0,0,0
20200520,052491,泰碩國票99購01,0.95,0.95,0.90,0.90,0.00,0.00,51000,3,48000,0,0,0,0,0,0,50000,1000,49000,49000
20200520,052492,易華電國票96購02,,,,,0.00,0.00,0,0,0,0,0,0,0,0,0,0,0,0,0
20200520,052493,上証2X中信97購02,1.01,1.05,1.01,1.05,-0.04,-3.67,20000,2,20600,0,0,0,0,0,0,10000,10000,0,0
20200520,052494,百和中信95購02,,,,,0.00,0.00,0,0,0,0,0,0,0,0,0,0,0,0,0
20200520,052495,滬深2X台新95購01,,,,,0.00,0.00,0,0,0,0,0,0,0,0,0,0,0,0,0
20200520,052496,華通台新96購02,,,,,0.00,0.00,0,0,0,0,0,0,0,0,0,0,0,0,0
20200520,052497,楠梓電永豐96購01,,,,,0.00,0.00,0,0,0,0,0,0,0,0,0,0,0,0,0
20200520,052498,台積電永豐95購06,,,,,0.00,0.00,0,0,0,0,0,0,0,0,0,0,0,0,0
20200520,052499,合勤控永豐95購01,,,,,0.00,0.00,0,0,0,0,0,0,0,0,0,0,0,0,0
20200520,052500,元翎永豐95購01,,,,,0.00,0.00,0,0,0,0,0,0,0,0,0,0,0,0,0
20200520,052501,茂林永豐95購04,,,,,0.00,0.00,0,0,0,0,0,0,0,0,0,0,0,0,0
20200520,052502,瀚宇博永豐95購02,,,,,0.00,0.00,0,0,0,0,0,0,0,0,0,0,0,0,0
20200520,052503,大成鋼日盛95購02,0.01,0.01,0.01,0.01,0.00,0.00,3000,1,30,0,0,0,0,0,0,3000,0,3000,3000
20200520,052504,鴻海日盛95購03,,,,,0.00,0.00,0,0,0,0,0,0,0,0,0,0,0,0,0
20200520,052505,友達日盛9B購02,,,,,0.00,0.00,0,0,0,0,0,0,0,0,0,0,0,0,0
20200520,052506,日月光日盛95購01,0.01,0.01,0.01,0.01,0.00,0.00,70000,1,700,0,0,0,0,0,0,70000,0,70000,70000
20200520,052507,日月光日盛95購02,,,,,0.00,0.00,0,0,0,0,0,0,0,0,0,0,0,0,0
20200520,052508,矽力日盛95購02,,,,,0.00,0.00,0,0,0,0,0,0,0,0,0,0,0,0,0
20200520,052509,鴻海凱基96購10,,,,,0.00,0.00,0,0,0,0,0,0,0,0,0,0,0,0,0
20200520,05250P,臻鼎國票96售01,3.47,3.47,3.47,3.47,-0.26,-6.97,1000,1,3470,0,0,0,0,0,0,1000,0,1000,1000
20200520,052510,聯發科凱基95購13,,,,,0.00,0.00,0,0,0,0,0,0,0,0,0,0,0,0,0
20200520,052511,聯發科凱基95購14,,,,,0.00,0.00,0,0,0,0,0,0,0,0,0,0,0,0,0
20200520,052512,全新凱基96購03,,,,,0.00,0.00,0,0,0,0,0,0,0,0,0,0,0,0,0
20200520,052513,大立光凱基95購13,,,,,0.00,0.00,0,0,0,0,0,0,0,0,0,0,0,0,0
20200520,052514,嘉澤凱基96購01,,,,,0.00,0.00,0,0,0,0,0,0,0,0,0,0,0,0,0
20200520,052515,矽力凱基95購02,,,,,0.00,0.00,0,0,0,0,0,0,0,0,0,0,0,0,0
20200520,052516,臺股指凱基95購20,,,,,0.00,0.00,0,0,0,0,0,0,0,0,0,0,0,0,0
20200520,052517,滬深2X元大95購05,,,,,0.00,0.00,0,0,0,0,0,0,0,0,0,0,0,0,0
20200520,052518,道瓊反元大95購02,,,,,0.00,0.00,0,0,0,0,0,0,0,0,0,0,0,0,0
20200520,052519,旺宏元大95購05,,,,,0.00,0.00,0,0,0,0,0,0,0,0,0,0,0,0,0
20200520,052520,南亞科元大95購06,,,,,0.00,0.00,0,0,0,0,0,0,0,0,0,0,0,0,0
20200520,052521,友達元大9B購01,,,,,0.00,0.00,0,0,0,0,0,0,0,0,0,0,0,0,0
20200520,052522,聯發科元大96購05,1.02,1.02,0.86,0.86,+0.10,13.16,20000,4,19600,0,0,0,0,0,0,20000,0,20000,20000
20200520,052523,奇力新元大97購01,,,,,0.00,0.00,0,0,0,0,0,0,0,0,0,0,0,0,0
20200520,052524,新光金元大9B購01,,,,,0.00,0.00,0,0,0,0,0,0,0,0,0,0,0,0,0
20200520,052525,聯詠元大95購06,,,,,0.00,0.00,0,0,0,0,0,0,0,0,0,0,0,0,0
20200520,052526,智伸科元大96購02,,,,,0.00,0.00,0,0,0,0,0,0,0,0,0,0,0,0,0
20200520,052527,泰鼎元大96購02,,,,,0.00,0.00,0,0,0,0,0,0,0,0,0,0,0,0,0
20200520,052528,茂林元大95購05,0.40,0.40,0.40,0.40,0.00,0.00,50000,1,20000,0,0,0,0,0,0,50000,0,50000,50000
20200520,052529,力成元大95購03,,,,,0.00,0.00,0,0,0,0,0,0,0,0,0,0,0,0,0
20200520,052530,台郡元大96購04,,,,,0.00,0.00,0,0,0,0,0,0,0,0,0,0,0,0,0
20200520,052531,台積電國泰96購06,,,,,0.00,0.00,0,0,0,0,0,0,0,0,0,0,0,0,0
20200520,052532,台積電國泰96購07,,,,,0.00,0.00,0,0,0,0,0,0,0,0,0,0,0,0,0
20200520,052533,聯發科國泰96購03,1.81,1.81,1.52,1.52,+0.15,10.95,33000,5,51870,0,0,0,0,0,0,33000,0,33000,33000
20200520,052534,貿聯國泰96購02,,,,,0.00,0.00,0,0,0,0,0,0,0,0,0,0,0,0,0
20200520,052535,日月光國泰96購01,,,,,0.00,0.00,0,0,0,0,0,0,0,0,0,0,0,0,0
20200520,052536,聯茂國泰97購01,,,,,0.00,0.00,0,0,0,0,0,0,0,0,0,0,0,0,0
20200520,052537,力成富邦95購01,,,,,0.00,0.00,0,0,0,0,0,0,0,0,0,0,0,0,0
20200520,052538,和大統一95購02,,,,,0.00,0.00,0,0,0,0,0,0,0,0,0,0,0,0,0
20200520,052539,華邦電統一95購01,,,,,0.00,0.00,0,0,0,0,0,0,0,0,0,0,0,0,0
20200520,052540,華新科統一95購03,,,,,0.00,0.00,0,0,0,0,0,0,0,0,0,0,0,0,0
20200520,052541,大立光統一95購06,,,,,0.00,0.00,0,0,0,0,0,0,0,0,0,0,0,0,0
20200520,052542,友達元富98購01,0.73,0.75,0.71,0.71,0.00,0.00,133000,6,96360,0,0,0,0,0,0,105000,28000,77000,77000
20200520,052543,聯詠元富95購01,,,,,0.00,0.00,0,0,0,0,0,0,0,0,0,0,0,0,0
20200520,052544,牧德元富95購01,1.49,1.50,1.49,1.50,0.00,0.00,14000,2,20900,0,0,0,0,0,0,14000,0,14000,14000
20200520,052545,康控元富95購02,,,,,0.00,0.00,0,0,0,0,0,0,0,0,0,0,0,0,0
20200520,052546,友達中信98購01,0.21,0.21,0.21,0.21,0.00,0.00,1000,1,210,0,0,0,0,0,0,0,1000,-1000,-1000
20200520,052547,光磊兆豐96購01,,,,,0.00,0.00,0,0,0,0,0,0,0,0,0,0,0,0,0
20200520,052548,旺宏亞東96購01,,,,,0.00,0.00,0,0,0,0,0,0,0,0,0,0,0,0,0
20200520,052549,喬山國票97購01,,,,,0.00,0.00,0,0,0,0,0,0,0,0,0,0,0,0,0
20200520,052550,鴻海國票97購02,,,,,0.00,0.00,0,0,0,0,0,0,0,0,0,0,0,0,0
20200520,052551,台積電國票97購03,,,,,0.00,0.00,0,0,0,0,0,0,0,0,0,0,0,0,0
20200520,052552,智邦國票97購01,,,,,0.00,0.00,0,0,0,0,0,0,0,0,0,0,0,0,0
20200520,052553,技嘉國票96購01,,,,,0.00,0.00,0,0,0,0,0,0,0,0,0,0,0,0,0
20200520,052554,正崴國票97購01,,,,,0.00,0.00,0,0,0,0,0,0,0,0,0,0,0,0,0
20200520,052555,漢唐國票97購01,,,,,0.00,0.00,0,0,0,0,0,0,0,0,0,0,0,0,0
20200520,052556,聯發科國票97購01,,,,,0.00,0.00,0,0,0,0,0,0,0,0,0,0,0,0,0
20200520,052557,群創國票97購02,,,,,0.00,0.00,0,0,0,0,0,0,0,0,0,0,0,0,0
20200520,052558,新唐國票97購01,,,,,0.00,0.00,0,0,0,0,0,0,0,0,0,0,0,0,0
20200520,052559,茂林國票97購01,,,,,0.00,0.00,0,0,0,0,0,0,0,0,0,0,0,0,0
20200520,052560,康舒國票97購01,,,,,0.00,0.00,0,0,0,0,0,0,0,0,0,0,0,0,0
20200520,052561,矽創國票97購01,0.70,0.70,0.70,0.70,+0.03,4.48,195000,5,136500,0,0,0,0,0,0,195000,0,195000,195000
20200520,052562,南亞科日盛96購01,,,,,0.00,0.00,0,0,0,0,0,0,0,0,0,0,0,0,0
20200520,052563,京元電日盛96購01,,,,,0.00,0.00,0,0,0,0,0,0,0,0,0,0,0,0,0
20200520,052564,美食日盛96購01,,,,,0.00,0.00,0,0,0,0,0,0,0,0,0,0,0,0,0
20200520,052565,上銀凱基96購01,,,,,0.00,0.00,0,0,0,0,0,0,0,0,0,0,0,0,0
20200520,052566,國巨凱基96購04,,,,,0.00,0.00,0,0,0,0,0,0,0,0,0,0,0,0,0
20200520,052567,台積電凱基96購05,,,,,0.00,0.00,0,0,0,0,0,0,0,0,0,0,0,0,0
20200520,052568,漢唐凱基96購02,,,,,0.00,0.00,0,0,0,0,0,0,0,0,0,0,0,0,0
20200520,052569,聯發科凱基96購08,0.20,0.20,0.20,0.20,+0.01,5.26,35000,2,7000,0,0,0,0,0,0,35000,0,35000,35000
20200520,052570,華新科凱基96購06,,,,,0.00,0.00,0,0,0,0,0,0,0,0,0,0,0,0,0
20200520,052571,新光金凱基98購02,,,,,0.00,0.00,0,0,0,0,0,0,0,0,0,0,0,0,0
20200520,052572,群創凱基99購01,0.74,0.74,0.74,0.74,-0.04,-5.13,30000,1,22200,0,0,0,0,0,0,30000,0,30000,30000
20200520,052573,智伸科凱基97購01,0.02,0.02,0.02,0.02,0.00,0.00,5000,1,100,0,0,0,0,0,0,5000,0,5000,5000
20200520,052574,茂林凱基96購02,,,,,0.00,0.00,0,0,0,0,0,0,0,0,0,0,0,0,0
20200520,052575,茂林凱基96購04,,,,,0.00,0.00,0,0,0,0,0,0,0,0,0,0,0,0,0
20200520,052576,聯茂凱基96購01,,,,,0.00,0.00,0,0,0,0,0,0,0,0,0,0,0,0,0
20200520,052577,台積電統一96購01,,,,,0.00,0.00,0,0,0,0,0,0,0,0,0,0,0,0,0
20200520,052578,大立光統一97購01,0.46,0.47,0.46,0.47,0.00,0.00,20000,2,9250,0,0,0,0,0,0,20000,0,20000,20000
20200520,052579,亞泥元富96購01,,,,,0.00,0.00,0,0,0,0,0,0,0,0,0,0,0,0,0
20200520,052580,高鐵元富96購01,,,,,0.00,0.00,0,0,0,0,0,0,0,0,0,0,0,0,0
20200520,052581,訊芯元富98購01,,,,,0.00,0.00,0,0,0,0,0,0,0,0,0,0,0,0,0
20200520,052582,喬山台新96購01,,,,,0.00,0.00,0,0,0,0,0,0,0,0,0,0,0,0,0
20200520,052583,友達台新96購02,,,,,0.00,0.00,0,0,0,0,0,0,0,0,0,0,0,0,0
20200520,052584,喬山永豐96購01,,,,,0.00,0.00,0,0,0,0,0,0,0,0,0,0,0,0,0
20200520,052585,友達永豐97購01,,,,,0.00,0.00,0,0,0,0,0,0,0,0,0,0,0,0,0
20200520,052586,晶豪科永豐96購01,0.63,0.63,0.63,0.63,-0.23,-26.74,1000,1,630,0,0,0,0,0,0,1000,0,1000,1000
20200520,052587,景碩永豐97購01,,,,,0.00,0.00,0,0,0,0,0,0,0,0,0,0,0,0,0
20200520,052588,玉晶光永豐98購01,,,,,0.00,0.00,0,0,0,0,0,0,0,0,0,0,0,0,0
20200520,052589,群創永豐97購01,,,,,0.00,0.00,0,0,0,0,0,0,0,0,0,0,0,0,0
20200520,05258P,臺股指凱基96售11,,,,,0.00,0.00,0,0,0,0,0,0,0,0,0,0,0,0,0
20200520,052590,祥碩永豐96購01,,,,,0.00,0.00,0,0,0,0,0,0,0,0,0,0,0,0,0
20200520,052591,康友永豐97購01,,,,,0.00,0.00,0,0,0,0,0,0,0,0,0,0,0,0,0
20200520,052592,華通群益98購01,,,,,0.00,0.00,0,0,0,0,0,0,0,0,0,0,0,0,0
20200520,052593,台積電群益96購02,,,,,0.00,0.00,0,0,0,0,0,0,0,0,0,0,0,0,0
20200520,052594,友訊群益98購01,,,,,0.00,0.00,0,0,0,0,0,0,0,0,0,0,0,0,0
20200520,052595,奇力新群益96購01,,,,,0.00,0.00,0,0,0,0,0,0,0,0,0,0,0,0,0
20200520,052596,群創群益98購05,,,,,0.00,0.00,0,0,0,0,0,0,0,0,0,0,0,0,0
20200520,052597,茂林群益96購01,,,,,0.00,0.00,0,0,0,0,0,0,0,0,0,0,0,0,0
20200520,052598,滬深2X元大96購05,,,,,0.00,0.00,0,0,0,0,0,0,0,0,0,0,0,0,0
20200520,052599,S&P反1元大96購01,,,,,0.00,0.00,0,0,0,0,0,0,0,0,0,0,0,0,0
20200520,05259P,臺股指凱基96售12,,,,,0.00,0.00,0,0,0,0,0,0,0,0,0,0,0,0,0
20200520,052600,力山元大97購01,,,,,0.00,0.00,0,0,0,0,0,0,0,0,0,0,0,0,0
20200520,052601,大成鋼元大96購01,,,,,0.00,0.00,0,0,0,0,0,0,0,0,0,0,0,0,0
20200520,052602,聯電元大97購01,0.12,0.12,0.11,0.12,-0.01,-7.69,920000,6,110300,0,0,0,0,0,0,860000,60000,800000,800000
20200520,052603,鴻海元大96購15,,,,,0.00,0.00,0,0,0,0,0,0,0,0,0,0,0,0,0
20200520,052604,建準元大97購01,1.95,1.95,1.64,1.81,-0.17,-8.59,466000,22,808890,0,0,0,0,0,0,388000,68000,320000,320000
20200520,052605,聯發科元大96購06,,,,,0.00,0.00,0,0,0,0,0,0,0,0,0,0,0,0,0
20200520,052606,聯發科元大97購04,2.34,2.35,2.34,2.35,+0.41,21.13,14000,2,32800,0,0,0,0,0,0,14000,0,14000,14000
20200520,052607,大立光元大96購03,,,,,0.00,0.00,0,0,0,0,0,0,0,0,0,0,0,0,0
20200520,052608,欣興元大97購01,,,,,0.00,0.00,0,0,0,0,0,0,0,0,0,0,0,0,0
20200520,052609,智易元大97購01,,,,,0.00,0.00,0,0,0,0,0,0,0,0,0,0,0,0,0
20200520,052610,貿聯元大97購01,0.07,0.07,0.07,0.07,+0.01,16.67,10000,1,700,0,0,0,0,0,0,0,0,0,0
20200520,052611,力成元大96購02,0.72,0.72,0.67,0.67,-0.04,-5.63,189000,5,133430,0,0,0,0,0,0,98000,97000,1000,1000
20200520,052612,康舒元大97購01,,,,,0.00,0.00,0,0,0,0,0,0,0,0,0,0,0,0,0
20200520,052613,易華電元大96購01,,,,,0.00,0.00,0,0,0,0,0,0,0,0,0,0,0,0,0
20200520,052614,聯電國泰97購01,,,,,0.00,0.00,0,0,0,0,0,0,0,0,0,0,0,0,0
20200520,052615,鴻海國泰98購01,,,,,0.00,0.00,0,0,0,0,0,0,0,0,0,0,0,0,0
20200520,052616,鴻海國泰98購02,,,,,0.00,0.00,0,0,0,0,0,0,0,0,0,0,0,0,0
20200520,052617,景碩國泰98購01,0.67,0.67,0.53,0.53,0.00,0.00,149000,2,85830,0,0,0,0,0,0,49000,100000,-51000,-51000
20200520,052618,群創國泰98購01,,,,,0.00,0.00,0,0,0,0,0,0,0,0,0,0,0,0,0
20200520,052619,茂林國泰99購01,1.04,1.20,1.04,1.17,+0.37,46.25,341000,12,392690,0,0,0,0,0,0,287000,40000,247000,247000
20200520,052620,上証2X富邦97購02,,,,,0.00,0.00,0,0,0,0,0,0,0,0,0,0,0,0,0
20200520,052621,台郡富邦97購01,0.15,0.15,0.15,0.15,0.00,0.00,1000,1,150,0,0,0,0,0,0,0,0,0,0
20200520,052622,貿聯兆豐97購01,,,,,0.00,0.00,0,0,0,0,0,0,0,0,0,0,0,0,0
20200520,052623,台郡兆豐96購01,,,,,0.00,0.00,0,0,0,0,0,0,0,0,0,0,0,0,0
20200520,052624,微星亞東97購01,2.57,2.67,2.35,2.35,-0.08,-3.29,25000,6,63580,0,0,0,0,0,0,13000,12000,1000,1000
20200520,052625,南電亞東97購01,,,,,0.00,0.00,0,0,0,0,0,0,0,0,0,0,0,0,0
20200520,052626,上証2X中信9A購01,0.26,0.26,0.26,0.26,0.00,0.00,20000,2,5200,0,0,0,0,0,0,0,20000,-20000,-20000
20200520,052627,中壽中信98購01,,,,,0.00,0.00,0,0,0,0,0,0,0,0,0,0,0,0,0
20200520,052628,樺漢中信96購01,,,,,0.00,0.00,0,0,0,0,0,0,0,0,0,0,0,0,0
20200520,052629,訊芯中信99購01,,,,,0.00,0.00,0,0,0,0,0,0,0,0,0,0,0,0,0
20200520,052630,滬深2X日盛96購01,,,,,0.00,0.00,0,0,0,0,0,0,0,0,0,0,0,0,0
20200520,052631,T50反1凱基98購02,,,,,0.00,0.00,0,0,0,0,0,0,0,0,0,0,0,0,0
20200520,052632,喬山凱基96購01,,,,,0.00,0.00,0,0,0,0,0,0,0,0,0,0,0,0,0
20200520,052633,國巨凱基96購05,,,,,0.00,0.00,0,0,0,0,0,0,0,0,0,0,0,0,0
20200520,052634,華邦電凱基96購01,,,,,0.00,0.00,0,0,0,0,0,0,0,0,0,0,0,0,0
20200520,052635,奇力新凱基98購01,,,,,0.00,0.00,0,0,0,0,0,0,0,0,0,0,0,0,0
20200520,052636,大立光凱基96購10,,,,,0.00,0.00,0,0,0,0,0,0,0,0,0,0,0,0,0
20200520,052637,欣興凱基97購01,,,,,0.00,0.00,0,0,0,0,0,0,0,0,0,0,0,0,0
20200520,052638,緯創凱基96購02,,,,,0.00,0.00,0,0,0,0,0,0,0,0,0,0,0,0,0
20200520,052639,康控凱基96購02,,,,,0.00,0.00,0,0,0,0,0,0,0,0,0,0,0,0,0
20200520,05263P,台積電元大96售09,,,,,0.00,0.00,0,0,0,0,0,0,0,0,0,0,0,0,0
20200520,052640,台表科凱基97購01,0.53,0.59,0.53,0.59,0.00,0.00,20000,2,11200,0,0,0,0,0,0,0,20000,-20000,-20000
20200520,052641,聯詠台新96購01,,,,,0.00,0.00,0,0,0,0,0,0,0,0,0,0,0,0,0
20200520,052642,滬深2X永豐96購03,,,,,0.00,0.00,0,0,0,0,0,0,0,0,0,0,0,0,0
20200520,052643,華通永豐96購02,,,,,0.00,0.00,0,0,0,0,0,0,0,0,0,0,0,0,0
20200520,052644,聯發科永豐96購01,1.67,1.67,1.28,1.28,+0.17,15.32,32000,2,41740,0,0,0,0,0,0,32000,0,32000,32000
20200520,052645,美食永豐96購01,,,,,0.00,0.00,0,0,0,0,0,0,0,0,0,0,0,0,0
20200520,052646,淘帝永豐96購01,,,,,0.00,0.00,0,0,0,0,0,0,0,0,0,0,0,0,0
20200520,052647,晶技永豐97購01,2.86,3.00,2.85,2.85,-0.19,-6.25,60000,4,178430,0,0,0,0,0,0,52000,8000,44000,44000
20200520,052648,茂林永豐96購01,0.01,0.01,0.01,0.01,0.00,0.00,70000,1,700,0,0,0,0,0,0,70000,0,70000,70000
20200520,052649,康控永豐96購01,,,,,0.00,0.00,0,0,0,0,0,0,0,0,0,0,0,0,0
20200520,052650,台郡永豐96購01,,,,,0.00,0.00,0,0,0,0,0,0,0,0,0,0,0,0,0
20200520,052651,台表科永豐96購02,,,,,0.00,0.00,0,0,0,0,0,0,0,0,0,0,0,0,0
20200520,052652,台虹永豐96購01,,,,,0.00,0.00,0,0,0,0,0,0,0,0,0,0,0,0,0
20200520,052653,臺股指永豐97購01,,,,,0.00,0.00,0,0,0,0,0,0,0,0,0,0,0,0,0
20200520,052654,友達統一97購01,0.33,0.33,0.33,0.33,+0.02,6.45,95000,1,31350,0,0,0,0,0,0,0,95000,-95000,-95000
20200520,052655,群創統一97購01,,,,,0.00,0.00,0,0,0,0,0,0,0,0,0,0,0,0,0
20200520,052656,力山元富96購01,,,,,0.00,0.00,0,0,0,0,0,0,0,0,0,0,0,0,0
20200520,052657,友達元富96購01,,,,,0.00,0.00,0,0,0,0,0,0,0,0,0,0,0,0,0
20200520,052658,友達元富9C購01,0.52,0.52,0.52,0.52,+0.16,44.44,10000,1,5200,0,0,0,0,0,0,0,10000,-10000,-10000
20200520,052659,上証2X國票99購01,0.78,0.80,0.78,0.80,-0.04,-4.76,15000,3,11800,0,0,0,0,0,0,5000,10000,-5000,-5000
20200520,052660,京元電國票97購01,,,,,0.00,0.00,0,0,0,0,0,0,0,0,0,0,0,0,0
20200520,052661,奇力新國票97購03,,,,,0.00,0.00,0,0,0,0,0,0,0,0,0,0,0,0,0
20200520,052662,華新科國票97購01,,,,,0.00,0.00,0,0,0,0,0,0,0,0,0,0,0,0,0
20200520,052663,奇鋐國票97購01,,,,,0.00,0.00,0,0,0,0,0,0,0,0,0,0,0,0,0
20200520,052664,麗豐國票96購02,,,,,0.00,0.00,0,0,0,0,0,0,0,0,0,0,0,0,0
20200520,052665,緯穎國票96購03,,,,,0.00,0.00,0,0,0,0,0,0,0,0,0,0,0,0,0
20200520,052666,瑞昱群益96購01,,,,,0.00,0.00,0,0,0,0,0,0,0,0,0,0,0,0,0
20200520,052667,漢唐群益96購01,,,,,0.00,0.00,0,0,0,0,0,0,0,0,0,0,0,0,0
20200520,052668,聯發科群益97購01,2.21,2.21,2.21,2.21,0.00,0.00,12000,1,26520,0,0,0,0,0,0,12000,0,12000,12000
20200520,052669,群創群益98購06,,,,,0.00,0.00,0,0,0,0,0,0,0,0,0,0,0,0,0
20200520,052670,茂林群益96購02,,,,,0.00,0.00,0,0,0,0,0,0,0,0,0,0,0,0,0
20200520,052671,祥碩群益96購01,,,,,0.00,0.00,0,0,0,0,0,0,0,0,0,0,0,0,0
20200520,052672,世紀鋼群益96購02,,,,,0.00,0.00,0,0,0,0,0,0,0,0,0,0,0,0,0
20200520,052673,T50反1國泰97購01,,,,,0.00,0.00,0,0,0,0,0,0,0,0,0,0,0,0,0
20200520,052674,智邦國泰98購01,4.00,4.00,4.00,4.00,0.00,0.00,1000,1,4000,0,0,0,0,0,0,0,1000,-1000,-1000
20200520,052675,新光金國泰98購01,,,,,0.00,0.00,0,0,0,0,0,0,0,0,0,0,0,0,0
20200520,052676,聯發科永昌98購01,3.38,3.68,3.38,3.68,+0.41,12.54,250000,33,886200,240000,0,240000,0,0,0,10000,240000,-230000,10000
20200520,052677,景碩富邦97購01,,,,,0.00,0.00,0,0,0,0,0,0,0,0,0,0,0,0,0
20200520,052678,群創富邦96購01,,,,,0.00,0.00,0,0,0,0,0,0,0,0,0,0,0,0,0
20200520,052679,致伸富邦98購01,,,,,0.00,0.00,0,0,0,0,0,0,0,0,0,0,0,0,0
20200520,052680,T50反1元大96購04,,,,,0.00,0.00,0,0,0,0,0,0,0,0,0,0,0,0,0
20200520,052681,T50反1元大98購02,1.06,1.08,1.05,1.06,-0.03,-2.75,492000,13,519210,0,0,0,0,0,0,446000,46000,400000,400000
20200520,052682,上銀元大97購01,,,,,0.00,0.00,0,0,0,0,0,0,0,0,0,0,0,0,0
20200520,052683,鴻海元大97購03,,,,,0.00,0.00,0,0,0,0,0,0,0,0,0,0,0,0,0
20200520,052684,旺宏元大98購01,0.39,0.45,0.39,0.45,+0.06,15.38,72000,3,28140,0,0,0,0,0,0,71000,0,71000,71000
20200520,052685,技嘉元大96購01,2.77,2.77,2.77,2.77,0.00,0.00,20000,1,55400,0,0,0,0,0,0,20000,20000,0,0
20200520,052686,華新科元大96購03,1.17,1.25,1.17,1.21,-0.03,-2.42,34000,5,40480,0,0,0,0,0,0,24000,10000,14000,14000
20200520,052687,國泰金元大96購03,,,,,0.00,0.00,0,0,0,0,0,0,0,0,0,0,0,0,0
20200520,052688,新日興元大96購01,,,,,0.00,0.00,0,0,0,0,0,0,0,0,0,0,0,0,0
20200520,052689,玉晶光元大98購03,,,,,0.00,0.00,0,0,0,0,0,0,0,0,0,0,0,0,0
20200520,05268P,玉晶光元大98售01,0.63,0.63,0.63,0.63,-0.02,-3.08,39000,4,24570,0,0,0,0,0,0,0,0,0,0
20200520,052690,台表科元大97購01,,,,,0.00,0.00,0,0,0,0,0,0,0,0,0,0,0,0,0
20200520,052691,GIS元大96購01,0.32,0.32,0.30,0.30,-0.04,-11.76,70000,6,21600,0,0,0,0,0,0,30000,40000,-10000,-10000
20200520,052692,滬深2X中信99購02,,,,,0.00,0.00,0,0,0,0,0,0,0,0,0,0,0,0,0
20200520,052693,微星中信96購01,,,,,0.00,0.00,0,0,0,0,0,0,0,0,0,0,0,0,0
20200520,052694,開發金中信98購01,,,,,0.00,0.00,0,0,0,0,0,0,0,0,0,0,0,0,0
20200520,052695,台表科中信98購01,0.09,0.19,0.07,0.18,+0.10,125.0,754000,39,90810,0,0,0,0,0,0,408000,92000,316000,316000
20200520,052696,玉晶光麥證97購01,2.82,3.16,2.82,3.16,+0.26,8.97,64000,18,195610,6000,58000,-52000,0,0,0,12000,64000,-52000,-52000
20200520,052697,滬深2X國票98購01,,,,,0.00,0.00,0,0,0,0,0,0,0,0,0,0,0,0,0
20200520,052698,深中小國票99購01,,,,,0.00,0.00,0,0,0,0,0,0,0,0,0,0,0,0,0
20200520,052699,友達國票97購01,,,,,0.00,0.00,0,0,0,0,0,0,0,0,0,0,0,0,0
20200520,052700,奇鋐國票97購02,0.29,0.35,0.29,0.34,+0.01,3.03,494000,10,158560,0,0,0,0,0,0,226000,268000,-42000,-42000
20200520,052701,群創國票96購01,,,,,0.00,0.00,0,0,0,0,0,0,0,0,0,0,0,0,0
20200520,052702,群創國票97購03,,,,,0.00,0.00,0,0,0,0,0,0,0,0,0,0,0,0,0
20200520,052703,貿聯國票97購01,,,,,0.00,0.00,0,0,0,0,0,0,0,0,0,0,0,0,0
20200520,052704,TPK國票97購01,,,,,0.00,0.00,0,0,0,0,0,0,0,0,0,0,0,0,0
20200520,052705,超眾國票97購01,,,,,0.00,0.00,0,0,0,0,0,0,0,0,0,0,0,0,0
20200520,052706,台虹國票97購01,,,,,0.00,0.00,0,0,0,0,0,0,0,0,0,0,0,0,0
20200520,052707,景碩台新96購01,,,,,0.00,0.00,0,0,0,0,0,0,0,0,0,0,0,0,0
20200520,052708,楠梓電永豐97購01,,,,,0.00,0.00,0,0,0,0,0,0,0,0,0,0,0,0,0
20200520,052709,光寶科日盛96購01,,,,,0.00,0.00,0,0,0,0,0,0,0,0,0,0,0,0,0
20200520,052710,玉晶光日盛96購01,,,,,0.00,0.00,0,0,0,0,0,0,0,0,0,0,0,0,0
20200520,052711,滬深2X凱基97購01,,,,,0.00,0.00,0,0,0,0,0,0,0,0,0,0,0,0,0
20200520,052712,旺宏凱基96購02,0.25,0.25,0.25,0.25,0.00,0.00,10000,1,2500,0,0,0,0,0,0,10000,0,10000,10000
20200520,052713,智邦凱基96購01,,,,,0.00,0.00,0,0,0,0,0,0,0,0,0,0,0,0,0
20200520,052714,義隆凱基96購02,,,,,0.00,0.00,0,0,0,0,0,0,0,0,0,0,0,0,0
20200520,052715,可成凱基96購01,,,,,0.00,0.00,0,0,0,0,0,0,0,0,0,0,0,0,0
20200520,052716,欣興凱基96購01,,,,,0.00,0.00,0,0,0,0,0,0,0,0,0,0,0,0,0
20200520,052717,正文凱基96購01,,,,,0.00,0.00,0,0,0,0,0,0,0,0,0,0,0,0,0
20200520,052718,新唐凱基96購01,,,,,0.00,0.00,0,0,0,0,0,0,0,0,0,0,0,0,0
20200520,052719,致新凱基96購01,,,,,0.00,0.00,0,0,0,0,0,0,0,0,0,0,0,0,0
20200520,05271P,國巨富邦97售01,0.10,0.10,0.10,0.10,-0.05,-33.33,184000,5,18400,0,0,0,0,0,0,139000,184000,-45000,-45000
20200520,052720,鴻海統一96購07,,,,,0.00,0.00,0,0,0,0,0,0,0,0,0,0,0,0,0
20200520,052721,友達統一96購01,,,,,0.00,0.00,0,0,0,0,0,0,0,0,0,0,0,0,0
20200520,052722,群創統一97購02,,,,,0.00,0.00,0,0,0,0,0,0,0,0,0,0,0,0,0
20200520,052723,新唐統一97購01,0.05,0.05,0.05,0.05,0.00,0.00,10000,1,500,0,0,0,0,0,0,10000,0,10000,10000
20200520,052724,力成統一97購01,,,,,0.00,0.00,0,0,0,0,0,0,0,0,0,0,0,0,0
20200520,052725,為升元富96購01,,,,,0.00,0.00,0,0,0,0,0,0,0,0,0,0,0,0,0
20200520,052726,鴻海元富96購03,,,,,0.00,0.00,0,0,0,0,0,0,0,0,0,0,0,0,0
20200520,052727,仁寶元富96購01,,,,,0.00,0.00,0,0,0,0,0,0,0,0,0,0,0,0,0
20200520,052728,上証2X國泰97購01,,,,,0.00,0.00,0,0,0,0,0,0,0,0,0,0,0,0,0
20200520,052729,國巨國泰97購03,1.97,1.97,1.94,1.94,0.00,0.00,20000,2,39100,0,0,0,0,0,0,0,20000,-20000,-20000
20200520,05272P,臻鼎中信97售03,0.33,0.33,0.30,0.31,-0.09,-22.5,44000,5,13400,0,0,0,0,0,0,0,44000,-44000,-44000
20200520,052730,華新科國泰98購01,1.80,1.80,1.80,1.80,0.00,0.00,45000,1,81000,0,0,0,0,0,0,45000,45000,0,0
20200520,052731,宏達電國泰98購01,,,,,0.00,0.00,0,0,0,0,0,0,0,0,0,0,0,0,0
20200520,052732,新唐國泰97購01,,,,,0.00,0.00,0,0,0,0,0,0,0,0,0,0,0,0,0
20200520,052733,台郡國泰97購01,,,,,0.00,0.00,0,0,0,0,0,0,0,0,0,0,0,0,0
20200520,052734,台表科國泰98購02,0.84,1.20,0.81,1.20,+0.50,71.43,73000,10,71020,0,0,0,0,0,0,33000,20000,13000,13000
20200520,052735,燿華富邦98購01,,,,,0.00,0.00,0,0,0,0,0,0,0,0,0,0,0,0,0
20200520,052736,T50反1元大96購05,,,,,0.00,0.00,0,0,0,0,0,0,0,0,0,0,0,0,0
20200520,052737,滬深2X元大96購06,,,,,0.00,0.00,0,0,0,0,0,0,0,0,0,0,0,0,0
20200520,052738,聯電元大98購02,0.57,0.57,0.51,0.51,-0.05,-8.93,303000,11,169510,0,0,0,0,0,0,149000,154000,-5000,-5000
20200520,052739,國巨元大96購04,1.47,1.47,1.47,1.47,0.00,0.00,1000,1,1470,0,0,0,0,0,0,0,1000,-1000,-1000
20200520,052740,聯發科元大96購07,,,,,0.00,0.00,0,0,0,0,0,0,0,0,0,0,0,0,0
20200520,052741,聯發科元大96購08,1.50,1.50,1.50,1.50,+0.29,23.97,20000,1,30000,0,0,0,0,0,0,20000,0,20000,20000
20200520,052742,可成元大96購01,,,,,0.00,0.00,0,0,0,0,0,0,0,0,0,0,0,0,0
20200520,052743,華新科元大97購01,,,,,0.00,0.00,0,0,0,0,0,0,0,0,0,0,0,0,0
20200520,052744,聯詠元大97購01,,,,,0.00,0.00,0,0,0,0,0,0,0,0,0,0,0,0,0
20200520,052745,欣興元大96購04,,,,,0.00,0.00,0,0,0,0,0,0,0,0,0,0,0,0,0
20200520,052746,泰碩元大97購01,,,,,0.00,0.00,0,0,0,0,0,0,0,0,0,0,0,0,0
20200520,052747,京鼎元大97購01,0.71,0.71,0.71,0.71,0.00,0.00,20000,2,14200,0,0,0,0,0,0,0,20000,-20000,-20000
20200520,052748,群創元大9A購02,,,,,0.00,0.00,0,0,0,0,0,0,0,0,0,0,0,0,0
20200520,052749,日月光元大96購02,,,,,0.00,0.00,0,0,0,0,0,0,0,0,0,0,0,0,0
20200520,052750,臺股指元大96購04,,,,,0.00,0.00,0,0,0,0,0,0,0,0,0,0,0,0,0
20200520,052751,臺股指元大96購05,,,,,0.00,0.00,0,0,0,0,0,0,0,0,0,0,0,0,0
20200520,052752,臺股指元大96購06,,,,,0.00,0.00,0,0,0,0,0,0,0,0,0,0,0,0,0
20200520,052753,電子類元大96購02,,,,,0.00,0.00,0,0,0,0,0,0,0,0,0,0,0,0,0
20200520,052754,上証2X群益9A購01,,,,,0.00,0.00,0,0,0,0,0,0,0,0,0,0,0,0,0
20200520,052755,滬深2X群益9A購01,,,,,0.00,0.00,0,0,0,0,0,0,0,0,0,0,0,0,0
20200520,052756,國巨群益96購02,,,,,0.00,0.00,0,0,0,0,0,0,0,0,0,0,0,0,0
20200520,052757,華邦電群益96購01,,,,,0.00,0.00,0,0,0,0,0,0,0,0,0,0,0,0,0
20200520,052758,友達群益99購01,,,,,0.00,0.00,0,0,0,0,0,0,0,0,0,0,0,0,0
20200520,052759,京元電群益96購01,,,,,0.00,0.00,0,0,0,0,0,0,0,0,0,0,0,0,0
20200520,052760,盟立群益96購01,,,,,0.00,0.00,0,0,0,0,0,0,0,0,0,0,0,0,0
20200520,052761,可成群益96購02,,,,,0.00,0.00,0,0,0,0,0,0,0,0,0,0,0,0,0
20200520,052762,欣興群益96購01,,,,,0.00,0.00,0,0,0,0,0,0,0,0,0,0,0,0,0
20200520,052763,晶技群益97購01,,,,,0.00,0.00,0,0,0,0,0,0,0,0,0,0,0,0,0
20200520,052764,景碩群益98購01,0.97,0.97,0.82,0.84,-0.14,-14.29,110000,11,96300,0,0,0,0,0,0,30000,80000,-50000,-50000
20200520,052765,新日興群益97購01,,,,,0.00,0.00,0,0,0,0,0,0,0,0,0,0,0,0,0
20200520,052766,玉晶光群益9A購01,,,,,0.00,0.00,0,0,0,0,0,0,0,0,0,0,0,0,0
20200520,052767,智伸科群益98購01,,,,,0.00,0.00,0,0,0,0,0,0,0,0,0,0,0,0,0
20200520,052768,泰鼎群益96購01,2.51,3.21,2.51,3.21,0.00,0.00,21000,3,57210,0,0,0,0,0,0,11000,10000,1000,1000
20200520,052769,達興群益96購01,,,,,0.00,0.00,0,0,0,0,0,0,0,0,0,0,0,0,0
20200520,052770,聯茂群益96購02,,,,,0.00,0.00,0,0,0,0,0,0,0,0,0,0,0,0,0
20200520,052771,GIS群益96購01,,,,,0.00,0.00,0,0,0,0,0,0,0,0,0,0,0,0,0
20200520,052772,台虹群益96購01,,,,,0.00,0.00,0,0,0,0,0,0,0,0,0,0,0,0,0
20200520,052773,大成鋼亞東97購01,,,,,0.00,0.00,0,0,0,0,0,0,0,0,0,0,0,0,0
20200520,052774,京元電亞東96購01,,,,,0.00,0.00,0,0,0,0,0,0,0,0,0,0,0,0,0
20200520,052775,滬深2X國票99購02,,,,,0.00,0.00,0,0,0,0,0,0,0,0,0,0,0,0,0
20200520,052776,力山國票97購01,,,,,0.00,0.00,0,0,0,0,0,0,0,0,0,0,0,0,0
20200520,052777,燿華國票98購01,0.33,0.42,0.33,0.42,0.00,0.00,175000,10,63380,0,0,0,0,0,0,1000,174000,-173000,-173000
20200520,052778,智原國票97購01,,,,,0.00,0.00,0,0,0,0,0,0,0,0,0,0,0,0,0
20200520,052779,欣興國票97購01,,,,,0.00,0.00,0,0,0,0,0,0,0,0,0,0,0,0,0
20200520,052780,玉晶光國票96購04,,,,,0.00,0.00,0,0,0,0,0,0,0,0,0,0,0,0,0
20200520,052781,瀚宇博國票97購03,,,,,0.00,0.00,0,0,0,0,0,0,0,0,0,0,0,0,0
20200520,052782,超眾國票96購02,,,,,0.00,0.00,0,0,0,0,0,0,0,0,0,0,0,0,0
20200520,052783,台郡國票97購01,,,,,0.00,0.00,0,0,0,0,0,0,0,0,0,0,0,0,0
20200520,052784,緯穎國票97購02,,,,,0.00,0.00,0,0,0,0,0,0,0,0,0,0,0,0,0
20200520,052785,滬深2X中信99購03,0.73,0.73,0.73,0.73,0.00,0.00,60000,1,43800,0,0,0,0,0,0,60000,0,60000,60000
20200520,052786,S&P500中信96購01,0.03,0.03,0.01,0.03,+0.01,50.0,92000,3,960,0,0,0,0,0,0,0,0,0,0
20200520,052787,國巨中信96購02,0.37,0.37,0.36,0.36,+0.17,89.47,30000,3,10900,0,0,0,0,0,0,30000,20000,10000,10000
20200520,052788,開發金中信98購02,,,,,0.00,0.00,0,0,0,0,0,0,0,0,0,0,0,0,0
20200520,052789,台積電麥證96購01,0.63,0.63,0.63,0.63,-0.06,-8.7,10000,1,6300,0,10000,-10000,0,0,0,10000,10000,0,0
20200520,052790,智邦兆豐97購01,2.97,2.97,2.97,2.97,+0.10,3.48,5000,1,14850,0,0,0,0,0,0,0,0,0,0
20200520,052791,友達兆豐97購01,0.03,0.03,0.03,0.03,+0.01,50.0,20000,2,600,0,0,0,0,0,0,20000,10000,10000,10000
20200520,052792,大立光兆豐96購01,,,,,0.00,0.00,0,0,0,0,0,0,0,0,0,0,0,0,0
20200520,052793,健鼎兆豐96購01,,,,,0.00,0.00,0,0,0,0,0,0,0,0,0,0,0,0,0
20200520,052794,群創兆豐97購01,,,,,0.00,0.00,0,0,0,0,0,0,0,0,0,0,0,0,0
20200520,052795,健策兆豐97購01,0.94,0.94,0.94,0.94,0.00,0.00,5000,1,4700,0,0,0,0,0,0,5000,0,5000,5000
20200520,052796,和碩兆豐96購01,0.17,0.17,0.17,0.17,0.00,0.00,10000,1,1700,0,0,0,0,0,0,10000,0,10000,10000
20200520,052797,樺漢兆豐96購01,,,,,0.00,0.00,0,0,0,0,0,0,0,0,0,0,0,0,0
20200520,052798,滬深2X元大96購07,0.15,0.15,0.15,0.15,-0.03,-16.67,48000,1,7200,0,0,0,0,0,0,48000,0,48000,48000
20200520,052799,上銀元大96購01,,,,,0.00,0.00,0,0,0,0,0,0,0,0,0,0,0,0,0
20200520,052800,國巨元大96購05,0.99,1.30,0.99,1.02,0.00,0.00,4000,3,4300,0,0,0,0,0,0,2000,4000,-2000,-2000
20200520,052801,友達元大9A購01,,,,,0.00,0.00,0,0,0,0,0,0,0,0,0,0,0,0,0
20200520,052802,華新科元大97購02,1.36,1.36,1.36,1.36,0.00,0.00,1000,1,1360,0,0,0,0,0,0,0,0,0,0
20200520,052803,冠德元大96購01,,,,,0.00,0.00,0,0,0,0,0,0,0,0,0,0,0,0,0
20200520,052804,淘帝元大96購01,,,,,0.00,0.00,0,0,0,0,0,0,0,0,0,0,0,0,0
20200520,052805,晶技元大97購01,1.99,1.99,1.73,1.73,0.00,0.00,4000,3,7620,0,0,0,0,0,0,0,4000,-4000,-4000
20200520,052806,玉晶光元大98購04,2.68,2.78,2.68,2.75,+0.09,3.38,19000,4,52070,0,0,0,0,0,0,0,19000,-19000,-19000
20200520,052807,貿聯元大98購01,,,,,0.00,0.00,0,0,0,0,0,0,0,0,0,0,0,0,0
20200520,052808,矽力元大96購02,,,,,0.00,0.00,0,0,0,0,0,0,0,0,0,0,0,0,0
20200520,052809,訊芯元大97購01,0.23,0.23,0.23,0.23,+0.01,4.55,130000,2,29900,0,0,0,0,0,0,130000,0,130000,130000
20200520,052810,易華電元大96購02,,,,,0.00,0.00,0,0,0,0,0,0,0,0,0,0,0,0,0
20200520,052811,玉晶光台新96購03,,,,,0.00,0.00,0,0,0,0,0,0,0,0,0,0,0,0,0
20200520,052812,致伸康和96購01,,,,,0.00,0.00,0,0,0,0,0,0,0,0,0,0,0,0,0
20200520,052813,T50正2永豐96購01,,,,,0.00,0.00,0,0,0,0,0,0,0,0,0,0,0,0,0
20200520,052814,上証2X永豐96購02,,,,,0.00,0.00,0,0,0,0,0,0,0,0,0,0,0,0,0
20200520,052815,滬深2X永豐97購01,,,,,0.00,0.00,0,0,0,0,0,0,0,0,0,0,0,0,0
20200520,052816,上銀永豐96購01,,,,,0.00,0.00,0,0,0,0,0,0,0,0,0,0,0,0,0
20200520,052817,楠梓電永豐96購02,,,,,0.00,0.00,0,0,0,0,0,0,0,0,0,0,0,0,0
20200520,052818,智邦永豐96購01,1.01,1.01,1.01,1.01,-0.04,-3.81,5000,1,5050,0,0,0,0,0,0,5000,0,5000,5000
20200520,052819,義隆永豐96購01,0.88,0.88,0.88,0.88,0.00,0.00,10000,1,8800,0,0,0,0,0,0,0,10000,-10000,-10000
20200520,052820,宏達電永豐96購01,,,,,0.00,0.00,0,0,0,0,0,0,0,0,0,0,0,0,0
20200520,052821,晶技永豐96購01,,,,,0.00,0.00,0,0,0,0,0,0,0,0,0,0,0,0,0
20200520,052822,泰碩永豐97購01,0.57,0.58,0.56,0.56,-0.08,-12.5,306000,7,172720,0,0,0,0,0,0,226000,80000,146000,146000
20200520,052823,創意永豐96購02,,,,,0.00,0.00,0,0,0,0,0,0,0,0,0,0,0,0,0
20200520,052824,揚明光永豐96購02,,,,,0.00,0.00,0,0,0,0,0,0,0,0,0,0,0,0,0
20200520,052825,TPK永豐96購01,,,,,0.00,0.00,0,0,0,0,0,0,0,0,0,0,0,0,0
20200520,052826,嘉聯益永豐96購01,,,,,0.00,0.00,0,0,0,0,0,0,0,0,0,0,0,0,0
20200520,052827,昇陽半永豐97購01,,,,,0.00,0.00,0,0,0,0,0,0,0,0,0,0,0,0,0
20200520,052828,滬深2X群益9A購02,0.13,0.13,0.13,0.13,-0.01,-7.14,200000,1,26000,0,0,0,0,0,0,200000,200000,0,0
20200520,052829,上銀群益96購01,,,,,0.00,0.00,0,0,0,0,0,0,0,0,0,0,0,0,0
20200520,052830,台光電群益96購01,,,,,0.00,0.00,0,0,0,0,0,0,0,0,0,0,0,0,0
20200520,052831,華固群益96購01,,,,,0.00,0.00,0,0,0,0,0,0,0,0,0,0,0,0,0
20200520,052832,益航群益96購01,,,,,0.00,0.00,0,0,0,0,0,0,0,0,0,0,0,0,0
20200520,052833,康控群益96購01,,,,,0.00,0.00,0,0,0,0,0,0,0,0,0,0,0,0,0
20200520,052834,彩晶群益96購01,,,,,0.00,0.00,0,0,0,0,0,0,0,0,0,0,0,0,0
20200520,052835,滬深2X國泰98購01,,,,,0.00,0.00,0,0,0,0,0,0,0,0,0,0,0,0,0
20200520,052836,旺宏國泰98購01,,,,,0.00,0.00,0,0,0,0,0,0,0,0,0,0,0,0,0
20200520,052837,友達國泰97購01,0.33,0.36,0.33,0.36,+0.01,2.86,310000,3,107850,0,0,0,0,0,0,125000,185000,-60000,-60000
20200520,052838,新唐國泰98購01,0.17,0.17,0.16,0.16,0.00,0.00,280000,13,45800,0,0,0,0,0,0,0,280000,-280000,-280000
20200520,052839,上海銀國泰97購01,0.10,0.10,0.10,0.10,0.00,0.00,32000,1,3200,0,0,0,0,0,0,32000,0,32000,32000
20200520,052840,友達富邦96購01,,,,,0.00,0.00,0,0,0,0,0,0,0,0,0,0,0,0,0
20200520,052841,群創富邦96購02,,,,,0.00,0.00,0,0,0,0,0,0,0,0,0,0,0,0,0
20200520,052842,滬深2X統一96購01,,,,,0.00,0.00,0,0,0,0,0,0,0,0,0,0,0,0,0
20200520,052843,鴻海統一96購09,,,,,0.00,0.00,0,0,0,0,0,0,0,0,0,0,0,0,0
20200520,052844,台積電統一96購02,,,,,0.00,0.00,0,0,0,0,0,0,0,0,0,0,0,0,0
20200520,052845,旺宏統一97購01,,,,,0.00,0.00,0,0,0,0,0,0,0,0,0,0,0,0,0
20200520,052846,智邦統一97購01,3.10,3.10,3.10,3.10,-0.56,-15.3,2000,1,6200,0,0,0,0,0,0,0,2000,-2000,-2000
20200520,052847,漢唐統一99購01,0.65,0.65,0.65,0.65,0.00,0.00,200000,1,130000,0,0,0,0,0,0,0,200000,-200000,-200000
20200520,052848,聯發科統一96購03,,,,,0.00,0.00,0,0,0,0,0,0,0,0,0,0,0,0,0
20200520,052849,可成統一97購01,0.22,0.22,0.20,0.20,-0.08,-28.57,182000,4,37620,0,0,0,0,0,0,62000,120000,-58000,-58000
20200520,052850,華新科統一96購02,,,,,0.00,0.00,0,0,0,0,0,0,0,0,0,0,0,0,0
20200520,052851,滬深2X元富96購02,,,,,0.00,0.00,0,0,0,0,0,0,0,0,0,0,0,0,0
20200520,052852,國巨元富96購02,0.01,0.06,0.01,0.01,0.00,0.00,850000,13,8550,0,0,0,0,0,0,0,0,0,0
20200520,052853,友達日盛99購01,,,,,0.00,0.00,0,0,0,0,0,0,0,0,0,0,0,0,0
20200520,052854,聯詠日盛96購01,,,,,0.00,0.00,0,0,0,0,0,0,0,0,0,0,0,0,0
20200520,052855,群創日盛99購01,,,,,0.00,0.00,0,0,0,0,0,0,0,0,0,0,0,0,0
20200520,052856,滬深2X凱基98購01,,,,,0.00,0.00,0,0,0,0,0,0,0,0,0,0,0,0,0
20200520,052857,大成鋼凱基96購01,,,,,0.00,0.00,0,0,0,0,0,0,0,0,0,0,0,0,0
20200520,052858,華通凱基97購02,0.29,0.29,0.27,0.27,-0.04,-12.9,102000,3,29540,0,0,0,0,0,0,92000,10000,82000,82000
20200520,052859,國巨凱基96購07,0.66,0.66,0.66,0.66,+0.09,15.79,5000,1,3300,0,0,0,0,0,0,0,0,0,0
20200520,052860,旺宏凱基96購03,,,,,0.00,0.00,0,0,0,0,0,0,0,0,0,0,0,0,0
20200520,052861,台光電凱基96購03,,,,,0.00,0.00,0,0,0,0,0,0,0,0,0,0,0,0,0
20200520,052862,正崴凱基96購01,,,,,0.00,0.00,0,0,0,0,0,0,0,0,0,0,0,0,0
20200520,052863,友達凱基98購02,0.49,0.49,0.42,0.43,-0.01,-2.27,25000,5,11570,0,0,0,0,0,0,0,25000,-25000,-25000
20200520,052864,奇力新凱基96購02,,,,,0.00,0.00,0,0,0,0,0,0,0,0,0,0,0,0,0
20200520,052865,大立光凱基96購11,,,,,0.00,0.00,0,0,0,0,0,0,0,0,0,0,0,0,0
20200520,052866,大立光凱基96購12,,,,,0.00,0.00,0,0,0,0,0,0,0,0,0,0,0,0,0
20200520,052867,晶技凱基96購01,,,,,0.00,0.00,0,0,0,0,0,0,0,0,0,0,0,0,0
20200520,052868,緯創凱基96購03,,,,,0.00,0.00,0,0,0,0,0,0,0,0,0,0,0,0,0
20200520,052869,新日興凱基96購01,,,,,0.00,0.00,0,0,0,0,0,0,0,0,0,0,0,0,0
20200520,052870,玉晶光凱基96購03,,,,,0.00,0.00,0,0,0,0,0,0,0,0,0,0,0,0,0
20200520,052871,群創凱基98購07,,,,,0.00,0.00,0,0,0,0,0,0,0,0,0,0,0,0,0
20200520,052872,智易凱基96購01,,,,,0.00,0.00,0,0,0,0,0,0,0,0,0,0,0,0,0
20200520,052873,新唐凱基96購02,,,,,0.00,0.00,0,0,0,0,0,0,0,0,0,0,0,0,0
20200520,052874,超眾凱基96購01,,,,,0.00,0.00,0,0,0,0,0,0,0,0,0,0,0,0,0
20200520,052875,樺漢凱基96購02,,,,,0.00,0.00,0,0,0,0,0,0,0,0,0,0,0,0,0
20200520,052876,GIS凱基96購03,,,,,0.00,0.00,0,0,0,0,0,0,0,0,0,0,0,0,0
20200520,052877,矽創凱基96購01,,,,,0.00,0.00,0,0,0,0,0,0,0,0,0,0,0,0,0
20200520,052878,台虹凱基96購01,,,,,0.00,0.00,0,0,0,0,0,0,0,0,0,0,0,0,0
20200520,052879,滬深2X凱基97購02,,,,,0.00,0.00,0,0,0,0,0,0,0,0,0,0,0,0,0
20200520,052880,台積電凱基96購06,,,,,0.00,0.00,0,0,0,0,0,0,0,0,0,0,0,0,0
20200520,052881,康控凱基97購01,,,,,0.00,0.00,0,0,0,0,0,0,0,0,0,0,0,0,0
20200520,052882,南電凱基96購02,,,,,0.00,0.00,0,0,0,0,0,0,0,0,0,0,0,0,0
20200520,052883,百和亞東97購01,,,,,0.00,0.00,0,0,0,0,0,0,0,0,0,0,0,0,0
20200520,052884,台積電兆豐96購01,,,,,0.00,0.00,0,0,0,0,0,0,0,0,0,0,0,0,0
20200520,052885,高鐵兆豐98購01,0.42,0.50,0.42,0.46,+0.04,9.52,174000,7,77720,0,0,0,0,0,0,110000,54000,56000,56000
20200520,052886,世紀鋼兆豐96購01,1.76,1.76,1.48,1.48,-0.21,-12.43,42000,6,66710,0,0,0,0,0,0,30000,7000,23000,23000
20200520,052887,華通中信96購01,0.12,0.12,0.12,0.12,0.00,0.00,200000,1,24000,0,0,0,0,0,0,200000,0,200000,200000
20200520,052888,台表科中信9A購01,0.35,0.51,0.29,0.47,+0.17,56.67,1232000,66,422190,0,0,0,0,0,0,888000,0,888000,888000
20200520,052889,致伸麥證97購01,,,,,0.00,0.00,0,0,0,0,0,0,0,0,0,0,0,0,0
20200520,052890,FB上証群益9B購01,0.63,0.64,0.61,0.64,+0.02,3.23,104000,5,63540,0,0,0,0,0,0,102000,102000,0,0
20200520,052891,台泥群益96購01,,,,,0.00,0.00,0,0,0,0,0,0,0,0,0,0,0,0,0
20200520,052892,大成鋼群益96購01,,,,,0.00,0.00,0,0,0,0,0,0,0,0,0,0,0,0,0
20200520,052893,聯電群益98購01,0.41,0.42,0.36,0.38,-0.03,-7.32,46000,9,17880,0,0,0,0,0,0,12000,34000,-22000,-22000
20200520,052894,國巨群益96購03,0.26,0.26,0.26,0.26,0.00,0.00,20000,1,5200,0,0,0,0,0,0,20000,0,20000,20000
20200520,052895,台積電群益96購04,1.68,1.81,1.68,1.81,+0.05,2.84,58000,4,98090,0,0,0,0,0,0,53000,5000,48000,48000
20200520,052896,宏達電群益96購01,,,,,0.00,0.00,0,0,0,0,0,0,0,0,0,0,0,0,0
20200520,052897,緯創群益96購03,,,,,0.00,0.00,0,0,0,0,0,0,0,0,0,0,0,0,0
20200520,052898,樺漢群益96購01,,,,,0.00,0.00,0,0,0,0,0,0,0,0,0,0,0,0,0
20200520,052899,和大國票97購01,,,,,0.00,0.00,0,0,0,0,0,0,0,0,0,0,0,0,0
20200520,052900,大成鋼國票97購01,,,,,0.00,0.00,0,0,0,0,0,0,0,0,0,0,0,0,0
20200520,052901,台達電國票97購01,,,,,0.00,0.00,0,0,0,0,0,0,0,0,0,0,0,0,0
20200520,052902,鴻海國票97購04,0.05,0.05,0.05,0.05,0.00,0.00,2000,2,100,0,0,0,0,0,0,0,0,0,0
20200520,052903,致茂國票97購01,,,,,0.00,0.00,0,0,0,0,0,0,0,0,0,0,0,0,0
20200520,052904,冠德國票97購01,,,,,0.00,0.00,0,0,0,0,0,0,0,0,0,0,0,0,0
20200520,052905,潤泰全國票97購01,,,,,0.00,0.00,0,0,0,0,0,0,0,0,0,0,0,0,0
20200520,052906,緯創國票97購01,,,,,0.00,0.00,0,0,0,0,0,0,0,0,0,0,0,0,0
20200520,052907,嘉澤國票97購01,9.15,9.15,9.15,9.15,-0.40,-4.19,21000,1,192150,0,0,0,0,0,0,0,21000,-21000,-21000
20200520,052908,大成鋼統一96購01,0.61,0.75,0.61,0.75,+0.16,27.12,480000,8,343150,0,0,0,0,0,0,275000,205000,70000,70000
20200520,052909,上銀統一96購01,,,,,0.00,0.00,0,0,0,0,0,0,0,0,0,0,0,0,0
20200520,052910,鴻海統一96購10,,,,,0.00,0.00,0,0,0,0,0,0,0,0,0,0,0,0,0
20200520,052911,友達統一97購02,,,,,0.00,0.00,0,0,0,0,0,0,0,0,0,0,0,0,0
20200520,052912,日月光統一96購01,,,,,0.00,0.00,0,0,0,0,0,0,0,0,0,0,0,0,0
20200520,052913,鴻海元富96購05,,,,,0.00,0.00,0,0,0,0,0,0,0,0,0,0,0,0,0
20200520,052914,奇力新元富96購01,,,,,0.00,0.00,0,0,0,0,0,0,0,0,0,0,0,0,0
20200520,052915,創意元富96購01,,,,,0.00,0.00,0,0,0,0,0,0,0,0,0,0,0,0,0
20200520,052916,華新科富邦96購01,1.13,1.13,1.13,1.13,0.00,0.00,20000,1,22600,0,0,0,0,0,0,20000,0,20000,20000
20200520,052917,大立光富邦99購02,,,,,0.00,0.00,0,0,0,0,0,0,0,0,0,0,0,0,0
20200520,052918,智易富邦97購02,,,,,0.00,0.00,0,0,0,0,0,0,0,0,0,0,0,0,0
20200520,052919,鈺齊富邦98購01,,,,,0.00,0.00,0,0,0,0,0,0,0,0,0,0,0,0,0
20200520,052920,景碩台新96購02,,,,,0.00,0.00,0,0,0,0,0,0,0,0,0,0,0,0,0
20200520,052921,大成鋼永豐96購01,,,,,0.00,0.00,0,0,0,0,0,0,0,0,0,0,0,0,0
20200520,052922,國巨永豐96購01,,,,,0.00,0.00,0,0,0,0,0,0,0,0,0,0,0,0,0
20200520,052923,台積電永豐96購02,0.07,0.07,0.07,0.07,0.00,0.00,20000,1,1400,0,0,0,0,0,0,20000,20000,0,0
20200520,052924,旺宏永豐96購01,,,,,0.00,0.00,0,0,0,0,0,0,0,0,0,0,0,0,0
20200520,052925,日電貿永豐96購01,,,,,0.00,0.00,0,0,0,0,0,0,0,0,0,0,0,0,0
20200520,052926,旺宏元大98購02,0.35,0.35,0.32,0.32,0.00,0.00,70000,2,22550,0,0,0,0,0,0,65000,0,65000,65000
20200520,052927,友達元大98購02,,,,,0.00,0.00,0,0,0,0,0,0,0,0,0,0,0,0,0
20200520,052928,美律元大98購01,,,,,0.00,0.00,0,0,0,0,0,0,0,0,0,0,0,0,0
20200520,052929,可成元大96購02,,,,,0.00,0.00,0,0,0,0,0,0,0,0,0,0,0,0,0
20200520,052930,華新科元大97購03,,,,,0.00,0.00,0,0,0,0,0,0,0,0,0,0,0,0,0
20200520,052931,麗豐元大97購01,,,,,0.00,0.00,0,0,0,0,0,0,0,0,0,0,0,0,0
20200520,052932,正文元大97購01,,,,,0.00,0.00,0,0,0,0,0,0,0,0,0,0,0,0,0
20200520,052933,祥碩元大96購01,,,,,0.00,0.00,0,0,0,0,0,0,0,0,0,0,0,0,0
20200520,052934,中磊元大96購01,0.39,0.39,0.39,0.39,-0.05,-11.36,200000,1,78000,0,0,0,0,0,0,200000,0,200000,200000
20200520,052935,康友元大96購03,,,,,0.00,0.00,0,0,0,0,0,0,0,0,0,0,0,0,0
20200520,052936,華通兆豐98購01,0.15,0.15,0.15,0.15,-0.05,-25.0,10000,1,1500,0,0,0,0,0,0,0,10000,-10000,-10000
20200520,052937,國巨兆豐97購01,0.28,0.45,0.28,0.33,+0.09,37.5,36000,4,12340,0,0,0,0,0,0,10000,10000,0,0
20200520,052938,華新科兆豐96購01,0.99,0.99,0.99,0.99,+0.01,1.02,92000,1,91080,0,0,0,0,0,0,92000,0,92000,92000
20200520,052939,富邦金兆豐96購01,0.20,0.20,0.17,0.18,-0.01,-5.26,430000,7,78050,0,0,0,0,0,0,315000,50000,265000,265000
20200520,052940,玉晶光兆豐97購01,1.52,1.56,1.52,1.56,+0.16,11.43,16000,2,24560,0,0,0,0,0,0,0,16000,-16000,-16000
20200520,052941,康控兆豐97購01,0.12,0.12,0.11,0.11,0.00,0.00,300000,5,35000,0,0,0,0,0,0,0,300000,-300000,-300000
20200520,052942,聯發科中信97購04,0.66,0.85,0.65,0.76,+0.13,20.63,544000,25,414550,0,0,0,0,0,0,452000,0,452000,452000
20200520,052943,奇力新國票96購02,,,,,0.00,0.00,0,0,0,0,0,0,0,0,0,0,0,0,0
20200520,052944,宏達電國票97購01,,,,,0.00,0.00,0,0,0,0,0,0,0,0,0,0,0,0,0
20200520,052945,嘉晶國票97購01,1.07,1.78,1.07,1.78,+0.85,91.4,1102000,30,1372850,0,0,0,0,0,0,255000,841000,-586000,-586000
20200520,052946,智原國票97購02,,,,,0.00,0.00,0,0,0,0,0,0,0,0,0,0,0,0,0
20200520,052947,晶技國票97購01,,,,,0.00,0.00,0,0,0,0,0,0,0,0,0,0,0,0,0
20200520,052948,景碩國票97購02,,,,,0.00,0.00,0,0,0,0,0,0,0,0,0,0,0,0,0
20200520,052949,智易國票97購02,,,,,0.00,0.00,0,0,0,0,0,0,0,0,0,0,0,0,0
20200520,052950,超眾國票98購01,,,,,0.00,0.00,0,0,0,0,0,0,0,0,0,0,0,0,0
20200520,052951,GIS國票97購02,,,,,0.00,0.00,0,0,0,0,0,0,0,0,0,0,0,0,0
20200520,052952,矽創國票97購02,0.25,0.26,0.25,0.26,+0.08,44.44,15000,13,3760,0,0,0,0,0,0,15000,0,15000,15000
20200520,052953,百和國票97購01,,,,,0.00,0.00,0,0,0,0,0,0,0,0,0,0,0,0,0
20200520,052954,大成鋼日盛96購01,,,,,0.00,0.00,0,0,0,0,0,0,0,0,0,0,0,0,0
20200520,052955,國巨日盛96購01,0.25,0.73,0.11,0.73,+0.63,630.0,21000,4,3770,0,0,0,0,0,0,13000,5000,8000,8000
20200520,052956,聯發科日盛96購01,0.53,0.53,0.53,0.53,0.00,0.00,20000,1,10600,0,0,0,0,0,0,20000,0,20000,20000
20200520,052957,T50反1凱基99購01,,,,,0.00,0.00,0,0,0,0,0,0,0,0,0,0,0,0,0
20200520,052958,T50反1凱基99購02,,,,,0.00,0.00,0,0,0,0,0,0,0,0,0,0,0,0,0
20200520,052959,聯電凱基97購01,0.12,0.12,0.12,0.12,0.00,0.00,30000,1,3600,0,0,0,0,0,0,30000,0,30000,30000
20200520,052960,中環凱基96購01,,,,,0.00,0.00,0,0,0,0,0,0,0,0,0,0,0,0,0
20200520,052961,國巨凱基97購02,0.50,0.50,0.50,0.50,0.00,0.00,1000,1,500,0,0,0,0,0,0,0,0,0,0
20200520,052962,台積電凱基97購03,0.03,0.03,0.03,0.03,0.00,0.00,20000,1,600,0,0,0,0,0,0,20000,0,20000,20000
20200520,052963,智邦凱基96購02,3.59,3.59,3.59,3.59,+0.11,3.16,9000,1,32310,0,0,0,0,0,0,9000,0,9000,9000
20200520,052964,台表科凱基96購03,0.01,0.03,0.01,0.03,+0.02,200.0,290000,7,5700,0,0,0,0,0,0,290000,0,290000,290000
20200520,052965,廣宇群益97購01,0.05,0.05,0.05,0.05,0.00,0.00,10000,1,500,0,0,0,0,0,0,0,10000,-10000,-10000
20200520,052966,光磊群益96購01,,,,,0.00,0.00,0,0,0,0,0,0,0,0,0,0,0,0,0
20200520,052967,智邦群益96購01,,,,,0.00,0.00,0,0,0,0,0,0,0,0,0,0,0,0,0
20200520,052968,燿華群益98購01,0.32,0.43,0.32,0.43,0.00,0.00,392000,6,144260,0,0,0,0,0,0,130000,262000,-132000,-132000
20200520,052969,建準群益97購01,2.07,2.10,1.91,2.10,-0.19,-8.3,45000,4,90800,0,0,0,0,0,0,10000,35000,-25000,-25000
20200520,05296P,牧德凱基96售01,,,,,0.00,0.00,0,0,0,0,0,0,0,0,0,0,0,0,0
20200520,052970,美律群益96購01,,,,,0.00,0.00,0,0,0,0,0,0,0,0,0,0,0,0,0
20200520,052971,京元電群益98購01,,,,,0.00,0.00,0,0,0,0,0,0,0,0,0,0,0,0,0
20200520,052972,義隆群益96購04,,,,,0.00,0.00,0,0,0,0,0,0,0,0,0,0,0,0,0
20200520,052973,冠德群益96購01,,,,,0.00,0.00,0,0,0,0,0,0,0,0,0,0,0,0,0
20200520,052974,瀚宇博群益96購01,,,,,0.00,0.00,0,0,0,0,0,0,0,0,0,0,0,0,0
20200520,052975,嘉聯益群益96購01,,,,,0.00,0.00,0,0,0,0,0,0,0,0,0,0,0,0,0
20200520,052976,台表科群益96購03,0.14,0.14,0.14,0.14,0.00,0.00,1000,1,140,0,0,0,0,0,0,1000,0,1000,1000
20200520,052977,奇力新麥證97購01,,,,,0.00,0.00,0,0,0,0,0,0,0,0,0,0,0,0,0
20200520,052978,貿聯麥證97購01,,,,,0.00,0.00,0,0,0,0,0,0,0,0,0,0,0,0,0
20200520,052979,上銀元大96購02,1.27,1.27,1.27,1.27,-0.03,-2.31,69000,3,87630,0,0,0,0,0,0,17000,52000,-35000,-35000
20200520,052980,上銀元大96購03,,,,,0.00,0.00,0,0,0,0,0,0,0,0,0,0,0,0,0
20200520,052981,鴻海元大97購05,,,,,0.00,0.00,0,0,0,0,0,0,0,0,0,0,0,0,0
20200520,052982,鴻海元大97購06,0.01,0.01,0.01,0.01,0.00,0.00,38000,9,380,0,0,0,0,0,0,0,0,0,0
20200520,052983,國巨元大96購07,,,,,0.00,0.00,0,0,0,0,0,0,0,0,0,0,0,0,0
20200520,052984,漢唐元大96購01,,,,,0.00,0.00,0,0,0,0,0,0,0,0,0,0,0,0,0
20200520,052985,美律元大96購02,,,,,0.00,0.00,0,0,0,0,0,0,0,0,0,0,0,0,0
20200520,052986,聯發科元大97購05,1.10,1.29,1.08,1.24,+0.19,18.1,518000,42,606910,0,0,0,0,0,0,409000,0,409000,409000
20200520,052987,華新科元大99購01,,,,,0.00,0.00,0,0,0,0,0,0,0,0,0,0,0,0,0
20200520,052988,智易元大96購02,,,,,0.00,0.00,0,0,0,0,0,0,0,0,0,0,0,0,0
20200520,052989,麗豐元大98購01,,,,,0.00,0.00,0,0,0,0,0,0,0,0,0,0,0,0,0
20200520,052990,超眾元大97購01,2.03,2.09,1.98,2.09,+0.09,4.5,142000,5,290120,0,0,0,0,0,0,48000,94000,-46000,-46000
20200520,052991,台積電台新96購01,,,,,0.00,0.00,0,0,0,0,0,0,0,0,0,0,0,0,0
20200520,052992,冠德台新96購01,,,,,0.00,0.00,0,0,0,0,0,0,0,0,0,0,0,0,0
20200520,052993,欣興台新97購01,,,,,0.00,0.00,0,0,0,0,0,0,0,0,0,0,0,0,0
20200520,052994,群創台新99購01,,,,,0.00,0.00,0,0,0,0,0,0,0,0,0,0,0,0,0
20200520,052995,上銀康和96購01,,,,,0.00,0.00,0,0,0,0,0,0,0,0,0,0,0,0,0
20200520,052996,聯電康和96購01,,,,,0.00,0.00,0,0,0,0,0,0,0,0,0,0,0,0,0
20200520,052997,國巨康和96購01,0.62,0.62,0.62,0.62,0.00,0.00,94000,2,58280,0,0,0,0,0,0,0,94000,-94000,-94000
20200520,052998,拓凱康和96購01,0.18,0.22,0.18,0.22,+0.13,144.44,150000,7,29400,0,0,0,0,0,0,100000,0,100000,100000
20200520,052999,臺股指康和96購01,,,,,0.00,0.00,0,0,0,0,0,0,0,0,0,0,0,0,0
20200520,053000,臺股指康和96購02,,,,,0.00,0.00,0,0,0,0,0,0,0,0,0,0,0,0,0
20200520,053001,力山永豐96購01,,,,,0.00,0.00,0,0,0,0,0,0,0,0,0,0,0,0,0
20200520,053002,鴻海永豐96購01,,,,,0.00,0.00,0,0,0,0,0,0,0,0,0,0,0,0,0
20200520,053003,國巨永豐96購02,0.54,0.54,0.54,0.54,+0.09,20.0,10000,1,5400,0,0,0,0,0,0,10000,0,10000,10000
20200520,053004,燿華永豐96購01,,,,,0.00,0.00,0,0,0,0,0,0,0,0,0,0,0,0,0
20200520,053005,微星永豐96購01,,,,,0.00,0.00,0,0,0,0,0,0,0,0,0,0,0,0,0
20200520,053006,玉晶光永豐96購03,0.97,0.97,0.97,0.97,+0.11,12.79,2000,1,1940,0,0,0,0,0,0,2000,0,2000,2000
20200520,053007,致伸永豐96購01,,,,,0.00,0.00,0,0,0,0,0,0,0,0,0,0,0,0,0
20200520,053008,達方永豐96購01,,,,,0.00,0.00,0,0,0,0,0,0,0,0,0,0,0,0,0
20200520,053009,大成鋼統一96購02,,,,,0.00,0.00,0,0,0,0,0,0,0,0,0,0,0,0,0
20200520,053010,鴻海統一96購11,,,,,0.00,0.00,0,0,0,0,0,0,0,0,0,0,0,0,0
20200520,053011,鴻海統一98購01,,,,,0.00,0.00,0,0,0,0,0,0,0,0,0,0,0,0,0
20200520,053012,國巨統一96購03,0.22,0.28,0.22,0.28,+0.17,154.55,793000,13,209820,0,0,0,0,0,0,793000,789000,4000,4000
20200520,053013,台積電統一97購01,0.16,0.16,0.16,0.16,0.00,0.00,25000,3,4000,0,0,0,0,0,0,0,25000,-25000,-25000
20200520,053014,旺宏統一97購02,,,,,0.00,0.00,0,0,0,0,0,0,0,0,0,0,0,0,0
20200520,053015,緯創統一96購01,,,,,0.00,0.00,0,0,0,0,0,0,0,0,0,0,0,0,0
20200520,053016,鈺齊統一96購01,,,,,0.00,0.00,0,0,0,0,0,0,0,0,0,0,0,0,0
20200520,053017,世紀鋼統一96購02,,,,,0.00,0.00,0,0,0,0,0,0,0,0,0,0,0,0,0
20200520,053018,旺宏元富96購02,,,,,0.00,0.00,0,0,0,0,0,0,0,0,0,0,0,0,0
20200520,053019,禾伸堂元富96購01,,,,,0.00,0.00,0,0,0,0,0,0,0,0,0,0,0,0,0
20200520,053020,貿聯元富96購01,,,,,0.00,0.00,0,0,0,0,0,0,0,0,0,0,0,0,0
20200520,053021,國巨國泰97購04,0.91,0.91,0.91,0.91,+0.08,9.64,1000,1,910,0,0,0,0,0,0,0,1000,-1000,-1000
20200520,053022,欣興國泰98購01,,,,,0.00,0.00,0,0,0,0,0,0,0,0,0,0,0,0,0
20200520,053023,泰鼎國泰97購01,,,,,0.00,0.00,0,0,0,0,0,0,0,0,0,0,0,0,0
20200520,053024,國巨富邦97購02,,,,,0.00,0.00,0,0,0,0,0,0,0,0,0,0,0,0,0
20200520,053025,燿華富邦98購02,0.05,0.05,0.05,0.05,0.00,0.00,5000,1,250,0,0,0,0,0,0,0,0,0,0
20200520,053026,奇力新富邦98購01,,,,,0.00,0.00,0,0,0,0,0,0,0,0,0,0,0,0,0
20200520,053027,玉晶光富邦98購01,,,,,0.00,0.00,0,0,0,0,0,0,0,0,0,0,0,0,0
20200520,053028,康控富邦98購01,,,,,0.00,0.00,0,0,0,0,0,0,0,0,0,0,0,0,0
20200520,053029,國巨第一96購01,0.20,0.40,0.18,0.20,+0.10,100.0,301000,29,79200,0,0,0,0,0,0,141000,213000,-72000,-72000
20200520,05302P,華通國泰96售01,,,,,0.00,0.00,0,0,0,0,0,0,0,0,0,0,0,0,0
20200520,053030,南亞科第一96購01,,,,,0.00,0.00,0,0,0,0,0,0,0,0,0,0,0,0,0
20200520,053031,華新科第一96購01,,,,,0.00,0.00,0,0,0,0,0,0,0,0,0,0,0,0,0
20200520,053032,國巨兆豐97購02,,,,,0.00,0.00,0,0,0,0,0,0,0,0,0,0,0,0,0
20200520,053033,智易兆豐97購01,0.36,0.37,0.36,0.37,0.00,0.00,170000,3,62300,0,0,0,0,0,0,60000,110000,-50000,-50000
20200520,053034,上海銀兆豐96購01,,,,,0.00,0.00,0,0,0,0,0,0,0,0,0,0,0,0,0
20200520,053035,台表科兆豐97購01,0.42,0.70,0.37,0.70,+0.32,84.21,979000,59,464580,0,0,0,0,0,0,679000,280000,399000,399000
20200520,053036,聯電凱基98購01,,,,,0.00,0.00,0,0,0,0,0,0,0,0,0,0,0,0,0
20200520,053037,國巨凱基96購08,,,,,0.00,0.00,0,0,0,0,0,0,0,0,0,0,0,0,0
20200520,053038,華邦電凱基97購01,,,,,0.00,0.00,0,0,0,0,0,0,0,0,0,0,0,0,0
20200520,053039,聯發科凱基96購11,,,,,0.00,0.00,0,0,0,0,0,0,0,0,0,0,0,0,0
20200520,05303P,華通國泰97售01,,,,,0.00,0.00,0,0,0,0,0,0,0,0,0,0,0,0,0
20200520,053040,全新凱基98購01,0.18,0.18,0.18,0.18,-0.03,-14.29,200000,1,36000,0,0,0,0,0,0,200000,0,200000,200000
20200520,053041,可成凱基96購02,,,,,0.00,0.00,0,0,0,0,0,0,0,0,0,0,0,0,0
20200520,053042,大立光凱基97購03,,,,,0.00,0.00,0,0,0,0,0,0,0,0,0,0,0,0,0
20200520,053043,嘉晶凱基96購01,0.71,0.71,0.71,0.71,+0.35,97.22,25000,1,17750,0,0,0,0,0,0,25000,0,25000,25000
20200520,053044,南茂凱基96購02,,,,,0.00,0.00,0,0,0,0,0,0,0,0,0,0,0,0,0
20200520,053045,國巨中信97購01,0.20,0.20,0.20,0.20,+0.06,42.86,10000,1,2000,0,0,0,0,0,0,10000,0,10000,10000
20200520,053046,智易中信96購01,,,,,0.00,0.00,0,0,0,0,0,0,0,0,0,0,0,0,0
20200520,053047,寶成中信97購01,,,,,0.00,0.00,0,0,0,0,0,0,0,0,0,0,0,0,0
20200520,053048,同欣電麥證96購01,,,,,0.00,0.00,0,0,0,0,0,0,0,0,0,0,0,0,0
20200520,053049,T50反1國票98購01,0.68,0.68,0.68,0.68,0.00,0.00,8000,1,5440,0,0,0,0,0,0,0,0,0,0
20200520,05304P,國巨國泰97售02,0.39,0.39,0.39,0.39,-0.07,-15.22,10000,2,3900,0,0,0,0,0,0,0,5000,-5000,-5000
20200520,053050,華通國票97購02,,,,,0.00,0.00,0,0,0,0,0,0,0,0,0,0,0,0,0
20200520,053051,楠梓電國票97購01,,,,,0.00,0.00,0,0,0,0,0,0,0,0,0,0,0,0,0
20200520,053052,旺宏國票97購02,,,,,0.00,0.00,0,0,0,0,0,0,0,0,0,0,0,0,0
20200520,053053,京元電國票97購02,,,,,0.00,0.00,0,0,0,0,0,0,0,0,0,0,0,0,0
20200520,053054,禾伸堂國票97購01,1.94,1.94,1.94,1.94,+0.26,15.48,10000,1,19400,0,0,0,0,0,0,0,10000,-10000,-10000
20200520,053055,聯詠國票97購01,0.42,0.44,0.39,0.44,-0.01,-2.22,925000,8,385740,0,0,0,0,0,0,923000,2000,921000,921000
20200520,053056,同欣電國票97購01,0.45,0.54,0.43,0.43,0.00,0.00,349000,20,167740,0,0,0,0,0,0,172000,177000,-5000,-5000
20200520,053057,聯電國泰97購02,,,,,0.00,0.00,0,0,0,0,0,0,0,0,0,0,0,0,0
20200520,053058,台光電永昌99購01,,,,,0.00,0.00,0,0,0,0,0,0,0,0,0,0,0,0,0
20200520,053059,聯發科永昌99購01,1.85,1.85,1.85,1.85,+0.15,8.82,20000,1,37000,0,0,0,0,0,0,20000,20000,0,0
20200520,05305P,華新科國泰97售01,0.29,0.75,0.29,0.75,+0.40,114.29,79000,9,27690,0,0,0,0,0,0,40000,61000,-21000,-21000
20200520,053060,大立光永昌96購05,,,,,0.00,0.00,0,0,0,0,0,0,0,0,0,0,0,0,0
20200520,053061,GIS富邦97購01,,,,,0.00,0.00,0,0,0,0,0,0,0,0,0,0,0,0,0
20200520,053062,緯穎富邦97購01,,,,,0.00,0.00,0,0,0,0,0,0,0,0,0,0,0,0,0
20200520,053063,力山群益98購01,0.94,0.95,0.92,0.93,0.00,0.00,290000,8,274450,0,0,0,0,0,0,260000,30000,230000,230000
20200520,053064,國巨群益96購04,3.06,3.06,3.06,3.06,+0.58,23.39,4000,1,12240,0,0,0,0,0,0,0,4000,-4000,-4000
20200520,053065,大立光群益96購01,,,,,0.00,0.00,0,0,0,0,0,0,0,0,0,0,0,0,0
20200520,053066,欣興群益96購02,,,,,0.00,0.00,0,0,0,0,0,0,0,0,0,0,0,0,0
20200520,053067,牧德群益96購01,0.95,0.95,0.95,0.95,+0.11,13.1,20000,1,19000,0,0,0,0,0,0,20000,0,20000,20000
20200520,053068,智伸科群益96購01,,,,,0.00,0.00,0,0,0,0,0,0,0,0,0,0,0,0,0
20200520,053069,同欣電群益98購01,,,,,0.00,0.00,0,0,0,0,0,0,0,0,0,0,0,0,0
20200520,05306P,泰碩國泰97售01,0.70,0.70,0.70,0.70,+0.03,4.48,84000,4,58800,0,0,0,0,0,0,64000,20000,44000,44000
20200520,053070,訊芯群益96購01,,,,,0.00,0.00,0,0,0,0,0,0,0,0,0,0,0,0,0
20200520,053071,南電群益96購01,,,,,0.00,0.00,0,0,0,0,0,0,0,0,0,0,0,0,0
20200520,053072,國巨台新97購01,1.51,1.51,1.47,1.47,+0.19,14.84,54000,8,80530,0,0,0,0,0,0,25000,29000,-4000,-4000
20200520,053073,技嘉康和96購01,1.20,1.20,1.09,1.09,-0.06,-5.22,112000,4,128320,0,0,0,0,0,0,62000,50000,12000,12000
20200520,053074,嘉晶永豐96購02,0.72,1.20,0.72,1.20,+0.55,84.62,21000,3,20840,0,0,0,0,0,0,19000,2000,17000,17000
20200520,053075,欣興永豐96購01,,,,,0.00,0.00,0,0,0,0,0,0,0,0,0,0,0,0,0
20200520,053076,貿聯永豐96購01,,,,,0.00,0.00,0,0,0,0,0,0,0,0,0,0,0,0,0
20200520,053077,同欣電永豐96購01,,,,,0.00,0.00,0,0,0,0,0,0,0,0,0,0,0,0,0
20200520,053078,昇陽半永豐97購02,,,,,0.00,0.00,0,0,0,0,0,0,0,0,0,0,0,0,0
20200520,053079,世紀鋼永豐96購01,,,,,0.00,0.00,0,0,0,0,0,0,0,0,0,0,0,0,0
20200520,053080,力山元大96購02,0.54,0.57,0.54,0.55,0.00,0.00,116000,4,63090,0,0,0,0,0,0,0,116000,-116000,-116000
20200520,053081,上銀元大97購02,,,,,0.00,0.00,0,0,0,0,0,0,0,0,0,0,0,0,0
20200520,053082,聯電元大98購03,0.18,0.18,0.16,0.17,-0.02,-10.53,19000,4,3260,0,0,0,0,0,0,8000,11000,-3000,-3000
20200520,053083,中環元大99購01,0.16,0.17,0.16,0.17,+0.02,13.33,275000,10,44200,0,0,0,0,0,0,0,275000,-275000,-275000
20200520,053084,國巨元大98購01,,,,,0.00,0.00,0,0,0,0,0,0,0,0,0,0,0,0,0
20200520,053085,華新科元大97購04,1.71,1.71,1.62,1.65,0.00,0.00,8000,3,13410,0,0,0,0,0,0,4000,4000,0,0
20200520,053086,宏達電元大97購01,,,,,0.00,0.00,0,0,0,0,0,0,0,0,0,0,0,0,0
20200520,053087,冠德元大96購02,0.01,0.01,0.01,0.01,0.00,0.00,144000,2,1440,0,0,0,0,0,0,144000,0,144000,144000
20200520,053088,奇鋐元大98購01,0.46,0.51,0.46,0.50,+0.03,6.38,24000,6,12160,0,0,0,0,0,0,0,24000,-24000,-24000
20200520,053089,貿聯元大97購02,,,,,0.00,0.00,0,0,0,0,0,0,0,0,0,0,0,0,0
20200520,053090,新唐元大96購01,,,,,0.00,0.00,0,0,0,0,0,0,0,0,0,0,0,0,0
20200520,053091,同欣電元大96購01,,,,,0.00,0.00,0,0,0,0,0,0,0,0,0,0,0,0,0
20200520,053092,台表科元大97購02,1.95,2.07,1.76,2.02,+0.25,14.12,126000,12,239980,0,0,0,0,0,0,116000,20000,96000,96000
20200520,053093,緯穎元大96購06,,,,,0.00,0.00,0,0,0,0,0,0,0,0,0,0,0,0,0
20200520,053094,聯電統一97購02,,,,,0.00,0.00,0,0,0,0,0,0,0,0,0,0,0,0,0
20200520,053095,台光電統一98購01,1.07,1.09,1.05,1.09,-0.09,-7.63,279000,16,297530,0,0,0,0,0,0,273000,6000,267000,267000
20200520,053096,康控統一96購01,,,,,0.00,0.00,0,0,0,0,0,0,0,0,0,0,0,0,0
20200520,053097,超眾統一96購03,1.20,1.30,1.20,1.30,+0.03,2.36,143000,3,181920,0,0,0,0,0,0,39000,104000,-65000,-65000
20200520,053098,國巨元富96購04,,,,,0.00,0.00,0,0,0,0,0,0,0,0,0,0,0,0,0
20200520,053099,正崴元富96購01,,,,,0.00,0.00,0,0,0,0,0,0,0,0,0,0,0,0,0
20200520,053100,美律元富96購01,,,,,0.00,0.00,0,0,0,0,0,0,0,0,0,0,0,0,0
20200520,053101,創意元富96購03,,,,,0.00,0.00,0,0,0,0,0,0,0,0,0,0,0,0,0
20200520,053102,祥碩元富96購01,,,,,0.00,0.00,0,0,0,0,0,0,0,0,0,0,0,0,0
20200520,053103,瀚宇博元富96購01,0.32,0.32,0.32,0.32,-0.03,-8.57,20000,1,6400,0,0,0,0,0,0,0,20000,-20000,-20000
20200520,053104,台表科元富96購02,,,,,0.00,0.00,0,0,0,0,0,0,0,0,0,0,0,0,0
20200520,053105,鴻海兆豐97購01,,,,,0.00,0.00,0,0,0,0,0,0,0,0,0,0,0,0,0
20200520,053106,鴻海兆豐98購01,0.07,0.07,0.03,0.03,0.00,0.00,16000,3,560,0,0,0,0,0,0,0,0,0,0
20200520,053107,旺宏兆豐97購01,0.44,0.46,0.44,0.46,+0.02,4.55,49000,3,21960,0,0,0,0,0,0,29000,20000,9000,9000
20200520,053108,南亞科兆豐96購01,,,,,0.00,0.00,0,0,0,0,0,0,0,0,0,0,0,0,0
20200520,053109,聯發科兆豐96購01,1.59,1.59,1.59,1.59,0.00,0.00,1000,1,1590,0,0,0,0,0,0,0,1000,-1000,-1000
20200520,053110,大立光兆豐97購01,,,,,0.00,0.00,0,0,0,0,0,0,0,0,0,0,0,0,0
20200520,053111,緯創兆豐97購01,1.06,1.06,1.00,1.00,+0.06,6.38,30000,2,31200,0,0,0,0,0,0,20000,10000,10000,10000
20200520,053112,中磊兆豐97購01,0.67,0.67,0.67,0.67,-0.03,-4.29,71000,1,47570,0,0,0,0,0,0,71000,0,71000,71000
20200520,053113,瀚宇博兆豐97購01,0.36,0.36,0.36,0.36,0.00,0.00,5000,1,1800,0,0,0,0,0,0,5000,0,5000,5000
20200520,053114,聯茂兆豐97購01,0.23,0.25,0.22,0.22,-0.05,-18.52,1158000,20,256560,0,0,0,0,0,0,1158000,0,1158000,1158000
20200520,053115,滬深2X中信97購01,,,,,0.00,0.00,0,0,0,0,0,0,0,0,0,0,0,0,0
20200520,053116,華新科中信96購01,,,,,0.00,0.00,0,0,0,0,0,0,0,0,0,0,0,0,0
20200520,053117,大立光中信9A購02,0.10,0.10,0.10,0.10,0.00,0.00,370000,4,37000,0,0,0,0,0,0,0,370000,-370000,-370000
20200520,053118,大立光中信9C購01,0.25,0.28,0.25,0.26,+0.01,4.0,727000,17,185100,0,0,0,0,0,0,142000,475000,-333000,-333000
20200520,053119,日月光中信97購01,,,,,0.00,0.00,0,0,0,0,0,0,0,0,0,0,0,0,0
20200520,053120,復盛中信9A購01,0.19,0.32,0.19,0.32,0.00,0.00,31000,4,9790,0,0,0,0,0,0,1000,30000,-29000,-29000
20200520,053121,上証2X凱基9C購01,,,,,0.00,0.00,0,0,0,0,0,0,0,0,0,0,0,0,0
20200520,053122,美律凱基98購01,,,,,0.00,0.00,0,0,0,0,0,0,0,0,0,0,0,0,0
20200520,053123,京元電凱基96購01,,,,,0.00,0.00,0,0,0,0,0,0,0,0,0,0,0,0,0
20200520,053124,聯發科凱基96購12,1.98,2.15,1.98,2.15,+0.21,10.82,30000,3,61100,0,0,0,0,0,0,20000,10000,10000,10000
20200520,053125,宏達電凱基96購01,,,,,0.00,0.00,0,0,0,0,0,0,0,0,0,0,0,0,0
20200520,053126,健策凱基97購02,,,,,0.00,0.00,0,0,0,0,0,0,0,0,0,0,0,0,0
20200520,053127,貿聯凱基97購01,,,,,0.00,0.00,0,0,0,0,0,0,0,0,0,0,0,0,0
20200520,053128,瀚宇博凱基96購01,,,,,0.00,0.00,0,0,0,0,0,0,0,0,0,0,0,0,0
20200520,053129,緯穎凱基96購01,4.57,4.57,4.57,4.57,-0.43,-8.6,30000,1,137100,0,0,0,0,0,0,30000,0,30000,30000
20200520,053130,聯發科麥證96購01,2.45,2.45,2.45,2.45,+0.30,13.95,2000,2,4900,2000,0,2000,0,0,0,2000,0,2000,2000
20200520,053131,華通國票97購03,,,,,0.00,0.00,0,0,0,0,0,0,0,0,0,0,0,0,0
20200520,053132,國巨國票97購02,0.80,0.80,0.59,0.59,0.00,0.00,65000,7,46050,0,0,0,0,0,0,15000,40000,-25000,-25000
20200520,053133,華邦電國票97購01,,,,,0.00,0.00,0,0,0,0,0,0,0,0,0,0,0,0,0
20200520,053134,南亞科國票97購01,,,,,0.00,0.00,0,0,0,0,0,0,0,0,0,0,0,0,0
20200520,053135,信邦國票96購01,2.44,2.44,1.88,1.88,-0.35,-15.7,10000,2,21600,0,0,0,0,0,0,5000,5000,0,0
20200520,053136,彩晶國票97購01,,,,,0.00,0.00,0,0,0,0,0,0,0,0,0,0,0,0,0
20200520,053137,旺宏富邦98購01,,,,,0.00,0.00,0,0,0,0,0,0,0,0,0,0,0,0,0
20200520,053138,華邦電富邦96購01,,,,,0.00,0.00,0,0,0,0,0,0,0,0,0,0,0,0,0
20200520,053139,滬深2X永豐98購01,,,,,0.00,0.00,0,0,0,0,0,0,0,0,0,0,0,0,0
20200520,053140,燿華永豐96購02,,,,,0.00,0.00,0,0,0,0,0,0,0,0,0,0,0,0,0
20200520,053141,景碩永豐96購02,,,,,0.00,0.00,0,0,0,0,0,0,0,0,0,0,0,0,0
20200520,053142,緯穎永豐96購01,2.95,3.14,2.95,3.14,-0.12,-3.68,20000,3,60900,0,0,0,0,0,0,10000,10000,0,0
20200520,053143,昇陽半永豐96購03,,,,,0.00,0.00,0,0,0,0,0,0,0,0,0,0,0,0,0
20200520,053144,上証2X元大96購01,,,,,0.00,0.00,0,0,0,0,0,0,0,0,0,0,0,0,0
20200520,053145,元黃金元大96購02,,,,,0.00,0.00,0,0,0,0,0,0,0,0,0,0,0,0,0
20200520,053146,滬深2X元大96購08,,,,,0.00,0.00,0,0,0,0,0,0,0,0,0,0,0,0,0
20200520,053147,楠梓電元大98購01,0.34,0.34,0.33,0.33,0.00,0.00,30000,2,10000,0,0,0,0,0,0,30000,0,30000,30000
20200520,053148,華邦電元大96購01,,,,,0.00,0.00,0,0,0,0,0,0,0,0,0,0,0,0,0
20200520,053149,京元電元大96購02,0.09,0.09,0.08,0.08,0.00,0.00,151000,3,13080,0,0,0,0,0,0,100000,51000,49000,49000
20200520,053150,聯發科元大96購11,,,,,0.00,0.00,0,0,0,0,0,0,0,0,0,0,0,0,0
20200520,053151,華新科元大96購04,2.89,2.89,2.89,2.89,+0.05,1.76,12000,1,34680,0,0,0,0,0,0,12000,0,12000,12000
20200520,053152,大立光元大99購01,,,,,0.00,0.00,0,0,0,0,0,0,0,0,0,0,0,0,0
20200520,053153,大立光元大99購02,,,,,0.00,0.00,0,0,0,0,0,0,0,0,0,0,0,0,0
20200520,053154,聯詠元大96購01,,,,,0.00,0.00,0,0,0,0,0,0,0,0,0,0,0,0,0
20200520,053155,晶技元大97購02,,,,,0.00,0.00,0,0,0,0,0,0,0,0,0,0,0,0,0
20200520,053156,緯創元大96購02,,,,,0.00,0.00,0,0,0,0,0,0,0,0,0,0,0,0,0
20200520,053157,日月光元大96購03,,,,,0.00,0.00,0,0,0,0,0,0,0,0,0,0,0,0,0
20200520,053158,茂林元大96購01,0.50,0.69,0.50,0.69,+0.17,32.69,456000,7,279420,0,0,0,0,0,0,91000,365000,-274000,-274000
20200520,053159,同欣電元大96購02,,,,,0.00,0.00,0,0,0,0,0,0,0,0,0,0,0,0,0
20200520,05315P,鴻海永昌96售08,,,,,0.00,0.00,0,0,0,0,0,0,0,0,0,0,0,0,0
20200520,053160,台表科元大96購03,,,,,0.00,0.00,0,0,0,0,0,0,0,0,0,0,0,0,0
20200520,053161,康友元大96購04,,,,,0.00,0.00,0,0,0,0,0,0,0,0,0,0,0,0,0
20200520,053162,緯穎元大97購01,,,,,0.00,0.00,0,0,0,0,0,0,0,0,0,0,0,0,0
20200520,053163,上証2X群益9A購02,,,,,0.00,0.00,0,0,0,0,0,0,0,0,0,0,0,0,0
20200520,053164,台光電群益96購02,,,,,0.00,0.00,0,0,0,0,0,0,0,0,0,0,0,0,0
20200520,053165,大立光群益96購03,,,,,0.00,0.00,0,0,0,0,0,0,0,0,0,0,0,0,0
20200520,053166,聯詠群益96購02,,,,,0.00,0.00,0,0,0,0,0,0,0,0,0,0,0,0,0
20200520,053167,欣興群益96購03,,,,,0.00,0.00,0,0,0,0,0,0,0,0,0,0,0,0,0
20200520,053168,晶技群益98購01,3.22,3.22,2.82,2.82,0.00,0.00,4000,3,12420,0,0,0,0,0,0,0,4000,-4000,-4000
20200520,053169,貿聯群益97購01,,,,,0.00,0.00,0,0,0,0,0,0,0,0,0,0,0,0,0
20200520,05316P,台積電永昌96售06,,,,,0.00,0.00,0,0,0,0,0,0,0,0,0,0,0,0,0
20200520,053170,茂林群益96購04,1.34,1.54,1.34,1.54,0.00,0.00,104000,3,159420,0,0,0,0,0,0,4000,100000,-96000,-96000
20200520,053171,中磊群益96購01,,,,,0.00,0.00,0,0,0,0,0,0,0,0,0,0,0,0,0
20200520,053172,瑞儀群益97購01,,,,,0.00,0.00,0,0,0,0,0,0,0,0,0,0,0,0,0
20200520,053173,矽格群益97購01,0.68,0.84,0.68,0.84,+0.14,20.0,374000,7,278280,0,0,0,0,0,0,60000,314000,-254000,-254000
20200520,053174,同欣電群益98購02,,,,,0.00,0.00,0,0,0,0,0,0,0,0,0,0,0,0,0
20200520,053175,矽力群益96購01,,,,,0.00,0.00,0,0,0,0,0,0,0,0,0,0,0,0,0
20200520,053176,矽力群益96購02,8.30,8.30,7.15,7.15,-1.15,-13.86,8000,4,60250,0,0,0,0,0,0,1000,6000,-5000,-5000
20200520,053177,華邦電統一96購01,,,,,0.00,0.00,0,0,0,0,0,0,0,0,0,0,0,0,0
20200520,053178,南亞科統一98購01,,,,,0.00,0.00,0,0,0,0,0,0,0,0,0,0,0,0,0
20200520,053179,大立光統一96購04,,,,,0.00,0.00,0,0,0,0,0,0,0,0,0,0,0,0,0
20200520,053180,同欣電統一96購01,,,,,0.00,0.00,0,0,0,0,0,0,0,0,0,0,0,0,0
20200520,053181,滬深2X元富99購02,,,,,0.00,0.00,0,0,0,0,0,0,0,0,0,0,0,0,0
20200520,053182,大立光元富96購02,,,,,0.00,0.00,0,0,0,0,0,0,0,0,0,0,0,0,0
20200520,053183,大立光元富96購03,,,,,0.00,0.00,0,0,0,0,0,0,0,0,0,0,0,0,0
20200520,053184,世紀鋼元富96購01,,,,,0.00,0.00,0,0,0,0,0,0,0,0,0,0,0,0,0
20200520,053185,友達中信99購01,,,,,0.00,0.00,0,0,0,0,0,0,0,0,0,0,0,0,0
20200520,053186,健策中信9C購01,0.53,0.60,0.53,0.57,+0.01,1.79,33000,5,17640,0,0,0,0,0,0,3000,22000,-19000,-19000
20200520,053187,國巨統一96購05,0.71,0.71,0.69,0.69,0.00,0.00,700000,2,491160,700000,0,700000,0,0,0,0,700000,-700000,0
20200520,053188,旺宏統一97購03,,,,,0.00,0.00,0,0,0,0,0,0,0,0,0,0,0,0,0
20200520,053189,聯發科統一96購05,3.50,4.06,3.50,4.06,+0.71,21.19,371000,23,1361420,0,0,0,0,0,0,368000,3000,365000,365000
20200520,053190,聯發科統一99購01,0.52,0.63,0.52,0.63,+0.11,21.15,130000,5,76240,0,0,0,0,0,0,14000,0,14000,14000
20200520,053191,奇鋐統一96購01,,,,,0.00,0.00,0,0,0,0,0,0,0,0,0,0,0,0,0
20200520,053192,創意統一96購01,,,,,0.00,0.00,0,0,0,0,0,0,0,0,0,0,0,0,0
20200520,053193,超眾統一97購01,,,,,0.00,0.00,0,0,0,0,0,0,0,0,0,0,0,0,0
20200520,053194,緯穎統一99購01,,,,,0.00,0.00,0,0,0,0,0,0,0,0,0,0,0,0,0
20200520,053195,玉晶光元富96購02,,,,,0.00,0.00,0,0,0,0,0,0,0,0,0,0,0,0,0
20200520,053196,康控元富96購01,,,,,0.00,0.00,0,0,0,0,0,0,0,0,0,0,0,0,0
20200520,053197,超眾元富96購02,,,,,0.00,0.00,0,0,0,0,0,0,0,0,0,0,0,0,0
20200520,053198,亞德客日盛96購01,,,,,0.00,0.00,0,0,0,0,0,0,0,0,0,0,0,0,0
20200520,053199,旺宏日盛96購01,,,,,0.00,0.00,0,0,0,0,0,0,0,0,0,0,0,0,0
20200520,053200,華邦電日盛96購01,,,,,0.00,0.00,0,0,0,0,0,0,0,0,0,0,0,0,0
20200520,053201,美律日盛96購01,,,,,0.00,0.00,0,0,0,0,0,0,0,0,0,0,0,0,0
20200520,053202,聯發科日盛96購02,1.46,1.48,1.46,1.48,+0.17,12.98,178000,20,259920,0,0,0,0,0,0,178000,0,178000,178000
20200520,053203,智易日盛96購01,,,,,0.00,0.00,0,0,0,0,0,0,0,0,0,0,0,0,0
20200520,053204,旺宏麥證96購01,,,,,0.00,0.00,0,0,0,0,0,0,0,0,0,0,0,0,0
20200520,053205,台光電麥證96購01,1.38,1.38,1.38,1.38,-0.06,-4.17,10000,1,13800,0,10000,-10000,0,0,0,0,10000,-10000,-10000
20200520,053206,聯發科麥證96購02,3.71,4.19,3.71,4.19,+0.53,14.48,12000,3,45480,10000,2000,8000,0,0,0,10000,2000,8000,8000
20200520,053207,SP黃豆凱基96購01,,,,,0.00,0.00,0,0,0,0,0,0,0,0,0,0,0,0,0
20200520,053208,鴻海凱基96購13,,,,,0.00,0.00,0,0,0,0,0,0,0,0,0,0,0,0,0
20200520,053209,台積電凱基96購07,,,,,0.00,0.00,0,0,0,0,0,0,0,0,0,0,0,0,0
20200520,05320P,華通凱基96售03,,,,,0.00,0.00,0,0,0,0,0,0,0,0,0,0,0,0,0
20200520,053210,華邦電凱基97購02,,,,,0.00,0.00,0,0,0,0,0,0,0,0,0,0,0,0,0
20200520,053211,漢唐凱基96購03,0.68,0.68,0.68,0.68,-0.11,-13.92,60000,2,40800,0,0,0,0,0,0,50000,10000,40000,40000
20200520,053212,友達凱基99購04,,,,,0.00,0.00,0,0,0,0,0,0,0,0,0,0,0,0,0
20200520,053213,建準凱基96購02,,,,,0.00,0.00,0,0,0,0,0,0,0,0,0,0,0,0,0
20200520,053214,冠德凱基96購02,,,,,0.00,0.00,0,0,0,0,0,0,0,0,0,0,0,0,0
20200520,053215,禾伸堂凱基96購01,,,,,0.00,0.00,0,0,0,0,0,0,0,0,0,0,0,0,0
20200520,053216,京鼎凱基96購02,,,,,0.00,0.00,0,0,0,0,0,0,0,0,0,0,0,0,0
20200520,053217,群創凱基99購02,,,,,0.00,0.00,0,0,0,0,0,0,0,0,0,0,0,0,0
20200520,053218,TPK凱基96購01,,,,,0.00,0.00,0,0,0,0,0,0,0,0,0,0,0,0,0
20200520,053219,祥碩凱基96購01,,,,,0.00,0.00,0,0,0,0,0,0,0,0,0,0,0,0,0
20200520,053220,瀚宇博凱基98購01,,,,,0.00,0.00,0,0,0,0,0,0,0,0,0,0,0,0,0
20200520,053221,彩晶凱基98購01,,,,,0.00,0.00,0,0,0,0,0,0,0,0,0,0,0,0,0
20200520,053222,聯茂凱基96購03,,,,,0.00,0.00,0,0,0,0,0,0,0,0,0,0,0,0,0
20200520,053223,台郡凱基96購02,0.29,0.31,0.29,0.31,-0.02,-6.06,69000,6,20490,0,0,0,0,0,0,30000,39000,-9000,-9000
20200520,053224,矽力凱基96購02,3.61,3.61,3.61,3.61,-0.64,-15.06,10000,1,36100,0,0,0,0,0,0,10000,0,10000,10000
20200520,053225,昇陽半凱基96購01,,,,,0.00,0.00,0,0,0,0,0,0,0,0,0,0,0,0,0
20200520,053226,國巨台新97購02,,,,,0.00,0.00,0,0,0,0,0,0,0,0,0,0,0,0,0
20200520,053227,晶技台新96購01,,,,,0.00,0.00,0,0,0,0,0,0,0,0,0,0,0,0,0
20200520,053228,康友台新97購01,,,,,0.00,0.00,0,0,0,0,0,0,0,0,0,0,0,0,0
20200520,053229,南電台新97購01,,,,,0.00,0.00,0,0,0,0,0,0,0,0,0,0,0,0,0
20200520,053230,達方台新97購01,,,,,0.00,0.00,0,0,0,0,0,0,0,0,0,0,0,0,0
20200520,053231,奇力新康和96購01,,,,,0.00,0.00,0,0,0,0,0,0,0,0,0,0,0,0,0
20200520,053232,友達永豐97購02,,,,,0.00,0.00,0,0,0,0,0,0,0,0,0,0,0,0,0
20200520,053233,大立光永豐96購01,,,,,0.00,0.00,0,0,0,0,0,0,0,0,0,0,0,0,0
20200520,053234,奇鋐永豐96購01,,,,,0.00,0.00,0,0,0,0,0,0,0,0,0,0,0,0,0
20200520,053235,智原永豐96購01,,,,,0.00,0.00,0,0,0,0,0,0,0,0,0,0,0,0,0
20200520,053236,群創永豐97購02,,,,,0.00,0.00,0,0,0,0,0,0,0,0,0,0,0,0,0
20200520,053237,揚明光永豐96購03,,,,,0.00,0.00,0,0,0,0,0,0,0,0,0,0,0,0,0
20200520,053238,麗豐永豐96購01,,,,,0.00,0.00,0,0,0,0,0,0,0,0,0,0,0,0,0
20200520,053239,崇越永豐96購01,,,,,0.00,0.00,0,0,0,0,0,0,0,0,0,0,0,0,0
20200520,05323P,瑞昱凱基96售02,,,,,0.00,0.00,0,0,0,0,0,0,0,0,0,0,0,0,0
20200520,053240,巨路永豐96購01,,,,,0.00,0.00,0,0,0,0,0,0,0,0,0,0,0,0,0
20200520,053241,元油反國票9A購01,,,,,0.00,0.00,0,0,0,0,0,0,0,0,0,0,0,0,0
20200520,053242,聯電國票96購04,,,,,0.00,0.00,0,0,0,0,0,0,0,0,0,0,0,0,0
20200520,053243,楠梓電國票97購02,0.18,0.18,0.18,0.18,0.00,0.00,38000,1,6840,0,0,0,0,0,0,38000,0,38000,38000
20200520,053244,光磊國票97購01,0.49,0.49,0.49,0.49,+0.01,2.08,61000,1,29890,0,0,0,0,0,0,0,61000,-61000,-61000
20200520,053245,全新國票97購01,,,,,0.00,0.00,0,0,0,0,0,0,0,0,0,0,0,0,0
20200520,053246,聯詠國票97購02,,,,,0.00,0.00,0,0,0,0,0,0,0,0,0,0,0,0,0
20200520,053247,麗豐國票97購01,,,,,0.00,0.00,0,0,0,0,0,0,0,0,0,0,0,0,0
20200520,053248,智伸科國票97購01,,,,,0.00,0.00,0,0,0,0,0,0,0,0,0,0,0,0,0
20200520,053249,致伸國票97購02,0.61,0.61,0.61,0.61,0.00,0.00,79000,1,48190,0,0,0,0,0,0,79000,79000,0,0
20200520,053250,百和國票97購02,,,,,0.00,0.00,0,0,0,0,0,0,0,0,0,0,0,0,0
20200520,053251,世紀鋼國票97購02,,,,,0.00,0.00,0,0,0,0,0,0,0,0,0,0,0,0,0
20200520,053252,華邦電國泰98購01,,,,,0.00,0.00,0,0,0,0,0,0,0,0,0,0,0,0,0
20200520,053253,友達國泰97購02,0.36,0.38,0.36,0.36,0.00,0.00,80000,4,29780,0,0,0,0,0,0,0,80000,-80000,-80000
20200520,053254,群創國泰98購02,,,,,0.00,0.00,0,0,0,0,0,0,0,0,0,0,0,0,0
20200520,053255,貿聯國泰97購01,0.41,0.43,0.38,0.41,+0.02,5.13,299000,55,124230,0,0,0,0,0,0,218000,81000,137000,137000
20200520,053256,上銀富邦98購01,,,,,0.00,0.00,0,0,0,0,0,0,0,0,0,0,0,0,0
20200520,053257,華通富邦97購01,0.02,0.02,0.02,0.02,0.00,0.00,100000,1,2000,0,0,0,0,0,0,0,0,0,0
20200520,053258,上証2X群益9A購03,,,,,0.00,0.00,0,0,0,0,0,0,0,0,0,0,0,0,0
20200520,053259,卜蜂群益97購01,0.44,0.45,0.43,0.44,-0.04,-8.33,327000,14,142310,0,0,0,0,0,0,272000,55000,217000,217000
20200520,053260,喬山群益96購01,,,,,0.00,0.00,0,0,0,0,0,0,0,0,0,0,0,0,0
20200520,053261,國巨群益96購05,,,,,0.00,0.00,0,0,0,0,0,0,0,0,0,0,0,0,0
20200520,053262,華邦電群益96購02,,,,,0.00,0.00,0,0,0,0,0,0,0,0,0,0,0,0,0
20200520,053263,華邦電群益96購03,,,,,0.00,0.00,0,0,0,0,0,0,0,0,0,0,0,0,0
20200520,053264,南亞科群益96購01,,,,,0.00,0.00,0,0,0,0,0,0,0,0,0,0,0,0,0
20200520,053265,南亞科群益96購02,,,,,0.00,0.00,0,0,0,0,0,0,0,0,0,0,0,0,0
20200520,053266,全新群益98購01,,,,,0.00,0.00,0,0,0,0,0,0,0,0,0,0,0,0,0
20200520,053267,華新科群益96購02,,,,,0.00,0.00,0,0,0,0,0,0,0,0,0,0,0,0,0
20200520,053268,日月光群益96購01,,,,,0.00,0.00,0,0,0,0,0,0,0,0,0,0,0,0,0
20200520,053269,同欣電群益96購01,0.12,0.12,0.12,0.12,0.00,0.00,150000,1,18000,0,0,0,0,0,0,150000,0,150000,150000
20200520,053270,台塑元大96購01,,,,,0.00,0.00,0,0,0,0,0,0,0,0,0,0,0,0,0
20200520,053271,喬山元大97購01,,,,,0.00,0.00,0,0,0,0,0,0,0,0,0,0,0,0,0
20200520,053272,鴻海元大96購17,,,,,0.00,0.00,0,0,0,0,0,0,0,0,0,0,0,0,0
20200520,053273,國巨元大96購08,,,,,0.00,0.00,0,0,0,0,0,0,0,0,0,0,0,0,0
20200520,053274,旺宏元大98購03,,,,,0.00,0.00,0,0,0,0,0,0,0,0,0,0,0,0,0
20200520,053275,燿華元大97購01,,,,,0.00,0.00,0,0,0,0,0,0,0,0,0,0,0,0,0
20200520,053276,友達元大9C購01,0.72,0.72,0.72,0.72,0.00,0.00,10000,1,7200,0,0,0,0,0,0,10000,0,10000,10000
20200520,053277,大立光元大96購04,,,,,0.00,0.00,0,0,0,0,0,0,0,0,0,0,0,0,0
20200520,053278,禾伸堂元大96購01,,,,,0.00,0.00,0,0,0,0,0,0,0,0,0,0,0,0,0
20200520,053279,景碩元大97購01,,,,,0.00,0.00,0,0,0,0,0,0,0,0,0,0,0,0,0
20200520,053280,群創元大9C購01,,,,,0.00,0.00,0,0,0,0,0,0,0,0,0,0,0,0,0
20200520,053281,茂林元大96購02,0.85,1.19,0.85,1.19,+0.34,40.0,241000,11,253150,0,0,0,0,0,0,0,241000,-241000,-241000
20200520,053282,彩晶元大9C購01,,,,,0.00,0.00,0,0,0,0,0,0,0,0,0,0,0,0,0
20200520,053283,同欣電元大96購03,,,,,0.00,0.00,0,0,0,0,0,0,0,0,0,0,0,0,0
20200520,053284,樺漢元大97購01,,,,,0.00,0.00,0,0,0,0,0,0,0,0,0,0,0,0,0
20200520,053285,臺股指元大96購08,,,,,0.00,0.00,0,0,0,0,0,0,0,0,0,0,0,0,0
20200520,053286,臺股指元大96購14,,,,,0.00,0.00,0,0,0,0,0,0,0,0,0,0,0,0,0
20200520,053287,臺股指元大96購15,,,,,0.00,0.00,0,0,0,0,0,0,0,0,0,0,0,0,0
20200520,053288,臺股指元大96購16,,,,,0.00,0.00,0,0,0,0,0,0,0,0,0,0,0,0,0
20200520,053289,臺股指元大96購17,,,,,0.00,0.00,0,0,0,0,0,0,0,0,0,0,0,0,0
20200520,053290,元油反中信97購01,,,,,0.00,0.00,0,0,0,0,0,0,0,0,0,0,0,0,0
20200520,053291,旺宏中信9A購01,,,,,0.00,0.00,0,0,0,0,0,0,0,0,0,0,0,0,0
20200520,053292,美律中信98購01,0.37,0.37,0.37,0.37,-0.02,-5.13,15000,1,5550,0,0,0,0,0,0,15000,0,15000,15000
20200520,053293,聯發科中信9B購01,0.75,0.86,0.75,0.81,+0.10,14.08,168000,19,131200,0,0,0,0,0,0,163000,0,163000,163000
20200520,053294,聯發科中信9C購01,0.73,0.84,0.72,0.77,+0.07,10.0,927000,59,713780,0,0,0,0,0,0,327000,595000,-268000,-268000
20200520,053295,奇力新中信96購01,,,,,0.00,0.00,0,0,0,0,0,0,0,0,0,0,0,0,0
20200520,053296,貿聯中信98購01,,,,,0.00,0.00,0,0,0,0,0,0,0,0,0,0,0,0,0
20200520,053297,鎧勝中信98購01,0.20,0.20,0.16,0.17,+0.02,13.33,158000,7,26860,0,0,0,0,0,0,50000,108000,-58000,-58000
20200520,053298,SP黃豆凱基99購01,,,,,0.00,0.00,0,0,0,0,0,0,0,0,0,0,0,0,0
20200520,053299,台泥凱基96購01,,,,,0.00,0.00,0,0,0,0,0,0,0,0,0,0,0,0,0
20200520,053300,大成鋼凱基96購02,,,,,0.00,0.00,0,0,0,0,0,0,0,0,0,0,0,0,0
20200520,053301,華通凱基96購04,,,,,0.00,0.00,0,0,0,0,0,0,0,0,0,0,0,0,0
20200520,053302,國巨凱基96購10,,,,,0.00,0.00,0,0,0,0,0,0,0,0,0,0,0,0,0
20200520,053303,建準凱基96購03,0.79,0.79,0.70,0.77,-0.11,-12.5,40000,4,29700,0,0,0,0,0,0,30000,10000,20000,20000
20200520,053304,可成凱基96購03,,,,,0.00,0.00,0,0,0,0,0,0,0,0,0,0,0,0,0
20200520,053305,聯詠凱基96購02,,,,,0.00,0.00,0,0,0,0,0,0,0,0,0,0,0,0,0
20200520,053306,晶技凱基97購01,,,,,0.00,0.00,0,0,0,0,0,0,0,0,0,0,0,0,0
20200520,053307,泰碩凱基97購01,,,,,0.00,0.00,0,0,0,0,0,0,0,0,0,0,0,0,0
20200520,053308,智易凱基96購02,,,,,0.00,0.00,0,0,0,0,0,0,0,0,0,0,0,0,0
20200520,053309,泰鼎凱基96購03,,,,,0.00,0.00,0,0,0,0,0,0,0,0,0,0,0,0,0
20200520,053310,彩晶凱基98購02,,,,,0.00,0.00,0,0,0,0,0,0,0,0,0,0,0,0,0
20200520,053311,同欣電凱基96購01,,,,,0.00,0.00,0,0,0,0,0,0,0,0,0,0,0,0,0
20200520,053312,緯穎凱基96購02,,,,,0.00,0.00,0,0,0,0,0,0,0,0,0,0,0,0,0
20200520,053313,世紀鋼凱基96購01,1.15,1.15,1.15,1.15,-0.40,-25.81,20000,1,23000,0,0,0,0,0,0,20000,0,20000,20000
20200520,053314,A50正2群益9A購01,,,,,0.00,0.00,0,0,0,0,0,0,0,0,0,0,0,0,0
20200520,053315,漢唐群益96購02,,,,,0.00,0.00,0,0,0,0,0,0,0,0,0,0,0,0,0
20200520,053316,友達群益9A購01,0.72,0.78,0.72,0.72,-0.04,-5.26,467000,10,351240,0,0,0,0,0,0,329000,138000,191000,191000
20200520,053317,友達群益9A購02,,,,,0.00,0.00,0,0,0,0,0,0,0,0,0,0,0,0,0
20200520,053318,全新群益99購01,,,,,0.00,0.00,0,0,0,0,0,0,0,0,0,0,0,0,0
20200520,053319,可成群益96購04,,,,,0.00,0.00,0,0,0,0,0,0,0,0,0,0,0,0,0
20200520,05331P,上証2X國票96售01,1.11,1.11,1.11,1.11,-0.02,-1.77,100000,1,111000,0,0,0,0,0,0,0,100000,-100000,-100000
20200520,053320,華新科群益97購01,2.96,2.96,2.68,2.68,-0.26,-8.84,142000,7,401250,0,0,0,0,0,0,122000,31000,91000,91000
20200520,053321,智原群益96購02,,,,,0.00,0.00,0,0,0,0,0,0,0,0,0,0,0,0,0
20200520,053322,京鼎群益97購01,,,,,0.00,0.00,0,0,0,0,0,0,0,0,0,0,0,0,0
20200520,053323,群創群益98購07,,,,,0.00,0.00,0,0,0,0,0,0,0,0,0,0,0,0,0
20200520,053324,康舒群益96購01,,,,,0.00,0.00,0,0,0,0,0,0,0,0,0,0,0,0,0
20200520,053325,GIS群益96購02,,,,,0.00,0.00,0,0,0,0,0,0,0,0,0,0,0,0,0
20200520,053326,瀚宇博台新96購01,,,,,0.00,0.00,0,0,0,0,0,0,0,0,0,0,0,0,0
20200520,053327,彩晶台新97購01,,,,,0.00,0.00,0,0,0,0,0,0,0,0,0,0,0,0,0
20200520,053328,滬深2X永豐99購01,,,,,0.00,0.00,0,0,0,0,0,0,0,0,0,0,0,0,0
20200520,053329,元油反永豐97購01,,,,,0.00,0.00,0,0,0,0,0,0,0,0,0,0,0,0,0
20200520,053330,燿華永豐96購03,,,,,0.00,0.00,0,0,0,0,0,0,0,0,0,0,0,0,0
20200520,053331,玉晶光永豐97購02,0.79,0.96,0.79,0.94,+0.10,11.9,215000,18,197310,0,0,0,0,0,0,52000,162000,-110000,-110000
20200520,053332,創意永豐96購03,0.25,0.29,0.25,0.29,0.00,0.00,48000,2,12320,0,0,0,0,0,0,40000,48000,-8000,-8000
20200520,053333,新唐永豐96購01,,,,,0.00,0.00,0,0,0,0,0,0,0,0,0,0,0,0,0
20200520,053334,訊芯永豐96購01,,,,,0.00,0.00,0,0,0,0,0,0,0,0,0,0,0,0,0
20200520,053335,易華電永豐96購01,,,,,0.00,0.00,0,0,0,0,0,0,0,0,0,0,0,0,0
20200520,053336,元油反國票9B購02,,,,,0.00,0.00,0,0,0,0,0,0,0,0,0,0,0,0,0
20200520,053337,聯電國票97購01,0.45,0.46,0.45,0.46,-0.04,-8.0,104000,3,47450,0,0,0,0,0,0,38000,66000,-28000,-28000
20200520,053338,台光電國票97購01,,,,,0.00,0.00,0,0,0,0,0,0,0,0,0,0,0,0,0
20200520,053339,友達國票97購02,,,,,0.00,0.00,0,0,0,0,0,0,0,0,0,0,0,0,0
20200520,053340,建準國票97購01,3.21,3.24,3.21,3.24,+0.03,0.93,16000,2,51510,0,0,0,0,0,0,16000,0,16000,16000
20200520,053341,聯發科國票97購03,0.20,0.50,0.20,0.36,+0.16,80.0,387000,12,132420,0,0,0,0,0,0,382000,0,382000,382000
20200520,053342,全新國票99購01,,,,,0.00,0.00,0,0,0,0,0,0,0,0,0,0,0,0,0
20200520,053343,宏達電國票97購02,,,,,0.00,0.00,0,0,0,0,0,0,0,0,0,0,0,0,0
20200520,053344,嘉晶國票97購02,1.70,1.70,1.70,1.70,0.00,0.00,10000,2,17000,0,0,0,0,0,0,0,0,0,0
20200520,053345,欣興國票97購02,,,,,0.00,0.00,0,0,0,0,0,0,0,0,0,0,0,0,0
20200520,053346,群創國票97購04,,,,,0.00,0.00,0,0,0,0,0,0,0,0,0,0,0,0,0
20200520,053347,茂林國票98購01,1.93,2.25,1.91,2.25,+0.37,19.68,134000,8,279140,0,0,0,0,0,0,40000,94000,-54000,-54000
20200520,053348,彩晶國票97購02,,,,,0.00,0.00,0,0,0,0,0,0,0,0,0,0,0,0,0
20200520,053349,台郡國票97購02,1.29,1.35,1.29,1.35,0.00,0.00,170000,3,225360,0,0,0,0,0,0,101000,69000,32000,32000
20200520,053350,台表科國票97購02,0.96,1.72,0.96,1.72,+0.66,62.26,471000,40,553250,0,0,0,0,0,0,241000,230000,11000,11000
20200520,053351,A50正2兆豐97購01,,,,,0.00,0.00,0,0,0,0,0,0,0,0,0,0,0,0,0
20200520,053352,義隆兆豐96購01,,,,,0.00,0.00,0,0,0,0,0,0,0,0,0,0,0,0,0
20200520,053353,玉晶光兆豐97購03,0.94,0.94,0.94,0.94,0.00,0.00,10000,1,9400,0,0,0,0,0,0,0,10000,-10000,-10000
20200520,053354,康控兆豐97購02,,,,,0.00,0.00,0,0,0,0,0,0,0,0,0,0,0,0,0
20200520,053355,超眾兆豐97購01,,,,,0.00,0.00,0,0,0,0,0,0,0,0,0,0,0,0,0
20200520,053356,聯發科統一96購07,3.74,3.86,3.74,3.86,+0.30,8.43,2000,2,7600,0,0,0,0,0,0,2000,0,2000,2000
20200520,053357,可成統一96購02,,,,,0.00,0.00,0,0,0,0,0,0,0,0,0,0,0,0,0
20200520,053358,晶技統一98購01,,,,,0.00,0.00,0,0,0,0,0,0,0,0,0,0,0,0,0
20200520,053359,矽力統一96購02,,,,,0.00,0.00,0,0,0,0,0,0,0,0,0,0,0,0,0
20200520,053360,上証2X元富96購01,,,,,0.00,0.00,0,0,0,0,0,0,0,0,0,0,0,0,0
20200520,053361,友達元富99購01,0.56,0.58,0.56,0.56,+0.03,5.66,64000,5,36460,0,0,0,0,0,0,30000,34000,-4000,-4000
20200520,053362,元油反國泰98購01,,,,,0.00,0.00,0,0,0,0,0,0,0,0,0,0,0,0,0
20200520,053363,旺宏國泰98購02,0.30,0.30,0.30,0.30,-0.01,-3.23,10000,1,3000,0,0,0,0,0,0,10000,0,10000,10000
20200520,053364,友達國泰98購01,0.44,0.44,0.44,0.44,-0.02,-4.35,125000,1,55000,0,0,0,0,0,0,125000,0,125000,125000
20200520,053365,彩晶國泰98購01,,,,,0.00,0.00,0,0,0,0,0,0,0,0,0,0,0,0,0
20200520,053366,樺漢國泰98購01,0.05,0.05,0.05,0.05,0.00,0.00,4000,1,200,0,0,0,0,0,0,4000,0,4000,4000
20200520,053367,元油反富邦97購01,,,,,0.00,0.00,0,0,0,0,0,0,0,0,0,0,0,0,0
20200520,053368,京元電富邦98購01,0.06,0.06,0.04,0.04,-0.02,-33.33,64000,3,3060,0,0,0,0,0,0,0,0,0,0
20200520,053369,T50反1元大96購06,,,,,0.00,0.00,0,0,0,0,0,0,0,0,0,0,0,0,0
20200520,053370,上証2X元大97購03,,,,,0.00,0.00,0,0,0,0,0,0,0,0,0,0,0,0,0
20200520,053371,滬深2X元大99購01,,,,,0.00,0.00,0,0,0,0,0,0,0,0,0,0,0,0,0
20200520,053372,元油反元大98購01,,,,,0.00,0.00,0,0,0,0,0,0,0,0,0,0,0,0,0
20200520,053373,台泥元大96購01,,,,,0.00,0.00,0,0,0,0,0,0,0,0,0,0,0,0,0
20200520,053374,台達電元大96購03,,,,,0.00,0.00,0,0,0,0,0,0,0,0,0,0,0,0,0
20200520,053375,鴻海元大96購18,0.08,0.08,0.08,0.08,-0.01,-11.11,10000,1,800,0,0,0,0,0,0,10000,0,10000,10000
20200520,053376,鴻海元大96購19,,,,,0.00,0.00,0,0,0,0,0,0,0,0,0,0,0,0,0
20200520,053377,台積電元大98購01,0.11,0.11,0.11,0.11,-0.10,-47.62,5000,1,550,0,0,0,0,0,0,5000,0,5000,5000
20200520,053378,台積電元大98購02,,,,,0.00,0.00,0,0,0,0,0,0,0,0,0,0,0,0,0
20200520,053379,南亞科元大96購01,,,,,0.00,0.00,0,0,0,0,0,0,0,0,0,0,0,0,0
20200520,053380,南亞科元大97購01,,,,,0.00,0.00,0,0,0,0,0,0,0,0,0,0,0,0,0
20200520,053381,友達元大9A購02,0.54,0.54,0.54,0.54,0.00,0.00,10000,1,5400,0,0,0,0,0,0,10000,0,10000,10000
20200520,053382,友達元大9C購02,,,,,0.00,0.00,0,0,0,0,0,0,0,0,0,0,0,0,0
20200520,053383,京元電元大97購01,,,,,0.00,0.00,0,0,0,0,0,0,0,0,0,0,0,0,0
20200520,053384,聯發科元大96購13,,,,,0.00,0.00,0,0,0,0,0,0,0,0,0,0,0,0,0
20200520,053385,聯詠元大96購02,0.13,0.14,0.13,0.14,0.00,0.00,40000,2,5400,0,0,0,0,0,0,40000,0,40000,40000
20200520,053386,聯詠元大96購03,,,,,0.00,0.00,0,0,0,0,0,0,0,0,0,0,0,0,0
20200520,053387,緯創元大97購01,0.32,0.32,0.32,0.32,-0.02,-5.88,60000,1,19200,0,0,0,0,0,0,60000,0,60000,60000
20200520,053388,群創元大9C購02,,,,,0.00,0.00,0,0,0,0,0,0,0,0,0,0,0,0,0
20200520,053389,彩晶元大98購01,,,,,0.00,0.00,0,0,0,0,0,0,0,0,0,0,0,0,0
20200520,053390,彩晶元大9A購01,,,,,0.00,0.00,0,0,0,0,0,0,0,0,0,0,0,0,0
20200520,053391,嘉聯益元大99購01,,,,,0.00,0.00,0,0,0,0,0,0,0,0,0,0,0,0,0
20200520,053392,致新元大96購01,1.52,1.60,1.52,1.60,+0.17,11.89,32000,3,50040,0,0,0,0,0,0,32000,0,32000,32000
20200520,053393,元油反中信98購01,,,,,0.00,0.00,0,0,0,0,0,0,0,0,0,0,0,0,0
20200520,053394,鴻海中信9A購01,0.15,0.15,0.15,0.15,0.00,0.00,1000,1,150,0,0,0,0,0,0,0,0,0,0
20200520,053395,致茂中信96購01,,,,,0.00,0.00,0,0,0,0,0,0,0,0,0,0,0,0,0
20200520,053396,漢唐中信9A購01,,,,,0.00,0.00,0,0,0,0,0,0,0,0,0,0,0,0,0
20200520,053397,國泰金中信96購01,,,,,0.00,0.00,0,0,0,0,0,0,0,0,0,0,0,0,0
20200520,053398,和鑫中信99購01,0.07,0.07,0.06,0.07,0.00,0.00,129000,15,7980,0,0,0,0,0,0,25000,80000,-55000,-55000
20200520,053399,創意中信96購01,,,,,0.00,0.00,0,0,0,0,0,0,0,0,0,0,0,0,0
20200520,053400,緯穎中信9A購01,2.00,2.06,1.86,1.86,-0.08,-4.12,62000,7,122300,0,0,0,0,0,0,40000,32000,8000,8000
20200520,053401,臺股指中信99購01,0.14,0.14,0.14,0.14,+0.02,16.67,1000,1,140,0,0,0,0,0,0,0,0,0,0
20200520,053402,A50正2群益9A購02,,,,,0.00,0.00,0,0,0,0,0,0,0,0,0,0,0,0,0
20200520,053403,彩晶群益98購01,,,,,0.00,0.00,0,0,0,0,0,0,0,0,0,0,0,0,0
20200520,053404,致新群益96購01,,,,,0.00,0.00,0,0,0,0,0,0,0,0,0,0,0,0,0
20200520,053405,台達電兆豐96購01,,,,,0.00,0.00,0,0,0,0,0,0,0,0,0,0,0,0,0
20200520,053406,國巨兆豐96購02,,,,,0.00,0.00,0,0,0,0,0,0,0,0,0,0,0,0,0
20200520,053407,台積電兆豐96購02,,,,,0.00,0.00,0,0,0,0,0,0,0,0,0,0,0,0,0
20200520,053408,友達兆豐98購01,0.11,0.11,0.11,0.11,0.00,0.00,40000,1,4400,0,0,0,0,0,0,40000,0,40000,40000
20200520,053409,和碩兆豐96購02,,,,,0.00,0.00,0,0,0,0,0,0,0,0,0,0,0,0,0
20200520,053410,啟碁兆豐96購01,,,,,0.00,0.00,0,0,0,0,0,0,0,0,0,0,0,0,0
20200520,053411,深中小國票9B購01,1.11,1.11,1.11,1.11,0.00,0.00,8000,1,8880,0,0,0,0,0,0,8000,0,8000,8000
20200520,053412,台達電國票97購02,,,,,0.00,0.00,0,0,0,0,0,0,0,0,0,0,0,0,0
20200520,053413,台積電國票99購01,,,,,0.00,0.00,0,0,0,0,0,0,0,0,0,0,0,0,0
20200520,053414,臻鼎國票97購01,,,,,0.00,0.00,0,0,0,0,0,0,0,0,0,0,0,0,0
20200520,053415,聯茂國票97購01,0.02,0.02,0.02,0.02,0.00,0.00,1000,1,20,0,0,0,0,0,0,1000,0,1000,1000
20200520,053416,光磊台新97購01,,,,,0.00,0.00,0,0,0,0,0,0,0,0,0,0,0,0,0
20200520,053417,上銀永豐96購02,,,,,0.00,0.00,0,0,0,0,0,0,0,0,0,0,0,0,0
20200520,053418,旺宏永豐96購02,0.02,0.03,0.01,0.02,0.00,0.00,242000,10,4080,0,0,0,0,0,0,0,0,0,0
20200520,053419,光罩永豐96購01,,,,,0.00,0.00,0,0,0,0,0,0,0,0,0,0,0,0,0
20200520,053420,華邦電永豐96購01,,,,,0.00,0.00,0,0,0,0,0,0,0,0,0,0,0,0,0
20200520,053421,南亞科永豐96購01,,,,,0.00,0.00,0,0,0,0,0,0,0,0,0,0,0,0,0
20200520,053422,可成永豐96購01,,,,,0.00,0.00,0,0,0,0,0,0,0,0,0,0,0,0,0
20200520,053423,亞光永豐96購01,0.07,0.07,0.07,0.07,0.00,0.00,30000,1,2100,0,0,0,0,0,0,30000,0,30000,30000
20200520,053424,欣興永豐96購02,,,,,0.00,0.00,0,0,0,0,0,0,0,0,0,0,0,0,0
20200520,053425,京鼎永豐96購01,,,,,0.00,0.00,0,0,0,0,0,0,0,0,0,0,0,0,0
20200520,053426,創意永豐96購04,,,,,0.00,0.00,0,0,0,0,0,0,0,0,0,0,0,0,0
20200520,053427,鎧勝永豐96購02,,,,,0.00,0.00,0,0,0,0,0,0,0,0,0,0,0,0,0
20200520,053428,中磊永豐96購02,0.34,0.34,0.34,0.34,0.00,0.00,3000,1,1020,0,0,0,0,0,0,3000,0,3000,3000
20200520,053429,彩晶永豐96購01,,,,,0.00,0.00,0,0,0,0,0,0,0,0,0,0,0,0,0
20200520,053430,樺漢永豐96購01,,,,,0.00,0.00,0,0,0,0,0,0,0,0,0,0,0,0,0
20200520,053431,志超永豐96購01,,,,,0.00,0.00,0,0,0,0,0,0,0,0,0,0,0,0,0
20200520,053432,世紀鋼永豐96購02,,,,,0.00,0.00,0,0,0,0,0,0,0,0,0,0,0,0,0
20200520,053433,友達日盛99購06,,,,,0.00,0.00,0,0,0,0,0,0,0,0,0,0,0,0,0
20200520,053434,國泰金日盛96購01,,,,,0.00,0.00,0,0,0,0,0,0,0,0,0,0,0,0,0
20200520,053435,新光金日盛96購01,,,,,0.00,0.00,0,0,0,0,0,0,0,0,0,0,0,0,0
20200520,053436,聯茂日盛96購01,0.19,0.19,0.16,0.16,-0.07,-30.43,253000,46,46160,0,0,0,0,0,0,253000,0,253000,253000
20200520,053437,啟碁日盛96購01,,,,,0.00,0.00,0,0,0,0,0,0,0,0,0,0,0,0,0
20200520,053438,玉晶光麥證97購02,0.39,0.50,0.36,0.49,-0.01,-2.0,74000,9,28790,0,70000,-70000,0,0,0,0,70000,-70000,-70000
20200520,053439,台積電凱基96購11,,,,,0.00,0.00,0,0,0,0,0,0,0,0,0,0,0,0,0
20200520,053440,台積電凱基96購12,,,,,0.00,0.00,0,0,0,0,0,0,0,0,0,0,0,0,0
20200520,053441,旺宏凱基98購01,,,,,0.00,0.00,0,0,0,0,0,0,0,0,0,0,0,0,0
20200520,053442,光罩凱基96購01,,,,,0.00,0.00,0,0,0,0,0,0,0,0,0,0,0,0,0
20200520,053443,智邦凱基97購01,6.20,6.35,6.20,6.35,+0.35,5.83,23000,2,143050,0,0,0,0,0,0,20000,3000,17000,17000
20200520,053444,奇力新凱基96購03,,,,,0.00,0.00,0,0,0,0,0,0,0,0,0,0,0,0,0
20200520,053445,可成凱基96購04,,,,,0.00,0.00,0,0,0,0,0,0,0,0,0,0,0,0,0
20200520,053446,欣興凱基96購02,0.21,0.21,0.17,0.18,0.00,0.00,101000,11,19290,0,0,0,0,0,0,0,101000,-101000,-101000
20200520,053447,京鼎凱基96購03,,,,,0.00,0.00,0,0,0,0,0,0,0,0,0,0,0,0,0
20200520,053448,智易凱基96購03,,,,,0.00,0.00,0,0,0,0,0,0,0,0,0,0,0,0,0
20200520,053449,超眾凱基98購01,,,,,0.00,0.00,0,0,0,0,0,0,0,0,0,0,0,0,0
20200520,053450,同欣電凱基96購02,0.30,0.32,0.30,0.31,+0.01,3.33,13000,3,4120,0,0,0,0,0,0,1000,12000,-11000,-11000
20200520,053451,致新凱基96購02,1.11,1.14,1.09,1.09,+0.17,18.48,50000,5,55600,0,0,0,0,0,0,0,50000,-50000,-50000
20200520,053452,臺股指凱基97購01,0.02,0.02,0.02,0.02,0.00,0.00,139000,2,2780,0,0,0,0,0,0,100000,0,100000,100000
20200520,053453,新光金統一98購01,,,,,0.00,0.00,0,0,0,0,0,0,0,0,0,0,0,0,0
20200520,053454,創意統一96購02,0.25,0.26,0.25,0.26,-0.02,-7.14,1996000,4,508980,0,0,0,0,0,0,1996000,0,1996000,1996000
20200520,053455,台光電元富96購02,,,,,0.00,0.00,0,0,0,0,0,0,0,0,0,0,0,0,0
20200520,053456,大立光元富96購04,,,,,0.00,0.00,0,0,0,0,0,0,0,0,0,0,0,0,0
20200520,053457,旺宏國泰98購03,,,,,0.00,0.00,0,0,0,0,0,0,0,0,0,0,0,0,0
20200520,053458,聯詠國泰97購01,0.12,0.14,0.11,0.14,-0.01,-6.67,37000,10,4730,0,0,0,0,0,0,27000,10000,17000,17000
20200520,053459,康控國泰97購01,,,,,0.00,0.00,0,0,0,0,0,0,0,0,0,0,0,0,0
20200520,053460,緯穎國泰97購01,,,,,0.00,0.00,0,0,0,0,0,0,0,0,0,0,0,0,0
20200520,053461,台郡永昌99購01,,,,,0.00,0.00,0,0,0,0,0,0,0,0,0,0,0,0,0
20200520,053462,元油反富邦97購02,,,,,0.00,0.00,0,0,0,0,0,0,0,0,0,0,0,0,0
20200520,053463,可成富邦98購01,0.16,0.16,0.16,0.16,0.00,0.00,2000,1,320,0,0,0,0,0,0,0,0,0,0
20200520,053464,喬山元大96購01,0.01,0.01,0.01,0.01,0.00,0.00,6000,1,60,0,0,0,0,0,0,6000,0,6000,6000
20200520,053465,聯電元大96購05,,,,,0.00,0.00,0,0,0,0,0,0,0,0,0,0,0,0,0
20200520,053466,華通元大98購01,,,,,0.00,0.00,0,0,0,0,0,0,0,0,0,0,0,0,0
20200520,053467,鴻海元大96購20,,,,,0.00,0.00,0,0,0,0,0,0,0,0,0,0,0,0,0
20200520,053468,鴻海元大98購01,,,,,0.00,0.00,0,0,0,0,0,0,0,0,0,0,0,0,0
20200520,053469,光磊元大97購01,,,,,0.00,0.00,0,0,0,0,0,0,0,0,0,0,0,0,0
20200520,053470,華邦電元大96購02,,,,,0.00,0.00,0,0,0,0,0,0,0,0,0,0,0,0,0
20200520,053471,正崴元大96購01,,,,,0.00,0.00,0,0,0,0,0,0,0,0,0,0,0,0,0
20200520,053472,漢唐元大96購02,,,,,0.00,0.00,0,0,0,0,0,0,0,0,0,0,0,0,0
20200520,053473,聯發科元大96購15,3.67,3.67,3.67,3.67,0.00,0.00,2000,1,7340,0,0,0,0,0,0,2000,0,2000,2000
20200520,053474,聯發科元大97購06,1.58,1.80,1.55,1.59,+0.14,9.66,125000,9,201210,0,0,0,0,0,0,110000,0,110000,110000
20200520,053475,華新科元大96購05,,,,,0.00,0.00,0,0,0,0,0,0,0,0,0,0,0,0,0
20200520,053476,冠德元大96購03,,,,,0.00,0.00,0,0,0,0,0,0,0,0,0,0,0,0,0
20200520,053477,大立光元大97購03,,,,,0.00,0.00,0,0,0,0,0,0,0,0,0,0,0,0,0
20200520,053478,京鼎元大96購01,,,,,0.00,0.00,0,0,0,0,0,0,0,0,0,0,0,0,0
20200520,053479,達興元大96購01,0.18,0.18,0.18,0.18,-0.02,-10.0,70000,1,12600,0,0,0,0,0,0,70000,0,70000,70000
20200520,05347P,滬深2X元富9B售02,1.44,1.44,1.44,1.44,0.00,0.00,2000,1,2880,0,0,0,0,0,0,0,2000,-2000,-2000
20200520,053480,祥碩元大96購02,,,,,0.00,0.00,0,0,0,0,0,0,0,0,0,0,0,0,0
20200520,053481,同欣電元大97購01,0.68,0.68,0.65,0.65,0.00,0.00,30000,3,20000,0,0,0,0,0,0,0,30000,-30000,-30000
20200520,053482,矽力元大96購03,,,,,0.00,0.00,0,0,0,0,0,0,0,0,0,0,0,0,0
20200520,053483,嘉澤第一96購01,,,,,0.00,0.00,0,0,0,0,0,0,0,0,0,0,0,0,0
20200520,053484,國巨國票97購03,,,,,0.00,0.00,0,0,0,0,0,0,0,0,0,0,0,0,0
20200520,053485,矽創國票97購04,0.54,0.55,0.54,0.54,+0.04,8.0,217000,28,117730,0,0,0,0,0,0,214000,3000,211000,211000
20200520,053486,T50反1兆豐96購01,0.84,0.85,0.84,0.85,-0.03,-3.41,30000,2,25300,0,0,0,0,0,0,0,30000,-30000,-30000
20200520,053487,台泥兆豐97購01,3.07,3.11,3.07,3.10,-0.08,-2.52,178000,13,551040,0,0,0,0,0,0,128000,50000,78000,78000
20200520,053488,中石化兆豐97購01,0.67,0.67,0.67,0.67,-0.05,-6.94,56000,1,37520,0,0,0,0,0,0,56000,0,56000,56000
20200520,053489,上銀兆豐97購01,,,,,0.00,0.00,0,0,0,0,0,0,0,0,0,0,0,0,0
20200520,05348P,美律元富98售01,1.06,1.10,1.06,1.08,+0.02,1.89,259000,10,280320,0,0,0,0,0,0,82000,177000,-95000,-95000
20200520,053490,為升兆豐97購01,,,,,0.00,0.00,0,0,0,0,0,0,0,0,0,0,0,0,0
20200520,053491,鴻海兆豐97購02,,,,,0.00,0.00,0,0,0,0,0,0,0,0,0,0,0,0,0
20200520,053492,華邦電兆豐97購01,0.24,0.24,0.24,0.24,0.00,0.00,100000,2,24000,0,0,0,0,0,0,100000,0,100000,100000
20200520,053493,智邦兆豐97購02,,,,,0.00,0.00,0,0,0,0,0,0,0,0,0,0,0,0,0
20200520,053494,南亞科兆豐96購02,0.35,0.35,0.33,0.33,+0.02,6.45,180000,7,61800,0,0,0,0,0,0,40000,140000,-100000,-100000
20200520,053495,聯發科兆豐96購02,,,,,0.00,0.00,0,0,0,0,0,0,0,0,0,0,0,0,0
20200520,053496,義隆兆豐96購02,1.64,1.77,1.64,1.77,+0.06,3.51,7000,2,11610,0,0,0,0,0,0,1000,6000,-5000,-5000
20200520,053497,新光金兆豐97購01,0.04,0.04,0.04,0.04,0.00,0.00,10000,1,400,0,0,0,0,0,0,0,10000,-10000,-10000
20200520,053498,大立光兆豐96購03,,,,,0.00,0.00,0,0,0,0,0,0,0,0,0,0,0,0,0
20200520,053499,禾伸堂兆豐96購01,,,,,0.00,0.00,0,0,0,0,0,0,0,0,0,0,0,0,0
20200520,05349P,可成元富98售03,,,,,0.00,0.00,0,0,0,0,0,0,0,0,0,0,0,0,0
20200520,053500,新日興兆豐97購01,1.68,2.08,1.68,2.08,+0.18,9.47,544000,24,1004600,0,0,0,0,0,0,79000,465000,-386000,-386000
20200520,053501,明泰兆豐96購01,2.52,2.52,2.50,2.50,-0.02,-0.79,20000,3,50200,0,0,0,0,0,0,10000,10000,0,0
20200520,053502,智伸科兆豐97購01,0.61,0.63,0.58,0.62,+0.06,10.71,258000,36,153710,0,0,0,0,0,0,207000,0,207000,207000
20200520,053503,臻鼎兆豐97購01,,,,,0.00,0.00,0,0,0,0,0,0,0,0,0,0,0,0,0
20200520,053504,祥碩兆豐96購01,,,,,0.00,0.00,0,0,0,0,0,0,0,0,0,0,0,0,0
20200520,053505,瑞儀兆豐97購01,0.64,0.67,0.64,0.67,-0.01,-1.47,69000,3,45540,0,0,0,0,0,0,0,69000,-69000,-69000
20200520,053506,南茂兆豐97購01,1.41,1.46,1.41,1.46,0.00,0.00,78000,6,110780,0,0,0,0,0,0,0,78000,-78000,-78000
20200520,053507,百和兆豐96購01,,,,,0.00,0.00,0,0,0,0,0,0,0,0,0,0,0,0,0
20200520,053508,元油反群益9A購01,,,,,0.00,0.00,0,0,0,0,0,0,0,0,0,0,0,0,0
20200520,053509,華新群益98購01,,,,,0.00,0.00,0,0,0,0,0,0,0,0,0,0,0,0,0
20200520,05350P,可成元富98售04,,,,,0.00,0.00,0,0,0,0,0,0,0,0,0,0,0,0,0
20200520,053510,聯電群益97購01,0.05,0.05,0.05,0.05,0.00,0.00,30000,1,1500,0,0,0,0,0,0,0,30000,-30000,-30000
20200520,053511,鴻海群益96購04,,,,,0.00,0.00,0,0,0,0,0,0,0,0,0,0,0,0,0
20200520,053512,台積電群益96購06,,,,,0.00,0.00,0,0,0,0,0,0,0,0,0,0,0,0,0
20200520,053513,義隆群益96購05,,,,,0.00,0.00,0,0,0,0,0,0,0,0,0,0,0,0,0
20200520,053514,麗豐群益96購01,,,,,0.00,0.00,0,0,0,0,0,0,0,0,0,0,0,0,0
20200520,053515,致伸群益96購02,,,,,0.00,0.00,0,0,0,0,0,0,0,0,0,0,0,0,0
20200520,053516,茂林群益96購05,1.20,1.25,1.20,1.25,+0.24,23.76,30000,5,37250,0,0,0,0,0,0,10000,10000,0,0
20200520,053517,崇越群益97購01,,,,,0.00,0.00,0,0,0,0,0,0,0,0,0,0,0,0,0
20200520,053518,聯茂群益96購03,,,,,0.00,0.00,0,0,0,0,0,0,0,0,0,0,0,0,0
20200520,053519,力成群益96購02,0.25,0.25,0.25,0.25,-0.11,-30.56,1000,1,250,0,0,0,0,0,0,1000,0,1000,1000
20200520,053520,康友群益96購01,,,,,0.00,0.00,0,0,0,0,0,0,0,0,0,0,0,0,0
20200520,053521,緯穎群益96購02,,,,,0.00,0.00,0,0,0,0,0,0,0,0,0,0,0,0,0
20200520,053522,臺股指群益99購01,,,,,0.00,0.00,0,0,0,0,0,0,0,0,0,0,0,0,0
20200520,053523,T50反1中信9A購01,,,,,0.00,0.00,0,0,0,0,0,0,0,0,0,0,0,0,0
20200520,053524,聯電中信97購02,0.04,0.04,0.03,0.03,0.00,0.00,100000,2,3100,0,0,0,0,0,0,90000,0,90000,90000
20200520,053525,台積電中信96購04,,,,,0.00,0.00,0,0,0,0,0,0,0,0,0,0,0,0,0
20200520,053526,正崴中信96購01,,,,,0.00,0.00,0,0,0,0,0,0,0,0,0,0,0,0,0
20200520,053527,創意中信97購01,,,,,0.00,0.00,0,0,0,0,0,0,0,0,0,0,0,0,0
20200520,053528,南電中信9A購01,0.80,0.80,0.73,0.73,-0.06,-7.59,25000,3,19000,0,0,0,0,0,0,0,25000,-25000,-25000
20200520,053529,國巨麥證96購01,,,,,0.00,0.00,0,0,0,0,0,0,0,0,0,0,0,0,0
20200520,053530,聯發科康和96購01,0.60,0.80,0.60,0.65,+0.07,12.07,737000,37,502610,0,0,0,0,0,0,432000,305000,127000,127000
20200520,053531,國泰金康和96購01,,,,,0.00,0.00,0,0,0,0,0,0,0,0,0,0,0,0,0
20200520,053532,台積電永豐96購03,,,,,0.00,0.00,0,0,0,0,0,0,0,0,0,0,0,0,0
20200520,053533,光罩永豐96購03,,,,,0.00,0.00,0,0,0,0,0,0,0,0,0,0,0,0,0
20200520,053534,微星永豐96購02,2.88,2.94,2.78,2.78,+0.06,2.21,37000,6,106420,0,0,0,0,0,0,27000,10000,17000,17000
20200520,053535,宏達電永豐96購02,,,,,0.00,0.00,0,0,0,0,0,0,0,0,0,0,0,0,0
20200520,053536,明泰永豐96購01,,,,,0.00,0.00,0,0,0,0,0,0,0,0,0,0,0,0,0
20200520,053537,玉晶光永豐98購02,,,,,0.00,0.00,0,0,0,0,0,0,0,0,0,0,0,0,0
20200520,053538,京鼎永豐96購03,,,,,0.00,0.00,0,0,0,0,0,0,0,0,0,0,0,0,0
20200520,053539,智易永豐96購01,,,,,0.00,0.00,0,0,0,0,0,0,0,0,0,0,0,0,0
20200520,053540,健策永豐96購01,,,,,0.00,0.00,0,0,0,0,0,0,0,0,0,0,0,0,0
20200520,053541,泰鼎永豐96購02,4.79,4.79,4.76,4.76,-0.04,-0.83,30000,5,143490,0,0,0,0,0,0,30000,0,30000,30000
20200520,053542,超眾永豐96購01,1.18,1.18,1.18,1.18,0.00,0.00,1000,1,1180,0,0,0,0,0,0,0,1000,-1000,-1000
20200520,053543,臺股指永豐96購02,,,,,0.00,0.00,0,0,0,0,0,0,0,0,0,0,0,0,0
20200520,053544,華新凱基96購01,,,,,0.00,0.00,0,0,0,0,0,0,0,0,0,0,0,0,0
20200520,053545,上銀凱基96購03,,,,,0.00,0.00,0,0,0,0,0,0,0,0,0,0,0,0,0
20200520,053546,台積電凱基96購13,,,,,0.00,0.00,0,0,0,0,0,0,0,0,0,0,0,0,0
20200520,053547,台積電凱基96購14,,,,,0.00,0.00,0,0,0,0,0,0,0,0,0,0,0,0,0
20200520,053548,旺宏凱基96購04,,,,,0.00,0.00,0,0,0,0,0,0,0,0,0,0,0,0,0
20200520,053549,南亞科凱基96購02,,,,,0.00,0.00,0,0,0,0,0,0,0,0,0,0,0,0,0
20200520,053550,聯發科凱基96購15,0.99,1.50,0.99,1.03,+0.12,13.19,16000,3,16750,0,0,0,0,0,0,15000,0,15000,15000
20200520,053551,可成凱基96購05,,,,,0.00,0.00,0,0,0,0,0,0,0,0,0,0,0,0,0
20200520,053552,華新科凱基96購08,0.02,0.02,0.02,0.02,-0.02,-50.0,17000,1,340,0,0,0,0,0,0,17000,0,17000,17000
20200520,053553,聯詠凱基96購03,,,,,0.00,0.00,0,0,0,0,0,0,0,0,0,0,0,0,0
20200520,053554,欣興凱基97購02,,,,,0.00,0.00,0,0,0,0,0,0,0,0,0,0,0,0,0
20200520,053555,日月光凱基97購01,,,,,0.00,0.00,0,0,0,0,0,0,0,0,0,0,0,0,0
20200520,053556,康控凱基97購02,,,,,0.00,0.00,0,0,0,0,0,0,0,0,0,0,0,0,0
20200520,053557,聯茂凱基96購04,0.43,0.43,0.43,0.43,+0.02,4.88,14000,2,6020,0,0,0,0,0,0,4000,10000,-6000,-6000
20200520,053558,訊芯凱基96購02,,,,,0.00,0.00,0,0,0,0,0,0,0,0,0,0,0,0,0
20200520,053559,台積電國泰98購01,,,,,0.00,0.00,0,0,0,0,0,0,0,0,0,0,0,0,0
20200520,053560,漢唐國泰98購01,,,,,0.00,0.00,0,0,0,0,0,0,0,0,0,0,0,0,0
20200520,053561,玉晶光國泰98購01,,,,,0.00,0.00,0,0,0,0,0,0,0,0,0,0,0,0,0
20200520,053562,玉晶光國泰98購02,,,,,0.00,0.00,0,0,0,0,0,0,0,0,0,0,0,0,0
20200520,053563,台積電富邦97購01,,,,,0.00,0.00,0,0,0,0,0,0,0,0,0,0,0,0,0
20200520,053564,台積電富邦99購01,0.14,0.14,0.11,0.13,-0.01,-7.14,3461000,137,427140,0,0,0,0,0,0,0,510000,-510000,-510000
20200520,053565,台光電富邦98購01,0.54,0.54,0.54,0.54,0.00,0.00,190000,3,102600,0,0,0,0,0,0,176000,0,176000,176000
20200520,053566,大立光富邦99購03,0.28,0.28,0.28,0.28,0.00,0.00,5000,1,1400,0,0,0,0,0,0,0,0,0,0
20200520,053567,群創富邦97購01,,,,,0.00,0.00,0,0,0,0,0,0,0,0,0,0,0,0,0
20200520,053568,智伸科富邦98購01,0.12,0.12,0.12,0.12,0.00,0.00,20000,2,2400,0,0,0,0,0,0,20000,0,20000,20000
20200520,053569,漢唐統一98購01,0.53,0.53,0.53,0.53,0.00,0.00,25000,2,13250,0,0,0,0,0,0,0,25000,-25000,-25000
20200520,053570,京元電統一96購01,,,,,0.00,0.00,0,0,0,0,0,0,0,0,0,0,0,0,0
20200520,053571,奇鋐統一96購02,0.25,0.25,0.25,0.25,-0.03,-10.71,16000,1,4000,0,0,0,0,0,0,16000,0,16000,16000
20200520,053572,彩晶統一96購01,,,,,0.00,0.00,0,0,0,0,0,0,0,0,0,0,0,0,0
20200520,053573,臺股指統一99購01,0.47,0.50,0.43,0.45,-0.01,-2.17,832000,12,370480,0,0,0,0,0,0,421000,411000,10000,10000
20200520,053574,奇力新元富99購01,0.35,0.35,0.34,0.34,0.00,0.00,50000,5,17200,0,0,0,0,0,0,0,50000,-50000,-50000
20200520,053575,聯詠元富96購01,,,,,0.00,0.00,0,0,0,0,0,0,0,0,0,0,0,0,0
20200520,053576,智原元富96購01,,,,,0.00,0.00,0,0,0,0,0,0,0,0,0,0,0,0,0
20200520,053577,上証2X元大96購02,,,,,0.00,0.00,0,0,0,0,0,0,0,0,0,0,0,0,0
20200520,053578,華新元大98購01,,,,,0.00,0.00,0,0,0,0,0,0,0,0,0,0,0,0,0
20200520,053579,華通元大97購01,,,,,0.00,0.00,0,0,0,0,0,0,0,0,0,0,0,0,0
20200520,053580,國巨元大96購10,,,,,0.00,0.00,0,0,0,0,0,0,0,0,0,0,0,0,0
20200520,053581,台積電元大96購14,,,,,0.00,0.00,0,0,0,0,0,0,0,0,0,0,0,0,0
20200520,053582,英業達元大97購01,1.19,1.29,1.19,1.22,0.00,0.00,471000,17,585870,0,0,0,0,0,0,183000,288000,-105000,-105000
20200520,053583,漢唐元大96購03,,,,,0.00,0.00,0,0,0,0,0,0,0,0,0,0,0,0,0
20200520,053584,友達元大9B購02,0.76,0.76,0.76,0.76,-0.03,-3.8,5000,1,3800,0,0,0,0,0,0,0,5000,-5000,-5000
20200520,053585,友達元大9C購03,,,,,0.00,0.00,0,0,0,0,0,0,0,0,0,0,0,0,0
20200520,053586,建準元大96購01,2.15,2.15,1.62,1.81,-0.40,-18.1,314000,21,584310,0,0,0,0,0,0,244000,78000,166000,166000
20200520,053587,京元電元大98購01,0.28,0.28,0.25,0.25,-0.08,-24.24,60000,6,16500,0,0,0,0,0,0,0,50000,-50000,-50000
20200520,053588,聯發科元大97購07,,,,,0.00,0.00,0,0,0,0,0,0,0,0,0,0,0,0,0
20200520,053589,宏達電元大97購02,,,,,0.00,0.00,0,0,0,0,0,0,0,0,0,0,0,0,0
20200520,053590,新光金元大9A購02,,,,,0.00,0.00,0,0,0,0,0,0,0,0,0,0,0,0,0
20200520,053591,大立光元大99購03,,,,,0.00,0.00,0,0,0,0,0,0,0,0,0,0,0,0,0
20200520,053592,亞光元大96購01,,,,,0.00,0.00,0,0,0,0,0,0,0,0,0,0,0,0,0
20200520,053593,晶技元大98購01,1.86,1.88,1.75,1.75,-0.12,-6.42,224000,11,408320,0,0,0,0,0,0,60000,164000,-104000,-104000
20200520,053594,京鼎元大96購02,,,,,0.00,0.00,0,0,0,0,0,0,0,0,0,0,0,0,0
20200520,053595,創意元大96購02,0.32,0.32,0.32,0.32,0.00,0.00,94000,1,30080,0,0,0,0,0,0,0,94000,-94000,-94000
20200520,053596,嘉澤元大96購01,,,,,0.00,0.00,0,0,0,0,0,0,0,0,0,0,0,0,0
20200520,053597,牧德元大99購01,,,,,0.00,0.00,0,0,0,0,0,0,0,0,0,0,0,0,0
20200520,053598,日月光元大96購04,,,,,0.00,0.00,0,0,0,0,0,0,0,0,0,0,0,0,0
20200520,053599,崇越元大96購01,,,,,0.00,0.00,0,0,0,0,0,0,0,0,0,0,0,0,0
20200520,053600,同欣電元大96購04,,,,,0.00,0.00,0,0,0,0,0,0,0,0,0,0,0,0,0
20200520,053601,台表科元大98購01,0.65,0.69,0.65,0.69,+0.08,13.11,22000,4,14340,0,0,0,0,0,0,22000,0,22000,22000
20200520,053602,台虹元大96購01,0.46,0.46,0.46,0.46,0.00,0.00,50000,1,23000,0,0,0,0,0,0,50000,0,50000,50000
20200520,053603,臺股指元大96購20,,,,,0.00,0.00,0,0,0,0,0,0,0,0,0,0,0,0,0
20200520,053604,臺股指元大96購21,,,,,0.00,0.00,0,0,0,0,0,0,0,0,0,0,0,0,0
20200520,053605,臺股指永昌96購01,,,,,0.00,0.00,0,0,0,0,0,0,0,0,0,0,0,0,0
20200520,053606,臺股指永昌96購02,,,,,0.00,0.00,0,0,0,0,0,0,0,0,0,0,0,0,0
20200520,053607,大立光第一96購01,,,,,0.00,0.00,0,0,0,0,0,0,0,0,0,0,0,0,0
20200520,053608,彩晶第一96購01,,,,,0.00,0.00,0,0,0,0,0,0,0,0,0,0,0,0,0
20200520,053609,華新中信9A購01,0.05,0.05,0.05,0.05,0.00,0.00,96000,12,4800,0,0,0,0,0,0,0,96000,-96000,-96000
20200520,053610,矽力中信98購01,1.97,1.97,1.97,1.97,0.00,0.00,11000,1,21670,0,0,0,0,0,0,11000,0,11000,11000
20200520,053611,聯茂麥證96購01,0.32,0.32,0.30,0.30,0.00,0.00,20000,2,6200,20000,0,20000,0,0,0,20000,0,20000,20000
20200520,053612,T50反1群益96購01,,,,,0.00,0.00,0,0,0,0,0,0,0,0,0,0,0,0,0
20200520,053613,元油反群益9A購02,,,,,0.00,0.00,0,0,0,0,0,0,0,0,0,0,0,0,0
20200520,053614,台積電群益96購08,,,,,0.00,0.00,0,0,0,0,0,0,0,0,0,0,0,0,0
20200520,053615,光罩群益96購01,,,,,0.00,0.00,0,0,0,0,0,0,0,0,0,0,0,0,0
20200520,053616,奇力新群益97購01,,,,,0.00,0.00,0,0,0,0,0,0,0,0,0,0,0,0,0
20200520,053617,宏達電群益96購02,,,,,0.00,0.00,0,0,0,0,0,0,0,0,0,0,0,0,0
20200520,053618,新唐群益96購01,,,,,0.00,0.00,0,0,0,0,0,0,0,0,0,0,0,0,0
20200520,053619,和碩群益96購01,,,,,0.00,0.00,0,0,0,0,0,0,0,0,0,0,0,0,0
20200520,05361P,聯發科富邦97售01,0.55,0.57,0.51,0.55,-0.06,-9.84,463000,24,251720,0,0,0,0,0,0,102000,361000,-259000,-259000
20200520,053620,臺股指群益96購06,,,,,0.00,0.00,0,0,0,0,0,0,0,0,0,0,0,0,0
20200520,053621,臺股指群益96購07,1.13,1.19,1.10,1.10,-0.06,-5.17,6000,6,6920,0,0,0,0,0,0,4000,2000,2000,2000
20200520,053622,臺股指群益96購08,,,,,0.00,0.00,0,0,0,0,0,0,0,0,0,0,0,0,0
20200520,053623,臺股指群益96購09,,,,,0.00,0.00,0,0,0,0,0,0,0,0,0,0,0,0,0
20200520,053624,A50正2兆豐97購02,,,,,0.00,0.00,0,0,0,0,0,0,0,0,0,0,0,0,0
20200520,053625,國巨兆豐96購03,0.16,0.17,0.15,0.17,0.00,0.00,109000,4,18190,0,0,0,0,0,0,109000,50000,59000,59000
20200520,053626,台積電兆豐96購03,,,,,0.00,0.00,0,0,0,0,0,0,0,0,0,0,0,0,0
20200520,053627,宏碁兆豐97購01,0.26,0.26,0.26,0.26,-0.02,-7.14,24000,1,6240,0,0,0,0,0,0,24000,0,24000,24000
20200520,053628,微星兆豐96購01,,,,,0.00,0.00,0,0,0,0,0,0,0,0,0,0,0,0,0
20200520,053629,玉山金兆豐96購01,0.59,0.59,0.59,0.59,0.00,0.00,9000,1,5310,0,0,0,0,0,0,9000,0,9000,9000
20200520,05362P,可成富邦97售02,1.64,1.64,1.64,1.64,+0.13,8.61,10000,1,16400,0,0,0,0,0,0,0,10000,-10000,-10000
20200520,053630,奇鋐兆豐97購01,0.93,0.93,0.93,0.93,+0.07,8.14,7000,1,6510,0,0,0,0,0,0,0,7000,-7000,-7000
20200520,053631,欣興兆豐97購01,0.98,1.06,0.92,0.96,-0.03,-3.03,264000,16,254430,0,0,0,0,0,0,174000,90000,84000,84000
20200520,053632,新唐兆豐96購01,0.16,0.16,0.16,0.16,0.00,0.00,25000,3,4000,0,0,0,0,0,0,0,25000,-25000,-25000
20200520,053633,臺股指兆豐96購01,,,,,0.00,0.00,0,0,0,0,0,0,0,0,0,0,0,0,0
20200520,053634,劍麟永豐96購01,,,,,0.00,0.00,0,0,0,0,0,0,0,0,0,0,0,0,0
20200520,053635,技嘉永豐96購01,1.92,1.99,1.78,1.80,-0.30,-14.29,55000,8,102700,0,0,0,0,0,0,34000,21000,13000,13000
20200520,053636,全新永豐96購02,,,,,0.00,0.00,0,0,0,0,0,0,0,0,0,0,0,0,0
20200520,053637,強茂永豐96購01,,,,,0.00,0.00,0,0,0,0,0,0,0,0,0,0,0,0,0
20200520,053638,信邦永豐96購01,0.46,0.47,0.44,0.44,+0.02,4.76,99000,4,44740,0,0,0,0,0,0,0,99000,-99000,-99000
20200520,053639,禾伸堂永豐96購01,,,,,0.00,0.00,0,0,0,0,0,0,0,0,0,0,0,0,0
20200520,053640,上緯控永豐96購01,0.78,0.86,0.69,0.69,-0.10,-12.66,296000,17,229040,0,0,0,0,0,0,100000,196000,-96000,-96000
20200520,053641,正文永豐96購01,,,,,0.00,0.00,0,0,0,0,0,0,0,0,0,0,0,0,0
20200520,053642,瀚宇博永豐96購01,0.46,0.46,0.46,0.46,-0.05,-9.8,50000,1,23000,0,0,0,0,0,0,50000,0,50000,50000
20200520,053643,漢唐國票97購02,,,,,0.00,0.00,0,0,0,0,0,0,0,0,0,0,0,0,0
20200520,053644,台表科國票97購03,1.22,1.51,1.22,1.51,+0.79,109.72,332000,8,439370,0,0,0,0,0,0,0,332000,-332000,-332000
20200520,053645,臺股指國票96購08,0.87,0.87,0.82,0.82,-0.02,-2.38,115000,5,98650,0,0,0,0,0,0,52000,63000,-11000,-11000
20200520,053646,臺股指國票96購09,,,,,0.00,0.00,0,0,0,0,0,0,0,0,0,0,0,0,0
20200520,053647,臺股指國票96購10,,,,,0.00,0.00,0,0,0,0,0,0,0,0,0,0,0,0,0
20200520,053648,台積電凱基97購04,0.39,0.39,0.39,0.39,-0.05,-11.36,632000,4,246480,0,0,0,0,0,0,621000,11000,610000,610000
20200520,053649,台積電凱基97購05,0.02,0.05,0.01,0.05,+0.02,66.67,97000,6,2210,0,0,0,0,0,0,0,0,0,0
20200520,053650,華邦電凱基98購01,,,,,0.00,0.00,0,0,0,0,0,0,0,0,0,0,0,0,0
20200520,053651,台光電凱基98購01,,,,,0.00,0.00,0,0,0,0,0,0,0,0,0,0,0,0,0
20200520,053652,友達凱基98購04,,,,,0.00,0.00,0,0,0,0,0,0,0,0,0,0,0,0,0
20200520,053653,京元電凱基96購02,,,,,0.00,0.00,0,0,0,0,0,0,0,0,0,0,0,0,0
20200520,053654,聯發科凱基98購01,0.97,1.35,0.97,1.35,+0.41,43.62,200000,11,223500,0,0,0,0,0,0,200000,0,200000,200000
20200520,053655,全新凱基98購02,,,,,0.00,0.00,0,0,0,0,0,0,0,0,0,0,0,0,0
20200520,053656,可成凱基96購06,,,,,0.00,0.00,0,0,0,0,0,0,0,0,0,0,0,0,0
20200520,053657,元大金凱基96購01,,,,,0.00,0.00,0,0,0,0,0,0,0,0,0,0,0,0,0
20200520,053658,亞光凱基96購01,,,,,0.00,0.00,0,0,0,0,0,0,0,0,0,0,0,0,0
20200520,053659,智原凱基97購01,,,,,0.00,0.00,0,0,0,0,0,0,0,0,0,0,0,0,0
20200520,053660,群創凱基98購08,,,,,0.00,0.00,0,0,0,0,0,0,0,0,0,0,0,0,0
20200520,053661,嘉澤凱基97購01,,,,,0.00,0.00,0,0,0,0,0,0,0,0,0,0,0,0,0
20200520,053662,矽力凱基97購01,5.95,6.30,5.65,6.30,+0.05,0.8,49000,6,291600,0,0,0,0,0,0,27000,22000,5000,5000
20200520,053663,臺股指凱基96購24,,,,,0.00,0.00,0,0,0,0,0,0,0,0,0,0,0,0,0
20200520,053664,臺股指凱基96購25,,,,,0.00,0.00,0,0,0,0,0,0,0,0,0,0,0,0,0
20200520,053665,臺股指凱基96購26,,,,,0.00,0.00,0,0,0,0,0,0,0,0,0,0,0,0,0
20200520,053666,臺股指凱基96購29,,,,,0.00,0.00,0,0,0,0,0,0,0,0,0,0,0,0,0
20200520,053667,鴻海統一96購12,,,,,0.00,0.00,0,0,0,0,0,0,0,0,0,0,0,0,0
20200520,053668,鴻海統一97購01,,,,,0.00,0.00,0,0,0,0,0,0,0,0,0,0,0,0,0
20200520,053669,台積電統一96購08,,,,,0.00,0.00,0,0,0,0,0,0,0,0,0,0,0,0,0
20200520,053670,台積電統一96購09,,,,,0.00,0.00,0,0,0,0,0,0,0,0,0,0,0,0,0
20200520,053671,可成統一96購03,,,,,0.00,0.00,0,0,0,0,0,0,0,0,0,0,0,0,0
20200520,053672,嘉澤元富96購02,,,,,0.00,0.00,0,0,0,0,0,0,0,0,0,0,0,0,0
20200520,053673,超眾元富96購03,,,,,0.00,0.00,0,0,0,0,0,0,0,0,0,0,0,0,0
20200520,053674,臺股指元富96購01,,,,,0.00,0.00,0,0,0,0,0,0,0,0,0,0,0,0,0
20200520,053675,臺股指元富96購02,,,,,0.00,0.00,0,0,0,0,0,0,0,0,0,0,0,0,0
20200520,053676,新光金國泰98購02,,,,,0.00,0.00,0,0,0,0,0,0,0,0,0,0,0,0,0
20200520,053677,同欣電國泰97購01,,,,,0.00,0.00,0,0,0,0,0,0,0,0,0,0,0,0,0
20200520,053678,南亞科富邦97購01,,,,,0.00,0.00,0,0,0,0,0,0,0,0,0,0,0,0,0
20200520,053679,緯創富邦96購01,,,,,0.00,0.00,0,0,0,0,0,0,0,0,0,0,0,0,0
20200520,053680,臺股指富邦96購01,,,,,0.00,0.00,0,0,0,0,0,0,0,0,0,0,0,0,0
20200520,053681,臺股指富邦96購02,,,,,0.00,0.00,0,0,0,0,0,0,0,0,0,0,0,0,0
20200520,053682,臺股指富邦96購03,,,,,0.00,0.00,0,0,0,0,0,0,0,0,0,0,0,0,0
20200520,053683,上証2X元大96購03,,,,,0.00,0.00,0,0,0,0,0,0,0,0,0,0,0,0,0
20200520,053684,台積電元大96購17,,,,,0.00,0.00,0,0,0,0,0,0,0,0,0,0,0,0,0
20200520,053685,台積電元大96購18,,,,,0.00,0.00,0,0,0,0,0,0,0,0,0,0,0,0,0
20200520,053686,台積電元大97購08,0.08,0.08,0.08,0.08,0.00,0.00,70000,3,5600,0,0,0,0,0,0,0,0,0,0
20200520,053687,智邦元大96購02,,,,,0.00,0.00,0,0,0,0,0,0,0,0,0,0,0,0,0
20200520,053688,燿華元大96購05,,,,,0.00,0.00,0,0,0,0,0,0,0,0,0,0,0,0,0
20200520,053689,台光電元大96購01,,,,,0.00,0.00,0,0,0,0,0,0,0,0,0,0,0,0,0
20200520,053690,南亞科元大96購02,,,,,0.00,0.00,0,0,0,0,0,0,0,0,0,0,0,0,0
20200520,053691,聯發科元大96購16,0.63,0.63,0.61,0.61,+0.15,32.61,105000,2,64150,0,0,0,0,0,0,5000,0,5000,5000
20200520,053692,聯詠元大96購04,,,,,0.00,0.00,0,0,0,0,0,0,0,0,0,0,0,0,0
20200520,053693,欣興元大96購05,,,,,0.00,0.00,0,0,0,0,0,0,0,0,0,0,0,0,0
20200520,053694,創意元大96購03,0.67,0.67,0.67,0.67,-0.06,-8.22,100000,1,67000,0,0,0,0,0,0,0,100000,-100000,-100000
20200520,053695,智易元大97購02,,,,,0.00,0.00,0,0,0,0,0,0,0,0,0,0,0,0,0
20200520,053696,日月光元大96購05,,,,,0.00,0.00,0,0,0,0,0,0,0,0,0,0,0,0,0
20200520,053697,臻鼎元大96購02,,,,,0.00,0.00,0,0,0,0,0,0,0,0,0,0,0,0,0
20200520,053698,中磊元大96購02,,,,,0.00,0.00,0,0,0,0,0,0,0,0,0,0,0,0,0
20200520,053699,臺股指元大96購22,,,,,0.00,0.00,0,0,0,0,0,0,0,0,0,0,0,0,0
20200520,053700,臺股指元大96購23,,,,,0.00,0.00,0,0,0,0,0,0,0,0,0,0,0,0,0
20200520,053701,台積電兆豐96購05,,,,,0.00,0.00,0,0,0,0,0,0,0,0,0,0,0,0,0
20200520,053702,智易兆豐97購02,,,,,0.00,0.00,0,0,0,0,0,0,0,0,0,0,0,0,0
20200520,053703,緯穎兆豐96購01,,,,,0.00,0.00,0,0,0,0,0,0,0,0,0,0,0,0,0
20200520,053704,國巨群益96購06,0.50,0.50,0.47,0.47,+0.21,80.77,9000,2,4350,0,0,0,0,0,0,0,9000,-9000,-9000
20200520,053705,滬深2X凱基99購01,0.35,0.35,0.35,0.35,-0.01,-2.78,200000,1,70000,0,0,0,0,0,0,200000,200000,0,0
20200520,053706,S&P反1凱基99購01,,,,,0.00,0.00,0,0,0,0,0,0,0,0,0,0,0,0,0
20200520,053707,A50正2凱基99購02,,,,,0.00,0.00,0,0,0,0,0,0,0,0,0,0,0,0,0
20200520,053708,道瓊反凱基98購01,,,,,0.00,0.00,0,0,0,0,0,0,0,0,0,0,0,0,0
20200520,053709,台達電凱基96購04,,,,,0.00,0.00,0,0,0,0,0,0,0,0,0,0,0,0,0
20200520,053710,華通凱基96購05,,,,,0.00,0.00,0,0,0,0,0,0,0,0,0,0,0,0,0
20200520,053711,鴻海凱基96購14,,,,,0.00,0.00,0,0,0,0,0,0,0,0,0,0,0,0,0
20200520,053712,台光電凱基96購04,,,,,0.00,0.00,0,0,0,0,0,0,0,0,0,0,0,0,0
20200520,053713,漢唐凱基96購04,,,,,0.00,0.00,0,0,0,0,0,0,0,0,0,0,0,0,0
20200520,053714,南亞科凱基96購03,,,,,0.00,0.00,0,0,0,0,0,0,0,0,0,0,0,0,0
20200520,053715,美律凱基96購04,,,,,0.00,0.00,0,0,0,0,0,0,0,0,0,0,0,0,0
20200520,053716,京元電凱基97購01,,,,,0.00,0.00,0,0,0,0,0,0,0,0,0,0,0,0,0
20200520,053717,聯發科凱基96購17,0.02,0.05,0.02,0.05,+0.03,150.0,418000,12,10240,0,0,0,0,0,0,94000,0,94000,94000
20200520,053718,全新凱基97購02,,,,,0.00,0.00,0,0,0,0,0,0,0,0,0,0,0,0,0
20200520,053719,可成凱基96購08,0.50,0.50,0.50,0.50,-0.20,-28.57,1000,1,500,0,0,0,0,0,0,0,1000,-1000,-1000
20200520,053720,宏達電凱基97購01,,,,,0.00,0.00,0,0,0,0,0,0,0,0,0,0,0,0,0
20200520,053721,國泰金凱基97購01,0.85,0.85,0.85,0.85,+0.01,1.19,80000,2,68000,0,0,0,0,0,0,50000,30000,20000,20000
20200520,053722,新光金凱基9C購01,0.66,0.66,0.66,0.66,0.00,0.00,5000,1,3300,0,0,0,0,0,0,0,0,0,0
20200520,053723,奇鋐凱基98購01,0.27,0.27,0.27,0.27,+0.01,3.85,100000,1,27000,0,0,0,0,0,0,100000,0,100000,100000
20200520,053724,聯詠凱基96購04,,,,,0.00,0.00,0,0,0,0,0,0,0,0,0,0,0,0,0
20200520,053725,晶相光凱基96購01,,,,,0.00,0.00,0,0,0,0,0,0,0,0,0,0,0,0,0
20200520,053726,TPK凱基96購02,,,,,0.00,0.00,0,0,0,0,0,0,0,0,0,0,0,0,0
20200520,053727,麗豐凱基97購01,,,,,0.00,0.00,0,0,0,0,0,0,0,0,0,0,0,0,0
20200520,053728,茂林凱基97購01,2.54,3.10,2.54,3.10,0.00,0.00,298000,29,861300,0,0,0,0,0,0,0,298000,-298000,-298000
20200520,053729,聯茂凱基96購05,0.72,0.72,0.70,0.70,-0.03,-4.11,86000,7,60400,0,0,0,0,0,0,48000,38000,10000,10000
20200520,053730,樺漢凱基98購01,,,,,0.00,0.00,0,0,0,0,0,0,0,0,0,0,0,0,0
20200520,053731,矽創凱基96購03,,,,,0.00,0.00,0,0,0,0,0,0,0,0,0,0,0,0,0
20200520,053732,S&P反1中信9C購01,,,,,0.00,0.00,0,0,0,0,0,0,0,0,0,0,0,0,0
20200520,053733,華邦電中信98購01,,,,,0.00,0.00,0,0,0,0,0,0,0,0,0,0,0,0,0
20200520,053734,友達中信98購02,,,,,0.00,0.00,0,0,0,0,0,0,0,0,0,0,0,0,0
20200520,053735,矽力中信97購01,,,,,0.00,0.00,0,0,0,0,0,0,0,0,0,0,0,0,0
20200520,053736,友達麥證96購01,,,,,0.00,0.00,0,0,0,0,0,0,0,0,0,0,0,0,0
20200520,053737,華新科麥證96購01,,,,,0.00,0.00,0,0,0,0,0,0,0,0,0,0,0,0,0
20200520,053738,群創麥證96購01,0.01,0.01,0.01,0.01,0.00,0.00,10000,1,100,10000,0,10000,0,0,0,10000,0,10000,10000
20200520,053739,A50正2國票9A購01,,,,,0.00,0.00,0,0,0,0,0,0,0,0,0,0,0,0,0
20200520,053740,元油反國票99購01,,,,,0.00,0.00,0,0,0,0,0,0,0,0,0,0,0,0,0
20200520,053741,漢唐國票97購03,,,,,0.00,0.00,0,0,0,0,0,0,0,0,0,0,0,0,0
20200520,053742,創意國票97購01,,,,,0.00,0.00,0,0,0,0,0,0,0,0,0,0,0,0,0
20200520,053743,康控國票97購02,,,,,0.00,0.00,0,0,0,0,0,0,0,0,0,0,0,0,0
20200520,053744,台郡國票97購03,0.38,0.39,0.38,0.39,0.00,0.00,22000,3,8460,0,0,0,0,0,0,2000,20000,-18000,-18000
20200520,053745,康友國票97購01,,,,,0.00,0.00,0,0,0,0,0,0,0,0,0,0,0,0,0
20200520,053746,彰銀康和96購01,,,,,0.00,0.00,0,0,0,0,0,0,0,0,0,0,0,0,0
20200520,053747,滬深2X永豐96購05,,,,,0.00,0.00,0,0,0,0,0,0,0,0,0,0,0,0,0
20200520,053748,燿華永豐96購04,,,,,0.00,0.00,0,0,0,0,0,0,0,0,0,0,0,0,0
20200520,053749,揚明光永豐97購01,,,,,0.00,0.00,0,0,0,0,0,0,0,0,0,0,0,0,0
20200520,05374P,台積電國票96售07,,,,,0.00,0.00,0,0,0,0,0,0,0,0,0,0,0,0,0
20200520,053750,致伸永豐96購02,,,,,0.00,0.00,0,0,0,0,0,0,0,0,0,0,0,0,0
20200520,053751,康控永豐96購02,,,,,0.00,0.00,0,0,0,0,0,0,0,0,0,0,0,0,0
20200520,053752,超眾永豐96購02,0.11,0.11,0.09,0.09,-0.02,-18.18,55000,2,5850,0,0,0,0,0,0,55000,0,55000,55000
20200520,053753,啟碁永豐96購01,,,,,0.00,0.00,0,0,0,0,0,0,0,0,0,0,0,0,0
20200520,053754,英業達元富96購02,0.36,0.39,0.36,0.37,+0.01,2.78,143000,6,55110,0,0,0,0,0,0,22000,121000,-99000,-99000
20200520,053755,亞光元富96購01,0.04,0.04,0.04,0.04,0.00,0.00,2000,1,80,0,0,0,0,0,0,2000,0,2000,2000
20200520,053756,亞光元富96購02,,,,,0.00,0.00,0,0,0,0,0,0,0,0,0,0,0,0,0
20200520,053757,聯發科國泰96購04,,,,,0.00,0.00,0,0,0,0,0,0,0,0,0,0,0,0,0
20200520,053758,華新科國泰97購02,2.15,2.18,2.04,2.14,+0.20,10.31,40000,10,85330,0,0,0,0,0,0,40000,20000,20000,20000
20200520,053759,晶相光國泰98購01,,,,,0.00,0.00,0,0,0,0,0,0,0,0,0,0,0,0,0
20200520,05375P,健策國票96售02,0.18,0.18,0.18,0.18,-0.03,-14.29,150000,1,27000,0,0,0,0,0,0,0,150000,-150000,-150000
20200520,053760,牧德國泰98購01,1.26,1.48,1.26,1.48,0.00,0.00,23000,8,30550,0,0,0,0,0,0,18000,0,18000,18000
20200520,053761,健策國泰98購01,0.43,0.43,0.43,0.43,+0.02,4.88,358000,2,153940,0,0,0,0,0,0,358000,328000,30000,30000
20200520,053762,T50反1富邦97購01,1.46,1.46,1.46,1.46,-0.02,-1.35,32000,5,46720,0,0,0,0,0,0,0,32000,-32000,-32000
20200520,053763,T50反1富邦98購01,,,,,0.00,0.00,0,0,0,0,0,0,0,0,0,0,0,0,0
20200520,053764,A50正2富邦99購01,,,,,0.00,0.00,0,0,0,0,0,0,0,0,0,0,0,0,0
20200520,053765,智邦富邦96購01,,,,,0.00,0.00,0,0,0,0,0,0,0,0,0,0,0,0,0
20200520,053766,友達富邦97購01,0.03,0.04,0.03,0.04,0.00,0.00,113000,5,4280,0,0,0,0,0,0,0,0,0,0
20200520,053767,臻鼎富邦97購02,,,,,0.00,0.00,0,0,0,0,0,0,0,0,0,0,0,0,0
20200520,053768,S&P反1元大99購01,1.10,1.10,1.10,1.10,+0.02,1.85,25000,1,27500,0,0,0,0,0,0,25000,0,25000,25000
20200520,053769,香港反元大99購01,,,,,0.00,0.00,0,0,0,0,0,0,0,0,0,0,0,0,0
20200520,053770,元金2X元大98購01,3.54,3.54,3.54,3.54,0.00,0.00,8000,2,28320,0,0,0,0,0,0,8000,0,8000,8000
20200520,053771,華新元大97購01,,,,,0.00,0.00,0,0,0,0,0,0,0,0,0,0,0,0,0
20200520,053772,大成鋼元大96購02,,,,,0.00,0.00,0,0,0,0,0,0,0,0,0,0,0,0,0
20200520,053773,上銀元大96購04,,,,,0.00,0.00,0,0,0,0,0,0,0,0,0,0,0,0,0
20200520,053774,台達電元大96購04,,,,,0.00,0.00,0,0,0,0,0,0,0,0,0,0,0,0,0
20200520,053775,鴻海元大96購21,,,,,0.00,0.00,0,0,0,0,0,0,0,0,0,0,0,0,0
20200520,053776,台積電元大96購19,,,,,0.00,0.00,0,0,0,0,0,0,0,0,0,0,0,0,0
20200520,053777,台積電元大96購20,,,,,0.00,0.00,0,0,0,0,0,0,0,0,0,0,0,0,0
20200520,053778,旺宏元大97購03,,,,,0.00,0.00,0,0,0,0,0,0,0,0,0,0,0,0,0
20200520,053779,台光電元大96購02,,,,,0.00,0.00,0,0,0,0,0,0,0,0,0,0,0,0,0
20200520,053780,南亞科元大96購03,0.30,0.30,0.30,0.30,+0.03,11.11,50000,1,15000,0,0,0,0,0,0,50000,0,50000,50000
20200520,053781,友達元大9B購03,,,,,0.00,0.00,0,0,0,0,0,0,0,0,0,0,0,0,0
20200520,053782,京元電元大98購02,0.33,0.33,0.32,0.32,-0.06,-15.79,210000,2,67300,0,0,0,0,0,0,0,210000,-210000,-210000
20200520,053783,聯發科元大96購17,3.40,3.40,3.40,3.40,0.00,0.00,50000,1,170000,0,0,0,0,0,0,0,50000,-50000,-50000
20200520,053784,奇力新元大97購02,1.28,1.35,1.25,1.25,0.00,0.00,133000,5,169690,0,0,0,0,0,0,30000,103000,-73000,-73000
20200520,053785,聯詠元大96購05,,,,,0.00,0.00,0,0,0,0,0,0,0,0,0,0,0,0,0
20200520,053786,新日興元大96購02,,,,,0.00,0.00,0,0,0,0,0,0,0,0,0,0,0,0,0
20200520,053787,健策元大97購02,,,,,0.00,0.00,0,0,0,0,0,0,0,0,0,0,0,0,0
20200520,053788,泰鼎元大97購01,,,,,0.00,0.00,0,0,0,0,0,0,0,0,0,0,0,0,0
20200520,053789,彩晶元大9C購02,,,,,0.00,0.00,0,0,0,0,0,0,0,0,0,0,0,0,0
20200520,05378P,台積電凱基96售02,,,,,0.00,0.00,0,0,0,0,0,0,0,0,0,0,0,0,0
20200520,053790,嘉聯益元大99購02,,,,,0.00,0.00,0,0,0,0,0,0,0,0,0,0,0,0,0
20200520,053791,同欣電元大96購05,,,,,0.00,0.00,0,0,0,0,0,0,0,0,0,0,0,0,0
20200520,053792,百和元大96購01,,,,,0.00,0.00,0,0,0,0,0,0,0,0,0,0,0,0,0
20200520,053793,致伸兆豐96購01,,,,,0.00,0.00,0,0,0,0,0,0,0,0,0,0,0,0,0
20200520,053794,燿華亞東96購01,,,,,0.00,0.00,0,0,0,0,0,0,0,0,0,0,0,0,0
20200520,053795,群創亞東96購01,,,,,0.00,0.00,0,0,0,0,0,0,0,0,0,0,0,0,0
20200520,053796,華通中信96購02,,,,,0.00,0.00,0,0,0,0,0,0,0,0,0,0,0,0,0
20200520,053797,台積電中信98購01,,,,,0.00,0.00,0,0,0,0,0,0,0,0,0,0,0,0,0
20200520,053798,台積電中信98購02,,,,,0.00,0.00,0,0,0,0,0,0,0,0,0,0,0,0,0
20200520,053799,矽創中信9A購01,0.20,0.20,0.17,0.19,-0.01,-5.0,86000,6,16640,0,0,0,0,0,0,30000,26000,4000,4000
20200520,053800,華通凱基97購03,0.66,0.67,0.66,0.67,-0.10,-12.99,160000,2,106400,0,0,0,0,0,0,160000,0,160000,160000
20200520,053801,台積電凱基96購18,,,,,0.00,0.00,0,0,0,0,0,0,0,0,0,0,0,0,0
20200520,053802,南亞科凱基96購04,,,,,0.00,0.00,0,0,0,0,0,0,0,0,0,0,0,0,0
20200520,053803,聯發科凱基96購18,,,,,0.00,0.00,0,0,0,0,0,0,0,0,0,0,0,0,0
20200520,053804,富邦金凱基96購01,0.77,0.77,0.77,0.77,0.00,0.00,20000,1,15400,0,0,0,0,0,0,0,20000,-20000,-20000
20200520,053805,奇鋐凱基98購02,,,,,0.00,0.00,0,0,0,0,0,0,0,0,0,0,0,0,0
20200520,053806,鎧勝凱基96購02,,,,,0.00,0.00,0,0,0,0,0,0,0,0,0,0,0,0,0
20200520,053807,T50反1群益96購02,,,,,0.00,0.00,0,0,0,0,0,0,0,0,0,0,0,0,0
20200520,053808,大成鋼群益97購01,,,,,0.00,0.00,0,0,0,0,0,0,0,0,0,0,0,0,0
20200520,053809,上銀群益96購02,,,,,0.00,0.00,0,0,0,0,0,0,0,0,0,0,0,0,0
20200520,053810,台達電群益96購01,0.39,0.39,0.39,0.39,0.00,0.00,98000,1,38220,0,0,0,0,0,0,98000,0,98000,98000
20200520,053811,國巨群益98購02,,,,,0.00,0.00,0,0,0,0,0,0,0,0,0,0,0,0,0
20200520,053812,台積電群益96購09,,,,,0.00,0.00,0,0,0,0,0,0,0,0,0,0,0,0,0
20200520,053813,友達群益9A購03,0.20,0.20,0.20,0.20,0.00,0.00,8000,1,1600,0,0,0,0,0,0,0,0,0,0
20200520,053814,美律群益97購02,,,,,0.00,0.00,0,0,0,0,0,0,0,0,0,0,0,0,0
20200520,053815,聯發科群益96購01,,,,,0.00,0.00,0,0,0,0,0,0,0,0,0,0,0,0,0
20200520,053816,聯發科群益96購02,0.01,0.01,0.01,0.01,0.00,0.00,428000,5,4280,0,0,0,0,0,0,428000,0,428000,428000
20200520,053817,華新科群益97購02,,,,,0.00,0.00,0,0,0,0,0,0,0,0,0,0,0,0,0
20200520,053818,富邦金群益98購01,,,,,0.00,0.00,0,0,0,0,0,0,0,0,0,0,0,0,0
20200520,053819,大立光群益96購04,,,,,0.00,0.00,0,0,0,0,0,0,0,0,0,0,0,0,0
20200520,053820,大立光群益96購05,,,,,0.00,0.00,0,0,0,0,0,0,0,0,0,0,0,0,0
20200520,053821,群創群益98購08,,,,,0.00,0.00,0,0,0,0,0,0,0,0,0,0,0,0,0
20200520,053822,正文群益97購01,,,,,0.00,0.00,0,0,0,0,0,0,0,0,0,0,0,0,0
20200520,053823,茂林群益96購06,,,,,0.00,0.00,0,0,0,0,0,0,0,0,0,0,0,0,0
20200520,053824,樺漢群益96購02,,,,,0.00,0.00,0,0,0,0,0,0,0,0,0,0,0,0,0
20200520,053825,南電群益96購02,,,,,0.00,0.00,0,0,0,0,0,0,0,0,0,0,0,0,0
20200520,053826,光磊麥證97購01,,,,,0.00,0.00,0,0,0,0,0,0,0,0,0,0,0,0,0
20200520,053827,漢唐麥證9A購01,0.82,0.82,0.82,0.82,+0.02,2.5,100000,2,82000,0,100000,-100000,0,0,0,0,100000,-100000,-100000
20200520,053828,貿聯麥證96購01,,,,,0.00,0.00,0,0,0,0,0,0,0,0,0,0,0,0,0
20200520,053829,力成麥證96購01,,,,,0.00,0.00,0,0,0,0,0,0,0,0,0,0,0,0,0
20200520,053830,台積電台新96購02,,,,,0.00,0.00,0,0,0,0,0,0,0,0,0,0,0,0,0
20200520,053831,台積電台新97購02,,,,,0.00,0.00,0,0,0,0,0,0,0,0,0,0,0,0,0
20200520,053832,聯發科台新96購01,,,,,0.00,0.00,0,0,0,0,0,0,0,0,0,0,0,0,0
20200520,053833,彩晶台新97購02,,,,,0.00,0.00,0,0,0,0,0,0,0,0,0,0,0,0,0
20200520,053834,卜蜂永豐96購01,0.77,0.77,0.77,0.77,0.00,0.00,4000,1,3080,0,0,0,0,0,0,0,4000,-4000,-4000
20200520,053835,南亞科永豐96購02,,,,,0.00,0.00,0,0,0,0,0,0,0,0,0,0,0,0,0
20200520,053836,亞光永豐96購02,,,,,0.00,0.00,0,0,0,0,0,0,0,0,0,0,0,0,0
20200520,053837,貿聯永豐96購02,,,,,0.00,0.00,0,0,0,0,0,0,0,0,0,0,0,0,0
20200520,053838,正文永豐96購02,,,,,0.00,0.00,0,0,0,0,0,0,0,0,0,0,0,0,0
20200520,053839,華通統一96購01,,,,,0.00,0.00,0,0,0,0,0,0,0,0,0,0,0,0,0
20200520,053840,燿華統一96購02,,,,,0.00,0.00,0,0,0,0,0,0,0,0,0,0,0,0,0
20200520,053841,美律統一96購01,,,,,0.00,0.00,0,0,0,0,0,0,0,0,0,0,0,0,0
20200520,053842,聯發科統一96購08,0.39,0.55,0.39,0.48,+0.16,50.0,700000,15,311000,0,0,0,0,0,0,700000,700000,0,0
20200520,053843,訊芯統一96購01,,,,,0.00,0.00,0,0,0,0,0,0,0,0,0,0,0,0,0
20200520,053844,GIS統一96購01,,,,,0.00,0.00,0,0,0,0,0,0,0,0,0,0,0,0,0
20200520,053845,和大元富96購01,,,,,0.00,0.00,0,0,0,0,0,0,0,0,0,0,0,0,0
20200520,053846,友達元富99購02,,,,,0.00,0.00,0,0,0,0,0,0,0,0,0,0,0,0,0
20200520,053847,美律元富96購02,,,,,0.00,0.00,0,0,0,0,0,0,0,0,0,0,0,0,0
20200520,053848,聯發科元富96購03,,,,,0.00,0.00,0,0,0,0,0,0,0,0,0,0,0,0,0
20200520,053849,聯發科元富96購04,1.25,1.38,1.22,1.22,+0.02,1.67,278000,21,349360,0,0,0,0,0,0,231000,14000,217000,217000
20200520,053850,嘉澤元富96購03,,,,,0.00,0.00,0,0,0,0,0,0,0,0,0,0,0,0,0
20200520,053851,鴻海國泰98購03,,,,,0.00,0.00,0,0,0,0,0,0,0,0,0,0,0,0,0
20200520,053852,南亞科國泰98購01,,,,,0.00,0.00,0,0,0,0,0,0,0,0,0,0,0,0,0
20200520,053853,康控國泰97購02,,,,,0.00,0.00,0,0,0,0,0,0,0,0,0,0,0,0,0
20200520,053854,聯茂國泰97購02,,,,,0.00,0.00,0,0,0,0,0,0,0,0,0,0,0,0,0
20200520,053855,康友國泰98購01,,,,,0.00,0.00,0,0,0,0,0,0,0,0,0,0,0,0,0
20200520,053856,台積電富邦98購01,0.03,0.03,0.03,0.03,-0.01,-25.0,1913000,34,57390,0,0,0,0,0,0,0,44000,-44000,-44000
20200520,053857,宏達電富邦97購02,0.03,0.06,0.03,0.06,0.00,0.00,34000,3,1050,0,0,0,0,0,0,0,0,0,0
20200520,053858,台達電元大96購05,,,,,0.00,0.00,0,0,0,0,0,0,0,0,0,0,0,0,0
20200520,053859,台積電元大97購09,,,,,0.00,0.00,0,0,0,0,0,0,0,0,0,0,0,0,0
20200520,053860,台積電元大98購03,0.38,0.38,0.38,0.38,+0.01,2.7,2000,1,760,0,0,0,0,0,0,0,0,0,0
20200520,053861,台光電元大98購01,,,,,0.00,0.00,0,0,0,0,0,0,0,0,0,0,0,0,0
20200520,053862,南亞科元大97購02,,,,,0.00,0.00,0,0,0,0,0,0,0,0,0,0,0,0,0
20200520,053863,聯發科元大96購18,0.09,0.09,0.08,0.09,-0.06,-40.0,256000,4,22030,0,0,0,0,0,0,251000,0,251000,251000
20200520,053864,義隆元大96購01,0.88,0.93,0.88,0.90,0.00,0.00,120000,3,106300,0,0,0,0,0,0,10000,110000,-100000,-100000
20200520,053865,欣興元大97購02,1.31,1.39,1.25,1.25,+0.29,30.21,121000,8,161820,0,0,0,0,0,0,50000,71000,-21000,-21000
20200520,053866,景碩元大97購02,,,,,0.00,0.00,0,0,0,0,0,0,0,0,0,0,0,0,0
20200520,053867,創意元大96購04,0.98,0.98,0.90,0.97,-0.02,-2.02,122000,3,116400,0,0,0,0,0,0,86000,36000,50000,50000
20200520,053868,群創元大99購02,,,,,0.00,0.00,0,0,0,0,0,0,0,0,0,0,0,0,0
20200520,053869,嘉澤元大96購02,,,,,0.00,0.00,0,0,0,0,0,0,0,0,0,0,0,0,0
20200520,053870,正文元大96購01,,,,,0.00,0.00,0,0,0,0,0,0,0,0,0,0,0,0,0
20200520,053871,臻鼎元大96購03,0.36,0.36,0.35,0.36,-0.03,-7.69,68000,7,24180,0,0,0,0,0,0,68000,0,68000,68000
20200520,053872,臻鼎元大96購04,,,,,0.00,0.00,0,0,0,0,0,0,0,0,0,0,0,0,0
20200520,053873,力成元大96購03,,,,,0.00,0.00,0,0,0,0,0,0,0,0,0,0,0,0,0
20200520,053874,台表科元大96購05,0.47,0.71,0.47,0.71,+0.31,77.5,43000,15,24500,0,0,0,0,0,0,41000,0,41000,41000
20200520,053875,GIS元大97購01,0.97,1.00,0.97,1.00,0.00,0.00,130000,4,127400,0,0,0,0,0,0,30000,130000,-100000,-100000
20200520,053876,可成永昌98購01,,,,,0.00,0.00,0,0,0,0,0,0,0,0,0,0,0,0,0
20200520,053877,奇力新亞東96購01,,,,,0.00,0.00,0,0,0,0,0,0,0,0,0,0,0,0,0
20200520,053878,台表科亞東96購01,,,,,0.00,0.00,0,0,0,0,0,0,0,0,0,0,0,0,0
20200520,053879,元油反中信98購02,,,,,0.00,0.00,0,0,0,0,0,0,0,0,0,0,0,0,0
20200520,053880,智邦中信96購01,,,,,0.00,0.00,0,0,0,0,0,0,0,0,0,0,0,0,0
20200520,053881,南亞科中信97購01,,,,,0.00,0.00,0,0,0,0,0,0,0,0,0,0,0,0,0
20200520,053882,聯發科中信98購02,0.13,0.20,0.13,0.15,+0.03,25.0,705000,18,104740,0,0,0,0,0,0,463000,0,463000,463000
20200520,053883,大立光中信98購02,0.03,0.03,0.03,0.03,+0.01,50.0,100000,2,3000,0,0,0,0,0,0,0,0,0,0
20200520,053884,緯穎第一96購01,1.80,1.80,1.80,1.80,-0.01,-0.55,5000,1,9000,0,0,0,0,0,0,5000,0,5000,5000
20200520,053885,全新兆豐96購01,,,,,0.00,0.00,0,0,0,0,0,0,0,0,0,0,0,0,0
20200520,053886,亞光兆豐96購01,,,,,0.00,0.00,0,0,0,0,0,0,0,0,0,0,0,0,0
20200520,053887,聯茂兆豐97購02,0.79,0.79,0.75,0.79,-0.02,-2.47,350000,21,273160,0,0,0,0,0,0,120000,230000,-110000,-110000
20200520,053888,和大群益97購01,0.12,0.14,0.12,0.14,+0.06,75.0,132000,3,15880,0,0,0,0,0,0,132000,0,132000,132000
20200520,053889,致茂群益97購01,0.85,0.85,0.85,0.85,-0.06,-6.59,96000,1,81600,0,0,0,0,0,0,0,96000,-96000,-96000
20200520,053890,華新科群益98購01,0.18,0.29,0.18,0.29,0.00,0.00,54000,3,11370,0,0,0,0,0,0,49000,15000,34000,34000
20200520,053891,欣興群益98購01,0.19,0.20,0.17,0.17,+0.02,13.33,17000,3,3220,0,0,0,0,0,0,17000,0,17000,17000
20200520,053892,景碩群益96購02,,,,,0.00,0.00,0,0,0,0,0,0,0,0,0,0,0,0,0
20200520,053893,京鼎群益97購02,,,,,0.00,0.00,0,0,0,0,0,0,0,0,0,0,0,0,0
20200520,053894,創意群益96購01,1.38,1.44,1.36,1.44,-0.02,-1.37,139000,4,192580,0,0,0,0,0,0,65000,74000,-9000,-9000
20200520,053895,智易群益96購02,,,,,0.00,0.00,0,0,0,0,0,0,0,0,0,0,0,0,0
20200520,053896,麗豐群益97購01,,,,,0.00,0.00,0,0,0,0,0,0,0,0,0,0,0,0,0
20200520,053897,台郡群益96購01,,,,,0.00,0.00,0,0,0,0,0,0,0,0,0,0,0,0,0
20200520,053898,康友群益97購01,,,,,0.00,0.00,0,0,0,0,0,0,0,0,0,0,0,0,0
20200520,053899,矽創群益96購02,,,,,0.00,0.00,0,0,0,0,0,0,0,0,0,0,0,0,0
20200520,053900,T50反1日盛99購01,0.55,0.55,0.50,0.50,-0.10,-16.67,31000,3,16550,0,0,0,0,0,0,0,31000,-31000,-31000
20200520,053901,T50反1凱基99購03,,,,,0.00,0.00,0,0,0,0,0,0,0,0,0,0,0,0,0
20200520,053902,S&P反1凱基97購01,,,,,0.00,0.00,0,0,0,0,0,0,0,0,0,0,0,0,0
20200520,053903,燿華凱基97購01,,,,,0.00,0.00,0,0,0,0,0,0,0,0,0,0,0,0,0
20200520,053904,漢唐凱基97購01,0.70,0.70,0.69,0.69,-0.02,-2.82,45000,2,31100,0,0,0,0,0,0,40000,5000,35000,35000
20200520,053905,華新科凱基96購10,0.83,0.83,0.83,0.83,-0.06,-6.74,67000,1,55610,0,0,0,0,0,0,67000,0,67000,67000
20200520,053906,宏達電凱基96購02,,,,,0.00,0.00,0,0,0,0,0,0,0,0,0,0,0,0,0
20200520,053907,揚明光凱基96購01,,,,,0.00,0.00,0,0,0,0,0,0,0,0,0,0,0,0,0
20200520,053908,貿聯凱基98購01,,,,,0.00,0.00,0,0,0,0,0,0,0,0,0,0,0,0,0
20200520,053909,致伸凱基97購01,,,,,0.00,0.00,0,0,0,0,0,0,0,0,0,0,0,0,0
20200520,05390P,康友群益95售04,,,,,0.00,0.00,0,0,0,0,0,0,0,0,0,0,0,0,0
20200520,053910,嘉聯益凱基98購01,,,,,0.00,0.00,0,0,0,0,0,0,0,0,0,0,0,0,0
20200520,053911,臺股指凱基96購31,,,,,0.00,0.00,0,0,0,0,0,0,0,0,0,0,0,0,0
20200520,053912,T50反1國票97購02,,,,,0.00,0.00,0,0,0,0,0,0,0,0,0,0,0,0,0
20200520,053913,華新國票97購01,0.47,0.48,0.47,0.48,0.00,0.00,258000,5,123200,0,0,0,0,0,0,0,258000,-258000,-258000
20200520,053914,國巨國票96購08,,,,,0.00,0.00,0,0,0,0,0,0,0,0,0,0,0,0,0
20200520,053915,光罩國票96購02,,,,,0.00,0.00,0,0,0,0,0,0,0,0,0,0,0,0,0
20200520,053916,漢唐國票97購04,2.00,2.00,2.00,2.00,0.00,0.00,15000,1,30000,0,0,0,0,0,0,0,15000,-15000,-15000
20200520,053917,友達國票97購03,0.05,0.05,0.05,0.05,0.00,0.00,200000,3,10000,0,0,0,0,0,0,0,0,0,0
20200520,053918,美律國票97購01,,,,,0.00,0.00,0,0,0,0,0,0,0,0,0,0,0,0,0
20200520,053919,可成國票97購02,0.85,0.85,0.82,0.83,-0.40,-32.52,33000,8,27350,0,0,0,0,0,0,1000,33000,-32000,-32000
20200520,05391P,鴻海統一95售12,,,,,0.00,0.00,0,0,0,0,0,0,0,0,0,0,0,0,0
20200520,053920,新光金國票98購01,,,,,0.00,0.00,0,0,0,0,0,0,0,0,0,0,0,0,0
20200520,053921,嘉晶國票97購03,1.78,2.46,1.78,2.46,+0.57,30.16,233000,16,491300,0,0,0,0,0,0,30000,203000,-173000,-173000
20200520,053922,亞光國票96購01,,,,,0.00,0.00,0,0,0,0,0,0,0,0,0,0,0,0,0
20200520,053923,亞光國票97購01,,,,,0.00,0.00,0,0,0,0,0,0,0,0,0,0,0,0,0
20200520,053924,京鼎國票97購01,0.52,0.52,0.52,0.52,-0.04,-7.14,38000,1,19760,0,0,0,0,0,0,38000,0,38000,38000
20200520,053925,群創國票98購01,,,,,0.00,0.00,0,0,0,0,0,0,0,0,0,0,0,0,0
20200520,053926,晶相光國票97購01,,,,,0.00,0.00,0,0,0,0,0,0,0,0,0,0,0,0,0
20200520,053927,牧德國票97購01,,,,,0.00,0.00,0,0,0,0,0,0,0,0,0,0,0,0,0
20200520,053928,智易國票97購03,,,,,0.00,0.00,0,0,0,0,0,0,0,0,0,0,0,0,0
20200520,053929,正文國票97購01,,,,,0.00,0.00,0,0,0,0,0,0,0,0,0,0,0,0,0
20200520,05392P,鴻海統一95售13,,,,,0.00,0.00,0,0,0,0,0,0,0,0,0,0,0,0,0
20200520,053930,S&P反1統一98購01,,,,,0.00,0.00,0,0,0,0,0,0,0,0,0,0,0,0,0
20200520,053931,楠梓電統一96購01,,,,,0.00,0.00,0,0,0,0,0,0,0,0,0,0,0,0,0
20200520,053932,華新科統一96購03,2.24,2.41,2.21,2.40,+0.16,7.14,443000,30,1040640,0,0,0,0,0,0,404000,39000,365000,365000
20200520,053933,大立光統一96購06,,,,,0.00,0.00,0,0,0,0,0,0,0,0,0,0,0,0,0
20200520,053934,A50正2元富96購02,,,,,0.00,0.00,0,0,0,0,0,0,0,0,0,0,0,0,0
20200520,053935,華通元富96購02,,,,,0.00,0.00,0,0,0,0,0,0,0,0,0,0,0,0,0
20200520,053936,旺宏元富96購04,0.01,0.01,0.01,0.01,0.00,0.00,160000,1,1600,0,0,0,0,0,0,160000,0,160000,160000
20200520,053937,光磊元富96購01,,,,,0.00,0.00,0,0,0,0,0,0,0,0,0,0,0,0,0
20200520,053938,彩晶元富96購01,,,,,0.00,0.00,0,0,0,0,0,0,0,0,0,0,0,0,0
20200520,053939,台表科元富96購03,0.30,0.30,0.28,0.28,0.00,0.00,285000,17,82300,0,0,0,0,0,0,285000,0,285000,285000
20200520,05393P,鴻海統一95售14,,,,,0.00,0.00,0,0,0,0,0,0,0,0,0,0,0,0,0
20200520,053940,康友元富96購01,,,,,0.00,0.00,0,0,0,0,0,0,0,0,0,0,0,0,0
20200520,053941,國巨國泰96購05,,,,,0.00,0.00,0,0,0,0,0,0,0,0,0,0,0,0,0
20200520,053942,超眾國泰96購02,,,,,0.00,0.00,0,0,0,0,0,0,0,0,0,0,0,0,0
20200520,053943,元油反富邦97購03,,,,,0.00,0.00,0,0,0,0,0,0,0,0,0,0,0,0,0
20200520,053944,亞泥富邦97購01,,,,,0.00,0.00,0,0,0,0,0,0,0,0,0,0,0,0,0
20200520,053945,國巨富邦98購02,0.30,0.40,0.30,0.36,+0.07,24.14,61000,7,21760,0,0,0,0,0,0,50000,41000,9000,9000
20200520,053946,全新富邦97購02,,,,,0.00,0.00,0,0,0,0,0,0,0,0,0,0,0,0,0
20200520,053947,義隆富邦97購01,0.86,0.91,0.84,0.88,0.00,0.00,81000,14,69970,0,0,0,0,0,0,61000,20000,41000,41000
20200520,053948,大立光富邦99購04,0.09,0.09,0.09,0.09,0.00,0.00,40000,1,3600,0,0,0,0,0,0,0,0,0,0
20200520,053949,康控富邦9A購01,,,,,0.00,0.00,0,0,0,0,0,0,0,0,0,0,0,0,0
20200520,05394P,聯詠中信95售02,,,,,0.00,0.00,0,0,0,0,0,0,0,0,0,0,0,0,0
20200520,053950,緯穎富邦97購02,3.28,3.42,3.28,3.42,+0.10,3.01,7000,2,23520,0,0,0,0,0,0,3000,4000,-1000,-1000
20200520,053951,T50反1台新06購02,,,,,0.00,0.00,0,0,0,0,0,0,0,0,0,0,0,0,0
20200520,053952,南亞科台新96購01,,,,,0.00,0.00,0,0,0,0,0,0,0,0,0,0,0,0,0
20200520,053953,群創台新97購01,,,,,0.00,0.00,0,0,0,0,0,0,0,0,0,0,0,0,0
20200520,053954,貿聯康和96購01,,,,,0.00,0.00,0,0,0,0,0,0,0,0,0,0,0,0,0
20200520,053955,華通永豐96購04,0.46,0.46,0.46,0.46,0.00,0.00,4000,1,1840,0,0,0,0,0,0,0,4000,-4000,-4000
20200520,053956,旺宏永豐96購04,,,,,0.00,0.00,0,0,0,0,0,0,0,0,0,0,0,0,0
20200520,053957,瑞昱永豐96購01,0.24,0.24,0.23,0.23,-0.09,-28.12,155000,16,36700,0,0,0,0,0,0,105000,50000,55000,55000
20200520,053958,京元電永豐96購01,0.08,0.08,0.08,0.08,-0.02,-20.0,58000,1,4640,0,0,0,0,0,0,0,58000,-58000,-58000
20200520,053959,晶豪科永豐96購02,0.23,0.23,0.17,0.17,-0.06,-26.09,105000,5,20750,0,0,0,0,0,0,40000,65000,-25000,-25000
20200520,05395P,旺宏元大96售06,0.40,0.40,0.40,0.40,-0.03,-6.98,13000,2,5200,0,0,0,0,0,0,10000,3000,7000,7000
20200520,053960,晶技永豐96購02,,,,,0.00,0.00,0,0,0,0,0,0,0,0,0,0,0,0,0
20200520,053961,揚明光永豐96購04,,,,,0.00,0.00,0,0,0,0,0,0,0,0,0,0,0,0,0
20200520,053962,聯茂永豐96購01,,,,,0.00,0.00,0,0,0,0,0,0,0,0,0,0,0,0,0
20200520,053963,百和永豐96購01,,,,,0.00,0.00,0,0,0,0,0,0,0,0,0,0,0,0,0
20200520,053964,上銀元大96購05,,,,,0.00,0.00,0,0,0,0,0,0,0,0,0,0,0,0,0
20200520,053965,聯電元大98購04,,,,,0.00,0.00,0,0,0,0,0,0,0,0,0,0,0,0,0
20200520,053966,旺宏元大96購08,,,,,0.00,0.00,0,0,0,0,0,0,0,0,0,0,0,0,0
20200520,053967,華邦電元大96購03,,,,,0.00,0.00,0,0,0,0,0,0,0,0,0,0,0,0,0
20200520,053968,華邦電元大97購01,,,,,0.00,0.00,0,0,0,0,0,0,0,0,0,0,0,0,0
20200520,053969,瑞昱元大97購01,0.76,0.81,0.76,0.81,+0.05,6.58,6000,2,4610,0,0,0,0,0,0,6000,5000,1000,1000
20200520,05396P,台郡元大95售05,,,,,0.00,0.00,0,0,0,0,0,0,0,0,0,0,0,0,0
20200520,053970,聯發科元大97購08,3.82,4.03,3.82,4.03,+0.50,14.16,12000,2,47730,0,0,0,0,0,0,0,12000,-12000,-12000
20200520,053971,聯發科元大97購09,0.57,0.78,0.57,0.66,+0.16,32.0,36000,5,23460,0,0,0,0,0,0,30000,0,30000,30000
20200520,053972,華新科元大96購06,,,,,0.00,0.00,0,0,0,0,0,0,0,0,0,0,0,0,0
20200520,053973,晶豪科元大96購01,1.94,1.94,1.94,1.94,-0.19,-8.92,400000,2,776000,0,0,0,0,0,0,400000,0,400000,400000
20200520,053974,大立光元大96購10,,,,,0.00,0.00,0,0,0,0,0,0,0,0,0,0,0,0,0
20200520,053975,大立光元大98購04,,,,,0.00,0.00,0,0,0,0,0,0,0,0,0,0,0,0,0
20200520,053976,亞光元大96購02,,,,,0.00,0.00,0,0,0,0,0,0,0,0,0,0,0,0,0
20200520,053977,新日興元大96購03,1.23,1.23,1.23,1.23,0.00,0.00,10000,1,12300,0,0,0,0,0,0,0,10000,-10000,-10000
20200520,053978,創意元大96購05,,,,,0.00,0.00,0,0,0,0,0,0,0,0,0,0,0,0,0
20200520,053979,健策元大98購01,2.20,2.20,2.20,2.20,0.00,0.00,1000,1,2200,0,0,0,0,0,0,0,1000,-1000,-1000
20200520,05397P,大立光凱基96售08,,,,,0.00,0.00,0,0,0,0,0,0,0,0,0,0,0,0,0
20200520,053980,泰鼎元大97購02,4.18,4.39,4.18,4.39,0.00,0.00,30000,3,128100,0,0,0,0,0,0,0,30000,-30000,-30000
20200520,053981,康控元大96購05,,,,,0.00,0.00,0,0,0,0,0,0,0,0,0,0,0,0,0
20200520,053982,臻鼎元大96購05,,,,,0.00,0.00,0,0,0,0,0,0,0,0,0,0,0,0,0
20200520,053983,樺漢元大97購02,,,,,0.00,0.00,0,0,0,0,0,0,0,0,0,0,0,0,0
20200520,053984,康友元大96購05,,,,,0.00,0.00,0,0,0,0,0,0,0,0,0,0,0,0,0
20200520,053985,矽創元大96購02,,,,,0.00,0.00,0,0,0,0,0,0,0,0,0,0,0,0,0
20200520,053986,矽創第一96購01,,,,,0.00,0.00,0,0,0,0,0,0,0,0,0,0,0,0,0
20200520,053987,宏碁亞東96購01,,,,,0.00,0.00,0,0,0,0,0,0,0,0,0,0,0,0,0
20200520,053988,友達亞東96購01,,,,,0.00,0.00,0,0,0,0,0,0,0,0,0,0,0,0,0
20200520,053989,奇力新兆豐97購01,,,,,0.00,0.00,0,0,0,0,0,0,0,0,0,0,0,0,0
20200520,05398P,康控國票96售03,,,,,0.00,0.00,0,0,0,0,0,0,0,0,0,0,0,0,0
20200520,053990,晶技兆豐96購01,,,,,0.00,0.00,0,0,0,0,0,0,0,0,0,0,0,0,0
20200520,053991,鴻海群益96購05,,,,,0.00,0.00,0,0,0,0,0,0,0,0,0,0,0,0,0
20200520,053992,中環群益96購01,,,,,0.00,0.00,0,0,0,0,0,0,0,0,0,0,0,0,0
20200520,053993,旺宏群益98購02,,,,,0.00,0.00,0,0,0,0,0,0,0,0,0,0,0,0,0
20200520,053994,微星群益96購01,1.84,1.84,1.57,1.57,+0.01,0.64,155000,9,267670,0,0,0,0,0,0,110000,44000,66000,66000
20200520,053995,奇力新群益97購02,,,,,0.00,0.00,0,0,0,0,0,0,0,0,0,0,0,0,0
20200520,053996,晶相光群益97購01,0.44,0.44,0.44,0.44,0.00,0.00,28000,1,12320,0,0,0,0,0,0,28000,0,28000,28000
20200520,053997,健策群益97購02,1.09,1.22,1.09,1.22,-0.10,-7.58,4000,3,4550,0,0,0,0,0,0,1000,4000,-3000,-3000
20200520,053998,泰鼎群益98購01,5.55,6.40,5.30,6.40,+0.55,9.4,195000,29,1108850,0,0,0,0,0,0,124000,70000,54000,54000
20200520,053999,台表科群益96購06,0.60,1.03,0.60,1.03,+0.41,66.13,160000,5,139000,0,0,0,0,0,0,60000,100000,-40000,-40000
20200520,05399P,GIS國票95售03,,,,,0.00,0.00,0,0,0,0,0,0,0,0,0,0,0,0,0
20200520,054000,訊芯群益96購02,0.03,0.03,0.03,0.03,0.00,0.00,3000,1,90,0,0,0,0,0,0,3000,0,3000,3000
20200520,054001,康友群益96購02,,,,,0.00,0.00,0,0,0,0,0,0,0,0,0,0,0,0,0
20200520,054002,GIS群益96購03,,,,,0.00,0.00,0,0,0,0,0,0,0,0,0,0,0,0,0
20200520,054003,鴻海統一96購13,0.50,0.50,0.50,0.50,-0.03,-5.66,10000,1,5000,0,0,0,0,0,0,10000,0,10000,10000
20200520,054004,鴻海統一96購14,,,,,0.00,0.00,0,0,0,0,0,0,0,0,0,0,0,0,0
20200520,054005,旺宏統一97購04,,,,,0.00,0.00,0,0,0,0,0,0,0,0,0,0,0,0,0
20200520,054006,智易統一97購01,,,,,0.00,0.00,0,0,0,0,0,0,0,0,0,0,0,0,0
20200520,054007,貿聯統一96購01,,,,,0.00,0.00,0,0,0,0,0,0,0,0,0,0,0,0,0
20200520,054008,大立光元富96購06,,,,,0.00,0.00,0,0,0,0,0,0,0,0,0,0,0,0,0
20200520,054009,欣興元富96購03,0.01,0.01,0.01,0.01,0.00,0.00,200000,1,2000,0,0,0,0,0,0,200000,0,200000,200000
20200520,05400P,台積電永豐95售05,,,,,0.00,0.00,0,0,0,0,0,0,0,0,0,0,0,0,0
20200520,054010,致伸元富96購01,,,,,0.00,0.00,0,0,0,0,0,0,0,0,0,0,0,0,0
20200520,054011,旺宏永豐96購05,,,,,0.00,0.00,0,0,0,0,0,0,0,0,0,0,0,0,0
20200520,054012,廣達永豐96購01,,,,,0.00,0.00,0,0,0,0,0,0,0,0,0,0,0,0,0
20200520,054013,聯發科永豐96購02,0.02,0.02,0.02,0.02,0.00,0.00,284000,2,5680,0,0,0,0,0,0,284000,0,284000,284000
20200520,054014,宏達電永豐96購04,,,,,0.00,0.00,0,0,0,0,0,0,0,0,0,0,0,0,0
20200520,054015,晶豪科永豐96購03,0.12,0.12,0.10,0.10,-0.05,-33.33,191000,3,21500,0,0,0,0,0,0,71000,120000,-49000,-49000
20200520,054016,嘉晶永豐96購04,0.37,0.57,0.37,0.56,+0.23,69.7,40000,7,19100,0,0,0,0,0,0,10000,30000,-20000,-20000
20200520,054017,茂林永豐96購02,0.36,0.46,0.36,0.44,0.00,0.00,250000,32,99800,0,0,0,0,0,0,0,250000,-250000,-250000
20200520,054018,華新台新96購01,,,,,0.00,0.00,0,0,0,0,0,0,0,0,0,0,0,0,0
20200520,054019,燿華台新96購01,,,,,0.00,0.00,0,0,0,0,0,0,0,0,0,0,0,0,0
20200520,05401P,聯茂永豐95售03,,,,,0.00,0.00,0,0,0,0,0,0,0,0,0,0,0,0,0
20200520,054020,技嘉台新97購01,,,,,0.00,0.00,0,0,0,0,0,0,0,0,0,0,0,0,0
20200520,054021,義隆台新96購01,,,,,0.00,0.00,0,0,0,0,0,0,0,0,0,0,0,0,0
20200520,054022,南亞康和96購01,,,,,0.00,0.00,0,0,0,0,0,0,0,0,0,0,0,0,0
20200520,054023,和大康和96購01,,,,,0.00,0.00,0,0,0,0,0,0,0,0,0,0,0,0,0
20200520,054024,中鋼康和96購01,,,,,0.00,0.00,0,0,0,0,0,0,0,0,0,0,0,0,0
20200520,054025,鴻海凱基96購17,,,,,0.00,0.00,0,0,0,0,0,0,0,0,0,0,0,0,0
20200520,054026,台積電凱基97購08,,,,,0.00,0.00,0,0,0,0,0,0,0,0,0,0,0,0,0
20200520,054027,欣興凱基96購04,0.47,0.47,0.47,0.47,+0.11,30.56,15000,3,7050,0,0,0,0,0,0,15000,0,15000,15000
20200520,054028,臻鼎凱基96購03,,,,,0.00,0.00,0,0,0,0,0,0,0,0,0,0,0,0,0
20200520,054029,瀚宇博凱基96購02,,,,,0.00,0.00,0,0,0,0,0,0,0,0,0,0,0,0,0
20200520,05402P,台郡永豐95售02,,,,,0.00,0.00,0,0,0,0,0,0,0,0,0,0,0,0,0
20200520,054030,台苯中信98購01,,,,,0.00,0.00,0,0,0,0,0,0,0,0,0,0,0,0,0
20200520,054031,中鋼中信98購01,,,,,0.00,0.00,0,0,0,0,0,0,0,0,0,0,0,0,0
20200520,054032,上銀中信96購01,,,,,0.00,0.00,0,0,0,0,0,0,0,0,0,0,0,0,0
20200520,054033,欣興中信96購02,,,,,0.00,0.00,0,0,0,0,0,0,0,0,0,0,0,0,0
20200520,054034,景碩中信96購01,0.01,0.01,0.01,0.01,0.00,0.00,10000,1,100,0,0,0,0,0,0,10000,0,10000,10000
20200520,054035,聯詠麥證96購01,,,,,0.00,0.00,0,0,0,0,0,0,0,0,0,0,0,0,0
20200520,054036,T50反1元大96購08,,,,,0.00,0.00,0,0,0,0,0,0,0,0,0,0,0,0,0
20200520,054037,T50反1元大96購09,0.86,0.86,0.86,0.86,0.00,0.00,10000,1,8600,0,0,0,0,0,0,0,10000,-10000,-10000
20200520,054038,T50反1元大98購04,,,,,0.00,0.00,0,0,0,0,0,0,0,0,0,0,0,0,0
20200520,054039,元油反元大96購08,,,,,0.00,0.00,0,0,0,0,0,0,0,0,0,0,0,0,0
20200520,05403P,台積電富邦95售08,,,,,0.00,0.00,0,0,0,0,0,0,0,0,0,0,0,0,0
20200520,054040,中石化元大9C購01,,,,,0.00,0.00,0,0,0,0,0,0,0,0,0,0,0,0,0
20200520,054041,鴻海元大96購22,,,,,0.00,0.00,0,0,0,0,0,0,0,0,0,0,0,0,0
20200520,054042,華泰元大96購01,,,,,0.00,0.00,0,0,0,0,0,0,0,0,0,0,0,0,0
20200520,054043,漢唐元大97購01,2.00,2.00,1.95,1.95,-0.15,-7.14,50000,5,98300,0,0,0,0,0,0,50000,0,50000,50000
20200520,054044,京元電元大96購03,,,,,0.00,0.00,0,0,0,0,0,0,0,0,0,0,0,0,0
20200520,054045,奇力新元大97購03,1.13,1.18,1.13,1.18,+0.12,11.32,178000,3,206640,0,0,0,0,0,0,110000,68000,42000,42000
20200520,054046,義隆元大96購02,0.77,0.77,0.75,0.75,0.00,0.00,200000,2,152000,0,0,0,0,0,0,0,200000,-200000,-200000
20200520,054047,富邦金元大97購01,0.20,0.20,0.20,0.20,0.00,0.00,70000,1,14000,0,0,0,0,0,0,70000,0,70000,70000
20200520,054048,國泰金元大96購04,,,,,0.00,0.00,0,0,0,0,0,0,0,0,0,0,0,0,0
20200520,054049,亞光元大96購03,,,,,0.00,0.00,0,0,0,0,0,0,0,0,0,0,0,0,0
20200520,05404P,台積電群益95售06,,,,,0.00,0.00,0,0,0,0,0,0,0,0,0,0,0,0,0
20200520,054050,創意元大96購06,0.56,0.56,0.56,0.56,-0.06,-9.68,68000,1,38080,0,0,0,0,0,0,0,68000,-68000,-68000
20200520,054051,貿聯元大97購03,,,,,0.00,0.00,0,0,0,0,0,0,0,0,0,0,0,0,0
20200520,054052,日月光元大96購06,,,,,0.00,0.00,0,0,0,0,0,0,0,0,0,0,0,0,0
20200520,054053,聯茂元大96購01,1.20,1.20,1.12,1.14,-0.11,-8.8,237000,11,276780,0,0,0,0,0,0,163000,74000,89000,89000
20200520,054054,光磊國票97購02,,,,,0.00,0.00,0,0,0,0,0,0,0,0,0,0,0,0,0
20200520,054055,全新國票99購02,0.35,0.35,0.29,0.29,0.00,0.00,20000,2,6400,0,0,0,0,0,0,0,20000,-20000,-20000
20200520,054056,華新科國票96購02,,,,,0.00,0.00,0,0,0,0,0,0,0,0,0,0,0,0,0
20200520,054057,晶豪科國票97購01,1.74,1.74,1.63,1.68,-0.20,-10.64,134000,3,222500,0,0,0,0,0,0,134000,75000,59000,59000
20200520,054058,晶豪科國票98購01,1.81,1.87,1.76,1.76,-0.35,-16.59,107000,5,191840,0,0,0,0,0,0,105000,86000,19000,19000
20200520,054059,欣興國票97購03,1.06,1.14,0.99,0.99,-0.05,-4.81,440000,4,441460,0,0,0,0,0,0,386000,54000,332000,332000
20200520,05405P,大立光群益95售04,,,,,0.00,0.00,0,0,0,0,0,0,0,0,0,0,0,0,0
20200520,054060,晶技國票97購02,,,,,0.00,0.00,0,0,0,0,0,0,0,0,0,0,0,0,0
20200520,054061,晶技國票97購03,4.64,4.64,4.64,4.64,-0.32,-6.45,3000,1,13920,0,0,0,0,0,0,3000,0,3000,3000
20200520,054062,TPK國票96購02,,,,,0.00,0.00,0,0,0,0,0,0,0,0,0,0,0,0,0
20200520,054063,聯茂國票97購02,,,,,0.00,0.00,0,0,0,0,0,0,0,0,0,0,0,0,0
20200520,054064,台郡國票97購04,1.68,1.68,1.66,1.66,0.00,0.00,51000,3,84960,0,0,0,0,0,0,15000,36000,-21000,-21000
20200520,054065,樺漢國票97購01,0.75,0.76,0.75,0.76,+0.01,1.33,52000,2,39470,0,0,0,0,0,0,52000,0,52000,52000
20200520,054066,緯穎國票97購03,13.80,14.30,13.80,14.30,+0.80,5.93,4000,2,55700,0,0,0,0,0,0,4000,0,4000,4000
20200520,054067,百和國票97購03,,,,,0.00,0.00,0,0,0,0,0,0,0,0,0,0,0,0,0
20200520,054068,華通國泰96購02,,,,,0.00,0.00,0,0,0,0,0,0,0,0,0,0,0,0,0
20200520,054069,亞光國泰98購01,,,,,0.00,0.00,0,0,0,0,0,0,0,0,0,0,0,0,0
20200520,05406P,台光電凱基95售02,,,,,0.00,0.00,0,0,0,0,0,0,0,0,0,0,0,0,0
20200520,054070,創意國泰96購02,,,,,0.00,0.00,0,0,0,0,0,0,0,0,0,0,0,0,0
20200520,054071,泰鼎國泰97購02,4.61,4.99,4.60,4.99,+0.21,4.39,6000,6,28060,0,0,0,0,0,0,5000,1000,4000,4000
20200520,054072,台積電富邦98購02,0.15,0.15,0.15,0.15,-0.04,-21.05,63000,3,9450,0,0,0,0,0,0,0,3000,-3000,-3000
20200520,054073,群創富邦96購03,,,,,0.00,0.00,0,0,0,0,0,0,0,0,0,0,0,0,0
20200520,054074,健策富邦98購01,0.39,0.39,0.39,0.39,-0.02,-4.88,5000,1,1950,0,0,0,0,0,0,5000,0,5000,5000
20200520,054075,GIS富邦97購02,0.11,0.11,0.11,0.11,0.00,0.00,50000,1,5500,0,0,0,0,0,0,50000,0,50000,50000
20200520,054076,義隆第一96購01,,,,,0.00,0.00,0,0,0,0,0,0,0,0,0,0,0,0,0
20200520,054077,中石化中信98購01,,,,,0.00,0.00,0,0,0,0,0,0,0,0,0,0,0,0,0
20200520,054078,鴻海中信98購01,,,,,0.00,0.00,0,0,0,0,0,0,0,0,0,0,0,0,0
20200520,054079,鴻海中信98購02,,,,,0.00,0.00,0,0,0,0,0,0,0,0,0,0,0,0,0
20200520,05407P,超眾凱基95售04,,,,,0.00,0.00,0,0,0,0,0,0,0,0,0,0,0,0,0
20200520,054080,微星中信98購01,,,,,0.00,0.00,0,0,0,0,0,0,0,0,0,0,0,0,0
20200520,054081,聯電元富96購01,,,,,0.00,0.00,0,0,0,0,0,0,0,0,0,0,0,0,0
20200520,054082,楠梓電元富96購01,0.35,0.35,0.35,0.35,0.00,0.00,82000,1,28700,0,0,0,0,0,0,82000,82000,0,0
20200520,054083,智伸科元富96購01,,,,,0.00,0.00,0,0,0,0,0,0,0,0,0,0,0,0,0
20200520,054084,旺宏統一97購05,,,,,0.00,0.00,0,0,0,0,0,0,0,0,0,0,0,0,0
20200520,054085,華新科統一96購04,,,,,0.00,0.00,0,0,0,0,0,0,0,0,0,0,0,0,0
20200520,054086,日月光亞東98購01,,,,,0.00,0.00,0,0,0,0,0,0,0,0,0,0,0,0,0
20200520,054087,矽創亞東96購01,,,,,0.00,0.00,0,0,0,0,0,0,0,0,0,0,0,0,0
20200520,054088,華新群益98購02,0.30,0.30,0.30,0.30,0.00,0.00,160000,3,48000,0,0,0,0,0,0,0,160000,-160000,-160000
20200520,054089,台積電群益96購11,,,,,0.00,0.00,0,0,0,0,0,0,0,0,0,0,0,0,0
20200520,05408P,臺股指中信95售13,,,,,0.00,0.00,0,0,0,0,0,0,0,0,0,0,0,0,0
20200520,054090,瑞昱群益97購01,2.88,3.05,2.68,2.68,-0.48,-15.19,220000,28,631950,0,0,0,0,0,0,193000,45000,148000,148000
20200520,054091,晶豪科群益96購01,1.22,1.27,1.09,1.09,-0.26,-19.26,363000,13,431500,0,0,0,0,0,0,127000,286000,-159000,-159000
20200520,054092,大立光群益97購01,,,,,0.00,0.00,0,0,0,0,0,0,0,0,0,0,0,0,0
20200520,054093,智原群益97購01,0.13,0.13,0.13,0.13,-0.02,-13.33,134000,1,17420,0,0,0,0,0,0,134000,0,134000,134000
20200520,054094,創意群益96購02,,,,,0.00,0.00,0,0,0,0,0,0,0,0,0,0,0,0,0
20200520,054095,同欣電群益98購03,,,,,0.00,0.00,0,0,0,0,0,0,0,0,0,0,0,0,0
20200520,054096,佳世達國票97購01,,,,,0.00,0.00,0,0,0,0,0,0,0,0,0,0,0,0,0
20200520,054097,淘帝國票97購01,0.01,0.01,0.01,0.01,-0.01,-50.0,10000,1,100,0,0,0,0,0,0,0,0,0,0
20200520,054098,嘉晶國票97購04,,,,,0.00,0.00,0,0,0,0,0,0,0,0,0,0,0,0,0
20200520,054099,TPK國票98購01,,,,,0.00,0.00,0,0,0,0,0,0,0,0,0,0,0,0,0
20200520,05409P,京元電元富95售05,,,,,0.00,0.00,0,0,0,0,0,0,0,0,0,0,0,0,0
20200520,054100,致伸國票97購03,0.47,0.47,0.47,0.47,-0.08,-14.55,114000,3,53580,0,0,0,0,0,0,114000,0,114000,114000
20200520,054101,茂林國票97購04,0.69,0.84,0.69,0.84,+0.25,42.37,444000,8,348630,0,0,0,0,0,0,0,444000,-444000,-444000
20200520,054102,百和國票97購04,0.37,0.41,0.34,0.41,+0.04,10.81,70000,4,27950,0,0,0,0,0,0,10000,60000,-50000,-50000
20200520,054103,T50反1凱基99購04,2.18,2.18,2.18,2.18,0.00,0.00,5000,1,10900,0,0,0,0,0,0,0,5000,-5000,-5000
20200520,054104,T50反1凱基9A購02,,,,,0.00,0.00,0,0,0,0,0,0,0,0,0,0,0,0,0
20200520,054105,元油反凱基9A購01,,,,,0.00,0.00,0,0,0,0,0,0,0,0,0,0,0,0,0
20200520,054106,元油反凱基9C購01,,,,,0.00,0.00,0,0,0,0,0,0,0,0,0,0,0,0,0
20200520,054107,上銀凱基97購01,,,,,0.00,0.00,0,0,0,0,0,0,0,0,0,0,0,0,0
20200520,054108,台積電凱基96購22,,,,,0.00,0.00,0,0,0,0,0,0,0,0,0,0,0,0,0
20200520,054109,南亞科凱基96購05,,,,,0.00,0.00,0,0,0,0,0,0,0,0,0,0,0,0,0
20200520,05410P,聯發科元富95售04,,,,,0.00,0.00,0,0,0,0,0,0,0,0,0,0,0,0,0
20200520,054110,群創凱基98購09,,,,,0.00,0.00,0,0,0,0,0,0,0,0,0,0,0,0,0
20200520,054111,緯穎凱基97購01,4.71,4.91,4.71,4.91,+0.22,4.69,13000,3,62280,0,0,0,0,0,0,7000,6000,1000,1000
20200520,054112,台積電麥證96購02,,,,,0.00,0.00,0,0,0,0,0,0,0,0,0,0,0,0,0
20200520,054113,奇力新台新97購01,,,,,0.00,0.00,0,0,0,0,0,0,0,0,0,0,0,0,0
20200520,054114,新光金台新97購01,0.04,0.04,0.04,0.04,0.00,0.00,499000,1,19960,0,0,0,0,0,0,0,0,0,0
20200520,054115,台塑康和96購01,,,,,0.00,0.00,0,0,0,0,0,0,0,0,0,0,0,0,0
20200520,054116,順德康和96購01,,,,,0.00,0.00,0,0,0,0,0,0,0,0,0,0,0,0,0
20200520,054117,宏全康和96購01,,,,,0.00,0.00,0,0,0,0,0,0,0,0,0,0,0,0,0
20200520,054118,國巨永豐96購04,0.14,0.14,0.14,0.14,+0.01,7.69,240000,2,33600,0,0,0,0,0,0,240000,0,240000,240000
20200520,054119,燿華永豐96購05,,,,,0.00,0.00,0,0,0,0,0,0,0,0,0,0,0,0,0
20200520,05411P,台積電國票96售08,0.28,0.28,0.28,0.28,0.00,0.00,1000,1,280,0,0,0,0,0,0,1000,0,1000,1000
20200520,054120,奇力新永豐96購01,,,,,0.00,0.00,0,0,0,0,0,0,0,0,0,0,0,0,0
20200520,054121,奇鋐永豐96購02,0.36,0.36,0.36,0.36,0.00,0.00,10000,1,3600,0,0,0,0,0,0,0,10000,-10000,-10000
20200520,054122,康友永豐96購01,,,,,0.00,0.00,0,0,0,0,0,0,0,0,0,0,0,0,0
20200520,054123,易華電永豐96購03,,,,,0.00,0.00,0,0,0,0,0,0,0,0,0,0,0,0,0
20200520,054124,達方永豐96購02,,,,,0.00,0.00,0,0,0,0,0,0,0,0,0,0,0,0,0
20200520,054125,元油反元大96購09,,,,,0.00,0.00,0,0,0,0,0,0,0,0,0,0,0,0,0
20200520,054126,和大元大96購02,,,,,0.00,0.00,0,0,0,0,0,0,0,0,0,0,0,0,0
20200520,054127,台積電元大96購21,0.04,0.04,0.04,0.04,0.00,0.00,62000,1,2480,0,0,0,0,0,0,62000,0,62000,62000
20200520,054128,台積電元大97購10,0.25,0.25,0.25,0.25,0.00,0.00,6000,2,1500,0,0,0,0,0,0,6000,1000,5000,5000
20200520,054129,技嘉元大96購02,,,,,0.00,0.00,0,0,0,0,0,0,0,0,0,0,0,0,0
20200520,05412P,泰碩國票95售02,0.01,0.01,0.01,0.01,0.00,0.00,35000,1,350,0,0,0,0,0,0,35000,0,35000,35000
20200520,054130,漢唐元大97購02,1.22,1.22,1.18,1.18,-0.02,-1.67,114000,6,138020,0,0,0,0,0,0,104000,10000,94000,94000
20200520,054131,南亞科元大96購04,0.01,0.01,0.01,0.01,0.00,0.00,2000,1,20,0,0,0,0,0,0,2000,0,2000,2000
20200520,054132,聯發科元大97購10,1.24,1.43,1.24,1.26,+0.13,11.5,92000,4,122780,0,0,0,0,0,0,92000,0,92000,92000
20200520,054133,奇力新元大97購04,,,,,0.00,0.00,0,0,0,0,0,0,0,0,0,0,0,0,0
20200520,054134,強茂元大96購01,0.55,0.58,0.55,0.58,0.00,0.00,214000,3,123820,0,0,0,0,0,0,214000,0,214000,214000
20200520,054135,大立光元大97購04,0.87,0.87,0.87,0.87,0.00,0.00,82000,2,71340,0,0,0,0,0,0,82000,0,82000,82000
20200520,054136,亞光元大96購04,,,,,0.00,0.00,0,0,0,0,0,0,0,0,0,0,0,0,0
20200520,054137,聯詠元大97購02,0.59,0.63,0.59,0.63,-0.02,-3.08,887000,13,544920,0,0,0,0,0,0,105000,782000,-677000,-677000
20200520,054138,晶技元大98購02,,,,,0.00,0.00,0,0,0,0,0,0,0,0,0,0,0,0,0
20200520,054139,揚明光元大96購01,,,,,0.00,0.00,0,0,0,0,0,0,0,0,0,0,0,0,0
20200520,05413P,台郡國票96售02,,,,,0.00,0.00,0,0,0,0,0,0,0,0,0,0,0,0,0
20200520,054140,智易元大97購03,0.55,0.55,0.52,0.52,-0.04,-7.14,83000,2,45620,0,0,0,0,0,0,83000,82000,1000,1000
20200520,054141,TPK元大96購02,,,,,0.00,0.00,0,0,0,0,0,0,0,0,0,0,0,0,0
20200520,054142,致伸元大97購01,,,,,0.00,0.00,0,0,0,0,0,0,0,0,0,0,0,0,0
20200520,054143,茂林元大96購04,1.64,2.37,1.64,2.37,+0.73,44.51,135000,14,280700,0,0,0,0,0,0,10000,125000,-115000,-115000
20200520,054144,康控元大97購02,,,,,0.00,0.00,0,0,0,0,0,0,0,0,0,0,0,0,0
20200520,054145,嘉聯益元大98購01,,,,,0.00,0.00,0,0,0,0,0,0,0,0,0,0,0,0,0
20200520,054146,康友元大96購06,,,,,0.00,0.00,0,0,0,0,0,0,0,0,0,0,0,0,0
20200520,054147,GIS元大96購02,,,,,0.00,0.00,0,0,0,0,0,0,0,0,0,0,0,0,0
20200520,054148,矽創元大96購03,0.73,0.73,0.65,0.67,-0.01,-1.47,223000,13,152410,0,0,0,0,0,0,223000,0,223000,223000
20200520,054149,達方元大96購01,,,,,0.00,0.00,0,0,0,0,0,0,0,0,0,0,0,0,0
20200520,05414P,台表科國票96售02,0.34,0.37,0.25,0.25,-0.15,-37.5,124000,10,36620,0,0,0,0,0,0,2000,122000,-120000,-120000
20200520,054150,國巨國泰97購05,,,,,0.00,0.00,0,0,0,0,0,0,0,0,0,0,0,0,0
20200520,054151,瑞昱國泰97購01,3.73,3.75,3.26,3.52,-0.73,-17.18,150000,24,540580,0,0,0,0,0,0,138000,1000,137000,137000
20200520,054152,漢唐國泰98購02,0.81,0.81,0.81,0.81,0.00,0.00,50000,1,40500,0,0,0,0,0,0,50000,0,50000,50000
20200520,054153,宏達電國泰97購01,,,,,0.00,0.00,0,0,0,0,0,0,0,0,0,0,0,0,0
20200520,054154,智易國泰97購01,,,,,0.00,0.00,0,0,0,0,0,0,0,0,0,0,0,0,0
20200520,054155,美律第一96購01,,,,,0.00,0.00,0,0,0,0,0,0,0,0,0,0,0,0,0
20200520,054156,聯電亞東98購01,,,,,0.00,0.00,0,0,0,0,0,0,0,0,0,0,0,0,0
20200520,054157,國巨亞東96購01,,,,,0.00,0.00,0,0,0,0,0,0,0,0,0,0,0,0,0
20200520,054158,國巨日盛99購01,0.85,0.85,0.53,0.53,+0.06,12.77,20000,4,12530,0,0,0,0,0,0,13000,0,13000,13000
20200520,054159,T50正2凱基99購01,0.27,0.27,0.27,0.27,0.00,0.00,120000,1,32400,0,0,0,0,0,0,120000,0,120000,120000
20200520,05415P,台積電台新95售04,,,,,0.00,0.00,0,0,0,0,0,0,0,0,0,0,0,0,0
20200520,054160,華泰凱基98購01,,,,,0.00,0.00,0,0,0,0,0,0,0,0,0,0,0,0,0
20200520,054161,友訊凱基98購01,,,,,0.00,0.00,0,0,0,0,0,0,0,0,0,0,0,0,0
20200520,054162,光罩凱基98購01,0.21,0.21,0.21,0.21,0.00,0.00,10000,1,2100,0,0,0,0,0,0,0,10000,-10000,-10000
20200520,054163,燿華凱基97購02,0.30,0.30,0.30,0.30,+0.09,42.86,5000,1,1500,0,0,0,0,0,0,0,5000,-5000,-5000
20200520,054164,強茂凱基98購01,0.78,0.87,0.78,0.85,+0.05,6.25,235000,11,196900,0,0,0,0,0,0,115000,120000,-5000,-5000
20200520,054165,亞光凱基96購02,,,,,0.00,0.00,0,0,0,0,0,0,0,0,0,0,0,0,0
20200520,054166,日電貿凱基98購01,0.68,0.71,0.67,0.67,0.00,0.00,50000,3,34400,0,0,0,0,0,0,40000,10000,30000,30000
20200520,054167,揚明光凱基98購01,,,,,0.00,0.00,0,0,0,0,0,0,0,0,0,0,0,0,0
20200520,054168,貿聯凱基97購02,,,,,0.00,0.00,0,0,0,0,0,0,0,0,0,0,0,0,0
20200520,054169,上緯控凱基98購01,0.88,0.92,0.79,0.79,-0.08,-9.2,175000,15,146800,0,0,0,0,0,0,157000,14000,143000,143000
20200520,05416P,喬山永豐95售04,,,,,0.00,0.00,0,0,0,0,0,0,0,0,0,0,0,0,0
20200520,054170,泰鼎凱基98購01,7.25,8.00,7.10,8.00,+0.55,7.38,100000,14,766000,0,0,0,0,0,0,40000,60000,-20000,-20000
20200520,054171,台郡凱基97購01,0.27,0.27,0.27,0.27,0.00,0.00,10000,1,2700,0,0,0,0,0,0,10000,0,10000,10000
20200520,054172,易華電凱基98購01,0.09,0.09,0.09,0.09,0.00,0.00,21000,1,1890,0,0,0,0,0,0,21000,0,21000,21000
20200520,054173,奇力新台新97購02,,,,,0.00,0.00,0,0,0,0,0,0,0,0,0,0,0,0,0
20200520,054174,宏達電台新97購01,,,,,0.00,0.00,0,0,0,0,0,0,0,0,0,0,0,0,0
20200520,054175,高鐵台新97購01,,,,,0.00,0.00,0,0,0,0,0,0,0,0,0,0,0,0,0
20200520,054176,亞光台新96購01,,,,,0.00,0.00,0,0,0,0,0,0,0,0,0,0,0,0,0
20200520,054177,牧德台新97購01,0.94,1.22,0.94,1.22,0.00,0.00,55000,5,58660,0,0,0,0,0,0,41000,0,41000,41000
20200520,054178,中磊台新97購01,0.55,0.55,0.50,0.50,-0.06,-10.71,820000,6,425000,0,0,0,0,0,0,420000,400000,20000,20000
20200520,054179,上海銀台新97購01,,,,,0.00,0.00,0,0,0,0,0,0,0,0,0,0,0,0,0
20200520,05417P,燿華永豐95售07,,,,,0.00,0.00,0,0,0,0,0,0,0,0,0,0,0,0,0
20200520,054180,亞泥康和96購01,0.54,0.54,0.53,0.53,-0.02,-3.64,116000,3,62420,0,0,0,0,0,0,22000,94000,-72000,-72000
20200520,054181,華新康和96購01,,,,,0.00,0.00,0,0,0,0,0,0,0,0,0,0,0,0,0
20200520,054182,台積電康和96購01,,,,,0.00,0.00,0,0,0,0,0,0,0,0,0,0,0,0,0
20200520,054183,亞光康和96購01,,,,,0.00,0.00,0,0,0,0,0,0,0,0,0,0,0,0,0
20200520,054184,A50正2永豐96購01,,,,,0.00,0.00,0,0,0,0,0,0,0,0,0,0,0,0,0
20200520,054185,喬山永豐96購02,0.15,0.15,0.15,0.15,0.00,0.00,20000,1,3000,0,0,0,0,0,0,0,20000,-20000,-20000
20200520,054186,高鐵永豐96購01,,,,,0.00,0.00,0,0,0,0,0,0,0,0,0,0,0,0,0
20200520,054187,亞光永豐96購03,,,,,0.00,0.00,0,0,0,0,0,0,0,0,0,0,0,0,0
20200520,054188,欣興永豐96購03,0.48,0.52,0.41,0.43,-0.03,-6.52,272000,14,130020,0,0,0,0,0,0,249000,23000,226000,226000
20200520,054189,貿聯永豐96購03,,,,,0.00,0.00,0,0,0,0,0,0,0,0,0,0,0,0,0
20200520,05418P,瑞昱永豐95售02,,,,,0.00,0.00,0,0,0,0,0,0,0,0,0,0,0,0,0
20200520,054190,矽創永豐96購01,,,,,0.00,0.00,0,0,0,0,0,0,0,0,0,0,0,0,0
20200520,054191,香港2X中信98購01,,,,,0.00,0.00,0,0,0,0,0,0,0,0,0,0,0,0,0
20200520,054192,國巨中信98購01,,,,,0.00,0.00,0,0,0,0,0,0,0,0,0,0,0,0,0
20200520,054193,鴻海麥證96購02,,,,,0.00,0.00,0,0,0,0,0,0,0,0,0,0,0,0,0
20200520,054194,國巨麥證96購02,,,,,0.00,0.00,0,0,0,0,0,0,0,0,0,0,0,0,0
20200520,054195,亞泥國泰98購01,,,,,0.00,0.00,0,0,0,0,0,0,0,0,0,0,0,0,0
20200520,054196,台光電國泰97購02,,,,,0.00,0.00,0,0,0,0,0,0,0,0,0,0,0,0,0
20200520,054197,台積電永昌96購07,,,,,0.00,0.00,0,0,0,0,0,0,0,0,0,0,0,0,0
20200520,054198,台積電永昌96購08,0.01,0.01,0.01,0.01,0.00,0.00,164000,2,1640,0,0,0,0,0,0,0,0,0,0
20200520,054199,大立光永昌96購07,,,,,0.00,0.00,0,0,0,0,0,0,0,0,0,0,0,0,0
20200520,05419P,矽力永豐95售02,,,,,0.00,0.00,0,0,0,0,0,0,0,0,0,0,0,0,0
20200520,054200,美律富邦97購02,,,,,0.00,0.00,0,0,0,0,0,0,0,0,0,0,0,0,0
20200520,054201,聯詠富邦97購02,0.35,0.35,0.30,0.34,-0.02,-5.56,70000,6,22910,0,0,0,0,0,0,0,70000,-70000,-70000
20200520,054202,樺漢富邦97購01,,,,,0.00,0.00,0,0,0,0,0,0,0,0,0,0,0,0,0
20200520,054203,滬深2X國票96購03,0.48,0.48,0.48,0.48,0.00,0.00,50000,1,24000,0,0,0,0,0,0,50000,0,50000,50000
20200520,054204,元金2X國票9B購02,2.26,2.26,2.26,2.26,+0.11,5.12,2000,1,4520,0,0,0,0,0,0,2000,0,2000,2000
20200520,054205,華新國票97購02,,,,,0.00,0.00,0,0,0,0,0,0,0,0,0,0,0,0,0
20200520,054206,鴻海國票99購01,0.04,0.04,0.03,0.04,-0.01,-20.0,381000,7,13430,0,0,0,0,0,0,0,0,0,0
20200520,054207,國巨國票98購01,,,,,0.00,0.00,0,0,0,0,0,0,0,0,0,0,0,0,0
20200520,054208,台積電國票97購07,,,,,0.00,0.00,0,0,0,0,0,0,0,0,0,0,0,0,0
20200520,054209,台積電國票97購08,,,,,0.00,0.00,0,0,0,0,0,0,0,0,0,0,0,0,0
20200520,05420P,大立光國泰97售03,,,,,0.00,0.00,0,0,0,0,0,0,0,0,0,0,0,0,0
20200520,054210,台光電國票97購03,,,,,0.00,0.00,0,0,0,0,0,0,0,0,0,0,0,0,0
20200520,054211,奇鋐國票97購03,0.75,0.75,0.75,0.75,0.00,0.00,36000,3,27000,0,0,0,0,0,0,0,36000,-36000,-36000
20200520,054212,聯詠國票97購03,0.67,0.67,0.67,0.67,0.00,0.00,70000,1,46900,0,0,0,0,0,0,0,70000,-70000,-70000
20200520,054213,欣興國票97購04,1.98,2.01,1.87,1.87,0.00,0.00,19000,3,37460,0,0,0,0,0,0,0,19000,-19000,-19000
20200520,054214,京鼎國票97購02,,,,,0.00,0.00,0,0,0,0,0,0,0,0,0,0,0,0,0
20200520,054215,創意國票97購02,,,,,0.00,0.00,0,0,0,0,0,0,0,0,0,0,0,0,0
20200520,054216,聯茂國票97購03,,,,,0.00,0.00,0,0,0,0,0,0,0,0,0,0,0,0,0
20200520,054217,台表科國票97購05,1.74,2.42,1.68,2.37,+0.79,50.0,757000,28,1390840,0,0,0,0,0,0,330000,427000,-97000,-97000
20200520,054218,S&P反1統一98購02,,,,,0.00,0.00,0,0,0,0,0,0,0,0,0,0,0,0,0
20200520,054219,楠梓電統一97購01,,,,,0.00,0.00,0,0,0,0,0,0,0,0,0,0,0,0,0
20200520,05421P,鴻海元大96售12,5.30,5.30,5.30,5.30,+0.30,6.0,13000,1,68900,0,0,0,0,0,0,13000,13000,0,0
20200520,054220,國巨統一97購02,0.51,0.59,0.49,0.49,+0.09,22.5,65000,11,34140,0,0,0,0,0,0,52000,63000,-11000,-11000
20200520,054221,華新科統一96購05,1.24,1.32,1.22,1.22,-0.06,-4.69,509000,23,653850,0,0,0,0,0,0,255000,254000,1000,1000
20200520,054222,大立光統一98購03,,,,,0.00,0.00,0,0,0,0,0,0,0,0,0,0,0,0,0
20200520,054223,大立光統一98購04,0.45,0.45,0.45,0.45,0.00,0.00,120000,1,54000,0,0,0,0,0,0,120000,0,120000,120000
20200520,054224,亞光統一98購01,,,,,0.00,0.00,0,0,0,0,0,0,0,0,0,0,0,0,0
20200520,054225,華新元富96購01,,,,,0.00,0.00,0,0,0,0,0,0,0,0,0,0,0,0,0
20200520,054226,燿華元富96購02,,,,,0.00,0.00,0,0,0,0,0,0,0,0,0,0,0,0,0
20200520,054227,宏達電元富96購02,,,,,0.00,0.00,0,0,0,0,0,0,0,0,0,0,0,0,0
20200520,054228,貿聯元富96購03,,,,,0.00,0.00,0,0,0,0,0,0,0,0,0,0,0,0,0
20200520,054229,超眾元富96購05,,,,,0.00,0.00,0,0,0,0,0,0,0,0,0,0,0,0,0
20200520,05422P,大立光中信97售02,,,,,0.00,0.00,0,0,0,0,0,0,0,0,0,0,0,0,0
20200520,054230,上銀群益96購03,,,,,0.00,0.00,0,0,0,0,0,0,0,0,0,0,0,0,0
20200520,054231,國巨群益98購03,6.95,7.80,6.95,7.15,+0.70,10.85,13000,10,93250,0,0,0,0,0,0,13000,9000,4000,4000
20200520,054232,台積電群益96購12,,,,,0.00,0.00,0,0,0,0,0,0,0,0,0,0,0,0,0
20200520,054233,聯發科群益96購04,,,,,0.00,0.00,0,0,0,0,0,0,0,0,0,0,0,0,0
20200520,054234,可成群益96購05,,,,,0.00,0.00,0,0,0,0,0,0,0,0,0,0,0,0,0
20200520,054235,欣興群益96購06,1.38,1.43,1.30,1.35,-0.11,-7.53,153000,9,212940,0,0,0,0,0,0,87000,66000,21000,21000
20200520,054236,貿聯群益96購01,,,,,0.00,0.00,0,0,0,0,0,0,0,0,0,0,0,0,0
20200520,054237,茂林群益97購01,0.78,0.81,0.77,0.78,0.00,0.00,187000,7,146510,0,0,0,0,0,0,0,187000,-187000,-187000
20200520,054238,聯茂群益96購04,2.45,2.45,2.45,2.45,0.00,0.00,30000,1,73500,0,0,0,0,0,0,0,30000,-30000,-30000
20200520,054239,台郡群益96購02,0.53,0.53,0.53,0.53,0.00,0.00,60000,1,31800,0,0,0,0,0,0,0,60000,-60000,-60000
20200520,05423P,聯電亞東95售02,,,,,0.00,0.00,0,0,0,0,0,0,0,0,0,0,0,0,0
20200520,054240,訊芯群益96購03,,,,,0.00,0.00,0,0,0,0,0,0,0,0,0,0,0,0,0
20200520,054241,深中小元大98購01,1.02,1.02,1.02,1.02,+0.04,4.08,60000,3,61200,0,0,0,0,0,0,20000,40000,-20000,-20000
20200520,054242,元油反元大98購02,,,,,0.00,0.00,0,0,0,0,0,0,0,0,0,0,0,0,0
20200520,054243,國喬元大96購01,,,,,0.00,0.00,0,0,0,0,0,0,0,0,0,0,0,0,0
20200520,054244,華新元大96購01,,,,,0.00,0.00,0,0,0,0,0,0,0,0,0,0,0,0,0
20200520,054245,鴻海元大96購23,,,,,0.00,0.00,0,0,0,0,0,0,0,0,0,0,0,0,0
20200520,054246,國巨元大96購12,1.05,1.05,0.90,0.90,+0.23,34.33,40000,4,39800,0,0,0,0,0,0,0,40000,-40000,-40000
20200520,054247,華邦電元大96購04,,,,,0.00,0.00,0,0,0,0,0,0,0,0,0,0,0,0,0
20200520,054248,燿華元大97購02,,,,,0.00,0.00,0,0,0,0,0,0,0,0,0,0,0,0,0
20200520,054249,技嘉元大96購03,2.37,2.37,2.37,2.37,0.00,0.00,1000,1,2370,0,0,0,0,0,0,0,0,0,0
20200520,05424P,台達電亞東96售02,,,,,0.00,0.00,0,0,0,0,0,0,0,0,0,0,0,0,0
20200520,054250,漢唐元大96購04,0.70,0.70,0.70,0.70,-0.10,-12.5,98000,2,68600,0,0,0,0,0,0,49000,49000,0,0
20200520,054251,聯發科元大96購21,1.45,1.65,1.45,1.65,+0.36,27.91,50000,6,81160,0,0,0,0,0,0,40000,0,40000,40000
20200520,054252,奇力新元大96購04,0.67,0.71,0.67,0.71,+0.10,16.39,168000,3,116160,0,0,0,0,0,0,100000,68000,32000,32000
20200520,054253,宏達電元大97購03,0.37,0.37,0.37,0.37,0.00,0.00,40000,4,14800,0,0,0,0,0,0,0,40000,-40000,-40000
20200520,054254,晶豪科元大96購02,,,,,0.00,0.00,0,0,0,0,0,0,0,0,0,0,0,0,0
20200520,054255,亞光元大96購05,,,,,0.00,0.00,0,0,0,0,0,0,0,0,0,0,0,0,0
20200520,054256,創意元大96購07,,,,,0.00,0.00,0,0,0,0,0,0,0,0,0,0,0,0,0
20200520,054257,揚明光元大96購02,,,,,0.00,0.00,0,0,0,0,0,0,0,0,0,0,0,0,0
20200520,054258,牧德元大97購01,2.52,3.23,2.52,3.13,+0.59,23.23,187000,20,551800,0,0,0,0,0,0,37000,179000,-142000,-142000
20200520,054259,健策元大97購03,,,,,0.00,0.00,0,0,0,0,0,0,0,0,0,0,0,0,0
20200520,05425P,華邦電亞東96售02,,,,,0.00,0.00,0,0,0,0,0,0,0,0,0,0,0,0,0
20200520,054260,貿聯元大96購03,0.65,0.65,0.63,0.64,+0.07,12.28,136000,7,87320,0,0,0,0,0,0,68000,68000,0,0
20200520,054261,智伸科元大96購03,0.28,0.28,0.28,0.28,0.00,0.00,53000,1,14840,0,0,0,0,0,0,53000,0,53000,53000
20200520,054262,瀚宇博元大96購03,0.31,0.31,0.31,0.31,0.00,0.00,100000,1,31000,0,0,0,0,0,0,100000,0,100000,100000
20200520,054263,聯茂元大96購02,1.02,1.02,1.02,1.02,+0.02,2.0,100000,1,102000,0,0,0,0,0,0,100000,0,100000,100000
20200520,054264,超眾元大97購02,,,,,0.00,0.00,0,0,0,0,0,0,0,0,0,0,0,0,0
20200520,054265,GIS元大96購03,,,,,0.00,0.00,0,0,0,0,0,0,0,0,0,0,0,0,0
20200520,054266,緯穎元大96購07,,,,,0.00,0.00,0,0,0,0,0,0,0,0,0,0,0,0,0
20200520,054267,上銀第一96購01,,,,,0.00,0.00,0,0,0,0,0,0,0,0,0,0,0,0,0
20200520,054268,健策第一96購01,0.11,0.11,0.11,0.11,0.00,0.00,120000,1,13200,0,0,0,0,0,0,120000,0,120000,120000
20200520,054269,台光電亞東98購01,,,,,0.00,0.00,0,0,0,0,0,0,0,0,0,0,0,0,0
20200520,05426P,聯發科凱基95售12,,,,,0.00,0.00,0,0,0,0,0,0,0,0,0,0,0,0,0
20200520,054270,寶滬深中信98購01,,,,,0.00,0.00,0,0,0,0,0,0,0,0,0,0,0,0,0
20200520,054271,中石化中信99購01,,,,,0.00,0.00,0,0,0,0,0,0,0,0,0,0,0,0,0
20200520,054272,華通中信98購01,,,,,0.00,0.00,0,0,0,0,0,0,0,0,0,0,0,0,0
20200520,054273,宏達電中信98購01,,,,,0.00,0.00,0,0,0,0,0,0,0,0,0,0,0,0,0
20200520,054274,智易中信96購02,,,,,0.00,0.00,0,0,0,0,0,0,0,0,0,0,0,0,0
20200520,054275,華通群益97購03,,,,,0.00,0.00,0,0,0,0,0,0,0,0,0,0,0,0,0
20200520,054276,國巨群益96購07,0.49,0.78,0.49,0.71,0.00,0.00,17000,3,10010,0,0,0,0,0,0,2000,5000,-3000,-3000
20200520,054277,亞光群益97購01,,,,,0.00,0.00,0,0,0,0,0,0,0,0,0,0,0,0,0
20200520,054278,晶技群益97購02,3.01,3.01,3.01,3.01,-0.13,-4.14,16000,1,48160,0,0,0,0,0,0,16000,0,16000,16000
20200520,054279,揚明光群益98購01,,,,,0.00,0.00,0,0,0,0,0,0,0,0,0,0,0,0,0
20200520,05427P,聯發科凱基96售07,1.31,1.45,1.31,1.45,-0.19,-11.59,7000,7,9510,0,0,0,0,0,0,5000,2000,3000,3000
20200520,054280,牧德群益98購01,,,,,0.00,0.00,0,0,0,0,0,0,0,0,0,0,0,0,0
20200520,054281,世芯群益97購01,,,,,0.00,0.00,0,0,0,0,0,0,0,0,0,0,0,0,0
20200520,054282,泰鼎群益98購02,2.37,2.37,2.37,2.37,+0.11,4.87,10000,1,23700,0,0,0,0,0,0,10000,0,10000,10000
20200520,054283,元油反元大99購02,,,,,0.00,0.00,0,0,0,0,0,0,0,0,0,0,0,0,0
20200520,054284,和大元大96購03,,,,,0.00,0.00,0,0,0,0,0,0,0,0,0,0,0,0,0
20200520,054285,國巨元大98購02,,,,,0.00,0.00,0,0,0,0,0,0,0,0,0,0,0,0,0
20200520,054286,台積電元大96購22,,,,,0.00,0.00,0,0,0,0,0,0,0,0,0,0,0,0,0
20200520,054287,台積電元大97購11,,,,,0.00,0.00,0,0,0,0,0,0,0,0,0,0,0,0,0
20200520,054288,華邦電元大96購05,,,,,0.00,0.00,0,0,0,0,0,0,0,0,0,0,0,0,0
20200520,054289,聯發科元大97購11,1.21,1.40,1.21,1.21,+0.11,10.0,100000,9,128500,20000,0,20000,0,0,0,50000,0,50000,70000
20200520,05428P,滬深2X統一95售01,,,,,0.00,0.00,0,0,0,0,0,0,0,0,0,0,0,0,0
20200520,054290,奇力新元大96購05,,,,,0.00,0.00,0,0,0,0,0,0,0,0,0,0,0,0,0
20200520,054291,高鐵元大97購01,,,,,0.00,0.00,0,0,0,0,0,0,0,0,0,0,0,0,0
20200520,054292,欣興元大96購06,0.57,0.65,0.57,0.65,-0.04,-5.8,101000,11,65570,0,0,0,0,0,0,1000,100000,-99000,-99000
20200520,054293,健策元大98購02,,,,,0.00,0.00,0,0,0,0,0,0,0,0,0,0,0,0,0
20200520,054294,世芯元大96購02,,,,,0.00,0.00,0,0,0,0,0,0,0,0,0,0,0,0,0
20200520,054295,世芯元大96購03,,,,,0.00,0.00,0,0,0,0,0,0,0,0,0,0,0,0,0
20200520,054296,世芯元大97購01,4.03,4.03,3.86,3.86,-0.32,-7.66,30000,3,119000,0,0,0,0,0,0,0,30000,-30000,-30000
20200520,054297,台郡元大98購01,,,,,0.00,0.00,0,0,0,0,0,0,0,0,0,0,0,0,0
20200520,054298,台表科元大97購03,2.27,3.06,2.27,3.06,+0.78,34.21,29000,2,71360,0,0,0,0,0,0,7000,22000,-15000,-15000
20200520,054299,南電元大96購03,,,,,0.00,0.00,0,0,0,0,0,0,0,0,0,0,0,0,0
20200520,05429P,鴻海統一95售16,,,,,0.00,0.00,0,0,0,0,0,0,0,0,0,0,0,0,0
20200520,054300,華通凱基96購07,1.10,1.15,1.10,1.12,0.00,0.00,69000,3,78250,0,0,0,0,0,0,33000,36000,-3000,-3000
20200520,054301,楠梓電凱基98購01,0.52,0.52,0.48,0.50,-0.02,-3.85,400000,6,202000,0,0,0,0,0,0,200000,200000,0,0
20200520,054302,鴻海凱基96購18,,,,,0.00,0.00,0,0,0,0,0,0,0,0,0,0,0,0,0
20200520,054303,國巨凱基96購15,,,,,0.00,0.00,0,0,0,0,0,0,0,0,0,0,0,0,0
20200520,054304,台積電凱基96購23,,,,,0.00,0.00,0,0,0,0,0,0,0,0,0,0,0,0,0
20200520,054305,光磊凱基98購01,,,,,0.00,0.00,0,0,0,0,0,0,0,0,0,0,0,0,0
20200520,054306,聯發科凱基96購23,3.67,3.67,3.67,3.67,0.00,0.00,13000,1,47710,0,0,0,0,0,0,0,13000,-13000,-13000
20200520,054307,高鐵凱基98購01,0.20,0.20,0.20,0.20,-0.04,-16.67,3000,1,600,0,0,0,0,0,0,3000,0,3000,3000
20200520,054308,嘉晶凱基98購01,1.28,1.28,1.21,1.21,0.00,0.00,22000,3,27620,0,0,0,0,0,0,12000,10000,2000,2000
20200520,054309,禾伸堂凱基98購01,4.04,4.04,4.04,4.04,-0.06,-1.46,10000,1,40400,0,0,0,0,0,0,10000,0,10000,10000
20200520,05430P,台積電統一95售07,1.14,1.17,1.14,1.15,-0.18,-13.53,36000,4,41500,0,0,0,0,0,0,16000,20000,-4000,-4000
20200520,054310,牧德凱基98購01,0.94,0.94,0.93,0.93,0.00,0.00,6000,2,5590,0,0,0,0,0,0,0,6000,-6000,-6000
20200520,054311,世芯凱基96購02,2.59,2.77,2.26,2.26,-0.48,-17.52,449000,39,1181390,0,0,0,0,0,0,379000,69000,310000,310000
20200520,054312,TPK凱基98購01,,,,,0.00,0.00,0,0,0,0,0,0,0,0,0,0,0,0,0
20200520,054313,麗豐凱基96購02,,,,,0.00,0.00,0,0,0,0,0,0,0,0,0,0,0,0,0
20200520,054314,嘉聯益凱基97購01,,,,,0.00,0.00,0,0,0,0,0,0,0,0,0,0,0,0,0
20200520,054315,訊芯凱基98購01,,,,,0.00,0.00,0,0,0,0,0,0,0,0,0,0,0,0,0
20200520,054316,矽創凱基97購01,0.94,0.94,0.80,0.80,-0.08,-9.09,141000,16,122930,0,0,0,0,0,0,120000,1000,119000,119000
20200520,054317,昇陽半凱基98購01,,,,,0.00,0.00,0,0,0,0,0,0,0,0,0,0,0,0,0
20200520,054318,台虹凱基98購01,0.88,0.89,0.84,0.87,-0.02,-2.25,439000,17,382540,0,0,0,0,0,0,239000,218000,21000,21000
20200520,054319,世紀鋼凱基96購02,,,,,0.00,0.00,0,0,0,0,0,0,0,0,0,0,0,0,0
20200520,05431P,台光電統一97售01,0.42,0.45,0.42,0.42,-0.01,-2.33,92000,11,39500,0,0,0,0,0,0,89000,3000,86000,86000
20200520,054320,國喬台新96購01,0.04,0.04,0.04,0.04,+0.02,100.0,15000,1,600,0,0,0,0,0,0,15000,0,15000,15000
20200520,054321,上銀台新96購01,,,,,0.00,0.00,0,0,0,0,0,0,0,0,0,0,0,0,0
20200520,054322,國巨台新96購02,,,,,0.00,0.00,0,0,0,0,0,0,0,0,0,0,0,0,0
20200520,054323,旺宏台新96購02,,,,,0.00,0.00,0,0,0,0,0,0,0,0,0,0,0,0,0
20200520,054324,美律台新97購01,,,,,0.00,0.00,0,0,0,0,0,0,0,0,0,0,0,0,0
20200520,054325,奇力新台新97購03,,,,,0.00,0.00,0,0,0,0,0,0,0,0,0,0,0,0,0
20200520,054326,宏達電台新97購02,,,,,0.00,0.00,0,0,0,0,0,0,0,0,0,0,0,0,0
20200520,054327,亞光台新96購02,0.01,0.01,0.01,0.01,0.00,0.00,10000,1,100,0,0,0,0,0,0,0,10000,-10000,-10000
20200520,054328,台化康和96購01,,,,,0.00,0.00,0,0,0,0,0,0,0,0,0,0,0,0,0
20200520,054329,華新科永豐96購02,,,,,0.00,0.00,0,0,0,0,0,0,0,0,0,0,0,0,0
20200520,05432P,國巨元富95售07,,,,,0.00,0.00,0,0,0,0,0,0,0,0,0,0,0,0,0
20200520,054330,世芯永豐96購02,1.22,1.32,0.97,0.97,-0.35,-26.52,289000,43,341660,0,0,0,0,0,0,221000,68000,153000,153000
20200520,054331,世芯永豐96購03,,,,,0.00,0.00,0,0,0,0,0,0,0,0,0,0,0,0,0
20200520,054332,世芯永豐97購01,1.86,1.94,1.56,1.56,-0.34,-17.89,137000,25,245390,0,0,0,0,0,0,102000,25000,77000,77000
20200520,054333,茂林永豐96購03,0.16,0.20,0.16,0.20,0.00,0.00,586000,54,94660,0,0,0,0,0,0,0,586000,-586000,-586000
20200520,054334,超眾永豐96購04,,,,,0.00,0.00,0,0,0,0,0,0,0,0,0,0,0,0,0
20200520,054335,緯穎永豐96購02,1.98,1.98,1.98,1.98,-0.14,-6.6,10000,7,19800,0,0,0,0,0,0,10000,0,10000,10000
20200520,054336,台積電統一96購11,,,,,0.00,0.00,0,0,0,0,0,0,0,0,0,0,0,0,0
20200520,054337,智邦統一96購01,,,,,0.00,0.00,0,0,0,0,0,0,0,0,0,0,0,0,0
20200520,054338,全新統一96購01,,,,,0.00,0.00,0,0,0,0,0,0,0,0,0,0,0,0,0
20200520,054339,聯詠統一96購02,0.52,0.56,0.49,0.52,-0.08,-13.33,783000,15,412270,0,0,0,0,0,0,321000,422000,-101000,-101000
20200520,05433P,智原元富95售02,,,,,0.00,0.00,0,0,0,0,0,0,0,0,0,0,0,0,0
20200520,054340,大成鋼元富96購01,,,,,0.00,0.00,0,0,0,0,0,0,0,0,0,0,0,0,0
20200520,054341,燿華元富96購03,0.14,0.14,0.14,0.14,0.00,0.00,10000,1,1400,0,0,0,0,0,0,0,10000,-10000,-10000
20200520,054342,亞光元富99購01,,,,,0.00,0.00,0,0,0,0,0,0,0,0,0,0,0,0,0
20200520,054343,世紀鋼元富96購02,1.57,1.68,1.39,1.39,-0.14,-9.15,283000,15,444480,0,0,0,0,0,0,161000,122000,39000,39000
20200520,054344,景碩國票97購04,,,,,0.00,0.00,0,0,0,0,0,0,0,0,0,0,0,0,0
20200520,054345,世芯國票96購02,,,,,0.00,0.00,0,0,0,0,0,0,0,0,0,0,0,0,0
20200520,054346,世芯國票97購01,,,,,0.00,0.00,0,0,0,0,0,0,0,0,0,0,0,0,0
20200520,054347,上緯控國票96購02,0.59,0.59,0.45,0.45,-0.08,-15.09,1374000,9,645610,0,1050000,-1050000,0,0,0,1250000,124000,1126000,76000
20200520,054348,康控國票97購03,,,,,0.00,0.00,0,0,0,0,0,0,0,0,0,0,0,0,0
20200520,054349,同欣電國票97購02,0.51,0.62,0.51,0.51,-0.03,-5.56,214000,6,111940,0,0,0,0,0,0,30000,184000,-154000,-154000
20200520,05434P,世紀鋼元富95售02,,,,,0.00,0.00,0,0,0,0,0,0,0,0,0,0,0,0,0
20200520,054350,美律國泰98購01,,,,,0.00,0.00,0,0,0,0,0,0,0,0,0,0,0,0,0
20200520,054351,華新科國泰97購03,1.45,1.52,1.36,1.36,-0.10,-6.85,257000,25,371930,0,0,0,0,0,0,127000,130000,-3000,-3000
20200520,054352,世芯國泰98購01,12.90,12.90,12.90,12.90,-1.40,-9.79,12000,1,154800,0,0,0,0,0,0,12000,0,12000,12000
20200520,054353,世紀鋼國泰98購01,,,,,0.00,0.00,0,0,0,0,0,0,0,0,0,0,0,0,0
20200520,054354,技嘉富邦97購01,1.46,1.53,1.45,1.51,-0.15,-9.04,110000,9,162000,0,0,0,0,0,0,75000,14000,61000,61000
20200520,054355,上海銀富邦98購01,,,,,0.00,0.00,0,0,0,0,0,0,0,0,0,0,0,0,0
20200520,054356,可成兆豐97購01,,,,,0.00,0.00,0,0,0,0,0,0,0,0,0,0,0,0,0
20200520,054357,可成兆豐97購02,,,,,0.00,0.00,0,0,0,0,0,0,0,0,0,0,0,0,0
20200520,054358,矽創兆豐96購01,0.55,0.55,0.54,0.54,+0.06,12.5,41000,4,22190,0,0,0,0,0,0,31000,5000,26000,26000
20200520,054359,南亞科日盛96購02,,,,,0.00,0.00,0,0,0,0,0,0,0,0,0,0,0,0,0
20200520,05435P,鴻海群益95售12,,,,,0.00,0.00,0,0,0,0,0,0,0,0,0,0,0,0,0
20200520,054360,智邦凱基96購03,,,,,0.00,0.00,0,0,0,0,0,0,0,0,0,0,0,0,0
20200520,054361,技嘉凱基96購01,1.85,1.85,1.73,1.74,-0.11,-5.95,15000,6,27290,0,0,0,0,0,0,0,15000,-15000,-15000
20200520,054362,亞光凱基96購03,,,,,0.00,0.00,0,0,0,0,0,0,0,0,0,0,0,0,0
20200520,054363,世芯凱基97購01,7.10,7.50,6.30,6.30,-0.95,-13.1,244000,34,1757700,0,0,0,0,0,0,213000,31000,182000,182000
20200520,054364,智伸科凱基96購01,,,,,0.00,0.00,0,0,0,0,0,0,0,0,0,0,0,0,0
20200520,054365,遠東新中信96購01,0.12,0.13,0.12,0.13,0.00,0.00,153000,3,18370,0,0,0,0,0,0,52000,101000,-49000,-49000
20200520,054366,和大中信98購01,,,,,0.00,0.00,0,0,0,0,0,0,0,0,0,0,0,0,0
20200520,054367,鴻海中信98購03,,,,,0.00,0.00,0,0,0,0,0,0,0,0,0,0,0,0,0
20200520,054368,鴻海中信9A購02,0.07,0.09,0.06,0.06,+0.01,20.0,17000,3,1200,0,0,0,0,0,0,0,0,0,0
20200520,054369,鴻海中信9C購01,0.17,0.17,0.15,0.15,0.00,0.00,445000,24,70130,0,0,0,0,0,0,0,0,0,0
20200520,05436P,台積電群益95售07,,,,,0.00,0.00,0,0,0,0,0,0,0,0,0,0,0,0,0
20200520,054370,台積電中信9A購01,0.28,0.28,0.28,0.28,0.00,0.00,5000,1,1400,0,0,0,0,0,0,0,0,0,0
20200520,054371,台積電中信9C購01,0.55,0.55,0.55,0.55,+0.20,57.14,2000,1,1100,0,0,0,0,0,0,0,0,0,0
20200520,054372,南亞科中信96購01,,,,,0.00,0.00,0,0,0,0,0,0,0,0,0,0,0,0,0
20200520,054373,富邦金中信97購01,0.49,0.49,0.49,0.49,-0.02,-3.92,49000,1,24010,0,0,0,0,0,0,49000,0,49000,49000
20200520,054374,信邦中信96購01,0.53,0.62,0.49,0.49,-0.02,-3.92,287000,31,157980,0,0,0,0,0,0,97000,190000,-93000,-93000
20200520,054375,貿聯中信99購01,,,,,0.00,0.00,0,0,0,0,0,0,0,0,0,0,0,0,0
20200520,054376,聯茂中信97購01,0.20,0.20,0.20,0.20,-0.02,-9.09,5000,1,1000,0,0,0,0,0,0,5000,0,5000,5000
20200520,054377,臺股指中信99購09,0.14,0.14,0.12,0.14,+0.01,7.69,264000,10,36900,0,0,0,0,0,0,0,0,0,0
20200520,054378,楠梓電群益98購01,1.42,1.42,1.32,1.36,0.00,0.00,398000,4,531680,0,0,0,0,0,0,83000,398000,-315000,-315000
20200520,054379,光磊群益98購01,,,,,0.00,0.00,0,0,0,0,0,0,0,0,0,0,0,0,0
20200520,05437P,聯詠永豐95售02,,,,,0.00,0.00,0,0,0,0,0,0,0,0,0,0,0,0,0
20200520,054380,世芯群益97購02,,,,,0.00,0.00,0,0,0,0,0,0,0,0,0,0,0,0,0
20200520,054381,世芯群益98購01,5.30,5.55,4.86,4.86,-0.64,-11.64,219000,12,1183600,0,0,0,0,0,0,187000,32000,155000,155000
20200520,054382,康控群益96購03,,,,,0.00,0.00,0,0,0,0,0,0,0,0,0,0,0,0,0
20200520,054383,傳奇群益97購01,0.17,0.17,0.16,0.16,-0.02,-11.11,858000,4,145660,0,0,0,0,0,0,858000,0,858000,858000
20200520,054384,瀚宇博群益96購02,0.63,0.63,0.63,0.63,0.00,0.00,11000,1,6930,0,0,0,0,0,0,0,11000,-11000,-11000
20200520,054385,矽創群益98購01,,,,,0.00,0.00,0,0,0,0,0,0,0,0,0,0,0,0,0
20200520,054386,鴻海統一98購03,,,,,0.00,0.00,0,0,0,0,0,0,0,0,0,0,0,0,0
20200520,054387,台積電統一98購02,,,,,0.00,0.00,0,0,0,0,0,0,0,0,0,0,0,0,0
20200520,054388,漢唐統一97購02,,,,,0.00,0.00,0,0,0,0,0,0,0,0,0,0,0,0,0
20200520,054389,為升元富96購02,0.01,0.01,0.01,0.01,0.00,0.00,40000,1,400,0,0,0,0,0,0,40000,0,40000,40000
20200520,05438P,康控永豐95售05,,,,,0.00,0.00,0,0,0,0,0,0,0,0,0,0,0,0,0
20200520,054390,智邦元富96購03,,,,,0.00,0.00,0,0,0,0,0,0,0,0,0,0,0,0,0
20200520,054391,宏達電元富96購04,,,,,0.00,0.00,0,0,0,0,0,0,0,0,0,0,0,0,0
20200520,054392,華通永豐96購05,,,,,0.00,0.00,0,0,0,0,0,0,0,0,0,0,0,0,0
20200520,054393,漢唐永豐96購01,,,,,0.00,0.00,0,0,0,0,0,0,0,0,0,0,0,0,0
20200520,054394,奇力新永豐96購03,,,,,0.00,0.00,0,0,0,0,0,0,0,0,0,0,0,0,0
20200520,054395,華新科永豐96購03,0.01,0.01,0.01,0.01,0.00,0.00,60000,1,600,0,0,0,0,0,0,60000,0,60000,60000
20200520,054396,日電貿永豐96購02,0.04,0.04,0.04,0.04,0.00,0.00,5000,1,200,0,0,0,0,0,0,5000,0,5000,5000
20200520,054397,創意永豐96購05,,,,,0.00,0.00,0,0,0,0,0,0,0,0,0,0,0,0,0
20200520,054398,牧德永豐96購03,,,,,0.00,0.00,0,0,0,0,0,0,0,0,0,0,0,0,0
20200520,054399,智易永豐96購03,,,,,0.00,0.00,0,0,0,0,0,0,0,0,0,0,0,0,0
20200520,05439P,聯發科國票95售06,,,,,0.00,0.00,0,0,0,0,0,0,0,0,0,0,0,0,0
20200520,054400,健策永豐96購02,,,,,0.00,0.00,0,0,0,0,0,0,0,0,0,0,0,0,0
20200520,054401,康普永豐96購01,,,,,0.00,0.00,0,0,0,0,0,0,0,0,0,0,0,0,0
20200520,054402,康控永豐96購03,,,,,0.00,0.00,0,0,0,0,0,0,0,0,0,0,0,0,0
20200520,054403,同欣電永豐96購02,0.12,0.12,0.11,0.11,-0.01,-8.33,135000,2,15450,0,0,0,0,0,0,75000,60000,15000,15000
20200520,054404,新日興康和96購01,,,,,0.00,0.00,0,0,0,0,0,0,0,0,0,0,0,0,0
20200520,054405,樺漢康和96購01,,,,,0.00,0.00,0,0,0,0,0,0,0,0,0,0,0,0,0
20200520,054406,旺宏國票98購01,,,,,0.00,0.00,0,0,0,0,0,0,0,0,0,0,0,0,0
20200520,054407,美律國票97購02,,,,,0.00,0.00,0,0,0,0,0,0,0,0,0,0,0,0,0
20200520,054408,義隆國票98購01,,,,,0.00,0.00,0,0,0,0,0,0,0,0,0,0,0,0,0
20200520,054409,亞光國票97購02,,,,,0.00,0.00,0,0,0,0,0,0,0,0,0,0,0,0,0
20200520,05440P,緯穎國票96售02,,,,,0.00,0.00,0,0,0,0,0,0,0,0,0,0,0,0,0
20200520,054410,國巨元大96購14,,,,,0.00,0.00,0,0,0,0,0,0,0,0,0,0,0,0,0
20200520,054411,光磊元大97購02,0.66,0.74,0.66,0.74,+0.06,8.82,366000,14,255420,0,0,0,0,0,0,98000,268000,-170000,-170000
20200520,054412,智邦元大96購03,,,,,0.00,0.00,0,0,0,0,0,0,0,0,0,0,0,0,0
20200520,054413,台光電元大96購03,1.87,1.87,1.87,1.87,-0.20,-9.66,20000,2,37400,0,0,0,0,0,0,10000,10000,0,0
20200520,054414,全新元大97購02,,,,,0.00,0.00,0,0,0,0,0,0,0,0,0,0,0,0,0
20200520,054415,奇力新元大96購06,,,,,0.00,0.00,0,0,0,0,0,0,0,0,0,0,0,0,0
20200520,054416,禾伸堂元大97購01,4.31,4.31,4.31,4.31,0.00,0.00,9000,1,38790,0,0,0,0,0,0,0,9000,-9000,-9000
20200520,054417,牧德元大96購01,1.30,1.30,1.30,1.30,0.00,0.00,10000,1,13000,0,0,0,0,0,0,10000,0,10000,10000
20200520,054418,茂林元大97購01,2.18,2.62,2.18,2.55,+0.37,16.97,162000,11,393430,0,0,0,0,0,0,50000,112000,-62000,-62000
20200520,054419,嘉聯益元大98購02,,,,,0.00,0.00,0,0,0,0,0,0,0,0,0,0,0,0,0
20200520,05441P,華通元大95售09,,,,,0.00,0.00,0,0,0,0,0,0,0,0,0,0,0,0,0
20200520,054420,緯穎元大96購08,7.55,8.00,6.60,6.60,-0.50,-7.04,130000,14,955050,0,0,0,0,0,0,80000,60000,20000,20000
20200520,054421,臺股指元大99購03,,,,,0.00,0.00,0,0,0,0,0,0,0,0,0,0,0,0,0
20200520,054422,T50反1富邦9A購01,,,,,0.00,0.00,0,0,0,0,0,0,0,0,0,0,0,0,0
20200520,054423,華新富邦96購01,,,,,0.00,0.00,0,0,0,0,0,0,0,0,0,0,0,0,0
20200520,054424,大成鋼富邦97購02,,,,,0.00,0.00,0,0,0,0,0,0,0,0,0,0,0,0,0
20200520,054425,聯發科富邦99購03,0.95,1.19,0.95,1.05,+0.06,6.06,581000,32,615200,355000,0,355000,0,0,0,165000,28000,137000,492000
20200520,054426,國泰金富邦97購02,0.31,0.32,0.31,0.31,+0.01,3.33,387000,12,122270,0,0,0,0,0,0,77000,310000,-233000,-233000
20200520,054427,潤泰全富邦97購01,0.45,0.45,0.45,0.45,-0.06,-11.76,2000,1,900,0,0,0,0,0,0,2000,0,2000,2000
20200520,054428,禾伸堂富邦98購01,0.75,0.75,0.72,0.72,+0.03,4.35,35000,4,25650,0,0,0,0,0,0,35000,0,35000,35000
20200520,054429,中石化台新97購01,,,,,0.00,0.00,0,0,0,0,0,0,0,0,0,0,0,0,0
20200520,05442P,鴻海元大96售13,3.57,3.57,3.43,3.43,-0.21,-5.77,15000,3,52850,0,0,0,0,0,0,15000,5000,10000,10000
20200520,054430,上銀台新96購02,,,,,0.00,0.00,0,0,0,0,0,0,0,0,0,0,0,0,0
20200520,054431,鴻海台新96購03,,,,,0.00,0.00,0,0,0,0,0,0,0,0,0,0,0,0,0
20200520,054432,台積電台新96購05,,,,,0.00,0.00,0,0,0,0,0,0,0,0,0,0,0,0,0
20200520,054433,南亞科台新96購02,,,,,0.00,0.00,0,0,0,0,0,0,0,0,0,0,0,0,0
20200520,054434,友達台新96購03,,,,,0.00,0.00,0,0,0,0,0,0,0,0,0,0,0,0,0
20200520,054435,華新科台新97購02,,,,,0.00,0.00,0,0,0,0,0,0,0,0,0,0,0,0,0
20200520,054436,高鐵台新97購02,,,,,0.00,0.00,0,0,0,0,0,0,0,0,0,0,0,0,0
20200520,054437,欣興台新97購02,,,,,0.00,0.00,0,0,0,0,0,0,0,0,0,0,0,0,0
20200520,054438,群創台新96購01,,,,,0.00,0.00,0,0,0,0,0,0,0,0,0,0,0,0,0
20200520,054439,健策台新96購03,0.62,0.62,0.56,0.56,0.00,0.00,22000,2,13520,0,0,0,0,0,0,0,22000,-22000,-22000
20200520,05443P,宏達電元大95售05,,,,,0.00,0.00,0,0,0,0,0,0,0,0,0,0,0,0,0
20200520,054440,TPK台新98購01,,,,,0.00,0.00,0,0,0,0,0,0,0,0,0,0,0,0,0
20200520,054441,力成台新96購01,,,,,0.00,0.00,0,0,0,0,0,0,0,0,0,0,0,0,0
20200520,054442,啟碁台新96購01,,,,,0.00,0.00,0,0,0,0,0,0,0,0,0,0,0,0,0
20200520,054443,樺漢台新96購02,,,,,0.00,0.00,0,0,0,0,0,0,0,0,0,0,0,0,0
20200520,054444,緯穎台新97購01,,,,,0.00,0.00,0,0,0,0,0,0,0,0,0,0,0,0,0
20200520,054445,技嘉兆豐96購01,3.95,3.95,3.95,3.95,-0.49,-11.04,10000,1,39500,0,0,0,0,0,0,10000,0,10000,10000
20200520,054446,美食兆豐97購01,0.28,0.28,0.24,0.25,+0.02,8.7,330000,29,82900,0,0,0,0,0,0,330000,0,330000,330000
20200520,054447,國泰金兆豐96購01,,,,,0.00,0.00,0,0,0,0,0,0,0,0,0,0,0,0,0
20200520,054448,矽力兆豐96購01,,,,,0.00,0.00,0,0,0,0,0,0,0,0,0,0,0,0,0
20200520,054449,中環第一96購01,,,,,0.00,0.00,0,0,0,0,0,0,0,0,0,0,0,0,0
20200520,05444P,大立光元大95售10,,,,,0.00,0.00,0,0,0,0,0,0,0,0,0,0,0,0,0
20200520,054450,聯茂第一96購01,,,,,0.00,0.00,0,0,0,0,0,0,0,0,0,0,0,0,0
20200520,054451,上銀亞東98購01,,,,,0.00,0.00,0,0,0,0,0,0,0,0,0,0,0,0,0
20200520,054452,華通亞東96購01,,,,,0.00,0.00,0,0,0,0,0,0,0,0,0,0,0,0,0
20200520,054453,上海銀亞東96購01,,,,,0.00,0.00,0,0,0,0,0,0,0,0,0,0,0,0,0
20200520,054454,滬深2X群益96購04,,,,,0.00,0.00,0,0,0,0,0,0,0,0,0,0,0,0,0
20200520,054455,楠梓電群益98購02,0.91,0.91,0.91,0.91,0.00,0.00,83000,1,75530,0,0,0,0,0,0,83000,83000,0,0
20200520,054456,華泰群益99購01,0.10,0.10,0.10,0.10,0.00,0.00,4000,1,400,0,0,0,0,0,0,4000,0,4000,4000
20200520,054457,強茂群益96購01,0.74,0.80,0.74,0.75,+0.06,8.7,383000,5,290970,0,0,0,0,0,0,98000,285000,-187000,-187000
20200520,054458,復盛群益96購01,0.49,0.86,0.49,0.86,+0.34,65.38,561000,17,311530,0,0,0,0,0,0,100000,460000,-360000,-360000
20200520,054459,鈺齊群益96購01,,,,,0.00,0.00,0,0,0,0,0,0,0,0,0,0,0,0,0
20200520,05445P,聯詠元大95售05,,,,,0.00,0.00,0,0,0,0,0,0,0,0,0,0,0,0,0
20200520,054460,和大凱基97購01,,,,,0.00,0.00,0,0,0,0,0,0,0,0,0,0,0,0,0
20200520,054461,台積電凱基97購09,,,,,0.00,0.00,0,0,0,0,0,0,0,0,0,0,0,0,0
20200520,054462,旺宏凱基96購08,,,,,0.00,0.00,0,0,0,0,0,0,0,0,0,0,0,0,0
20200520,054463,瑞昱凱基97購01,5.75,5.80,5.75,5.80,-0.20,-3.33,48000,9,276500,0,0,0,0,0,0,48000,0,48000,48000
20200520,054464,奇力新凱基98購02,,,,,0.00,0.00,0,0,0,0,0,0,0,0,0,0,0,0,0
20200520,054465,亞光凱基97購01,,,,,0.00,0.00,0,0,0,0,0,0,0,0,0,0,0,0,0
20200520,054466,欣興凱基97購03,1.60,1.67,1.60,1.67,+0.45,36.89,21000,2,34370,0,0,0,0,0,0,10000,11000,-1000,-1000
20200520,054467,隆達凱基97購01,0.78,1.10,0.78,1.10,+0.40,57.14,241000,19,201730,0,0,0,0,0,0,104000,106000,-2000,-2000
20200520,054468,台郡凱基98購01,,,,,0.00,0.00,0,0,0,0,0,0,0,0,0,0,0,0,0
20200520,054469,同欣電凱基97購01,,,,,0.00,0.00,0,0,0,0,0,0,0,0,0,0,0,0,0
20200520,05446P,緯穎元大95售04,,,,,0.00,0.00,0,0,0,0,0,0,0,0,0,0,0,0,0
20200520,054470,緯穎國票97購04,18.70,18.70,16.30,16.30,-1.60,-8.94,10000,5,176500,0,0,0,0,0,0,8000,2000,6000,6000
20200520,054471,T50反1中信9C購01,1.97,1.99,1.97,1.99,-0.01,-0.5,104000,5,205320,0,0,0,0,0,0,80000,24000,56000,56000
20200520,054472,道瓊反中信9A購01,,,,,0.00,0.00,0,0,0,0,0,0,0,0,0,0,0,0,0
20200520,054473,鴻海中信96購02,,,,,0.00,0.00,0,0,0,0,0,0,0,0,0,0,0,0,0
20200520,054474,鴻海中信96購03,,,,,0.00,0.00,0,0,0,0,0,0,0,0,0,0,0,0,0
20200520,054475,鴻海中信96購04,,,,,0.00,0.00,0,0,0,0,0,0,0,0,0,0,0,0,0
20200520,054476,聯發科中信96購03,0.01,0.03,0.01,0.03,+0.02,200.0,938000,6,27740,0,0,0,0,0,0,918000,0,918000,918000
20200520,054477,聯發科中信9C購02,0.69,0.69,0.54,0.58,-0.03,-4.92,802000,12,446560,0,0,0,0,0,0,750000,1000,749000,749000
20200520,054478,可成中信97購01,,,,,0.00,0.00,0,0,0,0,0,0,0,0,0,0,0,0,0
20200520,054479,緯創中信98購01,2.78,2.79,2.72,2.72,-0.01,-0.37,93000,12,256900,0,0,0,0,0,0,83000,10000,73000,73000
20200520,05447P,臺股指元大95售24,,,,,0.00,0.00,0,0,0,0,0,0,0,0,0,0,0,0,0
20200520,054480,和碩中信98購01,,,,,0.00,0.00,0,0,0,0,0,0,0,0,0,0,0,0,0
20200520,054481,鎧勝中信96購01,0.65,0.65,0.65,0.65,+0.03,4.84,117000,1,76050,0,0,0,0,0,0,117000,117000,0,0
20200520,054482,大成鋼台新96購01,,,,,0.00,0.00,0,0,0,0,0,0,0,0,0,0,0,0,0
20200520,054483,聯電台新96購01,,,,,0.00,0.00,0,0,0,0,0,0,0,0,0,0,0,0,0
20200520,054484,仁寶台新96購01,,,,,0.00,0.00,0,0,0,0,0,0,0,0,0,0,0,0,0
20200520,054485,華邦電台新96購01,,,,,0.00,0.00,0,0,0,0,0,0,0,0,0,0,0,0,0
20200520,054486,漢唐台新96購01,,,,,0.00,0.00,0,0,0,0,0,0,0,0,0,0,0,0,0
20200520,054487,京元電台新97購01,,,,,0.00,0.00,0,0,0,0,0,0,0,0,0,0,0,0,0
20200520,054488,禾伸堂台新96購01,,,,,0.00,0.00,0,0,0,0,0,0,0,0,0,0,0,0,0
20200520,054489,牧德台新97購02,,,,,0.00,0.00,0,0,0,0,0,0,0,0,0,0,0,0,0
20200520,05448P,臺股指元大95售25,,,,,0.00,0.00,0,0,0,0,0,0,0,0,0,0,0,0,0
20200520,054490,臻鼎台新96購02,,,,,0.00,0.00,0,0,0,0,0,0,0,0,0,0,0,0,0
20200520,054491,瀚宇博台新96購02,,,,,0.00,0.00,0,0,0,0,0,0,0,0,0,0,0,0,0
20200520,054492,嘉聯益台新96購01,,,,,0.00,0.00,0,0,0,0,0,0,0,0,0,0,0,0,0
20200520,054493,同欣電台新96購01,,,,,0.00,0.00,0,0,0,0,0,0,0,0,0,0,0,0,0
20200520,054494,訊芯台新96購01,,,,,0.00,0.00,0,0,0,0,0,0,0,0,0,0,0,0,0
20200520,054495,滬深2X永豐97購02,,,,,0.00,0.00,0,0,0,0,0,0,0,0,0,0,0,0,0
20200520,054496,為升永豐96購01,,,,,0.00,0.00,0,0,0,0,0,0,0,0,0,0,0,0,0
20200520,054497,國巨永豐96購05,,,,,0.00,0.00,0,0,0,0,0,0,0,0,0,0,0,0,0
20200520,054498,燿華永豐96購06,,,,,0.00,0.00,0,0,0,0,0,0,0,0,0,0,0,0,0
20200520,054499,台光電永豐96購02,0.22,0.22,0.22,0.22,-0.02,-8.33,498000,1,109560,0,0,0,0,0,0,498000,0,498000,498000
20200520,05449P,臺股指元大95售26,1.07,1.07,1.07,1.07,0.00,0.00,1000,1,1070,0,0,0,0,0,0,1000,0,1000,1000
20200520,054500,美律永豐96購02,,,,,0.00,0.00,0,0,0,0,0,0,0,0,0,0,0,0,0
20200520,054501,強茂永豐96購02,,,,,0.00,0.00,0,0,0,0,0,0,0,0,0,0,0,0,0
20200520,054502,泰碩永豐96購01,0.25,0.25,0.25,0.25,-0.04,-13.79,5000,1,1250,0,0,0,0,0,0,5000,0,5000,5000
20200520,054503,京鼎永豐96購04,,,,,0.00,0.00,0,0,0,0,0,0,0,0,0,0,0,0,0
20200520,054504,聯鈞永豐96購01,0.17,0.17,0.17,0.17,-0.03,-15.0,3000,1,510,0,0,0,0,0,0,3000,0,3000,3000
20200520,054505,揚明光永豐97購02,,,,,0.00,0.00,0,0,0,0,0,0,0,0,0,0,0,0,0
20200520,054506,矽格永豐96購01,0.12,0.14,0.11,0.14,0.00,0.00,40000,3,4900,0,0,0,0,0,0,0,40000,-40000,-40000
20200520,054507,鈺齊永豐96購01,,,,,0.00,0.00,0,0,0,0,0,0,0,0,0,0,0,0,0
20200520,054508,臺股指永豐96購04,0.01,0.01,0.01,0.01,0.00,0.00,30000,1,300,0,0,0,0,0,0,0,0,0,0
20200520,054509,上証反元大99購01,0.41,0.50,0.41,0.50,0.00,0.00,2000,2,910,0,0,0,0,0,0,1000,1000,0,0
20200520,05450P,臺股指元大95售27,,,,,0.00,0.00,0,0,0,0,0,0,0,0,0,0,0,0,0
20200520,054510,S&P反1元大98購01,,,,,0.00,0.00,0,0,0,0,0,0,0,0,0,0,0,0,0
20200520,054511,香港反元大98購01,,,,,0.00,0.00,0,0,0,0,0,0,0,0,0,0,0,0,0
20200520,054512,元油反元大99購03,,,,,0.00,0.00,0,0,0,0,0,0,0,0,0,0,0,0,0
20200520,054513,元金2X元大96購01,,,,,0.00,0.00,0,0,0,0,0,0,0,0,0,0,0,0,0
20200520,054514,道瓊銀元大98購01,0.68,0.70,0.68,0.70,+0.10,16.67,35000,4,24000,0,0,0,0,0,0,25000,0,25000,25000
20200520,054515,華通元大98購02,,,,,0.00,0.00,0,0,0,0,0,0,0,0,0,0,0,0,0
20200520,054516,國巨元大97購02,0.49,0.49,0.49,0.49,+0.05,11.36,6000,1,2940,0,0,0,0,0,0,6000,0,6000,6000
20200520,054517,高鐵元大96購01,0.38,0.38,0.35,0.35,0.00,0.00,218000,2,78340,0,0,0,0,0,0,0,218000,-218000,-218000
20200520,054518,亞光元大97購01,,,,,0.00,0.00,0,0,0,0,0,0,0,0,0,0,0,0,0
20200520,054519,禾伸堂元大97購02,1.73,1.73,1.67,1.67,0.00,0.00,20000,3,34000,0,0,0,0,0,0,20000,0,20000,20000
20200520,05451P,臺股指元大95售28,,,,,0.00,0.00,0,0,0,0,0,0,0,0,0,0,0,0,0
20200520,054520,健鼎元大96購02,,,,,0.00,0.00,0,0,0,0,0,0,0,0,0,0,0,0,0
20200520,054521,TPK元大96購03,,,,,0.00,0.00,0,0,0,0,0,0,0,0,0,0,0,0,0
20200520,054522,康友元大96購07,,,,,0.00,0.00,0,0,0,0,0,0,0,0,0,0,0,0,0
20200520,054523,GIS元大96購05,0.39,0.39,0.39,0.39,0.00,0.00,68000,1,26520,0,0,0,0,0,0,0,68000,-68000,-68000
20200520,054524,華通元富96購03,,,,,0.00,0.00,0,0,0,0,0,0,0,0,0,0,0,0,0
20200520,054525,奇鋐元富96購01,0.37,0.37,0.37,0.37,+0.01,2.78,23000,3,8510,0,0,0,0,0,0,0,23000,-23000,-23000
20200520,054526,道瓊反統一98購01,,,,,0.00,0.00,0,0,0,0,0,0,0,0,0,0,0,0,0
20200520,054527,國巨統一97購03,1.51,1.78,1.51,1.57,+0.17,12.14,313000,16,503820,0,0,0,0,0,0,153000,151000,2000,2000
20200520,054528,台光電統一96購02,1.07,1.07,1.01,1.01,-0.20,-16.53,554000,23,585490,0,0,0,0,0,0,495000,59000,436000,436000
20200520,054529,T50反1國泰97購02,,,,,0.00,0.00,0,0,0,0,0,0,0,0,0,0,0,0,0
20200520,05452P,亞德客群益95售02,,,,,0.00,0.00,0,0,0,0,0,0,0,0,0,0,0,0,0
20200520,054530,台光電國泰97購03,2.11,2.12,2.02,2.12,-0.35,-14.17,80000,11,166290,0,0,0,0,0,0,80000,0,80000,80000
20200520,054531,聯發科國泰97購02,3.07,3.40,2.99,3.38,+0.49,16.96,235000,31,743120,0,0,0,0,0,0,207000,17000,190000,190000
20200520,054532,強茂國泰98購01,0.43,0.43,0.43,0.43,+0.05,13.16,1000,1,430,0,0,0,0,0,0,0,1000,-1000,-1000
20200520,054533,泰碩國泰98購01,1.10,1.10,1.02,1.02,-0.08,-7.27,190000,10,201390,0,0,0,0,0,0,180000,36000,144000,144000
20200520,054534,台積電富邦98購03,0.04,0.04,0.04,0.04,0.00,0.00,100000,1,4000,0,0,0,0,0,0,100000,0,100000,100000
20200520,054535,旺宏富邦97購02,,,,,0.00,0.00,0,0,0,0,0,0,0,0,0,0,0,0,0
20200520,054536,宏達電富邦97購03,,,,,0.00,0.00,0,0,0,0,0,0,0,0,0,0,0,0,0
20200520,054537,南亞科亞東97購01,,,,,0.00,0.00,0,0,0,0,0,0,0,0,0,0,0,0,0
20200520,054538,台光電國票98購01,,,,,0.00,0.00,0,0,0,0,0,0,0,0,0,0,0,0,0
20200520,054539,欣興國票98購01,,,,,0.00,0.00,0,0,0,0,0,0,0,0,0,0,0,0,0
20200520,05453P,智邦群益95售03,,,,,0.00,0.00,0,0,0,0,0,0,0,0,0,0,0,0,0
20200520,054540,泰鼎國票99購01,2.74,3.23,2.60,3.23,+0.33,11.38,656000,35,1948500,0,0,0,0,0,0,127000,519000,-392000,-392000
20200520,054541,康控國票98購01,,,,,0.00,0.00,0,0,0,0,0,0,0,0,0,0,0,0,0
20200520,054542,台表科國票98購01,0.62,0.90,0.62,0.90,+0.34,60.71,3000,3,2250,0,0,0,0,0,0,3000,0,3000,3000
20200520,054543,元金2X中信01購01,,,,,0.00,0.00,0,0,0,0,0,0,0,0,0,0,0,0,0
20200520,054544,統一中信97購01,0.04,0.04,0.04,0.04,0.00,0.00,5000,1,200,0,0,0,0,0,0,0,0,0,0
20200520,054545,奇力新中信98購01,,,,,0.00,0.00,0,0,0,0,0,0,0,0,0,0,0,0,0
20200520,054546,玉晶光中信9B購01,0.20,0.22,0.19,0.22,+0.02,10.0,3005000,68,608750,0,0,0,0,0,0,1136000,1506000,-370000,-370000
20200520,054547,鴻海凱基98購02,,,,,0.00,0.00,0,0,0,0,0,0,0,0,0,0,0,0,0
20200520,054548,鴻海凱基98購03,,,,,0.00,0.00,0,0,0,0,0,0,0,0,0,0,0,0,0
20200520,054549,台積電凱基98購01,,,,,0.00,0.00,0,0,0,0,0,0,0,0,0,0,0,0,0
20200520,05454P,奇鋐群益95售04,,,,,0.00,0.00,0,0,0,0,0,0,0,0,0,0,0,0,0
20200520,054550,旺宏凱基98購02,0.66,0.66,0.63,0.64,0.00,0.00,21000,3,13310,0,0,0,0,0,0,0,21000,-21000,-21000
20200520,054551,聯發科凱基98購02,,,,,0.00,0.00,0,0,0,0,0,0,0,0,0,0,0,0,0
20200520,054552,聯發科凱基98購03,0.45,0.50,0.45,0.50,+0.19,61.29,109000,4,53000,0,0,0,0,0,0,30000,0,30000,30000
20200520,054553,宏達電凱基99購01,,,,,0.00,0.00,0,0,0,0,0,0,0,0,0,0,0,0,0
20200520,054554,大立光凱基98購02,,,,,0.00,0.00,0,0,0,0,0,0,0,0,0,0,0,0,0
20200520,054555,欣興凱基98購01,,,,,0.00,0.00,0,0,0,0,0,0,0,0,0,0,0,0,0
20200520,054556,世芯凱基99購01,0.96,0.96,0.80,0.81,-0.39,-32.5,126000,15,107030,0,0,0,0,0,0,50000,49000,1000,1000
20200520,054557,臻鼎凱基98購01,,,,,0.00,0.00,0,0,0,0,0,0,0,0,0,0,0,0,0
20200520,054558,劍麟群益99購01,0.19,0.19,0.19,0.19,+0.01,5.56,1000,1,190,0,0,0,0,0,0,0,1000,-1000,-1000
20200520,054559,台光電群益99購01,2.27,2.27,2.27,2.27,-0.21,-8.47,24000,1,54480,0,0,0,0,0,0,24000,0,24000,24000
20200520,05455P,聯詠日盛95售01,,,,,0.00,0.00,0,0,0,0,0,0,0,0,0,0,0,0,0
20200520,054560,全新群益98購03,,,,,0.00,0.00,0,0,0,0,0,0,0,0,0,0,0,0,0
20200520,054561,奇力新群益97購03,,,,,0.00,0.00,0,0,0,0,0,0,0,0,0,0,0,0,0
20200520,054562,亞光群益98購01,,,,,0.00,0.00,0,0,0,0,0,0,0,0,0,0,0,0,0
20200520,054563,泰碩群益99購01,0.82,0.82,0.75,0.75,-0.07,-8.54,70000,4,54800,0,0,0,0,0,0,0,70000,-70000,-70000
20200520,054564,玉晶光群益99購01,,,,,0.00,0.00,0,0,0,0,0,0,0,0,0,0,0,0,0
20200520,054565,玉晶光群益99購02,,,,,0.00,0.00,0,0,0,0,0,0,0,0,0,0,0,0,0
20200520,054566,貿聯群益97購02,,,,,0.00,0.00,0,0,0,0,0,0,0,0,0,0,0,0,0
20200520,054567,拓凱群益98購01,0.22,0.44,0.22,0.44,+0.22,100.0,5024000,159,1557810,0,0,0,0,0,0,2332000,2367000,-35000,-35000
20200520,054568,訊芯群益97購01,,,,,0.00,0.00,0,0,0,0,0,0,0,0,0,0,0,0,0
20200520,054569,GIS群益98購01,,,,,0.00,0.00,0,0,0,0,0,0,0,0,0,0,0,0,0
20200520,05456P,鴻海凱基95售19,0.11,0.11,0.11,0.11,-0.03,-21.43,51000,1,5610,0,0,0,0,0,0,51000,51000,0,0
20200520,054570,易華電群益98購01,,,,,0.00,0.00,0,0,0,0,0,0,0,0,0,0,0,0,0
20200520,054571,楠梓電元大99購01,,,,,0.00,0.00,0,0,0,0,0,0,0,0,0,0,0,0,0
20200520,054572,國巨元大98購03,0.91,0.96,0.86,0.86,0.00,0.00,51000,6,47660,0,0,0,0,0,0,0,51000,-51000,-51000
20200520,054573,漢唐元大98購01,,,,,0.00,0.00,0,0,0,0,0,0,0,0,0,0,0,0,0
20200520,054574,美律元大99購01,,,,,0.00,0.00,0,0,0,0,0,0,0,0,0,0,0,0,0
20200520,054575,聯鈞元大97購01,0.89,0.89,0.83,0.83,0.00,0.00,9000,2,7770,0,0,0,0,0,0,0,9000,-9000,-9000
20200520,054576,健策元大98購03,,,,,0.00,0.00,0,0,0,0,0,0,0,0,0,0,0,0,0
20200520,054577,世芯元大98購01,1.85,1.85,1.85,1.85,-0.25,-11.9,12000,2,22200,0,0,0,0,0,0,12000,0,12000,12000
20200520,054578,世芯元大99購01,2.06,2.11,2.06,2.11,-0.10,-4.52,127000,3,266610,0,0,0,0,0,0,124000,124000,0,0
20200520,054579,聯茂元大97購01,2.12,2.12,2.08,2.08,+0.07,3.48,54000,2,112480,0,0,0,0,0,0,4000,50000,-46000,-46000
20200520,05457P,鴻海凱基95售20,,,,,0.00,0.00,0,0,0,0,0,0,0,0,0,0,0,0,0
20200520,054580,樺漢元大98購01,,,,,0.00,0.00,0,0,0,0,0,0,0,0,0,0,0,0,0
20200520,054581,訊芯元大97購02,,,,,0.00,0.00,0,0,0,0,0,0,0,0,0,0,0,0,0
20200520,054582,致新元大97購01,2.03,2.03,1.88,1.88,+0.09,5.03,151000,12,293780,0,0,0,0,0,0,125000,26000,99000,99000
20200520,054583,玉晶光統一97購02,,,,,0.00,0.00,0,0,0,0,0,0,0,0,0,0,0,0,0
20200520,054584,貿聯元富97購01,0.30,0.30,0.30,0.30,-0.52,-63.41,2000,1,600,0,0,0,0,0,0,0,2000,-2000,-2000
20200520,054585,禾伸堂國泰99購01,,,,,0.00,0.00,0,0,0,0,0,0,0,0,0,0,0,0,0
20200520,054586,健鼎國泰99購01,,,,,0.00,0.00,0,0,0,0,0,0,0,0,0,0,0,0,0
20200520,054587,玉晶光國泰99購01,0.77,0.77,0.77,0.77,0.00,0.00,1000,1,770,0,0,0,0,0,0,0,1000,-1000,-1000
20200520,054588,玉晶光國泰99購02,,,,,0.00,0.00,0,0,0,0,0,0,0,0,0,0,0,0,0
20200520,054589,聯鈞國泰99購01,,,,,0.00,0.00,0,0,0,0,0,0,0,0,0,0,0,0,0
20200520,05458P,台積電凱基97售02,0.83,0.83,0.83,0.83,0.00,0.00,121000,1,100430,0,0,0,0,0,0,121000,121000,0,0
20200520,054590,嘉聯益國泰98購01,,,,,0.00,0.00,0,0,0,0,0,0,0,0,0,0,0,0,0
20200520,054591,GIS國泰98購01,,,,,0.00,0.00,0,0,0,0,0,0,0,0,0,0,0,0,0
20200520,054592,美律永昌9A購01,,,,,0.00,0.00,0,0,0,0,0,0,0,0,0,0,0,0,0
20200520,054593,滬深2X永昌9A購01,,,,,0.00,0.00,0,0,0,0,0,0,0,0,0,0,0,0,0
20200520,054594,國巨麥證97購01,,,,,0.00,0.00,0,0,0,0,0,0,0,0,0,0,0,0,0
20200520,054595,正崴麥證97購01,,,,,0.00,0.00,0,0,0,0,0,0,0,0,0,0,0,0,0
20200520,054596,聯發科麥證97購01,2.12,2.12,2.12,2.12,+0.31,17.13,3000,1,6360,0,3000,-3000,0,0,0,0,3000,-3000,-3000
20200520,054597,南亞台新97購01,,,,,0.00,0.00,0,0,0,0,0,0,0,0,0,0,0,0,0
20200520,054598,鴻海台新98購01,,,,,0.00,0.00,0,0,0,0,0,0,0,0,0,0,0,0,0
20200520,054599,正崴台新97購01,,,,,0.00,0.00,0,0,0,0,0,0,0,0,0,0,0,0,0
20200520,05459P,聯詠凱基95售03,,,,,0.00,0.00,0,0,0,0,0,0,0,0,0,0,0,0,0
20200520,054600,中壽台新97購01,0.01,0.01,0.01,0.01,0.00,0.00,152000,3,1520,0,0,0,0,0,0,0,0,0,0
20200520,054601,奇鋐台新98購01,,,,,0.00,0.00,0,0,0,0,0,0,0,0,0,0,0,0,0
20200520,054602,聯詠台新97購01,,,,,0.00,0.00,0,0,0,0,0,0,0,0,0,0,0,0,0
20200520,054603,智易台新98購01,,,,,0.00,0.00,0,0,0,0,0,0,0,0,0,0,0,0,0
20200520,054604,麗豐台新98購01,,,,,0.00,0.00,0,0,0,0,0,0,0,0,0,0,0,0,0
20200520,054605,鴻海永豐97購01,,,,,0.00,0.00,0,0,0,0,0,0,0,0,0,0,0,0,0
20200520,054606,台積電永豐97購02,,,,,0.00,0.00,0,0,0,0,0,0,0,0,0,0,0,0,0
20200520,054607,台積電永豐97購03,,,,,0.00,0.00,0,0,0,0,0,0,0,0,0,0,0,0,0
20200520,054608,致茂永豐97購01,,,,,0.00,0.00,0,0,0,0,0,0,0,0,0,0,0,0,0
20200520,054609,正崴永豐97購01,,,,,0.00,0.00,0,0,0,0,0,0,0,0,0,0,0,0,0
20200520,05460P,台郡凱基95售05,,,,,0.00,0.00,0,0,0,0,0,0,0,0,0,0,0,0,0
20200520,054610,聯發科永豐97購01,0.58,0.58,0.58,0.58,0.00,0.00,5000,3,2900,0,0,0,0,0,0,5000,0,5000,5000
20200520,054611,全新永豐97購01,,,,,0.00,0.00,0,0,0,0,0,0,0,0,0,0,0,0,0
20200520,054612,慧洋永豐97購01,,,,,0.00,0.00,0,0,0,0,0,0,0,0,0,0,0,0,0
20200520,054613,大立光永豐97購02,,,,,0.00,0.00,0,0,0,0,0,0,0,0,0,0,0,0,0
20200520,054614,玉晶光永豐97購03,0.04,0.07,0.04,0.07,0.00,0.00,440000,2,18500,0,0,0,0,0,0,410000,30000,380000,380000
20200520,054615,牧德永豐98購01,,,,,0.00,0.00,0,0,0,0,0,0,0,0,0,0,0,0,0
20200520,054616,智伸科永豐97購01,,,,,0.00,0.00,0,0,0,0,0,0,0,0,0,0,0,0,0
20200520,054617,超眾永豐97購01,,,,,0.00,0.00,0,0,0,0,0,0,0,0,0,0,0,0,0
20200520,054618,訊芯永豐97購01,,,,,0.00,0.00,0,0,0,0,0,0,0,0,0,0,0,0,0
20200520,054619,昇陽半永豐97購03,,,,,0.00,0.00,0,0,0,0,0,0,0,0,0,0,0,0,0
20200520,05461P,台積電亞東97售01,,,,,0.00,0.00,0,0,0,0,0,0,0,0,0,0,0,0,0
20200520,054620,南茂永豐97購01,,,,,0.00,0.00,0,0,0,0,0,0,0,0,0,0,0,0,0
20200520,054621,華新科兆豐98購01,0.11,0.11,0.11,0.11,0.00,0.00,10000,1,1100,0,0,0,0,0,0,0,10000,-10000,-10000
20200520,054622,漢唐第一97購01,,,,,0.00,0.00,0,0,0,0,0,0,0,0,0,0,0,0,0
20200520,054623,華新科第一97購01,0.04,0.08,0.04,0.08,0.00,0.00,38000,3,1560,0,0,0,0,0,0,0,0,0,0
20200520,054624,台積電凱基98購03,0.23,0.23,0.15,0.15,+0.01,7.14,8000,2,1440,0,0,0,0,0,0,0,8000,-8000,-8000
20200520,054625,旺宏凱基98購03,,,,,0.00,0.00,0,0,0,0,0,0,0,0,0,0,0,0,0
20200520,054626,建準凱基98購01,0.68,0.79,0.68,0.77,-0.08,-9.41,171000,8,130130,0,0,0,0,0,0,5000,162000,-157000,-157000
20200520,054627,義隆凱基98購01,0.57,0.57,0.57,0.57,+0.01,1.79,1000,1,570,0,0,0,0,0,0,1000,0,1000,1000
20200520,054628,可成凱基98購01,,,,,0.00,0.00,0,0,0,0,0,0,0,0,0,0,0,0,0
20200520,054629,華新科凱基98購01,,,,,0.00,0.00,0,0,0,0,0,0,0,0,0,0,0,0,0
20200520,05462P,美律亞東97售01,,,,,0.00,0.00,0,0,0,0,0,0,0,0,0,0,0,0,0
20200520,054630,聯鈞凱基98購01,,,,,0.00,0.00,0,0,0,0,0,0,0,0,0,0,0,0,0
20200520,054631,台郡凱基98購02,,,,,0.00,0.00,0,0,0,0,0,0,0,0,0,0,0,0,0
20200520,054632,緯穎凱基9A購01,1.53,1.53,1.40,1.40,-0.07,-4.76,23000,4,34290,0,0,0,0,0,0,0,20000,-20000,-20000
20200520,054633,臺股指凱基9A購02,,,,,0.00,0.00,0,0,0,0,0,0,0,0,0,0,0,0,0
20200520,054634,FB上証中信99購01,0.21,0.21,0.21,0.21,0.00,0.00,10000,1,2100,0,0,0,0,0,0,10000,0,10000,10000
20200520,054635,台達電中信98購01,,,,,0.00,0.00,0,0,0,0,0,0,0,0,0,0,0,0,0
20200520,054636,華通中信97購01,0.01,0.01,0.01,0.01,0.00,0.00,1001000,5,10010,0,0,0,0,0,0,1001000,0,1001000,1001000
20200520,054637,智邦中信98購01,,,,,0.00,0.00,0,0,0,0,0,0,0,0,0,0,0,0,0
20200520,054638,國泰金中信99購01,0.23,0.23,0.23,0.23,+0.01,4.55,60000,1,13800,0,0,0,0,0,0,60000,0,60000,60000
20200520,054639,台新金中信99購01,,,,,0.00,0.00,0,0,0,0,0,0,0,0,0,0,0,0,0
20200520,05463P,創意國票96售04,1.77,1.80,1.75,1.75,-0.06,-3.31,68000,5,121820,0,0,0,0,0,0,2000,66000,-64000,-64000
20200520,054640,健策中信9B購01,0.23,0.23,0.23,0.23,-0.02,-8.0,40000,2,9200,0,0,0,0,0,0,0,40000,-40000,-40000
20200520,054641,祥碩中信98購01,3.98,4.38,3.86,4.38,+0.61,16.18,66000,7,271130,0,0,0,0,0,0,45000,20000,25000,25000
20200520,054642,訊芯中信9A購01,0.04,0.04,0.04,0.04,0.00,0.00,20000,2,800,0,0,0,0,0,0,0,20000,-20000,-20000
20200520,054643,上証2X群益9B購01,,,,,0.00,0.00,0,0,0,0,0,0,0,0,0,0,0,0,0
20200520,054644,A50正2群益9B購01,0.19,0.19,0.19,0.19,0.00,0.00,100000,1,19000,0,0,0,0,0,0,100000,100000,0,0
20200520,054645,奇力新群益97購04,,,,,0.00,0.00,0,0,0,0,0,0,0,0,0,0,0,0,0
20200520,054646,華新科群益97購03,,,,,0.00,0.00,0,0,0,0,0,0,0,0,0,0,0,0,0
20200520,054647,禾伸堂群益99購01,,,,,0.00,0.00,0,0,0,0,0,0,0,0,0,0,0,0,0
20200520,054648,智原群益98購01,,,,,0.00,0.00,0,0,0,0,0,0,0,0,0,0,0,0,0
20200520,054649,聯茂群益97購01,,,,,0.00,0.00,0,0,0,0,0,0,0,0,0,0,0,0,0
20200520,05464P,華通康和95售02,,,,,0.00,0.00,0,0,0,0,0,0,0,0,0,0,0,0,0
20200520,054650,南亞麥證97購01,,,,,0.00,0.00,0,0,0,0,0,0,0,0,0,0,0,0,0
20200520,054651,台化麥證97購01,,,,,0.00,0.00,0,0,0,0,0,0,0,0,0,0,0,0,0
20200520,054652,裕隆麥證97購01,0.45,0.60,0.30,0.59,+0.14,31.11,266000,16,131120,0,0,0,0,0,0,0,0,0,0
20200520,054653,聯發科麥證97購02,,,,,0.00,0.00,0,0,0,0,0,0,0,0,0,0,0,0,0
20200520,054654,全新麥證99購01,,,,,0.00,0.00,0,0,0,0,0,0,0,0,0,0,0,0,0
20200520,054655,貿聯麥證98購01,0.26,0.26,0.26,0.26,0.00,0.00,99000,1,25740,99000,0,99000,0,0,0,99000,0,99000,99000
20200520,054656,深中小元大97購01,,,,,0.00,0.00,0,0,0,0,0,0,0,0,0,0,0,0,0
20200520,054657,道瓊銀元大97購01,,,,,0.00,0.00,0,0,0,0,0,0,0,0,0,0,0,0,0
20200520,054658,道瓊銀元大9A購01,0.26,0.28,0.26,0.28,+0.02,7.69,204000,9,54460,0,0,0,0,0,0,0,0,0,0
20200520,054659,亞光元大97購02,,,,,0.00,0.00,0,0,0,0,0,0,0,0,0,0,0,0,0
20200520,05465P,台表科永豐95售03,,,,,0.00,0.00,0,0,0,0,0,0,0,0,0,0,0,0,0
20200520,054660,禾伸堂元大97購03,,,,,0.00,0.00,0,0,0,0,0,0,0,0,0,0,0,0,0
20200520,054661,嘉聯益元大97購03,,,,,0.00,0.00,0,0,0,0,0,0,0,0,0,0,0,0,0
20200520,054662,同欣電元大97購02,0.36,0.39,0.36,0.39,+0.04,11.43,179000,3,67020,0,0,0,0,0,0,48000,131000,-83000,-83000
20200520,054663,同欣電元大97購03,,,,,0.00,0.00,0,0,0,0,0,0,0,0,0,0,0,0,0
20200520,054664,台表科元大97購04,,,,,0.00,0.00,0,0,0,0,0,0,0,0,0,0,0,0,0
20200520,054665,華通元富97購02,,,,,0.00,0.00,0,0,0,0,0,0,0,0,0,0,0,0,0
20200520,054666,強茂元富97購01,,,,,0.00,0.00,0,0,0,0,0,0,0,0,0,0,0,0,0
20200520,054667,神基元富97購01,,,,,0.00,0.00,0,0,0,0,0,0,0,0,0,0,0,0,0
20200520,054668,傳奇元富97購03,,,,,0.00,0.00,0,0,0,0,0,0,0,0,0,0,0,0,0
20200520,054669,凌華元富97購01,,,,,0.00,0.00,0,0,0,0,0,0,0,0,0,0,0,0,0
20200520,05466P,旺宏富邦97售01,0.73,0.74,0.73,0.74,0.00,0.00,30000,3,22000,0,0,0,0,0,0,0,30000,-30000,-30000
20200520,054670,康友元富97購01,,,,,0.00,0.00,0,0,0,0,0,0,0,0,0,0,0,0,0
20200520,054671,國巨國泰98購01,,,,,0.00,0.00,0,0,0,0,0,0,0,0,0,0,0,0,0
20200520,054672,華新科國泰99購01,,,,,0.00,0.00,0,0,0,0,0,0,0,0,0,0,0,0,0
20200520,054673,京鼎國泰98購01,,,,,0.00,0.00,0,0,0,0,0,0,0,0,0,0,0,0,0
20200520,054674,台光電台新97購01,,,,,0.00,0.00,0,0,0,0,0,0,0,0,0,0,0,0,0
20200520,054675,美律台新98購01,,,,,0.00,0.00,0,0,0,0,0,0,0,0,0,0,0,0,0
20200520,054676,牧德台新98購01,,,,,0.00,0.00,0,0,0,0,0,0,0,0,0,0,0,0,0
20200520,054677,智易台新98購02,,,,,0.00,0.00,0,0,0,0,0,0,0,0,0,0,0,0,0
20200520,054678,麗豐台新98購02,,,,,0.00,0.00,0,0,0,0,0,0,0,0,0,0,0,0,0
20200520,054679,台積電康和99購01,1.14,1.14,1.14,1.14,0.00,0.00,1000,1,1140,0,0,0,0,0,0,1000,1000,0,0
20200520,05467P,聯電元大95售02,,,,,0.00,0.00,0,0,0,0,0,0,0,0,0,0,0,0,0
20200520,054680,華新科康和97購02,,,,,0.00,0.00,0,0,0,0,0,0,0,0,0,0,0,0,0
20200520,054681,味全永豐97購01,,,,,0.00,0.00,0,0,0,0,0,0,0,0,0,0,0,0,0
20200520,054682,東元永豐97購01,0.48,0.48,0.48,0.48,-0.04,-7.69,19000,2,9120,0,0,0,0,0,0,19000,0,19000,19000
20200520,054683,川湖永豐97購01,,,,,0.00,0.00,0,0,0,0,0,0,0,0,0,0,0,0,0
20200520,054684,裕隆永豐97購01,0.41,0.50,0.35,0.43,+0.08,22.86,1325000,30,573550,0,0,0,0,0,0,534000,137000,397000,397000
20200520,054685,國巨永豐97購02,0.05,0.05,0.03,0.04,-0.01,-20.0,319000,10,12550,0,0,0,0,0,0,0,0,0,0
20200520,054686,順德永豐97購01,,,,,0.00,0.00,0,0,0,0,0,0,0,0,0,0,0,0,0
20200520,054687,建準永豐97購02,0.65,0.65,0.65,0.65,0.00,0.00,67000,1,43550,0,0,0,0,0,0,67000,0,67000,67000
20200520,054688,兆赫永豐97購01,0.03,0.03,0.02,0.02,0.00,0.00,370000,37,8400,0,0,0,0,0,0,0,370000,-370000,-370000
20200520,054689,華新科永豐97購01,,,,,0.00,0.00,0,0,0,0,0,0,0,0,0,0,0,0,0
20200520,05468P,鴻海元大96售14,,,,,0.00,0.00,0,0,0,0,0,0,0,0,0,0,0,0,0
20200520,054690,新興永豐97購01,,,,,0.00,0.00,0,0,0,0,0,0,0,0,0,0,0,0,0
20200520,054691,裕民永豐97購01,,,,,0.00,0.00,0,0,0,0,0,0,0,0,0,0,0,0,0
20200520,054692,台航永豐97購01,,,,,0.00,0.00,0,0,0,0,0,0,0,0,0,0,0,0,0
20200520,054693,神基永豐97購01,0.12,0.12,0.11,0.11,0.00,0.00,120000,5,13800,0,0,0,0,0,0,0,120000,-120000,-120000
20200520,054694,聯鈞永豐97購01,,,,,0.00,0.00,0,0,0,0,0,0,0,0,0,0,0,0,0
20200520,054695,世芯永豐98購01,1.50,1.65,1.47,1.47,-0.11,-6.96,110000,20,171450,0,0,0,0,0,0,31000,78000,-47000,-47000
20200520,054696,嘉聯益永豐97購01,,,,,0.00,0.00,0,0,0,0,0,0,0,0,0,0,0,0,0
20200520,054697,凌華永豐97購01,,,,,0.00,0.00,0,0,0,0,0,0,0,0,0,0,0,0,0
20200520,054698,同欣電永豐97購01,,,,,0.00,0.00,0,0,0,0,0,0,0,0,0,0,0,0,0
20200520,054699,復盛永豐97購01,0.08,0.08,0.08,0.08,0.00,0.00,30000,1,2400,0,0,0,0,0,0,30000,0,30000,30000
20200520,05469P,台積電元大95售24,1.54,1.54,1.54,1.54,-0.06,-3.75,125000,1,192500,0,0,0,0,0,0,125000,125000,0,0
20200520,054700,致新永豐97購01,0.34,0.35,0.30,0.34,+0.06,21.43,155000,6,49660,0,0,0,0,0,0,60000,95000,-35000,-35000
20200520,054701,宏全永豐97購01,,,,,0.00,0.00,0,0,0,0,0,0,0,0,0,0,0,0,0
20200520,054702,智邦第一97購01,,,,,0.00,0.00,0,0,0,0,0,0,0,0,0,0,0,0,0
20200520,054703,聯發科第一97購01,,,,,0.00,0.00,0,0,0,0,0,0,0,0,0,0,0,0,0
20200520,054704,玉晶光第一97購01,0.07,0.07,0.07,0.07,0.00,0.00,10000,1,700,0,0,0,0,0,0,0,0,0,0
20200520,054705,欣興亞東97購01,,,,,0.00,0.00,0,0,0,0,0,0,0,0,0,0,0,0,0
20200520,054706,TPK亞東97購01,,,,,0.00,0.00,0,0,0,0,0,0,0,0,0,0,0,0,0
20200520,054707,聯茂亞東97購01,,,,,0.00,0.00,0,0,0,0,0,0,0,0,0,0,0,0,0
20200520,054708,華通統一97購02,0.18,0.18,0.18,0.18,-0.03,-14.29,110000,2,19800,0,0,0,0,0,0,0,110000,-110000,-110000
20200520,054709,宏達電統一97購01,0.21,0.23,0.21,0.23,0.00,0.00,726000,5,164980,0,0,0,0,0,0,0,726000,-726000,-726000
20200520,05470P,康控元大95售05,,,,,0.00,0.00,0,0,0,0,0,0,0,0,0,0,0,0,0
20200520,054710,東元元富97購01,1.38,1.38,1.34,1.38,-0.01,-0.72,288000,10,391380,0,0,0,0,0,0,50000,238000,-188000,-188000
20200520,054711,禾伸堂元富97購01,,,,,0.00,0.00,0,0,0,0,0,0,0,0,0,0,0,0,0
20200520,054712,上証2X中信98購02,,,,,0.00,0.00,0,0,0,0,0,0,0,0,0,0,0,0,0
20200520,054713,國巨中信9B購01,0.39,0.41,0.36,0.39,+0.06,18.18,3246000,237,1239570,0,0,0,0,0,0,0,819000,-819000,-819000
20200520,054714,和鑫台新98購01,,,,,0.00,0.00,0,0,0,0,0,0,0,0,0,0,0,0,0
20200520,054715,中橡康和97購01,,,,,0.00,0.00,0,0,0,0,0,0,0,0,0,0,0,0,0
20200520,054716,緯穎康和97購01,2.11,2.11,1.94,1.94,-0.30,-13.39,7000,2,13920,0,0,0,0,0,0,2000,5000,-3000,-3000
20200520,054717,亞德客永豐97購01,,,,,0.00,0.00,0,0,0,0,0,0,0,0,0,0,0,0,0
20200520,054718,可成永豐97購01,,,,,0.00,0.00,0,0,0,0,0,0,0,0,0,0,0,0,0
20200520,054719,亞光永豐97購01,,,,,0.00,0.00,0,0,0,0,0,0,0,0,0,0,0,0,0
20200520,05471P,聯電統一95售01,0.21,0.21,0.21,0.21,+0.01,5.0,15000,2,3150,0,0,0,0,0,0,15000,0,15000,15000
20200520,054720,禾伸堂永豐97購01,0.27,0.27,0.27,0.27,+0.02,8.0,30000,1,8100,0,0,0,0,0,0,0,30000,-30000,-30000
20200520,054721,揚明光永豐97購03,,,,,0.00,0.00,0,0,0,0,0,0,0,0,0,0,0,0,0
20200520,054722,傳奇永豐97購01,,,,,0.00,0.00,0,0,0,0,0,0,0,0,0,0,0,0,0
20200520,054723,鴻海日盛97購01,,,,,0.00,0.00,0,0,0,0,0,0,0,0,0,0,0,0,0
20200520,054724,鴻海日盛97購02,,,,,0.00,0.00,0,0,0,0,0,0,0,0,0,0,0,0,0
20200520,054725,國巨日盛97購01,0.10,0.15,0.10,0.14,+0.09,180.0,711000,50,88910,0,0,0,0,0,0,618000,630000,-12000,-12000
20200520,054726,台積電日盛97購01,,,,,0.00,0.00,0,0,0,0,0,0,0,0,0,0,0,0,0
20200520,054727,台積電日盛97購02,0.01,0.01,0.01,0.01,0.00,0.00,1000,1,10,0,0,0,0,0,0,1000,1000,0,0
20200520,054728,聯發科日盛97購01,2.10,2.37,2.10,2.37,+0.36,17.91,404000,22,901920,0,0,0,0,0,0,296000,108000,188000,188000
20200520,054729,聯發科日盛97購02,0.72,0.72,0.72,0.72,+0.18,33.33,1000,1,720,0,0,0,0,0,0,1000,0,1000,1000
20200520,05472P,國巨統一96售02,,,,,0.00,0.00,0,0,0,0,0,0,0,0,0,0,0,0,0
20200520,054730,上証2X凱基98購02,,,,,0.00,0.00,0,0,0,0,0,0,0,0,0,0,0,0,0
20200520,054731,S&P反1凱基98購01,,,,,0.00,0.00,0,0,0,0,0,0,0,0,0,0,0,0,0
20200520,054732,台化凱基98購01,,,,,0.00,0.00,0,0,0,0,0,0,0,0,0,0,0,0,0
20200520,054733,鴻海凱基98購04,,,,,0.00,0.00,0,0,0,0,0,0,0,0,0,0,0,0,0
20200520,054734,燿華凱基97購03,,,,,0.00,0.00,0,0,0,0,0,0,0,0,0,0,0,0,0
20200520,054735,漢唐凱基98購01,1.16,1.16,1.16,1.16,0.00,0.00,43000,1,49880,0,0,0,0,0,0,0,43000,-43000,-43000
20200520,054736,南亞科凱基98購01,,,,,0.00,0.00,0,0,0,0,0,0,0,0,0,0,0,0,0
20200520,054737,京元電凱基99購01,0.09,0.09,0.09,0.09,0.00,0.00,50000,2,4500,0,0,0,0,0,0,0,0,0,0
20200520,054738,聯發科凱基97購01,3.12,3.12,3.12,3.12,+0.43,15.99,14000,1,43680,0,0,0,0,0,0,0,14000,-14000,-14000
20200520,054739,義隆凱基98購02,,,,,0.00,0.00,0,0,0,0,0,0,0,0,0,0,0,0,0
20200520,05473P,聯詠統一97售02,,,,,0.00,0.00,0,0,0,0,0,0,0,0,0,0,0,0,0
20200520,054740,強茂凱基99購01,,,,,0.00,0.00,0,0,0,0,0,0,0,0,0,0,0,0,0
20200520,054741,亞光凱基99購01,,,,,0.00,0.00,0,0,0,0,0,0,0,0,0,0,0,0,0
20200520,054742,京鼎凱基99購01,1.34,1.34,1.31,1.33,-0.03,-2.21,158000,3,208340,0,0,0,0,0,0,100000,58000,42000,42000
20200520,054743,聯鈞凱基99購01,,,,,0.00,0.00,0,0,0,0,0,0,0,0,0,0,0,0,0
20200520,054744,晶相光凱基99購01,,,,,0.00,0.00,0,0,0,0,0,0,0,0,0,0,0,0,0
20200520,054745,智易凱基97購01,,,,,0.00,0.00,0,0,0,0,0,0,0,0,0,0,0,0,0
20200520,054746,貿聯凱基98購02,,,,,0.00,0.00,0,0,0,0,0,0,0,0,0,0,0,0,0
20200520,054747,麗豐凱基98購01,,,,,0.00,0.00,0,0,0,0,0,0,0,0,0,0,0,0,0
20200520,054748,正文凱基98購01,,,,,0.00,0.00,0,0,0,0,0,0,0,0,0,0,0,0,0
20200520,054749,聯茂凱基98購01,,,,,0.00,0.00,0,0,0,0,0,0,0,0,0,0,0,0,0
20200520,05474P,智邦亞東95售01,,,,,0.00,0.00,0,0,0,0,0,0,0,0,0,0,0,0,0
20200520,054750,聯茂凱基98購02,2.20,2.24,2.20,2.24,-0.10,-4.27,20000,2,44400,0,0,0,0,0,0,10000,10000,0,0
20200520,054751,GIS凱基98購01,1.13,1.16,1.13,1.16,-0.06,-4.92,158000,3,180490,0,0,0,0,0,0,0,158000,-158000,-158000
20200520,054752,易華電凱基97購02,,,,,0.00,0.00,0,0,0,0,0,0,0,0,0,0,0,0,0
20200520,054753,復盛凱基98購01,0.26,0.27,0.26,0.27,0.00,0.00,12000,2,3180,0,0,0,0,0,0,0,12000,-12000,-12000
20200520,054754,昇陽半凱基98購02,,,,,0.00,0.00,0,0,0,0,0,0,0,0,0,0,0,0,0
20200520,054755,世紀鋼凱基98購01,1.92,1.95,1.90,1.90,-0.17,-8.21,94000,4,181700,0,0,0,0,0,0,90000,4000,86000,86000
20200520,054756,世紀鋼凱基99購01,1.44,1.44,1.44,1.44,-0.01,-0.69,2000,1,2880,0,0,0,0,0,0,0,2000,-2000,-2000
20200520,054757,南亞國票98購01,,,,,0.00,0.00,0,0,0,0,0,0,0,0,0,0,0,0,0
20200520,054758,南亞國票9A購01,0.95,0.95,0.95,0.95,0.00,0.00,30000,2,28500,0,0,0,0,0,0,0,30000,-30000,-30000
20200520,054759,台化國票98購01,,,,,0.00,0.00,0,0,0,0,0,0,0,0,0,0,0,0,0
20200520,05475P,聯茂亞東95售01,,,,,0.00,0.00,0,0,0,0,0,0,0,0,0,0,0,0,0
20200520,054760,台化國票9A購01,,,,,0.00,0.00,0,0,0,0,0,0,0,0,0,0,0,0,0
20200520,054761,台光電國票98購02,1.10,1.10,1.01,1.10,0.00,0.00,50000,5,53200,0,0,0,0,0,0,50000,0,50000,50000
20200520,054762,奇力新國票99購01,,,,,0.00,0.00,0,0,0,0,0,0,0,0,0,0,0,0,0
20200520,054763,宏達電國票99購01,,,,,0.00,0.00,0,0,0,0,0,0,0,0,0,0,0,0,0
20200520,054764,亞光國票98購01,,,,,0.00,0.00,0,0,0,0,0,0,0,0,0,0,0,0,0
20200520,054765,亞光國票98購02,,,,,0.00,0.00,0,0,0,0,0,0,0,0,0,0,0,0,0
20200520,054766,智原國票98購01,,,,,0.00,0.00,0,0,0,0,0,0,0,0,0,0,0,0,0
20200520,054767,日電貿國票98購01,1.69,1.75,1.67,1.69,-0.03,-1.74,421000,7,710390,0,0,0,0,0,0,352000,69000,283000,283000
20200520,054768,泰碩國票99購02,1.50,1.50,1.50,1.50,-0.10,-6.25,62000,1,93000,0,0,0,0,0,0,62000,0,62000,62000
20200520,054769,創意國票98購01,,,,,0.00,0.00,0,0,0,0,0,0,0,0,0,0,0,0,0
20200520,05476P,聯發科群益95售06,,,,,0.00,0.00,0,0,0,0,0,0,0,0,0,0,0,0,0
20200520,054770,健策國票98購01,,,,,0.00,0.00,0,0,0,0,0,0,0,0,0,0,0,0,0
20200520,054771,茂林國票98購02,1.15,1.54,1.13,1.54,+0.49,46.67,614000,18,783040,0,0,0,0,0,0,130000,480000,-350000,-350000
20200520,054772,康控國票98購02,,,,,0.00,0.00,0,0,0,0,0,0,0,0,0,0,0,0,0
20200520,054773,台郡國票98購01,1.90,1.90,1.90,1.90,+0.02,1.06,16000,1,30400,0,0,0,0,0,0,0,16000,-16000,-16000
20200520,054774,同欣電國票98購01,0.03,0.03,0.03,0.03,0.00,0.00,5000,1,150,0,0,0,0,0,0,0,0,0,0
20200520,054775,復盛國票98購01,,,,,0.00,0.00,0,0,0,0,0,0,0,0,0,0,0,0,0
20200520,054776,矽創國票98購01,1.33,1.33,1.33,1.33,+0.37,38.54,114000,3,151620,0,0,0,0,0,0,114000,0,114000,114000
20200520,054777,昇陽半國票98購01,,,,,0.00,0.00,0,0,0,0,0,0,0,0,0,0,0,0,0
20200520,054778,世紀鋼國票99購01,4.73,4.73,4.11,4.11,-0.31,-7.01,72000,4,305620,0,0,0,0,0,0,60000,12000,48000,48000
20200520,054779,台塑群益98購01,0.13,0.13,0.13,0.13,+0.02,18.18,1000,1,130,0,0,0,0,0,0,0,0,0,0
20200520,05477P,華新科群益95售06,,,,,0.00,0.00,0,0,0,0,0,0,0,0,0,0,0,0,0
20200520,054780,中石化群益99購01,0.17,0.17,0.17,0.17,0.00,0.00,10000,1,1700,0,0,0,0,0,0,10000,0,10000,10000
20200520,054781,台化群益99購01,,,,,0.00,0.00,0,0,0,0,0,0,0,0,0,0,0,0,0
20200520,054782,國巨群益97購01,,,,,0.00,0.00,0,0,0,0,0,0,0,0,0,0,0,0,0
20200520,054783,國巨群益98購04,,,,,0.00,0.00,0,0,0,0,0,0,0,0,0,0,0,0,0
20200520,054784,順德群益9A購01,,,,,0.00,0.00,0,0,0,0,0,0,0,0,0,0,0,0,0
20200520,054785,建準群益98購01,2.18,2.26,2.01,2.22,-0.23,-9.39,399000,26,844250,0,0,0,0,0,0,321000,46000,275000,275000
20200520,054786,全新群益99購02,0.33,0.33,0.33,0.33,0.00,0.00,1000,1,330,0,0,0,0,0,0,1000,0,1000,1000
20200520,054787,華新科群益97購04,,,,,0.00,0.00,0,0,0,0,0,0,0,0,0,0,0,0,0
20200520,054788,華新科群益98購02,0.79,0.88,0.77,0.77,-0.08,-9.41,334000,20,282730,0,0,0,0,0,0,117000,234000,-117000,-117000
20200520,054789,高鐵群益98購01,0.19,0.20,0.18,0.19,+0.03,18.75,740000,9,141590,0,0,0,0,0,0,200000,340000,-140000,-140000
20200520,05478P,智伸科國票96售02,,,,,0.00,0.00,0,0,0,0,0,0,0,0,0,0,0,0,0
20200520,054790,禾伸堂群益98購01,,,,,0.00,0.00,0,0,0,0,0,0,0,0,0,0,0,0,0
20200520,054791,泰碩群益99購02,0.92,0.92,0.82,0.84,-0.10,-10.64,150000,8,129000,0,0,0,0,0,0,30000,120000,-90000,-90000
20200520,054792,揚明光群益97購01,,,,,0.00,0.00,0,0,0,0,0,0,0,0,0,0,0,0,0
20200520,054793,牧德群益9A購01,,,,,0.00,0.00,0,0,0,0,0,0,0,0,0,0,0,0,0
20200520,054794,貿聯群益98購01,,,,,0.00,0.00,0,0,0,0,0,0,0,0,0,0,0,0,0
20200520,054795,合勤控群益98購01,0.45,0.57,0.45,0.57,+0.18,46.15,100000,3,48300,0,0,0,0,0,0,20000,80000,-60000,-60000
20200520,054796,康普群益98購01,0.16,0.16,0.16,0.16,0.00,0.00,20000,2,3200,0,0,0,0,0,0,0,20000,-20000,-20000
20200520,054797,臻鼎群益97購01,,,,,0.00,0.00,0,0,0,0,0,0,0,0,0,0,0,0,0
20200520,054798,超眾群益97購01,,,,,0.00,0.00,0,0,0,0,0,0,0,0,0,0,0,0,0
20200520,054799,超眾群益98購01,,,,,0.00,0.00,0,0,0,0,0,0,0,0,0,0,0,0,0
20200520,05479P,華新科台新96售01,,,,,0.00,0.00,0,0,0,0,0,0,0,0,0,0,0,0,0
20200520,054800,訊芯群益99購01,0.14,0.14,0.14,0.14,0.00,0.00,7000,1,980,0,0,0,0,0,0,0,7000,-7000,-7000
20200520,054801,康友群益97購02,,,,,0.00,0.00,0,0,0,0,0,0,0,0,0,0,0,0,0
20200520,054802,高股息元大97購01,,,,,0.00,0.00,0,0,0,0,0,0,0,0,0,0,0,0,0
20200520,054803,味全元大9A購01,,,,,0.00,0.00,0,0,0,0,0,0,0,0,0,0,0,0,0
20200520,054804,南亞元大9A購01,,,,,0.00,0.00,0,0,0,0,0,0,0,0,0,0,0,0,0
20200520,054805,台苯元大9A購01,0.56,0.56,0.50,0.50,-0.08,-13.79,992000,42,517590,0,0,0,0,0,0,781000,203000,578000,578000
20200520,054806,台化元大9A購01,0.52,0.60,0.52,0.60,0.00,0.00,55000,3,29000,0,0,0,0,0,0,0,10000,-10000,-10000
20200520,054807,台化元大9A購02,2.01,2.04,1.96,1.97,-0.07,-3.43,220000,11,441700,0,0,0,0,0,0,170000,50000,120000,120000
20200520,054808,東元元大9A購01,1.31,1.31,1.27,1.31,+0.03,2.34,730000,12,945520,0,0,0,0,0,0,170000,592000,-422000,-422000
20200520,054809,大成鋼元大97購01,,,,,0.00,0.00,0,0,0,0,0,0,0,0,0,0,0,0,0
20200520,05480P,滬深2X凱基96售05,1.78,1.78,1.78,1.78,-0.03,-1.66,38000,2,67640,0,0,0,0,0,0,38000,38000,0,0
20200520,054810,中橡元大9A購01,,,,,0.00,0.00,0,0,0,0,0,0,0,0,0,0,0,0,0
20200520,054811,裕隆元大9A購01,1.95,1.96,1.04,1.19,-0.77,-39.29,224000,29,270500,0,0,0,0,0,0,100000,105000,-5000,-5000
20200520,054812,鴻海元大97購08,,,,,0.00,0.00,0,0,0,0,0,0,0,0,0,0,0,0,0
20200520,054813,鴻海元大97購09,,,,,0.00,0.00,0,0,0,0,0,0,0,0,0,0,0,0,0
20200520,054814,台積電元大97購13,,,,,0.00,0.00,0,0,0,0,0,0,0,0,0,0,0,0,0
20200520,054815,台積電元大97購14,0.01,0.01,0.01,0.01,0.00,0.00,10000,1,100,0,0,0,0,0,0,10000,10000,0,0
20200520,054816,聯發科元大97購12,,,,,0.00,0.00,0,0,0,0,0,0,0,0,0,0,0,0,0
20200520,054817,聯發科元大97購13,,,,,0.00,0.00,0,0,0,0,0,0,0,0,0,0,0,0,0
20200520,054818,奇力新元大97購05,,,,,0.00,0.00,0,0,0,0,0,0,0,0,0,0,0,0,0
20200520,054819,裕民元大9A購01,0.66,0.66,0.63,0.63,-0.02,-3.08,495000,10,316790,0,0,0,0,0,0,249000,246000,3000,3000
20200520,05481P,鴻海凱基95售21,,,,,0.00,0.00,0,0,0,0,0,0,0,0,0,0,0,0,0
20200520,054820,新日興元大97購01,,,,,0.00,0.00,0,0,0,0,0,0,0,0,0,0,0,0,0
20200520,054821,貿聯元大9A購01,,,,,0.00,0.00,0,0,0,0,0,0,0,0,0,0,0,0,0
20200520,054822,祥碩元大97購01,,,,,0.00,0.00,0,0,0,0,0,0,0,0,0,0,0,0,0
20200520,054823,祥碩元大97購02,,,,,0.00,0.00,0,0,0,0,0,0,0,0,0,0,0,0,0
20200520,054824,同欣電元大97購04,,,,,0.00,0.00,0,0,0,0,0,0,0,0,0,0,0,0,0
20200520,054825,康友元大97購01,,,,,0.00,0.00,0,0,0,0,0,0,0,0,0,0,0,0,0
20200520,054826,復盛元大9A購01,1.69,2.14,1.67,2.14,+0.52,32.1,1185000,61,2229760,0,0,0,0,0,0,200000,985000,-785000,-785000
20200520,054827,宏全元大9A購01,0.84,0.84,0.74,0.74,-0.13,-14.94,409000,27,320740,0,0,0,0,0,0,309000,100000,209000,209000
20200520,054828,正崴國泰99購01,0.58,0.58,0.58,0.58,0.00,0.00,100000,1,58000,0,0,0,0,0,0,0,100000,-100000,-100000
20200520,054829,亞光國泰99購01,,,,,0.00,0.00,0,0,0,0,0,0,0,0,0,0,0,0,0
20200520,05482P,鴻海凱基95售22,,,,,0.00,0.00,0,0,0,0,0,0,0,0,0,0,0,0,0
20200520,054830,世芯國泰99購01,4.53,4.53,4.53,4.53,-0.92,-16.88,5000,1,22650,0,0,0,0,0,0,0,5000,-5000,-5000
20200520,054831,緯穎國泰98購01,,,,,0.00,0.00,0,0,0,0,0,0,0,0,0,0,0,0,0
20200520,054832,興勤中信97購01,,,,,0.00,0.00,0,0,0,0,0,0,0,0,0,0,0,0,0
20200520,054833,京鼎中信97購01,,,,,0.00,0.00,0,0,0,0,0,0,0,0,0,0,0,0,0
20200520,054834,帆宣中信97購01,0.02,0.08,0.02,0.08,0.00,0.00,104000,14,3220,0,0,0,0,0,0,0,100000,-100000,-100000
20200520,054835,致新中信97購01,0.40,0.46,0.40,0.41,+0.08,24.24,34000,8,14020,0,0,0,0,0,0,22000,22000,0,0
20200520,054836,勤誠中信97購01,,,,,0.00,0.00,0,0,0,0,0,0,0,0,0,0,0,0,0
20200520,054837,欣興第一97購01,,,,,0.00,0.00,0,0,0,0,0,0,0,0,0,0,0,0,0
20200520,054838,京鼎第一97購01,,,,,0.00,0.00,0,0,0,0,0,0,0,0,0,0,0,0,0
20200520,054839,中石化亞東98購01,,,,,0.00,0.00,0,0,0,0,0,0,0,0,0,0,0,0,0
20200520,05483P,國巨凱基95售07,,,,,0.00,0.00,0,0,0,0,0,0,0,0,0,0,0,0,0
20200520,054840,T50反1兆豐98購01,1.20,1.20,1.19,1.19,0.00,0.00,20000,2,23900,0,0,0,0,0,0,0,20000,-20000,-20000
20200520,054841,亞德客兆豐97購01,,,,,0.00,0.00,0,0,0,0,0,0,0,0,0,0,0,0,0
20200520,054842,台達電兆豐98購01,1.69,1.69,1.69,1.69,0.00,0.00,10000,1,16900,0,0,0,0,0,0,0,10000,-10000,-10000
20200520,054843,中環兆豐97購01,0.14,0.14,0.14,0.14,-0.75,-84.27,9000,3,1260,0,0,0,0,0,0,6000,0,6000,6000
20200520,054844,華邦電兆豐98購01,,,,,0.00,0.00,0,0,0,0,0,0,0,0,0,0,0,0,0
20200520,054845,智邦兆豐98購01,,,,,0.00,0.00,0,0,0,0,0,0,0,0,0,0,0,0,0
20200520,054846,瑞昱兆豐97購01,3.41,3.59,3.28,3.28,-0.30,-8.38,329000,46,1129320,0,0,0,0,0,0,326000,3000,323000,323000
20200520,054847,創意兆豐97購01,,,,,0.00,0.00,0,0,0,0,0,0,0,0,0,0,0,0,0
20200520,054848,群創兆豐98購01,0.02,0.02,0.01,0.01,0.00,0.00,20000,2,300,0,0,0,0,0,0,0,10000,-10000,-10000
20200520,054849,日月光兆豐97購01,,,,,0.00,0.00,0,0,0,0,0,0,0,0,0,0,0,0,0
20200520,05484P,台積電凱基95售18,,,,,0.00,0.00,0,0,0,0,0,0,0,0,0,0,0,0,0
20200520,054850,上海銀兆豐97購01,,,,,0.00,0.00,0,0,0,0,0,0,0,0,0,0,0,0,0
20200520,054851,樺漢兆豐97購01,,,,,0.00,0.00,0,0,0,0,0,0,0,0,0,0,0,0,0
20200520,054852,奇鋐國票98購01,0.98,0.98,0.98,0.98,0.00,0.00,19000,2,18620,0,0,0,0,0,0,0,19000,-19000,-19000
20200520,054853,TPK國票98購02,,,,,0.00,0.00,0,0,0,0,0,0,0,0,0,0,0,0,0
20200520,054854,台積電麥證97購01,,,,,0.00,0.00,0,0,0,0,0,0,0,0,0,0,0,0,0
20200520,054855,得力群益98購01,,,,,0.00,0.00,0,0,0,0,0,0,0,0,0,0,0,0,0
20200520,054856,得力群益99購01,,,,,0.00,0.00,0,0,0,0,0,0,0,0,0,0,0,0,0
20200520,054857,信錦群益97購01,,,,,0.00,0.00,0,0,0,0,0,0,0,0,0,0,0,0,0
20200520,054858,台肥群益97購01,0.26,0.26,0.26,0.26,-0.05,-16.13,5000,1,1300,0,0,0,0,0,0,5000,0,5000,5000
20200520,054859,鴻海群益97購02,0.15,0.15,0.15,0.15,-0.03,-16.67,10000,2,1500,0,0,0,0,0,0,5000,5000,0,0
20200520,05485P,旺宏凱基95售08,,,,,0.00,0.00,0,0,0,0,0,0,0,0,0,0,0,0,0
20200520,054860,台積電群益98購01,0.03,0.04,0.02,0.04,0.00,0.00,266000,8,5990,0,0,0,0,0,0,70000,34000,36000,36000
20200520,054861,智邦群益97購01,,,,,0.00,0.00,0,0,0,0,0,0,0,0,0,0,0,0,0
20200520,054862,群光群益97購01,,,,,0.00,0.00,0,0,0,0,0,0,0,0,0,0,0,0,0
20200520,054863,億光群益97購01,0.50,0.50,0.50,0.50,+0.04,8.7,160000,2,80000,0,0,0,0,0,0,0,160000,-160000,-160000
20200520,054864,聯發科群益97購02,0.12,0.16,0.12,0.13,+0.04,44.44,60000,3,8500,0,0,0,0,0,0,50000,0,50000,50000
20200520,054865,可成群益97購01,,,,,0.00,0.00,0,0,0,0,0,0,0,0,0,0,0,0,0
20200520,054866,宏盛群益98購01,,,,,0.00,0.00,0,0,0,0,0,0,0,0,0,0,0,0,0
20200520,054867,華航群益99購01,0.33,0.33,0.33,0.33,-0.02,-5.71,2000,1,660,0,0,0,0,0,0,2000,0,2000,2000
20200520,054868,國泰金群益9A購01,0.16,0.16,0.16,0.16,0.00,0.00,22000,1,3520,0,0,0,0,0,0,0,0,0,0
20200520,054869,新光金群益97購01,,,,,0.00,0.00,0,0,0,0,0,0,0,0,0,0,0,0,0
20200520,05486P,大立光凱基95售14,,,,,0.00,0.00,0,0,0,0,0,0,0,0,0,0,0,0,0
20200520,054870,新日興群益98購01,,,,,0.00,0.00,0,0,0,0,0,0,0,0,0,0,0,0,0
20200520,054871,明泰群益98購01,,,,,0.00,0.00,0,0,0,0,0,0,0,0,0,0,0,0,0
20200520,054872,瀚宇博群益98購01,,,,,0.00,0.00,0,0,0,0,0,0,0,0,0,0,0,0,0
20200520,054873,帆宣群益99購01,,,,,0.00,0.00,0,0,0,0,0,0,0,0,0,0,0,0,0
20200520,054874,帆宣群益99購02,,,,,0.00,0.00,0,0,0,0,0,0,0,0,0,0,0,0,0
20200520,054875,群電群益97購01,,,,,0.00,0.00,0,0,0,0,0,0,0,0,0,0,0,0,0
20200520,054876,群電群益97購02,,,,,0.00,0.00,0,0,0,0,0,0,0,0,0,0,0,0,0
20200520,054877,百和群益98購01,,,,,0.00,0.00,0,0,0,0,0,0,0,0,0,0,0,0,0
20200520,054878,和大統一97購02,,,,,0.00,0.00,0,0,0,0,0,0,0,0,0,0,0,0,0
20200520,054879,大成鋼統一97購01,,,,,0.00,0.00,0,0,0,0,0,0,0,0,0,0,0,0,0
20200520,05487P,台表科凱基95售02,,,,,0.00,0.00,0,0,0,0,0,0,0,0,0,0,0,0,0
20200520,054880,華泰統一97購01,0.27,0.27,0.27,0.27,0.00,0.00,2000,1,540,0,0,0,0,0,0,2000,0,2000,2000
20200520,054881,光罩統一97購01,0.32,0.32,0.32,0.32,+0.05,18.52,30000,1,9600,0,0,0,0,0,0,0,30000,-30000,-30000
20200520,054882,台光電統一97購02,0.94,0.94,0.90,0.90,-0.07,-7.22,603000,19,545940,0,0,0,0,0,0,233000,370000,-137000,-137000
20200520,054883,億光統一97購01,1.55,1.55,1.55,1.55,0.00,0.00,6000,1,9300,0,0,0,0,0,0,0,6000,-6000,-6000
20200520,054884,友達統一99購01,,,,,0.00,0.00,0,0,0,0,0,0,0,0,0,0,0,0,0
20200520,054885,建準統一98購01,0.87,0.87,0.87,0.87,-0.13,-13.0,8000,1,6960,0,0,0,0,0,0,0,8000,-8000,-8000
20200520,054886,大毅統一97購01,4.03,4.23,4.03,4.07,-0.06,-1.45,38000,6,156360,0,0,0,0,0,0,12000,26000,-14000,-14000
20200520,054887,大毅統一98購01,,,,,0.00,0.00,0,0,0,0,0,0,0,0,0,0,0,0,0
20200520,054888,泰碩統一97購01,,,,,0.00,0.00,0,0,0,0,0,0,0,0,0,0,0,0,0
20200520,054889,京鼎統一99購01,,,,,0.00,0.00,0,0,0,0,0,0,0,0,0,0,0,0,0
20200520,05488P,臺股指凱基95售21,,,,,0.00,0.00,0,0,0,0,0,0,0,0,0,0,0,0,0
20200520,054890,聯鈞統一99購01,1.32,1.32,1.32,1.32,+0.04,3.12,8000,1,10560,0,0,0,0,0,0,8000,0,8000,8000
20200520,054891,聯鈞統一99購02,,,,,0.00,0.00,0,0,0,0,0,0,0,0,0,0,0,0,0
20200520,054892,彩晶統一99購01,0.36,0.36,0.36,0.36,0.00,0.00,83000,1,29880,0,0,0,0,0,0,0,83000,-83000,-83000
20200520,054893,帆宣統一99購01,,,,,0.00,0.00,0,0,0,0,0,0,0,0,0,0,0,0,0
20200520,054894,GIS統一97購01,0.15,0.15,0.15,0.15,0.00,0.00,10000,1,1500,0,0,0,0,0,0,0,10000,-10000,-10000
20200520,054895,南電統一97購01,2.88,2.88,2.88,2.88,-0.20,-6.49,20000,1,57600,0,0,0,0,0,0,20000,0,20000,20000
20200520,054896,聯茂日盛97購01,0.54,0.54,0.54,0.54,0.00,0.00,11000,1,5940,0,0,0,0,0,0,11000,0,11000,11000
20200520,054897,信錦康和97購01,,,,,0.00,0.00,0,0,0,0,0,0,0,0,0,0,0,0,0
20200520,054898,台肥康和97購01,0.55,0.56,0.55,0.56,-0.02,-3.45,302000,2,166120,0,0,0,0,0,0,300000,2000,298000,298000
20200520,054899,南港康和97購01,,,,,0.00,0.00,0,0,0,0,0,0,0,0,0,0,0,0,0
20200520,05489P,臺股指凱基95售22,,,,,0.00,0.00,0,0,0,0,0,0,0,0,0,0,0,0,0
20200520,054900,金寶康和97購01,,,,,0.00,0.00,0,0,0,0,0,0,0,0,0,0,0,0,0
20200520,054901,群光康和97購01,,,,,0.00,0.00,0,0,0,0,0,0,0,0,0,0,0,0,0
20200520,054902,億光康和97購01,,,,,0.00,0.00,0,0,0,0,0,0,0,0,0,0,0,0,0
20200520,054903,億光康和97購02,,,,,0.00,0.00,0,0,0,0,0,0,0,0,0,0,0,0,0
20200520,054904,興勤康和97購01,,,,,0.00,0.00,0,0,0,0,0,0,0,0,0,0,0,0,0
20200520,054905,國揚康和97購01,,,,,0.00,0.00,0,0,0,0,0,0,0,0,0,0,0,0,0
20200520,054906,神達康和97購01,,,,,0.00,0.00,0,0,0,0,0,0,0,0,0,0,0,0,0
20200520,054907,帆宣康和97購01,,,,,0.00,0.00,0,0,0,0,0,0,0,0,0,0,0,0,0
20200520,054908,群電康和97購01,1.41,1.41,1.39,1.39,-0.01,-0.71,197000,4,277590,0,0,0,0,0,0,197000,0,197000,197000
20200520,054909,福懋科康和97購01,,,,,0.00,0.00,0,0,0,0,0,0,0,0,0,0,0,0,0
20200520,05490P,鴻海元大95售23,,,,,0.00,0.00,0,0,0,0,0,0,0,0,0,0,0,0,0
20200520,054910,信錦凱基97購01,,,,,0.00,0.00,0,0,0,0,0,0,0,0,0,0,0,0,0
20200520,054911,敬鵬凱基97購01,,,,,0.00,0.00,0,0,0,0,0,0,0,0,0,0,0,0,0
20200520,054912,群光凱基97購01,0.47,0.47,0.47,0.47,0.00,0.00,5000,1,2350,0,0,0,0,0,0,0,5000,-5000,-5000
20200520,054913,億光凱基97購01,0.58,0.60,0.58,0.60,+0.07,13.21,21000,2,12260,0,0,0,0,0,0,0,21000,-21000,-21000
20200520,054914,億光凱基98購01,,,,,0.00,0.00,0,0,0,0,0,0,0,0,0,0,0,0,0
20200520,054915,興勤凱基97購01,0.57,0.57,0.57,0.57,+0.03,5.56,50000,1,28500,0,0,0,0,0,0,0,50000,-50000,-50000
20200520,054916,聯發科凱基98購04,2.11,2.22,2.11,2.13,+0.13,6.5,46000,13,98510,0,0,0,0,0,0,36000,13000,23000,23000
20200520,054917,聯發科凱基98購05,,,,,0.00,0.00,0,0,0,0,0,0,0,0,0,0,0,0,0
20200520,054918,華新科凱基98購02,,,,,0.00,0.00,0,0,0,0,0,0,0,0,0,0,0,0,0
20200520,054919,興富發凱基97購01,0.74,0.74,0.74,0.74,-0.02,-2.63,20000,1,14800,0,0,0,0,0,0,20000,0,20000,20000
20200520,05491P,茂林元大95售04,,,,,0.00,0.00,0,0,0,0,0,0,0,0,0,0,0,0,0
20200520,054920,智原凱基98購01,,,,,0.00,0.00,0,0,0,0,0,0,0,0,0,0,0,0,0
20200520,054921,文曄凱基97購01,,,,,0.00,0.00,0,0,0,0,0,0,0,0,0,0,0,0,0
20200520,054922,文曄凱基98購01,,,,,0.00,0.00,0,0,0,0,0,0,0,0,0,0,0,0,0
20200520,054923,晶技凱基98購01,3.82,3.86,3.57,3.57,-0.51,-12.5,32000,4,120950,0,0,0,0,0,0,17000,15000,2000,2000
20200520,054924,景碩凱基98購01,,,,,0.00,0.00,0,0,0,0,0,0,0,0,0,0,0,0,0
20200520,054925,神達凱基97購01,1.20,1.34,1.20,1.30,+0.10,8.33,160000,7,200400,0,0,0,0,0,0,46000,114000,-68000,-68000
20200520,054926,神達凱基98購01,,,,,0.00,0.00,0,0,0,0,0,0,0,0,0,0,0,0,0
20200520,054927,帆宣凱基97購01,,,,,0.00,0.00,0,0,0,0,0,0,0,0,0,0,0,0,0
20200520,054928,帆宣凱基98購01,,,,,0.00,0.00,0,0,0,0,0,0,0,0,0,0,0,0,0
20200520,054929,群電凱基97購01,0.99,0.99,0.99,0.99,-0.01,-1.0,428000,3,423720,0,0,0,0,0,0,423000,5000,418000,418000
20200520,05492P,聯茂元大95售02,,,,,0.00,0.00,0,0,0,0,0,0,0,0,0,0,0,0,0
20200520,054930,群電凱基98購01,2.39,2.39,2.39,2.39,+0.10,4.37,32000,2,76480,0,0,0,0,0,0,32000,0,32000,32000
20200520,054931,緯穎凱基98購01,,,,,0.00,0.00,0,0,0,0,0,0,0,0,0,0,0,0,0
20200520,054932,台肥元大97購01,0.83,0.84,0.79,0.84,-0.06,-6.67,413000,12,337390,0,0,0,0,0,0,313000,177000,136000,136000
20200520,054933,南港元大97購01,0.52,0.52,0.52,0.52,+0.34,188.89,1000,1,520,0,0,0,0,0,0,0,0,0,0
20200520,054934,金寶元大97購01,0.32,0.32,0.32,0.32,0.00,0.00,10000,1,3200,0,0,0,0,0,0,0,10000,-10000,-10000
20200520,054935,華通元大98購03,1.05,1.05,1.03,1.03,0.00,0.00,60000,2,62000,0,0,0,0,0,0,0,60000,-60000,-60000
20200520,054936,鴻海元大97購10,,,,,0.00,0.00,0,0,0,0,0,0,0,0,0,0,0,0,0
20200520,054937,國巨元大97購03,0.15,0.15,0.15,0.15,+0.05,50.0,10000,1,1500,0,0,0,0,0,0,0,0,0,0
20200520,054938,國巨元大97購04,,,,,0.00,0.00,0,0,0,0,0,0,0,0,0,0,0,0,0
20200520,054939,台積電元大97購15,,,,,0.00,0.00,0,0,0,0,0,0,0,0,0,0,0,0,0
20200520,05493P,華新科富邦99售02,,,,,0.00,0.00,0,0,0,0,0,0,0,0,0,0,0,0,0
20200520,054940,台積電元大97購16,,,,,0.00,0.00,0,0,0,0,0,0,0,0,0,0,0,0,0
20200520,054941,凱美元大97購01,0.53,0.53,0.53,0.53,+0.10,23.26,20000,1,10600,0,0,0,0,0,0,20000,0,20000,20000
20200520,054942,凱美元大97購02,,,,,0.00,0.00,0,0,0,0,0,0,0,0,0,0,0,0,0
20200520,054943,群光元大97購01,0.96,0.96,0.96,0.96,+0.06,6.67,22000,2,21120,0,0,0,0,0,0,22000,22000,0,0
20200520,054944,精元元大97購01,,,,,0.00,0.00,0,0,0,0,0,0,0,0,0,0,0,0,0
20200520,054945,正崴元大97購01,,,,,0.00,0.00,0,0,0,0,0,0,0,0,0,0,0,0,0
20200520,054946,億光元大97購01,,,,,0.00,0.00,0,0,0,0,0,0,0,0,0,0,0,0,0
20200520,054947,興勤元大97購01,0.75,0.75,0.70,0.70,0.00,0.00,130000,2,96000,0,0,0,0,0,0,0,130000,-130000,-130000
20200520,054948,聯發科元大97購14,,,,,0.00,0.00,0,0,0,0,0,0,0,0,0,0,0,0,0
20200520,054949,奇力新元大98購01,,,,,0.00,0.00,0,0,0,0,0,0,0,0,0,0,0,0,0
20200520,05494P,華邦電統一95售02,,,,,0.00,0.00,0,0,0,0,0,0,0,0,0,0,0,0,0
20200520,054950,奇力新元大98購02,0.44,0.47,0.44,0.45,0.00,0.00,146000,4,64470,0,0,0,0,0,0,0,146000,-146000,-146000
20200520,054951,大毅元大97購01,4.66,4.66,4.66,4.66,+0.12,2.64,16000,1,74560,0,0,0,0,0,0,0,16000,-16000,-16000
20200520,054952,大毅元大97購02,,,,,0.00,0.00,0,0,0,0,0,0,0,0,0,0,0,0,0
20200520,054953,華新科元大97購05,,,,,0.00,0.00,0,0,0,0,0,0,0,0,0,0,0,0,0
20200520,054954,華新科元大97購06,0.03,0.03,0.03,0.03,0.00,0.00,13000,1,390,0,0,0,0,0,0,13000,0,13000,13000
20200520,054955,宏達電元大98購01,,,,,0.00,0.00,0,0,0,0,0,0,0,0,0,0,0,0,0
20200520,054956,宏盛元大97購01,,,,,0.00,0.00,0,0,0,0,0,0,0,0,0,0,0,0,0
20200520,054957,興富發元大97購01,1.69,1.69,1.69,1.69,+0.02,1.2,95000,2,160550,0,0,0,0,0,0,0,95000,-95000,-95000
20200520,054958,亞光元大97購03,,,,,0.00,0.00,0,0,0,0,0,0,0,0,0,0,0,0,0
20200520,054959,禾伸堂元大98購01,,,,,0.00,0.00,0,0,0,0,0,0,0,0,0,0,0,0,0
20200520,05495P,大立光統一95售07,,,,,0.00,0.00,0,0,0,0,0,0,0,0,0,0,0,0,0
20200520,054960,新日興元大97購02,,,,,0.00,0.00,0,0,0,0,0,0,0,0,0,0,0,0,0
20200520,054961,玉晶光元大99購01,0.36,0.37,0.36,0.37,+0.04,12.12,3000,2,1100,0,0,0,0,0,0,3000,0,3000,3000
20200520,054962,玉晶光元大99購02,0.33,0.49,0.33,0.49,0.00,0.00,10000,2,3460,0,0,0,0,0,0,9000,1000,8000,8000
20200520,054963,牧德元大97購02,,,,,0.00,0.00,0,0,0,0,0,0,0,0,0,0,0,0,0
20200520,054964,智易元大99購01,0.96,0.96,0.96,0.96,-0.04,-4.0,20000,1,19200,0,0,0,0,0,0,20000,0,20000,20000
20200520,054965,健策元大98購04,0.37,0.39,0.37,0.39,0.00,0.00,20000,2,7600,0,0,0,0,0,0,0,20000,-20000,-20000
20200520,054966,貿聯元大98購02,,,,,0.00,0.00,0,0,0,0,0,0,0,0,0,0,0,0,0
20200520,054967,神達元大97購01,1.77,1.77,1.77,1.77,0.00,0.00,6000,1,10620,0,0,0,0,0,0,6000,0,6000,6000
20200520,054968,佐登元大97購01,,,,,0.00,0.00,0,0,0,0,0,0,0,0,0,0,0,0,0
20200520,054969,亞翔元大97購01,0.42,0.42,0.39,0.39,0.00,0.00,40000,3,16400,0,0,0,0,0,0,0,40000,-40000,-40000
20200520,05496P,聯詠統一95售04,,,,,0.00,0.00,0,0,0,0,0,0,0,0,0,0,0,0,0
20200520,054970,帆宣元大97購01,0.39,0.39,0.39,0.39,0.00,0.00,10000,1,3900,0,0,0,0,0,0,10000,0,10000,10000
20200520,054971,帆宣元大97購02,,,,,0.00,0.00,0,0,0,0,0,0,0,0,0,0,0,0,0
20200520,054972,聯茂元大97購02,,,,,0.00,0.00,0,0,0,0,0,0,0,0,0,0,0,0,0
20200520,054973,台郡元大98購02,,,,,0.00,0.00,0,0,0,0,0,0,0,0,0,0,0,0,0
20200520,054974,台表科元大98購02,2.23,2.43,2.04,2.43,+0.68,38.86,89000,7,198410,0,0,0,0,0,0,64000,25000,39000,39000
20200520,054975,福懋科元大97購01,,,,,0.00,0.00,0,0,0,0,0,0,0,0,0,0,0,0,0
20200520,054976,上証2X元富9A購01,,,,,0.00,0.00,0,0,0,0,0,0,0,0,0,0,0,0,0
20200520,054977,SP黃豆元富9B購01,0.32,0.32,0.32,0.32,-0.01,-3.03,10000,1,3200,0,0,0,0,0,0,0,0,0,0
20200520,054978,堤維西元富97購01,,,,,0.00,0.00,0,0,0,0,0,0,0,0,0,0,0,0,0
20200520,054979,南港元富97購01,,,,,0.00,0.00,0,0,0,0,0,0,0,0,0,0,0,0,0
20200520,05497P,聯詠統一96售01,1.53,1.57,1.52,1.52,-0.03,-1.94,30000,13,46200,0,0,0,0,0,0,10000,20000,-10000,-10000
20200520,054980,國巨元富97購01,0.12,0.12,0.12,0.12,-0.03,-20.0,471000,9,56520,0,0,0,0,0,0,458000,0,458000,458000
20200520,054981,國巨元富97購02,,,,,0.00,0.00,0,0,0,0,0,0,0,0,0,0,0,0,0
20200520,054982,國巨元富97購03,0.03,0.05,0.03,0.05,-0.01,-16.67,90000,2,3100,0,0,0,0,0,0,0,0,0,0
20200520,054983,國巨元富97購04,0.04,0.04,0.03,0.03,-0.01,-25.0,170000,3,5600,0,0,0,0,0,0,0,0,0,0
20200520,054984,華泰元富97購01,,,,,0.00,0.00,0,0,0,0,0,0,0,0,0,0,0,0,0
20200520,054985,光罩元富97購01,,,,,0.00,0.00,0,0,0,0,0,0,0,0,0,0,0,0,0
20200520,054986,藍天元富97購01,,,,,0.00,0.00,0,0,0,0,0,0,0,0,0,0,0,0,0
20200520,054987,凱美元富97購01,,,,,0.00,0.00,0,0,0,0,0,0,0,0,0,0,0,0,0
20200520,054988,凱美元富97購02,,,,,0.00,0.00,0,0,0,0,0,0,0,0,0,0,0,0,0
20200520,054989,精元元富97購01,,,,,0.00,0.00,0,0,0,0,0,0,0,0,0,0,0,0,0
20200520,05498P,友達元富95售02,,,,,0.00,0.00,0,0,0,0,0,0,0,0,0,0,0,0,0
20200520,054990,凌陽元富97購01,0.16,0.16,0.14,0.14,-0.03,-17.65,30000,3,4500,0,0,0,0,0,0,0,30000,-30000,-30000
20200520,054991,南亞科元富97購01,,,,,0.00,0.00,0,0,0,0,0,0,0,0,0,0,0,0,0
20200520,054992,南亞科元富97購02,,,,,0.00,0.00,0,0,0,0,0,0,0,0,0,0,0,0,0
20200520,054993,南亞科元富97購03,,,,,0.00,0.00,0,0,0,0,0,0,0,0,0,0,0,0,0
20200520,054994,建準元富97購01,1.86,1.90,1.77,1.86,-0.18,-8.82,355000,6,647440,0,0,0,0,0,0,355000,0,355000,355000
20200520,054995,宏盛元富97購01,,,,,0.00,0.00,0,0,0,0,0,0,0,0,0,0,0,0,0
20200520,054996,聯陽元富97購01,,,,,0.00,0.00,0,0,0,0,0,0,0,0,0,0,0,0,0
20200520,054997,文曄元富97購01,,,,,0.00,0.00,0,0,0,0,0,0,0,0,0,0,0,0,0
20200520,054998,玉晶光元富97購02,,,,,0.00,0.00,0,0,0,0,0,0,0,0,0,0,0,0,0
20200520,054999,玉晶光元富97購03,,,,,0.00,0.00,0,0,0,0,0,0,0,0,0,0,0,0,0
20200520,05499P,聯詠元富95售02,,,,,0.00,0.00,0,0,0,0,0,0,0,0,0,0,0,0,0
20200520,055000,玉晶光元富97購04,,,,,0.00,0.00,0,0,0,0,0,0,0,0,0,0,0,0,0
20200520,055001,京鼎元富97購01,,,,,0.00,0.00,0,0,0,0,0,0,0,0,0,0,0,0,0
20200520,055002,群創元富99購04,,,,,0.00,0.00,0,0,0,0,0,0,0,0,0,0,0,0,0
20200520,055003,群創元富99購05,,,,,0.00,0.00,0,0,0,0,0,0,0,0,0,0,0,0,0
20200520,055004,群創元富99購06,,,,,0.00,0.00,0,0,0,0,0,0,0,0,0,0,0,0,0
20200520,055005,晶相光元富97購01,,,,,0.00,0.00,0,0,0,0,0,0,0,0,0,0,0,0,0
20200520,055006,晶相光元富9A購01,,,,,0.00,0.00,0,0,0,0,0,0,0,0,0,0,0,0,0
20200520,055007,晶相光元富9A購02,,,,,0.00,0.00,0,0,0,0,0,0,0,0,0,0,0,0,0
20200520,055008,隆達元富97購01,1.17,1.88,1.01,1.62,+0.64,65.31,97000,16,142350,0,0,0,0,0,0,17000,60000,-43000,-43000
20200520,055009,合勤控元富97購01,,,,,0.00,0.00,0,0,0,0,0,0,0,0,0,0,0,0,0
20200520,05500P,臺股指中信96售04,0.71,0.71,0.70,0.70,-0.16,-18.6,20000,2,14100,0,0,0,0,0,0,0,20000,-20000,-20000
20200520,055010,佐登元富97購01,,,,,0.00,0.00,0,0,0,0,0,0,0,0,0,0,0,0,0
20200520,055011,元翎元富97購01,,,,,0.00,0.00,0,0,0,0,0,0,0,0,0,0,0,0,0
20200520,055012,茂林元富97購01,,,,,0.00,0.00,0,0,0,0,0,0,0,0,0,0,0,0,0
20200520,055013,訊連元富97購01,0.69,0.69,0.69,0.69,-0.08,-10.39,10000,1,6900,0,0,0,0,0,0,10000,0,10000,10000
20200520,055014,達興元富97購01,0.56,0.57,0.56,0.57,+0.01,1.79,400000,2,227500,0,0,0,0,0,0,400000,0,400000,400000
20200520,055015,帆宣元富97購01,0.37,0.37,0.37,0.37,0.00,0.00,3000,1,1110,0,0,0,0,0,0,3000,0,3000,3000
20200520,055016,群電元富97購01,,,,,0.00,0.00,0,0,0,0,0,0,0,0,0,0,0,0,0
20200520,055017,緯穎元富97購01,,,,,0.00,0.00,0,0,0,0,0,0,0,0,0,0,0,0,0
20200520,055018,緯穎元富97購02,,,,,0.00,0.00,0,0,0,0,0,0,0,0,0,0,0,0,0
20200520,055019,福懋科元富97購01,1.33,1.35,1.33,1.35,+0.10,8.0,60000,5,80300,0,0,0,0,0,0,20000,40000,-20000,-20000
20200520,05501P,健策國票97售01,,,,,0.00,0.00,0,0,0,0,0,0,0,0,0,0,0,0,0
20200520,055020,上証2X國泰98購01,,,,,0.00,0.00,0,0,0,0,0,0,0,0,0,0,0,0,0
20200520,055021,亞德客國泰98購01,2.73,2.73,2.73,2.73,0.00,0.00,2000,1,5460,0,0,0,0,0,0,0,2000,-2000,-2000
20200520,055022,精元國泰99購01,0.32,0.32,0.32,0.32,0.00,0.00,2000,1,640,0,0,0,0,0,0,2000,0,2000,2000
20200520,055023,億光國泰98購01,,,,,0.00,0.00,0,0,0,0,0,0,0,0,0,0,0,0,0
20200520,055024,興勤國泰98購01,,,,,0.00,0.00,0,0,0,0,0,0,0,0,0,0,0,0,0
20200520,055025,華新科國泰98購02,0.92,0.92,0.90,0.90,-0.01,-1.1,129000,17,118190,0,0,0,0,0,0,129000,0,129000,129000
20200520,055026,健和興國泰98購01,,,,,0.00,0.00,0,0,0,0,0,0,0,0,0,0,0,0,0
20200520,055027,牧德國泰99購01,0.58,0.58,0.58,0.58,0.00,0.00,30000,3,17400,0,0,0,0,0,0,0,0,0,0
20200520,055028,佐登國泰98購01,,,,,0.00,0.00,0,0,0,0,0,0,0,0,0,0,0,0,0
20200520,055029,帆宣國泰99購01,,,,,0.00,0.00,0,0,0,0,0,0,0,0,0,0,0,0,0
20200520,05502P,台表科國票97售01,0.59,0.63,0.50,0.50,-0.27,-35.06,42000,6,23120,0,0,0,0,0,0,1000,41000,-40000,-40000
20200520,055030,帆宣國泰99購02,0.80,0.80,0.80,0.80,+0.02,2.56,126000,2,100800,0,0,0,0,0,0,64000,62000,2000,2000
20200520,055031,南港富邦99購01,,,,,0.00,0.00,0,0,0,0,0,0,0,0,0,0,0,0,0
20200520,055032,億光富邦99購01,0.38,0.47,0.38,0.41,+0.01,2.5,162000,22,71460,0,0,0,0,0,0,39000,123000,-84000,-84000
20200520,055033,漢唐富邦98購01,,,,,0.00,0.00,0,0,0,0,0,0,0,0,0,0,0,0,0
20200520,055034,建準富邦99購01,0.48,0.49,0.45,0.49,-0.08,-14.04,22000,3,10600,0,0,0,0,0,0,12000,10000,2000,2000
20200520,055035,興勤富邦98購01,,,,,0.00,0.00,0,0,0,0,0,0,0,0,0,0,0,0,0
20200520,055036,中工富邦9B購01,0.52,0.52,0.51,0.51,0.00,0.00,70000,7,36000,0,0,0,0,0,0,20000,50000,-30000,-30000
20200520,055037,宏盛富邦99購01,,,,,0.00,0.00,0,0,0,0,0,0,0,0,0,0,0,0,0
20200520,055038,華航富邦99購01,,,,,0.00,0.00,0,0,0,0,0,0,0,0,0,0,0,0,0
20200520,055039,神達富邦99購01,,,,,0.00,0.00,0,0,0,0,0,0,0,0,0,0,0,0,0
20200520,05503P,智邦日盛96售01,,,,,0.00,0.00,0,0,0,0,0,0,0,0,0,0,0,0,0
20200520,055040,台虹富邦99購01,,,,,0.00,0.00,0,0,0,0,0,0,0,0,0,0,0,0,0
20200520,055041,致新富邦97購01,0.60,0.60,0.60,0.60,0.00,0.00,160000,1,96000,0,0,0,0,0,0,160000,0,160000,160000
20200520,055042,得力永豐97購01,,,,,0.00,0.00,0,0,0,0,0,0,0,0,0,0,0,0,0
20200520,055043,中砂永豐97購01,,,,,0.00,0.00,0,0,0,0,0,0,0,0,0,0,0,0,0
20200520,055044,信錦永豐97購01,,,,,0.00,0.00,0,0,0,0,0,0,0,0,0,0,0,0,0
20200520,055045,台肥永豐97購01,,,,,0.00,0.00,0,0,0,0,0,0,0,0,0,0,0,0,0
20200520,055046,上銀永豐97購01,,,,,0.00,0.00,0,0,0,0,0,0,0,0,0,0,0,0,0
20200520,055047,南港永豐97購01,,,,,0.00,0.00,0,0,0,0,0,0,0,0,0,0,0,0,0
20200520,055048,台積電永豐97購04,,,,,0.00,0.00,0,0,0,0,0,0,0,0,0,0,0,0,0
20200520,055049,智邦永豐97購01,0.58,0.58,0.56,0.58,+0.05,9.43,148000,9,83050,0,0,0,0,0,0,2000,146000,-144000,-144000
20200520,05504P,台積電凱基96售04,,,,,0.00,0.00,0,0,0,0,0,0,0,0,0,0,0,0,0
20200520,055050,敬鵬永豐97購01,,,,,0.00,0.00,0,0,0,0,0,0,0,0,0,0,0,0,0
20200520,055051,藍天永豐97購01,,,,,0.00,0.00,0,0,0,0,0,0,0,0,0,0,0,0,0
20200520,055052,凱美永豐97購01,,,,,0.00,0.00,0,0,0,0,0,0,0,0,0,0,0,0,0
20200520,055053,瑞昱永豐97購01,,,,,0.00,0.00,0,0,0,0,0,0,0,0,0,0,0,0,0
20200520,055054,群光永豐97購01,,,,,0.00,0.00,0,0,0,0,0,0,0,0,0,0,0,0,0
20200520,055055,精元永豐97購01,,,,,0.00,0.00,0,0,0,0,0,0,0,0,0,0,0,0,0
20200520,055056,億光永豐97購01,0.05,0.05,0.05,0.05,+0.01,25.0,10000,1,500,0,0,0,0,0,0,0,10000,-10000,-10000
20200520,055057,興勤永豐97購01,,,,,0.00,0.00,0,0,0,0,0,0,0,0,0,0,0,0,0
20200520,055058,大毅永豐97購01,1.69,1.87,1.69,1.74,+0.05,2.96,140000,18,244540,0,0,0,0,0,0,18000,122000,-104000,-104000
20200520,055059,健和興永豐97購01,,,,,0.00,0.00,0,0,0,0,0,0,0,0,0,0,0,0,0
20200520,05505P,聯發科凱基96售09,,,,,0.00,0.00,0,0,0,0,0,0,0,0,0,0,0,0,0
20200520,055060,聯陽永豐97購01,1.43,1.43,1.32,1.37,+0.22,19.13,213000,10,289700,0,0,0,0,0,0,124000,83000,41000,41000
20200520,055061,聯詠永豐97購01,,,,,0.00,0.00,0,0,0,0,0,0,0,0,0,0,0,0,0
20200520,055062,文曄永豐97購01,,,,,0.00,0.00,0,0,0,0,0,0,0,0,0,0,0,0,0
20200520,055063,玉晶光永豐99購01,0.18,0.20,0.18,0.20,+0.04,25.0,165000,2,29800,0,0,0,0,0,0,165000,0,165000,165000
20200520,055064,碩天永豐97購01,,,,,0.00,0.00,0,0,0,0,0,0,0,0,0,0,0,0,0
20200520,055065,神達永豐97購01,,,,,0.00,0.00,0,0,0,0,0,0,0,0,0,0,0,0,0
20200520,055066,佐登永豐97購01,,,,,0.00,0.00,0,0,0,0,0,0,0,0,0,0,0,0,0
20200520,055067,禾聯碩永豐97購01,,,,,0.00,0.00,0,0,0,0,0,0,0,0,0,0,0,0,0
20200520,055068,亞翔永豐97購01,,,,,0.00,0.00,0,0,0,0,0,0,0,0,0,0,0,0,0
20200520,055069,帆宣永豐97購01,,,,,0.00,0.00,0,0,0,0,0,0,0,0,0,0,0,0,0
20200520,05506P,茂林凱基96售03,,,,,0.00,0.00,0,0,0,0,0,0,0,0,0,0,0,0,0
20200520,055070,聯茂永豐97購01,,,,,0.00,0.00,0,0,0,0,0,0,0,0,0,0,0,0,0
20200520,055071,群電永豐97購01,1.09,1.09,1.09,1.09,+0.02,1.87,71000,2,77390,0,0,0,0,0,0,71000,0,71000,71000
20200520,055072,康友永豐97購02,,,,,0.00,0.00,0,0,0,0,0,0,0,0,0,0,0,0,0
20200520,055073,易華電永豐97購01,,,,,0.00,0.00,0,0,0,0,0,0,0,0,0,0,0,0,0
20200520,055074,台虹永豐97購01,,,,,0.00,0.00,0,0,0,0,0,0,0,0,0,0,0,0,0
20200520,055075,南電永豐97購01,3.27,3.27,2.95,2.95,0.00,0.00,20000,2,62200,0,0,0,0,0,0,10000,10000,0,0
20200520,055076,福懋科永豐97購01,,,,,0.00,0.00,0,0,0,0,0,0,0,0,0,0,0,0,0
20200520,055077,臺股指永豐97購02,,,,,0.00,0.00,0,0,0,0,0,0,0,0,0,0,0,0,0
20200520,055078,亞泥中信98購01,,,,,0.00,0.00,0,0,0,0,0,0,0,0,0,0,0,0,0
20200520,055079,台光電中信97購01,,,,,0.00,0.00,0,0,0,0,0,0,0,0,0,0,0,0,0
20200520,05507P,聯茂凱基96售02,,,,,0.00,0.00,0,0,0,0,0,0,0,0,0,0,0,0,0
20200520,055080,正崴中信99購01,,,,,0.00,0.00,0,0,0,0,0,0,0,0,0,0,0,0,0
20200520,055081,健鼎中信97購01,0.02,0.02,0.02,0.02,0.00,0.00,5000,1,100,0,0,0,0,0,0,0,0,0,0
20200520,055082,台郡中信97購01,,,,,0.00,0.00,0,0,0,0,0,0,0,0,0,0,0,0,0
20200520,055083,康友中信97購01,,,,,0.00,0.00,0,0,0,0,0,0,0,0,0,0,0,0,0
20200520,055084,國巨第一97購01,,,,,0.00,0.00,0,0,0,0,0,0,0,0,0,0,0,0,0
20200520,055085,大毅國票97購01,3.86,4.31,3.46,3.46,-0.24,-6.49,51000,3,200160,0,0,0,0,0,0,38000,13000,25000,25000
20200520,055086,華邦電亞東98購01,,,,,0.00,0.00,0,0,0,0,0,0,0,0,0,0,0,0,0
20200520,055087,瑞昱亞東97購01,,,,,0.00,0.00,0,0,0,0,0,0,0,0,0,0,0,0,0
20200520,055088,聯詠亞東97購01,,,,,0.00,0.00,0,0,0,0,0,0,0,0,0,0,0,0,0
20200520,055089,金寶群益98購01,,,,,0.00,0.00,0,0,0,0,0,0,0,0,0,0,0,0,0
20200520,05508P,華通統一97售01,,,,,0.00,0.00,0,0,0,0,0,0,0,0,0,0,0,0,0
20200520,055090,國巨群益97購03,1.51,1.51,1.51,1.51,0.00,0.00,1000,1,1510,0,0,0,0,0,0,1000,1000,0,0
20200520,055091,微星群益97購01,1.57,1.57,1.57,1.57,+0.24,18.05,5000,1,7850,0,0,0,0,0,0,5000,0,5000,5000
20200520,055092,開發金群益9B購01,1.11,1.11,1.11,1.11,-0.01,-0.89,91000,2,101010,0,0,0,0,0,0,91000,26000,65000,65000
20200520,055093,京鼎群益98購01,0.97,0.98,0.97,0.98,-0.02,-2.0,57000,2,55300,0,0,0,0,0,0,56000,1000,55000,55000
20200520,055094,智易群益98購01,0.68,0.68,0.66,0.66,-0.04,-5.71,11000,2,7280,0,0,0,0,0,0,0,11000,-11000,-11000
20200520,055095,啟碁群益98購01,,,,,0.00,0.00,0,0,0,0,0,0,0,0,0,0,0,0,0
20200520,055096,緯穎群益97購01,2.56,2.56,2.38,2.38,-0.34,-12.5,10000,5,24780,0,0,0,0,0,0,0,10000,-10000,-10000
20200520,055097,福懋科群益97購01,1.09,1.09,1.09,1.09,+0.01,0.93,70000,1,76300,0,0,0,0,0,0,0,70000,-70000,-70000
20200520,055098,臺股指群益97購01,,,,,0.00,0.00,0,0,0,0,0,0,0,0,0,0,0,0,0
20200520,055099,可成日盛97購01,,,,,0.00,0.00,0,0,0,0,0,0,0,0,0,0,0,0,0
20200520,05509P,智邦元富96售02,,,,,0.00,0.00,0,0,0,0,0,0,0,0,0,0,0,0,0
20200520,055100,得力凱基97購01,,,,,0.00,0.00,0,0,0,0,0,0,0,0,0,0,0,0,0
20200520,055101,台肥凱基97購01,,,,,0.00,0.00,0,0,0,0,0,0,0,0,0,0,0,0,0
20200520,055102,上銀凱基98購01,,,,,0.00,0.00,0,0,0,0,0,0,0,0,0,0,0,0,0
20200520,055103,南港凱基97購01,,,,,0.00,0.00,0,0,0,0,0,0,0,0,0,0,0,0,0
20200520,055104,台達電凱基98購01,0.55,0.55,0.50,0.50,-0.03,-5.66,143000,15,78100,0,0,0,0,0,0,143000,1000,142000,142000
20200520,055105,鴻海凱基98購05,,,,,0.00,0.00,0,0,0,0,0,0,0,0,0,0,0,0,0
20200520,055106,台積電凱基98購05,,,,,0.00,0.00,0,0,0,0,0,0,0,0,0,0,0,0,0
20200520,055107,旺宏凱基98購04,,,,,0.00,0.00,0,0,0,0,0,0,0,0,0,0,0,0,0
20200520,055108,智邦凱基98購01,,,,,0.00,0.00,0,0,0,0,0,0,0,0,0,0,0,0,0
20200520,055109,正崴凱基98購01,,,,,0.00,0.00,0,0,0,0,0,0,0,0,0,0,0,0,0
20200520,05510P,燿華元富96售01,,,,,0.00,0.00,0,0,0,0,0,0,0,0,0,0,0,0,0
20200520,055110,美律凱基98購02,,,,,0.00,0.00,0,0,0,0,0,0,0,0,0,0,0,0,0
20200520,055111,宏盛凱基97購01,,,,,0.00,0.00,0,0,0,0,0,0,0,0,0,0,0,0,0
20200520,055112,晶豪科凱基98購01,2.33,2.40,2.17,2.17,-0.28,-11.43,162000,7,369430,0,0,0,0,0,0,112000,120000,-8000,-8000
20200520,055113,大立光凱基98購06,,,,,0.00,0.00,0,0,0,0,0,0,0,0,0,0,0,0,0
20200520,055114,新日興凱基98購01,0.61,0.73,0.61,0.73,0.00,0.00,92000,2,64520,0,0,0,0,0,0,0,92000,-92000,-92000
20200520,055115,日月光凱基98購01,,,,,0.00,0.00,0,0,0,0,0,0,0,0,0,0,0,0,0
20200520,055116,康控凱基98購01,,,,,0.00,0.00,0,0,0,0,0,0,0,0,0,0,0,0,0
20200520,055117,臻鼎凱基98購02,,,,,0.00,0.00,0,0,0,0,0,0,0,0,0,0,0,0,0
20200520,055118,嘉聯益凱基98購02,,,,,0.00,0.00,0,0,0,0,0,0,0,0,0,0,0,0,0
20200520,055119,力成凱基98購01,,,,,0.00,0.00,0,0,0,0,0,0,0,0,0,0,0,0,0
20200520,05511P,T50反1台新06售01,0.69,0.69,0.69,0.69,-0.01,-1.43,3000,1,2070,0,0,0,0,0,0,3000,0,3000,3000
20200520,055120,南港兆豐97購01,0.18,0.18,0.04,0.07,0.00,0.00,128000,6,6690,0,0,0,0,0,0,95000,10000,85000,85000
20200520,055121,鴻海兆豐97購03,0.32,0.32,0.32,0.32,0.00,0.00,100000,1,32000,0,0,0,0,0,0,0,100000,-100000,-100000
20200520,055122,國巨兆豐98購01,0.35,0.35,0.30,0.30,+0.13,76.47,30000,3,10000,0,0,0,0,0,0,30000,20000,10000,10000
20200520,055123,億光兆豐97購01,,,,,0.00,0.00,0,0,0,0,0,0,0,0,0,0,0,0,0
20200520,055124,建準兆豐97購01,1.96,1.96,1.77,1.77,-0.31,-14.9,531000,50,988180,0,0,0,0,0,0,332000,199000,133000,133000
20200520,055125,智原兆豐97購01,0.06,0.06,0.06,0.06,0.00,0.00,10000,1,600,0,0,0,0,0,0,10000,10000,0,0
20200520,055126,嘉澤兆豐97購01,,,,,0.00,0.00,0,0,0,0,0,0,0,0,0,0,0,0,0
20200520,055127,台虹兆豐97購01,0.75,0.76,0.74,0.76,-0.02,-2.56,193000,5,144310,0,0,0,0,0,0,90000,83000,7000,7000
20200520,055128,致新兆豐97購01,,,,,0.00,0.00,0,0,0,0,0,0,0,0,0,0,0,0,0
20200520,055129,鈺齊兆豐97購01,,,,,0.00,0.00,0,0,0,0,0,0,0,0,0,0,0,0,0
20200520,05512P,華新科台新97售01,,,,,0.00,0.00,0,0,0,0,0,0,0,0,0,0,0,0,0
20200520,055130,京鼎康和97購01,,,,,0.00,0.00,0,0,0,0,0,0,0,0,0,0,0,0,0
20200520,055131,茂林康和97購01,0.38,0.49,0.37,0.49,+0.15,44.12,959000,20,400760,0,0,0,0,0,0,309000,645000,-336000,-336000
20200520,055132,台虹康和97購01,,,,,0.00,0.00,0,0,0,0,0,0,0,0,0,0,0,0,0
20200520,055133,致新康和97購01,0.97,0.97,0.92,0.92,+0.06,6.98,23000,2,22260,0,0,0,0,0,0,22000,1000,21000,21000
20200520,055134,元油反國泰99購01,,,,,0.00,0.00,0,0,0,0,0,0,0,0,0,0,0,0,0
20200520,055135,聯發科富邦99購05,,,,,0.00,0.00,0,0,0,0,0,0,0,0,0,0,0,0,0
20200520,055136,聯發科富邦99購06,3.25,3.62,3.23,3.29,+0.15,4.78,390000,34,1343220,0,0,0,0,0,0,278000,112000,166000,166000
20200520,055137,GIS富邦98購01,,,,,0.00,0.00,0,0,0,0,0,0,0,0,0,0,0,0,0
20200520,055138,大毅永豐97購02,1.17,1.29,1.17,1.21,+0.04,3.42,134000,18,163440,0,0,0,0,0,0,6000,108000,-102000,-102000
20200520,055139,欣興永豐97購01,,,,,0.00,0.00,0,0,0,0,0,0,0,0,0,0,0,0,0
20200520,05513P,玉山金台新96售01,,,,,0.00,0.00,0,0,0,0,0,0,0,0,0,0,0,0,0
20200520,055140,晶相光永豐97購01,,,,,0.00,0.00,0,0,0,0,0,0,0,0,0,0,0,0,0
20200520,055141,牧德永豐98購02,,,,,0.00,0.00,0,0,0,0,0,0,0,0,0,0,0,0,0
20200520,055142,健策永豐98購01,0.60,0.64,0.60,0.64,-0.03,-4.48,17000,2,10840,0,0,0,0,0,0,0,17000,-17000,-17000
20200520,055143,臻鼎永豐97購01,,,,,0.00,0.00,0,0,0,0,0,0,0,0,0,0,0,0,0
20200520,055144,T50反1元大97購03,,,,,0.00,0.00,0,0,0,0,0,0,0,0,0,0,0,0,0
20200520,055145,T50反1元大97購04,,,,,0.00,0.00,0,0,0,0,0,0,0,0,0,0,0,0,0
20200520,055146,華通元大98購04,0.36,0.36,0.36,0.36,0.00,0.00,20000,1,7200,0,0,0,0,0,0,20000,0,20000,20000
20200520,055147,鴻海元大97購11,0.25,0.25,0.25,0.25,0.00,0.00,20000,2,5000,0,0,0,0,0,0,0,20000,-20000,-20000
20200520,055148,鴻海元大98購02,,,,,0.00,0.00,0,0,0,0,0,0,0,0,0,0,0,0,0
20200520,055149,國巨元大97購06,,,,,0.00,0.00,0,0,0,0,0,0,0,0,0,0,0,0,0
20200520,05514P,康舒永豐96售01,,,,,0.00,0.00,0,0,0,0,0,0,0,0,0,0,0,0,0
20200520,055150,台積電元大98購04,,,,,0.00,0.00,0,0,0,0,0,0,0,0,0,0,0,0,0
20200520,055151,台積電元大98購05,,,,,0.00,0.00,0,0,0,0,0,0,0,0,0,0,0,0,0
20200520,055152,旺宏元大98購04,,,,,0.00,0.00,0,0,0,0,0,0,0,0,0,0,0,0,0
20200520,055153,台光電元大98購02,1.23,1.23,1.22,1.23,-0.02,-1.6,100000,8,122500,0,0,0,0,0,0,100000,0,100000,100000
20200520,055154,聯發科元大98購01,2.40,2.40,2.17,2.17,+0.18,9.05,6000,2,13480,0,0,0,0,0,0,6000,0,6000,6000
20200520,055155,奇力新元大99購01,,,,,0.00,0.00,0,0,0,0,0,0,0,0,0,0,0,0,0
20200520,055156,華新科元大99購02,,,,,0.00,0.00,0,0,0,0,0,0,0,0,0,0,0,0,0
20200520,055157,晶豪科元大97購01,1.56,1.56,1.47,1.47,-0.26,-15.03,190000,16,286460,0,0,0,0,0,0,78000,122000,-44000,-44000
20200520,055158,亞光元大99購01,,,,,0.00,0.00,0,0,0,0,0,0,0,0,0,0,0,0,0
20200520,055159,玉晶光元大98購05,,,,,0.00,0.00,0,0,0,0,0,0,0,0,0,0,0,0,0
20200520,05515P,台積電群益96售03,,,,,0.00,0.00,0,0,0,0,0,0,0,0,0,0,0,0,0
20200520,055160,玉晶光元大99購03,,,,,0.00,0.00,0,0,0,0,0,0,0,0,0,0,0,0,0
20200520,055161,貿聯元大98購03,,,,,0.00,0.00,0,0,0,0,0,0,0,0,0,0,0,0,0
20200520,055162,新唐元大97購01,,,,,0.00,0.00,0,0,0,0,0,0,0,0,0,0,0,0,0
20200520,055163,訊芯元大98購01,0.12,0.12,0.12,0.12,0.00,0.00,30000,1,3600,0,0,0,0,0,0,30000,0,30000,30000
20200520,055164,矽創元大98購01,0.51,0.51,0.51,0.51,+0.05,10.87,20000,2,10200,0,0,0,0,0,0,0,0,0,0
20200520,055165,元油反統一98購01,,,,,0.00,0.00,0,0,0,0,0,0,0,0,0,0,0,0,0
20200520,055166,台積電統一97購05,0.05,0.05,0.05,0.05,0.00,0.00,20000,1,1000,0,0,0,0,0,0,20000,0,20000,20000
20200520,055167,友訊統一97購01,,,,,0.00,0.00,0,0,0,0,0,0,0,0,0,0,0,0,0
20200520,055168,光罩統一98購01,,,,,0.00,0.00,0,0,0,0,0,0,0,0,0,0,0,0,0
20200520,055169,光罩統一99購01,0.04,0.04,0.04,0.04,0.00,0.00,5000,1,200,0,0,0,0,0,0,5000,0,5000,5000
20200520,05516P,台積電元大96售12,,,,,0.00,0.00,0,0,0,0,0,0,0,0,0,0,0,0,0
20200520,055170,光磊統一97購01,,,,,0.00,0.00,0,0,0,0,0,0,0,0,0,0,0,0,0
20200520,055171,凱美統一97購01,0.34,0.34,0.33,0.34,0.00,0.00,70000,3,23600,0,0,0,0,0,0,0,70000,-70000,-70000
20200520,055172,凱美統一97購02,0.53,0.58,0.53,0.54,+0.06,12.5,156000,5,85610,0,0,0,0,0,0,63000,93000,-30000,-30000
20200520,055173,瑞昱統一97購01,3.24,3.24,3.13,3.22,-0.09,-2.72,332000,21,1049270,0,0,0,0,0,0,302000,0,302000,302000
20200520,055174,精元統一97購01,0.31,0.32,0.31,0.32,+0.01,3.23,14000,2,4380,0,0,0,0,0,0,0,14000,-14000,-14000
20200520,055175,建準統一97購01,,,,,0.00,0.00,0,0,0,0,0,0,0,0,0,0,0,0,0
20200520,055176,大毅統一98購02,4.59,4.87,4.59,4.65,-0.06,-1.27,50000,10,236460,0,0,0,0,0,0,10000,40000,-30000,-30000
20200520,055177,宏達電統一99購01,,,,,0.00,0.00,0,0,0,0,0,0,0,0,0,0,0,0,0
20200520,055178,晶豪科統一97購01,2.32,2.32,2.32,2.32,+0.07,3.11,22000,1,51040,0,0,0,0,0,0,22000,0,22000,22000
20200520,055179,大立光統一97購04,,,,,0.00,0.00,0,0,0,0,0,0,0,0,0,0,0,0,0
20200520,05517P,臻鼎元大96售01,,,,,0.00,0.00,0,0,0,0,0,0,0,0,0,0,0,0,0
20200520,055180,文曄統一97購01,,,,,0.00,0.00,0,0,0,0,0,0,0,0,0,0,0,0,0
20200520,055181,日電貿統一97購01,0.72,0.73,0.72,0.73,0.00,0.00,146000,3,105500,0,0,0,0,0,0,0,146000,-146000,-146000
20200520,055182,京鼎統一98購01,,,,,0.00,0.00,0,0,0,0,0,0,0,0,0,0,0,0,0
20200520,055183,聯鈞統一97購01,,,,,0.00,0.00,0,0,0,0,0,0,0,0,0,0,0,0,0
20200520,055184,群創統一98購02,,,,,0.00,0.00,0,0,0,0,0,0,0,0,0,0,0,0,0
20200520,055185,晶相光統一97購01,,,,,0.00,0.00,0,0,0,0,0,0,0,0,0,0,0,0,0
20200520,055186,正文統一97購01,,,,,0.00,0.00,0,0,0,0,0,0,0,0,0,0,0,0,0
20200520,055187,彩晶統一98購01,,,,,0.00,0.00,0,0,0,0,0,0,0,0,0,0,0,0,0
20200520,055188,亞翔統一97購01,,,,,0.00,0.00,0,0,0,0,0,0,0,0,0,0,0,0,0
20200520,055189,台虹統一97購01,,,,,0.00,0.00,0,0,0,0,0,0,0,0,0,0,0,0,0
20200520,05518P,T50反1凱基98售03,,,,,0.00,0.00,0,0,0,0,0,0,0,0,0,0,0,0,0
20200520,055190,華新科元富97購01,,,,,0.00,0.00,0,0,0,0,0,0,0,0,0,0,0,0,0
20200520,055191,牧德元富97購01,0.61,0.61,0.61,0.61,0.00,0.00,5000,1,3050,0,0,0,0,0,0,5000,0,5000,5000
20200520,055192,世芯元富97購01,,,,,0.00,0.00,0,0,0,0,0,0,0,0,0,0,0,0,0
20200520,055193,世芯元富97購02,,,,,0.00,0.00,0,0,0,0,0,0,0,0,0,0,0,0,0
20200520,055194,昇陽半元富97購01,,,,,0.00,0.00,0,0,0,0,0,0,0,0,0,0,0,0,0
20200520,055195,昇陽半元富97購02,,,,,0.00,0.00,0,0,0,0,0,0,0,0,0,0,0,0,0
20200520,055196,致新元富97購01,2.06,2.06,1.89,1.96,+0.16,8.89,233000,13,467130,0,0,0,0,0,0,163000,81000,82000,82000
20200520,055197,致新元富97購02,2.42,2.42,2.26,2.26,+0.20,9.71,116000,5,276440,0,0,0,0,0,0,94000,22000,72000,72000
20200520,055198,奇力新第一97購01,,,,,0.00,0.00,0,0,0,0,0,0,0,0,0,0,0,0,0
20200520,055199,國喬群益97購01,,,,,0.00,0.00,0,0,0,0,0,0,0,0,0,0,0,0,0
20200520,05519P,上証2X凱基98售01,2.65,2.65,2.65,2.65,-0.11,-3.99,2000,1,5300,0,0,0,0,0,0,2000,0,2000,2000
20200520,055200,和大群益98購01,,,,,0.00,0.00,0,0,0,0,0,0,0,0,0,0,0,0,0
20200520,055201,興勤群益98購01,,,,,0.00,0.00,0,0,0,0,0,0,0,0,0,0,0,0,0
20200520,055202,神達群益97購01,,,,,0.00,0.00,0,0,0,0,0,0,0,0,0,0,0,0,0
20200520,055203,建準中信97購01,0.73,0.73,0.54,0.67,-0.03,-4.29,281000,12,177270,0,0,0,0,0,0,80000,201000,-121000,-121000
20200520,055204,宏達電中信99購01,,,,,0.00,0.00,0,0,0,0,0,0,0,0,0,0,0,0,0
20200520,055205,京鼎中信99購01,,,,,0.00,0.00,0,0,0,0,0,0,0,0,0,0,0,0,0
20200520,055206,台虹中信97購01,,,,,0.00,0.00,0,0,0,0,0,0,0,0,0,0,0,0,0
20200520,055207,致新中信99購01,0.61,0.66,0.60,0.63,+0.12,23.53,121000,10,77160,0,0,0,0,0,0,118000,3000,115000,115000
20200520,055208,京鼎康和97購02,,,,,0.00,0.00,0,0,0,0,0,0,0,0,0,0,0,0,0
20200520,055209,勤誠康和97購01,,,,,0.00,0.00,0,0,0,0,0,0,0,0,0,0,0,0,0
20200520,05520P,聯詠凱基96售01,,,,,0.00,0.00,0,0,0,0,0,0,0,0,0,0,0,0,0
20200520,055210,S&P正2凱基97購01,0.04,0.05,0.04,0.05,0.00,0.00,5000,2,210,0,0,0,0,0,0,0,0,0,0
20200520,055211,A50反1凱基9A購01,,,,,0.00,0.00,0,0,0,0,0,0,0,0,0,0,0,0,0
20200520,055212,和大凱基97購02,,,,,0.00,0.00,0,0,0,0,0,0,0,0,0,0,0,0,0
20200520,055213,大成鋼凱基98購01,,,,,0.00,0.00,0,0,0,0,0,0,0,0,0,0,0,0,0
20200520,055214,聯電凱基97購02,0.19,0.19,0.16,0.17,-0.02,-10.53,81000,8,13870,0,0,0,0,0,0,56000,45000,11000,11000
20200520,055215,智邦凱基98購02,,,,,0.00,0.00,0,0,0,0,0,0,0,0,0,0,0,0,0
20200520,055216,友達凱基98購05,0.73,0.77,0.73,0.76,+0.01,1.33,274000,4,209570,0,0,0,0,0,0,57000,217000,-160000,-160000
20200520,055217,緯創凱基97購02,1.88,1.89,1.87,1.89,0.00,0.00,44000,5,82810,0,0,0,0,0,0,44000,0,44000,44000
20200520,055218,彩晶凱基99購01,,,,,0.00,0.00,0,0,0,0,0,0,0,0,0,0,0,0,0
20200520,055219,啟碁凱基98購01,,,,,0.00,0.00,0,0,0,0,0,0,0,0,0,0,0,0,0
20200520,05521P,創意永豐96售01,1.22,1.23,1.22,1.23,-0.04,-3.15,4000,4,4900,0,0,0,0,0,0,4000,0,4000,4000
20200520,055220,緯穎凱基98購02,,,,,0.00,0.00,0,0,0,0,0,0,0,0,0,0,0,0,0
20200520,055221,矽創凱基97購02,0.72,0.73,0.66,0.70,-0.02,-2.78,144000,20,101180,0,0,0,0,0,0,144000,0,144000,144000
20200520,055222,臺股指凱基97購05,,,,,0.00,0.00,0,0,0,0,0,0,0,0,0,0,0,0,0
20200520,055223,和大國票98購01,,,,,0.00,0.00,0,0,0,0,0,0,0,0,0,0,0,0,0
20200520,055224,鴻海國票99購02,,,,,0.00,0.00,0,0,0,0,0,0,0,0,0,0,0,0,0
20200520,055225,華邦電國票99購01,,,,,0.00,0.00,0,0,0,0,0,0,0,0,0,0,0,0,0
20200520,055226,聯發科國票97購05,,,,,0.00,0.00,0,0,0,0,0,0,0,0,0,0,0,0,0
20200520,055227,聯發科國票98購02,3.28,3.52,3.27,3.29,+0.25,8.22,7000,6,23220,0,0,0,0,0,0,4000,3000,1000,1000
20200520,055228,聯發科國票98購03,2.58,2.58,2.58,2.58,+0.21,8.86,5000,1,12900,0,0,0,0,0,0,5000,0,5000,5000
20200520,055229,大毅國票97購02,3.90,4.44,3.81,3.81,-0.15,-3.79,8000,7,31570,0,0,0,0,0,0,4000,4000,0,0
20200520,05522P,友達元富96售02,,,,,0.00,0.00,0,0,0,0,0,0,0,0,0,0,0,0,0
20200520,055230,大毅國票98購01,6.20,6.20,6.05,6.05,0.00,0.00,17000,3,104200,0,0,0,0,0,0,0,17000,-17000,-17000
20200520,055231,大毅國票98購02,,,,,0.00,0.00,0,0,0,0,0,0,0,0,0,0,0,0,0
20200520,055232,泰碩國票98購01,1.57,1.57,1.48,1.48,-0.10,-6.33,70000,3,107900,0,0,0,0,0,0,70000,20000,50000,50000
20200520,055233,康友國票98購01,,,,,0.00,0.00,0,0,0,0,0,0,0,0,0,0,0,0,0
20200520,055234,昇陽半國票98購02,,,,,0.00,0.00,0,0,0,0,0,0,0,0,0,0,0,0,0
20200520,055235,金寶台新98購01,0.58,0.58,0.52,0.58,-0.02,-3.33,400000,8,223150,0,0,0,0,0,0,280000,120000,160000,160000
20200520,055236,建準台新98購01,,,,,0.00,0.00,0,0,0,0,0,0,0,0,0,0,0,0,0
20200520,055237,晶豪科台新97購01,,,,,0.00,0.00,0,0,0,0,0,0,0,0,0,0,0,0,0
20200520,055238,茂林台新97購01,,,,,0.00,0.00,0,0,0,0,0,0,0,0,0,0,0,0,0
20200520,055239,帆宣台新97購01,0.10,0.10,0.10,0.10,0.00,0.00,85000,2,8500,0,0,0,0,0,0,85000,0,85000,85000
20200520,05523P,聯發科國票96售04,0.50,0.53,0.42,0.48,-0.15,-23.81,173000,10,79100,0,0,0,0,0,0,30000,143000,-113000,-113000
20200520,055240,京元電元富97購01,0.33,0.33,0.32,0.32,-0.08,-20.0,41000,4,13330,0,0,0,0,0,0,41000,0,41000,41000
20200520,055241,T50反1統一99購01,,,,,0.00,0.00,0,0,0,0,0,0,0,0,0,0,0,0,0
20200520,055242,道瓊銀統一98購01,,,,,0.00,0.00,0,0,0,0,0,0,0,0,0,0,0,0,0
20200520,055243,國巨統一97購04,0.11,0.11,0.11,0.11,+0.01,10.0,5000,1,550,0,0,0,0,0,0,0,5000,-5000,-5000
20200520,055244,國巨統一98購01,0.89,1.09,0.89,0.97,+0.18,22.78,180000,9,175810,0,0,0,0,0,0,133000,80000,53000,53000
20200520,055245,凱美統一99購01,0.60,0.60,0.56,0.56,+0.02,3.7,64000,6,37340,0,0,0,0,0,0,34000,30000,4000,4000
20200520,055246,美律統一98購01,,,,,0.00,0.00,0,0,0,0,0,0,0,0,0,0,0,0,0
20200520,055247,聯發科統一98購01,,,,,0.00,0.00,0,0,0,0,0,0,0,0,0,0,0,0,0
20200520,055248,可成統一97購02,0.44,0.44,0.44,0.44,-0.23,-34.33,1000,1,440,0,0,0,0,0,0,0,0,0,0
20200520,055249,大毅統一99購01,1.08,1.08,0.96,0.96,+0.01,1.05,58000,3,61780,0,0,0,0,0,0,3000,55000,-52000,-52000
20200520,05524P,瀚宇博國票97售02,1.73,1.84,1.73,1.84,+0.03,1.66,97000,8,175190,0,0,0,0,0,0,27000,70000,-43000,-43000
20200520,055250,華新科統一97購02,,,,,0.00,0.00,0,0,0,0,0,0,0,0,0,0,0,0,0
20200520,055251,華新科統一99購01,0.26,0.26,0.26,0.26,+0.01,4.0,10000,6,2600,0,0,0,0,0,0,10000,0,10000,10000
20200520,055252,新光金統一98購02,,,,,0.00,0.00,0,0,0,0,0,0,0,0,0,0,0,0,0
20200520,055253,大立光統一97購06,,,,,0.00,0.00,0,0,0,0,0,0,0,0,0,0,0,0,0
20200520,055254,聯詠統一97購03,0.94,0.97,0.88,0.95,-0.12,-11.21,481000,23,453210,0,0,0,0,0,0,421000,50000,371000,371000
20200520,055255,欣興統一97購02,0.29,0.30,0.22,0.29,+0.06,26.09,191000,12,50230,0,0,0,0,0,0,70000,71000,-1000,-1000
20200520,055256,日電貿統一99購01,1.34,1.34,1.34,1.34,-0.03,-2.19,2000,1,2680,0,0,0,0,0,0,2000,0,2000,2000
20200520,055257,景碩統一97購01,1.71,1.75,1.43,1.47,-0.22,-13.02,195000,6,300650,0,0,0,0,0,0,100000,95000,5000,5000
20200520,055258,玉晶光統一97購03,0.16,0.16,0.16,0.16,+0.01,6.67,10000,1,1600,0,0,0,0,0,0,10000,0,10000,10000
20200520,055259,玉晶光統一9A購01,0.54,0.54,0.54,0.54,0.00,0.00,40000,2,21600,0,0,0,0,0,0,0,40000,-40000,-40000
20200520,05525P,奇力新群益96售02,,,,,0.00,0.00,0,0,0,0,0,0,0,0,0,0,0,0,0
20200520,055260,晶相光統一98購01,,,,,0.00,0.00,0,0,0,0,0,0,0,0,0,0,0,0,0
20200520,055261,帆宣統一98購01,0.71,0.71,0.71,0.71,0.00,0.00,40000,1,28400,0,0,0,0,0,0,40000,0,40000,40000
20200520,055262,台虹國泰98購01,,,,,0.00,0.00,0,0,0,0,0,0,0,0,0,0,0,0,0
20200520,055263,華新科富邦9A購01,0.18,0.30,0.18,0.18,-0.02,-10.0,142000,7,26770,0,0,0,0,0,0,0,115000,-115000,-115000
20200520,055264,國巨永豐98購01,0.93,0.97,0.93,0.97,+0.14,16.87,11000,2,10630,0,0,0,0,0,0,1000,10000,-9000,-9000
20200520,055265,玉晶光永豐98購03,0.17,0.17,0.17,0.17,+0.02,13.33,30000,1,5100,0,0,0,0,0,0,0,30000,-30000,-30000
20200520,055266,京鼎永豐97購01,,,,,0.00,0.00,0,0,0,0,0,0,0,0,0,0,0,0,0
20200520,055267,百和永豐97購01,,,,,0.00,0.00,0,0,0,0,0,0,0,0,0,0,0,0,0
20200520,055268,和大元大97購01,,,,,0.00,0.00,0,0,0,0,0,0,0,0,0,0,0,0,0
20200520,055269,和大元大97購02,,,,,0.00,0.00,0,0,0,0,0,0,0,0,0,0,0,0,0
20200520,05526P,茂林群益96售03,,,,,0.00,0.00,0,0,0,0,0,0,0,0,0,0,0,0,0
20200520,055270,上銀元大97購03,,,,,0.00,0.00,0,0,0,0,0,0,0,0,0,0,0,0,0
20200520,055271,鴻海元大98購03,0.66,0.66,0.66,0.66,-0.02,-2.94,51000,1,33660,0,0,0,0,0,0,51000,0,51000,51000
20200520,055272,國巨元大98購04,0.54,0.54,0.54,0.54,0.00,0.00,1000,1,540,0,0,0,0,0,0,0,1000,-1000,-1000
20200520,055273,華泰元大97購01,,,,,0.00,0.00,0,0,0,0,0,0,0,0,0,0,0,0,0
20200520,055274,華泰元大97購02,,,,,0.00,0.00,0,0,0,0,0,0,0,0,0,0,0,0,0
20200520,055275,台積電元大97購19,,,,,0.00,0.00,0,0,0,0,0,0,0,0,0,0,0,0,0
20200520,055276,台積電元大97購20,,,,,0.00,0.00,0,0,0,0,0,0,0,0,0,0,0,0,0
20200520,055277,旺宏元大97購04,,,,,0.00,0.00,0,0,0,0,0,0,0,0,0,0,0,0,0
20200520,055278,旺宏元大98購05,0.20,0.20,0.20,0.20,0.00,0.00,5000,1,1000,0,0,0,0,0,0,5000,0,5000,5000
20200520,055279,華邦電元大97購02,,,,,0.00,0.00,0,0,0,0,0,0,0,0,0,0,0,0,0
20200520,05527P,聯茂群益96售01,0.54,0.54,0.54,0.54,0.00,0.00,1000,1,540,0,0,0,0,0,0,1000,0,1000,1000
20200520,055280,智邦元大97購01,,,,,0.00,0.00,0,0,0,0,0,0,0,0,0,0,0,0,0
20200520,055281,台光電元大98購03,,,,,0.00,0.00,0,0,0,0,0,0,0,0,0,0,0,0,0
20200520,055282,聯發科元大97購15,,,,,0.00,0.00,0,0,0,0,0,0,0,0,0,0,0,0,0
20200520,055283,聯發科元大97購16,2.64,2.64,2.64,2.64,+0.26,10.92,20000,1,52800,0,0,0,0,0,0,20000,0,20000,20000
20200520,055284,全新元大99購01,,,,,0.00,0.00,0,0,0,0,0,0,0,0,0,0,0,0,0
20200520,055285,華新科元大99購03,,,,,0.00,0.00,0,0,0,0,0,0,0,0,0,0,0,0,0
20200520,055286,晶技元大98購03,,,,,0.00,0.00,0,0,0,0,0,0,0,0,0,0,0,0,0
20200520,055287,日電貿元大97購01,1.62,1.62,1.62,1.62,-0.02,-1.22,24000,2,38880,0,0,0,0,0,0,1000,24000,-23000,-23000
20200520,055288,日電貿元大97購02,1.58,1.65,1.57,1.64,+0.03,1.86,248000,8,404160,0,0,0,0,0,0,125000,123000,2000,2000
20200520,055289,泰碩元大98購01,,,,,0.00,0.00,0,0,0,0,0,0,0,0,0,0,0,0,0
20200520,05528P,臺股指群益96售01,0.29,0.30,0.29,0.30,-0.08,-21.05,70000,5,20540,0,0,0,0,0,0,34000,36000,-2000,-2000
20200520,055290,玉晶光元大98購08,,,,,0.00,0.00,0,0,0,0,0,0,0,0,0,0,0,0,0
20200520,055291,京鼎元大97購02,,,,,0.00,0.00,0,0,0,0,0,0,0,0,0,0,0,0,0
20200520,055292,聯鈞元大97購02,,,,,0.00,0.00,0,0,0,0,0,0,0,0,0,0,0,0,0
20200520,055293,晶相光元大97購01,,,,,0.00,0.00,0,0,0,0,0,0,0,0,0,0,0,0,0
20200520,055294,智易元大98購01,,,,,0.00,0.00,0,0,0,0,0,0,0,0,0,0,0,0,0
20200520,055295,瀚宇博元大97購02,0.98,0.98,0.98,0.98,-0.06,-5.77,68000,1,66640,0,0,0,0,0,0,0,68000,-68000,-68000
20200520,055296,康舒元大97購02,,,,,0.00,0.00,0,0,0,0,0,0,0,0,0,0,0,0,0
20200520,055297,啟碁元大97購01,0.85,0.89,0.85,0.85,-0.08,-8.6,176000,4,153240,0,0,0,0,0,0,108000,68000,40000,40000
20200520,055298,啟碁元大97購02,,,,,0.00,0.00,0,0,0,0,0,0,0,0,0,0,0,0,0
20200520,055299,康友元大97購02,,,,,0.00,0.00,0,0,0,0,0,0,0,0,0,0,0,0,0
20200520,05529P,臺股指群益96售02,0.79,0.79,0.79,0.79,-0.13,-14.13,10000,1,7900,0,0,0,0,0,0,10000,0,10000,10000
20200520,055300,緯穎元大98購01,,,,,0.00,0.00,0,0,0,0,0,0,0,0,0,0,0,0,0
20200520,055301,台虹元大97購01,0.99,0.99,0.97,0.99,-0.09,-8.33,202000,4,198600,0,0,0,0,0,0,32000,170000,-138000,-138000
20200520,055302,達方元大97購01,,,,,0.00,0.00,0,0,0,0,0,0,0,0,0,0,0,0,0
20200520,055303,鈺齊元大97購01,,,,,0.00,0.00,0,0,0,0,0,0,0,0,0,0,0,0,0
20200520,055304,瑞昱第一98購01,0.68,0.68,0.68,0.68,+0.01,1.49,39000,9,26520,0,0,0,0,0,0,39000,0,39000,39000
20200520,055305,旺宏群益99購01,1.86,1.86,1.86,1.86,-0.07,-3.63,1000,1,1860,0,0,0,0,0,0,1000,0,1000,1000
20200520,055306,燿華群益97購01,,,,,0.00,0.00,0,0,0,0,0,0,0,0,0,0,0,0,0
20200520,055307,瑞昱群益97購02,,,,,0.00,0.00,0,0,0,0,0,0,0,0,0,0,0,0,0
20200520,055308,聯發科群益97購04,1.71,1.71,1.71,1.71,+0.12,7.55,1000,1,1710,0,0,0,0,0,0,1000,0,1000,1000
20200520,055309,冠德群益97購01,,,,,0.00,0.00,0,0,0,0,0,0,0,0,0,0,0,0,0
20200520,05530P,臺股指群益96售03,1.37,1.37,1.37,1.37,-0.17,-11.04,1000,1,1370,0,0,0,0,0,0,0,1000,-1000,-1000
20200520,055310,聯詠群益97購02,,,,,0.00,0.00,0,0,0,0,0,0,0,0,0,0,0,0,0
20200520,055311,健策群益98購02,0.69,0.73,0.68,0.68,-0.11,-13.92,251000,5,171730,0,0,0,0,0,0,1000,251000,-250000,-250000
20200520,055312,台虹群益99購01,0.94,0.94,0.94,0.94,-0.09,-8.74,34000,1,31960,0,0,0,0,0,0,34000,0,34000,34000
20200520,055313,南電群益97購01,,,,,0.00,0.00,0,0,0,0,0,0,0,0,0,0,0,0,0
20200520,055314,華邦電中信99購01,,,,,0.00,0.00,0,0,0,0,0,0,0,0,0,0,0,0,0
20200520,055315,晶技麥證97購01,,,,,0.00,0.00,0,0,0,0,0,0,0,0,0,0,0,0,0
20200520,055316,上銀國票98購01,,,,,0.00,0.00,0,0,0,0,0,0,0,0,0,0,0,0,0
20200520,055317,金寶國票98購01,,,,,0.00,0.00,0,0,0,0,0,0,0,0,0,0,0,0,0
20200520,055318,華通國票98購01,1.10,1.24,1.10,1.18,-0.03,-2.48,37000,7,45160,0,0,0,0,0,0,10000,27000,-17000,-17000
20200520,055319,國巨國票98購03,,,,,0.00,0.00,0,0,0,0,0,0,0,0,0,0,0,0,0
20200520,05531P,臺股指群益96售04,,,,,0.00,0.00,0,0,0,0,0,0,0,0,0,0,0,0,0
20200520,055320,建準國票98購01,3.78,3.85,3.78,3.85,+0.13,3.49,37000,4,140560,0,0,0,0,0,0,27000,10000,17000,17000
20200520,055321,大立光國票98購02,,,,,0.00,0.00,0,0,0,0,0,0,0,0,0,0,0,0,0
20200520,055322,欣興國票97購06,0.46,0.46,0.46,0.46,+0.18,64.29,1000,1,460,0,0,0,0,0,0,1000,0,1000,1000
20200520,055323,貿聯國票98購01,0.80,0.80,0.80,0.80,-0.01,-1.23,43000,1,34400,0,0,0,0,0,0,43000,0,43000,43000
20200520,055324,TPK國票98購03,,,,,0.00,0.00,0,0,0,0,0,0,0,0,0,0,0,0,0
20200520,055325,佐登國票98購01,,,,,0.00,0.00,0,0,0,0,0,0,0,0,0,0,0,0,0
20200520,055326,緯穎國票97購06,15.40,15.40,13.30,13.30,-4.30,-24.43,18000,3,261000,0,0,0,0,0,0,7000,11000,-4000,-4000
20200520,055327,致新國票98購01,5.65,5.65,5.30,5.35,+0.51,10.54,50000,6,276300,0,0,0,0,0,0,25000,25000,0,0
20200520,055328,鈺齊國票98購01,0.01,0.01,0.01,0.01,0.00,0.00,200000,1,2000,0,0,0,0,0,0,0,0,0,0
20200520,055329,百和國票98購01,,,,,0.00,0.00,0,0,0,0,0,0,0,0,0,0,0,0,0
20200520,05532P,臺股指群益96售05,,,,,0.00,0.00,0,0,0,0,0,0,0,0,0,0,0,0,0
20200520,055330,上銀兆豐98購02,2.40,2.40,2.40,2.40,-0.13,-5.14,15000,1,36000,0,0,0,0,0,0,15000,0,15000,15000
20200520,055331,國巨兆豐99購01,,,,,0.00,0.00,0,0,0,0,0,0,0,0,0,0,0,0,0
20200520,055332,奇力新兆豐98購01,,,,,0.00,0.00,0,0,0,0,0,0,0,0,0,0,0,0,0
20200520,055333,晶豪科兆豐97購01,2.51,2.51,2.42,2.42,-0.32,-11.68,18000,5,44360,0,0,0,0,0,0,5000,13000,-8000,-8000
20200520,055334,禾伸堂兆豐97購01,1.85,1.85,1.68,1.68,-0.05,-2.89,195000,5,349450,0,0,0,0,0,0,20000,175000,-155000,-155000
20200520,055335,健策兆豐98購01,,,,,0.00,0.00,0,0,0,0,0,0,0,0,0,0,0,0,0
20200520,055336,茂林兆豐98購01,1.22,1.38,1.19,1.38,0.00,0.00,515000,13,634310,0,0,0,0,0,0,0,515000,-515000,-515000
20200520,055337,超眾兆豐98購01,,,,,0.00,0.00,0,0,0,0,0,0,0,0,0,0,0,0,0
20200520,055338,GIS兆豐97購01,,,,,0.00,0.00,0,0,0,0,0,0,0,0,0,0,0,0,0
20200520,055339,緯穎兆豐98購01,,,,,0.00,0.00,0,0,0,0,0,0,0,0,0,0,0,0,0
20200520,05533P,滬深2X富邦97售01,,,,,0.00,0.00,0,0,0,0,0,0,0,0,0,0,0,0,0
20200520,055340,華新科日盛97購01,,,,,0.00,0.00,0,0,0,0,0,0,0,0,0,0,0,0,0
20200520,055341,台達電凱基97購02,,,,,0.00,0.00,0,0,0,0,0,0,0,0,0,0,0,0,0
20200520,055342,鴻海凱基97購04,,,,,0.00,0.00,0,0,0,0,0,0,0,0,0,0,0,0,0
20200520,055343,國巨凱基97購03,0.49,0.57,0.49,0.53,+0.07,15.22,105000,4,57450,0,0,0,0,0,0,100000,5000,95000,95000
20200520,055344,國巨凱基97購04,1.38,1.39,1.38,1.39,0.00,0.00,11000,2,15190,0,0,0,0,0,0,1000,11000,-10000,-10000
20200520,055345,國巨凱基98購01,,,,,0.00,0.00,0,0,0,0,0,0,0,0,0,0,0,0,0
20200520,055346,國巨凱基98購02,,,,,0.00,0.00,0,0,0,0,0,0,0,0,0,0,0,0,0
20200520,055347,台積電凱基97購10,,,,,0.00,0.00,0,0,0,0,0,0,0,0,0,0,0,0,0
20200520,055348,旺宏凱基97購01,,,,,0.00,0.00,0,0,0,0,0,0,0,0,0,0,0,0,0
20200520,055349,京元電凱基97購02,0.55,0.57,0.51,0.52,-0.11,-17.46,301000,24,160840,0,0,0,0,0,0,0,301000,-301000,-301000
20200520,05534P,元油反元大96售06,,,,,0.00,0.00,0,0,0,0,0,0,0,0,0,0,0,0,0
20200520,055350,聯發科凱基97購02,2.81,3.01,2.80,2.86,+0.14,5.15,159000,18,454200,0,0,0,0,0,0,129000,30000,99000,99000
20200520,055351,聯發科凱基97購03,6.85,7.55,6.85,7.00,+0.35,5.26,24000,4,170200,0,0,0,0,0,0,20000,4000,16000,16000
20200520,055352,奇力新凱基97購01,,,,,0.00,0.00,0,0,0,0,0,0,0,0,0,0,0,0,0
20200520,055353,華新科凱基98購03,1.69,1.69,1.69,1.69,+0.07,4.32,10000,1,16900,0,0,0,0,0,0,10000,0,10000,10000
20200520,055354,宏達電凱基98購01,0.58,0.58,0.58,0.58,0.00,0.00,10000,1,5800,0,0,0,0,0,0,0,10000,-10000,-10000
20200520,055355,大立光凱基97購05,,,,,0.00,0.00,0,0,0,0,0,0,0,0,0,0,0,0,0
20200520,055356,大立光凱基97購06,0.23,0.23,0.23,0.23,0.00,0.00,5000,1,1150,0,0,0,0,0,0,0,5000,-5000,-5000
20200520,055357,欣興凱基97購04,1.41,1.42,1.41,1.42,0.00,0.00,40000,2,56600,0,0,0,0,0,0,0,40000,-40000,-40000
20200520,055358,臻鼎凱基97購01,0.83,0.95,0.83,0.95,+0.06,6.74,51000,3,44730,0,0,0,0,0,0,50000,1000,49000,49000
20200520,055359,超眾凱基97購01,1.06,1.06,1.06,1.06,-0.01,-0.93,70000,1,74200,0,0,0,0,0,0,0,70000,-70000,-70000
20200520,05535P,台積電元大97售06,,,,,0.00,0.00,0,0,0,0,0,0,0,0,0,0,0,0,0
20200520,055360,台表科凱基97購02,1.27,1.76,1.19,1.67,+0.47,39.17,527000,65,738170,0,0,0,0,0,0,262000,216000,46000,46000
20200520,055361,樺漢凱基97購01,,,,,0.00,0.00,0,0,0,0,0,0,0,0,0,0,0,0,0
20200520,055362,GIS凱基97購03,,,,,0.00,0.00,0,0,0,0,0,0,0,0,0,0,0,0,0
20200520,055363,緯穎凱基98購03,,,,,0.00,0.00,0,0,0,0,0,0,0,0,0,0,0,0,0
20200520,055364,矽創凱基97購03,,,,,0.00,0.00,0,0,0,0,0,0,0,0,0,0,0,0,0
20200520,055365,華通元大97購03,,,,,0.00,0.00,0,0,0,0,0,0,0,0,0,0,0,0,0
20200520,055366,國巨元大98購05,,,,,0.00,0.00,0,0,0,0,0,0,0,0,0,0,0,0,0
20200520,055367,台積電元大97購23,,,,,0.00,0.00,0,0,0,0,0,0,0,0,0,0,0,0,0
20200520,055368,台積電元大97購24,,,,,0.00,0.00,0,0,0,0,0,0,0,0,0,0,0,0,0
20200520,055369,友訊元大97購01,,,,,0.00,0.00,0,0,0,0,0,0,0,0,0,0,0,0,0
20200520,05536P,奇力新元大96售03,,,,,0.00,0.00,0,0,0,0,0,0,0,0,0,0,0,0,0
20200520,055370,旺宏元大97購05,,,,,0.00,0.00,0,0,0,0,0,0,0,0,0,0,0,0,0
20200520,055371,正崴元大97購02,,,,,0.00,0.00,0,0,0,0,0,0,0,0,0,0,0,0,0
20200520,055372,宏達電元大97購04,,,,,0.00,0.00,0,0,0,0,0,0,0,0,0,0,0,0,0
20200520,055373,聯詠元大97購03,0.87,0.94,0.87,0.94,-0.07,-6.93,130000,15,116000,0,0,0,0,0,0,110000,30000,80000,80000
20200520,055374,明泰元大97購01,,,,,0.00,0.00,0,0,0,0,0,0,0,0,0,0,0,0,0
20200520,055375,京鼎元大97購03,,,,,0.00,0.00,0,0,0,0,0,0,0,0,0,0,0,0,0
20200520,055376,群創元大01購01,0.50,0.50,0.50,0.50,0.00,0.00,2000,2,1000,0,0,0,0,0,0,2000,0,2000,2000
20200520,055377,揚明光元大98購01,0.57,0.57,0.57,0.57,+0.02,3.64,390000,2,222300,0,0,0,0,0,0,390000,0,390000,390000
20200520,055378,晶相光元大97購02,,,,,0.00,0.00,0,0,0,0,0,0,0,0,0,0,0,0,0
20200520,055379,牧德元大97購03,,,,,0.00,0.00,0,0,0,0,0,0,0,0,0,0,0,0,0
20200520,05537P,群創中信98售01,,,,,0.00,0.00,0,0,0,0,0,0,0,0,0,0,0,0,0
20200520,055380,智易元大98購02,1.62,1.64,1.54,1.54,-0.08,-4.94,153000,9,242230,0,0,0,0,0,0,40000,113000,-73000,-73000
20200520,055381,茂林元大97購02,2.37,2.81,2.37,2.77,+0.42,17.87,176000,13,472020,0,0,0,0,0,0,0,175000,-175000,-175000
20200520,055382,台郡元大99購01,2.18,2.18,2.18,2.18,0.00,0.00,3000,1,6540,0,0,0,0,0,0,0,0,0,0
20200520,055383,GIS元大97購02,,,,,0.00,0.00,0,0,0,0,0,0,0,0,0,0,0,0,0
20200520,055384,緯穎元大98購02,3.55,3.60,3.32,3.43,-0.55,-13.82,51000,7,177080,0,0,0,0,0,0,6000,45000,-39000,-39000
20200520,055385,昇陽半元大98購01,0.09,0.09,0.09,0.09,0.00,0.00,100000,10,9000,0,0,0,0,0,0,0,100000,-100000,-100000
20200520,055386,致新元大97購02,,,,,0.00,0.00,0,0,0,0,0,0,0,0,0,0,0,0,0
20200520,055387,世紀鋼元大97購01,1.93,1.93,1.93,1.93,-0.25,-11.47,30000,1,57900,0,0,0,0,0,0,30000,0,30000,30000
20200520,055388,華通統一97購03,1.31,1.50,1.31,1.50,-0.05,-3.23,93000,6,135780,0,0,0,0,0,0,15000,78000,-63000,-63000
20200520,055389,國巨統一98購02,0.66,0.81,0.66,0.66,+0.07,11.86,192000,7,143290,0,0,0,0,0,0,0,192000,-192000,-192000
20200520,05538P,玉晶光國票97售02,1.28,1.28,1.07,1.10,-0.20,-15.38,1091000,22,1241220,0,0,0,0,0,0,513000,568000,-55000,-55000
20200520,055390,國巨統一98購03,3.25,3.47,3.02,3.02,+0.19,6.71,14000,6,44270,0,0,0,0,0,0,6000,8000,-2000,-2000
20200520,055391,光罩統一97購02,0.10,0.10,0.10,0.10,0.00,0.00,10000,1,1000,0,0,0,0,0,0,0,10000,-10000,-10000
20200520,055392,凱美統一97購03,0.10,0.10,0.10,0.10,0.00,0.00,100000,1,10000,0,0,0,0,0,0,0,100000,-100000,-100000
20200520,055393,華新科統一97購03,0.73,0.76,0.73,0.75,+0.01,1.35,96000,3,71700,0,0,0,0,0,0,41000,55000,-14000,-14000
20200520,055394,健策統一97購01,0.33,0.33,0.33,0.33,-0.02,-5.71,40000,1,13200,0,0,0,0,0,0,0,40000,-40000,-40000
20200520,055395,泰鼎統一97購01,,,,,0.00,0.00,0,0,0,0,0,0,0,0,0,0,0,0,0
20200520,055396,瑞儀統一97購01,0.23,0.23,0.23,0.23,0.00,0.00,80000,8,18400,0,0,0,0,0,0,0,80000,-80000,-80000
20200520,055397,超眾統一97購02,,,,,0.00,0.00,0,0,0,0,0,0,0,0,0,0,0,0,0
20200520,055398,超眾統一97購03,1.21,1.24,1.21,1.24,0.00,0.00,48000,2,58320,0,0,0,0,0,0,40000,8000,32000,32000
20200520,055399,超眾統一99購01,,,,,0.00,0.00,0,0,0,0,0,0,0,0,0,0,0,0,0
20200520,05539P,鎧勝永豐96售01,,,,,0.00,0.00,0,0,0,0,0,0,0,0,0,0,0,0,0
20200520,055400,緯穎統一97購01,,,,,0.00,0.00,0,0,0,0,0,0,0,0,0,0,0,0,0
20200520,055401,亞光元富9A購01,,,,,0.00,0.00,0,0,0,0,0,0,0,0,0,0,0,0,0
20200520,055402,正文元富97購02,0.75,0.75,0.75,0.75,+0.02,2.74,92000,1,69000,0,0,0,0,0,0,92000,0,92000,92000
20200520,055403,泰鼎元富97購01,4.77,5.45,4.49,5.40,+0.25,4.85,594000,42,2896940,0,0,0,0,0,0,569000,33000,536000,536000
20200520,055404,超眾元富97購01,0.40,0.40,0.36,0.36,-0.02,-5.26,352000,7,134740,0,0,0,0,0,0,200000,152000,48000,48000
20200520,055405,華泰國泰98購01,,,,,0.00,0.00,0,0,0,0,0,0,0,0,0,0,0,0,0
20200520,055406,大毅國泰99購01,,,,,0.00,0.00,0,0,0,0,0,0,0,0,0,0,0,0,0
20200520,055407,祥碩國泰98購01,,,,,0.00,0.00,0,0,0,0,0,0,0,0,0,0,0,0,0
20200520,055408,力成國泰98購01,,,,,0.00,0.00,0,0,0,0,0,0,0,0,0,0,0,0,0
20200520,055409,元黃金富邦01購01,1.80,1.80,1.80,1.80,+0.15,9.09,6000,3,10800,0,0,0,0,0,0,0,0,0,0
20200520,05540P,亞德客凱基96售01,,,,,0.00,0.00,0,0,0,0,0,0,0,0,0,0,0,0,0
20200520,055410,元油反富邦9A購01,,,,,0.00,0.00,0,0,0,0,0,0,0,0,0,0,0,0,0
20200520,055411,國巨富邦9A購02,0.26,0.26,0.24,0.24,+0.02,9.09,52000,6,13100,0,0,0,0,0,0,0,31000,-31000,-31000
20200520,055412,旺宏富邦99購01,,,,,0.00,0.00,0,0,0,0,0,0,0,0,0,0,0,0,0
20200520,055413,全新富邦98購01,0.03,0.03,0.03,0.03,0.00,0.00,21000,1,630,0,0,0,0,0,0,21000,0,21000,21000
20200520,055414,奇力新富邦9B購01,,,,,0.00,0.00,0,0,0,0,0,0,0,0,0,0,0,0,0
20200520,055415,禾伸堂富邦9B購01,,,,,0.00,0.00,0,0,0,0,0,0,0,0,0,0,0,0,0
20200520,055416,欣興富邦98購01,0.33,0.33,0.33,0.33,+0.02,6.45,6000,1,1980,0,0,0,0,0,0,0,6000,-6000,-6000
20200520,055417,健策富邦98購02,0.11,0.11,0.11,0.11,0.00,0.00,10000,1,1100,0,0,0,0,0,0,0,0,0,0
20200520,055418,華通永豐97購01,,,,,0.00,0.00,0,0,0,0,0,0,0,0,0,0,0,0,0
20200520,055419,國巨永豐97購03,,,,,0.00,0.00,0,0,0,0,0,0,0,0,0,0,0,0,0
20200520,05541P,鴻海統一96售08,1.52,1.61,1.50,1.61,+0.01,0.62,64000,6,99290,0,0,0,0,0,0,61000,3000,58000,58000
20200520,055420,欣興永豐98購01,0.75,0.75,0.66,0.66,-0.05,-7.04,781000,4,561870,0,0,0,0,0,0,761000,20000,741000,741000
20200520,055421,玉晶光永豐98購04,0.58,0.65,0.58,0.65,+0.08,14.04,120000,3,76100,0,0,0,0,0,0,20000,100000,-80000,-80000
20200520,055422,康控永豐97購01,,,,,0.00,0.00,0,0,0,0,0,0,0,0,0,0,0,0,0
20200520,055423,亞光亞東99購01,,,,,0.00,0.00,0,0,0,0,0,0,0,0,0,0,0,0,0
20200520,055424,聚陽群益98購01,,,,,0.00,0.00,0,0,0,0,0,0,0,0,0,0,0,0,0
20200520,055425,聚陽群益99購01,,,,,0.00,0.00,0,0,0,0,0,0,0,0,0,0,0,0,0
20200520,055426,旺宏群益99購02,1.32,1.32,1.32,1.32,+0.01,0.76,7000,1,9240,0,0,0,0,0,0,7000,0,7000,7000
20200520,055427,技嘉群益98購01,,,,,0.00,0.00,0,0,0,0,0,0,0,0,0,0,0,0,0
20200520,055428,友達群益9C購01,0.21,0.21,0.10,0.20,0.00,0.00,124000,5,25100,0,1000,-1000,0,0,0,0,0,0,-1000
20200520,055429,華新科群益99購01,,,,,0.00,0.00,0,0,0,0,0,0,0,0,0,0,0,0,0
20200520,05542P,滬深2X元富96售01,,,,,0.00,0.00,0,0,0,0,0,0,0,0,0,0,0,0,0
20200520,055430,宏達電群益97購01,,,,,0.00,0.00,0,0,0,0,0,0,0,0,0,0,0,0,0
20200520,055431,和鑫群益98購01,,,,,0.00,0.00,0,0,0,0,0,0,0,0,0,0,0,0,0
20200520,055432,臻鼎群益97購02,0.98,1.14,0.98,1.14,+0.08,7.55,287000,6,313460,0,0,0,0,0,0,57000,229000,-172000,-172000
20200520,055433,嘉聯益群益99購01,0.71,0.71,0.71,0.71,0.00,0.00,100000,1,71000,0,0,0,0,0,0,0,100000,-100000,-100000
20200520,055434,樺漢群益97購01,,,,,0.00,0.00,0,0,0,0,0,0,0,0,0,0,0,0,0
20200520,055435,佳世達中信99購01,,,,,0.00,0.00,0,0,0,0,0,0,0,0,0,0,0,0,0
20200520,055436,晶豪科中信99購01,1.11,1.11,1.11,1.11,0.00,0.00,5000,1,5550,0,0,0,0,0,0,0,5000,-5000,-5000
20200520,055437,禾伸堂中信99購01,1.57,1.58,1.48,1.48,+0.05,3.5,40000,3,62100,0,0,0,0,0,0,20000,20000,0,0
20200520,055438,鴻海國票98購01,,,,,0.00,0.00,0,0,0,0,0,0,0,0,0,0,0,0,0
20200520,055439,台表科國票98購02,0.66,0.98,0.66,0.98,+0.37,60.66,88000,9,74680,0,0,0,0,0,0,88000,0,88000,88000
20200520,05543P,鴻海元富96售04,,,,,0.00,0.00,0,0,0,0,0,0,0,0,0,0,0,0,0
20200520,055440,矽力國票98購01,12.80,12.80,12.60,12.70,-1.20,-8.63,32000,5,406200,0,0,0,0,0,0,0,32000,-32000,-32000
20200520,055441,緯穎國票98購01,,,,,0.00,0.00,0,0,0,0,0,0,0,0,0,0,0,0,0
20200520,055442,矽創國票98購02,1.58,1.60,1.43,1.43,-0.11,-7.14,204000,19,318030,0,0,0,0,0,0,204000,0,204000,204000
20200520,055443,台虹國票98購01,1.72,1.74,1.72,1.73,0.00,0.00,77000,3,133540,0,0,0,0,0,0,0,77000,-77000,-77000
20200520,055444,致新台新97購01,2.24,2.24,2.18,2.23,+0.28,14.36,60000,6,132550,0,0,0,0,0,0,55000,5000,50000,50000
20200520,055445,旺宏統一99購01,,,,,0.00,0.00,0,0,0,0,0,0,0,0,0,0,0,0,0
20200520,055446,奇力新統一9A購01,0.37,0.37,0.37,0.37,+0.06,19.35,1000,1,370,0,0,0,0,0,0,0,1000,-1000,-1000
20200520,055447,華新科統一97購04,0.45,0.45,0.15,0.40,+0.10,33.33,17000,4,4000,0,0,0,0,0,0,0,12000,-12000,-12000
20200520,055448,健策統一97購02,,,,,0.00,0.00,0,0,0,0,0,0,0,0,0,0,0,0,0
20200520,055449,超眾統一9A購01,1.74,1.78,1.74,1.78,+0.02,1.14,110000,4,194620,0,0,0,0,0,0,28000,82000,-54000,-54000
20200520,05544P,台表科元富96售01,,,,,0.00,0.00,0,0,0,0,0,0,0,0,0,0,0,0,0
20200520,055450,台積電元富97購01,0.03,0.05,0.03,0.05,0.00,0.00,210000,3,7500,0,0,0,0,0,0,210000,0,210000,210000
20200520,055451,台積電元富97購02,0.01,0.01,0.01,0.01,0.00,0.00,15000,1,150,0,0,0,0,0,0,0,0,0,0
20200520,055452,台積電元富97購03,,,,,0.00,0.00,0,0,0,0,0,0,0,0,0,0,0,0,0
20200520,055453,華邦電元富97購01,,,,,0.00,0.00,0,0,0,0,0,0,0,0,0,0,0,0,0
20200520,055454,華邦電元富97購02,,,,,0.00,0.00,0,0,0,0,0,0,0,0,0,0,0,0,0
20200520,055455,健策國泰98購02,,,,,0.00,0.00,0,0,0,0,0,0,0,0,0,0,0,0,0
20200520,055456,上銀富邦99購01,,,,,0.00,0.00,0,0,0,0,0,0,0,0,0,0,0,0,0
20200520,055457,聚陽永豐97購01,,,,,0.00,0.00,0,0,0,0,0,0,0,0,0,0,0,0,0
20200520,055458,燿華永豐98購01,0.38,0.40,0.38,0.40,0.00,0.00,83000,4,32240,0,0,0,0,0,0,0,83000,-83000,-83000
20200520,055459,建準永豐97購03,3.06,3.10,2.89,2.99,-0.05,-1.64,91000,9,269280,0,0,0,0,0,0,42000,49000,-7000,-7000
20200520,05545P,台表科國泰98售01,0.62,0.62,0.61,0.61,-0.34,-35.79,31000,3,19120,0,0,0,0,0,0,20000,11000,9000,9000
20200520,055460,華擎永豐97購01,3.16,3.77,3.16,3.66,0.00,0.00,99000,18,355900,0,0,0,0,0,0,15000,74000,-59000,-59000
20200520,055461,TPK永豐97購01,,,,,0.00,0.00,0,0,0,0,0,0,0,0,0,0,0,0,0
20200520,055462,華邦電日盛97購01,,,,,0.00,0.00,0,0,0,0,0,0,0,0,0,0,0,0,0
20200520,055463,國喬凱基97購01,0.20,0.20,0.16,0.16,-0.04,-20.0,105000,4,18600,0,0,0,0,0,0,0,0,0,0
20200520,055464,聚陽凱基97購01,,,,,0.00,0.00,0,0,0,0,0,0,0,0,0,0,0,0,0
20200520,055465,和大凱基97購03,,,,,0.00,0.00,0,0,0,0,0,0,0,0,0,0,0,0,0
20200520,055466,台達電凱基97購03,0.73,0.74,0.73,0.73,0.00,0.00,300000,28,219240,0,0,0,0,0,0,300000,0,300000,300000
20200520,055467,國巨凱基97購05,0.99,1.00,0.98,0.98,+0.37,60.66,50000,5,49600,0,0,0,0,0,0,0,50000,-50000,-50000
20200520,055468,智邦凱基97購04,,,,,0.00,0.00,0,0,0,0,0,0,0,0,0,0,0,0,0
20200520,055469,台光電凱基97購01,,,,,0.00,0.00,0,0,0,0,0,0,0,0,0,0,0,0,0
20200520,05546P,全新元大97售01,1.49,1.72,1.49,1.71,+0.14,8.92,360000,17,588820,0,0,0,0,0,0,122000,238000,-116000,-116000
20200520,055470,南亞科凱基97購01,,,,,0.00,0.00,0,0,0,0,0,0,0,0,0,0,0,0,0
20200520,055471,聯發科凱基97購04,5.85,5.85,5.85,5.85,+0.45,8.33,5000,1,29250,0,0,0,0,0,0,5000,0,5000,5000
20200520,055472,大立光凱基97購07,0.89,0.89,0.89,0.89,0.00,0.00,10000,1,8900,0,0,0,0,0,0,0,10000,-10000,-10000
20200520,055473,禾伸堂凱基97購01,2.68,2.68,2.68,2.68,+0.05,1.9,4000,1,10720,0,0,0,0,0,0,4000,0,4000,4000
20200520,055474,欣興凱基97購05,,,,,0.00,0.00,0,0,0,0,0,0,0,0,0,0,0,0,0
20200520,055475,臻鼎凱基97購02,,,,,0.00,0.00,0,0,0,0,0,0,0,0,0,0,0,0,0
20200520,055476,台郡凱基97購02,1.45,1.45,1.45,1.45,0.00,0.00,20000,1,29000,0,0,0,0,0,0,0,20000,-20000,-20000
20200520,055477,同欣電凱基98購01,,,,,0.00,0.00,0,0,0,0,0,0,0,0,0,0,0,0,0
20200520,055478,訊芯凱基97購01,,,,,0.00,0.00,0,0,0,0,0,0,0,0,0,0,0,0,0
20200520,055479,GIS凱基97購04,,,,,0.00,0.00,0,0,0,0,0,0,0,0,0,0,0,0,0
20200520,05547P,群創元大96售03,,,,,0.00,0.00,0,0,0,0,0,0,0,0,0,0,0,0,0
20200520,055480,元上證元大97購02,,,,,0.00,0.00,0,0,0,0,0,0,0,0,0,0,0,0,0
20200520,055481,聚陽元大97購01,0.12,0.12,0.12,0.12,+0.01,9.09,20000,2,2400,0,0,0,0,0,0,0,20000,-20000,-20000
20200520,055482,聚陽元大97購02,0.16,0.17,0.16,0.16,0.00,0.00,40000,4,6500,0,0,0,0,0,0,0,40000,-40000,-40000
20200520,055483,和大元大97購03,,,,,0.00,0.00,0,0,0,0,0,0,0,0,0,0,0,0,0
20200520,055484,華通元大97購04,,,,,0.00,0.00,0,0,0,0,0,0,0,0,0,0,0,0,0
20200520,055485,國巨元大97購09,,,,,0.00,0.00,0,0,0,0,0,0,0,0,0,0,0,0,0
20200520,055486,國巨元大98購06,1.35,1.35,1.35,1.35,0.00,0.00,5000,1,6750,0,0,0,0,0,0,0,5000,-5000,-5000
20200520,055487,國巨元大98購07,,,,,0.00,0.00,0,0,0,0,0,0,0,0,0,0,0,0,0
20200520,055488,華邦電元大98購01,,,,,0.00,0.00,0,0,0,0,0,0,0,0,0,0,0,0,0
20200520,055489,瑞昱元大97購02,2.43,2.46,2.23,2.40,+0.04,1.69,87000,12,209260,0,0,0,0,0,0,87000,25000,62000,62000
20200520,05548P,臺股指元大96售02,,,,,0.00,0.00,0,0,0,0,0,0,0,0,0,0,0,0,0
20200520,055490,台光電元大97購01,1.40,1.40,1.40,1.40,-0.04,-2.78,68000,1,95200,0,0,0,0,0,0,0,68000,-68000,-68000
20200520,055491,奇力新元大98購03,,,,,0.00,0.00,0,0,0,0,0,0,0,0,0,0,0,0,0
20200520,055492,華新科元大97購08,,,,,0.00,0.00,0,0,0,0,0,0,0,0,0,0,0,0,0
20200520,055493,華新科元大97購09,,,,,0.00,0.00,0,0,0,0,0,0,0,0,0,0,0,0,0
20200520,055494,華新科元大98購01,,,,,0.00,0.00,0,0,0,0,0,0,0,0,0,0,0,0,0
20200520,055495,長榮航元大97購01,,,,,0.00,0.00,0,0,0,0,0,0,0,0,0,0,0,0,0
20200520,055496,高鐵元大97購02,0.31,0.31,0.30,0.31,0.00,0.00,115000,4,35450,0,0,0,0,0,0,0,115000,-115000,-115000
20200520,055497,開發金元大97購01,0.62,0.63,0.62,0.63,+0.01,1.61,127000,2,79740,0,0,0,0,0,0,27000,100000,-73000,-73000
20200520,055498,大立光元大97購07,,,,,0.00,0.00,0,0,0,0,0,0,0,0,0,0,0,0,0
20200520,055499,大立光元大98購05,,,,,0.00,0.00,0,0,0,0,0,0,0,0,0,0,0,0,0
20200520,05549P,臺股指元大96售03,,,,,0.00,0.00,0,0,0,0,0,0,0,0,0,0,0,0,0
20200520,055500,京鼎元大97購04,,,,,0.00,0.00,0,0,0,0,0,0,0,0,0,0,0,0,0
20200520,055501,創意元大97購01,,,,,0.00,0.00,0,0,0,0,0,0,0,0,0,0,0,0,0
20200520,055502,群創元大9C購03,,,,,0.00,0.00,0,0,0,0,0,0,0,0,0,0,0,0,0
20200520,055503,健策元大98購05,,,,,0.00,0.00,0,0,0,0,0,0,0,0,0,0,0,0,0
20200520,055504,貿聯元大98購04,,,,,0.00,0.00,0,0,0,0,0,0,0,0,0,0,0,0,0
20200520,055505,新唐元大97購02,0.19,0.19,0.19,0.19,0.00,0.00,50000,1,9500,0,0,0,0,0,0,50000,0,50000,50000
20200520,055506,台郡元大99購02,,,,,0.00,0.00,0,0,0,0,0,0,0,0,0,0,0,0,0
20200520,055507,樺漢元大98購02,,,,,0.00,0.00,0,0,0,0,0,0,0,0,0,0,0,0,0
20200520,055508,矽力元大97購01,,,,,0.00,0.00,0,0,0,0,0,0,0,0,0,0,0,0,0
20200520,055509,訊芯元大97購03,0.36,0.36,0.36,0.36,0.00,0.00,68000,1,24480,0,0,0,0,0,0,0,68000,-68000,-68000
20200520,05550P,臺股指元大96售07,,,,,0.00,0.00,0,0,0,0,0,0,0,0,0,0,0,0,0
20200520,055510,GIS元大97購03,1.37,1.37,1.37,1.37,0.00,0.00,100000,1,137000,0,0,0,0,0,0,0,100000,-100000,-100000
20200520,055511,大立光兆豐97購02,,,,,0.00,0.00,0,0,0,0,0,0,0,0,0,0,0,0,0
20200520,055512,聯詠兆豐97購01,,,,,0.00,0.00,0,0,0,0,0,0,0,0,0,0,0,0,0
20200520,055513,旺宏亞東98購01,,,,,0.00,0.00,0,0,0,0,0,0,0,0,0,0,0,0,0
20200520,055514,亞光麥證97購01,,,,,0.00,0.00,0,0,0,0,0,0,0,0,0,0,0,0,0
20200520,055515,聚陽中信9A購01,0.15,0.20,0.15,0.20,-0.01,-4.76,11000,2,1700,0,0,0,0,0,0,0,10000,-10000,-10000
20200520,055516,上銀中信97購01,,,,,0.00,0.00,0,0,0,0,0,0,0,0,0,0,0,0,0
20200520,055517,國巨中信97購03,,,,,0.00,0.00,0,0,0,0,0,0,0,0,0,0,0,0,0
20200520,055518,華新科中信99購01,0.16,0.18,0.16,0.16,-0.02,-11.11,73000,7,11700,0,0,0,0,0,0,0,30000,-30000,-30000
20200520,055519,茂林中信99購01,0.71,0.96,0.71,0.96,+0.29,43.28,286000,55,229500,0,0,0,0,0,0,13000,263000,-250000,-250000
20200520,05551P,電子類元大96售01,,,,,0.00,0.00,0,0,0,0,0,0,0,0,0,0,0,0,0
20200520,055520,矽力中信97購02,,,,,0.00,0.00,0,0,0,0,0,0,0,0,0,0,0,0,0
20200520,055521,S&P反1群益01購01,,,,,0.00,0.00,0,0,0,0,0,0,0,0,0,0,0,0,0
20200520,055522,道瓊反群益01購01,,,,,0.00,0.00,0,0,0,0,0,0,0,0,0,0,0,0,0
20200520,055523,道瓊銀群益9A購01,0.55,0.55,0.54,0.54,-0.28,-34.15,20000,2,10850,0,0,0,0,0,0,0,0,0,0
20200520,055524,鴻海群益98購01,,,,,0.00,0.00,0,0,0,0,0,0,0,0,0,0,0,0,0
20200520,055525,國巨群益98購05,2.30,2.55,2.30,2.35,+0.14,6.33,50000,8,120260,0,0,0,0,0,0,1000,50000,-49000,-49000
20200520,055526,台積電群益97購02,,,,,0.00,0.00,0,0,0,0,0,0,0,0,0,0,0,0,0
20200520,055527,旺宏群益99購03,1.22,1.22,1.22,1.22,+0.01,0.83,1000,1,1220,0,0,0,0,0,0,0,1000,-1000,-1000
20200520,055528,華邦電群益97購01,,,,,0.00,0.00,0,0,0,0,0,0,0,0,0,0,0,0,0
20200520,055529,華邦電群益97購02,,,,,0.00,0.00,0,0,0,0,0,0,0,0,0,0,0,0,0
20200520,05552P,聯詠群益96售01,,,,,0.00,0.00,0,0,0,0,0,0,0,0,0,0,0,0,0
20200520,055530,聯發科群益98購01,,,,,0.00,0.00,0,0,0,0,0,0,0,0,0,0,0,0,0
20200520,055531,華新科群益98購03,,,,,0.00,0.00,0,0,0,0,0,0,0,0,0,0,0,0,0
20200520,055532,中工群益98購01,,,,,0.00,0.00,0,0,0,0,0,0,0,0,0,0,0,0,0
20200520,055533,大立光群益97購03,1.09,1.09,1.09,1.09,0.00,0.00,39000,1,42510,0,0,0,0,0,0,0,39000,-39000,-39000
20200520,055534,晶技群益97購03,,,,,0.00,0.00,0,0,0,0,0,0,0,0,0,0,0,0,0
20200520,055535,緯創群益98購01,,,,,0.00,0.00,0,0,0,0,0,0,0,0,0,0,0,0,0
20200520,055536,嘉聯益群益99購02,,,,,0.00,0.00,0,0,0,0,0,0,0,0,0,0,0,0,0
20200520,055537,康友群益97購03,,,,,0.00,0.00,0,0,0,0,0,0,0,0,0,0,0,0,0
20200520,055538,鴻海日盛97購04,,,,,0.00,0.00,0,0,0,0,0,0,0,0,0,0,0,0,0
20200520,055539,億光台新97購01,,,,,0.00,0.00,0,0,0,0,0,0,0,0,0,0,0,0,0
20200520,05553P,智原群益96售01,,,,,0.00,0.00,0,0,0,0,0,0,0,0,0,0,0,0,0
20200520,055540,京鼎台新97購01,,,,,0.00,0.00,0,0,0,0,0,0,0,0,0,0,0,0,0
20200520,055541,聚陽凱基98購01,,,,,0.00,0.00,0,0,0,0,0,0,0,0,0,0,0,0,0
20200520,055542,亞德客凱基97購01,,,,,0.00,0.00,0,0,0,0,0,0,0,0,0,0,0,0,0
20200520,055543,為升凱基97購01,,,,,0.00,0.00,0,0,0,0,0,0,0,0,0,0,0,0,0
20200520,055544,鴻海凱基97購05,,,,,0.00,0.00,0,0,0,0,0,0,0,0,0,0,0,0,0
20200520,055545,國巨凱基97購06,1.72,2.04,1.72,1.84,+0.23,14.29,54000,5,99660,0,0,0,0,0,0,6000,49000,-43000,-43000
20200520,055546,台積電凱基97購12,,,,,0.00,0.00,0,0,0,0,0,0,0,0,0,0,0,0,0
20200520,055547,台積電凱基97購13,,,,,0.00,0.00,0,0,0,0,0,0,0,0,0,0,0,0,0
20200520,055548,旺宏凱基97購02,,,,,0.00,0.00,0,0,0,0,0,0,0,0,0,0,0,0,0
20200520,055549,旺宏凱基97購03,0.93,0.93,0.93,0.93,0.00,0.00,20000,1,18600,0,0,0,0,0,0,0,20000,-20000,-20000
20200520,05554P,群創群益96售02,,,,,0.00,0.00,0,0,0,0,0,0,0,0,0,0,0,0,0
20200520,055550,華邦電凱基97購03,,,,,0.00,0.00,0,0,0,0,0,0,0,0,0,0,0,0,0
20200520,055551,致茂凱基98購01,0.35,0.40,0.35,0.40,+0.06,17.65,77000,4,27650,0,0,0,0,0,0,30000,47000,-17000,-17000
20200520,055552,瑞昱凱基97購02,,,,,0.00,0.00,0,0,0,0,0,0,0,0,0,0,0,0,0
20200520,055553,聯發科凱基97購05,0.49,0.66,0.49,0.65,+0.22,51.16,41000,4,22740,0,0,0,0,0,0,31000,0,31000,31000
20200520,055554,聯發科凱基97購06,,,,,0.00,0.00,0,0,0,0,0,0,0,0,0,0,0,0,0
20200520,055555,全新凱基9A購01,,,,,0.00,0.00,0,0,0,0,0,0,0,0,0,0,0,0,0
20200520,055556,奇力新凱基98購03,0.38,0.41,0.38,0.38,0.00,0.00,361000,4,138990,0,0,0,0,0,0,260000,101000,159000,159000
20200520,055557,華新科凱基97購01,,,,,0.00,0.00,0,0,0,0,0,0,0,0,0,0,0,0,0
20200520,055558,大立光凱基97購08,,,,,0.00,0.00,0,0,0,0,0,0,0,0,0,0,0,0,0
20200520,055559,大立光凱基97購09,,,,,0.00,0.00,0,0,0,0,0,0,0,0,0,0,0,0,0
20200520,05555P,健策群益98售01,0.71,0.71,0.65,0.65,-0.10,-13.33,120000,2,84600,0,0,0,0,0,0,120000,0,120000,120000
20200520,055560,大立光凱基97購10,,,,,0.00,0.00,0,0,0,0,0,0,0,0,0,0,0,0,0
20200520,055561,奇鋐凱基97購01,0.68,0.77,0.68,0.77,+0.08,11.59,92000,4,63980,0,0,0,0,0,0,22000,70000,-48000,-48000
20200520,055562,欣興凱基97購06,1.56,1.56,1.48,1.48,+0.05,3.5,22000,2,34240,0,0,0,0,0,0,21000,1000,20000,20000
20200520,055563,智易凱基97購02,1.18,1.18,1.18,1.18,-0.01,-0.84,1000,1,1180,0,0,0,0,0,0,1000,0,1000,1000
20200520,055564,茂林凱基98購01,0.61,0.61,0.61,0.61,0.00,0.00,1000,1,610,0,0,0,0,0,0,1000,0,1000,1000
20200520,055565,祥碩凱基97購01,9.05,9.05,9.05,9.05,+0.90,11.04,5000,2,45250,0,0,0,0,0,0,5000,0,5000,5000
20200520,055566,台表科凱基97購03,1.25,1.86,1.25,1.86,+0.57,44.19,204000,34,295220,0,0,0,0,0,0,156000,48000,108000,108000
20200520,055567,訊芯凱基98購02,,,,,0.00,0.00,0,0,0,0,0,0,0,0,0,0,0,0,0
20200520,055568,緯穎凱基97購02,4.43,4.43,4.43,4.43,-0.14,-3.06,10000,1,44300,0,0,0,0,0,0,10000,10000,0,0
20200520,055569,聚陽統一98購01,0.17,0.17,0.17,0.17,+0.01,6.25,1000,1,170,0,0,0,0,0,0,1000,0,1000,1000
20200520,05556P,全新國票96售04,,,,,0.00,0.00,0,0,0,0,0,0,0,0,0,0,0,0,0
20200520,055570,華通統一98購03,,,,,0.00,0.00,0,0,0,0,0,0,0,0,0,0,0,0,0
20200520,055571,鴻海統一97購03,,,,,0.00,0.00,0,0,0,0,0,0,0,0,0,0,0,0,0
20200520,055572,鴻海統一98購04,2.17,2.17,2.17,2.17,0.00,0.00,14000,1,30380,0,0,0,0,0,0,0,14000,-14000,-14000
20200520,055573,國巨統一97購06,,,,,0.00,0.00,0,0,0,0,0,0,0,0,0,0,0,0,0
20200520,055574,美律統一97購01,,,,,0.00,0.00,0,0,0,0,0,0,0,0,0,0,0,0,0
20200520,055575,華新科統一98購01,0.71,0.71,0.70,0.70,0.00,0.00,193000,5,135600,0,0,0,0,0,0,193000,0,193000,193000
20200520,055576,嘉晶統一98購01,3.55,4.33,3.55,4.33,+0.99,29.64,318000,17,1268040,0,0,0,0,0,0,18000,300000,-282000,-282000
20200520,055577,晶技統一97購02,,,,,0.00,0.00,0,0,0,0,0,0,0,0,0,0,0,0,0
20200520,055578,群創統一98購03,,,,,0.00,0.00,0,0,0,0,0,0,0,0,0,0,0,0,0
20200520,055579,健策統一9A購01,0.74,0.77,0.73,0.77,-0.06,-7.23,380000,9,286040,0,0,0,0,0,0,0,380000,-380000,-380000
20200520,05557P,S&P500中信96售02,,,,,0.00,0.00,0,0,0,0,0,0,0,0,0,0,0,0,0
20200520,055580,南茂統一97購01,,,,,0.00,0.00,0,0,0,0,0,0,0,0,0,0,0,0,0
20200520,055581,和大元大97購04,,,,,0.00,0.00,0,0,0,0,0,0,0,0,0,0,0,0,0
20200520,055582,亞德客元大97購01,,,,,0.00,0.00,0,0,0,0,0,0,0,0,0,0,0,0,0
20200520,055583,國巨元大97購10,2.24,2.57,2.24,2.43,+0.41,20.3,10000,3,22920,0,0,0,0,0,0,10000,2000,8000,8000
20200520,055584,國巨元大97購11,1.04,1.09,1.04,1.05,+0.06,6.06,104000,4,109670,0,0,0,0,0,0,54000,50000,4000,4000
20200520,055585,國巨元大98購08,,,,,0.00,0.00,0,0,0,0,0,0,0,0,0,0,0,0,0
20200520,055586,旺宏元大98購06,,,,,0.00,0.00,0,0,0,0,0,0,0,0,0,0,0,0,0
20200520,055587,智邦元大97購02,,,,,0.00,0.00,0,0,0,0,0,0,0,0,0,0,0,0,0
20200520,055588,瑞昱元大97購03,,,,,0.00,0.00,0,0,0,0,0,0,0,0,0,0,0,0,0
20200520,055589,台光電元大98購04,3.80,3.80,3.80,3.80,-0.06,-1.55,99000,2,376200,0,0,0,0,0,0,99000,0,99000,99000
20200520,05558P,鴻海麥證96售01,2.62,2.62,2.62,2.62,-0.07,-2.6,10000,2,26200,10000,0,10000,0,0,0,10000,0,10000,10000
20200520,055590,聯發科元大98購02,3.63,3.63,3.36,3.36,+0.46,15.86,55000,5,197440,0,0,0,0,0,0,46000,2000,44000,44000
20200520,055591,全新元大98購01,,,,,0.00,0.00,0,0,0,0,0,0,0,0,0,0,0,0,0
20200520,055592,奇力新元大97購07,0.61,0.61,0.61,0.61,0.00,0.00,68000,1,41480,0,0,0,0,0,0,0,68000,-68000,-68000
20200520,055593,華新科元大97購10,,,,,0.00,0.00,0,0,0,0,0,0,0,0,0,0,0,0,0
20200520,055594,華新科元大98購02,1.91,2.02,1.89,2.02,+0.09,4.66,97000,9,190120,0,0,0,0,0,0,78000,19000,59000,59000
20200520,055595,宏達電元大98購02,,,,,0.00,0.00,0,0,0,0,0,0,0,0,0,0,0,0,0
20200520,055596,新光金元大9B購02,,,,,0.00,0.00,0,0,0,0,0,0,0,0,0,0,0,0,0
20200520,055597,禾伸堂元大98購02,3.83,4.06,3.83,3.83,0.00,0.00,49000,6,190170,0,0,0,0,0,0,10000,39000,-29000,-29000
20200520,055598,欣興元大97購03,,,,,0.00,0.00,0,0,0,0,0,0,0,0,0,0,0,0,0
20200520,055599,TPK元大97購01,0.26,0.26,0.26,0.26,0.00,0.00,300000,1,78000,0,0,0,0,0,0,0,300000,-300000,-300000
20200520,05559P,臺股指麥證96售01,,,,,0.00,0.00,0,0,0,0,0,0,0,0,0,0,0,0,0
20200520,055600,致伸元大97購02,,,,,0.00,0.00,0,0,0,0,0,0,0,0,0,0,0,0,0
20200520,055601,茂林元大97購03,,,,,0.00,0.00,0,0,0,0,0,0,0,0,0,0,0,0,0
20200520,055602,康控元大97購03,,,,,0.00,0.00,0,0,0,0,0,0,0,0,0,0,0,0,0
20200520,055603,超眾元大97購04,1.50,1.50,1.50,1.50,-0.04,-2.6,68000,1,102000,0,0,0,0,0,0,0,68000,-68000,-68000
20200520,055604,訊芯元大98購02,,,,,0.00,0.00,0,0,0,0,0,0,0,0,0,0,0,0,0
20200520,055605,緯穎元大97購02,3.44,3.44,2.94,2.94,-0.16,-5.16,2000,2,6380,0,0,0,0,0,0,1000,0,1000,1000
20200520,055606,矽創元大97購01,,,,,0.00,0.00,0,0,0,0,0,0,0,0,0,0,0,0,0
20200520,055607,華通康和97購01,,,,,0.00,0.00,0,0,0,0,0,0,0,0,0,0,0,0,0
20200520,055608,華邦電康和97購01,,,,,0.00,0.00,0,0,0,0,0,0,0,0,0,0,0,0,0
20200520,055609,旺宏國票99購01,,,,,0.00,0.00,0,0,0,0,0,0,0,0,0,0,0,0,0
20200520,05560P,友達兆豐96售01,,,,,0.00,0.00,0,0,0,0,0,0,0,0,0,0,0,0,0
20200520,055610,光磊國票98購01,0.39,0.39,0.39,0.39,0.00,0.00,38000,1,14820,0,0,0,0,0,0,0,38000,-38000,-38000
20200520,055611,燿華國票98購02,0.12,0.14,0.12,0.14,+0.04,40.0,50000,3,6900,0,0,0,0,0,0,45000,5000,40000,40000
20200520,055612,台光電國票97購04,,,,,0.00,0.00,0,0,0,0,0,0,0,0,0,0,0,0,0
20200520,055613,全新國票98購01,,,,,0.00,0.00,0,0,0,0,0,0,0,0,0,0,0,0,0
20200520,055614,華新科國票97購02,0.40,0.40,0.40,0.40,0.00,0.00,1000,1,400,0,0,0,0,0,0,0,0,0,0
20200520,055615,宏達電國票99購02,,,,,0.00,0.00,0,0,0,0,0,0,0,0,0,0,0,0,0
20200520,055616,智原國票97購03,,,,,0.00,0.00,0,0,0,0,0,0,0,0,0,0,0,0,0
20200520,055617,TPK國票98購04,,,,,0.00,0.00,0,0,0,0,0,0,0,0,0,0,0,0,0
20200520,055618,麗豐國票98購01,0.95,0.95,0.95,0.95,0.00,0.00,63000,1,59850,0,0,0,0,0,0,63000,0,63000,63000
20200520,055619,同欣電國票98購02,1.80,2.06,1.80,1.80,-0.03,-1.64,738000,12,1388660,0,0,0,0,0,0,108000,630000,-522000,-522000
20200520,05561P,大立光兆豐96售02,,,,,0.00,0.00,0,0,0,0,0,0,0,0,0,0,0,0,0
20200520,055620,樺漢國票98購01,1.50,1.50,1.50,1.50,+0.04,2.74,69000,2,103500,0,0,0,0,0,0,69000,0,69000,69000
20200520,055621,國巨國泰98購03,,,,,0.00,0.00,0,0,0,0,0,0,0,0,0,0,0,0,0
20200520,055622,群創國泰99購01,,,,,0.00,0.00,0,0,0,0,0,0,0,0,0,0,0,0,0
20200520,055623,貿聯國泰99購01,0.44,0.45,0.44,0.44,+0.02,4.76,30000,27,13360,0,0,0,0,0,0,30000,0,30000,30000
20200520,055624,聯發科富邦99購07,,,,,0.00,0.00,0,0,0,0,0,0,0,0,0,0,0,0,0
20200520,055625,亞光富邦98購01,,,,,0.00,0.00,0,0,0,0,0,0,0,0,0,0,0,0,0
20200520,055626,力山永豐97購01,0.84,0.86,0.84,0.86,-0.04,-4.44,20000,2,17000,0,0,0,0,0,0,0,20000,-20000,-20000
20200520,055627,亞德客永豐97購02,1.56,1.56,1.56,1.56,0.00,0.00,1000,1,1560,0,0,0,0,0,0,0,1000,-1000,-1000
20200520,055628,旺宏永豐97購01,,,,,0.00,0.00,0,0,0,0,0,0,0,0,0,0,0,0,0
20200520,055629,華新科永豐97購04,,,,,0.00,0.00,0,0,0,0,0,0,0,0,0,0,0,0,0
20200520,05562P,鴻海元大96售16,,,,,0.00,0.00,0,0,0,0,0,0,0,0,0,0,0,0,0
20200520,055630,聯詠永豐97購02,,,,,0.00,0.00,0,0,0,0,0,0,0,0,0,0,0,0,0
20200520,055631,創意永豐98購01,0.98,0.99,0.98,0.99,+0.01,1.02,43000,3,42420,0,0,0,0,0,0,0,43000,-43000,-43000
20200520,055632,群創永豐98購01,,,,,0.00,0.00,0,0,0,0,0,0,0,0,0,0,0,0,0
20200520,055633,牧德永豐97購02,,,,,0.00,0.00,0,0,0,0,0,0,0,0,0,0,0,0,0
20200520,055634,訊芯永豐97購02,,,,,0.00,0.00,0,0,0,0,0,0,0,0,0,0,0,0,0
20200520,055635,緯穎永豐97購01,1.12,1.12,0.96,0.96,-0.05,-4.95,41000,3,39520,0,0,0,0,0,0,0,41000,-41000,-41000
20200520,055636,元油反元富97購02,,,,,0.00,0.00,0,0,0,0,0,0,0,0,0,0,0,0,0
20200520,055637,亞德客元富97購01,,,,,0.00,0.00,0,0,0,0,0,0,0,0,0,0,0,0,0
20200520,055638,上銀元富97購01,,,,,0.00,0.00,0,0,0,0,0,0,0,0,0,0,0,0,0
20200520,055639,上銀元富97購02,1.44,1.44,1.33,1.33,-0.10,-6.99,112000,5,158860,0,0,0,0,0,0,110000,2000,108000,108000
20200520,05563P,台積電元大97售07,,,,,0.00,0.00,0,0,0,0,0,0,0,0,0,0,0,0,0
20200520,055640,鴻海元富97購03,,,,,0.00,0.00,0,0,0,0,0,0,0,0,0,0,0,0,0
20200520,055641,鴻海元富97購04,,,,,0.00,0.00,0,0,0,0,0,0,0,0,0,0,0,0,0
20200520,055642,廣宇元富97購01,,,,,0.00,0.00,0,0,0,0,0,0,0,0,0,0,0,0,0
20200520,055643,宏碁元富97購01,,,,,0.00,0.00,0,0,0,0,0,0,0,0,0,0,0,0,0
20200520,055644,致茂元富97購01,,,,,0.00,0.00,0,0,0,0,0,0,0,0,0,0,0,0,0
20200520,055645,技嘉元富97購01,3.32,3.32,3.03,3.06,-0.19,-5.85,10000,8,30960,0,0,0,0,0,0,8000,1000,7000,7000
20200520,055646,漢唐元富97購01,,,,,0.00,0.00,0,0,0,0,0,0,0,0,0,0,0,0,0
20200520,055647,義隆元富97購01,,,,,0.00,0.00,0,0,0,0,0,0,0,0,0,0,0,0,0
20200520,055648,可成元富97購01,0.95,0.95,0.90,0.90,-0.16,-15.09,101000,3,94200,0,0,0,0,0,0,66000,35000,31000,31000
20200520,055649,華新科元富97購03,,,,,0.00,0.00,0,0,0,0,0,0,0,0,0,0,0,0,0
20200520,05564P,玉晶光元大97售02,0.09,0.09,0.09,0.09,-0.01,-10.0,20000,2,1800,0,0,0,0,0,0,0,0,0,0
20200520,055650,華新科元富98購01,,,,,0.00,0.00,0,0,0,0,0,0,0,0,0,0,0,0,0
20200520,055651,富邦金元富97購01,0.22,0.22,0.22,0.22,0.00,0.00,108000,2,23760,0,0,0,0,0,0,108000,0,108000,108000
20200520,055652,聯詠元富01購01,0.68,0.73,0.67,0.72,+0.02,2.86,623000,30,432290,0,0,0,0,0,0,421000,200000,221000,221000
20200520,055653,聯詠元富01購02,0.64,0.69,0.60,0.67,+0.01,1.52,606000,41,393260,0,0,0,0,0,0,491000,85000,406000,406000
20200520,055654,景碩元富97購01,,,,,0.00,0.00,0,0,0,0,0,0,0,0,0,0,0,0,0
20200520,055655,群創元富99購07,,,,,0.00,0.00,0,0,0,0,0,0,0,0,0,0,0,0,0
20200520,055656,新唐元富97購01,,,,,0.00,0.00,0,0,0,0,0,0,0,0,0,0,0,0,0
20200520,055657,超眾元富97購02,1.03,1.10,1.02,1.02,-0.04,-3.77,196000,5,202500,0,0,0,0,0,0,146000,66000,80000,80000
20200520,055658,南電元富97購01,,,,,0.00,0.00,0,0,0,0,0,0,0,0,0,0,0,0,0
20200520,055659,百和元富97購01,,,,,0.00,0.00,0,0,0,0,0,0,0,0,0,0,0,0,0
20200520,05565P,鎧勝元大96售01,0.79,0.79,0.79,0.79,-0.15,-15.96,50000,1,39500,0,0,0,0,0,0,0,50000,-50000,-50000
20200520,055660,台光電兆豐97購01,,,,,0.00,0.00,0,0,0,0,0,0,0,0,0,0,0,0,0
20200520,055661,亞德客中信98購01,0.47,0.50,0.47,0.50,+0.06,13.64,32000,4,15850,0,0,0,0,0,0,32000,0,32000,32000
20200520,055662,上銀中信99購01,0.67,0.67,0.67,0.67,-0.05,-6.94,50000,5,33500,0,0,0,0,0,0,50000,50000,0,0
20200520,055663,崇越中信97購01,,,,,0.00,0.00,0,0,0,0,0,0,0,0,0,0,0,0,0
20200520,055664,和大群益98購02,,,,,0.00,0.00,0,0,0,0,0,0,0,0,0,0,0,0,0
20200520,055665,亞德客群益97購01,2.66,2.66,2.51,2.51,-0.14,-5.28,40000,2,104300,0,0,0,0,0,0,0,40000,-40000,-40000
20200520,055666,鴻海群益97購05,,,,,0.00,0.00,0,0,0,0,0,0,0,0,0,0,0,0,0
20200520,055667,致茂群益98購01,0.74,0.75,0.74,0.75,+0.04,5.63,150000,3,111800,0,0,0,0,0,0,80000,70000,10000,10000
20200520,055668,欣興群益97購01,1.33,1.34,1.33,1.34,+0.01,0.75,47000,3,62710,0,0,0,0,0,0,27000,20000,7000,7000
20200520,055669,緯穎群益97購02,,,,,0.00,0.00,0,0,0,0,0,0,0,0,0,0,0,0,0
20200520,05566P,景碩永豐96售01,,,,,0.00,0.00,0,0,0,0,0,0,0,0,0,0,0,0,0
20200520,055670,矽創群益98購02,1.81,1.83,1.78,1.78,-0.01,-0.56,366000,18,661450,0,0,0,0,0,0,321000,45000,276000,276000
20200520,055671,世紀鋼群益97購01,2.50,2.50,2.50,2.50,-0.48,-16.11,6000,1,15000,0,0,0,0,0,0,0,6000,-6000,-6000
20200520,055672,國巨日盛97購02,,,,,0.00,0.00,0,0,0,0,0,0,0,0,0,0,0,0,0
20200520,055673,旺宏日盛97購01,,,,,0.00,0.00,0,0,0,0,0,0,0,0,0,0,0,0,0
20200520,055674,南港康和97購02,,,,,0.00,0.00,0,0,0,0,0,0,0,0,0,0,0,0,0
20200520,055675,亞德客凱基97購02,0.96,1.02,0.95,0.95,+0.05,5.56,19000,4,18490,0,0,0,0,0,0,0,19000,-19000,-19000
20200520,055676,亞德客凱基97購03,,,,,0.00,0.00,0,0,0,0,0,0,0,0,0,0,0,0,0
20200520,055677,喬山凱基97購01,,,,,0.00,0.00,0,0,0,0,0,0,0,0,0,0,0,0,0
20200520,055678,上銀凱基97購02,,,,,0.00,0.00,0,0,0,0,0,0,0,0,0,0,0,0,0
20200520,055679,華通凱基99購01,,,,,0.00,0.00,0,0,0,0,0,0,0,0,0,0,0,0,0
20200520,05567P,致伸群益96售01,,,,,0.00,0.00,0,0,0,0,0,0,0,0,0,0,0,0,0
20200520,055680,美律凱基99購01,,,,,0.00,0.00,0,0,0,0,0,0,0,0,0,0,0,0,0
20200520,055681,奇鋐凱基98購03,,,,,0.00,0.00,0,0,0,0,0,0,0,0,0,0,0,0,0
20200520,055682,智原凱基98購02,,,,,0.00,0.00,0,0,0,0,0,0,0,0,0,0,0,0,0
20200520,055683,晶技凱基99購01,,,,,0.00,0.00,0,0,0,0,0,0,0,0,0,0,0,0,0
20200520,055684,京鼎凱基97購01,0.63,0.64,0.62,0.62,-0.01,-1.59,311000,6,196640,0,0,0,0,0,0,220000,91000,129000,129000
20200520,055685,日月光凱基97購02,,,,,0.00,0.00,0,0,0,0,0,0,0,0,0,0,0,0,0
20200520,055686,致伸凱基97購02,0.41,0.41,0.41,0.41,-0.10,-19.61,50000,1,20500,0,0,0,0,0,0,50000,50000,0,0
20200520,055687,瀚宇博凱基97購01,,,,,0.00,0.00,0,0,0,0,0,0,0,0,0,0,0,0,0
20200520,055688,力成凱基98購02,0.37,0.37,0.37,0.37,0.00,0.00,10000,1,3700,0,0,0,0,0,0,10000,0,10000,10000
20200520,055689,台郡凱基99購01,0.99,0.99,0.99,0.99,0.00,0.00,44000,1,43560,0,0,0,0,0,0,44000,0,44000,44000
20200520,05568P,台積電統一96售03,0.70,0.70,0.70,0.70,0.00,0.00,10000,1,7000,0,0,0,0,0,0,10000,10000,0,0
20200520,055690,矽力凱基97購02,2.51,2.77,2.22,2.77,+0.12,4.53,57000,9,144620,0,0,0,0,0,0,21000,36000,-15000,-15000
20200520,055691,訊芯凱基97購02,,,,,0.00,0.00,0,0,0,0,0,0,0,0,0,0,0,0,0
20200520,055692,緯穎凱基97購03,2.71,2.87,2.67,2.67,-0.19,-6.64,190000,21,530380,0,0,0,0,0,0,190000,20000,170000,170000
20200520,055693,南茂凱基97購01,0.23,0.23,0.23,0.23,0.00,0.00,484000,1,111320,0,0,0,0,0,0,484000,0,484000,484000
20200520,055694,光罩國票98購01,,,,,0.00,0.00,0,0,0,0,0,0,0,0,0,0,0,0,0
20200520,055695,大毅國票98購03,7.10,7.10,6.95,6.95,0.00,0.00,9000,2,62850,0,0,0,0,0,0,0,9000,-9000,-9000
20200520,055696,華新科國票98購01,,,,,0.00,0.00,0,0,0,0,0,0,0,0,0,0,0,0,0
20200520,055697,牧德國票98購01,,,,,0.00,0.00,0,0,0,0,0,0,0,0,0,0,0,0,0
20200520,055698,茂林國票98購03,0.82,1.05,0.82,1.05,+0.31,41.89,538000,13,491440,0,0,0,0,0,0,0,538000,-538000,-538000
20200520,055699,康控國票97購04,,,,,0.00,0.00,0,0,0,0,0,0,0,0,0,0,0,0,0
20200520,05569P,漢唐統一97售01,0.76,0.77,0.76,0.77,-0.01,-1.28,265000,3,202400,0,0,0,0,0,0,265000,0,265000,265000
20200520,055700,緯穎國泰98購02,3.81,3.81,3.81,3.81,+0.08,2.14,3000,1,11430,0,0,0,0,0,0,3000,3000,0,0
20200520,055701,亞德客富邦99購01,,,,,0.00,0.00,0,0,0,0,0,0,0,0,0,0,0,0,0
20200520,055702,美律富邦98購01,,,,,0.00,0.00,0,0,0,0,0,0,0,0,0,0,0,0,0
20200520,055703,緯穎富邦98購01,0.61,0.65,0.51,0.51,-0.08,-13.56,82000,15,47520,0,0,0,0,0,0,39000,4000,35000,35000
20200520,055704,亞德客永豐97購04,,,,,0.00,0.00,0,0,0,0,0,0,0,0,0,0,0,0,0
20200520,055705,微星永豐97購01,0.76,0.76,0.60,0.60,-0.09,-13.04,141000,11,91460,0,0,0,0,0,0,103000,38000,65000,65000
20200520,055706,大立光永豐97購03,,,,,0.00,0.00,0,0,0,0,0,0,0,0,0,0,0,0,0
20200520,055707,聯鈞永豐98購01,0.66,0.66,0.66,0.66,0.00,0.00,68000,1,44880,0,0,0,0,0,0,0,68000,-68000,-68000
20200520,055708,茂林永豐97購02,,,,,0.00,0.00,0,0,0,0,0,0,0,0,0,0,0,0,0
20200520,055709,深中小元大97購03,,,,,0.00,0.00,0,0,0,0,0,0,0,0,0,0,0,0,0
20200520,05570P,聯發科統一96售04,,,,,0.00,0.00,0,0,0,0,0,0,0,0,0,0,0,0,0
20200520,055710,亞德客元大97購03,2.49,2.51,2.49,2.51,+0.02,0.8,16000,2,40140,0,0,0,0,0,0,1000,15000,-14000,-14000
20200520,055711,上銀元大97購04,,,,,0.00,0.00,0,0,0,0,0,0,0,0,0,0,0,0,0
20200520,055712,金寶元大97購02,,,,,0.00,0.00,0,0,0,0,0,0,0,0,0,0,0,0,0
20200520,055713,國巨元大98購09,4.33,4.33,3.95,3.97,+0.24,6.43,6000,6,24490,0,0,0,0,0,0,6000,5000,1000,1000
20200520,055714,智邦元大97購03,4.28,4.47,4.16,4.47,+0.27,6.43,67000,8,293250,0,0,0,0,0,0,12000,67000,-55000,-55000
20200520,055715,智邦元大97購04,7.35,7.35,7.35,7.35,0.00,0.00,5000,1,36750,0,0,0,0,0,0,5000,0,5000,5000
20200520,055716,致茂元大97購01,0.84,0.91,0.84,0.91,+0.03,3.41,164000,7,143000,0,0,0,0,0,0,68000,96000,-28000,-28000
20200520,055717,聯發科元大97購19,2.10,2.80,2.10,2.80,+0.78,38.61,23000,5,50720,0,0,0,0,0,0,23000,0,23000,23000
20200520,055718,可成元大97購02,,,,,0.00,0.00,0,0,0,0,0,0,0,0,0,0,0,0,0
20200520,055719,可成元大97購03,,,,,0.00,0.00,0,0,0,0,0,0,0,0,0,0,0,0,0
20200520,05571P,大立光統一96售03,2.10,2.15,2.07,2.13,-0.24,-10.13,64000,11,135500,0,0,0,0,0,0,14000,50000,-36000,-36000
20200520,055720,宏達電元大97購05,0.43,0.43,0.43,0.43,0.00,0.00,1000,1,430,0,0,0,0,0,0,0,1000,-1000,-1000
20200520,055721,聯詠元大97購04,,,,,0.00,0.00,0,0,0,0,0,0,0,0,0,0,0,0,0
20200520,055722,聯鈞元大97購03,,,,,0.00,0.00,0,0,0,0,0,0,0,0,0,0,0,0,0
20200520,055723,康控元大97購04,,,,,0.00,0.00,0,0,0,0,0,0,0,0,0,0,0,0,0
20200520,055724,祥碩元大97購03,,,,,0.00,0.00,0,0,0,0,0,0,0,0,0,0,0,0,0
20200520,055725,嘉聯益元大98購03,0.60,0.60,0.60,0.60,0.00,0.00,20000,1,12000,0,0,0,0,0,0,20000,0,20000,20000
20200520,055726,台表科元大98購03,3.35,4.04,3.03,3.99,+0.97,32.12,254000,22,908740,0,0,0,0,0,0,55000,199000,-144000,-144000
20200520,055727,矽力元大97購02,9.25,9.25,8.85,8.85,-1.25,-12.38,26000,3,238600,0,0,0,0,0,0,11000,15000,-4000,-4000
20200520,055728,緯穎元大97購03,1.71,1.71,1.71,1.71,-0.47,-21.56,40000,1,68400,0,0,0,0,0,0,40000,0,40000,40000
20200520,055729,金寶元富99購01,0.22,0.22,0.22,0.22,0.00,0.00,2000,1,440,0,0,0,0,0,0,0,0,0,0
20200520,05572P,群創統一96售02,,,,,0.00,0.00,0,0,0,0,0,0,0,0,0,0,0,0,0
20200520,055730,建準元富97購02,1.89,1.89,1.53,1.73,-0.04,-2.26,292000,44,491300,0,0,0,0,0,0,258000,5000,253000,253000
20200520,055731,美律元富97購01,0.36,0.36,0.36,0.36,-0.04,-10.0,98000,1,35280,0,0,0,0,0,0,0,98000,-98000,-98000
20200520,055732,全新元富9A購01,0.56,0.56,0.56,0.56,-0.05,-8.2,30000,2,16800,0,0,0,0,0,0,0,30000,-30000,-30000
20200520,055733,奇力新元富97購01,0.40,0.40,0.39,0.39,0.00,0.00,5000,2,1960,0,0,0,0,0,0,0,5000,-5000,-5000
20200520,055734,奇力新元富97購02,,,,,0.00,0.00,0,0,0,0,0,0,0,0,0,0,0,0,0
20200520,055735,宏達電元富98購01,,,,,0.00,0.00,0,0,0,0,0,0,0,0,0,0,0,0,0
20200520,055736,宏達電元富99購01,0.51,0.52,0.48,0.48,+0.03,6.67,400000,6,198000,0,0,0,0,0,0,100000,300000,-200000,-200000
20200520,055737,開發金元富97購01,,,,,0.00,0.00,0,0,0,0,0,0,0,0,0,0,0,0,0
20200520,055738,玉山金元富97購01,0.97,0.97,0.97,0.97,+0.14,16.87,10000,1,9700,0,0,0,0,0,0,0,10000,-10000,-10000
20200520,055739,健鼎元富97購01,,,,,0.00,0.00,0,0,0,0,0,0,0,0,0,0,0,0,0
20200520,05573P,仁寶元富96售02,0.21,0.21,0.21,0.21,-0.01,-4.55,5000,1,1050,0,0,0,0,0,0,0,5000,-5000,-5000
20200520,055740,智易元富97購01,,,,,0.00,0.00,0,0,0,0,0,0,0,0,0,0,0,0,0
20200520,055741,健策元富97購01,0.72,0.76,0.72,0.76,+0.04,5.56,284000,6,212480,0,0,0,0,0,0,0,284000,-284000,-284000
20200520,055742,健策元富97購02,0.07,0.07,0.07,0.07,0.00,0.00,135000,1,9450,0,0,0,0,0,0,135000,135000,0,0
20200520,055743,TPK元富98購01,,,,,0.00,0.00,0,0,0,0,0,0,0,0,0,0,0,0,0
20200520,055744,茂林元富97購02,0.30,0.56,0.30,0.56,+0.27,93.1,1114000,45,465390,0,0,0,0,0,0,68000,1076000,-1008000,-1008000
20200520,055745,臻鼎元富97購01,0.24,0.28,0.24,0.28,+0.05,21.74,257000,4,67830,0,0,0,0,0,0,255000,2000,253000,253000
20200520,055746,同欣電元富97購01,0.70,0.78,0.70,0.70,0.00,0.00,408000,17,299570,0,0,0,0,0,0,112000,296000,-184000,-184000
20200520,055747,康舒元富97購01,0.56,0.56,0.56,0.56,+0.03,5.66,45000,2,25200,0,0,0,0,0,0,45000,0,45000,45000
20200520,055748,GIS元富97購01,,,,,0.00,0.00,0,0,0,0,0,0,0,0,0,0,0,0,0
20200520,055749,智邦永昌9C購01,,,,,0.00,0.00,0,0,0,0,0,0,0,0,0,0,0,0,0
20200520,05574P,英業達元富96售01,,,,,0.00,0.00,0,0,0,0,0,0,0,0,0,0,0,0,0
20200520,055750,瑞昱永昌9C購01,,,,,0.00,0.00,0,0,0,0,0,0,0,0,0,0,0,0,0
20200520,055751,南亞科永昌9C購01,,,,,0.00,0.00,0,0,0,0,0,0,0,0,0,0,0,0,0
20200520,055752,臺股指永昌97購01,,,,,0.00,0.00,0,0,0,0,0,0,0,0,0,0,0,0,0
20200520,055753,貿聯第一98購01,0.18,0.18,0.18,0.18,+0.08,80.0,3000,1,540,0,0,0,0,0,0,0,0,0,0
20200520,055754,和大兆豐97購01,,,,,0.00,0.00,0,0,0,0,0,0,0,0,0,0,0,0,0
20200520,055755,禾伸堂兆豐97購02,1.83,1.91,1.80,1.80,+0.09,5.26,223000,6,418250,0,0,0,0,0,0,0,223000,-223000,-223000
20200520,055756,臺股指兆豐97購01,,,,,0.00,0.00,0,0,0,0,0,0,0,0,0,0,0,0,0
20200520,055757,大成鋼群益99購01,,,,,0.00,0.00,0,0,0,0,0,0,0,0,0,0,0,0,0
20200520,055758,旺宏群益97購01,,,,,0.00,0.00,0,0,0,0,0,0,0,0,0,0,0,0,0
20200520,055759,技嘉群益98購02,,,,,0.00,0.00,0,0,0,0,0,0,0,0,0,0,0,0,0
20200520,05575P,玉晶光元富96售01,,,,,0.00,0.00,0,0,0,0,0,0,0,0,0,0,0,0,0
20200520,055760,新日興群益98購02,,,,,0.00,0.00,0,0,0,0,0,0,0,0,0,0,0,0,0
20200520,055761,創意群益97購01,,,,,0.00,0.00,0,0,0,0,0,0,0,0,0,0,0,0,0
20200520,055762,智伸科群益97購01,,,,,0.00,0.00,0,0,0,0,0,0,0,0,0,0,0,0,0
20200520,055763,鎧勝群益97購01,0.25,0.26,0.21,0.21,+0.02,10.53,910000,29,209300,0,0,0,0,0,0,140000,770000,-630000,-630000
20200520,055764,臺股指群益97購02,,,,,0.00,0.00,0,0,0,0,0,0,0,0,0,0,0,0,0
20200520,055765,臺股指群益97購03,,,,,0.00,0.00,0,0,0,0,0,0,0,0,0,0,0,0,0
20200520,055766,臺股指群益97購04,,,,,0.00,0.00,0,0,0,0,0,0,0,0,0,0,0,0,0
20200520,055767,臺股指群益97購05,,,,,0.00,0.00,0,0,0,0,0,0,0,0,0,0,0,0,0
20200520,055768,臺股指群益97購06,,,,,0.00,0.00,0,0,0,0,0,0,0,0,0,0,0,0,0
20200520,055769,智伸科中信97購01,,,,,0.00,0.00,0,0,0,0,0,0,0,0,0,0,0,0,0
20200520,05576P,群創日盛99售02,,,,,0.00,0.00,0,0,0,0,0,0,0,0,0,0,0,0,0
20200520,055770,欣興麥證97購01,,,,,0.00,0.00,0,0,0,0,0,0,0,0,0,0,0,0,0
20200520,055771,台積電日盛97購04,0.10,0.10,0.10,0.10,0.00,0.00,15000,1,1500,0,0,0,0,0,0,0,0,0,0
20200520,055772,致茂凱基97購01,,,,,0.00,0.00,0,0,0,0,0,0,0,0,0,0,0,0,0
20200520,055773,瑞昱凱基97購03,3.21,3.26,3.21,3.26,0.00,0.00,14000,2,44990,0,0,0,0,0,0,14000,0,14000,14000
20200520,055774,台光電凱基97購02,0.88,0.91,0.88,0.91,-0.08,-8.08,206000,19,184800,0,0,0,0,0,0,206000,0,206000,206000
20200520,055775,友達凱基9A購01,0.47,0.47,0.47,0.47,+0.04,9.3,80000,1,37600,0,0,0,0,0,0,0,80000,-80000,-80000
20200520,055776,宏達電凱基98購02,0.74,0.74,0.74,0.74,+0.07,10.45,50000,3,37000,0,0,0,0,0,0,50000,3000,47000,47000
20200520,055777,冠德凱基97購01,0.25,0.25,0.25,0.25,0.00,0.00,100000,1,25000,0,0,0,0,0,0,100000,0,100000,100000
20200520,055778,美食凱基97購01,,,,,0.00,0.00,0,0,0,0,0,0,0,0,0,0,0,0,0
20200520,055779,國泰金凱基97購02,1.87,1.87,1.85,1.85,-0.05,-2.63,46000,4,85200,0,0,0,0,0,0,5000,41000,-36000,-36000
20200520,05577P,上銀凱基96售02,,,,,0.00,0.00,0,0,0,0,0,0,0,0,0,0,0,0,0
20200520,055780,禾伸堂凱基99購01,5.15,5.15,5.15,5.15,-0.05,-0.96,4000,1,20600,0,0,0,0,0,0,0,4000,-4000,-4000
20200520,055781,聯詠凱基98購01,,,,,0.00,0.00,0,0,0,0,0,0,0,0,0,0,0,0,0
20200520,055782,新日興凱基99購01,0.76,0.88,0.76,0.88,0.00,0.00,5000,2,4160,0,0,0,0,0,0,2000,3000,-1000,-1000
20200520,055783,群創凱基99購03,,,,,0.00,0.00,0,0,0,0,0,0,0,0,0,0,0,0,0
20200520,055784,TPK凱基97購02,,,,,0.00,0.00,0,0,0,0,0,0,0,0,0,0,0,0,0
20200520,055785,祥碩凱基97購02,7.85,7.85,7.85,7.85,+0.50,6.8,1000,1,7850,0,0,0,0,0,0,1000,0,1000,1000
20200520,055786,彩晶凱基99購02,0.08,0.08,0.08,0.08,0.00,0.00,10000,1,800,0,0,0,0,0,0,0,0,0,0
20200520,055787,聯茂凱基99購01,,,,,0.00,0.00,0,0,0,0,0,0,0,0,0,0,0,0,0
20200520,055788,緯穎凱基97購04,5.15,5.20,5.15,5.20,-0.10,-1.89,19000,2,98250,0,0,0,0,0,0,19000,0,19000,19000
20200520,055789,台虹凱基97購01,,,,,0.00,0.00,0,0,0,0,0,0,0,0,0,0,0,0,0
20200520,05578P,鴻海凱基96售11,,,,,0.00,0.00,0,0,0,0,0,0,0,0,0,0,0,0,0
20200520,055790,南電凱基97購01,,,,,0.00,0.00,0,0,0,0,0,0,0,0,0,0,0,0,0
20200520,055791,臺股指凱基97購14,,,,,0.00,0.00,0,0,0,0,0,0,0,0,0,0,0,0,0
20200520,055792,臺股指凱基97購15,,,,,0.00,0.00,0,0,0,0,0,0,0,0,0,0,0,0,0
20200520,055793,臺股指凱基97購16,,,,,0.00,0.00,0,0,0,0,0,0,0,0,0,0,0,0,0
20200520,055794,聯發科國泰99購01,0.87,1.00,0.87,1.00,+0.19,23.46,32000,3,27970,0,0,0,0,0,0,32000,0,32000,32000
20200520,055795,茂林國泰98購01,0.71,0.96,0.71,0.91,+0.28,44.44,333000,11,296510,0,0,0,0,0,0,307000,0,307000,307000
20200520,055796,南電國泰98購01,3.00,3.19,2.81,2.88,-0.12,-4.0,108000,12,311100,0,0,0,0,0,0,10000,98000,-88000,-88000
20200520,055797,華通富邦98購01,,,,,0.00,0.00,0,0,0,0,0,0,0,0,0,0,0,0,0
20200520,055798,聯茂富邦98購01,0.40,0.40,0.27,0.33,-0.02,-5.71,209000,12,61680,0,0,0,0,0,0,0,118000,-118000,-118000
20200520,055799,致茂永豐97購02,,,,,0.00,0.00,0,0,0,0,0,0,0,0,0,0,0,0,0
20200520,05579P,友達凱基98售03,1.19,1.26,1.19,1.26,0.00,0.00,42000,2,52780,0,0,0,0,0,0,0,42000,-42000,-42000
20200520,055800,欣興永豐97購02,,,,,0.00,0.00,0,0,0,0,0,0,0,0,0,0,0,0,0
20200520,055801,景碩永豐97購02,,,,,0.00,0.00,0,0,0,0,0,0,0,0,0,0,0,0,0
20200520,055802,新日興永豐97購01,,,,,0.00,0.00,0,0,0,0,0,0,0,0,0,0,0,0,0
20200520,055803,鎧勝永豐97購01,,,,,0.00,0.00,0,0,0,0,0,0,0,0,0,0,0,0,0
20200520,055804,祥碩永豐97購02,3.72,4.49,3.72,4.39,+0.79,21.94,146000,23,581480,0,0,0,0,0,0,91000,53000,38000,38000
20200520,055805,矽力永豐97購01,0.77,0.88,0.75,0.85,-0.01,-1.16,138000,12,112430,0,0,0,0,0,0,74000,64000,10000,10000
20200520,055806,致新永豐97購02,0.79,0.81,0.78,0.79,+0.10,14.49,222000,7,174870,0,0,0,0,0,0,191000,31000,160000,160000
20200520,055807,勤誠永豐97購01,0.11,0.11,0.11,0.11,0.00,0.00,30000,1,3300,0,0,0,0,0,0,30000,0,30000,30000
20200520,055808,世紀鋼永豐97購01,0.50,0.50,0.50,0.50,0.00,0.00,20000,2,10000,0,0,0,0,0,0,10000,10000,0,0
20200520,055809,T50反1國票98購02,1.03,1.03,1.03,1.03,-0.02,-1.9,15000,1,15450,0,0,0,0,0,0,15000,0,15000,15000
20200520,05580P,美律凱基96售03,,,,,0.00,0.00,0,0,0,0,0,0,0,0,0,0,0,0,0
20200520,055810,T50反1國票99購01,0.99,0.99,0.99,0.99,0.00,0.00,1000,1,990,0,0,0,0,0,0,0,1000,-1000,-1000
20200520,055811,國巨國票98購05,,,,,0.00,0.00,0,0,0,0,0,0,0,0,0,0,0,0,0
20200520,055812,台積電國票99購02,,,,,0.00,0.00,0,0,0,0,0,0,0,0,0,0,0,0,0
20200520,055813,聯發科國票98購04,5.80,5.80,5.30,5.35,+0.15,2.88,20000,6,109900,0,0,0,0,0,0,9000,11000,-2000,-2000
20200520,055814,晶豪科國票97購02,2.93,2.93,2.65,2.65,-0.19,-6.69,150000,3,417580,0,0,0,0,0,0,50000,114000,-64000,-64000
20200520,055815,亞光國票99購01,,,,,0.00,0.00,0,0,0,0,0,0,0,0,0,0,0,0,0
20200520,055816,新日興國票98購01,1.41,1.67,1.41,1.67,0.00,0.00,236000,6,361110,0,0,0,0,0,0,0,236000,-236000,-236000
20200520,055817,京鼎國票99購01,,,,,0.00,0.00,0,0,0,0,0,0,0,0,0,0,0,0,0
20200520,055818,晶相光國票97購02,,,,,0.00,0.00,0,0,0,0,0,0,0,0,0,0,0,0,0
20200520,055819,晶相光國票98購01,,,,,0.00,0.00,0,0,0,0,0,0,0,0,0,0,0,0,0
20200520,05581P,華新科凱基96售07,,,,,0.00,0.00,0,0,0,0,0,0,0,0,0,0,0,0,0
20200520,055820,矽力國票98購02,6.60,7.00,6.25,6.80,+0.10,1.49,195000,18,1322400,0,0,0,0,0,0,6000,189000,-183000,-183000
20200520,055821,勤誠國票98購01,,,,,0.00,0.00,0,0,0,0,0,0,0,0,0,0,0,0,0
20200520,055822,臺股指國票97購09,0.55,0.55,0.53,0.53,0.00,0.00,81000,3,43950,0,0,0,0,0,0,0,81000,-81000,-81000
20200520,055823,臺股指國票97購10,,,,,0.00,0.00,0,0,0,0,0,0,0,0,0,0,0,0,0
20200520,055824,臺股指國票97購11,0.96,0.96,0.89,0.89,-0.03,-3.26,273000,12,258780,0,0,0,0,0,0,233000,40000,193000,193000
20200520,055825,臺股指國票97購12,,,,,0.00,0.00,0,0,0,0,0,0,0,0,0,0,0,0,0
20200520,055826,中石化元大97購01,0.25,0.25,0.25,0.25,0.00,0.00,5000,1,1250,0,0,0,0,0,0,5000,0,5000,5000
20200520,055827,中石化元大98購01,0.36,0.36,0.34,0.34,-0.02,-5.56,168000,7,58220,0,0,0,0,0,0,168000,0,168000,168000
20200520,055828,上銀元大97購05,,,,,0.00,0.00,0,0,0,0,0,0,0,0,0,0,0,0,0
20200520,055829,上銀元大97購06,,,,,0.00,0.00,0,0,0,0,0,0,0,0,0,0,0,0,0
20200520,05582P,群創凱基98售06,,,,,0.00,0.00,0,0,0,0,0,0,0,0,0,0,0,0,0
20200520,055830,上銀元大97購07,,,,,0.00,0.00,0,0,0,0,0,0,0,0,0,0,0,0,0
20200520,055831,台達電元大97購01,,,,,0.00,0.00,0,0,0,0,0,0,0,0,0,0,0,0,0
20200520,055832,台達電元大97購02,,,,,0.00,0.00,0,0,0,0,0,0,0,0,0,0,0,0,0
20200520,055833,華通元大98購05,,,,,0.00,0.00,0,0,0,0,0,0,0,0,0,0,0,0,0
20200520,055834,國巨元大97購13,3.21,3.54,3.21,3.24,+0.18,5.88,71000,8,237630,0,0,0,0,0,0,60000,14000,46000,46000
20200520,055835,華邦電元大97購03,,,,,0.00,0.00,0,0,0,0,0,0,0,0,0,0,0,0,0
20200520,055836,華邦電元大97購04,,,,,0.00,0.00,0,0,0,0,0,0,0,0,0,0,0,0,0
20200520,055837,致茂元大97購02,0.30,0.32,0.30,0.32,0.00,0.00,136000,5,41760,0,0,0,0,0,0,68000,68000,0,0
20200520,055838,致茂元大97購03,,,,,0.00,0.00,0,0,0,0,0,0,0,0,0,0,0,0,0
20200520,055839,瑞昱元大97購04,,,,,0.00,0.00,0,0,0,0,0,0,0,0,0,0,0,0,0
20200520,05583P,訊芯凱基96售01,,,,,0.00,0.00,0,0,0,0,0,0,0,0,0,0,0,0,0
20200520,055840,南亞科元大97購03,,,,,0.00,0.00,0,0,0,0,0,0,0,0,0,0,0,0,0
20200520,055841,南亞科元大97購04,0.63,0.67,0.62,0.67,+0.04,6.35,79000,4,52480,0,0,0,0,0,0,68000,11000,57000,57000
20200520,055842,建準元大98購01,1.20,1.20,1.06,1.14,-0.05,-4.2,459000,35,504060,0,0,0,0,0,0,338000,158000,180000,180000
20200520,055843,美律元大97購02,,,,,0.00,0.00,0,0,0,0,0,0,0,0,0,0,0,0,0
20200520,055844,大毅元大98購01,1.99,2.06,1.96,1.96,-0.03,-1.51,48000,7,96230,0,0,0,0,0,0,10000,38000,-28000,-28000
20200520,055845,大立光元大97購08,0.70,0.74,0.70,0.74,-0.06,-7.5,51000,6,36840,0,0,0,0,0,0,51000,0,51000,51000
20200520,055846,大立光元大97購09,0.80,0.84,0.80,0.84,-0.07,-7.69,50000,2,41600,0,0,0,0,0,0,50000,0,50000,50000
20200520,055847,大立光元大97購10,0.65,0.72,0.65,0.72,-0.06,-7.69,278000,5,192700,0,0,0,0,0,0,0,278000,-278000,-278000
20200520,055848,大立光元大97購11,0.95,0.95,0.95,0.95,0.00,0.00,50000,1,47500,0,0,0,0,0,0,0,50000,-50000,-50000
20200520,055849,聯詠元大97購05,0.38,0.38,0.38,0.38,+0.02,5.56,68000,1,25840,0,0,0,0,0,0,68000,0,68000,68000
20200520,05584P,臺股指凱基96售13,3.64,3.64,3.64,3.64,-0.01,-0.27,1000,1,3640,0,0,0,0,0,0,0,1000,-1000,-1000
20200520,055850,聯詠元大97購06,0.45,0.50,0.45,0.50,+0.03,6.38,278000,8,135780,0,0,0,0,0,0,68000,210000,-142000,-142000
20200520,055851,智原元大98購01,,,,,0.00,0.00,0,0,0,0,0,0,0,0,0,0,0,0,0
20200520,055852,聯鈞元大98購01,,,,,0.00,0.00,0,0,0,0,0,0,0,0,0,0,0,0,0
20200520,055853,群創元大98購03,,,,,0.00,0.00,0,0,0,0,0,0,0,0,0,0,0,0,0
20200520,055854,群創元大98購04,,,,,0.00,0.00,0,0,0,0,0,0,0,0,0,0,0,0,0
20200520,055855,牧德元大99購02,,,,,0.00,0.00,0,0,0,0,0,0,0,0,0,0,0,0,0
20200520,055856,新唐元大97購03,0.26,0.26,0.24,0.26,0.00,0.00,430000,4,110200,0,0,0,0,0,0,330000,100000,230000,230000
20200520,055857,嘉聯益元大97購04,,,,,0.00,0.00,0,0,0,0,0,0,0,0,0,0,0,0,0
20200520,055858,聯茂元大97購03,0.78,0.78,0.75,0.75,+0.05,7.14,79000,2,60270,0,0,0,0,0,0,34000,45000,-11000,-11000
20200520,055859,啟碁元大97購03,0.63,0.66,0.63,0.66,+0.02,3.12,191000,3,124020,0,0,0,0,0,0,123000,68000,55000,55000
20200520,05585P,臺股指凱基96售14,,,,,0.00,0.00,0,0,0,0,0,0,0,0,0,0,0,0,0
20200520,055860,啟碁元大97購04,,,,,0.00,0.00,0,0,0,0,0,0,0,0,0,0,0,0,0
20200520,055861,矽力元大97購03,3.43,3.43,3.43,3.43,+0.06,1.78,1000,1,3430,0,0,0,0,0,0,0,1000,-1000,-1000
20200520,055862,矽力元大97購04,,,,,0.00,0.00,0,0,0,0,0,0,0,0,0,0,0,0,0
20200520,055863,緯穎元大97購05,1.51,1.55,1.51,1.55,+0.16,11.51,25000,3,38460,0,0,0,0,0,0,25000,20000,5000,5000
20200520,055864,臺股指元大97購01,,,,,0.00,0.00,0,0,0,0,0,0,0,0,0,0,0,0,0
20200520,055865,臺股指元大97購02,,,,,0.00,0.00,0,0,0,0,0,0,0,0,0,0,0,0,0
20200520,055866,臺股指元大97購03,,,,,0.00,0.00,0,0,0,0,0,0,0,0,0,0,0,0,0
20200520,055867,臺股指元大97購05,,,,,0.00,0.00,0,0,0,0,0,0,0,0,0,0,0,0,0
20200520,055868,臺股指元大97購07,,,,,0.00,0.00,0,0,0,0,0,0,0,0,0,0,0,0,0
20200520,055869,臺股指元大97購08,,,,,0.00,0.00,0,0,0,0,0,0,0,0,0,0,0,0,0
20200520,05586P,臺股指凱基96售15,,,,,0.00,0.00,0,0,0,0,0,0,0,0,0,0,0,0,0
20200520,055870,智原台新97購01,,,,,0.00,0.00,0,0,0,0,0,0,0,0,0,0,0,0,0
20200520,055871,群創台新97購02,,,,,0.00,0.00,0,0,0,0,0,0,0,0,0,0,0,0,0
20200520,055872,亞泥元富97購01,0.57,0.59,0.57,0.59,-0.03,-4.84,44000,4,25660,0,0,0,0,0,0,44000,0,44000,44000
20200520,055873,聚陽元富97購01,0.04,0.04,0.04,0.04,-0.06,-60.0,136000,2,5440,0,0,0,0,0,0,136000,0,136000,136000
20200520,055874,中環元富9A購01,0.59,0.66,0.58,0.60,+0.02,3.45,808000,20,481230,0,0,0,0,0,0,537000,271000,266000,266000
20200520,055875,光罩元富97購02,,,,,0.00,0.00,0,0,0,0,0,0,0,0,0,0,0,0,0
20200520,055876,美食元富9A購01,0.61,0.61,0.56,0.56,+0.01,1.82,31000,16,18860,0,0,0,0,0,0,30000,1000,29000,29000
20200520,055877,奇鋐元富97購01,1.10,1.10,1.10,1.10,+0.07,6.8,27000,1,29700,0,0,0,0,0,0,0,27000,-27000,-27000
20200520,055878,泰碩元富97購02,,,,,0.00,0.00,0,0,0,0,0,0,0,0,0,0,0,0,0
20200520,055879,神達元富97購01,,,,,0.00,0.00,0,0,0,0,0,0,0,0,0,0,0,0,0
20200520,05587P,鴻海凱基96售12,6.00,6.00,6.00,6.00,0.00,0.00,10000,2,60000,0,0,0,0,0,0,10000,0,10000,10000
20200520,055880,神達元富97購02,,,,,0.00,0.00,0,0,0,0,0,0,0,0,0,0,0,0,0
20200520,055881,康控元富97購01,,,,,0.00,0.00,0,0,0,0,0,0,0,0,0,0,0,0,0
20200520,055882,嘉聯益元富97購01,,,,,0.00,0.00,0,0,0,0,0,0,0,0,0,0,0,0,0
20200520,055883,樺漢元富97購01,,,,,0.00,0.00,0,0,0,0,0,0,0,0,0,0,0,0,0
20200520,055884,臺股指元富97購01,,,,,0.00,0.00,0,0,0,0,0,0,0,0,0,0,0,0,0
20200520,055885,大成鋼統一97購02,0.32,0.34,0.32,0.33,+0.07,26.92,694000,10,233910,0,0,0,0,0,0,499000,195000,304000,304000
20200520,055886,上銀統一97購02,,,,,0.00,0.00,0,0,0,0,0,0,0,0,0,0,0,0,0
20200520,055887,上銀統一97購03,0.65,0.65,0.59,0.59,-0.06,-9.23,355000,5,216210,0,0,0,0,0,0,255000,100000,155000,155000
20200520,055888,鴻海統一97購04,,,,,0.00,0.00,0,0,0,0,0,0,0,0,0,0,0,0,0
20200520,055889,鴻海統一97購05,,,,,0.00,0.00,0,0,0,0,0,0,0,0,0,0,0,0,0
20200520,05588P,群創兆豐97售02,,,,,0.00,0.00,0,0,0,0,0,0,0,0,0,0,0,0,0
20200520,055890,鴻海統一99購01,,,,,0.00,0.00,0,0,0,0,0,0,0,0,0,0,0,0,0
20200520,055891,鴻海統一9A購01,0.41,0.42,0.38,0.39,-0.02,-4.88,329000,13,135160,0,0,0,0,0,0,38000,277000,-239000,-239000
20200520,055892,國巨統一99購01,1.23,1.40,1.21,1.25,+0.14,12.61,70000,7,89700,0,0,0,0,0,0,70000,70000,0,0
20200520,055893,大立光統一97購07,0.27,0.27,0.27,0.27,0.00,0.00,50000,1,13500,0,0,0,0,0,0,0,50000,-50000,-50000
20200520,055894,欣興統一97購03,0.22,0.22,0.22,0.22,0.00,0.00,160000,2,35200,0,0,0,0,0,0,0,160000,-160000,-160000
20200520,055895,群創統一97購04,,,,,0.00,0.00,0,0,0,0,0,0,0,0,0,0,0,0,0
20200520,055896,南電統一97購02,1.88,1.98,1.69,1.73,-0.09,-4.95,608000,22,1105620,0,0,0,0,0,0,274000,329000,-55000,-55000
20200520,055897,TXFI0永昌99購01,,,,,0.00,0.00,0,0,0,0,0,0,0,0,0,0,0,0,0
20200520,055898,訊芯第一97購01,,,,,0.00,0.00,0,0,0,0,0,0,0,0,0,0,0,0,0
20200520,055899,群創中信99購01,,,,,0.00,0.00,0,0,0,0,0,0,0,0,0,0,0,0,0
20200520,05589P,大立光中信9A售01,,,,,0.00,0.00,0,0,0,0,0,0,0,0,0,0,0,0,0
20200520,055900,瀚宇博中信97購01,0.03,0.03,0.03,0.03,-0.01,-25.0,30000,3,900,0,0,0,0,0,0,0,30000,-30000,-30000
20200520,055901,超眾中信97購01,,,,,0.00,0.00,0,0,0,0,0,0,0,0,0,0,0,0,0
20200520,055902,同欣電中信99購01,0.38,0.41,0.36,0.36,+0.01,2.86,594000,66,221190,0,0,0,0,0,0,47000,442000,-395000,-395000
20200520,055903,鈺齊中信97購02,,,,,0.00,0.00,0,0,0,0,0,0,0,0,0,0,0,0,0
20200520,055904,貿聯亞東99購01,0.45,0.45,0.45,0.45,0.00,0.00,1000,1,450,0,0,0,0,0,0,0,1000,-1000,-1000
20200520,055905,可成兆豐97購03,0.14,0.14,0.14,0.14,0.00,0.00,10000,1,1400,0,0,0,0,0,0,0,10000,-10000,-10000
20200520,055906,大立光兆豐97購03,0.02,0.02,0.01,0.01,0.00,0.00,20000,3,300,0,0,0,0,0,0,10000,10000,0,0
20200520,055907,台虹兆豐98購01,0.68,0.68,0.68,0.68,0.00,0.00,74000,1,50320,0,0,0,0,0,0,0,74000,-74000,-74000
20200520,055908,GIS日盛97購01,,,,,0.00,0.00,0,0,0,0,0,0,0,0,0,0,0,0,0
20200520,055909,大成鋼凱基98購02,0.60,0.73,0.58,0.73,+0.14,23.73,196000,9,118140,0,0,0,0,0,0,60000,136000,-76000,-76000
20200520,05590P,臺股指中信96售05,0.57,0.57,0.56,0.57,-0.07,-10.94,94000,5,53480,0,0,0,0,0,0,70000,24000,46000,46000
20200520,055910,瑞昱凱基98購01,4.68,4.68,4.68,4.68,+0.17,3.77,10000,1,46800,0,0,0,0,0,0,10000,0,10000,10000
20200520,055911,可成凱基98購02,2.00,2.00,2.00,2.00,0.00,0.00,1000,1,2000,0,0,0,0,0,0,1000,1000,0,0
20200520,055912,宏達電凱基98購03,0.71,0.73,0.71,0.73,+0.05,7.35,52000,3,36960,0,0,0,0,0,0,2000,52000,-50000,-50000
20200520,055913,中信金凱基97購01,,,,,0.00,0.00,0,0,0,0,0,0,0,0,0,0,0,0,0
20200520,055914,大立光凱基97購13,,,,,0.00,0.00,0,0,0,0,0,0,0,0,0,0,0,0,0
20200520,055915,大立光凱基98購07,,,,,0.00,0.00,0,0,0,0,0,0,0,0,0,0,0,0,0
20200520,055916,奇鋐凱基99購01,0.73,0.78,0.72,0.78,+0.06,8.33,293000,10,215850,0,0,0,0,0,0,207000,86000,121000,121000
20200520,055917,禾伸堂凱基98購02,,,,,0.00,0.00,0,0,0,0,0,0,0,0,0,0,0,0,0
20200520,055918,和鑫凱基97購01,,,,,0.00,0.00,0,0,0,0,0,0,0,0,0,0,0,0,0
20200520,055919,景碩凱基98購02,2.83,2.83,2.53,2.53,-0.30,-10.6,54000,2,151320,0,0,0,0,0,0,5000,49000,-44000,-44000
20200520,05591P,義隆群益96售03,,,,,0.00,0.00,0,0,0,0,0,0,0,0,0,0,0,0,0
20200520,055920,智伸科凱基97購02,,,,,0.00,0.00,0,0,0,0,0,0,0,0,0,0,0,0,0
20200520,055921,新唐凱基98購01,,,,,0.00,0.00,0,0,0,0,0,0,0,0,0,0,0,0,0
20200520,055922,台郡凱基98購03,,,,,0.00,0.00,0,0,0,0,0,0,0,0,0,0,0,0,0
20200520,055923,矽力凱基98購01,3.69,4.11,3.55,4.07,-0.04,-0.97,25000,5,98750,0,0,0,0,0,0,4000,21000,-17000,-17000
20200520,055924,深中小群益9B購01,,,,,0.00,0.00,0,0,0,0,0,0,0,0,0,0,0,0,0
20200520,055925,上銀群益97購01,,,,,0.00,0.00,0,0,0,0,0,0,0,0,0,0,0,0,0
20200520,055926,國巨群益98購06,2.14,2.14,2.14,2.14,0.00,0.00,8000,2,17120,0,0,0,0,0,0,0,8000,-8000,-8000
20200520,055927,南亞科群益97購01,,,,,0.00,0.00,0,0,0,0,0,0,0,0,0,0,0,0,0
20200520,055928,南亞科群益97購02,,,,,0.00,0.00,0,0,0,0,0,0,0,0,0,0,0,0,0
20200520,055929,聯發科群益97購05,,,,,0.00,0.00,0,0,0,0,0,0,0,0,0,0,0,0,0
20200520,05592P,可成群益96售03,,,,,0.00,0.00,0,0,0,0,0,0,0,0,0,0,0,0,0
20200520,055930,可成群益98購01,,,,,0.00,0.00,0,0,0,0,0,0,0,0,0,0,0,0,0
20200520,055931,冠德群益97購02,0.30,0.30,0.30,0.30,0.00,0.00,10000,1,3000,0,0,0,0,0,0,10000,0,10000,10000
20200520,055932,玉山金群益99購01,,,,,0.00,0.00,0,0,0,0,0,0,0,0,0,0,0,0,0
20200520,055933,欣興群益98購02,2.37,2.40,2.26,2.26,0.00,0.00,72000,5,170640,0,0,0,0,0,0,54000,18000,36000,36000
20200520,055934,景碩群益98購03,2.43,2.43,2.43,2.43,+0.04,1.67,21000,1,51030,0,0,0,0,0,0,21000,0,21000,21000
20200520,055935,創意群益97購02,0.42,0.42,0.41,0.41,-0.04,-8.89,38000,2,15680,0,0,0,0,0,0,0,38000,-38000,-38000
20200520,055936,彩晶群益98購02,,,,,0.00,0.00,0,0,0,0,0,0,0,0,0,0,0,0,0
20200520,055937,康舒群益97購01,0.22,0.22,0.21,0.21,0.00,0.00,60000,3,12900,0,0,0,0,0,0,0,60000,-60000,-60000
20200520,055938,矽力群益97購01,,,,,0.00,0.00,0,0,0,0,0,0,0,0,0,0,0,0,0
20200520,055939,GIS群益97購01,,,,,0.00,0.00,0,0,0,0,0,0,0,0,0,0,0,0,0
20200520,05593P,鴻海國票97售03,2.24,2.29,2.24,2.29,-0.03,-1.29,22000,4,49730,0,0,0,0,0,0,1000,21000,-20000,-20000
20200520,055940,致新群益98購01,3.18,3.18,3.00,3.00,+0.17,6.01,190000,13,588610,0,0,0,0,0,0,171000,0,171000,171000
20200520,055941,百和群益98購02,,,,,0.00,0.00,0,0,0,0,0,0,0,0,0,0,0,0,0
20200520,055942,臺股指群益9C購01,,,,,0.00,0.00,0,0,0,0,0,0,0,0,0,0,0,0,0
20200520,055943,瑞昱麥證97購01,1.30,1.30,1.30,1.30,-0.17,-11.56,80000,1,104000,80000,0,80000,0,0,0,80000,0,80000,80000
20200520,055944,日月光麥證97購01,,,,,0.00,0.00,0,0,0,0,0,0,0,0,0,0,0,0,0
20200520,055945,上証2X元大97購04,,,,,0.00,0.00,0,0,0,0,0,0,0,0,0,0,0,0,0
20200520,055946,元油反元大97購02,,,,,0.00,0.00,0,0,0,0,0,0,0,0,0,0,0,0,0
20200520,055947,元油反元大98購03,,,,,0.00,0.00,0,0,0,0,0,0,0,0,0,0,0,0,0
20200520,055948,道瓊銀元大98購02,0.13,0.13,0.13,0.13,0.00,0.00,20000,2,2600,0,0,0,0,0,0,20000,0,20000,20000
20200520,055949,亞德客元大97購04,2.65,2.65,2.43,2.43,0.00,0.00,24000,2,61400,0,0,0,0,0,0,10000,14000,-4000,-4000
20200520,05594P,旺宏國票96售04,0.68,0.68,0.68,0.68,-0.03,-4.23,3000,1,2040,0,0,0,0,0,0,0,3000,-3000,-3000
20200520,055950,華新元大97購02,,,,,0.00,0.00,0,0,0,0,0,0,0,0,0,0,0,0,0
20200520,055951,大成鋼元大97購02,,,,,0.00,0.00,0,0,0,0,0,0,0,0,0,0,0,0,0
20200520,055952,上銀元大97購08,,,,,0.00,0.00,0,0,0,0,0,0,0,0,0,0,0,0,0
20200520,055953,上銀元大97購09,,,,,0.00,0.00,0,0,0,0,0,0,0,0,0,0,0,0,0
20200520,055954,南港元大97購02,,,,,0.00,0.00,0,0,0,0,0,0,0,0,0,0,0,0,0
20200520,055955,微星元大97購01,4.40,4.40,4.14,4.14,+0.31,8.09,7000,3,30020,0,0,0,0,0,0,7000,1000,6000,6000
20200520,055956,瑞昱元大97購05,,,,,0.00,0.00,0,0,0,0,0,0,0,0,0,0,0,0,0
20200520,055957,瑞昱元大97購06,0.45,0.45,0.45,0.45,-0.07,-13.46,20000,2,9000,0,0,0,0,0,0,0,20000,-20000,-20000
20200520,055958,台光電元大97購02,1.36,1.36,1.36,1.36,-0.09,-6.21,84000,2,114240,0,0,0,0,0,0,10000,74000,-64000,-64000
20200520,055959,美律元大97購03,,,,,0.00,0.00,0,0,0,0,0,0,0,0,0,0,0,0,0
20200520,05595P,友達統一96售02,,,,,0.00,0.00,0,0,0,0,0,0,0,0,0,0,0,0,0
20200520,055960,義隆元大97購01,1.18,1.30,1.18,1.30,0.00,0.00,156000,4,193160,0,0,0,0,0,0,0,156000,-156000,-156000
20200520,055961,國泰金元大97購01,,,,,0.00,0.00,0,0,0,0,0,0,0,0,0,0,0,0,0
20200520,055962,晶豪科元大97購02,3.52,3.52,3.33,3.33,-0.40,-10.72,44000,4,149960,0,0,0,0,0,0,40000,34000,6000,6000
20200520,055963,欣興元大97購04,1.56,1.66,1.45,1.45,0.00,0.00,212000,10,339480,0,0,0,0,0,0,108000,98000,10000,10000
20200520,055964,正文元大97購02,,,,,0.00,0.00,0,0,0,0,0,0,0,0,0,0,0,0,0
20200520,055965,泰鼎元大97購03,4.47,4.93,4.44,4.93,+0.28,6.02,40000,4,187000,0,0,0,0,0,0,20000,20000,0,0
20200520,055966,茂林元大99購01,0.54,0.70,0.54,0.70,+0.16,29.63,77000,10,49120,0,0,0,0,0,0,25000,56000,-31000,-31000
20200520,055967,臻鼎元大97購01,,,,,0.00,0.00,0,0,0,0,0,0,0,0,0,0,0,0,0
20200520,055968,祥碩元大97購04,,,,,0.00,0.00,0,0,0,0,0,0,0,0,0,0,0,0,0
20200520,055969,彩晶元大99購02,,,,,0.00,0.00,0,0,0,0,0,0,0,0,0,0,0,0,0
20200520,05596P,可成統一96售01,1.75,1.85,1.75,1.85,+0.49,36.03,78000,7,141040,0,0,0,0,0,0,14000,78000,-64000,-64000
20200520,055970,聯茂元大97購04,1.99,1.99,1.92,1.99,-0.11,-5.24,68000,5,133220,0,0,0,0,0,0,68000,0,68000,68000
20200520,055971,矽力元大97購05,,,,,0.00,0.00,0,0,0,0,0,0,0,0,0,0,0,0,0
20200520,055972,GIS元大97購04,,,,,0.00,0.00,0,0,0,0,0,0,0,0,0,0,0,0,0
20200520,055973,亞德客統一97購01,,,,,0.00,0.00,0,0,0,0,0,0,0,0,0,0,0,0,0
20200520,055974,上銀統一97購05,,,,,0.00,0.00,0,0,0,0,0,0,0,0,0,0,0,0,0
20200520,055975,鴻海統一98購05,,,,,0.00,0.00,0,0,0,0,0,0,0,0,0,0,0,0,0
20200520,055976,台積電統一99購03,,,,,0.00,0.00,0,0,0,0,0,0,0,0,0,0,0,0,0
20200520,055977,南亞科統一97購01,,,,,0.00,0.00,0,0,0,0,0,0,0,0,0,0,0,0,0
20200520,055978,大立光統一98購05,,,,,0.00,0.00,0,0,0,0,0,0,0,0,0,0,0,0,0
20200520,055979,聯鈞統一97購03,,,,,0.00,0.00,0,0,0,0,0,0,0,0,0,0,0,0,0
20200520,05597P,鴻海元富96售06,,,,,0.00,0.00,0,0,0,0,0,0,0,0,0,0,0,0,0
20200520,055980,祥碩統一98購01,1.85,2.05,1.85,2.01,+0.21,11.67,61000,4,121320,0,0,0,0,0,0,61000,0,61000,61000
20200520,055981,臺股指統一97購03,,,,,0.00,0.00,0,0,0,0,0,0,0,0,0,0,0,0,0
20200520,055982,T50反1元富97購01,,,,,0.00,0.00,0,0,0,0,0,0,0,0,0,0,0,0,0
20200520,055983,全新元富9A購02,,,,,0.00,0.00,0,0,0,0,0,0,0,0,0,0,0,0,0
20200520,055984,大立光元富97購02,,,,,0.00,0.00,0,0,0,0,0,0,0,0,0,0,0,0,0
20200520,055985,聯鈞元富97購01,,,,,0.00,0.00,0,0,0,0,0,0,0,0,0,0,0,0,0
20200520,055986,祥碩元富97購01,4.66,4.66,4.52,4.52,+0.21,4.87,30000,2,137000,0,0,0,0,0,0,30000,0,30000,30000
20200520,055987,台表科元富97購01,0.65,1.00,0.65,0.98,+0.25,34.25,1612000,44,1227650,0,0,0,0,0,0,493000,1119000,-626000,-626000
20200520,055988,矽力元富97購01,,,,,0.00,0.00,0,0,0,0,0,0,0,0,0,0,0,0,0
20200520,055989,矽力元富9A購01,3.17,3.36,2.96,3.17,-0.33,-9.43,21000,6,65380,0,0,0,0,0,0,0,19000,-19000,-19000
20200520,05598P,國巨元富96售03,0.02,0.02,0.02,0.02,0.00,0.00,50000,1,1000,0,0,0,0,0,0,50000,50000,0,0
20200520,055990,矽創元富97購01,,,,,0.00,0.00,0,0,0,0,0,0,0,0,0,0,0,0,0
20200520,055991,鈺齊元富97購01,0.10,0.10,0.10,0.10,0.00,0.00,50000,1,5000,0,0,0,0,0,0,50000,0,50000,50000
20200520,055992,智原台新97購02,,,,,0.00,0.00,0,0,0,0,0,0,0,0,0,0,0,0,0
20200520,055993,致茂國泰99購01,0.34,0.34,0.34,0.34,0.00,0.00,3000,1,1020,0,0,0,0,0,0,3000,0,3000,3000
20200520,055994,聯發科國泰99購02,2.54,2.57,2.36,2.36,+0.09,3.96,16000,3,40880,0,0,0,0,0,0,15000,14000,1000,1000
20200520,055995,華擎國泰99購01,,,,,0.00,0.00,0,0,0,0,0,0,0,0,0,0,0,0,0
20200520,055996,矽力國泰99購01,,,,,0.00,0.00,0,0,0,0,0,0,0,0,0,0,0,0,0
20200520,055997,矽創國泰99購01,0.36,0.36,0.36,0.36,-0.13,-26.53,2000,1,720,0,0,0,0,0,0,2000,0,2000,2000
20200520,055998,臺股指富邦99購01,,,,,0.00,0.00,0,0,0,0,0,0,0,0,0,0,0,0,0
20200520,055999,電子類富邦99購01,,,,,0.00,0.00,0,0,0,0,0,0,0,0,0,0,0,0,0
20200520,05599P,欣興台新96售01,,,,,0.00,0.00,0,0,0,0,0,0,0,0,0,0,0,0,0
20200520,056000,佳世達永豐97購01,,,,,0.00,0.00,0,0,0,0,0,0,0,0,0,0,0,0,0
20200520,056001,美食永豐97購01,,,,,0.00,0.00,0,0,0,0,0,0,0,0,0,0,0,0,0
20200520,056002,嘉晶永豐97購01,0.39,0.55,0.39,0.52,+0.21,67.74,181000,18,83910,0,0,0,0,0,0,126000,55000,71000,71000
20200520,056003,智伸科永豐97購02,,,,,0.00,0.00,0,0,0,0,0,0,0,0,0,0,0,0,0
20200520,056004,南電永豐97購02,2.47,2.47,2.06,2.06,-0.23,-10.04,180000,8,400800,0,0,0,0,0,0,70000,110000,-40000,-40000
20200520,056005,臺股指永豐97購04,,,,,0.00,0.00,0,0,0,0,0,0,0,0,0,0,0,0,0
20200520,056006,義隆亞東97購01,,,,,0.00,0.00,0,0,0,0,0,0,0,0,0,0,0,0,0
20200520,056007,上銀中信97購02,,,,,0.00,0.00,0,0,0,0,0,0,0,0,0,0,0,0,0
20200520,056008,全新中信9B購01,,,,,0.00,0.00,0,0,0,0,0,0,0,0,0,0,0,0,0
20200520,056009,奇力新中信98購03,,,,,0.00,0.00,0,0,0,0,0,0,0,0,0,0,0,0,0
20200520,05600P,玉晶光台新96售04,,,,,0.00,0.00,0,0,0,0,0,0,0,0,0,0,0,0,0
20200520,056010,力成中信97購01,0.07,0.07,0.07,0.07,0.00,0.00,20000,2,1400,0,0,0,0,0,0,0,20000,-20000,-20000
20200520,056011,矽力中信99購01,1.37,1.37,1.34,1.34,-0.10,-6.94,22000,5,29750,0,0,0,0,0,0,0,22000,-22000,-22000
20200520,056012,勤誠中信99購01,0.19,0.19,0.19,0.19,0.00,0.00,102000,2,19380,0,0,0,0,0,0,100000,2000,98000,98000
20200520,056013,T50反1群益97購01,,,,,0.00,0.00,0,0,0,0,0,0,0,0,0,0,0,0,0
20200520,056014,上銀群益97購02,,,,,0.00,0.00,0,0,0,0,0,0,0,0,0,0,0,0,0
20200520,056015,華通群益99購01,,,,,0.00,0.00,0,0,0,0,0,0,0,0,0,0,0,0,0
20200520,056016,鴻海群益97購06,,,,,0.00,0.00,0,0,0,0,0,0,0,0,0,0,0,0,0
20200520,056017,台積電群益97購04,,,,,0.00,0.00,0,0,0,0,0,0,0,0,0,0,0,0,0
20200520,056018,旺宏群益97購02,,,,,0.00,0.00,0,0,0,0,0,0,0,0,0,0,0,0,0
20200520,056019,燿華群益97購02,,,,,0.00,0.00,0,0,0,0,0,0,0,0,0,0,0,0,0
20200520,05601P,鴻海元大97售04,,,,,0.00,0.00,0,0,0,0,0,0,0,0,0,0,0,0,0
20200520,056020,義隆群益97購01,1.43,1.44,1.43,1.44,-0.07,-4.64,53000,2,75900,0,0,0,0,0,0,11000,42000,-31000,-31000
20200520,056021,興富發群益97購01,1.43,1.43,1.43,1.43,+0.03,2.14,90000,1,128700,0,0,0,0,0,0,90000,0,90000,90000
20200520,056022,新光金群益97購02,,,,,0.00,0.00,0,0,0,0,0,0,0,0,0,0,0,0,0
20200520,056023,晶豪科群益97購01,3.18,3.18,2.83,2.83,-0.40,-12.38,206000,5,594920,0,0,0,0,0,0,156000,100000,56000,56000
20200520,056024,大立光群益97購05,,,,,0.00,0.00,0,0,0,0,0,0,0,0,0,0,0,0,0
20200520,056025,嘉晶群益97購01,1.83,2.81,1.81,2.81,+1.07,61.49,287000,22,638020,0,0,0,0,0,0,92000,195000,-103000,-103000
20200520,056026,智易群益97購01,2.00,2.00,1.95,1.95,-0.04,-2.01,30000,2,59750,0,0,0,0,0,0,30000,0,30000,30000
20200520,056027,樺漢群益97購02,,,,,0.00,0.00,0,0,0,0,0,0,0,0,0,0,0,0,0
20200520,056028,GIS群益97購02,0.60,0.60,0.60,0.60,0.00,0.00,100000,1,60000,0,0,0,0,0,0,0,100000,-100000,-100000
20200520,056029,國巨麥證98購01,1.54,1.54,1.54,1.54,+0.20,14.93,1000,1,1540,0,1000,-1000,0,0,0,0,1000,-1000,-1000
20200520,05602P,國巨元大96售06,0.09,0.10,0.09,0.10,0.00,0.00,192000,2,19150,0,0,0,0,0,0,192000,192000,0,0
20200520,056030,華通日盛97購01,,,,,0.00,0.00,0,0,0,0,0,0,0,0,0,0,0,0,0
20200520,056031,勤誠康和97購02,,,,,0.00,0.00,0,0,0,0,0,0,0,0,0,0,0,0,0
20200520,056032,勤誠康和97購03,,,,,0.00,0.00,0,0,0,0,0,0,0,0,0,0,0,0,0
20200520,056033,T50正2凱基99購02,0.31,0.31,0.31,0.31,0.00,0.00,20000,1,6200,0,0,0,0,0,0,20000,0,20000,20000
20200520,056034,華通凱基98購01,,,,,0.00,0.00,0,0,0,0,0,0,0,0,0,0,0,0,0
20200520,056035,鴻海凱基97購06,,,,,0.00,0.00,0,0,0,0,0,0,0,0,0,0,0,0,0
20200520,056036,鴻海凱基97購07,,,,,0.00,0.00,0,0,0,0,0,0,0,0,0,0,0,0,0
20200520,056037,美律凱基98購03,,,,,0.00,0.00,0,0,0,0,0,0,0,0,0,0,0,0,0
20200520,056038,可成凱基97購01,0.93,0.93,0.93,0.93,-0.30,-24.39,25000,2,23250,0,0,0,0,0,0,0,25000,-25000,-25000
20200520,056039,宏達電凱基97購02,0.16,0.16,0.16,0.16,0.00,0.00,100000,2,16000,0,0,0,0,0,0,100000,100000,0,0
20200520,05603P,聯發科元大96售09,,,,,0.00,0.00,0,0,0,0,0,0,0,0,0,0,0,0,0
20200520,056040,亞光凱基98購01,,,,,0.00,0.00,0,0,0,0,0,0,0,0,0,0,0,0,0
20200520,056041,禾伸堂凱基98購03,,,,,0.00,0.00,0,0,0,0,0,0,0,0,0,0,0,0,0
20200520,056042,京鼎凱基97購02,,,,,0.00,0.00,0,0,0,0,0,0,0,0,0,0,0,0,0
20200520,056043,力成凱基97購01,,,,,0.00,0.00,0,0,0,0,0,0,0,0,0,0,0,0,0
20200520,056044,同欣電凱基97購03,0.46,0.53,0.46,0.48,+0.01,2.13,59000,5,29170,0,0,0,0,0,0,5000,54000,-49000,-49000
20200520,056045,勤誠凱基97購01,,,,,0.00,0.00,0,0,0,0,0,0,0,0,0,0,0,0,0
20200520,056046,百和凱基97購01,,,,,0.00,0.00,0,0,0,0,0,0,0,0,0,0,0,0,0
20200520,056047,台積電兆豐97購02,,,,,0.00,0.00,0,0,0,0,0,0,0,0,0,0,0,0,0
20200520,056048,同欣電兆豐97購01,,,,,0.00,0.00,0,0,0,0,0,0,0,0,0,0,0,0,0
20200520,056049,奇力新國票98購01,0.45,0.47,0.45,0.45,0.00,0.00,145000,4,67180,0,0,0,0,0,0,13000,132000,-119000,-119000
20200520,05604P,聯發科元大96售10,,,,,0.00,0.00,0,0,0,0,0,0,0,0,0,0,0,0,0
20200520,056050,晶技國票98購01,,,,,0.00,0.00,0,0,0,0,0,0,0,0,0,0,0,0,0
20200520,056051,T50反1元大97購05,,,,,0.00,0.00,0,0,0,0,0,0,0,0,0,0,0,0,0
20200520,056052,T50反1元大97購06,1.03,1.03,0.99,0.99,-0.01,-1.0,80000,8,80000,0,0,0,0,0,0,0,80000,-80000,-80000
20200520,056053,和大元大97購05,,,,,0.00,0.00,0,0,0,0,0,0,0,0,0,0,0,0,0
20200520,056054,亞德客元大97購05,2.71,2.71,2.69,2.69,0.00,0.00,74000,3,200060,0,0,0,0,0,0,0,74000,-74000,-74000
20200520,056055,國巨元大97購15,,,,,0.00,0.00,0,0,0,0,0,0,0,0,0,0,0,0,0
20200520,056056,旺宏元大97購06,,,,,0.00,0.00,0,0,0,0,0,0,0,0,0,0,0,0,0
20200520,056057,華邦電元大97購05,,,,,0.00,0.00,0,0,0,0,0,0,0,0,0,0,0,0,0
20200520,056058,建準元大97購02,2.51,2.51,2.00,2.33,-0.18,-7.17,255000,31,553720,0,0,0,0,0,0,197000,153000,44000,44000
20200520,056059,美律元大98購02,0.12,0.12,0.12,0.12,0.00,0.00,10000,1,1200,0,0,0,0,0,0,0,0,0,0
20200520,05605P,嘉聯益元大97售02,,,,,0.00,0.00,0,0,0,0,0,0,0,0,0,0,0,0,0
20200520,056060,宏達電元大99購01,0.12,0.12,0.12,0.12,0.00,0.00,20000,1,2400,0,0,0,0,0,0,0,0,0,0
20200520,056061,國泰金元大97購02,0.41,0.41,0.41,0.41,0.00,0.00,18000,1,7380,0,0,0,0,0,0,18000,0,18000,18000
20200520,056062,大立光元大97購12,,,,,0.00,0.00,0,0,0,0,0,0,0,0,0,0,0,0,0
20200520,056063,大立光元大97購13,,,,,0.00,0.00,0,0,0,0,0,0,0,0,0,0,0,0,0
20200520,056064,大立光元大97購14,,,,,0.00,0.00,0,0,0,0,0,0,0,0,0,0,0,0,0
20200520,056065,奇鋐元大97購01,1.82,1.92,1.82,1.92,+0.07,3.78,85000,9,159270,0,0,0,0,0,0,0,85000,-85000,-85000
20200520,056066,奇鋐元大98購02,0.41,0.43,0.41,0.42,0.00,0.00,500000,4,212000,0,0,0,0,0,0,500000,0,500000,500000
20200520,056067,智原元大97購01,0.42,0.42,0.42,0.42,0.00,0.00,150000,1,63000,0,0,0,0,0,0,0,150000,-150000,-150000
20200520,056068,欣興元大97購05,,,,,0.00,0.00,0,0,0,0,0,0,0,0,0,0,0,0,0
20200520,056069,新日興元大97購03,,,,,0.00,0.00,0,0,0,0,0,0,0,0,0,0,0,0,0
20200520,05606P,TPK國票97售02,2.42,2.42,2.42,2.42,-0.26,-9.7,2000,1,4840,0,0,0,0,0,0,0,2000,-2000,-2000
20200520,056070,新日興元大97購04,,,,,0.00,0.00,0,0,0,0,0,0,0,0,0,0,0,0,0
20200520,056071,創意元大97購02,,,,,0.00,0.00,0,0,0,0,0,0,0,0,0,0,0,0,0
20200520,056072,群創元大97購01,,,,,0.00,0.00,0,0,0,0,0,0,0,0,0,0,0,0,0
20200520,056073,智伸科元大97購01,,,,,0.00,0.00,0,0,0,0,0,0,0,0,0,0,0,0,0
20200520,056074,茂林元大97購04,,,,,0.00,0.00,0,0,0,0,0,0,0,0,0,0,0,0,0
20200520,056075,瀚宇博元大97購03,1.23,1.23,1.18,1.20,-0.08,-6.25,15000,5,18180,0,0,0,0,0,0,15000,15000,0,0
20200520,056076,超眾元大97購05,2.15,2.15,2.15,2.15,-0.05,-2.27,21000,1,45150,0,0,0,0,0,0,0,21000,-21000,-21000
20200520,056077,矽力元大97購07,3.49,3.73,3.31,3.66,-0.18,-4.69,141000,10,509390,0,3000,-3000,0,0,0,3000,138000,-135000,-138000
20200520,056078,勤誠元大97購01,,,,,0.00,0.00,0,0,0,0,0,0,0,0,0,0,0,0,0
20200520,056079,世紀鋼元大97購02,2.48,2.48,2.13,2.16,-0.24,-10.0,9000,4,20980,0,0,0,0,0,0,7000,2000,5000,5000
20200520,05607P,華通日盛96售01,,,,,0.00,0.00,0,0,0,0,0,0,0,0,0,0,0,0,0
20200520,056080,世紀鋼元大97購03,,,,,0.00,0.00,0,0,0,0,0,0,0,0,0,0,0,0,0
20200520,056081,T50反1統一99購02,,,,,0.00,0.00,0,0,0,0,0,0,0,0,0,0,0,0,0
20200520,056082,旺宏統一99購02,,,,,0.00,0.00,0,0,0,0,0,0,0,0,0,0,0,0,0
20200520,056083,億光統一97購03,0.75,0.90,0.75,0.84,+0.02,2.44,364000,14,298130,0,0,0,0,0,0,0,364000,-364000,-364000
20200520,056084,漢唐統一97購03,1.49,1.49,1.49,1.49,-0.13,-8.02,51000,2,75990,0,0,0,0,0,0,51000,0,51000,51000
20200520,056085,聯發科統一97購01,4.69,4.86,4.69,4.86,+0.43,9.71,22000,2,103690,0,0,0,0,0,0,19000,3000,16000,16000
20200520,056086,奇力新統一98購01,,,,,0.00,0.00,0,0,0,0,0,0,0,0,0,0,0,0,0
20200520,056087,世芯統一97購01,1.21,1.22,1.01,1.07,-0.21,-16.41,133000,23,152900,0,0,0,0,0,0,31000,92000,-61000,-61000
20200520,056088,台郡統一97購02,,,,,0.00,0.00,0,0,0,0,0,0,0,0,0,0,0,0,0
20200520,056089,同欣電統一98購01,,,,,0.00,0.00,0,0,0,0,0,0,0,0,0,0,0,0,0
20200520,05608P,聯發科凱基96售10,,,,,0.00,0.00,0,0,0,0,0,0,0,0,0,0,0,0,0
20200520,056090,康舒統一97購01,,,,,0.00,0.00,0,0,0,0,0,0,0,0,0,0,0,0,0
20200520,056091,百和統一97購01,0.42,0.42,0.42,0.42,+0.01,2.44,20000,1,8400,0,0,0,0,0,0,20000,0,20000,20000
20200520,056092,亞德客元富97購02,,,,,0.00,0.00,0,0,0,0,0,0,0,0,0,0,0,0,0
20200520,056093,大毅元富97購01,,,,,0.00,0.00,0,0,0,0,0,0,0,0,0,0,0,0,0
20200520,056094,大立光元富97購03,0.46,0.53,0.46,0.51,+0.05,10.87,35000,5,17430,0,0,0,0,0,0,25000,10000,15000,15000
20200520,056095,臻鼎元富9A購01,0.42,0.42,0.42,0.42,0.00,0.00,10000,1,4200,0,10000,-10000,0,0,0,10000,0,10000,0
20200520,056096,超眾元富9A購01,,,,,0.00,0.00,0,0,0,0,0,0,0,0,0,0,0,0,0
20200520,056097,訊芯元富97購02,,,,,0.00,0.00,0,0,0,0,0,0,0,0,0,0,0,0,0
20200520,056098,矽創元富97購02,0.55,0.56,0.45,0.45,-0.09,-16.67,624000,41,318550,0,0,0,0,0,0,559000,65000,494000,494000
20200520,056099,上銀永豐97購02,0.01,0.05,0.01,0.05,0.00,0.00,1330000,17,13340,0,0,0,0,0,0,846000,0,846000,846000
20200520,05609P,國泰金凱基96售01,,,,,0.00,0.00,0,0,0,0,0,0,0,0,0,0,0,0,0
20200520,056100,楠梓電永豐97購02,,,,,0.00,0.00,0,0,0,0,0,0,0,0,0,0,0,0,0
20200520,056101,光磊永豐98購01,0.63,0.67,0.62,0.67,0.00,0.00,143000,3,92830,0,0,0,0,0,0,0,143000,-143000,-143000
20200520,056102,億光永豐97購02,,,,,0.00,0.00,0,0,0,0,0,0,0,0,0,0,0,0,0
20200520,056103,聯發科永豐97購03,3.06,3.06,3.06,3.06,+0.38,14.18,1000,1,3060,0,0,0,0,0,0,0,1000,-1000,-1000
20200520,056104,義隆永豐97購01,,,,,0.00,0.00,0,0,0,0,0,0,0,0,0,0,0,0,0
20200520,056105,智原永豐97購01,,,,,0.00,0.00,0,0,0,0,0,0,0,0,0,0,0,0,0
20200520,056106,晶相光永豐97購02,,,,,0.00,0.00,0,0,0,0,0,0,0,0,0,0,0,0,0
20200520,056107,智易永豐97購02,1.56,1.57,1.54,1.57,+0.01,0.64,140000,6,217670,0,0,0,0,0,0,80000,60000,20000,20000
20200520,056108,麗豐永豐97購01,,,,,0.00,0.00,0,0,0,0,0,0,0,0,0,0,0,0,0
20200520,056109,彩晶永豐98購01,,,,,0.00,0.00,0,0,0,0,0,0,0,0,0,0,0,0,0
20200520,05610P,國巨群益98售01,,,,,0.00,0.00,0,0,0,0,0,0,0,0,0,0,0,0,0
20200520,056110,嘉聯益永豐97購02,,,,,0.00,0.00,0,0,0,0,0,0,0,0,0,0,0,0,0
20200520,056111,力成永豐97購01,,,,,0.00,0.00,0,0,0,0,0,0,0,0,0,0,0,0,0
20200520,056112,勤誠永豐97購02,0.04,0.04,0.04,0.04,0.00,0.00,8000,1,320,0,0,0,0,0,0,0,8000,-8000,-8000
20200520,056113,新日興兆豐98購01,0.59,0.71,0.59,0.71,0.00,0.00,172000,4,114600,0,0,0,0,0,0,0,172000,-172000,-172000
20200520,056114,台達電群益97購02,1.03,1.03,0.97,0.97,-0.06,-5.83,159000,10,157860,0,0,0,0,0,0,159000,0,159000,159000
20200520,056115,奇力新群益97購06,,,,,0.00,0.00,0,0,0,0,0,0,0,0,0,0,0,0,0
20200520,056116,義隆群益97購02,,,,,0.00,0.00,0,0,0,0,0,0,0,0,0,0,0,0,0
20200520,056117,宏達電群益97購02,,,,,0.00,0.00,0,0,0,0,0,0,0,0,0,0,0,0,0
20200520,056118,聯詠群益97購03,,,,,0.00,0.00,0,0,0,0,0,0,0,0,0,0,0,0,0
20200520,056119,欣興群益97購02,1.03,1.04,0.92,0.92,0.00,0.00,515000,52,533640,0,0,0,0,0,0,0,515000,-515000,-515000
20200520,05611P,康控群益96售02,,,,,0.00,0.00,0,0,0,0,0,0,0,0,0,0,0,0,0
20200520,056120,聯茂群益97購02,,,,,0.00,0.00,0,0,0,0,0,0,0,0,0,0,0,0,0
20200520,056121,勤誠群益97購01,0.67,0.68,0.67,0.68,-0.01,-1.45,40000,2,26990,0,0,0,0,0,0,40000,0,40000,40000
20200520,056122,勤誠群益97購02,,,,,0.00,0.00,0,0,0,0,0,0,0,0,0,0,0,0,0
20200520,056123,鈺齊群益97購01,,,,,0.00,0.00,0,0,0,0,0,0,0,0,0,0,0,0,0
20200520,056124,華通國票98購02,1.68,1.68,1.68,1.68,0.00,0.00,18000,1,30240,0,0,0,0,0,0,0,18000,-18000,-18000
20200520,056125,旺宏國票98購02,,,,,0.00,0.00,0,0,0,0,0,0,0,0,0,0,0,0,0
20200520,056126,台郡國票98購02,1.91,1.97,1.91,1.95,+0.01,0.52,81000,5,157670,0,0,0,0,0,0,12000,69000,-57000,-57000
20200520,056127,致新國票98購02,2.07,2.07,1.91,1.97,+0.13,7.07,1030000,62,2074950,0,0,0,0,0,0,708000,102000,606000,606000
20200520,056128,和大中信99購01,,,,,0.00,0.00,0,0,0,0,0,0,0,0,0,0,0,0,0
20200520,056129,義隆麥證97購01,0.83,0.83,0.83,0.83,0.00,0.00,5000,1,4150,5000,0,5000,0,0,0,5000,0,5000,5000
20200520,05612P,台積電元大96售13,,,,,0.00,0.00,0,0,0,0,0,0,0,0,0,0,0,0,0
20200520,056130,新日興麥證97購01,0.13,0.13,0.13,0.13,+0.01,8.33,165000,3,21450,0,165000,-165000,0,0,0,0,165000,-165000,-165000
20200520,056131,鴻海元大97購12,,,,,0.00,0.00,0,0,0,0,0,0,0,0,0,0,0,0,0
20200520,056132,台光電元大97購03,3.37,3.37,3.32,3.37,-0.04,-1.17,116000,8,387370,0,0,0,0,0,0,72000,44000,28000,28000
20200520,056133,可成元大97購05,1.46,1.46,1.46,1.46,-0.15,-9.32,23000,1,33580,0,0,0,0,0,0,0,23000,-23000,-23000
20200520,056134,可成元大97購06,,,,,0.00,0.00,0,0,0,0,0,0,0,0,0,0,0,0,0
20200520,056135,緯創元大98購01,4.31,4.31,4.25,4.25,+0.02,0.47,165000,10,703350,0,0,0,0,0,0,135000,30000,105000,105000
20200520,056136,京鼎元大98購01,0.70,0.70,0.70,0.70,0.00,0.00,69000,1,48300,0,0,0,0,0,0,0,69000,-69000,-69000
20200520,056137,聯鈞元大9A購01,,,,,0.00,0.00,0,0,0,0,0,0,0,0,0,0,0,0,0
20200520,056138,群創元大9B購01,,,,,0.00,0.00,0,0,0,0,0,0,0,0,0,0,0,0,0
20200520,056139,貿聯元大97購04,0.90,0.93,0.90,0.90,0.00,0.00,155000,8,141840,0,0,0,0,0,0,87000,68000,19000,19000
20200520,05613P,臻鼎台新96售01,,,,,0.00,0.00,0,0,0,0,0,0,0,0,0,0,0,0,0
20200520,056140,康控元大98購01,0.20,0.20,0.20,0.20,0.00,0.00,95000,1,19000,0,0,0,0,0,0,95000,0,95000,95000
20200520,056141,聯茂元大97購05,1.67,1.67,1.58,1.58,-0.17,-9.71,120000,9,194900,0,0,0,0,0,0,110000,10000,100000,100000
20200520,056142,超眾元大97購06,0.89,0.92,0.88,0.88,-0.02,-2.22,23000,3,20430,0,0,0,0,0,0,16000,7000,9000,9000
20200520,056143,訊芯元大97購04,0.36,0.36,0.35,0.35,+0.06,20.69,73000,4,26230,0,0,0,0,0,0,0,73000,-73000,-73000
20200520,056144,GIS元大98購01,1.43,1.45,1.43,1.45,+0.01,0.69,122000,3,176860,0,0,0,0,0,0,22000,100000,-78000,-78000
20200520,056145,緯穎元大98購03,2.16,2.17,1.99,1.99,-0.31,-13.48,20000,3,41560,0,0,0,0,0,0,10000,20000,-10000,-10000
20200520,056146,台虹元大98購01,1.45,1.45,1.45,1.45,-0.04,-2.68,100000,1,145000,0,0,0,0,0,0,0,100000,-100000,-100000
20200520,056147,鴻海日盛97購05,,,,,0.00,0.00,0,0,0,0,0,0,0,0,0,0,0,0,0
20200520,056148,臺股指日盛97購03,,,,,0.00,0.00,0,0,0,0,0,0,0,0,0,0,0,0,0
20200520,056149,亞光康和97購01,,,,,0.00,0.00,0,0,0,0,0,0,0,0,0,0,0,0,0
20200520,05614P,臺股指康和96售03,,,,,0.00,0.00,0,0,0,0,0,0,0,0,0,0,0,0,0
20200520,056150,台光電凱基98購02,1.82,1.82,1.82,1.82,-0.14,-7.14,30000,12,54600,0,0,0,0,0,0,30000,0,30000,30000
20200520,056151,建準凱基97購01,2.55,2.56,2.36,2.47,-0.17,-6.44,260000,20,633600,0,0,0,0,0,0,260000,0,260000,260000
20200520,056152,可成凱基97購02,,,,,0.00,0.00,0,0,0,0,0,0,0,0,0,0,0,0,0
20200520,056153,華新科凱基97購02,1.37,1.50,1.37,1.50,+0.06,4.17,164000,4,238780,0,0,0,0,0,0,164000,0,164000,164000
20200520,056154,宏達電凱基97購03,,,,,0.00,0.00,0,0,0,0,0,0,0,0,0,0,0,0,0
20200520,056155,嘉晶凱基97購01,0.83,1.05,0.83,1.05,0.00,0.00,30000,4,28300,0,0,0,0,0,0,10000,0,10000,10000
20200520,056156,禾伸堂凱基98購04,2.75,2.75,2.75,2.75,+0.06,2.23,35000,1,96250,0,0,0,0,0,0,35000,0,35000,35000
20200520,056157,聯詠凱基97購03,,,,,0.00,0.00,0,0,0,0,0,0,0,0,0,0,0,0,0
20200520,056158,新日興凱基98購02,,,,,0.00,0.00,0,0,0,0,0,0,0,0,0,0,0,0,0
20200520,056159,牧德凱基99購01,,,,,0.00,0.00,0,0,0,0,0,0,0,0,0,0,0,0,0
20200520,05615P,臺股指康和96售04,2.16,2.16,2.10,2.15,-0.06,-2.71,30000,8,63600,0,0,0,0,0,0,3000,27000,-24000,-24000
20200520,056160,智易凱基97購03,,,,,0.00,0.00,0,0,0,0,0,0,0,0,0,0,0,0,0
20200520,056161,康控凱基98購02,,,,,0.00,0.00,0,0,0,0,0,0,0,0,0,0,0,0,0
20200520,056162,祥碩凱基97購03,6.60,7.45,6.60,7.35,+1.20,19.51,20000,7,137350,0,0,0,0,0,0,17000,3000,14000,14000
20200520,056163,嘉聯益凱基98購03,,,,,0.00,0.00,0,0,0,0,0,0,0,0,0,0,0,0,0
20200520,056164,聯茂凱基98購03,3.11,3.11,3.11,3.11,-0.15,-4.6,28000,2,87080,0,0,0,0,0,0,28000,0,28000,28000
20200520,056165,矽力凱基98購02,1.50,1.50,1.50,1.50,-0.29,-16.2,5000,1,7500,0,0,0,0,0,0,5000,0,5000,5000
20200520,056166,微星台新97購01,1.64,1.68,1.64,1.64,+0.08,5.13,52000,5,86110,0,0,0,0,0,0,8000,44000,-36000,-36000
20200520,056167,力成台新97購01,,,,,0.00,0.00,0,0,0,0,0,0,0,0,0,0,0,0,0
20200520,056168,鴻海元富97購07,1.30,1.30,1.24,1.24,-0.07,-5.34,30000,3,38000,0,0,0,0,0,0,20000,10000,10000,10000
20200520,056169,鴻海元富97購08,1.11,1.11,1.08,1.08,-0.07,-6.09,11000,5,12090,0,0,0,0,0,0,4000,7000,-3000,-3000
20200520,05616P,台光電永豐96售01,,,,,0.00,0.00,0,0,0,0,0,0,0,0,0,0,0,0,0
20200520,056170,鴻海元富97購09,,,,,0.00,0.00,0,0,0,0,0,0,0,0,0,0,0,0,0
20200520,056171,鴻海元富97購10,,,,,0.00,0.00,0,0,0,0,0,0,0,0,0,0,0,0,0
20200520,056172,鴻海元富97購11,,,,,0.00,0.00,0,0,0,0,0,0,0,0,0,0,0,0,0
20200520,056173,廣達元富97購01,1.32,1.32,1.23,1.23,-0.09,-6.82,23000,4,29460,0,0,0,0,0,0,0,3000,-3000,-3000
20200520,056174,億光元富97購01,0.79,0.82,0.76,0.76,0.00,0.00,118000,4,93370,0,0,0,0,0,0,0,118000,-118000,-118000
20200520,056175,可成元富97購03,1.57,1.57,1.57,1.57,-0.29,-15.59,1000,1,1570,0,0,0,0,0,0,1000,0,1000,1000
20200520,056176,創意元富97購01,0.46,0.46,0.46,0.46,0.00,0.00,20000,2,9200,0,0,0,0,0,0,20000,20000,0,0
20200520,056177,嘉澤元富97購01,2.89,2.92,2.85,2.85,+0.05,1.79,148000,9,426360,0,0,0,0,0,0,78000,70000,8000,8000
20200520,056178,嘉澤元富97購02,3.05,3.09,2.97,2.97,-0.02,-0.67,194000,8,586890,0,0,0,0,0,0,62000,132000,-70000,-70000
20200520,056179,康友元富97購02,,,,,0.00,0.00,0,0,0,0,0,0,0,0,0,0,0,0,0
20200520,05617P,大立光統一97售02,,,,,0.00,0.00,0,0,0,0,0,0,0,0,0,0,0,0,0
20200520,056180,南茂元富97購01,,,,,0.00,0.00,0,0,0,0,0,0,0,0,0,0,0,0,0
20200520,056181,百和元富97購02,,,,,0.00,0.00,0,0,0,0,0,0,0,0,0,0,0,0,0
20200520,056182,台光電統一97購03,1.13,1.16,1.10,1.16,0.00,0.00,117000,22,132250,0,0,0,0,0,0,77000,40000,37000,37000
20200520,056183,南亞科統一97購02,,,,,0.00,0.00,0,0,0,0,0,0,0,0,0,0,0,0,0
20200520,056184,南亞科統一97購03,0.30,0.31,0.30,0.31,+0.03,10.71,70000,2,21200,0,0,0,0,0,0,0,70000,-70000,-70000
20200520,056185,全新統一98購01,,,,,0.00,0.00,0,0,0,0,0,0,0,0,0,0,0,0,0
20200520,056186,智原統一97購01,0.26,0.27,0.26,0.27,-0.01,-3.57,150000,26,39180,0,0,0,0,0,0,150000,0,150000,150000
20200520,056187,京鼎統一97購01,,,,,0.00,0.00,0,0,0,0,0,0,0,0,0,0,0,0,0
20200520,056188,晶相光統一99購01,,,,,0.00,0.00,0,0,0,0,0,0,0,0,0,0,0,0,0
20200520,056189,樺漢統一97購02,0.68,0.71,0.67,0.67,+0.01,1.52,351000,7,245230,0,0,0,0,0,0,227000,124000,103000,103000
20200520,05618P,聯發科元富96售02,,,,,0.00,0.00,0,0,0,0,0,0,0,0,0,0,0,0,0
20200520,056190,昇陽半統一97購01,,,,,0.00,0.00,0,0,0,0,0,0,0,0,0,0,0,0,0
20200520,056191,世紀鋼統一97購01,2.95,2.95,2.95,2.95,-0.14,-4.53,3000,1,8850,0,0,0,0,0,0,0,3000,-3000,-3000
20200520,056192,智邦富邦98購01,1.05,1.05,1.05,1.05,-0.01,-0.94,22000,3,23100,0,0,0,0,0,0,22000,0,22000,22000
20200520,056193,聯發科富邦99購08,1.93,1.93,1.81,1.82,+0.03,1.68,173000,11,322430,0,0,0,0,0,0,173000,167000,6000,6000
20200520,056194,聯發科富邦9B購01,2.80,2.80,2.80,2.80,+0.20,7.69,1000,1,2800,0,0,0,0,0,0,1000,0,1000,1000
20200520,056195,群創富邦98購01,,,,,0.00,0.00,0,0,0,0,0,0,0,0,0,0,0,0,0
20200520,056196,聯茂富邦98購02,0.49,0.49,0.46,0.48,-0.03,-5.88,500000,43,238380,0,0,0,0,0,0,500000,300000,200000,200000
20200520,056197,友訊永豐97購01,0.14,0.14,0.14,0.14,0.00,0.00,80000,3,11200,0,0,0,0,0,0,60000,20000,40000,40000
20200520,056198,台光電永豐97購02,0.84,0.86,0.84,0.86,-0.06,-6.52,290000,5,248600,0,0,0,0,0,0,287000,3000,284000,284000
20200520,056199,美律永豐97購01,,,,,0.00,0.00,0,0,0,0,0,0,0,0,0,0,0,0,0
20200520,05619P,創意元富96售02,,,,,0.00,0.00,0,0,0,0,0,0,0,0,0,0,0,0,0
20200520,056200,大毅永豐98購01,1.05,1.08,1.05,1.08,+0.04,3.85,14000,3,15000,0,0,0,0,0,0,10000,4000,6000,6000
20200520,056201,華新科永豐98購01,,,,,0.00,0.00,0,0,0,0,0,0,0,0,0,0,0,0,0
20200520,056202,國揚永豐97購01,,,,,0.00,0.00,0,0,0,0,0,0,0,0,0,0,0,0,0
20200520,056203,興富發永豐97購01,1.38,1.38,1.33,1.33,-0.07,-5.0,79000,2,108470,0,0,0,0,0,0,11000,68000,-57000,-57000
20200520,056204,嘉澤永豐97購01,0.65,0.65,0.62,0.62,-0.02,-3.12,20000,3,12700,0,0,0,0,0,0,20000,0,20000,20000
20200520,056205,貿聯永豐97購01,,,,,0.00,0.00,0,0,0,0,0,0,0,0,0,0,0,0,0
20200520,056206,泰鼎永豐97購01,,,,,0.00,0.00,0,0,0,0,0,0,0,0,0,0,0,0,0
20200520,056207,茂林永豐97購03,0.16,0.16,0.16,0.16,0.00,0.00,50000,5,8000,0,0,0,0,0,0,0,50000,-50000,-50000
20200520,056208,崇越永豐97購01,,,,,0.00,0.00,0,0,0,0,0,0,0,0,0,0,0,0,0
20200520,056209,超眾永豐97購02,0.86,0.91,0.84,0.85,-0.03,-3.41,106000,5,94910,0,0,0,0,0,0,10000,96000,-86000,-86000
20200520,05620P,大立光富邦9B售01,,,,,0.00,0.00,0,0,0,0,0,0,0,0,0,0,0,0,0
20200520,056210,矽創永豐97購02,0.31,0.32,0.28,0.28,-0.04,-12.5,70000,8,20650,0,0,0,0,0,0,30000,70000,-40000,-40000
20200520,056211,南港國票98購01,0.34,0.37,0.34,0.37,+0.04,12.12,510000,3,175200,0,0,0,0,0,0,450000,60000,390000,390000
20200520,056212,台光電國票98購03,3.40,3.40,3.37,3.39,-0.21,-5.83,44000,5,149320,0,0,0,0,0,0,37000,7000,30000,30000
20200520,056213,建準國票98購02,3.60,3.72,3.44,3.72,-0.19,-4.86,293000,11,1045880,0,0,0,0,0,0,277000,16000,261000,261000
20200520,056214,義隆國票99購01,1.83,1.84,1.83,1.84,-0.03,-1.6,32000,2,58720,0,0,0,0,0,0,0,32000,-32000,-32000
20200520,056215,華新科國票97購03,0.49,0.52,0.49,0.52,0.00,0.00,154000,5,77000,0,0,0,0,0,0,100000,54000,46000,46000
20200520,056216,智原第一97購01,,,,,0.00,0.00,0,0,0,0,0,0,0,0,0,0,0,0,0
20200520,056217,A50正2中信99購02,0.53,0.53,0.53,0.53,0.00,0.00,50000,1,26500,0,0,0,0,0,0,0,50000,-50000,-50000
20200520,056218,億光中信98購01,,,,,0.00,0.00,0,0,0,0,0,0,0,0,0,0,0,0,0
20200520,056219,T50反1日盛02購01,1.15,1.15,1.15,1.15,-0.15,-11.54,1000,1,1150,0,0,0,0,0,0,0,0,0,0
20200520,05621P,聯電中信96售01,1.02,1.02,1.02,1.02,0.00,0.00,10000,1,10200,0,0,0,0,0,0,0,10000,-10000,-10000
20200520,056220,上証2X凱基99購01,,,,,0.00,0.00,0,0,0,0,0,0,0,0,0,0,0,0,0
20200520,056221,鴻海凱基99購01,,,,,0.00,0.00,0,0,0,0,0,0,0,0,0,0,0,0,0
20200520,056222,台積電凱基9A購01,,,,,0.00,0.00,0,0,0,0,0,0,0,0,0,0,0,0,0
20200520,056223,華邦電凱基97購04,,,,,0.00,0.00,0,0,0,0,0,0,0,0,0,0,0,0,0
20200520,056224,聯發科凱基97購08,4.80,4.80,4.52,4.52,+0.22,5.12,10000,2,46600,0,0,0,0,0,0,10000,0,10000,10000
20200520,056225,聯發科凱基97購09,,,,,0.00,0.00,0,0,0,0,0,0,0,0,0,0,0,0,0
20200520,056226,聯發科凱基97購10,,,,,0.00,0.00,0,0,0,0,0,0,0,0,0,0,0,0,0
20200520,056227,奇力新凱基98購04,,,,,0.00,0.00,0,0,0,0,0,0,0,0,0,0,0,0,0
20200520,056228,可成凱基97購03,,,,,0.00,0.00,0,0,0,0,0,0,0,0,0,0,0,0,0
20200520,056229,可成凱基97購04,,,,,0.00,0.00,0,0,0,0,0,0,0,0,0,0,0,0,0
20200520,05622P,台積電中信96售02,,,,,0.00,0.00,0,0,0,0,0,0,0,0,0,0,0,0,0
20200520,056230,可成凱基98購03,1.12,1.12,1.12,1.12,-0.36,-24.32,1000,1,1120,0,0,0,0,0,0,1000,0,1000,1000
20200520,056231,嘉聯益凱基97購02,0.68,0.72,0.68,0.72,+0.03,4.35,80000,3,56500,0,0,0,0,0,0,60000,20000,40000,40000
20200520,056232,瑞儀凱基98購01,0.17,0.17,0.17,0.17,+0.01,6.25,50000,1,8500,0,0,0,0,0,0,0,50000,-50000,-50000
20200520,056233,超眾凱基97購02,,,,,0.00,0.00,0,0,0,0,0,0,0,0,0,0,0,0,0
20200520,056234,GIS麥證97購01,,,,,0.00,0.00,0,0,0,0,0,0,0,0,0,0,0,0,0
20200520,056235,鴻海群益97購07,,,,,0.00,0.00,0,0,0,0,0,0,0,0,0,0,0,0,0
20200520,056236,台積電群益97購06,,,,,0.00,0.00,0,0,0,0,0,0,0,0,0,0,0,0,0
20200520,056237,智邦群益97購02,5.60,5.60,5.60,5.60,-0.10,-1.75,23000,3,128800,0,0,0,0,0,0,23000,0,23000,23000
20200520,056238,聯發科群益98購02,,,,,0.00,0.00,0,0,0,0,0,0,0,0,0,0,0,0,0
20200520,056239,宏達電群益98購01,0.71,0.71,0.71,0.71,0.00,0.00,2000,2,1420,0,0,0,0,0,0,2000,2000,0,0
20200520,05623P,台積電中信96售03,,,,,0.00,0.00,0,0,0,0,0,0,0,0,0,0,0,0,0
20200520,056240,嘉晶群益97購02,0.90,1.27,0.90,1.20,+0.38,46.34,263000,41,271180,0,0,0,0,0,0,93000,132000,-39000,-39000
20200520,056241,緯創群益97購01,1.91,1.91,1.83,1.83,-0.05,-2.66,566000,19,1071880,0,0,0,0,0,0,315000,251000,64000,64000
20200520,056242,緯創群益9A購01,,,,,0.00,0.00,0,0,0,0,0,0,0,0,0,0,0,0,0
20200520,056243,創意群益97購03,0.56,0.56,0.56,0.56,+0.02,3.7,30000,1,16800,0,0,0,0,0,0,0,30000,-30000,-30000
20200520,056244,群創群益98購09,,,,,0.00,0.00,0,0,0,0,0,0,0,0,0,0,0,0,0
20200520,056245,嘉澤群益97購01,,,,,0.00,0.00,0,0,0,0,0,0,0,0,0,0,0,0,0
20200520,056246,祥碩群益97購01,,,,,0.00,0.00,0,0,0,0,0,0,0,0,0,0,0,0,0
20200520,056247,台郡群益97購01,0.76,0.76,0.76,0.76,0.00,0.00,71000,1,53960,0,0,0,0,0,0,71000,0,71000,71000
20200520,056248,康友群益97購04,,,,,0.00,0.00,0,0,0,0,0,0,0,0,0,0,0,0,0
20200520,056249,鴻海兆豐97購05,,,,,0.00,0.00,0,0,0,0,0,0,0,0,0,0,0,0,0
20200520,05624P,同欣電中信98售01,0.32,0.35,0.31,0.35,-0.01,-2.78,31000,4,9850,0,0,0,0,0,0,0,21000,-21000,-21000
20200520,056250,瑞昱兆豐97購02,1.08,1.13,1.01,1.01,-0.08,-7.34,373000,34,402790,0,0,0,0,0,0,297000,76000,221000,221000
20200520,056251,聯發科兆豐97購02,,,,,0.00,0.00,0,0,0,0,0,0,0,0,0,0,0,0,0
20200520,056252,聯發科兆豐97購03,,,,,0.00,0.00,0,0,0,0,0,0,0,0,0,0,0,0,0
20200520,056253,京鼎兆豐98購01,0.23,0.23,0.23,0.23,0.00,0.00,10000,1,2300,0,0,0,0,0,0,0,10000,-10000,-10000
20200520,056254,為升元富97購01,,,,,0.00,0.00,0,0,0,0,0,0,0,0,0,0,0,0,0
20200520,056255,華新科元富97購05,0.97,1.09,0.95,0.95,-0.10,-9.52,567000,18,572260,0,0,0,0,0,0,302000,265000,37000,37000
20200520,056256,聯茂元富97購03,,,,,0.00,0.00,0,0,0,0,0,0,0,0,0,0,0,0,0
20200520,056257,聯茂元富97購04,,,,,0.00,0.00,0,0,0,0,0,0,0,0,0,0,0,0,0
20200520,056258,訊芯元富97購04,,,,,0.00,0.00,0,0,0,0,0,0,0,0,0,0,0,0,0
20200520,056259,T50反1統一9A購01,,,,,0.00,0.00,0,0,0,0,0,0,0,0,0,0,0,0,0
20200520,05625P,國巨國票97售01,0.77,0.77,0.68,0.76,-0.10,-11.63,325000,26,235970,0,0,0,0,0,0,110000,215000,-105000,-105000
20200520,056260,鴻海統一98購07,0.62,0.62,0.62,0.62,-0.02,-3.12,87000,1,53940,0,0,0,0,0,0,87000,0,87000,87000
20200520,056261,台積電統一97購07,,,,,0.00,0.00,0,0,0,0,0,0,0,0,0,0,0,0,0
20200520,056262,台積電統一98購04,0.24,0.24,0.24,0.24,0.00,0.00,100000,10,24000,0,0,0,0,0,0,0,100000,-100000,-100000
20200520,056263,友訊統一99購01,,,,,0.00,0.00,0,0,0,0,0,0,0,0,0,0,0,0,0
20200520,056264,聯發科統一98購02,4.96,4.96,4.87,4.90,+0.24,5.15,167000,20,822740,0,0,0,0,0,0,167000,0,167000,167000
20200520,056265,國泰金統一97購01,0.58,0.58,0.58,0.58,+0.01,1.75,22000,1,12760,0,0,0,0,0,0,0,22000,-22000,-22000
20200520,056266,開發金統一9A購01,1.40,1.42,1.40,1.40,-0.01,-0.71,357000,12,502210,0,0,0,0,0,0,172000,226000,-54000,-54000
20200520,056267,文曄統一97購02,,,,,0.00,0.00,0,0,0,0,0,0,0,0,0,0,0,0,0
20200520,056268,新日興統一97購01,0.33,0.39,0.29,0.37,-0.01,-2.63,628000,51,226200,0,0,0,0,0,0,171000,457000,-286000,-286000
20200520,056269,新日興統一98購01,0.42,0.53,0.40,0.53,+0.07,15.22,650000,33,303980,0,0,0,0,0,0,108000,542000,-434000,-434000
20200520,05626P,景碩國票97售03,1.37,1.59,1.34,1.59,+0.13,8.9,287000,20,418250,0,0,0,0,0,0,71000,216000,-145000,-145000
20200520,056270,群創統一98購04,,,,,0.00,0.00,0,0,0,0,0,0,0,0,0,0,0,0,0
20200520,056271,嘉澤統一97購01,4.70,4.70,4.60,4.60,-0.17,-3.56,16000,2,74600,0,0,0,0,0,0,16000,0,16000,16000
20200520,056272,嘉澤統一99購01,,,,,0.00,0.00,0,0,0,0,0,0,0,0,0,0,0,0,0
20200520,056273,祥碩統一97購02,,,,,0.00,0.00,0,0,0,0,0,0,0,0,0,0,0,0,0
20200520,056274,彩晶統一98購02,,,,,0.00,0.00,0,0,0,0,0,0,0,0,0,0,0,0,0
20200520,056275,國巨國泰98購04,1.13,1.30,1.12,1.17,0.00,0.00,51000,6,61130,0,0,0,0,0,0,20000,30000,-10000,-10000
20200520,056276,同欣電國泰98購01,,,,,0.00,0.00,0,0,0,0,0,0,0,0,0,0,0,0,0
20200520,056277,上銀富邦99購02,,,,,0.00,0.00,0,0,0,0,0,0,0,0,0,0,0,0,0
20200520,056278,全新富邦98購02,,,,,0.00,0.00,0,0,0,0,0,0,0,0,0,0,0,0,0
20200520,056279,新日興富邦99購01,0.25,0.25,0.23,0.24,-0.03,-11.11,10000,9,2430,0,0,0,0,0,0,10000,0,10000,10000
20200520,05627P,致伸國票97售01,2.85,2.96,2.85,2.96,+0.09,3.14,34000,11,100100,0,0,0,0,0,0,6000,28000,-22000,-22000
20200520,056280,上証2X永豐98購01,,,,,0.00,0.00,0,0,0,0,0,0,0,0,0,0,0,0,0
20200520,056281,深中小永豐97購01,0.98,0.99,0.98,0.99,+0.04,4.21,48000,5,47090,0,0,0,0,0,0,10000,38000,-28000,-28000
20200520,056282,S&P反1永豐97購01,,,,,0.00,0.00,0,0,0,0,0,0,0,0,0,0,0,0,0
20200520,056283,鴻海永豐97購03,,,,,0.00,0.00,0,0,0,0,0,0,0,0,0,0,0,0,0
20200520,056284,台積電永豐97購06,,,,,0.00,0.00,0,0,0,0,0,0,0,0,0,0,0,0,0
20200520,056285,可成永豐97購02,0.04,0.04,0.04,0.04,0.00,0.00,10000,1,400,0,0,0,0,0,0,0,10000,-10000,-10000
20200520,056286,奇鋐永豐97購01,0.93,0.93,0.92,0.92,+0.02,2.22,22000,2,20340,0,0,0,0,0,0,12000,10000,2000,2000
20200520,056287,亞光永豐97購02,,,,,0.00,0.00,0,0,0,0,0,0,0,0,0,0,0,0,0
20200520,056288,健鼎永豐97購01,0.36,0.36,0.36,0.36,-0.04,-10.0,10000,1,3600,0,0,0,0,0,0,0,10000,-10000,-10000
20200520,056289,合勤控永豐97購01,0.35,0.48,0.35,0.47,+0.14,42.42,314000,23,136360,0,0,0,0,0,0,0,314000,-314000,-314000
20200520,05628P,茂林國票97售02,0.24,0.24,0.17,0.17,-0.10,-37.04,208000,10,36850,0,0,0,0,0,0,8000,200000,-192000,-192000
20200520,056290,正文永豐98購01,,,,,0.00,0.00,0,0,0,0,0,0,0,0,0,0,0,0,0
20200520,056291,聯茂永豐97購03,0.35,0.35,0.35,0.35,-0.03,-7.89,10000,2,3500,0,0,0,0,0,0,10000,0,10000,10000
20200520,056292,統一元大97購01,0.95,0.95,0.95,0.95,+0.05,5.56,10000,1,9500,0,0,0,0,0,0,0,0,0,0
20200520,056293,上銀元大97購10,,,,,0.00,0.00,0,0,0,0,0,0,0,0,0,0,0,0,0
20200520,056294,上銀元大97購11,,,,,0.00,0.00,0,0,0,0,0,0,0,0,0,0,0,0,0
20200520,056295,國巨元大97購16,3.06,3.06,2.80,2.80,0.00,0.00,13000,3,39500,0,0,0,0,0,0,2000,13000,-11000,-11000
20200520,056296,旺宏元大97購07,0.95,0.95,0.95,0.95,-0.02,-2.06,68000,1,64600,0,0,0,0,0,0,0,68000,-68000,-68000
20200520,056297,台光電元大97購04,,,,,0.00,0.00,0,0,0,0,0,0,0,0,0,0,0,0,0
20200520,056298,億光元大97購02,1.02,1.16,1.01,1.15,+0.17,17.35,258000,9,267960,0,0,0,0,0,0,136000,122000,14000,14000
20200520,056299,友達元大9B購04,,,,,0.00,0.00,0,0,0,0,0,0,0,0,0,0,0,0,0
20200520,05629P,聯發科永昌99售02,1.32,1.32,1.32,1.32,-0.13,-8.97,5000,1,6600,0,0,0,0,0,0,0,5000,-5000,-5000
20200520,056300,聯發科元大97購23,3.93,3.93,3.93,3.93,0.00,0.00,100000,1,393000,0,0,0,0,0,0,100000,0,100000,100000
20200520,056301,開發金元大9A購01,0.68,0.70,0.68,0.68,-0.02,-2.86,176000,3,121680,0,0,0,0,0,0,76000,100000,-24000,-24000
20200520,056302,大立光元大97購17,1.12,1.13,1.12,1.13,-0.07,-5.83,100000,2,112500,0,0,0,0,0,0,0,100000,-100000,-100000
20200520,056303,亞光元大97購04,,,,,0.00,0.00,0,0,0,0,0,0,0,0,0,0,0,0,0
20200520,056304,創意元大97購03,0.52,0.52,0.52,0.52,-0.01,-1.89,78000,2,40560,0,0,0,0,0,0,0,78000,-78000,-78000
20200520,056305,群創元大9A購03,,,,,0.00,0.00,0,0,0,0,0,0,0,0,0,0,0,0,0
20200520,056306,晶相光元大98購01,,,,,0.00,0.00,0,0,0,0,0,0,0,0,0,0,0,0,0
20200520,056307,貿聯元大97購05,0.77,0.78,0.77,0.78,+0.01,1.3,80000,2,62280,0,0,0,0,0,0,12000,68000,-56000,-56000
20200520,056308,TPK元大97購02,0.66,0.66,0.62,0.62,-0.01,-1.59,178000,2,114360,0,0,0,0,0,0,78000,178000,-100000,-100000
20200520,056309,合勤控元大97購01,0.77,0.99,0.77,0.99,+0.20,25.32,1008000,20,896290,0,0,0,0,0,0,68000,940000,-872000,-872000
20200520,05630P,大立光永昌96售06,,,,,0.00,0.00,0,0,0,0,0,0,0,0,0,0,0,0,0
20200520,056310,神達元大97購02,1.25,1.25,1.25,1.25,0.00,0.00,2000,2,2500,0,0,0,0,0,0,0,2000,-2000,-2000
20200520,056311,泰鼎元大98購01,,,,,0.00,0.00,0,0,0,0,0,0,0,0,0,0,0,0,0
20200520,056312,茂林元大98購01,0.45,0.54,0.45,0.54,+0.09,20.0,80000,8,41300,0,0,0,0,0,0,10000,70000,-60000,-60000
20200520,056313,聯茂元大98購01,0.80,0.80,0.79,0.79,0.00,0.00,60000,6,47900,0,0,0,0,0,0,0,60000,-60000,-60000
20200520,056314,力成元大97購01,1.30,1.31,1.17,1.17,-0.11,-8.59,82000,6,106520,0,0,0,0,0,0,82000,0,82000,82000
20200520,056315,同欣電元大97購05,,,,,0.00,0.00,0,0,0,0,0,0,0,0,0,0,0,0,0
20200520,056316,訊芯元大98購03,,,,,0.00,0.00,0,0,0,0,0,0,0,0,0,0,0,0,0
20200520,056317,華通群益99購02,,,,,0.00,0.00,0,0,0,0,0,0,0,0,0,0,0,0,0
20200520,056318,鴻海群益98購02,0.31,0.31,0.31,0.31,0.00,0.00,3000,1,930,0,0,0,0,0,0,3000,0,3000,3000
20200520,056319,智原群益98購02,,,,,0.00,0.00,0,0,0,0,0,0,0,0,0,0,0,0,0
20200520,05631P,國巨富邦9A售01,0.60,0.60,0.60,0.60,+0.05,9.09,10000,1,6000,0,0,0,0,0,0,10000,10000,0,0
20200520,056320,京鼎群益99購01,0.99,1.00,0.96,0.99,+0.02,2.06,474000,12,468240,0,0,0,0,0,0,33000,441000,-408000,-408000
20200520,056321,創意群益98購02,1.12,1.16,1.12,1.16,-0.01,-0.85,170000,5,195350,0,0,0,0,0,0,20000,150000,-130000,-130000
20200520,056322,臺股指群益98購01,,,,,0.00,0.00,0,0,0,0,0,0,0,0,0,0,0,0,0
20200520,056323,旺宏兆豐98購01,,,,,0.00,0.00,0,0,0,0,0,0,0,0,0,0,0,0,0
20200520,056324,南亞科兆豐98購01,0.24,0.24,0.23,0.23,0.00,0.00,90000,2,20800,0,0,0,0,0,0,10000,80000,-70000,-70000
20200520,056325,群創兆豐9A購01,0.03,0.03,0.03,0.03,0.00,0.00,10000,1,300,0,0,0,0,0,0,0,10000,-10000,-10000
20200520,056326,TPK兆豐98購01,,,,,0.00,0.00,0,0,0,0,0,0,0,0,0,0,0,0,0
20200520,056327,樺漢兆豐98購01,,,,,0.00,0.00,0,0,0,0,0,0,0,0,0,0,0,0,0
20200520,056328,訊芯兆豐98購01,,,,,0.00,0.00,0,0,0,0,0,0,0,0,0,0,0,0,0
20200520,056329,上銀國票98購02,,,,,0.00,0.00,0,0,0,0,0,0,0,0,0,0,0,0,0
20200520,05632P,大立光群益96售02,,,,,0.00,0.00,0,0,0,0,0,0,0,0,0,0,0,0,0
20200520,056330,玉晶光國票99購03,,,,,0.00,0.00,0,0,0,0,0,0,0,0,0,0,0,0,0
20200520,056331,聯鈞國票99購01,,,,,0.00,0.00,0,0,0,0,0,0,0,0,0,0,0,0,0
20200520,056332,台郡國票99購01,2.04,2.09,2.04,2.09,+0.02,0.97,40000,3,83000,0,0,0,0,0,0,0,40000,-40000,-40000
20200520,056333,台積電日盛9B購01,,,,,0.00,0.00,0,0,0,0,0,0,0,0,0,0,0,0,0
20200520,056334,台積電凱基98購06,,,,,0.00,0.00,0,0,0,0,0,0,0,0,0,0,0,0,0
20200520,056335,微星凱基98購01,1.44,1.45,1.34,1.34,-0.01,-0.74,128000,14,179790,0,0,0,0,0,0,73000,45000,28000,28000
20200520,056336,南亞科凱基98購02,,,,,0.00,0.00,0,0,0,0,0,0,0,0,0,0,0,0,0
20200520,056337,聯發科凱基98購06,,,,,0.00,0.00,0,0,0,0,0,0,0,0,0,0,0,0,0
20200520,056338,聯發科凱基99購01,4.46,4.70,4.46,4.67,+0.42,9.88,30000,11,135990,0,0,0,0,0,0,30000,0,30000,30000
20200520,056339,聯發科凱基99購02,3.65,4.18,3.65,3.83,+0.37,10.69,47000,13,180210,0,0,0,0,0,0,47000,0,47000,47000
20200520,05633P,台表科群益96售04,,,,,0.00,0.00,0,0,0,0,0,0,0,0,0,0,0,0,0
20200520,056340,可成凱基98購04,,,,,0.00,0.00,0,0,0,0,0,0,0,0,0,0,0,0,0
20200520,056341,宏達電凱基9A購01,,,,,0.00,0.00,0,0,0,0,0,0,0,0,0,0,0,0,0
20200520,056342,中工凱基98購01,,,,,0.00,0.00,0,0,0,0,0,0,0,0,0,0,0,0,0
20200520,056343,高鐵凱基98購02,0.51,0.60,0.51,0.56,+0.06,12.0,57000,13,31940,0,0,0,0,0,0,32000,25000,7000,7000
20200520,056344,嘉晶凱基98購02,1.31,1.60,1.31,1.60,0.00,0.00,13000,3,19610,0,0,0,0,0,0,3000,10000,-7000,-7000
20200520,056345,嘉聯益凱基99購01,,,,,0.00,0.00,0,0,0,0,0,0,0,0,0,0,0,0,0
20200520,056346,聯茂凱基99購02,,,,,0.00,0.00,0,0,0,0,0,0,0,0,0,0,0,0,0
20200520,056347,GIS凱基9A購01,,,,,0.00,0.00,0,0,0,0,0,0,0,0,0,0,0,0,0
20200520,056348,S&P反1元大9A購01,,,,,0.00,0.00,0,0,0,0,0,0,0,0,0,0,0,0,0
20200520,056349,道瓊銀元大9B購01,0.89,1.02,0.89,1.02,+0.17,20.0,502000,23,489980,0,0,0,0,0,0,78000,0,78000,78000
20200520,05634P,玉晶光台新97售01,0.33,0.34,0.32,0.33,-0.05,-13.16,241000,7,81380,0,0,0,0,0,0,0,231000,-231000,-231000
20200520,056350,上銀元大98購02,,,,,0.00,0.00,0,0,0,0,0,0,0,0,0,0,0,0,0
20200520,056351,鴻海元大98購06,0.68,0.68,0.67,0.67,-0.04,-5.63,384000,4,257520,0,0,0,0,0,0,360000,24000,336000,336000
20200520,056352,鴻海元大99購01,1.07,1.07,1.07,1.07,0.00,0.00,20000,1,21400,0,0,0,0,0,0,20000,0,20000,20000
20200520,056353,鴻海元大99購02,,,,,0.00,0.00,0,0,0,0,0,0,0,0,0,0,0,0,0
20200520,056354,國巨元大98購10,3.58,3.58,3.23,3.26,0.00,0.00,25000,7,84960,0,0,0,0,0,0,4000,25000,-21000,-21000
20200520,056355,台積電元大98購08,,,,,0.00,0.00,0,0,0,0,0,0,0,0,0,0,0,0,0
20200520,056356,台積電元大99購01,0.48,0.48,0.48,0.48,0.00,0.00,12000,4,5760,0,0,0,0,0,0,0,12000,-12000,-12000
20200520,056357,台積電元大9A購01,,,,,0.00,0.00,0,0,0,0,0,0,0,0,0,0,0,0,0
20200520,056358,友訊元大99購01,1.49,1.51,1.49,1.51,-0.06,-3.82,68000,2,102480,0,0,0,0,0,0,68000,0,68000,68000
20200520,056359,旺宏元大9A購01,0.47,0.47,0.47,0.47,0.00,0.00,60000,1,28200,0,0,0,0,0,0,60000,60000,0,0
20200520,05635P,健策台新96售02,,,,,0.00,0.00,0,0,0,0,0,0,0,0,0,0,0,0,0
20200520,056360,智邦元大98購01,,,,,0.00,0.00,0,0,0,0,0,0,0,0,0,0,0,0,0
20200520,056361,美律元大99購02,,,,,0.00,0.00,0,0,0,0,0,0,0,0,0,0,0,0,0
20200520,056362,聯發科元大99購01,2.68,2.97,2.68,2.97,+0.43,16.93,25000,3,68040,0,0,0,0,0,0,25000,0,25000,25000
20200520,056363,華新科元大99購04,,,,,0.00,0.00,0,0,0,0,0,0,0,0,0,0,0,0,0
20200520,056364,亞光元大99購02,0.43,0.43,0.42,0.42,0.00,0.00,150000,2,63500,0,0,0,0,0,0,0,150000,-150000,-150000
20200520,056365,欣興元大98購01,2.15,2.31,2.13,2.13,+0.06,2.9,170000,10,375650,0,0,0,0,0,0,43000,127000,-84000,-84000
20200520,056366,玉晶光元大99購04,2.02,2.23,2.02,2.23,+0.13,6.19,63000,4,138250,0,0,0,0,0,0,13000,53000,-40000,-40000
20200520,056367,祥碩元大98購01,8.55,8.55,8.15,8.55,+0.95,12.5,50000,5,425500,0,0,0,0,0,0,50000,50000,0,0
20200520,056368,祥碩元大98購02,,,,,0.00,0.00,0,0,0,0,0,0,0,0,0,0,0,0,0
20200520,056369,彩晶元大01購01,,,,,0.00,0.00,0,0,0,0,0,0,0,0,0,0,0,0,0
20200520,05636P,國巨永豐96售03,,,,,0.00,0.00,0,0,0,0,0,0,0,0,0,0,0,0,0
20200520,056370,台郡元大98購03,,,,,0.00,0.00,0,0,0,0,0,0,0,0,0,0,0,0,0
20200520,056371,樺漢元大98購03,,,,,0.00,0.00,0,0,0,0,0,0,0,0,0,0,0,0,0
20200520,056372,訊芯元大98購04,,,,,0.00,0.00,0,0,0,0,0,0,0,0,0,0,0,0,0
20200520,056373,上銀統一99購02,,,,,0.00,0.00,0,0,0,0,0,0,0,0,0,0,0,0,0
20200520,056374,聯發科統一9B購01,2.67,2.67,2.67,2.67,-0.02,-0.74,10000,1,26700,0,0,0,0,0,0,10000,0,10000,10000
20200520,056375,玉晶光統一01購01,,,,,0.00,0.00,0,0,0,0,0,0,0,0,0,0,0,0,0
20200520,056376,玉晶光統一98購01,,,,,0.00,0.00,0,0,0,0,0,0,0,0,0,0,0,0,0
20200520,056377,智伸科統一9A購01,,,,,0.00,0.00,0,0,0,0,0,0,0,0,0,0,0,0,0
20200520,056378,欣興元富98購01,1.95,1.97,1.79,1.79,+0.01,0.56,76000,5,140320,0,0,0,0,0,0,7000,69000,-62000,-62000
20200520,056379,玉晶光元富98購01,1.80,1.93,1.80,1.93,0.00,0.00,21000,3,37930,0,0,0,0,0,0,0,21000,-21000,-21000
20200520,05637P,聯電元大96售04,,,,,0.00,0.00,0,0,0,0,0,0,0,0,0,0,0,0,0
20200520,056380,麗豐元富98購01,,,,,0.00,0.00,0,0,0,0,0,0,0,0,0,0,0,0,0
20200520,056381,台虹元富98購01,,,,,0.00,0.00,0,0,0,0,0,0,0,0,0,0,0,0,0
20200520,056382,道瓊反國泰9A購01,,,,,0.00,0.00,0,0,0,0,0,0,0,0,0,0,0,0,0
20200520,056383,上銀國泰99購01,2.90,2.90,2.90,2.90,-0.03,-1.02,11000,1,31900,0,0,0,0,0,0,11000,0,11000,11000
20200520,056384,玉晶光國泰9A購02,,,,,0.00,0.00,0,0,0,0,0,0,0,0,0,0,0,0,0
20200520,056385,創意國泰99購01,0.49,0.50,0.49,0.50,-0.02,-3.85,95000,2,47000,0,0,0,0,0,0,95000,95000,0,0
20200520,056386,TPK國泰99購01,0.44,0.44,0.44,0.44,-0.02,-4.35,4000,1,1760,0,0,0,0,0,0,0,4000,-4000,-4000
20200520,056387,智伸科國泰99購01,0.18,0.19,0.18,0.19,0.00,0.00,11000,2,2080,0,0,0,0,0,0,11000,1000,10000,10000
20200520,056388,勤誠國泰99購01,,,,,0.00,0.00,0,0,0,0,0,0,0,0,0,0,0,0,0
20200520,056389,鴻海富邦99購01,,,,,0.00,0.00,0,0,0,0,0,0,0,0,0,0,0,0,0
20200520,05638P,國巨統一96售04,,,,,0.00,0.00,0,0,0,0,0,0,0,0,0,0,0,0,0
20200520,056390,台積電富邦9B購01,,,,,0.00,0.00,0,0,0,0,0,0,0,0,0,0,0,0,0
20200520,056391,大立光富邦9C購01,,,,,0.00,0.00,0,0,0,0,0,0,0,0,0,0,0,0,0
20200520,056392,玉晶光富邦9C購01,,,,,0.00,0.00,0,0,0,0,0,0,0,0,0,0,0,0,0
20200520,056393,精元永豐98購01,,,,,0.00,0.00,0,0,0,0,0,0,0,0,0,0,0,0,0
20200520,056394,晶豪科永豐98購01,1.89,1.96,1.71,1.71,-0.29,-14.5,82000,11,150960,0,0,0,0,0,0,11000,70000,-59000,-59000
20200520,056395,玉晶光永豐9B購01,,,,,0.00,0.00,0,0,0,0,0,0,0,0,0,0,0,0,0
20200520,056396,祥碩永豐98購01,2.00,2.52,2.00,2.52,+0.67,36.22,50000,6,115900,0,0,0,0,0,0,20000,20000,0,0
20200520,056397,彩晶永豐99購01,,,,,0.00,0.00,0,0,0,0,0,0,0,0,0,0,0,0,0
20200520,056398,南茂永豐98購01,0.82,0.88,0.81,0.88,+0.08,10.0,179000,11,150820,0,0,0,0,0,0,129000,59000,70000,70000
20200520,056399,上証2X群益9C購01,,,,,0.00,0.00,0,0,0,0,0,0,0,0,0,0,0,0,0
20200520,05639P,欣興統一97售01,1.55,1.61,1.53,1.53,-0.08,-4.97,127000,12,198190,0,0,0,0,0,0,126000,1000,125000,125000
20200520,056400,道瓊反群益9C購01,,,,,0.00,0.00,0,0,0,0,0,0,0,0,0,0,0,0,0
20200520,056401,國巨群益98購07,1.48,1.48,1.47,1.47,0.00,0.00,20000,2,29500,0,0,0,0,0,0,0,20000,-20000,-20000
20200520,056402,智易群益98購02,,,,,0.00,0.00,0,0,0,0,0,0,0,0,0,0,0,0,0
20200520,056403,茂林群益98購01,1.12,1.48,1.12,1.48,0.00,0.00,230000,11,302040,0,0,0,0,0,0,0,230000,-230000,-230000
20200520,056404,嘉聯益群益9A購01,1.07,1.07,1.07,1.07,+0.03,2.88,15000,1,16050,0,0,0,0,0,0,0,15000,-15000,-15000
20200520,056405,聯茂群益98購01,3.34,3.34,3.28,3.28,-0.23,-6.55,10000,2,33100,0,0,0,0,0,0,0,10000,-10000,-10000
20200520,056406,建準國票99購01,3.95,3.95,3.95,3.95,+0.01,0.25,2000,1,7900,0,0,0,0,0,0,2000,0,2000,2000
20200520,056407,嘉晶國票99購01,4.44,6.35,4.44,6.25,+1.96,45.69,235000,24,1223620,0,0,0,0,0,0,51000,185000,-134000,-134000
20200520,056408,奇鋐國票99購01,2.23,2.37,2.23,2.36,+0.08,3.51,29000,4,66840,0,0,0,0,0,0,0,29000,-29000,-29000
20200520,056409,麗豐國票99購01,,,,,0.00,0.00,0,0,0,0,0,0,0,0,0,0,0,0,0
20200520,05640P,旺宏元富96售03,0.33,0.33,0.33,0.33,-0.04,-10.81,5000,1,1650,0,0,0,0,0,0,0,5000,-5000,-5000
20200520,056410,康控國票99購01,1.49,1.49,1.33,1.36,+0.07,5.43,280000,18,401210,0,0,0,0,0,0,278000,2000,276000,276000
20200520,056411,緯穎國票99購01,6.10,6.45,5.35,5.45,-0.30,-5.22,57000,11,329750,0,0,0,0,0,0,26000,31000,-5000,-5000
20200520,056412,上証2X中信9A購02,1.17,1.17,1.17,1.17,+0.01,0.86,2000,1,2340,0,0,0,0,0,0,2000,0,2000,2000
20200520,056413,上証反中信9A購01,,,,,0.00,0.00,0,0,0,0,0,0,0,0,0,0,0,0,0
20200520,056414,國巨中信98購02,,,,,0.00,0.00,0,0,0,0,0,0,0,0,0,0,0,0,0
20200520,056415,聯發科中信98購04,1.46,1.46,1.42,1.42,+0.06,4.41,15000,2,21500,0,0,0,0,0,0,15000,0,15000,15000
20200520,056416,華新科中信98購01,0.24,0.25,0.24,0.24,+0.01,4.35,32000,4,7700,0,0,0,0,0,0,0,32000,-32000,-32000
20200520,056417,欣興中信98購01,0.33,0.36,0.31,0.31,-0.02,-6.06,158000,14,52390,0,0,0,0,0,0,115000,42000,73000,73000
20200520,056418,台光電元富98購01,1.84,1.87,1.84,1.87,-0.17,-8.33,95000,13,176300,0,0,0,0,0,0,85000,10000,75000,75000
20200520,056419,欣興元富98購02,2.22,2.39,2.09,2.15,-0.04,-1.83,233000,18,520160,0,0,0,0,0,0,67000,166000,-99000,-99000
20200520,05641P,貿聯元富96售02,,,,,0.00,0.00,0,0,0,0,0,0,0,0,0,0,0,0,0
20200520,056420,台表科元富98購01,1.06,1.54,1.03,1.45,+0.45,45.0,3642000,108,4416970,25000,0,25000,0,0,0,1731000,1857000,-126000,-101000
20200520,056421,鴻海統一98購08,0.39,0.39,0.39,0.39,0.00,0.00,10000,1,3900,0,0,0,0,0,0,10000,0,10000,10000
20200520,056422,全新統一98購02,,,,,0.00,0.00,0,0,0,0,0,0,0,0,0,0,0,0,0
20200520,056423,奇鋐統一98購01,1.27,1.37,1.27,1.37,+0.01,0.74,122000,7,165510,0,0,0,0,0,0,0,122000,-122000,-122000
20200520,056424,泰碩統一98購01,,,,,0.00,0.00,0,0,0,0,0,0,0,0,0,0,0,0,0
20200520,056425,聯發科日盛9A購01,,,,,0.00,0.00,0,0,0,0,0,0,0,0,0,0,0,0,0
20200520,056426,上証2X凱基9A購01,2.43,2.46,2.43,2.45,+0.01,0.41,18000,4,44050,0,0,0,0,0,0,0,18000,-18000,-18000
20200520,056427,上銀凱基98購03,,,,,0.00,0.00,0,0,0,0,0,0,0,0,0,0,0,0,0
20200520,056428,台達電凱基99購01,1.12,1.13,1.12,1.13,-0.03,-2.59,9000,8,10090,0,0,0,0,0,0,9000,0,9000,9000
20200520,056429,華通凱基98購02,,,,,0.00,0.00,0,0,0,0,0,0,0,0,0,0,0,0,0
20200520,05642P,玉晶光兆豐97售02,,,,,0.00,0.00,0,0,0,0,0,0,0,0,0,0,0,0,0
20200520,056430,鴻海凱基98購06,0.85,0.85,0.85,0.85,-0.09,-9.57,20000,2,17000,0,0,0,0,0,0,20000,0,20000,20000
20200520,056431,鴻海凱基98購07,0.40,0.40,0.39,0.39,0.00,0.00,15000,2,5900,0,0,0,0,0,0,0,15000,-15000,-15000
20200520,056432,鴻海凱基98購08,,,,,0.00,0.00,0,0,0,0,0,0,0,0,0,0,0,0,0
20200520,056433,鴻海凱基98購09,,,,,0.00,0.00,0,0,0,0,0,0,0,0,0,0,0,0,0
20200520,056434,國巨凱基98購03,2.78,3.15,2.78,2.85,+0.28,10.89,185000,24,537330,0,0,0,0,0,0,118000,72000,46000,46000
20200520,056435,台積電凱基98購09,,,,,0.00,0.00,0,0,0,0,0,0,0,0,0,0,0,0,0
20200520,056436,台積電凱基98購10,,,,,0.00,0.00,0,0,0,0,0,0,0,0,0,0,0,0,0
20200520,056437,台積電凱基98購11,,,,,0.00,0.00,0,0,0,0,0,0,0,0,0,0,0,0,0
20200520,056438,旺宏凱基98購05,1.50,1.50,1.50,1.50,0.00,0.00,20000,2,30000,0,0,0,0,0,0,0,20000,-20000,-20000
20200520,056439,華邦電凱基98購02,0.10,0.10,0.10,0.10,0.00,0.00,5000,1,500,0,0,0,0,0,0,5000,0,5000,5000
20200520,05643P,大立光中信98售01,,,,,0.00,0.00,0,0,0,0,0,0,0,0,0,0,0,0,0
20200520,056440,智邦凱基98購03,,,,,0.00,0.00,0,0,0,0,0,0,0,0,0,0,0,0,0
20200520,056441,燿華凱基98購01,0.61,0.72,0.61,0.72,+0.14,24.14,56000,5,36460,0,0,0,0,0,0,0,56000,-56000,-56000
20200520,056442,瑞昱凱基98購02,,,,,0.00,0.00,0,0,0,0,0,0,0,0,0,0,0,0,0
20200520,056443,南亞科凱基98購03,,,,,0.00,0.00,0,0,0,0,0,0,0,0,0,0,0,0,0
20200520,056444,南亞科凱基99購01,,,,,0.00,0.00,0,0,0,0,0,0,0,0,0,0,0,0,0
20200520,056445,聯發科凱基98購07,,,,,0.00,0.00,0,0,0,0,0,0,0,0,0,0,0,0,0
20200520,056446,聯發科凱基98購08,,,,,0.00,0.00,0,0,0,0,0,0,0,0,0,0,0,0,0
20200520,056447,聯發科凱基98購09,,,,,0.00,0.00,0,0,0,0,0,0,0,0,0,0,0,0,0
20200520,056448,全新凱基99購01,,,,,0.00,0.00,0,0,0,0,0,0,0,0,0,0,0,0,0
20200520,056449,義隆凱基98購03,,,,,0.00,0.00,0,0,0,0,0,0,0,0,0,0,0,0,0
20200520,05644P,大立光中信9A售03,0.49,0.49,0.46,0.48,-0.03,-5.88,503000,24,239040,0,0,0,0,0,0,200000,303000,-103000,-103000
20200520,056450,可成凱基98購05,,,,,0.00,0.00,0,0,0,0,0,0,0,0,0,0,0,0,0
20200520,056451,可成凱基99購01,,,,,0.00,0.00,0,0,0,0,0,0,0,0,0,0,0,0,0
20200520,056452,亞光凱基98購02,,,,,0.00,0.00,0,0,0,0,0,0,0,0,0,0,0,0,0
20200520,056453,禾伸堂凱基99購02,2.97,2.97,2.97,2.97,0.00,0.00,30000,3,89100,0,0,0,0,0,0,0,30000,-30000,-30000
20200520,056454,欣興凱基98購02,2.62,2.64,2.62,2.64,+0.50,23.36,35000,2,92260,0,0,0,0,0,0,28000,7000,21000,21000
20200520,056455,群創凱基9A購01,,,,,0.00,0.00,0,0,0,0,0,0,0,0,0,0,0,0,0
20200520,056456,群創凱基9B購01,,,,,0.00,0.00,0,0,0,0,0,0,0,0,0,0,0,0,0
20200520,056457,嘉澤凱基98購01,,,,,0.00,0.00,0,0,0,0,0,0,0,0,0,0,0,0,0
20200520,056458,日月光凱基98購02,1.06,1.07,1.06,1.07,0.00,0.00,57000,2,60450,0,0,0,0,0,0,3000,54000,-51000,-51000
20200520,056459,茂林凱基99購01,1.02,1.25,1.02,1.25,+0.32,34.41,615000,28,669890,0,0,0,0,0,0,136000,604000,-468000,-468000
20200520,05645P,聯發科凱基96售13,,,,,0.00,0.00,0,0,0,0,0,0,0,0,0,0,0,0,0
20200520,056460,同欣電凱基99購01,,,,,0.00,0.00,0,0,0,0,0,0,0,0,0,0,0,0,0
20200520,056461,樺漢凱基98購02,0.79,0.83,0.79,0.79,-0.01,-1.25,88000,7,71020,0,0,0,0,0,0,10000,78000,-68000,-68000
20200520,056462,訊芯凱基98購03,0.64,0.65,0.64,0.65,+0.02,3.17,30000,7,19430,0,0,0,0,0,0,30000,0,30000,30000
20200520,056463,台虹凱基98購02,0.98,1.01,0.98,1.01,-0.04,-3.81,383000,10,382900,0,0,0,0,0,0,183000,200000,-17000,-17000
20200520,056464,臺股指凱基99購06,,,,,0.00,0.00,0,0,0,0,0,0,0,0,0,0,0,0,0
20200520,056465,臺股指凱基99購07,,,,,0.00,0.00,0,0,0,0,0,0,0,0,0,0,0,0,0
20200520,056466,臺股指凱基99購08,,,,,0.00,0.00,0,0,0,0,0,0,0,0,0,0,0,0,0
20200520,056467,上証2X元大98購02,,,,,0.00,0.00,0,0,0,0,0,0,0,0,0,0,0,0,0
20200520,056468,鴻海元大98購07,,,,,0.00,0.00,0,0,0,0,0,0,0,0,0,0,0,0,0
20200520,056469,國巨元大99購01,,,,,0.00,0.00,0,0,0,0,0,0,0,0,0,0,0,0,0
20200520,05646P,聯發科國票96售05,,,,,0.00,0.00,0,0,0,0,0,0,0,0,0,0,0,0,0
20200520,056470,旺宏元大99購01,1.80,1.80,1.80,1.80,-0.02,-1.1,1000,1,1800,0,0,0,0,0,0,1000,1000,0,0
20200520,056471,台光電元大99購01,4.00,4.00,4.00,4.00,-0.28,-6.54,9000,1,36000,0,0,0,0,0,0,9000,0,9000,9000
20200520,056472,美律元大99購03,0.54,0.54,0.54,0.54,0.00,0.00,68000,1,36720,0,0,0,0,0,0,0,68000,-68000,-68000
20200520,056473,奇力新元大99購02,0.84,0.84,0.84,0.84,0.00,0.00,10000,1,8400,0,0,0,0,0,0,10000,0,10000,10000
20200520,056474,華新科元大99購05,,,,,0.00,0.00,0,0,0,0,0,0,0,0,0,0,0,0,0
20200520,056475,宏達電元大99購02,0.50,0.50,0.50,0.50,0.00,0.00,5000,1,2500,0,0,0,0,0,0,5000,0,5000,5000
20200520,056476,智原元大98購02,,,,,0.00,0.00,0,0,0,0,0,0,0,0,0,0,0,0,0
20200520,056477,欣興元大98購02,2.08,2.15,1.99,2.06,+0.07,3.52,153000,19,319040,0,0,0,0,0,0,109000,44000,65000,65000
20200520,056478,晶技元大99購01,2.68,2.74,2.53,2.53,-0.29,-10.28,103000,8,277280,0,0,0,0,0,0,50000,53000,-3000,-3000
20200520,056479,玉晶光元大99購05,2.11,2.26,2.06,2.26,+0.22,10.78,103000,6,225840,0,0,0,0,0,0,53000,53000,0,0
20200520,05647P,聯發科國票97售02,1.13,1.18,1.13,1.18,-0.23,-16.31,17000,3,19810,0,0,0,0,0,0,0,17000,-17000,-17000
20200520,056480,京鼎元大98購02,1.29,1.31,1.29,1.31,-0.03,-2.24,136000,2,176800,0,0,0,0,0,0,68000,68000,0,0
20200520,056481,創意元大98購01,0.90,0.90,0.85,0.85,-0.08,-8.6,178000,4,153840,0,0,0,0,0,0,110000,68000,42000,42000
20200520,056482,貿聯元大99購01,0.43,0.43,0.43,0.43,0.00,0.00,80000,2,34400,0,0,0,0,0,0,80000,0,80000,80000
20200520,056483,TPK元大98購01,0.59,0.63,0.57,0.57,-0.03,-5.0,112000,10,67640,0,0,0,0,0,0,112000,80000,32000,32000
20200520,056484,聯茂元大98購02,2.40,2.40,2.40,2.40,-0.16,-6.25,30000,1,72000,0,0,0,0,0,0,30000,0,30000,30000
20200520,056485,同欣電元大98購01,0.58,0.58,0.58,0.58,0.00,0.00,10000,1,5800,0,0,0,0,0,0,0,10000,-10000,-10000
20200520,056486,樺漢元大98購04,1.49,1.56,1.49,1.56,+0.05,3.31,309000,9,476090,0,0,0,0,0,0,138000,171000,-33000,-33000
20200520,056487,康友元大98購01,0.17,0.17,0.17,0.17,0.00,0.00,200000,1,34000,0,0,0,0,0,0,200000,0,200000,200000
20200520,056488,致新元大99購01,2.47,2.57,2.42,2.50,+0.13,5.49,255000,23,636970,1000,0,1000,0,0,0,231000,38000,193000,194000
20200520,056489,S&P反1國泰9A購01,,,,,0.00,0.00,0,0,0,0,0,0,0,0,0,0,0,0,0
20200520,05648P,康控國票97售01,,,,,0.00,0.00,0,0,0,0,0,0,0,0,0,0,0,0,0
20200520,056490,台積電國泰99購01,,,,,0.00,0.00,0,0,0,0,0,0,0,0,0,0,0,0,0
20200520,056491,南亞科國泰99購01,,,,,0.00,0.00,0,0,0,0,0,0,0,0,0,0,0,0,0
20200520,056492,全新國泰9A購01,0.71,0.71,0.59,0.59,-0.10,-14.49,54000,6,34290,0,0,0,0,0,0,14000,40000,-26000,-26000
20200520,056493,晶技國泰99購01,,,,,0.00,0.00,0,0,0,0,0,0,0,0,0,0,0,0,0
20200520,056494,緯創國泰99購01,,,,,0.00,0.00,0,0,0,0,0,0,0,0,0,0,0,0,0
20200520,056495,泰鼎國泰99購01,4.18,4.48,4.18,4.40,+0.42,10.55,105000,12,459290,0,0,0,0,0,0,0,105000,-105000,-105000
20200520,056496,康控國泰99購01,1.01,1.01,0.95,0.95,+0.05,5.56,220000,25,220710,0,0,0,0,0,0,214000,6000,208000,208000
20200520,056497,GIS國泰99購01,1.68,1.68,1.68,1.68,-0.01,-0.59,30000,1,50400,0,0,0,0,0,0,0,30000,-30000,-30000
20200520,056498,A50正2富邦9B購01,,,,,0.00,0.00,0,0,0,0,0,0,0,0,0,0,0,0,0
20200520,056499,鴻海富邦98購02,,,,,0.00,0.00,0,0,0,0,0,0,0,0,0,0,0,0,0
20200520,05649P,矽創國票97售03,1.39,1.42,1.39,1.42,-0.13,-8.39,3000,3,4230,0,0,0,0,0,0,0,3000,-3000,-3000
20200520,056500,大立光富邦9B購02,0.45,0.45,0.44,0.44,+0.14,46.67,11000,2,4850,0,0,0,0,0,0,0,0,0,0
20200520,056501,貿聯富邦99購01,,,,,0.00,0.00,0,0,0,0,0,0,0,0,0,0,0,0,0
20200520,056502,A50正2永豐98購01,,,,,0.00,0.00,0,0,0,0,0,0,0,0,0,0,0,0,0
20200520,056503,楠梓電永豐98購01,0.81,0.84,0.81,0.84,0.00,0.00,32000,2,26220,0,0,0,0,0,0,10000,32000,-22000,-22000
20200520,056504,國巨永豐98購02,2.06,2.06,2.06,2.06,+0.27,15.08,4000,2,8240,0,0,0,0,0,0,0,4000,-4000,-4000
20200520,056505,聯發科永豐98購01,2.50,2.85,2.50,2.77,+0.44,18.88,186000,4,529240,0,0,0,0,0,0,184000,182000,2000,2000
20200520,056506,晶豪科永豐98購02,,,,,0.00,0.00,0,0,0,0,0,0,0,0,0,0,0,0,0
20200520,056507,創意永豐98購02,1.06,1.06,1.03,1.06,-0.02,-1.85,178000,6,187170,0,0,0,0,0,0,0,178000,-178000,-178000
20200520,056508,揚明光永豐98購01,0.59,0.59,0.59,0.59,+0.04,7.27,113000,3,66670,0,0,0,0,0,0,108000,5000,103000,103000
20200520,056509,晶相光永豐98購01,,,,,0.00,0.00,0,0,0,0,0,0,0,0,0,0,0,0,0
20200520,05650P,台積電富邦96售01,0.09,0.09,0.08,0.08,-0.06,-42.86,4000,2,340,0,0,0,0,0,0,0,4000,-4000,-4000
20200520,056510,正文永豐98購02,,,,,0.00,0.00,0,0,0,0,0,0,0,0,0,0,0,0,0
20200520,056511,超眾永豐98購01,1.14,1.14,1.14,1.14,-0.09,-7.32,10000,1,11400,0,0,0,0,0,0,10000,0,10000,10000
20200520,056512,易華電永豐98購01,0.44,0.46,0.44,0.46,+0.02,4.55,20000,2,9000,0,0,0,0,0,0,10000,10000,0,0
20200520,056513,臻鼎亞東99購01,,,,,0.00,0.00,0,0,0,0,0,0,0,0,0,0,0,0,0
20200520,056514,訊芯亞東99購01,,,,,0.00,0.00,0,0,0,0,0,0,0,0,0,0,0,0,0
20200520,056515,燿華兆豐99購01,0.18,0.22,0.17,0.20,+0.06,42.86,235000,12,44900,0,0,0,0,0,0,0,0,0,0
20200520,056516,晶豪科兆豐98購01,2.53,2.53,2.35,2.35,-0.03,-1.26,4000,3,9870,0,0,0,0,0,0,0,4000,-4000,-4000
20200520,056517,茂林兆豐99購01,0.76,0.94,0.76,0.94,0.00,0.00,411000,18,350030,0,0,0,0,0,0,0,411000,-411000,-411000
20200520,056518,美律國票99購01,1.57,1.57,1.54,1.54,-0.07,-4.35,69000,3,106710,0,0,0,0,0,0,15000,54000,-39000,-39000
20200520,056519,創意國票99購01,2.66,2.78,2.66,2.78,+0.01,0.36,240000,5,646600,0,0,0,0,0,0,210000,30000,180000,180000
20200520,05651P,大立光元大97售02,,,,,0.00,0.00,0,0,0,0,0,0,0,0,0,0,0,0,0
20200520,056520,鴻海日盛99購01,,,,,0.00,0.00,0,0,0,0,0,0,0,0,0,0,0,0,0
20200520,056521,群創日盛98購01,,,,,0.00,0.00,0,0,0,0,0,0,0,0,0,0,0,0,0
20200520,056522,T50反1中信9B購01,,,,,0.00,0.00,0,0,0,0,0,0,0,0,0,0,0,0,0
20200520,056523,光寶科中信98購01,0.53,0.53,0.51,0.51,+0.02,4.08,28000,3,14560,0,0,0,0,0,0,27000,1000,26000,26000
20200520,056524,欣興中信98購02,0.45,0.49,0.43,0.45,+0.02,4.65,182000,17,82610,0,0,0,0,0,0,70000,102000,-32000,-32000
20200520,056525,T50反1凱基99購06,,,,,0.00,0.00,0,0,0,0,0,0,0,0,0,0,0,0,0
20200520,056526,力山凱基98購01,3.46,3.46,3.35,3.43,+0.13,3.94,65000,4,221840,0,0,0,0,0,0,3000,65000,-62000,-62000
20200520,056527,大成鋼凱基98購03,0.46,0.46,0.46,0.46,0.00,0.00,2000,1,920,0,0,0,0,0,0,2000,0,2000,2000
20200520,056528,為升凱基98購01,,,,,0.00,0.00,0,0,0,0,0,0,0,0,0,0,0,0,0
20200520,056529,中環凱基98購01,0.93,0.97,0.93,0.97,+0.05,5.43,300000,7,283360,0,0,0,0,0,0,0,300000,-300000,-300000
20200520,05652P,臻鼎群益96售01,,,,,0.00,0.00,0,0,0,0,0,0,0,0,0,0,0,0,0
20200520,056530,旺宏凱基98購06,,,,,0.00,0.00,0,0,0,0,0,0,0,0,0,0,0,0,0
20200520,056531,佳世達凱基98購01,,,,,0.00,0.00,0,0,0,0,0,0,0,0,0,0,0,0,0
20200520,056532,技嘉凱基98購01,4.26,4.31,4.26,4.31,-0.45,-9.45,26000,2,112010,0,0,0,0,0,0,26000,0,26000,26000
20200520,056533,友達凱基9A購02,0.83,0.83,0.82,0.82,0.00,0.00,131000,2,108220,0,0,0,0,0,0,0,131000,-131000,-131000
20200520,056534,京元電凱基98購01,2.46,2.50,2.33,2.35,-0.30,-11.32,82000,15,200120,0,0,0,0,0,0,0,82000,-82000,-82000
20200520,056535,全新凱基99購02,1.28,1.28,1.23,1.23,0.00,0.00,51000,2,65130,0,0,0,0,0,0,48000,3000,45000,45000
20200520,056536,義隆凱基98購04,3.08,3.15,3.08,3.15,-0.10,-3.08,26000,2,81270,0,0,0,0,0,0,26000,9000,17000,17000
20200520,056537,冠德凱基98購01,1.82,1.82,1.67,1.67,-0.24,-12.57,26000,5,45220,0,0,0,0,0,0,10000,16000,-6000,-6000
20200520,056538,國泰金凱基98購01,0.55,0.57,0.55,0.57,+0.05,9.62,48000,5,27060,0,0,0,0,0,0,18000,30000,-12000,-12000
20200520,056539,新光金凱基9A購01,,,,,0.00,0.00,0,0,0,0,0,0,0,0,0,0,0,0,0
20200520,05653P,華邦電統一96售02,,,,,0.00,0.00,0,0,0,0,0,0,0,0,0,0,0,0,0
20200520,056540,聯詠凱基98購02,0.69,0.79,0.68,0.79,-0.02,-2.47,300000,28,221970,0,0,0,0,0,0,300000,0,300000,300000
20200520,056541,智原凱基98購03,,,,,0.00,0.00,0,0,0,0,0,0,0,0,0,0,0,0,0
20200520,056542,緯創凱基98購01,,,,,0.00,0.00,0,0,0,0,0,0,0,0,0,0,0,0,0
20200520,056543,京鼎凱基98購01,0.87,0.89,0.85,0.85,-0.07,-7.61,166000,8,143120,0,0,0,0,0,0,61000,165000,-104000,-104000
20200520,056544,貿聯凱基98購03,1.24,1.24,1.23,1.23,-0.03,-2.38,40000,3,49400,0,0,0,0,0,0,20000,20000,0,0
20200520,056545,TPK凱基98購02,0.73,0.77,0.73,0.73,-0.01,-1.35,259000,25,192910,0,0,0,0,0,0,249000,104000,145000,145000
20200520,056546,致伸凱基98購01,,,,,0.00,0.00,0,0,0,0,0,0,0,0,0,0,0,0,0
20200520,056547,臻鼎凱基99購01,,,,,0.00,0.00,0,0,0,0,0,0,0,0,0,0,0,0,0
20200520,056548,瀚宇博凱基98購02,2.41,2.41,2.31,2.38,0.00,0.00,35000,4,82600,0,0,0,0,0,0,15000,20000,-5000,-5000
20200520,056549,嘉聯益凱基98購04,,,,,0.00,0.00,0,0,0,0,0,0,0,0,0,0,0,0,0
20200520,05654P,台光電統一96售01,,,,,0.00,0.00,0,0,0,0,0,0,0,0,0,0,0,0,0
20200520,056550,瑞儀凱基99購01,,,,,0.00,0.00,0,0,0,0,0,0,0,0,0,0,0,0,0
20200520,056551,台郡凱基98購04,2.46,2.46,2.46,2.46,-0.13,-5.02,10000,1,24600,0,0,0,0,0,0,10000,0,10000,10000
20200520,056552,台表科凱基99購01,1.95,2.45,1.80,2.45,+0.67,37.64,306000,45,644590,0,25000,-25000,0,0,0,61000,243000,-182000,-207000
20200520,056553,啟碁凱基98購02,,,,,0.00,0.00,0,0,0,0,0,0,0,0,0,0,0,0,0
20200520,056554,GIS凱基99購01,,,,,0.00,0.00,0,0,0,0,0,0,0,0,0,0,0,0,0
20200520,056555,矽創凱基98購01,1.06,1.09,0.98,0.98,-0.08,-7.55,15000,11,15590,0,0,0,0,0,0,7000,5000,2000,2000
20200520,056556,南電凱基98購01,6.55,6.55,6.30,6.30,+0.30,5.0,52000,3,338100,0,0,0,0,0,0,32000,20000,12000,12000
20200520,056557,世紀鋼凱基98購02,,,,,0.00,0.00,0,0,0,0,0,0,0,0,0,0,0,0,0
20200520,056558,台達電群益98購01,2.19,2.19,2.19,2.19,+0.03,1.39,1000,1,2190,0,0,0,0,0,0,1000,0,1000,1000
20200520,056559,華通群益98購02,0.61,0.67,0.61,0.62,-0.04,-6.06,391000,9,243820,0,0,0,0,0,0,357000,34000,323000,323000
20200520,05655P,南亞科統一96售01,,,,,0.00,0.00,0,0,0,0,0,0,0,0,0,0,0,0,0
20200520,056560,旺宏群益98購03,1.50,1.54,1.46,1.49,+0.01,0.68,245000,8,365700,0,0,0,0,0,0,135000,120000,15000,15000
20200520,056561,台光電群益98購02,,,,,0.00,0.00,0,0,0,0,0,0,0,0,0,0,0,0,0
20200520,056562,奇力新群益98購01,0.57,0.61,0.57,0.61,+0.07,12.96,97000,3,56100,0,0,0,0,0,0,96000,1000,95000,95000
20200520,056563,華新科群益98購04,2.34,2.49,2.34,2.49,+0.13,5.51,90000,2,216450,0,0,0,0,0,0,90000,39000,51000,51000
20200520,056564,亞光群益98購02,,,,,0.00,0.00,0,0,0,0,0,0,0,0,0,0,0,0,0
20200520,056565,欣興群益98購03,,,,,0.00,0.00,0,0,0,0,0,0,0,0,0,0,0,0,0
20200520,056566,臻鼎群益98購01,1.15,1.15,1.15,1.15,-0.05,-4.17,49000,1,56350,0,0,0,0,0,0,49000,0,49000,49000
20200520,056567,瀚宇博群益98購02,2.41,2.41,2.41,2.41,0.00,0.00,100000,1,241000,0,0,0,0,0,0,100000,0,100000,100000
20200520,056568,台表科群益98購01,3.72,4.17,3.67,4.17,+0.54,14.88,73000,10,278410,0,0,0,0,0,0,53000,20000,33000,33000
20200520,056569,T50正2元大9B購02,,,,,0.00,0.00,0,0,0,0,0,0,0,0,0,0,0,0,0
20200520,05656P,台表科統一96售01,0.17,0.17,0.17,0.17,-0.18,-51.43,3000,3,510,0,0,0,0,0,0,3000,0,3000,3000
20200520,056570,旺宏元大98購07,,,,,0.00,0.00,0,0,0,0,0,0,0,0,0,0,0,0,0
20200520,056571,燿華元大98購02,0.93,1.22,0.93,1.22,+0.28,29.79,365000,9,381630,0,0,0,0,0,0,0,365000,-365000,-365000
20200520,056572,義隆元大99購01,1.47,1.53,1.44,1.52,+0.03,2.01,115000,11,169090,0,0,0,0,0,0,104000,16000,88000,88000
20200520,056573,華新科元大99購06,1.34,1.35,1.33,1.33,+0.03,2.31,74000,3,99160,0,0,0,0,0,0,10000,64000,-54000,-54000
20200520,056574,亞光元大99購03,1.29,1.29,1.29,1.29,+0.03,2.38,2000,1,2580,0,0,0,0,0,0,0,2000,-2000,-2000
20200520,056575,禾伸堂元大99購01,,,,,0.00,0.00,0,0,0,0,0,0,0,0,0,0,0,0,0
20200520,056576,晶技元大99購02,4.88,4.88,4.57,4.57,-0.18,-3.79,13000,3,62930,0,0,0,0,0,0,4000,9000,-5000,-5000
20200520,056577,玉晶光元大99購06,0.72,0.81,0.72,0.80,+0.05,6.67,101000,16,78910,0,0,0,0,0,0,71000,20000,51000,51000
20200520,056578,智易元大99購02,2.44,2.46,2.43,2.46,+0.04,1.65,35000,3,85380,0,0,0,0,0,0,31000,4000,27000,27000
20200520,056579,麗豐元大99購01,0.94,0.98,0.90,0.91,-0.05,-5.21,575000,18,543400,0,0,0,0,0,0,555000,280000,275000,275000
20200520,05657P,樺漢統一97售01,,,,,0.00,0.00,0,0,0,0,0,0,0,0,0,0,0,0,0
20200520,056580,泰鼎元大9A購01,1.60,1.78,1.56,1.78,+0.08,4.71,46000,5,77840,0,0,0,0,0,0,46000,17000,29000,29000
20200520,056581,超眾元大99購01,3.45,3.45,3.45,3.45,+0.17,5.18,11000,1,37950,0,0,0,0,0,0,0,11000,-11000,-11000
20200520,056582,易華電元大98購01,0.93,0.93,0.92,0.92,-0.02,-2.13,136000,2,125800,0,0,0,0,0,0,68000,68000,0,0
20200520,056583,昇陽半元大98購02,0.58,0.63,0.58,0.63,0.00,0.00,19000,3,11620,0,0,0,0,0,0,9000,10000,-1000,-1000
20200520,056584,鴻海統一9B購01,1.03,1.03,0.97,0.97,-0.04,-3.96,331000,11,323840,0,0,0,0,0,0,313000,20000,293000,293000
20200520,056585,台積電統一9A購01,,,,,0.00,0.00,0,0,0,0,0,0,0,0,0,0,0,0,0
20200520,056586,光罩統一98購02,0.66,0.71,0.65,0.71,+0.09,14.52,512000,15,344270,0,0,0,0,0,0,210000,257000,-47000,-47000
20200520,056587,聯發科統一9A購01,3.07,3.44,3.07,3.44,0.00,0.00,60000,5,191400,0,0,0,0,0,0,60000,0,60000,60000
20200520,056588,聯發科統一9A購02,4.55,4.74,4.51,4.65,+0.27,6.16,213000,23,979730,0,0,0,0,0,0,152000,61000,91000,91000
20200520,056589,康控統一98購01,0.63,0.63,0.55,0.55,-0.25,-31.25,557000,46,334520,0,0,0,0,0,0,555000,2000,553000,553000
20200520,05658P,日月光元富96售02,4.88,5.15,4.66,5.15,+0.10,1.98,118000,12,587340,0,0,0,0,0,0,24000,94000,-70000,-70000
20200520,056590,樺漢統一9A購01,,,,,0.00,0.00,0,0,0,0,0,0,0,0,0,0,0,0,0
20200520,056591,S&P正2元富9A購01,,,,,0.00,0.00,0,0,0,0,0,0,0,0,0,0,0,0,0
20200520,056592,台積電元富98購01,,,,,0.00,0.00,0,0,0,0,0,0,0,0,0,0,0,0,0
20200520,056593,台積電元富98購02,,,,,0.00,0.00,0,0,0,0,0,0,0,0,0,0,0,0,0
20200520,056594,台積電元富98購03,,,,,0.00,0.00,0,0,0,0,0,0,0,0,0,0,0,0,0
20200520,056595,台積電元富98購04,,,,,0.00,0.00,0,0,0,0,0,0,0,0,0,0,0,0,0
20200520,056596,光磊元富98購01,1.13,1.23,1.13,1.23,+0.04,3.36,140000,12,161800,0,0,0,0,0,0,30000,110000,-80000,-80000
20200520,056597,宏碁元富98購01,,,,,0.00,0.00,0,0,0,0,0,0,0,0,0,0,0,0,0
20200520,056598,京元電元富98購01,0.70,0.70,0.55,0.55,-0.12,-17.91,25000,4,15520,0,0,0,0,0,0,10000,12000,-2000,-2000
20200520,056599,臻鼎元富98購01,1.07,1.32,1.07,1.32,+0.25,23.36,364000,10,444180,0,0,0,0,0,0,0,364000,-364000,-364000
20200520,05659P,A50正2中信97售01,,,,,0.00,0.00,0,0,0,0,0,0,0,0,0,0,0,0,0
20200520,056600,聯茂元富98購01,,,,,0.00,0.00,0,0,0,0,0,0,0,0,0,0,0,0,0
20200520,056601,鈺齊元富98購01,,,,,0.00,0.00,0,0,0,0,0,0,0,0,0,0,0,0,0
20200520,056602,嘉澤國泰99購01,,,,,0.00,0.00,0,0,0,0,0,0,0,0,0,0,0,0,0
20200520,056603,嘉聯益國泰9A購01,1.61,1.67,1.61,1.64,+0.08,5.13,240000,7,391410,0,0,0,0,0,0,75000,165000,-90000,-90000
20200520,056604,鴻海富邦9A購01,0.26,0.26,0.26,0.26,-0.03,-10.34,14000,3,3640,0,0,0,0,0,0,9000,0,9000,9000
20200520,056605,台積電富邦9B購02,0.40,0.40,0.38,0.38,+0.01,2.7,240000,6,93400,0,0,0,0,0,0,0,180000,-180000,-180000
20200520,056606,華新科富邦9A購02,0.35,0.35,0.35,0.35,0.00,0.00,15000,2,5250,0,0,0,0,0,0,0,0,0,0
20200520,056607,貿聯富邦99購02,,,,,0.00,0.00,0,0,0,0,0,0,0,0,0,0,0,0,0
20200520,056608,力山永豐98購01,,,,,0.00,0.00,0,0,0,0,0,0,0,0,0,0,0,0,0
20200520,056609,楠梓電永豐98購02,0.82,0.82,0.74,0.77,0.00,0.00,43000,3,33000,0,0,0,0,0,0,10000,43000,-33000,-33000
20200520,05660P,玉晶光第一96售01,0.12,0.12,0.11,0.11,0.00,0.00,594000,6,69300,0,0,0,0,0,0,0,594000,-594000,-594000
20200520,056610,鴻海永豐98購01,0.20,0.20,0.20,0.20,-0.02,-9.09,34000,3,6800,0,0,0,0,0,0,16000,18000,-2000,-2000
20200520,056611,國巨永豐98購03,1.35,1.54,1.35,1.44,+0.12,9.09,747000,22,1063360,0,0,0,0,0,0,311000,336000,-25000,-25000
20200520,056612,台積電永豐98購01,,,,,0.00,0.00,0,0,0,0,0,0,0,0,0,0,0,0,0
20200520,056613,旺宏永豐98購01,,,,,0.00,0.00,0,0,0,0,0,0,0,0,0,0,0,0,0
20200520,056614,智邦永豐98購01,1.99,2.07,1.97,2.07,+0.09,4.55,48000,3,96160,0,0,0,0,0,0,30000,18000,12000,12000
20200520,056615,燿華永豐98購02,0.64,0.64,0.64,0.64,+0.14,28.0,1000,1,640,0,0,0,0,0,0,1000,0,1000,1000
20200520,056616,台光電永豐98購01,1.12,1.13,1.11,1.11,-0.11,-9.02,77000,5,86040,0,0,0,0,0,0,47000,30000,17000,17000
20200520,056617,美律永豐98購01,0.46,0.46,0.43,0.43,-0.05,-10.42,65000,4,29600,0,0,0,0,0,0,30000,35000,-5000,-5000
20200520,056618,京元電永豐98購01,,,,,0.00,0.00,0,0,0,0,0,0,0,0,0,0,0,0,0
20200520,056619,強茂永豐98購01,,,,,0.00,0.00,0,0,0,0,0,0,0,0,0,0,0,0,0
20200520,05661P,聯發科統一96售06,0.60,0.61,0.60,0.61,-0.09,-12.86,46000,43,27820,0,0,0,0,0,0,46000,0,46000,46000
20200520,056620,華新科永豐98購02,,,,,0.00,0.00,0,0,0,0,0,0,0,0,0,0,0,0,0
20200520,056621,宏達電永豐98購01,0.56,0.57,0.56,0.57,0.00,0.00,20000,2,11300,0,0,0,0,0,0,0,20000,-20000,-20000
20200520,056622,高鐵永豐98購01,1.00,1.05,1.00,1.02,+0.06,6.25,328000,8,334020,0,0,0,0,0,0,0,328000,-328000,-328000
20200520,056623,禾伸堂永豐98購01,1.62,1.69,1.54,1.69,+0.16,10.46,85000,5,133700,0,0,0,0,0,0,65000,10000,55000,55000
20200520,056624,景碩永豐98購01,,,,,0.00,0.00,0,0,0,0,0,0,0,0,0,0,0,0,0
20200520,056625,致伸永豐98購01,0.46,0.49,0.44,0.49,0.00,0.00,57000,3,27130,0,0,0,0,0,0,0,57000,-57000,-57000
20200520,056626,同欣電永豐98購01,0.53,0.53,0.52,0.52,-0.02,-3.7,430000,4,223900,0,0,0,0,0,0,400000,30000,370000,370000
20200520,056627,訊芯永豐98購01,,,,,0.00,0.00,0,0,0,0,0,0,0,0,0,0,0,0,0
20200520,056628,矽創永豐98購01,,,,,0.00,0.00,0,0,0,0,0,0,0,0,0,0,0,0,0
20200520,056629,昇陽半永豐98購01,,,,,0.00,0.00,0,0,0,0,0,0,0,0,0,0,0,0,0
20200520,05662P,景碩元富96售01,,,,,0.00,0.00,0,0,0,0,0,0,0,0,0,0,0,0,0
20200520,056630,臺股指永豐98購02,,,,,0.00,0.00,0,0,0,0,0,0,0,0,0,0,0,0,0
20200520,056631,臺股指永豐98購03,,,,,0.00,0.00,0,0,0,0,0,0,0,0,0,0,0,0,0
20200520,056632,鴻海永昌98購01,,,,,0.00,0.00,0,0,0,0,0,0,0,0,0,0,0,0,0
20200520,056633,鴻海永昌98購02,,,,,0.00,0.00,0,0,0,0,0,0,0,0,0,0,0,0,0
20200520,056634,為升兆豐99購01,0.44,0.44,0.36,0.36,-0.08,-18.18,75000,6,28730,0,0,0,0,0,0,40000,10000,30000,30000
20200520,056635,亞德客日盛99購01,,,,,0.00,0.00,0,0,0,0,0,0,0,0,0,0,0,0,0
20200520,056636,台積電日盛9A購01,,,,,0.00,0.00,0,0,0,0,0,0,0,0,0,0,0,0,0
20200520,056637,台光電日盛9A購01,,,,,0.00,0.00,0,0,0,0,0,0,0,0,0,0,0,0,0
20200520,056638,臺股指日盛98購01,0.37,0.40,0.35,0.37,+0.02,5.71,1215000,23,453540,0,0,0,0,0,0,1101000,114000,987000,987000
20200520,056639,國產康和98購01,0.65,0.65,0.62,0.63,-0.02,-3.08,170000,24,107000,0,0,0,0,0,0,165000,0,165000,165000
20200520,05663P,創意元富96售04,,,,,0.00,0.00,0,0,0,0,0,0,0,0,0,0,0,0,0
20200520,056640,元油2X凱基9A購01,0.01,0.01,0.01,0.01,0.00,0.00,99000,1,990,0,0,0,0,0,0,0,0,0,0
20200520,056641,華通凱基98購03,2.47,2.47,2.47,2.47,-0.16,-6.08,19000,1,46930,0,0,0,0,0,0,0,19000,-19000,-19000
20200520,056642,旺宏凱基98購07,1.83,1.83,1.83,1.83,+0.03,1.67,10000,1,18300,0,0,0,0,0,0,10000,0,10000,10000
20200520,056643,奇力新凱基99購01,,,,,0.00,0.00,0,0,0,0,0,0,0,0,0,0,0,0,0
20200520,056644,宏達電凱基98購04,1.10,1.12,1.10,1.12,0.00,0.00,46000,4,50680,0,0,0,0,0,0,4000,46000,-42000,-42000
20200520,056645,大立光凱基98購12,,,,,0.00,0.00,0,0,0,0,0,0,0,0,0,0,0,0,0
20200520,056646,奇鋐凱基99購02,,,,,0.00,0.00,0,0,0,0,0,0,0,0,0,0,0,0,0
20200520,056647,晶技凱基98購02,,,,,0.00,0.00,0,0,0,0,0,0,0,0,0,0,0,0,0
20200520,056648,牧德凱基99購02,,,,,0.00,0.00,0,0,0,0,0,0,0,0,0,0,0,0,0
20200520,056649,智易凱基98購01,2.57,2.61,2.47,2.47,-0.10,-3.89,98000,4,251390,0,0,0,0,0,0,48000,50000,-2000,-2000
20200520,05664P,國巨凱基96售09,,,,,0.00,0.00,0,0,0,0,0,0,0,0,0,0,0,0,0
20200520,056650,彩晶凱基9A購01,,,,,0.00,0.00,0,0,0,0,0,0,0,0,0,0,0,0,0
20200520,056651,聯茂凱基98購04,,,,,0.00,0.00,0,0,0,0,0,0,0,0,0,0,0,0,0
20200520,056652,上証反元大9B購01,0.15,0.15,0.15,0.15,0.00,0.00,12000,2,1800,0,0,0,0,0,0,0,0,0,0
20200520,056653,元石油元大98購01,0.06,0.07,0.04,0.06,-0.01,-14.29,435000,16,24580,0,0,0,0,0,0,0,0,0,0
20200520,056654,元油2X元大98購02,,,,,0.00,0.00,0,0,0,0,0,0,0,0,0,0,0,0,0
20200520,056655,旺宏元大99購02,,,,,0.00,0.00,0,0,0,0,0,0,0,0,0,0,0,0,0
20200520,056656,華邦電元大98購02,,,,,0.00,0.00,0,0,0,0,0,0,0,0,0,0,0,0,0
20200520,056657,華邦電元大99購01,1.32,1.38,1.32,1.38,+0.12,9.52,86000,5,118200,0,0,0,0,0,0,0,86000,-86000,-86000
20200520,056658,美食元大98購01,1.60,1.60,1.37,1.37,-0.21,-13.29,150000,2,237700,0,0,0,0,0,0,150000,0,150000,150000
20200520,056659,泰碩元大99購01,1.56,1.59,1.50,1.50,-0.10,-6.25,87000,10,134980,0,0,0,0,0,0,52000,55000,-3000,-3000
20200520,05665P,台積電凱基96售08,0.65,0.65,0.65,0.65,0.00,0.00,100000,1,65000,0,0,0,0,0,0,100000,100000,0,0
20200520,056660,臺股指元大9A購07,,,,,0.00,0.00,0,0,0,0,0,0,0,0,0,0,0,0,0
20200520,056661,臺股指元大9A購08,,,,,0.00,0.00,0,0,0,0,0,0,0,0,0,0,0,0,0
20200520,056662,臺股指元大9A購09,0.85,0.85,0.84,0.85,0.00,0.00,16000,4,13500,0,0,0,0,0,0,13000,0,13000,13000
20200520,056663,臺股指元大9A購10,0.95,0.95,0.95,0.95,+0.08,9.2,10000,1,9500,0,0,0,0,0,0,10000,0,10000,10000
20200520,056664,上証反中信9B購01,,,,,0.00,0.00,0,0,0,0,0,0,0,0,0,0,0,0,0
20200520,056665,上証2X國票99購02,,,,,0.00,0.00,0,0,0,0,0,0,0,0,0,0,0,0,0
20200520,056666,元油2X國票9A購01,0.04,0.04,0.04,0.04,0.00,0.00,1000,1,40,0,0,0,0,0,0,0,0,0,0
20200520,056667,上銀國票99購01,,,,,0.00,0.00,0,0,0,0,0,0,0,0,0,0,0,0,0
20200520,056668,光磊國票99購01,,,,,0.00,0.00,0,0,0,0,0,0,0,0,0,0,0,0,0
20200520,056669,貿聯國票99購01,1.45,1.45,1.40,1.40,-0.02,-1.41,214000,5,307850,0,0,0,0,0,0,214000,0,214000,214000
20200520,05666P,聯發科凱基96售14,0.65,0.65,0.65,0.65,-0.17,-20.73,50000,5,32500,0,0,0,0,0,0,0,50000,-50000,-50000
20200520,056670,樺漢國票99購01,1.57,1.59,1.57,1.59,+0.08,5.3,350000,3,556040,0,0,0,0,0,0,350000,0,350000,350000
20200520,056671,台灣50元富9A購01,0.40,0.40,0.39,0.39,-0.01,-2.5,2000,2,790,0,0,0,0,0,0,0,2000,-2000,-2000
20200520,056672,元油2X元富98購10,0.05,0.09,0.05,0.09,+0.03,50.0,35000,2,2550,0,0,0,0,0,0,0,0,0,0
20200520,056673,中石化元富9B購01,1.00,1.00,0.92,0.96,-0.06,-5.88,1014000,25,985660,0,0,0,0,0,0,762000,252000,510000,510000
20200520,056674,華邦電元富98購01,0.61,0.64,0.61,0.61,+0.05,8.93,308000,8,193240,0,0,0,0,0,0,30000,278000,-248000,-248000
20200520,056675,聯發科元富02購01,2.33,2.33,2.33,2.33,+0.18,8.37,1000,1,2330,0,0,0,0,0,0,1000,0,1000,1000
20200520,056676,國產元富98購01,1.27,1.27,1.24,1.27,-0.04,-3.05,1106000,37,1400890,0,0,0,0,0,0,948000,148000,800000,800000
20200520,056677,智伸科元富98購01,1.05,1.09,0.98,1.02,+0.04,4.08,1433000,70,1490640,0,0,0,0,0,0,918000,390000,528000,528000
20200520,056678,力成元富98購01,,,,,0.00,0.00,0,0,0,0,0,0,0,0,0,0,0,0,0
20200520,056679,元油2X統一98購01,,,,,0.00,0.00,0,0,0,0,0,0,0,0,0,0,0,0,0
20200520,05667P,旺宏台新96售01,,,,,0.00,0.00,0,0,0,0,0,0,0,0,0,0,0,0,0
20200520,056680,華通統一98購04,0.38,0.43,0.38,0.38,-0.06,-13.64,232000,5,88240,0,0,0,0,0,0,220000,12000,208000,208000
20200520,056681,鴻海統一98購09,,,,,0.00,0.00,0,0,0,0,0,0,0,0,0,0,0,0,0
20200520,056682,鴻海統一98購10,,,,,0.00,0.00,0,0,0,0,0,0,0,0,0,0,0,0,0
20200520,056683,台積電統一98購05,0.46,0.46,0.46,0.46,-0.02,-4.17,50000,2,23000,0,0,0,0,0,0,50000,0,50000,50000
20200520,056684,旺宏統一98購02,1.07,1.07,1.07,1.07,-0.03,-2.73,20000,1,21400,0,0,0,0,0,0,0,20000,-20000,-20000
20200520,056685,光罩統一98購03,0.30,0.33,0.28,0.33,+0.07,26.92,121000,6,35600,0,0,0,0,0,0,1000,120000,-119000,-119000
20200520,056686,可成統一98購01,,,,,0.00,0.00,0,0,0,0,0,0,0,0,0,0,0,0,0
20200520,056687,元大金統一98購01,,,,,0.00,0.00,0,0,0,0,0,0,0,0,0,0,0,0,0
20200520,056688,聯詠統一98購01,0.48,0.49,0.46,0.49,-0.02,-3.92,331000,16,155690,0,0,0,0,0,0,331000,0,331000,331000
20200520,056689,玉晶光統一9A購03,,,,,0.00,0.00,0,0,0,0,0,0,0,0,0,0,0,0,0
20200520,05668P,滬深2X永豐96售04,,,,,0.00,0.00,0,0,0,0,0,0,0,0,0,0,0,0,0
20200520,056691,元油2X群益9B購01,0.10,0.10,0.10,0.10,0.00,0.00,1000,1,100,0,0,0,0,0,0,0,0,0,0
20200520,056692,燿華群益98購03,,,,,0.00,0.00,0,0,0,0,0,0,0,0,0,0,0,0,0
20200520,056693,國產群益98購01,0.74,0.74,0.73,0.73,-0.03,-3.95,196000,2,144060,0,0,0,0,0,0,98000,98000,0,0
20200520,056694,欣興群益98購04,3.18,3.58,3.08,3.10,-0.03,-0.96,122000,20,404510,0,0,0,0,0,0,45000,96000,-51000,-51000
20200520,056695,景碩群益99購01,,,,,0.00,0.00,0,0,0,0,0,0,0,0,0,0,0,0,0
20200520,056696,茂林群益98購02,0.66,0.72,0.63,0.72,0.00,0.00,46000,8,31020,0,0,0,0,0,0,0,46000,-46000,-46000
20200520,056697,緯穎群益98購01,,,,,0.00,0.00,0,0,0,0,0,0,0,0,0,0,0,0,0
20200520,056698,T50反1國泰9A購01,,,,,0.00,0.00,0,0,0,0,0,0,0,0,0,0,0,0,0
20200520,056699,光罩國泰99購01,0.77,0.84,0.77,0.84,+0.11,15.07,6000,2,4970,0,0,0,0,0,0,1000,5000,-4000,-4000
20200520,05669P,嘉晶永豐96售03,0.11,0.11,0.11,0.11,0.00,0.00,20000,1,2200,0,0,0,0,0,0,0,20000,-20000,-20000
20200520,056700,華新科國泰99購03,0.70,0.75,0.70,0.75,-0.05,-6.25,54000,2,38350,0,0,0,0,0,0,54000,0,54000,54000
20200520,056701,國產國泰9A購01,,,,,0.00,0.00,0,0,0,0,0,0,0,0,0,0,0,0,0
20200520,056702,欣興國泰9A購01,1.29,1.29,1.28,1.28,0.00,0.00,11000,2,14180,0,0,0,0,0,0,0,11000,-11000,-11000
20200520,056703,群創國泰9A購01,,,,,0.00,0.00,0,0,0,0,0,0,0,0,0,0,0,0,0
20200520,056704,健策國泰99購01,0.93,0.99,0.93,0.99,+0.16,19.28,7000,3,6810,0,0,0,0,0,0,0,7000,-7000,-7000
20200520,056705,超眾國泰99購01,2.40,2.47,2.38,2.38,-0.05,-2.06,127000,7,304730,0,0,0,0,0,0,106000,21000,85000,85000
20200520,056706,元油2X富邦9B購01,0.04,0.04,0.04,0.04,-0.01,-20.0,176000,4,7040,0,0,0,0,0,0,0,61000,-61000,-61000
20200520,056707,鴻海富邦99購03,0.47,0.51,0.47,0.48,+0.01,2.13,35000,3,17200,0,0,0,0,0,0,20000,30000,-10000,-10000
20200520,056708,元油2X永豐98購02,,,,,0.00,0.00,0,0,0,0,0,0,0,0,0,0,0,0,0
20200520,056709,華通永豐98購01,1.96,1.97,1.96,1.97,0.00,0.00,10000,3,19670,0,0,0,0,0,0,0,10000,-10000,-10000
20200520,05670P,台積電國票98售01,,,,,0.00,0.00,0,0,0,0,0,0,0,0,0,0,0,0,0
20200520,056710,漢唐永豐98購01,0.71,0.71,0.71,0.71,-0.05,-6.58,86000,2,61060,0,0,0,0,0,0,86000,0,86000,86000
20200520,056711,亞光永豐98購01,,,,,0.00,0.00,0,0,0,0,0,0,0,0,0,0,0,0,0
20200520,056712,京鼎永豐98購01,,,,,0.00,0.00,0,0,0,0,0,0,0,0,0,0,0,0,0
20200520,056713,華擎永豐98購01,1.69,2.11,1.69,2.03,+0.49,31.82,255000,42,500470,0,0,0,0,0,0,49000,206000,-157000,-157000
20200520,056714,晶相光永豐98購02,0.71,0.75,0.71,0.75,+0.02,2.74,174000,2,125860,0,0,0,0,0,0,116000,58000,58000,58000
20200520,056715,瀚宇博永豐98購01,0.73,0.73,0.67,0.70,-0.05,-6.67,63000,9,44230,0,0,0,0,0,0,53000,53000,0,0
20200520,056716,康舒永豐98購01,0.44,0.44,0.42,0.42,-0.01,-2.33,150000,7,64610,0,0,0,0,0,0,25000,90000,-65000,-65000
20200520,056717,康友永豐98購01,0.05,0.05,0.05,0.05,-0.01,-16.67,50000,5,2500,0,0,0,0,0,0,0,50000,-50000,-50000
20200520,056718,GIS永豐98購01,,,,,0.00,0.00,0,0,0,0,0,0,0,0,0,0,0,0,0
20200520,056719,台虹永豐98購01,,,,,0.00,0.00,0,0,0,0,0,0,0,0,0,0,0,0,0
20200520,05671P,友達國泰97售03,,,,,0.00,0.00,0,0,0,0,0,0,0,0,0,0,0,0,0
20200520,056720,世紀鋼永豐98購01,,,,,0.00,0.00,0,0,0,0,0,0,0,0,0,0,0,0,0
20200520,056721,台灣50永昌9A購01,,,,,0.00,0.00,0,0,0,0,0,0,0,0,0,0,0,0,0
20200520,056722,滬深反中信9B購01,,,,,0.00,0.00,0,0,0,0,0,0,0,0,0,0,0,0,0
20200520,056723,國巨中信9A購01,0.88,0.91,0.88,0.91,+0.14,18.18,36000,3,32460,0,0,0,0,0,0,0,36000,-36000,-36000
20200520,056724,臻鼎中信9A購01,0.22,0.26,0.22,0.26,+0.05,23.81,256000,9,63600,0,0,0,0,0,0,206000,50000,156000,156000
20200520,056725,鴻海國票99購03,,,,,0.00,0.00,0,0,0,0,0,0,0,0,0,0,0,0,0
20200520,056726,友達日盛9A購01,0.47,0.47,0.47,0.47,-0.01,-2.08,126000,1,59220,0,0,0,0,0,0,126000,0,126000,126000
20200520,056727,滬深反凱基9B購01,,,,,0.00,0.00,0,0,0,0,0,0,0,0,0,0,0,0,0
20200520,056728,元油2X凱基9A購02,,,,,0.00,0.00,0,0,0,0,0,0,0,0,0,0,0,0,0
20200520,056729,元油2X凱基9A購03,,,,,0.00,0.00,0,0,0,0,0,0,0,0,0,0,0,0,0
20200520,05672P,鴻海群益96售03,,,,,0.00,0.00,0,0,0,0,0,0,0,0,0,0,0,0,0
20200520,056730,元油2X凱基9A購04,,,,,0.00,0.00,0,0,0,0,0,0,0,0,0,0,0,0,0
20200520,056731,國巨凱基98購04,,,,,0.00,0.00,0,0,0,0,0,0,0,0,0,0,0,0,0
20200520,056732,國巨凱基98購07,,,,,0.00,0.00,0,0,0,0,0,0,0,0,0,0,0,0,0
20200520,056733,國巨凱基98購10,,,,,0.00,0.00,0,0,0,0,0,0,0,0,0,0,0,0,0
20200520,056734,國巨凱基99購01,0.83,0.85,0.76,0.76,+0.10,15.15,89000,4,71200,0,0,0,0,0,0,89000,0,89000,89000
20200520,056735,國巨凱基99購02,,,,,0.00,0.00,0,0,0,0,0,0,0,0,0,0,0,0,0
20200520,056736,國巨凱基99購03,2.31,2.31,2.20,2.20,+0.23,11.68,3000,2,6710,0,0,0,0,0,0,1000,2000,-1000,-1000
20200520,056737,國巨凱基9A購01,,,,,0.00,0.00,0,0,0,0,0,0,0,0,0,0,0,0,0
20200520,056738,國巨凱基9A購02,1.45,1.59,1.45,1.50,+0.14,10.29,128000,20,196440,0,0,0,0,0,0,2000,125000,-123000,-123000
20200520,056739,美律凱基98購04,,,,,0.00,0.00,0,0,0,0,0,0,0,0,0,0,0,0,0
20200520,05673P,台積電群益96售05,,,,,0.00,0.00,0,0,0,0,0,0,0,0,0,0,0,0,0
20200520,056740,大立光凱基98購13,,,,,0.00,0.00,0,0,0,0,0,0,0,0,0,0,0,0,0
20200520,056741,大立光凱基98購14,,,,,0.00,0.00,0,0,0,0,0,0,0,0,0,0,0,0,0
20200520,056742,玉晶光凱基9A購01,,,,,0.00,0.00,0,0,0,0,0,0,0,0,0,0,0,0,0
20200520,056743,貿聯凱基98購04,1.11,1.13,1.03,1.11,+0.04,3.74,56000,7,61620,0,0,0,0,0,0,18000,38000,-20000,-20000
20200520,056744,麗豐凱基9A購01,0.51,0.51,0.51,0.51,-0.03,-5.56,20000,1,10200,0,0,0,0,0,0,20000,0,20000,20000
20200520,056745,聯茂凱基99購03,2.61,2.61,2.61,2.61,-0.07,-2.61,10000,1,26100,0,0,0,0,0,0,10000,0,10000,10000
20200520,056746,超眾凱基99購01,2.13,2.13,2.03,2.03,-0.02,-0.98,77000,3,162770,0,0,0,0,0,0,18000,77000,-59000,-59000
20200520,056747,致新凱基99購01,1.85,1.99,1.85,1.90,+0.10,5.56,86000,16,167170,0,0,0,0,0,0,74000,10000,64000,64000
20200520,056748,T50反1兆豐99購01,,,,,0.00,0.00,0,0,0,0,0,0,0,0,0,0,0,0,0
20200520,056749,滬深2X兆豐99購01,1.04,1.05,1.01,1.05,+0.02,1.94,81000,8,84510,0,0,0,0,0,0,41000,10000,31000,31000
20200520,05674P,瑞昱群益96售02,,,,,0.00,0.00,0,0,0,0,0,0,0,0,0,0,0,0,0
20200520,056750,元油2X兆豐9A購01,0.02,0.02,0.02,0.02,+0.01,100.0,99000,1,1980,0,0,0,0,0,0,0,0,0,0
20200520,056751,和大兆豐98購01,0.14,0.14,0.14,0.14,+0.04,40.0,10000,1,1400,0,0,0,0,0,0,10000,10000,0,0
20200520,056752,國巨兆豐98購02,0.48,0.67,0.48,0.53,+0.11,26.19,130000,13,82000,0,0,0,0,0,0,10000,120000,-110000,-110000
20200520,056753,群創兆豐98購02,0.01,0.01,0.01,0.01,-0.01,-50.0,10000,1,100,0,0,0,0,0,0,0,10000,-10000,-10000
20200520,056754,智易兆豐99購01,,,,,0.00,0.00,0,0,0,0,0,0,0,0,0,0,0,0,0
20200520,056755,聯茂兆豐98購01,1.06,1.06,0.98,0.98,-0.07,-6.67,235000,17,238590,0,0,0,0,0,0,170000,30000,140000,140000
20200520,056756,T50反1元大98購06,0.39,0.39,0.39,0.39,0.00,0.00,60000,2,23400,0,0,0,0,0,0,60000,0,60000,60000
20200520,056757,T50反1元大98購07,,,,,0.00,0.00,0,0,0,0,0,0,0,0,0,0,0,0,0
20200520,056758,元石油元大98購02,0.07,0.07,0.07,0.07,-0.02,-22.22,56000,3,3920,0,0,0,0,0,0,0,0,0,0
20200520,056759,元油2X元大98購05,,,,,0.00,0.00,0,0,0,0,0,0,0,0,0,0,0,0,0
20200520,05675P,美律群益97售01,,,,,0.00,0.00,0,0,0,0,0,0,0,0,0,0,0,0,0
20200520,056760,元油2X元大98購06,0.02,0.02,0.02,0.02,0.00,0.00,50000,1,1000,0,0,0,0,0,0,0,0,0,0
20200520,056761,元油2X元大98購07,0.03,0.04,0.03,0.04,-0.01,-20.0,121000,6,3640,0,0,0,0,0,0,0,0,0,0
20200520,056762,亞德客元大98購01,2.41,2.53,2.36,2.36,0.00,0.00,275000,4,653480,0,0,0,0,0,0,195000,80000,115000,115000
20200520,056763,國巨元大99購02,3.40,3.40,3.15,3.15,+0.24,8.25,12000,3,39550,0,0,0,0,0,0,2000,12000,-10000,-10000
20200520,056764,友達元大9A購03,,,,,0.00,0.00,0,0,0,0,0,0,0,0,0,0,0,0,0
20200520,056765,友達元大9B購05,0.65,0.68,0.65,0.68,+0.01,1.49,179000,5,121220,0,0,0,0,0,0,179000,0,179000,179000
20200520,056766,義隆元大98購01,2.24,2.26,2.24,2.26,+0.05,2.26,42000,4,94500,0,0,0,0,0,0,5000,37000,-32000,-32000
20200520,056767,大毅元大99購01,1.66,1.77,1.61,1.61,-0.03,-1.83,266000,17,444800,0,0,0,0,0,0,112000,164000,-52000,-52000
20200520,056768,宏達電元大99購03,,,,,0.00,0.00,0,0,0,0,0,0,0,0,0,0,0,0,0
20200520,056769,國產元大98購01,0.94,0.96,0.91,0.96,-0.01,-1.03,739000,12,693740,0,0,0,0,0,0,646000,87000,559000,559000
20200520,05676P,欣興群益96售04,1.95,2.03,1.95,2.03,-0.22,-9.78,11000,2,21530,0,0,0,0,0,0,10000,1000,9000,9000
20200520,056770,國產元大98購02,1.01,1.01,0.99,0.99,-0.05,-4.81,12000,2,11920,0,0,0,0,0,0,12000,0,12000,12000
20200520,056771,嘉晶元大99購01,9.05,10.30,9.05,10.30,+1.70,19.77,61000,7,578750,0,0,0,0,0,0,38000,23000,15000,15000
20200520,056772,欣興元大99購01,3.49,3.71,3.40,3.46,-0.03,-0.86,91000,15,321160,0,0,0,0,0,0,71000,31000,40000,40000
20200520,056773,晶技元大99購03,,,,,0.00,0.00,0,0,0,0,0,0,0,0,0,0,0,0,0
20200520,056774,和鑫元大98購01,0.38,0.38,0.38,0.38,-0.01,-2.56,2000,1,760,0,0,0,0,0,0,2000,0,2000,2000
20200520,056775,康控元大99購01,,,,,0.00,0.00,0,0,0,0,0,0,0,0,0,0,0,0,0
20200520,056776,聯茂元大99購01,3.26,3.26,3.16,3.16,-0.28,-8.14,70000,3,227200,0,0,0,0,0,0,60000,10000,50000,50000
20200520,056777,矽力元大98購02,5.75,5.90,5.75,5.90,-0.30,-4.84,13000,2,75650,0,0,0,0,0,0,0,13000,-13000,-13000
20200520,056778,元石油群益9B購01,0.22,0.27,0.22,0.27,-0.02,-6.9,6000,2,1370,0,0,0,0,0,0,0,0,0,0
20200520,056779,元油2X群益9A購02,,,,,0.00,0.00,0,0,0,0,0,0,0,0,0,0,0,0,0
20200520,05677P,玉晶光群益98售03,,,,,0.00,0.00,0,0,0,0,0,0,0,0,0,0,0,0,0
20200520,056780,元油2X群益9A購03,0.04,0.06,0.04,0.06,0.00,0.00,292000,11,12710,0,0,0,0,0,0,0,50000,-50000,-50000
20200520,056781,元油2X群益9B購02,0.06,0.08,0.06,0.08,+0.01,14.29,121000,4,9380,0,0,0,0,0,0,0,0,0,0
20200520,056782,鴻海群益98購04,,,,,0.00,0.00,0,0,0,0,0,0,0,0,0,0,0,0,0
20200520,056783,國巨群益99購01,1.86,2.06,1.86,1.92,+0.20,11.63,441000,28,867230,0,0,0,0,0,0,153000,288000,-135000,-135000
20200520,056784,南亞科群益98購01,0.69,0.69,0.69,0.69,0.00,0.00,61000,1,42090,0,0,0,0,0,0,0,61000,-61000,-61000
20200520,056785,可成群益99購01,,,,,0.00,0.00,0,0,0,0,0,0,0,0,0,0,0,0,0
20200520,056786,亞光群益98購03,0.56,0.56,0.56,0.56,+0.04,7.69,15000,1,8400,0,0,0,0,0,0,15000,0,15000,15000
20200520,056787,健鼎群益98購01,1.11,1.11,1.11,1.11,-0.13,-10.48,98000,1,108780,0,0,0,0,0,0,98000,0,98000,98000
20200520,056788,日月光群益98購01,,,,,0.00,0.00,0,0,0,0,0,0,0,0,0,0,0,0,0
20200520,056789,和碩群益98購01,,,,,0.00,0.00,0,0,0,0,0,0,0,0,0,0,0,0,0
20200520,05678P,群創群益97售01,,,,,0.00,0.00,0,0,0,0,0,0,0,0,0,0,0,0,0
20200520,056790,彩晶群益98購03,,,,,0.00,0.00,0,0,0,0,0,0,0,0,0,0,0,0,0
20200520,056791,嘉聯益群益98購01,1.82,1.85,1.82,1.85,+0.01,0.54,56000,4,102800,0,0,0,0,0,0,0,56000,-56000,-56000
20200520,056792,訊芯群益98購01,0.16,0.16,0.16,0.16,0.00,0.00,10000,1,1600,0,0,0,0,0,0,0,10000,-10000,-10000
20200520,056793,臺股指群益98購03,,,,,0.00,0.00,0,0,0,0,0,0,0,0,0,0,0,0,0
20200520,056794,上銀麥證98購01,,,,,0.00,0.00,0,0,0,0,0,0,0,0,0,0,0,0,0
20200520,056795,鴻海麥證98購01,,,,,0.00,0.00,0,0,0,0,0,0,0,0,0,0,0,0,0
20200520,056796,國巨麥證98購02,2.07,2.07,1.96,1.96,+0.13,7.1,22000,3,43830,0,22000,-22000,0,0,0,0,22000,-22000,-22000
20200520,056797,台積電麥證98購01,,,,,0.00,0.00,0,0,0,0,0,0,0,0,0,0,0,0,0
20200520,056798,華新科麥證98購01,,,,,0.00,0.00,0,0,0,0,0,0,0,0,0,0,0,0,0
20200520,056799,群創麥證98購01,,,,,0.00,0.00,0,0,0,0,0,0,0,0,0,0,0,0,0
20200520,05679P,台表科群益96售05,,,,,0.00,0.00,0,0,0,0,0,0,0,0,0,0,0,0,0
20200520,056800,臺股指麥證98購01,,,,,0.00,0.00,0,0,0,0,0,0,0,0,0,0,0,0,0
20200520,056801,國巨台新98購01,0.88,0.88,0.81,0.81,0.00,0.00,192000,8,160930,0,0,0,0,0,0,85000,107000,-22000,-22000
20200520,056802,友達台新98購01,,,,,0.00,0.00,0,0,0,0,0,0,0,0,0,0,0,0,0
20200520,056803,群創台新99購02,,,,,0.00,0.00,0,0,0,0,0,0,0,0,0,0,0,0,0
20200520,056804,T50反1統一9A購03,,,,,0.00,0.00,0,0,0,0,0,0,0,0,0,0,0,0,0
20200520,056805,元石油統一9B購01,0.31,0.33,0.30,0.33,-0.01,-2.94,98000,8,30540,0,0,0,0,0,0,0,0,0,0
20200520,056806,元油2X統一98購02,,,,,0.00,0.00,0,0,0,0,0,0,0,0,0,0,0,0,0
20200520,056807,元油2X統一9B購01,0.06,0.07,0.06,0.07,0.00,0.00,201000,4,12310,0,0,0,0,0,0,0,0,0,0
20200520,056808,台積電統一98購06,0.17,0.17,0.17,0.17,0.00,0.00,5000,1,850,0,0,0,0,0,0,5000,0,5000,5000
20200520,056809,旺宏統一98購03,,,,,0.00,0.00,0,0,0,0,0,0,0,0,0,0,0,0,0
20200520,05680P,聯發科元大96售12,,,,,0.00,0.00,0,0,0,0,0,0,0,0,0,0,0,0,0
20200520,056810,群創統一9A購01,,,,,0.00,0.00,0,0,0,0,0,0,0,0,0,0,0,0,0
20200520,056811,健策統一9B購01,0.33,0.33,0.33,0.33,+0.02,6.45,2000,2,660,0,0,0,0,0,0,0,2000,-2000,-2000
20200520,056812,泰鼎統一98購01,,,,,0.00,0.00,0,0,0,0,0,0,0,0,0,0,0,0,0
20200520,056813,聯茂統一99購01,1.18,1.18,1.12,1.13,-0.08,-6.61,57000,25,64990,0,0,0,0,0,0,55000,0,55000,55000
20200520,056814,元油2X永豐98購04,,,,,0.00,0.00,0,0,0,0,0,0,0,0,0,0,0,0,0
20200520,056815,元油2X永豐98購05,,,,,0.00,0.00,0,0,0,0,0,0,0,0,0,0,0,0,0
20200520,056816,華通永豐98購02,,,,,0.00,0.00,0,0,0,0,0,0,0,0,0,0,0,0,0
20200520,056817,國巨永豐98購04,1.14,1.19,1.14,1.19,0.00,0.00,11000,2,13040,0,0,0,0,0,0,0,11000,-11000,-11000
20200520,056818,正崴永豐98購01,1.20,1.23,1.19,1.19,-0.07,-5.56,98000,5,119860,0,0,0,0,0,0,0,98000,-98000,-98000
20200520,056819,奇力新永豐98購01,,,,,0.00,0.00,0,0,0,0,0,0,0,0,0,0,0,0,0
20200520,05681P,大立光元大96售05,,,,,0.00,0.00,0,0,0,0,0,0,0,0,0,0,0,0,0
20200520,056820,欣興永豐98購02,1.78,1.98,1.72,1.75,-0.04,-2.23,117000,10,214840,0,0,0,0,0,0,115000,2000,113000,113000
20200520,056821,日電貿永豐98購01,0.69,0.72,0.69,0.72,-0.01,-1.37,63000,3,44970,0,0,0,0,0,0,13000,50000,-37000,-37000
20200520,056822,佐登永豐98購01,,,,,0.00,0.00,0,0,0,0,0,0,0,0,0,0,0,0,0
20200520,056823,智伸科永豐98購01,0.45,0.48,0.45,0.48,+0.06,14.29,80000,5,36600,0,0,0,0,0,0,60000,20000,40000,40000
20200520,056824,元石油富邦9B購01,,,,,0.00,0.00,0,0,0,0,0,0,0,0,0,0,0,0,0
20200520,056825,深中小富邦9B購01,,,,,0.00,0.00,0,0,0,0,0,0,0,0,0,0,0,0,0
20200520,056826,A50正2富邦9B購02,,,,,0.00,0.00,0,0,0,0,0,0,0,0,0,0,0,0,0
20200520,056827,元油2X富邦02購01,0.27,0.29,0.27,0.29,-0.01,-3.33,646000,25,182910,0,0,0,0,0,0,0,0,0,0
20200520,056828,國巨富邦9A購03,0.37,0.37,0.37,0.37,0.00,0.00,45000,1,16650,0,0,0,0,0,0,45000,0,45000,45000
20200520,056829,台積電富邦9A購01,0.33,0.33,0.28,0.31,-0.02,-6.06,1036000,76,317600,0,0,0,0,0,0,170000,0,170000,170000
20200520,05682P,大立光元大98售03,,,,,0.00,0.00,0,0,0,0,0,0,0,0,0,0,0,0,0
20200520,056830,友達富邦99購01,,,,,0.00,0.00,0,0,0,0,0,0,0,0,0,0,0,0,0
20200520,056831,元油2X元富98購11,0.01,0.01,0.01,0.01,0.00,0.00,59000,3,590,0,0,0,0,0,0,29000,0,29000,29000
20200520,056832,元油2X元富98購12,0.03,0.03,0.03,0.03,0.00,0.00,100000,1,3000,0,0,0,0,0,0,0,0,0,0
20200520,056833,和大元富9B購01,,,,,0.00,0.00,0,0,0,0,0,0,0,0,0,0,0,0,0
20200520,056834,華新元富99購01,,,,,0.00,0.00,0,0,0,0,0,0,0,0,0,0,0,0,0
20200520,056835,聯電元富99購01,1.13,1.14,1.12,1.14,+0.05,4.59,415000,7,467820,0,0,0,0,0,0,198000,217000,-19000,-19000
20200520,056836,國巨元富98購01,,,,,0.00,0.00,0,0,0,0,0,0,0,0,0,0,0,0,0
20200520,056837,國巨元富98購02,0.54,0.54,0.54,0.54,0.00,0.00,1000,1,540,0,0,0,0,0,0,0,1000,-1000,-1000
20200520,056838,旺宏元富98購01,0.90,0.91,0.90,0.91,-0.02,-2.15,37000,3,33370,0,0,0,0,0,0,30000,7000,23000,23000
20200520,056839,台光電元富98購02,2.42,2.45,2.42,2.42,-0.18,-6.92,225000,21,544980,0,0,0,0,0,0,225000,0,225000,225000
20200520,05683P,矽創元大96售01,0.91,0.91,0.91,0.91,-0.02,-2.15,5000,1,4550,0,0,0,0,0,0,0,5000,-5000,-5000
20200520,056840,友達元富98購02,,,,,0.00,0.00,0,0,0,0,0,0,0,0,0,0,0,0,0
20200520,056841,友達元富98購03,,,,,0.00,0.00,0,0,0,0,0,0,0,0,0,0,0,0,0
20200520,056842,全新元富98購01,,,,,0.00,0.00,0,0,0,0,0,0,0,0,0,0,0,0,0
20200520,056843,冠德元富98購01,0.89,0.89,0.89,0.89,-0.06,-6.32,3000,1,2670,0,0,0,0,0,0,0,3000,-3000,-3000
20200520,056844,欣興元富98購03,3.09,3.09,2.76,2.92,+0.07,2.46,86000,6,240540,0,0,0,0,0,0,12000,74000,-62000,-62000
20200520,056845,揚明光元富98購01,1.19,1.19,1.16,1.18,+0.11,10.28,227000,7,268440,0,0,0,0,0,0,98000,129000,-31000,-31000
20200520,056846,晶相光元富98購01,1.37,1.37,1.33,1.37,+0.02,1.48,310000,5,416700,0,0,0,0,0,0,200000,110000,90000,90000
20200520,056847,佐登元富98購01,1.26,1.27,1.16,1.16,-0.12,-9.38,270000,16,325320,0,0,0,0,0,0,152000,90000,62000,62000
20200520,056848,泰鼎元富98購01,1.60,1.87,1.59,1.82,+0.13,7.69,28000,5,48370,0,0,0,0,0,0,20000,13000,7000,7000
20200520,056849,瀚宇博元富98購01,2.36,2.36,2.36,2.36,-0.04,-1.67,4000,1,9440,0,0,0,0,0,0,4000,0,4000,4000
20200520,05684P,臺股指元大96售09,,,,,0.00,0.00,0,0,0,0,0,0,0,0,0,0,0,0,0
20200520,056850,彩晶元富99購01,0.54,0.54,0.54,0.54,0.00,0.00,56000,1,30240,0,0,0,0,0,0,0,56000,-56000,-56000
20200520,056851,瑞儀元富98購01,1.94,2.09,1.93,2.09,+0.11,5.56,254000,12,500000,0,0,0,0,0,0,111000,143000,-32000,-32000
20200520,056852,矽格元富98購01,2.45,2.85,2.43,2.81,+0.35,14.23,517000,40,1342330,0,0,0,0,0,0,136000,381000,-245000,-245000
20200520,056853,元油2X中信9B購02,,,,,0.00,0.00,0,0,0,0,0,0,0,0,0,0,0,0,0
20200520,056854,友達中信9A購01,,,,,0.00,0.00,0,0,0,0,0,0,0,0,0,0,0,0,0
20200520,056855,祥碩中信98購02,0.96,1.15,0.95,1.14,+0.23,25.27,853000,39,919920,0,0,0,0,0,0,719000,52000,667000,667000
20200520,056856,華通群益9A購01,3.08,3.30,3.08,3.15,-0.13,-3.96,24000,6,77600,0,0,0,0,0,0,1000,23000,-22000,-22000
20200520,056857,國巨群益99購02,1.15,1.16,1.09,1.10,0.00,0.00,81000,8,92890,0,0,0,0,0,0,20000,61000,-41000,-41000
20200520,056858,國巨群益99購03,,,,,0.00,0.00,0,0,0,0,0,0,0,0,0,0,0,0,0
20200520,056859,台積電群益98購02,0.15,0.15,0.15,0.15,0.00,0.00,30000,1,4500,0,0,0,0,0,0,30000,0,30000,30000
20200520,05685P,臺股指元大96售10,,,,,0.00,0.00,0,0,0,0,0,0,0,0,0,0,0,0,0
20200520,056860,正崴群益98購01,2.21,2.21,2.21,2.21,0.00,0.00,17000,1,37570,0,0,0,0,0,0,0,17000,-17000,-17000
20200520,056861,美律群益99購01,,,,,0.00,0.00,0,0,0,0,0,0,0,0,0,0,0,0,0
20200520,056862,聯發科群益98購03,,,,,0.00,0.00,0,0,0,0,0,0,0,0,0,0,0,0,0
20200520,056863,義隆群益98購01,3.91,3.91,3.91,3.91,0.00,0.00,1000,1,3910,0,0,0,0,0,0,1000,0,1000,1000
20200520,056864,新日興群益99購01,,,,,0.00,0.00,0,0,0,0,0,0,0,0,0,0,0,0,0
20200520,056865,樺漢群益98購01,,,,,0.00,0.00,0,0,0,0,0,0,0,0,0,0,0,0,0
20200520,056866,矽創群益98購03,,,,,0.00,0.00,0,0,0,0,0,0,0,0,0,0,0,0,0
20200520,056867,華通麥證98購01,0.67,0.67,0.67,0.67,+0.04,6.35,1000,1,670,0,1000,-1000,0,0,0,0,1000,-1000,-1000
20200520,056868,奇力新麥證98購01,,,,,0.00,0.00,0,0,0,0,0,0,0,0,0,0,0,0,0
20200520,056869,國巨日盛99購03,,,,,0.00,0.00,0,0,0,0,0,0,0,0,0,0,0,0,0
20200520,05686P,臺股指元大96售11,,,,,0.00,0.00,0,0,0,0,0,0,0,0,0,0,0,0,0
20200520,056870,全新日盛9A購01,,,,,0.00,0.00,0,0,0,0,0,0,0,0,0,0,0,0,0
20200520,056871,新日興日盛99購01,,,,,0.00,0.00,0,0,0,0,0,0,0,0,0,0,0,0,0
20200520,056872,旺宏凱基98購08,,,,,0.00,0.00,0,0,0,0,0,0,0,0,0,0,0,0,0
20200520,056873,友達凱基98購07,,,,,0.00,0.00,0,0,0,0,0,0,0,0,0,0,0,0,0
20200520,056874,友達凱基98購08,,,,,0.00,0.00,0,0,0,0,0,0,0,0,0,0,0,0,0
20200520,056875,亞光凱基98購03,,,,,0.00,0.00,0,0,0,0,0,0,0,0,0,0,0,0,0
20200520,056876,群創凱基98購11,,,,,0.00,0.00,0,0,0,0,0,0,0,0,0,0,0,0,0
20200520,056877,群創凱基99購04,,,,,0.00,0.00,0,0,0,0,0,0,0,0,0,0,0,0,0
20200520,056878,元油2X國票99購02,,,,,0.00,0.00,0,0,0,0,0,0,0,0,0,0,0,0,0
20200520,056879,旺宏國票99購02,1.27,1.27,1.27,1.27,0.00,0.00,4000,1,5080,0,0,0,0,0,0,0,4000,-4000,-4000
20200520,05687P,臺股指元大96售12,,,,,0.00,0.00,0,0,0,0,0,0,0,0,0,0,0,0,0
20200520,056880,緯穎國票98購02,,,,,0.00,0.00,0,0,0,0,0,0,0,0,0,0,0,0,0
20200520,056881,台灣50康和9A購01,,,,,0.00,0.00,0,0,0,0,0,0,0,0,0,0,0,0,0
20200520,056882,華邦電康和98購01,,,,,0.00,0.00,0,0,0,0,0,0,0,0,0,0,0,0,0
20200520,056883,美食康和98購01,0.95,0.95,0.95,0.95,+0.14,17.28,2000,2,1900,0,0,0,0,0,0,2000,0,2000,2000
20200520,056884,元油2X元大99購02,,,,,0.00,0.00,0,0,0,0,0,0,0,0,0,0,0,0,0
20200520,056885,元油2X元大99購03,0.35,0.35,0.35,0.35,0.00,0.00,10000,1,3500,0,0,0,0,0,0,0,10000,-10000,-10000
20200520,056886,元油2X元大99購04,,,,,0.00,0.00,0,0,0,0,0,0,0,0,0,0,0,0,0
20200520,056887,元油2X元大99購05,,,,,0.00,0.00,0,0,0,0,0,0,0,0,0,0,0,0,0
20200520,056888,元油2X元大99購06,,,,,0.00,0.00,0,0,0,0,0,0,0,0,0,0,0,0,0
20200520,056889,元油2X元大99購07,,,,,0.00,0.00,0,0,0,0,0,0,0,0,0,0,0,0,0
20200520,05688P,臺股指元大96售13,,,,,0.00,0.00,0,0,0,0,0,0,0,0,0,0,0,0,0
20200520,056890,國巨元大98購11,2.22,2.22,2.22,2.22,+0.21,10.45,15000,1,33300,0,0,0,0,0,0,15000,0,15000,15000
20200520,056891,國巨元大99購03,,,,,0.00,0.00,0,0,0,0,0,0,0,0,0,0,0,0,0
20200520,056892,旺宏元大9A購02,,,,,0.00,0.00,0,0,0,0,0,0,0,0,0,0,0,0,0
20200520,056893,智邦元大98購02,3.00,3.09,3.00,3.09,+0.17,5.82,25000,4,75290,0,0,0,0,0,0,5000,24000,-19000,-19000
20200520,056894,佳世達元大99購01,0.61,0.70,0.61,0.70,+0.11,18.64,525000,15,342270,0,0,0,0,0,0,124000,401000,-277000,-277000
20200520,056895,技嘉元大98購01,4.86,4.86,4.68,4.68,-0.13,-2.7,20000,4,96960,0,0,0,0,0,0,20000,2000,18000,18000
20200520,056896,南亞科元大98購01,,,,,0.00,0.00,0,0,0,0,0,0,0,0,0,0,0,0,0
20200520,056897,南亞科元大98購02,0.95,0.98,0.95,0.98,+0.08,8.89,99000,5,96190,0,0,0,0,0,0,88000,11000,77000,77000
20200520,056898,全新元大98購02,,,,,0.00,0.00,0,0,0,0,0,0,0,0,0,0,0,0,0
20200520,056899,可成元大98購01,1.33,1.33,1.33,1.33,0.00,0.00,68000,1,90440,0,0,0,0,0,0,0,68000,-68000,-68000
20200520,05689P,滬深2X中信97售02,,,,,0.00,0.00,0,0,0,0,0,0,0,0,0,0,0,0,0
20200520,056900,可成元大98購02,,,,,0.00,0.00,0,0,0,0,0,0,0,0,0,0,0,0,0
20200520,056901,華新科元大98購03,,,,,0.00,0.00,0,0,0,0,0,0,0,0,0,0,0,0,0
20200520,056902,大立光元大98購12,,,,,0.00,0.00,0,0,0,0,0,0,0,0,0,0,0,0,0
20200520,056903,大立光元大99購04,1.56,1.60,1.56,1.60,0.00,0.00,66000,3,103200,0,0,0,0,0,0,60000,6000,54000,54000
20200520,056904,大立光元大99購05,0.80,0.80,0.80,0.80,+0.03,3.9,5000,1,4000,0,0,0,0,0,0,5000,0,5000,5000
20200520,056905,欣興元大98購03,2.49,2.55,2.39,2.40,+0.07,3.0,117000,10,287640,0,0,0,0,0,0,56000,62000,-6000,-6000
20200520,056906,玉晶光元大9B購01,,,,,0.00,0.00,0,0,0,0,0,0,0,0,0,0,0,0,0
20200520,056907,群創元大9C購04,,,,,0.00,0.00,0,0,0,0,0,0,0,0,0,0,0,0,0
20200520,056908,牧德元大99購03,,,,,0.00,0.00,0,0,0,0,0,0,0,0,0,0,0,0,0
20200520,056909,嘉聯益元大99購03,1.71,1.76,1.71,1.76,+0.03,1.73,68000,4,118280,0,0,0,0,0,0,68000,0,68000,68000
20200520,05690P,友達中信96售02,,,,,0.00,0.00,0,0,0,0,0,0,0,0,0,0,0,0,0
20200520,056910,超眾元大99購02,2.14,2.14,2.14,2.14,0.00,0.00,10000,1,21400,0,0,0,0,0,0,10000,10000,0,0
20200520,056911,緯穎元大99購01,2.57,2.70,2.39,2.39,-0.36,-13.09,126000,15,331460,0,0,0,0,0,0,59000,78000,-19000,-19000
20200520,056912,臺股指元大99購04,,,,,0.00,0.00,0,0,0,0,0,0,0,0,0,0,0,0,0
20200520,056913,臺股指元大99購05,,,,,0.00,0.00,0,0,0,0,0,0,0,0,0,0,0,0,0
20200520,056914,臺股指元大99購09,,,,,0.00,0.00,0,0,0,0,0,0,0,0,0,0,0,0,0
20200520,056915,上銀兆豐99購01,1.00,1.01,1.00,1.01,-0.01,-0.98,20000,4,20100,0,0,0,0,0,0,0,20000,-20000,-20000
20200520,056916,台達電兆豐98購02,0.66,0.66,0.63,0.63,-0.03,-4.55,354000,25,228700,0,0,0,0,0,0,354000,0,354000,354000
20200520,056917,國巨兆豐98購03,,,,,0.00,0.00,0,0,0,0,0,0,0,0,0,0,0,0,0
20200520,056918,台積電兆豐98購01,,,,,0.00,0.00,0,0,0,0,0,0,0,0,0,0,0,0,0
20200520,056919,英業達兆豐98購01,1.51,1.56,1.49,1.49,+0.05,3.47,156000,7,235970,0,0,0,0,0,0,90000,66000,24000,24000
20200520,05691P,聯發科中信98售01,0.19,0.20,0.16,0.20,0.00,0.00,980000,31,170600,0,0,0,0,0,0,580000,850000,-270000,-270000
20200520,056920,友達兆豐98購02,,,,,0.00,0.00,0,0,0,0,0,0,0,0,0,0,0,0,0
20200520,056921,京元電兆豐98購01,0.65,0.70,0.63,0.63,-0.09,-12.5,486000,36,318600,0,0,0,0,0,0,0,446000,-446000,-446000
20200520,056922,全新兆豐99購01,,,,,0.00,0.00,0,0,0,0,0,0,0,0,0,0,0,0,0
20200520,056923,奇力新兆豐99購02,,,,,0.00,0.00,0,0,0,0,0,0,0,0,0,0,0,0,0
20200520,056924,亞光兆豐98購01,,,,,0.00,0.00,0,0,0,0,0,0,0,0,0,0,0,0,0
20200520,056925,群創兆豐98購03,0.06,0.06,0.02,0.02,0.00,0.00,20000,2,800,0,0,0,0,0,0,0,10000,-10000,-10000
20200520,056926,日月光兆豐98購01,,,,,0.00,0.00,0,0,0,0,0,0,0,0,0,0,0,0,0
20200520,056927,T50反1台新02購01,1.19,1.19,1.19,1.19,0.00,0.00,20000,2,23800,0,0,0,0,0,0,0,20000,-20000,-20000
20200520,056928,旺宏台新98購01,,,,,0.00,0.00,0,0,0,0,0,0,0,0,0,0,0,0,0
20200520,056929,華新科台新98購01,,,,,0.00,0.00,0,0,0,0,0,0,0,0,0,0,0,0,0
20200520,05692P,聯發科中信9A售02,0.48,0.49,0.43,0.46,-0.05,-9.8,737000,28,343310,0,0,0,0,0,0,220000,697000,-477000,-477000
20200520,056930,晶豪科台新98購01,,,,,0.00,0.00,0,0,0,0,0,0,0,0,0,0,0,0,0
20200520,056931,智原台新98購01,,,,,0.00,0.00,0,0,0,0,0,0,0,0,0,0,0,0,0
20200520,056932,T50反1元富98購01,,,,,0.00,0.00,0,0,0,0,0,0,0,0,0,0,0,0,0
20200520,056933,國巨元富98購03,0.38,0.40,0.38,0.40,0.00,0.00,30000,3,11700,0,0,0,0,0,0,30000,30000,0,0
20200520,056934,國巨元富98購04,,,,,0.00,0.00,0,0,0,0,0,0,0,0,0,0,0,0,0
20200520,056935,華新科元富98購02,,,,,0.00,0.00,0,0,0,0,0,0,0,0,0,0,0,0,0
20200520,056936,禾伸堂元富98購01,2.88,2.99,2.85,2.92,+0.09,3.18,53000,5,153680,0,0,0,0,0,0,36000,17000,19000,19000
20200520,056937,智原元富98購01,0.48,0.54,0.48,0.54,+0.03,5.88,110000,10,58840,0,0,0,0,0,0,10000,100000,-90000,-90000
20200520,056938,泰碩元富98購01,,,,,0.00,0.00,0,0,0,0,0,0,0,0,0,0,0,0,0
20200520,056939,康控元富98購01,1.29,1.29,1.08,1.08,-0.03,-2.7,869000,49,1020080,0,0,0,0,0,0,771000,0,771000,771000
20200520,05693P,滬深2X凱基98售02,,,,,0.00,0.00,0,0,0,0,0,0,0,0,0,0,0,0,0
20200520,056940,嘉聯益元富98購01,,,,,0.00,0.00,0,0,0,0,0,0,0,0,0,0,0,0,0
20200520,056941,台郡元富9B購01,,,,,0.00,0.00,0,0,0,0,0,0,0,0,0,0,0,0,0
20200520,056942,昇陽半元富98購01,,,,,0.00,0.00,0,0,0,0,0,0,0,0,0,0,0,0,0
20200520,056943,華通統一99購01,1.51,1.51,1.37,1.37,-0.11,-7.43,91000,11,136400,0,0,0,0,0,0,25000,66000,-41000,-41000
20200520,056944,鴻海統一98購11,,,,,0.00,0.00,0,0,0,0,0,0,0,0,0,0,0,0,0
20200520,056945,鴻海統一98購12,0.71,0.71,0.68,0.68,-0.04,-5.56,502000,7,341860,0,0,0,0,0,0,482000,20000,462000,462000
20200520,056946,國巨統一98購05,1.11,1.26,1.11,1.15,+0.12,11.65,215000,12,248160,0,0,0,0,0,0,36000,179000,-143000,-143000
20200520,056947,國巨統一9A購01,0.85,0.92,0.85,0.89,+0.11,14.1,567000,6,503050,0,0,0,0,0,0,15000,552000,-537000,-537000
20200520,056948,旺宏統一9A購01,,,,,0.00,0.00,0,0,0,0,0,0,0,0,0,0,0,0,0
20200520,056949,義隆統一98購01,1.91,2.02,1.91,2.02,+0.05,2.54,16000,2,31220,0,0,0,0,0,0,0,16000,-16000,-16000
20200520,05694P,台積電凱基96售09,,,,,0.00,0.00,0,0,0,0,0,0,0,0,0,0,0,0,0
20200520,056950,亞光統一99購01,,,,,0.00,0.00,0,0,0,0,0,0,0,0,0,0,0,0,0
20200520,056951,牧德統一99購01,0.53,0.64,0.53,0.64,+0.13,25.49,118000,4,67520,0,0,0,0,0,0,50000,68000,-18000,-18000
20200520,056952,元油2X國泰99購01,,,,,0.00,0.00,0,0,0,0,0,0,0,0,0,0,0,0,0
20200520,056953,智邦富邦98購02,0.87,0.87,0.87,0.87,0.00,0.00,10000,1,8700,0,0,0,0,0,0,10000,0,10000,10000
20200520,056954,聯詠富邦9A購01,0.46,0.50,0.46,0.47,-0.02,-4.08,662000,56,314160,0,0,0,0,0,0,527000,5000,522000,522000
20200520,056955,台灣50永豐98購01,0.05,0.07,0.03,0.04,-0.02,-33.33,537000,9,22190,0,0,0,0,0,0,0,225000,-225000,-225000
20200520,056956,元油2X永豐99購01,,,,,0.00,0.00,0,0,0,0,0,0,0,0,0,0,0,0,0
20200520,056957,元油2X永豐9A購02,,,,,0.00,0.00,0,0,0,0,0,0,0,0,0,0,0,0,0
20200520,056958,喬山永豐98購01,0.72,0.72,0.72,0.72,0.00,0.00,5000,1,3600,0,0,0,0,0,0,5000,0,5000,5000
20200520,056959,鴻海永豐98購03,,,,,0.00,0.00,0,0,0,0,0,0,0,0,0,0,0,0,0
20200520,05695P,台積電凱基96售10,,,,,0.00,0.00,0,0,0,0,0,0,0,0,0,0,0,0,0
20200520,056960,光罩永豐98購01,0.56,0.61,0.56,0.61,0.00,0.00,6000,2,3510,0,0,0,0,0,0,3000,3000,0,0
20200520,056961,凱美永豐98購01,0.78,0.82,0.73,0.74,-0.02,-2.63,409000,8,314580,0,0,0,0,0,0,181000,168000,13000,13000
20200520,056962,技嘉永豐98購01,1.28,1.28,1.14,1.14,-0.16,-12.31,92000,13,113240,0,0,0,0,0,0,40000,52000,-12000,-12000
20200520,056963,建準永豐98購01,2.32,2.32,2.14,2.14,-0.21,-8.94,18000,4,41020,0,0,0,0,0,0,4000,14000,-10000,-10000
20200520,056964,聯發科永豐98購03,,,,,0.00,0.00,0,0,0,0,0,0,0,0,0,0,0,0,0
20200520,056965,全新永豐98購01,,,,,0.00,0.00,0,0,0,0,0,0,0,0,0,0,0,0,0
20200520,056966,嘉晶永豐98購01,3.11,3.53,2.95,3.53,+0.89,33.71,18000,7,56840,0,0,0,0,0,0,10000,8000,2000,2000
20200520,056967,奇鋐永豐98購01,,,,,0.00,0.00,0,0,0,0,0,0,0,0,0,0,0,0,0
20200520,056968,揚明光永豐98購02,0.15,0.15,0.15,0.15,0.00,0.00,50000,1,7500,0,0,0,0,0,0,0,50000,-50000,-50000
20200520,056969,智易永豐98購01,,,,,0.00,0.00,0,0,0,0,0,0,0,0,0,0,0,0,0
20200520,05696P,南亞科凱基96售01,,,,,0.00,0.00,0,0,0,0,0,0,0,0,0,0,0,0,0
20200520,056970,TPK永豐98購01,0.44,0.44,0.42,0.43,+0.04,10.26,121000,3,52040,0,0,0,0,0,0,121000,21000,100000,100000
20200520,056971,麗豐永豐98購01,0.43,0.46,0.42,0.46,+0.28,155.56,33000,5,14450,0,0,0,0,0,0,33000,0,33000,33000
20200520,056972,祥碩永豐98購02,1.57,1.82,1.57,1.82,+0.49,36.84,40000,3,69500,0,0,0,0,0,0,40000,0,40000,40000
20200520,056973,T50反1永昌9C購01,,,,,0.00,0.00,0,0,0,0,0,0,0,0,0,0,0,0,0
20200520,056974,臻鼎永昌9C購01,,,,,0.00,0.00,0,0,0,0,0,0,0,0,0,0,0,0,0
20200520,056975,元油2X群益98購03,,,,,0.00,0.00,0,0,0,0,0,0,0,0,0,0,0,0,0
20200520,056976,喬山群益98購01,0.30,0.30,0.30,0.30,+0.01,3.45,10000,1,3000,0,0,0,0,0,0,0,10000,-10000,-10000
20200520,056977,國巨群益9A購01,0.89,0.89,0.80,0.80,0.00,0.00,14000,3,11590,0,0,0,0,0,0,0,14000,-14000,-14000
20200520,056978,技嘉群益99購01,3.42,3.46,3.42,3.42,-0.21,-5.79,60000,6,206200,0,0,0,0,0,0,0,60000,-60000,-60000
20200520,056979,微星群益98購01,,,,,0.00,0.00,0,0,0,0,0,0,0,0,0,0,0,0,0
20200520,05697P,友達凱基96售01,,,,,0.00,0.00,0,0,0,0,0,0,0,0,0,0,0,0,0
20200520,056980,建準群益98購02,1.67,1.73,1.56,1.73,-0.10,-5.46,201000,19,319210,0,0,0,0,0,0,175000,24000,151000,151000
20200520,056981,全新群益99購03,,,,,0.00,0.00,0,0,0,0,0,0,0,0,0,0,0,0,0
20200520,056982,華新科群益98購05,,,,,0.00,0.00,0,0,0,0,0,0,0,0,0,0,0,0,0
20200520,056983,大立光群益99購02,1.17,1.18,1.17,1.18,0.00,0.00,87000,2,102300,0,0,0,0,0,0,0,87000,-87000,-87000
20200520,056984,嘉晶群益98購01,2.80,3.64,2.80,3.64,+0.81,28.62,277000,27,894340,0,0,0,0,0,0,29000,258000,-229000,-229000
20200520,056985,智原群益98購03,,,,,0.00,0.00,0,0,0,0,0,0,0,0,0,0,0,0,0
20200520,056986,超眾群益98購03,,,,,0.00,0.00,0,0,0,0,0,0,0,0,0,0,0,0,0
20200520,056987,南茂群益98購01,,,,,0.00,0.00,0,0,0,0,0,0,0,0,0,0,0,0,0
20200520,056988,聚陽兆豐98購01,0.21,0.21,0.19,0.19,-0.02,-9.52,123000,17,24170,0,0,0,0,0,0,0,30000,-30000,-30000
20200520,056989,鴻海兆豐98購02,0.58,0.58,0.58,0.58,-0.06,-9.38,50000,1,29000,0,0,0,0,0,0,0,50000,-50000,-50000
20200520,05698P,群創凱基96售01,,,,,0.00,0.00,0,0,0,0,0,0,0,0,0,0,0,0,0
20200520,056990,聯發科兆豐98購01,2.40,2.40,2.40,2.40,0.00,0.00,54000,2,129600,0,0,0,0,0,0,54000,54000,0,0
20200520,056991,牧德兆豐98購01,0.59,0.71,0.59,0.66,+0.18,37.5,642000,21,422330,0,0,0,0,0,0,0,642000,-642000,-642000
20200520,056992,祥碩兆豐98購01,2.68,3.10,2.68,3.05,+0.97,46.63,99000,5,300700,0,0,0,0,0,0,5000,94000,-89000,-89000
20200520,056993,GIS兆豐99購01,,,,,0.00,0.00,0,0,0,0,0,0,0,0,0,0,0,0,0
20200520,056994,緯穎兆豐98購02,,,,,0.00,0.00,0,0,0,0,0,0,0,0,0,0,0,0,0
20200520,056995,華新科日盛99購01,0.80,0.89,0.80,0.82,-0.03,-3.53,506000,25,417240,0,0,0,0,0,0,367000,139000,228000,228000
20200520,056996,矽力日盛99購01,3.00,3.20,2.81,3.11,0.00,0.00,205000,9,609110,0,0,0,0,0,0,101000,100000,1000,1000
20200520,056997,台灣50康和9A購02,,,,,0.00,0.00,0,0,0,0,0,0,0,0,0,0,0,0,0
20200520,056998,麗豐康和98購01,,,,,0.00,0.00,0,0,0,0,0,0,0,0,0,0,0,0,0
20200520,056999,元油2X國票98購02,,,,,0.00,0.00,0,0,0,0,0,0,0,0,0,0,0,0,0
20200520,05699P,茂林凱基96售05,,,,,0.00,0.00,0,0,0,0,0,0,0,0,0,0,0,0,0
20200520,057000,亞德客國票99購01,,,,,0.00,0.00,0,0,0,0,0,0,0,0,0,0,0,0,0
20200520,057001,華邦電國票99購02,0.36,0.36,0.36,0.36,0.00,0.00,166000,2,59760,0,0,0,0,0,0,0,166000,-166000,-166000
20200520,057002,友達國票98購01,0.12,0.12,0.12,0.12,0.00,0.00,250000,1,30000,0,0,0,0,0,0,0,250000,-250000,-250000
20200520,057003,立積國票98購01,2.14,2.14,2.09,2.09,-0.16,-7.11,20000,2,42300,0,0,0,0,0,0,10000,10000,0,0
20200520,057004,滬深反中信9A購01,,,,,0.00,0.00,0,0,0,0,0,0,0,0,0,0,0,0,0
20200520,057005,元油2X中信9C購01,0.19,0.19,0.19,0.19,0.00,0.00,1000,1,190,0,0,0,0,0,0,0,0,0,0
20200520,057006,國巨中信98購03,0.30,0.30,0.30,0.30,+0.04,15.38,10000,1,3000,0,0,0,0,0,0,0,10000,-10000,-10000
20200520,057007,奇力新中信98購04,0.13,0.13,0.13,0.13,0.00,0.00,20000,1,2600,0,0,0,0,0,0,0,20000,-20000,-20000
20200520,057008,華新科中信99購02,,,,,0.00,0.00,0,0,0,0,0,0,0,0,0,0,0,0,0
20200520,057009,信邦中信99購01,0.85,0.93,0.81,0.83,+0.04,5.06,529000,16,465920,0,0,0,0,0,0,122000,407000,-285000,-285000
20200520,05700P,臻鼎凱基96售02,,,,,0.00,0.00,0,0,0,0,0,0,0,0,0,0,0,0,0
20200520,057010,景碩中信98購01,0.24,0.24,0.24,0.24,0.00,0.00,56000,2,13440,0,0,0,0,0,0,0,56000,-56000,-56000
20200520,057011,日月光中信99購01,,,,,0.00,0.00,0,0,0,0,0,0,0,0,0,0,0,0,0
20200520,057012,康控中信98購01,0.21,0.21,0.19,0.19,-0.03,-13.64,40000,2,8000,0,0,0,0,0,0,20000,20000,0,0
20200520,057013,聯發科麥證98購01,,,,,0.00,0.00,0,0,0,0,0,0,0,0,0,0,0,0,0
20200520,057014,元油2X凱基9A購05,,,,,0.00,0.00,0,0,0,0,0,0,0,0,0,0,0,0,0
20200520,057015,元油2X凱基9B購04,,,,,0.00,0.00,0,0,0,0,0,0,0,0,0,0,0,0,0
20200520,057016,中石化凱基9B購01,0.85,0.85,0.78,0.79,-0.03,-3.66,770000,66,638960,0,0,0,0,0,0,581000,44000,537000,537000
20200520,057017,和大凱基98購01,0.48,0.58,0.48,0.58,+0.11,23.4,114000,5,61720,0,0,0,0,0,0,10000,104000,-94000,-94000
20200520,057018,亞德客凱基98購01,,,,,0.00,0.00,0,0,0,0,0,0,0,0,0,0,0,0,0
20200520,057019,台積電凱基98購14,,,,,0.00,0.00,0,0,0,0,0,0,0,0,0,0,0,0,0
20200520,05701P,彩晶凱基96售01,0.74,0.74,0.74,0.74,0.00,0.00,1000,1,740,0,0,0,0,0,0,0,1000,-1000,-1000
20200520,057020,台積電凱基99購02,,,,,0.00,0.00,0,0,0,0,0,0,0,0,0,0,0,0,0
20200520,057021,台積電凱基9A購02,,,,,0.00,0.00,0,0,0,0,0,0,0,0,0,0,0,0,0
20200520,057022,智邦凱基98購04,3.17,3.17,3.17,3.17,+0.03,0.96,10000,1,31700,0,0,0,0,0,0,10000,0,10000,10000
20200520,057023,美律凱基99購02,0.90,0.93,0.90,0.93,-0.02,-2.11,94000,4,85640,0,0,0,0,0,0,44000,50000,-6000,-6000
20200520,057024,義隆凱基99購01,,,,,0.00,0.00,0,0,0,0,0,0,0,0,0,0,0,0,0
20200520,057025,華新科凱基98購04,,,,,0.00,0.00,0,0,0,0,0,0,0,0,0,0,0,0,0
20200520,057026,長榮航凱基98購01,,,,,0.00,0.00,0,0,0,0,0,0,0,0,0,0,0,0,0
20200520,057027,祥碩凱基98購01,1.49,1.58,1.49,1.56,+0.31,24.8,22000,4,33890,0,0,0,0,0,0,7000,8000,-1000,-1000
20200520,057028,台郡凱基99購02,2.16,2.20,2.16,2.20,+0.01,0.46,40000,2,87600,0,0,0,0,0,0,40000,0,40000,40000
20200520,057029,緯穎凱基98購04,3.84,3.98,3.61,3.61,-0.64,-15.06,79000,14,305880,0,0,0,0,0,0,69000,22000,47000,47000
20200520,05702P,矽創凱基96售02,,,,,0.00,0.00,0,0,0,0,0,0,0,0,0,0,0,0,0
20200520,057030,滬深反元大9B購01,,,,,0.00,0.00,0,0,0,0,0,0,0,0,0,0,0,0,0
20200520,057031,滬深反元大9B購02,,,,,0.00,0.00,0,0,0,0,0,0,0,0,0,0,0,0,0
20200520,057032,A50反1元大9B購01,0.77,0.78,0.77,0.78,+0.02,2.63,35000,2,27250,0,0,0,0,0,0,5000,30000,-25000,-25000
20200520,057033,A50反1元大9B購02,,,,,0.00,0.00,0,0,0,0,0,0,0,0,0,0,0,0,0
20200520,057034,道瓊反元大9B購01,,,,,0.00,0.00,0,0,0,0,0,0,0,0,0,0,0,0,0
20200520,057035,元油2X元大9B購03,,,,,0.00,0.00,0,0,0,0,0,0,0,0,0,0,0,0,0
20200520,057036,元油2X元大9B購04,0.05,0.06,0.05,0.06,0.00,0.00,51000,2,2560,0,0,0,0,0,0,0,0,0,0
20200520,057037,元油2X元大9B購05,0.06,0.06,0.06,0.06,+0.01,20.0,33000,1,1980,0,0,0,0,0,0,0,0,0,0
20200520,057038,元油2X元大9B購06,0.07,0.07,0.05,0.07,0.00,0.00,116000,4,6820,0,0,0,0,0,0,0,0,0,0
20200520,057039,元油2X元大9B購07,0.10,0.11,0.10,0.11,-0.01,-8.33,426000,12,44110,0,0,0,0,0,0,0,21000,-21000,-21000
20200520,05703P,矽力群益96售03,,,,,0.00,0.00,0,0,0,0,0,0,0,0,0,0,0,0,0
20200520,057040,國巨元大98購12,3.24,3.24,3.24,3.24,0.00,0.00,1000,1,3240,0,0,0,0,0,0,1000,1000,0,0
20200520,057041,國巨元大99購04,1.20,1.20,1.20,1.20,0.00,0.00,1000,1,1200,0,0,0,0,0,0,1000,0,1000,1000
20200520,057042,台積電元大98購10,,,,,0.00,0.00,0,0,0,0,0,0,0,0,0,0,0,0,0
20200520,057043,台積電元大99購02,,,,,0.00,0.00,0,0,0,0,0,0,0,0,0,0,0,0,0
20200520,057044,旺宏元大98購08,1.30,1.30,1.30,1.30,-0.04,-2.99,1000,1,1300,0,0,0,0,0,0,0,1000,-1000,-1000
20200520,057045,美律元大99購04,1.06,1.06,1.06,1.06,-0.05,-4.5,78000,3,82680,0,0,0,0,0,0,0,78000,-78000,-78000
20200520,057046,奇力新元大99購03,,,,,0.00,0.00,0,0,0,0,0,0,0,0,0,0,0,0,0
20200520,057047,華新科元大99購07,,,,,0.00,0.00,0,0,0,0,0,0,0,0,0,0,0,0,0
20200520,057048,新日興元大98購01,0.91,0.99,0.85,0.99,+0.02,2.06,259000,12,237070,0,0,0,0,0,0,100000,159000,-59000,-59000
20200520,057049,新日興元大98購02,,,,,0.00,0.00,0,0,0,0,0,0,0,0,0,0,0,0,0
20200520,05704P,矽力群益96售04,,,,,0.00,0.00,0,0,0,0,0,0,0,0,0,0,0,0,0
20200520,057050,群創元大99購03,,,,,0.00,0.00,0,0,0,0,0,0,0,0,0,0,0,0,0
20200520,057051,群創元大9B購03,,,,,0.00,0.00,0,0,0,0,0,0,0,0,0,0,0,0,0
20200520,057052,華擎元大98購01,2.00,2.10,2.00,2.10,0.00,0.00,19000,2,38900,0,0,0,0,0,0,10000,0,10000,10000
20200520,057053,立積元大98購02,1.79,1.79,1.62,1.62,-0.13,-7.43,118000,5,209080,0,0,0,0,0,0,14000,104000,-90000,-90000
20200520,057054,立積元大98購03,1.54,1.54,1.41,1.41,-0.10,-6.62,191000,11,285990,0,0,0,0,0,0,94000,97000,-3000,-3000
20200520,057055,立積元大99購01,1.71,1.71,1.62,1.62,-0.04,-2.41,118000,5,198550,0,0,0,0,0,0,37000,118000,-81000,-81000
20200520,057056,立積元大99購02,2.22,2.22,2.22,2.22,-0.09,-3.9,30000,1,66600,0,0,0,0,0,0,0,30000,-30000,-30000
20200520,057057,立積元大9A購01,2.84,2.84,2.71,2.71,-0.07,-2.52,88000,2,243420,0,0,0,0,0,0,38000,50000,-12000,-12000
20200520,057058,祥碩元大98購04,3.93,4.17,3.93,4.17,+0.32,8.31,5000,3,20200,0,0,0,0,0,0,5000,0,5000,5000
20200520,057059,易華電元大99購01,1.10,1.15,1.10,1.15,+0.04,3.6,178000,3,202840,0,0,0,0,0,0,68000,110000,-42000,-42000
20200520,05705P,上証2X永豐96售03,,,,,0.00,0.00,0,0,0,0,0,0,0,0,0,0,0,0,0
20200520,057060,緯穎元大98購05,2.28,2.36,2.24,2.36,-0.01,-0.42,9000,3,20640,0,0,0,0,0,0,9000,0,9000,9000
20200520,057061,華擎國泰9A購01,2.67,3.00,2.62,2.92,+0.36,14.06,358000,15,999280,0,0,0,0,0,0,0,358000,-358000,-358000
20200520,057062,立積國泰99購01,0.84,0.86,0.83,0.86,-0.04,-4.44,19000,4,15950,0,0,0,0,0,0,19000,0,19000,19000
20200520,057063,立積國泰9A購01,0.81,0.81,0.76,0.76,-0.07,-8.43,60000,4,45850,0,0,0,0,0,0,35000,25000,10000,10000
20200520,057064,華新科富邦9B購01,0.29,0.29,0.29,0.29,0.00,0.00,2000,1,580,0,0,0,0,0,0,2000,0,2000,2000
20200520,057065,牧德富邦99購01,,,,,0.00,0.00,0,0,0,0,0,0,0,0,0,0,0,0,0
20200520,057066,緯穎富邦99購01,0.75,0.75,0.71,0.71,-0.04,-5.33,17000,3,12340,0,0,0,0,0,0,0,17000,-17000,-17000
20200520,057067,元油2X永豐9B購01,,,,,0.00,0.00,0,0,0,0,0,0,0,0,0,0,0,0,0
20200520,057068,國巨永豐98購06,,,,,0.00,0.00,0,0,0,0,0,0,0,0,0,0,0,0,0
20200520,057069,台積電永豐98購02,,,,,0.00,0.00,0,0,0,0,0,0,0,0,0,0,0,0,0
20200520,05706P,TPK永豐96售02,,,,,0.00,0.00,0,0,0,0,0,0,0,0,0,0,0,0,0
20200520,057070,美律永豐98購02,,,,,0.00,0.00,0,0,0,0,0,0,0,0,0,0,0,0,0
20200520,057071,華擎永豐98購02,0.66,0.79,0.66,0.79,+0.15,23.44,408000,36,303020,0,0,0,0,0,0,148000,260000,-112000,-112000
20200520,057072,日月光永豐98購01,1.01,1.02,1.01,1.02,-0.14,-12.07,89000,3,90330,0,0,0,0,0,0,44000,45000,-1000,-1000
20200520,057073,康控永豐98購01,0.57,0.57,0.52,0.52,0.00,0.00,162000,30,86880,0,0,0,0,0,0,132000,0,132000,132000
20200520,057074,立積永豐98購01,0.30,0.33,0.30,0.32,+0.02,6.67,130000,6,41300,0,0,0,0,0,0,40000,90000,-50000,-50000
20200520,057075,嘉聯益永豐98購01,0.87,0.87,0.87,0.87,0.00,0.00,18000,1,15660,0,0,0,0,0,0,0,18000,-18000,-18000
20200520,057076,緯穎永豐98購01,,,,,0.00,0.00,0,0,0,0,0,0,0,0,0,0,0,0,0
20200520,057077,國巨統一98購06,0.76,0.86,0.76,0.78,+0.07,9.86,240000,7,194500,0,0,0,0,0,0,0,240000,-240000,-240000
20200520,057078,國巨統一9A購02,0.58,0.62,0.56,0.56,0.00,0.00,61000,7,35810,0,0,0,0,0,0,1000,60000,-59000,-59000
20200520,057079,台積電統一9A購02,,,,,0.00,0.00,0,0,0,0,0,0,0,0,0,0,0,0,0
20200520,05707P,中磊永豐96售01,,,,,0.00,0.00,0,0,0,0,0,0,0,0,0,0,0,0,0
20200520,057080,華新科統一99購02,0.27,0.27,0.25,0.25,-0.01,-3.85,80000,2,20800,0,0,0,0,0,0,40000,40000,0,0
20200520,057081,大立光統一98購07,0.48,0.48,0.48,0.48,0.00,0.00,1000,1,480,0,0,0,0,0,0,1000,0,1000,1000
20200520,057082,玉晶光統一9A購04,0.80,0.85,0.80,0.85,+0.07,8.97,201000,8,165880,0,0,0,0,0,0,45000,156000,-111000,-111000
20200520,057083,立積統一98購01,,,,,0.00,0.00,0,0,0,0,0,0,0,0,0,0,0,0,0
20200520,057084,立積統一9B購01,0.95,0.95,0.88,0.88,-0.03,-3.3,173000,4,164140,0,0,0,0,0,0,170000,3000,167000,167000
20200520,057085,立積統一9B購02,0.50,0.50,0.45,0.47,-0.02,-4.08,752000,20,366840,0,0,0,0,0,0,688000,52000,636000,636000
20200520,057086,立積統一9C購01,,,,,0.00,0.00,0,0,0,0,0,0,0,0,0,0,0,0,0
20200520,057087,台郡統一99購01,,,,,0.00,0.00,0,0,0,0,0,0,0,0,0,0,0,0,0
20200520,057088,上銀元富98購01,0.56,0.56,0.53,0.53,-0.04,-7.02,25000,3,13590,0,0,0,0,0,0,25000,19000,6000,6000
20200520,057089,奇力新元富98購01,0.41,0.42,0.41,0.42,0.00,0.00,98000,2,40660,0,0,0,0,0,0,0,98000,-98000,-98000
20200520,05708P,奇力新國票97售04,0.61,0.66,0.58,0.65,-0.07,-9.72,62000,5,37420,0,0,0,0,0,0,30000,32000,-2000,-2000
20200520,057090,奇力新元富98購02,,,,,0.00,0.00,0,0,0,0,0,0,0,0,0,0,0,0,0
20200520,057091,華新科元富9A購01,,,,,0.00,0.00,0,0,0,0,0,0,0,0,0,0,0,0,0
20200520,057092,健策元富98購01,1.34,1.43,1.34,1.43,-0.10,-6.54,176000,5,246640,0,0,0,0,0,0,0,176000,-176000,-176000
20200520,057093,臻鼎元富98購02,0.99,0.99,0.99,0.99,+0.04,4.21,40000,1,39600,0,0,0,0,0,0,40000,0,40000,40000
20200520,057094,祥碩元富98購01,3.79,3.79,3.79,3.79,+0.45,13.47,10000,2,37900,0,0,0,0,0,0,10000,10000,0,0
20200520,057095,祥碩元富98購02,2.08,2.12,2.08,2.12,0.00,0.00,28000,2,58560,0,0,0,0,0,0,28000,0,28000,28000
20200520,057096,緯穎元富98購01,3.03,3.21,2.75,2.75,-0.15,-5.17,503000,34,1528850,0,0,0,0,0,0,368000,70000,298000,298000
20200520,057097,致新元富98購01,5.05,5.05,4.93,4.93,+0.51,11.54,6000,2,30180,0,0,0,0,0,0,6000,0,6000,6000
20200520,057098,新光金台新98購01,,,,,0.00,0.00,0,0,0,0,0,0,0,0,0,0,0,0,0
20200520,057099,元油2X中信9B購03,,,,,0.00,0.00,0,0,0,0,0,0,0,0,0,0,0,0,0
20200520,05709P,大立光國票97售01,,,,,0.00,0.00,0,0,0,0,0,0,0,0,0,0,0,0,0
20200520,057100,國巨中信9A購02,0.56,0.59,0.56,0.57,+0.06,11.76,47000,3,27680,0,0,0,0,0,0,1000,46000,-45000,-45000
20200520,057101,新光金中信9A購01,,,,,0.00,0.00,0,0,0,0,0,0,0,0,0,0,0,0,0
20200520,057102,亞光中信9A購01,,,,,0.00,0.00,0,0,0,0,0,0,0,0,0,0,0,0,0
20200520,057103,禾伸堂中信9A購01,1.48,1.51,1.46,1.46,+0.09,6.57,40000,3,59600,0,0,0,0,0,0,20000,20000,0,0
20200520,057104,康友中信99購01,0.07,0.07,0.07,0.07,-0.02,-22.22,10000,1,700,0,0,0,0,0,0,10000,0,10000,10000
20200520,057105,致茂群益9A購01,0.83,0.85,0.83,0.85,+0.08,10.39,192000,6,160430,0,0,0,0,0,0,116000,76000,40000,40000
20200520,057106,美律群益98購03,0.68,0.68,0.68,0.68,-0.03,-4.23,10000,1,6800,0,0,0,0,0,0,0,10000,-10000,-10000
20200520,057107,華新科群益98購06,,,,,0.00,0.00,0,0,0,0,0,0,0,0,0,0,0,0,0
20200520,057108,潤泰全群益98購01,,,,,0.00,0.00,0,0,0,0,0,0,0,0,0,0,0,0,0
20200520,057109,信邦群益98購01,1.73,1.83,1.64,1.64,0.00,0.00,284000,7,486050,0,0,0,0,0,0,117000,147000,-30000,-30000
20200520,05710P,禾伸堂國票97售02,,,,,0.00,0.00,0,0,0,0,0,0,0,0,0,0,0,0,0
20200520,057110,立積群益98購01,0.68,0.69,0.64,0.64,-0.05,-7.25,130000,4,88370,0,0,0,0,0,0,130000,0,130000,130000
20200520,057111,立積群益98購02,2.21,2.21,2.21,2.21,-0.01,-0.45,90000,1,198900,0,0,0,0,0,0,0,90000,-90000,-90000
20200520,057112,立積群益99購01,0.96,0.99,0.89,0.89,-0.07,-7.29,198000,4,177920,0,0,0,0,0,0,175000,23000,152000,152000
20200520,057113,祥碩群益98購01,,,,,0.00,0.00,0,0,0,0,0,0,0,0,0,0,0,0,0
20200520,057114,台虹群益98購01,,,,,0.00,0.00,0,0,0,0,0,0,0,0,0,0,0,0,0
20200520,057115,元油2X日盛9A購01,,,,,0.00,0.00,0,0,0,0,0,0,0,0,0,0,0,0,0
20200520,057116,鴻海日盛9A購01,,,,,0.00,0.00,0,0,0,0,0,0,0,0,0,0,0,0,0
20200520,057117,開發金日盛9B購01,0.72,0.72,0.62,0.62,0.00,0.00,11000,2,6920,0,0,0,0,0,0,0,10000,-10000,-10000
20200520,057118,欣興日盛9A購01,1.36,1.36,1.22,1.22,+0.16,15.09,6000,2,7460,0,0,0,0,0,0,5000,1000,4000,4000
20200520,057119,微星康和98購01,2.00,2.00,1.86,1.86,-0.02,-1.06,72000,4,141700,0,0,0,0,0,0,17000,55000,-38000,-38000
20200520,05711P,茂林國票97售03,0.52,0.52,0.38,0.38,-0.18,-32.14,28000,7,12010,0,0,0,0,0,0,4000,24000,-20000,-20000
20200520,057120,茂林康和98購01,0.65,0.69,0.65,0.69,0.00,0.00,272000,7,180840,0,0,0,0,0,0,0,272000,-272000,-272000
20200520,057121,立積康和98購01,0.45,0.45,0.45,0.45,+0.04,9.76,68000,2,30600,0,0,0,0,0,0,0,68000,-68000,-68000
20200520,057122,元油2X凱基9B購05,,,,,0.00,0.00,0,0,0,0,0,0,0,0,0,0,0,0,0
20200520,057123,上銀凱基98購05,,,,,0.00,0.00,0,0,0,0,0,0,0,0,0,0,0,0,0
20200520,057124,為升凱基98購02,0.07,0.07,0.07,0.07,0.00,0.00,20000,1,1400,0,0,0,0,0,0,0,0,0,0
20200520,057125,國巨凱基98購12,1.09,1.10,1.09,1.10,+0.06,5.77,30000,2,32900,0,0,0,0,0,0,30000,0,30000,30000
20200520,057126,台積電凱基99購03,,,,,0.00,0.00,0,0,0,0,0,0,0,0,0,0,0,0,0
20200520,057127,旺宏凱基98購09,,,,,0.00,0.00,0,0,0,0,0,0,0,0,0,0,0,0,0
20200520,057128,台光電凱基98購03,,,,,0.00,0.00,0,0,0,0,0,0,0,0,0,0,0,0,0
20200520,057129,聯發科凱基99購03,,,,,0.00,0.00,0,0,0,0,0,0,0,0,0,0,0,0,0
20200520,05712P,友達統一97售03,,,,,0.00,0.00,0,0,0,0,0,0,0,0,0,0,0,0,0
20200520,057130,全新凱基98購03,0.34,0.34,0.32,0.32,-0.07,-17.95,130000,2,42900,0,0,0,0,0,0,65000,65000,0,0
20200520,057131,奇力新凱基98購05,0.61,0.64,0.61,0.64,+0.03,4.92,113000,2,70220,0,0,0,0,0,0,70000,43000,27000,27000
20200520,057132,華新科凱基98購05,0.77,0.81,0.76,0.76,0.00,0.00,231000,9,185560,0,0,0,0,0,0,231000,15000,216000,216000
20200520,057133,京鼎凱基98購02,0.55,0.55,0.55,0.55,-0.02,-3.51,48000,1,26400,0,0,0,0,0,0,48000,0,48000,48000
20200520,057134,茂林凱基98購02,0.66,0.92,0.66,0.92,0.00,0.00,314000,12,242460,0,0,0,0,0,0,0,314000,-314000,-314000
20200520,057135,立積凱基98購01,,,,,0.00,0.00,0,0,0,0,0,0,0,0,0,0,0,0,0
20200520,057136,立積凱基98購02,1.15,1.15,1.13,1.13,-0.06,-5.04,26000,8,29460,0,0,0,0,0,0,20000,6000,14000,14000
20200520,057137,鈺齊凱基98購01,0.31,0.31,0.31,0.31,+0.04,14.81,100000,1,31000,0,0,0,0,0,0,0,100000,-100000,-100000
20200520,057138,亞德客兆豐98購01,1.33,1.33,1.26,1.26,-0.01,-0.79,50000,3,63700,0,0,0,0,0,0,10000,40000,-30000,-30000
20200520,057139,華新科兆豐98購02,,,,,0.00,0.00,0,0,0,0,0,0,0,0,0,0,0,0,0
20200520,05713P,大立光統一96售05,,,,,0.00,0.00,0,0,0,0,0,0,0,0,0,0,0,0,0
20200520,057140,宏達電兆豐98購01,0.50,0.52,0.50,0.52,0.00,0.00,14000,2,7200,0,0,0,0,0,0,10000,4000,6000,6000
20200520,057141,嘉聯益兆豐99購01,0.67,0.69,0.67,0.67,0.00,0.00,97000,3,66490,0,0,0,0,0,0,75000,22000,53000,53000
20200520,057142,力成兆豐98購01,0.27,0.27,0.17,0.17,-0.03,-15.0,13000,4,2480,0,0,0,0,0,0,0,11000,-11000,-11000
20200520,057143,台郡兆豐98購01,,,,,0.00,0.00,0,0,0,0,0,0,0,0,0,0,0,0,0
20200520,057144,南電兆豐98購01,,,,,0.00,0.00,0,0,0,0,0,0,0,0,0,0,0,0,0
20200520,057145,上銀國票98購03,,,,,0.00,0.00,0,0,0,0,0,0,0,0,0,0,0,0,0
20200520,057146,技嘉國票98購01,,,,,0.00,0.00,0,0,0,0,0,0,0,0,0,0,0,0,0
20200520,057147,新日興國票99購01,1.79,2.15,1.79,2.15,+0.20,10.26,318000,12,632770,0,0,0,0,0,0,0,318000,-318000,-318000
20200520,057148,玉晶光國票99購04,2.06,2.24,2.06,2.24,0.00,0.00,6000,3,13250,0,0,0,0,0,0,2000,6000,-4000,-4000
20200520,057149,京鼎國票99購02,1.30,1.34,1.30,1.33,-0.01,-0.75,189000,5,249710,0,0,0,0,0,0,74000,115000,-41000,-41000
20200520,05714P,群創統一97售03,,,,,0.00,0.00,0,0,0,0,0,0,0,0,0,0,0,0,0
20200520,057150,貿聯國票99購02,1.43,1.43,1.43,1.43,+0.05,3.62,25000,1,35750,0,0,0,0,0,0,25000,0,25000,25000
20200520,057151,易華電國票99購01,0.80,0.80,0.80,0.80,-0.05,-5.88,6000,1,4800,0,0,0,0,0,0,0,6000,-6000,-6000
20200520,057152,緯穎國票99購03,6.35,6.35,6.35,6.35,-0.10,-1.55,2000,1,12700,0,0,0,0,0,0,2000,0,2000,2000
20200520,057153,祥碩國泰99購01,3.26,3.60,3.26,3.60,+0.37,11.46,15000,3,51050,0,0,0,0,0,0,15000,0,15000,15000
20200520,057154,易華電國泰99購01,,,,,0.00,0.00,0,0,0,0,0,0,0,0,0,0,0,0,0
20200520,057155,元油2X富邦9B購02,,,,,0.00,0.00,0,0,0,0,0,0,0,0,0,0,0,0,0
20200520,057156,元油2X富邦9C購01,0.05,0.11,0.05,0.11,+0.07,175.0,11000,2,610,0,0,0,0,0,0,0,0,0,0
20200520,057157,群創富邦98購02,,,,,0.00,0.00,0,0,0,0,0,0,0,0,0,0,0,0,0
20200520,057158,義隆永豐99購01,0.74,0.75,0.74,0.75,+0.02,2.74,60000,4,44800,0,0,0,0,0,0,40000,20000,20000,20000
20200520,057159,晶技永豐98購01,,,,,0.00,0.00,0,0,0,0,0,0,0,0,0,0,0,0,0
20200520,05715P,創意元富96售05,,,,,0.00,0.00,0,0,0,0,0,0,0,0,0,0,0,0,0
20200520,057160,佐登永豐98購02,,,,,0.00,0.00,0,0,0,0,0,0,0,0,0,0,0,0,0
20200520,057161,亞德客元大98購02,2.00,2.11,1.95,1.95,+0.05,2.63,182000,12,371900,0,0,0,0,0,0,142000,40000,102000,102000
20200520,057162,上銀元大98購03,2.90,2.90,2.90,2.90,+0.02,0.69,50000,1,145000,0,0,0,0,0,0,0,50000,-50000,-50000
20200520,057163,上銀元大98購04,1.66,1.66,1.66,1.66,+0.01,0.61,68000,1,112880,0,0,0,0,0,0,0,68000,-68000,-68000
20200520,057164,國巨元大98購14,2.29,2.48,2.28,2.37,+0.15,6.76,39000,4,89480,0,0,0,0,0,0,11000,29000,-18000,-18000
20200520,057165,國巨元大99購05,3.35,3.59,3.35,3.36,0.00,0.00,63000,5,213950,0,0,0,0,0,0,2000,63000,-61000,-61000
20200520,057166,國巨元大99購06,,,,,0.00,0.00,0,0,0,0,0,0,0,0,0,0,0,0,0
20200520,057167,台積電元大99購03,0.95,0.95,0.95,0.95,0.00,0.00,13000,1,12350,0,0,0,0,0,0,0,0,0,0
20200520,057168,旺宏元大99購03,,,,,0.00,0.00,0,0,0,0,0,0,0,0,0,0,0,0,0
20200520,057169,微星元大98購01,3.73,3.73,3.41,3.41,+0.04,1.19,123000,6,449030,0,0,0,0,0,0,73000,50000,23000,23000
20200520,05716P,T50反1元大98售03,,,,,0.00,0.00,0,0,0,0,0,0,0,0,0,0,0,0,0
20200520,057170,瑞昱元大98購01,2.99,3.11,2.80,2.81,-0.10,-3.44,357000,42,1066960,0,0,0,0,0,0,286000,169000,117000,117000
20200520,057171,台光電元大9B購01,2.49,2.54,2.47,2.54,-0.05,-1.93,131000,9,327580,0,0,0,0,0,0,87000,78000,9000,9000
20200520,057172,南亞科元大98購03,0.87,0.88,0.87,0.88,+0.05,6.02,78000,2,68540,0,0,0,0,0,0,10000,68000,-58000,-58000
20200520,057173,南亞科元大98購04,0.90,0.95,0.89,0.90,+0.02,2.27,154000,14,138510,0,0,0,0,0,0,139000,15000,124000,124000
20200520,057174,南亞科元大98購05,0.92,0.96,0.91,0.96,+0.09,10.34,146000,5,136060,0,0,0,0,0,0,78000,68000,10000,10000
20200520,057175,美律元大98購03,0.33,0.33,0.33,0.33,0.00,0.00,124000,1,40920,0,0,0,0,0,0,0,124000,-124000,-124000
20200520,057176,全新元大99購02,0.97,0.97,0.96,0.96,-0.11,-10.28,15000,2,14450,0,0,0,0,0,0,10000,5000,5000,5000
20200520,057177,奇力新元大99購04,0.71,0.77,0.71,0.77,0.00,0.00,83000,3,62930,0,0,0,0,0,0,73000,10000,63000,63000
20200520,057178,可成元大98購03,1.32,1.32,1.32,1.32,-0.44,-25.0,2000,1,2640,0,0,0,0,0,0,0,2000,-2000,-2000
20200520,057179,可成元大98購04,1.74,1.74,1.61,1.62,-0.28,-14.74,295000,12,489560,0,0,0,0,0,0,100000,195000,-95000,-95000
20200520,05717P,鴻海元大97售07,,,,,0.00,0.00,0,0,0,0,0,0,0,0,0,0,0,0,0
20200520,057180,華新科元大99購08,,,,,0.00,0.00,0,0,0,0,0,0,0,0,0,0,0,0,0
20200520,057181,亞光元大98購02,1.19,1.19,1.19,1.19,+0.07,6.25,132000,2,157080,0,0,0,0,0,0,0,132000,-132000,-132000
20200520,057182,禾伸堂元大99購02,,,,,0.00,0.00,0,0,0,0,0,0,0,0,0,0,0,0,0
20200520,057183,玉晶光元大99購07,,,,,0.00,0.00,0,0,0,0,0,0,0,0,0,0,0,0,0
20200520,057184,群創元大98購05,,,,,0.00,0.00,0,0,0,0,0,0,0,0,0,0,0,0,0
20200520,057185,群創元大98購06,,,,,0.00,0.00,0,0,0,0,0,0,0,0,0,0,0,0,0
20200520,057186,群創元大99購04,,,,,0.00,0.00,0,0,0,0,0,0,0,0,0,0,0,0,0
20200520,057187,群創元大9B購04,0.33,0.33,0.33,0.33,0.00,0.00,1000,1,330,0,0,0,0,0,0,0,1000,-1000,-1000
20200520,057188,佐登元大98購01,1.10,1.10,1.04,1.04,-0.06,-5.45,32000,2,34000,0,0,0,0,0,0,12000,20000,-8000,-8000
20200520,057189,康控元大98購02,1.55,1.55,1.42,1.42,0.00,0.00,71000,8,105980,0,0,0,0,0,0,71000,0,71000,71000
20200520,05718P,國巨元大96售09,0.43,0.43,0.43,0.43,-0.10,-18.87,118000,1,50740,0,0,0,0,0,0,118000,118000,0,0
20200520,057190,立積元大9A購02,1.13,1.13,1.02,1.03,-0.03,-2.83,56000,8,59700,0,0,0,0,0,0,20000,46000,-26000,-26000
20200520,057191,祥碩元大98購05,5.45,6.00,5.45,6.00,+0.85,16.5,39000,4,224250,0,0,0,0,0,0,0,39000,-39000,-39000
20200520,057192,力成元大98購01,,,,,0.00,0.00,0,0,0,0,0,0,0,0,0,0,0,0,0
20200520,057193,力成元大98購02,,,,,0.00,0.00,0,0,0,0,0,0,0,0,0,0,0,0,0
20200520,057194,南電元大98購01,7.30,7.35,6.90,6.90,-0.30,-4.17,29000,3,212200,0,0,0,0,0,0,28000,1000,27000,27000
20200520,057195,南茂元大98購01,1.35,1.46,1.35,1.46,+0.12,8.96,250000,11,355980,0,0,0,0,0,0,84000,180000,-96000,-96000
20200520,057196,茂林台新98購01,0.89,1.10,0.89,1.10,0.00,0.00,312000,8,283700,0,0,0,0,0,0,5000,302000,-297000,-297000
20200520,057197,立積台新98購01,0.64,0.64,0.60,0.60,-0.04,-6.25,220000,6,136300,0,0,0,0,0,0,0,190000,-190000,-190000
20200520,057198,智伸科統一9B購01,0.29,0.32,0.29,0.32,+0.07,28.0,595000,5,178530,0,0,0,0,0,0,593000,0,593000,593000
20200520,057199,台達電元富02購01,1.16,1.18,1.16,1.18,+0.03,2.61,656000,31,771230,0,0,0,0,0,0,436000,220000,216000,216000
20200520,05719P,可成元大96售03,1.46,1.46,1.43,1.46,+0.43,41.75,9000,3,13080,0,0,0,0,0,0,8000,1000,7000,7000
20200520,057200,技嘉元富98購01,,,,,0.00,0.00,0,0,0,0,0,0,0,0,0,0,0,0,0
20200520,057201,華擎元富98購01,2.85,3.47,2.85,3.32,+0.74,28.68,248000,52,815330,0,0,0,0,0,0,2000,231000,-229000,-229000
20200520,057202,TPK元富98購02,0.83,0.87,0.83,0.85,+0.04,4.94,441000,38,378930,0,0,0,0,0,0,344000,97000,247000,247000
20200520,057203,麗豐元富98購02,0.60,0.64,0.58,0.64,+0.01,1.59,198000,4,120120,0,0,0,0,0,0,100000,98000,2000,2000
20200520,057204,利勤元富98購01,,,,,0.00,0.00,0,0,0,0,0,0,0,0,0,0,0,0,0
20200520,057205,元翎元富98購01,,,,,0.00,0.00,0,0,0,0,0,0,0,0,0,0,0,0,0
20200520,057206,立積元富98購01,1.48,1.51,1.38,1.38,-0.15,-9.8,229000,8,328970,0,0,0,0,0,0,84000,145000,-61000,-61000
20200520,057207,立積元富98購02,1.43,1.48,1.34,1.34,-0.07,-4.96,180000,8,256660,0,0,0,0,0,0,105000,75000,30000,30000
20200520,057208,上海銀元富98購01,0.25,0.25,0.25,0.25,0.00,0.00,25000,1,6250,0,0,0,0,0,0,25000,0,25000,25000
20200520,057209,元油2X第一98購01,,,,,0.00,0.00,0,0,0,0,0,0,0,0,0,0,0,0,0
20200520,05720P,可成中信98售01,0.39,0.39,0.39,0.39,+0.06,18.18,50000,1,19500,0,0,0,0,0,0,50000,0,50000,50000
20200520,057210,T50反1群益98購01,,,,,0.00,0.00,0,0,0,0,0,0,0,0,0,0,0,0,0
20200520,057211,鴻海群益98購05,1.73,1.77,1.65,1.65,-0.11,-6.25,148000,7,250890,0,0,0,0,0,0,98000,54000,44000,44000
20200520,057212,台積電群益98購03,0.13,0.13,0.13,0.13,0.00,0.00,40000,1,5200,0,0,0,0,0,0,40000,0,40000,40000
20200520,057213,華邦電群益98購01,,,,,0.00,0.00,0,0,0,0,0,0,0,0,0,0,0,0,0
20200520,057214,瑞昱群益98購01,2.86,2.86,2.70,2.70,-0.46,-14.56,145000,22,409440,0,0,0,0,0,0,123000,22000,101000,101000
20200520,057215,友達群益98購03,,,,,0.00,0.00,0,0,0,0,0,0,0,0,0,0,0,0,0
20200520,057216,聯發科群益99購01,4.16,4.29,4.14,4.19,+0.10,2.44,26000,4,109290,0,0,0,0,0,0,18000,8000,10000,10000
20200520,057217,奇力新群益99購01,,,,,0.00,0.00,0,0,0,0,0,0,0,0,0,0,0,0,0
20200520,057218,可成群益99購03,,,,,0.00,0.00,0,0,0,0,0,0,0,0,0,0,0,0,0
20200520,057219,群創群益98購10,,,,,0.00,0.00,0,0,0,0,0,0,0,0,0,0,0,0,0
20200520,05721P,全新群益98售02,1.40,1.46,1.40,1.46,+0.08,5.8,8000,3,11560,0,0,0,0,0,0,6000,2000,4000,4000
20200520,057220,鈺齊群益98購01,,,,,0.00,0.00,0,0,0,0,0,0,0,0,0,0,0,0,0
20200520,057221,華通國票98購03,3.09,3.09,3.09,3.09,0.00,0.00,10000,1,30900,0,0,0,0,0,0,0,10000,-10000,-10000
20200520,057222,鴻海國票99購04,,,,,0.00,0.00,0,0,0,0,0,0,0,0,0,0,0,0,0
20200520,057223,富邦金日盛99購01,0.41,0.41,0.41,0.41,0.00,0.00,10000,1,4100,0,0,0,0,0,0,10000,0,10000,10000
20200520,057224,和碩日盛9A購01,,,,,0.00,0.00,0,0,0,0,0,0,0,0,0,0,0,0,0
20200520,057225,華新凱基98購01,0.47,0.47,0.44,0.44,0.00,0.00,75000,3,35100,0,0,0,0,0,0,0,75000,-75000,-75000
20200520,057226,上銀凱基98購06,,,,,0.00,0.00,0,0,0,0,0,0,0,0,0,0,0,0,0
20200520,057227,台積電凱基98購15,,,,,0.00,0.00,0,0,0,0,0,0,0,0,0,0,0,0,0
20200520,057228,友達凱基9B購01,0.94,0.94,0.94,0.94,0.00,0.00,73000,1,68620,0,0,0,0,0,0,0,73000,-73000,-73000
20200520,057229,友達凱基9B購02,,,,,0.00,0.00,0,0,0,0,0,0,0,0,0,0,0,0,0
20200520,05722P,玉晶光國票97售03,1.10,1.11,0.98,0.99,-0.10,-9.17,649000,23,661240,0,0,0,0,0,0,115000,573000,-458000,-458000
20200520,057230,建準凱基98購02,3.74,3.74,3.56,3.56,-0.29,-7.53,13000,3,48220,0,0,0,0,0,0,10000,3000,7000,7000
20200520,057231,美律凱基98購05,,,,,0.00,0.00,0,0,0,0,0,0,0,0,0,0,0,0,0
20200520,057232,京元電凱基98購02,1.04,1.06,0.97,0.97,0.00,0.00,68000,13,69220,0,0,0,0,0,0,0,68000,-68000,-68000
20200520,057233,聯發科凱基98購14,4.37,4.37,4.37,4.37,0.00,0.00,20000,2,87400,0,0,0,0,0,0,20000,20000,0,0
20200520,057234,宏達電凱基98購05,0.78,0.79,0.70,0.70,+0.03,4.48,138000,5,103860,0,0,0,0,0,0,4000,138000,-134000,-134000
20200520,057235,亞光凱基98購04,,,,,0.00,0.00,0,0,0,0,0,0,0,0,0,0,0,0,0
20200520,057236,聯詠凱基98購03,0.69,0.72,0.68,0.71,-0.10,-12.35,79000,25,55100,0,0,0,0,0,0,30000,9000,21000,21000
20200520,057237,群創凱基9B購02,,,,,0.00,0.00,0,0,0,0,0,0,0,0,0,0,0,0,0
20200520,057238,群創凱基9B購03,,,,,0.00,0.00,0,0,0,0,0,0,0,0,0,0,0,0,0
20200520,057239,貿聯凱基98購05,2.38,2.38,2.36,2.36,+0.04,1.72,90000,16,213000,0,0,0,0,0,0,70000,0,70000,70000
20200520,05723P,華通永豐96售03,0.68,0.68,0.65,0.65,0.00,0.00,50000,3,32800,0,0,0,0,0,0,40000,10000,30000,30000
20200520,057240,茂林凱基9A購01,0.52,0.70,0.52,0.70,+0.21,42.86,163000,11,88600,0,0,0,0,0,0,50000,120000,-70000,-70000
20200520,057241,超眾凱基99購02,,,,,0.00,0.00,0,0,0,0,0,0,0,0,0,0,0,0,0
20200520,057242,台郡凱基98購05,1.09,1.09,1.09,1.09,0.00,0.00,10000,1,10900,0,0,0,0,0,0,0,10000,-10000,-10000
20200520,057243,樺漢凱基99購01,2.19,2.19,2.19,2.19,+0.07,3.3,20000,1,43800,0,0,0,0,0,0,20000,0,20000,20000
20200520,057244,鈺齊凱基99購01,,,,,0.00,0.00,0,0,0,0,0,0,0,0,0,0,0,0,0
20200520,057245,福懋科台新98購01,,,,,0.00,0.00,0,0,0,0,0,0,0,0,0,0,0,0,0
20200520,057246,元油2X統一99購01,,,,,0.00,0.00,0,0,0,0,0,0,0,0,0,0,0,0,0
20200520,057247,元油2X統一9A購01,,,,,0.00,0.00,0,0,0,0,0,0,0,0,0,0,0,0,0
20200520,057248,台積電統一98購08,,,,,0.00,0.00,0,0,0,0,0,0,0,0,0,0,0,0,0
20200520,057249,華邦電統一9A購01,0.61,0.63,0.61,0.63,+0.04,6.78,153000,5,94930,0,0,0,0,0,0,1000,152000,-151000,-151000
20200520,05724P,致茂永豐96售01,0.56,0.56,0.52,0.52,-0.08,-13.33,136000,4,72110,0,0,0,0,0,0,125000,10000,115000,115000
20200520,057250,大立光統一98購08,0.71,0.71,0.71,0.71,0.00,0.00,3000,1,2130,0,0,0,0,0,0,3000,0,3000,3000
20200520,057251,泰鼎統一98購02,,,,,0.00,0.00,0,0,0,0,0,0,0,0,0,0,0,0,0
20200520,057252,牧德元富98購01,,,,,0.00,0.00,0,0,0,0,0,0,0,0,0,0,0,0,0
20200520,057253,高股息中信99購02,,,,,0.00,0.00,0,0,0,0,0,0,0,0,0,0,0,0,0
20200520,057254,友達麥證98購01,,,,,0.00,0.00,0,0,0,0,0,0,0,0,0,0,0,0,0
20200520,057255,聯發科麥證98購02,3.35,3.35,3.35,3.35,+0.12,3.72,5000,1,16750,5000,0,5000,0,0,0,5000,0,5000,5000
20200520,057256,元油2X兆豐98購01,,,,,0.00,0.00,0,0,0,0,0,0,0,0,0,0,0,0,0
20200520,057257,台泥兆豐99購01,1.58,1.61,1.56,1.58,-0.05,-3.07,448000,16,710260,0,0,0,0,0,0,346000,99000,247000,247000
20200520,057258,中環兆豐98購01,,,,,0.00,0.00,0,0,0,0,0,0,0,0,0,0,0,0,0
20200520,057259,台積電兆豐98購03,,,,,0.00,0.00,0,0,0,0,0,0,0,0,0,0,0,0,0
20200520,05725P,嘉聯益永豐96售02,,,,,0.00,0.00,0,0,0,0,0,0,0,0,0,0,0,0,0
20200520,057260,微星兆豐98購01,2.17,2.21,2.04,2.08,+0.02,0.97,106000,12,221750,0,0,0,0,0,0,66000,40000,26000,26000
20200520,057261,瑞昱兆豐98購01,,,,,0.00,0.00,0,0,0,0,0,0,0,0,0,0,0,0,0
20200520,057262,友達兆豐98購03,0.01,0.01,0.01,0.01,0.00,0.00,10000,1,100,0,0,0,0,0,0,0,10000,-10000,-10000
20200520,057263,可成兆豐99購01,0.53,0.53,0.45,0.45,-0.17,-27.42,15000,3,7530,0,0,0,0,0,0,0,15000,-15000,-15000
20200520,057264,新光金兆豐98購01,,,,,0.00,0.00,0,0,0,0,0,0,0,0,0,0,0,0,0
20200520,057265,聯詠兆豐98購01,,,,,0.00,0.00,0,0,0,0,0,0,0,0,0,0,0,0,0
20200520,057266,TPK兆豐98購02,0.66,0.67,0.64,0.64,-0.01,-1.54,266000,19,174720,0,0,0,0,0,0,152000,114000,38000,38000
20200520,057267,康控兆豐99購01,0.62,0.62,0.58,0.59,-0.02,-3.28,462000,26,273230,0,0,0,0,0,0,424000,38000,386000,386000
20200520,057268,臻鼎兆豐99購01,0.56,0.57,0.56,0.57,+0.06,11.76,45000,6,25250,0,10000,-10000,0,0,0,45000,0,45000,35000
20200520,057269,鈺齊兆豐98購01,0.13,0.13,0.13,0.13,0.00,0.00,1000,1,130,0,0,0,0,0,0,1000,0,1000,1000
20200520,05726P,易華電永豐96售02,,,,,0.00,0.00,0,0,0,0,0,0,0,0,0,0,0,0,0
20200520,057270,遠東新元大98購01,1.07,1.24,0.98,1.24,+0.13,11.71,147000,9,157070,0,0,0,0,0,0,125000,15000,110000,110000
20200520,057271,國巨元大98購17,,,,,0.00,0.00,0,0,0,0,0,0,0,0,0,0,0,0,0
20200520,057272,台積電元大98購14,1.06,1.06,1.06,1.06,0.00,0.00,5000,1,5300,0,0,0,0,0,0,0,0,0,0
20200520,057273,智邦元大98購05,5.65,5.95,5.65,5.85,+0.20,3.54,56000,3,318100,0,0,0,0,0,0,55000,6000,49000,49000
20200520,057274,友達元大98購03,,,,,0.00,0.00,0,0,0,0,0,0,0,0,0,0,0,0,0
20200520,057275,友達元大9A購04,0.49,0.49,0.49,0.49,+0.05,11.36,245000,1,120050,0,0,0,0,0,0,0,245000,-245000,-245000
20200520,057276,全新元大99購03,0.61,0.61,0.57,0.57,-0.06,-9.52,60000,2,35400,0,0,0,0,0,0,30000,30000,0,0
20200520,057277,可成元大98購05,1.81,1.81,1.72,1.72,0.00,0.00,23000,2,39830,0,0,0,0,0,0,0,23000,-23000,-23000
20200520,057278,可成元大98購06,1.29,1.29,1.19,1.19,-0.18,-13.14,115000,5,146510,0,0,0,0,0,0,8000,115000,-107000,-107000
20200520,057279,國揚元大98購01,3.64,3.76,3.43,3.52,-0.36,-9.28,324000,24,1131930,0,0,0,0,0,0,297000,24000,273000,273000
20200520,05727P,新光金日盛96售02,,,,,0.00,0.00,0,0,0,0,0,0,0,0,0,0,0,0,0
20200520,057280,大立光元大98購15,1.32,1.38,1.31,1.33,-0.09,-6.34,79000,5,106570,0,0,0,0,0,0,68000,11000,57000,57000
20200520,057281,大立光元大98購16,1.50,1.57,1.50,1.57,0.00,0.00,58000,2,87210,0,0,0,0,0,0,0,55000,-55000,-55000
20200520,057282,大立光元大99購06,0.90,0.93,0.90,0.93,+0.04,4.49,13000,2,11850,0,0,0,0,0,0,13000,0,13000,13000
20200520,057283,欣興元大98購07,2.18,2.28,2.09,2.11,0.00,0.00,328000,26,703960,0,0,0,0,0,0,132000,196000,-64000,-64000
20200520,057284,新日興元大98購03,1.55,1.55,1.44,1.47,-0.17,-10.37,136000,5,205360,0,0,0,0,0,0,68000,68000,0,0
20200520,057285,群創元大98購07,,,,,0.00,0.00,0,0,0,0,0,0,0,0,0,0,0,0,0
20200520,057286,群創元大9B購05,0.32,0.32,0.32,0.32,0.00,0.00,50000,1,16000,0,0,0,0,0,0,0,50000,-50000,-50000
20200520,057287,彩晶元大9C購03,1.05,1.08,1.04,1.08,+0.03,2.86,124000,7,132520,0,0,0,0,0,0,124000,0,124000,124000
20200520,057288,聯茂元大98購03,2.68,2.68,2.57,2.60,-0.07,-2.62,65000,7,169900,0,0,0,0,0,0,60000,5000,55000,55000
20200520,057289,力成元大98購03,0.55,0.55,0.55,0.55,-0.08,-12.7,1000,1,550,0,0,0,0,0,0,1000,0,1000,1000
20200520,05728P,滬深2X凱基98售03,,,,,0.00,0.00,0,0,0,0,0,0,0,0,0,0,0,0,0
20200520,057290,元油2X國泰99購02,,,,,0.00,0.00,0,0,0,0,0,0,0,0,0,0,0,0,0
20200520,057291,國巨國泰9A購01,,,,,0.00,0.00,0,0,0,0,0,0,0,0,0,0,0,0,0
20200520,057292,國巨國泰9B購01,0.64,0.64,0.64,0.64,+0.07,12.28,20000,2,12800,0,0,0,0,0,0,20000,20000,0,0
20200520,057293,力成國泰99購01,,,,,0.00,0.00,0,0,0,0,0,0,0,0,0,0,0,0,0
20200520,057294,台灣50永豐99購01,,,,,0.00,0.00,0,0,0,0,0,0,0,0,0,0,0,0,0
20200520,057295,可成永豐98購02,0.61,0.61,0.57,0.57,-0.16,-21.92,97000,4,58510,0,0,0,0,0,0,37000,60000,-23000,-23000
20200520,057296,智原永豐98購01,1.25,1.25,1.25,1.25,+0.09,7.76,88000,2,110000,0,0,0,0,0,0,88000,0,88000,88000
20200520,057297,新日興永豐98購01,,,,,0.00,0.00,0,0,0,0,0,0,0,0,0,0,0,0,0
20200520,057298,旭富永豐98購01,0.84,0.88,0.84,0.85,-0.02,-2.3,178000,8,155830,0,0,0,0,0,0,10000,168000,-158000,-158000
20200520,057299,立積永豐98購02,0.29,0.29,0.27,0.27,-0.02,-6.9,32000,4,9040,0,0,0,0,0,0,10000,22000,-12000,-12000
20200520,05729P,臺股指凱基97售02,3.13,3.15,3.11,3.11,-0.24,-7.16,180000,7,563040,0,0,0,0,0,0,153000,27000,126000,126000
20200520,057300,訊連永豐98購01,0.46,0.49,0.46,0.48,-0.03,-5.88,300000,24,143430,0,0,0,0,0,0,290000,10000,280000,280000
20200520,057301,嘉聯益永豐98購02,,,,,0.00,0.00,0,0,0,0,0,0,0,0,0,0,0,0,0
20200520,057302,福懋科中信98購01,,,,,0.00,0.00,0,0,0,0,0,0,0,0,0,0,0,0,0
20200520,057303,喬山兆豐99購01,0.59,0.66,0.59,0.64,0.00,0.00,20000,3,12400,0,0,0,0,0,0,10000,10000,0,0
20200520,057304,為升兆豐99購02,0.12,0.12,0.12,0.12,-0.02,-14.29,10000,1,1200,0,0,0,0,0,0,0,10000,-10000,-10000
20200520,057305,南亞科兆豐98購02,,,,,0.00,0.00,0,0,0,0,0,0,0,0,0,0,0,0,0
20200520,057306,玉晶光兆豐99購01,,,,,0.00,0.00,0,0,0,0,0,0,0,0,0,0,0,0,0
20200520,057307,瀚宇博兆豐99購01,0.85,0.85,0.82,0.83,-0.03,-3.49,106000,7,87940,0,0,0,0,0,0,84000,22000,62000,62000
20200520,057308,同欣電兆豐99購01,0.42,0.43,0.42,0.43,+0.03,7.5,20000,2,8500,0,0,0,0,0,0,20000,0,20000,20000
20200520,057309,南茂兆豐99購01,,,,,0.00,0.00,0,0,0,0,0,0,0,0,0,0,0,0,0
20200520,05730P,臺股指凱基97售03,,,,,0.00,0.00,0,0,0,0,0,0,0,0,0,0,0,0,0
20200520,057310,聯發科日盛99購01,,,,,0.00,0.00,0,0,0,0,0,0,0,0,0,0,0,0,0
20200520,057311,玉晶光日盛9A購01,,,,,0.00,0.00,0,0,0,0,0,0,0,0,0,0,0,0,0
20200520,057312,美律麥證98購01,,,,,0.00,0.00,0,0,0,0,0,0,0,0,0,0,0,0,0
20200520,057313,聯發科麥證99購01,,,,,0.00,0.00,0,0,0,0,0,0,0,0,0,0,0,0,0
20200520,057314,全新麥證98購01,0.19,0.19,0.18,0.18,-0.03,-14.29,13000,2,2410,0,13000,-13000,0,0,0,0,13000,-13000,-13000
20200520,057315,台灣50康和9A購03,,,,,0.00,0.00,0,0,0,0,0,0,0,0,0,0,0,0,0
20200520,057316,國巨凱基99購04,0.65,0.65,0.64,0.64,+0.11,20.75,21000,3,13540,0,0,0,0,0,0,0,21000,-21000,-21000
20200520,057317,技嘉凱基98購02,1.92,1.93,1.82,1.82,-0.02,-1.09,32000,4,60750,0,0,0,0,0,0,12000,20000,-8000,-8000
20200520,057318,台光電凱基9A購01,1.64,1.64,1.64,1.64,-0.16,-8.89,10000,1,16400,0,0,0,0,0,0,10000,10000,0,0
20200520,057319,奇力新凱基99購02,0.70,0.70,0.70,0.70,0.00,0.00,49000,1,34300,0,0,0,0,0,0,0,49000,-49000,-49000
20200520,05731P,創意統一96售03,1.28,1.31,1.24,1.24,-0.08,-6.06,204000,83,260050,0,0,0,0,0,0,106000,93000,13000,13000
20200520,057320,玉晶光凱基98購01,,,,,0.00,0.00,0,0,0,0,0,0,0,0,0,0,0,0,0
20200520,057321,台泥群益98購01,3.95,3.97,3.93,3.97,-0.05,-1.24,98000,8,387460,0,0,0,0,0,0,98000,40000,58000,58000
20200520,057322,旺宏群益98購04,0.65,0.65,0.65,0.65,-0.01,-1.52,10000,1,6500,0,0,0,0,0,0,0,10000,-10000,-10000
20200520,057323,智邦群益98購01,5.80,6.20,5.80,6.10,+0.20,3.39,25000,7,149550,0,0,0,0,0,0,11000,14000,-3000,-3000
20200520,057324,億光群益98購01,0.79,0.81,0.74,0.74,0.00,0.00,44000,4,34600,0,0,0,0,0,0,8000,36000,-28000,-28000
20200520,057325,可成群益9A購01,1.82,1.82,1.70,1.70,-0.33,-16.26,103000,11,178560,0,0,0,0,0,0,3000,103000,-100000,-100000
20200520,057326,景碩群益99購02,,,,,0.00,0.00,0,0,0,0,0,0,0,0,0,0,0,0,0
20200520,057327,玉晶光群益9A購04,2.37,2.53,2.37,2.53,+0.18,7.66,87000,16,217050,0,0,0,0,0,0,7000,87000,-80000,-80000
20200520,057328,京鼎群益99購02,1.26,1.26,1.26,1.26,0.00,0.00,40000,4,50400,0,0,0,0,0,0,10000,30000,-20000,-20000
20200520,057329,緯穎群益98購02,3.88,4.07,3.48,3.52,-0.03,-0.85,195000,18,727860,0,0,0,0,0,0,113000,122000,-9000,-9000
20200520,05732P,臺股指統一96售02,3.68,3.77,3.68,3.77,-0.14,-3.58,5000,3,18630,0,0,0,0,0,0,3000,2000,1000,1000
20200520,057330,台積電國票99購03,,,,,0.00,0.00,0,0,0,0,0,0,0,0,0,0,0,0,0
20200520,057331,台積電國票99購04,,,,,0.00,0.00,0,0,0,0,0,0,0,0,0,0,0,0,0
20200520,057332,旺宏國票99購03,,,,,0.00,0.00,0,0,0,0,0,0,0,0,0,0,0,0,0
20200520,057333,智邦國票99購01,,,,,0.00,0.00,0,0,0,0,0,0,0,0,0,0,0,0,0
20200520,057334,技嘉國票98購02,3.96,3.97,3.79,3.79,-0.16,-4.05,49000,7,186980,0,0,0,0,0,0,9000,43000,-34000,-34000
20200520,057335,技嘉國票99購01,2.68,2.71,2.62,2.62,+0.04,1.55,27000,3,72390,0,0,0,0,0,0,22000,5000,17000,17000
20200520,057336,聯發科國票99購01,,,,,0.00,0.00,0,0,0,0,0,0,0,0,0,0,0,0,0
20200520,057337,聯發科國票99購02,,,,,0.00,0.00,0,0,0,0,0,0,0,0,0,0,0,0,0
20200520,057338,群創國票99購01,,,,,0.00,0.00,0,0,0,0,0,0,0,0,0,0,0,0,0
20200520,057339,群創國票99購02,,,,,0.00,0.00,0,0,0,0,0,0,0,0,0,0,0,0,0
20200520,05733P,臺股指統一96售03,,,,,0.00,0.00,0,0,0,0,0,0,0,0,0,0,0,0,0
20200520,057340,玉晶光元富98購04,2.29,2.36,2.29,2.36,+0.22,10.28,31000,3,71800,0,0,0,0,0,0,21000,10000,11000,11000
20200520,057341,技嘉台新98購01,,,,,0.00,0.00,0,0,0,0,0,0,0,0,0,0,0,0,0
20200520,057342,玉晶光台新98購01,0.45,0.45,0.45,0.45,0.00,0.00,80000,1,36000,0,0,0,0,0,0,80000,0,80000,80000
20200520,057343,道瓊反統一9A購01,,,,,0.00,0.00,0,0,0,0,0,0,0,0,0,0,0,0,0
20200520,057344,元油2X統一98購03,,,,,0.00,0.00,0,0,0,0,0,0,0,0,0,0,0,0,0
20200520,057345,中50統一98購01,,,,,0.00,0.00,0,0,0,0,0,0,0,0,0,0,0,0,0
20200520,057346,鴻海統一98購13,,,,,0.00,0.00,0,0,0,0,0,0,0,0,0,0,0,0,0
20200520,057347,國巨統一9A購03,0.66,0.73,0.64,0.67,+0.08,13.56,1073000,54,722160,0,0,0,0,0,0,487000,586000,-99000,-99000
20200520,057348,台積電統一98購09,,,,,0.00,0.00,0,0,0,0,0,0,0,0,0,0,0,0,0
20200520,057349,聯發科統一98購04,3.54,3.54,3.33,3.33,+0.11,3.42,21000,2,70140,0,0,0,0,0,0,21000,0,21000,21000
20200520,05734P,臺股指統一96售04,,,,,0.00,0.00,0,0,0,0,0,0,0,0,0,0,0,0,0
20200520,057350,全新統一98購03,,,,,0.00,0.00,0,0,0,0,0,0,0,0,0,0,0,0,0
20200520,057351,奇力新統一98購02,,,,,0.00,0.00,0,0,0,0,0,0,0,0,0,0,0,0,0
20200520,057352,大立光統一9A購02,1.45,1.53,1.45,1.52,+0.02,1.33,30000,3,45250,0,0,0,0,0,0,23000,7000,16000,16000
20200520,057353,玉晶光統一99購01,1.09,1.09,1.09,1.09,+0.04,3.81,3000,1,3270,0,0,0,0,0,0,3000,0,3000,3000
20200520,057354,聯鈞統一99購03,0.69,0.69,0.59,0.63,-0.02,-3.08,50000,7,31750,0,0,0,0,0,0,30000,20000,10000,10000
20200520,057355,彩晶統一98購03,0.22,0.22,0.22,0.22,0.00,0.00,8000,1,1760,0,0,0,0,0,0,8000,0,8000,8000
20200520,057356,彩晶統一98購04,0.51,0.51,0.51,0.51,0.00,0.00,59000,1,30090,0,0,0,0,0,0,0,59000,-59000,-59000
20200520,057357,超眾統一98購01,,,,,0.00,0.00,0,0,0,0,0,0,0,0,0,0,0,0,0
20200520,057358,元油2X元大98購08,,,,,0.00,0.00,0,0,0,0,0,0,0,0,0,0,0,0,0
20200520,057359,元油2X元大98購09,,,,,0.00,0.00,0,0,0,0,0,0,0,0,0,0,0,0,0
20200520,05735P,臺股指統一96售05,,,,,0.00,0.00,0,0,0,0,0,0,0,0,0,0,0,0,0
20200520,057360,元油2X元大98購10,0.38,0.41,0.38,0.41,-0.04,-8.89,18000,2,7140,0,0,0,0,0,0,10000,8000,2000,2000
20200520,057361,元油2X元大98購11,,,,,0.00,0.00,0,0,0,0,0,0,0,0,0,0,0,0,0
20200520,057362,元油2X元大98購12,,,,,0.00,0.00,0,0,0,0,0,0,0,0,0,0,0,0,0
20200520,057363,華通元大99購02,4.57,4.57,4.57,4.57,-0.43,-8.6,30000,1,137100,0,0,0,0,0,0,0,30000,-30000,-30000
20200520,057364,國巨元大98購18,2.75,2.75,2.57,2.57,0.00,0.00,26000,2,67000,0,0,0,0,0,0,1000,26000,-25000,-25000
20200520,057365,智邦元大98購07,5.55,5.55,5.55,5.55,+0.05,0.91,30000,1,166500,0,0,0,0,0,0,30000,0,30000,30000
20200520,057366,智邦元大98購08,3.33,3.50,3.33,3.47,+0.16,4.83,86000,9,291200,0,0,0,0,0,0,15000,81000,-66000,-66000
20200520,057367,技嘉元大98購02,3.86,3.86,3.77,3.77,-0.08,-2.08,34000,2,130790,0,0,0,0,0,0,5000,29000,-24000,-24000
20200520,057368,微星元大98購02,3.39,3.39,3.13,3.28,+0.06,1.86,62000,4,208510,0,0,0,0,0,0,11000,51000,-40000,-40000
20200520,057369,奇力新元大99購05,1.61,1.68,1.56,1.56,+0.03,1.96,339000,9,565060,0,0,0,0,0,0,313000,26000,287000,287000
20200520,05736P,臺股指統一96售06,,,,,0.00,0.00,0,0,0,0,0,0,0,0,0,0,0,0,0
20200520,057370,可成元大98購07,1.21,1.21,1.21,1.21,0.00,0.00,36000,1,43560,0,0,0,0,0,0,36000,36000,0,0
20200520,057371,可成元大98購08,1.88,1.88,1.73,1.73,-0.27,-13.5,61000,4,113140,0,0,0,0,0,0,11000,61000,-50000,-50000
20200520,057372,華新科元大99購10,,,,,0.00,0.00,0,0,0,0,0,0,0,0,0,0,0,0,0
20200520,057373,大立光元大98購17,1.34,1.42,1.34,1.42,0.00,0.00,76000,2,102480,0,0,0,0,0,0,0,76000,-76000,-76000
20200520,057374,禾伸堂元大99購03,2.53,2.58,2.50,2.55,+0.07,2.82,122000,10,307950,0,0,0,0,0,0,122000,72000,50000,50000
20200520,057375,欣興元大98購09,2.37,2.58,2.37,2.50,+0.41,19.62,110000,8,273800,0,0,0,0,0,0,50000,60000,-10000,-10000
20200520,057376,新日興元大98購04,1.19,1.28,1.10,1.28,+0.09,7.56,165000,9,194600,0,0,0,0,0,0,68000,97000,-29000,-29000
20200520,057377,康控元大99購02,1.25,1.26,1.12,1.12,-0.06,-5.08,406000,28,482640,0,0,0,0,0,0,406000,166000,240000,240000
20200520,057378,康友元大98購02,0.47,0.47,0.47,0.47,-0.05,-9.62,68000,2,31960,0,0,0,0,0,0,68000,0,68000,68000
20200520,057379,寶成元大98購02,,,,,0.00,0.00,0,0,0,0,0,0,0,0,0,0,0,0,0
20200520,05737P,臺股指統一96售07,,,,,0.00,0.00,0,0,0,0,0,0,0,0,0,0,0,0,0
20200520,057380,技嘉國泰9A購01,2.26,2.26,2.12,2.14,-0.17,-7.36,5000,4,10840,0,0,0,0,0,0,5000,0,5000,5000
20200520,057381,微星國泰9A購01,2.24,2.24,2.11,2.11,+0.19,9.9,24000,2,51940,0,0,0,0,0,0,24000,24000,0,0
20200520,057382,聯發科國泰9A購01,,,,,0.00,0.00,0,0,0,0,0,0,0,0,0,0,0,0,0
20200520,057383,玉晶光富邦9A購01,0.77,0.77,0.77,0.77,0.00,0.00,150000,1,115500,0,0,0,0,0,0,150000,0,150000,150000
20200520,057384,台灣50永豐99購02,,,,,0.00,0.00,0,0,0,0,0,0,0,0,0,0,0,0,0
20200520,057385,光罩永豐99購01,0.23,0.29,0.23,0.29,+0.05,20.83,468000,23,123890,0,0,0,0,0,0,356000,106000,250000,250000
20200520,057386,聯發科永豐98購04,4.41,4.41,4.41,4.41,+0.32,7.82,20000,1,88200,0,0,0,0,0,0,0,20000,-20000,-20000
20200520,057387,奇力新永豐98購03,0.31,0.34,0.31,0.32,0.00,0.00,88000,3,28460,0,0,0,0,0,0,68000,20000,48000,48000
20200520,057388,奇鋐永豐98購02,1.87,1.88,1.87,1.88,+0.04,2.17,26000,3,48710,0,0,0,0,0,0,0,26000,-26000,-26000
20200520,057389,玉晶光永豐98購06,0.54,0.56,0.54,0.56,+0.06,12.0,90000,2,49800,0,0,0,0,0,0,90000,0,90000,90000
20200520,05738P,臺股指統一97售01,,,,,0.00,0.00,0,0,0,0,0,0,0,0,0,0,0,0,0
20200520,057390,台表科永豐98購01,1.23,1.54,1.08,1.46,+0.38,35.19,705000,59,862870,0,0,0,0,0,0,345000,292000,53000,53000
20200520,057391,樺漢永豐98購01,0.06,0.06,0.06,0.06,0.00,0.00,10000,1,600,0,0,0,0,0,0,0,10000,-10000,-10000
20200520,057392,福懋科永豐98購01,,,,,0.00,0.00,0,0,0,0,0,0,0,0,0,0,0,0,0
20200520,057393,台積電中信02購01,0.31,0.33,0.30,0.31,0.00,0.00,287000,38,89940,0,0,0,0,0,0,0,147000,-147000,-147000
20200520,057394,台積電中信9C購02,0.23,0.24,0.23,0.23,0.00,0.00,250000,25,57600,0,0,0,0,0,0,0,250000,-250000,-250000
20200520,057395,旺宏中信98購03,0.06,0.06,0.05,0.06,0.00,0.00,270000,8,14200,0,0,0,0,0,0,200000,70000,130000,130000
20200520,057396,健鼎中信99購01,0.41,0.41,0.41,0.41,0.00,0.00,10000,1,4100,0,0,0,0,0,0,10000,0,10000,10000
20200520,057397,茂林中信9A購01,0.78,1.00,0.78,1.00,+0.24,31.58,312000,37,274100,0,0,0,0,0,0,0,312000,-312000,-312000
20200520,057398,台郡中信99購01,,,,,0.00,0.00,0,0,0,0,0,0,0,0,0,0,0,0,0
20200520,057399,滬深反群益9C購01,,,,,0.00,0.00,0,0,0,0,0,0,0,0,0,0,0,0,0
20200520,05739P,臺股指統一97售02,,,,,0.00,0.00,0,0,0,0,0,0,0,0,0,0,0,0,0
20200520,057400,全新群益9A購01,,,,,0.00,0.00,0,0,0,0,0,0,0,0,0,0,0,0,0
20200520,057401,晶豪科群益99購01,,,,,0.00,0.00,0,0,0,0,0,0,0,0,0,0,0,0,0
20200520,057402,嘉晶群益98購02,2.50,2.50,2.50,2.50,+0.39,18.48,35000,2,87500,0,0,0,0,0,0,14000,0,14000,14000
20200520,057403,亞光群益98購04,0.97,1.02,0.97,1.02,+0.05,5.15,196000,2,194920,0,0,0,0,0,0,196000,0,196000,196000
20200520,057404,貿聯群益99購01,1.07,1.07,1.02,1.05,-0.02,-1.87,314000,9,325370,0,0,0,0,0,0,215000,99000,116000,116000
20200520,057405,麗豐群益98購01,0.52,0.57,0.52,0.57,0.00,0.00,60000,6,32900,0,0,0,0,0,0,0,60000,-60000,-60000
20200520,057406,茂林群益98購03,0.74,0.74,0.74,0.74,0.00,0.00,256000,2,189440,0,0,0,0,0,0,256000,0,256000,256000
20200520,057407,超眾群益99購01,1.09,1.09,1.09,1.09,0.00,0.00,69000,1,75210,0,0,0,0,0,0,0,69000,-69000,-69000
20200520,057408,台郡群益98購01,0.27,0.27,0.26,0.26,0.00,0.00,57000,7,14840,0,0,0,0,0,0,0,57000,-57000,-57000
20200520,057409,台虹群益98購02,,,,,0.00,0.00,0,0,0,0,0,0,0,0,0,0,0,0,0
20200520,05740P,宏達電元富96售01,,,,,0.00,0.00,0,0,0,0,0,0,0,0,0,0,0,0,0
20200520,057410,南電群益98購01,1.92,1.92,1.68,1.68,-0.43,-20.38,17000,2,30240,0,0,0,0,0,0,17000,0,17000,17000
20200520,057411,臺股指群益99購05,0.24,0.24,0.24,0.24,0.00,0.00,3000,1,720,0,0,0,0,0,0,3000,0,3000,3000
20200520,057412,臺股指群益99購06,,,,,0.00,0.00,0,0,0,0,0,0,0,0,0,0,0,0,0
20200520,057413,臺股指群益9C購04,4.57,4.58,4.57,4.58,+0.05,1.1,46000,3,210590,0,0,0,0,0,0,46000,0,46000,46000
20200520,057414,華新科日盛9A購01,,,,,0.00,0.00,0,0,0,0,0,0,0,0,0,0,0,0,0
20200520,057415,和碩日盛98購01,,,,,0.00,0.00,0,0,0,0,0,0,0,0,0,0,0,0,0
20200520,057416,T50反1凱基9C購01,,,,,0.00,0.00,0,0,0,0,0,0,0,0,0,0,0,0,0
20200520,057417,國巨凱基9A購03,,,,,0.00,0.00,0,0,0,0,0,0,0,0,0,0,0,0,0
20200520,057418,台光電凱基98購04,,,,,0.00,0.00,0,0,0,0,0,0,0,0,0,0,0,0,0
20200520,057419,奇力新凱基98購06,0.53,0.54,0.53,0.54,0.00,0.00,3000,2,1600,0,0,0,0,0,0,0,3000,-3000,-3000
20200520,05741P,聯發科元大96售14,,,,,0.00,0.00,0,0,0,0,0,0,0,0,0,0,0,0,0
20200520,057420,美食凱基98購01,0.95,1.02,0.86,0.89,+0.02,2.3,436000,25,416370,0,0,0,0,0,0,345000,15000,330000,330000
20200520,057421,智原凱基98購04,1.31,1.31,1.31,1.31,-0.03,-2.24,100000,2,131000,0,0,0,0,0,0,0,100000,-100000,-100000
20200520,057422,欣興凱基98購04,1.56,1.67,1.53,1.53,+0.03,2.0,135000,8,215160,0,0,0,0,0,0,66000,69000,-3000,-3000
20200520,057423,台郡凱基98購06,0.70,0.70,0.70,0.70,0.00,0.00,50000,1,35000,0,0,0,0,0,0,50000,0,50000,50000
20200520,057424,訊芯凱基98購04,0.39,0.39,0.38,0.38,-0.03,-7.32,30000,2,11600,0,0,0,0,0,0,10000,20000,-10000,-10000
20200520,057425,臺股指凱基9C購02,,,,,0.00,0.00,0,0,0,0,0,0,0,0,0,0,0,0,0
20200520,057426,元油2X兆豐9B購01,,,,,0.00,0.00,0,0,0,0,0,0,0,0,0,0,0,0,0
20200520,057427,華通兆豐99購01,0.43,0.43,0.43,0.43,0.00,0.00,7000,1,3010,0,0,0,0,0,0,7000,0,7000,7000
20200520,057428,正崴兆豐98購01,0.77,0.77,0.75,0.75,-0.02,-2.6,36000,3,27620,0,0,0,0,0,0,0,36000,-36000,-36000
20200520,057429,華新科兆豐98購03,0.20,0.20,0.20,0.20,0.00,0.00,10000,1,2000,0,0,0,0,0,0,10000,10000,0,0
20200520,05742P,可成元大96售04,0.71,0.76,0.71,0.73,0.00,0.00,12000,3,8770,0,0,0,0,0,0,0,12000,-12000,-12000
20200520,057430,富邦金兆豐98購01,0.24,0.24,0.24,0.24,0.00,0.00,1000,1,240,0,0,0,0,0,0,1000,0,1000,1000
20200520,057431,京鼎兆豐98購02,,,,,0.00,0.00,0,0,0,0,0,0,0,0,0,0,0,0,0
20200520,057432,T50反1國票9B購01,,,,,0.00,0.00,0,0,0,0,0,0,0,0,0,0,0,0,0
20200520,057433,上銀國票98購04,3.46,3.46,3.46,3.46,0.00,0.00,9000,1,31140,0,0,0,0,0,0,0,9000,-9000,-9000
20200520,057434,國巨國票99購03,0.39,0.39,0.39,0.39,0.00,0.00,3000,1,1170,0,0,0,0,0,0,3000,0,3000,3000
20200520,057435,旺宏國票99購04,,,,,0.00,0.00,0,0,0,0,0,0,0,0,0,0,0,0,0
20200520,057436,義隆國票99購02,,,,,0.00,0.00,0,0,0,0,0,0,0,0,0,0,0,0,0
20200520,057437,可成國票99購01,1.84,1.85,1.84,1.85,-0.36,-16.29,18000,2,33250,0,0,0,0,0,0,5000,13000,-8000,-8000
20200520,057438,禾伸堂國票99購01,2.39,2.58,2.39,2.47,+0.04,1.65,33000,4,82770,0,0,0,0,0,0,10000,23000,-13000,-13000
20200520,057439,元油2X統一99購02,,,,,0.00,0.00,0,0,0,0,0,0,0,0,0,0,0,0,0
20200520,05743P,創意元大96售01,,,,,0.00,0.00,0,0,0,0,0,0,0,0,0,0,0,0,0
20200520,057440,台積電統一98購10,0.16,0.16,0.16,0.16,0.00,0.00,5000,1,800,0,0,0,0,0,0,5000,0,5000,5000
20200520,057441,奇力新統一98購03,,,,,0.00,0.00,0,0,0,0,0,0,0,0,0,0,0,0,0
20200520,057442,玉晶光統一98購03,,,,,0.00,0.00,0,0,0,0,0,0,0,0,0,0,0,0,0
20200520,057443,臺股指統一99購04,,,,,0.00,0.00,0,0,0,0,0,0,0,0,0,0,0,0,0
20200520,057444,台泥元富98購01,2.94,3.02,2.94,2.98,-0.10,-3.25,214000,20,640600,0,0,0,0,0,0,129000,99000,30000,30000
20200520,057445,華通元富02購01,1.86,1.90,1.80,1.83,-0.06,-3.17,79000,10,146180,0,0,0,0,0,0,30000,49000,-19000,-19000
20200520,057446,旺宏元富02購01,1.83,1.83,1.80,1.80,-0.01,-0.55,30000,4,54870,0,0,0,0,0,0,20000,10000,10000,10000
20200520,057447,智邦元富02購01,3.29,3.41,3.29,3.38,+0.15,4.64,86000,9,290580,0,0,0,0,0,0,65000,41000,24000,24000
20200520,057448,致茂元富98購01,0.81,0.85,0.81,0.85,+0.01,1.19,30000,3,25100,0,0,0,0,0,0,10000,20000,-10000,-10000
20200520,057449,華新科元富99購02,1.98,2.04,1.93,2.00,-0.01,-0.5,291000,31,580300,0,0,0,0,0,0,271000,0,271000,271000
20200520,05744P,台表科元大96售04,,,,,0.00,0.00,0,0,0,0,0,0,0,0,0,0,0,0,0
20200520,057450,國泰金元富98購01,1.93,2.00,1.91,1.91,+0.01,0.53,457000,17,885160,0,0,0,0,0,0,234000,223000,11000,11000
20200520,057451,大立光元富9B購01,1.60,1.75,1.60,1.68,+0.09,5.66,166000,9,273340,0,0,0,0,0,0,35000,131000,-96000,-96000
20200520,057452,新日興元富98購01,0.72,0.72,0.72,0.72,0.00,0.00,10000,2,7200,0,0,0,0,0,0,0,10000,-10000,-10000
20200520,057453,矽創元富98購01,,,,,0.00,0.00,0,0,0,0,0,0,0,0,0,0,0,0,0
20200520,057454,上銀國泰99購02,,,,,0.00,0.00,0,0,0,0,0,0,0,0,0,0,0,0,0
20200520,057455,景碩國泰99購01,0.68,0.69,0.58,0.58,-0.08,-12.12,79000,3,53530,0,0,0,0,0,0,77000,2000,75000,75000
20200520,057456,道瓊銀富邦9C購01,1.99,2.10,1.96,1.97,0.00,0.00,59000,13,119880,0,0,0,0,0,0,36000,0,36000,36000
20200520,057457,華邦電富邦98購01,,,,,0.00,0.00,0,0,0,0,0,0,0,0,0,0,0,0,0
20200520,057458,TPK富邦9A購01,,,,,0.00,0.00,0,0,0,0,0,0,0,0,0,0,0,0,0
20200520,057459,臺股指富邦99購03,,,,,0.00,0.00,0,0,0,0,0,0,0,0,0,0,0,0,0
20200520,05745P,富邦金兆豐96售02,,,,,0.00,0.00,0,0,0,0,0,0,0,0,0,0,0,0,0
20200520,057460,楠梓電永豐98購03,0.81,0.81,0.77,0.77,0.00,0.00,150000,3,118220,0,0,0,0,0,0,82000,150000,-68000,-68000
20200520,057461,國巨永豐98購07,,,,,0.00,0.00,0,0,0,0,0,0,0,0,0,0,0,0,0
20200520,057462,光磊永豐98購02,0.92,0.95,0.90,0.95,+0.02,2.15,72000,7,65940,0,0,0,0,0,0,10000,62000,-52000,-52000
20200520,057463,華邦電永豐98購01,0.06,0.06,0.06,0.06,0.00,0.00,14000,1,840,0,0,0,0,0,0,0,14000,-14000,-14000
20200520,057464,大立光永豐98購02,,,,,0.00,0.00,0,0,0,0,0,0,0,0,0,0,0,0,0
20200520,057465,智易永豐98購02,,,,,0.00,0.00,0,0,0,0,0,0,0,0,0,0,0,0,0
20200520,057466,泰鼎永豐98購01,0.87,0.88,0.82,0.87,+0.07,8.75,23000,5,19970,0,0,0,0,0,0,13000,0,13000,13000
20200520,057467,祥碩永豐98購04,0.78,0.97,0.78,0.93,+0.22,30.99,336000,23,311740,0,0,0,0,0,0,106000,141000,-35000,-35000
20200520,057468,台郡永豐98購01,0.21,0.21,0.21,0.21,0.00,0.00,5000,1,1050,0,0,0,0,0,0,0,5000,-5000,-5000
20200520,057469,康友永豐98購02,0.09,0.09,0.08,0.08,-0.01,-11.11,335000,7,27150,0,0,0,0,0,0,0,335000,-335000,-335000
20200520,05746P,台積電群益96售07,,,,,0.00,0.00,0,0,0,0,0,0,0,0,0,0,0,0,0
20200520,057470,易華電永豐98購02,0.48,0.48,0.48,0.48,0.00,0.00,8000,1,3840,0,0,0,0,0,0,8000,0,8000,8000
20200520,057471,昇陽半永豐98購02,,,,,0.00,0.00,0,0,0,0,0,0,0,0,0,0,0,0,0
20200520,057472,T50正2元大9B購03,0.24,0.26,0.24,0.26,-0.04,-13.33,83000,5,20380,0,0,0,0,0,0,63000,0,63000,63000
20200520,057473,T50反1元大98購08,,,,,0.00,0.00,0,0,0,0,0,0,0,0,0,0,0,0,0
20200520,057474,T50反1元大98購09,,,,,0.00,0.00,0,0,0,0,0,0,0,0,0,0,0,0,0
20200520,057475,聯電元大9A購01,0.46,0.46,0.43,0.43,-0.02,-4.44,1071000,29,465500,0,0,0,0,0,0,566000,390000,176000,176000
20200520,057476,國巨元大98購19,,,,,0.00,0.00,0,0,0,0,0,0,0,0,0,0,0,0,0
20200520,057477,智邦元大98購09,4.32,4.50,4.32,4.39,+0.10,2.33,25000,3,109580,0,0,0,0,0,0,0,25000,-25000,-25000
20200520,057478,智邦元大99購01,,,,,0.00,0.00,0,0,0,0,0,0,0,0,0,0,0,0,0
20200520,057479,致茂元大98購03,1.39,1.39,1.36,1.36,0.00,0.00,6000,2,8250,0,0,0,0,0,0,3000,3000,0,0
20200520,05747P,漢唐群益96售03,,,,,0.00,0.00,0,0,0,0,0,0,0,0,0,0,0,0,0
20200520,057480,技嘉元大98購03,4.27,4.27,4.09,4.09,-0.25,-5.76,6000,2,25440,0,0,0,0,0,0,1000,5000,-4000,-4000
20200520,057481,技嘉元大98購04,4.26,4.26,4.26,4.26,-0.10,-2.29,30000,1,127800,0,0,0,0,0,0,0,30000,-30000,-30000
20200520,057482,微星元大98購03,3.83,3.83,3.83,3.83,+0.29,8.19,16000,2,61280,0,0,0,0,0,0,0,16000,-16000,-16000
20200520,057483,微星元大98購04,2.61,2.65,2.38,2.47,-0.01,-0.4,145000,17,366080,0,0,0,0,0,0,116000,64000,52000,52000
20200520,057484,南亞科元大98購06,0.75,0.75,0.75,0.75,0.00,0.00,68000,1,51000,0,0,0,0,0,0,0,68000,-68000,-68000
20200520,057485,友達元大9C購04,,,,,0.00,0.00,0,0,0,0,0,0,0,0,0,0,0,0,0
20200520,057486,美律元大98購04,0.82,0.82,0.82,0.82,0.00,0.00,15000,1,12300,0,0,0,0,0,0,0,15000,-15000,-15000
20200520,057487,聯發科元大98購10,4.52,4.52,4.28,4.28,+0.24,5.94,40000,4,173000,0,0,0,0,0,0,40000,0,40000,40000
20200520,057488,聯發科元大99購02,3.16,3.41,3.10,3.35,+0.28,9.12,16000,4,51700,0,0,0,0,0,0,15000,0,15000,15000
20200520,057489,奇力新元大99購06,1.49,1.55,1.49,1.55,+0.21,15.67,204000,4,315000,0,0,0,0,0,0,204000,0,204000,204000
20200520,05748P,臺股指群益99售02,,,,,0.00,0.00,0,0,0,0,0,0,0,0,0,0,0,0,0
20200520,057490,可成元大98購10,1.21,1.21,1.08,1.10,-0.37,-25.17,74000,3,88860,0,0,0,0,0,0,1000,74000,-73000,-73000
20200520,057491,美食元大98購03,1.87,2.13,1.83,1.87,+0.07,3.89,195000,13,386370,0,0,0,0,0,0,145000,50000,95000,95000
20200520,057492,大立光元大98購18,1.92,1.92,1.92,1.92,0.00,0.00,50000,1,96000,0,0,0,0,0,0,50000,0,50000,50000
20200520,057493,聯詠元大98購02,1.25,1.39,1.25,1.33,+0.04,3.1,123000,10,159810,0,0,0,0,0,0,123000,0,123000,123000
20200520,057494,玉晶光元大99購09,2.38,2.49,2.33,2.49,+0.16,6.87,52000,4,124750,0,0,0,0,0,0,52000,3000,49000,49000
20200520,057495,牧德元大99購04,1.94,2.29,1.94,2.29,0.00,0.00,131000,6,267510,0,0,0,0,0,0,0,131000,-131000,-131000
20200520,057496,佐登元大98購02,,,,,0.00,0.00,0,0,0,0,0,0,0,0,0,0,0,0,0
20200520,057497,祥碩元大98購06,4.13,4.89,4.06,4.89,+1.12,29.71,73000,9,322380,0,0,0,0,0,0,55000,18000,37000,37000
20200520,057498,台郡元大98購04,1.14,1.14,1.11,1.14,+0.01,0.88,136000,4,154440,0,0,0,0,0,0,68000,68000,0,0
20200520,057499,奇鋐群益98購01,2.31,2.40,2.31,2.38,+0.12,5.31,70000,7,166180,0,0,0,0,0,0,0,70000,-70000,-70000
20200520,05749P,臺股指群益99售03,,,,,0.00,0.00,0,0,0,0,0,0,0,0,0,0,0,0,0
20200520,057500,神達群益98購01,,,,,0.00,0.00,0,0,0,0,0,0,0,0,0,0,0,0,0
20200520,057501,超眾群益98購04,,,,,0.00,0.00,0,0,0,0,0,0,0,0,0,0,0,0,0
20200520,057502,訊芯群益98購02,0.73,0.73,0.70,0.70,+0.02,2.94,160000,17,113660,0,0,0,0,0,0,140000,0,140000,140000
20200520,057503,世紀鋼群益98購02,,,,,0.00,0.00,0,0,0,0,0,0,0,0,0,0,0,0,0
20200520,057504,技嘉麥證98購01,1.51,1.55,1.42,1.42,-0.02,-1.39,129000,15,192430,100000,29000,71000,0,0,0,100000,29000,71000,71000
20200520,057505,健策麥證98購01,0.46,0.46,0.46,0.46,-0.04,-8.0,4000,1,1840,0,4000,-4000,0,0,0,0,4000,-4000,-4000
20200520,057506,聯鈞國票99購02,,,,,0.00,0.00,0,0,0,0,0,0,0,0,0,0,0,0,0
20200520,057507,貿聯國票98購02,1.13,1.14,1.13,1.14,+0.02,1.79,88000,2,99880,0,0,0,0,0,0,0,88000,-88000,-88000
20200520,057508,康控國票99購03,0.60,0.61,0.52,0.52,-0.02,-3.7,348000,31,208600,0,0,0,0,0,0,237000,111000,126000,126000
20200520,057509,聯發科統一9A購03,,,,,0.00,0.00,0,0,0,0,0,0,0,0,0,0,0,0,0
20200520,05750P,臺股指群益99售04,,,,,0.00,0.00,0,0,0,0,0,0,0,0,0,0,0,0,0
20200520,057510,泰碩統一98購02,,,,,0.00,0.00,0,0,0,0,0,0,0,0,0,0,0,0,0
20200520,057511,健策統一98購02,0.68,0.74,0.68,0.74,-0.03,-3.9,322000,6,231500,0,0,0,0,0,0,86000,236000,-150000,-150000
20200520,057512,華邦電台新98購01,0.17,0.17,0.16,0.16,0.00,0.00,12000,2,2020,0,0,0,0,0,0,10000,2000,8000,8000
20200520,057513,智邦台新98購01,,,,,0.00,0.00,0,0,0,0,0,0,0,0,0,0,0,0,0
20200520,057514,華新科元富99購03,1.17,1.26,1.16,1.26,+0.09,7.69,243000,33,286460,0,0,0,0,0,0,219000,24000,195000,195000
20200520,057515,智原元富98購02,,,,,0.00,0.00,0,0,0,0,0,0,0,0,0,0,0,0,0
20200520,057516,和鑫元富98購01,0.46,0.47,0.45,0.46,0.00,0.00,459000,7,211430,0,0,0,0,0,0,242000,217000,25000,25000
20200520,057517,矽創元富98購02,0.75,0.75,0.53,0.54,-0.14,-20.59,655000,40,418800,0,0,0,0,0,0,476000,60000,416000,416000
20200520,057518,世紀鋼元富98購01,,,,,0.00,0.00,0,0,0,0,0,0,0,0,0,0,0,0,0
20200520,057519,元油2X元大98購14,,,,,0.00,0.00,0,0,0,0,0,0,0,0,0,0,0,0,0
20200520,05751P,台積電中信96售05,,,,,0.00,0.00,0,0,0,0,0,0,0,0,0,0,0,0,0
20200520,057520,元油2X元大98購15,,,,,0.00,0.00,0,0,0,0,0,0,0,0,0,0,0,0,0
20200520,057521,元油2X元大98購16,,,,,0.00,0.00,0,0,0,0,0,0,0,0,0,0,0,0,0
20200520,057522,元油2X元大98購17,0.42,0.42,0.42,0.42,0.00,0.00,25000,1,10500,0,0,0,0,0,0,0,25000,-25000,-25000
20200520,057523,大成鋼元大99購01,1.01,1.19,1.01,1.19,+0.17,16.67,542000,15,580320,0,0,0,0,0,0,76000,444000,-368000,-368000
20200520,057524,旺宏元大99購04,2.49,2.49,2.49,2.49,-0.03,-1.19,68000,2,169320,0,0,0,0,0,0,0,68000,-68000,-68000
20200520,057525,光磊元大99購01,1.61,1.72,1.61,1.72,+0.11,6.83,159000,10,265940,0,0,0,0,0,0,65000,112000,-47000,-47000
20200520,057526,智邦元大98購10,3.44,3.64,3.44,3.56,+0.15,4.4,113000,7,399180,0,0,0,0,0,0,9000,110000,-101000,-101000
20200520,057527,億光元大98購01,1.12,1.22,1.12,1.13,+0.01,0.89,403000,19,480100,0,0,0,0,0,0,134000,253000,-119000,-119000
20200520,057528,南亞科元大99購01,,,,,0.00,0.00,0,0,0,0,0,0,0,0,0,0,0,0,0
20200520,057529,嘉晶元大99購02,4.29,5.25,4.27,5.00,+0.81,19.33,181000,25,828090,0,0,0,0,0,0,86000,114000,-28000,-28000
20200520,05752P,台積電中信96售06,1.64,1.64,1.64,1.64,-0.05,-2.96,10000,1,16400,0,0,0,0,0,0,0,10000,-10000,-10000
20200520,057530,奇鋐元大99購01,4.17,4.39,4.17,4.39,0.00,0.00,94000,13,402070,0,0,0,0,0,0,31000,64000,-33000,-33000
20200520,057531,禾伸堂元大99購04,2.14,2.14,2.11,2.11,-0.02,-0.94,75000,4,160290,0,0,0,0,0,0,2000,73000,-71000,-71000
20200520,057532,智原元大98購03,1.15,1.23,1.15,1.21,+0.03,2.54,341000,14,411490,0,0,0,0,0,0,58000,341000,-283000,-283000
20200520,057533,晶相光元大98購02,1.11,1.11,1.11,1.11,+0.02,1.83,8000,1,8880,0,0,0,0,0,0,8000,0,8000,8000
20200520,057534,旭富元大98購01,,,,,0.00,0.00,0,0,0,0,0,0,0,0,0,0,0,0,0
20200520,057535,泰鼎元大99購01,,,,,0.00,0.00,0,0,0,0,0,0,0,0,0,0,0,0,0
20200520,057536,康控元大99購03,1.70,1.72,1.58,1.58,-0.04,-2.47,105000,11,173960,0,0,0,0,0,0,105000,0,105000,105000
20200520,057537,聯茂元大98購04,,,,,0.00,0.00,0,0,0,0,0,0,0,0,0,0,0,0,0
20200520,057538,緯穎元大98購07,,,,,0.00,0.00,0,0,0,0,0,0,0,0,0,0,0,0,0
20200520,057539,南茂元大98購02,1.38,1.53,1.36,1.51,+0.14,10.22,460000,17,663840,0,0,0,0,0,0,330000,174000,156000,156000
20200520,05753P,臺股指中信99售02,,,,,0.00,0.00,0,0,0,0,0,0,0,0,0,0,0,0,0
20200520,057540,緯穎日盛99購01,,,,,0.00,0.00,0,0,0,0,0,0,0,0,0,0,0,0,0
20200520,057541,台灣50康和9A購04,,,,,0.00,0.00,0,0,0,0,0,0,0,0,0,0,0,0,0
20200520,057542,上銀凱基99購01,,,,,0.00,0.00,0,0,0,0,0,0,0,0,0,0,0,0,0
20200520,057543,華通凱基99購02,1.31,1.32,1.31,1.31,0.00,0.00,55000,4,72200,0,0,0,0,0,0,0,55000,-55000,-55000
20200520,057544,鴻海凱基02購01,,,,,0.00,0.00,0,0,0,0,0,0,0,0,0,0,0,0,0
20200520,057545,國巨凱基99購05,0.33,0.33,0.32,0.32,+0.05,18.52,70000,3,22700,0,0,0,0,0,0,70000,0,70000,70000
20200520,057546,台積電凱基02購01,0.55,0.55,0.55,0.55,+0.10,22.22,10000,2,5500,0,0,0,0,0,0,0,0,0,0
20200520,057547,技嘉凱基99購01,,,,,0.00,0.00,0,0,0,0,0,0,0,0,0,0,0,0,0
20200520,057548,微星凱基99購01,1.01,1.05,0.95,0.95,+0.04,4.4,159000,13,158220,0,0,0,0,0,0,97000,57000,40000,40000
20200520,057549,台光電凱基98購05,,,,,0.00,0.00,0,0,0,0,0,0,0,0,0,0,0,0,0
20200520,05754P,臺股指中信99售03,,,,,0.00,0.00,0,0,0,0,0,0,0,0,0,0,0,0,0
20200520,057550,聯發科凱基02購01,2.06,2.06,2.06,2.06,0.00,0.00,10000,1,20600,0,0,0,0,0,0,10000,0,10000,10000
20200520,057551,華新科凱基98購06,,,,,0.00,0.00,0,0,0,0,0,0,0,0,0,0,0,0,0
20200520,057552,禾伸堂凱基98購05,,,,,0.00,0.00,0,0,0,0,0,0,0,0,0,0,0,0,0
20200520,057553,景碩凱基98購03,0.98,0.98,0.98,0.98,0.00,0.00,1000,1,980,0,0,0,0,0,0,0,1000,-1000,-1000
20200520,057554,新日興凱基99購02,,,,,0.00,0.00,0,0,0,0,0,0,0,0,0,0,0,0,0
20200520,057555,玉晶光凱基9A購02,,,,,0.00,0.00,0,0,0,0,0,0,0,0,0,0,0,0,0
20200520,057556,智易凱基99購01,1.76,1.77,1.70,1.70,-0.04,-2.3,86000,5,149650,0,0,0,0,0,0,71000,15000,56000,56000
20200520,057557,聯茂凱基99購04,1.73,1.76,1.71,1.76,-0.05,-2.76,67000,3,117120,0,0,0,0,0,0,67000,0,67000,67000
20200520,057558,致新凱基98購01,4.04,4.04,3.83,3.83,+0.11,2.96,24000,4,94960,0,0,0,0,0,0,19000,5000,14000,14000
20200520,057559,可成兆豐99購02,0.60,0.60,0.58,0.58,-0.17,-22.67,22000,3,13160,0,0,0,0,0,0,20000,2000,18000,18000
20200520,05755P,臺股指中信99售04,1.54,1.58,1.54,1.56,-0.04,-2.5,16000,3,24940,0,0,0,0,0,0,1000,15000,-14000,-14000
20200520,057560,華新科兆豐99購01,,,,,0.00,0.00,0,0,0,0,0,0,0,0,0,0,0,0,0
20200520,057561,大立光兆豐98購02,0.18,0.29,0.18,0.29,0.00,0.00,64000,2,14820,0,0,0,0,0,0,64000,64000,0,0
20200520,057562,奇鋐兆豐98購01,1.32,1.32,1.30,1.30,0.00,0.00,21000,4,27580,0,0,0,0,0,0,0,21000,-21000,-21000
20200520,057563,旭富國泰9A購01,2.40,2.40,2.23,2.32,-0.05,-2.11,12000,3,27020,0,0,0,0,0,0,10000,0,10000,10000
20200520,057564,台積電富邦9B購03,,,,,0.00,0.00,0,0,0,0,0,0,0,0,0,0,0,0,0
20200520,057565,可成富邦99購01,,,,,0.00,0.00,0,0,0,0,0,0,0,0,0,0,0,0,0
20200520,057566,欣興富邦99購01,,,,,0.00,0.00,0,0,0,0,0,0,0,0,0,0,0,0,0
20200520,057567,嘉聯益富邦9A購01,0.49,0.49,0.49,0.49,+0.02,4.26,80000,3,39200,0,0,0,0,0,0,20000,60000,-40000,-40000
20200520,057568,友訊永豐99購01,,,,,0.00,0.00,0,0,0,0,0,0,0,0,0,0,0,0,0
20200520,057569,光磊永豐98購03,0.76,0.83,0.76,0.83,+0.06,7.79,347000,7,271470,0,0,0,0,0,0,205000,142000,63000,63000
20200520,05756P,臺股指中信99售05,,,,,0.00,0.00,0,0,0,0,0,0,0,0,0,0,0,0,0
20200520,057570,技嘉永豐98購02,0.59,0.59,0.49,0.50,-0.04,-7.41,233000,22,122430,0,0,0,0,0,0,159000,67000,92000,92000
20200520,057571,泰碩永豐98購01,1.26,1.26,1.25,1.25,0.00,0.00,68000,5,85220,0,0,0,0,0,0,0,68000,-68000,-68000
20200520,057572,明泰永豐98購01,,,,,0.00,0.00,0,0,0,0,0,0,0,0,0,0,0,0,0
20200520,057573,京鼎永豐98購02,0.73,0.73,0.73,0.73,0.00,0.00,60000,1,43800,0,0,0,0,0,0,60000,0,60000,60000
20200520,057574,中磊永豐98購01,0.72,0.72,0.72,0.72,-0.05,-6.49,65000,1,46800,0,0,0,0,0,0,65000,0,65000,65000
20200520,057575,世紀鋼永豐98購02,1.70,1.83,1.49,1.49,-0.25,-14.37,61000,7,98750,0,0,0,0,0,0,0,61000,-61000,-61000
20200520,057576,南亞科第一9C購01,,,,,0.00,0.00,0,0,0,0,0,0,0,0,0,0,0,0,0
20200520,057577,廣宇中信9A購01,0.42,0.42,0.40,0.41,+0.01,2.5,43000,3,17870,0,0,0,0,0,0,6000,37000,-31000,-31000
20200520,057578,可成中信99購01,0.35,0.35,0.31,0.31,-0.06,-16.22,209000,11,65450,0,0,0,0,0,0,0,209000,-209000,-209000
20200520,057579,長榮航中信9A購01,0.31,0.32,0.28,0.28,+0.01,3.7,380000,62,112730,0,0,0,0,0,0,164000,216000,-52000,-52000
20200520,05757P,旺宏永豐96售03,0.79,0.79,0.79,0.79,-0.04,-4.82,3000,1,2370,0,0,0,0,0,0,0,3000,-3000,-3000
20200520,057580,玉山金中信9A購01,,,,,0.00,0.00,0,0,0,0,0,0,0,0,0,0,0,0,0
20200520,057581,元大金中信9A購01,,,,,0.00,0.00,0,0,0,0,0,0,0,0,0,0,0,0,0
20200520,057582,亞光中信9A購02,0.35,0.35,0.35,0.35,+0.01,2.94,30000,1,10500,0,0,0,0,0,0,30000,0,30000,30000
20200520,057583,啟碁中信9A購01,,,,,0.00,0.00,0,0,0,0,0,0,0,0,0,0,0,0,0
20200520,057584,國巨亞東99購01,,,,,0.00,0.00,0,0,0,0,0,0,0,0,0,0,0,0,0
20200520,057585,鴻海國票99購05,,,,,0.00,0.00,0,0,0,0,0,0,0,0,0,0,0,0,0
20200520,057586,台積電國票99購06,,,,,0.00,0.00,0,0,0,0,0,0,0,0,0,0,0,0,0
20200520,057587,微星國票99購01,4.04,4.04,3.87,3.87,+0.17,4.59,35000,4,137880,0,0,0,0,0,0,9000,26000,-17000,-17000
20200520,057588,南亞科國票99購01,,,,,0.00,0.00,0,0,0,0,0,0,0,0,0,0,0,0,0
20200520,057589,超眾國票9A購01,,,,,0.00,0.00,0,0,0,0,0,0,0,0,0,0,0,0,0
20200520,05758P,光罩永豐96售02,1.31,1.31,1.18,1.18,-0.25,-17.48,204000,8,250160,0,0,0,0,0,0,122000,82000,40000,40000
20200520,057590,元油2X兆豐98購02,,,,,0.00,0.00,0,0,0,0,0,0,0,0,0,0,0,0,0
20200520,057591,鴻海兆豐99購01,,,,,0.00,0.00,0,0,0,0,0,0,0,0,0,0,0,0,0
20200520,057592,美律兆豐99購01,,,,,0.00,0.00,0,0,0,0,0,0,0,0,0,0,0,0,0
20200520,057593,聯發科兆豐98購03,2.51,2.77,2.51,2.73,+0.32,13.28,142000,10,377200,0,0,0,0,0,0,47000,95000,-48000,-48000
20200520,057594,宏達電兆豐99購01,0.21,0.21,0.21,0.21,0.00,0.00,30000,1,6300,0,0,0,0,0,0,30000,0,30000,30000
20200520,057595,健鼎兆豐98購01,0.88,0.88,0.85,0.85,-0.08,-8.6,208000,12,178150,0,0,0,0,0,0,110000,88000,22000,22000
20200520,057596,聯茂兆豐99購01,,,,,0.00,0.00,0,0,0,0,0,0,0,0,0,0,0,0,0
20200520,057597,華通群益9A購02,,,,,0.00,0.00,0,0,0,0,0,0,0,0,0,0,0,0,0
20200520,057598,鴻海群益98購07,0.39,0.39,0.39,0.39,0.00,0.00,26000,1,10140,0,0,0,0,0,0,0,26000,-26000,-26000
20200520,057599,技嘉群益9A購01,2.70,2.70,2.60,2.60,-0.11,-4.06,14000,3,36600,0,0,0,0,0,0,2000,12000,-10000,-10000
20200520,05759P,智邦永豐96售02,,,,,0.00,0.00,0,0,0,0,0,0,0,0,0,0,0,0,0
20200520,057600,大立光群益99購03,0.65,0.65,0.65,0.65,+0.03,4.84,20000,2,13000,0,0,0,0,0,0,20000,20000,0,0
20200520,057601,中磊群益98購01,,,,,0.00,0.00,0,0,0,0,0,0,0,0,0,0,0,0,0
20200520,057602,聯茂群益98購02,,,,,0.00,0.00,0,0,0,0,0,0,0,0,0,0,0,0,0
20200520,057603,樺漢群益98購02,0.99,1.01,0.96,0.98,-0.02,-2.0,320000,6,315250,0,0,0,0,0,0,222000,98000,124000,124000
20200520,057604,鴻海統一9C購01,1.10,1.11,1.09,1.09,0.00,0.00,16000,4,17550,0,0,0,0,0,0,0,16000,-16000,-16000
20200520,057605,旺宏統一99購03,0.61,0.61,0.61,0.61,-0.01,-1.61,50000,1,30500,0,0,0,0,0,0,0,50000,-50000,-50000
20200520,057606,健策統一98購03,0.61,0.62,0.61,0.62,0.00,0.00,112000,2,68620,0,0,0,0,0,0,30000,82000,-52000,-52000
20200520,057607,旺宏台新98購02,,,,,0.00,0.00,0,0,0,0,0,0,0,0,0,0,0,0,0
20200520,057608,南亞科台新98購01,,,,,0.00,0.00,0,0,0,0,0,0,0,0,0,0,0,0,0
20200520,057609,友訊元富98購01,1.13,1.17,1.11,1.11,-0.06,-5.13,416000,13,475570,0,0,0,0,0,0,141000,255000,-114000,-114000
20200520,05760P,京鼎永豐96售02,0.75,0.75,0.75,0.75,0.00,0.00,25000,2,18750,0,0,0,0,0,0,0,25000,-25000,-25000
20200520,057610,致茂元富98購02,,,,,0.00,0.00,0,0,0,0,0,0,0,0,0,0,0,0,0
20200520,057611,技嘉元富98購02,3.68,3.68,3.68,3.68,-0.27,-6.84,10000,1,36800,0,0,0,0,0,0,0,10000,-10000,-10000
20200520,057612,瑞昱元富02購01,2.27,2.35,2.18,2.22,-0.10,-4.31,830000,46,1876810,0,0,0,0,0,0,491000,339000,152000,152000
20200520,057613,瑞昱元富02購02,2.67,2.75,2.61,2.75,+0.05,1.85,584000,43,1558890,0,0,0,0,0,0,519000,9000,510000,510000
20200520,057614,華新科元富99購04,0.80,0.80,0.80,0.80,+0.01,1.27,76000,1,60800,0,0,0,0,0,0,76000,0,76000,76000
20200520,057615,元油2X凱基98購02,,,,,0.00,0.00,0,0,0,0,0,0,0,0,0,0,0,0,0
20200520,057616,聯電凱基99購01,0.41,0.41,0.38,0.39,-0.02,-4.88,75000,5,29300,0,0,0,0,0,0,20000,55000,-35000,-35000
20200520,057617,國巨凱基99購06,0.53,0.53,0.53,0.53,0.00,0.00,10000,1,5300,0,0,0,0,0,0,10000,0,10000,10000
20200520,057618,台光電凱基99購01,1.48,1.51,1.46,1.51,-0.08,-5.03,92000,13,137120,0,0,0,0,0,0,92000,0,92000,92000
20200520,057619,玉晶光凱基98購02,1.17,1.20,1.17,1.20,+0.08,7.14,14000,2,16650,0,0,0,0,0,0,5000,9000,-4000,-4000
20200520,05761P,嘉澤永豐96售01,,,,,0.00,0.00,0,0,0,0,0,0,0,0,0,0,0,0,0
20200520,057620,康控凱基99購01,,,,,0.00,0.00,0,0,0,0,0,0,0,0,0,0,0,0,0
20200520,057621,崇越凱基98購01,,,,,0.00,0.00,0,0,0,0,0,0,0,0,0,0,0,0,0
20200520,057622,元油2X國泰99購03,,,,,0.00,0.00,0,0,0,0,0,0,0,0,0,0,0,0,0
20200520,057623,友訊國泰99購01,,,,,0.00,0.00,0,0,0,0,0,0,0,0,0,0,0,0,0
20200520,057624,新日興國泰99購01,0.79,0.89,0.76,0.87,-0.03,-3.33,130000,14,108350,0,0,0,0,0,0,130000,0,130000,130000
20200520,057625,泰鼎國泰9A購01,0.78,0.79,0.78,0.79,+0.08,11.27,40000,4,31400,0,0,0,0,0,0,0,40000,-40000,-40000
20200520,057626,技嘉富邦9A購01,1.06,1.07,0.99,0.99,-0.03,-2.94,99000,15,101090,0,0,0,0,0,0,57000,42000,15000,15000
20200520,057627,和大永豐98購01,0.07,0.08,0.07,0.08,+0.02,33.33,28000,2,2160,0,0,0,0,0,0,20000,8000,12000,12000
20200520,057628,旺宏永豐98購02,,,,,0.00,0.00,0,0,0,0,0,0,0,0,0,0,0,0,0
20200520,057629,泰碩永豐98購02,2.26,2.27,2.26,2.27,-0.14,-5.81,16000,2,36210,0,0,0,0,0,0,0,16000,-16000,-16000
20200520,05762P,昇陽半永豐96售04,1.91,1.91,1.90,1.90,-0.17,-8.21,4000,2,7620,0,0,0,0,0,0,2000,2000,0,0
20200520,057630,茂林永豐98購01,,,,,0.00,0.00,0,0,0,0,0,0,0,0,0,0,0,0,0
20200520,057631,康控永豐98購02,,,,,0.00,0.00,0,0,0,0,0,0,0,0,0,0,0,0,0
20200520,057632,傳奇永豐98購01,,,,,0.00,0.00,0,0,0,0,0,0,0,0,0,0,0,0,0
20200520,057633,緯穎永豐98購02,1.06,1.06,0.99,0.99,-0.10,-9.17,40000,4,40400,0,0,0,0,0,0,30000,40000,-10000,-10000
20200520,057634,道瓊反元大99購01,,,,,0.00,0.00,0,0,0,0,0,0,0,0,0,0,0,0,0
20200520,057635,中鋼元大98購01,,,,,0.00,0.00,0,0,0,0,0,0,0,0,0,0,0,0,0
20200520,057636,上銀元大98購06,1.70,1.70,1.64,1.64,-0.14,-7.87,92000,4,153820,0,0,0,0,0,0,82000,10000,72000,72000
20200520,057637,上銀元大98購07,1.34,1.35,1.26,1.26,-0.07,-5.26,129000,7,170070,0,0,0,0,0,0,58000,71000,-13000,-13000
20200520,057638,上銀元大99購01,1.58,1.58,1.58,1.58,-0.04,-2.47,2000,2,3160,0,0,0,0,0,0,0,2000,-2000,-2000
20200520,057639,國巨元大99購07,1.72,1.79,1.67,1.68,+0.11,7.01,75000,5,129600,0,0,0,0,0,0,10000,65000,-55000,-55000
20200520,05763P,致新永豐96售01,0.13,0.13,0.13,0.13,0.00,0.00,8000,1,1040,0,0,0,0,0,0,0,8000,-8000,-8000
20200520,057640,台積電元大98購16,1.39,1.39,1.36,1.36,0.00,0.00,16000,2,22150,0,0,0,0,0,0,0,16000,-16000,-16000
20200520,057641,旺宏元大98購10,,,,,0.00,0.00,0,0,0,0,0,0,0,0,0,0,0,0,0
20200520,057642,南亞科元大98購07,0.81,0.85,0.81,0.85,+0.05,6.25,68000,7,56200,0,0,0,0,0,0,68000,0,68000,68000
20200520,057643,聯發科元大99購03,,,,,0.00,0.00,0,0,0,0,0,0,0,0,0,0,0,0,0
20200520,057644,奇力新元大98購04,0.72,0.72,0.72,0.72,0.00,0.00,68000,1,48960,0,0,0,0,0,0,68000,0,68000,68000
20200520,057645,華新科元大99購11,,,,,0.00,0.00,0,0,0,0,0,0,0,0,0,0,0,0,0
20200520,057646,玉山金元大98購01,2.56,2.56,2.56,2.56,0.00,0.00,3000,1,7680,0,0,0,0,0,0,3000,3000,0,0
20200520,057647,欣興元大98購10,1.64,1.75,1.58,1.58,-0.03,-1.86,233000,13,387830,0,0,0,0,0,0,181000,52000,129000,129000
20200520,057648,和碩元大98購01,,,,,0.00,0.00,0,0,0,0,0,0,0,0,0,0,0,0,0
20200520,057649,嘉聯益元大99購04,1.10,1.12,1.10,1.12,-0.01,-0.88,75000,2,82640,0,0,0,0,0,0,7000,68000,-61000,-61000
20200520,05764P,世紀鋼永豐96售03,,,,,0.00,0.00,0,0,0,0,0,0,0,0,0,0,0,0,0
20200520,057650,力成元大98購04,1.38,1.40,1.38,1.40,+0.04,2.94,73000,5,101800,0,0,0,0,0,0,73000,0,73000,73000
20200520,057651,矽力元大98購03,7.35,7.85,7.20,7.75,-0.10,-1.27,48000,18,360900,0,0,0,0,0,0,30000,15000,15000,15000
20200520,057652,欣興永昌9C購01,3.48,3.48,3.48,3.48,+0.08,2.35,10000,1,34800,0,0,0,0,0,0,10000,0,10000,10000
20200520,057653,臺股指永昌98購01,,,,,0.00,0.00,0,0,0,0,0,0,0,0,0,0,0,0,0
20200520,057654,A50正2中信98購01,,,,,0.00,0.00,0,0,0,0,0,0,0,0,0,0,0,0,0
20200520,057655,奇力新中信98購05,,,,,0.00,0.00,0,0,0,0,0,0,0,0,0,0,0,0,0
20200520,057656,大成鋼兆豐98購01,0.47,0.56,0.47,0.56,+0.12,27.27,347000,11,182470,0,0,0,0,0,0,38000,309000,-271000,-271000
20200520,057657,國巨兆豐98購04,0.18,0.18,0.10,0.10,+0.03,42.86,20000,3,2800,0,0,0,0,0,0,0,10000,-10000,-10000
20200520,057658,玉晶光兆豐99購02,0.74,0.75,0.74,0.75,+0.10,15.38,32000,4,23980,0,0,0,0,0,0,32000,0,32000,32000
20200520,057659,台表科兆豐98購01,0.86,1.14,0.86,1.07,+0.22,25.88,182000,31,175120,0,0,0,0,0,0,34000,55000,-21000,-21000
20200520,05765P,臺股指永豐96售01,,,,,0.00,0.00,0,0,0,0,0,0,0,0,0,0,0,0,0
20200520,057660,訊芯兆豐98購02,,,,,0.00,0.00,0,0,0,0,0,0,0,0,0,0,0,0,0
20200520,057661,臺股指兆豐98購01,,,,,0.00,0.00,0,0,0,0,0,0,0,0,0,0,0,0,0
20200520,057662,上銀元大9A購01,,,,,0.00,0.00,0,0,0,0,0,0,0,0,0,0,0,0,0
20200520,057663,國巨元大99購08,,,,,0.00,0.00,0,0,0,0,0,0,0,0,0,0,0,0,0
20200520,057664,台積電元大9A購03,0.55,0.55,0.55,0.55,0.00,0.00,5000,1,2750,0,0,0,0,0,0,5000,0,5000,5000
20200520,057665,技嘉元大99購01,3.89,3.89,3.89,3.89,-0.15,-3.71,20000,1,77800,0,0,0,0,0,0,0,20000,-20000,-20000
20200520,057666,奇力新元大9A購01,,,,,0.00,0.00,0,0,0,0,0,0,0,0,0,0,0,0,0
20200520,057667,可成元大99購01,1.58,1.58,1.47,1.47,-0.23,-13.53,147000,4,230670,0,0,0,0,0,0,69000,79000,-10000,-10000
20200520,057668,華新科元大9A購01,,,,,0.00,0.00,0,0,0,0,0,0,0,0,0,0,0,0,0
20200520,057669,嘉晶元大99購03,1.80,2.11,1.80,2.11,0.00,0.00,15000,2,28550,0,0,0,0,0,0,15000,0,15000,15000
20200520,05766P,A50正2凱基99售01,1.03,1.03,1.02,1.02,0.00,0.00,2000,2,2050,0,0,0,0,0,0,0,2000,-2000,-2000
20200520,057670,欣興元大99購02,2.61,2.71,2.57,2.57,+0.07,2.8,117000,7,305690,0,0,0,0,0,0,59000,58000,1000,1000
20200520,057671,群創元大9B購06,0.73,0.73,0.72,0.73,-0.01,-1.35,127000,8,92310,0,0,0,0,0,0,127000,0,127000,127000
20200520,057672,茂林元大98購02,1.64,1.94,1.64,1.91,0.00,0.00,230000,6,419900,0,0,0,0,0,0,0,230000,-230000,-230000
20200520,057673,臻鼎元大98購01,0.94,0.94,0.94,0.94,0.00,0.00,30000,2,28200,0,0,0,0,0,0,0,0,0,0
20200520,057674,台郡元大99購03,0.76,0.78,0.75,0.75,-0.01,-1.32,255000,10,193280,0,0,0,0,0,0,100000,155000,-55000,-55000
20200520,057675,同欣電元大98購02,0.97,1.19,0.97,0.97,+0.02,2.11,1140000,49,1175750,0,0,0,0,0,0,198000,925000,-727000,-727000
20200520,057676,臺股指元大98購06,,,,,0.00,0.00,0,0,0,0,0,0,0,0,0,0,0,0,0
20200520,057677,臺股指元大98購07,0.16,0.16,0.16,0.16,0.00,0.00,5000,1,800,0,0,0,0,0,0,0,5000,-5000,-5000
20200520,057678,臺股指元大98購08,0.31,0.31,0.31,0.31,0.00,0.00,3000,1,930,0,0,0,0,0,0,3000,0,3000,3000
20200520,057679,臺股指元大98購09,,,,,0.00,0.00,0,0,0,0,0,0,0,0,0,0,0,0,0
20200520,05767P,國巨凱基96售11,,,,,0.00,0.00,0,0,0,0,0,0,0,0,0,0,0,0,0
20200520,057680,臺股指元大98購10,,,,,0.00,0.00,0,0,0,0,0,0,0,0,0,0,0,0,0
20200520,057681,T50反1日盛9C購01,,,,,0.00,0.00,0,0,0,0,0,0,0,0,0,0,0,0,0
20200520,057682,台積電日盛9A購03,,,,,0.00,0.00,0,0,0,0,0,0,0,0,0,0,0,0,0
20200520,057683,技嘉日盛98購01,3.19,3.19,3.19,3.19,+0.03,0.95,57000,1,181830,0,0,0,0,0,0,57000,0,57000,57000
20200520,057684,聯茂日盛99購01,1.18,1.18,1.16,1.18,-0.12,-9.23,257000,18,302900,0,0,0,0,0,0,257000,0,257000,257000
20200520,057685,台灣50凱基9C購01,0.36,0.36,0.36,0.36,0.00,0.00,20000,1,7200,0,0,0,0,0,0,0,0,0,0
20200520,057686,中50凱基99購01,,,,,0.00,0.00,0,0,0,0,0,0,0,0,0,0,0,0,0
20200520,057687,中502X凱基98購01,,,,,0.00,0.00,0,0,0,0,0,0,0,0,0,0,0,0,0
20200520,057688,國巨凱基99購07,,,,,0.00,0.00,0,0,0,0,0,0,0,0,0,0,0,0,0
20200520,057689,南亞科凱基99購02,0.65,0.67,0.65,0.67,+0.04,6.35,88000,3,57570,0,0,0,0,0,0,88000,0,88000,88000
20200520,05768P,台積電凱基96售15,,,,,0.00,0.00,0,0,0,0,0,0,0,0,0,0,0,0,0
20200520,057690,美律凱基99購03,,,,,0.00,0.00,0,0,0,0,0,0,0,0,0,0,0,0,0
20200520,057691,健策凱基99購01,0.86,0.94,0.86,0.89,0.00,0.00,162000,6,151300,0,0,0,0,0,0,1000,162000,-161000,-161000
20200520,057692,臺股指凱基98購10,,,,,0.00,0.00,0,0,0,0,0,0,0,0,0,0,0,0,0
20200520,057693,臺股指凱基98購11,,,,,0.00,0.00,0,0,0,0,0,0,0,0,0,0,0,0,0
20200520,057694,臺股指凱基98購12,0.09,0.11,0.09,0.11,+0.02,22.22,401000,4,43510,0,0,0,0,0,0,201000,0,201000,201000
20200520,057695,S&P反1群益9B購01,,,,,0.00,0.00,0,0,0,0,0,0,0,0,0,0,0,0,0
20200520,057696,聯電群益9A購01,0.18,0.20,0.18,0.19,+0.01,5.56,97000,4,17600,0,0,0,0,0,0,0,0,0,0
20200520,057697,國巨群益98購09,0.30,0.30,0.30,0.30,0.00,0.00,11000,2,3300,0,0,0,0,0,0,1000,10000,-9000,-9000
20200520,057698,奇力新群益98購02,,,,,0.00,0.00,0,0,0,0,0,0,0,0,0,0,0,0,0
20200520,057699,可成群益9A購02,1.38,1.38,1.34,1.35,-0.33,-19.64,20000,5,27000,0,0,0,0,0,0,2000,20000,-18000,-18000
20200520,05769P,台積電凱基96售16,,,,,0.00,0.00,0,0,0,0,0,0,0,0,0,0,0,0,0
20200520,057700,新日興群益9A購01,1.05,1.24,1.05,1.24,+0.10,8.77,394000,6,460780,0,0,0,0,0,0,11000,383000,-372000,-372000
20200520,057701,嘉聯益群益98購02,0.62,0.62,0.62,0.62,0.00,0.00,71000,1,44020,0,0,0,0,0,0,0,71000,-71000,-71000
20200520,057702,同欣電群益99購01,,,,,0.00,0.00,0,0,0,0,0,0,0,0,0,0,0,0,0
20200520,057703,矽力群益98購01,1.93,1.96,1.93,1.96,-0.10,-4.85,3000,2,5820,0,0,0,0,0,0,2000,0,2000,2000
20200520,057704,台虹群益98購03,1.45,1.47,1.42,1.44,-0.03,-2.04,878000,12,1274820,0,0,0,0,0,0,328000,550000,-222000,-222000
20200520,057705,臺股指群益98購05,1.42,1.45,1.36,1.37,0.00,0.00,393000,14,552830,0,0,0,0,0,0,142000,251000,-109000,-109000
20200520,057706,臺股指群益98購06,,,,,0.00,0.00,0,0,0,0,0,0,0,0,0,0,0,0,0
20200520,057707,臺股指群益98購07,1.86,1.91,1.83,1.83,-0.02,-1.08,330000,10,614400,0,0,0,0,0,0,190000,140000,50000,50000
20200520,057708,臺股指群益98購08,,,,,0.00,0.00,0,0,0,0,0,0,0,0,0,0,0,0,0
20200520,057709,電子類群益98購01,,,,,0.00,0.00,0,0,0,0,0,0,0,0,0,0,0,0,0
20200520,05770P,聯發科凱基96售16,,,,,0.00,0.00,0,0,0,0,0,0,0,0,0,0,0,0,0
20200520,057710,金融類群益98購01,,,,,0.00,0.00,0,0,0,0,0,0,0,0,0,0,0,0,0
20200520,057711,台積電統一9A購03,,,,,0.00,0.00,0,0,0,0,0,0,0,0,0,0,0,0,0
20200520,057712,南亞科統一9A購01,0.87,0.91,0.86,0.86,+0.02,2.38,205000,4,182320,0,0,0,0,0,0,90000,115000,-25000,-25000
20200520,057713,美律統一99購01,,,,,0.00,0.00,0,0,0,0,0,0,0,0,0,0,0,0,0
20200520,057714,聯發科統一98購05,3.22,3.27,3.22,3.27,+0.12,3.81,30000,2,97100,0,0,0,0,0,0,20000,10000,10000,10000
20200520,057715,聯發科統一99購03,,,,,0.00,0.00,0,0,0,0,0,0,0,0,0,0,0,0,0
20200520,057716,神達統一98購01,0.74,0.83,0.74,0.78,+0.01,1.3,730000,24,560490,0,0,0,0,0,0,305000,425000,-120000,-120000
20200520,057717,友訊元富98購02,0.97,1.01,0.96,0.96,-0.05,-4.95,231000,9,228220,0,0,0,0,0,0,50000,181000,-131000,-131000
20200520,057718,旺宏元富02購02,,,,,0.00,0.00,0,0,0,0,0,0,0,0,0,0,0,0,0
20200520,057719,欣興元富02購01,1.83,1.93,1.79,1.79,0.00,0.00,379000,21,701210,0,0,0,0,0,0,191000,188000,3000,3000
20200520,05771P,大立光凱基96售13,,,,,0.00,0.00,0,0,0,0,0,0,0,0,0,0,0,0,0
20200520,057720,日電貿元富98購01,1.56,1.62,1.56,1.62,-0.01,-0.61,60000,2,94980,0,0,0,0,0,0,37000,23000,14000,14000
20200520,057721,華擎元富98購02,1.54,1.89,1.54,1.89,+0.41,27.7,881000,64,1520840,0,0,0,0,0,0,163000,628000,-465000,-465000
20200520,057722,臺股指元富98購01,,,,,0.00,0.00,0,0,0,0,0,0,0,0,0,0,0,0,0
20200520,057723,臺股指元富98購02,0.19,0.19,0.19,0.19,0.00,0.00,1000,1,190,0,0,0,0,0,0,0,0,0,0
20200520,057724,亞德客國泰99購01,1.86,1.96,1.81,1.85,+0.04,2.21,458000,33,850400,0,0,0,0,0,0,124000,334000,-210000,-210000
20200520,057725,台達電國泰9A購01,1.43,1.43,1.40,1.43,+0.04,2.88,63000,36,89440,0,0,0,0,0,0,63000,0,63000,63000
20200520,057726,華通國泰9A購01,,,,,0.00,0.00,0,0,0,0,0,0,0,0,0,0,0,0,0
20200520,057727,華邦電國泰9A購01,0.95,1.01,0.95,0.99,+0.09,10.0,636000,18,616940,0,0,0,0,0,0,261000,395000,-134000,-134000
20200520,057728,瑞昱國泰99購01,,,,,0.00,0.00,0,0,0,0,0,0,0,0,0,0,0,0,0
20200520,057729,華新科國泰99購04,1.05,1.05,1.01,1.02,-0.01,-0.97,318000,22,328570,0,0,0,0,0,0,225000,77000,148000,148000
20200520,05772P,景碩凱基96售02,,,,,0.00,0.00,0,0,0,0,0,0,0,0,0,0,0,0,0
20200520,057730,聯鈞國泰9A購01,1.03,1.04,0.97,0.99,-0.06,-5.71,217000,6,223940,0,0,0,0,0,0,116000,101000,15000,15000
20200520,057731,華擎國泰9A購02,2.58,2.94,2.56,2.94,0.00,0.00,513000,16,1428590,0,0,0,0,0,0,0,511000,-511000,-511000
20200520,057732,牧德國泰9A購01,,,,,0.00,0.00,0,0,0,0,0,0,0,0,0,0,0,0,0
20200520,057733,嘉聯益國泰99購01,0.86,0.86,0.86,0.86,+0.02,2.38,100000,1,86000,0,0,0,0,0,0,100000,0,100000,100000
20200520,057734,訊芯國泰9A購01,0.48,0.48,0.48,0.48,+0.01,2.13,1000,1,480,0,0,0,0,0,0,0,1000,-1000,-1000
20200520,057735,台灣50富邦9C購02,1.21,1.21,1.21,1.21,-0.01,-0.82,2000,1,2420,0,0,0,0,0,0,2000,0,2000,2000
20200520,057736,鴻海富邦99購04,2.02,2.02,2.02,2.02,0.00,0.00,10000,2,20200,0,0,0,0,0,0,0,10000,-10000,-10000
20200520,057737,國巨富邦99購02,0.14,0.25,0.14,0.17,+0.04,30.77,80000,10,16050,0,0,0,0,0,0,5000,0,5000,5000
20200520,057738,旺宏富邦9A購01,0.51,0.51,0.50,0.50,0.00,0.00,35000,3,17600,0,0,0,0,0,0,15000,20000,-5000,-5000
20200520,057739,新日興富邦9B購01,0.44,0.50,0.43,0.50,+0.04,8.7,56000,8,25330,0,0,0,0,0,0,21000,35000,-14000,-14000
20200520,05773P,臺股指凱基99售03,,,,,0.00,0.00,0,0,0,0,0,0,0,0,0,0,0,0,0
20200520,057740,茂林富邦9A購01,0.36,0.48,0.36,0.48,+0.14,41.18,465000,22,178700,0,0,0,0,0,0,123000,307000,-184000,-184000
20200520,057741,超眾富邦98購01,,,,,0.00,0.00,0,0,0,0,0,0,0,0,0,0,0,0,0
20200520,057742,喬山永豐98購02,0.61,0.70,0.61,0.70,+0.08,12.9,328000,10,219460,0,0,0,0,0,0,1000,324000,-323000,-323000
20200520,057743,華擎永豐98購03,0.66,0.78,0.65,0.78,+0.16,25.81,878000,42,656430,0,0,0,0,0,0,119000,704000,-585000,-585000
20200520,057744,健策永豐98購02,0.95,0.98,0.95,0.98,-0.07,-6.67,58000,3,56230,0,0,0,0,0,0,3000,58000,-55000,-55000
20200520,057745,泰鼎永豐99購01,0.67,0.80,0.66,0.80,+0.08,11.11,27000,7,18800,0,0,0,0,0,0,1000,25000,-24000,-24000
20200520,057746,同欣電永豐98購02,,,,,0.00,0.00,0,0,0,0,0,0,0,0,0,0,0,0,0
20200520,057747,致新永豐98購01,1.35,1.40,1.29,1.29,+0.05,4.03,56000,8,76200,0,0,0,0,0,0,10000,46000,-36000,-36000
20200520,057748,華通國票98購04,,,,,0.00,0.00,0,0,0,0,0,0,0,0,0,0,0,0,0
20200520,057749,華新科國票99購01,,,,,0.00,0.00,0,0,0,0,0,0,0,0,0,0,0,0,0
20200520,05774P,臺股指凱基99售04,,,,,0.00,0.00,0,0,0,0,0,0,0,0,0,0,0,0,0
20200520,057750,神達國票99購01,,,,,0.00,0.00,0,0,0,0,0,0,0,0,0,0,0,0,0
20200520,057751,神達國票99購02,1.85,1.91,1.85,1.91,+0.14,7.91,10000,2,18800,0,0,0,0,0,0,10000,0,10000,10000
20200520,057752,臺股指國票98購08,1.36,1.36,1.28,1.30,-0.02,-1.52,253000,8,336420,0,0,0,0,0,0,130000,123000,7000,7000
20200520,057753,臺股指國票98購09,,,,,0.00,0.00,0,0,0,0,0,0,0,0,0,0,0,0,0
20200520,057754,臺股指國票98購10,0.06,0.06,0.06,0.06,0.00,0.00,40000,1,2400,0,0,0,0,0,0,40000,0,40000,40000
20200520,057755,鴻海日盛98購01,,,,,0.00,0.00,0,0,0,0,0,0,0,0,0,0,0,0,0
20200520,057756,瑞昱日盛99購01,,,,,0.00,0.00,0,0,0,0,0,0,0,0,0,0,0,0,0
20200520,057757,鴻海凱基98購13,2.53,2.53,2.53,2.53,-0.07,-2.69,6000,1,15180,0,0,0,0,0,0,0,6000,-6000,-6000
20200520,057758,鴻海凱基99購03,2.88,2.88,2.88,2.88,0.00,0.00,10000,1,28800,0,0,0,0,0,0,0,10000,-10000,-10000
20200520,057759,聯發科凱基98購17,5.80,5.80,5.80,5.80,+0.45,8.41,20000,2,116000,0,0,0,0,0,0,20000,20000,0,0
20200520,05775P,台積電國泰98售02,,,,,0.00,0.00,0,0,0,0,0,0,0,0,0,0,0,0,0
20200520,057760,聯發科凱基98購18,4.91,4.91,4.91,4.91,+0.12,2.51,2000,1,9820,0,0,0,0,0,0,2000,0,2000,2000
20200520,057761,聯發科凱基99購04,,,,,0.00,0.00,0,0,0,0,0,0,0,0,0,0,0,0,0
20200520,057762,全新凱基99購03,,,,,0.00,0.00,0,0,0,0,0,0,0,0,0,0,0,0,0
20200520,057763,康控凱基99購02,0.36,0.36,0.33,0.33,0.00,0.00,75000,12,26250,0,0,0,0,0,0,60000,15000,45000,45000
20200520,057764,台表科凱基9A購01,1.01,1.08,1.01,1.08,+0.27,33.33,2000,2,2090,0,0,0,0,0,0,2000,0,2000,2000
20200520,057765,康舒凱基98購01,,,,,0.00,0.00,0,0,0,0,0,0,0,0,0,0,0,0,0
20200520,057766,矽力凱基98購03,,,,,0.00,0.00,0,0,0,0,0,0,0,0,0,0,0,0,0
20200520,057767,緯穎凱基98購06,2.13,2.19,1.92,1.92,-0.08,-4.0,428000,40,911150,0,0,0,0,0,0,423000,21000,402000,402000
20200520,057768,華新科中信9A購01,0.19,0.19,0.19,0.19,+0.01,5.56,100000,1,19000,0,0,0,0,0,0,0,100000,-100000,-100000
20200520,057769,T50反1群益98購02,,,,,0.00,0.00,0,0,0,0,0,0,0,0,0,0,0,0,0
20200520,05776P,鴻海統一98售02,,,,,0.00,0.00,0,0,0,0,0,0,0,0,0,0,0,0,0
20200520,057770,亞德客群益98購01,1.99,1.99,1.90,1.90,-0.16,-7.77,57000,2,111810,0,0,0,0,0,0,0,57000,-57000,-57000
20200520,057771,鴻海群益99購01,,,,,0.00,0.00,0,0,0,0,0,0,0,0,0,0,0,0,0
20200520,057772,台積電群益99購01,,,,,0.00,0.00,0,0,0,0,0,0,0,0,0,0,0,0,0
20200520,057773,技嘉群益9A購02,3.15,3.16,3.03,3.05,-0.11,-3.48,543000,11,1659110,0,0,0,0,0,0,417000,126000,291000,291000
20200520,057774,台光電群益99購02,,,,,0.00,0.00,0,0,0,0,0,0,0,0,0,0,0,0,0
20200520,057775,南亞科群益98購02,,,,,0.00,0.00,0,0,0,0,0,0,0,0,0,0,0,0,0
20200520,057776,京元電群益98購02,1.37,1.37,1.25,1.25,-0.23,-15.54,667000,46,861030,0,0,0,0,0,0,5000,662000,-657000,-657000
20200520,057777,可成群益9A購03,,,,,0.00,0.00,0,0,0,0,0,0,0,0,0,0,0,0,0
20200520,057778,大立光群益98購02,2.74,2.74,2.74,2.74,+0.06,2.24,5000,1,13700,0,0,0,0,0,0,0,5000,-5000,-5000
20200520,057779,禾伸堂群益98購02,,,,,0.00,0.00,0,0,0,0,0,0,0,0,0,0,0,0,0
20200520,05777P,台積電統一96售04,,,,,0.00,0.00,0,0,0,0,0,0,0,0,0,0,0,0,0
20200520,057780,台郡群益98購02,1.23,1.29,1.21,1.21,-0.02,-1.63,143000,8,178260,0,0,0,0,0,0,111000,32000,79000,79000
20200520,057781,國巨國票99購04,,,,,0.00,0.00,0,0,0,0,0,0,0,0,0,0,0,0,0
20200520,057782,台積電國票99購07,,,,,0.00,0.00,0,0,0,0,0,0,0,0,0,0,0,0,0
20200520,057783,台積電國票9A購01,,,,,0.00,0.00,0,0,0,0,0,0,0,0,0,0,0,0,0
20200520,057784,台積電國票9B購01,,,,,0.00,0.00,0,0,0,0,0,0,0,0,0,0,0,0,0
20200520,057785,智邦國票99購02,9.55,9.55,9.45,9.45,+0.45,5.0,8000,2,76300,0,0,0,0,0,0,7000,1000,6000,6000
20200520,057786,聯發科國票98購05,4.55,4.55,4.55,4.55,+0.36,8.59,51000,2,232050,0,0,0,0,0,0,51000,0,51000,51000
20200520,057787,TPK國票99購01,1.72,1.73,1.67,1.67,+0.04,2.45,299000,4,502570,0,0,0,0,0,0,282000,253000,29000,29000
20200520,057788,嘉聯益國票99購01,,,,,0.00,0.00,0,0,0,0,0,0,0,0,0,0,0,0,0
20200520,057789,上銀統一9A購01,,,,,0.00,0.00,0,0,0,0,0,0,0,0,0,0,0,0,0
20200520,05778P,台積電統一96售05,,,,,0.00,0.00,0,0,0,0,0,0,0,0,0,0,0,0,0
20200520,057790,台積電統一99購04,1.21,1.21,1.21,1.21,0.00,0.00,1000,1,1210,0,0,0,0,0,0,1000,1000,0,0
20200520,057791,可成統一99購01,,,,,0.00,0.00,0,0,0,0,0,0,0,0,0,0,0,0,0
20200520,057792,群創統一99購01,,,,,0.00,0.00,0,0,0,0,0,0,0,0,0,0,0,0,0
20200520,057793,群創統一99購02,,,,,0.00,0.00,0,0,0,0,0,0,0,0,0,0,0,0,0
20200520,057794,T50反1兆豐99購02,0.68,0.71,0.66,0.69,-0.01,-1.43,67000,42,45420,0,0,0,0,0,0,0,67000,-67000,-67000
20200520,057795,鴻海兆豐99購02,0.71,0.71,0.68,0.68,-0.03,-4.23,10000,2,6920,0,0,0,0,0,0,6000,4000,2000,2000
20200520,057796,鴻海兆豐99購03,0.50,0.50,0.27,0.27,-0.02,-6.9,11000,2,3200,0,0,0,0,0,0,0,10000,-10000,-10000
20200520,057797,大立光兆豐99購01,,,,,0.00,0.00,0,0,0,0,0,0,0,0,0,0,0,0,0
20200520,057798,貿聯兆豐99購01,0.73,0.73,0.72,0.73,+0.02,2.82,416000,10,302030,0,0,0,0,0,0,351000,65000,286000,286000
20200520,057799,世紀鋼兆豐98購01,1.17,1.17,1.12,1.12,-0.14,-11.11,9000,2,10480,0,0,0,0,0,0,8000,1000,7000,7000
20200520,05779P,台積電統一96售06,3.42,3.51,3.32,3.32,0.00,0.00,820000,4,2770900,0,0,0,0,0,0,820000,820000,0,0
20200520,057800,元油2X元大98購18,,,,,0.00,0.00,0,0,0,0,0,0,0,0,0,0,0,0,0
20200520,057801,元油2X元大98購19,,,,,0.00,0.00,0,0,0,0,0,0,0,0,0,0,0,0,0
20200520,057802,卜蜂元大98購01,2.80,2.82,2.76,2.78,-0.02,-0.71,119000,20,332060,0,0,0,0,0,0,115000,0,115000,115000
20200520,057803,上銀元大98購08,1.41,1.41,1.41,1.41,-0.08,-5.37,68000,1,95880,0,0,0,0,0,0,0,68000,-68000,-68000
20200520,057804,為升元大98購01,1.23,1.23,1.05,1.05,-0.13,-11.02,667000,28,762640,40000,0,40000,0,0,0,348000,209000,139000,179000
20200520,057805,華通元大98購06,2.37,2.45,2.37,2.45,0.00,0.00,79000,2,192430,0,0,0,0,0,0,65000,14000,51000,51000
20200520,057806,國巨元大98購20,0.50,0.50,0.50,0.50,0.00,0.00,1000,1,500,0,0,0,0,0,0,1000,0,1000,1000
20200520,057807,友訊元大98購02,,,,,0.00,0.00,0,0,0,0,0,0,0,0,0,0,0,0,0
20200520,057808,旺宏元大99購05,,,,,0.00,0.00,0,0,0,0,0,0,0,0,0,0,0,0,0
20200520,057809,英業達元大98購01,2.12,2.23,2.12,2.14,+0.01,0.47,205000,20,443470,0,0,0,0,0,0,65000,140000,-75000,-75000
20200520,05780P,台積電統一96售07,2.62,2.62,2.62,2.62,0.00,0.00,14000,1,36680,0,0,0,0,0,0,14000,14000,0,0
20200520,057810,技嘉元大98購06,2.40,2.43,2.28,2.34,-0.05,-2.09,182000,9,434130,0,0,0,0,0,0,40000,142000,-102000,-102000
20200520,057811,南亞科元大98購08,,,,,0.00,0.00,0,0,0,0,0,0,0,0,0,0,0,0,0
20200520,057812,友達元大9A購05,0.49,0.50,0.49,0.49,-0.01,-2.0,300000,3,148000,0,0,0,0,0,0,100000,200000,-100000,-100000
20200520,057813,京元電元大98購03,,,,,0.00,0.00,0,0,0,0,0,0,0,0,0,0,0,0,0
20200520,057814,聯發科元大98購12,4.55,4.55,4.55,4.55,+0.57,14.32,1000,1,4550,0,0,0,0,0,0,1000,0,1000,1000
20200520,057815,信邦元大98購01,2.70,2.85,2.61,2.61,+0.04,1.56,213000,15,580950,0,0,0,0,0,0,179000,34000,145000,145000
20200520,057816,欣興元大98購13,1.77,1.85,1.67,1.71,-0.05,-2.84,185000,15,324150,0,0,0,0,0,0,68000,117000,-49000,-49000
20200520,057817,景碩元大98購01,1.83,1.83,1.83,1.83,+0.09,5.17,68000,2,124440,0,0,0,0,0,0,0,68000,-68000,-68000
20200520,057818,泰碩元大9A購01,2.62,2.62,2.51,2.51,-0.20,-7.38,40000,5,102600,0,0,0,0,0,0,10000,40000,-30000,-30000
20200520,057819,新日興元大99購01,1.54,1.64,1.44,1.64,+0.08,5.13,284000,12,430580,0,0,0,0,0,0,131000,153000,-22000,-22000
20200520,05781P,臺股指統一99售02,,,,,0.00,0.00,0,0,0,0,0,0,0,0,0,0,0,0,0
20200520,057820,華擎元大98購02,1.46,1.67,1.46,1.66,+0.26,18.57,293000,17,452280,0,0,0,0,0,0,107000,293000,-186000,-186000
20200520,057821,晶相光元大98購03,,,,,0.00,0.00,0,0,0,0,0,0,0,0,0,0,0,0,0
20200520,057822,牧德元大9A購01,,,,,0.00,0.00,0,0,0,0,0,0,0,0,0,0,0,0,0
20200520,057823,神達元大98購01,,,,,0.00,0.00,0,0,0,0,0,0,0,0,0,0,0,0,0
20200520,057824,日月光元大98購01,1.28,1.32,1.21,1.22,-0.20,-14.08,276000,10,349410,0,0,0,0,0,0,30000,246000,-216000,-216000
20200520,057825,和碩元大98購02,,,,,0.00,0.00,0,0,0,0,0,0,0,0,0,0,0,0,0
20200520,057826,祥碩元大98購08,4.02,4.37,3.93,4.37,+0.61,16.22,122000,11,494640,0,0,0,0,0,0,70000,52000,18000,18000
20200520,057827,康友元大98購03,0.39,0.41,0.39,0.41,-0.01,-2.38,10000,2,4000,0,0,0,0,0,0,5000,5000,0,0
20200520,057828,緯穎元大99購02,3.77,3.93,3.50,3.50,-0.22,-5.91,155000,15,598350,0,0,0,0,0,0,83000,117000,-34000,-34000
20200520,057829,臺股指元大98購12,,,,,0.00,0.00,0,0,0,0,0,0,0,0,0,0,0,0,0
20200520,05782P,聯詠元富96售02,,,,,0.00,0.00,0,0,0,0,0,0,0,0,0,0,0,0,0
20200520,057830,T50反1台新02購02,,,,,0.00,0.00,0,0,0,0,0,0,0,0,0,0,0,0,0
20200520,057831,聯發科元富02購04,3.70,3.85,3.69,3.85,+0.25,6.94,164000,15,610420,0,0,0,0,0,0,128000,36000,92000,92000
20200520,057832,聯發科元富02購05,4.66,4.74,4.65,4.69,+0.12,2.63,95000,13,442900,0,0,0,0,0,0,86000,9000,77000,77000
20200520,057833,聯發科元富02購06,4.36,4.46,4.35,4.43,+0.18,4.24,209000,18,915870,0,0,0,0,0,0,201000,8000,193000,193000
20200520,057834,聯發科元富02購07,5.20,5.30,5.15,5.30,+0.25,4.95,80000,8,416000,0,0,0,0,0,0,80000,0,80000,80000
20200520,057835,華擎元富9B購01,2.19,2.58,2.19,2.58,+0.49,23.44,764000,54,1814840,0,0,0,0,0,0,170000,658000,-488000,-488000
20200520,057836,南亞科國泰9A購01,0.83,0.87,0.83,0.87,+0.08,10.13,74000,2,61860,0,0,0,0,0,0,63000,11000,52000,52000
20200520,057837,康控國泰99購02,0.93,0.93,0.77,0.77,-0.05,-6.1,274000,37,230810,0,0,0,0,0,0,225000,9000,216000,216000
20200520,057838,台郡國泰99購01,,,,,0.00,0.00,0,0,0,0,0,0,0,0,0,0,0,0,0
20200520,057839,台積電富邦9A購02,,,,,0.00,0.00,0,0,0,0,0,0,0,0,0,0,0,0,0
20200520,05783P,嘉澤元富96售01,0.06,0.07,0.06,0.06,-0.01,-14.29,560000,23,34750,0,0,0,0,0,0,165000,355000,-190000,-190000
20200520,057840,健策富邦99購01,,,,,0.00,0.00,0,0,0,0,0,0,0,0,0,0,0,0,0
20200520,057841,茂林富邦9A購02,0.33,0.40,0.33,0.40,+0.11,37.93,435000,11,152650,0,0,0,0,0,0,85000,345000,-260000,-260000
20200520,057842,緯穎富邦99購02,0.85,0.90,0.85,0.88,-0.07,-7.37,21000,7,18380,0,0,0,0,0,0,20000,1000,19000,19000
20200520,057843,晶技永豐98購02,3.59,3.62,3.59,3.62,-0.13,-3.47,31000,2,111410,0,0,0,0,0,0,4000,27000,-23000,-23000
20200520,057844,新日興永豐99購01,0.12,0.12,0.12,0.12,0.00,0.00,10000,1,1200,0,0,0,0,0,0,0,10000,-10000,-10000
20200520,057845,晶相光永豐98購03,,,,,0.00,0.00,0,0,0,0,0,0,0,0,0,0,0,0,0
20200520,057846,神達永豐98購01,,,,,0.00,0.00,0,0,0,0,0,0,0,0,0,0,0,0,0
20200520,057847,聯茂永豐98購01,,,,,0.00,0.00,0,0,0,0,0,0,0,0,0,0,0,0,0
20200520,057848,台表科永豐98購02,0.48,0.48,0.47,0.47,+0.17,56.67,20000,2,9500,0,0,0,0,0,0,0,20000,-20000,-20000
20200520,057849,南茂永豐98購02,0.97,1.02,0.96,1.02,+0.04,4.08,104000,5,101110,0,0,0,0,0,0,10000,94000,-84000,-84000
20200520,05784P,臺股指元大96售18,,,,,0.00,0.00,0,0,0,0,0,0,0,0,0,0,0,0,0
20200520,057850,上銀兆豐99購02,,,,,0.00,0.00,0,0,0,0,0,0,0,0,0,0,0,0,0
20200520,057851,鴻海國票99購06,,,,,0.00,0.00,0,0,0,0,0,0,0,0,0,0,0,0,0
20200520,057852,國巨國票99購05,,,,,0.00,0.00,0,0,0,0,0,0,0,0,0,0,0,0,0
20200520,057853,旺宏國票99購05,2.14,2.14,2.14,2.14,-0.01,-0.47,7000,1,14980,0,0,0,0,0,0,0,7000,-7000,-7000
20200520,057854,聯發科國票99購03,,,,,0.00,0.00,0,0,0,0,0,0,0,0,0,0,0,0,0
20200520,057855,晶技國票99購01,,,,,0.00,0.00,0,0,0,0,0,0,0,0,0,0,0,0,0
20200520,057856,聯鈞國票99購03,,,,,0.00,0.00,0,0,0,0,0,0,0,0,0,0,0,0,0
20200520,057857,牧德國票99購01,0.94,1.09,0.94,1.08,+0.17,18.68,258000,12,272660,0,0,0,0,0,0,41000,217000,-176000,-176000
20200520,057858,T50正2康和98購01,,,,,0.00,0.00,0,0,0,0,0,0,0,0,0,0,0,0,0
20200520,057859,神達康和98購01,0.99,1.02,0.99,1.02,+0.03,3.03,97000,2,96900,0,0,0,0,0,0,0,97000,-97000,-97000
20200520,05785P,臺股指元大96售19,,,,,0.00,0.00,0,0,0,0,0,0,0,0,0,0,0,0,0
20200520,057860,金寶凱基98購01,0.47,0.47,0.47,0.47,-0.01,-2.08,44000,1,20680,0,0,0,0,0,0,0,44000,-44000,-44000
20200520,057861,台積電凱基98購16,0.45,0.45,0.45,0.45,0.00,0.00,5000,1,2250,0,0,0,0,0,0,0,0,0,0
20200520,057862,智邦凱基99購01,2.51,2.60,2.47,2.54,+0.08,3.25,77000,7,194970,0,0,0,0,0,0,41000,22000,19000,19000
20200520,057863,美律凱基9A購01,0.61,0.61,0.61,0.61,0.00,0.00,2000,1,1220,0,0,0,0,0,0,2000,0,2000,2000
20200520,057864,奇力新凱基99購03,,,,,0.00,0.00,0,0,0,0,0,0,0,0,0,0,0,0,0
20200520,057865,富邦金凱基98購01,,,,,0.00,0.00,0,0,0,0,0,0,0,0,0,0,0,0,0
20200520,057866,玉山金凱基98購01,,,,,0.00,0.00,0,0,0,0,0,0,0,0,0,0,0,0,0
20200520,057867,大立光凱基98購17,,,,,0.00,0.00,0,0,0,0,0,0,0,0,0,0,0,0,0
20200520,057868,大立光凱基98購18,,,,,0.00,0.00,0,0,0,0,0,0,0,0,0,0,0,0,0
20200520,057869,大立光凱基99購01,,,,,0.00,0.00,0,0,0,0,0,0,0,0,0,0,0,0,0
20200520,05786P,臺股指永昌96售03,,,,,0.00,0.00,0,0,0,0,0,0,0,0,0,0,0,0,0
20200520,057870,大立光凱基99購02,,,,,0.00,0.00,0,0,0,0,0,0,0,0,0,0,0,0,0
20200520,057871,國巨元大99購09,0.57,0.57,0.57,0.57,0.00,0.00,55000,1,31350,0,0,0,0,0,0,55000,0,55000,55000
20200520,057872,旺宏元大99購06,1.72,1.72,1.72,1.72,0.00,0.00,68000,1,116960,0,0,0,0,0,0,0,68000,-68000,-68000
20200520,057873,義隆元大98購03,2.34,2.39,2.34,2.39,+0.07,3.02,46000,5,109190,0,0,0,0,0,0,10000,36000,-26000,-26000
20200520,057874,可成元大99購02,1.27,1.27,1.17,1.18,-0.32,-21.33,94000,3,116840,0,0,0,0,0,0,20000,74000,-54000,-54000
20200520,057875,京鼎元大98購03,1.37,1.39,1.36,1.36,-0.06,-4.23,272000,5,373080,0,0,0,0,0,0,10000,262000,-252000,-252000
20200520,057876,隆達元大98購01,2.59,3.60,2.59,3.60,+0.95,35.85,61000,14,188800,0,0,0,0,0,0,32000,27000,5000,5000
20200520,057877,神達元大99購01,2.38,2.61,2.38,2.50,+0.12,5.04,203000,14,508290,0,0,0,0,0,0,0,203000,-203000,-203000
20200520,057878,台郡元大99購04,1.75,1.75,1.75,1.75,+0.04,2.34,21000,1,36750,0,0,0,0,0,0,0,21000,-21000,-21000
20200520,057879,電子類元大99購02,,,,,0.00,0.00,0,0,0,0,0,0,0,0,0,0,0,0,0
20200520,05787P,臺股指永昌96售04,,,,,0.00,0.00,0,0,0,0,0,0,0,0,0,0,0,0,0
20200520,057880,金融類元大99購02,,,,,0.00,0.00,0,0,0,0,0,0,0,0,0,0,0,0,0
20200520,057881,SP黃豆群益9A購01,,,,,0.00,0.00,0,0,0,0,0,0,0,0,0,0,0,0,0
20200520,057882,華通群益9A購03,2.33,2.33,2.25,2.25,-0.18,-7.41,34000,2,77620,0,0,0,0,0,0,0,34000,-34000,-34000
20200520,057883,中環群益98購01,0.43,0.50,0.43,0.50,+0.06,13.64,165000,4,76900,0,0,0,0,0,0,60000,105000,-45000,-45000
20200520,057884,華邦電群益98購02,,,,,0.00,0.00,0,0,0,0,0,0,0,0,0,0,0,0,0
20200520,057885,台光電群益98購04,2.48,2.48,2.48,2.48,-0.01,-0.4,5000,1,12400,0,0,0,0,0,0,0,5000,-5000,-5000
20200520,057886,聯詠群益98購01,1.45,1.50,1.45,1.49,+0.04,2.76,42000,4,62400,0,0,0,0,0,0,24000,18000,6000,6000
20200520,057887,智原群益98購04,1.01,1.09,1.01,1.09,+0.08,7.92,225000,5,235950,0,0,0,0,0,0,70000,155000,-85000,-85000
20200520,057888,貿聯群益98購02,2.38,2.38,2.33,2.34,-0.04,-1.68,141000,4,330370,0,0,0,0,0,0,41000,100000,-59000,-59000
20200520,057889,致新群益99購01,1.66,1.66,1.66,1.66,0.00,0.00,2000,1,3320,0,0,0,0,0,0,2000,0,2000,2000
20200520,05788P,臺股指永昌96售05,,,,,0.00,0.00,0,0,0,0,0,0,0,0,0,0,0,0,0
20200520,057890,滬深反統一98購01,0.78,0.78,0.78,0.78,0.00,0.00,25000,1,19500,0,0,0,0,0,0,25000,0,25000,25000
20200520,057891,華新科統一9A購01,,,,,0.00,0.00,0,0,0,0,0,0,0,0,0,0,0,0,0
20200520,057892,上証2X元富02購01,2.86,2.86,2.86,2.86,-0.08,-2.72,20000,1,57200,0,0,0,0,0,0,0,20000,-20000,-20000
20200520,057893,亞德客元富98購03,,,,,0.00,0.00,0,0,0,0,0,0,0,0,0,0,0,0,0
20200520,057894,華通元富02購02,2.40,2.40,2.40,2.40,-0.10,-4.0,2000,2,4800,0,0,0,0,0,0,0,2000,-2000,-2000
20200520,057895,全新元富9B購01,,,,,0.00,0.00,0,0,0,0,0,0,0,0,0,0,0,0,0
20200520,057896,嘉晶元富98購01,2.88,3.61,2.88,3.61,+0.57,18.75,56000,8,182000,0,0,0,0,0,0,10000,46000,-36000,-36000
20200520,057897,華通富邦99購01,,,,,0.00,0.00,0,0,0,0,0,0,0,0,0,0,0,0,0
20200520,057898,元油2X永豐98購06,,,,,0.00,0.00,0,0,0,0,0,0,0,0,0,0,0,0,0
20200520,057899,台積電永豐98購04,0.72,0.72,0.72,0.72,-0.01,-1.37,4000,2,2880,0,0,0,0,0,0,0,4000,-4000,-4000
20200520,05789P,臺股指永昌96售06,,,,,0.00,0.00,0,0,0,0,0,0,0,0,0,0,0,0,0
20200520,057900,南亞科永豐98購01,,,,,0.00,0.00,0,0,0,0,0,0,0,0,0,0,0,0,0
20200520,057901,大立光永豐98購04,0.99,0.99,0.99,0.99,-0.05,-4.81,2000,1,1980,0,0,0,0,0,0,2000,0,2000,2000
20200520,057902,嘉晶永豐98購02,0.78,1.16,0.75,1.16,+0.40,52.63,637000,77,572240,0,0,0,0,0,0,64000,573000,-509000,-509000
20200520,057903,聯鈞永豐99購01,0.24,0.24,0.23,0.23,-0.03,-11.54,170000,6,39500,0,0,0,0,0,0,20000,150000,-130000,-130000
20200520,057904,矽力永豐98購01,1.32,1.40,1.26,1.40,+0.07,5.26,231000,14,304740,0,0,0,0,0,0,125000,106000,19000,19000
20200520,057905,臺股指永豐98購06,,,,,0.00,0.00,0,0,0,0,0,0,0,0,0,0,0,0,0
20200520,057906,福懋科中信99購01,,,,,0.00,0.00,0,0,0,0,0,0,0,0,0,0,0,0,0
20200520,057907,台達電亞東99購01,0.89,0.89,0.89,0.89,-0.02,-2.2,10000,8,8900,0,0,0,0,0,0,10000,0,10000,10000
20200520,057908,國泰金亞東99購01,0.48,0.48,0.48,0.48,0.00,0.00,12000,1,5760,0,0,0,0,0,0,0,0,0,0
20200520,057909,台光電兆豐98購01,1.25,1.28,1.22,1.24,-0.10,-7.46,181000,12,223580,0,0,0,0,0,0,68000,113000,-45000,-45000
20200520,05790P,臺股指永昌96售07,,,,,0.00,0.00,0,0,0,0,0,0,0,0,0,0,0,0,0
20200520,057910,華新科兆豐99購02,0.12,0.12,0.12,0.12,0.00,0.00,10000,1,1200,0,0,0,0,0,0,10000,10000,0,0
20200520,057911,國巨日盛98購01,,,,,0.00,0.00,0,0,0,0,0,0,0,0,0,0,0,0,0
20200520,057912,美律日盛99購01,,,,,0.00,0.00,0,0,0,0,0,0,0,0,0,0,0,0,0
20200520,057913,健策日盛98購01,,,,,0.00,0.00,0,0,0,0,0,0,0,0,0,0,0,0,0
20200520,057914,日月光日盛9A購01,,,,,0.00,0.00,0,0,0,0,0,0,0,0,0,0,0,0,0
20200520,057915,台泥凱基98購01,1.90,1.95,1.89,1.92,-0.01,-0.52,222000,41,427430,0,0,0,0,0,0,186000,89000,97000,97000
20200520,057916,國巨凱基98購13,0.66,0.69,0.66,0.67,+0.06,9.84,100000,6,67400,0,0,0,0,0,0,50000,50000,0,0
20200520,057917,台積電凱基98購17,1.51,1.51,1.51,1.51,0.00,0.00,10000,1,15100,0,0,0,0,0,0,10000,0,10000,10000
20200520,057918,旺宏凱基99購01,,,,,0.00,0.00,0,0,0,0,0,0,0,0,0,0,0,0,0
20200520,057919,技嘉凱基98購03,2.01,2.03,1.88,1.92,-0.06,-3.03,94000,10,183500,0,0,0,0,0,0,89000,15000,74000,74000
20200520,05791P,臺股指中信99售06,,,,,0.00,0.00,0,0,0,0,0,0,0,0,0,0,0,0,0
20200520,057920,奇力新凱基98購08,,,,,0.00,0.00,0,0,0,0,0,0,0,0,0,0,0,0,0
20200520,057921,可成凱基98購09,,,,,0.00,0.00,0,0,0,0,0,0,0,0,0,0,0,0,0
20200520,057922,華新科凱基99購01,,,,,0.00,0.00,0,0,0,0,0,0,0,0,0,0,0,0,0
20200520,057923,晶豪科凱基98購02,2.02,2.07,1.90,1.91,-0.19,-9.05,437000,12,852010,0,0,0,0,0,0,193000,414000,-221000,-221000
20200520,057924,健策凱基98購02,1.05,1.05,1.05,1.05,0.00,0.00,1000,1,1050,0,0,0,0,0,0,1000,1000,0,0
20200520,057925,貿聯凱基99購01,1.08,1.09,1.08,1.08,-0.01,-0.92,83000,4,89940,0,0,0,0,0,0,37000,46000,-9000,-9000
20200520,057926,帆宣凱基98購02,,,,,0.00,0.00,0,0,0,0,0,0,0,0,0,0,0,0,0
20200520,057927,勤誠凱基98購01,1.29,1.30,1.29,1.30,-0.02,-1.52,30000,2,38820,0,0,0,0,0,0,30000,0,30000,30000
20200520,057928,鈺齊凱基98購02,,,,,0.00,0.00,0,0,0,0,0,0,0,0,0,0,0,0,0
20200520,057929,上銀群益98購02,2.29,2.29,2.23,2.23,-0.17,-7.08,28000,2,64000,0,0,0,0,0,0,2000,26000,-24000,-24000
20200520,05792P,臺股指中信99售07,,,,,0.00,0.00,0,0,0,0,0,0,0,0,0,0,0,0,0
20200520,057930,旺宏群益99購04,3.98,3.98,3.93,3.93,-0.05,-1.26,10000,2,39550,0,0,0,0,0,0,5000,5000,0,0
20200520,057931,正崴群益98購02,2.19,2.22,2.19,2.19,-0.03,-1.35,195000,3,427620,0,0,0,0,0,0,85000,110000,-25000,-25000
20200520,057932,美律群益98購04,,,,,0.00,0.00,0,0,0,0,0,0,0,0,0,0,0,0,0
20200520,057933,聯發科群益98購06,,,,,0.00,0.00,0,0,0,0,0,0,0,0,0,0,0,0,0
20200520,057934,華新科群益98購07,1.84,1.90,1.84,1.90,+0.08,4.4,79000,2,148060,0,0,0,0,0,0,79000,45000,34000,34000
20200520,057935,晶技群益98購02,4.25,4.47,4.25,4.47,+0.17,3.95,59000,6,255150,0,0,0,0,0,0,11000,48000,-37000,-37000
20200520,057936,健策群益99購01,2.35,2.49,2.35,2.49,+0.16,6.87,5000,2,12030,0,0,0,0,0,0,5000,5000,0,0
20200520,057937,神達群益98購02,1.15,1.31,1.15,1.29,0.00,0.00,187000,11,229280,0,0,0,0,0,0,0,187000,-187000,-187000
20200520,057938,台表科群益98購02,2.77,3.41,2.77,3.41,+0.73,27.24,186000,14,578240,0,0,0,0,0,0,27000,159000,-132000,-132000
20200520,057939,鈺齊群益98購02,,,,,0.00,0.00,0,0,0,0,0,0,0,0,0,0,0,0,0
20200520,05793P,臺股指中信99售08,2.30,2.30,2.30,2.30,-0.08,-3.36,1000,1,2300,0,0,0,0,0,0,0,1000,-1000,-1000
20200520,057940,和大國票99購01,0.85,1.06,0.85,1.06,+0.16,17.78,95000,13,94860,0,0,0,0,0,0,10000,85000,-75000,-75000
20200520,057941,聯電國票99購01,0.56,0.57,0.52,0.52,-0.08,-13.33,109000,7,59940,0,0,0,0,0,0,28000,81000,-53000,-53000
20200520,057942,可成國票99購02,,,,,0.00,0.00,0,0,0,0,0,0,0,0,0,0,0,0,0
20200520,057943,可成國票99購03,1.69,1.70,1.65,1.66,-0.40,-19.42,25000,6,41590,0,0,0,0,0,0,10000,25000,-15000,-15000
20200520,057944,新日興國票99購02,2.27,2.42,2.27,2.42,0.00,0.00,136000,7,315510,0,0,0,0,0,0,0,136000,-136000,-136000
20200520,057945,京鼎國票99購03,,,,,0.00,0.00,0,0,0,0,0,0,0,0,0,0,0,0,0
20200520,057946,晶相光國票99購01,0.63,0.64,0.63,0.64,-0.03,-4.48,3000,3,1910,0,0,0,0,0,0,0,3000,-3000,-3000
20200520,057947,和碩國票99購01,,,,,0.00,0.00,0,0,0,0,0,0,0,0,0,0,0,0,0
20200520,057948,嘉聯益國票99購02,,,,,0.00,0.00,0,0,0,0,0,0,0,0,0,0,0,0,0
20200520,057949,南電國票99購01,,,,,0.00,0.00,0,0,0,0,0,0,0,0,0,0,0,0,0
20200520,05794P,華邦電群益96售04,,,,,0.00,0.00,0,0,0,0,0,0,0,0,0,0,0,0,0
20200520,057950,T50正2元大9B購04,0.45,0.52,0.45,0.52,0.00,0.00,20000,2,9700,0,0,0,0,0,0,20000,10000,10000,10000
20200520,057951,元油2X元大98購20,,,,,0.00,0.00,0,0,0,0,0,0,0,0,0,0,0,0,0
20200520,057952,元油2X元大98購21,,,,,0.00,0.00,0,0,0,0,0,0,0,0,0,0,0,0,0
20200520,057953,聚陽元大98購01,0.43,0.43,0.39,0.42,+0.02,5.0,193000,20,78400,0,0,0,0,0,0,0,165000,-165000,-165000
20200520,057954,宏碁元大99購01,,,,,0.00,0.00,0,0,0,0,0,0,0,0,0,0,0,0,0
20200520,057955,技嘉元大98購07,2.32,2.35,2.18,2.23,-0.04,-1.76,232000,17,531030,0,0,0,0,0,0,128000,136000,-8000,-8000
20200520,057956,全新元大99購04,,,,,0.00,0.00,0,0,0,0,0,0,0,0,0,0,0,0,0
20200520,057957,嘉晶元大98購01,4.93,6.35,4.93,6.10,+1.21,24.74,71000,12,388610,0,0,0,0,0,0,19000,52000,-33000,-33000
20200520,057958,禾伸堂元大99購05,2.17,2.24,2.12,2.24,+0.09,4.19,144000,9,315460,0,0,0,0,0,0,94000,72000,22000,22000
20200520,057959,欣興元大98購14,2.62,2.73,2.62,2.62,0.00,0.00,51000,4,135730,0,0,0,0,0,0,51000,6000,45000,45000
20200520,05795P,華邦電群益96售05,3.13,3.13,3.13,3.13,0.00,0.00,10000,1,31300,0,0,0,0,0,0,0,10000,-10000,-10000
20200520,057960,聯鈞元大98購02,0.83,0.83,0.83,0.83,-0.03,-3.49,68000,1,56440,0,0,0,0,0,0,0,68000,-68000,-68000
20200520,057961,茂林元大9A購01,1.32,1.58,1.32,1.58,+0.26,19.7,426000,26,626510,0,0,0,0,0,0,207000,296000,-89000,-89000
20200520,057962,超眾元大99購03,4.36,4.36,4.36,4.36,+0.04,0.93,9000,1,39240,0,0,0,0,0,0,0,9000,-9000,-9000
20200520,057963,緯穎元大98購08,4.31,4.58,4.31,4.31,-0.37,-7.91,126000,12,559820,0,0,0,0,0,0,48000,108000,-60000,-60000
20200520,057964,緯穎元大99購03,4.40,4.56,4.40,4.56,+0.05,1.11,77000,8,344550,0,0,0,0,0,0,46000,66000,-20000,-20000
20200520,057965,臺股指元大98購14,,,,,0.00,0.00,0,0,0,0,0,0,0,0,0,0,0,0,0
20200520,057966,金融類元大98購01,0.13,0.14,0.13,0.14,-0.01,-6.67,141000,2,18340,0,0,0,0,0,0,140000,1000,139000,139000
20200520,057967,聯發科國泰9A購02,4.22,4.53,4.18,4.25,+0.16,3.91,324000,23,1412770,0,0,0,0,0,0,313000,11000,302000,302000
20200520,057968,可成國泰9A購01,,,,,0.00,0.00,0,0,0,0,0,0,0,0,0,0,0,0,0
20200520,057969,緯穎國泰99購01,3.29,3.48,3.06,3.06,-0.43,-12.32,283000,45,949530,0,0,0,0,0,0,280000,3000,277000,277000
20200520,05796P,臺股指群益96售10,,,,,0.00,0.00,0,0,0,0,0,0,0,0,0,0,0,0,0
20200520,057970,國巨富邦99購03,0.57,0.57,0.57,0.57,0.00,0.00,10000,1,5700,0,0,0,0,0,0,0,10000,-10000,-10000
20200520,057971,華新科富邦9B購02,0.84,0.84,0.79,0.81,-0.01,-1.22,742000,39,603190,0,0,0,0,0,0,689000,13000,676000,676000
20200520,057972,群創富邦9C購01,0.87,0.90,0.87,0.89,+0.03,3.49,240000,10,212450,0,0,0,0,0,0,204000,36000,168000,168000
20200520,057973,神達富邦9A購01,0.57,0.62,0.57,0.62,+0.04,6.9,601000,14,359600,0,0,0,0,0,0,170000,431000,-261000,-261000
20200520,057974,上銀永豐98購02,,,,,0.00,0.00,0,0,0,0,0,0,0,0,0,0,0,0,0
20200520,057975,台積電永豐98購05,,,,,0.00,0.00,0,0,0,0,0,0,0,0,0,0,0,0,0
20200520,057976,旺宏永豐98購03,,,,,0.00,0.00,0,0,0,0,0,0,0,0,0,0,0,0,0
20200520,057977,台光電永豐98購02,1.33,1.33,1.33,1.33,0.00,0.00,7000,1,9310,0,0,0,0,0,0,0,7000,-7000,-7000
20200520,057978,聯發科永豐98購05,,,,,0.00,0.00,0,0,0,0,0,0,0,0,0,0,0,0,0
20200520,057979,華新科永豐98購03,,,,,0.00,0.00,0,0,0,0,0,0,0,0,0,0,0,0,0
20200520,05797P,臺股指群益96售11,,,,,0.00,0.00,0,0,0,0,0,0,0,0,0,0,0,0,0
20200520,057980,聯詠永豐98購01,1.23,1.27,1.22,1.27,+0.04,3.25,60000,3,73920,0,0,0,0,0,0,0,60000,-60000,-60000
20200520,057981,臻鼎永豐98購01,0.18,0.22,0.18,0.22,+0.04,22.22,75000,9,15600,0,0,0,0,0,0,5000,70000,-65000,-65000
20200520,057982,帆宣永豐98購01,,,,,0.00,0.00,0,0,0,0,0,0,0,0,0,0,0,0,0
20200520,057983,緯穎永豐98購03,2.01,2.01,1.76,1.76,-0.19,-9.74,19000,10,35810,0,0,0,0,0,0,0,19000,-19000,-19000
20200520,057984,聯發科台新98購01,,,,,0.00,0.00,0,0,0,0,0,0,0,0,0,0,0,0,0
20200520,057985,華通元富02購03,2.53,2.53,2.53,2.53,-0.04,-1.56,2000,1,5060,0,0,0,0,0,0,0,2000,-2000,-2000
20200520,057986,華新科元富99購05,,,,,0.00,0.00,0,0,0,0,0,0,0,0,0,0,0,0,0
20200520,057987,大立光元富98購02,0.84,0.93,0.84,0.86,+0.01,1.18,642000,31,575590,0,0,0,0,0,0,441000,191000,250000,250000
20200520,057988,鈺齊元富98購02,0.94,0.94,0.94,0.94,+0.02,2.17,10000,1,9400,0,0,0,0,0,0,10000,0,10000,10000
20200520,057989,旺宏統一99購04,,,,,0.00,0.00,0,0,0,0,0,0,0,0,0,0,0,0,0
20200520,05798P,臺股指群益96售12,,,,,0.00,0.00,0,0,0,0,0,0,0,0,0,0,0,0,0
20200520,057990,美律統一99購02,0.86,0.86,0.85,0.85,-0.01,-1.16,50000,2,42750,0,0,0,0,0,0,25000,25000,0,0
20200520,057991,健策統一9C購01,1.02,1.02,1.02,1.02,0.00,0.00,58000,2,59160,0,0,0,0,0,0,0,58000,-58000,-58000
20200520,057992,大立光日盛98購01,,,,,0.00,0.00,0,0,0,0,0,0,0,0,0,0,0,0,0
20200520,057993,中環中信98購01,,,,,0.00,0.00,0,0,0,0,0,0,0,0,0,0,0,0,0
20200520,057994,技嘉中信98購01,3.18,3.18,3.16,3.16,-0.09,-2.77,10000,2,31700,0,0,0,0,0,0,0,10000,-10000,-10000
20200520,057995,華新科中信98購02,0.35,0.38,0.35,0.35,0.00,0.00,106000,3,37400,0,0,0,0,0,0,96000,10000,86000,86000
20200520,057996,臻鼎中信98購01,1.49,1.67,1.49,1.67,+0.22,15.17,50000,5,76300,0,0,0,0,0,0,10000,20000,-10000,-10000
20200520,057997,旺宏第一9C購01,,,,,0.00,0.00,0,0,0,0,0,0,0,0,0,0,0,0,0
20200520,057998,玉晶光麥證9A購01,0.90,0.90,0.90,0.90,+0.02,2.27,10000,1,9000,10000,0,10000,0,0,0,10000,0,10000,10000
20200520,057999,智邦亞東99購02,,,,,0.00,0.00,0,0,0,0,0,0,0,0,0,0,0,0,0
20200520,05799P,臺股指群益96售13,,,,,0.00,0.00,0,0,0,0,0,0,0,0,0,0,0,0,0
20200520,058000,FBVIX群益9B購01,,,,,0.00,0.00,0,0,0,0,0,0,0,0,0,0,0,0,0
20200520,058001,FBVIX群益9B購02,,,,,0.00,0.00,0,0,0,0,0,0,0,0,0,0,0,0,0
20200520,058002,FBVIX群益9C購01,,,,,0.00,0.00,0,0,0,0,0,0,0,0,0,0,0,0,0
20200520,058003,FBVIX群益9C購02,,,,,0.00,0.00,0,0,0,0,0,0,0,0,0,0,0,0,0
20200520,058004,大立光群益98購03,1.09,1.17,1.09,1.14,+0.01,0.88,104000,8,118430,0,0,0,0,0,0,39000,65000,-26000,-26000
20200520,058005,茂林群益98購04,0.83,1.00,0.83,1.00,0.00,0.00,160000,13,142920,0,0,0,0,0,0,20000,140000,-120000,-120000
20200520,058006,台郡群益98購04,1.94,1.98,1.94,1.98,-0.03,-1.49,118000,3,232840,0,0,0,0,0,0,98000,20000,78000,78000
20200520,058007,南電群益98購02,2.14,2.14,1.91,1.92,-0.07,-3.52,69000,5,140340,0,0,0,0,0,0,37000,32000,5000,5000
20200520,058008,禾伸堂國票99購02,2.61,2.81,2.61,2.81,+0.21,8.08,29000,3,79510,0,0,0,0,0,0,9000,20000,-11000,-11000
20200520,058009,智易國票99購01,,,,,0.00,0.00,0,0,0,0,0,0,0,0,0,0,0,0,0
20200520,05800P,台積電兆豐96售04,,,,,0.00,0.00,0,0,0,0,0,0,0,0,0,0,0,0,0
20200520,058010,帆宣國票98購01,,,,,0.00,0.00,0,0,0,0,0,0,0,0,0,0,0,0,0
20200520,058011,台虹國票99購01,3.13,3.25,3.13,3.25,-0.03,-0.91,16000,2,51160,0,0,0,0,0,0,7000,9000,-2000,-2000
20200520,058012,鈺齊國票99購01,0.97,0.99,0.96,0.98,+0.05,5.38,401000,7,389290,0,0,0,0,0,0,145000,256000,-111000,-111000
20200520,058013,SP黃豆凱基9A購01,0.37,0.38,0.35,0.38,0.00,0.00,21000,3,7420,0,0,0,0,0,0,18000,0,18000,18000
20200520,058014,上銀凱基99購02,,,,,0.00,0.00,0,0,0,0,0,0,0,0,0,0,0,0,0
20200520,058015,旺宏凱基99購02,,,,,0.00,0.00,0,0,0,0,0,0,0,0,0,0,0,0,0
20200520,058016,智邦凱基98購06,4.74,4.98,4.74,4.83,-0.32,-6.21,18000,3,86640,0,0,0,0,0,0,10000,8000,2000,2000
20200520,058017,漢唐凱基99購01,2.04,2.04,2.04,2.04,0.00,0.00,200000,3,408000,0,0,0,0,0,0,0,200000,-200000,-200000
20200520,058018,南亞科凱基99購03,,,,,0.00,0.00,0,0,0,0,0,0,0,0,0,0,0,0,0
20200520,058019,美律凱基99購04,1.17,1.17,1.17,1.17,0.00,0.00,49000,1,57330,0,0,0,0,0,0,0,49000,-49000,-49000
20200520,05801P,正崴兆豐96售01,,,,,0.00,0.00,0,0,0,0,0,0,0,0,0,0,0,0,0
20200520,058020,大立光凱基99購03,,,,,0.00,0.00,0,0,0,0,0,0,0,0,0,0,0,0,0
20200520,058021,牧德凱基98購02,0.77,0.93,0.77,0.92,+0.17,22.67,364000,14,310470,0,0,0,0,0,0,57000,307000,-250000,-250000
20200520,058022,樺漢凱基99購02,2.12,2.16,2.12,2.16,+0.09,4.35,70000,3,150000,0,0,0,0,0,0,40000,30000,10000,10000
20200520,058023,南電凱基98購02,1.33,1.33,1.33,1.33,-0.13,-8.9,5000,1,6650,0,0,0,0,0,0,0,5000,-5000,-5000
20200520,058024,台積電國泰9A購01,,,,,0.00,0.00,0,0,0,0,0,0,0,0,0,0,0,0,0
20200520,058025,聯茂國泰99購01,1.40,1.40,1.33,1.37,-0.11,-7.43,195000,26,267750,0,0,0,0,0,0,145000,50000,95000,95000
20200520,058026,上銀富邦9A購01,1.32,1.33,1.32,1.33,-0.02,-1.48,20000,2,26480,0,0,0,0,0,0,12000,8000,4000,4000
20200520,058027,鴻海富邦98購04,,,,,0.00,0.00,0,0,0,0,0,0,0,0,0,0,0,0,0
20200520,058028,國巨富邦99購04,,,,,0.00,0.00,0,0,0,0,0,0,0,0,0,0,0,0,0
20200520,058029,台灣50永豐9A購01,,,,,0.00,0.00,0,0,0,0,0,0,0,0,0,0,0,0,0
20200520,05802P,臺股指兆豐96售02,,,,,0.00,0.00,0,0,0,0,0,0,0,0,0,0,0,0,0
20200520,058030,國巨永豐98購08,,,,,0.00,0.00,0,0,0,0,0,0,0,0,0,0,0,0,0
20200520,058031,旺宏永豐98購04,,,,,0.00,0.00,0,0,0,0,0,0,0,0,0,0,0,0,0
20200520,058032,大立光永豐98購05,1.36,1.36,1.36,1.36,0.00,0.00,68000,1,92480,0,0,0,0,0,0,68000,0,68000,68000
20200520,058033,景碩永豐98購02,,,,,0.00,0.00,0,0,0,0,0,0,0,0,0,0,0,0,0
20200520,058034,神達永豐98購02,,,,,0.00,0.00,0,0,0,0,0,0,0,0,0,0,0,0,0
20200520,058035,旭富永豐98購02,0.74,0.75,0.73,0.73,-0.02,-2.67,987000,19,732660,0,0,0,0,0,0,162000,825000,-663000,-663000
20200520,058036,南電永豐98購01,1.82,1.82,1.82,1.82,-0.05,-2.67,10000,1,18200,0,0,0,0,0,0,0,0,0,0
20200520,058037,台灣50元大9B購02,0.65,0.67,0.65,0.67,+0.02,3.08,11000,3,7170,0,0,0,0,0,0,0,0,0,0
20200520,058038,滬深反元大98購01,,,,,0.00,0.00,0,0,0,0,0,0,0,0,0,0,0,0,0
20200520,058039,元石油元大98購03,0.09,0.09,0.08,0.08,-0.02,-20.0,40000,3,3300,0,0,0,0,0,0,0,0,0,0
20200520,05803P,臺股指兆豐96售03,0.42,0.42,0.42,0.42,0.00,0.00,12000,2,5040,0,0,0,0,0,0,0,12000,-12000,-12000
20200520,058040,FBVIX元大98購01,,,,,0.00,0.00,0,0,0,0,0,0,0,0,0,0,0,0,0
20200520,058041,FBVIX元大98購02,,,,,0.00,0.00,0,0,0,0,0,0,0,0,0,0,0,0,0
20200520,058042,鴻海元大98購12,2.15,2.22,2.15,2.22,+0.04,1.83,53000,2,117450,0,0,0,0,0,0,53000,0,53000,53000
20200520,058043,鴻海元大98購13,1.90,1.90,1.90,1.90,-0.11,-5.47,50000,1,95000,0,0,0,0,0,0,0,50000,-50000,-50000
20200520,058044,鴻海元大99購07,,,,,0.00,0.00,0,0,0,0,0,0,0,0,0,0,0,0,0
20200520,058045,鴻海元大99購08,0.86,0.88,0.86,0.88,-0.02,-2.22,2000,2,1740,0,0,0,0,0,0,0,2000,-2000,-2000
20200520,058046,國巨元大9A購01,,,,,0.00,0.00,0,0,0,0,0,0,0,0,0,0,0,0,0
20200520,058047,可成元大98購11,0.86,0.86,0.85,0.85,-0.11,-11.46,111000,2,95030,0,0,0,0,0,0,43000,68000,-25000,-25000
20200520,058048,群創元大9B購07,0.83,0.84,0.82,0.84,+0.03,3.7,100000,6,83400,0,0,0,0,0,0,100000,0,100000,100000
20200520,058049,帆宣元大98購01,,,,,0.00,0.00,0,0,0,0,0,0,0,0,0,0,0,0,0
20200520,05804P,美律永豐96售01,,,,,0.00,0.00,0,0,0,0,0,0,0,0,0,0,0,0,0
20200520,058050,台郡元大99購05,1.00,1.04,0.98,0.99,0.00,0.00,209000,7,208980,0,0,0,0,0,0,68000,141000,-73000,-73000
20200520,058051,同欣電元大98購03,1.52,1.70,1.52,1.70,+0.16,10.39,103000,12,163690,0,0,0,0,0,0,89000,14000,75000,75000
20200520,058052,南電元大98購02,2.60,2.60,2.51,2.51,-0.16,-5.99,10000,2,25550,0,0,0,0,0,0,0,10000,-10000,-10000
20200520,058053,上銀統一9B購01,0.96,0.96,0.92,0.92,-0.03,-3.16,20000,2,19000,0,0,0,0,0,0,0,20000,-20000,-20000
20200520,058054,台積電統一9C購01,0.50,0.51,0.49,0.51,0.00,0.00,300000,7,149120,0,0,0,0,0,0,276000,24000,252000,252000
20200520,058055,華擎統一9A購01,0.87,0.98,0.87,0.98,+0.15,18.07,2500000,58,2342820,0,0,0,0,0,0,486000,2324000,-1838000,-1838000
20200520,058056,FBVIX元富98購01,,,,,0.00,0.00,0,0,0,0,0,0,0,0,0,0,0,0,0
20200520,058057,FBVIX元富98購02,,,,,0.00,0.00,0,0,0,0,0,0,0,0,0,0,0,0,0
20200520,058058,大立光元富9B購02,,,,,0.00,0.00,0,0,0,0,0,0,0,0,0,0,0,0,0
20200520,058059,晶技元富98購01,,,,,0.00,0.00,0,0,0,0,0,0,0,0,0,0,0,0,0
20200520,05805P,義隆永豐96售02,0.35,0.35,0.35,0.35,-0.05,-12.5,30000,1,10500,0,0,0,0,0,0,30000,0,30000,30000
20200520,058060,貿聯元富98購01,0.72,0.72,0.71,0.71,+0.01,1.43,36000,2,25740,0,0,0,0,0,0,36000,0,36000,36000
20200520,058061,貿聯元富9B購01,2.27,2.27,2.12,2.12,-0.04,-1.85,202000,28,447620,0,0,0,0,0,0,158000,44000,114000,114000
20200520,058062,上銀中信98購01,,,,,0.00,0.00,0,0,0,0,0,0,0,0,0,0,0,0,0
20200520,058063,旺宏中信98購04,,,,,0.00,0.00,0,0,0,0,0,0,0,0,0,0,0,0,0
20200520,058064,華邦電亞東99購01,,,,,0.00,0.00,0,0,0,0,0,0,0,0,0,0,0,0,0
20200520,058065,南亞科亞東99購01,,,,,0.00,0.00,0,0,0,0,0,0,0,0,0,0,0,0,0
20200520,058066,可成亞東99購01,,,,,0.00,0.00,0,0,0,0,0,0,0,0,0,0,0,0,0
20200520,058067,台積電第一9C購01,,,,,0.00,0.00,0,0,0,0,0,0,0,0,0,0,0,0,0
20200520,058068,旺宏凱基98購11,,,,,0.00,0.00,0,0,0,0,0,0,0,0,0,0,0,0,0
20200520,058069,美律凱基99購05,,,,,0.00,0.00,0,0,0,0,0,0,0,0,0,0,0,0,0
20200520,05806P,宏達電永豐96售03,,,,,0.00,0.00,0,0,0,0,0,0,0,0,0,0,0,0,0
20200520,058070,華新科凱基98購07,1.19,1.19,1.19,1.19,+0.09,8.18,8000,1,9520,0,0,0,0,0,0,8000,0,8000,8000
20200520,058071,大立光凱基98購19,,,,,0.00,0.00,0,0,0,0,0,0,0,0,0,0,0,0,0
20200520,058072,大立光凱基98購20,,,,,0.00,0.00,0,0,0,0,0,0,0,0,0,0,0,0,0
20200520,058073,大立光凱基99購04,,,,,0.00,0.00,0,0,0,0,0,0,0,0,0,0,0,0,0
20200520,058074,欣興凱基99購01,,,,,0.00,0.00,0,0,0,0,0,0,0,0,0,0,0,0,0
20200520,058075,貿聯凱基99購02,,,,,0.00,0.00,0,0,0,0,0,0,0,0,0,0,0,0,0
20200520,058076,神達凱基98購02,0.51,0.51,0.51,0.51,0.00,0.00,50000,1,25500,0,0,0,0,0,0,0,50000,-50000,-50000
20200520,058077,超眾凱基98購02,2.05,2.13,2.05,2.13,+0.09,4.41,100000,3,210600,0,0,0,0,0,0,41000,70000,-29000,-29000
20200520,058078,景碩國票99購01,,,,,0.00,0.00,0,0,0,0,0,0,0,0,0,0,0,0,0
20200520,058079,鴻海群益98購08,2.12,2.17,2.06,2.07,-0.09,-4.17,125000,10,265240,0,0,0,0,0,0,13000,115000,-102000,-102000
20200520,05807P,泰鼎永豐96售03,,,,,0.00,0.00,0,0,0,0,0,0,0,0,0,0,0,0,0
20200520,058080,台積電群益98購06,3.67,3.67,3.55,3.55,-0.09,-2.47,43000,8,155110,0,0,0,0,0,0,27000,23000,4000,4000
20200520,058081,技嘉群益9A購03,,,,,0.00,0.00,0,0,0,0,0,0,0,0,0,0,0,0,0
20200520,058082,美律群益98購05,,,,,0.00,0.00,0,0,0,0,0,0,0,0,0,0,0,0,0
20200520,058083,聯發科群益98購08,8.15,8.15,8.15,8.15,+0.90,12.41,5000,1,40750,0,0,0,0,0,0,5000,0,5000,5000
20200520,058084,大立光群益98購04,,,,,0.00,0.00,0,0,0,0,0,0,0,0,0,0,0,0,0
20200520,058085,景碩群益9A購01,2.41,2.41,2.20,2.20,-0.20,-8.33,28000,4,66120,0,0,0,0,0,0,21000,7000,14000,14000
20200520,058086,鴻海元大98購14,2.68,2.68,2.67,2.67,-0.19,-6.64,113000,4,301740,0,0,0,0,0,0,113000,0,113000,113000
20200520,058087,鴻海元大98購15,,,,,0.00,0.00,0,0,0,0,0,0,0,0,0,0,0,0,0
20200520,058088,鴻海元大9A購01,1.18,1.18,1.14,1.14,0.00,0.00,11000,2,12580,0,0,0,0,0,0,0,11000,-11000,-11000
20200520,058089,聯發科元大98購15,5.95,6.45,5.90,6.45,+0.25,4.03,11000,3,65900,0,0,0,0,0,0,11000,0,11000,11000
20200520,05808P,臺股指國票96售01,,,,,0.00,0.00,0,0,0,0,0,0,0,0,0,0,0,0,0
20200520,058090,聯發科元大98購16,4.71,4.95,4.71,4.95,+0.41,9.03,10000,2,48300,0,0,0,0,0,0,10000,0,10000,10000
20200520,058091,欣興元大99購03,2.37,2.48,2.28,2.28,+0.01,0.44,183000,11,431030,0,0,0,0,0,0,152000,31000,121000,121000
20200520,058092,牧德元大98購02,,,,,0.00,0.00,0,0,0,0,0,0,0,0,0,0,0,0,0
20200520,058093,神達元大9A購01,2.03,2.24,2.03,2.17,+0.12,5.85,1219000,36,2595410,0,0,0,0,0,0,500000,719000,-219000,-219000
20200520,058094,祥碩元大98購09,3.40,3.40,3.40,3.40,+0.22,6.92,2000,2,6800,0,0,0,0,0,0,2000,0,2000,2000
20200520,058095,昇陽半元大98購03,,,,,0.00,0.00,0,0,0,0,0,0,0,0,0,0,0,0,0
20200520,058096,南電元大98購04,2.80,2.80,2.48,2.48,-0.26,-9.49,128000,6,349600,0,0,0,0,0,0,30000,98000,-68000,-68000
20200520,058097,台灣50國泰99購01,,,,,0.00,0.00,0,0,0,0,0,0,0,0,0,0,0,0,0
20200520,058098,T50反1國泰9A購02,,,,,0.00,0.00,0,0,0,0,0,0,0,0,0,0,0,0,0
20200520,058099,鴻海國泰9A購02,0.38,0.38,0.38,0.38,+0.01,2.7,2000,1,760,0,0,0,0,0,0,2000,0,2000,2000
20200520,05809P,臺股指國票96售02,6.00,6.00,5.95,5.95,0.00,0.00,100000,3,597500,0,0,0,0,0,0,0,100000,-100000,-100000
20200520,058100,聯茂國泰99購02,0.95,0.96,0.92,0.92,-0.09,-8.91,242000,24,224800,0,0,0,0,0,0,242000,0,242000,242000
20200520,058101,台積電富邦9C購01,,,,,0.00,0.00,0,0,0,0,0,0,0,0,0,0,0,0,0
20200520,058102,楠梓電永豐98購04,0.53,0.53,0.50,0.50,0.00,0.00,258000,4,134220,0,0,0,0,0,0,84000,258000,-174000,-174000
20200520,058103,台積電永豐98購06,,,,,0.00,0.00,0,0,0,0,0,0,0,0,0,0,0,0,0
20200520,058104,國巨統一9A購04,0.33,0.33,0.28,0.29,+0.03,11.54,249000,5,74220,0,0,0,0,0,0,59000,190000,-131000,-131000
20200520,058105,旺宏統一9A購02,1.13,1.13,1.10,1.10,0.00,0.00,9000,2,10050,0,0,0,0,0,0,5000,4000,1000,1000
20200520,058106,神達統一98購02,0.32,0.34,0.32,0.34,0.00,0.00,277000,4,93180,0,0,0,0,0,0,0,277000,-277000,-277000
20200520,058107,全新台新99購01,,,,,0.00,0.00,0,0,0,0,0,0,0,0,0,0,0,0,0
20200520,058108,台郡台新99購01,0.97,0.97,0.97,0.97,+0.01,1.04,131000,2,127070,0,0,0,0,0,0,100000,31000,69000,69000
20200520,058109,台灣50元富9B購01,,,,,0.00,0.00,0,0,0,0,0,0,0,0,0,0,0,0,0
20200520,05810P,臺股指國票96售03,,,,,0.00,0.00,0,0,0,0,0,0,0,0,0,0,0,0,0
20200520,058110,光寶科元富98購01,2.24,2.24,2.24,2.24,+0.04,1.82,30000,3,67200,0,0,0,0,0,0,30000,0,30000,30000
20200520,058111,健鼎元富98購01,1.78,1.78,1.78,1.78,0.00,0.00,1000,1,1780,0,0,0,0,0,0,1000,0,1000,1000
20200520,058112,神達元富98購01,,,,,0.00,0.00,0,0,0,0,0,0,0,0,0,0,0,0,0
20200520,058113,百和元富98購01,0.84,0.86,0.76,0.85,+0.02,2.41,672000,19,529730,0,0,0,0,0,0,424000,238000,186000,186000
20200520,058114,台積電第一01購01,,,,,0.00,0.00,0,0,0,0,0,0,0,0,0,0,0,0,0
20200520,058115,台光電中信99購01,3.14,3.14,3.14,3.14,-0.03,-0.95,3000,1,9420,0,0,0,0,0,0,0,3000,-3000,-3000
20200520,058116,正崴中信99購02,1.42,1.42,1.42,1.42,0.00,0.00,59000,2,83780,0,0,0,0,0,0,0,59000,-59000,-59000
20200520,058117,元石油群益9B購02,,,,,0.00,0.00,0,0,0,0,0,0,0,0,0,0,0,0,0
20200520,058118,瑞昱群益99購01,5.95,6.25,5.80,5.80,-0.95,-14.07,123000,12,746900,0,0,0,0,0,0,123000,0,123000,123000
20200520,058119,華新亞東99購01,,,,,0.00,0.00,0,0,0,0,0,0,0,0,0,0,0,0,0
20200520,05811P,臺股指國票96售04,,,,,0.00,0.00,0,0,0,0,0,0,0,0,0,0,0,0,0
20200520,058120,台灣50國票99購03,,,,,0.00,0.00,0,0,0,0,0,0,0,0,0,0,0,0,0
20200520,058121,國巨國票9A購01,0.60,0.60,0.60,0.60,0.00,0.00,1000,1,600,0,0,0,0,0,0,0,0,0,0
20200520,058122,美律國票9A購01,1.67,1.67,1.65,1.65,-0.05,-2.94,29000,2,48130,0,0,0,0,0,0,14000,15000,-1000,-1000
20200520,058123,亞光國票9A購01,0.78,0.78,0.78,0.78,-0.03,-3.7,81000,2,63180,0,0,0,0,0,0,43000,38000,5000,5000
20200520,058124,玉晶光國票9A購01,,,,,0.00,0.00,0,0,0,0,0,0,0,0,0,0,0,0,0
20200520,058125,元油2X元大9C購01,0.09,0.09,0.08,0.08,-0.01,-11.11,50000,3,4100,0,0,0,0,0,0,0,40000,-40000,-40000
20200520,058126,元油2X元大9C購02,,,,,0.00,0.00,0,0,0,0,0,0,0,0,0,0,0,0,0
20200520,058127,FBVIX元大9C購01,,,,,0.00,0.00,0,0,0,0,0,0,0,0,0,0,0,0,0
20200520,058128,FBVIX元大9C購02,,,,,0.00,0.00,0,0,0,0,0,0,0,0,0,0,0,0,0
20200520,058129,國巨元大99購10,1.45,1.61,1.42,1.45,+0.13,9.85,462000,23,701150,0,0,0,0,0,0,78000,384000,-306000,-306000
20200520,05812P,臺股指國票96售05,,,,,0.00,0.00,0,0,0,0,0,0,0,0,0,0,0,0,0
20200520,058130,瑞昱元大99購01,2.93,2.93,2.93,2.93,-0.24,-7.57,6000,1,17580,0,0,0,0,0,0,6000,6000,0,0
20200520,058131,義隆元大99購02,1.22,1.28,1.18,1.27,+0.03,2.42,341000,13,423220,0,0,0,0,0,0,125000,216000,-91000,-91000
20200520,058132,義隆元大99購03,1.23,1.29,1.23,1.27,+0.02,1.6,517000,15,656550,0,0,0,0,0,0,343000,178000,165000,165000
20200520,058133,華新科元大9A購02,0.51,0.51,0.51,0.51,0.00,0.00,2000,1,1020,0,0,0,0,0,0,0,2000,-2000,-2000
20200520,058134,信邦元大99購01,1.94,2.05,1.86,1.86,+0.01,0.54,272000,20,537750,20000,0,20000,0,0,0,224000,98000,126000,146000
20200520,058135,景碩元大99購01,2.19,2.19,2.17,2.18,+0.04,1.87,33000,4,71910,0,0,0,0,0,0,23000,10000,13000,13000
20200520,058136,景碩元大99購02,1.96,1.97,1.96,1.96,-0.10,-4.85,78000,4,152980,0,0,0,0,0,0,10000,68000,-58000,-58000
20200520,058137,玉晶光元大99購11,0.83,0.84,0.83,0.84,+0.06,7.69,241000,2,200040,0,0,0,0,0,0,240000,1000,239000,239000
20200520,058138,晶相光元大9C購01,,,,,0.00,0.00,0,0,0,0,0,0,0,0,0,0,0,0,0
20200520,058139,臻鼎元大99購01,1.02,1.13,1.00,1.13,+0.13,13.0,485000,18,523410,0,0,0,0,0,0,126000,344000,-218000,-218000
20200520,05813P,臺股指國票96售06,7.55,8.00,7.35,8.00,-0.10,-1.23,18000,3,135100,0,0,0,0,0,0,17000,1000,16000,16000
20200520,058140,臻鼎元大99購02,1.17,1.28,1.16,1.27,+0.10,8.55,425000,14,522810,0,0,0,0,0,0,135000,290000,-155000,-155000
20200520,058141,嘉聯益元大99購05,0.61,0.63,0.61,0.63,+0.02,3.28,197000,3,122910,0,0,0,0,0,0,197000,0,197000,197000
20200520,058142,瑞儀元大99購01,1.48,1.57,1.47,1.55,+0.08,5.44,790000,33,1218740,0,0,0,0,0,0,50000,740000,-690000,-690000
20200520,058143,瑞儀元大99購02,1.27,1.36,1.26,1.34,+0.02,1.52,858000,18,1115720,0,0,0,0,0,0,300000,558000,-258000,-258000
20200520,058144,聯茂元大99購02,0.72,0.72,0.69,0.71,-0.04,-5.33,137000,8,96180,0,0,0,0,0,0,78000,59000,19000,19000
20200520,058145,聯茂元大99購03,0.75,0.75,0.70,0.70,-0.04,-5.41,349000,13,255600,0,0,0,0,0,0,199000,150000,49000,49000
20200520,058146,勤誠元大99購01,1.45,1.45,1.41,1.41,-0.04,-2.76,136000,11,194360,0,0,0,0,0,0,91000,45000,46000,46000
20200520,058147,鈺齊元大99購01,,,,,0.00,0.00,0,0,0,0,0,0,0,0,0,0,0,0,0
20200520,058148,百和元大99購01,1.66,1.67,1.55,1.67,+0.07,4.38,667000,28,1071550,0,0,0,0,0,0,509000,148000,361000,361000
20200520,058149,百和元大99購02,1.40,1.43,1.33,1.37,-0.01,-0.72,664000,39,917670,0,0,0,0,0,0,462000,187000,275000,275000
20200520,05814P,臺股指國票96售07,,,,,0.00,0.00,0,0,0,0,0,0,0,0,0,0,0,0,0
20200520,058150,中502X統一9B購01,,,,,0.00,0.00,0,0,0,0,0,0,0,0,0,0,0,0,0
20200520,058151,台積電統一9A購04,0.74,0.74,0.74,0.74,0.00,0.00,5000,1,3700,0,0,0,0,0,0,0,5000,-5000,-5000
20200520,058152,聯發科統一9B購02,3.02,3.02,3.02,3.02,+0.10,3.42,43000,1,129860,0,0,0,0,0,0,43000,0,43000,43000
20200520,058153,景碩統一9B購01,0.83,0.84,0.83,0.84,+0.02,2.44,61000,2,50740,0,0,0,0,0,0,61000,0,61000,61000
20200520,058154,泰碩統一9A購01,1.33,1.33,1.27,1.27,-0.11,-7.97,219000,7,288320,0,0,0,0,0,0,120000,123000,-3000,-3000
20200520,058155,牧德統一9A購01,,,,,0.00,0.00,0,0,0,0,0,0,0,0,0,0,0,0,0
20200520,058156,超眾統一9A購02,0.72,0.75,0.71,0.75,+0.02,2.74,381000,6,280450,0,0,0,0,0,0,68000,313000,-245000,-245000
20200520,058157,華通台新99購01,,,,,0.00,0.00,0,0,0,0,0,0,0,0,0,0,0,0,0
20200520,058158,台積電台新99購01,0.37,0.37,0.34,0.36,-0.03,-7.69,307000,35,107170,0,0,0,0,0,0,302000,305000,-3000,-3000
20200520,058159,健策台新9A購01,1.20,1.22,1.20,1.22,+0.07,6.09,8000,3,9640,0,0,0,0,0,0,4000,4000,0,0
20200520,05815P,台積電凱基97售06,,,,,0.00,0.00,0,0,0,0,0,0,0,0,0,0,0,0,0
20200520,058160,奇鋐元富99購01,3.99,4.09,3.99,4.08,+0.04,0.99,125000,9,505910,0,0,0,0,0,0,0,125000,-125000,-125000
20200520,058161,T50反1日盛03購01,0.80,0.80,0.74,0.74,-0.16,-17.78,8000,4,6000,0,0,0,0,0,0,5000,0,5000,5000
20200520,058162,上銀日盛9B購01,,,,,0.00,0.00,0,0,0,0,0,0,0,0,0,0,0,0,0
20200520,058163,道瓊反凱基9B購01,,,,,0.00,0.00,0,0,0,0,0,0,0,0,0,0,0,0,0
20200520,058164,FBVIX凱基03購02,,,,,0.00,0.00,0,0,0,0,0,0,0,0,0,0,0,0,0
20200520,058165,FBVIX凱基9C購01,,,,,0.00,0.00,0,0,0,0,0,0,0,0,0,0,0,0,0
20200520,058166,鴻海凱基9A購01,2.52,2.52,2.52,2.52,0.00,0.00,10000,1,25200,0,0,0,0,0,0,0,10000,-10000,-10000
20200520,058167,鴻海凱基9A購03,3.59,3.59,3.59,3.59,-0.08,-2.18,10000,1,35900,0,0,0,0,0,0,0,10000,-10000,-10000
20200520,058168,國巨凱基9A購04,,,,,0.00,0.00,0,0,0,0,0,0,0,0,0,0,0,0,0
20200520,058169,國巨凱基9A購05,,,,,0.00,0.00,0,0,0,0,0,0,0,0,0,0,0,0,0
20200520,05816P,台積電凱基97售07,,,,,0.00,0.00,0,0,0,0,0,0,0,0,0,0,0,0,0
20200520,058170,國巨凱基9A購06,0.81,0.81,0.78,0.79,+0.07,9.72,310000,4,245800,0,0,0,0,0,0,0,310000,-310000,-310000
20200520,058171,國巨凱基9A購07,,,,,0.00,0.00,0,0,0,0,0,0,0,0,0,0,0,0,0
20200520,058172,國巨凱基9B購02,,,,,0.00,0.00,0,0,0,0,0,0,0,0,0,0,0,0,0
20200520,058173,台積電凱基99購04,,,,,0.00,0.00,0,0,0,0,0,0,0,0,0,0,0,0,0
20200520,058174,台積電凱基9A購05,1.32,1.32,1.32,1.32,0.00,0.00,3000,1,3960,0,0,0,0,0,0,0,3000,-3000,-3000
20200520,058175,旺宏凱基99購03,,,,,0.00,0.00,0,0,0,0,0,0,0,0,0,0,0,0,0
20200520,058176,聯發科凱基99購05,5.25,5.25,5.25,5.25,+0.05,0.96,10000,1,52500,0,0,0,0,0,0,10000,0,10000,10000
20200520,058177,華新科凱基99購02,,,,,0.00,0.00,0,0,0,0,0,0,0,0,0,0,0,0,0
20200520,058178,國巨國泰9A購02,,,,,0.00,0.00,0,0,0,0,0,0,0,0,0,0,0,0,0
20200520,058179,國巨國泰9B購02,,,,,0.00,0.00,0,0,0,0,0,0,0,0,0,0,0,0,0
20200520,05817P,可成凱基96售07,1.67,1.75,1.67,1.75,+0.15,9.37,154000,7,266820,0,0,0,0,0,0,54000,100000,-46000,-46000
20200520,058180,華新科國泰9A購01,0.86,0.90,0.83,0.84,-0.04,-4.55,662000,31,574530,0,0,0,0,0,0,475000,157000,318000,318000
20200520,058181,華新科國泰9B購01,,,,,0.00,0.00,0,0,0,0,0,0,0,0,0,0,0,0,0
20200520,058182,日電貿國泰9A購01,1.95,1.95,1.95,1.95,0.00,0.00,56000,2,109200,0,0,0,0,0,0,0,56000,-56000,-56000
20200520,058183,國巨富邦9A購06,0.12,0.14,0.12,0.12,0.00,0.00,303000,8,38210,0,0,0,0,0,0,8000,295000,-287000,-287000
20200520,058184,鴻海永豐99購01,0.44,0.44,0.42,0.43,-0.02,-4.44,30000,5,12900,0,0,0,0,0,0,2000,28000,-26000,-26000
20200520,058185,國巨永豐99購01,0.44,0.46,0.41,0.43,+0.07,19.44,379000,7,164340,0,0,0,0,0,0,299000,80000,219000,219000
20200520,058186,聯發科永豐99購01,,,,,0.00,0.00,0,0,0,0,0,0,0,0,0,0,0,0,0
20200520,058187,泰碩永豐99購01,2.08,2.08,1.96,1.96,-0.20,-9.26,49000,3,100240,0,0,0,0,0,0,33000,16000,17000,17000
20200520,058188,華擎永豐99購01,0.68,0.80,0.68,0.78,+0.14,21.88,338000,16,258420,0,0,0,0,0,0,142000,216000,-74000,-74000
20200520,058189,嘉澤永豐99購01,2.84,2.84,2.71,2.74,-0.02,-0.72,103000,15,284760,20000,0,20000,0,0,0,8000,95000,-87000,-67000
20200520,05818P,大立光凱基96售14,,,,,0.00,0.00,0,0,0,0,0,0,0,0,0,0,0,0,0
20200520,058190,貿聯永豐99購01,0.87,0.90,0.87,0.90,-0.04,-4.26,84000,4,74660,0,0,0,0,0,0,84000,0,84000,84000
20200520,058191,祥碩永豐99購01,2.96,3.35,2.96,3.35,+0.62,22.71,50000,10,155290,0,0,0,0,0,0,6000,34000,-28000,-28000
20200520,058192,訊芯永豐99購01,0.39,0.40,0.39,0.40,0.00,0.00,68000,7,26600,0,0,0,0,0,0,68000,0,68000,68000
20200520,058193,緯穎永豐99購01,3.15,3.18,3.15,3.18,+0.20,6.71,15000,3,47400,0,0,0,0,0,0,0,15000,-15000,-15000
20200520,058194,勤誠永豐99購01,,,,,0.00,0.00,0,0,0,0,0,0,0,0,0,0,0,0,0
20200520,058195,鈺齊永豐99購01,,,,,0.00,0.00,0,0,0,0,0,0,0,0,0,0,0,0,0
20200520,058196,台塑中信99購01,0.78,0.78,0.69,0.73,-0.05,-6.41,1745000,38,1307870,0,0,0,0,0,0,1343000,352000,991000,991000
20200520,058197,國巨中信99購02,0.30,0.30,0.28,0.28,+0.05,21.74,186000,10,53080,0,0,0,0,0,0,0,186000,-186000,-186000
20200520,058198,瑞昱亞東99購01,2.79,2.79,2.79,2.79,-0.04,-1.41,18000,8,50220,0,0,0,0,0,0,18000,0,18000,18000
20200520,058199,國巨康和99購01,,,,,0.00,0.00,0,0,0,0,0,0,0,0,0,0,0,0,0
20200520,05819P,臺股指凱基96售16,,,,,0.00,0.00,0,0,0,0,0,0,0,0,0,0,0,0,0
20200520,058200,世芯康和99購01,1.50,1.61,1.38,1.39,-0.17,-10.9,2399000,219,3584600,10000,0,10000,0,0,0,1221000,1138000,83000,93000
20200520,058201,華通凱基9A購01,1.74,1.74,1.66,1.68,-0.07,-4.0,18000,5,30930,0,0,0,0,0,0,5000,13000,-8000,-8000
20200520,058202,鴻海凱基9A購04,,,,,0.00,0.00,0,0,0,0,0,0,0,0,0,0,0,0,0
20200520,058203,信邦凱基99購01,1.55,1.66,1.52,1.52,0.00,0.00,126000,12,201790,0,0,0,0,0,0,88000,48000,40000,40000
20200520,058204,世芯凱基9A購01,3.53,3.69,3.26,3.26,-0.42,-11.41,197000,38,696790,0,0,0,0,0,0,134000,63000,71000,71000
20200520,058205,神達凱基9B購01,0.45,0.45,0.45,0.45,0.00,0.00,2000,1,900,0,0,0,0,0,0,0,0,0,0
20200520,058206,祥碩凱基99購01,4.59,4.80,4.59,4.80,+0.21,4.58,11000,3,52380,0,0,0,0,0,0,4000,7000,-3000,-3000
20200520,058207,南茂凱基99購01,0.88,0.92,0.88,0.92,+0.05,5.75,59000,3,51980,0,0,0,0,0,0,59000,0,59000,59000
20200520,058208,百和凱基99購01,1.86,2.03,1.84,1.99,+0.12,6.42,283000,26,537890,0,0,0,0,0,0,213000,87000,126000,126000
20200520,058209,臺股指凱基01購01,0.51,0.54,0.51,0.54,0.00,0.00,43000,4,22770,0,0,0,0,0,0,0,0,0,0
20200520,05820P,臺股指凱基96售17,,,,,0.00,0.00,0,0,0,0,0,0,0,0,0,0,0,0,0
20200520,058210,臺股指凱基9C購04,0.76,0.79,0.73,0.75,+0.02,2.74,254000,10,195130,0,0,0,0,0,0,247000,0,247000,247000
20200520,058211,國巨群益9A購02,,,,,0.00,0.00,0,0,0,0,0,0,0,0,0,0,0,0,0
20200520,058212,華新科群益9A購01,1.25,1.34,1.20,1.22,-0.06,-4.69,365000,16,460450,0,0,0,0,0,0,350000,22000,328000,328000
20200520,058213,欣興群益99購01,1.89,1.90,1.86,1.86,-0.04,-2.11,59000,5,111530,0,0,0,0,0,0,39000,28000,11000,11000
20200520,058214,世芯群益9A購01,4.83,4.83,4.77,4.79,-0.31,-6.08,11000,3,52610,0,0,0,0,0,0,10000,1000,9000,9000
20200520,058215,貿聯群益99購02,1.48,1.48,1.40,1.45,+0.03,2.11,276000,16,396600,0,0,0,0,0,0,213000,63000,150000,150000
20200520,058216,TPK群益99購01,1.61,1.66,1.60,1.60,0.00,0.00,459000,8,747370,0,0,0,0,0,0,267000,283000,-16000,-16000
20200520,058217,新唐群益99購01,0.60,0.60,0.56,0.59,+0.04,7.27,108000,5,64670,0,0,0,0,0,0,0,108000,-108000,-108000
20200520,058218,緯穎群益99購01,5.45,5.45,5.05,5.10,-0.55,-9.73,18000,4,93400,0,0,0,0,0,0,18000,15000,3000,3000
20200520,058219,台灣50國票9A購02,,,,,0.00,0.00,0,0,0,0,0,0,0,0,0,0,0,0,0
20200520,05821P,臺股指凱基96售18,,,,,0.00,0.00,0,0,0,0,0,0,0,0,0,0,0,0,0
20200520,058220,世芯國票9A購01,6.25,6.25,5.70,5.70,-0.30,-5.0,4000,4,23800,0,0,0,0,0,0,0,4000,-4000,-4000
20200520,058221,上銀統一99購04,,,,,0.00,0.00,0,0,0,0,0,0,0,0,0,0,0,0,0
20200520,058222,玉晶光統一9B購01,0.56,0.60,0.56,0.60,+0.05,9.09,260000,3,153600,0,0,0,0,0,0,0,260000,-260000,-260000
20200520,058223,世芯統一9B購01,3.69,3.69,3.54,3.54,-0.27,-7.09,50000,5,181400,0,0,0,0,0,0,0,50000,-50000,-50000
20200520,058224,世芯統一9B購02,2.50,2.50,2.50,2.50,-0.25,-9.09,11000,2,27500,0,0,0,0,0,0,0,0,0,0
20200520,058225,旺宏元富99購01,2.53,2.53,2.44,2.44,-0.01,-0.41,70000,6,175900,0,0,0,0,0,0,60000,10000,50000,50000
20200520,058226,世芯元富99購01,,,,,0.00,0.00,0,0,0,0,0,0,0,0,0,0,0,0,0
20200520,058227,台灣50元大9C購01,1.14,1.14,1.14,1.14,-0.01,-0.87,1000,1,1140,0,0,0,0,0,0,1000,0,1000,1000
20200520,058228,為升元大99購01,0.31,0.37,0.31,0.37,-0.02,-5.13,11000,2,3470,0,0,0,0,0,0,0,0,0,0
20200520,058229,為升元大99購02,1.03,1.03,0.90,0.90,-0.12,-11.76,65000,5,61630,0,0,0,0,0,0,65000,0,65000,65000
20200520,05822P,臺股指凱基96售19,,,,,0.00,0.00,0,0,0,0,0,0,0,0,0,0,0,0,0
20200520,058230,國巨元大99購11,2.19,2.19,2.13,2.13,+0.08,3.9,79000,3,172770,0,0,0,0,0,0,75000,4000,71000,71000
20200520,058231,技嘉元大99購02,4.38,4.40,4.38,4.40,-0.13,-2.87,13000,3,57000,0,0,0,0,0,0,13000,13000,0,0
20200520,058232,聯發科元大99購05,7.75,7.75,7.75,7.75,+0.10,1.31,15000,2,116250,0,0,0,0,0,0,15000,0,15000,15000
20200520,058233,聯發科元大99購06,7.75,7.75,7.75,7.75,0.00,0.00,5000,1,38750,0,0,0,0,0,0,5000,0,5000,5000
20200520,058234,華新科元大99購12,,,,,0.00,0.00,0,0,0,0,0,0,0,0,0,0,0,0,0
20200520,058235,大立光元大99購08,,,,,0.00,0.00,0,0,0,0,0,0,0,0,0,0,0,0,0
20200520,058236,大立光元大99購09,,,,,0.00,0.00,0,0,0,0,0,0,0,0,0,0,0,0,0
20200520,058237,嘉晶元大99購04,4.23,5.20,4.21,5.20,+0.83,18.99,208000,33,943160,0,0,0,0,0,0,97000,160000,-63000,-63000
20200520,058238,奇鋐元大99購02,4.25,4.38,4.25,4.38,0.00,0.00,57000,12,245900,0,0,0,0,0,0,0,57000,-57000,-57000
20200520,058239,景碩元大99購03,2.19,2.19,2.17,2.18,-0.02,-0.91,56000,6,122140,0,0,0,0,0,0,56000,0,56000,56000
20200520,05823P,臺股指凱基96售20,,,,,0.00,0.00,0,0,0,0,0,0,0,0,0,0,0,0,0
20200520,058240,景碩元大99購04,2.47,2.47,2.47,2.47,0.00,0.00,60000,2,148200,0,0,0,0,0,0,60000,0,60000,60000
20200520,058241,景碩元大99購05,2.23,2.23,2.01,2.01,-0.22,-9.87,86000,9,184210,0,0,0,0,0,0,56000,30000,26000,26000
20200520,058242,玉晶光元大9A購01,0.86,0.86,0.86,0.86,0.00,0.00,1000,1,860,0,0,0,0,0,0,0,1000,-1000,-1000
20200520,058243,華擎元大99購01,1.37,1.53,1.37,1.53,+0.23,17.69,744000,45,1090860,0,0,0,0,0,0,528000,638000,-110000,-110000
20200520,058244,神達元大99購02,1.37,1.53,1.36,1.53,+0.16,11.68,331000,14,465810,0,0,0,0,0,0,83000,248000,-165000,-165000
20200520,058245,訊連元大99購01,1.22,1.24,1.15,1.15,-0.06,-4.96,1116000,32,1327380,0,0,0,0,0,0,975000,139000,836000,836000
20200520,058246,帆宣元大99購01,0.73,0.73,0.73,0.73,+0.02,2.82,4000,1,2920,0,0,0,0,0,0,0,0,0,0
20200520,058247,聯茂元大99購04,1.10,1.10,1.04,1.08,-0.05,-4.42,210000,9,226100,0,0,0,0,0,0,210000,0,210000,210000
20200520,058248,聯茂元大99購05,1.07,1.07,1.03,1.03,+0.02,1.98,69000,8,71980,0,0,0,0,0,0,68000,1000,67000,67000
20200520,058249,緯穎元大99購04,5.20,5.35,5.20,5.35,+0.10,1.9,60000,4,318500,0,0,0,0,0,0,60000,0,60000,60000
20200520,05824P,臺股指凱基96售21,,,,,0.00,0.00,0,0,0,0,0,0,0,0,0,0,0,0,0
20200520,058250,台虹元大99購01,2.63,2.63,2.63,2.63,-0.04,-1.5,88000,3,231440,0,0,0,0,0,0,13000,75000,-62000,-62000
20200520,058251,百和元大99購03,1.22,1.22,1.16,1.18,-0.01,-0.84,317000,12,376870,0,0,0,0,0,0,249000,68000,181000,181000
20200520,058252,臺股指元大9A購16,,,,,0.00,0.00,0,0,0,0,0,0,0,0,0,0,0,0,0
20200520,058253,臺股指元大9A購17,0.70,0.70,0.66,0.67,0.00,0.00,39000,4,26110,0,0,0,0,0,0,33000,0,33000,33000
20200520,058254,臺股指元大9A購18,,,,,0.00,0.00,0,0,0,0,0,0,0,0,0,0,0,0,0
20200520,058255,臺股指元大9A購19,,,,,0.00,0.00,0,0,0,0,0,0,0,0,0,0,0,0,0
20200520,058256,臺股指元大9A購20,1.20,1.22,1.16,1.16,0.00,0.00,12000,3,14420,0,0,0,0,0,0,0,0,0,0
20200520,058257,聯陽國泰9B購01,3.59,3.62,3.52,3.62,+0.37,11.38,42000,3,150030,0,0,0,0,0,0,32000,0,32000,32000
20200520,058258,世芯國泰9A購01,,,,,0.00,0.00,0,0,0,0,0,0,0,0,0,0,0,0,0
20200520,058259,訊連國泰9B購01,1.47,1.51,1.33,1.42,-0.05,-3.4,133000,25,189100,0,0,0,0,0,0,105000,38000,67000,67000
20200520,05825P,臺股指凱基96售22,,,,,0.00,0.00,0,0,0,0,0,0,0,0,0,0,0,0,0
20200520,058260,華新科富邦9C購01,,,,,0.00,0.00,0,0,0,0,0,0,0,0,0,0,0,0,0
20200520,058261,大立光富邦03購01,0.36,0.43,0.36,0.38,+0.01,2.7,99000,13,36980,0,0,0,0,0,0,0,91000,-91000,-91000
20200520,058262,大立光富邦9C購02,1.22,1.30,1.22,1.30,+0.05,4.0,475000,15,607500,0,0,0,0,0,0,141000,334000,-193000,-193000
20200520,058263,大成鋼永豐99購01,,,,,0.00,0.00,0,0,0,0,0,0,0,0,0,0,0,0,0
20200520,058264,瑞昱永豐99購01,2.53,2.61,2.53,2.61,+0.11,4.4,13000,3,33130,0,0,0,0,0,0,10000,3000,7000,7000
20200520,058265,奇力新永豐9A購01,0.77,0.77,0.76,0.76,0.00,0.00,35000,3,26900,0,0,0,0,0,0,0,35000,-35000,-35000
20200520,058266,宏達電永豐99購01,0.98,1.03,0.98,1.01,+0.02,2.02,392000,4,394350,0,0,0,0,0,0,333000,61000,272000,272000
20200520,058267,奇鋐永豐99購01,0.72,0.79,0.71,0.79,+0.05,6.76,95000,13,73470,0,0,0,0,0,0,0,95000,-95000,-95000
20200520,058268,泰碩永豐9A購01,1.25,1.25,1.17,1.17,-0.11,-8.59,57000,4,69650,0,0,0,0,0,0,20000,37000,-17000,-17000
20200520,058269,世芯永豐9A購01,3.69,3.69,3.61,3.61,-0.23,-5.99,140000,4,511800,0,0,0,0,0,0,140000,0,140000,140000
20200520,05826P,臺股指凱基96售23,,,,,0.00,0.00,0,0,0,0,0,0,0,0,0,0,0,0,0
20200520,058270,上緯控永豐99購01,1.03,1.08,0.95,0.95,-0.07,-6.86,267000,14,272210,0,0,0,0,0,0,41000,176000,-135000,-135000
20200520,058271,訊連永豐99購01,0.64,0.65,0.61,0.63,-0.03,-4.55,662000,33,420700,0,0,0,0,0,0,568000,84000,484000,484000
20200520,058272,超眾永豐9A購01,,,,,0.00,0.00,0,0,0,0,0,0,0,0,0,0,0,0,0
20200520,058273,同欣電永豐99購01,0.67,0.75,0.67,0.67,-0.01,-1.47,172000,12,122070,0,0,0,0,0,0,5000,167000,-162000,-162000
20200520,058274,世紀鋼永豐99購01,1.68,1.68,1.68,1.68,-0.19,-10.16,5000,1,8400,0,0,0,0,0,0,5000,0,5000,5000
20200520,058275,S&P500中信9B購01,,,,,0.00,0.00,0,0,0,0,0,0,0,0,0,0,0,0,0
20200520,058276,道瓊指中信9C購01,0.33,0.33,0.33,0.33,-0.03,-8.33,3000,1,990,0,0,0,0,0,0,0,0,0,0
20200520,058277,FBVIX中信03購01,,,,,0.00,0.00,0,0,0,0,0,0,0,0,0,0,0,0,0
20200520,058278,FBVIX中信03購02,,,,,0.00,0.00,0,0,0,0,0,0,0,0,0,0,0,0,0
20200520,058279,FBVIX中信03購03,5.90,5.90,5.90,5.90,+0.10,1.72,1000,1,5900,0,0,0,0,0,0,1000,0,1000,1000
20200520,05827P,台積電統一96售10,,,,,0.00,0.00,0,0,0,0,0,0,0,0,0,0,0,0,0
20200520,058280,SGBR2X中信99購01,0.14,0.20,0.14,0.20,-0.01,-4.76,52000,3,8780,0,0,0,0,0,0,0,0,0,0
20200520,058281,奇力新中信99購01,,,,,0.00,0.00,0,0,0,0,0,0,0,0,0,0,0,0,0
20200520,058282,聯茂中信99購01,0.17,0.17,0.17,0.17,-0.05,-22.73,20000,2,3400,0,0,0,0,0,0,0,20000,-20000,-20000
20200520,058283,世紀鋼中信99購01,2.37,2.37,2.35,2.35,+0.98,71.53,20000,2,47200,0,0,0,0,0,0,0,0,0,0
20200520,058284,滬深反群益01購01,,,,,0.00,0.00,0,0,0,0,0,0,0,0,0,0,0,0,0
20200520,058285,牧德群益9A購02,,,,,0.00,0.00,0,0,0,0,0,0,0,0,0,0,0,0,0
20200520,058286,道瓊指國票9B購01,,,,,0.00,0.00,0,0,0,0,0,0,0,0,0,0,0,0,0
20200520,058287,國巨國票9A購02,,,,,0.00,0.00,0,0,0,0,0,0,0,0,0,0,0,0,0
20200520,058288,南亞科國票9A購01,,,,,0.00,0.00,0,0,0,0,0,0,0,0,0,0,0,0,0
20200520,058289,奇鋐國票9A購01,4.58,4.85,4.58,4.83,+0.16,3.43,90000,7,423320,0,0,0,0,0,0,0,90000,-90000,-90000
20200520,05828P,台積電統一97售02,,,,,0.00,0.00,0,0,0,0,0,0,0,0,0,0,0,0,0
20200520,058290,南電國票9A購01,4.64,4.64,4.55,4.55,-0.30,-6.19,12000,3,54870,0,0,0,0,0,0,0,12000,-12000,-12000
20200520,058291,元油2X日盛99購01,,,,,0.00,0.00,0,0,0,0,0,0,0,0,0,0,0,0,0
20200520,058292,上銀凱基9A購01,,,,,0.00,0.00,0,0,0,0,0,0,0,0,0,0,0,0,0
20200520,058293,光寶科凱基9A購01,1.28,1.29,1.28,1.29,-0.01,-0.77,198000,10,255100,0,0,0,0,0,0,173000,25000,148000,148000
20200520,058294,華新科凱基9A購01,0.55,0.58,0.55,0.58,+0.04,7.41,111000,8,63680,0,0,0,0,0,0,111000,0,111000,111000
20200520,058295,欣興凱基99購02,1.84,1.93,1.75,1.83,+0.05,2.81,156000,9,285420,0,0,0,0,0,0,55000,101000,-46000,-46000
20200520,058296,明泰凱基99購01,,,,,0.00,0.00,0,0,0,0,0,0,0,0,0,0,0,0,0
20200520,058297,茂林凱基9A購02,1.02,1.14,1.02,1.14,0.00,0.00,642000,17,697340,0,0,0,0,0,0,150000,492000,-342000,-342000
20200520,058298,聯茂凱基99購05,1.16,1.16,1.14,1.14,-0.10,-8.06,146000,3,167420,0,0,0,0,0,0,107000,39000,68000,68000
20200520,058299,同欣電凱基9A購01,,,,,0.00,0.00,0,0,0,0,0,0,0,0,0,0,0,0,0
20200520,05829P,臺股指統一96售08,3.41,3.41,3.41,3.41,0.00,0.00,5000,1,17050,0,0,0,0,0,0,0,5000,-5000,-5000
20200520,058300,元油2X元大99購09,,,,,0.00,0.00,0,0,0,0,0,0,0,0,0,0,0,0,0
20200520,058301,元油2X元大99購10,,,,,0.00,0.00,0,0,0,0,0,0,0,0,0,0,0,0,0
20200520,058302,元油2X元大99購11,,,,,0.00,0.00,0,0,0,0,0,0,0,0,0,0,0,0,0
20200520,058303,華通元大99購03,,,,,0.00,0.00,0,0,0,0,0,0,0,0,0,0,0,0,0
20200520,058304,鴻海元大99購12,,,,,0.00,0.00,0,0,0,0,0,0,0,0,0,0,0,0,0
20200520,058305,華邦電元大99購02,,,,,0.00,0.00,0,0,0,0,0,0,0,0,0,0,0,0,0
20200520,058306,聯發科元大99購07,,,,,0.00,0.00,0,0,0,0,0,0,0,0,0,0,0,0,0
20200520,058307,聯發科元大99購08,,,,,0.00,0.00,0,0,0,0,0,0,0,0,0,0,0,0,0
20200520,058308,全新元大9B購01,,,,,0.00,0.00,0,0,0,0,0,0,0,0,0,0,0,0,0
20200520,058309,大毅元大99購02,3.75,3.86,3.65,3.65,-0.13,-3.44,80000,8,298990,0,0,0,0,0,0,37000,43000,-6000,-6000
20200520,05830P,滬深2X元富99售03,2.36,2.38,2.35,2.35,-0.04,-1.67,50000,3,118100,0,0,0,0,0,0,40000,10000,30000,30000
20200520,058310,大立光元大99購10,,,,,0.00,0.00,0,0,0,0,0,0,0,0,0,0,0,0,0
20200520,058311,緯穎元大99購05,,,,,0.00,0.00,0,0,0,0,0,0,0,0,0,0,0,0,0
20200520,058312,大毅國泰9B購01,1.82,1.91,1.82,1.83,+0.02,1.1,135000,11,250800,0,0,0,0,0,0,27000,108000,-81000,-81000
20200520,058313,台積電富邦9B購04,,,,,0.00,0.00,0,0,0,0,0,0,0,0,0,0,0,0,0
20200520,058314,欣興富邦9B購01,0.53,0.53,0.47,0.53,0.00,0.00,29000,4,14300,0,0,0,0,0,0,17000,0,17000,17000
20200520,058315,TPK富邦9C購01,0.97,1.00,0.95,0.97,0.00,0.00,1038000,51,1028070,0,0,0,0,0,0,698000,290000,408000,408000
20200520,058316,元油2X永豐9A購03,,,,,0.00,0.00,0,0,0,0,0,0,0,0,0,0,0,0,0
20200520,058317,國巨永豐99購02,1.11,1.11,1.11,1.11,+0.15,15.62,8000,2,8880,0,0,0,0,0,0,0,8000,-8000,-8000
20200520,058318,致茂永豐9A購01,0.41,0.43,0.40,0.43,+0.05,13.16,75000,3,30260,0,0,0,0,0,0,73000,2000,71000,71000
20200520,058319,大毅永豐9A購01,1.05,1.13,1.05,1.07,+0.02,1.9,86000,10,93940,0,0,0,0,0,0,54000,76000,-22000,-22000
20200520,05831P,臺股指元富96售03,,,,,0.00,0.00,0,0,0,0,0,0,0,0,0,0,0,0,0
20200520,058320,華新科永豐99購02,,,,,0.00,0.00,0,0,0,0,0,0,0,0,0,0,0,0,0
20200520,058321,大立光永豐99購01,,,,,0.00,0.00,0,0,0,0,0,0,0,0,0,0,0,0,0
20200520,058322,玉晶光永豐99購02,0.76,0.81,0.75,0.80,+0.03,3.9,166000,11,130260,0,0,0,0,0,0,125000,41000,84000,84000
20200520,058323,泰鼎永豐9A購01,0.99,0.99,0.99,0.99,-0.18,-15.38,1000,1,990,0,0,0,0,0,0,1000,0,1000,1000
20200520,058324,嘉聯益永豐9A購01,1.22,1.22,1.22,1.22,0.00,0.00,12000,1,14640,0,0,0,0,0,0,0,12000,-12000,-12000
20200520,058325,昇陽半永豐99購01,0.25,0.25,0.25,0.25,+0.02,8.7,5000,1,1250,0,0,0,0,0,0,5000,0,5000,5000
20200520,058326,祥碩台新99購01,,,,,0.00,0.00,0,0,0,0,0,0,0,0,0,0,0,0,0
20200520,058327,大毅統一9B購01,0.72,0.77,0.70,0.70,-0.01,-1.41,611000,25,449550,0,0,0,0,0,0,179000,432000,-253000,-253000
20200520,058328,世紀鋼統一9B購01,0.76,0.79,0.69,0.69,-0.07,-9.21,400000,13,286250,0,0,0,0,0,0,385000,15000,370000,370000
20200520,058329,S&P正2元富01購01,,,,,0.00,0.00,0,0,0,0,0,0,0,0,0,0,0,0,0
20200520,05832P,臺股指元富96售04,,,,,0.00,0.00,0,0,0,0,0,0,0,0,0,0,0,0,0
20200520,058330,鴻海元富99購01,,,,,0.00,0.00,0,0,0,0,0,0,0,0,0,0,0,0,0
20200520,058331,鴻海元富99購02,,,,,0.00,0.00,0,0,0,0,0,0,0,0,0,0,0,0,0
20200520,058332,鴻海元富99購03,,,,,0.00,0.00,0,0,0,0,0,0,0,0,0,0,0,0,0
20200520,058333,鴻海元富99購04,2.15,2.15,2.15,2.15,0.00,0.00,7000,1,15050,0,0,0,0,0,0,0,7000,-7000,-7000
20200520,058334,鴻海元富99購05,2.05,2.05,2.05,2.05,0.00,0.00,7000,1,14350,0,0,0,0,0,0,0,7000,-7000,-7000
20200520,058335,鴻海元富99購06,,,,,0.00,0.00,0,0,0,0,0,0,0,0,0,0,0,0,0
20200520,058336,鴻海元富99購07,,,,,0.00,0.00,0,0,0,0,0,0,0,0,0,0,0,0,0
20200520,058337,日月光元富99購01,0.88,0.91,0.83,0.83,-0.07,-7.78,260000,6,225300,0,0,0,0,0,0,50000,210000,-160000,-160000
20200520,058338,康友元富99購01,0.59,0.59,0.59,0.59,-0.03,-4.84,100000,10,59000,0,0,0,0,0,0,0,100000,-100000,-100000
20200520,058339,康友元富99購02,,,,,0.00,0.00,0,0,0,0,0,0,0,0,0,0,0,0,0
20200520,05833P,臺股指元富96售05,,,,,0.00,0.00,0,0,0,0,0,0,0,0,0,0,0,0,0
20200520,058340,高股息群益99購01,,,,,0.00,0.00,0,0,0,0,0,0,0,0,0,0,0,0,0
20200520,058341,T50反1群益99購01,,,,,0.00,0.00,0,0,0,0,0,0,0,0,0,0,0,0,0
20200520,058342,鴻海群益9A購01,,,,,0.00,0.00,0,0,0,0,0,0,0,0,0,0,0,0,0
20200520,058343,台積電群益99購02,,,,,0.00,0.00,0,0,0,0,0,0,0,0,0,0,0,0,0
20200520,058344,旺宏群益99購05,,,,,0.00,0.00,0,0,0,0,0,0,0,0,0,0,0,0,0
20200520,058345,台光電群益99購03,2.28,2.32,2.18,2.32,+0.02,0.87,532000,23,1215390,0,0,0,0,0,0,35000,497000,-462000,-462000
20200520,058346,嘉晶群益99購01,1.36,1.68,1.27,1.55,+0.41,35.96,564000,30,781850,0,0,0,0,0,0,250000,314000,-64000,-64000
20200520,058347,玉晶光群益9B購01,6.85,7.45,6.85,7.45,+0.45,6.43,31000,22,222200,0,0,0,0,0,0,30000,29000,1000,1000
20200520,058348,台表科群益99購01,2.80,3.57,2.71,3.43,+0.72,26.57,301000,32,915130,0,0,0,0,0,0,156000,145000,11000,11000
20200520,058349,滬深2X日盛9A購01,,,,,0.00,0.00,0,0,0,0,0,0,0,0,0,0,0,0,0
20200520,05834P,臺股指元富96售06,,,,,0.00,0.00,0,0,0,0,0,0,0,0,0,0,0,0,0
20200520,058350,T50正2凱基9B購01,,,,,0.00,0.00,0,0,0,0,0,0,0,0,0,0,0,0,0
20200520,058351,上銀凱基9A購02,,,,,0.00,0.00,0,0,0,0,0,0,0,0,0,0,0,0,0
20200520,058352,鴻海凱基9A購05,1.36,1.36,1.30,1.30,-0.11,-7.8,31000,3,40910,0,0,0,0,0,0,20000,11000,9000,9000
20200520,058353,國巨凱基99購09,1.26,1.34,1.26,1.29,+0.15,13.16,61000,6,79200,0,0,0,0,0,0,41000,20000,21000,21000
20200520,058354,台積電凱基9A購06,,,,,0.00,0.00,0,0,0,0,0,0,0,0,0,0,0,0,0
20200520,058355,旺宏凱基99購04,2.71,2.71,2.66,2.66,-0.03,-1.12,3000,2,8030,0,0,0,0,0,0,2000,1000,1000,1000
20200520,058356,華邦電凱基99購01,0.81,0.81,0.80,0.80,0.00,0.00,17000,2,13720,0,0,0,0,0,0,5000,17000,-12000,-12000
20200520,058357,智邦凱基99購02,5.00,5.00,5.00,5.00,-0.50,-9.09,10000,1,50000,0,0,0,0,0,0,0,10000,-10000,-10000
20200520,058358,技嘉凱基9A購01,3.95,3.95,3.84,3.86,-0.02,-0.52,19000,4,74160,0,0,0,0,0,0,19000,0,19000,19000
20200520,058359,瑞昱凱基99購01,3.68,3.79,3.64,3.79,+0.09,2.43,160000,24,592550,0,0,0,0,0,0,160000,0,160000,160000
20200520,05835P,臺股指元富96售07,,,,,0.00,0.00,0,0,0,0,0,0,0,0,0,0,0,0,0
20200520,058360,台光電凱基9A購02,2.87,2.97,2.87,2.97,+0.04,1.37,51000,11,147120,0,0,0,0,0,0,50000,1000,49000,49000
20200520,058361,美律凱基99購06,,,,,0.00,0.00,0,0,0,0,0,0,0,0,0,0,0,0,0
20200520,058362,聯發科凱基99購06,,,,,0.00,0.00,0,0,0,0,0,0,0,0,0,0,0,0,0
20200520,058363,全新凱基9A購02,1.85,1.86,1.74,1.74,-0.13,-6.95,139000,6,250210,0,0,0,0,0,0,73000,66000,7000,7000
20200520,058364,奇力新凱基99購04,0.58,0.64,0.58,0.62,+0.05,8.77,151000,6,91680,0,0,0,0,0,0,115000,36000,79000,79000
20200520,058365,奇力新凱基9A購01,0.80,0.83,0.80,0.83,0.00,0.00,28000,3,22640,0,0,0,0,0,0,0,28000,-28000,-28000
20200520,058366,元大金凱基99購01,,,,,0.00,0.00,0,0,0,0,0,0,0,0,0,0,0,0,0
20200520,058367,大立光凱基9A購01,,,,,0.00,0.00,0,0,0,0,0,0,0,0,0,0,0,0,0
20200520,058368,奇鋐凱基9A購01,1.92,1.92,1.92,1.92,+0.03,1.59,2000,1,3840,0,0,0,0,0,0,2000,0,2000,2000
20200520,058369,亞光凱基99購02,1.49,1.49,1.49,1.49,+0.04,2.76,10000,1,14900,0,0,0,0,0,0,0,10000,-10000,-10000
20200520,05836P,臺股指元富96售08,,,,,0.00,0.00,0,0,0,0,0,0,0,0,0,0,0,0,0
20200520,058370,聯詠凱基99購01,0.49,0.58,0.48,0.55,+0.02,3.77,140000,12,70960,0,0,0,0,0,0,55000,50000,5000,5000
20200520,058371,智原凱基9A購01,1.72,1.80,1.72,1.77,+0.18,11.32,142000,8,249450,0,0,0,0,0,0,0,142000,-142000,-142000
20200520,058372,欣興凱基99購03,2.00,2.14,1.99,1.99,0.00,0.00,102000,10,209250,0,0,0,0,0,0,59000,43000,16000,16000
20200520,058373,晶技凱基99購02,,,,,0.00,0.00,0,0,0,0,0,0,0,0,0,0,0,0,0
20200520,058374,玉晶光凱基9A購03,1.68,1.68,1.68,1.68,+0.04,2.44,13000,1,21840,0,0,0,0,0,0,0,13000,-13000,-13000
20200520,058375,群創凱基9B購04,,,,,0.00,0.00,0,0,0,0,0,0,0,0,0,0,0,0,0
20200520,058376,貿聯凱基9A購01,,,,,0.00,0.00,0,0,0,0,0,0,0,0,0,0,0,0,0
20200520,058377,茂林凱基9A購03,1.36,1.60,1.36,1.60,+0.42,35.59,261000,14,358110,0,0,0,0,0,0,25000,251000,-226000,-226000
20200520,058378,南電凱基99購01,2.66,2.76,2.43,2.54,-0.12,-4.51,160000,12,420450,0,0,0,0,0,0,100000,60000,40000,40000
20200520,058379,臺股指凱基99購14,0.54,0.59,0.54,0.59,0.00,0.00,3000,2,1670,0,0,0,0,0,0,0,0,0,0
20200520,05837P,臺股指富邦96售04,,,,,0.00,0.00,0,0,0,0,0,0,0,0,0,0,0,0,0
20200520,058380,臺股指凱基99購15,0.40,0.40,0.40,0.40,0.00,0.00,10000,2,4000,0,0,0,0,0,0,10000,0,10000,10000
20200520,058381,元石油中信9C購01,,,,,0.00,0.00,0,0,0,0,0,0,0,0,0,0,0,0,0
20200520,058382,S&P500中信99購01,,,,,0.00,0.00,0,0,0,0,0,0,0,0,0,0,0,0,0
20200520,058383,道瓊指中信9C購02,,,,,0.00,0.00,0,0,0,0,0,0,0,0,0,0,0,0,0
20200520,058384,大成鋼中信99購01,0.20,0.20,0.20,0.20,0.00,0.00,30000,1,6000,0,0,0,0,0,0,0,30000,-30000,-30000
20200520,058385,創意中信99購01,,,,,0.00,0.00,0,0,0,0,0,0,0,0,0,0,0,0,0
20200520,058386,A50正2國票9B購01,,,,,0.00,0.00,0,0,0,0,0,0,0,0,0,0,0,0,0
20200520,058387,國巨國票9A購03,3.86,3.86,3.65,3.79,+0.42,12.46,8000,8,29940,0,0,0,0,0,0,5000,8000,-3000,-3000
20200520,058388,健策國票9A購01,,,,,0.00,0.00,0,0,0,0,0,0,0,0,0,0,0,0,0
20200520,058389,聯茂國票9A購01,,,,,0.00,0.00,0,0,0,0,0,0,0,0,0,0,0,0,0
20200520,05838P,臺股指富邦96售05,,,,,0.00,0.00,0,0,0,0,0,0,0,0,0,0,0,0,0
20200520,058390,樺漢國票9A購01,,,,,0.00,0.00,0,0,0,0,0,0,0,0,0,0,0,0,0
20200520,058391,T50反1元大99購02,,,,,0.00,0.00,0,0,0,0,0,0,0,0,0,0,0,0,0
20200520,058392,元油2X元大99購12,0.03,0.03,0.03,0.03,-0.01,-25.0,593000,9,17790,0,0,0,0,0,0,0,370000,-370000,-370000
20200520,058393,元油2X元大99購13,,,,,0.00,0.00,0,0,0,0,0,0,0,0,0,0,0,0,0
20200520,058394,元油2X元大99購14,,,,,0.00,0.00,0,0,0,0,0,0,0,0,0,0,0,0,0
20200520,058395,元油2X元大99購15,,,,,0.00,0.00,0,0,0,0,0,0,0,0,0,0,0,0,0
20200520,058396,力山元大99購01,4.02,4.08,4.02,4.05,+0.08,2.02,45000,3,182790,0,0,0,0,0,0,0,45000,-45000,-45000
20200520,058397,大成鋼元大99購02,1.01,1.29,1.01,1.28,+0.28,28.0,810000,29,913480,0,0,0,0,0,0,175000,733000,-558000,-558000
20200520,058398,中環元大99購02,0.85,0.96,0.85,0.95,+0.07,7.95,160000,6,147800,0,0,0,0,0,0,60000,100000,-40000,-40000
20200520,058399,美律元大99購05,0.65,0.65,0.63,0.63,-0.04,-5.97,278000,5,178250,0,0,0,0,0,0,15000,263000,-248000,-248000
20200520,05839P,臺股指富邦96售06,,,,,0.00,0.00,0,0,0,0,0,0,0,0,0,0,0,0,0
20200520,058400,聯發科元大99購09,,,,,0.00,0.00,0,0,0,0,0,0,0,0,0,0,0,0,0
20200520,058401,華航元大9A購01,0.90,0.90,0.90,0.90,0.00,0.00,10000,2,9000,0,0,0,0,0,0,0,7000,-7000,-7000
20200520,058402,欣興元大99購04,3.22,3.27,3.17,3.17,0.00,0.00,52000,7,166890,0,0,0,0,0,0,47000,22000,25000,25000
20200520,058403,玉晶光元大99購12,3.44,3.78,3.43,3.76,+0.22,6.21,265000,27,975400,0,0,0,0,0,0,80000,215000,-135000,-135000
20200520,058404,貿聯元大99購02,,,,,0.00,0.00,0,0,0,0,0,0,0,0,0,0,0,0,0
20200520,058405,訊連元大99購02,1.24,1.26,1.18,1.19,-0.05,-4.03,898000,31,1095240,0,0,0,0,0,0,818000,30000,788000,788000
20200520,058406,聯茂元大99購06,0.83,0.83,0.79,0.80,-0.02,-2.44,331000,12,268720,0,0,0,0,0,0,163000,100000,63000,63000
20200520,058407,滬深2X兆豐9A購01,,,,,0.00,0.00,0,0,0,0,0,0,0,0,0,0,0,0,0
20200520,058408,華通兆豐99購02,1.42,1.50,1.37,1.43,-0.06,-4.03,34000,14,48840,0,0,0,0,0,0,10000,24000,-14000,-14000
20200520,058409,鴻海兆豐99購05,,,,,0.00,0.00,0,0,0,0,0,0,0,0,0,0,0,0,0
20200520,05840P,臺股指富邦96售07,,,,,0.00,0.00,0,0,0,0,0,0,0,0,0,0,0,0,0
20200520,058410,國巨兆豐99購03,1.90,2.02,1.89,1.89,+0.23,13.86,228000,20,445020,0,0,0,0,0,0,32000,196000,-164000,-164000
20200520,058411,技嘉兆豐99購01,,,,,0.00,0.00,0,0,0,0,0,0,0,0,0,0,0,0,0
20200520,058412,聯發科兆豐99購01,2.64,2.64,2.64,2.64,+0.14,5.6,1000,1,2640,0,0,0,0,0,0,1000,0,1000,1000
20200520,058413,義隆兆豐99購01,1.32,1.32,1.32,1.32,0.00,0.00,15000,1,19800,0,0,0,0,0,0,0,15000,-15000,-15000
20200520,058414,大立光兆豐99購02,,,,,0.00,0.00,0,0,0,0,0,0,0,0,0,0,0,0,0
20200520,058415,祥碩兆豐99購01,,,,,0.00,0.00,0,0,0,0,0,0,0,0,0,0,0,0,0
20200520,058416,鴻海麥證99購01,1.65,1.65,1.65,1.65,-0.04,-2.37,10000,2,16500,0,10000,-10000,0,0,0,0,10000,-10000,-10000
20200520,058417,國巨麥證99購01,,,,,0.00,0.00,0,0,0,0,0,0,0,0,0,0,0,0,0
20200520,058418,台積電麥證99購01,,,,,0.00,0.00,0,0,0,0,0,0,0,0,0,0,0,0,0
20200520,058419,聯發科麥證99購02,,,,,0.00,0.00,0,0,0,0,0,0,0,0,0,0,0,0,0
20200520,05841P,華通元大96售04,1.42,1.42,1.41,1.41,+0.04,2.92,6000,6,8490,0,0,0,0,0,0,6000,0,6000,6000
20200520,058420,聯發科麥證99購03,,,,,0.00,0.00,0,0,0,0,0,0,0,0,0,0,0,0,0
20200520,058421,國泰金麥證01購01,1.48,1.56,1.48,1.52,+0.05,3.4,51000,8,76370,39000,2000,37000,0,0,0,39000,2000,37000,37000
20200520,058422,百和麥證99購01,1.61,1.65,1.49,1.59,+0.16,11.19,337000,53,523350,282000,55000,227000,0,0,0,282000,55000,227000,227000
20200520,058423,臺股指麥證99購01,,,,,0.00,0.00,0,0,0,0,0,0,0,0,0,0,0,0,0
20200520,058424,滬深2X元富99購04,1.56,1.56,1.54,1.55,-0.05,-3.12,14000,3,21790,0,0,0,0,0,0,13000,1000,12000,12000
20200520,058425,S&P正2元富01購02,,,,,0.00,0.00,0,0,0,0,0,0,0,0,0,0,0,0,0
20200520,058426,旺宏元富99購02,,,,,0.00,0.00,0,0,0,0,0,0,0,0,0,0,0,0,0
20200520,058427,大毅元富99購01,,,,,0.00,0.00,0,0,0,0,0,0,0,0,0,0,0,0,0
20200520,058428,大立光元富99購02,1.96,2.12,1.96,2.05,-0.10,-4.65,37000,4,75430,0,0,0,0,0,0,10000,27000,-17000,-17000
20200520,058429,欣興元富99購01,2.61,2.81,2.49,2.61,+0.02,0.77,195000,18,505820,0,0,0,0,0,0,98000,97000,1000,1000
20200520,05842P,台積電元大96售15,,,,,0.00,0.00,0,0,0,0,0,0,0,0,0,0,0,0,0
20200520,058430,滬深2X統一99購02,,,,,0.00,0.00,0,0,0,0,0,0,0,0,0,0,0,0,0
20200520,058431,國巨統一9B購01,1.28,1.40,1.28,1.29,+0.09,7.5,1230000,18,1637190,0,0,0,0,0,0,1165000,65000,1100000,1100000
20200520,058432,台積電統一9B購03,,,,,0.00,0.00,0,0,0,0,0,0,0,0,0,0,0,0,0
20200520,058433,台積電統一9B購04,0.73,0.73,0.73,0.73,0.00,0.00,1000,1,730,0,0,0,0,0,0,1000,0,1000,1000
20200520,058434,旺宏統一9B購01,1.24,1.24,1.24,1.24,0.00,0.00,8000,1,9920,0,0,0,0,0,0,8000,0,8000,8000
20200520,058435,旺宏統一9B購02,,,,,0.00,0.00,0,0,0,0,0,0,0,0,0,0,0,0,0
20200520,058436,聯發科統一9B購03,3.20,3.20,3.03,3.03,+0.29,10.58,12000,2,38060,0,0,0,0,0,0,12000,0,12000,12000
20200520,058437,可成統一9B購01,,,,,0.00,0.00,0,0,0,0,0,0,0,0,0,0,0,0,0
20200520,058438,大立光統一9B購01,1.43,1.49,1.43,1.49,+0.04,2.76,255000,5,374750,0,0,0,0,0,0,116000,139000,-23000,-23000
20200520,058439,玉晶光統一01購02,2.14,2.19,2.14,2.19,0.00,0.00,143000,4,311300,0,0,0,0,0,0,0,143000,-143000,-143000
20200520,05843P,台積電元大96售16,,,,,0.00,0.00,0,0,0,0,0,0,0,0,0,0,0,0,0
20200520,058440,玉晶光統一99購02,1.24,1.26,1.23,1.23,+0.03,2.5,40000,11,49950,0,0,0,0,0,0,0,40000,-40000,-40000
20200520,058441,T50反1台新03購01,,,,,0.00,0.00,0,0,0,0,0,0,0,0,0,0,0,0,0
20200520,058442,玉晶光台新99購01,,,,,0.00,0.00,0,0,0,0,0,0,0,0,0,0,0,0,0
20200520,058443,T50正2富邦01購01,,,,,0.00,0.00,0,0,0,0,0,0,0,0,0,0,0,0,0
20200520,058444,國巨富邦9B購01,1.02,1.02,0.95,0.95,+0.07,7.95,758000,21,764850,0,0,0,0,0,0,11000,747000,-736000,-736000
20200520,058445,旺宏富邦9C購01,0.62,0.62,0.61,0.61,0.00,0.00,261000,27,159860,0,0,0,0,0,0,6000,255000,-249000,-249000
20200520,058446,新光金富邦9C購01,0.36,0.37,0.34,0.37,-0.01,-2.63,131000,14,45070,0,0,0,0,0,0,10000,131000,-121000,-121000
20200520,058447,玉晶光富邦9A購02,,,,,0.00,0.00,0,0,0,0,0,0,0,0,0,0,0,0,0
20200520,058448,滬深2X永豐9A購01,,,,,0.00,0.00,0,0,0,0,0,0,0,0,0,0,0,0,0
20200520,058449,台積電永豐99購01,,,,,0.00,0.00,0,0,0,0,0,0,0,0,0,0,0,0,0
20200520,05844P,旺宏元大96售07,,,,,0.00,0.00,0,0,0,0,0,0,0,0,0,0,0,0,0
20200520,058450,旺宏永豐99購01,1.98,1.98,1.98,1.98,0.00,0.00,65000,2,128700,0,0,0,0,0,0,0,65000,-65000,-65000
20200520,058451,智邦永豐9A購01,2.06,2.06,2.02,2.02,-0.29,-12.55,10000,2,20400,0,0,0,0,0,0,0,10000,-10000,-10000
20200520,058452,義隆永豐99購02,,,,,0.00,0.00,0,0,0,0,0,0,0,0,0,0,0,0,0
20200520,058453,可成永豐99購01,0.85,0.85,0.85,0.85,-0.19,-18.27,14000,1,11900,0,0,0,0,0,0,14000,0,14000,14000
20200520,058454,嘉晶永豐99購01,1.32,1.82,1.30,1.82,+0.54,42.19,458000,53,648070,0,0,0,0,0,0,194000,264000,-70000,-70000
20200520,058455,玉晶光永豐99購03,,,,,0.00,0.00,0,0,0,0,0,0,0,0,0,0,0,0,0
20200520,058456,京鼎永豐99購01,1.16,1.16,1.15,1.15,-0.05,-4.17,60000,2,69470,0,0,0,0,0,0,0,60000,-60000,-60000
20200520,058457,創意永豐99購01,0.80,0.82,0.77,0.82,0.00,0.00,39000,5,30710,0,0,0,0,0,0,26000,23000,3000,3000
20200520,058458,牧德永豐9A購01,,,,,0.00,0.00,0,0,0,0,0,0,0,0,0,0,0,0,0
20200520,058459,南電永豐99購01,1.91,1.94,1.74,1.81,+0.07,4.02,128000,11,239100,0,0,0,0,0,0,10000,118000,-108000,-108000
20200520,05845P,大立光元大96售06,2.81,2.81,2.81,2.81,+0.09,3.31,1000,1,2810,0,0,0,0,0,0,0,1000,-1000,-1000
20200520,058460,臺股指永豐99購01,,,,,0.00,0.00,0,0,0,0,0,0,0,0,0,0,0,0,0
20200520,058461,滬深2X永昌9C購01,,,,,0.00,0.00,0,0,0,0,0,0,0,0,0,0,0,0,0
20200520,058462,台積電兆豐99購01,,,,,0.00,0.00,0,0,0,0,0,0,0,0,0,0,0,0,0
20200520,058463,宏達電兆豐99購02,0.38,0.38,0.38,0.38,0.00,0.00,100000,1,38000,0,0,0,0,0,0,0,100000,-100000,-100000
20200520,058464,矽創兆豐9A購01,0.88,0.90,0.78,0.78,-0.14,-15.22,338000,43,287690,0,0,0,0,0,0,244000,85000,159000,159000
20200520,058465,元石油中信01購01,,,,,0.00,0.00,0,0,0,0,0,0,0,0,0,0,0,0,0
20200520,058466,SGBR2X中信99購02,0.16,0.16,0.15,0.16,-0.02,-11.11,541000,21,85030,0,0,0,0,0,0,0,0,0,0
20200520,058467,日月光中信9A購01,,,,,0.00,0.00,0,0,0,0,0,0,0,0,0,0,0,0,0
20200520,058468,聯茂中信99購02,0.43,0.43,0.39,0.39,-0.04,-9.3,315000,22,127490,0,0,0,0,0,0,247000,20000,227000,227000
20200520,058469,臺股指中信9A購05,,,,,0.00,0.00,0,0,0,0,0,0,0,0,0,0,0,0,0
20200520,05846P,大立光元大96售07,,,,,0.00,0.00,0,0,0,0,0,0,0,0,0,0,0,0,0
20200520,058470,台灣50日盛9B購02,0.40,0.40,0.40,0.40,0.00,0.00,4000,1,1600,0,0,0,0,0,0,4000,0,4000,4000
20200520,058471,台積電日盛9C購01,,,,,0.00,0.00,0,0,0,0,0,0,0,0,0,0,0,0,0
20200520,058472,亞德客凱基9A購01,,,,,0.00,0.00,0,0,0,0,0,0,0,0,0,0,0,0,0
20200520,058473,上銀凱基9A購03,,,,,0.00,0.00,0,0,0,0,0,0,0,0,0,0,0,0,0
20200520,058474,鴻海凱基9A購06,,,,,0.00,0.00,0,0,0,0,0,0,0,0,0,0,0,0,0
20200520,058475,台積電凱基99購06,,,,,0.00,0.00,0,0,0,0,0,0,0,0,0,0,0,0,0
20200520,058476,旺宏凱基9A購01,2.39,2.39,2.39,2.39,0.00,0.00,18000,1,43020,0,0,0,0,0,0,0,18000,-18000,-18000
20200520,058477,億光凱基9A購01,,,,,0.00,0.00,0,0,0,0,0,0,0,0,0,0,0,0,0
20200520,058478,聯發科凱基9A購01,,,,,0.00,0.00,0,0,0,0,0,0,0,0,0,0,0,0,0
20200520,058479,亞光凱基9A購01,1.41,1.41,1.41,1.41,+0.03,2.17,20000,2,28200,0,0,0,0,0,0,10000,10000,0,0
20200520,05847P,大立光元大96售08,,,,,0.00,0.00,0,0,0,0,0,0,0,0,0,0,0,0,0
20200520,058480,新日興凱基9A購01,1.02,1.21,1.02,1.21,+0.13,12.04,93000,6,102450,0,0,0,0,0,0,12000,81000,-69000,-69000
20200520,058481,玉晶光凱基9A購04,1.75,1.75,1.75,1.75,0.00,0.00,6000,1,10500,0,0,0,0,0,0,0,6000,-6000,-6000
20200520,058482,祥碩凱基99購02,3.53,3.53,3.47,3.47,+0.28,8.78,12000,2,42240,0,0,0,0,0,0,10000,2000,8000,8000
20200520,058483,道瓊指國票9A購01,,,,,0.00,0.00,0,0,0,0,0,0,0,0,0,0,0,0,0
20200520,058484,元金2X國票04購01,1.66,1.67,1.66,1.67,+0.11,7.05,27000,3,44830,0,0,0,0,0,0,22000,0,22000,22000
20200520,058485,智邦國票9A購01,6.30,6.30,6.30,6.30,+0.45,7.69,1000,1,6300,0,0,0,0,0,0,0,1000,-1000,-1000
20200520,058486,大立光國票9A購01,,,,,0.00,0.00,0,0,0,0,0,0,0,0,0,0,0,0,0
20200520,058487,晶技國票9A購01,,,,,0.00,0.00,0,0,0,0,0,0,0,0,0,0,0,0,0
20200520,058488,華擎國票9A購01,4.54,4.68,4.54,4.66,+0.69,17.38,139000,5,634720,0,0,0,0,0,0,6000,133000,-127000,-127000
20200520,058489,台灣50群益9B購01,,,,,0.00,0.00,0,0,0,0,0,0,0,0,0,0,0,0,0
20200520,05848P,臺股指元大96售24,5.25,5.25,5.25,5.25,0.00,0.00,10000,1,52500,0,0,0,0,0,0,10000,0,10000,10000
20200520,058490,元黃金群益9B購01,,,,,0.00,0.00,0,0,0,0,0,0,0,0,0,0,0,0,0
20200520,058491,滬深2X群益01購01,,,,,0.00,0.00,0,0,0,0,0,0,0,0,0,0,0,0,0
20200520,058492,華通群益9B購01,,,,,0.00,0.00,0,0,0,0,0,0,0,0,0,0,0,0,0
20200520,058493,台積電群益9A購01,,,,,0.00,0.00,0,0,0,0,0,0,0,0,0,0,0,0,0
20200520,058494,可成群益9B購01,1.92,1.92,1.89,1.89,-0.31,-14.09,3000,2,5730,0,0,0,0,0,0,3000,3000,0,0
20200520,058495,元大金群益9B購01,1.62,1.62,1.62,1.62,-0.07,-4.14,46000,2,74520,0,0,0,0,0,0,0,14000,-14000,-14000
20200520,058496,文曄群益99購01,,,,,0.00,0.00,0,0,0,0,0,0,0,0,0,0,0,0,0
20200520,058497,新日興群益9B購01,1.20,1.40,1.20,1.40,+0.07,5.26,641000,10,840780,0,0,0,0,0,0,192000,439000,-247000,-247000
20200520,058498,世紀鋼群益99購01,2.03,2.03,1.85,1.85,-0.23,-11.06,106000,5,200960,0,0,0,0,0,0,46000,60000,-14000,-14000
20200520,058499,滬深2X元大9C購01,,,,,0.00,0.00,0,0,0,0,0,0,0,0,0,0,0,0,0
20200520,05849P,臺股指元大96售25,,,,,0.00,0.00,0,0,0,0,0,0,0,0,0,0,0,0,0
20200520,058500,元石油元大9C購01,0.31,0.31,0.30,0.30,0.00,0.00,120000,8,36010,0,0,0,0,0,0,0,0,0,0
20200520,058501,S&P正2元大99購01,,,,,0.00,0.00,0,0,0,0,0,0,0,0,0,0,0,0,0
20200520,058502,鴻海元大99購13,2.44,2.48,2.44,2.48,-0.01,-0.4,50000,2,123600,0,0,0,0,0,0,50000,0,50000,50000
20200520,058503,鴻海元大99購14,,,,,0.00,0.00,0,0,0,0,0,0,0,0,0,0,0,0,0
20200520,058504,台積電元大99購07,0.42,0.42,0.42,0.42,0.00,0.00,15000,1,6300,0,0,0,0,0,0,15000,0,15000,15000
20200520,058505,台積電元大99購08,2.44,2.44,2.39,2.39,-0.03,-1.24,112000,5,270280,0,0,0,0,0,0,50000,62000,-12000,-12000
20200520,058506,台積電元大99購09,,,,,0.00,0.00,0,0,0,0,0,0,0,0,0,0,0,0,0
20200520,058507,美律元大9A購01,0.71,0.71,0.69,0.69,-0.03,-4.17,31000,2,21410,0,0,0,0,0,0,0,31000,-31000,-31000
20200520,058508,聯發科元大99購11,8.70,8.70,8.70,8.70,+0.60,7.41,15000,1,130500,0,0,0,0,0,0,0,15000,-15000,-15000
20200520,058509,聯發科元大99購12,,,,,0.00,0.00,0,0,0,0,0,0,0,0,0,0,0,0,0
20200520,05850P,台積電兆豐96售06,,,,,0.00,0.00,0,0,0,0,0,0,0,0,0,0,0,0,0
20200520,058510,全新元大9B購02,0.51,0.51,0.46,0.46,-0.06,-11.54,498000,10,251380,0,0,0,0,0,0,433000,65000,368000,368000
20200520,058511,華新科元大9B購01,,,,,0.00,0.00,0,0,0,0,0,0,0,0,0,0,0,0,0
20200520,058512,宏達電元大99購04,0.86,0.92,0.86,0.87,+0.03,3.57,87000,6,75760,0,0,0,0,0,0,5000,86000,-81000,-81000
20200520,058513,宏達電元大99購05,1.22,1.32,1.22,1.26,+0.04,3.28,103000,4,128920,0,0,0,0,0,0,35000,72000,-37000,-37000
20200520,058514,潤泰全元大99購01,1.29,1.30,1.29,1.30,-0.03,-2.26,47000,2,60900,0,0,0,0,0,0,20000,27000,-7000,-7000
20200520,058515,健鼎元大99購01,1.39,1.39,1.33,1.33,-0.11,-7.64,289000,19,391030,0,0,0,0,0,0,119000,129000,-10000,-10000
20200520,058516,健鼎元大99購02,1.43,1.43,1.36,1.36,-0.10,-6.85,224000,12,310580,0,0,0,0,0,0,116000,72000,44000,44000
20200520,058517,景碩元大99購06,,,,,0.00,0.00,0,0,0,0,0,0,0,0,0,0,0,0,0
20200520,058518,玉晶光元大99購13,0.87,0.93,0.87,0.92,+0.04,4.55,446000,11,408410,0,0,0,0,0,0,40000,244000,-204000,-204000
20200520,058519,嘉澤元大99購01,8.90,9.10,8.90,8.95,-0.10,-1.1,15000,3,134350,0,0,0,0,0,0,15000,15000,0,0
20200520,05851P,力山群益97售01,1.13,1.13,1.12,1.12,-0.01,-0.88,22000,3,24840,0,0,0,0,0,0,0,22000,-22000,-22000
20200520,058520,智易元大99購03,4.10,4.12,3.90,3.96,-0.08,-1.98,35000,9,139520,0,0,0,0,0,0,28000,19000,9000,9000
20200520,058521,日月光元大99購01,2.17,2.21,2.17,2.21,+0.08,3.76,47000,3,102440,0,0,0,0,0,0,0,47000,-47000,-47000
20200520,058522,聯茂元大99購07,0.70,0.70,0.66,0.66,-0.04,-5.71,323000,19,219440,0,0,0,0,0,0,311000,62000,249000,249000
20200520,058523,聯茂元大99購08,0.55,0.55,0.53,0.54,-0.01,-1.82,287000,9,154880,0,0,0,0,0,0,287000,0,287000,287000
20200520,058524,超眾元大99購04,2.61,2.61,2.61,2.61,+0.06,2.35,50000,1,130500,0,0,0,0,0,0,50000,50000,0,0
20200520,058525,台虹元大99購02,1.06,1.07,1.06,1.07,0.00,0.00,161000,4,170760,0,0,0,0,0,0,31000,130000,-99000,-99000
20200520,058526,鈺齊元大99購02,,,,,0.00,0.00,0,0,0,0,0,0,0,0,0,0,0,0,0
20200520,058527,世紀鋼元大99購01,1.82,1.87,1.82,1.87,-0.03,-1.58,25000,2,46000,0,0,0,0,0,0,25000,0,25000,25000
20200520,058528,世紀鋼元大99購02,,,,,0.00,0.00,0,0,0,0,0,0,0,0,0,0,0,0,0
20200520,058529,S&P正2元富9B購01,,,,,0.00,0.00,0,0,0,0,0,0,0,0,0,0,0,0,0
20200520,05852P,嘉晶群益96售01,0.07,0.07,0.07,0.07,-0.05,-41.67,330000,7,23100,0,0,0,0,0,0,330000,0,330000,330000
20200520,058530,為升元富99購01,0.36,0.36,0.36,0.36,-0.05,-12.2,40000,2,14400,0,0,0,0,0,0,25000,0,25000,25000
20200520,058531,華通元富99購01,,,,,0.00,0.00,0,0,0,0,0,0,0,0,0,0,0,0,0
20200520,058532,禾伸堂元富99購01,2.72,2.87,2.68,2.75,+0.08,3.0,128000,12,358870,0,0,0,0,0,0,83000,45000,38000,38000
20200520,058533,玉晶光元富99購01,2.32,2.32,2.32,2.32,0.00,0.00,6000,1,13920,0,0,0,0,0,0,0,6000,-6000,-6000
20200520,058534,友達統一9B購01,0.66,0.66,0.66,0.66,+0.01,1.54,77000,2,50820,0,0,0,0,0,0,77000,0,77000,77000
20200520,058535,玉晶光統一9A購06,0.90,0.90,0.90,0.90,+0.03,3.45,15000,1,13500,0,0,0,0,0,0,15000,0,15000,15000
20200520,058536,群創統一9B購01,0.64,0.64,0.64,0.64,+0.01,1.59,119000,3,76160,0,0,0,0,0,0,119000,0,119000,119000
20200520,058537,彩晶統一9B購01,0.78,0.81,0.77,0.77,-0.01,-1.28,456000,12,358880,0,0,0,0,0,0,265000,181000,84000,84000
20200520,058538,智邦台新99購02,,,,,0.00,0.00,0,0,0,0,0,0,0,0,0,0,0,0,0
20200520,058539,聯發科台新99購01,,,,,0.00,0.00,0,0,0,0,0,0,0,0,0,0,0,0,0
20200520,05853P,欣興群益96售05,1.47,1.54,1.47,1.49,-0.43,-22.4,9000,4,13450,0,0,0,0,0,0,5000,4000,1000,1000
20200520,058540,嘉聯益國泰9A購02,1.37,1.43,1.37,1.43,+0.02,1.42,14000,2,19600,0,0,0,0,0,0,7000,7000,0,0
20200520,058541,T50反1富邦01購01,,,,,0.00,0.00,0,0,0,0,0,0,0,0,0,0,0,0,0
20200520,058542,T50反1富邦9B購01,,,,,0.00,0.00,0,0,0,0,0,0,0,0,0,0,0,0,0
20200520,058543,滬深2X富邦9A購01,,,,,0.00,0.00,0,0,0,0,0,0,0,0,0,0,0,0,0
20200520,058544,FBVIX富邦9B購01,,,,,0.00,0.00,0,0,0,0,0,0,0,0,0,0,0,0,0
20200520,058545,義隆富邦9C購01,1.20,1.20,1.18,1.18,-0.02,-1.67,20000,3,23800,0,0,0,0,0,0,8000,10000,-2000,-2000
20200520,058546,玉晶光富邦9B購01,0.68,0.69,0.68,0.69,0.00,0.00,374000,4,254520,0,0,0,0,0,0,0,374000,-374000,-374000
20200520,058547,世紀鋼富邦9A購01,0.63,0.69,0.56,0.56,-0.05,-8.2,313000,31,189530,0,0,0,0,0,0,40000,162000,-122000,-122000
20200520,058548,元石油永豐99購01,,,,,0.00,0.00,0,0,0,0,0,0,0,0,0,0,0,0,0
20200520,058549,藍天永豐99購01,,,,,0.00,0.00,0,0,0,0,0,0,0,0,0,0,0,0,0
20200520,05854P,華新科凱基96售09,,,,,0.00,0.00,0,0,0,0,0,0,0,0,0,0,0,0,0
20200520,058550,南亞科永豐99購01,1.33,1.33,1.33,1.33,0.00,0.00,136000,2,180880,0,0,0,0,0,0,136000,0,136000,136000
20200520,058551,義隆永豐99購03,1.54,1.56,1.54,1.56,0.00,0.00,31000,4,48140,0,0,0,0,0,0,0,31000,-31000,-31000
20200520,058552,欣興永豐99購01,,,,,0.00,0.00,0,0,0,0,0,0,0,0,0,0,0,0,0
20200520,058553,合勤控永豐99購01,0.87,0.87,0.87,0.87,0.00,0.00,1000,1,870,0,0,0,0,0,0,0,1000,-1000,-1000
20200520,058554,瀚宇博永豐99購01,0.96,0.96,0.96,0.96,-0.03,-3.03,10000,1,9600,0,0,0,0,0,0,10000,0,10000,10000
20200520,058555,矽創永豐9A購01,1.40,1.40,1.28,1.28,+0.01,0.79,57000,5,76650,0,0,0,0,0,0,57000,0,57000,57000
20200520,058556,百和永豐99購01,1.20,1.34,1.20,1.32,+0.10,8.2,45000,5,56720,0,0,0,0,0,0,34000,18000,16000,16000
20200520,058557,健策第一01購01,1.18,1.28,1.18,1.28,+0.07,5.79,419000,15,521010,0,0,0,0,0,0,55000,364000,-309000,-309000
20200520,058558,鴻海日盛9A購02,,,,,0.00,0.00,0,0,0,0,0,0,0,0,0,0,0,0,0
20200520,058559,華新科日盛99購02,1.14,1.21,1.13,1.16,-0.03,-2.52,450000,22,513840,0,0,0,0,0,0,395000,55000,340000,340000
20200520,05855P,滬深2X中信9C售01,,,,,0.00,0.00,0,0,0,0,0,0,0,0,0,0,0,0,0
20200520,058560,T50反1凱基9A購04,,,,,0.00,0.00,0,0,0,0,0,0,0,0,0,0,0,0,0
20200520,058561,T50反1凱基9A購05,1.53,1.54,1.53,1.54,0.00,0.00,15000,3,23000,0,0,0,0,0,0,0,15000,-15000,-15000
20200520,058562,元油2X凱基99購01,,,,,0.00,0.00,0,0,0,0,0,0,0,0,0,0,0,0,0
20200520,058563,元油2X凱基9B購07,,,,,0.00,0.00,0,0,0,0,0,0,0,0,0,0,0,0,0
20200520,058564,元金2X凱基9C購01,,,,,0.00,0.00,0,0,0,0,0,0,0,0,0,0,0,0,0
20200520,058565,鴻海凱基9A購07,1.75,1.75,1.75,1.75,-0.03,-1.69,20000,1,35000,0,0,0,0,0,0,0,20000,-20000,-20000
20200520,058566,聯發科凱基9A購02,,,,,0.00,0.00,0,0,0,0,0,0,0,0,0,0,0,0,0
20200520,058567,華新科凱基9A購02,0.97,1.02,0.97,0.99,-0.02,-1.98,45000,4,44350,0,0,0,0,0,0,30000,15000,15000,15000
20200520,058568,宏達電凱基9A購02,0.95,0.95,0.92,0.92,+0.06,6.98,298000,11,278700,0,0,0,0,0,0,2000,298000,-296000,-296000
20200520,058569,健策凱基9A購01,1.71,1.83,1.71,1.78,0.00,0.00,196000,10,343830,0,0,0,0,0,0,1000,196000,-195000,-195000
20200520,05856P,A50正2中信99售01,,,,,0.00,0.00,0,0,0,0,0,0,0,0,0,0,0,0,0
20200520,058570,臻鼎凱基9A購01,1.68,1.88,1.68,1.88,+0.10,5.62,100000,8,178400,0,0,0,0,0,0,50000,50000,0,0
20200520,058571,緯穎凱基9A購02,,,,,0.00,0.00,0,0,0,0,0,0,0,0,0,0,0,0,0
20200520,058572,百和凱基9A購01,2.55,2.59,2.54,2.54,-0.04,-1.55,143000,15,365160,0,0,0,0,0,0,103000,40000,63000,63000
20200520,058573,鴻海群益9A購02,2.56,2.60,2.49,2.49,-0.11,-4.23,12000,7,30830,0,0,0,0,0,0,6000,12000,-6000,-6000
20200520,058574,台積電群益99購03,2.81,2.81,2.79,2.79,-0.02,-0.71,2000,2,5600,0,0,0,0,0,0,2000,2000,0,0
20200520,058575,智邦群益99購01,6.30,6.30,6.30,6.30,+0.15,2.44,1000,1,6300,0,0,0,0,0,0,0,1000,-1000,-1000
20200520,058576,南亞科群益99購01,0.93,0.93,0.93,0.93,0.00,0.00,15000,2,13950,0,0,0,0,0,0,0,15000,-15000,-15000
20200520,058577,南亞科群益99購02,1.18,1.18,1.18,1.18,+0.09,8.26,20000,1,23600,0,0,0,0,0,0,20000,0,20000,20000
20200520,058578,聯發科群益99購03,6.70,6.70,6.70,6.70,0.00,0.00,6000,1,40200,0,0,0,0,0,0,6000,0,6000,6000
20200520,058579,聯發科群益99購04,,,,,0.00,0.00,0,0,0,0,0,0,0,0,0,0,0,0,0
20200520,05857P,旺宏中信98售02,,,,,0.00,0.00,0,0,0,0,0,0,0,0,0,0,0,0,0
20200520,058580,華新科群益99購02,1.32,1.32,1.32,1.32,-0.02,-1.49,14000,1,18480,0,0,0,0,0,0,14000,0,14000,14000
20200520,058581,大立光群益99購05,2.73,2.86,2.73,2.84,-0.14,-4.7,32000,3,89640,0,0,0,0,0,0,14000,18000,-4000,-4000
20200520,058582,禾伸堂群益99購02,,,,,0.00,0.00,0,0,0,0,0,0,0,0,0,0,0,0,0
20200520,058583,臻鼎群益99購01,1.93,2.11,1.93,2.11,+0.11,5.5,299000,5,612890,0,0,0,0,0,0,0,261000,-261000,-261000
20200520,058584,百和群益9A購01,1.65,1.69,1.50,1.69,+0.06,3.68,787000,25,1237650,0,0,0,0,0,0,742000,52000,690000,690000
20200520,058585,S&P正2中信9B購02,,,,,0.00,0.00,0,0,0,0,0,0,0,0,0,0,0,0,0
20200520,058586,鴻海中信01購02,0.53,0.53,0.53,0.53,-0.07,-11.67,2000,1,1060,0,0,0,0,0,0,0,0,0,0
20200520,058587,台積電中信9C購03,0.57,0.58,0.57,0.58,-0.05,-7.94,10000,3,5750,0,0,0,0,0,0,4000,0,4000,4000
20200520,058588,致茂中信9B購01,1.34,1.39,1.34,1.38,+0.02,1.47,117000,7,160770,0,0,0,0,0,0,46000,79000,-33000,-33000
20200520,058589,群創中信01購01,,,,,0.00,0.00,0,0,0,0,0,0,0,0,0,0,0,0,0
20200520,05858P,矽力中信96售01,,,,,0.00,0.00,0,0,0,0,0,0,0,0,0,0,0,0,0
20200520,058590,南電中信9A購02,0.56,0.56,0.50,0.50,-0.05,-9.09,40000,3,21400,0,0,0,0,0,0,20000,20000,0,0
20200520,058591,台灣50統一9B購02,,,,,0.00,0.00,0,0,0,0,0,0,0,0,0,0,0,0,0
20200520,058592,聯發科統一9C購01,2.61,2.61,2.61,2.61,+0.07,2.76,69000,2,180090,0,0,0,0,0,0,69000,0,69000,69000
20200520,058593,大立光統一9B購02,,,,,0.00,0.00,0,0,0,0,0,0,0,0,0,0,0,0,0
20200520,058594,台灣50元富9B購03,,,,,0.00,0.00,0,0,0,0,0,0,0,0,0,0,0,0,0
20200520,058595,T50正2元富99購01,,,,,0.00,0.00,0,0,0,0,0,0,0,0,0,0,0,0,0
20200520,058596,旺宏台新99購01,,,,,0.00,0.00,0,0,0,0,0,0,0,0,0,0,0,0,0
20200520,058597,瑞昱台新99購01,,,,,0.00,0.00,0,0,0,0,0,0,0,0,0,0,0,0,0
20200520,058598,T50反1元大99購04,,,,,0.00,0.00,0,0,0,0,0,0,0,0,0,0,0,0,0
20200520,058599,T50反1元大99購05,,,,,0.00,0.00,0,0,0,0,0,0,0,0,0,0,0,0,0
20200520,05859P,台表科國票97售04,1.54,1.57,0.99,0.99,-1.04,-51.23,1081000,9,1606240,0,0,0,0,0,0,0,1081000,-1081000,-1081000
20200520,058600,國巨元大99購15,,,,,0.00,0.00,0,0,0,0,0,0,0,0,0,0,0,0,0
20200520,058601,台積電元大99購10,2.16,2.16,2.05,2.15,+0.02,0.94,163000,8,347050,0,0,0,0,0,0,40000,113000,-73000,-73000
20200520,058602,台積電元大99購11,2.16,2.16,2.14,2.14,-0.04,-1.83,32000,2,68520,0,0,0,0,0,0,30000,2000,28000,28000
20200520,058603,台積電元大99購12,1.96,2.00,1.96,2.00,0.00,0.00,18000,3,35680,0,0,0,0,0,0,18000,0,18000,18000
20200520,058604,華邦電元大99購03,0.64,0.68,0.64,0.68,+0.06,9.68,136000,8,88560,0,0,0,0,0,0,68000,68000,0,0
20200520,058605,華邦電元大99購04,0.64,0.68,0.64,0.68,+0.04,6.25,140000,9,92280,0,0,0,0,0,0,68000,72000,-4000,-4000
20200520,058606,聯發科元大99購13,,,,,0.00,0.00,0,0,0,0,0,0,0,0,0,0,0,0,0
20200520,058607,聯發科元大99購14,,,,,0.00,0.00,0,0,0,0,0,0,0,0,0,0,0,0,0
20200520,058608,華新科元大99購13,,,,,0.00,0.00,0,0,0,0,0,0,0,0,0,0,0,0,0
20200520,058609,玉山金元大99購01,0.60,0.60,0.60,0.60,+0.01,1.69,1000,1,600,0,0,0,0,0,0,0,0,0,0
20200520,05860P,旺宏康和96售01,,,,,0.00,0.00,0,0,0,0,0,0,0,0,0,0,0,0,0
20200520,058610,欣興元大99購05,2.72,2.83,2.54,2.54,-0.09,-3.42,187000,21,504160,0,0,0,0,0,0,101000,91000,10000,10000
20200520,058611,欣興元大99購06,2.75,2.81,2.71,2.71,0.00,0.00,106000,8,292270,0,0,0,0,0,0,33000,78000,-45000,-45000
20200520,058612,健策元大99購02,3.05,3.22,3.03,3.13,-0.11,-3.4,98000,12,307340,0,0,0,0,0,0,69000,88000,-19000,-19000
20200520,058613,茂林元大99購03,1.30,1.65,1.30,1.65,+0.37,28.91,1112000,49,1647070,0,45000,-45000,0,0,0,540000,454000,86000,41000
20200520,058614,台郡元大9A購01,0.47,0.47,0.47,0.47,0.00,0.00,20000,1,9400,0,0,0,0,0,0,20000,0,20000,20000
20200520,058615,矽創元大99購01,,,,,0.00,0.00,0,0,0,0,0,0,0,0,0,0,0,0,0
20200520,058616,台虹元大9A購01,0.66,0.68,0.66,0.68,0.00,0.00,102000,6,68900,0,0,0,0,0,0,5000,97000,-92000,-92000
20200520,058617,南電元大99購01,3.78,3.78,3.52,3.53,-0.15,-4.08,31000,5,112380,0,0,0,0,0,0,10000,21000,-11000,-11000
20200520,058618,南電元大99購02,,,,,0.00,0.00,0,0,0,0,0,0,0,0,0,0,0,0,0
20200520,058619,台灣50國票99購04,,,,,0.00,0.00,0,0,0,0,0,0,0,0,0,0,0,0,0
20200520,05861P,瀚宇博永豐96售02,1.22,1.31,1.22,1.30,+0.04,3.17,149000,12,190440,0,0,0,0,0,0,35000,114000,-79000,-79000
20200520,058620,滬深2X國票9A購02,,,,,0.00,0.00,0,0,0,0,0,0,0,0,0,0,0,0,0
20200520,058621,華通國票9A購01,2.11,2.11,2.11,2.11,0.00,0.00,3000,1,6330,0,0,0,0,0,0,3000,0,3000,3000
20200520,058622,國巨國票99購07,2.82,2.87,2.63,2.66,+0.22,9.02,587000,40,1600430,0,0,0,0,0,0,20000,567000,-547000,-547000
20200520,058623,國巨國票99購08,2.25,2.76,2.25,2.43,+0.30,14.08,42000,6,107630,0,0,0,0,0,0,6000,25000,-19000,-19000
20200520,058624,台積電國票99購09,,,,,0.00,0.00,0,0,0,0,0,0,0,0,0,0,0,0,0
20200520,058625,旺宏國票9A購01,2.65,2.66,2.65,2.66,0.00,0.00,66000,2,175500,0,0,0,0,0,0,60000,6000,54000,54000
20200520,058626,瑞昱國票9A購01,5.05,5.05,4.78,4.78,-0.47,-8.95,9000,6,44300,0,0,0,0,0,0,0,9000,-9000,-9000
20200520,058627,聯發科國票99購04,,,,,0.00,0.00,0,0,0,0,0,0,0,0,0,0,0,0,0
20200520,058628,宏達電國票9A購01,,,,,0.00,0.00,0,0,0,0,0,0,0,0,0,0,0,0,0
20200520,058629,嘉晶國票9A購01,1.94,2.53,1.94,2.52,+0.61,31.94,165000,18,351740,0,0,0,0,0,0,60000,106000,-46000,-46000
20200520,05862P,大立光國泰98售01,,,,,0.00,0.00,0,0,0,0,0,0,0,0,0,0,0,0,0
20200520,058630,日月光國票9A購01,,,,,0.00,0.00,0,0,0,0,0,0,0,0,0,0,0,0,0
20200520,058631,鈺齊國票9A購01,4.51,4.54,4.42,4.42,+0.15,3.51,23000,4,103850,0,0,0,0,0,0,1000,23000,-22000,-22000
20200520,058632,世紀鋼國票9A購01,,,,,0.00,0.00,0,0,0,0,0,0,0,0,0,0,0,0,0
20200520,058633,台灣50兆豐99購01,,,,,0.00,0.00,0,0,0,0,0,0,0,0,0,0,0,0,0
20200520,058634,可成兆豐99購03,,,,,0.00,0.00,0,0,0,0,0,0,0,0,0,0,0,0,0
20200520,058635,華新科兆豐99購03,,,,,0.00,0.00,0,0,0,0,0,0,0,0,0,0,0,0,0
20200520,058636,亞光兆豐9A購01,0.40,0.40,0.40,0.40,0.00,0.00,15000,1,6000,0,0,0,0,0,0,15000,0,15000,15000
20200520,058637,晶技兆豐99購01,1.73,1.73,1.60,1.60,-0.10,-5.88,64000,6,107880,0,0,0,0,0,0,0,64000,-64000,-64000
20200520,058638,矽力兆豐99購01,,,,,0.00,0.00,0,0,0,0,0,0,0,0,0,0,0,0,0
20200520,058639,南電兆豐99購01,2.20,2.20,1.88,1.99,-0.10,-4.78,47000,8,95860,0,0,0,0,0,0,22000,25000,-3000,-3000
20200520,05863P,滬深2X元大96售09,,,,,0.00,0.00,0,0,0,0,0,0,0,0,0,0,0,0,0
20200520,058640,台灣50麥證9A購01,,,,,0.00,0.00,0,0,0,0,0,0,0,0,0,0,0,0,0
20200520,058641,鴻海麥證99購02,,,,,0.00,0.00,0,0,0,0,0,0,0,0,0,0,0,0,0
20200520,058642,旺宏麥證9A購01,,,,,0.00,0.00,0,0,0,0,0,0,0,0,0,0,0,0,0
20200520,058643,T50正2富邦03購01,,,,,0.00,0.00,0,0,0,0,0,0,0,0,0,0,0,0,0
20200520,058644,元黃金富邦03購01,,,,,0.00,0.00,0,0,0,0,0,0,0,0,0,0,0,0,0
20200520,058645,康控富邦01購01,0.55,0.55,0.51,0.52,+0.01,1.96,1369000,49,713410,0,0,0,0,0,0,360000,1009000,-649000,-649000
20200520,058646,聯茂富邦9A購01,0.25,0.25,0.24,0.25,-0.02,-7.41,339000,11,81590,0,0,0,0,0,0,54000,285000,-231000,-231000
20200520,058647,華新科永豐99購03,0.99,0.99,0.99,0.99,+0.07,7.61,39000,1,38610,0,0,0,0,0,0,39000,0,39000,39000
20200520,058648,聯陽永豐99購01,1.59,1.59,1.43,1.53,+0.21,15.91,288000,16,435000,0,0,0,0,0,0,51000,207000,-156000,-156000
20200520,058649,健策永豐99購01,1.78,1.87,1.78,1.87,-0.15,-7.43,68000,4,124910,0,0,0,0,0,0,1000,68000,-67000,-67000
20200520,05864P,元油反元大96售07,,,,,0.00,0.00,0,0,0,0,0,0,0,0,0,0,0,0,0
20200520,058650,台虹永豐9A購01,0.73,0.73,0.73,0.73,-0.04,-5.19,174000,2,127020,0,0,0,0,0,0,174000,0,174000,174000
20200520,058651,FBVIX中信9C購01,1.95,1.95,1.95,1.95,+0.04,2.09,3000,3,5850,0,0,0,0,0,0,2000,1000,1000,1000
20200520,058652,SGBR2X中信01購01,,,,,0.00,0.00,0,0,0,0,0,0,0,0,0,0,0,0,0
20200520,058653,光寶科中信9A購01,,,,,0.00,0.00,0,0,0,0,0,0,0,0,0,0,0,0,0
20200520,058654,鴻海中信03購01,,,,,0.00,0.00,0,0,0,0,0,0,0,0,0,0,0,0,0
20200520,058655,鴻海中信03購02,0.63,0.63,0.63,0.63,0.00,0.00,2000,1,1260,0,0,0,0,0,0,0,2000,-2000,-2000
20200520,058656,燿華中信99購01,0.49,0.68,0.49,0.64,+0.19,42.22,361000,32,197210,0,0,0,0,0,0,176000,111000,65000,65000
20200520,058657,大立光中信99購01,,,,,0.00,0.00,0,0,0,0,0,0,0,0,0,0,0,0,0
20200520,058658,瑞儀中信99購01,1.63,1.63,1.63,1.63,0.00,0.00,45000,3,73350,0,0,0,0,0,0,0,45000,-45000,-45000
20200520,058659,力成中信99購01,1.54,1.54,1.49,1.49,+0.02,1.36,6000,2,9190,0,0,0,0,0,0,5000,1000,4000,4000
20200520,05865P,大立光元大96售09,6.50,6.50,6.50,6.50,0.00,0.00,15000,1,97500,0,0,0,0,0,0,15000,0,15000,15000
20200520,058660,樺漢中信9A購01,0.94,1.00,0.94,0.95,+0.04,4.4,877000,15,856430,0,0,0,0,0,0,527000,320000,207000,207000
20200520,058661,臺股指中信9C購01,0.62,0.62,0.62,0.62,0.00,0.00,100000,1,62000,0,0,0,0,0,0,100000,0,100000,100000
20200520,058662,禾伸堂兆豐99購01,,,,,0.00,0.00,0,0,0,0,0,0,0,0,0,0,0,0,0
20200520,058663,瑞儀兆豐9A購01,1.15,1.22,1.15,1.22,+0.08,7.02,406000,19,480260,0,0,0,0,0,0,54000,280000,-226000,-226000
20200520,058664,百和兆豐99購01,1.00,1.06,0.95,1.00,-0.02,-1.96,1331000,61,1336400,0,0,0,0,0,0,593000,735000,-142000,-142000
20200520,058665,台灣50群益9B購02,,,,,0.00,0.00,0,0,0,0,0,0,0,0,0,0,0,0,0
20200520,058666,上証反群益01購01,0.62,0.62,0.62,0.62,0.00,0.00,239000,3,148180,0,0,0,0,0,0,0,239000,-239000,-239000
20200520,058667,元油2X群益99購01,,,,,0.00,0.00,0,0,0,0,0,0,0,0,0,0,0,0,0
20200520,058668,元油2X群益9B購04,0.14,0.14,0.14,0.14,+0.02,16.67,1000,1,140,0,0,0,0,0,0,0,0,0,0
20200520,058669,上銀群益99購01,,,,,0.00,0.00,0,0,0,0,0,0,0,0,0,0,0,0,0
20200520,05866P,致伸元大96售01,,,,,0.00,0.00,0,0,0,0,0,0,0,0,0,0,0,0,0
20200520,058670,鴻海群益9A購03,0.75,0.78,0.72,0.73,-0.04,-5.19,90000,6,65950,0,0,0,0,0,0,14000,76000,-62000,-62000
20200520,058671,旺宏群益9A購01,,,,,0.00,0.00,0,0,0,0,0,0,0,0,0,0,0,0,0
20200520,058672,可成群益9B購02,1.52,1.52,1.42,1.42,-0.47,-24.87,25000,8,36220,0,0,0,0,0,0,10000,25000,-15000,-15000
20200520,058673,華新科群益9A購02,4.42,4.42,4.42,4.42,+0.18,4.25,45000,1,198900,0,0,0,0,0,0,45000,45000,0,0
20200520,058674,宏達電群益99購01,1.09,1.11,1.09,1.11,0.00,0.00,102000,4,111740,0,0,0,0,0,0,4000,102000,-98000,-98000
20200520,058675,康控群益9B購01,0.59,0.59,0.57,0.58,0.00,0.00,200000,9,116700,0,0,0,0,0,0,199000,0,199000,199000
20200520,058676,聯茂群益99購01,0.72,0.72,0.68,0.69,-0.07,-9.21,101000,4,72070,0,0,0,0,0,0,91000,10000,81000,81000
20200520,058677,矽格群益99購01,0.70,0.82,0.70,0.80,+0.10,14.29,512000,11,387820,0,0,0,0,0,0,0,512000,-512000,-512000
20200520,058678,南亞科日盛99購01,,,,,0.00,0.00,0,0,0,0,0,0,0,0,0,0,0,0,0
20200520,058679,可成日盛99購01,,,,,0.00,0.00,0,0,0,0,0,0,0,0,0,0,0,0,0
20200520,05867P,友達兆豐97售02,,,,,0.00,0.00,0,0,0,0,0,0,0,0,0,0,0,0,0
20200520,058680,國巨麥證99購02,,,,,0.00,0.00,0,0,0,0,0,0,0,0,0,0,0,0,0
20200520,058681,大立光康和9B購01,,,,,0.00,0.00,0,0,0,0,0,0,0,0,0,0,0,0,0
20200520,058682,聯發科凱基99購07,6.25,6.25,6.25,6.25,+0.15,2.46,10000,1,62500,0,0,0,0,0,0,10000,0,10000,10000
20200520,058683,可成凱基9A購01,,,,,0.00,0.00,0,0,0,0,0,0,0,0,0,0,0,0,0
20200520,058684,健策凱基99購02,1.76,1.82,1.76,1.82,0.00,0.00,21000,2,37020,0,0,0,0,0,0,1000,21000,-20000,-20000
20200520,058685,TPK凱基99購01,1.50,1.56,1.50,1.51,+0.02,1.34,222000,15,338310,0,0,0,0,0,0,138000,153000,-15000,-15000
20200520,058686,祥碩凱基99購03,2.74,3.07,2.74,3.07,+0.43,16.29,13000,7,38210,0,0,0,0,0,0,13000,0,13000,13000
20200520,058687,聯茂凱基9A購01,0.87,0.88,0.87,0.88,-0.04,-4.35,20000,2,17500,0,0,0,0,0,0,20000,0,20000,20000
20200520,058688,矽創凱基9A購01,1.74,1.74,1.54,1.54,-0.16,-9.41,257000,27,434620,0,0,0,0,0,0,207000,20000,187000,187000
20200520,058689,元油2X國票99購03,0.07,0.07,0.07,0.07,+0.03,75.0,1000,1,70,0,0,0,0,0,0,0,0,0,0
20200520,05868P,台積電凱基96售17,,,,,0.00,0.00,0,0,0,0,0,0,0,0,0,0,0,0,0
20200520,058690,元油2X國票9A購03,,,,,0.00,0.00,0,0,0,0,0,0,0,0,0,0,0,0,0
20200520,058691,友訊國票9A購01,1.98,1.98,1.94,1.94,-0.04,-2.02,127000,5,247860,0,0,0,0,0,0,37000,90000,-53000,-53000
20200520,058692,華邦電國票9B購01,0.33,0.35,0.33,0.33,+0.04,13.79,25000,4,8450,0,0,0,0,0,0,20000,5000,15000,15000
20200520,058693,旭富國票9A購01,4.95,5.10,4.95,4.95,-0.03,-0.6,42000,7,210650,0,0,0,0,0,0,5000,37000,-32000,-32000
20200520,058694,鈺齊國票9A購02,2.32,2.32,2.31,2.31,+0.15,6.94,32000,2,74180,0,0,0,0,0,0,32000,0,32000,32000
20200520,058695,元油2X元大9C購03,,,,,0.00,0.00,0,0,0,0,0,0,0,0,0,0,0,0,0
20200520,058696,元油2X元大9C購04,,,,,0.00,0.00,0,0,0,0,0,0,0,0,0,0,0,0,0
20200520,058697,亞德客元大99購01,,,,,0.00,0.00,0,0,0,0,0,0,0,0,0,0,0,0,0
20200520,058698,華通元大99購05,0.95,0.95,0.94,0.94,-0.02,-2.08,17000,2,16000,0,0,0,0,0,0,0,17000,-17000,-17000
20200520,058699,楠梓電元大99購02,1.47,1.51,1.41,1.45,-0.02,-1.36,251000,8,371530,0,0,0,0,0,0,145000,183000,-38000,-38000
20200520,05869P,旺宏凱基96售05,,,,,0.00,0.00,0,0,0,0,0,0,0,0,0,0,0,0,0
20200520,058700,鴻海元大99購15,,,,,0.00,0.00,0,0,0,0,0,0,0,0,0,0,0,0,0
20200520,058701,鴻海元大99購16,1.07,1.07,1.05,1.05,0.00,0.00,78000,2,83260,0,0,0,0,0,0,68000,10000,58000,58000
20200520,058702,國巨元大99購16,1.20,1.27,1.18,1.20,+0.09,8.11,367000,31,446420,0,0,0,0,0,0,20000,347000,-327000,-327000
20200520,058703,台積電元大99購16,1.04,1.05,1.04,1.05,-0.02,-1.87,79000,3,82750,0,0,0,0,0,0,59000,20000,39000,39000
20200520,058704,台積電元大99購17,1.69,1.69,1.67,1.67,0.00,0.00,100000,2,168000,0,0,0,0,0,0,0,100000,-100000,-100000
20200520,058705,長榮航元大99購01,1.42,1.42,1.40,1.40,-0.01,-0.71,68000,7,95600,0,0,0,0,0,0,68000,0,68000,68000
20200520,058706,聯鈞元大9C購01,0.39,0.39,0.39,0.39,0.00,0.00,7000,1,2730,0,0,0,0,0,0,7000,0,7000,7000
20200520,058707,泰鼎元大99購02,3.42,3.72,3.23,3.72,+0.31,9.09,576000,58,1981730,0,0,0,0,0,0,338000,285000,53000,53000
20200520,058708,臺股指元大9A購21,,,,,0.00,0.00,0,0,0,0,0,0,0,0,0,0,0,0,0
20200520,058709,臺股指元大9A購22,,,,,0.00,0.00,0,0,0,0,0,0,0,0,0,0,0,0,0
20200520,05870P,聯發科凱基96售19,3.29,3.29,3.20,3.26,-0.27,-7.65,8000,5,26050,0,0,0,0,0,0,3000,5000,-2000,-2000
20200520,058710,臺股指元大9A購23,1.20,1.20,1.20,1.20,0.00,0.00,5000,1,6000,0,0,0,0,0,0,5000,0,5000,5000
20200520,058711,鴻海統一9A購02,0.84,0.84,0.82,0.82,-0.05,-5.75,25000,3,20670,0,0,0,0,0,0,9000,16000,-7000,-7000
20200520,058712,鴻海統一9B購03,0.82,0.82,0.80,0.80,-0.02,-2.44,60000,3,48500,0,0,0,0,0,0,30000,30000,0,0
20200520,058713,國巨統一9B購02,0.64,0.64,0.61,0.62,+0.11,21.57,1915000,6,1182720,0,0,0,0,0,0,1894000,1915000,-21000,-21000
20200520,058714,美律統一9B購01,0.77,0.78,0.74,0.74,-0.03,-3.9,156000,5,119540,0,0,0,0,0,0,20000,136000,-116000,-116000
20200520,058715,鴻海台新99購02,,,,,0.00,0.00,0,0,0,0,0,0,0,0,0,0,0,0,0
20200520,058716,華新科台新99購02,,,,,0.00,0.00,0,0,0,0,0,0,0,0,0,0,0,0,0
20200520,058717,南電台新99購02,,,,,0.00,0.00,0,0,0,0,0,0,0,0,0,0,0,0,0
20200520,058718,台灣50元富03購01,1.14,1.30,1.14,1.30,0.00,0.00,18000,5,21600,0,0,0,0,0,0,5000,1000,4000,4000
20200520,058719,智邦元富99購01,4.19,4.33,4.19,4.33,+0.15,3.59,46000,5,194880,0,0,0,0,0,0,30000,16000,14000,14000
20200520,05871P,全新凱基96售04,0.93,1.02,0.93,1.02,+0.06,6.25,100000,7,94390,0,0,0,0,0,0,75000,25000,50000,50000
20200520,058720,旭富元富99購01,2.71,2.77,2.65,2.68,-0.05,-1.83,158000,8,429280,0,0,0,0,0,0,3000,155000,-152000,-152000
20200520,058721,立積元富9C購01,1.50,1.53,1.41,1.47,-0.07,-4.55,502000,33,748770,0,0,0,0,0,0,336000,166000,170000,170000
20200520,058722,台郡元富99購01,0.70,0.72,0.68,0.68,-0.06,-8.11,620000,14,442010,0,0,0,0,0,0,293000,327000,-34000,-34000
20200520,058723,元石油國泰9A購01,,,,,0.00,0.00,0,0,0,0,0,0,0,0,0,0,0,0,0
20200520,058724,大立光國泰9B購01,,,,,0.00,0.00,0,0,0,0,0,0,0,0,0,0,0,0,0
20200520,058725,美律富邦9A購01,0.67,0.68,0.67,0.67,-0.02,-2.9,123000,3,82560,0,0,0,0,0,0,0,123000,-123000,-123000
20200520,058726,宏達電富邦9A購01,,,,,0.00,0.00,0,0,0,0,0,0,0,0,0,0,0,0,0
20200520,058727,嘉晶富邦9A購01,0.60,0.82,0.60,0.77,+0.17,28.33,360000,28,238490,0,0,0,0,0,0,248000,82000,166000,166000
20200520,058728,SP黃豆永豐99購01,,,,,0.00,0.00,0,0,0,0,0,0,0,0,0,0,0,0,0
20200520,058729,國巨永豐99購03,2.03,2.21,2.03,2.11,0.00,0.00,19000,5,39450,0,0,0,0,0,0,0,19000,-19000,-19000
20200520,05872P,大立光凱基96售15,,,,,0.00,0.00,0,0,0,0,0,0,0,0,0,0,0,0,0
20200520,058730,玉晶光永豐9A購01,1.49,1.57,1.47,1.57,+0.15,10.56,117000,16,176810,0,0,0,0,0,0,0,117000,-117000,-117000
20200520,058731,貿聯永豐99購02,0.76,0.76,0.75,0.75,+0.03,4.17,126000,10,95660,0,0,0,0,0,0,116000,10000,106000,106000
20200520,058732,矽格永豐99購01,0.69,0.78,0.69,0.77,+0.10,14.93,365000,18,268620,0,0,0,0,0,0,17000,348000,-331000,-331000
20200520,058733,同欣電永豐99購02,1.02,1.09,1.02,1.05,+0.02,1.94,122000,13,128740,0,0,0,0,0,0,10000,94000,-84000,-84000
20200520,058734,康友永豐99購01,,,,,0.00,0.00,0,0,0,0,0,0,0,0,0,0,0,0,0
20200520,058735,南茂永豐99購01,0.51,0.51,0.51,0.51,0.00,0.00,10000,1,5100,0,0,0,0,0,0,0,10000,-10000,-10000
20200520,058736,鈺齊永豐99購02,,,,,0.00,0.00,0,0,0,0,0,0,0,0,0,0,0,0,0
20200520,058737,鴻海第一01購01,,,,,0.00,0.00,0,0,0,0,0,0,0,0,0,0,0,0,0
20200520,058738,FBVIX中信03購04,2.13,2.13,2.13,2.13,+0.04,1.91,8000,2,17040,0,0,0,0,0,0,8000,0,8000,8000
20200520,058739,喬山中信99購01,0.56,0.66,0.56,0.66,+0.07,11.86,307000,7,178630,0,0,0,0,0,0,157000,150000,7000,7000
20200520,05873P,華通群益97售02,2.43,2.43,2.33,2.33,-0.03,-1.27,25000,7,58830,0,0,0,0,0,0,25000,0,25000,25000
20200520,058740,T50反1日盛9B購02,,,,,0.00,0.00,0,0,0,0,0,0,0,0,0,0,0,0,0
20200520,058741,欣興日盛99購01,1.53,1.67,1.53,1.53,-0.02,-1.29,51000,6,81760,0,0,0,0,0,0,22000,29000,-7000,-7000
20200520,058742,鴻海康和99購01,,,,,0.00,0.00,0,0,0,0,0,0,0,0,0,0,0,0,0
20200520,058743,可成康和99購01,,,,,0.00,0.00,0,0,0,0,0,0,0,0,0,0,0,0,0
20200520,058744,FBVIX凱基9C購03,,,,,0.00,0.00,0,0,0,0,0,0,0,0,0,0,0,0,0
20200520,058745,元金2X凱基9C購02,,,,,0.00,0.00,0,0,0,0,0,0,0,0,0,0,0,0,0
20200520,058746,華通凱基9A購02,1.76,1.76,1.76,1.76,+0.02,1.15,11000,1,19360,0,0,0,0,0,0,0,11000,-11000,-11000
20200520,058747,友達凱基9A購03,0.63,0.63,0.63,0.63,0.00,0.00,137000,2,86310,0,0,0,0,0,0,137000,0,137000,137000
20200520,058748,景碩凱基9A購01,1.11,1.13,1.00,1.00,-0.10,-9.09,254000,8,276730,0,0,0,0,0,0,83000,171000,-88000,-88000
20200520,058749,康控凱基99購03,0.85,0.85,0.81,0.81,+0.01,1.25,204000,32,168980,0,0,0,0,0,0,204000,10000,194000,194000
20200520,05874P,台積電群益96售10,5.80,5.80,5.80,5.80,0.00,0.00,10000,1,58000,0,0,0,0,0,0,10000,10000,0,0
20200520,058750,緯穎凱基9A購03,2.27,2.34,2.10,2.14,-0.05,-2.28,159000,16,355380,0,0,0,0,0,0,138000,41000,97000,97000
20200520,058751,南茂凱基9A購01,2.63,2.65,2.60,2.65,0.00,0.00,47000,4,123520,0,0,0,0,0,0,0,47000,-47000,-47000
20200520,058752,鈺齊凱基9A購01,0.81,0.81,0.81,0.81,+0.04,5.19,1000,1,810,0,0,0,0,0,0,1000,1000,0,0
20200520,058753,元石油群益9B購03,,,,,0.00,0.00,0,0,0,0,0,0,0,0,0,0,0,0,0
20200520,058754,元油2X群益99購02,,,,,0.00,0.00,0,0,0,0,0,0,0,0,0,0,0,0,0
20200520,058755,SGBR2X群益99購01,,,,,0.00,0.00,0,0,0,0,0,0,0,0,0,0,0,0,0
20200520,058756,SGBR2X群益99購02,,,,,0.00,0.00,0,0,0,0,0,0,0,0,0,0,0,0,0
20200520,058757,道瓊銀群益9A購02,,,,,0.00,0.00,0,0,0,0,0,0,0,0,0,0,0,0,0
20200520,058758,台積電群益99購05,1.01,1.01,0.99,0.99,0.00,0.00,20000,2,20000,0,0,0,0,0,0,10000,10000,0,0
20200520,058759,義隆群益99購01,3.14,3.16,3.14,3.16,-0.12,-3.66,25000,2,78800,0,0,0,0,0,0,15000,10000,5000,5000
20200520,05875P,旺宏群益98售01,,,,,0.00,0.00,0,0,0,0,0,0,0,0,0,0,0,0,0
20200520,058760,嘉晶群益9A購01,1.50,1.87,1.50,1.85,+0.38,25.85,267000,19,444580,0,0,0,0,0,0,24000,183000,-159000,-159000
20200520,058761,欣興群益99購02,2.01,2.01,1.86,1.86,-0.02,-1.06,120000,6,227500,0,0,0,0,0,0,100000,20000,80000,80000
20200520,058762,貿聯群益99購03,1.50,1.53,1.45,1.51,+0.06,4.14,935000,28,1402710,0,0,0,0,0,0,270000,645000,-375000,-375000
20200520,058763,和碩群益99購01,2.43,2.43,2.43,2.43,+0.01,0.41,10000,1,24300,0,0,0,0,0,0,10000,0,10000,10000
20200520,058764,康友群益99購01,,,,,0.00,0.00,0,0,0,0,0,0,0,0,0,0,0,0,0
20200520,058765,緯穎群益99購03,,,,,0.00,0.00,0,0,0,0,0,0,0,0,0,0,0,0,0
20200520,058766,力山兆豐99購01,2.10,2.15,2.09,2.09,+0.03,1.46,168000,6,354750,0,0,0,0,0,0,9000,159000,-150000,-150000
20200520,058767,亞德客兆豐99購01,,,,,0.00,0.00,0,0,0,0,0,0,0,0,0,0,0,0,0
20200520,058768,南港兆豐99購01,0.70,0.82,0.70,0.82,+0.09,12.33,43000,12,32710,0,0,0,0,0,0,28000,12000,16000,16000
20200520,058769,友達兆豐99購01,,,,,0.00,0.00,0,0,0,0,0,0,0,0,0,0,0,0,0
20200520,05876P,聯發科群益96售03,1.86,1.90,1.86,1.90,-0.15,-7.32,5000,3,9460,0,0,0,0,0,0,0,5000,-5000,-5000
20200520,058770,貿聯兆豐9A購01,1.41,1.41,1.38,1.38,+0.04,2.99,45000,7,62560,0,0,0,0,0,0,35000,10000,25000,25000
20200520,058771,神達兆豐99購01,0.73,0.80,0.73,0.79,+0.07,9.72,606000,16,463980,0,0,0,0,0,0,100000,506000,-406000,-406000
20200520,058772,茂林兆豐9A購01,0.81,0.97,0.81,0.97,+0.17,21.25,147000,8,132520,0,0,0,0,0,0,0,147000,-147000,-147000
20200520,058773,和碩兆豐99購01,1.73,1.73,1.71,1.71,-0.03,-1.72,20000,2,34400,0,0,0,0,0,0,10000,10000,0,0
20200520,058774,台郡兆豐9A購01,0.70,0.70,0.68,0.68,-0.03,-4.23,60000,2,41000,0,0,0,0,0,0,50000,10000,40000,40000
20200520,058775,台積電國票9A購02,3.23,3.24,3.16,3.21,0.00,0.00,45000,9,143700,0,0,0,0,0,0,5000,43000,-38000,-38000
20200520,058776,台積電國票9A購03,,,,,0.00,0.00,0,0,0,0,0,0,0,0,0,0,0,0,0
20200520,058777,台光電國票9A購01,16.60,16.60,16.00,16.00,-0.50,-3.03,7000,3,112900,0,0,0,0,0,0,6000,1000,5000,5000
20200520,058778,聯發科國票9A購01,7.15,7.15,7.15,7.15,0.00,0.00,42000,3,300300,0,0,0,0,0,0,42000,0,42000,42000
20200520,058779,大立光國票9A購02,,,,,0.00,0.00,0,0,0,0,0,0,0,0,0,0,0,0,0
20200520,05877P,大立光群益96售06,,,,,0.00,0.00,0,0,0,0,0,0,0,0,0,0,0,0,0
20200520,058780,牧德國票9A購01,1.92,1.94,1.92,1.94,0.00,0.00,10000,2,19300,0,0,0,0,0,0,0,10000,-10000,-10000
20200520,058781,康友國票9A購01,0.66,0.68,0.63,0.63,-0.05,-7.35,302000,7,196970,0,0,0,0,0,0,92000,210000,-118000,-118000
20200520,058782,臺股指國票99購01,2.50,2.50,2.50,2.50,+0.10,4.17,21000,1,52500,0,0,0,0,0,0,21000,0,21000,21000
20200520,058783,臺股指國票99購02,2.11,2.17,2.03,2.03,-0.04,-1.93,80000,6,167300,0,0,0,0,0,0,77000,3000,74000,74000
20200520,058784,臺股指國票99購03,,,,,0.00,0.00,0,0,0,0,0,0,0,0,0,0,0,0,0
20200520,058785,臺股指國票99購04,4.45,4.52,4.42,4.42,-0.06,-1.34,11000,4,49130,0,0,0,0,0,0,8000,3000,5000,5000
20200520,058786,元黃金元大99購01,,,,,0.00,0.00,0,0,0,0,0,0,0,0,0,0,0,0,0
20200520,058787,元石油元大9A購01,0.15,0.15,0.15,0.15,0.00,0.00,11000,2,1650,0,0,0,0,0,0,0,0,0,0
20200520,058788,喬山元大99購01,1.61,1.77,1.61,1.77,+0.21,13.46,703000,44,1202040,0,0,0,0,0,0,17000,686000,-669000,-669000
20200520,058789,喬山元大99購02,,,,,0.00,0.00,0,0,0,0,0,0,0,0,0,0,0,0,0
20200520,05878P,創意群益98售01,,,,,0.00,0.00,0,0,0,0,0,0,0,0,0,0,0,0,0
20200520,058790,楠梓電元大99購03,1.60,1.63,1.54,1.57,-0.04,-2.48,249000,8,396520,0,0,0,0,0,0,146000,183000,-37000,-37000
20200520,058791,鴻海元大99購17,1.90,1.90,1.90,1.90,-0.07,-3.55,5000,1,9500,0,0,0,0,0,0,0,5000,-5000,-5000
20200520,058792,鴻海元大99購18,,,,,0.00,0.00,0,0,0,0,0,0,0,0,0,0,0,0,0
20200520,058793,鴻海元大99購19,2.41,2.41,2.41,2.41,-0.09,-3.6,1000,1,2410,0,0,0,0,0,0,1000,0,1000,1000
20200520,058794,旺宏元大99購09,,,,,0.00,0.00,0,0,0,0,0,0,0,0,0,0,0,0,0
20200520,058795,可成元大99購03,1.89,1.89,1.74,1.79,0.00,0.00,203000,21,361570,0,0,0,0,0,0,8000,203000,-195000,-195000
20200520,058796,可成元大99購04,1.14,1.14,1.14,1.14,-0.07,-5.79,68000,1,77520,0,0,0,0,0,0,0,68000,-68000,-68000
20200520,058797,大毅元大99購03,3.85,3.96,3.80,3.86,0.00,0.00,103000,14,398060,0,0,0,0,0,0,92000,11000,81000,81000
20200520,058798,大立光元大99購11,1.61,1.69,1.61,1.69,-0.06,-3.43,51000,2,82190,0,0,0,0,0,0,0,51000,-51000,-51000
20200520,058799,晶技元大99購04,6.45,6.45,6.45,6.45,0.00,0.00,28000,1,180600,0,0,0,0,0,0,0,28000,-28000,-28000
20200520,05879P,台積電台新96售03,2.09,2.09,2.09,2.09,-0.06,-2.79,12000,2,25080,0,0,0,0,0,0,12000,12000,0,0
20200520,058800,健策元大99購03,3.16,3.31,3.10,3.31,+0.19,6.09,125000,7,397660,0,0,0,0,0,0,78000,75000,3000,3000
20200520,058801,致伸元大99購01,1.41,1.48,1.38,1.48,+0.05,3.5,357000,13,499850,0,0,0,0,0,0,262000,302000,-40000,-40000
20200520,058802,矽創元大99購02,3.52,3.52,3.04,3.04,-0.27,-8.16,217000,21,731000,0,0,0,0,0,0,177000,71000,106000,106000
20200520,058803,世紀鋼元大99購03,2.62,2.70,2.36,2.36,-0.22,-8.53,105000,12,264920,0,0,0,0,0,0,24000,102000,-78000,-78000
20200520,058804,T50反1統一9B購01,,,,,0.00,0.00,0,0,0,0,0,0,0,0,0,0,0,0,0
20200520,058805,元石油統一9B購02,,,,,0.00,0.00,0,0,0,0,0,0,0,0,0,0,0,0,0
20200520,058806,道瓊銀統一9B購01,2.49,2.54,2.49,2.51,+0.31,14.09,527000,9,1319210,0,0,0,0,0,0,57000,470000,-413000,-413000
20200520,058807,和大統一9B購01,,,,,0.00,0.00,0,0,0,0,0,0,0,0,0,0,0,0,0
20200520,058808,大成鋼統一9B購01,0.56,0.57,0.56,0.57,+0.09,18.75,210000,4,118050,0,0,0,0,0,0,0,210000,-210000,-210000
20200520,058809,國巨統一9B購03,0.63,0.71,0.63,0.64,+0.06,10.34,462000,12,303700,0,0,0,0,0,0,110000,302000,-192000,-192000
20200520,05880P,創意康和96售01,,,,,0.00,0.00,0,0,0,0,0,0,0,0,0,0,0,0,0
20200520,058810,國巨統一9B購04,0.59,0.65,0.59,0.62,+0.07,12.73,115000,13,71400,0,0,0,0,0,0,110000,100000,10000,10000
20200520,058811,台積電統一9A購05,1.00,1.00,1.00,1.00,0.00,0.00,1000,1,1000,0,0,0,0,0,0,1000,1000,0,0
20200520,058812,台積電統一9B購06,1.54,1.54,1.54,1.54,0.00,0.00,1000,1,1540,0,0,0,0,0,0,1000,1000,0,0
20200520,058813,旺宏統一9B購04,1.28,1.28,1.28,1.28,-0.01,-0.78,8000,1,10240,0,0,0,0,0,0,8000,0,8000,8000
20200520,058814,南亞科台新99購01,0.22,0.22,0.22,0.22,0.00,0.00,20000,2,4400,0,0,0,0,0,0,0,20000,-20000,-20000
20200520,058815,華新科台新99購03,,,,,0.00,0.00,0,0,0,0,0,0,0,0,0,0,0,0,0
20200520,058816,祥碩台新99購02,,,,,0.00,0.00,0,0,0,0,0,0,0,0,0,0,0,0,0
20200520,058817,嘉聯益台新99購01,,,,,0.00,0.00,0,0,0,0,0,0,0,0,0,0,0,0,0
20200520,058818,南電台新99購03,,,,,0.00,0.00,0,0,0,0,0,0,0,0,0,0,0,0,0
20200520,058819,華通國泰9B購01,2.33,2.34,2.31,2.31,-0.01,-0.43,31000,9,72390,0,0,0,0,0,0,20000,11000,9000,9000
20200520,05881P,彩晶康和96售01,,,,,0.00,0.00,0,0,0,0,0,0,0,0,0,0,0,0,0
20200520,058820,致茂國泰9B購01,1.58,1.64,1.58,1.64,+0.12,7.89,298000,5,480440,0,0,0,0,0,0,100000,198000,-98000,-98000
20200520,058821,泰鼎國泰9B購01,3.71,4.01,3.58,4.01,+0.26,6.93,243000,21,944550,0,0,0,0,0,0,22000,221000,-199000,-199000
20200520,058822,樺漢國泰9B購01,1.66,1.72,1.63,1.66,+0.02,1.22,634000,25,1046450,0,0,0,0,0,0,589000,18000,571000,571000
20200520,058823,聯發科富邦9C購01,9.75,10.90,9.55,9.55,+0.45,4.95,15000,5,147150,0,0,0,0,0,0,11000,4000,7000,7000
20200520,058824,晶技富邦9A購01,,,,,0.00,0.00,0,0,0,0,0,0,0,0,0,0,0,0,0
20200520,058825,同欣電富邦9A購01,,,,,0.00,0.00,0,0,0,0,0,0,0,0,0,0,0,0,0
20200520,058826,台積電永豐99購02,1.88,1.88,1.88,1.88,0.00,0.00,2000,1,3760,0,0,0,0,0,0,0,2000,-2000,-2000
20200520,058827,聯發科永豐9A購01,2.74,2.74,2.74,2.74,0.00,0.00,100000,5,274000,0,0,0,0,0,0,100000,100000,0,0
20200520,058828,大毅永豐99購01,0.87,0.88,0.87,0.88,+0.02,2.33,12000,2,10550,0,0,0,0,0,0,1000,11000,-10000,-10000
20200520,058829,華新科永豐99購04,0.69,0.73,0.68,0.68,-0.03,-4.23,147000,13,103050,0,0,0,0,0,0,107000,90000,17000,17000
20200520,05882P,華新科永豐96售01,,,,,0.00,0.00,0,0,0,0,0,0,0,0,0,0,0,0,0
20200520,058830,健策永豐99購02,1.38,1.45,1.38,1.45,-0.07,-4.61,202000,8,284430,0,0,0,0,0,0,0,202000,-202000,-202000
20200520,058831,茂林永豐99購01,0.90,1.35,0.90,1.35,+0.45,50.0,524000,28,545520,0,0,0,0,0,0,12000,497000,-485000,-485000
20200520,058832,立積永豐99購01,0.32,0.32,0.32,0.32,0.00,0.00,50000,1,16000,0,0,0,0,0,0,0,50000,-50000,-50000
20200520,058833,台表科永豐99購01,2.12,2.58,1.96,2.58,+0.50,24.04,488000,51,1050800,0,0,0,0,0,0,312000,148000,164000,164000
20200520,058834,GIS永豐99購01,0.78,0.81,0.78,0.81,0.00,0.00,30000,3,24000,0,0,0,0,0,0,0,30000,-30000,-30000
20200520,058835,元油2X中信9C購02,0.77,0.77,0.77,0.77,+0.20,35.09,18000,1,13860,0,0,0,0,0,0,18000,0,18000,18000
20200520,058836,FBVIX中信03購05,1.01,1.02,1.00,1.00,+0.03,3.09,326000,10,326590,0,0,0,0,0,0,294000,285000,9000,9000
20200520,058837,SGBR2X中信9C購01,0.54,0.54,0.53,0.53,-0.01,-1.85,21000,3,11240,0,0,0,0,0,0,0,0,0,0
20200520,058838,國巨中信99購03,0.96,1.06,0.94,0.97,+0.10,11.49,221000,23,213990,0,0,0,0,0,0,50000,171000,-121000,-121000
20200520,058839,瑞儀中信99購02,0.78,0.84,0.78,0.83,+0.05,6.41,135000,15,109750,0,0,0,0,0,0,35000,99000,-64000,-64000
20200520,05883P,致伸永豐96售03,,,,,0.00,0.00,0,0,0,0,0,0,0,0,0,0,0,0,0
20200520,058840,T50反1群益99購02,,,,,0.00,0.00,0,0,0,0,0,0,0,0,0,0,0,0,0
20200520,058841,深中小群益01購01,0.74,0.74,0.71,0.71,0.00,0.00,1499000,11,1098260,0,0,0,0,0,0,899000,600000,299000,299000
20200520,058842,元油2X群益9C購01,1.83,1.83,1.83,1.83,0.00,0.00,4000,1,7320,0,0,0,0,0,0,0,0,0,0
20200520,058843,元油2X群益9C購02,,,,,0.00,0.00,0,0,0,0,0,0,0,0,0,0,0,0,0
20200520,058844,元油2X群益9C購03,,,,,0.00,0.00,0,0,0,0,0,0,0,0,0,0,0,0,0
20200520,058845,元油2X群益9C購04,,,,,0.00,0.00,0,0,0,0,0,0,0,0,0,0,0,0,0
20200520,058846,鴻海群益99購03,2.66,2.66,2.66,2.66,-0.15,-5.34,75000,1,199500,0,0,0,0,0,0,0,75000,-75000,-75000
20200520,058847,國巨群益99購05,1.89,1.89,1.79,1.79,+0.11,6.55,62000,6,113980,0,0,0,0,0,0,0,62000,-62000,-62000
20200520,058848,台積電群益99購07,1.06,1.07,1.05,1.07,0.00,0.00,30000,3,31800,0,0,0,0,0,0,30000,0,30000,30000
20200520,058849,奇力新群益99購02,0.81,0.81,0.79,0.79,+0.02,2.6,151000,3,119310,0,0,0,0,0,0,150000,1000,149000,149000
20200520,05884P,旺宏統一96售01,1.72,1.74,1.72,1.73,-0.03,-1.7,70000,8,121200,0,0,0,0,0,0,40000,30000,10000,10000
20200520,058850,華新科群益99購03,1.74,1.78,1.67,1.67,-0.03,-1.76,223000,6,382320,0,0,0,0,0,0,133000,103000,30000,30000
20200520,058851,大立光群益99購07,1.72,1.79,1.72,1.79,+0.06,3.47,92000,4,161880,0,0,0,0,0,0,40000,52000,-12000,-12000
20200520,058852,貿聯群益99購04,2.44,2.44,2.30,2.41,+0.09,3.88,822000,33,1968770,0,0,0,0,0,0,177000,645000,-468000,-468000
20200520,058853,日月光群益99購01,,,,,0.00,0.00,0,0,0,0,0,0,0,0,0,0,0,0,0
20200520,058854,樺漢群益9B購01,1.38,1.40,1.36,1.37,0.00,0.00,560000,10,767540,0,0,0,0,0,0,343000,217000,126000,126000
20200520,058855,台積電兆豐99購02,0.82,0.82,0.82,0.82,0.00,0.00,25000,1,20500,0,0,0,0,0,0,0,0,0,0
20200520,058856,新光金兆豐99購01,0.33,0.33,0.33,0.33,0.00,0.00,25000,1,8250,0,0,0,0,0,0,25000,0,25000,25000
20200520,058857,元油2X日盛99購02,0.16,0.16,0.13,0.16,+0.02,14.29,62000,4,8220,0,0,0,0,0,0,0,0,0,0
20200520,058858,元油2X凱基9A購07,,,,,0.00,0.00,0,0,0,0,0,0,0,0,0,0,0,0,0
20200520,058859,元油2X凱基9A購08,,,,,0.00,0.00,0,0,0,0,0,0,0,0,0,0,0,0,0
20200520,05885P,牧德統一96售01,,,,,0.00,0.00,0,0,0,0,0,0,0,0,0,0,0,0,0
20200520,058860,SGBR2X凱基9A購01,,,,,0.00,0.00,0,0,0,0,0,0,0,0,0,0,0,0,0
20200520,058861,國巨凱基9A購08,1.57,1.57,1.57,1.57,+0.13,9.03,1000,1,1570,0,0,0,0,0,0,0,1000,-1000,-1000
20200520,058862,聯發科凱基99購08,,,,,0.00,0.00,0,0,0,0,0,0,0,0,0,0,0,0,0
20200520,058863,可成凱基99購02,,,,,0.00,0.00,0,0,0,0,0,0,0,0,0,0,0,0,0
20200520,058864,欣興凱基99購04,2.61,2.61,2.40,2.40,0.00,0.00,20000,2,50100,0,0,0,0,0,0,0,20000,-20000,-20000
20200520,058865,群創凱基01購01,,,,,0.00,0.00,0,0,0,0,0,0,0,0,0,0,0,0,0
20200520,058866,元油2X國票99購04,,,,,0.00,0.00,0,0,0,0,0,0,0,0,0,0,0,0,0
20200520,058867,元油2X國票99購05,,,,,0.00,0.00,0,0,0,0,0,0,0,0,0,0,0,0,0
20200520,058868,元油2X國票99購06,0.70,0.70,0.66,0.66,+0.01,1.54,55000,3,38300,0,0,0,0,0,0,0,55000,-55000,-55000
20200520,058869,元油2X國票9A購04,,,,,0.00,0.00,0,0,0,0,0,0,0,0,0,0,0,0,0
20200520,05886P,華通元富96售01,3.23,3.38,3.17,3.38,+0.24,7.64,10000,8,32590,0,0,0,0,0,0,5000,5000,0,0
20200520,058870,元油2X國票9A購05,,,,,0.00,0.00,0,0,0,0,0,0,0,0,0,0,0,0,0
20200520,058871,元油2X國票9A購06,,,,,0.00,0.00,0,0,0,0,0,0,0,0,0,0,0,0,0
20200520,058872,元油2X國票9B購01,,,,,0.00,0.00,0,0,0,0,0,0,0,0,0,0,0,0,0
20200520,058873,美律國票9A購02,1.27,1.27,1.26,1.26,-0.03,-2.33,38000,2,48070,0,0,0,0,0,0,19000,19000,0,0
20200520,058874,聯鈞國票9A購01,,,,,0.00,0.00,0,0,0,0,0,0,0,0,0,0,0,0,0
20200520,058875,台表科國票9A購02,11.30,14.70,10.70,14.30,+2.70,23.28,145000,25,1753000,0,0,0,0,0,0,71000,74000,-3000,-3000
20200520,058876,南電國票9A購02,,,,,0.00,0.00,0,0,0,0,0,0,0,0,0,0,0,0,0
20200520,058877,T50反1國泰9B購01,0.95,0.95,0.93,0.94,-0.01,-1.05,75000,4,70650,0,0,0,0,0,0,0,75000,-75000,-75000
20200520,058878,旭富國泰9B購01,2.70,2.77,2.63,2.70,-0.01,-0.37,203000,19,542360,0,0,0,0,0,0,138000,42000,96000,96000
20200520,058879,智邦富邦99購01,,,,,0.00,0.00,0,0,0,0,0,0,0,0,0,0,0,0,0
20200520,05887P,友達元富99售03,2.51,2.56,2.48,2.56,-0.01,-0.39,10000,10,25070,0,0,0,0,0,0,8000,2000,6000,6000
20200520,058880,台灣50永豐99購04,,,,,0.00,0.00,0,0,0,0,0,0,0,0,0,0,0,0,0
20200520,058881,全新永豐99購01,0.52,0.52,0.51,0.51,0.00,0.00,12000,2,6220,0,0,0,0,0,0,0,12000,-12000,-12000
20200520,058882,晶相光永豐99購01,,,,,0.00,0.00,0,0,0,0,0,0,0,0,0,0,0,0,0
20200520,058883,旭富永豐99購01,0.78,0.78,0.78,0.78,0.00,0.00,136000,2,106080,0,0,0,0,0,0,136000,0,136000,136000
20200520,058884,世紀鋼永豐99購02,1.84,1.88,1.84,1.88,+0.05,2.73,84000,7,155900,0,0,0,0,0,0,20000,64000,-44000,-44000
20200520,058885,元石油元大9C購02,0.96,0.96,0.92,0.92,-0.07,-7.07,4000,2,3760,0,0,0,0,0,0,0,2000,-2000,-2000
20200520,058886,元石油元大9C購03,1.47,1.47,1.40,1.40,0.00,0.00,5000,2,7210,0,0,0,0,0,0,0,0,0,0
20200520,058887,元石油元大9C購04,,,,,0.00,0.00,0,0,0,0,0,0,0,0,0,0,0,0,0
20200520,058888,元油2X元大99購16,,,,,0.00,0.00,0,0,0,0,0,0,0,0,0,0,0,0,0
20200520,058889,元油2X元大9C購05,,,,,0.00,0.00,0,0,0,0,0,0,0,0,0,0,0,0,0
20200520,05888P,友達元大97售01,1.76,1.76,1.68,1.68,0.00,0.00,30000,3,51900,0,0,0,0,0,0,10000,30000,-20000,-20000
20200520,058890,元油2X元大9C購06,,,,,0.00,0.00,0,0,0,0,0,0,0,0,0,0,0,0,0
20200520,058891,元油2X元大9C購07,,,,,0.00,0.00,0,0,0,0,0,0,0,0,0,0,0,0,0
20200520,058892,元油2X元大9C購08,0.88,0.95,0.88,0.94,-0.04,-4.08,148000,8,133110,0,0,0,0,0,0,132000,16000,116000,116000
20200520,058893,元油2X元大9C購10,,,,,0.00,0.00,0,0,0,0,0,0,0,0,0,0,0,0,0
20200520,058894,元油2X元大9C購11,,,,,0.00,0.00,0,0,0,0,0,0,0,0,0,0,0,0,0
20200520,058895,鴻海元大99購20,2.74,2.74,2.68,2.68,-0.08,-2.9,2000,2,5420,0,0,0,0,0,0,1000,1000,0,0
20200520,058896,中環元大99購03,1.04,1.14,1.03,1.09,+0.07,6.86,166000,15,180500,0,0,0,0,0,0,60000,111000,-51000,-51000
20200520,058897,國巨元大99購17,2.64,2.64,2.64,2.64,+0.23,9.54,5000,1,13200,0,0,0,0,0,0,5000,0,5000,5000
20200520,058898,台積電元大99購20,,,,,0.00,0.00,0,0,0,0,0,0,0,0,0,0,0,0,0
20200520,058899,旺宏元大99購10,,,,,0.00,0.00,0,0,0,0,0,0,0,0,0,0,0,0,0
20200520,05889P,群創元大98售02,2.29,2.34,2.26,2.34,0.00,0.00,10000,10,22810,0,0,0,0,0,0,9000,1000,8000,8000
20200520,058900,旺宏元大99購11,,,,,0.00,0.00,0,0,0,0,0,0,0,0,0,0,0,0,0
20200520,058901,美律元大99購07,0.90,0.91,0.87,0.88,-0.02,-2.22,157000,9,139920,0,0,0,0,0,0,92000,65000,27000,27000
20200520,058902,聯發科元大99購15,,,,,0.00,0.00,0,0,0,0,0,0,0,0,0,0,0,0,0
20200520,058903,聯發科元大99購16,,,,,0.00,0.00,0,0,0,0,0,0,0,0,0,0,0,0,0
20200520,058904,晶技元大99購05,4.57,4.57,4.57,4.57,0.00,0.00,5000,1,22850,0,0,0,0,0,0,0,5000,-5000,-5000
20200520,058905,京鼎元大99購01,2.24,2.24,2.20,2.20,-0.02,-0.9,27000,2,60080,0,0,0,0,0,0,0,27000,-27000,-27000
20200520,058906,晶相光元大99購01,,,,,0.00,0.00,0,0,0,0,0,0,0,0,0,0,0,0,0
20200520,058907,健策元大99購04,3.42,3.63,3.31,3.58,-0.02,-0.56,143000,15,502200,0,0,0,0,0,0,33000,133000,-100000,-100000
20200520,058908,貿聯元大99購03,1.46,1.48,1.41,1.47,+0.04,2.8,406000,31,593760,0,0,0,0,0,0,284000,134000,150000,150000
20200520,058909,神達元大99購03,2.37,2.59,2.37,2.52,+0.16,6.78,360000,21,887000,0,0,0,0,0,0,60000,310000,-250000,-250000
20200520,05890P,彩晶元大99售01,,,,,0.00,0.00,0,0,0,0,0,0,0,0,0,0,0,0,0
20200520,058910,泰鼎元大99購03,1.60,1.74,1.48,1.74,+0.15,9.43,1443000,100,2339860,16000,0,16000,0,0,0,741000,630000,111000,127000
20200520,058911,茂林元大99購04,1.73,2.05,1.73,2.05,+0.36,21.3,338000,14,631320,0,0,0,0,0,0,61000,328000,-267000,-267000
20200520,058912,祥碩元大99購01,6.95,7.75,6.95,7.70,+1.00,14.93,58000,8,443450,0,0,0,0,0,0,45000,52000,-7000,-7000
20200520,058913,元油2X元富01購01,0.31,0.31,0.28,0.28,+0.01,3.7,9000,7,2550,0,0,0,0,0,0,0,0,0,0
20200520,058914,元油2X元富01購02,0.24,0.24,0.20,0.24,+0.01,4.35,153000,10,33480,0,0,0,0,0,0,0,0,0,0
20200520,058915,SGBR2X元富99購01,,,,,0.00,0.00,0,0,0,0,0,0,0,0,0,0,0,0,0
20200520,058916,SGBR2X元富99購02,,,,,0.00,0.00,0,0,0,0,0,0,0,0,0,0,0,0,0
20200520,058917,SGBR2X元富99購03,,,,,0.00,0.00,0,0,0,0,0,0,0,0,0,0,0,0,0
20200520,058918,SGBR2X元富99購04,,,,,0.00,0.00,0,0,0,0,0,0,0,0,0,0,0,0,0
20200520,058919,SGBR2X元富99購05,,,,,0.00,0.00,0,0,0,0,0,0,0,0,0,0,0,0,0
20200520,05891P,聯發科中信98售03,,,,,0.00,0.00,0,0,0,0,0,0,0,0,0,0,0,0,0
20200520,058920,SGBR2X元富99購06,3.38,3.52,3.38,3.47,-0.04,-1.14,436000,16,1511470,0,0,0,0,0,0,398000,38000,360000,360000
20200520,058921,聯發科元富03購01,,,,,0.00,0.00,0,0,0,0,0,0,0,0,0,0,0,0,0
20200520,058922,聯發科元富03購02,,,,,0.00,0.00,0,0,0,0,0,0,0,0,0,0,0,0,0
20200520,058923,華新科元富99購06,2.34,2.43,2.28,2.33,+0.04,1.75,609000,41,1454020,0,0,0,0,0,0,489000,50000,439000,439000
20200520,058924,晶相光元富99購02,0.59,0.60,0.59,0.60,+0.05,9.09,110000,2,65900,0,0,0,0,0,0,10000,100000,-90000,-90000
20200520,058925,旭富元富99購02,1.36,1.42,1.34,1.39,-0.03,-2.11,136000,7,190960,0,0,0,0,0,0,110000,26000,84000,84000
20200520,058926,勤誠元富99購01,1.27,1.27,1.25,1.25,-0.05,-3.85,25000,2,31650,0,0,0,0,0,0,20000,0,20000,20000
20200520,058927,勤誠元富99購02,1.98,2.04,1.98,2.04,+0.01,0.49,120000,5,242800,0,0,0,0,0,0,120000,0,120000,120000
20200520,058928,國巨統一9C購01,0.67,0.72,0.66,0.68,+0.06,9.68,104000,11,70230,0,0,0,0,0,0,10000,74000,-64000,-64000
20200520,058929,可成統一9C購01,1.13,1.13,1.08,1.10,-0.09,-7.56,716000,17,781700,0,0,0,0,0,0,302000,416000,-114000,-114000
20200520,05892P,大立光中信98售03,,,,,0.00,0.00,0,0,0,0,0,0,0,0,0,0,0,0,0
20200520,058930,華新科統一9B購01,1.19,1.22,1.17,1.17,0.00,0.00,197000,6,234010,0,0,0,0,0,0,161000,36000,125000,125000
20200520,058931,玉晶光統一9C購01,1.27,1.30,1.27,1.30,+0.06,4.84,60000,6,76700,0,0,0,0,0,0,40000,20000,20000,20000
20200520,058932,FBVIX台新99購01,1.43,1.44,1.43,1.44,+0.05,3.6,6000,2,8610,0,0,0,0,0,0,6000,0,6000,6000
20200520,058933,FBVIX台新9B購01,,,,,0.00,0.00,0,0,0,0,0,0,0,0,0,0,0,0,0
20200520,058934,台灣50中信03購03,,,,,0.00,0.00,0,0,0,0,0,0,0,0,0,0,0,0,0
20200520,058935,元油2X中信9C購03,,,,,0.00,0.00,0,0,0,0,0,0,0,0,0,0,0,0,0
20200520,058936,國喬中信99購01,1.32,1.42,1.23,1.25,-0.24,-16.11,1141000,141,1525700,0,0,0,0,0,0,386000,644000,-258000,-258000
20200520,058937,仁寶中信99購01,1.25,1.25,1.21,1.21,-0.05,-3.97,80000,8,98900,0,0,0,0,0,0,30000,50000,-20000,-20000
20200520,058938,台積電中信01購03,,,,,0.00,0.00,0,0,0,0,0,0,0,0,0,0,0,0,0
20200520,058939,台積電中信9B購01,,,,,0.00,0.00,0,0,0,0,0,0,0,0,0,0,0,0,0
20200520,05893P,國巨兆豐96售04,,,,,0.00,0.00,0,0,0,0,0,0,0,0,0,0,0,0,0
20200520,058940,聯發科中信9A購03,5.05,5.40,5.05,5.40,+0.52,10.66,30000,3,156000,0,0,0,0,0,0,30000,0,30000,30000
20200520,058941,華新科中信99購03,,,,,0.00,0.00,0,0,0,0,0,0,0,0,0,0,0,0,0
20200520,058942,南茂中信99購01,1.00,1.06,1.00,1.06,+0.07,7.07,96000,5,98340,0,0,0,0,0,0,20000,76000,-56000,-56000
20200520,058943,元石油群益9C購01,1.30,1.37,1.30,1.32,+0.03,2.33,109000,18,145680,0,0,0,0,0,0,0,102000,-102000,-102000
20200520,058944,元石油群益9C購02,2.10,2.13,2.10,2.13,-0.17,-7.39,51000,2,107130,0,0,0,0,0,0,51000,0,51000,51000
20200520,058945,S&P正2群益9C購01,,,,,0.00,0.00,0,0,0,0,0,0,0,0,0,0,0,0,0
20200520,058946,SGBR2X群益9B購01,,,,,0.00,0.00,0,0,0,0,0,0,0,0,0,0,0,0,0
20200520,058947,SGBR2X群益9B購02,3.53,3.66,3.53,3.63,-0.09,-2.42,261000,28,939680,0,0,0,0,0,0,179000,78000,101000,101000
20200520,058948,道瓊銀群益9C購01,1.88,2.20,1.86,1.86,+0.31,20.0,13000,4,24720,0,0,0,0,0,0,7000,0,7000,7000
20200520,058949,上銀群益99購02,,,,,0.00,0.00,0,0,0,0,0,0,0,0,0,0,0,0,0
20200520,05894P,友達群益98售02,,,,,0.00,0.00,0,0,0,0,0,0,0,0,0,0,0,0,0
20200520,058950,國巨群益99購06,3.43,3.90,3.43,3.50,+0.33,10.41,305000,26,1110520,0,0,0,0,0,0,56000,249000,-193000,-193000
20200520,058951,南電群益99購01,1.91,2.01,1.81,1.85,-0.06,-3.14,175000,13,332930,0,0,0,0,0,0,55000,120000,-65000,-65000
20200520,058952,南茂群益99購01,1.04,1.04,1.04,1.04,0.00,0.00,98000,1,101920,0,0,0,0,0,0,98000,0,98000,98000
20200520,058953,S&P反1國票03購01,,,,,0.00,0.00,0,0,0,0,0,0,0,0,0,0,0,0,0
20200520,058954,元油2X國票9A購07,,,,,0.00,0.00,0,0,0,0,0,0,0,0,0,0,0,0,0
20200520,058955,台積電國票9A購04,3.91,3.93,3.80,3.90,-0.09,-2.26,142000,22,555160,0,0,0,0,0,0,9000,107000,-98000,-98000
20200520,058956,健策國票9A購02,2.56,2.77,2.43,2.72,+0.21,8.37,165000,14,432940,0,0,0,0,0,0,83000,77000,6000,6000
20200520,058957,貿聯國票9A購01,2.40,2.41,2.40,2.41,+0.01,0.42,128000,6,308190,0,0,0,0,0,0,29000,99000,-70000,-70000
20200520,058958,台表科國票9A購03,4.69,5.05,4.52,5.05,+0.57,12.72,35000,6,164540,0,0,0,0,0,0,35000,0,35000,35000
20200520,058959,南茂國票9A購01,2.36,2.46,2.36,2.46,+0.14,6.03,19000,3,46280,0,0,0,0,0,0,0,19000,-19000,-19000
20200520,05895P,奇力新群益96售03,0.89,0.94,0.89,0.94,-0.09,-8.74,12000,2,10780,0,0,0,0,0,0,10000,2000,8000,8000
20200520,058960,臺股指國票99購05,,,,,0.00,0.00,0,0,0,0,0,0,0,0,0,0,0,0,0
20200520,058961,台灣50兆豐9C購01,0.62,0.62,0.56,0.58,-0.02,-3.33,24000,4,14360,0,0,0,0,0,0,4000,20000,-16000,-16000
20200520,058962,元油2X兆豐9A購02,0.12,0.12,0.12,0.12,-0.02,-14.29,70000,3,8400,0,0,0,0,0,0,0,50000,-50000,-50000
20200520,058963,華新科兆豐99購05,1.14,1.19,1.10,1.10,-0.04,-3.51,334000,19,393790,0,0,0,0,0,0,334000,0,334000,334000
20200520,058964,群創兆豐99購01,0.22,0.22,0.22,0.22,0.00,0.00,158000,3,34760,0,0,0,0,0,0,158000,158000,0,0
20200520,058965,祥碩兆豐99購02,3.38,3.38,3.38,3.38,+0.34,11.18,4000,1,13520,0,0,0,0,0,0,0,4000,-4000,-4000
20200520,058966,元油2X日盛99購03,0.55,0.65,0.51,0.61,-0.10,-14.08,231000,13,135280,0,0,0,0,0,0,0,10000,-10000,-10000
20200520,058967,可成麥證99購01,3.26,3.26,3.08,3.08,-0.56,-15.38,5000,2,16120,4000,1000,3000,0,0,0,5000,1000,4000,4000
20200520,058968,T50正2永豐99購01,,,,,0.00,0.00,0,0,0,0,0,0,0,0,0,0,0,0,0
20200520,058969,亞德客永豐99購01,3.16,3.23,3.16,3.23,0.00,0.00,17000,2,54210,0,0,0,0,0,0,0,17000,-17000,-17000
20200520,05896P,宏達電群益96售03,,,,,0.00,0.00,0,0,0,0,0,0,0,0,0,0,0,0,0
20200520,058970,鴻海永豐99購02,,,,,0.00,0.00,0,0,0,0,0,0,0,0,0,0,0,0,0
20200520,058971,台積電永豐99購03,,,,,0.00,0.00,0,0,0,0,0,0,0,0,0,0,0,0,0
20200520,058972,新日興永豐9A購01,0.73,0.83,0.73,0.83,+0.04,5.06,290000,10,230610,0,0,0,0,0,0,19000,271000,-252000,-252000
20200520,058973,麗豐永豐99購01,1.08,1.16,1.08,1.11,-0.04,-3.48,262000,9,298580,0,0,0,0,0,0,189000,73000,116000,116000
20200520,058974,臺股指永豐99購03,,,,,0.00,0.00,0,0,0,0,0,0,0,0,0,0,0,0,0
20200520,058975,台灣50凱基01購02,,,,,0.00,0.00,0,0,0,0,0,0,0,0,0,0,0,0,0
20200520,058976,元油2X凱基9A購09,,,,,0.00,0.00,0,0,0,0,0,0,0,0,0,0,0,0,0
20200520,058977,SGBR2X凱基03購01,3.45,3.61,3.45,3.58,-0.03,-0.83,143000,24,505950,0,0,0,0,0,0,92000,45000,47000,47000
20200520,058978,SGBR2X凱基9A購03,,,,,0.00,0.00,0,0,0,0,0,0,0,0,0,0,0,0,0
20200520,058979,上銀凱基99購04,,,,,0.00,0.00,0,0,0,0,0,0,0,0,0,0,0,0,0
20200520,05897P,國巨凱基96售12,0.52,0.55,0.52,0.55,-0.20,-26.67,102000,2,56040,0,0,0,0,0,0,102000,100000,2000,2000
20200520,058980,鴻海凱基99購06,5.65,5.65,5.50,5.50,-0.20,-3.51,3000,3,16750,0,0,0,0,0,0,3000,3000,0,0
20200520,058981,國巨凱基99購10,1.52,1.52,1.52,1.52,0.00,0.00,30000,3,45600,0,0,0,0,0,0,0,30000,-30000,-30000
20200520,058982,台積電凱基99購08,1.73,1.73,1.73,1.73,+0.02,1.17,3000,1,5190,0,0,0,0,0,0,3000,0,3000,3000
20200520,058983,旺宏凱基99購05,2.31,2.32,2.27,2.27,-0.02,-0.87,27000,3,62390,0,0,0,0,0,0,1000,26000,-25000,-25000
20200520,058984,全新凱基9A購03,0.90,0.90,0.86,0.86,0.00,0.00,25000,3,21800,0,0,0,0,0,0,5000,20000,-15000,-15000
20200520,058985,可成凱基99購03,,,,,0.00,0.00,0,0,0,0,0,0,0,0,0,0,0,0,0
20200520,058986,華新科凱基9A購03,1.35,1.35,1.27,1.28,-0.03,-2.29,19000,7,24600,0,0,0,0,0,0,0,19000,-19000,-19000
20200520,058987,華新科凱基9B購01,,,,,0.00,0.00,0,0,0,0,0,0,0,0,0,0,0,0,0
20200520,058988,大立光凱基9A購02,1.13,1.13,1.13,1.13,0.00,0.00,3000,1,3390,0,0,0,0,0,0,3000,0,3000,3000
20200520,058989,茂林凱基99購02,1.44,1.67,1.44,1.67,+0.33,24.63,401000,33,616260,0,0,0,0,0,0,43000,391000,-348000,-348000
20200520,05898P,旺宏凱基96售06,0.20,0.20,0.20,0.20,-0.01,-4.76,30000,3,6000,0,0,0,0,0,0,0,30000,-30000,-30000
20200520,058990,GIS凱基99購02,2.32,2.39,2.32,2.36,-0.01,-0.42,82000,4,194560,0,0,0,0,0,0,3000,82000,-79000,-79000
20200520,058991,台灣50元大03購01,,,,,0.00,0.00,0,0,0,0,0,0,0,0,0,0,0,0,0
20200520,058992,上証反元大99購02,,,,,0.00,0.00,0,0,0,0,0,0,0,0,0,0,0,0,0
20200520,058993,滬深反元大9C購01,,,,,0.00,0.00,0,0,0,0,0,0,0,0,0,0,0,0,0
20200520,058994,道瓊指元大99購01,0.90,0.91,0.90,0.91,-0.07,-7.14,23000,3,20770,0,0,0,0,0,0,16000,7000,9000,9000
20200520,058995,台達電元大99購01,1.53,1.53,1.47,1.47,-0.02,-1.34,485000,5,723930,0,0,0,0,0,0,482000,3000,479000,479000
20200520,058996,台達電元大99購02,1.53,1.53,1.45,1.45,-0.06,-3.97,591000,14,881280,0,0,0,0,0,0,519000,82000,437000,437000
20200520,058997,鴻海元大99購21,1.23,1.23,1.21,1.21,-0.07,-5.47,12000,2,14720,0,0,0,0,0,0,10000,2000,8000,8000
20200520,058998,鴻海元大99購22,3.20,3.26,3.20,3.26,-0.11,-3.26,50000,2,162400,0,0,0,0,0,0,50000,0,50000,50000
20200520,058999,台積電元大99購24,1.05,1.24,1.05,1.23,0.00,0.00,143000,10,173390,0,0,0,0,0,0,133000,0,133000,133000
20200520,05899P,臺股指凱基96售30,3.34,3.34,3.34,3.34,0.00,0.00,10000,1,33400,0,0,0,0,0,0,0,10000,-10000,-10000
20200520,059000,台積電元大99購25,,,,,0.00,0.00,0,0,0,0,0,0,0,0,0,0,0,0,0
20200520,059001,聯發科元大99購17,10.20,10.20,10.20,10.20,0.00,0.00,10000,1,102000,0,0,0,0,0,0,0,10000,-10000,-10000
20200520,059002,聯發科元大99購18,,,,,0.00,0.00,0,0,0,0,0,0,0,0,0,0,0,0,0
20200520,059003,中壽元大99購01,2.36,2.36,2.36,2.36,-0.04,-1.67,16000,1,37760,0,0,0,0,0,0,16000,0,16000,16000
20200520,059004,嘉晶元大99購05,2.25,2.83,2.21,2.78,+0.59,26.94,650000,75,1620860,0,0,0,0,0,0,316000,414000,-98000,-98000
20200520,059005,嘉晶元大99購06,1.51,1.89,1.48,1.75,+0.28,19.05,2324000,104,3891600,0,0,0,0,0,0,1046000,1130000,-84000,-84000
20200520,059006,樺漢元大99購01,2.05,2.13,2.05,2.13,+0.11,5.45,198000,9,419010,0,0,0,0,0,0,148000,50000,98000,98000
20200520,059007,南電元大99購05,4.33,4.33,4.08,4.13,-0.13,-3.05,20000,6,84780,0,0,0,0,0,0,5000,15000,-10000,-10000
20200520,059008,鈺齊元大99購03,0.81,0.81,0.81,0.81,+0.01,1.25,47000,1,38070,0,0,0,0,0,0,47000,0,47000,47000
20200520,059009,世紀鋼元大99購04,3.83,4.05,3.50,3.50,-0.38,-9.79,390000,58,1484590,0,0,0,0,0,0,168000,345000,-177000,-177000
20200520,05900P,臺股指凱基99售05,,,,,0.00,0.00,0,0,0,0,0,0,0,0,0,0,0,0,0
20200520,059010,臺股指元大99購12,,,,,0.00,0.00,0,0,0,0,0,0,0,0,0,0,0,0,0
20200520,059011,臺股指元大9A購30,,,,,0.00,0.00,0,0,0,0,0,0,0,0,0,0,0,0,0
20200520,059012,臺股指元大9A購31,,,,,0.00,0.00,0,0,0,0,0,0,0,0,0,0,0,0,0
20200520,059013,臺股指元大9A購32,,,,,0.00,0.00,0,0,0,0,0,0,0,0,0,0,0,0,0
20200520,059014,SGBR2X元富03購01,4.19,4.33,4.19,4.33,+0.06,1.41,33000,4,138430,0,0,0,0,0,0,33000,0,33000,33000
20200520,059015,華通元富99購02,,,,,0.00,0.00,0,0,0,0,0,0,0,0,0,0,0,0,0
20200520,059016,晶相光元富99購03,0.72,0.74,0.72,0.74,+0.01,1.37,366000,6,267480,0,0,0,0,0,0,168000,198000,-30000,-30000
20200520,059017,台灣50統一9B購03,,,,,0.00,0.00,0,0,0,0,0,0,0,0,0,0,0,0,0
20200520,059018,滬深2X統一9A購01,,,,,0.00,0.00,0,0,0,0,0,0,0,0,0,0,0,0,0
20200520,059019,元石油統一9B購03,2.43,2.50,2.43,2.48,-0.03,-1.2,528000,23,1308030,0,0,0,0,0,0,372000,134000,238000,238000
20200520,05901P,臺股指凱基9C售01,,,,,0.00,0.00,0,0,0,0,0,0,0,0,0,0,0,0,0
20200520,059020,元油2X統一9B購02,1.30,1.37,1.30,1.37,+0.05,3.79,43000,4,56650,0,0,0,0,0,0,28000,15000,13000,13000
20200520,059021,台積電統一9B購07,0.93,0.93,0.93,0.93,+0.01,1.09,32000,1,29760,0,0,0,0,0,0,0,32000,-32000,-32000
20200520,059022,聯發科統一9B購04,,,,,0.00,0.00,0,0,0,0,0,0,0,0,0,0,0,0,0
20200520,059023,可成統一9B購02,1.25,1.25,1.19,1.21,-0.17,-12.32,50000,7,60640,0,0,0,0,0,0,10000,50000,-40000,-40000
20200520,059024,大立光統一9B購04,0.50,0.50,0.50,0.50,+0.01,2.04,20000,1,10000,0,0,0,0,0,0,0,20000,-20000,-20000
20200520,059025,台灣50台新9B購02,,,,,0.00,0.00,0,0,0,0,0,0,0,0,0,0,0,0,0
20200520,059026,FBVIX台新99購03,,,,,0.00,0.00,0,0,0,0,0,0,0,0,0,0,0,0,0
20200520,059027,神達台新99購02,1.41,1.54,1.41,1.54,+0.08,5.48,37000,3,55610,0,0,0,0,0,0,9000,28000,-19000,-19000
20200520,059028,嘉聯益台新99購02,,,,,0.00,0.00,0,0,0,0,0,0,0,0,0,0,0,0,0
20200520,059029,旺宏兆豐99購01,0.99,0.99,0.99,0.99,+0.01,1.02,21000,2,20790,0,0,0,0,0,0,11000,10000,1000,1000
20200520,05902P,華通國票96售02,3.09,3.09,3.09,3.09,+0.12,4.04,1000,1,3090,0,0,0,0,0,0,1000,0,1000,1000
20200520,059030,奇力新兆豐99購03,0.99,1.02,0.94,0.94,+0.05,5.62,723000,17,712050,0,0,0,0,0,0,56000,667000,-611000,-611000
20200520,059031,元石油中信03購01,1.80,1.85,1.80,1.80,0.00,0.00,53000,4,96510,0,0,0,0,0,0,29000,0,29000,29000
20200520,059032,元石油群益9C購03,0.84,0.89,0.84,0.86,-0.03,-3.37,109000,17,94820,0,0,0,0,0,0,0,109000,-109000,-109000
20200520,059033,元油2X群益9C購05,1.76,1.89,1.76,1.89,+0.43,29.45,9000,3,16470,0,0,0,0,0,0,9000,0,9000,9000
20200520,059034,華通群益9B購02,,,,,0.00,0.00,0,0,0,0,0,0,0,0,0,0,0,0,0
20200520,059035,旺宏群益99購06,,,,,0.00,0.00,0,0,0,0,0,0,0,0,0,0,0,0,0
20200520,059036,可成群益9B購03,2.22,2.22,2.09,2.13,-0.27,-11.25,136000,10,292370,0,0,0,0,0,0,84000,44000,40000,40000
20200520,059037,宏達電群益99購02,2.41,2.55,2.41,2.41,+0.06,2.55,107000,9,265510,0,0,0,0,0,0,70000,49000,21000,21000
20200520,059038,健策群益9A購02,2.18,2.34,2.18,2.32,+0.19,8.92,357000,16,803730,0,0,0,0,0,0,63000,347000,-284000,-284000
20200520,059039,致伸群益99購01,2.37,2.43,2.30,2.43,+0.03,1.25,345000,6,812640,0,0,0,0,0,0,292000,137000,155000,155000
20200520,05903P,聯發科統一96售09,0.73,0.73,0.67,0.67,-0.12,-15.19,2000,2,1400,0,0,0,0,0,0,0,2000,-2000,-2000
20200520,059040,訊芯群益99購03,1.21,1.21,1.17,1.20,0.00,0.00,227000,7,269310,0,0,0,0,0,0,133000,74000,59000,59000
20200520,059041,南茂群益99購02,2.00,2.09,2.00,2.09,+0.14,7.18,88000,8,178850,0,0,0,0,0,0,0,87000,-87000,-87000
20200520,059042,世紀鋼群益99購02,1.60,1.62,1.47,1.49,-0.17,-10.24,31000,5,46870,0,0,0,0,0,0,11000,20000,-9000,-9000
20200520,059043,聯電日盛99購01,,,,,0.00,0.00,0,0,0,0,0,0,0,0,0,0,0,0,0
20200520,059044,聯電日盛99購02,,,,,0.00,0.00,0,0,0,0,0,0,0,0,0,0,0,0,0
20200520,059045,高股息凱基99購01,,,,,0.00,0.00,0,0,0,0,0,0,0,0,0,0,0,0,0
20200520,059046,滬深2X凱基9C購01,,,,,0.00,0.00,0,0,0,0,0,0,0,0,0,0,0,0,0
20200520,059047,元油2X凱基9A購10,1.16,1.32,1.16,1.24,-0.08,-6.06,399000,18,480750,0,0,0,0,0,0,283000,137000,146000,146000
20200520,059048,元油2X凱基9A購11,,,,,0.00,0.00,0,0,0,0,0,0,0,0,0,0,0,0,0
20200520,059049,元油2X凱基9A購12,,,,,0.00,0.00,0,0,0,0,0,0,0,0,0,0,0,0,0
20200520,05904P,大立光統一96售07,,,,,0.00,0.00,0,0,0,0,0,0,0,0,0,0,0,0,0
20200520,059050,元油2X凱基9B購08,1.27,1.34,1.27,1.34,+0.01,0.75,17000,3,22530,0,0,0,0,0,0,17000,0,17000,17000
20200520,059051,和大凱基9A購01,0.97,1.13,0.97,1.12,+0.10,9.8,670000,21,692330,0,0,0,0,0,0,251000,419000,-168000,-168000
20200520,059052,為升凱基99購01,,,,,0.00,0.00,0,0,0,0,0,0,0,0,0,0,0,0,0
20200520,059053,鴻海凱基99購07,,,,,0.00,0.00,0,0,0,0,0,0,0,0,0,0,0,0,0
20200520,059054,國巨凱基99購11,1.91,1.91,1.86,1.86,+0.16,9.41,20000,2,37700,0,0,0,0,0,0,0,20000,-20000,-20000
20200520,059055,旺宏凱基9B購02,,,,,0.00,0.00,0,0,0,0,0,0,0,0,0,0,0,0,0
20200520,059056,技嘉凱基99購02,4.52,4.52,4.52,4.52,-0.11,-2.38,1000,1,4520,0,0,0,0,0,0,1000,1000,0,0
20200520,059057,聯發科凱基99購10,,,,,0.00,0.00,0,0,0,0,0,0,0,0,0,0,0,0,0
20200520,059058,可成凱基9B購01,2.92,2.92,2.79,2.79,-0.64,-18.66,2000,2,5710,0,0,0,0,0,0,2000,2000,0,0
20200520,059059,宏達電凱基99購03,0.93,0.95,0.93,0.95,+0.05,5.56,70000,3,65140,0,0,0,0,0,0,70000,2000,68000,68000
20200520,05905P,晶技統一97售01,0.74,0.80,0.72,0.78,+0.02,2.63,98000,21,75180,0,0,0,0,0,0,95000,3000,92000,92000
20200520,059060,大立光凱基9A購03,,,,,0.00,0.00,0,0,0,0,0,0,0,0,0,0,0,0,0
20200520,059061,晶技凱基9A購01,,,,,0.00,0.00,0,0,0,0,0,0,0,0,0,0,0,0,0
20200520,059062,群創凱基99購05,1.05,1.07,1.04,1.04,0.00,0.00,100000,4,104990,0,0,0,0,0,0,100000,100000,0,0
20200520,059063,康控凱基99購04,1.32,1.32,1.21,1.21,-0.01,-0.82,351000,25,436270,0,0,0,0,0,0,283000,0,283000,283000
20200520,059064,緯穎凱基99購02,2.18,2.27,2.08,2.08,-0.04,-1.89,211000,21,468440,0,0,0,0,0,0,151000,60000,91000,91000
20200520,059065,南電凱基9A購01,1.72,1.85,1.63,1.65,-0.07,-4.07,92000,10,160550,0,0,0,0,0,0,55000,37000,18000,18000
20200520,059066,道瓊指國票04購01,,,,,0.00,0.00,0,0,0,0,0,0,0,0,0,0,0,0,0
20200520,059067,上銀國票9A購02,,,,,0.00,0.00,0,0,0,0,0,0,0,0,0,0,0,0,0
20200520,059068,台虹國票9A購01,2.27,2.31,2.23,2.26,-0.06,-2.59,405000,5,918850,0,0,0,0,0,0,150000,255000,-105000,-105000
20200520,059069,臺指反元大9C購01,,,,,0.00,0.00,0,0,0,0,0,0,0,0,0,0,0,0,0
20200520,05906P,國巨元富96售05,,,,,0.00,0.00,0,0,0,0,0,0,0,0,0,0,0,0,0
20200520,059070,道瓊指元大99購02,1.30,1.34,1.30,1.34,-0.02,-1.47,62000,5,82050,0,0,0,0,0,0,10000,52000,-42000,-42000
20200520,059071,元油2X元大9C購12,1.60,1.66,1.60,1.66,-0.04,-2.35,59000,5,96200,0,0,0,0,0,0,30000,29000,1000,1000
20200520,059072,元油2X元大9C購13,1.51,1.64,1.51,1.64,-0.14,-7.87,214000,13,337410,0,0,0,0,0,0,214000,0,214000,214000
20200520,059073,元油2X元大9C購14,1.50,1.62,1.50,1.58,+0.36,29.51,21000,5,32700,0,0,0,0,0,0,21000,0,21000,21000
20200520,059074,元油2X元大9C購15,1.88,1.89,1.79,1.81,-0.11,-5.73,225000,17,413750,0,0,0,0,0,0,95000,130000,-35000,-35000
20200520,059075,FBVIX元大99購01,1.82,1.82,1.82,1.82,+0.06,3.41,3000,1,5460,0,0,0,0,0,0,3000,0,3000,3000
20200520,059076,FBVIX元大99購04,,,,,0.00,0.00,0,0,0,0,0,0,0,0,0,0,0,0,0
20200520,059077,FBVIX元大99購05,1.74,1.74,1.74,1.74,+0.06,3.57,15000,1,26100,0,0,0,0,0,0,0,15000,-15000,-15000
20200520,059078,FBVIX元大99購06,1.78,1.78,1.78,1.78,+0.05,2.89,1000,1,1780,0,0,0,0,0,0,0,1000,-1000,-1000
20200520,059079,SGBR2X元大99購01,,,,,0.00,0.00,0,0,0,0,0,0,0,0,0,0,0,0,0
20200520,05907P,聯發科元富96售05,1.52,1.55,1.46,1.48,-0.17,-10.3,52000,14,78670,0,0,0,0,0,0,23000,29000,-6000,-6000
20200520,059080,亞泥元大99購01,2.37,2.37,2.36,2.36,-0.05,-2.07,11000,2,26060,0,0,0,0,0,0,11000,1000,10000,10000
20200520,059081,和大元大99購01,0.92,1.07,0.92,1.07,0.00,0.00,15000,2,15300,0,0,0,0,0,0,5000,10000,-5000,-5000
20200520,059082,華通元大99購06,1.08,1.08,1.06,1.06,-0.03,-2.75,15000,2,16100,0,0,0,0,0,0,0,15000,-15000,-15000
20200520,059083,華通元大99購07,1.08,1.08,1.08,1.08,-0.03,-2.7,1000,1,1080,0,0,0,0,0,0,1000,0,1000,1000
20200520,059084,鴻海元大99購24,,,,,0.00,0.00,0,0,0,0,0,0,0,0,0,0,0,0,0
20200520,059085,鴻海元大99購25,3.43,3.43,3.43,3.43,-0.02,-0.58,1000,1,3430,0,0,0,0,0,0,1000,1000,0,0
20200520,059086,國巨元大99購18,0.99,1.09,0.99,1.00,+0.06,6.38,1443000,55,1484980,0,0,0,0,0,0,256000,1157000,-901000,-901000
20200520,059087,台積電元大99購26,3.78,3.78,3.78,3.78,+0.06,1.61,30000,1,113400,0,0,0,0,0,0,30000,0,30000,30000
20200520,059088,台積電元大99購27,,,,,0.00,0.00,0,0,0,0,0,0,0,0,0,0,0,0,0
20200520,059089,聯發科元大99購19,5.80,6.10,5.80,5.90,+0.20,3.51,29000,3,169300,0,0,0,0,0,0,7000,22000,-15000,-15000
20200520,05908P,大立光元富96售05,5.15,5.15,5.15,5.15,0.00,0.00,16000,2,82400,0,0,0,0,0,0,16000,0,16000,16000
20200520,059090,台新金元大99購01,,,,,0.00,0.00,0,0,0,0,0,0,0,0,0,0,0,0,0
20200520,059091,中信金元大99購01,0.75,0.75,0.71,0.71,0.00,0.00,20000,3,14500,0,0,0,0,0,0,15000,0,15000,15000
20200520,059092,聯陽元大99購01,,,,,0.00,0.00,0,0,0,0,0,0,0,0,0,0,0,0,0
20200520,059093,旭富元大99購01,1.14,1.17,1.13,1.14,0.00,0.00,337000,5,384680,0,0,0,0,0,0,200000,337000,-137000,-137000
20200520,059094,臻鼎元大99購03,,,,,0.00,0.00,0,0,0,0,0,0,0,0,0,0,0,0,0
20200520,059095,訊芯元大99購01,1.00,1.03,0.99,0.99,0.00,0.00,565000,26,567820,0,0,0,0,0,0,478000,221000,257000,257000
20200520,059096,百和元大99購04,1.82,1.82,1.71,1.73,-0.02,-1.14,430000,17,756380,0,0,0,0,0,0,369000,60000,309000,309000
20200520,059097,世紀鋼元大99購05,1.17,1.20,1.03,1.03,-0.12,-10.43,171000,12,192880,0,0,0,0,0,0,146000,45000,101000,101000
20200520,059098,元油2X統一9B購03,0.34,0.37,0.34,0.34,-0.03,-8.11,93000,12,32740,0,0,0,0,0,0,0,0,0,0
20200520,059099,元油2X統一9C購01,,,,,0.00,0.00,0,0,0,0,0,0,0,0,0,0,0,0,0
20200520,05909P,康友元富96售02,,,,,0.00,0.00,0,0,0,0,0,0,0,0,0,0,0,0,0
20200520,059100,元油2X統一9C購02,0.77,0.79,0.74,0.79,-0.02,-2.47,338000,18,259590,0,0,0,0,0,0,149000,145000,4000,4000
20200520,059101,康控統一9A購01,0.76,0.77,0.69,0.69,0.00,0.00,842000,75,622780,0,0,0,0,0,0,709000,133000,576000,576000
20200520,059102,聯鈞元富99購01,,,,,0.00,0.00,0,0,0,0,0,0,0,0,0,0,0,0,0
20200520,059103,旭富元富99購03,,,,,0.00,0.00,0,0,0,0,0,0,0,0,0,0,0,0,0
20200520,059104,臺股指元富99購05,,,,,0.00,0.00,0,0,0,0,0,0,0,0,0,0,0,0,0
20200520,059105,臺股指元富99購06,,,,,0.00,0.00,0,0,0,0,0,0,0,0,0,0,0,0,0
20200520,059106,臺股指元富99購07,,,,,0.00,0.00,0,0,0,0,0,0,0,0,0,0,0,0,0
20200520,059107,南茂國泰9A購01,1.80,1.89,1.80,1.89,+0.13,7.39,114000,7,209730,0,0,0,0,0,0,28000,86000,-58000,-58000
20200520,059108,台灣50富邦9B購01,,,,,0.00,0.00,0,0,0,0,0,0,0,0,0,0,0,0,0
20200520,059109,台積電富邦9C購03,,,,,0.00,0.00,0,0,0,0,0,0,0,0,0,0,0,0,0
20200520,05910P,力山永豐96售02,0.70,0.71,0.70,0.71,-0.02,-2.74,30000,2,21050,0,0,0,0,0,0,30000,0,30000,30000
20200520,059110,元油2X永豐99購02,,,,,0.00,0.00,0,0,0,0,0,0,0,0,0,0,0,0,0
20200520,059111,元油2X永豐99購03,,,,,0.00,0.00,0,0,0,0,0,0,0,0,0,0,0,0,0
20200520,059112,上銀永豐99購01,,,,,0.00,0.00,0,0,0,0,0,0,0,0,0,0,0,0,0
20200520,059113,群光永豐99購01,2.10,2.10,2.10,2.10,+0.08,3.96,51000,2,107100,0,0,0,0,0,0,0,51000,-51000,-51000
20200520,059114,華新科永豐99購05,0.77,0.83,0.77,0.78,+0.01,1.3,47000,6,37700,0,0,0,0,0,0,26000,27000,-1000,-1000
20200520,059115,美食永豐99購01,3.04,3.11,2.71,2.83,+0.10,3.66,328000,33,968900,0,0,0,0,0,0,315000,10000,305000,305000
20200520,059116,晶豪科永豐99購01,3.08,3.08,2.87,2.87,0.00,0.00,47000,2,139090,0,0,0,0,0,0,47000,27000,20000,20000
20200520,059117,禾伸堂永豐99購01,2.77,2.77,2.77,2.77,0.00,0.00,10000,1,27700,0,0,0,0,0,0,0,10000,-10000,-10000
20200520,059118,晶技永豐9A購01,2.86,2.86,2.84,2.84,-0.11,-3.73,27000,2,76780,0,0,0,0,0,0,5000,22000,-17000,-17000
20200520,059119,華擎永豐99購02,2.50,2.64,2.50,2.55,+0.28,12.33,24000,5,61280,0,0,0,0,0,0,4000,20000,-16000,-16000
20200520,05911P,南亞科永豐96售03,2.16,2.16,2.01,2.14,-0.17,-7.36,97000,12,205220,0,0,0,0,0,0,35000,62000,-27000,-27000
20200520,059120,致伸永豐99購01,2.57,2.73,2.57,2.73,+0.04,1.49,124000,4,321800,0,0,0,0,0,0,81000,124000,-43000,-43000
20200520,059121,瑞儀永豐99購01,2.23,2.36,2.21,2.36,+0.05,2.16,108000,12,245450,0,0,0,0,0,0,26000,91000,-65000,-65000
20200520,059122,超眾永豐99購01,,,,,0.00,0.00,0,0,0,0,0,0,0,0,0,0,0,0,0
20200520,059123,訊芯永豐99購03,0.95,0.95,0.91,0.92,+0.01,1.1,300000,14,279030,0,0,0,0,0,0,178000,122000,56000,56000
20200520,059124,台積電第一03購01,,,,,0.00,0.00,0,0,0,0,0,0,0,0,0,0,0,0,0
20200520,059125,台積電第一03購02,,,,,0.00,0.00,0,0,0,0,0,0,0,0,0,0,0,0,0
20200520,059126,臺指反中信9B購01,1.62,1.62,1.61,1.61,-0.05,-3.01,56000,2,90290,0,0,0,0,0,0,56000,0,56000,56000
20200520,059127,國巨中信99購04,0.88,0.90,0.88,0.90,+0.07,8.43,192000,5,170780,0,0,0,0,0,0,29000,163000,-134000,-134000
20200520,059128,友達中信99購02,0.84,0.92,0.80,0.80,-0.01,-1.23,1500000,43,1261790,0,0,0,0,0,0,1057000,443000,614000,614000
20200520,059129,麗豐中信99購01,1.53,1.60,1.53,1.60,+0.02,1.27,80000,7,126700,0,0,0,0,0,0,30000,50000,-20000,-20000
20200520,05912P,和大元大96售01,1.55,1.55,1.55,1.55,0.00,0.00,10000,1,15500,0,0,0,0,0,0,10000,0,10000,10000
20200520,059130,台灣50群益9B購05,,,,,0.00,0.00,0,0,0,0,0,0,0,0,0,0,0,0,0
20200520,059131,國巨群益99購07,3.36,3.43,3.36,3.43,+0.19,5.86,13000,2,43820,0,0,0,0,0,0,11000,2000,9000,9000
20200520,059132,臺股指群益99購07,,,,,0.00,0.00,0,0,0,0,0,0,0,0,0,0,0,0,0
20200520,059133,臺股指群益99購08,4.92,4.92,4.75,4.83,+0.02,0.42,13000,4,62990,0,0,0,0,0,0,8000,5000,3000,3000
20200520,059134,臺股指群益99購09,5.65,5.65,5.65,5.65,0.00,0.00,10000,1,56500,0,0,0,0,0,0,10000,0,10000,10000
20200520,059135,臺股指群益99購10,,,,,0.00,0.00,0,0,0,0,0,0,0,0,0,0,0,0,0
20200520,059136,臺股指群益99購11,,,,,0.00,0.00,0,0,0,0,0,0,0,0,0,0,0,0,0
20200520,059137,電子類群益99購01,2.24,2.27,2.21,2.21,+0.01,0.45,50000,5,111310,0,0,0,0,0,0,26000,24000,2000,2000
20200520,059138,台積電兆豐99購04,,,,,0.00,0.00,0,0,0,0,0,0,0,0,0,0,0,0,0
20200520,059139,全新兆豐9A購01,1.50,1.50,1.37,1.37,-0.12,-8.05,172000,4,238130,0,0,0,0,0,0,7000,165000,-158000,-158000
20200520,05913P,國巨元大96售11,,,,,0.00,0.00,0,0,0,0,0,0,0,0,0,0,0,0,0
20200520,059140,大立光兆豐9A購02,1.09,1.10,1.09,1.10,0.00,0.00,175000,5,191720,0,0,0,0,0,0,0,175000,-175000,-175000
20200520,059141,臺股指兆豐99購01,,,,,0.00,0.00,0,0,0,0,0,0,0,0,0,0,0,0,0
20200520,059142,道瓊指國票9B購02,1.93,1.93,1.92,1.93,-0.08,-3.98,35000,3,67450,0,0,0,0,0,0,10000,25000,-15000,-15000
20200520,059143,國巨國票9A購04,7.70,8.35,7.70,7.90,+0.65,8.97,82000,17,667300,0,0,0,0,0,0,11000,77000,-66000,-66000
20200520,059144,嘉晶國票9A購02,3.92,4.39,3.92,4.39,+0.54,14.03,70000,9,284560,0,0,0,0,0,0,42000,28000,14000,14000
20200520,059145,創意國票99購02,16.00,16.00,16.00,16.00,-0.10,-0.62,2000,2,32000,0,0,0,0,0,0,2000,2000,0,0
20200520,059146,貿聯國票9A購02,3.22,3.31,3.12,3.31,+0.13,4.09,299000,11,968070,0,0,0,0,0,0,165000,134000,31000,31000
20200520,059147,矽創國票99購01,6.15,6.20,5.25,5.25,-0.75,-12.5,141000,29,861450,0,0,0,0,0,0,131000,10000,121000,121000
20200520,059148,百和國票9A購01,5.10,5.10,4.93,4.93,-0.12,-2.38,46000,3,232900,0,0,0,0,0,0,46000,0,46000,46000
20200520,059149,臺股指國票99購12,6.20,6.25,6.00,6.15,0.00,0.00,4000,4,24600,0,0,0,0,0,0,3000,1000,2000,2000
20200520,05914P,友達元大96售04,,,,,0.00,0.00,0,0,0,0,0,0,0,0,0,0,0,0,0
20200520,059150,臺股指國票99購13,,,,,0.00,0.00,0,0,0,0,0,0,0,0,0,0,0,0,0
20200520,059151,臺股指國票99購14,4.60,4.66,4.45,4.53,+0.03,0.67,64000,13,291330,0,0,0,0,0,0,50000,14000,36000,36000
20200520,059152,臺股指國票99購15,4.20,4.20,4.11,4.11,+0.03,0.74,6000,2,24750,0,0,0,0,0,0,0,6000,-6000,-6000
20200520,059153,臺股指國票99購16,3.56,3.62,3.43,3.48,-0.02,-0.57,77000,20,272780,0,0,0,0,0,0,45000,32000,13000,13000
20200520,059154,可成日盛99購02,,,,,0.00,0.00,0,0,0,0,0,0,0,0,0,0,0,0,0
20200520,059155,台表科日盛99購01,2.49,3.13,2.42,3.13,+0.73,30.42,1740000,92,4558130,0,0,0,0,0,0,874000,874000,0,0
20200520,059156,台灣50凱基01購03,,,,,0.00,0.00,0,0,0,0,0,0,0,0,0,0,0,0,0
20200520,059157,元石油凱基9C購01,,,,,0.00,0.00,0,0,0,0,0,0,0,0,0,0,0,0,0
20200520,059158,S&P正2凱基99購01,,,,,0.00,0.00,0,0,0,0,0,0,0,0,0,0,0,0,0
20200520,059159,上銀凱基99購05,,,,,0.00,0.00,0,0,0,0,0,0,0,0,0,0,0,0,0
20200520,05915P,聯發科元大96售19,1.66,1.68,1.56,1.68,-0.12,-6.67,41000,4,66300,0,0,0,0,0,0,26000,15000,11000,11000
20200520,059160,華通凱基99購03,2.25,2.25,2.25,2.25,0.00,0.00,18000,1,40500,0,0,0,0,0,0,0,18000,-18000,-18000
20200520,059161,鴻海凱基9A購09,,,,,0.00,0.00,0,0,0,0,0,0,0,0,0,0,0,0,0
20200520,059162,國巨凱基99購12,4.42,4.45,4.15,4.15,+0.28,7.24,26000,5,112880,0,0,0,0,0,0,2000,26000,-24000,-24000
20200520,059163,台積電凱基99購10,3.27,3.27,3.27,3.27,0.00,0.00,10000,1,32700,0,0,0,0,0,0,10000,0,10000,10000
20200520,059164,旺宏凱基99購06,4.49,4.51,4.46,4.51,+0.05,1.12,29000,3,130330,0,0,0,0,0,0,29000,29000,0,0
20200520,059165,南亞科凱基99購04,3.62,3.62,3.62,3.62,+0.16,4.62,10000,1,36200,0,0,0,0,0,0,10000,0,10000,10000
20200520,059166,友達凱基99購05,1.15,1.21,1.15,1.19,+0.06,5.31,390000,7,463320,0,0,0,0,0,0,235000,155000,80000,80000
20200520,059167,聯發科凱基99購11,,,,,0.00,0.00,0,0,0,0,0,0,0,0,0,0,0,0,0
20200520,059168,奇力新凱基99購05,1.05,1.11,1.04,1.05,+0.03,2.94,412000,7,437670,0,0,0,0,0,0,285000,127000,158000,158000
20200520,059169,可成凱基99購04,2.44,2.44,2.44,2.44,-0.34,-12.23,1000,1,2440,0,0,0,0,0,0,1000,1000,0,0
20200520,05916P,聯發科元大96售20,2.20,2.38,2.20,2.38,-0.28,-10.53,16000,7,36840,0,0,0,0,0,0,8000,8000,0,0
20200520,059170,康控凱基9B購01,1.08,1.08,1.04,1.04,-0.01,-0.95,362000,31,380800,0,0,0,0,0,0,359000,21000,338000,338000
20200520,059171,祥碩凱基99購04,4.45,4.65,4.45,4.65,+0.57,13.97,30000,4,137500,0,0,0,0,0,0,0,30000,-30000,-30000
20200520,059172,台郡凱基99購03,1.72,1.72,1.72,1.72,0.00,0.00,34000,2,58480,0,0,0,0,0,0,0,34000,-34000,-34000
20200520,059173,矽力凱基99購01,4.01,4.01,4.01,4.01,0.00,0.00,20000,2,80200,0,0,0,0,0,0,0,20000,-20000,-20000
20200520,059174,訊芯凱基99購01,1.79,1.79,1.75,1.76,+0.01,0.57,255000,21,451510,0,0,0,0,0,0,255000,68000,187000,187000
20200520,059175,臺股指凱基99購26,,,,,0.00,0.00,0,0,0,0,0,0,0,0,0,0,0,0,0
20200520,059176,臺股指凱基99購27,2.54,2.60,2.48,2.48,0.00,0.00,317000,16,795220,0,0,0,0,0,0,135000,182000,-47000,-47000
20200520,059177,臺股指凱基99購28,2.21,2.21,2.14,2.14,+0.04,1.9,4000,3,8650,0,0,0,0,0,0,4000,0,4000,4000
20200520,059178,臺股指凱基99購30,,,,,0.00,0.00,0,0,0,0,0,0,0,0,0,0,0,0,0
20200520,059179,祥碩元富99購01,5.85,6.00,5.85,6.00,0.00,0.00,161000,7,949500,0,0,0,0,0,0,128000,0,128000,128000
20200520,05917P,宏達電元大96售02,,,,,0.00,0.00,0,0,0,0,0,0,0,0,0,0,0,0,0
20200520,059180,祥碩元富9A購01,4.20,4.39,4.20,4.39,+0.54,14.03,31000,10,133590,0,0,0,0,0,0,26000,0,26000,26000
20200520,059181,世紀鋼元富9C購01,2.15,2.18,2.03,2.03,-0.15,-6.88,210000,10,439040,0,0,0,0,0,0,26000,184000,-158000,-158000
20200520,059182,台灣50台新9B購03,,,,,0.00,0.00,0,0,0,0,0,0,0,0,0,0,0,0,0
20200520,059183,T50反1台新03購02,0.47,0.48,0.47,0.48,0.00,0.00,460000,46,219300,0,0,0,0,0,0,0,460000,-460000,-460000
20200520,059184,晶技台新99購01,,,,,0.00,0.00,0,0,0,0,0,0,0,0,0,0,0,0,0
20200520,059185,臺股指台新99購12,,,,,0.00,0.00,0,0,0,0,0,0,0,0,0,0,0,0,0
20200520,059186,華通富邦9A購01,1.26,1.26,1.26,1.26,+0.06,5.0,5000,1,6300,0,0,0,0,0,0,0,5000,-5000,-5000
20200520,059187,國巨富邦9B購02,1.58,1.58,1.53,1.53,0.00,0.00,11000,4,17330,0,0,0,0,0,0,1000,10000,-9000,-9000
20200520,059188,京元電富邦9B購01,0.82,0.84,0.79,0.79,-0.09,-10.23,632000,75,506380,0,0,0,0,0,0,2000,608000,-606000,-606000
20200520,059189,國泰金富邦9B購01,2.45,2.54,2.45,2.52,+0.08,3.28,355000,21,883810,0,0,0,0,0,0,253000,96000,157000,157000
20200520,05918P,大立光元大96售11,,,,,0.00,0.00,0,0,0,0,0,0,0,0,0,0,0,0,0
20200520,059190,欣興富邦9A購01,1.74,1.74,1.53,1.53,-0.08,-4.97,3000,3,4930,0,0,0,0,0,0,0,2000,-2000,-2000
20200520,059191,茂林富邦9B購01,1.25,1.25,1.25,1.25,0.00,0.00,5000,1,6250,0,0,0,0,0,0,5000,0,5000,5000
20200520,059192,臺股指富邦9C購01,3.74,3.74,3.72,3.72,+0.01,0.27,7000,3,26160,0,0,0,0,0,0,3000,4000,-1000,-1000
20200520,059193,台灣50永豐99購05,,,,,0.00,0.00,0,0,0,0,0,0,0,0,0,0,0,0,0
20200520,059194,元金2X永豐99購01,1.86,1.86,1.84,1.85,+0.12,6.94,61000,7,113080,0,0,0,0,0,0,35000,26000,9000,9000
20200520,059195,國巨永豐99購04,3.04,3.27,3.04,3.27,0.00,0.00,16000,2,50020,0,0,0,0,0,0,10000,6000,4000,4000
20200520,059196,聯發科永豐99購02,4.38,4.71,4.38,4.71,+0.50,11.88,17000,3,77180,0,0,0,0,0,0,4000,13000,-9000,-9000
20200520,059197,可成永豐99購02,2.57,2.57,2.44,2.44,-0.43,-14.98,6000,2,15290,0,0,0,0,0,0,6000,1000,5000,5000
20200520,059198,華新科永豐99購06,1.30,1.36,1.30,1.36,+0.09,7.09,76000,3,99460,0,0,0,0,0,0,65000,11000,54000,54000
20200520,059199,欣興永豐99購02,3.93,3.93,3.93,3.93,0.00,0.00,17000,1,66810,0,0,0,0,0,0,0,17000,-17000,-17000
20200520,05919P,京鼎元大96售03,1.13,1.14,1.09,1.12,-0.04,-3.45,270000,14,300760,0,0,0,0,0,0,260000,250000,10000,10000
20200520,059200,京鼎永豐99購02,1.98,1.98,1.98,1.98,-0.06,-2.94,2000,1,3960,0,0,0,0,0,0,0,2000,-2000,-2000
20200520,059201,祥碩永豐99購02,3.60,3.60,3.60,3.60,+0.20,5.88,10000,1,36000,0,0,0,0,0,0,10000,0,10000,10000
20200520,059202,禾聯碩永豐99購01,,,,,0.00,0.00,0,0,0,0,0,0,0,0,0,0,0,0,0
20200520,059203,勤誠永豐99購02,2.12,2.12,2.12,2.12,-0.04,-1.85,2000,1,4240,0,0,0,0,0,0,2000,0,2000,2000
20200520,059204,台灣50元大01購02,,,,,0.00,0.00,0,0,0,0,0,0,0,0,0,0,0,0,0
20200520,059205,元石油元大99購01,1.85,1.86,1.85,1.86,-0.04,-2.11,110000,2,204500,0,0,0,0,0,0,0,110000,-110000,-110000
20200520,059206,元石油元大99購02,,,,,0.00,0.00,0,0,0,0,0,0,0,0,0,0,0,0,0
20200520,059207,臺指反元大9C購02,1.44,1.44,1.44,1.44,-0.01,-0.69,15000,1,21600,0,0,0,0,0,0,0,15000,-15000,-15000
20200520,059208,SGBR2X元大99購02,1.29,1.29,1.04,1.27,-0.03,-2.31,42000,13,48230,0,0,0,0,0,0,0,0,0,0
20200520,059209,華通元大99購08,,,,,0.00,0.00,0,0,0,0,0,0,0,0,0,0,0,0,0
20200520,05920P,力成元大96售04,,,,,0.00,0.00,0,0,0,0,0,0,0,0,0,0,0,0,0
20200520,059210,鴻海元大99購26,,,,,0.00,0.00,0,0,0,0,0,0,0,0,0,0,0,0,0
20200520,059211,鴻海元大99購27,,,,,0.00,0.00,0,0,0,0,0,0,0,0,0,0,0,0,0
20200520,059212,鴻海元大99購28,3.85,3.85,3.78,3.78,-0.04,-1.05,4000,2,15330,0,0,0,0,0,0,1000,4000,-3000,-3000
20200520,059213,國巨元大99購19,4.09,4.36,4.03,4.13,+0.29,7.55,131000,34,548440,0,0,0,0,0,0,70000,63000,7000,7000
20200520,059214,國巨元大99購20,4.49,4.80,4.49,4.52,+0.28,6.6,37000,11,170430,0,0,0,0,0,0,11000,23000,-12000,-12000
20200520,059215,台積電元大99購28,1.73,1.74,1.69,1.73,+0.02,1.17,160000,9,274650,0,0,0,0,0,0,135000,25000,110000,110000
20200520,059216,台積電元大99購29,,,,,0.00,0.00,0,0,0,0,0,0,0,0,0,0,0,0,0
20200520,059217,台積電元大99購30,3.91,3.91,3.83,3.83,-0.04,-1.03,40000,3,154000,0,0,0,0,0,0,40000,0,40000,40000
20200520,059218,台積電元大99購31,,,,,0.00,0.00,0,0,0,0,0,0,0,0,0,0,0,0,0
20200520,059219,旺宏元大99購12,1.69,1.71,1.69,1.71,+0.03,1.79,35000,3,59350,0,0,0,0,0,0,20000,15000,5000,5000
20200520,05921P,同欣電元大96售06,0.66,0.66,0.60,0.64,-0.02,-3.03,142000,3,86920,0,0,0,0,0,0,42000,100000,-58000,-58000
20200520,059220,聯發科元大99購20,,,,,0.00,0.00,0,0,0,0,0,0,0,0,0,0,0,0,0
20200520,059221,聯發科元大99購21,,,,,0.00,0.00,0,0,0,0,0,0,0,0,0,0,0,0,0
20200520,059222,聯發科元大99購22,,,,,0.00,0.00,0,0,0,0,0,0,0,0,0,0,0,0,0
20200520,059223,大立光元大99購14,3.14,3.14,3.14,3.14,+0.02,0.64,1000,1,3140,0,0,0,0,0,0,0,1000,-1000,-1000
20200520,059224,大立光元大99購15,2.97,3.09,2.97,2.98,+0.03,1.02,55000,4,166700,0,0,0,0,0,0,15000,40000,-25000,-25000
20200520,059225,臺股指元大99購18,,,,,0.00,0.00,0,0,0,0,0,0,0,0,0,0,0,0,0
20200520,059226,臺股指元大99購19,,,,,0.00,0.00,0,0,0,0,0,0,0,0,0,0,0,0,0
20200520,059227,臺股指元大99購20,,,,,0.00,0.00,0,0,0,0,0,0,0,0,0,0,0,0,0
20200520,059228,臺股指元大99購21,,,,,0.00,0.00,0,0,0,0,0,0,0,0,0,0,0,0,0
20200520,059229,臺股指元大99購22,4.80,4.80,4.80,4.80,+0.08,1.69,5000,1,24000,0,0,0,0,0,0,5000,0,5000,5000
20200520,05922P,京元電兆豐96售01,1.85,1.90,1.82,1.90,+0.17,9.83,64000,7,119550,0,0,0,0,0,0,19000,45000,-26000,-26000
20200520,059230,滬深2X國票9B購02,1.54,1.56,1.54,1.56,0.00,0.00,273000,2,425780,0,0,0,0,0,0,268000,5000,263000,263000
20200520,059231,華通國票9A購04,,,,,0.00,0.00,0,0,0,0,0,0,0,0,0,0,0,0,0
20200520,059232,台灣50凱基03購01,,,,,0.00,0.00,0,0,0,0,0,0,0,0,0,0,0,0,0
20200520,059233,台灣50凱基9C購02,,,,,0.00,0.00,0,0,0,0,0,0,0,0,0,0,0,0,0
20200520,059234,台灣50凱基9C購03,,,,,0.00,0.00,0,0,0,0,0,0,0,0,0,0,0,0,0
20200520,059235,鴻海凱基99購08,,,,,0.00,0.00,0,0,0,0,0,0,0,0,0,0,0,0,0
20200520,059236,鴻海凱基99購09,2.01,2.02,1.95,1.95,-0.03,-1.52,97000,18,193620,0,0,0,0,0,0,94000,93000,1000,1000
20200520,059237,鴻海凱基9A購10,,,,,0.00,0.00,0,0,0,0,0,0,0,0,0,0,0,0,0
20200520,059238,台積電凱基99購11,,,,,0.00,0.00,0,0,0,0,0,0,0,0,0,0,0,0,0
20200520,059239,台積電凱基99購12,1.97,1.97,1.92,1.95,0.00,0.00,46000,9,89690,0,0,0,0,0,0,15000,21000,-6000,-6000
20200520,05923P,旺宏元富96售05,1.12,1.15,1.11,1.15,-0.05,-4.17,121000,3,136320,0,0,0,0,0,0,70000,51000,19000,19000
20200520,059240,台積電凱基9A購09,7.95,7.95,7.80,7.90,-0.05,-0.63,22000,5,173250,0,0,0,0,0,0,3000,22000,-19000,-19000
20200520,059241,旺宏凱基99購07,,,,,0.00,0.00,0,0,0,0,0,0,0,0,0,0,0,0,0
20200520,059242,南亞科凱基99購06,1.26,1.26,1.19,1.20,+0.06,5.26,80000,7,98030,0,0,0,0,0,0,0,80000,-80000,-80000
20200520,059243,聯發科凱基99購12,,,,,0.00,0.00,0,0,0,0,0,0,0,0,0,0,0,0,0
20200520,059244,聯發科凱基99購13,,,,,0.00,0.00,0,0,0,0,0,0,0,0,0,0,0,0,0
20200520,059245,聯發科凱基9A購03,,,,,0.00,0.00,0,0,0,0,0,0,0,0,0,0,0,0,0
20200520,059246,奇力新凱基9A購02,1.74,1.74,1.74,1.74,0.00,0.00,10000,1,17400,0,0,0,0,0,0,0,10000,-10000,-10000
20200520,059247,可成凱基99購05,3.01,3.03,2.89,2.89,0.00,0.00,21000,4,63010,0,0,0,0,0,0,9000,21000,-12000,-12000
20200520,059248,華新科凱基99購04,2.49,2.49,2.49,2.49,+0.10,4.18,14000,3,34860,0,0,0,0,0,0,0,14000,-14000,-14000
20200520,059249,大立光凱基99購05,1.93,1.97,1.93,1.97,0.00,0.00,131000,2,255350,0,0,0,0,0,0,68000,63000,5000,5000
20200520,05924P,超眾元富96售04,,,,,0.00,0.00,0,0,0,0,0,0,0,0,0,0,0,0,0
20200520,059250,大立光凱基99購06,1.59,1.67,1.59,1.67,+0.08,5.03,149000,3,245470,0,0,0,0,0,0,74000,75000,-1000,-1000
20200520,059251,大立光凱基9A購04,,,,,0.00,0.00,0,0,0,0,0,0,0,0,0,0,0,0,0
20200520,059252,聯詠凱基99購03,2.19,2.32,2.17,2.28,-0.05,-2.15,267000,22,603320,0,0,0,0,0,0,180000,87000,93000,93000
20200520,059253,康控凱基9B購02,1.89,1.89,1.72,1.72,-0.07,-3.91,442000,46,801600,0,0,0,0,0,0,352000,187000,165000,165000
20200520,059254,台表科凱基9A購02,2.93,3.41,2.80,3.41,+0.46,15.59,240000,52,730400,0,0,0,0,0,0,110000,120000,-10000,-10000
20200520,059255,臺股指凱基99購33,2.42,2.42,2.42,2.42,+0.06,2.54,1000,1,2420,0,0,0,0,0,0,0,1000,-1000,-1000
20200520,059256,臺股指凱基99購34,2.58,2.60,2.54,2.54,+0.02,0.79,661000,14,1698730,0,0,0,0,0,0,619000,42000,577000,577000
20200520,059257,臺股指凱基99購35,,,,,0.00,0.00,0,0,0,0,0,0,0,0,0,0,0,0,0
20200520,059258,台灣50群益99購01,,,,,0.00,0.00,0,0,0,0,0,0,0,0,0,0,0,0,0
20200520,059259,FBVIX中信03購06,0.92,0.93,0.92,0.92,+0.02,2.22,89000,7,82450,0,0,0,0,0,0,35000,54000,-19000,-19000
20200520,05925P,晶技永豐96售03,0.13,0.13,0.13,0.13,0.00,0.00,44000,1,5720,0,0,0,0,0,0,44000,0,44000,44000
20200520,059260,國巨中信99購05,1.87,1.89,1.87,1.89,0.00,0.00,30000,3,56400,0,0,0,0,0,0,0,30000,-30000,-30000
20200520,059261,華邦電中信01購01,,,,,0.00,0.00,0,0,0,0,0,0,0,0,0,0,0,0,0
20200520,059262,致茂中信01購01,1.18,1.25,1.18,1.25,+0.05,4.17,30000,4,36200,0,0,0,0,0,0,15000,30000,-15000,-15000
20200520,059263,瑞昱中信01購01,1.62,1.65,1.55,1.62,+0.02,1.25,165000,30,265420,0,0,0,0,0,0,154000,11000,143000,143000
20200520,059264,台光電中信99購02,1.43,1.43,1.39,1.39,0.00,0.00,40000,3,56400,0,0,0,0,0,0,20000,20000,0,0
20200520,059265,美律中信01購01,0.90,0.90,0.90,0.90,0.00,0.00,1000,1,900,0,0,0,0,0,0,1000,0,1000,1000
20200520,059266,緯創中信01購01,2.08,2.08,2.04,2.04,0.00,0.00,78000,8,160880,0,0,0,0,0,0,40000,38000,2000,2000
20200520,059267,群創中信01購02,1.35,1.35,1.35,1.35,+0.04,3.05,7000,1,9450,0,0,0,0,0,0,0,7000,-7000,-7000
20200520,059268,鎧勝中信01購01,1.27,1.27,1.25,1.25,+0.06,5.04,45000,5,56750,0,0,0,0,0,0,10000,35000,-25000,-25000
20200520,059269,臺股指中信9B購03,,,,,0.00,0.00,0,0,0,0,0,0,0,0,0,0,0,0,0
20200520,05926P,智易永豐96售02,,,,,0.00,0.00,0,0,0,0,0,0,0,0,0,0,0,0,0
20200520,059270,台灣50元大01購03,,,,,0.00,0.00,0,0,0,0,0,0,0,0,0,0,0,0,0
20200520,059271,台灣50元大01購05,,,,,0.00,0.00,0,0,0,0,0,0,0,0,0,0,0,0,0
20200520,059272,台灣50元大99購01,,,,,0.00,0.00,0,0,0,0,0,0,0,0,0,0,0,0,0
20200520,059273,臺指反元大9C購03,0.89,0.89,0.89,0.89,0.00,0.00,15000,1,13350,0,0,0,0,0,0,15000,0,15000,15000
20200520,059274,國巨元大99購22,1.65,1.74,1.63,1.68,+0.14,9.09,541000,34,912390,0,0,0,0,0,0,6000,535000,-529000,-529000
20200520,059275,可成元大99購05,4.44,4.44,4.34,4.34,-0.47,-9.77,5000,3,22030,0,0,0,0,0,0,5000,5000,0,0
20200520,059276,可成元大99購06,3.40,3.40,3.24,3.24,0.00,0.00,13000,4,43580,0,0,0,0,0,0,11000,13000,-2000,-2000
20200520,059277,群創元大99購05,0.81,0.81,0.81,0.81,0.00,0.00,68000,1,55080,0,0,0,0,0,0,0,68000,-68000,-68000
20200520,059278,群創元大9A購04,0.89,0.92,0.85,0.85,-0.03,-3.41,188000,4,161830,0,0,0,0,0,0,166000,22000,144000,144000
20200520,059279,台灣50富邦9C購03,,,,,0.00,0.00,0,0,0,0,0,0,0,0,0,0,0,0,0
20200520,05927P,正文永豐96售03,,,,,0.00,0.00,0,0,0,0,0,0,0,0,0,0,0,0,0
20200520,059280,台灣50永豐99購06,,,,,0.00,0.00,0,0,0,0,0,0,0,0,0,0,0,0,0
20200520,059281,創意永豐99購02,1.54,1.57,1.47,1.57,+0.02,1.29,124000,9,188720,0,0,0,0,0,0,54000,92000,-38000,-38000
20200520,059282,嘉聯益永豐99購01,2.04,2.11,2.04,2.11,+0.04,1.93,62000,5,128000,0,0,0,0,0,0,16000,46000,-30000,-30000
20200520,059283,康友永豐99購02,0.78,0.80,0.78,0.80,0.00,0.00,124000,2,98800,0,0,0,0,0,0,124000,0,124000,124000
20200520,059284,緯穎永豐99購03,3.45,3.45,3.45,3.45,+0.09,2.68,10000,1,34500,0,0,0,0,0,0,0,10000,-10000,-10000
20200520,059285,台灣50元富01購02,,,,,0.00,0.00,0,0,0,0,0,0,0,0,0,0,0,0,0
20200520,059286,S&P正2元富01購03,1.35,1.37,1.35,1.36,-0.02,-1.45,500000,3,680020,0,0,0,0,0,0,497000,0,497000,497000
20200520,059287,華通元富99購03,4.58,4.71,4.58,4.71,-0.09,-1.88,28000,5,129900,0,0,0,0,0,0,10000,18000,-8000,-8000
20200520,059288,旺宏元富99購03,,,,,0.00,0.00,0,0,0,0,0,0,0,0,0,0,0,0,0
20200520,059289,瑞昱元富99購01,4.69,4.89,4.65,4.67,-0.12,-2.51,351000,36,1680850,0,0,0,0,0,0,316000,55000,261000,261000
20200520,05928P,華邦電康和96售01,,,,,0.00,0.00,0,0,0,0,0,0,0,0,0,0,0,0,0
20200520,059290,全新元富99購01,1.69,1.69,1.69,1.69,-0.14,-7.65,1000,1,1690,0,0,0,0,0,0,0,1000,-1000,-1000
20200520,059291,華新科元富9B購01,2.70,2.82,2.70,2.75,0.00,0.00,82000,7,223850,0,0,0,0,0,0,50000,32000,18000,18000
20200520,059292,華新科元富9B購02,2.51,2.63,2.51,2.60,+0.09,3.59,130000,9,336200,0,0,0,0,0,0,130000,0,130000,130000
20200520,059293,宏達電元富9B購01,1.24,1.24,1.24,1.24,+0.04,3.33,22000,1,27280,0,0,0,0,0,0,22000,0,22000,22000
20200520,059294,宏達電元富9B購02,,,,,0.00,0.00,0,0,0,0,0,0,0,0,0,0,0,0,0
20200520,059295,大立光元富99購05,2.96,3.17,2.96,3.02,+0.06,2.03,303000,26,930590,0,0,0,0,0,0,147000,151000,-4000,-4000
20200520,059296,大立光元富99購06,2.56,2.75,2.56,2.71,+0.09,3.44,299000,19,791280,0,0,0,0,0,0,135000,163000,-28000,-28000
20200520,059297,大立光元富9C購01,2.81,3.00,2.81,2.93,+0.14,5.02,255000,13,746870,0,0,0,0,0,0,215000,40000,175000,175000
20200520,059298,大立光元富9C購02,3.40,3.65,3.40,3.43,-0.01,-0.29,1253000,23,4425860,0,0,0,0,0,0,616000,633000,-17000,-17000
20200520,059299,欣興元富99購03,4.70,4.88,4.61,4.64,+0.06,1.31,60000,14,280400,0,0,0,0,0,0,51000,7000,44000,44000
20200520,05929P,宏達電康和96售01,,,,,0.00,0.00,0,0,0,0,0,0,0,0,0,0,0,0,0
20200520,059300,國巨群益99購08,,,,,0.00,0.00,0,0,0,0,0,0,0,0,0,0,0,0,0
20200520,059301,華新科群益99購04,,,,,0.00,0.00,0,0,0,0,0,0,0,0,0,0,0,0,0
20200520,059302,大立光群益99購08,3.15,3.21,3.10,3.10,0.00,0.00,48000,3,152530,0,0,0,0,0,0,1000,47000,-46000,-46000
20200520,059303,國巨兆豐99購04,,,,,0.00,0.00,0,0,0,0,0,0,0,0,0,0,0,0,0
20200520,059304,華新科兆豐99購06,,,,,0.00,0.00,0,0,0,0,0,0,0,0,0,0,0,0,0
20200520,059305,台灣50元大99購02,4.14,4.14,4.14,4.14,-0.01,-0.24,92000,2,380880,0,0,0,0,0,0,92000,0,92000,92000
20200520,059306,台灣50元大99購03,,,,,0.00,0.00,0,0,0,0,0,0,0,0,0,0,0,0,0
20200520,059307,T50反1元大99購06,0.78,0.82,0.78,0.81,0.00,0.00,1175000,11,950910,0,0,0,0,0,0,44000,1120000,-1076000,-1076000
20200520,059308,T50反1元大99購07,,,,,0.00,0.00,0,0,0,0,0,0,0,0,0,0,0,0,0
20200520,059309,滬深2X元大99購02,,,,,0.00,0.00,0,0,0,0,0,0,0,0,0,0,0,0,0
20200520,05930P,景碩康和96售01,0.55,0.66,0.55,0.66,+0.04,6.45,200000,2,121000,0,0,0,0,0,0,100000,100000,0,0
20200520,059310,元石油元大99購03,,,,,0.00,0.00,0,0,0,0,0,0,0,0,0,0,0,0,0
20200520,059311,元石油元大99購04,,,,,0.00,0.00,0,0,0,0,0,0,0,0,0,0,0,0,0
20200520,059312,元石油元大99購05,1.84,1.90,1.84,1.90,-0.02,-1.04,686000,14,1287430,0,0,0,0,0,0,381000,635000,-254000,-254000
20200520,059313,元石油元大99購06,2.08,2.08,2.05,2.08,-0.02,-0.95,386000,10,795310,0,0,0,0,0,0,151000,235000,-84000,-84000
20200520,059314,上銀元大99購03,,,,,0.00,0.00,0,0,0,0,0,0,0,0,0,0,0,0,0
20200520,059315,鴻海元大99購30,3.80,3.80,3.80,3.80,-0.11,-2.81,3000,2,11400,0,0,0,0,0,0,3000,0,3000,3000
20200520,059316,國巨元大99購23,6.70,6.70,6.70,6.70,+0.60,9.84,5000,1,33500,0,0,0,0,0,0,5000,0,5000,5000
20200520,059317,台積電元大99購34,,,,,0.00,0.00,0,0,0,0,0,0,0,0,0,0,0,0,0
20200520,059318,旺宏元大99購13,,,,,0.00,0.00,0,0,0,0,0,0,0,0,0,0,0,0,0
20200520,059319,台光電元大99購04,3.83,3.91,3.79,3.91,-0.09,-2.25,291000,16,1114210,0,0,0,0,0,0,0,291000,-291000,-291000
20200520,05931P,鴻海凱基96售15,,,,,0.00,0.00,0,0,0,0,0,0,0,0,0,0,0,0,0
20200520,059320,華新科元大99購15,5.80,5.95,5.75,5.80,0.00,0.00,28000,7,162600,0,0,0,0,0,0,14000,14000,0,0
20200520,059321,欣興元大99購07,,,,,0.00,0.00,0,0,0,0,0,0,0,0,0,0,0,0,0
20200520,059322,晶技元大99購06,2.84,2.84,2.84,2.84,-0.07,-2.41,1000,1,2840,0,0,0,0,0,0,0,1000,-1000,-1000
20200520,059323,新日興元大99購02,3.35,3.61,3.35,3.46,-0.09,-2.54,187000,6,650950,0,0,0,0,0,0,62000,125000,-63000,-63000
20200520,059324,智易元大99購04,,,,,0.00,0.00,0,0,0,0,0,0,0,0,0,0,0,0,0
20200520,059325,超眾元大99購05,,,,,0.00,0.00,0,0,0,0,0,0,0,0,0,0,0,0,0
20200520,059326,康友元大99購01,1.36,1.40,1.34,1.36,-0.05,-3.55,271000,12,370360,0,0,0,0,0,0,100000,171000,-71000,-71000
20200520,059327,南茂元大99購01,3.81,4.04,3.81,4.04,+0.33,8.89,78000,6,305240,0,0,0,0,0,0,0,78000,-78000,-78000
20200520,059328,台灣50國票99購08,,,,,0.00,0.00,0,0,0,0,0,0,0,0,0,0,0,0,0
20200520,059329,台灣50國票99購09,,,,,0.00,0.00,0,0,0,0,0,0,0,0,0,0,0,0,0
20200520,05932P,鴻海凱基96售16,,,,,0.00,0.00,0,0,0,0,0,0,0,0,0,0,0,0,0
20200520,059330,台灣50國票99購10,,,,,0.00,0.00,0,0,0,0,0,0,0,0,0,0,0,0,0
20200520,059331,台灣50國票9A購06,,,,,0.00,0.00,0,0,0,0,0,0,0,0,0,0,0,0,0
20200520,059332,台灣50國票9A購07,,,,,0.00,0.00,0,0,0,0,0,0,0,0,0,0,0,0,0
20200520,059333,滬深2X國票9A購03,,,,,0.00,0.00,0,0,0,0,0,0,0,0,0,0,0,0,0
20200520,059334,A50正2國票9A購02,1.70,1.70,1.70,1.70,0.00,0.00,10000,1,17000,0,0,0,0,0,0,10000,0,10000,10000
20200520,059335,台灣50凱基03購02,,,,,0.00,0.00,0,0,0,0,0,0,0,0,0,0,0,0,0
20200520,059336,台灣50凱基9A購02,,,,,0.00,0.00,0,0,0,0,0,0,0,0,0,0,0,0,0
20200520,059337,台灣50凱基9C購05,,,,,0.00,0.00,0,0,0,0,0,0,0,0,0,0,0,0,0
20200520,059338,滬深2X凱基9C購02,,,,,0.00,0.00,0,0,0,0,0,0,0,0,0,0,0,0,0
20200520,059339,上銀凱基99購06,,,,,0.00,0.00,0,0,0,0,0,0,0,0,0,0,0,0,0
20200520,05933P,鴻海凱基97售03,,,,,0.00,0.00,0,0,0,0,0,0,0,0,0,0,0,0,0
20200520,059340,鴻海凱基9A購12,1.78,1.78,1.77,1.77,-0.03,-1.67,20000,2,35500,0,0,0,0,0,0,0,20000,-20000,-20000
20200520,059341,台積電凱基99購15,2.75,2.75,2.75,2.75,+0.02,0.73,15000,1,41250,0,0,0,0,0,0,15000,0,15000,15000
20200520,059342,聯發科凱基9A購05,,,,,0.00,0.00,0,0,0,0,0,0,0,0,0,0,0,0,0
20200520,059343,宏達電凱基99購04,1.25,1.25,1.25,1.25,+0.04,3.31,24000,3,30000,0,0,0,0,0,0,24000,4000,20000,20000
20200520,059344,長榮航凱基99購01,,,,,0.00,0.00,0,0,0,0,0,0,0,0,0,0,0,0,0
20200520,059345,禾伸堂凱基99購03,,,,,0.00,0.00,0,0,0,0,0,0,0,0,0,0,0,0,0
20200520,059346,新日興凱基99購03,2.02,2.14,2.02,2.14,0.00,0.00,25000,2,51700,0,0,0,0,0,0,0,25000,-25000,-25000
20200520,059347,京鼎凱基99購02,,,,,0.00,0.00,0,0,0,0,0,0,0,0,0,0,0,0,0
20200520,059348,日月光凱基99購01,2.73,2.73,2.73,2.73,-0.38,-12.22,1000,1,2730,0,0,0,0,0,0,0,1000,-1000,-1000
20200520,059349,台郡凱基99購04,,,,,0.00,0.00,0,0,0,0,0,0,0,0,0,0,0,0,0
20200520,05934P,國巨凱基96售13,0.01,0.01,0.01,0.01,0.00,0.00,10000,1,100,0,0,0,0,0,0,10000,10000,0,0
20200520,059350,樺漢凱基9A購01,1.38,1.43,1.38,1.40,+0.04,2.94,281000,15,398500,0,0,0,0,0,0,173000,108000,65000,65000
20200520,059351,台虹凱基99購01,2.55,2.60,2.55,2.56,-0.10,-3.76,473000,12,1219600,0,0,0,0,0,0,200000,273000,-73000,-73000
20200520,059352,台灣50富邦01購01,3.56,3.56,3.51,3.51,0.00,0.00,37000,2,130970,0,0,0,0,0,0,0,37000,-37000,-37000
20200520,059353,滬深2X富邦9A購02,,,,,0.00,0.00,0,0,0,0,0,0,0,0,0,0,0,0,0
20200520,059354,臺指反富邦9B購01,0.33,0.33,0.33,0.33,0.00,0.00,23000,4,7590,0,0,0,0,0,0,0,0,0,0
20200520,059355,國巨富邦9B購03,1.60,1.60,1.52,1.52,+0.10,7.04,139000,7,213190,0,0,0,0,0,0,100000,39000,61000,61000
20200520,059356,滬深2X永豐99購02,,,,,0.00,0.00,0,0,0,0,0,0,0,0,0,0,0,0,0
20200520,059357,華通永豐99購01,3.05,3.05,3.05,3.05,-0.14,-4.39,10000,1,30500,0,0,0,0,0,0,10000,0,10000,10000
20200520,059358,旺宏永豐99購02,2.02,2.07,2.02,2.02,+0.03,1.51,37000,5,75040,0,0,0,0,0,0,5000,32000,-27000,-27000
20200520,059359,精元永豐99購01,1.08,1.14,1.08,1.08,0.00,0.00,562000,10,625960,0,0,0,0,0,0,50000,512000,-462000,-462000
20200520,05935P,台積電凱基96售19,4.98,4.98,4.98,4.98,0.00,0.00,70000,1,348600,0,0,0,0,0,0,70000,70000,0,0
20200520,059360,全新永豐99購02,,,,,0.00,0.00,0,0,0,0,0,0,0,0,0,0,0,0,0
20200520,059361,玉晶光永豐99購04,,,,,0.00,0.00,0,0,0,0,0,0,0,0,0,0,0,0,0
20200520,059362,健策永豐99購03,2.09,2.21,2.06,2.19,-0.04,-1.79,115000,14,243230,0,0,0,0,0,0,11000,105000,-94000,-94000
20200520,059363,超眾永豐99購02,,,,,0.00,0.00,0,0,0,0,0,0,0,0,0,0,0,0,0
20200520,059364,昇陽半永豐99購02,1.33,1.43,1.33,1.43,+0.13,10.0,174000,9,240210,0,0,0,0,0,0,30000,144000,-114000,-114000
20200520,059365,T50反1台新99購01,,,,,0.00,0.00,0,0,0,0,0,0,0,0,0,0,0,0,0
20200520,059366,台積電台新99購04,1.87,1.87,1.87,1.87,-0.02,-1.06,158000,1,295460,0,0,0,0,0,0,158000,0,158000,158000
20200520,059367,台灣50元富01購03,,,,,0.00,0.00,0,0,0,0,0,0,0,0,0,0,0,0,0
20200520,059368,T50正2元富99購02,4.42,4.42,4.42,4.42,+0.02,0.45,3000,1,13260,0,0,0,0,0,0,3000,0,3000,3000
20200520,059369,滬深2X元富9C購01,,,,,0.00,0.00,0,0,0,0,0,0,0,0,0,0,0,0,0
20200520,05936P,台積電凱基96售20,6.30,6.30,6.25,6.25,0.00,0.00,10000,2,62750,0,0,0,0,0,0,0,10000,-10000,-10000
20200520,059370,玉晶光元富99購02,1.65,1.77,1.64,1.75,+0.09,5.42,142000,23,245190,0,0,0,0,0,0,85000,57000,28000,28000
20200520,059371,聯鈞元富99購02,,,,,0.00,0.00,0,0,0,0,0,0,0,0,0,0,0,0,0
20200520,059372,台灣50群益99購02,,,,,0.00,0.00,0,0,0,0,0,0,0,0,0,0,0,0,0
20200520,059373,滬深2X群益01購03,,,,,0.00,0.00,0,0,0,0,0,0,0,0,0,0,0,0,0
20200520,059374,A50正2群益01購01,,,,,0.00,0.00,0,0,0,0,0,0,0,0,0,0,0,0,0
20200520,059375,道瓊反群益9C購02,0.40,0.40,0.39,0.39,0.00,0.00,196000,11,76970,0,0,0,0,0,0,189000,5000,184000,184000
20200520,059376,國巨群益99購09,5.45,5.45,5.45,5.45,0.00,0.00,5000,1,27250,0,0,0,0,0,0,5000,0,5000,5000
20200520,059377,台積電群益99購09,2.19,2.21,2.18,2.19,-0.04,-1.79,226000,9,497110,0,0,0,0,0,0,123000,100000,23000,23000
20200520,059378,台光電群益9B購01,2.58,2.64,2.56,2.64,0.00,0.00,51000,6,131040,0,0,0,0,0,0,0,51000,-51000,-51000
20200520,059379,聯電亞東99購02,,,,,0.00,0.00,0,0,0,0,0,0,0,0,0,0,0,0,0
20200520,05937P,台積電凱基96售21,2.59,2.59,2.59,2.59,-0.11,-4.07,20000,1,51800,0,0,0,0,0,0,20000,20000,0,0
20200520,059380,鴻海亞東99購01,0.73,0.73,0.73,0.73,0.00,0.00,5000,1,3650,0,0,0,0,0,0,0,5000,-5000,-5000
20200520,059381,TPK亞東99購01,,,,,0.00,0.00,0,0,0,0,0,0,0,0,0,0,0,0,0
20200520,059382,台灣50凱基99購02,,,,,0.00,0.00,0,0,0,0,0,0,0,0,0,0,0,0,0
20200520,059383,台灣50凱基99購03,2.33,2.33,2.33,2.33,+0.02,0.87,1000,1,2330,0,0,0,0,0,0,0,1000,-1000,-1000
20200520,059384,上証2X凱基9B購01,,,,,0.00,0.00,0,0,0,0,0,0,0,0,0,0,0,0,0
20200520,059385,滬深2X凱基9C購03,,,,,0.00,0.00,0,0,0,0,0,0,0,0,0,0,0,0,0
20200520,059386,上銀凱基99購07,,,,,0.00,0.00,0,0,0,0,0,0,0,0,0,0,0,0,0
20200520,059387,華通凱基9A購03,1.94,1.95,1.94,1.95,-0.05,-2.5,11000,2,21440,0,0,0,0,0,0,10000,1000,9000,9000
20200520,059388,國巨凱基99購13,,,,,0.00,0.00,0,0,0,0,0,0,0,0,0,0,0,0,0
20200520,059389,國巨凱基99購14,,,,,0.00,0.00,0,0,0,0,0,0,0,0,0,0,0,0,0
20200520,05938P,旺宏凱基96售07,1.17,1.17,1.17,1.17,-0.05,-4.1,1000,1,1170,0,0,0,0,0,0,0,1000,-1000,-1000
20200520,059390,華新科凱基99購05,,,,,0.00,0.00,0,0,0,0,0,0,0,0,0,0,0,0,0
20200520,059391,立積凱基9A購01,,,,,0.00,0.00,0,0,0,0,0,0,0,0,0,0,0,0,0
20200520,059392,臺股指凱基99購38,,,,,0.00,0.00,0,0,0,0,0,0,0,0,0,0,0,0,0
20200520,059393,臺股指凱基99購39,3.97,3.97,3.97,3.97,0.00,0.00,60000,1,238200,0,0,0,0,0,0,60000,0,60000,60000
20200520,059394,臺股指凱基99購40,,,,,0.00,0.00,0,0,0,0,0,0,0,0,0,0,0,0,0
20200520,059395,T50反1元富99購03,0.42,0.43,0.41,0.42,0.00,0.00,517000,11,218980,0,0,0,0,0,0,9000,502000,-493000,-493000
20200520,059396,T50反1元富99購04,0.24,0.26,0.24,0.26,+0.01,4.0,1047000,16,256990,0,0,0,0,0,0,470000,565000,-95000,-95000
20200520,059397,T50反1元富99購05,0.62,0.65,0.62,0.64,-0.01,-1.54,24000,5,15170,0,0,0,0,0,0,9000,15000,-6000,-6000
20200520,059398,滬深2X元富9C購02,,,,,0.00,0.00,0,0,0,0,0,0,0,0,0,0,0,0,0
20200520,059399,滬深2X元富9C購03,,,,,0.00,0.00,0,0,0,0,0,0,0,0,0,0,0,0,0
20200520,05939P,聯發科凱基96售20,,,,,0.00,0.00,0,0,0,0,0,0,0,0,0,0,0,0,0
20200520,059400,滬深2X元富9C購04,,,,,0.00,0.00,0,0,0,0,0,0,0,0,0,0,0,0,0
20200520,059401,牧德元富99購01,2.01,2.10,2.01,2.10,0.00,0.00,40000,4,82700,0,0,0,0,0,0,0,40000,-40000,-40000
20200520,059402,台灣50台新99購01,,,,,0.00,0.00,0,0,0,0,0,0,0,0,0,0,0,0,0
20200520,059403,T50反1台新03購03,0.50,0.50,0.48,0.49,-0.02,-3.92,405000,19,198900,0,0,0,0,0,0,176000,226000,-50000,-50000
20200520,059404,鴻海台新99購03,,,,,0.00,0.00,0,0,0,0,0,0,0,0,0,0,0,0,0
20200520,059405,台灣50國票01購01,,,,,0.00,0.00,0,0,0,0,0,0,0,0,0,0,0,0,0
20200520,059406,台灣50國票9A購08,,,,,0.00,0.00,0,0,0,0,0,0,0,0,0,0,0,0,0
20200520,059407,台灣50國票9B購01,,,,,0.00,0.00,0,0,0,0,0,0,0,0,0,0,0,0,0
20200520,059408,台灣50國票9B購02,,,,,0.00,0.00,0,0,0,0,0,0,0,0,0,0,0,0,0
20200520,059409,台灣50國票9C購01,,,,,0.00,0.00,0,0,0,0,0,0,0,0,0,0,0,0,0
20200520,05940P,聯發科凱基96售21,3.71,3.71,3.71,3.71,0.00,0.00,1000,1,3710,0,0,0,0,0,0,0,1000,-1000,-1000
20200520,059410,滬深2X國票9A購04,,,,,0.00,0.00,0,0,0,0,0,0,0,0,0,0,0,0,0
20200520,059411,臺股指國票99購17,,,,,0.00,0.00,0,0,0,0,0,0,0,0,0,0,0,0,0
20200520,059412,臺股指國票99購18,,,,,0.00,0.00,0,0,0,0,0,0,0,0,0,0,0,0,0
20200520,059413,台灣50元大99購05,,,,,0.00,0.00,0,0,0,0,0,0,0,0,0,0,0,0,0
20200520,059414,台灣50元大9A購02,,,,,0.00,0.00,0,0,0,0,0,0,0,0,0,0,0,0,0
20200520,059415,台灣50元大9A購03,,,,,0.00,0.00,0,0,0,0,0,0,0,0,0,0,0,0,0
20200520,059416,T50反1元大99購08,,,,,0.00,0.00,0,0,0,0,0,0,0,0,0,0,0,0,0
20200520,059417,上証反元大9C購01,,,,,0.00,0.00,0,0,0,0,0,0,0,0,0,0,0,0,0
20200520,059418,上証反元大9C購02,,,,,0.00,0.00,0,0,0,0,0,0,0,0,0,0,0,0,0
20200520,059419,滬深2X元大99購03,,,,,0.00,0.00,0,0,0,0,0,0,0,0,0,0,0,0,0
20200520,05941P,聯發科凱基96售22,3.73,3.73,3.73,3.73,0.00,0.00,1000,1,3730,0,0,0,0,0,0,0,1000,-1000,-1000
20200520,059420,滬深2X元大99購04,,,,,0.00,0.00,0,0,0,0,0,0,0,0,0,0,0,0,0
20200520,059421,滬深2X元大99購05,,,,,0.00,0.00,0,0,0,0,0,0,0,0,0,0,0,0,0
20200520,059422,滬深2X元大99購06,,,,,0.00,0.00,0,0,0,0,0,0,0,0,0,0,0,0,0
20200520,059423,滬深2X元大9A購01,,,,,0.00,0.00,0,0,0,0,0,0,0,0,0,0,0,0,0
20200520,059424,SGBR2X元大9A購01,1.88,1.88,1.76,1.77,-0.07,-3.8,189000,17,337780,0,0,0,0,0,0,113000,55000,58000,58000
20200520,059425,SGBR2X元大9A購02,1.75,1.88,1.75,1.81,-0.06,-3.21,350000,28,622860,0,0,0,0,0,0,66000,232000,-166000,-166000
20200520,059426,鴻海元大99購31,4.50,4.50,4.50,4.50,0.00,0.00,1000,1,4500,0,0,0,0,0,0,1000,0,1000,1000
20200520,059427,國巨元大99購24,7.50,7.50,7.50,7.50,0.00,0.00,1000,1,7500,0,0,0,0,0,0,1000,0,1000,1000
20200520,059428,國巨元大99購25,,,,,0.00,0.00,0,0,0,0,0,0,0,0,0,0,0,0,0
20200520,059429,台積電元大99購35,5.55,5.55,5.55,5.55,0.00,0.00,1000,1,5550,0,0,0,0,0,0,1000,1000,0,0
20200520,05942P,奇力新凱基96售04,,,,,0.00,0.00,0,0,0,0,0,0,0,0,0,0,0,0,0
20200520,059430,台積電元大99購36,5.95,5.95,5.95,5.95,-0.05,-0.83,1000,1,5950,0,0,0,0,0,0,1000,0,1000,1000
20200520,059431,旺宏元大99購14,4.73,4.73,4.68,4.68,0.00,0.00,10000,2,47050,0,0,0,0,0,0,0,10000,-10000,-10000
20200520,059432,聯發科元大99購26,,,,,0.00,0.00,0,0,0,0,0,0,0,0,0,0,0,0,0
20200520,059433,聯發科元大99購27,,,,,0.00,0.00,0,0,0,0,0,0,0,0,0,0,0,0,0
20200520,059434,全新元大99購05,5.15,5.15,5.15,5.15,0.00,0.00,38000,2,195700,0,0,0,0,0,0,0,38000,-38000,-38000
20200520,059435,大立光元大99購17,4.27,4.49,4.27,4.49,0.00,0.00,46000,3,199940,0,0,0,0,0,0,0,46000,-46000,-46000
20200520,059436,大立光元大99購18,4.19,4.36,4.17,4.36,+0.14,3.32,43000,6,184550,0,0,0,0,0,0,17000,26000,-9000,-9000
20200520,059437,京鼎元大99購02,,,,,0.00,0.00,0,0,0,0,0,0,0,0,0,0,0,0,0
20200520,059438,群創元大99購06,1.26,1.30,1.20,1.20,-0.02,-1.64,672000,27,843530,0,0,0,0,0,0,363000,265000,98000,98000
20200520,059439,健策元大9B購01,,,,,0.00,0.00,0,0,0,0,0,0,0,0,0,0,0,0,0
20200520,05943P,欣興凱基96售03,1.98,2.07,1.92,2.04,-0.45,-18.07,24000,9,47790,0,0,0,0,0,0,13000,11000,2000,2000
20200520,059440,康控元大9B購01,,,,,0.00,0.00,0,0,0,0,0,0,0,0,0,0,0,0,0
20200520,059441,祥碩元大99購02,,,,,0.00,0.00,0,0,0,0,0,0,0,0,0,0,0,0,0
20200520,059442,祥碩元大99購03,,,,,0.00,0.00,0,0,0,0,0,0,0,0,0,0,0,0,0
20200520,059443,嘉聯益元大9B購01,5.75,5.75,5.70,5.70,+0.15,2.7,28000,2,160050,0,0,0,0,0,0,28000,0,28000,28000
20200520,059444,臺股指元大99購25,,,,,0.00,0.00,0,0,0,0,0,0,0,0,0,0,0,0,0
20200520,059445,臺股指元大99購26,,,,,0.00,0.00,0,0,0,0,0,0,0,0,0,0,0,0,0
20200520,059446,臺股指元大99購27,,,,,0.00,0.00,0,0,0,0,0,0,0,0,0,0,0,0,0
20200520,059447,臺股指元大99購28,,,,,0.00,0.00,0,0,0,0,0,0,0,0,0,0,0,0,0
20200520,059448,上証2X永豐99購01,,,,,0.00,0.00,0,0,0,0,0,0,0,0,0,0,0,0,0
20200520,059449,滬深2X永豐99購03,,,,,0.00,0.00,0,0,0,0,0,0,0,0,0,0,0,0,0
20200520,05944P,富邦金中信96售01,,,,,0.00,0.00,0,0,0,0,0,0,0,0,0,0,0,0,0
20200520,059450,和大永豐99購01,1.56,1.83,1.56,1.82,+0.19,11.66,960000,45,1631930,0,0,0,0,0,0,284000,676000,-392000,-392000
20200520,059451,國巨永豐99購05,,,,,0.00,0.00,0,0,0,0,0,0,0,0,0,0,0,0,0
20200520,059452,全新永豐99購03,1.73,1.73,1.73,1.73,-0.18,-9.42,30000,1,51900,0,0,0,0,0,0,30000,0,30000,30000
20200520,059453,奇力新永豐99購01,2.26,2.31,2.24,2.29,+0.12,5.53,40000,4,91000,0,0,0,0,0,0,30000,10000,20000,20000
20200520,059454,亞光永豐99購01,1.79,1.85,1.79,1.85,+0.11,6.32,131000,4,238560,0,0,0,0,0,0,0,131000,-131000,-131000
20200520,059455,玉晶光永豐99購05,3.15,3.15,3.15,3.15,-0.04,-1.25,4000,1,12600,0,0,0,0,0,0,4000,0,4000,4000
20200520,059456,智易永豐99購01,4.08,4.08,4.08,4.08,+0.02,0.49,2000,1,8160,0,0,0,0,0,0,2000,0,2000,2000
20200520,059457,立積永豐99購02,,,,,0.00,0.00,0,0,0,0,0,0,0,0,0,0,0,0,0
20200520,059458,鎧勝永豐99購01,1.86,1.87,1.86,1.87,+0.11,6.25,20000,2,37300,0,0,0,0,0,0,10000,20000,-10000,-10000
20200520,059459,訊芯永豐99購04,2.37,2.37,2.30,2.30,-0.01,-0.43,252000,13,592270,0,0,0,0,0,0,228000,24000,204000,204000
20200520,05945P,聯詠中信96售01,,,,,0.00,0.00,0,0,0,0,0,0,0,0,0,0,0,0,0
20200520,059460,GIS永豐99購02,,,,,0.00,0.00,0,0,0,0,0,0,0,0,0,0,0,0,0
20200520,059461,鈺齊永豐99購03,1.17,1.18,1.17,1.18,+0.03,2.61,185000,4,218190,0,0,0,0,0,0,122000,63000,59000,59000
20200520,059462,台灣50元大9C購06,,,,,0.00,0.00,0,0,0,0,0,0,0,0,0,0,0,0,0
20200520,059463,台灣50元大9C購07,,,,,0.00,0.00,0,0,0,0,0,0,0,0,0,0,0,0,0
20200520,059464,台灣50元大9C購08,,,,,0.00,0.00,0,0,0,0,0,0,0,0,0,0,0,0,0
20200520,059465,台灣50元大9C購09,,,,,0.00,0.00,0,0,0,0,0,0,0,0,0,0,0,0,0
20200520,059466,國巨元大99購26,7.70,7.70,7.65,7.65,+0.35,4.79,20000,2,153500,0,0,0,0,0,0,0,20000,-20000,-20000
20200520,059467,旺宏元大99購15,6.50,6.50,6.50,6.50,0.00,0.00,20000,1,130000,0,0,0,0,0,0,0,20000,-20000,-20000
20200520,059468,智邦元大99購02,2.99,2.99,2.99,2.99,+0.10,3.46,10000,2,29900,0,0,0,0,0,0,10000,0,10000,10000
20200520,059469,智邦元大99購03,3.32,3.42,3.32,3.36,+0.07,2.13,91000,6,308990,0,0,0,0,0,0,10000,91000,-81000,-81000
20200520,05946P,和碩中信96售01,,,,,0.00,0.00,0,0,0,0,0,0,0,0,0,0,0,0,0
20200520,059470,華新科元大99購16,,,,,0.00,0.00,0,0,0,0,0,0,0,0,0,0,0,0,0
20200520,059471,華新科元大99購17,5.45,5.60,5.40,5.50,+0.15,2.8,75000,7,410150,0,0,0,0,0,0,75000,35000,40000,40000
20200520,059472,T50正2群益99購01,,,,,0.00,0.00,0,0,0,0,0,0,0,0,0,0,0,0,0
20200520,059473,T50反1群益99購03,0.67,0.67,0.67,0.67,0.00,0.00,10000,1,6700,0,0,0,0,0,0,0,10000,-10000,-10000
20200520,059474,元石油群益99購01,2.51,2.51,2.46,2.49,-0.09,-3.49,75000,9,186550,0,0,0,0,0,0,48000,5000,43000,43000
20200520,059475,元石油群益99購02,1.80,1.80,1.73,1.77,-0.12,-6.35,9000,7,15960,0,0,0,0,0,0,6000,1000,5000,5000
20200520,059476,道瓊指群益9C購01,0.96,0.98,0.96,0.98,-0.02,-2.0,41000,4,39680,0,0,0,0,0,0,10000,31000,-21000,-21000
20200520,059477,FBVIX群益99購01,,,,,0.00,0.00,0,0,0,0,0,0,0,0,0,0,0,0,0
20200520,059478,FBVIX群益9A購01,,,,,0.00,0.00,0,0,0,0,0,0,0,0,0,0,0,0,0
20200520,059479,國巨群益99購10,,,,,0.00,0.00,0,0,0,0,0,0,0,0,0,0,0,0,0
20200520,05947P,大成鋼元大96售03,,,,,0.00,0.00,0,0,0,0,0,0,0,0,0,0,0,0,0
20200520,059480,美律群益9A購01,,,,,0.00,0.00,0,0,0,0,0,0,0,0,0,0,0,0,0
20200520,059481,華新科群益99購05,,,,,0.00,0.00,0,0,0,0,0,0,0,0,0,0,0,0,0
20200520,059482,貿聯群益99購05,,,,,0.00,0.00,0,0,0,0,0,0,0,0,0,0,0,0,0
20200520,059483,臺股指群益99購17,,,,,0.00,0.00,0,0,0,0,0,0,0,0,0,0,0,0,0
20200520,059484,臺股指群益99購18,,,,,0.00,0.00,0,0,0,0,0,0,0,0,0,0,0,0,0
20200520,059485,台灣50兆豐99購02,4.79,4.79,4.79,4.79,+0.03,0.63,48000,2,229920,0,0,0,0,0,0,0,48000,-48000,-48000
20200520,059486,A50正2兆豐9A購01,,,,,0.00,0.00,0,0,0,0,0,0,0,0,0,0,0,0,0
20200520,059487,聯發科兆豐99購03,,,,,0.00,0.00,0,0,0,0,0,0,0,0,0,0,0,0,0
20200520,059488,大立光兆豐99購03,2.22,2.22,2.22,2.22,0.00,0.00,47000,2,104340,0,0,0,0,0,0,0,47000,-47000,-47000
20200520,059489,上証2X國票9A購01,3.71,3.71,3.71,3.71,-0.06,-1.59,10000,1,37100,0,0,0,0,0,0,10000,0,10000,10000
20200520,05948P,茂林元大96售03,0.18,0.18,0.18,0.18,0.00,0.00,37000,1,6660,0,0,0,0,0,0,37000,0,37000,37000
20200520,059490,國巨國票99購09,8.25,8.25,8.20,8.20,0.00,0.00,15000,2,123500,0,0,0,0,0,0,5000,10000,-5000,-5000
20200520,059491,國巨國票9A購05,6.80,6.80,6.80,6.80,+0.35,5.43,5000,1,34000,0,0,0,0,0,0,0,5000,-5000,-5000
20200520,059492,國巨國票9A購06,7.10,7.10,7.10,7.10,0.00,0.00,10000,1,71000,0,0,0,0,0,0,10000,0,10000,10000
20200520,059493,國巨國票9B購01,11.80,12.30,11.60,11.60,+0.90,8.41,21000,6,248100,0,0,0,0,0,0,2000,19000,-17000,-17000
20200520,059494,國巨國票9C購01,9.30,9.60,8.85,8.85,0.00,0.00,37000,5,352200,0,0,0,0,0,0,5000,32000,-27000,-27000
20200520,059495,台灣50元富9C購02,,,,,0.00,0.00,0,0,0,0,0,0,0,0,0,0,0,0,0
20200520,059496,T50正2元富99購03,,,,,0.00,0.00,0,0,0,0,0,0,0,0,0,0,0,0,0
20200520,059497,滬深2X元富9C購05,2.88,2.88,2.88,2.88,-0.09,-3.03,74000,3,213120,0,0,0,0,0,0,0,74000,-74000,-74000
20200520,059498,滬深2X元富9C購06,,,,,0.00,0.00,0,0,0,0,0,0,0,0,0,0,0,0,0
20200520,059499,滬深2X元富9C購07,,,,,0.00,0.00,0,0,0,0,0,0,0,0,0,0,0,0,0
20200520,05949P,台積電國票96售09,,,,,0.00,0.00,0,0,0,0,0,0,0,0,0,0,0,0,0
20200520,059500,鴻海元富99購11,2.62,2.62,2.62,2.62,-0.01,-0.38,6000,1,15720,0,0,0,0,0,0,0,6000,-6000,-6000
20200520,059501,可成元富99購01,1.80,1.80,1.80,1.80,-0.22,-10.89,7000,1,12600,0,0,0,0,0,0,7000,0,7000,7000
20200520,059502,台灣50台新9B購04,,,,,0.00,0.00,0,0,0,0,0,0,0,0,0,0,0,0,0
20200520,059503,大立光富邦9B購04,0.75,0.78,0.75,0.76,+0.01,1.33,187000,19,143390,0,0,0,0,0,0,30000,156000,-126000,-126000
20200520,059504,台灣50永豐99購08,,,,,0.00,0.00,0,0,0,0,0,0,0,0,0,0,0,0,0
20200520,059505,上証2X永豐99購02,,,,,0.00,0.00,0,0,0,0,0,0,0,0,0,0,0,0,0
20200520,059506,滬深2X永豐99購04,,,,,0.00,0.00,0,0,0,0,0,0,0,0,0,0,0,0,0
20200520,059507,鴻海永豐99購03,1.43,1.43,1.40,1.40,-0.04,-2.78,40000,3,56600,0,0,0,0,0,0,20000,20000,0,0
20200520,059508,聯發科永豐99購03,,,,,0.00,0.00,0,0,0,0,0,0,0,0,0,0,0,0,0
20200520,059509,奇力新永豐99購02,3.03,3.20,3.03,3.10,+0.18,6.16,111000,4,347630,0,0,0,0,0,0,84000,27000,57000,57000
20200520,05950P,台積電國票97售04,7.55,7.55,7.55,7.55,-0.30,-3.82,3000,1,22650,0,0,0,0,0,0,0,3000,-3000,-3000
20200520,059510,華新科永豐99購07,1.70,1.80,1.70,1.78,+0.09,5.33,336000,7,576900,0,0,0,0,0,0,245000,91000,154000,154000
20200520,059511,宏達電永豐99購02,0.88,0.88,0.88,0.88,0.00,0.00,2000,2,1760,0,0,0,0,0,0,2000,2000,0,0
20200520,059512,晶豪科永豐99購02,,,,,0.00,0.00,0,0,0,0,0,0,0,0,0,0,0,0,0
20200520,059513,揚明光永豐99購01,,,,,0.00,0.00,0,0,0,0,0,0,0,0,0,0,0,0,0
20200520,059514,嘉澤永豐99購02,,,,,0.00,0.00,0,0,0,0,0,0,0,0,0,0,0,0,0
20200520,059515,牧德永豐99購01,2.73,3.20,2.73,3.13,+0.42,15.5,112000,15,338550,0,0,0,0,0,0,10000,102000,-92000,-92000
20200520,059516,TPK永豐99購01,1.70,1.77,1.70,1.70,0.00,0.00,259000,11,448780,0,0,0,0,0,0,191000,84000,107000,107000
20200520,059517,茂林永豐99購02,,,,,0.00,0.00,0,0,0,0,0,0,0,0,0,0,0,0,0
20200520,059518,康控永豐99購01,,,,,0.00,0.00,0,0,0,0,0,0,0,0,0,0,0,0,0
20200520,059519,台郡永豐99購01,1.37,1.42,1.35,1.35,-0.03,-2.17,72000,7,99740,0,0,0,0,0,0,30000,42000,-12000,-12000
20200520,05951P,台積電國票97售05,,,,,0.00,0.00,0,0,0,0,0,0,0,0,0,0,0,0,0
20200520,059520,台表科永豐99購02,,,,,0.00,0.00,0,0,0,0,0,0,0,0,0,0,0,0,0
20200520,059521,南電永豐99購03,2.21,2.21,2.20,2.20,0.00,0.00,36000,3,79440,0,0,0,0,0,0,0,36000,-36000,-36000
20200520,059522,上証2X凱基9B購02,,,,,0.00,0.00,0,0,0,0,0,0,0,0,0,0,0,0,0
20200520,059523,滬深2X凱基9C購04,,,,,0.00,0.00,0,0,0,0,0,0,0,0,0,0,0,0,0
20200520,059524,FBVIX凱基9A購02,1.00,1.00,1.00,1.00,+0.03,3.09,34000,10,34000,0,0,0,0,0,0,29000,5000,24000,24000
20200520,059525,上銀凱基99購08,,,,,0.00,0.00,0,0,0,0,0,0,0,0,0,0,0,0,0
20200520,059526,鴻海凱基99購12,1.91,1.91,1.91,1.91,-0.01,-0.52,7000,1,13370,0,0,0,0,0,0,7000,0,7000,7000
20200520,059527,聯發科凱基99購16,4.06,4.06,4.06,4.06,0.00,0.00,5000,1,20300,0,0,0,0,0,0,5000,0,5000,5000
20200520,059528,華新科凱基99購06,1.73,1.73,1.73,1.73,+0.05,2.98,5000,1,8650,0,0,0,0,0,0,5000,5000,0,0
20200520,059529,華新科凱基9A購04,,,,,0.00,0.00,0,0,0,0,0,0,0,0,0,0,0,0,0
20200520,05952P,台積電國票97售06,,,,,0.00,0.00,0,0,0,0,0,0,0,0,0,0,0,0,0
20200520,059530,華新科凱基9A購05,,,,,0.00,0.00,0,0,0,0,0,0,0,0,0,0,0,0,0
20200520,059531,華新科凱基9B購02,,,,,0.00,0.00,0,0,0,0,0,0,0,0,0,0,0,0,0
20200520,059532,華新科凱基9B購03,2.76,2.87,2.76,2.78,+0.08,2.96,14000,4,39500,0,0,0,0,0,0,11000,3000,8000,8000
20200520,059533,富邦金凱基99購01,1.99,2.02,1.99,2.02,+0.02,1.0,34000,6,67940,0,0,0,0,0,0,34000,12000,22000,22000
20200520,059534,國泰金凱基99購01,2.05,2.10,2.05,2.10,+0.03,1.45,117000,8,241460,0,0,0,0,0,0,100000,17000,83000,83000
20200520,059535,玉山金凱基99購01,2.77,2.78,2.77,2.78,0.00,0.00,17000,2,47110,0,0,0,0,0,0,17000,2000,15000,15000
20200520,059536,新光金凱基99購05,1.48,1.48,1.47,1.47,-0.01,-0.68,24000,2,35430,0,0,0,0,0,0,9000,15000,-6000,-6000
20200520,059537,大立光凱基99購09,1.90,1.97,1.87,1.97,+0.07,3.68,195000,6,375040,0,0,0,0,0,0,58000,132000,-74000,-74000
20200520,059538,健策凱基99購03,2.74,2.74,2.74,2.74,+0.01,0.37,3000,1,8220,0,0,0,0,0,0,3000,3000,0,0
20200520,059539,緯穎凱基99購03,2.35,2.41,2.18,2.18,-0.09,-3.96,272000,17,641500,0,0,0,0,0,0,187000,95000,92000,92000
20200520,05953P,台積電國票98售02,6.70,6.70,6.70,6.70,0.00,0.00,3000,1,20100,0,0,0,0,0,0,0,3000,-3000,-3000
20200520,059540,新光金日盛99購01,0.91,0.96,0.91,0.96,+0.01,1.05,15000,2,13700,0,0,0,0,0,0,14000,1000,13000,13000
20200520,059541,T50正2康和99購01,3.64,3.71,3.64,3.71,+0.03,0.82,10000,2,36750,0,0,0,0,0,0,5000,5000,0,0
20200520,059542,聯發科亞東99購01,,,,,0.00,0.00,0,0,0,0,0,0,0,0,0,0,0,0,0
20200520,059543,可成亞東99購02,,,,,0.00,0.00,0,0,0,0,0,0,0,0,0,0,0,0,0
20200520,059544,創意亞東99購01,3.14,3.29,3.14,3.26,-0.02,-0.61,20000,4,65290,0,0,0,0,0,0,3000,17000,-14000,-14000
20200520,059545,台灣50群益99購04,,,,,0.00,0.00,0,0,0,0,0,0,0,0,0,0,0,0,0
20200520,059546,FBVIX群益99購03,,,,,0.00,0.00,0,0,0,0,0,0,0,0,0,0,0,0,0
20200520,059547,國巨群益99購11,,,,,0.00,0.00,0,0,0,0,0,0,0,0,0,0,0,0,0
20200520,059548,台積電群益99購10,,,,,0.00,0.00,0,0,0,0,0,0,0,0,0,0,0,0,0
20200520,059549,台光電群益99購04,,,,,0.00,0.00,0,0,0,0,0,0,0,0,0,0,0,0,0
20200520,05954P,旺宏國票97售03,,,,,0.00,0.00,0,0,0,0,0,0,0,0,0,0,0,0,0
20200520,059550,台灣50日盛99購02,,,,,0.00,0.00,0,0,0,0,0,0,0,0,0,0,0,0,0
20200520,059551,T50正2康和99購02,4.86,4.86,4.86,4.86,+0.07,1.46,10000,1,48600,0,0,0,0,0,0,10000,0,10000,10000
20200520,059552,台灣50凱基99購04,,,,,0.00,0.00,0,0,0,0,0,0,0,0,0,0,0,0,0
20200520,059553,台灣50凱基99購05,,,,,0.00,0.00,0,0,0,0,0,0,0,0,0,0,0,0,0
20200520,059554,台灣50凱基99購08,,,,,0.00,0.00,0,0,0,0,0,0,0,0,0,0,0,0,0
20200520,059555,台灣50凱基9A購06,1.81,1.81,1.79,1.79,-0.02,-1.1,6000,3,10780,0,0,0,0,0,0,4000,2000,2000,2000
20200520,059556,台灣50凱基9A購07,,,,,0.00,0.00,0,0,0,0,0,0,0,0,0,0,0,0,0
20200520,059557,台灣50凱基9C購07,,,,,0.00,0.00,0,0,0,0,0,0,0,0,0,0,0,0,0
20200520,059558,T50正2凱基9C購03,7.40,7.40,7.40,7.40,0.00,0.00,4000,1,29600,0,0,0,0,0,0,4000,0,4000,4000
20200520,059559,T50反1凱基99購07,0.23,0.23,0.23,0.23,-0.01,-4.17,410000,1,94300,0,0,0,0,0,0,410000,0,410000,410000
20200520,05955P,台光電國票97售02,0.47,0.50,0.47,0.49,-0.04,-7.55,232000,14,115310,0,0,0,0,0,0,19000,213000,-194000,-194000
20200520,059560,T50反1凱基99購08,0.19,0.20,0.19,0.20,-0.01,-4.76,943000,20,186930,0,0,0,0,0,0,166000,255000,-89000,-89000
20200520,059561,滬深2X凱基9C購05,,,,,0.00,0.00,0,0,0,0,0,0,0,0,0,0,0,0,0
20200520,059562,上銀凱基99購09,3.01,3.01,3.01,3.01,0.00,0.00,10000,1,30100,0,0,0,0,0,0,10000,0,10000,10000
20200520,059563,鴻海凱基9A購14,1.32,1.32,1.32,1.32,-0.03,-2.22,10000,1,13200,0,0,0,0,0,0,0,10000,-10000,-10000
20200520,059564,鴻海凱基9A購15,,,,,0.00,0.00,0,0,0,0,0,0,0,0,0,0,0,0,0
20200520,059565,國巨凱基99購16,,,,,0.00,0.00,0,0,0,0,0,0,0,0,0,0,0,0,0
20200520,059566,台積電凱基9A購11,1.59,1.59,1.57,1.57,0.00,0.00,20000,2,31600,0,0,0,0,0,0,0,10000,-10000,-10000
20200520,059567,台積電凱基9A購12,,,,,0.00,0.00,0,0,0,0,0,0,0,0,0,0,0,0,0
20200520,059568,台積電凱基9A購13,1.73,1.73,1.73,1.73,-0.01,-0.57,2000,2,3460,0,0,0,0,0,0,0,2000,-2000,-2000
20200520,059569,旺宏凱基99購09,,,,,0.00,0.00,0,0,0,0,0,0,0,0,0,0,0,0,0
20200520,05956P,漢唐國票96售02,,,,,0.00,0.00,0,0,0,0,0,0,0,0,0,0,0,0,0
20200520,059570,全新凱基99購04,,,,,0.00,0.00,0,0,0,0,0,0,0,0,0,0,0,0,0
20200520,059571,奇力新凱基99購06,2.18,2.18,2.18,2.18,0.00,0.00,10000,1,21800,0,0,0,0,0,0,0,10000,-10000,-10000
20200520,059572,華新科凱基99購08,,,,,0.00,0.00,0,0,0,0,0,0,0,0,0,0,0,0,0
20200520,059573,健策凱基9A購02,3.00,3.06,3.00,3.06,0.00,0.00,13000,5,39600,0,0,0,0,0,0,13000,13000,0,0
20200520,059574,台表科凱基99購02,4.96,5.55,4.84,5.55,+0.55,11.0,142000,37,725600,0,0,0,0,0,0,70000,72000,-2000,-2000
20200520,059575,臺股指凱基99購41,,,,,0.00,0.00,0,0,0,0,0,0,0,0,0,0,0,0,0
20200520,059576,臺股指凱基99購42,,,,,0.00,0.00,0,0,0,0,0,0,0,0,0,0,0,0,0
20200520,059577,旺宏元富99購04,,,,,0.00,0.00,0,0,0,0,0,0,0,0,0,0,0,0,0
20200520,059578,智邦元富99購02,,,,,0.00,0.00,0,0,0,0,0,0,0,0,0,0,0,0,0
20200520,059579,聯發科元富99購06,,,,,0.00,0.00,0,0,0,0,0,0,0,0,0,0,0,0,0
20200520,05957P,友達國票97售04,,,,,0.00,0.00,0,0,0,0,0,0,0,0,0,0,0,0,0
20200520,059580,大立光元富99購07,3.03,3.21,3.03,3.15,+0.08,2.61,136000,9,423740,0,0,0,0,0,0,54000,82000,-28000,-28000
20200520,059581,日月光元富99購02,2.14,2.23,2.00,2.03,-0.14,-6.45,590000,26,1235470,0,0,0,0,0,0,97000,488000,-391000,-391000
20200520,059582,台灣50台新99購03,,,,,0.00,0.00,0,0,0,0,0,0,0,0,0,0,0,0,0
20200520,059583,台灣50元大01購10,,,,,0.00,0.00,0,0,0,0,0,0,0,0,0,0,0,0,0
20200520,059584,台灣50元大01購11,,,,,0.00,0.00,0,0,0,0,0,0,0,0,0,0,0,0,0
20200520,059585,台灣50元大9C購10,,,,,0.00,0.00,0,0,0,0,0,0,0,0,0,0,0,0,0
20200520,059586,上銀元大9A購02,,,,,0.00,0.00,0,0,0,0,0,0,0,0,0,0,0,0,0
20200520,059587,華通元大9A購01,,,,,0.00,0.00,0,0,0,0,0,0,0,0,0,0,0,0,0
20200520,059588,鴻海元大99購32,4.19,4.19,4.10,4.10,0.00,0.00,26000,17,106780,0,0,0,0,0,0,24000,26000,-2000,-2000
20200520,059589,國巨元大9A購02,,,,,0.00,0.00,0,0,0,0,0,0,0,0,0,0,0,0,0
20200520,05958P,聯發科國票97售04,2.43,2.44,2.26,2.44,-0.12,-4.69,540000,16,1255420,0,0,0,0,0,0,102000,438000,-336000,-336000
20200520,059590,台積電元大99購39,,,,,0.00,0.00,0,0,0,0,0,0,0,0,0,0,0,0,0
20200520,059591,台積電元大9A購04,,,,,0.00,0.00,0,0,0,0,0,0,0,0,0,0,0,0,0
20200520,059592,聯發科元大99購28,,,,,0.00,0.00,0,0,0,0,0,0,0,0,0,0,0,0,0
20200520,059593,聯發科元大99購29,,,,,0.00,0.00,0,0,0,0,0,0,0,0,0,0,0,0,0
20200520,059594,奇力新元大9B購01,5.00,5.10,4.96,4.96,0.00,0.00,40000,7,199800,0,0,0,0,0,0,10000,40000,-30000,-30000
20200520,059595,華新科元大9A購03,5.40,5.40,5.40,5.40,+0.10,1.89,19000,2,102600,0,0,0,0,0,0,19000,0,19000,19000
20200520,059596,大立光元大99購20,,,,,0.00,0.00,0,0,0,0,0,0,0,0,0,0,0,0,0
20200520,059597,大立光元大99購21,3.97,4.10,3.97,4.10,+0.05,1.23,67000,6,269680,0,0,0,0,0,0,17000,45000,-28000,-28000
20200520,059598,欣興元大99購08,6.45,6.60,6.30,6.35,+0.35,5.83,23000,12,149100,0,0,0,0,0,0,19000,15000,4000,4000
20200520,059599,健策元大9B購02,,,,,0.00,0.00,0,0,0,0,0,0,0,0,0,0,0,0,0
20200520,05959P,聯發科國票98售01,4.46,4.46,4.46,4.46,-0.27,-5.71,19000,1,84740,0,0,0,0,0,0,19000,0,19000,19000
20200520,059600,緯穎元大99購07,,,,,0.00,0.00,0,0,0,0,0,0,0,0,0,0,0,0,0
20200520,059601,臺股指元大9A購38,,,,,0.00,0.00,0,0,0,0,0,0,0,0,0,0,0,0,0
20200520,059602,臺股指元大9A購39,,,,,0.00,0.00,0,0,0,0,0,0,0,0,0,0,0,0,0
20200520,059603,臺股指元大9A購40,,,,,0.00,0.00,0,0,0,0,0,0,0,0,0,0,0,0,0
20200520,059604,臺股指元大9A購41,,,,,0.00,0.00,0,0,0,0,0,0,0,0,0,0,0,0,0
20200520,059605,臺股指元大9A購42,,,,,0.00,0.00,0,0,0,0,0,0,0,0,0,0,0,0,0
20200520,059606,上銀富邦9B購02,,,,,0.00,0.00,0,0,0,0,0,0,0,0,0,0,0,0,0
20200520,059607,台積電富邦9C購04,1.77,1.78,1.77,1.78,+0.01,0.56,79000,5,139880,0,0,0,0,0,0,50000,29000,21000,21000
20200520,059608,聯發科富邦9B購04,,,,,0.00,0.00,0,0,0,0,0,0,0,0,0,0,0,0,0
20200520,059609,A50正2永豐99購01,,,,,0.00,0.00,0,0,0,0,0,0,0,0,0,0,0,0,0
20200520,05960P,欣興統一96售01,,,,,0.00,0.00,0,0,0,0,0,0,0,0,0,0,0,0,0
20200520,059610,上銀永豐99購02,,,,,0.00,0.00,0,0,0,0,0,0,0,0,0,0,0,0,0
20200520,059611,台積電永豐99購05,1.74,1.74,1.70,1.73,0.00,0.00,40000,4,68800,0,0,0,0,0,0,20000,20000,0,0
20200520,059612,奇鋐永豐99購02,2.03,2.06,2.03,2.06,+0.05,2.49,18000,3,36740,0,0,0,0,0,0,0,18000,-18000,-18000
20200520,059613,泰鼎永豐99購02,1.29,1.47,1.25,1.47,+0.13,9.7,254000,39,341110,0,0,0,0,0,0,133000,121000,12000,12000
20200520,059614,致新永豐99購01,3.26,3.38,3.20,3.26,+0.08,2.52,52000,10,169530,0,0,0,0,0,0,51000,1000,50000,50000
20200520,059615,台灣50群益99購05,,,,,0.00,0.00,0,0,0,0,0,0,0,0,0,0,0,0,0
20200520,059616,滬深2X群益01購04,,,,,0.00,0.00,0,0,0,0,0,0,0,0,0,0,0,0,0
20200520,059617,A50正2群益01購02,,,,,0.00,0.00,0,0,0,0,0,0,0,0,0,0,0,0,0
20200520,059618,台積電日盛99購01,2.64,2.64,2.56,2.64,+0.01,0.38,169000,25,443340,0,0,0,0,0,0,139000,18000,121000,121000
20200520,059619,台積電日盛9A購04,3.35,3.38,3.35,3.38,-0.02,-0.59,376000,2,1259630,0,0,0,0,0,0,376000,0,376000,376000
20200520,05961P,鴻海群益97售01,,,,,0.00,0.00,0,0,0,0,0,0,0,0,0,0,0,0,0
20200520,059620,聯發科日盛99購02,9.60,9.75,9.60,9.75,+0.30,3.17,25000,3,242250,0,0,0,0,0,0,10000,15000,-5000,-5000
20200520,059621,T50正2凱基9C購04,,,,,0.00,0.00,0,0,0,0,0,0,0,0,0,0,0,0,0
20200520,059622,上銀凱基99購10,2.25,2.25,2.25,2.25,0.00,0.00,10000,1,22500,0,0,0,0,0,0,10000,0,10000,10000
20200520,059623,聯電凱基99購02,1.04,1.04,1.03,1.03,-0.03,-2.83,60000,3,62200,0,0,0,0,0,0,0,60000,-60000,-60000
20200520,059624,鴻海凱基01購01,1.19,1.19,1.19,1.19,0.00,0.00,38000,1,45220,0,0,0,0,0,0,0,38000,-38000,-38000
20200520,059625,國巨凱基99購17,,,,,0.00,0.00,0,0,0,0,0,0,0,0,0,0,0,0,0
20200520,059626,台積電凱基01購01,1.38,1.38,1.37,1.38,-0.01,-0.72,75000,3,103400,0,0,0,0,0,0,75000,0,75000,75000
20200520,059627,旺宏凱基99購10,,,,,0.00,0.00,0,0,0,0,0,0,0,0,0,0,0,0,0
20200520,059628,智邦凱基99購04,1.78,1.78,1.78,1.78,0.00,0.00,10000,1,17800,0,0,0,0,0,0,10000,0,10000,10000
20200520,059629,友達凱基99購06,1.07,1.07,1.07,1.07,-0.01,-0.93,10000,1,10700,0,0,0,0,0,0,10000,0,10000,10000
20200520,05962P,大立光群益96售07,,,,,0.00,0.00,0,0,0,0,0,0,0,0,0,0,0,0,0
20200520,059630,美律凱基99購07,,,,,0.00,0.00,0,0,0,0,0,0,0,0,0,0,0,0,0
20200520,059631,京元電凱基99購02,0.80,0.82,0.76,0.77,-0.09,-10.47,361000,21,286110,0,0,0,0,0,0,10000,348000,-338000,-338000
20200520,059632,聯發科凱基01購01,2.37,2.45,2.37,2.39,+0.07,3.02,119000,7,283020,0,0,0,0,0,0,110000,9000,101000,101000
20200520,059633,聯發科凱基9A購07,,,,,0.00,0.00,0,0,0,0,0,0,0,0,0,0,0,0,0
20200520,059634,可成凱基99購07,1.24,1.26,1.24,1.25,0.00,0.00,23000,4,28820,0,0,0,0,0,0,3000,15000,-12000,-12000
20200520,059635,華新科凱基9A購06,1.72,1.72,1.72,1.72,+0.06,3.61,3000,1,5160,0,0,0,0,0,0,0,3000,-3000,-3000
20200520,059636,宏達電凱基99購05,0.67,0.67,0.67,0.67,+0.05,8.06,7000,1,4690,0,0,0,0,0,0,7000,7000,0,0
20200520,059637,大立光凱基01購01,0.90,0.90,0.89,0.89,0.00,0.00,18000,9,16180,0,0,0,0,0,0,0,8000,-8000,-8000
20200520,059638,大立光凱基99購11,1.82,1.91,1.82,1.91,-0.02,-1.04,130000,3,244100,0,0,0,0,0,0,65000,65000,0,0
20200520,059639,大立光凱基9A購06,1.15,1.15,1.15,1.15,+0.02,1.77,46000,3,52900,0,0,0,0,0,0,1000,45000,-44000,-44000
20200520,05963P,貿聯國票97售02,1.09,1.17,1.09,1.17,+0.01,0.86,29000,2,32570,0,0,0,0,0,0,29000,0,29000,29000
20200520,059640,聯詠凱基99購04,1.55,1.55,1.55,1.55,0.00,0.00,25000,2,38750,0,0,0,0,0,0,20000,5000,15000,15000
20200520,059641,群創凱基99購06,1.23,1.24,1.22,1.22,+0.01,0.83,203000,7,249160,0,0,0,0,0,0,203000,100000,103000,103000
20200520,059642,健策凱基99購04,2.54,2.54,2.54,2.54,0.00,0.00,10000,1,25400,0,0,0,0,0,0,0,10000,-10000,-10000
20200520,059643,日月光凱基99購02,1.45,1.48,1.39,1.41,-0.06,-4.08,49000,7,70370,0,0,0,0,0,0,4000,45000,-41000,-41000
20200520,059644,茂林凱基99購03,2.98,3.12,2.98,3.12,0.00,0.00,50000,10,153800,0,0,0,0,0,0,0,50000,-50000,-50000
20200520,059645,祥碩凱基99購05,3.36,3.36,3.36,3.36,0.00,0.00,10000,1,33600,0,0,0,0,0,0,10000,0,10000,10000
20200520,059646,聯茂凱基99購06,0.89,0.92,0.88,0.88,-0.04,-4.35,27000,4,23900,0,0,0,0,0,0,10000,27000,-17000,-17000
20200520,059647,超眾凱基99購04,,,,,0.00,0.00,0,0,0,0,0,0,0,0,0,0,0,0,0
20200520,059648,台表科凱基99購03,3.72,4.13,3.63,4.13,+0.40,10.72,142000,36,542280,0,0,0,0,0,0,86000,56000,30000,30000
20200520,059649,矽力凱基99購02,,,,,0.00,0.00,0,0,0,0,0,0,0,0,0,0,0,0,0
20200520,05964P,華通凱基96售06,1.23,1.23,1.23,1.23,-0.03,-2.38,10000,1,12300,0,0,0,0,0,0,10000,0,10000,10000
20200520,059650,緯穎凱基99購04,,,,,0.00,0.00,0,0,0,0,0,0,0,0,0,0,0,0,0
20200520,059651,台灣50元大99購06,,,,,0.00,0.00,0,0,0,0,0,0,0,0,0,0,0,0,0
20200520,059652,台灣50元大99購07,,,,,0.00,0.00,0,0,0,0,0,0,0,0,0,0,0,0,0
20200520,059653,台灣50元大99購08,,,,,0.00,0.00,0,0,0,0,0,0,0,0,0,0,0,0,0
20200520,059654,T50反1元大99購09,,,,,0.00,0.00,0,0,0,0,0,0,0,0,0,0,0,0,0
20200520,059655,T50反1元大99購10,,,,,0.00,0.00,0,0,0,0,0,0,0,0,0,0,0,0,0
20200520,059656,T50反1元大99購11,0.47,0.48,0.46,0.47,-0.02,-4.08,250000,15,117090,0,0,0,0,0,0,145000,105000,40000,40000
20200520,059657,華通元大99購09,,,,,0.00,0.00,0,0,0,0,0,0,0,0,0,0,0,0,0
20200520,059658,國巨元大9A購03,,,,,0.00,0.00,0,0,0,0,0,0,0,0,0,0,0,0,0
20200520,059659,旺宏元大9A購03,,,,,0.00,0.00,0,0,0,0,0,0,0,0,0,0,0,0,0
20200520,05965P,健策凱基96售05,,,,,0.00,0.00,0,0,0,0,0,0,0,0,0,0,0,0,0
20200520,059660,華新科元大9A購04,3.26,3.36,3.22,3.36,+0.13,4.02,83000,8,271900,0,0,0,0,0,0,83000,0,83000,83000
20200520,059661,大立光元大99購22,4.52,4.79,4.52,4.79,0.00,0.00,19000,3,89800,0,0,0,0,0,0,0,19000,-19000,-19000
20200520,059662,旭富元大9C購01,7.00,7.10,7.00,7.05,-0.05,-0.7,96000,7,675350,0,0,0,0,0,0,25000,71000,-46000,-46000
20200520,059663,旭富元大9C購02,4.36,4.42,4.36,4.39,+0.02,0.46,56000,6,244610,0,0,0,0,0,0,45000,11000,34000,34000
20200520,059664,立積元大9C購01,,,,,0.00,0.00,0,0,0,0,0,0,0,0,0,0,0,0,0
20200520,059665,嘉聯益元大99購06,,,,,0.00,0.00,0,0,0,0,0,0,0,0,0,0,0,0,0
20200520,059666,台表科元大9B購01,,,,,0.00,0.00,0,0,0,0,0,0,0,0,0,0,0,0,0
20200520,059667,矽力元大99購01,,,,,0.00,0.00,0,0,0,0,0,0,0,0,0,0,0,0,0
20200520,059668,台灣50元富9B購04,,,,,0.00,0.00,0,0,0,0,0,0,0,0,0,0,0,0,0
20200520,059669,台灣50元富9B購05,,,,,0.00,0.00,0,0,0,0,0,0,0,0,0,0,0,0,0
20200520,05966P,矽力凱基96售03,,,,,0.00,0.00,0,0,0,0,0,0,0,0,0,0,0,0,0
20200520,059670,T50正2元富99購04,,,,,0.00,0.00,0,0,0,0,0,0,0,0,0,0,0,0,0
20200520,059671,滬深2X元富99購05,4.10,4.15,4.06,4.14,+0.04,0.98,335000,15,1372450,0,0,0,0,0,0,55000,280000,-225000,-225000
20200520,059672,滬深2X元富99購06,3.03,3.03,3.03,3.03,-0.07,-2.26,28000,1,84840,0,0,0,0,0,0,28000,0,28000,28000
20200520,059673,玉山金元富99購01,6.00,6.00,6.00,6.00,0.00,0.00,8000,1,48000,0,0,0,0,0,0,8000,0,8000,8000
20200520,059674,玉山金元富99購02,,,,,0.00,0.00,0,0,0,0,0,0,0,0,0,0,0,0,0
20200520,059675,大立光元富99購08,3.50,3.71,3.50,3.54,+0.04,1.14,1026000,18,3717240,0,0,0,0,0,0,552000,474000,78000,78000
20200520,059676,台積電台新99購05,1.59,1.59,1.59,1.59,0.00,0.00,5000,1,7950,0,0,0,0,0,0,5000,0,5000,5000
20200520,059677,大立光台新99購01,,,,,0.00,0.00,0,0,0,0,0,0,0,0,0,0,0,0,0
20200520,059678,鴻海國泰9A購03,1.92,1.94,1.92,1.94,-0.04,-2.02,35000,3,67400,0,0,0,0,0,0,25000,10000,15000,15000
20200520,059679,國巨國泰9B購03,,,,,0.00,0.00,0,0,0,0,0,0,0,0,0,0,0,0,0
20200520,05967P,臺股指麥證96售02,,,,,0.00,0.00,0,0,0,0,0,0,0,0,0,0,0,0,0
20200520,059680,台積電國泰9A購03,2.74,2.76,2.65,2.73,+0.02,0.74,953000,60,2591340,0,0,0,0,0,0,524000,421000,103000,103000
20200520,059681,華新科國泰9B購02,2.98,2.98,2.93,2.93,+0.04,1.38,56000,3,166830,0,0,0,0,0,0,55000,1000,54000,54000
20200520,059682,可成富邦9A購01,,,,,0.00,0.00,0,0,0,0,0,0,0,0,0,0,0,0,0
20200520,059683,康控富邦9C購01,1.13,1.13,1.13,1.13,-0.05,-4.24,88000,1,99440,0,0,0,0,0,0,88000,0,88000,88000
20200520,059684,台灣50永豐99購09,,,,,0.00,0.00,0,0,0,0,0,0,0,0,0,0,0,0,0
20200520,059685,T50正2永豐99購02,2.72,2.72,2.65,2.65,-0.02,-0.75,10000,2,26850,0,0,0,0,0,0,10000,0,10000,10000
20200520,059686,上証2X永豐9A購01,,,,,0.00,0.00,0,0,0,0,0,0,0,0,0,0,0,0,0
20200520,059687,卜蜂永豐99購01,2.10,2.12,2.10,2.12,+0.01,0.47,35000,3,73800,0,0,0,0,0,0,20000,15000,5000,5000
20200520,059688,燿華永豐99購01,1.74,2.04,1.74,2.03,+0.31,18.02,836000,42,1538100,0,0,0,0,0,0,96000,767000,-671000,-671000
20200520,059689,南亞科永豐99購02,1.70,1.70,1.64,1.65,+0.09,5.77,23000,4,37880,0,0,0,0,0,0,0,23000,-23000,-23000
20200520,05968P,鴻海台新96售02,,,,,0.00,0.00,0,0,0,0,0,0,0,0,0,0,0,0,0
20200520,059690,建準永豐99購01,,,,,0.00,0.00,0,0,0,0,0,0,0,0,0,0,0,0,0
20200520,059691,大立光永豐99購02,1.29,1.31,1.26,1.26,-0.01,-0.79,50000,5,64500,0,0,0,0,0,0,40000,10000,30000,30000
20200520,059692,聯詠永豐99購01,1.67,1.73,1.67,1.73,+0.01,0.58,121000,5,205060,0,0,0,0,0,0,95000,26000,69000,69000
20200520,059693,智原永豐99購01,,,,,0.00,0.00,0,0,0,0,0,0,0,0,0,0,0,0,0
20200520,059694,創意永豐99購03,2.36,2.42,2.36,2.42,-0.05,-2.02,149000,5,357510,0,0,0,0,0,0,42000,107000,-65000,-65000
20200520,059695,聯鈞永豐99購02,1.36,1.36,1.29,1.29,-0.06,-4.44,145000,7,193650,0,0,0,0,0,0,88000,55000,33000,33000
20200520,059696,立積永豐99購03,1.83,1.83,1.77,1.77,-0.01,-0.56,38000,5,68360,0,0,0,0,0,0,0,38000,-38000,-38000
20200520,059697,上証2X凱基9A購03,,,,,0.00,0.00,0,0,0,0,0,0,0,0,0,0,0,0,0
20200520,059698,滬深2X凱基9A購02,,,,,0.00,0.00,0,0,0,0,0,0,0,0,0,0,0,0,0
20200520,059699,華通凱基99購04,,,,,0.00,0.00,0,0,0,0,0,0,0,0,0,0,0,0,0
20200520,05969P,台積電台新96售04,1.00,1.11,1.00,1.07,-0.01,-0.93,510000,51,545800,0,0,0,0,0,0,510000,510000,0,0
20200520,059700,鴻海凱基9A購16,1.21,1.21,1.17,1.17,-0.03,-2.5,6000,2,7100,0,0,0,0,0,0,4000,2000,2000,2000
20200520,059701,國巨凱基9A購09,,,,,0.00,0.00,0,0,0,0,0,0,0,0,0,0,0,0,0
20200520,059702,台積電凱基9A購14,,,,,0.00,0.00,0,0,0,0,0,0,0,0,0,0,0,0,0
20200520,059703,旺宏凱基99購11,,,,,0.00,0.00,0,0,0,0,0,0,0,0,0,0,0,0,0
20200520,059704,聯發科凱基9A購08,2.32,2.39,2.32,2.38,+0.15,6.73,4000,4,9460,0,0,0,0,0,0,2000,2000,0,0
20200520,059705,華新科凱基9A購07,1.94,1.96,1.94,1.96,+0.05,2.62,2000,2,3900,0,0,0,0,0,0,2000,0,2000,2000
20200520,059706,嘉晶凱基99購01,1.76,2.10,1.76,2.09,+0.35,20.11,238000,28,460160,0,0,0,0,0,0,5000,238000,-233000,-233000
20200520,059707,健策凱基9A購03,2.82,2.82,2.82,2.82,0.00,0.00,3000,1,8460,0,0,0,0,0,0,3000,3000,0,0
20200520,059708,立積凱基9A購02,,,,,0.00,0.00,0,0,0,0,0,0,0,0,0,0,0,0,0
20200520,059709,上証2X元大9C購01,2.15,2.15,2.12,2.12,-0.02,-0.93,25000,2,53300,0,0,0,0,0,0,25000,0,25000,25000
20200520,05970P,超眾永豐96售03,,,,,0.00,0.00,0,0,0,0,0,0,0,0,0,0,0,0,0
20200520,059710,上証2X元大9C購02,,,,,0.00,0.00,0,0,0,0,0,0,0,0,0,0,0,0,0
20200520,059711,滬深2X元大9C購02,2.18,2.18,2.18,2.18,+0.03,1.4,20000,1,43600,0,0,0,0,0,0,20000,0,20000,20000
20200520,059712,滬深2X元大9C購03,,,,,0.00,0.00,0,0,0,0,0,0,0,0,0,0,0,0,0
20200520,059713,滬深2X元大9C購04,1.77,1.77,1.77,1.77,+0.01,0.57,20000,1,35400,0,0,0,0,0,0,20000,0,20000,20000
20200520,059714,A50正2元大9C購01,,,,,0.00,0.00,0,0,0,0,0,0,0,0,0,0,0,0,0
20200520,059715,A50正2元大9C購02,,,,,0.00,0.00,0,0,0,0,0,0,0,0,0,0,0,0,0
20200520,059716,鴻海元大99購35,4.74,4.74,4.60,4.60,-0.14,-2.95,3000,3,13990,0,0,0,0,0,0,3000,3000,0,0
20200520,059717,國巨元大99購21,9.60,9.95,9.60,9.80,+0.50,5.38,25000,11,244250,0,0,0,0,0,0,12000,20000,-8000,-8000
20200520,059718,國巨元大9A購04,,,,,0.00,0.00,0,0,0,0,0,0,0,0,0,0,0,0,0
20200520,059719,台積電元大99購42,5.65,5.70,5.65,5.70,+0.15,2.7,15000,2,85000,0,0,0,0,0,0,10000,5000,5000,5000
20200520,05971P,世紀鋼永豐96售04,,,,,0.00,0.00,0,0,0,0,0,0,0,0,0,0,0,0,0
20200520,059720,台積電元大99購43,5.15,5.15,5.05,5.10,0.00,0.00,60000,4,305500,0,0,0,0,0,0,35000,25000,10000,10000
20200520,059721,旺宏元大99購16,,,,,0.00,0.00,0,0,0,0,0,0,0,0,0,0,0,0,0
20200520,059722,南亞科元大99購02,6.25,6.45,6.20,6.45,+0.40,6.61,31000,3,196000,0,0,0,0,0,0,0,31000,-31000,-31000
20200520,059723,美律元大9A購02,2.22,2.22,2.22,2.22,-0.01,-0.45,5000,1,11100,0,0,0,0,0,0,0,5000,-5000,-5000
20200520,059724,聯發科元大99購30,,,,,0.00,0.00,0,0,0,0,0,0,0,0,0,0,0,0,0
20200520,059725,聯發科元大99購31,,,,,0.00,0.00,0,0,0,0,0,0,0,0,0,0,0,0,0
20200520,059726,華新科元大99購18,,,,,0.00,0.00,0,0,0,0,0,0,0,0,0,0,0,0,0
20200520,059727,大立光元大9A購01,4.98,4.98,4.98,4.98,0.00,0.00,8000,1,39840,0,0,0,0,0,0,0,8000,-8000,-8000
20200520,059728,聯鈞元大99購01,4.39,4.49,4.27,4.27,-0.25,-5.53,81000,5,355370,0,0,0,0,0,0,41000,40000,1000,1000
20200520,059729,群創元大9C購05,1.91,1.95,1.86,1.86,-0.02,-1.06,358000,27,682280,0,0,0,0,0,0,247000,69000,178000,178000
20200520,05972P,瑞昱元大96售01,,,,,0.00,0.00,0,0,0,0,0,0,0,0,0,0,0,0,0
20200520,059730,晶相光元大9C購02,1.97,1.97,1.97,1.97,-0.02,-1.01,50000,1,98500,0,0,0,0,0,0,50000,0,50000,50000
20200520,059731,康控元大99購04,4.19,4.23,3.82,3.86,-0.14,-3.5,114000,13,462540,0,0,0,0,0,0,114000,20000,94000,94000
20200520,059732,超眾元大9A購01,3.95,3.98,3.76,3.76,-0.08,-2.08,98000,6,384740,0,0,0,0,0,0,11000,87000,-76000,-76000
20200520,059733,緯穎元大99購08,8.20,8.20,8.20,8.20,0.00,0.00,2000,1,16400,0,0,0,0,0,0,0,2000,-2000,-2000
20200520,059734,T50正2元富99購05,,,,,0.00,0.00,0,0,0,0,0,0,0,0,0,0,0,0,0
20200520,059735,T50反1元富99購06,,,,,0.00,0.00,0,0,0,0,0,0,0,0,0,0,0,0,0
20200520,059736,T50反1元富99購07,,,,,0.00,0.00,0,0,0,0,0,0,0,0,0,0,0,0,0
20200520,059737,T50反1元富99購08,,,,,0.00,0.00,0,0,0,0,0,0,0,0,0,0,0,0,0
20200520,059738,上証2X元富99購01,,,,,0.00,0.00,0,0,0,0,0,0,0,0,0,0,0,0,0
20200520,059739,華通元富99購04,,,,,0.00,0.00,0,0,0,0,0,0,0,0,0,0,0,0,0
20200520,05973P,聯詠元大96售06,,,,,0.00,0.00,0,0,0,0,0,0,0,0,0,0,0,0,0
20200520,059740,瑞昱元富99購02,,,,,0.00,0.00,0,0,0,0,0,0,0,0,0,0,0,0,0
20200520,059741,聯發科元富99購07,6.80,6.80,6.65,6.65,0.00,0.00,81000,3,545550,0,0,0,0,0,0,81000,0,81000,81000
20200520,059742,富邦金元富99購01,3.86,3.92,3.84,3.92,+0.06,1.55,129000,12,498130,0,0,0,0,0,0,58000,71000,-13000,-13000
20200520,059743,開發金元富99購01,2.01,2.03,2.00,2.00,0.00,0.00,85000,6,171250,0,0,0,0,0,0,45000,40000,5000,5000
20200520,059744,禾伸堂元富99購02,,,,,0.00,0.00,0,0,0,0,0,0,0,0,0,0,0,0,0
20200520,059745,欣興元富99購04,5.85,6.00,5.85,6.00,+0.55,10.09,3000,2,17850,0,0,0,0,0,0,1000,2000,-1000,-1000
20200520,059746,聯鈞元富99購03,,,,,0.00,0.00,0,0,0,0,0,0,0,0,0,0,0,0,0
20200520,059747,台達電台新99購01,2.09,2.09,2.03,2.03,-0.11,-5.14,40000,2,83000,0,0,0,0,0,0,30000,10000,20000,20000
20200520,059748,聯發科台新99購03,3.30,3.30,3.10,3.12,+0.10,3.31,65000,4,201940,0,0,0,0,0,0,65000,0,65000,65000
20200520,059749,台灣50群益9A購04,,,,,0.00,0.00,0,0,0,0,0,0,0,0,0,0,0,0,0
20200520,05974P,國巨富邦97售03,,,,,0.00,0.00,0,0,0,0,0,0,0,0,0,0,0,0,0
20200520,059750,台灣50群益9A購05,,,,,0.00,0.00,0,0,0,0,0,0,0,0,0,0,0,0,0
20200520,059751,華通群益9B購03,,,,,0.00,0.00,0,0,0,0,0,0,0,0,0,0,0,0,0
20200520,059752,國巨群益9B購01,,,,,0.00,0.00,0,0,0,0,0,0,0,0,0,0,0,0,0
20200520,059753,貿聯群益99購06,4.01,4.01,4.01,4.01,-0.05,-1.23,2000,1,8020,0,0,0,0,0,0,2000,0,2000,2000
20200520,059754,訊芯群益9A購01,2.43,2.45,2.40,2.45,+0.05,2.08,365000,11,884530,0,0,0,0,0,0,365000,0,365000,365000
20200520,059755,宏達電國泰9A購01,1.85,1.93,1.85,1.86,+0.07,3.91,573000,24,1094340,0,0,0,0,0,0,276000,349000,-73000,-73000
20200520,059756,奇力新富邦9C購01,2.94,2.95,2.91,2.91,0.00,0.00,14000,3,40900,0,0,0,0,0,0,1000,13000,-12000,-12000
20200520,059757,上証2X永豐99購03,,,,,0.00,0.00,0,0,0,0,0,0,0,0,0,0,0,0,0
20200520,059758,滬深2X永豐99購05,,,,,0.00,0.00,0,0,0,0,0,0,0,0,0,0,0,0,0
20200520,059759,A50正2永豐99購02,,,,,0.00,0.00,0,0,0,0,0,0,0,0,0,0,0,0,0
20200520,05975P,國巨日盛99售02,,,,,0.00,0.00,0,0,0,0,0,0,0,0,0,0,0,0,0
20200520,059760,楠梓電永豐99購01,1.42,1.44,1.37,1.40,-0.04,-2.78,118000,7,166550,0,0,0,0,0,0,10000,118000,-108000,-108000
20200520,059761,國巨永豐99購06,,,,,0.00,0.00,0,0,0,0,0,0,0,0,0,0,0,0,0
20200520,059762,禾伸堂永豐99購02,2.35,2.42,2.27,2.27,-0.01,-0.44,150000,8,355500,0,0,0,0,0,0,90000,60000,30000,30000
20200520,059763,華擎永豐99購03,1.86,1.98,1.86,1.98,+0.17,9.39,265000,8,507150,0,0,0,0,0,0,80000,185000,-105000,-105000
20200520,059764,健策永豐99購04,2.30,2.41,2.28,2.40,0.00,0.00,74000,9,172210,0,0,0,0,0,0,1000,74000,-73000,-73000
20200520,059765,嘉聯益永豐99購02,1.25,1.30,1.25,1.26,-0.01,-0.79,61000,5,77490,0,0,0,0,0,0,16000,45000,-29000,-29000
20200520,059766,同欣電永豐99購03,2.07,2.20,2.07,2.11,+0.03,1.44,152000,15,321920,0,0,0,0,0,0,78000,78000,0,0
20200520,059767,矽力永豐99購01,2.73,2.81,2.73,2.75,-0.05,-1.79,24000,3,66400,0,0,0,0,0,0,24000,0,24000,24000
20200520,059768,上証2X群益9C購02,,,,,0.00,0.00,0,0,0,0,0,0,0,0,0,0,0,0,0
20200520,059769,滬深2X群益9C購01,,,,,0.00,0.00,0,0,0,0,0,0,0,0,0,0,0,0,0
20200520,05976P,國巨凱基96售14,0.99,0.99,0.90,0.90,-0.27,-23.08,100000,6,96500,0,0,0,0,0,0,50000,50000,0,0
20200520,059770,A50正2群益9C購01,,,,,0.00,0.00,0,0,0,0,0,0,0,0,0,0,0,0,0
20200520,059771,台積電群益99購11,1.83,1.83,1.79,1.83,0.00,0.00,62000,11,112460,0,0,0,0,0,0,28000,34000,-6000,-6000
20200520,059772,可成群益9A購05,2.81,2.81,2.69,2.69,-0.32,-10.63,8000,7,21940,0,0,0,0,0,0,6000,8000,-2000,-2000
20200520,059773,康控群益99購01,2.46,2.46,2.46,2.46,+0.05,2.07,30000,1,73800,0,0,0,0,0,0,30000,0,30000,30000
20200520,059774,臺股指群益99購21,,,,,0.00,0.00,0,0,0,0,0,0,0,0,0,0,0,0,0
20200520,059775,台灣50元大9C購16,,,,,0.00,0.00,0,0,0,0,0,0,0,0,0,0,0,0,0
20200520,059776,台灣50元大9C購17,,,,,0.00,0.00,0,0,0,0,0,0,0,0,0,0,0,0,0
20200520,059777,台灣50元大9C購18,,,,,0.00,0.00,0,0,0,0,0,0,0,0,0,0,0,0,0
20200520,059778,上証2X元大9C購03,,,,,0.00,0.00,0,0,0,0,0,0,0,0,0,0,0,0,0
20200520,059779,滬深2X元大9C購05,,,,,0.00,0.00,0,0,0,0,0,0,0,0,0,0,0,0,0
20200520,05977P,旺宏永豐96售06,0.71,0.71,0.71,0.71,-0.02,-2.74,1000,1,710,0,0,0,0,0,0,0,1000,-1000,-1000
20200520,059780,滬深2X元大9C購06,1.39,1.39,1.37,1.37,-0.01,-0.72,115000,3,157570,0,0,0,0,0,0,100000,15000,85000,85000
20200520,059781,A50正2元大9C購03,,,,,0.00,0.00,0,0,0,0,0,0,0,0,0,0,0,0,0
20200520,059782,A50正2元大9C購04,2.07,2.07,2.07,2.07,0.00,0.00,20000,2,41400,0,0,0,0,0,0,10000,10000,0,0
20200520,059783,旺宏元大99購17,,,,,0.00,0.00,0,0,0,0,0,0,0,0,0,0,0,0,0
20200520,059784,台光電元大9A購01,6.45,6.45,6.40,6.40,-0.05,-0.78,15000,3,96700,0,0,0,0,0,0,14000,11000,3000,3000
20200520,059785,美律元大9A購03,1.99,1.99,1.99,1.99,0.00,0.00,53000,2,105470,0,0,0,0,0,0,3000,53000,-50000,-50000
20200520,059786,全新元大99購06,3.56,3.56,3.17,3.17,-0.38,-10.7,62000,7,210440,0,0,0,0,0,0,22000,59000,-37000,-37000
20200520,059787,奇力新元大9A購02,5.50,5.60,5.50,5.60,+0.35,6.67,31000,2,173400,0,0,0,0,0,0,29000,2000,27000,27000
20200520,059788,華新科元大9A購05,5.75,5.75,5.75,5.75,0.00,0.00,1000,1,5750,0,0,0,0,0,0,1000,0,1000,1000
20200520,059789,貿聯元大9A購02,2.24,2.27,2.24,2.26,0.00,0.00,199000,19,447800,0,0,0,0,0,0,66000,133000,-67000,-67000
20200520,05978P,麗豐永豐96售02,1.18,1.23,1.15,1.22,+0.03,2.52,164000,6,195780,0,0,0,0,0,0,79000,85000,-6000,-6000
20200520,059790,立積元大9C購02,3.83,3.83,3.61,3.61,-0.18,-4.75,29000,4,108750,0,0,0,0,0,0,13000,16000,-3000,-3000
20200520,059791,超眾元大99購06,2.61,2.62,2.61,2.62,0.00,0.00,39000,2,102100,0,0,0,0,0,0,8000,39000,-31000,-31000
20200520,059792,台灣50國票9A購09,,,,,0.00,0.00,0,0,0,0,0,0,0,0,0,0,0,0,0
20200520,059793,滬深2X國票99購03,,,,,0.00,0.00,0,0,0,0,0,0,0,0,0,0,0,0,0
20200520,059794,滬深2X國票99購04,,,,,0.00,0.00,0,0,0,0,0,0,0,0,0,0,0,0,0
20200520,059795,鴻海國票99購07,2.38,2.38,2.30,2.30,0.00,0.00,2000,2,4680,0,0,0,0,0,0,0,2000,-2000,-2000
20200520,059796,台積電國票99購10,2.66,2.66,2.59,2.59,-0.06,-2.26,81000,3,213950,0,0,0,0,0,0,50000,31000,19000,19000
20200520,059797,大立光國票99購01,,,,,0.00,0.00,0,0,0,0,0,0,0,0,0,0,0,0,0
20200520,059798,臺股指國票99購21,7.25,7.25,7.25,7.25,0.00,0.00,10000,1,72500,0,0,0,0,0,0,0,10000,-10000,-10000
20200520,059799,台灣50元富01購05,,,,,0.00,0.00,0,0,0,0,0,0,0,0,0,0,0,0,0
20200520,05979P,華新科中信96售02,,,,,0.00,0.00,0,0,0,0,0,0,0,0,0,0,0,0,0
20200520,059800,T50反1元富99購09,,,,,0.00,0.00,0,0,0,0,0,0,0,0,0,0,0,0,0
20200520,059801,T50反1元富99購10,,,,,0.00,0.00,0,0,0,0,0,0,0,0,0,0,0,0,0
20200520,059802,上証2X元富99購02,,,,,0.00,0.00,0,0,0,0,0,0,0,0,0,0,0,0,0
20200520,059803,S&P正2元富9B購03,2.82,2.85,2.82,2.85,-0.03,-1.04,422000,13,1196450,0,0,0,0,0,0,30000,392000,-362000,-362000
20200520,059804,台積電元富99購01,3.39,3.39,3.33,3.33,-0.05,-1.48,109000,4,368210,0,0,0,0,0,0,54000,55000,-1000,-1000
20200520,059805,台積電元富99購02,2.97,2.97,2.91,2.91,-0.05,-1.69,22000,3,64920,0,0,0,0,0,0,5000,17000,-12000,-12000
20200520,059806,聯發科元富99購08,4.00,4.00,3.89,3.89,0.00,0.00,138000,2,546500,0,0,0,0,0,0,138000,0,138000,138000
20200520,059807,大立光元富99購09,2.00,2.13,2.00,2.09,+0.11,5.56,625000,25,1293560,57000,57000,0,0,0,0,385000,196000,189000,189000
20200520,059808,創意元富99購01,,,,,0.00,0.00,0,0,0,0,0,0,0,0,0,0,0,0,0
20200520,059809,貿聯元富99購01,,,,,0.00,0.00,0,0,0,0,0,0,0,0,0,0,0,0,0
20200520,05980P,台積電永昌96售09,2.09,2.15,2.09,2.15,0.00,0.00,76000,3,161420,0,0,0,0,0,0,76000,76000,0,0
20200520,059810,台灣50台新99購04,,,,,0.00,0.00,0,0,0,0,0,0,0,0,0,0,0,0,0
20200520,059811,高股息凱基99購02,1.83,1.83,1.82,1.82,+0.01,0.55,2000,2,3650,0,0,0,0,0,0,1000,1000,0,0
20200520,059812,上証2X凱基9A購04,,,,,0.00,0.00,0,0,0,0,0,0,0,0,0,0,0,0,0
20200520,059813,滬深2X凱基9B購01,,,,,0.00,0.00,0,0,0,0,0,0,0,0,0,0,0,0,0
20200520,059814,SP黃豆凱基9A購02,1.29,1.31,1.29,1.29,-0.01,-0.77,87000,6,112330,0,0,0,0,0,0,32000,55000,-23000,-23000
20200520,059815,SP黃豆凱基9A購03,,,,,0.00,0.00,0,0,0,0,0,0,0,0,0,0,0,0,0
20200520,059816,聯電凱基99購03,1.13,1.13,1.09,1.12,-0.02,-1.75,86000,7,95150,0,0,0,0,0,0,43000,43000,0,0
20200520,059817,華通凱基99購05,,,,,0.00,0.00,0,0,0,0,0,0,0,0,0,0,0,0,0
20200520,059818,鴻海凱基99購14,,,,,0.00,0.00,0,0,0,0,0,0,0,0,0,0,0,0,0
20200520,059819,台積電凱基99購17,0.73,0.73,0.72,0.72,-0.02,-2.7,111000,3,80760,0,0,0,0,0,0,61000,50000,11000,11000
20200520,05981P,可成永昌98售02,,,,,0.00,0.00,0,0,0,0,0,0,0,0,0,0,0,0,0
20200520,059820,南亞科凱基99購07,1.24,1.24,1.21,1.22,+0.03,2.52,71000,3,86040,0,0,0,0,0,0,60000,1000,59000,59000
20200520,059821,美律凱基99購08,0.98,0.98,0.98,0.98,-0.02,-2.0,10000,1,9800,0,0,0,0,0,0,0,10000,-10000,-10000
20200520,059822,聯發科凱基99購19,1.58,1.60,1.58,1.60,+0.08,5.26,99000,2,158380,0,0,0,0,0,0,99000,0,99000,99000
20200520,059823,奇力新凱基99購07,1.69,1.76,1.69,1.76,+0.12,7.32,126000,3,218260,0,0,0,0,0,0,126000,0,126000,126000
20200520,059824,大立光凱基99購13,0.80,0.80,0.80,0.80,+0.04,5.26,2000,1,1600,0,0,0,0,0,0,0,2000,-2000,-2000
20200520,059825,嘉晶凱基99購02,1.52,1.86,1.52,1.78,+0.27,17.88,592000,23,1045370,0,0,0,0,0,0,375000,235000,140000,140000
20200520,059826,欣興凱基99購06,1.70,1.76,1.70,1.71,+0.25,17.12,110000,5,190100,0,0,0,0,0,0,110000,0,110000,110000
20200520,059827,晶技凱基99購03,,,,,0.00,0.00,0,0,0,0,0,0,0,0,0,0,0,0,0
20200520,059828,健策凱基99購05,2.36,2.45,2.36,2.45,0.00,0.00,30000,5,71700,0,0,0,0,0,0,5000,30000,-25000,-25000
20200520,059829,超眾凱基99購05,1.04,1.04,1.04,1.04,+0.02,1.96,100000,1,104000,0,0,0,0,0,0,0,100000,-100000,-100000
20200520,05982P,漢唐國票96售03,1.52,1.52,1.52,1.52,+0.04,2.7,39000,1,59280,0,0,0,0,0,0,0,39000,-39000,-39000
20200520,059830,台郡凱基99購05,1.08,1.08,1.08,1.08,-0.01,-0.92,42000,1,45360,0,0,0,0,0,0,42000,0,42000,42000
20200520,059831,聯詠康和99購01,2.10,2.19,2.06,2.19,-0.02,-0.9,137000,41,287240,0,0,0,0,0,0,91000,6000,85000,85000
20200520,059832,超眾康和99購01,1.82,1.82,1.82,1.82,0.00,0.00,15000,1,27300,0,0,0,0,0,0,0,15000,-15000,-15000
20200520,059833,緯穎康和99購01,,,,,0.00,0.00,0,0,0,0,0,0,0,0,0,0,0,0,0
20200520,059834,友達國泰9B購01,2.09,2.17,2.09,2.17,+0.08,3.83,135000,7,291070,0,0,0,0,0,0,114000,0,114000,114000
20200520,059835,聯發科國泰9B購01,4.49,4.49,4.49,4.49,+0.09,2.05,2000,1,8980,0,0,0,0,0,0,2000,0,2000,2000
20200520,059836,大立光國泰9B購02,1.91,2.01,1.91,1.95,+0.04,2.09,186000,16,366470,0,0,0,0,0,0,41000,145000,-104000,-104000
20200520,059837,健策國泰9B購01,,,,,0.00,0.00,0,0,0,0,0,0,0,0,0,0,0,0,0
20200520,059838,茂林國泰9B購01,,,,,0.00,0.00,0,0,0,0,0,0,0,0,0,0,0,0,0
20200520,059839,T50反1富邦99購02,,,,,0.00,0.00,0,0,0,0,0,0,0,0,0,0,0,0,0
20200520,05983P,聯詠國票96售02,1.55,1.66,1.55,1.66,+0.04,2.47,110000,3,174100,0,0,0,0,0,0,74000,36000,38000,38000
20200520,059840,鴻海富邦9A購02,1.50,1.52,1.50,1.52,-0.02,-1.3,35000,4,52740,0,0,0,0,0,0,35000,0,35000,35000
20200520,059841,國巨富邦9C購01,1.51,1.61,1.49,1.52,+0.10,7.04,485000,41,744830,0,0,0,0,0,0,213000,265000,-52000,-52000
20200520,059842,台積電富邦9C購05,,,,,0.00,0.00,0,0,0,0,0,0,0,0,0,0,0,0,0
20200520,059843,華新科富邦9B購03,,,,,0.00,0.00,0,0,0,0,0,0,0,0,0,0,0,0,0
20200520,059844,大立光富邦9C購04,0.80,0.82,0.80,0.82,+0.02,2.5,110000,6,89600,0,0,0,0,0,0,80000,30000,50000,50000
20200520,059845,欣興富邦9A購02,,,,,0.00,0.00,0,0,0,0,0,0,0,0,0,0,0,0,0
20200520,059846,力山永豐99購01,,,,,0.00,0.00,0,0,0,0,0,0,0,0,0,0,0,0,0
20200520,059847,喬山永豐99購01,2.43,2.49,2.43,2.49,-0.02,-0.8,72000,3,176580,0,0,0,0,0,0,0,72000,-72000,-72000
20200520,059848,智邦永豐99購01,1.94,2.04,1.93,2.00,+0.05,2.56,67000,17,131940,0,0,0,0,0,0,44000,23000,21000,21000
20200520,059849,興勤永豐99購01,1.37,1.37,1.37,1.37,0.00,0.00,15000,1,20550,0,0,0,0,0,0,0,15000,-15000,-15000
20200520,05984P,台積電統一98售01,1.52,1.58,1.52,1.58,0.00,0.00,116000,3,181300,0,0,0,0,0,0,116000,116000,0,0
20200520,059850,日電貿永豐99購01,2.25,2.29,2.25,2.29,+0.03,1.33,17000,3,38730,0,0,0,0,0,0,10000,2000,8000,8000
20200520,059851,晶相光永豐99購02,1.60,1.60,1.13,1.16,+0.03,2.65,174000,3,200240,0,0,0,0,0,0,112000,58000,54000,54000
20200520,059852,康控永豐99購02,1.76,1.76,1.62,1.62,-0.07,-4.14,382000,16,659390,0,0,0,0,0,0,287000,95000,192000,192000
20200520,059853,超眾永豐99購03,1.00,1.00,0.95,0.95,-0.03,-3.06,135000,2,134500,0,0,0,0,0,0,10000,125000,-115000,-115000
20200520,059854,台表科永豐99購03,3.38,3.38,3.38,3.38,+0.01,0.3,3000,1,10140,0,0,0,0,0,0,3000,0,3000,3000
20200520,059855,緯穎永豐99購04,1.76,1.87,1.70,1.70,0.00,0.00,186000,7,332600,0,0,0,0,0,0,136000,50000,86000,86000
20200520,059856,昇陽半永豐99購03,,,,,0.00,0.00,0,0,0,0,0,0,0,0,0,0,0,0,0
20200520,059857,台灣50群益99購06,,,,,0.00,0.00,0,0,0,0,0,0,0,0,0,0,0,0,0
20200520,059858,台灣50群益9A購09,,,,,0.00,0.00,0,0,0,0,0,0,0,0,0,0,0,0,0
20200520,059859,國巨群益9A購03,,,,,0.00,0.00,0,0,0,0,0,0,0,0,0,0,0,0,0
20200520,05985P,燿華統一96售03,,,,,0.00,0.00,0,0,0,0,0,0,0,0,0,0,0,0,0
20200520,059860,台積電群益9A購02,3.66,3.68,3.66,3.68,+0.01,0.27,27000,3,99340,0,0,0,0,0,0,1000,27000,-26000,-26000
20200520,059861,聯發科群益9A購01,6.10,6.10,6.10,6.10,+0.25,4.27,25000,1,152500,0,0,0,0,0,0,25000,0,25000,25000
20200520,059862,全新群益99購04,1.17,1.17,1.07,1.07,-0.10,-8.55,18000,3,20760,0,0,0,0,0,0,15000,3000,12000,12000
20200520,059863,和大凱基99購01,1.81,2.04,1.81,2.04,+0.16,8.51,303000,10,567760,0,0,0,0,0,0,253000,50000,203000,203000
20200520,059864,亞德客凱基99購01,1.79,1.82,1.76,1.76,+0.01,0.57,22000,4,39480,0,0,0,0,0,0,1000,21000,-20000,-20000
20200520,059865,國巨凱基01購01,1.33,1.43,1.33,1.36,+0.09,7.09,1053000,52,1442710,0,0,0,0,0,0,450000,533000,-83000,-83000
20200520,059866,國巨凱基99購18,1.68,1.75,1.68,1.75,+0.17,10.76,23000,2,38850,0,0,0,0,0,0,3000,20000,-17000,-17000
20200520,059867,華邦電凱基99購02,1.22,1.24,1.21,1.21,+0.06,5.22,64000,5,78790,0,0,0,0,0,0,10000,54000,-44000,-44000
20200520,059868,台光電凱基99購03,1.55,1.58,1.52,1.58,+0.01,0.64,214000,23,331000,0,0,0,0,0,0,20000,194000,-174000,-174000
20200520,059869,友達凱基99購07,1.01,1.01,0.96,0.96,-0.03,-3.03,84000,4,83340,0,0,0,0,0,0,0,84000,-84000,-84000
20200520,05986P,大立光統一97售03,,,,,0.00,0.00,0,0,0,0,0,0,0,0,0,0,0,0,0
20200520,059870,全新凱基99購05,0.90,0.90,0.85,0.87,-0.06,-6.45,80000,5,69500,0,0,0,0,0,0,30000,50000,-20000,-20000
20200520,059871,義隆凱基99購03,,,,,0.00,0.00,0,0,0,0,0,0,0,0,0,0,0,0,0
20200520,059872,華新科凱基01購01,0.95,1.00,0.95,0.96,-0.01,-1.03,501000,32,491690,0,0,0,0,0,0,428000,77000,351000,351000
20200520,059873,華新科凱基99購09,1.17,1.17,1.17,1.17,+0.03,2.63,25000,1,29250,0,0,0,0,0,0,0,25000,-25000,-25000
20200520,059874,大立光凱基99購15,,,,,0.00,0.00,0,0,0,0,0,0,0,0,0,0,0,0,0
20200520,059875,信邦凱基99購02,1.61,1.61,1.50,1.50,0.00,0.00,40000,3,61600,0,0,0,0,0,0,0,40000,-40000,-40000
20200520,059876,智易凱基99購02,,,,,0.00,0.00,0,0,0,0,0,0,0,0,0,0,0,0,0
20200520,059877,康控凱基99購05,1.73,1.73,1.66,1.68,+0.02,1.2,51000,13,86520,0,0,0,0,0,0,41000,10000,31000,31000
20200520,059878,聯茂凱基99購07,0.85,0.87,0.84,0.85,-0.04,-4.49,457000,16,391530,0,0,0,0,0,0,236000,231000,5000,5000
20200520,059879,GIS凱基99購03,1.50,1.50,1.50,1.50,0.00,0.00,1000,1,1500,0,0,0,0,0,0,1000,0,1000,1000
20200520,05987P,健策統一96售02,1.01,1.09,1.00,1.09,+0.01,0.93,3000,3,3100,0,0,0,0,0,0,2000,1000,1000,1000
20200520,059880,世紀鋼凱基99購02,1.11,1.11,1.01,1.01,-0.08,-7.34,140000,3,142700,0,0,0,0,0,0,140000,0,140000,140000
20200520,059881,臺股指凱基99購46,2.08,2.10,2.06,2.06,+0.02,0.98,24000,6,49980,0,0,0,0,0,0,15000,9000,6000,6000
20200520,059882,臺股指凱基9C購06,1.66,1.69,1.62,1.65,+0.01,0.61,799000,32,1316100,0,0,0,0,0,0,398000,395000,3000,3000
20200520,059883,T50反1國票99購02,,,,,0.00,0.00,0,0,0,0,0,0,0,0,0,0,0,0,0
20200520,059884,鴻海國票99購09,1.16,1.16,1.14,1.14,-0.11,-8.8,51000,2,58160,0,0,0,0,0,0,50000,1000,49000,49000
20200520,059885,台積電國票99購12,3.47,3.47,3.40,3.44,+0.03,0.88,31000,7,106570,0,0,0,0,0,0,13000,21000,-8000,-8000
20200520,059886,可成國票99購04,2.15,2.15,2.09,2.11,-0.31,-12.81,170000,10,358810,0,0,0,0,0,0,4000,170000,-166000,-166000
20200520,059887,華新科國票99購02,8.30,8.30,8.30,8.30,0.00,0.00,2000,1,16600,0,0,0,0,0,0,0,2000,-2000,-2000
20200520,059888,華新科國票99購03,,,,,0.00,0.00,0,0,0,0,0,0,0,0,0,0,0,0,0
20200520,059889,華新科國票99購04,3.65,3.85,3.65,3.85,+0.17,4.62,63000,5,234010,0,0,0,0,0,0,58000,5000,53000,53000
20200520,05988P,光磊元富96售02,2.42,2.42,2.42,2.42,-0.07,-2.81,10000,1,24200,0,0,0,0,0,0,0,10000,-10000,-10000
20200520,059890,大立光國票99購03,,,,,0.00,0.00,0,0,0,0,0,0,0,0,0,0,0,0,0
20200520,059891,臺股指國票99購25,,,,,0.00,0.00,0,0,0,0,0,0,0,0,0,0,0,0,0
20200520,059892,台灣50台新9A購02,1.28,1.28,1.28,1.28,0.00,0.00,40000,1,51200,0,0,0,0,0,0,40000,0,40000,40000
20200520,059893,台積電台新9A購02,1.12,1.12,1.11,1.11,-0.02,-1.77,2000,2,2230,0,0,0,0,0,0,2000,1000,1000,1000
20200520,059894,台灣50元大9C購19,,,,,0.00,0.00,0,0,0,0,0,0,0,0,0,0,0,0,0
20200520,059895,T50反1元大99購12,,,,,0.00,0.00,0,0,0,0,0,0,0,0,0,0,0,0,0
20200520,059896,T50反1元大99購13,,,,,0.00,0.00,0,0,0,0,0,0,0,0,0,0,0,0,0
20200520,059897,T50反1元大99購14,,,,,0.00,0.00,0,0,0,0,0,0,0,0,0,0,0,0,0
20200520,059898,T50反1元大99購15,0.81,0.81,0.81,0.81,0.00,0.00,10000,1,8100,0,0,0,0,0,0,0,10000,-10000,-10000
20200520,059899,上証2X元大9C購04,,,,,0.00,0.00,0,0,0,0,0,0,0,0,0,0,0,0,0
20200520,05989P,健策元富96售01,0.73,0.76,0.71,0.71,-0.05,-6.58,369000,8,265890,0,0,0,0,0,0,267000,102000,165000,165000
20200520,059900,上証反元大99購03,,,,,0.00,0.00,0,0,0,0,0,0,0,0,0,0,0,0,0
20200520,059901,滬深2X元大9C購07,1.59,1.59,1.59,1.59,-0.05,-3.05,10000,1,15900,0,0,0,0,0,0,10000,0,10000,10000
20200520,059902,滬深2X元大9C購08,,,,,0.00,0.00,0,0,0,0,0,0,0,0,0,0,0,0,0
20200520,059903,S&P正2元大99購02,1.87,1.87,1.87,1.87,0.00,0.00,1000,1,1870,0,0,0,0,0,0,0,0,0,0
20200520,059904,A50正2元大9C購05,,,,,0.00,0.00,0,0,0,0,0,0,0,0,0,0,0,0,0
20200520,059905,A50正2元大9C購06,,,,,0.00,0.00,0,0,0,0,0,0,0,0,0,0,0,0,0
20200520,059906,臺指反元大9C購04,,,,,0.00,0.00,0,0,0,0,0,0,0,0,0,0,0,0,0
20200520,059907,道瓊指元大99購03,2.08,2.10,2.07,2.10,-0.10,-4.55,259000,7,539050,0,0,0,0,0,0,224000,35000,189000,189000
20200520,059908,元金2X元大99購01,1.83,1.83,1.81,1.81,+0.07,4.02,40000,7,72960,0,0,0,0,0,0,16000,20000,-4000,-4000
20200520,059909,鴻海元大99購36,,,,,0.00,0.00,0,0,0,0,0,0,0,0,0,0,0,0,0
20200520,05990P,台積電群益96售13,6.10,6.10,6.10,6.10,0.00,0.00,10000,1,61000,0,0,0,0,0,0,0,10000,-10000,-10000
20200520,059910,鴻海元大99購37,3.14,3.19,3.09,3.09,-0.13,-4.04,76000,7,240160,0,0,0,0,0,0,76000,60000,16000,16000
20200520,059911,國巨元大99購27,2.75,2.93,2.73,2.77,+0.14,5.32,233000,26,659690,0,0,0,0,0,0,47000,186000,-139000,-139000
20200520,059912,國巨元大99購28,,,,,0.00,0.00,0,0,0,0,0,0,0,0,0,0,0,0,0
20200520,059913,台積電元大99購44,1.87,1.87,1.84,1.84,-0.02,-1.08,70000,2,130000,0,0,0,0,0,0,70000,0,70000,70000
20200520,059914,台積電元大99購47,1.93,1.93,1.88,1.89,-0.02,-1.05,102000,3,194280,0,0,0,0,0,0,50000,52000,-2000,-2000
20200520,059915,聯發科元大99購32,3.58,3.59,3.57,3.57,+0.09,2.59,50000,7,178980,0,0,0,0,0,0,50000,3000,47000,47000
20200520,059916,聯發科元大99購33,,,,,0.00,0.00,0,0,0,0,0,0,0,0,0,0,0,0,0
20200520,059917,華新科元大99購19,2.82,2.93,2.80,2.93,+0.17,6.16,43000,4,122650,0,0,0,0,0,0,30000,13000,17000,17000
20200520,059918,華新科元大99購20,1.93,1.97,1.90,1.90,-0.04,-2.06,104000,9,200630,0,0,0,0,0,0,69000,35000,34000,34000
20200520,059919,宏達電元大99購06,2.08,2.24,2.08,2.10,+0.04,1.94,134000,12,290780,0,0,0,0,0,0,70000,106000,-36000,-36000
20200520,05991P,聯茂群益96售05,0.47,0.48,0.45,0.45,-0.02,-4.26,19000,3,8930,0,0,0,0,0,0,5000,14000,-9000,-9000
20200520,059920,宏達電元大99購07,2.08,2.22,2.08,2.09,+0.03,1.46,246000,10,519710,0,0,0,0,0,0,94000,156000,-62000,-62000
20200520,059921,大立光元大99購24,1.64,1.64,1.64,1.64,0.00,0.00,6000,1,9840,0,0,0,0,0,0,0,6000,-6000,-6000
20200520,059922,大立光元大99購25,1.08,1.28,1.08,1.23,-0.01,-0.81,111000,14,139230,0,0,0,0,0,0,47000,63000,-16000,-16000
20200520,059923,緯穎元大99購09,4.83,5.00,4.83,5.00,+0.11,2.25,62000,6,305620,0,0,0,0,0,0,32000,30000,2000,2000
20200520,059924,世紀鋼元大99購06,2.61,2.61,2.36,2.36,-0.10,-4.07,32000,5,79260,0,0,0,0,0,0,11000,21000,-10000,-10000
20200520,059925,可成國泰9B購01,2.58,2.58,2.58,2.58,-0.14,-5.15,5000,1,12900,0,0,0,0,0,0,5000,0,5000,5000
20200520,059926,世紀鋼國泰9B購01,2.41,2.41,2.41,2.41,-0.07,-2.82,4000,1,9640,0,0,0,0,0,0,0,4000,-4000,-4000
20200520,059927,台灣50富邦9A購01,,,,,0.00,0.00,0,0,0,0,0,0,0,0,0,0,0,0,0
20200520,059928,道瓊銀富邦03購01,1.15,1.16,1.15,1.15,+0.12,11.65,480000,14,555180,0,0,0,0,0,0,166000,314000,-148000,-148000
20200520,059929,華新科富邦9C購03,0.77,0.77,0.77,0.77,+0.03,4.05,1000,1,770,0,0,0,0,0,0,1000,1000,0,0
20200520,05992P,華通元大96售05,,,,,0.00,0.00,0,0,0,0,0,0,0,0,0,0,0,0,0
20200520,059930,健策富邦9B購01,2.08,2.20,2.08,2.20,+0.04,1.85,389000,13,839780,0,0,0,0,0,0,22000,367000,-345000,-345000
20200520,059931,緯穎富邦9A購01,0.98,1.02,0.91,0.91,-0.03,-3.19,1303000,46,1270140,0,0,0,0,0,0,1053000,180000,873000,873000
20200520,059932,世紀鋼富邦9A購02,0.70,0.72,0.64,0.64,-0.06,-8.57,402000,17,277190,0,0,0,0,0,0,360000,42000,318000,318000
20200520,059933,台灣50永豐99購11,,,,,0.00,0.00,0,0,0,0,0,0,0,0,0,0,0,0,0
20200520,059934,華通永豐99購02,1.61,1.69,1.60,1.60,-0.12,-6.98,30000,10,49570,0,0,0,0,0,0,2000,28000,-26000,-26000
20200520,059935,國巨永豐99購07,,,,,0.00,0.00,0,0,0,0,0,0,0,0,0,0,0,0,0
20200520,059936,台積電永豐99購06,,,,,0.00,0.00,0,0,0,0,0,0,0,0,0,0,0,0,0
20200520,059937,旺宏永豐99購03,,,,,0.00,0.00,0,0,0,0,0,0,0,0,0,0,0,0,0
20200520,059938,凱美永豐99購01,1.70,1.74,1.69,1.70,+0.04,2.41,196000,8,335530,0,0,0,0,0,0,164000,32000,132000,132000
20200520,059939,技嘉永豐99購01,2.33,2.33,2.19,2.20,-0.03,-1.35,79000,8,178870,0,0,0,0,0,0,25000,54000,-29000,-29000
20200520,05993P,國巨元大96售13,,,,,0.00,0.00,0,0,0,0,0,0,0,0,0,0,0,0,0
20200520,059940,微星永豐99購01,1.92,1.92,1.81,1.81,-0.04,-2.16,558000,29,1050790,0,0,0,0,0,0,70000,483000,-413000,-413000
20200520,059941,聯發科永豐99購04,2.08,2.11,2.01,2.01,+0.09,4.69,12000,4,24690,0,0,0,0,0,0,8000,4000,4000,4000
20200520,059942,全新永豐99購04,,,,,0.00,0.00,0,0,0,0,0,0,0,0,0,0,0,0,0
20200520,059943,信邦永豐99購01,1.23,1.29,1.18,1.18,-0.01,-0.84,236000,16,292100,0,0,0,0,0,0,138000,98000,40000,40000
20200520,059944,欣興永豐99購03,1.45,1.56,1.45,1.49,-0.01,-0.67,244000,10,362450,0,0,0,0,0,0,229000,15000,214000,214000
20200520,059945,嘉澤永豐99購03,2.39,2.39,2.26,2.26,-0.13,-5.44,22000,5,50750,0,0,0,0,0,0,19000,0,19000,19000
20200520,059946,健策永豐99購05,1.78,1.81,1.78,1.81,-0.13,-6.7,21000,2,37620,0,0,0,0,0,0,0,21000,-21000,-21000
20200520,059947,貿聯永豐99購03,1.48,1.49,1.46,1.46,-0.01,-0.68,49000,4,72610,0,0,0,0,0,0,39000,10000,29000,29000
20200520,059948,正文永豐99購01,1.08,1.08,1.08,1.08,0.00,0.00,26000,1,28080,0,0,0,0,0,0,26000,26000,0,0
20200520,059949,啟碁永豐99購01,1.59,1.59,1.57,1.57,-0.03,-1.88,169000,7,266420,0,0,0,0,0,0,139000,30000,109000,109000
20200520,05994P,奇鋐元大96售02,0.38,0.39,0.35,0.35,-0.05,-12.5,63000,12,23810,0,0,0,0,0,0,21000,42000,-21000,-21000
20200520,059950,百和永豐99購02,1.52,1.57,1.52,1.56,+0.09,6.12,191000,12,298160,0,0,0,0,0,0,21000,170000,-149000,-149000
20200520,059951,台塑康和99購01,1.98,1.99,1.86,1.95,-0.02,-1.02,962000,56,1904150,0,0,0,0,0,0,880000,82000,798000,798000
20200520,059952,旺宏康和99購01,,,,,0.00,0.00,0,0,0,0,0,0,0,0,0,0,0,0,0
20200520,059953,聯發科康和99購01,4.03,4.10,4.03,4.10,+0.17,4.33,25000,3,101100,0,0,0,0,0,0,25000,20000,5000,5000
20200520,059954,華新科康和99購01,2.32,2.42,2.24,2.24,-0.07,-3.03,94000,8,221820,0,0,0,0,0,0,69000,54000,15000,15000
20200520,059955,美食康和99購01,3.08,3.28,2.86,2.86,-0.09,-3.05,86000,21,272440,0,0,0,0,0,0,76000,0,76000,76000
20200520,059956,玉山金康和99購01,1.77,1.77,1.77,1.77,+0.01,0.57,11000,2,19470,0,0,0,0,0,0,11000,11000,0,0
20200520,059957,中信金康和99購01,1.99,1.99,1.99,1.99,0.00,0.00,24000,2,47760,0,0,0,0,0,0,24000,0,24000,24000
20200520,059958,鎧勝康和99購01,2.13,2.13,2.13,2.13,+0.12,5.97,160000,1,340800,0,0,0,0,0,0,160000,160000,0,0
20200520,059959,訊芯康和99購01,2.48,2.48,2.42,2.45,+0.11,4.7,52000,7,128480,0,0,0,0,0,0,47000,5000,42000,42000
20200520,05995P,T50正2中信9C售01,3.04,3.05,3.03,3.05,-0.04,-1.29,65000,5,197700,0,0,0,0,0,0,30000,35000,-5000,-5000
20200520,059960,健策國票99購01,,,,,0.00,0.00,0,0,0,0,0,0,0,0,0,0,0,0,0
20200520,059961,T50反1凱基99購09,0.42,0.42,0.41,0.42,-0.01,-2.33,405000,4,168090,0,0,0,0,0,0,201000,204000,-3000,-3000
20200520,059962,S&P正2凱基99購02,,,,,0.00,0.00,0,0,0,0,0,0,0,0,0,0,0,0,0
20200520,059963,臺指反凱基99購01,,,,,0.00,0.00,0,0,0,0,0,0,0,0,0,0,0,0,0
20200520,059964,元金2X凱基99購02,,,,,0.00,0.00,0,0,0,0,0,0,0,0,0,0,0,0,0
20200520,059965,鴻海凱基99購16,0.62,0.62,0.61,0.61,0.00,0.00,60000,2,36700,0,0,0,0,0,0,10000,50000,-40000,-40000
20200520,059966,台積電凱基99購19,,,,,0.00,0.00,0,0,0,0,0,0,0,0,0,0,0,0,0
20200520,059967,聯發科凱基99購20,1.63,1.63,1.54,1.54,+0.05,3.36,19000,4,29900,0,0,0,0,0,0,18000,1000,17000,17000
20200520,059968,世紀鋼凱基99購03,,,,,0.00,0.00,0,0,0,0,0,0,0,0,0,0,0,0,0
20200520,059969,台灣50元大9B購06,,,,,0.00,0.00,0,0,0,0,0,0,0,0,0,0,0,0,0
20200520,05996P,華新科群益96售03,4.39,4.39,4.39,4.39,-0.42,-8.73,1000,1,4390,0,0,0,0,0,0,0,1000,-1000,-1000
20200520,059970,台灣50元大9B購07,,,,,0.00,0.00,0,0,0,0,0,0,0,0,0,0,0,0,0
20200520,059971,台灣50元大9B購08,,,,,0.00,0.00,0,0,0,0,0,0,0,0,0,0,0,0,0
20200520,059972,S&P正2元大99購03,3.07,3.07,3.07,3.07,-0.01,-0.32,120000,1,368400,0,0,0,0,0,0,0,120000,-120000,-120000
20200520,059973,A50正2元大99購02,,,,,0.00,0.00,0,0,0,0,0,0,0,0,0,0,0,0,0
20200520,059974,臺指反元大9C購05,,,,,0.00,0.00,0,0,0,0,0,0,0,0,0,0,0,0,0
20200520,059975,元金2X元大99購02,1.89,1.89,1.76,1.76,0.00,0.00,262000,21,463260,0,0,0,0,0,0,124000,101000,23000,23000
20200520,059976,道瓊銀元大99購01,1.71,1.77,1.70,1.70,+0.21,14.09,723000,25,1244090,0,0,0,0,0,0,140000,573000,-433000,-433000
20200520,059977,鴻海元大99購40,,,,,0.00,0.00,0,0,0,0,0,0,0,0,0,0,0,0,0
20200520,059978,國巨元大99購29,2.71,2.78,2.71,2.78,+0.15,5.7,2000,2,5490,0,0,0,0,0,0,2000,0,2000,2000
20200520,059979,台積電元大99購49,1.81,1.82,1.81,1.82,-0.01,-0.55,58000,2,105480,0,0,0,0,0,0,8000,50000,-42000,-42000
20200520,05997P,嘉聯益群益96售02,,,,,0.00,0.00,0,0,0,0,0,0,0,0,0,0,0,0,0
20200520,059980,台積電元大99購50,1.76,1.76,1.73,1.73,-0.02,-1.14,91000,3,159530,0,0,0,0,0,0,20000,71000,-51000,-51000
20200520,059981,聯發科元大99購36,3.42,3.60,3.41,3.46,+0.13,3.9,87000,12,302190,0,0,0,0,0,0,58000,35000,23000,23000
20200520,059982,聯發科元大99購37,,,,,0.00,0.00,0,0,0,0,0,0,0,0,0,0,0,0,0
20200520,059983,聯發科元大99購38,3.45,3.48,3.45,3.48,+0.08,2.35,30000,3,103800,0,0,0,0,0,0,30000,0,30000,30000
20200520,059984,華新科元大99購21,1.98,1.98,1.95,1.95,+0.08,4.28,50000,5,98200,0,0,0,0,0,0,50000,0,50000,50000
20200520,059985,華新科元大99購22,2.72,2.78,2.69,2.72,+0.02,0.74,113000,12,306790,0,0,0,0,0,0,100000,20000,80000,80000
20200520,059986,宏達電元大99購08,1.72,1.86,1.71,1.75,+0.05,2.94,244000,19,430400,0,0,0,0,0,0,193000,75000,118000,118000
20200520,059987,大立光元大99購28,,,,,0.00,0.00,0,0,0,0,0,0,0,0,0,0,0,0,0
20200520,059988,大立光元大9A購02,1.71,1.71,1.67,1.67,-0.06,-3.47,144000,5,245740,0,0,0,0,0,0,140000,4000,136000,136000
20200520,059989,嘉晶元大9A購01,3.67,4.03,3.64,4.03,+0.45,12.57,159000,13,587330,0,0,0,0,0,0,67000,92000,-25000,-25000
20200520,05998P,台積電元大97售12,,,,,0.00,0.00,0,0,0,0,0,0,0,0,0,0,0,0,0
20200520,059990,健策元大9A購01,4.31,4.51,4.29,4.51,+0.28,6.62,65000,10,286390,0,0,0,0,0,0,40000,57000,-17000,-17000
20200520,059991,超眾元大9A購02,3.17,3.17,3.17,3.17,+0.03,0.96,10000,1,31700,0,0,0,0,0,0,10000,0,10000,10000
20200520,059992,S&P正2元富9B購04,1.99,2.00,1.99,2.00,-0.04,-1.96,43000,5,85980,0,0,0,0,0,0,21000,22000,-1000,-1000
20200520,059993,上銀元富99購01,5.15,5.15,5.15,5.15,+0.15,3.0,40000,1,206000,0,0,0,0,0,0,40000,0,40000,40000
20200520,059994,國巨元富99購01,,,,,0.00,0.00,0,0,0,0,0,0,0,0,0,0,0,0,0
20200520,059995,南亞科元富99購01,2.49,2.60,2.49,2.50,+0.04,1.63,242000,19,609060,0,0,0,0,0,0,102000,140000,-38000,-38000
20200520,059996,美律元富99購01,2.07,2.07,1.98,2.01,-0.11,-5.19,233000,11,470230,0,0,0,0,0,0,149000,138000,11000,11000
20200520,059997,華航元富99購01,2.23,2.23,2.16,2.16,+0.05,2.37,108000,8,240000,0,0,0,0,0,0,103000,5000,98000,98000
20200520,059998,華航元富99購02,2.72,2.72,2.68,2.68,+0.09,3.47,85000,2,229800,0,0,0,0,0,0,85000,0,85000,85000
20200520,059999,緯穎元富99購01,3.90,4.00,3.66,3.66,-0.35,-8.73,367000,37,1427610,0,0,0,0,0,0,269000,53000,216000,216000
20200520,05999P,世芯元大96售01,0.11,0.11,0.11,0.11,0.00,0.00,5000,1,550,0,0,0,0,0,0,0,5000,-5000,-5000
20200520,060000,國巨台新99購01,,,,,0.00,0.00,0,0,0,0,0,0,0,0,0,0,0,0,0
20200520,060001,台灣50群益9A購10,,,,,0.00,0.00,0,0,0,0,0,0,0,0,0,0,0,0,0
20200520,060002,T50反1群益9A購01,0.43,0.43,0.43,0.43,0.00,0.00,2000,1,860,0,0,0,0,0,0,0,2000,-2000,-2000
20200520,060003,上証2X群益9B購02,,,,,0.00,0.00,0,0,0,0,0,0,0,0,0,0,0,0,0
20200520,060004,臺指反群益9A購01,,,,,0.00,0.00,0,0,0,0,0,0,0,0,0,0,0,0,0
20200520,060005,上銀群益99購03,,,,,0.00,0.00,0,0,0,0,0,0,0,0,0,0,0,0,0
20200520,060006,華通群益9A購04,,,,,0.00,0.00,0,0,0,0,0,0,0,0,0,0,0,0,0
20200520,060007,鴻海群益99購04,,,,,0.00,0.00,0,0,0,0,0,0,0,0,0,0,0,0,0
20200520,060008,華邦電群益9A購01,1.49,1.57,1.46,1.46,+0.06,4.29,703000,28,1062370,0,0,0,0,0,0,291000,412000,-121000,-121000
20200520,060009,南亞科群益99購03,2.39,2.50,2.39,2.50,+0.16,6.84,115000,8,281430,0,0,0,0,0,0,58000,57000,1000,1000
20200520,06000P,GIS元大96售04,2.01,2.02,2.01,2.02,-0.08,-3.81,30000,2,60500,0,0,0,0,0,0,30000,0,30000,30000
20200520,060010,義隆群益99購02,3.37,3.37,3.37,3.37,-0.02,-0.59,30000,1,101100,0,0,0,0,0,0,0,30000,-30000,-30000
20200520,060011,臺股指群益9C購06,3.50,3.53,3.50,3.53,+0.04,1.15,59000,2,206770,0,0,0,0,0,0,50000,9000,41000,41000
20200520,060012,電子類群益99購02,,,,,0.00,0.00,0,0,0,0,0,0,0,0,0,0,0,0,0
20200520,060013,S&P正2康和99購01,3.07,3.07,3.07,3.07,-0.05,-1.6,1000,1,3070,0,0,0,0,0,0,0,1000,-1000,-1000
20200520,060014,中鋼康和99購01,1.41,1.41,1.41,1.41,+0.01,0.71,283000,4,399030,0,0,0,0,0,0,79000,204000,-125000,-125000
20200520,060015,國巨康和99購03,3.15,3.39,3.14,3.19,+0.20,6.69,152000,10,491000,0,0,0,0,0,0,51000,102000,-51000,-51000
20200520,060016,廣達康和99購01,2.28,2.28,2.10,2.14,-0.05,-2.28,294000,47,664390,0,0,0,0,0,0,292000,9000,283000,283000
20200520,060017,全新康和99購01,,,,,0.00,0.00,0,0,0,0,0,0,0,0,0,0,0,0,0
20200520,060018,國產康和99購01,2.72,2.72,2.69,2.69,-0.07,-2.54,10000,6,27170,0,0,0,0,0,0,10000,0,10000,10000
20200520,060019,彰銀康和99購01,1.21,1.21,1.21,1.21,-0.01,-0.82,10000,1,12100,0,0,0,0,0,0,10000,0,10000,10000
20200520,06001P,樺漢台新96售01,,,,,0.00,0.00,0,0,0,0,0,0,0,0,0,0,0,0,0
20200520,060020,康控康和99購01,2.63,2.63,2.48,2.48,+0.26,11.71,295000,33,753850,0,0,0,0,0,0,254000,21000,233000,233000
20200520,060021,立積康和99購01,,,,,0.00,0.00,0,0,0,0,0,0,0,0,0,0,0,0,0
20200520,060022,勤誠康和99購01,3.01,3.07,3.01,3.07,+0.02,0.66,15000,2,45690,0,0,0,0,0,0,15000,0,15000,15000
20200520,060023,T50反1國泰9A購03,,,,,0.00,0.00,0,0,0,0,0,0,0,0,0,0,0,0,0
20200520,060024,T50反1國泰9B購02,0.82,0.83,0.82,0.83,-0.01,-1.19,50000,2,41250,0,0,0,0,0,0,50000,0,50000,50000
20200520,060025,台積電富邦9C購06,,,,,0.00,0.00,0,0,0,0,0,0,0,0,0,0,0,0,0
20200520,060026,聯發科富邦9B購05,2.50,2.61,2.49,2.52,+0.07,2.86,177000,12,452120,0,0,0,0,0,0,171000,6000,165000,165000
20200520,060027,元金2X永豐99購02,0.94,0.94,0.93,0.93,+0.03,3.33,74000,2,68960,0,0,0,0,0,0,74000,0,74000,74000
20200520,060028,國揚永豐99購01,1.43,1.51,1.39,1.51,-0.08,-5.03,1513000,125,2216340,0,0,0,0,0,0,1481000,14000,1467000,1467000
20200520,060029,嘉晶永豐99購03,1.39,1.65,1.39,1.65,+0.24,17.02,180000,19,274790,0,0,0,0,0,0,130000,50000,80000,80000
20200520,06002P,華通康和96售01,,,,,0.00,0.00,0,0,0,0,0,0,0,0,0,0,0,0,0
20200520,060030,晶相光永豐99購03,1.16,1.19,1.16,1.19,+0.01,0.85,174000,2,203580,0,0,0,0,0,0,116000,58000,58000,58000
20200520,060031,旭富永豐99購02,0.73,0.77,0.73,0.74,-0.01,-1.33,214000,3,163200,0,0,0,0,0,0,52000,162000,-110000,-110000
20200520,060032,利勤永豐99購01,0.82,0.91,0.82,0.91,+0.13,16.67,91000,6,81550,0,0,0,0,0,0,0,91000,-91000,-91000
20200520,060033,臻鼎永豐99購01,1.15,1.27,1.15,1.25,+0.11,9.65,230000,18,280120,0,0,0,0,0,0,70000,160000,-90000,-90000
20200520,060034,立積永豐99購04,1.34,1.34,1.25,1.25,-0.04,-3.1,51000,5,66040,0,0,0,0,0,0,32000,19000,13000,13000
20200520,060035,臺股指永豐99購04,,,,,0.00,0.00,0,0,0,0,0,0,0,0,0,0,0,0,0
20200520,060036,上証2X國票99購03,,,,,0.00,0.00,0,0,0,0,0,0,0,0,0,0,0,0,0
20200520,060037,鴻海國票99購10,2.51,2.51,2.51,2.51,0.00,0.00,50000,1,125500,0,0,0,0,0,0,50000,0,50000,50000
20200520,060038,台積電國票99購13,2.36,2.36,2.30,2.33,-0.02,-0.85,71000,5,166060,0,0,0,0,0,0,16000,55000,-39000,-39000
20200520,060039,大立光國票99購04,,,,,0.00,0.00,0,0,0,0,0,0,0,0,0,0,0,0,0
20200520,06003P,亞光康和96售02,1.06,1.06,1.06,1.06,0.00,0.00,20000,1,21200,0,0,0,0,0,0,20000,0,20000,20000
20200520,060040,康控國票99購04,6.95,6.95,6.80,6.85,+0.40,6.2,167000,29,1155750,0,0,0,0,0,0,164000,3000,161000,161000
20200520,060041,T50反1群益99購04,,,,,0.00,0.00,0,0,0,0,0,0,0,0,0,0,0,0,0
20200520,060042,台積電群益99購12,1.32,1.32,1.31,1.32,0.00,0.00,390000,10,512720,0,0,0,0,0,0,275000,115000,160000,160000
20200520,060043,全新群益9B購02,1.99,1.99,1.82,1.83,-0.20,-9.85,192000,13,371220,0,0,0,0,0,0,29000,163000,-134000,-134000
20200520,060044,大立光群益99購09,2.53,2.54,2.53,2.54,+0.04,1.6,32000,2,80980,0,0,0,0,0,0,0,32000,-32000,-32000
20200520,060045,嘉晶群益99購02,2.25,2.80,2.25,2.80,+0.42,17.65,421000,26,1069160,0,0,0,0,0,0,52000,369000,-317000,-317000
20200520,060046,S&P反1凱基99購02,,,,,0.00,0.00,0,0,0,0,0,0,0,0,0,0,0,0,0
20200520,060047,道瓊反凱基99購01,0.35,0.35,0.34,0.34,-0.01,-2.86,78000,10,26680,0,0,0,0,0,0,61000,11000,50000,50000
20200520,060048,元金2X凱基99購03,1.41,1.43,1.41,1.43,+0.09,6.72,200000,4,284500,0,0,0,0,0,0,50000,130000,-80000,-80000
20200520,060049,華通凱基99購06,1.75,1.75,1.74,1.75,+0.01,0.57,79000,6,137990,0,0,0,0,0,0,0,79000,-79000,-79000
20200520,06004P,奇力新永豐96售02,1.11,1.12,1.11,1.11,-0.08,-6.72,43000,6,47740,0,0,0,0,0,0,0,43000,-43000,-43000
20200520,060050,鴻海凱基9B購01,1.36,1.36,1.35,1.35,+0.01,0.75,59000,3,79890,0,0,0,0,0,0,35000,24000,11000,11000
20200520,060051,台積電凱基9B購01,0.94,0.94,0.93,0.94,+0.01,1.08,40000,5,37550,0,0,0,0,0,0,30000,10000,20000,20000
20200520,060052,宏碁凱基99購01,1.38,1.40,1.38,1.40,-0.02,-1.41,108000,3,149840,0,0,0,0,0,0,40000,68000,-28000,-28000
20200520,060053,聯發科凱基9B購02,2.22,2.22,2.22,2.22,+0.01,0.45,10000,1,22200,0,0,0,0,0,0,10000,0,10000,10000
20200520,060054,華新科凱基9B購04,1.31,1.31,1.31,1.31,+0.09,7.38,10000,1,13100,0,0,0,0,0,0,10000,0,10000,10000
20200520,060055,宏達電凱基99購06,0.71,0.75,0.71,0.72,+0.03,4.35,79000,5,56690,0,0,0,0,0,0,69000,19000,50000,50000
20200520,060056,大立光凱基9B購01,0.91,0.91,0.91,0.91,+0.05,5.81,40000,2,36400,0,0,0,0,0,0,0,40000,-40000,-40000
20200520,060057,欣興凱基9B購01,1.36,1.46,1.36,1.38,-0.02,-1.43,129000,10,181210,0,0,0,0,0,0,92000,36000,56000,56000
20200520,060058,牧德凱基9B購01,1.68,1.94,1.66,1.94,+0.31,19.02,413000,30,739610,0,0,0,0,0,0,84000,309000,-225000,-225000
20200520,060059,鴻海兆豐99購06,1.64,1.64,1.64,1.64,-0.06,-3.53,9000,1,14760,0,0,0,0,0,0,0,9000,-9000,-9000
20200520,06005P,晶豪科永豐96售04,0.44,0.49,0.43,0.48,+0.03,6.67,212000,14,98690,0,0,0,0,0,0,42000,170000,-128000,-128000
20200520,060060,台積電兆豐99購05,0.73,0.75,0.73,0.75,+0.01,1.35,270000,6,197350,0,0,0,0,0,0,205000,65000,140000,140000
20200520,060061,旺宏兆豐99購02,1.77,1.77,1.77,1.77,0.00,0.00,8000,1,14160,0,0,0,0,0,0,0,8000,-8000,-8000
20200520,060062,聯發科兆豐99購04,,,,,0.00,0.00,0,0,0,0,0,0,0,0,0,0,0,0,0
20200520,060063,可成兆豐9B購01,2.31,2.31,2.24,2.24,-0.19,-7.82,319000,5,714990,0,0,0,0,0,0,9000,310000,-301000,-301000
20200520,060064,華新科兆豐99購07,1.72,1.79,1.65,1.65,-0.07,-4.07,272000,16,481890,0,0,0,0,0,0,262000,10000,252000,252000
20200520,060065,大立光兆豐9B購01,1.65,1.73,1.65,1.68,+0.02,1.2,26000,6,43740,0,0,0,0,0,0,14000,12000,2000,2000
20200520,060066,欣興兆豐9B購01,1.75,1.75,1.70,1.70,+0.18,11.84,4000,2,6850,0,0,0,0,0,0,1000,3000,-2000,-2000
20200520,060067,T50反1元富99購11,,,,,0.00,0.00,0,0,0,0,0,0,0,0,0,0,0,0,0
20200520,060068,T50反1元富99購12,,,,,0.00,0.00,0,0,0,0,0,0,0,0,0,0,0,0,0
20200520,060069,T50反1元富99購13,,,,,0.00,0.00,0,0,0,0,0,0,0,0,0,0,0,0,0
20200520,06006P,欣興永豐96售04,0.35,0.38,0.30,0.33,-0.06,-15.38,143000,32,48360,0,0,0,0,0,0,75000,68000,7000,7000
20200520,060070,國巨元富99購02,,,,,0.00,0.00,0,0,0,0,0,0,0,0,0,0,0,0,0
20200520,060071,國巨元富99購03,3.49,3.49,3.49,3.49,0.00,0.00,3000,1,10470,0,0,0,0,0,0,0,3000,-3000,-3000
20200520,060072,國巨元富99購04,2.96,3.19,2.96,3.06,0.00,0.00,709000,26,2176080,0,0,0,0,0,0,543000,166000,377000,377000
20200520,060073,台積電元富99購03,1.90,1.94,1.90,1.94,+0.04,2.11,49000,3,93300,0,0,0,0,0,0,44000,5000,39000,39000
20200520,060074,台積電元富99購04,,,,,0.00,0.00,0,0,0,0,0,0,0,0,0,0,0,0,0
20200520,060075,台積電元富99購05,,,,,0.00,0.00,0,0,0,0,0,0,0,0,0,0,0,0,0
20200520,060076,台灣50台新9B購05,,,,,0.00,0.00,0,0,0,0,0,0,0,0,0,0,0,0,0
20200520,060077,台積電台新9B購01,1.04,1.04,1.02,1.02,-0.01,-0.97,21000,2,21440,0,0,0,0,0,0,21000,1000,20000,20000
20200520,060078,旺宏台新99購03,,,,,0.00,0.00,0,0,0,0,0,0,0,0,0,0,0,0,0
20200520,060079,台郡台新99購03,,,,,0.00,0.00,0,0,0,0,0,0,0,0,0,0,0,0,0
20200520,06007P,世芯永豐96售01,0.05,0.05,0.05,0.05,+0.01,25.0,650000,2,32500,0,0,0,0,0,0,650000,0,650000,650000
20200520,060080,台灣50元大02購01,,,,,0.00,0.00,0,0,0,0,0,0,0,0,0,0,0,0,0
20200520,060081,台灣50元大02購02,,,,,0.00,0.00,0,0,0,0,0,0,0,0,0,0,0,0,0
20200520,060082,臺指反元大9C購06,,,,,0.00,0.00,0,0,0,0,0,0,0,0,0,0,0,0,0
20200520,060083,和大元大99購02,3.19,3.59,3.13,3.57,+0.38,11.91,569000,48,1917980,0,0,0,0,0,0,102000,490000,-388000,-388000
20200520,060084,聯電元大99購02,1.73,1.76,1.62,1.62,-0.09,-5.26,119000,9,201520,0,0,0,0,0,0,68000,51000,17000,17000
20200520,060085,華通元大99購10,3.17,3.25,3.13,3.13,-0.07,-2.19,110000,4,349600,0,0,0,0,0,0,60000,80000,-20000,-20000
20200520,060086,鴻海元大99購42,,,,,0.00,0.00,0,0,0,0,0,0,0,0,0,0,0,0,0
20200520,060087,鴻海元大99購43,2.36,2.36,2.36,2.36,+0.01,0.43,2000,1,4720,0,0,0,0,0,0,0,2000,-2000,-2000
20200520,060088,國巨元大99購30,5.50,5.50,5.50,5.50,0.00,0.00,1000,1,5500,0,0,0,0,0,0,0,1000,-1000,-1000
20200520,060089,台積電元大99購54,,,,,0.00,0.00,0,0,0,0,0,0,0,0,0,0,0,0,0
20200520,06008P,燿華統一96售04,,,,,0.00,0.00,0,0,0,0,0,0,0,0,0,0,0,0,0
20200520,060090,台積電元大99購55,,,,,0.00,0.00,0,0,0,0,0,0,0,0,0,0,0,0,0
20200520,060091,技嘉元大99購03,4.15,4.18,4.13,4.15,-0.06,-1.43,231000,5,959570,0,0,0,0,0,0,231000,0,231000,231000
20200520,060092,瑞昱元大99購03,3.19,3.26,3.05,3.07,-0.07,-2.23,258000,29,815770,0,0,0,0,0,0,179000,124000,55000,55000
20200520,060093,友達元大03購01,2.23,2.31,2.16,2.17,-0.03,-1.36,251000,17,552110,0,0,0,0,0,0,135000,116000,19000,19000
20200520,060094,聯發科元大99購41,,,,,0.00,0.00,0,0,0,0,0,0,0,0,0,0,0,0,0
20200520,060095,聯發科元大99購42,6.80,7.10,6.80,7.00,+0.30,4.48,17000,4,116100,0,0,0,0,0,0,17000,0,17000,17000
20200520,060096,聯發科元大99購43,3.92,4.14,3.91,3.95,+0.14,3.67,91000,13,362320,0,0,0,0,0,0,82000,16000,66000,66000
20200520,060097,華新科元大99購23,3.12,3.23,3.08,3.23,+0.13,4.19,97000,8,305580,0,0,0,0,0,0,85000,12000,73000,73000
20200520,060098,華新科元大99購24,2.61,2.68,2.54,2.54,-0.07,-2.68,121000,18,314860,0,0,0,0,0,0,118000,17000,101000,101000
20200520,060099,宏達電元大99購09,1.72,1.84,1.72,1.76,+0.04,2.33,327000,14,578340,0,0,0,0,0,0,137000,208000,-71000,-71000
20200520,06009P,宏達電元富96售03,,,,,0.00,0.00,0,0,0,0,0,0,0,0,0,0,0,0,0
20200520,060100,新光金元大9C購01,1.46,1.49,1.45,1.45,0.00,0.00,384000,9,565490,0,0,0,0,0,0,129000,255000,-126000,-126000
20200520,060101,大立光元大99購31,,,,,0.00,0.00,0,0,0,0,0,0,0,0,0,0,0,0,0
20200520,060102,禾伸堂元大99購06,,,,,0.00,0.00,0,0,0,0,0,0,0,0,0,0,0,0,0
20200520,060103,聯詠元大99購01,2.74,2.86,2.74,2.81,+0.01,0.36,133000,15,369920,0,0,0,0,0,0,103000,30000,73000,73000
20200520,060104,新日興元大99購03,2.11,2.40,2.03,2.40,+0.23,10.6,282000,17,620150,0,0,0,0,0,0,79000,203000,-124000,-124000
20200520,060105,牧德元大9B購01,4.95,5.60,4.95,5.60,+0.62,12.45,128000,13,666850,0,0,0,0,0,0,32000,96000,-64000,-64000
20200520,060106,旭富元大99購02,,,,,0.00,0.00,0,0,0,0,0,0,0,0,0,0,0,0,0
20200520,060107,旭富元大99購03,2.02,2.02,2.02,2.02,-0.09,-4.27,114000,4,230280,0,0,0,0,0,0,0,114000,-114000,-114000
20200520,060108,泰鼎元大99購04,3.36,3.57,3.26,3.57,+0.17,5.0,65000,8,221160,0,0,0,0,0,0,40000,27000,13000,13000
20200520,060109,茂林元大99購05,2.66,3.25,2.66,3.25,+0.65,25.0,600000,26,1793310,0,0,0,0,0,0,338000,253000,85000,85000
20200520,06010P,國泰金元富96售01,1.47,1.49,1.43,1.46,-0.10,-6.41,183000,24,268050,0,0,0,0,0,0,98000,85000,13000,13000
20200520,060110,茂林元大99購06,1.96,2.33,1.96,2.33,+0.36,18.27,259000,20,545730,0,0,0,0,0,0,93000,239000,-146000,-146000
20200520,060111,臻鼎元大99購04,2.81,3.01,2.81,3.01,+0.19,6.74,212000,10,620170,0,0,0,0,0,0,10000,192000,-182000,-182000
20200520,060112,祥碩元大99購04,,,,,0.00,0.00,0,0,0,0,0,0,0,0,0,0,0,0,0
20200520,060113,祥碩元大9B購01,6.10,6.40,6.10,6.40,+0.20,3.23,85000,8,530150,0,0,0,0,0,0,1000,84000,-83000,-83000
20200520,060114,緯穎元大99購10,3.18,3.18,3.12,3.12,-0.07,-2.19,6000,3,18900,0,0,0,0,0,0,0,6000,-6000,-6000
20200520,060115,南電元大99購06,2.75,2.78,2.52,2.62,-0.09,-3.32,127000,16,344010,0,0,0,0,0,0,51000,76000,-25000,-25000
20200520,060116,世紀鋼元大99購07,2.62,2.62,2.54,2.54,-0.03,-1.17,17000,2,43740,0,0,0,0,0,0,17000,0,17000,17000
20200520,060117,國巨國泰9B購04,,,,,0.00,0.00,0,0,0,0,0,0,0,0,0,0,0,0,0
20200520,060118,臺指反富邦9C購01,,,,,0.00,0.00,0,0,0,0,0,0,0,0,0,0,0,0,0
20200520,060119,上銀富邦9B購03,,,,,0.00,0.00,0,0,0,0,0,0,0,0,0,0,0,0,0
20200520,06011P,貿聯元富96售04,,,,,0.00,0.00,0,0,0,0,0,0,0,0,0,0,0,0,0
20200520,060120,聯電富邦9B購01,,,,,0.00,0.00,0,0,0,0,0,0,0,0,0,0,0,0,0
20200520,060121,新光金富邦99購01,0.71,0.73,0.71,0.71,0.00,0.00,253000,13,181960,0,0,0,0,0,0,100000,153000,-53000,-53000
20200520,060122,亞德客永豐99購02,1.29,1.29,1.29,1.29,+0.06,4.88,1000,1,1290,0,0,0,0,0,0,0,1000,-1000,-1000
20200520,060123,光罩永豐99購02,0.94,0.96,0.94,0.96,+0.07,7.87,33000,5,31170,0,0,0,0,0,0,5000,28000,-23000,-23000
20200520,060124,奇力新永豐99購03,1.42,1.48,1.42,1.48,+0.09,6.47,99000,2,145980,0,0,0,0,0,0,99000,0,99000,99000
20200520,060125,強茂永豐99購01,1.49,1.49,1.49,1.49,0.00,0.00,3000,1,4470,0,0,0,0,0,0,3000,0,3000,3000
20200520,060126,創意永豐99購04,1.20,1.25,1.19,1.25,+0.03,2.46,238000,7,292980,0,0,0,0,0,0,30000,208000,-178000,-178000
20200520,060127,牧德永豐99購02,1.69,1.99,1.69,1.93,+0.29,17.68,417000,21,755020,0,0,0,0,0,0,76000,341000,-265000,-265000
20200520,060128,健策永豐99購06,1.10,1.18,1.10,1.18,-0.07,-5.6,217000,3,246900,0,0,0,0,0,0,101000,117000,-16000,-16000
20200520,060129,祥碩永豐99購03,2.18,2.26,2.18,2.26,+0.24,11.88,19000,2,42140,0,0,0,0,0,0,10000,9000,1000,1000
20200520,06012P,世芯國票96售01,,,,,0.00,0.00,0,0,0,0,0,0,0,0,0,0,0,0,0
20200520,060130,瀚宇博永豐99購02,1.02,1.02,1.02,1.02,-0.01,-0.97,10000,1,10200,0,0,0,0,0,0,10000,0,10000,10000
20200520,060131,GIS永豐99購03,1.42,1.42,1.42,1.42,-0.03,-2.07,45000,1,63900,0,0,0,0,0,0,0,45000,-45000,-45000
20200520,060132,滬深2X群益9C購02,,,,,0.00,0.00,0,0,0,0,0,0,0,0,0,0,0,0,0
20200520,060133,牧德群益9B購01,2.44,2.76,2.40,2.74,+0.33,13.69,445000,15,1159770,0,0,0,0,0,0,230000,215000,15000,15000
20200520,060134,鈺齊群益9A購01,1.28,1.31,1.27,1.27,+0.01,0.79,583000,19,750460,0,0,0,0,0,0,287000,296000,-9000,-9000
20200520,060135,台灣50國票9C購02,,,,,0.00,0.00,0,0,0,0,0,0,0,0,0,0,0,0,0
20200520,060136,T50反1國票9A購01,,,,,0.00,0.00,0,0,0,0,0,0,0,0,0,0,0,0,0
20200520,060137,T50反1國票9A購02,,,,,0.00,0.00,0,0,0,0,0,0,0,0,0,0,0,0,0
20200520,060138,T50反1國票9A購03,,,,,0.00,0.00,0,0,0,0,0,0,0,0,0,0,0,0,0
20200520,060139,T50反1國票9A購04,0.46,0.46,0.46,0.46,0.00,0.00,5000,1,2300,0,0,0,0,0,0,0,5000,-5000,-5000
20200520,06013P,世芯國泰97售03,0.13,0.30,0.13,0.30,+0.16,114.29,61000,5,8700,0,0,0,0,0,0,30000,30000,0,0
20200520,060140,T50反1國票9A購05,,,,,0.00,0.00,0,0,0,0,0,0,0,0,0,0,0,0,0
20200520,060141,T50反1國票9B購02,,,,,0.00,0.00,0,0,0,0,0,0,0,0,0,0,0,0,0
20200520,060142,臺指反國票9B購01,,,,,0.00,0.00,0,0,0,0,0,0,0,0,0,0,0,0,0
20200520,060143,台積電國票9B購03,3.61,3.61,3.61,3.61,-0.04,-1.1,5000,1,18050,0,0,0,0,0,0,5000,0,5000,5000
20200520,060144,全新國票9B購01,,,,,0.00,0.00,0,0,0,0,0,0,0,0,0,0,0,0,0
20200520,060145,牧德國票9A購02,7.25,8.10,7.25,8.10,0.00,0.00,4000,4,30750,0,0,0,0,0,0,1000,4000,-3000,-3000
20200520,060146,健策國票9A購03,,,,,0.00,0.00,0,0,0,0,0,0,0,0,0,0,0,0,0
20200520,060147,臺股指國票9A購07,,,,,0.00,0.00,0,0,0,0,0,0,0,0,0,0,0,0,0
20200520,060148,臺股指國票9A購08,4.10,4.10,4.10,4.10,+0.05,1.23,3000,1,12300,0,0,0,0,0,0,3000,0,3000,3000
20200520,060149,元金2X富邦04購01,6.15,6.15,6.15,6.15,+0.15,2.5,31000,2,190650,0,0,0,0,0,0,31000,0,31000,31000
20200520,06014P,聯發科富邦97售02,,,,,0.00,0.00,0,0,0,0,0,0,0,0,0,0,0,0,0
20200520,060150,華通富邦9B購01,1.11,1.11,1.11,1.11,0.00,0.00,3000,1,3330,0,0,0,0,0,0,3000,0,3000,3000
20200520,060151,旺宏富邦9A購02,1.10,1.11,1.10,1.11,+0.01,0.91,20000,2,22100,0,0,0,0,0,0,10000,10000,0,0
20200520,060152,上証2X永豐9A購02,0.88,0.88,0.88,0.88,0.00,0.00,10000,1,8800,0,0,0,0,0,0,0,10000,-10000,-10000
20200520,060153,A50正2永豐9A購01,,,,,0.00,0.00,0,0,0,0,0,0,0,0,0,0,0,0,0
20200520,060154,堤維西永豐9A購01,1.07,1.09,1.07,1.09,+0.03,2.83,62000,4,66430,0,0,0,0,0,0,55000,7000,48000,48000
20200520,060155,友訊永豐9A購01,0.83,0.86,0.83,0.86,0.00,0.00,292000,6,248160,0,0,0,0,0,0,60000,232000,-172000,-172000
20200520,060156,光磊永豐9A購01,1.09,1.16,1.09,1.16,+0.07,6.42,381000,13,427510,0,0,0,0,0,0,130000,326000,-196000,-196000
20200520,060157,致茂永豐9A購02,0.80,0.83,0.80,0.83,+0.03,3.75,590000,9,481960,0,0,0,0,0,0,68000,522000,-454000,-454000
20200520,060158,廣達永豐9A購01,1.35,1.35,1.29,1.29,-0.03,-2.27,6000,2,7980,0,0,0,0,0,0,0,4000,-4000,-4000
20200520,060159,健和興永豐9A購01,1.55,1.72,1.55,1.67,+0.17,11.33,288000,21,468660,0,0,0,0,0,0,40000,248000,-208000,-208000
20200520,06015P,大立光富邦98售04,,,,,0.00,0.00,0,0,0,0,0,0,0,0,0,0,0,0,0
20200520,060160,聯陽永豐9A購01,2.50,2.53,2.40,2.47,+0.16,6.93,130000,12,319910,1000,0,1000,0,0,0,51000,79000,-28000,-27000
20200520,060161,牧德永豐9A購02,1.65,1.82,1.65,1.77,+0.22,14.19,44000,9,77490,0,0,0,0,0,0,0,44000,-44000,-44000
20200520,060162,碩天永豐9A購01,1.10,1.11,1.09,1.11,+0.03,2.78,137000,11,150010,0,0,0,0,0,0,116000,21000,95000,95000
20200520,060163,健策永豐9B購01,1.18,1.27,1.18,1.25,+0.04,3.31,386000,12,482400,0,0,0,0,0,0,2000,386000,-384000,-384000
20200520,060164,合勤控永豐9A購01,1.19,1.43,1.19,1.43,+0.28,24.35,324000,12,426620,0,0,0,0,0,0,10000,314000,-304000,-304000
20200520,060165,上緯控永豐9A購01,2.23,2.26,2.05,2.06,-0.09,-4.19,141000,10,299000,0,0,0,0,0,0,12000,98000,-86000,-86000
20200520,060166,佐登永豐9A購01,1.28,1.28,1.23,1.23,-0.08,-6.11,123000,15,154210,0,0,0,0,0,0,118000,5000,113000,113000
20200520,060167,禾聯碩永豐9A購01,0.99,1.01,0.99,1.01,-0.04,-3.81,26000,2,25780,0,0,0,0,0,0,26000,0,26000,26000
20200520,060168,台表科永豐9A購01,2.65,2.67,2.65,2.67,+0.10,3.89,150000,18,399060,0,0,0,0,0,0,150000,0,150000,150000
20200520,060169,群電永豐9A購01,1.74,1.74,1.69,1.73,-0.02,-1.14,99000,21,170810,0,0,0,0,0,0,99000,0,99000,99000
20200520,06016P,京元電凱基96售03,0.57,0.62,0.56,0.62,+0.08,14.81,179000,32,104970,0,0,0,0,0,0,91000,88000,3000,3000
20200520,060170,世紀鋼永豐9A購01,,,,,0.00,0.00,0,0,0,0,0,0,0,0,0,0,0,0,0
20200520,060171,宏達電台新9A購01,0.95,0.99,0.95,0.98,0.00,0.00,90000,3,88200,0,0,0,0,0,0,0,90000,-90000,-90000
20200520,060172,智原台新9A購01,1.24,1.29,1.24,1.29,+0.09,7.5,94000,8,117850,0,0,0,0,0,0,40000,54000,-14000,-14000
20200520,060173,台灣50元富02購01,,,,,0.00,0.00,0,0,0,0,0,0,0,0,0,0,0,0,0
20200520,060174,T50反1元富04購01,0.84,0.84,0.84,0.84,-0.01,-1.18,4000,1,3360,0,0,0,0,0,0,0,4000,-4000,-4000
20200520,060175,T50反1元富04購02,,,,,0.00,0.00,0,0,0,0,0,0,0,0,0,0,0,0,0
20200520,060176,T50反1元富04購03,,,,,0.00,0.00,0,0,0,0,0,0,0,0,0,0,0,0,0
20200520,060177,T50反1元富04購04,,,,,0.00,0.00,0,0,0,0,0,0,0,0,0,0,0,0,0
20200520,060178,T50反1元富04購05,1.10,1.10,1.10,1.10,-0.02,-1.79,70000,1,77000,0,0,0,0,0,0,70000,0,70000,70000
20200520,060179,T50反1元富04購06,,,,,0.00,0.00,0,0,0,0,0,0,0,0,0,0,0,0,0
20200520,06017P,亞光凱基96售04,2.52,2.52,2.52,2.52,0.00,0.00,10000,1,25200,0,0,0,0,0,0,0,10000,-10000,-10000
20200520,060180,上証2X元富9A購02,,,,,0.00,0.00,0,0,0,0,0,0,0,0,0,0,0,0,0
20200520,060181,華通元富9A購01,,,,,0.00,0.00,0,0,0,0,0,0,0,0,0,0,0,0,0
20200520,060182,旺宏元富9A購01,,,,,0.00,0.00,0,0,0,0,0,0,0,0,0,0,0,0,0
20200520,060183,南亞科元富9A購01,2.84,2.96,2.84,2.85,+0.10,3.64,153000,20,444110,0,0,0,0,0,0,74000,79000,-5000,-5000
20200520,060184,建準元富9A購01,,,,,0.00,0.00,0,0,0,0,0,0,0,0,0,0,0,0,0
20200520,060185,聯發科元富04購01,3.51,3.51,3.39,3.39,+0.15,4.63,6000,2,20580,0,0,0,0,0,0,0,6000,-6000,-6000
20200520,060186,義隆元富9A購01,1.50,1.51,1.47,1.51,0.00,0.00,70000,6,104770,0,0,0,0,0,0,60000,10000,50000,50000
20200520,060187,華新科元富9A購02,1.65,1.69,1.58,1.58,-0.04,-2.47,211000,32,343930,0,0,0,0,0,0,163000,38000,125000,125000
20200520,060188,華新科元富9A購03,1.93,2.04,1.93,2.04,+0.07,3.55,227000,7,443730,0,0,0,0,0,0,125000,102000,23000,23000
20200520,060189,宏達電元富9B購03,0.95,1.00,0.95,1.00,+0.08,8.7,164000,4,161300,0,0,0,0,0,0,54000,110000,-56000,-56000
20200520,06018P,康控凱基96售03,1.31,1.35,1.31,1.35,-0.26,-16.15,47000,3,61610,0,0,0,0,0,0,0,47000,-47000,-47000
20200520,060190,國泰金元富9A購01,2.65,2.70,2.64,2.69,+0.05,1.89,278000,13,739710,0,0,0,0,0,0,153000,125000,28000,28000
20200520,060191,亞光元富9A購02,1.80,1.87,1.80,1.84,+0.05,2.79,249000,12,460160,0,0,0,0,0,0,239000,10000,229000,229000
20200520,060192,欣興元富9A購01,,,,,0.00,0.00,0,0,0,0,0,0,0,0,0,0,0,0,0
20200520,060193,群創元富9A購01,1.33,1.35,1.33,1.35,+0.03,2.27,291000,4,389990,0,0,0,0,0,0,143000,148000,-5000,-5000
20200520,060194,旭富元富9A購01,1.50,1.55,1.49,1.55,+0.01,0.65,22000,3,33000,0,0,0,0,0,0,22000,0,22000,22000
20200520,060195,旭富元富9A購02,1.54,1.60,1.53,1.57,+0.02,1.29,234000,11,366940,0,0,0,0,0,0,95000,139000,-44000,-44000
20200520,060196,泰鼎元富9A購01,3.35,3.49,3.35,3.49,+0.06,1.75,5000,2,17310,0,0,0,0,0,0,1000,4000,-3000,-3000
20200520,060197,臻鼎元富9A購02,1.85,2.09,1.85,2.06,+0.22,11.96,634000,27,1262640,0,0,0,0,0,0,127000,506000,-379000,-379000
20200520,060198,祥碩元富9A購02,,,,,0.00,0.00,0,0,0,0,0,0,0,0,0,0,0,0,0
20200520,060199,台郡元富9A購01,,,,,0.00,0.00,0,0,0,0,0,0,0,0,0,0,0,0,0
20200520,06019P,緯穎凱基96售03,,,,,0.00,0.00,0,0,0,0,0,0,0,0,0,0,0,0,0
20200520,060200,同欣電元富9A購01,3.73,3.94,3.70,3.70,+0.02,0.54,58000,11,218210,0,0,0,0,0,0,27000,20000,7000,7000
20200520,060201,台表科元富9A購01,,,,,0.00,0.00,0,0,0,0,0,0,0,0,0,0,0,0,0
20200520,060202,康友元富9A購01,2.13,2.13,2.08,2.08,-0.07,-3.26,41000,3,86330,0,0,0,0,0,0,21000,20000,1000,1000
20200520,060203,緯穎元富9A購01,3.67,3.83,3.49,3.49,-0.09,-2.51,196000,14,727910,0,0,0,0,0,0,167000,29000,138000,138000
20200520,060204,矽創元富9A購01,2.51,2.51,2.22,2.27,-0.14,-5.81,520000,46,1252570,0,0,0,0,0,0,296000,145000,151000,151000
20200520,060205,台灣50麥證02購01,,,,,0.00,0.00,0,0,0,0,0,0,0,0,0,0,0,0,0
20200520,060206,臺股指麥證9A購01,,,,,0.00,0.00,0,0,0,0,0,0,0,0,0,0,0,0,0
20200520,060207,臺股指麥證9A購02,,,,,0.00,0.00,0,0,0,0,0,0,0,0,0,0,0,0,0
20200520,060208,卜蜂康和9A購01,2.34,2.36,2.34,2.36,+0.02,0.85,3000,2,7040,0,0,0,0,0,0,3000,0,3000,3000
20200520,060209,喬山康和9A購01,2.99,3.15,2.99,3.15,+0.09,2.94,55000,9,168120,0,0,0,0,0,0,0,55000,-55000,-55000
20200520,06020P,燿華元富96售04,,,,,0.00,0.00,0,0,0,0,0,0,0,0,0,0,0,0,0
20200520,060210,上銀康和9A購01,,,,,0.00,0.00,0,0,0,0,0,0,0,0,0,0,0,0,0
20200520,060211,智邦康和9A購01,4.19,4.19,4.19,4.19,+0.08,1.95,2000,1,8380,0,0,0,0,0,0,2000,0,2000,2000
20200520,060212,華航康和9A購01,1.37,1.37,1.25,1.25,-0.03,-2.34,1174000,40,1560760,0,0,0,0,0,0,880000,284000,596000,596000
20200520,060213,牧德康和9A購01,,,,,0.00,0.00,0,0,0,0,0,0,0,0,0,0,0,0,0
20200520,060214,茂林康和9A購01,2.25,2.52,2.25,2.52,0.00,0.00,429000,10,1033600,0,0,0,0,0,0,68000,361000,-293000,-293000
20200520,060215,柏文康和9A購01,3.62,4.08,3.62,3.98,+0.24,6.42,107000,30,413420,0,0,0,0,0,0,41000,41000,0,0
20200520,060216,鴻海凱基9A購17,1.07,1.07,1.07,1.07,0.00,0.00,100000,1,107000,0,0,0,0,0,0,0,100000,-100000,-100000
20200520,060217,國巨凱基9A購10,2.19,2.19,2.19,2.19,0.00,0.00,10000,1,21900,0,0,0,0,0,0,0,10000,-10000,-10000
20200520,060218,台積電凱基9A購15,1.19,1.19,1.19,1.19,-0.01,-0.83,6000,2,7140,0,0,0,0,0,0,6000,0,6000,6000
20200520,060219,聯發科凱基9A購09,2.01,2.01,2.01,2.01,0.00,0.00,10000,1,20100,0,0,0,0,0,0,10000,0,10000,10000
20200520,06021P,世紀鋼元富96售03,0.49,0.55,0.46,0.55,+0.03,5.77,345000,18,165200,0,0,0,0,0,0,174000,171000,3000,3000
20200520,060220,華新科凱基9A購08,1.31,1.31,1.31,1.31,-0.02,-1.5,10000,1,13100,0,0,0,0,0,0,10000,0,10000,10000
20200520,060221,大立光凱基9A購07,0.87,0.87,0.85,0.86,+0.01,1.18,65000,6,56070,0,0,0,0,0,0,52000,13000,39000,39000
20200520,060222,貿聯凱基9A購02,1.36,1.37,1.32,1.36,+0.03,2.26,146000,30,197560,0,0,0,0,0,0,96000,42000,54000,54000
20200520,060223,台灣50元大9A購05,,,,,0.00,0.00,0,0,0,0,0,0,0,0,0,0,0,0,0
20200520,060224,台灣50元大9A購09,,,,,0.00,0.00,0,0,0,0,0,0,0,0,0,0,0,0,0
20200520,060225,S&P反1元大9A購02,,,,,0.00,0.00,0,0,0,0,0,0,0,0,0,0,0,0,0
20200520,060226,道瓊反元大9A購01,0.49,0.49,0.48,0.48,-0.09,-15.79,306000,6,149910,0,0,0,0,0,0,305000,1000,304000,304000
20200520,060227,和大元大9A購01,3.41,3.85,3.35,3.85,+0.36,10.32,519000,44,1883250,0,0,0,0,0,0,153000,356000,-203000,-203000
20200520,060228,亞德客元大9A購01,3.54,3.54,3.32,3.32,0.00,0.00,52000,4,179090,0,0,0,0,0,0,42000,10000,32000,32000
20200520,060229,楠梓電元大9C購01,3.62,3.72,3.54,3.61,-0.03,-0.82,68000,10,249550,0,0,0,0,0,0,10000,68000,-58000,-58000
20200520,06022P,緯穎永豐96售03,,,,,0.00,0.00,0,0,0,0,0,0,0,0,0,0,0,0,0
20200520,060230,台積電元大9A購07,2.25,2.25,2.25,2.25,+0.03,1.35,50000,1,112500,0,0,0,0,0,0,0,50000,-50000,-50000
20200520,060231,台積電元大9A購08,,,,,0.00,0.00,0,0,0,0,0,0,0,0,0,0,0,0,0
20200520,060232,友訊元大9C購01,1.69,1.69,1.64,1.64,-0.06,-3.53,55000,3,91450,0,0,0,0,0,0,51000,4000,47000,47000
20200520,060233,宏碁元大9A購01,1.63,1.67,1.59,1.59,-0.01,-0.62,225000,7,366790,0,0,0,0,0,0,209000,6000,203000,203000
20200520,060234,凱美元大9C購01,3.02,3.15,2.99,3.01,+0.03,1.01,335000,19,1031520,0,0,0,0,0,0,265000,68000,197000,197000
20200520,060235,瑞昱元大9A購01,4.20,4.20,4.00,4.00,-0.20,-4.76,89000,25,366700,0,0,0,0,0,0,80000,64000,16000,16000
20200520,060236,精元元大9C購01,2.44,2.50,2.44,2.50,+0.14,5.93,21000,3,52440,0,0,0,0,0,0,11000,0,11000,11000
20200520,060237,友達元大9A購06,1.97,2.04,1.92,1.93,-0.07,-3.5,147000,11,290360,0,0,0,0,0,0,97000,50000,47000,47000
20200520,060238,強茂元大9C購01,3.46,3.64,3.46,3.55,+0.03,0.85,282000,18,998510,0,0,0,0,0,0,205000,77000,128000,128000
20200520,060239,國揚元大9C購01,2.53,2.59,2.41,2.53,-0.11,-4.17,530000,46,1301800,0,0,0,0,0,0,394000,136000,258000,258000
20200520,06023P,超眾國票96售03,1.39,1.39,1.39,1.39,-0.02,-1.42,1000,1,1390,0,0,0,0,0,0,1000,0,1000,1000
20200520,060240,富邦金元大9A購01,2.93,2.93,2.91,2.93,0.00,0.00,176000,13,515480,0,0,0,0,0,0,176000,0,176000,176000
20200520,060241,國泰金元大9A購01,2.69,2.75,2.69,2.75,+0.03,1.1,164000,12,446500,0,0,0,0,0,0,120000,44000,76000,76000
20200520,060242,潤泰全元大9C購01,1.14,1.14,1.14,1.14,-0.04,-3.39,68000,1,77520,0,0,0,0,0,0,0,68000,-68000,-68000
20200520,060243,潤泰全元大9C購02,,,,,0.00,0.00,0,0,0,0,0,0,0,0,0,0,0,0,0
20200520,060244,大立光元大9B購02,2.31,2.31,2.26,2.26,+0.02,0.89,35000,3,80500,0,0,0,0,0,0,5000,30000,-25000,-25000
20200520,060245,聯陽元大9C購01,4.35,4.35,4.19,4.30,+0.29,7.23,243000,30,1041000,0,0,0,0,0,0,61000,182000,-121000,-121000
20200520,060246,晶相光元大9C購03,2.48,2.55,2.48,2.48,-0.05,-1.98,240000,16,604000,0,0,0,0,0,0,220000,20000,200000,200000
20200520,060247,牧德元大9A購02,3.80,4.34,3.80,4.34,+0.61,16.35,61000,7,239070,0,0,0,0,0,0,50000,10000,40000,40000
20200520,060248,日月光元大9A購01,2.40,2.42,2.28,2.29,0.00,0.00,107000,6,249300,0,0,0,0,0,0,10000,97000,-87000,-87000
20200520,060249,正文元大9C購01,,,,,0.00,0.00,0,0,0,0,0,0,0,0,0,0,0,0,0
20200520,06024P,台郡國票97售05,2.16,2.16,2.16,2.16,-0.02,-0.92,50000,1,108000,0,0,0,0,0,0,50000,0,50000,50000
20200520,060250,台表科元大9A購01,6.25,7.10,6.25,7.10,+0.80,12.7,10000,3,67400,0,0,0,0,0,0,10000,0,10000,10000
20200520,060251,易華電元大9C購01,2.83,2.93,2.83,2.93,+0.07,2.45,55000,2,160650,0,0,0,0,0,0,5000,50000,-45000,-45000
20200520,060252,緯穎元大9A購02,3.32,3.48,3.16,3.16,-0.31,-8.93,184000,20,615750,0,0,0,0,0,0,168000,36000,132000,132000
20200520,060253,昇陽半元大9C購01,2.91,3.06,2.89,3.03,+0.14,4.84,138000,12,412770,0,0,0,0,0,0,50000,88000,-38000,-38000
20200520,060254,世紀鋼元大9A購01,2.54,2.56,2.37,2.37,-0.30,-11.24,71000,5,177780,0,0,0,0,0,0,3000,71000,-68000,-68000
20200520,060255,臺股指元大9B購06,,,,,0.00,0.00,0,0,0,0,0,0,0,0,0,0,0,0,0
20200520,060256,臺股指元大9B購07,,,,,0.00,0.00,0,0,0,0,0,0,0,0,0,0,0,0,0
20200520,060257,臺股指元大9B購08,,,,,0.00,0.00,0,0,0,0,0,0,0,0,0,0,0,0,0
20200520,060258,T50反1凱基9A購06,0.97,0.97,0.96,0.96,-0.03,-3.03,56000,4,53770,0,0,0,0,0,0,35000,21000,14000,14000
20200520,060259,潤泰全凱基9C購01,0.77,0.77,0.77,0.77,-0.02,-2.53,70000,1,53900,0,0,0,0,0,0,70000,0,70000,70000
20200520,06025P,臺股指元大99售02,2.04,2.07,2.02,2.03,-0.04,-1.93,232000,12,471490,0,0,0,0,0,0,203000,12000,191000,191000
20200520,060260,京鼎凱基9C購01,2.34,2.36,2.34,2.35,+0.01,0.43,112000,7,263280,0,0,0,0,0,0,92000,20000,72000,72000
20200520,060261,臺股指凱基9A購04,4.15,4.15,4.15,4.15,+0.05,1.22,6000,2,24900,0,0,0,0,0,0,6000,0,6000,6000
20200520,060262,臺股指凱基9B購02,4.35,4.39,4.35,4.39,+0.04,0.92,4000,3,17480,0,0,0,0,0,0,4000,0,4000,4000
20200520,060263,臺指反國票9C購01,0.79,0.79,0.79,0.79,0.00,0.00,1000,1,790,0,0,0,0,0,0,0,1000,-1000,-1000
20200520,060264,華新科國票9A購02,5.00,5.25,5.00,5.25,+0.32,6.49,25000,3,127550,0,0,0,0,0,0,22000,3000,19000,19000
20200520,060265,宏達電國票9A購02,1.77,1.80,1.77,1.80,+0.16,9.76,41000,3,73290,0,0,0,0,0,0,0,41000,-41000,-41000
20200520,060266,潤泰全國票9A購01,1.64,1.65,1.63,1.65,-0.14,-7.82,58000,3,95120,0,0,0,0,0,0,10000,48000,-38000,-38000
20200520,060267,上緯控國票9C購01,3.75,3.75,3.75,3.75,0.00,0.00,1000,1,3750,0,0,0,0,0,0,0,1000,-1000,-1000
20200520,060268,台灣50元大9C購20,,,,,0.00,0.00,0,0,0,0,0,0,0,0,0,0,0,0,0
20200520,060269,台灣50元大9C購21,,,,,0.00,0.00,0,0,0,0,0,0,0,0,0,0,0,0,0
20200520,06026P,華通台新97售01,,,,,0.00,0.00,0,0,0,0,0,0,0,0,0,0,0,0,0
20200520,060270,台灣50元大9C購22,,,,,0.00,0.00,0,0,0,0,0,0,0,0,0,0,0,0,0
20200520,060271,台灣50元大9C購23,,,,,0.00,0.00,0,0,0,0,0,0,0,0,0,0,0,0,0
20200520,060272,台灣50元大9C購25,,,,,0.00,0.00,0,0,0,0,0,0,0,0,0,0,0,0,0
20200520,060273,T50反1元大9A購03,,,,,0.00,0.00,0,0,0,0,0,0,0,0,0,0,0,0,0
20200520,060274,T50反1元大9A購04,,,,,0.00,0.00,0,0,0,0,0,0,0,0,0,0,0,0,0
20200520,060275,元黃金元大9A購01,1.54,1.54,1.53,1.53,+0.06,4.08,67000,5,102680,0,0,0,0,0,0,50000,15000,35000,35000
20200520,060276,S&P反1元大9A購03,,,,,0.00,0.00,0,0,0,0,0,0,0,0,0,0,0,0,0
20200520,060277,道瓊反元大9A購02,0.78,0.79,0.78,0.78,+0.01,1.3,78000,3,61340,0,0,0,0,0,0,0,78000,-78000,-78000
20200520,060278,道瓊反元大9A購03,0.79,0.79,0.77,0.77,0.00,0.00,312000,3,240430,0,0,0,0,0,0,300000,12000,288000,288000
20200520,060279,SP黃豆元大9A購01,,,,,0.00,0.00,0,0,0,0,0,0,0,0,0,0,0,0,0
20200520,06027P,鴻海台新96售04,,,,,0.00,0.00,0,0,0,0,0,0,0,0,0,0,0,0,0
20200520,060280,元金2X元大9A購01,2.20,2.22,2.20,2.22,+0.12,5.71,32000,6,70560,0,0,0,0,0,0,26000,6000,20000,20000
20200520,060281,卜蜂元大9C購01,3.28,3.30,3.26,3.29,0.00,0.00,40000,8,131080,0,0,0,0,0,0,31000,9000,22000,22000
20200520,060282,聚陽元大9A購01,3.41,3.41,3.15,3.21,-0.05,-1.53,313000,36,1026740,0,0,0,0,0,0,237000,66000,171000,171000
20200520,060283,台肥元大9C購01,2.46,2.46,2.40,2.43,-0.02,-0.82,194000,15,472100,0,0,0,0,0,0,194000,59000,135000,135000
20200520,060284,南港元大01購01,1.73,1.80,1.73,1.80,+0.08,4.65,141000,7,247030,0,0,0,0,0,0,91000,50000,41000,41000
20200520,060285,聯電元大9C購01,1.82,1.82,1.68,1.68,0.00,0.00,144000,8,252190,0,0,0,0,0,0,20000,124000,-104000,-104000
20200520,060286,佳世達元大9C購01,2.13,2.24,2.13,2.24,+0.17,8.21,315000,27,685870,0,0,0,0,0,0,185000,130000,55000,55000
20200520,060287,燿華元大9A購01,2.55,2.89,2.55,2.89,0.00,0.00,384000,23,1048920,0,0,0,0,0,0,25000,384000,-359000,-359000
20200520,060288,群光元大9C購01,2.38,2.40,2.35,2.38,+0.03,1.28,191000,9,453360,0,0,0,0,0,0,101000,112000,-11000,-11000
20200520,060289,京元電元大9A購01,2.02,2.05,1.93,1.93,-0.20,-9.39,1029000,82,2022440,0,0,0,0,0,0,66000,955000,-889000,-889000
20200520,06028P,智邦台新97售01,,,,,0.00,0.00,0,0,0,0,0,0,0,0,0,0,0,0,0
20200520,060290,興富發元大9C購01,2.55,2.55,2.55,2.55,+0.04,1.59,50000,1,127500,0,0,0,0,0,0,0,50000,-50000,-50000
20200520,060291,高鐵元大9A購01,5.80,6.10,5.80,6.00,+0.25,4.35,310000,28,1858050,0,0,0,0,0,0,35000,294000,-259000,-259000
20200520,060292,聯詠元大9A購01,2.65,2.77,2.65,2.68,-0.12,-4.29,163000,17,439710,0,0,0,0,0,0,143000,36000,107000,107000
20200520,060293,緯創元大9A購01,3.10,3.10,3.00,3.00,-0.06,-1.96,457000,44,1406920,0,0,0,0,0,0,405000,33000,372000,372000
20200520,060294,嘉澤元大9A購01,,,,,0.00,0.00,0,0,0,0,0,0,0,0,0,0,0,0,0
20200520,060295,貿聯元大9A購03,3.11,3.11,3.06,3.07,-0.01,-0.32,59000,8,181200,0,0,0,0,0,0,22000,37000,-15000,-15000
20200520,060296,和碩元大9A購01,2.54,2.54,2.54,2.54,-0.03,-1.17,88000,4,223520,0,0,0,0,0,0,88000,0,88000,88000
20200520,060297,和碩元大9A購02,2.13,2.13,2.11,2.11,-0.02,-0.94,78000,3,165940,0,0,0,0,0,0,10000,68000,-58000,-58000
20200520,060298,鎧勝元大9C購01,3.46,3.46,3.32,3.32,+0.15,4.73,140000,3,470400,0,0,0,0,0,0,140000,100000,40000,40000
20200520,060299,友訊國泰9B購01,1.11,1.11,1.11,1.11,+0.06,5.71,10000,1,11100,0,0,0,0,0,0,0,10000,-10000,-10000
20200520,06029P,聯發科台新96售02,,,,,0.00,0.00,0,0,0,0,0,0,0,0,0,0,0,0,0
20200520,060300,佐登國泰9B購01,1.86,1.86,1.76,1.78,-0.07,-3.78,495000,14,881400,0,0,0,0,0,0,445000,50000,395000,395000
20200520,060301,國巨富邦9C購02,1.39,1.39,1.35,1.35,+0.08,6.3,12000,2,16320,0,0,0,0,0,0,0,12000,-12000,-12000
20200520,060302,台積電富邦02購01,0.84,0.84,0.82,0.84,0.00,0.00,2801000,27,2308480,0,0,0,0,0,0,2631000,155000,2476000,2476000
20200520,060303,宏達電富邦9B購01,0.64,0.67,0.64,0.64,+0.02,3.23,278000,6,185810,0,0,0,0,0,0,6000,272000,-266000,-266000
20200520,060304,大立光富邦9C購05,,,,,0.00,0.00,0,0,0,0,0,0,0,0,0,0,0,0,0
20200520,060305,得力永豐9A購01,1.42,1.42,1.42,1.42,0.00,0.00,15000,1,21300,0,0,0,0,0,0,0,15000,-15000,-15000
20200520,060306,台肥永豐9A購01,1.31,1.32,1.29,1.32,-0.04,-2.94,255000,24,332380,0,0,0,0,0,0,235000,0,235000,235000
20200520,060307,南港永豐9A購01,0.81,0.83,0.81,0.83,0.00,0.00,330000,13,272320,0,0,0,0,0,0,0,330000,-330000,-330000
20200520,060308,劍麟永豐9A購01,1.14,1.16,1.14,1.16,+0.01,0.87,281000,5,325780,0,0,0,0,0,0,130000,151000,-21000,-21000
20200520,060309,佳世達永豐9A購01,0.91,0.92,0.91,0.92,+0.03,3.37,56000,5,51180,0,0,0,0,0,0,56000,0,56000,56000
20200520,06030P,友達兆豐96售02,,,,,0.00,0.00,0,0,0,0,0,0,0,0,0,0,0,0,0
20200520,060310,瑞昱永豐9A購01,1.42,1.44,1.42,1.44,-0.06,-4.0,85000,11,122000,0,0,0,0,0,0,10000,75000,-65000,-65000
20200520,060311,盟立永豐9A購01,1.29,1.29,1.29,1.29,0.00,0.00,2000,1,2580,0,0,0,0,0,0,2000,0,2000,2000
20200520,060312,潤泰全永豐9A購01,,,,,0.00,0.00,0,0,0,0,0,0,0,0,0,0,0,0,0
20200520,060313,淘帝永豐9A購01,0.65,0.67,0.63,0.63,-0.02,-3.08,361000,9,232050,0,0,0,0,0,0,245000,116000,129000,129000
20200520,060314,元翎永豐9A購01,1.08,1.10,1.08,1.10,+0.04,3.77,31000,3,33500,0,0,0,0,0,0,30000,1000,29000,29000
20200520,060315,易華電永豐9A購01,1.40,1.44,1.40,1.44,+0.04,2.86,15000,2,21320,0,0,0,0,0,0,7000,8000,-1000,-1000
20200520,060316,福懋科永豐9A購01,,,,,0.00,0.00,0,0,0,0,0,0,0,0,0,0,0,0,0
20200520,060317,台灣50群益02購01,2.45,2.47,2.45,2.46,+0.04,1.65,65000,3,159880,0,0,0,0,0,0,65000,0,65000,65000
20200520,060318,上証2X群益9C購03,,,,,0.00,0.00,0,0,0,0,0,0,0,0,0,0,0,0,0
20200520,060319,臺指反群益9A購02,,,,,0.00,0.00,0,0,0,0,0,0,0,0,0,0,0,0,0
20200520,06031P,新光金兆豐96售02,,,,,0.00,0.00,0,0,0,0,0,0,0,0,0,0,0,0,0
20200520,060320,元金2X群益02購01,1.43,1.44,1.42,1.42,+0.04,2.9,42000,8,60140,0,0,0,0,0,0,27000,15000,12000,12000
20200520,060321,元金2X群益9B購01,,,,,0.00,0.00,0,0,0,0,0,0,0,0,0,0,0,0,0
20200520,060322,卜蜂群益9A購01,2.43,2.47,2.41,2.47,+0.01,0.41,110000,12,267610,0,0,0,0,0,0,87000,23000,64000,64000
20200520,060323,華通群益9C購01,2.02,2.12,2.02,2.07,-0.05,-2.36,261000,15,537520,0,0,0,0,0,0,100000,161000,-61000,-61000
20200520,060324,台積電群益9B購02,1.85,1.85,1.82,1.82,0.00,0.00,15000,2,27450,0,0,0,0,0,0,10000,5000,5000,5000
20200520,060325,旺宏群益9A購02,,,,,0.00,0.00,0,0,0,0,0,0,0,0,0,0,0,0,0
20200520,060326,群光群益9A購01,2.39,2.45,2.38,2.45,+0.12,5.15,285000,9,682420,0,0,0,0,0,0,256000,59000,197000,197000
20200520,060327,美律群益9A購02,1.28,1.28,1.23,1.23,-0.05,-3.91,25000,3,31350,0,0,0,0,0,0,13000,12000,1000,1000
20200520,060328,可成群益9A購06,2.84,2.86,2.81,2.84,-0.33,-10.41,14000,8,39750,0,0,0,0,0,0,7000,14000,-7000,-7000
20200520,060329,鎧勝群益9B購01,1.70,1.71,1.68,1.68,+0.07,4.35,225000,4,382620,0,0,0,0,0,0,84000,225000,-141000,-141000
20200520,06032P,健策群益97售03,,,,,0.00,0.00,0,0,0,0,0,0,0,0,0,0,0,0,0
20200520,060330,台灣50麥證9A購03,,,,,0.00,0.00,0,0,0,0,0,0,0,0,0,0,0,0,0
20200520,060331,台積電麥證9A購01,,,,,0.00,0.00,0,0,0,0,0,0,0,0,0,0,0,0,0
20200520,060332,聯發科麥證9A購01,3.53,3.73,3.52,3.72,+0.31,9.09,29000,13,103550,20000,9000,11000,0,0,0,20000,9000,11000,11000
20200520,060333,金寶康和9A購01,1.82,1.87,1.82,1.87,0.00,0.00,9000,2,16730,0,0,0,0,0,0,0,9000,-9000,-9000
20200520,060334,群光康和9A購01,3.50,3.50,3.50,3.50,0.00,0.00,10000,1,35000,0,0,0,0,0,0,0,10000,-10000,-10000
20200520,060335,明泰康和9A購01,5.40,5.40,5.40,5.40,0.00,0.00,10000,2,54000,0,0,0,0,0,0,5000,0,5000,5000
20200520,060336,南電康和9A購01,1.59,1.72,1.40,1.50,-0.08,-5.06,187000,13,299310,0,0,0,0,0,0,152000,35000,117000,117000
20200520,060337,FBVIX統一9A購01,0.47,0.47,0.47,0.47,+0.01,2.17,101000,2,47470,0,0,0,0,0,0,0,101000,-101000,-101000
20200520,060338,鴻海統一9C購02,0.92,0.92,0.92,0.92,-0.02,-2.13,80000,1,73600,0,0,0,0,0,0,80000,0,80000,80000
20200520,060339,國巨統一01購01,2.01,2.11,2.01,2.06,0.00,0.00,404000,15,819240,0,0,0,0,0,0,75000,329000,-254000,-254000
20200520,06033P,可成凱基96售09,,,,,0.00,0.00,0,0,0,0,0,0,0,0,0,0,0,0,0
20200520,060340,國巨統一01購02,1.59,1.59,1.54,1.54,+0.06,4.05,45000,5,70750,0,0,0,0,0,0,20000,15000,5000,5000
20200520,060341,國巨統一9C購02,1.52,1.53,1.47,1.47,+0.09,6.52,70000,4,106000,0,0,0,0,0,0,0,70000,-70000,-70000
20200520,060342,台積電統一02購01,1.21,1.22,1.21,1.22,+0.02,1.67,3000,3,3640,0,0,0,0,0,0,2000,2000,0,0
20200520,060343,台積電統一9C購02,0.98,0.98,0.98,0.98,0.00,0.00,10000,1,9800,0,0,0,0,0,0,10000,0,10000,10000
20200520,060344,聯發科統一01購01,1.67,1.76,1.67,1.67,+0.04,2.45,46000,7,78930,0,0,0,0,0,0,15000,31000,-16000,-16000
20200520,060345,聯發科統一9B購05,2.16,2.16,2.16,2.16,+0.06,2.86,24000,1,51840,0,0,0,0,0,0,24000,0,24000,24000
20200520,060346,華新科統一01購01,1.59,1.60,1.56,1.56,-0.01,-0.64,222000,6,351560,0,0,0,0,0,0,184000,38000,146000,146000
20200520,060347,大立光統一02購01,1.03,1.04,1.03,1.04,+0.02,1.96,104000,6,107960,0,0,0,0,0,0,50000,54000,-4000,-4000
20200520,060348,上証2X元富9A購03,,,,,0.00,0.00,0,0,0,0,0,0,0,0,0,0,0,0,0
20200520,060349,上証2X元富9A購04,,,,,0.00,0.00,0,0,0,0,0,0,0,0,0,0,0,0,0
20200520,06034P,世芯凱基96售03,,,,,0.00,0.00,0,0,0,0,0,0,0,0,0,0,0,0,0
20200520,060350,元黃金元富9B購01,1.83,1.85,1.83,1.85,+0.08,4.52,61000,6,111960,0,0,0,0,0,0,33000,28000,5000,5000
20200520,060351,滬深2X元富9A購01,,,,,0.00,0.00,0,0,0,0,0,0,0,0,0,0,0,0,0
20200520,060352,滬深2X元富9A購02,,,,,0.00,0.00,0,0,0,0,0,0,0,0,0,0,0,0,0
20200520,060353,A50正2元富9A購01,,,,,0.00,0.00,0,0,0,0,0,0,0,0,0,0,0,0,0
20200520,060354,A50正2元富9A購02,3.60,3.60,3.58,3.58,0.00,0.00,50000,2,179600,0,0,0,0,0,0,50000,0,50000,50000
20200520,060355,元金2X元富9C購01,1.83,1.85,1.83,1.83,+0.07,3.98,272000,19,498020,0,0,0,0,0,0,231000,39000,192000,192000
20200520,060356,上銀元富9A購01,,,,,0.00,0.00,0,0,0,0,0,0,0,0,0,0,0,0,0
20200520,060357,上銀元富9A購02,,,,,0.00,0.00,0,0,0,0,0,0,0,0,0,0,0,0,0
20200520,060358,國巨元富9A購01,,,,,0.00,0.00,0,0,0,0,0,0,0,0,0,0,0,0,0
20200520,060359,國巨元富9A購02,,,,,0.00,0.00,0,0,0,0,0,0,0,0,0,0,0,0,0
20200520,06035P,同欣電凱基96售03,0.49,0.49,0.49,0.49,-0.05,-9.26,20000,1,9800,0,0,0,0,0,0,0,20000,-20000,-20000
20200520,060360,南亞科元富9A購02,2.39,2.50,2.39,2.41,+0.10,4.33,198000,22,485880,0,0,0,0,0,0,120000,78000,42000,42000
20200520,060361,南亞科元富9A購03,2.02,2.12,2.02,2.03,+0.08,4.1,349000,24,716720,0,0,0,0,0,0,85000,264000,-179000,-179000
20200520,060362,建準元富9A購02,,,,,0.00,0.00,0,0,0,0,0,0,0,0,0,0,0,0,0
20200520,060363,美律元富9A購01,1.62,1.63,1.57,1.57,-0.07,-4.27,253000,6,409360,0,0,0,0,0,0,115000,138000,-23000,-23000
20200520,060364,奇力新元富9A購01,3.34,3.48,3.32,3.34,+0.15,4.7,97000,12,329020,0,0,0,0,0,0,33000,64000,-31000,-31000
20200520,060365,京鼎元富9A購01,,,,,0.00,0.00,0,0,0,0,0,0,0,0,0,0,0,0,0
20200520,060366,健策元富9A購01,1.65,1.73,1.63,1.68,-0.02,-1.18,472000,20,792620,0,0,0,0,0,0,103000,369000,-266000,-266000
20200520,060367,緯穎元富9A購02,3.51,3.62,3.44,3.59,-0.01,-0.28,606000,44,2118480,0,0,0,0,0,0,471000,99000,372000,372000
20200520,060368,緯穎元富9A購03,3.95,4.02,3.81,3.81,-0.05,-1.3,5000,3,19680,0,0,0,0,0,0,4000,1000,3000,3000
20200520,060369,滬深2X元富01購01,,,,,0.00,0.00,0,0,0,0,0,0,0,0,0,0,0,0,0
20200520,06036P,台表科凱基96售04,,,,,0.00,0.00,0,0,0,0,0,0,0,0,0,0,0,0,0
20200520,060370,滬深2X元富04購01,,,,,0.00,0.00,0,0,0,0,0,0,0,0,0,0,0,0,0
20200520,060371,A50正2元富01購01,,,,,0.00,0.00,0,0,0,0,0,0,0,0,0,0,0,0,0
20200520,060372,A50正2元富9A購04,,,,,0.00,0.00,0,0,0,0,0,0,0,0,0,0,0,0,0
20200520,060373,元金2X元富9A購01,1.47,1.47,1.47,1.47,+0.06,4.26,2000,1,2940,0,0,0,0,0,0,2000,0,2000,2000
20200520,060374,儒鴻元富9A購01,2.45,2.47,2.42,2.46,+0.04,1.65,80000,8,194700,0,0,0,0,0,0,74000,15000,59000,59000
20200520,060375,葡萄王元富9A購01,1.34,1.38,1.32,1.32,-0.05,-3.65,272000,8,368640,0,0,0,0,0,0,96000,176000,-80000,-80000
20200520,060376,瑞祺元富9A購01,2.07,2.25,2.06,2.25,+0.22,10.84,412000,28,881880,0,0,0,0,0,0,116000,296000,-180000,-180000
20200520,060377,鴻海台新9A購01,,,,,0.00,0.00,0,0,0,0,0,0,0,0,0,0,0,0,0
20200520,060378,台灣50凱基04購01,,,,,0.00,0.00,0,0,0,0,0,0,0,0,0,0,0,0,0
20200520,060379,T50反1凱基9A購07,0.52,0.53,0.52,0.53,-0.01,-1.85,12000,2,6260,0,0,0,0,0,0,10000,2000,8000,8000
20200520,06037P,超眾國票98售02,,,,,0.00,0.00,0,0,0,0,0,0,0,0,0,0,0,0,0
20200520,060380,T50反1凱基9A購08,0.78,0.78,0.78,0.78,0.00,0.00,25000,1,19500,0,0,0,0,0,0,0,25000,-25000,-25000
20200520,060381,元黃金凱基9A購01,0.65,0.65,0.65,0.65,+0.04,6.56,61000,3,39650,0,0,0,0,0,0,0,61000,-61000,-61000
20200520,060382,儒鴻凱基9A購01,1.89,1.93,1.89,1.93,+0.05,2.66,61000,5,115940,0,0,0,0,0,0,58000,25000,33000,33000
20200520,060383,葡萄王凱基9A購01,0.79,0.79,0.77,0.77,-0.03,-3.75,22000,3,17140,0,0,0,0,0,0,12000,10000,2000,2000
20200520,060384,葡萄王凱基9B購01,,,,,0.00,0.00,0,0,0,0,0,0,0,0,0,0,0,0,0
20200520,060385,台勝科凱基9A購01,1.46,1.57,1.42,1.56,+0.11,7.59,633000,31,959120,0,0,0,0,0,0,161000,412000,-251000,-251000
20200520,060386,台勝科凱基9B購01,1.83,1.98,1.83,1.98,-0.03,-1.49,39000,4,72570,0,0,0,0,0,0,31000,8000,23000,23000
20200520,060387,盛群凱基9A購01,1.44,1.48,1.44,1.48,+0.03,2.07,37000,4,53810,0,0,0,0,0,0,22000,15000,7000,7000
20200520,060388,世紀鋼凱基9B購01,1.80,1.80,1.80,1.80,+0.01,0.56,20000,1,36000,0,0,0,0,0,0,20000,0,20000,20000
20200520,060389,世紀鋼凱基9B購02,0.90,0.90,0.84,0.84,-0.05,-5.62,16000,3,14160,0,0,0,0,0,0,16000,0,16000,16000
20200520,06038P,國泰金台新96售01,0.10,0.10,0.10,0.10,0.00,0.00,1000,1,100,0,0,0,0,0,0,0,0,0,0
20200520,060390,聯鈞群益9A購01,0.92,0.92,0.92,0.92,-0.01,-1.08,65000,1,59800,0,0,0,0,0,0,65000,0,65000,65000
20200520,060391,華擎群益9C購01,2.19,2.45,2.19,2.35,+0.28,13.53,613000,16,1386730,0,0,0,0,0,0,360000,283000,77000,77000
20200520,060392,華擎群益9C購02,2.37,2.69,2.37,2.69,+0.39,16.96,291000,17,736530,0,0,0,0,0,0,85000,206000,-121000,-121000
20200520,060393,泰鼎群益9A購01,3.83,4.13,3.76,4.12,+0.11,2.74,205000,12,802010,0,0,0,0,0,0,141000,44000,97000,97000
20200520,060394,欣興麥證9A購01,2.60,2.70,2.49,2.55,+0.03,1.19,379000,11,975620,186000,143000,43000,0,0,0,186000,143000,43000,43000
20200520,060395,儒鴻國票9A購01,3.48,3.61,3.44,3.61,-0.11,-2.96,30000,4,104820,0,0,0,0,0,0,26000,4000,22000,22000
20200520,060396,友達國票9A購01,1.41,1.42,1.41,1.42,0.00,0.00,18000,2,25490,0,0,0,0,0,0,0,18000,-18000,-18000
20200520,060397,群創國票9A購01,,,,,0.00,0.00,0,0,0,0,0,0,0,0,0,0,0,0,0
20200520,060398,立積國票9B購01,1.90,1.90,1.90,1.90,-0.09,-4.52,5000,1,9500,0,0,0,0,0,0,0,5000,-5000,-5000
20200520,060399,康友國票9A購02,2.77,2.77,2.77,2.77,-0.16,-5.46,10000,10,27700,0,0,0,0,0,0,10000,10000,0,0
20200520,06039P,亞光台新96售03,,,,,0.00,0.00,0,0,0,0,0,0,0,0,0,0,0,0,0
20200520,060400,南電國票9A購03,3.75,3.96,3.75,3.80,+0.15,4.11,186000,8,725300,0,0,0,0,0,0,170000,16000,154000,154000
20200520,060401,世紀鋼國票9B購01,2.91,2.91,2.91,2.91,-0.20,-6.43,5000,1,14550,0,0,0,0,0,0,0,5000,-5000,-5000
20200520,060402,神隆國泰9B購01,1.95,1.97,1.93,1.97,-0.05,-2.48,59000,7,114750,0,0,0,0,0,0,6000,43000,-37000,-37000
20200520,060403,上銀國泰9B購01,,,,,0.00,0.00,0,0,0,0,0,0,0,0,0,0,0,0,0
20200520,060404,台勝科國泰9B購01,2.24,2.40,2.20,2.38,+0.13,5.78,589000,21,1376120,0,0,0,0,0,0,41000,528000,-487000,-487000
20200520,060405,中租國泰9C購01,3.26,3.26,3.26,3.26,+0.03,0.93,31000,1,101060,0,0,0,0,0,0,31000,0,31000,31000
20200520,060406,瑞祺國泰9B購01,1.31,1.46,1.31,1.44,+0.13,9.92,1995000,40,2725560,0,0,0,0,0,0,58000,1937000,-1879000,-1879000
20200520,060407,南六國泰9C購01,,,,,0.00,0.00,0,0,0,0,0,0,0,0,0,0,0,0,0
20200520,060408,和潤國泰9C購01,2.43,2.44,2.41,2.41,-0.01,-0.41,144000,9,349400,0,0,0,0,0,0,35000,109000,-74000,-74000
20200520,060409,味全永豐9A購01,1.14,1.14,1.11,1.11,-0.04,-3.48,97000,7,110520,0,0,0,0,0,0,25000,72000,-47000,-47000
20200520,06040P,亞光康和96售03,,,,,0.00,0.00,0,0,0,0,0,0,0,0,0,0,0,0,0
20200520,060410,台苯永豐9A購01,1.25,1.25,1.19,1.19,-0.11,-8.46,312000,21,382780,0,0,0,0,0,0,242000,50000,192000,192000
20200520,060411,達新永豐9A購01,0.90,1.05,0.90,1.03,+0.11,11.96,446000,27,432530,0,0,0,0,0,0,169000,277000,-108000,-108000
20200520,060412,儒鴻永豐9A購01,1.20,1.22,1.20,1.22,+0.01,0.83,21000,3,25440,0,0,0,0,0,0,9000,12000,-3000,-3000
20200520,060413,東元永豐9A購01,1.50,1.52,1.50,1.52,0.00,0.00,381000,7,575060,0,0,0,0,0,0,0,381000,-381000,-381000
20200520,060414,中興電永豐9A購01,1.56,1.57,1.50,1.53,-0.06,-3.77,898000,78,1373890,0,0,0,0,0,0,638000,155000,483000,483000
20200520,060415,葡萄王永豐9A購01,0.70,0.70,0.70,0.70,-0.01,-1.41,150000,2,105000,0,0,0,0,0,0,150000,0,150000,150000
20200520,060416,神隆永豐9A購01,1.11,1.11,1.10,1.10,-0.01,-0.9,100000,3,110800,0,0,0,0,0,0,0,100000,-100000,-100000
20200520,060417,正隆永豐9A購01,1.35,1.40,1.29,1.34,+0.01,0.75,848000,49,1154890,0,0,0,0,0,0,485000,303000,182000,182000
20200520,060418,中橡永豐9A購01,0.92,0.92,0.90,0.91,-0.04,-4.21,167000,4,152090,0,0,0,0,0,0,167000,0,167000,167000
20200520,060419,漢翔永豐9A購01,0.94,0.94,0.87,0.90,-0.05,-5.26,116000,9,103630,0,0,0,0,0,0,0,3000,-3000,-3000
20200520,06041P,全新永豐96售03,,,,,0.00,0.00,0,0,0,0,0,0,0,0,0,0,0,0,0
20200520,060420,神基永豐9A購01,1.01,1.01,1.00,1.00,-0.03,-2.91,186000,3,187660,0,0,0,0,0,0,0,186000,-186000,-186000
20200520,060421,華擎永豐9A購01,0.74,0.84,0.74,0.82,0.00,0.00,366000,10,294470,0,0,0,0,0,0,30000,336000,-306000,-306000
20200520,060422,台勝科永豐9A購01,1.15,1.23,1.15,1.22,+0.07,6.09,282000,11,335830,0,0,0,0,0,0,7000,275000,-268000,-268000
20200520,060423,智易永豐9A購01,1.36,1.38,1.36,1.37,-0.02,-1.44,55000,6,75500,0,0,0,0,0,0,5000,50000,-45000,-45000
20200520,060424,中租永豐9A購01,1.48,1.49,1.48,1.48,0.00,0.00,325000,9,482480,0,0,0,0,0,0,242000,78000,164000,164000
20200520,060425,凌華永豐9A購01,0.65,0.66,0.62,0.66,-0.01,-1.49,93000,6,59260,0,0,0,0,0,0,63000,30000,33000,33000
20200520,060426,盛群永豐9A購01,0.91,0.92,0.91,0.92,-0.01,-1.08,58000,2,53320,0,0,0,0,0,0,58000,0,58000,58000
20200520,060427,聯茂永豐9A購01,0.65,0.67,0.64,0.64,-0.06,-8.57,981000,28,635870,0,0,0,0,0,0,857000,75000,782000,782000
20200520,060428,瑞祺永豐9A購01,0.78,0.84,0.78,0.84,+0.07,9.09,1192000,12,962910,0,0,0,0,0,0,70000,1122000,-1052000,-1052000
20200520,060429,南六永豐9A購01,2.60,2.74,2.60,2.60,0.00,0.00,4000,3,10540,0,0,0,0,0,0,1000,3000,-2000,-2000
20200520,06042P,華新科永豐96售04,,,,,0.00,0.00,0,0,0,0,0,0,0,0,0,0,0,0,0
20200520,060430,和潤永豐9A購01,1.61,1.63,1.59,1.61,0.00,0.00,245000,12,394970,0,0,0,0,0,0,194000,51000,143000,143000
20200520,060431,復盛永豐9A購01,0.82,1.02,0.82,1.01,+0.19,23.17,2230000,47,1973420,0,0,0,0,0,0,60000,2170000,-2110000,-2110000
20200520,060432,達方永豐9A購01,1.31,1.33,1.30,1.30,0.00,0.00,280000,10,370300,0,0,0,0,0,0,40000,240000,-200000,-200000
20200520,060433,億豐永豐9A購01,1.85,1.94,1.82,1.90,+0.13,7.34,635000,13,1188830,0,0,0,0,0,0,133000,502000,-369000,-369000
20200520,060434,台汽電永豐9A購01,1.48,1.48,1.42,1.42,-0.11,-7.19,334000,18,480720,0,0,0,0,0,0,284000,50000,234000,234000
20200520,060435,鈺齊永豐9A購01,0.84,0.84,0.84,0.84,+0.02,2.44,61000,1,51240,0,0,0,0,0,0,61000,0,61000,61000
20200520,060436,巨大永豐9A購01,2.74,2.88,2.74,2.88,+0.43,17.55,57000,7,158860,0,0,0,0,0,0,41000,16000,25000,25000
20200520,060437,宏全永豐9A購01,1.23,1.23,1.16,1.17,-0.11,-8.59,1203000,84,1429660,0,0,0,0,0,0,1047000,156000,891000,891000
20200520,060438,台灣50元大9A購11,,,,,0.00,0.00,0,0,0,0,0,0,0,0,0,0,0,0,0
20200520,060439,台灣50元大9C購26,,,,,0.00,0.00,0,0,0,0,0,0,0,0,0,0,0,0,0
20200520,06043P,創意永豐96售06,0.40,0.40,0.35,0.35,0.00,0.00,69000,4,26100,0,0,0,0,0,0,42000,69000,-27000,-27000
20200520,060440,台灣50元大9C購27,,,,,0.00,0.00,0,0,0,0,0,0,0,0,0,0,0,0,0
20200520,060441,上証2X元大9A購01,,,,,0.00,0.00,0,0,0,0,0,0,0,0,0,0,0,0,0
20200520,060442,滬深2X元大9A購02,,,,,0.00,0.00,0,0,0,0,0,0,0,0,0,0,0,0,0
20200520,060443,滬深2X元大9A購03,,,,,0.00,0.00,0,0,0,0,0,0,0,0,0,0,0,0,0
20200520,060444,滬深2X元大9A購04,,,,,0.00,0.00,0,0,0,0,0,0,0,0,0,0,0,0,0
20200520,060445,S&P反1元大9A購04,,,,,0.00,0.00,0,0,0,0,0,0,0,0,0,0,0,0,0
20200520,060446,A50正2元大9A購01,,,,,0.00,0.00,0,0,0,0,0,0,0,0,0,0,0,0,0
20200520,060447,A50正2元大9A購02,,,,,0.00,0.00,0,0,0,0,0,0,0,0,0,0,0,0,0
20200520,060448,道瓊反元大9A購04,0.66,0.66,0.66,0.66,+0.01,1.54,215000,3,141900,0,0,0,0,0,0,215000,0,215000,215000
20200520,060449,元金2X元大9A購02,2.31,2.31,2.30,2.30,+0.12,5.5,74000,4,170420,0,0,0,0,0,0,74000,0,74000,74000
20200520,06044P,同欣電永豐96售03,0.64,0.64,0.64,0.64,-0.11,-14.67,10000,2,6400,0,0,0,0,0,0,0,10000,-10000,-10000
20200520,060450,南亞元大9A購02,2.76,2.76,2.74,2.74,0.00,0.00,22000,3,60680,0,0,0,0,0,0,22000,0,22000,22000
20200520,060451,中石化元大9C購02,1.66,1.68,1.59,1.60,-0.05,-3.03,825000,21,1355070,0,0,0,0,0,0,585000,260000,325000,325000
20200520,060452,儒鴻元大9A購01,3.36,3.36,3.26,3.32,+0.09,2.79,128000,12,423070,0,0,0,0,0,0,118000,47000,71000,71000
20200520,060453,儒鴻元大9A購02,2.81,2.81,2.75,2.79,+0.08,2.95,189000,9,524870,0,0,0,0,0,0,116000,132000,-16000,-16000
20200520,060454,葡萄王元大9A購01,1.71,1.73,1.69,1.69,-0.11,-6.11,103000,3,176750,0,0,0,0,0,0,35000,101000,-66000,-66000
20200520,060455,葡萄王元大9A購02,1.71,1.73,1.71,1.71,-0.03,-1.72,104000,3,178380,0,0,0,0,0,0,27000,104000,-77000,-77000
20200520,060456,正隆元大9A購01,3.02,3.15,2.94,2.96,-0.01,-0.34,1098000,61,3345000,0,0,0,0,0,0,535000,575000,-40000,-40000
20200520,060457,中橡元大9A購02,2.06,2.06,1.98,2.02,-0.04,-1.94,125000,9,252300,0,0,0,0,0,0,30000,105000,-75000,-75000
20200520,060458,華通元大9A購02,3.05,3.05,2.96,2.96,-0.29,-8.92,40000,5,121310,0,0,0,0,0,0,10000,30000,-20000,-20000
20200520,060459,鴻海元大9A購07,2.90,2.90,2.90,2.90,+0.02,0.69,50000,1,145000,0,0,0,0,0,0,50000,0,50000,50000
20200520,06045P,臺股指永豐96售03,,,,,0.00,0.00,0,0,0,0,0,0,0,0,0,0,0,0,0
20200520,060460,鴻海元大9A購08,2.36,2.40,2.34,2.34,-0.06,-2.5,196000,35,463320,0,0,0,0,0,0,186000,161000,25000,25000
20200520,060461,鴻海元大9A購09,,,,,0.00,0.00,0,0,0,0,0,0,0,0,0,0,0,0,0
20200520,060462,鴻海元大9A購10,,,,,0.00,0.00,0,0,0,0,0,0,0,0,0,0,0,0,0
20200520,060463,台積電元大9A購10,1.99,1.99,1.99,1.99,0.00,0.00,50000,1,99500,0,0,0,0,0,0,0,50000,-50000,-50000
20200520,060464,台積電元大9A購11,,,,,0.00,0.00,0,0,0,0,0,0,0,0,0,0,0,0,0
20200520,060465,聯發科元大9A購02,,,,,0.00,0.00,0,0,0,0,0,0,0,0,0,0,0,0,0
20200520,060466,玉山金元大9A購01,3.21,3.21,3.21,3.21,+0.02,0.63,22000,2,70620,0,0,0,0,0,0,22000,2000,20000,20000
20200520,060467,神基元大9A購01,2.15,2.16,2.15,2.15,-0.02,-0.92,204000,3,439100,0,0,0,0,0,0,154000,50000,104000,104000
20200520,060468,聯鈞元大9A購02,2.23,2.28,2.18,2.18,-0.10,-4.39,119000,13,265620,0,0,0,0,0,0,119000,0,119000,119000
20200520,060469,台勝科元大9A購02,3.44,3.69,3.44,3.69,-0.02,-0.54,154000,7,561090,0,0,0,0,0,0,3000,151000,-148000,-148000
20200520,06046P,健策統一96售03,1.66,1.73,1.64,1.66,-0.03,-1.78,248000,14,414890,0,0,0,0,0,0,137000,111000,26000,26000
20200520,060470,台勝科元大9A購03,2.60,2.80,2.55,2.80,+0.19,7.28,54000,6,146650,0,0,0,0,0,0,4000,50000,-46000,-46000
20200520,060471,台勝科元大9B購01,4.15,4.34,4.15,4.34,-0.17,-3.77,20000,3,85070,0,0,0,0,0,0,2000,18000,-16000,-16000
20200520,060472,中租元大9A購02,3.91,3.96,3.91,3.96,+0.08,2.06,65000,5,255250,0,0,0,0,0,0,65000,43000,22000,22000
20200520,060473,中租元大9A購03,3.08,3.08,3.08,3.08,+0.06,1.99,36000,4,110880,0,0,0,0,0,0,36000,0,36000,36000
20200520,060474,中租元大9B購01,,,,,0.00,0.00,0,0,0,0,0,0,0,0,0,0,0,0,0
20200520,060475,瑞祺元大9A購01,2.25,2.38,2.25,2.36,0.00,0.00,210000,13,487200,0,0,0,0,0,0,0,209000,-209000,-209000
20200520,060476,瑞祺元大9A購02,2.17,2.33,2.17,2.33,+0.17,7.87,368000,25,827550,0,0,0,0,0,0,73000,287000,-214000,-214000
20200520,060477,和潤元大9A購01,3.46,3.48,3.43,3.43,-0.06,-1.72,110000,12,380540,0,0,0,0,0,0,20000,110000,-90000,-90000
20200520,060478,南電元大9A購01,3.14,3.14,2.91,2.99,-0.11,-3.55,80000,9,244700,0,0,0,0,0,0,45000,35000,10000,10000
20200520,060479,億豐元大9A購01,4.54,4.86,4.54,4.86,+0.22,4.74,112000,11,523720,0,0,0,0,0,0,41000,71000,-30000,-30000
20200520,06047P,聯發科富邦99售04,2.88,2.91,2.72,2.86,-0.17,-5.61,246000,91,693410,0,0,0,0,0,0,94000,152000,-58000,-58000
20200520,060480,億豐元大9A購02,3.82,4.00,3.82,4.00,+0.09,2.3,144000,7,563400,0,0,0,0,0,0,63000,81000,-18000,-18000
20200520,060481,巨大元大9A購01,,,,,0.00,0.00,0,0,0,0,0,0,0,0,0,0,0,0,0
20200520,060482,東元富邦9A購01,0.74,0.74,0.74,0.74,0.00,0.00,6000,2,4440,0,0,0,0,0,0,0,6000,-6000,-6000
20200520,060483,友達富邦9A購01,0.97,1.05,0.96,1.00,+0.01,1.01,443000,42,438470,0,0,0,0,0,0,318000,90000,228000,228000
20200520,060484,聯發科富邦9C購02,2.36,2.48,2.35,2.37,+0.07,3.04,356000,27,854060,0,0,0,0,0,0,241000,104000,137000,137000
20200520,060485,華新科富邦9C購04,0.79,0.80,0.78,0.78,-0.01,-1.27,287000,13,226820,0,0,0,0,0,0,274000,15000,259000,259000
20200520,060486,中租富邦9A購01,,,,,0.00,0.00,0,0,0,0,0,0,0,0,0,0,0,0,0
20200520,060487,盛群富邦9B購01,1.31,1.31,1.29,1.29,0.00,0.00,120000,2,155200,0,0,0,0,0,0,100000,20000,80000,80000
20200520,060488,台灣50群益9C購01,,,,,0.00,0.00,0,0,0,0,0,0,0,0,0,0,0,0,0
20200520,060489,世紀鋼群益9A購01,1.07,1.08,0.97,0.97,-0.06,-5.83,125000,3,133450,0,0,0,0,0,0,0,125000,-125000,-125000
20200520,06048P,大立光富邦96售05,,,,,0.00,0.00,0,0,0,0,0,0,0,0,0,0,0,0,0
20200520,060490,華新科台新9A購01,2.36,2.44,2.36,2.44,+0.11,4.72,18000,2,43120,0,0,0,0,0,0,18000,0,18000,18000
20200520,060491,台灣50元富04購01,,,,,0.00,0.00,0,0,0,0,0,0,0,0,0,0,0,0,0
20200520,060492,元黃金元富9A購01,,,,,0.00,0.00,0,0,0,0,0,0,0,0,0,0,0,0,0
20200520,060493,美律元富01購01,2.07,2.08,2.06,2.08,-0.01,-0.48,199000,4,411130,0,0,0,0,0,0,109000,90000,19000,19000
20200520,060494,台灣50元大01購12,,,,,0.00,0.00,0,0,0,0,0,0,0,0,0,0,0,0,0
20200520,060495,台灣50元大01購13,,,,,0.00,0.00,0,0,0,0,0,0,0,0,0,0,0,0,0
20200520,060496,滬深2X元大9A購05,,,,,0.00,0.00,0,0,0,0,0,0,0,0,0,0,0,0,0
20200520,060497,臺指反元大01購02,,,,,0.00,0.00,0,0,0,0,0,0,0,0,0,0,0,0,0
20200520,060498,華通元大9A購03,,,,,0.00,0.00,0,0,0,0,0,0,0,0,0,0,0,0,0
20200520,060499,鴻海元大9A購11,,,,,0.00,0.00,0,0,0,0,0,0,0,0,0,0,0,0,0
20200520,06049P,創意亞東97售01,1.04,1.04,1.04,1.04,0.00,0.00,10000,1,10400,0,0,0,0,0,0,0,10000,-10000,-10000
20200520,060500,鴻海元大9A購12,1.32,1.32,1.30,1.30,-0.02,-1.52,201000,3,261320,0,0,0,0,0,0,199000,1000,198000,198000
20200520,060501,鴻海元大9A購13,,,,,0.00,0.00,0,0,0,0,0,0,0,0,0,0,0,0,0
20200520,060502,國巨元大9A購07,5.60,6.00,5.60,5.70,+0.40,7.55,12000,5,68900,0,0,0,0,0,0,1000,11000,-10000,-10000
20200520,060503,技嘉元大9A購01,1.68,1.70,1.60,1.61,-0.07,-4.17,156000,8,252430,0,0,0,0,0,0,154000,102000,52000,52000
20200520,060504,技嘉元大9A購02,2.41,2.41,2.27,2.27,-0.05,-2.16,107000,9,248610,0,0,0,0,0,0,107000,50000,57000,57000
20200520,060505,友達元大9C購05,1.77,1.81,1.73,1.73,-0.06,-3.35,76000,8,134560,0,0,0,0,0,0,66000,10000,56000,56000
20200520,060506,京元電元大9A購02,1.12,1.18,1.09,1.10,-0.12,-9.84,1187000,87,1338150,0,0,0,0,0,0,269000,890000,-621000,-621000
20200520,060507,聯發科元大9A購03,5.90,6.10,5.90,6.10,+0.25,4.27,18000,3,107050,0,0,0,0,0,0,15000,3000,12000,12000
20200520,060508,聯發科元大9A購04,4.44,4.44,4.44,4.44,+0.13,3.02,50000,1,222000,0,0,0,0,0,0,50000,0,50000,50000
20200520,060509,宏達電元大9A購02,1.29,1.37,1.29,1.32,+0.08,6.45,82000,7,109240,0,0,0,0,0,0,72000,14000,58000,58000
20200520,06050P,玉晶光國票98售01,4.37,4.37,4.06,4.08,-0.32,-7.27,143000,10,600380,0,0,0,0,0,0,73000,70000,3000,3000
20200520,060510,大立光元大9A購03,,,,,0.00,0.00,0,0,0,0,0,0,0,0,0,0,0,0,0
20200520,060511,群創元大9B購08,1.50,1.53,1.48,1.51,+0.02,1.34,230000,13,346200,0,0,0,0,0,0,230000,0,230000,230000
20200520,060512,祥碩元大9A購02,2.17,2.31,2.12,2.30,+0.23,11.11,192000,17,427540,0,0,0,0,0,0,48000,144000,-96000,-96000
20200520,060513,緯穎元大9B購01,2.47,2.58,2.34,2.34,-0.05,-2.09,211000,30,520630,0,0,0,0,0,0,171000,65000,106000,106000
20200520,060514,南電元大9A購02,1.85,1.93,1.70,1.77,-0.04,-2.21,304000,35,554180,0,0,0,0,0,0,121000,178000,-57000,-57000
20200520,060515,臺股指元大9B購12,1.87,1.87,1.87,1.87,0.00,0.00,20000,1,37400,0,0,0,0,0,0,0,20000,-20000,-20000
20200520,060516,臺股指元大9B購13,2.32,2.32,2.32,2.32,0.00,0.00,1000,1,2320,0,0,0,0,0,0,1000,0,1000,1000
20200520,060517,臺股指元大9B購14,,,,,0.00,0.00,0,0,0,0,0,0,0,0,0,0,0,0,0
20200520,060518,台灣50中信01購01,,,,,0.00,0.00,0,0,0,0,0,0,0,0,0,0,0,0,0
20200520,060519,S&P500中信01購01,,,,,0.00,0.00,0,0,0,0,0,0,0,0,0,0,0,0,0
20200520,06051P,嘉聯益國票97售04,,,,,0.00,0.00,0,0,0,0,0,0,0,0,0,0,0,0,0
20200520,060520,臺指2X中信01購02,2.77,2.83,2.77,2.83,+0.02,0.71,3000,2,8370,0,0,0,0,0,0,3000,0,3000,3000
20200520,060521,鴻海中信01購03,0.91,0.92,0.91,0.91,-0.01,-1.09,16000,7,14610,0,0,0,0,0,0,10000,6000,4000,4000
20200520,060522,鴻海中信9A購03,,,,,0.00,0.00,0,0,0,0,0,0,0,0,0,0,0,0,0
20200520,060523,鴻海中信9C購03,,,,,0.00,0.00,0,0,0,0,0,0,0,0,0,0,0,0,0
20200520,060524,國巨中信9A購03,1.83,1.96,1.83,1.88,+0.14,8.05,144000,19,271480,0,0,0,0,0,0,15000,129000,-114000,-114000
20200520,060525,台積電中信01購04,1.32,1.32,1.32,1.32,0.00,0.00,1000,1,1320,0,0,0,0,0,0,1000,1000,0,0
20200520,060526,台積電中信9A購02,1.36,1.38,1.36,1.38,+0.03,2.22,35000,3,47800,0,0,0,0,0,0,25000,11000,14000,14000
20200520,060527,台積電中信9C購04,1.38,1.38,1.38,1.38,0.00,0.00,1000,1,1380,0,0,0,0,0,0,1000,1000,0,0
20200520,060528,友達中信9C購01,1.33,1.41,1.33,1.39,+0.06,4.51,662000,12,910940,0,0,0,0,0,0,68000,594000,-526000,-526000
20200520,060529,聯發科中信9A購04,1.57,1.69,1.56,1.61,+0.08,5.23,239000,22,384940,0,0,0,0,0,0,170000,68000,102000,102000
20200520,06052P,台郡國票97售06,,,,,0.00,0.00,0,0,0,0,0,0,0,0,0,0,0,0,0
20200520,060530,聯發科中信9C購03,1.45,1.45,1.37,1.39,+0.04,2.96,54000,11,76350,0,0,0,0,0,0,24000,5000,19000,19000
20200520,060531,大立光中信9A購04,0.63,0.63,0.63,0.63,0.00,0.00,111000,1,69930,0,0,0,0,0,0,0,111000,-111000,-111000
20200520,060532,欣興中信9A購01,1.34,1.40,1.31,1.31,0.00,0.00,124000,10,165540,0,0,0,0,0,0,113000,11000,102000,102000
20200520,060533,臺股指中信9B購05,1.80,1.80,1.80,1.80,+0.02,1.12,10000,1,18000,0,0,0,0,0,0,10000,0,10000,10000
20200520,060534,友達麥證9A購01,1.28,1.28,1.26,1.26,0.00,0.00,64000,3,81640,0,64000,-64000,0,0,0,0,64000,-64000,-64000
20200520,060535,群創麥證9A購01,1.22,1.22,1.21,1.21,+0.02,1.68,42000,5,51020,42000,0,42000,0,0,0,42000,0,42000,42000
20200520,060536,祥碩麥證9A購01,3.21,3.46,3.21,3.46,+0.20,6.13,23000,3,78330,0,23000,-23000,0,0,0,0,23000,-23000,-23000
20200520,060537,台灣50凱基9B購01,1.94,1.96,1.92,1.94,+0.02,1.04,144000,9,279170,0,0,0,0,0,0,42000,102000,-60000,-60000
20200520,060538,S&P反1凱基9A購01,0.65,0.65,0.64,0.64,0.00,0.00,39000,4,25030,0,0,0,0,0,0,32000,7000,25000,25000
20200520,060539,道瓊反凱基9A購01,0.60,0.60,0.59,0.59,+0.01,1.72,58000,7,34640,0,0,0,0,0,0,18000,38000,-20000,-20000
20200520,06053P,緯穎國票97售05,0.01,0.01,0.01,0.01,0.00,0.00,300000,2,3000,0,0,0,0,0,0,300000,0,300000,300000
20200520,060540,南亞凱基9A購01,1.94,1.94,1.93,1.94,-0.02,-1.02,116000,6,224710,0,0,0,0,0,0,116000,0,116000,116000
20200520,060541,正隆凱基9A購01,2.41,2.55,2.39,2.42,0.00,0.00,636000,44,1567590,0,30000,-30000,0,0,0,466000,125000,341000,311000
20200520,060542,上銀凱基9A購04,,,,,0.00,0.00,0,0,0,0,0,0,0,0,0,0,0,0,0
20200520,060543,鴻海凱基9B購02,1.51,1.51,1.51,1.51,0.00,0.00,18000,1,27180,0,0,0,0,0,0,0,18000,-18000,-18000
20200520,060544,國巨凱基9B購03,2.87,2.87,2.87,2.87,+0.15,5.51,3000,1,8610,0,0,0,0,0,0,0,3000,-3000,-3000
20200520,060545,台積電凱基9B購02,1.21,1.22,1.19,1.22,+0.01,0.83,36000,3,43590,0,0,0,0,0,0,36000,0,36000,36000
20200520,060546,旺宏凱基9A購02,,,,,0.00,0.00,0,0,0,0,0,0,0,0,0,0,0,0,0
20200520,060547,瑞昱凱基9A購01,1.93,2.00,1.87,1.87,-0.06,-3.11,479000,33,919850,0,0,0,0,0,0,467000,12000,455000,455000
20200520,060548,友達凱基9B購03,1.69,1.76,1.69,1.76,+0.02,1.15,109000,8,189200,0,0,0,0,0,0,99000,10000,89000,89000
20200520,060549,聯發科凱基9B購03,3.16,3.25,3.16,3.25,+0.26,8.7,11000,2,35120,0,0,0,0,0,0,0,11000,-11000,-11000
20200520,06054P,臺股指中信9A售01,2.64,2.70,2.64,2.70,0.00,0.00,7000,2,18780,0,0,0,0,0,0,2000,5000,-3000,-3000
20200520,060550,可成凱基9A購02,1.62,1.65,1.62,1.64,0.00,0.00,196000,5,322220,0,0,0,0,0,0,0,196000,-196000,-196000
20200520,060551,大立光凱基9B購02,0.76,0.79,0.76,0.77,0.00,0.00,166000,10,129140,0,0,0,0,0,0,84000,82000,2000,2000
20200520,060552,群創凱基9B購05,1.41,1.46,1.37,1.39,-0.04,-2.8,240000,10,336600,0,0,0,0,0,0,240000,7000,233000,233000
20200520,060553,祥碩凱基9A購01,2.31,2.31,2.31,2.31,+0.04,1.76,13000,1,30030,0,0,0,0,0,0,13000,0,13000,13000
20200520,060554,中租凱基9A購01,,,,,0.00,0.00,0,0,0,0,0,0,0,0,0,0,0,0,0
20200520,060555,台表科凱基9A購03,3.65,4.10,3.63,4.10,+0.53,14.85,108000,21,416860,0,0,0,0,0,0,40000,68000,-28000,-28000
20200520,060556,緯穎凱基9A購04,2.38,2.44,2.21,2.21,-0.08,-3.49,138000,8,324930,0,0,0,0,0,0,98000,50000,48000,48000
20200520,060557,南電凱基9A購02,1.42,1.50,1.30,1.37,-0.03,-2.14,544000,47,762420,0,0,0,0,0,0,199000,339000,-140000,-140000
20200520,060558,億豐凱基9A購01,2.51,2.62,2.51,2.61,+0.08,3.16,253000,18,645590,0,0,0,0,0,0,159000,70000,89000,89000
20200520,060559,世紀鋼凱基9C購01,1.53,1.53,1.53,1.53,-0.23,-13.07,21000,3,32130,0,0,0,0,0,0,11000,10000,1000,1000
20200520,06055P,華通凱基97售04,1.79,1.79,1.66,1.69,0.00,0.00,27000,7,45870,0,0,0,0,0,0,13000,14000,-1000,-1000
20200520,060560,欣興國泰9C購01,2.30,2.38,2.21,2.25,+0.05,2.27,338000,30,778400,0,0,0,0,0,0,121000,217000,-96000,-96000
20200520,060561,台積電富邦04購01,0.86,0.86,0.84,0.84,-0.01,-1.18,1520000,26,1294910,0,0,0,0,0,0,1231000,256000,975000,975000
20200520,060562,旺宏富邦9C購02,1.29,1.30,1.29,1.30,0.00,0.00,85000,3,110420,0,0,0,0,0,0,85000,77000,8000,8000
20200520,060563,智邦富邦9A購01,,,,,0.00,0.00,0,0,0,0,0,0,0,0,0,0,0,0,0
20200520,060564,南亞科富邦9C購01,1.12,1.12,1.10,1.10,+0.04,3.77,505000,3,559550,0,0,0,0,0,0,200000,305000,-105000,-105000
20200520,060565,大立光富邦01購01,,,,,0.00,0.00,0,0,0,0,0,0,0,0,0,0,0,0,0
20200520,060566,聯詠富邦9C購01,1.16,1.22,1.15,1.17,-0.02,-1.68,85000,32,99170,0,0,0,0,0,0,50000,15000,35000,35000
20200520,060567,華擎富邦9C購01,0.95,1.01,0.95,1.01,0.00,0.00,24000,6,23520,0,0,0,0,0,0,12000,12000,0,0
20200520,060568,SP黃豆永豐9A購01,,,,,0.00,0.00,0,0,0,0,0,0,0,0,0,0,0,0,0
20200520,060569,台積電永豐9A購01,1.44,1.44,1.44,1.44,+0.02,1.41,30000,1,43200,0,0,0,0,0,0,0,30000,-30000,-30000
20200520,06056P,台積電凱基98售02,,,,,0.00,0.00,0,0,0,0,0,0,0,0,0,0,0,0,0
20200520,060570,南亞科永豐9A購01,,,,,0.00,0.00,0,0,0,0,0,0,0,0,0,0,0,0,0
20200520,060571,京元電永豐9A購01,0.91,0.92,0.86,0.87,-0.10,-10.31,253000,13,224110,0,0,0,0,0,0,20000,233000,-213000,-213000
20200520,060572,景碩永豐9A購01,,,,,0.00,0.00,0,0,0,0,0,0,0,0,0,0,0,0,0
20200520,060573,力成永豐9A購01,,,,,0.00,0.00,0,0,0,0,0,0,0,0,0,0,0,0,0
20200520,060574,高股息中信9C購01,1.94,1.94,1.94,1.94,+0.01,0.52,200000,1,388000,0,0,0,0,0,0,200000,0,200000,200000
20200520,060575,大立光中信9B購02,0.74,0.74,0.74,0.74,-0.03,-3.9,5000,1,3700,0,0,0,0,0,0,5000,0,5000,5000
20200520,060576,欣興中信9B購01,2.13,2.23,2.04,2.08,+0.04,1.96,317000,23,678970,0,0,0,0,0,0,239000,78000,161000,161000
20200520,060577,玉晶光中信9A購02,0.98,0.98,0.98,0.98,+0.01,1.03,20000,1,19600,0,0,0,0,0,0,20000,0,20000,20000
20200520,060578,臺股指中信9C購03,1.14,1.14,1.14,1.14,+0.02,1.79,40000,1,45600,0,0,0,0,0,0,40000,0,40000,40000
20200520,060579,上証2X群益9C購04,,,,,0.00,0.00,0,0,0,0,0,0,0,0,0,0,0,0,0
20200520,06057P,大立光凱基98售01,8.05,8.05,8.05,8.05,-0.10,-1.23,10000,1,80500,0,0,0,0,0,0,10000,0,10000,10000
20200520,060580,A50正2群益9C購03,,,,,0.00,0.00,0,0,0,0,0,0,0,0,0,0,0,0,0
20200520,060581,玉晶光群益9B購02,2.54,2.58,2.53,2.58,0.00,0.00,141000,4,360810,0,0,0,0,0,0,0,141000,-141000,-141000
20200520,060582,玉晶光群益9C購01,2.67,2.67,2.61,2.62,+0.16,6.5,88000,4,230250,0,0,0,0,0,0,70000,18000,52000,52000
20200520,060583,南亞科元富9A購05,1.92,2.02,1.92,1.93,+0.05,2.66,183000,15,360260,0,0,0,0,0,0,85000,98000,-13000,-13000
20200520,060584,玉晶光元富9A購01,3.44,3.71,3.44,3.71,+0.17,4.8,32000,8,115660,0,0,0,0,0,0,4000,28000,-24000,-24000
20200520,060585,玉晶光元富9A購02,,,,,0.00,0.00,0,0,0,0,0,0,0,0,0,0,0,0,0
20200520,060586,玉晶光元富9A購03,2.99,3.20,2.99,3.20,0.00,0.00,73000,8,224100,0,0,0,0,0,0,0,73000,-73000,-73000
20200520,060587,牧德元富9A購01,,,,,0.00,0.00,0,0,0,0,0,0,0,0,0,0,0,0,0
20200520,060588,台灣50台新9A購03,,,,,0.00,0.00,0,0,0,0,0,0,0,0,0,0,0,0,0
20200520,060589,台灣50台新9B購06,,,,,0.00,0.00,0,0,0,0,0,0,0,0,0,0,0,0,0
20200520,06058P,玉晶光凱基97售04,1.65,1.65,1.53,1.53,-0.16,-9.47,520000,8,816700,0,0,0,0,0,0,0,520000,-520000,-520000
20200520,060590,台積電台新9C購02,1.21,1.21,1.21,1.21,-0.01,-0.82,1000,1,1210,0,0,0,0,0,0,1000,1000,0,0
20200520,060591,富邦金台新9A購01,1.66,1.71,1.66,1.71,+0.07,4.27,15000,2,25250,0,0,0,0,0,0,8000,7000,1000,1000
20200520,060592,上銀麥證9A購01,,,,,0.00,0.00,0,0,0,0,0,0,0,0,0,0,0,0,0
20200520,060593,華通麥證9A購01,3.04,3.05,3.04,3.05,-0.03,-0.97,4000,2,12180,0,4000,-4000,0,0,0,0,4000,-4000,-4000
20200520,060594,國巨麥證9A購01,2.88,2.88,2.88,2.88,0.00,0.00,5000,1,14400,5000,0,5000,0,0,0,5000,0,5000,5000
20200520,060595,台灣50凱基04購04,2.40,2.40,2.40,2.40,0.00,0.00,114000,2,273600,0,0,0,0,0,0,114000,0,114000,114000
20200520,060596,元黃金凱基9A購02,0.37,0.37,0.37,0.37,+0.02,5.71,28000,4,10360,0,0,0,0,0,0,28000,0,28000,28000
20200520,060597,華通凱基9A購04,1.72,1.72,1.72,1.72,-0.05,-2.82,21000,1,36120,0,0,0,0,0,0,0,21000,-21000,-21000
20200520,060598,鴻海凱基9A購20,1.56,1.56,1.56,1.56,0.00,0.00,18000,1,28080,0,0,0,0,0,0,0,18000,-18000,-18000
20200520,060599,國巨凱基9C購01,2.29,2.45,2.29,2.34,+0.16,7.34,153000,12,358030,0,0,0,0,0,0,55000,98000,-43000,-43000
20200520,06059P,泰碩元大97售02,0.64,0.71,0.64,0.71,+0.04,5.97,112000,7,76320,0,0,0,0,0,0,100000,12000,88000,88000
20200520,060600,台積電凱基9C購01,,,,,0.00,0.00,0,0,0,0,0,0,0,0,0,0,0,0,0
20200520,060601,技嘉凱基9A購02,1.50,1.50,1.44,1.44,-0.04,-2.7,306000,16,449090,0,0,0,0,0,0,57000,249000,-192000,-192000
20200520,060602,京元電凱基9A購01,1.06,1.07,1.02,1.03,-0.09,-8.04,604000,39,637910,0,0,0,0,0,0,0,599000,-599000,-599000
20200520,060603,聯發科凱基9A購12,2.27,2.27,2.27,2.27,+0.08,3.65,1000,1,2270,0,0,0,0,0,0,1000,0,1000,1000
20200520,060604,宏達電凱基9B購01,1.23,1.28,1.23,1.25,+0.04,3.31,54000,6,67000,0,0,0,0,0,0,42000,14000,28000,28000
20200520,060605,大立光凱基9C購01,,,,,0.00,0.00,0,0,0,0,0,0,0,0,0,0,0,0,0
20200520,060606,玉晶光凱基9A購05,,,,,0.00,0.00,0,0,0,0,0,0,0,0,0,0,0,0,0
20200520,060607,玉晶光凱基9A購06,,,,,0.00,0.00,0,0,0,0,0,0,0,0,0,0,0,0,0
20200520,060608,玉晶光凱基9A購08,1.23,1.23,1.21,1.21,+0.03,2.54,61000,4,74830,0,0,0,0,0,0,10000,51000,-41000,-41000
20200520,060609,玉晶光凱基9B購01,1.83,1.83,1.83,1.83,0.00,0.00,7000,1,12810,0,0,0,0,0,0,0,7000,-7000,-7000
20200520,06060P,玉晶光元大97售03,1.71,1.71,1.58,1.58,-0.15,-8.67,53000,2,89980,0,0,0,0,0,0,5000,48000,-43000,-43000
20200520,060610,玉晶光凱基9B購02,3.53,3.62,3.53,3.59,+0.16,4.66,39000,7,139680,0,0,0,0,0,0,5000,39000,-34000,-34000
20200520,060611,同欣電凱基9A購02,1.33,1.40,1.31,1.32,0.00,0.00,622000,34,844720,0,0,0,0,0,0,493000,129000,364000,364000
20200520,060612,世紀鋼凱基9A購01,1.35,1.35,1.31,1.31,-0.10,-7.09,60000,2,79000,0,0,0,0,0,0,10000,50000,-40000,-40000
20200520,060613,T50反1元大9A購05,1.13,1.13,1.13,1.13,0.00,0.00,5000,1,5650,0,0,0,0,0,0,0,5000,-5000,-5000
20200520,060614,T50反1元大9A購06,1.09,1.09,1.09,1.09,0.00,0.00,18000,1,19620,0,0,0,0,0,0,0,18000,-18000,-18000
20200520,060615,T50反1元大9A購07,,,,,0.00,0.00,0,0,0,0,0,0,0,0,0,0,0,0,0
20200520,060616,宏碁元大9A購02,1.81,1.83,1.81,1.83,+0.01,0.55,190000,3,346600,0,0,0,0,0,0,190000,0,190000,190000
20200520,060617,華新科元大9A購08,2.27,2.34,2.23,2.31,+0.03,1.32,113000,14,257160,0,0,0,0,0,0,113000,3000,110000,110000
20200520,060618,玉晶光元大9A購02,,,,,0.00,0.00,0,0,0,0,0,0,0,0,0,0,0,0,0
20200520,060619,玉晶光元大9A購03,2.19,2.27,2.15,2.27,+0.11,5.09,69000,4,150870,0,0,0,0,0,0,0,69000,-69000,-69000
20200520,06061P,訊芯統一97售01,,,,,0.00,0.00,0,0,0,0,0,0,0,0,0,0,0,0,0
20200520,060620,玉晶光元大9A購04,2.20,2.23,2.20,2.23,+0.13,6.19,70000,3,154800,0,0,0,0,0,0,50000,70000,-20000,-20000
20200520,060621,玉晶光元大9A購05,3.00,3.16,3.00,3.16,+0.34,12.06,43000,6,132230,0,0,0,0,0,0,9000,43000,-34000,-34000
20200520,060622,玉晶光元大9B購02,1.72,1.72,1.72,1.72,+0.09,5.52,5000,1,8600,0,0,0,0,0,0,0,5000,-5000,-5000
20200520,060623,玉晶光元大9C購01,1.66,1.74,1.66,1.74,+0.10,6.1,20000,4,34220,0,0,0,0,0,0,19000,8000,11000,11000
20200520,060624,玉晶光元大9C購02,3.25,3.31,3.18,3.31,+0.25,8.17,138000,8,454500,0,0,0,0,0,0,12000,138000,-126000,-126000
20200520,060625,華擎元大9A購01,1.28,1.42,1.26,1.42,+0.19,15.45,389000,26,526830,0,0,0,0,0,0,221000,238000,-17000,-17000
20200520,060626,貿聯元大9A購04,1.54,1.54,1.49,1.54,+0.03,1.99,66000,6,100820,0,0,0,0,0,0,55000,21000,34000,34000
20200520,060627,國巨國泰9B購05,3.56,3.56,3.36,3.36,0.00,0.00,21000,3,73260,0,0,0,0,0,0,0,21000,-21000,-21000
20200520,060628,和大富邦9B購01,1.20,1.36,1.18,1.36,+0.12,9.68,2389000,78,3033540,0,0,0,0,0,0,575000,1814000,-1239000,-1239000
20200520,060629,鴻海富邦9B購01,1.18,1.20,1.16,1.16,-0.04,-3.33,79000,10,94010,0,0,0,0,0,0,47000,29000,18000,18000
20200520,06062P,宏達電元富97售01,3.41,3.41,3.41,3.41,0.00,0.00,1000,1,3410,0,0,0,0,0,0,0,1000,-1000,-1000
20200520,060630,國巨富邦9C購03,1.11,1.12,1.08,1.08,+0.05,4.85,35000,3,38320,0,0,0,0,0,0,35000,0,35000,35000
20200520,060631,微星富邦9B購01,0.92,0.96,0.86,0.87,-0.05,-5.43,554000,34,512490,0,0,0,0,0,0,200000,330000,-130000,-130000
20200520,060632,可成富邦9B購01,0.70,0.71,0.68,0.68,-0.06,-8.11,339000,14,231190,0,0,0,0,0,0,0,339000,-339000,-339000
20200520,060633,玉晶光富邦02購01,1.37,1.43,1.37,1.43,+0.09,6.72,214000,16,304280,0,0,0,0,0,0,0,204000,-204000,-204000
20200520,060634,矽創富邦9B購01,0.98,0.98,0.87,0.89,-0.06,-6.32,541000,68,511870,0,0,0,0,0,0,384000,116000,268000,268000
20200520,060635,義隆永豐9A購01,,,,,0.00,0.00,0,0,0,0,0,0,0,0,0,0,0,0,0
20200520,060636,大毅永豐9A購02,1.50,1.53,1.47,1.47,+0.01,0.68,67000,9,100850,0,0,0,0,0,0,0,67000,-67000,-67000
20200520,060637,玉晶光永豐9A購03,,,,,0.00,0.00,0,0,0,0,0,0,0,0,0,0,0,0,0
20200520,060638,玉晶光永豐9A購04,1.79,1.80,1.77,1.77,+0.04,2.31,74000,12,132390,0,0,0,0,0,0,0,74000,-74000,-74000
20200520,060639,玉晶光永豐9A購05,1.93,1.99,1.90,1.97,+0.13,7.07,199000,18,390580,0,0,0,0,0,0,1000,198000,-197000,-197000
20200520,06063P,玉晶光元富97售01,,,,,0.00,0.00,0,0,0,0,0,0,0,0,0,0,0,0,0
20200520,060640,京鼎永豐9A購01,1.53,1.53,1.50,1.51,-0.01,-0.66,125000,8,190160,0,0,0,0,0,0,3000,122000,-119000,-119000
20200520,060641,聯鈞永豐9A購01,,,,,0.00,0.00,0,0,0,0,0,0,0,0,0,0,0,0,0
20200520,060642,華擎永豐9A購02,0.58,0.67,0.58,0.64,0.00,0.00,35000,8,22080,0,0,0,0,0,0,4000,31000,-27000,-27000
20200520,060643,牧德永豐9A購03,1.30,1.46,1.30,1.45,+0.22,17.89,677000,12,972680,0,0,0,0,0,0,41000,636000,-595000,-595000
20200520,060644,泰鼎永豐9A購02,1.54,1.73,1.54,1.73,+0.13,8.12,241000,27,399940,0,0,0,0,0,0,59000,177000,-118000,-118000
20200520,060645,台表科永豐9A購02,2.04,2.25,1.93,2.25,+0.32,16.58,398000,32,804390,0,0,0,0,0,0,343000,50000,293000,293000
20200520,060646,南電永豐9A購01,1.09,1.11,1.02,1.06,-0.03,-2.75,186000,16,196090,0,0,0,0,0,0,164000,21000,143000,143000
20200520,060647,T50反1第一9A購01,,,,,0.00,0.00,0,0,0,0,0,0,0,0,0,0,0,0,0
20200520,060648,鴻海第一9A購01,0.81,0.81,0.81,0.81,-0.04,-4.71,10000,1,8100,0,0,0,0,0,0,10000,0,10000,10000
20200520,060649,國巨第一9A購01,1.17,1.26,1.16,1.18,+0.09,8.26,1979000,29,2368040,0,0,0,0,0,0,1157000,822000,335000,335000
20200520,06064P,台積電台新98售01,1.94,2.00,1.92,2.00,+0.02,1.01,270000,29,528640,0,0,0,0,0,0,270000,270000,0,0
20200520,060650,奇力新中信9A購01,0.89,0.92,0.89,0.91,0.00,0.00,107000,4,97230,0,0,0,0,0,0,0,107000,-107000,-107000
20200520,060651,瑞儀中信9B購01,0.96,1.00,0.96,1.00,+0.04,4.17,168000,7,163160,0,0,0,0,0,0,0,168000,-168000,-168000
20200520,060652,滬深2X群益9C購04,,,,,0.00,0.00,0,0,0,0,0,0,0,0,0,0,0,0,0
20200520,060653,全新群益9A購02,1.71,1.71,1.71,1.71,-0.01,-0.58,6000,1,10260,0,0,0,0,0,0,6000,0,6000,6000
20200520,060654,大毅群益9B購01,1.18,1.18,1.14,1.16,+0.03,2.65,461000,10,529470,0,0,0,0,0,0,308000,153000,155000,155000
20200520,060655,國巨統一9B購06,1.46,1.46,1.41,1.41,0.00,0.00,30000,4,43350,0,0,0,0,0,0,10000,20000,-10000,-10000
20200520,060656,國巨統一9C購03,,,,,0.00,0.00,0,0,0,0,0,0,0,0,0,0,0,0,0
20200520,060657,旺宏統一9B購05,,,,,0.00,0.00,0,0,0,0,0,0,0,0,0,0,0,0,0
20200520,060658,台灣50凱基01購04,1.73,1.73,1.72,1.73,+0.01,0.58,15000,3,25870,0,0,0,0,0,0,15000,0,15000,15000
20200520,060659,鴻海凱基9B購03,2.95,2.95,2.95,2.95,0.00,0.00,10000,1,29500,0,0,0,0,0,0,0,10000,-10000,-10000
20200520,06065P,大立光台新97售01,,,,,0.00,0.00,0,0,0,0,0,0,0,0,0,0,0,0,0
20200520,060660,國巨凱基9B購04,1.91,1.91,1.85,1.86,0.00,0.00,544000,4,1037640,0,0,0,0,0,0,0,544000,-544000,-544000
20200520,060661,台積電凱基9A購18,1.37,1.37,1.37,1.37,-0.02,-1.44,5000,1,6850,0,0,0,0,0,0,0,5000,-5000,-5000
20200520,060662,旺宏凱基9A購03,,,,,0.00,0.00,0,0,0,0,0,0,0,0,0,0,0,0,0
20200520,060663,聯發科凱基9A購13,6.35,6.80,6.35,6.55,+0.35,5.65,27000,6,174850,0,0,0,0,0,0,22000,5000,17000,17000
20200520,060664,聯詠凱基9A購01,1.20,1.26,1.19,1.21,-0.03,-2.42,365000,21,452140,0,0,0,0,0,0,141000,214000,-73000,-73000
20200520,060665,康控凱基9A購01,1.56,1.56,1.46,1.46,-0.01,-0.68,464000,36,688670,0,0,0,0,0,0,367000,10000,357000,357000
20200520,060666,聯茂凱基9A購02,0.78,0.79,0.76,0.76,-0.03,-3.8,304000,14,237000,0,0,0,0,0,0,251000,63000,188000,188000
20200520,060667,力成凱基9A購01,1.34,1.34,1.31,1.31,-0.05,-3.68,143000,8,188570,0,0,0,0,0,0,73000,70000,3000,3000
20200520,060668,上証2X元大9A購02,,,,,0.00,0.00,0,0,0,0,0,0,0,0,0,0,0,0,0
20200520,060669,上証2X元大9A購03,,,,,0.00,0.00,0,0,0,0,0,0,0,0,0,0,0,0,0
20200520,06066P,群創台新98售01,,,,,0.00,0.00,0,0,0,0,0,0,0,0,0,0,0,0,0
20200520,060670,臺指反元大01購03,0.69,0.69,0.69,0.69,0.00,0.00,10000,1,6900,0,0,0,0,0,0,0,10000,-10000,-10000
20200520,060671,亞德客元大9A購03,2.09,2.09,1.98,2.00,+0.03,1.52,67000,6,137110,0,0,0,0,0,0,37000,30000,7000,7000
20200520,060672,鴻海元大9A購14,,,,,0.00,0.00,0,0,0,0,0,0,0,0,0,0,0,0,0
20200520,060673,旺宏元大9A購04,1.74,1.74,1.74,1.74,+0.02,1.16,2000,1,3480,0,0,0,0,0,0,2000,0,2000,2000
20200520,060674,瑞昱元大9A購03,2.50,2.50,2.38,2.40,-0.07,-2.83,303000,26,739320,5000,0,5000,0,0,0,239000,134000,105000,110000
20200520,060675,南亞科元大9A購02,1.81,1.87,1.79,1.87,+0.08,4.47,186000,8,342080,0,0,0,0,0,0,118000,68000,50000,50000
20200520,060676,京元電元大9A購03,0.96,0.99,0.94,0.94,-0.07,-6.93,131000,8,127330,0,0,0,0,0,0,10000,121000,-111000,-111000
20200520,060677,京元電元大9A購04,1.44,1.44,1.30,1.30,-0.14,-9.72,1482000,64,1970650,0,0,0,0,0,0,549000,898000,-349000,-349000
20200520,060678,聯詠元大9A購03,2.11,2.11,2.06,2.11,-0.13,-5.8,69000,8,143290,0,0,0,0,0,0,44000,34000,10000,10000
20200520,060679,聯詠元大9A購04,1.69,1.75,1.69,1.72,-0.09,-4.97,148000,12,253510,0,0,0,0,0,0,101000,88000,13000,13000
20200520,06067P,華新科康和97售01,0.79,0.79,0.73,0.79,+0.01,1.28,160000,11,123600,0,0,0,0,0,0,40000,120000,-80000,-80000
20200520,060680,玉晶光元大9C購03,3.85,4.17,3.85,4.15,+0.37,9.79,98000,17,402380,0,0,0,0,0,0,14000,93000,-79000,-79000
20200520,060681,華擎元大9A購02,1.66,1.66,1.66,1.66,0.00,0.00,22000,1,36520,0,0,0,0,0,0,0,22000,-22000,-22000
20200520,060682,牧德元大9A購03,1.58,1.85,1.58,1.79,+0.21,13.29,449000,34,790060,0,0,0,0,0,0,87000,360000,-273000,-273000
20200520,060683,泰鼎元大9A購02,3.28,3.51,3.12,3.51,+0.23,7.01,724000,70,2376850,0,0,0,0,0,0,437000,317000,120000,120000
20200520,060684,同欣電元大9A購01,1.95,2.09,1.93,1.95,-0.01,-0.51,429000,35,859060,0,0,0,0,0,0,192000,240000,-48000,-48000
20200520,060685,康友元大9A購01,2.03,2.09,2.03,2.09,-0.04,-1.88,103000,4,212270,0,0,0,0,0,0,0,103000,-103000,-103000
20200520,060686,康友元大9A購02,1.48,1.50,1.47,1.50,-0.05,-3.23,131000,4,193660,0,0,0,0,0,0,93000,38000,55000,55000
20200520,060687,GIS元大9A購01,2.28,2.31,2.27,2.28,-0.02,-0.87,79000,6,181430,0,0,0,0,0,0,16000,69000,-53000,-53000
20200520,060688,世紀鋼元大9C購01,2.13,2.13,1.96,1.96,-0.13,-6.22,631000,10,1305000,0,70000,-70000,0,0,0,420000,211000,209000,139000
20200520,060689,臺股指元大9A購43,,,,,0.00,0.00,0,0,0,0,0,0,0,0,0,0,0,0,0
20200520,06068P,玉晶光康和97售01,0.73,0.75,0.72,0.72,-0.11,-13.25,861000,12,638120,0,0,0,0,0,0,74000,787000,-713000,-713000
20200520,060690,臺股指元大9A購46,,,,,0.00,0.00,0,0,0,0,0,0,0,0,0,0,0,0,0
20200520,060691,臺股指元大9A購47,,,,,0.00,0.00,0,0,0,0,0,0,0,0,0,0,0,0,0
20200520,060692,鴻海麥證9A購01,1.71,1.71,1.62,1.62,-0.04,-2.41,30000,4,49800,10000,20000,-10000,0,0,0,10000,20000,-10000,-10000
20200520,060693,台積電麥證9A購02,,,,,0.00,0.00,0,0,0,0,0,0,0,0,0,0,0,0,0
20200520,060694,旺宏麥證9A購02,,,,,0.00,0.00,0,0,0,0,0,0,0,0,0,0,0,0,0
20200520,060695,同欣電麥證9A購01,1.07,1.07,1.00,1.01,-0.03,-2.88,407000,17,428590,365000,0,365000,0,0,0,365000,0,365000,365000
20200520,060696,道瓊反國泰9C購01,0.97,0.97,0.97,0.97,+0.03,3.19,15000,2,14550,0,0,0,0,0,0,5000,10000,-5000,-5000
20200520,060697,鴻海國泰9C購01,1.69,1.70,1.69,1.69,-0.07,-3.98,37000,5,62690,0,0,0,0,0,0,0,37000,-37000,-37000
20200520,060698,旺宏國泰9C購01,1.94,1.98,1.93,1.94,+0.04,2.11,190000,11,370780,0,0,0,0,0,0,5000,185000,-180000,-180000
20200520,060699,華新科國泰9B購03,1.99,2.05,1.92,1.97,-0.02,-1.01,595000,64,1184830,0,0,0,0,0,0,527000,108000,419000,419000
20200520,06069P,台積電永豐97售01,,,,,0.00,0.00,0,0,0,0,0,0,0,0,0,0,0,0,0
20200520,060700,華新科國泰9C購01,1.89,1.94,1.81,1.81,-0.06,-3.21,610000,62,1146710,0,0,0,0,0,0,413000,227000,186000,186000
20200520,060701,玉晶光國泰9C購01,1.91,2.01,1.91,2.01,+0.10,5.24,413000,23,813860,0,0,0,0,0,0,89000,325000,-236000,-236000
20200520,060702,玉晶光國泰9C購02,1.73,1.82,1.73,1.82,+0.13,7.69,298000,12,533660,0,0,0,0,0,0,25000,273000,-248000,-248000
20200520,060703,T50反1富邦9C購01,,,,,0.00,0.00,0,0,0,0,0,0,0,0,0,0,0,0,0
20200520,060704,台積電富邦01購01,0.71,0.71,0.70,0.70,-0.01,-1.41,46000,3,32210,0,0,0,0,0,0,36000,10000,26000,26000
20200520,060705,台光電富邦9B購01,0.91,0.95,0.90,0.92,-0.01,-1.08,320000,29,293820,0,0,0,0,0,0,279000,11000,268000,268000
20200520,060706,群創富邦9A購01,0.63,0.63,0.61,0.61,-0.04,-6.15,403000,6,249990,0,0,0,0,0,0,383000,20000,363000,363000
20200520,060707,台郡富邦9A購01,0.54,0.55,0.53,0.53,0.00,0.00,81000,8,43430,0,0,0,0,0,0,56000,25000,31000,31000
20200520,060708,康友富邦9B購01,0.66,0.68,0.66,0.67,-0.02,-2.9,133000,5,90040,0,0,0,0,0,0,30000,103000,-73000,-73000
20200520,060709,緯穎富邦9B購01,0.82,0.86,0.76,0.76,-0.02,-2.56,1273000,75,1047770,0,0,0,0,0,0,1104000,150000,954000,954000
20200520,06070P,漢唐永豐97售01,,,,,0.00,0.00,0,0,0,0,0,0,0,0,0,0,0,0,0
20200520,060710,上銀永豐9A購01,,,,,0.00,0.00,0,0,0,0,0,0,0,0,0,0,0,0,0
20200520,060711,旺宏永豐9A購01,,,,,0.00,0.00,0,0,0,0,0,0,0,0,0,0,0,0,0
20200520,060712,建準永豐9A購01,2.49,2.52,2.40,2.51,-0.10,-3.83,191000,19,474070,0,0,0,0,0,0,119000,67000,52000,52000
20200520,060713,聯詠永豐9A購01,0.86,0.94,0.86,0.94,-0.01,-1.05,105000,7,94020,0,0,0,0,0,0,105000,0,105000,105000
20200520,060714,晶技永豐9A購02,1.26,1.27,1.22,1.23,-0.06,-4.65,101000,5,126370,0,0,0,0,0,0,71000,30000,41000,41000
20200520,060715,日電貿永豐9A購01,1.21,1.21,1.17,1.17,-0.01,-0.85,116000,3,140160,0,0,0,0,0,0,0,116000,-116000,-116000
20200520,060716,新唐永豐9A購01,0.96,0.96,0.93,0.96,+0.05,5.49,80000,4,75700,0,0,0,0,0,0,0,80000,-80000,-80000
20200520,060717,康控永豐9A購01,,,,,0.00,0.00,0,0,0,0,0,0,0,0,0,0,0,0,0
20200520,060718,中磊永豐9A購01,1.31,1.31,1.31,1.31,-0.03,-2.24,115000,4,150650,0,0,0,0,0,0,97000,18000,79000,79000
20200520,060719,瀚宇博永豐9A購01,0.71,0.71,0.69,0.69,-0.02,-2.82,19000,4,13450,0,0,0,0,0,0,16000,3000,13000,13000
20200520,06071P,大立光永豐97售01,,,,,0.00,0.00,0,0,0,0,0,0,0,0,0,0,0,0,0
20200520,060720,嘉聯益永豐9A購02,0.74,0.74,0.74,0.74,0.00,0.00,135000,2,99900,0,0,0,0,0,0,0,135000,-135000,-135000
20200520,060721,瑞儀永豐9A購01,1.05,1.12,1.04,1.12,+0.03,2.75,440000,13,486160,0,0,0,0,0,0,59000,394000,-335000,-335000
20200520,060722,矽格永豐9A購01,1.14,1.24,1.14,1.24,+0.10,8.77,445000,24,535240,0,0,0,0,0,0,0,445000,-445000,-445000
20200520,060723,致新永豐9A購01,1.33,1.37,1.30,1.34,+0.08,6.35,281000,23,379220,0,0,0,0,0,0,114000,167000,-53000,-53000
20200520,060724,台灣50第一9A購02,,,,,0.00,0.00,0,0,0,0,0,0,0,0,0,0,0,0,0
20200520,060725,台積電第一9A購01,0.73,0.73,0.73,0.73,0.00,0.00,10000,1,7300,0,0,0,0,0,0,10000,0,10000,10000
20200520,060726,聯發科第一9A購01,1.79,1.81,1.79,1.81,+0.04,2.26,47000,9,84150,0,0,0,0,0,0,47000,0,47000,47000
20200520,060727,高股息中信9C購02,1.00,1.00,1.00,1.00,-0.01,-0.99,3000,1,3000,0,0,0,0,0,0,3000,0,3000,3000
20200520,060728,上証2X群益9C購05,,,,,0.00,0.00,0,0,0,0,0,0,0,0,0,0,0,0,0
20200520,060729,國巨群益9A購05,2.49,2.49,2.49,2.49,+0.27,12.16,19000,2,47310,0,0,0,0,0,0,0,19000,-19000,-19000
20200520,06072P,牧德永豐97售01,0.41,0.41,0.32,0.33,-0.18,-35.29,332000,8,127760,0,0,0,0,0,0,0,332000,-332000,-332000
20200520,060730,台積電群益9A購03,2.13,2.13,2.12,2.12,-0.02,-0.93,11000,2,23330,0,0,0,0,0,0,1000,11000,-10000,-10000
20200520,060731,奇力新群益9A購01,0.94,0.97,0.94,0.94,0.00,0.00,494000,7,468460,0,0,0,0,0,0,0,494000,-494000,-494000
20200520,060732,玉晶光群益9C購02,1.86,1.91,1.86,1.91,0.00,0.00,159000,7,299390,0,0,0,0,0,0,0,159000,-159000,-159000
20200520,060733,和大統一9C購01,1.15,1.31,1.14,1.31,+0.12,10.08,1378000,35,1651940,0,0,0,0,0,0,736000,642000,94000,94000
20200520,060734,華通統一9C購01,1.05,1.09,1.04,1.04,-0.03,-2.8,381000,4,398640,0,0,0,0,0,0,341000,40000,301000,301000
20200520,060735,鴻海統一9C購03,0.92,0.92,0.91,0.91,0.00,0.00,20000,3,18310,0,0,0,0,0,0,0,20000,-20000,-20000
20200520,060736,旺宏統一01購01,1.13,1.13,1.10,1.11,+0.01,0.91,12000,3,13510,0,0,0,0,0,0,1000,11000,-10000,-10000
20200520,060737,瑞儀統一9C購01,1.17,1.21,1.17,1.21,+0.02,1.68,335000,10,400370,0,0,0,0,0,0,50000,285000,-235000,-235000
20200520,060738,矽格統一9C購01,1.34,1.34,1.34,1.34,0.00,0.00,5000,1,6700,0,0,0,0,0,0,0,5000,-5000,-5000
20200520,060739,台灣50台新9A購04,,,,,0.00,0.00,0,0,0,0,0,0,0,0,0,0,0,0,0
20200520,06073P,健策永豐97售01,1.30,1.36,1.29,1.36,-0.02,-1.45,219000,8,288890,0,0,0,0,0,0,131000,88000,43000,43000
20200520,060740,T50反1台新9C購02,,,,,0.00,0.00,0,0,0,0,0,0,0,0,0,0,0,0,0
20200520,060741,滬深2X國票9A購05,,,,,0.00,0.00,0,0,0,0,0,0,0,0,0,0,0,0,0
20200520,060742,臺指反國票9B購02,0.39,0.39,0.39,0.39,-0.01,-2.5,52000,5,20280,0,0,0,0,0,0,0,52000,-52000,-52000
20200520,060743,鴻海國票9A購03,,,,,0.00,0.00,0,0,0,0,0,0,0,0,0,0,0,0,0
20200520,060744,鴻海國票9A購04,1.53,1.58,1.48,1.48,-0.07,-4.52,165000,8,254200,0,0,0,0,0,0,75000,90000,-15000,-15000
20200520,060745,京元電國票9A購01,0.61,0.62,0.60,0.60,-0.06,-9.09,15000,3,9150,0,0,0,0,0,0,10000,5000,5000,5000
20200520,060746,玉晶光國票9B購02,2.11,2.29,2.11,2.28,+0.12,5.56,327000,10,740830,0,0,0,0,0,0,111000,217000,-106000,-106000
20200520,060747,聯鈞國票9A購02,2.55,2.55,2.41,2.41,-0.20,-7.66,90000,4,226420,0,0,0,0,0,0,80000,10000,70000,70000
20200520,060748,臻鼎國票9A購01,1.62,1.78,1.62,1.78,+0.18,11.25,103000,7,172790,0,0,0,0,0,0,95000,0,95000,95000
20200520,060749,祥碩國票9A購01,,,,,0.00,0.00,0,0,0,0,0,0,0,0,0,0,0,0,0
20200520,06074P,台積電凱基98售04,16.00,16.00,16.00,16.00,0.00,0.00,2000,2,32000,0,0,0,0,0,0,0,2000,-2000,-2000
20200520,060750,高股息元大9A購01,,,,,0.00,0.00,0,0,0,0,0,0,0,0,0,0,0,0,0
20200520,060751,高股息元大9B購01,1.47,1.47,1.47,1.47,0.00,0.00,1000,1,1470,0,0,0,0,0,0,1000,0,1000,1000
20200520,060752,上銀元大9A購04,2.62,2.64,2.60,2.60,-0.06,-2.26,58000,3,151960,0,0,0,0,0,0,0,58000,-58000,-58000
20200520,060753,上銀元大9A購05,3.47,3.47,3.47,3.47,+0.01,0.29,3000,1,10410,0,0,0,0,0,0,0,3000,-3000,-3000
20200520,060754,華通元大9A購04,2.28,2.28,2.24,2.24,-0.03,-1.32,53000,3,118820,0,0,0,0,0,0,53000,0,53000,53000
20200520,060755,鴻海元大9A購15,,,,,0.00,0.00,0,0,0,0,0,0,0,0,0,0,0,0,0
20200520,060756,鴻海元大9A購16,1.39,1.39,1.39,1.39,0.00,0.00,1000,1,1390,0,0,0,0,0,0,0,1000,-1000,-1000
20200520,060757,台積電元大9A購18,2.33,2.33,2.32,2.32,-0.02,-0.85,52000,2,121140,0,0,0,0,0,0,0,52000,-52000,-52000
20200520,060758,台積電元大9A購19,1.17,1.18,1.16,1.18,+0.01,0.85,280000,15,326930,0,0,0,0,0,0,264000,2000,262000,262000
20200520,060759,南亞科元大9A購03,1.61,1.61,1.61,1.61,0.00,0.00,50000,1,80500,0,0,0,0,0,0,0,50000,-50000,-50000
20200520,06075P,智邦凱基97售02,,,,,0.00,0.00,0,0,0,0,0,0,0,0,0,0,0,0,0
20200520,060760,南亞科元大9A購04,2.27,2.35,2.25,2.35,+0.16,7.31,138000,13,314860,0,0,0,0,0,0,96000,42000,54000,54000
20200520,060761,南亞科元大9A購05,1.23,1.26,1.22,1.22,+0.04,3.39,72000,5,90170,0,0,0,0,0,0,15000,72000,-57000,-57000
20200520,060762,長榮航元大9A購02,2.53,2.53,2.46,2.49,+0.04,1.63,160000,13,399900,0,0,0,0,0,0,130000,20000,110000,110000
20200520,060763,聯鈞元大9A購03,1.22,1.24,1.19,1.20,-0.06,-4.76,322000,11,390810,0,0,0,0,0,0,66000,256000,-190000,-190000
20200520,060764,華擎元大9A購03,1.14,1.27,1.13,1.27,+0.17,15.45,791000,49,957280,0,0,0,0,0,0,355000,540000,-185000,-185000
20200520,060765,世芯元大9A購01,3.50,3.50,3.50,3.50,-0.38,-9.79,1000,1,3500,0,0,0,0,0,0,0,1000,-1000,-1000
20200520,060766,世芯元大9A購02,3.33,3.36,3.25,3.27,-0.05,-1.51,243000,21,803140,0,0,0,0,0,0,241000,0,241000,241000
20200520,060767,世紀鋼元大9A購02,0.97,0.97,0.95,0.95,-0.08,-7.77,14000,2,13380,0,0,0,0,0,0,4000,10000,-6000,-6000
20200520,060768,鴻海麥證9A購02,,,,,0.00,0.00,0,0,0,0,0,0,0,0,0,0,0,0,0
20200520,060769,國巨麥證9A購02,2.85,2.85,2.85,2.85,+0.29,11.33,7000,1,19950,0,7000,-7000,0,0,0,0,7000,-7000,-7000
20200520,06076P,大立光凱基98售03,,,,,0.00,0.00,0,0,0,0,0,0,0,0,0,0,0,0,0
20200520,060770,宏達電麥證9A購01,1.37,1.38,1.37,1.38,+0.05,3.76,76000,6,104380,76000,0,76000,0,0,0,76000,0,76000,76000
20200520,060771,滬深2X凱基9B購02,,,,,0.00,0.00,0,0,0,0,0,0,0,0,0,0,0,0,0
20200520,060772,FBVIX凱基9A購03,,,,,0.00,0.00,0,0,0,0,0,0,0,0,0,0,0,0,0
20200520,060773,FBVIX凱基9A購04,,,,,0.00,0.00,0,0,0,0,0,0,0,0,0,0,0,0,0
20200520,060774,南亞科凱基9A購01,0.99,0.99,0.95,0.95,0.00,0.00,22000,3,21360,0,0,0,0,0,0,10000,12000,-2000,-2000
20200520,060775,世芯凱基9A購02,3.06,3.15,2.87,2.87,-0.28,-8.89,96000,15,290920,0,0,0,0,0,0,86000,10000,76000,76000
20200520,060776,世芯凱基9B購01,2.49,2.54,2.27,2.27,-0.22,-8.84,464000,52,1136670,0,1000,-1000,0,0,0,389000,65000,324000,323000
20200520,060777,茂林凱基9C購01,1.57,1.78,1.57,1.78,+0.29,19.46,643000,27,1066970,0,0,0,0,0,0,17000,620000,-603000,-603000
20200520,060778,臺股指凱基9A購06,2.59,2.65,2.59,2.59,+0.03,1.17,187000,6,485430,0,0,0,0,0,0,182000,5000,177000,177000
20200520,060779,臺股指凱基9A購07,3.29,3.32,3.19,3.25,+0.01,0.31,41000,9,134380,0,0,0,0,0,0,29000,12000,17000,17000
20200520,06077P,GIS凱基97售02,1.62,1.62,1.62,1.62,0.00,0.00,400000,2,648000,0,0,0,0,0,0,0,400000,-400000,-400000
20200520,060780,祥碩國泰9B購01,,,,,0.00,0.00,0,0,0,0,0,0,0,0,0,0,0,0,0
20200520,060781,台郡國泰9B購01,1.64,1.64,1.59,1.64,0.00,0.00,476000,20,775810,0,0,0,0,0,0,267000,209000,58000,58000
20200520,060782,道瓊指富邦9C購01,0.73,0.74,0.73,0.74,-0.03,-3.9,28000,5,20620,0,0,0,0,0,0,0,18000,-18000,-18000
20200520,060783,亞德客富邦9B購01,1.25,1.25,1.17,1.17,+0.01,0.86,124000,6,153470,0,0,0,0,0,0,1000,123000,-122000,-122000
20200520,060784,鴻海富邦9C購01,0.79,0.80,0.76,0.76,-0.03,-3.8,355000,18,282610,0,0,0,0,0,0,98000,254000,-156000,-156000
20200520,060785,國巨富邦9B購04,0.80,0.86,0.80,0.83,+0.08,10.67,117000,9,99610,0,0,0,0,0,0,0,117000,-117000,-117000
20200520,060786,聯發科富邦9B購06,1.86,1.97,1.86,1.97,+0.16,8.84,95000,20,178220,0,0,0,0,0,0,82000,13000,69000,69000
20200520,060787,奇力新富邦9A購01,0.65,0.65,0.65,0.65,0.00,0.00,150000,1,97500,0,0,0,0,0,0,0,150000,-150000,-150000
20200520,060788,嘉晶富邦9B購01,0.99,1.25,0.99,1.16,+0.19,19.59,1628000,49,1747350,0,0,0,0,0,0,148000,1480000,-1332000,-1332000
20200520,060789,禾伸堂富邦9B購02,1.15,1.15,1.15,1.15,0.00,0.00,10000,1,11500,0,0,0,0,0,0,0,10000,-10000,-10000
20200520,06078P,臺股指凱基9A售01,,,,,0.00,0.00,0,0,0,0,0,0,0,0,0,0,0,0,0
20200520,060790,日月光富邦9A購01,0.50,0.50,0.48,0.49,-0.02,-3.92,160000,7,77100,0,0,0,0,0,0,0,150000,-150000,-150000
20200520,060791,聯茂富邦9A購02,0.39,0.39,0.39,0.39,-0.04,-9.3,165000,7,64350,0,0,0,0,0,0,165000,0,165000,165000
20200520,060792,信錦永豐9A購01,1.20,1.23,1.20,1.23,+0.02,1.65,116000,22,139820,0,0,0,0,0,0,116000,0,116000,116000
20200520,060793,微星永豐9A購01,3.13,3.15,3.01,3.01,-0.02,-0.66,115000,12,358210,0,0,0,0,0,0,75000,40000,35000,35000
20200520,060794,景碩永豐9A購02,,,,,0.00,0.00,0,0,0,0,0,0,0,0,0,0,0,0,0
20200520,060795,世芯永豐9A購02,2.48,2.48,2.30,2.30,-0.25,-9.8,135000,5,325990,0,0,0,0,0,0,80000,55000,25000,25000
20200520,060796,世芯永豐9A購03,2.46,2.50,2.22,2.24,-0.24,-9.68,778000,32,1893440,0,0,0,0,0,0,700000,78000,622000,622000
20200520,060797,世芯永豐9A購04,,,,,0.00,0.00,0,0,0,0,0,0,0,0,0,0,0,0,0
20200520,060798,旭富永豐9A購01,0.60,0.61,0.60,0.61,-0.01,-1.61,121000,3,73000,0,0,0,0,0,0,81000,40000,41000,41000
20200520,060799,茂林永豐9A購01,0.97,1.07,0.97,1.07,0.00,0.00,560000,20,574530,0,0,0,0,0,0,0,560000,-560000,-560000
20200520,06079P,燿華群益98售02,,,,,0.00,0.00,0,0,0,0,0,0,0,0,0,0,0,0,0
20200520,060800,華新科第一9A購01,0.86,0.86,0.86,0.86,0.00,0.00,60000,17,51600,0,0,0,0,0,0,60000,0,60000,60000
20200520,060801,滬深2X中信01購01,1.43,1.43,1.43,1.43,-0.06,-4.03,1000,1,1430,0,0,0,0,0,0,1000,0,1000,1000
20200520,060802,道瓊指中信9C購03,0.78,0.79,0.78,0.79,-0.04,-4.82,16000,2,12540,0,0,0,0,0,0,10000,6000,4000,4000
20200520,060803,台灣50群益9A購13,,,,,0.00,0.00,0,0,0,0,0,0,0,0,0,0,0,0,0
20200520,060804,T50反1群益9A購02,0.42,0.42,0.41,0.41,-0.02,-4.65,325000,3,136250,0,0,0,0,0,0,25000,300000,-275000,-275000
20200520,060805,國巨群益9A購06,2.67,2.72,2.67,2.72,0.00,0.00,13000,2,34860,0,0,0,0,0,0,0,13000,-13000,-13000
20200520,060806,華新科群益9A購03,2.09,2.09,1.92,1.92,-0.08,-4.0,67000,2,139520,0,0,0,0,0,0,67000,0,67000,67000
20200520,060807,新光金群益9A購01,0.67,0.69,0.67,0.69,+0.04,6.15,272000,6,184920,0,0,0,0,0,0,0,272000,-272000,-272000
20200520,060808,欣興群益9A購01,2.11,2.19,2.11,2.13,+0.05,2.4,76000,7,163660,0,0,0,0,0,0,36000,40000,-4000,-4000
20200520,060809,康友群益9A購01,1.28,1.28,1.27,1.28,-0.03,-2.29,231000,5,293450,0,0,0,0,0,0,231000,0,231000,231000
20200520,06080P,景碩群益98售02,0.93,0.93,0.93,0.93,-0.52,-35.86,10000,1,9300,0,0,0,0,0,0,10000,0,10000,10000
20200520,060810,滬深2X凱基9B購03,,,,,0.00,0.00,0,0,0,0,0,0,0,0,0,0,0,0,0
20200520,060811,亞德客凱基9A購02,1.74,1.74,1.74,1.74,0.00,0.00,100000,3,174000,0,0,0,0,0,0,0,100000,-100000,-100000
20200520,060812,智邦凱基9A購01,1.85,1.91,1.85,1.89,+0.09,5.0,63000,7,119110,0,0,0,0,0,0,63000,49000,14000,14000
20200520,060813,高鐵凱基9A購01,1.23,1.31,1.23,1.29,+0.07,5.74,159000,26,202970,0,0,0,0,0,0,65000,101000,-36000,-36000
20200520,060814,健策凱基9B購01,1.47,1.53,1.47,1.50,+0.07,4.9,248000,19,368710,0,0,0,0,0,0,92000,248000,-156000,-156000
20200520,060815,茂林凱基9B購01,1.77,1.90,1.75,1.90,+0.30,18.75,543000,18,969380,0,0,0,0,0,0,0,543000,-543000,-543000
20200520,060816,世紀鋼凱基9C購02,0.76,0.76,0.70,0.70,-0.03,-4.11,941000,14,698270,0,0,0,0,0,0,749000,184000,565000,565000
20200520,060817,華邦電台新9A購01,1.14,1.18,1.14,1.16,+0.08,7.41,214000,7,249700,0,0,0,0,0,0,93000,121000,-28000,-28000
20200520,060818,上銀統一9C購01,1.56,1.56,1.50,1.50,-0.05,-3.23,25000,4,38760,0,0,0,0,0,0,10000,15000,-5000,-5000
20200520,060819,國巨統一9C購04,1.04,1.04,0.99,1.00,+0.05,5.26,415000,13,420000,0,0,0,0,0,0,145000,270000,-125000,-125000
20200520,06081P,深中小元大97售02,0.19,0.27,0.19,0.27,-0.03,-10.0,132000,10,25240,0,0,0,0,0,0,0,130000,-130000,-130000
20200520,060820,上証2X元大9A購04,,,,,0.00,0.00,0,0,0,0,0,0,0,0,0,0,0,0,0
20200520,060821,SP黃豆元大9A購02,1.09,1.10,1.09,1.10,-0.01,-0.9,121000,6,132590,0,0,0,0,0,0,76000,45000,31000,31000
20200520,060822,華通元大9A購05,,,,,0.00,0.00,0,0,0,0,0,0,0,0,0,0,0,0,0
20200520,060823,旺宏元大9A購05,1.71,1.76,1.70,1.70,+0.01,0.59,228000,7,392380,0,0,0,0,0,0,138000,90000,48000,48000
20200520,060824,旺宏元大9A購06,2.65,2.69,2.64,2.64,-0.03,-1.12,48000,3,128670,0,0,0,0,0,0,43000,10000,33000,33000
20200520,060825,聯詠元大9A購05,1.56,1.66,1.56,1.59,-0.03,-1.85,337000,19,548190,0,0,0,0,0,0,316000,30000,286000,286000
20200520,060826,牧德元大9B購02,1.51,1.69,1.50,1.68,+0.18,12.0,556000,23,886420,0,0,0,0,0,0,128000,424000,-296000,-296000
20200520,060827,健策元大9A購02,1.68,1.74,1.65,1.74,+0.11,6.75,176000,9,295240,0,0,0,0,0,0,126000,51000,75000,75000
20200520,060828,高股息國票9A購01,,,,,0.00,0.00,0,0,0,0,0,0,0,0,0,0,0,0,0
20200520,060829,T50反1國票9A購06,,,,,0.00,0.00,0,0,0,0,0,0,0,0,0,0,0,0,0
20200520,06082P,華通統一98售01,,,,,0.00,0.00,0,0,0,0,0,0,0,0,0,0,0,0,0
20200520,060830,T50反1國票9A購07,0.54,0.54,0.54,0.54,0.00,0.00,20000,1,10800,0,0,0,0,0,0,0,20000,-20000,-20000
20200520,060831,T50反1國票9B購03,,,,,0.00,0.00,0,0,0,0,0,0,0,0,0,0,0,0,0
20200520,060832,臺指反國票9A購01,,,,,0.00,0.00,0,0,0,0,0,0,0,0,0,0,0,0,0
20200520,060833,道瓊反國票9A購01,0.74,0.74,0.74,0.74,+0.01,1.37,18000,1,13320,0,0,0,0,0,0,18000,0,18000,18000
20200520,060834,道瓊反國票9C購01,1.05,1.05,1.05,1.05,+0.01,0.96,49000,1,51450,0,0,0,0,0,0,49000,0,49000,49000
20200520,060835,亞德客國票9A購01,2.90,2.91,2.90,2.91,+0.08,2.83,16000,2,46410,0,15000,-15000,0,0,0,16000,0,16000,1000
20200520,060836,上銀國票9A購03,,,,,0.00,0.00,0,0,0,0,0,0,0,0,0,0,0,0,0
20200520,060837,上銀國票9A購04,,,,,0.00,0.00,0,0,0,0,0,0,0,0,0,0,0,0,0
20200520,060838,華通國票9A購05,5.70,5.70,5.65,5.65,-0.25,-4.24,4000,2,22750,0,0,0,0,0,0,3000,1000,2000,2000
20200520,060839,聯發科國票9A購02,,,,,0.00,0.00,0,0,0,0,0,0,0,0,0,0,0,0,0
20200520,06083P,華通統一98售02,2.08,2.08,2.08,2.08,+0.05,2.46,2000,2,4160,0,0,0,0,0,0,2000,0,2000,2000
20200520,060840,可成國票9B購01,2.36,2.36,2.36,2.36,0.00,0.00,60000,2,141600,0,0,0,0,0,0,0,60000,-60000,-60000
20200520,060841,宏達電國票9B購01,1.17,1.20,1.15,1.15,+0.04,3.6,107000,6,125850,0,0,0,0,0,0,47000,60000,-13000,-13000
20200520,060842,新光金國票9B購01,,,,,0.00,0.00,0,0,0,0,0,0,0,0,0,0,0,0,0
20200520,060843,大立光國票9A購06,2.44,2.44,2.44,2.44,0.00,0.00,10000,1,24400,0,0,0,0,0,0,0,10000,-10000,-10000
20200520,060844,大立光國票9A購07,2.45,2.45,2.45,2.45,+0.07,2.94,6000,1,14700,0,0,0,0,0,0,0,6000,-6000,-6000
20200520,060845,欣興國票9A購01,4.48,4.69,4.29,4.35,+0.14,3.33,55000,6,248200,0,0,0,0,0,0,40000,23000,17000,17000
20200520,060846,欣興國票9A購02,3.74,3.90,3.63,3.75,+0.12,3.31,395000,11,1469150,0,0,0,0,0,0,203000,192000,11000,11000
20200520,060847,康控國票9A購01,2.72,2.75,2.68,2.73,+0.14,5.41,209000,29,568160,0,0,0,0,0,0,200000,9000,191000,191000
20200520,060848,聯茂國票9A購02,1.56,1.57,1.54,1.57,-0.09,-5.42,34000,4,52850,0,0,0,0,0,0,5000,29000,-24000,-24000
20200520,060849,力成國票9A購01,4.23,4.23,4.07,4.07,-0.26,-6.0,16000,2,66720,0,0,0,0,0,0,6000,10000,-4000,-4000
20200520,06084P,宏達電元富97售02,2.74,2.74,2.74,2.74,0.00,0.00,1000,1,2740,0,0,0,0,0,0,0,1000,-1000,-1000
20200520,060850,康友國票9A購03,2.09,2.09,2.04,2.07,-0.04,-1.9,134000,13,277960,0,0,0,0,0,0,96000,48000,48000,48000
20200520,060851,國巨國泰9C購01,2.48,2.68,2.47,2.53,+0.18,7.66,931000,56,2377490,0,0,0,0,0,0,207000,724000,-517000,-517000
20200520,060852,京鼎國泰9B購01,,,,,0.00,0.00,0,0,0,0,0,0,0,0,0,0,0,0,0
20200520,060853,健策國泰9B購02,1.89,1.91,1.89,1.91,-0.05,-2.55,35000,3,66830,0,0,0,0,0,0,1000,35000,-34000,-34000
20200520,060854,台積電富邦9C購08,0.65,0.65,0.65,0.65,0.00,0.00,310000,3,201500,0,0,0,0,0,0,200000,110000,90000,90000
20200520,060855,華新科富邦01購01,0.63,0.66,0.63,0.63,-0.02,-3.08,502000,22,323720,0,0,0,0,0,0,417000,85000,332000,332000
20200520,060856,健策富邦9B購02,0.70,0.76,0.68,0.75,+0.05,7.14,1236000,28,896800,0,0,0,0,0,0,446000,1009000,-563000,-563000
20200520,060857,旭富富邦9B購01,0.52,0.53,0.52,0.52,0.00,0.00,263000,9,136790,0,0,0,0,0,0,163000,100000,63000,63000
20200520,060858,T50反1永豐9A購01,,,,,0.00,0.00,0,0,0,0,0,0,0,0,0,0,0,0,0
20200520,060859,鴻海永豐9A購01,1.58,1.58,1.58,1.58,0.00,0.00,18000,2,28440,0,0,0,0,0,0,0,18000,-18000,-18000
20200520,06085P,義隆台新97售01,0.28,0.28,0.28,0.28,0.00,0.00,10000,1,2800,0,0,0,0,0,0,0,0,0,0
20200520,060860,國巨永豐9A購02,1.24,1.24,1.24,1.24,0.00,0.00,7000,2,8680,0,0,0,0,0,0,0,7000,-7000,-7000
20200520,060861,漢唐永豐9A購01,1.31,1.31,1.29,1.29,-0.05,-3.73,283000,11,370280,0,0,0,0,0,0,48000,235000,-187000,-187000
20200520,060862,美律永豐9A購01,,,,,0.00,0.00,0,0,0,0,0,0,0,0,0,0,0,0,0
20200520,060863,聯發科永豐9A購02,,,,,0.00,0.00,0,0,0,0,0,0,0,0,0,0,0,0,0
20200520,060864,可成永豐9A購01,1.18,1.18,1.08,1.08,-0.29,-21.17,46000,5,52530,0,0,0,0,0,0,0,46000,-46000,-46000
20200520,060865,創意永豐9A購01,0.90,0.91,0.90,0.91,+0.02,2.25,58000,4,52590,0,0,0,0,0,0,0,58000,-58000,-58000
20200520,060866,世芯永豐9B購01,2.87,2.87,2.87,2.87,-0.33,-10.31,10000,1,28700,0,0,0,0,0,0,10000,0,10000,10000
20200520,060867,智伸科永豐9A購01,1.02,1.07,0.98,1.02,+0.03,3.03,1004000,42,1020470,0,0,0,0,0,0,721000,276000,445000,445000
20200520,060868,致伸永豐9A購01,1.00,1.07,1.00,1.06,+0.02,1.92,105000,4,106090,0,0,0,0,0,0,87000,95000,-8000,-8000
20200520,060869,超眾永豐9A購02,0.90,0.90,0.90,0.90,0.00,0.00,139000,1,125100,0,0,0,0,0,0,0,139000,-139000,-139000
20200520,06086P,台積電康和97售01,,,,,0.00,0.00,0,0,0,0,0,0,0,0,0,0,0,0,0
20200520,060870,旭富群益9A購01,1.58,1.63,1.56,1.56,-0.06,-3.7,121000,3,191730,0,0,0,0,0,0,90000,31000,59000,59000
20200520,060871,台灣50中信01購03,0.90,0.90,0.89,0.89,-0.01,-1.11,65000,4,58350,0,0,0,0,0,0,50000,15000,35000,35000
20200520,060872,高股息中信02購01,,,,,0.00,0.00,0,0,0,0,0,0,0,0,0,0,0,0,0
20200520,060873,道瓊反中信9C購01,0.81,0.81,0.81,0.81,0.00,0.00,19000,1,15390,0,0,0,0,0,0,0,19000,-19000,-19000
20200520,060874,中鋼中信02購01,0.97,0.97,0.97,0.97,+0.01,1.04,28000,25,27160,0,0,0,0,0,0,28000,0,28000,28000
20200520,060875,華通中信02購01,1.45,1.46,1.45,1.46,-0.04,-2.67,10000,2,14550,0,0,0,0,0,0,5000,5000,0,0
20200520,060876,國巨中信9A購04,1.49,1.60,1.49,1.50,+0.13,9.49,225000,9,342300,0,0,0,0,0,0,100000,125000,-25000,-25000
20200520,060877,華邦電中信02購01,0.88,0.89,0.88,0.89,+0.04,4.71,15000,2,13250,0,0,0,0,0,0,0,15000,-15000,-15000
20200520,060878,奇力新中信9C購01,1.23,1.25,1.23,1.25,+0.09,7.76,395000,5,491290,0,0,0,0,0,0,0,395000,-395000,-395000
20200520,060879,華新科中信9A購02,0.86,0.90,0.86,0.87,+0.01,1.16,358000,6,315560,0,0,0,0,0,0,280000,78000,202000,202000
20200520,06087P,國巨永豐97售01,0.88,1.02,0.88,0.96,0.00,0.00,23000,5,21450,0,0,0,0,0,0,1000,22000,-21000,-21000
20200520,060880,中壽中信9C購01,0.71,0.73,0.71,0.72,0.00,0.00,67000,4,48080,0,0,0,0,0,0,17000,50000,-33000,-33000
20200520,060881,玉山金中信02購01,1.22,1.22,1.20,1.20,-0.01,-0.83,102000,11,122440,0,0,0,0,0,0,2000,100000,-98000,-98000
20200520,060882,大立光中信9A購05,,,,,0.00,0.00,0,0,0,0,0,0,0,0,0,0,0,0,0
20200520,060884,超眾中信9B購01,,,,,0.00,0.00,0,0,0,0,0,0,0,0,0,0,0,0,0
20200520,060885,世紀鋼中信9A購01,0.64,0.64,0.58,0.58,-0.04,-6.45,38000,7,23400,0,0,0,0,0,0,23000,15000,8000,8000
20200520,060886,國巨統一01購03,1.73,1.73,1.67,1.71,+0.10,6.21,52000,8,88020,0,0,0,0,0,0,32000,10000,22000,22000
20200520,060887,台積電統一01購01,1.10,1.11,1.09,1.10,+0.01,0.92,87000,5,95700,0,0,0,0,0,0,4000,84000,-80000,-80000
20200520,060888,金像電統一9C購01,1.17,1.20,1.13,1.13,-0.06,-5.04,376000,14,440960,0,0,0,0,0,0,251000,115000,136000,136000
20200520,060889,國泰金統一9C購01,1.36,1.38,1.36,1.36,+0.01,0.74,501000,8,683320,0,0,0,0,0,0,401000,100000,301000,301000
20200520,06088P,建準永豐97售01,,,,,0.00,0.00,0,0,0,0,0,0,0,0,0,0,0,0,0
20200520,060890,大立光統一01購01,0.91,0.95,0.91,0.92,+0.01,1.1,460000,15,427100,0,0,0,0,0,0,200000,260000,-60000,-60000
20200520,060891,世芯統一9A購01,2.65,2.67,2.65,2.66,-0.07,-2.56,53000,4,140860,0,0,0,0,0,0,53000,0,53000,53000
20200520,060892,超眾統一9C購01,,,,,0.00,0.00,0,0,0,0,0,0,0,0,0,0,0,0,0
20200520,060893,台灣50凱基01購07,,,,,0.00,0.00,0,0,0,0,0,0,0,0,0,0,0,0,0
20200520,060894,奇力新凱基9A購03,1.11,1.16,1.11,1.13,+0.05,4.63,186000,8,213140,0,0,0,0,0,0,128000,58000,70000,70000
20200520,060895,華新科凱基9B購05,1.59,1.59,1.54,1.54,+0.04,2.67,20000,2,31300,0,0,0,0,0,0,10000,10000,0,0
20200520,060896,晶技凱基9A購02,1.19,1.24,1.13,1.14,-0.06,-5.0,625000,36,745330,0,0,0,0,0,0,432000,192000,240000,240000
20200520,060897,健策凱基9A購04,1.33,1.44,1.33,1.43,+0.09,6.72,122000,15,170270,0,0,0,0,0,0,75000,52000,23000,23000
20200520,060898,世芯凱基9A購03,2.32,2.38,2.16,2.16,-0.28,-11.48,64000,25,147910,0,0,0,0,0,0,60000,4000,56000,56000
20200520,060899,超眾凱基9A購01,1.13,1.13,1.13,1.13,0.00,0.00,110000,2,124300,0,0,0,0,0,0,0,110000,-110000,-110000
20200520,06089P,矽創永豐97售01,0.77,0.84,0.77,0.84,-0.06,-6.67,114000,3,93050,0,0,0,0,0,0,0,114000,-114000,-114000
20200520,060900,超眾凱基9B購01,1.32,1.32,1.32,1.32,0.00,0.00,68000,1,89760,0,0,0,0,0,0,68000,0,68000,68000
20200520,060901,臺股指凱基9A購13,2.67,2.72,2.57,2.68,+0.04,1.52,94000,10,251990,0,0,0,0,0,0,90000,4000,86000,86000
20200520,060902,上証2X元大9A購05,,,,,0.00,0.00,0,0,0,0,0,0,0,0,0,0,0,0,0
20200520,060903,臺指反元大9A購01,,,,,0.00,0.00,0,0,0,0,0,0,0,0,0,0,0,0,0
20200520,060904,臺指反元大9C購07,,,,,0.00,0.00,0,0,0,0,0,0,0,0,0,0,0,0,0
20200520,060905,台積電元大9A購20,,,,,0.00,0.00,0,0,0,0,0,0,0,0,0,0,0,0,0
20200520,060906,旺宏元大9A購07,3.29,3.29,3.29,3.29,+0.03,0.92,10000,1,32900,0,0,0,0,0,0,0,10000,-10000,-10000
20200520,060907,金像電元大9A購02,3.14,3.20,3.00,3.01,-0.18,-5.64,347000,27,1088730,0,0,0,0,0,0,227000,110000,117000,117000
20200520,060908,金像電元大9A購03,2.66,2.71,2.58,2.58,-0.10,-3.73,342000,28,912160,0,0,0,0,0,0,273000,69000,204000,204000
20200520,060909,金像電元大9B購01,4.73,4.82,4.54,4.54,-0.25,-5.22,120000,12,566950,0,0,0,0,0,0,62000,58000,4000,4000
20200520,06090P,旺宏統一97售06,2.55,2.56,2.55,2.56,-0.04,-1.54,2000,2,5110,0,0,0,0,0,0,0,2000,-2000,-2000
20200520,060910,聯發科元大9A購05,5.30,5.45,5.30,5.45,+0.25,4.81,13000,2,69350,0,0,0,0,0,0,10000,3000,7000,7000
20200520,060911,大毅元大9A購01,2.94,3.06,2.91,2.91,+0.03,1.04,70000,10,208090,0,0,0,0,0,0,16000,54000,-38000,-38000
20200520,060912,華新科元大9A購10,1.70,1.70,1.70,1.70,+0.07,4.29,62000,2,105400,0,0,0,0,0,0,0,62000,-62000,-62000
20200520,060913,宏達電元大9A購03,1.54,1.58,1.54,1.58,+0.06,3.95,171000,10,266060,0,0,0,0,0,0,103000,72000,31000,31000
20200520,060914,健策元大9A購03,1.24,1.29,1.22,1.27,+0.06,4.96,171000,8,214690,0,0,0,0,0,0,161000,111000,50000,50000
20200520,060915,旭富元大9A購01,1.31,1.36,1.29,1.30,-0.03,-2.26,339000,15,449200,0,0,0,0,0,0,145000,214000,-69000,-69000
20200520,060916,金像電國泰9C購01,1.97,2.02,1.88,1.88,-0.11,-5.53,846000,41,1677560,0,0,0,0,0,0,678000,286000,392000,392000
20200520,060917,台表科國泰9B購01,3.60,3.60,3.39,3.42,+0.02,0.59,235000,40,816790,0,0,0,0,0,0,205000,0,205000,205000
20200520,060918,康友國泰9C購01,1.55,1.58,1.52,1.53,-0.06,-3.77,506000,21,790960,0,0,0,0,0,0,170000,361000,-191000,-191000
20200520,060919,滬深2X富邦9B購01,,,,,0.00,0.00,0,0,0,0,0,0,0,0,0,0,0,0,0
20200520,06091P,華新科統一97售01,2.90,2.96,2.88,2.88,-0.12,-4.0,62000,5,182860,0,0,0,0,0,0,5000,57000,-52000,-52000
20200520,060920,超眾富邦9B購01,0.37,0.37,0.37,0.37,0.00,0.00,10000,1,3700,0,0,0,0,0,0,10000,0,10000,10000
20200520,060921,中橡永豐9A購02,0.71,0.71,0.69,0.69,-0.03,-4.17,48000,3,33460,0,0,0,0,0,0,29000,19000,10000,10000
20200520,060922,金像電永豐9A購01,1.36,1.40,1.35,1.37,-0.01,-0.72,328000,14,449630,0,83000,-83000,0,0,0,324000,4000,320000,237000
20200520,060923,全新永豐9A購01,0.91,0.91,0.91,0.91,-0.01,-1.09,10000,1,9100,0,0,0,0,0,0,10000,0,10000,10000
20200520,060924,大毅永豐9A購03,1.24,1.26,1.23,1.24,+0.04,3.33,53000,7,66000,0,0,0,0,0,0,0,53000,-53000,-53000
20200520,060925,華新科永豐9A購01,1.13,1.13,1.13,1.13,+0.04,3.67,3000,1,3390,0,0,0,0,0,0,3000,3000,0,0
20200520,060926,宏達電永豐9A購01,1.19,1.22,1.17,1.17,0.00,0.00,57000,6,68580,0,0,0,0,0,0,3000,57000,-54000,-54000
20200520,060927,嘉晶永豐9A購01,1.96,2.17,1.96,2.03,+0.15,7.98,59000,9,120020,0,0,0,0,0,0,31000,28000,3000,3000
20200520,060928,明泰永豐9A購01,,,,,0.00,0.00,0,0,0,0,0,0,0,0,0,0,0,0,0
20200520,060929,健策永豐9A購01,0.98,1.02,0.98,1.02,-0.08,-7.27,245000,4,245040,0,0,0,0,0,0,129000,131000,-2000,-2000
20200520,06092P,嘉聯益統一97售01,,,,,0.00,0.00,0,0,0,0,0,0,0,0,0,0,0,0,0
20200520,060930,超眾永豐9A購03,0.67,0.67,0.67,0.67,-0.03,-4.29,3000,1,2010,0,0,0,0,0,0,3000,0,3000,3000
20200520,060931,GIS永豐9A購01,,,,,0.00,0.00,0,0,0,0,0,0,0,0,0,0,0,0,0
20200520,060932,南六永豐9A購02,2.11,2.20,2.00,2.17,+0.12,5.85,141000,15,294420,0,0,0,0,0,0,30000,111000,-81000,-81000
20200520,060933,南電永豐9A購02,0.91,0.94,0.84,0.84,-0.08,-8.7,153000,5,140850,0,0,0,0,0,0,134000,19000,115000,115000
20200520,060934,台汽電永豐9A購02,1.05,1.05,1.04,1.05,-0.05,-4.55,22000,5,23080,0,0,0,0,0,0,17000,5000,12000,12000
20200520,060935,T50反1國票9A購08,,,,,0.00,0.00,0,0,0,0,0,0,0,0,0,0,0,0,0
20200520,060936,T50反1國票9A購09,0.83,0.83,0.83,0.83,0.00,0.00,4000,1,3320,0,0,0,0,0,0,0,4000,-4000,-4000
20200520,060937,T50反1國票9A購10,0.61,0.62,0.59,0.61,-0.01,-1.61,1740000,15,1046910,0,0,0,0,0,0,11000,1729000,-1718000,-1718000
20200520,060938,臺指反國票9B購03,,,,,0.00,0.00,0,0,0,0,0,0,0,0,0,0,0,0,0
20200520,060939,鴻海國票9A購06,2.19,2.19,2.19,2.19,-0.04,-1.79,20000,1,43800,0,0,0,0,0,0,20000,0,20000,20000
20200520,06093P,華通元富97售03,,,,,0.00,0.00,0,0,0,0,0,0,0,0,0,0,0,0,0
20200520,060940,國巨國票9B購03,4.22,4.22,4.06,4.08,+0.29,7.65,10000,4,40880,0,0,0,0,0,0,8000,4000,4000,4000
20200520,060941,台積電國票9B購04,3.23,3.23,3.23,3.23,+0.05,1.57,18000,2,58140,0,0,0,0,0,0,0,18000,-18000,-18000
20200520,060942,智邦國票9A購02,3.13,3.26,3.07,3.23,+0.17,5.56,732000,14,2338090,0,0,0,0,0,0,362000,366000,-4000,-4000
20200520,060943,宏達電國票9B購02,2.03,2.12,2.03,2.12,+0.12,6.0,43000,3,89390,0,0,0,0,0,0,15000,28000,-13000,-13000
20200520,060944,國泰金國票9A購01,1.73,1.73,1.73,1.73,0.00,0.00,76000,2,131480,0,0,0,0,0,0,76000,0,76000,76000
20200520,060945,緯穎國票9A購02,5.45,5.70,5.10,5.10,-0.20,-3.77,11000,3,58950,0,0,0,0,0,0,8000,8000,0,0
20200520,060946,世紀鋼國票9A購02,1.88,1.97,1.80,1.80,-0.11,-5.76,45000,4,86750,0,0,0,0,0,0,0,45000,-45000,-45000
20200520,060947,台積電統一9C購03,1.19,1.19,1.19,1.19,+0.01,0.85,1000,1,1190,0,0,0,0,0,0,1000,1000,0,0
20200520,060948,可成第一9A購01,0.68,0.68,0.68,0.68,-0.09,-11.69,110000,2,74800,0,0,0,0,0,0,0,110000,-110000,-110000
20200520,060949,祥碩中信9A購01,2.14,2.30,2.07,2.30,+0.31,15.58,134000,11,292760,0,0,0,0,0,0,110000,24000,86000,86000
20200520,06094P,台達電中信97售01,,,,,0.00,0.00,0,0,0,0,0,0,0,0,0,0,0,0,0
20200520,060950,T50反1群益9A購03,,,,,0.00,0.00,0,0,0,0,0,0,0,0,0,0,0,0,0
20200520,060951,元黃金群益9A購01,,,,,0.00,0.00,0,0,0,0,0,0,0,0,0,0,0,0,0
20200520,060952,滬深2X群益9C購05,,,,,0.00,0.00,0,0,0,0,0,0,0,0,0,0,0,0,0
20200520,060953,富邦金群益9A購01,1.55,1.60,1.54,1.59,+0.02,1.27,406000,16,639680,0,0,0,0,0,0,307000,24000,283000,283000
20200520,060954,國泰金群益9A購02,1.25,1.27,1.25,1.26,-0.02,-1.56,370000,7,466690,0,0,0,0,0,0,194000,176000,18000,18000
20200520,060955,大立光群益9A購02,1.21,1.25,1.21,1.25,-0.06,-4.58,64000,2,77720,0,0,0,0,0,0,57000,7000,50000,50000
20200520,060956,超眾群益9A購01,,,,,0.00,0.00,0,0,0,0,0,0,0,0,0,0,0,0,0
20200520,060957,SP黃豆凱基9A購04,1.00,1.02,1.00,1.02,0.00,0.00,41000,2,41020,0,0,0,0,0,0,40000,1000,39000,39000
20200520,060958,儒鴻凱基9A購02,0.69,0.71,0.67,0.71,+0.01,1.43,412000,10,283640,0,0,0,0,0,0,377000,65000,312000,312000
20200520,060959,金像電凱基9A購01,1.54,1.58,1.46,1.47,-0.08,-5.16,619000,41,942580,0,0,0,0,0,0,163000,430000,-267000,-267000
20200520,06095P,燿華永豐97售01,,,,,0.00,0.00,0,0,0,0,0,0,0,0,0,0,0,0,0
20200520,060960,金像電凱基9B購01,1.97,2.03,1.90,1.90,-0.12,-5.94,653000,23,1299520,0,0,0,0,0,0,522000,103000,419000,419000
20200520,060961,台光電凱基9A購03,1.41,1.45,1.39,1.44,-0.01,-0.69,133000,22,188930,0,0,0,0,0,0,123000,10000,113000,113000
20200520,060962,義隆凱基9B購01,0.58,0.60,0.58,0.58,0.00,0.00,440000,4,259400,0,0,0,0,0,0,410000,30000,380000,380000
20200520,060963,禾伸堂凱基9A購01,1.60,1.61,1.60,1.61,-0.01,-0.62,155000,5,249400,0,0,0,0,0,0,135000,20000,115000,115000
20200520,060964,日月光凱基9A購01,0.79,0.80,0.79,0.80,0.00,0.00,52000,2,41200,0,0,0,0,0,0,0,52000,-52000,-52000
20200520,060965,中租凱基9B購01,1.06,1.06,1.05,1.06,+0.02,1.92,562000,5,595520,0,0,0,0,0,0,559000,23000,536000,536000
20200520,060966,台表科凱基9B購01,1.90,2.38,1.90,2.36,+0.45,23.56,1028000,77,2082630,0,0,0,0,0,0,932000,624000,308000,308000
20200520,060967,鈺齊凱基9A購02,1.15,1.17,1.14,1.15,+0.03,2.68,308000,13,356870,0,0,0,0,0,0,173000,136000,37000,37000
20200520,060968,台灣50元大9C購28,,,,,0.00,0.00,0,0,0,0,0,0,0,0,0,0,0,0,0
20200520,060969,台灣50元大9C購29,,,,,0.00,0.00,0,0,0,0,0,0,0,0,0,0,0,0,0
20200520,06096P,全新永豐97售02,1.42,1.65,1.42,1.63,+0.13,8.67,176000,13,270100,0,0,0,0,0,0,45000,131000,-86000,-86000
20200520,060970,T50反1元大9A購08,,,,,0.00,0.00,0,0,0,0,0,0,0,0,0,0,0,0,0
20200520,060971,T50反1元大9A購09,,,,,0.00,0.00,0,0,0,0,0,0,0,0,0,0,0,0,0
20200520,060972,T50反1元大9A購10,1.23,1.23,1.23,1.23,0.00,0.00,2000,1,2460,0,0,0,0,0,0,0,2000,-2000,-2000
20200520,060973,T50反1元大9A購11,,,,,0.00,0.00,0,0,0,0,0,0,0,0,0,0,0,0,0
20200520,060974,滬深2X元大01購01,,,,,0.00,0.00,0,0,0,0,0,0,0,0,0,0,0,0,0
20200520,060975,滬深2X元大01購02,,,,,0.00,0.00,0,0,0,0,0,0,0,0,0,0,0,0,0
20200520,060976,SP黃豆元大9A購03,0.75,0.75,0.75,0.75,-0.02,-2.6,55000,1,41250,0,0,0,0,0,0,55000,0,55000,55000
20200520,060977,亞德客元大9A購04,3.88,3.88,3.68,3.71,-0.18,-4.63,130000,9,485300,0,0,0,0,0,0,30000,100000,-70000,-70000
20200520,060978,國巨元大9A購13,2.78,2.82,2.70,2.71,0.00,0.00,62000,10,170630,0,0,0,0,0,0,0,62000,-62000,-62000
20200520,060979,國巨元大9A購14,2.01,2.01,2.01,2.01,0.00,0.00,25000,1,50250,0,0,0,0,0,0,0,25000,-25000,-25000
20200520,06097P,茂林永豐97售01,,,,,0.00,0.00,0,0,0,0,0,0,0,0,0,0,0,0,0
20200520,060980,台積電元大9A購21,,,,,0.00,0.00,0,0,0,0,0,0,0,0,0,0,0,0,0
20200520,060981,旺宏元大9A購08,2.70,2.70,2.70,2.70,-0.04,-1.46,25000,5,67500,0,0,0,0,0,0,25000,25000,0,0
20200520,060982,旺宏元大9A購09,2.97,2.97,2.97,2.97,0.00,0.00,25000,2,74250,0,0,0,0,0,0,0,25000,-25000,-25000
20200520,060983,南亞科元大9A購06,2.23,2.31,2.21,2.25,+0.09,4.17,102000,10,229060,0,0,0,0,0,0,69000,36000,33000,33000
20200520,060984,南亞科元大9A購07,2.32,2.36,2.28,2.28,+0.10,4.59,88000,6,205390,0,0,0,0,0,0,31000,78000,-47000,-47000
20200520,060985,聯發科元大9A購06,5.90,5.90,5.90,5.90,+0.25,4.42,40000,2,236000,0,0,0,0,0,0,10000,30000,-20000,-20000
20200520,060986,聯發科元大9A購07,3.01,3.17,3.00,3.06,+0.13,4.44,55000,7,167840,0,0,0,0,0,0,52000,3000,49000,49000
20200520,060987,華新科元大9A購11,1.66,1.71,1.63,1.70,+0.04,2.41,165000,13,276550,0,0,0,0,0,0,115000,50000,65000,65000
20200520,060988,華新科元大9A購12,1.19,1.20,1.16,1.20,+0.07,6.19,85000,7,100450,0,0,0,0,0,0,0,85000,-85000,-85000
20200520,060989,國泰金元大9A購02,2.24,2.30,2.24,2.30,+0.06,2.68,190000,12,430160,0,0,0,0,0,0,168000,22000,146000,146000
20200520,06098P,T50反1日盛97售02,,,,,0.00,0.00,0,0,0,0,0,0,0,0,0,0,0,0,0
20200520,060990,新光金元大9B購03,1.31,1.33,1.31,1.33,+0.01,0.76,138000,6,181340,0,0,0,0,0,0,110000,28000,82000,82000
20200520,060991,京鼎元大9A購01,2.38,2.39,2.38,2.39,-0.03,-1.24,93000,3,221770,0,0,0,0,0,0,0,93000,-93000,-93000
20200520,060992,健策元大9A購05,1.33,1.38,1.27,1.38,-0.07,-4.83,368000,14,485920,0,0,0,0,0,0,137000,242000,-105000,-105000
20200520,060993,健策元大9B購03,1.18,1.25,1.18,1.23,-0.09,-6.82,153000,7,186420,0,0,0,0,0,0,90000,63000,27000,27000
20200520,060994,世芯元大9A購03,4.24,4.24,4.03,4.03,-0.19,-4.5,94000,15,393150,0,0,0,0,0,0,94000,0,94000,94000
20200520,060995,泰鼎元大9A購03,2.70,2.90,2.55,2.90,+0.21,7.81,853000,68,2299600,0,0,0,0,0,0,461000,415000,46000,46000
20200520,060996,臻鼎元大9A購01,2.68,2.87,2.68,2.87,+0.21,7.89,146000,6,416520,0,0,0,0,0,0,10000,136000,-126000,-126000
20200520,060997,上銀兆豐9B購01,,,,,0.00,0.00,0,0,0,0,0,0,0,0,0,0,0,0,0
20200520,060998,華通兆豐9A購01,0.99,1.05,0.99,1.04,0.00,0.00,27000,6,27690,0,0,0,0,0,0,10000,17000,-7000,-7000
20200520,060999,國巨兆豐9A購01,2.36,2.40,2.26,2.28,+0.18,8.57,62000,8,145000,0,0,0,0,0,0,0,62000,-62000,-62000
20200520,06099P,鴻海日盛97售03,4.25,4.25,4.25,4.25,0.00,0.00,10000,2,42500,0,0,0,0,0,0,0,10000,-10000,-10000
20200520,061000,旺宏兆豐9A購02,,,,,0.00,0.00,0,0,0,0,0,0,0,0,0,0,0,0,0
20200520,061001,智邦兆豐9B購01,1.43,1.50,1.43,1.49,+0.06,4.2,98000,11,143400,0,0,0,0,0,0,13000,85000,-72000,-72000
20200520,061002,瑞昱兆豐9B購01,1.66,1.72,1.58,1.64,-0.14,-7.87,113000,9,186530,0,0,0,0,0,0,101000,12000,89000,89000
20200520,061003,南亞科兆豐9A購01,1.33,1.33,1.29,1.29,0.00,0.00,87000,2,112590,0,0,0,0,0,0,0,87000,-87000,-87000
20200520,061004,友達兆豐9A購01,1.27,1.28,1.26,1.26,0.00,0.00,42000,5,53610,0,0,0,0,0,0,0,42000,-42000,-42000
20200520,061005,可成兆豐9A購01,1.11,1.11,1.05,1.06,-0.14,-11.67,103000,8,110530,0,0,0,0,0,0,23000,91000,-68000,-68000
20200520,061006,新光金兆豐9A購01,0.73,0.75,0.73,0.75,+0.02,2.74,198000,9,145110,0,0,0,0,0,0,161000,37000,124000,124000
20200520,061007,聯詠兆豐9A購01,1.02,1.05,1.00,1.04,-0.03,-2.8,345000,27,351460,0,0,0,0,0,0,193000,132000,61000,61000
20200520,061008,群創兆豐9A購02,0.88,0.88,0.88,0.88,-0.05,-5.38,4000,1,3520,0,0,0,0,0,0,4000,0,4000,4000
20200520,061009,台灣50麥證02購02,,,,,0.00,0.00,0,0,0,0,0,0,0,0,0,0,0,0,0
20200520,06100P,台積電日盛97售03,1.49,1.95,1.49,1.53,-0.18,-10.53,80000,9,130500,0,0,0,0,0,0,40000,60000,-20000,-20000
20200520,061010,上銀麥證9A購02,3.10,3.10,3.10,3.10,-0.16,-4.91,5000,1,15500,0,5000,-5000,0,0,0,0,5000,-5000,-5000
20200520,061011,華通麥證9A購02,1.57,1.58,1.55,1.55,-0.02,-1.27,78000,5,121120,0,78000,-78000,0,0,0,0,78000,-78000,-78000
20200520,061012,國巨麥證9A購03,2.04,2.04,1.97,1.97,+0.14,7.65,7000,2,14070,0,7000,-7000,0,0,0,0,7000,-7000,-7000
20200520,061013,台積電麥證9A購03,1.70,1.70,1.64,1.64,-0.04,-2.38,23000,3,38310,9000,14000,-5000,0,0,0,9000,14000,-5000,-5000
20200520,061014,台積電麥證9A購04,,,,,0.00,0.00,0,0,0,0,0,0,0,0,0,0,0,0,0
20200520,061015,旺宏麥證9A購03,2.43,2.43,2.37,2.37,+0.01,0.42,15000,2,36150,10000,5000,5000,0,0,0,10000,5000,5000,5000
20200520,061016,可成麥證9A購01,,,,,0.00,0.00,0,0,0,0,0,0,0,0,0,0,0,0,0
20200520,061017,國泰金麥證9A購01,1.41,1.41,1.41,1.41,0.00,0.00,46000,4,64860,46000,0,46000,0,0,0,46000,0,46000,46000
20200520,061018,台積電國票9B購05,3.56,3.57,3.56,3.57,-0.01,-0.28,2000,2,7130,0,0,0,0,0,0,2000,2000,0,0
20200520,061019,大毅國票9A購01,3.34,3.61,3.26,3.26,-0.19,-5.51,21000,3,70280,0,0,0,0,0,0,21000,0,21000,21000
20200520,06101P,聯發科日盛97售03,,,,,0.00,0.00,0,0,0,0,0,0,0,0,0,0,0,0,0
20200520,061020,超眾國票9A購02,,,,,0.00,0.00,0,0,0,0,0,0,0,0,0,0,0,0,0
20200520,061021,聯電國泰9B購01,1.26,1.27,1.20,1.20,-0.02,-1.64,317000,5,396630,0,0,0,0,0,0,157000,210000,-53000,-53000
20200520,061022,健策國泰9B購03,2.14,2.26,2.10,2.26,-0.11,-4.64,625000,23,1360640,0,0,0,0,0,0,171000,604000,-433000,-433000
20200520,061023,茂林國泰9B購02,2.41,2.78,2.41,2.78,+0.37,15.35,373000,16,987420,0,0,0,0,0,0,104000,233000,-129000,-129000
20200520,061024,南電國泰9B購01,1.56,1.62,1.40,1.45,-0.06,-3.97,1086000,38,1602750,0,0,0,0,0,0,517000,560000,-43000,-43000
20200520,061025,創意富邦9B購01,0.61,0.63,0.60,0.63,+0.01,1.61,312000,7,193120,0,0,0,0,0,0,312000,0,312000,312000
20200520,061026,南電富邦9B購01,0.52,0.52,0.49,0.49,-0.02,-3.92,171000,10,85020,0,0,0,0,0,0,36000,135000,-99000,-99000
20200520,061027,儒鴻永豐9A購02,0.65,0.66,0.65,0.66,-0.03,-4.35,58000,5,37940,0,0,0,0,0,0,14000,44000,-30000,-30000
20200520,061028,聚陽永豐9A購01,0.85,0.85,0.80,0.84,0.00,0.00,263000,28,220970,0,0,0,0,0,0,158000,85000,73000,73000
20200520,061029,力山永豐9A購01,2.29,2.31,2.28,2.28,-0.06,-2.56,60000,3,137650,0,0,0,0,0,0,25000,35000,-10000,-10000
20200520,06102P,智邦凱基97售03,0.17,0.17,0.17,0.17,0.00,0.00,450000,6,76500,0,0,0,0,0,0,0,450000,-450000,-450000
20200520,061030,喬山永豐9A購01,1.31,1.32,1.31,1.32,+0.11,9.09,80000,2,105190,0,0,0,0,0,0,0,80000,-80000,-80000
20200520,061031,神隆永豐9A購02,0.90,0.90,0.89,0.89,-0.02,-2.2,57000,2,51290,0,0,0,0,0,0,0,57000,-57000,-57000
20200520,061032,金像電永豐9A購03,1.12,1.16,1.06,1.06,-0.10,-8.62,1052000,22,1153390,0,0,0,0,0,0,408000,644000,-236000,-236000
20200520,061033,台光電永豐9A購01,0.93,0.95,0.92,0.93,-0.03,-3.12,278000,5,256340,0,0,0,0,0,0,267000,11000,256000,256000
20200520,061034,晶豪科永豐9A購01,1.49,1.49,1.40,1.40,-0.12,-7.89,324000,12,466430,0,0,0,0,0,0,309000,15000,294000,294000
20200520,061035,亞光永豐9A購01,0.79,0.79,0.79,0.79,+0.04,5.33,13000,1,10270,0,0,0,0,0,0,0,13000,-13000,-13000
20200520,061036,晶技永豐9A購03,0.88,0.89,0.84,0.84,-0.04,-4.55,32000,5,27970,0,0,0,0,0,0,16000,16000,0,0
20200520,061037,嘉澤永豐9A購01,1.96,1.96,1.87,1.92,+0.03,1.59,233000,11,450230,0,0,0,0,0,0,145000,88000,57000,57000
20200520,061038,TPK永豐9A購01,0.70,0.74,0.70,0.72,+0.01,1.41,249000,9,180800,0,0,0,0,0,0,249000,0,249000,249000
20200520,061039,台表科永豐9A購03,1.48,1.70,1.48,1.70,+0.23,15.65,208000,7,312160,0,0,0,0,0,0,202000,6000,196000,196000
20200520,06103P,漢唐凱基97售02,,,,,0.00,0.00,0,0,0,0,0,0,0,0,0,0,0,0,0
20200520,061040,康友永豐9A購01,0.63,0.63,0.63,0.63,-0.01,-1.56,68000,1,42840,0,0,0,0,0,0,68000,0,68000,68000
20200520,061041,南電永豐9A購03,0.67,0.67,0.65,0.67,-0.03,-4.29,177000,7,116190,0,0,0,0,0,0,177000,0,177000,177000
20200520,061042,致新永豐9A購02,1.19,1.19,1.12,1.15,+0.05,4.55,409000,13,467470,0,0,0,0,0,0,157000,252000,-95000,-95000
20200520,061043,百和永豐9A購01,0.87,0.92,0.84,0.91,+0.04,4.6,364000,6,326070,0,0,0,0,0,0,98000,266000,-168000,-168000
20200520,061044,世紀鋼永豐9A購02,0.92,0.92,0.92,0.92,-0.14,-13.21,1000,1,920,0,0,0,0,0,0,0,1000,-1000,-1000
20200520,061045,儒鴻第一9A購01,,,,,0.00,0.00,0,0,0,0,0,0,0,0,0,0,0,0,0
20200520,061046,上銀第一9A購01,,,,,0.00,0.00,0,0,0,0,0,0,0,0,0,0,0,0,0
20200520,061047,大立光第一9A購01,,,,,0.00,0.00,0,0,0,0,0,0,0,0,0,0,0,0,0
20200520,061048,國巨中信9A購05,0.85,0.85,0.82,0.82,0.00,0.00,48000,13,40010,0,0,0,0,0,0,10000,37000,-27000,-27000
20200520,061049,奇力新中信9A購02,0.67,0.69,0.67,0.69,0.00,0.00,190000,3,129300,0,0,0,0,0,0,0,190000,-190000,-190000
20200520,06104P,大立光凱基97售04,,,,,0.00,0.00,0,0,0,0,0,0,0,0,0,0,0,0,0
20200520,061050,康友中信9A購01,0.68,0.69,0.66,0.66,-0.03,-4.35,84000,3,56750,0,0,0,0,0,0,41000,43000,-2000,-2000
20200520,061051,臺股指中信9A購06,,,,,0.00,0.00,0,0,0,0,0,0,0,0,0,0,0,0,0
20200520,061052,和大群益9A購01,1.83,2.10,1.82,2.10,+0.19,9.95,858000,31,1679570,0,0,0,0,0,0,325000,570000,-245000,-245000
20200520,061053,國巨群益9A購08,2.50,2.50,2.36,2.36,0.00,0.00,44000,7,107330,0,0,0,0,0,0,20000,24000,-4000,-4000
20200520,061054,台積電群益9A購04,2.19,2.19,2.17,2.17,0.00,0.00,11000,2,23890,0,0,0,0,0,0,1000,11000,-10000,-10000
20200520,061055,康控群益9A購01,1.51,1.51,1.42,1.42,-0.02,-1.39,620000,27,909580,0,0,0,0,0,0,620000,0,620000,620000
20200520,061056,臺指反國票02購01,1.36,1.36,1.36,1.36,-0.02,-1.45,10000,1,13600,0,0,0,0,0,0,0,10000,-10000,-10000
20200520,061057,華新科國票9A購04,5.90,5.90,5.90,5.90,+0.60,11.32,10000,1,59000,0,0,0,0,0,0,0,10000,-10000,-10000
20200520,061058,健策國票9A購05,4.34,4.54,4.34,4.54,+0.22,5.09,21000,7,93600,0,0,0,0,0,0,9000,12000,-3000,-3000
20200520,061059,世芯國票9B購01,7.20,7.50,6.90,6.90,-0.60,-8.0,105000,6,773600,0,0,0,0,0,0,105000,0,105000,105000
20200520,06105P,國巨國票98售02,3.33,3.33,3.33,3.33,-0.55,-14.18,5000,1,16650,0,0,0,0,0,0,5000,0,5000,5000
20200520,061060,台灣50麥證9B購01,,,,,0.00,0.00,0,0,0,0,0,0,0,0,0,0,0,0,0
20200520,061061,聯發科麥證9A購02,,,,,0.00,0.00,0,0,0,0,0,0,0,0,0,0,0,0,0
20200520,061062,和大凱基9A購02,1.38,1.61,1.38,1.60,+0.16,11.11,285000,14,432800,0,0,0,0,0,0,97000,188000,-91000,-91000
20200520,061063,國巨凱基9A購14,,,,,0.00,0.00,0,0,0,0,0,0,0,0,0,0,0,0,0
20200520,061064,可成凱基9B購02,1.17,1.17,1.13,1.13,-0.16,-12.4,40000,2,45600,0,0,0,0,0,0,0,40000,-40000,-40000
20200520,061065,神基凱基9A購01,0.75,0.75,0.74,0.74,-0.03,-3.9,72000,3,53300,0,0,0,0,0,0,0,72000,-72000,-72000
20200520,061066,嘉晶凱基9B購01,1.16,1.45,1.16,1.37,+0.22,19.13,1197000,83,1544310,0,0,0,0,0,0,245000,970000,-725000,-725000
20200520,061067,貿聯凱基9A購03,1.07,1.08,1.07,1.07,-0.01,-0.93,69000,5,74090,0,0,0,0,0,0,62000,7000,55000,55000
20200520,061068,祥碩凱基9B購01,2.41,2.46,2.41,2.46,+0.17,7.42,5000,3,12150,0,0,0,0,0,0,2000,3000,-1000,-1000
20200520,061069,嘉聯益凱基9A購01,0.78,0.78,0.78,0.78,+0.01,1.3,20000,1,15600,0,0,0,0,0,0,20000,0,20000,20000
20200520,06106P,國巨群益97售02,2.53,2.53,2.53,2.53,-0.35,-12.15,10000,1,25300,0,0,0,0,0,0,10000,10000,0,0
20200520,061070,超眾凱基9C購01,,,,,0.00,0.00,0,0,0,0,0,0,0,0,0,0,0,0,0
20200520,061071,復盛凱基9A購01,1.02,1.35,1.02,1.35,+0.34,33.66,1229000,106,1421060,0,0,0,0,0,0,281000,778000,-497000,-497000
20200520,061072,南電凱基9B購01,0.76,0.76,0.75,0.75,-0.04,-5.06,42000,2,31820,0,0,0,0,0,0,32000,10000,22000,22000
20200520,061073,T50反1兆豐9A購01,,,,,0.00,0.00,0,0,0,0,0,0,0,0,0,0,0,0,0
20200520,061074,儒鴻兆豐9B購01,0.84,0.85,0.82,0.85,+0.01,1.19,117000,12,98550,0,0,0,0,0,0,96000,21000,75000,75000
20200520,061075,亞德客兆豐9A購01,1.50,1.50,1.50,1.50,+0.04,2.74,30000,1,45000,0,0,0,0,0,0,0,30000,-30000,-30000
20200520,061076,台達電兆豐9A購01,1.27,1.27,1.22,1.22,-0.03,-2.4,436000,31,546680,0,0,0,0,0,0,356000,80000,276000,276000
20200520,061077,國巨兆豐9B購01,1.15,1.25,1.15,1.20,+0.11,10.09,300000,20,359880,0,0,0,0,0,0,199000,101000,98000,98000
20200520,061078,台積電兆豐9A購01,1.18,1.19,1.18,1.19,-0.01,-0.83,91000,3,108140,0,0,0,0,0,0,15000,76000,-61000,-61000
20200520,061079,台積電兆豐9A購02,,,,,0.00,0.00,0,0,0,0,0,0,0,0,0,0,0,0,0
20200520,06107P,美律群益98售02,,,,,0.00,0.00,0,0,0,0,0,0,0,0,0,0,0,0,0
20200520,061080,華邦電兆豐9B購01,0.93,0.96,0.93,0.96,+0.08,9.09,39000,2,36300,0,0,0,0,0,0,38000,1000,37000,37000
20200520,061081,宏碁兆豐9A購01,0.86,0.87,0.84,0.84,-0.04,-4.55,193000,5,163830,0,0,0,0,0,0,138000,55000,83000,83000
20200520,061082,台光電兆豐9A購01,1.44,1.44,1.44,1.44,-0.08,-5.26,49000,2,70560,0,0,0,0,0,0,49000,0,49000,49000
20200520,061083,京元電兆豐9A購01,0.55,0.56,0.54,0.54,-0.05,-8.47,208000,5,114300,0,0,0,0,0,0,8000,200000,-192000,-192000
20200520,061084,京元電兆豐9A購02,0.58,0.60,0.56,0.57,-0.06,-9.52,1209000,23,691980,0,0,0,0,0,0,700000,489000,211000,211000
20200520,061085,聯茂兆豐9A購01,0.39,0.39,0.39,0.39,-0.01,-2.5,216000,27,84240,0,0,0,0,0,0,216000,0,216000,216000
20200520,061086,FBVIX統一01購01,,,,,0.00,0.00,0,0,0,0,0,0,0,0,0,0,0,0,0
20200520,061087,國巨統一01購04,1.16,1.22,1.14,1.17,+0.08,7.34,553000,52,654060,0,0,0,0,0,0,110000,443000,-333000,-333000
20200520,061088,國巨統一9C購05,1.20,1.20,1.20,1.20,+0.11,10.09,5000,1,6000,0,0,0,0,0,0,0,5000,-5000,-5000
20200520,061089,台積電統一9C購04,,,,,0.00,0.00,0,0,0,0,0,0,0,0,0,0,0,0,0
20200520,06108P,奇力新群益97售05,,,,,0.00,0.00,0,0,0,0,0,0,0,0,0,0,0,0,0
20200520,061090,奇力新統一9C購01,,,,,0.00,0.00,0,0,0,0,0,0,0,0,0,0,0,0,0
20200520,061091,奇力新統一9C購02,0.69,0.71,0.68,0.68,+0.02,3.03,312000,10,214460,0,0,0,0,0,0,32000,280000,-248000,-248000
20200520,061092,可成統一9C購02,0.96,0.96,0.92,0.92,-0.09,-8.91,99000,10,91790,0,0,0,0,0,0,42000,64000,-22000,-22000
20200520,061093,華新科統一9B購03,,,,,0.00,0.00,0,0,0,0,0,0,0,0,0,0,0,0,0
20200520,061094,彩晶統一9B購02,0.73,0.73,0.70,0.70,-0.03,-4.11,457000,6,326710,0,0,0,0,0,0,292000,165000,127000,127000
20200520,061095,台積電台新9B購03,0.84,0.85,0.82,0.83,0.00,0.00,104000,6,86640,0,0,0,0,0,0,80000,2000,78000,78000
20200520,061096,上証2X元大9A購06,,,,,0.00,0.00,0,0,0,0,0,0,0,0,0,0,0,0,0
20200520,061097,上証2X元大9A購07,,,,,0.00,0.00,0,0,0,0,0,0,0,0,0,0,0,0,0
20200520,061098,滬深2X元大9A購06,,,,,0.00,0.00,0,0,0,0,0,0,0,0,0,0,0,0,0
20200520,061099,滬深2X元大9A購07,,,,,0.00,0.00,0,0,0,0,0,0,0,0,0,0,0,0,0
20200520,06109P,華新科群益97售05,,,,,0.00,0.00,0,0,0,0,0,0,0,0,0,0,0,0,0
20200520,061100,SP黃豆元大9A購04,0.52,0.52,0.51,0.52,-0.01,-1.89,375000,6,194980,0,0,0,0,0,0,2000,373000,-371000,-371000
20200520,061101,道瓊銀元大9A購02,1.92,1.97,1.92,1.96,+0.27,15.98,266000,11,520000,0,0,0,0,0,0,160000,216000,-56000,-56000
20200520,061102,台積電元大9A購22,1.59,1.59,1.55,1.55,-0.04,-2.52,15000,2,23650,0,0,0,0,0,0,15000,0,15000,15000
20200520,061103,聯發科元大9A購08,6.65,6.65,6.65,6.65,+0.40,6.4,5000,1,33250,0,0,0,0,0,0,5000,0,5000,5000
20200520,061104,華新科元大9A購13,1.69,1.75,1.69,1.75,+0.13,8.02,155000,9,268200,0,0,0,0,0,0,155000,0,155000,155000
20200520,061105,宏達電元大9A購04,1.48,1.53,1.48,1.52,+0.04,2.7,328000,18,496300,0,0,0,0,0,0,310000,22000,288000,288000
20200520,061106,群創元大9B購09,1.29,1.32,1.28,1.31,+0.01,0.77,200000,12,260100,0,0,0,0,0,0,200000,0,200000,200000
20200520,061107,世芯元大9A購05,4.13,4.13,4.09,4.09,+0.06,1.49,14000,2,57420,0,0,0,0,0,0,14000,0,14000,14000
20200520,061108,臻鼎元大9A購02,1.71,1.82,1.69,1.82,+0.14,8.33,510000,23,904200,0,0,0,0,0,0,117000,407000,-290000,-290000
20200520,061109,臻鼎元大9A購03,1.75,1.88,1.75,1.88,+0.15,8.67,355000,12,659040,0,0,0,0,0,0,23000,332000,-309000,-309000
20200520,06110P,國巨國泰98售02,,,,,0.00,0.00,0,0,0,0,0,0,0,0,0,0,0,0,0
20200520,061110,超眾元大9A購03,1.92,1.96,1.89,1.96,+0.05,2.62,115000,4,222360,0,0,0,0,0,0,14000,115000,-101000,-101000
20200520,061111,台表科元大9A購02,2.53,2.82,2.36,2.82,+0.48,20.51,319000,29,792240,0,0,0,0,0,0,280000,45000,235000,235000
20200520,061112,台表科元大9A購03,3.41,3.91,3.17,3.76,+0.61,19.37,314000,33,1074780,0,0,0,0,0,0,179000,218000,-39000,-39000
20200520,061113,南電元大9A購03,1.48,1.52,1.44,1.52,+0.07,4.83,139000,5,206460,0,0,0,0,0,0,71000,68000,3000,3000
20200520,061114,南電元大9A購04,1.09,1.18,1.03,1.06,-0.03,-2.75,515000,22,571950,0,0,0,0,0,0,257000,205000,52000,52000
20200520,061115,電子類元大9A購02,2.91,2.91,2.91,2.91,+0.03,1.04,75000,3,218250,0,0,0,0,0,0,75000,0,75000,75000
20200520,061116,金融類元大9A購02,1.41,1.41,1.41,1.41,0.00,0.00,10000,1,14100,0,0,0,0,0,0,10000,0,10000,10000
20200520,061117,美律國泰9C購01,1.48,1.50,1.48,1.50,-0.02,-1.32,47000,3,69700,0,0,0,0,0,0,33000,14000,19000,19000
20200520,061118,GIS富邦9A購01,0.81,0.81,0.81,0.81,-0.04,-4.71,5000,1,4050,0,0,0,0,0,0,5000,0,5000,5000
20200520,061119,國巨永豐9A購03,1.12,1.12,1.12,1.12,+0.08,7.69,5000,1,5600,0,0,0,0,0,0,0,5000,-5000,-5000
20200520,06111P,上銀兆豐98售01,,,,,0.00,0.00,0,0,0,0,0,0,0,0,0,0,0,0,0
20200520,061120,台積電永豐9A購03,1.09,1.09,1.08,1.08,-0.01,-0.92,2000,2,2170,0,0,0,0,0,0,1000,2000,-1000,-1000
20200520,061121,智邦永豐9A購02,1.24,1.26,1.22,1.26,+0.04,3.28,265000,10,331250,0,0,0,0,0,0,12000,253000,-241000,-241000
20200520,061122,敬鵬永豐9A購01,0.78,0.87,0.76,0.79,+0.03,3.95,537000,54,436950,0,0,0,0,0,0,351000,158000,193000,193000
20200520,061123,燿華永豐9A購01,0.77,0.92,0.77,0.92,+0.19,26.03,624000,22,514390,0,0,0,0,0,0,0,624000,-624000,-624000
20200520,061124,微星永豐9A購02,1.34,1.40,1.29,1.32,-0.01,-0.75,984000,45,1317160,0,0,0,0,0,0,723000,169000,554000,554000
20200520,061125,億光永豐9A購01,1.14,1.27,1.14,1.27,+0.12,10.43,89000,11,108330,0,0,0,0,0,0,42000,47000,-5000,-5000
20200520,061126,京元電永豐9A購02,0.36,0.38,0.35,0.35,-0.06,-14.63,173000,15,61710,0,0,0,0,0,0,108000,38000,70000,70000
20200520,061127,美食永豐9A購01,1.38,1.47,1.28,1.37,+0.07,5.38,623000,61,873090,0,0,0,0,0,0,391000,142000,249000,249000
20200520,061128,大立光永豐9A購02,,,,,0.00,0.00,0,0,0,0,0,0,0,0,0,0,0,0,0
20200520,061129,文曄永豐9A購01,,,,,0.00,0.00,0,0,0,0,0,0,0,0,0,0,0,0,0
20200520,06112P,台積電兆豐97售01,,,,,0.00,0.00,0,0,0,0,0,0,0,0,0,0,0,0,0
20200520,061130,牧德永豐9A購04,1.06,1.19,1.06,1.19,+0.19,19.0,460000,6,536090,0,0,0,0,0,0,50000,410000,-360000,-360000
20200520,061131,崇越永豐9A購01,0.92,0.92,0.92,0.92,-0.01,-1.08,85000,1,78200,0,0,0,0,0,0,85000,0,85000,85000
20200520,061132,志超永豐9A購01,1.21,1.21,1.18,1.18,-0.02,-1.67,146000,5,175820,0,0,0,0,0,0,68000,78000,-10000,-10000
20200520,061133,玉晶光第一9A購01,0.96,0.99,0.96,0.99,0.00,0.00,35000,4,34540,0,0,0,0,0,0,5000,30000,-25000,-25000
20200520,061134,大成鋼統一9C購01,0.82,0.91,0.82,0.91,+0.10,12.35,349000,10,294610,0,0,0,0,0,0,68000,281000,-213000,-213000
20200520,061135,聯發科統一9C購03,1.57,1.57,1.57,1.57,+0.04,2.61,6000,1,9420,0,0,0,0,0,0,6000,0,6000,6000
20200520,061136,可成統一9A購01,,,,,0.00,0.00,0,0,0,0,0,0,0,0,0,0,0,0,0
20200520,061137,晶技統一9B購01,0.46,0.46,0.45,0.45,-0.04,-8.16,35000,3,15800,0,0,0,0,0,0,0,35000,-35000,-35000
20200520,061138,晶技統一9C購01,0.48,0.48,0.48,0.48,0.00,0.00,26000,2,12480,0,0,0,0,0,0,0,26000,-26000,-26000
20200520,061139,玉晶光統一9C購02,1.09,1.10,1.08,1.10,+0.06,5.77,29000,4,31440,0,0,0,0,0,0,0,29000,-29000,-29000
20200520,06113P,台積電群益97售01,4.83,4.83,4.83,4.83,0.00,0.00,1259000,7,6080970,0,0,0,0,0,0,1259000,1259000,0,0
20200520,061140,華擎統一9C購01,0.82,0.90,0.82,0.90,0.00,0.00,77000,5,67040,0,0,0,0,0,0,0,77000,-77000,-77000
20200520,061141,臻鼎統一9A購01,0.93,1.01,0.93,1.01,+0.08,8.6,135000,6,130950,0,0,0,0,0,0,115000,20000,95000,95000
20200520,061142,南電統一9A購01,0.55,0.59,0.51,0.53,-0.04,-7.02,364000,26,200420,0,0,0,0,0,0,144000,220000,-76000,-76000
20200520,061143,道瓊指中信9C購04,0.74,0.74,0.74,0.74,-0.01,-1.33,3000,1,2220,0,0,0,0,0,0,0,3000,-3000,-3000
20200520,061144,玉晶光中信9B購02,0.67,0.67,0.67,0.67,+0.06,9.84,45000,1,30150,0,0,0,0,0,0,0,45000,-45000,-45000
20200520,061145,臻鼎中信9A購02,0.75,0.82,0.75,0.81,+0.09,12.5,271000,12,206490,0,0,0,0,0,0,145000,120000,25000,25000
20200520,061146,台表科中信9A購02,1.47,1.75,1.34,1.75,+0.42,31.58,507000,63,758960,0,0,0,0,0,0,258000,204000,54000,54000
20200520,061147,上証2X群益9C購06,,,,,0.00,0.00,0,0,0,0,0,0,0,0,0,0,0,0,0
20200520,061148,道瓊反群益9A購02,0.67,0.67,0.66,0.66,0.00,0.00,2000,2,1330,0,0,0,0,0,0,0,2000,-2000,-2000
20200520,061149,華通群益9A購05,2.10,2.10,2.05,2.05,-0.03,-1.44,23000,2,47900,0,0,0,0,0,0,0,23000,-23000,-23000
20200520,06114P,台積電統一97售03,,,,,0.00,0.00,0,0,0,0,0,0,0,0,0,0,0,0,0
20200520,061150,國巨群益9A購09,2.38,2.60,2.38,2.43,+0.22,9.95,16000,4,39830,0,0,0,0,0,0,1000,16000,-15000,-15000
20200520,061151,友訊群益9A購01,1.73,1.73,1.67,1.67,-0.05,-2.91,46000,6,79470,0,0,0,0,0,0,33000,46000,-13000,-13000
20200520,061152,微星群益9A購01,3.21,3.25,3.12,3.12,+0.03,0.97,378000,17,1205640,0,0,0,0,0,0,261000,45000,216000,216000
20200520,061153,奇力新群益9A購02,1.42,1.46,1.37,1.39,+0.05,3.73,253000,10,360880,0,0,0,0,0,0,133000,120000,13000,13000
20200520,061154,可成群益9B購04,1.54,1.54,1.54,1.54,-0.13,-7.78,10000,1,15400,0,0,0,0,0,0,0,10000,-10000,-10000
20200520,061155,華新科群益9A購06,1.53,1.53,1.48,1.51,-0.02,-1.31,419000,6,625140,0,0,0,0,0,0,339000,80000,259000,259000
20200520,061156,玉晶光群益9A購07,1.68,1.80,1.68,1.80,0.00,0.00,323000,5,576740,0,0,0,0,0,0,0,323000,-323000,-323000
20200520,061157,聯鈞群益9A購02,0.88,0.88,0.88,0.88,-0.07,-7.37,5000,1,4400,0,0,0,0,0,0,5000,0,5000,5000
20200520,061158,世芯群益9A購02,,,,,0.00,0.00,0,0,0,0,0,0,0,0,0,0,0,0,0
20200520,061159,同欣電群益9A購01,1.37,1.49,1.37,1.37,-0.01,-0.72,1164000,68,1666510,0,0,0,0,0,0,631000,532000,99000,99000
20200520,06115P,台積電統一97售04,,,,,0.00,0.00,0,0,0,0,0,0,0,0,0,0,0,0,0
20200520,061160,瑞祺群益9A購01,1.24,1.33,1.24,1.33,+0.11,9.02,780000,15,1000320,0,0,0,0,0,0,116000,654000,-538000,-538000
20200520,061161,南六群益9A購01,,,,,0.00,0.00,0,0,0,0,0,0,0,0,0,0,0,0,0
20200520,061162,南電群益9A購02,1.05,1.05,0.96,0.96,-0.06,-5.88,351000,5,353850,0,0,0,0,0,0,301000,50000,251000,251000
20200520,061163,台灣50兆豐9A購04,1.52,1.52,1.52,1.52,0.00,0.00,85000,1,129200,0,0,0,0,0,0,85000,0,85000,85000
20200520,061164,燿華兆豐9B購01,0.88,1.06,0.87,1.04,+0.16,18.18,1240000,48,1206270,0,0,0,0,0,0,515000,725000,-210000,-210000
20200520,061165,美律兆豐9A購01,0.88,0.89,0.88,0.88,-0.02,-2.22,136000,7,119790,0,0,0,0,0,0,2000,134000,-132000,-132000
20200520,061166,玉晶光兆豐9B購01,1.18,1.23,1.18,1.23,+0.07,6.03,95000,18,114560,0,0,0,0,0,0,20000,65000,-45000,-45000
20200520,061167,臻鼎兆豐9B購01,1.42,1.42,1.42,1.42,0.00,0.00,1000,1,1420,0,0,0,0,0,0,0,1000,-1000,-1000
20200520,061168,力成兆豐9A購01,1.14,1.14,1.08,1.09,-0.03,-2.68,114000,7,128620,0,0,0,0,0,0,99000,15000,84000,84000
20200520,061169,GIS兆豐9A購01,1.51,1.55,1.51,1.55,0.00,0.00,115000,4,177360,0,0,0,0,0,0,2000,113000,-111000,-111000
20200520,06116P,臺股指日盛97售01,,,,,0.00,0.00,0,0,0,0,0,0,0,0,0,0,0,0,0
20200520,061170,南茂兆豐9B購01,1.07,1.13,1.07,1.12,+0.06,5.66,370000,20,406540,0,0,0,0,0,0,65000,305000,-240000,-240000
20200520,061171,大立光麥證9A購01,,,,,0.00,0.00,0,0,0,0,0,0,0,0,0,0,0,0,0
20200520,061172,大立光麥證9A購02,,,,,0.00,0.00,0,0,0,0,0,0,0,0,0,0,0,0,0
20200520,061173,T50反1凱基04購01,0.92,0.92,0.92,0.92,0.00,0.00,405000,3,372600,0,0,0,0,0,0,200000,205000,-5000,-5000
20200520,061174,鴻海凱基9A購23,2.36,2.36,2.36,2.36,-0.08,-3.28,10000,1,23600,0,0,0,0,0,0,0,10000,-10000,-10000
20200520,061175,台積電凱基9A購19,,,,,0.00,0.00,0,0,0,0,0,0,0,0,0,0,0,0,0
20200520,061176,聯發科凱基9A購14,6.75,7.30,6.70,7.30,+0.75,11.45,19000,5,129950,0,0,0,0,0,0,16000,3000,13000,13000
20200520,061177,大立光凱基9A購10,2.87,2.94,2.87,2.94,0.00,0.00,87000,2,252700,0,0,0,0,0,0,0,87000,-87000,-87000
20200520,061178,晶技凱基9B購01,0.89,0.89,0.89,0.89,-0.04,-4.3,122000,2,108580,0,0,0,0,0,0,54000,68000,-14000,-14000
20200520,061179,華擎凱基9A購01,1.19,1.31,1.19,1.29,+0.14,12.17,250000,8,314500,0,0,0,0,0,0,0,250000,-250000,-250000
20200520,06117P,臺股指日盛97售02,,,,,0.00,0.00,0,0,0,0,0,0,0,0,0,0,0,0,0
20200520,061180,華擎凱基9B購01,1.55,1.70,1.55,1.65,0.00,0.00,352000,12,574000,0,0,0,0,0,0,0,352000,-352000,-352000
20200520,061181,牧德凱基9A購01,1.04,1.21,1.03,1.19,+0.17,16.67,920000,31,1045470,0,0,0,0,0,0,449000,646000,-197000,-197000
20200520,061182,南六凱基9A購01,1.83,1.99,1.83,1.99,+0.06,3.11,12000,3,22230,0,0,0,0,0,0,10000,2000,8000,8000
20200520,061183,友達國泰9B購02,1.38,1.46,1.35,1.36,-0.01,-0.73,1156000,44,1653520,0,0,0,0,0,0,985000,146000,839000,839000
20200520,061184,大立光國泰9C購01,1.48,1.57,1.48,1.53,+0.04,2.68,89000,10,133910,0,0,0,0,0,0,76000,32000,44000,44000
20200520,061185,嘉晶國泰9B購01,2.14,2.59,2.12,2.49,+0.38,18.01,404000,43,938740,0,0,0,0,0,0,93000,312000,-219000,-219000
20200520,061186,牧德國泰9C購01,1.61,1.86,1.59,1.83,+0.23,14.37,1755000,66,3114400,0,0,0,0,0,0,292000,1443000,-1151000,-1151000
20200520,061187,瀚宇博國泰9C購01,1.36,1.37,1.28,1.28,-0.09,-6.57,134000,6,182970,0,0,0,0,0,0,134000,4000,130000,130000
20200520,061188,大成鋼富邦9B購01,0.67,0.77,0.66,0.75,+0.11,17.19,1500000,42,1061790,0,0,0,0,0,0,387000,1063000,-676000,-676000
20200520,061189,可成富邦9B購02,0.52,0.52,0.49,0.49,-0.09,-15.52,260000,5,134100,0,0,0,0,0,0,30000,220000,-190000,-190000
20200520,06118P,上証2X凱基98售03,,,,,0.00,0.00,0,0,0,0,0,0,0,0,0,0,0,0,0
20200520,061190,力山永豐9A購02,1.83,1.85,1.82,1.82,-0.08,-4.21,67000,3,123050,0,0,0,0,0,0,30000,37000,-7000,-7000
20200520,061191,可成永豐9A購02,0.75,0.75,0.70,0.70,-0.20,-22.22,88000,3,64420,0,0,0,0,0,0,10000,78000,-68000,-68000
20200520,061192,奇鋐永豐9A購01,0.99,0.99,0.99,0.99,+0.02,2.06,30000,2,29700,0,0,0,0,0,0,0,30000,-30000,-30000
20200520,061193,玉晶光永豐9B購02,2.06,2.13,2.05,2.11,+0.15,7.65,141000,13,297340,0,0,0,0,0,0,0,141000,-141000,-141000
20200520,061194,聯鈞永豐9A購02,,,,,0.00,0.00,0,0,0,0,0,0,0,0,0,0,0,0,0
20200520,061195,健策永豐9B購02,0.84,0.84,0.84,0.84,0.00,0.00,17000,5,14280,0,0,0,0,0,0,17000,17000,0,0
20200520,061196,世芯永豐9A購06,1.98,2.02,1.81,1.81,-0.20,-9.95,618000,29,1205040,0,0,0,0,0,0,478000,130000,348000,348000
20200520,061197,矽創永豐9A購02,1.10,1.10,0.96,0.97,-0.12,-11.01,1754000,123,1843350,0,0,0,0,0,0,1545000,98000,1447000,1447000
20200520,061198,世紀鋼永豐9A購03,,,,,0.00,0.00,0,0,0,0,0,0,0,0,0,0,0,0,0
20200520,061199,道瓊反元大9A購05,,,,,0.00,0.00,0,0,0,0,0,0,0,0,0,0,0,0,0
20200520,06119P,大立光凱基98售04,5.90,5.90,5.90,5.90,0.00,0.00,1000,1,5900,0,0,0,0,0,0,0,1000,-1000,-1000
20200520,061200,道瓊反元大9A購06,1.10,1.10,1.09,1.09,+0.03,2.83,13000,3,14200,0,0,0,0,0,0,13000,0,13000,13000
20200520,061201,FBVIX元大01購03,,,,,0.00,0.00,0,0,0,0,0,0,0,0,0,0,0,0,0
20200520,061202,和大元大9A購02,2.16,2.46,2.10,2.46,+0.27,12.33,412000,33,944080,0,0,0,0,0,0,94000,318000,-224000,-224000
20200520,061203,國巨元大9A購15,2.11,2.21,2.11,2.13,+0.13,6.5,27000,4,57570,0,0,0,0,0,0,0,27000,-27000,-27000
20200520,061204,國巨元大9A購16,4.00,4.09,3.86,3.87,+0.17,4.59,51000,9,199090,0,0,0,0,0,0,15000,38000,-23000,-23000
20200520,061205,旺宏元大9A購11,1.97,1.97,1.97,1.97,+0.01,0.51,75000,1,147750,0,0,0,0,0,0,75000,0,75000,75000
20200520,061206,旺宏元大9A購12,2.09,2.26,2.09,2.23,0.00,0.00,14000,4,31170,0,0,0,0,0,0,8000,5000,3000,3000
20200520,061207,美律元大9A購04,1.60,1.62,1.60,1.62,-0.06,-3.57,83000,5,134060,0,0,0,0,0,0,68000,15000,53000,53000
20200520,061208,聯發科元大9A購09,,,,,0.00,0.00,0,0,0,0,0,0,0,0,0,0,0,0,0
20200520,061209,聯發科元大9A購10,6.25,6.25,6.25,6.25,+0.15,2.46,15000,2,93750,0,0,0,0,0,0,15000,0,15000,15000
20200520,06120P,大立光凱基98售05,,,,,0.00,0.00,0,0,0,0,0,0,0,0,0,0,0,0,0
20200520,061210,玉山金元大9A購02,2.10,2.10,2.10,2.10,+0.02,0.96,70000,2,147000,0,0,0,0,0,0,70000,2000,68000,68000
20200520,061211,玉晶光元大9A購12,0.93,1.00,0.93,0.98,+0.03,3.16,17000,4,16160,0,0,0,0,0,0,12000,5000,7000,7000
20200520,061212,聯鈞元大9A購04,1.44,1.48,1.39,1.39,-0.08,-5.44,144000,6,207330,0,0,0,0,0,0,66000,78000,-12000,-12000
20200520,061213,群創元大9A購05,1.23,1.26,1.22,1.25,+0.01,0.81,284000,14,353200,0,0,0,0,0,0,284000,0,284000,284000
20200520,061214,華擎元大9A購04,1.46,1.63,1.46,1.63,+0.20,13.99,198000,21,309440,0,0,0,0,0,0,62000,136000,-74000,-74000
20200520,061215,健策元大9A購06,1.18,1.23,1.15,1.23,+0.08,6.96,141000,6,167130,0,0,0,0,0,0,69000,73000,-4000,-4000
20200520,061216,世芯元大9A購06,3.98,4.04,3.72,3.72,-0.23,-5.82,282000,34,1112730,0,0,0,0,0,0,268000,0,268000,268000
20200520,061217,臺股指元大9A購54,,,,,0.00,0.00,0,0,0,0,0,0,0,0,0,0,0,0,0
20200520,061218,臺股指元大9A購55,1.47,1.47,1.45,1.45,-0.01,-0.68,46000,2,67480,0,0,0,0,0,0,39000,7000,32000,32000
20200520,061219,臺股指元大9A購56,,,,,0.00,0.00,0,0,0,0,0,0,0,0,0,0,0,0,0
20200520,06121P,同欣電凱基97售02,,,,,0.00,0.00,0,0,0,0,0,0,0,0,0,0,0,0,0
20200520,061220,臺股指元大9A購57,,,,,0.00,0.00,0,0,0,0,0,0,0,0,0,0,0,0,0
20200520,061221,臺股指元大9A購58,,,,,0.00,0.00,0,0,0,0,0,0,0,0,0,0,0,0,0
20200520,061222,台灣50中信9A購02,1.53,1.53,1.53,1.53,-0.01,-0.65,64000,1,97920,0,0,0,0,0,0,64000,0,64000,64000
20200520,061223,T50反1中信01購01,0.97,0.97,0.97,0.97,-0.01,-1.02,103000,2,99910,0,0,0,0,0,0,0,103000,-103000,-103000
20200520,061224,道瓊反中信01購01,1.15,1.15,1.15,1.15,+0.02,1.77,12000,2,13800,0,0,0,0,0,0,0,12000,-12000,-12000
20200520,061225,台積電中信9A購04,,,,,0.00,0.00,0,0,0,0,0,0,0,0,0,0,0,0,0
20200520,061226,台積電中信9A購05,0.49,0.50,0.49,0.50,+0.01,2.04,6000,2,2950,0,0,0,0,0,0,0,6000,-6000,-6000
20200520,061227,日月光中信9B購01,0.92,0.94,0.87,0.87,-0.07,-7.45,236000,7,218370,0,0,0,0,0,0,87000,149000,-62000,-62000
20200520,061228,聯茂中信9A購01,0.54,0.54,0.53,0.53,0.00,0.00,180000,4,95700,0,0,0,0,0,0,95000,85000,10000,10000
20200520,061229,緯穎中信9B購01,1.19,1.26,1.12,1.14,-0.06,-5.0,430000,33,505610,0,0,0,0,0,0,146000,309000,-163000,-163000
20200520,06122P,亞光元大98售01,,,,,0.00,0.00,0,0,0,0,0,0,0,0,0,0,0,0,0
20200520,061230,臺指反元大01購04,1.00,1.00,0.99,0.99,0.00,0.00,19000,2,18960,0,0,0,0,0,0,0,19000,-19000,-19000
20200520,061231,聚陽元大9A購02,1.35,1.35,1.20,1.29,-0.02,-1.53,1777000,101,2275790,0,0,0,0,0,0,1199000,454000,745000,745000
20200520,061232,和大元大9A購03,2.61,2.92,2.55,2.92,+0.32,12.31,575000,46,1586520,0,0,0,0,0,0,233000,342000,-109000,-109000
20200520,061233,國巨元大9A購17,1.16,1.23,1.16,1.17,+0.07,6.36,241000,20,285770,0,0,0,0,0,0,190000,41000,149000,149000
20200520,061234,國巨元大9A購18,2.60,2.99,2.60,2.82,+0.20,7.63,62000,9,176120,0,0,0,0,0,0,3000,58000,-55000,-55000
20200520,061235,台積電元大9A購23,,,,,0.00,0.00,0,0,0,0,0,0,0,0,0,0,0,0,0
20200520,061236,台積電元大9A購24,2.11,2.11,2.11,2.11,0.00,0.00,50000,1,105500,0,0,0,0,0,0,0,50000,-50000,-50000
20200520,061237,晶技元大9A購01,1.14,1.14,1.09,1.09,-0.11,-9.17,141000,4,159810,0,0,0,0,0,0,68000,73000,-5000,-5000
20200520,061238,晶技元大9A購02,0.96,0.99,0.96,0.99,+0.02,2.06,114000,3,112480,0,0,0,0,0,0,0,114000,-114000,-114000
20200520,061239,聯發科兆豐9A購01,3.03,3.10,3.03,3.05,+0.12,4.1,23000,6,70530,0,0,0,0,0,0,11000,12000,-1000,-1000
20200520,06123P,玉晶光元大97售04,1.25,1.25,1.17,1.17,-0.09,-7.14,121000,4,142850,0,0,0,0,0,0,41000,80000,-39000,-39000
20200520,061240,華新科兆豐9A購01,1.01,1.06,1.00,1.01,0.00,0.00,442000,10,450450,0,0,0,0,0,0,258000,184000,74000,74000
20200520,061241,晶技兆豐9A購01,0.80,0.81,0.73,0.74,-0.04,-5.13,367000,10,276790,0,0,0,0,0,0,354000,13000,341000,341000
20200520,061242,玉晶光兆豐9B購02,1.14,1.14,1.14,1.14,+0.09,8.57,10000,1,11400,0,0,0,0,0,0,0,10000,-10000,-10000
20200520,061243,麗豐兆豐9A購01,1.07,1.14,1.07,1.07,-0.04,-3.6,242000,26,267080,0,0,0,0,0,0,201000,41000,160000,160000
20200520,061244,和碩兆豐9A購01,0.80,0.80,0.80,0.80,0.00,0.00,58000,2,46400,0,0,0,0,0,0,14000,44000,-30000,-30000
20200520,061245,晶技群益9A購01,0.90,0.91,0.88,0.88,-0.01,-1.12,96000,3,86860,0,0,0,0,0,0,20000,76000,-56000,-56000
20200520,061246,玉晶光群益9A購08,3.04,3.33,2.99,3.33,+0.30,9.9,51000,15,164230,0,0,0,0,0,0,20000,44000,-24000,-24000
20200520,061247,玉晶光群益9A購09,2.06,2.19,2.06,2.19,+0.23,11.73,34000,4,72830,0,0,0,0,0,0,2000,32000,-30000,-30000
20200520,061248,健策群益9A購03,0.73,0.77,0.73,0.77,-0.07,-8.33,93000,3,68900,0,0,0,0,0,0,92000,4000,88000,88000
20200520,061249,億豐群益9A購01,2.22,2.38,2.22,2.33,+0.09,4.02,239000,12,543320,0,0,0,0,0,0,37000,142000,-105000,-105000
20200520,06124P,超眾元大97售03,,,,,0.00,0.00,0,0,0,0,0,0,0,0,0,0,0,0,0
20200520,061250,臺股指群益9A購01,,,,,0.00,0.00,0,0,0,0,0,0,0,0,0,0,0,0,0
20200520,061251,臺股指群益9A購02,,,,,0.00,0.00,0,0,0,0,0,0,0,0,0,0,0,0,0
20200520,061252,臺股指群益9A購03,2.94,2.98,2.89,2.89,+0.03,1.05,180000,6,528550,0,0,0,0,0,0,155000,25000,130000,130000
20200520,061253,臺股指群益9A購04,2.25,2.25,2.22,2.22,+0.01,0.45,63000,3,141660,0,0,0,0,0,0,60000,3000,57000,57000
20200520,061254,道瓊反凱基9A購02,1.46,1.46,1.45,1.45,0.00,0.00,97000,5,141320,0,0,0,0,0,0,7000,80000,-73000,-73000
20200520,061255,道瓊反凱基9C購01,1.47,1.48,1.47,1.48,+0.04,2.78,9000,2,13280,0,0,0,0,0,0,4000,5000,-1000,-1000
20200520,061256,亞德客凱基9B購01,1.30,1.30,1.30,1.30,0.00,0.00,100000,1,130000,0,0,0,0,0,0,0,100000,-100000,-100000
20200520,061257,上銀凱基9A購06,,,,,0.00,0.00,0,0,0,0,0,0,0,0,0,0,0,0,0
20200520,061258,華通凱基9A購06,,,,,0.00,0.00,0,0,0,0,0,0,0,0,0,0,0,0,0
20200520,061259,台積電凱基9A購21,,,,,0.00,0.00,0,0,0,0,0,0,0,0,0,0,0,0,0
20200520,06125P,楠梓電元富99售01,1.08,1.14,1.08,1.11,+0.03,2.78,150000,5,164500,0,0,0,0,0,0,0,150000,-150000,-150000
20200520,061260,台積電凱基9A購23,,,,,0.00,0.00,0,0,0,0,0,0,0,0,0,0,0,0,0
20200520,061261,台積電凱基9B購03,0.84,0.86,0.84,0.86,+0.01,1.18,40000,2,34000,0,0,0,0,0,0,20000,20000,0,0
20200520,061262,智邦凱基9A購02,1.14,1.18,1.14,1.17,+0.05,4.46,15000,7,17450,0,0,0,0,0,0,6000,9000,-3000,-3000
20200520,061263,微星凱基9A購01,1.49,1.55,1.45,1.45,-0.03,-2.03,408000,26,611230,0,0,0,0,0,0,321000,74000,247000,247000
20200520,061264,全新凱基9B購01,0.77,0.77,0.70,0.71,-0.06,-7.79,34000,7,25000,0,0,0,0,0,0,15000,19000,-4000,-4000
20200520,061265,富邦金凱基9B購01,1.36,1.40,1.36,1.40,+0.03,2.19,81000,5,111070,0,0,0,0,0,0,71000,10000,61000,61000
20200520,061266,國泰金凱基9B購01,1.49,1.50,1.49,1.50,-0.01,-0.66,86000,3,128940,0,0,0,0,0,0,86000,0,86000,86000
20200520,061267,玉山金凱基9B購01,,,,,0.00,0.00,0,0,0,0,0,0,0,0,0,0,0,0,0
20200520,061268,玉晶光凱基9B購04,,,,,0.00,0.00,0,0,0,0,0,0,0,0,0,0,0,0,0
20200520,061269,嘉澤凱基9A購01,1.85,1.87,1.79,1.79,-0.02,-1.1,478000,25,862720,0,0,0,0,0,0,139000,339000,-200000,-200000
20200520,06126P,凌陽元富97售02,,,,,0.00,0.00,0,0,0,0,0,0,0,0,0,0,0,0,0
20200520,061270,彩晶凱基9A購02,0.86,0.89,0.86,0.89,0.00,0.00,137000,3,119530,0,0,0,0,0,0,87000,50000,37000,37000
20200520,061271,聯茂凱基9A購04,0.45,0.45,0.43,0.44,-0.04,-8.33,253000,8,110950,0,0,0,0,0,0,185000,68000,117000,117000
20200520,061272,超眾凱基9A購03,,,,,0.00,0.00,0,0,0,0,0,0,0,0,0,0,0,0,0
20200520,061273,臺股指凱基9A購23,3.01,3.01,2.88,2.90,+0.06,2.11,11000,3,32000,0,0,0,0,0,0,6000,5000,1000,1000
20200520,061274,臺股指凱基9A購24,2.56,2.60,2.50,2.50,0.00,0.00,198000,9,504070,0,0,0,0,0,0,130000,68000,62000,62000
20200520,061275,臺股指凱基9A購25,2.28,2.36,2.22,2.23,-0.01,-0.45,552000,18,1267950,0,0,0,0,0,0,132000,420000,-288000,-288000
20200520,061276,T50反1台新9A購03,,,,,0.00,0.00,0,0,0,0,0,0,0,0,0,0,0,0,0
20200520,061277,智邦台新9A購01,2.13,2.13,2.13,2.13,0.00,0.00,10000,1,21300,0,0,0,0,0,0,10000,0,10000,10000
20200520,061278,和大統一9A購01,1.20,1.42,1.20,1.42,+0.14,10.94,1614000,42,2122130,0,0,0,0,0,0,512000,1160000,-648000,-648000
20200520,061279,鴻海統一9C購04,0.93,0.93,0.91,0.91,-0.01,-1.09,220000,6,204000,0,0,0,0,0,0,150000,70000,80000,80000
20200520,06127P,泰碩元富97售01,,,,,0.00,0.00,0,0,0,0,0,0,0,0,0,0,0,0,0
20200520,061280,國巨統一9C購06,1.35,1.42,1.35,1.37,+0.08,6.2,53000,4,72450,0,0,0,0,0,0,53000,0,53000,53000
20200520,061281,台積電統一9C購05,0.70,0.70,0.70,0.70,0.00,0.00,70000,1,49000,0,0,0,0,0,0,70000,0,70000,70000
20200520,061282,台積電統一9C購06,,,,,0.00,0.00,0,0,0,0,0,0,0,0,0,0,0,0,0
20200520,061283,智邦統一9A購01,1.03,1.07,1.00,1.02,+0.02,2.0,1071000,59,1109420,30000,0,30000,0,0,0,626000,469000,157000,187000
20200520,061284,友達統一9C購01,1.04,1.09,1.04,1.07,+0.02,1.9,158000,8,168670,0,0,0,0,0,0,74000,84000,-10000,-10000
20200520,061285,大立光統一9A購04,,,,,0.00,0.00,0,0,0,0,0,0,0,0,0,0,0,0,0
20200520,061286,大立光統一9A購05,2.34,2.50,2.34,2.50,-0.03,-1.19,38000,4,92160,0,0,0,0,0,0,12000,26000,-14000,-14000
20200520,061287,大立光統一9B購06,,,,,0.00,0.00,0,0,0,0,0,0,0,0,0,0,0,0,0
20200520,061288,大立光統一9C購01,0.75,0.76,0.75,0.75,-0.01,-1.32,15000,4,11260,0,0,0,0,0,0,2000,13000,-11000,-11000
20200520,061289,玉晶光統一01購03,1.23,1.29,1.23,1.29,+0.07,5.74,29000,7,36800,0,0,0,0,0,0,8000,21000,-13000,-13000
20200520,06128P,玉晶光元富97售05,,,,,0.00,0.00,0,0,0,0,0,0,0,0,0,0,0,0,0
20200520,061290,玉晶光統一01購04,,,,,0.00,0.00,0,0,0,0,0,0,0,0,0,0,0,0,0
20200520,061291,玉晶光統一01購05,,,,,0.00,0.00,0,0,0,0,0,0,0,0,0,0,0,0,0
20200520,061292,玉晶光統一01購06,1.51,1.56,1.51,1.54,0.00,0.00,25000,13,38590,0,0,0,0,0,0,0,25000,-25000,-25000
20200520,061293,聯茂統一9A購01,0.60,0.60,0.58,0.59,-0.04,-6.35,165000,48,97770,0,0,0,0,0,0,165000,0,165000,165000
20200520,061294,奇力新麥證9A購01,1.23,1.27,1.20,1.20,+0.04,3.45,130000,5,161700,87000,43000,44000,0,0,0,87000,43000,44000,44000
20200520,061295,台積電國泰9B購02,2.18,2.18,2.10,2.10,-0.03,-1.41,139000,11,299890,0,0,0,0,0,0,21000,120000,-99000,-99000
20200520,061296,台積電國泰9C購01,1.87,1.87,1.80,1.80,-0.05,-2.7,82000,6,151460,0,0,0,0,0,0,10000,74000,-64000,-64000
20200520,061297,台積電富邦9C購09,0.39,0.39,0.38,0.39,0.00,0.00,161000,3,62190,0,0,0,0,0,0,60000,0,60000,60000
20200520,061298,華新科富邦01購02,0.70,0.70,0.70,0.70,+0.03,4.48,3000,2,2100,0,0,0,0,0,0,1000,3000,-2000,-2000
20200520,061299,臺股指富邦9A購01,,,,,0.00,0.00,0,0,0,0,0,0,0,0,0,0,0,0,0
20200520,06129P,玉晶光元富97售06,,,,,0.00,0.00,0,0,0,0,0,0,0,0,0,0,0,0,0
20200520,061300,臺股指富邦9A購02,1.22,1.22,1.19,1.19,-0.01,-0.83,20000,4,24000,0,0,0,0,0,0,10000,10000,0,0
20200520,061301,華新科永豐9A購03,0.82,0.85,0.82,0.85,+0.02,2.41,99000,7,84080,0,0,0,0,0,0,14000,87000,-73000,-73000
20200520,061302,晶技永豐9A購04,,,,,0.00,0.00,0,0,0,0,0,0,0,0,0,0,0,0,0
20200520,061303,玉晶光永豐9B購03,1.18,1.18,1.18,1.18,0.00,0.00,3000,1,3540,0,0,0,0,0,0,3000,0,3000,3000
20200520,061304,創意永豐9A購02,0.60,0.60,0.60,0.60,+0.01,1.69,45000,3,27000,0,0,0,0,0,0,0,45000,-45000,-45000
20200520,061305,帆宣永豐9A購01,0.87,0.88,0.87,0.88,+0.01,1.15,114000,2,99750,0,0,0,0,0,0,57000,57000,0,0
20200520,061306,瑞祺永豐9A購02,0.71,0.75,0.71,0.75,0.00,0.00,779000,7,570530,0,0,0,0,0,0,10000,769000,-759000,-759000
20200520,061307,和潤永豐9A購02,1.00,1.00,0.99,1.00,-0.01,-0.99,244000,6,243930,0,0,0,0,0,0,28000,216000,-188000,-188000
20200520,061308,元金2X中信9A購01,0.91,0.92,0.91,0.92,+0.05,5.75,65000,5,59500,0,0,0,0,0,0,65000,0,65000,65000
20200520,061309,鴻海統一9C購05,0.77,0.77,0.75,0.75,-0.02,-2.6,124000,4,93080,0,0,0,0,0,0,74000,50000,24000,24000
20200520,06130P,玉晶光元富97售07,,,,,0.00,0.00,0,0,0,0,0,0,0,0,0,0,0,0,0
20200520,061310,華新科麥證9A購01,1.25,1.25,1.18,1.18,-0.03,-2.48,13000,4,15680,2000,11000,-9000,0,0,0,2000,11000,-9000,-9000
20200520,061311,元黃金凱基9A購03,1.16,1.16,1.16,1.16,+0.03,2.65,1000,1,1160,0,0,0,0,0,0,1000,0,1000,1000
20200520,061312,滬深2X凱基9A購05,,,,,0.00,0.00,0,0,0,0,0,0,0,0,0,0,0,0,0
20200520,061313,滬深2X凱基9B購05,,,,,0.00,0.00,0,0,0,0,0,0,0,0,0,0,0,0,0
20200520,061314,滬深2X凱基9B購06,,,,,0.00,0.00,0,0,0,0,0,0,0,0,0,0,0,0,0
20200520,061315,滬深2X凱基9C購06,1.56,1.56,1.56,1.56,-0.06,-3.7,1000,1,1560,0,0,0,0,0,0,1000,0,1000,1000
20200520,061316,台積電凱基9A購24,1.24,1.24,1.24,1.24,-0.02,-1.59,1000,1,1240,0,0,0,0,0,0,0,1000,-1000,-1000
20200520,061317,旺宏凱基9A購05,,,,,0.00,0.00,0,0,0,0,0,0,0,0,0,0,0,0,0
20200520,061318,智邦凱基9B購01,1.10,1.13,1.06,1.12,+0.05,4.67,186000,22,205550,0,0,0,0,0,0,121000,45000,76000,76000
20200520,061319,聯發科凱基9A購16,2.82,2.93,2.82,2.93,+0.22,8.12,32000,2,90460,0,0,0,0,0,0,32000,0,32000,32000
20200520,06131P,京鼎元富97售02,,,,,0.00,0.00,0,0,0,0,0,0,0,0,0,0,0,0,0
20200520,061320,奇力新凱基9A購04,1.03,1.06,1.03,1.06,0.00,0.00,52000,3,54400,0,0,0,0,0,0,0,52000,-52000,-52000
20200520,061321,華新科凱基9A購09,,,,,0.00,0.00,0,0,0,0,0,0,0,0,0,0,0,0,0
20200520,061322,華新科凱基9A購12,,,,,0.00,0.00,0,0,0,0,0,0,0,0,0,0,0,0,0
20200520,061323,華新科凱基9B購06,,,,,0.00,0.00,0,0,0,0,0,0,0,0,0,0,0,0,0
20200520,061324,華新科凱基9C購01,,,,,0.00,0.00,0,0,0,0,0,0,0,0,0,0,0,0,0
20200520,061325,晶技凱基9A購03,,,,,0.00,0.00,0,0,0,0,0,0,0,0,0,0,0,0,0
20200520,061326,新日興凱基9B購01,0.98,1.09,0.98,1.09,0.00,0.00,192000,8,194560,0,0,0,0,0,0,0,192000,-192000,-192000
20200520,061327,台郡凱基9A購02,0.99,0.99,0.99,0.99,-0.01,-1.0,45000,1,44550,0,0,0,0,0,0,45000,0,45000,45000
20200520,061328,T50反1元大9A購12,,,,,0.00,0.00,0,0,0,0,0,0,0,0,0,0,0,0,0
20200520,061329,T50反1元大9A購13,,,,,0.00,0.00,0,0,0,0,0,0,0,0,0,0,0,0,0
20200520,06132P,正文元富97售01,,,,,0.00,0.00,0,0,0,0,0,0,0,0,0,0,0,0,0
20200520,061330,T50反1元大9A購14,,,,,0.00,0.00,0,0,0,0,0,0,0,0,0,0,0,0,0
20200520,061331,T50反1元大9A購15,,,,,0.00,0.00,0,0,0,0,0,0,0,0,0,0,0,0,0
20200520,061332,T50反1元大9A購16,,,,,0.00,0.00,0,0,0,0,0,0,0,0,0,0,0,0,0
20200520,061333,華通元大9A購08,3.23,3.34,3.23,3.34,0.00,0.00,20000,2,65700,0,0,0,0,0,0,20000,0,20000,20000
20200520,061334,華通元大9A購09,3.02,3.08,2.95,3.02,-0.11,-3.51,129000,7,388220,0,0,0,0,0,0,52000,77000,-25000,-25000
20200520,061335,國巨元大9A購19,2.16,2.16,2.16,2.16,0.00,0.00,25000,1,54000,0,0,0,0,0,0,0,25000,-25000,-25000
20200520,061336,國巨元大9A購20,2.99,3.18,2.96,3.01,+0.20,7.12,80000,42,243580,0,0,0,0,0,0,11000,68000,-57000,-57000
20200520,061337,台積電元大9A購27,1.36,1.36,1.36,1.36,-0.02,-1.45,20000,1,27200,0,0,0,0,0,0,20000,0,20000,20000
20200520,061338,台積電元大9A購28,,,,,0.00,0.00,0,0,0,0,0,0,0,0,0,0,0,0,0
20200520,061339,京元電元大9A購05,1.13,1.13,1.03,1.03,-0.11,-9.65,238000,12,253870,0,0,0,0,0,0,110000,128000,-18000,-18000
20200520,06133P,帆宣元富97售02,,,,,0.00,0.00,0,0,0,0,0,0,0,0,0,0,0,0,0
20200520,061340,義隆元大9A購01,2.27,2.27,2.27,2.27,0.00,0.00,10000,1,22700,0,0,0,0,0,0,0,10000,-10000,-10000
20200520,061341,華新科元大9A購16,2.47,2.52,2.47,2.52,+0.11,4.56,55000,2,137100,0,0,0,0,0,0,30000,25000,5000,5000
20200520,061342,華新科元大9A購17,1.51,1.53,1.49,1.51,+0.05,3.42,78000,8,117240,0,0,0,0,0,0,68000,10000,58000,58000
20200520,061343,大立光元大9A購04,2.81,2.88,2.81,2.88,-0.01,-0.35,85000,4,242350,0,0,0,0,0,0,0,85000,-85000,-85000
20200520,061344,禾伸堂元大9A購02,2.18,2.23,2.12,2.14,-0.03,-1.38,277000,12,604950,0,0,0,0,0,0,217000,172000,45000,45000
20200520,061345,玉晶光元大9A購14,1.28,1.35,1.28,1.35,+0.05,3.85,36000,14,47270,0,0,0,0,0,0,19000,17000,2000,2000
20200520,061346,玉晶光元大9B購03,1.31,1.34,1.31,1.34,+0.06,4.69,30000,3,39900,0,0,0,0,0,0,20000,10000,10000,10000
20200520,061347,創意元大9A購02,1.21,1.23,1.17,1.21,+0.01,0.83,317000,9,384170,0,0,0,0,0,0,261000,256000,5000,5000
20200520,061348,聯鈞元大9A購05,,,,,0.00,0.00,0,0,0,0,0,0,0,0,0,0,0,0,0
20200520,061349,嘉澤元大9A購02,3.39,3.40,3.26,3.26,-0.05,-1.51,170000,11,566860,0,0,0,0,0,0,151000,55000,96000,96000
20200520,06134P,緯穎元富97售03,,,,,0.00,0.00,0,0,0,0,0,0,0,0,0,0,0,0,0
20200520,061350,牧德元大9B購03,1.41,1.62,1.40,1.59,+0.22,16.06,522000,45,807020,0,0,0,0,0,0,203000,335000,-132000,-132000
20200520,061351,智伸科元大9A購01,1.68,1.74,1.65,1.68,+0.05,3.07,1128000,53,1918050,0,0,0,0,0,0,694000,374000,320000,320000
20200520,061352,茂林元大9A購04,2.54,3.02,2.54,3.02,+0.49,19.37,216000,18,592460,0,0,0,0,0,0,12000,204000,-192000,-192000
20200520,061353,康控元大9A購01,1.75,1.75,1.58,1.60,-0.07,-4.19,328000,23,547870,0,0,0,0,0,0,293000,55000,238000,238000
20200520,061354,瑞儀元大9A購01,1.81,1.90,1.80,1.88,+0.09,5.03,1249000,67,2345390,0,0,0,0,0,0,47000,1202000,-1155000,-1155000
20200520,061355,康友元大9A購03,1.62,1.62,1.61,1.62,-0.08,-4.71,177000,19,286250,0,0,0,0,0,0,133000,54000,79000,79000
20200520,061356,南電元大9A購06,1.52,1.59,1.44,1.48,-0.05,-3.27,305000,18,459530,0,0,0,0,0,0,100000,205000,-105000,-105000
20200520,061357,寶成元大9A購01,1.65,1.65,1.62,1.62,-0.05,-2.99,186000,9,302850,0,0,0,0,0,0,186000,0,186000,186000
20200520,061358,世紀鋼元大9A購04,3.44,3.45,3.07,3.07,-0.34,-9.97,29000,4,99430,0,0,0,0,0,0,8000,28000,-20000,-20000
20200520,061359,台灣50兆豐9C購02,1.52,1.52,1.52,1.52,0.00,0.00,30000,1,45600,0,0,0,0,0,0,30000,0,30000,30000
20200520,06135P,志超元富97售01,0.25,0.25,0.25,0.25,0.00,0.00,1000,1,250,0,0,0,0,0,0,0,1000,-1000,-1000
20200520,061360,智邦兆豐9B購02,1.16,1.22,1.16,1.20,+0.03,2.56,162000,11,191910,0,0,0,0,0,0,73000,89000,-16000,-16000
20200520,061361,世紀鋼兆豐9A購01,1.14,1.17,1.03,1.03,-0.10,-8.85,482000,7,522890,0,0,0,0,0,0,185000,297000,-112000,-112000
20200520,061362,台塑國票9B購01,2.89,2.91,2.79,2.79,-0.16,-5.42,94000,5,271940,0,0,0,0,0,0,45000,49000,-4000,-4000
20200520,061363,儒鴻國票9B購01,1.99,2.00,1.94,2.00,+0.06,3.09,17000,3,33680,0,0,0,0,0,0,7000,10000,-3000,-3000
20200520,061364,國巨國票9A購09,4.19,4.19,4.04,4.06,+0.29,7.69,10000,5,40710,0,0,0,0,0,0,8000,5000,3000,3000
20200520,061365,國巨國票9B購05,4.77,4.84,4.64,4.67,+0.31,7.11,30000,10,142010,0,0,0,0,0,0,6000,30000,-24000,-24000
20200520,061366,台勝科國票9A購01,2.11,2.41,2.11,2.41,+0.18,8.07,32000,4,71060,0,0,0,0,0,0,25000,7000,18000,18000
20200520,061367,瑞祺國票9A購01,1.54,1.72,1.54,1.72,+0.21,13.91,571000,14,927710,0,0,0,0,0,0,277000,294000,-17000,-17000
20200520,061368,南六國票9A購01,4.38,4.79,4.38,4.64,+0.23,5.22,46000,11,208890,0,0,0,0,0,0,23000,23000,0,0
20200520,061369,T50反1國泰9B購03,,,,,0.00,0.00,0,0,0,0,0,0,0,0,0,0,0,0,0
20200520,06136P,華新科國泰99售02,,,,,0.00,0.00,0,0,0,0,0,0,0,0,0,0,0,0,0
20200520,061370,晶技國泰9C購01,1.18,1.18,1.18,1.18,-0.05,-4.07,25000,1,29500,0,0,0,0,0,0,25000,0,25000,25000
20200520,061371,嘉澤國泰9C購01,3.14,3.14,3.12,3.12,+0.03,0.97,5000,2,15640,0,0,0,0,0,0,5000,0,5000,5000
20200520,061372,世紀鋼國泰9C購01,1.64,1.66,1.50,1.51,-0.11,-6.79,845000,32,1358990,0,0,0,0,0,0,550000,284000,266000,266000
20200520,061373,華通富邦9A購02,0.69,0.72,0.68,0.68,-0.03,-4.23,1061000,24,732330,0,0,0,0,0,0,521000,530000,-9000,-9000
20200520,061374,力山永豐9A購04,1.03,1.06,1.03,1.04,+0.02,1.96,163000,4,171680,0,0,0,0,0,0,30000,133000,-103000,-103000
20200520,061375,華通永豐9A購02,,,,,0.00,0.00,0,0,0,0,0,0,0,0,0,0,0,0,0
20200520,061376,瑞昱永豐9A購02,1.19,1.25,1.19,1.25,+0.06,5.04,70000,5,86200,0,0,0,0,0,0,70000,0,70000,70000
20200520,061377,聯發科永豐9A購04,2.68,2.68,2.68,2.68,+0.18,7.2,10000,2,26800,0,0,0,0,0,0,0,10000,-10000,-10000
20200520,061378,南六永豐9A購03,1.58,1.66,1.52,1.59,+0.04,2.58,70000,9,111930,0,0,0,0,0,0,42000,28000,14000,14000
20200520,061379,鈺齊永豐9A購02,0.71,0.71,0.70,0.70,+0.01,1.45,86000,3,60520,0,0,0,0,0,0,54000,32000,22000,22000
20200520,06137P,玉晶光永豐97售04,0.80,0.80,0.73,0.73,-0.12,-14.12,139000,10,104920,0,0,0,0,0,0,89000,50000,39000,39000
20200520,061380,巨大永豐9A購02,2.33,2.50,2.33,2.45,+0.19,8.41,93000,14,228940,0,0,0,0,0,0,27000,65000,-38000,-38000
20200520,061381,台灣50群益9B購07,1.74,1.74,1.74,1.74,+0.02,1.16,98000,2,170520,0,0,0,0,0,0,0,98000,-98000,-98000
20200520,061382,台灣50群益9C購02,2.07,2.07,2.07,2.07,+0.02,0.98,200000,1,414000,0,0,0,0,0,0,200000,0,200000,200000
20200520,061383,高股息群益9A購01,2.32,2.32,2.32,2.32,+0.01,0.43,55000,1,127600,0,0,0,0,0,0,55000,0,55000,55000
20200520,061384,T50反1群益9A購04,,,,,0.00,0.00,0,0,0,0,0,0,0,0,0,0,0,0,0
20200520,061385,上証2X群益9C購07,,,,,0.00,0.00,0,0,0,0,0,0,0,0,0,0,0,0,0
20200520,061386,道瓊銀群益9A購03,,,,,0.00,0.00,0,0,0,0,0,0,0,0,0,0,0,0,0
20200520,061387,鴻海群益9A購05,2.60,2.64,2.55,2.55,-0.09,-3.41,213000,8,561490,0,0,0,0,0,0,7000,208000,-201000,-201000
20200520,061388,台積電群益9A購05,2.36,2.36,2.28,2.28,-0.04,-1.72,19000,5,44290,0,0,0,0,0,0,18000,2000,16000,16000
20200520,061389,華新科群益9B購01,2.22,2.35,2.22,2.25,-0.01,-0.44,193000,5,440220,0,0,0,0,0,0,149000,44000,105000,105000
20200520,06138P,台積電中信99售01,,,,,0.00,0.00,0,0,0,0,0,0,0,0,0,0,0,0,0
20200520,061390,大立光群益9A購04,1.27,1.27,1.23,1.24,0.00,0.00,69000,3,87310,0,0,0,0,0,0,0,69000,-69000,-69000
20200520,061391,晶技群益9A購02,0.60,0.60,0.60,0.60,0.00,0.00,100000,1,60000,0,0,0,0,0,0,0,100000,-100000,-100000
20200520,061392,泰鼎群益9A購02,2.07,2.35,2.04,2.35,+0.19,8.8,896000,44,1940800,0,0,0,0,0,0,495000,391000,104000,104000
20200520,061393,緯穎群益9A購01,,,,,0.00,0.00,0,0,0,0,0,0,0,0,0,0,0,0,0
20200520,061394,FBVIX統一9B購01,0.77,0.77,0.76,0.77,+0.02,2.67,135000,3,102950,0,0,0,0,0,0,125000,10000,115000,115000
20200520,061395,健策統一9C購02,0.79,0.85,0.79,0.84,+0.05,6.33,665000,13,537970,0,0,0,0,0,0,220000,445000,-225000,-225000
20200520,061396,台灣50台新9C購03,,,,,0.00,0.00,0,0,0,0,0,0,0,0,0,0,0,0,0
20200520,061397,上銀台新9A購01,,,,,0.00,0.00,0,0,0,0,0,0,0,0,0,0,0,0,0
20200520,061398,力成中信9A購01,0.76,0.76,0.76,0.76,+0.01,1.33,50000,1,38000,0,0,0,0,0,0,0,50000,-50000,-50000
20200520,061399,喬山兆豐9B購01,1.73,1.83,1.73,1.83,+0.14,8.28,34000,5,60850,0,0,0,0,0,0,24000,10000,14000,14000
20200520,06139P,台積電中信99售02,,,,,0.00,0.00,0,0,0,0,0,0,0,0,0,0,0,0,0
20200520,061400,可成兆豐9B購02,1.11,1.11,1.10,1.10,0.00,0.00,13000,3,14350,0,0,0,0,0,0,0,13000,-13000,-13000
20200520,061401,華擎兆豐9B購01,1.24,1.37,1.24,1.36,+0.19,16.24,411000,24,542490,0,0,0,0,0,0,52000,344000,-292000,-292000
20200520,061402,矽創兆豐9B購01,1.83,1.83,1.67,1.67,-0.05,-2.91,27000,5,46720,0,0,0,0,0,0,15000,12000,3000,3000
20200520,061403,滬深2X國票9A購06,,,,,0.00,0.00,0,0,0,0,0,0,0,0,0,0,0,0,0
20200520,061404,臺指反國票04購01,,,,,0.00,0.00,0,0,0,0,0,0,0,0,0,0,0,0,0
20200520,061405,亞德客國票9B購01,3.06,3.06,2.95,2.95,+0.03,1.03,33000,2,100100,0,0,0,0,0,0,25000,8000,17000,17000
20200520,061406,華通國票9A購06,4.31,4.31,4.30,4.30,-0.04,-0.92,12000,2,51650,0,0,0,0,0,0,5000,7000,-2000,-2000
20200520,061407,鴻海國票9A購07,1.59,1.63,1.59,1.60,-0.03,-1.84,79000,5,126500,0,0,0,0,0,0,0,79000,-79000,-79000
20200520,061408,華新科國票9A購06,,,,,0.00,0.00,0,0,0,0,0,0,0,0,0,0,0,0,0
20200520,061409,力成國票9A購02,,,,,0.00,0.00,0,0,0,0,0,0,0,0,0,0,0,0,0
20200520,06140P,華新科群益97售06,4.22,4.36,4.22,4.36,-0.12,-2.68,51000,2,222220,0,0,0,0,0,0,1000,50000,-49000,-49000
20200520,061410,緯穎國票9A購03,6.40,6.40,5.65,5.65,-0.25,-4.24,6000,2,35400,0,0,0,0,0,0,4000,6000,-2000,-2000
20200520,061411,T50反1群益9A購05,0.54,0.55,0.53,0.55,-0.01,-1.79,372000,11,201320,0,0,0,0,0,0,26000,346000,-320000,-320000
20200520,061412,儒鴻群益9A購01,2.67,2.72,2.64,2.72,+0.09,3.42,72000,8,191910,0,0,0,0,0,0,66000,33000,33000,33000
20200520,061413,台勝科群益9A購01,1.47,1.62,1.44,1.58,+0.10,6.76,396000,16,601380,0,0,0,0,0,0,50000,346000,-296000,-296000
20200520,061414,牧德群益9B購02,0.98,1.17,0.98,1.15,+0.15,15.0,773000,16,848650,0,0,0,0,0,0,86000,682000,-596000,-596000
20200520,061415,健策群益9A購04,1.08,1.08,1.08,1.08,-0.06,-5.26,1000,1,1080,0,0,0,0,0,0,1000,1000,0,0
20200520,061416,聯茂群益9A購01,1.04,1.04,1.03,1.04,-0.06,-5.45,178000,5,184950,0,0,0,0,0,0,161000,17000,144000,144000
20200520,061417,力成群益9A購01,,,,,0.00,0.00,0,0,0,0,0,0,0,0,0,0,0,0,0
20200520,061418,世紀鋼群益9A購02,1.61,1.66,1.48,1.48,-0.12,-7.5,665000,17,1056610,0,0,0,0,0,0,416000,244000,172000,172000
20200520,061419,國巨元大9A購21,2.28,2.28,2.20,2.20,+0.11,5.26,72000,6,159560,0,0,0,0,0,0,2000,65000,-63000,-63000
20200520,06141P,大立光日盛97售01,3.22,3.22,3.16,3.16,-0.12,-3.66,10000,2,31900,0,0,0,0,0,0,5000,5000,0,0
20200520,061420,國巨元大9A購22,2.59,2.59,2.56,2.56,+0.16,6.67,75000,3,192750,0,0,0,0,0,0,25000,50000,-25000,-25000
20200520,061421,台積電元大9A購29,1.38,1.38,1.37,1.37,+0.01,0.74,4000,2,5500,0,0,0,0,0,0,2000,2000,0,0
20200520,061422,台積電元大9A購30,1.23,1.23,1.19,1.19,-0.01,-0.83,77000,4,94310,0,0,0,0,0,0,22000,50000,-28000,-28000
20200520,061423,廣達元大9A購01,2.21,2.21,2.08,2.12,-0.03,-1.4,595000,46,1291530,0,0,0,0,0,0,334000,180000,154000,154000
20200520,061424,華新科元大9A購18,2.03,2.03,2.03,2.03,+0.15,7.98,25000,1,50750,0,0,0,0,0,0,0,25000,-25000,-25000
20200520,061425,華新科元大9A購19,3.00,3.11,2.96,3.11,+0.13,4.36,77000,8,232670,0,0,0,0,0,0,77000,0,77000,77000
20200520,061426,玉晶光元大9A購15,1.29,1.32,1.28,1.32,+0.05,3.94,370000,6,477960,0,0,0,0,0,0,240000,130000,110000,110000
20200520,061427,旭富元大9A購02,1.45,1.50,1.43,1.44,-0.02,-1.37,507000,17,745000,0,0,0,0,0,0,370000,357000,13000,13000
20200520,061428,南六元大9A購01,3.12,3.25,2.99,3.14,+0.12,3.97,207000,12,658130,0,0,0,0,0,0,2000,205000,-203000,-203000
20200520,061429,南六元大9A購02,2.45,2.57,2.34,2.52,+0.13,5.44,49000,7,120440,0,0,0,0,0,0,3000,46000,-43000,-43000
20200520,06142P,台虹康和97售02,,,,,0.00,0.00,0,0,0,0,0,0,0,0,0,0,0,0,0
20200520,061430,致新元大9A購01,2.32,2.40,2.30,2.32,+0.09,4.04,351000,39,821500,0,0,0,0,0,0,341000,10000,331000,331000
20200520,061431,鈺齊元大9A購01,2.07,2.11,2.06,2.08,+0.06,2.97,106000,7,220360,0,0,0,0,0,0,38000,68000,-30000,-30000
20200520,061432,世紀鋼元大9A購05,1.28,1.28,1.17,1.17,-0.10,-7.87,51000,9,60480,0,0,0,0,0,0,41000,50000,-9000,-9000
20200520,061433,華通麥證9A購03,1.34,1.35,1.30,1.30,-0.04,-2.99,41000,5,53770,10000,31000,-21000,0,0,0,10000,31000,-21000,-21000
20200520,061434,國巨麥證9A購04,,,,,0.00,0.00,0,0,0,0,0,0,0,0,0,0,0,0,0
20200520,061435,元金2X凱基9C購03,1.56,1.56,1.55,1.55,+0.04,2.65,43000,3,66680,0,0,0,0,0,0,40000,3000,37000,37000
20200520,061436,上銀凱基9A購07,,,,,0.00,0.00,0,0,0,0,0,0,0,0,0,0,0,0,0
20200520,061437,燿華凱基9A購01,1.03,1.21,1.03,1.21,+0.18,17.48,512000,23,563700,0,0,0,0,0,0,102000,410000,-308000,-308000
20200520,061438,牧德凱基9B購02,1.35,1.57,1.34,1.55,+0.24,18.32,602000,19,876470,0,0,0,0,0,0,95000,507000,-412000,-412000
20200520,061439,寶成凱基9A購01,1.20,1.23,1.20,1.23,-0.02,-1.6,200000,6,244000,0,0,0,0,0,0,50000,150000,-100000,-100000
20200520,06143P,鴻海永豐97售02,,,,,0.00,0.00,0,0,0,0,0,0,0,0,0,0,0,0,0
20200520,061440,台灣50永豐9A購04,,,,,0.00,0.00,0,0,0,0,0,0,0,0,0,0,0,0,0
20200520,061441,大毅永豐9A購04,0.98,0.98,0.96,0.97,+0.04,4.3,61000,5,59140,0,0,0,0,0,0,0,61000,-61000,-61000
20200520,061442,玉晶光永豐9A購07,,,,,0.00,0.00,0,0,0,0,0,0,0,0,0,0,0,0,0
20200520,061443,大立光統一9C購02,0.92,0.94,0.92,0.94,+0.02,2.17,30000,2,28000,0,0,0,0,0,0,30000,0,30000,30000
20200520,061444,聯發科台新9A購01,3.68,3.68,3.68,3.68,+0.08,2.22,20000,1,73600,0,0,0,0,0,0,20000,0,20000,20000
20200520,061445,道瓊指中信9A購01,0.84,0.84,0.84,0.84,-0.03,-3.45,78000,2,65520,0,0,0,0,0,0,78000,0,78000,78000
20200520,061446,鴻海中信04購01,1.31,1.31,1.31,1.31,-0.01,-0.76,2000,1,2620,0,0,0,0,0,0,0,2000,-2000,-2000
20200520,061447,鴻海中信04購02,1.08,1.08,1.08,1.08,0.00,0.00,1000,1,1080,0,0,0,0,0,0,0,1000,-1000,-1000
20200520,061448,旺宏中信9A購02,0.74,0.76,0.74,0.76,+0.02,2.7,12000,2,8920,0,0,0,0,0,0,10000,2000,8000,8000
20200520,061449,大立光中信9C購02,0.84,0.86,0.84,0.86,-0.03,-3.37,100000,6,85000,0,0,0,0,0,0,50000,50000,0,0
20200520,06144P,台光電永豐97售01,0.46,0.49,0.46,0.49,+0.01,2.08,12000,2,5580,0,0,0,0,0,0,0,12000,-12000,-12000
20200520,061450,嘉晶中信9A購01,1.03,1.28,1.02,1.19,+0.21,21.43,882000,70,1007960,0,0,0,0,0,0,562000,311000,251000,251000
20200520,061451,南電中信9A購03,0.40,0.43,0.35,0.37,-0.03,-7.5,951000,46,378730,0,0,0,0,0,0,235000,676000,-441000,-441000
20200520,061452,大成鋼凱基9A購01,1.06,1.19,1.05,1.18,+0.13,12.38,277000,18,305900,0,0,0,0,0,0,20000,257000,-237000,-237000
20200520,061453,台達電凱基9B購01,1.37,1.37,1.37,1.37,-0.02,-1.44,207000,22,283590,0,0,0,0,0,0,207000,0,207000,207000
20200520,061454,國巨凱基9A購16,4.05,4.05,4.05,4.05,+0.17,4.38,2000,1,8100,0,0,0,0,0,0,0,2000,-2000,-2000
20200520,061455,京元電凱基9B購01,0.74,0.75,0.70,0.70,-0.08,-10.26,497000,30,357910,0,0,0,0,0,0,85000,377000,-292000,-292000
20200520,061456,玉晶光凱基9B購05,1.57,1.67,1.57,1.66,+0.07,4.4,75000,25,121610,0,0,0,0,0,0,45000,30000,15000,15000
20200520,061457,TPK凱基9A購01,0.91,0.95,0.91,0.91,0.00,0.00,258000,9,238660,0,0,0,0,0,0,180000,159000,21000,21000
20200520,061458,臻鼎凱基9A購02,1.22,1.33,1.22,1.32,+0.06,4.76,278000,12,358570,0,0,0,0,0,0,13000,173000,-160000,-160000
20200520,061459,台灣50群益9B購08,,,,,0.00,0.00,0,0,0,0,0,0,0,0,0,0,0,0,0
20200520,06145P,華新科永豐97售02,1.29,1.29,1.29,1.29,-0.13,-9.15,1000,1,1290,0,0,0,0,0,0,1000,0,1000,1000
20200520,061460,FBVIX群益9A購02,0.86,0.86,0.86,0.86,0.00,0.00,10000,1,8600,0,0,0,0,0,0,10000,0,10000,10000
20200520,061461,元金2X群益9A購01,1.29,1.30,1.29,1.30,+0.06,4.84,71000,2,92290,0,0,0,0,0,0,1000,70000,-69000,-69000
20200520,061462,國巨群益9A購11,1.88,1.88,1.85,1.85,+0.18,10.78,24000,4,44820,0,0,0,0,0,0,0,24000,-24000,-24000
20200520,061463,智邦群益9A購02,1.91,2.01,1.88,1.98,+0.08,4.21,105000,10,203330,0,0,0,0,0,0,56000,49000,7000,7000
20200520,061464,瑞昱群益9A購01,1.90,1.95,1.81,1.81,-0.05,-2.69,1455000,36,2665360,0,0,0,0,0,0,417000,1028000,-611000,-611000
20200520,061465,聯詠群益9A購01,1.96,2.06,1.96,2.04,+0.05,2.51,459000,12,914380,0,0,0,0,0,0,164000,295000,-131000,-131000
20200520,061466,創意群益9A購01,1.21,1.25,1.21,1.25,-0.02,-1.57,142000,3,172020,0,0,0,0,0,0,39000,103000,-64000,-64000
20200520,061467,嘉澤群益9A購01,4.32,4.32,4.32,4.32,+0.02,0.47,10000,1,43200,0,0,0,0,0,0,10000,0,10000,10000
20200520,061468,神達群益9A購01,1.96,2.12,1.96,2.09,+0.15,7.73,588000,24,1210050,17000,0,17000,0,0,0,80000,508000,-428000,-411000
20200520,061469,瑞祺群益9A購02,1.02,1.08,1.02,1.08,0.00,0.00,477000,13,496810,0,0,0,0,0,0,0,477000,-477000,-477000
20200520,06146P,S&P反1元大97售03,,,,,0.00,0.00,0,0,0,0,0,0,0,0,0,0,0,0,0
20200520,061470,鈺齊群益9A購02,1.47,1.49,1.46,1.47,+0.03,2.08,324000,11,477480,0,0,0,0,0,0,116000,208000,-92000,-92000
20200520,061471,台積電元大9A購31,1.41,1.41,1.37,1.37,-0.03,-2.14,90000,3,125900,0,0,0,0,0,0,20000,70000,-50000,-50000
20200520,061472,台積電元大9A購32,1.96,1.96,1.93,1.93,0.00,0.00,150000,3,291000,0,0,0,0,0,0,100000,50000,50000,50000
20200520,061473,台積電元大9A購33,1.44,1.44,1.40,1.41,-0.01,-0.7,120000,5,170600,0,0,0,0,0,0,40000,80000,-40000,-40000
20200520,061474,瑞昱元大9A購04,2.42,2.50,2.32,2.32,-0.06,-2.52,235000,24,568040,0,0,0,0,0,0,151000,100000,51000,51000
20200520,061475,漢唐元大9A購01,1.78,1.80,1.76,1.76,+0.01,0.57,403000,16,713910,0,0,0,0,0,0,105000,348000,-243000,-243000
20200520,061476,大毅元大9A購02,1.85,1.85,1.84,1.84,+0.05,2.79,204000,9,376700,0,0,0,0,0,0,55000,149000,-94000,-94000
20200520,061477,晶豪科元大9A購01,2.27,2.27,2.10,2.10,-0.17,-7.49,271000,14,602730,0,0,0,0,0,0,253000,18000,235000,235000
20200520,061478,奇鋐元大9A購01,1.88,2.01,1.88,1.99,+0.08,4.19,322000,21,626930,0,0,0,0,0,0,125000,197000,-72000,-72000
20200520,061479,泰碩元大9A購02,1.93,1.93,1.85,1.85,-0.12,-6.09,77000,3,147450,0,0,0,0,0,0,25000,52000,-27000,-27000
20200520,06147P,國巨元大97售05,1.48,1.49,1.40,1.44,-0.21,-12.73,178000,7,258120,0,0,0,0,0,0,118000,103000,15000,15000
20200520,061480,泰碩元大9B購01,1.69,1.69,1.62,1.63,-0.08,-4.68,166000,9,271240,0,0,0,0,0,0,71000,95000,-24000,-24000
20200520,061481,嘉澤元大9A購03,4.20,4.20,4.20,4.20,+0.14,3.45,2000,1,8400,0,0,0,0,0,0,2000,2000,0,0
20200520,061482,健策元大9C購01,2.93,3.06,2.93,3.06,-0.16,-4.97,97000,5,288830,0,0,0,0,0,0,4000,97000,-93000,-93000
20200520,061483,TPK元大9A購01,2.13,2.20,2.12,2.12,-0.03,-1.4,337000,17,732260,0,0,0,0,0,0,277000,85000,192000,192000
20200520,061484,華通兆豐9B購01,1.46,1.47,1.46,1.46,-0.01,-0.68,7000,5,10230,0,0,0,0,0,0,0,7000,-7000,-7000
20200520,061485,鴻海兆豐9A購01,1.23,1.23,1.20,1.20,0.00,0.00,17000,2,20760,0,0,0,0,0,0,0,17000,-17000,-17000
20200520,061486,國巨兆豐9B購02,,,,,0.00,0.00,0,0,0,0,0,0,0,0,0,0,0,0,0
20200520,061487,聯發科兆豐9B購02,3.22,3.22,3.22,3.22,+0.15,4.89,5000,1,16100,0,0,0,0,0,0,5000,0,5000,5000
20200520,061488,奇力新兆豐9A購01,1.08,1.09,1.07,1.07,+0.06,5.94,163000,5,176850,0,0,0,0,0,0,111000,52000,59000,59000
20200520,061489,高鐵兆豐9A購01,1.43,1.53,1.43,1.52,+0.09,6.29,773000,51,1142430,0,0,0,0,0,0,421000,335000,86000,86000
20200520,06148P,台積電元大97售17,,,,,0.00,0.00,0,0,0,0,0,0,0,0,0,0,0,0,0
20200520,061490,茂林兆豐9B購01,1.17,1.42,1.17,1.42,+0.30,26.79,58000,6,73640,0,0,0,0,0,0,20000,38000,-18000,-18000
20200520,061491,嘉聯益兆豐9B購01,1.10,1.11,1.09,1.09,0.00,0.00,113000,4,123840,0,0,0,0,0,0,109000,4000,105000,105000
20200520,061492,超眾兆豐9B購01,0.84,0.88,0.84,0.86,+0.03,3.61,101000,3,85880,0,0,0,0,0,0,101000,0,101000,101000
20200520,061493,T50反1國票9B購04,,,,,0.00,0.00,0,0,0,0,0,0,0,0,0,0,0,0,0
20200520,061494,聯發科國票9A購04,8.30,8.30,8.30,8.30,+0.40,5.06,1000,1,8300,0,0,0,0,0,0,0,1000,-1000,-1000
20200520,061495,聯發科國票9B購01,,,,,0.00,0.00,0,0,0,0,0,0,0,0,0,0,0,0,0
20200520,061496,華新科國票9A購07,,,,,0.00,0.00,0,0,0,0,0,0,0,0,0,0,0,0,0
20200520,061497,大立光國票9A購09,,,,,0.00,0.00,0,0,0,0,0,0,0,0,0,0,0,0,0
20200520,061498,大立光國票9A購10,2.66,2.66,2.66,2.66,+0.11,4.31,6000,1,15960,0,0,0,0,0,0,6000,0,6000,6000
20200520,061499,嘉晶國票9A購03,6.10,8.00,6.10,8.00,+2.20,37.93,15000,7,99650,0,0,0,0,0,0,5000,11000,-6000,-6000
20200520,06149P,台積電元大97售18,5.15,5.15,5.15,5.15,0.00,0.00,80000,1,412000,0,0,0,0,0,0,80000,80000,0,0
20200520,061500,京鼎國票9B購01,,,,,0.00,0.00,0,0,0,0,0,0,0,0,0,0,0,0,0
20200520,061501,嘉澤國票9A購01,7.00,7.00,7.00,7.00,+0.05,0.72,5000,1,35000,0,0,0,0,0,0,5000,0,5000,5000
20200520,061502,嘉澤國票9A購02,,,,,0.00,0.00,0,0,0,0,0,0,0,0,0,0,0,0,0
20200520,061503,臻鼎國票9B購01,2.74,3.04,2.74,3.04,+0.35,13.01,180000,11,516570,0,0,0,0,0,0,59000,121000,-62000,-62000
20200520,061504,祥碩國票9A購02,4.30,4.40,4.29,4.40,+0.40,10.0,4000,4,17380,0,0,0,0,0,0,1000,1000,0,0
20200520,061505,力成國票9A購03,3.31,3.31,3.19,3.19,-0.14,-4.2,52000,3,170900,0,0,0,0,0,0,45000,7000,38000,38000
20200520,061506,瑞祺國票9A購02,2.12,2.34,2.12,2.34,+0.19,8.84,361000,12,797030,0,0,0,0,0,0,83000,278000,-195000,-195000
20200520,061507,南電國票9A購05,3.92,4.12,3.54,3.64,-0.17,-4.46,38000,8,144490,0,0,0,0,0,0,10000,28000,-18000,-18000
20200520,061508,南六國泰9C購02,2.62,2.74,2.62,2.68,+0.11,4.28,153000,8,409240,0,0,0,0,0,0,72000,81000,-9000,-9000
20200520,061509,SP黃豆富邦9C購01,0.79,0.79,0.79,0.79,-0.01,-1.25,30000,2,23700,0,0,0,0,0,0,0,20000,-20000,-20000
20200520,06150P,奇力新元大97售06,1.42,1.45,1.42,1.45,-0.06,-3.97,60000,2,85500,0,0,0,0,0,0,0,60000,-60000,-60000
20200520,061510,嘉澤富邦9C購01,1.13,1.13,1.11,1.11,-0.01,-0.89,36000,3,40560,0,0,0,0,0,0,36000,0,36000,36000
20200520,061511,緯穎富邦9B購02,1.25,1.33,1.20,1.20,0.00,0.00,91000,16,112970,0,0,0,0,0,0,65000,57000,8000,8000
20200520,061512,國巨永豐9A購04,2.23,2.36,2.23,2.25,+0.15,7.14,68000,8,156850,0,0,0,0,0,0,0,68000,-68000,-68000
20200520,061513,華新科永豐9A購04,0.60,0.60,0.60,0.60,0.00,0.00,5000,1,3000,0,0,0,0,0,0,5000,0,5000,5000
20200520,061514,泰碩永豐9A購02,0.92,0.92,0.91,0.91,-0.08,-8.08,52000,2,47330,0,0,0,0,0,0,52000,0,52000,52000
20200520,061515,泰碩永豐9A購03,1.50,1.50,1.50,1.50,-0.04,-2.6,32000,1,48000,0,0,0,0,0,0,32000,0,32000,32000
20200520,061516,力成永豐9A購02,,,,,0.00,0.00,0,0,0,0,0,0,0,0,0,0,0,0,0
20200520,061517,瑞祺永豐9A購03,0.72,0.74,0.72,0.74,+0.06,8.82,359000,5,258940,0,0,0,0,0,0,0,359000,-359000,-359000
20200520,061518,達方永豐9A購02,0.86,0.89,0.86,0.87,+0.01,1.16,445000,12,393500,0,0,0,0,0,0,1000,444000,-443000,-443000
20200520,061519,T50反1中信03購01,0.78,0.78,0.78,0.78,0.00,0.00,10000,1,7800,0,0,0,0,0,0,0,10000,-10000,-10000
20200520,06151P,華新科元大97售07,1.91,1.94,1.85,1.94,+0.01,0.52,35000,3,66850,0,0,0,0,0,0,15000,20000,-5000,-5000
20200520,061520,健策中信9A購01,0.51,0.51,0.51,0.51,-0.06,-10.53,59000,1,30090,0,0,0,0,0,0,0,59000,-59000,-59000
20200520,061521,亞光兆豐9A購02,0.94,0.97,0.94,0.97,+0.01,1.04,404000,15,387630,0,0,0,0,0,0,151000,253000,-102000,-102000
20200520,061522,元黃金凱基01購01,,,,,0.00,0.00,0,0,0,0,0,0,0,0,0,0,0,0,0
20200520,061523,SP黃豆凱基9B購01,1.34,1.34,1.34,1.34,0.00,0.00,10000,1,13400,0,0,0,0,0,0,0,10000,-10000,-10000
20200520,061524,華通凱基9A購07,3.00,3.00,3.00,3.00,0.00,0.00,6000,1,18000,0,0,0,0,0,0,0,6000,-6000,-6000
20200520,061525,華新科凱基9A購13,2.20,2.20,2.20,2.20,+0.03,1.38,4000,1,8800,0,0,0,0,0,0,4000,0,4000,4000
20200520,061526,宏達電凱基9A購04,2.57,2.79,2.57,2.63,+0.11,4.37,24000,5,64000,0,0,0,0,0,0,21000,14000,7000,7000
20200520,061527,牧德凱基9A購02,1.26,1.49,1.25,1.44,+0.19,15.2,876000,29,1170680,0,0,0,0,0,0,642000,244000,398000,398000
20200520,061528,超眾凱基9A購04,,,,,0.00,0.00,0,0,0,0,0,0,0,0,0,0,0,0,0
20200520,061529,國巨台新9A購02,1.46,1.46,1.46,1.46,+0.06,4.29,10000,1,14600,0,0,0,0,0,0,10000,0,10000,10000
20200520,06152P,玉晶光元大98售06,,,,,0.00,0.00,0,0,0,0,0,0,0,0,0,0,0,0,0
20200520,061530,智邦台新9A購02,2.31,2.31,2.27,2.27,+0.09,4.13,6000,2,13820,0,0,0,0,0,0,1000,5000,-4000,-4000
20200520,061531,奇鋐台新9A購01,,,,,0.00,0.00,0,0,0,0,0,0,0,0,0,0,0,0,0
20200520,061532,和大統一9C購02,1.11,1.27,1.11,1.26,+0.11,9.57,1040000,37,1226680,0,0,0,0,0,0,377000,687000,-310000,-310000
20200520,061533,友達統一9C購02,0.98,1.02,0.96,0.96,-0.03,-3.03,224000,12,222100,0,0,0,0,0,0,199000,25000,174000,174000
20200520,061534,聯發科統一9C購04,,,,,0.00,0.00,0,0,0,0,0,0,0,0,0,0,0,0,0
20200520,061535,群創統一9C購01,0.95,0.96,0.95,0.95,+0.03,3.26,64000,3,60840,0,0,0,0,0,0,54000,10000,44000,44000
20200520,061536,華擎統一9C購02,0.76,0.84,0.76,0.84,+0.11,15.07,574000,16,463520,0,0,0,0,0,0,110000,464000,-354000,-354000
20200520,061537,SP黃豆群益9A購02,1.20,1.20,1.20,1.20,0.00,0.00,20000,2,24000,0,0,0,0,0,0,20000,0,20000,20000
20200520,061538,SP黃豆群益9A購03,0.75,0.75,0.75,0.75,0.00,0.00,499000,2,374250,0,0,0,0,0,0,0,499000,-499000,-499000
20200520,061539,國巨群益9B購03,5.80,5.80,5.65,5.70,+0.30,5.56,34000,6,196050,0,0,0,0,0,0,0,34000,-34000,-34000
20200520,06153P,健策元大97售04,0.77,0.79,0.77,0.79,-0.02,-2.47,109000,2,85110,0,0,0,0,0,0,109000,0,109000,109000
20200520,061540,台積電群益9A購07,2.84,2.84,2.80,2.82,0.00,0.00,52000,5,147100,0,0,0,0,0,0,40000,12000,28000,28000
20200520,061541,旺宏群益9A購03,2.80,2.80,2.80,2.80,-0.05,-1.75,10000,1,28000,0,0,0,0,0,0,0,10000,-10000,-10000
20200520,061542,旺宏群益9A購04,,,,,0.00,0.00,0,0,0,0,0,0,0,0,0,0,0,0,0
20200520,061543,南亞科群益9A購01,2.00,2.07,1.99,2.00,+0.07,3.63,188000,8,378820,0,0,0,0,0,0,52000,136000,-84000,-84000
20200520,061544,大毅群益9B購02,2.19,2.26,2.19,2.19,+0.15,7.35,55000,6,122370,0,0,0,0,0,0,0,55000,-55000,-55000
20200520,061545,華新科群益9A購09,1.89,2.00,1.89,1.91,-0.02,-1.04,180000,7,347620,0,0,0,0,0,0,98000,82000,16000,16000
20200520,061546,大立光群益9A購05,3.68,3.79,3.68,3.77,+0.09,2.45,25000,3,94560,0,0,0,0,0,0,0,25000,-25000,-25000
20200520,061547,禾伸堂群益9A購01,1.89,2.00,1.89,1.90,0.00,0.00,273000,11,531690,0,0,0,0,0,0,154000,119000,35000,35000
20200520,061548,聯詠群益9A購02,1.85,1.89,1.83,1.89,-0.01,-0.53,86000,3,159540,0,0,0,0,0,0,60000,26000,34000,34000
20200520,061549,泰碩群益9A購01,1.64,1.67,1.61,1.61,-0.13,-7.47,90000,5,148190,0,0,0,0,0,0,80000,90000,-10000,-10000
20200520,06154P,超眾元大98售01,,,,,0.00,0.00,0,0,0,0,0,0,0,0,0,0,0,0,0
20200520,061550,聯鈞群益9A購03,,,,,0.00,0.00,0,0,0,0,0,0,0,0,0,0,0,0,0
20200520,061551,GIS群益9A購01,3.17,3.21,3.17,3.21,+0.03,0.94,64000,4,204320,0,0,0,0,0,0,8000,56000,-48000,-48000
20200520,061552,南六群益9A購02,1.88,1.95,1.80,1.95,+0.15,8.33,132000,6,246150,0,0,0,0,0,0,80000,37000,43000,43000
20200520,061553,南電群益9A購03,0.34,0.84,0.34,0.74,-0.03,-3.9,610000,8,475570,0,0,0,0,0,0,343000,262000,81000,81000
20200520,061554,T50反1國票9B購05,,,,,0.00,0.00,0,0,0,0,0,0,0,0,0,0,0,0,0
20200520,061555,聯電國票9B購01,0.82,0.82,0.82,0.82,0.00,0.00,121000,2,99220,0,0,0,0,0,0,0,121000,-121000,-121000
20200520,061556,台積電國票9A購08,1.86,1.86,1.86,1.86,-0.01,-0.53,10000,1,18600,0,0,0,0,0,0,10000,0,10000,10000
20200520,061557,台積電國票9C購02,,,,,0.00,0.00,0,0,0,0,0,0,0,0,0,0,0,0,0
20200520,061558,旺宏國票9B購02,1.66,1.66,1.64,1.65,+0.02,1.23,142000,7,233900,0,0,0,0,0,0,89000,53000,36000,36000
20200520,061559,南亞科國票9A購02,3.05,3.05,3.05,3.05,+0.18,6.27,15000,1,45750,0,0,0,0,0,0,15000,0,15000,15000
20200520,06155P,智邦統一97售02,0.62,0.64,0.60,0.62,-0.06,-8.82,61000,9,37840,0,0,0,0,0,0,19000,42000,-23000,-23000
20200520,061560,友達國票9B購01,1.63,1.69,1.63,1.69,0.00,0.00,68000,5,111920,0,0,0,0,0,0,47000,21000,26000,26000
20200520,061561,義隆國票9A購02,1.36,1.44,1.36,1.44,+0.03,2.13,75000,3,104400,0,0,0,0,0,0,55000,20000,35000,35000
20200520,061562,群創國票9B購01,1.22,1.24,1.22,1.24,0.00,0.00,16000,2,19680,0,0,0,0,0,0,0,16000,-16000,-16000
20200520,061563,群創國票9B購02,,,,,0.00,0.00,0,0,0,0,0,0,0,0,0,0,0,0,0
20200520,061564,華擎國票9A購02,2.18,2.21,2.18,2.21,+0.40,22.1,165000,3,361500,0,0,0,0,0,0,0,165000,-165000,-165000
20200520,061565,滬深2X元大9A購08,,,,,0.00,0.00,0,0,0,0,0,0,0,0,0,0,0,0,0
20200520,061566,華通元大9A購10,3.44,3.44,3.44,3.44,-0.18,-4.97,18000,1,61920,0,0,0,0,0,0,0,18000,-18000,-18000
20200520,061567,華通元大9A購11,2.27,2.34,2.27,2.28,-0.03,-1.3,39000,4,89760,0,0,0,0,0,0,13000,26000,-13000,-13000
20200520,061568,國巨元大9A購25,3.06,3.12,3.06,3.10,0.00,0.00,107000,8,329420,0,0,0,0,0,0,73000,57000,16000,16000
20200520,061569,旺宏元大9A購14,,,,,0.00,0.00,0,0,0,0,0,0,0,0,0,0,0,0,0
20200520,06156P,大立光統一97售05,,,,,0.00,0.00,0,0,0,0,0,0,0,0,0,0,0,0,0
20200520,061570,瑞昱元大9A購05,2.05,2.08,1.94,1.96,-0.04,-2.0,239000,30,481110,0,0,0,0,0,0,152000,131000,21000,21000
20200520,061571,奇力新元大9A購03,2.52,2.58,2.46,2.46,+0.05,2.07,335000,11,853110,0,0,0,0,0,0,220000,115000,105000,105000
20200520,061572,奇力新元大9A購04,3.02,3.09,2.97,2.97,+0.10,3.48,278000,11,855340,0,0,0,0,0,0,250000,28000,222000,222000
20200520,061573,義隆元大9A購02,1.31,1.31,1.31,1.31,0.00,0.00,68000,1,89080,0,0,0,0,0,0,0,68000,-68000,-68000
20200520,061574,大毅元大9B購01,2.65,2.76,2.61,2.65,+0.07,2.71,162000,5,423840,0,0,0,0,0,0,151000,11000,140000,140000
20200520,061575,華新科元大9A購20,2.23,2.23,2.23,2.23,-0.01,-0.45,51000,2,113730,0,0,0,0,0,0,0,51000,-51000,-51000
20200520,061576,華新科元大9A購21,2.39,2.44,2.36,2.44,+0.06,2.52,59000,4,142180,0,0,0,0,0,0,8000,53000,-45000,-45000
20200520,061577,泰碩元大9A購03,1.55,1.55,1.50,1.50,-0.07,-4.46,104000,4,159300,0,0,0,0,0,0,20000,84000,-64000,-64000
20200520,061578,玉晶光元大9A購16,1.70,1.78,1.70,1.78,+0.09,5.33,65000,8,113780,0,0,0,0,0,0,35000,30000,5000,5000
20200520,061579,京鼎元大9A購02,2.25,2.28,2.25,2.28,-0.01,-0.44,52000,3,117300,0,0,0,0,0,0,10000,42000,-32000,-32000
20200520,06157P,聯鈞統一97售02,,,,,0.00,0.00,0,0,0,0,0,0,0,0,0,0,0,0,0
20200520,061580,華擎元大9A購06,1.55,1.70,1.53,1.70,+0.21,14.09,446000,16,725780,0,0,0,0,0,0,68000,378000,-310000,-310000
20200520,061581,貿聯元大9A購05,1.78,1.80,1.76,1.78,+0.04,2.3,220000,14,391640,0,0,0,0,0,0,68000,147000,-79000,-79000
20200520,061582,麗豐元大9A購01,1.70,1.75,1.65,1.70,-0.05,-2.86,267000,19,457500,0,0,0,0,0,0,199000,68000,131000,131000
20200520,061583,矽創元大9A購01,2.15,2.21,1.95,1.95,-0.20,-9.3,754000,63,1592440,0,0,0,0,0,0,663000,101000,562000,562000
20200520,061584,勤誠元大9A購01,1.60,1.60,1.58,1.58,-0.03,-1.86,11000,2,17580,0,0,0,0,0,0,1000,10000,-9000,-9000
20200520,061585,台積電富邦9B購06,0.66,0.66,0.65,0.66,0.00,0.00,50000,6,32700,0,0,0,0,0,0,30000,20000,10000,10000
20200520,061586,智邦富邦9A購02,0.92,0.92,0.92,0.92,+0.04,4.55,56000,2,51520,0,0,0,0,0,0,56000,0,56000,56000
20200520,061587,美律富邦9A購02,,,,,0.00,0.00,0,0,0,0,0,0,0,0,0,0,0,0,0
20200520,061588,聯發科富邦9B購07,1.60,1.68,1.59,1.61,+0.04,2.55,430000,30,692740,0,0,0,0,0,0,309000,161000,148000,148000
20200520,061589,世紀鋼富邦9B購01,0.68,0.69,0.62,0.62,-0.05,-7.46,453000,14,286520,0,0,0,0,0,0,347000,383000,-36000,-36000
20200520,06158P,玉晶光元富97售08,,,,,0.00,0.00,0,0,0,0,0,0,0,0,0,0,0,0,0
20200520,061590,金寶永豐9A購01,0.57,0.58,0.54,0.58,0.00,0.00,432000,9,243690,0,0,0,0,0,0,0,432000,-432000,-432000
20200520,061591,旺宏永豐9A購02,,,,,0.00,0.00,0,0,0,0,0,0,0,0,0,0,0,0,0
20200520,061592,義隆永豐9A購03,0.67,0.67,0.67,0.67,+0.01,1.52,30000,1,20100,0,0,0,0,0,0,0,30000,-30000,-30000
20200520,061593,智原永豐9A購01,0.72,0.77,0.72,0.77,+0.06,8.45,80000,3,59060,0,0,0,0,0,0,10000,70000,-60000,-60000
20200520,061594,玉晶光永豐9A購08,,,,,0.00,0.00,0,0,0,0,0,0,0,0,0,0,0,0,0
20200520,061595,智易永豐9A購02,1.11,1.11,1.06,1.06,-0.02,-1.85,23000,4,24920,0,0,0,0,0,0,19000,4000,15000,15000
20200520,061596,健策永豐9A購03,0.81,0.84,0.81,0.84,-0.05,-5.62,111000,5,91300,0,0,0,0,0,0,5000,111000,-106000,-106000
20200520,061597,南六永豐9A購04,1.14,1.26,1.14,1.26,+0.04,3.28,21000,3,24360,0,0,0,0,0,0,11000,10000,1000,1000
20200520,061598,南電永豐9A購04,0.46,0.50,0.44,0.45,-0.03,-6.25,830000,22,388450,0,0,0,0,0,0,735000,55000,680000,680000
20200520,061599,元金反中信9C購01,,,,,0.00,0.00,0,0,0,0,0,0,0,0,0,0,0,0,0
20200520,06159P,牧德元富97售02,,,,,0.00,0.00,0,0,0,0,0,0,0,0,0,0,0,0,0
20200520,061600,聯電凱基9B購01,0.72,0.72,0.71,0.71,-0.01,-1.39,120000,3,85500,0,0,0,0,0,0,90000,30000,60000,60000
20200520,061601,台積電凱基9A購26,,,,,0.00,0.00,0,0,0,0,0,0,0,0,0,0,0,0,0
20200520,061602,旺宏凱基9A購06,,,,,0.00,0.00,0,0,0,0,0,0,0,0,0,0,0,0,0
20200520,061603,瑞昱凱基9A購02,1.43,1.46,1.35,1.39,-0.03,-2.11,387000,40,553470,0,0,0,0,0,0,306000,13000,293000,293000
20200520,061604,台光電凱基9B購01,,,,,0.00,0.00,0,0,0,0,0,0,0,0,0,0,0,0,0
20200520,061605,華新科凱基9A購14,0.69,0.73,0.69,0.70,0.00,0.00,260000,18,186850,0,0,0,0,0,0,238000,25000,213000,213000
20200520,061606,景碩凱基9A購02,,,,,0.00,0.00,0,0,0,0,0,0,0,0,0,0,0,0,0
20200520,061607,台表科凱基9B購02,1.80,2.08,1.68,2.00,+0.33,19.76,1583000,121,2827480,0,0,0,0,0,0,722000,998000,-276000,-276000
20200520,061608,SP黃豆統一9A購01,,,,,0.00,0.00,0,0,0,0,0,0,0,0,0,0,0,0,0
20200520,061609,華新科統一9C購01,0.48,0.48,0.47,0.47,-0.01,-2.08,25000,2,11800,0,0,0,0,0,0,0,25000,-25000,-25000
20200520,06160P,台達電群益97售01,1.06,1.06,1.06,1.06,+0.04,3.92,20000,2,21200,0,0,0,0,0,0,0,20000,-20000,-20000
20200520,061610,力成統一9C購01,0.68,0.68,0.66,0.66,-0.02,-2.94,75000,3,50500,0,0,0,0,0,0,50000,25000,25000,25000
20200520,061611,南六統一01購01,0.78,0.81,0.73,0.78,+0.02,2.63,100000,6,79260,0,0,0,0,0,0,39000,61000,-22000,-22000
20200520,061612,南六統一9A購01,0.97,1.08,0.97,1.04,+0.03,2.97,447000,15,470350,0,0,0,0,0,0,112000,335000,-223000,-223000
20200520,061613,南六統一9C購01,0.95,1.04,0.95,0.99,+0.01,1.02,260000,11,260010,0,0,0,0,0,0,177000,81000,96000,96000
20200520,061614,亞德客群益9A購01,4.08,4.08,4.08,4.08,+0.10,2.51,2000,1,8160,0,0,0,0,0,0,0,2000,-2000,-2000
20200520,061615,鴻海群益9A購06,2.72,2.77,2.68,2.68,-0.07,-2.55,113000,5,307220,0,0,0,0,0,0,17000,103000,-86000,-86000
20200520,061616,鴻海群益9A購07,1.96,1.98,1.93,1.93,-0.19,-8.96,123000,7,240740,0,0,0,0,0,0,5000,121000,-116000,-116000
20200520,061617,微星群益9A購02,3.57,3.57,3.43,3.49,+0.02,0.58,321000,10,1113310,0,0,0,0,0,0,310000,11000,299000,299000
20200520,061618,友達群益9A購04,1.35,1.40,1.34,1.38,0.00,0.00,304000,9,418350,0,0,0,0,0,0,206000,98000,108000,108000
20200520,061619,大立光群益9B購01,2.58,2.59,2.57,2.57,-0.10,-3.75,66000,3,170420,0,0,0,0,0,0,37000,44000,-7000,-7000
20200520,06161P,聯發科群益97售03,1.61,1.61,1.35,1.58,-0.20,-11.24,99000,13,148130,0,0,0,0,0,0,10000,88000,-78000,-78000
20200520,061620,禾伸堂群益9A購02,1.65,1.67,1.55,1.56,-0.01,-0.64,84000,8,138390,0,0,0,0,0,0,45000,39000,6000,6000
20200520,061621,健策群益9A購05,1.84,1.99,1.84,1.98,+0.09,4.76,192000,10,366910,0,0,0,0,0,0,24000,169000,-145000,-145000
20200520,061622,臻鼎群益9A購01,2.17,2.33,2.17,2.33,+0.22,10.43,57000,5,125490,0,0,0,0,0,0,3000,20000,-17000,-17000
20200520,061623,祥碩群益9A購01,6.25,6.30,5.60,6.30,+0.50,8.62,8000,3,46850,0,0,0,0,0,0,5000,3000,2000,2000
20200520,061624,中租群益9A購01,2.93,2.93,2.93,2.93,+0.06,2.09,30000,2,87900,0,0,0,0,0,0,30000,0,30000,30000
20200520,061625,聯茂群益9A購02,1.10,1.12,1.09,1.10,-0.08,-6.78,255000,8,284190,0,0,0,0,0,0,250000,66000,184000,184000
20200520,061626,超眾群益9A購02,2.10,2.16,2.06,2.06,-0.05,-2.37,104000,4,222000,0,0,0,0,0,0,30000,101000,-71000,-71000
20200520,061627,台表科群益9A購01,3.23,3.27,3.23,3.23,0.00,0.00,33000,5,107190,0,0,0,0,0,0,25000,0,25000,25000
20200520,061628,緯穎群益9A購04,3.53,3.60,3.23,3.23,-0.12,-3.58,55000,10,189840,0,0,0,0,0,0,31000,24000,7000,7000
20200520,061629,FBVIX元大9A購01,,,,,0.00,0.00,0,0,0,0,0,0,0,0,0,0,0,0,0
20200520,06162P,大立光群益97售02,,,,,0.00,0.00,0,0,0,0,0,0,0,0,0,0,0,0,0
20200520,061630,FBVIX元大9A購02,,,,,0.00,0.00,0,0,0,0,0,0,0,0,0,0,0,0,0
20200520,061631,SP黃豆元大9A購05,0.76,0.77,0.76,0.77,+0.01,1.32,5000,2,3810,0,0,0,0,0,0,4000,1000,3000,3000
20200520,061632,SP黃豆元大9A購06,,,,,0.00,0.00,0,0,0,0,0,0,0,0,0,0,0,0,0
20200520,061633,統一元大9A購01,2.37,2.43,2.36,2.42,+0.08,3.42,202000,8,486390,0,0,0,0,0,0,79000,123000,-44000,-44000
20200520,061634,遠東新元大9A購01,2.26,2.44,2.17,2.42,+0.11,4.76,942000,61,2178750,0,0,0,0,0,0,737000,432000,305000,305000
20200520,061635,台積電元大9A購34,,,,,0.00,0.00,0,0,0,0,0,0,0,0,0,0,0,0,0
20200520,061636,聯發科元大9A購11,,,,,0.00,0.00,0,0,0,0,0,0,0,0,0,0,0,0,0
20200520,061637,華新科元大9A購22,1.63,1.63,1.63,1.63,+0.13,8.67,54000,2,88020,0,0,0,0,0,0,0,54000,-54000,-54000
20200520,061638,國泰金元大9A購03,2.39,2.48,2.39,2.48,+0.09,3.77,264000,14,637420,0,0,0,0,0,0,190000,74000,116000,116000
20200520,061639,晶豪科元大9A購02,3.08,3.08,2.84,2.85,-0.23,-7.47,308000,20,909120,0,0,0,0,0,0,279000,74000,205000,205000
20200520,06163P,聯詠群益97售01,1.18,1.24,1.14,1.24,-0.01,-0.8,190000,3,229000,0,0,0,0,0,0,0,190000,-190000,-190000
20200520,061640,智原元大9A購01,2.20,2.30,2.20,2.27,+0.14,6.57,253000,20,571040,0,0,0,0,0,0,24000,229000,-205000,-205000
20200520,061641,玉晶光元大9A購17,2.12,2.15,2.12,2.14,+0.09,4.39,80000,3,170300,0,0,0,0,0,0,20000,60000,-40000,-40000
20200520,061642,創意元大9A購04,1.35,1.35,1.30,1.35,+0.03,2.27,921000,29,1235010,0,0,0,0,0,0,267000,703000,-436000,-436000
20200520,061643,嘉澤元大9A購05,4.62,4.65,4.56,4.56,+0.04,0.88,40000,6,184470,0,0,0,0,0,0,30000,18000,12000,12000
20200520,061644,健策元大9C購02,2.28,2.41,2.27,2.41,-0.11,-4.37,80000,7,186390,0,0,0,0,0,0,16000,70000,-54000,-54000
20200520,061645,超眾元大9A購06,1.48,1.48,1.43,1.43,-0.05,-3.38,101000,3,148220,0,0,0,0,0,0,33000,81000,-48000,-48000
20200520,061646,力成元大9A購02,1.40,1.41,1.33,1.33,-0.05,-3.62,102000,8,141320,0,0,0,0,0,0,102000,0,102000,102000
20200520,061647,南六元大9A購03,2.51,2.62,2.36,2.52,+0.04,1.61,137000,8,345660,0,0,0,0,0,0,9000,128000,-119000,-119000
20200520,061648,緯穎元大9A購04,3.59,3.59,3.51,3.51,-0.09,-2.5,2000,2,7100,0,0,0,0,0,0,1000,1000,0,0
20200520,061649,緯穎元大9A購06,3.84,3.94,3.84,3.94,+0.20,5.35,46000,7,177950,0,0,0,0,0,0,46000,0,46000,46000
20200520,06164P,臺股指凱基97售04,,,,,0.00,0.00,0,0,0,0,0,0,0,0,0,0,0,0,0
20200520,061650,南電元大9A購07,1.62,1.70,1.51,1.51,-0.07,-4.43,934000,29,1494660,0,0,0,0,0,0,441000,463000,-22000,-22000
20200520,061651,世紀鋼元大9C購02,2.52,2.52,2.52,2.52,-0.15,-5.62,25000,1,63000,0,0,0,0,0,0,0,25000,-25000,-25000
20200520,061652,T50反1國票9C購01,,,,,0.00,0.00,0,0,0,0,0,0,0,0,0,0,0,0,0
20200520,061653,上証2X國票9A購02,,,,,0.00,0.00,0,0,0,0,0,0,0,0,0,0,0,0,0
20200520,061654,旺宏國票9A購02,,,,,0.00,0.00,0,0,0,0,0,0,0,0,0,0,0,0,0
20200520,061655,微星國票9A購01,5.40,5.40,5.40,5.40,+0.15,2.86,4000,1,21600,0,0,0,0,0,0,0,4000,-4000,-4000
20200520,061656,華新科國票9A購08,2.27,2.40,2.27,2.40,+0.09,3.9,54000,6,126150,0,0,0,0,0,0,23000,31000,-8000,-8000
20200520,061657,智原國票9A購01,2.62,2.62,2.62,2.62,+0.08,3.15,12000,1,31440,0,0,0,0,0,0,12000,0,12000,12000
20200520,061658,聯茂富邦9A購03,0.40,0.40,0.39,0.39,-0.03,-7.14,167000,27,65530,0,0,0,0,0,0,165000,2000,163000,163000
20200520,061659,信邦永豐9A購01,1.04,1.11,1.01,1.01,-0.02,-1.94,454000,28,474780,0,0,0,0,0,0,101000,333000,-232000,-232000
20200520,06165P,臺股指凱基9A售03,2.15,2.15,2.15,2.15,-0.01,-0.46,10000,1,21500,0,0,0,0,0,0,0,10000,-10000,-10000
20200520,061660,禾伸堂永豐9A購01,0.83,0.85,0.82,0.82,0.00,0.00,173000,5,145890,0,0,0,0,0,0,52000,121000,-69000,-69000
20200520,061661,京鼎永豐9A購02,1.19,1.19,1.16,1.19,0.00,0.00,204000,7,240110,0,0,0,0,0,0,104000,100000,4000,4000
20200520,061662,瑞儀永豐9A購02,0.98,1.04,0.98,1.04,0.00,0.00,323000,10,329620,0,0,0,0,0,0,86000,323000,-237000,-237000
20200520,061663,南六永豐9A購05,1.10,1.13,1.08,1.08,-0.02,-1.82,241000,7,268520,0,0,0,0,0,0,110000,131000,-21000,-21000
20200520,061664,上銀中信9A購01,,,,,0.00,0.00,0,0,0,0,0,0,0,0,0,0,0,0,0
20200520,061665,旺宏中信9C購01,,,,,0.00,0.00,0,0,0,0,0,0,0,0,0,0,0,0,0
20200520,061666,友達中信01購01,0.97,0.99,0.96,0.99,+0.03,3.12,161000,6,157160,30000,0,30000,0,0,0,31000,130000,-99000,-69000
20200520,061667,友達中信9A購02,0.81,0.85,0.81,0.85,+0.06,7.59,93000,4,76620,0,0,0,0,0,0,63000,30000,33000,33000
20200520,061668,信邦中信9B購01,1.04,1.10,1.00,1.00,0.00,0.00,526000,17,556730,0,0,0,0,0,0,96000,430000,-334000,-334000
20200520,061669,崇越中信9A購01,0.74,0.74,0.74,0.74,+0.02,2.78,266000,4,196840,0,0,0,0,0,0,133000,133000,0,0
20200520,06166P,大立光國票98售01,,,,,0.00,0.00,0,0,0,0,0,0,0,0,0,0,0,0,0
20200520,061670,台灣50元大9A購20,1.87,1.87,1.87,1.87,0.00,0.00,5000,1,9350,0,0,0,0,0,0,0,5000,-5000,-5000
20200520,061671,台灣50元大9A購21,,,,,0.00,0.00,0,0,0,0,0,0,0,0,0,0,0,0,0
20200520,061672,臺指反元大01購05,,,,,0.00,0.00,0,0,0,0,0,0,0,0,0,0,0,0,0
20200520,061673,仁寶元大9B購01,1.34,1.34,1.32,1.32,-0.03,-2.22,138000,4,184880,0,0,0,0,0,0,70000,68000,2000,2000
20200520,061674,聯發科元大9A購12,6.75,6.75,6.75,6.75,+0.15,2.27,10000,1,67500,0,0,0,0,0,0,10000,0,10000,10000
20200520,061675,華新科元大9A購23,1.48,1.48,1.48,1.48,+0.11,8.03,68000,2,100640,0,0,0,0,0,0,0,68000,-68000,-68000
20200520,061676,新光金元大9A購03,0.93,0.95,0.93,0.95,+0.01,1.06,153000,8,143070,0,0,0,0,0,0,114000,39000,75000,75000
20200520,061677,泰碩元大9A購05,1.47,1.47,1.47,1.47,0.00,0.00,5000,1,7350,0,0,0,0,0,0,0,5000,-5000,-5000
20200520,061678,玉晶光元大9B購04,1.99,1.99,1.99,1.99,+0.07,3.65,9000,1,17910,0,0,0,0,0,0,9000,9000,0,0
20200520,061679,健策元大9B購04,1.16,1.20,1.16,1.20,-0.06,-4.76,82000,3,97420,0,0,0,0,0,0,22000,60000,-38000,-38000
20200520,06167P,欣興國票97售05,1.52,1.53,1.52,1.53,-0.06,-3.77,5000,4,7640,0,0,0,0,0,0,1000,4000,-3000,-3000
20200520,061680,崇越元大9A購01,1.63,1.63,1.61,1.61,-0.03,-1.83,178000,8,289680,0,0,0,0,0,0,175000,3000,172000,172000
20200520,061681,南電元大9A購08,0.95,1.01,0.90,0.90,-0.06,-6.25,110000,8,107720,0,0,0,0,0,0,90000,20000,70000,70000
20200520,061682,南電元大9B購01,1.06,1.12,1.01,1.04,-0.03,-2.8,321000,24,336950,0,0,0,0,0,0,107000,214000,-107000,-107000
20200520,061683,台灣50群益9B購09,0.96,0.96,0.96,0.96,-0.03,-3.03,10000,1,9600,0,0,0,0,0,0,10000,0,10000,10000
20200520,061684,T50反1群益9A購06,1.02,1.04,1.02,1.04,0.00,0.00,45000,3,46200,0,0,0,0,0,0,20000,25000,-5000,-5000
20200520,061685,道瓊反群益9A購03,,,,,0.00,0.00,0,0,0,0,0,0,0,0,0,0,0,0,0
20200520,061686,SP黃豆群益9A購04,,,,,0.00,0.00,0,0,0,0,0,0,0,0,0,0,0,0,0
20200520,061687,大成鋼群益9A購01,1.55,1.79,1.54,1.79,+0.20,12.58,523000,18,861150,0,0,0,0,0,0,98000,425000,-327000,-327000
20200520,061688,華通群益9A購07,2.63,2.63,2.50,2.50,-0.18,-6.72,34000,2,88770,0,0,0,0,0,0,0,34000,-34000,-34000
20200520,061689,國巨群益9A購12,3.57,3.89,3.57,3.78,+0.49,14.89,141000,22,524580,0,0,0,0,0,0,34000,113000,-79000,-79000
20200520,06168P,台表科國票97售06,1.14,1.14,0.93,0.93,0.00,0.00,11000,2,10440,0,0,0,0,0,0,0,11000,-11000,-11000
20200520,061690,旺宏群益9A購05,2.71,2.71,2.71,2.71,+0.02,0.74,5000,1,13550,0,0,0,0,0,0,5000,0,5000,5000
20200520,061691,聯發科群益9A購03,,,,,0.00,0.00,0,0,0,0,0,0,0,0,0,0,0,0,0
20200520,061692,聯發科群益9A購04,5.50,5.50,5.50,5.50,+0.15,2.8,10000,1,55000,0,0,0,0,0,0,10000,0,10000,10000
20200520,061693,華新科群益9B購02,2.37,2.49,2.35,2.40,-0.03,-1.23,250000,10,605490,0,0,0,0,0,0,164000,89000,75000,75000
20200520,061694,玉山金群益9A購01,2.34,2.34,2.34,2.34,+0.01,0.43,2000,1,4680,0,0,0,0,0,0,2000,2000,0,0
20200520,061695,群創群益9A購01,0.84,0.88,0.82,0.82,-0.06,-6.82,422000,6,356660,0,0,0,0,0,0,185000,237000,-52000,-52000
20200520,061696,南茂群益9A購01,1.51,1.60,1.51,1.60,+0.08,5.26,258000,8,397970,0,0,0,0,0,0,49000,209000,-160000,-160000
20200520,061697,世紀鋼群益9A購03,2.17,2.17,2.17,2.17,+0.02,0.93,10000,2,21700,0,0,0,0,0,0,0,10000,-10000,-10000
20200520,061698,智邦國票9A購04,,,,,0.00,0.00,0,0,0,0,0,0,0,0,0,0,0,0,0
20200520,061699,燿華國票9A購01,1.75,1.92,1.75,1.92,+0.35,22.29,27000,4,48740,0,0,0,0,0,0,27000,0,27000,27000
20200520,06169P,華新科元富97售02,3.01,3.03,2.86,3.03,+0.01,0.33,15000,4,43430,0,0,0,0,0,0,1000,14000,-13000,-13000
20200520,061700,瑞昱國票9A購02,1.92,1.98,1.84,1.85,-0.06,-3.14,137000,8,265010,0,0,0,0,0,0,71000,71000,0,0
20200520,061701,友達國票9B購02,1.00,1.03,1.00,1.03,+0.05,5.1,96000,2,96720,0,0,0,0,0,0,72000,24000,48000,48000
20200520,061702,奇鋐國票9A購02,2.82,2.97,2.82,2.96,0.00,0.00,32000,5,92850,0,0,0,0,0,0,0,32000,-32000,-32000
20200520,061703,信邦國票9A購01,2.61,2.69,2.49,2.49,-0.04,-1.58,225000,14,589620,0,10000,-10000,0,0,0,20000,205000,-185000,-195000
20200520,061704,景碩國票9A購01,2.15,2.15,2.15,2.15,0.00,0.00,40000,1,86000,0,0,0,0,0,0,0,40000,-40000,-40000
20200520,061705,健策國票9A購06,4.15,4.15,4.15,4.15,-0.40,-8.79,5000,1,20750,0,0,0,0,0,0,5000,0,5000,5000
20200520,061706,旭富國票9A購02,1.73,1.78,1.72,1.78,+0.03,1.71,102000,6,178530,0,0,0,0,0,0,34000,68000,-34000,-34000
20200520,061707,超眾國票9B購01,2.03,2.04,1.98,1.98,-0.06,-2.94,49000,3,99120,0,0,0,0,0,0,37000,12000,25000,25000
20200520,061708,同欣電國票9A購02,2.14,2.33,2.11,2.11,-0.05,-2.31,213000,16,466580,0,0,0,0,0,0,121000,162000,-41000,-41000
20200520,061709,SP黃豆凱基01購02,,,,,0.00,0.00,0,0,0,0,0,0,0,0,0,0,0,0,0
20200520,06170P,禾伸堂元富97售02,0.44,0.44,0.41,0.44,-0.05,-10.2,98000,7,42840,0,0,0,0,0,0,30000,68000,-38000,-38000
20200520,061710,國巨凱基9A購18,,,,,0.00,0.00,0,0,0,0,0,0,0,0,0,0,0,0,0
20200520,061711,台積電凱基9A購27,,,,,0.00,0.00,0,0,0,0,0,0,0,0,0,0,0,0,0
20200520,061712,旺宏凱基9A購08,1.06,1.06,1.06,1.06,0.00,0.00,10000,1,10600,0,0,0,0,0,0,0,10000,-10000,-10000
20200520,061713,華邦電凱基9A購01,1.14,1.14,1.14,1.14,0.00,0.00,10000,1,11400,0,0,0,0,0,0,0,10000,-10000,-10000
20200520,061714,華新科凱基9A購15,1.05,1.05,1.05,1.05,+0.05,5.0,10000,1,10500,0,0,0,0,0,0,10000,0,10000,10000
20200520,061715,牧德凱基9B購03,1.27,1.47,1.27,1.46,+0.20,15.87,400000,19,549200,0,0,0,0,0,0,80000,320000,-240000,-240000
20200520,061716,瑞儀凱基9B購01,0.71,0.76,0.71,0.75,+0.02,2.74,383000,14,281110,0,0,0,0,0,0,88000,285000,-197000,-197000
20200520,061717,力成凱基9B購01,0.90,0.90,0.89,0.89,+0.01,1.14,113000,4,100770,0,0,0,0,0,0,113000,0,113000,113000
20200520,061718,GIS凱基9B購01,1.01,1.01,1.01,1.01,0.00,0.00,127000,2,128270,0,0,0,0,0,0,0,127000,-127000,-127000
20200520,061719,緯穎凱基9A購06,4.24,4.32,4.21,4.24,-0.10,-2.3,146000,11,620610,0,0,0,0,0,0,111000,45000,66000,66000
20200520,06171P,台積電統一97售06,,,,,0.00,0.00,0,0,0,0,0,0,0,0,0,0,0,0,0
20200520,061720,智邦國泰9C購01,1.54,1.60,1.51,1.57,+0.05,3.29,684000,35,1066150,0,0,0,0,0,0,439000,291000,148000,148000
20200520,061721,道瓊反富邦9B購01,,,,,0.00,0.00,0,0,0,0,0,0,0,0,0,0,0,0,0
20200520,061722,健策永豐9B購03,0.82,0.82,0.82,0.82,-0.07,-7.87,44000,1,36080,0,0,0,0,0,0,0,44000,-44000,-44000
20200520,061723,嘉聯益永豐9A購03,0.69,0.69,0.69,0.69,+0.03,4.55,14000,1,9660,0,0,0,0,0,0,0,14000,-14000,-14000
20200520,061724,訊芯永豐9A購01,0.64,0.65,0.61,0.64,+0.02,3.23,238000,37,151050,0,0,0,0,0,0,170000,18000,152000,152000
20200520,061725,國巨麥證9A購05,,,,,0.00,0.00,0,0,0,0,0,0,0,0,0,0,0,0,0
20200520,061726,台積電麥證9A購05,1.45,1.46,1.42,1.42,-0.03,-2.07,96000,6,139170,75000,11000,64000,0,0,0,75000,11000,64000,64000
20200520,061727,旺宏麥證9A購04,,,,,0.00,0.00,0,0,0,0,0,0,0,0,0,0,0,0,0
20200520,061728,華新科麥證9A購02,,,,,0.00,0.00,0,0,0,0,0,0,0,0,0,0,0,0,0
20200520,061729,祥碩麥證9A購02,,,,,0.00,0.00,0,0,0,0,0,0,0,0,0,0,0,0,0
20200520,06172P,台虹永豐97售02,0.55,0.55,0.55,0.55,+0.01,1.85,50000,1,27500,0,0,0,0,0,0,0,50000,-50000,-50000
20200520,061730,旺宏統一01購02,1.12,1.12,1.12,1.12,0.00,0.00,10000,1,11200,0,0,0,0,0,0,0,10000,-10000,-10000
20200520,061731,旺宏統一9B購06,1.18,1.18,1.18,1.18,+0.01,0.85,50000,1,59000,0,0,0,0,0,0,0,50000,-50000,-50000
20200520,061732,智邦中信9B購01,0.73,0.73,0.73,0.73,-0.03,-3.95,10000,1,7300,0,0,0,0,0,0,10000,0,10000,10000
20200520,061733,聯發科中信01購01,1.28,1.30,1.28,1.30,+0.05,4.0,5000,3,6460,0,0,0,0,0,0,2000,3000,-1000,-1000
20200520,061734,全新中信9B購02,0.59,0.59,0.56,0.56,-0.07,-11.11,115000,3,65100,0,0,0,0,0,0,30000,85000,-55000,-55000
20200520,061735,上銀凱基9B購01,,,,,0.00,0.00,0,0,0,0,0,0,0,0,0,0,0,0,0
20200520,061736,國巨凱基9B購05,,,,,0.00,0.00,0,0,0,0,0,0,0,0,0,0,0,0,0
20200520,061737,南亞科凱基9B購01,,,,,0.00,0.00,0,0,0,0,0,0,0,0,0,0,0,0,0
20200520,061738,聯發科凱基9B購04,,,,,0.00,0.00,0,0,0,0,0,0,0,0,0,0,0,0,0
20200520,061739,奇力新凱基9C購01,0.82,0.82,0.78,0.78,+0.04,5.41,16000,3,12680,0,0,0,0,0,0,0,16000,-16000,-16000
20200520,06173P,華通元大97售02,1.54,1.58,1.46,1.50,0.00,0.00,37000,8,57700,0,0,0,0,0,0,1000,36000,-35000,-35000
20200520,061740,華新科凱基03購01,0.76,0.78,0.76,0.78,+0.05,6.85,87000,4,67460,0,0,0,0,0,0,20000,67000,-47000,-47000
20200520,061741,新光金凱基9B購01,0.94,0.96,0.94,0.96,+0.02,2.13,65000,3,61500,0,0,0,0,0,0,45000,20000,25000,25000
20200520,061742,奇鋐凱基9B購01,0.82,0.89,0.82,0.89,0.00,0.00,177000,8,153420,0,0,0,0,0,0,13000,164000,-151000,-151000
20200520,061743,祥碩凱基9B購02,2.02,2.28,2.02,2.24,+0.26,13.13,292000,23,646030,0,0,0,0,0,0,82000,240000,-158000,-158000
20200520,061744,超眾凱基9B購02,,,,,0.00,0.00,0,0,0,0,0,0,0,0,0,0,0,0,0
20200520,061745,南電凱基9B購02,0.50,0.55,0.49,0.49,-0.04,-7.55,238000,6,122220,0,0,0,0,0,0,230000,8000,222000,222000
20200520,061746,國巨統一9C購07,,,,,0.00,0.00,0,0,0,0,0,0,0,0,0,0,0,0,0
20200520,061747,南亞科統一01購01,0.61,0.61,0.61,0.61,+0.02,3.39,50000,1,30500,0,0,0,0,0,0,0,50000,-50000,-50000
20200520,061748,華新科統一9C購02,,,,,0.00,0.00,0,0,0,0,0,0,0,0,0,0,0,0,0
20200520,061749,群創統一9C購02,0.88,0.91,0.86,0.86,0.00,0.00,265000,10,233610,0,0,0,0,0,0,203000,62000,141000,141000
20200520,06174P,國巨元大97售07,,,,,0.00,0.00,0,0,0,0,0,0,0,0,0,0,0,0,0
20200520,061750,台達電台新9B購01,0.90,0.92,0.89,0.90,+0.02,2.27,188000,44,169150,0,0,0,0,0,0,185000,3000,182000,182000
20200520,061751,華通台新9B購01,1.96,2.02,1.96,2.02,0.00,0.00,51000,2,100020,0,0,0,0,0,0,0,51000,-51000,-51000
20200520,061752,瑞昱台新9B購01,2.06,2.06,1.90,2.01,-0.05,-2.43,37000,3,75010,0,0,0,0,0,0,37000,5000,32000,32000
20200520,061753,南亞科台新9B購01,1.29,1.33,1.29,1.33,+0.08,6.4,212000,6,273960,0,0,0,0,0,0,200000,12000,188000,188000
20200520,061754,晶技麥證9B購01,,,,,0.00,0.00,0,0,0,0,0,0,0,0,0,0,0,0,0
20200520,061755,台灣50元大9B購11,,,,,0.00,0.00,0,0,0,0,0,0,0,0,0,0,0,0,0
20200520,061756,台灣50元大9B購12,,,,,0.00,0.00,0,0,0,0,0,0,0,0,0,0,0,0,0
20200520,061757,T50反1元大9B購01,1.29,1.29,1.29,1.29,0.00,0.00,4000,1,5160,0,0,0,0,0,0,0,4000,-4000,-4000
20200520,061758,T50反1元大9B購02,1.29,1.29,1.29,1.29,0.00,0.00,4000,1,5160,0,0,0,0,0,0,0,4000,-4000,-4000
20200520,061759,上証反元大02購01,,,,,0.00,0.00,0,0,0,0,0,0,0,0,0,0,0,0,0
20200520,06175P,台積電元大97售21,5.30,5.30,5.30,5.30,0.00,0.00,70000,1,371000,0,0,0,0,0,0,70000,70000,0,0
20200520,061760,臺指反元大01購06,1.00,1.00,1.00,1.00,-0.02,-1.96,2000,1,2000,0,0,0,0,0,0,0,2000,-2000,-2000
20200520,061761,臺指反元大02購01,,,,,0.00,0.00,0,0,0,0,0,0,0,0,0,0,0,0,0
20200520,061762,台塑元大9B購01,3.37,3.38,3.25,3.29,-0.10,-2.95,523000,34,1746820,0,0,0,0,0,0,321000,202000,119000,119000
20200520,061763,聯電元大9C購02,1.50,1.50,1.41,1.41,-0.05,-3.42,128000,3,191100,0,0,0,0,0,0,0,128000,-128000,-128000
20200520,061764,旺宏元大9B購01,2.47,2.47,2.47,2.47,-0.04,-1.59,20000,1,49400,0,0,0,0,0,0,20000,0,20000,20000
20200520,061765,義隆元大9B購01,2.07,2.12,2.01,2.12,+0.04,1.92,128000,4,266320,0,0,0,0,0,0,50000,78000,-28000,-28000
20200520,061766,華新科元大9B購02,,,,,0.00,0.00,0,0,0,0,0,0,0,0,0,0,0,0,0
20200520,061767,信邦元大9B購01,2.28,2.38,2.17,2.17,+0.01,0.46,270000,15,617090,0,0,0,0,0,0,169000,176000,-7000,-7000
20200520,061768,晶技元大9B購02,1.30,1.34,1.30,1.34,+0.02,1.52,136000,2,179520,0,0,0,0,0,0,68000,68000,0,0
20200520,061769,晶技元大9B購03,1.18,1.19,1.10,1.10,-0.06,-5.17,384000,18,443140,0,0,0,0,0,0,128000,256000,-128000,-128000
20200520,06176P,台積電元大97售22,,,,,0.00,0.00,0,0,0,0,0,0,0,0,0,0,0,0,0
20200520,061770,泰碩元大9B購02,2.63,2.63,2.52,2.52,-0.17,-6.32,39000,3,100370,0,0,0,0,0,0,39000,0,39000,39000
20200520,061771,玉晶光元大9C購04,2.08,2.11,2.08,2.10,+0.10,5.0,32000,4,67070,0,0,0,0,0,0,13000,19000,-6000,-6000
20200520,061772,健策元大9B購06,0.94,1.05,0.94,1.05,-0.01,-0.94,99000,8,100660,0,0,0,0,0,0,66000,83000,-17000,-17000
20200520,061773,和潤元大9B購01,2.10,2.10,2.08,2.08,+0.02,0.97,222000,11,464150,0,0,0,0,0,0,53000,169000,-116000,-116000
20200520,061774,T50反1國票9B購06,0.89,0.91,0.89,0.91,-0.01,-1.09,224000,10,199970,0,0,0,0,0,0,43000,181000,-138000,-138000
20200520,061775,臺指反國票9B購04,1.11,1.14,1.11,1.14,0.00,0.00,30000,2,33900,0,0,0,0,0,0,20000,10000,10000,10000
20200520,061776,晶技國票9B購01,3.19,3.22,2.96,2.96,-0.23,-7.21,87000,6,272580,0,0,0,0,0,0,50000,37000,13000,13000
20200520,061777,臺指反群益9B購01,,,,,0.00,0.00,0,0,0,0,0,0,0,0,0,0,0,0,0
20200520,061778,元金2X群益9B購02,1.37,1.37,1.37,1.37,+0.07,5.38,4000,1,5480,0,0,0,0,0,0,4000,0,4000,4000
20200520,061779,上銀群益9B購01,3.54,3.54,3.54,3.54,0.00,0.00,2000,1,7080,0,0,0,0,0,0,0,2000,-2000,-2000
20200520,06177P,玉晶光元大98售07,1.85,1.85,1.85,1.85,-0.02,-1.07,24000,1,44400,0,0,0,0,0,0,24000,0,24000,24000
20200520,061780,國巨群益9C購01,1.48,1.63,1.48,1.50,+0.10,7.14,37000,11,57300,0,0,0,0,0,0,0,37000,-37000,-37000
20200520,061781,台積電群益9C購01,3.56,3.56,3.51,3.56,+0.02,0.56,132000,5,467400,0,0,0,0,0,0,82000,52000,30000,30000
20200520,061782,智邦群益9B購01,1.66,1.73,1.66,1.73,+0.08,4.85,40000,4,69130,0,0,0,0,0,0,1000,39000,-38000,-38000
20200520,061783,友達群益9B購01,0.97,1.04,0.97,0.97,-0.04,-3.96,662000,19,665120,0,0,0,0,0,0,534000,128000,406000,406000
20200520,061784,聯發科群益9B購02,,,,,0.00,0.00,0,0,0,0,0,0,0,0,0,0,0,0,0
20200520,061785,奇力新群益9B購01,1.04,1.09,1.04,1.04,+0.06,6.12,242000,25,259220,0,0,0,0,0,0,86000,156000,-70000,-70000
20200520,061786,義隆群益9B購01,,,,,0.00,0.00,0,0,0,0,0,0,0,0,0,0,0,0,0
20200520,061787,華新科群益9C購01,2.01,2.11,2.01,2.11,+0.07,3.43,36000,2,75160,0,0,0,0,0,0,8000,28000,-20000,-20000
20200520,061788,信邦群益9B購01,1.12,1.15,1.08,1.08,-0.01,-0.92,87000,4,97850,0,0,0,0,0,0,67000,20000,47000,47000
20200520,061789,群創群益9B購01,0.73,0.75,0.73,0.73,-0.03,-3.95,490000,8,361510,0,0,0,0,0,0,309000,207000,102000,102000
20200520,06178P,大立光第一99售01,,,,,0.00,0.00,0,0,0,0,0,0,0,0,0,0,0,0,0
20200520,061790,中租群益9B購01,2.05,2.05,2.05,2.05,-0.04,-1.91,10000,1,20500,0,0,0,0,0,0,10000,0,10000,10000
20200520,061791,康友群益9B購01,1.95,1.95,1.89,1.89,-0.12,-5.97,215000,4,414270,0,0,0,0,0,0,117000,98000,19000,19000
20200520,061792,和大永豐9B購01,1.15,1.33,1.14,1.33,+0.18,15.65,460000,16,570840,0,0,0,0,0,0,43000,417000,-374000,-374000
20200520,061793,上銀永豐9B購01,,,,,0.00,0.00,0,0,0,0,0,0,0,0,0,0,0,0,0
20200520,061794,國巨永豐9B購01,0.89,0.89,0.85,0.85,0.00,0.00,14000,2,12380,0,0,0,0,0,0,0,14000,-14000,-14000
20200520,061795,智邦永豐9B購01,0.82,0.82,0.81,0.81,0.00,0.00,31000,3,25120,0,0,0,0,0,0,30000,1000,29000,29000
20200520,061796,興勤永豐9B購01,0.99,0.99,0.99,0.99,0.00,0.00,58000,2,57420,0,0,0,0,0,0,0,58000,-58000,-58000
20200520,061797,聯發科永豐9B購01,2.35,2.56,2.34,2.38,+0.12,5.31,174000,8,431700,0,0,0,0,0,0,149000,25000,124000,124000
20200520,061798,晶豪科永豐9B購01,1.01,1.01,1.00,1.00,-0.08,-7.41,200000,4,200500,0,0,0,0,0,0,200000,0,200000,200000
20200520,061799,奇鋐永豐9B購01,0.63,0.67,0.63,0.67,+0.02,3.08,52000,3,33240,0,0,0,0,0,0,2000,50000,-48000,-48000
20200520,06179P,國巨群益97售04,4.36,4.36,4.36,4.36,-0.79,-15.34,10000,1,43600,0,0,0,0,0,0,10000,0,10000,10000
20200520,061800,泰鼎永豐9B購01,1.12,1.29,1.12,1.29,+0.12,10.26,867000,38,1057160,0,0,0,0,0,0,157000,701000,-544000,-544000
20200520,061801,祥碩永豐9B購01,1.88,2.07,1.88,2.07,+0.23,12.5,165000,9,328420,0,0,0,0,0,0,30000,135000,-105000,-105000
20200520,061802,勤誠永豐9B購01,0.86,0.86,0.86,0.86,-0.01,-1.15,10000,1,8600,0,0,0,0,0,0,10000,0,10000,10000
20200520,061803,巨大永豐9B購01,1.75,2.03,1.75,1.94,+0.31,19.02,549000,42,1065040,0,0,0,0,0,0,182000,302000,-120000,-120000
20200520,061804,國巨中信9B購02,0.93,0.96,0.93,0.96,0.00,0.00,115000,2,107850,0,0,0,0,0,0,0,115000,-115000,-115000
20200520,061805,華新科中信9B購01,,,,,0.00,0.00,0,0,0,0,0,0,0,0,0,0,0,0,0
20200520,061806,元黃金統一9B購01,,,,,0.00,0.00,0,0,0,0,0,0,0,0,0,0,0,0,0
20200520,061807,元金2X統一9B購01,,,,,0.00,0.00,0,0,0,0,0,0,0,0,0,0,0,0,0
20200520,061808,聯發科統一01購02,1.63,1.75,1.61,1.65,+0.07,4.43,556000,43,929980,0,0,0,0,0,0,389000,167000,222000,222000
20200520,061809,聯發科統一9C購05,2.07,2.10,2.07,2.10,+0.07,3.45,107000,4,221790,0,0,0,0,0,0,97000,10000,87000,87000
20200520,06180P,禾伸堂群益97售01,0.54,0.56,0.54,0.56,-0.08,-12.5,80000,4,43680,0,0,0,0,0,0,78000,2000,76000,76000
20200520,061810,S&P反1群益9B購02,,,,,0.00,0.00,0,0,0,0,0,0,0,0,0,0,0,0,0
20200520,061811,A50正2群益01購03,,,,,0.00,0.00,0,0,0,0,0,0,0,0,0,0,0,0,0
20200520,061812,臺指反群益9B購02,,,,,0.00,0.00,0,0,0,0,0,0,0,0,0,0,0,0,0
20200520,061813,鴻海群益9B購02,,,,,0.00,0.00,0,0,0,0,0,0,0,0,0,0,0,0,0
20200520,061814,聯發科群益9B購04,3.14,3.47,3.13,3.19,+0.15,4.93,196000,15,635960,0,0,0,0,0,0,174000,105000,69000,69000
20200520,061815,奇力新群益9B購02,1.40,1.42,1.36,1.40,+0.05,3.7,239000,6,328640,0,0,0,0,0,0,131000,108000,23000,23000
20200520,061816,長榮航群益9B購02,2.09,2.09,2.01,2.03,+0.02,1.0,177000,7,364620,0,0,0,0,0,0,28000,112000,-84000,-84000
20200520,061817,高鐵群益9B購01,1.87,2.01,1.87,1.97,+0.13,7.07,807000,47,1581280,0,0,0,0,0,0,504000,335000,169000,169000
20200520,061818,富邦金群益9C購01,1.89,1.97,1.89,1.93,-0.02,-1.03,519000,22,999740,0,0,0,0,0,0,404000,172000,232000,232000
20200520,061819,茂林群益9B購01,2.06,2.09,2.06,2.06,0.00,0.00,149000,3,308740,0,0,0,0,0,0,0,149000,-149000,-149000
20200520,06181P,國巨中信97售02,,,,,0.00,0.00,0,0,0,0,0,0,0,0,0,0,0,0,0
20200520,061820,康控群益9B購02,1.60,1.60,1.42,1.42,-0.08,-5.33,582000,31,867270,0,0,0,0,0,0,521000,10000,511000,511000
20200520,061821,祥碩群益9B購02,7.25,7.25,7.25,7.25,+0.60,9.02,2000,1,14500,0,0,0,0,0,0,2000,0,2000,2000
20200520,061822,和潤群益9B購01,1.90,1.92,1.90,1.90,-0.02,-1.04,709000,9,1351200,0,0,0,0,0,0,70000,639000,-569000,-569000
20200520,061823,勤誠群益9B購01,1.62,1.65,1.62,1.62,+0.01,0.62,26000,4,42150,0,0,0,0,0,0,24000,2000,22000,22000
20200520,061824,聯電麥證9B購01,0.76,0.77,0.73,0.73,-0.03,-3.95,145000,4,109350,50000,95000,-45000,0,0,0,50000,95000,-45000,-45000
20200520,061825,聯發科麥證9B購01,3.33,3.44,3.30,3.30,+0.08,2.48,104000,10,348110,35000,69000,-34000,0,0,0,35000,69000,-34000,-34000
20200520,061826,台郡麥證9B購01,0.94,0.94,0.93,0.93,-0.02,-2.11,173000,4,161580,69000,104000,-35000,0,0,0,69000,104000,-35000,-35000
20200520,061827,台灣50凱基02購01,1.56,1.56,1.56,1.56,+0.01,0.65,15000,2,23400,0,0,0,0,0,0,0,15000,-15000,-15000
20200520,061828,T50反1凱基02購01,,,,,0.00,0.00,0,0,0,0,0,0,0,0,0,0,0,0,0
20200520,061829,T50反1凱基9C購02,,,,,0.00,0.00,0,0,0,0,0,0,0,0,0,0,0,0,0
20200520,06182P,群創兆豐97售03,2.08,2.08,2.08,2.08,-0.05,-2.35,24000,1,49920,0,0,0,0,0,0,24000,0,24000,24000
20200520,061830,元金2X凱基01購01,,,,,0.00,0.00,0,0,0,0,0,0,0,0,0,0,0,0,0
20200520,061831,智邦凱基9B購02,0.92,0.97,0.92,0.97,+0.05,5.43,43000,5,40410,0,0,0,0,0,0,43000,0,43000,43000
20200520,061832,聯發科凱基9B購06,1.68,1.82,1.67,1.69,+0.05,3.05,20000,11,34230,0,0,0,0,0,0,14000,6000,8000,8000
20200520,061833,華新科凱基02購01,1.00,1.00,1.00,1.00,-0.02,-1.96,18000,1,18000,0,0,0,0,0,0,18000,0,18000,18000
20200520,061834,華新科凱基02購02,1.24,1.24,1.24,1.24,-0.02,-1.59,10000,1,12400,0,0,0,0,0,0,10000,0,10000,10000
20200520,061835,華新科凱基02購03,2.12,2.12,2.12,2.12,-0.04,-1.85,12000,2,25440,0,0,0,0,0,0,12000,0,12000,12000
20200520,061836,華新科凱基05購01,2.24,2.28,2.24,2.28,0.00,0.00,26000,3,58640,0,0,0,0,0,0,26000,0,26000,26000
20200520,061837,華新科凱基05購02,1.58,1.67,1.58,1.67,+0.06,3.73,31000,3,49670,0,0,0,0,0,0,31000,0,31000,31000
20200520,061838,華新科凱基05購03,2.57,2.67,2.57,2.67,+0.05,1.91,8000,2,20760,0,0,0,0,0,0,8000,0,8000,8000
20200520,061839,華新科凱基05購04,1.00,1.01,1.00,1.01,-0.01,-0.98,58000,4,58300,0,0,0,0,0,0,18000,40000,-22000,-22000
20200520,06183P,大立光元大97售05,,,,,0.00,0.00,0,0,0,0,0,0,0,0,0,0,0,0,0
20200520,061840,長榮航凱基9C購01,1.14,1.14,1.08,1.08,-0.05,-4.42,285000,10,311920,0,0,0,0,0,0,70000,215000,-145000,-145000
20200520,061841,晶技凱基9C購01,,,,,0.00,0.00,0,0,0,0,0,0,0,0,0,0,0,0,0
20200520,061842,牧德凱基9C購01,2.75,3.25,2.74,3.11,+0.46,17.36,342000,20,1003790,0,0,0,0,0,0,48000,295000,-247000,-247000
20200520,061843,億豐凱基9C購01,1.15,1.22,1.15,1.17,+0.07,6.36,635000,15,746030,0,0,0,0,0,0,0,635000,-635000,-635000
20200520,061844,T50反1國票9C購02,,,,,0.00,0.00,0,0,0,0,0,0,0,0,0,0,0,0,0
20200520,061845,SP黃豆國票9B購02,,,,,0.00,0.00,0,0,0,0,0,0,0,0,0,0,0,0,0
20200520,061846,元金2X國票9C購01,,,,,0.00,0.00,0,0,0,0,0,0,0,0,0,0,0,0,0
20200520,061847,力山國票9B購01,3.46,3.46,3.37,3.45,0.00,0.00,68000,8,232380,0,0,0,0,0,0,0,68000,-68000,-68000
20200520,061848,國巨國票9B購07,,,,,0.00,0.00,0,0,0,0,0,0,0,0,0,0,0,0,0
20200520,061849,國巨國票9B購08,,,,,0.00,0.00,0,0,0,0,0,0,0,0,0,0,0,0,0
20200520,06184P,大立光元大97售06,,,,,0.00,0.00,0,0,0,0,0,0,0,0,0,0,0,0,0
20200520,061850,國巨國票9C購02,,,,,0.00,0.00,0,0,0,0,0,0,0,0,0,0,0,0,0
20200520,061851,智邦國票9B購01,5.65,5.65,5.65,5.65,0.00,0.00,1000,1,5650,0,0,0,0,0,0,1000,0,1000,1000
20200520,061852,大立光國票9B購02,,,,,0.00,0.00,0,0,0,0,0,0,0,0,0,0,0,0,0
20200520,061853,晶技國票9B購02,,,,,0.00,0.00,0,0,0,0,0,0,0,0,0,0,0,0,0
20200520,061854,祥碩國票9B購02,4.90,4.90,4.90,4.90,+0.30,6.52,5000,1,24500,0,0,0,0,0,0,5000,0,5000,5000
20200520,061855,台郡國票9B購01,2.22,2.27,2.20,2.27,+0.02,0.89,79000,6,176280,0,0,0,0,0,0,49000,30000,19000,19000
20200520,061856,台郡國票9B購02,1.26,1.29,1.24,1.26,-0.02,-1.56,186000,10,237070,0,0,0,0,0,0,19000,167000,-148000,-148000
20200520,061857,康友國票9B購01,2.47,2.47,2.42,2.42,-0.05,-2.02,20000,11,48900,0,0,0,0,0,0,20000,10000,10000,10000
20200520,061858,南電國票9B購02,2.80,2.92,2.59,2.61,-0.12,-4.4,59000,8,166830,0,0,0,0,0,0,1000,58000,-57000,-57000
20200520,061859,勤誠國票9B購01,2.21,2.23,2.19,2.22,-0.03,-1.33,209000,5,462450,0,0,0,0,0,0,119000,90000,29000,29000
20200520,06185P,台表科元大97售05,1.03,1.03,0.85,0.85,-0.22,-20.56,54000,5,51750,0,0,0,0,0,0,35000,19000,16000,16000
20200520,061860,臺股指國票9B購04,3.63,3.69,3.57,3.62,+0.03,0.84,24000,9,87480,0,0,0,0,0,0,22000,2000,20000,20000
20200520,061861,臺股指國票9B購05,,,,,0.00,0.00,0,0,0,0,0,0,0,0,0,0,0,0,0
20200520,061862,台灣50元大9C購35,,,,,0.00,0.00,0,0,0,0,0,0,0,0,0,0,0,0,0
20200520,061863,台灣50元大9C購36,,,,,0.00,0.00,0,0,0,0,0,0,0,0,0,0,0,0,0
20200520,061864,臺指反元大01購07,,,,,0.00,0.00,0,0,0,0,0,0,0,0,0,0,0,0,0
20200520,061865,力山元大9B購01,1.70,1.75,1.70,1.75,+0.03,1.74,121000,6,207780,0,0,0,0,0,0,50000,109000,-59000,-59000
20200520,061866,力山元大9C購01,2.25,2.33,2.25,2.31,0.00,0.00,182000,7,416990,0,0,0,0,0,0,33000,182000,-149000,-149000
20200520,061867,旺宏元大9B購02,1.62,1.64,1.62,1.64,+0.04,2.5,10000,2,16380,0,0,0,0,0,0,10000,0,10000,10000
20200520,061868,旺宏元大9B購03,2.62,2.62,2.62,2.62,-0.05,-1.87,5000,1,13100,0,0,0,0,0,0,5000,5000,0,0
20200520,061869,智邦元大9B購01,1.74,1.77,1.70,1.76,+0.06,3.53,200000,13,349950,0,0,0,0,0,0,27000,164000,-137000,-137000
20200520,06186P,鴻海統一97售02,,,,,0.00,0.00,0,0,0,0,0,0,0,0,0,0,0,0,0
20200520,061870,智邦元大9B購02,2.44,2.52,2.44,2.49,+0.07,2.89,212000,10,526640,0,0,0,0,0,0,12000,212000,-200000,-200000
20200520,061871,瑞昱元大9B購01,3.52,3.54,3.35,3.35,-0.19,-5.37,94000,18,326780,0,0,0,0,0,0,92000,42000,50000,50000
20200520,061872,友達元大9C購06,1.77,1.84,1.72,1.72,-0.01,-0.58,160000,11,288100,0,0,0,0,0,0,140000,20000,120000,120000
20200520,061873,友達元大9C購07,1.34,1.41,1.33,1.41,+0.04,2.92,92000,11,125020,0,0,0,0,0,0,92000,0,92000,92000
20200520,061874,義隆元大9B購02,2.42,2.50,2.36,2.50,+0.10,4.17,108000,6,260880,0,0,0,0,0,0,30000,78000,-48000,-48000
20200520,061875,華新科元大9B購03,1.91,1.98,1.88,1.98,+0.18,10.0,93000,6,181740,0,0,0,0,0,0,68000,25000,43000,43000
20200520,061876,明泰元大9B購01,3.07,3.08,3.06,3.08,0.00,0.00,23000,3,70750,0,0,0,0,0,0,0,23000,-23000,-23000
20200520,061877,貿聯元大9B購01,2.06,2.09,2.04,2.06,+0.06,3.0,231000,16,478450,0,0,0,0,0,0,155000,76000,79000,79000
20200520,061878,茂林元大9B購01,2.31,2.60,2.31,2.57,+0.27,11.74,184000,11,448620,0,0,0,0,0,0,59000,125000,-66000,-66000
20200520,061879,超眾元大9C購01,1.71,1.74,1.66,1.66,-0.03,-1.78,216000,8,371090,0,0,0,0,0,0,13000,216000,-203000,-203000
20200520,06187P,國巨統一97售05,2.52,2.53,2.38,2.50,-0.25,-9.09,41000,14,102580,0,0,0,0,0,0,18000,23000,-5000,-5000
20200520,061880,台郡元大9B購02,1.53,1.53,1.51,1.51,-0.01,-0.66,240000,7,366600,0,0,0,0,0,0,130000,114000,16000,16000
20200520,061881,緯穎元大9B購02,5.25,5.25,4.96,4.96,0.00,0.00,6000,2,30920,0,0,0,0,0,0,2000,6000,-4000,-4000
20200520,061882,矽創元大9B購01,2.28,2.28,1.99,2.03,-0.16,-7.31,769000,39,1666010,0,0,0,0,0,0,639000,231000,408000,408000
20200520,061883,臺股指元大9B購15,,,,,0.00,0.00,0,0,0,0,0,0,0,0,0,0,0,0,0
20200520,061884,臺股指元大9B購18,2.06,2.06,2.06,2.06,+0.05,2.49,10000,1,20600,0,0,0,0,0,0,0,10000,-10000,-10000
20200520,061885,臺股指元大9B購19,,,,,0.00,0.00,0,0,0,0,0,0,0,0,0,0,0,0,0
20200520,061886,力山國泰01購01,1.62,1.67,1.62,1.64,0.00,0.00,257000,10,422610,0,0,0,0,0,0,50000,207000,-157000,-157000
20200520,061887,祥碩國泰9C購01,,,,,0.00,0.00,0,0,0,0,0,0,0,0,0,0,0,0,0
20200520,061888,元金2X富邦9C購01,,,,,0.00,0.00,0,0,0,0,0,0,0,0,0,0,0,0,0
20200520,061889,祥碩富邦9B購01,1.53,1.64,1.51,1.63,+0.16,10.88,116000,11,186360,0,0,0,0,0,0,106000,5000,101000,101000
20200520,06188P,大立光元富97售01,3.22,3.22,3.09,3.13,-0.13,-3.99,212000,7,665690,0,0,0,0,0,0,57000,155000,-98000,-98000
20200520,061890,元金2X永豐9B購01,,,,,0.00,0.00,0,0,0,0,0,0,0,0,0,0,0,0,0
20200520,061891,力山永豐9B購01,0.80,0.80,0.79,0.80,+0.01,1.27,44000,4,34790,0,0,0,0,0,0,11000,3000,8000,8000
20200520,061892,亞德客永豐9B購01,,,,,0.00,0.00,0,0,0,0,0,0,0,0,0,0,0,0,0
20200520,061893,鴻海永豐9B購01,1.10,1.10,1.10,1.10,0.00,0.00,22000,2,24200,0,0,0,0,0,0,0,22000,-22000,-22000
20200520,061894,台積電永豐9B購01,,,,,0.00,0.00,0,0,0,0,0,0,0,0,0,0,0,0,0
20200520,061895,旺宏永豐9B購01,,,,,0.00,0.00,0,0,0,0,0,0,0,0,0,0,0,0,0
20200520,061896,景碩永豐9B購01,0.62,0.62,0.62,0.62,0.00,0.00,60000,1,37200,0,0,0,0,0,0,60000,0,60000,60000
20200520,061897,泰碩永豐9B購01,0.55,0.55,0.55,0.55,-0.03,-5.17,3000,1,1650,0,0,0,0,0,0,3000,0,3000,3000
20200520,061898,茂林永豐9B購01,0.70,0.82,0.70,0.82,+0.13,18.84,236000,17,187240,0,0,0,0,0,0,0,236000,-236000,-236000
20200520,061899,復盛永豐9B購01,0.74,0.93,0.73,0.93,+0.18,24.0,947000,43,780880,0,0,0,0,0,0,263000,684000,-421000,-421000
20200520,06189P,華新科永豐97售03,0.91,0.91,0.91,0.91,0.00,0.00,9000,1,8190,0,0,0,0,0,0,9000,0,9000,9000
20200520,061900,志超永豐9B購01,0.92,0.92,0.90,0.90,-0.02,-2.17,56000,2,51480,0,0,0,0,0,0,54000,2000,52000,52000
20200520,061901,柏文永豐9B購01,1.26,1.38,1.25,1.36,+0.13,10.57,915000,38,1215040,0,0,0,0,0,0,493000,419000,74000,74000
20200520,061902,百和永豐9B購01,0.71,0.73,0.65,0.70,+0.01,1.45,242000,9,165200,0,0,0,0,0,0,153000,89000,64000,64000
20200520,061903,宏全永豐9B購01,0.96,0.96,0.91,0.91,-0.09,-9.0,753000,87,700810,0,0,0,0,0,0,685000,68000,617000,617000
20200520,061904,台灣50中信9B購01,,,,,0.00,0.00,0,0,0,0,0,0,0,0,0,0,0,0,0
20200520,061905,上証反中信03購01,0.90,0.90,0.89,0.89,0.00,0.00,20000,2,17900,0,0,0,0,0,0,0,20000,-20000,-20000
20200520,061906,統一中信9B購01,0.90,0.92,0.90,0.92,+0.02,2.22,341000,11,312090,0,0,0,0,0,0,241000,100000,141000,141000
20200520,061907,裕隆中信9B購01,1.49,1.56,1.36,1.50,-0.25,-14.29,891000,75,1288570,0,0,0,0,0,0,573000,250000,323000,323000
20200520,061908,台積電中信05購01,0.80,0.83,0.80,0.83,+0.01,1.22,65000,3,53150,0,0,0,0,0,0,60000,5000,55000,55000
20200520,061909,台積電中信05購02,,,,,0.00,0.00,0,0,0,0,0,0,0,0,0,0,0,0,0
20200520,06190P,玉晶光永豐97售05,1.30,1.32,1.20,1.20,-0.15,-11.11,10000,4,12340,0,0,0,0,0,0,3000,7000,-4000,-4000
20200520,061910,台積電中信05購03,1.02,1.02,1.02,1.02,+0.01,0.99,31000,3,31620,0,0,0,0,0,0,31000,1000,30000,30000
20200520,061911,台積電中信05購04,1.17,1.17,1.12,1.12,0.00,0.00,12000,3,13500,0,0,0,0,0,0,11000,1000,10000,10000
20200520,061912,台積電中信05購05,1.23,1.24,1.22,1.22,-0.01,-0.81,32000,5,39360,0,0,0,0,0,0,31000,2000,29000,29000
20200520,061913,宏碁中信9B購01,,,,,0.00,0.00,0,0,0,0,0,0,0,0,0,0,0,0,0
20200520,061914,台光電中信9B購01,0.99,0.99,0.97,0.97,-0.09,-8.49,103000,16,101170,0,0,0,0,0,0,103000,0,103000,103000
20200520,061915,T50反1凱基02購02,2.00,2.01,1.98,2.01,+0.01,0.5,1207000,9,2395800,0,0,0,0,0,0,979000,199000,780000,780000
20200520,061916,元金2X凱基02購01,,,,,0.00,0.00,0,0,0,0,0,0,0,0,0,0,0,0,0
20200520,061917,亞德客凱基9B購02,0.92,0.92,0.92,0.92,0.00,0.00,110000,1,101200,0,0,0,0,0,0,0,110000,-110000,-110000
20200520,061918,上銀凱基9B購02,,,,,0.00,0.00,0,0,0,0,0,0,0,0,0,0,0,0,0
20200520,061919,國巨凱基9B購06,,,,,0.00,0.00,0,0,0,0,0,0,0,0,0,0,0,0,0
20200520,06191P,鴻海群益97售03,,,,,0.00,0.00,0,0,0,0,0,0,0,0,0,0,0,0,0
20200520,061920,台積電凱基9C購02,,,,,0.00,0.00,0,0,0,0,0,0,0,0,0,0,0,0,0
20200520,061921,旺宏凱基9B購03,,,,,0.00,0.00,0,0,0,0,0,0,0,0,0,0,0,0,0
20200520,061922,瑞昱凱基9B購01,1.41,1.47,1.35,1.42,-0.04,-2.74,341000,34,490270,0,0,0,0,0,0,341000,0,341000,341000
20200520,061923,友達凱基9B購04,1.09,1.16,1.09,1.15,+0.01,0.88,376000,20,429810,0,0,0,0,0,0,314000,62000,252000,252000
20200520,061924,聯發科凱基9C購01,1.57,1.67,1.56,1.58,+0.04,2.6,86000,11,137550,0,0,0,0,0,0,44000,39000,5000,5000
20200520,061925,禾伸堂凱基9C購01,1.14,1.14,1.13,1.13,-0.02,-1.74,60000,2,68000,0,0,0,0,0,0,40000,20000,20000,20000
20200520,061926,晶技凱基9B購02,0.85,0.85,0.85,0.85,-0.03,-3.41,57000,1,48450,0,0,0,0,0,0,57000,0,57000,57000
20200520,061927,玉晶光凱基9C購01,1.34,1.38,1.34,1.36,+0.15,12.4,55000,7,75090,0,0,0,0,0,0,0,55000,-55000,-55000
20200520,061928,群創凱基9B購06,0.96,0.99,0.96,0.99,0.00,0.00,86000,4,84180,0,0,0,0,0,0,86000,45000,41000,41000
20200520,061929,嘉澤凱基9B購01,3.37,3.37,3.37,3.37,-0.09,-2.6,47000,3,158390,0,0,0,0,0,0,47000,47000,0,0
20200520,06192P,高股息中信98售01,,,,,0.00,0.00,0,0,0,0,0,0,0,0,0,0,0,0,0
20200520,061930,臺股指凱基9B購05,1.12,1.14,1.08,1.11,+0.03,2.78,66000,7,73590,0,0,0,0,0,0,35000,31000,4000,4000
20200520,061931,力山國票9B購02,2.78,2.78,2.78,2.78,+0.04,1.46,13000,1,36140,0,0,0,0,0,0,0,13000,-13000,-13000
20200520,061932,上銀國票9B購01,3.79,3.79,3.51,3.54,-0.22,-5.85,441000,15,1614090,0,0,0,0,0,0,217000,224000,-7000,-7000
20200520,061933,光寶科國票9B購01,3.03,3.03,3.03,3.03,+0.05,1.68,20000,1,60600,0,0,0,0,0,0,0,20000,-20000,-20000
20200520,061934,台積電國票9B購06,,,,,0.00,0.00,0,0,0,0,0,0,0,0,0,0,0,0,0
20200520,061935,台積電國票9B購07,,,,,0.00,0.00,0,0,0,0,0,0,0,0,0,0,0,0,0
20200520,061936,旺宏國票9B購03,,,,,0.00,0.00,0,0,0,0,0,0,0,0,0,0,0,0,0
20200520,061937,聯發科國票9B購02,2.80,3.01,2.79,3.01,+0.29,10.66,46000,4,130700,0,0,0,0,0,0,36000,10000,26000,26000
20200520,061938,大立光國票9B購03,2.32,2.44,2.30,2.34,+0.08,3.54,120000,6,277340,0,0,0,0,0,0,110000,10000,100000,100000
20200520,061939,中租國票9B購01,1.99,1.99,1.97,1.97,-0.01,-0.51,178000,7,351780,0,0,0,0,0,0,56000,122000,-66000,-66000
20200520,06193P,台積電元富97售04,,,,,0.00,0.00,0,0,0,0,0,0,0,0,0,0,0,0,0
20200520,061940,世紀鋼國票9C購01,3.77,3.77,3.76,3.76,+0.12,3.3,16000,2,60240,0,0,0,0,0,0,0,16000,-16000,-16000
20200520,061941,道瓊指群益9B購01,,,,,0.00,0.00,0,0,0,0,0,0,0,0,0,0,0,0,0
20200520,061942,亞德客群益9B購01,3.08,3.08,3.08,3.08,+0.15,5.12,3000,1,9240,0,0,0,0,0,0,0,3000,-3000,-3000
20200520,061943,上銀群益9B購02,,,,,0.00,0.00,0,0,0,0,0,0,0,0,0,0,0,0,0
20200520,061944,聯電群益9B購01,,,,,0.00,0.00,0,0,0,0,0,0,0,0,0,0,0,0,0
20200520,061945,華通群益9B購04,2.22,2.22,2.22,2.22,+0.01,0.45,26000,1,57720,0,0,0,0,0,0,0,26000,-26000,-26000
20200520,061946,鴻海群益9B購03,2.09,2.11,2.09,2.11,-0.02,-0.94,99000,5,206970,0,0,0,0,0,0,4000,99000,-95000,-95000
20200520,061947,旺宏群益9B購02,1.84,1.84,1.84,1.84,+0.02,1.1,201000,4,369840,0,0,0,0,0,0,80000,121000,-41000,-41000
20200520,061948,美食群益9B購01,2.37,2.38,2.05,2.18,+0.14,6.86,110000,12,239340,0,0,0,0,0,0,56000,77000,-21000,-21000
20200520,061949,大立光群益9B購03,0.86,0.91,0.86,0.91,+0.02,2.25,119000,3,106520,0,0,0,0,0,0,26000,93000,-67000,-67000
20200520,06194P,台積電元富97售05,,,,,0.00,0.00,0,0,0,0,0,0,0,0,0,0,0,0,0
20200520,061950,日月光群益9B購01,2.65,2.70,2.56,2.57,-0.15,-5.51,216000,9,566100,0,0,0,0,0,0,129000,87000,42000,42000
20200520,061951,南電群益9B購01,0.72,0.72,0.69,0.70,-0.05,-6.67,38000,4,27110,0,0,0,0,0,0,31000,7000,24000,24000
20200520,061952,臺股指群益9B購01,,,,,0.00,0.00,0,0,0,0,0,0,0,0,0,0,0,0,0
20200520,061953,台積電台新9B購04,0.81,0.81,0.80,0.81,0.00,0.00,280000,6,225320,0,0,0,0,0,0,280000,0,280000,280000
20200520,061954,元金2X統一9B購02,,,,,0.00,0.00,0,0,0,0,0,0,0,0,0,0,0,0,0
20200520,061955,FANG+統一9B購01,,,,,0.00,0.00,0,0,0,0,0,0,0,0,0,0,0,0,0
20200520,061956,和大統一01購01,0.75,0.87,0.75,0.86,+0.07,8.86,2068000,42,1678210,0,0,0,0,0,0,710000,1358000,-648000,-648000
20200520,061957,上銀統一01購01,0.96,0.96,0.92,0.92,-0.03,-3.16,370000,4,341000,0,0,0,0,0,0,60000,310000,-250000,-250000
20200520,061958,鴻海統一01購01,1.69,1.70,1.64,1.64,-0.02,-1.2,42000,6,70250,0,0,0,0,0,0,7000,42000,-35000,-35000
20200520,061959,鴻海統一9B購04,1.77,1.77,1.77,1.77,0.00,0.00,5000,1,8850,0,0,0,0,0,0,0,5000,-5000,-5000
20200520,06195P,台積電元富97售06,,,,,0.00,0.00,0,0,0,0,0,0,0,0,0,0,0,0,0
20200520,061960,國巨統一01購05,0.78,0.79,0.77,0.77,+0.05,6.94,184000,6,142460,0,0,0,0,0,0,20000,164000,-144000,-144000
20200520,061961,台積電統一01購02,0.63,0.63,0.63,0.63,0.00,0.00,10000,1,6300,0,0,0,0,0,0,10000,0,10000,10000
20200520,061962,台積電統一01購03,1.38,1.38,1.35,1.35,-0.01,-0.74,21000,2,28380,0,0,0,0,0,0,21000,1000,20000,20000
20200520,061963,台積電統一01購04,1.69,1.69,1.65,1.69,+0.01,0.6,116000,4,195840,0,0,0,0,0,0,111000,6000,105000,105000
20200520,061964,台積電統一01購05,1.32,1.32,1.29,1.29,-0.02,-1.53,11000,2,14220,0,0,0,0,0,0,11000,1000,10000,10000
20200520,061965,台積電統一02購02,1.06,1.06,1.05,1.05,-0.01,-0.94,7000,3,7360,0,0,0,0,0,0,7000,1000,6000,6000
20200520,061966,旺宏統一01購03,,,,,0.00,0.00,0,0,0,0,0,0,0,0,0,0,0,0,0
20200520,061967,旺宏統一01購04,0.57,0.57,0.57,0.57,0.00,0.00,80000,2,45600,0,0,0,0,0,0,0,80000,-80000,-80000
20200520,061968,聯發科統一01購03,,,,,0.00,0.00,0,0,0,0,0,0,0,0,0,0,0,0,0
20200520,061969,大立光統一01購02,0.62,0.63,0.62,0.63,+0.02,3.28,110000,2,68300,0,0,0,0,0,0,0,110000,-110000,-110000
20200520,06196P,元上證元大97售01,,,,,0.00,0.00,0,0,0,0,0,0,0,0,0,0,0,0,0
20200520,061970,大立光統一9C購03,1.45,1.45,1.45,1.45,-0.06,-3.97,21000,1,30450,0,0,0,0,0,0,0,21000,-21000,-21000
20200520,061971,力山元大9C購02,2.12,2.17,2.08,2.14,-0.01,-0.47,114000,9,242690,0,0,0,0,0,0,28000,86000,-58000,-58000
20200520,061972,華新元大9B購01,1.43,1.50,1.43,1.45,-0.01,-0.68,197000,5,290780,0,0,0,0,0,0,162000,35000,127000,127000
20200520,061973,上銀元大9B購01,3.29,3.29,3.26,3.26,0.00,0.00,50000,3,163300,0,0,0,0,0,0,50000,0,50000,50000
20200520,061974,光寶科元大9B購01,2.94,2.96,2.93,2.96,+0.03,1.02,524000,28,1541600,0,0,0,0,0,0,449000,79000,370000,370000
20200520,061975,華通元大9B購01,3.25,3.27,3.25,3.27,-0.04,-1.21,55000,2,178850,0,0,0,0,0,0,0,55000,-55000,-55000
20200520,061976,國巨元大9B購01,2.07,2.14,2.02,2.03,+0.15,7.98,529000,19,1087270,0,0,0,0,0,0,40000,489000,-449000,-449000
20200520,061977,國巨元大9B購02,3.12,3.12,2.94,2.96,+0.18,6.47,43000,6,127700,0,0,0,0,0,0,12000,32000,-20000,-20000
20200520,061978,旺宏元大9C購01,2.44,2.44,2.44,2.44,-0.01,-0.41,10000,1,24400,0,0,0,0,0,0,0,10000,-10000,-10000
20200520,061979,友達元大9C購08,1.56,1.64,1.55,1.60,+0.06,3.9,161000,11,257260,0,0,0,0,0,0,134000,27000,107000,107000
20200520,06197P,國巨元大97售08,0.76,0.76,0.76,0.76,0.00,0.00,199000,1,151240,0,0,0,0,0,0,199000,199000,0,0
20200520,061980,聯發科元大9B購01,4.89,5.20,4.88,4.91,+0.17,3.59,28000,6,139480,0,0,0,0,0,0,15000,22000,-7000,-7000
20200520,061981,聯發科元大9B購02,4.02,4.23,4.01,4.04,+0.14,3.59,139000,14,568770,0,0,0,0,0,0,120000,35000,85000,85000
20200520,061982,聯發科元大9B購03,5.00,5.25,4.98,5.05,+0.16,3.27,105000,17,537410,0,0,0,0,0,0,30000,77000,-47000,-47000
20200520,061983,華新科元大9B購04,2.23,2.31,2.19,2.29,+0.10,4.57,140000,11,315400,0,0,0,0,0,0,140000,0,140000,140000
20200520,061984,華新科元大9B購05,1.72,1.72,1.72,1.72,-0.01,-0.58,26000,1,44720,0,0,0,0,0,0,26000,0,26000,26000
20200520,061985,富邦金元大9B購01,2.70,2.78,2.68,2.78,+0.08,2.96,213000,17,575060,0,0,0,0,0,0,208000,12000,196000,196000
20200520,061986,晶豪科元大9B購01,2.92,2.93,2.69,2.69,-0.25,-8.5,375000,27,1049780,0,0,0,0,0,0,256000,169000,87000,87000
20200520,061987,大立光元大9B購03,2.40,2.55,2.40,2.55,-0.03,-1.16,57000,3,144300,0,0,0,0,0,0,0,57000,-57000,-57000
20200520,061988,大立光元大9B購04,2.52,2.68,2.52,2.68,-0.02,-0.74,110000,7,288550,0,0,0,0,0,0,25000,85000,-60000,-60000
20200520,061989,晶技元大9B購04,2.04,2.09,2.04,2.07,0.00,0.00,197000,4,405820,0,0,0,0,0,0,50000,147000,-97000,-97000
20200520,06198P,台積電元大98售06,2.31,2.31,2.31,2.31,0.00,0.00,240000,1,554400,0,0,0,0,0,0,240000,240000,0,0
20200520,061990,台勝科元大9C購01,2.03,2.14,2.00,2.14,-0.03,-1.38,101000,5,204040,0,0,0,0,0,0,50000,51000,-1000,-1000
20200520,061991,牧德元大9C購01,2.39,3.10,2.38,2.71,+0.35,14.83,555000,63,1440200,0,0,0,0,0,0,248000,344000,-96000,-96000
20200520,061992,祥碩元大9B購02,5.45,5.85,5.40,5.85,+0.70,13.59,73000,7,404750,0,0,0,0,0,0,0,73000,-73000,-73000
20200520,061993,祥碩元大9C購01,4.09,4.43,4.06,4.24,+0.29,7.34,40000,8,164020,0,0,0,0,0,0,39000,1000,38000,38000
20200520,061994,瑞儀元大9B購01,2.22,2.37,2.22,2.37,+0.07,3.04,452000,32,1046400,0,0,0,0,0,0,61000,452000,-391000,-391000
20200520,061995,超眾元大01購01,3.06,3.06,3.06,3.06,0.00,0.00,50000,1,153000,0,0,0,0,0,0,0,50000,-50000,-50000
20200520,061996,矽格元大9B購01,1.39,1.52,1.38,1.50,+0.12,8.7,1399000,47,2035580,0,0,0,0,0,0,264000,1245000,-981000,-981000
20200520,061997,台郡元大9B購03,1.94,1.99,1.94,1.99,+0.10,5.29,76000,3,148360,0,0,0,0,0,0,0,76000,-76000,-76000
20200520,061998,緯穎元大9B購03,5.10,5.35,4.80,4.80,-0.09,-1.84,48000,9,248100,0,0,0,0,0,0,31000,17000,14000,14000
20200520,061999,臺股指元大9B購23,1.68,1.68,1.66,1.66,+0.01,0.61,45000,2,75480,0,0,0,0,0,0,39000,6000,33000,33000
20200520,06199P,聯發科元大97售17,,,,,0.00,0.00,0,0,0,0,0,0,0,0,0,0,0,0,0
20200520,062000,臺股指元大9B購24,,,,,0.00,0.00,0,0,0,0,0,0,0,0,0,0,0,0,0
20200520,062001,臺股指元大9B購25,,,,,0.00,0.00,0,0,0,0,0,0,0,0,0,0,0,0,0
20200520,062002,鴻海國泰01購01,1.39,1.42,1.39,1.40,0.00,0.00,82000,7,114730,0,0,0,0,0,0,41000,47000,-6000,-6000
20200520,062003,國巨國泰01購01,1.90,2.05,1.90,1.98,+0.19,10.61,140000,10,271560,0,0,0,0,0,0,20000,139000,-119000,-119000
20200520,062004,國巨國泰9C購03,2.04,2.20,2.04,2.13,+0.18,9.23,173000,10,361460,0,0,0,0,0,0,75000,123000,-48000,-48000
20200520,062005,旺宏國泰01購01,1.12,1.14,1.12,1.14,+0.02,1.79,13000,2,14640,0,0,0,0,0,0,13000,0,13000,13000
20200520,062006,瑞昱國泰9C購01,1.68,1.70,1.56,1.62,-0.06,-3.57,543000,36,885960,0,0,0,0,0,0,513000,33000,480000,480000
20200520,062007,台光電國泰9C購01,1.60,1.62,1.56,1.62,+0.01,0.62,569000,49,909940,0,0,0,0,0,0,397000,238000,159000,159000
20200520,062008,南亞科國泰9C購01,1.29,1.34,1.28,1.28,+0.05,4.07,674000,17,888130,0,0,0,0,0,0,500000,174000,326000,326000
20200520,062009,聯發科國泰01購01,2.53,2.71,2.52,2.56,+0.08,3.23,454000,41,1171790,0,10000,-10000,0,0,0,447000,41000,406000,396000
20200520,06200P,聯發科元大97售18,3.08,3.08,3.08,3.08,0.00,0.00,15000,1,46200,0,0,0,0,0,0,0,15000,-15000,-15000
20200520,062010,台灣50富邦9B購03,,,,,0.00,0.00,0,0,0,0,0,0,0,0,0,0,0,0,0
20200520,062011,上銀富邦9C購01,,,,,0.00,0.00,0,0,0,0,0,0,0,0,0,0,0,0,0
20200520,062012,燿華富邦9C購01,0.90,1.06,0.90,1.06,+0.18,20.45,720000,22,694040,0,0,0,0,0,0,57000,663000,-606000,-606000
20200520,062013,奇鋐富邦9B購01,0.42,0.45,0.42,0.45,-0.02,-4.26,38000,4,16610,0,0,0,0,0,0,10000,28000,-18000,-18000
20200520,062014,牧德富邦9C購01,0.57,0.62,0.57,0.61,0.00,0.00,745000,17,454130,0,0,0,0,0,0,0,745000,-745000,-745000
20200520,062015,喬山永豐9B購01,0.82,0.82,0.82,0.82,+0.07,9.33,5000,1,4100,0,0,0,0,0,0,0,0,0,0
20200520,062016,美食永豐9B購01,0.90,0.94,0.82,0.90,+0.05,5.88,1205000,71,1052820,0,0,0,0,0,0,794000,371000,423000,423000
20200520,062017,京鼎永豐9B購01,,,,,0.00,0.00,0,0,0,0,0,0,0,0,0,0,0,0,0
20200520,062018,台勝科永豐9B購01,0.87,0.95,0.87,0.95,0.00,0.00,265000,4,239710,0,0,0,0,0,0,11000,254000,-243000,-243000
20200520,062019,嘉澤永豐9B購01,1.64,1.64,1.58,1.58,-0.01,-0.63,38000,5,61550,0,0,0,0,0,0,31000,7000,24000,24000
20200520,06201P,可成元大97售01,,,,,0.00,0.00,0,0,0,0,0,0,0,0,0,0,0,0,0
20200520,062020,智伸科永豐9B購01,0.78,0.81,0.76,0.76,+0.01,1.33,106000,7,83450,0,0,0,0,0,0,10000,93000,-83000,-83000
20200520,062021,康控永豐9B購01,0.66,0.66,0.61,0.61,0.00,0.00,97000,6,60750,0,0,0,0,0,0,50000,47000,3000,3000
20200520,062022,緯穎永豐9B購01,1.39,1.44,1.30,1.30,-0.05,-3.7,186000,7,263440,0,0,0,0,0,0,136000,74000,62000,62000
20200520,062023,寶成永豐9B購01,0.89,0.89,0.89,0.89,-0.04,-4.3,5000,1,4450,0,0,0,0,0,0,0,5000,-5000,-5000
20200520,062024,臺股指中信9C購05,1.18,1.18,1.18,1.18,0.00,0.00,25000,1,29500,0,0,0,0,0,0,25000,0,25000,25000
20200520,062025,台達電群益9B購01,1.95,1.97,1.86,1.86,-0.07,-3.63,285000,16,541770,0,0,0,0,0,0,269000,16000,253000,253000
20200520,062026,華邦電群益9B購01,1.03,1.06,1.02,1.02,+0.05,5.15,195000,10,204660,0,0,0,0,0,0,135000,100000,35000,35000
20200520,062027,國泰金群益9B購01,1.81,1.86,1.81,1.83,0.00,0.00,430000,8,785800,0,0,0,0,0,0,177000,253000,-76000,-76000
20200520,062028,晶技群益9B購01,1.39,1.39,1.29,1.29,-0.10,-7.19,322000,5,426420,0,0,0,0,0,0,222000,100000,122000,122000
20200520,062029,牧德群益9B購03,2.22,2.52,2.19,2.47,+0.36,17.06,318000,9,776370,0,0,0,0,0,0,21000,297000,-276000,-276000
20200520,06202P,大立光元大98售06,,,,,0.00,0.00,0,0,0,0,0,0,0,0,0,0,0,0,0
20200520,062030,旭富群益9B購01,2.97,2.99,2.89,2.89,-0.07,-2.36,14000,3,40640,0,0,0,0,0,0,0,14000,-14000,-14000
20200520,062031,臻鼎群益9B購01,1.65,1.83,1.65,1.81,+0.18,11.04,935000,30,1661240,0,0,0,0,0,0,93000,839000,-746000,-746000
20200520,062032,崇越群益9B購01,1.66,1.66,1.66,1.66,+0.04,2.47,196000,2,325360,0,0,0,0,0,0,98000,98000,0,0
20200520,062033,瀚宇博群益9B購01,1.47,1.48,1.47,1.48,-0.07,-4.52,44000,2,65020,0,0,0,0,0,0,34000,10000,24000,24000
20200520,062034,同欣電群益9B購01,2.03,2.22,2.02,2.02,-0.01,-0.49,1076000,31,2223020,0,0,0,0,0,0,87000,984000,-897000,-897000
20200520,062035,瑞祺群益9B購01,1.29,1.38,1.26,1.38,+0.10,7.81,599000,14,790600,0,0,0,0,0,0,10000,589000,-579000,-579000
20200520,062036,致新群益9B購01,2.13,2.13,2.01,2.04,+0.13,6.81,280000,15,577120,0,0,0,0,0,0,149000,131000,18000,18000
20200520,062037,華新凱基9B購01,1.01,1.05,1.01,1.03,0.00,0.00,152000,3,156040,0,0,0,0,0,0,0,152000,-152000,-152000
20200520,062038,鴻海凱基9B購05,3.02,3.02,3.02,3.02,-0.05,-1.63,3000,2,9060,0,0,0,0,0,0,3000,3000,0,0
20200520,062039,聯發科凱基9B購07,2.08,2.19,2.08,2.16,+0.17,8.54,90000,5,189650,0,0,0,0,0,0,66000,15000,51000,51000
20200520,06203P,奇力新中信98售02,,,,,0.00,0.00,0,0,0,0,0,0,0,0,0,0,0,0,0
20200520,062040,玉晶光凱基01購01,1.51,1.51,1.50,1.50,0.00,0.00,7000,2,10510,0,0,0,0,0,0,6000,1000,5000,5000
20200520,062041,華擎凱基9C購01,1.51,1.64,1.51,1.64,0.00,0.00,187000,14,293940,0,0,0,0,0,0,40000,182000,-142000,-142000
20200520,062042,台勝科凱基9C購01,1.05,1.15,1.05,1.15,-0.03,-2.54,97000,5,104330,0,0,0,0,0,0,68000,20000,48000,48000
20200520,062043,牧德凱基9B購04,1.48,1.79,1.48,1.69,+0.21,14.19,932000,37,1484340,0,0,0,0,0,0,130000,792000,-662000,-662000
20200520,062044,健策凱基9B購02,1.28,1.29,1.28,1.28,0.00,0.00,31000,4,39880,0,0,0,0,0,0,1000,31000,-30000,-30000
20200520,062045,崇越凱基9B購01,0.88,0.90,0.88,0.90,+0.01,1.12,101000,2,88900,0,0,0,0,0,0,100000,1000,99000,99000
20200520,062046,矽格凱基9B購01,0.97,1.08,0.96,1.06,+0.11,11.58,314000,25,323550,0,0,0,0,0,0,0,314000,-314000,-314000
20200520,062047,緯穎凱基9B購01,5.10,5.15,4.78,4.78,-0.09,-1.85,123000,8,627790,0,0,0,0,0,0,119000,33000,86000,86000
20200520,062048,義隆台新9B購01,,,,,0.00,0.00,0,0,0,0,0,0,0,0,0,0,0,0,0
20200520,062049,亞德客統一01購01,0.72,0.72,0.70,0.70,+0.01,1.45,684000,11,483470,0,0,0,0,0,0,258000,426000,-168000,-168000
20200520,06204P,鴻海群益97售04,,,,,0.00,0.00,0,0,0,0,0,0,0,0,0,0,0,0,0
20200520,062050,亞德客統一9C購01,0.90,0.90,0.90,0.90,+0.06,7.14,11000,1,9900,0,0,0,0,0,0,0,11000,-11000,-11000
20200520,062051,上銀統一9C購02,1.02,1.02,1.01,1.01,0.00,0.00,20000,2,20300,0,0,0,0,0,0,0,20000,-20000,-20000
20200520,062052,華通統一01購01,0.89,0.93,0.88,0.90,-0.04,-4.26,335000,10,301970,0,0,0,0,0,0,308000,27000,281000,281000
20200520,062053,華通統一9C購02,0.90,0.96,0.90,0.92,-0.05,-5.15,35000,9,33300,0,0,0,0,0,0,6000,29000,-23000,-23000
20200520,062054,鴻海統一9C購06,0.80,0.80,0.80,0.80,-0.06,-6.98,3000,1,2400,0,0,0,0,0,0,3000,3000,0,0
20200520,062055,鴻海統一9C購07,,,,,0.00,0.00,0,0,0,0,0,0,0,0,0,0,0,0,0
20200520,062056,國巨統一9C購08,,,,,0.00,0.00,0,0,0,0,0,0,0,0,0,0,0,0,0
20200520,062057,華邦電統一01購01,0.79,0.80,0.78,0.78,+0.04,5.41,105000,3,82960,0,0,0,0,0,0,0,105000,-105000,-105000
20200520,062058,瑞昱統一01購01,0.89,0.92,0.84,0.87,-0.01,-1.14,1617000,47,1447330,0,0,0,0,0,0,1312000,305000,1007000,1007000
20200520,062059,聯發科統一9C購06,1.26,1.33,1.26,1.29,+0.07,5.74,29000,5,37330,0,0,0,0,0,0,17000,12000,5000,5000
20200520,06205P,台積電群益97售03,,,,,0.00,0.00,0,0,0,0,0,0,0,0,0,0,0,0,0
20200520,062060,奇鋐統一9C購01,0.66,0.71,0.65,0.70,+0.03,4.48,499000,14,342760,0,0,0,0,0,0,40000,459000,-419000,-419000
20200520,062061,台勝科統一01購01,0.82,0.88,0.82,0.86,+0.03,3.61,714000,15,602830,0,0,0,0,0,0,115000,599000,-484000,-484000
20200520,062062,貿聯統一01購01,0.80,0.81,0.77,0.81,+0.02,2.53,1148000,23,894220,0,0,0,0,0,0,882000,226000,656000,656000
20200520,062063,世紀鋼統一9C購01,0.86,0.86,0.79,0.79,-0.07,-8.14,72000,3,58220,0,0,0,0,0,0,50000,22000,28000,28000
20200520,062064,台灣50元大9B購13,0.97,0.97,0.97,0.97,-0.02,-2.02,9000,1,8730,0,0,0,0,0,0,9000,0,9000,9000
20200520,062065,台灣50元大9B購14,1.45,1.45,1.45,1.45,0.00,0.00,50000,2,72500,0,0,0,0,0,0,0,50000,-50000,-50000
20200520,062066,元黃金元大9B購01,0.65,0.65,0.64,0.64,+0.01,1.59,53000,5,34050,0,0,0,0,0,0,50000,3000,47000,47000
20200520,062067,滬深2X元大9B購01,,,,,0.00,0.00,0,0,0,0,0,0,0,0,0,0,0,0,0
20200520,062068,滬深2X元大9B購02,1.12,1.12,1.12,1.12,-0.02,-1.75,45000,1,50400,0,0,0,0,0,0,45000,0,45000,45000
20200520,062069,喬山元大9B購01,1.73,1.86,1.69,1.86,+0.20,12.05,1258000,52,2262210,0,0,0,0,0,0,140000,1118000,-978000,-978000
20200520,06206P,台積電凱基97售11,,,,,0.00,0.00,0,0,0,0,0,0,0,0,0,0,0,0,0
20200520,062070,金寶元大9B購01,0.98,0.98,0.98,0.98,+0.02,2.08,11000,1,10780,0,0,0,0,0,0,11000,0,11000,11000
20200520,062071,華通元大9B購02,,,,,0.00,0.00,0,0,0,0,0,0,0,0,0,0,0,0,0
20200520,062072,國巨元大9B購05,2.67,2.67,2.67,2.67,0.00,0.00,25000,1,66750,0,0,0,0,0,0,0,25000,-25000,-25000
20200520,062073,國巨元大9B購06,3.23,3.23,3.05,3.07,0.00,0.00,32000,3,97900,0,0,0,0,0,0,1000,32000,-31000,-31000
20200520,062074,旺宏元大9B購04,2.38,2.43,2.38,2.43,0.00,0.00,100000,7,240600,0,0,0,0,0,0,100000,0,100000,100000
20200520,062075,智邦元大9B購03,2.68,2.76,2.68,2.73,-0.16,-5.54,326000,9,889100,0,0,0,0,0,0,4000,326000,-322000,-322000
20200520,062076,美律元大9B購02,2.21,2.21,2.21,2.21,0.00,0.00,45000,1,99450,0,0,0,0,0,0,0,45000,-45000,-45000
20200520,062077,聯發科元大9B購04,6.35,6.40,6.35,6.40,+0.15,2.4,30000,3,191250,0,0,0,0,0,0,15000,15000,0,0
20200520,062078,聯發科元大9B購05,5.45,5.45,5.45,5.45,+0.10,1.87,15000,2,81750,0,0,0,0,0,0,15000,0,15000,15000
20200520,062079,聯發科元大9B購06,,,,,0.00,0.00,0,0,0,0,0,0,0,0,0,0,0,0,0
20200520,06207P,聯發科凱基97售07,4.67,4.84,4.67,4.84,0.00,0.00,3000,3,14220,0,0,0,0,0,0,0,3000,-3000,-3000
20200520,062080,奇力新元大9B購02,2.39,2.45,2.39,2.45,+0.16,6.99,141000,5,337890,0,0,0,0,0,0,126000,15000,111000,111000
20200520,062081,華新科元大9B購06,1.63,1.68,1.58,1.58,-0.04,-2.47,168000,14,272840,0,0,0,0,0,0,108000,60000,48000,48000
20200520,062082,嘉晶元大9B購01,3.27,3.77,3.25,3.77,+0.44,13.21,424000,39,1488230,0,0,0,0,0,0,153000,293000,-140000,-140000
20200520,062083,健策元大9C購03,1.87,1.94,1.84,1.94,-0.04,-2.02,113000,9,211620,0,0,0,0,0,0,50000,64000,-14000,-14000
20200520,062084,台郡元大9B購04,1.48,1.52,1.46,1.46,-0.03,-2.01,239000,10,353480,0,0,0,0,0,0,168000,72000,96000,96000
20200520,062085,同欣電元大9B購01,2.37,2.54,2.34,2.39,+0.06,2.58,295000,31,720290,0,0,0,0,0,0,183000,112000,71000,71000
20200520,062086,瑞祺元大9B購01,1.40,1.52,1.40,1.52,+0.14,10.14,410000,13,598980,0,0,0,0,0,0,49000,361000,-312000,-312000
20200520,062087,瑞祺元大9B購02,1.25,1.35,1.25,1.35,+0.12,9.76,480000,20,624380,0,0,0,0,0,0,77000,403000,-326000,-326000
20200520,062088,緯穎元大9B購04,5.05,5.30,4.77,4.77,-0.11,-2.25,58000,7,292390,0,0,0,0,0,0,27000,31000,-4000,-4000
20200520,062089,矽創元大9B購02,3.10,3.10,2.69,2.71,-0.27,-9.06,540000,34,1587350,0,0,0,0,0,0,425000,214000,211000,211000
20200520,06208P,台郡凱基97售03,1.50,1.51,1.48,1.51,-0.03,-1.95,101000,3,151000,0,0,0,0,0,0,0,101000,-101000,-101000
20200520,062090,南電元大9B購02,2.04,2.04,1.35,1.95,+0.03,1.56,35000,4,63150,0,0,0,0,0,0,10000,15000,-5000,-5000
20200520,062091,世紀鋼元大9B購01,2.47,2.47,2.43,2.47,+0.03,1.23,122000,4,299160,0,0,0,0,0,0,50000,72000,-22000,-22000
20200520,062092,臺指反富邦9C購02,,,,,0.00,0.00,0,0,0,0,0,0,0,0,0,0,0,0,0
20200520,062093,台積電富邦9C購11,0.46,0.46,0.46,0.46,0.00,0.00,10000,1,4600,0,0,0,0,0,0,10000,0,10000,10000
20200520,062094,台積電富邦9C購12,0.49,0.49,0.49,0.49,0.00,0.00,14000,2,6860,0,0,0,0,0,0,0,14000,-14000,-14000
20200520,062095,旺宏富邦9C購03,,,,,0.00,0.00,0,0,0,0,0,0,0,0,0,0,0,0,0
20200520,062096,神隆永豐9B購01,0.84,0.84,0.81,0.83,-0.05,-5.68,236000,5,192660,0,0,0,0,0,0,176000,60000,116000,116000
20200520,062097,台光電永豐9B購01,0.81,0.84,0.81,0.84,-0.06,-6.67,89000,4,72390,0,0,0,0,0,0,88000,0,88000,88000
20200520,062098,億光永豐9B購01,0.72,0.79,0.72,0.76,+0.02,2.7,232000,6,174290,0,0,0,0,0,0,85000,147000,-62000,-62000
20200520,062099,牧德永豐9B購01,0.96,1.15,0.96,1.13,+0.19,20.21,865000,23,948070,0,0,0,0,0,0,59000,811000,-752000,-752000
20200520,06209P,旺宏統一97售07,,,,,0.00,0.00,0,0,0,0,0,0,0,0,0,0,0,0,0
20200520,062100,矽格永豐9B購01,0.84,0.89,0.84,0.89,+0.04,4.71,308000,9,265710,0,0,0,0,0,0,0,308000,-308000,-308000
20200520,062101,T50反1國票01購01,,,,,0.00,0.00,0,0,0,0,0,0,0,0,0,0,0,0,0
20200520,062102,T50反1國票9B購07,1.37,1.37,1.37,1.37,-0.01,-0.72,1000,1,1370,0,0,0,0,0,0,0,1000,-1000,-1000
20200520,062103,T50反1國票9B購08,,,,,0.00,0.00,0,0,0,0,0,0,0,0,0,0,0,0,0
20200520,062104,上証2X國票9B購03,,,,,0.00,0.00,0,0,0,0,0,0,0,0,0,0,0,0,0
20200520,062105,國巨國票9C購03,,,,,0.00,0.00,0,0,0,0,0,0,0,0,0,0,0,0,0
20200520,062106,華邦電國票9B購02,0.93,0.93,0.93,0.93,0.00,0.00,39000,2,36270,0,0,0,0,0,0,1000,38000,-37000,-37000
20200520,062107,台光電國票9B購01,2.02,2.02,1.93,1.93,-0.22,-10.23,94000,3,188980,0,0,0,0,0,0,42000,52000,-10000,-10000
20200520,062108,晶豪科國票9B購01,1.47,1.48,1.39,1.39,-0.13,-8.55,548000,17,789400,0,0,0,0,0,0,372000,260000,112000,112000
20200520,062109,聯詠國票9C購01,2.50,2.59,2.50,2.52,-0.06,-2.33,176000,6,448480,0,0,0,0,0,0,61000,115000,-54000,-54000
20200520,06210P,元油反元大97售01,,,,,0.00,0.00,0,0,0,0,0,0,0,0,0,0,0,0,0
20200520,062110,華擎國票9B購01,1.99,2.21,1.98,2.21,+0.36,19.46,478000,22,1001700,0,0,0,0,0,0,85000,393000,-308000,-308000
20200520,062111,台勝科國票9B購01,2.62,2.88,2.62,2.88,+0.23,8.68,100000,4,264440,0,0,0,0,0,0,49000,51000,-2000,-2000
20200520,062112,祥碩國票9C購01,5.15,5.45,5.15,5.45,+0.45,9.0,93000,9,493050,0,0,0,0,0,0,0,93000,-93000,-93000
20200520,062113,瑞祺國票9B購01,2.08,2.28,2.08,2.28,+0.26,12.87,262000,11,567120,0,0,0,0,0,0,12000,250000,-238000,-238000
20200520,062114,GIS國票9C購01,1.39,1.41,1.39,1.41,+0.02,1.44,140000,5,196300,0,0,0,0,0,0,0,140000,-140000,-140000
20200520,062115,臺股指國票9B購09,,,,,0.00,0.00,0,0,0,0,0,0,0,0,0,0,0,0,0
20200520,062116,元金2X第一9B購01,0.63,0.64,0.63,0.63,+0.03,5.0,528000,21,334400,0,0,0,0,0,0,344000,176000,168000,168000
20200520,062117,燿華中信9B購01,0.71,0.71,0.71,0.71,0.00,0.00,99000,1,70290,0,0,0,0,0,0,0,99000,-99000,-99000
20200520,062118,華新科中信9B購02,,,,,0.00,0.00,0,0,0,0,0,0,0,0,0,0,0,0,0
20200520,062119,世紀鋼中信9B購01,0.67,0.67,0.67,0.67,+0.02,3.08,17000,1,11390,0,0,0,0,0,0,17000,0,17000,17000
20200520,06211P,鴻海元大98售04,2.78,2.90,2.78,2.88,+0.01,0.35,35000,7,100000,0,0,0,0,0,0,35000,35000,0,0
20200520,062120,國巨台新9B購01,0.90,0.90,0.90,0.90,+0.10,12.5,3000,1,2700,0,0,0,0,0,0,0,3000,-3000,-3000
20200520,062121,奇鋐台新9B購01,,,,,0.00,0.00,0,0,0,0,0,0,0,0,0,0,0,0,0
20200520,062122,國巨統一02購01,0.91,0.97,0.91,0.94,+0.08,9.3,28000,4,26260,0,0,0,0,0,0,10000,18000,-8000,-8000
20200520,062123,台積電統一9B購13,,,,,0.00,0.00,0,0,0,0,0,0,0,0,0,0,0,0,0
20200520,062124,大立光統一9B購09,,,,,0.00,0.00,0,0,0,0,0,0,0,0,0,0,0,0,0
20200520,062125,嘉晶統一9B購01,1.23,1.49,1.23,1.43,+0.24,20.17,517000,34,677630,2000,0,2000,0,0,0,150000,358000,-208000,-206000
20200520,062126,創意統一9B購01,0.67,0.70,0.66,0.70,+0.02,2.94,766000,18,526760,0,0,0,0,0,0,331000,435000,-104000,-104000
20200520,062127,台勝科統一01購02,0.63,0.68,0.63,0.66,+0.02,3.12,74000,7,48570,0,0,0,0,0,0,41000,33000,8000,8000
20200520,062128,祥碩統一01購01,1.54,1.69,1.53,1.68,+0.19,12.75,190000,28,302360,0,0,0,0,0,0,160000,53000,107000,107000
20200520,062129,世紀鋼統一02購01,0.61,0.61,0.61,0.61,-0.04,-6.15,993000,4,605730,0,0,0,0,0,0,993000,0,993000,993000
20200520,06212P,華新科元大97售11,2.16,2.18,2.07,2.18,+0.01,0.46,82000,10,174750,0,0,0,0,0,0,32000,50000,-18000,-18000
20200520,062130,T50反1群益9B購01,,,,,0.00,0.00,0,0,0,0,0,0,0,0,0,0,0,0,0
20200520,062131,臺指反群益9B購03,,,,,0.00,0.00,0,0,0,0,0,0,0,0,0,0,0,0,0
20200520,062132,神隆群益9B購01,1.82,1.82,1.82,1.82,-0.03,-1.62,98000,1,178360,0,0,0,0,0,0,98000,0,98000,98000
20200520,062133,大成鋼群益9B購01,1.34,1.59,1.34,1.59,+0.26,19.55,700000,16,1015670,0,0,0,0,0,0,103000,597000,-494000,-494000
20200520,062134,國巨群益9B購04,1.86,2.04,1.86,1.91,+0.16,9.14,163000,12,315620,0,0,0,0,0,0,21000,142000,-121000,-121000
20200520,062135,國巨群益9B購05,1.47,1.63,1.46,1.63,+0.24,17.27,15000,9,23070,0,0,0,0,0,0,11000,4000,7000,7000
20200520,062136,南亞科群益9B購01,1.59,1.62,1.59,1.62,0.00,0.00,40000,4,64100,0,0,0,0,0,0,0,40000,-40000,-40000
20200520,062137,華新科群益9B購04,0.88,0.88,0.88,0.88,+0.03,3.53,9000,1,7920,0,0,0,0,0,0,9000,9000,0,0
20200520,062138,力成群益9B購01,1.61,1.61,1.61,1.61,-0.07,-4.17,10000,1,16100,0,0,0,0,0,0,0,10000,-10000,-10000
20200520,062139,臺指反國票9C購02,,,,,0.00,0.00,0,0,0,0,0,0,0,0,0,0,0,0,0
20200520,06213P,大立光元大98售07,4.62,4.62,4.56,4.56,-0.02,-0.44,5000,5,22960,0,0,0,0,0,0,1000,4000,-3000,-3000
20200520,062140,元金2X國票9B購03,2.97,2.97,2.97,2.97,+0.15,5.32,50000,1,148500,0,0,0,0,0,0,50000,0,50000,50000
20200520,062141,遠東新國票9B購01,1.71,1.92,1.71,1.92,+0.05,2.67,251000,4,439350,0,0,0,0,0,0,200000,51000,149000,149000
20200520,062142,喬山國票9B購01,2.36,2.50,2.36,2.48,+0.19,8.3,607000,18,1480720,0,0,0,0,0,0,0,607000,-607000,-607000
20200520,062143,大成鋼國票9B購01,1.24,1.50,1.24,1.50,+0.17,12.78,368000,11,500790,0,0,0,0,0,0,30000,338000,-308000,-308000
20200520,062144,華通國票9B購01,3.53,3.53,3.35,3.35,0.00,0.00,13000,2,44990,0,0,0,0,0,0,5000,8000,-3000,-3000
20200520,062145,億光國票9B購01,2.03,2.17,2.03,2.07,+0.12,6.15,117000,11,241990,0,0,0,0,0,0,0,117000,-117000,-117000
20200520,062146,大毅國票9B購01,5.70,6.00,5.70,5.80,-0.05,-0.85,54000,4,310100,0,0,0,0,0,0,8000,46000,-38000,-38000
20200520,062147,大毅國票9B購02,3.33,3.59,3.33,3.56,+0.10,2.89,147000,7,514650,0,0,0,0,0,0,137000,10000,127000,127000
20200520,062148,奇鋐國票9B購01,2.21,2.26,2.21,2.25,0.00,0.00,22000,4,48970,0,0,0,0,0,0,0,22000,-22000,-22000
20200520,062149,牧德國票9B購01,6.95,8.00,6.95,8.00,0.00,0.00,8000,3,59600,0,0,0,0,0,0,1000,8000,-7000,-7000
20200520,06214P,國巨國票98售04,3.82,3.82,3.70,3.70,-0.40,-9.76,91000,3,336820,0,0,0,0,0,0,91000,0,91000,91000
20200520,062150,南六國票9B購01,4.73,4.73,4.73,4.73,-0.97,-17.02,22000,1,104060,0,0,0,0,0,0,0,22000,-22000,-22000
20200520,062151,世紀鋼國票01購01,1.55,1.55,1.55,1.55,+0.06,4.03,19000,1,29450,0,0,0,0,0,0,0,19000,-19000,-19000
20200520,062152,國巨麥證9C購01,1.09,1.09,1.09,1.09,+0.12,12.37,17000,1,18530,0,17000,-17000,0,0,0,0,17000,-17000,-17000
20200520,062153,智邦麥證9B購01,1.02,1.06,1.02,1.05,+0.03,2.94,43000,7,44130,21000,22000,-1000,0,0,0,21000,22000,-1000,-1000
20200520,062154,國巨凱基9C購02,,,,,0.00,0.00,0,0,0,0,0,0,0,0,0,0,0,0,0
20200520,062155,國巨凱基9C購03,,,,,0.00,0.00,0,0,0,0,0,0,0,0,0,0,0,0,0
20200520,062156,美律凱基9B購01,,,,,0.00,0.00,0,0,0,0,0,0,0,0,0,0,0,0,0
20200520,062157,聯發科凱基9B購08,4.98,5.35,4.98,5.10,+0.22,4.51,208000,6,1063950,0,0,0,0,0,0,200000,8000,192000,192000
20200520,062158,禾伸堂凱基9B購01,0.63,0.63,0.60,0.60,-0.01,-1.64,115000,3,69180,0,0,0,0,0,0,115000,0,115000,115000
20200520,062159,聯詠凱基9B購01,1.47,1.54,1.46,1.54,-0.07,-4.35,255000,27,387240,0,0,0,0,0,0,223000,32000,191000,191000
20200520,06215P,康控永豐97售02,,,,,0.00,0.00,0,0,0,0,0,0,0,0,0,0,0,0,0
20200520,062160,南六凱基9B購01,1.11,1.20,1.11,1.15,+0.03,2.68,193000,7,218410,0,0,0,0,0,0,183000,10000,173000,173000
20200520,062161,南六凱基9C購01,1.70,1.70,1.70,1.70,+0.06,3.66,7000,1,11900,0,0,0,0,0,0,7000,0,7000,7000
20200520,062162,世紀鋼凱基9B購03,1.05,1.05,1.05,1.05,+0.01,0.96,15000,1,15750,0,0,0,0,0,0,15000,0,15000,15000
20200520,062163,大毅國泰01購01,1.56,1.65,1.51,1.51,-0.03,-1.95,523000,26,841520,0,0,0,0,0,0,82000,461000,-379000,-379000
20200520,062164,禾伸堂國泰01購01,1.08,1.09,1.06,1.06,+0.03,2.91,248000,3,266820,0,0,0,0,0,0,198000,50000,148000,148000
20200520,062165,聯茂國泰01購01,1.11,1.11,1.02,1.06,-0.05,-4.5,2610000,98,2755240,0,0,0,0,0,0,2399000,117000,2282000,2282000
20200520,062166,致新國泰01購01,2.07,2.11,2.07,2.08,+0.19,10.05,13000,3,27130,0,0,0,0,0,0,3000,10000,-7000,-7000
20200520,062167,燿華永豐9B購01,0.64,0.79,0.64,0.79,+0.20,33.9,273000,5,188400,0,0,0,0,0,0,0,273000,-273000,-273000
20200520,062168,大毅永豐9B購01,0.90,0.90,0.84,0.84,0.00,0.00,37000,5,32910,0,0,0,0,0,0,0,37000,-37000,-37000
20200520,062169,禾伸堂永豐9B購01,0.58,0.58,0.58,0.58,-0.01,-1.69,3000,1,1740,0,0,0,0,0,0,0,3000,-3000,-3000
20200520,06216P,上銀元富97售03,1.73,1.75,1.73,1.75,-0.07,-3.85,2000,2,3480,0,0,0,0,0,0,1000,1000,0,0
20200520,062170,健策永豐9B購04,,,,,0.00,0.00,0,0,0,0,0,0,0,0,0,0,0,0,0
20200520,062171,中磊永豐9B購01,0.79,0.79,0.78,0.78,-0.03,-3.7,62000,2,48370,0,0,0,0,0,0,61000,0,61000,61000
20200520,062172,南六永豐9B購01,0.93,0.93,0.93,0.93,-0.03,-3.12,85000,1,79050,0,0,0,0,0,0,85000,0,85000,85000
20200520,062173,世紀鋼永豐9B購01,0.73,0.76,0.73,0.76,-0.06,-7.32,20000,3,14900,0,0,0,0,0,0,20000,0,20000,20000
20200520,062174,T50反1元大9B購03,,,,,0.00,0.00,0,0,0,0,0,0,0,0,0,0,0,0,0
20200520,062175,臺指反元大02購02,,,,,0.00,0.00,0,0,0,0,0,0,0,0,0,0,0,0,0
20200520,062176,元金2X元大9B購01,1.51,1.51,1.51,1.51,+0.07,4.86,1000,1,1510,0,0,0,0,0,0,0,1000,-1000,-1000
20200520,062177,上銀元大9B購02,,,,,0.00,0.00,0,0,0,0,0,0,0,0,0,0,0,0,0
20200520,062178,上銀元大9B購03,3.37,3.37,3.21,3.21,-0.15,-4.46,36000,3,120750,0,0,0,0,0,0,3000,33000,-30000,-30000
20200520,062179,旺宏元大9B購05,1.90,1.91,1.90,1.91,+0.02,1.06,85000,3,162000,0,0,0,0,0,0,50000,35000,15000,15000
20200520,06217P,鴻海元富97售05,,,,,0.00,0.00,0,0,0,0,0,0,0,0,0,0,0,0,0
20200520,062180,瑞昱元大9B購03,3.63,3.71,3.47,3.47,-0.09,-2.53,193000,26,699290,0,0,0,0,0,0,191000,82000,109000,109000
20200520,062181,義隆元大9B購03,,,,,0.00,0.00,0,0,0,0,0,0,0,0,0,0,0,0,0
20200520,062182,華新科元大9B購07,2.32,2.32,2.28,2.28,-0.05,-2.15,74000,3,171440,0,0,0,0,0,0,74000,0,74000,74000
20200520,062183,奇鋐元大9B購01,1.22,1.26,1.22,1.25,0.00,0.00,43000,5,53220,0,0,0,0,0,0,0,43000,-43000,-43000
20200520,062184,奇鋐元大9B購02,1.89,2.01,1.89,2.00,+0.02,1.01,65000,9,126970,0,0,0,0,0,0,0,65000,-65000,-65000
20200520,062185,禾伸堂元大9B購01,1.58,1.64,1.54,1.64,+0.07,4.46,215000,10,345120,0,0,0,0,0,0,164000,51000,113000,113000
20200520,062186,晶技元大9B購05,2.26,2.27,2.12,2.12,-0.10,-4.5,37000,4,82320,0,0,0,0,0,0,10000,27000,-17000,-17000
20200520,062187,台勝科元大9B購02,2.66,2.90,2.66,2.90,-0.02,-0.68,188000,11,521140,0,0,0,0,0,0,3000,185000,-182000,-182000
20200520,062188,貿聯元大9B購02,3.05,3.10,3.05,3.05,+0.05,1.67,66000,11,202400,0,0,0,0,0,0,31000,35000,-4000,-4000
20200520,062189,康控元大9B購02,1.93,1.93,1.85,1.85,-0.01,-0.54,124000,11,232000,0,0,0,0,0,0,124000,0,124000,124000
20200520,06218P,鴻海元富97售06,,,,,0.00,0.00,0,0,0,0,0,0,0,0,0,0,0,0,0
20200520,062190,瀚宇博元大9B購01,2.10,2.10,2.09,2.09,-0.02,-0.95,77000,2,161430,0,0,0,0,0,0,0,77000,-77000,-77000
20200520,062191,台郡元大9B購05,2.73,2.73,2.69,2.73,-0.06,-2.15,50000,4,135700,0,0,0,0,0,0,50000,0,50000,50000
20200520,062192,南六元大9B購01,3.80,3.82,3.80,3.82,+0.26,7.3,20000,2,76200,0,0,0,0,0,0,0,20000,-20000,-20000
20200520,062193,瑞昱第一9B購01,1.05,1.08,1.00,1.02,-0.05,-4.67,440000,26,462350,0,0,0,0,0,0,390000,100000,290000,290000
20200520,062194,遠東新中信9C購01,1.01,1.12,1.00,1.09,+0.04,3.81,1351000,39,1413870,0,0,0,0,0,0,906000,405000,501000,501000
20200520,062195,聚陽中信9C購01,1.39,1.41,1.32,1.32,-0.04,-2.94,439000,35,598440,0,0,0,0,0,0,254000,145000,109000,109000
20200520,062196,聯發科中信01購02,1.23,1.31,1.23,1.23,+0.03,2.5,75000,5,97630,0,0,0,0,0,0,28000,47000,-19000,-19000
20200520,062197,聯發科中信01購03,1.14,1.25,1.14,1.16,+0.04,3.57,757000,16,903310,0,0,0,0,0,0,13000,744000,-731000,-731000
20200520,062198,臺指反國票01購01,,,,,0.00,0.00,0,0,0,0,0,0,0,0,0,0,0,0,0
20200520,062199,臺指反國票02購02,,,,,0.00,0.00,0,0,0,0,0,0,0,0,0,0,0,0,0
20200520,06219P,國巨元富97售05,0.22,0.22,0.22,0.22,0.00,0.00,331000,1,72820,0,0,0,0,0,0,331000,331000,0,0
20200520,062200,臺指反國票03購01,1.34,1.35,1.34,1.35,-0.02,-1.46,216000,3,289540,0,0,0,0,0,0,200000,16000,184000,184000
20200520,062201,臺指反國票9B購05,,,,,0.00,0.00,0,0,0,0,0,0,0,0,0,0,0,0,0
20200520,062202,國巨國票9C購04,2.30,2.30,2.30,2.30,+0.17,7.98,10000,1,23000,0,0,0,0,0,0,0,10000,-10000,-10000
20200520,062203,燿華國票9C購01,1.42,1.64,1.41,1.64,+0.32,24.24,294000,25,461130,0,0,0,0,0,0,0,294000,-294000,-294000
20200520,062204,京元電國票9C購01,1.43,1.43,1.34,1.34,-0.16,-10.67,312000,13,426060,0,0,0,0,0,0,25000,287000,-262000,-262000
20200520,062205,奇力新國票9C購01,1.18,1.22,1.18,1.22,+0.05,4.27,168000,3,201520,0,0,0,0,0,0,86000,82000,4000,4000
20200520,062206,緯創國票9B購01,3.70,3.70,3.70,3.70,+0.19,5.41,38000,1,140600,0,0,0,0,0,0,0,38000,-38000,-38000
20200520,062207,牧德國票9B購02,1.06,1.20,1.06,1.16,0.00,0.00,300000,11,338970,0,0,0,0,0,0,0,300000,-300000,-300000
20200520,062208,旭富國票9C購01,1.81,1.84,1.81,1.83,-0.04,-2.14,131000,7,240140,0,0,0,0,0,0,12000,119000,-107000,-107000
20200520,062209,台積電台新9B購05,0.90,0.90,0.90,0.90,-0.01,-1.1,20000,1,18000,0,0,0,0,0,0,0,20000,-20000,-20000
20200520,06220P,廣宇元富97售02,,,,,0.00,0.00,0,0,0,0,0,0,0,0,0,0,0,0,0
20200520,062210,聯發科台新9B購01,2.30,2.53,2.30,2.34,+0.10,4.46,49000,3,113330,0,0,0,0,0,0,39000,10000,29000,29000
20200520,062211,玉晶光台新9B購01,,,,,0.00,0.00,0,0,0,0,0,0,0,0,0,0,0,0,0
20200520,062212,臻鼎台新9B購01,0.96,1.03,0.95,1.03,+0.04,4.04,127000,7,125460,0,0,0,0,0,0,13000,114000,-101000,-101000
20200520,062213,和大統一9B購02,0.91,1.08,0.91,1.08,+0.14,14.89,745000,32,728980,0,0,0,0,0,0,195000,550000,-355000,-355000
20200520,062214,金寶統一01購01,0.70,0.70,0.67,0.70,+0.02,2.94,347000,4,239420,0,0,0,0,0,0,99000,248000,-149000,-149000
20200520,062215,華通統一9B購01,1.00,1.00,1.00,1.00,-0.07,-6.54,23000,1,23000,0,0,0,0,0,0,23000,0,23000,23000
20200520,062216,國巨統一9B購11,0.81,0.85,0.80,0.80,+0.07,9.59,198000,3,163880,0,0,0,0,0,0,48000,150000,-102000,-102000
20200520,062217,旺宏統一9C購01,,,,,0.00,0.00,0,0,0,0,0,0,0,0,0,0,0,0,0
20200520,062218,燿華統一01購01,0.60,0.73,0.60,0.72,+0.13,22.03,913000,20,618790,0,0,0,0,0,0,306000,607000,-301000,-301000
20200520,062219,燿華統一9B購01,0.67,0.84,0.67,0.83,+0.17,25.76,1525000,31,1141480,0,0,0,0,0,0,143000,1379000,-1236000,-1236000
20200520,062220,台光電統一01購01,0.74,0.74,0.72,0.73,-0.01,-1.35,350000,13,254600,0,0,0,0,0,0,316000,34000,282000,282000
20200520,062221,奇力新統一01購01,0.61,0.62,0.59,0.59,+0.02,3.51,206000,7,125510,0,0,0,0,0,0,25000,181000,-156000,-156000
20200520,062222,華新科統一9B購04,0.73,0.75,0.73,0.75,+0.04,5.63,189000,2,138230,0,0,0,0,0,0,176000,13000,163000,163000
20200520,062223,大立光統一9C購04,1.41,1.41,1.41,1.41,0.00,0.00,21000,1,29610,0,0,0,0,0,0,0,21000,-21000,-21000
20200520,062224,玉晶光統一9C購03,,,,,0.00,0.00,0,0,0,0,0,0,0,0,0,0,0,0,0
20200520,062225,華擎統一01購01,0.91,1.03,0.91,1.02,+0.16,18.6,1859000,31,1849360,0,0,0,0,0,0,106000,1753000,-1647000,-1647000
20200520,062226,臻鼎統一9B購01,0.74,0.78,0.74,0.78,+0.05,6.85,251000,3,194240,0,250000,-250000,0,0,0,250000,1000,249000,-1000
20200520,062227,南六統一01購02,0.72,0.72,0.72,0.72,-0.03,-4.0,25000,1,18000,0,0,0,0,0,0,25000,0,25000,25000
20200520,062228,南六統一02購01,0.70,0.70,0.69,0.69,-0.02,-2.82,93000,3,64650,0,0,0,0,0,0,25000,68000,-43000,-43000
20200520,062229,南六統一9B購01,0.79,0.86,0.77,0.86,-0.03,-3.37,281000,8,233330,0,0,0,0,0,0,75000,206000,-131000,-131000
20200520,06222P,致茂元富97售02,,,,,0.00,0.00,0,0,0,0,0,0,0,0,0,0,0,0,0
20200520,062230,緯穎統一01購01,1.09,1.11,1.00,1.01,-0.04,-3.81,613000,32,642730,0,0,0,0,0,0,411000,229000,182000,182000
20200520,062231,台光電麥證9C購01,1.19,1.19,1.18,1.18,-0.05,-4.07,170000,2,201450,85000,85000,0,0,0,0,85000,85000,0,0
20200520,062232,聯詠麥證9C購01,1.19,1.19,1.16,1.16,-0.03,-2.52,138000,4,160380,93000,45000,48000,0,0,0,93000,45000,48000,48000
20200520,062233,神隆凱基9B購01,1.47,1.47,1.47,1.47,-0.02,-1.34,20000,1,29400,0,0,0,0,0,0,20000,0,20000,20000
20200520,062234,廣達凱基9B購01,1.48,1.49,1.38,1.41,-0.02,-1.4,1385000,92,2002300,0,0,0,0,0,0,827000,375000,452000,452000
20200520,062235,億光凱基9B購01,1.42,1.56,1.41,1.47,+0.07,5.0,236000,11,350640,0,0,0,0,0,0,50000,186000,-136000,-136000
20200520,062236,信邦凱基9B購01,1.12,1.16,1.06,1.06,-0.01,-0.93,421000,17,469930,0,0,0,0,0,0,70000,350000,-280000,-280000
20200520,062237,緯創凱基9B購01,1.94,1.94,1.93,1.93,+0.02,1.05,140000,8,270390,0,0,0,0,0,0,140000,0,140000,140000
20200520,062238,臻鼎凱基9C購01,1.02,1.10,1.02,1.08,0.00,0.00,199000,15,213610,0,0,0,0,0,0,6000,184000,-178000,-178000
20200520,062239,台汽電凱基9B購01,1.95,1.95,1.86,1.89,-0.12,-5.97,368000,13,696120,0,0,0,0,0,0,101000,257000,-156000,-156000
20200520,06223P,漢唐元富97售02,,,,,0.00,0.00,0,0,0,0,0,0,0,0,0,0,0,0,0
20200520,062240,上証2X元大9B購01,,,,,0.00,0.00,0,0,0,0,0,0,0,0,0,0,0,0,0
20200520,062241,滬深2X元大9B購03,,,,,0.00,0.00,0,0,0,0,0,0,0,0,0,0,0,0,0
20200520,062242,臺指反元大02購03,,,,,0.00,0.00,0,0,0,0,0,0,0,0,0,0,0,0,0
20200520,062243,臺指反元大02購04,,,,,0.00,0.00,0,0,0,0,0,0,0,0,0,0,0,0,0
20200520,062244,臺指反元大02購05,,,,,0.00,0.00,0,0,0,0,0,0,0,0,0,0,0,0,0
20200520,062245,臺指反元大02購06,,,,,0.00,0.00,0,0,0,0,0,0,0,0,0,0,0,0,0
20200520,062246,力山元大9B購02,1.96,1.99,1.96,1.99,0.00,0.00,34000,4,67540,0,0,0,0,0,0,0,34000,-34000,-34000
20200520,062247,國巨元大9B購07,2.58,2.58,2.58,2.58,0.00,0.00,25000,1,64500,0,0,0,0,0,0,0,25000,-25000,-25000
20200520,062248,國巨元大9B購08,2.51,2.63,2.51,2.55,0.00,0.00,40000,3,102000,0,0,0,0,0,0,15000,25000,-10000,-10000
20200520,062249,台積電元大9B購01,2.76,2.76,2.74,2.74,0.00,0.00,52000,2,143120,0,0,0,0,0,0,0,52000,-52000,-52000
20200520,06224P,可成元富97售02,,,,,0.00,0.00,0,0,0,0,0,0,0,0,0,0,0,0,0
20200520,062250,台積電元大9B購02,2.91,2.91,2.87,2.87,-0.05,-1.71,31000,3,89730,0,0,0,0,0,0,28000,3000,25000,25000
20200520,062251,旺宏元大9B購06,2.27,2.27,2.27,2.27,+0.01,0.44,10000,1,22700,0,0,0,0,0,0,0,10000,-10000,-10000
20200520,062252,華邦電元大9C購01,2.63,2.74,2.63,2.71,+0.15,5.86,167000,11,447940,0,0,0,0,0,0,67000,117000,-50000,-50000
20200520,062253,燿華元大9B購02,2.18,2.63,2.18,2.63,+0.42,19.0,379000,24,917060,0,0,0,0,0,0,25000,379000,-354000,-354000
20200520,062254,台光電元大9B購02,2.82,2.82,2.78,2.82,-0.01,-0.35,67000,6,187340,0,0,0,0,0,0,67000,0,67000,67000
20200520,062255,聯發科元大9B購07,4.13,4.33,4.11,4.15,+0.13,3.23,145000,12,605490,0,0,0,0,0,0,125000,30000,95000,95000
20200520,062256,聯發科元大9B購08,5.75,5.80,5.75,5.80,+0.10,1.75,15000,2,86500,0,0,0,0,0,0,15000,0,15000,15000
20200520,062257,聯發科元大9B購09,5.00,5.00,4.99,4.99,+0.12,2.46,10000,2,49960,0,0,0,0,0,0,10000,4000,6000,6000
20200520,062258,奇力新元大9B購03,1.59,1.63,1.59,1.63,+0.11,7.24,99000,2,160970,0,0,0,0,0,0,99000,0,99000,99000
20200520,062259,可成元大9B購03,2.44,2.44,2.32,2.32,-0.49,-17.44,19000,3,45140,0,0,0,0,0,0,9000,19000,-10000,-10000
20200520,06225P,華新科元富97售04,,,,,0.00,0.00,0,0,0,0,0,0,0,0,0,0,0,0,0
20200520,062260,華新科元大9B購09,2.55,2.61,2.49,2.49,-0.05,-1.97,163000,5,414840,0,0,0,0,0,0,145000,18000,127000,127000
20200520,062261,嘉晶元大9B購02,4.50,5.50,4.45,5.20,+0.83,18.99,251000,41,1213750,0,0,0,0,0,0,125000,204000,-79000,-79000
20200520,062262,茂林元大9B購02,2.77,3.13,2.77,3.13,+0.48,18.11,175000,11,511180,0,0,0,0,0,0,20000,155000,-135000,-135000
20200520,062263,康控元大9B購03,1.98,1.98,1.91,1.91,0.00,0.00,203000,13,392680,0,0,0,0,0,0,158000,45000,113000,113000
20200520,062264,南六元大9B購02,1.78,1.80,1.77,1.80,+0.01,0.56,138000,3,246740,0,0,0,0,0,0,60000,78000,-18000,-18000
20200520,062265,南茂元大9B購01,1.34,1.43,1.34,1.43,+0.07,5.15,259000,6,356310,0,0,0,0,0,0,156000,103000,53000,53000
20200520,062266,世紀鋼元大9B購02,1.94,1.95,1.74,1.74,-0.32,-15.53,155000,10,300050,0,0,0,0,0,0,0,155000,-155000,-155000
20200520,062267,滬深2X群益01購05,2.66,2.66,2.66,2.66,0.00,0.00,20000,2,53200,0,0,0,0,0,0,10000,20000,-10000,-10000
20200520,062268,力山群益9B購01,2.09,2.13,2.09,2.13,-0.01,-0.47,59000,2,124710,0,0,0,0,0,0,0,59000,-59000,-59000
20200520,062269,葡萄王群益9B購01,1.69,1.73,1.69,1.69,-0.05,-2.87,199000,6,338170,0,0,0,0,0,0,45000,154000,-109000,-109000
20200520,06226P,聯發科麥證97售03,0.62,0.62,0.62,0.62,-0.08,-11.43,1000,1,620,0,1000,-1000,0,0,0,0,1000,-1000,-1000
20200520,062270,上銀群益9B購03,,,,,0.00,0.00,0,0,0,0,0,0,0,0,0,0,0,0,0
20200520,062271,華通群益9C購02,2.19,2.19,2.19,2.19,-0.08,-3.52,33000,1,72270,0,0,0,0,0,0,0,33000,-33000,-33000
20200520,062272,鴻海群益9B購05,2.43,2.47,2.43,2.45,-0.08,-3.16,67000,7,164290,0,0,0,0,0,0,4000,67000,-63000,-63000
20200520,062273,國巨群益9C購02,1.95,1.95,1.85,1.87,0.00,0.00,127000,3,238010,0,0,0,0,0,0,0,127000,-127000,-127000
20200520,062274,台積電群益9B購04,0.96,0.96,0.96,0.96,0.00,0.00,15000,1,14400,0,0,0,0,0,0,15000,0,15000,15000
20200520,062275,燿華群益9B購01,1.22,1.44,1.22,1.44,+0.23,19.01,1087000,27,1464540,0,0,0,0,0,0,0,1087000,-1087000,-1087000
20200520,062276,瑞昱群益9B購01,3.73,3.73,3.60,3.60,-0.08,-2.17,51000,7,186000,0,0,0,0,0,0,10000,41000,-31000,-31000
20200520,062277,廣達群益9B購01,2.52,2.52,2.42,2.42,-0.03,-1.22,322000,14,804510,0,0,0,0,0,0,302000,20000,282000,282000
20200520,062278,聯發科群益9C購01,3.70,4.00,3.70,3.75,+0.17,4.75,271000,18,1046880,0,0,0,0,0,0,267000,256000,11000,11000
20200520,062279,晶豪科群益9B購01,3.06,3.06,2.89,2.89,-0.22,-7.07,89000,7,263500,0,0,0,0,0,0,78000,61000,17000,17000
20200520,06227P,大立光群益97售04,,,,,0.00,0.00,0,0,0,0,0,0,0,0,0,0,0,0,0
20200520,062280,大立光群益9C購01,1.98,2.05,1.98,2.05,-0.08,-3.76,72000,2,145150,0,0,0,0,0,0,35000,37000,-2000,-2000
20200520,062281,奇鋐群益9B購01,2.19,2.33,2.19,2.33,+0.04,1.75,196000,12,441950,0,0,0,0,0,0,0,196000,-196000,-196000
20200520,062282,禾伸堂群益9B購01,1.12,1.20,1.09,1.09,-0.06,-5.22,116000,7,130820,0,0,0,0,0,0,105000,11000,94000,94000
20200520,062283,玉晶光群益01購01,3.28,3.51,3.28,3.51,+0.25,7.67,34000,7,117350,0,0,0,0,0,0,5000,34000,-29000,-29000
20200520,062284,華擎群益9C購03,2.96,3.34,2.96,3.29,+0.46,16.25,386000,19,1245760,0,0,0,0,0,0,75000,316000,-241000,-241000
20200520,062285,台勝科群益9B購01,2.66,2.93,2.58,2.93,+0.01,0.34,246000,16,666760,0,0,0,0,0,0,16000,230000,-214000,-214000
20200520,062286,台郡群益9B購01,1.32,1.37,1.32,1.33,-0.02,-1.48,296000,7,396220,0,0,0,0,0,0,115000,181000,-66000,-66000
20200520,062287,康友群益9B購02,1.36,1.36,1.36,1.36,-0.06,-4.23,98000,1,133280,0,0,0,0,0,0,98000,0,98000,98000
20200520,062288,南六群益9B購01,1.27,1.28,1.27,1.28,-0.01,-0.78,160000,2,203820,0,0,0,0,0,0,62000,98000,-36000,-36000
20200520,062289,緯穎群益9B購01,4.70,4.70,4.19,4.19,-0.28,-6.26,18000,3,83630,0,0,0,0,0,0,0,18000,-18000,-18000
20200520,06228P,亞德客凱基97售04,,,,,0.00,0.00,0,0,0,0,0,0,0,0,0,0,0,0,0
20200520,062290,聯發科富邦9C購04,1.47,1.57,1.46,1.49,+0.08,5.67,212000,32,317780,0,0,0,0,0,0,162000,50000,112000,112000
20200520,062291,力成富邦9B購01,,,,,0.00,0.00,0,0,0,0,0,0,0,0,0,0,0,0,0
20200520,062292,旭富永豐9B購01,0.77,0.78,0.77,0.78,+0.01,1.3,322000,4,249540,0,0,0,0,0,0,0,322000,-322000,-322000
20200520,062293,麗豐永豐9B購01,0.69,0.73,0.67,0.67,-0.05,-6.94,111000,7,75460,0,0,0,0,0,0,89000,22000,67000,67000
20200520,062294,盛群永豐9B購01,0.82,0.82,0.82,0.82,-0.01,-1.2,60000,1,49200,0,0,0,0,0,0,60000,0,60000,60000
20200520,062295,康友永豐9B購01,0.59,0.62,0.59,0.59,-0.02,-3.28,237000,7,142600,0,0,0,0,0,0,0,237000,-237000,-237000
20200520,062296,南六永豐9B購02,0.72,0.80,0.72,0.79,+0.04,5.33,135000,5,107150,0,0,0,0,0,0,0,135000,-135000,-135000
20200520,062297,億豐永豐9B購01,1.02,1.09,1.02,1.09,+0.07,6.86,805000,15,850510,0,0,0,0,0,0,116000,686000,-570000,-570000
20200520,062298,國巨第一9B購01,,,,,0.00,0.00,0,0,0,0,0,0,0,0,0,0,0,0,0
20200520,062299,台積電第一9B購01,0.52,0.52,0.52,0.52,-0.01,-1.89,10000,1,5200,0,0,0,0,0,0,0,10000,-10000,-10000
20200520,06229P,欣興凱基97售07,,,,,0.00,0.00,0,0,0,0,0,0,0,0,0,0,0,0,0
20200520,062300,T50反1中信03購02,1.19,1.19,1.18,1.18,0.00,0.00,10000,2,11850,0,0,0,0,0,0,5000,5000,0,0
20200520,062301,聯詠中信05購01,1.10,1.12,1.08,1.08,-0.04,-3.57,71000,7,78410,0,0,0,0,0,0,35000,33000,2000,2000
20200520,062302,聯詠中信05購02,1.18,1.23,1.17,1.23,-0.01,-0.81,174000,27,210490,0,0,0,0,0,0,98000,76000,22000,22000
20200520,062303,台表科中信01購01,1.15,1.30,1.05,1.29,+0.21,19.44,810000,49,912300,0,0,0,0,0,0,299000,501000,-202000,-202000
20200520,062304,臺指反凱基9B購01,,,,,0.00,0.00,0,0,0,0,0,0,0,0,0,0,0,0,0
20200520,062305,遠東新凱基9B購01,1.37,1.54,1.37,1.54,+0.07,4.76,479000,24,682940,0,0,0,0,0,0,295000,135000,160000,160000
20200520,062306,華通凱基9B購01,,,,,0.00,0.00,0,0,0,0,0,0,0,0,0,0,0,0,0
20200520,062307,華通凱基9C購01,1.41,1.44,1.41,1.44,0.00,0.00,21000,2,29640,0,0,0,0,0,0,21000,0,21000,21000
20200520,062308,旺宏凱基9B購04,,,,,0.00,0.00,0,0,0,0,0,0,0,0,0,0,0,0,0
20200520,062309,燿華凱基9B購01,2.50,2.84,2.50,2.84,+0.33,13.15,489000,33,1313780,0,0,0,0,0,0,66000,423000,-357000,-357000
20200520,06230P,亞德客永豐97售03,0.64,0.68,0.64,0.68,+0.01,1.49,143000,4,96640,0,0,0,0,0,0,0,143000,-143000,-143000
20200520,062310,南亞科凱基9B購02,2.60,2.60,2.60,2.60,0.00,0.00,10000,2,26000,0,0,0,0,0,0,0,10000,-10000,-10000
20200520,062311,奇力新凱基9B購01,1.59,1.67,1.59,1.67,+0.13,8.44,89000,2,147990,0,0,0,0,0,0,89000,0,89000,89000
20200520,062312,大立光凱基9B購03,2.83,2.99,2.83,2.97,-0.06,-1.98,111000,7,322920,0,0,0,0,0,0,41000,70000,-29000,-29000
20200520,062313,聯詠凱基9C購01,1.70,1.83,1.70,1.72,-0.12,-6.52,195000,21,341300,0,0,0,0,0,0,86000,69000,17000,17000
20200520,062314,玉晶光凱基9B購06,2.82,3.08,2.81,3.08,+0.36,13.24,78000,14,236720,0,0,0,0,0,0,14000,78000,-64000,-64000
20200520,062315,健策凱基9C購01,2.37,2.45,2.37,2.45,0.00,0.00,165000,7,396750,0,0,0,0,0,0,1000,165000,-164000,-164000
20200520,062316,康控凱基9B購03,2.79,2.79,2.57,2.57,-0.05,-1.91,179000,26,471990,0,0,0,0,0,0,145000,0,145000,145000
20200520,062317,祥碩凱基9B購03,6.00,6.00,6.00,6.00,-0.35,-5.51,3000,1,18000,0,0,0,0,0,0,3000,0,3000,3000
20200520,062318,台郡凱基9B購01,,,,,0.00,0.00,0,0,0,0,0,0,0,0,0,0,0,0,0
20200520,062319,南六凱基9B購02,2.43,2.71,2.43,2.62,0.00,0.00,98000,6,246780,0,0,0,0,0,0,10000,88000,-78000,-78000
20200520,06231P,台積電永豐97售05,0.99,0.99,0.99,0.99,0.00,0.00,60000,1,59400,0,0,0,0,0,0,60000,60000,0,0
20200520,062320,南電凱基9B購03,,,,,0.00,0.00,0,0,0,0,0,0,0,0,0,0,0,0,0
20200520,062321,力成台新9B購01,0.90,0.90,0.89,0.89,-0.02,-2.2,12000,2,10700,0,0,0,0,0,0,2000,10000,-8000,-8000
20200520,062322,元金2X統一01購01,,,,,0.00,0.00,0,0,0,0,0,0,0,0,0,0,0,0,0
20200520,062323,上銀統一9B購03,,,,,0.00,0.00,0,0,0,0,0,0,0,0,0,0,0,0,0
20200520,062324,上銀統一9B購04,1.00,1.00,0.99,0.99,-0.04,-3.88,20000,2,19900,0,0,0,0,0,0,0,20000,-20000,-20000
20200520,062325,鴻海統一9B購05,0.95,0.95,0.93,0.93,-0.08,-7.92,165000,7,156430,0,0,0,0,0,0,23000,161000,-138000,-138000
20200520,062326,國巨統一9C購09,0.84,0.84,0.84,0.84,0.00,0.00,31000,3,26040,0,0,0,0,0,0,0,31000,-31000,-31000
20200520,062327,燿華統一9B購02,0.67,0.79,0.67,0.79,+0.13,19.7,406000,7,303370,0,0,0,0,0,0,76000,330000,-254000,-254000
20200520,062328,南亞科統一9C購01,1.53,1.59,1.53,1.56,+0.08,5.41,429000,6,679710,0,0,0,0,0,0,344000,85000,259000,259000
20200520,062329,奇力新統一9C購03,,,,,0.00,0.00,0,0,0,0,0,0,0,0,0,0,0,0,0
20200520,06232P,智易永豐97售01,1.06,1.08,1.06,1.08,-0.02,-1.82,35000,2,37660,0,0,0,0,0,0,0,35000,-35000,-35000
20200520,062330,可成統一9B購03,0.58,0.58,0.58,0.58,-0.10,-14.71,3000,1,1740,0,0,0,0,0,0,0,3000,-3000,-3000
20200520,062331,大立光統一9B購10,,,,,0.00,0.00,0,0,0,0,0,0,0,0,0,0,0,0,0
20200520,062332,大立光統一9B購11,0.91,0.96,0.91,0.96,+0.04,4.35,84000,4,78490,0,0,0,0,0,0,74000,10000,64000,64000
20200520,062333,嘉晶統一9C購01,1.21,1.48,1.20,1.39,+0.21,17.8,482000,26,634520,0,0,0,0,0,0,103000,379000,-276000,-276000
20200520,062334,健策統一9B購02,0.92,0.99,0.92,0.99,-0.07,-6.6,433000,10,407450,0,0,0,0,0,0,165000,268000,-103000,-103000
20200520,062335,茂林統一01購01,,,,,0.00,0.00,0,0,0,0,0,0,0,0,0,0,0,0,0
20200520,062336,茂林統一01購02,0.72,0.79,0.72,0.79,+0.12,17.91,229000,5,173690,0,0,0,0,0,0,29000,200000,-171000,-171000
20200520,062337,台表科統一01購01,0.98,1.12,0.91,1.08,+0.15,16.13,7556000,329,7408670,0,0,0,0,0,0,4556000,2680000,1876000,1876000
20200520,062338,鴻海麥證9B購01,1.53,1.53,1.53,1.53,-0.03,-1.92,10000,2,15300,0,10000,-10000,0,0,0,0,10000,-10000,-10000
20200520,062339,瑞昱麥證9C購01,1.20,1.22,1.16,1.22,+0.01,0.83,252000,11,298580,252000,0,252000,0,0,0,252000,0,252000,252000
20200520,06233P,訊芯永豐97售03,,,,,0.00,0.00,0,0,0,0,0,0,0,0,0,0,0,0,0
20200520,062340,力成麥證9B購01,0.81,0.83,0.81,0.83,-0.02,-2.35,119000,3,96430,117000,2000,115000,0,0,0,117000,2000,115000,115000
20200520,062341,台表科麥證9C購01,1.69,1.90,1.61,1.90,+0.27,16.56,202000,24,347100,111000,91000,20000,0,0,0,147000,92000,55000,55000
20200520,062342,上証2X群益01購03,,,,,0.00,0.00,0,0,0,0,0,0,0,0,0,0,0,0,0
20200520,062343,中石化群益9B購01,0.80,0.81,0.79,0.80,0.00,0.00,1358000,34,1081910,0,0,0,0,0,0,1105000,253000,852000,852000
20200520,062344,力山群益9B購02,1.08,1.12,1.08,1.12,+0.01,0.9,54000,2,58680,0,0,0,0,0,0,45000,9000,36000,36000
20200520,062345,和大群益9B購01,1.34,1.62,1.34,1.62,+0.18,12.5,525000,14,776120,0,0,0,0,0,0,293000,153000,140000,140000
20200520,062346,智邦群益9B購02,3.29,3.35,3.29,3.30,+0.05,1.54,56000,6,185610,0,0,0,0,0,0,8000,56000,-48000,-48000
20200520,062347,台光電群益9B購02,2.04,2.06,2.02,2.04,-0.03,-1.45,170000,7,345520,0,0,0,0,0,0,170000,0,170000,170000
20200520,062348,聯發科群益9B購06,4.29,4.51,4.29,4.37,+0.24,5.81,43000,8,190710,0,0,0,0,0,0,26000,23000,3000,3000
20200520,062349,新日興群益9B購02,1.41,1.65,1.40,1.65,+0.09,5.77,465000,7,698700,0,0,0,0,0,0,119000,346000,-227000,-227000
20200520,06234P,亞德客元大97售02,0.50,0.55,0.49,0.53,-0.04,-7.02,127000,5,67950,0,0,0,0,0,0,0,127000,-127000,-127000
20200520,062350,台表科群益9B購01,1.19,1.52,1.15,1.50,+0.31,26.05,1543000,55,2008340,0,0,0,0,0,0,420000,1123000,-703000,-703000
20200520,062351,瑞祺群益9C購01,1.33,1.45,1.33,1.45,+0.10,7.41,851000,12,1194260,0,0,0,0,0,0,37000,814000,-777000,-777000
20200520,062352,南六群益9B購02,1.15,1.27,1.15,1.27,+0.06,4.96,55000,2,65050,0,0,0,0,0,0,40000,15000,25000,25000
20200520,062353,亞德客元大9B購01,2.61,2.69,2.61,2.69,+0.03,1.13,100000,3,265000,0,0,0,0,0,0,50000,50000,0,0
20200520,062354,台達電元大9B購01,,,,,0.00,0.00,0,0,0,0,0,0,0,0,0,0,0,0,0
20200520,062355,華通元大9B購03,2.85,2.93,2.80,2.93,-0.12,-3.93,23000,3,66200,0,0,0,0,0,0,13000,10000,3000,3000
20200520,062356,國巨元大9B購10,1.64,1.64,1.64,1.64,+0.09,5.81,249000,1,408360,0,0,0,0,0,0,0,249000,-249000,-249000
20200520,062357,國巨元大9B購11,2.08,2.18,2.08,2.16,+0.18,9.09,52000,4,112520,0,0,0,0,0,0,5000,47000,-42000,-42000
20200520,062358,國巨元大9B購12,2.61,2.78,2.61,2.62,0.00,0.00,335000,15,903100,0,0,0,0,0,0,0,335000,-335000,-335000
20200520,062359,旺宏元大9C購02,1.35,1.37,1.35,1.37,+0.04,3.01,13000,2,17610,0,0,0,0,0,0,10000,3000,7000,7000
20200520,06235P,國巨元大97售12,,,,,0.00,0.00,0,0,0,0,0,0,0,0,0,0,0,0,0
20200520,062360,華邦電元大9B購01,1.50,1.56,1.50,1.53,+0.09,6.25,325000,16,500240,0,0,0,0,0,0,153000,172000,-19000,-19000
20200520,062361,智邦元大9B購06,2.74,2.85,2.74,2.85,+0.09,3.26,74000,4,204680,0,0,0,0,0,0,0,74000,-74000,-74000
20200520,062362,致茂元大9B購01,1.73,1.83,1.73,1.83,+0.07,3.98,262000,10,472860,0,0,0,0,0,0,50000,212000,-162000,-162000
20200520,062363,燿華元大9B購03,1.54,1.86,1.54,1.85,+0.31,20.13,902000,36,1533790,0,0,0,0,0,0,118000,834000,-716000,-716000
20200520,062364,瑞昱元大9B購04,3.14,3.14,3.00,3.00,-0.07,-2.28,111000,21,342920,0,0,0,0,0,0,99000,62000,37000,37000
20200520,062365,台光電元大9B購03,1.98,2.01,1.96,2.01,-0.07,-3.37,135000,6,268560,0,0,0,0,0,0,85000,83000,2000,2000
20200520,062366,義隆元大9B購04,2.35,2.35,2.35,2.35,0.00,0.00,9000,1,21150,0,0,0,0,0,0,0,9000,-9000,-9000
20200520,062367,禾伸堂元大9B購02,2.34,2.47,2.30,2.43,+0.11,4.74,85000,8,201850,0,0,0,0,0,0,70000,15000,55000,55000
20200520,062368,聯詠元大9B購01,2.91,3.08,2.91,2.99,-0.13,-4.17,173000,16,517340,0,0,0,0,0,0,137000,106000,31000,31000
20200520,062369,創意元大9B購01,2.83,2.83,2.83,2.83,+0.01,0.35,30000,2,84900,0,0,0,0,0,0,18000,12000,6000,6000
20200520,06236P,台積電元大97售25,,,,,0.00,0.00,0,0,0,0,0,0,0,0,0,0,0,0,0
20200520,062370,華擎元大9B購01,2.02,2.23,2.02,2.23,+0.26,13.2,147000,7,311230,0,0,0,0,0,0,30000,117000,-87000,-87000
20200520,062371,健策元大9B購08,2.40,2.50,2.35,2.50,-0.20,-7.41,161000,11,384130,0,0,0,0,0,0,72000,95000,-23000,-23000
20200520,062372,旭富元大9B購01,2.43,2.48,2.43,2.48,+0.01,0.4,76000,3,185830,0,0,0,0,0,0,0,65000,-65000,-65000
20200520,062373,泰鼎元大9B購01,2.48,2.67,2.34,2.67,+0.20,8.1,747000,64,1853080,0,0,0,0,0,0,417000,345000,72000,72000
20200520,062374,茂林元大9B購03,2.36,2.76,2.36,2.76,0.00,0.00,245000,14,621910,0,0,0,0,0,0,0,245000,-245000,-245000
20200520,062375,祥碩元大9B購03,5.55,5.95,5.45,5.95,+0.25,4.39,135000,12,766100,0,0,0,0,0,0,40000,125000,-85000,-85000
20200520,062376,中租元大9B購02,2.64,2.64,2.64,2.64,+0.02,0.76,92000,3,242880,0,0,0,0,0,0,92000,42000,50000,50000
20200520,062377,力成元大9B購01,1.93,1.95,1.84,1.86,-0.05,-2.62,133000,12,255960,0,0,0,0,0,0,52000,81000,-29000,-29000
20200520,062378,台表科元大9C購01,4.14,4.56,3.93,4.56,+0.73,19.06,208000,25,858720,0,0,0,0,0,0,145000,79000,66000,66000
20200520,062379,致新元大9B購01,2.51,2.61,2.46,2.46,+0.03,1.23,172000,17,436190,0,0,0,0,0,0,162000,7000,155000,155000
20200520,06237P,台積電元大97售26,,,,,0.00,0.00,0,0,0,0,0,0,0,0,0,0,0,0,0
20200520,062380,巨大元大9B購01,2.80,3.00,2.80,2.94,+0.41,16.21,202000,25,590430,0,0,0,0,0,0,59000,138000,-79000,-79000
20200520,062381,上銀國泰9C購01,1.44,1.44,1.38,1.38,-0.03,-2.13,20000,3,28370,0,0,0,0,0,0,0,20000,-20000,-20000
20200520,062382,燿華國泰9C購01,1.19,1.48,1.19,1.48,+0.29,24.37,592000,15,815770,0,0,0,0,0,0,42000,550000,-508000,-508000
20200520,062383,大立光國泰01購01,0.95,1.01,0.95,1.01,+0.05,5.21,87000,3,83250,0,0,0,0,0,0,77000,10000,67000,67000
20200520,062384,聯詠國泰9C購01,1.17,1.25,1.16,1.20,-0.06,-4.76,422000,16,503360,0,0,0,0,0,0,109000,313000,-204000,-204000
20200520,062385,玉晶光國泰01購01,1.76,1.85,1.76,1.85,+0.07,3.93,282000,8,511630,0,0,0,0,0,0,68000,215000,-147000,-147000
20200520,062386,京鼎國泰9C購01,1.23,1.23,1.20,1.20,-0.01,-0.83,107000,6,129950,0,0,0,0,0,0,45000,62000,-17000,-17000
20200520,062387,健策國泰01購01,1.20,1.26,1.15,1.26,+0.08,6.78,1362000,27,1661770,0,0,0,0,0,0,131000,1250000,-1119000,-1119000
20200520,062388,旭富國泰01購01,1.72,1.77,1.69,1.72,+0.03,1.78,235000,12,408310,0,0,0,0,0,0,45000,190000,-145000,-145000
20200520,062389,台表科國泰01購01,2.29,2.65,2.09,2.55,+0.46,22.01,4063000,155,9172860,0,0,0,0,0,0,1984000,2507000,-523000,-523000
20200520,06238P,台積電元大98售07,,,,,0.00,0.00,0,0,0,0,0,0,0,0,0,0,0,0,0
20200520,062390,元黃金富邦9C購01,1.96,1.96,1.96,1.96,0.00,0.00,10000,1,19600,0,0,0,0,0,0,10000,0,10000,10000
20200520,062391,台達電富邦9C購01,0.80,0.80,0.77,0.77,-0.01,-1.28,160000,33,127410,0,0,0,0,0,0,158000,2000,156000,156000
20200520,062392,國巨富邦02購01,0.62,0.67,0.62,0.64,+0.06,10.34,550000,29,354150,0,0,0,0,0,0,120000,430000,-310000,-310000
20200520,062393,智邦富邦9B購01,0.47,0.49,0.46,0.48,+0.03,6.67,409000,17,195640,0,0,0,0,0,0,253000,352000,-99000,-99000
20200520,062394,大立光富邦02購01,,,,,0.00,0.00,0,0,0,0,0,0,0,0,0,0,0,0,0
20200520,062395,台表科富邦9C購01,0.88,1.04,0.80,0.99,+0.18,22.22,4827000,166,4281930,0,0,0,0,0,0,2099000,2421000,-322000,-322000
20200520,062396,華通永豐9B購01,,,,,0.00,0.00,0,0,0,0,0,0,0,0,0,0,0,0,0
20200520,062397,國巨永豐9B購02,,,,,0.00,0.00,0,0,0,0,0,0,0,0,0,0,0,0,0
20200520,062398,建準永豐9B購01,1.84,1.86,1.75,1.85,-0.03,-1.6,175000,18,317340,0,0,0,0,0,0,75000,100000,-25000,-25000
20200520,062399,神基永豐9B購01,,,,,0.00,0.00,0,0,0,0,0,0,0,0,0,0,0,0,0
20200520,06239P,奇力新元大97售08,2.85,2.88,2.85,2.88,-0.20,-6.49,35000,2,100050,0,0,0,0,0,0,0,35000,-35000,-35000
20200520,062400,晶豪科永豐9B購02,0.89,0.89,0.82,0.84,-0.07,-7.69,773000,20,642200,0,0,0,0,0,0,727000,17000,710000,710000
20200520,062401,信邦永豐9B購01,0.85,0.86,0.80,0.80,-0.07,-8.05,271000,11,227500,0,0,0,0,0,0,0,271000,-271000,-271000
20200520,062402,台勝科永豐9B購02,0.71,0.78,0.71,0.78,-0.01,-1.27,35000,3,25410,0,0,0,0,0,0,26000,9000,17000,17000
20200520,062403,健策永豐9B購06,1.11,1.18,1.10,1.17,-0.06,-4.88,166000,5,192400,0,0,0,0,0,0,11000,156000,-145000,-145000
20200520,062404,新唐永豐9B購01,,,,,0.00,0.00,0,0,0,0,0,0,0,0,0,0,0,0,0
20200520,062405,泰鼎永豐9B購02,0.99,1.10,0.99,1.10,+0.10,10.0,467000,19,498490,0,0,0,0,0,0,3000,464000,-461000,-461000
20200520,062406,臻鼎永豐9B購01,0.64,0.68,0.64,0.68,0.00,0.00,407000,10,271160,0,0,0,0,0,0,2000,405000,-403000,-403000
20200520,062407,同欣電永豐9B購01,0.82,0.86,0.82,0.83,+0.02,2.47,63000,7,53480,0,0,0,0,0,0,14000,49000,-35000,-35000
20200520,062408,致新永豐9B購01,0.93,0.96,0.90,0.92,+0.05,5.75,294000,13,269140,0,0,0,0,0,0,206000,88000,118000,118000
20200520,062409,巨大永豐9B購02,1.30,1.48,1.30,1.42,+0.23,19.33,111000,11,153690,0,0,0,0,0,0,10000,60000,-50000,-50000
20200520,06240P,奇力新元富97售03,1.43,1.43,1.43,1.43,-0.16,-10.06,50000,2,71500,0,0,0,0,0,0,0,50000,-50000,-50000
20200520,062410,台積電第一9B購02,0.33,0.33,0.32,0.33,-0.01,-2.94,222000,5,72260,0,0,0,0,0,0,100000,122000,-22000,-22000
20200520,062411,玉晶光第一9B購01,0.74,0.74,0.74,0.74,0.00,0.00,70000,1,51800,0,0,0,0,0,0,70000,0,70000,70000
20200520,062412,道瓊指中信9C購05,,,,,0.00,0.00,0,0,0,0,0,0,0,0,0,0,0,0,0
20200520,062413,台光電中信9B購02,0.61,0.62,0.60,0.62,-0.04,-6.06,90000,28,55020,0,0,0,0,0,0,90000,0,90000,90000
20200520,062414,臻鼎中信01購01,0.51,0.55,0.51,0.55,+0.05,10.0,122000,9,66680,0,0,0,0,0,0,92000,20000,72000,72000
20200520,062415,聯茂中信9C購01,0.55,0.55,0.52,0.52,-0.04,-7.14,185000,5,98200,0,0,0,0,0,0,165000,20000,145000,145000
20200520,062416,和大統一01購02,0.62,0.70,0.61,0.70,+0.06,9.38,370000,7,239470,0,0,0,0,0,0,50000,320000,-270000,-270000
20200520,062417,鴻海統一9C購08,,,,,0.00,0.00,0,0,0,0,0,0,0,0,0,0,0,0,0
20200520,062418,台積電統一01購06,,,,,0.00,0.00,0,0,0,0,0,0,0,0,0,0,0,0,0
20200520,062419,台積電統一9B購15,,,,,0.00,0.00,0,0,0,0,0,0,0,0,0,0,0,0,0
20200520,06241P,大立光元富9A售01,,,,,0.00,0.00,0,0,0,0,0,0,0,0,0,0,0,0,0
20200520,062420,台積電統一9C購08,1.29,1.29,1.29,1.29,+0.01,0.78,1000,1,1290,0,0,0,0,0,0,1000,1000,0,0
20200520,062421,台積電統一9C購09,0.85,0.85,0.85,0.85,-0.02,-2.3,50000,2,42500,0,0,0,0,0,0,15000,35000,-20000,-20000
20200520,062422,億光統一01購01,0.75,0.76,0.73,0.73,+0.01,1.39,99000,4,73180,0,0,0,0,0,0,0,99000,-99000,-99000
20200520,062423,聯發科統一9C購07,1.43,1.58,1.41,1.45,+0.05,3.57,774000,53,1140830,0,0,0,0,0,0,141000,633000,-492000,-492000
20200520,062424,聯發科統一9C購08,1.32,1.43,1.32,1.34,+0.06,4.69,163000,8,228580,0,0,0,0,0,0,163000,0,163000,163000
20200520,062425,可成統一01購01,0.62,0.62,0.60,0.60,-0.07,-10.45,10000,2,6100,0,0,0,0,0,0,0,10000,-10000,-10000
20200520,062426,大立光統一02購02,0.66,0.69,0.66,0.69,+0.02,2.99,172000,6,116730,0,0,0,0,0,0,1000,171000,-170000,-170000
20200520,062427,嘉澤統一01購01,1.22,1.24,1.19,1.19,-0.04,-3.25,170000,7,206950,0,0,0,0,0,0,91000,79000,12000,12000
20200520,062428,超眾統一9B購01,0.85,0.85,0.85,0.85,0.00,0.00,4000,1,3400,0,0,0,0,0,0,0,4000,-4000,-4000
20200520,062429,A50正2元大9B購01,,,,,0.00,0.00,0,0,0,0,0,0,0,0,0,0,0,0,0
20200520,06242P,大立光元富9A售02,4.71,4.71,4.56,4.56,-0.18,-3.8,7000,3,32580,0,0,0,0,0,0,6000,1000,5000,5000
20200520,062430,A50正2元大9B購02,,,,,0.00,0.00,0,0,0,0,0,0,0,0,0,0,0,0,0
20200520,062431,元金2X元大9B購02,,,,,0.00,0.00,0,0,0,0,0,0,0,0,0,0,0,0,0
20200520,062432,上銀元大9B購04,3.13,3.13,3.13,3.13,+0.02,0.64,60000,2,187800,0,0,0,0,0,0,0,60000,-60000,-60000
20200520,062433,上銀元大9B購05,2.95,2.95,2.95,2.95,-0.04,-1.34,29000,1,85550,0,0,0,0,0,0,0,29000,-29000,-29000
20200520,062434,華通元大9B購04,2.49,2.58,2.49,2.58,+0.07,2.79,118000,5,297920,0,0,0,0,0,0,50000,68000,-18000,-18000
20200520,062435,國巨元大9B購13,2.89,3.10,2.85,3.02,+0.31,11.44,180000,10,540600,0,0,0,0,0,0,30000,150000,-120000,-120000
20200520,062436,國巨元大9B購14,2.16,2.34,2.16,2.19,0.00,0.00,353000,18,799230,0,0,0,0,0,0,3000,350000,-347000,-347000
20200520,062437,廣達元大9B購01,4.03,4.03,4.03,4.03,+0.11,2.81,19000,2,76570,0,0,0,0,0,0,19000,0,19000,19000
20200520,062438,台光電元大9B購04,1.68,1.68,1.68,1.68,-0.11,-6.15,56000,2,94080,0,0,0,0,0,0,22000,34000,-12000,-12000
20200520,062439,聯發科元大9B購10,3.25,3.42,3.25,3.28,+0.13,4.13,53000,9,175700,0,0,0,0,0,0,37000,22000,15000,15000
20200520,06243P,亞光元富97售01,4.20,4.23,4.20,4.23,-0.10,-2.31,130000,4,549000,0,0,0,0,0,0,0,130000,-130000,-130000
20200520,062440,聯發科元大9B購11,4.59,4.72,4.54,4.62,+0.16,3.59,13000,4,60130,0,0,0,0,0,0,9000,13000,-4000,-4000
20200520,062441,華新科元大9C購01,2.29,2.36,2.23,2.23,-0.05,-2.19,236000,26,540600,0,0,0,0,0,0,204000,34000,170000,170000
20200520,062442,華新科元大9C購02,1.75,1.81,1.72,1.75,-0.01,-0.57,78000,8,136430,0,0,0,0,0,0,20000,58000,-38000,-38000
20200520,062443,大立光元大9B購05,,,,,0.00,0.00,0,0,0,0,0,0,0,0,0,0,0,0,0
20200520,062444,大立光元大9C購01,1.68,1.68,1.68,1.68,-0.02,-1.18,10000,1,16800,0,0,0,0,0,0,10000,0,10000,10000
20200520,062445,大立光元大9C購02,2.61,2.67,2.61,2.67,-0.07,-2.55,60000,5,159100,0,0,0,0,0,0,25000,35000,-10000,-10000
20200520,062446,聯詠元大9B購02,2.62,2.73,2.62,2.66,-0.13,-4.66,104000,12,276020,0,0,0,0,0,0,80000,34000,46000,46000
20200520,062447,華擎元大9C購01,2.07,2.31,2.07,2.28,0.00,0.00,264000,23,585390,0,0,0,0,0,0,98000,259000,-161000,-161000
20200520,062448,健策元大9C購04,1.22,1.29,1.22,1.29,-0.03,-2.27,52000,3,67010,0,0,0,0,0,0,1000,52000,-51000,-51000
20200520,062449,臻鼎元大9B購01,1.67,1.79,1.67,1.78,0.00,0.00,351000,9,611770,0,0,0,0,0,0,0,351000,-351000,-351000
20200520,06244P,智易元富97售02,1.07,1.07,1.07,1.07,0.00,0.00,1000,1,1070,0,0,0,0,0,0,0,1000,-1000,-1000
20200520,062450,臻鼎元大9B購02,1.56,1.71,1.56,1.69,0.00,0.00,321000,9,533870,0,0,0,0,0,0,0,321000,-321000,-321000
20200520,062451,瀚宇博元大9B購02,1.68,1.68,1.68,1.68,0.00,0.00,70000,2,117600,0,0,0,0,0,0,0,70000,-70000,-70000
20200520,062452,A50正2群益01購04,,,,,0.00,0.00,0,0,0,0,0,0,0,0,0,0,0,0,0
20200520,062453,聚陽群益9C購01,1.90,1.90,1.81,1.83,+0.03,1.67,118000,5,216940,0,0,0,0,0,0,0,118000,-118000,-118000
20200520,062454,華通群益9C購03,1.89,1.90,1.82,1.82,0.00,0.00,153000,7,283090,0,0,0,0,0,0,0,153000,-153000,-153000
20200520,062455,鴻海群益9C購01,,,,,0.00,0.00,0,0,0,0,0,0,0,0,0,0,0,0,0
20200520,062456,台積電群益9B購05,1.97,1.97,1.93,1.93,-0.02,-1.03,55000,2,108150,0,0,0,0,0,0,50000,5000,45000,45000
20200520,062457,京元電群益9B購01,0.91,0.91,0.86,0.86,-0.24,-21.82,310000,6,270900,0,0,0,0,0,0,0,310000,-310000,-310000
20200520,062458,全新群益9B購03,,,,,0.00,0.00,0,0,0,0,0,0,0,0,0,0,0,0,0
20200520,062459,聯詠群益9B購01,1.79,1.90,1.79,1.85,-0.07,-3.65,279000,9,525050,0,0,0,0,0,0,123000,156000,-33000,-33000
20200520,06245P,健策元富97售03,1.07,1.11,1.00,1.02,-0.08,-7.27,365000,15,387980,0,0,0,0,0,0,139000,226000,-87000,-87000
20200520,062460,京鼎群益9C購01,1.71,1.72,1.70,1.72,+0.04,2.38,47000,4,80230,0,0,0,0,0,0,15000,32000,-17000,-17000
20200520,062461,智伸科群益9B購01,1.69,1.82,1.69,1.75,+0.08,4.79,1375000,44,2393400,0,0,0,0,0,0,747000,546000,201000,201000
20200520,062462,GIS群益9B購01,1.22,1.22,1.22,1.22,0.00,0.00,61000,1,74420,0,0,0,0,0,0,0,61000,-61000,-61000
20200520,062463,世紀鋼麥證9B購01,,,,,0.00,0.00,0,0,0,0,0,0,0,0,0,0,0,0,0
20200520,062464,T50反1凱基9C購03,0.71,0.71,0.71,0.71,-0.01,-1.39,85000,1,60350,0,0,0,0,0,0,85000,0,85000,85000
20200520,062465,臺指反凱基01購01,,,,,0.00,0.00,0,0,0,0,0,0,0,0,0,0,0,0,0
20200520,062466,FBVIX凱基9B購01,1.12,1.13,1.11,1.12,+0.03,2.75,273000,7,306340,0,0,0,0,0,0,175000,98000,77000,77000
20200520,062467,國巨凱基9B購08,1.95,1.95,1.95,1.95,+0.16,8.94,31000,1,60450,0,0,0,0,0,0,0,31000,-31000,-31000
20200520,062468,台積電凱基9B購06,,,,,0.00,0.00,0,0,0,0,0,0,0,0,0,0,0,0,0
20200520,062469,旺宏凱基9B購05,,,,,0.00,0.00,0,0,0,0,0,0,0,0,0,0,0,0,0
20200520,06246P,茂林元富97售03,0.91,0.91,0.62,0.62,-0.33,-34.74,220000,15,158420,0,0,0,0,0,0,4000,196000,-192000,-192000
20200520,062470,智邦凱基9C購01,3.07,3.19,3.07,3.19,+0.16,5.28,33000,3,104910,0,0,0,0,0,0,30000,23000,7000,7000
20200520,062471,國泰金凱基9B購02,3.16,3.16,3.15,3.15,-0.02,-0.63,23000,3,72580,0,0,0,0,0,0,13000,10000,3000,3000
20200520,062472,大立光凱基9B購04,0.99,0.99,0.99,0.99,0.00,0.00,5000,1,4950,0,0,0,0,0,0,0,5000,-5000,-5000
20200520,062473,同欣電凱基9B購01,2.38,2.55,2.38,2.41,+0.07,2.99,116000,10,283850,0,0,0,0,0,0,45000,71000,-26000,-26000
20200520,062474,台表科凱基9C購01,2.82,3.34,2.72,3.30,+0.59,21.77,287000,26,881020,0,0,0,0,0,0,177000,112000,65000,65000
20200520,062475,道瓊反國票9B購02,1.59,1.59,1.58,1.58,0.00,0.00,49000,6,77770,0,0,0,0,0,0,19000,30000,-11000,-11000
20200520,062476,神隆國票9B購01,2.43,2.50,2.43,2.50,-0.06,-2.34,21000,2,51870,0,0,0,0,0,0,9000,12000,-3000,-3000
20200520,062477,聯詠國票9B購01,2.26,2.41,2.25,2.41,+0.03,1.26,70000,5,161640,0,0,0,0,0,0,27000,43000,-16000,-16000
20200520,062478,牧德國票9B購03,4.26,4.83,4.26,4.83,+0.63,15.0,22000,4,95690,0,0,0,0,0,0,8000,15000,-7000,-7000
20200520,062479,TPK國票9B購01,3.09,3.21,3.09,3.09,-0.06,-1.9,278000,8,866810,0,0,0,0,0,0,211000,217000,-6000,-6000
20200520,06247P,同欣電元富97售02,1.32,1.32,1.32,1.32,0.00,0.00,5000,1,6600,0,0,0,0,0,0,5000,0,5000,5000
20200520,062480,茂林國票9B購01,1.88,2.17,1.87,2.17,+0.34,18.58,392000,14,801810,0,0,0,0,0,0,13000,379000,-366000,-366000
20200520,062481,同欣電國票9B購01,2.84,3.10,2.84,2.84,-0.01,-0.35,126000,14,373060,40000,0,40000,0,0,0,12000,115000,-103000,-63000
20200520,062482,台表科國票9B購01,4.02,5.10,4.02,5.10,+0.74,16.97,309000,34,1353630,0,0,0,0,0,0,158000,151000,7000,7000
20200520,062483,致新國票9B購01,3.52,3.52,3.31,3.33,+0.22,7.07,183000,11,621670,0,0,0,0,0,0,96000,87000,9000,9000
20200520,062484,臺股指國票9B購10,2.60,2.60,2.60,2.60,-0.01,-0.38,160000,1,416000,0,0,0,0,0,0,0,160000,-160000,-160000
20200520,062485,華通國泰01購01,1.31,1.31,1.31,1.31,-0.05,-3.68,1000,1,1310,0,0,0,0,0,0,0,1000,-1000,-1000
20200520,062486,瑞昱富邦9B購01,0.66,0.68,0.61,0.64,-0.01,-1.54,3361000,124,2199350,0,0,0,0,0,0,2715000,1016000,1699000,1699000
20200520,062487,中興電永豐9B購01,1.05,1.07,1.03,1.05,-0.04,-3.67,656000,73,685420,0,0,0,0,0,0,646000,10000,636000,636000
20200520,062488,台光電永豐9B購02,,,,,0.00,0.00,0,0,0,0,0,0,0,0,0,0,0,0,0
20200520,062489,可成永豐9B購02,,,,,0.00,0.00,0,0,0,0,0,0,0,0,0,0,0,0,0
20200520,06248P,國巨統一97售07,2.11,2.11,2.11,2.11,0.00,0.00,10000,1,21100,0,0,0,0,0,0,0,10000,-10000,-10000
20200520,062490,聯茂永豐9B購01,0.53,0.53,0.51,0.53,-0.03,-5.36,666000,11,349240,0,0,0,0,0,0,654000,0,654000,654000
20200520,062491,矽創永豐9B購01,0.87,0.87,0.76,0.76,-0.10,-11.63,396000,12,323270,0,0,0,0,0,0,396000,0,396000,396000
20200520,062492,牧德第一9B購01,0.53,0.58,0.53,0.57,+0.10,21.28,604000,12,330570,0,0,0,0,0,0,0,604000,-604000,-604000
20200520,062493,元金反中信9B購01,1.33,1.33,1.33,1.33,-0.07,-5.0,5000,1,6650,0,0,0,0,0,0,5000,0,5000,5000
20200520,062494,中石化中信9C購01,0.98,0.98,0.95,0.95,-0.02,-2.06,386000,23,374430,0,0,0,0,0,0,386000,0,386000,386000
20200520,062495,友達中信01購02,1.06,1.08,1.06,1.08,0.00,0.00,23000,2,24660,0,0,0,0,0,0,0,23000,-23000,-23000
20200520,062496,矽創中信9B購01,0.73,0.73,0.63,0.64,-0.07,-9.86,533000,35,369060,0,0,0,0,0,0,423000,110000,313000,313000
20200520,062497,遠東新群益9B購01,2.17,2.43,2.17,2.43,+0.10,4.29,584000,13,1324420,0,0,0,0,0,0,347000,237000,110000,110000
20200520,062498,華通群益9C購04,2.10,2.10,2.08,2.10,0.00,0.00,80000,5,167500,0,0,0,0,0,0,0,80000,-80000,-80000
20200520,062499,鴻海群益01購01,2.78,2.79,2.71,2.71,-0.14,-4.91,57000,5,158180,0,0,0,0,0,0,25000,32000,-7000,-7000
20200520,06249P,億光統一97售02,2.06,2.08,2.06,2.06,-0.07,-3.29,7000,7,14440,0,0,0,0,0,0,7000,0,7000,7000
20200520,062500,國巨群益01購01,3.83,4.08,3.83,4.04,+0.37,10.08,60000,9,234020,0,0,0,0,0,0,0,60000,-60000,-60000
20200520,062501,台積電群益9C購03,3.53,3.53,3.40,3.40,-0.12,-3.41,20000,7,69860,0,0,0,0,0,0,20000,6000,14000,14000
20200520,062502,旺宏群益9C購01,,,,,0.00,0.00,0,0,0,0,0,0,0,0,0,0,0,0,0
20200520,062503,玉晶光群益01購03,2.87,3.11,2.87,3.11,+0.27,9.51,156000,20,476720,0,0,0,0,0,0,8000,156000,-148000,-148000
20200520,062504,旭富群益9B購02,2.31,2.31,2.31,2.31,-0.01,-0.43,15000,1,34650,0,0,0,0,0,0,0,15000,-15000,-15000
20200520,062505,祥碩群益9B購03,4.32,4.56,4.32,4.56,+0.46,11.22,70000,7,311620,0,0,0,0,0,0,0,70000,-70000,-70000
20200520,062506,巨大群益9C購01,3.66,4.01,3.66,3.76,+0.62,19.75,203000,15,775200,0,0,0,0,0,0,31000,192000,-161000,-161000
20200520,062507,臺股指群益9B購02,,,,,0.00,0.00,0,0,0,0,0,0,0,0,0,0,0,0,0
20200520,062508,臺股指群益9B購03,2.15,2.15,2.15,2.15,+0.06,2.87,210000,1,451500,0,0,0,0,0,0,210000,0,210000,210000
20200520,062509,SP黃豆國票9B購03,1.59,1.61,1.59,1.61,0.00,0.00,60000,5,96000,0,0,0,0,0,0,0,50000,-50000,-50000
20200520,06250P,臺股指永昌97售02,,,,,0.00,0.00,0,0,0,0,0,0,0,0,0,0,0,0,0
20200520,062510,台積電國票01購01,,,,,0.00,0.00,0,0,0,0,0,0,0,0,0,0,0,0,0
20200520,062511,台光電國票9B購02,2.40,2.47,2.34,2.47,-0.15,-5.73,87000,5,209920,0,0,0,0,0,0,37000,50000,-13000,-13000
20200520,062512,美食國票9B購01,2.68,2.68,2.43,2.43,+0.07,2.97,200000,18,527020,0,0,0,0,0,0,190000,10000,180000,180000
20200520,062513,玉晶光國票9C購01,2.54,2.73,2.54,2.73,+0.16,6.23,32000,9,86460,0,0,0,0,0,0,10000,32000,-22000,-22000
20200520,062514,玉晶光國票9C購02,,,,,0.00,0.00,0,0,0,0,0,0,0,0,0,0,0,0,0
20200520,062515,台灣50元大9B購15,,,,,0.00,0.00,0,0,0,0,0,0,0,0,0,0,0,0,0
20200520,062516,台灣50元大9B購16,,,,,0.00,0.00,0,0,0,0,0,0,0,0,0,0,0,0,0
20200520,062517,滬深2X元大9B購05,0.98,0.98,0.98,0.98,-0.02,-2.0,30000,1,29400,0,0,0,0,0,0,0,30000,-30000,-30000
20200520,062518,臺指反元大02購07,,,,,0.00,0.00,0,0,0,0,0,0,0,0,0,0,0,0,0
20200520,062519,元金2X元大9B購03,,,,,0.00,0.00,0,0,0,0,0,0,0,0,0,0,0,0,0
20200520,06251P,臺股指永昌97售03,,,,,0.00,0.00,0,0,0,0,0,0,0,0,0,0,0,0,0
20200520,062520,晶豪科元大9B購02,3.15,3.15,2.88,2.88,-0.23,-7.4,264000,16,791530,0,0,0,0,0,0,252000,62000,190000,190000
20200520,062521,玉晶光元大9C購05,3.06,3.12,3.06,3.12,0.00,0.00,180000,4,555800,0,0,0,0,0,0,0,180000,-180000,-180000
20200520,062522,同欣電元大9B購02,2.51,2.72,2.48,2.53,+0.06,2.43,117000,16,301050,0,0,0,0,0,0,63000,54000,9000,9000
20200520,062523,世紀鋼元大9C購03,,,,,0.00,0.00,0,0,0,0,0,0,0,0,0,0,0,0,0
20200520,062524,鴻海統一9C購09,0.77,0.77,0.76,0.76,-0.04,-5.0,8000,2,6110,0,0,0,0,0,0,3000,5000,-2000,-2000
20200520,062525,鴻海統一9C購10,,,,,0.00,0.00,0,0,0,0,0,0,0,0,0,0,0,0,0
20200520,062526,友達統一01購01,0.77,0.79,0.77,0.77,0.00,0.00,97000,6,75750,0,0,0,0,0,0,0,97000,-97000,-97000
20200520,062527,美律統一01購01,0.65,0.65,0.63,0.63,0.00,0.00,25000,2,16050,0,0,0,0,0,0,0,25000,-25000,-25000
20200520,062528,全新統一9C購01,0.81,0.81,0.81,0.81,+0.01,1.25,12000,1,9720,0,0,0,0,0,0,12000,0,12000,12000
20200520,062529,可成統一9C購03,,,,,0.00,0.00,0,0,0,0,0,0,0,0,0,0,0,0,0
20200520,06252P,臺股指兆豐97售02,,,,,0.00,0.00,0,0,0,0,0,0,0,0,0,0,0,0,0
20200520,062530,大立光統一01購03,0.86,0.86,0.86,0.86,+0.02,2.38,10000,1,8600,0,0,0,0,0,0,10000,0,10000,10000
20200520,062531,大立光統一9C購06,,,,,0.00,0.00,0,0,0,0,0,0,0,0,0,0,0,0,0
20200520,062532,聯詠統一9C購01,0.74,0.78,0.73,0.77,-0.02,-2.53,699000,30,538980,0,0,0,0,0,0,359000,340000,19000,19000
20200520,062533,嘉澤統一9C購01,1.51,1.52,1.45,1.49,-0.03,-1.97,432000,9,645650,0,0,0,0,0,0,79000,353000,-274000,-274000
20200520,062534,力成統一01購01,,,,,0.00,0.00,0,0,0,0,0,0,0,0,0,0,0,0,0
20200520,062535,台積電麥證02購01,,,,,0.00,0.00,0,0,0,0,0,0,0,0,0,0,0,0,0
20200520,062536,玉晶光麥證9B購01,1.81,1.84,1.80,1.80,0.00,0.00,29000,11,52890,0,29000,-29000,0,0,0,0,29000,-29000,-29000
20200520,062537,聯電國泰9C購01,1.01,1.04,1.01,1.03,0.00,0.00,243000,5,246950,0,0,0,0,0,0,0,243000,-243000,-243000
20200520,062538,台積電國泰9C購02,3.66,3.66,3.66,3.66,-0.12,-3.17,2000,2,7320,0,0,0,0,0,0,2000,2000,0,0
20200520,062539,可成國泰01購01,1.09,1.09,1.01,1.01,-0.13,-11.4,72000,7,74090,0,0,0,0,0,0,20000,52000,-32000,-32000
20200520,06253P,臺股指兆豐97售03,,,,,0.00,0.00,0,0,0,0,0,0,0,0,0,0,0,0,0
20200520,062540,茂林國泰9C購01,1.31,1.65,1.31,1.62,+0.32,24.62,2480000,61,3590790,0,0,0,0,0,0,339000,2382000,-2043000,-2043000
20200520,062541,臻鼎國泰01購01,1.35,1.48,1.35,1.44,+0.10,7.46,1258000,20,1814000,0,0,0,0,0,0,44000,1214000,-1170000,-1170000
20200520,062542,南電國泰9C購01,1.97,2.05,1.83,1.87,-0.07,-3.61,608000,38,1181320,0,0,0,0,0,0,413000,195000,218000,218000
20200520,062543,華通富邦9C購01,0.38,0.41,0.38,0.39,-0.01,-2.5,90000,7,34700,0,0,0,0,0,0,30000,60000,-30000,-30000
20200520,062544,信錦永豐9B購01,,,,,0.00,0.00,0,0,0,0,0,0,0,0,0,0,0,0,0
20200520,062545,嘉晶永豐9B購01,1.19,1.42,1.19,1.42,+0.17,13.6,189000,12,236950,0,0,0,0,0,0,107000,82000,25000,25000
20200520,062546,新日興永豐9B購01,0.60,0.67,0.60,0.67,0.00,0.00,460000,7,286100,0,0,0,0,0,0,0,460000,-460000,-460000
20200520,062547,玉晶光永豐9B購05,,,,,0.00,0.00,0,0,0,0,0,0,0,0,0,0,0,0,0
20200520,062548,智易永豐9B購01,0.77,0.77,0.77,0.77,0.00,0.00,13000,1,10010,0,0,0,0,0,0,13000,0,13000,13000
20200520,062549,中租永豐9B購01,0.65,0.67,0.65,0.67,-0.01,-1.47,342000,4,222760,0,0,0,0,0,0,319000,23000,296000,296000
20200520,06254P,臺股指群益97售07,2.85,2.95,2.80,2.95,-0.10,-3.28,256000,15,728340,0,0,0,0,0,0,30000,226000,-196000,-196000
20200520,062550,啟碁永豐9B購01,0.93,0.93,0.91,0.91,-0.04,-4.21,163000,4,149500,0,0,0,0,0,0,163000,0,163000,163000
20200520,062551,緯穎永豐9B購02,0.88,0.93,0.88,0.93,+0.03,3.33,129000,13,114520,0,0,0,0,0,0,129000,0,129000,129000
20200520,062552,南電永豐9B購01,0.35,0.36,0.35,0.36,-0.02,-5.26,191000,6,67960,0,0,0,0,0,0,81000,110000,-29000,-29000
20200520,062553,台積電凱基9B購07,,,,,0.00,0.00,0,0,0,0,0,0,0,0,0,0,0,0,0
20200520,062554,台積電凱基9B購08,,,,,0.00,0.00,0,0,0,0,0,0,0,0,0,0,0,0,0
20200520,062555,旺宏凱基9B購06,,,,,0.00,0.00,0,0,0,0,0,0,0,0,0,0,0,0,0
20200520,062556,瑞昱凱基9B購02,3.20,3.28,3.12,3.12,-0.16,-4.88,363000,41,1177070,0,0,0,0,0,0,361000,13000,348000,348000
20200520,062557,台光電凱基9B購02,0.70,0.74,0.69,0.74,0.00,0.00,18000,8,12590,0,0,0,0,0,0,17000,1000,16000,16000
20200520,062558,義隆凱基9B購02,,,,,0.00,0.00,0,0,0,0,0,0,0,0,0,0,0,0,0
20200520,062559,嘉晶凱基9B購02,3.13,3.95,3.13,3.80,+0.54,16.56,552000,30,1929390,0,0,0,0,0,0,157000,548000,-391000,-391000
20200520,06255P,臺股指群益97售08,8.05,8.05,8.05,8.05,0.00,0.00,1000,1,8050,0,0,0,0,0,0,0,1000,-1000,-1000
20200520,062560,奇鋐凱基9B購02,2.16,2.29,2.16,2.26,0.00,0.00,41000,9,92360,0,0,0,0,0,0,3000,41000,-38000,-38000
20200520,062561,瀚宇博凱基9B購01,,,,,0.00,0.00,0,0,0,0,0,0,0,0,0,0,0,0,0
20200520,062562,瑞儀凱基9B購02,1.08,1.16,1.08,1.16,+0.08,7.41,471000,20,528680,0,0,0,0,0,0,168000,372000,-204000,-204000
20200520,062563,緯穎凱基9B購03,1.45,1.50,1.42,1.49,-0.01,-0.67,121000,16,176050,0,0,0,0,0,0,121000,9000,112000,112000
20200520,062564,矽創凱基9B購01,1.73,1.75,1.55,1.58,-0.12,-7.06,391000,33,659370,0,0,0,0,0,0,295000,106000,189000,189000
20200520,062565,漢唐中信9C購01,,,,,0.00,0.00,0,0,0,0,0,0,0,0,0,0,0,0,0
20200520,062566,嘉晶中信9C購01,0.89,1.14,0.88,1.05,+0.21,25.0,757000,44,741460,0,0,0,0,0,0,55000,708000,-653000,-653000
20200520,062567,祥碩中信9C購01,1.06,1.17,1.06,1.17,+0.17,17.0,413000,18,455320,0,0,0,0,0,0,207000,201000,6000,6000
20200520,062568,緯穎中信9C購01,0.67,0.71,0.62,0.62,-0.03,-4.62,195000,9,135370,0,0,0,0,0,0,141000,54000,87000,87000
20200520,062569,南電中信01購01,0.31,0.31,0.29,0.30,-0.02,-6.25,45000,4,13350,0,0,0,0,0,0,35000,10000,25000,25000
20200520,06256P,臺股指群益97售09,5.10,5.25,5.00,5.15,-0.20,-3.74,48000,6,243150,0,0,0,0,0,0,32000,16000,16000,16000
20200520,062570,T50反1群益9B購02,,,,,0.00,0.00,0,0,0,0,0,0,0,0,0,0,0,0,0
20200520,062571,臺指反群益9B購04,,,,,0.00,0.00,0,0,0,0,0,0,0,0,0,0,0,0,0
20200520,062572,元金反群益9C購01,,,,,0.00,0.00,0,0,0,0,0,0,0,0,0,0,0,0,0
20200520,062573,大毅群益9B購03,1.91,2.02,1.91,1.96,0.00,0.00,60000,5,118550,0,0,0,0,0,0,35000,45000,-10000,-10000
20200520,062574,美食群益9B購02,2.05,2.09,1.78,1.93,+0.08,4.32,247000,13,471330,0,0,0,0,0,0,180000,67000,113000,113000
20200520,062575,景碩群益9B購01,1.32,1.32,1.19,1.19,-0.11,-8.46,260000,5,315340,0,0,0,0,0,0,38000,222000,-184000,-184000
20200520,062576,華擎群益9B購02,1.41,1.61,1.41,1.60,+0.25,18.52,907000,14,1426530,0,0,0,0,0,0,10000,897000,-887000,-887000
20200520,062577,泰鼎群益9B購01,1.52,1.74,1.48,1.74,+0.14,8.75,1242000,49,2021970,0,0,0,0,0,0,388000,851000,-463000,-463000
20200520,062578,超眾群益9B購01,,,,,0.00,0.00,0,0,0,0,0,0,0,0,0,0,0,0,0
20200520,062579,華通統一01購02,0.70,0.70,0.70,0.70,-0.06,-7.89,30000,1,21000,0,0,0,0,0,0,30000,0,30000,30000
20200520,06257P,臺股指群益97售10,,,,,0.00,0.00,0,0,0,0,0,0,0,0,0,0,0,0,0
20200520,062580,華通統一9C購03,,,,,0.00,0.00,0,0,0,0,0,0,0,0,0,0,0,0,0
20200520,062581,鴻海統一01購02,,,,,0.00,0.00,0,0,0,0,0,0,0,0,0,0,0,0,0
20200520,062582,鴻海統一9C購11,,,,,0.00,0.00,0,0,0,0,0,0,0,0,0,0,0,0,0
20200520,062583,鴻海統一9C購12,,,,,0.00,0.00,0,0,0,0,0,0,0,0,0,0,0,0,0
20200520,062584,鴻海統一9C購13,0.85,0.85,0.81,0.81,-0.07,-7.95,13000,2,10930,0,0,0,0,0,0,0,13000,-13000,-13000
20200520,062585,鴻海統一9C購14,,,,,0.00,0.00,0,0,0,0,0,0,0,0,0,0,0,0,0
20200520,062586,國巨統一01購06,1.52,1.52,1.52,1.52,0.00,0.00,10000,1,15200,0,0,0,0,0,0,0,10000,-10000,-10000
20200520,062587,國巨統一9B購13,,,,,0.00,0.00,0,0,0,0,0,0,0,0,0,0,0,0,0
20200520,062588,國巨統一9B購14,,,,,0.00,0.00,0,0,0,0,0,0,0,0,0,0,0,0,0
20200520,062589,友達統一9C購03,1.24,1.24,1.19,1.19,-0.06,-4.8,189000,3,227900,0,0,0,0,0,0,189000,0,189000,189000
20200520,06258P,臺股指群益97售11,,,,,0.00,0.00,0,0,0,0,0,0,0,0,0,0,0,0,0
20200520,062590,亞光統一9B購01,0.79,0.82,0.79,0.82,+0.04,5.13,264000,5,213600,0,0,0,0,0,0,88000,176000,-88000,-88000
20200520,062591,新日興統一9C購01,0.67,0.82,0.67,0.82,+0.08,10.81,1739000,30,1310760,0,0,0,0,0,0,326000,1408000,-1082000,-1082000
20200520,062592,牧德統一01購01,0.89,1.02,0.89,1.01,+0.14,16.09,676000,23,661550,0,0,0,0,0,0,149000,532000,-383000,-383000
20200520,062593,健策統一9B購03,0.64,0.64,0.64,0.64,0.00,0.00,141000,1,90240,0,0,0,0,0,0,0,141000,-141000,-141000
20200520,062594,祥碩統一01購02,1.30,1.40,1.27,1.40,+0.15,12.0,1411000,70,1911470,0,0,0,0,0,0,132000,1276000,-1144000,-1144000
20200520,062595,祥碩統一9B購01,1.48,1.64,1.48,1.62,+0.17,11.72,72000,8,113530,0,0,0,0,0,0,32000,40000,-8000,-8000
20200520,062596,緯穎統一01購02,0.82,0.84,0.76,0.77,-0.05,-6.1,106000,13,85750,0,0,0,0,0,0,1000,105000,-104000,-104000
20200520,062597,世紀鋼統一01購01,0.69,0.70,0.69,0.70,-0.04,-5.41,126000,4,88140,0,0,0,0,0,0,6000,120000,-114000,-114000
20200520,062598,華通台新9B購02,,,,,0.00,0.00,0,0,0,0,0,0,0,0,0,0,0,0,0
20200520,062599,鴻海台新9B購01,,,,,0.00,0.00,0,0,0,0,0,0,0,0,0,0,0,0,0
20200520,06259P,臺股指群益97售12,,,,,0.00,0.00,0,0,0,0,0,0,0,0,0,0,0,0,0
20200520,062600,可成台新9B購01,0.84,0.84,0.80,0.80,-0.21,-20.79,7000,4,5760,0,0,0,0,0,0,7000,7000,0,0
20200520,062601,富邦金台新9B購01,1.02,1.07,1.02,1.07,+0.02,1.9,71000,7,75030,0,0,0,0,0,0,16000,71000,-55000,-55000
20200520,062602,華通麥證9C購01,1.12,1.13,1.12,1.12,0.00,0.00,23000,4,25860,0,23000,-23000,0,0,0,0,23000,-23000,-23000
20200520,062603,台化凱基9B購01,1.06,1.08,1.06,1.06,-0.02,-1.85,115000,7,123400,0,0,0,0,0,0,95000,20000,75000,75000
20200520,062604,東元凱基9B購01,,,,,0.00,0.00,0,0,0,0,0,0,0,0,0,0,0,0,0
20200520,062605,上銀凱基9B購03,,,,,0.00,0.00,0,0,0,0,0,0,0,0,0,0,0,0,0
20200520,062606,聯電凱基9C購02,0.80,0.81,0.79,0.79,-0.04,-4.82,461000,8,369230,0,0,0,0,0,0,85000,376000,-291000,-291000
20200520,062607,美食凱基9B購01,1.94,1.94,1.67,1.76,-0.09,-4.86,456000,33,840160,0,0,0,0,0,0,415000,41000,374000,374000
20200520,062608,智易凱基9B購01,0.93,0.95,0.92,0.92,-0.02,-2.13,269000,4,254200,0,0,0,0,0,0,64000,205000,-141000,-141000
20200520,062609,帆宣凱基9B購01,0.84,0.84,0.84,0.84,0.00,0.00,50000,1,42000,0,0,0,0,0,0,0,50000,-50000,-50000
20200520,06260P,臺股指群益97售13,,,,,0.00,0.00,0,0,0,0,0,0,0,0,0,0,0,0,0
20200520,062610,啟碁凱基9B購01,1.04,1.04,1.01,1.01,-0.04,-3.81,20000,2,20500,0,0,0,0,0,0,10000,10000,0,0
20200520,062611,台灣50元大9B購18,,,,,0.00,0.00,0,0,0,0,0,0,0,0,0,0,0,0,0
20200520,062612,台灣50元大9B購19,,,,,0.00,0.00,0,0,0,0,0,0,0,0,0,0,0,0,0
20200520,062613,臺指反元大02購10,1.57,1.57,1.57,1.57,0.00,0.00,15000,1,23550,0,0,0,0,0,0,0,15000,-15000,-15000
20200520,062614,臺指反元大02購11,,,,,0.00,0.00,0,0,0,0,0,0,0,0,0,0,0,0,0
20200520,062615,亞德客元大9B購02,2.75,2.75,2.55,2.55,-0.07,-2.67,14000,2,36500,0,0,0,0,0,0,10000,4000,6000,6000
20200520,062616,玉晶光元大9C購06,1.58,1.58,1.57,1.57,+0.06,3.97,2000,2,3150,0,0,0,0,0,0,1000,1000,0,0
20200520,062617,京鼎元大9B購01,2.11,2.16,2.11,2.14,+0.03,1.42,107000,7,229380,0,0,0,0,0,0,65000,107000,-42000,-42000
20200520,062618,祥碩元大9B購04,5.60,6.05,5.60,6.05,+0.60,11.01,76000,8,437950,0,0,0,0,0,0,0,76000,-76000,-76000
20200520,062619,台表科元大9B購03,3.34,3.88,3.16,3.88,+0.81,26.38,309000,19,1094070,0,0,0,0,0,0,94000,221000,-127000,-127000
20200520,06261P,上銀凱基97售03,0.27,0.27,0.27,0.27,0.00,0.00,15000,1,4050,0,0,0,0,0,0,15000,0,15000,15000
20200520,062620,台表科元大9B購04,2.59,3.03,2.42,3.00,+0.63,26.58,493000,32,1317330,0,0,0,0,0,0,221000,326000,-105000,-105000
20200520,062621,緯穎元大9B購05,3.13,3.30,2.93,2.93,-0.30,-9.29,488000,21,1525190,0,0,0,0,0,0,483000,24000,459000,459000
20200520,062622,南電元大9B購03,1.38,1.47,1.33,1.33,-0.09,-6.34,142000,5,205460,0,0,0,0,0,0,80000,62000,18000,18000
20200520,062623,元金2X國票01購01,4.11,4.13,4.11,4.13,+0.18,4.56,10000,2,41200,0,0,0,0,0,0,5000,5000,0,0
20200520,062624,大成鋼國票9B購02,0.83,0.83,0.83,0.83,0.00,0.00,60000,1,49800,0,0,0,0,0,0,0,60000,-60000,-60000
20200520,062625,華通國票9B購02,2.25,2.25,2.25,2.25,0.00,0.00,24000,2,54000,0,0,0,0,0,0,0,24000,-24000,-24000
20200520,062626,台積電國票9C購04,,,,,0.00,0.00,0,0,0,0,0,0,0,0,0,0,0,0,0
20200520,062627,旺宏國票9C購01,,,,,0.00,0.00,0,0,0,0,0,0,0,0,0,0,0,0,0
20200520,062628,廣達國票9B購01,3.87,3.87,3.76,3.76,-0.09,-2.34,22000,2,84480,0,0,0,0,0,0,16000,6000,10000,10000
20200520,062629,聯發科國票9C購01,,,,,0.00,0.00,0,0,0,0,0,0,0,0,0,0,0,0,0
20200520,06262P,國巨凱基97售07,1.38,1.52,1.38,1.50,-0.24,-13.79,19000,8,28040,0,0,0,0,0,0,4000,15000,-11000,-11000
20200520,062630,全新國票9B購02,,,,,0.00,0.00,0,0,0,0,0,0,0,0,0,0,0,0,0
20200520,062631,奇力新國票9B購01,1.56,1.64,1.54,1.54,0.00,0.00,259000,6,411070,0,0,0,0,0,0,0,259000,-259000,-259000
20200520,062632,嘉晶國票9B購01,6.15,7.95,6.15,7.95,+1.40,21.37,8000,4,53700,0,0,0,0,0,0,6000,4000,2000,2000
20200520,062633,亞光國票9B購01,1.54,1.56,1.54,1.54,+0.03,1.99,137000,5,212940,0,0,0,0,0,0,125000,12000,113000,113000
20200520,062634,玉晶光國票9B購03,2.35,2.53,2.35,2.53,+0.15,6.3,81000,5,202850,0,0,0,0,0,0,2000,81000,-79000,-79000
20200520,062635,創意國票9B購01,3.95,4.12,3.95,4.09,+0.07,1.74,26000,4,105510,0,0,0,0,0,0,7000,19000,-12000,-12000
20200520,062636,聯鈞國票9B購01,2.61,2.63,2.61,2.63,+0.05,1.94,23000,2,60250,0,0,0,0,0,0,12000,11000,1000,1000
20200520,062637,智易國票9B購01,,,,,0.00,0.00,0,0,0,0,0,0,0,0,0,0,0,0,0
20200520,062638,茂林國票9C購01,2.12,2.38,2.11,2.38,+0.31,14.98,493000,15,1124580,0,0,0,0,0,0,35000,458000,-423000,-423000
20200520,062639,臻鼎國票9C購01,1.81,1.81,1.81,1.81,-0.05,-2.69,51000,2,92310,0,0,0,0,0,0,51000,0,51000,51000
20200520,06263P,燿華凱基97售04,,,,,0.00,0.00,0,0,0,0,0,0,0,0,0,0,0,0,0
20200520,062640,訊連國票9C購01,1.57,1.63,1.57,1.58,-0.07,-4.24,854000,29,1373780,0,0,0,0,0,0,839000,15000,824000,824000
20200520,062641,瀚宇博國票9B購01,,,,,0.00,0.00,0,0,0,0,0,0,0,0,0,0,0,0,0
20200520,062642,帆宣國票9B購01,,,,,0.00,0.00,0,0,0,0,0,0,0,0,0,0,0,0,0
20200520,062643,緯穎國票9B購01,6.85,6.85,6.70,6.70,-0.20,-2.9,3000,3,20350,0,0,0,0,0,0,0,3000,-3000,-3000
20200520,062644,中環國泰9C購01,1.18,1.32,1.18,1.29,+0.17,15.18,382000,18,473720,0,0,0,0,0,0,108000,274000,-166000,-166000
20200520,062645,國巨國泰9B購08,3.00,3.32,3.00,3.15,+0.37,13.31,71000,5,217320,0,0,0,0,0,0,1000,71000,-70000,-70000
20200520,062646,聯發科國泰01購02,2.08,2.18,2.06,2.10,+0.08,3.96,538000,26,1121350,0,0,0,0,0,0,225000,313000,-88000,-88000
20200520,062647,南電國泰9C購02,0.80,0.85,0.75,0.77,-0.02,-2.53,565000,28,460050,0,0,0,0,0,0,144000,411000,-267000,-267000
20200520,062648,聯茂富邦9B購01,0.31,0.31,0.31,0.31,-0.02,-6.06,200000,2,62000,0,0,0,0,0,0,200000,0,200000,200000
20200520,062649,緯穎富邦9B購03,0.55,0.55,0.52,0.52,-0.01,-1.89,185000,24,100610,0,0,0,0,0,0,183000,2000,181000,181000
20200520,06264P,友達凱基98售06,,,,,0.00,0.00,0,0,0,0,0,0,0,0,0,0,0,0,0
20200520,062650,南電富邦01購01,0.30,0.30,0.29,0.29,-0.01,-3.33,56000,3,16300,0,0,0,0,0,0,0,56000,-56000,-56000
20200520,062651,世紀鋼富邦9C購01,0.50,0.50,0.46,0.46,-0.04,-8.0,113000,12,53910,0,0,0,0,0,0,10000,103000,-93000,-93000
20200520,062652,上証2X永豐9B購01,,,,,0.00,0.00,0,0,0,0,0,0,0,0,0,0,0,0,0
20200520,062653,正隆永豐9B購01,1.03,1.08,1.00,1.06,+0.02,1.92,435000,26,458440,0,0,0,0,0,0,214000,201000,13000,13000
20200520,062654,技嘉永豐9B購01,1.27,1.27,1.27,1.27,-0.03,-2.31,2000,1,2540,0,0,0,0,0,0,2000,0,2000,2000
20200520,062655,漢唐永豐9B購01,0.87,0.87,0.87,0.87,-0.03,-3.33,73000,2,63510,0,0,0,0,0,0,73000,0,73000,73000
20200520,062656,全新永豐9B購01,,,,,0.00,0.00,0,0,0,0,0,0,0,0,0,0,0,0,0
20200520,062657,華新科第一9B購01,,,,,0.00,0.00,0,0,0,0,0,0,0,0,0,0,0,0,0
20200520,062658,聯茂第一9B購01,0.32,0.32,0.32,0.32,-0.02,-5.88,2000,1,640,0,0,0,0,0,0,0,2000,-2000,-2000
20200520,062659,台灣50群益9B購10,3.31,3.31,3.31,3.31,+0.01,0.3,60000,2,198600,0,0,0,0,0,0,0,60000,-60000,-60000
20200520,06265P,美律凱基97售01,1.99,2.05,1.99,2.05,+0.01,0.49,58000,5,117610,0,0,0,0,0,0,0,58000,-58000,-58000
20200520,062660,神隆群益9B購02,,,,,0.00,0.00,0,0,0,0,0,0,0,0,0,0,0,0,0
20200520,062661,華通群益9B購05,1.68,1.69,1.61,1.61,0.00,0.00,161000,7,264510,0,0,0,0,0,0,0,161000,-161000,-161000
20200520,062662,友達群益9B購02,1.27,1.36,1.27,1.32,+0.04,3.12,187000,5,246840,0,0,0,0,0,0,99000,88000,11000,11000
20200520,062663,聯發科群益9B購07,3.56,3.56,3.56,3.56,+0.49,15.96,3000,1,10680,0,0,0,0,0,0,0,3000,-3000,-3000
20200520,062664,群創群益9B購02,1.09,1.11,1.05,1.05,-0.02,-1.87,312000,7,332910,0,0,0,0,0,0,178000,134000,44000,44000
20200520,062665,智易群益9B購01,1.85,1.85,1.85,1.85,+0.03,1.65,5000,1,9250,0,0,0,0,0,0,0,5000,-5000,-5000
20200520,062666,和碩群益9B購01,1.84,1.84,1.82,1.82,0.00,0.00,10000,2,18340,0,0,0,0,0,0,0,10000,-10000,-10000
20200520,062667,立積群益9B購01,1.04,1.04,1.04,1.04,0.00,0.00,1000,1,1040,0,0,0,0,0,0,0,1000,-1000,-1000
20200520,062668,國巨中信9B購04,0.75,0.82,0.75,0.78,0.00,0.00,205000,8,156200,0,0,0,0,0,0,0,205000,-205000,-205000
20200520,062669,微星中信03購01,1.68,1.68,1.61,1.66,+0.09,5.73,203000,8,331770,0,0,0,0,0,0,103000,100000,3000,3000
20200520,06266P,大立光凱基97售11,9.25,9.25,9.25,9.25,+0.35,3.93,10000,1,92500,0,0,0,0,0,0,0,10000,-10000,-10000
20200520,062670,瑞昱中信03購01,1.40,1.42,1.33,1.33,-0.11,-7.64,133000,4,180070,0,0,0,0,0,0,37000,96000,-59000,-59000
20200520,062671,國泰金中信03購01,1.15,1.16,1.14,1.16,+0.02,1.75,88000,6,101550,0,0,0,0,0,0,36000,52000,-16000,-16000
20200520,062672,兆豐金中信03購01,1.45,1.48,1.45,1.48,+0.07,4.96,49000,4,71850,0,0,0,0,0,0,9000,40000,-31000,-31000
20200520,062673,台新金中信03購01,,,,,0.00,0.00,0,0,0,0,0,0,0,0,0,0,0,0,0
20200520,062674,百和中信03購01,1.32,1.34,1.24,1.29,+0.01,0.78,240000,49,310910,0,0,0,0,0,0,219000,21000,198000,198000
20200520,062675,台積電台新9B購06,,,,,0.00,0.00,0,0,0,0,0,0,0,0,0,0,0,0,0
20200520,062676,南六台新9B購01,,,,,0.00,0.00,0,0,0,0,0,0,0,0,0,0,0,0,0
20200520,062677,儒鴻統一01購01,0.88,0.89,0.86,0.89,+0.02,2.3,109000,11,95950,0,0,0,0,0,0,31000,98000,-67000,-67000
20200520,062678,華通統一9C購04,,,,,0.00,0.00,0,0,0,0,0,0,0,0,0,0,0,0,0
20200520,062679,技嘉統一01購01,0.98,0.98,0.97,0.97,-0.01,-1.02,10000,2,9750,0,0,0,0,0,0,0,10000,-10000,-10000
20200520,06267P,大立光凱基97售12,,,,,0.00,0.00,0,0,0,0,0,0,0,0,0,0,0,0,0
20200520,062680,微星統一01購01,0.84,0.85,0.80,0.80,-0.02,-2.44,804000,22,669750,0,0,0,0,0,0,366000,438000,-72000,-72000
20200520,062681,全新統一01購01,0.50,0.50,0.48,0.48,-0.04,-7.69,29000,2,14300,0,0,0,0,0,0,19000,10000,9000,9000
20200520,062682,全新統一9B購01,,,,,0.00,0.00,0,0,0,0,0,0,0,0,0,0,0,0,0
20200520,062683,可成統一9B購04,0.59,0.59,0.59,0.59,0.00,0.00,25000,1,14750,0,0,0,0,0,0,0,25000,-25000,-25000
20200520,062684,華新科統一01購02,0.82,0.86,0.81,0.81,-0.02,-2.41,393000,9,323430,0,0,0,0,0,0,349000,44000,305000,305000
20200520,062685,華新科統一9C購03,0.86,0.88,0.86,0.88,+0.01,1.15,383000,6,333720,0,0,0,0,0,0,326000,57000,269000,269000
20200520,062686,群創統一9C購03,1.12,1.12,1.11,1.11,-0.03,-2.63,204000,4,226900,0,0,0,0,0,0,204000,0,204000,204000
20200520,062687,華擎統一01購02,0.73,0.81,0.73,0.81,0.00,0.00,468000,10,362250,0,0,0,0,0,0,0,468000,-468000,-468000
20200520,062688,華擎統一01購03,0.70,0.72,0.70,0.72,0.00,0.00,331000,7,234570,0,0,0,0,0,0,0,331000,-331000,-331000
20200520,062689,華擎統一02購01,0.72,0.76,0.72,0.76,0.00,0.00,513000,8,382610,0,0,0,0,0,0,0,513000,-513000,-513000
20200520,06268P,聯詠凱基97售02,2.14,2.18,2.14,2.18,-0.01,-0.46,141000,2,302300,0,0,0,0,0,0,0,141000,-141000,-141000
20200520,062690,華擎統一9B購01,0.82,0.92,0.82,0.92,+0.16,21.05,826000,20,728100,0,0,0,0,0,0,91000,735000,-644000,-644000
20200520,062691,T50反1元大9B購04,,,,,0.00,0.00,0,0,0,0,0,0,0,0,0,0,0,0,0
20200520,062692,T50反1元大9B購05,,,,,0.00,0.00,0,0,0,0,0,0,0,0,0,0,0,0,0
20200520,062693,中石化元大02購01,1.24,1.26,1.18,1.22,-0.01,-0.81,266000,14,327350,0,0,0,0,0,0,256000,36000,220000,220000
20200520,062694,遠東新元大9B購01,3.12,3.31,3.02,3.31,+0.10,3.12,136000,13,427180,0,0,0,0,0,0,92000,44000,48000,48000
20200520,062695,華通元大9C購01,1.59,1.59,1.59,1.59,-0.04,-2.45,15000,2,23850,0,0,0,0,0,0,5000,10000,-5000,-5000
20200520,062696,國巨元大9B購16,,,,,0.00,0.00,0,0,0,0,0,0,0,0,0,0,0,0,0
20200520,062697,國巨元大9C購01,1.42,1.50,1.42,1.42,+0.08,5.97,332000,9,474730,0,0,0,0,0,0,50000,282000,-232000,-232000
20200520,062698,台積電元大01購01,1.58,1.58,1.57,1.57,0.00,0.00,119000,3,187990,0,0,0,0,0,0,100000,19000,81000,81000
20200520,062699,台積電元大01購02,1.63,1.63,1.60,1.62,-0.01,-0.61,112000,4,179440,0,0,0,0,0,0,101000,11000,90000,90000
20200520,06269P,群創凱基98售10,,,,,0.00,0.00,0,0,0,0,0,0,0,0,0,0,0,0,0
20200520,062700,台光電元大9B購05,2.62,2.62,2.53,2.53,-0.29,-10.28,6000,2,15270,0,0,0,0,0,0,1000,5000,-4000,-4000
20200520,062701,漢唐元大9B購01,,,,,0.00,0.00,0,0,0,0,0,0,0,0,0,0,0,0,0
20200520,062702,可成元大9C購01,1.36,1.36,1.36,1.36,0.00,0.00,8000,1,10880,0,0,0,0,0,0,8000,8000,0,0
20200520,062703,可成元大9C購02,1.30,1.30,1.30,1.30,0.00,0.00,8000,1,10400,0,0,0,0,0,0,8000,8000,0,0
20200520,062704,大毅元大9C購01,1.90,1.90,1.90,1.90,0.00,0.00,35000,3,66500,0,0,0,0,0,0,0,35000,-35000,-35000
20200520,062705,美食元大9B購01,2.48,2.70,2.43,2.49,+0.10,4.18,322000,22,821040,0,0,0,0,0,0,195000,106000,89000,89000
20200520,062706,大立光元大9B購06,2.74,2.88,2.74,2.88,-0.02,-0.69,100000,5,283050,0,0,0,0,0,0,25000,75000,-50000,-50000
20200520,062707,致伸元大9B購01,2.39,2.39,2.39,2.39,0.00,0.00,50000,1,119500,0,0,0,0,0,0,50000,50000,0,0
20200520,062708,立積元大9B購01,1.75,1.75,1.67,1.70,-0.03,-1.73,148000,9,252090,0,0,0,0,0,0,147000,1000,146000,146000
20200520,062709,帆宣元大9B購01,1.84,1.84,1.84,1.84,-0.02,-1.08,14000,2,25760,0,0,0,0,0,0,14000,0,14000,14000
20200520,06270P,致伸凱基97售03,0.96,0.96,0.86,0.88,-0.06,-6.38,116000,5,109180,0,0,0,0,0,0,5000,111000,-106000,-106000
20200520,062710,盛群元大9B購01,2.02,2.05,2.02,2.04,+0.02,0.99,87000,5,177350,0,0,0,0,0,0,87000,12000,75000,75000
20200520,062711,台表科元大9B購05,2.29,2.63,2.13,2.51,+0.35,16.2,524000,51,1240770,0,0,0,0,0,0,212000,399000,-187000,-187000
20200520,062712,晶技麥證9B購02,1.29,1.29,1.22,1.22,-0.11,-8.27,99000,6,123530,49000,50000,-1000,0,0,0,49000,50000,-1000,-1000
20200520,062713,台灣50凱基02購03,,,,,0.00,0.00,0,0,0,0,0,0,0,0,0,0,0,0,0
20200520,062714,台灣50凱基9C購10,,,,,0.00,0.00,0,0,0,0,0,0,0,0,0,0,0,0,0
20200520,062715,T50反1凱基03購01,,,,,0.00,0.00,0,0,0,0,0,0,0,0,0,0,0,0,0
20200520,062716,鴻海凱基9B購06,,,,,0.00,0.00,0,0,0,0,0,0,0,0,0,0,0,0,0
20200520,062717,華邦電凱基9C購01,1.94,1.94,1.94,1.94,0.00,0.00,5000,1,9700,0,0,0,0,0,0,0,5000,-5000,-5000
20200520,062718,技嘉凱基9B購01,2.01,2.01,2.01,2.01,-0.05,-2.43,5000,1,10050,0,0,0,0,0,0,0,5000,-5000,-5000
20200520,062719,微星凱基9B購01,1.40,1.45,1.38,1.38,-0.03,-2.13,19000,3,26450,0,0,0,0,0,0,8000,11000,-3000,-3000
20200520,06271P,彩晶凱基97售01,2.02,2.03,2.02,2.03,0.00,0.00,20000,2,40500,0,0,0,0,0,0,0,20000,-20000,-20000
20200520,062720,南亞科凱基9B購03,1.31,1.38,1.31,1.31,+0.03,2.34,310000,7,411500,0,0,0,0,0,0,270000,40000,230000,230000
20200520,062721,美律凱基9B購02,,,,,0.00,0.00,0,0,0,0,0,0,0,0,0,0,0,0,0
20200520,062722,京元電凱基9B購02,0.69,0.69,0.63,0.63,-0.12,-16.0,380000,33,246720,0,0,0,0,0,0,143000,235000,-92000,-92000
20200520,062723,聯發科凱基9B購09,2.41,2.41,2.41,2.41,+0.03,1.26,11000,1,26510,0,0,0,0,0,0,11000,11000,0,0
20200520,062724,可成凱基9B購04,1.41,1.43,1.41,1.43,0.00,0.00,6000,2,8560,0,0,0,0,0,0,1000,6000,-5000,-5000
20200520,062725,大立光凱基9B購06,,,,,0.00,0.00,0,0,0,0,0,0,0,0,0,0,0,0,0
20200520,062726,華擎凱基9B購02,1.51,1.69,1.51,1.69,0.00,0.00,390000,20,623700,0,0,0,0,0,0,0,390000,-390000,-390000
20200520,062727,華擎凱基9B購03,2.13,2.36,2.13,2.36,0.00,0.00,234000,16,533340,0,0,0,0,0,0,0,234000,-234000,-234000
20200520,062728,健策凱基9B購04,1.35,1.41,1.35,1.40,-0.07,-4.76,122000,7,169250,0,0,0,0,0,0,1000,122000,-121000,-121000
20200520,062729,神達凱基9B購02,2.07,2.22,2.07,2.22,0.00,0.00,58000,7,125560,0,0,0,0,0,0,0,58000,-58000,-58000
20200520,06272P,台郡凱基97售04,1.26,1.28,1.26,1.28,0.00,0.00,100000,2,127000,0,0,0,0,0,0,0,100000,-100000,-100000
20200520,062730,致伸凱基9B購01,0.84,0.84,0.84,0.84,0.00,0.00,50000,1,42000,0,0,0,0,0,0,50000,50000,0,0
20200520,062731,力成凱基9B購02,,,,,0.00,0.00,0,0,0,0,0,0,0,0,0,0,0,0,0
20200520,062732,南六凱基9B購03,,,,,0.00,0.00,0,0,0,0,0,0,0,0,0,0,0,0,0
20200520,062733,巨大凱基9B購01,1.88,2.02,1.88,1.94,+0.33,20.5,307000,24,602590,0,0,0,0,0,0,42000,275000,-233000,-233000
20200520,062734,臺指反國票9C購03,1.43,1.43,1.43,1.43,0.00,0.00,10000,1,14300,0,0,0,0,0,0,10000,0,10000,10000
20200520,062735,和大國票9B購01,4.08,4.58,4.08,4.58,0.00,0.00,44000,10,192370,0,0,0,0,0,0,0,44000,-44000,-44000
20200520,062736,漢唐國票9B購01,3.15,3.15,3.15,3.15,0.00,0.00,5000,1,15750,0,0,0,0,0,0,0,5000,-5000,-5000
20200520,062737,聯發科國票9B購03,,,,,0.00,0.00,0,0,0,0,0,0,0,0,0,0,0,0,0
20200520,062738,可成國票9B購02,1.29,1.29,1.26,1.26,-0.37,-22.7,7000,2,8880,0,0,0,0,0,0,7000,7000,0,0
20200520,062739,嘉晶國票9B購02,4.85,5.95,4.83,5.95,+1.36,29.63,26000,5,138250,0,0,0,0,0,0,6000,21000,-15000,-15000
20200520,06273P,台表科凱基97售04,,,,,0.00,0.00,0,0,0,0,0,0,0,0,0,0,0,0,0
20200520,062740,致伸國票9B購01,2.26,2.39,2.26,2.39,0.00,0.00,87000,2,197140,0,0,0,0,0,0,83000,87000,-4000,-4000
20200520,062741,立積國票9B購02,,,,,0.00,0.00,0,0,0,0,0,0,0,0,0,0,0,0,0
20200520,062742,技嘉國泰01購01,2.01,2.01,1.96,1.96,-0.04,-2.0,48000,5,95600,0,0,0,0,0,0,16000,48000,-32000,-32000
20200520,062743,微星國泰01購01,1.86,1.86,1.79,1.79,+0.07,4.07,98000,5,181470,0,0,0,0,0,0,98000,0,98000,98000
20200520,062744,超眾國泰9C購01,2.43,2.49,2.43,2.49,+0.06,2.47,69000,4,170510,0,0,0,0,0,0,21000,48000,-27000,-27000
20200520,062745,聯詠永豐9B購01,0.66,0.66,0.65,0.66,-0.07,-9.59,188000,5,123760,0,0,0,0,0,0,188000,0,188000,188000
20200520,062746,致伸永豐9B購01,0.73,0.75,0.71,0.75,0.00,0.00,173000,4,125270,0,0,0,0,0,0,77000,173000,-96000,-96000
20200520,062747,立積永豐9B購01,,,,,0.00,0.00,0,0,0,0,0,0,0,0,0,0,0,0,0
20200520,062748,祥碩永豐9B購02,1.57,1.76,1.53,1.76,+0.25,16.56,644000,19,1084570,0,0,0,0,0,0,86000,558000,-472000,-472000
20200520,062749,元金2X中信9B購01,,,,,0.00,0.00,0,0,0,0,0,0,0,0,0,0,0,0,0
20200520,06274P,臺股指凱基97售06,,,,,0.00,0.00,0,0,0,0,0,0,0,0,0,0,0,0,0
20200520,062750,可成中信9B購01,,,,,0.00,0.00,0,0,0,0,0,0,0,0,0,0,0,0,0
20200520,062751,華擎中信9C購01,0.58,0.60,0.58,0.60,0.00,0.00,159000,3,93000,0,0,0,0,0,0,0,159000,-159000,-159000
20200520,062752,世芯中信9B購01,1.22,1.22,1.09,1.09,-0.13,-10.66,67000,7,80210,0,0,0,0,0,0,54000,13000,41000,41000
20200520,062753,台積電麥證9B購01,,,,,0.00,0.00,0,0,0,0,0,0,0,0,0,0,0,0,0
20200520,062754,台勝科麥證9B購01,1.05,1.05,1.05,1.05,-0.07,-6.25,48000,1,50400,0,48000,-48000,0,0,0,0,48000,-48000,-48000
20200520,062755,茂林麥證9B購01,1.21,1.30,1.21,1.30,0.00,0.00,123000,2,152250,0,123000,-123000,0,0,0,0,123000,-123000,-123000
20200520,062756,臺指反凱基9C購01,,,,,0.00,0.00,0,0,0,0,0,0,0,0,0,0,0,0,0
20200520,062757,華通凱基9B購02,,,,,0.00,0.00,0,0,0,0,0,0,0,0,0,0,0,0,0
20200520,062758,國巨凱基9B購09,2.27,2.27,2.26,2.26,0.00,0.00,49000,2,111180,0,0,0,0,0,0,0,49000,-49000,-49000
20200520,062759,旺宏凱基9B購07,,,,,0.00,0.00,0,0,0,0,0,0,0,0,0,0,0,0,0
20200520,06275P,臺股指凱基97售07,,,,,0.00,0.00,0,0,0,0,0,0,0,0,0,0,0,0,0
20200520,062760,漢唐凱基9B購01,1.53,1.53,1.53,1.53,0.00,0.00,200000,3,306000,0,0,0,0,0,0,0,200000,-200000,-200000
20200520,062761,嘉晶凱基9C購01,1.63,1.93,1.63,1.88,0.00,0.00,586000,26,1024230,0,0,0,0,0,0,0,586000,-586000,-586000
20200520,062762,聯詠凱基9B購02,,,,,0.00,0.00,0,0,0,0,0,0,0,0,0,0,0,0,0
20200520,062763,華擎凱基9C購02,1.88,2.09,1.88,2.09,0.00,0.00,166000,9,327260,0,0,0,0,0,0,0,166000,-166000,-166000
20200520,062764,世芯凱基9B購02,4.03,4.17,3.88,3.88,-0.26,-6.28,41000,6,167740,0,0,0,0,0,0,31000,10000,21000,21000
20200520,062765,祥碩凱基9B購04,2.30,2.30,2.30,2.30,0.00,0.00,10000,1,23000,0,0,0,0,0,0,0,10000,-10000,-10000
20200520,062766,台郡凱基9B購02,0.93,0.93,0.90,0.90,0.00,0.00,150000,3,136500,0,0,0,0,0,0,50000,100000,-50000,-50000
20200520,062767,GIS凱基9B購02,1.73,1.74,1.73,1.74,0.00,0.00,130000,4,225190,0,0,0,0,0,0,0,130000,-130000,-130000
20200520,062768,南電凱基9B購04,1.48,1.48,1.48,1.48,+0.06,4.23,10000,1,14800,0,0,0,0,0,0,10000,0,10000,10000
20200520,062769,臺股指凱基9B購13,,,,,0.00,0.00,0,0,0,0,0,0,0,0,0,0,0,0,0
20200520,06276P,臺股指凱基97售08,,,,,0.00,0.00,0,0,0,0,0,0,0,0,0,0,0,0,0
20200520,062770,臺股指凱基9B購14,,,,,0.00,0.00,0,0,0,0,0,0,0,0,0,0,0,0,0
20200520,062771,臺股指凱基9B購15,,,,,0.00,0.00,0,0,0,0,0,0,0,0,0,0,0,0,0
20200520,062772,T50反1元大9B購06,,,,,0.00,0.00,0,0,0,0,0,0,0,0,0,0,0,0,0
20200520,062773,臺指反元大02購12,,,,,0.00,0.00,0,0,0,0,0,0,0,0,0,0,0,0,0
20200520,062774,儒鴻元大9C購01,2.70,2.74,2.70,2.74,+0.07,2.62,21000,2,57140,0,0,0,0,0,0,21000,21000,0,0
20200520,062775,大成鋼元大9B購02,1.84,2.02,1.84,2.02,+0.30,17.44,208000,17,391970,0,0,0,0,0,0,29000,208000,-179000,-179000
20200520,062776,鴻海元大9B購03,,,,,0.00,0.00,0,0,0,0,0,0,0,0,0,0,0,0,0
20200520,062777,鴻海元大9C購03,1.70,1.70,1.70,1.70,0.00,0.00,10000,1,17000,0,0,0,0,0,0,0,10000,-10000,-10000
20200520,062778,國巨元大9B購17,2.88,2.90,2.88,2.90,+0.23,8.61,31000,2,89400,0,0,0,0,0,0,0,31000,-31000,-31000
20200520,062779,台積電元大9B購03,1.68,1.68,1.68,1.68,+0.01,0.6,1000,1,1680,0,0,0,0,0,0,1000,1000,0,0
20200520,06277P,臺股指凱基97售09,8.00,8.05,7.95,7.95,-0.30,-3.64,18000,8,143800,0,0,0,0,0,0,0,18000,-18000,-18000
20200520,062780,旺宏元大01購01,,,,,0.00,0.00,0,0,0,0,0,0,0,0,0,0,0,0,0
20200520,062781,微星元大9C購01,2.42,2.42,2.42,2.42,+0.25,11.52,15000,1,36300,0,0,0,0,0,0,0,15000,-15000,-15000
20200520,062782,聯發科元大9B購12,2.72,2.79,2.71,2.75,+0.11,4.17,72000,8,197650,0,0,0,0,0,0,41000,72000,-31000,-31000
20200520,062783,大立光元大9C購03,,,,,0.00,0.00,0,0,0,0,0,0,0,0,0,0,0,0,0
20200520,062784,世芯元大9B購01,3.56,3.56,3.35,3.35,-0.18,-5.1,98000,6,347750,0,0,0,0,0,0,92000,6000,86000,86000
20200520,062785,世芯元大9C購01,1.75,1.77,1.59,1.59,-0.15,-8.62,534000,42,906960,0,0,0,0,0,0,426000,98000,328000,328000
20200520,062786,立積元大9C購03,1.40,1.40,1.30,1.30,0.00,0.00,25000,4,34000,0,0,0,0,0,0,5000,25000,-20000,-20000
20200520,062787,超眾元大9C購02,2.06,2.06,2.06,2.06,0.00,0.00,50000,1,103000,0,0,0,0,0,0,0,50000,-50000,-50000
20200520,062788,臺股指元大9B購31,,,,,0.00,0.00,0,0,0,0,0,0,0,0,0,0,0,0,0
20200520,062789,臺股指元大9B購32,,,,,0.00,0.00,0,0,0,0,0,0,0,0,0,0,0,0,0
20200520,06278P,臺股指凱基97售10,,,,,0.00,0.00,0,0,0,0,0,0,0,0,0,0,0,0,0
20200520,062790,臺股指元大9B購33,,,,,0.00,0.00,0,0,0,0,0,0,0,0,0,0,0,0,0
20200520,062791,臺股指元大9B購34,,,,,0.00,0.00,0,0,0,0,0,0,0,0,0,0,0,0,0
20200520,062792,臺股指元大9B購35,,,,,0.00,0.00,0,0,0,0,0,0,0,0,0,0,0,0,0
20200520,062793,鴻海統一9B購06,,,,,0.00,0.00,0,0,0,0,0,0,0,0,0,0,0,0,0
20200520,062794,鴻海統一9C購15,,,,,0.00,0.00,0,0,0,0,0,0,0,0,0,0,0,0,0
20200520,062795,國巨統一9B購15,1.37,1.37,1.37,1.37,0.00,0.00,1000,1,1370,0,0,0,0,0,0,0,1000,-1000,-1000
20200520,062796,技嘉統一9C購01,1.04,1.04,0.99,0.99,-0.01,-1.0,36000,3,36140,0,0,0,0,0,0,36000,15000,21000,21000
20200520,062797,瑞昱統一9B購01,1.25,1.27,1.16,1.20,-0.03,-2.44,213000,6,267240,0,0,0,0,0,0,114000,99000,15000,15000
20200520,062798,台光電統一9B購01,1.01,1.03,1.01,1.03,0.00,0.00,121000,2,124150,0,0,0,0,0,0,0,121000,-121000,-121000
20200520,062799,聯發科統一9C購09,1.24,1.27,1.24,1.27,0.00,0.00,207000,2,256890,0,0,0,0,0,0,0,207000,-207000,-207000
20200520,06279P,臺股指凱基97售11,,,,,0.00,0.00,0,0,0,0,0,0,0,0,0,0,0,0,0
20200520,062800,奇力新統一01購02,0.66,0.67,0.65,0.65,0.00,0.00,71000,4,46660,0,0,0,0,0,0,0,71000,-71000,-71000
20200520,062801,宏達電統一01購01,0.85,0.86,0.82,0.82,0.00,0.00,336000,6,286970,0,0,0,0,0,0,0,336000,-336000,-336000
20200520,062802,宏達電統一9B購01,1.11,1.13,1.08,1.08,+0.06,5.88,377000,6,417020,0,0,0,0,0,0,130000,247000,-117000,-117000
20200520,062803,嘉晶統一9B購02,1.01,1.29,1.01,1.21,+0.22,22.22,1048000,35,1198520,0,0,0,0,0,0,6000,1048000,-1042000,-1042000
20200520,062804,玉晶光統一9C購04,,,,,0.00,0.00,0,0,0,0,0,0,0,0,0,0,0,0,0
20200520,062805,台勝科統一9C購01,0.85,0.89,0.85,0.89,0.00,0.00,369000,5,322410,0,0,0,0,0,0,0,369000,-369000,-369000
20200520,062806,世芯統一02購01,1.12,1.13,1.04,1.04,-0.09,-7.96,232000,20,255730,0,0,0,0,0,0,151000,78000,73000,73000
20200520,062807,和碩統一9B購01,,,,,0.00,0.00,0,0,0,0,0,0,0,0,0,0,0,0,0
20200520,062808,祥碩統一9C購01,1.13,1.24,1.13,1.17,+0.08,7.34,781000,21,922650,0,0,0,0,0,0,0,781000,-781000,-781000
20200520,062809,同欣電統一9C購01,0.87,0.90,0.83,0.84,0.00,0.00,630000,15,546590,0,0,0,0,0,0,0,630000,-630000,-630000
20200520,06280P,臺股指凱基97售12,,,,,0.00,0.00,0,0,0,0,0,0,0,0,0,0,0,0,0
20200520,062810,華通兆豐9B購02,0.60,0.60,0.58,0.58,0.00,0.00,89000,2,53320,0,0,0,0,0,0,0,89000,-89000,-89000
20200520,062811,鴻海兆豐9B購01,0.99,0.99,0.99,0.99,0.00,0.00,15000,1,14850,0,0,0,0,0,0,0,15000,-15000,-15000
20200520,062812,國巨兆豐9B購03,1.24,1.24,1.21,1.21,0.00,0.00,10000,2,12250,0,0,0,0,0,0,0,10000,-10000,-10000
20200520,062813,台積電兆豐9B購01,1.21,1.21,1.19,1.19,0.00,0.00,55000,2,66450,0,0,0,0,0,0,0,55000,-55000,-55000
20200520,062814,台光電兆豐9B購01,1.05,1.05,1.05,1.05,0.00,0.00,85000,1,89250,0,0,0,0,0,0,0,85000,-85000,-85000
20200520,062815,聯發科兆豐9B購03,2.45,2.47,2.45,2.47,0.00,0.00,89000,3,218210,0,0,0,0,0,0,0,89000,-89000,-89000
20200520,062816,華新科兆豐9B購01,0.96,0.96,0.94,0.94,0.00,0.00,101000,2,95260,0,0,0,0,0,0,0,101000,-101000,-101000
20200520,062817,富邦金兆豐9B購01,1.30,1.35,1.30,1.35,+0.02,1.5,51000,4,68690,0,0,0,0,0,0,3000,51000,-48000,-48000
20200520,062818,大立光兆豐9C購01,,,,,0.00,0.00,0,0,0,0,0,0,0,0,0,0,0,0,0
20200520,062819,奇鋐兆豐9B購01,1.13,1.14,1.13,1.14,0.00,0.00,77000,2,87670,0,0,0,0,0,0,0,77000,-77000,-77000
20200520,06281P,臺股指凱基97售13,,,,,0.00,0.00,0,0,0,0,0,0,0,0,0,0,0,0,0
20200520,062820,禾伸堂兆豐9B購01,1.26,1.32,1.26,1.30,0.00,0.00,199000,7,256820,0,0,0,0,0,0,0,199000,-199000,-199000
20200520,062821,華擎兆豐9C購01,0.97,1.09,0.97,1.07,0.00,0.00,193000,10,198220,0,0,0,0,0,0,0,193000,-193000,-193000
20200520,062822,力成兆豐9B購01,,,,,0.00,0.00,0,0,0,0,0,0,0,0,0,0,0,0,0
20200520,062823,台表科兆豐9B購01,2.17,2.48,2.13,2.48,+0.45,22.17,178000,11,402680,0,0,0,0,0,0,4000,174000,-170000,-170000
20200520,062824,國巨群益9C購03,2.08,2.08,1.97,1.97,+0.09,4.79,41000,9,82280,0,0,0,0,0,0,2000,36000,-34000,-34000
20200520,062825,聯發科群益9B購08,3.28,3.28,3.28,3.28,+0.10,3.14,6000,1,19680,0,0,0,0,0,0,6000,0,6000,6000
20200520,062826,奇力新群益9C購01,1.24,1.24,1.22,1.22,0.00,0.00,51000,2,62420,0,0,0,0,0,0,0,51000,-51000,-51000
20200520,062827,神基群益9B購01,,,,,0.00,0.00,0,0,0,0,0,0,0,0,0,0,0,0,0
20200520,062828,聯詠群益9B購02,,,,,0.00,0.00,0,0,0,0,0,0,0,0,0,0,0,0,0
20200520,062829,泰碩群益9B購01,,,,,0.00,0.00,0,0,0,0,0,0,0,0,0,0,0,0,0
20200520,06282P,聯鈞永豐97售02,1.75,1.75,1.75,1.75,-0.02,-1.13,1000,1,1750,0,0,0,0,0,0,0,1000,-1000,-1000
20200520,062830,玉晶光群益01購05,2.44,2.57,2.44,2.57,+0.15,6.2,44000,3,107840,0,0,0,0,0,0,1000,43000,-42000,-42000
20200520,062831,嘉澤群益9B購01,,,,,0.00,0.00,0,0,0,0,0,0,0,0,0,0,0,0,0
20200520,062832,嘉澤群益9B購02,,,,,0.00,0.00,0,0,0,0,0,0,0,0,0,0,0,0,0
20200520,062833,世芯群益9B購01,2.18,2.27,2.03,2.03,-0.22,-9.78,329000,8,731810,0,0,0,0,0,0,326000,3000,323000,323000
20200520,062834,立積群益9B購02,,,,,0.00,0.00,0,0,0,0,0,0,0,0,0,0,0,0,0
20200520,062835,瑞儀群益9B購01,1.68,1.81,1.68,1.79,+0.05,2.87,394000,25,693790,0,0,0,0,0,0,37000,394000,-357000,-357000
20200520,062836,同欣電群益9B購02,2.21,2.44,2.21,2.25,+0.03,1.35,29000,4,69530,0,0,0,0,0,0,5000,25000,-20000,-20000
20200520,062837,復盛群益9B購01,2.01,2.58,2.01,2.56,0.00,0.00,260000,21,571450,0,0,0,0,0,0,66000,260000,-194000,-194000
20200520,062838,臺股指群益9B購05,,,,,0.00,0.00,0,0,0,0,0,0,0,0,0,0,0,0,0
20200520,062839,臺股指群益9B購06,,,,,0.00,0.00,0,0,0,0,0,0,0,0,0,0,0,0,0
20200520,06283P,祥碩永豐97售01,0.09,0.12,0.09,0.12,0.00,0.00,9000,3,840,0,0,0,0,0,0,0,0,0,0
20200520,062840,臺股指群益9B購07,,,,,0.00,0.00,0,0,0,0,0,0,0,0,0,0,0,0,0
20200520,062841,臺股指群益9B購08,,,,,0.00,0.00,0,0,0,0,0,0,0,0,0,0,0,0,0
20200520,062842,臺股指群益9B購09,,,,,0.00,0.00,0,0,0,0,0,0,0,0,0,0,0,0,0
20200520,062843,臺股指群益9B購10,,,,,0.00,0.00,0,0,0,0,0,0,0,0,0,0,0,0,0
20200520,062844,T50反1國泰9C購01,0.73,0.73,0.73,0.73,-0.03,-3.95,22000,2,16060,0,0,0,0,0,0,20000,2000,18000,18000
20200520,062845,微星富邦01購01,,,,,0.00,0.00,0,0,0,0,0,0,0,0,0,0,0,0,0
20200520,062846,國泰金富邦9C購01,1.06,1.09,1.06,1.06,0.00,0.00,174000,6,187170,0,0,0,0,0,0,9000,165000,-156000,-156000
20200520,062847,臺股指富邦9B購01,,,,,0.00,0.00,0,0,0,0,0,0,0,0,0,0,0,0,0
20200520,062848,臺股指富邦9B購02,,,,,0.00,0.00,0,0,0,0,0,0,0,0,0,0,0,0,0
20200520,062849,中興電永豐9B購02,0.94,0.94,0.94,0.94,0.00,0.00,11000,1,10340,0,0,0,0,0,0,0,11000,-11000,-11000
20200520,06284P,台積電國票98售03,7.85,7.90,7.85,7.90,0.00,0.00,4000,2,31450,0,0,0,0,0,0,1000,3000,-2000,-2000
20200520,062850,友訊永豐9B購01,0.74,0.74,0.74,0.74,0.00,0.00,153000,2,113220,0,0,0,0,0,0,0,153000,-153000,-153000
20200520,062851,建準永豐9B購02,1.14,1.14,1.09,1.10,-0.08,-6.78,100000,4,110300,0,0,0,0,0,0,10000,90000,-80000,-80000
20200520,062852,聯發科永豐9B購02,2.12,2.20,2.12,2.13,+0.09,4.41,71000,5,154710,0,0,0,0,0,0,1000,70000,-69000,-69000
20200520,062853,大毅永豐9B購03,1.05,1.05,1.05,1.05,0.00,0.00,10000,1,10500,0,0,0,0,0,0,0,10000,-10000,-10000
20200520,062854,日電貿永豐9B購01,0.98,0.98,0.98,0.98,0.00,0.00,10000,1,9800,0,0,0,0,0,0,0,10000,-10000,-10000
20200520,062855,嘉澤永豐9B購02,1.07,1.07,1.07,1.07,0.00,0.00,5000,1,5350,0,0,0,0,0,0,0,5000,-5000,-5000
20200520,062856,世芯永豐9B購02,1.43,1.43,1.35,1.40,-0.07,-4.76,290000,12,402800,0,0,0,0,0,0,0,280000,-280000,-280000
20200520,062857,SP黃豆國票9C購01,,,,,0.00,0.00,0,0,0,0,0,0,0,0,0,0,0,0,0
20200520,062858,微星國票9B購01,1.53,1.53,1.50,1.50,+0.03,2.04,31000,4,47180,0,0,0,0,0,0,5000,26000,-21000,-21000
20200520,062859,玉晶光國票01購02,1.96,2.11,1.96,2.11,+0.15,7.65,95000,7,194230,0,0,0,0,0,0,71000,91000,-20000,-20000
20200520,06285P,台積電國票98售04,,,,,0.00,0.00,0,0,0,0,0,0,0,0,0,0,0,0,0
20200520,062860,華擎國票9B購02,2.19,2.57,2.19,2.57,0.00,0.00,210000,12,508550,0,0,0,0,0,0,0,210000,-210000,-210000
20200520,062861,世芯國票9C購01,4.93,4.93,4.93,4.93,0.00,0.00,5000,1,24650,0,0,0,0,0,0,0,5000,-5000,-5000
20200520,062862,瑞儀國票9B購01,,,,,0.00,0.00,0,0,0,0,0,0,0,0,0,0,0,0,0
20200520,062863,聯茂國票9B購01,1.26,1.26,1.26,1.26,0.00,0.00,19000,1,23940,0,0,0,0,0,0,0,19000,-19000,-19000
20200520,062864,臺股指國票9B購21,2.84,2.84,2.74,2.78,0.00,0.00,18000,7,50290,0,0,0,0,0,0,0,18000,-18000,-18000
20200520,062865,臺股指國票9B購22,,,,,0.00,0.00,0,0,0,0,0,0,0,0,0,0,0,0,0
20200520,062866,臺股指國票9B購23,,,,,0.00,0.00,0,0,0,0,0,0,0,0,0,0,0,0,0
20200520,062867,東元中信9B購01,,,,,0.00,0.00,0,0,0,0,0,0,0,0,0,0,0,0,0
20200520,062868,葡萄王中信9B購01,,,,,0.00,0.00,0,0,0,0,0,0,0,0,0,0,0,0,0
20200520,062869,帆宣中信9B購01,,,,,0.00,0.00,0,0,0,0,0,0,0,0,0,0,0,0,0
20200520,06286P,世芯國票97售02,0.26,0.32,0.25,0.32,+0.06,23.08,805000,19,229140,0,0,0,0,0,0,135000,670000,-535000,-535000
20200520,062870,亞德客兆豐9C購01,,,,,0.00,0.00,0,0,0,0,0,0,0,0,0,0,0,0,0
20200520,062871,大成鋼兆豐9B購01,0.96,1.04,0.96,1.04,+0.19,22.35,28000,2,28320,0,0,0,0,0,0,0,28000,-28000,-28000
20200520,062872,華通兆豐9C購01,,,,,0.00,0.00,0,0,0,0,0,0,0,0,0,0,0,0,0
20200520,062873,國巨兆豐9C購01,,,,,0.00,0.00,0,0,0,0,0,0,0,0,0,0,0,0,0
20200520,062874,微星兆豐9B購01,,,,,0.00,0.00,0,0,0,0,0,0,0,0,0,0,0,0,0
20200520,062875,瑞昱兆豐9C購01,1.41,1.41,1.40,1.40,+0.11,8.53,50000,2,70300,0,0,0,0,0,0,0,50000,-50000,-50000
20200520,062876,全新兆豐9B購01,,,,,0.00,0.00,0,0,0,0,0,0,0,0,0,0,0,0,0
20200520,062877,可成兆豐9C購01,,,,,0.00,0.00,0,0,0,0,0,0,0,0,0,0,0,0,0
20200520,062878,宏達電兆豐9B購01,,,,,0.00,0.00,0,0,0,0,0,0,0,0,0,0,0,0,0
20200520,062879,美食兆豐9B購01,,,,,0.00,0.00,0,0,0,0,0,0,0,0,0,0,0,0,0
20200520,06287P,臺股指國票97售01,,,,,0.00,0.00,0,0,0,0,0,0,0,0,0,0,0,0,0
20200520,062880,大立光兆豐9B購02,,,,,0.00,0.00,0,0,0,0,0,0,0,0,0,0,0,0,0
20200520,062881,緯創兆豐9C購01,,,,,0.00,0.00,0,0,0,0,0,0,0,0,0,0,0,0,0
20200520,062882,新日興兆豐9C購01,,,,,0.00,0.00,0,0,0,0,0,0,0,0,0,0,0,0,0
20200520,062883,智易兆豐9C購01,,,,,0.00,0.00,0,0,0,0,0,0,0,0,0,0,0,0,0
20200520,062884,康控兆豐9C購01,,,,,0.00,0.00,0,0,0,0,0,0,0,0,0,0,0,0,0
20200520,062885,臻鼎兆豐9C購01,,,,,0.00,0.00,0,0,0,0,0,0,0,0,0,0,0,0,0
20200520,062886,中興電群益9B購01,1.44,1.44,1.42,1.42,-0.04,-2.74,10000,2,14300,0,0,0,0,0,0,0,10000,-10000,-10000
20200520,062887,台積電群益9C購05,,,,,0.00,0.00,0,0,0,0,0,0,0,0,0,0,0,0,0
20200520,062888,漢唐群益9B購01,1.21,1.21,1.21,1.21,-0.20,-14.18,200000,2,242000,0,0,0,0,0,0,0,200000,-200000,-200000
20200520,062889,可成群益9C購01,,,,,0.00,0.00,0,0,0,0,0,0,0,0,0,0,0,0,0
20200520,06288P,臺股指國票97售02,,,,,0.00,0.00,0,0,0,0,0,0,0,0,0,0,0,0,0
20200520,062890,祥碩群益9B購04,1.67,1.67,1.67,1.67,+0.30,21.9,5000,1,8350,0,0,0,0,0,0,0,5000,-5000,-5000
20200520,062891,台汽電群益9B購01,,,,,0.00,0.00,0,0,0,0,0,0,0,0,0,0,0,0,0
20200520,062892,臺指反元大02購13,,,,,0.00,0.00,0,0,0,0,0,0,0,0,0,0,0,0,0
20200520,062893,元金2X元大9C購01,1.13,1.13,1.13,1.13,0.00,0.00,5000,1,5650,0,0,0,0,0,0,0,5000,-5000,-5000
20200520,062894,道瓊銀元大9B購02,1.57,1.58,1.57,1.57,+0.38,31.93,77000,5,120940,0,0,0,0,0,0,0,77000,-77000,-77000
20200520,062895,道瓊銀元大9C購01,,,,,0.00,0.00,0,0,0,0,0,0,0,0,0,0,0,0,0
20200520,062896,中興電元大9B購01,2.01,2.07,1.97,1.97,-0.04,-1.99,120000,3,246800,0,0,0,0,0,0,0,120000,-120000,-120000
20200520,062897,上銀元大9B購06,,,,,0.00,0.00,0,0,0,0,0,0,0,0,0,0,0,0,0
20200520,062898,華通元大9B購05,,,,,0.00,0.00,0,0,0,0,0,0,0,0,0,0,0,0,0
20200520,062899,鴻海元大9C購04,,,,,0.00,0.00,0,0,0,0,0,0,0,0,0,0,0,0,0
20200520,06289P,臺股指國票97售03,,,,,0.00,0.00,0,0,0,0,0,0,0,0,0,0,0,0,0
20200520,062900,台積電元大9B購04,,,,,0.00,0.00,0,0,0,0,0,0,0,0,0,0,0,0,0
20200520,062901,台積電元大9B購05,,,,,0.00,0.00,0,0,0,0,0,0,0,0,0,0,0,0,0
20200520,062902,智邦元大9B購07,,,,,0.00,0.00,0,0,0,0,0,0,0,0,0,0,0,0,0
20200520,062903,燿華元大9B購04,1.88,2.05,1.88,2.05,+0.23,12.64,58000,5,114630,0,0,0,0,0,0,25000,58000,-33000,-33000
20200520,062904,台光電元大9B購06,,,,,0.00,0.00,0,0,0,0,0,0,0,0,0,0,0,0,0
20200520,062905,聯發科元大9B購13,4.70,4.70,4.61,4.61,+1.18,34.4,14000,2,65440,0,0,0,0,0,0,14000,14000,0,0
20200520,062906,全新元大9B購03,,,,,0.00,0.00,0,0,0,0,0,0,0,0,0,0,0,0,0
20200520,062907,可成元大9C購03,1.85,1.85,1.85,1.85,-0.35,-15.91,15000,1,27750,0,0,0,0,0,0,0,15000,-15000,-15000
20200520,062908,晶豪科元大9B購03,1.61,1.61,1.60,1.60,-0.13,-7.51,12000,2,19260,0,0,0,0,0,0,0,12000,-12000,-12000
20200520,062909,大立光元大9C購04,,,,,0.00,0.00,0,0,0,0,0,0,0,0,0,0,0,0,0
20200520,06290P,臺股指國票97售04,,,,,0.00,0.00,0,0,0,0,0,0,0,0,0,0,0,0,0
20200520,062910,亞光元大9B購01,,,,,0.00,0.00,0,0,0,0,0,0,0,0,0,0,0,0,0
20200520,062911,聯詠元大9B購03,,,,,0.00,0.00,0,0,0,0,0,0,0,0,0,0,0,0,0
20200520,062912,新日興元大9B購01,,,,,0.00,0.00,0,0,0,0,0,0,0,0,0,0,0,0,0
20200520,062913,創意元大9B購02,,,,,0.00,0.00,0,0,0,0,0,0,0,0,0,0,0,0,0
20200520,062914,嘉澤元大9B購02,2.90,2.90,2.84,2.84,+0.15,5.58,6000,2,17160,0,0,0,0,0,0,6000,6000,0,0
20200520,062915,嘉澤元大9B購03,2.08,2.13,2.08,2.08,+0.10,5.05,42000,5,88380,0,0,0,0,0,0,19000,42000,-23000,-23000
20200520,062916,智易元大9B購01,2.70,2.70,2.70,2.70,+0.06,2.27,3000,1,8100,0,0,0,0,0,0,0,3000,-3000,-3000
20200520,062917,旭富元大9C購03,,,,,0.00,0.00,0,0,0,0,0,0,0,0,0,0,0,0,0
20200520,062918,祥碩元大9C購02,4.39,4.43,4.39,4.43,+0.75,20.38,8000,3,35200,0,0,0,0,0,0,0,8000,-8000,-8000
20200520,062919,聯茂元大9B購01,1.62,1.62,1.62,1.62,-0.30,-15.62,5000,1,8100,0,0,0,0,0,0,0,5000,-5000,-5000
20200520,06291P,臺股指國票97售05,,,,,0.00,0.00,0,0,0,0,0,0,0,0,0,0,0,0,0
20200520,062920,康友元大9B購01,,,,,0.00,0.00,0,0,0,0,0,0,0,0,0,0,0,0,0
20200520,062921,GIS元大9B購01,,,,,0.00,0.00,0,0,0,0,0,0,0,0,0,0,0,0,0
20200520,062922,南六元大9B購03,,,,,0.00,0.00,0,0,0,0,0,0,0,0,0,0,0,0,0
20200520,062923,緯穎元大9B購06,3.66,3.66,3.66,3.66,+0.11,3.1,1000,1,3660,0,0,0,0,0,0,0,1000,-1000,-1000
20200520,062924,世紀鋼元大9C購04,1.27,1.27,1.24,1.24,+0.02,1.64,13000,2,16210,0,0,0,0,0,0,0,13000,-13000,-13000
20200520,062925,建準國票9B購01,,,,,0.00,0.00,0,0,0,0,0,0,0,0,0,0,0,0,0
20200520,062926,嘉澤國票9B購01,,,,,0.00,0.00,0,0,0,0,0,0,0,0,0,0,0,0,0
20200520,062927,同欣電國票9B購02,2.29,2.29,2.26,2.26,+0.95,72.52,733000,7,1674700,0,0,0,0,0,0,1000,733000,-732000,-732000
20200520,062928,富邦金台新9B購02,1.02,1.05,1.02,1.02,+0.02,2.0,93000,5,95500,0,0,0,0,0,0,43000,93000,-50000,-50000
20200520,062929,SP黃豆統一9B購01,,,,,0.00,0.00,0,0,0,0,0,0,0,0,0,0,0,0,0
20200520,06292P,臺股指國票97售06,11.60,11.60,11.60,11.60,0.00,0.00,1000,1,11600,0,0,0,0,0,0,0,1000,-1000,-1000
20200520,062930,旺宏統一9C購02,,,,,0.00,0.00,0,0,0,0,0,0,0,0,0,0,0,0,0
20200520,062931,上証2X凱基01購01,,,,,0.00,0.00,0,0,0,0,0,0,0,0,0,0,0,0,0
20200520,062932,滬深2X凱基01購01,,,,,0.00,0.00,0,0,0,0,0,0,0,0,0,0,0,0,0
20200520,062933,滬深2X凱基9B購07,,,,,0.00,0.00,0,0,0,0,0,0,0,0,0,0,0,0,0
20200520,062934,大成鋼凱基9B購02,,,,,0.00,0.00,0,0,0,0,0,0,0,0,0,0,0,0,0
20200520,062935,華通凱基9C購02,,,,,0.00,0.00,0,0,0,0,0,0,0,0,0,0,0,0,0
20200520,062936,鴻海凱基9B購07,,,,,0.00,0.00,0,0,0,0,0,0,0,0,0,0,0,0,0
20200520,062937,旺宏凱基9B購08,,,,,0.00,0.00,0,0,0,0,0,0,0,0,0,0,0,0,0
20200520,062938,聯發科凱基9B購10,3.60,3.60,3.60,3.60,+1.39,62.9,1000,1,3600,0,0,0,0,0,0,0,1000,-1000,-1000
20200520,062939,奇力新凱基9B購02,,,,,0.00,0.00,0,0,0,0,0,0,0,0,0,0,0,0,0
20200520,06293P,臺股指國票97售07,,,,,0.00,0.00,0,0,0,0,0,0,0,0,0,0,0,0,0
20200520,062940,華新科凱基9C購02,,,,,0.00,0.00,0,0,0,0,0,0,0,0,0,0,0,0,0
20200520,062941,大立光凱基9B購07,,,,,0.00,0.00,0,0,0,0,0,0,0,0,0,0,0,0,0
20200520,062942,嘉澤凱基9B購02,,,,,0.00,0.00,0,0,0,0,0,0,0,0,0,0,0,0,0
20200520,062943,世芯凱基9B購03,2.05,2.05,2.05,2.05,-0.05,-2.38,2000,1,4100,0,0,0,0,0,0,0,2000,-2000,-2000
20200520,062944,茂林凱基9B購02,,,,,0.00,0.00,0,0,0,0,0,0,0,0,0,0,0,0,0
20200520,062945,世芯國泰01購01,,,,,0.00,0.00,0,0,0,0,0,0,0,0,0,0,0,0,0
20200520,062946,祥碩國泰9C購02,2.56,2.56,2.56,2.56,+0.35,15.84,19000,1,48640,0,0,0,0,0,0,0,19000,-19000,-19000
20200520,062947,國巨富邦01購01,0.70,0.72,0.70,0.71,-0.02,-2.74,567000,40,404710,0,0,0,0,0,0,0,567000,-567000,-567000
20200520,062948,台積電富邦01購02,,,,,0.00,0.00,0,0,0,0,0,0,0,0,0,0,0,0,0
20200520,062949,聯發科富邦01購01,,,,,0.00,0.00,0,0,0,0,0,0,0,0,0,0,0,0,0
20200520,06294P,臺股指國票97售08,,,,,0.00,0.00,0,0,0,0,0,0,0,0,0,0,0,0,0
20200520,062950,貿聯富邦01購01,0.85,0.85,0.85,0.85,+0.06,7.59,22000,2,18700,0,0,0,0,0,0,0,22000,-22000,-22000
20200520,062951,鴻海永豐9B購02,,,,,0.00,0.00,0,0,0,0,0,0,0,0,0,0,0,0,0
20200520,062952,台積電永豐9B購02,,,,,0.00,0.00,0,0,0,0,0,0,0,0,0,0,0,0,0
20200520,062953,大立光永豐9B購01,,,,,0.00,0.00,0,0,0,0,0,0,0,0,0,0,0,0,0
20200520,062954,世芯永豐9B購03,,,,,0.00,0.00,0,0,0,0,0,0,0,0,0,0,0,0,0
20200520,062955,立積永豐9B購02,,,,,0.00,0.00,0,0,0,0,0,0,0,0,0,0,0,0,0
20200520,062956,同欣電永豐9B購02,0.90,0.90,0.90,0.90,+0.02,2.27,10000,1,9000,0,0,0,0,0,0,0,10000,-10000,-10000
20200520,062957,鴻海麥證9C購01,,,,,0.00,0.00,0,0,0,0,0,0,0,0,0,0,0,0,0
20200520,062958,長榮航麥證9B購01,,,,,0.00,0.00,0,0,0,0,0,0,0,0,0,0,0,0,0
20200520,062959,上証2X元富9B購01,,,,,0.00,0.00,0,0,0,0,0,0,0,0,0,0,0,0,0
20200520,06295P,國巨元大97售14,,,,,0.00,0.00,0,0,0,0,0,0,0,0,0,0,0,0,0
20200520,062960,上証2X元富9B購02,,,,,0.00,0.00,0,0,0,0,0,0,0,0,0,0,0,0,0
20200520,062961,S&P反1元富9B購01,,,,,0.00,0.00,0,0,0,0,0,0,0,0,0,0,0,0,0
20200520,062962,道瓊反元富9B購01,,,,,0.00,0.00,0,0,0,0,0,0,0,0,0,0,0,0,0
20200520,062963,道瓊反元富9B購02,,,,,0.00,0.00,0,0,0,0,0,0,0,0,0,0,0,0,0
20200520,062964,FBVIX元富9B購01,,,,,0.00,0.00,0,0,0,0,0,0,0,0,0,0,0,0,0
20200520,062965,FBVIX元富9C購01,,,,,0.00,0.00,0,0,0,0,0,0,0,0,0,0,0,0,0
20200520,062966,元金2X元富9B購02,,,,,0.00,0.00,0,0,0,0,0,0,0,0,0,0,0,0,0
20200520,062967,上銀元富9B購01,,,,,0.00,0.00,0,0,0,0,0,0,0,0,0,0,0,0,0
20200520,062968,仁寶元富9B購01,,,,,0.00,0.00,0,0,0,0,0,0,0,0,0,0,0,0,0
20200520,062969,旺宏元富9B購01,,,,,0.00,0.00,0,0,0,0,0,0,0,0,0,0,0,0,0
20200520,06296P,燿華元大98售01,1.95,1.95,1.77,1.78,-0.24,-11.88,62000,13,115740,0,0,0,0,0,0,28000,34000,-6000,-6000
20200520,062970,智邦元富9B購01,1.94,1.94,1.94,1.94,+0.21,12.14,5000,1,9700,0,0,0,0,0,0,0,5000,-5000,-5000
20200520,062971,英業達元富9B購01,,,,,0.00,0.00,0,0,0,0,0,0,0,0,0,0,0,0,0
20200520,062972,京元電元富9B購01,1.17,1.17,1.17,1.17,-0.67,-36.41,200000,2,234000,0,0,0,0,0,0,0,200000,-200000,-200000
20200520,062973,聯發科元富05購01,3.53,3.53,3.53,3.53,+0.99,38.98,100000,1,353000,0,0,0,0,0,0,0,100000,-100000,-100000
20200520,062974,奇力新元富9B購01,,,,,0.00,0.00,0,0,0,0,0,0,0,0,0,0,0,0,0
20200520,062975,京鼎元富9B購01,,,,,0.00,0.00,0,0,0,0,0,0,0,0,0,0,0,0,0
20200520,062976,嘉澤元富9B購01,1.60,1.60,1.55,1.55,+0.01,0.65,80000,2,125500,0,0,0,0,0,0,0,80000,-80000,-80000
20200520,062977,健策元富9B購01,,,,,0.00,0.00,0,0,0,0,0,0,0,0,0,0,0,0,0
20200520,062978,世芯元富9B購01,,,,,0.00,0.00,0,0,0,0,0,0,0,0,0,0,0,0,0
20200520,062979,茂林元富9B購01,2.69,2.90,2.69,2.90,+0.53,22.36,6000,2,16560,0,0,0,0,0,0,0,6000,-6000,-6000
20200520,06297P,美律元大97售01,,,,,0.00,0.00,0,0,0,0,0,0,0,0,0,0,0,0,0
20200520,062980,康控元富9B購01,,,,,0.00,0.00,0,0,0,0,0,0,0,0,0,0,0,0,0
20200520,062981,祥碩元富9B購01,1.89,1.89,1.89,1.89,+0.22,13.17,26000,1,49140,0,0,0,0,0,0,0,26000,-26000,-26000
20200520,062982,同欣電元富9B購01,2.63,2.68,2.52,2.52,+0.11,4.56,53000,5,138630,0,0,0,0,0,0,0,53000,-53000,-53000
20200520,062983,緯穎元富9B購01,,,,,0.00,0.00,0,0,0,0,0,0,0,0,0,0,0,0,0
20200520,062984,致新元富9B購01,,,,,0.00,0.00,0,0,0,0,0,0,0,0,0,0,0,0,0
20200520,06298P,聯發科元大97售20,,,,,0.00,0.00,0,0,0,0,0,0,0,0,0,0,0,0,0
20200520,06299P,可成元大97售04,,,,,0.00,0.00,0,0,0,0,0,0,0,0,0,0,0,0,0
20200520,06300P,緯穎元大97售04,0.13,0.13,0.13,0.13,0.00,0.00,30000,1,3900,0,0,0,0,0,0,0,30000,-30000,-30000
20200520,06301P,臺股指元大97售04,,,,,0.00,0.00,0,0,0,0,0,0,0,0,0,0,0,0,0
20200520,06302P,臺股指元大97售06,,,,,0.00,0.00,0,0,0,0,0,0,0,0,0,0,0,0,0
20200520,06303P,臺股指元大97售09,,,,,0.00,0.00,0,0,0,0,0,0,0,0,0,0,0,0,0
20200520,06304P,臺股指元大97售10,,,,,0.00,0.00,0,0,0,0,0,0,0,0,0,0,0,0,0
20200520,06305P,臺股指元大97售11,,,,,0.00,0.00,0,0,0,0,0,0,0,0,0,0,0,0,0
20200520,06306P,臺股指元大97售12,,,,,0.00,0.00,0,0,0,0,0,0,0,0,0,0,0,0,0
20200520,06307P,聚陽元富97售02,,,,,0.00,0.00,0,0,0,0,0,0,0,0,0,0,0,0,0
20200520,06308P,國巨元富97售06,1.18,1.18,1.17,1.18,-0.19,-13.87,1999000,5,2348840,0,0,0,0,0,0,1999000,1999000,0,0
20200520,06309P,光罩元富97售03,,,,,0.00,0.00,0,0,0,0,0,0,0,0,0,0,0,0,0
20200520,06310P,精元元富97售02,,,,,0.00,0.00,0,0,0,0,0,0,0,0,0,0,0,0,0
20200520,06311P,嘉聯益元富97售02,,,,,0.00,0.00,0,0,0,0,0,0,0,0,0,0,0,0,0
20200520,06312P,樺漢元富97售02,,,,,0.00,0.00,0,0,0,0,0,0,0,0,0,0,0,0,0
20200520,06313P,訊芯元富97售01,,,,,0.00,0.00,0,0,0,0,0,0,0,0,0,0,0,0,0
20200520,06314P,GIS元富97售02,0.80,0.80,0.80,0.80,+0.07,9.59,1000,1,800,0,0,0,0,0,0,0,1000,-1000,-1000
20200520,06315P,臺股指元富97售02,,,,,0.00,0.00,0,0,0,0,0,0,0,0,0,0,0,0,0
20200520,06316P,臺股指元富97售03,,,,,0.00,0.00,0,0,0,0,0,0,0,0,0,0,0,0,0
20200520,06317P,臺股指元富97售04,,,,,0.00,0.00,0,0,0,0,0,0,0,0,0,0,0,0,0
20200520,06318P,臺股指元富97售05,,,,,0.00,0.00,0,0,0,0,0,0,0,0,0,0,0,0,0
20200520,06319P,臺股指元富97售06,,,,,0.00,0.00,0,0,0,0,0,0,0,0,0,0,0,0,0
20200520,06320P,上銀統一97售04,1.49,1.61,1.49,1.61,+0.03,1.9,231000,13,350590,0,0,0,0,0,0,163000,68000,95000,95000
20200520,06321P,台積電統一98售03,,,,,0.00,0.00,0,0,0,0,0,0,0,0,0,0,0,0,0
20200520,06322P,超眾統一97售04,,,,,0.00,0.00,0,0,0,0,0,0,0,0,0,0,0,0,0
20200520,06323P,台郡統一97售01,2.33,2.33,2.33,2.33,0.00,0.00,290000,2,675700,0,0,0,0,0,0,0,290000,-290000,-290000
20200520,06324P,TXFI0永昌99售02,,,,,0.00,0.00,0,0,0,0,0,0,0,0,0,0,0,0,0
20200520,06325P,TXFI0永昌99售03,,,,,0.00,0.00,0,0,0,0,0,0,0,0,0,0,0,0,0
20200520,06326P,鴻海中信01售01,1.44,1.48,1.44,1.48,0.00,0.00,32000,5,47280,0,0,0,0,0,0,0,30000,-30000,-30000
20200520,06327P,台積電中信01售01,,,,,0.00,0.00,0,0,0,0,0,0,0,0,0,0,0,0,0
20200520,06328P,台積電中信01售02,1.22,1.22,1.22,1.22,-0.11,-8.27,4000,1,4880,0,0,0,0,0,0,4000,4000,0,0
20200520,06329P,大立光兆豐97售04,,,,,0.00,0.00,0,0,0,0,0,0,0,0,0,0,0,0,0
20200520,06330P,南亞科群益97售03,,,,,0.00,0.00,0,0,0,0,0,0,0,0,0,0,0,0,0
20200520,06331P,南亞科群益97售04,,,,,0.00,0.00,0,0,0,0,0,0,0,0,0,0,0,0,0
20200520,06332P,世紀鋼群益98售01,0.48,0.53,0.45,0.53,+0.02,3.92,201000,12,96000,0,0,0,0,0,0,164000,37000,127000,127000
20200520,06333P,臺股指群益9C售02,,,,,0.00,0.00,0,0,0,0,0,0,0,0,0,0,0,0,0
20200520,06334P,臺股指群益9C售03,,,,,0.00,0.00,0,0,0,0,0,0,0,0,0,0,0,0,0
20200520,06335P,台積電麥證97售02,,,,,0.00,0.00,0,0,0,0,0,0,0,0,0,0,0,0,0
20200520,06336P,鴻海元大98售05,5.25,5.35,5.25,5.35,0.00,0.00,40000,4,211500,0,0,0,0,0,0,40000,15000,25000,25000
20200520,06337P,祥碩元大97售05,0.19,0.19,0.14,0.14,-0.05,-26.32,59000,7,8510,0,0,0,0,0,0,0,0,0,0
20200520,06338P,亞德客統一97售02,1.12,1.14,1.06,1.14,-0.05,-4.2,37000,7,40110,0,0,0,0,0,0,21000,16000,5000,5000
20200520,06339P,上銀統一97售06,1.10,1.23,1.10,1.23,+0.03,2.5,2000,2,2330,0,0,0,0,0,0,1000,1000,0,0
20200520,06340P,鴻海統一98售06,,,,,0.00,0.00,0,0,0,0,0,0,0,0,0,0,0,0,0
20200520,06341P,大立光統一97售08,,,,,0.00,0.00,0,0,0,0,0,0,0,0,0,0,0,0,0
20200520,06342P,世芯統一98售01,0.56,0.60,0.56,0.60,+0.03,5.26,79000,5,45500,0,0,0,0,0,0,0,65000,-65000,-65000
20200520,06343P,臺股指統一98售01,,,,,0.00,0.00,0,0,0,0,0,0,0,0,0,0,0,0,0
20200520,06344P,臺股指統一99售03,,,,,0.00,0.00,0,0,0,0,0,0,0,0,0,0,0,0,0
20200520,06345P,臺股指統一9A售01,,,,,0.00,0.00,0,0,0,0,0,0,0,0,0,0,0,0,0
20200520,06346P,聯鈞元富97售02,,,,,0.00,0.00,0,0,0,0,0,0,0,0,0,0,0,0,0
20200520,06347P,祥碩元富97售02,0.15,0.15,0.15,0.15,-0.03,-16.67,20000,2,3000,0,0,0,0,0,0,0,20000,-20000,-20000
20200520,06348P,鈺齊元富97售02,,,,,0.00,0.00,0,0,0,0,0,0,0,0,0,0,0,0,0
20200520,06349P,臺股指台新99售01,,,,,0.00,0.00,0,0,0,0,0,0,0,0,0,0,0,0,0
20200520,06350P,臺股指台新99售02,,,,,0.00,0.00,0,0,0,0,0,0,0,0,0,0,0,0,0
20200520,06351P,臺股指台新99售03,,,,,0.00,0.00,0,0,0,0,0,0,0,0,0,0,0,0,0
20200520,06352P,臺股指富邦99售02,,,,,0.00,0.00,0,0,0,0,0,0,0,0,0,0,0,0,0
20200520,06353P,電子類富邦99售02,,,,,0.00,0.00,0,0,0,0,0,0,0,0,0,0,0,0,0
20200520,06354P,大立光永豐97售04,,,,,0.00,0.00,0,0,0,0,0,0,0,0,0,0,0,0,0
20200520,06355P,聯茂永豐97售02,0.75,0.79,0.75,0.78,+0.03,4.0,77000,8,58740,0,0,0,0,0,0,51000,26000,25000,25000
20200520,06356P,啟碁永豐97售01,2.86,2.86,2.86,2.86,0.00,0.00,37000,1,105820,0,0,0,0,0,0,0,37000,-37000,-37000
20200520,06357P,臺股指永豐97售03,,,,,0.00,0.00,0,0,0,0,0,0,0,0,0,0,0,0,0
20200520,06358P,力成中信97售02,,,,,0.00,0.00,0,0,0,0,0,0,0,0,0,0,0,0,0
20200520,06359P,上銀群益97售03,,,,,0.00,0.00,0,0,0,0,0,0,0,0,0,0,0,0,0
20200520,06360P,台積電群益97售05,,,,,0.00,0.00,0,0,0,0,0,0,0,0,0,0,0,0,0
20200520,06361P,聯發科群益97售06,,,,,0.00,0.00,0,0,0,0,0,0,0,0,0,0,0,0,0
20200520,06362P,臺股指麥證97售01,,,,,0.00,0.00,0,0,0,0,0,0,0,0,0,0,0,0,0
20200520,06363P,臺股指麥證97售02,,,,,0.00,0.00,0,0,0,0,0,0,0,0,0,0,0,0,0
20200520,06364P,鴻海凱基97售08,,,,,0.00,0.00,0,0,0,0,0,0,0,0,0,0,0,0,0
20200520,06365P,鴻海凱基97售09,,,,,0.00,0.00,0,0,0,0,0,0,0,0,0,0,0,0,0
20200520,06366P,鴻海凱基97售10,,,,,0.00,0.00,0,0,0,0,0,0,0,0,0,0,0,0,0
20200520,06367P,台積電凱基97售14,2.25,2.25,2.25,2.25,0.00,0.00,60000,1,135000,0,0,0,0,0,0,60000,60000,0,0
20200520,06368P,台積電凱基97售15,5.60,5.60,5.60,5.60,0.00,0.00,70000,1,392000,0,0,0,0,0,0,70000,70000,0,0
20200520,06369P,台積電凱基97售16,2.68,2.79,2.68,2.69,-0.17,-5.94,141000,5,379490,0,0,0,0,0,0,125000,136000,-11000,-11000
20200520,06370P,貿聯凱基97售03,0.89,0.93,0.89,0.93,0.00,0.00,52000,3,46580,0,0,0,0,0,0,40000,12000,28000,28000
20200520,06371P,茂林國票98售04,2.17,2.17,1.84,1.84,-0.41,-18.22,104000,4,211220,0,0,0,0,0,0,94000,10000,84000,84000
20200520,06372P,聯發科元大97售21,,,,,0.00,0.00,0,0,0,0,0,0,0,0,0,0,0,0,0
20200520,06373P,聯發科元大97售22,,,,,0.00,0.00,0,0,0,0,0,0,0,0,0,0,0,0,0
20200520,06374P,台表科元大97售06,1.11,1.18,0.89,0.89,-0.28,-23.93,437000,16,441120,0,0,0,0,0,0,261000,176000,85000,85000
20200520,06375P,矽力元大97售06,,,,,0.00,0.00,0,0,0,0,0,0,0,0,0,0,0,0,0
20200520,06376P,上銀統一99售01,2.53,2.60,2.53,2.60,+0.02,0.78,29000,5,74570,0,0,0,0,0,0,6000,23000,-17000,-17000
20200520,06377P,華通統一97售04,3.13,3.23,3.04,3.08,+0.07,2.33,28000,6,85900,0,0,0,0,0,0,7000,21000,-14000,-14000
20200520,06378P,國巨統一97售08,,,,,0.00,0.00,0,0,0,0,0,0,0,0,0,0,0,0,0
20200520,06379P,群創統一97售05,,,,,0.00,0.00,0,0,0,0,0,0,0,0,0,0,0,0,0
20200520,06380P,臺股指統一98售02,,,,,0.00,0.00,0,0,0,0,0,0,0,0,0,0,0,0,0
20200520,06381P,臺股指統一98售03,,,,,0.00,0.00,0,0,0,0,0,0,0,0,0,0,0,0,0
20200520,06382P,大毅元富97售02,,,,,0.00,0.00,0,0,0,0,0,0,0,0,0,0,0,0,0
20200520,06383P,聯茂元富97售01,0.58,0.58,0.58,0.58,0.00,0.00,2000,1,1160,0,0,0,0,0,0,2000,0,2000,2000
20200520,06384P,訊芯元富97售03,,,,,0.00,0.00,0,0,0,0,0,0,0,0,0,0,0,0,0
20200520,06385P,聯發科永豐97售02,,,,,0.00,0.00,0,0,0,0,0,0,0,0,0,0,0,0,0
20200520,06386P,欣興永豐97售03,2.53,2.62,2.46,2.62,0.00,0.00,126000,8,313270,0,0,0,0,0,0,123000,3000,120000,120000
20200520,06387P,緯穎永豐97售02,0.17,0.17,0.17,0.17,0.00,0.00,20000,1,3400,0,0,0,0,0,0,0,20000,-20000,-20000
20200520,06388P,鴻海兆豐97售04,,,,,0.00,0.00,0,0,0,0,0,0,0,0,0,0,0,0,0
20200520,06389P,聯發科兆豐97售01,,,,,0.00,0.00,0,0,0,0,0,0,0,0,0,0,0,0,0
20200520,06390P,美律國票97售03,,,,,0.00,0.00,0,0,0,0,0,0,0,0,0,0,0,0,0
20200520,06391P,上銀中信97售03,,,,,0.00,0.00,0,0,0,0,0,0,0,0,0,0,0,0,0
20200520,06392P,T50反1元大9A售01,,,,,0.00,0.00,0,0,0,0,0,0,0,0,0,0,0,0,0
20200520,06393P,台積電元大97售27,,,,,0.00,0.00,0,0,0,0,0,0,0,0,0,0,0,0,0
20200520,06394P,台積電元大97售28,4.68,4.68,4.68,4.68,0.00,0.00,66000,1,308880,0,0,0,0,0,0,66000,66000,0,0
20200520,06395P,台積電元大97售29,3.96,4.01,3.96,4.01,-0.11,-2.67,39000,2,156340,0,0,0,0,0,0,38000,39000,-1000,-1000
20200520,06396P,新日興康和97售01,,,,,0.00,0.00,0,0,0,0,0,0,0,0,0,0,0,0,0
20200520,06397P,T50反1凱基9A售03,,,,,0.00,0.00,0,0,0,0,0,0,0,0,0,0,0,0,0
20200520,06398P,禾伸堂凱基97售02,0.48,0.48,0.48,0.48,-0.02,-4.0,220000,2,105600,0,0,0,0,0,0,0,220000,-220000,-220000
20200520,06399P,台表科凱基97售05,,,,,0.00,0.00,0,0,0,0,0,0,0,0,0,0,0,0,0
20200520,06400P,鴻海元富97售12,,,,,0.00,0.00,0,0,0,0,0,0,0,0,0,0,0,0,0
20200520,06401P,鴻海元富97售13,,,,,0.00,0.00,0,0,0,0,0,0,0,0,0,0,0,0,0
20200520,06402P,鴻海元富97售14,,,,,0.00,0.00,0,0,0,0,0,0,0,0,0,0,0,0,0
20200520,06403P,鴻海元富97售15,,,,,0.00,0.00,0,0,0,0,0,0,0,0,0,0,0,0,0
20200520,06404P,鴻海元富97售16,,,,,0.00,0.00,0,0,0,0,0,0,0,0,0,0,0,0,0
20200520,06405P,億光元富97售02,1.72,1.72,1.67,1.67,-0.06,-3.47,8000,8,13560,0,0,0,0,0,0,8000,0,8000,8000
20200520,06406P,可成元富97售04,,,,,0.00,0.00,0,0,0,0,0,0,0,0,0,0,0,0,0
20200520,06407P,創意元富97售02,,,,,0.00,0.00,0,0,0,0,0,0,0,0,0,0,0,0,0
20200520,06408P,聯茂元富97售02,,,,,0.00,0.00,0,0,0,0,0,0,0,0,0,0,0,0,0
20200520,06409P,康友元富97售03,,,,,0.00,0.00,0,0,0,0,0,0,0,0,0,0,0,0,0
20200520,06410P,祥碩統一97售01,,,,,0.00,0.00,0,0,0,0,0,0,0,0,0,0,0,0,0
20200520,06411P,晶相光永豐97售03,1.30,1.34,1.29,1.32,0.00,0.00,105000,14,139210,0,0,0,0,0,0,41000,64000,-23000,-23000
20200520,06412P,南亞科日盛97售01,2.67,2.67,2.67,2.67,0.00,0.00,7000,1,18690,0,0,0,0,0,0,0,7000,-7000,-7000
20200520,06413P,聯發科凱基97售11,,,,,0.00,0.00,0,0,0,0,0,0,0,0,0,0,0,0,0
20200520,06414P,矽力凱基97售03,,,,,0.00,0.00,0,0,0,0,0,0,0,0,0,0,0,0,0
20200520,06415P,台積電群益97售07,,,,,0.00,0.00,0,0,0,0,0,0,0,0,0,0,0,0,0
20200520,06416P,大立光群益97售06,,,,,0.00,0.00,0,0,0,0,0,0,0,0,0,0,0,0,0
20200520,06417P,台積電兆豐97售03,,,,,0.00,0.00,0,0,0,0,0,0,0,0,0,0,0,0,0
20200520,06418P,T50反1統一9A售02,,,,,0.00,0.00,0,0,0,0,0,0,0,0,0,0,0,0,0
20200520,06419P,國巨統一97售09,,,,,0.00,0.00,0,0,0,0,0,0,0,0,0,0,0,0,0
20200520,06420P,大立光統一98售06,,,,,0.00,0.00,0,0,0,0,0,0,0,0,0,0,0,0,0
20200520,06421P,嘉澤統一97售02,0.77,0.81,0.77,0.81,-0.01,-1.22,93000,8,72610,0,0,0,0,0,0,83000,10000,73000,73000
20200520,06422P,勤誠統一98售01,,,,,0.00,0.00,0,0,0,0,0,0,0,0,0,0,0,0,0
20200520,06423P,亞光台新97售01,,,,,0.00,0.00,0,0,0,0,0,0,0,0,0,0,0,0,0
20200520,06424P,大成鋼永豐97售01,2.00,2.00,1.80,1.80,-0.25,-12.2,75000,17,146320,0,0,0,0,0,0,55000,20000,35000,35000
20200520,06425P,TPK永豐97售02,,,,,0.00,0.00,0,0,0,0,0,0,0,0,0,0,0,0,0
20200520,06426P,T50正2元大9B售01,1.29,1.29,1.29,1.29,+0.20,18.35,1000,1,1290,0,0,0,0,0,0,0,0,0,0
20200520,06427P,鴻海元大97售13,,,,,0.00,0.00,0,0,0,0,0,0,0,0,0,0,0,0,0
20200520,06428P,國巨元大97售17,1.48,1.48,1.37,1.41,-0.13,-8.44,37000,8,52320,0,0,0,0,0,0,1000,31000,-30000,-30000
20200520,06429P,大立光元大97售15,,,,,0.00,0.00,0,0,0,0,0,0,0,0,0,0,0,0,0
20200520,06430P,大立光元大97售16,,,,,0.00,0.00,0,0,0,0,0,0,0,0,0,0,0,0,0
20200520,06431P,新日興元大97售05,2.57,2.57,2.57,2.57,-0.03,-1.15,25000,1,64250,0,0,0,0,0,0,0,25000,-25000,-25000
20200520,06432P,上銀群益98售01,,,,,0.00,0.00,0,0,0,0,0,0,0,0,0,0,0,0,0
20200520,06433P,大立光群益99售01,,,,,0.00,0.00,0,0,0,0,0,0,0,0,0,0,0,0,0
20200520,06434P,超眾群益98售02,0.66,0.68,0.64,0.68,-0.01,-1.45,184000,4,119920,0,0,0,0,0,0,0,184000,-184000,-184000
20200520,06435P,臺股指群益98售02,,,,,0.00,0.00,0,0,0,0,0,0,0,0,0,0,0,0,0
20200520,06436P,台光電國票98售04,1.28,1.32,1.28,1.29,+0.04,3.2,52000,4,66650,0,0,0,0,0,0,0,52000,-52000,-52000
20200520,06437P,玉晶光國票99售01,,,,,0.00,0.00,0,0,0,0,0,0,0,0,0,0,0,0,0
20200520,06438P,玉晶光國票99售02,,,,,0.00,0.00,0,0,0,0,0,0,0,0,0,0,0,0,0
20200520,06439P,上銀凱基98售02,,,,,0.00,0.00,0,0,0,0,0,0,0,0,0,0,0,0,0
20200520,06440P,台積電凱基98售07,,,,,0.00,0.00,0,0,0,0,0,0,0,0,0,0,0,0,0
20200520,06441P,台積電凱基98售08,2.65,2.65,2.65,2.65,-0.13,-4.68,3000,1,7950,0,0,0,0,0,0,3000,0,3000,3000
20200520,06443P,台積電凱基99售01,,,,,0.00,0.00,0,0,0,0,0,0,0,0,0,0,0,0,0
20200520,06444P,大立光凱基98售08,,,,,0.00,0.00,0,0,0,0,0,0,0,0,0,0,0,0,0
20200520,06445P,大立光凱基98售09,,,,,0.00,0.00,0,0,0,0,0,0,0,0,0,0,0,0,0
20200520,06446P,大立光凱基98售10,,,,,0.00,0.00,0,0,0,0,0,0,0,0,0,0,0,0,0
20200520,06447P,上銀元大98售01,2.36,2.51,2.36,2.51,+0.06,2.45,75000,5,178110,0,0,0,0,0,0,70000,5000,65000,65000
20200520,06448P,華通元大99售01,2.09,2.18,2.06,2.12,+0.01,0.47,168000,11,357030,0,0,0,0,0,0,0,168000,-168000,-168000
20200520,06449P,台積電元大98售09,,,,,0.00,0.00,0,0,0,0,0,0,0,0,0,0,0,0,0
20200520,06450P,聯發科元大98售03,0.65,0.65,0.65,0.65,0.00,0.00,2000,1,1300,0,0,0,0,0,0,0,2000,-2000,-2000
20200520,06451P,聯發科元大98售04,,,,,0.00,0.00,0,0,0,0,0,0,0,0,0,0,0,0,0
20200520,06452P,大立光元大98售08,,,,,0.00,0.00,0,0,0,0,0,0,0,0,0,0,0,0,0
20200520,06453P,群創元大9B售02,3.04,3.05,3.02,3.05,-0.04,-1.29,31000,9,94390,0,0,0,0,0,0,31000,0,31000,31000
20200520,06454P,緯穎元大98售04,0.28,0.32,0.28,0.32,+0.01,3.23,263000,6,77340,0,0,0,0,0,0,121000,263000,-142000,-142000
20200520,06455P,上銀統一99售03,,,,,0.00,0.00,0,0,0,0,0,0,0,0,0,0,0,0,0
20200520,06456P,聯發科統一98售03,0.41,0.47,0.33,0.43,-0.01,-2.27,1702000,99,660620,0,0,0,0,0,0,173000,1232000,-1059000,-1059000
20200520,06457P,玉晶光統一98售02,2.56,2.58,2.42,2.42,-0.14,-5.47,133000,5,324560,0,0,0,0,0,0,103000,30000,73000,73000
20200520,06458P,玉晶光統一9A售02,2.38,2.38,2.33,2.35,-0.05,-2.08,14000,5,32900,0,0,0,0,0,0,0,14000,-14000,-14000
20200520,06459P,亞德客元富98售01,,,,,0.00,0.00,0,0,0,0,0,0,0,0,0,0,0,0,0
20200520,06460P,亞德客元富98售02,,,,,0.00,0.00,0,0,0,0,0,0,0,0,0,0,0,0,0
20200520,06461P,玉晶光國泰9A售01,2.36,2.36,2.28,2.28,-0.12,-5.0,11000,2,25160,0,0,0,0,0,0,11000,0,11000,11000
20200520,06462P,鴻海富邦98售01,,,,,0.00,0.00,0,0,0,0,0,0,0,0,0,0,0,0,0
20200520,06463P,大立光富邦9A售01,,,,,0.00,0.00,0,0,0,0,0,0,0,0,0,0,0,0,0
20200520,06464P,台光電亞東99售01,,,,,0.00,0.00,0,0,0,0,0,0,0,0,0,0,0,0,0
20200520,06465P,國巨統一98售04,1.10,1.11,1.00,1.08,-0.15,-12.2,776000,42,821590,0,0,0,0,0,0,116000,660000,-544000,-544000
20200520,06466P,台積電統一9B售01,3.02,3.04,3.02,3.02,-0.02,-0.66,19000,4,57400,0,0,0,0,0,0,0,19000,-19000,-19000
20200520,06467P,旺宏統一98售01,,,,,0.00,0.00,0,0,0,0,0,0,0,0,0,0,0,0,0
20200520,06468P,華新科統一98售02,,,,,0.00,0.00,0,0,0,0,0,0,0,0,0,0,0,0,0
20200520,06469P,臺股指凱基99售09,,,,,0.00,0.00,0,0,0,0,0,0,0,0,0,0,0,0,0
20200520,06470P,臺股指凱基99售10,2.88,2.88,2.88,2.88,0.00,0.00,1000,1,2880,0,0,0,0,0,0,0,1000,-1000,-1000
20200520,06471P,臺股指凱基99售11,,,,,0.00,0.00,0,0,0,0,0,0,0,0,0,0,0,0,0
20200520,06472P,道瓊銀元大98售03,,,,,0.00,0.00,0,0,0,0,0,0,0,0,0,0,0,0,0
20200520,06473P,鴻海元大99售03,4.20,4.20,4.20,4.20,-0.03,-0.71,25000,2,105000,0,0,0,0,0,0,25000,0,25000,25000
20200520,06474P,鴻海富邦98售03,,,,,0.00,0.00,0,0,0,0,0,0,0,0,0,0,0,0,0
20200520,06475P,牧德永豐98售03,1.08,1.08,0.89,0.89,-0.24,-21.24,48000,5,46860,0,0,0,0,0,0,0,48000,-48000,-48000
20200520,06476P,臺股指永豐98售01,,,,,0.00,0.00,0,0,0,0,0,0,0,0,0,0,0,0,0
20200520,06477P,緯穎國票99售02,0.56,0.56,0.56,0.56,+0.02,3.7,1000,1,560,0,0,0,0,0,0,0,1000,-1000,-1000
20200520,06478P,臺股指日盛9A售01,,,,,0.00,0.00,0,0,0,0,0,0,0,0,0,0,0,0,0
20200520,06479P,聯發科中信99售02,0.20,0.21,0.18,0.20,-0.03,-13.04,330000,10,67830,0,0,0,0,0,0,0,321000,-321000,-321000
20200520,06480P,上銀凱基98售04,,,,,0.00,0.00,0,0,0,0,0,0,0,0,0,0,0,0,0
20200520,06481P,台積電凱基98售12,,,,,0.00,0.00,0,0,0,0,0,0,0,0,0,0,0,0,0
20200520,06482P,台積電凱基98售13,1.77,1.77,1.77,1.77,0.00,0.00,50000,1,88500,0,0,0,0,0,0,50000,50000,0,0
20200520,06483P,聯發科凱基98售10,,,,,0.00,0.00,0,0,0,0,0,0,0,0,0,0,0,0,0
20200520,06484P,聯發科凱基98售11,,,,,0.00,0.00,0,0,0,0,0,0,0,0,0,0,0,0,0
20200520,06485P,玉晶光群益9A售02,3.89,3.89,3.72,3.72,-0.09,-2.36,7000,3,26830,0,0,0,0,0,0,0,7000,-7000,-7000
20200520,06486P,麗豐元大98售02,0.83,0.85,0.81,0.83,0.00,0.00,384000,7,320470,0,0,0,0,0,0,325000,309000,16000,16000
20200520,06487P,聯發科統一99售02,0.99,0.99,0.95,0.98,-0.09,-8.41,38000,16,36750,0,0,0,0,0,0,12000,26000,-14000,-14000
20200520,06488P,台積電元富98售05,,,,,0.00,0.00,0,0,0,0,0,0,0,0,0,0,0,0,0
20200520,06489P,台積電元富98售06,,,,,0.00,0.00,0,0,0,0,0,0,0,0,0,0,0,0,0
20200520,06490P,鴻海富邦99售02,,,,,0.00,0.00,0,0,0,0,0,0,0,0,0,0,0,0,0
20200520,06491P,台積電富邦99售02,1.17,1.20,1.16,1.17,-0.01,-0.85,654000,10,764690,0,0,0,0,0,0,623000,576000,47000,47000
20200520,06492P,上銀永豐98售01,,,,,0.00,0.00,0,0,0,0,0,0,0,0,0,0,0,0,0
20200520,06493P,聯發科永豐98售02,,,,,0.00,0.00,0,0,0,0,0,0,0,0,0,0,0,0,0
20200520,06494P,鴻海永昌98售03,2.12,2.12,2.12,2.12,+0.14,7.07,1000,1,2120,0,0,0,0,0,0,0,1000,-1000,-1000
20200520,06495P,華新科亞東9A售01,,,,,0.00,0.00,0,0,0,0,0,0,0,0,0,0,0,0,0
20200520,06496P,台灣50日盛98售01,3.05,3.14,3.05,3.14,-0.02,-0.63,5000,3,15590,0,0,0,0,0,0,4000,0,4000,4000
20200520,06497P,大立光凱基98售11,5.00,5.00,4.87,4.99,-0.01,-0.2,14000,3,69860,0,0,0,0,0,0,13000,1000,12000,12000
20200520,06498P,臺股指元大9A售03,,,,,0.00,0.00,0,0,0,0,0,0,0,0,0,0,0,0,0
20200520,06499P,臺股指元大9A售04,,,,,0.00,0.00,0,0,0,0,0,0,0,0,0,0,0,0,0
20200520,06500P,臺股指元大9A售05,,,,,0.00,0.00,0,0,0,0,0,0,0,0,0,0,0,0,0
20200520,06501P,臺股指元大9A售06,7.05,7.05,7.05,7.05,0.00,0.00,21000,1,148050,0,0,0,0,0,0,21000,0,21000,21000
20200520,06502P,A50中信98售01,,,,,0.00,0.00,0,0,0,0,0,0,0,0,0,0,0,0,0
20200520,06503P,臺股指中信9A售02,,,,,0.00,0.00,0,0,0,0,0,0,0,0,0,0,0,0,0
20200520,06504P,麗豐國票99售02,,,,,0.00,0.00,0,0,0,0,0,0,0,0,0,0,0,0,0
20200520,06505P,康控國票99售02,2.44,2.62,2.44,2.62,+0.10,3.97,141000,8,357880,0,0,0,0,0,0,30000,111000,-81000,-81000
20200520,06506P,台郡國票99售02,0.96,0.96,0.91,0.96,0.00,0.00,218000,9,205210,0,10000,-10000,0,0,0,157000,61000,96000,86000
20200520,06507P,台表科國票99售01,0.45,0.50,0.35,0.36,-0.15,-29.41,2019000,35,893050,0,0,0,0,0,0,154000,1865000,-1711000,-1711000
20200520,06508P,台灣50統一98售01,,,,,0.00,0.00,0,0,0,0,0,0,0,0,0,0,0,0,0
20200520,06509P,鴻海群益98售03,3.43,3.48,3.37,3.48,+0.04,1.16,106000,8,360970,0,0,0,0,0,0,106000,0,106000,106000
20200520,06510P,燿華永豐98售03,1.90,1.91,1.66,1.66,-0.35,-17.41,95000,11,169050,0,0,0,0,0,0,40000,75000,-35000,-35000
20200520,06511P,元油2X中信9B售01,,,,,0.00,0.00,0,0,0,0,0,0,0,0,0,0,0,0,0
20200520,06512P,元油2X凱基9B售01,,,,,0.00,0.00,0,0,0,0,0,0,0,0,0,0,0,0,0
20200520,06513P,鴻海凱基98售10,2.16,2.24,2.13,2.23,+0.02,0.9,249000,16,539150,0,0,0,0,0,0,204000,49000,155000,155000
20200520,06514P,國巨凱基98售05,1.04,1.04,0.97,1.03,-0.14,-11.97,368000,10,370480,0,0,0,0,0,0,3000,365000,-362000,-362000
20200520,06515P,國巨凱基98售06,1.93,1.94,1.85,1.89,-0.19,-9.13,45000,7,86520,0,0,0,0,0,0,19000,26000,-7000,-7000
20200520,06516P,國巨凱基98售08,1.60,1.60,1.52,1.52,-0.16,-9.52,7000,2,10960,0,0,0,0,0,0,3000,4000,-1000,-1000
20200520,06517P,國巨凱基98售09,1.68,1.69,1.58,1.68,-0.15,-8.2,189000,20,312350,0,0,0,0,0,0,101000,88000,13000,13000
20200520,06518P,奇力新兆豐99售01,,,,,0.00,0.00,0,0,0,0,0,0,0,0,0,0,0,0,0
20200520,06519P,元油2X元大98售03,,,,,0.00,0.00,0,0,0,0,0,0,0,0,0,0,0,0,0
20200520,06520P,元油2X元大98售04,,,,,0.00,0.00,0,0,0,0,0,0,0,0,0,0,0,0,0
20200520,06521P,矽力元大98售01,0.88,0.92,0.88,0.92,-0.03,-3.16,122000,9,108160,0,0,0,0,0,0,0,0,0,0
20200520,06522P,元油2X群益9B售03,,,,,0.00,0.00,0,0,0,0,0,0,0,0,0,0,0,0,0
20200520,06523P,台積電麥證98售02,,,,,0.00,0.00,0,0,0,0,0,0,0,0,0,0,0,0,0
20200520,06524P,臺股指麥證98售02,,,,,0.00,0.00,0,0,0,0,0,0,0,0,0,0,0,0,0
20200520,06525P,上証2X國泰99售01,1.01,1.04,1.01,1.04,0.00,0.00,6000,2,6090,0,0,0,0,0,0,0,6000,-6000,-6000
20200520,06526P,元油2X永豐98售03,,,,,0.00,0.00,0,0,0,0,0,0,0,0,0,0,0,0,0
20200520,06527P,T50正2富邦9C售01,4.06,4.10,4.06,4.10,-0.01,-0.24,999000,3,4075900,0,0,0,0,0,0,500000,499000,1000,1000
20200520,06528P,台積電富邦99售03,,,,,0.00,0.00,0,0,0,0,0,0,0,0,0,0,0,0,0
20200520,06529P,貿聯富邦99售03,0.94,0.99,0.94,0.99,+0.01,1.02,510000,29,488100,0,0,0,0,0,0,300000,210000,90000,90000
20200520,06530P,元油2X元富98售13,,,,,0.00,0.00,0,0,0,0,0,0,0,0,0,0,0,0,0
20200520,06531P,元油2X元富98售14,,,,,0.00,0.00,0,0,0,0,0,0,0,0,0,0,0,0,0
20200520,06532P,友達元富98售04,2.66,2.72,2.64,2.72,-0.03,-1.09,42000,9,113700,0,0,0,0,0,0,7000,35000,-28000,-28000
20200520,06533P,上証2X中信9B售01,,,,,0.00,0.00,0,0,0,0,0,0,0,0,0,0,0,0,0
20200520,06534P,聯發科群益98售04,1.55,1.55,1.52,1.52,-0.14,-8.43,13000,3,19950,0,0,0,0,0,0,7000,6000,1000,1000
20200520,06535P,可成群益99售02,3.35,3.37,3.35,3.37,+0.27,8.71,247000,5,829810,0,0,0,0,0,0,119000,228000,-109000,-109000
20200520,06536P,臺股指群益98售04,,,,,0.00,0.00,0,0,0,0,0,0,0,0,0,0,0,0,0
20200520,06537P,華通凱基98售04,,,,,0.00,0.00,0,0,0,0,0,0,0,0,0,0,0,0,0
20200520,06538P,國巨凱基98售11,,,,,0.00,0.00,0,0,0,0,0,0,0,0,0,0,0,0,0
20200520,06539P,聯發科凱基98售12,0.80,0.85,0.72,0.85,-0.04,-4.49,80000,3,59700,0,0,0,0,0,0,60000,20000,40000,40000
20200520,06540P,聯發科凱基98售13,3.90,3.90,3.90,3.90,0.00,0.00,1000,1,3900,0,0,0,0,0,0,0,1000,-1000,-1000
20200520,06541P,元油2X國票9A售02,,,,,0.00,0.00,0,0,0,0,0,0,0,0,0,0,0,0,0
20200520,06542P,台光電國票98售05,1.67,1.73,1.67,1.72,-0.09,-4.97,164000,9,278130,0,0,0,0,0,0,24000,140000,-116000,-116000
20200520,06543P,鴻海元大98售08,4.02,4.04,3.97,4.04,-0.04,-0.98,92000,4,368030,0,0,0,0,0,0,92000,67000,25000,25000
20200520,06544P,鴻海元大98售09,5.35,5.35,5.30,5.35,-0.10,-1.83,31000,4,165600,0,0,0,0,0,0,25000,6000,19000,19000
20200520,06545P,致茂元大98售01,2.72,2.72,2.72,2.72,-0.11,-3.89,11000,2,29920,0,0,0,0,0,0,11000,0,11000,11000
20200520,06546P,聯發科元大98售05,2.30,2.30,2.30,2.30,0.00,0.00,20000,1,46000,0,0,0,0,0,0,0,20000,-20000,-20000
20200520,06547P,大立光元大98售09,,,,,0.00,0.00,0,0,0,0,0,0,0,0,0,0,0,0,0
20200520,06548P,大立光元大98售10,,,,,0.00,0.00,0,0,0,0,0,0,0,0,0,0,0,0,0
20200520,06549P,大立光元大98售11,4.84,4.84,4.84,4.84,0.00,0.00,9000,1,43560,0,0,0,0,0,0,9000,0,9000,9000
20200520,06550P,健策元大99售01,,,,,0.00,0.00,0,0,0,0,0,0,0,0,0,0,0,0,0
20200520,06551P,貿聯元大98售05,2.31,2.33,2.31,2.33,0.00,0.00,50000,2,116000,0,0,0,0,0,0,0,50000,-50000,-50000
20200520,06552P,茂林元大99售02,1.08,1.12,1.04,1.04,-0.24,-18.75,65000,7,69300,0,0,0,0,0,0,15000,50000,-35000,-35000
20200520,06553P,訊芯元大98售05,,,,,0.00,0.00,0,0,0,0,0,0,0,0,0,0,0,0,0
20200520,06554P,臺股指元大99售06,3.37,3.37,3.37,3.37,-0.11,-3.16,14000,1,47180,0,0,0,0,0,0,14000,0,14000,14000
20200520,06555P,臺股指元大99售07,,,,,0.00,0.00,0,0,0,0,0,0,0,0,0,0,0,0,0
20200520,06556P,臺股指元大99售08,8.40,8.40,8.40,8.40,0.00,0.00,40000,2,336000,0,0,0,0,0,0,40000,0,40000,40000
20200520,06557P,台積電兆豐98售02,,,,,0.00,0.00,0,0,0,0,0,0,0,0,0,0,0,0,0
20200520,06558P,旺宏元富98售02,6.20,6.20,6.20,6.20,+0.05,0.81,100000,2,620000,0,0,0,0,0,0,0,100000,-100000,-100000
20200520,06559P,玉晶光元富98售02,,,,,0.00,0.00,0,0,0,0,0,0,0,0,0,0,0,0,0
20200520,06560P,台積電統一98售07,,,,,0.00,0.00,0,0,0,0,0,0,0,0,0,0,0,0,0
20200520,06561P,台灣50國泰9A售01,,,,,0.00,0.00,0,0,0,0,0,0,0,0,0,0,0,0,0
20200520,06562P,台積電國泰99售02,,,,,0.00,0.00,0,0,0,0,0,0,0,0,0,0,0,0,0
20200520,06563P,元油2X富邦02售02,,,,,0.00,0.00,0,0,0,0,0,0,0,0,0,0,0,0,0
20200520,06564P,國巨富邦9A售04,0.64,0.64,0.63,0.63,0.00,0.00,6000,2,3790,0,0,0,0,0,0,6000,0,6000,6000
20200520,06565P,元油2X永豐9A售01,,,,,0.00,0.00,0,0,0,0,0,0,0,0,0,0,0,0,0
20200520,06566P,華通永豐98售03,0.71,0.75,0.71,0.74,-0.01,-1.33,154000,13,112740,0,0,0,0,0,0,64000,80000,-16000,-16000
20200520,06567P,鴻海永豐98售02,2.00,2.00,2.00,2.00,+0.13,6.95,9000,1,18000,0,0,0,0,0,0,0,9000,-9000,-9000
20200520,06568P,國巨永豐98售05,1.69,1.69,1.62,1.68,-0.17,-9.19,106000,11,176640,0,0,0,0,0,0,21000,85000,-64000,-64000
20200520,06569P,可成永豐98售01,0.68,0.76,0.68,0.73,+0.11,17.74,156000,6,116280,0,0,0,0,0,0,28000,126000,-98000,-98000
20200520,06570P,大立光永豐98售01,,,,,0.00,0.00,0,0,0,0,0,0,0,0,0,0,0,0,0
20200520,06571P,欣興永豐98售03,0.44,0.50,0.41,0.50,-0.02,-3.85,48000,7,20040,0,0,0,0,0,0,47000,1000,46000,46000
20200520,06572P,台積電永昌99售01,,,,,0.00,0.00,0,0,0,0,0,0,0,0,0,0,0,0,0
20200520,06573P,台積電永昌99售02,,,,,0.00,0.00,0,0,0,0,0,0,0,0,0,0,0,0,0
20200520,06574P,大立光永昌99售01,,,,,0.00,0.00,0,0,0,0,0,0,0,0,0,0,0,0,0
20200520,06575P,大立光永昌99售02,,,,,0.00,0.00,0,0,0,0,0,0,0,0,0,0,0,0,0
20200520,06576P,台光電群益98售03,1.61,1.61,1.59,1.59,+0.01,0.63,146000,4,234520,0,0,0,0,0,0,27000,119000,-92000,-92000
20200520,06577P,聯發科日盛9A售02,,,,,0.00,0.00,0,0,0,0,0,0,0,0,0,0,0,0,0
20200520,06578P,華新科國票98售02,,,,,0.00,0.00,0,0,0,0,0,0,0,0,0,0,0,0,0
20200520,06579P,臺股指麥證98售03,,,,,0.00,0.00,0,0,0,0,0,0,0,0,0,0,0,0,0
20200520,06580P,元油2X凱基9A售06,,,,,0.00,0.00,0,0,0,0,0,0,0,0,0,0,0,0,0
20200520,06581P,南亞科凱基98售04,,,,,0.00,0.00,0,0,0,0,0,0,0,0,0,0,0,0,0
20200520,06582P,可成凱基98售06,2.41,2.50,2.41,2.50,+0.16,6.84,348000,8,862320,0,0,0,0,0,0,37000,311000,-274000,-274000
20200520,06583P,可成凱基98售07,4.36,4.56,4.36,4.56,+0.34,8.06,119000,10,535260,0,0,0,0,0,0,22000,107000,-85000,-85000
20200520,06584P,欣興凱基98售03,1.39,1.43,1.32,1.43,-0.01,-0.69,64000,8,87150,0,0,0,0,0,0,53000,11000,42000,42000
20200520,06585P,鴻海元大99售04,,,,,0.00,0.00,0,0,0,0,0,0,0,0,0,0,0,0,0
20200520,06586P,鴻海元大9C售01,,,,,0.00,0.00,0,0,0,0,0,0,0,0,0,0,0,0,0
20200520,06587P,國巨元大98售13,,,,,0.00,0.00,0,0,0,0,0,0,0,0,0,0,0,0,0
20200520,06588P,台積電元大98售11,,,,,0.00,0.00,0,0,0,0,0,0,0,0,0,0,0,0,0
20200520,06589P,台積電元大98售12,,,,,0.00,0.00,0,0,0,0,0,0,0,0,0,0,0,0,0
20200520,06590P,大立光元大98售13,,,,,0.00,0.00,0,0,0,0,0,0,0,0,0,0,0,0,0
20200520,06591P,大立光元大98售14,4.69,4.69,4.69,4.69,-0.02,-0.42,15000,1,70350,0,0,0,0,0,0,15000,0,15000,15000
20200520,06592P,欣興元大98售04,2.60,2.60,2.54,2.54,-0.33,-11.5,18000,3,45790,0,0,0,0,0,0,17000,1000,16000,16000
20200520,06593P,欣興元大98售05,2.36,2.40,2.21,2.35,-0.03,-1.26,148000,29,340900,0,0,0,0,0,0,23000,124000,-101000,-101000
20200520,06594P,立積元大98售01,1.46,1.54,1.46,1.52,-0.01,-0.65,170000,9,251710,0,0,0,0,0,0,55000,115000,-60000,-60000
20200520,06595P,祥碩元大98售03,0.70,0.71,0.61,0.61,-0.13,-17.57,1445000,38,940330,0,0,0,0,0,0,982000,1174000,-192000,-192000
20200520,06596P,元油2X富邦02售03,,,,,0.00,0.00,0,0,0,0,0,0,0,0,0,0,0,0,0
20200520,06597P,國巨富邦9A售05,1.14,1.14,1.06,1.10,-0.09,-7.56,199000,18,217300,0,0,0,0,0,0,144000,55000,89000,89000
20200520,06598P,奇力新永豐98售02,1.74,1.76,1.74,1.74,-0.08,-4.4,22000,4,38300,0,0,0,0,0,0,0,22000,-22000,-22000
20200520,06599P,宏達電永豐98售02,1.96,2.00,1.94,1.99,-0.12,-5.69,80000,6,158870,0,0,0,0,0,0,10000,70000,-60000,-60000
20200520,06600P,貿聯永豐98售01,0.99,1.04,0.99,1.04,0.00,0.00,99000,7,99760,0,0,0,0,0,0,60000,39000,21000,21000
20200520,06601P,臺股指永豐98售04,,,,,0.00,0.00,0,0,0,0,0,0,0,0,0,0,0,0,0
20200520,06602P,國巨統一99售02,2.36,2.36,2.27,2.36,-0.11,-4.45,21000,7,49050,0,0,0,0,0,0,4000,17000,-13000,-13000
20200520,06603P,立積統一99售01,1.75,1.81,1.75,1.81,-0.03,-1.63,32000,8,57560,0,0,0,0,0,0,27000,4000,23000,23000
20200520,06604P,聯發科元富02售02,0.81,0.85,0.74,0.85,-0.01,-1.16,309000,30,243290,0,0,0,0,0,0,30000,279000,-249000,-249000
20200520,06605P,玉晶光元富98售03,,,,,0.00,0.00,0,0,0,0,0,0,0,0,0,0,0,0,0
20200520,06606P,訊芯元富98售02,,,,,0.00,0.00,0,0,0,0,0,0,0,0,0,0,0,0,0
20200520,06607P,友達台新98售02,,,,,0.00,0.00,0,0,0,0,0,0,0,0,0,0,0,0,0
20200520,06608P,立積群益99售02,0.80,0.85,0.79,0.82,+0.01,1.23,339000,16,279820,0,0,0,0,0,0,196000,143000,53000,53000
20200520,06609P,元油2X凱基9B售06,,,,,0.00,0.00,0,0,0,0,0,0,0,0,0,0,0,0,0
20200520,06610P,台積電凱基9A售03,,,,,0.00,0.00,0,0,0,0,0,0,0,0,0,0,0,0,0
20200520,06611P,祥碩國票98售01,0.51,0.51,0.42,0.43,-0.13,-23.21,257000,33,117410,0,0,0,0,0,0,111000,136000,-25000,-25000
20200520,06612P,元油2X富邦9B售03,,,,,0.00,0.00,0,0,0,0,0,0,0,0,0,0,0,0,0
20200520,06613P,華新科富邦9A售03,,,,,0.00,0.00,0,0,0,0,0,0,0,0,0,0,0,0,0
20200520,06614P,祥碩永豐98售03,0.27,0.27,0.24,0.24,-0.05,-17.24,107000,11,28680,0,0,0,0,0,0,0,0,0,0
20200520,06615P,鴻海元大9C售02,2.71,2.71,2.71,2.71,0.00,0.00,299000,3,810290,0,0,0,0,0,0,299000,0,299000,299000
20200520,06616P,國巨元大98售15,3.47,3.47,3.32,3.32,-0.35,-9.54,101000,5,338450,0,0,0,0,0,0,93000,38000,55000,55000
20200520,06617P,智邦元大98售03,0.50,0.50,0.48,0.48,-0.04,-7.69,32000,8,15660,0,0,0,0,0,0,30000,2000,28000,28000
20200520,06618P,智邦元大98售04,0.70,0.70,0.23,0.30,-0.30,-50.0,7000,3,2150,0,0,0,0,0,0,0,1000,-1000,-1000
20200520,06619P,聯發科元大98售06,1.12,1.14,0.98,1.11,-0.12,-9.76,882000,32,964320,0,0,0,0,0,0,322000,560000,-238000,-238000
20200520,06620P,聯發科元大98售07,,,,,0.00,0.00,0,0,0,0,0,0,0,0,0,0,0,0,0
20200520,06621P,欣興元大98售06,2.72,2.72,2.65,2.65,-0.43,-13.96,17000,2,45120,0,0,0,0,0,0,17000,0,17000,17000
20200520,06622P,牧德元大98售01,1.43,1.44,1.41,1.43,-0.19,-11.73,124000,6,177220,0,0,0,0,0,0,44000,80000,-36000,-36000
20200520,06623P,立積元大98售04,1.28,1.28,1.28,1.28,-0.13,-9.22,2000,1,2560,0,0,0,0,0,0,2000,0,2000,2000
20200520,06624P,訊芯元大98售06,1.57,1.62,1.57,1.62,-0.02,-1.22,96000,8,153040,0,0,0,0,0,0,96000,96000,0,0
20200520,06625P,華新科統一98售03,,,,,0.00,0.00,0,0,0,0,0,0,0,0,0,0,0,0,0
20200520,06626P,大立光統一9A售01,,,,,0.00,0.00,0,0,0,0,0,0,0,0,0,0,0,0,0
20200520,06627P,華新科元富99售01,2.56,2.58,2.56,2.58,+0.02,0.78,203000,3,523680,0,0,0,0,0,0,0,203000,-203000,-203000
20200520,06628P,訊芯元富98售03,,,,,0.00,0.00,0,0,0,0,0,0,0,0,0,0,0,0,0
20200520,06629P,台灣50第一98售01,,,,,0.00,0.00,0,0,0,0,0,0,0,0,0,0,0,0,0
20200520,06630P,國巨群益98售08,,,,,0.00,0.00,0,0,0,0,0,0,0,0,0,0,0,0,0
20200520,06631P,玉晶光群益9A售03,,,,,0.00,0.00,0,0,0,0,0,0,0,0,0,0,0,0,0
20200520,06632P,創意群益98售03,,,,,0.00,0.00,0,0,0,0,0,0,0,0,0,0,0,0,0
20200520,06633P,國巨國票99售01,4.37,4.37,4.16,4.32,-0.27,-5.88,64000,11,273790,0,0,0,0,0,0,23000,41000,-18000,-18000
20200520,06634P,欣興國票98售02,2.32,2.50,2.32,2.49,-0.28,-10.11,7000,4,16850,0,0,0,0,0,0,0,7000,-7000,-7000
20200520,06635P,聯發科凱基98售15,,,,,0.00,0.00,0,0,0,0,0,0,0,0,0,0,0,0,0
20200520,06636P,可成凱基98售08,1.02,1.10,1.02,1.07,+0.16,17.58,101000,11,106880,0,0,0,0,0,0,35000,66000,-31000,-31000
20200520,06637P,大立光凱基98售15,,,,,0.00,0.00,0,0,0,0,0,0,0,0,0,0,0,0,0
20200520,06638P,鴻海統一99售02,1.36,1.42,1.36,1.42,+0.08,5.97,227000,32,317410,0,0,0,0,0,0,20000,207000,-187000,-187000
20200520,06639P,訊芯元富98售04,,,,,0.00,0.00,0,0,0,0,0,0,0,0,0,0,0,0,0
20200520,06640P,國巨兆豐99售02,,,,,0.00,0.00,0,0,0,0,0,0,0,0,0,0,0,0,0
20200520,06641P,智邦兆豐99售01,,,,,0.00,0.00,0,0,0,0,0,0,0,0,0,0,0,0,0
20200520,06642P,可成兆豐98售01,0.95,0.95,0.95,0.95,0.00,0.00,3000,1,2850,0,0,0,0,0,0,0,0,0,0
20200520,06643P,大立光兆豐98售01,,,,,0.00,0.00,0,0,0,0,0,0,0,0,0,0,0,0,0
20200520,06644P,亞德客元大98售03,1.34,1.41,1.34,1.38,0.00,0.00,102000,3,139000,0,0,0,0,0,0,0,102000,-102000,-102000
20200520,06645P,上銀元大98售05,2.14,2.24,2.14,2.24,+0.03,1.36,87000,6,189960,0,0,0,0,0,0,82000,5000,77000,77000
20200520,06646P,國巨元大98售16,2.26,2.31,2.21,2.28,-0.14,-5.79,22000,4,49490,0,0,0,0,0,0,16000,6000,10000,10000
20200520,06647P,台積電元大98售13,,,,,0.00,0.00,0,0,0,0,0,0,0,0,0,0,0,0,0
20200520,06648P,華邦電元大98售03,,,,,0.00,0.00,0,0,0,0,0,0,0,0,0,0,0,0,0
20200520,06649P,聯發科元大98售08,,,,,0.00,0.00,0,0,0,0,0,0,0,0,0,0,0,0,0
20200520,06650P,聯發科元大98售09,,,,,0.00,0.00,0,0,0,0,0,0,0,0,0,0,0,0,0
20200520,06651P,華新科元大99售09,,,,,0.00,0.00,0,0,0,0,0,0,0,0,0,0,0,0,0
20200520,06652P,長榮航元大98售01,0.99,0.99,0.94,0.94,-0.06,-6.0,110000,12,107200,0,0,0,0,0,0,0,89000,-89000,-89000
20200520,06653P,美食元大98售02,0.90,1.02,0.88,0.98,-0.05,-4.85,631000,11,603520,0,0,0,0,0,0,280000,341000,-61000,-61000
20200520,06654P,欣興元大98售08,1.76,1.86,1.69,1.82,-0.05,-2.67,363000,37,643790,0,0,0,0,0,0,166000,197000,-31000,-31000
20200520,06655P,TPK元大98售02,1.16,1.16,1.16,1.16,-0.03,-2.52,2000,1,2320,0,0,0,0,0,0,0,2000,-2000,-2000
20200520,06656P,GIS元大98售02,1.69,1.69,1.67,1.67,-0.03,-1.76,212000,5,358080,0,0,0,0,0,0,10000,202000,-192000,-192000
20200520,06657P,寶成元大98售01,3.18,3.18,3.18,3.18,+0.04,1.27,1000,1,3180,0,0,0,0,0,0,0,1000,-1000,-1000
20200520,06658P,台灣50富邦9C售01,6.85,6.85,6.85,6.85,0.00,0.00,3000,1,20550,0,0,0,0,0,0,0,3000,-3000,-3000
20200520,06659P,T50正2富邦9A售01,,,,,0.00,0.00,0,0,0,0,0,0,0,0,0,0,0,0,0
20200520,06660P,大立光富邦9B售03,1.74,1.74,1.72,1.72,0.00,0.00,7000,2,12080,0,0,0,0,0,0,0,7000,-7000,-7000
20200520,06661P,玉晶光永豐98售05,0.83,0.84,0.75,0.75,-0.08,-9.64,216000,10,173580,0,0,0,0,0,0,67000,144000,-77000,-77000
20200520,06662P,玉晶光中信9A售01,0.40,0.41,0.38,0.39,-0.02,-4.88,878000,28,342590,0,0,0,0,0,0,293000,545000,-252000,-252000
20200520,06663P,鴻海兆豐98售03,,,,,0.00,0.00,0,0,0,0,0,0,0,0,0,0,0,0,0
20200520,06664P,聯發科兆豐98售02,,,,,0.00,0.00,0,0,0,0,0,0,0,0,0,0,0,0,0
20200520,06665P,欣興兆豐99售01,,,,,0.00,0.00,0,0,0,0,0,0,0,0,0,0,0,0,0
20200520,06666P,台積電日盛9A售02,,,,,0.00,0.00,0,0,0,0,0,0,0,0,0,0,0,0,0
20200520,06667P,鴻海凱基98售11,2.00,2.06,1.96,2.04,+0.03,1.49,155000,37,310850,0,0,0,0,0,0,30000,125000,-95000,-95000
20200520,06668P,祥碩凱基98售02,0.29,0.29,0.24,0.24,-0.07,-22.58,345000,37,87050,0,0,0,0,0,0,105000,230000,-125000,-125000
20200520,06669P,緯穎凱基98售05,0.24,0.27,0.23,0.27,+0.01,3.85,310000,13,76300,0,0,0,0,0,0,170000,140000,30000,30000
20200520,06670P,鴻海群益98售06,4.61,4.63,4.57,4.63,-0.01,-0.22,100000,6,460280,0,0,0,0,0,0,100000,0,100000,100000
20200520,06671P,台積電群益98售04,4.22,4.22,4.22,4.22,0.00,0.00,409000,4,1725980,0,0,0,0,0,0,409000,409000,0,0
20200520,06672P,聯發科群益98售05,,,,,0.00,0.00,0,0,0,0,0,0,0,0,0,0,0,0,0
20200520,06673P,大立光群益98售01,4.21,4.21,4.13,4.13,-0.02,-0.48,6000,2,25020,0,0,0,0,0,0,0,6000,-6000,-6000
20200520,06674P,祥碩群益98售02,0.61,0.61,0.40,0.42,-0.09,-17.65,601000,64,258810,0,0,0,0,0,0,95000,453000,-358000,-358000
20200520,06675P,國巨國票99售02,,,,,0.00,0.00,0,0,0,0,0,0,0,0,0,0,0,0,0
20200520,06676P,華新科國票98售03,4.63,4.63,4.63,4.63,0.00,0.00,26000,1,120380,0,0,0,0,0,0,0,26000,-26000,-26000
20200520,06677P,牧德國票98售02,4.18,4.18,3.56,3.56,-0.82,-18.72,119000,9,470180,0,0,0,0,0,0,80000,39000,41000,41000
20200520,06678P,大立光統一99售01,,,,,0.00,0.00,0,0,0,0,0,0,0,0,0,0,0,0,0
20200520,06679P,旺宏元大98售09,1.60,1.60,1.59,1.59,-0.04,-2.45,20000,3,31900,0,0,0,0,0,0,10000,20000,-10000,-10000
20200520,06680P,智邦元大98售06,,,,,0.00,0.00,0,0,0,0,0,0,0,0,0,0,0,0,0
20200520,06681P,致茂元大98售02,2.76,2.76,2.70,2.70,-0.10,-3.57,20000,2,54300,0,0,0,0,0,0,20000,0,20000,20000
20200520,06682P,玉晶光元大99售08,,,,,0.00,0.00,0,0,0,0,0,0,0,0,0,0,0,0,0
20200520,06683P,訊芯元大98售07,1.63,1.70,1.63,1.70,-0.06,-3.41,9000,5,15050,0,0,0,0,0,0,4000,5000,-1000,-1000
20200520,06684P,緯穎元大98售06,0.44,0.49,0.44,0.49,0.00,0.00,667000,5,314580,0,0,0,0,0,0,570000,97000,473000,473000
20200520,06685P,鴻海國泰9A售01,2.33,2.41,2.30,2.41,+0.04,1.69,133000,5,308970,0,0,0,0,0,0,107000,26000,81000,81000
20200520,06686P,麗豐永豐98售02,1.04,1.07,1.04,1.07,+0.03,2.88,195000,2,205050,0,0,0,0,0,0,0,195000,-195000,-195000
20200520,06687P,A50正2中信9A售01,,,,,0.00,0.00,0,0,0,0,0,0,0,0,0,0,0,0,0
20200520,06688P,鴻海中信02售01,,,,,0.00,0.00,0,0,0,0,0,0,0,0,0,0,0,0,0
20200520,06689P,鴻海中信9C售02,,,,,0.00,0.00,0,0,0,0,0,0,0,0,0,0,0,0,0
20200520,06690P,玉晶光群益9A售05,,,,,0.00,0.00,0,0,0,0,0,0,0,0,0,0,0,0,0
20200520,06691P,臺股指群益9C售05,,,,,0.00,0.00,0,0,0,0,0,0,0,0,0,0,0,0,0
20200520,06692P,瑞昱凱基98售03,0.54,0.54,0.54,0.54,-0.02,-3.57,5000,1,2700,0,0,0,0,0,0,0,5000,-5000,-5000
20200520,06693P,臺股指凱基98售01,,,,,0.00,0.00,0,0,0,0,0,0,0,0,0,0,0,0,0
20200520,06694P,臺股指凱基99售13,,,,,0.00,0.00,0,0,0,0,0,0,0,0,0,0,0,0,0
20200520,06695P,群創兆豐98售04,,,,,0.00,0.00,0,0,0,0,0,0,0,0,0,0,0,0,0
20200520,06696P,台灣50國票99售01,,,,,0.00,0.00,0,0,0,0,0,0,0,0,0,0,0,0,0
20200520,06697P,台積電國票99售05,,,,,0.00,0.00,0,0,0,0,0,0,0,0,0,0,0,0,0
20200520,06698P,玉晶光國票99售05,3.47,3.47,3.32,3.32,-0.18,-5.14,37000,4,128240,0,0,0,0,0,0,36000,1000,35000,35000
20200520,06699P,台積電統一98售11,,,,,0.00,0.00,0,0,0,0,0,0,0,0,0,0,0,0,0
20200520,06700P,臺股指統一99售05,,,,,0.00,0.00,0,0,0,0,0,0,0,0,0,0,0,0,0
20200520,06701P,臺股指統一99售06,2.57,2.70,2.57,2.67,0.00,0.00,231000,18,608700,0,0,0,0,0,0,62000,169000,-107000,-107000
20200520,06702P,智邦元富98售01,0.67,0.69,0.66,0.68,-0.03,-4.23,353000,12,241070,0,0,0,0,0,0,351000,2000,349000,349000
20200520,06703P,新日興元富98售02,,,,,0.00,0.00,0,0,0,0,0,0,0,0,0,0,0,0,0
20200520,06704P,玉晶光元富98售05,,,,,0.00,0.00,0,0,0,0,0,0,0,0,0,0,0,0,0
20200520,06705P,臻鼎元富98售03,3.22,3.22,2.93,2.93,-0.35,-10.67,125000,7,368640,0,0,0,0,0,0,8000,117000,-109000,-109000
20200520,06706P,智原台新98售02,1.12,1.13,1.08,1.09,-0.05,-4.39,354000,12,392630,0,0,0,0,0,0,113000,211000,-98000,-98000
20200520,06707P,臺股指台新99售04,,,,,0.00,0.00,0,0,0,0,0,0,0,0,0,0,0,0,0
20200520,06708P,臺股指台新99售05,,,,,0.00,0.00,0,0,0,0,0,0,0,0,0,0,0,0,0
20200520,06709P,臺股指台新99售06,,,,,0.00,0.00,0,0,0,0,0,0,0,0,0,0,0,0,0
20200520,06710P,臺股指台新99售07,,,,,0.00,0.00,0,0,0,0,0,0,0,0,0,0,0,0,0
20200520,06711P,臺股指台新99售08,,,,,0.00,0.00,0,0,0,0,0,0,0,0,0,0,0,0,0
20200520,06712P,臺股指台新99售09,10.80,10.80,10.80,10.80,-0.10,-0.92,20000,2,216000,0,0,0,0,0,0,0,20000,-20000,-20000
20200520,06713P,臺股指富邦99售04,3.92,3.96,3.92,3.94,-0.04,-1.01,14000,5,55130,0,0,0,0,0,0,2000,12000,-10000,-10000
20200520,06714P,台積電元大98售15,7.10,7.25,7.10,7.25,0.00,0.00,60000,2,431550,0,0,0,0,0,0,60000,0,60000,60000
20200520,06715P,台積電元大99售04,,,,,0.00,0.00,0,0,0,0,0,0,0,0,0,0,0,0,0
20200520,06716P,台積電元大9A售02,,,,,0.00,0.00,0,0,0,0,0,0,0,0,0,0,0,0,0
20200520,06717P,可成元大98售09,2.52,2.58,2.52,2.58,0.00,0.00,42000,2,106860,0,0,0,0,0,0,0,42000,-42000,-42000
20200520,06718P,聯詠元大98售01,2.60,2.78,2.60,2.78,+0.08,2.96,66000,2,180600,0,0,0,0,0,0,16000,50000,-34000,-34000
20200520,06719P,台灣50群益9A售01,,,,,0.00,0.00,0,0,0,0,0,0,0,0,0,0,0,0,0
20200520,06720P,智邦亞東99售01,0.45,0.45,0.45,0.45,+0.06,15.38,1000,1,450,0,0,0,0,0,0,0,0,0,0
20200520,06721P,臺股指中信9A售03,1.83,1.83,1.82,1.82,-0.04,-2.15,6000,3,10970,0,0,0,0,0,0,2000,3000,-1000,-1000
20200520,06722P,臺股指中信9A售04,,,,,0.00,0.00,0,0,0,0,0,0,0,0,0,0,0,0,0
20200520,06723P,台灣50麥證99售01,6.35,6.70,6.35,6.70,+0.25,3.88,40000,4,264500,0,40000,-40000,0,0,0,0,40000,-40000,-40000
20200520,06724P,台灣50國票98售01,10.60,10.60,10.60,10.60,0.00,0.00,2000,1,21200,0,0,0,0,0,0,0,2000,-2000,-2000
20200520,06725P,聯電元富98售01,1.51,1.60,1.50,1.58,+0.08,5.33,580000,17,893080,0,0,0,0,0,0,236000,344000,-108000,-108000
20200520,06726P,欣興元富98售04,3.26,3.35,3.17,3.35,-0.04,-1.18,142000,19,460680,0,0,0,0,0,0,139000,3000,136000,136000
20200520,06727P,台光電元大98售05,0.75,0.80,0.75,0.75,-0.03,-3.85,236000,5,185200,0,0,0,0,0,0,135000,101000,34000,34000
20200520,06728P,全新元大98售03,1.99,2.17,1.99,2.16,+0.14,6.93,527000,26,1102890,0,0,0,0,0,0,165000,271000,-106000,-106000
20200520,06729P,聯詠元大98售03,2.92,3.16,2.92,3.16,+0.06,1.94,300000,9,899340,0,0,0,0,0,0,184000,116000,68000,68000
20200520,06730P,祥碩元大98售07,1.19,1.19,1.05,1.05,-0.18,-14.63,50000,10,53780,0,0,0,0,0,0,22000,0,22000,22000
20200520,06731P,聯茂元大98售05,,,,,0.00,0.00,0,0,0,0,0,0,0,0,0,0,0,0,0
20200520,06732P,台灣50日盛9A售01,,,,,0.00,0.00,0,0,0,0,0,0,0,0,0,0,0,0,0
20200520,06733P,鴻海凱基99售02,,,,,0.00,0.00,0,0,0,0,0,0,0,0,0,0,0,0,0
20200520,06734P,智邦凱基98售05,0.85,0.87,0.85,0.86,-0.04,-4.44,290000,17,247710,0,0,0,0,0,0,288000,2000,286000,286000
20200520,06735P,奇力新凱基98售07,,,,,0.00,0.00,0,0,0,0,0,0,0,0,0,0,0,0,0
20200520,06736P,新日興凱基98售03,0.84,0.85,0.74,0.75,-0.08,-9.64,312000,38,240820,0,0,0,0,0,0,100000,212000,-112000,-112000
20200520,06737P,台郡凱基98售07,1.65,1.65,1.65,1.65,-0.01,-0.6,50000,1,82500,0,0,0,0,0,0,0,50000,-50000,-50000
20200520,06738P,瑞昱兆豐98售02,,,,,0.00,0.00,0,0,0,0,0,0,0,0,0,0,0,0,0
20200520,06739P,聯詠兆豐98售02,0.69,0.73,0.69,0.69,-0.01,-1.43,89000,12,63110,0,0,0,0,0,0,63000,26000,37000,37000
20200520,06740P,台灣50國泰9A售02,,,,,0.00,0.00,0,0,0,0,0,0,0,0,0,0,0,0,0
20200520,06741P,台積電富邦98售04,2.69,2.69,2.69,2.69,0.00,0.00,330000,1,887700,0,0,0,0,0,0,330000,330000,0,0
20200520,06742P,可成富邦99售02,2.17,2.27,2.14,2.27,+0.21,10.19,332000,8,746050,0,0,0,0,0,0,17000,315000,-298000,-298000
20200520,06743P,創意永豐98售03,1.15,1.15,1.09,1.09,-0.05,-4.39,134000,72,147200,2000,0,2000,0,0,0,112000,30000,82000,84000
20200520,06744P,嘉聯益永豐98售03,1.83,1.83,1.78,1.78,-0.08,-4.3,28000,8,50800,0,0,0,0,0,0,26000,2000,24000,24000
20200520,06745P,台積電群益98售05,,,,,0.00,0.00,0,0,0,0,0,0,0,0,0,0,0,0,0
20200520,06746P,聯發科群益99售02,4.12,4.12,3.94,3.94,-0.37,-8.58,24000,3,98260,0,0,0,0,0,0,22000,2000,20000,20000
20200520,06747P,大立光群益99售04,,,,,0.00,0.00,0,0,0,0,0,0,0,0,0,0,0,0,0
20200520,06748P,智邦台新98售02,0.45,0.46,0.43,0.44,-0.04,-8.33,309000,11,135760,0,0,0,0,0,0,64000,245000,-181000,-181000
20200520,06749P,技嘉元富98售03,,,,,0.00,0.00,0,0,0,0,0,0,0,0,0,0,0,0,0
20200520,06750P,聯發科元富02售03,1.94,1.94,1.85,1.91,-0.09,-4.5,220000,21,423140,0,0,0,0,0,0,47000,173000,-126000,-126000
20200520,06751P,旺宏凱基98售10,2.65,2.65,2.65,2.65,-0.01,-0.38,15000,1,39750,0,0,0,0,0,0,15000,0,15000,15000
20200520,06752P,訊芯凱基98售05,1.79,1.79,1.79,1.79,-0.21,-10.5,1000,1,1790,0,0,0,0,0,0,1000,0,1000,1000
20200520,06753P,智邦富邦98售03,,,,,0.00,0.00,0,0,0,0,0,0,0,0,0,0,0,0,0
20200520,06754P,台積電永豐98售03,,,,,0.00,0.00,0,0,0,0,0,0,0,0,0,0,0,0,0
20200520,06755P,大立光永豐98售03,,,,,0.00,0.00,0,0,0,0,0,0,0,0,0,0,0,0,0
20200520,06756P,臺股指永豐98售05,,,,,0.00,0.00,0,0,0,0,0,0,0,0,0,0,0,0,0
20200520,06757P,台灣50元大9B售01,2.32,2.33,2.32,2.33,-0.05,-2.1,4000,2,9310,0,0,0,0,0,0,0,4000,-4000,-4000
20200520,06758P,鴻海元大98售10,6.75,6.75,6.75,6.75,-0.05,-0.74,15000,2,101250,0,0,0,0,0,0,15000,0,15000,15000
20200520,06759P,台積電元大98售17,4.11,4.11,4.11,4.11,0.00,0.00,320000,3,1315200,0,0,0,0,0,0,320000,320000,0,0
20200520,06760P,台積電元大98售18,,,,,0.00,0.00,0,0,0,0,0,0,0,0,0,0,0,0,0
20200520,06761P,台積電元大99售05,3.24,3.24,3.24,3.24,0.00,0.00,5000,1,16200,0,0,0,0,0,0,0,5000,-5000,-5000
20200520,06762P,智邦元大98售11,,,,,0.00,0.00,0,0,0,0,0,0,0,0,0,0,0,0,0
20200520,06763P,技嘉元大98售05,1.62,1.71,1.61,1.66,-0.05,-2.92,83000,9,135390,0,0,0,0,0,0,63000,20000,43000,43000
20200520,06764P,聯發科元大98售11,0.58,0.58,0.58,0.58,-0.13,-18.31,1000,1,580,0,0,0,0,0,0,0,1000,-1000,-1000
20200520,06765P,欣興元大98售11,2.62,2.72,2.54,2.65,-0.08,-2.93,76000,19,199590,0,0,0,0,0,0,42000,34000,8000,8000
20200520,06766P,玉晶光元大99售10,1.72,1.72,1.67,1.67,-0.07,-4.02,97000,14,163690,0,0,0,0,0,0,29000,68000,-39000,-39000
20200520,06767P,台積電永昌99售03,3.22,3.22,3.22,3.22,-0.13,-3.88,5000,2,16100,0,0,0,0,0,0,0,4000,-4000,-4000
20200520,06768P,臺股指永昌98售02,,,,,0.00,0.00,0,0,0,0,0,0,0,0,0,0,0,0,0
20200520,06769P,臺股指永昌98售03,,,,,0.00,0.00,0,0,0,0,0,0,0,0,0,0,0,0,0
20200520,06770P,台灣50第一9C售01,,,,,0.00,0.00,0,0,0,0,0,0,0,0,0,0,0,0,0
20200520,06771P,台灣50中信02售01,3.57,3.58,3.57,3.58,-0.01,-0.28,13000,2,46510,0,0,0,0,0,0,10000,3000,7000,7000
20200520,06772P,國巨中信99售01,0.99,0.99,0.89,0.89,0.00,0.00,33000,4,29870,0,0,0,0,0,0,28000,5000,23000,23000
20200520,06773P,台灣50兆豐9A售01,1.87,1.87,1.87,1.87,0.00,0.00,10000,1,18700,0,0,0,0,0,0,0,10000,-10000,-10000
20200520,06774P,臺股指兆豐98售02,,,,,0.00,0.00,0,0,0,0,0,0,0,0,0,0,0,0,0
20200520,06775P,臺股指兆豐98售03,,,,,0.00,0.00,0,0,0,0,0,0,0,0,0,0,0,0,0
20200520,06776P,鴻海元大99售05,7.30,7.30,7.30,7.30,-0.05,-0.68,15000,2,109500,0,0,0,0,0,0,15000,0,15000,15000
20200520,06777P,鴻海元大99售06,8.25,8.25,8.20,8.20,-0.10,-1.2,95000,4,782250,0,0,0,0,0,0,5000,90000,-85000,-85000
20200520,06778P,台積電元大99售06,,,,,0.00,0.00,0,0,0,0,0,0,0,0,0,0,0,0,0
20200520,06779P,智邦元大98售12,,,,,0.00,0.00,0,0,0,0,0,0,0,0,0,0,0,0,0
20200520,06780P,義隆元大98售02,1.30,1.31,1.25,1.25,-0.07,-5.3,116000,7,150500,0,1000,-1000,0,0,0,114000,1000,113000,112000
20200520,06781P,大立光元大98售19,,,,,0.00,0.00,0,0,0,0,0,0,0,0,0,0,0,0,0
20200520,06782P,大立光元大99售07,2.94,3.07,2.94,3.07,0.00,0.00,43000,4,126780,0,0,0,0,0,0,40000,3000,37000,37000
20200520,06783P,亞光元大98售03,3.81,3.81,3.78,3.78,-0.10,-2.58,35000,2,133200,0,0,0,0,0,0,0,35000,-35000,-35000
20200520,06784P,臺股指元大98售01,,,,,0.00,0.00,0,0,0,0,0,0,0,0,0,0,0,0,0
20200520,06785P,臺股指元大98售02,,,,,0.00,0.00,0,0,0,0,0,0,0,0,0,0,0,0,0
20200520,06786P,臺股指元大98售03,,,,,0.00,0.00,0,0,0,0,0,0,0,0,0,0,0,0,0
20200520,06787P,臺股指元大98售04,,,,,0.00,0.00,0,0,0,0,0,0,0,0,0,0,0,0,0
20200520,06788P,臺股指元大98售05,,,,,0.00,0.00,0,0,0,0,0,0,0,0,0,0,0,0,0
20200520,06789P,鴻海凱基98售12,4.23,4.34,4.18,4.34,+0.07,1.64,107000,10,450830,0,0,0,0,0,0,100000,7000,93000,93000
20200520,06790P,台積電凱基9A售04,0.81,0.89,0.81,0.84,-0.07,-7.69,141000,68,120840,0,0,0,0,0,0,131000,141000,-10000,-10000
20200520,06791P,聯發科凱基98售16,,,,,0.00,0.00,0,0,0,0,0,0,0,0,0,0,0,0,0
20200520,06792P,臺股指凱基98售02,,,,,0.00,0.00,0,0,0,0,0,0,0,0,0,0,0,0,0
20200520,06793P,臺股指凱基98售03,,,,,0.00,0.00,0,0,0,0,0,0,0,0,0,0,0,0,0
20200520,06794P,臺股指凱基98售04,7.35,7.35,7.30,7.30,-0.10,-1.35,2000,2,14650,0,0,0,0,0,0,0,2000,-2000,-2000
20200520,06795P,臺股指凱基98售05,,,,,0.00,0.00,0,0,0,0,0,0,0,0,0,0,0,0,0
20200520,06796P,臺股指凱基98售06,,,,,0.00,0.00,0,0,0,0,0,0,0,0,0,0,0,0,0
20200520,06797P,臺股指凱基98售07,,,,,0.00,0.00,0,0,0,0,0,0,0,0,0,0,0,0,0
20200520,06798P,臺股指凱基98售08,,,,,0.00,0.00,0,0,0,0,0,0,0,0,0,0,0,0,0
20200520,06799P,臺股指凱基98售09,,,,,0.00,0.00,0,0,0,0,0,0,0,0,0,0,0,0,0
20200520,06800P,台灣50群益9A售02,3.63,3.63,3.63,3.63,0.00,0.00,1000,1,3630,0,0,0,0,0,0,1000,0,1000,1000
20200520,06801P,技嘉群益99售02,1.01,1.06,0.98,1.04,+0.02,1.96,124000,19,127150,0,0,0,0,0,0,37000,87000,-50000,-50000
20200520,06802P,緯穎群益98售03,,,,,0.00,0.00,0,0,0,0,0,0,0,0,0,0,0,0,0
20200520,06803P,臺股指群益98售09,10.10,10.10,10.10,10.10,-0.30,-2.88,1000,1,10100,0,0,0,0,0,0,1000,0,1000,1000
20200520,06804P,臺股指群益98售10,,,,,0.00,0.00,0,0,0,0,0,0,0,0,0,0,0,0,0
20200520,06805P,臺股指群益98售11,,,,,0.00,0.00,0,0,0,0,0,0,0,0,0,0,0,0,0
20200520,06806P,臺股指群益98售12,9.45,9.60,9.45,9.60,-0.05,-0.52,10000,2,95250,0,0,0,0,0,0,5000,5000,0,0
20200520,06807P,臺股指群益98售13,,,,,0.00,0.00,0,0,0,0,0,0,0,0,0,0,0,0,0
20200520,06808P,電子類群益98售02,,,,,0.00,0.00,0,0,0,0,0,0,0,0,0,0,0,0,0
20200520,06809P,電子類群益98售03,11.20,11.20,11.20,11.20,-0.10,-0.88,7000,2,78400,0,0,0,0,0,0,0,7000,-7000,-7000
20200520,06810P,國巨統一99售03,2.11,2.11,2.11,2.11,0.00,0.00,1000,1,2110,0,0,0,0,0,0,0,1000,-1000,-1000
20200520,06811P,聯發科統一98售06,0.57,0.64,0.57,0.62,0.00,0.00,24000,3,14580,0,0,0,0,0,0,10000,24000,-14000,-14000
20200520,06812P,台灣50元富9C售01,,,,,0.00,0.00,0,0,0,0,0,0,0,0,0,0,0,0,0
20200520,06813P,友訊元富98售03,1.98,2.00,1.98,2.00,+0.01,0.5,15000,2,29800,0,0,0,0,0,0,15000,0,15000,15000
20200520,06814P,臺股指元富98售03,,,,,0.00,0.00,0,0,0,0,0,0,0,0,0,0,0,0,0
20200520,06815P,臺股指元富98售04,,,,,0.00,0.00,0,0,0,0,0,0,0,0,0,0,0,0,0
20200520,06816P,臺股指元富98售05,,,,,0.00,0.00,0,0,0,0,0,0,0,0,0,0,0,0,0
20200520,06817P,臺股指元富98售06,,,,,0.00,0.00,0,0,0,0,0,0,0,0,0,0,0,0,0
20200520,06818P,臺股指元富98售07,,,,,0.00,0.00,0,0,0,0,0,0,0,0,0,0,0,0,0
20200520,06819P,臺股指元富98售08,,,,,0.00,0.00,0,0,0,0,0,0,0,0,0,0,0,0,0
20200520,06820P,臺股指元富98售09,,,,,0.00,0.00,0,0,0,0,0,0,0,0,0,0,0,0,0
20200520,06821P,臺股指元富98售10,,,,,0.00,0.00,0,0,0,0,0,0,0,0,0,0,0,0,0
20200520,06822P,上銀富邦99售03,1.58,1.67,1.58,1.66,+0.03,1.84,77000,5,126640,0,0,0,0,0,0,1000,76000,-75000,-75000
20200520,06823P,台灣50永豐98售02,,,,,0.00,0.00,0,0,0,0,0,0,0,0,0,0,0,0,0
20200520,06824P,台灣50國票99售02,,,,,0.00,0.00,0,0,0,0,0,0,0,0,0,0,0,0,0
20200520,06825P,臺股指國票98售01,11.60,11.80,11.60,11.80,-0.30,-2.48,3000,2,35200,0,0,0,0,0,0,0,3000,-3000,-3000
20200520,06826P,臺股指國票98售02,,,,,0.00,0.00,0,0,0,0,0,0,0,0,0,0,0,0,0
20200520,06827P,臺股指國票98售03,,,,,0.00,0.00,0,0,0,0,0,0,0,0,0,0,0,0,0
20200520,06828P,臺股指國票98售04,,,,,0.00,0.00,0,0,0,0,0,0,0,0,0,0,0,0,0
20200520,06829P,臺股指國票98售05,,,,,0.00,0.00,0,0,0,0,0,0,0,0,0,0,0,0,0
20200520,06830P,臺股指國票98售06,,,,,0.00,0.00,0,0,0,0,0,0,0,0,0,0,0,0,0
20200520,06831P,臺股指國票98售07,,,,,0.00,0.00,0,0,0,0,0,0,0,0,0,0,0,0,0
20200520,06832P,玉晶光凱基98售03,0.95,0.95,0.91,0.91,-0.06,-6.19,93000,10,86890,0,0,0,0,0,0,40000,73000,-33000,-33000
20200520,06833P,矽力群益99售01,0.45,0.54,0.44,0.45,0.00,0.00,444000,58,202050,0,0,0,0,0,0,0,275000,-275000,-275000
20200520,06834P,訊芯群益99售02,,,,,0.00,0.00,0,0,0,0,0,0,0,0,0,0,0,0,0
20200520,06835P,台灣50國票9A售01,,,,,0.00,0.00,0,0,0,0,0,0,0,0,0,0,0,0,0
20200520,06836P,玉晶光國票99售06,2.10,2.11,1.98,1.98,-0.12,-5.71,500000,23,1034710,0,0,0,0,0,0,23000,477000,-454000,-454000
20200520,06837P,上銀統一9A售02,,,,,0.00,0.00,0,0,0,0,0,0,0,0,0,0,0,0,0
20200520,06838P,台積電統一99售05,,,,,0.00,0.00,0,0,0,0,0,0,0,0,0,0,0,0,0
20200520,06839P,玉晶光統一9A售05,1.30,1.30,1.23,1.25,-0.11,-8.09,131000,8,164480,0,0,0,0,0,0,66000,65000,1000,1000
20200520,06840P,臺股指統一98售04,,,,,0.00,0.00,0,0,0,0,0,0,0,0,0,0,0,0,0
20200520,06841P,臺股指統一9A售02,,,,,0.00,0.00,0,0,0,0,0,0,0,0,0,0,0,0,0
20200520,06842P,臺股指統一9A售03,,,,,0.00,0.00,0,0,0,0,0,0,0,0,0,0,0,0,0
20200520,06843P,鴻海元大98售11,3.97,4.01,3.97,4.01,+0.02,0.5,45000,4,178850,0,0,0,0,0,0,45000,0,45000,45000
20200520,06844P,智邦元大98售13,,,,,0.00,0.00,0,0,0,0,0,0,0,0,0,0,0,0,0
20200520,06845P,億光元大98售02,1.96,1.98,1.86,1.86,-0.17,-8.37,107000,11,206640,0,0,0,0,0,0,27000,80000,-53000,-53000
20200520,06846P,美律元大98售05,2.92,2.92,2.92,2.92,+0.04,1.39,50000,2,146000,0,0,0,0,0,0,12000,50000,-38000,-38000
20200520,06847P,奇力新元大98售05,1.88,1.96,1.88,1.96,-0.07,-3.45,47000,4,91460,0,0,0,0,0,0,2000,45000,-43000,-43000
20200520,06848P,聯詠元大98售04,2.29,2.44,2.29,2.42,+0.07,2.98,83000,4,198820,0,0,0,0,0,0,33000,50000,-17000,-17000
20200520,06849P,欣興元大98售12,2.53,2.53,2.37,2.49,-0.08,-3.11,25000,6,60130,0,0,0,0,0,0,21000,4000,17000,17000
20200520,06850P,聯茂元大98售06,,,,,0.00,0.00,0,0,0,0,0,0,0,0,0,0,0,0,0
20200520,06851P,鈺齊元大98售01,2.40,2.41,2.39,2.40,-0.07,-2.83,260000,8,624500,0,0,0,0,0,0,10000,250000,-240000,-240000
20200520,06852P,臺股指元大98售11,0.55,0.56,0.52,0.55,-0.02,-3.51,756000,46,414910,0,0,0,0,0,0,268000,485000,-217000,-217000
20200520,06853P,華擎元富98售03,1.34,1.36,1.16,1.16,-0.29,-20.0,227000,31,288850,0,0,0,0,0,0,121000,90000,31000,31000
20200520,06854P,鴻海富邦99售05,,,,,0.00,0.00,0,0,0,0,0,0,0,0,0,0,0,0,0
20200520,06855P,聯發科富邦9A售01,,,,,0.00,0.00,0,0,0,0,0,0,0,0,0,0,0,0,0
20200520,06856P,台灣50永豐99售03,,,,,0.00,0.00,0,0,0,0,0,0,0,0,0,0,0,0,0
20200520,06857P,超眾永豐98售02,0.60,0.61,0.56,0.60,+0.01,1.69,113000,7,65400,0,0,0,0,0,0,93000,20000,73000,73000
20200520,06858P,道瓊指中信9B售01,,,,,0.00,0.00,0,0,0,0,0,0,0,0,0,0,0,0,0
20200520,06859P,元金2X中信9C售01,1.37,1.37,1.37,1.37,-0.03,-2.14,1000,1,1370,0,0,0,0,0,0,0,1000,-1000,-1000
20200520,06860P,台灣50兆豐98售01,,,,,0.00,0.00,0,0,0,0,0,0,0,0,0,0,0,0,0
20200520,06861P,台積電國票99售08,,,,,0.00,0.00,0,0,0,0,0,0,0,0,0,0,0,0,0
20200520,06862P,大立光凱基98售16,,,,,0.00,0.00,0,0,0,0,0,0,0,0,0,0,0,0,0
20200520,06863P,欣興凱基98售05,1.34,1.44,1.34,1.42,-0.02,-1.39,190000,24,266580,0,0,0,0,0,0,27000,170000,-143000,-143000
20200520,06864P,健策凱基98售01,1.58,1.64,1.53,1.53,-0.09,-5.56,590000,18,932020,0,0,0,0,0,0,242000,403000,-161000,-161000
20200520,06865P,亞德客元大98售04,3.25,3.25,3.25,3.25,0.00,0.00,28000,2,91000,0,0,0,0,0,0,0,28000,-28000,-28000
20200520,06866P,聯發科元大98售13,0.31,0.35,0.30,0.35,-0.06,-14.63,18000,3,5950,0,0,0,0,0,0,0,18000,-18000,-18000
20200520,06867P,訊芯元大98售08,,,,,0.00,0.00,0,0,0,0,0,0,0,0,0,0,0,0,0
20200520,06868P,電子類元大99售01,,,,,0.00,0.00,0,0,0,0,0,0,0,0,0,0,0,0,0
20200520,06869P,金融類元大99售01,1.49,1.49,1.42,1.42,0.00,0.00,2000,2,2910,0,0,0,0,0,0,1000,1000,0,0
20200520,06870P,台灣50群益9A售03,,,,,0.00,0.00,0,0,0,0,0,0,0,0,0,0,0,0,0
20200520,06871P,元油2X群益98售04,,,,,0.00,0.00,0,0,0,0,0,0,0,0,0,0,0,0,0
20200520,06872P,亞德客元富98售04,,,,,0.00,0.00,0,0,0,0,0,0,0,0,0,0,0,0,0
20200520,06873P,嘉晶元富98售02,,,,,0.00,0.00,0,0,0,0,0,0,0,0,0,0,0,0,0
20200520,06874P,台積電台新98售02,1.77,2.00,1.77,1.90,+0.04,2.15,612000,62,1147500,0,0,0,0,0,0,612000,610000,2000,2000
20200520,06875P,台灣50永昌9A售02,,,,,0.00,0.00,0,0,0,0,0,0,0,0,0,0,0,0,0
20200520,06876P,台灣50兆豐9B售01,,,,,0.00,0.00,0,0,0,0,0,0,0,0,0,0,0,0,0
20200520,06877P,台積電兆豐98售04,,,,,0.00,0.00,0,0,0,0,0,0,0,0,0,0,0,0,0
20200520,06878P,台灣50日盛9B售01,,,,,0.00,0.00,0,0,0,0,0,0,0,0,0,0,0,0,0
20200520,06879P,長榮航凱基98售02,1.02,1.02,1.02,1.02,0.00,0.00,20000,4,20400,0,0,0,0,0,0,10000,0,10000,10000
20200520,06880P,鈺齊凱基98售03,1.78,1.78,1.78,1.78,-0.05,-2.73,2000,1,3560,0,0,0,0,0,0,2000,0,2000,2000
20200520,06881P,國巨群益98售10,,,,,0.00,0.00,0,0,0,0,0,0,0,0,0,0,0,0,0
20200520,06882P,聯發科群益98售07,2.10,2.10,1.93,2.00,-0.21,-9.5,213000,4,421700,0,0,0,0,0,0,7000,206000,-199000,-199000
20200520,06883P,聯茂群益98售03,1.51,1.55,1.51,1.55,+0.06,4.03,22000,2,34020,0,0,0,0,0,0,0,22000,-22000,-22000
20200520,06884P,台郡群益98售03,2.73,2.76,2.73,2.73,-0.01,-0.36,220000,3,603600,0,0,0,0,0,0,0,220000,-220000,-220000
20200520,06885P,國巨國票99售06,9.95,9.95,9.60,9.80,-1.00,-9.26,338000,9,3345450,0,0,0,0,0,0,10000,328000,-318000,-318000
20200520,06886P,旺宏元大99售07,4.55,4.65,4.55,4.65,-0.06,-1.27,91000,4,420490,0,0,0,0,0,0,26000,65000,-39000,-39000
20200520,06887P,華新科元大98售04,,,,,0.00,0.00,0,0,0,0,0,0,0,0,0,0,0,0,0
20200520,06888P,日月光元大98售02,6.35,6.55,6.25,6.45,+0.05,0.78,133000,7,856500,0,0,0,0,0,0,33000,100000,-67000,-67000
20200520,06889P,臺股指元大98售13,0.90,0.91,0.89,0.89,-0.03,-3.26,114000,4,101740,0,0,0,0,0,0,104000,10000,94000,94000
20200520,06890P,金融類元大98售02,0.55,0.55,0.55,0.55,-0.01,-1.79,30000,1,16500,0,0,0,0,0,0,30000,0,30000,30000
20200520,06891P,緯穎富邦99售03,0.25,0.27,0.24,0.27,+0.01,3.85,102000,12,25610,0,0,0,0,0,0,1000,101000,-100000,-100000
20200520,06892P,聯鈞元富98售01,,,,,0.00,0.00,0,0,0,0,0,0,0,0,0,0,0,0,0
20200520,06893P,致新元富98售02,0.95,0.96,0.95,0.96,-0.12,-11.11,10000,2,9550,0,0,0,0,0,0,0,10000,-10000,-10000
20200520,06894P,鈺齊元富98售03,,,,,0.00,0.00,0,0,0,0,0,0,0,0,0,0,0,0,0
20200520,06895P,台灣50統一9A售01,,,,,0.00,0.00,0,0,0,0,0,0,0,0,0,0,0,0,0
20200520,06896P,信邦中信98售01,0.49,0.49,0.49,0.49,-0.04,-7.55,28000,1,13720,0,0,0,0,0,0,28000,0,28000,28000
20200520,06897P,FBVIX群益01售01,,,,,0.00,0.00,0,0,0,0,0,0,0,0,0,0,0,0,0
20200520,06898P,FBVIX群益9C售03,0.96,0.96,0.96,0.96,0.00,0.00,250000,1,240000,0,0,0,0,0,0,250000,250000,0,0
20200520,06899P,嘉澤群益98售01,0.31,0.34,0.31,0.32,-0.02,-5.88,228000,14,75710,0,0,0,0,0,0,93000,135000,-42000,-42000
20200520,06900P,FBVIX國票12售01,0.45,0.45,0.45,0.45,-0.01,-2.17,10000,1,4500,0,0,0,0,0,0,10000,0,10000,10000
20200520,06901P,亞德客凱基98售02,0.58,0.61,0.58,0.60,0.00,0.00,279000,6,165290,0,0,0,0,0,0,147000,130000,17000,17000
20200520,06902P,聯電凱基98售02,1.16,1.18,1.16,1.16,0.00,0.00,160000,4,186400,0,0,0,0,0,0,0,160000,-160000,-160000
20200520,06903P,技嘉凱基98售04,0.73,0.75,0.73,0.75,+0.03,4.17,14000,3,10310,0,0,0,0,0,0,2000,12000,-10000,-10000
20200520,06904P,TPK凱基98售03,1.66,1.66,1.66,1.66,-0.07,-4.05,1000,1,1660,0,0,0,0,0,0,1000,0,1000,1000
20200520,06905P,上証2X國泰99售02,,,,,0.00,0.00,0,0,0,0,0,0,0,0,0,0,0,0,0
20200520,06906P,國巨國泰99售01,,,,,0.00,0.00,0,0,0,0,0,0,0,0,0,0,0,0,0
20200520,06907P,華新科國泰99售05,,,,,0.00,0.00,0,0,0,0,0,0,0,0,0,0,0,0,0
20200520,06908P,健策國泰99售02,1.54,1.54,1.37,1.43,-0.08,-5.3,58000,6,83620,0,0,0,0,0,0,36000,22000,14000,14000
20200520,06909P,元油2X元大98售22,,,,,0.00,0.00,0,0,0,0,0,0,0,0,0,0,0,0,0
20200520,06910P,元油2X元大98售23,,,,,0.00,0.00,0,0,0,0,0,0,0,0,0,0,0,0,0
20200520,06911P,鴻海元大99售09,4.31,4.36,4.27,4.36,+0.01,0.23,125000,8,542490,0,0,0,0,0,0,124000,100000,24000,24000
20200520,06912P,台光電元大99售02,1.61,1.61,1.58,1.60,+0.10,6.67,207000,5,332410,0,0,0,0,0,0,32000,175000,-143000,-143000
20200520,06913P,聯發科元大98售14,0.35,0.35,0.29,0.34,-0.06,-15.0,40000,5,12800,0,0,0,0,0,0,0,40000,-40000,-40000
20200520,06914P,南茂元大98售03,1.70,1.70,1.64,1.64,-0.15,-8.38,113000,4,191550,0,0,0,0,0,0,100000,13000,87000,87000
20200520,06915P,晶技元富98售02,0.35,0.35,0.35,0.35,0.00,0.00,10000,1,3500,0,0,0,0,0,0,0,0,0,0
20200520,06916P,聯鈞元富98售02,,,,,0.00,0.00,0,0,0,0,0,0,0,0,0,0,0,0,0
20200520,06917P,聯電亞東99售01,,,,,0.00,0.00,0,0,0,0,0,0,0,0,0,0,0,0,0
20200520,06918P,嘉聯益亞東99售01,,,,,0.00,0.00,0,0,0,0,0,0,0,0,0,0,0,0,0
20200520,06919P,臺股指日盛98售02,6.70,6.70,6.70,6.70,0.00,0.00,10000,1,67000,0,0,0,0,0,0,10000,10000,0,0
20200520,06920P,台灣50凱基9A售01,,,,,0.00,0.00,0,0,0,0,0,0,0,0,0,0,0,0,0
20200520,06921P,台光電凱基98售06,1.65,1.65,1.64,1.65,+0.01,0.61,3000,3,4940,0,0,0,0,0,0,3000,0,3000,3000
20200520,06922P,元上證群益9C售01,,,,,0.00,0.00,0,0,0,0,0,0,0,0,0,0,0,0,0
20200520,06923P,鴻海群益98售09,6.70,6.70,6.65,6.65,-0.15,-2.21,41000,5,273650,0,0,0,0,0,0,41000,0,41000,41000
20200520,06924P,台積電群益98售07,3.00,3.00,3.00,3.00,0.00,0.00,495000,1,1485000,0,0,0,0,0,0,495000,495000,0,0
20200520,06925P,致茂群益9A售02,2.35,2.35,2.32,2.32,-0.18,-7.2,10000,2,23350,0,0,0,0,0,0,5000,5000,0,0
20200520,06926P,可成群益9A售04,5.50,5.65,5.50,5.65,+0.65,13.0,106000,3,588450,0,0,0,0,0,0,0,106000,-106000,-106000
20200520,06927P,台灣50元大9B售03,,,,,0.00,0.00,0,0,0,0,0,0,0,0,0,0,0,0,0
20200520,06928P,鴻海元大99售10,3.96,3.96,3.93,3.93,-0.05,-1.26,50000,3,197700,0,0,0,0,0,0,50000,10000,40000,40000
20200520,06929P,鴻海元大99售11,,,,,0.00,0.00,0,0,0,0,0,0,0,0,0,0,0,0,0
20200520,06930P,台積電元大98售19,,,,,0.00,0.00,0,0,0,0,0,0,0,0,0,0,0,0,0
20200520,06931P,大立光元大98售20,,,,,0.00,0.00,0,0,0,0,0,0,0,0,0,0,0,0,0
20200520,06932P,大立光元大98售21,,,,,0.00,0.00,0,0,0,0,0,0,0,0,0,0,0,0,0
20200520,06933P,禾伸堂元大98售03,1.16,1.22,1.13,1.22,0.00,0.00,405000,18,479680,0,0,0,0,0,0,151000,254000,-103000,-103000
20200520,06934P,聯鈞元大98售03,2.40,2.50,2.39,2.49,+0.09,3.75,200000,19,492900,0,0,0,0,0,0,131000,69000,62000,62000
20200520,06935P,神達元大98售02,,,,,0.00,0.00,0,0,0,0,0,0,0,0,0,0,0,0,0
20200520,06936P,瑞儀元大98售01,2.89,2.90,2.77,2.77,-0.15,-5.14,89000,8,253950,0,0,0,0,0,0,79000,9000,70000,70000
20200520,06937P,GIS元大98售03,2.22,2.24,2.22,2.22,-0.04,-1.77,158000,9,353290,0,0,0,0,0,0,44000,114000,-70000,-70000
20200520,06938P,南電元大98售03,3.07,3.09,2.87,3.09,-0.02,-0.64,72000,4,210510,0,0,0,0,0,0,70000,1000,69000,69000
20200520,06939P,國巨永豐98售09,2.46,2.46,2.46,2.46,-0.22,-8.21,15000,2,36900,0,0,0,0,0,0,9000,6000,3000,3000
20200520,06940P,旺宏永豐98售05,2.00,2.00,2.00,2.00,-0.02,-0.99,75000,1,150000,0,0,0,0,0,0,0,75000,-75000,-75000
20200520,06941P,國巨統一98售07,,,,,0.00,0.00,0,0,0,0,0,0,0,0,0,0,0,0,0
20200520,06942P,台灣50台新02售01,,,,,0.00,0.00,0,0,0,0,0,0,0,0,0,0,0,0,0
20200520,06943P,致茂元富98售03,,,,,0.00,0.00,0,0,0,0,0,0,0,0,0,0,0,0,0
20200520,06944P,健鼎元富98售02,3.00,3.02,3.00,3.02,0.00,0.00,8000,2,24100,0,0,0,0,0,0,0,8000,-8000,-8000
20200520,06945P,國巨群益99售04,,,,,0.00,0.00,0,0,0,0,0,0,0,0,0,0,0,0,0
20200520,06946P,T50正2元大9C售01,4.34,4.39,4.28,4.33,-0.03,-0.69,74000,8,321620,0,0,0,0,0,0,0,74000,-74000,-74000
20200520,06947P,FBVIX元大01售01,,,,,0.00,0.00,0,0,0,0,0,0,0,0,0,0,0,0,0
20200520,06948P,FBVIX元大01售02,,,,,0.00,0.00,0,0,0,0,0,0,0,0,0,0,0,0,0
20200520,06949P,台表科元大99售01,1.59,1.69,1.44,1.44,-0.19,-11.66,59000,5,97310,0,0,0,0,0,0,27000,32000,-5000,-5000
20200520,06950P,鴻海統一9B售02,2.40,2.40,2.40,2.40,0.00,0.00,33000,1,79200,0,0,0,0,0,0,0,33000,-33000,-33000
20200520,06951P,台積電統一9B售02,,,,,0.00,0.00,0,0,0,0,0,0,0,0,0,0,0,0,0
20200520,06952P,大立光統一9A售03,,,,,0.00,0.00,0,0,0,0,0,0,0,0,0,0,0,0,0
20200520,06953P,景碩統一9A售01,0.85,0.85,0.85,0.85,-0.01,-1.16,5000,1,4250,0,0,0,0,0,0,0,0,0,0
20200520,06954P,大立光元富99售01,4.45,4.45,4.26,4.37,-0.09,-2.02,128000,11,560000,0,0,0,0,0,0,90000,38000,52000,52000
20200520,06955P,臻鼎元富99售01,1.68,1.68,1.56,1.56,-0.19,-10.86,25000,4,41000,0,0,0,0,0,0,0,25000,-25000,-25000
20200520,06956P,國巨日盛99售04,,,,,0.00,0.00,0,0,0,0,0,0,0,0,0,0,0,0,0
20200520,06957P,FBVIX凱基01售01,,,,,0.00,0.00,0,0,0,0,0,0,0,0,0,0,0,0,0
20200520,06958P,FBVIX凱基9C售02,,,,,0.00,0.00,0,0,0,0,0,0,0,0,0,0,0,0,0
20200520,06959P,鴻海凱基9A售02,2.75,2.79,2.74,2.79,+0.02,0.72,97000,9,267000,0,0,0,0,0,0,77000,20000,57000,57000
20200520,06960P,國巨凱基99售08,2.55,2.64,2.55,2.64,0.00,0.00,13000,2,33870,0,0,0,0,0,0,0,13000,-13000,-13000
20200520,06961P,台積電凱基99售05,1.63,1.63,1.63,1.63,0.00,0.00,70000,1,114100,0,0,0,0,0,0,70000,70000,0,0
20200520,06962P,華新科永豐99售01,1.13,1.17,1.13,1.16,+0.04,3.57,72000,6,81740,0,0,0,0,0,0,0,72000,-72000,-72000
20200520,06963P,鴻海凱基99售04,,,,,0.00,0.00,0,0,0,0,0,0,0,0,0,0,0,0,0
20200520,06964P,臺股指凱基9B售01,,,,,0.00,0.00,0,0,0,0,0,0,0,0,0,0,0,0,0
20200520,06965P,台積電台新99售02,1.19,1.32,1.19,1.27,-0.01,-0.78,615000,62,794750,0,0,0,0,0,0,540000,615000,-75000,-75000
20200520,06966P,健策台新9A售02,,,,,0.00,0.00,0,0,0,0,0,0,0,0,0,0,0,0,0
20200520,06967P,台郡台新99售02,1.03,1.07,1.03,1.07,+0.05,4.9,13000,2,13510,0,0,0,0,0,0,10000,3000,7000,7000
20200520,06968P,元油2X元大99售08,,,,,0.00,0.00,0,0,0,0,0,0,0,0,0,0,0,0,0
20200520,06969P,上銀元大99售02,,,,,0.00,0.00,0,0,0,0,0,0,0,0,0,0,0,0,0
20200520,06970P,旺宏元大99售08,,,,,0.00,0.00,0,0,0,0,0,0,0,0,0,0,0,0,0
20200520,06971P,台光電元大99售03,0.84,0.84,0.82,0.82,+0.01,1.23,153000,3,127460,0,0,0,0,0,0,53000,100000,-47000,-47000
20200520,06972P,聯發科元大99售04,2.63,2.89,2.63,2.89,-0.11,-3.67,17000,2,48870,0,0,0,0,0,0,0,17000,-17000,-17000
20200520,06973P,臺股指元大9A售11,,,,,0.00,0.00,0,0,0,0,0,0,0,0,0,0,0,0,0
20200520,06974P,臺股指元大9A售12,,,,,0.00,0.00,0,0,0,0,0,0,0,0,0,0,0,0,0
20200520,06975P,臺股指元大9A售13,,,,,0.00,0.00,0,0,0,0,0,0,0,0,0,0,0,0,0
20200520,06976P,臺股指元大9A售14,,,,,0.00,0.00,0,0,0,0,0,0,0,0,0,0,0,0,0
20200520,06977P,臺股指元大9A售15,,,,,0.00,0.00,0,0,0,0,0,0,0,0,0,0,0,0,0
20200520,06978P,聯發科富邦9B售02,,,,,0.00,0.00,0,0,0,0,0,0,0,0,0,0,0,0,0
20200520,06979P,台灣50永豐9A售02,,,,,0.00,0.00,0,0,0,0,0,0,0,0,0,0,0,0,0
20200520,06980P,緯穎永豐99售02,0.52,0.59,0.52,0.59,+0.01,1.72,110000,2,64200,0,0,0,0,0,0,100000,10000,90000,90000
20200520,06981P,台灣50麥證99售02,2.59,2.60,2.59,2.60,0.00,0.00,8000,2,20770,3000,5000,-2000,0,0,0,3000,5000,-2000,-2000
20200520,06982P,義隆凱基99售02,0.88,0.88,0.59,0.61,-0.01,-1.61,756000,18,456890,0,0,0,0,0,0,504000,188000,316000,316000
20200520,06983P,台積電國泰9A售02,2.51,2.62,2.51,2.58,-0.02,-0.77,48000,7,123600,0,0,0,0,0,0,6000,42000,-36000,-36000
20200520,06984P,上銀富邦9B售01,1.95,2.02,1.95,2.01,+0.03,1.52,71000,5,139640,0,0,0,0,0,0,61000,10000,51000,51000
20200520,06985P,華新科富邦9C售02,,,,,0.00,0.00,0,0,0,0,0,0,0,0,0,0,0,0,0
20200520,06986P,台積電台新9A售01,1.27,2.04,1.27,1.34,-0.02,-1.47,640000,64,880000,0,0,0,0,0,0,540000,640000,-100000,-100000
20200520,06987P,鴻海元富99售08,,,,,0.00,0.00,0,0,0,0,0,0,0,0,0,0,0,0,0
20200520,06988P,鴻海元富99售09,6.80,6.90,6.80,6.90,0.00,0.00,6000,2,41100,0,0,0,0,0,0,3000,3000,0,0
20200520,06989P,鴻海元富99售10,,,,,0.00,0.00,0,0,0,0,0,0,0,0,0,0,0,0,0
20200520,06990P,康友元富99售03,,,,,0.00,0.00,0,0,0,0,0,0,0,0,0,0,0,0,0
20200520,06991P,矽創群益99售01,1.12,1.25,1.11,1.24,+0.08,6.9,439000,19,520510,0,0,0,0,0,0,115000,324000,-209000,-209000
20200520,06992P,玉晶光日盛9B售01,,,,,0.00,0.00,0,0,0,0,0,0,0,0,0,0,0,0,0
20200520,06993P,鴻海凱基99售05,2.03,2.10,2.00,2.09,0.00,0.00,334000,16,678660,0,0,0,0,0,0,304000,30000,274000,274000
20200520,06994P,台光電凱基99售02,1.14,1.14,1.14,1.14,+0.01,0.88,10000,1,11400,0,0,0,0,0,0,10000,0,10000,10000
20200520,06995P,臺股指凱基99售16,1.49,1.49,1.47,1.47,0.00,0.00,201000,21,299470,0,0,0,0,0,0,0,201000,-201000,-201000
20200520,06996P,臺股指凱基99售17,,,,,0.00,0.00,0,0,0,0,0,0,0,0,0,0,0,0,0
20200520,06997P,台灣50中信03售01,,,,,0.00,0.00,0,0,0,0,0,0,0,0,0,0,0,0,0
20200520,06998P,S&P正2中信9B售01,,,,,0.00,0.00,0,0,0,0,0,0,0,0,0,0,0,0,0
20200520,06999P,玉晶光國票9B售01,3.88,3.88,3.76,3.76,-0.27,-6.7,6000,3,22900,0,0,0,0,0,0,2000,4000,-2000,-2000
20200520,07000P,T50反1元大99售03,,,,,0.00,0.00,0,0,0,0,0,0,0,0,0,0,0,0,0
20200520,07001P,國巨元大99售12,,,,,0.00,0.00,0,0,0,0,0,0,0,0,0,0,0,0,0
20200520,07002P,鴻海兆豐99售04,,,,,0.00,0.00,0,0,0,0,0,0,0,0,0,0,0,0,0
20200520,07003P,聯發科兆豐99售02,,,,,0.00,0.00,0,0,0,0,0,0,0,0,0,0,0,0,0
20200520,07004P,大立光兆豐9A售01,,,,,0.00,0.00,0,0,0,0,0,0,0,0,0,0,0,0,0
20200520,07005P,台積電統一9B售05,1.06,1.07,1.06,1.07,0.00,0.00,100000,10,106900,0,0,0,0,0,0,100000,100000,0,0
20200520,07006P,旺宏統一9B售03,1.17,1.19,1.17,1.19,+0.01,0.85,15000,4,17750,0,0,0,0,0,0,4000,11000,-7000,-7000
20200520,07007P,台灣50台新01售02,5.90,5.90,5.90,5.90,0.00,0.00,40000,1,236000,0,0,0,0,0,0,0,40000,-40000,-40000
20200520,07008P,台郡中信99售02,,,,,0.00,0.00,0,0,0,0,0,0,0,0,0,0,0,0,0
20200520,07009P,臺股指中信9B售01,1.67,1.67,1.64,1.64,-0.03,-1.8,17000,3,27910,0,0,0,0,0,0,1000,16000,-15000,-15000
20200520,07010P,T50正2凱基9C售01,,,,,0.00,0.00,0,0,0,0,0,0,0,0,0,0,0,0,0
20200520,07011P,宏達電凱基99售02,1.78,1.78,1.75,1.75,-0.06,-3.31,45000,2,79740,0,0,0,0,0,0,45000,33000,12000,12000
20200520,07012P,智邦群益9A售01,,,,,0.00,0.00,0,0,0,0,0,0,0,0,0,0,0,0,0
20200520,07013P,玉晶光群益9A售06,3.99,3.99,3.92,3.92,-0.09,-2.24,12000,2,47810,0,0,0,0,0,0,11000,1000,10000,10000
20200520,07014P,華通元大99售04,1.68,1.71,1.58,1.65,0.00,0.00,67000,16,110090,0,0,0,0,0,0,33000,33000,0,0
20200520,07015P,國巨元大99售13,0.98,1.01,0.98,1.01,0.00,0.00,166000,19,167080,0,0,0,0,0,0,0,166000,-166000,-166000
20200520,07016P,聯發科元大99售10,1.89,1.89,1.89,1.89,-0.37,-16.37,1000,1,1890,0,0,0,0,0,0,0,1000,-1000,-1000
20200520,07017P,台灣50元富9B售02,,,,,0.00,0.00,0,0,0,0,0,0,0,0,0,0,0,0,0
20200520,07018P,台灣50統一9B售01,,,,,0.00,0.00,0,0,0,0,0,0,0,0,0,0,0,0,0
20200520,07019P,鴻海台新99售01,,,,,0.00,0.00,0,0,0,0,0,0,0,0,0,0,0,0,0
20200520,07020P,玉晶光台新99售02,1.40,1.40,1.40,1.40,0.00,0.00,20000,2,28000,0,0,0,0,0,0,20000,20000,0,0
20200520,07021P,台積電富邦9C售02,,,,,0.00,0.00,0,0,0,0,0,0,0,0,0,0,0,0,0
20200520,07022P,嘉晶永豐99售02,0.85,0.86,0.69,0.73,-0.19,-20.65,358000,18,284490,0,0,0,0,0,0,229000,129000,100000,100000
20200520,07023P,南電永豐99售02,1.38,1.51,1.35,1.47,-0.01,-0.68,67000,13,95520,0,0,0,0,0,0,33000,34000,-1000,-1000
20200520,07024P,臺股指永豐99售02,2.10,2.10,2.10,2.10,+0.01,0.48,10000,1,21000,0,0,0,0,0,0,10000,0,10000,10000
20200520,07025P,玉晶光凱基99售01,0.97,0.97,0.97,0.97,-0.02,-2.02,4000,4,3880,0,0,0,0,0,0,4000,0,4000,4000
20200520,07026P,超眾凱基99售03,0.79,0.81,0.77,0.80,-0.01,-1.23,210000,8,168660,0,0,0,0,0,0,86000,129000,-43000,-43000
20200520,07027P,台積電群益99售04,4.68,4.78,4.67,4.67,-0.10,-2.1,115000,12,544680,0,0,0,0,0,0,10000,105000,-95000,-95000
20200520,07028P,大立光群益99售06,4.41,4.41,4.41,4.41,0.00,0.00,4000,1,17640,0,0,0,0,0,0,4000,0,4000,4000
20200520,07029P,緯穎群益99售02,,,,,0.00,0.00,0,0,0,0,0,0,0,0,0,0,0,0,0
20200520,07030P,鈺齊群益99售01,,,,,0.00,0.00,0,0,0,0,0,0,0,0,0,0,0,0,0
20200520,07031P,台灣50中信03售02,1.57,1.57,1.57,1.57,-0.02,-1.26,40000,1,62800,0,0,0,0,0,0,40000,0,40000,40000
20200520,07032P,聯發科統一9C售02,0.88,0.93,0.88,0.92,-0.03,-3.16,382000,10,346900,0,0,0,0,0,0,85000,297000,-212000,-212000
20200520,07033P,大立光統一9B售03,,,,,0.00,0.00,0,0,0,0,0,0,0,0,0,0,0,0,0
20200520,07034P,大立光元富99售03,3.14,3.14,3.14,3.14,-0.02,-0.63,6000,1,18840,0,0,0,0,0,0,6000,0,6000,6000
20200520,07035P,大立光元富99售04,4.77,4.77,4.77,4.77,0.00,0.00,10000,1,47700,0,0,0,0,0,0,0,10000,-10000,-10000
20200520,07036P,台灣50台新9C售01,,,,,0.00,0.00,0,0,0,0,0,0,0,0,0,0,0,0,0
20200520,07037P,台積電台新99售03,1.64,1.76,1.64,1.71,+0.02,1.18,290000,29,495500,0,0,0,0,0,0,290000,290000,0,0
20200520,07038P,華新科台新99售01,,,,,0.00,0.00,0,0,0,0,0,0,0,0,0,0,0,0,0
20200520,07039P,南電台新99售01,1.20,1.33,1.15,1.33,+0.09,7.26,43000,6,56430,0,0,0,0,0,0,43000,0,43000,43000
20200520,07040P,台灣50元大9C售02,3.32,3.32,3.28,3.31,0.00,0.00,50000,5,165200,0,0,0,0,0,0,0,50000,-50000,-50000
20200520,07041P,T50反1元大9C售01,,,,,0.00,0.00,0,0,0,0,0,0,0,0,0,0,0,0,0
20200520,07042P,T50反1元大9C售02,,,,,0.00,0.00,0,0,0,0,0,0,0,0,0,0,0,0,0
20200520,07043P,國巨元大99售14,2.06,2.15,2.06,2.11,-0.37,-14.92,85000,6,177850,0,0,0,0,0,0,40000,45000,-5000,-5000
20200520,07044P,台積電元大99售13,,,,,0.00,0.00,0,0,0,0,0,0,0,0,0,0,0,0,0
20200520,07045P,上銀國票9A售01,,,,,0.00,0.00,0,0,0,0,0,0,0,0,0,0,0,0,0
20200520,07046P,大立光富邦9C售03,1.10,1.10,1.10,1.10,+0.04,3.77,1000,1,1100,0,0,0,0,0,0,0,0,0,0
20200520,07047P,S&P500中信9B售02,,,,,0.00,0.00,0,0,0,0,0,0,0,0,0,0,0,0,0
20200520,07048P,台積電中信03售01,,,,,0.00,0.00,0,0,0,0,0,0,0,0,0,0,0,0,0
20200520,07049P,聯發科中信99售03,0.57,0.59,0.54,0.58,-0.05,-7.94,105000,8,59050,0,0,0,0,0,0,0,105000,-105000,-105000
20200520,07050P,宏達電中信9B售01,1.24,1.24,1.20,1.24,-0.04,-3.12,47000,6,58200,0,0,0,0,0,0,45000,12000,33000,33000
20200520,07051P,大立光中信99售02,2.37,2.37,2.31,2.31,-0.09,-3.75,8000,2,18900,0,0,0,0,0,0,7000,1000,6000,6000
20200520,07052P,臺股指中信9C售02,,,,,0.00,0.00,0,0,0,0,0,0,0,0,0,0,0,0,0
20200520,07053P,台灣50兆豐01售01,2.23,2.23,2.23,2.23,+0.22,10.95,2000,1,4460,0,0,0,0,0,0,2000,0,2000,2000
20200520,07054P,華新科兆豐99售04,,,,,0.00,0.00,0,0,0,0,0,0,0,0,0,0,0,0,0
20200520,07055P,景碩群益9A售02,2.81,3.00,2.80,2.97,+0.11,3.85,194000,20,574160,0,0,0,0,0,0,22000,171000,-149000,-149000
20200520,07056P,臺股指麥證99售02,4.76,4.76,4.76,4.76,0.00,0.00,1000,1,4760,0,1000,-1000,0,0,0,0,1000,-1000,-1000
20200520,07057P,大立光康和9B售02,2.16,2.18,2.16,2.18,-0.04,-1.8,30000,2,65200,0,0,0,0,0,0,10000,20000,-10000,-10000
20200520,07058P,台積電凱基9A售07,2.80,2.83,2.80,2.83,-0.01,-0.35,27000,4,76100,0,0,0,0,0,0,25000,2000,23000,23000
20200520,07059P,華通國票9A售02,2.79,2.79,2.75,2.75,+0.01,0.36,3000,2,8290,0,0,0,0,0,0,1000,2000,-1000,-1000
20200520,07060P,台表科國票9A售01,0.91,0.96,0.77,0.79,-0.16,-16.84,537000,48,453900,0,0,0,0,0,0,49000,478000,-429000,-429000
20200520,07061P,台積電元大99售14,,,,,0.00,0.00,0,0,0,0,0,0,0,0,0,0,0,0,0
20200520,07062P,台積電元大99售15,,,,,0.00,0.00,0,0,0,0,0,0,0,0,0,0,0,0,0
20200520,07063P,臺股指元大9A售24,,,,,0.00,0.00,0,0,0,0,0,0,0,0,0,0,0,0,0
20200520,07064P,臺股指元大9A售25,,,,,0.00,0.00,0,0,0,0,0,0,0,0,0,0,0,0,0
20200520,07065P,臺股指元大9A售26,8.45,8.45,8.45,8.45,-0.05,-0.59,20000,2,169000,0,0,0,0,0,0,0,20000,-20000,-20000
20200520,07066P,台灣50台新9B售01,,,,,0.00,0.00,0,0,0,0,0,0,0,0,0,0,0,0,0
20200520,07067P,旺宏台新99售02,1.37,1.38,1.35,1.38,-0.01,-0.72,47000,6,64410,0,0,0,0,0,0,23000,24000,-1000,-1000
20200520,07068P,欣興台新99售01,1.82,1.82,1.82,1.82,-0.07,-3.7,5000,1,9100,0,0,0,0,0,0,0,5000,-5000,-5000
20200520,07069P,欣興元富99售02,4.64,4.75,4.64,4.71,-0.39,-7.65,96000,7,449500,0,0,0,0,0,0,40000,56000,-16000,-16000
20200520,07070P,晶相光元富99售01,3.64,3.70,3.58,3.59,-0.14,-3.75,222000,13,814060,0,0,0,0,0,0,27000,195000,-168000,-168000
20200520,07071P,立積元富99售01,1.58,1.63,1.56,1.62,+0.06,3.85,342000,27,548300,0,0,0,0,0,0,112000,229000,-117000,-117000
20200520,07072P,元油2X凱基9C售01,,,,,0.00,0.00,0,0,0,0,0,0,0,0,0,0,0,0,0
20200520,07073P,臺股指中信9B售02,,,,,0.00,0.00,0,0,0,0,0,0,0,0,0,0,0,0,0
20200520,07074P,FBVIX凱基9A售01,1.05,1.05,1.05,1.05,-0.02,-1.87,48000,1,50400,0,0,0,0,0,0,48000,48000,0,0
20200520,07075P,FBVIX凱基9C售04,,,,,0.00,0.00,0,0,0,0,0,0,0,0,0,0,0,0,0
20200520,07076P,鴻海凱基9A售08,2.88,2.91,2.85,2.91,+0.01,0.34,38000,11,109380,0,0,0,0,0,0,28000,10000,18000,18000
20200520,07077P,緯穎凱基99售01,,,,,0.00,0.00,0,0,0,0,0,0,0,0,0,0,0,0,0
20200520,07078P,鴻海群益99售02,,,,,0.00,0.00,0,0,0,0,0,0,0,0,0,0,0,0,0
20200520,07079P,台積電群益99售06,,,,,0.00,0.00,0,0,0,0,0,0,0,0,0,0,0,0,0
20200520,07080P,健策群益9A售01,1.19,1.24,1.13,1.15,-0.05,-4.17,198000,15,233800,0,0,0,0,0,0,186000,12000,174000,174000
20200520,07081P,南電群益9A售01,1.58,1.63,1.56,1.63,+0.02,1.24,92000,12,147620,0,0,0,0,0,0,31000,61000,-30000,-30000
20200520,07082P,美律元大99售06,1.14,1.16,1.12,1.15,+0.03,2.68,1111000,54,1267670,0,0,0,0,0,0,256000,999000,-743000,-743000
20200520,07083P,台積電統一9A售06,1.08,1.09,1.08,1.09,0.00,0.00,100000,10,108900,0,0,0,0,0,0,100000,100000,0,0
20200520,07084P,S&P正2元富9B售02,0.90,0.94,0.89,0.94,+0.02,2.17,114000,10,105080,0,0,0,0,0,0,0,59000,-59000,-59000
20200520,07085P,超眾元富9C售01,1.90,1.93,1.90,1.92,+0.03,1.59,102000,3,196240,0,0,0,0,0,0,0,102000,-102000,-102000
20200520,07086P,力成元富9C售01,2.38,2.43,2.38,2.43,+0.04,1.67,213000,38,513970,0,0,0,0,0,0,85000,128000,-43000,-43000
20200520,07087P,聯發科台新99售02,,,,,0.00,0.00,0,0,0,0,0,0,0,0,0,0,0,0,0
20200520,07088P,訊芯永豐99售02,0.77,0.77,0.76,0.76,-0.03,-3.8,88000,2,67560,0,0,0,0,0,0,0,88000,-88000,-88000
20200520,07089P,臺指2X中信01售01,1.41,1.43,1.40,1.43,-0.02,-1.38,148000,9,210360,0,0,0,0,0,0,2000,146000,-144000,-144000
20200520,07090P,台灣50凱基01售01,3.42,3.42,3.40,3.40,0.00,0.00,2000,2,6820,0,0,0,0,0,0,0,2000,-2000,-2000
20200520,07091P,SGBR2X凱基9A售02,,,,,0.00,0.00,0,0,0,0,0,0,0,0,0,0,0,0,0
20200520,07092P,上銀凱基99售03,,,,,0.00,0.00,0,0,0,0,0,0,0,0,0,0,0,0,0
20200520,07093P,台積電凱基99售07,,,,,0.00,0.00,0,0,0,0,0,0,0,0,0,0,0,0,0
20200520,07094P,華通國票9A售03,2.11,2.11,2.11,2.11,+0.05,2.43,2000,2,4220,0,0,0,0,0,0,2000,0,2000,2000
20200520,07095P,台灣50元大9C售03,,,,,0.00,0.00,0,0,0,0,0,0,0,0,0,0,0,0,0
20200520,07096P,元石油元大9C售05,0.80,0.80,0.80,0.80,-0.11,-12.09,1000,1,800,0,0,0,0,0,0,1000,0,1000,1000
20200520,07097P,元油2X元大9C售09,,,,,0.00,0.00,0,0,0,0,0,0,0,0,0,0,0,0,0
20200520,07098P,台積電元大99售18,,,,,0.00,0.00,0,0,0,0,0,0,0,0,0,0,0,0,0
20200520,07099P,台積電元大99售19,,,,,0.00,0.00,0,0,0,0,0,0,0,0,0,0,0,0,0
20200520,07100P,華航元大99售01,0.50,0.73,0.50,0.73,-0.01,-1.35,406000,20,282820,0,0,0,0,0,0,54000,343000,-289000,-289000
20200520,07101P,台郡元大99售06,1.21,1.23,1.21,1.23,0.00,0.00,150000,2,183500,0,0,0,0,0,0,0,150000,-150000,-150000
20200520,07102P,南電元大99售03,2.34,2.34,2.34,2.34,-0.05,-2.09,25000,1,58500,0,0,0,0,0,0,0,25000,-25000,-25000
20200520,07103P,南電元大99售04,2.99,3.18,2.96,3.07,+0.02,0.66,249000,19,767500,0,0,0,0,0,0,197000,12000,185000,185000
20200520,07104P,聯發科元富99售04,1.14,1.16,1.14,1.16,-0.09,-7.2,11000,3,12650,0,0,0,0,0,0,0,11000,-11000,-11000
20200520,07105P,大毅元富99售02,0.60,0.62,0.57,0.62,0.00,0.00,290000,9,171550,0,0,0,0,0,0,279000,4000,275000,275000
20200520,07106P,國巨統一9B售05,1.02,1.04,1.02,1.03,-0.08,-7.21,65000,5,66940,0,0,0,0,0,0,60000,5000,55000,55000
20200520,07107P,臺股指統一99售07,,,,,0.00,0.00,0,0,0,0,0,0,0,0,0,0,0,0,0
20200520,07108P,FBVIX台新99售02,0.72,0.72,0.72,0.72,-0.01,-1.37,439000,2,316080,0,0,0,0,0,0,439000,0,439000,439000
20200520,07109P,聯發科中信9B售02,,,,,0.00,0.00,0,0,0,0,0,0,0,0,0,0,0,0,0
20200520,07110P,台灣50群益9B售03,,,,,0.00,0.00,0,0,0,0,0,0,0,0,0,0,0,0,0
20200520,07111P,台積電群益99售08,,,,,0.00,0.00,0,0,0,0,0,0,0,0,0,0,0,0,0
20200520,07112P,聯發科群益99售05,2.08,2.15,2.08,2.13,0.00,0.00,40000,5,84800,0,0,0,0,0,0,0,40000,-40000,-40000
20200520,07113P,台積電兆豐99售03,,,,,0.00,0.00,0,0,0,0,0,0,0,0,0,0,0,0,0
20200520,07114P,旺宏兆豐9A售01,,,,,0.00,0.00,0,0,0,0,0,0,0,0,0,0,0,0,0
20200520,07115P,T50反1日盛9C售02,,,,,0.00,0.00,0,0,0,0,0,0,0,0,0,0,0,0,0
20200520,07116P,台灣50麥證9A售02,,,,,0.00,0.00,0,0,0,0,0,0,0,0,0,0,0,0,0
20200520,07117P,SGBR2X凱基9C售01,,,,,0.00,0.00,0,0,0,0,0,0,0,0,0,0,0,0,0
20200520,07118P,台積電凱基99售09,,,,,0.00,0.00,0,0,0,0,0,0,0,0,0,0,0,0,0
20200520,07119P,台積電凱基9A售08,0.65,0.65,0.50,0.50,0.00,0.00,24000,5,12150,0,0,0,0,0,0,0,0,0,0
20200520,07120P,聯發科凱基99售09,,,,,0.00,0.00,0,0,0,0,0,0,0,0,0,0,0,0,0
20200520,07121P,華新科凱基99售03,1.94,1.94,1.94,1.94,-0.04,-2.02,10000,1,19400,0,0,0,0,0,0,0,10000,-10000,-10000
20200520,07122P,欣興凱基99售05,1.53,1.63,1.48,1.57,-0.04,-2.48,165000,10,256200,0,0,0,0,0,0,5000,160000,-155000,-155000
20200520,07123P,鴻海元大99售23,,,,,0.00,0.00,0,0,0,0,0,0,0,0,0,0,0,0,0
20200520,07124P,台積電元大99售21,,,,,0.00,0.00,0,0,0,0,0,0,0,0,0,0,0,0,0
20200520,07125P,台積電元大99售22,,,,,0.00,0.00,0,0,0,0,0,0,0,0,0,0,0,0,0
20200520,07126P,台積電元大99售23,1.28,1.28,1.28,1.28,0.00,0.00,2000,1,2560,0,0,0,0,0,0,0,2000,-2000,-2000
20200520,07127P,精元元大99售01,3.63,3.65,3.53,3.65,-0.05,-1.35,52000,6,188190,0,0,0,0,0,0,15000,37000,-22000,-22000
20200520,07128P,大毅元大99售04,0.62,0.63,0.59,0.63,0.00,0.00,449000,13,275000,0,0,0,0,0,0,125000,322000,-197000,-197000
20200520,07129P,華新科元大99售14,4.27,4.37,4.25,4.34,0.00,0.00,196000,7,850040,0,0,0,0,0,0,130000,66000,64000,64000
20200520,07130P,台郡元大9B售01,1.02,1.04,1.01,1.03,+0.01,0.98,309000,7,318090,0,0,0,0,0,0,59000,250000,-191000,-191000
20200520,07131P,緯穎元大99售06,1.45,1.56,1.40,1.53,-0.01,-0.65,81000,13,119270,0,0,0,0,0,0,50000,81000,-31000,-31000
20200520,07132P,臺股指元大99售11,,,,,0.00,0.00,0,0,0,0,0,0,0,0,0,0,0,0,0
20200520,07133P,臺股指元大9A售27,2.62,2.62,2.62,2.62,0.00,0.00,6000,1,15720,0,0,0,0,0,0,0,0,0,0
20200520,07134P,臺股指元大9A售28,3.89,3.91,3.87,3.91,-0.07,-1.76,52000,5,202990,0,0,0,0,0,0,0,52000,-52000,-52000
20200520,07135P,臺股指元大9A售29,,,,,0.00,0.00,0,0,0,0,0,0,0,0,0,0,0,0,0
20200520,07136P,T50反1台新01售01,,,,,0.00,0.00,0,0,0,0,0,0,0,0,0,0,0,0,0
20200520,07137P,大立光中信9B售01,,,,,0.00,0.00,0,0,0,0,0,0,0,0,0,0,0,0,0
20200520,07138P,台灣50群益9B售04,,,,,0.00,0.00,0,0,0,0,0,0,0,0,0,0,0,0,0
20200520,07139P,元油2X群益9C售06,3.37,3.37,3.37,3.37,-0.10,-2.88,10000,1,33700,0,0,0,0,0,0,10000,0,10000,10000
20200520,07140P,台灣50日盛99售01,2.67,2.90,2.50,2.90,+0.11,3.94,101000,11,265400,0,0,0,0,0,0,0,100000,-100000,-100000
20200520,07141P,台灣50國票9A售03,,,,,0.00,0.00,0,0,0,0,0,0,0,0,0,0,0,0,0
20200520,07142P,台灣50元大01售01,,,,,0.00,0.00,0,0,0,0,0,0,0,0,0,0,0,0,0
20200520,07143P,FBVIX元大99售02,,,,,0.00,0.00,0,0,0,0,0,0,0,0,0,0,0,0,0
20200520,07144P,FBVIX元大99售03,,,,,0.00,0.00,0,0,0,0,0,0,0,0,0,0,0,0,0
20200520,07145P,為升元大99售03,1.27,1.31,1.25,1.31,+0.07,5.65,62000,7,79220,0,0,0,0,0,0,0,62000,-62000,-62000
20200520,07146P,瑞昱元大99售02,1.17,1.20,1.13,1.16,-0.06,-4.92,139000,8,161440,0,0,0,0,0,0,0,119000,-119000,-119000
20200520,07147P,高鐵元大99售01,0.75,0.75,0.70,0.70,-0.08,-10.26,116000,14,84980,0,0,0,0,0,0,112000,3000,109000,109000
20200520,07148P,富邦金元大99售01,3.20,3.20,1.58,1.58,0.00,0.00,281000,10,463050,0,0,0,0,0,0,0,273000,-273000,-273000
20200520,07149P,健鼎元大99售03,1.99,2.03,1.99,2.02,+0.08,4.12,146000,10,291420,0,0,0,0,0,0,0,146000,-146000,-146000
20200520,07150P,和碩元大99售01,1.11,1.11,1.11,1.11,+0.01,0.91,10000,1,11100,0,0,0,0,0,0,10000,0,10000,10000
20200520,07151P,台灣50統一9B售04,,,,,0.00,0.00,0,0,0,0,0,0,0,0,0,0,0,0,0
20200520,07152P,臺股指元富99售08,,,,,0.00,0.00,0,0,0,0,0,0,0,0,0,0,0,0,0
20200520,07153P,臺股指元富99售09,,,,,0.00,0.00,0,0,0,0,0,0,0,0,0,0,0,0,0
20200520,07155P,臺股指元富99售10,,,,,0.00,0.00,0,0,0,0,0,0,0,0,0,0,0,0,0
20200520,07156P,臺股指元富99售11,,,,,0.00,0.00,0,0,0,0,0,0,0,0,0,0,0,0,0
20200520,07157P,臺股指元富99售12,,,,,0.00,0.00,0,0,0,0,0,0,0,0,0,0,0,0,0
20200520,07158P,FBVIX國泰9C售01,1.40,1.40,1.40,1.40,-0.02,-1.41,90000,1,126000,0,0,0,0,0,0,90000,0,90000,90000
20200520,07159P,台積電永豐99售04,,,,,0.00,0.00,0,0,0,0,0,0,0,0,0,0,0,0,0
20200520,07160P,台灣50中信03售04,,,,,0.00,0.00,0,0,0,0,0,0,0,0,0,0,0,0,0
20200520,07161P,臺股指群益99售12,5.45,5.45,5.45,5.45,-0.15,-2.68,20000,4,109000,0,0,0,0,0,0,0,20000,-20000,-20000
20200520,07162P,臺股指群益99售13,2.22,2.30,2.19,2.26,-0.09,-3.83,590000,34,1312930,0,0,0,0,0,0,322000,267000,55000,55000
20200520,07163P,臺股指群益99售14,2.54,2.60,2.50,2.57,-0.06,-2.28,57000,9,144570,0,0,0,0,0,0,16000,41000,-25000,-25000
20200520,07164P,臺股指群益99售15,2.61,2.68,2.57,2.62,-0.07,-2.6,192000,18,503190,0,0,0,0,0,0,60000,132000,-72000,-72000
20200520,07165P,臺股指群益99售16,4.44,4.45,4.41,4.45,-0.13,-2.84,15000,3,66500,0,0,0,0,0,0,10000,5000,5000,5000
20200520,07166P,台灣50兆豐03售01,0.90,0.90,0.90,0.90,0.00,0.00,10000,2,9000,0,0,0,0,0,0,0,0,0,0
20200520,07167P,臺股指兆豐99售02,,,,,0.00,0.00,0,0,0,0,0,0,0,0,0,0,0,0,0
20200520,07168P,臺股指兆豐99售03,,,,,0.00,0.00,0,0,0,0,0,0,0,0,0,0,0,0,0
20200520,07169P,臺股指國票99售06,4.32,4.32,4.32,4.32,0.00,0.00,10000,1,43200,0,0,0,0,0,0,0,10000,-10000,-10000
20200520,07170P,臺股指國票99售07,2.96,3.01,2.92,3.01,-0.04,-1.31,583000,21,1726320,0,0,0,0,0,0,361000,222000,139000,139000
20200520,07171P,臺股指國票99售08,2.29,2.33,2.28,2.33,-0.03,-1.27,112000,7,259760,0,0,0,0,0,0,26000,86000,-60000,-60000
20200520,07172P,臺股指國票99售09,2.36,2.44,2.33,2.44,+0.01,0.41,346000,24,816380,0,0,0,0,0,0,204000,142000,62000,62000
20200520,07173P,臺股指國票99售10,1.81,1.88,1.78,1.84,-0.03,-1.6,169000,25,306820,0,0,0,0,0,0,65000,104000,-39000,-39000
20200520,07174P,臺股指國票99售11,3.35,3.44,3.29,3.40,-0.06,-1.73,1121000,26,3756590,0,0,0,0,0,0,689000,432000,257000,257000
20200520,07175P,聯詠凱基99售02,1.26,1.26,1.24,1.24,-0.02,-1.59,20000,2,25000,0,0,0,0,0,0,10000,10000,0,0
20200520,07176P,臺股指凱基99售18,,,,,0.00,0.00,0,0,0,0,0,0,0,0,0,0,0,0,0
20200520,07177P,臺股指凱基99售19,,,,,0.00,0.00,0,0,0,0,0,0,0,0,0,0,0,0,0
20200520,07178P,臺股指凱基99售20,3.38,3.38,3.36,3.36,-0.09,-2.61,8000,2,26960,0,0,0,0,0,0,0,8000,-8000,-8000
20200520,07179P,臺股指凱基99售21,,,,,0.00,0.00,0,0,0,0,0,0,0,0,0,0,0,0,0
20200520,07180P,臺股指凱基99售22,3.93,3.98,3.93,3.95,-0.06,-1.5,10000,4,39540,0,0,0,0,0,0,0,10000,-10000,-10000
20200520,07181P,臺股指凱基99售23,3.27,3.32,3.27,3.32,-0.03,-0.9,33000,6,108640,0,0,0,0,0,0,7000,26000,-19000,-19000
20200520,07182P,臺股指凱基99售24,,,,,0.00,0.00,0,0,0,0,0,0,0,0,0,0,0,0,0
20200520,07183P,臺股指凱基99售25,4.03,4.03,4.00,4.00,-0.14,-3.38,25000,5,100520,0,0,0,0,0,0,0,25000,-25000,-25000
20200520,07184P,台灣50元富01售01,4.42,4.53,4.42,4.53,+0.09,2.03,3000,3,13410,0,0,0,0,0,0,0,3000,-3000,-3000
20200520,07185P,臺股指統一9C售01,,,,,0.00,0.00,0,0,0,0,0,0,0,0,0,0,0,0,0
20200520,07186P,臺股指統一9C售02,,,,,0.00,0.00,0,0,0,0,0,0,0,0,0,0,0,0,0
20200520,07187P,臺股指台新99售10,1.24,1.24,1.23,1.23,-0.03,-2.38,20000,2,24700,0,0,0,0,0,0,0,20000,-20000,-20000
20200520,07188P,臺股指台新99售11,,,,,0.00,0.00,0,0,0,0,0,0,0,0,0,0,0,0,0
20200520,07189P,聯發科富邦9B售03,0.74,0.74,0.73,0.74,-0.04,-5.13,37000,8,27370,0,0,0,0,0,0,7000,30000,-23000,-23000
20200520,07190P,臺股指富邦9C售02,1.95,1.95,1.92,1.94,-0.01,-0.51,41000,11,79470,0,0,0,0,0,0,3000,38000,-35000,-35000
20200520,07191P,台積電元大99售32,,,,,0.00,0.00,0,0,0,0,0,0,0,0,0,0,0,0,0
20200520,07192P,聯發科元大99售23,2.11,2.28,2.11,2.24,-0.16,-6.67,49000,6,106450,0,0,0,0,0,0,44000,5000,39000,39000
20200520,07193P,聯發科元大99售24,,,,,0.00,0.00,0,0,0,0,0,0,0,0,0,0,0,0,0
20200520,07194P,聯發科元大99售25,2.19,2.19,2.05,2.05,-0.38,-15.64,2000,2,4240,0,0,0,0,0,0,0,2000,-2000,-2000
20200520,07195P,大立光元大99售12,,,,,0.00,0.00,0,0,0,0,0,0,0,0,0,0,0,0,0
20200520,07196P,大立光元大99售13,4.71,4.71,4.58,4.58,-0.23,-4.78,20000,3,92900,0,0,0,0,0,0,20000,0,20000,20000
20200520,07197P,臺股指元大99售13,4.31,4.34,4.27,4.34,-0.06,-1.36,190000,7,815460,0,0,0,0,0,0,24000,166000,-142000,-142000
20200520,07198P,臺股指元大99售14,,,,,0.00,0.00,0,0,0,0,0,0,0,0,0,0,0,0,0
20200520,07199P,臺股指元大99售15,,,,,0.00,0.00,0,0,0,0,0,0,0,0,0,0,0,0,0
20200520,07200P,臺股指元大99售16,,,,,0.00,0.00,0,0,0,0,0,0,0,0,0,0,0,0,0
20200520,07201P,臺股指元大99售17,,,,,0.00,0.00,0,0,0,0,0,0,0,0,0,0,0,0,0
20200520,07202P,台灣50凱基9C售04,1.80,1.82,1.80,1.82,-0.01,-0.55,2000,2,3620,0,0,0,0,0,0,1000,1000,0,0
20200520,07203P,T50正2凱基9C售02,1.60,1.60,1.60,1.60,0.00,0.00,23000,2,36800,0,0,0,0,0,0,0,23000,-23000,-23000
20200520,07204P,鴻海凱基99售10,1.24,1.29,1.23,1.29,+0.01,0.78,350000,10,436080,0,0,0,0,0,0,300000,50000,250000,250000
20200520,07205P,鴻海凱基99售11,1.08,1.08,1.08,1.08,-0.03,-2.7,200000,5,216000,0,0,0,0,0,0,195000,0,195000,195000
20200520,07206P,鴻海凱基9A售11,1.18,1.22,1.16,1.22,+0.01,0.83,305000,12,358620,0,0,0,0,0,0,293000,2000,291000,291000
20200520,07207P,台積電凱基99售13,,,,,0.00,0.00,0,0,0,0,0,0,0,0,0,0,0,0,0
20200520,07208P,台積電凱基99售14,1.01,1.03,1.00,1.03,+0.01,0.98,119000,15,121210,0,0,0,0,0,0,15000,104000,-89000,-89000
20200520,07209P,台積電凱基9A售10,,,,,0.00,0.00,0,0,0,0,0,0,0,0,0,0,0,0,0
20200520,07210P,智邦凱基99售03,0.37,0.38,0.37,0.37,-0.02,-5.13,75000,8,28070,0,0,0,0,0,0,45000,30000,15000,15000
20200520,07211P,南亞科凱基99售05,1.73,1.84,1.73,1.81,-0.13,-6.7,38000,7,68630,0,0,0,0,0,0,21000,17000,4000,4000
20200520,07212P,聯發科凱基99售14,0.27,0.27,0.27,0.27,-0.03,-10.0,10000,1,2700,0,0,0,0,0,0,0,10000,-10000,-10000
20200520,07213P,聯發科凱基99售15,,,,,0.00,0.00,0,0,0,0,0,0,0,0,0,0,0,0,0
20200520,07214P,聯發科凱基9A售04,0.32,0.32,0.28,0.31,-0.03,-8.82,1119000,57,329130,0,0,0,0,0,0,59000,1059000,-1000000,-1000000
20200520,07215P,大立光凱基99售07,1.38,1.38,1.34,1.34,0.00,0.00,56000,4,76480,0,0,0,0,0,0,1000,55000,-54000,-54000
20200520,07216P,大立光凱基99售08,1.34,1.37,1.33,1.35,-0.06,-4.26,157000,9,210330,0,0,0,0,0,0,16000,141000,-125000,-125000
20200520,07217P,大立光凱基9A售05,1.19,1.19,1.17,1.19,-0.03,-2.46,125000,4,148100,0,0,0,0,0,0,45000,80000,-35000,-35000
20200520,07218P,臺股指凱基99售31,1.93,1.94,1.93,1.94,-0.06,-3.0,7000,2,13530,0,0,0,0,0,0,0,7000,-7000,-7000
20200520,07219P,臺股指凱基99售32,,,,,0.00,0.00,0,0,0,0,0,0,0,0,0,0,0,0,0
20200520,07220P,台灣50中信03售05,,,,,0.00,0.00,0,0,0,0,0,0,0,0,0,0,0,0,0
20200520,07221P,臺股指中信9B售04,,,,,0.00,0.00,0,0,0,0,0,0,0,0,0,0,0,0,0
20200520,07222P,台灣50元大01售04,,,,,0.00,0.00,0,0,0,0,0,0,0,0,0,0,0,0,0
20200520,07223P,鴻海元大99售29,2.18,2.18,2.18,2.18,-0.05,-2.24,35000,2,76300,0,0,0,0,0,0,35000,0,35000,35000
20200520,07224P,鴻海元大9A售02,,,,,0.00,0.00,0,0,0,0,0,0,0,0,0,0,0,0,0
20200520,07225P,台積電元大99售33,2.50,2.50,2.50,2.50,+0.01,0.4,48000,1,120000,0,0,0,0,0,0,0,48000,-48000,-48000
20200520,07226P,貿聯富邦9B售01,0.39,0.40,0.39,0.40,-0.02,-4.76,47000,6,18440,0,0,0,0,0,0,47000,0,47000,47000
20200520,07227P,聯發科元富99售05,0.59,0.59,0.58,0.58,-0.05,-7.94,310000,8,179900,0,0,0,0,0,0,155000,155000,0,0
20200520,07228P,台灣50群益9B售06,2.37,2.41,2.37,2.41,-0.02,-0.82,198000,3,474540,0,0,0,0,0,0,66000,132000,-66000,-66000
20200520,07229P,T50正2群益9A售01,,,,,0.00,0.00,0,0,0,0,0,0,0,0,0,0,0,0,0
20200520,07230P,滬深2X群益01售02,,,,,0.00,0.00,0,0,0,0,0,0,0,0,0,0,0,0,0
20200520,07231P,台灣50元大01售06,5.50,5.50,5.50,5.50,0.00,0.00,5000,1,27500,0,0,0,0,0,0,5000,0,5000,5000
20200520,07232P,台灣50元大01售07,,,,,0.00,0.00,0,0,0,0,0,0,0,0,0,0,0,0,0
20200520,07233P,台灣50元大99售04,2.62,2.62,2.62,2.62,-0.04,-1.5,5000,1,13100,0,0,0,0,0,0,0,5000,-5000,-5000
20200520,07234P,台灣50元大9B售04,4.32,4.32,4.32,4.32,-0.05,-1.14,59000,1,254880,0,0,0,0,0,0,59000,0,59000,59000
20200520,07235P,T50正2元大9C售02,3.52,3.52,3.51,3.51,-0.05,-1.4,11000,4,38660,0,0,0,0,0,0,0,11000,-11000,-11000
20200520,07236P,台灣50國票99售05,,,,,0.00,0.00,0,0,0,0,0,0,0,0,0,0,0,0,0
20200520,07237P,台灣50國票99售06,,,,,0.00,0.00,0,0,0,0,0,0,0,0,0,0,0,0,0
20200520,07238P,台灣50國票99售07,3.09,3.16,3.09,3.16,-0.03,-0.94,42000,5,131310,0,0,0,0,0,0,31000,11000,20000,20000
20200520,07239P,台灣50國票9A售04,,,,,0.00,0.00,0,0,0,0,0,0,0,0,0,0,0,0,0
20200520,07241P,台灣50國票9A售05,4.22,4.29,4.21,4.29,-0.06,-1.38,25000,4,106000,0,0,0,0,0,0,0,25000,-25000,-25000
20200520,07242P,台灣50凱基9A售03,,,,,0.00,0.00,0,0,0,0,0,0,0,0,0,0,0,0,0
20200520,07243P,台灣50凱基9A售04,,,,,0.00,0.00,0,0,0,0,0,0,0,0,0,0,0,0,0
20200520,07244P,鴻海凱基9A售13,1.72,1.78,1.69,1.78,0.00,0.00,321000,15,551070,0,0,0,0,0,0,304000,17000,287000,287000
20200520,07245P,台積電凱基99售16,2.42,2.42,2.42,2.42,-0.03,-1.22,41000,2,99220,0,0,0,0,0,0,0,41000,-41000,-41000
20200520,07246P,旺宏凱基99售08,1.16,1.18,1.15,1.15,-0.01,-0.86,414000,5,488140,0,0,0,0,0,0,10000,404000,-394000,-394000
20200520,07247P,聯發科凱基9A售06,0.38,0.41,0.38,0.40,-0.03,-6.98,297000,8,116900,0,0,0,0,0,0,170000,127000,43000,43000
20200520,07248P,可成凱基99售06,0.70,0.70,0.70,0.70,+0.07,11.11,201000,2,140700,0,0,0,0,0,0,0,201000,-201000,-201000
20200520,07249P,T50正2富邦03售02,,,,,0.00,0.00,0,0,0,0,0,0,0,0,0,0,0,0,0
20200520,07250P,台灣50永豐99售07,,,,,0.00,0.00,0,0,0,0,0,0,0,0,0,0,0,0,0
20200520,07251P,台灣50元富01售04,,,,,0.00,0.00,0,0,0,0,0,0,0,0,0,0,0,0,0
20200520,07252P,台灣50凱基99售01,1.58,1.58,1.57,1.57,-0.04,-2.48,11000,2,17370,0,0,0,0,0,0,1000,10000,-9000,-9000
20200520,07253P,台灣50凱基9A售05,,,,,0.00,0.00,0,0,0,0,0,0,0,0,0,0,0,0,0
20200520,07254P,台灣50凱基9C售06,,,,,0.00,0.00,0,0,0,0,0,0,0,0,0,0,0,0,0
20200520,07255P,國巨凱基99售15,0.62,0.62,0.60,0.62,-0.05,-7.46,28000,6,17260,0,0,0,0,0,0,22000,6000,16000,16000
20200520,07256P,臺股指凱基99售36,2.00,2.00,2.00,2.00,-0.04,-1.96,35000,3,70000,0,0,0,0,0,0,35000,0,35000,35000
20200520,07257P,臺股指凱基99售37,1.90,1.90,1.86,1.88,-0.03,-1.57,123000,7,229640,0,0,0,0,0,0,70000,53000,17000,17000
20200520,07258P,台灣50台新9A售01,0.46,0.47,0.45,0.46,-0.01,-2.13,265000,8,121950,0,0,0,0,0,0,125000,140000,-15000,-15000
20200520,07259P,滬深2X國票01售01,0.50,0.50,0.49,0.49,0.00,0.00,10000,2,4950,0,0,0,0,0,0,5000,5000,0,0
20200520,07260P,台灣50元大9A售01,2.76,2.76,2.76,2.76,-0.05,-1.78,74000,1,204240,0,0,0,0,0,0,74000,0,74000,74000
20200520,07261P,台灣50元大9A售04,3.20,3.20,3.20,3.20,-0.01,-0.31,73000,1,233600,0,0,0,0,0,0,73000,0,73000,73000
20200520,07262P,台灣50元大9B售05,,,,,0.00,0.00,0,0,0,0,0,0,0,0,0,0,0,0,0
20200520,07263P,台積電元大99售37,1.48,1.50,1.45,1.49,-0.04,-2.61,325000,8,483250,0,0,0,0,0,0,205000,220000,-15000,-15000
20200520,07264P,台積電元大99售38,2.52,2.52,2.52,2.52,-0.09,-3.45,10000,1,25200,0,0,0,0,0,0,10000,0,10000,10000
20200520,07265P,大立光元大99售16,1.93,1.93,1.87,1.87,-0.09,-4.59,275000,5,514800,0,0,0,0,0,0,261000,14000,247000,247000
20200520,07266P,大立光元大99售19,2.19,2.21,2.19,2.21,-0.04,-1.78,52000,4,114400,0,0,0,0,0,0,1000,26000,-25000,-25000
20200520,07267P,臺股指元大99售23,3.24,3.24,3.24,3.24,0.00,0.00,3000,1,9720,0,0,0,0,0,0,0,3000,-3000,-3000
20200520,07268P,臺股指元大99售24,,,,,0.00,0.00,0,0,0,0,0,0,0,0,0,0,0,0,0
20200520,07269P,台灣50元大01售08,,,,,0.00,0.00,0,0,0,0,0,0,0,0,0,0,0,0,0
20200520,07270P,台灣50元大01售09,3.85,3.87,3.85,3.86,-0.03,-0.77,10000,3,38630,0,0,0,0,0,0,8000,2000,6000,6000
20200520,07271P,台灣50元大9C售04,,,,,0.00,0.00,0,0,0,0,0,0,0,0,0,0,0,0,0
20200520,07272P,台灣50元大9C售05,,,,,0.00,0.00,0,0,0,0,0,0,0,0,0,0,0,0,0
20200520,07273P,台灣50群益99售03,,,,,0.00,0.00,0,0,0,0,0,0,0,0,0,0,0,0,0
20200520,07274P,上証2X群益01售01,1.90,1.90,1.90,1.90,+0.01,0.53,5000,1,9500,0,0,0,0,0,0,5000,0,5000,5000
20200520,07275P,FBVIX群益99售02,,,,,0.00,0.00,0,0,0,0,0,0,0,0,0,0,0,0,0
20200520,07276P,臺股指群益99售19,1.51,1.52,1.51,1.52,-0.03,-1.94,11000,2,16620,0,0,0,0,0,0,0,11000,-11000,-11000
20200520,07277P,臺股指群益99售20,,,,,0.00,0.00,0,0,0,0,0,0,0,0,0,0,0,0,0
20200520,07278P,台灣50元富9C售03,,,,,0.00,0.00,0,0,0,0,0,0,0,0,0,0,0,0,0
20200520,07279P,台灣50台新99售02,0.17,0.19,0.17,0.19,0.00,0.00,110000,9,19560,0,0,0,0,0,0,0,68000,-68000,-68000
20200520,07280P,FBVIX凱基99售01,1.51,1.51,1.51,1.51,-0.05,-3.21,54000,6,81540,0,0,0,0,0,0,38000,0,38000,38000
20200520,07281P,鴻海凱基99售13,1.15,1.17,1.15,1.17,0.00,0.00,30000,2,34700,0,0,0,0,0,0,20000,10000,10000,10000
20200520,07282P,聯發科凱基99售17,0.73,0.74,0.71,0.72,-0.03,-4.0,15000,7,10820,0,0,0,0,0,0,0,15000,-15000,-15000
20200520,07283P,華新科凱基99售07,0.54,0.54,0.54,0.54,-0.03,-5.26,20000,1,10800,0,0,0,0,0,0,20000,0,20000,20000
20200520,07284P,大立光凱基99售10,1.37,1.38,1.37,1.38,-0.03,-2.13,20000,2,27500,0,0,0,0,0,0,0,20000,-20000,-20000
20200520,07285P,上証2X群益01售02,,,,,0.00,0.00,0,0,0,0,0,0,0,0,0,0,0,0,0
20200520,07286P,元石油群益99售03,,,,,0.00,0.00,0,0,0,0,0,0,0,0,0,0,0,0,0
20200520,07287P,全新群益9B售01,0.30,0.32,0.30,0.32,+0.01,3.23,774000,5,246780,0,0,0,0,0,0,744000,30000,714000,714000
20200520,07288P,台灣50凱基99售06,0.67,0.68,0.66,0.66,0.00,0.00,56000,8,37470,0,0,0,0,0,0,1000,46000,-45000,-45000
20200520,07289P,台灣50凱基99售07,0.63,0.63,0.63,0.63,0.00,0.00,40000,1,25200,0,0,0,0,0,0,40000,0,40000,40000
20200520,07290P,台灣50凱基9A售08,,,,,0.00,0.00,0,0,0,0,0,0,0,0,0,0,0,0,0
20200520,07291P,臺股指凱基99售43,0.78,0.78,0.78,0.78,-0.01,-1.27,10000,1,7800,0,0,0,0,0,0,0,10000,-10000,-10000
20200520,07292P,臺股指凱基99售44,0.67,0.67,0.66,0.66,-0.01,-1.49,114000,8,75380,0,0,0,0,0,0,76000,34000,42000,42000
20200520,07293P,臺股指凱基99售45,0.97,0.97,0.97,0.97,-0.01,-1.02,113000,4,109610,0,0,0,0,0,0,100000,3000,97000,97000
20200520,07294P,滬深2X元富9C售08,,,,,0.00,0.00,0,0,0,0,0,0,0,0,0,0,0,0,0
20200520,07295P,滬深2X元富9C售09,1.49,1.50,1.49,1.50,+0.02,1.35,7000,3,10470,0,0,0,0,0,0,0,7000,-7000,-7000
20200520,07296P,T50反1台新99售02,,,,,0.00,0.00,0,0,0,0,0,0,0,0,0,0,0,0,0
20200520,07297P,台灣50元大9C售11,,,,,0.00,0.00,0,0,0,0,0,0,0,0,0,0,0,0,0
20200520,07298P,台灣50元大9C售12,,,,,0.00,0.00,0,0,0,0,0,0,0,0,0,0,0,0,0
20200520,07299P,台灣50元大9C售13,,,,,0.00,0.00,0,0,0,0,0,0,0,0,0,0,0,0,0
20200520,07300P,臺股指元大9A售33,0.96,0.98,0.96,0.98,+0.01,1.03,30000,3,28900,0,0,0,0,0,0,0,30000,-30000,-30000
20200520,07301P,臺股指元大9A售34,0.97,0.97,0.97,0.97,-0.03,-3.0,6000,2,5820,0,0,0,0,0,0,0,6000,-6000,-6000
20200520,07302P,臺股指元大9A售35,1.09,1.09,1.09,1.09,0.00,0.00,10000,2,10900,0,0,0,0,0,0,0,10000,-10000,-10000
20200520,07303P,臺股指元大9A售36,1.10,1.11,1.10,1.10,-0.03,-2.65,605000,3,668490,0,0,0,0,0,0,299000,306000,-7000,-7000
20200520,07304P,臺股指元大9A售37,1.23,1.24,1.22,1.23,-0.02,-1.6,1049000,14,1289160,0,0,0,0,0,0,213000,836000,-623000,-623000
20200520,07305P,T50正2群益99售02,0.86,0.87,0.86,0.87,0.00,0.00,12000,2,10340,0,0,0,0,0,0,0,12000,-12000,-12000
20200520,07306P,台灣50凱基9A售09,0.62,0.62,0.62,0.62,-0.01,-1.59,2000,1,1240,0,0,0,0,0,0,0,2000,-2000,-2000
20200520,07307P,上証2X凱基9A售02,,,,,0.00,0.00,0,0,0,0,0,0,0,0,0,0,0,0,0
20200520,07308P,滬深2X凱基9A售01,,,,,0.00,0.00,0,0,0,0,0,0,0,0,0,0,0,0,0
20200520,07309P,聯發科凱基99售18,0.39,0.40,0.39,0.40,-0.02,-4.76,10000,2,3950,0,0,0,0,0,0,5000,5000,0,0
20200520,07310P,大立光凱基99售12,,,,,0.00,0.00,0,0,0,0,0,0,0,0,0,0,0,0,0
20200520,07311P,台灣50元大99售09,,,,,0.00,0.00,0,0,0,0,0,0,0,0,0,0,0,0,0
20200520,07312P,台灣50元大99售10,1.01,1.01,1.01,1.01,-0.02,-1.94,10000,1,10100,0,0,0,0,0,0,0,10000,-10000,-10000
20200520,07313P,台灣50元大99售11,,,,,0.00,0.00,0,0,0,0,0,0,0,0,0,0,0,0,0
20200520,07314P,T50正2元大9C售03,1.88,1.88,1.88,1.88,0.00,0.00,2000,1,3760,0,0,0,0,0,0,0,2000,-2000,-2000
20200520,07315P,台積電台新99售06,0.34,0.34,0.33,0.33,0.00,0.00,60000,6,20300,0,0,0,0,0,0,0,60000,-60000,-60000
20200520,07316P,長榮航康和99售01,0.54,0.54,0.54,0.54,0.00,0.00,30000,1,16200,0,0,0,0,0,0,30000,0,30000,30000
20200520,07317P,T50正2凱基9B售02,0.82,0.82,0.82,0.82,-0.01,-1.2,5000,5,4100,0,0,0,0,0,0,0,5000,-5000,-5000
20200520,07318P,鴻海凱基01售02,,,,,0.00,0.00,0,0,0,0,0,0,0,0,0,0,0,0,0
20200520,07319P,台積電凱基01售02,0.64,0.65,0.64,0.64,-0.01,-1.54,116000,6,74740,0,0,0,0,0,0,0,30000,-30000,-30000
20200520,07320P,台灣50元大9C售14,,,,,0.00,0.00,0,0,0,0,0,0,0,0,0,0,0,0,0
20200520,07321P,台灣50元大9C售15,,,,,0.00,0.00,0,0,0,0,0,0,0,0,0,0,0,0,0
20200520,07322P,鴻海元大99售33,2.43,2.43,2.43,2.43,-0.04,-1.62,25000,1,60750,0,0,0,0,0,0,25000,0,25000,25000
20200520,07323P,鴻海元大99售34,2.97,2.97,2.97,2.97,-0.02,-0.67,25000,2,74250,0,0,0,0,0,0,25000,0,25000,25000
20200520,07324P,台積電元大99售40,,,,,0.00,0.00,0,0,0,0,0,0,0,0,0,0,0,0,0
20200520,07325P,台積電元大99售41,2.41,2.41,2.41,2.41,0.00,0.00,50000,1,120500,0,0,0,0,0,0,0,50000,-50000,-50000
20200520,07326P,大立光元大99售23,3.11,3.11,3.11,3.11,-0.11,-3.42,14000,1,43540,0,0,0,0,0,0,14000,0,14000,14000
20200520,07327P,台灣50群益9A售06,1.76,1.76,1.76,1.76,-0.02,-1.12,80000,1,140800,0,0,0,0,0,0,0,80000,-80000,-80000
20200520,07328P,FBVIX國泰9B售01,1.85,1.85,1.84,1.84,-0.02,-1.08,523000,8,964280,0,0,0,0,0,0,234000,523000,-289000,-289000
20200520,07329P,台灣50群益9A售07,,,,,0.00,0.00,0,0,0,0,0,0,0,0,0,0,0,0,0
20200520,07330P,台灣50群益9A售08,,,,,0.00,0.00,0,0,0,0,0,0,0,0,0,0,0,0,0
20200520,07331P,臺股指群益99售22,,,,,0.00,0.00,0,0,0,0,0,0,0,0,0,0,0,0,0
20200520,07332P,臺股指群益99售23,,,,,0.00,0.00,0,0,0,0,0,0,0,0,0,0,0,0,0
20200520,07333P,台灣50國票9B售03,,,,,0.00,0.00,0,0,0,0,0,0,0,0,0,0,0,0,0
20200520,07334P,臺股指國票99售19,0.90,0.92,0.90,0.92,-0.02,-2.13,376000,19,342330,0,0,0,0,0,0,142000,234000,-92000,-92000
20200520,07335P,臺股指國票99售20,,,,,0.00,0.00,0,0,0,0,0,0,0,0,0,0,0,0,0
20200520,07336P,台灣50台新99售05,,,,,0.00,0.00,0,0,0,0,0,0,0,0,0,0,0,0,0
20200520,07337P,台灣50凱基99售09,,,,,0.00,0.00,0,0,0,0,0,0,0,0,0,0,0,0,0
20200520,07338P,滬深2X凱基99售02,,,,,0.00,0.00,0,0,0,0,0,0,0,0,0,0,0,0,0
20200520,07339P,滬深2X凱基9A售03,,,,,0.00,0.00,0,0,0,0,0,0,0,0,0,0,0,0,0
20200520,07340P,鴻海凱基99售15,,,,,0.00,0.00,0,0,0,0,0,0,0,0,0,0,0,0,0
20200520,07341P,台積電凱基99售18,0.55,0.55,0.54,0.54,-0.01,-1.82,61000,6,33460,0,0,0,0,0,0,1000,50000,-49000,-49000
20200520,07342P,大立光凱基99售14,0.82,0.83,0.81,0.82,-0.02,-2.38,382000,7,315750,0,0,0,0,0,0,28000,334000,-306000,-306000
20200520,07343P,高鐵康和99售01,,,,,0.00,0.00,0,0,0,0,0,0,0,0,0,0,0,0,0
20200520,07344P,鴻海富邦9A售03,1.07,1.08,1.06,1.08,0.00,0.00,74000,4,79550,0,0,0,0,0,0,16000,58000,-42000,-42000
20200520,07345P,台灣50永豐99售10,,,,,0.00,0.00,0,0,0,0,0,0,0,0,0,0,0,0,0
20200520,07346P,FBVIX群益99售04,,,,,0.00,0.00,0,0,0,0,0,0,0,0,0,0,0,0,0
20200520,07347P,上証2X凱基99售02,1.02,1.02,1.02,1.02,0.00,0.00,200000,1,204000,0,0,0,0,0,0,0,200000,-200000,-200000
20200520,07348P,滬深2X凱基9A售04,,,,,0.00,0.00,0,0,0,0,0,0,0,0,0,0,0,0,0
20200520,07349P,大立光凱基99售16,,,,,0.00,0.00,0,0,0,0,0,0,0,0,0,0,0,0,0
20200520,07350P,台灣50國票99售11,,,,,0.00,0.00,0,0,0,0,0,0,0,0,0,0,0,0,0
20200520,07351P,鴻海國票99售08,1.35,1.38,1.35,1.38,+0.06,4.55,112000,3,153300,0,0,0,0,0,0,42000,70000,-28000,-28000
20200520,07352P,台積電國票99售11,1.88,1.89,1.88,1.89,0.00,0.00,4000,2,7540,0,0,0,0,0,0,0,4000,-4000,-4000
20200520,07353P,大立光國票99售02,,,,,0.00,0.00,0,0,0,0,0,0,0,0,0,0,0,0,0
20200520,07354P,臺股指國票99售22,1.23,1.25,1.23,1.25,-0.03,-2.34,50000,2,61900,0,0,0,0,0,0,20000,30000,-10000,-10000
20200520,07355P,臺股指國票99售23,1.51,1.55,1.51,1.55,0.00,0.00,20000,2,30240,0,0,0,0,0,0,0,20000,-20000,-20000
20200520,07356P,臺股指國票99售24,,,,,0.00,0.00,0,0,0,0,0,0,0,0,0,0,0,0,0
20200520,07357P,鴻海元大99售38,1.32,1.33,1.32,1.33,+0.01,0.76,51000,2,67820,0,0,0,0,0,0,50000,1000,49000,49000
20200520,07358P,鴻海元大99售39,1.78,1.81,1.78,1.81,+0.01,0.56,50000,4,89250,0,0,0,0,0,0,35000,15000,20000,20000
20200520,07359P,台積電元大99售45,1.51,1.51,1.51,1.51,0.00,0.00,79000,1,119290,0,0,0,0,0,0,0,79000,-79000,-79000
20200520,07360P,台積電元大99售46,,,,,0.00,0.00,0,0,0,0,0,0,0,0,0,0,0,0,0
20200520,07361P,聯發科元大99售34,0.66,0.68,0.64,0.68,-0.03,-4.23,24000,3,15720,0,0,0,0,0,0,0,24000,-24000,-24000
20200520,07362P,聯發科元大99售35,,,,,0.00,0.00,0,0,0,0,0,0,0,0,0,0,0,0,0
20200520,07363P,大立光元大99售26,1.42,1.43,1.40,1.43,-0.04,-2.72,190000,8,268310,0,0,0,0,0,0,118000,72000,46000,46000
20200520,07364P,大立光元大99售27,,,,,0.00,0.00,0,0,0,0,0,0,0,0,0,0,0,0,0
20200520,07365P,超眾元大99售07,2.15,2.15,2.15,2.15,0.00,0.00,21000,1,45150,0,0,0,0,0,0,0,21000,-21000,-21000
20200520,07366P,國巨康和99售02,1.01,1.01,0.86,0.93,-0.09,-8.82,3814000,51,3466700,0,0,0,0,0,0,1977000,1836000,141000,141000
20200520,07367P,鴻海凱基99售17,,,,,0.00,0.00,0,0,0,0,0,0,0,0,0,0,0,0,0
20200520,07368P,國巨凱基99售19,0.43,0.43,0.19,0.42,-0.04,-8.7,150000,15,61100,0,0,0,0,0,0,140000,0,140000,140000
20200520,07369P,台積電凱基99售20,0.61,0.61,0.61,0.61,0.00,0.00,20000,2,12200,0,0,0,0,0,0,0,20000,-20000,-20000
20200520,07370P,南亞科凱基99售08,0.67,0.70,0.67,0.68,-0.05,-6.85,764000,8,513550,0,0,0,0,0,0,760000,4000,756000,756000
20200520,07371P,滬深2X元大99售07,,,,,0.00,0.00,0,0,0,0,0,0,0,0,0,0,0,0,0
20200520,07372P,滬深2X元大99售08,,,,,0.00,0.00,0,0,0,0,0,0,0,0,0,0,0,0,0
20200520,07373P,A50正2元大99售01,,,,,0.00,0.00,0,0,0,0,0,0,0,0,0,0,0,0,0
20200520,07374P,鴻海元大99售41,1.19,1.19,1.19,1.19,-0.01,-0.83,50000,1,59500,0,0,0,0,0,0,50000,0,50000,50000
20200520,07375P,台積電元大99售48,,,,,0.00,0.00,0,0,0,0,0,0,0,0,0,0,0,0,0
20200520,07376P,聯發科元大99售39,0.54,0.54,0.54,0.54,-0.03,-5.26,59000,2,31860,0,0,0,0,0,0,55000,4000,51000,51000
20200520,07377P,聯發科元大99售40,0.71,0.71,0.65,0.70,-0.04,-5.41,230000,7,161150,0,0,0,0,0,0,105000,125000,-20000,-20000
20200520,07378P,大立光元大99售29,1.81,1.81,1.81,1.81,0.00,0.00,31000,3,56110,0,0,0,0,0,0,0,31000,-31000,-31000
20200520,07379P,大立光元大99售30,1.37,1.37,1.37,1.37,0.00,0.00,3000,1,4110,0,0,0,0,0,0,3000,0,3000,3000
20200520,07380P,台灣50群益9A售11,,,,,0.00,0.00,0,0,0,0,0,0,0,0,0,0,0,0,0
20200520,07381P,鴻海群益99售05,1.93,1.94,1.93,1.94,-0.01,-0.51,100000,3,193610,0,0,0,0,0,0,100000,0,100000,100000
20200520,07382P,台積電群益9B售01,1.17,1.17,1.17,1.17,0.00,0.00,20000,1,23400,0,0,0,0,0,0,0,20000,-20000,-20000
20200520,07383P,聯發科群益99售06,0.39,0.39,0.39,0.39,-0.06,-13.33,30000,1,11700,0,0,0,0,0,0,0,30000,-30000,-30000
20200520,07384P,大立光群益9A售01,1.63,1.63,1.63,1.63,+0.04,2.52,1000,1,1630,0,0,0,0,0,0,1000,0,1000,1000
20200520,07385P,緯穎群益99售04,2.23,2.28,2.23,2.28,+0.13,6.05,21000,2,47830,0,0,0,0,0,0,0,21000,-21000,-21000
20200520,07386P,臺股指群益99售24,1.74,1.74,1.74,1.74,-0.01,-0.57,2000,1,3480,0,0,0,0,0,0,0,2000,-2000,-2000
20200520,07387P,臺股指群益99售25,2.04,2.04,2.04,2.04,-0.03,-1.45,20000,1,40800,0,0,0,0,0,0,0,20000,-20000,-20000
20200520,07388P,臺股指群益9C售07,2.47,2.50,2.47,2.50,-0.02,-0.79,6000,2,14850,0,0,0,0,0,0,0,6000,-6000,-6000
20200520,07389P,臺股指群益9C售08,2.14,2.14,2.14,2.14,0.00,0.00,3000,1,6420,0,0,0,0,0,0,0,3000,-3000,-3000
20200520,07390P,華新科康和99售02,0.84,0.84,0.84,0.84,-0.03,-3.45,50000,1,42000,0,0,0,0,0,0,0,50000,-50000,-50000
20200520,07391P,台灣50國泰02售01,0.71,0.71,0.71,0.71,-0.01,-1.39,138000,4,97980,0,0,0,0,0,0,108000,30000,78000,78000
20200520,07392P,台積電國泰02售01,0.76,0.77,0.76,0.77,0.00,0.00,9000,3,6880,0,0,0,0,0,0,0,9000,-9000,-9000
20200520,07393P,台灣50富邦9B售02,,,,,0.00,0.00,0,0,0,0,0,0,0,0,0,0,0,0,0
20200520,07394P,國巨群益99售12,1.09,1.09,1.09,1.09,-0.06,-5.22,1000,1,1090,0,0,0,0,0,0,0,1000,-1000,-1000
20200520,07395P,台積電群益99售13,,,,,0.00,0.00,0,0,0,0,0,0,0,0,0,0,0,0,0
20200520,07396P,聯發科群益9B售01,0.77,0.77,0.77,0.77,-0.02,-2.53,10000,1,7700,0,0,0,0,0,0,0,10000,-10000,-10000
20200520,07397P,大立光群益99售10,,,,,0.00,0.00,0,0,0,0,0,0,0,0,0,0,0,0,0
20200520,07398P,鴻海凱基99售18,,,,,0.00,0.00,0,0,0,0,0,0,0,0,0,0,0,0,0
20200520,07399P,鴻海凱基99售19,0.82,0.82,0.82,0.82,+0.02,2.5,5000,1,4100,0,0,0,0,0,0,5000,0,5000,5000
20200520,07400P,國巨凱基99售20,0.50,0.50,0.50,0.50,-0.02,-3.85,24000,2,12000,0,0,0,0,0,0,24000,0,24000,24000
20200520,07401P,台積電凱基99售21,,,,,0.00,0.00,0,0,0,0,0,0,0,0,0,0,0,0,0
20200520,07402P,瑞昱凱基99售02,0.61,0.61,0.61,0.61,+0.01,1.67,50000,1,30500,0,0,0,0,0,0,50000,0,50000,50000
20200520,07403P,聯發科凱基99售21,0.45,0.45,0.45,0.45,0.00,0.00,10000,1,4500,0,0,0,0,0,0,0,10000,-10000,-10000
20200520,07404P,華新科凱基99售10,,,,,0.00,0.00,0,0,0,0,0,0,0,0,0,0,0,0,0
20200520,07405P,大立光凱基99售17,,,,,0.00,0.00,0,0,0,0,0,0,0,0,0,0,0,0,0
20200520,07406P,大立光凱基99售18,1.00,1.00,1.00,1.00,0.00,0.00,10000,1,10000,0,0,0,0,0,0,0,10000,-10000,-10000
20200520,07407P,欣興凱基99售07,0.51,0.54,0.49,0.52,-0.02,-3.7,550000,32,279110,0,0,0,0,0,0,457000,85000,372000,372000
20200520,07408P,台積電兆豐99售06,0.40,0.41,0.40,0.40,-0.01,-2.44,147000,8,59570,0,0,0,0,0,0,0,147000,-147000,-147000
20200520,07409P,台積電台新99售07,0.41,0.41,0.41,0.41,0.00,0.00,50000,1,20500,0,0,0,0,0,0,0,50000,-50000,-50000
20200520,07410P,鴻海元大99售44,1.59,1.61,1.59,1.61,+0.01,0.62,128000,8,204260,0,0,0,0,0,0,50000,78000,-28000,-28000
20200520,07411P,國巨元大99售31,1.13,1.19,1.13,1.18,-0.08,-6.35,161000,3,184990,0,0,0,0,0,0,60000,101000,-41000,-41000
20200520,07412P,國巨元大99售32,1.08,1.08,1.08,1.08,-0.09,-7.69,1000,1,1080,0,0,0,0,0,0,1000,0,1000,1000
20200520,07413P,國巨元大99售33,0.94,0.94,0.89,0.91,-0.06,-6.19,15000,4,13670,0,0,0,0,0,0,12000,3000,9000,9000
20200520,07414P,台積電元大99售51,,,,,0.00,0.00,0,0,0,0,0,0,0,0,0,0,0,0,0
20200520,07415P,台積電元大99售52,2.62,2.62,2.62,2.62,0.00,0.00,1000,1,2620,0,0,0,0,0,0,0,1000,-1000,-1000
20200520,07416P,台積電元大99售53,2.01,2.03,2.00,2.00,-0.05,-2.44,119000,8,240460,0,0,0,0,0,0,13000,106000,-93000,-93000
20200520,07417P,聯發科元大99售44,1.08,1.08,1.08,1.08,-0.06,-5.26,20000,2,21600,0,0,0,0,0,0,10000,10000,0,0
20200520,07418P,聯發科元大99售45,0.87,0.94,0.87,0.93,-0.05,-5.1,106000,9,93290,0,0,0,0,0,0,0,106000,-106000,-106000
20200520,07419P,聯發科元大99售46,0.73,0.73,0.67,0.72,-0.04,-5.26,50000,5,35200,0,0,0,0,0,0,10000,40000,-30000,-30000
20200520,07420P,可成元大99售07,1.29,1.32,1.28,1.31,+0.13,11.02,348000,8,449460,0,0,0,0,0,0,154000,194000,-40000,-40000
20200520,07421P,國泰金元大99售01,1.05,1.07,1.05,1.07,-0.01,-0.93,6000,2,6360,0,0,0,0,0,0,0,6000,-6000,-6000
20200520,07422P,大立光元大99售32,1.97,1.97,1.97,1.97,0.00,0.00,20000,1,39400,0,0,0,0,0,0,0,20000,-20000,-20000
20200520,07423P,大立光元大99售33,3.28,3.28,3.23,3.23,-0.06,-1.82,65000,3,211200,0,0,0,0,0,0,25000,40000,-15000,-15000
20200520,07424P,大立光元大9B售01,,,,,0.00,0.00,0,0,0,0,0,0,0,0,0,0,0,0,0
20200520,07425P,台灣50國票9A售10,,,,,0.00,0.00,0,0,0,0,0,0,0,0,0,0,0,0,0
20200520,07426P,上証2X國票9B售01,0.84,0.86,0.84,0.85,-0.02,-2.3,51000,3,43160,0,0,0,0,0,0,0,51000,-51000,-51000
20200520,07427P,台積電國票9B售02,,,,,0.00,0.00,0,0,0,0,0,0,0,0,0,0,0,0,0
20200520,07428P,華新科國票9A售01,2.33,2.33,2.33,2.33,-0.08,-3.32,50000,1,116500,0,0,0,0,0,0,50000,0,50000,50000
20200520,07429P,臺股指國票9A售01,1.17,1.17,1.17,1.17,0.00,0.00,2000,1,2340,0,0,0,0,0,0,0,2000,-2000,-2000
20200520,07430P,臺股指國票9A售02,,,,,0.00,0.00,0,0,0,0,0,0,0,0,0,0,0,0,0
20200520,07431P,臺股指國票9A售03,,,,,0.00,0.00,0,0,0,0,0,0,0,0,0,0,0,0,0
20200520,07432P,臺股指國票9A售04,,,,,0.00,0.00,0,0,0,0,0,0,0,0,0,0,0,0,0
20200520,07433P,臺股指國票9A售05,,,,,0.00,0.00,0,0,0,0,0,0,0,0,0,0,0,0,0
20200520,07434P,臺股指國票9A售06,0.96,0.96,0.94,0.94,-0.05,-5.05,24000,3,22800,0,0,0,0,0,0,0,24000,-24000,-24000
20200520,07435P,台積電富邦9C售07,,,,,0.00,0.00,0,0,0,0,0,0,0,0,0,0,0,0,0
20200520,07436P,臺股指麥證9A售03,,,,,0.00,0.00,0,0,0,0,0,0,0,0,0,0,0,0,0
20200520,07437P,臺股指麥證9A售04,,,,,0.00,0.00,0,0,0,0,0,0,0,0,0,0,0,0,0
20200520,07438P,臺股指麥證9A售05,,,,,0.00,0.00,0,0,0,0,0,0,0,0,0,0,0,0,0
20200520,07439P,臺股指麥證9B售01,,,,,0.00,0.00,0,0,0,0,0,0,0,0,0,0,0,0,0
20200520,07440P,臺股指麥證9B售02,,,,,0.00,0.00,0,0,0,0,0,0,0,0,0,0,0,0,0
20200520,07441P,臺股指麥證9B售03,,,,,0.00,0.00,0,0,0,0,0,0,0,0,0,0,0,0,0
20200520,07442P,華航康和9A售02,0.33,0.36,0.33,0.36,0.00,0.00,71000,5,24600,0,0,0,0,0,0,71000,0,71000,71000
20200520,07443P,鴻海凱基9A售18,,,,,0.00,0.00,0,0,0,0,0,0,0,0,0,0,0,0,0
20200520,07444P,聯發科凱基9A售10,0.47,0.49,0.47,0.49,-0.02,-3.92,12000,3,5840,0,0,0,0,0,0,0,12000,-12000,-12000
20200520,07445P,大立光凱基9A售08,0.79,0.79,0.79,0.79,-0.03,-3.66,15000,1,11850,0,0,0,0,0,0,15000,0,15000,15000
20200520,07446P,台灣50元大9A售06,,,,,0.00,0.00,0,0,0,0,0,0,0,0,0,0,0,0,0
20200520,07447P,台灣50元大9A售07,,,,,0.00,0.00,0,0,0,0,0,0,0,0,0,0,0,0,0
20200520,07448P,台灣50元大9A售08,,,,,0.00,0.00,0,0,0,0,0,0,0,0,0,0,0,0,0
20200520,07449P,臺指反元大01售01,,,,,0.00,0.00,0,0,0,0,0,0,0,0,0,0,0,0,0
20200520,07450P,鴻海元大9A售03,1.56,1.56,1.56,1.56,-0.01,-0.64,50000,1,78000,0,0,0,0,0,0,50000,0,50000,50000
20200520,07451P,鴻海元大9B售01,1.32,1.33,1.32,1.33,+0.02,1.53,50000,4,66200,0,0,0,0,0,0,0,50000,-50000,-50000
20200520,07452P,國巨元大9A售05,0.87,0.87,0.85,0.85,-0.12,-12.37,25000,3,21650,0,0,0,0,0,0,5000,20000,-15000,-15000
20200520,07453P,台積電元大9A售05,1.42,1.42,1.42,1.42,0.00,0.00,1000,1,1420,0,0,0,0,0,0,0,1000,-1000,-1000
20200520,07454P,台積電元大9A售06,,,,,0.00,0.00,0,0,0,0,0,0,0,0,0,0,0,0,0
20200520,07455P,聯發科元大9A售01,,,,,0.00,0.00,0,0,0,0,0,0,0,0,0,0,0,0,0
20200520,07456P,華新科元大9A售06,1.18,1.18,1.15,1.15,-0.06,-4.96,215000,2,253250,0,0,0,0,0,0,15000,200000,-185000,-185000
20200520,07457P,宏達電元大9A售01,1.52,1.57,1.52,1.57,-0.02,-1.26,27000,6,41720,0,0,0,0,0,0,8000,19000,-11000,-11000
20200520,07458P,長榮航元大9A售01,0.55,0.56,0.55,0.56,-0.03,-5.08,371000,8,207160,0,0,0,0,0,0,270000,51000,219000,219000
20200520,07459P,緯穎元大9A售01,0.80,0.81,0.80,0.81,+0.01,1.25,40000,2,32100,0,0,0,0,0,0,40000,0,40000,40000
20200520,07460P,臺股指元大9B售03,,,,,0.00,0.00,0,0,0,0,0,0,0,0,0,0,0,0,0
20200520,07461P,臺股指元大9B售04,,,,,0.00,0.00,0,0,0,0,0,0,0,0,0,0,0,0,0
20200520,07462P,臺股指元大9B售05,1.19,1.19,1.19,1.19,-0.01,-0.83,317000,8,377230,0,0,0,0,0,0,151000,166000,-15000,-15000
20200520,07463P,台積電國票9A售05,0.79,0.79,0.79,0.79,-0.01,-1.25,30000,2,23700,0,0,0,0,0,0,30000,0,30000,30000
20200520,07464P,台灣50兆豐9A售02,,,,,0.00,0.00,0,0,0,0,0,0,0,0,0,0,0,0,0
20200520,07465P,台灣50元大9C售24,,,,,0.00,0.00,0,0,0,0,0,0,0,0,0,0,0,0,0
20200520,07466P,亞德客元大9A售02,1.44,1.44,1.42,1.42,-0.02,-1.39,61000,2,87240,0,0,0,0,0,0,30000,31000,-1000,-1000
20200520,07467P,上銀元大9A售03,0.98,1.02,0.98,1.02,-0.01,-0.97,101000,2,99020,0,0,0,0,0,0,100000,1000,99000,99000
20200520,07468P,聯電元大9A售02,0.62,0.66,0.62,0.66,+0.02,3.12,136000,6,87240,0,0,0,0,0,0,1000,135000,-134000,-134000
20200520,07469P,台達電元大9A售01,0.80,0.82,0.80,0.82,0.00,0.00,177000,3,144320,0,0,0,0,0,0,72000,105000,-33000,-33000
20200520,07470P,國巨元大9A售06,1.12,1.12,1.10,1.11,-0.07,-5.93,24000,4,26720,0,0,0,0,0,0,1000,23000,-22000,-22000
20200520,07471P,南亞科元大9A售01,1.78,1.84,1.77,1.84,-0.08,-4.17,89000,5,160800,0,0,0,0,0,0,61000,29000,32000,32000
20200520,07472P,和碩元大9A售03,2.10,2.12,2.09,2.12,-0.03,-1.4,578000,26,1221270,0,0,0,0,0,0,221000,357000,-136000,-136000
20200520,07473P,祥碩元大9A售01,1.03,1.03,0.95,0.95,-0.11,-10.38,429000,16,416180,0,0,0,0,0,0,271000,429000,-158000,-158000
20200520,07474P,滬深2X群益9C售03,1.33,1.33,1.33,1.33,+0.01,0.76,2000,1,2660,0,0,0,0,0,0,2000,0,2000,2000
20200520,07475P,A50正2群益9C售02,1.54,1.54,1.54,1.54,0.00,0.00,250000,1,385000,0,0,0,0,0,0,250000,0,250000,250000
20200520,07476P,鴻海群益9A售04,1.35,1.38,1.33,1.38,-0.02,-1.43,130000,4,175400,0,0,0,0,0,0,110000,20000,90000,90000
20200520,07477P,國巨群益9A售04,,,,,0.00,0.00,0,0,0,0,0,0,0,0,0,0,0,0,0
20200520,07478P,南電康和9A售02,0.99,0.99,0.82,0.93,+0.01,1.09,761000,82,687920,0,0,0,0,0,0,563000,197000,366000,366000
20200520,07479P,A50正2元富9A售03,,,,,0.00,0.00,0,0,0,0,0,0,0,0,0,0,0,0,0
20200520,07481P,大立光台新9A售01,,,,,0.00,0.00,0,0,0,0,0,0,0,0,0,0,0,0,0
20200520,07482P,南亞科元富9A售04,1.15,1.16,1.13,1.16,-0.04,-3.33,73000,14,83810,0,0,0,0,0,0,23000,45000,-22000,-22000
20200520,07483P,國巨台新9A售01,,,,,0.00,0.00,0,0,0,0,0,0,0,0,0,0,0,0,0
20200520,07484P,台灣50凱基04售02,,,,,0.00,0.00,0,0,0,0,0,0,0,0,0,0,0,0,0
20200520,07485P,台灣50凱基04售03,,,,,0.00,0.00,0,0,0,0,0,0,0,0,0,0,0,0,0
20200520,07486P,上証2X國票9B售02,1.74,1.74,1.73,1.73,-0.02,-1.14,35000,2,60700,0,0,0,0,0,0,0,35000,-35000,-35000
20200520,07487P,鴻海國票9A售01,,,,,0.00,0.00,0,0,0,0,0,0,0,0,0,0,0,0,0
20200520,07488P,鴻海國票9A售02,,,,,0.00,0.00,0,0,0,0,0,0,0,0,0,0,0,0,0
20200520,07489P,國巨國票9A售07,,,,,0.00,0.00,0,0,0,0,0,0,0,0,0,0,0,0,0
20200520,07490P,大立光國票9A售03,2.33,2.33,2.33,2.33,-0.13,-5.28,38000,1,88540,0,0,0,0,0,0,38000,0,38000,38000
20200520,07491P,臺股指國票9A售09,0.64,0.64,0.64,0.64,-0.02,-3.03,460000,1,294400,0,0,0,0,0,0,0,460000,-460000,-460000
20200520,07492P,臺股指國票9A售10,0.69,0.69,0.69,0.69,0.00,0.00,5000,1,3450,0,0,0,0,0,0,0,5000,-5000,-5000
20200520,07493P,台灣50元大9A售10,,,,,0.00,0.00,0,0,0,0,0,0,0,0,0,0,0,0,0
20200520,07494P,葡萄王元大9A售03,2.00,2.03,2.00,2.03,0.00,0.00,105000,3,212000,0,0,0,0,0,0,5000,100000,-95000,-95000
20200520,07495P,鴻海元大9A售04,,,,,0.00,0.00,0,0,0,0,0,0,0,0,0,0,0,0,0
20200520,07496P,鴻海元大9A售05,,,,,0.00,0.00,0,0,0,0,0,0,0,0,0,0,0,0,0
20200520,07497P,鴻海元大9A售06,1.55,1.55,1.55,1.55,-0.01,-0.64,50000,1,77500,0,0,0,0,0,0,50000,0,50000,50000
20200520,07498P,台積電元大9A售09,,,,,0.00,0.00,0,0,0,0,0,0,0,0,0,0,0,0,0
20200520,07499P,台積電元大9A售12,,,,,0.00,0.00,0,0,0,0,0,0,0,0,0,0,0,0,0
20200520,07500P,微星元大9A售01,1.16,1.24,1.14,1.22,-0.01,-0.81,113000,7,133260,0,0,0,0,0,0,60000,53000,7000,7000
20200520,07501P,華新科元大9A售07,1.31,1.31,1.31,1.31,-0.06,-4.38,1000,1,1310,0,0,0,0,0,0,1000,0,1000,1000
20200520,07502P,美食元大9A售01,1.21,1.35,1.21,1.35,+0.08,6.3,258000,5,328300,0,0,0,0,0,0,158000,100000,58000,58000
20200520,07503P,禾伸堂元大9A售01,0.85,0.87,0.85,0.87,-0.04,-4.4,149000,3,128650,0,0,0,0,0,0,49000,100000,-51000,-51000
20200520,07504P,聯詠元大9A售02,1.78,1.79,1.74,1.74,-0.04,-2.25,70000,4,124350,0,0,0,0,0,0,0,70000,-70000,-70000
20200520,07505P,台勝科元大9A售01,1.24,1.25,1.17,1.18,-0.04,-3.28,184000,13,220760,0,0,0,0,0,0,40000,144000,-104000,-104000
20200520,07506P,中租元大9A售01,1.09,1.10,1.09,1.10,-0.02,-1.79,216000,6,236200,0,0,0,0,0,0,100000,116000,-16000,-16000
20200520,07507P,國巨國票9B售02,,,,,0.00,0.00,0,0,0,0,0,0,0,0,0,0,0,0,0
20200520,07508P,華新科國票9A售03,,,,,0.00,0.00,0,0,0,0,0,0,0,0,0,0,0,0,0
20200520,07509P,牧德國票9A售03,0.84,0.84,0.71,0.71,-0.21,-22.83,91000,4,72390,0,0,0,0,0,0,33000,58000,-25000,-25000
20200520,07510P,台灣50元富04售02,,,,,0.00,0.00,0,0,0,0,0,0,0,0,0,0,0,0,0
20200520,07511P,鴻海元大9B售02,,,,,0.00,0.00,0,0,0,0,0,0,0,0,0,0,0,0,0
20200520,07512P,國巨元大9A售08,,,,,0.00,0.00,0,0,0,0,0,0,0,0,0,0,0,0,0
20200520,07513P,台積電元大9A售13,1.51,1.51,1.51,1.51,-0.03,-1.95,5000,1,7550,0,0,0,0,0,0,0,5000,-5000,-5000
20200520,07514P,台積電元大9A售14,0.94,0.94,0.94,0.94,0.00,0.00,10000,1,9400,0,0,0,0,0,0,0,10000,-10000,-10000
20200520,07515P,台積電元大9A售15,,,,,0.00,0.00,0,0,0,0,0,0,0,0,0,0,0,0,0
20200520,07516P,台積電元大9A售16,,,,,0.00,0.00,0,0,0,0,0,0,0,0,0,0,0,0,0
20200520,07517P,台積電元大9A售17,0.71,0.71,0.69,0.69,0.00,0.00,2000,2,1400,0,0,0,0,0,0,0,2000,-2000,-2000
20200520,07518P,臺股指元大9B售09,,,,,0.00,0.00,0,0,0,0,0,0,0,0,0,0,0,0,0
20200520,07519P,臺股指元大9B售10,0.99,0.99,0.98,0.98,-0.02,-2.0,15000,2,14800,0,0,0,0,0,0,5000,10000,-5000,-5000
20200520,07520P,臺股指元大9B售11,1.00,1.00,0.99,0.99,-0.03,-2.94,27000,5,26850,0,0,0,0,0,0,5000,22000,-17000,-17000
20200520,07521P,台積電中信01售05,,,,,0.00,0.00,0,0,0,0,0,0,0,0,0,0,0,0,0
20200520,07522P,台積電中信9A售03,,,,,0.00,0.00,0,0,0,0,0,0,0,0,0,0,0,0,0
20200520,07523P,台積電中信9C售05,,,,,0.00,0.00,0,0,0,0,0,0,0,0,0,0,0,0,0
20200520,07524P,臺股指中信9B售06,0.71,0.72,0.71,0.72,-0.01,-1.37,125000,7,88950,0,0,0,0,0,0,0,125000,-125000,-125000
20200520,07525P,臺股指中信9B售07,0.58,0.58,0.58,0.58,-0.02,-3.33,28000,3,16240,0,0,0,0,0,0,0,28000,-28000,-28000
20200520,07526P,臺股指中信9B售08,,,,,0.00,0.00,0,0,0,0,0,0,0,0,0,0,0,0,0
20200520,07527P,台灣50凱基9B售02,1.15,1.18,1.15,1.17,-0.01,-0.85,203000,11,236380,0,0,0,0,0,0,53000,150000,-97000,-97000
20200520,07528P,鴻海凱基9A售19,,,,,0.00,0.00,0,0,0,0,0,0,0,0,0,0,0,0,0
20200520,07529P,國巨凱基9A售11,0.62,0.62,0.60,0.60,0.00,0.00,7000,2,4260,0,0,0,0,0,0,0,7000,-7000,-7000
20200520,07530P,聯發科凱基9A售11,0.52,0.53,0.50,0.53,-0.02,-3.64,644000,15,329190,0,0,0,0,0,0,80000,564000,-484000,-484000
20200520,07531P,大立光國泰9B售03,1.83,1.86,1.82,1.83,-0.05,-2.66,142000,10,260870,0,0,0,0,0,0,8000,134000,-126000,-126000
20200520,07532P,台灣50中信01售02,0.73,0.73,0.72,0.72,0.00,0.00,35000,2,25300,0,0,0,0,0,0,25000,10000,15000,15000
20200520,07533P,臺股指中信9C售04,0.73,0.74,0.73,0.74,0.00,0.00,25000,3,18300,0,0,0,0,0,0,10000,15000,-5000,-5000
20200520,07534P,台灣50群益9A售12,,,,,0.00,0.00,0,0,0,0,0,0,0,0,0,0,0,0,0
20200520,07535P,上銀元富9A售03,1.17,1.23,1.17,1.22,+0.02,1.67,17000,4,20780,0,0,0,0,0,0,2000,15000,-13000,-13000
20200520,07536P,華新科元富9A售04,1.38,1.40,1.34,1.40,+0.01,0.72,352000,9,491560,0,0,0,0,0,0,11000,341000,-330000,-330000
20200520,07537P,玉晶光元富9A售04,1.67,1.67,1.61,1.61,-0.07,-4.17,17000,2,27850,0,0,0,0,0,0,9000,8000,1000,1000
20200520,07538P,玉晶光元富9A售05,,,,,0.00,0.00,0,0,0,0,0,0,0,0,0,0,0,0,0
20200520,07539P,玉山金台新9A售01,,,,,0.00,0.00,0,0,0,0,0,0,0,0,0,0,0,0,0
20200520,07540P,鴻海凱基9A售21,,,,,0.00,0.00,0,0,0,0,0,0,0,0,0,0,0,0,0
20200520,07541P,國巨凱基9A售12,,,,,0.00,0.00,0,0,0,0,0,0,0,0,0,0,0,0,0
20200520,07542P,台積電凱基9A售16,1.32,1.32,1.32,1.32,0.00,0.00,20000,2,26400,0,0,0,0,0,0,20000,0,20000,20000
20200520,07543P,台積電凱基9A售17,1.09,1.09,1.09,1.09,0.00,0.00,110000,1,119900,0,0,0,0,0,0,0,110000,-110000,-110000
20200520,07544P,大立光凱基9A售09,1.50,1.51,1.50,1.51,-0.04,-2.58,94000,3,141900,0,0,0,0,0,0,94000,0,94000,94000
20200520,07545P,玉晶光凱基9A售07,0.46,0.83,0.46,0.79,-0.03,-3.66,386000,15,310430,0,0,0,0,0,0,27000,347000,-320000,-320000
20200520,07546P,玉晶光凱基9A售09,0.57,0.57,0.54,0.54,-0.03,-5.26,1678000,20,931280,0,0,0,0,0,0,590000,1068000,-478000,-478000
20200520,07547P,緯穎凱基9A售05,,,,,0.00,0.00,0,0,0,0,0,0,0,0,0,0,0,0,0
20200520,07548P,台灣50元大9A售12,1.94,1.94,1.93,1.93,0.00,0.00,2000,2,3870,0,0,0,0,0,0,0,2000,-2000,-2000
20200520,07549P,台灣50元大9A售13,,,,,0.00,0.00,0,0,0,0,0,0,0,0,0,0,0,0,0
20200520,07550P,國巨元大9A售09,,,,,0.00,0.00,0,0,0,0,0,0,0,0,0,0,0,0,0
20200520,07551P,國巨元大9A售10,,,,,0.00,0.00,0,0,0,0,0,0,0,0,0,0,0,0,0
20200520,07552P,技嘉元大9A售03,0.83,0.85,0.82,0.85,0.00,0.00,124000,9,103220,0,0,0,0,0,0,114000,10000,104000,104000
20200520,07553P,嘉晶元大9A售02,1.19,1.19,1.04,1.06,-0.17,-13.82,153000,19,173880,0,0,0,0,0,0,70000,132000,-62000,-62000
20200520,07554P,玉晶光元大9A售06,,,,,0.00,0.00,0,0,0,0,0,0,0,0,0,0,0,0,0
20200520,07555P,玉晶光元大9A售07,1.29,1.29,1.25,1.25,-0.06,-4.58,37000,2,47610,0,0,0,0,0,0,34000,3000,31000,31000
20200520,07556P,玉晶光元大9A售08,,,,,0.00,0.00,0,0,0,0,0,0,0,0,0,0,0,0,0
20200520,07557P,玉晶光元大9A售09,1.02,1.02,1.02,1.02,-0.05,-4.67,100000,1,102000,0,0,0,0,0,0,100000,0,100000,100000
20200520,07558P,玉晶光元大9A售10,1.59,1.59,1.48,1.48,-0.10,-6.33,52000,5,79770,0,0,0,0,0,0,22000,30000,-8000,-8000
20200520,07559P,祥碩元大9A售03,0.71,0.71,0.65,0.67,-0.07,-9.46,885000,34,603840,0,0,0,0,0,0,368000,515000,-147000,-147000
20200520,07560P,台積電國泰9B售01,2.41,2.43,2.40,2.43,0.00,0.00,140000,3,339250,0,0,0,0,0,0,15000,125000,-110000,-110000
20200520,07561P,玉晶光永豐9A售02,0.82,0.82,0.80,0.80,-0.03,-3.61,56000,2,45800,0,0,0,0,0,0,0,56000,-56000,-56000
20200520,07562P,台灣50第一9A售01,,,,,0.00,0.00,0,0,0,0,0,0,0,0,0,0,0,0,0
20200520,07563P,台灣50中信04售01,,,,,0.00,0.00,0,0,0,0,0,0,0,0,0,0,0,0,0
20200520,07564P,臺股指中信01售01,1.42,1.42,1.42,1.42,0.00,0.00,5000,1,7100,0,0,0,0,0,0,0,5000,-5000,-5000
20200520,07565P,台灣50台新9C售02,,,,,0.00,0.00,0,0,0,0,0,0,0,0,0,0,0,0,0
20200520,07566P,台積電台新9B售02,1.08,1.08,1.08,1.08,0.00,0.00,10000,1,10800,0,0,0,0,0,0,0,10000,-10000,-10000
20200520,07567P,台灣50凱基01售05,,,,,0.00,0.00,0,0,0,0,0,0,0,0,0,0,0,0,0
20200520,07568P,鴻海凱基9A售22,0.87,0.87,0.87,0.87,+0.02,2.35,50000,2,43500,0,0,0,0,0,0,0,50000,-50000,-50000
20200520,07569P,國巨凱基9A售13,,,,,0.00,0.00,0,0,0,0,0,0,0,0,0,0,0,0,0
20200520,07570P,旺宏凱基9A售04,,,,,0.00,0.00,0,0,0,0,0,0,0,0,0,0,0,0,0
20200520,07571P,台灣50元大9A售14,,,,,0.00,0.00,0,0,0,0,0,0,0,0,0,0,0,0,0
20200520,07572P,台灣50元大9A售15,,,,,0.00,0.00,0,0,0,0,0,0,0,0,0,0,0,0,0
20200520,07573P,國巨元大9A售11,1.08,1.08,1.08,1.08,0.00,0.00,40000,1,43200,0,0,0,0,0,0,40000,0,40000,40000
20200520,07574P,國巨元大9A售12,,,,,0.00,0.00,0,0,0,0,0,0,0,0,0,0,0,0,0
20200520,07575P,瑞昱元大9A售02,1.21,1.25,1.18,1.21,-0.01,-0.82,228000,23,278570,0,0,0,0,0,0,59000,137000,-78000,-78000
20200520,07576P,可成元大9A售01,1.52,1.60,1.52,1.60,+0.12,8.11,170000,4,263900,0,0,0,0,0,0,120000,50000,70000,70000
20200520,07577P,華新科元大9A售09,1.18,1.18,1.18,1.18,-0.03,-2.48,8000,1,9440,0,0,0,0,0,0,0,8000,-8000,-8000
20200520,07578P,高鐵元大9A售02,1.14,1.14,1.09,1.11,-0.07,-5.93,177000,17,199170,0,0,0,0,0,0,108000,69000,39000,39000
20200520,07579P,聯茂元大9A售01,1.85,1.88,1.85,1.88,+0.04,2.17,105000,7,196850,0,0,0,0,0,0,105000,94000,11000,11000
20200520,07580P,緯穎元大9A售03,1.03,1.11,1.01,1.11,+0.02,1.83,290000,7,302300,0,0,0,0,0,0,240000,40000,200000,200000
20200520,07581P,臺股指元大9A售44,,,,,0.00,0.00,0,0,0,0,0,0,0,0,0,0,0,0,0
20200520,07582P,臺股指元大9A售45,,,,,0.00,0.00,0,0,0,0,0,0,0,0,0,0,0,0,0
20200520,07583P,台積電富邦9B售05,,,,,0.00,0.00,0,0,0,0,0,0,0,0,0,0,0,0,0
20200520,07584P,台積電永豐9A售02,,,,,0.00,0.00,0,0,0,0,0,0,0,0,0,0,0,0,0
20200520,07585P,台灣50中信03售06,,,,,0.00,0.00,0,0,0,0,0,0,0,0,0,0,0,0,0
20200520,07586P,FBVIX台新9A售01,,,,,0.00,0.00,0,0,0,0,0,0,0,0,0,0,0,0,0
20200520,07587P,台灣50國票9A售11,,,,,0.00,0.00,0,0,0,0,0,0,0,0,0,0,0,0,0
20200520,07588P,滬深2X國票9C售01,,,,,0.00,0.00,0,0,0,0,0,0,0,0,0,0,0,0,0
20200520,07589P,玉晶光國票9A售02,,,,,0.00,0.00,0,0,0,0,0,0,0,0,0,0,0,0,0
20200520,07590P,玉晶光國票9A售03,1.74,1.74,1.74,1.74,-0.06,-3.33,10000,1,17400,0,0,0,0,0,0,0,10000,-10000,-10000
20200520,07591P,台灣50元大9A售16,1.60,1.61,1.60,1.61,-0.01,-0.62,45000,2,72200,0,0,0,0,0,0,0,45000,-45000,-45000
20200520,07592P,台灣50元大9A售17,,,,,0.00,0.00,0,0,0,0,0,0,0,0,0,0,0,0,0
20200520,07593P,臺股指凱基9A售08,1.75,1.77,1.73,1.77,-0.02,-1.12,291000,6,507690,0,0,0,0,0,0,30000,261000,-231000,-231000
20200520,07594P,大立光永豐9A售01,,,,,0.00,0.00,0,0,0,0,0,0,0,0,0,0,0,0,0
20200520,07595P,台灣50中信03售07,,,,,0.00,0.00,0,0,0,0,0,0,0,0,0,0,0,0,0
20200520,07596P,上証2X中信01售01,,,,,0.00,0.00,0,0,0,0,0,0,0,0,0,0,0,0,0
20200520,07597P,臺股指中信01售02,0.71,0.73,0.71,0.72,-0.01,-1.37,2682000,64,1931370,0,0,0,0,0,0,391000,2107000,-1716000,-1716000
20200520,07598P,臺股指中信01售03,,,,,0.00,0.00,0,0,0,0,0,0,0,0,0,0,0,0,0
20200520,07599P,台灣50凱基04售05,,,,,0.00,0.00,0,0,0,0,0,0,0,0,0,0,0,0,0
20200520,07600P,台灣50凱基04售06,,,,,0.00,0.00,0,0,0,0,0,0,0,0,0,0,0,0,0
20200520,07601P,國巨統一9A售05,,,,,0.00,0.00,0,0,0,0,0,0,0,0,0,0,0,0,0
20200520,07602P,台積電統一9A售07,0.65,0.65,0.65,0.65,0.00,0.00,2000,1,1300,0,0,0,0,0,0,0,2000,-2000,-2000
20200520,07603P,台積電統一9B售08,,,,,0.00,0.00,0,0,0,0,0,0,0,0,0,0,0,0,0
20200520,07604P,台灣50元大9B售09,,,,,0.00,0.00,0,0,0,0,0,0,0,0,0,0,0,0,0
20200520,07605P,台灣50元大9B售10,1.85,1.85,1.85,1.85,0.00,0.00,1000,1,1850,0,0,0,0,0,0,1000,0,1000,1000
20200520,07606P,台灣50國票01售02,,,,,0.00,0.00,0,0,0,0,0,0,0,0,0,0,0,0,0
20200520,07607P,台灣50國票01售03,,,,,0.00,0.00,0,0,0,0,0,0,0,0,0,0,0,0,0
20200520,07608P,台灣50國票9C售03,2.15,2.15,2.13,2.13,-0.03,-1.39,122000,5,260060,0,0,0,0,0,0,2000,120000,-118000,-118000
20200520,07609P,台灣50國票9C售04,2.46,2.50,2.46,2.47,-0.05,-1.98,8000,8,19840,0,0,0,0,0,0,0,8000,-8000,-8000
20200520,07610P,大立光國票9A售04,2.10,2.11,2.10,2.11,0.00,0.00,18000,2,37880,0,0,0,0,0,0,0,18000,-18000,-18000
20200520,07611P,大立光國票9A售05,,,,,0.00,0.00,0,0,0,0,0,0,0,0,0,0,0,0,0
20200520,07612P,國巨國泰9B售06,0.71,0.71,0.67,0.70,-0.05,-6.67,508000,18,352310,0,0,0,0,0,0,227000,271000,-44000,-44000
20200520,07613P,國巨永豐9A售01,,,,,0.00,0.00,0,0,0,0,0,0,0,0,0,0,0,0,0
20200520,07614P,華新科群益9A售04,1.18,1.20,1.18,1.20,-0.03,-2.44,101000,2,121180,0,0,0,0,0,0,1000,100000,-99000,-99000
20200520,07615P,華通中信02售02,,,,,0.00,0.00,0,0,0,0,0,0,0,0,0,0,0,0,0
20200520,07616P,瑞昱中信02售01,0.60,0.60,0.60,0.60,0.00,0.00,27000,1,16200,0,0,0,0,0,0,0,27000,-27000,-27000
20200520,07617P,聯發科中信9C售04,0.30,0.31,0.29,0.31,0.00,0.00,507000,14,155480,0,0,0,0,0,0,1000,506000,-505000,-505000
20200520,07618P,大立光中信9A售06,0.45,0.45,0.45,0.45,-0.03,-6.25,100000,1,45000,0,0,0,0,0,0,100000,0,100000,100000
20200520,07619P,鴻海統一9A售03,0.74,0.74,0.73,0.73,0.00,0.00,100000,4,73200,0,0,0,0,0,0,90000,10000,80000,80000
20200520,07620P,國巨統一9B售07,0.97,0.97,0.96,0.96,-0.03,-3.03,22000,2,21320,0,0,0,0,0,0,2000,20000,-18000,-18000
20200520,07621P,台積電統一9B售09,,,,,0.00,0.00,0,0,0,0,0,0,0,0,0,0,0,0,0
20200520,07622P,華新科統一9B售02,,,,,0.00,0.00,0,0,0,0,0,0,0,0,0,0,0,0,0
20200520,07623P,大立光統一9B售05,0.85,0.86,0.85,0.86,0.00,0.00,35000,2,29950,0,0,0,0,0,0,35000,0,35000,35000
20200520,07624P,台灣50台新9B售07,,,,,0.00,0.00,0,0,0,0,0,0,0,0,0,0,0,0,0
20200520,07625P,台灣50凱基01售06,,,,,0.00,0.00,0,0,0,0,0,0,0,0,0,0,0,0,0
20200520,07626P,台灣50凱基04售07,,,,,0.00,0.00,0,0,0,0,0,0,0,0,0,0,0,0,0
20200520,07627P,超眾凱基9A售02,0.77,0.78,0.77,0.78,0.00,0.00,57000,4,44140,0,0,0,0,0,0,0,57000,-57000,-57000
20200520,07628P,臺股指凱基9A售09,1.32,1.32,1.32,1.32,0.00,0.00,4000,1,5280,0,0,0,0,0,0,0,4000,-4000,-4000
20200520,07629P,臺股指凱基9A售10,,,,,0.00,0.00,0,0,0,0,0,0,0,0,0,0,0,0,0
20200520,07630P,臺股指凱基9A售11,1.76,1.82,1.75,1.79,-0.02,-1.1,943000,13,1666360,0,0,0,0,0,0,11000,932000,-921000,-921000
20200520,07631P,臺股指凱基9A售12,,,,,0.00,0.00,0,0,0,0,0,0,0,0,0,0,0,0,0
20200520,07632P,臺股指凱基9A售14,,,,,0.00,0.00,0,0,0,0,0,0,0,0,0,0,0,0,0
20200520,07633P,台灣50元大9A售18,,,,,0.00,0.00,0,0,0,0,0,0,0,0,0,0,0,0,0
20200520,07634P,金像電元大9A售01,1.27,1.32,1.24,1.31,+0.04,3.15,1091000,48,1381630,0,0,0,0,0,0,527000,619000,-92000,-92000
20200520,07635P,世芯永豐9A售05,0.47,0.51,0.47,0.51,+0.02,4.08,66000,5,32360,0,0,0,0,0,0,11000,55000,-44000,-44000
20200520,07636P,鴻海國票9A售05,,,,,0.00,0.00,0,0,0,0,0,0,0,0,0,0,0,0,0
20200520,07637P,國巨國票9A售08,,,,,0.00,0.00,0,0,0,0,0,0,0,0,0,0,0,0,0
20200520,07638P,長榮航國票9A售01,0.62,0.66,0.62,0.66,0.00,0.00,458000,156,290550,0,0,0,0,0,0,185000,273000,-88000,-88000
20200520,07639P,緯穎國票9A售01,1.00,1.05,0.95,1.05,-0.03,-2.78,276000,6,278520,0,0,0,0,0,0,134000,142000,-8000,-8000
20200520,07640P,國巨群益9A售07,1.34,1.34,1.34,1.34,-0.06,-4.29,2000,2,2680,0,0,0,0,0,0,1000,1000,0,0
20200520,07641P,上銀凱基9A售05,,,,,0.00,0.00,0,0,0,0,0,0,0,0,0,0,0,0,0
20200520,07642P,華通凱基9A售05,0.87,0.87,0.87,0.87,+0.02,2.35,6000,1,5220,0,0,0,0,0,0,6000,0,6000,6000
20200520,07643P,禾伸堂凱基9A售02,0.60,0.62,0.60,0.61,-0.02,-3.17,281000,5,174000,0,0,0,0,0,0,21000,260000,-239000,-239000
20200520,07644P,南電凱基9A售03,0.94,0.99,0.91,0.96,+0.01,1.05,327000,23,302750,0,0,0,0,0,0,293000,34000,259000,259000
20200520,07645P,華通元大9A售06,1.22,1.22,1.19,1.20,+0.06,5.26,30000,3,36100,0,0,0,0,0,0,0,30000,-30000,-30000
20200520,07646P,世芯元大9A售04,1.01,1.11,1.01,1.11,+0.07,6.73,697000,40,750200,0,0,0,0,0,0,127000,540000,-413000,-413000
20200520,07647P,健策國票9A售04,2.55,2.55,2.42,2.47,+0.05,2.07,250000,7,619500,0,0,0,0,0,0,100000,150000,-50000,-50000
20200520,07648P,祥碩國票9B售01,0.99,0.99,0.88,0.89,-0.17,-16.04,759000,31,712770,0,0,0,0,0,0,200000,549000,-349000,-349000
20200520,07649P,金像電永豐9A售02,0.59,0.61,0.57,0.61,+0.02,3.39,74000,9,43680,0,0,0,0,0,0,2000,62000,-60000,-60000
20200520,07650P,台灣50中信9A售01,,,,,0.00,0.00,0,0,0,0,0,0,0,0,0,0,0,0,0
20200520,07651P,道瓊指中信01售01,0.98,0.98,0.97,0.97,0.00,0.00,16000,3,15530,0,0,0,0,0,0,13000,1000,12000,12000
20200520,07652P,臺股指中信9A售07,0.79,0.82,0.79,0.80,-0.02,-2.44,370000,14,297200,0,0,0,0,0,0,155000,215000,-60000,-60000
20200520,07653P,華新科群益9A售05,1.91,1.93,1.90,1.90,-0.06,-3.06,242000,4,463590,0,0,0,0,0,0,0,242000,-242000,-242000
20200520,07654P,台灣50凱基01售08,,,,,0.00,0.00,0,0,0,0,0,0,0,0,0,0,0,0,0
20200520,07655P,台灣50凱基01售09,,,,,0.00,0.00,0,0,0,0,0,0,0,0,0,0,0,0,0
20200520,07656P,國巨凱基9A售15,0.89,0.89,0.89,0.89,0.00,0.00,10000,1,8900,0,0,0,0,0,0,0,10000,-10000,-10000
20200520,07657P,技嘉凱基9A售03,0.45,0.47,0.45,0.47,0.00,0.00,252000,6,116940,0,0,0,0,0,0,142000,110000,32000,32000
20200520,07658P,國泰金凱基9A售01,0.67,0.67,0.67,0.67,0.00,0.00,10000,1,6700,0,0,0,0,0,0,0,10000,-10000,-10000
20200520,07659P,中租凱基9A售02,0.63,0.64,0.63,0.64,-0.02,-3.03,252000,5,160280,0,0,0,0,0,0,205000,47000,158000,158000
20200520,07660P,聯茂凱基9A售03,1.22,1.24,1.22,1.23,+0.01,0.82,82000,9,100600,0,0,0,0,0,0,35000,47000,-12000,-12000
20200520,07661P,台灣50兆豐9A售03,,,,,0.00,0.00,0,0,0,0,0,0,0,0,0,0,0,0,0
20200520,07662P,台積電兆豐9A售03,0.88,0.88,0.88,0.88,0.00,0.00,186000,2,163680,0,0,0,0,0,0,0,186000,-186000,-186000
20200520,07663P,台灣50台新01售03,0.87,0.87,0.87,0.87,0.00,0.00,2000,1,1740,0,0,0,0,0,0,0,2000,-2000,-2000
20200520,07664P,台灣50元大9C售30,1.61,1.62,1.61,1.62,0.00,0.00,25000,2,40400,0,0,0,0,0,0,0,25000,-25000,-25000
20200520,07665P,台灣50元大9C售31,,,,,0.00,0.00,0,0,0,0,0,0,0,0,0,0,0,0,0
20200520,07666P,台灣50元大9C售32,,,,,0.00,0.00,0,0,0,0,0,0,0,0,0,0,0,0,0
20200520,07667P,亞德客元大9A售05,1.32,1.38,1.32,1.37,-0.01,-0.72,110000,4,149700,0,0,0,0,0,0,50000,60000,-10000,-10000
20200520,07668P,旺宏元大9A售10,1.91,1.91,1.91,1.91,-0.03,-1.55,63000,3,120330,0,0,0,0,0,0,3000,60000,-57000,-57000
20200520,07669P,華新科元大9A售14,1.30,1.32,1.27,1.32,+0.01,0.76,107000,11,139050,0,0,0,0,0,0,14000,93000,-79000,-79000
20200520,07670P,茂林元大9A售02,1.65,1.65,1.57,1.57,-0.12,-7.1,28000,3,46080,0,0,0,0,0,0,26000,2000,24000,24000
20200520,07671P,超眾元大9A售04,2.01,2.02,2.01,2.02,0.00,0.00,72000,2,144940,0,0,0,0,0,0,0,72000,-72000,-72000
20200520,07672P,南電元大9A售05,1.76,1.86,1.74,1.81,0.00,0.00,267000,21,475240,0,0,0,0,0,0,202000,59000,143000,143000
20200520,07673P,電子類元大9A售01,1.77,1.78,1.75,1.78,-0.04,-2.2,56000,6,98960,0,0,0,0,0,0,0,56000,-56000,-56000
20200520,07674P,金融類元大9A售01,1.30,1.30,1.30,1.30,-0.02,-1.52,10000,1,13000,0,0,0,0,0,0,0,10000,-10000,-10000
20200520,07675P,全新永豐9A售02,0.86,0.90,0.82,0.90,+0.04,4.65,392000,19,335390,0,0,0,0,0,0,320000,69000,251000,251000
20200520,07676P,華新科永豐9A售02,0.94,0.94,0.94,0.94,-0.02,-2.08,6000,1,5640,0,0,0,0,0,0,0,6000,-6000,-6000
20200520,07677P,祥碩永豐9A售01,0.41,0.42,0.39,0.39,-0.05,-11.36,598000,36,237960,0,0,0,0,0,0,10000,588000,-578000,-578000
20200520,07678P,大立光群益9A售03,,,,,0.00,0.00,0,0,0,0,0,0,0,0,0,0,0,0,0
20200520,07679P,台灣50凱基01售10,,,,,0.00,0.00,0,0,0,0,0,0,0,0,0,0,0,0,0
20200520,07680P,鴻海凱基9A售24,1.15,1.15,1.15,1.15,0.00,0.00,104000,1,119600,0,0,0,0,0,0,104000,0,104000,104000
20200520,07681P,台積電凱基9A售20,,,,,0.00,0.00,0,0,0,0,0,0,0,0,0,0,0,0,0
20200520,07682P,聯發科凱基9A售15,,,,,0.00,0.00,0,0,0,0,0,0,0,0,0,0,0,0,0
20200520,07683P,宏達電凱基9A售03,1.12,1.16,1.12,1.16,-0.01,-0.85,24000,2,27680,0,0,0,0,0,0,4000,20000,-16000,-16000
20200520,07684P,大立光凱基9A售11,1.17,1.17,1.17,1.17,-0.01,-0.85,1000,1,1170,0,0,0,0,0,0,0,1000,-1000,-1000
20200520,07685P,玉晶光凱基9B售03,0.68,0.68,0.67,0.67,-0.03,-4.29,180000,9,121300,0,0,0,0,0,0,100000,79000,21000,21000
20200520,07686P,祥碩凱基9A售02,0.55,0.56,0.55,0.56,0.00,0.00,15000,2,8350,0,0,0,0,0,0,5000,10000,-5000,-5000
20200520,07687P,上銀元大9A售06,1.41,1.42,1.41,1.42,-0.04,-2.74,32000,2,45430,0,0,0,0,0,0,32000,0,32000,32000
20200520,07688P,華通元大9A售07,2.02,2.02,2.02,2.02,+0.07,3.59,22000,1,44440,0,0,0,0,0,0,0,22000,-22000,-22000
20200520,07689P,旺宏元大9A售13,1.98,2.00,1.98,2.00,-0.01,-0.5,93000,3,185500,0,0,0,0,0,0,25000,68000,-43000,-43000
20200520,07690P,華新科元大9A售15,2.14,2.14,2.14,2.14,-0.06,-2.73,1000,1,2140,0,0,0,0,0,0,0,1000,-1000,-1000
20200520,07691P,宏達電元大9A售05,1.26,1.27,1.24,1.26,-0.05,-3.82,112000,4,140620,0,0,0,0,0,0,2000,110000,-108000,-108000
20200520,07692P,玉晶光元大9A售11,,,,,0.00,0.00,0,0,0,0,0,0,0,0,0,0,0,0,0
20200520,07693P,群創元大9B售10,,,,,0.00,0.00,0,0,0,0,0,0,0,0,0,0,0,0,0
20200520,07694P,超眾元大9A售05,1.39,1.43,1.39,1.41,+0.01,0.71,161000,5,228330,0,0,0,0,0,0,10000,151000,-141000,-141000
20200520,07695P,台郡元大9A售02,1.35,1.36,1.35,1.36,-0.04,-2.86,132000,2,179200,0,0,0,0,0,0,32000,100000,-68000,-68000
20200520,07696P,臺股指元大9A售49,,,,,0.00,0.00,0,0,0,0,0,0,0,0,0,0,0,0,0
20200520,07697P,臺股指元大9A售50,,,,,0.00,0.00,0,0,0,0,0,0,0,0,0,0,0,0,0
20200520,07698P,臺股指元大9A售51,1.09,1.09,1.08,1.08,-0.04,-3.57,30000,2,32500,0,0,0,0,0,0,20000,10000,10000,10000
20200520,07699P,臺股指元大9A售52,1.20,1.20,1.19,1.20,0.00,0.00,52000,4,62240,0,0,0,0,0,0,0,52000,-52000,-52000
20200520,07700P,臺股指元大9A售53,1.29,1.29,1.28,1.28,-0.04,-3.03,96000,3,123800,0,0,0,0,0,0,0,96000,-96000,-96000
20200520,07701P,玉晶光第一9A售02,,,,,0.00,0.00,0,0,0,0,0,0,0,0,0,0,0,0,0
20200520,07702P,台積電中信9A售06,,,,,0.00,0.00,0,0,0,0,0,0,0,0,0,0,0,0,0
20200520,07703P,玉晶光中信9B售03,,,,,0.00,0.00,0,0,0,0,0,0,0,0,0,0,0,0,0
20200520,07704P,台積電元大9A售25,,,,,0.00,0.00,0,0,0,0,0,0,0,0,0,0,0,0,0
20200520,07705P,台積電元大9A售26,,,,,0.00,0.00,0,0,0,0,0,0,0,0,0,0,0,0,0
20200520,07706P,長榮航元大9A售03,1.00,1.01,1.00,1.01,-0.08,-7.34,199000,4,200890,0,0,0,0,0,0,199000,0,199000,199000
20200520,07707P,玉山金元大9A售03,2.05,2.06,2.05,2.06,0.00,0.00,60000,2,123100,0,0,0,0,0,0,0,60000,-60000,-60000
20200520,07708P,玉晶光元大9A售13,2.57,2.61,2.51,2.52,-0.10,-3.82,133000,6,342930,0,0,0,0,0,0,105000,28000,77000,77000
20200520,07709P,創意元大9A售01,,,,,0.00,0.00,0,0,0,0,0,0,0,0,0,0,0,0,0
20200520,07710P,華擎元大9A售05,1.33,1.33,1.27,1.27,-0.10,-7.3,29000,5,38030,0,0,0,0,0,0,20000,9000,11000,11000
20200520,07711P,世芯元大9A售07,0.60,0.64,0.60,0.64,+0.05,8.47,154000,20,94280,0,0,0,0,0,0,40000,104000,-64000,-64000
20200520,07712P,茂林元大9A售03,1.21,1.21,1.07,1.07,-0.19,-15.08,76000,5,86360,0,0,0,0,0,0,36000,40000,-4000,-4000
20200520,07713P,台郡元大9A售03,2.10,2.12,2.10,2.12,-0.05,-2.3,71000,2,150100,0,0,0,0,0,0,21000,50000,-29000,-29000
20200520,07714P,世紀鋼元大9A售03,1.18,1.27,1.17,1.27,+0.05,4.1,496000,16,602430,0,0,0,0,0,0,174000,322000,-148000,-148000
20200520,07715P,台灣50群益9A售14,2.15,2.20,2.15,2.17,-0.04,-1.81,550000,9,1191600,0,0,0,0,0,0,416000,134000,282000,282000
20200520,07716P,臺股指群益9A售05,,,,,0.00,0.00,0,0,0,0,0,0,0,0,0,0,0,0,0
20200520,07717P,臺股指群益9A售06,2.58,2.58,2.55,2.55,0.00,0.00,20000,3,51510,0,0,0,0,0,0,15000,5000,10000,10000
20200520,07718P,臺股指群益9A售07,,,,,0.00,0.00,0,0,0,0,0,0,0,0,0,0,0,0,0
20200520,07719P,臺股指群益9A售08,2.25,2.31,2.22,2.27,-0.02,-0.87,138000,17,312930,0,0,0,0,0,0,15000,123000,-108000,-108000
20200520,07720P,臺股指群益9A售09,2.86,2.94,2.86,2.88,-0.04,-1.37,52000,7,150010,0,0,0,0,0,0,0,52000,-52000,-52000
20200520,07721P,台積電凱基9A售22,,,,,0.00,0.00,0,0,0,0,0,0,0,0,0,0,0,0,0
20200520,07722P,玉晶光凱基9A售10,0.82,0.82,0.78,0.78,-0.03,-3.7,149000,8,117900,0,0,0,0,0,0,90000,56000,34000,34000
20200520,07723P,臺股指凱基9A售15,,,,,0.00,0.00,0,0,0,0,0,0,0,0,0,0,0,0,0
20200520,07724P,臺股指凱基9A售16,,,,,0.00,0.00,0,0,0,0,0,0,0,0,0,0,0,0,0
20200520,07725P,臺股指凱基9A售17,,,,,0.00,0.00,0,0,0,0,0,0,0,0,0,0,0,0,0
20200520,07726P,臺股指凱基9A售18,,,,,0.00,0.00,0,0,0,0,0,0,0,0,0,0,0,0,0
20200520,07727P,臺股指凱基9A售19,,,,,0.00,0.00,0,0,0,0,0,0,0,0,0,0,0,0,0
20200520,07728P,臺股指凱基9A售20,2.32,2.35,2.30,2.33,-0.04,-1.69,348000,8,809090,0,0,0,0,0,0,321000,27000,294000,294000
20200520,07729P,臺股指凱基9A售21,2.13,2.13,2.11,2.11,-0.08,-3.65,30000,2,63700,0,0,0,0,0,0,20000,10000,10000,10000
20200520,07730P,臺股指凱基9A售22,2.25,2.30,2.22,2.30,-0.01,-0.43,36000,4,80500,0,0,0,0,0,0,0,36000,-36000,-36000
20200520,07731P,臺股指凱基9A售28,2.51,2.57,2.49,2.54,-0.02,-0.78,141000,16,355680,0,0,0,0,0,0,10000,131000,-121000,-121000
20200520,07732P,台灣50台新9A售05,0.81,0.81,0.81,0.81,0.00,0.00,5000,1,4050,0,0,0,0,0,0,5000,0,5000,5000
20200520,07733P,台積電統一9B售10,,,,,0.00,0.00,0,0,0,0,0,0,0,0,0,0,0,0,0
20200520,07734P,台積電富邦9C售10,0.69,0.69,0.69,0.69,0.00,0.00,58000,2,40020,0,0,0,0,0,0,0,58000,-58000,-58000
20200520,07735P,臺股指富邦9A售03,,,,,0.00,0.00,0,0,0,0,0,0,0,0,0,0,0,0,0
20200520,07736P,台灣50永豐9A售03,,,,,0.00,0.00,0,0,0,0,0,0,0,0,0,0,0,0,0
20200520,07737P,華通永豐9A售01,,,,,0.00,0.00,0,0,0,0,0,0,0,0,0,0,0,0,0
20200520,07738P,玉晶光永豐9A售06,,,,,0.00,0.00,0,0,0,0,0,0,0,0,0,0,0,0,0
20200520,07739P,緯穎永豐9A售01,,,,,0.00,0.00,0,0,0,0,0,0,0,0,0,0,0,0,0
20200520,07740P,臺股指永豐9A售01,,,,,0.00,0.00,0,0,0,0,0,0,0,0,0,0,0,0,0
20200520,07741P,滬深2X凱基9B售04,,,,,0.00,0.00,0,0,0,0,0,0,0,0,0,0,0,0,0
20200520,07742P,台積電凱基9A售25,1.63,1.63,1.63,1.63,0.00,0.00,75000,2,122250,0,0,0,0,0,0,0,75000,-75000,-75000
20200520,07743P,智邦凱基9A售03,0.53,0.53,0.52,0.52,-0.01,-1.89,16000,3,8370,0,0,0,0,0,0,5000,11000,-6000,-6000
20200520,07744P,奇力新凱基9A售05,0.92,0.92,0.92,0.92,-0.03,-3.16,20000,2,18400,0,0,0,0,0,0,20000,0,20000,20000
20200520,07745P,華新科凱基9A售10,1.19,1.21,1.19,1.21,0.00,0.00,90000,2,108700,0,0,0,0,0,0,0,90000,-90000,-90000
20200520,07746P,華新科凱基9A售11,,,,,0.00,0.00,0,0,0,0,0,0,0,0,0,0,0,0,0
20200520,07747P,晶技凱基9A售04,1.36,1.41,1.36,1.39,+0.01,0.72,240000,11,333250,0,0,0,0,0,0,75000,125000,-50000,-50000
20200520,07748P,茂林凱基9A售04,0.82,0.82,0.78,0.78,-0.09,-10.34,81000,2,65260,0,0,0,0,0,0,81000,0,81000,81000
20200520,07749P,台郡凱基9A售01,1.01,1.03,1.01,1.02,0.00,0.00,350000,4,358500,0,0,0,0,0,0,150000,200000,-50000,-50000
20200520,07750P,台表科凱基9A售04,0.67,0.70,0.60,0.60,-0.09,-13.04,112000,8,75400,0,0,0,0,0,0,45000,67000,-22000,-22000
20200520,07751P,世紀鋼凱基9A售02,0.83,0.89,0.83,0.89,+0.04,4.71,138000,3,119140,100000,0,100000,0,0,0,28000,138000,-110000,-10000
20200520,07752P,台灣50元大9C售33,,,,,0.00,0.00,0,0,0,0,0,0,0,0,0,0,0,0,0
20200520,07753P,台灣50元大9C售34,,,,,0.00,0.00,0,0,0,0,0,0,0,0,0,0,0,0,0
20200520,07754P,日月光元大9A售02,2.09,2.13,2.04,2.13,+0.06,2.9,240000,11,499880,0,0,0,0,0,0,178000,62000,116000,116000
20200520,07755P,台灣50國票03售01,,,,,0.00,0.00,0,0,0,0,0,0,0,0,0,0,0,0,0
20200520,07756P,台灣50國票04售01,,,,,0.00,0.00,0,0,0,0,0,0,0,0,0,0,0,0,0
20200520,07757P,國巨國票9B售04,,,,,0.00,0.00,0,0,0,0,0,0,0,0,0,0,0,0,0
20200520,07758P,台積電國票9A售06,,,,,0.00,0.00,0,0,0,0,0,0,0,0,0,0,0,0,0
20200520,07759P,臺股指富邦9A售04,,,,,0.00,0.00,0,0,0,0,0,0,0,0,0,0,0,0,0
20200520,07760P,力山永豐9A售03,0.77,0.77,0.77,0.77,0.00,0.00,6000,1,4620,0,0,0,0,0,0,6000,0,6000,6000
20200520,07761P,智邦永豐9A售03,0.64,0.64,0.64,0.64,-0.01,-1.54,1000,1,640,0,0,0,0,0,0,0,1000,-1000,-1000
20200520,07762P,聯發科永豐9A售03,,,,,0.00,0.00,0,0,0,0,0,0,0,0,0,0,0,0,0
20200520,07763P,嘉澤永豐9A售02,0.47,0.48,0.47,0.47,-0.01,-2.08,443000,10,209220,0,0,0,0,0,0,22000,421000,-399000,-399000
20200520,07764P,世紀鋼永豐9A售04,0.75,0.80,0.74,0.80,+0.02,2.56,57000,8,43170,0,0,0,0,0,0,55000,2000,53000,53000
20200520,07765P,台積電群益9A售06,1.76,1.79,1.75,1.76,-0.02,-1.12,1073000,10,1889280,0,0,0,0,0,0,1008000,65000,943000,943000
20200520,07766P,美律群益9A售03,1.12,1.16,1.12,1.15,0.00,0.00,310000,5,353550,0,0,0,0,0,0,100000,210000,-110000,-110000
20200520,07767P,華新科群益9A售07,2.33,2.33,2.33,2.33,-0.05,-2.1,200000,1,466000,0,0,0,0,0,0,0,200000,-200000,-200000
20200520,07768P,緯穎群益9A售02,1.27,1.34,1.21,1.34,+0.04,3.08,66000,8,85050,0,0,0,0,0,0,13000,53000,-40000,-40000
20200520,07769P,國巨國票9A售10,,,,,0.00,0.00,0,0,0,0,0,0,0,0,0,0,0,0,0
20200520,07770P,台積電國票9A售07,,,,,0.00,0.00,0,0,0,0,0,0,0,0,0,0,0,0,0
20200520,07771P,義隆國票9A售01,1.47,1.47,1.43,1.45,-0.03,-2.03,28000,4,40260,0,0,0,0,0,0,25000,3000,22000,22000
20200520,07772P,華新科國票9A售05,,,,,0.00,0.00,0,0,0,0,0,0,0,0,0,0,0,0,0
20200520,07773P,台灣50群益9A售15,,,,,0.00,0.00,0,0,0,0,0,0,0,0,0,0,0,0,0
20200520,07774P,台灣50群益9A售16,1.05,1.08,1.05,1.07,0.00,0.00,1241000,44,1307020,0,0,0,0,0,0,0,1241000,-1241000,-1241000
20200520,07775P,國巨群益9A售10,2.01,2.01,1.99,1.99,-0.10,-4.78,2000,2,4000,0,0,0,0,0,0,1000,1000,0,0
20200520,07776P,國巨群益9B售02,1.39,1.39,1.39,1.39,-0.07,-4.79,30000,2,41700,0,0,0,0,0,0,0,30000,-30000,-30000
20200520,07777P,創意元大9A售03,2.35,2.38,2.35,2.38,+0.01,0.42,35000,2,82550,0,0,0,0,0,0,25000,10000,15000,15000
20200520,07778P,台灣50凱基9C售08,,,,,0.00,0.00,0,0,0,0,0,0,0,0,0,0,0,0,0
20200520,07779P,鴻海凱基9B售04,2.64,2.67,2.63,2.67,-0.06,-2.2,244000,8,645150,0,0,0,0,0,0,244000,0,244000,244000
20200520,07780P,美律凱基9A售02,1.18,1.21,1.18,1.21,+0.02,1.68,52000,6,62220,0,0,0,0,0,0,20000,42000,-22000,-22000
20200520,07781P,高鐵凱基9A售02,0.57,0.57,0.57,0.57,-0.03,-5.0,280000,3,159600,0,0,0,0,0,0,80000,200000,-120000,-120000
20200520,07782P,寶成凱基9A售02,0.95,0.97,0.95,0.97,+0.02,2.11,82000,3,79500,0,0,0,0,0,0,2000,80000,-78000,-78000
20200520,07783P,聯發科富邦9C售03,,,,,0.00,0.00,0,0,0,0,0,0,0,0,0,0,0,0,0
20200520,07784P,華新科富邦9B售04,,,,,0.00,0.00,0,0,0,0,0,0,0,0,0,0,0,0,0
20200520,07785P,鴻海中信04售03,,,,,0.00,0.00,0,0,0,0,0,0,0,0,0,0,0,0,0
20200520,07786P,南電中信9C售01,0.64,0.69,0.64,0.66,+0.01,1.54,82000,6,54630,0,0,0,0,0,0,25000,57000,-32000,-32000
20200520,07787P,國巨凱基9A售17,,,,,0.00,0.00,0,0,0,0,0,0,0,0,0,0,0,0,0
20200520,07788P,華新科群益9A售08,1.60,1.60,1.57,1.57,-0.05,-3.09,201000,2,321570,0,0,0,0,0,0,0,201000,-201000,-201000
20200520,07789P,緯穎群益9A售03,1.17,1.23,1.17,1.23,+0.03,2.5,212000,7,256240,0,0,0,0,0,0,3000,209000,-206000,-206000
20200520,07790P,台灣50元大9A售19,1.08,1.08,1.08,1.08,0.00,0.00,50000,1,54000,0,0,0,0,0,0,0,50000,-50000,-50000
20200520,07791P,奇鋐元大9A售02,1.47,1.48,1.43,1.44,-0.05,-3.36,27000,11,39200,0,0,0,0,0,0,13000,14000,-1000,-1000
20200520,07792P,牧德元大9A售04,,,,,0.00,0.00,0,0,0,0,0,0,0,0,0,0,0,0,0
20200520,07793P,同欣電元大9A售02,,,,,0.00,0.00,0,0,0,0,0,0,0,0,0,0,0,0,0
20200520,07794P,智邦國票9A售03,1.79,1.80,1.74,1.75,-0.07,-3.85,98000,9,172620,0,0,0,0,0,0,28000,70000,-42000,-42000
20200520,07795P,美律國票9A售03,1.76,1.76,1.76,1.76,-0.01,-0.56,14000,1,24640,0,0,0,0,0,0,0,14000,-14000,-14000
20200520,07796P,聯發科國票9A售03,,,,,0.00,0.00,0,0,0,0,0,0,0,0,0,0,0,0,0
20200520,07797P,大立光國票9A售08,,,,,0.00,0.00,0,0,0,0,0,0,0,0,0,0,0,0,0
20200520,07798P,同欣電國票9A售01,0.95,0.95,0.90,0.94,-0.04,-4.08,500000,5,462550,0,0,0,0,0,0,290000,210000,80000,80000
20200520,07799P,南電國票9A售04,3.36,3.50,3.35,3.50,+0.07,2.04,18000,4,61870,0,0,0,0,0,0,18000,0,18000,18000
20200520,07800P,華新科國泰9B售04,2.27,2.30,2.25,2.30,0.00,0.00,387000,11,888950,0,0,0,0,0,0,61000,326000,-265000,-265000
20200520,07801P,上銀永豐9A售02,0.63,0.63,0.63,0.63,0.00,0.00,1000,1,630,0,0,0,0,0,0,0,1000,-1000,-1000
20200520,07802P,瑞昱永豐9A售03,0.68,0.74,0.68,0.71,0.00,0.00,39000,11,28040,0,0,0,0,0,0,19000,20000,-1000,-1000
20200520,07803P,南亞科永豐9A售02,0.88,0.89,0.86,0.89,-0.02,-2.2,52000,8,45810,0,0,0,0,0,0,35000,17000,18000,18000
20200520,07804P,美律永豐9A售02,1.01,1.01,1.01,1.01,0.00,0.00,374000,4,377740,0,0,0,0,0,0,0,374000,-374000,-374000
20200520,07805P,義隆永豐9A售02,0.91,0.92,0.91,0.92,-0.01,-1.08,150000,10,136620,0,0,0,0,0,0,133000,13000,120000,120000
20200520,07806P,健策永豐9A售02,0.88,0.88,0.87,0.87,-0.01,-1.14,23000,2,20210,0,0,0,0,0,0,20000,3000,17000,17000
20200520,07807P,聯茂永豐9A售02,0.98,0.98,0.98,0.98,0.00,0.00,102000,3,99960,0,0,0,0,0,0,50000,52000,-2000,-2000
20200520,07808P,超眾永豐9A售04,0.93,0.93,0.93,0.93,+0.02,2.2,10000,1,9300,0,0,0,0,0,0,0,10000,-10000,-10000
20200520,07809P,國巨中信9A售06,,,,,0.00,0.00,0,0,0,0,0,0,0,0,0,0,0,0,0
20200520,07810P,台積電統一9A售08,,,,,0.00,0.00,0,0,0,0,0,0,0,0,0,0,0,0,0
20200520,07811P,華新科統一9A售02,0.74,0.74,0.74,0.74,-0.02,-2.63,1000,1,740,0,0,0,0,0,0,1000,0,1000,1000
20200520,07812P,大立光統一9A售06,,,,,0.00,0.00,0,0,0,0,0,0,0,0,0,0,0,0,0
20200520,07813P,台灣50群益9C售03,,,,,0.00,0.00,0,0,0,0,0,0,0,0,0,0,0,0,0
20200520,07814P,華通群益9A售06,1.72,1.73,1.72,1.73,+0.04,2.37,3000,3,5170,0,0,0,0,0,0,3000,0,3000,3000
20200520,07815P,美律群益9A售04,1.83,1.83,1.83,1.83,+0.03,1.67,334000,2,611220,0,0,0,0,0,0,0,334000,-334000,-334000
20200520,07816P,聯發科群益9A售02,1.15,1.15,1.11,1.14,-0.08,-6.56,7000,3,7840,0,0,0,0,0,0,1000,6000,-5000,-5000
20200520,07817P,同欣電群益9A售02,,,,,0.00,0.00,0,0,0,0,0,0,0,0,0,0,0,0,0
20200520,07818P,台積電國票9C售01,,,,,0.00,0.00,0,0,0,0,0,0,0,0,0,0,0,0,0
20200520,07819P,旺宏國票9B售01,2.12,2.14,2.10,2.14,-0.01,-0.47,146000,5,310840,0,0,0,0,0,0,76000,78000,-2000,-2000
20200520,07820P,臺股指國票9A售11,1.93,1.94,1.93,1.94,-0.04,-2.02,588000,2,1137730,0,0,0,0,0,0,289000,299000,-10000,-10000
20200520,07821P,臺股指國票9A售12,1.57,1.60,1.55,1.59,-0.02,-1.24,394000,23,619400,0,0,0,0,0,0,113000,281000,-168000,-168000
20200520,07822P,滬深2X元大9A售09,,,,,0.00,0.00,0,0,0,0,0,0,0,0,0,0,0,0,0
20200520,07823P,國巨元大9A售23,2.62,2.62,2.53,2.59,-0.13,-4.78,155000,6,398000,0,0,0,0,0,0,115000,90000,25000,25000
20200520,07824P,國巨元大9A售24,,,,,0.00,0.00,0,0,0,0,0,0,0,0,0,0,0,0,0
20200520,07825P,健策國泰9B售04,1.52,1.58,1.47,1.47,-0.09,-5.77,723000,22,1111370,0,0,0,0,0,0,564000,341000,223000,223000
20200520,07826P,台積電富邦9B售07,,,,,0.00,0.00,0,0,0,0,0,0,0,0,0,0,0,0,0
20200520,07827P,台灣50中信9C售01,,,,,0.00,0.00,0,0,0,0,0,0,0,0,0,0,0,0,0
20200520,07828P,SP黃豆凱基01售01,0.74,0.74,0.74,0.74,0.00,0.00,13000,1,9620,0,0,0,0,0,0,13000,0,13000,13000
20200520,07829P,旺宏凱基9A售07,1.09,1.09,1.09,1.09,0.00,0.00,10000,1,10900,0,0,0,0,0,0,10000,0,10000,10000
20200520,07830P,牧德凱基9A售03,0.76,0.76,0.71,0.71,-0.08,-10.13,100000,3,74700,0,0,0,0,0,0,0,100000,-100000,-100000
20200520,07831P,大立光統一9B售07,2.01,2.01,2.01,2.01,+0.03,1.52,1000,1,2010,0,0,0,0,0,0,1000,0,1000,1000
20200520,07832P,台積電群益9A售08,3.13,3.18,3.13,3.15,-0.04,-1.25,69000,7,217210,0,0,0,0,0,0,39000,30000,9000,9000
20200520,07833P,大立光群益9B售02,1.53,1.53,1.49,1.49,0.00,0.00,10000,2,15100,0,0,0,0,0,0,5000,5000,0,0
20200520,07834P,聯詠群益9A售03,0.95,1.01,0.95,1.01,+0.05,5.21,304000,6,293100,0,0,0,0,0,0,124000,180000,-56000,-56000
20200520,07835P,台表科群益9A售02,0.89,0.89,0.73,0.73,-0.15,-17.05,303000,21,250650,0,0,0,0,0,0,0,303000,-303000,-303000
20200520,07836P,大成鋼元大9A售01,1.70,1.70,1.67,1.67,-0.07,-4.02,13000,7,21850,0,0,0,0,0,0,13000,0,13000,13000
20200520,07837P,華邦電元大9A售01,1.74,1.80,1.73,1.77,-0.08,-4.32,102000,8,181380,0,0,0,0,0,0,34000,68000,-34000,-34000
20200520,07838P,泰碩元大9A售04,1.74,1.80,1.74,1.80,+0.04,2.27,79000,18,140540,0,0,0,0,0,0,36000,38000,-2000,-2000
20200520,07839P,嘉澤元大9A售04,1.27,1.33,1.26,1.33,+0.04,3.1,190000,14,245860,0,0,0,0,0,0,72000,118000,-46000,-46000
20200520,07840P,康控元大9A售02,1.47,1.59,1.47,1.57,+0.05,3.29,334000,14,521680,0,0,0,0,0,0,64000,283000,-219000,-219000
20200520,07841P,臻鼎元大9A售04,,,,,0.00,0.00,0,0,0,0,0,0,0,0,0,0,0,0,0
20200520,07842P,力成元大9A售01,1.39,1.46,1.39,1.46,+0.03,2.1,155000,6,224280,0,0,0,0,0,0,40000,115000,-75000,-75000
20200520,07843P,緯穎元大9A售05,0.97,1.02,0.96,1.02,0.00,0.00,75000,5,74400,0,0,0,0,0,0,35000,40000,-5000,-5000
20200520,07844P,可成國票9A售01,2.34,2.38,2.34,2.34,+0.17,7.83,887000,38,2094120,0,0,0,0,0,0,407000,880000,-473000,-473000
20200520,07845P,南亞科元大9A售08,1.97,1.99,1.94,1.97,-0.07,-3.43,98000,8,192190,0,0,0,0,0,0,63000,35000,28000,28000
20200520,07846P,台灣50群益9A售17,3.62,3.67,3.62,3.67,+0.01,0.27,177000,3,646640,0,0,0,0,0,0,59000,118000,-59000,-59000
20200520,07847P,國巨群益9A售13,2.25,2.25,2.24,2.24,-0.09,-3.86,2000,2,4490,0,0,0,0,0,0,1000,1000,0,0
20200520,07848P,旺宏群益9B售01,,,,,0.00,0.00,0,0,0,0,0,0,0,0,0,0,0,0,0
20200520,07849P,大立光群益9A售06,2.14,2.14,2.14,2.14,-0.02,-0.93,1000,1,2140,0,0,0,0,0,0,1000,0,1000,1000
20200520,07850P,健策群益9A售06,1.45,1.48,1.40,1.41,-0.07,-4.73,251000,10,365070,0,0,0,0,0,0,74000,238000,-164000,-164000
20200520,07851P,聯發科國票9A售05,1.12,1.12,1.03,1.09,-0.11,-9.17,245000,10,265850,0,0,0,0,0,0,125000,100000,25000,25000
20200520,07852P,臺股指國票9A售13,2.82,2.83,2.78,2.78,-0.10,-3.47,18000,6,50580,0,0,0,0,0,0,0,18000,-18000,-18000
20200520,07853P,國巨凱基9A售19,,,,,0.00,0.00,0,0,0,0,0,0,0,0,0,0,0,0,0
20200520,07854P,台積電凱基9A售28,3.12,3.12,3.12,3.12,-0.03,-0.95,3000,1,9360,0,0,0,0,0,0,0,3000,-3000,-3000
20200520,07855P,旺宏凱基9A售09,1.65,1.66,1.65,1.66,-0.01,-0.6,12000,2,19860,0,0,0,0,0,0,6000,6000,0,0
20200520,07856P,力成凱基9A售02,0.94,0.98,0.94,0.98,0.00,0.00,192000,3,185220,0,0,0,0,0,0,85000,107000,-22000,-22000
20200520,07857P,國巨永豐9A售05,0.96,0.96,0.96,0.96,-0.05,-4.95,2000,1,1920,0,0,0,0,0,0,2000,0,2000,2000
20200520,07858P,旺宏永豐9A售03,1.01,1.04,1.01,1.04,0.00,0.00,272000,4,282790,0,0,0,0,0,0,3000,269000,-266000,-266000
20200520,07859P,台灣50麥證9A售04,,,,,0.00,0.00,0,0,0,0,0,0,0,0,0,0,0,0,0
20200520,07860P,臺股指麥證9A售06,1.53,1.53,1.53,1.53,-0.04,-2.55,2000,1,3060,2000,0,2000,0,0,0,2000,0,2000,2000
20200520,07861P,台灣50中信03售08,,,,,0.00,0.00,0,0,0,0,0,0,0,0,0,0,0,0,0
20200520,07862P,聯發科凱基9B售05,0.76,0.76,0.72,0.75,-0.04,-5.06,61000,7,44910,0,0,0,0,0,0,32000,29000,3000,3000
20200520,07863P,華新科凱基9B售07,1.23,1.27,1.23,1.27,+0.02,1.6,105000,4,132150,0,0,0,0,0,0,0,105000,-105000,-105000
20200520,07864P,可成元大9B售01,2.09,2.19,2.09,2.16,+0.13,6.4,324000,15,693430,0,0,0,0,0,0,123000,211000,-88000,-88000
20200520,07865P,可成元大9B售02,2.83,2.98,2.83,2.95,+0.20,7.27,221000,12,650580,0,0,0,0,0,0,80000,141000,-61000,-61000
20200520,07866P,上証2X國票97售01,0.11,0.11,0.11,0.11,0.00,0.00,10000,1,1100,0,0,0,0,0,0,0,10000,-10000,-10000
20200520,07867P,晶技元大9B售01,2.45,2.52,2.41,2.48,+0.02,0.81,188000,16,464900,0,0,0,0,0,0,39000,149000,-110000,-110000
20200520,07868P,健策元大9B售05,2.05,2.05,2.01,2.01,-0.05,-2.43,119000,3,242450,0,0,0,0,0,0,69000,50000,19000,19000
20200520,07869P,台灣50群益9C售04,,,,,0.00,0.00,0,0,0,0,0,0,0,0,0,0,0,0,0
20200520,07870P,鴻海群益9B售01,4.46,4.57,4.43,4.57,+0.02,0.44,173000,9,775290,0,0,0,0,0,0,143000,30000,113000,113000
20200520,07871P,台積電群益9C售02,4.57,4.61,4.54,4.59,-0.05,-1.08,98000,11,448970,0,0,0,0,0,0,25000,73000,-48000,-48000
20200520,07872P,聯發科群益9B售03,,,,,0.00,0.00,0,0,0,0,0,0,0,0,0,0,0,0,0
20200520,07873P,華新科群益9B售03,2.70,2.70,2.66,2.66,-0.06,-2.21,18000,2,48280,0,0,0,0,0,0,8000,10000,-2000,-2000
20200520,07874P,長榮航群益9B售01,1.42,1.42,1.42,1.42,-0.05,-3.4,3000,1,4260,0,0,0,0,0,0,3000,0,3000,3000
20200520,07875P,祥碩群益9B售01,0.70,0.70,0.64,0.65,-0.08,-10.96,135000,22,89410,0,0,0,0,0,0,25000,110000,-85000,-85000
20200520,07876P,台灣50國泰01售01,1.36,1.36,1.36,1.36,0.00,0.00,25000,1,34000,0,0,0,0,0,0,25000,0,25000,25000
20200520,07877P,晶技永豐9B售01,1.16,1.21,1.16,1.21,+0.03,2.54,101000,7,120970,0,0,0,0,0,0,63000,38000,25000,25000
20200520,07878P,智邦群益9C售01,2.57,2.59,2.53,2.53,-0.12,-4.53,101000,10,261220,0,0,0,0,0,0,101000,0,101000,101000
20200520,07879P,瑞昱群益9C售01,1.53,1.58,1.51,1.55,+0.01,0.65,151000,11,234950,0,0,0,0,0,0,12000,139000,-127000,-127000
20200520,07880P,可成群益9B售05,2.56,2.64,2.56,2.64,+0.19,7.76,237000,4,623520,0,0,0,0,0,0,27000,210000,-183000,-183000
20200520,07881P,台灣50凱基01售11,,,,,0.00,0.00,0,0,0,0,0,0,0,0,0,0,0,0,0
20200520,07882P,台灣50凱基01售12,1.96,1.98,1.96,1.98,-0.02,-1.0,23000,2,45380,0,0,0,0,0,0,8000,15000,-7000,-7000
20200520,07883P,可成凱基9B售03,1.48,1.52,1.48,1.50,+0.10,7.14,952000,24,1433120,0,0,0,0,0,0,198000,945000,-747000,-747000
20200520,07884P,華新科凱基9B售08,2.73,2.76,2.73,2.75,+0.03,1.1,55000,4,151520,0,0,0,0,0,0,7000,48000,-41000,-41000
20200520,07885P,長榮航凱基9B售01,0.78,0.78,0.78,0.78,-0.06,-7.14,200000,8,156000,0,0,0,0,0,0,200000,0,200000,200000
20200520,07886P,國巨國票9B售06,1.95,1.97,1.93,1.97,-0.14,-6.64,26000,4,50420,0,0,0,0,0,0,10000,16000,-6000,-6000
20200520,07887P,台積電國票9C售03,1.42,1.42,1.42,1.42,-0.01,-0.7,28000,2,39760,0,0,0,0,0,0,0,28000,-28000,-28000
20200520,07888P,大立光國票9B售01,3.27,3.32,3.27,3.32,-0.11,-3.21,77000,2,252040,0,0,0,0,0,0,72000,5000,67000,67000
20200520,07889P,旭富國票9B售01,1.52,1.52,1.52,1.52,+0.02,1.33,60000,2,91200,0,0,0,0,0,0,60000,0,60000,60000
20200520,07890P,南電國票9B售01,4.37,4.49,4.37,4.49,+0.14,3.22,11000,3,48910,0,0,0,0,0,0,1000,10000,-9000,-9000
20200520,07891P,臺股指國票9B售01,4.25,4.33,4.23,4.27,-0.03,-0.7,45000,5,191070,0,0,0,0,0,0,1000,44000,-43000,-43000
20200520,07892P,臺股指國票9B售02,,,,,0.00,0.00,0,0,0,0,0,0,0,0,0,0,0,0,0
20200520,07893P,臺股指國票9B售03,3.12,3.12,3.08,3.08,-0.11,-3.45,20000,2,62000,0,0,0,0,0,0,0,20000,-20000,-20000
20200520,07894P,燿華元大9B售01,2.81,2.81,2.58,2.58,-0.31,-10.73,412000,13,1101830,0,0,0,0,0,0,334000,78000,256000,256000
20200520,07895P,美律元大9B售01,2.22,2.31,2.22,2.31,+0.03,1.32,53000,3,122160,0,0,0,0,0,0,14000,50000,-36000,-36000
20200520,07896P,臺股指元大9B售16,1.09,1.09,1.09,1.09,0.00,0.00,6000,1,6540,0,0,0,0,0,0,0,6000,-6000,-6000
20200520,07897P,臺股指元大9B售17,,,,,0.00,0.00,0,0,0,0,0,0,0,0,0,0,0,0,0
20200520,07898P,國巨國泰9C售02,1.52,1.53,1.44,1.52,-0.07,-4.4,408000,25,607580,0,0,0,0,0,0,295000,108000,187000,187000
20200520,07899P,和大凱基9B售01,1.07,1.07,0.97,0.97,-0.13,-11.82,314000,3,310780,0,0,0,0,0,0,300000,14000,286000,286000
20200520,07900P,臺股指凱基9B售03,4.25,4.32,4.25,4.28,-0.13,-2.95,3000,3,12850,0,0,0,0,0,0,1000,2000,-1000,-1000
20200520,07901P,臺股指凱基9B售04,,,,,0.00,0.00,0,0,0,0,0,0,0,0,0,0,0,0,0
20200520,07902P,玉晶光國票01售01,,,,,0.00,0.00,0,0,0,0,0,0,0,0,0,0,0,0,0
20200520,07903P,台積電群益9B售03,2.26,2.26,2.26,2.26,-0.01,-0.44,50000,5,113000,0,0,0,0,0,0,0,50000,-50000,-50000
20200520,07904P,聯發科群益9B售05,2.55,2.55,2.38,2.52,-0.11,-4.18,532000,55,1321750,0,0,0,0,0,0,161000,366000,-205000,-205000
20200520,07905P,大立光群益9B售04,2.51,2.51,2.48,2.49,-0.05,-1.97,63000,3,156980,0,0,0,0,0,0,0,63000,-63000,-63000
20200520,07906P,中租群益9B售02,1.99,2.01,1.99,2.01,-0.05,-2.43,206000,8,411700,0,0,0,0,0,0,189000,15000,174000,174000
20200520,07907P,台灣50台新9B售08,,,,,0.00,0.00,0,0,0,0,0,0,0,0,0,0,0,0,0
20200520,07908P,台積電統一9B售11,,,,,0.00,0.00,0,0,0,0,0,0,0,0,0,0,0,0,0
20200520,07909P,台積電統一9B售12,1.62,1.62,1.62,1.62,-0.01,-0.61,89000,1,144180,0,0,0,0,0,0,89000,0,89000,89000
20200520,07910P,台積電統一9C售07,2.12,2.16,2.12,2.15,-0.01,-0.46,120000,8,258170,0,0,0,0,0,0,20000,100000,-80000,-80000
20200520,07911P,大立光統一9B售08,0.71,0.71,0.71,0.71,0.00,0.00,10000,1,7100,0,0,0,0,0,0,0,10000,-10000,-10000
20200520,07912P,玉晶光統一9B售02,0.85,0.85,0.83,0.83,0.00,0.00,29000,2,24150,0,0,0,0,0,0,29000,0,29000,29000
20200520,07913P,友達元大01售01,1.31,1.35,1.31,1.34,+0.01,0.75,108000,4,144190,0,0,0,0,0,0,7000,101000,-94000,-94000
20200520,07914P,臺股指元大9B售20,,,,,0.00,0.00,0,0,0,0,0,0,0,0,0,0,0,0,0
20200520,07915P,臺股指元大9B售21,,,,,0.00,0.00,0,0,0,0,0,0,0,0,0,0,0,0,0
20200520,07916P,臺股指元大9B售22,1.21,1.24,1.21,1.24,0.00,0.00,23000,2,27920,0,0,0,0,0,0,20000,3000,17000,17000
20200520,07917P,可成永豐9B售01,1.17,1.22,1.17,1.22,+0.08,7.02,605000,15,731920,0,0,0,0,0,0,255000,550000,-295000,-295000
20200520,07918P,玉晶光永豐9B售04,,,,,0.00,0.00,0,0,0,0,0,0,0,0,0,0,0,0,0
20200520,07919P,創意永豐9B售01,1.05,1.05,1.02,1.02,-0.03,-2.86,23000,3,23910,0,0,0,0,0,0,13000,10000,3000,3000
20200520,07920P,大立光中信01售01,0.55,0.55,0.54,0.54,-0.02,-3.57,13000,2,7050,0,0,0,0,0,0,0,13000,-13000,-13000
20200520,07921P,鴻海群益9B售04,2.74,2.86,2.74,2.86,0.00,0.00,127000,6,350680,0,0,0,0,0,0,127000,0,127000,127000
20200520,07922P,大立光群益9B售05,1.93,1.93,1.86,1.89,-0.05,-2.58,386000,4,729480,0,0,0,0,0,0,336000,350000,-14000,-14000
20200520,07923P,元金2X凱基02售02,1.45,1.45,1.45,1.45,0.00,0.00,200000,1,290000,0,0,0,0,0,0,200000,0,200000,200000
20200520,07924P,台積電凱基9B售04,3.38,3.38,3.38,3.38,-0.05,-1.46,20000,2,67600,0,0,0,0,0,0,20000,0,20000,20000
20200520,07925P,台積電凱基9B售05,3.81,3.81,3.81,3.81,-0.06,-1.55,19000,1,72390,0,0,0,0,0,0,19000,0,19000,19000
20200520,07926P,上銀統一9B售02,0.85,0.85,0.83,0.84,0.00,0.00,53000,3,45010,0,0,0,0,0,0,0,53000,-53000,-53000
20200520,07927P,國巨統一9B售08,1.13,1.14,1.12,1.12,-0.06,-5.08,160000,5,180600,0,0,0,0,0,0,100000,60000,40000,40000
20200520,07928P,國巨統一9B售09,0.79,0.81,0.79,0.81,-0.06,-6.9,190000,5,150200,0,0,0,0,0,0,185000,5000,180000,180000
20200520,07929P,旺宏統一9B售07,1.07,1.09,1.07,1.09,-0.02,-1.8,302000,2,323180,0,0,0,0,0,0,302000,0,302000,302000
20200520,07930P,聯發科統一9B售06,0.63,0.63,0.62,0.62,-0.04,-6.06,35000,4,21800,0,0,0,0,0,0,0,35000,-35000,-35000
20200520,07931P,國巨元大9B售03,2.38,2.38,2.32,2.32,0.00,0.00,66000,4,153280,0,0,0,0,0,0,66000,50000,16000,16000
20200520,07932P,國巨元大9B售04,3.23,3.23,3.23,3.23,-0.16,-4.72,1000,1,3230,0,0,0,0,0,0,0,1000,-1000,-1000
20200520,07933P,大立光富邦9C售06,0.73,0.73,0.71,0.71,-0.02,-2.74,35000,2,25050,0,0,0,0,0,0,0,35000,-35000,-35000
20200520,07934P,臺股指國票9B售06,2.13,2.13,2.13,2.13,0.00,0.00,5000,1,10650,0,0,0,0,0,0,0,5000,-5000,-5000
20200520,07935P,臺股指國票9B售07,2.40,2.40,2.40,2.40,-0.05,-2.04,5000,1,12000,0,0,0,0,0,0,0,5000,-5000,-5000
20200520,07936P,臺股指國票9B售08,,,,,0.00,0.00,0,0,0,0,0,0,0,0,0,0,0,0,0
20200520,07937P,國巨中信9B售03,,,,,0.00,0.00,0,0,0,0,0,0,0,0,0,0,0,0,0
20200520,07938P,國巨統一9B售10,1.69,1.72,1.69,1.72,0.00,0.00,6000,2,10260,0,0,0,0,0,0,4000,2000,2000,2000
20200520,07939P,台積電統一9B售14,,,,,0.00,0.00,0,0,0,0,0,0,0,0,0,0,0,0,0
20200520,07940P,國巨群益9B售06,2.56,2.65,2.56,2.65,-0.10,-3.64,51000,7,133660,0,0,0,0,0,0,1000,50000,-49000,-49000
20200520,07941P,國巨凱基9B售07,1.08,1.08,1.05,1.08,-0.04,-3.57,88000,7,93600,0,0,0,0,0,0,73000,15000,58000,58000
20200520,07942P,健策凱基9B售03,1.12,1.12,1.07,1.08,-0.02,-1.82,93000,5,102830,0,0,0,0,0,0,63000,93000,-30000,-30000
20200520,07943P,瑞昱元大9B售02,3.29,3.35,3.29,3.35,0.00,0.00,27000,2,89610,0,0,0,0,0,0,0,27000,-27000,-27000
20200520,07944P,華新科元大9B售08,2.94,2.97,2.86,2.96,-0.02,-0.67,216000,21,630180,0,0,0,0,0,0,168000,48000,120000,120000
20200520,07945P,上銀國票9B售02,2.53,2.59,2.53,2.59,0.00,0.00,141000,4,357720,0,0,0,0,0,0,46000,95000,-49000,-49000
20200520,07946P,華通統一9B售02,1.24,1.24,1.20,1.22,0.00,0.00,74000,11,90370,0,0,0,0,0,0,16000,58000,-42000,-42000
20200520,07947P,國巨統一9B售12,1.16,1.16,1.16,1.16,-0.08,-6.45,100000,1,116000,0,0,0,0,0,0,0,100000,-100000,-100000
20200520,07948P,大成鋼凱基9B售01,,,,,0.00,0.00,0,0,0,0,0,0,0,0,0,0,0,0,0
20200520,07949P,滬深2X元大9B售04,,,,,0.00,0.00,0,0,0,0,0,0,0,0,0,0,0,0,0
20200520,07950P,智邦元大9B售04,2.65,2.70,2.61,2.61,-0.12,-4.4,250000,9,667880,0,0,0,0,0,0,184000,66000,118000,118000
20200520,07951P,智邦元大9B售05,2.07,2.07,2.00,2.01,-0.08,-3.83,259000,12,529220,0,0,0,0,0,0,239000,10000,229000,229000
20200520,07952P,富邦金元大9B售02,2.61,2.61,2.61,2.61,-0.08,-2.97,12000,1,31320,0,0,0,0,0,0,0,12000,-12000,-12000
20200520,07953P,健策元大9B售07,2.45,2.51,2.39,2.41,-0.06,-2.43,200000,8,496460,0,0,0,0,0,0,195000,145000,50000,50000
20200520,07954P,台表科元大9B售02,2.25,2.25,1.90,1.90,-0.29,-13.24,83000,5,170220,0,0,0,0,0,0,18000,65000,-47000,-47000
20200520,07955P,大成鋼群益9B售02,2.00,2.00,1.98,1.99,-0.07,-3.4,6000,3,11970,0,0,0,0,0,0,6000,0,6000,6000
20200520,07956P,鴻海群益9B售06,1.97,2.00,1.96,2.00,-0.01,-0.5,261000,9,512910,0,0,0,0,0,0,260000,1000,259000,259000
20200520,07957P,晶技群益9B售02,2.04,2.12,2.00,2.07,+0.02,0.98,452000,21,923090,0,0,0,0,0,0,102000,350000,-248000,-248000
20200520,07958P,華擎群益9B售01,1.25,1.26,1.25,1.26,-0.06,-4.55,4000,4,5010,0,0,0,0,0,0,4000,0,4000,4000
20200520,07959P,健策永豐9B售05,1.17,1.17,1.13,1.13,-0.04,-3.42,91000,4,106390,0,0,0,0,0,0,0,91000,-91000,-91000
20200520,07960P,台灣50中信9B售02,,,,,0.00,0.00,0,0,0,0,0,0,0,0,0,0,0,0,0
20200520,07961P,滬深2X中信01售02,,,,,0.00,0.00,0,0,0,0,0,0,0,0,0,0,0,0,0
20200520,07962P,聯詠中信05售03,,,,,0.00,0.00,0,0,0,0,0,0,0,0,0,0,0,0,0
20200520,07963P,智邦統一9B售01,0.99,0.99,0.96,0.98,-0.03,-2.97,128000,14,124820,0,0,0,0,0,0,121000,7000,114000,114000
20200520,07964P,大立光統一9B售12,,,,,0.00,0.00,0,0,0,0,0,0,0,0,0,0,0,0,0
20200520,07965P,玉晶光群益01售02,2.55,2.55,2.46,2.46,-0.07,-2.77,30000,5,75100,0,0,0,0,0,0,20000,10000,10000,10000
20200520,07966P,瑞祺群益9B售02,,,,,0.00,0.00,0,0,0,0,0,0,0,0,0,0,0,0,0
20200520,07967P,力山元大9B售03,2.25,2.27,2.24,2.27,-0.02,-0.87,11000,3,24810,0,0,0,0,0,0,7000,4000,3000,3000
20200520,07968P,國巨元大9B售09,3.60,3.63,3.53,3.59,-0.22,-5.77,150000,6,540320,0,0,0,0,0,0,115000,35000,80000,80000
20200520,07969P,臺股指元大9B售27,,,,,0.00,0.00,0,0,0,0,0,0,0,0,0,0,0,0,0
20200520,07970P,臺股指元大9B售28,,,,,0.00,0.00,0,0,0,0,0,0,0,0,0,0,0,0,0
20200520,07971P,臺股指元大9B售29,,,,,0.00,0.00,0,0,0,0,0,0,0,0,0,0,0,0,0
20200520,07972P,大立光統一9C售05,2.36,2.36,2.32,2.34,-0.04,-1.68,53000,7,123860,0,0,0,0,0,0,41000,12000,29000,29000
20200520,07973P,大立光台新9B售01,,,,,0.00,0.00,0,0,0,0,0,0,0,0,0,0,0,0,0
20200520,07974P,上証2X元大9B售02,1.58,1.58,1.58,1.58,+0.04,2.6,10000,1,15800,0,0,0,0,0,0,0,10000,-10000,-10000
20200520,07975P,國巨元大9B售15,2.34,2.34,2.24,2.28,-0.13,-5.39,304000,18,695840,0,0,0,0,0,0,237000,90000,147000,147000
20200520,07976P,聯發科群益9C售02,1.21,1.21,1.12,1.19,-0.06,-4.8,110000,13,127790,0,0,0,0,0,0,12000,98000,-86000,-86000
20200520,07977P,華新科群益01售01,1.83,1.83,1.83,1.83,-0.03,-1.61,50000,1,91500,0,0,0,0,0,0,0,50000,-50000,-50000
20200520,07978P,茂林群益9B售02,1.73,1.73,1.73,1.73,-0.23,-11.73,2000,1,3460,0,0,0,0,0,0,2000,0,2000,2000
20200520,07979P,大立光凱基9B售05,2.01,2.01,2.00,2.00,-0.03,-1.48,50000,2,100300,0,0,0,0,0,0,50000,0,50000,50000
20200520,07980P,臺股指凱基02售01,1.66,1.66,1.66,1.66,-0.02,-1.19,22000,2,36520,0,0,0,0,0,0,0,22000,-22000,-22000
20200520,07981P,上銀群益9B售04,1.64,1.68,1.64,1.68,+0.02,1.2,20000,2,33200,0,0,0,0,0,0,0,20000,-20000,-20000
20200520,07982P,全新群益9B售04,1.72,1.84,1.72,1.83,+0.08,4.57,457000,37,819190,0,0,0,0,0,0,84000,373000,-289000,-289000
20200520,07983P,茂林群益9B售03,1.50,1.50,1.39,1.41,-0.12,-7.84,172000,7,250670,0,0,0,0,0,0,164000,8000,156000,156000
20200520,07984P,臺指反元大02售08,,,,,0.00,0.00,0,0,0,0,0,0,0,0,0,0,0,0,0
20200520,07985P,臺指反元大02售09,,,,,0.00,0.00,0,0,0,0,0,0,0,0,0,0,0,0,0
20200520,07986P,大成鋼統一9B售02,0.83,0.83,0.83,0.83,-0.03,-3.49,16000,6,13280,0,0,0,0,0,0,16000,0,16000,16000
20200520,07987P,大立光統一9B售13,0.85,0.85,0.85,0.85,-0.03,-3.41,3000,2,2550,0,0,0,0,0,0,3000,0,3000,3000
20200520,07988P,台積電台新9C售03,0.99,1.00,0.99,1.00,+0.01,1.01,210000,8,209900,0,0,0,0,0,0,10000,200000,-190000,-190000
20200520,07989P,玉晶光凱基9B售07,1.50,1.50,1.46,1.46,-0.05,-3.31,14000,3,20820,0,0,0,0,0,0,0,14000,-14000,-14000
20200520,07990P,緯穎凱基9B售02,1.02,1.09,1.02,1.09,+0.03,2.83,163000,8,175040,0,0,0,0,0,0,14000,149000,-135000,-135000
20200520,07991P,鴻海群益9C售02,3.51,3.55,3.51,3.55,+0.03,0.85,70000,8,246340,0,0,0,0,0,0,44000,26000,18000,18000
20200520,07992P,玉晶光群益01售04,3.78,3.78,3.65,3.65,-0.11,-2.93,80000,6,293810,0,0,0,0,0,0,21000,59000,-38000,-38000
20200520,07993P,寶成群益9B售01,,,,,0.00,0.00,0,0,0,0,0,0,0,0,0,0,0,0,0
20200520,07994P,臺股指群益9B售04,,,,,0.00,0.00,0,0,0,0,0,0,0,0,0,0,0,0,0
20200520,07995P,臺股指麥證9C售01,,,,,0.00,0.00,0,0,0,0,0,0,0,0,0,0,0,0,0
20200520,07996P,亞德客凱基9B售03,1.61,1.64,1.61,1.64,+0.01,0.61,12000,2,19380,0,0,0,0,0,0,12000,0,12000,12000
20200520,07997P,上銀凱基9B售04,,,,,0.00,0.00,0,0,0,0,0,0,0,0,0,0,0,0,0
20200520,07998P,聯電凱基9C售01,1.32,1.33,1.32,1.33,+0.03,2.31,136000,3,179820,0,0,0,0,0,0,0,136000,-136000,-136000
20200520,07999P,台達電凱基9B售02,1.16,1.21,1.16,1.21,+0.02,1.68,55000,3,65350,0,0,0,0,0,0,0,55000,-55000,-55000
20200520,08000P,奇鋐凱基9B售03,1.39,1.39,1.38,1.38,0.00,0.00,34000,2,46940,0,0,0,0,0,0,32000,2000,30000,30000
20200520,08001P,台灣50元大9B售17,1.67,1.68,1.67,1.68,0.00,0.00,18000,3,30220,0,0,0,0,0,0,0,18000,-18000,-18000
20200520,08002P,大毅國票9B售03,2.59,2.73,2.59,2.73,-0.01,-0.36,271000,11,725620,0,0,0,0,0,0,129000,142000,-13000,-13000
20200520,08003P,國巨國泰9B售07,,,,,0.00,0.00,0,0,0,0,0,0,0,0,0,0,0,0,0
20200520,08004P,大毅永豐9B售02,0.91,0.94,0.91,0.93,-0.01,-1.06,163000,9,152330,0,0,0,0,0,0,0,162000,-162000,-162000
20200520,08005P,台積電群益9C售04,1.66,1.68,1.66,1.67,0.00,0.00,21000,5,35020,0,0,0,0,0,0,0,21000,-21000,-21000
20200520,08006P,長榮航中信03售01,0.64,0.64,0.64,0.64,-0.03,-4.48,246000,2,157440,0,0,0,0,0,0,216000,30000,186000,186000
20200520,08007P,國泰金中信03售02,,,,,0.00,0.00,0,0,0,0,0,0,0,0,0,0,0,0,0
20200520,08008P,華新科統一9B售05,,,,,0.00,0.00,0,0,0,0,0,0,0,0,0,0,0,0,0
20200520,08009P,華擎統一9B售02,1.06,1.06,1.01,1.01,-0.09,-8.18,52000,8,54120,0,0,0,0,0,0,3000,49000,-46000,-46000
20200520,08010P,大成鋼元大9B售01,2.28,2.28,2.13,2.13,-0.23,-9.75,38000,3,85890,0,0,0,0,0,0,33000,38000,-5000,-5000
20200520,08011P,玉晶光元大9B售05,1.30,1.30,1.30,1.30,-0.05,-3.7,10000,1,13000,0,0,0,0,0,0,10000,0,10000,10000
20200520,08012P,台灣50凱基01售13,1.18,1.18,1.18,1.18,0.00,0.00,5000,1,5900,0,0,0,0,0,0,0,5000,-5000,-5000
20200520,08013P,台灣50凱基9C售09,,,,,0.00,0.00,0,0,0,0,0,0,0,0,0,0,0,0,0
20200520,08014P,微星凱基9B售02,1.06,1.11,1.06,1.11,+0.02,1.83,87000,5,93230,0,0,0,0,0,0,22000,65000,-43000,-43000
20200520,08015P,可成凱基9B售05,2.23,2.32,2.23,2.30,+0.16,7.48,125000,9,284920,0,0,0,0,0,0,42000,93000,-51000,-51000
20200520,08016P,臺股指凱基02售02,,,,,0.00,0.00,0,0,0,0,0,0,0,0,0,0,0,0,0
20200520,08017P,華新科國票9B售01,2.94,2.94,2.94,2.94,0.00,0.00,41000,1,120540,0,0,0,0,0,0,0,41000,-41000,-41000
20200520,08018P,牧德國票9B售04,,,,,0.00,0.00,0,0,0,0,0,0,0,0,0,0,0,0,0
20200520,08019P,緯穎國票9B售02,2.20,2.21,2.19,2.21,0.00,0.00,10000,4,22020,0,0,0,0,0,0,0,10000,-10000,-10000
20200520,08020P,臺股指凱基9B售06,,,,,0.00,0.00,0,0,0,0,0,0,0,0,0,0,0,0,0
20200520,08021P,臺股指凱基9B售07,,,,,0.00,0.00,0,0,0,0,0,0,0,0,0,0,0,0,0
20200520,08022P,臺股指凱基9B售08,,,,,0.00,0.00,0,0,0,0,0,0,0,0,0,0,0,0,0
20200520,08023P,臺股指凱基9B售09,,,,,0.00,0.00,0,0,0,0,0,0,0,0,0,0,0,0,0
20200520,08024P,臺股指凱基9B售10,2.98,2.98,2.96,2.96,0.00,0.00,10000,2,29700,0,0,0,0,0,0,0,10000,-10000,-10000
20200520,08025P,臺股指凱基9B售11,,,,,0.00,0.00,0,0,0,0,0,0,0,0,0,0,0,0,0
20200520,08026P,臺股指凱基9B售12,2.39,2.41,2.39,2.41,-0.04,-1.63,15000,2,35950,0,0,0,0,0,0,10000,5000,5000,5000
20200520,08027P,嘉晶元大9B售03,1.95,1.95,1.86,1.86,0.00,0.00,15000,2,28350,0,0,0,0,0,0,0,15000,-15000,-15000
20200520,08028P,臺股指元大9B售30,,,,,0.00,0.00,0,0,0,0,0,0,0,0,0,0,0,0,0
20200520,08029P,臺股指元大9B售36,,,,,0.00,0.00,0,0,0,0,0,0,0,0,0,0,0,0,0
20200520,08030P,臺股指元大9B售37,,,,,0.00,0.00,0,0,0,0,0,0,0,0,0,0,0,0,0
20200520,08031P,臺股指元大9B售38,,,,,0.00,0.00,0,0,0,0,0,0,0,0,0,0,0,0,0
20200520,08032P,台積電統一9B售16,,,,,0.00,0.00,0,0,0,0,0,0,0,0,0,0,0,0,0
20200520,08033P,台灣50兆豐9C售03,,,,,0.00,0.00,0,0,0,0,0,0,0,0,0,0,0,0,0
20200520,08034P,台積電兆豐9B售02,1.23,1.24,1.23,1.23,-0.02,-1.6,103000,3,126710,0,0,0,0,0,0,0,103000,-103000,-103000
20200520,08035P,國巨群益9C售04,,,,,0.00,0.00,0,0,0,0,0,0,0,0,0,0,0,0,0
20200520,08036P,嘉澤群益9B售03,1.91,1.91,1.91,1.91,0.00,0.00,10000,1,19100,0,0,0,0,0,0,0,10000,-10000,-10000
20200520,08037P,台表科群益9B售02,1.35,1.40,1.35,1.40,-0.24,-14.63,47000,7,64250,0,0,0,0,0,0,2000,45000,-43000,-43000
20200520,08038P,臺股指群益9B售11,,,,,0.00,0.00,0,0,0,0,0,0,0,0,0,0,0,0,0
20200520,08039P,臺股指群益9B售12,,,,,0.00,0.00,0,0,0,0,0,0,0,0,0,0,0,0,0
20200520,08040P,臺股指群益9B售13,,,,,0.00,0.00,0,0,0,0,0,0,0,0,0,0,0,0,0
20200520,08041P,臺股指群益9B售14,,,,,0.00,0.00,0,0,0,0,0,0,0,0,0,0,0,0,0
20200520,08042P,臺股指群益9B售15,,,,,0.00,0.00,0,0,0,0,0,0,0,0,0,0,0,0,0
20200520,08043P,電子類群益9B售01,,,,,0.00,0.00,0,0,0,0,0,0,0,0,0,0,0,0,0
20200520,08044P,臺股指富邦9B售03,,,,,0.00,0.00,0,0,0,0,0,0,0,0,0,0,0,0,0
20200520,08045P,健策國票9B售01,,,,,0.00,0.00,0,0,0,0,0,0,0,0,0,0,0,0,0
20200520,08046P,臺股指國票9B售11,,,,,0.00,0.00,0,0,0,0,0,0,0,0,0,0,0,0,0
20200520,08047P,臺股指國票9B售12,3.30,3.36,3.30,3.36,0.00,0.00,5000,2,16680,0,0,0,0,0,0,0,5000,-5000,-5000
20200520,08048P,臺股指國票9B售13,,,,,0.00,0.00,0,0,0,0,0,0,0,0,0,0,0,0,0
20200520,08049P,臺股指國票9B售14,,,,,0.00,0.00,0,0,0,0,0,0,0,0,0,0,0,0,0
20200520,08050P,臺股指國票9B售15,,,,,0.00,0.00,0,0,0,0,0,0,0,0,0,0,0,0,0
20200520,08051P,臺股指國票9B售16,,,,,0.00,0.00,0,0,0,0,0,0,0,0,0,0,0,0,0
20200520,08052P,臺股指國票9B售17,,,,,0.00,0.00,0,0,0,0,0,0,0,0,0,0,0,0,0
20200520,08053P,臺股指國票9B售18,4.64,4.64,4.64,4.64,-0.04,-0.85,6000,1,27840,0,0,0,0,0,0,0,6000,-6000,-6000
20200520,08054P,臺股指國票9B售19,,,,,0.00,0.00,0,0,0,0,0,0,0,0,0,0,0,0,0
20200520,08055P,臺股指國票9B售20,,,,,0.00,0.00,0,0,0,0,0,0,0,0,0,0,0,0,0
20200520,08056P,華通群益9B售06,,,,,0.00,0.00,0,0,0,0,0,0,0,0,0,0,0,0,0
20200520,08057P,京鼎群益9B售01,,,,,0.00,0.00,0,0,0,0,0,0,0,0,0,0,0,0,0
20200520,08058P,華新科元大9B售10,,,,,0.00,0.00,0,0,0,0,0,0,0,0,0,0,0,0,0
20200520,08059P,京鼎元大9B售02,,,,,0.00,0.00,0,0,0,0,0,0,0,0,0,0,0,0,0
20200520,08060P,嘉澤元大9B售01,2.14,2.14,2.11,2.13,+0.19,9.79,25000,10,53140,0,0,0,0,0,0,0,25000,-25000,-25000
20200520,08061P,大毅國票9B售04,,,,,0.00,0.00,0,0,0,0,0,0,0,0,0,0,0,0,0
20200520,08062P,華擎國票9B售03,3.02,3.02,2.97,2.97,+1.01,51.53,2000,2,5990,0,0,0,0,0,0,0,2000,-2000,-2000
20200520,08063P,立積國票9B售03,1.34,1.34,1.34,1.34,+0.48,55.81,10000,1,13400,0,0,0,0,0,0,0,10000,-10000,-10000
20200520,08064P,上証2X凱基9C售02,,,,,0.00,0.00,0,0,0,0,0,0,0,0,0,0,0,0,0
20200520,08065P,瑞昱凱基9B售03,,,,,0.00,0.00,0,0,0,0,0,0,0,0,0,0,0,0,0
20200520,08066P,南亞科凱基9B售04,,,,,0.00,0.00,0,0,0,0,0,0,0,0,0,0,0,0,0
20200520,08067P,大立光凱基9B售08,2.34,2.34,2.34,2.34,+0.07,3.08,100000,2,234000,0,0,0,0,0,0,100000,100000,0,0
20200520,08068P,宏達電國泰9C售01,1.32,1.32,1.32,1.32,+0.03,2.33,5000,1,6600,0,0,0,0,0,0,0,5000,-5000,-5000
20200520,08069P,大立光國泰01售02,,,,,0.00,0.00,0,0,0,0,0,0,0,0,0,0,0,0,0
20200520,08070P,晶技國泰9C售02,,,,,0.00,0.00,0,0,0,0,0,0,0,0,0,0,0,0,0
20200520,08071P,臺股指富邦9B售04,,,,,0.00,0.00,0,0,0,0,0,0,0,0,0,0,0,0,0
20200520,08072P,祥碩永豐9B售03,1.02,1.02,1.00,1.00,+0.03,3.09,16000,3,16100,0,0,0,0,0,0,0,16000,-16000,-16000
20200520,08073P,台灣50麥證9C售01,,,,,0.00,0.00,0,0,0,0,0,0,0,0,0,0,0,0,0
20200520,08074P,緯穎元富9B售02,,,,,0.00,0.00,0,0,0,0,0,0,0,0,0,0,0,0,0
20200520,08100P,台灣50元富95售01,,,,,0.00,0.00,0,0,0,0,0,0,0,0,0,0,0,0,0
20200520,08163P,T50正2中信95售01,,,,,0.00,0.00,0,0,0,0,0,0,0,0,0,0,0,0,0
20200520,08164P,滬深2X中信95售04,,,,,0.00,0.00,0,0,0,0,0,0,0,0,0,0,0,0,0
20200520,08217P,T50反1凱基96售02,,,,,0.00,0.00,0,0,0,0,0,0,0,0,0,0,0,0,0
20200520,08218P,滬深2X凱基96售01,,,,,0.00,0.00,0,0,0,0,0,0,0,0,0,0,0,0,0
20200520,08484P,台灣50中信96售01,,,,,0.00,0.00,0,0,0,0,0,0,0,0,0,0,0,0,0
20200520,08506P,台灣50中信96售02,0.02,0.02,0.02,0.02,-0.08,-80.0,20000,1,400,0,0,0,0,0,0,0,20000,-20000,-20000
20200520,08525P,台灣50凱基96售02,,,,,0.00,0.00,0,0,0,0,0,0,0,0,0,0,0,0,0
20200520,08539P,元油2X國票99售01,,,,,0.00,0.00,0,0,0,0,0,0,0,0,0,0,0,0,0
20200520,08570P,台灣50凱基96售03,,,,,0.00,0.00,0,0,0,0,0,0,0,0,0,0,0,0,0
20200520,08602P,台灣50凱基96售04,,,,,0.00,0.00,0,0,0,0,0,0,0,0,0,0,0,0,0
20200520,08609P,世紀鋼永豐9C售03,,,,,0.00,0.00,0,0,0,0,0,0,0,0,0,0,0,0,0
20200520,08625P,台灣50凱基96售05,,,,,0.00,0.00,0,0,0,0,0,0,0,0,0,0,0,0,0
20200520,08637P,台灣50中信96售03,0.46,0.50,0.46,0.50,+0.05,11.11,31000,3,14300,0,0,0,0,0,0,0,3000,-3000,-3000
20200520,08653P,台灣50凱基96售07,,,,,0.00,0.00,0,0,0,0,0,0,0,0,0,0,0,0,0
20200520,08663P,台灣50元大96售01,,,,,0.00,0.00,0,0,0,0,0,0,0,0,0,0,0,0,0
20200520,08671P,友訊國票01售01,,,,,0.00,0.00,0,0,0,0,0,0,0,0,0,0,0,0,0
20200520,08674P,嘉晶元富07售02,,,,,0.00,0.00,0,0,0,0,0,0,0,0,0,0,0,0,0
20200520,08679P,台灣50元大01售15,,,,,0.00,0.00,0,0,0,0,0,0,0,0,0,0,0,0,0
20200520,08714P,華碩元富01售03,0.20,0.25,0.20,0.20,0.00,0.00,98000,7,21600,0,0,0,0,0,0,32000,0,32000,32000
20200520,08801P,聯發科元大01售13,,,,,0.00,0.00,0,0,0,0,0,0,0,0,0,0,0,0,0
20200520,08818P,台灣50元大97售01,0.30,0.32,0.25,0.32,+0.02,6.67,41000,6,11960,0,0,0,0,0,0,0,0,0,0
20200520,08852P,台灣50台新01售01,,,,,0.00,0.00,0,0,0,0,0,0,0,0,0,0,0,0,0
20200520,1101,台泥,43.20,43.20,42.90,42.90,-0.10,-0.23,11157906,4058,480344408,4688768,3027987,1660781,13000,76000,-63000,311000,171000,140000,1737781
20200520,1101B,台泥乙特,53.90,54.50,53.90,54.50,0.00,0.00,5034,6,273336,0,0,0,0,0,0,4000,0,4000,4000
20200520,1102,亞泥,44.00,44.05,43.75,43.90,-0.15,-0.34,8588570,2943,377489908,1875237,7398057,-5522820,6000,5000,1000,170000,183000,-13000,-5534820
20200520,1103,嘉泥,16.15,16.15,16.00,16.10,-0.10,-0.62,568503,192,9135921,37000,163000,-126000,0,0,0,155000,1000,154000,28000
20200520,1104,環泥,17.65,17.75,17.55,17.70,+0.10,0.57,277801,170,4897333,130533,109000,21533,0,0,0,0,1000,-1000,20533
20200520,1108,幸福,8.81,8.82,8.72,8.80,-0.01,-0.11,511718,134,4485085,29000,9000,20000,0,0,0,0,0,0,20000
20200520,1109,信大,17.50,17.50,17.30,17.30,-0.10,-0.57,183015,75,3188711,33000,56000,-23000,0,0,0,0,55000,-55000,-78000
20200520,1110,東泥,15.85,16.15,15.50,15.65,-0.20,-1.26,106810,52,1675705,27000,64000,-37000,0,0,0,0,0,0,-37000
20200520,1201,味全,22.30,22.45,22.05,22.15,-0.15,-0.67,845801,401,18820009,43000,127000,-84000,0,0,0,3000,3000,0,-84000
20200520,1203,味王,28.40,28.50,28.15,28.20,-0.20,-0.7,85217,50,2415676,13000,6000,7000,0,0,0,0,0,0,7000
20200520,1210,大成,44.75,44.90,43.80,43.85,-0.95,-2.12,4384666,2713,193396398,466000,1780376,-1314376,0,0,0,21000,25000,-4000,-1318376
20200520,1213,大飲,5.76,6.08,5.76,5.80,-0.05,-0.85,13416,12,78289,0,0,0,0,0,0,0,0,0,0
20200520,1215,卜蜂,71.00,71.10,70.60,70.80,-0.20,-0.28,1068214,724,75753435,227055,125000,102055,0,0,0,10000,35000,-25000,77055
20200520,1216,統一,71.00,71.30,70.60,71.30,+1.10,1.57,7908847,3805,562275730,6604663,3728206,2876457,13000,0,13000,127000,26000,101000,2990457
20200520,1217,愛之味,7.19,7.20,7.12,7.13,-0.01,-0.14,1009535,341,7210083,208000,57000,151000,0,0,0,0,0,0,151000
20200520,1218,泰山,24.45,24.90,24.25,24.30,-0.05,-0.21,1044574,561,25600736,150000,192000,-42000,0,0,0,0,0,0,-42000
20200520,1219,福壽,19.10,19.40,19.00,19.40,+0.20,1.04,84423,55,1610469,4000,41000,-37000,0,0,0,0,0,0,-37000
20200520,1220,台榮,10.50,10.60,10.50,10.55,+0.05,0.48,207000,60,2183350,5000,4000,1000,0,0,0,0,0,0,1000
20200520,1225,福懋油,37.80,38.15,37.50,37.65,-0.15,-0.4,94000,33,3556150,5000,21000,-16000,0,0,0,0,0,0,-16000
20200520,1227,佳格,67.20,67.20,66.30,66.30,-0.40,-0.6,815642,582,54465872,534000,552052,-18052,37000,0,37000,32000,1000,31000,49948
20200520,1229,聯華,42.30,42.40,41.65,41.80,-0.50,-1.18,3778985,1940,158562320,306225,2322000,-2015775,0,0,0,31000,2984,28016,-1987759
20200520,1231,聯華食,41.40,41.50,41.35,41.50,+0.10,0.24,119382,98,4948884,5000,24301,-19301,0,0,0,0,2000,-2000,-21301
20200520,1232,大統益,118.00,118.50,117.50,118.50,+0.50,0.42,29499,51,3483381,1000,10000,-9000,0,0,0,0,0,0,-9000
20200520,1233,天仁,35.55,36.80,35.55,35.80,+0.25,0.7,27000,19,981600,0,1000,-1000,0,0,0,0,0,0,-1000
20200520,1234,黑松,32.05,32.15,31.85,31.85,-0.20,-0.62,63100,48,2017614,10000,30000,-20000,0,0,0,0,5000,-5000,-25000
20200520,1235,興泰,26.10,26.10,25.60,25.60,+0.10,0.39,7225,8,186887,1000,2000,-1000,0,0,0,2000,0,2000,1000
20200520,1236,宏亞,11.90,11.90,11.85,11.85,0.00,0.00,23000,11,273650,0,2000,-2000,0,0,0,0,0,0,-2000
20200520,1256,鮮活果汁-KY,202.50,204.00,201.00,203.50,+0.50,0.25,71724,115,14562420,13000,11000,2000,0,0,0,0,0,0,2000
20200520,1301,台塑,86.80,86.90,85.40,86.40,+0.20,0.23,6018660,3458,519206662,2722532,2580000,142532,124000,0,124000,440000,566000,-126000,140532
20200520,1303,南亞,64.00,64.00,63.40,63.90,+0.30,0.47,4061458,2185,259027536,2681482,1696000,985482,15000,0,15000,392000,137000,255000,1255482
20200520,1304,台聚,12.30,12.30,12.05,12.20,-0.20,-1.61,3236209,1185,39313239,95000,1296000,-1201000,0,0,0,4000,103000,-99000,-1300000
20200520,1305,華夏,19.90,20.00,19.10,19.20,-0.70,-3.52,7313354,3237,142106073,311040,2310582,-1999542,0,0,0,99000,1000,98000,-1901542
20200520,1307,三芳,24.05,25.60,24.00,24.75,+0.50,2.06,1816221,1107,45180924,1000,63208,-62208,0,0,0,2000,1000,1000,-61208
20200520,1308,亞聚,17.80,17.80,17.40,17.70,-0.10,-0.56,3262415,1482,57298597,66000,922000,-856000,0,0,0,97000,11000,86000,-770000
20200520,1309,台達化,11.75,12.55,11.30,12.30,+0.65,5.58,25232491,7042,301293880,831000,1999000,-1168000,0,0,0,27000,20000,7000,-1161000
20200520,1310,台苯,16.90,16.90,16.50,16.50,-0.35,-2.08,2581209,1252,42973464,31000,1389007,-1358007,0,0,0,10000,29000,-19000,-1377007
20200520,1312,國喬,15.40,15.70,15.00,15.15,0.00,0.00,26478135,8307,406673195,418000,5889745,-5471745,0,0,0,199000,385000,-186000,-5657745
20200520,1312A,國喬特,30.70,30.70,30.55,30.55,-0.25,-0.81,3000,2,91950,0,0,0,0,0,0,0,0,0,0
20200520,1313,聯成,9.47,9.52,9.40,9.41,-0.11,-1.16,864921,344,8181269,110000,409000,-299000,0,0,0,16000,4000,12000,-287000
20200520,1314,中石化,8.52,8.53,8.35,8.39,-0.03,-0.36,17745645,4256,149762405,2255000,2588000,-333000,0,0,0,103000,753000,-650000,-983000
20200520,1315,達新,51.50,54.00,51.20,53.90,+2.20,4.26,1790457,910,94027581,190000,115000,75000,0,0,0,7000,3000,4000,79000
20200520,1316,上曜,11.20,11.25,11.10,11.15,-0.05,-0.45,264000,127,2954550,18000,4000,14000,0,0,0,3000,1000,2000,16000
20200520,1319,東陽,36.50,37.50,36.00,37.50,+1.15,3.16,2695768,1493,99149495,453042,402788,50254,0,0,0,3000,1000,2000,52254
20200520,1321,大洋,30.40,30.40,30.00,30.05,-0.25,-0.83,114000,63,3430750,5000,9000,-4000,0,0,0,2000,1000,1000,-3000
20200520,1323,永裕,33.05,33.20,32.90,33.20,+0.40,1.22,67605,50,2236494,5000,9000,-4000,0,0,0,0,0,0,-4000
20200520,1324,地球,9.19,9.43,9.19,9.37,+0.11,1.19,70887,32,664611,1000,2000,-1000,0,0,0,0,0,0,-1000
20200520,1325,恆大,149.50,149.50,143.00,149.50,+13.50,9.93,10524073,5081,1562913899,185000,503000,-318000,343000,0,343000,70000,502000,-432000,-407000
20200520,1326,台化,73.50,73.60,72.90,73.20,0.00,0.00,5369645,2581,393389958,1825246,3085000,-1259754,9000,72000,-63000,214000,7000,207000,-1115754
20200520,1337,再生-KY,5.45,5.45,5.10,5.13,-0.13,-2.47,1452126,461,7611618,73000,97000,-24000,0,0,0,4000,0,4000,-20000
20200520,1338,廣華-KY,50.60,52.60,50.50,52.10,+1.40,2.76,467007,397,24072185,105000,93000,12000,0,0,0,1000,35000,-34000,-22000
20200520,1339,昭輝,42.00,44.25,41.70,43.00,+1.00,2.38,2619201,1774,112500122,101000,239000,-138000,0,0,0,0,42000,-42000,-180000
20200520,1340,勝悅-KY,10.30,10.60,10.15,10.40,+0.20,1.96,500996,272,5208947,16000,34000,-18000,0,0,0,2000,1000,1000,-17000
20200520,1341,富林-KY,61.90,61.90,60.60,61.80,-0.10,-0.16,20004,17,1217344,0,0,0,0,0,0,0,0,0,0
20200520,1402,遠東新,27.40,27.90,27.10,27.60,+0.20,0.73,24140161,9681,665878745,4436448,5268976,-832528,502000,0,502000,146000,164000,-18000,-348528
20200520,1409,新纖,11.05,11.05,10.90,10.90,-0.15,-1.36,1934787,654,21196919,79000,643000,-564000,0,0,0,1000,2000,-1000,-565000
20200520,1410,南染,30.80,30.80,30.45,30.45,-0.35,-1.14,2020,3,61859,0,1000,-1000,0,0,0,0,0,0,-1000
20200520,1413,宏洲,7.08,7.08,7.00,7.02,-0.06,-0.85,134999,28,947931,1000,5000,-4000,0,0,0,0,0,0,-4000
20200520,1414,東和,6.49,6.50,6.45,6.47,0.00,0.00,124688,44,807505,10000,4000,6000,0,0,0,0,0,0,6000
20200520,1416,廣豐,11.15,11.15,11.10,11.10,-0.10,-0.89,150733,73,1676215,8000,2000,6000,0,0,0,2000,0,2000,8000
20200520,1417,嘉裕,8.09,8.09,7.92,7.92,-0.06,-0.75,327136,128,2613658,28000,32000,-4000,0,0,0,0,2000,-2000,-6000
20200520,1418,東華,5.62,5.63,5.50,5.50,+0.37,7.21,14689,14,82120,0,0,0,0,0,0,0,0,0,0
20200520,1419,新紡,41.75,41.75,40.20,40.50,-1.25,-2.99,32828,33,1332484,5000,26000,-21000,0,0,0,0,0,0,-21000
20200520,1423,利華,10.75,10.80,10.75,10.75,0.00,0.00,53001,19,570260,0,5000,-5000,0,0,0,0,0,0,-5000
20200520,1432,大魯閣,5.68,5.82,5.63,5.74,-0.10,-1.71,131431,57,747131,6000,4000,2000,0,0,0,0,0,0,2000
20200520,1434,福懋,33.85,34.10,33.80,33.95,+0.05,0.15,1407874,642,47761267,936000,583000,353000,0,0,0,3000,43000,-40000,313000
20200520,1435,中福,8.22,8.22,8.08,8.12,-0.06,-0.73,132238,61,1074816,2000,16000,-14000,0,0,0,0,0,0,-14000
20200520,1436,華友聯,37.55,37.55,36.80,36.80,-0.40,-1.08,51380,48,1900220,2000,19000,-17000,0,0,0,0,3000,-3000,-20000
20200520,1437,勤益控,20.55,20.60,20.45,20.50,-0.10,-0.49,95000,40,1947650,6000,12000,-6000,0,0,0,0,6000,-6000,-12000
20200520,1438,裕豐,12.90,12.95,12.60,12.95,-0.60,-4.43,7000,7,89850,1000,0,1000,0,0,0,0,0,0,1000
20200520,1439,中和,34.10,34.75,34.10,34.30,-0.50,-1.44,425466,244,14636624,24000,79000,-55000,0,0,0,0,0,0,-55000
20200520,1440,南紡,8.75,8.85,8.75,8.81,+0.06,0.69,818180,342,7207295,442000,102000,340000,0,0,0,3000,2000,1000,341000
20200520,1441,大東,6.95,6.95,6.87,6.94,-0.03,-0.43,36345,28,251841,1000,2000,-1000,0,0,0,0,0,0,-1000
20200520,1442,名軒,17.65,17.75,17.50,17.50,+0.05,0.29,77543,56,1364327,8000,7000,1000,0,0,0,5000,0,5000,6000
20200520,1443,立益,8.68,8.99,8.68,8.99,+0.31,3.57,72111,32,633094,4000,0,4000,0,0,0,0,0,0,4000
20200520,1444,力麗,7.02,7.06,6.91,6.91,-0.14,-1.99,1338511,470,9335568,131000,494000,-363000,0,0,0,1000,1000,0,-363000
20200520,1445,大宇,8.32,8.42,8.30,8.36,+0.04,0.48,191001,53,1595828,13000,4000,9000,0,0,0,0,0,0,9000
20200520,1446,宏和,29.05,29.55,29.05,29.20,0.00,0.00,80000,60,2351900,29000,7000,22000,0,0,0,2000,0,2000,24000
20200520,1447,力鵬,5.85,5.86,5.80,5.83,+0.02,0.34,325897,161,1901168,151000,69000,82000,0,0,0,2000,1000,1000,83000
20200520,1449,佳和,15.90,16.00,15.10,15.15,-0.25,-1.62,1875171,673,29143065,42000,339000,-297000,0,0,0,0,0,0,-297000
20200520,1451,年興,14.50,14.75,14.50,14.70,+0.20,1.38,299395,163,4399345,58000,27000,31000,0,0,0,1000,4000,-3000,28000
20200520,1452,宏益,16.85,16.90,16.80,16.80,-0.05,-0.3,150348,77,2531538,43000,10000,33000,0,0,0,0,0,0,33000
20200520,1453,大將,6.89,6.97,6.89,6.89,+0.02,0.29,19700,17,136457,0,1000,-1000,0,0,0,0,0,0,-1000
20200520,1454,台富,7.85,7.97,7.82,7.95,0.00,0.00,217000,34,1724330,2000,11000,-9000,0,0,0,0,0,0,-9000
20200520,1455,集盛,7.16,7.18,7.12,7.15,0.00,0.00,698638,173,4993915,97000,60903,36097,0,0,0,9000,1000,8000,44097
20200520,1456,怡華,8.00,8.05,7.91,8.00,-0.10,-1.23,8200,11,65450,3000,0,3000,0,0,0,0,0,0,3000
20200520,1457,宜進,12.10,12.10,11.85,11.90,-0.15,-1.24,361200,133,4324458,57000,41000,16000,0,0,0,0,0,0,16000
20200520,1459,聯發,6.93,6.96,6.85,6.95,-0.01,-0.14,228016,49,1570095,8000,7000,1000,0,0,0,1000,0,1000,2000
20200520,1460,宏遠,7.39,7.59,7.25,7.26,-0.13,-1.76,1521683,627,11224948,145000,505000,-360000,0,0,0,3000,1000,2000,-358000
20200520,1463,強盛,11.40,11.40,11.30,11.30,-0.10,-0.88,64883,35,737427,1000,3000,-2000,0,0,0,1000,0,1000,-1000
20200520,1464,得力,20.70,20.70,20.50,20.55,-0.05,-0.24,394049,230,8108805,145000,27000,118000,0,0,0,3000,0,3000,121000
20200520,1465,偉全,15.20,15.35,15.10,15.15,-0.05,-0.33,94600,64,1436588,6000,2000,4000,0,0,0,0,0,0,4000
20200520,1466,聚隆,7.91,7.91,7.60,7.69,-0.19,-2.41,90001,49,687947,3000,2000,1000,0,0,0,0,0,0,1000
20200520,1467,南緯,10.00,10.80,9.97,10.45,+0.40,3.98,3271755,635,33947012,461000,53000,408000,0,0,0,0,0,0,408000
20200520,1468,昶和,9.72,9.99,9.70,9.99,+0.01,0.1,11000,10,108490,2000,2000,0,0,0,0,0,0,0,0
20200520,1470,大統新創,19.35,19.80,19.35,19.75,+0.75,3.95,3000,3,58900,1000,0,1000,0,0,0,0,0,0,1000
20200520,1471,首利,2.55,2.55,2.43,2.49,-0.06,-2.35,83043,29,206061,0,0,0,0,0,0,0,0,0,0
20200520,1472,三洋紡,12.15,12.55,11.70,11.75,-0.30,-2.49,765373,359,9260645,14000,62000,-48000,0,0,0,0,0,0,-48000
20200520,1473,台南,19.85,20.00,19.60,19.80,0.00,0.00,106179,74,2096115,39000,5000,34000,0,0,0,0,0,0,34000
20200520,1474,弘裕,9.40,9.42,9.31,9.35,-0.04,-0.43,319000,111,2983990,27000,13000,14000,0,0,0,0,0,0,14000
20200520,1475,本盟,14.15,14.15,13.80,13.80,-0.35,-2.47,13000,5,180100,0,0,0,0,0,0,0,0,0,0
20200520,1476,儒鴻,279.00,280.50,275.00,279.50,+1.00,0.36,1008185,895,280562355,418700,273000,145700,16000,0,16000,96000,9000,87000,248700
20200520,1477,聚陽,127.00,129.00,124.00,126.50,-0.50,-0.39,3018245,2242,381109115,181000,931995,-750995,473000,333000,140000,126000,40000,86000,-524995
20200520,1503,士電,45.15,45.30,44.75,44.85,-0.30,-0.66,209681,133,9469238,9000,69000,-60000,0,0,0,2000,3000,-1000,-61000
20200520,1504,東元,27.20,27.25,27.00,27.10,+0.10,0.37,3199607,1945,86719683,970000,2111621,-1141621,0,0,0,309000,46000,263000,-878621
20200520,1506,正道,13.55,13.55,12.90,13.15,-0.15,-1.13,600548,207,7849528,22000,10000,12000,0,0,0,0,0,0,12000
20200520,1507,永大,57.20,57.40,56.70,56.70,-1.00,-1.73,153211,146,8711882,25000,93000,-68000,0,0,0,0,1000,-1000,-69000
20200520,1512,瑞利,5.63,5.63,5.63,5.63,+0.51,9.96,778176,111,4381129,0,0,0,0,0,0,0,0,0,0
20200520,1513,中興電,27.85,27.95,27.45,27.60,-0.10,-0.36,3565169,1049,98594431,508000,336000,172000,0,0,0,7000,213000,-206000,-34000
20200520,1514,亞力,20.60,20.65,20.40,20.50,0.00,0.00,839544,377,17205042,209000,45480,163520,0,0,0,1000,0,1000,164520
20200520,1515,力山,70.80,71.70,70.40,70.80,+0.40,0.57,2039509,1290,144845735,341000,213000,128000,218000,0,218000,32000,11000,21000,367000
20200520,1516,川飛,13.75,13.75,13.60,13.75,0.00,0.00,22369,17,305717,0,1000,-1000,0,0,0,0,0,0,-1000
20200520,1517,利奇,7.91,7.93,7.86,7.92,+0.01,0.13,151394,65,1196676,5000,6000,-1000,0,0,0,1000,0,1000,0
20200520,1519,華城,26.10,26.45,25.95,26.30,+0.30,1.15,498475,303,13065791,99000,62000,37000,0,0,0,0,2000,-2000,35000
20200520,1521,大億,57.80,58.00,57.20,57.60,-0.20,-0.35,40505,35,2332390,8000,13000,-5000,0,0,0,0,0,0,-5000
20200520,1522,堤維西,23.25,23.50,23.25,23.40,+0.15,0.65,342612,205,7993018,95000,44000,51000,0,0,0,1000,9000,-8000,43000
20200520,1524,耿鼎,8.74,8.96,8.70,8.90,+0.16,1.83,275642,123,2444103,47000,5000,42000,0,0,0,0,0,0,42000
20200520,1525,江申,46.35,48.60,46.35,48.60,+4.40,9.95,422061,241,20428164,5000,3000,2000,0,50000,-50000,0,0,0,-48000
20200520,1526,日馳,22.55,24.00,22.55,24.00,+2.15,9.84,6703840,3043,158966060,309000,383000,-74000,0,0,0,1000,0,1000,-73000
20200520,1527,鑽全,39.90,41.50,39.85,40.85,+1.00,2.51,963360,553,39320801,106000,120000,-14000,0,0,0,2000,0,2000,-12000
20200520,1528,恩德,7.54,7.55,7.46,7.50,-0.03,-0.4,86489,57,649311,19000,5000,14000,0,0,0,1000,0,1000,15000
20200520,1529,樂士,14.50,14.50,13.70,14.15,+0.05,0.35,51525,37,721750,1000,2000,-1000,0,0,0,3000,0,3000,2000
20200520,1530,亞崴,32.05,32.30,31.60,31.90,-0.20,-0.62,25000,14,795000,1000,2000,-1000,0,0,0,0,0,0,-1000
20200520,1531,高林股,12.95,13.00,12.70,12.95,0.00,0.00,90500,51,1166899,6000,27000,-21000,0,0,0,1000,0,1000,-20000
20200520,1532,勤美,28.05,28.95,28.00,28.25,+0.20,0.71,488503,256,13814207,38000,91000,-53000,0,0,0,2000,1000,1000,-52000
20200520,1533,車王電,26.35,26.55,26.25,26.30,+0.05,0.19,61406,55,1617435,9000,6000,3000,0,0,0,1000,0,1000,4000
20200520,1535,中宇,33.00,33.00,32.45,32.55,-0.65,-1.96,63150,31,2058882,14000,0,14000,0,0,0,0,0,0,14000
20200520,1536,和大,95.40,98.90,94.10,98.50,+3.00,3.14,3670397,2791,356791200,820000,449000,371000,0,0,0,445000,125000,320000,691000
20200520,1537,廣隆,142.50,143.00,142.00,143.00,+1.00,0.7,47535,45,6777040,13000,8000,5000,0,0,0,0,1000,-1000,4000
20200520,1538,正峰新,2.71,2.73,2.71,2.72,-0.13,-4.56,22288,12,60550,0,0,0,0,0,0,0,0,0,0
20200520,1539,巨庭,17.35,17.35,17.15,17.25,-0.10,-0.58,57000,42,982250,0,2000,-2000,0,0,0,0,0,0,-2000
20200520,1540,喬福,16.00,16.00,15.80,15.85,+0.05,0.32,113200,71,1796600,6000,12000,-6000,0,0,0,0,0,0,-6000
20200520,1541,錩泰,40.15,41.75,39.90,40.50,+0.60,1.5,358260,224,14610694,28000,9000,19000,0,0,0,0,1000,-1000,18000
20200520,1558,伸興,131.00,132.00,131.00,131.50,-0.50,-0.38,29111,31,3825207,5000,14111,-9111,0,0,0,0,0,0,-9111
20200520,1560,中砂,59.90,60.50,59.90,60.00,-0.40,-0.66,238439,190,14306227,15000,43000,-28000,0,0,0,0,0,0,-28000
20200520,1568,倉佑,14.85,15.00,14.60,14.80,+0.10,0.68,87920,71,1300480,13000,0,13000,0,0,0,0,0,0,13000
20200520,1582,信錦,81.60,82.50,81.00,81.70,+0.10,0.12,304909,213,24862361,16000,48000,-32000,0,0,0,9000,2000,7000,-25000
20200520,1583,程泰,60.00,60.50,59.60,59.60,0.00,0.00,9159,10,548376,2000,2000,0,0,0,0,0,0,0,0
20200520,1587,吉茂,12.75,13.10,12.75,13.10,+0.05,0.38,2000,2,25850,0,0,0,0,0,0,0,0,0,0
20200520,1589,永冠-KY,61.20,61.40,59.60,59.70,-1.30,-2.13,273034,207,16478240,14000,31000,-17000,0,0,0,0,30000,-30000,-47000
20200520,1590,亞德客-KY,551.00,559.00,543.00,547.00,+6.00,1.11,1017865,892,558882350,502865,157089,345776,0,18000,-18000,10000,38000,-28000,299776
20200520,1592,英瑞-KY,11.10,11.30,11.00,11.20,0.00,0.00,1201636,400,13407208,46000,47000,-1000,0,0,0,0,0,0,-1000
20200520,1598,岱宇,40.00,42.45,39.85,42.45,+2.70,6.79,2806868,1703,115979970,507000,149000,358000,0,0,0,0,0,0,358000
20200520,1603,華電,26.65,26.65,26.20,26.30,-0.30,-1.13,14000,13,368650,2000,4000,-2000,0,0,0,0,0,0,-2000
20200520,1604,聲寶,19.60,19.70,19.55,19.65,-0.10,-0.51,592945,203,11631364,47000,139000,-92000,0,0,0,0,0,0,-92000
20200520,1605,華新,12.65,12.75,12.55,12.60,0.00,0.00,5321869,1441,67389339,1351000,2045639,-694639,0,0,0,368000,71000,297000,-397639
20200520,1608,華榮,9.15,9.25,9.15,9.19,+0.03,0.33,411100,136,3780287,110000,13000,97000,0,0,0,1000,1000,0,97000
20200520,1609,大亞,10.90,10.90,10.55,10.60,-0.15,-1.4,2268130,732,24195909,134000,238000,-104000,0,0,0,3000,1000,2000,-102000
20200520,1611,中電,13.20,13.30,13.15,13.25,+0.05,0.38,419881,214,5554675,35000,66000,-31000,0,0,0,0,0,0,-31000
20200520,1612,宏泰,10.10,10.10,10.00,10.00,-0.10,-0.99,144001,41,1446760,8000,5000,3000,0,0,0,0,0,0,3000
20200520,1614,三洋電,31.05,31.05,30.70,30.85,-0.05,-0.16,73065,43,2251955,25000,27000,-2000,0,0,0,0,0,0,-2000
20200520,1615,大山,22.00,22.15,21.80,21.80,-0.10,-0.46,208000,99,4557350,42000,12000,30000,0,0,0,0,12000,-12000,18000
20200520,1616,億泰,4.18,4.18,3.92,4.12,-0.10,-2.37,194182,62,785876,4000,7000,-3000,0,0,0,0,0,0,-3000
20200520,1617,榮星,11.10,11.20,11.05,11.20,+0.05,0.45,49000,31,545800,4000,4000,0,0,0,0,0,1000,-1000,-1000
20200520,1618,合機,7.85,7.85,7.70,7.75,+0.04,0.52,47150,31,366475,5000,7000,-2000,0,0,0,0,0,0,-2000
20200520,1626,艾美特-KY,25.30,26.10,25.30,26.00,+0.40,1.56,134000,89,3464800,37000,23000,14000,0,0,0,0,0,0,14000
20200520,1701,中化,21.90,22.00,21.60,21.75,-0.05,-0.23,1806953,897,39336424,901000,115000,786000,0,0,0,1000,2000,-1000,785000
20200520,1702,南僑,44.25,44.40,43.90,43.95,-0.30,-0.68,233189,202,10267916,60000,92427,-32427,0,0,0,2000,30000,-28000,-60427
20200520,1707,葡萄王,194.00,194.50,191.50,191.50,-1.00,-0.52,455913,412,87849209,172300,309000,-136700,0,5000,-5000,7000,7000,0,-141700
20200520,1708,東鹼,23.90,24.20,23.80,24.15,+0.25,1.05,324840,148,7767910,67000,39000,28000,0,0,0,1000,0,1000,29000
20200520,1709,和益,13.20,13.20,12.95,13.00,-0.10,-0.76,536407,211,6999591,135000,53000,82000,0,0,0,0,1000,-1000,81000
20200520,1710,東聯,16.90,17.00,16.70,16.80,-0.05,-0.3,906146,395,15243732,110000,332198,-222198,0,0,0,2000,1000,1000,-221198
20200520,1711,永光,14.95,15.05,14.75,14.80,0.00,0.00,642581,396,9552294,248000,78000,170000,0,0,0,1000,1000,0,170000
20200520,1712,興農,18.20,18.20,18.10,18.15,0.00,0.00,588627,279,10672504,6000,110577,-104577,0,0,0,1000,8000,-7000,-111577
20200520,1713,國化,17.90,17.95,17.75,17.75,-0.20,-1.11,37710,25,672245,2000,3000,-1000,0,0,0,1000,5000,-4000,-5000
20200520,1714,和桐,7.33,7.41,7.29,7.29,-0.04,-0.55,1606070,481,11788833,545000,316000,229000,0,0,0,3000,1000,2000,231000
20200520,1717,長興,31.40,31.50,30.25,30.70,-0.65,-2.07,4452904,2625,136871499,605000,509000,96000,0,0,0,37000,2000,35000,131000
20200520,1718,中纖,6.40,6.48,6.31,6.40,+0.04,0.63,3274886,1128,20936097,444000,465000,-21000,0,0,0,403000,48000,355000,334000
20200520,1720,生達,40.30,40.35,39.65,39.85,-0.15,-0.38,1243254,772,49610607,307000,174000,133000,0,0,0,1000,15000,-14000,119000
20200520,1721,三晃,9.88,10.00,9.88,9.92,+0.01,0.1,290930,73,2889625,36000,9000,27000,0,0,0,1000,0,1000,28000
20200520,1722,台肥,49.10,49.20,48.80,48.85,-0.15,-0.31,1831549,1173,89714551,570000,371495,198505,360000,0,360000,31000,32000,-1000,557505
20200520,1723,中碳,102.00,103.50,101.50,102.00,0.00,0.00,256474,226,26287581,23000,137000,-114000,0,0,0,6000,0,6000,-108000
20200520,1724,台硝,12.25,12.25,12.15,12.25,-0.05,-0.41,9187,19,112187,0,3000,-3000,0,0,0,1000,0,1000,-2000
20200520,1725,元禎,14.30,14.50,14.30,14.40,-0.10,-0.69,12420,14,178964,3000,2000,1000,0,0,0,0,0,0,1000
20200520,1726,永記,69.90,69.90,67.30,68.80,-0.50,-0.72,39287,38,2699688,7000,24000,-17000,0,0,0,0,1000,-1000,-18000
20200520,1727,中華化,9.10,9.26,9.00,9.00,-0.10,-1.1,139103,70,1260694,2000,3000,-1000,0,0,0,0,0,0,-1000
20200520,1730,花仙子,71.50,71.50,70.20,70.70,-0.70,-0.98,179430,141,12702190,38000,34000,4000,0,0,0,0,0,0,4000
20200520,1731,美吾華,13.80,14.10,13.60,13.90,+0.15,1.09,1043161,556,14494278,407000,11000,396000,0,0,0,119000,0,119000,515000
20200520,1732,毛寶,31.30,31.50,30.75,31.05,+0.30,0.98,1278500,860,39929673,59000,9000,50000,0,0,0,0,8000,-8000,42000
20200520,1733,五鼎,25.60,25.60,24.65,24.70,-1.00,-3.89,1413601,801,35309495,40000,129000,-89000,0,0,0,6000,75000,-69000,-158000
20200520,1734,杏輝,20.95,20.95,20.55,20.65,-0.15,-0.72,462991,262,9601494,94000,80177,13823,0,0,0,1000,0,1000,14823
20200520,1735,日勝化,16.85,16.85,16.70,16.70,0.00,0.00,2059,4,34535,0,1000,-1000,0,0,0,0,0,0,-1000
20200520,1736,喬山,64.90,66.30,64.00,66.20,+2.40,3.76,2978843,2069,194724887,829000,160000,669000,0,0,0,99000,1000,98000,767000
20200520,1737,臺鹽,30.95,31.15,30.90,31.00,+0.05,0.16,255728,141,7937818,8000,31000,-23000,0,0,0,1000,0,1000,-22000
20200520,1760,寶齡富錦,143.50,154.00,140.00,154.00,+14.00,10.0,36553926,20413,5468632104,1475000,939100,535900,297000,0,297000,22000,5000,17000,849900
20200520,1762,中化生,63.80,64.70,60.60,61.90,-1.20,-1.9,14703914,8757,922934768,1403000,963000,440000,0,210000,-210000,9000,39000,-30000,200000
20200520,1773,勝一,96.40,97.30,96.00,96.90,-0.10,-0.1,197229,183,19039427,35000,7000,28000,0,0,0,1000,4000,-3000,25000
20200520,1776,展宇,17.05,17.05,16.95,17.00,-0.15,-0.87,12000,10,204050,0,2000,-2000,0,0,0,0,0,0,-2000
20200520,1783,和康生,27.85,27.85,27.15,27.30,-0.55,-1.97,686000,430,18765600,55000,79000,-24000,0,0,0,0,0,0,-24000
20200520,1786,科妍,62.50,62.80,62.10,62.30,-0.10,-0.16,106071,85,6621423,34000,8000,26000,0,0,0,1000,0,1000,27000
20200520,1789,神隆,32.45,32.50,31.60,31.75,-0.30,-0.94,3602742,2342,115156352,675000,512000,163000,0,500000,-500000,18000,1000,17000,-320000
20200520,1795,美時,77.80,78.80,77.00,78.00,+0.70,0.91,1765191,1353,137518000,821000,105105,715895,0,0,0,0,0,0,715895
20200520,1802,台玻,8.96,8.97,8.74,8.78,-0.13,-1.46,1114698,415,9842628,284000,349000,-65000,0,0,0,182000,4000,178000,113000
20200520,1805,寶徠,8.11,8.27,8.11,8.17,-0.15,-1.8,15535,15,126340,1000,1000,0,0,0,0,0,0,0,0
20200520,1806,冠軍,4.93,4.96,4.88,4.94,0.00,0.00,322771,115,1588659,23000,7000,16000,0,0,0,1000,0,1000,17000
20200520,1808,潤隆,58.80,58.90,58.50,58.60,-0.20,-0.34,126500,95,7422250,35000,54000,-19000,0,0,0,0,0,0,-19000
20200520,1809,中釉,9.21,9.27,9.13,9.20,+0.01,0.11,488527,169,4503518,98000,24000,74000,0,0,0,0,0,0,74000
20200520,1810,和成,7.30,7.31,7.24,7.28,+0.01,0.14,116000,41,844060,11000,7000,4000,0,0,0,0,0,0,4000
20200520,1817,凱撒衛,30.40,30.50,29.80,30.35,-0.05,-0.16,204700,74,6191945,2000,23000,-21000,0,0,0,0,1000,-1000,-22000
20200520,1902,台紙,20.65,20.70,20.65,20.70,+0.05,0.24,1076034,504,22223084,0,615000,-615000,0,0,0,0,0,0,-615000
20200520,1903,士紙,44.20,45.45,43.10,43.70,-0.30,-0.68,535150,316,23887488,47000,70000,-23000,0,0,0,0,0,0,-23000
20200520,1904,正隆,23.80,24.15,23.55,23.55,-0.05,-0.21,8563882,3939,204256854,2015594,859267,1156327,1404000,0,1404000,181000,109000,72000,2632327
20200520,1905,華紙,7.75,7.77,7.70,7.75,0.00,0.00,916605,274,7096291,329000,80000,249000,0,0,0,6000,2000,4000,253000
20200520,1906,寶隆,12.20,12.30,12.05,12.05,-0.15,-1.23,102100,59,1242693,13000,17000,-4000,0,0,0,3000,0,3000,-1000
20200520,1907,永豐餘,13.35,13.35,13.20,13.25,-0.10,-0.75,1775161,584,23575919,254000,430000,-176000,0,0,0,1000,3000,-2000,-178000
20200520,1909,榮成,12.90,12.95,12.40,12.55,-0.25,-1.95,5044058,1700,63809077,381000,2116000,-1735000,0,0,0,13000,60000,-47000,-1782000
20200520,2002,中鋼,19.85,19.90,19.80,19.90,+0.10,0.51,15227504,5103,302358598,6666982,6265000,401982,33000,0,33000,1084000,221000,863000,1297982
20200520,2002A,中鋼特,53.40,53.40,53.30,53.40,0.00,0.00,6050,7,322985,0,0,0,0,0,0,2000,0,2000,2000
20200520,2006,東和鋼鐵,23.50,23.65,23.45,23.55,+0.05,0.21,1578176,594,37165781,188000,257993,-69993,0,0,0,170000,8000,162000,92007
20200520,2007,燁興,3.84,3.94,3.84,3.86,+0.01,0.26,192517,64,750716,10000,10000,0,0,0,0,0,0,0,0
20200520,2008,高興昌,12.35,12.35,12.30,12.30,-0.10,-0.81,14163,15,174345,3000,2000,1000,0,0,0,0,0,0,1000
20200520,2009,第一銅,7.36,7.37,7.29,7.35,0.00,0.00,140525,67,1029161,36000,12000,24000,0,0,0,0,0,0,24000
20200520,2010,春源,9.35,9.36,9.31,9.32,-0.03,-0.32,241030,77,2251039,46000,63000,-17000,0,0,0,0,13000,-13000,-30000
20200520,2012,春雨,17.65,17.65,17.55,17.55,-0.05,-0.28,43336,32,762146,3000,6000,-3000,0,0,0,2000,0,2000,-1000
20200520,2013,中鋼構,24.50,24.60,24.15,24.15,-0.25,-1.02,758957,366,18510604,59000,35000,24000,0,0,0,3000,1000,2000,26000
20200520,2014,中鴻,7.38,7.38,7.27,7.29,+0.03,0.41,1202612,394,8794267,360000,214589,145411,0,0,0,11000,3000,8000,153411
20200520,2015,豐興,52.20,52.40,52.00,52.00,-0.20,-0.38,208864,115,10891846,46864,149774,-102910,0,0,0,0,1000,-1000,-103910
20200520,2017,官田鋼,6.77,6.80,6.71,6.72,-0.01,-0.15,265823,84,1799230,18000,10000,8000,0,0,0,5000,0,5000,13000
20200520,2020,美亞,17.65,17.80,17.65,17.80,+0.15,0.85,770553,278,13643759,20000,55407,-35407,0,0,0,0,0,0,-35407
20200520,2022,聚亨,4.28,4.35,4.27,4.30,+0.03,0.7,795795,216,3423127,23000,89000,-66000,0,0,0,1000,9000,-8000,-74000
20200520,2023,燁輝,8.37,8.45,8.37,8.40,+0.01,0.12,1027819,270,8638456,379000,309000,70000,0,0,0,85000,2000,83000,153000
20200520,2024,志聯,12.50,12.50,12.45,12.50,0.00,0.00,98480,22,1230850,3000,2000,1000,0,0,0,0,0,0,1000
20200520,2025,千興,1.80,1.80,1.67,1.68,-0.08,-4.55,92983,15,158578,0,0,0,0,0,0,0,0,0,0
20200520,2027,大成鋼,25.80,27.00,25.75,26.85,+1.05,4.07,6008948,2899,159480644,1245000,1301000,-56000,0,0,0,1188000,95000,1093000,1037000
20200520,2028,威致,9.40,9.40,9.36,9.36,-0.04,-0.43,14205,10,133397,0,3000,-3000,0,0,0,0,0,0,-3000
20200520,2029,盛餘,15.95,16.25,15.95,16.25,+0.25,1.56,33681,36,539799,8000,10000,-2000,0,0,0,4000,0,4000,2000
20200520,2030,彰源,10.25,10.25,10.15,10.20,0.00,0.00,120552,62,1228575,6000,5000,1000,0,0,0,2000,0,2000,3000
20200520,2031,新光鋼,24.25,24.25,23.75,23.75,-0.25,-1.04,307712,208,7356106,30000,133000,-103000,0,0,0,7000,2000,5000,-98000
20200520,2032,新鋼,8.32,8.36,8.29,8.36,+0.07,0.84,61051,23,508633,2000,3000,-1000,0,0,0,0,0,0,-1000
20200520,2033,佳大,9.49,9.50,9.26,9.49,+0.02,0.21,80265,35,755570,0,3000,-3000,0,0,0,0,0,0,-3000
20200520,2034,允強,23.70,23.90,23.60,23.60,-0.10,-0.42,330147,180,7819317,73000,145673,-72673,0,0,0,5000,1000,4000,-68673
20200520,2038,海光,6.85,6.95,6.65,6.74,-0.15,-2.18,489085,229,3296225,9000,5000,4000,0,0,0,1000,0,1000,5000
20200520,2049,上銀,291.00,291.00,284.00,285.00,-4.00,-1.38,1088487,987,312837024,326473,204417,122056,0,0,0,55000,26000,29000,151056
20200520,2059,川湖,316.00,331.50,316.00,323.50,+10.50,3.35,829162,713,269282502,109000,144000,-35000,0,0,0,5000,7000,-2000,-37000
20200520,2062,橋椿,19.45,19.45,18.85,19.00,-0.25,-1.3,163500,119,3114300,9000,40000,-31000,0,0,0,2000,0,2000,-29000
20200520,2069,運錩,15.95,16.05,15.70,15.85,-0.45,-2.76,45024,33,713334,4000,2000,2000,0,0,0,1000,0,1000,3000
20200520,2101,南港,38.85,39.70,38.35,39.70,+0.95,2.45,1846934,989,72191790,159000,561000,-402000,0,0,0,36000,7000,29000,-373000
20200520,2102,泰豐,15.85,16.20,15.70,15.90,+0.10,0.63,3626121,1136,57951309,510000,903000,-393000,0,0,0,0,1000,-1000,-394000
20200520,2103,台橡,16.90,17.00,16.50,16.60,-0.15,-0.9,2814275,1219,46961067,110000,1458000,-1348000,0,0,0,3000,1000,2000,-1346000
20200520,2104,國際中橡,20.20,20.20,19.85,19.90,-0.20,-1.0,3334152,1228,66621407,571000,938771,-367771,0,0,0,2000,3000,-1000,-368771
20200520,2105,正新,33.45,33.80,32.80,33.70,+0.40,1.2,4357755,2134,145520329,1654000,998000,656000,5000,0,5000,409000,153000,256000,917000
20200520,2106,建大,30.30,30.50,29.90,30.30,0.00,0.00,2361775,983,71173435,126000,525000,-399000,177000,0,177000,1000,1000,0,-222000
20200520,2107,厚生,18.25,18.30,18.00,18.10,-0.15,-0.82,377107,202,6829976,31000,32000,-1000,0,0,0,0,9000,-9000,-10000
20200520,2108,南帝,35.90,36.10,35.00,35.15,-0.55,-1.54,2916318,1712,102861858,971000,350350,620650,0,0,0,1000,1000,0,620650
20200520,2109,華豐,12.90,13.40,12.90,13.20,+0.20,1.54,647999,229,8531086,115000,32000,83000,0,0,0,0,0,0,83000
20200520,2114,鑫永銓,80.80,81.30,80.70,80.70,+0.10,0.12,61324,45,4968044,2000,2000,0,0,0,0,0,0,0,0
20200520,2115,六暉-KY,40.95,41.00,40.35,40.35,-0.35,-0.86,12239,15,496892,1000,1000,0,0,0,0,0,1000,-1000,-1000
20200520,2201,裕隆,20.20,20.60,19.25,20.35,+0.65,3.3,37020046,12240,739649251,5276000,5440000,-164000,3187000,0,3187000,459000,104000,355000,3378000
20200520,2204,中華,36.50,37.25,36.15,36.45,-0.15,-0.41,2144106,1235,78415585,606000,211000,395000,0,0,0,1000,7000,-6000,389000
20200520,2206,三陽工業,20.05,20.10,19.95,20.05,0.00,0.00,402400,181,8051799,82000,103000,-21000,0,0,0,1000,1000,0,-21000
20200520,2207,和泰車,545.00,555.00,536.00,551.00,+13.00,2.42,939714,880,515819414,379359,389732,-10373,3000,0,3000,13000,17000,-4000,-11373
20200520,2208,台船,25.20,25.40,24.20,24.25,-0.25,-1.02,3550831,1847,87986343,245000,550000,-305000,0,0,0,1000,1000,0,-305000
20200520,2227,裕日車,262.50,262.50,259.00,261.00,-0.50,-0.19,59340,60,15475089,5000,13000,-8000,0,0,0,3000,0,3000,-5000
20200520,2228,劍麟,88.00,88.30,87.20,87.90,+0.70,0.8,282200,244,24779340,74000,42000,32000,0,0,0,2000,4000,-2000,30000
20200520,2231,為升,161.00,163.50,155.50,156.50,-3.50,-2.19,1626097,1289,257366729,151000,286000,-135000,0,0,0,16000,14000,2000,-133000
20200520,2233,宇隆,61.50,61.60,61.00,61.20,-0.30,-0.49,241024,181,14769767,4000,36000,-32000,0,0,0,2000,67000,-65000,-97000
20200520,2236,百達-KY,15.45,15.50,15.35,15.45,+0.20,1.31,16778,14,259486,0,1000,-1000,0,0,0,0,0,0,-1000
20200520,2239,英利-KY,59.40,59.40,58.70,59.00,-0.40,-0.67,47527,49,2801197,11000,20000,-9000,0,0,0,0,0,0,-9000
20200520,2243,宏旭-KY,10.10,10.60,9.92,9.92,-0.18,-1.78,82000,52,841710,2000,0,2000,0,0,0,2000,0,2000,4000
20200520,2301,光寶科,47.20,47.20,46.80,46.80,0.00,0.00,4477494,2763,210198188,1241650,2362341,-1120691,506000,0,506000,922000,262000,660000,45309
20200520,2302,麗正,7.08,7.10,7.00,7.02,-0.05,-0.71,141503,60,994271,20000,3000,17000,0,0,0,0,0,0,17000
20200520,2303,聯電,15.15,15.15,14.85,14.85,-0.10,-0.67,63261595,17936,946138123,33577698,32912748,664950,30000,0,30000,863000,579000,284000,978950
20200520,2305,全友,5.21,5.29,5.20,5.21,0.00,0.00,186809,88,977416,13000,6000,7000,0,0,0,4000,1000,3000,10000
20200520,2308,台達電,142.00,142.00,139.00,141.00,0.00,0.00,4247196,1980,598224636,2572000,2914000,-342000,256000,3000,253000,146000,154000,-8000,-97000
20200520,2312,金寶,12.00,12.00,11.60,12.00,0.00,0.00,14310908,3528,168917496,1736000,2334000,-598000,0,0,0,122000,88000,34000,-564000
20200520,2313,華通,39.00,39.80,38.50,39.15,-0.15,-0.38,25165201,11540,983280028,4381095,2365000,2016095,1478000,545000,933000,734000,3390000,-2656000,293095
20200520,2314,台揚,21.30,21.35,20.80,21.00,-0.20,-0.94,741119,422,15592978,160000,242000,-82000,0,0,0,8000,1000,7000,-75000
20200520,2316,楠梓電,29.85,30.35,29.55,29.80,-0.10,-0.33,2442014,1012,72961410,458000,590000,-132000,0,0,0,92000,16000,76000,-56000
20200520,2317,鴻海,74.90,75.30,74.50,74.50,-0.30,-0.4,30828720,13870,2304984331,11979996,19839122,-7859126,32000,0,32000,839000,533000,306000,-7521126
20200520,2321,東訊,1.41,1.50,1.41,1.50,+0.13,9.49,227559,51,341066,0,0,0,0,0,0,0,0,0,0
20200520,2323,中環,7.60,7.79,7.52,7.60,+0.08,1.06,15415510,4092,117685198,2134000,2751000,-617000,0,5000,-5000,1755000,500000,1255000,633000
20200520,2324,仁寶,18.60,18.60,18.45,18.50,0.00,0.00,8275080,2559,153175659,5313000,6301498,-988498,0,0,0,84000,117000,-33000,-1021498
20200520,2327,國巨,381.00,395.00,379.00,384.50,+11.50,3.08,33041224,24029,12779005688,2859230,8111000,-5251770,51000,219000,-168000,1524000,384000,1140000,-4279770
20200520,2328,廣宇,18.05,18.35,18.05,18.05,0.00,0.00,1068440,541,19413207,82000,340000,-258000,0,0,0,106000,8000,98000,-160000
20200520,2329,華泰,11.30,11.50,11.20,11.20,-0.10,-0.88,2162996,597,24521693,423000,248000,175000,0,0,0,10000,1000,9000,184000
20200520,2330,台積電,293.00,294.00,291.00,294.00,+2.50,0.86,36789994,16906,10772280152,29265379,17645464,11619915,274000,124000,150000,2412000,2289993,122007,11891922
20200520,2331,精英,11.70,11.70,11.55,11.55,-0.15,-1.28,493932,271,5731017,111000,44000,67000,0,0,0,69000,0,69000,136000
20200520,2332,友訊,12.55,12.75,12.45,12.55,0.00,0.00,4056237,1266,51063408,655000,449000,206000,0,0,0,45000,67000,-22000,184000
20200520,2337,旺宏,33.00,33.35,32.80,32.85,+0.05,0.15,27049761,10485,893273899,4436000,3908000,528000,0,1136000,-1136000,254000,294000,-40000,-648000
20200520,2338,光罩,26.05,26.65,25.85,26.50,+0.90,3.52,4848999,2566,127481119,742000,880000,-138000,0,0,0,71000,19000,52000,-86000
20200520,2340,光磊,20.70,21.10,20.60,21.00,+0.30,1.45,3385117,1167,70865335,1136000,66000,1070000,0,0,0,222000,47000,175000,1245000
20200520,2342,茂矽,28.70,29.95,27.80,27.80,-1.10,-3.81,16321414,7962,473016085,864000,1475000,-611000,0,0,0,5000,0,5000,-606000
20200520,2344,華邦電,13.05,13.35,13.00,13.10,+0.20,1.55,22673907,5691,298634468,6089700,4042736,2046964,0,0,0,274000,488000,-214000,1832964
20200520,2345,智邦,213.00,215.50,210.50,215.00,+3.00,1.42,4186307,3041,892271034,2793500,2042808,750692,103000,0,103000,168000,95000,73000,926692
20200520,2347,聯強,43.50,44.20,43.35,44.10,+0.95,2.2,8628977,4387,379254570,4405531,1203681,3201850,800000,0,800000,111000,230000,-119000,3882850
20200520,2348,海悅,60.60,60.60,60.00,60.10,-0.30,-0.5,284142,170,17108477,60000,15000,45000,0,0,0,0,1000,-1000,44000
20200520,2349,錸德,5.80,6.28,5.39,5.95,+0.16,2.76,27667737,6932,160207646,1285000,6090000,-4805000,0,4000,-4000,0,0,0,-4809000
20200520,2351,順德,44.65,45.25,44.35,45.20,+0.55,1.23,362000,228,16283100,120000,47000,73000,0,0,0,3000,1000,2000,75000
20200520,2352,佳世達,16.55,16.85,16.50,16.80,+0.35,2.13,7158766,2511,119625173,1129722,1201000,-71278,0,0,0,79000,105000,-26000,-97278
20200520,2353,宏碁,16.40,16.45,16.15,16.30,-0.05,-0.31,7374489,2488,120137021,3400000,4520880,-1120880,0,0,0,530000,182000,348000,-772880
20200520,2354,鴻準,54.50,55.00,54.50,54.70,+0.20,0.37,1853305,1209,101405495,934000,838507,95493,0,0,0,245000,64000,181000,276493
20200520,2355,敬鵬,24.10,25.25,24.05,24.25,+0.35,1.46,6149637,3126,151461791,1015000,905702,109298,0,0,0,132000,66000,66000,175298
20200520,2356,英業達,23.80,24.10,23.80,23.95,+0.20,0.84,8802447,3130,210713678,5270000,3138506,2131494,0,0,0,212000,205000,7000,2138494
20200520,2357,華碩,211.50,213.00,205.50,205.50,-5.00,-2.38,3195130,2340,664824331,1499370,2569042,-1069672,3000,0,3000,270000,4000,266000,-800672
20200520,2358,廷鑫,13.75,13.75,13.50,13.60,-0.15,-1.09,130361,68,1767173,18000,3000,15000,0,0,0,0,0,0,15000
20200520,2359,所羅門,18.35,18.50,18.30,18.40,+0.05,0.27,192055,108,3532503,72000,8000,64000,0,0,0,3000,0,3000,67000
20200520,2360,致茂,132.50,135.50,132.50,134.50,+3.50,2.67,1168515,931,156574267,752000,125000,627000,0,0,0,61000,30000,31000,658000
20200520,2362,藍天,29.90,30.15,29.55,29.55,-0.40,-1.34,386792,215,11542048,67000,95000,-28000,0,0,0,8000,2000,6000,-22000
20200520,2363,矽統,11.90,12.25,11.80,12.00,+0.10,0.84,17439988,4544,210622837,4763000,1038000,3725000,0,0,0,6000,0,6000,3731000
20200520,2364,倫飛,2.10,2.10,2.10,2.10,0.00,0.00,54644,9,114669,0,0,0,0,0,0,0,0,0,0
20200520,2365,昆盈,7.81,7.92,7.81,7.92,+0.12,1.54,256122,122,2016267,124000,5000,119000,0,0,0,5000,0,5000,124000
20200520,2367,燿華,21.70,23.50,21.70,23.30,+1.50,6.88,31200736,11321,707182040,6582001,4522413,2059588,0,0,0,1471000,125000,1346000,3405588
20200520,2368,金像電,33.50,33.75,32.50,32.70,-0.80,-2.39,30696285,11455,1015199757,2570000,6429000,-3859000,0,47000,-47000,576000,636000,-60000,-3966000
20200520,2369,菱生,9.40,9.50,9.37,9.45,+0.09,0.96,914888,392,8631221,325000,154000,171000,0,0,0,6000,1000,5000,176000
20200520,2371,大同,20.50,20.65,20.35,20.60,+0.25,1.23,4390839,1563,89971192,1480000,2573000,-1093000,0,0,0,87000,18000,69000,-1024000
20200520,2373,震旦行,88.60,89.00,86.40,88.00,-0.60,-0.68,68543,66,6034784,16000,57000,-41000,0,0,0,3000,0,3000,-38000
20200520,2374,佳能,11.80,11.90,11.75,11.85,+0.05,0.42,160581,93,1897498,28000,43000,-15000,0,0,0,5000,1000,4000,-11000
20200520,2375,凱美,37.15,37.95,36.95,37.10,+0.35,0.95,2682248,1817,100169626,406000,468000,-62000,0,0,0,55000,19000,36000,-26000
20200520,2376,技嘉,63.10,63.70,62.00,62.60,0.00,0.00,9552217,5455,598260032,2830932,1332193,1498739,0,1000,-1000,169000,350000,-181000,1316739
20200520,2377,微星,108.00,108.50,105.00,106.50,+0.50,0.47,7190372,4725,768350432,3434933,1306489,2128444,119000,200000,-81000,127000,316000,-189000,1858444
20200520,2379,瑞昱,258.50,261.50,252.00,255.50,-0.50,-0.2,5811301,4257,1491551954,1343181,2171566,-828385,51000,0,51000,126000,218000,-92000,-869385
20200520,2380,虹光,3.55,3.61,3.46,3.57,-0.01,-0.28,112877,67,396173,3000,2000,1000,0,0,0,0,0,0,1000
20200520,2382,廣達,69.00,69.20,67.70,68.30,0.00,0.00,10612733,6109,727264558,5824675,2228928,3595747,229000,0,229000,434000,214000,220000,4044747
20200520,2383,台光電,135.50,136.50,133.50,135.50,+0.50,0.37,2797957,1933,377857669,683000,384814,298186,84000,153000,-69000,400000,206000,194000,423186
20200520,2385,群光,81.70,81.90,81.00,81.10,+0.10,0.12,1988931,1267,162067035,1695000,1111144,583856,0,0,0,25000,15000,10000,593856
20200520,2387,精元,29.20,29.95,28.95,29.10,+0.15,0.52,1842582,1222,54068142,383000,516000,-133000,0,0,0,146000,5000,141000,8000
20200520,2388,威盛,28.90,29.50,28.40,28.95,+0.05,0.17,883131,469,25634783,222000,149000,73000,0,1000,-1000,0,0,0,72000
20200520,2390,云辰,9.78,10.45,9.44,10.05,+0.15,1.52,7158192,2553,70447395,153000,208000,-55000,0,0,0,0,0,0,-55000
20200520,2392,正崴,36.25,36.60,36.05,36.10,-0.15,-0.41,1589762,911,57690746,385000,248000,137000,0,0,0,45000,185000,-140000,-3000
20200520,2393,億光,32.00,33.00,31.70,32.45,+0.75,2.37,2367794,1492,76974464,1226000,783687,442313,0,0,0,148000,154000,-6000,436313
20200520,2395,研華,288.00,290.00,284.00,285.00,-3.00,-1.04,488940,455,139844367,356210,312756,43454,1000,0,1000,29000,1000,28000,72454
20200520,2397,友通,75.10,75.70,75.10,75.40,-0.50,-0.66,46010,38,3469360,15000,6000,9000,0,0,0,2000,1000,1000,10000
20200520,2399,映泰,9.90,10.05,9.87,9.95,+0.06,0.61,404587,183,4027080,183000,39000,144000,0,0,0,3000,0,3000,147000
20200520,2401,凌陽,11.25,11.35,10.60,10.95,-0.20,-1.79,10463821,3619,115365231,150000,1623000,-1473000,0,0,0,220000,70000,150000,-1323000
20200520,2402,毅嘉,12.75,12.85,12.60,12.70,-0.05,-0.39,451633,224,5747192,133000,40000,93000,0,0,0,22000,1000,21000,114000
20200520,2404,漢唐,192.00,194.00,191.00,191.50,-0.50,-0.26,785658,695,150714336,100000,416834,-316834,0,74000,-74000,30000,33000,-3000,-393834
20200520,2405,浩鑫,9.92,10.05,9.88,9.89,-0.06,-0.6,1089001,317,10838469,89000,70000,19000,0,0,0,0,0,0,19000
20200520,2406,國碩,9.55,9.70,9.41,9.56,+0.12,1.27,1754963,517,16766141,587000,299000,288000,0,0,0,3000,0,3000,291000
20200520,2408,南亞科,60.00,61.00,59.60,59.90,+0.70,1.18,10004291,5735,602439031,2593000,2721000,-128000,2000,350000,-348000,397000,301000,96000,-380000
20200520,2409,友達,7.72,7.88,7.63,7.63,-0.03,-0.39,62918768,12210,487016101,15336000,20830000,-5494000,0,0,0,1991000,1317000,674000,-4820000
20200520,2412,中華電,111.00,111.50,111.00,111.50,+0.50,0.45,5522356,2883,614697016,1837000,1020509,816491,10000,196000,-186000,554000,92000,462000,1092491
20200520,2413,環科,12.00,12.30,11.95,12.10,-0.05,-0.41,206145,71,2491504,18000,5000,13000,0,0,0,2000,1000,1000,14000
20200520,2414,精技,23.95,24.00,23.85,23.90,-0.05,-0.21,115082,84,2753258,17000,5000,12000,0,0,0,3000,0,3000,15000
20200520,2415,錩新,16.10,16.10,15.80,15.85,-0.25,-1.55,294357,148,4674908,11000,6000,5000,0,0,0,2000,1000,1000,6000
20200520,2417,圓剛,13.45,13.65,13.25,13.50,+0.15,1.12,1991324,740,26783239,642000,116000,526000,0,0,0,7000,0,7000,533000
20200520,2419,仲琦,20.15,20.25,20.05,20.10,-0.05,-0.25,223101,139,4489670,46000,41000,5000,0,0,0,4000,0,4000,9000
20200520,2420,新巨,33.75,33.80,33.60,33.70,+0.15,0.45,211002,138,7105668,43000,13000,30000,0,0,0,2000,34000,-32000,-2000
20200520,2421,建準,53.30,53.30,50.70,52.40,-0.60,-1.13,7285442,4703,377529406,1921465,1095145,826320,0,588000,-588000,293000,429000,-136000,102320
20200520,2423,固緯,23.85,23.85,23.60,23.75,+0.10,0.42,92747,79,2197802,7000,14000,-7000,0,0,0,2000,1000,1000,-6000
20200520,2424,隴華,,,,,0.00,0.00,0,0,0,0,0,0,0,0,0,0,0,0,0
20200520,2425,承啟,24.30,24.35,24.10,24.20,-0.10,-0.41,87688,62,2123448,29000,25000,4000,0,0,0,3000,0,3000,7000
20200520,2426,鼎元,13.75,14.30,13.75,14.20,+0.55,4.03,10226579,2656,143858055,624000,676000,-52000,0,0,0,5000,1000,4000,-48000
20200520,2427,三商電,9.97,10.05,9.94,9.94,-0.11,-1.09,102000,52,1018120,4000,4000,0,0,0,0,3000,5000,-2000,-2000
20200520,2428,興勤,86.50,87.70,86.10,87.60,+1.40,1.62,354300,283,30862469,46000,51000,-5000,0,0,0,3000,7000,-4000,-9000
20200520,2429,銘旺科,19.05,19.30,18.85,19.00,-0.45,-2.31,97903,61,1862695,4000,6000,-2000,0,0,0,0,0,0,-2000
20200520,2430,燦坤,16.90,17.10,16.90,16.95,+0.10,0.59,373157,130,6346633,5000,3000,2000,0,0,0,2000,2000,0,2000
20200520,2431,聯昌,8.20,8.24,8.11,8.14,-0.05,-0.61,303074,115,2479157,25000,47000,-22000,0,0,0,3000,0,3000,-19000
20200520,2433,互盛電,51.80,51.80,51.60,51.80,-0.10,-0.19,104400,84,5402160,12000,22000,-10000,0,0,0,5000,0,5000,-5000
20200520,2434,統懋,6.80,6.80,6.25,6.25,-0.15,-2.34,3110,3,20515,0,0,0,0,0,0,0,0,0,0
20200520,2436,偉詮電,25.45,26.75,25.45,26.55,+1.25,4.94,2956799,1593,77542275,352000,113000,239000,0,0,0,8000,0,8000,247000
20200520,2438,翔耀,5.68,5.73,5.59,5.59,-0.10,-1.76,44282,18,251729,2000,2000,0,0,0,0,0,0,0,0
20200520,2439,美律,129.50,130.50,128.00,128.50,-1.00,-0.77,1433552,1199,184640260,92000,538390,-446390,33000,0,33000,144000,63000,81000,-332390
20200520,2440,太空梭,9.43,9.43,8.75,8.75,-0.15,-1.69,19652,17,176748,2000,0,2000,0,0,0,0,0,0,2000
20200520,2441,超豐,45.15,45.65,45.15,45.60,+0.55,1.22,595675,468,27068143,441000,138000,303000,0,0,0,12000,10000,2000,305000
20200520,2442,新美齊,7.89,7.94,7.70,7.70,-0.15,-1.91,639195,270,4984789,85000,182000,-97000,0,0,0,8000,1000,7000,-90000
20200520,2443,億麗,2.96,2.96,2.85,2.89,-0.07,-2.36,256407,108,745117,6000,12000,-6000,0,0,0,0,0,0,-6000
20200520,2444,兆勁,16.60,16.80,16.25,16.55,0.00,0.00,2277112,395,37845692,82000,2000,80000,0,0,0,0,0,0,80000
20200520,2448,晶電,36.45,37.85,36.20,37.80,+1.75,4.85,51280931,23365,1912440168,5479000,9397000,-3918000,1669000,0,1669000,1813000,100000,1713000,-536000
20200520,2449,京元電子,30.80,30.95,30.30,30.30,-0.75,-2.42,39757144,19321,1212734247,3912872,19991000,-16078128,0,0,0,1269000,55000,1214000,-14864128
20200520,2450,神腦,28.00,28.20,27.95,28.15,+0.20,0.72,163853,133,4599559,53000,67000,-14000,0,0,0,3000,0,3000,-11000
20200520,2451,創見,69.50,69.90,69.40,69.80,+0.30,0.43,644500,502,44897550,154000,273000,-119000,50000,0,50000,10000,7000,3000,-66000
20200520,2453,凌群,16.25,16.40,16.15,16.30,+0.10,0.62,359260,195,5837912,87000,10000,77000,0,0,0,1000,2000,-1000,76000
20200520,2454,聯發科,467.00,479.00,464.00,470.00,+8.00,1.73,18969567,12582,8904290369,13273835,5479447,7794388,215000,0,215000,191000,435000,-244000,7765388
20200520,2455,全新,88.00,88.00,83.70,84.50,-3.80,-4.3,3718130,2806,316798385,365000,1136000,-771000,0,98000,-98000,117000,240000,-123000,-992000
20200520,2456,奇力新,100.00,102.00,99.10,99.30,+1.00,1.02,8522259,5997,855976731,574136,2657000,-2082864,0,279000,-279000,169000,45000,124000,-2237864
20200520,2457,飛宏,6.90,7.13,6.85,7.04,+0.16,2.33,1176541,449,8256920,351000,170000,181000,0,0,0,6000,0,6000,187000
20200520,2458,義隆,93.00,94.00,92.30,93.60,+0.70,0.75,2903365,2091,270950249,948000,658937,289063,250000,354000,-104000,41000,105000,-64000,121063
20200520,2459,敦吉,40.40,40.45,40.15,40.45,+0.05,0.12,73922,59,2979993,1000,3000,-2000,0,0,0,1000,1000,0,-2000
20200520,2460,建通,8.07,8.07,7.97,7.97,-0.06,-0.75,37251,22,298401,2000,3000,-1000,0,0,0,3000,0,3000,2000
20200520,2461,光群雷,14.65,14.65,14.40,14.65,+0.15,1.03,520994,258,7581859,117000,75000,42000,0,0,0,8000,0,8000,50000
20200520,2462,良得電,26.60,26.60,26.35,26.35,-0.35,-1.31,51964,29,1378505,9000,2000,7000,0,0,0,2000,0,2000,9000
20200520,2464,盟立,37.10,37.30,37.00,37.00,-0.10,-0.27,447062,291,16590062,58000,53000,5000,0,0,0,2000,51000,-49000,-44000
20200520,2465,麗臺,9.38,9.40,9.19,9.21,-0.04,-0.43,113012,67,1045889,1000,6000,-5000,0,0,0,0,0,0,-5000
20200520,2466,冠西電,30.00,30.00,29.60,29.80,-0.25,-0.83,60000,38,1794400,1000,3000,-2000,0,0,0,3000,0,3000,1000
20200520,2467,志聖,28.30,28.40,28.10,28.25,0.00,0.00,535486,345,15094950,92000,199000,-107000,0,0,0,3000,0,3000,-104000
20200520,2468,華經,12.60,12.60,12.50,12.55,-0.05,-0.4,48186,32,604555,4000,2000,2000,0,0,0,0,0,0,2000
20200520,2471,資通,21.30,21.80,21.05,21.60,+0.35,1.65,1917523,528,41176694,188000,373000,-185000,0,0,0,1000,131000,-130000,-315000
20200520,2472,立隆電,41.85,42.40,41.35,41.75,+0.05,0.12,1156656,792,48391739,156000,152000,4000,0,0,0,8000,0,8000,12000
20200520,2474,可成,221.50,221.50,215.50,217.50,-6.50,-2.9,8418860,6521,1830388259,1503717,4066506,-2562789,2000,900000,-898000,67000,310000,-243000,-3703789
20200520,2476,鉅祥,19.95,20.10,19.95,20.00,+0.05,0.25,133740,78,2680460,4000,72000,-68000,0,0,0,0,0,0,-68000
20200520,2477,美隆電,22.20,22.20,21.45,21.45,+0.15,0.7,86363,86,1880281,8000,21000,-13000,0,0,0,15000,0,15000,2000
20200520,2478,大毅,79.00,81.00,78.10,78.10,+0.20,0.26,10815489,7004,857937576,722000,765000,-43000,0,0,0,95000,17000,78000,35000
20200520,2480,敦陽科,63.90,65.00,63.80,64.80,+1.30,2.05,838091,611,53936466,176000,53000,123000,0,0,0,1000,2000,-1000,122000
20200520,2481,強茂,23.75,24.30,23.65,24.05,+0.25,1.05,4396169,2095,105513633,575000,687000,-112000,0,200000,-200000,10000,1000,9000,-303000
20200520,2482,連宇,10.80,10.95,10.80,10.95,+0.15,1.39,133400,58,1448408,0,2000,-2000,0,0,0,3000,0,3000,1000
20200520,2483,百容,19.55,19.60,19.55,19.55,0.00,0.00,74255,41,1452385,8000,2000,6000,0,0,0,2000,0,2000,8000
20200520,2484,希華,21.20,21.45,21.05,21.05,0.00,0.00,1622669,650,34473576,339000,191000,148000,0,0,0,3000,0,3000,151000
20200520,2485,兆赫,15.85,16.45,15.50,16.25,+0.40,2.52,1950833,719,31326714,512000,144000,368000,0,0,0,71000,26000,45000,413000
20200520,2486,一詮,7.42,7.45,7.29,7.45,+0.05,0.68,204685,112,1510309,63000,5000,58000,0,0,0,3000,0,3000,61000
20200520,2488,漢平,28.15,28.35,28.15,28.20,+0.05,0.18,89000,52,2512250,19000,5000,14000,0,0,0,1000,0,1000,15000
20200520,2489,瑞軒,7.16,7.59,7.16,7.36,+0.20,2.79,3370926,1380,25004250,997000,346000,651000,0,0,0,89000,180000,-91000,560000
20200520,2491,吉祥全,7.57,7.70,7.57,7.63,+0.07,0.93,43314,38,331021,3000,2000,1000,0,0,0,0,0,0,1000
20200520,2492,華新科,191.50,194.50,189.00,189.00,-1.50,-0.79,13771662,9317,2636044780,1437000,2854000,-1417000,60000,0,60000,212000,360000,-148000,-1505000
20200520,2493,揚博,33.50,34.00,33.40,33.60,+0.20,0.6,1499296,917,50488927,147000,103000,44000,0,0,0,3000,1000,2000,46000
20200520,2495,普安,11.45,11.70,11.45,11.70,+0.20,1.74,798193,174,9233755,57000,7000,50000,0,0,0,3000,0,3000,53000
20200520,2496,卓越,68.00,69.40,67.00,69.00,+1.50,2.22,127288,90,8702384,0,41000,-41000,0,0,0,0,0,0,-41000
20200520,2497,怡利電,16.10,16.25,15.95,16.00,+0.05,0.31,48099,31,771424,2000,3000,-1000,0,0,0,0,0,0,-1000
20200520,2498,宏達電,28.85,29.35,28.65,28.70,+0.05,0.17,5502473,2732,159375734,1174100,1258000,-83900,0,0,0,299000,207000,92000,8100
20200520,2501,國建,18.80,19.00,18.70,18.75,-0.05,-0.27,522481,339,9844865,119000,243097,-124097,0,0,0,3000,97000,-94000,-218097
20200520,2504,國產,14.25,14.30,14.10,14.20,-0.05,-0.35,4497018,1335,63883093,1569000,476000,1093000,0,0,0,421000,330000,91000,1184000
20200520,2505,國揚,21.25,21.40,20.70,21.10,-0.35,-1.63,5157363,2114,108656802,490000,1082000,-592000,0,0,0,52000,591000,-539000,-1131000
20200520,2506,太設,9.05,9.10,9.02,9.02,-0.03,-0.33,77136,46,698804,27000,9000,18000,0,0,0,0,0,0,18000
20200520,2509,全坤建,19.90,20.05,19.85,19.95,-0.10,-0.5,67610,50,1347337,7000,44000,-37000,0,0,0,0,0,0,-37000
20200520,2511,太子,9.76,9.83,9.72,9.74,-0.01,-0.1,666953,261,6509770,289000,115000,174000,0,0,0,17000,1000,16000,190000
20200520,2514,龍邦,14.50,14.55,14.40,14.45,-0.10,-0.69,99681,82,1441955,45000,48000,-3000,0,0,0,1000,2000,-1000,-4000
20200520,2515,中工,6.94,6.95,6.87,6.89,-0.05,-0.72,1982077,660,13703027,98877,265000,-166123,0,0,0,19000,206000,-187000,-353123
20200520,2516,新建,4.78,4.79,4.68,4.70,-0.06,-1.26,148871,68,704331,23000,14000,9000,0,0,0,0,4000,-4000,5000
20200520,2520,冠德,26.10,26.20,25.50,25.65,-0.55,-2.1,1395984,642,36007285,60000,464948,-404948,0,0,0,62000,68000,-6000,-410948
20200520,2524,京城,31.00,31.00,30.60,30.70,-0.35,-1.13,465414,140,14340365,21000,138000,-117000,0,0,0,0,1000,-1000,-118000
20200520,2527,宏璟,19.60,19.65,19.45,19.55,+0.05,0.26,178086,69,3473594,11000,8000,3000,0,0,0,0,0,0,3000
20200520,2528,皇普,20.05,20.05,19.90,20.05,-0.05,-0.25,58000,25,1159950,8000,3000,5000,0,0,0,0,0,0,5000
20200520,2530,華建,16.90,16.90,16.60,16.60,-0.20,-1.19,173132,73,2907290,8000,15000,-7000,0,0,0,0,0,0,-7000
20200520,2534,宏盛,17.15,17.30,16.95,17.00,-0.15,-0.87,664659,365,11338160,88000,203000,-115000,0,0,0,1000,1000,0,-115000
20200520,2535,達欣工,21.70,21.90,21.60,21.65,-0.05,-0.23,427739,255,9281184,37000,57000,-20000,0,0,0,109000,4000,105000,85000
20200520,2536,宏普,23.80,24.00,23.55,23.85,-0.15,-0.62,930167,415,22206855,151000,49000,102000,0,0,0,68000,0,68000,170000
20200520,2537,聯上發,10.05,10.10,9.96,10.05,0.00,0.00,1097297,320,10993640,314000,182000,132000,0,0,0,0,0,0,132000
20200520,2538,基泰,9.80,9.85,9.77,9.80,0.00,0.00,189066,76,1854313,51000,9000,42000,0,0,0,0,0,0,42000
20200520,2539,櫻花建,34.40,34.55,34.10,34.40,0.00,0.00,388454,168,13367069,35000,69000,-34000,0,0,0,0,1000,-1000,-35000
20200520,2540,愛山林,30.70,30.70,27.95,28.00,-2.90,-9.39,80034,61,2298602,7000,38000,-31000,0,0,0,2000,0,2000,-29000
20200520,2542,興富發,44.00,44.20,43.80,43.80,-0.20,-0.45,2415682,1437,106246308,1377000,1527653,-150653,0,0,0,195000,109000,86000,-64653
20200520,2543,皇昌,6.65,6.65,6.47,6.47,-0.06,-0.92,21000,17,137800,3000,8000,-5000,0,0,0,0,0,0,-5000
20200520,2545,皇翔,32.60,33.00,32.40,32.95,+0.35,1.07,185841,113,6072550,66000,61000,5000,0,0,0,1000,0,1000,6000
20200520,2546,根基,38.05,38.15,37.80,38.00,-0.05,-0.13,105001,45,3988888,15000,11000,4000,0,0,0,0,2000,-2000,2000
20200520,2547,日勝生,9.98,10.00,9.92,9.98,0.00,0.00,567235,214,5651220,76000,233000,-157000,0,0,0,2000,1000,1000,-156000
20200520,2548,華固,90.50,90.80,90.30,90.50,0.00,0.00,481023,369,43544478,196000,194643,1357,0,0,0,0,20000,-20000,-18643
20200520,2597,潤弘,61.90,61.90,60.50,60.90,-0.90,-1.46,69000,45,4244400,7000,21000,-14000,0,0,0,0,2000,-2000,-16000
20200520,2601,益航,9.50,9.52,9.38,9.40,-0.11,-1.16,2070907,706,19534601,122000,322000,-200000,0,0,0,2000,1000,1000,-199000
20200520,2603,長榮,10.80,10.85,10.70,10.75,+0.05,0.47,16830943,5359,181289968,3921000,5104000,-1183000,1877000,0,1877000,49000,1693000,-1644000,-950000
20200520,2605,新興,14.10,14.15,13.95,13.95,-0.05,-0.36,1076603,377,15121398,415000,40000,375000,0,0,0,131000,4000,127000,502000
20200520,2606,裕民,28.35,28.40,27.95,28.30,+0.05,0.18,1253122,548,35301348,371000,199000,172000,0,0,0,1000,5000,-4000,168000
20200520,2607,榮運,12.95,13.00,12.85,12.90,-0.05,-0.39,812663,216,10482382,249663,131000,118663,0,0,0,1000,6000,-5000,113663
20200520,2608,嘉里大榮,41.45,42.00,41.00,41.80,+0.35,0.84,455807,355,18929589,257000,69000,188000,0,0,0,25000,9000,16000,204000
20200520,2609,陽明,6.49,6.49,6.39,6.40,-0.05,-0.78,1439793,393,9262499,102000,302000,-200000,0,0,0,0,0,0,-200000
20200520,2610,華航,8.60,8.65,8.33,8.33,-0.01,-0.12,37512475,9733,318335773,3479000,3700438,-221438,6717000,0,6717000,126000,378000,-252000,6243562
20200520,2611,志信,6.07,6.07,5.94,6.02,-0.05,-0.82,163215,62,977834,6000,4000,2000,0,0,0,0,0,0,2000
20200520,2612,中航,23.50,23.70,23.45,23.45,0.00,0.00,114698,66,2699189,19000,23000,-4000,0,0,0,0,0,0,-4000
20200520,2613,中櫃,13.45,13.50,13.30,13.40,+0.05,0.37,112038,36,1507308,3000,4000,-1000,0,0,0,1000,0,1000,0
20200520,2614,東森,15.90,16.15,15.70,15.70,-0.05,-0.32,8649205,3132,137614205,583000,2093000,-1510000,0,0,0,0,3000,-3000,-1513000
20200520,2615,萬海,16.00,16.20,16.00,16.05,+0.05,0.31,1100241,409,17716027,214000,300000,-86000,0,0,0,2000,3000,-1000,-87000
20200520,2616,山隆,30.20,30.25,30.10,30.15,+0.05,0.17,379145,126,11436293,43000,26000,17000,0,0,0,0,0,0,17000
20200520,2617,台航,15.70,15.75,15.60,15.70,+0.05,0.32,274084,134,4295377,31000,38000,-7000,0,0,0,0,0,0,-7000
20200520,2618,長榮航,11.25,11.35,11.05,11.05,-0.05,-0.45,31420124,8471,352249696,4832000,4940902,-108902,0,0,0,753000,236000,517000,408098
20200520,2630,亞航,16.40,16.90,16.35,16.60,0.00,0.00,28000,22,463350,2000,3000,-1000,0,0,0,0,0,0,-1000
20200520,2633,台灣高鐵,34.75,35.35,34.70,35.10,+0.55,1.59,12566246,5389,440600608,2364283,1462000,902283,2972000,0,2972000,638000,906000,-268000,3606283
20200520,2634,漢翔,28.45,28.45,28.00,28.05,-0.35,-1.23,1873861,1027,52827404,90000,376000,-286000,0,0,0,1000,1000,0,-286000
20200520,2636,台驊投控,23.35,23.50,23.25,23.50,+0.25,1.08,436047,209,10191346,96000,35000,61000,0,0,0,0,0,0,61000
20200520,2637,慧洋-KY,23.50,23.80,23.45,23.70,+0.20,0.85,1432344,551,33782767,293000,312000,-19000,0,0,0,1000,123000,-122000,-141000
20200520,2642,宅配通,39.25,39.60,37.70,38.05,-0.95,-2.44,2859334,1937,109933219,304000,201000,103000,0,0,0,26000,0,26000,129000
20200520,2701,萬企,11.70,11.70,11.60,11.65,-0.05,-0.43,81970,49,954994,6000,63000,-57000,0,0,0,0,0,0,-57000
20200520,2702,華園,15.55,15.85,15.40,15.70,+0.15,0.96,230400,137,3591428,87000,3000,84000,0,0,0,0,0,0,84000
20200520,2704,國賓,26.40,26.55,26.10,26.40,0.00,0.00,128531,96,3387611,39000,7000,32000,0,0,0,0,0,0,32000
20200520,2705,六福,13.55,14.15,13.25,14.00,+0.35,2.56,765386,299,10523770,31000,38000,-7000,0,0,0,0,0,0,-7000
20200520,2706,第一店,13.05,13.10,12.85,12.95,-0.10,-0.77,198890,94,2574510,6000,11000,-5000,0,0,0,1000,0,1000,-4000
20200520,2707,晶華,140.00,140.00,138.00,138.50,-1.50,-1.07,269800,212,37577700,15000,19000,-4000,0,0,0,1000,0,1000,-3000
20200520,2712,遠雄來,36.55,36.55,36.20,36.55,+0.35,0.97,4000,4,145800,1000,0,1000,0,0,0,0,0,0,1000
20200520,2722,夏都,23.65,23.65,23.25,23.25,-0.60,-2.52,10050,10,235612,1000,2000,-1000,0,0,0,0,0,0,-1000
20200520,2723,美食-KY,102.50,106.00,99.10,102.00,+2.30,2.31,2170936,1737,221563436,165000,720513,-555513,385000,0,385000,11000,95000,-84000,-254513
20200520,2727,王品,68.50,68.80,67.50,67.70,-0.50,-0.73,213698,197,14513868,10000,19406,-9406,0,0,0,0,0,0,-9406
20200520,2731,雄獅,71.10,71.30,69.50,69.80,-0.60,-0.85,255235,189,17905691,28000,32000,-4000,0,0,0,0,0,0,-4000
20200520,2739,寒舍,23.10,23.10,22.90,23.05,-0.05,-0.22,13000,13,299150,1000,1000,0,0,0,0,0,0,0,0
20200520,2748,雲品,43.80,43.95,43.60,43.60,0.00,0.00,36000,30,1572650,2000,4000,-2000,0,0,0,0,0,0,-2000
20200520,2801,彰銀,18.95,19.00,18.85,18.85,0.00,0.00,4670647,1973,88316634,2244000,3169000,-925000,17000,0,17000,411000,52000,359000,-549000
20200520,2809,京城銀,33.00,33.15,32.90,32.90,-0.05,-0.15,1195997,757,39481144,305000,740000,-435000,0,0,0,4000,1000,3000,-432000
20200520,2812,台中銀,11.40,11.50,11.40,11.45,0.00,0.00,4501967,1129,51524899,1141000,518000,623000,0,0,0,152000,10000,142000,765000
20200520,2816,旺旺保,19.30,19.40,19.30,19.30,+0.05,0.26,83285,57,1611943,22000,14000,8000,0,0,0,0,0,0,8000
20200520,2820,華票,14.65,14.70,14.60,14.65,0.00,0.00,998313,214,14619715,259000,164000,95000,0,0,0,0,0,0,95000
20200520,2823,中壽,19.95,20.10,19.90,19.95,+0.05,0.25,9341006,2735,186542736,4143000,5469673,-1326673,8000,0,8000,287000,81000,206000,-1112673
20200520,2832,台產,19.95,20.05,19.85,19.90,-0.05,-0.25,237825,96,4746241,26000,54000,-28000,0,0,0,2000,12000,-10000,-38000
20200520,2834,臺企銀,10.75,10.75,10.70,10.75,0.00,0.00,9329652,3232,99970929,2087000,2134000,-47000,0,0,0,159000,549000,-390000,-437000
20200520,2836,高雄銀,9.51,9.55,9.47,9.51,0.00,0.00,534280,173,5080145,132000,190000,-58000,0,0,0,1000,20000,-19000,-77000
20200520,2838,聯邦銀,10.80,10.80,10.70,10.75,-0.05,-0.46,823317,453,8868687,36000,316000,-280000,0,0,0,152000,0,152000,-128000
20200520,2838A,聯邦銀甲特,54.10,54.30,54.10,54.20,+0.10,0.18,166018,121,8999673,0,0,0,0,0,0,0,0,0,0
20200520,2841,台開,6.51,6.55,6.47,6.52,-0.01,-0.15,1206648,403,7856426,224000,143000,81000,0,0,0,2000,1000,1000,82000
20200520,2845,遠東銀,10.80,10.80,10.70,10.70,-0.05,-0.47,2034204,633,21853924,73600,633000,-559400,0,0,0,19000,1000,18000,-541400
20200520,2849,安泰銀,14.25,14.50,14.15,14.25,-0.20,-1.38,169042,68,2407800,72000,127000,-55000,0,0,0,0,0,0,-55000
20200520,2850,新產,36.10,36.25,36.05,36.05,-0.05,-0.14,219302,131,7922281,148000,38000,110000,0,0,0,0,19000,-19000,91000
20200520,2851,中再保,19.05,19.05,18.85,18.95,-0.10,-0.52,174577,95,3308655,44000,91000,-47000,0,0,0,0,0,0,-47000
20200520,2852,第一保,14.00,14.00,13.60,14.00,0.00,0.00,89001,63,1229013,12000,57000,-45000,0,0,0,0,0,0,-45000
20200520,2855,統一證,13.30,13.35,13.15,13.15,-0.15,-1.13,1768103,524,23354957,211000,406000,-195000,0,0,0,0,0,0,-195000
20200520,2867,三商壽,9.63,9.63,9.51,9.52,-0.08,-0.83,2043585,574,19548177,677000,406000,271000,0,0,0,4000,64000,-60000,211000
20200520,2880,華南金,19.35,19.40,19.25,19.40,+0.10,0.52,8125436,3076,157056877,3850000,2911000,939000,25000,0,25000,615000,3000,612000,1576000
20200520,2881,富邦金,42.10,42.35,42.00,42.25,+0.25,0.6,16158614,5250,682548304,7560544,5334109,2226435,20000,0,20000,418000,303000,115000,2361435
20200520,2881A,富邦特,64.90,65.00,64.90,65.00,0.00,0.00,92093,593,5982424,0,0,0,0,0,0,0,0,0,0
20200520,2881B,富邦金乙特,63.70,63.90,63.60,63.90,+0.10,0.16,51076,29,3256018,0,0,0,0,0,0,10000,10000,0,0
20200520,2882,國泰金,39.60,39.80,39.50,39.65,+0.20,0.51,13574646,5082,538378777,6429708,2254551,4175157,23000,0,23000,444000,86000,358000,4556157
20200520,2882A,國泰特,63.70,63.80,63.60,63.70,0.00,0.00,87150,78,5554339,0,2000,-2000,0,0,0,0,30000,-30000,-32000
20200520,2882B,國泰金乙特,63.50,63.60,63.50,63.60,+0.10,0.16,21124,15,1342823,0,0,0,0,0,0,2000,14000,-12000,-12000
20200520,2883,開發金,9.01,9.07,8.99,9.02,+0.02,0.22,16864912,4446,152131867,7895000,4604000,3291000,37000,0,37000,390000,359000,31000,3359000
20200520,2884,玉山金,27.10,27.15,26.90,27.00,+0.10,0.37,23220111,6807,627365197,8852359,13511802,-4659443,30000,0,30000,650000,61000,589000,-4040443
20200520,2885,元大金,16.30,16.35,16.20,16.20,-0.05,-0.31,24245206,6934,394046303,5422699,20897048,-15474349,31000,0,31000,174000,6000,168000,-15275349
20200520,2886,兆豐金,30.65,30.80,30.55,30.80,+0.25,0.82,19620699,7184,601498555,7447495,6386000,1061495,29000,0,29000,921000,92000,829000,1919495
20200520,2887,台新金,12.65,12.65,12.55,12.65,0.00,0.00,15926239,3655,200831780,5163000,9738006,-4575006,28000,0,28000,221000,296000,-75000,-4622006
20200520,2887E,台新戊特,54.40,54.50,54.40,54.50,+0.10,0.18,94505,38,5142870,0,0,0,0,0,0,20000,0,20000,20000
20200520,2887F,台新戊特二,52.40,52.50,52.40,52.50,+0.10,0.19,27698,13,1451472,0,0,0,0,0,0,0,24000,-24000,-24000
20200520,2888,新光金,8.17,8.24,8.17,8.17,0.00,0.00,29963041,6905,245634116,10540452,9120771,1419681,32000,0,32000,609000,1733233,-1124233,327448
20200520,2888A,新光金甲特,44.15,44.20,44.15,44.20,-0.05,-0.11,32252,30,1425033,0,0,0,0,0,0,0,0,0,0
20200520,2889,國票金,11.40,11.50,11.40,11.45,+0.05,0.44,4697179,1162,53787240,726000,565400,160600,0,0,0,2000,0,2000,162600
20200520,2890,永豐金,11.75,11.80,11.65,11.65,-0.05,-0.43,11721091,3242,137199515,6834792,6698620,136172,28000,132000,-104000,237000,418000,-181000,-148828
20200520,2891,中信金,19.85,19.90,19.70,19.85,0.00,0.00,32978059,7036,653521933,18720609,26296369,-7575760,49000,0,49000,465000,121000,344000,-7182760
20200520,2891B,中信金乙特,65.80,65.90,65.60,65.90,0.00,0.00,24070,25,1583571,0,0,0,0,0,0,2000,0,2000,2000
20200520,2891C,中信金丙特,62.60,63.00,62.60,63.00,+0.10,0.16,8131,13,509611,0,0,0,0,0,0,1000,0,1000,1000
20200520,2892,第一金,22.15,22.15,22.00,22.10,0.00,0.00,11827171,4035,260996680,4658298,6048505,-1390207,27000,0,27000,388000,5000,383000,-980207
20200520,2897,王道銀行,7.16,7.19,7.10,7.11,-0.04,-0.56,879260,232,6280499,308000,294000,14000,0,0,0,13000,0,13000,27000
20200520,2897A,王道銀甲特,10.15,10.20,10.15,10.20,+0.05,0.49,13000,8,132300,0,0,0,0,0,0,0,0,0,0
20200520,2901,欣欣,22.25,22.35,22.20,22.35,+0.05,0.22,87490,34,1953194,1000,2000,-1000,0,0,0,0,0,0,-1000
20200520,2903,遠百,24.35,24.50,24.20,24.20,-0.10,-0.41,1739467,704,42407726,263517,560724,-297207,225000,0,225000,0,116000,-116000,-188207
20200520,2904,匯僑,23.95,24.00,23.85,23.90,-0.05,-0.21,60076,45,1437085,0,4000,-4000,0,0,0,0,0,0,-4000
20200520,2905,三商,21.70,21.80,21.55,21.75,+0.10,0.46,1227789,289,26692105,287000,218000,69000,0,0,0,1000,2000,-1000,68000
20200520,2906,高林,11.70,11.75,11.05,11.75,+1.05,9.81,13056756,2479,152464078,126000,87000,39000,0,0,0,0,1000,-1000,38000
20200520,2908,特力,18.70,18.75,18.50,18.50,-0.15,-0.8,614596,326,11406464,51000,47000,4000,0,0,0,1000,1000,0,4000
20200520,2910,統領,31.30,31.30,31.30,31.30,+0.10,0.32,1403,3,43913,0,0,0,0,0,0,0,0,0,0
20200520,2911,麗嬰房,5.93,6.00,5.87,5.96,+0.06,1.02,69805,50,414400,13000,0,13000,0,0,0,0,0,0,13000
20200520,2912,統一超,302.00,302.50,298.00,298.00,-2.50,-0.83,835277,659,250009950,440600,738978,-298378,2000,0,2000,53000,1000,52000,-244378
20200520,2913,農林,14.20,14.25,14.05,14.15,-0.05,-0.35,340504,235,4817612,81000,136000,-55000,0,0,0,41000,4000,37000,-18000
20200520,2915,潤泰全,67.80,68.00,67.40,67.40,-0.40,-0.59,1715084,1149,115994564,806200,1109000,-302800,0,0,0,34000,25000,9000,-293800
20200520,2923,鼎固-KY,24.70,24.75,23.10,24.30,-0.45,-1.82,203000,69,4853000,56000,139000,-83000,0,0,0,0,0,0,-83000
20200520,2929,淘帝-KY,56.70,57.30,56.20,56.50,0.00,0.00,354450,288,20080002,41000,58000,-17000,0,0,0,0,29000,-29000,-46000
20200520,2936,客思達-KY,14.90,14.90,14.70,14.90,+0.10,0.68,31000,6,456300,3000,0,3000,0,0,0,0,0,0,3000
20200520,2939,凱羿-KY,141.50,144.00,141.50,142.00,+1.00,0.71,84030,67,11999760,29000,9000,20000,0,0,0,0,1000,-1000,19000
20200520,3002,歐格,10.55,10.60,10.40,10.55,0.00,0.00,73000,34,766200,2000,2000,0,0,0,0,1000,1000,0,0
20200520,3003,健和興,38.45,39.50,37.95,39.00,+0.80,2.09,950966,586,36913930,197000,47000,150000,0,93000,-93000,36000,0,36000,93000
20200520,3004,豐達科,55.30,55.50,54.70,55.10,+0.40,0.73,263100,182,14498080,77000,30000,47000,0,0,0,0,0,0,47000
20200520,3005,神基,44.45,44.65,44.15,44.35,-0.45,-1.0,1050218,738,46608804,210000,724213,-514213,0,0,0,8000,33000,-25000,-539213
20200520,3006,晶豪科,42.60,42.85,41.50,41.65,-1.10,-2.57,6804748,3931,285483901,334000,1325000,-991000,0,0,0,174000,235000,-61000,-1052000
20200520,3008,大立光,3850.00,3935.00,3850.00,3870.00,+25.00,0.65,662613,709,2581028177,391923,373724,18199,0,14000,-14000,10000,6000,4000,8199
20200520,3010,華立,55.90,56.20,55.20,55.50,-0.40,-0.72,236104,153,13116072,23000,69000,-46000,0,0,0,3000,0,3000,-43000
20200520,3011,今皓,5.11,5.62,5.11,5.62,+0.51,9.98,835552,237,4633061,14000,31000,-17000,0,0,0,0,0,0,-17000
20200520,3013,晟銘電,12.50,12.55,12.40,12.50,+0.10,0.81,115000,52,1437600,12000,36000,-24000,0,0,0,3000,2000,1000,-23000
20200520,3014,聯陽,57.60,58.00,56.50,57.10,+1.10,1.96,5608381,3556,321263986,526000,1067000,-541000,0,0,0,38000,19000,19000,-522000
20200520,3015,全漢,21.90,22.05,21.85,22.00,+0.15,0.69,200614,145,4403613,40000,50000,-10000,0,0,0,14000,1000,13000,3000
20200520,3016,嘉晶,58.50,63.00,58.20,61.40,+3.90,6.78,23299695,14560,1411797488,1705000,808000,897000,543000,0,543000,1322000,105000,1217000,2657000
20200520,3017,奇鋐,37.40,37.90,36.90,37.80,+0.60,1.61,5400765,3083,202195814,1564000,1018000,546000,0,0,0,146000,9000,137000,683000
20200520,3018,同開,18.90,18.90,18.45,18.75,-0.05,-0.27,221043,125,4111558,32000,9000,23000,0,0,0,0,0,0,23000
20200520,3019,亞光,68.50,69.30,68.10,68.20,+0.20,0.29,1402050,993,96148550,429000,186000,243000,0,0,0,49000,86000,-37000,206000
20200520,3021,鴻名,12.95,13.15,12.90,13.00,-0.20,-1.52,25122,15,325873,1000,0,1000,0,0,0,3000,0,3000,4000
20200520,3022,威強電,40.45,40.70,40.00,40.50,+0.20,0.5,147328,119,5954167,19000,21000,-2000,0,0,0,0,0,0,-2000
20200520,3023,信邦,149.00,152.00,146.50,147.00,+0.50,0.34,2148064,1648,319876408,581000,782165,-201165,243000,11000,232000,12000,28000,-16000,14835
20200520,3024,憶聲,7.18,7.26,7.12,7.17,-0.01,-0.14,257186,95,1842793,43000,6000,37000,0,0,0,0,0,0,37000
20200520,3025,星通,19.40,19.45,19.05,19.05,-0.05,-0.26,55131,36,1059375,7000,5000,2000,0,0,0,1000,0,1000,3000
20200520,3026,禾伸堂,126.50,128.50,124.50,124.50,-0.50,-0.4,3767655,2609,475935375,316000,756878,-440878,0,0,0,105000,52000,53000,-387878
20200520,3027,盛達,8.13,8.15,8.00,8.13,+0.05,0.62,377721,129,3052906,33000,2000,31000,0,0,0,3000,0,3000,34000
20200520,3028,增你強,19.00,19.05,18.95,19.00,+0.05,0.26,129000,87,2453500,36000,29000,7000,0,0,0,9000,0,9000,16000
20200520,3029,零壹,32.70,32.80,32.40,32.70,-0.10,-0.3,1210411,729,39433522,65000,114000,-49000,0,0,0,1000,83000,-82000,-131000
20200520,3030,德律,53.40,54.30,53.10,54.00,+0.70,1.31,445301,302,23946941,99907,112000,-12093,0,0,0,3000,12000,-9000,-21093
20200520,3031,佰鴻,14.90,15.20,14.90,15.10,+0.25,1.68,1013368,383,15315420,168000,81000,87000,0,0,0,20000,1000,19000,106000
20200520,3032,偉訓,29.00,29.10,28.85,28.90,-0.05,-0.17,208000,90,6013700,18000,26000,-8000,0,0,0,3000,0,3000,-5000
20200520,3033,威健,14.75,14.75,14.65,14.70,0.00,0.00,191434,139,2810970,20000,42000,-22000,0,0,0,4000,1000,3000,-19000
20200520,3034,聯詠,197.00,200.50,195.00,198.00,+1.00,0.51,4504553,3016,891110759,1355700,1407178,-51478,83000,409000,-326000,205000,146000,59000,-318478
20200520,3035,智原,42.45,42.90,41.85,42.30,+0.35,0.83,1977630,1323,83865235,953000,116000,837000,0,1000,-1000,176000,49000,127000,963000
20200520,3036,文曄,39.00,39.00,38.70,38.70,-0.10,-0.26,1218130,867,47285988,100000,159159,-59159,0,0,0,262000,502000,-240000,-299159
20200520,3037,欣興,39.50,40.45,38.90,39.60,+0.50,1.28,51407637,22700,2036609672,11230000,12736781,-1506781,560000,2595000,-2035000,2722000,978000,1744000,-1797781
20200520,3038,全台,19.10,19.50,19.00,19.15,+0.10,0.52,5292009,1810,101906771,996000,315000,681000,0,166000,-166000,203000,51000,152000,667000
20200520,3040,遠見,36.40,39.25,36.40,39.25,+3.55,9.94,2870318,1619,110285124,0,0,0,0,0,0,0,0,0,0
20200520,3041,揚智,17.10,17.90,17.05,17.05,+0.05,0.29,4478000,2192,77888174,347000,1462000,-1115000,0,0,0,3000,0,3000,-1112000
20200520,3042,晶技,55.50,56.20,54.40,54.50,-0.80,-1.45,7265258,4381,400489254,1350000,1489000,-139000,0,845000,-845000,122000,275000,-153000,-1137000
20200520,3043,科風,1.46,1.50,1.46,1.49,+0.04,2.76,202300,41,301715,0,0,0,0,0,0,0,0,0,0
20200520,3044,健鼎,110.50,110.50,108.50,109.00,-1.50,-1.36,2904289,1620,316918579,468544,2233625,-1765081,45000,0,45000,44000,59000,-15000,-1735081
20200520,3045,台灣大,108.00,108.50,107.50,107.50,-0.50,-0.46,2671887,1394,288078796,882201,1167180,-284979,4000,77000,-73000,321000,73000,248000,-109979
20200520,3046,建碁,11.50,11.75,11.40,11.70,-0.05,-0.43,42704,27,498245,3000,2000,1000,0,0,0,0,0,0,1000
20200520,3047,訊舟,8.07,8.13,8.00,8.01,-0.06,-0.74,388840,121,3125147,16000,36000,-20000,0,0,0,2000,0,2000,-18000
20200520,3048,益登,17.75,17.75,17.50,17.65,-0.05,-0.28,689643,339,12152796,60000,75000,-15000,0,0,0,11000,4000,7000,-8000
20200520,3049,和鑫,10.05,10.15,10.00,10.05,+0.05,0.5,3075298,984,30966938,699000,921000,-222000,0,0,0,58000,202000,-144000,-366000
20200520,3050,鈺德,9.65,9.70,9.56,9.57,-0.09,-0.93,250051,104,2401755,6000,17000,-11000,0,0,0,1000,0,1000,-10000
20200520,3051,力特,3.18,3.29,3.12,3.22,-0.09,-2.72,192275,48,616978,0,0,0,0,0,0,0,0,0,0
20200520,3052,夆典,10.55,11.10,10.55,10.95,+0.40,3.79,1456815,467,15781480,164000,39000,125000,0,0,0,0,2000,-2000,123000
20200520,3054,立萬利,23.90,24.00,23.80,24.00,+0.10,0.42,39000,31,934700,4000,2000,2000,0,0,0,3000,0,3000,5000
20200520,3055,蔚華科,28.15,28.20,27.35,27.35,-0.20,-0.73,91238,44,2524169,10000,3000,7000,0,0,0,2000,0,2000,9000
20200520,3056,總太,32.10,32.10,31.90,32.10,0.00,0.00,1045973,487,33474479,206000,79000,127000,0,0,0,0,1000,-1000,126000
20200520,3057,喬鼎,4.57,4.58,4.50,4.52,-0.06,-1.31,119000,53,537440,3000,3000,0,0,0,0,0,0,0,0
20200520,3058,立德,6.85,6.94,6.80,6.81,+0.01,0.15,230068,86,1572618,33000,4000,29000,0,0,0,11000,0,11000,40000
20200520,3059,華晶科,23.15,24.15,22.90,23.00,+0.65,2.91,6829468,3598,160264164,345000,832000,-487000,200000,0,200000,13000,1000,12000,-275000
20200520,3060,銘異,13.00,13.15,12.75,12.80,-0.20,-1.54,1202656,404,15588493,301000,179000,122000,0,0,0,3000,0,3000,125000
20200520,3062,建漢,14.60,14.75,14.50,14.60,0.00,0.00,962253,441,14081888,316000,245000,71000,0,0,0,6000,0,6000,77000
20200520,3090,日電貿,52.60,53.40,52.30,52.30,0.00,0.00,1366347,900,72053912,350148,111000,239148,0,0,0,39000,8000,31000,270148
20200520,3094,聯傑,18.50,19.45,18.15,18.15,-0.05,-0.27,1448109,805,27079315,85000,188000,-103000,0,0,0,1000,0,1000,-102000
20200520,3130,一零四,157.00,157.00,156.00,156.00,-1.00,-0.64,5450,12,853374,0,0,0,0,0,0,0,0,0,0
20200520,3149,正達,7.40,7.46,7.25,7.25,-0.10,-1.36,308282,115,2252951,15000,11000,4000,0,0,0,0,0,0,4000
20200520,3164,景岳,24.05,24.40,23.55,23.80,-0.20,-0.83,185400,103,4460629,12000,34000,-22000,0,0,0,0,0,0,-22000
20200520,3167,大量,41.35,41.60,40.40,40.40,-0.95,-2.3,74162,35,3049662,1000,2000,-1000,0,0,0,0,0,0,-1000
20200520,3189,景碩,48.60,48.60,46.40,46.95,-1.05,-2.19,4964596,2846,234690757,1171000,1394000,-223000,0,409000,-409000,119000,112000,7000,-625000
20200520,3209,全科,20.30,20.45,20.30,20.35,-0.15,-0.73,530236,293,10801410,42000,39000,3000,0,0,0,2000,5000,-3000,0
20200520,3229,晟鈦,9.38,9.38,9.09,9.25,+0.02,0.22,30000,23,275030,0,2000,-2000,0,0,0,0,0,0,-2000
20200520,3231,緯創,28.50,28.60,28.15,28.15,-0.15,-0.53,14558263,4803,412428264,7761000,4888699,2872301,8000,0,8000,205000,303000,-98000,2782301
20200520,3257,虹冠電,62.20,63.00,61.50,62.00,+0.10,0.16,374033,217,23214837,69000,14000,55000,0,0,0,4000,0,4000,59000
20200520,3266,昇陽,13.80,13.95,13.50,13.55,0.00,0.00,165147,91,2257441,13000,17000,-4000,0,0,0,0,0,0,-4000
20200520,3296,勝德,13.05,13.05,13.00,13.05,0.00,0.00,4200,5,54790,0,1000,-1000,0,0,0,0,0,0,-1000
20200520,3305,昇貿,19.60,20.35,19.45,20.10,+0.70,3.61,586096,353,11734049,32000,6000,26000,0,0,0,8000,0,8000,34000
20200520,3308,聯德,5.38,5.50,5.35,5.50,+0.10,1.85,18041,13,97153,1000,2000,-1000,0,0,0,0,0,0,-1000
20200520,3311,閎暉,29.50,30.50,28.95,29.45,+0.85,2.97,929785,528,27592688,35000,94000,-59000,0,0,0,1000,0,1000,-58000
20200520,3312,弘憶股,15.00,15.10,14.90,14.90,-0.05,-0.33,327875,158,4902333,31000,83000,-52000,0,0,0,2000,0,2000,-50000
20200520,3321,同泰,10.00,10.90,10.00,10.90,+0.95,9.55,652127,212,7024683,8000,3000,5000,0,0,0,0,0,0,5000
20200520,3338,泰碩,91.80,92.20,90.30,90.50,-1.30,-1.42,2528430,1769,229698130,162000,367000,-205000,0,156000,-156000,14000,128000,-114000,-475000
20200520,3346,麗清,25.70,26.05,25.50,25.55,-0.15,-0.58,187669,125,4822359,29000,55669,-26669,0,0,0,0,0,0,-26669
20200520,3356,奇偶,22.25,22.80,21.80,22.55,+0.65,2.97,638083,337,14349661,174000,27000,147000,0,0,0,1000,1000,0,147000
20200520,3376,新日興,125.00,131.50,123.00,131.50,+6.50,5.2,2678851,1682,341187481,376000,610459,-234459,291000,30000,261000,166000,110000,56000,82541
20200520,3380,明泰,26.20,26.25,26.05,26.20,+0.05,0.19,3175678,2215,83044986,776000,410749,365251,0,0,0,572000,77000,495000,860251
20200520,3383,新世紀,4.38,4.38,4.20,4.36,-0.01,-0.23,25499,21,108748,2000,0,2000,0,0,0,0,0,0,2000
20200520,3406,玉晶光,478.00,491.50,473.00,490.00,+14.50,3.05,6568348,5341,3183955020,1431078,735000,696078,140000,71000,69000,384000,107000,277000,1042078
20200520,3413,京鼎,167.00,169.00,166.00,169.00,+2.00,1.2,1171686,882,196587434,395000,131000,264000,0,0,0,4000,4000,0,264000
20200520,3416,融程電,55.60,56.10,55.30,55.50,-0.10,-0.18,156579,72,8719860,2000,4000,-2000,0,0,0,1000,0,1000,-1000
20200520,3419,譁裕,13.90,14.10,13.90,14.05,+0.20,1.44,325865,175,4562452,115000,25000,90000,0,0,0,2000,0,2000,92000
20200520,3432,台端,11.25,11.25,11.15,11.15,-0.10,-0.89,70000,21,786400,0,1000,-1000,0,0,0,1000,0,1000,0
20200520,3437,榮創,18.75,20.15,18.75,19.15,+0.50,2.68,11049015,5049,215412830,892000,2213000,-1321000,0,0,0,4000,0,4000,-1317000
20200520,3443,創意,224.50,226.00,221.00,224.50,+1.00,0.45,1001312,796,223953200,246000,150000,96000,52000,0,52000,74000,40000,34000,182000
20200520,3450,聯鈞,63.70,64.30,62.80,62.80,-1.20,-1.88,2295518,1633,145294633,162000,593285,-431285,0,54000,-54000,13000,7000,6000,-479285
20200520,3454,晶睿,69.80,71.20,69.80,70.70,+1.60,2.32,273660,229,19322428,128000,17000,111000,0,0,0,1000,0,1000,112000
20200520,3481,群創,6.33,6.40,6.22,6.22,-0.06,-0.96,46079425,7199,289958262,10880000,13052867,-2172867,0,0,0,966000,1418000,-452000,-2624867
20200520,3494,誠研,3.40,3.41,3.32,3.38,-0.01,-0.29,142106,40,479418,11000,3000,8000,0,0,0,0,0,0,8000
20200520,3501,維熹,45.10,45.25,45.05,45.10,0.00,0.00,124000,61,5597650,29000,12000,17000,0,0,0,2000,0,2000,19000
20200520,3504,揚明光,59.30,60.20,59.20,59.90,+0.90,1.53,357000,263,21344800,132000,18000,114000,0,0,0,2000,2000,0,114000
20200520,3515,華擎,122.50,129.50,122.00,129.50,+7.50,6.15,6754831,4676,858808199,1471000,487000,984000,411000,7000,404000,562000,82000,480000,1868000
20200520,3518,柏騰,34.80,35.95,34.80,35.35,+0.35,1.0,602224,398,21365517,214000,153000,61000,0,0,0,1000,0,1000,62000
20200520,3528,安馳,38.65,38.65,38.00,38.45,-0.15,-0.39,30349,33,1159600,0,3000,-3000,0,0,0,2000,1000,1000,-2000
20200520,3530,晶相光,80.40,81.40,79.70,81.40,+0.90,1.12,705192,504,56835736,182000,108000,74000,0,0,0,3000,26000,-23000,51000
20200520,3532,台勝科,151.00,155.00,149.50,153.50,+3.00,1.99,1020075,837,155656435,303692,185000,118692,0,0,0,58000,9000,49000,167692
20200520,3533,嘉澤,409.00,409.00,400.50,403.50,+0.50,0.12,879075,811,354855225,427000,73000,354000,0,121000,-121000,26000,22000,4000,237000
20200520,3535,晶彩科,15.90,15.90,15.40,15.45,-0.25,-1.59,583200,301,9082470,172000,51000,121000,0,0,0,2000,0,2000,123000
20200520,3536,誠創,3.12,3.12,3.12,3.12,-0.25,-7.42,5000,3,15600,0,0,0,0,0,0,0,0,0,0
20200520,3543,州巧,17.05,17.05,16.35,16.55,-0.45,-2.65,612009,329,10172667,13000,4000,9000,0,0,0,0,0,0,9000
20200520,3545,敦泰,32.00,32.40,31.40,32.00,+0.15,0.47,8112202,3835,258041014,1280000,2236366,-956366,0,0,0,11000,0,11000,-945366
20200520,3550,聯穎,11.95,11.95,11.80,11.95,0.00,0.00,40000,27,475800,0,2000,-2000,0,0,0,1000,1000,0,-2000
20200520,3557,嘉威,71.70,74.60,70.50,72.30,+0.30,0.42,2550440,1810,185665280,847000,266000,581000,0,0,0,1000,0,1000,582000
20200520,3563,牧德,330.00,353.00,330.00,347.00,+18.00,5.47,2888224,2786,994272280,586912,203000,383912,162000,3000,159000,148000,33000,115000,657912
20200520,3576,聯合再生,6.04,6.06,5.95,6.03,+0.03,0.5,6214744,1212,37304116,716000,435000,281000,0,0,0,0,0,0,281000
20200520,3583,辛耘,46.50,47.40,46.50,46.80,+0.35,0.75,112000,94,5253550,53000,8000,45000,0,0,0,6000,0,6000,51000
20200520,3588,通嘉,30.70,31.40,30.25,30.55,+0.60,2.0,495388,342,15220921,73000,68000,5000,0,0,0,1000,0,1000,6000
20200520,3591,艾笛森,11.95,12.05,11.95,12.00,+0.05,0.42,178100,71,2133740,3000,4000,-1000,0,0,0,2000,0,2000,1000
20200520,3593,力銘,9.20,9.50,9.10,9.37,+0.27,2.97,163248,86,1504450,6000,2000,4000,0,0,0,0,0,0,4000
20200520,3596,智易,84.90,85.40,84.00,84.50,-0.30,-0.35,1262279,1052,106785645,213000,282025,-69025,0,0,0,26000,8000,18000,-51025
20200520,3605,宏致,23.85,24.00,23.65,23.75,+0.05,0.21,348493,212,8305482,85000,57000,28000,0,0,0,13000,0,13000,41000
20200520,3607,谷崧,12.40,12.95,12.40,12.55,+0.20,1.62,598040,282,7580859,126000,10000,116000,0,0,0,2000,0,2000,118000
20200520,3617,碩天,81.00,81.40,80.80,81.00,+0.30,0.37,126000,101,10221000,35000,2000,33000,0,0,0,7000,2000,5000,38000
20200520,3622,洋華,18.65,18.85,18.50,18.75,+0.10,0.54,99445,64,1859188,36000,13000,23000,0,0,0,1000,0,1000,24000
20200520,3645,達邁,40.00,40.70,40.00,40.50,+0.80,2.02,535225,370,21610109,191500,27000,164500,0,0,0,2000,0,2000,166500
20200520,3653,健策,203.50,207.00,198.50,207.00,+5.50,2.73,2366712,1912,481593384,690000,350359,339641,4000,355000,-351000,193000,82000,111000,99641
20200520,3661,世芯-KY,311.00,313.00,296.00,296.50,-12.50,-4.05,6791728,5411,2064247944,1009000,1222000,-213000,21000,16000,5000,153000,195000,-42000,-250000
20200520,3665,貿聯-KY,188.50,190.00,185.50,189.00,+2.50,1.34,1147520,922,215716820,94000,275000,-181000,0,0,0,38000,50000,-12000,-193000
20200520,3669,圓展,30.00,30.80,29.80,30.40,+0.70,2.36,1300150,800,39541110,212000,62000,150000,0,0,0,1000,0,1000,151000
20200520,3673,TPK-KY,41.40,41.80,41.00,41.20,-0.25,-0.6,1688630,955,69942599,438000,316000,122000,0,0,0,69000,121000,-52000,70000
20200520,3679,新至陞,63.30,63.40,61.50,61.80,-1.10,-1.75,67550,66,4187635,5000,21000,-16000,0,0,0,0,0,0,-16000
20200520,3682,亞太電,6.54,6.80,6.50,6.73,+0.19,2.91,5459846,1416,36456804,676000,633000,43000,0,0,0,0,0,0,43000
20200520,3686,達能,3.83,3.84,3.72,3.82,-0.01,-0.26,394149,120,1488908,2000,3000,-1000,0,0,0,0,0,0,-1000
20200520,3694,海華,17.45,17.75,17.30,17.55,+0.05,0.29,143621,103,2508237,7000,4000,3000,0,0,0,2000,0,2000,5000
20200520,3698,隆達,18.50,20.15,18.25,20.10,+1.75,9.54,36313198,12534,708294810,4203000,2505000,1698000,0,0,0,1177000,42000,1135000,2833000
20200520,3701,大眾控,13.65,13.65,13.55,13.55,+0.05,0.37,5998,17,81517,4000,0,4000,0,0,0,0,0,0,4000
20200520,3702,大聯大,39.30,39.30,38.95,38.95,-0.15,-0.38,1467689,966,57300240,647096,683320,-36224,0,2000,-2000,160000,45000,115000,76776
20200520,3702A,大聯大甲特,49.10,49.20,49.10,49.20,+0.10,0.2,142000,36,6980300,9000,0,9000,0,0,0,0,81000,-81000,-72000
20200520,3703,欣陸,11.70,11.80,11.60,11.70,+0.10,0.86,937371,175,10929920,174000,36000,138000,0,0,0,137000,1000,136000,274000
20200520,3704,合勤控,14.90,16.15,14.90,16.15,+1.45,9.86,7408521,3100,116862155,823000,463000,360000,0,0,0,207000,1000,206000,566000
20200520,3705,永信,48.65,48.90,47.80,47.90,-0.50,-1.03,1259628,747,60912872,119000,118000,1000,0,0,0,0,1000,-1000,0
20200520,3706,神達,30.30,30.90,30.15,30.70,+0.60,1.99,8468556,4513,259005861,1573000,393000,1180000,344000,636000,-292000,417000,105000,312000,1200000
20200520,3708,上緯投控,85.50,86.30,82.80,82.80,-1.70,-2.01,2216480,1653,186831091,250000,226000,24000,0,0,0,12000,10000,2000,26000
20200520,3711,日月光投控,61.80,62.70,61.00,61.70,-0.50,-0.8,11055536,5646,680474532,5764895,5750000,14895,10000,0,10000,658000,367000,291000,315895
20200520,3712,永崴投控,13.50,13.60,13.25,13.35,-0.10,-0.74,276147,176,3695146,72000,10000,62000,0,0,0,6000,1000,5000,67000
20200520,4104,佳醫,55.30,55.60,55.10,55.40,+0.30,0.54,252231,204,13967116,37000,26000,11000,0,0,0,0,3000,-3000,8000
20200520,4106,雃博,35.00,36.05,34.00,34.30,-0.80,-2.28,8110192,4602,284408827,677000,913000,-236000,0,0,0,0,6000,-6000,-242000
20200520,4108,懷特,19.25,19.70,19.25,19.40,-0.05,-0.26,352251,212,6856470,108000,17000,91000,0,0,0,0,0,0,91000
20200520,4119,旭富,139.00,141.00,137.50,139.00,+0.50,0.36,1732509,1247,241125251,465000,284000,181000,0,0,0,18000,19000,-1000,180000
20200520,4133,亞諾法,60.50,63.40,57.30,60.50,+0.10,0.17,23493133,14717,1435969134,1147000,963000,184000,0,0,0,0,0,0,184000
20200520,4137,麗豐-KY,191.50,193.00,188.00,188.00,-2.00,-1.05,239088,207,45353675,26000,98901,-72901,0,0,0,9000,27000,-18000,-90901
20200520,4141,龍燈-KY,14.10,14.40,14.10,14.10,0.00,0.00,90560,59,1289296,12000,7000,5000,0,0,0,0,0,0,5000
20200520,4142,國光生,52.30,57.50,51.00,55.00,+2.60,4.96,137906540,67001,7551857872,7534000,6949000,585000,0,0,0,49000,11000,38000,623000
20200520,4144,康聯-KY,21.85,21.85,21.50,21.50,-0.35,-1.6,109498,77,2373653,5000,6000,-1000,0,0,0,0,0,0,-1000
20200520,4148,全宇生技-KY,36.00,36.00,34.20,34.90,-1.10,-3.06,183050,150,6399860,9000,29000,-20000,0,0,0,0,0,0,-20000
20200520,4155,訊映,30.75,30.85,30.00,30.10,-0.30,-0.99,582500,364,17700175,101000,37000,64000,0,0,0,0,0,0,64000
20200520,4164,承業醫,38.70,39.20,38.50,39.10,+0.25,0.64,306874,202,11932687,103000,9000,94000,0,0,0,11000,0,11000,105000
20200520,4190,佐登-KY,84.20,84.70,82.20,82.70,-1.90,-2.25,195001,181,16178293,13000,95000,-82000,0,0,0,2000,10000,-8000,-90000
20200520,4306,炎洲,10.75,10.75,10.55,10.65,-0.15,-1.39,462748,175,4938306,17000,83000,-66000,0,0,0,6000,1000,5000,-61000
20200520,4414,如興,8.57,8.57,8.45,8.47,0.00,0.00,497240,202,4229172,97000,57000,40000,0,0,0,1000,7000,-6000,34000
20200520,4426,利勤,30.20,31.90,30.20,31.80,+1.70,5.65,760265,498,23768371,286000,31000,255000,0,0,0,55000,0,55000,310000
20200520,4438,廣越,119.00,120.50,117.50,118.50,-2.00,-1.66,64000,55,7610500,15000,26000,-11000,0,0,0,0,0,0,-11000
20200520,4439,冠星-KY,137.50,139.00,135.50,137.50,-1.50,-1.08,63000,54,8627000,0,0,0,0,0,0,0,0,0,0
20200520,4526,東台,12.65,12.70,12.60,12.60,-0.05,-0.4,253698,96,3205579,29000,46000,-17000,0,0,0,0,0,0,-17000
20200520,4532,瑞智,17.15,17.15,17.00,17.05,-0.10,-0.58,421278,245,7195100,102000,58357,43643,0,0,0,1000,1000,0,43643
20200520,4536,拓凱,119.50,129.50,119.00,128.50,+10.50,8.9,4388876,3377,548129504,261000,499000,-238000,239000,0,239000,82000,57000,25000,26000
20200520,4540,全球傳動,51.90,52.10,51.10,51.90,+0.20,0.39,168241,133,8684279,28000,11000,17000,0,0,0,0,0,0,17000
20200520,4545,銘鈺,26.25,27.65,26.20,27.40,+1.10,4.18,120163,83,3229699,21000,5000,16000,0,0,0,1000,0,1000,17000
20200520,4551,智伸科,139.00,140.50,136.00,137.00,+2.50,1.86,1615233,1247,223549921,309000,205000,104000,35000,0,35000,20000,46000,-26000,113000
20200520,4552,力達-KY,29.60,30.00,29.35,29.50,-0.15,-0.51,156597,121,4637021,19000,6000,13000,0,0,0,0,53000,-53000,-40000
20200520,4555,氣立,52.50,52.50,50.10,50.70,-1.10,-2.12,120050,99,6117560,6000,9000,-3000,0,0,0,0,0,0,-3000
20200520,4557,永新-KY,67.40,67.50,67.10,67.50,+0.10,0.15,26244,22,1765772,3000,1000,2000,0,0,0,0,0,0,2000
20200520,4560,強信-KY,48.50,48.50,47.85,48.20,-0.20,-0.41,261000,146,12555900,135000,153000,-18000,0,0,0,0,0,0,-18000
20200520,4562,穎漢,16.90,16.90,16.70,16.90,+0.15,0.9,10000,9,167900,0,2000,-2000,0,0,0,0,0,0,-2000
20200520,4564,元翎,31.05,31.90,31.00,31.85,+0.90,2.91,708500,418,22395799,309000,17000,292000,0,0,0,0,0,0,292000
20200520,4566,時碩工業,42.65,42.80,41.00,42.30,+0.40,0.95,1196756,889,50122275,104000,188000,-84000,0,0,0,0,1000,-1000,-85000
20200520,4571,鈞興-KY,59.50,60.70,59.20,60.40,+0.40,0.67,15000,12,893700,1000,8000,-7000,0,0,0,0,0,0,-7000
20200520,4572,駐龍,83.00,83.30,82.40,82.70,-0.10,-0.12,77000,56,6375500,12000,2000,10000,0,0,0,0,0,0,10000
20200520,4576,大銀微系統,72.10,73.90,71.00,71.20,-0.80,-1.11,88000,79,6316000,4000,32000,-28000,0,0,0,0,0,0,-28000
20200520,4581,光隆精密-KY,38.80,39.50,38.80,39.40,+0.60,1.55,55000,42,2150500,6000,1000,5000,0,0,0,0,0,0,5000
20200520,4720,德淵,16.95,18.30,16.95,18.15,+1.25,7.4,14096790,5348,251300693,194000,120000,74000,0,0,0,0,0,0,74000
20200520,4722,國精化,27.90,28.00,27.60,27.95,+0.05,0.18,464164,196,12898581,7000,39000,-32000,0,0,0,61000,2000,59000,27000
20200520,4725,信昌化,6.79,6.79,6.79,6.79,-0.75,-9.95,166276,56,1129012,10000,0,10000,0,0,0,0,0,0,10000
20200520,4737,華廣,66.80,67.90,66.80,67.30,+0.50,0.75,73000,55,4911200,16000,3000,13000,0,0,0,0,0,0,13000
20200520,4739,康普,59.30,59.30,56.50,57.80,-0.90,-1.53,261768,220,15193563,69000,48000,21000,0,0,0,0,0,0,21000
20200520,4746,台耀,52.00,53.20,50.80,52.30,+0.60,1.16,6716257,4326,349474431,540000,418000,122000,0,0,0,4000,4000,0,122000
20200520,4755,三福化,46.00,46.05,45.85,46.00,+0.10,0.22,31000,25,1425250,1000,2000,-1000,0,0,0,0,0,0,-1000
20200520,4763,材料-KY,126.00,127.00,125.00,125.50,0.00,0.00,126789,117,15937625,7000,17000,-10000,0,0,0,1000,2000,-1000,-11000
20200520,4764,雙鍵,68.10,68.90,68.00,68.60,0.00,0.00,47100,31,3228300,2000,4000,-2000,0,0,0,0,0,0,-2000
20200520,4766,南寶,123.50,125.50,123.50,125.50,+2.50,2.03,181394,166,22601144,69000,30000,39000,0,0,0,0,1000,-1000,38000
20200520,4807,日成-KY,30.75,30.85,29.00,29.00,-2.50,-7.94,264022,216,7903510,0,4000,-4000,0,0,0,1000,0,1000,-3000
20200520,4904,遠傳,66.50,66.50,65.70,65.80,-0.20,-0.3,2681938,1463,176986608,1145000,2103938,-958938,4000,0,4000,295000,160000,135000,-819938
20200520,4906,正文,21.35,21.45,21.20,21.35,0.00,0.00,832718,400,17752620,316000,68000,248000,0,0,0,5000,1000,4000,252000
20200520,4912,聯德控股-KY,81.00,81.40,80.40,81.00,0.00,0.00,56237,58,4556297,5000,3000,2000,0,0,0,1000,0,1000,3000
20200520,4915,致伸,46.50,47.45,46.15,46.90,+0.40,0.86,2530922,1783,118036748,1255000,1443722,-188722,0,0,0,62000,12000,50000,-138722
20200520,4916,事欣科,26.80,26.80,26.55,26.70,+0.20,0.75,159000,102,4239450,40000,3000,37000,0,0,0,4000,0,4000,41000
20200520,4919,新唐,35.85,36.25,35.60,35.85,+0.35,0.99,1263964,813,45445103,201000,182000,19000,0,0,0,17000,1000,16000,35000
20200520,4927,泰鼎-KY,63.40,65.00,61.80,65.00,+2.10,3.34,12080796,7084,770963739,2293000,1357113,935887,743000,0,743000,379000,355000,24000,1702887
20200520,4930,燦星網,9.80,9.80,9.62,9.63,-0.06,-0.62,31068,27,301448,1000,4000,-3000,0,0,0,0,1000,-1000,-4000
20200520,4934,太極,16.85,17.15,16.65,16.75,-0.10,-0.59,1752482,774,29488715,228000,117000,111000,0,0,0,0,0,0,111000
20200520,4935,茂林-KY,125.00,135.50,125.00,135.50,+12.00,9.72,10069028,6558,1324230292,1710000,562000,1148000,420000,80000,340000,639000,27000,612000,2100000
20200520,4938,和碩,61.20,61.70,61.00,61.00,-0.10,-0.16,8696393,4578,532723918,2895475,6596378,-3700903,5000,0,5000,293000,77000,216000,-3479903
20200520,4942,嘉彰,34.00,34.10,33.75,33.80,-0.20,-0.59,311000,210,10545200,75000,148000,-73000,0,0,0,2000,0,2000,-71000
20200520,4943,康控-KY,121.50,122.50,116.00,117.00,-2.50,-2.09,2860494,2143,339564540,178000,771000,-593000,0,0,0,28000,102000,-74000,-667000
20200520,4952,凌通,29.15,29.55,29.15,29.30,+0.15,0.51,117000,82,3437450,26000,12000,14000,0,0,0,3000,0,3000,17000
20200520,4956,光鋐,17.10,19.15,17.10,19.15,+1.55,8.81,2203991,720,40738374,164000,6000,158000,0,0,0,0,161000,-161000,-3000
20200520,4958,臻鼎-KY,109.50,114.00,109.50,113.00,+4.00,3.67,7261820,4504,817545567,2047000,2979858,-932858,1194000,0,1194000,354000,210000,144000,405142
20200520,4960,誠美材,6.15,6.29,6.07,6.10,+0.02,0.33,2937772,672,18119195,299000,717000,-418000,0,0,0,8000,0,8000,-410000
20200520,4961,天鈺,26.95,27.80,26.85,27.65,+0.80,2.98,694154,412,19059457,228000,64000,164000,0,0,0,2000,0,2000,166000
20200520,4967,十銓,40.00,41.50,40.00,40.90,+1.45,3.68,7582175,4417,309628656,489000,420000,69000,0,0,0,1000,4000,-3000,66000
20200520,4968,立積,153.00,154.50,148.50,150.00,-3.00,-1.96,3358363,2493,505197176,377000,581000,-204000,0,272000,-272000,16000,39000,-23000,-499000
20200520,4976,佳凌,17.45,17.90,17.30,17.45,0.00,0.00,196537,136,3443019,68000,25000,43000,0,0,0,2000,0,2000,45000
20200520,4977,眾達-KY,122.00,122.00,118.00,118.50,-1.00,-0.84,1061550,755,127030170,106000,346000,-240000,0,0,0,1000,2000,-1000,-241000
20200520,4989,榮科,19.65,19.65,19.25,19.25,-0.05,-0.26,95237,70,1842426,6000,5000,1000,0,0,0,2000,0,2000,3000
20200520,4994,傳奇,64.60,65.40,64.00,64.00,-0.40,-0.62,94228,79,6087020,23000,18000,5000,0,0,0,1000,0,1000,6000
20200520,4999,鑫禾,40.10,40.25,39.90,40.10,+0.15,0.38,80016,42,3200048,8000,13000,-5000,0,0,0,6000,0,6000,1000
20200520,5007,三星,44.45,44.80,44.05,44.75,+0.30,0.67,81001,57,3601594,32000,51000,-19000,0,0,0,1000,0,1000,-18000
20200520,5203,訊連,120.00,120.50,117.50,118.50,-1.50,-1.25,506810,413,60070580,21000,143000,-122000,10000,0,10000,7000,44000,-37000,-149000
20200520,5215,科嘉-KY,72.80,72.80,71.70,71.80,-0.30,-0.42,866289,577,62548652,148000,91000,57000,0,0,0,1000,35000,-34000,23000
20200520,5225,東科-KY,25.80,25.80,24.85,24.85,-0.45,-1.78,199198,122,5016940,7000,89000,-82000,0,0,0,1000,0,1000,-81000
20200520,5234,達興材料,88.40,88.50,86.70,86.70,-0.90,-1.03,123080,116,10774336,3000,49000,-46000,0,0,0,4000,0,4000,-42000
20200520,5243,乙盛-KY,30.35,31.20,30.30,30.40,+0.05,0.16,668500,391,20450525,152000,230000,-78000,0,0,0,15000,58000,-43000,-121000
20200520,5258,虹堡,23.30,23.90,23.20,23.90,+0.55,2.36,149000,109,3508450,21000,22000,-1000,0,0,0,1000,3000,-2000,-3000
20200520,5264,鎧勝-KY,43.80,44.40,42.65,43.00,+0.35,0.82,1800862,1146,77891566,190000,820000,-630000,0,0,0,34000,25000,9000,-621000
20200520,5269,祥碩,1120.00,1165.00,1105.00,1165.00,+60.00,5.43,1028074,1026,1171775470,309053,179100,129953,3000,1000,2000,47000,23000,24000,155953
20200520,5283,禾聯碩,99.90,99.90,98.80,99.00,-0.60,-0.6,69300,68,6876848,13000,6000,7000,0,0,0,0,1000,-1000,6000
20200520,5284,jpp-KY,40.35,40.45,40.00,40.05,-0.30,-0.74,86000,55,3459250,1000,6000,-5000,0,0,0,0,0,0,-5000
20200520,5285,界霖,41.60,42.35,41.40,42.25,+0.85,2.05,155000,108,6504900,90000,9000,81000,0,0,0,0,0,0,81000
20200520,5288,豐祥-KY,95.50,96.50,94.50,95.60,-0.90,-0.93,200040,151,19076040,21000,86000,-65000,0,0,0,0,0,0,-65000
20200520,5305,敦南,41.70,41.70,41.40,41.50,-0.05,-0.12,451144,297,18737925,329000,101000,228000,0,0,0,7000,0,7000,235000
20200520,5388,中磊,72.00,72.60,71.70,71.90,-0.10,-0.14,487194,428,35098587,109000,263144,-154144,0,0,0,32000,34000,-2000,-156144
20200520,5434,崇越,102.50,103.00,101.50,102.00,-0.50,-0.49,446491,324,45608082,140000,50000,90000,0,0,0,43000,5000,38000,128000
20200520,5469,瀚宇博,37.00,37.10,36.25,36.60,-0.25,-0.68,3826138,1985,139987231,683000,663000,20000,0,300000,-300000,8000,103000,-95000,-375000
20200520,5471,松翰,57.60,58.50,57.00,57.40,+0.40,0.7,8420593,5072,485267727,1177000,426000,751000,0,318000,-318000,6000,0,6000,439000
20200520,5484,慧友,8.16,8.24,8.16,8.24,+0.20,2.49,104713,29,854433,0,4000,-4000,0,0,0,0,0,0,-4000
20200520,5515,建國,10.35,10.35,10.25,10.30,-0.05,-0.48,123402,53,1272017,14000,6000,8000,0,0,0,0,0,0,8000
20200520,5519,隆大,14.75,14.90,14.70,14.75,-0.05,-0.34,579242,212,8569831,137000,15000,122000,0,0,0,0,0,0,122000
20200520,5521,工信,8.44,8.48,8.30,8.32,-0.11,-1.3,1710923,449,14340095,61000,317000,-256000,0,0,0,1000,0,1000,-255000
20200520,5522,遠雄,44.00,44.10,43.75,44.00,0.00,0.00,1291261,515,56754385,190000,435000,-245000,0,0,0,8000,40000,-32000,-277000
20200520,5525,順天,19.95,20.10,19.95,20.10,0.00,0.00,33684,30,673847,7000,3000,4000,0,0,0,0,0,0,4000
20200520,5531,鄉林,8.68,8.74,8.58,8.61,-0.07,-0.81,264764,141,2286685,54000,148000,-94000,0,0,0,3000,1000,2000,-92000
20200520,5533,皇鼎,15.45,15.45,15.35,15.35,+0.05,0.33,84670,30,1304283,6000,5000,1000,0,0,0,0,0,0,1000
20200520,5534,長虹,82.30,82.50,82.00,82.10,-0.30,-0.36,360911,292,29711072,170909,172407,-1498,0,0,0,2000,20000,-18000,-19498
20200520,5538,東明-KY,29.10,29.10,29.10,29.10,0.00,0.00,4000,4,116400,0,3000,-3000,0,0,0,0,0,0,-3000
20200520,5546,永固-KY,60.50,62.30,58.70,59.60,0.00,0.00,3106110,1982,188315000,702000,40000,662000,0,0,0,98000,0,98000,760000
20200520,5607,遠雄港,21.95,22.40,21.70,21.80,-0.15,-0.68,1349000,567,29727850,316000,79000,237000,0,0,0,0,0,0,237000
20200520,5608,四維航,5.01,5.04,4.96,5.00,0.00,0.00,924086,246,4625502,150000,38000,112000,0,0,0,1000,1000,0,112000
20200520,5706,鳳凰,31.90,31.90,31.45,31.45,-0.40,-1.26,65700,58,2077664,3000,5000,-2000,0,0,0,0,0,0,-2000
20200520,5871,中租-KY,113.00,113.50,112.50,113.00,0.00,0.00,4600876,1234,519703348,3439000,3509010,-70010,3000,0,3000,97000,120000,-23000,-90010
20200520,5876,上海商銀,43.40,43.80,43.25,43.40,+0.05,0.12,2742273,1292,119186499,1678000,1100849,577151,9000,0,9000,79000,3000,76000,662151
20200520,5880,合庫金,20.10,20.15,20.00,20.05,-0.05,-0.25,10281440,3180,206287567,3525000,6825000,-3300000,25000,66000,-41000,284000,16000,268000,-3073000
20200520,5906,台南-KY,16.80,17.25,16.75,16.85,+0.05,0.3,31000,25,527100,2000,2000,0,0,0,0,0,0,0,0
20200520,5907,大洋-KY,23.50,23.80,23.40,23.70,+0.20,0.85,244000,109,5757650,92000,10000,82000,0,0,0,0,60000,-60000,22000
20200520,6005,群益證,9.98,10.05,9.91,9.95,-0.03,-0.3,1874504,1797,18655810,266000,1073000,-807000,0,0,0,0,0,0,-807000
20200520,6024,群益期,38.50,38.65,38.50,38.60,+0.10,0.26,111564,90,4305118,18000,22000,-4000,0,0,0,0,0,0,-4000
20200520,6108,競國,21.00,21.05,20.80,20.85,-0.05,-0.24,293365,184,6132508,32000,82000,-50000,0,0,0,2000,0,2000,-48000
20200520,6112,聚碩,39.90,39.95,39.20,39.95,0.00,0.00,1316237,861,52092676,314000,52000,262000,0,0,0,1000,0,1000,263000
20200520,6115,鎰勝,43.60,43.60,43.25,43.30,-0.30,-0.69,75000,64,3254450,8000,34000,-26000,0,0,0,10000,0,10000,-16000
20200520,6116,彩晶,6.07,6.14,6.00,6.00,-0.02,-0.33,8049891,1782,48719456,1491000,1697115,-206115,0,0,0,324000,405000,-81000,-287115
20200520,6117,迎廣,16.30,16.30,15.60,16.20,-0.10,-0.61,53000,27,840300,0,2000,-2000,0,0,0,1000,0,1000,-1000
20200520,6120,達運,10.45,10.70,10.45,10.50,+0.05,0.48,596728,281,6304770,121000,53000,68000,0,0,0,11000,1000,10000,78000
20200520,6128,上福,28.80,28.90,28.70,28.85,+0.05,0.17,41653,37,1199173,8000,7000,1000,0,0,0,7000,0,7000,8000
20200520,6131,鈞泰,,,,,0.00,0.00,0,0,0,0,0,0,0,0,0,0,0,0,0
20200520,6133,金橋,7.15,7.19,7.10,7.15,+0.01,0.14,26700,14,191125,3000,2000,1000,0,0,0,2000,0,2000,3000
20200520,6136,富爾特,18.60,18.75,18.60,18.60,-0.05,-0.27,100200,59,1870179,27000,3000,24000,0,0,0,1000,0,1000,25000
20200520,6139,亞翔,26.25,26.75,25.80,25.80,+0.05,0.19,1835554,1042,48210541,222000,147000,75000,0,0,0,16000,0,16000,91000
20200520,6141,柏承,17.20,17.35,17.20,17.20,+0.10,0.58,450006,245,7769703,59000,57000,2000,0,0,0,5000,0,5000,7000
20200520,6142,友勁,7.07,7.17,7.04,7.07,+0.01,0.14,68000,36,480750,9000,7000,2000,0,0,0,40000,0,40000,42000
20200520,6152,百一,6.02,6.05,5.91,6.03,-0.02,-0.33,156296,54,936866,4000,3000,1000,0,0,0,0,0,0,1000
20200520,6153,嘉聯益,26.10,26.60,26.10,26.40,+0.20,0.76,2531816,1514,66696621,780000,784000,-4000,0,0,0,103000,81000,22000,18000
20200520,6155,鈞寶,24.50,25.15,24.20,24.40,+0.20,0.83,365006,277,8972697,56000,63000,-7000,0,0,0,2000,0,2000,-5000
20200520,6164,華興,5.73,5.73,5.67,5.69,-0.03,-0.52,175342,71,999028,2000,10000,-8000,0,0,0,2000,0,2000,-6000
20200520,6165,捷泰,26.05,28.60,26.05,28.60,+2.60,10.0,1200693,609,33666819,262000,54000,208000,0,0,0,0,0,0,208000
20200520,6166,凌華,65.00,65.20,63.10,63.90,-1.10,-1.69,426654,298,27426728,71000,187000,-116000,0,0,0,3000,0,3000,-113000
20200520,6168,宏齊,12.00,12.60,12.00,12.50,+0.35,2.88,1142731,426,14090235,263000,19000,244000,0,0,0,4000,1000,3000,247000
20200520,6172,互億,23.00,23.30,22.50,22.50,-0.50,-2.17,170222,83,3898372,2000,9000,-7000,0,0,0,0,0,0,-7000
20200520,6176,瑞儀,97.90,99.80,97.70,99.50,+1.90,1.95,5333269,3733,528257287,2036627,656367,1380260,0,0,0,363000,51000,312000,1692260
20200520,6177,達麗,28.50,28.50,28.40,28.50,+0.15,0.53,363431,166,10340601,96000,7000,89000,0,0,0,0,0,0,89000
20200520,6183,關貿,42.05,42.10,41.90,41.95,-0.10,-0.24,80130,55,3366674,9000,14000,-5000,0,0,0,3000,0,3000,-2000
20200520,6184,大豐電,42.00,42.25,42.00,42.05,+0.05,0.12,192866,90,8128262,26000,5000,21000,0,0,0,0,0,0,21000
20200520,6189,豐藝,34.05,34.60,34.05,34.45,+0.35,1.03,537202,320,18486619,124000,7000,117000,0,0,0,9000,1000,8000,125000
20200520,6191,精成科,13.75,13.85,13.55,13.60,+0.20,1.49,4823550,1700,66027474,134000,1025000,-891000,0,0,0,8000,0,8000,-883000
20200520,6192,巨路,65.30,65.60,65.10,65.40,+0.10,0.15,90172,69,5892465,6000,4000,2000,0,0,0,6000,0,6000,8000
20200520,6196,帆宣,71.40,71.40,70.10,70.60,0.00,0.00,600000,464,42486700,139000,164000,-25000,0,0,0,5000,8000,-3000,-28000
20200520,6197,佳必琪,32.00,32.40,32.00,32.15,+0.20,0.63,437950,280,14119890,131000,63750,67250,0,0,0,12000,0,12000,79250
20200520,6201,亞弘電,33.30,33.45,33.25,33.25,+0.05,0.15,20150,18,671424,1000,2000,-1000,0,0,0,1000,0,1000,0
20200520,6202,盛群,65.20,66.00,65.20,65.50,+0.40,0.61,670610,475,43991076,245000,178000,67000,0,0,0,4000,8000,-4000,63000
20200520,6205,詮欣,25.00,25.00,24.80,24.80,-0.20,-0.8,38188,23,952412,0,6000,-6000,0,0,0,1000,0,1000,-5000
20200520,6206,飛捷,67.90,68.40,67.80,68.10,+0.30,0.44,85865,73,5839220,17000,9000,8000,0,0,0,3000,0,3000,11000
20200520,6209,今國光,21.60,21.80,21.30,21.45,-0.15,-0.69,405001,247,8744121,120000,29000,91000,0,0,0,3000,1000,2000,93000
20200520,6213,聯茂,131.00,131.50,128.00,128.50,-2.00,-1.53,2927502,2260,378459760,235272,756181,-520909,250000,334000,-84000,112000,230000,-118000,-722909
20200520,6214,精誠,78.50,78.70,78.10,78.50,0.00,0.00,351681,306,27586855,123000,130487,-7487,0,0,0,6000,17000,-11000,-18487
20200520,6215,和椿,16.00,16.25,15.80,16.00,+0.10,0.63,903001,470,14465217,19000,31000,-12000,0,0,0,1000,0,1000,-11000
20200520,6216,居易,27.30,27.40,27.20,27.25,-0.15,-0.55,40733,28,1112459,0,2000,-2000,0,0,0,1000,0,1000,-1000
20200520,6224,聚鼎,61.00,62.10,61.00,61.90,+1.10,1.81,386649,275,23806572,128000,4000,124000,0,0,0,1000,1000,0,124000
20200520,6225,天瀚,2.66,3.12,2.66,3.12,0.00,0.00,5640,8,16663,0,0,0,0,0,0,0,0,0,0
20200520,6226,光鼎,8.31,8.35,8.17,8.17,-0.14,-1.68,2099374,677,17297854,38000,269000,-231000,0,0,0,4000,0,4000,-227000
20200520,6230,超眾,244.50,247.00,240.00,240.00,-2.50,-1.03,487316,434,118626472,168000,72000,96000,0,0,0,12000,8000,4000,100000
20200520,6235,華孚,10.35,10.50,10.35,10.35,0.00,0.00,178525,87,1857610,29000,9000,20000,0,0,0,3000,0,3000,23000
20200520,6239,力成,99.30,100.50,98.10,98.80,-0.40,-0.4,3690988,2119,364426200,1197580,2361415,-1163835,232000,2000,230000,29000,143000,-114000,-1047835
20200520,6243,迅杰,9.00,9.02,8.90,8.92,-0.06,-0.67,197220,82,1766866,4000,2000,2000,0,0,0,0,0,0,2000
20200520,6251,定穎,19.05,19.20,18.75,18.95,+0.15,0.8,9242865,3357,175057533,766000,1239000,-473000,0,49000,-49000,11000,1000,10000,-512000
20200520,6257,矽格,37.00,37.90,36.85,37.75,+0.95,2.58,4925246,2831,184006671,777000,548000,229000,300000,0,300000,270000,314000,-44000,485000
20200520,6269,台郡,102.50,103.50,101.50,101.50,0.00,0.00,3422910,1992,349474320,527000,1911975,-1384975,282000,0,282000,16000,112000,-96000,-1198975
20200520,6271,同欣電,133.50,137.50,133.00,134.00,+2.00,1.52,6466567,4501,871975978,918000,1311000,-393000,783000,72000,711000,110000,349000,-239000,79000
20200520,6277,宏正,88.10,89.00,87.00,88.60,+0.50,0.57,251134,215,22140944,113000,49000,64000,0,0,0,7000,0,7000,71000
20200520,6278,台表科,112.50,120.00,109.00,117.00,+7.00,6.36,26259547,16564,2999269702,1559000,2713000,-1154000,431000,70000,361000,889000,946000,-57000,-850000
20200520,6281,全國電,68.20,68.20,68.00,68.00,-0.20,-0.29,40600,40,2764658,2000,16000,-14000,0,0,0,1000,1000,0,-14000
20200520,6282,康舒,20.70,20.70,20.45,20.50,-0.05,-0.24,1901258,850,39098126,160000,320000,-160000,0,0,0,82000,64000,18000,-142000
20200520,6283,淳安,21.60,22.40,21.60,21.90,+0.05,0.23,317150,190,7015770,53000,19000,34000,0,0,0,2000,1000,1000,35000
20200520,6285,啟碁,63.00,63.50,62.60,62.60,-0.60,-0.95,991175,604,62396125,221000,165585,55415,0,100000,-100000,21000,116000,-95000,-139585
20200520,6288,聯嘉,19.60,19.60,19.15,19.25,-0.35,-1.79,1533901,737,29702322,43000,693000,-650000,0,0,0,4000,2000,2000,-648000
20200520,6289,華上,1.81,1.81,1.73,1.73,-0.06,-3.35,3500,7,6202,0,0,0,0,0,0,0,0,0,0
20200520,6405,悅城,14.85,15.10,14.80,15.10,+0.15,1.0,14000,9,208300,1000,1000,0,0,0,0,2000,0,2000,2000
20200520,6409,旭隼,786.00,812.00,780.00,792.00,+13.00,1.67,114721,132,90906032,84480,60000,24480,0,0,0,3000,1000,2000,26480
20200520,6412,群電,64.40,64.40,63.30,64.00,0.00,0.00,485873,457,31043834,395000,103766,291234,0,0,0,1000,22000,-21000,270234
20200520,6414,樺漢,188.00,191.50,188.00,189.00,+1.50,0.8,526090,466,99786780,85000,59000,26000,0,0,0,6000,47000,-41000,-15000
20200520,6415,矽力-KY,1450.00,1485.00,1420.00,1480.00,-5.00,-0.34,1231881,1092,1802306855,864260,809829,54431,0,5000,-5000,8000,8000,0,49431
20200520,6416,瑞祺電通,123.00,128.00,123.00,127.00,+4.50,3.67,1878703,1428,236379281,169000,61000,108000,134000,0,134000,294000,50000,244000,486000
20200520,6431,光麗-KY,22.90,22.90,22.70,22.75,-0.15,-0.66,17483,13,398517,0,2000,-2000,0,0,0,0,0,0,-2000
20200520,6442,光聖,35.30,35.55,35.20,35.30,+0.10,0.28,19050,13,672946,1000,1000,0,0,0,0,1000,0,1000,1000
20200520,6443,元晶,6.22,6.30,6.16,6.19,+0.01,0.16,1500969,335,9323745,174000,32000,142000,0,0,0,0,0,0,142000
20200520,6449,鈺邦,30.05,30.95,30.05,30.55,+0.60,2.0,99254,80,3030197,44000,12000,32000,0,0,0,5000,3000,2000,34000
20200520,6451,訊芯-KY,108.50,109.00,106.50,108.00,+1.00,0.93,681290,570,73424965,92000,123000,-31000,0,0,0,3000,12000,-9000,-40000
20200520,6452,康友-KY,152.50,154.00,150.50,151.00,-1.50,-0.98,552629,421,84025289,194000,57000,137000,0,0,0,18000,1000,17000,154000
20200520,6456,GIS-KY,95.40,95.60,94.50,95.10,+0.20,0.21,1422645,906,135320238,305000,425000,-120000,37000,0,37000,23000,81000,-58000,-141000
20200520,6464,台數科,115.00,115.00,113.50,114.00,-1.00,-0.87,19050,16,2179650,0,2000,-2000,0,0,0,0,0,0,-2000
20200520,6477,安集,20.00,20.15,19.95,20.00,+0.05,0.25,104000,48,2080450,24000,4000,20000,0,0,0,3000,0,3000,23000
20200520,6491,晶碩,125.00,126.50,123.50,124.00,-1.00,-0.8,127100,92,15893100,27000,5000,22000,0,0,0,0,0,0,22000
20200520,6504,南六,236.50,240.50,229.00,237.50,+5.50,2.37,3749670,2954,885323624,548000,113000,435000,207000,0,207000,47000,160000,-113000,529000
20200520,6505,台塑化,93.00,93.00,91.00,91.00,-1.10,-1.19,4240366,2629,388479861,1389000,2299000,-910000,84000,0,84000,43000,14000,29000,-797000
20200520,6525,捷敏-KY,59.50,60.30,59.10,59.60,+1.00,1.71,305600,207,18255360,74000,13000,61000,0,0,0,12000,0,12000,73000
20200520,6531,愛普,221.00,223.00,214.50,216.50,+0.50,0.23,2797280,2194,612219616,521000,354000,167000,0,0,0,9000,0,9000,176000
20200520,6533,晶心科,116.50,121.50,115.00,120.00,+4.00,3.45,3111851,2593,369717769,237000,185000,52000,0,0,0,1000,12000,-11000,41000
20200520,6541,泰福-KY,48.20,48.20,46.65,48.20,+4.35,9.92,4350429,1652,208983276,119000,87000,32000,0,0,0,0,0,0,32000
20200520,6552,易華電,58.10,58.60,57.50,58.10,+0.30,0.52,457001,328,26547558,165000,36000,129000,0,0,0,1000,1000,0,129000
20200520,6558,興能高,44.30,45.20,43.50,45.20,+1.30,2.96,1196159,806,53300818,273000,83000,190000,0,0,0,5000,0,5000,195000
20200520,6573,虹揚-KY,18.00,18.10,17.60,17.70,+0.15,0.85,48173,44,858964,0,3000,-3000,0,0,0,0,0,0,-3000
20200520,6579,研揚,64.10,64.40,64.00,64.10,-0.10,-0.16,14000,14,899000,2000,3000,-1000,0,0,0,3000,0,3000,2000
20200520,6581,鋼聯,61.20,61.30,60.70,60.80,-0.40,-0.65,33028,31,2011448,2000,6000,-4000,0,0,0,0,0,0,-4000
20200520,6582,申豐,109.50,111.00,106.50,108.00,-0.50,-0.46,800250,656,86843750,65000,44000,21000,0,0,0,0,0,0,21000
20200520,6591,動力-KY,48.00,48.05,46.00,46.50,-1.50,-3.12,1049100,854,49088949,12000,414000,-402000,0,0,0,8000,5000,3000,-399000
20200520,6592,和潤企業,80.10,80.30,79.60,80.00,+0.20,0.25,1303154,812,104210120,406124,111000,295124,0,0,0,51000,4000,47000,342124
20200520,6605,帝寶,48.40,50.00,48.40,49.20,+1.05,2.18,506100,361,24973232,45000,22000,23000,0,0,0,0,37000,-37000,-14000
20200520,6625,必應,38.00,38.00,37.80,37.80,-0.45,-1.18,52252,19,1975700,0,2000,-2000,0,0,0,0,0,0,-2000
20200520,6641,基士德-KY,67.50,67.80,67.20,67.20,-0.60,-0.88,25250,18,1704600,1000,0,1000,0,0,0,0,0,0,1000
20200520,6655,科定,41.30,41.50,40.40,40.40,-0.90,-2.18,80000,30,3284100,1000,4000,-3000,0,0,0,0,0,0,-3000
20200520,6666,羅麗芬-KY,121.00,121.50,120.00,121.50,+1.50,1.25,20642,22,2496324,0,1000,-1000,0,0,0,0,0,0,-1000
20200520,6668,中揚光,58.50,59.00,57.10,57.80,-0.60,-1.03,184107,147,10696784,30000,34000,-4000,0,0,0,3000,0,3000,-1000
20200520,6669,緯穎,871.00,885.00,845.00,854.00,-3.00,-0.35,1603564,1510,1384310168,378000,311000,67000,20000,61000,-41000,45000,64000,-19000,7000
20200520,6670,復盛應用,158.00,171.50,158.00,170.50,+12.50,7.91,2395357,1860,395579506,668000,251887,416113,40000,16000,24000,140000,61000,79000,519113
20200520,6671,三能-KY,37.45,38.10,37.30,37.70,+0.35,0.94,175132,68,6577019,3000,8000,-5000,0,0,0,0,70000,-70000,-75000
20200520,6672,騰輝電子-KY,89.30,89.80,88.00,88.80,-0.50,-0.56,807000,576,71838800,113000,180000,-67000,0,0,0,1000,0,1000,-66000
20200520,6674,鋐寶科技,23.40,23.80,23.00,23.45,-0.15,-0.64,66000,39,1540000,1000,3000,-2000,0,0,0,1000,0,1000,-1000
20200520,6698,旭暉應材,51.40,52.50,51.40,52.50,+0.60,1.16,71000,58,3689400,14000,6000,8000,0,0,0,0,0,0,8000
20200520,6706,惠特,139.00,147.50,137.00,147.50,+13.00,9.67,5192045,3361,744250635,209000,79000,130000,214000,0,214000,55000,0,55000,399000
20200520,6715,嘉基,103.50,110.50,103.00,110.00,+6.50,6.28,901278,632,97072914,183000,0,183000,0,0,0,0,0,0,183000
20200520,8011,台通,20.10,20.30,18.90,18.90,-1.10,-5.5,6290748,2985,121444934,202000,164000,38000,0,0,0,1000,0,1000,39000
20200520,8016,矽創,155.00,155.00,146.00,147.00,-5.00,-3.29,5709849,4147,853847573,133000,1326287,-1193287,20000,80000,-60000,9000,89000,-80000,-1333287
20200520,8021,尖點,20.65,20.65,20.30,20.35,-0.20,-0.97,395783,235,8091028,51000,17000,34000,0,0,0,82000,0,82000,116000
20200520,8028,昇陽半導體,47.25,48.30,47.10,48.15,+1.10,2.34,829495,594,39587555,257000,139000,118000,0,0,0,6000,0,6000,124000
20200520,8033,雷虎,8.17,8.26,8.03,8.10,-0.07,-0.86,356488,206,2891062,10000,5000,5000,0,0,0,0,0,0,5000
20200520,8039,台虹,46.90,47.10,46.20,46.75,+0.05,0.11,924667,554,43283829,315000,183000,132000,0,0,0,40000,19000,21000,153000
20200520,8046,南電,59.00,60.30,56.70,57.80,-0.70,-1.2,34127170,17433,1990352843,4703000,4232000,471000,4462000,2618000,1844000,360000,340000,20000,2335000
20200520,8070,長華,156.00,156.00,155.00,155.50,0.00,0.00,31221,33,4847865,0,7000,-7000,0,0,0,2000,0,2000,-5000
20200520,8072,陞泰,21.60,21.85,21.60,21.70,+0.05,0.23,48317,48,1048794,0,2000,-2000,0,0,0,1000,0,1000,-1000
20200520,8081,致新,148.00,149.50,145.00,147.50,+3.00,2.08,4130720,3012,608467690,1161230,796000,365230,0,31000,-31000,10000,30000,-20000,314230
20200520,8101,華冠,4.11,4.11,4.11,4.11,-0.45,-9.87,72050,19,296125,0,0,0,0,0,0,0,0,0,0
20200520,8103,瀚荃,24.25,24.35,24.25,24.35,+0.10,0.41,104596,63,2542222,19000,18000,1000,0,0,0,5000,1000,4000,5000
20200520,8104,錸寶,40.30,41.45,39.30,41.10,+1.40,3.53,618077,470,25076420,91000,53000,38000,0,0,0,1000,0,1000,39000
20200520,8105,凌巨,8.90,9.19,8.90,9.06,+0.16,1.8,759271,331,6865104,331000,133000,198000,0,0,0,9000,1000,8000,206000
20200520,8110,華東,9.70,9.82,9.68,9.72,+0.02,0.21,506817,231,4939612,168000,36000,132000,0,0,0,45000,7000,38000,170000
20200520,8112,至上,30.30,30.75,30.25,30.65,+0.40,1.32,2719040,1425,82836473,846955,833000,13955,0,0,0,4000,154000,-150000,-136045
20200520,8114,振樺電,84.60,84.90,84.20,84.90,+0.30,0.35,51072,38,4317955,13000,2000,11000,0,0,0,5000,0,5000,16000
20200520,8131,福懋科,37.15,37.70,37.15,37.55,+0.55,1.49,496317,257,18578616,152000,47000,105000,0,0,0,11000,5000,6000,111000
20200520,8150,南茂,30.50,31.20,30.50,31.10,+0.65,2.13,3820178,1878,118011998,943000,500389,442611,500000,0,500000,75000,23000,52000,994611
20200520,8163,達方,36.45,36.80,36.20,36.40,+0.20,0.55,868462,556,31719315,128000,287000,-159000,0,0,0,103000,35000,68000,-91000
20200520,8201,無敵,8.22,8.27,8.10,8.19,-0.01,-0.12,113020,43,921401,1000,14000,-13000,0,0,0,0,0,0,-13000
20200520,8210,勤誠,92.50,92.60,91.30,91.60,-0.40,-0.43,901280,698,82766260,152000,321000,-169000,0,0,0,1000,80000,-79000,-248000
20200520,8213,志超,35.05,35.15,34.60,35.00,0.00,0.00,1746238,784,60982450,242000,211000,31000,0,0,0,3000,1000,2000,33000
20200520,8215,明基材,16.25,16.55,16.20,16.40,+0.20,1.23,934992,441,15334562,456000,87000,369000,0,0,0,5000,1000,4000,373000
20200520,8222,寶一,13.60,13.60,13.30,13.30,-0.10,-0.75,50169,31,671250,1000,5000,-4000,0,0,0,0,0,0,-4000
20200520,8249,菱光,18.40,18.50,18.35,18.40,0.00,0.00,74010,45,1361635,3000,9000,-6000,0,0,0,2000,0,2000,-4000
20200520,8261,富鼎,24.90,26.30,24.90,25.25,+0.65,2.64,1008991,721,25805272,87000,241000,-154000,0,0,0,3000,0,3000,-151000
20200520,8271,宇瞻,47.75,47.80,46.65,46.90,-0.50,-1.05,1712181,1168,80440883,366000,369000,-3000,0,118000,-118000,10000,0,10000,-111000
20200520,8341,日友,276.50,278.00,274.50,274.50,-2.00,-0.72,134394,164,37089147,83000,35333,47667,0,0,0,0,0,0,47667
20200520,8367,建新國際,25.15,25.60,25.00,25.00,-0.50,-1.96,126000,90,3159850,2000,3000,-1000,0,0,0,0,1000,-1000,-2000
20200520,8374,羅昇,20.80,20.90,20.65,20.90,+0.10,0.48,63019,39,1309090,9000,2000,7000,0,0,0,0,0,0,7000
20200520,8404,百和興業-KY,29.50,30.10,29.30,30.00,+0.60,2.04,558699,380,16641673,234002,45000,189002,0,0,0,1000,3000,-2000,187002
20200520,8411,福貞-KY,10.45,10.45,10.30,10.45,0.00,0.00,53000,33,548800,2000,3000,-1000,0,0,0,0,0,0,-1000
20200520,8422,可寧衛,154.50,157.00,154.50,156.50,+2.00,1.29,336710,266,52509470,8000,103000,-95000,0,0,0,1000,2000,-1000,-96000
20200520,8427,基勝-KY,48.35,48.85,47.10,48.85,0.00,0.00,12000,11,573100,4000,1000,3000,0,0,0,0,0,0,3000
20200520,8429,金麗-KY,7.25,7.29,7.21,7.21,-0.03,-0.41,216236,155,1566142,53000,30000,23000,0,0,0,0,0,0,23000
20200520,8442,威宏-KY,41.45,41.45,40.65,41.15,-0.25,-0.6,25000,24,1024550,1000,2000,-1000,0,0,0,0,0,0,-1000
20200520,8443,阿瘦,8.55,8.57,8.55,8.57,-0.10,-1.15,5327,11,45682,0,2000,-2000,0,0,0,1000,0,1000,-1000
20200520,8454,富邦媒,496.00,534.00,494.00,526.00,+30.00,6.05,794473,825,412662298,337950,267728,70222,0,38000,-38000,38000,13000,25000,57222
20200520,8462,柏文,193.50,202.00,193.50,200.50,+8.50,4.43,1163230,1024,231688102,147000,119000,28000,155000,0,155000,16000,7000,9000,192000
20200520,8463,潤泰材,38.65,38.70,38.00,38.20,-0.40,-1.04,194000,141,7440700,36000,23000,13000,0,0,0,0,0,0,13000
20200520,8464,億豐,248.00,252.50,246.00,248.50,+3.00,1.22,1058599,656,264118446,451215,232000,219215,100000,0,100000,16000,2000,14000,333215
20200520,8466,美吉吉-KY,66.00,67.00,66.00,67.00,+0.30,0.45,6000,6,398700,0,0,0,0,0,0,0,0,0,0
20200520,8467,波力-KY,51.40,54.80,51.30,54.80,+4.90,9.82,92002,66,4999509,7000,8000,-1000,0,0,0,0,0,0,-1000
20200520,8473,山林水,43.25,43.45,42.85,42.85,-0.35,-0.81,70283,49,3028776,3000,6000,-3000,0,0,0,0,1000,-1000,-4000
20200520,8478,東哥遊艇,35.85,35.85,35.10,35.20,-0.65,-1.81,38008,33,1338086,2000,2000,0,0,0,0,0,0,0,0
20200520,8480,泰昇-KY,139.50,139.50,136.00,137.50,-2.00,-1.43,17118,22,2359343,2000,10000,-8000,0,0,0,0,0,0,-8000
20200520,8481,政伸,58.30,59.20,58.30,58.40,-1.10,-1.85,7000,6,409200,0,1000,-1000,0,0,0,0,0,0,-1000
20200520,8482,商億-KY,105.00,105.50,104.00,104.00,0.00,0.00,233000,138,24372500,30000,44000,-14000,0,0,0,0,0,0,-14000
20200520,8488,吉源-KY,13.45,13.55,13.35,13.55,-0.05,-0.37,7000,7,94250,0,3000,-3000,0,0,0,0,1000,-1000,-4000
20200520,8497,格威傳媒,67.00,67.00,67.00,67.00,0.00,0.00,1000,1,67000,0,0,0,0,0,0,0,0,0,0
20200520,8499,鼎炫-KY,101.50,105.00,101.50,103.00,+2.00,1.98,151000,127,15574500,12000,10000,2000,0,0,0,0,0,0,2000
20200520,8926,台汽電,37.35,37.35,36.45,36.65,-0.70,-1.87,3691151,1994,135477098,1097000,224000,873000,0,0,0,1000,26000,-25000,848000
20200520,8940,新天地,9.96,9.99,9.79,9.79,-0.17,-1.71,50045,27,495326,0,2000,-2000,0,0,0,0,1000,-1000,-3000
20200520,8996,高力,71.30,73.40,70.00,71.50,+2.80,4.08,12062483,8304,864436175,621000,1265000,-644000,917000,0,917000,50000,75000,-25000,248000
20200520,9103,美德醫療-DR,5.28,5.28,5.15,5.15,+0.20,4.04,4580968,632,23732714,366000,0,366000,0,0,0,0,0,0,366000
20200520,910322,康師傅-DR,26.60,26.60,26.15,26.20,-1.40,-5.07,6000,4,157900,3000,2000,1000,0,0,0,0,0,0,1000
20200520,910482,聖馬丁-DR,0.26,0.26,0.25,0.25,0.00,0.00,2308068,59,597909,0,0,0,0,0,0,0,0,0,0
20200520,9105,泰金寶-DR,2.46,2.46,2.43,2.44,-0.04,-1.61,350099,65,854000,34000,0,34000,0,0,0,0,0,0,34000
20200520,910861,神州-DR,8.59,8.60,8.48,8.48,-0.01,-0.12,62000,17,530670,17000,0,17000,0,0,0,0,0,0,17000
20200520,9110,越南控-DR,1.36,1.37,1.31,1.34,+0.01,0.75,33000,13,44480,0,0,0,0,0,0,0,0,0,0
20200520,911608,明輝-DR,,,,,0.00,0.00,0,0,0,0,0,0,0,0,0,0,0,0,0
20200520,911616,杜康-DR,0.91,0.91,0.88,0.90,-0.02,-2.17,72000,29,64510,0,0,0,0,0,0,0,0,0,0
20200520,911622,泰聚亨-DR,,,,,0.00,0.00,0,0,0,0,0,0,0,0,0,0,0,0,0
20200520,911868,同方友友-DR,0.94,0.94,0.94,0.94,-0.03,-3.09,12000,4,11280,11000,0,11000,0,0,0,0,0,0,11000
20200520,912000,晨訊科-DR,1.91,1.91,1.90,1.90,+0.01,0.53,5000,3,9540,0,0,0,0,0,0,0,0,0,0
20200520,912398,友佳-DR,2.33,2.33,2.19,2.23,0.00,0.00,233000,43,516030,0,171000,-171000,0,0,0,0,0,0,-171000
20200520,9136,巨騰-DR,9.59,9.68,9.51,9.51,+0.06,0.63,613000,105,5864340,306000,5000,301000,0,0,0,0,0,0,301000
20200520,9188,精熙-DR,2.53,2.53,2.50,2.52,0.00,0.00,67000,20,169250,0,0,0,0,0,0,0,0,0,0
20200520,9802,鈺齊-KY,87.50,88.40,87.30,87.30,+0.40,0.46,1377000,947,120958400,334000,318000,16000,0,155000,-155000,22000,1000,21000,-118000
20200520,9902,台火,8.67,8.70,8.64,8.64,-0.03,-0.35,47000,37,407310,2000,13000,-11000,0,0,0,0,0,0,-11000
20200520,9904,寶成,27.40,27.45,27.10,27.40,-0.05,-0.18,6475075,3432,176519642,2260000,2101543,158457,607000,0,607000,208000,90000,118000,883457
20200520,9905,大華,21.30,21.40,21.20,21.25,0.00,0.00,39000,29,829900,8000,2000,6000,0,0,0,0,0,0,6000
20200520,9906,欣巴巴,22.00,22.00,21.85,21.85,+0.05,0.23,65524,48,1436213,2000,2000,0,0,0,0,0,0,0,0
20200520,9907,統一實,8.69,8.74,8.60,8.63,-0.02,-0.23,1456044,392,12583456,414000,46000,368000,0,0,0,3000,2000,1000,369000
20200520,9908,大台北,29.90,30.10,29.90,29.90,-0.10,-0.33,280500,127,8397050,30000,29000,1000,0,0,0,1000,7000,-6000,-5000
20200520,9910,豐泰,168.50,176.50,165.00,175.00,+6.50,3.86,5830524,3633,1013322700,1419000,1961768,-542768,1065000,0,1065000,106000,11000,95000,617232
20200520,9911,櫻花,46.70,46.90,45.25,46.55,-0.10,-0.21,160575,131,7465213,35000,84000,-49000,0,0,0,3000,2000,1000,-48000
20200520,9912,偉聯,6.74,6.74,6.36,6.70,-0.11,-1.62,68671,55,452063,0,0,0,0,0,0,1000,0,1000,1000
20200520,9914,美利達,172.00,181.50,172.00,178.00,+8.50,5.01,3905057,2967,693215146,1750001,751000,999001,370000,340000,30000,138000,24000,114000,1143001
20200520,9917,中保科,86.00,86.40,85.90,85.90,-0.10,-0.12,504970,331,43468303,179871,327000,-147129,0,159000,-159000,20000,1000,19000,-287129
20200520,9918,欣天然,34.90,34.90,34.20,34.20,-0.30,-0.87,11300,13,388719,4000,2000,2000,0,0,0,0,3000,-3000,-1000
20200520,9919,康那香,31.10,32.90,31.00,32.90,+2.95,9.85,9213379,2872,297403314,657000,115000,542000,0,0,0,50000,801000,-751000,-209000
20200520,9921,巨大,224.00,233.50,223.00,228.50,+10.50,4.82,4467757,3460,1026514203,3059679,1594000,1465679,5000,110000,-105000,111000,4000,107000,1467679
20200520,9924,福興,40.50,40.75,40.40,40.45,-0.05,-0.12,97000,81,3931950,10000,28000,-18000,0,0,0,0,3000,-3000,-21000
20200520,9925,新保,36.00,36.20,35.90,36.00,-0.25,-0.69,412560,227,14863097,26000,181000,-155000,0,0,0,0,5000,-5000,-160000
20200520,9926,新海,42.00,42.00,42.00,42.00,0.00,0.00,5070,7,212940,0,3000,-3000,0,0,0,0,0,0,-3000
20200520,9927,泰銘,29.85,29.95,29.70,29.95,+0.10,0.34,137436,78,4096706,10000,55000,-45000,0,0,0,0,0,0,-45000
20200520,9928,中視,3.79,3.79,3.79,3.79,+0.09,2.43,10139,15,38389,0,0,0,0,0,0,0,0,0,0
20200520,9929,秋雨,11.80,12.15,11.75,12.15,0.00,0.00,43081,22,512729,1000,2000,-1000,0,0,0,0,0,0,-1000
20200520,9930,中聯資源,44.00,44.25,43.80,43.80,-0.20,-0.45,91513,90,4026990,19002,30000,-10998,0,0,0,0,0,0,-10998
20200520,9931,欣高,39.80,40.45,39.75,40.45,0.00,0.00,4100,5,164360,0,0,0,0,0,0,0,0,0,0
20200520,9933,中鼎,34.20,34.40,33.95,34.30,+0.40,1.18,2242728,1437,76584520,945000,595843,349157,0,0,0,1000,4000,-3000,346157
20200520,9934,成霖,12.30,12.40,12.10,12.15,-0.15,-1.22,580900,213,7116684,50000,56000,-6000,0,0,0,0,1000,-1000,-7000
20200520,9935,慶豐富,27.80,28.00,27.35,27.75,+0.40,1.46,575181,318,15903468,236000,94000,142000,0,0,0,1000,0,1000,143000
20200520,9937,全國,43.85,44.35,43.80,43.95,-0.20,-0.45,20002,15,878287,1000,5000,-4000,0,0,0,0,0,0,-4000
20200520,9938,百和,66.80,66.80,64.40,66.00,+0.20,0.3,3885246,2614,255716278,432000,398000,34000,0,261000,-261000,95000,149000,-54000,-281000
20200520,9939,宏全,56.50,56.60,54.60,54.60,-2.20,-3.87,2102250,1333,116118297,49000,1322591,-1273591,0,0,0,23000,161000,-138000,-1411591
20200520,9940,信義,25.75,26.05,25.65,25.70,-0.05,-0.19,276013,180,7148926,56386,103000,-46614,0,0,0,51000,1000,50000,3386
20200520,9941,裕融,99.60,100.50,99.20,99.60,+0.60,0.61,313350,249,31228500,77000,41000,36000,0,0,0,0,2000,-2000,34000
20200520,9941A,裕融甲特,52.70,52.80,52.70,52.80,0.00,0.00,4000,4,211100,0,0,0,0,0,0,0,0,0,0
20200520,9942,茂順,63.50,64.90,63.50,64.30,+0.80,1.26,59001,51,3777268,8000,32000,-24000,0,0,0,0,0,0,-24000
20200520,9943,好樂迪,64.00,64.10,63.60,63.60,-0.30,-0.47,118022,105,7525909,5000,34000,-29000,0,0,0,0,0,0,-29000
20200520,9944,新麗,21.65,23.20,21.10,23.20,+2.10,9.95,9678468,4051,218672005,434000,374000,60000,0,0,0,0,1000,-1000,59000
20200520,9945,潤泰新,45.30,45.35,44.85,45.00,-0.25,-0.55,3247232,1732,146383440,438000,825000,-387000,174000,0,174000,5000,71000,-66000,-279000
20200520,9946,三發地產,14.80,15.05,14.55,15.05,+0.05,0.33,201797,100,2998355,0,31000,-31000,0,0,0,0,0,0,-31000
20200520,9955,佳龍,17.00,17.00,16.60,16.70,-0.05,-0.3,671238,301,11262946,31000,104000,-73000,0,0,0,0,0,0,-73000
20200520,9958,世紀鋼,87.60,88.00,84.60,84.60,-1.90,-2.2,6601850,4407,568203050,386000,581000,-195000,0,30000,-30000,123000,364000,-241000,-466000
20200520,00679B,元大美債20年,49.83,49.99,49.83,49.93,+0.09,0.18,182000,70,9088690,4000,0,4000,0,0,0,49000,114000,-65000,-61000
20200520,00687B,國泰20年美債,52.45,52.45,52.30,52.35,+0.15,0.29,121000,18,6334300,0,3000,-3000,0,0,0,105000,113000,-8000,-11000
20200520,00694B,富邦美債1-3,40.61,40.61,40.61,40.61,+0.03,0.07,300000,2,12183000,0,0,0,0,0,0,300000,300000,0,0
20200520,00695B,富邦美債7-10,42.24,42.26,42.24,42.26,+0.09,0.21,302000,3,12762480,0,0,0,0,0,0,302000,300000,2000,2000
20200520,00696B,富邦美債20年,52.30,52.30,52.25,52.30,+0.15,0.29,422000,6,22050100,0,10000,-10000,0,0,0,400000,412000,-12000,-22000
20200520,00697B,元大美債7-10,44.77,44.79,44.77,44.78,+0.01,0.02,839000,34,37565950,0,0,0,0,0,0,120000,120000,0,0
20200520,00718B,富邦中國政策債,19.70,19.70,19.67,19.68,+0.02,0.1,425000,18,8364150,0,0,0,0,0,0,396000,405000,-9000,-9000
20200520,00719B,元大美債1-3,32.30,32.30,32.25,32.27,-0.03,-0.09,312000,9,10070530,0,0,0,0,0,0,100000,102000,-2000,-2000
20200520,00720B,元大投資級公司債,44.41,44.47,44.41,44.47,+0.42,0.95,1247000,65,55408570,0,0,0,0,0,0,111000,105000,6000,6000
20200520,00721B,元大中國債3-5,45.35,45.35,45.32,45.32,-0.03,-0.07,1362000,41,61759630,0,0,0,0,0,0,100000,100000,0,0
20200520,00722B,群益15年IG電信債,48.79,49.08,48.78,49.02,+0.52,1.07,115000,25,5631280,0,0,0,0,0,0,108000,104000,4000,4000
20200520,00723B,群益15年IG科技債,45.84,45.90,45.84,45.90,+0.40,0.88,101000,5,4635840,0,0,0,0,0,0,101000,100000,1000,1000
20200520,00724B,群益10年IG金融債,43.00,43.10,43.00,43.10,+0.25,0.58,110000,12,4740480,0,0,0,0,0,0,104000,100000,4000,4000
20200520,00725B,國泰投資級公司債,42.60,42.67,42.58,42.63,+0.37,0.88,114000,8,4859300,0,0,0,0,0,0,100000,111000,-11000,-11000
20200520,00726B,國泰5Y+新興債,42.01,42.15,42.01,42.08,+0.38,0.91,109000,7,4586710,0,0,0,0,0,0,101000,108000,-7000,-7000
20200520,00727B,國泰1-5Y高收債,38.32,38.32,38.24,38.25,+0.10,0.26,105000,7,4016290,0,0,0,0,0,0,103000,101000,2000,2000
20200520,00734B,台新JPM新興債,20.57,20.68,20.56,20.59,+0.12,0.59,1028000,32,21146660,0,0,0,0,0,0,956000,934000,22000,22000
20200520,00740B,富邦全球投等債,46.99,47.00,46.91,46.95,+0.53,1.14,355000,17,16671830,0,0,0,0,0,0,350000,345000,5000,5000
20200520,00741B,富邦全球高收債,37.34,37.34,37.30,37.30,+0.10,0.27,240000,4,8956800,0,0,0,0,0,0,240000,240000,0,0
20200520,00744B,國泰中國政金債5+,41.55,41.61,41.55,41.61,+0.12,0.29,124000,5,5153470,0,0,0,0,0,0,124000,124000,0,0
20200520,00745B,富邦中政債0-1,38.98,38.98,38.97,38.97,+0.02,0.05,100000,4,3897500,0,0,0,0,0,0,100000,100000,0,0
20200520,00746B,富邦A級公司債,46.78,46.78,46.75,46.75,+0.40,0.86,100000,4,4676500,0,0,0,0,0,0,100000,100000,0,0
20200520,00747B,FH中國政策債,50.60,50.70,50.60,50.60,0.00,0.0,856000,27,43358100,0,0,0,0,0,0,105000,106000,-1000,-1000
20200520,00748B,凱基中國債3-10,41.35,41.35,41.35,41.35,+0.05,0.12,100000,2,4135000,0,0,0,0,0,0,100000,100000,0,0
20200520,00749B,凱基新興債10+,44.60,44.60,44.60,44.60,+0.30,0.68,135000,9,6021000,0,0,0,0,0,0,135000,135000,0,0
20200520,00750B,凱基科技債10+,47.00,47.00,47.00,47.00,+0.51,1.1,100000,2,4700000,0,0,0,0,0,0,100000,100000,0,0
20200520,00751B,元大AAA至A公司債,47.97,47.98,47.85,47.88,+0.37,0.78,717000,81,34370240,0,0,0,0,0,0,213000,144000,69000,69000
20200520,00754B,群益AAA-AA公司債,49.17,49.20,49.17,49.20,+0.33,0.68,101000,3,4969170,0,0,0,0,0,0,101000,100000,1000,1000
20200520,00755B,群益15年IG公用債,45.93,46.03,45.93,46.00,+0.07,0.15,111000,9,5101010,0,0,0,0,0,0,100000,109000,-9000,-9000
20200520,00756B,群益15年EM主權債,46.74,47.03,46.74,47.03,+0.33,0.71,126000,13,5924700,2000,0,2000,0,0,0,123000,121000,2000,4000
20200520,00758B,FH能源債,57.85,57.90,57.85,57.90,,0.00,104000,4,6021400,0,0,0,0,0,0,104000,100000,4000,4000
20200520,00759B,FH製藥債,75.50,75.50,75.50,75.50,,0.00,100000,2,7550000,0,0,0,0,0,0,100000,100000,0,0
20200520,00760B,FH新興企業債,62.80,63.05,62.80,62.95,,0.00,134000,8,8443900,25000,0,25000,0,0,0,109000,125000,-16000,9000
20200520,00761B,國泰A級公司債,49.10,49.15,49.10,49.15,+0.45,0.92,101000,3,4964100,0,0,0,0,0,0,101000,100000,1000,1000
20200520,00764B,群益25年美債,53.00,53.00,52.90,52.90,+0.05,0.09,101000,3,5343000,0,0,0,0,0,0,100000,101000,-1000,-1000
20200520,00765B,群益中國政金債,39.67,39.67,39.67,39.67,-0.08,-0.2,100000,2,3967000,0,0,0,0,0,0,100000,100000,0,0
20200520,00768B,FH20年美債,82.30,82.30,82.05,82.25,+0.40,0.49,1063000,20,87366900,111000,0,111000,0,0,0,100000,211000,-111000,0
20200520,00769B,FH中國信用債,60.15,60.20,60.15,60.20,+0.05,0.08,695000,20,41828500,0,0,0,0,0,0,100000,100000,0,0
20200520,00772B,中信高評級公司債,47.33,47.41,47.33,47.38,+0.28,0.59,690000,32,32702290,0,0,0,0,0,0,650000,672000,-22000,-22000
20200520,00773B,中信優先金融債,47.09,47.12,46.96,47.01,+0.27,0.58,655000,28,30789090,0,0,0,0,0,0,634000,626000,8000,8000
20200520,00777B,凱基AAA至A公司債,46.95,46.95,46.95,46.95,+0.45,0.97,100000,2,4695000,0,0,0,0,0,0,100000,100000,0,0
20200520,00778B,凱基金融債20+,46.42,46.42,46.42,46.42,+0.42,0.91,120000,4,5570400,0,0,0,0,0,0,120000,120000,0,0
20200520,00779B,凱基美債25+,53.60,53.60,53.60,53.60,0.00,0.0,100000,2,5360000,0,0,0,0,0,0,100000,100000,0,0
20200520,00780B,國泰A級金融債,42.95,42.95,42.95,42.95,+0.15,0.35,100000,2,4295000,0,0,0,0,0,0,100000,100000,0,0
20200520,00781B,國泰A級科技債,47.31,47.31,47.30,47.30,+0.52,1.11,101000,3,4777310,0,0,0,0,0,0,101000,100000,1000,1000
20200520,00782B,國泰A級公用債,45.31,45.32,45.20,45.25,+0.11,0.24,217000,22,9819700,0,0,0,0,0,0,217000,213000,4000,4000
20200520,00784B,富邦中國投等債,40.60,40.69,40.60,40.69,+0.19,0.47,200000,4,8129000,0,0,0,0,0,0,200000,200000,0,0
20200520,00785B,富邦金融投等債,44.13,44.13,44.13,44.13,+0.43,0.98,200000,5,8826000,0,0,0,0,0,0,200000,200000,0,0
20200520,00786B,元大10年IG銀行債,43.08,43.08,43.05,43.05,+0.24,0.56,6000,6,258350,0,0,0,0,0,0,6000,3000,3000,3000
20200520,00787B,元大10年IG醫療債,45.81,45.84,45.65,45.75,+0.23,0.51,1131000,65,51777890,130000,0,130000,0,0,0,48000,163000,-115000,15000
20200520,00788B,元大10年IG電能債,43.50,43.52,43.38,43.41,+0.25,0.58,1010000,50,43900240,0,0,0,0,0,0,204000,195000,9000,9000
20200520,00789B,FH公司債A3,69.85,70.10,69.85,70.10,+0.35,0.5,700000,8,48965000,0,0,0,0,0,0,100000,100000,0,0
20200520,00790B,FH次順位IG金融債,65.30,65.40,65.30,65.40,+0.40,0.62,250000,3,16335000,0,0,0,0,0,0,100000,100000,0,0
20200520,00791B,FH美元信用債1-5Y,59.40,59.40,59.20,59.30,-0.10,-0.17,350000,4,20760000,0,0,0,0,0,0,100000,100000,0,0
20200520,00792B,群益A級公司債,45.43,45.45,45.42,45.42,+0.34,0.75,103000,5,4681280,0,0,0,0,0,0,103000,100000,3000,3000
20200520,00793B,群益AAA-A醫療債,46.29,46.42,46.29,46.42,+0.24,0.52,106000,5,4920000,0,0,0,0,0,0,104000,100000,4000,4000
20200520,00794B,群益7+中國政金債,39.43,39.48,39.43,39.48,+0.01,0.03,101000,3,3987430,0,0,0,0,0,0,101000,100000,1000,1000
20200520,00795B,中信美國公債20年,50.05,50.20,50.05,50.15,+0.10,0.2,219000,12,10989500,0,0,0,0,0,0,216000,212000,4000,4000
20200520,00796B,中信中國債7-10,39.31,39.31,39.28,39.28,-0.08,-0.2,210000,6,8250900,0,0,0,0,0,0,210000,210000,0,0
20200520,00798B,國泰中企A級債7+,42.60,42.65,42.60,42.65,-0.05,-0.12,101000,3,4307600,0,0,0,0,0,0,101000,100000,1000,1000
20200520,00799B,國泰A級醫療債,45.71,45.75,45.70,45.70,+0.15,0.33,107000,6,4890020,0,0,0,0,0,0,100000,106000,-6000,-6000
20200520,00831B,新光美債1-3,39.87,39.92,39.87,39.92,+0.05,0.13,54000,3,2155480,0,0,0,0,0,0,54000,50000,4000,4000
20200520,00832B,新光美債20+,51.60,51.60,51.60,51.60,0.00,0.0,50000,2,2580000,0,0,0,0,0,0,50000,50000,0,0
20200520,00833B,第一金美債20+,49.23,49.29,49.23,49.29,+0.06,0.12,102000,5,5026960,0,0,0,0,0,0,100000,100000,0,0
20200520,00834B,第一金金融債10+,43.84,43.84,43.83,43.83,+0.51,1.18,100000,4,4383500,0,0,0,0,0,0,100000,100000,0,0
20200520,00835B,第一金科技債10+,44.22,44.22,44.22,44.22,+0.46,1.05,2000,2,88440,0,0,0,0,0,0,2000,2000,0,0
20200520,00836B,永豐10年A公司債,42.57,42.80,42.57,42.80,+0.29,0.68,101000,3,4322570,0,0,0,0,0,0,101000,100000,1000,1000
20200520,00837B,永豐15年金融債,35.00,35.72,35.00,35.57,+0.22,0.62,132000,13,4661840,0,0,0,0,0,0,100000,100000,0,0
20200520,00838B,永豐7-10年中國債,39.12,39.12,39.12,39.12,+0.06,0.15,100000,2,3912000,0,0,0,0,0,0,100000,100000,0,0
20200520,00839B,凱基醫療保健債,44.11,44.35,44.11,44.35,,0.00,104000,3,4611440,0,0,0,0,0,0,104000,100000,4000,4000
20200520,00840B,凱基IG精選15+,42.50,42.50,42.50,42.50,,0.00,100000,2,4250000,0,0,0,0,0,0,100000,100000,0,0
20200520,00841B,凱基AAA-AA公司債,43.20,43.20,43.20,43.20,,0.00,100000,2,4320000,0,0,0,0,0,0,100000,100000,0,0
20200520,00842B,台新美元銀行債,41.61,41.61,41.52,41.52,+0.20,0.48,55000,6,2285930,0,0,0,0,0,0,52000,53000,-1000,-1000
20200520,00843B,台新中國政策債,39.20,39.26,39.15,39.15,-0.11,-0.28,55000,5,2155070,0,0,0,0,0,0,51000,50000,1000,1000
20200520,00844B,新光15年IG金融債,41.56,41.56,41.50,41.50,+0.35,0.85,5000,3,207680,0,0,0,0,0,0,2000,5000,-3000,-3000
20200520,00845B,富邦新興投等債,36.74,36.74,36.68,36.74,+0.29,0.8,297000,7,10902500,88000,0,88000,0,0,0,200000,297000,-97000,-9000
20200520,00846B,富邦歐洲銀行債,39.37,39.37,39.35,39.35,+0.12,0.31,207000,4,8145590,0,0,0,0,0,0,200000,207000,-7000,-7000
20200520,00847B,中信美國市政債,37.95,37.98,37.95,37.95,+0.10,0.26,223000,15,8467080,0,0,0,0,0,0,217000,211000,6000,6000
20200520,00848B,中信新興亞洲債,38.48,38.54,38.48,38.54,+0.40,1.05,210000,7,8088500,35000,0,35000,0,0,0,175000,210000,-35000,0
20200520,00849B,中信EM主權債0-5,38.92,38.92,38.90,38.90,+0.02,0.05,210000,6,8171450,0,0,0,0,0,0,210000,210000,0,0
20200520,00853B,統一美債10年Aa-A,37.92,37.92,37.92,37.92,+0.03,0.08,1000,1,37920,0,0,0,0,0,0,1000,0,1000,1000
20200520,00854B,富邦全球保險債,40.22,40.22,40.22,40.22,+0.35,0.88,110000,3,4424200,10000,0,10000,0,0,0,100000,110000,-10000,0
20200520,00855B,富邦全球能源債,36.75,36.81,36.74,36.80,+0.36,0.99,149000,24,5481720,0,0,0,0,0,0,100000,149000,-49000,-49000
20200520,00856B,永豐1-3年美公債,39.55,39.55,39.55,39.55,-0.02,-0.05,100000,2,3955000,0,0,0,0,0,0,100000,100000,0,0
20200520,00857B,永豐20年美公債,44.53,44.53,44.53,44.53,0.00,0.0,100000,2,4453000,0,0,0,0,0,0,100000,100000,0,0
20200520,00858,永豐美國500大,19.98,19.98,19.98,19.98,-0.10,-0.5,100000,2,1998000,0,0,0,0,0,0,100000,100000,0,0
20200520,00859B,群益0-1年美債,39.10,39.15,39.10,39.15,+0.01,0.03,101000,3,3954100,0,0,0,0,0,0,100000,100000,0,0
20200520,00860B,群益1-5年IG債,39.38,39.38,39.35,39.35,+0.06,0.15,101000,3,3977350,0,0,0,0,0,0,100000,100000,0,0
20200520,00862B,中信投資級公司債,40.23,40.34,40.23,40.33,+0.39,0.98,221000,14,8910320,0,0,0,0,0,0,220000,210000,10000,10000
20200520,00863B,中信全球電信債,41.59,41.80,41.59,41.78,+0.22,0.53,213000,9,8901500,0,0,0,0,0,0,213000,212000,1000,1000
20200520,00864B,中信美國公債0-1,39.48,39.48,39.48,39.48,+0.01,0.03,210000,6,8290800,0,0,0,0,0,0,210000,210000,0,0
20200520,00867B,新光A-BBB電信債,42.13,42.13,42.00,42.00,+0.30,0.72,5000,5,210260,0,0,0,0,0,0,2000,2000,0,0
20200520,00868B,FT1-3年美公債,40.42,40.42,40.42,40.42,+0.07,0.17,100000,2,4042000,0,0,0,0,0,0,100000,100000,0,0
20200520,00869B,FT10-25年公司債,39.35,39.35,39.35,39.35,+0.19,0.49,100000,2,3935000,0,0,0,0,0,0,100000,100000,0,0
20200520,00870B,元大15年EM主權債,39.32,39.32,39.23,39.32,+0.17,0.43,792000,23,31122890,0,0,0,0,0,0,205000,201000,4000,4000
20200520,00871B,元大中國政金債,39.41,39.46,39.41,39.46,0.00,0.0,236000,8,9308160,0,0,0,0,0,0,235000,236000,-1000,-1000
20200520,00872B,凱基美債1-3,40.79,40.79,40.79,40.79,0.00,0.0,100000,2,4079000,0,0,0,0,0,0,100000,100000,0,0
20200520,00873B,凱基新興債1-5,38.76,38.97,38.76,38.94,+0.14,0.36,102000,4,3971730,0,0,0,0,0,0,102000,101000,1000,1000
20200520,00874B,凱基BBB公司債15+,37.89,37.89,37.89,37.89,+0.39,1.04,100000,2,3789000,0,0,0,0,0,0,100000,100000,0,0
20200520,1240,茂生農經,53.20,53.60,53.00,53.10,-0.40,-0.75,25000,16,1330900,0,0,0,0,0,0,0,0,0,0
20200520,1258,其祥-KY,10.65,11.40,10.65,11.35,+0.95,9.13,241000,97,2744650,8000,8000,0,0,0,0,0,0,0,0
20200520,1259,安心,70.00,70.30,69.20,70.30,+0.30,0.43,31000,21,2169300,0,0,0,0,0,0,0,0,0,0
20200520,1264,德麥,218.00,220.00,218.00,219.00,+1.50,0.69,14000,14,3066500,0,0,0,0,0,0,0,0,0,0
20200520,1268,漢來美食,128.50,128.50,127.00,128.50,-0.50,-0.39,21000,20,2680000,0,0,0,0,0,0,0,0,0,0
20200520,1336,台翰,15.10,15.20,15.10,15.15,+0.10,0.66,192000,57,2905500,0,0,0,0,0,0,0,0,0,0
20200520,1565,精華,359.50,359.50,353.50,354.00,-2.00,-0.56,108000,103,38362500,12000,4000,8000,0,0,0,2000,1000,1000,9000
20200520,1569,濱川,24.10,24.55,23.40,23.50,-0.40,-1.67,4786000,1672,115728900,85000,342000,-257000,0,0,0,0,116000,-116000,-373000
20200520,1570,力肯,14.00,14.05,13.75,13.90,+0.10,0.72,82000,48,1138200,0,0,0,0,0,0,0,0,0,0
20200520,1580,新麥,88.80,89.90,88.70,89.40,+0.70,0.79,57000,53,5092300,19000,10000,9000,0,0,0,0,0,0,9000
20200520,1584,精剛,7.11,7.17,6.85,7.07,-0.13,-1.81,397000,87,2779610,0,0,0,0,0,0,0,0,0,0
20200520,1586,和勤,38.25,38.25,37.85,38.10,-0.15,-0.39,328000,150,12469750,25000,4000,21000,0,0,0,0,0,0,21000
20200520,1591,駿吉-KY,19.60,19.60,19.00,19.25,+0.05,0.26,4000,4,76850,0,0,0,0,0,0,0,0,0,0
20200520,1593,祺驊,46.80,46.80,46.70,46.80,+0.10,0.21,17000,10,794200,0,0,0,0,0,0,0,0,0,0
20200520,1595,川寶,34.10,34.95,33.70,34.85,+0.15,0.43,33000,27,1130700,0,0,0,0,0,0,0,0,0,0
20200520,1597,直得,86.50,88.50,86.50,88.20,+1.90,2.2,376000,321,32980600,70000,14000,56000,10000,0,10000,26000,0,26000,92000
20200520,1599,宏佳騰,29.35,29.60,29.35,29.60,+0.10,0.34,4000,4,117850,0,0,0,0,0,0,0,0,0,0
20200520,1742,台蠟,21.70,21.70,21.15,21.60,+0.10,0.47,120000,82,2560700,6000,2000,4000,0,0,0,0,0,0,4000
20200520,1752,南光,43.55,44.15,43.25,43.70,+0.30,0.69,542000,371,23740900,160000,57000,103000,0,0,0,21000,9000,12000,115000
20200520,1777,生泰,83.80,88.70,82.80,87.90,+4.50,5.4,759000,551,65941600,57000,12000,45000,0,0,0,0,0,0,45000
20200520,1781,合世,17.20,17.20,16.10,16.30,-0.90,-5.23,890000,570,14740850,0,33000,-33000,0,0,0,0,8000,-8000,-41000
20200520,1784,訊聯,38.90,38.95,37.90,38.00,-0.90,-2.31,962000,646,36739250,58000,14000,44000,0,0,0,0,0,0,44000
20200520,1785,光洋科,19.95,20.05,19.70,19.75,-0.05,-0.25,966000,387,19120900,58000,71000,-13000,0,0,0,0,0,0,-13000
20200520,1788,杏昌,108.00,109.50,108.00,109.00,+0.50,0.46,19000,17,2069500,0,0,0,0,0,0,0,0,0,0
20200520,1796,金穎生技,23.60,23.60,23.55,23.55,+0.45,1.95,2000,2,47150,0,0,0,0,0,0,0,0,0,0
20200520,1799,易威,14.85,14.85,14.85,14.85,+1.35,10.0,1097000,380,16290450,0,10000,-10000,0,0,0,0,0,0,-10000
20200520,1813,寶利徠,21.15,21.30,21.10,21.30,+0.15,0.71,46000,33,973350,0,3000,-3000,0,0,0,0,0,0,-3000
20200520,1815,富喬,9.86,10.05,9.86,9.87,+0.02,0.2,1904000,458,18900250,156000,168000,-12000,0,0,0,0,6000,-6000,-18000
20200520,2035,唐榮,38.50,38.60,38.50,38.60,+0.40,1.05,13000,9,501000,0,0,0,0,0,0,0,0,0,0
20200520,2061,風青,8.00,8.00,7.92,7.92,-0.08,-1.0,9000,7,71660,0,0,0,0,0,0,0,0,0,0
20200520,2063,世鎧,32.50,32.50,32.45,32.45,-0.05,-0.15,18000,14,584700,0,0,0,0,0,0,0,0,0,0
20200520,2064,晉椿,11.35,11.35,11.35,11.35,+0.05,0.44,1000,1,11350,0,0,0,0,0,0,0,0,0,0
20200520,2065,世豐,58.30,59.00,57.80,58.20,+0.10,0.17,336000,218,19611100,26000,14000,12000,0,0,0,0,0,0,12000
20200520,2066,世德,53.20,53.80,53.20,53.80,+0.10,0.19,26000,12,1391900,0,0,0,0,0,0,0,0,0,0
20200520,2067,嘉鋼,9.06,9.07,8.89,8.89,0.00,0.0,14000,9,125040,0,0,0,0,0,0,0,0,0,0
20200520,2070,精湛,31.75,32.10,31.00,31.20,-0.70,-2.19,56000,29,1774450,0,0,0,0,0,0,0,0,0,0
20200520,2221,大甲,25.00,25.05,24.85,25.00,0.00,0.0,34000,28,847650,0,0,0,0,0,0,0,0,0,0
20200520,2230,泰茂,10.00,10.00,9.85,9.85,-0.15,-1.5,15000,11,148170,0,0,0,0,0,0,0,0,0,0
20200520,2235,謚源,46.80,47.70,46.75,46.90,+0.15,0.32,27000,18,1268000,0,0,0,0,0,0,0,0,0,0
20200520,2596,綠意,19.00,19.45,19.00,19.30,+0.30,1.58,123000,55,2365700,7000,0,7000,0,0,0,0,0,0,7000
20200520,2640,大車隊,78.50,78.80,78.50,78.60,+0.30,0.38,43000,25,3380000,16000,0,16000,0,0,0,0,0,0,16000
20200520,2641,正德,6.19,6.23,6.19,6.19,0.00,0.0,285000,77,1766500,0,0,0,0,0,0,0,0,0,0
20200520,2643,捷迅,44.30,44.30,43.55,43.90,0.00,0.0,127000,102,5565450,8000,0,8000,0,0,0,43000,0,43000,51000
20200520,2718,晶悅,18.30,18.30,18.30,18.30,+1.30,7.65,1000,1,18300,0,0,0,0,0,0,0,0,0,0
20200520,2719,燦星旅,8.40,8.50,8.40,8.50,+0.10,1.19,50000,28,424800,0,0,0,0,0,0,0,0,0,0
20200520,2724,富驛-KY,2.95,2.95,2.95,2.95,0.00,0.0,4000,4,11800,0,0,0,0,0,0,0,0,0,0
20200520,2726,雅茗-KY,66.10,66.50,64.10,66.10,+1.20,1.85,182000,149,11908200,22000,0,22000,0,0,0,0,0,0,22000
20200520,2729,瓦城,230.50,230.50,224.50,225.50,-5.00,-2.17,78000,68,17707500,0,25000,-25000,0,0,0,0,0,0,-25000
20200520,2732,六角,146.00,147.50,141.00,141.00,-4.00,-2.76,516000,454,73969000,30000,27000,3000,0,0,0,0,6000,-6000,-3000
20200520,2734,易飛網,9.90,9.99,9.71,9.99,+0.09,0.91,19000,14,188500,0,0,0,0,0,0,0,0,0,0
20200520,2736,高野,14.50,14.60,14.10,14.45,+0.10,0.7,106000,51,1533450,3000,2000,1000,0,0,0,0,0,0,1000
20200520,2740,天蔥,12.35,13.45,12.35,13.15,+0.85,6.91,49000,29,628050,0,3000,-3000,0,0,0,0,0,0,-3000
20200520,2743,山富,15.30,15.40,15.05,15.20,+0.05,0.33,63000,35,960100,0,1000,-1000,0,0,0,0,0,0,-1000
20200520,2745,五福,15.85,15.85,15.70,15.80,-0.05,-0.32,40000,18,631350,0,0,0,0,0,0,0,0,0,0
20200520,2752,豆府,109.50,110.00,108.50,108.50,-1.00,-0.91,25000,24,2736500,0,1000,-1000,0,0,0,0,0,0,-1000
20200520,2916,滿心,16.60,16.60,16.40,16.45,-0.15,-0.9,18000,13,296100,0,1000,-1000,0,0,0,0,0,0,-1000
20200520,2924,東凌-KY,19.80,19.90,19.80,19.90,+0.10,0.51,3000,3,59600,0,0,0,0,0,0,0,0,0,0
20200520,2926,誠品生活,83.30,83.80,83.30,83.80,+0.60,0.72,3000,3,250700,0,0,0,0,0,0,0,0,0,0
20200520,2928,紅馬-KY,44.35,44.85,41.80,42.50,-1.40,-3.19,276000,205,12013950,70000,11000,59000,0,0,0,7000,0,7000,66000
20200520,2937,集雅社,25.90,26.25,25.85,26.25,+0.25,0.96,8000,7,207800,0,0,0,0,0,0,3000,0,3000,3000
20200520,3064,泰偉,14.35,14.35,14.35,14.35,0.00,0.0,9000,7,129150,0,0,0,0,0,0,0,0,0,0
20200520,3066,李洲,6.81,6.88,6.25,6.87,+0.09,1.33,13000,8,86000,0,0,0,0,0,0,0,0,0,0
20200520,3067,全域,27.85,28.80,25.60,28.00,+0.15,0.54,45000,40,1230300,0,5000,-5000,0,0,0,0,4000,-4000,-9000
20200520,3071,協禧,19.15,19.25,18.95,19.00,+0.10,0.53,367000,180,6998500,16000,0,16000,0,0,0,0,0,0,16000
20200520,3073,凱柏實業,8.30,8.30,7.65,7.65,-0.66,-7.94,9000,5,70930,0,0,0,0,0,0,0,0,0,0
20200520,3078,僑威,27.00,27.00,26.65,26.70,-0.10,-0.37,1302000,677,34875700,48000,133323,-85323,210000,0,210000,0,5000,-5000,119677
20200520,3081,聯亞,261.50,262.00,257.00,258.00,-1.00,-0.39,562000,440,145623000,58000,207000,-149000,0,0,0,7000,2000,5000,-144000
20200520,3083,網龍,87.40,88.50,85.20,85.20,-0.80,-0.93,2336000,1780,201653900,78092,132000,-53908,0,0,0,53000,75000,-22000,-75908
20200520,3085,新零售,2.10,2.20,2.10,2.10,+0.04,1.94,36000,16,77600,0,0,0,0,0,0,0,0,0,0
20200520,3086,華義,17.80,17.80,17.80,17.80,+0.15,0.85,1000,1,17800,0,0,0,0,0,0,0,0,0,0
20200520,3088,艾訊,53.50,53.80,53.40,53.50,0.00,0.0,59000,46,3157700,0,20000,-20000,0,0,0,0,0,0,-20000
20200520,3089,元炬,20.30,21.00,20.00,21.00,+1.00,5.0,116000,49,2361150,3000,0,3000,0,0,0,0,0,0,3000
20200520,3092,鴻碩,41.90,42.10,41.80,41.80,-0.15,-0.36,176000,101,7385900,3000,5000,-2000,0,0,0,0,0,0,-2000
20200520,3093,港建,29.10,29.30,29.00,29.30,+0.05,0.17,14000,12,407600,0,0,0,0,0,0,0,0,0,0
20200520,3095,及成,1.96,2.02,1.96,2.02,-0.06,-2.88,12000,5,23660,0,0,0,0,0,0,0,0,0,0
20200520,3105,穩懋,250.00,250.50,243.50,246.00,-6.00,-2.38,10561000,8203,2597783000,2403100,3167000,-763900,113000,160000,-47000,101000,231000,-130000,-940900
20200520,3114,好德,21.45,21.65,21.40,21.65,+0.15,0.7,81000,28,1743650,20000,2000,18000,0,0,0,0,0,0,18000
20200520,3115,寶島極,10.85,11.65,10.85,11.65,+1.05,9.91,77000,48,879300,0,2000,-2000,0,0,0,0,0,0,-2000
20200520,3118,進階,35.80,36.40,34.60,34.60,-1.90,-5.21,938000,663,33149300,7000,34000,-27000,0,0,0,8000,0,8000,-19000
20200520,3122,笙泉,10.30,11.40,10.30,11.15,+0.75,7.21,119000,75,1323050,0,0,0,0,0,0,0,4000,-4000,-4000
20200520,3128,昇銳,12.90,12.90,12.70,12.80,0.00,0.0,19000,16,242850,0,0,0,0,0,0,0,0,0,0
20200520,3131,弘塑,229.00,229.00,225.00,227.00,-1.00,-0.44,372000,307,84497000,18000,3000,15000,0,22000,-22000,9000,8000,1000,-6000
20200520,3141,晶宏,21.80,22.20,21.70,22.05,+0.45,2.08,230000,139,5050900,46000,2000,44000,0,0,0,0,0,0,44000
20200520,3144,新揚科,25.30,25.55,25.15,25.20,0.00,0.0,189000,124,4782350,4000,9000,-5000,0,0,0,0,0,0,-5000
20200520,3147,大綜,32.15,32.20,32.00,32.20,-0.10,-0.31,25000,14,803550,0,0,0,0,0,0,0,0,0,0
20200520,3152,璟德,302.50,302.50,298.50,300.00,-1.50,-0.5,264000,222,79315500,85000,55000,30000,0,0,0,3000,8000,-5000,25000
20200520,3162,精確,9.50,9.50,9.46,9.48,-0.13,-1.35,13000,8,123220,0,0,0,0,0,0,0,0,0,0
20200520,3163,波若威,40.95,41.75,40.30,40.80,+1.00,2.51,1075000,684,44025650,102000,54000,48000,0,0,0,103000,7000,96000,144000
20200520,3169,亞信,35.40,36.50,35.35,35.90,+0.20,0.56,123000,92,4421100,9000,1000,8000,0,0,0,0,0,0,8000
20200520,3171,新洲,18.35,19.10,18.30,18.95,+0.65,3.55,461000,206,8680600,31000,17000,14000,0,0,0,0,0,0,14000
20200520,3176,基亞,65.30,68.00,62.50,63.00,-5.50,-8.03,5213000,3500,334793200,31000,44000,-13000,0,0,0,60000,1000,59000,46000
20200520,3178,公準,46.70,47.40,45.70,46.55,0.00,0.0,914000,688,42359950,50000,34000,16000,0,0,0,0,0,0,16000
20200520,3188,鑫龍騰,13.90,13.90,13.80,13.85,0.00,0.0,22000,8,304900,0,0,0,0,0,0,0,0,0,0
20200520,3191,和進,43.80,45.45,43.60,44.85,+1.05,2.4,138000,102,6165600,19000,1000,18000,0,0,0,0,0,0,18000
20200520,3202,樺晟,19.30,20.15,18.75,18.75,-0.25,-1.32,4572000,1462,88382200,388000,420000,-32000,0,0,0,0,0,0,-32000
20200520,3205,佰研,41.00,41.95,40.00,41.60,+0.95,2.34,142000,106,5845550,30000,0,30000,0,0,0,0,0,0,30000
20200520,3206,志豐,27.65,27.95,27.20,27.95,+0.30,1.08,175000,90,4843800,18000,6000,12000,0,0,0,0,0,0,12000
20200520,3207,耀勝,11.65,11.90,11.60,11.90,0.00,0.0,9000,6,105800,0,0,0,0,0,0,0,0,0,0
20200520,3211,順達,74.20,77.60,74.10,77.50,+3.40,4.59,4651000,3228,354226500,833000,65000,768000,0,0,0,319000,64000,255000,1023000
20200520,3213,茂訊,48.60,49.40,48.40,48.95,-0.10,-0.2,197000,112,9625100,29000,0,29000,0,0,0,0,54000,-54000,-25000
20200520,3217,優群,94.60,96.30,93.50,93.70,-0.60,-0.64,2373000,1672,224653700,379140,272000,107140,0,236000,-236000,66000,14000,52000,-76860
20200520,3218,大學光,124.00,134.00,120.00,130.50,+3.50,2.76,10593000,7875,1353444500,779000,1169010,-390010,14000,94000,-80000,156000,46000,110000,-360010
20200520,3221,台嘉碩,21.40,21.75,21.40,21.75,+0.35,1.64,393000,230,8470300,106000,8000,98000,0,0,0,0,0,0,98000
20200520,3224,三顧,50.00,50.00,49.05,49.15,-0.30,-0.61,38000,35,1870700,1000,6000,-5000,0,0,0,0,0,0,-5000
20200520,3226,至寶電,54.00,54.00,54.00,54.00,+1.00,1.89,1000,1,54000,0,0,0,0,0,0,0,0,0,0
20200520,3227,原相,164.00,164.50,161.00,161.50,-2.00,-1.22,2795000,2222,452949000,117071,797000,-679929,300000,66000,234000,21000,144000,-123000,-568929
20200520,3228,金麗科,32.40,32.90,32.10,32.50,+0.30,0.93,236000,134,7648400,39000,50000,-11000,0,0,0,6000,1000,5000,-6000
20200520,3230,錦明,5.46,5.48,5.39,5.45,0.00,0.0,9000,5,48850,0,0,0,0,0,0,0,0,0,0
20200520,3232,昱捷,20.35,20.35,18.75,19.10,-1.15,-5.68,2416000,1389,46202950,19000,46000,-27000,0,0,0,4000,1000,3000,-24000
20200520,3234,光環,34.60,35.45,34.60,35.25,+0.75,2.17,1556000,926,54475500,372000,41000,331000,0,0,0,0,1000,-1000,330000
20200520,3236,千如,16.70,16.80,16.30,16.45,-0.15,-0.9,303000,153,5021000,75000,6000,69000,0,0,0,0,0,0,69000
20200520,3252,海灣,14.75,15.15,14.75,14.90,+0.20,1.36,74000,26,1105300,3000,0,3000,0,0,0,0,0,0,3000
20200520,3259,鑫創,13.00,13.00,12.85,13.00,0.00,0.0,78000,27,1009050,15000,0,15000,0,0,0,0,4000,-4000,11000
20200520,3260,威剛,54.00,54.20,52.80,53.30,-0.50,-0.93,3421000,2181,183154400,176000,810000,-634000,0,0,0,345000,292000,53000,-581000
20200520,3264,欣銓,28.15,28.35,27.65,27.85,-0.25,-0.89,2575000,1239,72086450,256000,214046,41954,0,0,0,17000,43000,-26000,15954
20200520,3265,台星科,23.60,23.80,23.40,23.50,-0.05,-0.21,107000,72,2515150,1000,9000,-8000,0,0,0,0,0,0,-8000
20200520,3268,海德威,10.00,10.00,9.89,10.00,0.00,0.0,8000,7,79670,0,0,0,0,0,0,0,0,0,0
20200520,3272,東碩,21.70,21.70,21.25,21.40,-0.15,-0.7,79000,45,1698450,13000,0,13000,0,0,0,0,0,0,13000
20200520,3276,宇環,7.35,7.66,7.35,7.40,-0.11,-1.46,6000,6,44810,0,1000,-1000,0,0,0,0,0,0,-1000
20200520,3284,太普高,11.95,12.10,11.75,12.10,+0.10,0.83,160000,28,1903550,0,0,0,0,0,0,0,0,0,0
20200520,3285,微端,14.60,14.65,14.50,14.50,0.00,0.0,18000,16,263050,0,0,0,0,0,0,0,0,0,0
20200520,3287,廣寰科,8.38,8.47,8.18,8.33,-0.01,-0.12,91000,41,757230,0,2000,-2000,0,0,0,0,0,0,-2000
20200520,3288,點晶,8.70,9.43,8.70,8.88,-0.35,-3.79,9000,9,80250,0,0,0,0,0,0,0,0,0,0
20200520,3289,宜特,47.30,48.95,47.00,48.95,+1.65,3.49,2138000,1318,102105250,251000,166000,85000,36000,0,36000,30000,49000,-19000,102000
20200520,3290,東浦,13.90,13.90,13.70,13.70,0.00,0.0,184000,99,2532500,0,4000,-4000,0,0,0,0,0,0,-4000
20200520,3293,鈊象,540.00,542.00,530.00,530.00,-6.00,-1.12,903000,811,483263000,239200,124423,114777,3000,43000,-40000,7000,15000,-8000,66777
20200520,3294,英濟,13.85,13.85,13.50,13.50,-0.10,-0.74,17000,11,232850,0,0,0,0,0,0,0,0,0,0
20200520,3297,杭特,11.65,11.80,11.60,11.65,0.00,0.0,12000,6,140200,0,0,0,0,0,0,0,0,0,0
20200520,3303,岱稜,24.10,24.25,23.75,23.90,-0.10,-0.42,187000,120,4462250,0,9000,-9000,0,0,0,0,0,0,-9000
20200520,3306,鼎天,17.05,17.30,17.05,17.10,+0.10,0.59,4000,4,68500,0,0,0,0,0,0,0,0,0,0
20200520,3310,佳穎,28.95,28.95,28.75,28.95,0.00,0.0,18000,10,518800,0,0,0,0,0,0,0,0,0,0
20200520,3313,斐成,14.15,14.45,14.10,14.30,+0.05,0.35,185000,70,2647550,31000,11000,20000,0,0,0,0,0,0,20000
20200520,3317,尼克森,38.85,39.80,38.30,38.50,+1.25,3.36,5915000,3827,231638350,230000,365000,-135000,0,0,0,89000,19000,70000,-65000
20200520,3322,建舜電,6.72,6.75,6.66,6.73,+0.01,0.15,46000,22,308860,2000,0,2000,0,0,0,0,0,0,2000
20200520,3323,加百裕,29.75,29.95,29.65,29.85,+0.10,0.34,159000,116,4745000,13000,9000,4000,0,0,0,0,0,0,4000
20200520,3324,雙鴻,166.00,166.50,163.00,163.50,-2.00,-1.21,1221000,965,200714000,113000,112000,1000,0,157000,-157000,12000,14000,-2000,-158000
20200520,3325,旭品,13.15,13.40,13.00,13.05,-0.10,-0.76,272000,115,3583150,0,6000,-6000,0,0,0,0,0,0,-6000
20200520,3332,幸康,29.50,29.50,29.50,29.50,+0.25,0.85,2000,1,59000,0,0,0,0,0,0,0,0,0,0
20200520,3339,泰谷,2.74,2.75,2.74,2.75,0.00,0.0,4000,2,10990,0,0,0,0,0,0,0,0,0,0
20200520,3354,律勝,12.10,12.25,12.05,12.25,+0.10,0.82,31000,16,377250,0,0,0,0,0,0,0,0,0,0
20200520,3360,尚立,16.40,16.50,16.10,16.30,-0.05,-0.31,468000,180,7644850,70000,4000,66000,0,0,0,0,0,0,66000
20200520,3362,先進光,36.90,37.20,35.85,36.15,-1.05,-2.82,396000,301,14433950,36000,25000,11000,0,0,0,1000,0,1000,12000
20200520,3363,上詮,24.35,24.40,24.10,24.15,-0.05,-0.21,312000,198,7549350,49000,4000,45000,0,0,0,0,2000,-2000,43000
20200520,3372,典範,8.90,9.02,8.90,9.02,+0.02,0.22,17000,10,151830,0,0,0,0,0,0,0,0,0,0
20200520,3373,熱映,115.00,124.00,115.00,124.00,+11.00,9.73,2141000,889,259167000,150000,78000,72000,0,0,0,20000,10000,10000,82000
20200520,3374,精材,77.80,79.50,77.50,78.20,+0.50,0.64,7203000,4207,565808700,590000,370000,220000,0,0,0,0,1000,-1000,219000
20200520,3379,彬台,8.60,8.80,8.54,8.57,+0.02,0.23,175000,79,1511870,3000,3000,0,0,0,0,0,0,0,0
20200520,3388,崇越電,64.80,65.10,64.60,64.70,-0.10,-0.15,47000,33,3044700,8000,2000,6000,0,0,0,0,0,0,6000
20200520,3390,旭軟,14.10,14.10,13.90,14.00,0.00,0.0,51000,33,711300,0,12000,-12000,0,0,0,0,0,0,-12000
20200520,3402,漢科,26.45,26.70,26.40,26.40,-0.15,-0.56,193000,141,5106550,24000,12000,12000,0,0,0,0,78000,-78000,-66000
20200520,3426,台興,36.00,36.00,36.00,36.00,+1.00,2.86,1000,1,36000,0,0,0,0,0,0,0,0,0,0
20200520,3434,哲固,11.00,11.00,10.90,10.95,-0.10,-0.9,22000,6,241400,0,0,0,0,0,0,0,0,0,0
20200520,3438,類比科,30.80,33.30,30.80,33.30,+3.00,9.9,3726000,2206,122249150,116000,121000,-5000,0,0,0,0,0,0,-5000
20200520,3441,聯一光,25.70,26.25,25.45,25.45,-0.05,-0.2,51000,47,1311850,1000,3000,-2000,0,0,0,0,0,0,-2000
20200520,3444,利機,36.40,37.40,36.30,36.50,+0.65,1.81,1035000,728,37958600,24000,81000,-57000,0,0,0,0,0,0,-57000
20200520,3455,由田,45.05,45.45,45.05,45.30,+0.25,0.55,119000,87,5387300,12000,13000,-1000,0,0,0,0,0,0,-1000
20200520,3465,進泰電子,51.00,51.00,49.95,50.50,-0.50,-0.98,22000,19,1104400,0,0,0,0,0,0,0,0,0,0
20200520,3466,致振,14.70,14.80,14.70,14.80,-0.05,-0.34,39000,16,576900,0,0,0,0,0,0,0,0,0,0
20200520,3479,安勤,65.60,66.70,64.80,66.40,+1.00,1.53,409000,317,26978600,107000,54000,53000,0,0,0,0,1000,-1000,52000
20200520,3483,力致,62.00,62.90,61.10,62.40,+0.80,1.3,1478000,934,91711300,321000,74000,247000,0,0,0,13000,37000,-24000,223000
20200520,3484,崧騰,24.10,24.15,23.90,24.15,+0.05,0.21,63000,34,1514450,2000,17000,-15000,0,0,0,0,0,0,-15000
20200520,3489,森寶,10.30,10.35,10.20,10.20,0.00,0.0,45000,21,460200,3000,4000,-1000,0,0,0,0,0,0,-1000
20200520,3490,單井,20.20,20.60,20.20,20.30,+0.30,1.5,280000,198,5696900,47000,14000,33000,0,0,0,0,0,0,33000
20200520,3491,昇達科,72.50,73.00,72.30,72.60,+0.10,0.14,221000,160,16059300,80000,1000,79000,0,0,0,13000,0,13000,92000
20200520,3492,長盛,15.40,15.65,15.40,15.45,+0.15,0.98,56000,50,866500,0,0,0,0,0,0,0,0,0,0
20200520,3498,陽程,20.30,21.00,20.30,20.90,+0.40,1.95,132000,84,2738150,32000,0,32000,0,0,0,0,0,0,32000
20200520,3499,環天科,11.45,11.45,11.35,11.40,0.00,0.0,66000,25,752450,1000,0,1000,0,0,0,0,0,0,1000
20200520,3508,位速,19.20,19.45,19.10,19.35,+0.15,0.78,219000,102,4229300,62000,0,62000,0,0,0,0,0,0,62000
20200520,3511,矽瑪,26.50,27.25,26.45,26.80,+0.40,1.52,498000,341,13376400,76000,25000,51000,0,0,0,0,0,0,51000
20200520,3512,皇龍,29.00,29.00,28.80,29.00,0.00,0.0,95000,16,2745900,0,0,0,0,0,0,0,0,0,0
20200520,3516,亞帝歐,10.85,11.00,10.85,10.85,-0.05,-0.46,19000,6,207100,0,0,0,0,0,0,0,0,0,0
20200520,3520,振維,12.55,12.60,12.05,12.50,-0.05,-0.4,248000,61,3074950,0,0,0,0,0,0,0,0,0,0
20200520,3521,鴻翊,12.30,12.35,12.00,12.10,-0.20,-1.63,64000,36,780250,0,1000,-1000,0,0,0,0,0,0,-1000
20200520,3522,御頂,9.75,9.95,9.75,9.80,+0.05,0.51,35000,15,343810,3000,0,3000,0,0,0,0,0,0,3000
20200520,3523,迎輝,9.91,9.96,9.70,9.95,+0.04,0.4,43000,24,425620,0,0,0,0,0,0,0,2000,-2000,-2000
20200520,3526,凡甲,96.10,96.70,94.10,94.60,-0.40,-0.42,2627000,2023,250206500,231200,155000,76200,0,299000,-299000,21000,52000,-31000,-253800
20200520,3527,聚積,92.70,92.90,91.10,92.00,+0.10,0.11,544000,418,50056600,94000,18000,76000,0,0,0,25000,6000,19000,95000
20200520,3529,力旺,357.00,367.50,345.00,349.00,+2.50,0.72,3257000,2887,1159953500,192200,319000,-126800,166000,93000,73000,100000,29000,71000,17200
20200520,3531,先益,23.40,23.40,23.30,23.40,0.00,0.0,32000,16,747950,0,0,0,0,0,0,0,0,0,0
20200520,3537,堡達,38.50,39.25,38.40,38.55,-0.05,-0.13,1352000,782,52537300,105000,77000,28000,0,0,0,0,2000,-2000,26000
20200520,3540,曜越,20.55,20.55,20.35,20.40,-0.10,-0.49,69000,49,1411900,0,0,0,0,0,0,0,0,0,0
20200520,3541,西柏,75.80,75.90,75.40,75.60,0.00,0.0,100000,81,7557200,14000,6000,8000,0,0,0,0,0,0,8000
20200520,3546,宇峻,87.70,89.40,87.50,89.00,+1.40,1.6,748000,622,66114000,74000,19000,55000,0,0,0,9000,4000,5000,60000
20200520,3548,兆利,62.40,63.40,62.10,63.10,+0.60,0.96,243000,208,15200600,23000,13000,10000,0,0,0,0,27000,-27000,-17000
20200520,3551,世禾,42.00,42.30,41.70,41.80,-0.05,-0.12,285000,202,11955400,48000,13000,35000,0,0,0,1000,1000,0,35000
20200520,3552,同致,53.50,56.10,53.20,54.80,+1.30,2.43,324000,242,17819100,37000,2000,35000,0,0,0,2000,39000,-37000,-2000
20200520,3555,重鵬,28.00,28.00,27.15,28.00,-0.60,-2.1,4000,4,111150,0,0,0,0,0,0,0,0,0,0
20200520,3556,禾瑞亞,62.60,65.50,61.50,64.90,+3.50,5.7,4485000,2741,286638100,210000,78000,132000,0,0,0,0,0,0,132000
20200520,3558,神準,106.50,106.50,105.50,106.00,-0.50,-0.47,128000,105,13570000,3000,5000,-2000,0,0,0,0,0,0,-2000
20200520,3564,其陽,27.25,27.65,27.25,27.35,-0.20,-0.73,33000,10,909000,1000,0,1000,0,0,0,0,0,0,1000
20200520,3567,逸昌,24.80,24.90,24.70,24.80,-0.10,-0.4,73000,43,1809800,0,0,0,0,0,0,0,10000,-10000,-10000
20200520,3570,大塚,95.30,95.60,93.90,94.70,0.00,0.0,33000,29,3122800,4000,1000,3000,0,0,0,0,0,0,3000
20200520,3577,泓格,29.70,29.85,29.30,29.85,+0.05,0.17,9000,9,265950,0,0,0,0,0,0,0,0,0,0
20200520,3580,友威科,23.15,23.30,22.90,23.15,0.00,0.0,28000,28,646300,5000,2000,3000,0,0,0,0,0,0,3000
20200520,3581,博磊,14.40,14.40,14.30,14.40,+0.05,0.35,5000,5,71900,0,0,0,0,0,0,0,0,0,0
20200520,3587,閎康,73.50,76.40,73.50,75.80,+1.70,2.29,919000,566,69006500,113000,9000,104000,0,0,0,42000,23000,19000,123000
20200520,3594,磐儀,19.20,19.55,19.20,19.45,+0.10,0.52,110000,52,2134950,10000,1000,9000,0,0,0,0,0,0,9000
20200520,3597,映興,16.10,16.10,16.05,16.05,0.00,0.0,19000,16,305250,0,0,0,0,0,0,0,0,0,0
20200520,3609,東林,22.80,22.80,22.05,22.15,-0.05,-0.23,46000,29,1023950,3000,0,3000,0,0,0,0,0,0,3000
20200520,3611,鼎翰,189.50,191.50,189.50,191.00,+1.50,0.79,29000,28,5524500,13000,0,13000,0,0,0,0,0,0,13000
20200520,3615,安可,13.45,13.85,13.40,13.80,+0.30,2.22,172000,81,2341300,2000,0,2000,0,0,0,0,0,0,2000
20200520,3623,富晶通,16.00,16.00,15.65,15.75,0.00,0.0,8000,8,126150,0,0,0,0,0,0,0,0,0,0
20200520,3624,光頡,27.40,27.90,27.15,27.20,0.00,0.0,783000,513,21510050,60000,46000,14000,0,0,0,2000,10000,-8000,6000
20200520,3625,西勝,16.15,16.15,15.75,15.75,-0.25,-1.56,155000,122,2455850,0,16000,-16000,0,0,0,0,0,0,-16000
20200520,3628,盈正,31.95,31.95,31.30,31.80,-0.15,-0.47,16000,13,504650,0,0,0,0,0,0,0,0,0,0
20200520,3629,地心引力,59.00,59.00,58.00,58.00,-1.00,-1.69,6000,6,350000,0,0,0,0,0,0,0,0,0,0
20200520,3630,新鉅科,50.30,50.90,49.60,50.70,+0.85,1.71,1270000,802,63787450,196000,28000,168000,0,0,0,25000,16000,9000,177000
20200520,3631,晟楠,50.20,50.80,50.00,50.20,0.00,0.0,121000,71,6083200,12000,0,12000,0,0,0,0,0,0,12000
20200520,3632,研勤,9.98,9.98,9.56,9.75,+0.19,1.99,48000,40,465140,0,3000,-3000,0,0,0,0,0,0,-3000
20200520,3642,駿熠電,17.15,17.15,16.85,16.95,-0.05,-0.29,25000,15,424150,0,0,0,0,0,0,0,0,0,0
20200520,3646,艾恩特,15.20,15.25,14.85,15.10,+0.05,0.33,37000,25,556400,0,0,0,0,0,0,0,0,0,0
20200520,3652,精聯,14.65,14.65,14.40,14.60,0.00,0.0,14000,12,203150,0,0,0,0,0,0,0,0,0,0
20200520,3663,鑫科,18.30,18.50,18.30,18.50,+0.05,0.27,21000,13,385100,0,0,0,0,0,0,0,0,0,0
20200520,3664,安瑞-KY,12.35,12.50,12.20,12.40,+0.10,0.81,15000,12,186350,0,0,0,0,0,0,0,0,0,0
20200520,3666,光耀,15.40,15.40,15.25,15.25,-0.10,-0.65,17000,14,260300,0,0,0,0,0,0,0,0,0,0
20200520,3672,康聯訊,11.95,12.10,11.70,12.10,+0.10,0.83,18000,6,214950,0,0,0,0,0,0,0,0,0,0
20200520,3675,德微,44.30,44.50,44.20,44.25,-0.35,-0.78,20000,14,885750,3000,0,3000,0,0,0,0,0,0,3000
20200520,3680,家登,177.50,192.00,176.50,191.00,+14.50,8.22,9127000,6634,1695180500,318000,188000,130000,209000,0,209000,246000,15000,231000,570000
20200520,3684,榮昌,34.00,34.15,33.50,33.85,-0.35,-1.02,31000,25,1049000,1000,0,1000,0,0,0,0,0,0,1000
20200520,3685,元創精密,18.65,18.75,18.50,18.55,-0.25,-1.33,36000,28,669200,0,0,0,0,0,0,0,0,0,0
20200520,3687,歐買尬,41.70,42.05,41.15,41.20,0.00,0.0,244000,203,10118350,62000,12000,50000,0,0,0,0,0,0,50000
20200520,3689,湧德,23.10,23.50,23.10,23.15,-0.25,-1.07,46000,28,1072800,0,5000,-5000,0,0,0,0,0,0,-5000
20200520,3691,碩禾,91.00,92.00,90.00,92.00,+1.30,1.43,268000,216,24354500,138000,5000,133000,0,0,0,15000,18000,-3000,130000
20200520,3693,營邦,52.80,56.10,51.20,56.00,+4.90,9.59,1681000,1007,91561100,0,0,0,0,0,0,0,0,0,0
20200520,3707,漢磊,26.05,27.15,26.00,26.60,+0.80,3.1,16450000,7990,437936950,606000,495000,111000,0,0,0,152000,35000,117000,228000
20200520,3709,鑫聯大投控,21.30,21.30,21.25,21.25,+0.30,1.43,13000,10,276800,0,0,0,0,0,0,0,0,0,0
20200520,3710,連展投控,6.85,6.91,6.85,6.89,+0.04,0.58,112000,35,769490,7000,0,7000,0,0,0,0,0,0,7000
20200520,3713,新晶投控,13.80,13.80,13.30,13.35,-0.45,-3.26,121000,47,1631700,0,0,0,0,0,0,0,0,0,0
20200520,4102,永日,21.95,21.95,21.30,21.30,-0.35,-1.62,691000,385,14880500,49000,25000,24000,0,0,0,0,4000,-4000,20000
20200520,4105,東洋,75.20,75.20,74.20,74.90,-0.10,-0.13,523000,274,39006700,5000,44000,-39000,0,0,0,13000,9000,4000,-35000
20200520,4107,邦特,121.00,126.50,121.00,124.50,+4.50,3.75,1608000,1137,199158500,117000,98000,19000,30000,0,30000,34000,10000,24000,73000
20200520,4109,加捷生醫,16.85,17.05,16.40,16.50,-0.20,-1.2,307000,188,5083650,5000,6000,-1000,0,0,0,0,0,0,-1000
20200520,4111,濟生,30.30,30.35,28.50,28.70,-1.10,-3.69,2603000,1494,76741600,7000,85000,-78000,0,0,0,10000,0,10000,-68000
20200520,4113,聯上,12.30,12.45,12.20,12.30,0.00,0.0,202000,72,2480100,5000,2000,3000,0,0,0,0,0,0,3000
20200520,4114,健喬,24.00,24.00,23.70,23.90,0.00,0.0,365000,215,8711800,103000,5000,98000,0,0,0,0,0,0,98000
20200520,4116,明基醫,30.10,30.25,29.55,30.00,-0.10,-0.33,44000,33,1317200,3000,0,3000,0,0,0,2000,0,2000,5000
20200520,4120,友華,49.45,52.50,48.30,52.50,+3.50,7.14,1334000,1017,68689700,28000,49035,-21035,0,0,0,0,0,0,-21035
20200520,4121,優盛,20.75,21.50,20.45,20.65,+0.05,0.24,6085000,3217,128181300,582000,388000,194000,0,0,0,0,0,0,194000
20200520,4123,晟德,51.80,54.00,51.10,52.60,+1.30,2.53,5863000,3388,309813200,260000,682000,-422000,0,0,0,404000,35000,369000,-53000
20200520,4126,太醫,78.50,79.40,77.70,78.40,0.00,0.0,581000,414,45563800,108000,63000,45000,0,0,0,8000,2000,6000,51000
20200520,4127,天良,10.85,11.00,10.70,11.00,+0.20,1.85,191000,95,2076500,0,0,0,0,0,0,0,0,0,0
20200520,4128,中天,35.40,35.40,30.00,33.60,+1.40,4.35,28351000,14898,957427950,268000,607000,-339000,0,0,0,0,3000,-3000,-342000
20200520,4129,聯合,34.65,34.95,34.00,34.00,-0.60,-1.73,92000,77,3157100,2000,6000,-4000,0,0,0,0,0,0,-4000
20200520,4129A,聯合甲特,48.30,48.30,48.10,48.10,-0.15,-0.31,19000,9,916450,0,0,0,0,0,0,0,0,0,0
20200520,4130,健亞,27.65,29.80,27.45,29.10,+1.45,5.24,5121000,3029,148150250,268000,230000,38000,0,0,0,0,0,0,38000
20200520,4131,晶宇,4.79,4.79,4.69,4.69,+0.32,7.32,9000,5,42310,0,0,0,0,0,0,0,0,0,0
20200520,4138,曜亞,49.30,49.30,48.70,48.85,-0.10,-0.2,57000,42,2784000,0,0,0,0,0,0,0,0,0,0
20200520,4139,馬光-KY,42.20,43.20,42.20,43.20,+1.00,2.37,176000,117,7527850,1000,10000,-9000,0,0,0,0,0,0,-9000
20200520,4147,中裕,92.00,92.20,90.00,90.00,-1.60,-1.75,759000,615,68770300,122700,62000,60700,0,120000,-120000,0,0,0,-59300
20200520,4152,台微體,70.10,71.00,70.10,70.80,+0.30,0.43,32000,27,2252400,2000,0,2000,0,0,0,0,0,0,2000
20200520,4153,鈺緯,26.80,27.00,26.65,27.00,+0.20,0.75,67000,36,1798200,0,0,0,0,0,0,0,0,0,0
20200520,4154,康樂-KY,40.00,40.00,35.00,37.00,-1.60,-4.15,440000,270,16580300,7000,4000,3000,0,0,0,2000,0,2000,5000
20200520,4157,太景*-KY,19.15,19.40,18.65,18.70,-0.55,-2.86,4123000,1996,78229550,227000,221000,6000,0,0,0,67000,29000,38000,44000
20200520,4160,創源,35.60,35.60,33.50,33.80,-1.70,-4.79,912000,560,31096950,0,19000,-19000,0,0,0,2000,0,2000,-17000
20200520,4161,聿新科,29.70,29.80,29.45,29.70,0.00,0.0,47000,35,1391600,6000,0,6000,0,0,0,0,0,0,6000
20200520,4162,智擎,56.50,56.50,55.00,55.10,-0.30,-0.54,851000,468,47492900,117000,51000,66000,0,0,0,2000,1000,1000,67000
20200520,4163,鐿鈦,125.00,126.00,124.00,125.00,+0.50,0.4,122000,97,15279000,21000,0,21000,0,0,0,0,0,0,21000
20200520,4167,展旺,26.40,27.25,26.25,26.65,+0.30,1.14,6995000,3388,186793850,348000,226000,122000,0,0,0,100000,0,100000,222000
20200520,4168,醣聯,22.50,23.40,20.60,20.85,-1.85,-8.15,1215000,735,26864400,3000,2000,1000,0,0,0,4000,34000,-30000,-29000
20200520,4171,瑞基,271.00,295.00,271.00,295.00,+23.50,8.66,409000,291,117081500,2000,58000,-56000,0,0,0,21000,21000,0,-56000
20200520,4173,久裕,19.65,19.65,19.20,19.25,-0.40,-2.04,922000,570,17821050,39000,32000,7000,0,0,0,0,58000,-58000,-51000
20200520,4174,浩鼎,94.30,94.80,93.80,94.10,-0.30,-0.32,254000,219,23917300,36000,0,36000,0,0,0,0,0,0,36000
20200520,4175,杏一,73.90,75.40,73.90,75.00,+1.20,1.63,114000,89,8500000,9000,0,9000,0,0,0,0,0,0,9000
20200520,4183,福永生技,18.30,18.50,18.15,18.25,-0.45,-2.41,12000,12,220450,0,0,0,0,0,0,0,0,0,0
20200520,4188,安克,19.40,19.40,18.60,18.70,-0.30,-1.58,98000,59,1837950,0,0,0,0,0,0,0,0,0,0
20200520,4192,杏國,32.10,32.30,31.00,31.90,-0.25,-0.78,112000,81,3536300,0,7000,-7000,0,0,0,0,0,0,-7000
20200520,4198,環瑞醫,4.98,4.98,4.49,4.55,-0.43,-8.63,1111000,231,5079130,0,0,0,0,0,0,0,0,0,0
20200520,4205,中華食,89.90,89.90,89.40,89.60,-0.40,-0.44,12000,12,1074700,0,0,0,0,0,0,0,0,0,0
20200520,4207,環泰,11.00,11.00,10.65,10.80,-0.10,-0.92,292000,75,3148500,0,0,0,0,0,0,0,0,0,0
20200520,4303,信立,18.15,18.80,18.15,18.65,+0.25,1.36,40000,20,746950,0,0,0,0,0,0,0,0,0,0
20200520,4304,勝昱,4.53,5.37,4.49,4.49,-0.49,-9.84,7000,5,32510,0,0,0,0,0,0,0,0,0,0
20200520,4305,世坤,34.00,34.30,34.00,34.30,+0.25,0.73,12000,11,409600,0,0,0,0,0,0,0,0,0,0
20200520,4401,東隆興,24.75,27.20,24.60,26.05,+1.25,5.04,1019000,493,26694000,36000,114000,-78000,0,0,0,0,1000,-1000,-79000
20200520,4402,福大,5.14,5.15,5.02,5.02,+0.02,0.4,23000,10,116940,0,0,0,0,0,0,0,0,0,0
20200520,4406,新昕纖,8.61,8.61,8.53,8.55,0.00,0.0,9000,7,76910,0,0,0,0,0,0,0,0,0,0
20200520,4413,飛寶企業,12.35,12.65,12.35,12.60,+0.10,0.8,12000,11,150050,0,0,0,0,0,0,0,0,0,0
20200520,4416,三圓,,,,,,0.00,0,0,0,0,0,0,0,0,0,0,0,0,0
20200520,4417,金洲,30.50,30.60,30.35,30.60,+0.05,0.16,68000,39,2072450,2000,13000,-11000,0,0,0,0,0,0,-11000
20200520,4419,元勝,,,,,,0.00,0,0,0,0,0,0,0,0,0,0,0,0,0
20200520,4420,光明,23.90,24.00,23.90,24.00,+0.20,0.84,27000,17,647500,0,1000,-1000,0,0,0,0,0,0,-1000
20200520,4429,聚紡,,,,,,0.00,0,0,0,0,0,0,0,0,0,0,0,0,0
20200520,4430,耀億,23.85,24.05,23.70,24.05,+0.10,0.42,33000,28,787350,1000,0,1000,0,0,0,0,0,0,1000
20200520,4432,銘旺實,11.75,12.40,11.75,12.20,+0.35,2.95,97000,53,1166650,7000,0,7000,0,0,0,0,0,0,7000
20200520,4433,興采,30.35,30.35,29.70,29.90,-0.30,-0.99,39000,35,1167550,2000,3000,-1000,0,0,0,0,0,0,-1000
20200520,4502,健信,53.30,53.60,52.20,52.40,-0.90,-1.69,36000,34,1904300,2000,0,2000,0,0,0,0,0,0,2000
20200520,4503,金雨,15.90,17.05,15.90,17.05,+1.55,10.0,400000,137,6730600,7000,0,7000,0,0,0,0,0,0,7000
20200520,4506,崇友,57.60,58.80,57.30,57.30,-0.50,-0.87,50000,32,2897600,28000,17000,11000,0,0,0,7000,0,7000,18000
20200520,4510,高鋒,9.85,9.90,9.81,9.88,+0.03,0.3,113000,11,1115360,0,0,0,0,0,0,0,0,0,0
20200520,4513,福裕,7.45,7.46,7.29,7.29,-0.22,-2.93,103000,47,755990,0,0,0,0,0,0,0,0,0,0
20200520,4523,永彰,20.85,20.95,20.75,20.95,+0.05,0.24,12000,12,249450,0,0,0,0,0,0,0,0,0,0
20200520,4527,方土霖,25.50,25.50,25.30,25.30,-0.20,-0.78,32000,14,812000,0,3000,-3000,0,0,0,0,0,0,-3000
20200520,4528,江興鍛,39.20,40.60,39.10,39.55,+0.70,1.8,114000,87,4537650,1000,12000,-11000,0,0,0,0,0,0,-11000
20200520,4529,淳紳,8.81,9.38,8.80,9.05,+0.13,1.46,48000,36,434120,4000,0,4000,0,0,0,0,0,0,4000
20200520,4530,宏易,10.95,10.95,10.95,10.95,-0.05,-0.45,5000,2,54750,0,0,0,0,0,0,0,0,0,0
20200520,4533,協易機,10.80,10.85,10.75,10.85,+0.05,0.46,71000,4,766900,0,0,0,0,0,0,0,0,0,0
20200520,4534,慶騰,7.33,7.40,7.31,7.40,-0.10,-1.33,81000,34,595990,2000,0,2000,0,0,0,0,0,0,2000
20200520,4535,至興,23.90,24.50,23.90,24.00,-0.15,-0.62,6000,4,144600,0,0,0,0,0,0,0,0,0,0
20200520,4538,大詠城,,,,,,0.00,0,0,0,0,0,0,0,0,0,0,0,0,0
20200520,4541,晟田,18.10,18.10,17.95,17.95,-0.15,-0.83,22000,17,396650,0,0,0,0,0,0,0,0,0,0
20200520,4542,科嶠,23.50,23.80,22.80,23.40,0.00,0.0,11000,9,255400,0,0,0,0,0,0,0,0,0,0
20200520,4543,萬在,15.30,15.50,15.25,15.50,+0.20,1.31,77000,22,1185850,2000,0,2000,0,0,0,0,0,0,2000
20200520,4549,桓達,72.10,73.90,71.80,73.10,+1.30,1.81,105000,92,7656100,31000,10000,21000,0,0,0,0,11000,-11000,10000
20200520,4550,長佳,25.30,25.30,25.20,25.25,0.00,0.0,46000,33,1160600,0,2000,-2000,0,0,0,0,0,0,-2000
20200520,4554,橙的,19.00,19.30,18.95,18.95,-0.35,-1.81,18000,15,342450,0,0,0,0,0,0,0,0,0,0
20200520,4556,旭然,33.95,34.00,33.95,34.00,+0.05,0.15,3000,3,101900,0,0,0,0,0,0,0,0,0,0
20200520,4561,健椿,25.00,25.40,24.80,25.20,+0.20,0.8,32000,19,801950,0,0,0,0,0,0,0,0,0,0
20200520,4563,百德,35.10,35.60,35.05,35.50,-0.15,-0.42,36000,26,1266350,4000,0,4000,0,0,0,0,1000,-1000,3000
20200520,4568,科際精密,56.80,56.80,55.50,56.70,+0.30,0.53,3000,3,169000,0,0,0,0,0,0,0,0,0,0
20200520,4580,捷流閥業,99.50,99.50,98.10,98.30,-1.20,-1.21,197000,159,19411400,0,7000,-7000,0,0,0,0,0,0,-7000
20200520,4609,唐鋒,8.38,8.80,8.38,8.71,+0.21,2.47,35000,14,305110,0,10000,-10000,0,0,0,0,0,0,-10000
20200520,4702,中美實,10.20,10.20,9.83,9.98,-0.07,-0.7,76000,47,753830,0,1000,-1000,0,0,0,0,0,0,-1000
20200520,4706,大恭,16.35,16.45,16.10,16.10,0.00,0.0,30000,20,485950,0,0,0,0,0,0,0,0,0,0
20200520,4707,磐亞,11.65,11.65,11.50,11.55,0.00,0.0,1631000,559,18810600,18000,8000,10000,0,0,0,0,6000,-6000,4000
20200520,4711,永純,13.70,13.75,13.55,13.60,0.00,0.0,19000,13,259000,0,0,0,0,0,0,0,0,0,0
20200520,4712,南璋,6.64,7.00,6.42,6.80,+0.39,6.08,72000,43,490960,0,1000,-1000,0,0,0,0,0,0,-1000
20200520,4714,永捷,14.20,14.20,14.00,14.15,+0.05,0.35,499000,202,7022950,54000,8000,46000,0,0,0,0,0,0,46000
20200520,4716,大立,14.15,14.15,13.95,13.95,-0.20,-1.41,168000,67,2353900,0,0,0,0,0,0,0,0,0,0
20200520,4721,美琪瑪,51.90,52.00,50.60,50.90,-1.10,-2.12,198000,168,10121900,34000,15000,19000,0,0,0,0,1000,-1000,18000
20200520,4726,永昕,30.55,32.50,28.30,30.95,+0.40,1.31,5385000,2968,163715950,369000,39000,330000,0,0,0,62000,24000,38000,368000
20200520,4728,雙美,77.10,78.70,76.60,76.90,+0.20,0.26,336000,293,26019700,15000,17000,-2000,0,0,0,19000,17000,2000,0
20200520,4729,熒茂,16.50,17.25,15.70,17.25,+1.25,7.81,2093000,1134,35015950,32000,19000,13000,0,0,0,0,0,0,13000
20200520,4735,豪展,73.80,75.30,73.10,74.70,+2.70,3.75,2252000,1508,167148800,332000,62000,270000,0,0,0,69000,4000,65000,335000
20200520,4736,泰博,265.00,273.50,260.50,271.50,+15.00,5.85,2148000,1625,575738000,307000,303093,3907,0,37000,-37000,55000,41000,14000,-19093
20200520,4741,泓瀚,26.00,26.50,25.70,25.70,+0.10,0.39,100000,72,2604850,0,2000,-2000,0,0,0,0,0,0,-2000
20200520,4743,合一,127.00,127.00,118.00,127.00,+11.50,9.96,17911000,9954,2243098500,215000,83000,132000,0,0,0,0,8000,-8000,124000
20200520,4744,皇將,36.20,36.30,35.80,36.00,-0.15,-0.41,88000,55,3164900,18000,0,18000,0,0,0,0,1000,-1000,17000
20200520,4745,合富-KY,33.80,34.00,33.25,33.35,-0.35,-1.04,67000,56,2253300,0,3000,-3000,0,0,0,0,0,0,-3000
20200520,4747,強生,41.60,43.30,41.60,42.50,+0.95,2.29,232000,185,9874600,13000,0,13000,0,0,0,0,1000,-1000,12000
20200520,4754,國碳科,55.20,55.20,55.00,55.10,-0.20,-0.36,10000,8,550700,0,0,0,0,0,0,0,0,0,0
20200520,4760,勤凱,76.40,80.90,75.80,80.60,+5.00,6.61,681000,556,53990300,30000,42000,-12000,0,0,0,0,5000,-5000,-17000
20200520,4767,誠泰科技,23.50,23.50,23.50,23.50,+0.50,2.17,5000,3,117500,0,0,0,0,0,0,0,0,0,0
20200520,4803,VHQ-KY,68.70,70.50,68.70,70.40,+1.70,2.47,377000,309,26308100,21000,61000,-40000,0,0,0,2000,6000,-4000,-44000
20200520,4804,大略-KY,9.35,9.35,9.11,9.24,-0.01,-0.11,30000,25,276530,0,0,0,0,0,0,2000,0,2000,2000
20200520,4806,昇華,7.40,8.45,7.40,8.12,+0.02,0.25,9000,8,71850,0,0,0,0,0,0,0,0,0,0
20200520,4903,聯光通,13.60,14.20,13.50,14.00,+0.50,3.7,211000,79,2947500,34000,0,34000,0,0,0,0,0,0,34000
20200520,4905,台聯電,49.50,49.50,49.50,49.50,0.00,0.0,33000,13,1633500,0,0,0,0,0,0,0,0,0,0
20200520,4907,富宇,24.95,25.00,24.90,24.90,0.00,0.0,37000,20,922300,0,0,0,0,0,0,0,0,0,0
20200520,4908,前鼎,37.40,38.10,37.25,37.50,+0.50,1.35,937000,571,35264550,74000,37000,37000,0,0,0,15000,10000,5000,42000
20200520,4909,新復興,14.80,14.95,14.65,14.85,+0.05,0.34,148000,68,2187900,3000,2000,1000,0,0,0,0,0,0,1000
20200520,4911,德英,30.70,30.70,30.00,30.00,-0.75,-2.44,17000,17,513150,0,0,0,0,0,0,0,0,0,0
20200520,4924,欣厚-KY,6.55,7.00,6.55,6.89,+0.29,4.39,369000,106,2489310,213000,189000,24000,0,0,0,0,0,0,24000
20200520,4931,新盛力,31.70,31.80,30.90,31.15,+0.05,0.16,93000,66,2900200,10000,0,10000,0,0,0,0,0,0,10000
20200520,4933,友輝,21.20,21.20,21.05,21.05,-0.05,-0.24,39000,18,823350,0,1000,-1000,0,0,0,0,0,0,-1000
20200520,4939,亞電,13.95,14.85,13.90,13.90,+0.05,0.36,1986000,1078,28546750,19000,106000,-87000,0,0,0,0,0,0,-87000
20200520,4944,兆遠,8.88,8.88,8.64,8.70,-0.17,-1.92,99000,39,866790,0,0,0,0,0,0,1000,0,1000,1000
20200520,4946,辣椒,16.65,16.65,16.65,16.65,-1.80,-9.76,64000,38,1065600,0,0,0,0,0,0,0,0,0,0
20200520,4947,昂寶-KY,228.50,229.00,228.50,228.50,0.00,0.0,71000,51,16230500,14000,4000,10000,0,0,0,0,299,-299,9701
20200520,4950,牧東,,,,,,0.00,0,0,0,0,0,0,0,0,0,0,0,0,0
20200520,4953,緯軟,73.90,75.50,73.80,74.90,+1.10,1.49,387000,330,28889300,98000,25000,73000,0,0,0,4000,0,4000,77000
20200520,4966,譜瑞-KY,887.00,901.00,860.00,878.00,+2.00,0.23,1152000,1068,1015484000,258000,311416,-53416,5000,31000,-26000,29000,21000,8000,-71416
20200520,4971,IET-KY,56.50,57.20,55.80,55.80,-1.30,-2.28,168000,148,9470300,4000,23000,-19000,0,0,0,0,0,0,-19000
20200520,4972,湯石照明,30.10,30.15,29.90,30.10,0.00,0.0,34000,23,1020900,1000,0,1000,0,0,0,0,0,0,1000
20200520,4973,廣穎,24.20,24.60,23.90,24.45,+0.55,2.3,1080000,633,26176950,56000,202000,-146000,0,0,0,0,3000,-3000,-149000
20200520,4974,亞泰,52.90,53.50,52.60,53.20,+0.60,1.14,327000,223,17340600,99000,0,99000,0,0,0,0,0,0,99000
20200520,4979,華星光,21.30,22.10,21.05,21.75,+0.70,3.33,1331000,751,28649250,255000,16000,239000,0,0,0,0,0,0,239000
20200520,4987,科誠,48.30,48.30,47.00,47.20,-0.95,-1.97,93000,68,4397150,0,0,0,0,0,0,0,0,0,0
20200520,4991,環宇-KY,52.40,53.60,52.40,52.70,+0.90,1.74,763000,649,40516400,53000,183000,-130000,0,0,0,20000,0,20000,-110000
20200520,4995,晶達,45.25,45.30,44.40,45.10,0.00,0.0,112000,64,5004850,0,0,0,0,0,0,0,0,0,0
20200520,5009,榮剛,16.50,16.65,16.40,16.55,-0.05,-0.3,684000,199,11309800,8000,48000,-40000,0,0,0,41000,0,41000,1000
20200520,5011,久陽,15.10,15.20,15.10,15.20,0.00,0.0,30000,5,454500,0,0,0,0,0,0,0,0,0,0
20200520,5013,強新,23.60,23.60,23.40,23.40,-0.80,-3.31,9000,5,210900,0,0,0,0,0,0,0,0,0,0
20200520,5014,建錩,8.07,8.07,8.01,8.01,-0.05,-0.62,93000,39,747130,0,0,0,0,0,0,0,0,0,0
20200520,5015,華祺,35.85,35.85,35.50,35.65,+0.10,0.28,10000,10,356000,1000,0,1000,0,0,0,0,0,0,1000
20200520,5016,松和,27.95,28.10,27.95,28.10,-0.10,-0.35,16000,7,449050,0,0,0,0,0,0,0,0,0,0
20200520,5102,富強,15.45,15.60,15.45,15.50,0.00,0.0,25000,14,387500,0,0,0,0,0,0,0,0,0,0
20200520,5201,凱衛,32.30,32.85,31.90,32.25,-0.05,-0.15,32000,23,1026950,4000,0,4000,0,0,0,0,0,0,4000
20200520,5202,力新,15.20,16.30,14.85,15.25,+0.40,2.69,334000,144,5234850,0,0,0,0,0,0,0,0,0,0
20200520,5205,中茂,5.70,5.79,5.70,5.79,0.00,0.0,5000,2,28860,0,0,0,0,0,0,0,0,0,0
20200520,5206,坤悅,15.00,15.00,14.95,15.00,+0.10,0.67,74000,37,1107500,10000,0,10000,0,0,0,0,0,0,10000
20200520,5209,新鼎,61.80,62.60,61.50,62.00,-0.70,-1.12,77000,70,4778200,15000,0,15000,0,0,0,0,0,0,15000
20200520,5210,寶碩,6.44,6.50,6.33,6.45,+0.08,1.26,48000,35,308160,0,0,0,0,0,0,0,0,0,0
20200520,5211,蒙恬,13.90,13.90,13.10,13.50,-0.40,-2.88,106000,45,1432500,0,1000,-1000,0,0,0,1000,0,1000,0
20200520,5212,凌網,48.30,48.35,47.55,47.55,-1.05,-2.16,98000,88,4685600,15000,2000,13000,0,0,0,0,0,0,13000
20200520,5213,亞昕,14.85,14.85,14.70,14.70,-0.15,-1.01,117000,41,1727850,1000,0,1000,0,0,0,0,0,0,1000
20200520,5220,萬達光電,30.15,31.10,30.05,31.00,+1.90,6.53,509000,321,15620000,7000,7000,0,0,0,0,0,0,0,0
20200520,5223,安力-KY,34.10,35.30,33.65,34.50,+0.60,1.77,116000,72,3958850,18000,4000,14000,0,0,0,6000,0,6000,20000
20200520,5227,立凱-KY,9.20,9.21,9.00,9.02,-0.13,-1.42,654000,248,5922650,83000,0,83000,0,0,0,0,0,0,83000
20200520,5230,雷笛克光學,23.10,23.10,22.30,22.50,-0.40,-1.75,27000,27,606550,0,0,0,0,0,0,0,0,0,0
20200520,5245,智晶,33.70,35.75,33.20,35.30,+2.10,6.33,870000,706,30357150,42000,27000,15000,0,0,0,0,0,0,15000
20200520,5251,天鉞電,13.15,13.40,13.15,13.40,+0.25,1.9,193000,76,2562150,1000,0,1000,0,0,0,0,0,0,1000
20200520,5263,智崴,117.00,118.50,116.00,116.50,-0.50,-0.43,87000,76,10169000,2000,2000,0,0,0,0,0,0,0,0
20200520,5272,笙科,18.35,18.45,18.10,18.15,-0.20,-1.09,86000,46,1568400,8000,0,8000,0,0,0,0,0,0,8000
20200520,5274,信驊,1430.00,1440.00,1335.00,1335.00,-45.00,-3.26,543000,523,758605000,75840,158000,-82160,0,0,0,6000,15000,-9000,-91160
20200520,5276,達輝-KY,8.80,8.80,8.51,8.70,-0.35,-3.87,80000,35,687330,1000,0,1000,0,0,0,0,0,0,1000
20200520,5278,尚凡,125.00,128.00,124.50,126.50,+3.00,2.43,60000,50,7572000,14000,0,14000,0,0,0,0,0,0,14000
20200520,5281,大峽谷-KY,22.50,22.90,22.50,22.90,+0.40,1.78,8000,6,180850,0,0,0,0,0,0,0,0,0,0
20200520,5287,數字,228.50,229.00,224.50,229.00,+5.50,2.46,44000,44,10004000,15000,7000,8000,0,0,0,0,0,0,8000
20200520,5289,宜鼎,184.50,188.00,183.00,188.00,+4.50,2.45,959000,702,178586000,398000,60000,338000,0,0,0,47000,24000,23000,361000
20200520,5291,邑昇,21.80,22.20,21.65,22.20,+0.35,1.6,162000,87,3550000,19000,12000,7000,0,0,0,0,0,0,7000
20200520,5299,杰力,115.00,118.00,114.50,118.00,+3.00,2.61,1855000,1274,216148000,90000,158000,-68000,0,0,0,108000,22000,86000,18000
20200520,5301,寶得利,8.86,8.86,8.65,8.65,-0.09,-1.03,11000,5,95740,0,0,0,0,0,0,0,0,0,0
20200520,5302,太欣,5.48,5.48,5.29,5.38,-0.11,-2.0,159000,85,853910,0,12000,-12000,0,0,0,0,0,0,-12000
20200520,5304,鼎創達,2.28,2.37,2.28,2.30,-0.08,-3.36,14000,4,32210,0,0,0,0,0,0,0,0,0,0
20200520,5306,桂盟,106.00,113.00,105.50,108.50,+5.00,4.83,2419000,1873,263893500,252001,36000,216001,258000,0,258000,0,1000,-1000,473001
20200520,5309,系統電,26.10,26.20,25.10,25.15,-0.80,-3.08,3628000,1687,92368350,65000,340000,-275000,0,0,0,0,0,0,-275000
20200520,5310,天剛,12.40,13.35,12.40,13.35,+1.20,9.88,81000,44,1055550,0,0,0,0,0,0,0,0,0,0
20200520,5312,寶島科,63.80,63.90,63.40,63.40,-0.30,-0.47,28000,27,1782400,0,0,0,0,0,0,0,0,0,0
20200520,5314,世紀,3.78,3.95,3.78,3.90,+0.08,2.09,16000,9,62470,0,0,0,0,0,0,0,0,0,0
20200520,5315,光聯,13.40,13.45,13.30,13.40,-0.05,-0.37,80000,32,1069350,29000,4000,25000,0,0,0,0,0,0,25000
20200520,5321,友銓,21.30,21.80,21.20,21.70,+0.30,1.4,33000,24,714300,4000,0,4000,0,0,0,0,0,0,4000
20200520,5324,士開,8.28,8.28,8.18,8.26,+0.02,0.24,19000,17,155960,0,0,0,0,0,0,0,0,0,0
20200520,5328,華容,8.38,8.50,8.13,8.31,+0.04,0.48,588000,317,4897170,27000,10000,17000,0,0,0,0,0,0,17000
20200520,5340,建榮,41.75,42.70,41.10,41.10,-0.15,-0.36,398000,277,16578850,44000,61000,-17000,0,0,0,8000,0,8000,-9000
20200520,5344,立衛,9.87,9.87,9.40,9.40,-0.47,-4.76,178000,67,1708090,0,6000,-6000,0,0,0,0,0,0,-6000
20200520,5345,天揚,5.21,5.21,5.21,5.21,-0.09,-1.7,7000,4,36470,0,0,0,0,0,0,0,0,0,0
20200520,5347,世界,68.70,69.20,67.90,68.40,-0.10,-0.15,3343000,1433,228635700,889000,2155000,-1266000,0,454000,-454000,88000,31000,57000,-1663000
20200520,5348,系通,6.20,6.20,6.20,6.20,0.00,0.0,1000,1,6200,0,0,0,0,0,0,0,0,0,0
20200520,5349,先豐,20.45,20.95,20.45,20.90,+0.55,2.7,771000,419,16004050,244000,3000,241000,0,0,0,2000,2000,0,241000
20200520,5351,鈺創,6.26,6.32,6.17,6.20,+0.03,0.49,958000,259,5971950,150000,66000,84000,0,0,0,0,0,0,84000
20200520,5353,台林,17.30,17.35,17.20,17.30,0.00,0.0,24000,15,414950,0,0,0,0,0,0,0,0,0,0
20200520,5355,佳總,4.38,4.38,4.33,4.38,-0.01,-0.23,11000,8,47990,0,0,0,0,0,0,0,0,0,0
20200520,5356,協益,28.90,28.95,28.50,28.55,+0.05,0.18,61000,49,1750000,6000,18000,-12000,0,0,0,0,0,0,-12000
20200520,5364,力麗店,,,,,,0.00,0,0,0,0,0,0,0,0,0,0,0,0,0
20200520,5371,中光電,31.10,31.15,30.90,30.90,+0.10,0.32,578000,364,17906350,88000,264752,-176752,0,0,0,0,0,0,-176752
20200520,5381,合正,2.99,3.00,2.99,3.00,0.00,0.0,6000,5,17990,0,0,0,0,0,0,0,0,0,0
20200520,5383,金利,22.20,22.70,21.60,22.50,-0.50,-2.17,206000,118,4567350,14000,9000,5000,0,0,0,0,0,0,5000
20200520,5386,青雲,29.50,29.80,29.10,29.25,0.00,0.0,136000,89,3985150,10000,0,10000,0,0,0,0,2000,-2000,8000
20200520,5392,應華,24.50,25.50,24.20,25.00,+0.75,3.09,867000,442,21611750,53000,56000,-3000,0,0,0,2000,0,2000,-1000
20200520,5398,慕康生醫,25.50,25.80,25.50,25.55,+0.15,0.59,35000,20,899100,0,10000,-10000,0,0,0,0,0,0,-10000
20200520,5403,中菲,47.45,47.45,47.05,47.15,-0.30,-0.63,203000,110,9573850,0,14000,-14000,0,0,0,0,66000,-66000,-80000
20200520,5410,國眾,20.70,20.75,20.50,20.70,+0.10,0.49,291000,132,6008800,23000,0,23000,0,0,0,0,0,0,23000
20200520,5425,台半,37.95,38.35,37.50,37.60,+0.10,0.27,545000,397,20618300,101000,48000,53000,0,0,0,37000,91000,-54000,-1000
20200520,5426,振發,10.10,10.10,9.92,9.94,-0.11,-1.09,82000,29,820100,0,0,0,0,0,0,0,0,0,0
20200520,5432,達威,15.90,16.05,15.70,15.95,+0.25,1.59,22000,19,350300,0,0,0,0,0,0,0,0,0,0
20200520,5438,東友,12.30,12.30,11.85,11.95,-0.35,-2.85,458000,198,5498500,0,0,0,0,0,0,0,0,0,0
20200520,5439,高技,45.30,46.40,45.30,46.30,+1.15,2.55,1033000,671,47614200,286000,4000,282000,50000,0,50000,62000,0,62000,394000
20200520,5443,均豪,18.60,19.60,18.60,19.30,+0.70,3.76,1320000,599,25260650,75000,6000,69000,0,0,0,9000,0,9000,78000
20200520,5450,寶聯通,15.05,15.05,14.15,14.80,-0.10,-0.67,34000,17,493450,0,0,0,0,0,0,0,0,0,0
20200520,5452,佶優,6.20,6.20,6.15,6.20,-0.04,-0.64,51000,21,314570,0,0,0,0,0,0,0,0,0,0
20200520,5455,昇益,18.05,18.05,17.15,17.50,-0.65,-3.58,6000,6,104800,0,0,0,0,0,0,0,0,0,0
20200520,5457,宣德,74.20,76.00,73.50,76.00,+1.80,2.43,1795000,1173,134421100,332000,192000,140000,221000,0,221000,89000,67000,22000,383000
20200520,5460,同協,10.75,10.75,10.65,10.75,0.00,0.0,52000,24,556700,0,0,0,0,0,0,0,0,0,0
20200520,5464,霖宏,11.15,11.15,11.00,11.10,+0.05,0.45,97000,29,1070800,0,0,0,0,0,0,0,0,0,0
20200520,5465,富驊,16.75,16.80,15.65,16.65,-0.05,-0.3,547000,260,8873900,5000,0,5000,0,0,0,10000,0,10000,15000
20200520,5468,凱鈺,10.30,11.10,9.96,11.10,+0.80,7.77,3000,3,31360,0,0,0,0,0,0,0,0,0,0
20200520,5474,聰泰,91.70,92.90,90.60,91.50,+0.10,0.11,258000,209,23558000,11000,5000,6000,0,0,0,0,0,0,6000
20200520,5475,德宏,2.11,2.19,2.11,2.18,-0.01,-0.46,59000,21,127180,0,0,0,0,0,0,0,0,0,0
20200520,5478,智冠,116.00,119.00,112.50,116.50,+4.50,4.02,2530000,1937,293470500,163000,149000,14000,50000,55000,-5000,76000,5000,71000,80000
20200520,5481,新華,12.60,12.60,12.35,12.45,0.00,0.0,188000,22,2340850,0,4000,-4000,0,0,0,0,0,0,-4000
20200520,5483,中美晶,88.80,89.00,87.70,88.00,-0.50,-0.56,5820000,3969,512845500,227000,1424000,-1197000,0,0,0,56000,222000,-166000,-1363000
20200520,5487,通泰,30.45,30.60,30.00,30.60,+0.30,0.99,32000,26,965250,0,0,0,0,0,0,0,0,0,0
20200520,5488,松普,5.18,5.26,5.15,5.20,0.00,0.0,100000,42,519010,1000,0,1000,0,0,0,0,0,0,1000
20200520,5489,彩富,32.30,32.35,32.30,32.35,-0.05,-0.15,8000,8,258550,0,0,0,0,0,0,0,0,0,0
20200520,5490,同亨,25.20,25.40,25.20,25.20,0.00,0.0,110000,69,2779450,10000,2000,8000,0,0,0,0,1000,-1000,7000
20200520,5493,三聯,38.10,38.50,38.10,38.10,+0.10,0.26,98000,59,3748700,12000,1000,11000,0,0,0,0,0,0,11000
20200520,5498,凱崴,11.70,11.70,11.35,11.65,+0.15,1.3,1266000,403,14565450,36000,38000,-2000,0,0,0,0,0,0,-2000
20200520,5508,永信建,31.65,31.75,31.50,31.60,-0.05,-0.16,73000,37,2310800,1000,1000,0,0,0,0,0,0,0,0
20200520,5511,德昌,29.10,29.10,29.05,29.10,0.00,0.0,39000,34,1134050,9000,7000,2000,0,0,0,0,0,0,2000
20200520,5512,力麒,9.33,9.36,9.25,9.31,-0.02,-0.21,303000,115,2819130,8000,55000,-47000,0,0,0,0,0,0,-47000
20200520,5514,三豐,18.95,19.05,18.95,19.05,-0.25,-1.3,10000,4,189950,0,0,0,0,0,0,0,0,0,0
20200520,5516,雙喜,14.60,14.60,14.30,14.40,+0.15,1.05,27000,10,390100,0,1000,-1000,0,0,0,0,0,0,-1000
20200520,5520,力泰,36.50,36.50,36.50,36.50,+0.40,1.11,1000,1,36500,0,0,0,0,0,0,0,0,0,0
20200520,5523,豐謙,10.40,10.85,10.30,10.85,+0.35,3.33,44000,18,460100,0,0,0,0,0,0,0,0,0,0
20200520,5529,志嘉,6.60,6.74,6.60,6.65,+0.05,0.76,179000,63,1188820,0,27000,-27000,0,0,0,0,0,0,-27000
20200520,5530,龍巖,57.20,57.20,56.50,56.90,-0.20,-0.35,138000,102,7845500,9000,44000,-35000,0,0,0,0,0,0,-35000
20200520,5536,聖暉,210.00,210.00,207.00,208.00,-2.00,-0.95,242000,207,50400000,18000,83000,-65000,0,0,0,1000,1000,0,-65000
20200520,5543,崇佑-KY,20.00,20.00,20.00,20.00,0.00,0.0,6000,2,120000,0,0,0,0,0,0,0,0,0,0
20200520,5601,台聯櫃,,,,,,0.00,0,0,0,0,0,0,0,0,0,0,0,0,0
20200520,5603,陸海,9.74,9.74,9.42,9.63,-0.04,-0.41,172000,30,1653830,0,0,0,0,0,0,0,0,0,0
20200520,5604,中連貨,57.30,57.30,56.20,56.30,-0.90,-1.57,233000,184,13184800,2000,1000,1000,0,0,0,0,0,0,1000
20200520,5609,中菲行,29.15,29.25,29.00,29.20,+0.10,0.34,885000,400,25758850,109000,3000,106000,0,0,0,0,13000,-13000,93000
20200520,5701,劍湖山,1.60,1.68,1.60,1.67,-0.01,-0.6,245000,31,394070,0,0,0,0,0,0,0,0,0,0
20200520,5703,亞都,,,,,,0.00,0,0,0,0,0,0,0,0,0,0,0,0,0
20200520,5704,老爺知,23.50,23.50,23.50,23.50,-0.40,-1.67,1000,1,23500,0,0,0,0,0,0,0,0,0,0
20200520,5820,日盛金,9.30,9.32,9.26,9.30,0.00,0.0,783000,244,7272990,127000,165000,-38000,0,0,0,0,60000,-60000,-98000
20200520,5864,致和證,8.20,8.22,8.08,8.10,,0.00,677000,230,5521510,0,2000,-2000,0,0,0,0,0,0,-2000
20200520,5878,台名,46.40,46.80,46.40,46.70,+0.30,0.65,18000,15,840400,0,0,0,0,0,0,0,0,0,0
20200520,5902,德記,11.15,11.50,11.15,11.30,+0.15,1.35,33000,19,373500,0,0,0,0,0,0,0,0,0,0
20200520,5903,全家,240.50,245.00,240.50,242.50,+2.50,1.04,98000,91,23796000,19000,4293,14707,0,0,0,0,0,0,14707
20200520,5904,寶雅,578.00,599.00,578.00,586.00,+8.00,1.38,155000,155,91136000,35000,73823,-38823,18000,0,18000,23000,4000,19000,-1823
20200520,5905,南仁湖,9.58,9.63,9.40,9.49,0.00,0.0,470000,225,4463060,16000,117000,-101000,0,0,0,0,0,0,-101000
20200520,6015,宏遠證,6.14,6.14,6.09,6.10,-0.01,-0.16,203000,34,1238180,0,0,0,0,0,0,0,0,0,0
20200520,6016,康和證,7.00,7.06,7.00,7.04,-0.01,-0.14,342000,60,2408560,45000,143000,-98000,0,0,0,0,0,0,-98000
20200520,6020,大展證,12.30,12.40,12.30,12.30,0.00,0.0,15000,4,185200,0,0,0,0,0,0,0,0,0,0
20200520,6021,大慶證,13.00,13.50,12.95,13.35,+0.25,1.91,187000,64,2483050,139000,0,139000,0,0,0,0,0,0,139000
20200520,6023,元大期,55.00,55.20,54.80,55.00,0.00,0.0,146000,76,8029000,9000,3000,6000,0,0,0,0,12000,-12000,-6000
20200520,6026,福邦證,8.74,8.75,8.68,8.70,-0.02,-0.23,237000,62,2063680,14000,0,14000,0,0,0,0,0,0,14000
20200520,6101,寬魚國際,30.25,30.25,28.65,29.45,-0.70,-2.32,272000,137,7929650,0,2000,-2000,0,0,0,0,0,0,-2000
20200520,6103,合邦,,,,,,0.00,0,0,0,0,0,0,0,0,0,0,0,0,0
20200520,6104,創惟,42.30,43.25,42.00,42.95,+1.75,4.25,4615000,2839,196529050,500000,103000,397000,0,0,0,0,2000,-2000,395000
20200520,6109,亞元,10.40,10.40,10.00,10.00,-0.15,-1.48,123000,46,1240450,0,0,0,0,0,0,0,0,0,0
20200520,6111,大宇資,72.40,74.00,71.00,71.50,-0.20,-0.28,642000,575,46427900,54000,63000,-9000,0,0,0,7000,0,7000,-2000
20200520,6113,亞矽,5.68,5.72,5.68,5.68,0.00,0.0,4000,4,22770,0,0,0,0,0,0,0,0,0,0
20200520,6114,久威,24.65,24.90,24.50,24.60,+0.25,1.03,64000,44,1577000,0,1000,-1000,0,0,0,0,0,0,-1000
20200520,6118,建達,8.06,8.15,8.06,8.09,+0.03,0.37,144000,61,1168120,16000,0,16000,0,0,0,0,0,0,16000
20200520,6121,新普,312.50,313.50,308.00,310.00,0.00,0.0,631000,580,195622000,170000,54903,115097,0,0,0,18000,44000,-26000,89097
20200520,6122,擎邦,13.85,13.90,13.80,13.90,+0.10,0.72,203000,101,2811400,15000,6000,9000,0,0,0,0,0,0,9000
20200520,6123,上奇,42.00,42.00,41.60,41.80,-0.05,-0.12,78000,53,3254750,3000,4000,-1000,0,0,0,0,0,0,-1000
20200520,6124,業強,28.65,29.45,28.65,29.00,-0.15,-0.51,62000,44,1802300,13000,0,13000,0,0,0,0,0,0,13000
20200520,6125,廣運,16.85,16.95,16.65,16.80,-0.05,-0.3,1970000,855,33004450,101000,29000,72000,0,0,0,0,0,0,72000
20200520,6126,信音,15.80,16.45,15.65,16.30,+0.65,4.15,2218000,987,35757050,239000,12000,227000,0,0,0,0,105000,-105000,122000
20200520,6127,九豪,17.15,17.50,17.00,17.05,+0.10,0.59,1478000,782,25466600,161000,116000,45000,0,0,0,0,0,0,45000
20200520,6129,普誠,6.02,6.05,6.00,6.04,+0.02,0.33,241000,74,1452970,28000,0,28000,0,0,0,0,0,0,28000
20200520,6130,星寶國際,27.50,27.50,27.20,27.40,-0.05,-0.18,27000,17,738600,0,1000,-1000,0,0,0,0,0,0,-1000
20200520,6134,萬旭,6.81,6.81,6.51,6.55,+0.07,1.08,46000,29,305490,0,3000,-3000,0,0,0,0,0,0,-3000
20200520,6138,茂達,72.70,78.30,72.70,78.30,+7.10,9.97,5880000,3208,454535400,130000,108000,22000,0,267000,-267000,83000,3000,80000,-165000
20200520,6140,訊達,10.50,10.65,10.45,10.60,0.00,0.0,25000,12,263850,0,0,0,0,0,0,0,0,0,0
20200520,6143,振曜,35.80,36.55,35.45,35.70,+0.10,0.28,184000,144,6574750,47000,30000,17000,0,0,0,0,0,0,17000
20200520,6144,得利影,6.53,6.53,6.43,6.43,-0.71,-9.94,46000,18,297070,0,0,0,0,0,0,0,0,0,0
20200520,6146,耕興,198.00,199.50,197.50,198.00,+0.50,0.25,181000,114,35894000,89000,101000,-12000,0,0,0,0,0,0,-12000
20200520,6147,頎邦,58.80,58.90,58.30,58.40,-0.40,-0.68,5787000,3388,338723300,217000,3543561,-3326561,0,125,-125,3000,95000,-92000,-3418686
20200520,6148,驊宏資,9.98,10.15,9.98,10.05,+0.06,0.6,178000,49,1787620,0,0,0,0,0,0,0,0,0,0
20200520,6150,撼訊,49.00,50.00,49.00,49.55,+0.60,1.23,373000,301,18448850,33000,0,33000,0,0,0,0,0,0,33000
20200520,6151,晉倫,20.30,20.30,20.00,20.05,-0.25,-1.23,60000,36,1208100,0,5000,-5000,0,0,0,0,0,0,-5000
20200520,6154,順發,12.20,12.25,12.15,12.20,-0.10,-0.81,27000,17,328500,0,0,0,0,0,0,0,0,0,0
20200520,6156,松上,11.30,11.30,11.15,11.15,-0.15,-1.33,58000,28,650850,0,0,0,0,0,0,0,0,0,0
20200520,6158,禾昌,22.15,23.30,21.85,22.65,+0.20,0.89,263000,131,5851000,11000,22000,-11000,0,0,0,0,0,0,-11000
20200520,6160,欣技,12.55,12.55,12.15,12.20,-0.35,-2.79,301000,168,3687000,2000,2000,0,0,0,0,0,0,0,0
20200520,6161,捷波,17.90,17.95,17.75,17.80,0.00,0.0,238000,88,4243400,6000,0,6000,0,0,0,0,0,0,6000
20200520,6163,華電網,14.05,14.10,13.90,13.95,-0.10,-0.71,144000,50,2016850,5000,0,5000,0,0,0,0,0,0,5000
20200520,6167,久正,6.78,6.81,6.65,6.73,-0.05,-0.74,529000,83,3573260,16000,2000,14000,0,0,0,0,0,0,14000
20200520,6169,昱泉,32.70,32.70,31.50,31.80,+0.10,0.32,31000,22,987500,7000,0,7000,0,0,0,0,0,0,7000
20200520,6170,統振,17.30,17.65,17.15,17.25,+0.05,0.29,1311000,622,22755000,77000,68000,9000,0,0,0,0,0,0,9000
20200520,6171,亞銳士,21.90,22.00,21.50,21.75,+0.05,0.23,63000,49,1370500,0,0,0,0,0,0,2000,0,2000,2000
20200520,6173,信昌電,56.30,57.50,55.80,55.80,0.00,0.0,2087000,1579,117920300,176000,214000,-38000,0,0,0,46000,89000,-43000,-81000
20200520,6174,安碁,10.75,10.75,10.70,10.70,-0.05,-0.47,9000,5,96600,0,0,0,0,0,0,0,0,0,0
20200520,6175,立敦,18.55,19.00,18.30,18.50,-0.05,-0.27,210000,126,3917950,2000,24000,-22000,0,0,0,0,0,0,-22000
20200520,6179,亞通,35.50,37.00,35.25,35.25,-0.10,-0.28,243000,162,8734050,6000,16000,-10000,0,0,0,0,0,0,-10000
20200520,6180,橘子,61.80,62.80,61.20,62.50,+1.00,1.63,3597000,2329,223209400,595000,154000,441000,0,0,0,46000,50000,-4000,437000
20200520,6182,合晶,33.70,33.80,33.20,33.55,+0.35,1.05,6334000,3503,212281300,645000,265000,380000,0,0,0,560000,72000,488000,868000
20200520,6185,幃翔,15.85,16.95,15.85,16.40,+0.65,4.13,1936000,973,32095550,72000,51000,21000,0,0,0,18000,1000,17000,38000
20200520,6186,新潤,29.60,30.40,29.35,30.00,+0.40,1.35,612000,360,18204850,52000,39000,13000,0,0,0,0,5000,-5000,8000
20200520,6187,萬潤,41.50,43.60,41.50,43.50,+1.80,4.32,296000,181,12640550,70000,0,70000,0,0,0,0,0,0,70000
20200520,6188,廣明,34.00,34.45,33.80,34.30,+0.30,0.88,1720000,996,58522200,358000,19000,339000,0,0,0,32000,169000,-137000,202000
20200520,6190,萬泰科,16.15,16.15,15.90,16.05,0.00,0.0,958000,320,15309250,52000,0,52000,0,0,0,0,0,0,52000
20200520,6194,育富,25.35,25.40,24.85,25.20,+0.05,0.2,79000,38,1978000,0,0,0,0,0,0,0,0,0,0
20200520,6195,詩肯,33.50,33.85,32.10,33.40,-0.10,-0.3,48000,37,1592750,0,0,0,0,0,0,0,0,0,0
20200520,6198,凌泰,9.77,9.77,9.77,9.77,+0.19,1.98,4000,4,39080,0,0,0,0,0,0,0,0,0,0
20200520,6199,天品,12.05,12.05,12.05,12.05,+0.05,0.42,4000,2,48200,0,0,0,0,0,0,0,0,0,0
20200520,006201,元大富櫃50,13.20,13.21,13.17,13.19,-0.01,-0.08,60000,18,791080,0,0,0,0,0,0,1000,41000,-40000,-40000
20200520,6203,海韻電,54.80,55.80,53.70,54.40,+0.40,0.74,1800000,1119,98322700,112000,37000,75000,0,0,0,3000,5000,-2000,73000
20200520,6204,艾華,24.85,25.00,24.80,24.80,-0.15,-0.6,97000,37,2413300,0,0,0,0,0,0,0,0,0,0
20200520,6207,雷科,23.65,23.65,23.00,23.20,-0.10,-0.43,154000,106,3580300,11000,1000,10000,0,0,0,0,0,0,10000
20200520,6208,日揚,25.15,25.90,25.00,25.70,+0.50,1.98,239000,156,6081600,28000,0,28000,0,0,0,0,0,0,28000
20200520,6210,慶生,45.00,45.35,44.80,45.30,0.00,0.0,181000,108,8159450,1000,4000,-3000,0,0,0,0,1000,-1000,-4000
20200520,6212,理銘,46.50,46.50,46.50,46.50,-0.50,-1.06,1000,1,46500,0,0,0,0,0,0,0,0,0,0
20200520,6217,中探針,30.75,30.75,30.10,30.15,-0.05,-0.17,136000,86,4121700,23000,16000,7000,0,0,0,0,0,0,7000
20200520,6218,豪勉,20.00,20.00,19.75,20.00,+0.05,0.25,9000,6,179750,0,0,0,0,0,0,0,0,0,0
20200520,6219,富旺,13.50,14.10,13.50,13.85,+0.20,1.47,7121000,940,97832550,229000,485000,-256000,0,0,0,0,13000,-13000,-269000
20200520,6220,岳豐,18.75,18.95,18.70,18.85,+0.10,0.53,65000,43,1222400,0,20000,-20000,0,0,0,2000,2000,0,-20000
20200520,6221,晉泰,59.00,62.30,59.00,61.60,+2.60,4.41,347000,238,20952300,68000,0,68000,0,16000,-16000,0,1000,-1000,51000
20200520,6222,上揚,13.00,13.05,12.50,13.05,0.00,0.0,65000,29,827750,0,9000,-9000,0,0,0,0,0,0,-9000
20200520,6223,旺矽,79.80,82.80,78.80,82.30,+2.40,3.0,5002000,3306,406682800,200000,316000,-116000,107000,0,107000,207000,146000,61000,52000
20200520,6227,茂綸,21.60,21.75,21.25,21.40,-0.35,-1.61,168000,113,3607100,10000,0,10000,0,0,0,4000,0,4000,14000
20200520,6228,全譜,5.99,6.28,5.94,5.94,0.00,0.0,56000,19,335830,0,0,0,0,0,0,0,0,0,0
20200520,6229,研通,12.80,12.80,12.75,12.80,0.00,0.0,40000,15,511200,0,0,0,0,0,0,0,0,0,0
20200520,6231,系微,66.10,69.70,66.10,69.60,+4.20,6.42,2153000,1681,147745800,202000,70000,132000,0,0,0,0,0,0,132000
20200520,6233,旺玖,10.80,10.90,10.65,10.80,+0.05,0.47,423000,165,4553300,102000,23000,79000,0,0,0,0,0,0,79000
20200520,6234,高僑,25.00,25.40,24.95,25.00,+0.05,0.2,228000,141,5726100,0,10000,-10000,0,0,0,0,1000,-1000,-11000
20200520,6236,康呈,,,,,,0.00,0,0,0,0,0,0,0,0,0,0,0,0,0
20200520,6237,驊訊,17.20,17.80,17.15,17.60,+0.45,2.62,522000,234,9084150,98000,1000,97000,0,0,0,2000,0,2000,99000
20200520,6238,勝麗,161.00,165.00,160.00,161.00,+1.00,0.62,745000,585,121144500,52045,85351,-33306,0,0,0,8000,8000,0,-33306
20200520,6240,松崗,12.70,12.70,12.70,12.70,0.00,0.0,3000,3,38100,0,0,0,0,0,0,0,0,0,0
20200520,6241,易通展,9.80,9.82,9.80,9.81,-0.19,-1.9,31000,12,304160,5000,0,5000,0,0,0,0,0,0,5000
20200520,6242,立康,33.90,33.90,33.55,33.55,-0.25,-0.74,5000,5,168400,0,0,0,0,0,0,0,0,0,0
20200520,6244,茂迪,6.94,6.99,6.70,6.95,+0.01,0.14,2462000,801,16935410,394000,122364,271636,0,0,0,0,11000,-11000,260636
20200520,6245,立端,56.00,56.60,55.40,56.60,+1.10,1.98,414000,320,23172600,140000,22000,118000,0,0,0,0,0,0,118000
20200520,6246,臺龍,7.79,7.79,7.35,7.59,-0.10,-1.3,17000,14,126600,0,0,0,0,0,0,0,0,0,0
20200520,6247,淇譽電,9.63,9.63,9.63,9.63,-0.01,-0.1,1000,1,9630,0,0,0,0,0,0,0,0,0,0
20200520,6248,沛波,27.30,27.30,27.05,27.30,0.00,0.0,21000,18,571500,0,0,0,0,0,0,0,0,0,0
20200520,6259,百徽,2.26,2.26,2.00,2.00,-0.19,-8.68,158000,23,322090,0,0,0,0,0,0,0,0,0,0
20200520,6261,久元,61.50,63.30,59.60,62.50,+2.10,3.48,12983000,8412,798736200,513000,532000,-19000,0,0,0,389000,237000,152000,133000
20200520,6263,普萊德,62.60,62.80,62.60,62.70,+0.10,0.16,36000,30,2256400,0,0,0,0,0,0,0,0,0,0
20200520,6264,富裔,5.60,5.80,5.60,5.80,0.00,0.0,23000,14,132010,0,0,0,0,0,0,0,0,0,0
20200520,6265,方土昶,5.92,5.94,5.84,5.94,+0.02,0.34,82000,40,482690,0,0,0,0,0,0,0,0,0,0
20200520,6266,泰詠,21.40,21.40,21.00,21.15,-0.15,-0.7,654000,375,13831700,25000,70000,-45000,0,0,0,0,118000,-118000,-163000
20200520,6270,倍微,19.20,19.50,18.50,18.80,-0.25,-1.31,6795000,2935,129287150,9000,129000,-120000,0,0,0,101000,0,101000,-19000
20200520,6274,台燿,132.50,133.00,128.00,128.50,-3.50,-2.65,3305000,2430,428139500,655000,343894,311106,586000,1213000,-627000,3000,84000,-81000,-396894
20200520,6275,元山,17.05,17.40,16.70,16.90,-0.15,-0.88,1972000,373,33885650,79000,44000,35000,0,0,0,0,0,0,35000
20200520,6276,安鈦克,20.65,21.00,19.50,19.70,-1.40,-6.64,1670000,1030,33651150,55000,89000,-34000,0,0,0,78000,0,78000,44000
20200520,6279,胡連,83.60,88.40,83.40,87.00,+4.50,5.45,3286000,2497,284723700,180000,140000,40000,312000,0,312000,301000,71000,230000,582000
20200520,6284,佳邦,30.95,31.45,30.50,30.55,-0.60,-1.93,484000,328,14939050,13000,102000,-89000,0,0,0,3000,1000,2000,-87000
20200520,6287,元隆,,,,,,0.00,0,0,0,0,0,0,0,0,0,0,0,0,0
20200520,6290,良維,62.90,63.50,62.20,62.50,-0.40,-0.64,1927000,1212,121064200,92000,170000,-78000,0,0,0,50000,71000,-21000,-99000
20200520,6291,沛亨,16.70,16.70,16.70,16.70,-0.25,-1.47,2000,2,33400,0,0,0,0,0,0,0,0,0,0
20200520,6292,迅德,35.60,35.65,35.55,35.60,0.00,0.0,106000,54,3774000,0,1000,-1000,0,0,0,0,0,0,-1000
20200520,6294,智基,107.50,109.50,107.50,109.00,+2.00,1.87,76000,56,8273000,49000,0,49000,0,0,0,0,0,0,49000
20200520,6404,通訊-KY,3.32,3.32,3.30,3.30,+0.13,4.1,10000,4,33060,0,0,0,0,0,0,0,0,0,0
20200520,6411,晶焱,83.90,84.90,83.50,83.70,-0.50,-0.59,493000,408,41409700,47000,46000,1000,0,100000,-100000,2000,21000,-19000,-118000
20200520,6417,韋僑,54.90,55.30,54.50,55.30,-0.60,-1.07,7000,7,384600,0,0,0,0,0,0,0,0,0,0
20200520,6418,詠昇,13.75,13.90,13.75,13.90,+0.15,1.09,7000,5,96550,0,0,0,0,0,0,0,0,0,0
20200520,6419,京晨科,13.35,13.35,13.35,13.35,+0.10,0.75,1000,1,13350,0,0,0,0,0,0,0,0,0,0
20200520,6425,易發,25.80,26.00,25.65,25.90,+0.10,0.39,56000,18,1448100,0,0,0,0,0,0,0,4000,-4000,-4000
20200520,6426,統新,144.50,145.00,140.50,141.50,-2.00,-1.39,1731000,1438,246941500,64000,139000,-75000,0,0,0,13000,102000,-89000,-164000
20200520,6432,今展科,29.75,30.10,29.15,29.15,-0.15,-0.51,350000,230,10302600,38000,31000,7000,0,0,0,0,0,0,7000
20200520,6435,大中,92.00,93.90,91.20,91.60,+1.40,1.55,588000,502,54359500,28000,79000,-51000,0,0,0,2000,0,2000,-49000
20200520,6438,迅得,58.90,60.10,58.60,59.50,+0.80,1.36,525000,393,31191000,79000,24000,55000,0,0,0,35000,7000,28000,83000
20200520,6441,廣錠,82.60,83.90,80.90,81.10,-0.90,-1.1,1080000,759,88950700,69000,19000,50000,0,0,0,1000,0,1000,51000
20200520,6446,藥華藥,116.00,116.50,112.00,114.00,-3.00,-2.56,841000,630,95372000,35000,6000,29000,0,0,0,0,0,0,29000
20200520,6457,紘康,85.50,85.50,80.10,80.80,-2.00,-2.42,1848000,1317,152922400,63000,21000,42000,0,0,0,10000,2000,8000,50000
20200520,6461,益得,17.85,18.20,17.15,17.75,-0.15,-0.84,218000,100,3879950,17000,0,17000,0,0,0,4000,0,4000,21000
20200520,6462,神盾,195.00,197.00,188.00,188.50,-4.50,-2.33,6635000,5350,1271698500,509000,820000,-311000,0,0,0,90000,277000,-187000,-498000
20200520,6465,威潤,38.30,38.60,38.15,38.60,+0.30,0.78,26000,26,997600,1000,0,1000,0,0,0,0,0,0,1000
20200520,6469,大樹,79.80,81.70,79.80,81.40,+1.40,1.75,66000,52,5350700,2000,2000,0,0,0,0,0,0,0,0
20200520,6470,宇智,40.75,41.45,40.75,41.40,+0.20,0.49,163000,115,6691650,16000,4000,12000,0,0,0,0,0,0,12000
20200520,6472,保瑞,147.50,148.50,146.50,148.00,+1.00,0.68,115000,105,16989500,3000,18000,-15000,0,0,0,2000,2000,0,-15000
20200520,6482,弘煜科,28.50,28.50,28.00,28.30,-0.20,-0.7,14000,5,397900,1000,0,1000,0,0,0,0,0,0,1000
20200520,6485,點序,26.40,26.50,26.10,26.10,-0.15,-0.57,100000,63,2635750,13000,0,13000,0,0,0,0,0,0,13000
20200520,6486,互動,73.20,73.60,73.00,73.30,+0.10,0.14,88000,69,6451500,8000,6000,2000,0,0,0,0,0,0,2000
20200520,6488,環球晶,375.00,375.50,367.50,368.50,-4.50,-1.21,2544000,2102,942116000,140000,484000,-344000,0,0,0,180000,103000,77000,-267000
20200520,6492,生華科,104.00,117.00,100.00,117.00,+10.50,9.86,2761000,1815,304879500,38000,96000,-58000,0,0,0,0,0,0,-58000
20200520,6494,九齊,34.35,34.95,34.20,34.25,-0.35,-1.01,384000,241,13215400,2000,28999,-26999,0,0,0,0,0,0,-26999
20200520,6496,科懋,30.95,30.95,30.30,30.40,-0.40,-1.3,65000,50,1983900,2000,3000,-1000,0,0,0,0,0,0,-1000
20200520,6497,亞獅康-KY,4.40,4.42,4.40,4.42,-0.18,-3.91,16000,10,70450,0,0,0,0,0,0,0,0,0,0
20200520,6499,益安,52.30,53.30,51.70,53.20,+0.50,0.95,81000,63,4271700,11000,0,11000,0,0,0,0,0,0,11000
20200520,6506,雙邦,17.80,17.85,17.70,17.85,+0.05,0.28,17000,13,301650,0,861,-861,0,0,0,0,0,0,-861
20200520,6508,惠光,33.60,33.65,33.20,33.35,-0.40,-1.19,318000,234,10627050,24000,1000,23000,0,0,0,72000,0,72000,95000
20200520,6509,聚和,21.90,22.30,21.50,21.85,-0.45,-2.02,7672000,3707,167605300,190000,167000,23000,0,0,0,83000,0,83000,106000
20200520,6510,精測,606.00,606.00,588.00,597.00,-6.00,-1.0,1016000,953,604735000,48000,235000,-187000,0,0,0,4000,18000,-14000,-201000
20200520,6512,啟發電,13.90,14.45,13.40,13.85,-0.10,-0.72,282000,192,3899700,2000,10000,-8000,0,0,0,0,0,0,-8000
20200520,6514,芮特-KY,60.30,60.30,59.90,60.10,+0.20,0.33,74000,58,4446700,26000,0,26000,0,0,0,0,0,0,26000
20200520,6516,勤崴國際,81.60,81.80,80.70,80.70,-0.60,-0.74,18000,14,1465800,2000,0,2000,0,0,0,0,0,0,2000
20200520,6523,達爾膚,63.70,63.70,62.70,62.90,-0.10,-0.16,195000,147,12313000,38000,10000,28000,0,0,0,0,0,0,28000
20200520,6527,明達醫,52.80,52.90,51.90,52.40,0.00,0.0,34000,31,1774500,4000,0,4000,0,0,0,0,0,0,4000
20200520,6530,創威,17.40,17.55,17.20,17.55,+0.25,1.45,40000,22,693950,0,0,0,0,0,0,0,0,0,0
20200520,6532,瑞耘,66.00,67.50,65.70,66.60,+1.70,2.62,1872000,1150,124628700,118000,0,118000,0,0,0,5000,8000,-3000,115000
20200520,6535,順藥,29.35,29.70,29.20,29.70,+0.45,1.54,157000,103,4615800,13000,0,13000,0,0,0,0,0,0,13000
20200520,6538,倉和,282.50,293.00,278.50,288.00,+10.00,3.6,9820000,8227,2810310000,483000,248000,235000,141000,0,141000,68000,10000,58000,434000
20200520,6542,隆中,62.30,62.30,60.00,60.40,+0.90,1.51,29000,24,1760100,0,3000,-3000,0,0,0,0,0,0,-3000
20200520,6547,高端疫苗,78.10,91.10,78.10,84.60,-1.20,-1.4,18478000,12542,1542967000,480000,1923000,-1443000,0,0,0,3000,1000,2000,-1441000
20200520,6548,長科*,28.20,28.70,28.10,28.55,+0.10,0.35,518000,270,14723000,69000,5000,64000,0,0,0,23000,3000,20000,84000
20200520,6556,勝品,45.40,45.50,45.40,45.50,-0.10,-0.22,6000,2,272900,0,0,0,0,0,0,0,0,0,0
20200520,6560,欣普羅,29.30,29.45,29.30,29.45,+0.25,0.86,16000,13,469200,0,2000,-2000,0,0,0,0,0,0,-2000
20200520,6561,是方,307.00,316.50,305.00,315.00,+11.50,3.79,458000,436,143070000,55000,6000,49000,52000,0,52000,30000,1000,29000,130000
20200520,6568,宏觀,125.00,126.50,124.50,125.00,-1.50,-1.19,78000,64,9785500,0,3000,-3000,0,24000,-24000,0,0,0,-27000
20200520,6569,醫揚,167.00,167.00,166.50,166.50,-1.00,-0.6,12000,11,2002500,0,2000,-2000,0,0,0,0,0,0,-2000
20200520,6570,維田,37.50,37.50,37.00,37.00,-0.50,-1.33,27000,21,1000250,0,0,0,0,0,0,0,0,0,0
20200520,6574,霈方,57.70,57.70,56.00,57.30,+1.30,2.32,5000,5,283000,0,0,0,0,0,0,0,0,0,0
20200520,6576,逸達,54.90,55.00,53.50,53.80,-2.00,-3.58,393000,291,21255800,6000,26000,-20000,0,0,0,12000,0,12000,-8000
20200520,6577,勁豐,73.60,73.70,72.50,72.90,-0.60,-0.82,71000,58,5174800,6000,1000,5000,0,0,0,0,0,0,5000
20200520,6578,達邦蛋白,19.85,21.80,19.85,21.80,+1.95,9.82,311000,167,6708050,7000,0,7000,0,0,0,0,0,0,7000
20200520,6589,台康生技,49.80,54.70,48.00,54.60,+4.80,9.64,13495000,8351,708018250,136500,262000,-125500,0,0,0,20000,38000,-18000,-143500
20200520,6590,普鴻,38.50,39.95,38.50,39.30,+1.00,2.61,54000,47,2121400,0,0,0,0,0,0,0,0,0,0
20200520,6593,台灣銘板,23.00,23.95,22.70,23.50,0.00,0.0,6000,6,139900,0,0,0,0,0,0,0,0,0,0
20200520,6594,展匯科,26.80,26.80,26.25,26.70,-0.10,-0.37,62000,56,1644900,1000,0,1000,0,0,0,0,0,0,1000
20200520,6596,寬宏藝術,50.50,50.50,50.40,50.50,+0.10,0.2,17000,14,858100,0,0,0,0,0,0,0,0,0,0
20200520,6603,富強鑫,9.06,9.07,8.99,9.02,-0.06,-0.66,87000,23,785780,0,0,0,0,0,0,0,0,0,0
20200520,6609,瀧澤科,25.70,25.80,25.50,25.60,-0.30,-1.16,38000,21,972800,0,0,0,0,0,0,0,0,0,0
20200520,6612,奈米醫材,82.00,82.00,79.00,80.50,-1.50,-1.83,298000,252,23923000,11000,18000,-7000,0,0,0,0,0,0,-7000
20200520,6613,朋億,146.00,147.50,146.00,147.50,+2.00,1.37,52000,43,7635500,3000,0,3000,0,0,0,0,0,0,3000
20200520,6615,慧智,60.00,60.20,60.00,60.20,-0.20,-0.33,8000,7,481200,0,0,0,0,0,0,0,0,0,0
20200520,6616,特昇-KY,25.50,25.55,25.35,25.45,-0.10,-0.39,36000,23,917600,0,0,0,0,0,0,0,0,0,0
20200520,6624,萬年清,39.90,39.90,38.80,39.70,+0.90,2.32,20000,12,794300,1000,2000,-1000,0,0,0,0,0,0,-1000
20200520,6629,泰金-KY,50.10,50.50,50.10,50.50,0.00,0.0,4000,4,200800,0,0,0,0,0,0,0,0,0,0
20200520,6640,均華,45.10,46.20,45.10,46.00,+0.70,1.55,50000,22,2279650,0,2000,-2000,0,0,0,0,0,0,-2000
20200520,6642,富致,34.45,35.00,33.80,33.85,-0.60,-1.74,84000,51,2871500,0,1000,-1000,0,0,0,0,0,0,-1000
20200520,6643,M31,292.50,300.00,285.50,287.00,-3.00,-1.03,1498000,1370,441292500,19000,218000,-199000,37000,0,37000,20000,32000,-12000,-174000
20200520,6649,台生材,28.05,28.15,27.90,27.90,-0.10,-0.36,34000,17,952700,0,0,0,0,0,0,0,0,0,0
20200520,6654,天正國際,53.50,53.60,51.80,52.80,+1.00,1.93,42000,41,2206800,0,2000,-2000,0,0,0,0,1000,-1000,-3000
20200520,6662,樂斯科,45.05,48.50,44.80,48.40,+2.80,6.14,215000,169,10207100,0,0,0,0,0,0,0,0,0,0
20200520,6664,群翊,60.50,61.10,60.10,61.10,+0.60,0.99,68000,55,4129600,15000,0,15000,0,0,0,0,0,0,15000
20200520,6667,信紘科,68.40,69.00,67.60,67.80,+0.30,0.44,261000,206,17776100,71000,0,71000,0,0,0,0,0,0,71000
20200520,6679,鈺太,149.50,151.50,147.50,150.00,+1.50,1.01,495000,440,73902500,9000,56000,-47000,0,0,0,15000,5000,10000,-37000
20200520,6680,鑫創電子,63.00,63.40,62.50,63.00,+0.50,0.8,27000,13,1701800,0,0,0,0,0,0,0,0,0,0
20200520,6683,雍智科技,240.00,252.00,237.00,246.00,+14.00,6.03,4711000,3972,1151692500,136000,156000,-20000,118000,0,118000,173000,81000,92000,190000
20200520,6690,安碁資訊,133.50,134.50,131.00,132.00,-0.50,-0.38,71000,59,9410000,0,4000,-4000,0,0,0,0,0,0,-4000
20200520,6697,東捷資訊,41.20,42.50,40.90,42.50,+1.60,3.91,442000,315,18396700,18000,13000,5000,0,0,0,0,0,0,5000
20200520,6716,應廣,75.90,76.90,74.50,74.80,-1.20,-1.58,155000,136,11662900,0,3000,-3000,0,0,0,0,0,0,-3000
20200520,6803,崑鼎,215.50,216.50,215.50,216.50,+1.00,0.46,22000,20,4754000,1000,0,1000,0,0,0,1000,0,1000,2000
20200520,7402,邑錡,38.40,38.40,36.20,37.85,-0.60,-1.56,3000,3,112450,0,0,0,0,0,0,0,0,0,0
20200520,8024,佑華,8.57,8.60,8.55,8.59,+0.03,0.35,58000,15,497340,1000,0,1000,0,0,0,0,0,0,1000
20200520,8027,鈦昇,32.20,32.20,31.80,31.90,+0.05,0.16,53000,45,1690350,7000,0,7000,0,0,0,0,0,0,7000
20200520,8032,光菱,22.40,22.40,22.10,22.20,-0.20,-0.89,10000,8,221900,0,0,0,0,0,0,0,0,0,0
20200520,8034,榮群,34.50,34.75,33.50,34.50,+0.40,1.17,1482000,894,50634600,299000,0,299000,0,0,0,2000,1000,1000,300000
20200520,8038,長園科,32.40,33.00,32.25,32.50,-0.30,-0.91,196000,65,6430700,0,6000,-6000,0,0,0,0,0,0,-6000
20200520,8040,九暘,16.60,16.70,16.25,16.65,+0.40,2.46,676000,378,11136700,143000,41000,102000,0,0,0,0,1000,-1000,101000
20200520,8042,金山電,33.55,33.95,33.55,33.60,+0.20,0.6,104000,76,3510200,7000,3000,4000,0,0,0,0,2000,-2000,2000
20200520,8043,蜜望實,26.75,27.75,26.65,26.65,+0.20,0.76,435000,322,11773150,19000,43000,-24000,0,0,0,0,0,0,-24000
20200520,8044,網家,107.50,114.00,107.50,112.00,+6.00,5.66,8291000,5887,917978000,1985000,193000,1792000,400000,0,400000,244000,224000,20000,2212000
20200520,8047,星雲,9.95,9.95,9.83,9.95,-0.20,-1.97,14000,8,138580,0,0,0,0,0,0,0,0,0,0
20200520,8048,德勝,31.70,31.90,31.55,31.65,-0.30,-0.94,37000,31,1171300,0,3000,-3000,0,0,0,0,0,0,-3000
20200520,8049,晶采,21.90,21.90,21.60,21.80,0.00,0.0,364000,197,7913000,41000,0,41000,0,0,0,0,0,0,41000
20200520,8050,廣積,38.10,38.35,38.10,38.30,+0.10,0.26,99000,71,3786450,16000,19000,-3000,0,0,0,0,0,0,-3000
20200520,8054,安國,12.10,12.10,12.00,12.10,0.00,0.0,65000,36,782350,1000,0,1000,0,0,0,0,0,0,1000
20200520,8059,凱碩,13.05,13.05,12.95,13.05,0.00,0.0,65000,35,846000,7000,1000,6000,0,0,0,0,0,0,6000
20200520,8064,東捷,14.10,14.30,14.10,14.15,+0.05,0.35,155000,96,2204000,21000,2000,19000,0,0,0,0,0,0,19000
20200520,8066,來思達,62.60,62.60,61.60,62.50,-0.10,-0.16,36000,34,2235000,0,2000,-2000,0,0,0,0,1000,-1000,-3000
20200520,8067,志旭,7.23,7.41,7.23,7.23,-0.14,-1.9,6000,6,43700,0,0,0,0,0,0,0,0,0,0
20200520,8068,全達,22.80,22.80,21.55,22.45,+0.30,1.35,42000,36,920700,0,9000,-9000,0,0,0,0,0,0,-9000
20200520,8069,元太,36.40,39.30,36.10,39.05,+2.75,7.58,39391000,16047,1486392150,4101000,2610617,1490383,251000,0,251000,2847000,124000,2723000,4464383
20200520,8071,能率網通,12.45,12.60,12.35,12.45,0.00,0.0,119000,68,1476050,8000,3000,5000,0,0,0,0,0,0,5000
20200520,8074,鉅橡,16.25,16.30,16.20,16.30,+0.05,0.31,33000,17,536650,0,0,0,0,0,0,0,0,0,0
20200520,8076,伍豐,28.55,28.80,28.25,28.40,0.00,0.0,390000,205,11085400,109000,9000,100000,0,0,0,0,0,0,100000
20200520,8077,洛碁,9.36,9.80,9.36,9.50,+0.12,1.28,26000,16,251770,0,0,0,0,0,0,0,0,0,0
20200520,8080,永利聯合,3.10,3.10,3.10,3.10,+0.13,4.38,18000,8,55800,0,0,0,0,0,0,0,0,0,0
20200520,8083,瑞穎,158.00,160.00,156.50,157.50,0.00,0.0,50000,42,7885000,0,0,0,0,0,0,0,0,0,0
20200520,8084,巨虹,41.00,43.00,41.00,43.00,+1.50,3.61,53000,29,2206500,15000,0,15000,0,0,0,0,0,0,15000
20200520,8085,福華,3.68,3.71,3.66,3.70,+0.01,0.27,73000,16,269230,0,0,0,0,0,0,0,0,0,0
20200520,8086,宏捷科,86.10,86.70,84.80,85.30,-1.40,-1.61,5609000,3861,480388100,437000,455000,-18000,1000,3921,-2921,15000,22000,-7000,-27921
20200520,8087,華鎂鑫,,,,,,0.00,0,0,0,0,0,0,0,0,0,0,0,0,0
20200520,8088,品安,28.50,28.90,28.40,28.45,+0.10,0.35,1759000,781,50263650,102000,153000,-51000,0,0,0,0,0,0,-51000
20200520,8091,翔名,54.00,55.00,54.00,54.20,+0.20,0.37,165000,111,8961800,14000,4000,10000,0,0,0,0,0,0,10000
20200520,8092,建暐,7.45,7.67,7.41,7.65,+0.14,1.86,52000,26,390980,0,2000,-2000,0,0,0,0,0,0,-2000
20200520,8093,保銳,4.34,4.35,4.28,4.34,+0.07,1.64,103000,28,444420,0,1000,-1000,0,0,0,0,0,0,-1000
20200520,8096,擎亞,11.25,11.40,11.15,11.15,-0.10,-0.89,852000,334,9615200,53000,21000,32000,0,0,0,0,0,0,32000
20200520,8097,常珵,12.50,12.50,12.25,12.25,-0.25,-2.0,5000,5,61550,0,0,0,0,0,0,0,0,0,0
20200520,8099,大世科,17.65,17.65,17.50,17.60,0.00,0.0,80000,53,1406050,0,0,0,0,0,0,0,0,0,0
20200520,8107,大億金茂,16.15,16.20,16.10,16.15,0.00,0.0,40000,23,646000,0,0,0,0,0,0,0,0,0,0
20200520,8109,博大,68.50,69.00,68.00,68.10,-0.40,-0.58,26000,25,1777500,0,0,0,0,0,0,1000,0,1000,1000
20200520,8111,立碁,9.50,9.50,9.38,9.38,-0.09,-0.95,119000,60,1122050,0,0,0,0,0,0,0,0,0,0
20200520,8121,越峰,10.00,10.10,9.94,9.95,-0.10,-1.0,112000,67,1118730,1000,1000,0,0,0,0,0,0,0,0
20200520,8147,正淩,34.00,35.30,34.00,34.50,+0.85,2.53,229000,103,7922850,11000,0,11000,0,0,0,4000,0,4000,15000
20200520,8155,博智,154.50,156.00,150.00,153.00,-1.00,-0.65,2034000,1694,310575500,65000,100000,-35000,0,372000,-372000,1000,17000,-16000,-423000
20200520,8171,天宇,14.45,14.80,14.15,14.75,+0.50,3.51,801000,389,11591650,110000,0,110000,0,0,0,0,0,0,110000
20200520,8176,智捷,8.91,8.93,8.90,8.90,0.00,0.0,53000,38,472270,0,13000,-13000,0,0,0,0,0,0,-13000
20200520,8182,加高,28.50,28.70,28.20,28.20,-0.30,-1.05,1132000,731,32116800,166000,43000,123000,0,0,0,0,0,0,123000
20200520,8183,精星,17.35,17.45,17.15,17.20,-0.05,-0.29,433000,216,7479500,116000,5000,111000,0,0,0,0,0,0,111000
20200520,8234,新漢,21.80,22.60,21.80,22.50,+0.65,2.97,121000,84,2686600,17000,0,17000,0,0,0,0,0,0,17000
20200520,8240,華宏,24.20,24.20,24.00,24.20,0.00,0.0,61000,35,1469550,6000,0,6000,0,0,0,0,2000,-2000,4000
20200520,8255,朋程,83.80,84.50,83.70,83.80,+0.10,0.12,127000,110,10682400,25000,5000,20000,0,80000,-80000,0,0,0,-60000
20200520,8277,商丞,6.41,6.41,6.11,6.20,-0.13,-2.05,137000,60,852040,0,0,0,0,0,0,0,0,0,0
20200520,8279,生展,108.00,111.00,107.00,111.00,+3.00,2.78,60000,51,6584500,9000,0,9000,0,0,0,0,0,0,9000
20200520,8284,三竹,67.60,67.60,66.00,66.00,-1.50,-2.22,834000,640,55382100,10000,0,10000,0,0,0,0,10000,-10000,0
20200520,8289,泰藝,11.75,11.85,11.65,11.65,-0.15,-1.27,76000,47,889950,17000,3000,14000,0,0,0,0,0,0,14000
20200520,8291,尚茂,2.91,3.00,2.91,3.00,-0.23,-7.12,12000,3,35460,0,0,0,0,0,0,0,0,0,0
20200520,8299,群聯,275.00,276.00,271.00,273.00,-2.00,-0.73,1965000,1566,536347000,297700,440000,-142300,20000,185000,-165000,73000,112000,-39000,-346300
20200520,8342,益張,50.30,55.10,50.10,52.40,+2.30,4.59,236000,168,12539900,5000,1000,4000,0,0,0,0,0,0,4000
20200520,8349,恒耀,42.50,42.50,41.75,41.85,-0.65,-1.53,85000,62,3574300,12000,27000,-15000,0,0,0,0,0,0,-15000
20200520,8349A,恒耀甲特,42.15,42.15,42.00,42.15,+0.10,0.24,17000,10,714450,0,0,0,0,0,0,0,0,0,0
20200520,8354,冠好,17.00,17.10,17.00,17.10,-0.10,-0.58,119000,9,2033500,0,0,0,0,0,0,0,0,0,0
20200520,8358,金居,41.40,41.80,40.90,40.95,-0.90,-2.15,4336000,2644,178625850,89000,677000,-588000,0,0,0,58000,156000,-98000,-686000
20200520,8383,千附,35.35,35.45,35.20,35.45,+0.30,0.85,267000,207,9431650,31000,45000,-14000,0,0,0,47000,0,47000,33000
20200520,8390,金益鼎,18.75,18.90,18.50,18.55,+0.05,0.27,482000,226,9016650,3000,10000,-7000,0,0,0,0,0,0,-7000
20200520,8401,白紗科,12.00,12.00,11.75,12.00,0.00,0.0,9000,7,106750,0,0,0,0,0,0,0,0,0,0
20200520,8403,盛弘,41.50,44.30,40.60,44.30,+4.00,9.93,11381000,5352,492295900,288000,292000,-4000,200000,0,200000,8000,225000,-217000,-21000
20200520,8406,金可-KY,148.00,148.00,146.00,146.00,-2.50,-1.68,181000,144,26579500,4000,16000,-12000,0,0,0,1000,0,1000,-11000
20200520,8409,商之器,18.10,18.60,18.10,18.15,+0.05,0.28,54000,43,986650,0,0,0,0,0,0,0,0,0,0
20200520,8410,森田,37.25,38.20,37.10,38.20,+0.80,2.14,404000,230,15283450,23000,22000,1000,0,0,0,0,0,0,1000
20200520,8415,大國鋼,25.50,26.25,25.50,26.10,+0.50,1.95,320000,209,8334200,127000,96000,31000,0,0,0,0,0,0,31000
20200520,8416,實威,113.50,114.00,113.00,113.50,0.00,0.0,30000,24,3410000,1000,0,1000,0,0,0,0,0,0,1000
20200520,8418,捷必勝-KY,13.45,13.50,13.45,13.50,+0.05,0.37,5000,2,67450,0,0,0,0,0,0,0,0,0,0
20200520,8420,明揚,,,,,,0.00,0,0,0,0,0,0,0,0,0,0,0,0,0
20200520,8421,旭源,9.88,9.88,9.55,9.76,-0.13,-1.31,30000,21,289560,0,0,0,0,0,0,1000,0,1000,1000
20200520,8423,保綠-KY,17.00,17.10,16.90,16.90,-0.20,-1.17,16000,10,271250,0,0,0,0,0,0,0,0,0,0
20200520,8424,惠普,52.50,52.50,52.10,52.10,+0.10,0.19,28000,18,1465100,0,0,0,0,0,0,0,0,0,0
20200520,8426,紅木-KY,13.15,13.15,13.15,13.15,0.00,0.0,11000,3,144650,0,0,0,0,0,0,0,0,0,0
20200520,8431,匯鑽科,50.90,51.70,50.90,51.50,-0.20,-0.39,88000,70,4512900,22000,1000,21000,0,0,0,0,0,0,21000
20200520,8432,東生華,68.60,68.90,67.70,67.90,-0.50,-0.73,23000,21,1568000,0,0,0,0,0,0,0,0,0,0
20200520,8433,弘帆,42.00,42.30,41.45,42.30,+0.25,0.59,21000,18,880950,0,0,0,0,0,0,0,0,0,0
20200520,8435,鉅邁,50.30,50.60,50.20,50.20,-0.10,-0.2,46000,30,2317400,7000,0,7000,0,0,0,0,0,0,7000
20200520,8436,大江,255.00,257.00,249.50,250.00,-3.00,-1.19,1253000,994,316967500,304000,236397,67603,55000,33000,22000,25000,20000,5000,94603
20200520,8437,大地-KY,182.50,198.00,181.50,196.50,+15.50,8.56,252000,240,47550000,103000,185158,-82158,0,0,0,4000,0,4000,-78158
20200520,8440,綠電,13.00,13.00,12.60,12.90,,0.00,53000,46,682600,0,0,0,0,0,0,0,0,0,0
20200520,8444,綠河-KY,48.90,49.00,48.90,48.90,0.00,0.0,7000,7,342500,0,0,0,0,0,0,0,0,0,0
20200520,8446,華研,110.50,111.00,110.00,110.00,-0.50,-0.45,77000,55,8499000,1000,26000,-25000,0,0,0,0,0,0,-25000
20200520,8450,霹靂,25.60,25.60,24.30,25.35,-0.25,-0.98,120000,87,3008850,1000,0,1000,0,0,0,1000,0,1000,2000
20200520,8455,大拓-KY,20.00,20.00,19.90,19.95,+0.50,2.57,5000,5,99700,0,0,0,0,0,0,0,0,0,0
20200520,8472,夠麻吉,29.50,29.60,29.50,29.60,+0.10,0.34,36000,20,1062600,0,0,0,0,0,0,0,0,0,0
20200520,8476,台境,23.30,23.70,23.30,23.65,+0.35,1.5,23000,13,542950,0,0,0,0,0,0,0,0,0,0
20200520,8477,創業家,50.70,51.90,49.50,50.50,+0.20,0.4,628000,431,31805000,3000,55000,-52000,0,0,0,0,1000,-1000,-53000
20200520,8489,三貝德,64.40,64.90,63.30,63.70,-0.40,-0.62,173000,149,11042300,40000,11000,29000,0,0,0,3000,0,3000,32000
20200520,8906,花王,,,,,,0.00,0,0,0,0,0,0,0,0,0,0,0,0,0
20200520,8908,欣雄,46.40,46.40,46.35,46.35,-0.05,-0.11,48000,47,2225450,0,0,0,0,0,0,0,0,0,0
20200520,8916,光隆,40.95,41.20,40.90,41.05,0.00,0.0,104000,69,4265350,18000,7000,11000,0,0,0,0,0,0,11000
20200520,8916A,光隆甲特,52.50,52.70,52.40,52.70,0.00,0.0,6000,6,315200,0,0,0,0,0,0,2000,0,2000,2000
20200520,8917,欣泰,60.00,60.20,60.00,60.10,-0.30,-0.5,13000,7,780800,0,0,0,0,0,0,0,0,0,0
20200520,8921,沈氏,12.85,12.85,12.85,12.85,-0.15,-1.15,4000,1,51400,0,0,0,0,0,0,0,0,0,0
20200520,8923,時報,15.00,15.00,14.95,14.95,+0.05,0.34,6000,2,89750,0,0,0,0,0,0,0,0,0,0
20200520,8924,大田,47.90,47.95,46.45,47.70,+0.30,0.63,2889000,1708,136384750,90000,334000,-244000,0,0,0,3000,163000,-160000,-404000
20200520,8927,北基,15.45,15.90,15.35,15.35,+0.25,1.66,18000,9,280100,0,0,0,0,0,0,0,0,0,0
20200520,8928,鉅明,26.80,27.20,26.65,27.05,+0.30,1.12,218000,128,5873900,8000,5000,3000,0,0,0,0,0,0,3000
20200520,8929,富堡,28.40,29.20,28.40,29.20,+0.90,3.18,125000,96,3606650,0,0,0,0,0,0,0,0,0,0
20200520,8930,青鋼,11.95,12.30,11.65,12.00,+0.15,1.27,160000,56,1924450,0,2000,-2000,0,0,0,0,0,0,-2000
20200520,8931,大汽電,28.80,28.85,28.50,28.75,-0.10,-0.35,28000,26,802450,0,1000,-1000,0,0,0,0,0,0,-1000
20200520,8932,宏大,12.80,12.90,12.50,12.50,-0.20,-1.57,43000,20,542700,0,0,0,0,0,0,0,0,0,0
20200520,8933,愛地雅,7.02,7.20,6.87,6.87,-0.13,-1.86,753000,287,5283700,0,26000,-26000,0,0,0,0,0,0,-26000
20200520,8934,衡平,33.15,33.15,33.15,33.15,0.00,0.0,1000,1,33150,0,0,0,0,0,0,0,0,0,0
20200520,8935,邦泰,8.60,8.60,8.49,8.54,-0.02,-0.23,30000,11,256280,0,3000,-3000,0,0,0,0,0,0,-3000
20200520,8936,國統,17.70,17.70,17.30,17.35,-0.35,-1.98,406000,276,7080900,10000,60000,-50000,0,0,0,0,0,0,-50000
20200520,8937,合騏,14.45,14.50,14.35,14.35,-0.05,-0.35,5000,4,72100,0,0,0,0,0,0,0,0,0,0
20200520,8938,明安,34.20,34.20,32.80,33.05,+0.40,1.23,482000,307,16041950,18000,23000,-5000,0,0,0,0,116000,-116000,-121000
20200520,8941,關中,39.00,39.10,38.00,38.95,+0.25,0.65,60000,37,2320200,0,0,0,0,0,0,0,0,0,0
20200520,8942,森鉅,53.20,53.60,53.00,53.00,-0.40,-0.75,341000,215,18111600,30000,0,30000,0,0,0,0,2000,-2000,28000
20200520,9949,琉園,12.25,12.45,11.30,11.50,-0.95,-7.63,172000,91,2011650,1000,1000,0,0,0,0,6000,0,6000,6000
20200520,9950,萬國通,9.50,9.50,9.45,9.50,0.00,0.0,53000,14,501910,0,0,0,0,0,0,0,0,0,0
20200520,9951,皇田,70.10,70.10,68.90,69.10,-0.40,-0.58,199000,149,13813900,6000,7000,-1000,0,0,0,0,1000,-1000,-2000
20200520,9960,邁達康,26.80,27.00,26.55,26.80,0.00,0.0,41000,41,1105050,0,0,0,0,0,0,0,0,0,0
20200520,9962,有益,7.99,8.12,7.99,8.12,+0.12,1.5,12000,7,96080,3000,0,3000,0,0,0,0,0,0,3000
20200520,020001,富邦存股雙十N,4.91,4.93,4.89,4.89,0.00,0.0,49000,8,240150,0,0,0,0,0,0,43000,2000,41000,41000
20200520,020003,統一漲升股利150N,,,,,,0.00,0,0,0,0,0,0,0,0,0,0,0,0,0
20200520,020009,群益A50綠碳N,,,,,,0.00,0,0,0,0,0,0,0,0,0,0,0,0,0
20200520,020010,永昌富櫃200N,10.36,10.38,10.32,10.33,+0.02,0.19,43000,19,445000,0,0,0,0,0,0,22000,21000,1000,1000
20200520,020013,元富亞洲高股息N,,,,,,0.00,0,0,0,0,0,0,0,0,0,0,0,0,0
20200520,020014,元大富櫃200N,4.78,4.79,4.78,4.78,+0.03,0.63,26000,9,124490,0,0,0,0,0,0,24000,2000,22000,22000
20200520,72510P,原相群益96售02,,,,,,0.00,0,0,0,0,0,0,0,0,0,0,0,0,0
20200520,72535P,雙鴻群益95售01,0.36,0.36,0.36,0.36,-0.11,-23.4,10000,1,3600,0,0,0,0,0,0,10000,0,10000,10000
20200520,72548P,大江統一96售01,,,,,,0.00,0,0,0,0,0,0,0,0,0,0,0,0,0
20200520,72568P,新普群益96售01,,,,,,0.00,0,0,0,0,0,0,0,0,0,0,0,0,0
20200520,72572P,網家元富96售02,0.73,0.73,0.73,0.73,-0.33,-31.13,4000,1,2920,0,0,0,0,0,0,0,4000,-4000,-4000
20200520,72594P,雙鴻國泰96售03,,,,,,0.00,0,0,0,0,0,0,0,0,0,0,0,0,0
20200520,72595P,大江富邦96售01,,,,,,0.00,0,0,0,0,0,0,0,0,0,0,0,0,0
20200520,72611P,雙鴻凱基96售02,0.91,0.92,0.91,0.92,+0.02,2.22,11000,2,10020,0,0,0,0,0,0,11000,0,11000,11000
20200520,72623P,穩懋富邦96售02,0.92,0.94,0.92,0.94,+0.03,3.3,4000,2,3700,0,0,0,0,0,0,4000,0,4000,4000
20200520,72624P,櫃200第一96售02,,,,,,0.00,0,0,0,0,0,0,0,0,0,0,0,0,0
20200520,72638P,中美晶元富95售03,,,,,,0.00,0,0,0,0,0,0,0,0,0,0,0,0,0
20200520,72655P,穩懋統一96售03,,,,,,0.00,0,0,0,0,0,0,0,0,0,0,0,0,0
20200520,72658P,建榮國票95售03,,,,,,0.00,0,0,0,0,0,0,0,0,0,0,0,0,0
20200520,72661P,穩懋中信96售01,0.94,0.94,0.94,0.94,+0.05,5.62,2000,1,1880,0,0,0,0,0,0,2000,0,2000,2000
20200520,72662P,穩懋中信98售01,0.84,0.85,0.84,0.85,+0.05,6.25,81000,5,68250,0,0,0,0,0,0,57000,24000,33000,33000
20200520,72663P,神盾元富96售01,,,,,,0.00,0,0,0,0,0,0,0,0,0,0,0,0,0
20200520,72672P,穩懋國票96售01,,,,,,0.00,0,0,0,0,0,0,0,0,0,0,0,0,0
20200520,72673P,穩懋國泰96售01,,,,,,0.00,0,0,0,0,0,0,0,0,0,0,0,0,0
20200520,72674P,環球晶富邦97售02,0.28,0.29,0.28,0.29,+0.02,7.41,11000,2,3090,0,0,0,0,0,0,11000,0,11000,11000
20200520,72684P,大江國票96售02,1.08,1.20,1.08,1.20,+0.03,2.56,4000,4,4480,0,0,0,0,0,0,4000,0,4000,4000
20200520,72686P,新普群益97售03,,,,,,0.00,0,0,0,0,0,0,0,0,0,0,0,0,0
20200520,72689P,環宇國票96售01,,,,,,0.00,0,0,0,0,0,0,0,0,0,0,0,0,0
20200520,72697P,穩懋亞東96售01,,,,,,0.00,0,0,0,0,0,0,0,0,0,0,0,0,0
20200520,72703P,聯亞群益96售01,,,,,,0.00,0,0,0,0,0,0,0,0,0,0,0,0,0
20200520,72704P,大江國票96售03,,,,,,0.00,0,0,0,0,0,0,0,0,0,0,0,0,0
20200520,72706P,環球晶國泰96售02,,,,,,0.00,0,0,0,0,0,0,0,0,0,0,0,0,0
20200520,72707P,中美晶國票96售02,0.25,0.25,0.24,0.24,-0.04,-14.29,40000,5,9760,0,0,0,0,0,0,40000,0,40000,40000
20200520,72711P,櫃200永昌96售05,,,,,,0.00,0,0,0,0,0,0,0,0,0,0,0,0,0
20200520,72713P,櫃200元大96售01,,,,,,0.00,0,0,0,0,0,0,0,0,0,0,0,0,0
20200520,72714P,櫃200元大96售02,,,,,,0.00,0,0,0,0,0,0,0,0,0,0,0,0,0
20200520,72716P,穩懋統一96售04,2.69,2.82,2.67,2.82,+0.07,2.55,62000,8,172560,0,0,0,0,0,0,12000,50000,-38000,-38000
20200520,72719P,原相亞東96售02,,,,,,0.00,0,0,0,0,0,0,0,0,0,0,0,0,0
20200520,72732P,櫃200T永昌96售05,,,,,,0.00,0,0,0,0,0,0,0,0,0,0,0,0,0
20200520,72733P,櫃200凱基96售01,,,,,,0.00,0,0,0,0,0,0,0,0,0,0,0,0,0
20200520,72734P,櫃200凱基96售02,,,,,,0.00,0,0,0,0,0,0,0,0,0,0,0,0,0
20200520,72737P,櫃200富邦9A售03,,,,,,0.00,0,0,0,0,0,0,0,0,0,0,0,0,0
20200520,72738P,櫃200富邦9A售04,,,,,,0.00,0,0,0,0,0,0,0,0,0,0,0,0,0
20200520,72740P,中美晶元大95售05,,,,,,0.00,0,0,0,0,0,0,0,0,0,0,0,0,0
20200520,72741P,良維元大95售03,,,,,,0.00,0,0,0,0,0,0,0,0,0,0,0,0,0
20200520,72742P,雙鴻元大95售03,,,,,,0.00,0,0,0,0,0,0,0,0,0,0,0,0,0
20200520,72743P,群聯永豐95售02,0.15,0.15,0.15,0.15,-0.03,-16.67,20000,2,3000,0,0,0,0,0,0,0,20000,-20000,-20000
20200520,72744P,神盾元大95售07,,,,,,0.00,0,0,0,0,0,0,0,0,0,0,0,0,0
20200520,72745P,威剛國票96售01,,,,,,0.00,0,0,0,0,0,0,0,0,0,0,0,0,0
20200520,72746P,大江富邦97售02,0.89,0.91,0.89,0.91,+0.01,1.11,30000,3,27100,0,0,0,0,0,0,20000,10000,10000,10000
20200520,72747P,櫃200T永昌9C售05,,,,,,0.00,0,0,0,0,0,0,0,0,0,0,0,0,0
20200520,72748P,穩懋康和95售01,,,,,,0.00,0,0,0,0,0,0,0,0,0,0,0,0,0
20200520,72749P,金居元大95售04,,,,,,0.00,0,0,0,0,0,0,0,0,0,0,0,0,0
20200520,72750P,精華元大95售04,,,,,,0.00,0,0,0,0,0,0,0,0,0,0,0,0,0
20200520,72751P,元太中信95售02,,,,,,0.00,0,0,0,0,0,0,0,0,0,0,0,0,0
20200520,72752P,環球晶凱基96售02,,,,,,0.00,0,0,0,0,0,0,0,0,0,0,0,0,0
20200520,72753P,新普永豐95售02,,,,,,0.00,0,0,0,0,0,0,0,0,0,0,0,0,0
20200520,72754P,大江群益95售02,,,,,,0.00,0,0,0,0,0,0,0,0,0,0,0,0,0
20200520,72755P,精華凱基95售02,,,,,,0.00,0,0,0,0,0,0,0,0,0,0,0,0,0
20200520,72756P,穩懋凱基95售02,,,,,,0.00,0,0,0,0,0,0,0,0,0,0,0,0,0
20200520,72757P,精華統一95售01,,,,,,0.00,0,0,0,0,0,0,0,0,0,0,0,0,0
20200520,72758P,環球晶凱基95售14,,,,,,0.00,0,0,0,0,0,0,0,0,0,0,0,0,0
20200520,72759P,精華永豐95售03,,,,,,0.00,0,0,0,0,0,0,0,0,0,0,0,0,0
20200520,72760P,精測元大95售01,,,,,,0.00,0,0,0,0,0,0,0,0,0,0,0,0,0
20200520,72761P,中美晶富邦96售01,,,,,,0.00,0,0,0,0,0,0,0,0,0,0,0,0,0
20200520,72762P,穩懋富邦97售02,0.71,0.76,0.71,0.75,+0.06,8.7,295000,15,216790,0,0,0,0,0,0,94000,201000,-107000,-107000
20200520,72763P,精測中信96售01,,,,,,0.00,0,0,0,0,0,0,0,0,0,0,0,0,0
20200520,72764P,中美晶凱基96售02,,,,,,0.00,0,0,0,0,0,0,0,0,0,0,0,0,0
20200520,72765P,精測國泰97售01,,,,,,0.00,0,0,0,0,0,0,0,0,0,0,0,0,0
20200520,72766P,中美晶富邦97售01,,,,,,0.00,0,0,0,0,0,0,0,0,0,0,0,0,0
20200520,72767P,精測康和96售01,,,,,,0.00,0,0,0,0,0,0,0,0,0,0,0,0,0
20200520,72768P,精測凱基96售02,,,,,,0.00,0,0,0,0,0,0,0,0,0,0,0,0,0
20200520,72769P,雙鴻兆豐97售01,,,,,,0.00,0,0,0,0,0,0,0,0,0,0,0,0,0
20200520,72770P,精測永豐96售03,1.63,1.71,1.63,1.71,+0.13,8.23,15000,2,24850,0,0,0,0,0,0,10000,5000,5000,5000
20200520,72771P,鈊象元大96售01,,,,,,0.00,0,0,0,0,0,0,0,0,0,0,0,0,0
20200520,72772P,同致國票97售01,1.73,1.73,1.45,1.60,-0.23,-12.57,5000,4,8070,0,0,0,0,0,0,1000,4000,-3000,-3000
20200520,72773P,鈊象國票96售01,,,,,,0.00,0,0,0,0,0,0,0,0,0,0,0,0,0
20200520,72774P,精測群益96售02,,,,,,0.00,0,0,0,0,0,0,0,0,0,0,0,0,0
20200520,72775P,精測統一96售02,,,,,,0.00,0,0,0,0,0,0,0,0,0,0,0,0,0
20200520,72776P,精測凱基96售05,,,,,,0.00,0,0,0,0,0,0,0,0,0,0,0,0,0
20200520,72777P,櫃200凱基96售04,,,,,,0.00,0,0,0,0,0,0,0,0,0,0,0,0,0
20200520,72778P,櫃200凱基96售05,,,,,,0.00,0,0,0,0,0,0,0,0,0,0,0,0,0
20200520,72779P,鈊象凱基96售02,,,,,,0.00,0,0,0,0,0,0,0,0,0,0,0,0,0
20200520,72780P,鈊象台新96售01,,,,,,0.00,0,0,0,0,0,0,0,0,0,0,0,0,0
20200520,72781P,鈊象永豐96售02,,,,,,0.00,0,0,0,0,0,0,0,0,0,0,0,0,0
20200520,72782P,鈊象康和96售01,0.01,0.01,0.01,0.01,-0.01,-50.0,30000,1,300,0,0,0,0,0,0,30000,0,30000,30000
20200520,72783P,鈊象群益96售01,,,,,,0.00,0,0,0,0,0,0,0,0,0,0,0,0,0
20200520,72784P,精測統一96售03,0.94,0.94,0.85,0.85,-0.02,-2.3,30000,3,27100,0,0,0,0,0,0,20000,10000,10000,10000
20200520,72785P,鈊象元富96售02,,,,,,0.00,0,0,0,0,0,0,0,0,0,0,0,0,0
20200520,72786P,聯亞國票97售02,,,,,,0.00,0,0,0,0,0,0,0,0,0,0,0,0,0
20200520,72787P,精測永豐96售05,,,,,,0.00,0,0,0,0,0,0,0,0,0,0,0,0,0
20200520,72788P,群聯群益96售03,,,,,,0.00,0,0,0,0,0,0,0,0,0,0,0,0,0
20200520,72789P,精測群益96售03,,,,,,0.00,0,0,0,0,0,0,0,0,0,0,0,0,0
20200520,72790P,精華群益96售01,,,,,,0.00,0,0,0,0,0,0,0,0,0,0,0,0,0
20200520,72791P,精測凱基96售06,,,,,,0.00,0,0,0,0,0,0,0,0,0,0,0,0,0
20200520,72792P,穩懋國票96售04,2.24,2.24,2.24,2.24,-0.02,-0.88,2000,2,4480,0,0,0,0,0,0,2000,0,2000,2000
20200520,72793P,穩懋兆豐96售03,,,,,,0.00,0,0,0,0,0,0,0,0,0,0,0,0,0
20200520,72794P,穩懋兆豐97售01,0.57,0.57,0.57,0.57,+0.06,11.76,1000,1,570,0,0,0,0,0,0,1000,0,1000,1000
20200520,72795P,鈊象元大96售02,,,,,,0.00,0,0,0,0,0,0,0,0,0,0,0,0,0
20200520,72796P,穩懋統一97售02,,,,,,0.00,0,0,0,0,0,0,0,0,0,0,0,0,0
20200520,72797P,鈊象統一97售01,,,,,,0.00,0,0,0,0,0,0,0,0,0,0,0,0,0
20200520,72798P,穩懋凱基96售08,0.47,0.51,0.47,0.51,+0.06,13.33,39000,2,18570,0,0,0,0,0,0,39000,0,39000,39000
20200520,72799P,世界永豐96售01,,,,,,0.00,0,0,0,0,0,0,0,0,0,0,0,0,0
20200520,72800P,鈊象元富96售03,,,,,,0.00,0,0,0,0,0,0,0,0,0,0,0,0,0
20200520,72801P,中美晶元大96售01,0.49,0.51,0.49,0.51,-0.10,-16.39,2000,2,1000,0,0,0,0,0,0,0,2000,-2000,-2000
20200520,72802P,世界元大96售04,,,,,,0.00,0,0,0,0,0,0,0,0,0,0,0,0,0
20200520,72803P,中美晶中信98售01,0.93,0.93,0.93,0.93,0.00,0.0,6000,1,5580,0,0,0,0,0,0,0,6000,-6000,-6000
20200520,72804P,世界中信96售02,,,,,,0.00,0,0,0,0,0,0,0,0,0,0,0,0,0
20200520,72805P,鈊象元富96售04,,,,,,0.00,0,0,0,0,0,0,0,0,0,0,0,0,0
20200520,72806P,世界康和96售02,0.81,0.81,0.81,0.81,-0.01,-1.22,57000,2,46170,0,0,0,0,0,0,0,57000,-57000,-57000
20200520,72807P,網龍群益98售02,0.36,0.37,0.36,0.37,+0.02,5.71,72000,5,26000,0,0,0,0,0,0,62000,10000,52000,52000
20200520,72808P,力旺康和96售01,,,,,,0.00,0,0,0,0,0,0,0,0,0,0,0,0,0
20200520,72809P,聯亞元富96售01,,,,,,0.00,0,0,0,0,0,0,0,0,0,0,0,0,0
20200520,72810P,雙鴻元富96售02,,,,,,0.00,0,0,0,0,0,0,0,0,0,0,0,0,0
20200520,72811P,鈊象元富96售05,,,,,,0.00,0,0,0,0,0,0,0,0,0,0,0,0,0
20200520,72812P,世界統一96售01,1.25,1.25,1.25,1.25,+0.01,0.81,73000,4,91250,0,0,0,0,0,0,0,73000,-73000,-73000
20200520,72813P,宣德統一97售01,,,,,,0.00,0,0,0,0,0,0,0,0,0,0,0,0,0
20200520,72814P,世界群益98售03,1.64,1.66,1.64,1.66,+0.04,2.47,154000,3,254100,0,0,0,0,0,0,0,154000,-154000,-154000
20200520,72815P,宣德元大96售05,1.22,1.25,1.15,1.15,-0.24,-17.27,158000,3,194650,0,0,0,0,0,0,83000,75000,8000,8000
20200520,72816P,信昌電國票97售02,,,,,,0.00,0,0,0,0,0,0,0,0,0,0,0,0,0
20200520,72817P,網龍國票97售03,0.42,0.48,0.41,0.48,+0.03,6.67,113000,10,48970,0,0,0,0,0,0,80000,33000,47000,47000
20200520,72818P,櫃200第一96售05,,,,,,0.00,0,0,0,0,0,0,0,0,0,0,0,0,0
20200520,72819P,櫃200第一96售06,,,,,,0.00,0,0,0,0,0,0,0,0,0,0,0,0,0
20200520,72820P,中美晶兆豐97售01,,,,,,0.00,0,0,0,0,0,0,0,0,0,0,0,0,0
20200520,72821P,櫃200永昌97售02,,,,,,0.00,0,0,0,0,0,0,0,0,0,0,0,0,0
20200520,72822P,櫃200永昌97售03,,,,,,0.00,0,0,0,0,0,0,0,0,0,0,0,0,0
20200520,72823P,櫃200永昌99售04,,,,,,0.00,0,0,0,0,0,0,0,0,0,0,0,0,0
20200520,72824P,櫃200永昌99售05,,,,,,0.00,0,0,0,0,0,0,0,0,0,0,0,0,0
20200520,72825P,緯軟永豐96售01,,,,,,0.00,0,0,0,0,0,0,0,0,0,0,0,0,0
20200520,72826P,穩懋統一96售11,1.97,1.97,1.97,1.97,0.00,0.0,1000,1,1970,0,0,0,0,0,0,1000,0,1000,1000
20200520,72827P,穩懋統一96售12,1.65,1.82,1.65,1.73,+0.12,7.45,469000,17,812060,0,0,0,0,0,0,160000,309000,-149000,-149000
20200520,72828P,新普凱基96售01,,,,,,0.00,0,0,0,0,0,0,0,0,0,0,0,0,0
20200520,72829P,神盾群益98售02,,,,,,0.00,0,0,0,0,0,0,0,0,0,0,0,0,0
20200520,72830P,櫃200永昌9B售02,,,,,,0.00,0,0,0,0,0,0,0,0,0,0,0,0,0
20200520,72831P,櫃200永昌9B售03,,,,,,0.00,0,0,0,0,0,0,0,0,0,0,0,0,0
20200520,72832P,櫃200永昌9C售04,1.01,1.02,1.01,1.02,-0.03,-2.86,22000,3,22420,0,0,0,0,0,0,0,22000,-22000,-22000
20200520,72833P,櫃200永昌9C售05,,,,,,0.00,0,0,0,0,0,0,0,0,0,0,0,0,0
20200520,72834P,威剛元富99售01,,,,,,0.00,0,0,0,0,0,0,0,0,0,0,0,0,0
20200520,72835P,環球晶中信9A售01,0.71,0.74,0.71,0.73,+0.01,1.39,139000,9,99830,0,0,0,0,0,0,30000,109000,-79000,-79000
20200520,72836P,聯亞永豐96售02,0.65,0.66,0.65,0.66,-0.02,-2.94,127000,2,82580,0,0,0,0,0,0,127000,0,127000,127000
20200520,72837P,雙鴻永豐96售01,1.37,1.43,1.36,1.43,+0.04,2.88,16000,7,21970,0,0,0,0,0,0,15000,1000,14000,14000
20200520,72838P,M31元大96售03,,,,,,0.00,0,0,0,0,0,0,0,0,0,0,0,0,0
20200520,72839P,世界元富96售03,,,,,,0.00,0,0,0,0,0,0,0,0,0,0,0,0,0
20200520,72840P,聖暉統一97售01,,,,,,0.00,0,0,0,0,0,0,0,0,0,0,0,0,0
20200520,72841P,環球晶凱基96售09,0.33,0.33,0.33,0.33,-0.02,-5.71,100000,1,33000,0,0,0,0,0,0,0,100000,-100000,-100000
20200520,72842P,宣德永豐96售02,,,,,,0.00,0,0,0,0,0,0,0,0,0,0,0,0,0
20200520,72843P,精測永豐96售11,,,,,,0.00,0,0,0,0,0,0,0,0,0,0,0,0,0
20200520,72844P,精測國泰97售03,,,,,,0.00,0,0,0,0,0,0,0,0,0,0,0,0,0
20200520,72845P,精測元大96售05,,,,,,0.00,0,0,0,0,0,0,0,0,0,0,0,0,0
20200520,72846P,穩懋元大96售08,0.90,0.90,0.90,0.90,+0.01,1.12,10000,1,9000,0,0,0,0,0,0,10000,0,10000,10000
20200520,72847P,鈊象元大96售05,,,,,,0.00,0,0,0,0,0,0,0,0,0,0,0,0,0
20200520,72848P,信驊康和96售01,,,,,,0.00,0,0,0,0,0,0,0,0,0,0,0,0,0
20200520,72849P,櫃200永昌98售03,,,,,,0.00,0,0,0,0,0,0,0,0,0,0,0,0,0
20200520,72850P,櫃200永昌98售04,,,,,,0.00,0,0,0,0,0,0,0,0,0,0,0,0,0
20200520,72851P,佳邦永豐96售02,,,,,,0.00,0,0,0,0,0,0,0,0,0,0,0,0,0
20200520,72852P,信昌電永豐96售01,0.87,0.87,0.87,0.87,-0.07,-7.45,25000,1,21750,0,0,0,0,0,0,0,25000,-25000,-25000
20200520,72853P,穩懋元大96售09,1.11,1.11,1.11,1.11,+0.11,11.0,1000,1,1110,0,0,0,0,0,0,1000,0,1000,1000
20200520,72854P,勝麗國票97售02,0.53,0.53,0.53,0.53,-0.04,-7.02,10000,1,5300,0,0,0,0,0,0,10000,0,10000,10000
20200520,72855P,精測元大96售06,,,,,,0.00,0,0,0,0,0,0,0,0,0,0,0,0,0
20200520,72856P,閎康統一96售01,,,,,,0.00,0,0,0,0,0,0,0,0,0,0,0,0,0
20200520,72857P,聯亞凱基96售02,,,,,,0.00,0,0,0,0,0,0,0,0,0,0,0,0,0
20200520,72858P,直得永豐96售02,0.44,0.44,0.44,0.44,-0.07,-13.73,47000,2,20680,0,0,0,0,0,0,0,47000,-47000,-47000
20200520,72859P,原相永豐96售02,,,,,,0.00,0,0,0,0,0,0,0,0,0,0,0,0,0
20200520,72860P,環球晶永豐96售01,,,,,,0.00,0,0,0,0,0,0,0,0,0,0,0,0,0
20200520,72861P,精測群益96售07,,,,,,0.00,0,0,0,0,0,0,0,0,0,0,0,0,0
20200520,72862P,力旺國票96售01,,,,,,0.00,0,0,0,0,0,0,0,0,0,0,0,0,0
20200520,72863P,群聯元大96售05,,,,,,0.00,0,0,0,0,0,0,0,0,0,0,0,0,0
20200520,72864P,良維永豐96售04,1.32,1.32,1.27,1.32,-0.02,-1.49,25000,3,32750,0,0,0,0,0,0,5000,20000,-15000,-15000
20200520,72865P,聯亞國票97售03,1.15,1.15,1.15,1.15,+0.03,2.68,15000,1,17250,0,0,0,0,0,0,15000,0,15000,15000
20200520,72866P,原相台新96售01,,,,,,0.00,0,0,0,0,0,0,0,0,0,0,0,0,0
20200520,72867P,頎邦元富96售03,,,,,,0.00,0,0,0,0,0,0,0,0,0,0,0,0,0
20200520,72868P,頎邦永豐96售01,0.57,0.57,0.57,0.57,-0.03,-5.0,1000,1,570,0,0,0,0,0,0,1000,0,1000,1000
20200520,72869P,頎邦元大96售01,1.33,1.39,1.33,1.36,+0.04,3.03,331000,8,452410,0,0,0,0,0,0,9000,325000,-316000,-316000
20200520,72870P,頎邦群益97售03,1.09,1.10,1.09,1.10,+0.02,1.85,52000,4,57000,0,0,0,0,0,0,0,52000,-52000,-52000
20200520,72871P,鈊象國票97售02,0.11,0.11,0.11,0.11,+0.01,10.0,6000,1,660,0,0,0,0,0,0,0,0,0,0
20200520,72872P,大江永豐96售04,0.75,0.83,0.75,0.83,+0.02,2.47,23000,4,17370,0,0,0,0,0,0,23000,0,23000,23000
20200520,72873P,穩懋凱基96售14,,,,,,0.00,0,0,0,0,0,0,0,0,0,0,0,0,0
20200520,72874P,台燿元富96售01,,,,,,0.00,0,0,0,0,0,0,0,0,0,0,0,0,0
20200520,72875P,碩禾台新97售02,,,,,,0.00,0,0,0,0,0,0,0,0,0,0,0,0,0
20200520,72876P,頎邦康和96售02,,,,,,0.00,0,0,0,0,0,0,0,0,0,0,0,0,0
20200520,72877P,環球晶統一96售03,1.23,1.23,1.23,1.23,-0.01,-0.81,1000,1,1230,0,0,0,0,0,0,0,1000,-1000,-1000
20200520,72878P,穩懋統一96售13,2.23,2.23,2.13,2.23,+0.15,7.21,50000,5,111200,0,0,0,0,0,0,0,50000,-50000,-50000
20200520,72879P,環球晶中信96售03,0.71,0.77,0.71,0.76,+0.05,7.04,265000,8,199750,0,0,0,0,0,0,0,265000,-265000,-265000
20200520,72880P,台燿凱基96售04,,,,,,0.00,0,0,0,0,0,0,0,0,0,0,0,0,0
20200520,72881P,穩懋凱基96售15,,,,,,0.00,0,0,0,0,0,0,0,0,0,0,0,0,0
20200520,72882P,威剛國票96售02,,,,,,0.00,0,0,0,0,0,0,0,0,0,0,0,0,0
20200520,72883P,雍智國泰97售01,0.50,0.50,0.40,0.46,-0.09,-16.36,171000,27,75010,0,0,0,0,0,0,40000,131000,-91000,-91000
20200520,72884P,中美晶元富97售01,1.60,1.67,1.60,1.66,+0.03,1.84,268000,19,436010,0,0,0,0,0,0,173000,95000,78000,78000
20200520,72885P,晶焱永豐97售02,0.94,0.95,0.94,0.95,-0.01,-1.04,127000,8,120080,0,0,0,0,0,0,0,127000,-127000,-127000
20200520,72886P,旺矽康和97售01,0.21,0.21,0.19,0.19,-0.05,-20.83,163000,3,31240,0,0,0,0,0,0,149000,14000,135000,135000
20200520,72887P,威剛康和97售01,0.69,0.70,0.66,0.66,-0.03,-4.35,47000,6,31660,0,0,0,0,0,0,6000,41000,-35000,-35000
20200520,72888P,中美晶中信99售01,0.57,0.57,0.57,0.57,-0.01,-1.72,20000,2,11400,0,0,0,0,0,0,20000,0,20000,20000
20200520,72889P,合晶永豐97售02,,,,,,0.00,0,0,0,0,0,0,0,0,0,0,0,0,0
20200520,72890P,金居永豐97售01,1.44,1.44,1.44,1.44,-0.07,-4.64,5000,1,7200,0,0,0,0,0,0,5000,0,5000,5000
20200520,72891P,優群永豐97售02,0.02,0.05,0.02,0.05,+0.01,25.0,105000,3,2550,0,0,0,0,0,0,90000,0,90000,90000
20200520,72892P,精測康和97售01,,,,,,0.00,0,0,0,0,0,0,0,0,0,0,0,0,0
20200520,72893P,櫃200群益97售03,,,,,,0.00,0,0,0,0,0,0,0,0,0,0,0,0,0
20200520,72894P,中美晶凱基97售03,,,,,,0.00,0,0,0,0,0,0,0,0,0,0,0,0,0
20200520,72895P,穩懋日盛97售03,,,,,,0.00,0,0,0,0,0,0,0,0,0,0,0,0,0
20200520,72896P,廣明永豐97售02,1.45,1.46,1.44,1.46,-0.08,-5.19,141000,5,204450,0,0,0,0,0,0,82000,59000,23000,23000
20200520,72897P,璟德永豐97售01,0.70,0.71,0.70,0.70,-0.03,-4.11,86000,8,60700,0,0,0,0,0,0,4000,82000,-78000,-78000
20200520,72898P,雙鴻國票98售01,,,,,,0.00,0,0,0,0,0,0,0,0,0,0,0,0,0
20200520,72899P,中美晶群益97售02,1.08,1.09,1.07,1.07,-0.02,-1.83,7000,7,7560,0,0,0,0,0,0,7000,0,7000,7000
20200520,72900P,聯亞群益97售01,,,,,,0.00,0,0,0,0,0,0,0,0,0,0,0,0,0
20200520,72901P,穩懋統一97售04,2.39,2.47,2.39,2.47,+0.03,1.23,21000,2,50990,0,0,0,0,0,0,21000,0,21000,21000
20200520,72902P,精測元富97售01,,,,,,0.00,0,0,0,0,0,0,0,0,0,0,0,0,0
20200520,72903P,中美晶國票97售03,2.64,2.68,2.60,2.68,+0.02,0.75,10000,10,26430,0,0,0,0,0,0,6000,4000,2000,2000
20200520,72904P,大江群益97售03,1.42,1.44,1.42,1.44,-0.07,-4.64,13000,2,18480,0,0,0,0,0,0,13000,0,13000,13000
20200520,72905P,穩懋國泰98售01,1.80,1.82,1.73,1.77,+0.13,7.93,575000,12,1021000,0,0,0,0,0,0,575000,285000,290000,290000
20200520,72906P,穩懋國泰99售01,1.53,1.61,1.53,1.61,+0.12,8.05,330000,7,524170,0,0,0,0,0,0,325000,330000,-5000,-5000
20200520,72907P,穩懋兆豐98售01,,,,,,0.00,0,0,0,0,0,0,0,0,0,0,0,0,0
20200520,72908P,原相永豐97售01,,,,,,0.00,0,0,0,0,0,0,0,0,0,0,0,0,0
20200520,72909P,穩懋永豐97售01,1.11,1.17,1.11,1.16,+0.06,5.45,157000,7,181270,0,0,0,0,0,0,33000,124000,-91000,-91000
20200520,72910P,穩懋統一99售02,2.81,2.81,2.81,2.81,+0.13,4.85,110000,2,309100,0,0,0,0,0,0,0,110000,-110000,-110000
20200520,72911P,穩懋元大97售05,1.44,1.59,1.44,1.53,+0.10,6.99,201000,17,311000,0,0,0,0,0,0,145000,184000,-39000,-39000
20200520,72912P,原相中信99售02,0.64,0.67,0.63,0.65,+0.03,4.84,325000,10,210850,0,0,0,0,0,0,100000,219000,-119000,-119000
20200520,72913P,旺矽統一97售02,,,,,,0.00,0,0,0,0,0,0,0,0,0,0,0,0,0
20200520,72914P,穩懋元大97售06,1.70,1.74,1.67,1.71,+0.17,11.04,390000,18,670320,0,0,0,0,0,0,330000,297000,33000,33000
20200520,72915P,中美晶凱基97售06,,,,,,0.00,0,0,0,0,0,0,0,0,0,0,0,0,0
20200520,72916P,穩懋凱基97售04,1.43,1.43,1.43,1.43,+0.06,4.38,29000,1,41470,0,0,0,0,0,0,29000,0,29000,29000
20200520,72917P,網龍國票98售01,0.87,0.92,0.86,0.92,+0.03,3.37,260000,24,230560,0,0,0,0,0,0,154000,102000,52000,52000
20200520,72918P,環球晶元富97售02,1.19,1.19,1.18,1.18,+0.06,5.36,60000,2,70900,0,0,0,0,0,0,60000,60000,0,0
20200520,72919P,聯亞元富97售02,1.88,1.92,1.88,1.89,-0.01,-0.53,438000,9,831700,0,0,0,0,0,0,238000,200000,38000,38000
20200520,72920P,雙鴻元富97售02,,,,,,0.00,0,0,0,0,0,0,0,0,0,0,0,0,0
20200520,72921P,雙鴻元大98售01,,,,,,0.00,0,0,0,0,0,0,0,0,0,0,0,0,0
20200520,72922P,原相亞東99售01,,,,,,0.00,0,0,0,0,0,0,0,0,0,0,0,0,0
20200520,72923P,台燿永豐97售01,0.32,0.38,0.32,0.38,+0.04,11.76,33000,9,11290,0,0,0,0,0,0,17000,16000,1000,1000
20200520,72924P,精測凱基97售05,,,,,,0.00,0,0,0,0,0,0,0,0,0,0,0,0,0
20200520,72925P,鈊象凱基97售02,,,,,,0.00,0,0,0,0,0,0,0,0,0,0,0,0,0
20200520,72926P,精華元大97售02,2.64,2.64,2.64,2.64,-0.06,-2.22,40000,3,105600,0,0,0,0,0,0,0,40000,-40000,-40000
20200520,72927P,大江元富97售02,,,,,,0.00,0,0,0,0,0,0,0,0,0,0,0,0,0
20200520,72928P,宜鼎元富97售02,,,,,,0.00,0,0,0,0,0,0,0,0,0,0,0,0,0
20200520,72929P,信驊元富97售02,0.12,0.12,0.12,0.12,-0.07,-36.84,3000,1,360,0,0,0,0,0,0,0,3000,-3000,-3000
20200520,72930P,威剛元富97售03,,,,,,0.00,0,0,0,0,0,0,0,0,0,0,0,0,0
20200520,72931P,新普元富97售02,0.61,0.65,0.61,0.65,+0.02,3.17,440000,11,271000,0,0,0,0,0,0,375000,65000,310000,310000
20200520,72932P,網家元富97售02,0.22,0.22,0.16,0.19,-0.09,-32.14,622000,13,114670,0,0,0,0,0,0,103000,519000,-416000,-416000
20200520,72933P,碩禾永豐97售01,1.63,1.63,1.58,1.58,-0.08,-4.82,160000,4,257550,0,0,0,0,0,0,0,160000,-160000,-160000
20200520,72934P,晟德永豐97售01,1.98,1.98,1.83,1.88,-0.13,-6.47,41000,4,77880,0,0,0,0,0,0,20000,21000,-1000,-1000
20200520,72935P,鈊象永豐97售03,0.34,0.35,0.34,0.35,-0.04,-10.26,10000,5,3440,0,0,0,0,0,0,10000,0,10000,10000
20200520,72936P,鈊象元富97售03,0.25,0.25,0.25,0.25,0.00,0.0,10000,1,2500,0,0,0,0,0,0,0,10000,-10000,-10000
20200520,72937P,櫃200元大99售01,,,,,,0.00,0,0,0,0,0,0,0,0,0,0,0,0,0
20200520,72938P,櫃200元大99售02,,,,,,0.00,0,0,0,0,0,0,0,0,0,0,0,0,0
20200520,72939P,網龍元大97售02,1.33,1.98,1.32,1.98,+0.10,5.32,137000,17,249420,0,0,0,0,0,0,109000,8000,101000,101000
20200520,72940P,環球晶群益97售04,1.71,1.71,1.71,1.71,-0.05,-2.84,10000,1,17100,0,0,0,0,0,0,10000,0,10000,10000
20200520,72941P,環球晶統一97售03,,,,,,0.00,0,0,0,0,0,0,0,0,0,0,0,0,0
20200520,72942P,群聯元富97售01,,,,,,0.00,0,0,0,0,0,0,0,0,0,0,0,0,0
20200520,72943P,雙鴻元富97售03,,,,,,0.00,0,0,0,0,0,0,0,0,0,0,0,0,0
20200520,72944P,信昌電元富97售01,,,,,,0.00,0,0,0,0,0,0,0,0,0,0,0,0,0
20200520,72945P,大江永豐97售04,1.61,1.66,1.61,1.66,-0.01,-0.6,26000,3,42610,0,0,0,0,0,0,11000,15000,-4000,-4000
20200520,72946P,穩懋富邦99售02,1.29,1.36,1.29,1.35,+0.09,7.14,567000,29,756220,0,0,0,0,0,0,221000,378000,-157000,-157000
20200520,72947P,環球晶凱基97售08,2.14,2.14,2.14,2.14,+0.04,1.9,1000,1,2140,0,0,0,0,0,0,1000,0,1000,1000
20200520,72948P,大江元大97售06,0.59,0.60,0.59,0.60,-0.02,-3.23,43000,3,25420,0,0,0,0,0,0,28000,15000,13000,13000
20200520,72949P,環球晶永豐97售02,1.30,1.37,1.30,1.36,+0.04,3.03,112000,7,150450,0,0,0,0,0,0,70000,102000,-32000,-32000
20200520,72950P,中美晶元富97售02,2.55,2.63,2.55,2.63,+0.05,1.94,70000,12,182070,0,0,0,0,0,0,18000,52000,-34000,-34000
20200520,72951P,宣德元富97售02,,,,,,0.00,0,0,0,0,0,0,0,0,0,0,0,0,0
20200520,72952P,群聯元富97售02,,,,,,0.00,0,0,0,0,0,0,0,0,0,0,0,0,0
20200520,72953P,環球晶元富97售05,2.19,2.19,2.19,2.19,-0.03,-1.35,30000,1,65700,0,0,0,0,0,0,30000,30000,0,0
20200520,72954P,穩懋元富97售05,,,,,,0.00,0,0,0,0,0,0,0,0,0,0,0,0,0
20200520,72955P,中美晶元大98售02,1.60,1.60,1.60,1.60,+0.01,0.63,2000,1,3200,0,0,0,0,0,0,0,2000,-2000,-2000
20200520,72956P,信驊元大98售01,0.29,0.35,0.29,0.35,+0.01,2.94,186000,12,58110,0,0,0,0,0,0,75000,111000,-36000,-36000
20200520,72957P,精測元富98售01,,,,,,0.00,0,0,0,0,0,0,0,0,0,0,0,0,0
20200520,72958P,威剛元大98售03,,,,,,0.00,0,0,0,0,0,0,0,0,0,0,0,0,0
20200520,72959P,大江永豐98售02,,,,,,0.00,0,0,0,0,0,0,0,0,0,0,0,0,0
20200520,72960P,中美晶永豐98售01,,,,,,0.00,0,0,0,0,0,0,0,0,0,0,0,0,0
20200520,72961P,環球晶國泰99售01,,,,,,0.00,0,0,0,0,0,0,0,0,0,0,0,0,0
20200520,72962P,鈊象元富98售01,0.50,0.50,0.50,0.50,-0.02,-3.85,1000,1,500,0,0,0,0,0,0,0,0,0,0
20200520,72963P,環球晶凱基98售03,1.66,1.70,1.66,1.70,+0.03,1.8,146000,3,246560,0,0,0,0,0,0,100000,46000,54000,54000
20200520,72964P,環球晶元大98售05,2.27,2.27,2.27,2.27,-0.01,-0.44,13000,1,29510,0,0,0,0,0,0,0,13000,-13000,-13000
20200520,72965P,環球晶元大98售06,2.28,2.37,2.28,2.37,+0.09,3.95,17000,2,39120,0,0,0,0,0,0,0,17000,-17000,-17000
20200520,72966P,環球晶元大98售07,2.18,2.28,2.18,2.26,+0.03,1.35,56000,6,125140,0,0,0,0,0,0,30000,26000,4000,4000
20200520,72967P,精測國泰9A售02,,,,,,0.00,0,0,0,0,0,0,0,0,0,0,0,0,0
20200520,72968P,大江元富98售03,,,,,,0.00,0,0,0,0,0,0,0,0,0,0,0,0,0
20200520,72969P,精測元大98售03,6.25,6.25,6.25,6.25,0.00,0.0,7000,1,43750,0,0,0,0,0,0,0,7000,-7000,-7000
20200520,72970P,原相永豐98售01,0.84,0.88,0.84,0.88,+0.04,4.76,83000,11,71820,0,0,0,0,0,0,20000,73000,-53000,-53000
20200520,72971P,穩懋凱基98售05,2.95,3.01,2.95,3.00,+0.12,4.17,57000,6,169840,0,0,0,0,0,0,22000,35000,-13000,-13000
20200520,72972P,大江元富98售04,,,,,,0.00,0,0,0,0,0,0,0,0,0,0,0,0,0
20200520,72973P,大江富邦9A售03,0.49,0.51,0.49,0.51,+0.01,2.0,125000,7,62470,0,0,0,0,0,0,65000,60000,5000,5000
20200520,72974P,精測元大98售04,2.05,2.05,2.05,2.05,+0.09,4.59,10000,2,20500,0,0,0,0,0,0,0,10000,-10000,-10000
20200520,72975P,緯軟元大9A售01,,,,,,0.00,0,0,0,0,0,0,0,0,0,0,0,0,0
20200520,72976P,環球晶元大98售08,1.36,1.39,1.36,1.39,-0.09,-6.08,25000,4,34040,0,0,0,0,0,0,25000,0,25000,25000
20200520,72977P,晶焱永豐98售02,0.91,0.92,0.91,0.91,-0.05,-5.21,134000,4,122310,0,0,0,0,0,0,30000,104000,-74000,-74000
20200520,72978P,新鉅科元大98售02,3.76,3.76,3.67,3.67,-0.11,-2.91,18000,3,66650,0,0,0,0,0,0,13000,5000,8000,8000
20200520,72979P,聯亞元大98售02,,,,,,0.00,0,0,0,0,0,0,0,0,0,0,0,0,0
20200520,72980P,穩懋元大98售03,,,,,,0.00,0,0,0,0,0,0,0,0,0,0,0,0,0
20200520,72981P,聯亞凱基98售03,0.61,0.61,0.59,0.59,-0.03,-4.84,175000,3,105650,0,0,0,0,0,0,175000,0,175000,175000
20200520,72982P,精測元大98售05,,,,,,0.00,0,0,0,0,0,0,0,0,0,0,0,0,0
20200520,72983P,穩懋元大98售04,5.60,5.60,5.60,5.60,0.00,0.0,18000,4,100800,0,0,0,0,0,0,2000,16000,-14000,-14000
20200520,72984P,威剛永豐98售02,1.64,1.64,1.64,1.64,+0.03,1.86,5000,1,8200,0,0,0,0,0,0,0,5000,-5000,-5000
20200520,72985P,群聯元富98售03,4.50,4.58,4.50,4.56,+0.01,0.22,106000,21,482990,0,0,0,0,0,0,7000,99000,-92000,-92000
20200520,72986P,環球晶元大98售11,,,,,,0.00,0,0,0,0,0,0,0,0,0,0,0,0,0
20200520,72987P,環球晶元大98售12,3.77,3.88,3.77,3.88,+0.07,1.84,48000,3,182060,0,0,0,0,0,0,30000,18000,12000,12000
20200520,72988P,聯亞元大98售03,1.27,1.27,1.24,1.24,-0.06,-4.62,130000,3,163100,0,0,0,0,0,0,60000,70000,-10000,-10000
20200520,72989P,信昌電永豐98售02,1.21,1.25,1.21,1.25,-0.07,-5.3,95000,4,116780,0,0,0,0,0,0,49000,46000,3000,3000
20200520,72990P,環球晶凱基98售06,1.23,1.23,1.18,1.18,+0.02,1.72,31000,2,36630,0,0,0,0,0,0,30000,1000,29000,29000
20200520,72991P,穩懋凱基98售08,3.69,3.71,3.69,3.71,+0.10,2.77,2000,2,7400,0,0,0,0,0,0,2000,0,2000,2000
20200520,72992P,穩懋永豐98售02,,,,,,0.00,0,0,0,0,0,0,0,0,0,0,0,0,0
20200520,72993P,穩懋元富98售01,2.84,3.02,2.84,3.02,+0.25,9.03,330000,9,980940,0,0,0,0,0,0,293000,74000,219000,219000
20200520,72994P,穩懋元富98售02,4.57,4.57,4.57,4.57,-0.09,-1.93,17000,1,77690,0,0,0,0,0,0,17000,0,17000,17000
20200520,72995P,雙鴻兆豐99售02,0.53,0.53,0.52,0.52,0.00,0.0,155000,2,80610,0,0,0,0,0,0,155000,0,155000,155000
20200520,72996P,力旺元富98售02,1.23,1.42,1.17,1.42,-0.01,-0.7,349000,30,446720,0,0,0,0,0,0,15000,334000,-319000,-319000
20200520,72997P,精測台新98售02,,,,,,0.00,0,0,0,0,0,0,0,0,0,0,0,0,0
20200520,72998P,穩懋台新98售01,,,,,,0.00,0,0,0,0,0,0,0,0,0,0,0,0,0
20200520,72999P,環球晶群益98售03,,,,,,0.00,0,0,0,0,0,0,0,0,0,0,0,0,0
20200520,73000P,穩懋富邦99售03,,,,,,0.00,0,0,0,0,0,0,0,0,0,0,0,0,0
20200520,73001P,譜瑞元大98售05,2.03,2.27,1.99,2.27,+0.08,3.65,63000,11,136450,0,0,0,0,0,0,25000,38000,-13000,-13000
20200520,73002P,精測元富98售03,3.70,3.78,3.68,3.72,+0.04,1.09,261000,27,982920,0,0,0,0,0,0,170000,90000,80000,80000
20200520,73003P,神盾群益9A售04,1.34,1.40,1.34,1.40,+0.03,2.19,197000,9,269440,0,0,0,0,0,0,0,197000,-197000,-197000
20200520,73004P,譜瑞台新99售01,0.39,0.45,0.39,0.45,+0.05,12.5,65000,4,27250,0,0,0,0,0,0,25000,40000,-15000,-15000
20200520,73005P,中美晶元大98售07,2.48,2.52,2.48,2.49,+0.03,1.22,69000,4,171470,0,0,0,0,0,0,57000,20000,37000,37000
20200520,73006P,聯亞元大98售04,1.86,1.88,1.85,1.88,-0.04,-2.08,187000,6,348620,0,0,0,0,0,0,30000,157000,-127000,-127000
20200520,73007P,中美晶元富98售01,2.25,2.25,2.25,2.25,0.00,0.0,10000,1,22500,0,0,0,0,0,0,10000,0,10000,10000
20200520,73008P,合晶元富98售02,,,,,,0.00,0,0,0,0,0,0,0,0,0,0,0,0,0
20200520,73009P,原相元富98售02,1.52,1.55,1.52,1.55,+0.06,4.03,127000,5,194780,0,0,0,0,0,0,0,127000,-127000,-127000
20200520,73010P,勝麗元富98售01,,,,,,0.00,0,0,0,0,0,0,0,0,0,0,0,0,0
20200520,73011P,原相台新98售01,,,,,,0.00,0,0,0,0,0,0,0,0,0,0,0,0,0
20200520,73012P,威剛統一98售02,,,,,,0.00,0,0,0,0,0,0,0,0,0,0,0,0,0
20200520,73013P,中美晶群益98售05,,,,,,0.00,0,0,0,0,0,0,0,0,0,0,0,0,0
20200520,73014P,環球晶國泰9A售02,,,,,,0.00,0,0,0,0,0,0,0,0,0,0,0,0,0
20200520,73015P,碩禾元大99售04,,,,,,0.00,0,0,0,0,0,0,0,0,0,0,0,0,0
20200520,73016P,精測元大98售06,6.25,6.40,6.25,6.40,+0.15,2.4,68000,7,431700,0,0,0,0,0,0,0,68000,-68000,-68000
20200520,73017P,環球晶統一99售05,,,,,,0.00,0,0,0,0,0,0,0,0,0,0,0,0,0
20200520,73018P,威剛國票99售02,2.22,2.29,2.21,2.28,+0.03,1.33,33000,8,74990,0,0,0,0,0,0,4000,29000,-25000,-25000
20200520,73019P,穩懋國泰99售02,,,,,,0.00,0,0,0,0,0,0,0,0,0,0,0,0,0
20200520,73020P,穩懋亞東98售02,2.44,2.44,2.44,2.44,+0.19,8.44,10000,1,24400,0,0,0,0,0,0,10000,10000,0,0
20200520,73021P,原相元大99售02,,,,,,0.00,0,0,0,0,0,0,0,0,0,0,0,0,0
20200520,73022P,台燿中信9A售02,0.73,0.78,0.73,0.78,+0.04,5.41,209000,9,158290,0,0,0,0,0,0,204000,5000,199000,199000
20200520,73023P,新普中信9C售01,0.68,0.70,0.68,0.69,-0.01,-1.43,82000,5,56760,0,0,0,0,0,0,42000,40000,2000,2000
20200520,73024P,譜瑞中信9C售01,,,,,,0.00,0,0,0,0,0,0,0,0,0,0,0,0,0
20200520,73025P,譜瑞凱基98售03,0.71,0.71,0.40,0.46,+0.02,4.55,656000,22,281400,0,0,0,0,0,0,157000,498000,-341000,-341000
20200520,73026P,泰博永豐98售02,0.34,0.49,0.33,0.36,-0.13,-26.53,171000,29,63710,0,0,0,0,0,0,0,0,0,0
20200520,73027P,雙鴻元大9A售02,0.96,0.99,0.95,0.98,+0.01,1.03,185000,13,179560,0,0,0,0,0,0,84000,133000,-49000,-49000
20200520,73028P,中美晶統一9B售01,1.30,1.31,1.30,1.31,0.00,0.0,25000,7,32540,0,0,0,0,0,0,25000,0,25000,25000
20200520,73029P,中美晶凱基99售06,2.05,2.08,2.05,2.08,+0.09,4.52,136000,5,280860,0,0,0,0,0,0,0,136000,-136000,-136000
20200520,73030P,大江群益99售01,1.02,1.08,1.02,1.08,0.00,0.0,61000,5,62770,0,0,0,0,0,0,61000,0,61000,61000
20200520,73031P,宏捷科康和99售02,2.26,2.26,2.26,2.26,+0.01,0.44,1000,1,2260,0,0,0,0,0,0,0,1000,-1000,-1000
20200520,73032P,雙鴻群益9B售01,0.89,0.89,0.89,0.89,+0.02,2.3,22000,2,19580,0,0,0,0,0,0,0,22000,-22000,-22000
20200520,73033P,宏捷科國票99售01,1.99,2.05,1.99,2.03,-0.02,-0.98,144000,11,289840,0,0,0,0,0,0,62000,82000,-20000,-20000
20200520,73034P,大江富邦9B售01,0.60,0.60,0.60,0.60,+0.01,1.69,2000,1,1200,0,0,0,0,0,0,2000,0,2000,2000
20200520,73035P,中美晶台新99售01,,,,,,0.00,0,0,0,0,0,0,0,0,0,0,0,0,0
20200520,73036P,鈊象永豐99售02,0.98,0.98,0.94,0.98,0.00,0.0,299000,20,287580,0,0,0,0,0,0,0,299000,-299000,-299000
20200520,73037P,海韻電元富99售02,0.56,0.56,0.56,0.56,+0.01,1.82,20000,1,11200,0,0,0,0,0,0,20000,0,20000,20000
20200520,73038P,中美晶台新99售02,,,,,,0.00,0,0,0,0,0,0,0,0,0,0,0,0,0
20200520,73039P,原相台新99售01,1.62,1.65,1.62,1.65,+0.06,3.77,158000,9,257320,0,0,0,0,0,0,8000,150000,-142000,-142000
20200520,73040P,穩懋凱基99售04,1.34,1.43,1.34,1.42,+0.09,6.77,173000,20,242870,0,0,0,0,0,0,38000,143000,-105000,-105000
20200520,73041P,穩懋統一9B售02,0.90,0.95,0.90,0.94,+0.09,10.59,1507000,5,1361740,0,0,0,0,0,0,1497000,1507000,-10000,-10000
20200520,73042P,原相元大99售04,2.40,2.42,2.40,2.40,+0.09,3.9,34000,9,82020,0,0,0,0,0,0,0,34000,-34000,-34000
20200520,73043P,穩懋元大99售04,2.99,2.99,2.99,2.99,+0.27,9.93,10000,1,29900,0,0,0,0,0,0,0,10000,-10000,-10000
20200520,73044P,原相國票9A售01,2.08,2.15,2.08,2.13,+0.05,2.4,359000,22,761530,0,0,0,0,0,0,11000,340000,-329000,-329000
20200520,73045P,雙鴻國票9A售02,1.19,1.23,1.19,1.23,+0.02,1.65,140000,7,170470,0,0,0,0,0,0,12000,128000,-116000,-116000
20200520,73046P,神盾群益9A售05,1.47,1.47,1.47,1.47,-0.01,-0.68,5000,1,7350,0,0,0,0,0,0,0,5000,-5000,-5000
20200520,73047P,宏捷科元富9C售03,1.82,1.87,1.82,1.84,+0.03,1.66,501000,25,930240,0,0,0,0,0,0,17000,484000,-467000,-467000
20200520,73048P,中美晶中信9B售01,1.06,1.06,1.05,1.05,0.00,0.0,29000,2,30700,0,0,0,0,0,0,4000,25000,-21000,-21000
20200520,73049P,宏捷科元大99售05,0.98,0.98,0.96,0.98,+0.02,2.08,72000,7,70070,0,0,0,0,0,0,6000,66000,-60000,-60000
20200520,73050P,雍智元大99售02,0.49,0.50,0.44,0.48,-0.05,-9.43,474000,19,228980,0,0,0,0,0,0,23000,427000,-404000,-404000
20200520,73051P,台燿元富9C售02,2.77,2.89,2.77,2.89,+0.09,3.21,126000,20,354480,0,0,0,0,0,0,107000,18000,89000,89000
20200520,73052P,原相統一99售03,1.27,1.27,1.25,1.25,+0.04,3.31,11000,2,13770,0,0,0,0,0,0,10000,1000,9000,9000
20200520,73053P,原相統一9A售02,1.05,1.05,1.04,1.04,+0.01,0.97,2000,2,2090,0,0,0,0,0,0,1000,1000,0,0
20200520,73054P,穩懋元大99售08,1.82,1.85,1.82,1.85,+0.01,0.54,26000,2,47350,0,0,0,0,0,0,26000,0,26000,26000
20200520,73055P,信驊永豐99售03,0.45,0.48,0.42,0.48,+0.01,2.13,430000,15,190930,0,0,0,0,0,0,245000,180000,65000,65000
20200520,73056P,原相永豐99售02,0.95,0.95,0.95,0.95,+0.02,2.15,8000,4,7600,0,0,0,0,0,0,1000,7000,-6000,-6000
20200520,73057P,環球晶兆豐99售02,1.96,1.96,1.96,1.96,+0.03,1.55,5000,1,9800,0,0,0,0,0,0,5000,0,5000,5000
20200520,73058P,原相統一9B售02,1.15,1.17,1.15,1.17,+0.02,1.74,24000,3,27870,0,0,0,0,0,0,0,24000,-24000,-24000
20200520,73059P,鈊象元大99售05,1.55,1.59,1.54,1.59,+0.01,0.63,516000,26,806060,0,0,0,0,0,0,383000,130000,253000,253000
20200520,73060P,環球晶凱基99售06,1.21,1.21,1.21,1.21,+0.01,0.83,25000,1,30250,0,0,0,0,0,0,0,25000,-25000,-25000
20200520,73061P,群聯元大9A售01,1.09,1.19,1.09,1.19,+0.11,10.19,4000,2,4660,0,0,0,0,0,0,1000,0,1000,1000
20200520,73062P,群聯凱基99售02,5.60,5.65,5.60,5.65,-0.05,-0.88,8000,2,45050,0,0,0,0,0,0,0,8000,-8000,-8000
20200520,73063P,環球晶凱基99售10,,,,,,0.00,0,0,0,0,0,0,0,0,0,0,0,0,0
20200520,73064P,中美晶富邦9B售02,0.82,0.82,0.82,0.82,+0.01,1.23,10000,1,8200,0,0,0,0,0,0,10000,0,10000,10000
20200520,73065P,鈊象元富99售01,,,,,,0.00,0,0,0,0,0,0,0,0,0,0,0,0,0
20200520,73066P,環球晶元大99售07,1.34,1.40,1.34,1.40,+0.03,2.19,47000,7,63240,0,0,0,0,0,0,27000,20000,7000,7000
20200520,73067P,環球晶元大99售08,,,,,,0.00,0,0,0,0,0,0,0,0,0,0,0,0,0
20200520,73068P,穩懋元大99售12,,,,,,0.00,0,0,0,0,0,0,0,0,0,0,0,0,0
20200520,73069P,聯亞富邦9B售01,,,,,,0.00,0,0,0,0,0,0,0,0,0,0,0,0,0
20200520,73070P,元太亞東99售02,0.29,0.29,0.17,0.27,-0.02,-6.9,13000,3,3150,0,0,0,0,0,0,5000,8000,-3000,-3000
20200520,73071P,雙鴻元富99售02,0.69,0.69,0.69,0.69,+0.01,1.47,4000,1,2760,0,0,0,0,0,0,0,4000,-4000,-4000
20200520,73072P,環球晶元大99售12,,,,,,0.00,0,0,0,0,0,0,0,0,0,0,0,0,0
20200520,73073P,穩懋元大99售19,3.45,3.51,3.45,3.51,+0.12,3.54,49000,3,170230,0,0,0,0,0,0,24000,25000,-1000,-1000
20200520,73074P,聯亞國票99售04,,,,,,0.00,0,0,0,0,0,0,0,0,0,0,0,0,0
20200520,73075P,中美晶元大99售06,1.28,1.29,1.28,1.29,+0.01,0.78,108000,2,138380,0,0,0,0,0,0,94000,14000,80000,80000
20200520,73076P,中美晶元大99售07,1.18,1.21,1.18,1.21,+0.02,1.68,110000,2,130100,0,0,0,0,0,0,100000,10000,90000,90000
20200520,73077P,環球晶元大99售16,,,,,,0.00,0,0,0,0,0,0,0,0,0,0,0,0,0
20200520,73078P,環球晶元大99售17,,,,,,0.00,0,0,0,0,0,0,0,0,0,0,0,0,0
20200520,73079P,環球晶凱基99售14,0.68,0.69,0.68,0.69,+0.02,2.99,7000,3,4770,0,0,0,0,0,0,0,7000,-7000,-7000
20200520,73080P,穩懋凱基99售11,0.80,0.84,0.80,0.83,+0.03,3.75,268000,14,220090,0,0,0,0,0,0,166000,102000,64000,64000
20200520,73081P,環球晶國泰9A售04,1.22,1.25,1.22,1.25,+0.03,2.46,177000,8,217820,0,0,0,0,0,0,0,177000,-177000,-177000
20200520,73082P,精測元富9A售01,1.61,1.64,1.58,1.64,+0.04,2.5,115000,5,186680,0,0,0,0,0,0,27000,88000,-61000,-61000
20200520,73083P,環球晶凱基9A售03,,,,,,0.00,0,0,0,0,0,0,0,0,0,0,0,0,0
20200520,73084P,穩懋凱基9A售03,0.88,0.89,0.88,0.88,+0.02,2.33,97000,6,85730,0,0,0,0,0,0,59000,38000,21000,21000
20200520,73085P,群聯國票9A售02,1.48,1.52,1.48,1.49,-0.07,-4.49,205000,16,307290,0,0,0,0,0,0,2000,203000,-201000,-201000
20200520,73086P,鈊象國票9A售01,2.44,2.49,2.44,2.49,+0.01,0.4,26000,4,63640,0,0,0,0,0,0,22000,4000,18000,18000
20200520,73087P,穩懋元大9A售03,2.10,2.16,2.10,2.13,+0.06,2.9,247000,27,526340,0,0,0,0,0,0,125000,122000,3000,3000
20200520,73088P,穩懋元大9A售04,2.06,2.12,2.06,2.11,+0.05,2.43,65000,4,135800,0,0,0,0,0,0,45000,20000,25000,25000
20200520,73089P,群聯凱基9A售03,,,,,,0.00,0,0,0,0,0,0,0,0,0,0,0,0,0
20200520,73090P,環球晶國票9A售01,1.93,1.93,1.93,1.93,-0.01,-0.52,62000,1,119660,0,0,0,0,0,0,62000,0,62000,62000
20200520,73091P,穩懋康和9A售01,,,,,,0.00,0,0,0,0,0,0,0,0,0,0,0,0,0
20200520,73092P,新普元大9A售01,1.50,1.55,1.49,1.54,+0.01,0.65,383000,16,583440,0,0,0,0,0,0,293000,90000,203000,203000
20200520,73093P,精測凱基9A售03,0.88,0.89,0.88,0.89,+0.02,2.3,117000,4,103120,0,0,0,0,0,0,1000,116000,-115000,-115000
20200520,73094P,中美晶國票9A售03,1.24,1.24,1.24,1.24,+0.04,3.33,3000,3,3720,0,0,0,0,0,0,0,3000,-3000,-3000
20200520,73095P,穩懋元大9A售05,1.64,1.70,1.64,1.68,+0.05,3.07,561000,20,938360,0,0,0,0,0,0,483000,48000,435000,435000
20200520,73096P,世界元大9A售02,1.22,1.27,1.20,1.25,0.00,0.0,91000,10,114520,0,0,0,0,0,0,10000,81000,-71000,-71000
20200520,73097P,群聯元大9A售04,2.60,2.63,2.59,2.59,-0.01,-0.38,39000,4,101840,0,0,0,0,0,0,7000,32000,-25000,-25000
20200520,73098P,信驊凱基9A售02,0.67,0.69,0.66,0.69,-0.01,-1.43,140000,14,93790,0,0,0,0,0,0,0,140000,-140000,-140000
20200520,73099P,穩懋國泰9B售02,2.17,2.27,2.17,2.26,+0.09,4.15,282000,21,629620,0,0,0,0,0,0,126000,151000,-25000,-25000
20200520,73100P,神盾元富9A售02,0.94,1.01,0.94,1.01,+0.02,2.02,282000,18,279670,0,0,0,0,0,0,133000,149000,-16000,-16000
20200520,73101P,中美晶凱基9A售05,,,,,,0.00,0,0,0,0,0,0,0,0,0,0,0,0,0
20200520,73102P,原相元大9A售06,1.27,1.27,1.27,1.27,+0.04,3.25,38000,2,48260,0,0,0,0,0,0,0,38000,-38000,-38000
20200520,73103P,穩懋富邦9C售01,1.07,1.09,1.07,1.09,+0.03,2.83,208000,4,224680,0,0,0,0,0,0,206000,2000,204000,204000
20200520,73104P,原相元大9A售07,1.29,1.29,1.29,1.29,+0.02,1.57,35000,1,45150,0,0,0,0,0,0,0,35000,-35000,-35000
20200520,73105P,穩懋國票9A售03,3.17,3.17,3.17,3.17,+0.08,2.59,35000,2,110950,0,0,0,0,0,0,35000,0,35000,35000
20200520,73106P,原相永豐9A售03,0.91,0.92,0.91,0.92,0.00,0.0,271000,6,248000,0,0,0,0,0,0,0,271000,-271000,-271000
20200520,73107P,原相國票9B售02,0.98,0.99,0.98,0.99,+0.01,1.02,211000,4,208790,0,0,0,0,0,0,0,211000,-211000,-211000
20200520,73108P,鈊象國票9A售03,3.29,3.29,3.29,3.29,-0.05,-1.5,14000,2,46060,0,0,0,0,0,0,14000,0,14000,14000
20200520,73109P,神盾永豐9A售04,,,,,,0.00,0,0,0,0,0,0,0,0,0,0,0,0,0
20200520,73110P,環球晶統一9A售01,0.67,0.68,0.67,0.68,+0.01,1.49,110000,2,74700,0,0,0,0,0,0,0,110000,-110000,-110000
20200520,73111P,穩懋統一9A售03,,,,,,0.00,0,0,0,0,0,0,0,0,0,0,0,0,0
20200520,73112P,信驊國票9A售03,0.97,0.97,0.97,0.97,-0.05,-4.9,8000,1,7760,0,0,0,0,0,0,0,8000,-8000,-8000
20200520,73113P,穩懋國票9A售04,2.57,2.57,2.57,2.57,+0.11,4.47,5000,1,12850,0,0,0,0,0,0,5000,0,5000,5000
20200520,73114P,穩懋元大9A售06,2.84,2.92,2.84,2.90,+0.01,0.35,47000,5,136020,0,0,0,0,0,0,25000,22000,3000,3000
20200520,73115P,鈊象元大9A售03,3.26,3.33,3.23,3.33,+0.05,1.52,263000,12,868410,0,0,0,0,0,0,247000,16000,231000,231000
20200520,73116P,原相凱基9A售04,,,,,,0.00,0,0,0,0,0,0,0,0,0,0,0,0,0
20200520,73117P,鈊象永豐9A售04,0.92,0.92,0.91,0.92,-0.02,-2.13,11000,3,10100,0,0,0,0,0,0,2000,9000,-7000,-7000
20200520,73118P,精測群益9A售01,1.53,1.56,1.53,1.53,+0.05,3.38,42000,4,64560,0,0,0,0,0,0,27000,15000,12000,12000
20200520,73119P,原相凱基9A售05,1.03,1.03,1.02,1.02,+0.02,2.0,62000,2,63740,0,0,0,0,0,0,12000,50000,-38000,-38000
20200520,73120P,群聯凱基9A售05,0.72,0.73,0.72,0.73,+0.01,1.39,163000,6,118290,0,0,0,0,0,0,100000,63000,37000,37000
20200520,73121P,中美晶元大9A售03,2.09,2.13,2.09,2.13,+0.02,0.95,148000,6,313840,0,0,0,0,0,0,135000,8000,127000,127000
20200520,73122P,宏捷科元大9B售03,,,,,,0.00,0,0,0,0,0,0,0,0,0,0,0,0,0
20200520,73123P,信驊元大9A售04,1.30,1.41,1.30,1.41,+0.07,5.22,159000,9,219350,0,0,0,0,0,0,2000,157000,-155000,-155000
20200520,73124P,穩懋元大9A售07,2.80,2.87,2.80,2.86,+0.02,0.7,38000,4,108240,0,0,0,0,0,0,25000,13000,12000,12000
20200520,73125P,精測元大9A售06,2.09,2.15,2.07,2.13,+0.05,2.4,833000,28,1760750,0,0,0,0,0,0,541000,292000,249000,249000
20200520,73126P,聯亞元大9A售02,,,,,,0.00,0,0,0,0,0,0,0,0,0,0,0,0,0
20200520,73127P,鈊象元大9B售05,1.23,1.24,1.23,1.24,-0.01,-0.8,86000,7,106220,0,0,0,0,0,0,56000,30000,26000,26000
20200520,73128P,鈊象群益9A售04,2.03,2.08,2.03,2.08,+0.02,0.97,1103000,11,2273820,0,0,0,0,0,0,969000,134000,835000,835000
20200520,73129P,中美晶永豐9A售02,0.84,0.86,0.84,0.86,0.00,0.0,6000,6,5100,0,0,0,0,0,0,3000,3000,0,0
20200520,73130P,碩禾永豐9A售02,,,,,,0.00,0,0,0,0,0,0,0,0,0,0,0,0,0
20200520,73131P,聯亞凱基9A售03,,,,,,0.00,0,0,0,0,0,0,0,0,0,0,0,0,0
20200520,73132P,大江國票9A售07,,,,,,0.00,0,0,0,0,0,0,0,0,0,0,0,0,0
20200520,73133P,神盾國票9B售02,,,,,,0.00,0,0,0,0,0,0,0,0,0,0,0,0,0
20200520,73134P,神盾國票9B售03,1.04,1.04,1.04,1.04,+0.03,2.97,1000,1,1040,0,0,0,0,0,0,0,1000,-1000,-1000
20200520,73135P,雙鴻國票9A售04,2.48,2.54,2.46,2.48,-0.01,-0.4,39000,6,96380,0,0,0,0,0,0,39000,0,39000,39000
20200520,73136P,宏捷科永豐9A售02,,,,,,0.00,0,0,0,0,0,0,0,0,0,0,0,0,0
20200520,73137P,頎邦永豐9A售03,0.60,0.60,0.60,0.60,0.00,0.0,105000,3,63000,0,0,0,0,0,0,0,105000,-105000,-105000
20200520,73138P,宏捷科凱基9A售04,1.20,1.20,1.20,1.20,0.00,0.0,15000,1,18000,0,0,0,0,0,0,15000,0,15000,15000
20200520,73139P,精測凱基9A售06,1.13,1.16,1.13,1.16,+0.03,2.65,36000,6,41120,0,0,0,0,0,0,26000,9000,17000,17000
20200520,73140P,穩懋凱基9A售06,1.60,1.64,1.60,1.64,+0.04,2.5,52000,6,84630,0,0,0,0,0,0,32000,20000,12000,12000
20200520,73141P,神盾元大9A售07,0.89,0.90,0.89,0.90,-0.02,-2.17,171000,4,153740,0,0,0,0,0,0,171000,171000,0,0
20200520,73142P,精測群益9A售03,1.67,1.71,1.67,1.71,+0.04,2.4,131000,7,222580,0,0,0,0,0,0,32000,99000,-67000,-67000
20200520,73143P,環球晶富邦9B售04,,,,,,0.00,0,0,0,0,0,0,0,0,0,0,0,0,0
20200520,73144P,大江元大9A售06,1.14,1.15,1.14,1.14,-0.04,-3.39,30000,3,34300,0,0,0,0,0,0,20000,10000,10000,10000
20200520,73145P,宏捷科元大9A售04,1.70,1.72,1.70,1.71,+0.01,0.59,67000,5,114430,0,0,0,0,0,0,0,67000,-67000,-67000
20200520,73146P,頎邦元大9A售02,0.89,0.89,0.89,0.89,+0.01,1.14,158000,6,140620,0,0,0,0,0,0,58000,100000,-42000,-42000
20200520,73147P,信驊群益9A售03,1.45,1.45,1.45,1.45,+0.02,1.4,44000,1,63800,0,0,0,0,0,0,0,44000,-44000,-44000
20200520,73148P,宏捷科國票9A售05,2.52,2.61,2.51,2.60,+0.10,4.0,63000,8,159310,0,0,0,0,0,0,46000,17000,29000,29000
20200520,73149P,穩懋中信9C售02,,,,,,0.00,0,0,0,0,0,0,0,0,0,0,0,0,0
20200520,73150P,威剛永豐9A售02,0.83,0.83,0.81,0.81,-0.02,-2.41,20000,5,16580,0,0,0,0,0,0,1000,19000,-18000,-18000
20200520,73151P,精測永豐9A售04,1.09,1.09,1.09,1.09,+0.03,2.83,6000,2,6540,0,0,0,0,0,0,5000,1000,4000,4000
20200520,73152P,穩懋永豐9A售03,0.97,0.98,0.97,0.98,+0.05,5.38,29000,5,28180,0,0,0,0,0,0,0,29000,-29000,-29000
20200520,73153P,威剛元大9A售07,1.15,1.18,1.15,1.15,-0.01,-0.86,290000,12,334910,0,0,0,0,0,0,130000,239000,-109000,-109000
20200520,73154P,神盾元大9B售03,0.84,0.85,0.84,0.85,0.00,0.0,60000,3,50600,0,0,0,0,0,0,60000,0,60000,60000
20200520,73155P,群聯元大9A售12,1.35,1.40,1.35,1.37,0.00,0.0,295000,25,405820,0,2000,-2000,0,0,0,43000,219000,-176000,-178000
20200520,73156P,聯亞群益9A售01,2.04,2.06,2.02,2.02,-0.03,-1.46,86000,4,176710,0,0,0,0,0,0,71000,15000,56000,56000
20200520,73157P,宏捷科凱基9A售05,2.31,2.32,2.31,2.31,+0.04,1.76,71000,4,164040,0,0,0,0,0,0,0,71000,-71000,-71000
20200520,73158P,環球晶凱基9A售04,1.21,1.21,1.21,1.21,+0.03,2.54,1000,1,1210,0,0,0,0,0,0,0,1000,-1000,-1000
20200520,73159P,聯亞國票9A售02,,,,,,0.00,0,0,0,0,0,0,0,0,0,0,0,0,0
20200520,73160P,精測元大9A售07,1.77,1.81,1.77,1.78,+0.02,1.14,319000,7,568860,0,0,0,0,0,0,231000,88000,143000,143000
20200520,73161P,鈊象群益9A售05,3.53,3.62,3.52,3.62,+0.03,0.84,33000,4,118070,0,0,0,0,0,0,2000,31000,-29000,-29000
20200520,73162P,穩懋統一9B售04,1.11,1.11,1.10,1.10,+0.01,0.92,222000,6,246270,0,0,0,0,0,0,0,222000,-222000,-222000
20200520,73163P,大江國票9A售08,2.02,2.07,2.02,2.07,-0.03,-1.43,29000,3,59560,0,0,0,0,0,0,15000,14000,1000,1000
20200520,73164P,台燿元大9A售01,1.28,1.33,1.28,1.33,+0.02,1.53,50000,4,64600,0,0,0,0,0,0,34000,16000,18000,18000
20200520,73165P,緯軟元大9A售02,1.63,1.66,1.63,1.66,-0.03,-1.78,200000,2,329000,0,0,0,0,0,0,0,200000,-200000,-200000
20200520,73166P,聯亞元大9A售03,1.47,1.47,1.47,1.47,-0.03,-2.0,5000,1,7350,0,0,0,0,0,0,0,5000,-5000,-5000
20200520,73167P,櫃200元大9A售01,0.94,0.94,0.94,0.94,-0.03,-3.09,10000,1,9400,0,0,0,0,0,0,10000,0,10000,10000
20200520,73168P,信驊群益9A售04,0.91,1.00,0.90,1.00,+0.02,2.04,331000,13,324170,0,0,0,0,0,0,18000,313000,-295000,-295000
20200520,73169P,信驊國票9A售05,1.52,1.67,1.50,1.67,+0.04,2.45,249000,17,392780,0,0,0,0,0,0,55000,194000,-139000,-139000
20200520,73170P,穩懋國票9A售05,2.25,2.36,2.25,2.33,+0.08,3.56,66000,5,151910,0,0,0,0,0,0,51000,46000,5000,5000
20200520,73171P,神盾凱基9A售03,0.67,0.69,0.67,0.69,-0.02,-2.82,10000,2,6800,0,0,0,0,0,0,0,10000,-10000,-10000
20200520,73172P,群聯永豐9B售01,,,,,,0.00,0,0,0,0,0,0,0,0,0,0,0,0,0
20200520,73173P,台燿群益9B售01,0.75,0.80,0.74,0.80,+0.01,1.27,26000,8,20040,0,0,0,0,0,0,16000,10000,6000,6000
20200520,73174P,環球晶群益9B售03,,,,,,0.00,0,0,0,0,0,0,0,0,0,0,0,0,0
20200520,73175P,鈊象永豐9B售01,,,,,,0.00,0,0,0,0,0,0,0,0,0,0,0,0,0
20200520,73176P,威剛國票9B售03,3.31,3.39,3.31,3.39,+0.04,1.19,20000,3,67640,0,0,0,0,0,0,2000,18000,-16000,-16000
20200520,73177P,聯亞國票9B售02,2.91,2.91,2.91,2.91,-0.03,-1.02,10000,1,29100,0,0,0,0,0,0,10000,0,10000,10000
20200520,73178P,環球晶中信9C售03,0.63,0.64,0.63,0.64,+0.01,1.59,131000,3,82730,0,0,0,0,0,0,0,131000,-131000,-131000
20200520,73179P,鈊象群益9B售02,1.51,1.55,1.51,1.53,+0.02,1.32,96000,5,147600,0,0,0,0,0,0,11000,85000,-74000,-74000
20200520,73180P,穩懋元大9B售02,2.33,2.39,2.33,2.39,+0.09,3.91,101000,5,236990,0,0,0,0,0,0,30000,71000,-41000,-41000
20200520,73181P,穩懋統一9B售07,1.12,1.12,1.12,1.12,+0.05,4.67,10000,1,11200,0,0,0,0,0,0,0,10000,-10000,-10000
20200520,73182P,神盾元大9C售01,2.25,2.25,2.25,2.25,+0.03,1.35,6000,1,13500,0,0,0,0,0,0,0,6000,-6000,-6000
20200520,73183P,環球晶群益9B售06,,,,,,0.00,0,0,0,0,0,0,0,0,0,0,0,0,0
20200520,73184P,精華元大9B售01,2.26,2.31,2.26,2.30,+0.02,0.88,203000,5,465780,0,0,0,0,0,0,0,203000,-203000,-203000
20200520,73185P,原相群益9B售06,,,,,,0.00,0,0,0,0,0,0,0,0,0,0,0,0,0
20200520,73186P,群聯群益9B售03,2.35,2.40,2.35,2.37,-0.01,-0.42,89000,6,210540,0,0,0,0,0,0,17000,72000,-55000,-55000
20200520,73187P,鈊象群益9B售03,3.49,3.49,3.49,3.49,-0.08,-2.24,13000,1,45370,0,0,0,0,0,0,13000,0,13000,13000
20200520,73188P,環球晶統一9B售03,0.93,0.93,0.93,0.93,+0.03,3.33,24000,2,22320,0,0,0,0,0,0,0,24000,-24000,-24000
20200520,73189P,穩懋統一9B售09,1.54,1.57,1.54,1.56,+0.05,3.31,126000,11,195600,0,0,0,0,0,0,65000,61000,4000,4000
20200520,73190P,原相群益9B售07,0.87,0.87,0.87,0.87,+0.06,7.41,61000,1,53070,0,0,0,0,0,0,61000,61000,0,0
20200520,73191P,群聯群益9B售04,2.62,2.66,2.62,2.66,+0.02,0.76,50000,6,132240,0,0,0,0,0,0,0,50000,-50000,-50000
20200520,73192P,穩懋凱基9B售02,2.04,2.11,2.04,2.11,+0.02,0.96,55000,3,115270,0,0,0,0,0,0,54000,51000,3000,3000
20200520,73193P,神盾元大9B售04,1.67,1.67,1.67,1.67,0.00,0.0,84000,1,140280,0,0,0,0,0,0,0,84000,-84000,-84000
20200520,73194P,環球晶統一9B售04,,,,,,0.00,0,0,0,0,0,0,0,0,0,0,0,0,0
20200520,73195P,鈊象統一9B售01,0.79,0.79,0.79,0.79,-0.02,-2.47,19000,1,15010,0,0,0,0,0,0,19000,0,19000,19000
20200520,73196P,威剛元大9B售05,,,,,,0.00,0,0,0,0,0,0,0,0,0,0,0,0,0
20200520,73197P,緯軟群益9B售01,,,,,,0.00,0,0,0,0,0,0,0,0,0,0,0,0,0
20200520,73198P,頎邦群益9C售02,1.91,1.91,1.91,1.91,+0.02,1.06,23000,1,43930,0,0,0,0,0,0,0,23000,-23000,-23000
20200520,73199P,雙鴻國票9B售04,,,,,,0.00,0,0,0,0,0,0,0,0,0,0,0,0,0
20200520,73200P,神盾永豐9B售01,,,,,,0.00,0,0,0,0,0,0,0,0,0,0,0,0,0
20200520,73201P,台燿凱基9B售02,,,,,,0.00,0,0,0,0,0,0,0,0,0,0,0,0,0
20200520,73202P,穩懋凱基9B售04,2.35,2.35,2.29,2.29,+0.08,3.62,13000,3,30290,0,0,0,0,0,0,0,13000,-13000,-13000
20200520,73203P,泰博國票9B售01,2.00,2.02,1.90,1.91,+0.56,41.48,405000,42,790250,0,0,0,0,0,0,365000,405000,-40000,-40000
20200520,702038,中光電台新97購01,,,,,,0.00,0,0,0,0,0,0,0,0,0,0,0,0,0
20200520,702039,群聯台新97購01,3.10,3.10,2.92,2.96,-0.04,-1.33,26000,4,78200,0,0,0,0,0,0,15000,10000,5000,5000
20200520,705010,穩懋中信95購02,,,,,,0.00,0,0,0,0,0,0,0,0,0,0,0,0,0
20200520,705503,保瑞國泰98購01,0.32,0.32,0.32,0.32,+0.03,10.34,12000,2,3840,0,0,0,0,0,0,0,12000,-12000,-12000
20200520,705608,威剛元富95購01,,,,,,0.00,0,0,0,0,0,0,0,0,0,0,0,0,0
20200520,705684,建榮統一96購01,0.01,0.01,0.01,0.01,0.00,0.0,100000,1,1000,0,0,0,0,0,0,100000,0,100000,100000
20200520,705685,建榮統一96購02,,,,,,0.00,0,0,0,0,0,0,0,0,0,0,0,0,0
20200520,705730,群聯元富96購01,,,,,,0.00,0,0,0,0,0,0,0,0,0,0,0,0,0
20200520,705741,富喬統一96購01,,,,,,0.00,0,0,0,0,0,0,0,0,0,0,0,0,0
20200520,705775,宜鼎群益96購01,,,,,,0.00,0,0,0,0,0,0,0,0,0,0,0,0,0
20200520,705776,原相群益96購01,,,,,,0.00,0,0,0,0,0,0,0,0,0,0,0,0,0
20200520,705788,緯軟元大96購01,,,,,,0.00,0,0,0,0,0,0,0,0,0,0,0,0,0
20200520,705803,原相富邦97購01,,,,,,0.00,0,0,0,0,0,0,0,0,0,0,0,0,0
20200520,705805,環球晶富邦97購01,0.78,0.78,0.71,0.71,-0.08,-10.13,15000,2,11000,0,0,0,0,0,0,5000,15000,-10000,-10000
20200520,705847,環球晶統一99購01,2.20,2.20,2.20,2.20,-0.14,-5.98,40000,1,88000,0,0,0,0,0,0,40000,0,40000,40000
20200520,705848,禾昌元富96購01,,,,,,0.00,0,0,0,0,0,0,0,0,0,0,0,0,0
20200520,705869,穩懋元大96購01,0.07,0.07,0.07,0.07,-0.02,-22.22,30000,1,2100,0,0,0,0,0,0,30000,0,30000,30000
20200520,705904,六角富邦97購01,,,,,,0.00,0,0,0,0,0,0,0,0,0,0,0,0,0
20200520,705905,昇達科富邦97購01,,,,,,0.00,0,0,0,0,0,0,0,0,0,0,0,0,0
20200520,705924,大江元富96購01,,,,,,0.00,0,0,0,0,0,0,0,0,0,0,0,0,0
20200520,706054,穩懋中信95購03,,,,,,0.00,0,0,0,0,0,0,0,0,0,0,0,0,0
20200520,706056,穩懋元富95購01,,,,,,0.00,0,0,0,0,0,0,0,0,0,0,0,0,0
20200520,706108,威剛富邦97購01,0.47,0.47,0.43,0.43,-0.01,-2.27,121000,13,54430,0,0,0,0,0,0,21000,120000,-99000,-99000
20200520,706109,雙鴻富邦97購01,0.10,0.12,0.10,0.10,-0.04,-28.57,233000,6,25360,0,0,0,0,0,0,30000,203000,-173000,-173000
20200520,706112,原相元大95購01,,,,,,0.00,0,0,0,0,0,0,0,0,0,0,0,0,0
20200520,706130,雙美群益95購01,,,,,,0.00,0,0,0,0,0,0,0,0,0,0,0,0,0
20200520,706133,鈺太國票95購02,,,,,,0.00,0,0,0,0,0,0,0,0,0,0,0,0,0
20200520,706134,穩懋富邦95購01,,,,,,0.00,0,0,0,0,0,0,0,0,0,0,0,0,0
20200520,706164,博智元大95購01,,,,,,0.00,0,0,0,0,0,0,0,0,0,0,0,0,0
20200520,706167,三貝德國票95購01,,,,,,0.00,0,0,0,0,0,0,0,0,0,0,0,0,0
20200520,706171,鐿鈦國票95購01,,,,,,0.00,0,0,0,0,0,0,0,0,0,0,0,0,0
20200520,706173,神盾國泰95購01,,,,,,0.00,0,0,0,0,0,0,0,0,0,0,0,0,0
20200520,706175,譜瑞國泰95購01,,,,,,0.00,0,0,0,0,0,0,0,0,0,0,0,0,0
20200520,706194,博智國票95購01,,,,,,0.00,0,0,0,0,0,0,0,0,0,0,0,0,0
20200520,706199,昇達科國泰95購01,,,,,,0.00,0,0,0,0,0,0,0,0,0,0,0,0,0
20200520,706200,保瑞國泰95購02,,,,,,0.00,0,0,0,0,0,0,0,0,0,0,0,0,0
20200520,706256,神盾富邦96購01,,,,,,0.00,0,0,0,0,0,0,0,0,0,0,0,0,0
20200520,706267,合晶元大96購01,,,,,,0.00,0,0,0,0,0,0,0,0,0,0,0,0,0
20200520,706296,穩懋統一96購01,,,,,,0.00,0,0,0,0,0,0,0,0,0,0,0,0,0
20200520,706302,三貝德國票96購01,,,,,,0.00,0,0,0,0,0,0,0,0,0,0,0,0,0
20200520,706357,網家元富96購01,,,,,,0.00,0,0,0,0,0,0,0,0,0,0,0,0,0
20200520,706373,雙鴻國泰96購01,,,,,,0.00,0,0,0,0,0,0,0,0,0,0,0,0,0
20200520,706383,群聯群益96購01,,,,,,0.00,0,0,0,0,0,0,0,0,0,0,0,0,0
20200520,706393,昇達科元大96購01,,,,,,0.00,0,0,0,0,0,0,0,0,0,0,0,0,0
20200520,706410,信昌電元大96購01,,,,,,0.00,0,0,0,0,0,0,0,0,0,0,0,0,0
20200520,706415,緯軟元大96購02,,,,,,0.00,0,0,0,0,0,0,0,0,0,0,0,0,0
20200520,706417,雙鴻元大97購01,0.10,0.10,0.10,0.10,+0.01,11.11,5000,1,500,0,0,0,0,0,0,0,0,0,0
20200520,706419,鈺太元大96購01,,,,,,0.00,0,0,0,0,0,0,0,0,0,0,0,0,0
20200520,706423,宏觀群益96購01,,,,,,0.00,0,0,0,0,0,0,0,0,0,0,0,0,0
20200520,706427,雙鴻群益96購01,,,,,,0.00,0,0,0,0,0,0,0,0,0,0,0,0,0
20200520,706430,建榮國票96購01,,,,,,0.00,0,0,0,0,0,0,0,0,0,0,0,0,0
20200520,706436,穩懋富邦96購01,,,,,,0.00,0,0,0,0,0,0,0,0,0,0,0,0,0
20200520,706446,雙鴻麥證96購01,,,,,,0.00,0,0,0,0,0,0,0,0,0,0,0,0,0
20200520,706448,威剛元富97購01,,,,,,0.00,0,0,0,0,0,0,0,0,0,0,0,0,0
20200520,706461,元太富邦96購01,1.18,1.49,1.18,1.49,+0.36,31.86,21000,2,30980,0,0,0,0,0,0,21000,0,21000,21000
20200520,706481,雙鴻群益96購02,,,,,,0.00,0,0,0,0,0,0,0,0,0,0,0,0,0
20200520,706513,金居群益96購01,,,,,,0.00,0,0,0,0,0,0,0,0,0,0,0,0,0
20200520,706516,大田元大96購01,,,,,,0.00,0,0,0,0,0,0,0,0,0,0,0,0,0
20200520,706518,杰力元大96購01,,,,,,0.00,0,0,0,0,0,0,0,0,0,0,0,0,0
20200520,706529,M31國泰96購01,,,,,,0.00,0,0,0,0,0,0,0,0,0,0,0,0,0
20200520,706530,群聯國泰96購01,,,,,,0.00,0,0,0,0,0,0,0,0,0,0,0,0,0
20200520,706531,雙鴻國泰96購02,,,,,,0.00,0,0,0,0,0,0,0,0,0,0,0,0,0
20200520,706554,神盾群益96購01,,,,,,0.00,0,0,0,0,0,0,0,0,0,0,0,0,0
20200520,706556,由田富邦96購01,,,,,,0.00,0,0,0,0,0,0,0,0,0,0,0,0,0
20200520,706574,建榮元大97購01,,,,,,0.00,0,0,0,0,0,0,0,0,0,0,0,0,0
20200520,706596,建榮永豐96購01,,,,,,0.00,0,0,0,0,0,0,0,0,0,0,0,0,0
20200520,706602,大江元大96購01,,,,,,0.00,0,0,0,0,0,0,0,0,0,0,0,0,0
20200520,706612,原相群益97購01,2.71,2.71,2.71,2.71,-0.16,-5.57,10000,1,27100,0,0,0,0,0,0,10000,10000,0,0
20200520,706614,櫃200永昌96購01,,,,,,0.00,0,0,0,0,0,0,0,0,0,0,0,0,0
20200520,706615,櫃200永昌96購02,,,,,,0.00,0,0,0,0,0,0,0,0,0,0,0,0,0
20200520,706616,櫃200永昌96購03,,,,,,0.00,0,0,0,0,0,0,0,0,0,0,0,0,0
20200520,706618,原相國泰96購01,,,,,,0.00,0,0,0,0,0,0,0,0,0,0,0,0,0
20200520,706624,雙鴻凱基96購01,,,,,,0.00,0,0,0,0,0,0,0,0,0,0,0,0,0
20200520,706631,櫃200第一96購01,,,,,,0.00,0,0,0,0,0,0,0,0,0,0,0,0,0
20200520,706646,昇達科元大96購02,,,,,,0.00,0,0,0,0,0,0,0,0,0,0,0,0,0
20200520,706651,雙美元大96購01,,,,,,0.00,0,0,0,0,0,0,0,0,0,0,0,0,0
20200520,706690,環球晶富邦98購01,0.30,0.31,0.29,0.29,-0.04,-12.12,50000,5,15320,0,0,0,0,0,0,45000,5000,40000,40000
20200520,706726,M31元大96購01,,,,,,0.00,0,0,0,0,0,0,0,0,0,0,0,0,0
20200520,706731,良維元大97購01,,,,,,0.00,0,0,0,0,0,0,0,0,0,0,0,0,0
20200520,706733,神盾元大96購01,,,,,,0.00,0,0,0,0,0,0,0,0,0,0,0,0,0
20200520,706747,安勤統一95購01,,,,,,0.00,0,0,0,0,0,0,0,0,0,0,0,0,0
20200520,706748,安勤統一95購02,,,,,,0.00,0,0,0,0,0,0,0,0,0,0,0,0,0
20200520,706751,同致國票95購01,,,,,,0.00,0,0,0,0,0,0,0,0,0,0,0,0,0
20200520,706752,波若威國票95購01,,,,,,0.00,0,0,0,0,0,0,0,0,0,0,0,0,0
20200520,706754,碩禾台新96購01,,,,,,0.00,0,0,0,0,0,0,0,0,0,0,0,0,0
20200520,706758,六角國泰96購01,,,,,,0.00,0,0,0,0,0,0,0,0,0,0,0,0,0
20200520,706759,雙美國泰95購01,,,,,,0.00,0,0,0,0,0,0,0,0,0,0,0,0,0
20200520,706760,鈺太國泰95購01,,,,,,0.00,0,0,0,0,0,0,0,0,0,0,0,0,0
20200520,706761,鐿鈦國泰96購01,,,,,,0.00,0,0,0,0,0,0,0,0,0,0,0,0,0
20200520,706762,大江兆豐95購02,,,,,,0.00,0,0,0,0,0,0,0,0,0,0,0,0,0
20200520,706763,勝麗兆豐95購01,,,,,,0.00,0,0,0,0,0,0,0,0,0,0,0,0,0
20200520,706765,六角元大96購01,,,,,,0.00,0,0,0,0,0,0,0,0,0,0,0,0,0
20200520,706767,群聯元大95購04,,,,,,0.00,0,0,0,0,0,0,0,0,0,0,0,0,0
20200520,706769,環球晶元大95購02,,,,,,0.00,0,0,0,0,0,0,0,0,0,0,0,0,0
20200520,706773,優群群益95購01,,,,,,0.00,0,0,0,0,0,0,0,0,0,0,0,0,0
20200520,706774,雙美群益96購01,,,,,,0.00,0,0,0,0,0,0,0,0,0,0,0,0,0
20200520,706787,博智國票95購02,,,,,,0.00,0,0,0,0,0,0,0,0,0,0,0,0,0
20200520,706788,大學光國泰96購01,,,,,,0.00,0,0,0,0,0,0,0,0,0,0,0,0,0
20200520,706792,威剛元大96購01,,,,,,0.00,0,0,0,0,0,0,0,0,0,0,0,0,0
20200520,706796,鈺太元大96購02,0.53,0.53,0.53,0.53,-0.03,-5.36,21000,3,11130,0,0,0,0,0,0,0,21000,-21000,-21000
20200520,706800,原相元大96購01,,,,,,0.00,0,0,0,0,0,0,0,0,0,0,0,0,0
20200520,706803,環球晶中信97購01,0.09,0.10,0.08,0.09,-0.01,-10.0,355000,29,31140,0,0,0,0,0,0,73000,232000,-159000,-159000
20200520,706804,由田國泰96購01,,,,,,0.00,0,0,0,0,0,0,0,0,0,0,0,0,0
20200520,706809,神盾元富95購01,,,,,,0.00,0,0,0,0,0,0,0,0,0,0,0,0,0
20200520,706811,環球晶元富95購03,,,,,,0.00,0,0,0,0,0,0,0,0,0,0,0,0,0
20200520,706821,雙鴻永豐95購04,,,,,,0.00,0,0,0,0,0,0,0,0,0,0,0,0,0
20200520,706822,立端群益95購01,,,,,,0.00,0,0,0,0,0,0,0,0,0,0,0,0,0
20200520,706825,穩懋統一96購02,,,,,,0.00,0,0,0,0,0,0,0,0,0,0,0,0,0
20200520,706830,迅得元大95購01,,,,,,0.00,0,0,0,0,0,0,0,0,0,0,0,0,0
20200520,706833,鈺太元大96購03,,,,,,0.00,0,0,0,0,0,0,0,0,0,0,0,0,0
20200520,706840,良維國票95購01,,,,,,0.00,0,0,0,0,0,0,0,0,0,0,0,0,0
20200520,706841,保瑞國票95購01,,,,,,0.00,0,0,0,0,0,0,0,0,0,0,0,0,0
20200520,706843,碩禾國票95購01,,,,,,0.00,0,0,0,0,0,0,0,0,0,0,0,0,0
20200520,706844,新鉅科富邦98購01,,,,,,0.00,0,0,0,0,0,0,0,0,0,0,0,0,0
20200520,706853,神盾元富95購02,,,,,,0.00,0,0,0,0,0,0,0,0,0,0,0,0,0
20200520,706855,原相兆豐95購02,,,,,,0.00,0,0,0,0,0,0,0,0,0,0,0,0,0
20200520,706856,環球晶兆豐95購04,,,,,,0.00,0,0,0,0,0,0,0,0,0,0,0,0,0
20200520,706858,由田群益96購01,,,,,,0.00,0,0,0,0,0,0,0,0,0,0,0,0,0
20200520,706866,凡甲國票95購01,0.09,0.09,0.06,0.06,-0.04,-40.0,490000,7,37500,0,0,0,0,0,0,470000,10000,460000,460000
20200520,706867,中美晶國票95購01,,,,,,0.00,0,0,0,0,0,0,0,0,0,0,0,0,0
20200520,706868,神盾國票96購01,,,,,,0.00,0,0,0,0,0,0,0,0,0,0,0,0,0
20200520,706869,環球晶國票95購02,,,,,,0.00,0,0,0,0,0,0,0,0,0,0,0,0,0
20200520,706870,原相群益97購02,,,,,,0.00,0,0,0,0,0,0,0,0,0,0,0,0,0
20200520,706872,波若威永豐95購01,,,,,,0.00,0,0,0,0,0,0,0,0,0,0,0,0,0
20200520,706876,大宇資元大96購01,,,,,,0.00,0,0,0,0,0,0,0,0,0,0,0,0,0
20200520,706877,合晶元大95購01,0.03,0.03,0.02,0.02,0.00,0.0,125000,7,3590,0,0,0,0,0,0,125000,0,125000,125000
20200520,706879,信昌電元大95購02,,,,,,0.00,0,0,0,0,0,0,0,0,0,0,0,0,0
20200520,706882,緯軟元大96購03,,,,,,0.00,0,0,0,0,0,0,0,0,0,0,0,0,0
20200520,706884,環球晶元大95購03,,,,,,0.00,0,0,0,0,0,0,0,0,0,0,0,0,0
20200520,706889,雙鴻元富96購01,,,,,,0.00,0,0,0,0,0,0,0,0,0,0,0,0,0
20200520,706890,信驊凱基95購01,,,,,,0.00,0,0,0,0,0,0,0,0,0,0,0,0,0
20200520,706892,網家凱基95購01,,,,,,0.00,0,0,0,0,0,0,0,0,0,0,0,0,0
20200520,706894,M31元大95購01,,,,,,0.00,0,0,0,0,0,0,0,0,0,0,0,0,0
20200520,706898,勝麗元大95購02,0.78,0.97,0.75,0.94,+0.09,10.59,127000,7,115080,0,0,0,0,0,0,127000,0,127000,127000
20200520,706899,閎康元大95購01,,,,,,0.00,0,0,0,0,0,0,0,0,0,0,0,0,0
20200520,706902,迅得永豐95購02,,,,,,0.00,0,0,0,0,0,0,0,0,0,0,0,0,0
20200520,706906,大學光國票96購01,,,,,,0.00,0,0,0,0,0,0,0,0,0,0,0,0,0
20200520,706907,合晶國票95購01,,,,,,0.00,0,0,0,0,0,0,0,0,0,0,0,0,0
20200520,706908,皇田國票95購01,,,,,,0.00,0,0,0,0,0,0,0,0,0,0,0,0,0
20200520,706910,閎康國票95購01,,,,,,0.00,0,0,0,0,0,0,0,0,0,0,0,0,0
20200520,706912,鐿鈦國票96購01,0.51,0.53,0.51,0.53,0.00,0.0,488000,9,257400,0,0,0,0,0,0,67000,421000,-354000,-354000
20200520,706916,M31元大96購02,,,,,,0.00,0,0,0,0,0,0,0,0,0,0,0,0,0
20200520,706918,大學光元大96購01,,,,,,0.00,0,0,0,0,0,0,0,0,0,0,0,0,0
20200520,706919,良維元大96購01,,,,,,0.00,0,0,0,0,0,0,0,0,0,0,0,0,0
20200520,706920,宣德元大96購01,,,,,,0.00,0,0,0,0,0,0,0,0,0,0,0,0,0
20200520,706923,聚積元大96購01,,,,,,0.00,0,0,0,0,0,0,0,0,0,0,0,0,0
20200520,706928,大學光永豐96購01,,,,,,0.00,0,0,0,0,0,0,0,0,0,0,0,0,0
20200520,706933,神盾中信97購01,0.01,0.01,0.01,0.01,-0.01,-50.0,158000,4,1580,0,0,0,0,0,0,58000,0,58000,58000
20200520,706934,環宇中信97購01,,,,,,0.00,0,0,0,0,0,0,0,0,0,0,0,0,0
20200520,706935,VHQ凱基96購01,,,,,,0.00,0,0,0,0,0,0,0,0,0,0,0,0,0
20200520,706936,台燿凱基96購01,,,,,,0.00,0,0,0,0,0,0,0,0,0,0,0,0,0
20200520,706937,宜鼎凱基96購01,,,,,,0.00,0,0,0,0,0,0,0,0,0,0,0,0,0
20200520,706940,穩懋凱基96購01,,,,,,0.00,0,0,0,0,0,0,0,0,0,0,0,0,0
20200520,706941,譜瑞凱基96購01,,,,,,0.00,0,0,0,0,0,0,0,0,0,0,0,0,0
20200520,706942,大中國票96購01,,,,,,0.00,0,0,0,0,0,0,0,0,0,0,0,0,0
20200520,706945,碩禾國票96購01,0.01,0.01,0.01,0.01,0.00,0.0,150000,1,1500,0,0,0,0,0,0,150000,0,150000,150000
20200520,706946,環球晶國票96購01,,,,,,0.00,0,0,0,0,0,0,0,0,0,0,0,0,0
20200520,706947,大田國泰96購01,,,,,,0.00,0,0,0,0,0,0,0,0,0,0,0,0,0
20200520,706950,雙鴻富邦96購01,,,,,,0.00,0,0,0,0,0,0,0,0,0,0,0,0,0
20200520,706952,新鉅科元富96購01,,,,,,0.00,0,0,0,0,0,0,0,0,0,0,0,0,0
20200520,706956,原相群益96購03,,,,,,0.00,0,0,0,0,0,0,0,0,0,0,0,0,0
20200520,706960,雙鴻元大96購01,,,,,,0.00,0,0,0,0,0,0,0,0,0,0,0,0,0
20200520,706961,金可中信96購01,,,,,,0.00,0,0,0,0,0,0,0,0,0,0,0,0,0
20200520,706962,勝麗中信97購01,0.46,0.46,0.43,0.43,+0.01,2.38,122000,3,53000,0,0,0,0,0,0,112000,110000,2000,2000
20200520,706963,群聯中信97購01,0.10,0.10,0.10,0.10,-0.01,-9.09,200000,1,20000,0,0,0,0,0,0,200000,0,200000,200000
20200520,706965,群聯統一96購01,,,,,,0.00,0,0,0,0,0,0,0,0,0,0,0,0,0
20200520,706966,三貝德凱基96購01,,,,,,0.00,0,0,0,0,0,0,0,0,0,0,0,0,0
20200520,706969,信驊凱基96購01,,,,,,0.00,0,0,0,0,0,0,0,0,0,0,0,0,0
20200520,706970,茂達凱基96購01,0.11,0.19,0.11,0.19,+0.12,171.43,6000,4,840,0,0,0,0,0,0,5000,0,5000,5000
20200520,706973,穩懋凱基96購02,,,,,,0.00,0,0,0,0,0,0,0,0,0,0,0,0,0
20200520,706974,穩懋富邦96購03,0.01,0.01,0.01,0.01,0.00,0.0,1058000,6,10580,0,0,0,0,0,0,0,0,0,0
20200520,706975,穩懋富邦96購04,,,,,,0.00,0,0,0,0,0,0,0,0,0,0,0,0,0
20200520,706976,大江國泰96購01,,,,,,0.00,0,0,0,0,0,0,0,0,0,0,0,0,0
20200520,706977,神盾國泰96購01,,,,,,0.00,0,0,0,0,0,0,0,0,0,0,0,0,0
20200520,706984,合晶國票96購01,,,,,,0.00,0,0,0,0,0,0,0,0,0,0,0,0,0
20200520,706985,建榮國票96購02,,,,,,0.00,0,0,0,0,0,0,0,0,0,0,0,0,0
20200520,706986,網家國票96購01,,,,,,0.00,0,0,0,0,0,0,0,0,0,0,0,0,0
20200520,706990,中美晶中信97購01,0.35,0.36,0.35,0.35,-0.04,-10.26,55000,4,19650,0,0,0,0,0,0,15000,40000,-25000,-25000
20200520,706991,弘塑中信97購01,0.52,0.52,0.51,0.51,-0.02,-3.77,150000,5,76700,0,0,0,0,0,0,130000,20000,110000,110000
20200520,706992,神盾中信96購01,,,,,,0.00,0,0,0,0,0,0,0,0,0,0,0,0,0
20200520,706993,環球晶中信96購01,0.02,0.02,0.02,0.02,-0.02,-50.0,130000,1,2600,0,0,0,0,0,0,130000,0,130000,130000
20200520,706995,弘塑統一96購01,,,,,,0.00,0,0,0,0,0,0,0,0,0,0,0,0,0
20200520,706996,群聯統一96購02,,,,,,0.00,0,0,0,0,0,0,0,0,0,0,0,0,0
20200520,707000,台燿凱基96購02,,,,,,0.00,0,0,0,0,0,0,0,0,0,0,0,0,0
20200520,707003,神盾凱基96購01,,,,,,0.00,0,0,0,0,0,0,0,0,0,0,0,0,0
20200520,707013,良維兆豐96購01,,,,,,0.00,0,0,0,0,0,0,0,0,0,0,0,0,0
20200520,707018,合晶元大96購02,,,,,,0.00,0,0,0,0,0,0,0,0,0,0,0,0,0
20200520,707019,金居元大96購01,,,,,,0.00,0,0,0,0,0,0,0,0,0,0,0,0,0
20200520,707020,信昌電元大96購02,,,,,,0.00,0,0,0,0,0,0,0,0,0,0,0,0,0
20200520,707024,由田國票96購01,,,,,,0.00,0,0,0,0,0,0,0,0,0,0,0,0,0
20200520,707025,杰力國票96購01,0.32,0.33,0.32,0.33,+0.03,10.0,177000,2,57640,0,0,0,0,0,0,0,177000,-177000,-177000
20200520,707026,晶焱國票96購01,,,,,,0.00,0,0,0,0,0,0,0,0,0,0,0,0,0
20200520,707027,網龍國票96購01,,,,,,0.00,0,0,0,0,0,0,0,0,0,0,0,0,0
20200520,707029,大宇資國泰97購01,,,,,,0.00,0,0,0,0,0,0,0,0,0,0,0,0,0
20200520,707030,建榮國泰97購01,,,,,,0.00,0,0,0,0,0,0,0,0,0,0,0,0,0
20200520,707038,譜瑞富邦97購01,2.44,2.44,2.44,2.44,+0.13,5.63,5000,1,12200,0,0,0,0,0,0,5000,0,5000,5000
20200520,707046,大宇資元大97購01,,,,,,0.00,0,0,0,0,0,0,0,0,0,0,0,0,0
20200520,707048,昇達科元大96購03,,,,,,0.00,0,0,0,0,0,0,0,0,0,0,0,0,0
20200520,707049,杰力元大96購02,,,,,,0.00,0,0,0,0,0,0,0,0,0,0,0,0,0
20200520,707050,信昌電元大96購03,0.02,0.02,0.02,0.02,-0.06,-75.0,15000,1,300,0,0,0,0,0,0,15000,0,15000,15000
20200520,707051,神盾元大97購01,,,,,,0.00,0,0,0,0,0,0,0,0,0,0,0,0,0
20200520,707053,群聯元大96購01,,,,,,0.00,0,0,0,0,0,0,0,0,0,0,0,0,0
20200520,707054,合晶國泰97購01,0.64,0.64,0.64,0.64,+0.02,3.23,24000,1,15360,0,0,0,0,0,0,0,24000,-24000,-24000
20200520,707055,大江國票96購01,,,,,,0.00,0,0,0,0,0,0,0,0,0,0,0,0,0
20200520,707056,台半國票96購01,,,,,,0.00,0,0,0,0,0,0,0,0,0,0,0,0,0
20200520,707061,聯亞國票96購01,,,,,,0.00,0,0,0,0,0,0,0,0,0,0,0,0,0
20200520,707063,中美晶兆豐96購01,,,,,,0.00,0,0,0,0,0,0,0,0,0,0,0,0,0
20200520,707065,新普群益97購01,1.37,1.37,1.28,1.28,-0.07,-5.19,192000,5,261740,0,0,0,0,0,0,182000,10000,172000,172000
20200520,707075,廣明永豐96購01,,,,,,0.00,0,0,0,0,0,0,0,0,0,0,0,0,0
20200520,707077,精華中信97購01,,,,,,0.00,0,0,0,0,0,0,0,0,0,0,0,0,0
20200520,707078,環宇中信97購02,,,,,,0.00,0,0,0,0,0,0,0,0,0,0,0,0,0
20200520,707079,晟德中信97購01,,,,,,0.00,0,0,0,0,0,0,0,0,0,0,0,0,0
20200520,707080,弘塑統一98購01,,,,,,0.00,0,0,0,0,0,0,0,0,0,0,0,0,0
20200520,707083,大江元大96購02,,,,,,0.00,0,0,0,0,0,0,0,0,0,0,0,0,0
20200520,707084,原相元大97購01,4.25,4.25,4.25,4.25,-0.12,-2.75,1000,1,4250,0,0,0,0,0,0,0,1000,-1000,-1000
20200520,707085,群聯元大96購02,,,,,,0.00,0,0,0,0,0,0,0,0,0,0,0,0,0
20200520,707093,廣明國泰96購01,,,,,,0.00,0,0,0,0,0,0,0,0,0,0,0,0,0
20200520,707094,中美晶國票96購01,,,,,,0.00,0,0,0,0,0,0,0,0,0,0,0,0,0
20200520,707095,宜鼎國票96購01,,,,,,0.00,0,0,0,0,0,0,0,0,0,0,0,0,0
20200520,707097,穩懋國票96購02,,,,,,0.00,0,0,0,0,0,0,0,0,0,0,0,0,0
20200520,707098,台燿兆豐96購01,0.44,0.44,0.38,0.38,-0.14,-26.92,64000,6,25520,0,0,0,0,0,0,20000,44000,-24000,-24000
20200520,707099,穩懋兆豐96購01,,,,,,0.00,0,0,0,0,0,0,0,0,0,0,0,0,0
20200520,707102,原相群益96購04,,,,,,0.00,0,0,0,0,0,0,0,0,0,0,0,0,0
20200520,707104,六角兆豐96購01,,,,,,0.00,0,0,0,0,0,0,0,0,0,0,0,0,0
20200520,707106,原相台新97購01,,,,,,0.00,0,0,0,0,0,0,0,0,0,0,0,0,0
20200520,707108,新普群益97購02,1.10,1.13,1.08,1.08,-0.02,-1.82,111000,4,124580,0,0,0,0,0,0,51000,60000,-9000,-9000
20200520,707109,環宇群益97購01,,,,,,0.00,0,0,0,0,0,0,0,0,0,0,0,0,0
20200520,707113,金居元大96購02,,,,,,0.00,0,0,0,0,0,0,0,0,0,0,0,0,0
20200520,707114,建榮元大96購01,,,,,,0.00,0,0,0,0,0,0,0,0,0,0,0,0,0
20200520,707117,聯亞元大96購01,,,,,,0.00,0,0,0,0,0,0,0,0,0,0,0,0,0
20200520,707121,大江國票97購01,,,,,,0.00,0,0,0,0,0,0,0,0,0,0,0,0,0
20200520,707123,保瑞國票96購01,0.35,0.35,0.35,0.35,-0.05,-12.5,43000,1,15050,0,0,0,0,0,0,0,43000,-43000,-43000
20200520,707124,環宇國泰96購01,,,,,,0.00,0,0,0,0,0,0,0,0,0,0,0,0,0
20200520,707125,環球晶國泰96購01,,,,,,0.00,0,0,0,0,0,0,0,0,0,0,0,0,0
20200520,707132,晟德國泰96購01,,,,,,0.00,0,0,0,0,0,0,0,0,0,0,0,0,0
20200520,707133,中光電群益96購01,,,,,,0.00,0,0,0,0,0,0,0,0,0,0,0,0,0
20200520,707134,元太群益96購01,,,,,,0.00,0,0,0,0,0,0,0,0,0,0,0,0,0
20200520,707135,原相群益97購03,1.13,1.13,1.13,1.13,+0.06,5.61,10000,1,11300,0,0,0,0,0,0,0,10000,-10000,-10000
20200520,707136,群聯群益97購01,,,,,,0.00,0,0,0,0,0,0,0,0,0,0,0,0,0
20200520,707147,大江元大96購03,,,,,,0.00,0,0,0,0,0,0,0,0,0,0,0,0,0
20200520,707149,群聯元大96購03,,,,,,0.00,0,0,0,0,0,0,0,0,0,0,0,0,0
20200520,707154,雙鴻元大97購02,,,,,,0.00,0,0,0,0,0,0,0,0,0,0,0,0,0
20200520,707157,同致兆豐96購01,,,,,,0.00,0,0,0,0,0,0,0,0,0,0,0,0,0
20200520,707158,威剛兆豐96購01,,,,,,0.00,0,0,0,0,0,0,0,0,0,0,0,0,0
20200520,707159,網龍兆豐96購01,0.30,0.30,0.30,0.30,-0.02,-6.25,15000,2,4500,0,0,0,0,0,0,15000,0,15000,15000
20200520,707161,元太國票96購01,0.58,0.71,0.54,0.71,+0.34,91.89,111000,52,67090,0,0,0,0,0,0,0,111000,-111000,-111000
20200520,707162,旺矽國票96購01,,,,,,0.00,0,0,0,0,0,0,0,0,0,0,0,0,0
20200520,707163,信昌電國票96購01,,,,,,0.00,0,0,0,0,0,0,0,0,0,0,0,0,0
20200520,707164,宣德國票96購01,0.37,0.40,0.37,0.40,+0.05,14.29,111000,2,41970,0,0,0,0,0,0,30000,81000,-51000,-51000
20200520,707165,聚積國票96購01,,,,,,0.00,0,0,0,0,0,0,0,0,0,0,0,0,0
20200520,707166,譜瑞國票96購01,5.15,5.15,4.19,4.19,-1.01,-19.42,12000,2,59880,0,0,0,0,0,0,10000,0,10000,10000
20200520,707167,中美晶國泰96購01,,,,,,0.00,0,0,0,0,0,0,0,0,0,0,0,0,0
20200520,707168,群聯國泰97購01,,,,,,0.00,0,0,0,0,0,0,0,0,0,0,0,0,0
20200520,707169,群聯富邦96購01,,,,,,0.00,0,0,0,0,0,0,0,0,0,0,0,0,0
20200520,707170,環宇富邦97購01,,,,,,0.00,0,0,0,0,0,0,0,0,0,0,0,0,0
20200520,707171,弘塑中信99購01,0.36,0.36,0.35,0.36,-0.01,-2.7,155000,7,55650,0,0,0,0,0,0,30000,125000,-95000,-95000
20200520,707172,環球晶中信99購01,0.12,0.12,0.11,0.11,-0.02,-15.38,810000,10,93800,0,0,0,0,0,0,0,810000,-810000,-810000
20200520,707173,鈺太中信96購01,0.04,0.04,0.04,0.04,0.00,0.0,25000,1,1000,0,0,0,0,0,0,25000,0,25000,25000
20200520,707174,凡甲凱基96購01,0.49,0.54,0.46,0.47,-0.14,-22.95,98000,8,48770,0,0,0,0,0,0,55000,43000,12000,12000
20200520,707175,大江凱基96購01,,,,,,0.00,0,0,0,0,0,0,0,0,0,0,0,0,0
20200520,707178,威剛凱基97購01,,,,,,0.00,0,0,0,0,0,0,0,0,0,0,0,0,0
20200520,707189,美琪瑪元大96購01,,,,,,0.00,0,0,0,0,0,0,0,0,0,0,0,0,0
20200520,707190,神盾元大96購02,,,,,,0.00,0,0,0,0,0,0,0,0,0,0,0,0,0
20200520,707196,閎康群益96購01,,,,,,0.00,0,0,0,0,0,0,0,0,0,0,0,0,0
20200520,707197,順達群益96購01,0.57,0.73,0.57,0.73,+0.15,25.86,40000,5,24800,0,0,0,0,0,0,0,40000,-40000,-40000
20200520,707198,VHQ國票96購01,,,,,,0.00,0,0,0,0,0,0,0,0,0,0,0,0,0
20200520,707200,網龍國票97購01,1.22,1.32,1.09,1.09,-0.14,-11.38,127000,9,150370,0,0,0,0,0,0,45000,87000,-42000,-42000
20200520,707201,環球晶國票96購02,,,,,,0.00,0,0,0,0,0,0,0,0,0,0,0,0,0
20200520,707202,聯亞國票96購02,,,,,,0.00,0,0,0,0,0,0,0,0,0,0,0,0,0
20200520,707207,宇峻元大97購01,,,,,,0.00,0,0,0,0,0,0,0,0,0,0,0,0,0
20200520,707213,順達統一97購01,1.23,1.40,1.23,1.40,+0.28,25.0,11000,2,15230,0,0,0,0,0,0,11000,0,11000,11000
20200520,707233,迅得群益97購01,,,,,,0.00,0,0,0,0,0,0,0,0,0,0,0,0,0
20200520,707235,群聯群益96購02,,,,,,0.00,0,0,0,0,0,0,0,0,0,0,0,0,0
20200520,707236,聚積群益97購01,,,,,,0.00,0,0,0,0,0,0,0,0,0,0,0,0,0
20200520,707241,昇達科國票96購01,,,,,,0.00,0,0,0,0,0,0,0,0,0,0,0,0,0
20200520,707242,信驊國票96購01,,,,,,0.00,0,0,0,0,0,0,0,0,0,0,0,0,0
20200520,707243,新普國票96購01,,,,,,0.00,0,0,0,0,0,0,0,0,0,0,0,0,0
20200520,707244,精華國票96購01,,,,,,0.00,0,0,0,0,0,0,0,0,0,0,0,0,0
20200520,707246,弘塑元大96購01,,,,,,0.00,0,0,0,0,0,0,0,0,0,0,0,0,0
20200520,707248,建榮元大96購02,,,,,,0.00,0,0,0,0,0,0,0,0,0,0,0,0,0
20200520,707252,鐿鈦元大96購01,,,,,,0.00,0,0,0,0,0,0,0,0,0,0,0,0,0
20200520,707253,穩懋亞東96購02,,,,,,0.00,0,0,0,0,0,0,0,0,0,0,0,0,0
20200520,707254,同致中信97購01,,,,,,0.00,0,0,0,0,0,0,0,0,0,0,0,0,0
20200520,707262,大宇資凱基97購01,,,,,,0.00,0,0,0,0,0,0,0,0,0,0,0,0,0
20200520,707263,神盾凱基96購02,0.06,0.06,0.06,0.06,-0.04,-40.0,1000,1,60,0,0,0,0,0,0,1000,0,1000,1000
20200520,707275,元太元大96購01,1.50,2.67,1.50,2.67,+0.97,57.06,652000,26,1255170,0,0,0,0,0,0,105000,547000,-442000,-442000
20200520,707277,神盾元大97購02,0.12,0.12,0.12,0.12,-0.01,-7.69,10000,1,1200,0,0,0,0,0,0,0,10000,-10000,-10000
20200520,707278,勝麗元大96購01,0.84,0.92,0.84,0.89,+0.10,12.66,59000,3,50140,0,0,0,0,0,0,48000,11000,37000,37000
20200520,707280,碩禾元大96購01,0.03,0.03,0.03,0.03,-0.01,-25.0,50000,1,1500,0,0,0,0,0,0,50000,0,50000,50000
20200520,707285,弘塑國泰97購01,,,,,,0.00,0,0,0,0,0,0,0,0,0,0,0,0,0
20200520,707287,同致國票96購01,,,,,,0.00,0,0,0,0,0,0,0,0,0,0,0,0,0
20200520,707288,良維國票97購01,0.53,0.53,0.50,0.51,-0.01,-1.92,196000,7,100600,0,0,0,0,0,0,94000,179000,-85000,-85000
20200520,707289,緯軟國票97購01,,,,,,0.00,0,0,0,0,0,0,0,0,0,0,0,0,0
20200520,707290,優群國票96購01,,,,,,0.00,0,0,0,0,0,0,0,0,0,0,0,0,0
20200520,707293,泰博兆豐96購01,6.85,7.15,6.85,7.15,+0.10,1.42,11000,2,78350,0,0,0,0,0,0,1000,10000,-9000,-9000
20200520,707294,VHQ群益96購01,,,,,,0.00,0,0,0,0,0,0,0,0,0,0,0,0,0
20200520,707297,台燿凱基96購03,0.37,0.41,0.37,0.41,-0.07,-14.58,45000,16,17030,0,0,0,0,0,0,35000,10000,25000,25000
20200520,707302,原相亞東96購01,,,,,,0.00,0,0,0,0,0,0,0,0,0,0,0,0,0
20200520,707309,合晶國票96購02,,,,,,0.00,0,0,0,0,0,0,0,0,0,0,0,0,0
20200520,707310,原相國票96購01,,,,,,0.00,0,0,0,0,0,0,0,0,0,0,0,0,0
20200520,707315,大江元大96購04,,,,,,0.00,0,0,0,0,0,0,0,0,0,0,0,0,0
20200520,707316,同致元大96購01,,,,,,0.00,0,0,0,0,0,0,0,0,0,0,0,0,0
20200520,707323,環宇元大96購01,,,,,,0.00,0,0,0,0,0,0,0,0,0,0,0,0,0
20200520,707324,櫃200永昌96購04,,,,,,0.00,0,0,0,0,0,0,0,0,0,0,0,0,0
20200520,707325,M31中信96購01,,,,,,0.00,0,0,0,0,0,0,0,0,0,0,0,0,0
20200520,707326,穩懋中信97購01,,,,,,0.00,0,0,0,0,0,0,0,0,0,0,0,0,0
20200520,707328,中美晶凱基96購01,,,,,,0.00,0,0,0,0,0,0,0,0,0,0,0,0,0
20200520,707333,大江國票96購04,,,,,,0.00,0,0,0,0,0,0,0,0,0,0,0,0,0
20200520,707334,合晶國票97購01,,,,,,0.00,0,0,0,0,0,0,0,0,0,0,0,0,0
20200520,707335,勝麗國票97購01,1.00,1.07,1.00,1.02,+0.04,4.08,265000,7,273510,0,0,0,0,0,0,59000,265000,-206000,-206000
20200520,707336,群聯國票96購01,0.80,0.80,0.75,0.79,-0.08,-9.2,56000,5,44670,0,0,0,0,0,0,54000,2000,52000,52000
20200520,707337,網龍國票97購02,1.59,1.69,1.48,1.53,-0.05,-3.16,427000,6,686970,0,0,0,0,0,0,402000,25000,377000,377000
20200520,707338,環球晶國票96購03,,,,,,0.00,0,0,0,0,0,0,0,0,0,0,0,0,0
20200520,707339,晟德國票97購01,0.81,0.92,0.81,0.92,+0.19,26.03,142000,8,123280,0,0,0,0,0,0,20000,122000,-102000,-102000
20200520,707340,神盾國泰97購01,,,,,,0.00,0,0,0,0,0,0,0,0,0,0,0,0,0
20200520,707341,博智國泰97購01,,,,,,0.00,0,0,0,0,0,0,0,0,0,0,0,0,0
20200520,707342,原相富邦99購01,1.89,1.89,1.89,1.89,-0.06,-3.08,20000,2,37800,0,0,0,0,0,0,0,20000,-20000,-20000
20200520,707343,聯亞兆豐96購01,0.61,0.61,0.59,0.59,-0.06,-9.23,112000,3,68040,0,0,0,0,0,0,10000,102000,-92000,-92000
20200520,707345,宣德群益96購01,,,,,,0.00,0,0,0,0,0,0,0,0,0,0,0,0,0
20200520,707346,皇田群益97購01,,,,,,0.00,0,0,0,0,0,0,0,0,0,0,0,0,0
20200520,707347,金居元大96購03,,,,,,0.00,0,0,0,0,0,0,0,0,0,0,0,0,0
20200520,707348,保瑞元大96購01,0.06,0.07,0.06,0.07,0.00,0.0,66000,5,3990,0,0,0,0,0,0,63000,3000,60000,60000
20200520,707349,茂達元大96購01,0.25,0.25,0.25,0.25,+0.15,150.0,70000,1,17500,0,0,0,0,0,0,70000,0,70000,70000
20200520,707350,優群元大96購01,,,,,,0.00,0,0,0,0,0,0,0,0,0,0,0,0,0
20200520,707351,環球晶元大96購01,,,,,,0.00,0,0,0,0,0,0,0,0,0,0,0,0,0
20200520,707352,櫃200元大96購03,,,,,,0.00,0,0,0,0,0,0,0,0,0,0,0,0,0
20200520,707353,櫃200元大96購04,,,,,,0.00,0,0,0,0,0,0,0,0,0,0,0,0,0
20200520,707354,昇達科中信97購01,,,,,,0.00,0,0,0,0,0,0,0,0,0,0,0,0,0
20200520,707357,大江國票97購02,,,,,,0.00,0,0,0,0,0,0,0,0,0,0,0,0,0
20200520,707361,元太元大96購02,1.45,1.71,1.45,1.71,+0.52,43.7,113000,5,188900,0,0,0,0,0,0,113000,0,113000,113000
20200520,707363,合晶元大96購03,0.64,0.64,0.64,0.64,+0.02,3.23,98000,1,62720,0,0,0,0,0,0,0,98000,-98000,-98000
20200520,707365,群聯元大97購01,,,,,,0.00,0,0,0,0,0,0,0,0,0,0,0,0,0
20200520,707366,廣明元大96購01,,,,,,0.00,0,0,0,0,0,0,0,0,0,0,0,0,0
20200520,707368,茂達永豐96購01,,,,,,0.00,0,0,0,0,0,0,0,0,0,0,0,0,0
20200520,707370,杰力國票96購02,,,,,,0.00,0,0,0,0,0,0,0,0,0,0,0,0,0
20200520,707371,大江富邦97購01,,,,,,0.00,0,0,0,0,0,0,0,0,0,0,0,0,0
20200520,707372,原相凱基96購01,,,,,,0.00,0,0,0,0,0,0,0,0,0,0,0,0,0
20200520,707376,雙鴻凱基96購03,,,,,,0.00,0,0,0,0,0,0,0,0,0,0,0,0,0
20200520,707385,晶焱元大96購01,0.53,0.57,0.53,0.57,-0.02,-3.39,337000,13,186970,0,0,0,0,0,0,249000,246000,3000,3000
20200520,707395,大宇資群益97購01,,,,,,0.00,0,0,0,0,0,0,0,0,0,0,0,0,0
20200520,707400,威剛元大96購02,,,,,,0.00,0,0,0,0,0,0,0,0,0,0,0,0,0
20200520,707402,大宇資永豐96購01,,,,,,0.00,0,0,0,0,0,0,0,0,0,0,0,0,0
20200520,707403,旺矽永豐96購01,,,,,,0.00,0,0,0,0,0,0,0,0,0,0,0,0,0
20200520,707405,優群永豐96購01,,,,,,0.00,0,0,0,0,0,0,0,0,0,0,0,0,0
20200520,707406,M31國票96購01,,,,,,0.00,0,0,0,0,0,0,0,0,0,0,0,0,0
20200520,707407,中美晶國票96購03,,,,,,0.00,0,0,0,0,0,0,0,0,0,0,0,0,0
20200520,707408,兆利國票96購01,,,,,,0.00,0,0,0,0,0,0,0,0,0,0,0,0,0
20200520,707410,雙美國票96購01,0.16,0.16,0.16,0.16,-0.01,-5.88,550000,4,88000,0,0,0,0,0,0,550000,0,550000,550000
20200520,707415,櫃200T永昌96購01,,,,,,0.00,0,0,0,0,0,0,0,0,0,0,0,0,0
20200520,707416,櫃200T永昌96購02,,,,,,0.00,0,0,0,0,0,0,0,0,0,0,0,0,0
20200520,707417,櫃200T永昌96購03,,,,,,0.00,0,0,0,0,0,0,0,0,0,0,0,0,0
20200520,707418,櫃200T永昌96購04,,,,,,0.00,0,0,0,0,0,0,0,0,0,0,0,0,0
20200520,707421,緯軟凱基96購01,,,,,,0.00,0,0,0,0,0,0,0,0,0,0,0,0,0
20200520,707422,櫃200凱基99購01,,,,,,0.00,0,0,0,0,0,0,0,0,0,0,0,0,0
20200520,707423,三貝德國票96購02,0.01,0.01,0.01,0.01,0.00,0.0,20000,20,200,0,0,0,0,0,0,0,0,0,0
20200520,707424,大學光國票96購02,,,,,,0.00,0,0,0,0,0,0,0,0,0,0,0,0,0
20200520,707425,台燿國票96購01,0.53,0.53,0.53,0.53,-0.11,-17.19,47000,1,24910,0,0,0,0,0,0,47000,0,47000,47000
20200520,707426,穩懋國票96購03,0.04,0.04,0.04,0.04,-0.03,-42.86,30000,1,1200,0,0,0,0,0,0,30000,0,30000,30000
20200520,707427,新普國泰96購01,,,,,,0.00,0,0,0,0,0,0,0,0,0,0,0,0,0
20200520,707428,譜瑞國泰97購01,,,,,,0.00,0,0,0,0,0,0,0,0,0,0,0,0,0
20200520,707432,雙鴻台新96購01,,,,,,0.00,0,0,0,0,0,0,0,0,0,0,0,0,0
20200520,707434,環球晶元大96購02,2.39,2.39,2.18,2.18,-0.18,-7.63,67000,4,157630,0,0,0,0,0,0,23000,52000,-29000,-29000
20200520,707437,群聯兆豐96購01,,,,,,0.00,0,0,0,0,0,0,0,0,0,0,0,0,0
20200520,707440,昇達科群益97購01,,,,,,0.00,0,0,0,0,0,0,0,0,0,0,0,0,0
20200520,707441,晶焱群益96購01,,,,,,0.00,0,0,0,0,0,0,0,0,0,0,0,0,0
20200520,707442,櫃200富邦9A購01,1.45,1.45,1.45,1.45,+0.59,68.6,3000,1,4350,0,0,0,0,0,0,3000,0,3000,3000
20200520,707443,櫃200富邦9A購02,,,,,,0.00,0,0,0,0,0,0,0,0,0,0,0,0,0
20200520,707444,雙鴻富邦96購02,,,,,,0.00,0,0,0,0,0,0,0,0,0,0,0,0,0
20200520,707450,大江中信96購01,,,,,,0.00,0,0,0,0,0,0,0,0,0,0,0,0,0
20200520,707451,大江台新95購01,,,,,,0.00,0,0,0,0,0,0,0,0,0,0,0,0,0
20200520,707452,兆利元大96購01,,,,,,0.00,0,0,0,0,0,0,0,0,0,0,0,0,0
20200520,707453,迅得元大95購02,,,,,,0.00,0,0,0,0,0,0,0,0,0,0,0,0,0
20200520,707454,博智元大95購03,,,,,,0.00,0,0,0,0,0,0,0,0,0,0,0,0,0
20200520,707455,神盾康和95購01,,,,,,0.00,0,0,0,0,0,0,0,0,0,0,0,0,0
20200520,707456,勝麗群益95購02,,,,,,0.00,0,0,0,0,0,0,0,0,0,0,0,0,0
20200520,707457,緯軟群益96購01,,,,,,0.00,0,0,0,0,0,0,0,0,0,0,0,0,0
20200520,707458,金居統一95購01,,,,,,0.00,0,0,0,0,0,0,0,0,0,0,0,0,0
20200520,707459,迅得凱基98購01,,,,,,0.00,0,0,0,0,0,0,0,0,0,0,0,0,0
20200520,707460,邦特凱基95購01,,,,,,0.00,0,0,0,0,0,0,0,0,0,0,0,0,0
20200520,707461,信昌電凱基97購01,,,,,,0.00,0,0,0,0,0,0,0,0,0,0,0,0,0
20200520,707462,茂達凱基9B購01,0.68,1.11,0.68,1.11,+0.56,101.82,79000,14,61790,0,0,0,0,0,0,4000,72000,-68000,-68000
20200520,707463,神盾凱基9B購01,0.57,0.57,0.51,0.51,-0.04,-7.27,453000,34,246770,0,0,0,0,0,0,196000,257000,-61000,-61000
20200520,707464,勝麗凱基97購01,0.76,0.78,0.76,0.78,+0.03,4.0,157000,3,121260,0,0,0,0,0,0,120000,37000,83000,83000
20200520,707465,閎康凱基97購01,,,,,,0.00,0,0,0,0,0,0,0,0,0,0,0,0,0
20200520,707466,環宇凱基97購01,,,,,,0.00,0,0,0,0,0,0,0,0,0,0,0,0,0
20200520,707467,環球晶凱基96購01,2.74,2.76,2.54,2.54,-0.34,-11.81,14000,3,37720,0,0,0,0,0,0,14000,10000,4000,4000
20200520,707468,穩懋凱基96購03,,,,,,0.00,0,0,0,0,0,0,0,0,0,0,0,0,0
20200520,707469,鈺太凱基97購01,0.27,0.27,0.27,0.27,+0.02,8.0,110000,3,29700,0,0,0,0,0,0,0,110000,-110000,-110000
20200520,707470,鐿鈦凱基96購01,,,,,,0.00,0,0,0,0,0,0,0,0,0,0,0,0,0
20200520,707471,信昌電國票96購02,,,,,,0.00,0,0,0,0,0,0,0,0,0,0,0,0,0
20200520,707472,晶焱國票96購02,,,,,,0.00,0,0,0,0,0,0,0,0,0,0,0,0,0
20200520,707473,群聯國票96購02,0.18,0.18,0.17,0.17,-0.04,-19.05,70000,3,12500,0,0,0,0,0,0,0,70000,-70000,-70000
20200520,707474,穩懋富邦97購01,0.13,0.13,0.13,0.13,-0.03,-18.75,45000,2,5850,0,0,0,0,0,0,0,0,0,0
20200520,707475,光洋科永豐95購01,,,,,,0.00,0,0,0,0,0,0,0,0,0,0,0,0,0
20200520,707476,穩懋永豐95購03,,,,,,0.00,0,0,0,0,0,0,0,0,0,0,0,0,0
20200520,707477,網龍中信95購01,,,,,,0.00,0,0,0,0,0,0,0,0,0,0,0,0,0
20200520,707478,中美晶凱基95購03,,,,,,0.00,0,0,0,0,0,0,0,0,0,0,0,0,0
20200520,707479,晶焱凱基96購01,,,,,,0.00,0,0,0,0,0,0,0,0,0,0,0,0,0
20200520,707480,環球晶凱基97購01,,,,,,0.00,0,0,0,0,0,0,0,0,0,0,0,0,0
20200520,707481,三貝德永豐95購01,,,,,,0.00,0,0,0,0,0,0,0,0,0,0,0,0,0
20200520,707482,神盾永豐95購02,,,,,,0.00,0,0,0,0,0,0,0,0,0,0,0,0,0
20200520,707483,環球晶永豐95購04,,,,,,0.00,0,0,0,0,0,0,0,0,0,0,0,0,0
20200520,707484,大江元大96購05,,,,,,0.00,0,0,0,0,0,0,0,0,0,0,0,0,0
20200520,707485,同致元大97購01,,,,,,0.00,0,0,0,0,0,0,0,0,0,0,0,0,0
20200520,707487,迅得國票96購01,,,,,,0.00,0,0,0,0,0,0,0,0,0,0,0,0,0
20200520,707488,宜鼎國票96購02,,,,,,0.00,0,0,0,0,0,0,0,0,0,0,0,0,0
20200520,707489,美琪瑪國票96購01,,,,,,0.00,0,0,0,0,0,0,0,0,0,0,0,0,0
20200520,707490,智崴國泰96購01,,,,,,0.00,0,0,0,0,0,0,0,0,0,0,0,0,0
20200520,707491,櫃200T永昌9C購01,,,,,,0.00,0,0,0,0,0,0,0,0,0,0,0,0,0
20200520,707492,櫃200T永昌9C購02,,,,,,0.00,0,0,0,0,0,0,0,0,0,0,0,0,0
20200520,707493,櫃200T永昌9C購03,,,,,,0.00,0,0,0,0,0,0,0,0,0,0,0,0,0
20200520,707494,櫃200T永昌9C購04,,,,,,0.00,0,0,0,0,0,0,0,0,0,0,0,0,0
20200520,707495,穩懋康和95購02,,,,,,0.00,0,0,0,0,0,0,0,0,0,0,0,0,0
20200520,707496,精華群益95購03,,,,,,0.00,0,0,0,0,0,0,0,0,0,0,0,0,0
20200520,707497,宜鼎元大95購02,,,,,,0.00,0,0,0,0,0,0,0,0,0,0,0,0,0
20200520,707498,旺矽元大96購01,,,,,,0.00,0,0,0,0,0,0,0,0,0,0,0,0,0
20200520,707499,精華元大95購03,,,,,,0.00,0,0,0,0,0,0,0,0,0,0,0,0,0
20200520,707500,智崴國票96購01,,,,,,0.00,0,0,0,0,0,0,0,0,0,0,0,0,0
20200520,707501,閎康國票97購01,0.78,0.84,0.78,0.84,+0.06,7.69,205000,7,164040,0,0,0,0,0,0,36000,169000,-133000,-133000
20200520,707502,金可國泰97購01,,,,,,0.00,0,0,0,0,0,0,0,0,0,0,0,0,0
20200520,707503,精華國泰97購01,,,,,,0.00,0,0,0,0,0,0,0,0,0,0,0,0,0
20200520,707504,環球晶國泰96購03,1.65,1.65,1.65,1.65,-0.09,-5.17,2000,1,3300,0,0,0,0,0,0,0,2000,-2000,-2000
20200520,707505,穩懋國泰96購02,,,,,,0.00,0,0,0,0,0,0,0,0,0,0,0,0,0
20200520,707506,穩懋統一96購05,0.27,0.30,0.27,0.30,-0.04,-11.76,130000,2,38100,0,0,0,0,0,0,30000,100000,-70000,-70000
20200520,707507,三貝德凱基96購02,,,,,,0.00,0,0,0,0,0,0,0,0,0,0,0,0,0
20200520,707508,中美晶凱基95購04,,,,,,0.00,0,0,0,0,0,0,0,0,0,0,0,0,0
20200520,707509,元太凱基96購01,0.14,0.26,0.14,0.26,+0.02,8.33,74000,5,10790,0,0,0,0,0,0,74000,0,74000,74000
20200520,707511,建榮凱基97購01,,,,,,0.00,0,0,0,0,0,0,0,0,0,0,0,0,0
20200520,707512,穩懋凱基96購04,,,,,,0.00,0,0,0,0,0,0,0,0,0,0,0,0,0
20200520,707513,元太第一95購01,,,,,,0.00,0,0,0,0,0,0,0,0,0,0,0,0,0
20200520,707514,晶焱永豐95購02,,,,,,0.00,0,0,0,0,0,0,0,0,0,0,0,0,0
20200520,707515,精華永豐95購02,,,,,,0.00,0,0,0,0,0,0,0,0,0,0,0,0,0
20200520,707516,聚積永豐95購01,,,,,,0.00,0,0,0,0,0,0,0,0,0,0,0,0,0
20200520,707517,穩懋兆豐96購02,,,,,,0.00,0,0,0,0,0,0,0,0,0,0,0,0,0
20200520,707518,金可康和95購01,,,,,,0.00,0,0,0,0,0,0,0,0,0,0,0,0,0
20200520,707519,金可群益95購01,,,,,,0.00,0,0,0,0,0,0,0,0,0,0,0,0,0
20200520,707520,優群群益97購01,3.59,3.59,3.59,3.59,+0.04,1.13,4000,1,14360,0,0,0,0,0,0,4000,0,4000,4000
20200520,707521,環球晶群益95購04,,,,,,0.00,0,0,0,0,0,0,0,0,0,0,0,0,0
20200520,707522,聯亞群益95購02,,,,,,0.00,0,0,0,0,0,0,0,0,0,0,0,0,0
20200520,707523,群聯元富95購02,,,,,,0.00,0,0,0,0,0,0,0,0,0,0,0,0,0
20200520,707524,鈺太兆豐95購01,,,,,,0.00,0,0,0,0,0,0,0,0,0,0,0,0,0
20200520,707525,泰博中信97購01,,,,,,0.00,0,0,0,0,0,0,0,0,0,0,0,0,0
20200520,707526,建榮凱基96購01,,,,,,0.00,0,0,0,0,0,0,0,0,0,0,0,0,0
20200520,707527,新普凱基95購02,,,,,,0.00,0,0,0,0,0,0,0,0,0,0,0,0,0
20200520,707528,精華凱基96購01,,,,,,0.00,0,0,0,0,0,0,0,0,0,0,0,0,0
20200520,707529,精華統一97購01,,,,,,0.00,0,0,0,0,0,0,0,0,0,0,0,0,0
20200520,707530,精華統一97購02,,,,,,0.00,0,0,0,0,0,0,0,0,0,0,0,0,0
20200520,707531,神盾國票97購01,0.22,0.22,0.20,0.20,0.00,0.0,70000,3,15000,0,0,0,0,0,0,0,70000,-70000,-70000
20200520,707532,群聯國票96購03,0.23,0.23,0.23,0.23,+0.03,15.0,16000,2,3680,0,0,0,0,0,0,0,16000,-16000,-16000
20200520,707533,緯軟國票97購02,,,,,,0.00,0,0,0,0,0,0,0,0,0,0,0,0,0
20200520,707534,碩禾元大98購01,,,,,,0.00,0,0,0,0,0,0,0,0,0,0,0,0,0
20200520,707535,精華元大96購01,,,,,,0.00,0,0,0,0,0,0,0,0,0,0,0,0,0
20200520,707536,穩懋元大95購12,,,,,,0.00,0,0,0,0,0,0,0,0,0,0,0,0,0
20200520,707537,穩懋元大95購13,,,,,,0.00,0,0,0,0,0,0,0,0,0,0,0,0,0
20200520,707538,世界永豐95購01,,,,,,0.00,0,0,0,0,0,0,0,0,0,0,0,0,0
20200520,707539,合晶永豐95購03,,,,,,0.00,0,0,0,0,0,0,0,0,0,0,0,0,0
20200520,707540,宇峻永豐95購02,,,,,,0.00,0,0,0,0,0,0,0,0,0,0,0,0,0
20200520,707541,佳邦永豐95購01,,,,,,0.00,0,0,0,0,0,0,0,0,0,0,0,0,0
20200520,707542,金居永豐95購01,,,,,,0.00,0,0,0,0,0,0,0,0,0,0,0,0,0
20200520,707543,泰博永豐95購01,,,,,,0.00,0,0,0,0,0,0,0,0,0,0,0,0,0
20200520,707544,勝麗永豐95購02,,,,,,0.00,0,0,0,0,0,0,0,0,0,0,0,0,0
20200520,707545,晟德永豐95購02,,,,,,0.00,0,0,0,0,0,0,0,0,0,0,0,0,0
20200520,707546,台半亞東96購01,,,,,,0.00,0,0,0,0,0,0,0,0,0,0,0,0,0
20200520,707547,世界中信96購01,,,,,,0.00,0,0,0,0,0,0,0,0,0,0,0,0,0
20200520,707548,精測中信95購01,,,,,,0.00,0,0,0,0,0,0,0,0,0,0,0,0,0
20200520,707549,精測凱基96購01,,,,,,0.00,0,0,0,0,0,0,0,0,0,0,0,0,0
20200520,707550,聯亞凱基95購03,,,,,,0.00,0,0,0,0,0,0,0,0,0,0,0,0,0
20200520,707551,穩懋凱基95購03,,,,,,0.00,0,0,0,0,0,0,0,0,0,0,0,0,0
20200520,707552,精測統一96購01,,,,,,0.00,0,0,0,0,0,0,0,0,0,0,0,0,0
20200520,707553,安勤永豐95購01,,,,,,0.00,0,0,0,0,0,0,0,0,0,0,0,0,0
20200520,707554,金可永豐95購02,,,,,,0.00,0,0,0,0,0,0,0,0,0,0,0,0,0
20200520,707555,宣德永豐95購03,,,,,,0.00,0,0,0,0,0,0,0,0,0,0,0,0,0
20200520,707556,精測永豐96購01,,,,,,0.00,0,0,0,0,0,0,0,0,0,0,0,0,0
20200520,707557,廣明永豐95購02,,,,,,0.00,0,0,0,0,0,0,0,0,0,0,0,0,0
20200520,707558,台燿亞東95購01,,,,,,0.00,0,0,0,0,0,0,0,0,0,0,0,0,0
20200520,707559,信昌電亞東95購01,,,,,,0.00,0,0,0,0,0,0,0,0,0,0,0,0,0
20200520,707560,精測元富95購01,,,,,,0.00,0,0,0,0,0,0,0,0,0,0,0,0,0
20200520,707561,M31國票96購02,,,,,,0.00,0,0,0,0,0,0,0,0,0,0,0,0,0
20200520,707562,由田國票97購01,,,,,,0.00,0,0,0,0,0,0,0,0,0,0,0,0,0
20200520,707563,宇峻國票96購01,,,,,,0.00,0,0,0,0,0,0,0,0,0,0,0,0,0
20200520,707564,環球晶國票96購04,,,,,,0.00,0,0,0,0,0,0,0,0,0,0,0,0,0
20200520,707565,精測國泰95購01,,,,,,0.00,0,0,0,0,0,0,0,0,0,0,0,0,0
20200520,707566,大江元大96購06,,,,,,0.00,0,0,0,0,0,0,0,0,0,0,0,0,0
20200520,707567,合晶元大96購04,0.54,0.55,0.54,0.55,+0.03,5.77,3000,2,1640,0,0,0,0,0,0,3000,0,3000,3000
20200520,707568,勝麗元大95購03,,,,,,0.00,0,0,0,0,0,0,0,0,0,0,0,0,0
20200520,707569,群聯元大95購07,,,,,,0.00,0,0,0,0,0,0,0,0,0,0,0,0,0
20200520,707570,精測元大95購02,,,,,,0.00,0,0,0,0,0,0,0,0,0,0,0,0,0
20200520,707571,優群元大97購01,,,,,,0.00,0,0,0,0,0,0,0,0,0,0,0,0,0
20200520,707572,穩懋元大95購14,,,,,,0.00,0,0,0,0,0,0,0,0,0,0,0,0,0
20200520,707573,穩懋元大96購02,,,,,,0.00,0,0,0,0,0,0,0,0,0,0,0,0,0
20200520,707574,大江富邦97購03,,,,,,0.00,0,0,0,0,0,0,0,0,0,0,0,0,0
20200520,707575,雙鴻康和95購02,,,,,,0.00,0,0,0,0,0,0,0,0,0,0,0,0,0
20200520,707576,元太群益95購02,,,,,,0.00,0,0,0,0,0,0,0,0,0,0,0,0,0
20200520,707577,神盾群益97購01,0.18,0.18,0.16,0.16,-0.01,-5.88,30000,3,5100,0,0,0,0,0,0,0,30000,-30000,-30000
20200520,707578,精測群益95購01,,,,,,0.00,0,0,0,0,0,0,0,0,0,0,0,0,0
20200520,707579,聯亞群益95購03,,,,,,0.00,0,0,0,0,0,0,0,0,0,0,0,0,0
20200520,707580,雙鴻群益96購03,,,,,,0.00,0,0,0,0,0,0,0,0,0,0,0,0,0
20200520,707581,世界元大96購01,,,,,,0.00,0,0,0,0,0,0,0,0,0,0,0,0,0
20200520,707582,金可元大96購01,,,,,,0.00,0,0,0,0,0,0,0,0,0,0,0,0,0
20200520,707583,順達元大96購01,1.11,1.46,1.11,1.46,+0.32,28.07,199000,7,251170,0,0,0,0,0,0,18000,199000,-181000,-181000
20200520,707584,精測元大97購01,,,,,,0.00,0,0,0,0,0,0,0,0,0,0,0,0,0
20200520,707585,精華元大96購02,,,,,,0.00,0,0,0,0,0,0,0,0,0,0,0,0,0
20200520,707586,新鉅科元富96購02,,,,,,0.00,0,0,0,0,0,0,0,0,0,0,0,0,0
20200520,707587,精測元富96購01,,,,,,0.00,0,0,0,0,0,0,0,0,0,0,0,0,0
20200520,707588,廣明元富96購01,,,,,,0.00,0,0,0,0,0,0,0,0,0,0,0,0,0
20200520,707589,宣德統一96購01,,,,,,0.00,0,0,0,0,0,0,0,0,0,0,0,0,0
20200520,707590,群聯統一96購03,,,,,,0.00,0,0,0,0,0,0,0,0,0,0,0,0,0
20200520,707591,精測統一97購01,,,,,,0.00,0,0,0,0,0,0,0,0,0,0,0,0,0
20200520,707592,穩懋統一97購01,,,,,,0.00,0,0,0,0,0,0,0,0,0,0,0,0,0
20200520,707593,穩懋統一98購01,,,,,,0.00,0,0,0,0,0,0,0,0,0,0,0,0,0
20200520,707595,精測凱基97購01,,,,,,0.00,0,0,0,0,0,0,0,0,0,0,0,0,0
20200520,707596,精測凱基97購02,,,,,,0.00,0,0,0,0,0,0,0,0,0,0,0,0,0
20200520,707597,雙鴻凱基96購04,,,,,,0.00,0,0,0,0,0,0,0,0,0,0,0,0,0
20200520,707598,穩懋凱基96購05,,,,,,0.00,0,0,0,0,0,0,0,0,0,0,0,0,0
20200520,707599,大江永豐96購01,,,,,,0.00,0,0,0,0,0,0,0,0,0,0,0,0,0
20200520,707600,中美晶永豐96購01,,,,,,0.00,0,0,0,0,0,0,0,0,0,0,0,0,0
20200520,707601,精測永豐96購02,,,,,,0.00,0,0,0,0,0,0,0,0,0,0,0,0,0
20200520,707602,精測永豐97購01,,,,,,0.00,0,0,0,0,0,0,0,0,0,0,0,0,0
20200520,707603,邦特國票97購01,0.07,0.11,0.07,0.11,+0.05,83.33,90000,6,7700,0,0,0,0,0,0,90000,0,90000,90000
20200520,707604,金可國票97購01,,,,,,0.00,0,0,0,0,0,0,0,0,0,0,0,0,0
20200520,707605,群聯富邦97購01,,,,,,0.00,0,0,0,0,0,0,0,0,0,0,0,0,0
20200520,707606,精測富邦96購01,,,,,,0.00,0,0,0,0,0,0,0,0,0,0,0,0,0
20200520,707607,精測兆豐97購01,,,,,,0.00,0,0,0,0,0,0,0,0,0,0,0,0,0
20200520,707608,東洋群益96購01,,,,,,0.00,0,0,0,0,0,0,0,0,0,0,0,0,0
20200520,707609,金居群益98購01,0.56,0.58,0.56,0.56,-0.08,-12.5,234000,3,133000,0,0,0,0,0,0,234000,0,234000,234000
20200520,707610,保瑞群益98購01,0.21,0.22,0.21,0.22,-0.08,-26.67,4000,2,860,0,0,0,0,0,0,2000,0,2000,2000
20200520,707611,新鉅科群益96購01,,,,,,0.00,0,0,0,0,0,0,0,0,0,0,0,0,0
20200520,707612,精測群益96購01,,,,,,0.00,0,0,0,0,0,0,0,0,0,0,0,0,0
20200520,707613,鈊象台新97購01,,,,,,0.00,0,0,0,0,0,0,0,0,0,0,0,0,0
20200520,707614,精測中信96購02,,,,,,0.00,0,0,0,0,0,0,0,0,0,0,0,0,0
20200520,707615,鈊象中信96購01,,,,,,0.00,0,0,0,0,0,0,0,0,0,0,0,0,0
20200520,707616,M31凱基97購01,,,,,,0.00,0,0,0,0,0,0,0,0,0,0,0,0,0
20200520,707617,宣德凱基96購01,,,,,,0.00,0,0,0,0,0,0,0,0,0,0,0,0,0
20200520,707618,精測凱基97購03,,,,,,0.00,0,0,0,0,0,0,0,0,0,0,0,0,0
20200520,707619,璟德凱基96購01,,,,,,0.00,0,0,0,0,0,0,0,0,0,0,0,0,0
20200520,707620,鐿鈦凱基96購02,,,,,,0.00,0,0,0,0,0,0,0,0,0,0,0,0,0
20200520,707621,精測統一97購02,0.10,0.10,0.10,0.10,-0.03,-23.08,20000,1,2000,0,0,0,0,0,0,20000,0,20000,20000
20200520,707622,鈊象統一96購01,,,,,,0.00,0,0,0,0,0,0,0,0,0,0,0,0,0
20200520,707623,勝麗兆豐96購01,,,,,,0.00,0,0,0,0,0,0,0,0,0,0,0,0,0
20200520,707624,精測康和96購02,,,,,,0.00,0,0,0,0,0,0,0,0,0,0,0,0,0
20200520,707625,鈊象康和96購01,,,,,,0.00,0,0,0,0,0,0,0,0,0,0,0,0,0
20200520,707626,環球晶永昌99購01,1.93,1.93,1.93,1.93,-0.19,-8.96,20000,2,38600,0,0,0,0,0,0,0,20000,-20000,-20000
20200520,707627,迅得永豐97購01,,,,,,0.00,0,0,0,0,0,0,0,0,0,0,0,0,0
20200520,707628,旺矽永豐97購01,0.53,0.67,0.53,0.67,+0.14,26.42,111000,6,68630,0,0,0,0,0,0,71000,40000,31000,31000
20200520,707629,昇達科永豐97購01,,,,,,0.00,0,0,0,0,0,0,0,0,0,0,0,0,0
20200520,707630,僑威永豐96購01,,,,,,0.00,0,0,0,0,0,0,0,0,0,0,0,0,0
20200520,707631,璟德永豐96購01,,,,,,0.00,0,0,0,0,0,0,0,0,0,0,0,0,0
20200520,707632,鈊象永豐96購01,,,,,,0.00,0,0,0,0,0,0,0,0,0,0,0,0,0
20200520,707633,鈊象永豐97購01,,,,,,0.00,0,0,0,0,0,0,0,0,0,0,0,0,0
20200520,707634,元太元大96購03,0.68,1.20,0.62,1.20,+0.47,64.38,694000,16,509620,0,0,0,0,0,0,215000,479000,-264000,-264000
20200520,707635,宣德元大96購02,,,,,,0.00,0,0,0,0,0,0,0,0,0,0,0,0,0
20200520,707636,新普元大96購01,,,,,,0.00,0,0,0,0,0,0,0,0,0,0,0,0,0
20200520,707637,群聯元大97購02,,,,,,0.00,0,0,0,0,0,0,0,0,0,0,0,0,0
20200520,707638,精測元大96購01,,,,,,0.00,0,0,0,0,0,0,0,0,0,0,0,0,0
20200520,707639,鈊象元大97購01,,,,,,0.00,0,0,0,0,0,0,0,0,0,0,0,0,0
20200520,707640,波若威國票97購01,0.07,0.07,0.07,0.07,+0.01,16.67,208000,3,14560,0,0,0,0,0,0,0,208000,-208000,-208000
20200520,707641,聯亞國票97購01,,,,,,0.00,0,0,0,0,0,0,0,0,0,0,0,0,0
20200520,707642,宣德國泰97購01,0.30,0.30,0.30,0.30,+0.06,25.0,10000,1,3000,0,0,0,0,0,0,10000,0,10000,10000
20200520,707643,原相國泰98購01,,,,,,0.00,0,0,0,0,0,0,0,0,0,0,0,0,0
20200520,707644,精測國泰98購01,,,,,,0.00,0,0,0,0,0,0,0,0,0,0,0,0,0
20200520,707645,鈊象國泰98購01,,,,,,0.00,0,0,0,0,0,0,0,0,0,0,0,0,0
20200520,707646,鈊象群益99購01,,,,,,0.00,0,0,0,0,0,0,0,0,0,0,0,0,0
20200520,707647,鈺太中信96購02,,,,,,0.00,0,0,0,0,0,0,0,0,0,0,0,0,0
20200520,707648,雙鴻統一96購01,,,,,,0.00,0,0,0,0,0,0,0,0,0,0,0,0,0
20200520,707649,鈊象統一96購02,,,,,,0.00,0,0,0,0,0,0,0,0,0,0,0,0,0
20200520,707650,宇峻凱基98購01,0.24,0.25,0.24,0.25,0.00,0.0,23000,2,5720,0,0,0,0,0,0,0,0,0,0
20200520,707651,精測凱基96購03,,,,,,0.00,0,0,0,0,0,0,0,0,0,0,0,0,0
20200520,707652,環球晶凱基96購03,,,,,,0.00,0,0,0,0,0,0,0,0,0,0,0,0,0
20200520,707653,櫃200凱基96購03,,,,,,0.00,0,0,0,0,0,0,0,0,0,0,0,0,0
20200520,707654,雙美凱基97購01,,,,,,0.00,0,0,0,0,0,0,0,0,0,0,0,0,0
20200520,707655,穩懋凱基96購06,,,,,,0.00,0,0,0,0,0,0,0,0,0,0,0,0,0
20200520,707656,鈊象凱基96購01,,,,,,0.00,0,0,0,0,0,0,0,0,0,0,0,0,0
20200520,707657,鈊象凱基97購01,3.93,3.93,3.93,3.93,-0.26,-6.21,2000,1,7860,0,0,0,0,0,0,2000,0,2000,2000
20200520,707658,信昌電元富96購01,0.11,0.11,0.11,0.11,+0.03,37.5,10000,1,1100,0,0,0,0,0,0,10000,0,10000,10000
20200520,707659,精測元富96購02,,,,,,0.00,0,0,0,0,0,0,0,0,0,0,0,0,0
20200520,707660,鈊象元富96購01,,,,,,0.00,0,0,0,0,0,0,0,0,0,0,0,0,0
20200520,707661,宣德台新96購01,,,,,,0.00,0,0,0,0,0,0,0,0,0,0,0,0,0
20200520,707662,凡甲國票97購01,1.92,1.92,1.92,1.92,-0.01,-0.52,20000,2,38400,0,0,0,0,0,0,0,20000,-20000,-20000
20200520,707663,世界國票97購01,,,,,,0.00,0,0,0,0,0,0,0,0,0,0,0,0,0
20200520,707664,杰力國票97購01,0.81,0.93,0.81,0.93,+0.15,19.23,245000,3,204450,0,0,0,0,0,0,195000,50000,145000,145000
20200520,707665,原相國票98購01,,,,,,0.00,0,0,0,0,0,0,0,0,0,0,0,0,0
20200520,707666,鈊象國票96購02,5.25,5.25,5.25,5.25,-0.75,-12.5,2000,1,10500,0,0,0,0,0,0,2000,0,2000,2000
20200520,707667,精測國泰98購02,,,,,,0.00,0,0,0,0,0,0,0,0,0,0,0,0,0
20200520,707668,合晶富邦96購01,,,,,,0.00,0,0,0,0,0,0,0,0,0,0,0,0,0
20200520,707669,安勤永豐97購01,,,,,,0.00,0,0,0,0,0,0,0,0,0,0,0,0,0
20200520,707670,閎康永豐96購01,,,,,,0.00,0,0,0,0,0,0,0,0,0,0,0,0,0
20200520,707671,精測永豐96購04,,,,,,0.00,0,0,0,0,0,0,0,0,0,0,0,0,0
20200520,707672,晶焱兆豐97購01,0.42,0.42,0.42,0.42,-0.02,-4.55,30000,1,12600,0,0,0,0,0,0,0,30000,-30000,-30000
20200520,707673,雙鴻兆豐97購02,,,,,,0.00,0,0,0,0,0,0,0,0,0,0,0,0,0
20200520,707674,合晶元大97購01,,,,,,0.00,0,0,0,0,0,0,0,0,0,0,0,0,0
20200520,707675,茂達元大97購01,,,,,,0.00,0,0,0,0,0,0,0,0,0,0,0,0,0
20200520,707676,原相元大97購02,,,,,,0.00,0,0,0,0,0,0,0,0,0,0,0,0,0
20200520,707677,勝麗元大96購02,,,,,,0.00,0,0,0,0,0,0,0,0,0,0,0,0,0
20200520,707678,精測元大98購01,,,,,,0.00,0,0,0,0,0,0,0,0,0,0,0,0,0
20200520,707679,璟德元大96購01,,,,,,0.00,0,0,0,0,0,0,0,0,0,0,0,0,0
20200520,707680,鈊象元大98購01,,,,,,0.00,0,0,0,0,0,0,0,0,0,0,0,0,0
20200520,707681,力麒康和96購01,,,,,,0.00,0,0,0,0,0,0,0,0,0,0,0,0,0
20200520,707682,精測康和96購03,,,,,,0.00,0,0,0,0,0,0,0,0,0,0,0,0,0
20200520,707683,東隆興群益96購01,,,,,,0.00,0,0,0,0,0,0,0,0,0,0,0,0,0
20200520,707684,金居群益98購02,0.71,0.71,0.71,0.71,-0.09,-11.25,107000,1,75970,0,0,0,0,0,0,107000,0,107000,107000
20200520,707685,保瑞群益98購02,,,,,,0.00,0,0,0,0,0,0,0,0,0,0,0,0,0
20200520,707686,神盾群益98購01,,,,,,0.00,0,0,0,0,0,0,0,0,0,0,0,0,0
20200520,707687,順達群益96購02,,,,,,0.00,0,0,0,0,0,0,0,0,0,0,0,0,0
20200520,707688,緯軟統一96購01,,,,,,0.00,0,0,0,0,0,0,0,0,0,0,0,0,0
20200520,707689,穩懋統一96購06,0.16,0.16,0.16,0.16,-0.07,-30.43,200000,1,32000,0,0,0,0,0,0,200000,0,200000,200000
20200520,707690,鈊象統一96購03,,,,,,0.00,0,0,0,0,0,0,0,0,0,0,0,0,0
20200520,707691,同致元大97購02,,,,,,0.00,0,0,0,0,0,0,0,0,0,0,0,0,0
20200520,707692,迅得元大97購01,,,,,,0.00,0,0,0,0,0,0,0,0,0,0,0,0,0
20200520,707693,晶焱元大97購01,0.65,0.65,0.65,0.65,0.00,0.0,100000,1,65000,0,0,0,0,0,0,100000,0,100000,100000
20200520,707694,群聯元大97購03,,,,,,0.00,0,0,0,0,0,0,0,0,0,0,0,0,0
20200520,707695,優群元大97購02,,,,,,0.00,0,0,0,0,0,0,0,0,0,0,0,0,0
20200520,707696,聯亞元大97購01,,,,,,0.00,0,0,0,0,0,0,0,0,0,0,0,0,0
20200520,707697,穩懋元大96購03,,,,,,0.00,0,0,0,0,0,0,0,0,0,0,0,0,0
20200520,707698,鈊象元大97購02,,,,,,0.00,0,0,0,0,0,0,0,0,0,0,0,0,0
20200520,707699,原相元富96購01,,,,,,0.00,0,0,0,0,0,0,0,0,0,0,0,0,0
20200520,707700,精華元富96購01,,,,,,0.00,0,0,0,0,0,0,0,0,0,0,0,0,0
20200520,707701,環球晶元富96購01,,,,,,0.00,0,0,0,0,0,0,0,0,0,0,0,0,0
20200520,707702,鈊象台新98購01,,,,,,0.00,0,0,0,0,0,0,0,0,0,0,0,0,0
20200520,707703,M31凱基96購01,,,,,,0.00,0,0,0,0,0,0,0,0,0,0,0,0,0
20200520,707704,金可凱基97購01,,,,,,0.00,0,0,0,0,0,0,0,0,0,0,0,0,0
20200520,707705,金居凱基96購01,,,,,,0.00,0,0,0,0,0,0,0,0,0,0,0,0,0
20200520,707706,精華凱基96購02,,,,,,0.00,0,0,0,0,0,0,0,0,0,0,0,0,0
20200520,707707,環球晶凱基96購04,,,,,,0.00,0,0,0,0,0,0,0,0,0,0,0,0,0
20200520,707708,聯亞凱基96購01,,,,,,0.00,0,0,0,0,0,0,0,0,0,0,0,0,0
20200520,707709,鐿鈦凱基97購01,,,,,,0.00,0,0,0,0,0,0,0,0,0,0,0,0,0
20200520,707710,大田國票97購01,0.74,0.82,0.71,0.82,+0.07,9.33,315000,16,234020,0,0,0,0,0,0,271000,44000,227000,227000
20200520,707711,六角國票98購01,,,,,,0.00,0,0,0,0,0,0,0,0,0,0,0,0,0
20200520,707713,晶焱國票97購01,,,,,,0.00,0,0,0,0,0,0,0,0,0,0,0,0,0
20200520,707714,群聯國票97購01,,,,,,0.00,0,0,0,0,0,0,0,0,0,0,0,0,0
20200520,707715,大江國泰98購01,0.16,0.16,0.16,0.16,-0.02,-11.11,31000,1,4960,0,0,0,0,0,0,31000,0,31000,31000
20200520,707716,晶焱國泰98購01,,,,,,0.00,0,0,0,0,0,0,0,0,0,0,0,0,0
20200520,707717,穩懋國泰97購01,,,,,,0.00,0,0,0,0,0,0,0,0,0,0,0,0,0
20200520,707718,良維永豐96購01,,,,,,0.00,0,0,0,0,0,0,0,0,0,0,0,0,0
20200520,707719,威剛永豐96購01,,,,,,0.00,0,0,0,0,0,0,0,0,0,0,0,0,0
20200520,707720,宣德永豐97購01,,,,,,0.00,0,0,0,0,0,0,0,0,0,0,0,0,0
20200520,707721,鈊象永豐96購03,,,,,,0.00,0,0,0,0,0,0,0,0,0,0,0,0,0
20200520,707722,三貝德群益96購01,,,,,,0.00,0,0,0,0,0,0,0,0,0,0,0,0,0
20200520,707723,宜鼎群益96購02,,,,,,0.00,0,0,0,0,0,0,0,0,0,0,0,0,0
20200520,707724,長科*群益96購01,,,,,,0.00,0,0,0,0,0,0,0,0,0,0,0,0,0
20200520,707725,閎康群益97購01,0.32,0.33,0.32,0.33,+0.03,10.0,180000,2,58600,0,0,0,0,0,0,0,180000,-180000,-180000
20200520,707726,晟德群益96購01,,,,,,0.00,0,0,0,0,0,0,0,0,0,0,0,0,0
20200520,707727,鈊象群益99購02,,,,,,0.00,0,0,0,0,0,0,0,0,0,0,0,0,0
20200520,707728,鈊象康和96購03,,,,,,0.00,0,0,0,0,0,0,0,0,0,0,0,0,0
20200520,707729,鈊象凱基98購01,5.80,5.95,5.75,5.75,-0.05,-0.86,39000,10,227850,0,0,0,0,0,0,36000,9000,27000,27000
20200520,707730,穩懋元富96購01,,,,,,0.00,0,0,0,0,0,0,0,0,0,0,0,0,0
20200520,707731,環球晶亞東97購01,,,,,,0.00,0,0,0,0,0,0,0,0,0,0,0,0,0
20200520,707732,凡甲永豐97購01,0.78,0.80,0.72,0.74,-0.04,-5.13,310000,7,230240,0,0,0,0,0,0,290000,20000,270000,270000
20200520,707733,大宇資永豐96購02,,,,,,0.00,0,0,0,0,0,0,0,0,0,0,0,0,0
20200520,707734,元太國票97購01,2.53,3.53,2.53,3.53,+0.88,33.21,287000,30,831420,0,0,0,0,0,0,0,277000,-277000,-277000
20200520,707735,台燿國票97購01,,,,,,0.00,0,0,0,0,0,0,0,0,0,0,0,0,0
20200520,707736,信驊國票97購01,,,,,,0.00,0,0,0,0,0,0,0,0,0,0,0,0,0
20200520,707737,新普國票97購01,,,,,,0.00,0,0,0,0,0,0,0,0,0,0,0,0,0
20200520,707738,聖暉國泰96購01,1.60,1.60,1.60,1.60,-0.08,-4.76,10000,1,16000,0,0,0,0,0,0,10000,0,10000,10000
20200520,707739,網家國泰97購01,0.49,0.51,0.45,0.50,+0.01,2.04,59000,10,28970,0,0,0,0,0,0,42000,12000,30000,30000
20200520,707740,金可兆豐96購01,,,,,,0.00,0,0,0,0,0,0,0,0,0,0,0,0,0
20200520,707741,胡連康和96購01,0.90,1.00,0.90,1.00,+0.27,36.99,90000,2,87000,0,0,0,0,0,0,60000,30000,30000,30000
20200520,707742,佳邦群益96購01,,,,,,0.00,0,0,0,0,0,0,0,0,0,0,0,0,0
20200520,707743,旺矽群益97購01,0.88,0.88,0.88,0.88,+0.04,4.76,10000,1,8800,0,0,0,0,0,0,0,10000,-10000,-10000
20200520,707744,新普群益98購01,1.33,1.36,1.25,1.27,-0.05,-3.79,161000,7,214510,0,0,0,0,0,0,55000,106000,-51000,-51000
20200520,707745,網龍群益98購01,1.29,1.29,1.17,1.17,0.00,0.0,31000,4,38470,0,0,0,0,0,0,1000,31000,-30000,-30000
20200520,707746,由田元大96購01,,,,,,0.00,0,0,0,0,0,0,0,0,0,0,0,0,0
20200520,707747,信昌電元大97購01,,,,,,0.00,0,0,0,0,0,0,0,0,0,0,0,0,0
20200520,707748,神盾元大99購01,,,,,,0.00,0,0,0,0,0,0,0,0,0,0,0,0,0
20200520,707749,精華元大97購01,,,,,,0.00,0,0,0,0,0,0,0,0,0,0,0,0,0
20200520,707750,穩懋元大97購01,0.20,0.20,0.20,0.20,-0.03,-13.04,10000,2,2000,0,0,0,0,0,0,0,8000,-8000,-8000
20200520,707751,鈺太元大97購01,,,,,,0.00,0,0,0,0,0,0,0,0,0,0,0,0,0
20200520,707752,世界中信98購01,,,,,,0.00,0,0,0,0,0,0,0,0,0,0,0,0,0
20200520,707753,環球晶中信99購02,0.47,0.50,0.44,0.46,-0.04,-8.0,1371000,45,636110,0,0,0,0,0,0,600000,745000,-145000,-145000
20200520,707754,環球晶統一96購01,,,,,,0.00,0,0,0,0,0,0,0,0,0,0,0,0,0
20200520,707755,穩懋統一96購07,,,,,,0.00,0,0,0,0,0,0,0,0,0,0,0,0,0
20200520,707756,世界凱基96購01,,,,,,0.00,0,0,0,0,0,0,0,0,0,0,0,0,0
20200520,707757,網龍凱基97購01,0.50,0.52,0.50,0.52,+0.02,4.0,60000,2,31000,0,0,0,0,0,0,60000,0,60000,60000
20200520,707758,穩懋凱基96購07,,,,,,0.00,0,0,0,0,0,0,0,0,0,0,0,0,0
20200520,707759,大江元大97購01,0.43,0.44,0.39,0.39,-0.10,-20.41,224000,9,96880,0,0,0,0,0,0,136000,88000,48000,48000
20200520,707760,世界元大96購02,,,,,,0.00,0,0,0,0,0,0,0,0,0,0,0,0,0
20200520,707761,迅得元大98購01,,,,,,0.00,0,0,0,0,0,0,0,0,0,0,0,0,0
20200520,707762,宣德元大96購03,,,,,,0.00,0,0,0,0,0,0,0,0,0,0,0,0,0
20200520,707763,群聯元大96購04,,,,,,0.00,0,0,0,0,0,0,0,0,0,0,0,0,0
20200520,707764,鈊象元大96購03,,,,,,0.00,0,0,0,0,0,0,0,0,0,0,0,0,0
20200520,707765,原相永昌99購01,2.33,2.33,2.19,2.19,-0.18,-7.59,122000,16,276460,0,0,0,0,0,0,0,87000,-87000,-87000
20200520,707766,大田永豐96購01,,,,,,0.00,0,0,0,0,0,0,0,0,0,0,0,0,0
20200520,707767,中美晶永豐96購02,,,,,,0.00,0,0,0,0,0,0,0,0,0,0,0,0,0
20200520,707768,世界永豐96購02,,,,,,0.00,0,0,0,0,0,0,0,0,0,0,0,0,0
20200520,707769,光頡永豐96購01,,,,,,0.00,0,0,0,0,0,0,0,0,0,0,0,0,0
20200520,707770,合晶永豐97購01,0.93,0.93,0.89,0.93,+0.08,9.41,166000,6,152700,0,0,0,0,0,0,40000,130000,-90000,-90000
20200520,707771,精測永豐96購06,,,,,,0.00,0,0,0,0,0,0,0,0,0,0,0,0,0
20200520,707772,精測永豐96購07,,,,,,0.00,0,0,0,0,0,0,0,0,0,0,0,0,0
20200520,707773,穩懋永豐96購01,,,,,,0.00,0,0,0,0,0,0,0,0,0,0,0,0,0
20200520,707774,大宇資國票97購01,,,,,,0.00,0,0,0,0,0,0,0,0,0,0,0,0,0
20200520,707775,良維國票97購02,0.52,0.52,0.52,0.52,-0.02,-3.7,84000,1,43680,0,0,0,0,0,0,84000,84000,0,0
20200520,707776,宜鼎國票97購01,4.14,4.32,4.11,4.32,+0.18,4.35,120000,12,498300,0,0,0,0,0,0,10000,110000,-100000,-100000
20200520,707777,金居國票97購01,,,,,,0.00,0,0,0,0,0,0,0,0,0,0,0,0,0
20200520,707778,信昌電國票97購01,0.72,0.76,0.72,0.76,+0.10,15.15,159000,2,114880,0,0,0,0,0,0,149000,10000,139000,139000
20200520,707779,保瑞國票97購01,,,,,,0.00,0,0,0,0,0,0,0,0,0,0,0,0,0
20200520,707780,昇達科富邦98購01,0.21,0.21,0.21,0.21,0.00,0.0,12000,2,2520,0,0,0,0,0,0,0,12000,-12000,-12000
20200520,707781,宣德麥證96購01,,,,,,0.00,0,0,0,0,0,0,0,0,0,0,0,0,0
20200520,707782,世界台新97購01,0.19,0.19,0.19,0.19,+0.01,5.56,100000,1,19000,0,0,0,0,0,0,100000,0,100000,100000
20200520,707783,泰博兆豐96購02,,,,,,0.00,0,0,0,0,0,0,0,0,0,0,0,0,0
20200520,707784,聚積康和96購01,,,,,,0.00,0,0,0,0,0,0,0,0,0,0,0,0,0
20200520,707785,凡甲群益98購01,1.72,1.72,1.63,1.63,-0.27,-14.21,40000,3,67000,0,0,0,0,0,0,20000,20000,0,0
20200520,707786,中美晶群益96購01,,,,,,0.00,0,0,0,0,0,0,0,0,0,0,0,0,0
20200520,707787,合晶群益96購01,,,,,,0.00,0,0,0,0,0,0,0,0,0,0,0,0,0
20200520,707788,晶焱群益98購01,0.50,0.50,0.50,0.50,+0.03,6.38,20000,1,10000,0,0,0,0,0,0,20000,20000,0,0
20200520,707789,精測群益96購04,,,,,,0.00,0,0,0,0,0,0,0,0,0,0,0,0,0
20200520,707790,廣明群益96購01,,,,,,0.00,0,0,0,0,0,0,0,0,0,0,0,0,0
20200520,707791,聯亞群益96購02,,,,,,0.00,0,0,0,0,0,0,0,0,0,0,0,0,0
20200520,707792,鐿鈦群益97購01,,,,,,0.00,0,0,0,0,0,0,0,0,0,0,0,0,0
20200520,707793,中美晶元大96購02,,,,,,0.00,0,0,0,0,0,0,0,0,0,0,0,0,0
20200520,707794,世界元大96購03,,,,,,0.00,0,0,0,0,0,0,0,0,0,0,0,0,0
20200520,707795,精測元大96購02,,,,,,0.00,0,0,0,0,0,0,0,0,0,0,0,0,0
20200520,707796,聯亞元大96購02,,,,,,0.00,0,0,0,0,0,0,0,0,0,0,0,0,0
20200520,707797,鈊象元大96購04,,,,,,0.00,0,0,0,0,0,0,0,0,0,0,0,0,0
20200520,707798,世界統一97購01,,,,,,0.00,0,0,0,0,0,0,0,0,0,0,0,0,0
20200520,707799,神盾統一98購01,0.47,0.47,0.38,0.39,-0.03,-7.14,577000,22,247830,0,0,0,0,0,0,557000,20000,537000,537000
20200520,707800,穩懋統一98購02,,,,,,0.00,0,0,0,0,0,0,0,0,0,0,0,0,0
20200520,707801,鈊象統一97購02,,,,,,0.00,0,0,0,0,0,0,0,0,0,0,0,0,0
20200520,707802,宣德中信9A購01,0.29,0.30,0.29,0.29,+0.01,3.57,170000,6,49800,0,0,0,0,0,0,80000,90000,-10000,-10000
20200520,707803,中光電凱基96購01,,,,,,0.00,0,0,0,0,0,0,0,0,0,0,0,0,0
20200520,707804,世界凱基96購02,,,,,,0.00,0,0,0,0,0,0,0,0,0,0,0,0,0
20200520,707805,旺矽凱基96購01,,,,,,0.00,0,0,0,0,0,0,0,0,0,0,0,0,0
20200520,707806,信昌電凱基97購02,0.22,0.22,0.22,0.22,+0.02,10.0,3000,1,660,0,0,0,0,0,0,0,3000,-3000,-3000
20200520,707807,佳邦國票97購01,0.05,0.05,0.05,0.05,0.00,0.0,579000,4,28950,0,0,0,0,0,0,0,519000,-519000,-519000
20200520,707808,優群國票98購01,,,,,,0.00,0,0,0,0,0,0,0,0,0,0,0,0,0
20200520,707809,中美晶國泰97購01,,,,,,0.00,0,0,0,0,0,0,0,0,0,0,0,0,0
20200520,707810,穩懋麥證96購01,,,,,,0.00,0,0,0,0,0,0,0,0,0,0,0,0,0
20200520,707811,世界元富96購01,,,,,,0.00,0,0,0,0,0,0,0,0,0,0,0,0,0
20200520,707812,茂達元富96購01,,,,,,0.00,0,0,0,0,0,0,0,0,0,0,0,0,0
20200520,707813,群聯元富96購02,,,,,,0.00,0,0,0,0,0,0,0,0,0,0,0,0,0
20200520,707814,穩懋富邦98購01,0.10,0.23,0.09,0.23,+0.06,35.29,64000,6,6960,0,0,0,0,0,0,9000,0,9000,9000
20200520,707815,中美晶台新97購01,0.21,0.21,0.21,0.21,+0.01,5.0,10000,1,2100,0,0,0,0,0,0,0,10000,-10000,-10000
20200520,707816,良維台新97購01,0.85,0.85,0.79,0.83,+0.01,1.22,221000,6,181940,0,0,0,0,0,0,118000,184000,-66000,-66000
20200520,707817,閎康台新96購01,,,,,,0.00,0,0,0,0,0,0,0,0,0,0,0,0,0
20200520,707818,群聯台新97購02,,,,,,0.00,0,0,0,0,0,0,0,0,0,0,0,0,0
20200520,707819,碩禾台新97購01,,,,,,0.00,0,0,0,0,0,0,0,0,0,0,0,0,0
20200520,707820,世界康和96購01,,,,,,0.00,0,0,0,0,0,0,0,0,0,0,0,0,0
20200520,707821,凡甲群益96購01,,,,,,0.00,0,0,0,0,0,0,0,0,0,0,0,0,0
20200520,707822,中美晶群益96購02,,,,,,0.00,0,0,0,0,0,0,0,0,0,0,0,0,0
20200520,707823,宜鼎群益97購01,1.11,1.20,1.11,1.17,+0.12,11.43,23000,3,26400,0,0,0,0,0,0,0,23000,-23000,-23000
20200520,707824,環球晶群益96購01,,,,,,0.00,0,0,0,0,0,0,0,0,0,0,0,0,0
20200520,707825,鈊象群益99購03,,,,,,0.00,0,0,0,0,0,0,0,0,0,0,0,0,0
20200520,707826,大江永豐96購02,,,,,,0.00,0,0,0,0,0,0,0,0,0,0,0,0,0
20200520,707827,世界永豐96購03,,,,,,0.00,0,0,0,0,0,0,0,0,0,0,0,0,0
20200520,707828,合晶永豐96購01,,,,,,0.00,0,0,0,0,0,0,0,0,0,0,0,0,0
20200520,707829,博智永豐96購01,,,,,,0.00,0,0,0,0,0,0,0,0,0,0,0,0,0
20200520,707830,網龍永豐96購01,,,,,,0.00,0,0,0,0,0,0,0,0,0,0,0,0,0
20200520,707831,雙美永豐97購01,,,,,,0.00,0,0,0,0,0,0,0,0,0,0,0,0,0
20200520,707832,精測兆豐97購02,,,,,,0.00,0,0,0,0,0,0,0,0,0,0,0,0,0
20200520,707833,網龍兆豐97購01,1.29,1.29,1.29,1.29,-0.06,-4.44,2000,1,2580,0,0,0,0,0,0,2000,0,2000,2000
20200520,707834,晟德兆豐97購01,0.47,0.54,0.47,0.54,+0.14,35.0,260000,9,125630,0,0,0,0,0,0,0,260000,-260000,-260000
20200520,707835,原相康和96購01,,,,,,0.00,0,0,0,0,0,0,0,0,0,0,0,0,0
20200520,707836,力旺永豐96購01,,,,,,0.00,0,0,0,0,0,0,0,0,0,0,0,0,0
20200520,707837,良維永豐96購02,,,,,,0.00,0,0,0,0,0,0,0,0,0,0,0,0,0
20200520,707838,佳邦永豐96購01,,,,,,0.00,0,0,0,0,0,0,0,0,0,0,0,0,0
20200520,707839,建榮永豐97購01,,,,,,0.00,0,0,0,0,0,0,0,0,0,0,0,0,0
20200520,707840,晶焱永豐97購01,,,,,,0.00,0,0,0,0,0,0,0,0,0,0,0,0,0
20200520,707841,智崴永豐96購01,,,,,,0.00,0,0,0,0,0,0,0,0,0,0,0,0,0
20200520,707842,精測永豐96購08,,,,,,0.00,0,0,0,0,0,0,0,0,0,0,0,0,0
20200520,707843,鈊象永豐96購04,,,,,,0.00,0,0,0,0,0,0,0,0,0,0,0,0,0
20200520,707844,中美晶元大97購01,,,,,,0.00,0,0,0,0,0,0,0,0,0,0,0,0,0
20200520,707845,台半元大96購01,,,,,,0.00,0,0,0,0,0,0,0,0,0,0,0,0,0
20200520,707846,杰力元大96購03,,,,,,0.00,0,0,0,0,0,0,0,0,0,0,0,0,0
20200520,707847,宣德元大96購04,0.35,0.35,0.35,0.35,-0.03,-7.89,2000,1,700,0,0,0,0,0,0,0,2000,-2000,-2000
20200520,707848,精測元大96購03,,,,,,0.00,0,0,0,0,0,0,0,0,0,0,0,0,0
20200520,707849,雙鴻元大99購01,0.25,0.25,0.22,0.22,-0.01,-4.35,34000,5,8040,0,0,0,0,0,0,4000,30000,-26000,-26000
20200520,707850,鈊象元大97購03,,,,,,0.00,0,0,0,0,0,0,0,0,0,0,0,0,0
20200520,707851,群聯麥證96購01,,,,,,0.00,0,0,0,0,0,0,0,0,0,0,0,0,0
20200520,707852,環球晶麥證96購01,,,,,,0.00,0,0,0,0,0,0,0,0,0,0,0,0,0
20200520,707853,雙鴻麥證97購01,,,,,,0.00,0,0,0,0,0,0,0,0,0,0,0,0,0
20200520,707854,合晶台新96購01,,,,,,0.00,0,0,0,0,0,0,0,0,0,0,0,0,0
20200520,707855,良維台新97購02,,,,,,0.00,0,0,0,0,0,0,0,0,0,0,0,0,0
20200520,707856,神盾台新97購01,,,,,,0.00,0,0,0,0,0,0,0,0,0,0,0,0,0
20200520,707857,新普台新97購01,,,,,,0.00,0,0,0,0,0,0,0,0,0,0,0,0,0
20200520,707858,穩懋台新97購01,,,,,,0.00,0,0,0,0,0,0,0,0,0,0,0,0,0
20200520,707859,中美晶國票97購01,,,,,,0.00,0,0,0,0,0,0,0,0,0,0,0,0,0
20200520,707860,同致國票97購02,,,,,,0.00,0,0,0,0,0,0,0,0,0,0,0,0,0
20200520,707861,東隆興國票96購01,,,,,,0.00,0,0,0,0,0,0,0,0,0,0,0,0,0
20200520,707862,茂達國票97購01,0.65,0.85,0.65,0.83,+0.34,69.39,154000,3,119100,0,0,0,0,0,0,0,154000,-154000,-154000
20200520,707863,穩懋國票97購01,,,,,,0.00,0,0,0,0,0,0,0,0,0,0,0,0,0
20200520,707864,M31凱基98購01,0.20,0.20,0.20,0.20,-0.06,-23.08,20000,1,4000,0,0,0,0,0,0,20000,0,20000,20000
20200520,707865,中美晶凱基96購03,,,,,,0.00,0,0,0,0,0,0,0,0,0,0,0,0,0
20200520,707866,合晶凱基96購01,,,,,,0.00,0,0,0,0,0,0,0,0,0,0,0,0,0
20200520,707867,宣德凱基96購02,,,,,,0.00,0,0,0,0,0,0,0,0,0,0,0,0,0
20200520,707868,碩禾凱基97購01,,,,,,0.00,0,0,0,0,0,0,0,0,0,0,0,0,0
20200520,707869,精測凱基96購07,,,,,,0.00,0,0,0,0,0,0,0,0,0,0,0,0,0
20200520,707870,聯亞凱基97購01,0.24,0.24,0.24,0.24,-0.11,-31.43,10000,1,2400,0,0,0,0,0,0,10000,0,10000,10000
20200520,707871,精測國泰97購02,,,,,,0.00,0,0,0,0,0,0,0,0,0,0,0,0,0
20200520,707872,精測國泰98購03,,,,,,0.00,0,0,0,0,0,0,0,0,0,0,0,0,0
20200520,707873,鈺太國泰98購01,,,,,,0.00,0,0,0,0,0,0,0,0,0,0,0,0,0
20200520,707874,世界富邦98購01,,,,,,0.00,0,0,0,0,0,0,0,0,0,0,0,0,0
20200520,707875,世界群益98購01,0.35,0.36,0.35,0.36,-0.02,-5.26,278000,5,97700,0,0,0,0,0,0,218000,40000,178000,178000
20200520,707876,世界群益98購02,0.25,0.25,0.23,0.23,-0.02,-8.0,60000,2,14800,0,0,0,0,0,0,0,60000,-60000,-60000
20200520,707877,迅得群益97購02,,,,,,0.00,0,0,0,0,0,0,0,0,0,0,0,0,0
20200520,707878,信昌電群益96購01,,,,,,0.00,0,0,0,0,0,0,0,0,0,0,0,0,0
20200520,707879,宣德群益96購02,,,,,,0.00,0,0,0,0,0,0,0,0,0,0,0,0,0
20200520,707880,建榮群益97購01,,,,,,0.00,0,0,0,0,0,0,0,0,0,0,0,0,0
20200520,707881,璟德群益97購01,0.64,0.66,0.61,0.65,+0.02,3.17,180000,8,116280,0,0,0,0,0,0,108000,72000,36000,36000
20200520,707882,環球晶群益97購01,0.59,0.60,0.53,0.55,-0.11,-16.67,183000,6,97950,0,0,0,0,0,0,150000,33000,117000,117000
20200520,707883,力旺元大97購01,1.69,1.81,1.46,1.46,+0.10,7.35,388000,12,616010,0,0,0,0,0,0,37000,303000,-266000,-266000
20200520,707884,中美晶元大97購02,,,,,,0.00,0,0,0,0,0,0,0,0,0,0,0,0,0
20200520,707885,台燿元大96購01,0.29,0.29,0.25,0.25,-0.06,-19.35,167000,8,46310,0,0,0,0,0,0,68000,99000,-31000,-31000
20200520,707886,旺矽元大99購01,,,,,,0.00,0,0,0,0,0,0,0,0,0,0,0,0,0
20200520,707887,晶焱元大97購02,0.12,0.12,0.12,0.12,-0.08,-40.0,45000,1,5400,0,0,0,0,0,0,45000,0,45000,45000
20200520,707888,精測元大97購02,,,,,,0.00,0,0,0,0,0,0,0,0,0,0,0,0,0
20200520,707889,璟德元大96購02,,,,,,0.00,0,0,0,0,0,0,0,0,0,0,0,0,0
20200520,707890,穩懋元大96購04,0.07,0.07,0.07,0.07,-0.12,-63.16,30000,1,2100,0,0,0,0,0,0,30000,0,30000,30000
20200520,707891,力旺凱基96購01,,,,,,0.00,0,0,0,0,0,0,0,0,0,0,0,0,0
20200520,707892,大江凱基96購02,,,,,,0.00,0,0,0,0,0,0,0,0,0,0,0,0,0
20200520,707893,保瑞凱基96購01,,,,,,0.00,0,0,0,0,0,0,0,0,0,0,0,0,0
20200520,707894,璟德凱基96購02,,,,,,0.00,0,0,0,0,0,0,0,0,0,0,0,0,0
20200520,707895,穩懋凱基96購09,,,,,,0.00,0,0,0,0,0,0,0,0,0,0,0,0,0
20200520,707896,中美晶統一96購01,,,,,,0.00,0,0,0,0,0,0,0,0,0,0,0,0,0
20200520,707898,台燿兆豐97購01,,,,,,0.00,0,0,0,0,0,0,0,0,0,0,0,0,0
20200520,707899,威剛群益96購01,,,,,,0.00,0,0,0,0,0,0,0,0,0,0,0,0,0
20200520,707900,宣德群益96購03,,,,,,0.00,0,0,0,0,0,0,0,0,0,0,0,0,0
20200520,707901,精測群益96購05,,,,,,0.00,0,0,0,0,0,0,0,0,0,0,0,0,0
20200520,707902,鈊象群益98購01,5.95,6.10,5.70,5.70,-0.30,-5.0,47000,8,274100,0,0,0,0,0,0,32000,24000,8000,8000
20200520,707903,M31永豐96購01,,,,,,0.00,0,0,0,0,0,0,0,0,0,0,0,0,0
20200520,707904,金居永豐96購01,,,,,,0.00,0,0,0,0,0,0,0,0,0,0,0,0,0
20200520,707905,宣德永豐96購01,,,,,,0.00,0,0,0,0,0,0,0,0,0,0,0,0,0
20200520,707906,精測永豐96購09,,,,,,0.00,0,0,0,0,0,0,0,0,0,0,0,0,0
20200520,707907,璟德永豐96購02,,,,,,0.00,0,0,0,0,0,0,0,0,0,0,0,0,0
20200520,707908,優群永豐96購02,,,,,,0.00,0,0,0,0,0,0,0,0,0,0,0,0,0
20200520,707909,凡甲台新96購01,,,,,,0.00,0,0,0,0,0,0,0,0,0,0,0,0,0
20200520,707910,力旺國票97購01,1.22,1.34,1.00,1.03,+0.03,3.0,901000,19,1043140,0,0,0,0,0,0,494000,407000,87000,87000
20200520,707911,杰力國票97購02,1.15,1.15,1.15,1.15,+0.03,2.68,5000,2,5750,0,0,0,0,0,0,5000,0,5000,5000
20200520,707912,聚積國票97購01,,,,,,0.00,0,0,0,0,0,0,0,0,0,0,0,0,0
20200520,707913,鈊象國票97購01,12.40,12.40,12.40,12.40,-0.70,-5.34,20000,2,248000,0,0,0,0,0,0,20000,0,20000,20000
20200520,707914,環球晶國泰97購01,,,,,,0.00,0,0,0,0,0,0,0,0,0,0,0,0,0
20200520,707915,中美晶富邦97購02,,,,,,0.00,0,0,0,0,0,0,0,0,0,0,0,0,0
20200520,707916,聯亞富邦98購01,0.44,0.44,0.44,0.44,-0.02,-4.35,45000,1,19800,0,0,0,0,0,0,45000,0,45000,45000
20200520,707917,中美晶麥證96購01,,,,,,0.00,0,0,0,0,0,0,0,0,0,0,0,0,0
20200520,707918,合晶麥證96購01,,,,,,0.00,0,0,0,0,0,0,0,0,0,0,0,0,0
20200520,707919,櫃200第一96購03,0.11,0.11,0.11,0.11,-0.04,-26.67,10000,1,1100,0,0,0,0,0,0,10000,0,10000,10000
20200520,707920,櫃200第一96購04,,,,,,0.00,0,0,0,0,0,0,0,0,0,0,0,0,0
20200520,707921,譜瑞兆豐96購01,,,,,,0.00,0,0,0,0,0,0,0,0,0,0,0,0,0
20200520,707922,雍智康和96購01,0.69,0.72,0.69,0.72,+0.13,22.03,50000,9,35790,0,0,0,0,0,0,50000,0,50000,50000
20200520,707923,力旺群益97購01,,,,,,0.00,0,0,0,0,0,0,0,0,0,0,0,0,0
20200520,707924,中美晶群益97購01,0.08,0.08,0.08,0.08,-0.01,-11.11,251000,7,20080,0,0,0,0,0,0,251000,201000,50000,50000
20200520,707925,信驊群益96購01,,,,,,0.00,0,0,0,0,0,0,0,0,0,0,0,0,0
20200520,707926,雍智群益96購01,0.78,0.78,0.78,0.78,+0.17,27.87,5000,1,3900,0,0,0,0,0,0,5000,0,5000,5000
20200520,707927,碩禾群益97購01,,,,,,0.00,0,0,0,0,0,0,0,0,0,0,0,0,0
20200520,707928,環球晶群益97購02,2.71,2.73,2.71,2.71,-0.06,-2.17,8000,3,21780,0,0,0,0,0,0,8000,8000,0,0
20200520,707929,凡甲元大98購01,,,,,,0.00,0,0,0,0,0,0,0,0,0,0,0,0,0
20200520,707930,雍智元大97購01,2.29,2.72,2.16,2.47,+0.42,20.49,235000,17,566440,0,0,0,0,0,0,20000,215000,-195000,-195000
20200520,707931,力旺統一96購01,0.63,0.70,0.51,0.51,+0.05,10.87,518000,36,312110,0,0,0,0,0,0,195000,323000,-128000,-128000
20200520,707932,雍智統一97購01,1.30,1.30,1.30,1.30,+0.11,9.24,10000,1,13000,0,0,0,0,0,0,0,0,0,0
20200520,707933,新普中信96購01,,,,,,0.00,0,0,0,0,0,0,0,0,0,0,0,0,0
20200520,707934,雍智中信96購01,0.48,0.59,0.48,0.59,+0.23,63.89,96000,5,48370,0,0,0,0,0,0,51000,0,51000,51000
20200520,707935,大江國票97購03,,,,,,0.00,0,0,0,0,0,0,0,0,0,0,0,0,0
20200520,707936,世界國票97購02,,,,,,0.00,0,0,0,0,0,0,0,0,0,0,0,0,0
20200520,707937,雍智國票96購01,1.65,1.65,1.65,1.65,+0.65,65.0,3000,1,4950,0,0,0,0,0,0,0,3000,-3000,-3000
20200520,707938,雙鴻國票97購01,,,,,,0.00,0,0,0,0,0,0,0,0,0,0,0,0,0
20200520,707939,鈺太國票97購01,,,,,,0.00,0,0,0,0,0,0,0,0,0,0,0,0,0
20200520,707940,弘塑凱基97購01,0.30,0.30,0.30,0.30,-0.01,-3.23,39000,2,11700,0,0,0,0,0,0,39000,0,39000,39000
20200520,707941,同致凱基97購01,0.25,0.34,0.25,0.30,+0.01,3.45,426000,12,131520,0,0,0,0,0,0,376000,318000,58000,58000
20200520,707942,神盾凱基98購01,,,,,,0.00,0,0,0,0,0,0,0,0,0,0,0,0,0
20200520,707943,雍智凱基96購01,0.91,1.10,0.89,1.10,+0.30,37.5,376000,53,374290,0,0,0,0,0,0,86000,250000,-164000,-164000
20200520,707944,廣明凱基96購01,,,,,,0.00,0,0,0,0,0,0,0,0,0,0,0,0,0
20200520,707945,環球晶凱基96購05,,,,,,0.00,0,0,0,0,0,0,0,0,0,0,0,0,0
20200520,707946,鈊象凱基96購03,,,,,,0.00,0,0,0,0,0,0,0,0,0,0,0,0,0
20200520,707947,力旺麥證96購01,,,,,,0.00,0,0,0,0,0,0,0,0,0,0,0,0,0
20200520,707948,威剛國泰97購01,,,,,,0.00,0,0,0,0,0,0,0,0,0,0,0,0,0
20200520,707949,群聯國泰98購01,,,,,,0.00,0,0,0,0,0,0,0,0,0,0,0,0,0
20200520,707950,雍智國泰98購01,2.28,2.57,2.28,2.57,+0.61,31.12,31000,6,70970,0,0,0,0,0,0,30000,1000,29000,29000
20200520,707951,精測元富99購01,0.06,0.06,0.05,0.06,-0.01,-14.29,204000,9,12230,0,0,0,0,0,0,169000,35000,134000,134000
20200520,707952,聯亞元富96購02,,,,,,0.00,0,0,0,0,0,0,0,0,0,0,0,0,0
20200520,707953,力旺台新97購01,1.26,1.26,0.46,0.46,-0.80,-63.49,5000,4,4100,0,0,0,0,0,0,0,3000,-3000,-3000
20200520,707954,世界台新97購02,0.30,0.31,0.29,0.29,-0.02,-6.45,400000,4,120000,0,0,0,0,0,0,0,400000,-400000,-400000
20200520,707955,櫃200永昌97購01,2.13,2.13,2.11,2.11,+0.05,2.43,9000,2,19070,0,0,0,0,0,0,9000,0,9000,9000
20200520,707956,櫃200永昌99購01,,,,,,0.00,0,0,0,0,0,0,0,0,0,0,0,0,0
20200520,707957,櫃200永昌99購02,,,,,,0.00,0,0,0,0,0,0,0,0,0,0,0,0,0
20200520,707958,櫃200永昌99購03,,,,,,0.00,0,0,0,0,0,0,0,0,0,0,0,0,0
20200520,707959,久元永豐96購01,0.52,0.65,0.49,0.65,+0.19,41.3,196000,7,111690,0,0,0,0,0,0,1000,195000,-194000,-194000
20200520,707960,立端永豐96購01,0.16,0.16,0.16,0.16,0.00,0.0,10000,1,1600,0,0,0,0,0,0,10000,0,10000,10000
20200520,707961,良維永豐96購03,0.64,0.64,0.64,0.64,+0.01,1.59,18000,2,11520,0,0,0,0,0,0,1000,17000,-16000,-16000
20200520,707962,宜鼎永豐96購01,,,,,,0.00,0,0,0,0,0,0,0,0,0,0,0,0,0
20200520,707963,皇田永豐96購01,,,,,,0.00,0,0,0,0,0,0,0,0,0,0,0,0,0
20200520,707964,美琪瑪永豐96購01,,,,,,0.00,0,0,0,0,0,0,0,0,0,0,0,0,0
20200520,707965,雍智永豐96購01,0.42,0.56,0.42,0.55,+0.19,52.78,292000,19,144770,0,0,0,0,0,0,125000,157000,-32000,-32000
20200520,707966,穩懋統一96購08,,,,,,0.00,0,0,0,0,0,0,0,0,0,0,0,0,0
20200520,707967,穩懋統一96購09,,,,,,0.00,0,0,0,0,0,0,0,0,0,0,0,0,0
20200520,707968,穩懋統一96購10,,,,,,0.00,0,0,0,0,0,0,0,0,0,0,0,0,0
20200520,707969,穩懋統一97購03,,,,,,0.00,0,0,0,0,0,0,0,0,0,0,0,0,0
20200520,707970,鈊象統一97購03,,,,,,0.00,0,0,0,0,0,0,0,0,0,0,0,0,0
20200520,707971,中美晶中信96購01,,,,,,0.00,0,0,0,0,0,0,0,0,0,0,0,0,0
20200520,707972,同致中信98購01,,,,,,0.00,0,0,0,0,0,0,0,0,0,0,0,0,0
20200520,707973,環球晶中信9C購01,,,,,,0.00,0,0,0,0,0,0,0,0,0,0,0,0,0
20200520,707974,世界凱基96購03,,,,,,0.00,0,0,0,0,0,0,0,0,0,0,0,0,0
20200520,707975,金居凱基96購02,,,,,,0.00,0,0,0,0,0,0,0,0,0,0,0,0,0
20200520,707976,環球晶凱基96購06,,,,,,0.00,0,0,0,0,0,0,0,0,0,0,0,0,0
20200520,707977,穩懋凱基96購10,,,,,,0.00,0,0,0,0,0,0,0,0,0,0,0,0,0
20200520,707978,大江群益97購01,,,,,,0.00,0,0,0,0,0,0,0,0,0,0,0,0,0
20200520,707979,原相群益98購01,,,,,,0.00,0,0,0,0,0,0,0,0,0,0,0,0,0
20200520,707980,弘塑國票97購01,,,,,,0.00,0,0,0,0,0,0,0,0,0,0,0,0,0
20200520,707981,宜鼎國票97購02,3.61,3.82,3.61,3.82,+0.29,8.22,2000,2,7430,0,0,0,0,0,0,2000,0,2000,2000
20200520,707983,環球晶國票97購01,1.74,1.74,1.72,1.72,-0.17,-8.99,7000,2,12080,0,0,0,0,0,0,0,7000,-7000,-7000
20200520,707984,緯軟國泰97購01,,,,,,0.00,0,0,0,0,0,0,0,0,0,0,0,0,0
20200520,707985,櫃200永昌9B購01,,,,,,0.00,0,0,0,0,0,0,0,0,0,0,0,0,0
20200520,707986,櫃200永昌9C購01,,,,,,0.00,0,0,0,0,0,0,0,0,0,0,0,0,0
20200520,707987,櫃200永昌9C購02,,,,,,0.00,0,0,0,0,0,0,0,0,0,0,0,0,0
20200520,707988,櫃200永昌9C購03,,,,,,0.00,0,0,0,0,0,0,0,0,0,0,0,0,0
20200520,707989,大宇資第一96購01,,,,,,0.00,0,0,0,0,0,0,0,0,0,0,0,0,0
20200520,707990,凡甲永豐96購01,0.40,0.40,0.37,0.37,-0.02,-5.13,34000,3,13510,0,0,0,0,0,0,31000,3000,28000,28000
20200520,707991,弘塑永豐96購01,,,,,,0.00,0,0,0,0,0,0,0,0,0,0,0,0,0
20200520,707992,昇達科永豐96購01,,,,,,0.00,0,0,0,0,0,0,0,0,0,0,0,0,0
20200520,707993,波若威永豐97購01,,,,,,0.00,0,0,0,0,0,0,0,0,0,0,0,0,0
20200520,707994,威剛永豐96購02,,,,,,0.00,0,0,0,0,0,0,0,0,0,0,0,0,0
20200520,707995,原相永豐96購01,,,,,,0.00,0,0,0,0,0,0,0,0,0,0,0,0,0
20200520,707996,神盾永豐96購01,,,,,,0.00,0,0,0,0,0,0,0,0,0,0,0,0,0
20200520,707997,網龍永豐96購02,0.95,1.06,0.83,0.83,-0.17,-17.0,293000,17,260630,0,0,0,0,0,0,187000,108000,79000,79000
20200520,707998,廣明永豐96購02,,,,,,0.00,0,0,0,0,0,0,0,0,0,0,0,0,0
20200520,707999,聯亞永豐96購01,0.62,0.62,0.57,0.57,-0.07,-10.94,11000,2,6320,0,0,0,0,0,0,1000,10000,-9000,-9000
20200520,708000,雙鴻永豐97購01,,,,,,0.00,0,0,0,0,0,0,0,0,0,0,0,0,0
20200520,708001,世界元大96購05,0.16,0.16,0.16,0.16,-0.02,-11.11,13000,1,2080,0,0,0,0,0,0,13000,0,13000,13000
20200520,708002,合晶元大97購02,,,,,,0.00,0,0,0,0,0,0,0,0,0,0,0,0,0
20200520,708003,宜鼎元大96購01,,,,,,0.00,0,0,0,0,0,0,0,0,0,0,0,0,0
20200520,708004,雍智元大97購02,1.68,1.68,1.68,1.68,+0.36,27.27,10000,1,16800,0,0,0,0,0,0,10000,0,10000,10000
20200520,708005,精測元大97購03,0.07,0.07,0.07,0.07,-0.02,-22.22,54000,2,3780,0,0,0,0,0,0,54000,0,54000,54000
20200520,708006,精華元大96購03,,,,,,0.00,0,0,0,0,0,0,0,0,0,0,0,0,0
20200520,708007,雍智元富96購01,0.94,1.28,0.90,1.04,+0.32,44.44,832000,56,848550,0,0,0,0,0,0,304000,439000,-135000,-135000
20200520,708008,精測元富96購03,,,,,,0.00,0,0,0,0,0,0,0,0,0,0,0,0,0
20200520,708009,精測台新96購01,,,,,,0.00,0,0,0,0,0,0,0,0,0,0,0,0,0
20200520,708010,璟德台新96購01,,,,,,0.00,0,0,0,0,0,0,0,0,0,0,0,0,0
20200520,708011,良維兆豐97購01,1.17,1.19,1.11,1.11,-0.07,-5.93,240000,30,278400,0,0,0,0,0,0,136000,104000,32000,32000
20200520,708012,聚積兆豐97購01,0.50,0.52,0.50,0.52,-0.01,-1.89,625000,5,316360,0,0,0,0,0,0,203000,422000,-219000,-219000
20200520,708013,廣明兆豐96購01,0.22,0.22,0.21,0.22,-0.05,-18.52,10000,4,2190,0,0,0,0,0,0,10000,0,10000,10000
20200520,708014,聯亞兆豐97購01,1.94,1.94,1.93,1.93,-0.09,-4.46,61000,2,117780,0,0,0,0,0,0,56000,5000,51000,51000
20200520,708015,鈺太康和96購01,,,,,,0.00,0,0,0,0,0,0,0,0,0,0,0,0,0
20200520,708016,新普群益98購02,1.23,1.23,1.14,1.16,-0.13,-10.08,246000,9,292770,0,0,0,0,0,0,76000,170000,-94000,-94000
20200520,708017,精測群益96購06,,,,,,0.00,0,0,0,0,0,0,0,0,0,0,0,0,0
20200520,708018,雙鴻群益98購01,,,,,,0.00,0,0,0,0,0,0,0,0,0,0,0,0,0
20200520,708019,世界麥證96購01,,,,,,0.00,0,0,0,0,0,0,0,0,0,0,0,0,0
20200520,708020,世界元富96購02,,,,,,0.00,0,0,0,0,0,0,0,0,0,0,0,0,0
20200520,708021,勝麗元富96購01,,,,,,0.00,0,0,0,0,0,0,0,0,0,0,0,0,0
20200520,708022,璟德元富96購01,0.17,0.17,0.17,0.17,-0.06,-26.09,30000,1,5100,0,0,0,0,0,0,30000,0,30000,30000
20200520,708023,鈺太元富96購01,,,,,,0.00,0,0,0,0,0,0,0,0,0,0,0,0,0
20200520,708024,金居中信9C購01,0.30,0.30,0.28,0.29,-0.03,-9.38,533000,16,156480,0,0,0,0,0,0,31000,502000,-471000,-471000
20200520,708025,勝麗中信9A購01,0.22,0.26,0.22,0.24,+0.03,14.29,1906000,11,467860,0,0,0,0,0,0,850000,1056000,-206000,-206000
20200520,708026,群聯永豐96購01,,,,,,0.00,0,0,0,0,0,0,0,0,0,0,0,0,0
20200520,708027,精測永豐96購10,,,,,,0.00,0,0,0,0,0,0,0,0,0,0,0,0,0
20200520,708028,鈺太永豐96購01,,,,,,0.00,0,0,0,0,0,0,0,0,0,0,0,0,0
20200520,708029,旺矽國票97購01,0.41,0.50,0.41,0.48,+0.07,17.07,180000,16,83950,0,0,0,0,0,0,40000,140000,-100000,-100000
20200520,708030,精華國票97購01,,,,,,0.00,0,0,0,0,0,0,0,0,0,0,0,0,0
20200520,708031,中美晶凱基96購04,0.72,0.72,0.70,0.70,-0.09,-11.39,23000,3,16500,0,0,0,0,0,0,0,23000,-23000,-23000
20200520,708032,六角凱基97購01,0.39,0.39,0.39,0.39,+0.03,8.33,49000,1,19110,0,0,0,0,0,0,49000,0,49000,49000
20200520,708034,勝麗凱基96購01,0.35,0.37,0.35,0.37,-0.01,-2.63,55000,2,19450,0,0,0,0,0,0,45000,10000,35000,35000
20200520,708035,博智凱基96購01,4.27,4.27,4.27,4.27,-0.33,-7.17,1000,1,4270,0,0,0,0,0,0,0,1000,-1000,-1000
20200520,708036,優群凱基98購01,,,,,,0.00,0,0,0,0,0,0,0,0,0,0,0,0,0
20200520,708037,環球晶凱基96購07,,,,,,0.00,0,0,0,0,0,0,0,0,0,0,0,0,0
20200520,708038,穩懋凱基96購11,,,,,,0.00,0,0,0,0,0,0,0,0,0,0,0,0,0
20200520,708039,宣德國泰98購01,0.26,0.27,0.26,0.27,+0.02,8.0,45000,2,11900,0,0,0,0,0,0,0,45000,-45000,-45000
20200520,708040,雍智國泰98購02,3.49,4.03,3.40,3.91,+0.83,26.95,202000,45,737850,0,0,0,0,0,0,82000,106000,-24000,-24000
20200520,708041,精測國泰98購04,,,,,,0.00,0,0,0,0,0,0,0,0,0,0,0,0,0
20200520,708042,精測國泰99購01,,,,,,0.00,0,0,0,0,0,0,0,0,0,0,0,0,0
20200520,708043,精測國泰9A購01,,,,,,0.00,0,0,0,0,0,0,0,0,0,0,0,0,0
20200520,708044,雙鴻富邦97購02,,,,,,0.00,0,0,0,0,0,0,0,0,0,0,0,0,0
20200520,708045,大江元大97購02,,,,,,0.00,0,0,0,0,0,0,0,0,0,0,0,0,0
20200520,708046,中美晶元大96購03,,,,,,0.00,0,0,0,0,0,0,0,0,0,0,0,0,0
20200520,708047,世界元大96購06,,,,,,0.00,0,0,0,0,0,0,0,0,0,0,0,0,0
20200520,708048,合晶元大96購05,,,,,,0.00,0,0,0,0,0,0,0,0,0,0,0,0,0
20200520,708049,信驊元大96購01,,,,,,0.00,0,0,0,0,0,0,0,0,0,0,0,0,0
20200520,708050,雍智元大96購01,,,,,,0.00,0,0,0,0,0,0,0,0,0,0,0,0,0
20200520,708051,精測元大96購04,,,,,,0.00,0,0,0,0,0,0,0,0,0,0,0,0,0
20200520,708052,穩懋元大96購05,,,,,,0.00,0,0,0,0,0,0,0,0,0,0,0,0,0
20200520,708053,鈺太元大97購02,,,,,,0.00,0,0,0,0,0,0,0,0,0,0,0,0,0
20200520,708054,力旺元富96購01,,,,,,0.00,0,0,0,0,0,0,0,0,0,0,0,0,0
20200520,708055,金可中信9A購01,0.05,0.05,0.05,0.05,0.00,0.0,5000,1,250,0,0,0,0,0,0,0,5000,-5000,-5000
20200520,708056,聖暉統一99購01,0.52,0.52,0.52,0.52,-0.01,-1.89,50000,1,26000,0,0,0,0,0,0,0,50000,-50000,-50000
20200520,708057,大江凱基98購01,0.15,0.15,0.15,0.15,+0.05,50.0,1000,1,150,0,0,0,0,0,0,0,0,0,0
20200520,708058,良維凱基98購01,0.38,0.38,0.37,0.37,-0.03,-7.5,53000,2,20110,0,0,0,0,0,0,53000,0,53000,53000
20200520,708059,旺矽凱基98購01,1.26,1.43,1.22,1.38,+0.14,11.29,584000,22,787170,0,0,0,0,0,0,220000,364000,-144000,-144000
20200520,708060,信驊凱基96購02,3.40,3.41,3.40,3.41,+0.08,2.4,42000,10,142820,0,0,0,0,0,0,22000,20000,2000,2000
20200520,708061,雍智凱基98購01,0.79,0.95,0.75,0.92,+0.24,35.29,632000,50,508940,0,0,0,0,0,0,167000,393000,-226000,-226000
20200520,708062,精測凱基99購01,0.03,0.03,0.03,0.03,-0.07,-70.0,21000,1,630,0,0,0,0,0,0,0,0,0,0
20200520,708063,緯軟凱基98購01,,,,,,0.00,0,0,0,0,0,0,0,0,0,0,0,0,0
20200520,708064,環球晶凱基96購08,0.23,0.23,0.23,0.23,-0.07,-23.33,457000,6,105110,0,0,0,0,0,0,457000,457000,0,0
20200520,708065,力旺永豐96購02,0.43,0.51,0.43,0.51,+0.15,41.67,92000,13,43420,0,0,0,0,0,0,55000,37000,18000,18000
20200520,708066,同致永豐96購01,,,,,,0.00,0,0,0,0,0,0,0,0,0,0,0,0,0
20200520,708067,迅得永豐97購02,,,,,,0.00,0,0,0,0,0,0,0,0,0,0,0,0,0
20200520,708068,欣銓永豐96購01,,,,,,0.00,0,0,0,0,0,0,0,0,0,0,0,0,0
20200520,708069,弘塑康和9C購01,0.43,0.43,0.43,0.43,-0.02,-4.44,9000,2,3870,0,0,0,0,0,0,9000,0,9000,9000
20200520,708070,大田群益96購01,0.59,0.61,0.59,0.61,+0.07,12.96,118000,3,70580,0,0,0,0,0,0,118000,0,118000,118000
20200520,708071,合晶群益96購02,0.72,0.75,0.72,0.75,+0.02,2.74,81000,2,59820,0,0,0,0,0,0,50000,31000,19000,19000
20200520,708072,信昌電群益96購02,0.66,0.74,0.66,0.74,+0.09,13.85,123000,2,85820,0,0,0,0,0,0,65000,58000,7000,7000
20200520,708073,茂達群益98購01,0.49,0.62,0.49,0.61,+0.23,60.53,301000,18,171210,0,0,0,0,0,0,3000,298000,-295000,-295000
20200520,708074,大宇資國票97購02,,,,,,0.00,0,0,0,0,0,0,0,0,0,0,0,0,0
20200520,708075,雙鴻國票97購02,,,,,,0.00,0,0,0,0,0,0,0,0,0,0,0,0,0
20200520,708076,力旺國泰98購01,0.76,0.87,0.73,0.76,+0.03,4.11,40000,6,32540,0,0,0,0,0,0,30000,10000,20000,20000
20200520,708077,威剛富邦98購01,0.17,0.17,0.17,0.17,+0.03,21.43,1000,1,170,0,0,0,0,0,0,0,0,0,0
20200520,708078,勝麗富邦97購01,,,,,,0.00,0,0,0,0,0,0,0,0,0,0,0,0,0
20200520,708079,群聯富邦98購01,,,,,,0.00,0,0,0,0,0,0,0,0,0,0,0,0,0
20200520,708080,精測富邦97購01,0.01,0.01,0.01,0.01,-0.01,-50.0,59000,1,590,0,0,0,0,0,0,0,0,0,0
20200520,708081,信驊元大96購02,,,,,,0.00,0,0,0,0,0,0,0,0,0,0,0,0,0
20200520,708082,新普元大97購01,,,,,,0.00,0,0,0,0,0,0,0,0,0,0,0,0,0
20200520,708083,環球晶元大96購03,0.85,0.85,0.78,0.78,-0.16,-17.02,136000,8,112740,0,0,0,0,0,0,68000,68000,0,0
20200520,708084,環球晶元大97購01,2.10,2.10,1.95,1.95,-0.12,-5.8,64000,9,130290,0,0,0,0,0,0,59000,12000,47000,47000
20200520,708085,穩懋元大96購06,,,,,,0.00,0,0,0,0,0,0,0,0,0,0,0,0,0
20200520,708086,穩懋元大96購07,,,,,,0.00,0,0,0,0,0,0,0,0,0,0,0,0,0
20200520,708087,群聯元富96購03,,,,,,0.00,0,0,0,0,0,0,0,0,0,0,0,0,0
20200520,708088,群聯兆豐97購01,,,,,,0.00,0,0,0,0,0,0,0,0,0,0,0,0,0
20200520,708089,精測兆豐97購03,,,,,,0.00,0,0,0,0,0,0,0,0,0,0,0,0,0
20200520,708090,穩懋兆豐96購04,,,,,,0.00,0,0,0,0,0,0,0,0,0,0,0,0,0
20200520,708091,久元康和96購01,0.91,0.92,0.86,0.92,+0.08,9.52,174000,8,156140,0,0,0,0,0,0,42000,132000,-90000,-90000
20200520,708092,櫃200永昌98購01,,,,,,0.00,0,0,0,0,0,0,0,0,0,0,0,0,0
20200520,708093,櫃200永昌98購02,,,,,,0.00,0,0,0,0,0,0,0,0,0,0,0,0,0
20200520,708094,大學光群益98購01,4.94,4.94,4.94,4.94,+0.20,4.22,1000,1,4940,0,0,0,0,0,0,0,1000,-1000,-1000
20200520,708095,VHQ中信96購01,,,,,,0.00,0,0,0,0,0,0,0,0,0,0,0,0,0
20200520,708096,合晶中信9A購01,0.26,0.28,0.26,0.27,+0.01,3.85,140000,4,36550,0,0,0,0,0,0,30000,110000,-80000,-80000
20200520,708097,宣德中信9A購02,0.13,0.13,0.13,0.13,+0.01,8.33,200000,2,26000,0,0,0,0,0,0,0,200000,-200000,-200000
20200520,708098,群聯中信9A購01,0.08,0.08,0.08,0.08,+0.01,14.29,130000,4,10400,0,0,0,0,0,0,0,20000,-20000,-20000
20200520,708099,M31凱基97購02,,,,,,0.00,0,0,0,0,0,0,0,0,0,0,0,0,0
20200520,708100,大江凱基96購03,,,,,,0.00,0,0,0,0,0,0,0,0,0,0,0,0,0
20200520,708101,合晶凱基97購01,,,,,,0.00,0,0,0,0,0,0,0,0,0,0,0,0,0
20200520,708102,良維凱基97購01,,,,,,0.00,0,0,0,0,0,0,0,0,0,0,0,0,0
20200520,708103,宜鼎凱基96購02,2.36,2.49,2.36,2.49,+0.19,8.26,40000,2,97000,0,0,0,0,0,0,0,40000,-40000,-40000
20200520,708104,晶焱凱基98購01,0.07,0.07,0.07,0.07,0.00,0.0,10000,1,700,0,0,0,0,0,0,0,0,0,0
20200520,708105,旺矽統一97購01,,,,,,0.00,0,0,0,0,0,0,0,0,0,0,0,0,0
20200520,708106,宣德統一97購02,,,,,,0.00,0,0,0,0,0,0,0,0,0,0,0,0,0
20200520,708107,大江永豐96購03,,,,,,0.00,0,0,0,0,0,0,0,0,0,0,0,0,0
20200520,708109,昇達科永豐96購02,,,,,,0.00,0,0,0,0,0,0,0,0,0,0,0,0,0
20200520,708110,博智永豐96購02,1.06,1.06,1.06,1.06,-0.07,-6.19,10000,1,10600,0,0,0,0,0,0,0,10000,-10000,-10000
20200520,708111,新鉅科永豐96購01,,,,,,0.00,0,0,0,0,0,0,0,0,0,0,0,0,0
20200520,708112,晟德永豐96購01,0.44,0.49,0.44,0.49,+0.09,22.5,235000,7,110550,0,0,0,0,0,0,68000,167000,-99000,-99000
20200520,708113,世界元大96購07,,,,,,0.00,0,0,0,0,0,0,0,0,0,0,0,0,0
20200520,708114,良維元大97購02,0.56,0.56,0.56,0.56,-0.01,-1.75,10000,1,5600,0,0,0,0,0,0,10000,10000,0,0
20200520,708115,佳邦元大96購01,,,,,,0.00,0,0,0,0,0,0,0,0,0,0,0,0,0
20200520,708117,廣明元大97購01,,,,,,0.00,0,0,0,0,0,0,0,0,0,0,0,0,0
20200520,708118,環球晶元大96購04,,,,,,0.00,0,0,0,0,0,0,0,0,0,0,0,0,0
20200520,708119,環球晶元大97購02,,,,,,0.00,0,0,0,0,0,0,0,0,0,0,0,0,0
20200520,708120,穩懋元大96購10,,,,,,0.00,0,0,0,0,0,0,0,0,0,0,0,0,0
20200520,708121,M31國票97購01,0.40,0.59,0.28,0.37,+0.02,5.71,30000,7,11620,0,0,0,0,0,0,10000,12000,-2000,-2000
20200520,708122,六角國票98購02,0.78,0.78,0.78,0.78,+0.02,2.63,5000,1,3900,0,0,0,0,0,0,5000,0,5000,5000
20200520,708123,原相國票97購01,1.32,1.32,1.30,1.30,-0.09,-6.47,7000,3,9160,0,0,0,0,0,0,0,7000,-7000,-7000
20200520,708124,神盾國票97購02,,,,,,0.00,0,0,0,0,0,0,0,0,0,0,0,0,0
20200520,708125,碩禾國票97購01,0.17,0.17,0.17,0.17,0.00,0.0,10000,1,1700,0,0,0,0,0,0,0,10000,-10000,-10000
20200520,708126,環宇國票97購01,,,,,,0.00,0,0,0,0,0,0,0,0,0,0,0,0,0
20200520,708128,環球晶國泰97購02,,,,,,0.00,0,0,0,0,0,0,0,0,0,0,0,0,0
20200520,708129,力旺元大96購01,1.03,1.11,1.01,1.11,+0.47,73.44,190000,9,199900,0,0,0,0,0,0,100000,90000,10000,10000
20200520,708130,台燿元大96購02,0.43,0.43,0.39,0.39,-0.01,-2.5,106000,3,45340,0,0,0,0,0,0,5000,101000,-96000,-96000
20200520,708131,泰博元大96購01,,,,,,0.00,0,0,0,0,0,0,0,0,0,0,0,0,0
20200520,708132,博智元大97購01,,,,,,0.00,0,0,0,0,0,0,0,0,0,0,0,0,0
20200520,708133,網家元大96購01,,,,,,0.00,0,0,0,0,0,0,0,0,0,0,0,0,0
20200520,708134,穩懋元大96購11,,,,,,0.00,0,0,0,0,0,0,0,0,0,0,0,0,0
20200520,708135,群聯群益96購04,,,,,,0.00,0,0,0,0,0,0,0,0,0,0,0,0,0
20200520,708136,宇峻凱基98購02,0.38,0.38,0.38,0.38,0.00,0.0,144000,1,54720,0,0,0,0,0,0,0,144000,-144000,-144000
20200520,708137,旺矽凱基97購01,0.38,0.42,0.38,0.41,+0.04,10.81,577000,9,231630,0,0,0,0,0,0,106000,471000,-365000,-365000
20200520,708138,原相凱基98購01,,,,,,0.00,0,0,0,0,0,0,0,0,0,0,0,0,0
20200520,708139,精華凱基97購01,,,,,,0.00,0,0,0,0,0,0,0,0,0,0,0,0,0
20200520,708140,優群凱基98購02,,,,,,0.00,0,0,0,0,0,0,0,0,0,0,0,0,0
20200520,708141,鈊象凱基98購02,5.20,5.30,5.20,5.30,-0.15,-2.75,3000,2,15700,0,0,0,0,0,0,3000,3000,0,0
20200520,708142,宣德台新96購02,,,,,,0.00,0,0,0,0,0,0,0,0,0,0,0,0,0
20200520,708143,大江永豐97購01,,,,,,0.00,0,0,0,0,0,0,0,0,0,0,0,0,0
20200520,708144,杰力永豐96購01,,,,,,0.00,0,0,0,0,0,0,0,0,0,0,0,0,0
20200520,708145,直得永豐96購01,,,,,,0.00,0,0,0,0,0,0,0,0,0,0,0,0,0
20200520,708146,信昌電永豐96購02,0.80,0.85,0.78,0.85,+0.09,11.84,152000,7,120950,0,0,0,0,0,0,105000,47000,58000,58000
20200520,708147,保瑞永豐96購01,,,,,,0.00,0,0,0,0,0,0,0,0,0,0,0,0,0
20200520,708148,胡連永豐96購01,0.19,0.19,0.18,0.18,+0.05,38.46,25000,3,4740,0,0,0,0,0,0,0,25000,-25000,-25000
20200520,708149,精測永豐96購12,,,,,,0.00,0,0,0,0,0,0,0,0,0,0,0,0,0
20200520,708150,聚積永豐96購01,,,,,,0.00,0,0,0,0,0,0,0,0,0,0,0,0,0
20200520,708151,雙鴻永豐97購02,,,,,,0.00,0,0,0,0,0,0,0,0,0,0,0,0,0
20200520,708152,力旺中信96購01,,,,,,0.00,0,0,0,0,0,0,0,0,0,0,0,0,0
20200520,708153,建榮統一98購01,0.13,0.13,0.13,0.13,-0.01,-7.14,50000,1,6500,0,0,0,0,0,0,50000,0,50000,50000
20200520,708154,大江凱基98購02,0.12,0.13,0.10,0.13,+0.03,30.0,69000,13,8290,0,0,0,0,0,0,0,0,0,0
20200520,708155,宇峻凱基98購03,,,,,,0.00,0,0,0,0,0,0,0,0,0,0,0,0,0
20200520,708157,金居凱基97購01,,,,,,0.00,0,0,0,0,0,0,0,0,0,0,0,0,0
20200520,708158,鐿鈦凱基96購03,,,,,,0.00,0,0,0,0,0,0,0,0,0,0,0,0,0
20200520,708159,大江元大97購03,,,,,,0.00,0,0,0,0,0,0,0,0,0,0,0,0,0
20200520,708160,合晶元大98購01,,,,,,0.00,0,0,0,0,0,0,0,0,0,0,0,0,0
20200520,708162,欣銓元大96購01,,,,,,0.00,0,0,0,0,0,0,0,0,0,0,0,0,0
20200520,708163,威剛元大98購01,,,,,,0.00,0,0,0,0,0,0,0,0,0,0,0,0,0
20200520,708164,環球晶元大96購05,0.19,0.19,0.19,0.19,-0.13,-40.62,7000,1,1330,0,0,0,0,0,0,7000,0,7000,7000
20200520,708165,環球晶元大97購03,,,,,,0.00,0,0,0,0,0,0,0,0,0,0,0,0,0
20200520,708166,凡甲永豐96購02,2.30,2.30,2.17,2.17,-0.50,-18.73,30000,3,67600,0,0,0,0,0,0,20000,10000,10000,10000
20200520,708167,台燿永豐96購01,0.04,0.04,0.04,0.04,-0.02,-33.33,30000,1,1200,0,0,0,0,0,0,30000,0,30000,30000
20200520,708168,波若威永豐97購02,,,,,,0.00,0,0,0,0,0,0,0,0,0,0,0,0,0
20200520,708169,網家永豐96購01,0.34,0.43,0.32,0.41,+0.13,46.43,396000,19,146020,0,0,0,0,0,0,185000,201000,-16000,-16000
20200520,708170,網龍永豐96購03,1.52,1.53,1.32,1.34,-0.07,-4.96,37000,5,54150,0,0,0,0,0,0,15000,22000,-7000,-7000
20200520,708171,優群永豐96購03,,,,,,0.00,0,0,0,0,0,0,0,0,0,0,0,0,0
20200520,708172,緯軟兆豐97購01,,,,,,0.00,0,0,0,0,0,0,0,0,0,0,0,0,0
20200520,708173,鈺太兆豐97購01,0.09,0.09,0.09,0.09,0.00,0.0,10000,1,900,0,0,0,0,0,0,10000,0,10000,10000
20200520,708174,胡連康和96購02,0.38,0.40,0.38,0.40,+0.09,29.03,14000,2,5400,0,0,0,0,0,0,4000,10000,-6000,-6000
20200520,708175,精華群益96購02,,,,,,0.00,0,0,0,0,0,0,0,0,0,0,0,0,0
20200520,708176,中美晶國票97購02,,,,,,0.00,0,0,0,0,0,0,0,0,0,0,0,0,0
20200520,708177,欣銓富邦97購01,,,,,,0.00,0,0,0,0,0,0,0,0,0,0,0,0,0
20200520,708178,鈊象富邦97購01,,,,,,0.00,0,0,0,0,0,0,0,0,0,0,0,0,0
20200520,708179,神盾元富98購01,,,,,,0.00,0,0,0,0,0,0,0,0,0,0,0,0,0
20200520,708180,群聯元富96購04,0.01,0.01,0.01,0.01,0.00,0.0,10000,1,100,0,0,0,0,0,0,10000,10000,0,0
20200520,708181,VHQ統一96購01,,,,,,0.00,0,0,0,0,0,0,0,0,0,0,0,0,0
20200520,708182,凡甲統一96購01,,,,,,0.00,0,0,0,0,0,0,0,0,0,0,0,0,0
20200520,708183,中美晶凱基96購05,,,,,,0.00,0,0,0,0,0,0,0,0,0,0,0,0,0
20200520,708184,建榮凱基96購02,,,,,,0.00,0,0,0,0,0,0,0,0,0,0,0,0,0
20200520,708185,原相凱基97購01,,,,,,0.00,0,0,0,0,0,0,0,0,0,0,0,0,0
20200520,708186,神盾凱基96購03,,,,,,0.00,0,0,0,0,0,0,0,0,0,0,0,0,0
20200520,708187,金居兆豐97購01,1.17,1.19,1.13,1.13,-0.13,-10.32,148000,6,169280,0,0,0,0,0,0,48000,100000,-52000,-52000
20200520,708188,威剛兆豐97購01,0.43,0.43,0.42,0.42,-0.01,-2.33,45000,4,18950,0,0,0,0,0,0,5000,40000,-35000,-35000
20200520,708189,茂達群益98購02,1.08,1.29,1.08,1.29,+0.43,50.0,222000,6,267890,0,0,0,0,0,0,77000,159000,-82000,-82000
20200520,708190,六角元大96購02,,,,,,0.00,0,0,0,0,0,0,0,0,0,0,0,0,0
20200520,708191,同致元大96購02,0.40,0.41,0.39,0.39,+0.14,56.0,310000,5,125900,0,0,0,0,0,0,300000,310000,-10000,-10000
20200520,708192,旺矽元大97購01,1.60,1.82,1.46,1.78,+0.21,13.38,791000,36,1313360,0,0,0,0,0,0,400000,391000,9000,9000
20200520,708193,直得元大96購01,0.20,0.20,0.20,0.20,+0.03,17.65,80000,1,16000,0,0,0,0,0,0,80000,0,80000,80000
20200520,708194,宣德元大97購01,1.26,1.37,1.26,1.37,+0.11,8.73,130000,5,172780,0,0,0,0,0,0,1000,130000,-129000,-129000
20200520,708195,精測元大96購07,,,,,,0.00,0,0,0,0,0,0,0,0,0,0,0,0,0
20200520,708196,環宇元大96購02,,,,,,0.00,0,0,0,0,0,0,0,0,0,0,0,0,0
20200520,708197,合晶亞東97購01,,,,,,0.00,0,0,0,0,0,0,0,0,0,0,0,0,0
20200520,708198,三貝德永豐96購01,,,,,,0.00,0,0,0,0,0,0,0,0,0,0,0,0,0
20200520,708199,大田永豐96購02,0.55,0.57,0.55,0.57,+0.06,11.76,90000,5,50020,0,0,0,0,0,0,80000,10000,70000,70000
20200520,708200,中美晶永豐96購03,,,,,,0.00,0,0,0,0,0,0,0,0,0,0,0,0,0
20200520,708201,金居永豐96購02,0.51,0.52,0.47,0.47,-0.06,-11.32,77000,6,38700,0,0,0,0,0,0,37000,40000,-3000,-3000
20200520,708202,碩禾永豐96購01,0.06,0.06,0.06,0.06,0.00,0.0,5000,1,300,0,0,0,0,0,0,5000,0,5000,5000
20200520,708203,雙鴻永豐96購02,,,,,,0.00,0,0,0,0,0,0,0,0,0,0,0,0,0
20200520,708205,力旺台新97購02,0.70,0.71,0.70,0.71,+0.39,121.88,45000,2,31700,0,0,0,0,0,0,45000,0,45000,45000
20200520,708206,大江國票97購04,,,,,,0.00,0,0,0,0,0,0,0,0,0,0,0,0,0
20200520,708207,大學光國票98購01,,,,,,0.00,0,0,0,0,0,0,0,0,0,0,0,0,0
20200520,708208,勝麗國票97購03,,,,,,0.00,0,0,0,0,0,0,0,0,0,0,0,0,0
20200520,708209,博智國票97購01,,,,,,0.00,0,0,0,0,0,0,0,0,0,0,0,0,0
20200520,708210,閎康國票97購02,0.87,0.94,0.87,0.94,+0.07,8.05,110000,4,98380,0,0,0,0,0,0,0,110000,-110000,-110000
20200520,708211,精華國票97購02,,,,,,0.00,0,0,0,0,0,0,0,0,0,0,0,0,0
20200520,708212,鈺太國泰96購01,,,,,,0.00,0,0,0,0,0,0,0,0,0,0,0,0,0
20200520,708213,群聯富邦97購02,,,,,,0.00,0,0,0,0,0,0,0,0,0,0,0,0,0
20200520,708214,鈺太統一99購01,,,,,,0.00,0,0,0,0,0,0,0,0,0,0,0,0,0
20200520,708215,久元凱基96購01,1.32,1.46,1.32,1.46,+0.38,35.19,70000,4,96700,0,0,0,0,0,0,70000,0,70000,70000
20200520,708216,勝麗凱基98購01,0.78,0.82,0.78,0.82,+0.07,9.33,91000,3,73030,0,0,0,0,0,0,48000,43000,5000,5000
20200520,708217,碩禾凱基98購01,,,,,,0.00,0,0,0,0,0,0,0,0,0,0,0,0,0
20200520,708218,中美晶元富96購01,,,,,,0.00,0,0,0,0,0,0,0,0,0,0,0,0,0
20200520,708219,新普元富96購01,2.65,2.65,2.65,2.65,-0.40,-13.11,41000,1,108650,0,0,0,0,0,0,0,41000,-41000,-41000
20200520,708220,雙鴻台新97購01,,,,,,0.00,0,0,0,0,0,0,0,0,0,0,0,0,0
20200520,708221,VHQ康和96購01,,,,,,0.00,0,0,0,0,0,0,0,0,0,0,0,0,0
20200520,708222,網家康和96購01,0.68,0.68,0.68,0.68,+0.36,112.5,20000,2,13600,0,0,0,0,0,0,0,20000,-20000,-20000
20200520,708223,台半群益96購01,,,,,,0.00,0,0,0,0,0,0,0,0,0,0,0,0,0
20200520,708224,良維群益96購01,,,,,,0.00,0,0,0,0,0,0,0,0,0,0,0,0,0
20200520,708226,信昌電群益96購03,,,,,,0.00,0,0,0,0,0,0,0,0,0,0,0,0,0
20200520,708227,鈊象群益99購04,,,,,,0.00,0,0,0,0,0,0,0,0,0,0,0,0,0
20200520,708228,波若威永豐96購01,,,,,,0.00,0,0,0,0,0,0,0,0,0,0,0,0,0
20200520,708229,中美晶亞東96購01,,,,,,0.00,0,0,0,0,0,0,0,0,0,0,0,0,0
20200520,708230,群聯亞東96購01,,,,,,0.00,0,0,0,0,0,0,0,0,0,0,0,0,0
20200520,708231,六角國票98購03,0.28,0.28,0.24,0.24,-0.04,-14.29,330000,3,87200,0,0,0,0,0,0,200000,130000,70000,70000
20200520,708232,宜鼎國票97購03,3.12,3.56,3.12,3.56,+0.28,8.54,80000,15,266200,0,0,0,0,0,0,29000,53000,-24000,-24000
20200520,708233,宣德國票97購01,0.87,0.94,0.87,0.94,+0.06,6.82,188000,4,170660,0,0,0,0,0,0,0,188000,-188000,-188000
20200520,708234,神盾國票98購01,0.25,0.25,0.22,0.22,-0.03,-12.0,104000,7,24280,0,0,0,0,0,0,0,104000,-104000,-104000
20200520,708235,璟德國票97購01,0.83,0.89,0.83,0.89,-0.01,-1.11,133000,3,116090,0,0,0,0,0,0,95000,38000,57000,57000
20200520,708236,優群國票97購01,,,,,,0.00,0,0,0,0,0,0,0,0,0,0,0,0,0
20200520,708237,環宇國票97購02,,,,,,0.00,0,0,0,0,0,0,0,0,0,0,0,0,0
20200520,708238,三貝德元大97購01,,,,,,0.00,0,0,0,0,0,0,0,0,0,0,0,0,0
20200520,708239,中美晶元大96購04,,,,,,0.00,0,0,0,0,0,0,0,0,0,0,0,0,0
20200520,708240,宇峻元大97購02,1.11,1.11,1.11,1.11,+0.04,3.74,12000,1,13320,0,0,0,0,0,0,0,12000,-12000,-12000
20200520,708241,聯亞元大97購02,1.62,1.62,1.62,1.62,0.00,0.0,10000,1,16200,0,0,0,0,0,0,0,10000,-10000,-10000
20200520,708242,穩懋元大97購02,,,,,,0.00,0,0,0,0,0,0,0,0,0,0,0,0,0
20200520,708243,譜瑞元大97購01,,,,,,0.00,0,0,0,0,0,0,0,0,0,0,0,0,0
20200520,708244,原相國泰98購02,1.33,1.33,1.33,1.33,-0.17,-11.33,200000,1,266000,0,0,0,0,0,0,200000,200000,0,0
20200520,708245,勝麗國泰98購01,1.14,1.14,1.14,1.14,+0.17,17.53,10000,1,11400,0,0,0,0,0,0,0,10000,-10000,-10000
20200520,708246,網家國泰97購02,1.98,2.07,1.98,2.06,+0.48,30.38,107000,6,220370,0,0,0,0,0,0,0,107000,-107000,-107000
20200520,708247,原相第一96購01,,,,,,0.00,0,0,0,0,0,0,0,0,0,0,0,0,0
20200520,708248,波若威凱基98購01,,,,,,0.00,0,0,0,0,0,0,0,0,0,0,0,0,0
20200520,708249,雙鴻凱基98購01,0.05,0.05,0.05,0.05,-0.05,-50.0,30000,1,1500,0,0,0,0,0,0,30000,0,30000,30000
20200520,708250,穩懋凱基96購12,,,,,,0.00,0,0,0,0,0,0,0,0,0,0,0,0,0
20200520,708251,頎邦凱基97購01,,,,,,0.00,0,0,0,0,0,0,0,0,0,0,0,0,0
20200520,708252,頎邦凱基97購02,,,,,,0.00,0,0,0,0,0,0,0,0,0,0,0,0,0
20200520,708253,大江元富96購02,,,,,,0.00,0,0,0,0,0,0,0,0,0,0,0,0,0
20200520,708254,頎邦元富96購01,,,,,,0.00,0,0,0,0,0,0,0,0,0,0,0,0,0
20200520,708255,頎邦元富96購02,,,,,,0.00,0,0,0,0,0,0,0,0,0,0,0,0,0
20200520,708256,信昌電永豐96購03,,,,,,0.00,0,0,0,0,0,0,0,0,0,0,0,0,0
20200520,708257,頎邦永豐96購02,0.38,0.38,0.38,0.38,-0.05,-11.63,95000,1,36100,0,0,0,0,0,0,95000,0,95000,95000
20200520,708258,頎邦永豐96購03,,,,,,0.00,0,0,0,0,0,0,0,0,0,0,0,0,0
20200520,708259,神盾統一96購01,0.12,0.12,0.11,0.11,-0.03,-21.43,80000,3,9100,0,0,0,0,0,0,50000,30000,20000,20000
20200520,708260,群聯統一98購01,1.68,1.68,1.68,1.68,-0.11,-6.15,166000,2,278880,0,0,0,0,0,0,166000,0,166000,166000
20200520,708261,頎邦統一96購01,,,,,,0.00,0,0,0,0,0,0,0,0,0,0,0,0,0
20200520,708262,合晶國票97購02,,,,,,0.00,0,0,0,0,0,0,0,0,0,0,0,0,0
20200520,708263,威剛國票97購01,,,,,,0.00,0,0,0,0,0,0,0,0,0,0,0,0,0
20200520,708264,宣德國票97購02,0.55,0.56,0.55,0.56,0.00,0.0,189000,3,105460,0,0,0,0,0,0,151000,38000,113000,113000
20200520,708265,聚積國票97購02,,,,,,0.00,0,0,0,0,0,0,0,0,0,0,0,0,0
20200520,708266,頎邦國票97購01,,,,,,0.00,0,0,0,0,0,0,0,0,0,0,0,0,0
20200520,708267,M31國泰98購01,,,,,,0.00,0,0,0,0,0,0,0,0,0,0,0,0,0
20200520,708268,聯亞國泰98購01,0.61,0.61,0.57,0.59,-0.06,-9.23,13000,5,7710,0,0,0,0,0,0,0,13000,-13000,-13000
20200520,708269,頎邦國泰97購01,,,,,,0.00,0,0,0,0,0,0,0,0,0,0,0,0,0
20200520,708271,原相富邦98購01,,,,,,0.00,0,0,0,0,0,0,0,0,0,0,0,0,0
20200520,708272,頎邦富邦98購01,0.27,0.27,0.27,0.27,+0.01,3.85,1000,1,270,0,0,0,0,0,0,0,1000,-1000,-1000
20200520,708273,力旺元大96購02,2.18,2.40,1.86,1.86,+0.12,6.9,222000,16,470910,0,0,0,0,0,0,6000,216000,-210000,-210000
20200520,708274,中美晶元大96購05,0.55,0.55,0.55,0.55,-0.14,-20.29,30000,1,16500,0,0,0,0,0,0,30000,0,30000,30000
20200520,708275,六角元大98購01,,,,,,0.00,0,0,0,0,0,0,0,0,0,0,0,0,0
20200520,708276,台半元大96購02,,,,,,0.00,0,0,0,0,0,0,0,0,0,0,0,0,0
20200520,708277,金居元大97購01,,,,,,0.00,0,0,0,0,0,0,0,0,0,0,0,0,0
20200520,708278,勝麗元大96購03,0.74,0.85,0.74,0.82,+0.06,7.89,207000,6,164890,0,0,0,0,0,0,68000,139000,-71000,-71000
20200520,708279,頎邦元大96購02,,,,,,0.00,0,0,0,0,0,0,0,0,0,0,0,0,0
20200520,708280,頎邦元大96購03,,,,,,0.00,0,0,0,0,0,0,0,0,0,0,0,0,0
20200520,708281,頎邦元大97購01,0.31,0.31,0.31,0.31,-0.08,-20.51,50000,1,15500,0,0,0,0,0,0,50000,0,50000,50000
20200520,708282,兆利群益98購01,,,,,,0.00,0,0,0,0,0,0,0,0,0,0,0,0,0
20200520,708283,頎邦群益97購01,0.53,0.53,0.52,0.53,-0.02,-3.64,30000,3,15800,0,0,0,0,0,0,20000,10000,10000,10000
20200520,708284,頎邦群益97購02,,,,,,0.00,0,0,0,0,0,0,0,0,0,0,0,0,0
20200520,708285,頎邦群益98購01,0.40,0.40,0.38,0.38,-0.05,-11.63,359000,3,140400,0,0,0,0,0,0,160000,199000,-39000,-39000
20200520,708286,三貝德康和96購01,0.08,0.08,0.08,0.08,-0.01,-11.11,40000,1,3200,0,0,0,0,0,0,40000,0,40000,40000
20200520,708287,兆利康和9C購01,,,,,,0.00,0,0,0,0,0,0,0,0,0,0,0,0,0
20200520,708288,富喬康和96購01,,,,,,0.00,0,0,0,0,0,0,0,0,0,0,0,0,0
20200520,708289,杰力群益96購01,0.73,0.83,0.73,0.83,+0.05,6.41,235000,7,186550,0,0,0,0,0,0,50000,140000,-90000,-90000
20200520,708290,威剛群益97購01,,,,,,0.00,0,0,0,0,0,0,0,0,0,0,0,0,0
20200520,708291,環宇群益98購01,,,,,,0.00,0,0,0,0,0,0,0,0,0,0,0,0,0
20200520,708292,M31國票97購02,,,,,,0.00,0,0,0,0,0,0,0,0,0,0,0,0,0
20200520,708293,合晶國票98購01,1.21,1.24,1.19,1.24,+0.10,8.77,234000,11,288200,0,0,0,0,0,0,20000,234000,-214000,-214000
20200520,708294,良維國票97購03,1.04,1.04,1.04,1.04,+0.01,0.97,127000,2,132080,0,0,0,0,0,0,127000,77000,50000,50000
20200520,708296,威剛國票97購02,0.01,0.02,0.01,0.02,+0.01,100.0,101000,4,1020,0,0,0,0,0,0,0,0,0,0
20200520,708297,茂達國票97購02,1.12,1.32,1.12,1.32,+0.42,46.67,522000,10,649340,0,0,0,0,0,0,55000,467000,-412000,-412000
20200520,708298,原相國票98購02,,,,,,0.00,0,0,0,0,0,0,0,0,0,0,0,0,0
20200520,708299,穩懋國票97購02,0.73,0.73,0.73,0.73,-0.05,-6.41,30000,1,21900,0,0,0,0,0,0,0,30000,-30000,-30000
20200520,708300,群聯日盛96購01,,,,,,0.00,0,0,0,0,0,0,0,0,0,0,0,0,0
20200520,708301,優群永豐97購01,2.80,2.84,2.55,2.55,+0.07,2.82,31000,5,85250,0,0,0,0,0,0,21000,10000,11000,11000
20200520,708302,穩懋永豐96購02,0.07,0.07,0.07,0.07,-0.03,-30.0,60000,1,4200,0,0,0,0,0,0,60000,0,60000,60000
20200520,708303,伍豐中信9A購01,,,,,,0.00,0,0,0,0,0,0,0,0,0,0,0,0,0
20200520,708304,同致中信98購02,,,,,,0.00,0,0,0,0,0,0,0,0,0,0,0,0,0
20200520,708305,宜鼎中信9A購01,0.58,0.67,0.58,0.67,+0.07,11.67,1228000,33,767640,0,0,0,0,0,0,500000,758000,-258000,-258000
20200520,708306,閎康統一99購01,,,,,,0.00,0,0,0,0,0,0,0,0,0,0,0,0,0
20200520,708307,頎邦統一96購02,,,,,,0.00,0,0,0,0,0,0,0,0,0,0,0,0,0
20200520,708308,大中凱基98購01,0.16,0.16,0.14,0.14,+0.01,7.69,160000,5,24000,0,0,0,0,0,0,70000,90000,-20000,-20000
20200520,708309,大江凱基97購01,,,,,,0.00,0,0,0,0,0,0,0,0,0,0,0,0,0
20200520,708310,兆利凱基98購01,0.13,0.13,0.13,0.13,0.00,0.0,10000,1,1300,0,0,0,0,0,0,0,10000,-10000,-10000
20200520,708311,迅得凱基97購01,,,,,,0.00,0,0,0,0,0,0,0,0,0,0,0,0,0
20200520,708312,佳邦凱基98購01,0.35,0.35,0.34,0.34,-0.02,-5.56,80000,2,27700,0,0,0,0,0,0,50000,30000,20000,20000
20200520,708313,金居凱基98購01,0.95,0.96,0.95,0.96,-0.04,-4.0,62000,3,59500,0,0,0,0,0,0,62000,0,62000,62000
20200520,708314,聚積凱基98購01,,,,,,0.00,0,0,0,0,0,0,0,0,0,0,0,0,0
20200520,708315,廣明凱基98購01,0.07,0.07,0.07,0.07,-0.10,-58.82,7000,1,490,0,0,0,0,0,0,7000,0,7000,7000
20200520,708316,緯軟凱基98購02,,,,,,0.00,0,0,0,0,0,0,0,0,0,0,0,0,0
20200520,708317,環宇凱基98購01,0.30,0.30,0.30,0.30,+0.02,7.14,10000,1,3000,0,0,0,0,0,0,10000,0,10000,10000
20200520,708318,聯亞凱基98購01,1.55,1.55,1.55,1.55,-0.09,-5.49,5000,1,7750,0,0,0,0,0,0,5000,0,5000,5000
20200520,708319,穩懋凱基96購13,,,,,,0.00,0,0,0,0,0,0,0,0,0,0,0,0,0
20200520,708320,頎邦凱基96購01,,,,,,0.00,0,0,0,0,0,0,0,0,0,0,0,0,0
20200520,708321,大學光元大97購01,,,,,,0.00,0,0,0,0,0,0,0,0,0,0,0,0,0
20200520,708322,群聯元大97購04,,,,,,0.00,0,0,0,0,0,0,0,0,0,0,0,0,0
20200520,708323,聯亞元大97購03,,,,,,0.00,0,0,0,0,0,0,0,0,0,0,0,0,0
20200520,708324,新普兆豐97購01,1.81,1.81,1.71,1.73,-0.13,-6.99,145000,6,252050,0,0,0,0,0,0,135000,10000,125000,125000
20200520,708325,穩懋兆豐97購02,0.92,0.93,0.90,0.90,-0.15,-14.29,19000,3,17330,0,0,0,0,0,0,4000,15000,-11000,-11000
20200520,708326,大江日盛96購01,,,,,,0.00,0,0,0,0,0,0,0,0,0,0,0,0,0
20200520,708327,鈊象第一96購01,,,,,,0.00,0,0,0,0,0,0,0,0,0,0,0,0,0
20200520,708328,晶焱元大97購03,,,,,,0.00,0,0,0,0,0,0,0,0,0,0,0,0,0
20200520,708329,頎邦康和96購01,,,,,,0.00,0,0,0,0,0,0,0,0,0,0,0,0,0
20200520,708330,M31群益98購01,,,,,,0.00,0,0,0,0,0,0,0,0,0,0,0,0,0
20200520,708331,中美晶群益96購03,,,,,,0.00,0,0,0,0,0,0,0,0,0,0,0,0,0
20200520,708332,六角群益98購01,,,,,,0.00,0,0,0,0,0,0,0,0,0,0,0,0,0
20200520,708333,宇峻群益98購01,,,,,,0.00,0,0,0,0,0,0,0,0,0,0,0,0,0
20200520,708334,佳邦群益98購01,,,,,,0.00,0,0,0,0,0,0,0,0,0,0,0,0,0
20200520,708335,網龍群益96購01,,,,,,0.00,0,0,0,0,0,0,0,0,0,0,0,0,0
20200520,708336,大宇資永豐97購01,,,,,,0.00,0,0,0,0,0,0,0,0,0,0,0,0,0
20200520,708337,大學光永豐96購02,,,,,,0.00,0,0,0,0,0,0,0,0,0,0,0,0,0
20200520,708338,伍豐永豐96購01,,,,,,0.00,0,0,0,0,0,0,0,0,0,0,0,0,0
20200520,708339,旺矽永豐97購02,0.34,0.34,0.34,0.34,+0.02,6.25,10000,1,3400,0,0,0,0,0,0,10000,0,10000,10000
20200520,708341,美琪瑪永豐96購02,,,,,,0.00,0,0,0,0,0,0,0,0,0,0,0,0,0
20200520,708342,群聯永豐96購02,,,,,,0.00,0,0,0,0,0,0,0,0,0,0,0,0,0
20200520,708343,網龍永豐96購04,,,,,,0.00,0,0,0,0,0,0,0,0,0,0,0,0,0
20200520,708344,聯亞永豐96購03,,,,,,0.00,0,0,0,0,0,0,0,0,0,0,0,0,0
20200520,708345,鈊象永豐96購05,1.43,1.43,1.31,1.31,-0.19,-12.67,72000,7,98380,0,0,0,0,0,0,42000,32000,10000,10000
20200520,708346,M31統一97購01,0.73,0.80,0.66,0.66,-0.03,-4.35,809000,20,622750,0,0,0,0,0,0,431000,378000,53000,53000
20200520,708347,環球晶統一96購02,,,,,,0.00,0,0,0,0,0,0,0,0,0,0,0,0,0
20200520,708348,環球晶中信96購02,,,,,,0.00,0,0,0,0,0,0,0,0,0,0,0,0,0
20200520,708349,鈺太中信97購01,0.11,0.11,0.11,0.11,+0.01,10.0,10000,1,1100,0,0,0,0,0,0,10000,0,10000,10000
20200520,708350,中美晶台新97購02,,,,,,0.00,0,0,0,0,0,0,0,0,0,0,0,0,0
20200520,708351,穩懋台新97購02,,,,,,0.00,0,0,0,0,0,0,0,0,0,0,0,0,0
20200520,708352,杰力凱基98購01,0.54,0.61,0.53,0.61,+0.06,10.91,393000,26,223140,0,0,0,0,0,0,219000,154000,65000,65000
20200520,708353,中美晶富邦97購03,,,,,,0.00,0,0,0,0,0,0,0,0,0,0,0,0,0
20200520,708354,合晶國票99購01,0.95,0.98,0.95,0.98,+0.07,7.69,101000,2,98920,0,0,0,0,0,0,2000,101000,-99000,-99000
20200520,708355,昇達科國票97購01,0.70,0.71,0.70,0.71,-0.06,-7.79,114000,2,80560,0,0,0,0,0,0,76000,114000,-38000,-38000
20200520,708356,信昌電國票97購03,0.46,0.46,0.41,0.41,-0.02,-4.65,300000,4,130000,0,0,0,0,0,0,100000,200000,-100000,-100000
20200520,708357,神盾國票97購03,0.91,0.93,0.85,0.85,-0.06,-6.59,195000,5,169530,0,0,0,0,0,0,0,195000,-195000,-195000
20200520,708358,群聯國票97購02,,,,,,0.00,0,0,0,0,0,0,0,0,0,0,0,0,0
20200520,708359,中美晶國泰97購02,,,,,,0.00,0,0,0,0,0,0,0,0,0,0,0,0,0
20200520,708360,宇峻國泰97購01,,,,,,0.00,0,0,0,0,0,0,0,0,0,0,0,0,0
20200520,708361,鈊象國泰98購02,,,,,,0.00,0,0,0,0,0,0,0,0,0,0,0,0,0
20200520,708362,環球晶統一96購04,,,,,,0.00,0,0,0,0,0,0,0,0,0,0,0,0,0
20200520,708363,台燿中信98購01,0.54,0.54,0.46,0.46,-0.05,-9.8,515000,49,257940,0,0,0,0,0,0,257000,258000,-1000,-1000
20200520,708364,新普中信98購01,0.69,0.69,0.55,0.55,-0.26,-32.1,14000,3,8720,0,0,0,0,0,0,6000,8000,-2000,-2000
20200520,708365,凡甲凱基97購01,1.48,1.51,1.32,1.32,-0.12,-8.33,299000,29,427790,0,0,0,0,0,0,283000,0,283000,283000
20200520,708366,中美晶凱基97購01,,,,,,0.00,0,0,0,0,0,0,0,0,0,0,0,0,0
20200520,708367,良維凱基97購02,0.56,0.56,0.56,0.56,+0.02,3.7,50000,1,28000,0,0,0,0,0,0,0,50000,-50000,-50000
20200520,708368,宣德凱基97購01,,,,,,0.00,0,0,0,0,0,0,0,0,0,0,0,0,0
20200520,708369,雙美凱基98購01,,,,,,0.00,0,0,0,0,0,0,0,0,0,0,0,0,0
20200520,708370,中美晶元大96購06,0.51,0.51,0.51,0.51,+0.01,2.0,68000,1,34680,0,0,0,0,0,0,0,68000,-68000,-68000
20200520,708371,信昌電元大96購04,,,,,,0.00,0,0,0,0,0,0,0,0,0,0,0,0,0
20200520,708372,優群元大97購03,,,,,,0.00,0,0,0,0,0,0,0,0,0,0,0,0,0
20200520,708373,中美晶元富96購02,,,,,,0.00,0,0,0,0,0,0,0,0,0,0,0,0,0
20200520,708374,久元台新96購01,1.34,1.44,1.33,1.44,+0.25,21.01,9000,4,12420,0,0,0,0,0,0,9000,0,9000,9000
20200520,708375,久元台新96購02,,,,,,0.00,0,0,0,0,0,0,0,0,0,0,0,0,0
20200520,708376,台半台新96購01,,,,,,0.00,0,0,0,0,0,0,0,0,0,0,0,0,0
20200520,708377,鈊象台新96購02,,,,,,0.00,0,0,0,0,0,0,0,0,0,0,0,0,0
20200520,708378,頎邦台新97購01,,,,,,0.00,0,0,0,0,0,0,0,0,0,0,0,0,0
20200520,708379,穩懋亞東98購01,,,,,,0.00,0,0,0,0,0,0,0,0,0,0,0,0,0
20200520,708380,台半永豐96購01,,,,,,0.00,0,0,0,0,0,0,0,0,0,0,0,0,0
20200520,708381,亞泰永豐96購01,,,,,,0.00,0,0,0,0,0,0,0,0,0,0,0,0,0
20200520,708382,宜鼎永豐96購02,,,,,,0.00,0,0,0,0,0,0,0,0,0,0,0,0,0
20200520,708383,信昌電永豐96購04,,,,,,0.00,0,0,0,0,0,0,0,0,0,0,0,0,0
20200520,708384,雍智永豐97購01,0.45,0.57,0.43,0.47,+0.10,27.03,676000,41,339820,0,0,0,0,0,0,152000,513000,-361000,-361000
20200520,708385,碩禾永豐96購02,,,,,,0.00,0,0,0,0,0,0,0,0,0,0,0,0,0
20200520,708386,雙鴻永豐97購03,,,,,,0.00,0,0,0,0,0,0,0,0,0,0,0,0,0
20200520,708387,瓦城康和96購01,,,,,,0.00,0,0,0,0,0,0,0,0,0,0,0,0,0
20200520,708388,三貝德群益96購02,,,,,,0.00,0,0,0,0,0,0,0,0,0,0,0,0,0
20200520,708389,台半群益96購02,,,,,,0.00,0,0,0,0,0,0,0,0,0,0,0,0,0
20200520,708390,美琪瑪群益96購01,,,,,,0.00,0,0,0,0,0,0,0,0,0,0,0,0,0
20200520,708391,原相群益98購02,0.79,0.79,0.79,0.79,-0.76,-49.03,61000,1,48190,0,0,0,0,0,0,61000,61000,0,0
20200520,708392,大江國票97購05,,,,,,0.00,0,0,0,0,0,0,0,0,0,0,0,0,0
20200520,708393,信昌電國泰98購01,,,,,,0.00,0,0,0,0,0,0,0,0,0,0,0,0,0
20200520,708394,威剛國泰98購01,,,,,,0.00,0,0,0,0,0,0,0,0,0,0,0,0,0
20200520,708395,環球晶國泰97購03,,,,,,0.00,0,0,0,0,0,0,0,0,0,0,0,0,0
20200520,708396,信昌電富邦98購01,,,,,,0.00,0,0,0,0,0,0,0,0,0,0,0,0,0
20200520,708397,群聯富邦97購03,,,,,,0.00,0,0,0,0,0,0,0,0,0,0,0,0,0
20200520,708398,環球晶富邦99購01,0.68,0.68,0.65,0.65,-0.04,-5.8,207000,24,136540,0,0,0,0,0,0,11000,192000,-181000,-181000
20200520,708399,穩懋富邦97購03,,,,,,0.00,0,0,0,0,0,0,0,0,0,0,0,0,0
20200520,708400,建榮國票98購01,,,,,,0.00,0,0,0,0,0,0,0,0,0,0,0,0,0
20200520,708401,威剛國泰98購02,,,,,,0.00,0,0,0,0,0,0,0,0,0,0,0,0,0
20200520,708402,優群國泰99購01,3.65,3.65,3.65,3.65,+0.31,9.28,6000,1,21900,0,0,0,0,0,0,0,6000,-6000,-6000
20200520,708403,合晶元大98購02,1.73,1.74,1.64,1.73,+0.06,3.59,353000,14,600910,0,0,0,0,0,0,106000,313000,-207000,-207000
20200520,708404,聖暉元大97購01,1.42,1.42,1.36,1.38,+0.02,1.47,100000,7,138200,0,0,0,0,0,0,100000,0,100000,100000
20200520,708405,頎邦元大97購02,,,,,,0.00,0,0,0,0,0,0,0,0,0,0,0,0,0
20200520,708407,環球晶元富97購01,0.65,0.65,0.63,0.63,-0.06,-8.7,49000,4,31430,0,0,0,0,0,0,0,49000,-49000,-49000
20200520,708408,雙鴻統一97購01,,,,,,0.00,0,0,0,0,0,0,0,0,0,0,0,0,0
20200520,708409,精測中信97購01,0.02,0.02,0.02,0.02,0.00,0.0,10000,1,200,0,0,0,0,0,0,0,10000,-10000,-10000
20200520,708410,頎邦中信9B購01,0.09,0.10,0.09,0.10,0.00,0.0,250000,4,24500,0,0,0,0,0,0,40000,200000,-160000,-160000
20200520,708411,宜鼎凱基99購01,,,,,,0.00,0,0,0,0,0,0,0,0,0,0,0,0,0
20200520,708412,直得凱基98購01,,,,,,0.00,0,0,0,0,0,0,0,0,0,0,0,0,0
20200520,708413,信昌電凱基98購01,,,,,,0.00,0,0,0,0,0,0,0,0,0,0,0,0,0
20200520,708414,群聯凱基98購01,,,,,,0.00,0,0,0,0,0,0,0,0,0,0,0,0,0
20200520,708415,VHQ永豐97購01,,,,,,0.00,0,0,0,0,0,0,0,0,0,0,0,0,0
20200520,708416,大宇資永豐99購01,,,,,,0.00,0,0,0,0,0,0,0,0,0,0,0,0,0
20200520,708417,長科*永豐97購01,,,,,,0.00,0,0,0,0,0,0,0,0,0,0,0,0,0
20200520,708418,廣明永豐97購01,,,,,,0.00,0,0,0,0,0,0,0,0,0,0,0,0,0
20200520,708419,環宇永豐98購01,,,,,,0.00,0,0,0,0,0,0,0,0,0,0,0,0,0
20200520,708420,宜鼎群益98購01,,,,,,0.00,0,0,0,0,0,0,0,0,0,0,0,0,0
20200520,708421,群聯群益98購01,,,,,,0.00,0,0,0,0,0,0,0,0,0,0,0,0,0
20200520,708422,群聯群益99購01,,,,,,0.00,0,0,0,0,0,0,0,0,0,0,0,0,0
20200520,708423,世界麥證97購01,,,,,,0.00,0,0,0,0,0,0,0,0,0,0,0,0,0
20200520,708424,原相台新97購02,,,,,,0.00,0,0,0,0,0,0,0,0,0,0,0,0,0
20200520,708425,新鉅科台新98購01,,,,,,0.00,0,0,0,0,0,0,0,0,0,0,0,0,0
20200520,708426,群聯台新97購03,,,,,,0.00,0,0,0,0,0,0,0,0,0,0,0,0,0
20200520,708427,聯亞台新97購01,,,,,,0.00,0,0,0,0,0,0,0,0,0,0,0,0,0
20200520,708428,鈺太台新97購01,,,,,,0.00,0,0,0,0,0,0,0,0,0,0,0,0,0
20200520,708429,群聯統一97購01,0.80,0.80,0.80,0.80,-0.03,-3.61,36000,1,28800,0,0,0,0,0,0,36000,0,36000,36000
20200520,708430,兆利中信9A購01,0.04,0.04,0.04,0.04,0.00,0.0,50000,5,2000,0,0,0,0,0,0,0,50000,-50000,-50000
20200520,708431,原相中信99購01,0.80,0.80,0.76,0.76,-0.08,-9.52,60000,5,46150,0,0,0,0,0,0,35000,20000,15000,15000
20200520,708432,廣明中信9B購01,0.07,0.10,0.07,0.10,+0.02,25.0,30000,3,2500,0,0,0,0,0,0,0,20000,-20000,-20000
20200520,708433,穩懋中信99購01,0.15,0.15,0.13,0.13,-0.04,-23.53,1775000,42,237300,0,0,0,0,0,0,795000,910000,-115000,-115000
20200520,708434,合晶凱基98購01,0.53,0.55,0.53,0.55,+0.05,10.0,15000,2,8050,0,0,0,0,0,0,15000,0,15000,15000
20200520,708435,勝麗凱基97購02,,,,,,0.00,0,0,0,0,0,0,0,0,0,0,0,0,0
20200520,708436,博智凱基97購01,,,,,,0.00,0,0,0,0,0,0,0,0,0,0,0,0,0
20200520,708437,穩懋日盛97購01,,,,,,0.00,0,0,0,0,0,0,0,0,0,0,0,0,0
20200520,708438,中美晶亞東97購01,,,,,,0.00,0,0,0,0,0,0,0,0,0,0,0,0,0
20200520,708439,合晶亞東97購02,,,,,,0.00,0,0,0,0,0,0,0,0,0,0,0,0,0
20200520,708440,大田元富97購01,0.94,0.99,0.94,0.98,+0.02,2.08,210000,7,200700,0,0,0,0,0,0,200000,10000,190000,190000
20200520,708441,榮剛元富97購01,0.16,0.16,0.16,0.16,-0.10,-38.46,5000,1,800,0,0,0,0,0,0,5000,0,5000,5000
20200520,708442,聯亞台新99購01,,,,,,0.00,0,0,0,0,0,0,0,0,0,0,0,0,0
20200520,708444,威剛元大99購01,,,,,,0.00,0,0,0,0,0,0,0,0,0,0,0,0,0
20200520,708445,神盾元大99購02,,,,,,0.00,0,0,0,0,0,0,0,0,0,0,0,0,0
20200520,708446,聯亞元大97購04,,,,,,0.00,0,0,0,0,0,0,0,0,0,0,0,0,0
20200520,708447,鈺太元大99購01,0.67,0.67,0.63,0.63,-0.02,-3.08,125000,5,81950,0,0,0,0,0,0,125000,0,125000,125000
20200520,708448,大中永豐97購01,,,,,,0.00,0,0,0,0,0,0,0,0,0,0,0,0,0
20200520,708449,大江永豐97購02,,,,,,0.00,0,0,0,0,0,0,0,0,0,0,0,0,0
20200520,708450,六角永豐97購01,,,,,,0.00,0,0,0,0,0,0,0,0,0,0,0,0,0
20200520,708451,兆利永豐97購01,,,,,,0.00,0,0,0,0,0,0,0,0,0,0,0,0,0
20200520,708452,波若威永豐98購01,,,,,,0.00,0,0,0,0,0,0,0,0,0,0,0,0,0
20200520,708453,宣德永豐97購02,,,,,,0.00,0,0,0,0,0,0,0,0,0,0,0,0,0
20200520,708454,建榮永豐99購01,,,,,,0.00,0,0,0,0,0,0,0,0,0,0,0,0,0
20200520,708455,森鉅永豐97購01,,,,,,0.00,0,0,0,0,0,0,0,0,0,0,0,0,0
20200520,708456,榮剛永豐97購01,,,,,,0.00,0,0,0,0,0,0,0,0,0,0,0,0,0
20200520,708457,廣積永豐97購01,,,,,,0.00,0,0,0,0,0,0,0,0,0,0,0,0,0
20200520,708458,旺矽群益9A購01,1.10,1.18,1.10,1.18,+0.12,11.32,43000,5,49180,0,0,0,0,0,0,0,43000,-43000,-43000
20200520,708459,昇達科群益98購01,,,,,,0.00,0,0,0,0,0,0,0,0,0,0,0,0,0
20200520,708460,櫃200群益97購01,,,,,,0.00,0,0,0,0,0,0,0,0,0,0,0,0,0
20200520,708461,櫃200群益97購02,,,,,,0.00,0,0,0,0,0,0,0,0,0,0,0,0,0
20200520,708462,中美晶元大97購03,1.15,1.15,1.13,1.13,-0.10,-8.13,399000,17,456850,0,0,0,0,0,0,100000,222000,-122000,-122000
20200520,708463,宜鼎元大97購01,1.42,1.63,1.42,1.63,+0.11,7.24,202000,10,317160,0,0,0,0,0,0,6000,196000,-190000,-190000
20200520,708465,璟德元大97購01,0.97,0.97,0.93,0.93,-0.01,-1.06,135000,2,127030,0,0,0,0,0,0,37000,98000,-61000,-61000
20200520,708466,璟德元大97購02,0.55,0.55,0.55,0.55,+0.02,3.77,68000,1,37400,0,0,0,0,0,0,0,68000,-68000,-68000
20200520,708467,優群元大97購04,,,,,,0.00,0,0,0,0,0,0,0,0,0,0,0,0,0
20200520,708468,兆利康和97購01,,,,,,0.00,0,0,0,0,0,0,0,0,0,0,0,0,0
20200520,708469,璟德康和97購01,,,,,,0.00,0,0,0,0,0,0,0,0,0,0,0,0,0
20200520,708470,璟德元富97購01,0.43,0.43,0.43,0.43,0.00,0.0,2000,1,860,0,0,0,0,0,0,2000,0,2000,2000
20200520,708471,璟德台新97購01,,,,,,0.00,0,0,0,0,0,0,0,0,0,0,0,0,0
20200520,708472,三貝德凱基99購01,0.04,0.04,0.04,0.04,-0.01,-20.0,10000,1,400,0,0,0,0,0,0,0,0,0,0
20200520,708473,大田凱基98購01,0.20,0.20,0.20,0.20,+0.01,5.26,25000,1,5000,0,0,0,0,0,0,0,25000,-25000,-25000
20200520,708474,中美晶凱基97購02,,,,,,0.00,0,0,0,0,0,0,0,0,0,0,0,0,0
20200520,708475,宇峻凱基9A購01,,,,,,0.00,0,0,0,0,0,0,0,0,0,0,0,0,0
20200520,708476,網龍凱基98購01,1.27,1.27,1.27,1.27,-0.06,-4.51,10000,1,12700,0,0,0,0,0,0,10000,0,10000,10000
20200520,708477,鈊象凱基99購01,,,,,,0.00,0,0,0,0,0,0,0,0,0,0,0,0,0
20200520,708478,穩懋日盛97購02,,,,,,0.00,0,0,0,0,0,0,0,0,0,0,0,0,0
20200520,708479,立端永豐97購01,,,,,,0.00,0,0,0,0,0,0,0,0,0,0,0,0,0
20200520,708480,宇峻永豐97購01,,,,,,0.00,0,0,0,0,0,0,0,0,0,0,0,0,0
20200520,708481,迅得永豐97購03,,,,,,0.00,0,0,0,0,0,0,0,0,0,0,0,0,0
20200520,708482,神盾永豐97購01,,,,,,0.00,0,0,0,0,0,0,0,0,0,0,0,0,0
20200520,708483,璟德永豐97購02,,,,,,0.00,0,0,0,0,0,0,0,0,0,0,0,0,0
20200520,708484,璟德國泰98購01,,,,,,0.00,0,0,0,0,0,0,0,0,0,0,0,0,0
20200520,708485,六角國票97購01,,,,,,0.00,0,0,0,0,0,0,0,0,0,0,0,0,0
20200520,708487,信昌電國票98購01,,,,,,0.00,0,0,0,0,0,0,0,0,0,0,0,0,0
20200520,708488,威剛國票98購01,,,,,,0.00,0,0,0,0,0,0,0,0,0,0,0,0,0
20200520,708489,群聯國票98購01,0.06,0.06,0.06,0.06,-0.03,-33.33,1000,1,60,0,0,0,0,0,0,1000,0,1000,1000
20200520,708490,雍智國票98購01,0.88,1.08,0.82,0.92,+0.17,22.67,2135000,113,1913780,0,0,0,0,0,0,224000,1881000,-1657000,-1657000
20200520,708491,雙美國票99購01,,,,,,0.00,0,0,0,0,0,0,0,0,0,0,0,0,0
20200520,708492,雙鴻國票98購02,,,,,,0.00,0,0,0,0,0,0,0,0,0,0,0,0,0
20200520,708493,鈊象國票98購01,,,,,,0.00,0,0,0,0,0,0,0,0,0,0,0,0,0
20200520,708494,大江群益97購02,,,,,,0.00,0,0,0,0,0,0,0,0,0,0,0,0,0
20200520,708495,信昌電群益97購01,,,,,,0.00,0,0,0,0,0,0,0,0,0,0,0,0,0
20200520,708496,建榮群益99購01,,,,,,0.00,0,0,0,0,0,0,0,0,0,0,0,0,0
20200520,708497,原相群益99購01,0.80,0.80,0.80,0.80,-0.09,-10.11,38000,1,30400,0,0,0,0,0,0,38000,38000,0,0
20200520,708498,勝麗群益98購01,0.95,0.95,0.95,0.95,+0.04,4.4,71000,2,67450,0,0,0,0,0,0,10000,61000,-51000,-51000
20200520,708499,璟德群益98購01,0.26,0.26,0.26,0.26,+0.02,8.33,175000,1,45500,0,0,0,0,0,0,175000,0,175000,175000
20200520,708500,鈊象群益99購05,7.60,7.80,7.55,7.55,-0.10,-1.31,33000,6,251100,0,0,0,0,0,0,4000,33000,-29000,-29000
20200520,708501,力致元大97購01,,,,,,0.00,0,0,0,0,0,0,0,0,0,0,0,0,0
20200520,708502,中美晶元大97購04,,,,,,0.00,0,0,0,0,0,0,0,0,0,0,0,0,0
20200520,708503,世禾元大97購01,,,,,,0.00,0,0,0,0,0,0,0,0,0,0,0,0,0
20200520,708504,尼克森元大97購01,,,,,,0.00,0,0,0,0,0,0,0,0,0,0,0,0,0
20200520,708505,宇峻元大97購03,0.32,0.32,0.32,0.32,0.00,0.0,20000,2,6400,0,0,0,0,0,0,0,20000,-20000,-20000
20200520,708506,信昌電元大98購01,,,,,,0.00,0,0,0,0,0,0,0,0,0,0,0,0,0
20200520,708507,碩禾元大98購02,,,,,,0.00,0,0,0,0,0,0,0,0,0,0,0,0,0
20200520,708508,雙鴻元大99購02,,,,,,0.00,0,0,0,0,0,0,0,0,0,0,0,0,0
20200520,708509,尼克森統一99購01,,,,,,0.00,0,0,0,0,0,0,0,0,0,0,0,0,0
20200520,708510,尼克森統一99購02,,,,,,0.00,0,0,0,0,0,0,0,0,0,0,0,0,0
20200520,708511,迅得統一99購01,,,,,,0.00,0,0,0,0,0,0,0,0,0,0,0,0,0
20200520,708512,頎邦統一97購01,,,,,,0.00,0,0,0,0,0,0,0,0,0,0,0,0,0
20200520,708513,M31中信98購01,,,,,,0.00,0,0,0,0,0,0,0,0,0,0,0,0,0
20200520,708514,大中中信97購01,,,,,,0.00,0,0,0,0,0,0,0,0,0,0,0,0,0
20200520,708515,宇峻中信97購01,,,,,,0.00,0,0,0,0,0,0,0,0,0,0,0,0,0
20200520,708516,博智中信97購01,,,,,,0.00,0,0,0,0,0,0,0,0,0,0,0,0,0
20200520,708517,大中凱基98購02,,,,,,0.00,0,0,0,0,0,0,0,0,0,0,0,0,0
20200520,708518,同致凱基98購01,0.23,0.30,0.23,0.24,+0.05,26.32,52000,17,12640,0,0,0,0,0,0,27000,3000,24000,24000
20200520,708519,合晶凱基97購02,,,,,,0.00,0,0,0,0,0,0,0,0,0,0,0,0,0
20200520,708520,朋億凱基97購01,,,,,,0.00,0,0,0,0,0,0,0,0,0,0,0,0,0
20200520,708521,南光凱基97購01,0.69,0.71,0.67,0.67,+0.01,1.52,71000,6,49990,0,0,0,0,0,0,6000,65000,-59000,-59000
20200520,708522,緯軟凱基98購03,,,,,,0.00,0,0,0,0,0,0,0,0,0,0,0,0,0
20200520,708523,大江兆豐97購01,,,,,,0.00,0,0,0,0,0,0,0,0,0,0,0,0,0
20200520,708524,中美晶兆豐98購01,0.07,0.07,0.07,0.07,-0.01,-12.5,300000,3,21000,0,0,0,0,0,0,300000,300000,0,0
20200520,708525,台燿兆豐97購02,0.48,0.49,0.41,0.41,-0.15,-26.79,180000,21,82540,0,0,0,0,0,0,150000,30000,120000,120000
20200520,708526,精華兆豐98購01,0.90,0.90,0.90,0.90,+0.05,5.88,12000,1,10800,0,0,0,0,0,0,12000,0,12000,12000
20200520,708527,中美晶群益97購03,,,,,,0.00,0,0,0,0,0,0,0,0,0,0,0,0,0
20200520,708528,太景*群益98購01,0.43,0.54,0.43,0.43,-0.07,-14.0,122000,8,53880,0,0,0,0,0,0,85000,0,85000,85000
20200520,708529,立端群益97購01,,,,,,0.00,0,0,0,0,0,0,0,0,0,0,0,0,0
20200520,708530,朋億群益98購01,0.40,0.40,0.40,0.40,0.00,0.0,50000,1,20000,0,0,0,0,0,0,50000,0,50000,50000
20200520,708531,欣銓群益98購01,,,,,,0.00,0,0,0,0,0,0,0,0,0,0,0,0,0
20200520,708532,群聯群益97購02,,,,,,0.00,0,0,0,0,0,0,0,0,0,0,0,0,0
20200520,708533,緯軟群益98購01,,,,,,0.00,0,0,0,0,0,0,0,0,0,0,0,0,0
20200520,708534,環球晶群益97購03,,,,,,0.00,0,0,0,0,0,0,0,0,0,0,0,0,0
20200520,708535,譜瑞群益97購01,,,,,,0.00,0,0,0,0,0,0,0,0,0,0,0,0,0
20200520,708536,建榮國票98購02,,,,,,0.00,0,0,0,0,0,0,0,0,0,0,0,0,0
20200520,708537,力致國泰99購01,0.86,0.86,0.86,0.86,-0.09,-9.47,15000,1,12900,0,0,0,0,0,0,15000,0,15000,15000
20200520,708538,凡甲國泰99購01,1.70,1.73,1.67,1.72,-0.15,-8.02,139000,24,237500,0,0,0,0,0,0,89000,50000,39000,39000
20200520,708539,中菲行國泰98購01,,,,,,0.00,0,0,0,0,0,0,0,0,0,0,0,0,0
20200520,708540,世禾國泰98購01,0.50,0.52,0.50,0.52,+0.01,1.96,40000,3,20600,0,0,0,0,0,0,20000,20000,0,0
20200520,708541,尼克森國泰99購01,0.30,0.32,0.29,0.32,+0.11,52.38,151000,12,46010,0,0,0,0,0,0,40000,111000,-71000,-71000
20200520,708542,幃翔國泰98購01,0.14,0.15,0.14,0.15,+0.03,25.0,2000,2,290,0,0,0,0,0,0,2000,0,2000,2000
20200520,708543,幃翔國泰98購02,0.37,0.49,0.37,0.47,+0.11,30.56,554000,20,232460,0,0,0,0,0,0,111000,443000,-332000,-332000
20200520,708544,群聯國泰99購01,,,,,,0.00,0,0,0,0,0,0,0,0,0,0,0,0,0
20200520,708545,雙鴻國泰99購01,,,,,,0.00,0,0,0,0,0,0,0,0,0,0,0,0,0
20200520,708546,力致永豐97購01,0.41,0.41,0.41,0.41,-0.02,-4.65,5000,1,2050,0,0,0,0,0,0,5000,0,5000,5000
20200520,708547,世禾永豐97購01,,,,,,0.00,0,0,0,0,0,0,0,0,0,0,0,0,0
20200520,708548,尼克森永豐97購01,0.05,0.05,0.05,0.05,+0.02,66.67,70000,3,3500,0,0,0,0,0,0,50000,20000,30000,30000
20200520,708549,立敦永豐97購01,,,,,,0.00,0,0,0,0,0,0,0,0,0,0,0,0,0
20200520,708550,同亨永豐97購01,,,,,,0.00,0,0,0,0,0,0,0,0,0,0,0,0,0
20200520,708551,直得永豐97購01,,,,,,0.00,0,0,0,0,0,0,0,0,0,0,0,0,0
20200520,708552,南光永豐97購01,0.24,0.24,0.24,0.24,0.00,0.0,2000,1,480,0,0,0,0,0,0,2000,0,2000,2000
20200520,708553,威剛永豐98購01,,,,,,0.00,0,0,0,0,0,0,0,0,0,0,0,0,0
20200520,708554,幃翔永豐97購01,0.12,0.13,0.12,0.13,+0.03,30.0,4000,3,490,0,0,0,0,0,0,3000,1000,2000,2000
20200520,708555,新潤永豐97購01,,,,,,0.00,0,0,0,0,0,0,0,0,0,0,0,0,0
20200520,708556,網龍永豐97購01,0.12,0.12,0.12,0.12,-0.04,-25.0,60000,2,7200,0,0,0,0,0,0,0,0,0,0
20200520,708557,緯軟永豐97購01,,,,,,0.00,0,0,0,0,0,0,0,0,0,0,0,0,0
20200520,708558,環球晶永豐97購01,0.17,0.17,0.17,0.17,-0.03,-15.0,5000,1,850,0,0,0,0,0,0,5000,0,5000,5000
20200520,708559,聯上永豐97購01,,,,,,0.00,0,0,0,0,0,0,0,0,0,0,0,0,0
20200520,708560,大中康和97購01,,,,,,0.00,0,0,0,0,0,0,0,0,0,0,0,0,0
20200520,708561,亞泰康和97購01,,,,,,0.00,0,0,0,0,0,0,0,0,0,0,0,0,0
20200520,708562,博智康和97購01,,,,,,0.00,0,0,0,0,0,0,0,0,0,0,0,0,0
20200520,708563,力致元富97購01,0.43,0.43,0.43,0.43,0.00,0.0,80000,1,34400,0,0,0,0,0,0,80000,0,80000,80000
20200520,708564,中菲行元富97購01,,,,,,0.00,0,0,0,0,0,0,0,0,0,0,0,0,0
20200520,708565,太景*元富97購01,,,,,,0.00,0,0,0,0,0,0,0,0,0,0,0,0,0
20200520,708566,世禾元富97購01,,,,,,0.00,0,0,0,0,0,0,0,0,0,0,0,0,0
20200520,708567,尼克森元富97購01,,,,,,0.00,0,0,0,0,0,0,0,0,0,0,0,0,0
20200520,708568,幃翔元富97購01,,,,,,0.00,0,0,0,0,0,0,0,0,0,0,0,0,0
20200520,708569,力致統一97購01,,,,,,0.00,0,0,0,0,0,0,0,0,0,0,0,0,0
20200520,708570,力致統一97購02,0.79,0.79,0.79,0.79,+0.04,5.33,3000,1,2370,0,0,0,0,0,0,0,3000,-3000,-3000
20200520,708571,環球晶統一97購01,,,,,,0.00,0,0,0,0,0,0,0,0,0,0,0,0,0
20200520,708572,兆利凱基98購02,,,,,,0.00,0,0,0,0,0,0,0,0,0,0,0,0,0
20200520,708574,威剛凱基99購01,,,,,,0.00,0,0,0,0,0,0,0,0,0,0,0,0,0
20200520,708575,精測凱基98購01,,,,,,0.00,0,0,0,0,0,0,0,0,0,0,0,0,0
20200520,708576,聯亞凱基99購01,,,,,,0.00,0,0,0,0,0,0,0,0,0,0,0,0,0
20200520,708577,頎邦凱基97購03,,,,,,0.00,0,0,0,0,0,0,0,0,0,0,0,0,0
20200520,708578,中美晶麥證97購01,,,,,,0.00,0,0,0,0,0,0,0,0,0,0,0,0,0
20200520,708579,原相麥證97購01,,,,,,0.00,0,0,0,0,0,0,0,0,0,0,0,0,0
20200520,708580,神盾元富97購01,,,,,,0.00,0,0,0,0,0,0,0,0,0,0,0,0,0
20200520,708581,神盾元富97購02,,,,,,0.00,0,0,0,0,0,0,0,0,0,0,0,0,0
20200520,708582,宇峻元大97購04,,,,,,0.00,0,0,0,0,0,0,0,0,0,0,0,0,0
20200520,708583,亞泰元大97購01,,,,,,0.00,0,0,0,0,0,0,0,0,0,0,0,0,0
20200520,708584,威剛元大98購02,0.04,0.04,0.04,0.04,-0.01,-20.0,20000,1,800,0,0,0,0,0,0,20000,0,20000,20000
20200520,708585,建榮元大97購02,,,,,,0.00,0,0,0,0,0,0,0,0,0,0,0,0,0
20200520,708586,原相元大98購01,1.01,1.02,0.98,1.01,-0.06,-5.61,36000,5,36080,0,0,0,0,0,0,31000,11000,20000,20000
20200520,708587,原相元大99購01,1.10,1.10,1.10,1.10,-0.08,-6.78,16000,1,17600,0,0,0,0,0,0,16000,16000,0,0
20200520,708588,群聯元大98購01,,,,,,0.00,0,0,0,0,0,0,0,0,0,0,0,0,0
20200520,708589,聯亞元大98購01,,,,,,0.00,0,0,0,0,0,0,0,0,0,0,0,0,0
20200520,708590,雙美元大99購01,,,,,,0.00,0,0,0,0,0,0,0,0,0,0,0,0,0
20200520,708591,雙鴻元大99購03,0.28,0.28,0.28,0.28,-0.04,-12.5,13000,1,3640,0,0,0,0,0,0,13000,0,13000,13000
20200520,708592,穩懋元大97購03,,,,,,0.00,0,0,0,0,0,0,0,0,0,0,0,0,0
20200520,708593,穩懋元大97購04,,,,,,0.00,0,0,0,0,0,0,0,0,0,0,0,0,0
20200520,708594,鈊象元大99購01,,,,,,0.00,0,0,0,0,0,0,0,0,0,0,0,0,0
20200520,708595,大江兆豐97購02,0.18,0.18,0.18,0.18,-0.03,-14.29,50000,1,9000,0,0,0,0,0,0,0,50000,-50000,-50000
20200520,708596,群聯兆豐98購01,,,,,,0.00,0,0,0,0,0,0,0,0,0,0,0,0,0
20200520,708597,迅得康和97購01,,,,,,0.00,0,0,0,0,0,0,0,0,0,0,0,0,0
20200520,708598,六角群益98購02,,,,,,0.00,0,0,0,0,0,0,0,0,0,0,0,0,0
20200520,708599,亞泰群益97購01,,,,,,0.00,0,0,0,0,0,0,0,0,0,0,0,0,0
20200520,708600,台燿亞東97購01,,,,,,0.00,0,0,0,0,0,0,0,0,0,0,0,0,0
20200520,708601,光頡永豐97購01,,,,,,0.00,0,0,0,0,0,0,0,0,0,0,0,0,0
20200520,708602,亞泰永豐97購01,,,,,,0.00,0,0,0,0,0,0,0,0,0,0,0,0,0
20200520,708603,力致元富97購02,0.47,0.53,0.47,0.52,0.00,0.0,127000,5,64930,0,0,0,0,0,0,119000,8000,111000,111000
20200520,708604,鈺太元富97購01,,,,,,0.00,0,0,0,0,0,0,0,0,0,0,0,0,0
20200520,708605,久元台新97購01,1.46,1.46,1.46,1.46,+0.15,11.45,5000,1,7300,0,0,0,0,0,0,5000,0,5000,5000
20200520,708606,大中台新97購01,,,,,,0.00,0,0,0,0,0,0,0,0,0,0,0,0,0
20200520,708607,晶焱台新97購01,,,,,,0.00,0,0,0,0,0,0,0,0,0,0,0,0,0
20200520,708608,光頡統一97購01,,,,,,0.00,0,0,0,0,0,0,0,0,0,0,0,0,0
20200520,708609,光頡統一99購01,,,,,,0.00,0,0,0,0,0,0,0,0,0,0,0,0,0
20200520,708610,合晶統一97購01,0.93,0.93,0.91,0.91,+0.03,3.41,84000,3,77360,0,0,0,0,0,0,0,84000,-84000,-84000
20200520,708611,大中中信99購01,0.10,0.10,0.08,0.08,0.00,0.0,220000,7,19900,0,0,0,0,0,0,40000,130000,-90000,-90000
20200520,708612,亞泰中信97購01,,,,,,0.00,0,0,0,0,0,0,0,0,0,0,0,0,0
20200520,708613,博智中信99購01,,,,,,0.00,0,0,0,0,0,0,0,0,0,0,0,0,0
20200520,708614,緯軟中信97購01,,,,,,0.00,0,0,0,0,0,0,0,0,0,0,0,0,0
20200520,708615,台半凱基98購01,0.02,0.02,0.02,0.02,-0.05,-71.43,9000,1,180,0,0,0,0,0,0,9000,0,9000,9000
20200520,708616,兆利凱基98購03,,,,,,0.00,0,0,0,0,0,0,0,0,0,0,0,0,0
20200520,708617,宇峻凱基99購01,,,,,,0.00,0,0,0,0,0,0,0,0,0,0,0,0,0
20200520,708618,新普凱基98購01,,,,,,0.00,0,0,0,0,0,0,0,0,0,0,0,0,0
20200520,708619,璟德凱基98購01,,,,,,0.00,0,0,0,0,0,0,0,0,0,0,0,0,0
20200520,708620,環球晶凱基97購02,0.97,0.98,0.97,0.98,-0.05,-4.85,5000,2,4890,0,0,0,0,0,0,5000,5000,0,0
20200520,708621,頎邦第一97購01,,,,,,0.00,0,0,0,0,0,0,0,0,0,0,0,0,0
20200520,708622,光頡永豐97購02,,,,,,0.00,0,0,0,0,0,0,0,0,0,0,0,0,0
20200520,708623,建榮永豐98購01,,,,,,0.00,0,0,0,0,0,0,0,0,0,0,0,0,0
20200520,708624,雙美永豐98購01,,,,,,0.00,0,0,0,0,0,0,0,0,0,0,0,0,0
20200520,708625,雙鴻永豐98購01,,,,,,0.00,0,0,0,0,0,0,0,0,0,0,0,0,0
20200520,708626,亞泰國票97購01,,,,,,0.00,0,0,0,0,0,0,0,0,0,0,0,0,0
20200520,708627,新普國票98購01,,,,,,0.00,0,0,0,0,0,0,0,0,0,0,0,0,0
20200520,708628,廣明國票98購01,1.11,1.15,1.11,1.15,-0.02,-1.71,112000,3,126090,0,0,0,0,0,0,69000,48000,21000,21000
20200520,708629,璟德國票98購01,,,,,,0.00,0,0,0,0,0,0,0,0,0,0,0,0,0
20200520,708630,環宇國票98購01,0.19,0.19,0.19,0.19,+0.02,11.76,10000,1,1900,0,0,0,0,0,0,0,10000,-10000,-10000
20200520,708631,頎邦國票98購01,,,,,,0.00,0,0,0,0,0,0,0,0,0,0,0,0,0
20200520,708632,M31元大98購01,,,,,,0.00,0,0,0,0,0,0,0,0,0,0,0,0,0
20200520,708634,信昌電元大98購02,,,,,,0.00,0,0,0,0,0,0,0,0,0,0,0,0,0
20200520,708635,建榮元大97購03,,,,,,0.00,0,0,0,0,0,0,0,0,0,0,0,0,0
20200520,708636,原相元大98購02,0.77,0.77,0.74,0.74,-0.09,-10.84,59000,2,45130,0,0,0,0,0,0,59000,49000,10000,10000
20200520,708637,群聯元大98購02,,,,,,0.00,0,0,0,0,0,0,0,0,0,0,0,0,0
20200520,708638,精測元大97購04,,,,,,0.00,0,0,0,0,0,0,0,0,0,0,0,0,0
20200520,708639,網龍元大97購01,,,,,,0.00,0,0,0,0,0,0,0,0,0,0,0,0,0
20200520,708640,璟德元大97購03,,,,,,0.00,0,0,0,0,0,0,0,0,0,0,0,0,0
20200520,708641,鈊象元大98購02,,,,,,0.00,0,0,0,0,0,0,0,0,0,0,0,0,0
20200520,708642,頎邦元大97購03,,,,,,0.00,0,0,0,0,0,0,0,0,0,0,0,0,0
20200520,708643,頎邦元大97購04,,,,,,0.00,0,0,0,0,0,0,0,0,0,0,0,0,0
20200520,708644,雙美國泰99購01,,,,,,0.00,0,0,0,0,0,0,0,0,0,0,0,0,0
20200520,708645,聯亞兆豐98購01,,,,,,0.00,0,0,0,0,0,0,0,0,0,0,0,0,0
20200520,708646,櫃200兆豐97購01,,,,,,0.00,0,0,0,0,0,0,0,0,0,0,0,0,0
20200520,708647,泰博群益97購01,,,,,,0.00,0,0,0,0,0,0,0,0,0,0,0,0,0
20200520,708648,VHQ中信97購01,,,,,,0.00,0,0,0,0,0,0,0,0,0,0,0,0,0
20200520,708649,鈊象中信97購01,,,,,,0.00,0,0,0,0,0,0,0,0,0,0,0,0,0
20200520,708650,迅得麥證98購01,,,,,,0.00,0,0,0,0,0,0,0,0,0,0,0,0,0
20200520,708651,大學光元富99購01,,,,,,0.00,0,0,0,0,0,0,0,0,0,0,0,0,0
20200520,708652,光頡元富97購01,0.18,0.18,0.18,0.18,-0.09,-33.33,29000,1,5220,0,0,0,0,0,0,29000,0,29000,29000
20200520,708653,神盾元富97購03,,,,,,0.00,0,0,0,0,0,0,0,0,0,0,0,0,0
20200520,708654,力致統一97購03,,,,,,0.00,0,0,0,0,0,0,0,0,0,0,0,0,0
20200520,708655,波若威統一99購01,,,,,,0.00,0,0,0,0,0,0,0,0,0,0,0,0,0
20200520,708656,信昌電統一98購01,0.90,0.90,0.90,0.90,+0.03,3.45,147000,4,132300,0,0,0,0,0,0,147000,0,147000,147000
20200520,708657,兆利台新97購01,0.01,0.01,0.01,0.01,-0.03,-75.0,10000,1,100,0,0,0,0,0,0,0,10000,-10000,-10000
20200520,708658,神盾台新98購01,,,,,,0.00,0,0,0,0,0,0,0,0,0,0,0,0,0
20200520,708659,合晶凱基97購03,1.34,1.34,1.32,1.32,+0.04,3.12,12000,3,16040,0,0,0,0,0,0,2000,12000,-10000,-10000
20200520,708660,宇峻凱基99購02,,,,,,0.00,0,0,0,0,0,0,0,0,0,0,0,0,0
20200520,708661,良維凱基97購03,,,,,,0.00,0,0,0,0,0,0,0,0,0,0,0,0,0
20200520,708662,信昌電凱基98購02,0.80,0.80,0.80,0.80,+0.04,5.26,50000,1,40000,0,0,0,0,0,0,50000,0,50000,50000
20200520,708663,茂達凱基97購01,0.74,0.98,0.74,0.96,+0.43,81.13,95000,6,84600,0,0,0,0,0,0,45000,50000,-5000,-5000
20200520,708664,群聯凱基98購02,,,,,,0.00,0,0,0,0,0,0,0,0,0,0,0,0,0
20200520,708665,網家凱基97購01,2.17,2.67,2.17,2.56,+0.71,38.38,240000,33,563370,0,0,0,0,0,0,114000,126000,-12000,-12000
20200520,708666,聚積凱基97購01,,,,,,0.00,0,0,0,0,0,0,0,0,0,0,0,0,0
20200520,708667,廣明凱基98購02,,,,,,0.00,0,0,0,0,0,0,0,0,0,0,0,0,0
20200520,708668,優群凱基98購03,2.65,2.72,2.65,2.72,+0.16,6.25,19000,2,51050,0,0,0,0,0,0,0,19000,-19000,-19000
20200520,708669,聯亞凱基99購02,,,,,,0.00,0,0,0,0,0,0,0,0,0,0,0,0,0
20200520,708670,鈺太凱基98購01,,,,,,0.00,0,0,0,0,0,0,0,0,0,0,0,0,0
20200520,708671,頎邦凱基97購04,,,,,,0.00,0,0,0,0,0,0,0,0,0,0,0,0,0
20200520,708672,M31元大99購01,0.49,0.50,0.49,0.50,+0.06,13.64,53000,4,25980,0,0,0,0,0,0,53000,0,53000,53000
20200520,708673,凡甲元大98購02,1.90,1.90,1.88,1.88,-0.22,-10.48,15000,2,28400,0,0,0,0,0,0,10000,5000,5000,5000
20200520,708674,大宇資元大98購01,,,,,,0.00,0,0,0,0,0,0,0,0,0,0,0,0,0
20200520,708675,六角元大98購02,,,,,,0.00,0,0,0,0,0,0,0,0,0,0,0,0,0
20200520,708677,晶焱元大98購01,,,,,,0.00,0,0,0,0,0,0,0,0,0,0,0,0,0
20200520,708678,鈊象元大97購04,,,,,,0.00,0,0,0,0,0,0,0,0,0,0,0,0,0
20200520,708679,光頡國票98購01,,,,,,0.00,0,0,0,0,0,0,0,0,0,0,0,0,0
20200520,708680,金居國票98購01,,,,,,0.00,0,0,0,0,0,0,0,0,0,0,0,0,0
20200520,708681,建榮國票99購01,,,,,,0.00,0,0,0,0,0,0,0,0,0,0,0,0,0
20200520,708682,穩懋國票98購01,,,,,,0.00,0,0,0,0,0,0,0,0,0,0,0,0,0
20200520,708683,鈊象國票97購03,,,,,,0.00,0,0,0,0,0,0,0,0,0,0,0,0,0
20200520,708684,光頡國泰98購01,0.69,0.73,0.67,0.73,+0.06,8.96,80000,5,55600,0,0,0,0,0,0,40000,40000,0,0
20200520,708685,亞泰國泰98購01,,,,,,0.00,0,0,0,0,0,0,0,0,0,0,0,0,0
20200520,708686,世界兆豐97購01,0.41,0.41,0.41,0.41,0.00,0.0,30000,1,12300,0,0,0,0,0,0,0,30000,-30000,-30000
20200520,708687,同致兆豐98購01,0.30,0.40,0.30,0.34,-0.01,-2.86,901000,49,338300,0,0,0,0,0,0,641000,0,641000,641000
20200520,708688,宜鼎兆豐98購01,2.25,2.46,2.25,2.46,+0.15,6.49,293000,22,682480,0,0,0,0,0,0,116000,179000,-63000,-63000
20200520,708689,勝麗群益98購02,1.27,1.38,1.27,1.38,+0.11,8.66,40000,4,53200,0,0,0,0,0,0,0,40000,-40000,-40000
20200520,708690,晟德群益97購01,,,,,,0.00,0,0,0,0,0,0,0,0,0,0,0,0,0
20200520,708691,穩懋永豐97購02,0.67,0.67,0.67,0.67,-0.11,-14.1,50000,1,33500,0,0,0,0,0,0,50000,0,50000,50000
20200520,708692,元太亞東97購01,,,,,,0.00,0,0,0,0,0,0,0,0,0,0,0,0,0
20200520,708693,台半中信99購01,,,,,,0.00,0,0,0,0,0,0,0,0,0,0,0,0,0
20200520,708694,M31統一98購01,0.55,0.69,0.55,0.69,+0.09,15.0,277000,55,159310,0,0,0,0,0,0,262000,15000,247000,247000
20200520,708695,波若威統一97購01,0.36,0.39,0.34,0.34,+0.03,9.68,286000,11,104620,0,0,0,0,0,0,0,286000,-286000,-286000
20200520,708696,建榮統一9A購01,,,,,,0.00,0,0,0,0,0,0,0,0,0,0,0,0,0
20200520,708697,建榮統一9A購02,,,,,,0.00,0,0,0,0,0,0,0,0,0,0,0,0,0
20200520,708698,雙鴻統一97購02,0.52,0.53,0.52,0.53,0.00,0.0,3000,2,1580,0,0,0,0,0,0,0,3000,-3000,-3000
20200520,708699,雙鴻統一99購01,,,,,,0.00,0,0,0,0,0,0,0,0,0,0,0,0,0
20200520,708700,穩懋統一99購01,,,,,,0.00,0,0,0,0,0,0,0,0,0,0,0,0,0
20200520,708701,建榮凱基97購02,0.15,0.15,0.15,0.15,+0.01,7.14,40000,4,6000,0,0,0,0,0,0,0,40000,-40000,-40000
20200520,708702,原相凱基98購02,,,,,,0.00,0,0,0,0,0,0,0,0,0,0,0,0,0
20200520,708703,精測凱基97購04,,,,,,0.00,0,0,0,0,0,0,0,0,0,0,0,0,0
20200520,708704,環球晶凱基97購03,,,,,,0.00,0,0,0,0,0,0,0,0,0,0,0,0,0
20200520,708705,穩懋凱基97購01,,,,,,0.00,0,0,0,0,0,0,0,0,0,0,0,0,0
20200520,708706,鈺太凱基98購02,0.69,0.69,0.69,0.69,+0.10,16.95,52000,2,35880,0,0,0,0,0,0,3000,49000,-46000,-46000
20200520,708707,大江元大97購04,,,,,,0.00,0,0,0,0,0,0,0,0,0,0,0,0,0
20200520,708708,光頡元大98購01,,,,,,0.00,0,0,0,0,0,0,0,0,0,0,0,0,0
20200520,708709,新普元大97購02,1.80,1.84,1.71,1.71,-0.07,-3.93,139000,4,246580,0,0,0,0,0,0,53000,89000,-36000,-36000
20200520,708710,新普元大97購03,,,,,,0.00,0,0,0,0,0,0,0,0,0,0,0,0,0
20200520,708711,群聯元大97購05,0.03,0.03,0.03,0.03,-0.01,-25.0,10000,1,300,0,0,0,0,0,0,10000,0,10000,10000
20200520,708712,聯亞元大97購05,,,,,,0.00,0,0,0,0,0,0,0,0,0,0,0,0,0
20200520,708713,雙鴻元大99購04,0.52,0.52,0.52,0.52,-0.03,-5.45,10000,1,5200,0,0,0,0,0,0,10000,0,10000,10000
20200520,708714,聯亞元富97購01,0.48,0.48,0.48,0.48,-0.06,-11.11,3000,1,1440,0,0,0,0,0,0,0,3000,-3000,-3000
20200520,708715,台燿日盛97購01,,,,,,0.00,0,0,0,0,0,0,0,0,0,0,0,0,0
20200520,708716,建榮永豐97購02,,,,,,0.00,0,0,0,0,0,0,0,0,0,0,0,0,0
20200520,708717,閎康永豐97購01,0.86,0.89,0.83,0.89,-0.01,-1.11,325000,8,279620,0,0,0,0,0,0,267000,58000,209000,209000
20200520,708718,譜瑞永豐97購01,3.40,3.40,3.03,3.03,-0.26,-7.9,56000,9,184980,0,0,0,0,0,0,40000,16000,24000,24000
20200520,708719,鈊象永豐98購01,,,,,,0.00,0,0,0,0,0,0,0,0,0,0,0,0,0
20200520,708720,力致國票97購01,,,,,,0.00,0,0,0,0,0,0,0,0,0,0,0,0,0
20200520,708721,光頡國票98購02,,,,,,0.00,0,0,0,0,0,0,0,0,0,0,0,0,0
20200520,708722,金居國票98購02,,,,,,0.00,0,0,0,0,0,0,0,0,0,0,0,0,0
20200520,708723,威剛國票98購02,,,,,,0.00,0,0,0,0,0,0,0,0,0,0,0,0,0
20200520,708724,晶焱國票98購01,,,,,,0.00,0,0,0,0,0,0,0,0,0,0,0,0,0
20200520,708725,群聯國票98購02,0.10,0.10,0.10,0.10,-0.02,-16.67,18000,1,1800,0,0,0,0,0,0,18000,0,18000,18000
20200520,708726,廣明國票98購02,2.23,2.23,2.23,2.23,+0.07,3.24,13000,1,28990,0,0,0,0,0,0,0,13000,-13000,-13000
20200520,708727,光頡國泰99購01,,,,,,0.00,0,0,0,0,0,0,0,0,0,0,0,0,0
20200520,708728,原相國泰98購03,1.36,1.36,1.36,1.36,-1.07,-44.03,410000,1,557600,0,0,0,0,0,0,410000,410000,0,0
20200520,708729,大江富邦99購01,,,,,,0.00,0,0,0,0,0,0,0,0,0,0,0,0,0
20200520,708730,久元群益97購01,1.67,1.67,1.67,1.67,-0.21,-11.17,2000,1,3340,0,0,0,0,0,0,2000,0,2000,2000
20200520,708731,聚積群益97購02,,,,,,0.00,0,0,0,0,0,0,0,0,0,0,0,0,0
20200520,708732,頎邦群益98購02,,,,,,0.00,0,0,0,0,0,0,0,0,0,0,0,0,0
20200520,708733,M31凱基99購01,,,,,,0.00,0,0,0,0,0,0,0,0,0,0,0,0,0
20200520,708734,中美晶凱基97購04,,,,,,0.00,0,0,0,0,0,0,0,0,0,0,0,0,0
20200520,708735,昇達科凱基97購01,0.68,0.70,0.68,0.70,-0.05,-6.67,100000,5,69000,0,0,0,0,0,0,100000,100000,0,0
20200520,708736,聯亞凱基97購02,,,,,,0.00,0,0,0,0,0,0,0,0,0,0,0,0,0
20200520,708737,雙美凱基99購01,,,,,,0.00,0,0,0,0,0,0,0,0,0,0,0,0,0
20200520,708738,穩懋凱基97購02,1.14,1.18,1.14,1.18,-0.17,-12.59,9000,2,10420,0,0,0,0,0,0,4000,5000,-1000,-1000
20200520,708739,穩懋凱基97購03,,,,,,0.00,0,0,0,0,0,0,0,0,0,0,0,0,0
20200520,708740,譜瑞凱基97購01,,,,,,0.00,0,0,0,0,0,0,0,0,0,0,0,0,0
20200520,708741,鈊象凱基98購03,4.39,4.51,4.33,4.33,-0.08,-1.81,34000,9,149200,0,0,0,0,0,0,24000,16000,8000,8000
20200520,708742,新普麥證97購01,0.97,0.99,0.91,0.91,-0.04,-4.21,63000,5,59870,63000,0,63000,0,0,0,63000,0,63000,63000
20200520,708743,同致元富97購01,0.04,0.07,0.04,0.07,-0.06,-46.15,113000,2,4610,0,0,0,0,0,0,110000,0,110000,110000
20200520,708744,金居元富97購01,,,,,,0.00,0,0,0,0,0,0,0,0,0,0,0,0,0
20200520,708745,原相元富97購01,,,,,,0.00,0,0,0,0,0,0,0,0,0,0,0,0,0
20200520,708746,穩懋元富97購01,0.42,0.42,0.37,0.37,-0.11,-22.92,42000,5,16040,0,0,0,0,0,0,12000,30000,-18000,-18000
20200520,708747,立端亞東98購01,,,,,,0.00,0,0,0,0,0,0,0,0,0,0,0,0,0
20200520,708748,合晶永豐97購03,,,,,,0.00,0,0,0,0,0,0,0,0,0,0,0,0,0
20200520,708749,旺矽永豐97購03,0.25,0.25,0.25,0.25,+0.08,47.06,2000,1,500,0,0,0,0,0,0,2000,0,2000,2000
20200520,708750,信驊永豐97購01,1.89,1.89,1.51,1.51,-0.13,-7.93,181000,26,331530,0,0,0,0,0,0,50000,121000,-71000,-71000
20200520,708751,聯亞永豐97購01,,,,,,0.00,0,0,0,0,0,0,0,0,0,0,0,0,0
20200520,708752,原相統一97購01,0.96,0.97,0.94,0.94,-0.10,-9.62,284000,7,272530,0,0,0,0,0,0,284000,0,284000,284000
20200520,708753,廣明統一9A購01,1.12,1.13,1.10,1.13,-0.05,-4.24,538000,15,602830,0,0,0,0,0,0,314000,264000,50000,50000
20200520,708754,聯亞統一98購01,0.36,0.36,0.36,0.36,-0.03,-7.69,40000,1,14400,0,0,0,0,0,0,40000,0,40000,40000
20200520,708755,鈊象統一99購01,,,,,,0.00,0,0,0,0,0,0,0,0,0,0,0,0,0
20200520,708756,大中國票98購01,,,,,,0.00,0,0,0,0,0,0,0,0,0,0,0,0,0
20200520,708757,大江國票97購06,0.04,0.04,0.04,0.04,+0.01,33.33,30000,1,1200,0,0,0,0,0,0,0,0,0,0
20200520,708758,佳邦國票98購01,0.73,0.78,0.73,0.78,+0.02,2.63,94000,3,71710,0,0,0,0,0,0,39000,55000,-16000,-16000
20200520,708759,宜鼎國票97購04,,,,,,0.00,0,0,0,0,0,0,0,0,0,0,0,0,0
20200520,708760,信昌電國票98購02,,,,,,0.00,0,0,0,0,0,0,0,0,0,0,0,0,0
20200520,708761,宣德國票98購01,,,,,,0.00,0,0,0,0,0,0,0,0,0,0,0,0,0
20200520,708762,神盾國票98購02,0.32,0.32,0.26,0.27,-0.05,-15.62,904000,15,254790,0,0,0,0,0,0,705000,199000,506000,506000
20200520,708763,群聯國票98購03,,,,,,0.00,0,0,0,0,0,0,0,0,0,0,0,0,0
20200520,708764,緯軟國票98購01,,,,,,0.00,0,0,0,0,0,0,0,0,0,0,0,0,0
20200520,708765,威剛國泰98購03,0.04,0.04,0.04,0.04,-0.08,-66.67,30000,1,1200,0,0,0,0,0,0,30000,0,30000,30000
20200520,708766,廣明國泰98購01,1.56,1.62,1.54,1.62,-0.12,-6.9,285000,11,445170,0,0,0,0,0,0,254000,31000,223000,223000
20200520,708767,穩懋富邦99購01,0.50,0.82,0.46,0.46,-0.41,-47.13,27000,5,13690,0,0,0,0,0,0,0,25000,-25000,-25000
20200520,708768,六角元大97購01,,,,,,0.00,0,0,0,0,0,0,0,0,0,0,0,0,0
20200520,708769,合晶元大98購03,1.89,1.89,1.81,1.89,+0.09,5.0,354000,19,658820,0,0,0,0,0,0,137000,219000,-82000,-82000
20200520,708770,泰博元大97購01,,,,,,0.00,0,0,0,0,0,0,0,0,0,0,0,0,0
20200520,708771,精測元大97購05,,,,,,0.00,0,0,0,0,0,0,0,0,0,0,0,0,0
20200520,708772,聚積元大98購01,,,,,,0.00,0,0,0,0,0,0,0,0,0,0,0,0,0
20200520,708773,廣明元大97購02,0.85,0.89,0.83,0.89,+0.04,4.71,186000,5,158940,0,0,0,0,0,0,80000,106000,-26000,-26000
20200520,708774,璟德元大97購04,0.43,0.43,0.43,0.43,+0.02,4.88,5000,1,2150,0,0,0,0,0,0,0,5000,-5000,-5000
20200520,708775,穩懋元大97購07,,,,,,0.00,0,0,0,0,0,0,0,0,0,0,0,0,0
20200520,708776,穩懋元大98購01,0.63,0.63,0.50,0.50,-0.16,-24.24,65000,6,32920,0,0,0,0,0,0,0,4000,-4000,-4000
20200520,708777,旺矽兆豐98購01,,,,,,0.00,0,0,0,0,0,0,0,0,0,0,0,0,0
20200520,708778,環球晶兆豐98購01,,,,,,0.00,0,0,0,0,0,0,0,0,0,0,0,0,0
20200520,708779,雙鴻兆豐98購01,,,,,,0.00,0,0,0,0,0,0,0,0,0,0,0,0,0
20200520,708780,穩懋兆豐97購03,0.09,0.09,0.09,0.09,-0.04,-30.77,50000,1,4500,0,0,0,0,0,0,50000,0,50000,50000
20200520,708781,信驊群益97購01,7.10,7.10,6.45,6.45,-0.45,-6.52,11000,2,77450,0,0,0,0,0,0,11000,0,11000,11000
20200520,708782,建榮群益98購01,0.15,0.15,0.15,0.15,-0.01,-6.25,50000,1,7500,0,0,0,0,0,0,50000,50000,0,0
20200520,708783,優群群益99購01,4.43,4.43,4.43,4.43,-0.01,-0.23,4000,1,17720,0,0,0,0,0,0,4000,0,4000,4000
20200520,708784,環宇群益97購02,,,,,,0.00,0,0,0,0,0,0,0,0,0,0,0,0,0
20200520,708785,信驊中信9B購01,1.48,1.48,1.21,1.22,-0.12,-8.96,682000,73,963420,0,0,0,0,0,0,380000,200000,180000,180000
20200520,708786,中美晶凱基97購05,,,,,,0.00,0,0,0,0,0,0,0,0,0,0,0,0,0
20200520,708787,同致凱基98購02,,,,,,0.00,0,0,0,0,0,0,0,0,0,0,0,0,0
20200520,708788,泰博凱基99購01,,,,,,0.00,0,0,0,0,0,0,0,0,0,0,0,0,0
20200520,708789,群聯凱基97購01,0.57,0.57,0.57,0.57,-0.01,-1.72,1000,1,570,0,0,0,0,0,0,0,1000,-1000,-1000
20200520,708790,優群凱基98購04,4.25,4.29,4.17,4.17,+0.14,3.47,30000,4,127100,0,0,0,0,0,0,0,30000,-30000,-30000
20200520,708791,雙美凱基99購02,,,,,,0.00,0,0,0,0,0,0,0,0,0,0,0,0,0
20200520,708792,凡甲國票98購01,1.44,1.44,1.36,1.37,-0.18,-11.61,23000,6,31710,0,0,0,0,0,0,3000,20000,-17000,-17000
20200520,708793,迅得國票98購01,,,,,,0.00,0,0,0,0,0,0,0,0,0,0,0,0,0
20200520,708794,旺矽國票98購01,,,,,,0.00,0,0,0,0,0,0,0,0,0,0,0,0,0
20200520,708795,原相國票98購03,2.13,2.13,2.07,2.07,-0.14,-6.33,57000,4,120820,0,0,0,0,0,0,52000,5000,47000,47000
20200520,708796,兆利群益97購01,,,,,,0.00,0,0,0,0,0,0,0,0,0,0,0,0,0
20200520,708797,金居群益99購01,1.08,1.10,1.06,1.08,-0.06,-5.26,852000,12,915200,0,0,0,0,0,0,832000,15000,817000,817000
20200520,708798,晶焱群益99購01,0.29,0.29,0.29,0.29,-0.01,-3.33,20000,1,5800,0,0,0,0,0,0,20000,20000,0,0
20200520,708799,閎康群益97購02,0.67,0.72,0.66,0.72,+0.05,7.46,408000,7,277640,0,0,0,0,0,0,20000,388000,-368000,-368000
20200520,708800,凡甲元富99購01,1.23,1.29,1.16,1.18,-0.03,-2.48,616000,52,766190,0,0,0,0,0,0,450000,126000,324000,324000
20200520,708801,六角元富97購01,0.57,0.57,0.55,0.55,-0.01,-1.79,60000,6,33300,0,0,0,0,0,0,10000,50000,-40000,-40000
20200520,708802,欣銓元富97購01,,,,,,0.00,0,0,0,0,0,0,0,0,0,0,0,0,0
20200520,708803,晶焱元富99購01,0.42,0.44,0.42,0.44,+0.01,2.33,64000,3,27280,0,0,0,0,0,0,64000,20000,44000,44000
20200520,708804,廣明元富99購01,1.25,1.28,1.23,1.28,-0.10,-7.25,735000,26,922200,0,0,0,0,0,0,487000,248000,239000,239000
20200520,708805,環球晶元富98購01,,,,,,0.00,0,0,0,0,0,0,0,0,0,0,0,0,0
20200520,708806,環球晶元富99購01,0.50,0.50,0.49,0.49,-0.04,-7.55,620000,9,308000,0,0,0,0,0,0,620000,600000,20000,20000
20200520,708807,雙美元富97購01,0.35,0.37,0.33,0.34,-0.01,-2.86,587000,9,206100,0,0,0,0,0,0,200000,387000,-187000,-187000
20200520,708808,雙鴻元富97購01,0.60,0.60,0.58,0.58,-0.02,-3.33,90000,2,53800,0,0,0,0,0,0,80000,10000,70000,70000
20200520,708809,穩懋元富97購02,0.43,0.43,0.43,0.43,-0.10,-18.87,10000,1,4300,0,0,0,0,0,0,0,10000,-10000,-10000
20200520,708810,鈊象元富97購01,,,,,,0.00,0,0,0,0,0,0,0,0,0,0,0,0,0
20200520,708811,雙鴻國泰98購01,,,,,,0.00,0,0,0,0,0,0,0,0,0,0,0,0,0
20200520,708812,精測台新98購01,,,,,,0.00,0,0,0,0,0,0,0,0,0,0,0,0,0
20200520,708813,宇峻元大98購01,0.12,0.12,0.12,0.12,-0.03,-20.0,10000,1,1200,0,0,0,0,0,0,10000,0,10000,10000
20200520,708814,建榮元大97購04,,,,,,0.00,0,0,0,0,0,0,0,0,0,0,0,0,0
20200520,708815,泰博元大97購02,,,,,,0.00,0,0,0,0,0,0,0,0,0,0,0,0,0
20200520,708816,聯亞元大97購06,0.75,0.75,0.75,0.75,0.00,0.0,68000,1,51000,0,0,0,0,0,0,0,68000,-68000,-68000
20200520,708817,譜瑞元大98購01,,,,,,0.00,0,0,0,0,0,0,0,0,0,0,0,0,0
20200520,708818,鈊象元大98購03,,,,,,0.00,0,0,0,0,0,0,0,0,0,0,0,0,0
20200520,708819,合晶永豐97購04,0.54,0.56,0.51,0.54,+0.08,17.39,61000,8,32940,0,0,0,0,0,0,4000,57000,-53000,-53000
20200520,708820,威剛永豐99購01,,,,,,0.00,0,0,0,0,0,0,0,0,0,0,0,0,0
20200520,708821,原相永豐97購02,0.09,0.09,0.09,0.09,-0.01,-10.0,3000,1,270,0,0,0,0,0,0,3000,0,3000,3000
20200520,708822,泰博永豐97購01,5.30,5.30,5.30,5.30,-0.65,-10.92,5000,1,26500,0,0,0,0,0,0,5000,0,5000,5000
20200520,708823,勝麗永豐97購01,,,,,,0.00,0,0,0,0,0,0,0,0,0,0,0,0,0
20200520,708824,廣明永豐97購03,0.95,0.95,0.95,0.95,-0.10,-9.52,77000,2,73150,0,0,0,0,0,0,77000,0,77000,77000
20200520,708825,碩禾中信9A購01,0.03,0.04,0.03,0.04,0.00,0.0,371000,43,11240,0,0,0,0,0,0,0,371000,-371000,-371000
20200520,708826,威剛統一9A購01,,,,,,0.00,0,0,0,0,0,0,0,0,0,0,0,0,0
20200520,708827,群聯統一97購02,,,,,,0.00,0,0,0,0,0,0,0,0,0,0,0,0,0
20200520,708828,六角凱基99購01,,,,,,0.00,0,0,0,0,0,0,0,0,0,0,0,0,0
20200520,708829,宜鼎凱基98購01,0.64,0.64,0.64,0.64,+0.07,12.28,5000,1,3200,0,0,0,0,0,0,0,0,0,0
20200520,708830,信昌電凱基97購03,,,,,,0.00,0,0,0,0,0,0,0,0,0,0,0,0,0
20200520,708831,廣明凱基99購01,1.62,1.66,1.61,1.62,-0.13,-7.43,35000,5,57010,0,0,0,0,0,0,35000,1000,34000,34000
20200520,708832,群聯台新97購04,,,,,,0.00,0,0,0,0,0,0,0,0,0,0,0,0,0
20200520,708833,中美晶元大97購05,1.53,1.54,1.44,1.45,-0.13,-8.23,356000,16,528920,0,0,0,0,0,0,266000,91000,175000,175000
20200520,708834,中美晶元大97購06,1.64,1.64,1.64,1.64,-0.11,-6.29,115000,2,188600,0,0,0,0,0,0,21000,94000,-73000,-73000
20200520,708836,宣德元大97購02,,,,,,0.00,0,0,0,0,0,0,0,0,0,0,0,0,0
20200520,708837,新普元大97購04,,,,,,0.00,0,0,0,0,0,0,0,0,0,0,0,0,0
20200520,708838,新普元大97購05,2.20,2.26,2.09,2.09,-0.31,-12.92,57000,4,124720,0,0,0,0,0,0,41000,15000,26000,26000
20200520,708839,群聯元大97購06,,,,,,0.00,0,0,0,0,0,0,0,0,0,0,0,0,0
20200520,708840,雍智元大99購01,0.93,1.00,0.93,1.00,+0.19,23.46,25000,3,24650,0,0,0,0,0,0,24000,0,24000,24000
20200520,708841,網龍元大98購01,,,,,,0.00,0,0,0,0,0,0,0,0,0,0,0,0,0
20200520,708842,環球晶元大97購04,2.33,2.33,2.28,2.28,-0.04,-1.72,59000,2,137020,0,0,0,0,0,0,9000,59000,-50000,-50000
20200520,708843,環球晶元大97購05,2.40,2.40,2.34,2.34,-0.04,-1.68,48000,3,114840,0,0,0,0,0,0,7000,48000,-41000,-41000
20200520,708844,聯亞元大97購07,,,,,,0.00,0,0,0,0,0,0,0,0,0,0,0,0,0
20200520,708845,雙鴻元大97購03,,,,,,0.00,0,0,0,0,0,0,0,0,0,0,0,0,0
20200520,708846,鈊象元大98購04,1.15,1.15,1.11,1.11,-0.16,-12.6,18000,5,20420,0,0,0,0,0,0,8000,0,8000,8000
20200520,708847,群聯第一97購01,,,,,,0.00,0,0,0,0,0,0,0,0,0,0,0,0,0
20200520,708848,中美晶永豐97購01,,,,,,0.00,0,0,0,0,0,0,0,0,0,0,0,0,0
20200520,708849,胡連永豐97購01,0.32,0.32,0.32,0.32,+0.05,18.52,20000,2,6400,0,0,0,0,0,0,0,20000,-20000,-20000
20200520,708850,閎康永豐97購02,0.53,0.53,0.52,0.52,-0.05,-8.77,68000,3,35960,0,0,0,0,0,0,68000,0,68000,68000
20200520,708851,精測永豐97購02,,,,,,0.00,0,0,0,0,0,0,0,0,0,0,0,0,0
20200520,708852,鈊象永豐97購02,0.77,0.77,0.71,0.71,-0.08,-10.13,64000,8,46720,0,0,0,0,0,0,2000,62000,-60000,-60000
20200520,708853,世界群益98購04,0.13,0.13,0.11,0.11,-0.01,-8.33,498000,3,58760,0,0,0,0,0,0,299000,199000,100000,100000
20200520,708854,晶焱群益99購02,0.40,0.40,0.40,0.40,0.00,0.0,20000,1,8000,0,0,0,0,0,0,20000,20000,0,0
20200520,708855,大江元富97購01,0.99,0.99,0.88,0.88,-0.09,-9.28,177000,11,164030,0,0,0,0,0,0,107000,70000,37000,37000
20200520,708856,台燿元富97購01,1.16,1.16,0.94,0.94,-0.12,-11.32,369000,28,391390,0,0,0,0,0,0,255000,74000,181000,181000
20200520,708857,宜鼎元富97購01,1.05,1.05,1.05,1.05,-0.02,-1.87,20000,2,21000,0,0,0,0,0,0,0,20000,-20000,-20000
20200520,708858,昇達科元富97購01,,,,,,0.00,0,0,0,0,0,0,0,0,0,0,0,0,0
20200520,708859,信驊元富97購01,5.20,5.45,4.30,4.30,-0.62,-12.6,356000,37,1820790,0,0,0,0,0,0,248000,91000,157000,157000
20200520,708860,威剛元富97購02,,,,,,0.00,0,0,0,0,0,0,0,0,0,0,0,0,0
20200520,708861,新普元富97購01,1.33,1.33,1.33,1.33,-0.18,-11.92,10000,1,13300,0,0,0,0,0,0,10000,0,10000,10000
20200520,708862,網家元富97購01,1.17,1.52,1.17,1.44,+0.50,53.19,52000,6,74940,0,0,0,0,0,0,2000,50000,-48000,-48000
20200520,708863,聚積元富97購01,,,,,,0.00,0,0,0,0,0,0,0,0,0,0,0,0,0
20200520,708864,穩懋元富97購03,,,,,,0.00,0,0,0,0,0,0,0,0,0,0,0,0,0
20200520,708865,直得國票97購01,0.20,0.23,0.20,0.23,+0.04,21.05,100000,2,20600,0,0,0,0,0,0,80000,20000,60000,60000
20200520,708866,原相國泰98購04,1.90,1.90,1.81,1.81,-0.11,-5.73,100000,3,187300,0,0,0,0,0,0,70000,30000,40000,40000
20200520,708867,鈊象國泰99購01,,,,,,0.00,0,0,0,0,0,0,0,0,0,0,0,0,0
20200520,708868,鈊象中信99購01,,,,,,0.00,0,0,0,0,0,0,0,0,0,0,0,0,0
20200520,708869,凡甲凱基98購01,1.10,1.14,1.10,1.10,-0.03,-2.65,206000,22,231430,0,0,0,0,0,0,161000,45000,116000,116000
20200520,708870,大江凱基98購03,0.10,0.10,0.10,0.10,-0.01,-9.09,199000,2,19900,0,0,0,0,0,0,0,0,0,0
20200520,708871,信驊凱基98購01,3.46,3.47,3.46,3.47,+0.07,2.06,32000,6,110940,0,0,0,0,0,0,12000,20000,-8000,-8000
20200520,708872,新鉅科凱基97購01,,,,,,0.00,0,0,0,0,0,0,0,0,0,0,0,0,0
20200520,708873,精測凱基98購02,,,,,,0.00,0,0,0,0,0,0,0,0,0,0,0,0,0
20200520,708874,群聯統一97購03,0.75,0.75,0.75,0.75,0.00,0.0,41000,1,30750,0,0,0,0,0,0,41000,0,41000,41000
20200520,708875,譜瑞統一97購01,,,,,,0.00,0,0,0,0,0,0,0,0,0,0,0,0,0
20200520,708876,信昌電兆豐98購01,,,,,,0.00,0,0,0,0,0,0,0,0,0,0,0,0,0
20200520,708877,胡連康和97購01,0.54,0.55,0.54,0.55,+0.06,12.24,36000,2,19670,0,0,0,0,0,0,0,36000,-36000,-36000
20200520,708878,台燿群益97購01,0.84,0.84,0.69,0.69,-0.09,-11.54,225000,21,168860,0,0,0,0,0,0,107000,88000,19000,19000
20200520,708879,博智群益97購01,,,,,,0.00,0,0,0,0,0,0,0,0,0,0,0,0,0
20200520,708880,雙鴻群益99購01,,,,,,0.00,0,0,0,0,0,0,0,0,0,0,0,0,0
20200520,708881,金居國泰99購01,1.03,1.28,0.93,0.93,-0.10,-9.71,91000,10,92980,0,0,0,0,0,0,0,90000,-90000,-90000
20200520,708882,威剛元富97購04,,,,,,0.00,0,0,0,0,0,0,0,0,0,0,0,0,0
20200520,708883,原相元富97購02,0.16,0.16,0.14,0.14,-0.04,-22.22,160000,3,22600,0,0,0,0,0,0,150000,160000,-10000,-10000
20200520,708884,聯亞元富97購03,,,,,,0.00,0,0,0,0,0,0,0,0,0,0,0,0,0
20200520,708885,穩懋元富97購04,0.56,0.56,0.50,0.51,-0.13,-20.31,127000,8,67900,0,0,0,0,0,0,75000,52000,23000,23000
20200520,708886,鈊象元富97購02,,,,,,0.00,0,0,0,0,0,0,0,0,0,0,0,0,0
20200520,708887,鈊象台新97購02,,,,,,0.00,0,0,0,0,0,0,0,0,0,0,0,0,0
20200520,708888,中美晶元大97購07,1.24,1.24,1.21,1.24,-0.09,-6.77,156000,8,191940,0,0,0,0,0,0,156000,0,156000,156000
20200520,708889,台燿元大97購01,0.98,0.98,0.87,0.87,-0.13,-13.0,200000,11,181600,0,0,0,0,0,0,100000,100000,0,0
20200520,708890,宜鼎元大97購02,1.16,1.28,1.16,1.28,+0.10,8.47,645000,24,786820,0,0,0,0,0,0,277000,466000,-189000,-189000
20200520,708891,金居元大99購01,0.70,0.71,0.68,0.69,-0.06,-8.0,163000,7,113100,0,0,0,0,0,0,103000,60000,43000,43000
20200520,708892,胡連元大97購01,0.36,0.39,0.36,0.39,+0.11,39.29,565000,7,210900,0,0,0,0,0,0,215000,350000,-135000,-135000
20200520,708893,泰博元大97購03,,,,,,0.00,0,0,0,0,0,0,0,0,0,0,0,0,0
20200520,708894,閎康元大97購01,0.69,0.78,0.69,0.77,+0.02,2.67,468000,10,336170,0,0,0,0,0,0,246000,381000,-135000,-135000
20200520,708895,環球晶元大97購06,,,,,,0.00,0,0,0,0,0,0,0,0,0,0,0,0,0
20200520,708896,環球晶元大97購07,,,,,,0.00,0,0,0,0,0,0,0,0,0,0,0,0,0
20200520,708897,櫃200元大99購03,,,,,,0.00,0,0,0,0,0,0,0,0,0,0,0,0,0
20200520,708898,櫃200元大99購04,,,,,,0.00,0,0,0,0,0,0,0,0,0,0,0,0,0
20200520,708899,頎邦元大97購05,0.87,0.87,0.85,0.87,-0.05,-5.43,136000,5,117340,0,0,0,0,0,0,68000,68000,0,0
20200520,708900,中美晶元大97購08,1.33,1.35,1.29,1.29,-0.12,-8.51,18000,3,23820,0,0,0,0,0,0,6000,12000,-6000,-6000
20200520,708901,台燿元大97購02,1.06,1.06,0.93,0.93,-0.12,-11.43,220000,5,225200,0,0,0,0,0,0,0,220000,-220000,-220000
20200520,708902,迅得元大99購01,0.30,0.31,0.30,0.31,+0.03,10.71,80000,2,24400,0,0,0,0,0,0,0,80000,-80000,-80000
20200520,708903,宜鼎元大97購03,,,,,,0.00,0,0,0,0,0,0,0,0,0,0,0,0,0
20200520,708904,旺矽元大98購01,,,,,,0.00,0,0,0,0,0,0,0,0,0,0,0,0,0
20200520,708905,威剛元大97購01,,,,,,0.00,0,0,0,0,0,0,0,0,0,0,0,0,0
20200520,708906,泰博元大97購04,,,,,,0.00,0,0,0,0,0,0,0,0,0,0,0,0,0
20200520,708907,精測元大97購06,0.27,0.28,0.26,0.28,-0.03,-9.68,390000,4,102900,0,0,0,0,0,0,30000,360000,-330000,-330000
20200520,708908,廣明元大97購03,1.62,1.65,1.59,1.65,-0.16,-8.84,145000,9,233450,0,0,0,0,0,0,140000,0,140000,140000
20200520,708909,優群元大99購01,,,,,,0.00,0,0,0,0,0,0,0,0,0,0,0,0,0
20200520,708910,環球晶元大97購08,1.47,1.47,1.42,1.42,-0.04,-2.74,75000,4,109950,0,0,0,0,0,0,7000,75000,-68000,-68000
20200520,708911,環球晶元大97購09,0.86,0.86,0.79,0.79,-0.07,-8.14,53000,4,44730,0,0,0,0,0,0,5000,53000,-48000,-48000
20200520,708912,世界麥證97購02,,,,,,0.00,0,0,0,0,0,0,0,0,0,0,0,0,0
20200520,708913,大江永豐97購03,0.55,0.55,0.55,0.55,-0.02,-3.51,10000,1,5500,0,0,0,0,0,0,0,10000,-10000,-10000
20200520,708914,旺矽永豐97購04,0.44,0.44,0.44,0.44,+0.08,22.22,30000,1,13200,0,0,0,0,0,0,30000,0,30000,30000
20200520,708915,新普永豐97購01,0.58,0.58,0.58,0.58,-0.04,-6.45,2000,1,1160,0,0,0,0,0,0,2000,2000,0,0
20200520,708916,精華永豐97購01,,,,,,0.00,0,0,0,0,0,0,0,0,0,0,0,0,0
20200520,708917,原相兆豐98購01,,,,,,0.00,0,0,0,0,0,0,0,0,0,0,0,0,0
20200520,708918,群聯台新97購05,,,,,,0.00,0,0,0,0,0,0,0,0,0,0,0,0,0
20200520,708919,中美晶群益97購04,,,,,,0.00,0,0,0,0,0,0,0,0,0,0,0,0,0
20200520,708920,同致群益97購01,,,,,,0.00,0,0,0,0,0,0,0,0,0,0,0,0,0
20200520,708921,勝麗群益97購01,0.88,0.96,0.88,0.92,+0.05,5.75,110000,6,102480,0,0,0,0,0,0,12000,98000,-86000,-86000
20200520,708922,緯軟群益98購02,,,,,,0.00,0,0,0,0,0,0,0,0,0,0,0,0,0
20200520,708923,鈊象群益97購01,,,,,,0.00,0,0,0,0,0,0,0,0,0,0,0,0,0
20200520,708924,穩懋永昌9C購01,2.70,2.70,2.70,2.70,-0.18,-6.25,10000,1,27000,0,0,0,0,0,0,0,10000,-10000,-10000
20200520,708925,世界統一97購02,,,,,,0.00,0,0,0,0,0,0,0,0,0,0,0,0,0
20200520,708926,胡連統一98購01,,,,,,0.00,0,0,0,0,0,0,0,0,0,0,0,0,0
20200520,708927,胡連統一99購01,,,,,,0.00,0,0,0,0,0,0,0,0,0,0,0,0,0
20200520,708928,環球晶統一97購02,0.78,0.78,0.78,0.78,-0.03,-3.7,48000,1,37440,0,0,0,0,0,0,0,48000,-48000,-48000
20200520,708929,雍智中信97購01,0.57,0.68,0.54,0.60,+0.11,22.45,1419000,62,839060,0,0,0,0,0,0,483000,894000,-411000,-411000
20200520,708930,聚積中信97購01,,,,,,0.00,0,0,0,0,0,0,0,0,0,0,0,0,0
20200520,708931,VHQ凱基97購01,,,,,,0.00,0,0,0,0,0,0,0,0,0,0,0,0,0
20200520,708932,VHQ凱基98購01,,,,,,0.00,0,0,0,0,0,0,0,0,0,0,0,0,0
20200520,708933,神盾凱基98購02,,,,,,0.00,0,0,0,0,0,0,0,0,0,0,0,0,0
20200520,708934,晶焱凱基98購02,,,,,,0.00,0,0,0,0,0,0,0,0,0,0,0,0,0
20200520,708935,環球晶凱基97購04,,,,,,0.00,0,0,0,0,0,0,0,0,0,0,0,0,0
20200520,708936,環球晶凱基97購05,,,,,,0.00,0,0,0,0,0,0,0,0,0,0,0,0,0
20200520,708937,雙鴻富邦98購01,,,,,,0.00,0,0,0,0,0,0,0,0,0,0,0,0,0
20200520,708938,大宇資國票98購01,,,,,,0.00,0,0,0,0,0,0,0,0,0,0,0,0,0
20200520,708939,金居國票98購03,2.39,2.42,2.34,2.34,-0.07,-2.9,52000,5,124540,0,0,0,0,0,0,0,52000,-52000,-52000
20200520,708940,碩禾國票98購01,,,,,,0.00,0,0,0,0,0,0,0,0,0,0,0,0,0
20200520,708941,M31元富97購01,0.59,0.66,0.58,0.58,+0.05,9.43,365000,15,228580,0,0,0,0,0,0,140000,145000,-5000,-5000
20200520,708942,金居第一97購01,,,,,,0.00,0,0,0,0,0,0,0,0,0,0,0,0,0
20200520,708943,M31元富97購02,0.61,0.65,0.61,0.62,+0.06,10.71,387000,12,242460,0,0,0,0,0,0,260000,127000,133000,133000
20200520,708944,閎康元富97購01,,,,,,0.00,0,0,0,0,0,0,0,0,0,0,0,0,0
20200520,708945,大田永豐97購01,0.46,0.50,0.46,0.48,0.00,0.0,178000,10,85680,0,0,0,0,0,0,163000,15000,148000,148000
20200520,708946,六角永豐97購02,,,,,,0.00,0,0,0,0,0,0,0,0,0,0,0,0,0
20200520,708947,群聯永豐97購01,,,,,,0.00,0,0,0,0,0,0,0,0,0,0,0,0,0
20200520,708948,雙鴻永豐97購04,,,,,,0.00,0,0,0,0,0,0,0,0,0,0,0,0,0
20200520,708949,旺矽康和97購02,0.90,0.96,0.90,0.96,+0.08,9.09,52000,3,47580,0,0,0,0,0,0,0,52000,-52000,-52000
20200520,708950,威剛康和97購02,,,,,,0.00,0,0,0,0,0,0,0,0,0,0,0,0,0
20200520,708951,合晶群益99購01,2.12,2.14,2.10,2.11,+0.07,3.43,257000,5,543380,0,0,0,0,0,0,1000,257000,-256000,-256000
20200520,708952,迅得群益98購01,,,,,,0.00,0,0,0,0,0,0,0,0,0,0,0,0,0
20200520,708953,宜鼎群益97購02,,,,,,0.00,0,0,0,0,0,0,0,0,0,0,0,0,0
20200520,708954,胡連群益97購01,0.50,0.50,0.47,0.47,+0.10,27.03,135000,4,65500,0,0,0,0,0,0,0,135000,-135000,-135000
20200520,708955,雙美群益98購01,,,,,,0.00,0,0,0,0,0,0,0,0,0,0,0,0,0
20200520,708956,大江凱基97購02,,,,,,0.00,0,0,0,0,0,0,0,0,0,0,0,0,0
20200520,708957,世界凱基97購01,0.25,0.25,0.25,0.25,-0.02,-7.41,30000,1,7500,0,0,0,0,0,0,0,30000,-30000,-30000
20200520,708958,台燿凱基98購01,2.37,2.37,2.21,2.21,-0.13,-5.56,70000,14,162100,0,0,0,0,0,0,60000,10000,50000,50000
20200520,708959,宣德凱基98購01,0.61,0.67,0.61,0.66,+0.04,6.45,120000,3,78700,0,0,0,0,0,0,20000,100000,-80000,-80000
20200520,708960,璟德凱基97購01,,,,,,0.00,0,0,0,0,0,0,0,0,0,0,0,0,0
20200520,708961,環球晶凱基97購06,1.46,1.47,1.46,1.46,-0.03,-2.01,6000,3,8800,0,0,0,0,0,0,6000,6000,0,0
20200520,708962,鈊象凱基98購04,,,,,,0.00,0,0,0,0,0,0,0,0,0,0,0,0,0
20200520,708963,譜瑞凱基97購02,3.86,4.13,3.32,3.48,-0.27,-7.2,144000,30,548910,0,0,0,0,0,0,90000,33000,57000,57000
20200520,708964,信昌電國票98購03,,,,,,0.00,0,0,0,0,0,0,0,0,0,0,0,0,0
20200520,708965,廣明國票98購03,1.86,1.95,1.86,1.95,-0.03,-1.52,91000,4,175380,0,0,0,0,0,0,65000,26000,39000,39000
20200520,708966,聯亞國票98購01,,,,,,0.00,0,0,0,0,0,0,0,0,0,0,0,0,0
20200520,708967,大江元大97購05,0.77,0.77,0.77,0.77,-0.07,-8.33,5000,1,3850,0,0,0,0,0,0,5000,5000,0,0
20200520,708968,中美晶元大97購09,,,,,,0.00,0,0,0,0,0,0,0,0,0,0,0,0,0
20200520,708969,宣德元大97購03,0.44,0.44,0.44,0.44,+0.04,10.0,200000,1,88000,0,0,0,0,0,0,200000,0,200000,200000
20200520,708970,群聯元大97購07,,,,,,0.00,0,0,0,0,0,0,0,0,0,0,0,0,0
20200520,708971,精測元大97購07,,,,,,0.00,0,0,0,0,0,0,0,0,0,0,0,0,0
20200520,708972,網龍元大98購02,0.63,0.63,0.63,0.63,+0.01,1.61,6000,1,3780,0,0,0,0,0,0,0,6000,-6000,-6000
20200520,708973,聚積元大97購01,,,,,,0.00,0,0,0,0,0,0,0,0,0,0,0,0,0
20200520,708974,環球晶元大97購10,1.20,1.20,1.16,1.16,-0.04,-3.33,74000,3,88610,0,0,0,0,0,0,6000,74000,-68000,-68000
20200520,708975,環球晶元大97購11,,,,,,0.00,0,0,0,0,0,0,0,0,0,0,0,0,0
20200520,708976,環球晶元大97購12,1.20,1.20,1.13,1.16,-0.03,-2.52,13000,4,15450,0,0,0,0,0,0,12000,3000,9000,9000
20200520,708977,M31兆豐97購01,0.18,0.18,0.18,0.18,+0.01,5.88,5000,1,900,0,0,0,0,0,0,0,5000,-5000,-5000
20200520,708978,頎邦兆豐97購01,,,,,,0.00,0,0,0,0,0,0,0,0,0,0,0,0,0
20200520,708979,VHQ統一98購01,,,,,,0.00,0,0,0,0,0,0,0,0,0,0,0,0,0
20200520,708980,威剛統一98購01,,,,,,0.00,0,0,0,0,0,0,0,0,0,0,0,0,0
20200520,708981,光頡國票98購03,0.54,0.59,0.54,0.58,+0.04,7.41,300000,4,166500,0,0,0,0,0,0,300000,0,300000,300000
20200520,708982,大學光國泰99購01,,,,,,0.00,0,0,0,0,0,0,0,0,0,0,0,0,0
20200520,708983,穩懋國泰98購02,,,,,,0.00,0,0,0,0,0,0,0,0,0,0,0,0,0
20200520,708984,大江凱基97購03,,,,,,0.00,0,0,0,0,0,0,0,0,0,0,0,0,0
20200520,708985,六角凱基99購02,,,,,,0.00,0,0,0,0,0,0,0,0,0,0,0,0,0
20200520,708986,旺矽凱基97購02,1.35,1.51,1.34,1.48,+0.14,10.45,469000,29,677170,0,0,0,0,0,0,46000,413000,-367000,-367000
20200520,708987,環球晶凱基97購07,,,,,,0.00,0,0,0,0,0,0,0,0,0,0,0,0,0
20200520,708988,雙鴻凱基98購02,1.05,1.05,1.00,1.00,-0.05,-4.76,151000,4,154050,0,0,0,0,0,0,1000,151000,-150000,-150000
20200520,708989,穩懋凱基97購05,,,,,,0.00,0,0,0,0,0,0,0,0,0,0,0,0,0
20200520,708990,穩懋凱基98購01,,,,,,0.00,0,0,0,0,0,0,0,0,0,0,0,0,0
20200520,708991,穩懋凱基98購02,,,,,,0.00,0,0,0,0,0,0,0,0,0,0,0,0,0
20200520,708992,M31元大98購02,0.79,0.81,0.79,0.81,+0.07,9.46,48000,2,38840,0,0,0,0,0,0,2000,46000,-44000,-44000
20200520,708993,大學光元大98購01,,,,,,0.00,0,0,0,0,0,0,0,0,0,0,0,0,0
20200520,708994,中美晶元大98購01,0.24,0.24,0.24,0.24,-0.08,-25.0,104000,1,24960,0,0,0,0,0,0,104000,104000,0,0
20200520,708995,世界元大97購01,0.44,0.44,0.44,0.44,0.00,0.0,68000,1,29920,0,0,0,0,0,0,0,68000,-68000,-68000
20200520,708996,保瑞元大97購01,,,,,,0.00,0,0,0,0,0,0,0,0,0,0,0,0,0
20200520,708997,晶焱元大99購01,,,,,,0.00,0,0,0,0,0,0,0,0,0,0,0,0,0
20200520,708998,大學光康和9B購01,1.52,1.61,1.52,1.61,+0.06,3.87,17000,3,26040,0,0,0,0,0,0,17000,0,17000,17000
20200520,708999,泰博群益97購02,23.00,23.00,23.00,23.00,+1.40,6.48,5000,1,115000,0,0,0,0,0,0,0,5000,-5000,-5000
20200520,709000,環球晶群益98購01,2.39,2.42,2.39,2.39,-0.04,-1.65,7000,3,16880,0,0,0,0,0,0,7000,7000,0,0
20200520,709001,鈺太群益97購01,0.72,0.72,0.71,0.71,+0.04,5.97,63000,2,44830,0,0,0,0,0,0,10000,53000,-43000,-43000
20200520,709002,環球晶日盛97購01,0.20,0.20,0.19,0.19,-0.06,-24.0,155000,3,30000,0,0,0,0,0,0,155000,155000,0,0
20200520,709003,世禾永豐97購02,,,,,,0.00,0,0,0,0,0,0,0,0,0,0,0,0,0
20200520,709004,順達永豐97購01,0.64,0.85,0.64,0.85,+0.20,30.77,825000,35,618830,0,0,0,0,0,0,248000,566000,-318000,-318000
20200520,709005,新揚科永豐97購01,0.08,0.08,0.08,0.08,-0.01,-11.11,20000,1,1600,0,0,0,0,0,0,20000,0,20000,20000
20200520,709006,穩懋永豐97購03,0.15,0.15,0.15,0.15,-0.04,-21.05,130000,2,19500,0,0,0,0,0,0,130000,0,130000,130000
20200520,709007,勝麗台新97購01,0.37,0.37,0.37,0.37,+0.01,2.78,250000,1,92500,0,0,0,0,0,0,250000,0,250000,250000
20200520,709008,中美晶元富99購01,,,,,,0.00,0,0,0,0,0,0,0,0,0,0,0,0,0
20200520,709009,信昌電元富97購02,0.74,0.74,0.74,0.74,0.00,0.0,10000,1,7400,0,0,0,0,0,0,10000,0,10000,10000
20200520,709010,宣德元富97購01,1.26,1.37,1.26,1.36,+0.09,7.09,90000,8,117500,0,0,0,0,0,0,40000,50000,-10000,-10000
20200520,709011,緯軟元富97購01,,,,,,0.00,0,0,0,0,0,0,0,0,0,0,0,0,0
20200520,709012,環球晶元富97購03,,,,,,0.00,0,0,0,0,0,0,0,0,0,0,0,0,0
20200520,709013,環球晶元富97購04,,,,,,0.00,0,0,0,0,0,0,0,0,0,0,0,0,0
20200520,709014,鈊象元富97購04,4.73,4.73,4.56,4.56,-0.05,-1.08,50000,5,232800,0,0,0,0,0,0,0,50000,-50000,-50000
20200520,709015,世禾統一99購01,,,,,,0.00,0,0,0,0,0,0,0,0,0,0,0,0,0
20200520,709016,世禾統一9A購01,0.12,0.12,0.12,0.12,0.00,0.0,20000,2,2400,0,0,0,0,0,0,0,20000,-20000,-20000
20200520,709017,金居統一98購01,2.48,2.48,2.46,2.46,-0.09,-3.53,44000,2,108920,0,0,0,0,0,0,44000,0,44000,44000
20200520,709018,順達統一99購01,,,,,,0.00,0,0,0,0,0,0,0,0,0,0,0,0,0
20200520,709019,中美晶凱基9A購01,,,,,,0.00,0,0,0,0,0,0,0,0,0,0,0,0,0
20200520,709020,迅得凱基9A購01,,,,,,0.00,0,0,0,0,0,0,0,0,0,0,0,0,0
20200520,709021,亞泰凱基9A購01,,,,,,0.00,0,0,0,0,0,0,0,0,0,0,0,0,0
20200520,709022,保瑞凱基98購01,0.63,0.63,0.63,0.63,+0.01,1.61,12000,1,7560,0,0,0,0,0,0,0,0,0,0
20200520,709023,新普凱基98購02,0.81,0.81,0.74,0.74,-0.05,-6.33,329000,76,252950,0,0,0,0,0,0,0,262000,-262000,-262000
20200520,709024,環球晶凱基98購01,,,,,,0.00,0,0,0,0,0,0,0,0,0,0,0,0,0
20200520,709025,環球晶凱基99購01,,,,,,0.00,0,0,0,0,0,0,0,0,0,0,0,0,0
20200520,709026,穩懋日盛98購01,,,,,,0.00,0,0,0,0,0,0,0,0,0,0,0,0,0
20200520,709027,大江國票99購01,1.45,1.45,1.45,1.45,-0.17,-10.49,20000,1,29000,0,0,0,0,0,0,20000,0,20000,20000
20200520,709028,凡甲富邦9A購01,1.35,1.36,1.27,1.29,-0.02,-1.53,176000,44,233830,0,0,0,0,0,0,154000,22000,132000,132000
20200520,709029,聯亞富邦9A購01,0.18,0.19,0.18,0.19,-0.01,-5.0,1807000,10,343260,0,0,0,0,0,0,7000,1800000,-1793000,-1793000
20200520,709030,大江元大98購01,0.74,0.74,0.74,0.74,-0.15,-16.85,15000,1,11100,0,0,0,0,0,0,15000,0,15000,15000
20200520,709031,群聯元大99購01,,,,,,0.00,0,0,0,0,0,0,0,0,0,0,0,0,0
20200520,709032,碩禾元大99購01,,,,,,0.00,0,0,0,0,0,0,0,0,0,0,0,0,0
20200520,709033,優群元大99購02,2.97,3.04,2.96,2.96,+0.04,1.37,105000,3,314780,0,0,0,0,0,0,6000,99000,-93000,-93000
20200520,709034,環球晶元大98購01,1.17,1.17,1.09,1.09,-0.11,-9.17,25000,2,27650,0,0,0,0,0,0,25000,5000,20000,20000
20200520,709035,環球晶元大98購02,,,,,,0.00,0,0,0,0,0,0,0,0,0,0,0,0,0
20200520,709036,環球晶元大98購03,,,,,,0.00,0,0,0,0,0,0,0,0,0,0,0,0,0
20200520,709037,聯亞元大99購01,,,,,,0.00,0,0,0,0,0,0,0,0,0,0,0,0,0
20200520,709038,譜瑞元大98購02,,,,,,0.00,0,0,0,0,0,0,0,0,0,0,0,0,0
20200520,709039,譜瑞元富98購01,,,,,,0.00,0,0,0,0,0,0,0,0,0,0,0,0,0
20200520,709040,勝麗台新98購01,,,,,,0.00,0,0,0,0,0,0,0,0,0,0,0,0,0
20200520,709041,精測台新99購01,,,,,,0.00,0,0,0,0,0,0,0,0,0,0,0,0,0
20200520,709042,宣德兆豐98購01,0.83,0.87,0.83,0.87,+0.08,10.13,69000,2,57630,0,0,0,0,0,0,60000,9000,51000,51000
20200520,709043,威剛群益9A購01,,,,,,0.00,0,0,0,0,0,0,0,0,0,0,0,0,0
20200520,709044,統新康和98購01,0.70,0.75,0.70,0.75,+0.06,8.7,180000,14,132550,0,0,0,0,0,0,60000,120000,-60000,-60000
20200520,709045,神盾群益9A購01,1.42,1.51,1.42,1.44,-0.12,-7.69,16000,3,23100,0,0,0,0,0,0,4000,12000,-8000,-8000
20200520,709046,廣明群益98購01,1.16,1.16,1.16,1.16,-0.18,-13.43,7000,1,8120,0,0,0,0,0,0,7000,0,7000,7000
20200520,709047,世禾永豐98購01,,,,,,0.00,0,0,0,0,0,0,0,0,0,0,0,0,0
20200520,709048,合晶永豐98購01,1.30,1.33,1.24,1.29,+0.13,11.21,87000,11,111800,0,30000,-30000,0,0,0,58000,31000,27000,-3000
20200520,709049,亞泰永豐99購01,1.03,1.06,1.03,1.06,+0.05,4.95,66000,2,68340,0,0,0,0,0,0,0,66000,-66000,-66000
20200520,709050,金居永豐98購01,1.86,1.95,1.81,1.81,-0.17,-8.59,70000,8,131690,0,0,0,0,0,0,23000,47000,-24000,-24000
20200520,709051,統新永豐98購01,0.58,0.59,0.51,0.51,-0.10,-16.39,155000,35,87560,0,0,0,0,0,0,80000,55000,25000,25000
20200520,709052,鈊象永豐98購02,0.55,0.56,0.55,0.56,-0.06,-9.68,20000,2,11100,0,0,0,0,0,0,0,10000,-10000,-10000
20200520,709053,M31元大98購03,1.51,1.64,1.46,1.50,+0.07,4.9,683000,45,1072790,0,0,0,0,0,0,526000,449000,77000,77000
20200520,709054,凡甲元大9A購01,,,,,,0.00,0,0,0,0,0,0,0,0,0,0,0,0,0
20200520,709055,中美晶元大99購01,0.91,0.91,0.89,0.89,+0.07,8.54,60000,6,54000,0,0,0,0,0,0,0,60000,-60000,-60000
20200520,709056,群聯元大98購03,,,,,,0.00,0,0,0,0,0,0,0,0,0,0,0,0,0
20200520,709057,精測元大98購02,,,,,,0.00,0,0,0,0,0,0,0,0,0,0,0,0,0
20200520,709058,緯軟元大98購01,0.53,0.53,0.53,0.53,+0.03,6.0,6000,1,3180,0,0,0,0,0,0,0,6000,-6000,-6000
20200520,709059,鈊象元大99購02,2.65,2.65,2.60,2.60,-0.31,-10.65,73000,2,191700,0,0,0,0,0,0,73000,0,73000,73000
20200520,709060,大江國泰9A購01,,,,,,0.00,0,0,0,0,0,0,0,0,0,0,0,0,0
20200520,709061,台燿國泰99購01,1.99,1.99,1.81,1.81,-0.10,-5.24,703000,52,1340180,0,0,0,0,0,0,655000,28000,627000,627000
20200520,709062,合晶國泰99購01,2.33,2.33,2.25,2.25,+0.03,1.35,26000,2,58820,0,0,0,0,0,0,0,26000,-26000,-26000
20200520,709063,雍智國票99購01,6.40,7.40,6.40,6.70,+1.05,18.58,140000,25,944250,0,0,0,0,0,0,23000,117000,-94000,-94000
20200520,709064,網龍國票99購01,,,,,,0.00,0,0,0,0,0,0,0,0,0,0,0,0,0
20200520,709065,雙鴻國票99購01,1.37,1.37,1.37,1.37,+0.02,1.48,1000,1,1370,0,0,0,0,0,0,1000,1000,0,0
20200520,709066,中美晶統一98購01,1.28,1.28,1.25,1.25,-0.12,-8.76,19000,3,24020,0,0,0,0,0,0,19000,0,19000,19000
20200520,709067,統新統一01購01,1.46,1.46,1.46,1.46,-0.03,-2.01,6000,1,8760,0,0,0,0,0,0,6000,0,6000,6000
20200520,709068,統新統一98購01,1.38,1.38,1.29,1.36,+0.01,0.74,630000,26,840580,0,0,0,0,0,0,540000,60000,480000,480000
20200520,709069,統新統一9B購01,1.22,1.24,1.22,1.24,0.00,0.0,6000,2,7420,0,0,0,0,0,0,1000,0,1000,1000
20200520,709070,統新統一9C購01,1.26,1.26,1.21,1.23,-0.06,-4.65,151000,15,188020,0,0,0,0,0,0,151000,0,151000,151000
20200520,709071,鈊象統一9A購01,,,,,,0.00,0,0,0,0,0,0,0,0,0,0,0,0,0
20200520,709072,鈊象中信98購01,0.51,0.51,0.47,0.47,-0.09,-16.07,79000,5,37890,0,0,0,0,0,0,50000,28000,22000,22000
20200520,709073,大江凱基98購04,,,,,,0.00,0,0,0,0,0,0,0,0,0,0,0,0,0
20200520,709074,大學光凱基9A購01,2.30,2.30,2.30,2.30,-0.71,-23.59,10000,1,23000,0,0,0,0,0,0,0,10000,-10000,-10000
20200520,709075,中美晶凱基98購01,1.57,1.57,1.57,1.57,-0.07,-4.27,52000,2,81640,0,0,0,0,0,0,49000,3000,46000,46000
20200520,709076,合晶凱基98購02,1.95,2.01,1.95,2.00,+0.09,4.71,174000,16,345620,0,0,0,0,0,0,108000,152000,-44000,-44000
20200520,709077,宜鼎凱基98購02,2.96,3.23,2.96,3.23,+0.12,3.86,91000,8,282150,0,0,0,0,0,0,42000,52000,-10000,-10000
20200520,709078,昇達科凱基98購01,0.82,0.84,0.82,0.84,-0.02,-2.33,160000,10,132200,0,0,0,0,0,0,160000,160000,0,0
20200520,709079,信昌電凱基98購03,1.62,1.76,1.62,1.63,+0.01,0.62,138000,8,232870,0,0,0,0,0,0,59000,89000,-30000,-30000
20200520,709080,宣德凱基98購02,1.23,1.35,1.21,1.35,+0.15,12.5,216000,9,276460,0,0,0,0,0,0,21000,196000,-175000,-175000
20200520,709081,原相凱基98購03,1.27,1.27,1.27,1.27,-0.10,-7.3,10000,1,12700,0,0,0,0,0,0,10000,10000,0,0
20200520,709082,精測凱基98購03,,,,,,0.00,0,0,0,0,0,0,0,0,0,0,0,0,0
20200520,709083,廣明凱基98購03,1.89,1.95,1.88,1.94,-0.14,-6.73,65000,7,125260,0,0,0,0,0,0,35000,31000,4000,4000
20200520,709084,優群凱基9A購01,,,,,,0.00,0,0,0,0,0,0,0,0,0,0,0,0,0
20200520,709085,環球晶凱基98購02,1.38,1.38,1.38,1.38,-0.15,-9.8,2000,1,2760,0,0,0,0,0,0,2000,0,2000,2000
20200520,709086,環球晶凱基99購02,1.74,1.75,1.74,1.74,-0.02,-1.14,6000,3,10480,0,0,0,0,0,0,6000,6000,0,0
20200520,709087,聯亞凱基98購02,,,,,,0.00,0,0,0,0,0,0,0,0,0,0,0,0,0
20200520,709088,鈊象凱基9A購01,,,,,,0.00,0,0,0,0,0,0,0,0,0,0,0,0,0
20200520,709089,統新元富98購01,,,,,,0.00,0,0,0,0,0,0,0,0,0,0,0,0,0
20200520,709090,統新元富98購02,1.56,1.58,1.40,1.55,0.00,0.0,420000,41,626800,0,0,0,0,0,0,322000,28000,294000,294000
20200520,709091,穩懋統一98購03,0.75,0.75,0.72,0.72,-0.13,-15.29,60000,4,44300,0,0,0,0,0,0,0,60000,-60000,-60000
20200520,709092,鈊象中信99購02,,,,,,0.00,0,0,0,0,0,0,0,0,0,0,0,0,0
20200520,709093,VHQ元大99購01,0.42,0.45,0.42,0.45,-0.06,-11.76,345000,5,148850,0,0,0,0,0,0,0,345000,-345000,-345000
20200520,709094,大江元大99購01,,,,,,0.00,0,0,0,0,0,0,0,0,0,0,0,0,0
20200520,709095,六角元大99購01,0.70,0.70,0.70,0.70,-0.01,-1.41,19000,1,13300,0,0,0,0,0,0,19000,0,19000,19000
20200520,709096,同致元大99購01,,,,,,0.00,0,0,0,0,0,0,0,0,0,0,0,0,0
20200520,709097,建榮元大98購01,,,,,,0.00,0,0,0,0,0,0,0,0,0,0,0,0,0
20200520,709098,原相元大9A購01,1.41,1.41,1.39,1.39,-0.08,-5.44,170000,17,236700,0,0,0,0,0,0,170000,170000,0,0
20200520,709099,鈊象元大99購03,,,,,,0.00,0,0,0,0,0,0,0,0,0,0,0,0,0
20200520,709100,鈺太元大99購02,0.86,0.86,0.86,0.86,+0.05,6.17,10000,1,8600,0,0,0,0,0,0,10000,0,10000,10000
20200520,709101,泰博元富98購01,,,,,,0.00,0,0,0,0,0,0,0,0,0,0,0,0,0
20200520,709102,三貝德群益98購01,,,,,,0.00,0,0,0,0,0,0,0,0,0,0,0,0,0
20200520,709103,中美晶群益98購01,1.33,1.33,1.29,1.29,-0.19,-12.84,20000,2,26560,0,0,0,0,0,0,20000,20000,0,0
20200520,709104,良維群益98購01,3.65,3.68,3.48,3.54,+0.04,1.14,156000,6,559050,0,0,0,0,0,0,144000,62000,82000,82000
20200520,709105,宣德群益98購01,2.43,2.71,2.43,2.71,+0.26,10.61,124000,8,320170,0,0,0,0,0,0,53000,74000,-21000,-21000
20200520,709106,統新群益98購01,3.38,3.44,3.23,3.44,+0.01,0.29,351000,33,1159590,0,0,0,0,0,0,324000,27000,297000,297000
20200520,709107,晶焱群益98購02,,,,,,0.00,0,0,0,0,0,0,0,0,0,0,0,0,0
20200520,709108,金居國票99購01,1.50,1.51,1.44,1.45,-0.04,-2.68,833000,9,1232850,0,0,0,0,0,0,789000,44000,745000,745000
20200520,709109,統新國票98購01,3.83,4.02,3.75,3.75,-0.17,-4.34,127000,12,487940,0,0,0,0,0,0,101000,26000,75000,75000
20200520,709110,聯亞國票99購01,2.98,3.08,2.98,3.08,-0.06,-1.91,68000,2,205640,0,0,0,0,0,0,30000,38000,-8000,-8000
20200520,709111,VHQ永豐98購01,0.39,0.41,0.39,0.41,+0.02,5.13,80000,5,32320,0,0,0,0,0,0,80000,0,80000,80000
20200520,709112,大宇資永豐98購01,0.40,0.40,0.37,0.37,-0.01,-2.63,38000,4,14210,0,0,0,0,0,0,13000,25000,-12000,-12000
20200520,709113,大學光永豐9A購01,1.96,2.11,1.96,2.06,-0.02,-0.96,35000,6,71430,0,0,0,0,0,0,26000,9000,17000,17000
20200520,709114,波若威永豐99購01,1.22,1.29,1.22,1.22,+0.08,7.02,446000,9,559150,0,0,0,0,0,0,5000,441000,-436000,-436000
20200520,709115,金可永豐98購01,,,,,,0.00,0,0,0,0,0,0,0,0,0,0,0,0,0
20200520,709116,環球晶永豐98購01,,,,,,0.00,0,0,0,0,0,0,0,0,0,0,0,0,0
20200520,709117,大江凱基98購05,2.27,2.27,2.25,2.25,+0.04,1.81,20000,2,45200,0,0,0,0,0,0,0,20000,-20000,-20000
20200520,709118,元太凱基98購01,3.18,4.09,3.18,4.09,+0.93,29.43,12000,2,47260,0,0,0,0,0,0,0,12000,-12000,-12000
20200520,709119,台燿凱基98購02,,,,,,0.00,0,0,0,0,0,0,0,0,0,0,0,0,0
20200520,709120,同致凱基98購03,,,,,,0.00,0,0,0,0,0,0,0,0,0,0,0,0,0
20200520,709121,合晶凱基98購03,2.32,2.38,2.32,2.37,+0.08,3.49,91000,10,213270,0,0,0,0,0,0,4000,91000,-87000,-87000
20200520,709122,宜鼎凱基98購03,,,,,,0.00,0,0,0,0,0,0,0,0,0,0,0,0,0
20200520,709123,昇達科凱基98購02,0.35,0.36,0.35,0.36,+0.02,5.88,32000,2,11280,0,0,0,0,0,0,24000,8000,16000,16000
20200520,709124,信昌電凱基98購04,,,,,,0.00,0,0,0,0,0,0,0,0,0,0,0,0,0
20200520,709125,原相凱基98購04,,,,,,0.00,0,0,0,0,0,0,0,0,0,0,0,0,0
20200520,709126,勝麗凱基98購02,0.98,1.01,0.98,1.01,+0.09,9.78,30000,2,30000,0,0,0,0,0,0,0,30000,-30000,-30000
20200520,709127,群聯凱基98購03,,,,,,0.00,0,0,0,0,0,0,0,0,0,0,0,0,0
20200520,709128,廣明凱基98購04,1.97,2.02,1.95,1.95,-0.21,-9.72,107000,8,211930,0,0,0,0,0,0,58000,49000,9000,9000
20200520,709129,璟德凱基98購02,,,,,,0.00,0,0,0,0,0,0,0,0,0,0,0,0,0
20200520,709130,優群凱基9A購02,,,,,,0.00,0,0,0,0,0,0,0,0,0,0,0,0,0
20200520,709131,穩懋凱基98購03,,,,,,0.00,0,0,0,0,0,0,0,0,0,0,0,0,0
20200520,709132,穩懋凱基98購04,,,,,,0.00,0,0,0,0,0,0,0,0,0,0,0,0,0
20200520,709133,頎邦凱基98購01,,,,,,0.00,0,0,0,0,0,0,0,0,0,0,0,0,0
20200520,709134,環球晶統一98購01,,,,,,0.00,0,0,0,0,0,0,0,0,0,0,0,0,0
20200520,709135,原相凱基99購01,,,,,,0.00,0,0,0,0,0,0,0,0,0,0,0,0,0
20200520,709136,群聯凱基98購04,,,,,,0.00,0,0,0,0,0,0,0,0,0,0,0,0,0
20200520,709137,碩禾凱基9A購01,,,,,,0.00,0,0,0,0,0,0,0,0,0,0,0,0,0
20200520,709138,M31元大99購02,0.85,0.86,0.79,0.79,+0.02,2.6,96000,3,81980,0,0,0,0,0,0,0,96000,-96000,-96000
20200520,709139,鈊象元大99購04,,,,,,0.00,0,0,0,0,0,0,0,0,0,0,0,0,0
20200520,709140,泰博國票99購01,24.90,27.30,24.90,26.60,-0.50,-1.85,21000,7,555400,0,0,0,0,0,0,11000,10000,1000,1000
20200520,709141,神盾國泰9A購01,,,,,,0.00,0,0,0,0,0,0,0,0,0,0,0,0,0
20200520,709142,宣德富邦9A購01,1.44,1.55,1.38,1.55,+0.14,9.93,782000,45,1135260,0,0,0,0,0,0,423000,348000,75000,75000
20200520,709143,環球晶富邦9A購01,0.34,0.35,0.32,0.33,-0.02,-5.71,273000,6,89220,0,0,0,0,0,0,203000,249000,-46000,-46000
20200520,709144,信昌電亞東99購01,,,,,,0.00,0,0,0,0,0,0,0,0,0,0,0,0,0
20200520,709145,大江永豐98購01,2.03,2.04,1.92,1.92,-0.12,-5.88,42000,6,83680,0,0,0,0,0,0,8000,34000,-26000,-26000
20200520,709146,同致永豐98購01,,,,,,0.00,0,0,0,0,0,0,0,0,0,0,0,0,0
20200520,709147,合晶永豐98購02,,,,,,0.00,0,0,0,0,0,0,0,0,0,0,0,0,0
20200520,709148,良維永豐98購01,1.41,1.42,1.33,1.37,0.00,0.0,63000,6,86990,0,0,0,0,0,0,46000,44000,2000,2000
20200520,709149,東隆興永豐98購01,0.12,0.12,0.12,0.12,+0.01,9.09,10000,1,1200,0,0,0,0,0,0,0,0,0,0
20200520,709150,南光永豐98購01,0.21,0.22,0.21,0.21,+0.01,5.0,400000,4,84900,0,0,0,0,0,0,300000,100000,200000,200000
20200520,709151,茂達永豐98購01,0.93,1.20,0.91,1.20,+0.57,90.48,156000,11,154790,0,0,0,0,0,0,30000,89000,-59000,-59000
20200520,709152,新潤永豐98購01,,,,,,0.00,0,0,0,0,0,0,0,0,0,0,0,0,0
20200520,709153,大江兆豐98購01,1.40,1.40,1.40,1.40,-0.01,-0.71,20000,2,28000,0,0,0,0,0,0,0,20000,-20000,-20000
20200520,709154,VHQ康和98購01,,,,,,0.00,0,0,0,0,0,0,0,0,0,0,0,0,0
20200520,709155,世界群益9A購01,0.59,0.59,0.59,0.59,-0.01,-1.67,104000,2,61360,0,0,0,0,0,0,104000,0,104000,104000
20200520,709156,台燿群益99購01,,,,,,0.00,0,0,0,0,0,0,0,0,0,0,0,0,0
20200520,709157,威剛群益9A購02,,,,,,0.00,0,0,0,0,0,0,0,0,0,0,0,0,0
20200520,709158,廣明群益98購02,1.22,1.26,1.22,1.26,-0.14,-10.0,126000,3,157770,0,0,0,0,0,0,7000,119000,-112000,-112000
20200520,709159,優群群益99購02,,,,,,0.00,0,0,0,0,0,0,0,0,0,0,0,0,0
20200520,709160,大江元富98購01,,,,,,0.00,0,0,0,0,0,0,0,0,0,0,0,0,0
20200520,709161,元太台新98購01,2.99,3.70,2.99,3.70,+1.06,40.15,85000,11,289100,0,0,0,0,0,0,70000,10000,60000,60000
20200520,709162,鈊象台新98購02,,,,,,0.00,0,0,0,0,0,0,0,0,0,0,0,0,0
20200520,709163,宇峻元大99購01,,,,,,0.00,0,0,0,0,0,0,0,0,0,0,0,0,0
20200520,709164,金居元大99購02,1.56,1.61,1.52,1.52,-0.12,-7.32,88000,8,138320,0,0,0,0,0,0,76000,12000,64000,64000
20200520,709165,新鉅科元大98購01,,,,,,0.00,0,0,0,0,0,0,0,0,0,0,0,0,0
20200520,709166,上詮永豐98購01,,,,,,0.00,0,0,0,0,0,0,0,0,0,0,0,0,0
20200520,709167,光頡永豐98購01,,,,,,0.00,0,0,0,0,0,0,0,0,0,0,0,0,0
20200520,709168,波若威永豐98購02,,,,,,0.00,0,0,0,0,0,0,0,0,0,0,0,0,0
20200520,709169,建榮永豐99購02,,,,,,0.00,0,0,0,0,0,0,0,0,0,0,0,0,0
20200520,709170,健信永豐98購01,,,,,,0.00,0,0,0,0,0,0,0,0,0,0,0,0,0
20200520,709171,璟德永豐98購01,,,,,,0.00,0,0,0,0,0,0,0,0,0,0,0,0,0
20200520,709172,統新國泰99購01,1.92,1.96,1.79,1.87,-0.13,-6.5,644000,62,1204870,0,0,0,0,0,0,624000,10000,614000,614000
20200520,709173,環球晶統一99購02,0.90,0.90,0.90,0.90,-0.07,-7.22,110000,2,99000,0,0,0,0,0,0,110000,0,110000,110000
20200520,709174,太醫中信99購01,0.62,0.67,0.62,0.65,+0.01,1.56,224000,7,144350,0,0,0,0,0,0,0,224000,-224000,-224000
20200520,709175,環球晶中信98購01,0.07,0.08,0.07,0.08,0.00,0.0,13000,3,920,0,0,0,0,0,0,0,13000,-13000,-13000
20200520,709176,大江凱基98購06,2.92,2.92,2.73,2.73,-0.11,-3.87,43000,5,119860,0,0,0,0,0,0,32000,11000,21000,21000
20200520,709177,宣德凱基98購03,0.86,0.96,0.83,0.96,+0.12,14.29,299000,14,265400,0,0,0,0,0,0,155000,144000,11000,11000
20200520,709178,精測凱基98購04,,,,,,0.00,0,0,0,0,0,0,0,0,0,0,0,0,0
20200520,709179,雙鴻兆豐99購01,0.56,0.56,0.56,0.56,-0.01,-1.75,10000,1,5600,0,0,0,0,0,0,10000,0,10000,10000
20200520,709180,統新康和98購02,1.29,1.29,1.28,1.28,-0.13,-9.22,45000,10,58040,0,0,0,0,0,0,45000,0,45000,45000
20200520,709181,太景*群益99購01,0.48,0.48,0.48,0.48,0.00,0.0,10000,1,4800,0,0,0,0,0,0,0,0,0,0
20200520,709182,大江富邦9A購01,2.30,2.30,2.30,2.30,-0.06,-2.54,3000,1,6900,0,0,0,0,0,0,0,3000,-3000,-3000
20200520,709183,原相麥證99購01,0.47,0.47,0.46,0.46,-0.03,-6.12,550000,2,257990,550000,0,550000,0,0,0,550000,550000,0,0
20200520,709184,順達麥證98購01,2.03,2.43,1.99,2.36,+0.38,19.19,267000,18,574180,124000,143000,-19000,0,0,0,124000,143000,-19000,-19000
20200520,709185,璟德麥證98購01,0.62,0.68,0.62,0.68,+0.08,13.33,3000,3,1960,0,3000,-3000,0,0,0,0,3000,-3000,-3000
20200520,709186,鈊象台新98購03,,,,,,0.00,0,0,0,0,0,0,0,0,0,0,0,0,0
20200520,709187,大中元富98購01,0.71,0.75,0.71,0.75,+0.07,10.29,15000,2,10850,0,0,0,0,0,0,10000,5000,5000,5000
20200520,709188,太景*元富98購01,,,,,,0.00,0,0,0,0,0,0,0,0,0,0,0,0,0
20200520,709189,台半元富98購01,,,,,,0.00,0,0,0,0,0,0,0,0,0,0,0,0,0
20200520,709190,由田元富98購01,1.06,1.06,1.06,1.06,+0.01,0.95,10000,1,10600,0,0,0,0,0,0,0,10000,-10000,-10000
20200520,709191,杰力元富98購01,3.01,3.29,3.01,3.29,+0.24,7.87,529000,49,1681220,0,0,0,0,0,0,193000,331000,-138000,-138000
20200520,709192,金居元富99購01,,,,,,0.00,0,0,0,0,0,0,0,0,0,0,0,0,0
20200520,709193,美琪瑪元富98購01,0.28,0.28,0.28,0.28,-0.02,-6.67,20000,1,5600,0,0,0,0,0,0,0,20000,-20000,-20000
20200520,709194,統新元富98購03,2.72,2.87,2.68,2.70,-0.24,-8.16,559000,46,1541130,0,0,0,0,0,0,533000,26000,507000,507000
20200520,709195,碩禾元富9B購01,0.27,0.28,0.17,0.28,-0.26,-48.15,146000,4,25420,0,0,0,0,0,0,140000,6000,134000,134000
20200520,709196,群聯中信99購01,0.06,0.06,0.06,0.06,-0.01,-14.29,40000,1,2400,0,0,0,0,0,0,40000,0,40000,40000
20200520,709197,大學光統一99購01,,,,,,0.00,0,0,0,0,0,0,0,0,0,0,0,0,0
20200520,709198,原相統一99購01,3.28,3.28,3.28,3.28,-0.06,-1.8,15000,1,49200,0,0,0,0,0,0,15000,0,15000,15000
20200520,709199,M31凱基98購02,1.13,1.21,1.13,1.21,+0.36,42.35,20000,7,23000,0,0,0,0,0,0,20000,0,20000,20000
20200520,709200,中美晶凱基98購02,,,,,,0.00,0,0,0,0,0,0,0,0,0,0,0,0,0
20200520,709201,建榮凱基9A購01,0.58,0.58,0.58,0.58,+0.04,7.41,50000,1,29000,0,0,0,0,0,0,0,50000,-50000,-50000
20200520,709202,神盾凱基99購01,,,,,,0.00,0,0,0,0,0,0,0,0,0,0,0,0,0
20200520,709203,金可兆豐99購01,,,,,,0.00,0,0,0,0,0,0,0,0,0,0,0,0,0
20200520,709204,宣德兆豐98購02,0.76,0.85,0.72,0.85,+0.10,13.33,111000,17,85680,0,0,0,0,0,0,60000,36000,24000,24000
20200520,709205,環球晶兆豐98購02,,,,,,0.00,0,0,0,0,0,0,0,0,0,0,0,0,0
20200520,709206,合晶群益98購01,,,,,,0.00,0,0,0,0,0,0,0,0,0,0,0,0,0
20200520,709207,原相群益9B購01,2.40,2.40,2.28,2.28,-0.28,-10.94,176000,4,402980,0,0,0,0,0,0,156000,171000,-15000,-15000
20200520,709208,統新群益98購02,1.34,1.36,1.23,1.23,-0.08,-6.11,100000,13,131600,0,0,0,0,0,0,10000,40000,-30000,-30000
20200520,709209,廣明群益98購03,0.79,0.79,0.79,0.79,-0.10,-11.24,11000,1,8690,0,0,0,0,0,0,11000,0,11000,11000
20200520,709210,緯軟群益99購01,0.52,0.52,0.49,0.49,+0.02,4.26,62000,2,31280,0,0,0,0,0,0,32000,30000,2000,2000
20200520,709211,鈺太群益98購01,1.71,1.71,1.70,1.70,+0.09,5.59,135000,4,230630,0,0,0,0,0,0,0,135000,-135000,-135000
20200520,709212,建榮國票99購02,,,,,,0.00,0,0,0,0,0,0,0,0,0,0,0,0,0
20200520,709213,雍智國票99購02,2.22,2.22,2.22,2.22,+0.21,10.45,10000,1,22200,0,0,0,0,0,0,0,10000,-10000,-10000
20200520,709214,中美晶元大99購02,1.27,1.27,1.26,1.26,-0.04,-3.08,132000,3,167340,0,0,0,0,0,0,0,132000,-132000,-132000
20200520,709215,金居元大9A購01,5.55,5.55,5.55,5.55,-0.30,-5.13,1000,1,5550,0,0,0,0,0,0,1000,0,1000,1000
20200520,709216,威剛元大99購02,,,,,,0.00,0,0,0,0,0,0,0,0,0,0,0,0,0
20200520,709217,宣德元大99購01,,,,,,0.00,0,0,0,0,0,0,0,0,0,0,0,0,0
20200520,709218,群聯元大98購04,,,,,,0.00,0,0,0,0,0,0,0,0,0,0,0,0,0
20200520,709219,碩禾元大99購02,0.79,0.80,0.78,0.80,+0.03,3.9,168000,4,132540,0,0,0,0,0,0,108000,168000,-60000,-60000
20200520,709220,網家元大99購01,2.11,2.25,2.01,2.25,+0.50,28.57,53000,10,112920,0,0,0,0,0,0,38000,0,38000,38000
20200520,709221,環球晶元大98購04,,,,,,0.00,0,0,0,0,0,0,0,0,0,0,0,0,0
20200520,709222,環球晶元大99購01,,,,,,0.00,0,0,0,0,0,0,0,0,0,0,0,0,0
20200520,709223,雙鴻元大99購05,0.72,0.72,0.70,0.70,0.00,0.0,20000,3,14250,0,0,0,0,0,0,0,20000,-20000,-20000
20200520,709224,穩懋元大98購02,1.34,1.34,1.25,1.25,-0.23,-15.54,164000,8,211720,0,0,0,0,0,0,52000,119000,-67000,-67000
20200520,709225,穩懋元大99購01,,,,,,0.00,0,0,0,0,0,0,0,0,0,0,0,0,0
20200520,709226,泰博國泰99購01,,,,,,0.00,0,0,0,0,0,0,0,0,0,0,0,0,0
20200520,709227,大江富邦9A購02,1.32,1.32,1.32,1.32,-0.06,-4.35,99000,1,130680,0,0,0,0,0,0,99000,99000,0,0
20200520,709228,中美晶富邦9A購01,0.14,0.14,0.12,0.12,-0.06,-33.33,509000,2,61280,0,0,0,0,0,0,499000,509000,-10000,-10000
20200520,709229,精測富邦99購01,,,,,,0.00,0,0,0,0,0,0,0,0,0,0,0,0,0
20200520,709230,環球晶富邦9B購01,0.16,0.16,0.16,0.16,-0.01,-5.88,110000,2,17600,0,0,0,0,0,0,0,110000,-110000,-110000
20200520,709231,威剛麥證98購01,,,,,,0.00,0,0,0,0,0,0,0,0,0,0,0,0,0
20200520,709232,群聯麥證98購01,0.70,0.70,0.67,0.67,-0.02,-2.9,35000,5,24000,25000,10000,15000,0,0,0,25000,10000,15000,15000
20200520,709233,聯亞麥證98購01,,,,,,0.00,0,0,0,0,0,0,0,0,0,0,0,0,0
20200520,709234,力旺元富98購01,2.17,2.67,2.04,2.11,-0.34,-13.88,1941000,167,4579350,0,0,0,0,0,0,902000,1072000,-170000,-170000
20200520,709235,大江元富98購02,4.68,4.68,4.68,4.68,-0.13,-2.7,4000,1,18720,0,0,0,0,0,0,4000,0,4000,4000
20200520,709236,原相元富98購01,2.10,2.10,2.06,2.06,-0.11,-5.07,57000,8,119160,0,0,0,0,0,0,46000,11000,35000,35000
20200520,709237,新鉅科元富98購01,,,,,,0.00,0,0,0,0,0,0,0,0,0,0,0,0,0
20200520,709238,聚積元富98購01,0.89,0.92,0.88,0.92,+0.02,2.22,172000,7,155510,0,0,0,0,0,0,0,172000,-172000,-172000
20200520,709239,環球晶第一01購01,0.40,0.51,0.40,0.51,+0.10,24.39,160000,7,70300,0,0,0,0,0,0,100000,60000,40000,40000
20200520,709240,M31永豐98購01,1.17,1.21,1.17,1.21,+0.10,9.01,68000,7,81080,0,0,0,0,0,0,0,68000,-68000,-68000
20200520,709241,凡甲永豐98購01,,,,,,0.00,0,0,0,0,0,0,0,0,0,0,0,0,0
20200520,709242,大中永豐98購01,,,,,,0.00,0,0,0,0,0,0,0,0,0,0,0,0,0
20200520,709243,迅得永豐98購01,,,,,,0.00,0,0,0,0,0,0,0,0,0,0,0,0,0
20200520,709244,杰力永豐98購01,1.16,1.28,1.16,1.28,+0.11,9.4,577000,25,712190,0,10000,-10000,0,0,0,167000,360000,-193000,-203000
20200520,709245,統新永豐98購02,0.41,0.41,0.38,0.38,-0.08,-17.39,634000,25,252640,0,0,0,0,0,0,360000,274000,86000,86000
20200520,709246,晶焱永豐98購01,0.98,0.98,0.98,0.98,+0.02,2.08,50000,1,49000,0,0,0,0,0,0,50000,0,50000,50000
20200520,709247,網龍永豐98購01,0.95,0.95,0.91,0.91,0.00,0.0,40000,2,36800,0,0,0,0,0,0,40000,0,40000,40000
20200520,709248,優群永豐98購01,,,,,,0.00,0,0,0,0,0,0,0,0,0,0,0,0,0
20200520,709249,原相台新9A購01,1.08,1.08,1.08,1.08,-0.21,-16.28,3000,1,3240,0,0,0,0,0,0,3000,3000,0,0
20200520,709250,聯亞台新9A購01,,,,,,0.00,0,0,0,0,0,0,0,0,0,0,0,0,0
20200520,709251,前鼎統一99購01,0.61,0.61,0.61,0.61,+0.03,5.17,108000,1,65880,0,0,0,0,0,0,0,108000,-108000,-108000
20200520,709252,聯亞中信98購01,0.57,0.57,0.57,0.57,0.00,0.0,11000,1,6270,0,0,0,0,0,0,11000,0,11000,11000
20200520,709253,晶焱凱基98購03,1.54,1.54,1.54,1.54,-0.05,-3.14,16000,1,24640,0,0,0,0,0,0,16000,0,16000,16000
20200520,709254,群聯凱基99購01,,,,,,0.00,0,0,0,0,0,0,0,0,0,0,0,0,0
20200520,709255,神盾台新98購02,,,,,,0.00,0,0,0,0,0,0,0,0,0,0,0,0,0
20200520,709256,精測台新99購02,,,,,,0.00,0,0,0,0,0,0,0,0,0,0,0,0,0
20200520,709257,VHQ元富98購01,,,,,,0.00,0,0,0,0,0,0,0,0,0,0,0,0,0
20200520,709258,前鼎元富98購01,1.03,1.04,0.99,1.00,+0.07,7.53,178000,5,179530,0,0,0,0,0,0,50000,178000,-128000,-128000
20200520,709259,精測元富98購02,,,,,,0.00,0,0,0,0,0,0,0,0,0,0,0,0,0
20200520,709260,中美晶國票98購01,1.52,1.56,1.52,1.56,-0.09,-5.45,6000,2,9240,0,0,0,0,0,0,6000,0,6000,6000
20200520,709261,保瑞國票98購01,,,,,,0.00,0,0,0,0,0,0,0,0,0,0,0,0,0
20200520,709262,前鼎國票99購01,2.10,2.14,2.09,2.09,+0.06,2.96,38000,3,80500,0,0,0,0,0,0,8000,30000,-22000,-22000
20200520,709263,原相國票99購01,,,,,,0.00,0,0,0,0,0,0,0,0,0,0,0,0,0
20200520,709264,泰博國票99購02,15.70,15.70,15.70,15.70,+0.80,5.37,1000,1,15700,0,0,0,0,0,0,1000,0,1000,1000
20200520,709265,統新國票99購01,0.97,0.98,0.90,0.91,-0.09,-9.0,1181000,41,1121390,0,0,0,0,0,0,890000,281000,609000,609000
20200520,709266,六角兆豐98購01,,,,,,0.00,0,0,0,0,0,0,0,0,0,0,0,0,0
20200520,709267,宇峻群益9A購01,,,,,,0.00,0,0,0,0,0,0,0,0,0,0,0,0,0
20200520,709268,博智群益98購01,,,,,,0.00,0,0,0,0,0,0,0,0,0,0,0,0,0
20200520,709269,網龍群益98購03,2.86,2.86,2.73,2.73,-0.14,-4.88,9000,4,25370,0,0,0,0,0,0,9000,9000,0,0
20200520,709270,太景*國泰9A購01,0.43,0.46,0.43,0.46,+0.02,4.55,39000,3,17070,0,0,0,0,0,0,29000,0,29000,29000
20200520,709271,前鼎國泰99購01,,,,,,0.00,0,0,0,0,0,0,0,0,0,0,0,0,0
20200520,709272,新鉅科國泰99購01,,,,,,0.00,0,0,0,0,0,0,0,0,0,0,0,0,0
20200520,709273,環宇富邦9A購01,0.38,0.39,0.38,0.38,+0.03,8.57,200000,5,76100,0,0,0,0,0,0,30000,170000,-140000,-140000
20200520,709274,大江元大98購02,,,,,,0.00,0,0,0,0,0,0,0,0,0,0,0,0,0
20200520,709275,前鼎元大99購01,1.04,1.04,0.99,0.99,+0.02,2.06,145000,6,149400,0,0,0,0,0,0,0,145000,-145000,-145000
20200520,709276,威剛元大9A購01,,,,,,0.00,0,0,0,0,0,0,0,0,0,0,0,0,0
20200520,709277,神盾元大9A購01,0.76,0.76,0.76,0.76,0.00,0.0,1000,1,760,0,0,0,0,0,0,1000,1000,0,0
20200520,709278,群聯元大99購02,,,,,,0.00,0,0,0,0,0,0,0,0,0,0,0,0,0
20200520,709279,緯軟元大98購02,,,,,,0.00,0,0,0,0,0,0,0,0,0,0,0,0,0
20200520,709280,璟德元大98購01,2.11,2.11,2.06,2.06,-0.01,-0.48,72000,3,149420,0,0,0,0,0,0,22000,50000,-28000,-28000
20200520,709281,中美晶日盛9A購01,,,,,,0.00,0,0,0,0,0,0,0,0,0,0,0,0,0
20200520,709282,伍豐永豐98購01,,,,,,0.00,0,0,0,0,0,0,0,0,0,0,0,0,0
20200520,709283,兆利永豐98購01,,,,,,0.00,0,0,0,0,0,0,0,0,0,0,0,0,0
20200520,709284,宜鼎永豐98購01,0.61,0.67,0.61,0.67,+0.07,11.67,22000,3,13770,0,0,0,0,0,0,0,22000,-22000,-22000
20200520,709285,前鼎永豐98購01,,,,,,0.00,0,0,0,0,0,0,0,0,0,0,0,0,0
20200520,709286,建榮永豐9A購01,,,,,,0.00,0,0,0,0,0,0,0,0,0,0,0,0,0
20200520,709287,新鉅科永豐98購01,,,,,,0.00,0,0,0,0,0,0,0,0,0,0,0,0,0
20200520,709288,聯亞永豐98購01,0.77,0.77,0.73,0.75,-0.03,-3.85,66000,6,49680,0,0,0,0,0,0,30000,36000,-6000,-6000
20200520,709289,雙鴻永豐99購01,,,,,,0.00,0,0,0,0,0,0,0,0,0,0,0,0,0
20200520,709290,金居凱基98購02,,,,,,0.00,0,0,0,0,0,0,0,0,0,0,0,0,0
20200520,709291,威剛凱基9A購01,0.22,0.22,0.22,0.22,-0.01,-4.35,10000,1,2200,0,0,0,0,0,0,0,10000,-10000,-10000
20200520,709292,環球晶凱基98購04,,,,,,0.00,0,0,0,0,0,0,0,0,0,0,0,0,0
20200520,709293,環球晶康和98購01,,,,,,0.00,0,0,0,0,0,0,0,0,0,0,0,0,0
20200520,709294,大江群益98購01,,,,,,0.00,0,0,0,0,0,0,0,0,0,0,0,0,0
20200520,709295,宇峻群益9A購02,,,,,,0.00,0,0,0,0,0,0,0,0,0,0,0,0,0
20200520,709296,神盾群益9A購02,0.92,0.92,0.92,0.92,-0.09,-8.91,8000,1,7360,0,0,0,0,0,0,8000,0,8000,8000
20200520,709297,宣德國票99購01,1.79,1.95,1.79,1.95,+0.23,13.37,346000,15,627870,0,0,0,0,0,0,129000,188000,-59000,-59000
20200520,709298,群聯國票99購01,,,,,,0.00,0,0,0,0,0,0,0,0,0,0,0,0,0
20200520,709299,VHQ國泰99購01,0.42,0.45,0.42,0.45,+0.04,9.76,493000,9,213210,0,0,0,0,0,0,360000,133000,227000,227000
20200520,709300,宣德國泰9A購01,1.11,1.13,1.11,1.13,-0.01,-0.88,137000,5,153950,0,0,0,0,0,0,126000,8000,118000,118000
20200520,709301,大宇資永豐98購02,,,,,,0.00,0,0,0,0,0,0,0,0,0,0,0,0,0
20200520,709302,六角永豐98購01,0.83,0.83,0.83,0.83,+0.01,1.22,136000,2,112880,0,0,0,0,0,0,136000,0,136000,136000
20200520,709303,亞泰永豐98購01,0.95,0.95,0.95,0.95,+0.05,5.56,38000,1,36100,0,0,0,0,0,0,0,38000,-38000,-38000
20200520,709304,信昌電永豐98購01,,,,,,0.00,0,0,0,0,0,0,0,0,0,0,0,0,0
20200520,709305,宣德永豐98購01,1.47,1.56,1.44,1.56,+0.11,7.59,230000,12,342330,0,0,0,0,0,0,77000,154000,-77000,-77000
20200520,709306,原相永豐98購02,,,,,,0.00,0,0,0,0,0,0,0,0,0,0,0,0,0
20200520,709307,神盾永豐99購01,0.65,0.65,0.55,0.55,-0.05,-8.33,241000,6,134950,0,0,0,0,0,0,238000,23000,215000,215000
20200520,709308,雙美永豐99購01,,,,,,0.00,0,0,0,0,0,0,0,0,0,0,0,0,0
20200520,709309,譜瑞永豐98購01,2.10,2.14,1.77,1.77,-0.18,-9.23,201000,32,399720,0,0,0,0,0,0,101000,90000,11000,11000
20200520,709310,合晶元富98購01,1.78,1.83,1.77,1.83,+0.06,3.39,143000,17,256710,0,0,0,0,0,0,0,143000,-143000,-143000
20200520,709311,前鼎元富98購02,1.18,1.23,1.18,1.19,+0.07,6.25,299000,7,363280,0,0,0,0,0,0,75000,274000,-199000,-199000
20200520,709312,大學光元大99購01,2.88,2.88,2.88,2.88,-0.06,-2.04,5000,1,14400,0,0,0,0,0,0,0,5000,-5000,-5000
20200520,709313,保瑞元大98購01,1.60,1.60,1.60,1.60,+0.01,0.63,68000,1,108800,0,0,0,0,0,0,68000,0,68000,68000
20200520,709314,前鼎元大99購02,0.98,0.98,0.95,0.95,+0.03,3.26,170000,6,163050,0,0,0,0,0,0,0,170000,-170000,-170000
20200520,709315,胡連元大98購01,0.65,0.85,0.65,0.79,+0.16,25.4,2079000,69,1585750,0,0,0,0,0,0,440000,1468000,-1028000,-1028000
20200520,709316,神盾元大9A購02,0.97,0.99,0.89,0.89,-0.06,-6.32,497000,37,463960,0,0,0,0,0,0,409000,82000,327000,327000
20200520,709317,群聯元大98購05,,,,,,0.00,0,0,0,0,0,0,0,0,0,0,0,0,0
20200520,709318,環球晶元大98購09,,,,,,0.00,0,0,0,0,0,0,0,0,0,0,0,0,0
20200520,709319,環球晶元大98購10,1.29,1.29,1.21,1.21,-0.06,-4.72,123000,2,154270,0,0,0,0,0,0,55000,68000,-13000,-13000
20200520,709320,雙鴻元大9A購01,0.85,0.85,0.81,0.81,-0.02,-2.41,40000,3,33000,0,0,0,0,0,0,20000,20000,0,0
20200520,709321,譜瑞元大98購03,7.20,7.20,7.20,7.20,-1.20,-14.29,2000,1,14400,0,0,0,0,0,0,2000,0,2000,2000
20200520,709322,六角台新98購01,,,,,,0.00,0,0,0,0,0,0,0,0,0,0,0,0,0
20200520,709323,群聯麥證98購02,,,,,,0.00,0,0,0,0,0,0,0,0,0,0,0,0,0
20200520,709324,同致元富98購01,0.53,0.78,0.53,0.78,-0.07,-8.24,4000,2,2370,0,0,0,0,0,0,0,0,0,0
20200520,709325,神盾元富99購01,,,,,,0.00,0,0,0,0,0,0,0,0,0,0,0,0,0
20200520,709326,群聯元富98購01,,,,,,0.00,0,0,0,0,0,0,0,0,0,0,0,0,0
20200520,709327,碩禾元富9B購02,,,,,,0.00,0,0,0,0,0,0,0,0,0,0,0,0,0
20200520,709328,三貝德凱基98購01,0.29,0.29,0.29,0.29,0.00,0.0,10000,1,2900,0,0,0,0,0,0,0,10000,-10000,-10000
20200520,709329,大江凱基98購07,,,,,,0.00,0,0,0,0,0,0,0,0,0,0,0,0,0
20200520,709330,威剛凱基9A購02,,,,,,0.00,0,0,0,0,0,0,0,0,0,0,0,0,0
20200520,709331,雍智凱基99購01,1.83,2.09,1.74,1.86,+0.21,12.73,491000,50,925150,0,0,0,0,0,0,319000,166000,153000,153000
20200520,709332,環球晶凱基98購05,2.26,2.28,2.26,2.26,-0.05,-2.16,7000,3,15920,0,0,0,0,0,0,7000,7000,0,0
20200520,709333,聯亞凱基99購03,1.95,1.95,1.93,1.93,0.00,0.0,67000,2,129650,0,0,0,0,0,0,17000,50000,-33000,-33000
20200520,709334,穩懋凱基98購06,,,,,,0.00,0,0,0,0,0,0,0,0,0,0,0,0,0
20200520,709335,泰博永豐98購01,,,,,,0.00,0,0,0,0,0,0,0,0,0,0,0,0,0
20200520,709336,博智永豐98購01,1.26,1.26,1.12,1.16,-0.06,-4.92,162000,7,188870,0,0,0,0,0,0,160000,137000,23000,23000
20200520,709337,緯軟永豐98購01,,,,,,0.00,0,0,0,0,0,0,0,0,0,0,0,0,0
20200520,709338,環宇永豐98購02,,,,,,0.00,0,0,0,0,0,0,0,0,0,0,0,0,0
20200520,709339,VHQ統一99購01,,,,,,0.00,0,0,0,0,0,0,0,0,0,0,0,0,0
20200520,709340,大學光統一9A購01,2.02,2.13,2.02,2.13,+0.03,1.43,11000,2,23320,0,0,0,0,0,0,10000,0,10000,10000
20200520,709341,廣明統一99購01,1.57,1.60,1.55,1.60,0.00,0.0,78000,6,123180,0,0,0,0,0,0,47000,47000,0,0
20200520,709342,穩懋統一98購04,0.33,0.33,0.33,0.33,-0.09,-21.43,15000,1,4950,0,0,0,0,0,0,0,15000,-15000,-15000
20200520,709343,凡甲元大98購03,3.28,3.28,3.28,3.28,-0.04,-1.2,10000,1,32800,0,0,0,0,0,0,10000,0,10000,10000
20200520,709344,中美晶元大98購03,,,,,,0.00,0,0,0,0,0,0,0,0,0,0,0,0,0
20200520,709345,宇峻元大99購02,,,,,,0.00,0,0,0,0,0,0,0,0,0,0,0,0,0
20200520,709346,博智元大98購01,4.78,4.82,4.67,4.67,-0.14,-2.91,30000,4,142500,0,0,0,0,0,0,10000,20000,-10000,-10000
20200520,709347,群聯元大98購06,,,,,,0.00,0,0,0,0,0,0,0,0,0,0,0,0,0
20200520,709348,網家元大98購01,2.57,2.99,2.53,2.77,+0.42,17.87,208000,29,569060,0,0,0,0,0,0,142000,68000,74000,74000
20200520,709349,廣明元大98購01,1.32,1.34,1.31,1.31,-0.15,-10.27,245000,7,325780,0,0,0,0,0,0,195000,50000,145000,145000
20200520,709350,中美晶兆豐99購01,0.77,0.78,0.77,0.78,-0.03,-3.7,11000,2,8570,0,0,0,0,0,0,0,11000,-11000,-11000
20200520,709351,泰博兆豐98購01,,,,,,0.00,0,0,0,0,0,0,0,0,0,0,0,0,0
20200520,709352,精華兆豐99購01,0.99,0.99,0.99,0.99,-0.02,-1.98,22000,2,21780,0,0,0,0,0,0,22000,0,22000,22000
20200520,709353,頎邦兆豐98購01,0.61,0.61,0.60,0.61,-0.03,-4.69,44000,3,26720,0,0,0,0,0,0,44000,0,44000,44000
20200520,709354,M31群益9A購01,1.22,1.25,1.10,1.10,-0.03,-2.65,432000,21,524260,0,0,0,0,0,0,85000,347000,-262000,-262000
20200520,709355,中美晶群益98購02,,,,,,0.00,0,0,0,0,0,0,0,0,0,0,0,0,0
20200520,709356,宜鼎群益98購02,3.82,4.17,3.82,4.17,+0.40,10.61,32000,4,128920,0,0,0,0,0,0,2000,32000,-30000,-30000
20200520,709357,原相群益98購03,0.21,0.21,0.20,0.20,-0.11,-35.48,150000,9,30030,0,0,0,0,0,0,140000,147000,-7000,-7000
20200520,709358,譜瑞群益98購01,5.90,5.90,5.90,5.90,-0.10,-1.67,10000,1,59000,0,0,0,0,0,0,10000,0,10000,10000
20200520,709359,璟德國泰99購01,,,,,,0.00,0,0,0,0,0,0,0,0,0,0,0,0,0
20200520,709360,神盾富邦9A購01,0.36,0.36,0.36,0.36,0.00,0.0,2000,1,720,0,0,0,0,0,0,2000,2000,0,0
20200520,709361,群聯凱基98購05,2.19,2.19,2.18,2.18,+0.06,2.83,42000,2,91680,0,0,0,0,0,0,30000,12000,18000,18000
20200520,709362,網家凱基99購01,,,,,,0.00,0,0,0,0,0,0,0,0,0,0,0,0,0
20200520,709363,晟德凱基98購01,,,,,,0.00,0,0,0,0,0,0,0,0,0,0,0,0,0
20200520,709364,神盾統一98購02,,,,,,0.00,0,0,0,0,0,0,0,0,0,0,0,0,0
20200520,709365,VHQ元大99購02,,,,,,0.00,0,0,0,0,0,0,0,0,0,0,0,0,0
20200520,709366,中美晶元大98購04,,,,,,0.00,0,0,0,0,0,0,0,0,0,0,0,0,0
20200520,709367,兆利元大99購01,,,,,,0.00,0,0,0,0,0,0,0,0,0,0,0,0,0
20200520,709368,原相元大9A購02,,,,,,0.00,0,0,0,0,0,0,0,0,0,0,0,0,0
20200520,709369,群聯元大98購07,,,,,,0.00,0,0,0,0,0,0,0,0,0,0,0,0,0
20200520,709370,碩禾元大99購03,,,,,,0.00,0,0,0,0,0,0,0,0,0,0,0,0,0
20200520,709371,廣明元大98購02,1.31,1.35,1.31,1.35,-0.04,-2.88,44000,2,59120,0,0,0,0,0,0,7000,37000,-30000,-30000
20200520,709372,神盾第一9C購01,0.89,0.89,0.86,0.86,+0.01,1.18,155000,29,136330,0,0,0,0,0,0,145000,0,145000,145000
20200520,709373,三貝德永豐99購01,,,,,,0.00,0,0,0,0,0,0,0,0,0,0,0,0,0
20200520,709374,大田永豐98購01,1.23,1.27,1.14,1.27,+0.02,1.6,595000,17,703100,0,0,0,0,0,0,480000,175000,305000,305000
20200520,709375,大江永豐98購03,,,,,,0.00,0,0,0,0,0,0,0,0,0,0,0,0,0
20200520,709376,旺矽永豐98購01,1.10,1.10,1.10,1.10,0.00,0.0,10000,1,11000,0,0,0,0,0,0,10000,0,10000,10000
20200520,709377,勝麗永豐98購01,,,,,,0.00,0,0,0,0,0,0,0,0,0,0,0,0,0
20200520,709378,宜鼎兆豐99購01,0.97,1.05,0.97,1.05,+0.05,5.0,480000,15,479930,0,0,0,0,0,0,179000,301000,-122000,-122000
20200520,709379,神盾兆豐99購01,0.94,0.94,0.84,0.84,-0.08,-8.7,1257000,53,1109080,0,0,0,0,0,0,1104000,61000,1043000,1043000
20200520,709380,穩懋兆豐99購01,0.21,0.29,0.21,0.28,-0.04,-12.5,100000,10,27600,0,0,0,0,0,0,10000,90000,-80000,-80000
20200520,709381,網家康和98購01,0.99,1.09,0.99,1.09,+0.29,36.25,345000,13,363370,0,0,0,0,0,0,98000,247000,-149000,-149000
20200520,709382,大學光群益99購01,4.86,5.75,4.86,5.60,+0.35,6.67,61000,5,313530,0,0,0,0,0,0,38000,23000,15000,15000
20200520,709383,六角群益98購03,1.54,1.54,1.54,1.54,+0.06,4.05,98000,1,150920,0,0,0,0,0,0,0,98000,-98000,-98000
20200520,709384,迅得群益9A購01,0.55,0.57,0.55,0.55,0.00,0.0,108000,11,59720,0,0,0,0,0,0,68000,0,68000,68000
20200520,709385,環宇群益99購01,,,,,,0.00,0,0,0,0,0,0,0,0,0,0,0,0,0
20200520,709386,鈺太群益98購02,,,,,,0.00,0,0,0,0,0,0,0,0,0,0,0,0,0
20200520,709387,大學光統一99購02,2.86,3.42,2.76,3.42,+0.38,12.5,285000,12,880860,0,0,0,0,0,0,27000,258000,-231000,-231000
20200520,709388,穩懋統一98購05,,,,,,0.00,0,0,0,0,0,0,0,0,0,0,0,0,0
20200520,709389,原相中信9A購01,,,,,,0.00,0,0,0,0,0,0,0,0,0,0,0,0,0
20200520,709390,大學光凱基98購01,5.55,6.15,5.55,6.15,-1.30,-17.45,30000,3,178500,0,0,0,0,0,0,0,30000,-30000,-30000
20200520,709391,六角凱基98購01,0.88,0.88,0.88,0.88,+0.03,3.53,50000,2,44000,0,0,0,0,0,0,0,50000,-50000,-50000
20200520,709392,穩懋凱基98購07,,,,,,0.00,0,0,0,0,0,0,0,0,0,0,0,0,0
20200520,709393,宜鼎元富98購01,0.67,0.75,0.67,0.75,+0.07,10.29,80000,7,56150,0,0,0,0,0,0,65000,55000,10000,10000
20200520,709394,群聯元富98購02,,,,,,0.00,0,0,0,0,0,0,0,0,0,0,0,0,0
20200520,709395,譜瑞元富98購02,4.49,4.49,4.41,4.41,-0.13,-2.86,30000,11,134380,0,0,0,0,0,0,30000,0,30000,30000
20200520,709396,台燿元大98購01,,,,,,0.00,0,0,0,0,0,0,0,0,0,0,0,0,0
20200520,709397,神盾元大99購03,0.92,0.94,0.84,0.84,-0.01,-1.18,303000,23,273500,0,0,0,0,0,0,298000,25000,273000,273000
20200520,709398,精測元大99購01,,,,,,0.00,0,0,0,0,0,0,0,0,0,0,0,0,0
20200520,709399,穩懋元大98購05,1.58,1.58,1.49,1.52,-0.19,-11.11,7000,4,10640,0,0,0,0,0,0,6000,7000,-1000,-1000
20200520,709400,穩懋元大98購06,1.25,1.25,1.16,1.19,-0.16,-11.85,76000,11,94120,0,0,0,0,0,0,74000,8000,66000,66000
20200520,709401,穩懋元大98購07,1.46,1.46,1.38,1.39,-0.17,-10.9,94000,8,136190,0,0,0,0,0,0,24000,77000,-53000,-53000
20200520,709402,前鼎國票99購02,1.14,1.18,1.14,1.14,+0.03,2.7,230000,4,263340,0,0,0,0,0,0,171000,215000,-44000,-44000
20200520,709403,雙美國票9B購01,1.12,1.18,1.10,1.10,-0.03,-2.65,552000,5,633200,0,0,0,0,0,0,252000,302000,-50000,-50000
20200520,709404,雙鴻國票9A購01,,,,,,0.00,0,0,0,0,0,0,0,0,0,0,0,0,0
20200520,709405,譜瑞國票99購01,12.40,12.40,12.40,12.40,+0.80,6.9,6000,1,74400,0,0,0,0,0,0,6000,0,6000,6000
20200520,709406,博智國泰9A購01,,,,,,0.00,0,0,0,0,0,0,0,0,0,0,0,0,0
20200520,709407,大學光富邦9C購01,1.47,1.83,1.47,1.83,+0.16,9.58,119000,6,210540,0,0,0,0,0,0,1000,118000,-117000,-117000
20200520,709408,VHQ永豐99購01,,,,,,0.00,0,0,0,0,0,0,0,0,0,0,0,0,0
20200520,709409,力致永豐99購01,1.16,1.22,1.16,1.22,+0.07,6.09,23000,3,27780,0,0,0,0,0,0,1000,22000,-21000,-21000
20200520,709410,大學光永豐98購01,3.68,4.09,3.68,4.09,+0.31,8.2,17000,2,64610,0,0,0,0,0,0,12000,5000,7000,7000
20200520,709411,台燿永豐98購01,0.33,0.34,0.31,0.31,-0.03,-8.82,150000,17,48590,0,0,0,0,0,0,100000,50000,50000,50000
20200520,709412,立端永豐98購01,0.81,0.81,0.81,0.81,+0.03,3.85,27000,1,21870,0,0,0,0,0,0,0,27000,-27000,-27000
20200520,709413,合晶永豐98購03,,,,,,0.00,0,0,0,0,0,0,0,0,0,0,0,0,0
20200520,709414,東隆興永豐98購02,,,,,,0.00,0,0,0,0,0,0,0,0,0,0,0,0,0
20200520,709415,群聯永豐98購01,,,,,,0.00,0,0,0,0,0,0,0,0,0,0,0,0,0
20200520,709416,緯軟永豐98購02,,,,,,0.00,0,0,0,0,0,0,0,0,0,0,0,0,0
20200520,709417,穩懋永豐98購01,,,,,,0.00,0,0,0,0,0,0,0,0,0,0,0,0,0
20200520,709418,頎邦永豐98購01,0.45,0.45,0.45,0.45,-0.02,-4.26,35000,4,15750,0,0,0,0,0,0,20000,25000,-5000,-5000
20200520,709419,泰博兆豐98購02,7.60,7.60,7.60,7.60,+0.45,6.29,1000,1,7600,0,0,0,0,0,0,1000,0,1000,1000
20200520,709420,群聯兆豐99購01,,,,,,0.00,0,0,0,0,0,0,0,0,0,0,0,0,0
20200520,709421,大江群益98購02,0.75,0.75,0.75,0.75,-0.06,-7.41,20000,1,15000,0,0,0,0,0,0,20000,20000,0,0
20200520,709422,中美晶群益99購01,,,,,,0.00,0,0,0,0,0,0,0,0,0,0,0,0,0
20200520,709423,亞泰群益98購01,,,,,,0.00,0,0,0,0,0,0,0,0,0,0,0,0,0
20200520,709424,南光群益98購01,1.90,1.90,1.90,1.90,+0.10,5.56,65000,3,123500,0,0,0,0,0,0,0,65000,-65000,-65000
20200520,709425,璟德群益98購02,0.99,0.99,0.97,0.97,-0.03,-3.0,55000,2,53650,0,0,0,0,0,0,55000,0,55000,55000
20200520,709426,智擎中信98購01,0.28,0.28,0.27,0.27,0.00,0.0,15000,2,4100,0,0,0,0,0,0,0,15000,-15000,-15000
20200520,709427,力旺凱基98購01,2.00,2.00,2.00,2.00,+0.33,19.76,5000,1,10000,0,0,0,0,0,0,0,0,0,0
20200520,709428,三貝德凱基99購02,,,,,,0.00,0,0,0,0,0,0,0,0,0,0,0,0,0
20200520,709429,環球晶凱基99購03,,,,,,0.00,0,0,0,0,0,0,0,0,0,0,0,0,0
20200520,709430,穩懋凱基99購01,,,,,,0.00,0,0,0,0,0,0,0,0,0,0,0,0,0
20200520,709431,M31永豐99購01,1.12,1.19,1.12,1.19,+0.17,16.67,310000,15,358540,0,0,0,0,0,0,133000,177000,-44000,-44000
20200520,709432,力旺永豐98購01,1.32,1.40,1.16,1.19,+0.03,2.59,648000,51,847860,0,0,0,0,0,0,90000,558000,-468000,-468000
20200520,709433,大學光永豐98購02,3.81,4.91,3.81,4.88,+0.94,23.86,107000,18,489910,0,0,0,0,0,0,6000,101000,-95000,-95000
20200520,709434,宣德永豐98購02,1.01,1.01,1.01,1.01,+0.06,6.32,10000,1,10100,0,0,0,0,0,0,0,10000,-10000,-10000
20200520,709435,元太亞東99購01,6.70,7.75,6.70,7.75,+1.00,14.81,6000,4,41950,0,0,0,0,0,0,3000,1000,2000,2000
20200520,709436,穩懋麥證98購01,0.35,0.35,0.35,0.35,-0.05,-12.5,120000,3,42000,0,120000,-120000,0,0,0,0,120000,-120000,-120000
20200520,709437,M31元富98購01,1.15,1.23,1.10,1.10,0.00,0.0,1274000,50,1519430,0,0,0,0,0,0,840000,346000,494000,494000
20200520,709438,光頡元富98購01,,,,,,0.00,0,0,0,0,0,0,0,0,0,0,0,0,0
20200520,709439,優群元富98購01,,,,,,0.00,0,0,0,0,0,0,0,0,0,0,0,0,0
20200520,709440,三貝德元大99購01,,,,,,0.00,0,0,0,0,0,0,0,0,0,0,0,0,0
20200520,709441,神盾元大9A購03,,,,,,0.00,0,0,0,0,0,0,0,0,0,0,0,0,0
20200520,709442,神準元大98購01,0.62,0.64,0.62,0.64,+0.03,4.92,123000,3,77060,0,0,0,0,0,0,0,123000,-123000,-123000
20200520,709443,統新元大99購01,1.98,2.00,1.86,1.86,-0.08,-4.12,1058000,48,2059560,0,0,0,0,0,0,954000,103000,851000,851000
20200520,709444,博智元大98購02,6.55,6.55,6.55,6.55,-0.50,-7.09,11000,1,72050,0,0,0,0,0,0,0,11000,-11000,-11000
20200520,709445,雍智元大98購01,2.20,2.28,2.16,2.28,+0.28,14.0,212000,23,466280,0,0,0,0,0,0,212000,141000,71000,71000
20200520,709446,網家元大98購02,1.57,1.85,1.55,1.73,+0.27,18.49,904000,49,1523470,0,0,0,0,0,0,760000,412000,348000,348000
20200520,709447,緯軟元大99購01,0.76,0.76,0.76,0.76,+0.06,8.57,43000,2,32680,0,0,0,0,0,0,0,43000,-43000,-43000
20200520,709448,環球晶元大98購13,,,,,,0.00,0,0,0,0,0,0,0,0,0,0,0,0,0
20200520,709449,穩懋元大98購08,1.13,1.13,1.06,1.08,-0.16,-12.9,108000,8,119760,0,0,0,0,0,0,107000,8000,99000,99000
20200520,709450,宇峻國票99購01,0.75,0.78,0.74,0.77,-0.03,-3.75,91000,5,69630,0,0,0,0,0,0,0,91000,-91000,-91000
20200520,709451,大學光兆豐99購01,3.89,3.89,3.89,3.89,+0.21,5.71,1000,1,3890,0,0,0,0,0,0,1000,0,1000,1000
20200520,709452,原相兆豐99購01,,,,,,0.00,0,0,0,0,0,0,0,0,0,0,0,0,0
20200520,709453,穩懋兆豐98購02,,,,,,0.00,0,0,0,0,0,0,0,0,0,0,0,0,0
20200520,709454,網家群益98購01,0.98,0.98,0.98,0.98,+0.33,50.77,17000,1,16660,0,0,0,0,0,0,17000,0,17000,17000
20200520,709455,網家群益98購02,2.82,3.38,2.82,3.33,+0.63,23.33,427000,26,1289830,0,0,0,0,0,0,199000,228000,-29000,-29000
20200520,709456,穩懋統一9A購01,0.51,0.51,0.47,0.48,-0.06,-11.11,183000,7,91480,0,0,0,0,0,0,173000,10000,163000,163000
20200520,709457,譜瑞中信9A購01,,,,,,0.00,0,0,0,0,0,0,0,0,0,0,0,0,0
20200520,709458,大江凱基99購01,1.10,1.10,1.10,1.10,+0.04,3.77,20000,2,22000,0,0,0,0,0,0,0,20000,-20000,-20000
20200520,709459,中美晶凱基99購01,1.16,1.16,1.16,1.16,+0.03,2.65,50000,1,58000,0,0,0,0,0,0,50000,0,50000,50000
20200520,709460,穩懋凱基99購02,,,,,,0.00,0,0,0,0,0,0,0,0,0,0,0,0,0
20200520,709461,譜瑞麥證98購01,2.99,2.99,2.76,2.76,-0.04,-1.43,184000,4,538840,184000,0,184000,0,0,0,184000,0,184000,184000
20200520,709462,環球晶元富98購02,,,,,,0.00,0,0,0,0,0,0,0,0,0,0,0,0,0
20200520,709463,環球晶元富98購03,0.82,0.82,0.82,0.82,-0.05,-5.75,20000,1,16400,0,0,0,0,0,0,0,20000,-20000,-20000
20200520,709464,中美晶元大98購05,,,,,,0.00,0,0,0,0,0,0,0,0,0,0,0,0,0
20200520,709465,精測元大99購02,,,,,,0.00,0,0,0,0,0,0,0,0,0,0,0,0,0
20200520,709466,環球晶元大98購14,1.02,1.02,0.99,0.99,-0.04,-3.88,11000,2,11190,0,0,0,0,0,0,10000,1000,9000,9000
20200520,709467,譜瑞元大98購04,6.30,6.35,5.70,5.90,-0.25,-4.07,91000,10,561500,0,0,0,0,0,0,60000,36000,24000,24000
20200520,709468,穩懋日盛99購01,,,,,,0.00,0,0,0,0,0,0,0,0,0,0,0,0,0
20200520,709469,久元永豐98購01,0.95,1.07,0.88,1.03,+0.14,15.73,1549000,78,1508390,0,0,0,0,0,0,679000,848000,-169000,-169000
20200520,709470,原相永豐99購01,0.21,0.21,0.19,0.19,-0.04,-17.39,35000,3,6750,0,0,0,0,0,0,0,5000,-5000,-5000
20200520,709471,環球晶永豐98購02,0.17,0.17,0.17,0.17,-0.02,-10.53,3000,1,510,0,0,0,0,0,0,0,3000,-3000,-3000
20200520,709472,譜瑞永豐98購02,2.53,2.65,2.42,2.43,-0.02,-0.82,164000,6,407270,0,0,0,0,0,0,155000,9000,146000,146000
20200520,709473,網家台新98購01,0.91,1.11,0.91,1.04,+0.20,23.81,904000,53,891570,0,0,0,0,0,0,523000,371000,152000,152000
20200520,709474,台燿兆豐98購01,0.82,0.82,0.74,0.74,-0.08,-9.76,375000,26,298760,0,0,0,0,0,0,210000,155000,55000,55000
20200520,709475,晟德兆豐99購01,0.69,0.78,0.68,0.68,+0.07,11.48,243000,26,175230,0,0,0,0,0,0,93000,140000,-47000,-47000
20200520,709476,旺矽國票99購01,2.45,2.87,2.34,2.78,+0.32,13.01,490000,22,1226280,0,0,0,0,0,0,353000,137000,216000,216000
20200520,709477,璟德國票99購01,,,,,,0.00,0,0,0,0,0,0,0,0,0,0,0,0,0
20200520,709478,聯亞國票99購02,1.64,1.64,1.64,1.64,+0.02,1.23,10000,1,16400,0,0,0,0,0,0,10000,10000,0,0
20200520,709479,譜瑞國票99購02,9.55,9.55,9.55,9.55,-0.15,-1.55,1000,1,9550,0,0,0,0,0,0,1000,0,1000,1000
20200520,709480,宇峻康和98購01,0.25,0.25,0.25,0.25,+0.01,4.17,60000,10,15000,0,0,0,0,0,0,40000,20000,20000,20000
20200520,709481,凡甲群益98購02,,,,,,0.00,0,0,0,0,0,0,0,0,0,0,0,0,0
20200520,709482,大宇資群益9A購01,0.42,0.42,0.42,0.42,+0.02,5.0,70000,1,29400,0,0,0,0,0,0,70000,0,70000,70000
20200520,709483,迅得群益9A購02,0.58,0.58,0.58,0.58,+0.04,7.41,129000,1,74820,0,0,0,0,0,0,0,129000,-129000,-129000
20200520,709484,金居群益9A購01,1.94,1.94,1.94,1.94,-0.10,-4.9,4000,1,7760,0,0,0,0,0,0,4000,0,4000,4000
20200520,709485,晶焱群益9A購01,0.82,0.82,0.77,0.77,+0.02,2.67,30000,4,23980,0,0,0,0,0,0,20000,30000,-10000,-10000
20200520,709486,群聯群益98購02,,,,,,0.00,0,0,0,0,0,0,0,0,0,0,0,0,0
20200520,709487,環球晶群益98購02,,,,,,0.00,0,0,0,0,0,0,0,0,0,0,0,0,0
20200520,709488,大江國泰9A購02,,,,,,0.00,0,0,0,0,0,0,0,0,0,0,0,0,0
20200520,709489,譜瑞國泰9A購01,,,,,,0.00,0,0,0,0,0,0,0,0,0,0,0,0,0
20200520,709490,穩懋富邦9A購01,0.18,0.18,0.18,0.18,-0.03,-14.29,10000,1,1800,0,0,0,0,0,0,0,10000,-10000,-10000
20200520,709491,譜瑞富邦9A購01,1.17,1.20,1.15,1.15,-0.05,-4.17,108000,7,126800,0,0,0,0,0,0,80000,26000,54000,54000
20200520,709492,同致元富9B購01,1.22,1.25,1.22,1.25,+0.01,0.81,94000,11,116060,0,0,0,0,0,0,10000,0,10000,10000
20200520,709493,博智元富98購01,2.02,2.02,2.02,2.02,-0.12,-5.61,6000,1,12120,0,0,0,0,0,0,0,6000,-6000,-6000
20200520,709494,威剛統一9A購02,0.09,0.09,0.09,0.09,-0.01,-10.0,3000,1,270,0,0,0,0,0,0,3000,0,3000,3000
20200520,709495,譜瑞統一99購01,1.41,1.46,1.26,1.32,-0.05,-3.65,676000,33,925070,0,0,0,0,0,0,479000,178000,301000,301000
20200520,709496,中美晶凱基99購02,,,,,,0.00,0,0,0,0,0,0,0,0,0,0,0,0,0
20200520,709497,網家凱基98購01,0.95,1.07,0.93,1.07,+0.18,20.22,476000,41,479670,0,0,0,0,0,0,141000,295000,-154000,-154000
20200520,709498,網龍凱基98購02,1.74,1.83,1.65,1.65,-0.07,-4.07,218000,5,363170,0,0,0,0,0,0,37000,185000,-148000,-148000
20200520,709499,環球晶凱基98購07,,,,,,0.00,0,0,0,0,0,0,0,0,0,0,0,0,0
20200520,709500,環球晶凱基99購04,,,,,,0.00,0,0,0,0,0,0,0,0,0,0,0,0,0
20200520,709501,譜瑞凱基98購01,,,,,,0.00,0,0,0,0,0,0,0,0,0,0,0,0,0
20200520,709502,譜瑞凱基99購01,2.41,2.46,2.14,2.21,-0.07,-3.07,360000,30,844380,0,0,0,0,0,0,290000,177000,113000,113000
20200520,709503,譜瑞凱基9A購01,3.52,3.57,3.36,3.36,-0.34,-9.19,156000,23,546200,0,0,0,0,0,0,135000,21000,114000,114000
20200520,709504,合晶兆豐98購01,1.20,1.24,1.20,1.24,+0.05,4.2,169000,10,206560,0,0,0,0,0,0,6000,169000,-163000,-163000
20200520,709505,威剛兆豐99購01,0.31,0.31,0.31,0.31,0.00,0.0,10000,1,3100,0,0,0,0,0,0,0,10000,-10000,-10000
20200520,709506,聚積兆豐99購01,,,,,,0.00,0,0,0,0,0,0,0,0,0,0,0,0,0
20200520,709507,中美晶永豐98購02,,,,,,0.00,0,0,0,0,0,0,0,0,0,0,0,0,0
20200520,709508,尼克森永豐98購01,0.86,0.86,0.84,0.84,+0.18,27.27,196000,7,164850,0,0,0,0,0,0,1000,195000,-194000,-194000
20200520,709509,安勤永豐98購01,0.13,0.13,0.13,0.13,0.00,0.0,25000,2,3250,0,0,0,0,0,0,15000,10000,5000,5000
20200520,709510,信驊永豐98購01,3.80,3.88,3.71,3.71,+0.21,6.0,67000,18,254600,0,0,0,0,0,0,58000,8000,50000,50000
20200520,709511,博智永豐98購02,0.68,0.68,0.68,0.68,-0.04,-5.56,148000,3,100640,0,0,0,0,0,0,80000,68000,12000,12000
20200520,709512,網家永豐98購01,0.21,0.30,0.21,0.27,+0.07,35.0,447000,23,119220,0,0,0,0,0,0,140000,307000,-167000,-167000
20200520,709513,中美晶國票98購02,0.36,0.36,0.35,0.35,-0.04,-10.26,172000,3,61610,0,0,0,0,0,0,172000,0,172000,172000
20200520,709514,網家國票99購01,1.63,2.00,1.63,1.91,+0.50,35.46,327000,22,568700,0,0,0,0,0,0,225000,101000,124000,124000
20200520,709515,穩懋國票99購01,,,,,,0.00,0,0,0,0,0,0,0,0,0,0,0,0,0
20200520,709516,中美晶國泰9A購01,1.03,1.03,1.03,1.03,+0.01,0.98,49000,1,50470,0,0,0,0,0,0,49000,0,49000,49000
20200520,709517,太景*國泰9A購02,,,,,,0.00,0,0,0,0,0,0,0,0,0,0,0,0,0
20200520,709518,宇峻國泰9A購01,0.51,0.51,0.51,0.51,-0.03,-5.56,23000,2,11730,0,0,0,0,0,0,3000,20000,-17000,-17000
20200520,709519,威剛國泰99購01,0.78,0.78,0.72,0.72,-0.05,-6.49,192000,3,146760,0,0,0,0,0,0,192000,0,192000,192000
20200520,709520,原相國泰99購01,0.44,0.44,0.44,0.44,-0.10,-18.52,1000,1,440,0,0,0,0,0,0,1000,1000,0,0
20200520,709521,博智國泰9A購02,2.97,2.97,2.76,2.76,-0.13,-4.5,22000,3,65060,0,0,0,0,0,0,21000,1000,20000,20000
20200520,709522,環球晶國泰99購02,,,,,,0.00,0,0,0,0,0,0,0,0,0,0,0,0,0
20200520,709523,環球晶國泰9A購01,,,,,,0.00,0,0,0,0,0,0,0,0,0,0,0,0,0
20200520,709524,鈊象國泰9A購01,,,,,,0.00,0,0,0,0,0,0,0,0,0,0,0,0,0
20200520,709525,譜瑞台新98購01,2.69,2.73,2.38,2.38,-0.19,-7.39,240000,18,643140,0,0,0,0,0,0,230000,10000,220000,220000
20200520,709526,大學光富邦98購01,,,,,,0.00,0,0,0,0,0,0,0,0,0,0,0,0,0
20200520,709527,力旺群益99購01,1.92,2.03,1.71,1.72,-0.01,-0.58,264000,18,518610,0,0,0,0,0,0,93000,202000,-109000,-109000
20200520,709528,中美晶群益99購02,,,,,,0.00,0,0,0,0,0,0,0,0,0,0,0,0,0
20200520,709529,宜鼎群益98購03,1.76,1.90,1.76,1.90,+0.08,4.4,263000,18,487700,0,0,0,0,0,0,31000,233000,-202000,-202000
20200520,709530,神盾群益9A購03,,,,,,0.00,0,0,0,0,0,0,0,0,0,0,0,0,0
20200520,709531,碩禾群益98購01,,,,,,0.00,0,0,0,0,0,0,0,0,0,0,0,0,0
20200520,709532,精測群益98購01,0.30,0.30,0.28,0.28,-0.04,-12.5,499000,10,144700,0,0,0,0,0,0,240000,259000,-19000,-19000
20200520,709533,譜瑞群益98購02,4.25,4.41,4.07,4.07,-0.45,-9.96,104000,8,443230,0,0,0,0,0,0,75000,29000,46000,46000
20200520,709534,M31元大9A購01,0.99,1.05,0.92,0.92,-0.02,-2.13,402000,24,408980,0,0,0,0,0,0,254000,157000,97000,97000
20200520,709535,宣德元大99購02,2.39,2.52,2.35,2.52,+0.13,5.44,623000,25,1510650,0,0,0,0,0,0,124000,499000,-375000,-375000
20200520,709536,網家元大98購03,2.38,2.71,2.34,2.71,+0.37,15.81,87000,8,217240,0,0,0,0,0,0,21000,66000,-45000,-45000
20200520,709537,環球晶元大9A購01,,,,,,0.00,0,0,0,0,0,0,0,0,0,0,0,0,0
20200520,709538,穩懋元大98購09,1.66,1.66,1.57,1.59,-0.14,-8.09,6000,3,9530,0,0,0,0,0,0,6000,6000,0,0
20200520,709539,鈺太元大99購03,1.29,1.29,1.26,1.26,+0.08,6.78,104000,10,133400,0,0,0,0,0,0,100000,36000,64000,64000
20200520,709540,雍智元富98購01,2.28,2.61,2.17,2.29,+0.31,15.66,1735000,197,4057920,0,0,0,0,0,0,894000,990000,-96000,-96000
20200520,709541,環球晶中信99購03,0.10,0.10,0.10,0.10,-0.02,-16.67,230000,2,23000,0,0,0,0,0,0,130000,100000,30000,30000
20200520,709542,大江凱基9A購01,0.74,0.74,0.74,0.74,0.00,0.0,50000,1,37000,0,0,0,0,0,0,0,50000,-50000,-50000
20200520,709543,中美晶凱基9A購02,0.09,0.09,0.09,0.09,-0.07,-43.75,3000,1,270,0,0,0,0,0,0,3000,3000,0,0
20200520,709544,台半凱基98購02,,,,,,0.00,0,0,0,0,0,0,0,0,0,0,0,0,0
20200520,709545,安勤凱基98購01,,,,,,0.00,0,0,0,0,0,0,0,0,0,0,0,0,0
20200520,709546,環球晶凱基99購05,,,,,,0.00,0,0,0,0,0,0,0,0,0,0,0,0,0
20200520,709547,穩懋凱基98購09,,,,,,0.00,0,0,0,0,0,0,0,0,0,0,0,0,0
20200520,709548,威剛統一99購01,,,,,,0.00,0,0,0,0,0,0,0,0,0,0,0,0,0
20200520,709549,網家統一9A購01,0.54,0.68,0.54,0.61,+0.11,22.0,2645000,112,1558820,0,0,0,0,0,0,881000,1689000,-808000,-808000
20200520,709550,環球晶統一99購03,,,,,,0.00,0,0,0,0,0,0,0,0,0,0,0,0,0
20200520,709551,大江元大99購02,2.89,2.92,2.89,2.92,+0.06,2.1,219000,8,638390,0,0,0,0,0,0,177000,42000,135000,135000
20200520,709552,神盾元大99購04,1.10,1.13,0.97,0.97,-0.09,-8.49,347000,29,371490,0,0,0,0,0,0,334000,10000,324000,324000
20200520,709553,博智元大98購03,3.01,3.01,2.79,2.86,-0.22,-7.14,141000,10,414550,0,0,0,0,0,0,50000,91000,-41000,-41000
20200520,709554,群聯元大99購03,,,,,,0.00,0,0,0,0,0,0,0,0,0,0,0,0,0
20200520,709555,譜瑞元大98購06,6.70,6.80,6.65,6.80,-0.20,-2.86,66000,9,442700,0,0,0,0,0,0,49000,23000,26000,26000
20200520,709556,威剛國票99購01,,,,,,0.00,0,0,0,0,0,0,0,0,0,0,0,0,0
20200520,709557,神盾國票99購01,1.11,1.11,1.04,1.04,-0.08,-7.14,55000,2,60700,0,0,0,0,0,0,50000,5000,45000,45000
20200520,709558,廣明國票99購01,1.67,1.68,1.65,1.68,-0.06,-3.45,284000,5,470980,0,0,0,0,0,0,180000,104000,76000,76000
20200520,709559,環球晶國票99購01,,,,,,0.00,0,0,0,0,0,0,0,0,0,0,0,0,0
20200520,709560,雙美國票99購02,2.18,2.20,2.18,2.20,-0.05,-2.22,3000,2,6560,0,0,0,0,0,0,3000,3000,0,0
20200520,709561,聚積國泰99購01,0.47,0.47,0.46,0.46,-0.01,-2.13,20000,2,9300,0,0,0,0,0,0,20000,0,20000,20000
20200520,709562,中美晶群益98購03,,,,,,0.00,0,0,0,0,0,0,0,0,0,0,0,0,0
20200520,709563,合晶群益98購02,1.00,1.03,0.99,1.03,+0.04,4.04,99000,3,98550,0,0,0,0,0,0,1000,99000,-98000,-98000
20200520,709564,旺矽群益99購01,1.17,1.33,1.11,1.27,+0.12,10.43,701000,31,865560,0,0,0,0,0,0,71000,630000,-559000,-559000
20200520,709565,宣德群益98購02,2.00,2.20,2.00,2.20,+0.20,10.0,277000,11,579100,0,0,0,0,0,0,97000,183000,-86000,-86000
20200520,709566,鈺太群益98購03,,,,,,0.00,0,0,0,0,0,0,0,0,0,0,0,0,0
20200520,709567,穩懋台新98購02,,,,,,0.00,0,0,0,0,0,0,0,0,0,0,0,0,0
20200520,709568,原相亞東99購02,,,,,,0.00,0,0,0,0,0,0,0,0,0,0,0,0,0
20200520,709569,群聯亞東98購01,,,,,,0.00,0,0,0,0,0,0,0,0,0,0,0,0,0
20200520,709570,直得永豐98購01,,,,,,0.00,0,0,0,0,0,0,0,0,0,0,0,0,0
20200520,709571,網龍永豐98購02,1.64,1.64,1.52,1.52,-0.15,-8.98,81000,3,126340,0,0,0,0,0,0,61000,20000,41000,41000
20200520,709572,聚積永豐98購01,,,,,,0.00,0,0,0,0,0,0,0,0,0,0,0,0,0
20200520,709573,鈺太永豐98購01,,,,,,0.00,0,0,0,0,0,0,0,0,0,0,0,0,0
20200520,709574,元太台新98購02,3.00,3.54,3.00,3.54,+0.71,25.09,14000,2,47400,0,0,0,0,0,0,0,14000,-14000,-14000
20200520,709575,中美晶元大98購06,,,,,,0.00,0,0,0,0,0,0,0,0,0,0,0,0,0
20200520,709576,原相元大9A購03,,,,,,0.00,0,0,0,0,0,0,0,0,0,0,0,0,0
20200520,709577,泰博元大98購01,9.75,10.50,9.60,10.50,+1.20,12.9,62000,6,606500,0,0,0,0,0,0,30000,32000,-2000,-2000
20200520,709578,聚積元大9A購01,0.41,0.41,0.39,0.39,0.00,0.0,30000,2,11900,0,0,0,0,0,0,0,30000,-30000,-30000
20200520,709579,環球晶元大98購15,0.60,0.60,0.60,0.60,-0.03,-4.76,5000,1,3000,0,0,0,0,0,0,0,5000,-5000,-5000
20200520,709580,宇峻中信98購01,0.22,0.27,0.22,0.27,+0.04,17.39,40000,4,9800,0,0,0,0,0,0,0,40000,-40000,-40000
20200520,709581,原相統一99購02,,,,,,0.00,0,0,0,0,0,0,0,0,0,0,0,0,0
20200520,709582,雙鴻統一99購02,0.75,0.75,0.72,0.72,-0.03,-4.0,53000,2,38550,0,0,0,0,0,0,53000,0,53000,53000
20200520,709583,大宇資凱基99購01,0.25,0.25,0.23,0.24,-0.01,-4.0,93000,4,22720,0,0,0,0,0,0,93000,0,93000,93000
20200520,709584,威剛凱基98購01,0.69,0.69,0.67,0.67,-0.02,-2.9,70000,2,48100,0,0,0,0,0,0,70000,0,70000,70000
20200520,709585,博智凱基9A購01,,,,,,0.00,0,0,0,0,0,0,0,0,0,0,0,0,0
20200520,709586,精測凱基99購02,,,,,,0.00,0,0,0,0,0,0,0,0,0,0,0,0,0
20200520,709587,譜瑞凱基98購02,,,,,,0.00,0,0,0,0,0,0,0,0,0,0,0,0,0
20200520,709588,中美晶群益98購04,,,,,,0.00,0,0,0,0,0,0,0,0,0,0,0,0,0
20200520,709589,元太群益99購01,3.09,4.00,3.06,4.00,+0.89,28.62,820000,56,2711290,0,0,0,0,0,0,546000,295000,251000,251000
20200520,709590,網家群益98購03,,,,,,0.00,0,0,0,0,0,0,0,0,0,0,0,0,0
20200520,709591,譜瑞群益98購03,4.18,4.29,3.91,3.91,-0.26,-6.24,85000,8,354770,0,0,0,0,0,0,80000,3000,77000,77000
20200520,709592,泰博國票99購03,8.95,8.95,8.95,8.95,+0.90,11.18,1000,1,8950,0,0,0,0,0,0,0,1000,-1000,-1000
20200520,709593,合晶國泰99購02,,,,,,0.00,0,0,0,0,0,0,0,0,0,0,0,0,0
20200520,709594,保瑞國泰9A購01,,,,,,0.00,0,0,0,0,0,0,0,0,0,0,0,0,0
20200520,709595,璟德兆豐99購01,0.34,0.34,0.34,0.34,+0.02,6.25,29000,3,9860,0,0,0,0,0,0,29000,0,29000,29000
20200520,709596,亞泰永豐99購02,,,,,,0.00,0,0,0,0,0,0,0,0,0,0,0,0,0
20200520,709597,保瑞永豐98購01,,,,,,0.00,0,0,0,0,0,0,0,0,0,0,0,0,0
20200520,709598,建榮永豐99購03,,,,,,0.00,0,0,0,0,0,0,0,0,0,0,0,0,0
20200520,709599,神盾永豐98購01,0.56,0.56,0.56,0.56,-0.06,-9.68,10000,1,5600,0,0,0,0,0,0,10000,0,10000,10000
20200520,709600,新鉅科永豐98購02,,,,,,0.00,0,0,0,0,0,0,0,0,0,0,0,0,0
20200520,709601,雙美永豐99購02,0.96,0.96,0.91,0.91,+0.01,1.11,12000,2,11020,0,0,0,0,0,0,12000,12000,0,0
20200520,709602,穩懋永豐98購03,,,,,,0.00,0,0,0,0,0,0,0,0,0,0,0,0,0
20200520,709603,晟德永豐98購01,1.06,1.07,1.06,1.07,+0.15,16.3,69000,2,73150,0,0,0,0,0,0,69000,0,69000,69000
20200520,709604,鈊象永豐98購03,0.44,0.44,0.44,0.44,-0.04,-8.33,266000,1,117040,0,0,0,0,0,0,266000,0,266000,266000
20200520,709605,中美晶元富99購02,,,,,,0.00,0,0,0,0,0,0,0,0,0,0,0,0,0
20200520,709606,尼克森元富98購01,,,,,,0.00,0,0,0,0,0,0,0,0,0,0,0,0,0
20200520,709607,博智元富98購02,1.92,1.94,1.85,1.85,-0.22,-10.63,73000,5,140550,0,0,0,0,0,0,73000,0,73000,73000
20200520,709608,網龍元富98購01,1.70,1.73,1.59,1.59,-0.06,-3.64,54000,6,89000,0,0,0,0,0,0,10000,44000,-34000,-34000
20200520,709609,穩懋元富02購01,0.92,0.92,0.92,0.92,-0.07,-7.07,5000,1,4600,0,0,0,0,0,0,0,5000,-5000,-5000
20200520,709610,穩懋元富02購02,1.65,1.65,1.59,1.59,-0.12,-7.02,173000,8,283450,0,0,0,0,0,0,0,173000,-173000,-173000
20200520,709611,穩懋元富02購03,,,,,,0.00,0,0,0,0,0,0,0,0,0,0,0,0,0
20200520,709612,穩懋元富02購04,1.59,1.59,1.55,1.55,-0.11,-6.63,5000,2,7830,0,0,0,0,0,0,0,5000,-5000,-5000
20200520,709613,凡甲凱基98購02,,,,,,0.00,0,0,0,0,0,0,0,0,0,0,0,0,0
20200520,709614,中美晶凱基99購03,,,,,,0.00,0,0,0,0,0,0,0,0,0,0,0,0,0
20200520,709615,緯軟凱基98購04,,,,,,0.00,0,0,0,0,0,0,0,0,0,0,0,0,0
20200520,709616,大江兆豐99購01,1.37,1.38,1.29,1.30,-0.03,-2.26,409000,14,535910,0,0,0,0,0,0,53000,356000,-303000,-303000
20200520,709617,大江群益98購03,,,,,,0.00,0,0,0,0,0,0,0,0,0,0,0,0,0
20200520,709618,安勤群益98購01,,,,,,0.00,0,0,0,0,0,0,0,0,0,0,0,0,0
20200520,709619,杰力群益98購01,1.73,1.90,1.73,1.88,+0.13,7.43,655000,21,1194360,0,8000,-8000,0,0,0,61000,592000,-531000,-539000
20200520,709620,群聯群益98購03,2.47,2.49,2.40,2.46,-0.11,-4.28,48000,9,118280,0,0,0,0,0,0,48000,7000,41000,41000
20200520,709621,環球晶群益98購04,1.81,1.82,1.72,1.72,-0.13,-7.03,31000,5,53890,0,0,0,0,0,0,6000,31000,-25000,-25000
20200520,709622,M31永豐98購02,0.98,0.98,0.96,0.98,+0.08,8.89,80000,6,78000,0,0,0,0,0,0,0,80000,-80000,-80000
20200520,709623,尼克森永豐98購02,0.88,0.88,0.83,0.83,+0.16,23.88,186000,8,161650,0,0,0,0,0,0,0,186000,-186000,-186000
20200520,709624,泰博永豐99購01,3.12,3.46,3.10,3.46,+0.47,15.72,44000,6,142220,0,0,0,0,0,0,23000,21000,2000,2000
20200520,709625,力旺國票99購01,2.98,3.32,2.81,2.82,0.00,0.0,164000,15,507650,0,0,0,0,0,0,4000,158000,-154000,-154000
20200520,709626,建榮國票9A購01,,,,,,0.00,0,0,0,0,0,0,0,0,0,0,0,0,0
20200520,709627,博智國票99購01,2.58,2.58,2.58,2.58,-0.39,-13.13,15000,1,38700,0,0,0,0,0,0,15000,15000,0,0
20200520,709628,優群國票99購01,,,,,,0.00,0,0,0,0,0,0,0,0,0,0,0,0,0
20200520,709629,環球晶國票99購02,,,,,,0.00,0,0,0,0,0,0,0,0,0,0,0,0,0
20200520,709630,聯亞國票99購03,,,,,,0.00,0,0,0,0,0,0,0,0,0,0,0,0,0
20200520,709631,大中元大98購01,0.79,0.88,0.79,0.83,+0.06,7.79,187000,9,153490,0,0,0,0,0,0,136000,91000,45000,45000
20200520,709632,合晶元大99購01,2.73,2.74,2.69,2.74,+0.21,8.3,95000,9,257750,0,0,0,0,0,0,5000,95000,-90000,-90000
20200520,709633,宜鼎元大99購01,0.95,1.03,0.95,1.03,+0.05,5.1,501000,20,499650,0,0,0,0,0,0,226000,401000,-175000,-175000
20200520,709634,保瑞元大98購02,1.54,1.54,1.54,1.54,+0.03,1.99,68000,1,104720,0,0,0,0,0,0,0,68000,-68000,-68000
20200520,709635,譜瑞元大98購07,3.31,3.36,3.00,3.00,-0.20,-6.25,386000,38,1257900,0,0,0,0,0,0,260000,126000,134000,134000
20200520,709636,晟德元大98購01,1.47,1.67,1.38,1.58,+0.15,10.49,1027000,34,1571730,45000,0,45000,0,0,0,292000,633000,-341000,-296000
20200520,709637,安勤元富98購01,,,,,,0.00,0,0,0,0,0,0,0,0,0,0,0,0,0
20200520,709638,威剛富邦9A購01,,,,,,0.00,0,0,0,0,0,0,0,0,0,0,0,0,0
20200520,709639,雙鴻富邦99購01,,,,,,0.00,0,0,0,0,0,0,0,0,0,0,0,0,0
20200520,709640,博智台新98購01,0.85,0.85,0.79,0.84,-0.09,-9.68,67000,12,56280,0,0,0,0,0,0,14000,53000,-39000,-39000
20200520,709641,久元群益98購01,2.08,2.42,2.06,2.38,+0.29,13.88,1234000,61,2726640,0,0,0,0,0,0,764000,523000,241000,241000
20200520,709642,群聯群益98購04,,,,,,0.00,0,0,0,0,0,0,0,0,0,0,0,0,0
20200520,709643,聖暉群益98購01,2.32,2.32,2.20,2.28,-0.07,-2.98,85000,8,192840,0,0,0,0,0,0,26000,59000,-33000,-33000
20200520,709644,璟德中信98購01,1.74,1.74,1.70,1.71,+0.02,1.18,30000,3,51500,0,0,0,0,0,0,10000,20000,-10000,-10000
20200520,709645,合晶統一9A購01,0.69,0.72,0.69,0.71,+0.04,5.97,913000,13,648740,0,0,0,0,0,0,2000,911000,-909000,-909000
20200520,709646,神盾統一99購01,0.91,0.91,0.82,0.82,-0.07,-7.87,340000,47,294440,0,0,0,0,0,0,340000,0,340000,340000
20200520,709647,環球晶統一99購04,,,,,,0.00,0,0,0,0,0,0,0,0,0,0,0,0,0
20200520,709648,穩懋統一98購06,0.83,0.83,0.83,0.83,-0.10,-10.75,5000,1,4150,0,0,0,0,0,0,0,5000,-5000,-5000
20200520,709649,中美晶凱基99購04,,,,,,0.00,0,0,0,0,0,0,0,0,0,0,0,0,0
20200520,709650,精測凱基98購05,0.44,0.44,0.44,0.44,0.00,0.0,10000,1,4400,0,0,0,0,0,0,0,10000,-10000,-10000
20200520,709651,聯亞凱基99購04,,,,,,0.00,0,0,0,0,0,0,0,0,0,0,0,0,0
20200520,709652,大學光國票99購01,,,,,,0.00,0,0,0,0,0,0,0,0,0,0,0,0,0
20200520,709653,原相國票99購02,,,,,,0.00,0,0,0,0,0,0,0,0,0,0,0,0,0
20200520,709654,安勤國泰99購01,,,,,,0.00,0,0,0,0,0,0,0,0,0,0,0,0,0
20200520,709655,大江元大98購03,3.08,3.09,3.08,3.09,+0.07,2.32,150000,3,463000,0,0,0,0,0,0,150000,0,150000,150000
20200520,709656,中美晶元大99購03,1.25,1.25,1.21,1.21,-0.04,-3.2,58000,5,71410,0,0,0,0,0,0,0,58000,-58000,-58000
20200520,709657,宇峻元大99購03,,,,,,0.00,0,0,0,0,0,0,0,0,0,0,0,0,0
20200520,709658,博智元大99購01,3.45,3.45,3.45,3.45,-0.10,-2.82,50000,1,172500,0,0,0,0,0,0,0,50000,-50000,-50000
20200520,709659,網家元大99購02,,,,,,0.00,0,0,0,0,0,0,0,0,0,0,0,0,0
20200520,709660,環球晶元大98購16,0.93,0.93,0.87,0.87,-0.07,-7.45,95000,6,87250,0,0,0,0,0,0,1000,94000,-93000,-93000
20200520,709661,環球晶元大99購02,1.06,1.09,1.06,1.09,-0.02,-1.8,3000,3,3230,0,0,0,0,0,0,1000,2000,-1000,-1000
20200520,709662,穩懋元大98購10,1.81,1.81,1.70,1.70,-0.14,-7.61,56000,4,100920,0,0,0,0,0,0,5000,56000,-51000,-51000
20200520,709663,譜瑞元大98購08,6.40,6.45,6.40,6.45,+0.15,2.38,54000,2,347100,0,0,0,0,0,0,24000,30000,-6000,-6000
20200520,709664,神盾第一9C購02,1.08,1.09,1.05,1.06,+0.02,1.92,250000,31,269670,0,0,0,0,0,0,220000,0,220000,220000
20200520,709665,台半永豐98購01,0.12,0.12,0.11,0.11,0.00,0.0,60000,4,6900,0,0,0,0,0,0,0,60000,-60000,-60000
20200520,709666,兆利永豐98購02,,,,,,0.00,0,0,0,0,0,0,0,0,0,0,0,0,0
20200520,709667,金居永豐98購02,0.75,0.76,0.71,0.71,-0.11,-13.41,95000,9,70960,0,0,0,0,0,0,0,95000,-95000,-95000
20200520,709668,宣德永豐98購03,1.11,1.11,1.11,1.11,+0.05,4.72,10000,1,11100,0,0,0,0,0,0,0,10000,-10000,-10000
20200520,709669,博智永豐99購01,0.59,0.59,0.59,0.59,-0.05,-7.81,4000,1,2360,0,0,0,0,0,0,0,4000,-4000,-4000
20200520,709670,晶焱永豐98購03,0.90,0.90,0.90,0.90,-0.01,-1.1,14000,1,12600,0,0,0,0,0,0,14000,0,14000,14000
20200520,709671,雍智永豐99購01,1.67,1.90,1.66,1.87,+0.33,21.43,417000,32,723350,0,0,0,0,0,0,166000,251000,-85000,-85000
20200520,709672,環宇永豐98購03,,,,,,0.00,0,0,0,0,0,0,0,0,0,0,0,0,0
20200520,709673,環球晶元富98購04,,,,,,0.00,0,0,0,0,0,0,0,0,0,0,0,0,0
20200520,709674,力旺元大98購01,5.30,5.45,4.78,4.80,+0.13,2.78,175000,16,878640,0,0,0,0,0,0,5000,170000,-165000,-165000
20200520,709675,力旺元大98購02,2.90,3.00,2.80,2.82,+0.33,13.25,19000,4,54400,0,0,0,0,0,0,12000,4000,8000,8000
20200520,709676,中美晶元大98購08,1.02,1.03,1.02,1.03,0.00,0.0,68000,2,69940,0,0,0,0,0,0,0,68000,-68000,-68000
20200520,709677,聚積元大99購01,0.41,0.42,0.41,0.42,+0.02,5.0,15000,2,6250,0,0,0,0,0,0,10000,5000,5000,5000
20200520,709678,聯亞元大98購05,0.86,0.86,0.83,0.83,-0.01,-1.19,25000,3,21100,0,0,0,0,0,0,10000,25000,-15000,-15000
20200520,709679,譜瑞元大98購09,3.96,4.04,3.52,3.56,-0.36,-9.18,154000,16,598810,0,0,0,0,0,0,74000,80000,-6000,-6000
20200520,709680,中美晶國票99購01,,,,,,0.00,0,0,0,0,0,0,0,0,0,0,0,0,0
20200520,709681,宣德國票98購02,2.19,2.37,2.10,2.37,+0.21,9.72,286000,10,627100,0,0,0,0,0,0,229000,58000,171000,171000
20200520,709682,建榮國票9A購02,,,,,,0.00,0,0,0,0,0,0,0,0,0,0,0,0,0
20200520,709683,網家國票99購02,3.59,4.15,3.59,4.15,+0.95,29.69,169000,14,635470,0,0,0,0,0,0,73000,96000,-23000,-23000
20200520,709684,雍智國泰9A購01,2.08,2.31,1.99,2.13,+0.21,10.94,2624000,157,5587540,0,0,0,0,0,0,1037000,1503000,-466000,-466000
20200520,709685,安勤統一98購01,,,,,,0.00,0,0,0,0,0,0,0,0,0,0,0,0,0
20200520,709686,元太中信9A購01,2.05,2.42,2.05,2.42,+0.38,18.63,450000,51,991730,0,0,0,0,0,0,159000,275000,-116000,-116000
20200520,709687,台燿中信9A購01,0.73,0.74,0.66,0.67,-0.03,-4.29,418000,44,293420,0,0,0,0,0,0,237000,161000,76000,76000
20200520,709688,合晶中信9A購02,,,,,,0.00,0,0,0,0,0,0,0,0,0,0,0,0,0
20200520,709689,中美晶凱基99購05,,,,,,0.00,0,0,0,0,0,0,0,0,0,0,0,0,0
20200520,709690,六角凱基99購03,,,,,,0.00,0,0,0,0,0,0,0,0,0,0,0,0,0
20200520,709691,智崴凱基98購01,0.16,0.16,0.16,0.16,0.00,0.0,60000,6,9600,0,0,0,0,0,0,0,0,0,0
20200520,709692,昇達科永豐98購01,0.46,0.46,0.46,0.46,+0.01,2.22,10000,1,4600,0,0,0,0,0,0,0,10000,-10000,-10000
20200520,709693,建榮永豐99購04,1.13,1.13,1.13,1.13,+0.03,2.73,10000,1,11300,0,0,0,0,0,0,0,10000,-10000,-10000
20200520,709694,順達永豐98購01,2.26,2.63,2.22,2.61,+0.40,18.1,216000,22,515880,0,0,0,0,0,0,20000,196000,-176000,-176000
20200520,709695,精測永豐98購01,,,,,,0.00,0,0,0,0,0,0,0,0,0,0,0,0,0
20200520,709696,穩懋永豐98購04,,,,,,0.00,0,0,0,0,0,0,0,0,0,0,0,0,0
20200520,709697,鈊象永豐99購01,0.38,0.38,0.37,0.37,-0.03,-7.5,115000,3,42650,0,0,0,0,0,0,0,115000,-115000,-115000
20200520,709698,力旺中信99購01,2.45,4.34,2.19,2.25,-0.20,-8.16,686000,67,1739250,0,0,0,0,0,0,511000,140000,371000,371000
20200520,709699,凡甲元大9A購02,,,,,,0.00,0,0,0,0,0,0,0,0,0,0,0,0,0
20200520,709700,安勤元大99購01,0.61,0.61,0.61,0.61,+0.04,7.02,20000,1,12200,0,0,0,0,0,0,0,20000,-20000,-20000
20200520,709701,宏捷科元大99購01,,,,,,0.00,0,0,0,0,0,0,0,0,0,0,0,0,0
20200520,709702,宜鼎元大9A購01,0.91,1.00,0.91,1.00,+0.07,7.53,523000,29,500070,0,0,0,0,0,0,312000,204000,108000,108000
20200520,709703,直得元大99購01,1.78,1.85,1.78,1.85,+0.11,6.32,120000,4,215700,0,0,0,0,0,0,20000,115000,-95000,-95000
20200520,709704,南光元大99購01,1.23,1.28,1.21,1.24,+0.04,3.33,826000,20,1025480,0,0,0,0,0,0,330000,476000,-146000,-146000
20200520,709705,原相元大99購03,0.41,0.41,0.41,0.41,-0.04,-8.89,10000,2,4100,0,0,0,0,0,0,7000,0,7000,7000
20200520,709706,新鉅科元大99購01,,,,,,0.00,0,0,0,0,0,0,0,0,0,0,0,0,0
20200520,709707,穩懋元大99購02,,,,,,0.00,0,0,0,0,0,0,0,0,0,0,0,0,0
20200520,709708,晟德元大99購01,1.67,1.88,1.67,1.80,+0.15,9.09,1144000,43,2034040,0,0,0,0,0,0,78000,1066000,-988000,-988000
20200520,709709,大宇資國票9A購01,,,,,,0.00,0,0,0,0,0,0,0,0,0,0,0,0,0
20200520,709710,宏捷科國票9A購01,,,,,,0.00,0,0,0,0,0,0,0,0,0,0,0,0,0
20200520,709711,穩懋國泰9A購01,1.71,1.71,1.61,1.61,-0.12,-6.94,116000,6,193460,0,0,0,0,0,0,36000,35000,1000,1000
20200520,709712,穩懋國泰9B購01,,,,,,0.00,0,0,0,0,0,0,0,0,0,0,0,0,0
20200520,709713,亞泰元富99購01,1.25,1.31,1.25,1.31,+0.05,3.97,153000,4,193640,0,0,0,0,0,0,50000,103000,-53000,-53000
20200520,709714,合晶統一9A購02,1.16,1.19,1.15,1.18,+0.04,3.51,186000,11,216640,0,0,0,0,0,0,7000,186000,-179000,-179000
20200520,709715,宏捷科統一9A購01,0.56,0.56,0.54,0.54,-0.03,-5.26,118000,6,64860,0,0,0,0,0,0,51000,67000,-16000,-16000
20200520,709716,泰博統一9A購01,4.12,4.36,4.12,4.36,+0.37,9.27,26000,3,110320,0,0,0,0,0,0,0,26000,-26000,-26000
20200520,709717,神盾統一9A購01,0.53,0.53,0.47,0.47,-0.03,-6.0,259000,6,129810,0,0,0,0,0,0,123000,136000,-13000,-13000
20200520,709718,雙鴻統一9A購01,0.81,0.81,0.78,0.78,-0.02,-2.5,94000,3,75300,0,0,0,0,0,0,94000,0,94000,94000
20200520,709719,宏捷科日盛99購01,,,,,,0.00,0,0,0,0,0,0,0,0,0,0,0,0,0
20200520,709720,VHQ凱基9A購01,0.63,0.66,0.63,0.66,+0.02,3.12,150000,4,97930,0,0,0,0,0,0,150000,0,150000,150000
20200520,709721,三貝德凱基9A購01,,,,,,0.00,0,0,0,0,0,0,0,0,0,0,0,0,0
20200520,709722,太景*凱基99購01,,,,,,0.00,0,0,0,0,0,0,0,0,0,0,0,0,0
20200520,709723,宏捷科凱基99購01,0.54,0.55,0.54,0.55,-0.01,-1.79,20000,3,10900,0,0,0,0,0,0,0,20000,-20000,-20000
20200520,709724,晶焱凱基99購01,,,,,,0.00,0,0,0,0,0,0,0,0,0,0,0,0,0
20200520,709725,大學光永豐99購01,,,,,,0.00,0,0,0,0,0,0,0,0,0,0,0,0,0
20200520,709726,宏捷科永豐99購01,,,,,,0.00,0,0,0,0,0,0,0,0,0,0,0,0,0
20200520,709727,信驊永豐99購01,3.38,3.44,2.83,2.83,-0.20,-6.6,91000,15,290430,0,0,0,0,0,0,41000,50000,-9000,-9000
20200520,709728,威剛永豐99購02,,,,,,0.00,0,0,0,0,0,0,0,0,0,0,0,0,0
20200520,709729,環球晶永豐99購01,,,,,,0.00,0,0,0,0,0,0,0,0,0,0,0,0,0
20200520,709730,宏捷科康和99購01,,,,,,0.00,0,0,0,0,0,0,0,0,0,0,0,0,0
20200520,709731,宏捷科群益99購01,0.77,0.77,0.77,0.77,-0.07,-8.33,10000,1,7700,0,0,0,0,0,0,0,10000,-10000,-10000
20200520,709732,宏捷科元富99購01,0.91,0.95,0.91,0.92,-0.05,-5.15,514000,18,476720,0,0,0,0,0,0,341000,173000,168000,168000
20200520,709733,智擎元富99購01,1.12,1.13,1.08,1.08,-0.02,-1.82,87000,4,96740,0,0,0,0,0,0,75000,12000,63000,63000
20200520,709734,中美晶統一9B購02,,,,,,0.00,0,0,0,0,0,0,0,0,0,0,0,0,0
20200520,709735,宏捷科統一9B購01,0.69,0.70,0.69,0.70,-0.02,-2.78,26000,4,18090,0,0,0,0,0,0,24000,2000,22000,22000
20200520,709736,宏捷科凱基9B購01,,,,,,0.00,0,0,0,0,0,0,0,0,0,0,0,0,0
20200520,709737,威剛凱基9B購01,0.49,0.49,0.49,0.49,+0.01,2.08,55000,1,26950,0,0,0,0,0,0,55000,0,55000,55000
20200520,709738,建榮凱基9A購02,,,,,,0.00,0,0,0,0,0,0,0,0,0,0,0,0,0
20200520,709739,神盾凱基9A購01,0.98,0.98,0.88,0.88,-0.02,-2.22,150000,24,146280,0,0,0,0,0,0,145000,69000,76000,76000
20200520,709740,新鉅科凱基99購01,0.24,0.26,0.24,0.26,+0.01,4.0,150000,2,37000,0,0,0,0,0,0,100000,50000,50000,50000
20200520,709741,聚積凱基9A購01,0.61,0.61,0.60,0.60,0.00,0.0,29000,3,17570,0,0,0,0,0,0,0,29000,-29000,-29000
20200520,709742,久元元大99購01,2.21,2.40,2.02,2.34,+0.29,14.15,640000,53,1364310,0,0,0,0,0,0,515000,98000,417000,417000
20200520,709743,久元元大99購02,2.20,2.40,1.99,2.31,+0.26,12.68,1328000,106,2879520,0,0,0,0,0,0,806000,585000,221000,221000
20200520,709744,光頡元大99購01,1.47,1.51,1.47,1.51,+0.10,7.09,68000,2,102280,0,0,0,0,0,0,68000,0,68000,68000
20200520,709745,合晶元大99購02,1.11,1.17,1.11,1.14,+0.07,6.54,297000,8,336630,0,0,0,0,0,0,1000,297000,-296000,-296000
20200520,709746,宏捷科元大99購03,,,,,,0.00,0,0,0,0,0,0,0,0,0,0,0,0,0
20200520,709747,迅得元大9B購01,0.61,0.63,0.61,0.63,+0.02,3.28,77000,3,47090,0,0,0,0,0,0,77000,0,77000,77000
20200520,709748,勝麗元大99購01,2.15,2.20,2.15,2.15,+0.09,4.37,68000,3,147050,0,0,0,0,0,0,1000,67000,-66000,-66000
20200520,709749,宏捷科群益99購02,0.42,0.42,0.41,0.41,-0.04,-8.89,144000,4,59640,0,0,0,0,0,0,53000,91000,-38000,-38000
20200520,709750,信昌電群益99購01,1.80,1.83,1.80,1.83,+0.11,6.4,98000,2,177840,0,0,0,0,0,0,0,98000,-98000,-98000
20200520,709751,安勤國票99購01,,,,,,0.00,0,0,0,0,0,0,0,0,0,0,0,0,0
20200520,709752,中美晶富邦9B購01,0.23,0.23,0.23,0.23,-0.01,-4.17,10000,1,2300,0,0,0,0,0,0,0,0,0,0
20200520,709753,宏捷科富邦9B購01,0.52,0.53,0.51,0.51,-0.03,-5.56,28000,4,14480,0,0,0,0,0,0,10000,18000,-8000,-8000
20200520,709754,穩懋富邦9B購01,0.84,0.84,0.84,0.84,-0.05,-5.62,11000,1,9240,0,0,0,0,0,0,11000,0,11000,11000
20200520,709755,力致永豐99購02,2.24,2.24,2.24,2.24,+0.07,3.23,22000,1,49280,0,0,0,0,0,0,0,22000,-22000,-22000
20200520,709756,大學光永豐99購02,,,,,,0.00,0,0,0,0,0,0,0,0,0,0,0,0,0
20200520,709757,宏捷科永豐99購02,,,,,,0.00,0,0,0,0,0,0,0,0,0,0,0,0,0
20200520,709758,精華永豐99購01,0.20,0.20,0.18,0.18,-0.02,-10.0,55000,4,10400,0,0,0,0,0,0,30000,25000,5000,5000
20200520,709759,鈺太永豐99購01,0.97,0.97,0.96,0.96,+0.01,1.05,51000,2,49060,0,0,0,0,0,0,0,51000,-51000,-51000
20200520,709760,合晶凱基9A購01,1.79,1.84,1.79,1.82,+0.08,4.6,81000,8,146250,0,0,0,0,0,0,49000,34000,15000,15000
20200520,709761,雙鴻凱基9A購01,1.49,1.49,1.48,1.49,-0.02,-1.32,63000,4,93360,0,0,0,0,0,0,63000,2000,61000,61000
20200520,709762,宏捷科統一9B購02,1.01,1.01,1.00,1.00,-0.03,-2.91,17000,3,17050,0,0,0,0,0,0,12000,5000,7000,7000
20200520,709763,宣德統一99購01,,,,,,0.00,0,0,0,0,0,0,0,0,0,0,0,0,0
20200520,709764,建榮統一9B購01,,,,,,0.00,0,0,0,0,0,0,0,0,0,0,0,0,0
20200520,709765,海韻電永豐99購01,2.34,2.36,2.28,2.28,-0.08,-3.39,31000,5,72070,0,0,0,0,0,0,31000,14000,17000,17000
20200520,709766,優群永豐99購01,,,,,,0.00,0,0,0,0,0,0,0,0,0,0,0,0,0
20200520,709767,穩懋永豐9A購01,1.53,1.53,1.52,1.52,-0.09,-5.59,99000,3,150620,0,0,0,0,0,0,99000,99000,0,0
20200520,709768,海韻電元富99購01,3.60,3.60,3.19,3.28,-0.09,-2.67,42000,8,142480,0,0,0,0,0,0,2000,40000,-38000,-38000
20200520,709769,宏捷科國票99購02,,,,,,0.00,0,0,0,0,0,0,0,0,0,0,0,0,0
20200520,709770,威剛國票9A購01,,,,,,0.00,0,0,0,0,0,0,0,0,0,0,0,0,0
20200520,709771,宏捷科元大99購04,1.35,1.35,1.31,1.31,-0.13,-9.03,84000,9,111580,0,0,0,0,0,0,0,84000,-84000,-84000
20200520,709772,穩懋元大99購03,2.01,2.01,1.94,1.94,-0.19,-8.92,57000,5,114250,0,0,0,0,0,0,4000,57000,-53000,-53000
20200520,709773,宏捷科國泰9A購01,,,,,,0.00,0,0,0,0,0,0,0,0,0,0,0,0,0
20200520,709774,海韻電國泰9B購01,3.45,3.48,3.35,3.35,-0.12,-3.46,33000,8,113310,0,0,0,0,0,0,33000,0,33000,33000
20200520,709775,原相富邦9B購01,0.23,0.24,0.23,0.24,-0.01,-4.0,36000,4,8340,0,0,0,0,0,0,20000,36000,-16000,-16000
20200520,709776,環球晶富邦9B購02,0.38,0.38,0.36,0.36,-0.03,-7.69,173000,5,62320,0,0,0,0,0,0,120000,53000,67000,67000
20200520,709777,神盾群益9B購01,0.98,0.98,0.90,0.90,-0.05,-5.26,343000,7,324050,0,0,0,0,0,0,342000,7000,335000,335000
20200520,709778,波若威永豐99購02,,,,,,0.00,0,0,0,0,0,0,0,0,0,0,0,0,0
20200520,709779,信昌電永豐99購01,0.64,0.66,0.64,0.65,+0.05,8.33,90000,4,58500,0,0,0,0,0,0,70000,20000,50000,50000
20200520,709780,晶焱永豐99購01,,,,,,0.00,0,0,0,0,0,0,0,0,0,0,0,0,0
20200520,709781,緯軟永豐99購01,0.50,0.50,0.50,0.50,0.00,0.0,20000,1,10000,0,0,0,0,0,0,20000,0,20000,20000
20200520,709782,雙鴻永豐99購02,0.60,0.60,0.60,0.60,-0.03,-4.76,26000,2,15600,0,0,0,0,0,0,25000,1000,24000,24000
20200520,709783,宏捷科元富9C購01,0.95,0.95,0.95,0.95,-0.01,-1.04,40000,1,38000,0,0,0,0,0,0,40000,0,40000,40000
20200520,709784,閎康中信99購01,1.20,1.30,1.19,1.30,+0.02,1.56,327000,12,408680,0,0,0,0,0,0,107000,280000,-173000,-173000
20200520,709785,合晶凱基9A購02,,,,,,0.00,0,0,0,0,0,0,0,0,0,0,0,0,0
20200520,709786,金居凱基99購01,2.63,2.66,2.63,2.66,-0.02,-0.75,20000,2,52750,0,0,0,0,0,0,5000,15000,-10000,-10000
20200520,709787,金居凱基9A購01,1.48,1.48,1.48,1.48,-0.10,-6.33,70000,1,103600,0,0,0,0,0,0,0,70000,-70000,-70000
20200520,709788,泰博凱基9A購01,4.05,4.33,4.05,4.31,+0.26,6.42,124000,13,525920,0,0,0,0,0,0,110000,124000,-14000,-14000
20200520,709789,神盾凱基99購02,,,,,,0.00,0,0,0,0,0,0,0,0,0,0,0,0,0
20200520,709790,網龍凱基9A購01,3.89,3.93,3.88,3.88,+0.04,1.04,13000,3,50510,0,0,0,0,0,0,11000,3000,8000,8000
20200520,709791,雙鴻凱基99購01,2.31,2.31,2.29,2.29,-0.05,-2.14,36000,3,82480,0,0,0,0,0,0,36000,36000,0,0
20200520,709792,穩懋凱基99購03,1.45,1.45,1.45,1.45,-0.14,-8.81,1000,1,1450,0,0,0,0,0,0,0,1000,-1000,-1000
20200520,709793,威剛統一9B購01,,,,,,0.00,0,0,0,0,0,0,0,0,0,0,0,0,0
20200520,709794,原相統一9B購01,0.50,0.50,0.49,0.49,-0.04,-7.55,44000,5,21700,0,0,0,0,0,0,21000,23000,-2000,-2000
20200520,709795,穩懋統一9B購01,0.62,0.62,0.62,0.62,-0.07,-10.14,45000,2,27900,0,0,0,0,0,0,15000,30000,-15000,-15000
20200520,709796,三貝德國票9A購01,,,,,,0.00,0,0,0,0,0,0,0,0,0,0,0,0,0
20200520,709797,群聯國票9A購01,,,,,,0.00,0,0,0,0,0,0,0,0,0,0,0,0,0
20200520,709798,優群國票9A購01,5.75,5.75,5.50,5.50,+0.10,1.85,19000,2,107000,0,0,0,0,0,0,0,19000,-19000,-19000
20200520,709799,鈺太國泰9C購01,1.17,1.17,1.14,1.14,+0.05,4.59,365000,8,419940,0,0,0,0,0,0,73000,312000,-239000,-239000
20200520,709800,建榮富邦9B購01,,,,,,0.00,0,0,0,0,0,0,0,0,0,0,0,0,0
20200520,709801,凡甲兆豐99購01,,,,,,0.00,0,0,0,0,0,0,0,0,0,0,0,0,0
20200520,709802,中美晶兆豐9A購01,,,,,,0.00,0,0,0,0,0,0,0,0,0,0,0,0,0
20200520,709803,穩懋兆豐99購02,0.76,0.77,0.70,0.71,-0.14,-16.47,71000,13,53830,0,0,0,0,0,0,0,63000,-63000,-63000
20200520,709804,譜瑞兆豐99購01,3.19,3.20,3.07,3.07,+0.13,4.42,41000,8,127110,0,0,0,0,0,0,11000,30000,-19000,-19000
20200520,709805,VHQ群益9B購01,,,,,,0.00,0,0,0,0,0,0,0,0,0,0,0,0,0
20200520,709806,建榮群益9B購01,,,,,,0.00,0,0,0,0,0,0,0,0,0,0,0,0,0
20200520,709807,博智群益99購01,2.57,2.57,2.50,2.51,-0.19,-7.04,64000,4,163020,0,0,0,0,0,0,22000,64000,-42000,-42000
20200520,709808,聚積群益99購01,,,,,,0.00,0,0,0,0,0,0,0,0,0,0,0,0,0
20200520,709809,力致元大9A購01,1.76,1.87,1.76,1.83,+0.03,1.67,145000,18,268300,0,0,0,0,0,0,12000,124000,-112000,-112000
20200520,709810,大宇資元大99購01,0.38,0.38,0.38,0.38,+0.01,2.7,50000,3,19000,0,0,0,0,0,0,0,50000,-50000,-50000
20200520,709811,大江元大99購03,4.36,4.36,4.34,4.34,+0.05,1.17,13000,3,56620,0,0,0,0,0,0,3000,10000,-7000,-7000
20200520,709812,光頡元大99購02,1.48,1.52,1.45,1.52,+0.08,5.56,136000,6,204140,0,0,0,0,0,0,68000,68000,0,0
20200520,709813,迅得元大99購02,1.66,1.76,1.65,1.73,+0.06,3.59,379000,20,648660,0,0,0,0,0,0,233000,146000,87000,87000
20200520,709814,建榮元大99購01,,,,,,0.00,0,0,0,0,0,0,0,0,0,0,0,0,0
20200520,709815,網龍元大9A購01,2.29,2.29,2.21,2.21,0.00,0.0,39000,3,86430,0,0,0,0,0,0,39000,6000,33000,33000
20200520,709816,環宇元大99購01,0.64,0.64,0.62,0.62,+0.06,10.71,347000,6,218880,0,0,0,0,0,0,0,347000,-347000,-347000
20200520,709817,網家群益99購01,1.87,2.15,1.85,2.15,+0.42,24.28,1458000,111,2857360,0,0,0,0,0,0,1034000,305000,729000,729000
20200520,709818,安勤永豐9A購01,,,,,,0.00,0,0,0,0,0,0,0,0,0,0,0,0,0
20200520,709819,宏捷科永豐99購03,,,,,,0.00,0,0,0,0,0,0,0,0,0,0,0,0,0
20200520,709820,迅得永豐99購01,0.75,0.81,0.75,0.80,+0.04,5.26,649000,17,504050,0,0,0,0,0,0,183000,466000,-283000,-283000
20200520,709821,宣德永豐99購01,1.69,1.75,1.69,1.75,+0.22,14.38,105000,4,179300,0,0,0,0,0,0,45000,60000,-15000,-15000
20200520,709822,原相永豐9A購01,0.20,0.20,0.17,0.17,-0.03,-15.0,417000,16,80340,0,0,0,0,0,0,30000,347000,-317000,-317000
20200520,709823,博智永豐9A購01,0.44,0.44,0.41,0.44,-0.01,-2.22,82000,5,34820,0,0,0,0,0,0,0,82000,-82000,-82000
20200520,709824,新普永豐99購01,2.05,2.05,2.05,2.05,-0.16,-7.24,10000,1,20500,0,0,0,0,0,0,0,10000,-10000,-10000
20200520,709825,聖暉永豐99購01,1.26,1.26,1.21,1.23,-0.03,-2.38,90000,5,112040,0,0,0,0,0,0,75000,15000,60000,60000
20200520,709826,優群永豐9A購01,1.33,1.40,1.32,1.32,+0.01,0.76,44000,8,59660,0,0,0,0,0,0,10000,24000,-14000,-14000
20200520,709827,穩懋永豐99購01,1.69,1.69,1.69,1.69,-0.22,-11.52,38000,1,64220,0,0,0,0,0,0,38000,0,38000,38000
20200520,709828,信驊國票9A購01,11.60,11.90,10.30,10.30,-0.50,-4.63,28000,6,313800,0,0,0,0,0,0,8000,20000,-12000,-12000
20200520,709829,聖暉國票9A購01,7.00,7.00,7.00,7.00,-0.05,-0.71,10000,1,70000,0,0,0,0,0,0,10000,0,10000,10000
20200520,709830,信驊國泰9B購01,3.76,3.76,3.40,3.40,-0.13,-3.68,192000,8,709780,0,0,0,0,0,0,188000,178000,10000,10000
20200520,709831,原相富邦9C購01,0.20,0.20,0.19,0.19,-0.01,-5.0,26000,4,5050,0,0,0,0,0,0,0,26000,-26000,-26000
20200520,709832,宏捷科元富9C購02,,,,,,0.00,0,0,0,0,0,0,0,0,0,0,0,0,0
20200520,709833,聖暉元富99購01,2.20,2.20,2.20,2.20,+0.05,2.33,10000,1,22000,0,0,0,0,0,0,10000,0,10000,10000
20200520,709834,建榮統一9B購02,,,,,,0.00,0,0,0,0,0,0,0,0,0,0,0,0,0
20200520,709835,台半元大99購01,0.87,0.87,0.87,0.87,+0.04,4.82,100000,1,87000,0,0,0,0,0,0,0,100000,-100000,-100000
20200520,709836,金居元大99購03,1.81,1.87,1.78,1.78,-0.13,-6.81,41000,7,74140,0,0,0,0,0,0,5000,36000,-31000,-31000
20200520,709837,博智元大99購02,,,,,,0.00,0,0,0,0,0,0,0,0,0,0,0,0,0
20200520,709838,網龍元大9A購02,2.04,2.04,1.92,1.92,-0.04,-2.04,237000,11,460240,0,0,0,0,0,0,201000,37000,164000,164000
20200520,709839,力旺凱基99購01,2.29,2.44,2.10,2.10,-0.05,-2.33,679000,57,1551600,0,0,0,0,0,0,442000,475000,-33000,-33000
20200520,709840,合晶凱基9A購03,1.39,1.43,1.39,1.42,+0.05,3.65,155000,9,218720,0,0,0,0,0,0,82000,155000,-73000,-73000
20200520,709841,聯亞凱基9A購01,,,,,,0.00,0,0,0,0,0,0,0,0,0,0,0,0,0
20200520,709842,譜瑞凱基9A購02,3.98,3.98,3.90,3.97,-0.11,-2.7,41000,17,162610,0,0,0,0,0,0,41000,0,41000,41000
20200520,709843,雙鴻中信9B購01,,,,,,0.00,0,0,0,0,0,0,0,0,0,0,0,0,0
20200520,709844,宏捷科凱基9A購01,1.42,1.44,1.41,1.41,-0.05,-3.42,140000,4,200500,0,0,0,0,0,0,60000,80000,-20000,-20000
20200520,709845,金可凱基9A購01,,,,,,0.00,0,0,0,0,0,0,0,0,0,0,0,0,0
20200520,709846,凡甲元大99購01,,,,,,0.00,0,0,0,0,0,0,0,0,0,0,0,0,0
20200520,709847,宇峻元大9C購01,0.52,0.53,0.51,0.52,+0.02,4.0,119000,4,61440,0,0,0,0,0,0,3000,116000,-113000,-113000
20200520,709848,金可元大99購01,,,,,,0.00,0,0,0,0,0,0,0,0,0,0,0,0,0
20200520,709849,保瑞元大9A購01,0.92,0.95,0.92,0.94,+0.02,2.17,173000,8,162680,0,0,0,0,0,0,145000,78000,67000,67000
20200520,709850,建榮元大99購02,,,,,,0.00,0,0,0,0,0,0,0,0,0,0,0,0,0
20200520,709851,晶焱元大9A購01,,,,,,0.00,0,0,0,0,0,0,0,0,0,0,0,0,0
20200520,709852,群聯元大99購04,,,,,,0.00,0,0,0,0,0,0,0,0,0,0,0,0,0
20200520,709853,大江國票9A購01,1.85,1.85,1.77,1.77,-0.06,-3.28,32000,3,57440,0,0,0,0,0,0,10000,22000,-12000,-12000
20200520,709854,穩懋國票99購02,1.22,1.22,1.08,1.08,-0.22,-16.92,35000,4,40450,0,0,0,0,0,0,0,35000,-35000,-35000
20200520,709855,穩懋富邦9B購02,0.62,0.63,0.61,0.63,-0.05,-7.35,870000,13,543100,0,0,0,0,0,0,335000,510000,-175000,-175000
20200520,709856,晶焱兆豐9A購01,0.67,0.68,0.67,0.68,0.00,0.0,274000,5,183680,0,0,0,0,0,0,274000,0,274000,274000
20200520,709857,環球晶兆豐99購01,,,,,,0.00,0,0,0,0,0,0,0,0,0,0,0,0,0
20200520,709858,穩懋兆豐9A購01,,,,,,0.00,0,0,0,0,0,0,0,0,0,0,0,0,0
20200520,709859,安勤群益99購01,,,,,,0.00,0,0,0,0,0,0,0,0,0,0,0,0,0
20200520,709860,新鉅科群益9A購01,0.65,0.65,0.65,0.65,-0.01,-1.52,84000,2,54600,0,0,0,0,0,0,76000,8000,68000,68000
20200520,709861,環球晶群益99購01,2.00,2.01,1.99,1.99,-0.03,-1.49,6000,3,12030,0,0,0,0,0,0,6000,6000,0,0
20200520,709862,碩禾永豐99購01,,,,,,0.00,0,0,0,0,0,0,0,0,0,0,0,0,0
20200520,709863,網龍永豐9A購01,1.70,1.70,1.65,1.67,-0.06,-3.47,27000,4,45370,0,0,0,0,0,0,16000,11000,5000,5000
20200520,709864,璟德元富99購01,1.89,1.90,1.83,1.88,-0.01,-0.53,296000,18,550270,0,0,0,0,0,0,178000,58000,120000,120000
20200520,709865,鈺太元富99購01,1.86,1.86,1.80,1.82,+0.09,5.2,134000,10,245680,0,0,0,0,0,0,59000,75000,-16000,-16000
20200520,709866,凡甲永豐9A購01,1.47,1.47,1.40,1.43,-0.04,-2.72,55000,7,79320,0,0,0,0,0,0,50000,5000,45000,45000
20200520,709867,兆利永豐99購01,,,,,,0.00,0,0,0,0,0,0,0,0,0,0,0,0,0
20200520,709868,欣銓永豐99購01,0.74,0.76,0.70,0.71,-0.04,-5.33,199000,5,142670,0,0,0,0,0,0,91000,108000,-17000,-17000
20200520,709869,信驊永豐99購02,1.32,1.37,1.18,1.18,-0.02,-1.67,423000,38,544970,0,0,0,0,0,0,207000,175000,32000,32000
20200520,709870,群聯永豐99購01,,,,,,0.00,0,0,0,0,0,0,0,0,0,0,0,0,0
20200520,709871,聚積永豐99購01,0.53,0.53,0.53,0.53,0.00,0.0,80000,1,42400,0,0,0,0,0,0,0,80000,-80000,-80000
20200520,709872,環球晶永豐99購02,0.91,0.92,0.86,0.86,-0.07,-7.53,97000,8,87820,0,0,0,0,0,0,62000,37000,25000,25000
20200520,709873,東洋統一9B購01,1.85,1.86,1.81,1.83,-0.06,-3.17,273000,13,501280,0,0,0,0,0,0,113000,160000,-47000,-47000
20200520,709874,建榮凱基9A購03,,,,,,0.00,0,0,0,0,0,0,0,0,0,0,0,0,0
20200520,709875,大中國票9A購01,,,,,,0.00,0,0,0,0,0,0,0,0,0,0,0,0,0
20200520,709876,台燿國票9A購01,3.76,3.76,3.53,3.53,-0.51,-12.62,68000,6,248390,0,0,0,0,0,0,55000,13000,42000,42000
20200520,709877,泰博國泰9A購01,,,,,,0.00,0,0,0,0,0,0,0,0,0,0,0,0,0
20200520,709878,大江元大99購04,1.85,1.85,1.81,1.81,-0.01,-0.55,210000,4,386920,0,0,0,0,0,0,200000,11000,189000,189000
20200520,709879,安勤元大99購02,,,,,,0.00,0,0,0,0,0,0,0,0,0,0,0,0,0
20200520,709880,宏捷科元大99購06,,,,,,0.00,0,0,0,0,0,0,0,0,0,0,0,0,0
20200520,709881,聖暉元大99購01,1.94,1.94,1.85,1.87,-0.04,-2.09,332000,15,626520,0,0,0,0,0,0,176000,154000,22000,22000
20200520,709882,優群元大99購03,1.69,1.69,1.69,1.69,+0.06,3.68,100000,2,169000,0,0,0,0,0,0,0,100000,-100000,-100000
20200520,709883,優群元大9B購01,1.85,1.92,1.85,1.92,+0.08,4.35,35000,3,66300,0,0,0,0,0,0,10000,25000,-15000,-15000
20200520,709884,穩懋元大99購05,2.10,2.10,1.99,1.99,-0.24,-10.76,172000,11,349300,0,0,0,0,0,0,114000,66000,48000,48000
20200520,709885,信驊兆豐99購01,1.93,2.00,1.68,1.68,-0.14,-7.69,366000,30,702750,0,0,0,0,0,0,241000,117000,124000,124000
20200520,709886,中美晶群益9A購01,0.76,0.76,0.76,0.76,-0.05,-6.17,60000,1,45600,0,0,0,0,0,0,0,60000,-60000,-60000
20200520,709887,神盾群益9B購02,2.53,2.53,2.32,2.32,-0.05,-2.11,205000,8,503910,0,0,0,0,0,0,189000,32000,157000,157000
20200520,709888,聯亞群益99購01,1.18,1.19,1.18,1.19,-0.06,-4.8,100000,2,118020,0,0,0,0,0,0,100000,0,100000,100000
20200520,709889,台燿元富9C購01,2.70,2.70,2.47,2.51,-0.27,-9.71,440000,24,1146780,0,0,0,0,0,0,323000,117000,206000,206000
20200520,709890,原相統一9A購01,0.91,0.91,0.90,0.90,-0.04,-4.26,236000,6,212900,0,0,0,0,0,0,188000,48000,140000,140000
20200520,709891,大宇資凱基9B購01,0.62,0.67,0.62,0.64,-0.01,-1.54,132000,9,85840,0,0,0,0,0,0,72000,60000,12000,12000
20200520,709892,宇峻凱基9B購01,0.78,0.80,0.76,0.78,0.00,0.0,275000,7,217450,0,0,0,0,0,0,15000,260000,-245000,-245000
20200520,709893,信驊凱基9A購01,3.30,3.34,2.97,2.97,-0.19,-6.01,54000,8,178700,0,0,0,0,0,0,22000,32000,-10000,-10000
20200520,709894,統新凱基9B購01,1.24,1.26,1.19,1.19,-0.16,-11.85,524000,20,642050,0,0,0,0,0,0,385000,137000,248000,248000
20200520,709895,順達凱基99購01,1.90,2.14,1.89,2.14,+0.27,14.44,540000,40,1084830,0,0,0,0,0,0,6000,534000,-528000,-528000
20200520,709896,雙美凱基9B購01,1.33,1.33,1.30,1.30,-0.05,-3.7,57000,2,74910,0,0,0,0,0,0,57000,57000,0,0
20200520,709897,雙鴻元大99購06,1.46,1.46,1.41,1.42,0.00,0.0,77000,4,111680,0,0,0,0,0,0,31000,47000,-16000,-16000
20200520,709898,穩懋元大99購06,2.32,2.32,2.20,2.24,-0.23,-9.31,12000,5,27200,0,0,0,0,0,0,8000,12000,-4000,-4000
20200520,709899,穩懋元大99購07,1.13,1.14,1.07,1.07,-0.12,-10.08,134000,13,147950,0,0,0,0,0,0,93000,58000,35000,35000
20200520,709900,力致永豐99購03,,,,,,0.00,0,0,0,0,0,0,0,0,0,0,0,0,0
20200520,709901,光頡永豐99購01,0.82,0.82,0.81,0.81,+0.03,3.85,94000,2,76440,0,0,0,0,0,0,64000,30000,34000,34000
20200520,709902,新鉅科永豐99購01,,,,,,0.00,0,0,0,0,0,0,0,0,0,0,0,0,0
20200520,709903,精測永豐9A購01,0.80,0.80,0.80,0.80,-0.05,-5.88,3000,1,2400,0,0,0,0,0,0,0,3000,-3000,-3000
20200520,709904,璟德永豐99購01,0.96,1.00,0.96,1.00,0.00,0.0,102000,4,100080,0,0,0,0,0,0,34000,68000,-34000,-34000
20200520,709905,環球晶永豐99購03,1.58,1.58,1.57,1.57,-0.03,-1.88,6000,2,9470,0,0,0,0,0,0,6000,6000,0,0
20200520,709906,兆利國票99購01,,,,,,0.00,0,0,0,0,0,0,0,0,0,0,0,0,0
20200520,709907,金居國票9A購01,,,,,,0.00,0,0,0,0,0,0,0,0,0,0,0,0,0
20200520,709908,信驊國票9A購02,8.90,9.00,8.75,8.75,+0.40,4.79,46000,7,411150,0,0,0,0,0,0,27000,19000,8000,8000
20200520,709909,兆利國泰9A購01,,,,,,0.00,0,0,0,0,0,0,0,0,0,0,0,0,0
20200520,709910,宏捷科國泰9B購01,0.94,0.94,0.94,0.94,-0.01,-1.05,2000,1,1880,0,0,0,0,0,0,0,2000,-2000,-2000
20200520,709911,精測國泰9C購01,0.59,0.59,0.54,0.54,-0.06,-10.0,75000,19,41890,0,0,0,0,0,0,35000,40000,-5000,-5000
20200520,709912,威剛富邦9C購01,,,,,,0.00,0,0,0,0,0,0,0,0,0,0,0,0,0
20200520,709913,M31群益99購01,0.81,0.86,0.74,0.74,-0.02,-2.63,833000,22,684770,0,0,0,0,0,0,570000,262000,308000,308000
20200520,709914,中美晶群益9B購01,,,,,,0.00,0,0,0,0,0,0,0,0,0,0,0,0,0
20200520,709915,台燿群益99購02,1.53,1.53,1.39,1.40,-0.11,-7.28,303000,20,438680,0,0,0,0,0,0,197000,165000,32000,32000
20200520,709916,合晶群益9A購01,1.30,1.31,1.30,1.31,+0.09,7.38,534000,8,695200,0,0,0,0,0,0,0,534000,-534000,-534000
20200520,709917,緯軟群益9A購01,1.12,1.16,1.12,1.13,+0.07,6.6,43000,4,49190,0,0,0,0,0,0,0,43000,-43000,-43000
20200520,709918,璟德群益99購01,1.90,1.91,1.84,1.84,-0.03,-1.6,397000,4,751070,0,0,0,0,0,0,397000,0,397000,397000
20200520,709919,環球晶群益99購02,2.17,2.19,2.17,2.18,-0.02,-0.91,6000,3,13110,0,0,0,0,0,0,6000,6000,0,0
20200520,709920,原相日盛9B購01,,,,,,0.00,0,0,0,0,0,0,0,0,0,0,0,0,0
20200520,709921,雍智國泰9C購01,1.35,1.45,1.30,1.37,+0.14,11.38,937000,67,1276840,0,0,0,0,0,0,638000,283000,355000,355000
20200520,709922,璟德國泰9A購01,1.94,1.94,1.89,1.93,0.00,0.0,361000,13,691570,0,0,0,0,0,0,321000,66000,255000,255000
20200520,709923,VHQ群益99購01,,,,,,0.00,0,0,0,0,0,0,0,0,0,0,0,0,0
20200520,709924,中美晶群益99購03,0.58,0.58,0.57,0.57,-0.04,-6.56,70000,3,40400,0,0,0,0,0,0,20000,50000,-30000,-30000
20200520,709925,精測群益99購01,1.10,1.13,1.10,1.11,-0.05,-4.31,153000,4,169850,0,0,0,0,0,0,137000,16000,121000,121000
20200520,709926,精測富邦9A購01,0.14,0.14,0.13,0.14,0.00,0.0,258000,13,35460,0,0,0,0,0,0,66000,162000,-96000,-96000
20200520,709927,聯亞國票9A購01,4.77,4.77,4.77,4.77,-0.07,-1.45,20000,2,95400,0,0,0,0,0,0,0,20000,-20000,-20000
20200520,709928,穩懋國票99購03,7.10,7.10,7.10,7.10,-0.30,-4.05,2000,1,14200,0,0,0,0,0,0,0,2000,-2000,-2000
20200520,709929,大江永豐99購01,,,,,,0.00,0,0,0,0,0,0,0,0,0,0,0,0,0
20200520,709930,精測永豐99購01,,,,,,0.00,0,0,0,0,0,0,0,0,0,0,0,0,0
20200520,709931,建榮統一9B購03,,,,,,0.00,0,0,0,0,0,0,0,0,0,0,0,0,0
20200520,709932,中美晶凱基99購07,,,,,,0.00,0,0,0,0,0,0,0,0,0,0,0,0,0
20200520,709933,碩禾凱基9B購01,,,,,,0.00,0,0,0,0,0,0,0,0,0,0,0,0,0
20200520,709934,精測元富99購02,0.72,0.75,0.70,0.71,-0.07,-8.97,317000,17,232780,0,0,0,0,0,0,306000,11000,295000,295000
20200520,709935,鈺太元富99購02,2.24,2.25,2.14,2.18,0.00,0.0,260000,22,575880,0,0,0,0,0,0,116000,124000,-8000,-8000
20200520,709936,元太元大99購01,4.07,4.84,4.07,4.84,+0.74,18.05,23000,5,99150,0,0,0,0,0,0,12000,5000,7000,7000
20200520,709937,兆利元大9B購01,0.39,0.40,0.39,0.40,+0.02,5.26,110000,2,43000,0,0,0,0,0,0,0,110000,-110000,-110000
20200520,709938,宏捷科元大99購07,0.88,0.88,0.88,0.88,-0.02,-2.22,40000,3,35200,0,0,0,0,0,0,25000,15000,10000,10000
20200520,709939,良維元大99購01,3.28,3.33,3.23,3.29,+0.04,1.23,161000,20,528790,0,0,0,0,0,0,136000,35000,101000,101000
20200520,709940,信驊元大99購01,9.20,9.20,9.00,9.20,+0.45,5.14,21000,4,191250,0,0,0,0,0,0,16000,21000,-5000,-5000
20200520,709941,信驊元大99購02,5.65,5.65,5.65,5.65,-0.25,-4.24,4000,1,22600,0,0,0,0,0,0,0,4000,-4000,-4000
20200520,709942,威剛元大9A購02,,,,,,0.00,0,0,0,0,0,0,0,0,0,0,0,0,0
20200520,709943,泰博元大99購01,4.81,4.81,4.81,4.81,+0.04,0.84,1000,1,4810,0,0,0,0,0,0,1000,0,1000,1000
20200520,709944,順達元大99購01,2.38,2.75,2.36,2.73,+0.39,16.67,747000,63,1904390,0,0,0,0,0,0,390000,646000,-256000,-256000
20200520,709945,群聯元大99購05,,,,,,0.00,0,0,0,0,0,0,0,0,0,0,0,0,0
20200520,709946,精華元大99購01,1.03,1.03,0.98,0.98,-0.04,-3.92,561000,10,558370,0,0,0,0,0,0,244000,338000,-94000,-94000
20200520,709947,神盾永豐99購02,1.07,1.11,0.94,0.94,-0.11,-10.48,2517000,74,2510930,0,0,0,0,0,0,1692000,606000,1086000,1086000
20200520,709948,穩懋永豐99購02,1.58,1.58,1.56,1.56,-0.03,-1.89,30000,3,47200,0,0,0,0,0,0,30000,30000,0,0
20200520,709949,中美晶日盛99購01,1.32,1.32,1.32,1.32,-0.06,-4.35,10000,1,13200,0,0,0,0,0,0,10000,0,10000,10000
20200520,709950,大學光元大99購02,4.24,4.24,4.24,4.24,+0.25,6.27,1000,1,4240,0,0,0,0,0,0,1000,0,1000,1000
20200520,709951,台燿元大99購01,1.58,1.58,1.45,1.45,-0.06,-3.97,69000,3,105850,0,0,0,0,0,0,60000,9000,51000,51000
20200520,709952,良維元大99購02,3.47,3.54,3.43,3.50,+0.06,1.74,229000,18,798180,0,0,0,0,0,0,217000,22000,195000,195000
20200520,709953,建榮元大9B購01,,,,,,0.00,0,0,0,0,0,0,0,0,0,0,0,0,0
20200520,709954,M31國票9A購01,2.42,2.51,2.36,2.36,+0.08,3.51,138000,12,338990,0,0,0,0,0,0,17000,121000,-104000,-104000
20200520,709955,大江國票9A購02,3.24,3.24,3.24,3.24,+0.02,0.62,2000,1,6480,0,0,0,0,0,0,2000,2000,0,0
20200520,709956,群聯統一9B購01,0.82,0.82,0.82,0.82,+0.01,1.23,216000,6,177120,0,0,0,0,0,0,216000,0,216000,216000
20200520,709957,璟德兆豐99購02,0.86,0.88,0.86,0.87,-0.02,-2.25,300000,26,262000,0,0,0,0,0,0,300000,0,300000,300000
20200520,709958,迅得凱基99購01,1.69,1.78,1.68,1.74,+0.04,2.35,754000,38,1311400,0,0,0,0,0,0,424000,270000,154000,154000
20200520,709959,保瑞凱基9B購01,,,,,,0.00,0,0,0,0,0,0,0,0,0,0,0,0,0
20200520,709960,原相凱基9A購01,2.02,2.03,1.99,1.99,-0.13,-6.13,56000,8,112770,0,0,0,0,0,0,20000,36000,-16000,-16000
20200520,709961,雍智凱基9B購01,1.61,1.75,1.61,1.75,+0.27,18.24,92000,14,153020,0,0,0,0,0,0,52000,30000,22000,22000
20200520,709962,精測凱基99購03,,,,,,0.00,0,0,0,0,0,0,0,0,0,0,0,0,0
20200520,709963,廣明凱基99購02,2.54,2.57,2.54,2.57,-0.16,-5.86,64000,7,164170,0,0,0,0,0,0,54000,10000,44000,44000
20200520,709964,璟德凱基99購01,3.85,3.91,3.85,3.91,+0.02,0.51,43000,3,165890,0,0,0,0,0,0,43000,0,43000,43000
20200520,709965,環球晶凱基99購07,,,,,,0.00,0,0,0,0,0,0,0,0,0,0,0,0,0
20200520,709966,金居群益9B購01,2.85,2.86,2.77,2.77,-0.21,-7.05,27000,4,76250,0,0,0,0,0,0,17000,10000,7000,7000
20200520,709967,信驊群益99購01,2.87,2.90,2.76,2.81,+0.17,6.44,444000,16,1252350,0,0,0,0,0,0,336000,98000,238000,238000
20200520,709968,聯亞群益99購02,2.43,2.47,2.43,2.47,+0.04,1.65,60000,3,146200,0,0,0,0,0,0,60000,10000,50000,50000
20200520,709969,譜瑞兆豐99購02,2.39,2.40,2.17,2.17,-0.20,-8.44,95000,17,222990,0,0,0,0,0,0,90000,4000,86000,86000
20200520,709970,宏捷科元大9A購01,,,,,,0.00,0,0,0,0,0,0,0,0,0,0,0,0,0
20200520,709971,邦特元大99購01,1.32,1.48,1.28,1.48,+0.26,21.31,980000,36,1387220,0,0,0,0,0,0,231000,719000,-488000,-488000
20200520,709972,旺矽元大9B購01,1.70,1.85,1.66,1.84,+0.14,8.24,1373000,62,2413010,0,0,0,0,0,0,870000,503000,367000,367000
20200520,709973,中美晶國票9A購01,,,,,,0.00,0,0,0,0,0,0,0,0,0,0,0,0,0
20200520,709974,旺矽國票99購02,6.85,7.50,6.40,7.45,+0.75,11.19,57000,22,399000,0,0,0,0,0,0,11000,46000,-35000,-35000
20200520,709975,宣德國票9A購01,2.03,2.21,2.03,2.21,+0.25,12.76,71000,5,146760,0,0,0,0,0,0,17000,55000,-38000,-38000
20200520,709976,鈺太國票9A購01,2.55,2.59,2.48,2.48,+0.01,0.4,74000,3,186720,0,0,0,0,0,0,50000,24000,26000,26000
20200520,709977,M31永豐99購02,2.41,2.59,2.38,2.38,+0.06,2.59,83000,8,208030,0,0,0,0,0,0,58000,25000,33000,33000
20200520,709978,建榮永豐9A購02,,,,,,0.00,0,0,0,0,0,0,0,0,0,0,0,0,0
20200520,709979,晶焱永豐9A購01,1.10,1.10,1.10,1.10,-0.01,-0.9,45000,1,49500,0,0,0,0,0,0,45000,0,45000,45000
20200520,709980,鈊象永豐9A購01,1.41,1.45,1.41,1.41,-0.06,-4.08,13000,4,18390,0,0,0,0,0,0,1000,12000,-11000,-11000
20200520,709981,M31凱基99購02,2.63,2.74,2.61,2.74,+0.29,11.84,341000,45,909480,0,0,0,0,0,0,285000,41000,244000,244000
20200520,709982,穩懋凱基99購05,,,,,,0.00,0,0,0,0,0,0,0,0,0,0,0,0,0
20200520,709983,群聯日盛9B購01,0.61,0.61,0.61,0.61,0.00,0.0,20000,1,12200,0,0,0,0,0,0,20000,0,20000,20000
20200520,709984,原相群益9C購01,1.50,1.50,1.50,1.50,-0.03,-1.96,49000,1,73500,0,0,0,0,0,0,49000,0,49000,49000
20200520,709985,大江富邦9B購02,1.55,1.55,1.55,1.55,-0.02,-1.27,40000,1,62000,0,0,0,0,0,0,40000,0,40000,40000
20200520,709986,金可中信99購01,1.38,1.38,1.32,1.32,-0.09,-6.38,32000,4,43740,0,0,0,0,0,0,22000,10000,12000,12000
20200520,709987,精華中信99購01,1.98,1.98,1.93,1.93,0.00,0.0,30000,3,58700,0,0,0,0,0,0,20000,10000,10000,10000
20200520,709988,大江永豐99購02,3.65,3.65,3.65,3.65,-0.11,-2.93,4000,1,14600,0,0,0,0,0,0,4000,0,4000,4000
20200520,709989,茂達永豐99購01,2.41,2.41,2.37,2.40,+0.61,34.08,28000,3,67240,0,0,0,0,0,0,0,28000,-28000,-28000
20200520,709990,精測永豐99購02,0.92,0.92,0.92,0.92,-0.07,-7.07,94000,2,86480,0,0,0,0,0,0,94000,0,94000,94000
20200520,709991,環球晶凱基99購08,4.23,4.25,4.23,4.23,-0.04,-0.94,8000,3,33960,0,0,0,0,0,0,8000,8000,0,0
20200520,709992,中美晶元大99購04,1.04,1.04,1.04,1.04,-0.01,-0.95,20000,1,20800,0,0,0,0,0,0,20000,0,20000,20000
20200520,709993,中美晶元大99購05,1.08,1.08,1.08,1.08,-0.04,-3.57,50000,1,54000,0,0,0,0,0,0,50000,0,50000,50000
20200520,709994,中美晶元大9B購01,0.90,0.90,0.87,0.87,-0.02,-2.25,281000,16,247020,0,0,0,0,0,0,166000,105000,61000,61000
20200520,709995,環球晶元大99購03,3.58,3.58,3.38,3.38,-0.15,-4.25,49000,9,169950,0,0,0,0,0,0,39000,39000,0,0
20200520,709996,環球晶元大99購04,4.03,4.03,3.83,3.83,-0.15,-3.77,36000,6,142520,0,0,0,0,0,0,36000,20000,16000,16000
20200520,709997,聯亞元大99購02,2.09,2.10,2.01,2.09,+0.02,0.97,31000,6,64510,0,0,0,0,0,0,25000,6000,19000,19000
20200520,709998,穩懋元大99購09,2.03,2.04,1.94,1.96,-0.14,-6.67,78000,13,156870,0,0,0,0,0,0,71000,26000,45000,45000
20200520,709999,穩懋元大99購10,1.58,1.59,1.52,1.52,-0.14,-8.43,92000,12,142660,0,0,0,0,0,0,7000,91000,-84000,-84000
20200520,710000,穩懋元大99購11,1.72,1.72,1.63,1.63,-0.16,-8.94,38000,7,63800,0,0,0,0,0,0,28000,18000,10000,10000
20200520,710001,M31國票9A購02,8.10,8.30,7.95,8.15,+0.65,8.67,30000,7,243700,0,0,0,0,0,0,0,30000,-30000,-30000
20200520,710002,穩懋國票9A購01,,,,,,0.00,0,0,0,0,0,0,0,0,0,0,0,0,0
20200520,710003,精測元大99購03,0.81,0.82,0.78,0.80,-0.04,-4.76,355000,15,283520,0,0,0,0,0,0,164000,190000,-26000,-26000
20200520,710004,中美晶元富9B購01,1.49,1.52,1.46,1.47,-0.06,-3.92,362000,14,534590,0,0,0,0,0,0,349000,32000,317000,317000
20200520,710005,中美晶元富9B購02,1.65,1.65,1.65,1.65,-0.03,-1.79,9000,1,14850,0,0,0,0,0,0,9000,0,9000,9000
20200520,710006,神盾元富9B購01,1.94,1.94,1.78,1.78,-0.10,-5.32,143000,43,273580,0,0,0,0,0,0,122000,35000,87000,87000
20200520,710007,環球晶元富9B購01,1.94,1.94,1.87,1.87,-0.07,-3.61,61000,4,118100,0,0,0,0,0,0,55000,6000,49000,49000
20200520,710008,環球晶元富9B購02,2.56,2.56,2.56,2.56,-0.02,-0.78,6000,1,15360,0,0,0,0,0,0,6000,0,6000,6000
20200520,710009,穩懋元富99購01,3.43,3.45,3.29,3.29,-0.32,-8.86,59000,10,200880,0,0,0,0,0,0,32000,27000,5000,5000
20200520,710010,中美晶國票9A購02,1.83,1.83,1.83,1.83,-0.01,-0.54,8000,1,14640,0,0,0,0,0,0,8000,0,8000,8000
20200520,710011,泰博國票9A購01,,,,,,0.00,0,0,0,0,0,0,0,0,0,0,0,0,0
20200520,710012,大宇資凱基9B購02,1.20,1.20,1.13,1.14,-0.01,-0.87,867000,37,999890,0,0,0,0,0,0,107000,760000,-653000,-653000
20200520,710013,金可凱基99購01,,,,,,0.00,0,0,0,0,0,0,0,0,0,0,0,0,0
20200520,710014,信驊凱基99購01,,,,,,0.00,0,0,0,0,0,0,0,0,0,0,0,0,0
20200520,710015,統新凱基9A購01,,,,,,0.00,0,0,0,0,0,0,0,0,0,0,0,0,0
20200520,710016,群聯凱基9A購01,1.61,1.64,1.61,1.64,-0.01,-0.61,44000,4,71040,0,0,0,0,0,0,32000,44000,-12000,-12000
20200520,710017,環球晶凱基99購09,2.00,2.00,1.92,1.92,-0.09,-4.48,56000,4,107770,0,0,0,0,0,0,51000,56000,-5000,-5000
20200520,710018,譜瑞凱基99購02,4.83,4.88,4.49,4.49,-0.44,-8.92,30000,10,143680,0,0,0,0,0,0,17000,13000,4000,4000
20200520,710019,精測中信9A購01,0.58,0.58,0.53,0.54,-0.04,-6.9,1037000,27,566720,0,0,0,0,0,0,632000,389000,243000,243000
20200520,710020,合晶永豐99購01,3.33,3.36,3.28,3.35,+0.09,2.76,80000,10,263680,0,0,0,0,0,0,16000,70000,-54000,-54000
20200520,710021,雙鴻永豐99購03,2.21,2.21,2.16,2.16,-0.04,-1.82,59000,5,129280,0,0,0,0,0,0,57000,3000,54000,54000
20200520,710022,譜瑞永豐99購01,3.85,4.00,3.85,3.94,+0.06,1.55,52000,3,200980,0,0,0,0,0,0,46000,6000,40000,40000
20200520,710023,鈊象永豐99購03,1.34,1.34,1.33,1.33,-0.04,-2.92,4000,2,5340,0,0,0,0,0,0,0,4000,-4000,-4000
20200520,710024,宏捷科永豐99購04,2.03,2.03,2.03,2.03,-0.07,-3.33,24000,2,48720,0,0,0,0,0,0,0,24000,-24000,-24000
20200520,710025,泰博永豐99購02,,,,,,0.00,0,0,0,0,0,0,0,0,0,0,0,0,0
20200520,710026,群聯永豐99購02,1.51,1.51,1.47,1.48,-0.03,-1.99,46000,3,68460,0,0,0,0,0,0,30000,36000,-6000,-6000
20200520,710027,優群永豐99購02,2.75,2.86,2.75,2.86,+0.11,4.0,63000,3,176030,0,0,0,0,0,0,37000,25000,12000,12000
20200520,710028,原相群益9C購02,1.54,1.54,1.52,1.52,-0.05,-3.18,96000,5,147500,0,0,0,0,0,0,88000,8000,80000,80000
20200520,710029,優群群益9A購01,3.18,3.31,3.18,3.31,+0.14,4.42,29000,2,95210,0,0,0,0,0,0,6000,23000,-17000,-17000
20200520,710030,大宇資元大9A購01,2.29,2.29,2.24,2.26,+0.05,2.26,52000,3,118080,0,0,0,0,0,0,52000,0,52000,52000
20200520,710031,金居元大99購04,,,,,,0.00,0,0,0,0,0,0,0,0,0,0,0,0,0
20200520,710032,精測元大99購04,0.79,0.79,0.75,0.78,-0.07,-8.24,149000,7,115180,0,0,0,0,0,0,36000,112000,-76000,-76000
20200520,710033,聯亞元大9A購01,3.39,3.39,3.29,3.29,-0.17,-4.91,16000,3,53940,0,0,0,0,0,0,13000,3000,10000,10000
20200520,710034,穩懋元大9A購01,1.82,1.82,1.74,1.76,-0.15,-7.85,40000,7,71160,0,0,0,0,0,0,20000,28000,-8000,-8000
20200520,710035,雙鴻元富99購01,,,,,,0.00,0,0,0,0,0,0,0,0,0,0,0,0,0
20200520,710036,大學光凱基9A購02,3.36,3.52,3.36,3.52,+0.29,8.98,30000,3,104000,0,0,0,0,0,0,0,20000,-20000,-20000
20200520,710037,群聯凱基99購03,2.72,2.73,2.72,2.73,-0.04,-1.44,25000,2,68150,0,0,0,0,0,0,25000,0,25000,25000
20200520,710038,泰博群益9A購01,,,,,,0.00,0,0,0,0,0,0,0,0,0,0,0,0,0
20200520,710039,宏捷科富邦9B購02,,,,,,0.00,0,0,0,0,0,0,0,0,0,0,0,0,0
20200520,710040,穩懋亞東99購01,1.07,1.07,1.07,1.07,-0.09,-7.76,10000,2,10700,0,0,0,0,0,0,0,10000,-10000,-10000
20200520,710041,原相凱基99購02,2.16,2.16,2.13,2.15,-0.09,-4.02,71000,3,152720,0,0,0,0,0,0,71000,30000,41000,41000
20200520,710042,群聯凱基99購04,3.19,3.19,3.13,3.16,-0.07,-2.17,55000,5,172930,0,0,0,0,0,0,45000,10000,35000,35000
20200520,710043,碩禾凱基9B購02,0.96,0.98,0.96,0.97,+0.03,3.19,165000,8,159910,0,0,0,0,0,0,95000,95000,0,0
20200520,710044,雙美凱基99購03,,,,,,0.00,0,0,0,0,0,0,0,0,0,0,0,0,0
20200520,710045,穩懋凱基99購06,2.20,2.20,2.14,2.14,-0.06,-2.73,34000,3,73860,0,0,0,0,0,0,30000,4000,26000,26000
20200520,710046,威剛元大9A購03,2.11,2.11,2.05,2.06,-0.02,-0.96,273000,17,566280,0,0,0,0,0,0,273000,0,273000,273000
20200520,710047,群聯元大99購06,8.40,8.40,8.25,8.35,-0.10,-1.18,24000,6,199300,0,0,0,0,0,0,12000,14000,-2000,-2000
20200520,710048,環球晶元大99購05,,,,,,0.00,0,0,0,0,0,0,0,0,0,0,0,0,0
20200520,710049,環球晶元大99購06,5.10,5.10,5.10,5.10,-0.05,-0.97,1000,1,5100,0,0,0,0,0,0,1000,1000,0,0
20200520,710050,中美晶永豐99購01,,,,,,0.00,0,0,0,0,0,0,0,0,0,0,0,0,0
20200520,710051,宏捷科永豐99購05,3.16,3.16,3.16,3.16,-0.14,-4.24,4000,1,12640,0,0,0,0,0,0,0,4000,-4000,-4000
20200520,710052,原相永豐99購03,1.26,1.26,1.26,1.26,-0.03,-2.33,10000,1,12600,0,0,0,0,0,0,0,10000,-10000,-10000
20200520,710053,環球晶永豐99購04,1.66,1.66,1.66,1.66,+0.01,0.61,1000,1,1660,0,0,0,0,0,0,1000,1000,0,0
20200520,710054,聯亞永豐99購01,1.47,1.47,1.43,1.43,-0.08,-5.3,125000,4,181730,0,0,0,0,0,0,66000,59000,7000,7000
20200520,710055,雙鴻永豐9A購01,,,,,,0.00,0,0,0,0,0,0,0,0,0,0,0,0,0
20200520,710056,大江元大99購05,,,,,,0.00,0,0,0,0,0,0,0,0,0,0,0,0,0
20200520,710057,M31永豐99購03,3.02,3.19,3.02,3.14,+0.21,7.17,127000,12,395630,0,0,0,0,0,0,127000,0,127000,127000
20200520,710058,力致永豐9A購01,,,,,,0.00,0,0,0,0,0,0,0,0,0,0,0,0,0
20200520,710059,大田永豐99購01,2.56,2.60,2.42,2.60,+0.09,3.59,544000,37,1372660,0,0,0,0,0,0,500000,40000,460000,460000
20200520,710060,光頡永豐99購02,2.57,2.57,2.57,2.57,+0.07,2.8,10000,1,25700,0,0,0,0,0,0,10000,0,10000,10000
20200520,710061,迅得永豐99購02,2.26,2.27,2.26,2.27,+0.17,8.1,24000,6,54280,0,0,0,0,0,0,0,24000,-24000,-24000
20200520,710062,原相永豐99購04,1.36,1.36,1.31,1.31,-0.10,-7.09,11000,2,14460,0,0,0,0,0,0,10000,1000,9000,9000
20200520,710063,神盾永豐99購03,2.53,2.55,2.45,2.45,+0.01,0.41,116000,3,287800,0,0,0,0,0,0,116000,0,116000,116000
20200520,710064,聚積永豐99購02,2.01,2.05,2.00,2.05,+0.10,5.13,91000,6,183650,0,0,0,0,0,0,5000,86000,-81000,-81000
20200520,710065,璟德永豐99購02,1.82,1.84,1.79,1.82,-0.02,-1.09,131000,12,237910,0,0,0,0,0,0,80000,41000,39000,39000
20200520,710066,宏捷科群益99購03,2.94,2.94,2.84,2.84,-0.15,-5.02,41000,2,119540,0,0,0,0,0,0,10000,41000,-31000,-31000
20200520,710067,原相群益9C購03,4.01,4.03,3.95,3.96,-0.24,-5.71,159000,7,638300,0,0,0,0,0,0,155000,4000,151000,151000
20200520,710068,威剛康和99購01,2.44,2.45,2.40,2.40,-0.06,-2.44,132000,22,319800,0,0,0,0,0,0,132000,122000,10000,10000
20200520,710069,大江凱基99購02,3.64,3.64,3.64,3.64,-0.06,-1.62,1000,1,3640,0,0,0,0,0,0,1000,1000,0,0
20200520,710070,中美晶凱基99購08,1.32,1.32,1.32,1.32,-0.06,-4.35,2000,1,2640,0,0,0,0,0,0,2000,0,2000,2000
20200520,710071,原相凱基99購03,1.58,1.58,1.55,1.56,-0.08,-4.88,117000,6,183960,0,0,0,0,0,0,30000,107000,-77000,-77000
20200520,710072,環球晶凱基99購11,1.36,1.36,1.35,1.36,-0.06,-4.23,35000,4,47550,0,0,0,0,0,0,0,35000,-35000,-35000
20200520,710073,穩懋兆豐9A購02,2.78,2.78,2.76,2.76,-0.20,-6.76,22000,2,61140,0,0,0,0,0,0,0,22000,-22000,-22000
20200520,710074,群聯元富99購01,3.01,3.01,2.93,2.98,-0.06,-1.97,782000,13,2330210,0,0,0,0,0,0,712000,768000,-56000,-56000
20200520,710075,大江富邦9B購03,,,,,,0.00,0,0,0,0,0,0,0,0,0,0,0,0,0
20200520,710076,穩懋富邦9B購03,,,,,,0.00,0,0,0,0,0,0,0,0,0,0,0,0,0
20200520,710077,中美晶元大9A購01,1.54,1.54,1.50,1.52,-0.03,-1.94,347000,8,531100,0,0,0,0,0,0,200000,147000,53000,53000
20200520,710078,宇峻元大9A購01,,,,,,0.00,0,0,0,0,0,0,0,0,0,0,0,0,0
20200520,710079,宣德元大9A購01,,,,,,0.00,0,0,0,0,0,0,0,0,0,0,0,0,0
20200520,710080,環球晶元大99購09,,,,,,0.00,0,0,0,0,0,0,0,0,0,0,0,0,0
20200520,710081,穩懋元大99購13,5.20,5.20,5.05,5.05,-0.40,-7.34,7000,2,35800,0,0,0,0,0,0,4000,7000,-3000,-3000
20200520,710082,穩懋元大99購14,,,,,,0.00,0,0,0,0,0,0,0,0,0,0,0,0,0
20200520,710083,宏捷科凱基99購02,,,,,,0.00,0,0,0,0,0,0,0,0,0,0,0,0,0
20200520,710084,泰博凱基99購02,3.41,3.43,3.41,3.43,-0.39,-10.21,10000,3,34160,0,0,0,0,0,0,10000,0,10000,10000
20200520,710085,群聯凱基99購05,2.23,2.26,2.20,2.20,-0.08,-3.51,41000,5,91070,0,0,0,0,0,0,27000,24000,3000,3000
20200520,710086,穩懋凱基99購07,,,,,,0.00,0,0,0,0,0,0,0,0,0,0,0,0,0
20200520,710087,大學光永豐99購03,,,,,,0.00,0,0,0,0,0,0,0,0,0,0,0,0,0
20200520,710088,威剛永豐99購03,1.95,1.95,1.91,1.91,-0.05,-2.55,295000,9,569410,0,0,0,0,0,0,255000,40000,215000,215000
20200520,710089,宣德永豐99購02,3.25,3.25,3.25,3.25,+0.08,2.52,2000,1,6500,0,0,0,0,0,0,2000,0,2000,2000
20200520,710090,碩禾永豐99購02,,,,,,0.00,0,0,0,0,0,0,0,0,0,0,0,0,0
20200520,710091,優群元富99購01,4.49,4.76,4.42,4.59,+0.10,2.23,296000,27,1353740,0,0,0,0,0,0,94000,202000,-108000,-108000
20200520,710092,網家元大99購03,3.38,3.61,3.32,3.61,+0.33,10.06,240000,20,832160,0,0,0,0,0,0,224000,16000,208000,208000
20200520,710093,聚積元大9C購01,2.64,2.68,2.59,2.63,+0.01,0.38,147000,5,386170,0,0,0,0,0,0,66000,81000,-15000,-15000
20200520,710094,雙美元大9C購01,1.78,1.78,1.75,1.75,0.00,0.0,80000,2,141800,0,0,0,0,0,0,60000,20000,40000,40000
20200520,710095,穩懋元大99購15,4.91,4.91,4.70,4.76,-0.39,-7.57,10000,6,47660,0,0,0,0,0,0,9000,9000,0,0
20200520,710096,鈺太元大9A購01,,,,,,0.00,0,0,0,0,0,0,0,0,0,0,0,0,0
20200520,710097,大學光群益9A購01,,,,,,0.00,0,0,0,0,0,0,0,0,0,0,0,0,0
20200520,710098,尼克森永豐99購01,1.79,1.93,1.79,1.85,+0.20,12.12,506000,32,950290,0,0,0,0,0,0,313000,193000,120000,120000
20200520,710099,亞泰永豐99購03,,,,,,0.00,0,0,0,0,0,0,0,0,0,0,0,0,0
20200520,710100,旺矽永豐99購01,3.75,4.07,3.66,4.03,+0.29,7.75,33000,9,128240,0,0,0,0,0,0,1000,32000,-31000,-31000
20200520,710101,昇達科永豐99購01,,,,,,0.00,0,0,0,0,0,0,0,0,0,0,0,0,0
20200520,710102,信昌電永豐99購02,2.32,2.32,2.20,2.22,+0.07,3.26,68000,4,157040,0,0,0,0,0,0,59000,9000,50000,50000
20200520,710103,威剛永豐99購04,2.72,2.74,2.64,2.64,-0.08,-2.94,102000,5,277030,0,0,0,0,0,0,102000,0,102000,102000
20200520,710104,新鉅科永豐99購02,1.43,1.47,1.43,1.47,+0.04,2.8,88000,3,125920,0,0,0,0,0,0,2000,86000,-84000,-84000
20200520,710105,網龍永豐99購01,,,,,,0.00,0,0,0,0,0,0,0,0,0,0,0,0,0
20200520,710106,廣明永豐99購01,2.79,2.80,2.77,2.77,-0.19,-6.42,68000,4,190070,0,0,0,0,0,0,58000,10000,48000,48000
20200520,710107,緯軟永豐99購02,1.80,1.90,1.80,1.85,+0.07,3.93,83000,7,152260,0,0,0,0,0,0,0,83000,-83000,-83000
20200520,710108,環宇永豐99購01,1.34,1.35,1.33,1.33,+0.07,5.56,32000,4,42800,0,0,0,0,0,0,30000,2000,28000,28000
20200520,710109,晟德永豐99購01,2.67,2.95,2.67,2.95,+0.28,10.49,290000,14,831130,0,0,0,0,0,0,44000,246000,-202000,-202000
20200520,710110,信昌電富邦9C購01,,,,,,0.00,0,0,0,0,0,0,0,0,0,0,0,0,0
20200520,710111,三貝德凱基99購03,1.95,1.95,1.95,1.95,+0.05,2.63,75000,2,146250,0,0,0,0,0,0,75000,0,75000,75000
20200520,710112,大江凱基99購03,2.76,2.76,2.76,2.76,-0.03,-1.08,1000,1,2760,0,0,0,0,0,0,1000,1000,0,0
20200520,710113,宣德凱基99購01,2.67,2.72,2.67,2.72,+0.04,1.49,10000,2,27150,0,0,0,0,0,0,10000,0,10000,10000
20200520,710114,原相凱基99購04,,,,,,0.00,0,0,0,0,0,0,0,0,0,0,0,0,0
20200520,710115,群聯凱基99購06,,,,,,0.00,0,0,0,0,0,0,0,0,0,0,0,0,0
20200520,710116,環球晶凱基99購12,,,,,,0.00,0,0,0,0,0,0,0,0,0,0,0,0,0
20200520,710117,聯亞凱基99購05,1.17,1.17,1.17,1.17,-0.03,-2.5,88000,1,102960,0,0,0,0,0,0,0,88000,-88000,-88000
20200520,710118,雙鴻凱基99購02,,,,,,0.00,0,0,0,0,0,0,0,0,0,0,0,0,0
20200520,710119,穩懋凱基99購08,1.25,1.25,1.24,1.24,-0.08,-6.06,35000,2,43700,0,0,0,0,0,0,30000,5000,25000,25000
20200520,710120,鈊象凱基99購02,1.26,1.26,1.22,1.22,-0.02,-1.61,71000,4,86910,0,0,0,0,0,0,71000,1000,70000,70000
20200520,710121,三貝德永豐99購02,,,,,,0.00,0,0,0,0,0,0,0,0,0,0,0,0,0
20200520,710122,大江永豐99購03,,,,,,0.00,0,0,0,0,0,0,0,0,0,0,0,0,0
20200520,710123,安勤永豐99購01,0.98,0.98,0.98,0.98,+0.05,5.38,38000,1,37240,0,0,0,0,0,0,0,38000,-38000,-38000
20200520,710124,良維永豐99購01,2.40,2.43,2.38,2.38,+0.01,0.42,60000,6,144600,0,0,0,0,0,0,60000,10000,50000,50000
20200520,710125,金居永豐99購01,2.34,2.34,2.34,2.34,-0.08,-3.31,10000,1,23400,0,0,0,0,0,0,0,10000,-10000,-10000
20200520,710126,南光永豐99購01,1.10,1.12,1.10,1.12,+0.05,4.67,200000,2,222000,0,0,0,0,0,0,0,200000,-200000,-200000
20200520,710127,原相永豐99購05,1.54,1.54,1.54,1.54,-0.04,-2.53,10000,1,15400,0,0,0,0,0,0,10000,0,10000,10000
20200520,710128,晶焱永豐99購02,1.23,1.23,1.23,1.23,0.00,0.0,48000,2,59040,0,0,0,0,0,0,48000,0,48000,48000
20200520,710129,群聯永豐99購03,1.32,1.34,1.29,1.34,+0.01,0.75,112000,3,146580,0,0,0,0,0,0,112000,0,112000,112000
20200520,710130,精測永豐99購03,,,,,,0.00,0,0,0,0,0,0,0,0,0,0,0,0,0
20200520,710131,璟德永豐99購03,1.26,1.28,1.22,1.24,0.00,0.0,239000,12,296670,0,0,0,0,0,0,90000,139000,-49000,-49000
20200520,710132,鈊象永豐99購04,,,,,,0.00,0,0,0,0,0,0,0,0,0,0,0,0,0
20200520,710133,宏捷科國泰9B購02,1.97,1.98,1.97,1.98,-0.08,-3.88,104000,2,204910,0,0,0,0,0,0,0,104000,-104000,-104000
20200520,710134,環球晶國泰9A購03,2.20,2.20,2.10,2.10,-0.09,-4.11,77000,12,164550,0,0,0,0,0,0,25000,55000,-30000,-30000
20200520,710135,穩懋國泰9A購02,1.93,1.94,1.85,1.85,-0.16,-7.96,174000,15,328110,0,0,0,0,0,0,96000,78000,18000,18000
20200520,710136,大江元大9A購01,,,,,,0.00,0,0,0,0,0,0,0,0,0,0,0,0,0
20200520,710137,原相元大9B購01,5.20,5.20,5.10,5.10,-0.15,-2.86,5000,2,25600,0,0,0,0,0,0,4000,5000,-1000,-1000
20200520,710138,群聯元大99購07,7.05,7.05,6.80,7.00,0.00,0.0,38000,12,263500,0,0,0,0,0,0,30000,15000,15000,15000
20200520,710139,環球晶元大99購10,3.94,3.94,3.87,3.87,-0.02,-0.51,50000,5,196370,0,0,0,0,0,0,20000,41000,-21000,-21000
20200520,710140,環球晶元大99購11,3.99,4.01,3.93,3.93,-0.09,-2.24,24000,4,94980,0,0,0,0,0,0,9000,24000,-15000,-15000
20200520,710141,聯亞元大99購03,3.24,3.24,3.24,3.24,-0.09,-2.7,50000,1,162000,0,0,0,0,0,0,50000,0,50000,50000
20200520,710142,穩懋元大99購16,5.00,5.00,4.85,4.94,-0.41,-7.66,123000,5,602440,0,0,0,0,0,0,123000,6000,117000,117000
20200520,710143,譜瑞元大99購01,8.75,8.75,8.75,8.75,-0.70,-7.41,2000,1,17500,0,0,0,0,0,0,2000,0,2000,2000
20200520,710144,鈊象元大9A購01,2.59,2.61,2.48,2.48,-0.09,-3.5,235000,14,598020,0,0,0,0,0,0,168000,70000,98000,98000
20200520,710145,原相台新99購02,1.84,1.84,1.84,1.84,-0.10,-5.15,8000,1,14720,0,0,0,0,0,0,8000,0,8000,8000
20200520,710146,群聯台新99購01,,,,,,0.00,0,0,0,0,0,0,0,0,0,0,0,0,0
20200520,710147,精測元富99購03,1.45,1.47,1.39,1.39,-0.16,-10.32,454000,21,654260,0,0,0,0,0,0,394000,53000,341000,341000
20200520,710148,精測元富99購04,1.34,1.38,1.34,1.34,-0.10,-6.94,299000,20,409760,0,0,0,0,0,0,229000,70000,159000,159000
20200520,710149,鈊象元富99購02,,,,,,0.00,0,0,0,0,0,0,0,0,0,0,0,0,0
20200520,710150,M31凱基9A購01,2.58,2.63,2.58,2.63,+0.19,7.79,44000,5,114720,0,0,0,0,0,0,0,44000,-44000,-44000
20200520,710151,VHQ凱基99購01,1.45,1.45,1.44,1.44,+0.07,5.11,64000,4,92550,0,0,0,0,0,0,25000,39000,-14000,-14000
20200520,710152,中美晶凱基9A購03,,,,,,0.00,0,0,0,0,0,0,0,0,0,0,0,0,0
20200520,710153,威剛凱基9A購03,1.91,1.91,1.91,1.91,0.00,0.0,20000,2,38200,0,0,0,0,0,0,20000,0,20000,20000
20200520,710154,原相凱基9A購02,,,,,,0.00,0,0,0,0,0,0,0,0,0,0,0,0,0
20200520,710155,群聯凱基9A購02,,,,,,0.00,0,0,0,0,0,0,0,0,0,0,0,0,0
20200520,710156,精測凱基9A購01,0.86,0.86,0.83,0.85,-0.04,-4.49,59000,5,49710,0,0,0,0,0,0,50000,9000,41000,41000
20200520,710157,優群凱基9A購03,1.85,1.86,1.85,1.86,+0.10,5.68,20000,2,37100,0,0,0,0,0,0,10000,10000,0,0
20200520,710158,環球晶凱基9A購01,1.07,1.07,1.06,1.06,-0.02,-1.85,8000,4,8490,0,0,0,0,0,0,3000,4000,-1000,-1000
20200520,710159,雙美凱基9A購01,,,,,,0.00,0,0,0,0,0,0,0,0,0,0,0,0,0
20200520,710160,穩懋凱基9A購01,1.18,1.20,1.18,1.20,-0.07,-5.51,10000,2,11900,0,0,0,0,0,0,10000,0,10000,10000
20200520,710161,鈊象凱基9A購02,0.90,0.90,0.90,0.90,-0.06,-6.25,20000,1,18000,0,0,0,0,0,0,20000,0,20000,20000
20200520,710162,鈊象凱基9B購01,0.65,0.65,0.63,0.63,-0.02,-3.08,262000,14,166400,0,0,0,0,0,0,141000,110000,31000,31000
20200520,710163,鈺太國泰9B購01,,,,,,0.00,0,0,0,0,0,0,0,0,0,0,0,0,0
20200520,710164,大江元大9A購02,8.95,8.95,8.85,8.85,+0.05,0.57,13000,3,116100,0,0,0,0,0,0,3000,12000,-9000,-9000
20200520,710165,大學光元大9C購01,,,,,,0.00,0,0,0,0,0,0,0,0,0,0,0,0,0
20200520,710166,中美晶元大9A購02,3.29,3.29,3.21,3.21,-0.15,-4.46,86000,3,280390,0,0,0,0,0,0,36000,75000,-39000,-39000
20200520,710167,宏捷科元大9B購01,1.25,1.26,1.24,1.25,-0.02,-1.57,23000,5,28890,0,0,0,0,0,0,13000,10000,3000,3000
20200520,710168,原相元大9A購04,4.40,4.40,4.26,4.26,-0.23,-5.12,68000,8,296350,0,0,0,0,0,0,44000,28000,16000,16000
20200520,710169,晶焱元大99購02,2.88,2.91,2.86,2.91,0.00,0.0,124000,8,357440,0,0,0,0,0,0,74000,50000,24000,24000
20200520,710170,聯亞元大99購04,2.61,2.61,2.49,2.58,-0.12,-4.44,90000,8,231560,0,0,0,0,0,0,90000,0,90000,90000
20200520,710171,穩懋元大99購17,2.96,2.96,2.84,2.87,-0.22,-7.12,23000,7,67070,0,0,0,0,0,0,8000,23000,-15000,-15000
20200520,710172,穩懋元大99購18,2.50,2.50,2.39,2.39,-0.23,-8.78,75000,8,184410,0,0,0,0,0,0,27000,55000,-28000,-28000
20200520,710173,原相台新99購03,2.82,2.82,2.82,2.82,-0.16,-5.37,2000,1,5640,0,0,0,0,0,0,2000,0,2000,2000
20200520,710174,群聯台新99購02,3.09,3.09,3.09,3.09,-0.03,-0.96,4000,1,12360,0,0,0,0,0,0,4000,0,4000,4000
20200520,710175,伍豐永豐99購01,,,,,,0.00,0,0,0,0,0,0,0,0,0,0,0,0,0
20200520,710176,兆利永豐99購02,0.97,0.99,0.97,0.99,+0.02,2.06,54000,2,52920,0,0,0,0,0,0,0,54000,-54000,-54000
20200520,710177,同亨永豐99購01,,,,,,0.00,0,0,0,0,0,0,0,0,0,0,0,0,0
20200520,710178,合晶永豐99購02,1.87,1.90,1.86,1.90,+0.12,6.74,80000,16,150260,0,0,0,0,0,0,6000,79000,-73000,-73000
20200520,710179,宜鼎永豐99購01,1.60,1.66,1.60,1.66,+0.09,5.73,299000,7,484120,0,0,0,0,0,0,152000,147000,5000,5000
20200520,710180,信驊永豐99購04,1.19,1.20,1.03,1.03,-0.08,-7.21,967000,49,1114480,0,0,0,0,0,0,874000,57000,817000,817000
20200520,710181,聯亞永豐99購02,0.87,0.87,0.87,0.87,-0.01,-1.14,20000,1,17400,0,0,0,0,0,0,20000,0,20000,20000
20200520,710182,M31凱基99購03,2.02,2.10,1.90,1.90,-0.04,-2.06,212000,30,436700,0,0,0,0,0,0,142000,40000,102000,102000
20200520,710183,中美晶凱基99購09,1.23,1.24,1.23,1.24,-0.04,-3.12,25000,2,30800,0,0,0,0,0,0,20000,5000,15000,15000
20200520,710184,雍智凱基99購02,3.55,3.76,3.55,3.76,+0.34,9.94,100000,12,364060,0,0,0,0,0,0,14000,86000,-72000,-72000
20200520,710185,精測凱基99購04,0.69,0.69,0.65,0.65,-0.06,-8.45,44000,4,28680,0,0,0,0,0,0,20000,22000,-2000,-2000
20200520,710186,環球晶凱基99購13,0.84,0.84,0.81,0.81,-0.03,-3.57,53000,5,43830,0,0,0,0,0,0,36000,18000,18000,18000
20200520,710187,聯亞凱基99購06,,,,,,0.00,0,0,0,0,0,0,0,0,0,0,0,0,0
20200520,710188,穩懋凱基99購09,,,,,,0.00,0,0,0,0,0,0,0,0,0,0,0,0,0
20200520,710189,譜瑞凱基99購03,2.34,2.34,2.34,2.34,-0.04,-1.68,30000,5,70200,0,0,0,0,0,0,30000,0,30000,30000
20200520,710190,鈊象凱基99購03,0.76,0.76,0.75,0.76,-0.02,-2.56,45000,3,34100,0,0,0,0,0,0,10000,35000,-25000,-25000
20200520,710191,中美晶國票99購02,4.36,4.36,4.21,4.21,-0.09,-2.09,13000,2,55180,0,0,0,0,0,0,13000,0,13000,13000
20200520,710192,穩懋國票99購04,,,,,,0.00,0,0,0,0,0,0,0,0,0,0,0,0,0
20200520,710193,三貝德康和99購01,,,,,,0.00,0,0,0,0,0,0,0,0,0,0,0,0,0
20200520,710194,優群康和99購01,1.13,1.13,1.13,1.13,+0.02,1.8,5000,1,5650,0,0,0,0,0,0,5000,0,5000,5000
20200520,710195,原相元富99購01,3.57,3.57,3.54,3.57,-0.16,-4.29,47000,6,167280,0,0,0,0,0,0,17000,30000,-13000,-13000
20200520,710196,穩懋元富99購02,,,,,,0.00,0,0,0,0,0,0,0,0,0,0,0,0,0
20200520,710197,由田永豐99購01,0.78,0.78,0.77,0.77,0.00,0.0,32000,2,24940,0,0,0,0,0,0,2000,30000,-28000,-28000
20200520,710198,長科*永豐99購01,1.38,1.42,1.38,1.42,0.00,0.0,312000,6,436000,0,0,0,0,0,0,20000,292000,-272000,-272000
20200520,710199,皇田永豐99購01,,,,,,0.00,0,0,0,0,0,0,0,0,0,0,0,0,0
20200520,710200,美琪瑪永豐99購01,1.62,1.62,1.60,1.60,-0.07,-4.19,15000,2,24100,0,0,0,0,0,0,10000,5000,5000,5000
20200520,710201,新揚科永豐99購01,,,,,,0.00,0,0,0,0,0,0,0,0,0,0,0,0,0
20200520,710202,雍智永豐99購02,3.15,3.15,3.15,3.15,+0.45,16.67,5000,1,15750,0,0,0,0,0,0,5000,0,5000,5000
20200520,710203,精華永豐99購02,1.11,1.11,1.08,1.08,-0.03,-2.7,152000,3,164730,0,0,0,0,0,0,19000,133000,-114000,-114000
20200520,710204,網家永豐99購01,2.03,2.16,2.03,2.07,+0.11,5.61,125000,17,256950,0,0,0,0,0,0,85000,40000,45000,45000
20200520,710205,網龍永豐99購02,,,,,,0.00,0,0,0,0,0,0,0,0,0,0,0,0,0
20200520,710206,鈊象永豐99購05,,,,,,0.00,0,0,0,0,0,0,0,0,0,0,0,0,0
20200520,710207,中美晶國泰9B購01,2.11,2.11,2.05,2.05,-0.07,-3.3,880000,20,1819640,0,0,0,0,0,0,403000,477000,-74000,-74000
20200520,710208,群聯國泰9B購01,1.95,1.95,1.90,1.92,-0.01,-0.52,793000,19,1518440,0,0,0,0,0,0,553000,240000,313000,313000
20200520,710209,群聯富邦9A購01,,,,,,0.00,0,0,0,0,0,0,0,0,0,0,0,0,0
20200520,710210,環球晶富邦9B購03,0.67,0.67,0.64,0.64,-0.04,-5.88,21000,3,13470,0,0,0,0,0,0,21000,1000,20000,20000
20200520,710211,穩懋富邦9B購04,0.91,0.91,0.87,0.88,-0.06,-6.38,656000,39,580590,0,0,0,0,0,0,71000,583000,-512000,-512000
20200520,710212,群聯元大99購08,4.38,4.38,4.19,4.31,-0.08,-1.82,36000,13,155290,0,0,0,0,0,0,36000,9000,27000,27000
20200520,710213,鈊象元大99購06,2.63,2.63,2.55,2.55,-0.13,-4.85,71000,8,181690,0,0,0,0,0,0,71000,41000,30000,30000
20200520,710214,大江凱基99購04,2.20,2.20,2.20,2.20,+0.04,1.85,1000,1,2200,0,0,0,0,0,0,1000,1000,0,0
20200520,710215,旺矽凱基99購01,,,,,,0.00,0,0,0,0,0,0,0,0,0,0,0,0,0
20200520,710216,泰博凱基99購03,,,,,,0.00,0,0,0,0,0,0,0,0,0,0,0,0,0
20200520,710217,晶焱凱基99購02,0.88,0.90,0.88,0.89,-0.01,-1.11,112000,6,99580,0,0,0,0,0,0,78000,34000,44000,44000
20200520,710218,群聯凱基99購07,1.09,1.09,1.08,1.08,-0.02,-1.82,50000,4,54300,0,0,0,0,0,0,30000,20000,10000,10000
20200520,710219,精測凱基99購05,0.59,0.60,0.59,0.60,-0.03,-4.76,16000,2,9590,0,0,0,0,0,0,1000,15000,-14000,-14000
20200520,710220,鈊象凱基99購04,0.93,0.93,0.89,0.89,-0.04,-4.3,35000,3,32300,0,0,0,0,0,0,35000,0,35000,35000
20200520,710221,原相國票99購03,2.94,2.94,2.94,2.94,-0.07,-2.33,38000,1,111720,0,0,0,0,0,0,38000,0,38000,38000
20200520,710222,力麒康和99購01,,,,,,0.00,0,0,0,0,0,0,0,0,0,0,0,0,0
20200520,710223,美琪瑪康和99購01,,,,,,0.00,0,0,0,0,0,0,0,0,0,0,0,0,0
20200520,710224,新鉅科康和99購01,2.20,2.20,2.20,2.20,-0.02,-0.9,241000,5,530200,0,0,0,0,0,0,0,241000,-241000,-241000
20200520,710225,聯亞康和99購01,,,,,,0.00,0,0,0,0,0,0,0,0,0,0,0,0,0
20200520,710226,良維永豐99購02,1.55,1.56,1.51,1.54,+0.02,1.32,469000,18,728110,0,0,0,0,0,0,433000,118000,315000,315000
20200520,710227,保瑞永豐99購01,0.99,1.00,0.99,1.00,+0.03,3.09,128000,4,127550,0,0,0,0,0,0,60000,68000,-8000,-8000
20200520,710228,原相永豐99購06,1.04,1.05,1.02,1.02,-0.06,-5.56,22000,3,22490,0,0,0,0,0,0,20000,2000,18000,18000
20200520,710229,神盾永豐99購04,1.60,1.60,1.52,1.53,+0.06,4.08,234000,8,359600,0,0,0,0,0,0,214000,0,214000,214000
20200520,710230,神盾永豐99購05,1.64,1.65,1.50,1.50,-0.11,-6.83,762000,18,1217050,0,0,0,0,0,0,720000,42000,678000,678000
20200520,710231,優群永豐99購03,1.77,1.77,1.71,1.71,+0.07,4.27,66000,2,115080,0,0,0,0,0,0,0,66000,-66000,-66000
20200520,710232,鈺太永豐99購02,1.32,1.32,1.29,1.29,+0.07,5.74,35000,2,45450,0,0,0,0,0,0,10000,25000,-15000,-15000
20200520,710233,精測富邦9A購02,0.30,0.30,0.30,0.30,-0.02,-6.25,21000,7,6300,0,0,0,0,0,0,7000,14000,-7000,-7000
20200520,710234,台燿凱基99購01,1.39,1.42,1.33,1.33,-0.07,-5.0,171000,8,236770,0,0,0,0,0,0,76000,95000,-19000,-19000
20200520,710235,保瑞凱基99購01,1.15,1.15,1.15,1.15,-0.07,-5.74,72000,2,82800,0,0,0,0,0,0,42000,30000,12000,12000
20200520,710236,原相凱基99購05,,,,,,0.00,0,0,0,0,0,0,0,0,0,0,0,0,0
20200520,710237,神盾凱基99購03,1.68,1.70,1.55,1.55,-0.08,-4.91,246000,35,402860,0,0,0,0,0,0,164000,96000,68000,68000
20200520,710238,精測凱基9A購02,,,,,,0.00,0,0,0,0,0,0,0,0,0,0,0,0,0
20200520,710239,鈊象凱基99購05,1.13,1.13,1.13,1.13,+0.01,0.89,1000,1,1130,0,0,0,0,0,0,1000,1000,0,0
20200520,710240,原相元大99購05,2.73,2.73,2.73,2.73,-0.12,-4.21,6000,2,16380,0,0,0,0,0,0,6000,4000,2000,2000
20200520,710241,神盾元大9A購04,5.55,5.60,5.25,5.25,-0.15,-2.78,298000,26,1604000,0,0,0,0,0,0,288000,50000,238000,238000
20200520,710242,環球晶元大99購13,2.03,2.03,2.00,2.00,-0.02,-0.99,8000,4,16080,0,0,0,0,0,0,7000,8000,-1000,-1000
20200520,710243,穩懋元大99購20,1.21,1.21,1.16,1.16,-0.11,-8.66,31000,7,36210,0,0,0,0,0,0,8000,31000,-23000,-23000
20200520,710244,穩懋元大99購21,1.30,1.31,1.23,1.24,-0.12,-8.82,105000,14,132820,0,0,0,0,0,0,76000,48000,28000,28000
20200520,710245,中美晶群益99購04,1.74,1.74,1.70,1.70,-0.05,-2.86,312000,4,537300,0,0,0,0,0,0,312000,0,312000,312000
20200520,710246,鈊象群益99購06,1.54,1.54,1.49,1.49,-0.02,-1.32,41000,3,61340,0,0,0,0,0,0,1000,41000,-40000,-40000
20200520,710247,信驊元富99購01,1.98,2.00,1.67,1.67,-0.15,-8.24,214000,22,413330,0,0,0,0,0,0,119000,85000,34000,34000
20200520,710248,原相元富99購02,2.36,2.36,2.34,2.36,-0.10,-4.07,141000,9,332360,0,0,0,0,0,0,131000,10000,121000,121000
20200520,710249,群聯元富99購02,2.09,2.09,2.09,2.09,+0.01,0.48,20000,1,41800,0,0,0,0,0,0,20000,0,20000,20000
20200520,710250,大江國票99購02,12.50,12.50,12.50,12.50,+0.10,0.81,1000,1,12500,0,0,0,0,0,0,1000,1000,0,0
20200520,710251,泰博國票9A購02,,,,,,0.00,0,0,0,0,0,0,0,0,0,0,0,0,0
20200520,710252,群聯國票99購02,1.82,1.82,1.82,1.82,-0.01,-0.55,46000,3,83720,0,0,0,0,0,0,46000,0,46000,46000
20200520,710253,網龍康和99購01,,,,,,0.00,0,0,0,0,0,0,0,0,0,0,0,0,0
20200520,710254,鈊象國泰9B購01,1.92,1.94,1.87,1.87,-0.04,-2.09,1470000,28,2815540,0,0,0,0,0,0,1370000,101000,1269000,1269000
20200520,710255,中美晶富邦9B購03,0.72,0.73,0.71,0.71,-0.03,-4.05,70000,3,50500,0,0,0,0,0,0,0,70000,-70000,-70000
20200520,710256,金居群益9B購02,4.28,4.28,4.28,4.28,-0.17,-3.82,2000,1,8560,0,0,0,0,0,0,2000,0,2000,2000
20200520,710257,群聯群益99購02,2.29,2.31,2.24,2.25,-0.05,-2.17,114000,7,259960,0,0,0,0,0,0,86000,28000,58000,58000
20200520,710258,鈊象國票9B購01,1.87,1.87,1.83,1.83,-0.06,-3.17,86000,4,159020,0,0,0,0,0,0,26000,60000,-34000,-34000
20200520,710259,宇峻元大9B購01,2.59,2.67,2.59,2.65,+0.07,2.71,113000,9,294590,0,0,0,0,0,0,1000,112000,-111000,-111000
20200520,710260,威剛元大9B購01,3.41,3.43,3.33,3.33,-0.07,-2.06,308000,23,1040880,0,0,0,0,0,0,299000,34000,265000,265000
20200520,710261,神盾元大9B購01,2.65,2.65,2.46,2.46,-0.11,-4.28,183000,3,452380,0,0,0,0,0,0,183000,3000,180000,180000
20200520,710262,精測元大99購05,1.03,1.03,1.03,1.03,-0.04,-3.74,14000,2,14420,0,0,0,0,0,0,14000,14000,0,0
20200520,710263,環球晶元大99購14,2.95,2.95,2.80,2.80,-0.13,-4.44,64000,5,187750,0,0,0,0,0,0,9000,64000,-55000,-55000
20200520,710264,環球晶元大99購15,1.99,1.99,1.88,1.88,-0.09,-4.57,87000,7,170470,0,0,0,0,0,0,17000,77000,-60000,-60000
20200520,710265,穩懋元大99購22,1.85,1.85,1.77,1.77,-0.18,-9.23,91000,7,167140,0,0,0,0,0,0,20000,74000,-54000,-54000
20200520,710266,譜瑞元大99購02,4.11,4.16,3.87,3.88,-0.31,-7.4,28000,8,114540,0,0,0,0,0,0,28000,0,28000,28000
20200520,710267,中美晶凱基9B購01,,,,,,0.00,0,0,0,0,0,0,0,0,0,0,0,0,0
20200520,710268,世界凱基99購01,1.70,1.75,1.70,1.72,-0.02,-1.15,183000,8,315980,0,0,0,0,0,0,103000,80000,23000,23000
20200520,710269,建榮凱基99購01,,,,,,0.00,0,0,0,0,0,0,0,0,0,0,0,0,0
20200520,710270,碩禾凱基99購01,1.08,1.08,1.08,1.08,+0.02,1.89,50000,1,54000,0,0,0,0,0,0,50000,50000,0,0
20200520,710271,精測凱基99購06,0.46,0.46,0.45,0.45,-0.03,-6.25,105000,3,47400,0,0,0,0,0,0,15000,90000,-75000,-75000
20200520,710272,環球晶凱基9B購01,1.14,1.14,1.09,1.11,-0.05,-4.31,164000,6,181060,0,0,0,0,0,0,141000,24000,117000,117000
20200520,710273,穩懋凱基99購10,0.64,0.64,0.62,0.62,-0.06,-8.82,50000,2,31400,0,0,0,0,0,0,30000,20000,10000,10000
20200520,710274,力致永豐99購04,1.73,1.77,1.72,1.72,+0.03,1.78,57000,8,99140,0,0,0,0,0,0,0,57000,-57000,-57000
20200520,710275,三貝德永豐99購03,1.03,1.03,1.03,1.03,+0.03,3.0,10000,1,10300,0,0,0,0,0,0,10000,0,10000,10000
20200520,710276,宏捷科永豐99購06,0.99,0.99,0.99,0.99,-0.04,-3.88,5000,1,4950,0,0,0,0,0,0,0,5000,-5000,-5000
20200520,710277,杰力永豐99購01,2.16,2.26,2.16,2.26,+0.13,6.1,100000,7,221140,0,0,0,0,0,0,100000,0,100000,100000
20200520,710278,直得永豐99購01,1.64,1.70,1.64,1.69,+0.08,4.97,473000,13,790720,0,0,0,0,0,0,3000,470000,-467000,-467000
20200520,710279,威剛永豐99購05,1.26,1.28,1.26,1.28,0.00,0.0,312000,6,395360,0,0,0,0,0,0,312000,0,312000,312000
20200520,710280,新鉅科永豐99購03,1.02,1.06,1.02,1.06,+0.03,2.91,73000,3,75420,0,0,0,0,0,0,49000,24000,25000,25000
20200520,710281,碩禾永豐99購03,0.97,0.97,0.97,0.97,+0.01,1.04,80000,2,77600,0,0,0,0,0,0,80000,80000,0,0
20200520,710282,精測永豐99購04,0.37,0.37,0.37,0.37,+0.01,2.78,22000,1,8140,0,0,0,0,0,0,22000,0,22000,22000
20200520,710283,原相群益9A購01,0.92,0.92,0.89,0.89,-0.05,-5.32,723000,9,659210,0,0,0,0,0,0,80000,643000,-563000,-563000
20200520,710284,群聯群益9A購01,2.96,2.99,2.96,2.99,-0.05,-1.64,43000,6,127920,0,0,0,0,0,0,14000,31000,-17000,-17000
20200520,710285,大江富邦9C購01,,,,,,0.00,0,0,0,0,0,0,0,0,0,0,0,0,0
20200520,710286,神盾元富9A購01,1.92,1.92,1.74,1.74,-0.13,-6.95,642000,44,1179730,0,0,0,0,0,0,593000,9000,584000,584000
20200520,710287,群聯元富9A購01,2.03,2.03,2.03,2.03,+0.02,1.0,20000,1,40600,0,0,0,0,0,0,20000,0,20000,20000
20200520,710288,環球晶元富9A購01,1.31,1.31,1.26,1.26,-0.08,-5.97,178000,5,231610,0,0,0,0,0,0,80000,98000,-18000,-18000
20200520,710289,環球晶元富9A購02,2.31,2.31,2.31,2.31,-0.03,-1.28,6000,1,13860,0,0,0,0,0,0,6000,0,6000,6000
20200520,710290,穩懋元富9A購01,1.24,1.27,1.23,1.26,-0.08,-5.97,295000,11,366880,0,0,0,0,0,0,18000,277000,-259000,-259000
20200520,710291,鈺太元富9A購01,,,,,,0.00,0,0,0,0,0,0,0,0,0,0,0,0,0
20200520,710292,弘塑元大9B購01,2.65,2.71,2.65,2.71,-0.01,-0.37,283000,9,756900,0,0,0,0,0,0,170000,233000,-63000,-63000
20200520,710293,金可元大9A購01,2.11,2.13,2.11,2.13,-0.06,-2.74,20000,2,42300,0,0,0,0,0,0,20000,0,20000,20000
20200520,710294,博智元大9A購01,2.40,2.40,2.24,2.24,-0.12,-5.08,91000,10,212750,0,0,0,0,0,0,61000,30000,31000,31000
20200520,710295,群聯元大9A購02,2.62,2.62,2.53,2.56,-0.01,-0.39,245000,22,629110,0,0,0,0,0,0,245000,24000,221000,221000
20200520,710296,雍智元大9B購01,6.00,6.00,6.00,6.00,+0.70,13.21,10000,1,60000,0,0,0,0,0,0,10000,0,10000,10000
20200520,710297,環球晶元大9A購02,2.49,2.50,2.41,2.41,-0.09,-3.6,31000,7,76460,0,0,0,0,0,0,13000,25000,-12000,-12000
20200520,710298,穩懋元大9A購02,1.82,1.82,1.74,1.75,-0.17,-8.85,35000,9,61170,0,0,0,0,0,0,7000,35000,-28000,-28000
20200520,710299,大中永豐9A購01,1.57,1.66,1.57,1.66,+0.12,7.79,85000,2,140200,0,0,0,0,0,0,10000,75000,-65000,-65000
20200520,710300,尼克森永豐9A購01,1.60,1.68,1.57,1.57,+0.15,10.56,140000,13,229730,0,0,0,0,0,0,0,140000,-140000,-140000
20200520,710301,弘塑永豐9A購01,1.05,1.05,1.05,1.05,0.00,0.0,245000,2,257250,0,0,0,0,0,0,45000,200000,-155000,-155000
20200520,710302,均豪永豐9A購01,0.99,0.99,0.99,0.99,+0.08,8.79,72000,6,71280,0,0,0,0,0,0,0,72000,-72000,-72000
20200520,710303,迅得永豐9A購01,1.72,1.84,1.72,1.84,+0.18,10.84,201000,11,357380,0,0,0,0,0,0,66000,135000,-69000,-69000
20200520,710304,波若威永豐9A購01,1.91,2.02,1.91,2.00,+0.19,10.5,184000,7,369020,0,0,0,0,0,0,28000,156000,-128000,-128000
20200520,710305,前鼎永豐9A購01,1.80,1.80,1.78,1.79,+0.04,2.29,72000,7,129500,0,0,0,0,0,0,66000,6000,60000,60000
20200520,710306,建榮永豐9B購01,,,,,,0.00,0,0,0,0,0,0,0,0,0,0,0,0,0
20200520,710307,泰博永豐9A購01,,,,,,0.00,0,0,0,0,0,0,0,0,0,0,0,0,0
20200520,710308,神盾永豐9A購01,1.90,1.91,1.81,1.81,-0.03,-1.63,158000,7,289180,0,0,0,0,0,0,158000,0,158000,158000
20200520,710309,高技永豐9A購01,2.12,2.23,2.12,2.22,+0.15,7.25,574000,24,1251930,0,0,0,0,0,0,20000,544000,-524000,-524000
20200520,710310,博智永豐9A購02,0.73,0.73,0.69,0.70,-0.09,-11.39,150000,3,106300,0,0,0,0,0,0,150000,0,150000,150000
20200520,710311,群聯永豐9A購01,,,,,,0.00,0,0,0,0,0,0,0,0,0,0,0,0,0
20200520,710312,鈊象永豐9A購02,,,,,,0.00,0,0,0,0,0,0,0,0,0,0,0,0,0
20200520,710313,大中凱基9A購01,1.71,1.71,1.66,1.66,+0.05,3.11,12000,3,20270,0,0,0,0,0,0,1000,11000,-10000,-10000
20200520,710314,弘塑凱基9A購01,1.50,1.50,1.46,1.50,0.00,0.0,232000,10,344220,0,0,0,0,0,0,62000,170000,-108000,-108000
20200520,710315,良維凱基9A購01,1.52,1.55,1.51,1.55,-0.01,-0.64,213000,8,327430,0,0,0,0,0,0,213000,50000,163000,163000
20200520,710316,胡連凱基9A購01,2.12,2.22,2.12,2.22,+0.24,12.12,9000,4,19560,0,0,0,0,0,0,2000,6000,-4000,-4000
20200520,710317,群聯凱基9B購01,1.09,1.10,1.08,1.10,+0.01,0.92,104000,9,113800,0,0,0,0,0,0,60000,44000,16000,16000
20200520,710318,環球晶凱基9A購02,1.30,1.30,1.25,1.25,-0.05,-3.85,27000,3,34010,0,0,0,0,0,0,17000,10000,7000,7000
20200520,710319,穩懋凱基9A購02,0.85,0.85,0.81,0.83,-0.04,-4.6,215000,11,177560,0,0,0,0,0,0,60000,155000,-95000,-95000
20200520,710320,鈊象國票9A購02,3.07,3.17,3.05,3.05,-0.08,-2.56,5000,5,15510,0,0,0,0,0,0,5000,5000,0,0
20200520,710321,弘塑康和9A購01,,,,,,0.00,0,0,0,0,0,0,0,0,0,0,0,0,0
20200520,710322,昇達科康和9A購01,2.26,2.26,2.25,2.25,-0.01,-0.44,90000,2,203300,0,0,0,0,0,0,80000,90000,-10000,-10000
20200520,710323,緯軟康和9A購01,1.76,1.77,1.76,1.77,+0.18,11.32,10000,2,17650,0,0,0,0,0,0,0,10000,-10000,-10000
20200520,710324,環球晶台新9A購01,,,,,,0.00,0,0,0,0,0,0,0,0,0,0,0,0,0
20200520,710325,三貝德國泰9C購01,,,,,,0.00,0,0,0,0,0,0,0,0,0,0,0,0,0
20200520,710326,美琪瑪國泰9B購01,,,,,,0.00,0,0,0,0,0,0,0,0,0,0,0,0,0
20200520,710327,譜瑞國泰9C購01,3.14,3.14,3.11,3.11,-0.11,-3.42,16000,3,49940,0,0,0,0,0,0,6000,16000,-10000,-10000
20200520,710328,精測台新9A購01,0.48,0.48,0.46,0.46,-0.05,-9.8,69000,2,32920,0,0,0,0,0,0,69000,0,69000,69000
20200520,710329,M31元大9A購02,3.83,4.03,3.58,3.58,-0.10,-2.72,653000,51,2512120,0,0,0,0,0,0,503000,265000,238000,238000
20200520,710330,元太元大9A購01,6.50,7.20,6.50,7.00,+0.85,13.82,41000,7,289400,0,0,0,0,0,0,34000,41000,-7000,-7000
20200520,710331,世界元大9A購01,3.39,3.49,3.39,3.44,+0.05,1.47,186000,10,642200,0,0,0,0,0,0,144000,42000,102000,102000
20200520,710332,良維元大9A購01,3.73,3.80,3.72,3.77,+0.05,1.34,206000,17,773610,0,0,0,0,0,0,185000,31000,154000,154000
20200520,710333,信驊元大9A購01,4.91,4.91,4.72,4.80,+0.24,5.26,86000,7,415880,0,0,0,0,0,0,86000,46000,40000,40000
20200520,710334,威剛元大9A購04,3.32,3.32,3.22,3.26,-0.03,-0.91,304000,19,992540,0,0,0,0,0,0,294000,23000,271000,271000
20200520,710335,精測元大9A購01,1.18,1.18,1.18,1.18,-0.04,-3.28,16000,2,18880,0,0,0,0,0,0,16000,16000,0,0
20200520,710336,頎邦元大9A購01,2.57,2.57,2.52,2.53,-0.07,-2.69,327000,11,833230,0,0,0,0,0,0,109000,218000,-109000,-109000
20200520,710337,杰力群益9C購01,3.07,3.07,3.02,3.02,+0.05,1.68,54000,4,163680,0,0,0,0,0,0,42000,12000,30000,30000
20200520,710338,保瑞群益9B購01,,,,,,0.00,0,0,0,0,0,0,0,0,0,0,0,0,0
20200520,710339,網龍群益9C購01,,,,,,0.00,0,0,0,0,0,0,0,0,0,0,0,0,0
20200520,710340,兆利凱基9C購01,,,,,,0.00,0,0,0,0,0,0,0,0,0,0,0,0,0
20200520,710341,威剛凱基9A購04,1.49,1.49,1.44,1.46,-0.03,-2.01,280000,14,409350,0,0,0,0,0,0,278000,32000,246000,246000
20200520,710342,泰博凱基9A購02,3.10,3.26,3.10,3.26,-0.04,-1.21,24000,7,76080,0,0,0,0,0,0,24000,0,24000,24000
20200520,710343,網龍凱基9C購01,4.10,4.10,4.10,4.10,+0.08,1.99,2000,1,8200,0,0,0,0,0,0,0,2000,-2000,-2000
20200520,710344,聚積凱基9C購01,1.35,1.36,1.35,1.35,-0.01,-0.74,16000,3,21610,0,0,0,0,0,0,1000,15000,-14000,-14000
20200520,710345,穩懋麥證9A購01,,,,,,0.00,0,0,0,0,0,0,0,0,0,0,0,0,0
20200520,710346,弘塑元富9A購01,2.68,2.68,2.61,2.65,-0.04,-1.49,194000,11,513760,0,0,0,0,0,0,51000,143000,-92000,-92000
20200520,710347,弘塑元富9A購02,2.04,2.05,1.98,2.05,0.00,0.0,800000,19,1606750,0,0,0,0,0,0,390000,410000,-20000,-20000
20200520,710348,神盾元富9B購02,2.52,2.57,2.31,2.31,-0.14,-5.71,655000,47,1584550,0,0,0,0,0,0,549000,15000,534000,534000
20200520,710349,精華元富9A購01,3.96,3.96,3.81,3.81,-0.14,-3.54,30000,3,117200,0,0,0,0,0,0,20000,10000,10000,10000
20200520,710350,宏捷科國票9A購02,,,,,,0.00,0,0,0,0,0,0,0,0,0,0,0,0,0
20200520,710351,原相國票9B購01,2.75,2.75,2.75,2.75,-0.03,-1.08,5000,1,13750,0,0,0,0,0,0,5000,0,5000,5000
20200520,710352,神盾國票9B購01,1.91,1.91,1.91,1.91,-0.09,-4.5,60000,1,114600,0,0,0,0,0,0,60000,0,60000,60000
20200520,710353,神盾國票9C購01,2.26,2.26,2.26,2.26,-0.04,-1.74,45000,1,101700,0,0,0,0,0,0,45000,0,45000,45000
20200520,710354,博智康和9A購01,0.77,0.77,0.70,0.72,-0.03,-4.0,367000,12,272230,0,0,0,0,0,0,342000,25000,317000,317000
20200520,710355,新普康和9A購01,2.38,2.38,2.28,2.29,-0.04,-1.72,431000,10,989280,0,0,0,0,0,0,321000,110000,211000,211000
20200520,710356,精測康和9A購01,0.61,0.63,0.60,0.63,-0.04,-5.97,105000,11,64880,0,0,0,0,0,0,105000,0,105000,105000
20200520,710357,應華康和9A購01,2.50,2.91,2.50,2.91,+0.37,14.57,41000,4,108190,0,0,0,0,0,0,20000,21000,-1000,-1000
20200520,710358,世禾永豐9A購01,,,,,,0.00,0,0,0,0,0,0,0,0,0,0,0,0,0
20200520,710359,光隆永豐9A購01,,,,,,0.00,0,0,0,0,0,0,0,0,0,0,0,0,0
20200520,710360,宇峻永豐9A購01,0.93,0.93,0.93,0.93,+0.01,1.09,127000,3,118110,0,0,0,0,0,0,0,127000,-127000,-127000
20200520,710361,佳邦永豐9A購01,2.05,2.05,2.05,2.05,+0.09,4.59,5000,1,10250,0,0,0,0,0,0,0,5000,-5000,-5000
20200520,710362,振曜永豐9A購01,,,,,,0.00,0,0,0,0,0,0,0,0,0,0,0,0,0
20200520,710363,盛弘永豐9A購01,1.61,2.08,1.52,2.05,+0.48,30.57,988000,164,1808180,0,0,0,0,0,0,346000,0,346000,346000
20200520,710364,新潤永豐9A購01,1.16,1.16,1.16,1.16,-0.02,-1.69,10000,1,11600,0,0,0,0,0,0,10000,0,10000,10000
20200520,710365,是方國泰9B購01,1.56,1.65,1.51,1.64,+0.17,11.56,742000,26,1174090,0,0,0,0,0,0,237000,449000,-212000,-212000
20200520,710366,原相國泰9B購01,1.37,1.37,1.34,1.34,-0.06,-4.29,137000,9,186890,0,0,0,0,0,0,135000,2000,133000,133000
20200520,710367,建榮永豐9A購03,,,,,,0.00,0,0,0,0,0,0,0,0,0,0,0,0,0
20200520,710368,是方永豐9A購01,0.97,1.09,0.97,1.06,+0.09,9.28,693000,27,713130,0,0,0,0,0,0,104000,589000,-485000,-485000
20200520,710369,森鉅永豐9A購01,0.95,0.95,0.93,0.93,-0.04,-4.12,139000,5,130270,0,0,0,0,0,0,89000,0,89000,89000
20200520,710370,磐亞永豐9A購01,,,,,,0.00,0,0,0,0,0,0,0,0,0,0,0,0,0
20200520,710371,寶雅永豐9A購01,1.92,2.04,1.92,2.04,+0.07,3.55,163000,9,323930,0,20000,-20000,0,0,0,68000,95000,-27000,-47000
20200520,710372,原相群益9A購02,2.46,2.46,2.46,2.46,-0.14,-5.38,100000,4,246000,0,0,0,0,0,0,100000,0,100000,100000
20200520,710373,精華元富9A購02,2.36,2.36,2.36,2.36,-0.05,-2.07,10000,1,23600,0,0,0,0,0,0,0,10000,-10000,-10000
20200520,710374,譜瑞元富9A購01,2.56,2.56,2.35,2.35,-0.18,-7.11,36000,8,91210,0,0,0,0,0,0,36000,0,36000,36000
20200520,710375,原相元大9B購02,2.70,2.70,2.61,2.61,-0.16,-5.78,139000,13,368980,0,0,0,0,0,0,134000,9000,125000,125000
20200520,710376,泰博元大9C購01,3.02,3.02,3.02,3.02,0.00,0.0,3000,1,9060,0,0,0,0,0,0,0,0,0,0
20200520,710377,新鉅科元大9B購01,2.62,2.74,2.62,2.74,+0.11,4.18,377000,6,995880,0,0,0,0,0,0,288000,89000,199000,199000
20200520,710378,群聯元大9A購03,2.49,2.49,2.40,2.40,-0.09,-3.61,87000,9,212570,0,0,0,0,0,0,87000,39000,48000,48000
20200520,710379,精測元大9A購02,1.02,1.04,1.01,1.01,-0.06,-5.61,103000,7,105360,0,0,0,0,0,0,15000,103000,-88000,-88000
20200520,710380,鈊象元大9A購02,1.50,1.52,1.46,1.46,-0.12,-7.59,53000,4,78760,0,0,0,0,0,0,33000,20000,13000,13000
20200520,710381,鈊象元大9B購01,1.52,1.53,1.50,1.53,+0.01,0.66,40000,4,60790,0,0,0,0,0,0,39000,2000,37000,37000
20200520,710382,凡甲凱基9A購01,2.15,2.20,2.10,2.10,-0.16,-7.08,268000,9,576060,0,0,0,0,0,0,258000,10000,248000,248000
20200520,710383,凡甲凱基9A購02,1.45,1.45,1.45,1.45,-0.18,-11.04,20000,1,29000,0,0,0,0,0,0,20000,0,20000,20000
20200520,710384,威剛凱基9B購02,1.86,1.86,1.86,1.86,-0.01,-0.53,15000,2,27900,0,0,0,0,0,0,15000,0,15000,15000
20200520,710385,博智凱基9A購02,0.92,0.93,0.90,0.93,-0.02,-2.11,26000,8,23610,0,0,0,0,0,0,6000,20000,-14000,-14000
20200520,710386,大江國票9A購03,,,,,,0.00,0,0,0,0,0,0,0,0,0,0,0,0,0
20200520,710387,穩懋國票9A購02,1.64,1.64,1.59,1.59,-0.14,-8.09,75000,5,121780,20000,0,20000,0,0,0,51000,24000,27000,47000
20200520,710388,鈊象國票9B購02,2.37,2.41,2.37,2.39,-0.03,-1.24,62000,5,147480,0,0,0,0,0,0,24000,41000,-17000,-17000
20200520,710389,原相台新9A購02,1.29,1.29,1.27,1.27,-0.03,-2.31,34000,2,43820,0,0,0,0,0,0,32000,2000,30000,30000
20200520,710390,M31群益9A購02,2.10,2.29,1.98,1.99,-0.10,-4.78,857000,78,1892220,0,0,0,0,0,0,617000,290000,327000,327000
20200520,710391,原相元大9B購03,1.92,1.92,1.86,1.87,-0.09,-4.59,122000,10,229550,0,0,0,0,0,0,122000,41000,81000,81000
20200520,710392,精測元大9A購03,,,,,,0.00,0,0,0,0,0,0,0,0,0,0,0,0,0
20200520,710393,雙鴻元大9C購01,3.68,3.68,3.61,3.63,-0.01,-0.27,58000,6,210650,0,0,0,0,0,0,58000,55000,3000,3000
20200520,710394,鈊象元大9C購01,1.32,1.33,1.32,1.33,+0.01,0.76,58000,2,76610,0,0,0,0,0,0,0,58000,-58000,-58000
20200520,710395,神盾富邦01購01,1.00,1.00,0.90,0.90,-0.05,-5.26,429000,66,411160,0,0,0,0,0,0,384000,84000,300000,300000
20200520,710396,雙鴻富邦9B購01,0.88,0.88,0.87,0.88,0.00,0.0,457000,12,400290,0,0,0,0,0,0,242000,378000,-136000,-136000
20200520,710397,群聯中信9C購01,0.78,0.78,0.77,0.77,0.00,0.0,120000,5,92600,0,0,0,0,0,0,120000,0,120000,120000
20200520,710398,精測中信9A購02,0.47,0.47,0.46,0.46,-0.02,-4.17,69000,4,31840,0,0,0,0,0,0,69000,0,69000,69000
20200520,710399,環球晶中信9A購02,0.58,0.58,0.58,0.58,-0.02,-3.33,10000,1,5800,0,0,0,0,0,0,0,10000,-10000,-10000
20200520,710400,中美晶永豐9A購01,,,,,,0.00,0,0,0,0,0,0,0,0,0,0,0,0,0
20200520,710401,建榮永豐9A購04,,,,,,0.00,0,0,0,0,0,0,0,0,0,0,0,0,0
20200520,710402,神盾永豐9A購02,1.68,1.68,1.68,1.68,+0.14,9.09,10000,1,16800,0,0,0,0,0,0,10000,0,10000,10000
20200520,710403,閎康永豐9A購01,1.54,1.67,1.54,1.63,+0.06,3.82,340000,22,542330,0,0,0,0,0,0,170000,165000,5000,5000
20200520,710404,雙鴻永豐9A購02,1.38,1.38,1.38,1.38,0.00,0.0,1000,1,1380,0,0,0,0,0,0,1000,1000,0,0
20200520,710405,大學光凱基9A購03,,,,,,0.00,0,0,0,0,0,0,0,0,0,0,0,0,0
20200520,710406,中美晶凱基9A購04,1.82,1.82,1.79,1.79,-0.05,-2.72,32000,2,58090,0,0,0,0,0,0,27000,5000,22000,22000
20200520,710407,泰博凱基9B購01,3.26,3.35,3.17,3.19,+0.23,7.77,18000,6,58710,0,0,0,0,0,0,1000,2000,-1000,-1000
20200520,710408,博智凱基9B購01,1.15,1.15,1.15,1.15,-0.14,-10.85,6000,1,6900,0,0,0,0,0,0,0,6000,-6000,-6000
20200520,710409,環球晶凱基9B購02,1.78,1.78,1.72,1.73,-0.05,-2.81,10000,8,17530,0,0,0,0,0,0,1000,10000,-9000,-9000
20200520,710410,雙鴻凱基9A購02,2.45,2.45,2.41,2.45,-0.01,-0.41,49000,5,118950,0,0,0,0,0,0,14000,39000,-25000,-25000
20200520,710411,穩懋凱基9B購01,0.84,0.84,0.82,0.82,-0.05,-5.75,6000,2,5000,0,0,0,0,0,0,0,6000,-6000,-6000
20200520,710412,宇峻國票9B購01,1.06,1.11,1.06,1.11,+0.04,3.74,41000,4,44310,0,0,0,0,0,0,24000,17000,7000,7000
20200520,710413,威剛中信9B購01,0.73,0.73,0.73,0.73,-0.02,-2.67,1000,1,730,0,0,0,0,0,0,1000,0,1000,1000
20200520,710414,雙鴻中信9A購01,1.37,1.37,1.35,1.35,-0.01,-0.74,2000,2,2720,0,0,0,0,0,0,2000,2000,0,0
20200520,710415,原相元大9A購05,1.08,1.09,1.05,1.06,-0.05,-4.5,223000,14,237160,0,0,0,0,0,0,185000,42000,143000,143000
20200520,710416,神盾元大9B購02,2.07,2.10,1.90,1.90,-0.13,-6.4,1017000,54,2028030,0,0,0,0,0,0,911000,474000,437000,437000
20200520,710417,博智元大9B購01,0.93,1.04,0.93,1.00,-0.03,-2.91,106000,12,106430,0,0,0,0,0,0,76000,29000,47000,47000
20200520,710418,群聯元大9A購05,1.70,1.70,1.64,1.64,-0.02,-1.2,80000,9,134720,0,0,0,0,0,0,80000,0,80000,80000
20200520,710419,雙鴻元大9B購01,1.71,1.71,1.71,1.71,-0.02,-1.16,69000,2,117990,0,0,0,0,0,0,1000,69000,-68000,-68000
20200520,710420,鈊象元大9B購02,0.93,0.93,0.93,0.93,0.00,0.0,5000,1,4650,0,0,0,0,0,0,0,5000,-5000,-5000
20200520,710421,宏捷科永豐9A購01,,,,,,0.00,0,0,0,0,0,0,0,0,0,0,0,0,0
20200520,710422,昇達科永豐9A購01,0.92,0.95,0.92,0.95,-0.02,-2.06,104000,6,97440,0,0,0,0,0,0,104000,54000,50000,50000
20200520,710423,晶焱永豐9A購02,1.33,1.40,1.33,1.40,+0.04,2.94,221000,8,300230,0,0,0,0,0,0,181000,40000,141000,141000
20200520,710424,業強永豐9A購01,,,,,,0.00,0,0,0,0,0,0,0,0,0,0,0,0,0
20200520,710425,頎邦永豐9A購01,1.19,1.19,1.18,1.18,-0.03,-2.48,193000,5,228350,0,0,0,0,0,0,193000,0,193000,193000
20200520,710426,宏捷科凱基9A購02,0.81,0.81,0.81,0.81,-0.03,-3.57,68000,1,55080,0,0,0,0,0,0,0,68000,-68000,-68000
20200520,710427,神盾凱基9B購02,1.95,1.97,1.83,1.87,-0.03,-1.58,304000,28,576350,0,0,0,0,0,0,249000,19000,230000,230000
20200520,710428,群聯凱基9B購02,1.57,1.57,1.57,1.57,+0.01,0.64,20000,1,31400,0,0,0,0,0,0,20000,0,20000,20000
20200520,710429,群聯麥證9B購01,2.08,2.08,2.08,2.08,+0.09,4.52,8000,1,16640,8000,0,8000,0,0,0,8000,0,8000,8000
20200520,710430,宏捷科國泰9B購03,1.65,1.65,1.60,1.61,-0.04,-2.42,92000,5,150730,0,0,0,0,0,0,91000,34000,57000,57000
20200520,710431,宇峻群益9B購01,,,,,,0.00,0,0,0,0,0,0,0,0,0,0,0,0,0
20200520,710432,泰博群益9B購01,2.02,2.20,2.02,2.20,+0.25,12.82,92000,18,194590,0,0,0,0,0,0,43000,20000,23000,23000
20200520,710433,原相富邦9C購02,0.72,0.72,0.70,0.70,-0.04,-5.41,60000,2,42200,0,0,0,0,0,0,60000,0,60000,60000
20200520,710434,群聯富邦9B購01,0.73,0.73,0.71,0.71,-0.03,-4.05,381000,8,272290,0,0,0,0,0,0,381000,0,381000,381000
20200520,710435,旺矽元富9A購01,2.76,2.97,2.76,2.97,+0.28,10.41,78000,12,222450,0,0,0,0,0,0,0,78000,-78000,-78000
20200520,710436,威剛元富9A購01,2.84,2.84,2.84,2.84,+0.01,0.35,10000,1,28400,0,0,0,0,0,0,10000,0,10000,10000
20200520,710437,威剛元富9A購02,2.24,2.24,2.24,2.24,+0.01,0.45,10000,1,22400,0,0,0,0,0,0,10000,0,10000,10000
20200520,710438,泰博元富9A購01,,,,,,0.00,0,0,0,0,0,0,0,0,0,0,0,0,0
20200520,710439,泰博元富9A購02,,,,,,0.00,0,0,0,0,0,0,0,0,0,0,0,0,0
20200520,710440,雙鴻元富9A購01,5.00,5.00,5.00,5.00,-0.10,-1.96,33000,5,165000,0,0,0,0,0,0,1000,32000,-31000,-31000
20200520,710441,鈊象元富9A購01,1.83,1.83,1.83,1.83,-0.12,-6.15,1000,1,1830,0,0,0,0,0,0,0,1000,-1000,-1000
20200520,710442,鈊象元富9A購02,2.12,2.12,2.11,2.12,-0.10,-4.5,77000,3,163140,0,0,0,0,0,0,67000,10000,57000,57000
20200520,710443,威剛國泰9C購01,1.78,1.78,1.72,1.72,-0.04,-2.27,540000,21,952600,0,0,0,0,0,0,450000,90000,360000,360000
20200520,710444,雙鴻國泰9C購01,2.00,2.00,1.96,1.97,-0.01,-0.51,136000,11,268020,0,0,0,0,0,0,98000,50000,48000,48000
20200520,710445,博智群益9A購01,0.70,0.70,0.70,0.70,-0.11,-13.58,10000,2,7000,0,0,0,0,0,0,0,10000,-10000,-10000
20200520,710446,神盾凱基9A購02,1.57,1.59,1.47,1.47,-0.05,-3.29,525000,62,816440,0,0,0,0,0,0,458000,114000,344000,344000
20200520,710447,群聯凱基9A購04,1.33,1.33,1.33,1.33,+0.01,0.76,20000,1,26600,0,0,0,0,0,0,20000,0,20000,20000
20200520,710448,優群凱基9A購04,1.36,1.41,1.36,1.37,+0.05,3.79,130000,4,177500,0,0,0,0,0,0,100000,30000,70000,70000
20200520,710449,環球晶凱基9C購01,1.52,1.54,1.50,1.50,-0.06,-3.85,437000,7,666040,0,0,0,0,0,0,400000,37000,363000,363000
20200520,710450,雙鴻凱基9B購01,1.75,1.75,1.75,1.75,-0.01,-0.57,3000,2,5250,0,0,0,0,0,0,1000,3000,-2000,-2000
20200520,710451,穩懋凱基9C購01,0.79,0.79,0.79,0.79,-0.03,-3.66,70000,1,55300,0,0,0,0,0,0,0,70000,-70000,-70000
20200520,710452,鈊象凱基9A購03,,,,,,0.00,0,0,0,0,0,0,0,0,0,0,0,0,0
20200520,710453,鈊象第一9A購01,,,,,,0.00,0,0,0,0,0,0,0,0,0,0,0,0,0
20200520,710454,精測中信9B購01,0.46,0.46,0.45,0.45,-0.03,-6.25,29000,2,13250,0,0,0,0,0,0,20000,9000,11000,11000
20200520,710455,鈊象中信9A購01,,,,,,0.00,0,0,0,0,0,0,0,0,0,0,0,0,0
20200520,710456,台半永豐9A購01,1.11,1.11,1.11,1.11,+0.03,2.78,120000,4,133200,0,0,0,0,0,0,0,120000,-120000,-120000
20200520,710457,台燿永豐9A購01,0.99,0.99,0.89,0.90,-0.04,-4.26,285000,39,273010,0,0,0,0,0,0,198000,63000,135000,135000
20200520,710458,合晶永豐9A購01,1.21,1.23,1.19,1.23,+0.07,6.03,123000,6,150910,0,0,0,0,0,0,7000,123000,-116000,-116000
20200520,710459,宜特永豐9A購01,1.69,1.85,1.69,1.85,+0.12,6.94,379000,16,659770,0,0,0,0,0,0,201000,178000,23000,23000
20200520,710460,旺矽永豐9A購01,1.95,2.13,1.90,2.11,+0.15,7.65,239000,26,474140,0,0,0,0,0,0,112000,127000,-15000,-15000
20200520,710461,信昌電永豐9A購01,1.04,1.08,1.04,1.05,+0.04,3.96,202000,6,213060,0,0,0,0,0,0,124000,78000,46000,46000
20200520,710462,威剛永豐9A購01,0.95,0.95,0.93,0.93,-0.04,-4.12,185000,2,173090,0,0,0,0,0,0,185000,0,185000,185000
20200520,710463,聚積永豐9A購01,1.04,1.06,1.04,1.06,0.00,0.0,121000,4,127530,0,0,0,0,0,0,10000,111000,-101000,-101000
20200520,710464,緯軟永豐9A購01,0.89,0.89,0.88,0.88,+0.07,8.64,20000,2,17700,0,0,0,0,0,0,0,20000,-20000,-20000
20200520,710465,優群永豐9A購02,1.09,1.14,1.09,1.14,+0.10,9.62,72000,2,78680,0,0,0,0,0,0,0,72000,-72000,-72000
20200520,710466,環宇永豐9A購01,0.94,0.94,0.92,0.92,+0.06,6.98,400000,2,372000,0,0,0,0,0,0,0,400000,-400000,-400000
20200520,710467,穩懋永豐9A購02,,,,,,0.00,0,0,0,0,0,0,0,0,0,0,0,0,0
20200520,710468,鈊象永豐9A購03,,,,,,0.00,0,0,0,0,0,0,0,0,0,0,0,0,0
20200520,710469,宏捷科元大9C購01,1.18,1.18,1.18,1.18,-0.03,-2.48,2000,1,2360,0,0,0,0,0,0,0,2000,-2000,-2000
20200520,710470,信驊元大9A購02,2.49,2.57,2.26,2.26,-0.13,-5.44,100000,10,235760,0,0,0,0,0,0,78000,35000,43000,43000
20200520,710471,原相元大9B購04,1.24,1.24,1.21,1.21,-0.06,-4.72,69000,6,84810,0,0,0,0,0,0,23000,49000,-26000,-26000
20200520,710472,群聯元大9A購06,1.54,1.54,1.54,1.54,-0.01,-0.65,60000,2,92400,0,0,0,0,0,0,50000,10000,40000,40000
20200520,710473,精測元大9A購04,1.25,1.25,1.23,1.23,-0.06,-4.65,23000,3,28410,0,0,0,0,0,0,17000,23000,-6000,-6000
20200520,710474,環球晶富邦9C購01,0.75,0.75,0.74,0.74,-0.02,-2.63,11000,2,8150,0,0,0,0,0,0,1000,11000,-10000,-10000
20200520,710475,聯亞富邦9B購02,0.79,0.79,0.77,0.78,0.00,0.0,133000,9,103560,0,0,0,0,0,0,31000,96000,-65000,-65000
20200520,710476,鈊象富邦9B購01,0.48,0.48,0.48,0.48,-0.03,-5.88,30000,2,14400,0,0,0,0,0,0,30000,0,30000,30000
20200520,710477,弘塑元大9A購01,2.32,2.37,2.32,2.37,0.00,0.0,244000,9,570600,0,0,0,0,0,0,130000,244000,-114000,-114000
20200520,710478,神盾元大9A購05,1.86,1.92,1.72,1.72,-0.12,-6.52,905000,76,1654700,0,0,0,0,0,0,821000,142000,679000,679000
20200520,710479,群聯元大9A購07,1.95,1.95,1.95,1.95,+0.01,0.52,50000,1,97500,0,0,0,0,0,0,0,50000,-50000,-50000
20200520,710480,鈊象元大9B購03,,,,,,0.00,0,0,0,0,0,0,0,0,0,0,0,0,0
20200520,710481,精測國泰9B購01,0.80,0.80,0.78,0.78,-0.05,-6.02,50000,4,39500,0,0,0,0,0,0,20000,30000,-10000,-10000
20200520,710482,威剛群益9A購03,1.51,1.51,1.44,1.44,-0.07,-4.64,228000,12,341670,0,0,0,0,0,0,147000,81000,66000,66000
20200520,710483,雙鴻群益9A購01,2.13,2.13,2.11,2.11,-0.02,-0.94,199000,6,421770,0,0,0,0,0,0,97000,105000,-8000,-8000
20200520,710484,鈊象群益9A購01,0.68,0.68,0.68,0.68,-0.03,-4.23,100000,1,68000,0,0,0,0,0,0,100000,0,100000,100000
20200520,710485,譜瑞富邦9C購01,1.54,1.57,1.41,1.45,-0.05,-3.33,386000,49,581540,0,0,0,0,0,0,212000,154000,58000,58000
20200520,710486,大江第一9A購01,,,,,,0.00,0,0,0,0,0,0,0,0,0,0,0,0,0
20200520,710487,環球晶第一9A購01,,,,,,0.00,0,0,0,0,0,0,0,0,0,0,0,0,0
20200520,710488,穩懋第一9A購01,0.53,0.53,0.53,0.53,-0.03,-5.36,6000,2,3180,0,0,0,0,0,0,0,6000,-6000,-6000
20200520,710489,力旺永豐9A購01,2.26,2.42,2.15,2.16,0.00,0.0,228000,18,532560,0,0,0,0,0,0,77000,151000,-74000,-74000
20200520,710490,世界永豐9A購01,1.47,1.47,1.45,1.45,0.00,0.0,187000,6,273270,0,0,0,0,0,0,84000,103000,-19000,-19000
20200520,710491,宇峻永豐9A購02,0.82,0.84,0.81,0.83,+0.02,2.47,200000,9,164400,0,0,0,0,0,0,40000,160000,-120000,-120000
20200520,710492,建榮永豐9B購02,1.61,1.61,1.61,1.61,+0.02,1.26,18000,1,28980,0,0,0,0,0,0,0,18000,-18000,-18000
20200520,710493,原相永豐9A購02,,,,,,0.00,0,0,0,0,0,0,0,0,0,0,0,0,0
20200520,710494,博智國票9A購01,1.35,1.37,1.29,1.37,-0.09,-6.16,90000,8,119810,0,0,0,0,0,0,60000,20000,40000,40000
20200520,710495,威剛統一9C購01,0.72,0.72,0.71,0.71,-0.02,-2.74,25000,2,17800,0,0,0,0,0,0,25000,0,25000,25000
20200520,710496,穩懋統一9C購01,0.83,0.83,0.82,0.82,-0.04,-4.65,30000,3,24700,0,0,0,0,0,0,0,30000,-30000,-30000
20200520,710497,網家麥證9A購01,3.05,3.38,3.05,3.38,+0.58,20.71,78000,8,246270,36000,42000,-6000,0,0,0,36000,42000,-6000,-6000
20200520,710498,建榮凱基9C購01,2.44,2.46,2.44,2.46,+0.10,4.24,100000,3,244360,0,0,0,0,0,0,100000,0,100000,100000
20200520,710499,網家國泰9B購01,2.43,2.74,2.42,2.74,+0.41,17.6,538000,37,1359750,0,0,0,0,0,0,385000,193000,192000,192000
20200520,710500,弘塑群益9A購01,1.78,1.80,1.75,1.80,0.00,0.0,361000,8,638270,0,0,0,0,0,0,121000,240000,-119000,-119000
20200520,710501,威剛元大9A購05,1.98,1.98,1.91,1.91,-0.04,-2.05,387000,20,751660,0,0,0,0,0,0,315000,75000,240000,240000
20200520,710502,泰博元大9B購01,,,,,,0.00,0,0,0,0,0,0,0,0,0,0,0,0,0
20200520,710503,雙鴻元大9C購02,1.45,1.45,1.42,1.43,0.00,0.0,204000,10,291730,0,0,0,0,0,0,55000,149000,-94000,-94000
20200520,710504,世界富邦9C購01,0.87,0.89,0.87,0.88,0.00,0.0,577000,16,512220,0,0,0,0,0,0,352000,225000,127000,127000
20200520,710505,泰博富邦9B購01,,,,,,0.00,0,0,0,0,0,0,0,0,0,0,0,0,0
20200520,710506,頎邦富邦9C購01,0.92,0.92,0.90,0.90,-0.03,-3.23,296000,20,272100,0,0,0,0,0,0,274000,22000,252000,252000
20200520,710507,宏捷科凱基9C購01,1.12,1.13,1.11,1.13,-0.03,-2.59,21000,4,23480,0,0,0,0,0,0,5000,16000,-11000,-11000
20200520,710508,南光凱基9A購01,1.42,1.42,1.41,1.41,-0.03,-2.08,60000,2,85100,0,0,0,0,0,0,60000,0,60000,60000
20200520,710509,建榮凱基9B購01,2.46,2.46,2.46,2.46,+0.08,3.36,21000,1,51660,0,0,0,0,0,0,21000,0,21000,21000
20200520,710510,群聯凱基9B購03,1.26,1.27,1.25,1.26,-0.01,-0.79,89000,5,112050,0,0,0,0,0,0,88000,1000,87000,87000
20200520,710511,網家凱基9A購01,3.11,3.24,3.08,3.24,+0.29,9.83,116000,37,367990,0,0,0,0,0,0,86000,30000,56000,56000
20200520,710512,中美晶統一9A購01,0.84,0.84,0.83,0.83,-0.03,-3.49,60000,2,50300,0,0,0,0,0,0,60000,0,60000,60000
20200520,710513,雙鴻統一9C購01,0.89,0.89,0.87,0.88,-0.01,-1.12,82000,3,72930,0,0,0,0,0,0,79000,3000,76000,76000
20200520,710514,穩懋統一9A購02,,,,,,0.00,0,0,0,0,0,0,0,0,0,0,0,0,0
20200520,710515,大學光永豐9A購02,,,,,,0.00,0,0,0,0,0,0,0,0,0,0,0,0,0
20200520,710516,宇峻永豐9B購01,,,,,,0.00,0,0,0,0,0,0,0,0,0,0,0,0,0
20200520,710517,保瑞永豐9A購01,1.12,1.12,1.12,1.12,+0.04,3.7,90000,2,100800,0,0,0,0,0,0,90000,0,90000,90000
20200520,710518,建榮永豐9A購05,1.55,1.57,1.55,1.57,+0.06,3.97,44000,2,68740,0,0,0,0,0,0,0,44000,-44000,-44000
20200520,710519,胡連永豐9A購01,1.62,1.74,1.61,1.66,+0.17,11.41,146000,17,245130,0,0,0,0,0,0,23000,112000,-89000,-89000
20200520,710520,泰博永豐9A購02,,,,,,0.00,0,0,0,0,0,0,0,0,0,0,0,0,0
20200520,710521,神盾永豐9A購03,1.44,1.45,1.31,1.32,-0.01,-0.75,210000,9,282610,0,0,0,0,0,0,200000,10000,190000,190000
20200520,710522,博智永豐9A購03,,,,,,0.00,0,0,0,0,0,0,0,0,0,0,0,0,0
20200520,710523,網龍永豐9A購02,2.10,2.17,2.08,2.08,-0.01,-0.48,63000,8,133340,0,0,0,0,0,0,3000,63000,-60000,-60000
20200520,710524,大江國票9A購04,7.85,7.85,7.70,7.70,+0.05,0.65,13000,2,100400,0,0,0,0,0,0,13000,11000,2000,2000
20200520,710525,弘塑國票9A購01,4.12,4.27,4.09,4.24,-0.07,-1.62,82000,7,345880,0,0,0,0,0,0,52000,30000,22000,22000
20200520,710526,網家國票9A購01,7.75,9.00,7.75,8.55,+1.30,17.93,153000,28,1266300,0,0,0,0,0,0,54000,99000,-45000,-45000
20200520,710527,大江國泰9C購01,2.33,2.33,2.25,2.25,-0.05,-2.17,11000,2,25230,0,0,0,0,0,0,6000,0,6000,6000
20200520,710528,雍智群益9A購01,3.16,3.38,3.00,3.21,+0.35,12.24,312000,15,1000490,0,0,0,0,0,0,147000,150000,-3000,-3000
20200520,710529,威剛元大9A購06,2.02,2.02,1.91,1.91,-0.07,-3.54,471000,22,932640,0,0,0,0,0,0,403000,68000,335000,335000
20200520,710530,泰博元大9A購01,,,,,,0.00,0,0,0,0,0,0,0,0,0,0,0,0,0
20200520,710531,神盾元大9A購06,4.08,4.16,3.76,3.76,-0.20,-5.05,213000,21,856100,0,0,0,0,0,0,209000,89000,120000,120000
20200520,710532,群聯元大9A購08,1.79,1.79,1.74,1.74,-0.03,-1.69,101000,7,178490,0,0,0,0,0,0,45000,90000,-45000,-45000
20200520,710533,鈊象元大9B購04,2.18,2.18,2.12,2.12,-0.05,-2.3,64000,3,138770,0,0,0,0,0,0,14000,50000,-36000,-36000
20200520,710534,鈺太元大9B購01,1.86,1.86,1.83,1.83,+0.05,2.81,194000,6,358470,0,0,0,0,0,0,155000,72000,83000,83000
20200520,710535,網家第一9A購01,1.19,1.29,1.19,1.29,+0.14,12.17,436000,26,544510,0,0,0,0,0,0,181000,195000,-14000,-14000
20200520,710536,凡甲永豐9A購02,1.71,1.71,1.71,1.71,-0.26,-13.2,36000,2,61560,0,0,0,0,0,0,36000,0,36000,36000
20200520,710537,金居永豐9A購01,,,,,,0.00,0,0,0,0,0,0,0,0,0,0,0,0,0
20200520,710538,原相永豐9A購04,,,,,,0.00,0,0,0,0,0,0,0,0,0,0,0,0,0
20200520,710539,華研永豐9A購01,,,,,,0.00,0,0,0,0,0,0,0,0,0,0,0,0,0
20200520,710540,群聯永豐9A購02,,,,,,0.00,0,0,0,0,0,0,0,0,0,0,0,0,0
20200520,710541,雍智永豐9A購01,1.70,1.88,1.66,1.74,+0.16,10.13,290000,30,506340,0,0,0,0,0,0,154000,131000,23000,23000
20200520,710542,網家永豐9A購01,1.39,1.60,1.39,1.60,+0.24,17.65,321000,30,467740,0,0,0,0,0,0,132000,189000,-57000,-57000
20200520,710543,網龍永豐9A購03,1.93,1.93,1.86,1.86,-0.13,-6.53,97000,5,180750,0,0,0,0,0,0,87000,10000,77000,77000
20200520,710544,鈺太永豐9A購01,0.95,0.96,0.94,0.94,+0.01,1.08,101000,8,95920,0,0,0,0,0,0,0,101000,-101000,-101000
20200520,710545,力旺凱基9A購01,2.68,2.78,2.52,2.58,+0.06,2.38,119000,29,320290,0,0,0,0,0,0,64000,28000,36000,36000
20200520,710546,宏捷科凱基9A購03,0.96,0.96,0.95,0.95,-0.04,-4.04,46000,3,44100,0,0,0,0,0,0,30000,16000,14000,14000
20200520,710547,原相凱基9A購03,,,,,,0.00,0,0,0,0,0,0,0,0,0,0,0,0,0
20200520,710548,泰博凱基9A購03,2.99,3.07,2.99,3.07,-0.11,-3.46,20000,2,60600,0,0,0,0,0,0,10000,10000,0,0
20200520,710549,精華凱基9A購01,0.98,0.98,0.96,0.96,+0.01,1.05,21000,2,20560,0,0,0,0,0,0,21000,20000,1000,1000
20200520,710550,網家凱基9C購01,1.41,1.57,1.41,1.53,+0.16,11.68,205000,35,303210,0,0,0,0,0,0,124000,103000,21000,21000
20200520,710551,鈺太凱基9A購01,1.55,1.56,1.55,1.55,+0.06,4.03,46000,3,71540,0,0,0,0,0,0,46000,10000,36000,36000
20200520,710552,泰博統一9C購01,2.68,2.68,2.68,2.68,+0.08,3.08,6000,1,16080,0,0,0,0,0,0,6000,0,6000,6000
20200520,710553,穩懋統一9B購03,0.58,0.58,0.56,0.57,-0.05,-8.06,84000,5,48500,0,0,0,0,0,0,82000,2000,80000,80000
20200520,710554,中美晶國票9A購04,1.86,1.86,1.80,1.80,-0.07,-3.74,45000,4,83300,0,0,0,0,0,0,40000,5000,35000,35000
20200520,710555,宇峻國票9A購01,1.50,1.50,1.50,1.50,-0.07,-4.46,3000,1,4500,0,0,0,0,0,0,0,3000,-3000,-3000
20200520,710556,良維國票9A購01,3.43,3.51,3.38,3.51,+0.10,2.93,140000,8,482490,0,0,0,0,0,0,136000,119000,17000,17000
20200520,710557,優群國票9A購02,3.06,3.06,3.06,3.06,+0.12,4.08,10000,1,30600,0,0,0,0,0,0,0,10000,-10000,-10000
20200520,710558,雙鴻國票9A購03,3.34,3.34,3.30,3.30,-0.04,-1.2,64000,3,213720,0,0,0,0,0,0,64000,1000,63000,63000
20200520,710559,世界元大9A購03,2.61,2.70,2.56,2.58,-0.05,-1.9,265000,16,700600,0,0,0,0,0,0,125000,180000,-55000,-55000
20200520,710560,宏捷科元大9B購02,0.94,0.94,0.91,0.91,-0.06,-6.19,60000,2,56100,0,0,0,0,0,0,10000,50000,-40000,-40000
20200520,710561,威剛元大9B購02,1.12,1.12,1.08,1.09,-0.01,-0.91,214000,19,235630,0,0,0,0,0,0,212000,102000,110000,110000
20200520,710562,胡連元大9A購01,2.40,2.80,2.39,2.68,+0.31,13.08,981000,76,2584890,0,0,0,0,0,0,110000,856000,-746000,-746000
20200520,710563,原相元大9A購08,1.43,1.43,1.43,1.43,-0.05,-3.38,3000,1,4290,0,0,0,0,0,0,3000,3000,0,0
20200520,710564,群聯元大9A購09,,,,,,0.00,0,0,0,0,0,0,0,0,0,0,0,0,0
20200520,710565,群聯元大9A購10,0.95,0.95,0.94,0.94,-0.02,-2.08,11000,2,10350,0,0,0,0,0,0,0,11000,-11000,-11000
20200520,710566,碩禾元大9B購01,1.12,1.12,1.10,1.10,+0.02,1.85,82000,2,90220,0,0,0,0,0,0,82000,81000,1000,1000
20200520,710567,優群元大9A購01,2.30,2.41,2.24,2.32,+0.01,0.43,475000,22,1092030,0,0,0,0,0,0,169000,306000,-137000,-137000
20200520,710568,鈊象兆豐9A購01,0.86,0.86,0.83,0.85,-0.02,-2.3,23000,3,19380,0,0,0,0,0,0,13000,10000,3000,3000
20200520,710569,中美晶富邦9B購04,0.75,0.75,0.73,0.73,-0.03,-3.95,117000,7,86180,0,0,0,0,0,0,117000,0,117000,117000
20200520,710570,宏捷科群益9A購01,,,,,,0.00,0,0,0,0,0,0,0,0,0,0,0,0,0
20200520,710571,新鉅科群益9A購02,1.24,1.32,1.23,1.32,+0.03,2.33,217000,5,275060,0,0,0,0,0,0,49000,168000,-119000,-119000
20200520,710572,網家群益9A購01,1.49,1.71,1.47,1.62,+0.24,17.39,1185000,62,1849500,0,0,0,0,0,0,671000,494000,177000,177000
20200520,710573,網龍群益9A購01,3.34,3.34,3.12,3.12,-0.45,-12.61,47000,2,147080,0,0,0,0,0,0,45000,2000,43000,43000
20200520,710574,鈊象群益9A購02,1.21,1.24,1.18,1.18,-0.04,-3.28,41000,5,48790,0,0,0,0,0,0,26000,16000,10000,10000
20200520,710575,環球晶中信9B購01,0.58,0.58,0.58,0.58,-0.02,-3.33,2000,1,1160,0,0,0,0,0,0,0,2000,-2000,-2000
20200520,710576,M31永豐9A購01,1.49,1.60,1.41,1.41,-0.01,-0.7,282000,20,430080,0,0,0,0,0,0,203000,77000,126000,126000
20200520,710577,大江永豐9A購01,1.20,1.20,1.15,1.15,-0.02,-1.71,13000,2,15550,0,0,0,0,0,0,12000,1000,11000,11000
20200520,710578,世界永豐9A購02,0.83,0.83,0.82,0.82,-0.05,-5.75,81000,2,66590,0,0,0,0,0,0,81000,0,81000,81000
20200520,710579,伍豐永豐9A購01,,,,,,0.00,0,0,0,0,0,0,0,0,0,0,0,0,0
20200520,710580,兆利永豐9A購01,,,,,,0.00,0,0,0,0,0,0,0,0,0,0,0,0,0
20200520,710581,欣銓永豐9A購01,1.19,1.23,1.18,1.18,-0.04,-3.28,445000,15,533900,0,0,0,0,0,0,353000,92000,261000,261000
20200520,710582,新鉅科永豐9A購01,0.67,0.67,0.67,0.67,-0.03,-4.29,143000,1,95810,0,0,0,0,0,0,143000,0,143000,143000
20200520,710583,精測永豐9A購02,0.32,0.32,0.32,0.32,+0.01,3.23,20000,1,6400,0,0,0,0,0,0,0,20000,-20000,-20000
20200520,710584,網家永豐9A購02,1.21,1.36,1.21,1.36,+0.20,17.24,281000,22,359840,0,0,0,0,0,0,131000,150000,-19000,-19000
20200520,710585,穩懋麥證9A購02,,,,,,0.00,0,0,0,0,0,0,0,0,0,0,0,0,0
20200520,710586,原相統一9C購01,,,,,,0.00,0,0,0,0,0,0,0,0,0,0,0,0,0
20200520,710587,宏捷科凱基9C購02,1.05,1.05,1.04,1.04,-0.04,-3.7,40000,2,41900,0,0,0,0,0,0,10000,30000,-20000,-20000
20200520,710588,信驊凱基9A購03,2.17,2.22,2.14,2.19,+0.14,6.83,61000,8,133690,1000,0,1000,0,0,0,25000,36000,-11000,-10000
20200520,710589,威剛凱基9A購05,1.16,1.17,1.11,1.11,-0.06,-5.13,356000,13,410600,0,0,0,0,0,0,222000,130000,92000,92000
20200520,710590,鈺太凱基9B購01,1.21,1.21,1.21,1.21,+0.08,7.08,10000,1,12100,0,0,0,0,0,0,10000,10000,0,0
20200520,710591,凡甲國票9A購01,3.84,4.00,3.74,3.75,-0.10,-2.6,223000,10,859410,0,0,0,0,0,0,178000,45000,133000,133000
20200520,710592,大江國票9A購05,2.13,2.14,2.00,2.00,-0.09,-4.31,253000,10,537120,0,0,0,0,0,0,221000,34000,187000,187000
20200520,710593,弘塑國票9A購02,,,,,,0.00,0,0,0,0,0,0,0,0,0,0,0,0,0
20200520,710594,泰博國票9A購03,,,,,,0.00,0,0,0,0,0,0,0,0,0,0,0,0,0
20200520,710595,雍智國票9A購01,5.40,6.00,5.25,5.50,+0.55,11.11,203000,21,1116500,0,0,0,0,0,0,100000,103000,-3000,-3000
20200520,710596,大江元大9A購03,1.42,1.43,1.37,1.37,-0.03,-2.14,34000,5,47170,0,0,0,0,0,0,34000,0,34000,34000
20200520,710597,大學光元大9A購01,,,,,,0.00,0,0,0,0,0,0,0,0,0,0,0,0,0
20200520,710598,原相元大9A購09,2.10,2.10,2.02,2.02,-0.14,-6.48,111000,8,230280,0,0,0,0,0,0,79000,61000,18000,18000
20200520,710599,泰博元大9A購02,,,,,,0.00,0,0,0,0,0,0,0,0,0,0,0,0,0
20200520,710600,群聯元大9A購11,2.33,2.33,2.33,2.33,-0.01,-0.43,36000,1,83880,0,0,0,0,0,0,36000,0,36000,36000
20200520,710601,精測元大9A購05,1.51,1.51,1.44,1.47,-0.04,-2.65,153000,6,223850,0,0,0,0,0,0,85000,85000,0,0
20200520,710602,鈊象元大9A購04,2.29,2.35,2.29,2.35,-0.03,-1.26,2000,2,4640,0,0,0,0,0,0,1000,2000,-1000,-1000
20200520,710603,大江凱基9B購01,1.69,1.69,1.59,1.62,-0.03,-1.82,57000,9,92510,0,0,0,0,0,0,29000,28000,1000,1000
20200520,710604,大學光凱基9A購04,3.70,4.42,3.70,4.42,-0.11,-2.43,61000,7,254370,0,0,0,0,0,0,1000,60000,-59000,-59000
20200520,710605,原相凱基9B購01,,,,,,0.00,0,0,0,0,0,0,0,0,0,0,0,0,0
20200520,710606,太醫統一9C購01,0.56,0.56,0.56,0.56,-0.02,-3.45,60000,1,33600,0,0,0,0,0,0,60000,0,60000,60000
20200520,710607,寶雅統一9C購01,1.30,1.38,1.30,1.36,+0.05,3.82,997000,18,1345670,0,0,0,0,0,0,510000,987000,-477000,-477000
20200520,710608,鈊象統一9A購02,,,,,,0.00,0,0,0,0,0,0,0,0,0,0,0,0,0
20200520,710609,鈊象統一9A購03,,,,,,0.00,0,0,0,0,0,0,0,0,0,0,0,0,0
20200520,710610,凡甲兆豐9A購01,1.80,1.86,1.80,1.80,-0.19,-9.55,156000,17,285230,0,0,0,0,0,0,144000,12000,132000,132000
20200520,710611,泰博兆豐9A購01,3.33,4.49,3.33,4.34,+0.34,8.5,118000,9,423950,0,0,0,0,0,0,115000,0,115000,115000
20200520,710612,環球晶兆豐9B購01,1.32,1.32,1.28,1.28,-0.05,-3.76,34000,5,44430,0,0,0,0,0,0,11000,23000,-12000,-12000
20200520,710613,聯亞兆豐9A購01,0.92,0.92,0.92,0.92,+0.01,1.1,60000,1,55200,0,0,0,0,0,0,60000,0,60000,60000
20200520,710614,雙鴻兆豐9B購01,1.46,1.46,1.43,1.43,-0.03,-2.05,60000,4,86600,0,0,0,0,0,0,20000,40000,-20000,-20000
20200520,710615,穩懋兆豐9A購03,0.76,0.76,0.71,0.72,-0.06,-7.69,297000,19,215640,0,0,0,0,0,0,55000,242000,-187000,-187000
20200520,710616,穩懋兆豐9B購01,1.62,1.62,1.59,1.59,-0.16,-9.14,83000,3,132630,0,0,0,0,0,0,0,83000,-83000,-83000
20200520,710617,大江永豐9A購02,1.08,1.08,1.08,1.08,0.00,0.0,30000,1,32400,0,0,0,0,0,0,0,0,0,0
20200520,710618,六角永豐9A購01,0.96,0.96,0.90,0.90,-0.02,-2.17,202000,6,191350,0,0,0,0,0,0,187000,15000,172000,172000
20200520,710619,太醫永豐9A購01,0.67,0.69,0.67,0.68,-0.01,-1.45,142000,4,96680,0,0,0,0,0,0,0,142000,-142000,-142000
20200520,710620,信昌電永豐9A購02,0.81,0.81,0.81,0.81,+0.02,2.53,20000,2,16200,0,0,0,0,0,0,10000,10000,0,0
20200520,710621,原相永豐9A購05,,,,,,0.00,0,0,0,0,0,0,0,0,0,0,0,0,0
20200520,710622,雍智永豐9A購02,1.53,1.71,1.50,1.57,+0.15,10.56,471000,27,746960,0,0,0,0,0,0,210000,255000,-45000,-45000
20200520,710623,碩禾永豐9A購01,,,,,,0.00,0,0,0,0,0,0,0,0,0,0,0,0,0
20200520,710624,寶雅永豐9A購02,1.43,1.53,1.43,1.53,+0.09,6.25,102000,5,150760,10000,0,10000,0,0,0,0,102000,-102000,-92000
20200520,710625,大江國票9A購06,5.85,5.85,5.40,5.40,-0.25,-4.42,7000,3,38350,0,0,0,0,0,0,7000,0,7000,7000
20200520,710626,弘塑國票9A購03,2.56,2.56,2.49,2.53,-0.04,-1.56,100000,4,253400,0,0,0,0,0,0,50000,50000,0,0
20200520,710627,宏捷科國票9A購03,,,,,,0.00,0,0,0,0,0,0,0,0,0,0,0,0,0
20200520,710628,鈊象國票9A購04,4.86,4.86,4.68,4.68,-0.14,-2.9,11000,6,52600,0,0,0,0,0,0,11000,11000,0,0
20200520,710629,凡甲群益9A購01,1.42,1.47,1.38,1.38,-0.05,-3.5,267000,10,378230,0,0,0,0,0,0,150000,117000,33000,33000
20200520,710630,大江群益9A購01,1.72,1.72,1.60,1.62,-0.05,-2.99,243000,8,408240,0,0,0,0,0,0,101000,142000,-41000,-41000
20200520,710631,宇峻群益9A購03,0.76,0.79,0.76,0.78,+0.03,4.0,166000,4,127280,0,0,0,0,0,0,0,166000,-166000,-166000
20200520,710632,群聯群益9A購02,1.26,1.26,1.25,1.25,-0.02,-1.57,40000,2,50200,0,0,0,0,0,0,0,40000,-40000,-40000
20200520,710633,雙鴻群益9A購02,1.34,1.36,1.34,1.36,0.00,0.0,71000,2,95160,0,0,0,0,0,0,71000,71000,0,0
20200520,710634,鈊象群益9A購03,0.85,0.85,0.85,0.85,-0.02,-2.3,20000,1,17000,0,0,0,0,0,0,20000,0,20000,20000
20200520,710635,鈺太群益9A購01,1.09,1.09,1.04,1.07,+0.03,2.88,120000,5,128620,0,0,0,0,0,0,76000,84000,-8000,-8000
20200520,710636,寶雅凱基9A購01,1.46,1.56,1.46,1.56,+0.07,4.7,99000,9,149910,2000,0,2000,0,0,0,30000,69000,-39000,-37000
20200520,710637,原相統一9A購03,0.66,0.67,0.64,0.65,-0.04,-5.8,1088000,21,706310,0,0,0,0,0,0,976000,112000,864000,864000
20200520,710638,精測統一9B購01,0.56,0.56,0.54,0.54,-0.05,-8.47,50000,3,27500,0,0,0,0,0,0,10000,40000,-30000,-30000
20200520,710639,穩懋統一9C購02,0.62,0.63,0.60,0.61,-0.03,-4.69,261000,19,159830,0,0,0,0,0,0,121000,120000,1000,1000
20200520,710640,大江元大9A購04,1.48,1.48,1.42,1.42,-0.04,-2.74,26000,3,37820,0,0,0,0,0,0,16000,10000,6000,6000
20200520,710641,信驊元大9A購03,3.82,3.88,3.72,3.88,+0.34,9.6,66000,6,253470,0,0,0,0,0,0,66000,53000,13000,13000
20200520,710642,原相元大9A購10,1.39,1.39,1.34,1.34,-0.06,-4.29,410000,21,559850,0,0,0,0,0,0,282000,130000,152000,152000
20200520,710643,泰博元大9B購02,5.35,5.75,5.35,5.75,-0.30,-4.96,17000,5,95900,0,0,0,0,0,0,6000,11000,-5000,-5000
20200520,710644,博智元大9A購02,1.26,1.26,1.20,1.25,-0.08,-6.02,45000,6,55000,0,5000,-5000,0,0,0,10000,25000,-15000,-20000
20200520,710645,網家元大9A購01,2.93,3.44,2.93,3.22,+0.29,9.9,361000,46,1174470,0,0,0,0,0,0,173000,197000,-24000,-24000
20200520,710646,優群元大9A購02,1.73,1.82,1.70,1.70,-0.02,-1.16,170000,7,299120,0,0,0,0,0,0,74000,96000,-22000,-22000
20200520,710647,威剛富邦9B購01,0.69,0.69,0.69,0.69,-0.02,-2.82,10000,1,6900,0,0,0,0,0,0,10000,0,10000,10000
20200520,710648,弘塑國泰9C購01,1.57,1.57,1.52,1.57,0.00,0.0,457000,16,706480,0,0,0,0,0,0,116000,341000,-225000,-225000
20200520,710649,神盾國泰9C購01,2.10,2.13,1.95,1.95,-0.09,-4.41,356000,49,732970,0,0,0,0,0,0,339000,105000,234000,234000
20200520,710650,新普國泰9C購01,1.88,1.88,1.74,1.77,-0.08,-4.32,295000,22,528820,0,0,0,0,0,0,167000,181000,-14000,-14000
20200520,710651,信驊群益9A購01,,,,,,0.00,0,0,0,0,0,0,0,0,0,0,0,0,0
20200520,710652,原相中信03購01,0.79,0.79,0.77,0.77,-0.03,-3.75,136000,7,104970,0,0,0,0,0,0,96000,40000,56000,56000
20200520,710653,博智中信9A購01,0.50,0.50,0.50,0.50,-0.04,-7.41,37000,3,18500,0,0,0,0,0,0,0,37000,-37000,-37000
20200520,710654,弘塑永豐9A購02,,,,,,0.00,0,0,0,0,0,0,0,0,0,0,0,0,0
20200520,710655,佳邦永豐9A購02,,,,,,0.00,0,0,0,0,0,0,0,0,0,0,0,0,0
20200520,710656,博智永豐9A購04,0.65,0.65,0.62,0.62,-0.06,-8.82,20000,2,12700,0,0,0,0,0,0,0,20000,-20000,-20000
20200520,710657,閎康永豐9A購02,1.00,1.07,1.00,1.07,+0.02,1.9,200000,7,205930,0,0,0,0,0,0,105000,153000,-48000,-48000
20200520,710658,順達永豐9A購01,1.12,1.33,1.12,1.32,+0.20,17.86,1288000,40,1585390,0,0,0,0,0,0,128000,1160000,-1032000,-1032000
20200520,710659,雍智永豐9A購03,2.17,2.42,2.15,2.27,+0.18,8.61,211000,21,475880,0,0,0,0,0,0,127000,82000,45000,45000
20200520,710660,雙美永豐9A購01,1.32,1.37,1.30,1.33,-0.03,-2.21,103000,6,136990,0,0,0,0,0,0,77000,32000,45000,45000
20200520,710661,良維兆豐9B購01,,,,,,0.00,0,0,0,0,0,0,0,0,0,0,0,0,0
20200520,710662,金居兆豐9A購01,1.99,2.00,1.99,2.00,-0.06,-2.91,38000,5,75960,0,0,0,0,0,0,37000,1000,36000,36000
20200520,710663,原相兆豐9B購01,0.93,0.93,0.92,0.93,-0.04,-4.12,397000,4,368970,0,0,0,0,0,0,373000,24000,349000,349000
20200520,710664,神盾兆豐9B購01,1.41,1.41,1.31,1.31,-0.04,-2.96,124000,6,172460,0,0,0,0,0,0,124000,0,124000,124000
20200520,710665,新普兆豐9A購01,1.56,1.56,1.49,1.50,-0.08,-5.06,101000,7,155060,0,0,0,0,0,0,101000,0,101000,101000
20200520,710666,凡甲元大9A購03,,,,,,0.00,0,0,0,0,0,0,0,0,0,0,0,0,0
20200520,710667,泰博元大9A購03,,,,,,0.00,0,0,0,0,0,0,0,0,0,0,0,0,0
20200520,710668,原相兆豐9B購02,0.88,0.89,0.87,0.88,-0.05,-5.38,319000,5,279670,0,0,0,0,0,0,294000,25000,269000,269000
20200520,710669,環球晶兆豐9B購02,1.09,1.09,1.09,1.09,-0.02,-1.8,14000,1,15260,0,0,0,0,0,0,0,14000,-14000,-14000
20200520,710670,雙美群益9B購01,1.45,1.45,1.40,1.42,+0.01,0.71,80000,7,114450,2000,0,2000,0,0,0,75000,10000,65000,67000
20200520,710671,大江富邦9C購02,0.96,0.96,0.90,0.91,-0.04,-4.21,687000,10,629320,0,0,0,0,0,0,460000,227000,233000,233000
20200520,710672,M31凱基9A購02,1.23,1.29,1.20,1.20,+0.04,3.45,192000,28,239000,0,0,0,0,0,0,141000,81000,60000,60000
20200520,710673,大江凱基9A購02,,,,,,0.00,0,0,0,0,0,0,0,0,0,0,0,0,0
20200520,710674,原相凱基9A購06,,,,,,0.00,0,0,0,0,0,0,0,0,0,0,0,0,0
20200520,710675,群聯凱基9B購04,0.88,0.90,0.88,0.90,+0.01,1.12,178000,3,159000,0,0,0,0,0,0,110000,68000,42000,42000
20200520,710676,精測凱基9A購04,,,,,,0.00,0,0,0,0,0,0,0,0,0,0,0,0,0
20200520,710677,聯亞凱基9A購02,,,,,,0.00,0,0,0,0,0,0,0,0,0,0,0,0,0
20200520,710678,穩懋凱基9A購04,0.60,0.60,0.56,0.56,-0.06,-9.68,8000,2,4560,0,0,0,0,0,0,6000,2000,4000,4000
20200520,710679,譜瑞凱基9A購03,1.91,1.93,1.73,1.78,-0.07,-3.78,140000,15,263090,0,0,0,0,0,0,99000,41000,58000,58000
20200520,710680,雙鴻第一9B購01,0.80,0.80,0.80,0.80,0.00,0.0,60000,1,48000,0,0,0,0,0,0,60000,0,60000,60000
20200520,710681,泰博中信9B購01,2.30,3.36,2.30,2.49,+0.09,3.75,35000,5,85270,0,0,0,0,0,0,21000,13000,8000,8000
20200520,710682,精測中信9A購03,0.72,0.72,0.70,0.70,-0.02,-2.78,75000,2,53960,0,0,0,0,0,0,73000,75000,-2000,-2000
20200520,710683,弘塑永豐9A購03,,,,,,0.00,0,0,0,0,0,0,0,0,0,0,0,0,0
20200520,710684,旺矽永豐9A購02,1.66,1.84,1.64,1.82,+0.14,8.33,426000,36,729360,0,0,0,0,0,0,89000,337000,-248000,-248000
20200520,710685,業強永豐9A購02,,,,,,0.00,0,0,0,0,0,0,0,0,0,0,0,0,0
20200520,710686,中美晶麥證9A購01,1.39,1.39,1.36,1.36,-0.04,-2.86,61000,8,83760,61000,0,61000,0,0,0,61000,0,61000,61000
20200520,710687,威剛麥證9B購01,,,,,,0.00,0,0,0,0,0,0,0,0,0,0,0,0,0
20200520,710688,博智統一9A購01,0.67,0.67,0.62,0.65,-0.05,-7.14,38000,6,24080,0,0,0,0,0,0,14000,24000,-10000,-10000
20200520,710689,博智統一9A購02,0.83,0.85,0.83,0.85,-0.02,-2.3,223000,2,185550,0,0,0,0,0,0,223000,23000,200000,200000
20200520,710690,環球晶統一9C購01,0.91,0.91,0.91,0.91,-0.03,-3.19,5000,1,4550,0,0,0,0,0,0,5000,0,5000,5000
20200520,710691,群聯國泰9C購01,1.50,1.50,1.46,1.49,0.00,0.0,558000,21,826900,0,0,0,0,0,0,558000,0,558000,558000
20200520,710692,精測國泰9C購02,1.90,1.90,1.76,1.76,-0.14,-7.37,329000,25,599460,0,0,0,0,0,0,229000,63000,166000,166000
20200520,710693,優群國泰9B購01,1.49,1.56,1.44,1.48,+0.05,3.5,879000,41,1307140,0,0,0,0,0,0,403000,466000,-63000,-63000
20200520,710694,晟德兆豐9B購01,1.47,1.58,1.47,1.54,+0.10,6.94,322000,9,497080,0,0,0,0,0,0,254000,10000,244000,244000
20200520,710695,鈊象兆豐9B購01,0.99,1.01,0.99,1.01,0.00,0.0,31000,2,30710,0,0,0,0,0,0,31000,1000,30000,30000
20200520,710696,大江元大9A購05,1.50,1.52,1.50,1.50,+0.01,0.67,101000,4,153200,0,0,0,0,0,0,26000,75000,-49000,-49000
20200520,710697,信驊元大9A購05,2.85,2.85,2.50,2.50,-0.10,-3.85,35000,13,92350,0,0,0,0,0,0,27000,5000,22000,22000
20200520,710698,雍智元大9A購01,2.98,3.23,2.89,3.07,+0.34,12.45,731000,63,2238860,2000,0,2000,0,0,0,427000,620000,-193000,-191000
20200520,710699,優群元大9A購03,2.29,2.40,2.22,2.40,+0.13,5.73,151000,6,344860,0,0,0,0,0,0,99000,52000,47000,47000
20200520,710700,雙美元大9A購01,2.25,2.31,2.20,2.21,-0.01,-0.45,655000,14,1480270,0,0,0,0,0,0,299000,335000,-36000,-36000
20200520,710701,鈊象元大9A購05,2.24,2.24,2.17,2.17,-0.06,-2.69,2000,2,4410,0,0,0,0,0,0,1000,2000,-1000,-1000
20200520,710702,鈺太元大9A購02,1.26,1.28,1.24,1.25,+0.02,1.63,272000,8,345170,0,0,0,0,0,0,115000,188000,-73000,-73000
20200520,710703,信驊群益9A購02,2.78,2.78,2.38,2.40,-0.17,-6.61,386000,25,1038570,0,0,0,0,0,0,293000,73000,220000,220000
20200520,710704,泰博群益9A購02,4.67,5.70,4.66,5.55,+0.97,21.18,42000,6,202290,0,0,0,0,0,0,22000,20000,2000,2000
20200520,710705,精測群益9A購02,1.96,1.96,1.94,1.95,-0.14,-6.7,31000,6,60500,0,0,0,0,0,0,11000,20000,-9000,-9000
20200520,710706,精測永豐9A購03,1.14,1.14,1.11,1.11,-0.07,-5.93,124000,4,140170,0,0,0,0,0,0,115000,5000,110000,110000
20200520,710707,璟德永豐9A購01,,,,,,0.00,0,0,0,0,0,0,0,0,0,0,0,0,0
20200520,710708,晟德永豐9A購01,1.35,1.54,1.33,1.49,+0.13,9.56,456000,25,664520,0,0,0,0,0,0,78000,388000,-310000,-310000
20200520,710709,頎邦永豐9A購02,,,,,,0.00,0,0,0,0,0,0,0,0,0,0,0,0,0
20200520,710710,群聯麥證9A購01,0.85,0.85,0.84,0.84,+0.03,3.7,19000,2,16060,19000,0,19000,0,0,0,19000,0,19000,19000
20200520,710711,穩懋統一9A購04,0.53,0.53,0.50,0.51,-0.04,-7.27,42000,6,21540,0,0,0,0,0,0,16000,26000,-10000,-10000
20200520,710712,M31凱基9A購03,1.22,1.30,1.13,1.13,-0.04,-3.42,354000,36,440510,0,0,0,0,0,0,253000,111000,142000,142000
20200520,710713,弘塑凱基9B購01,1.04,1.04,1.02,1.04,-0.01,-0.95,143000,6,147110,0,0,0,0,0,0,32000,111000,-79000,-79000
20200520,710714,環球晶凱基9B購03,,,,,,0.00,0,0,0,0,0,0,0,0,0,0,0,0,0
20200520,710715,穩懋凱基9A購05,0.99,0.99,0.99,0.99,-0.08,-7.48,10000,1,9900,0,0,0,0,0,0,0,10000,-10000,-10000
20200520,710716,凡甲永豐9A購03,0.88,0.89,0.87,0.87,-0.01,-1.14,183000,7,161210,0,0,0,0,0,0,113000,68000,45000,45000
20200520,710717,宏捷科永豐9B購01,0.83,0.83,0.83,0.83,-0.02,-2.35,3000,1,2490,0,0,0,0,0,0,0,3000,-3000,-3000
20200520,710718,良維永豐9A購01,1.08,1.09,1.06,1.08,0.00,0.0,304000,13,325910,0,0,0,0,0,0,303000,78000,225000,225000
20200520,710719,南光永豐9A購01,0.85,0.86,0.85,0.86,0.00,0.0,266000,2,227430,0,0,0,0,0,0,0,266000,-266000,-266000
20200520,710720,優群永豐9A購03,,,,,,0.00,0,0,0,0,0,0,0,0,0,0,0,0,0
20200520,710721,威剛統一9C購02,0.87,0.87,0.87,0.87,+0.03,3.57,5000,1,4350,0,0,0,0,0,0,5000,0,5000,5000
20200520,710722,宏捷科凱基9B購02,,,,,,0.00,0,0,0,0,0,0,0,0,0,0,0,0,0
20200520,710723,原相凱基9B購02,,,,,,0.00,0,0,0,0,0,0,0,0,0,0,0,0,0
20200520,710724,精測凱基9A購05,1.22,1.23,1.18,1.18,-0.07,-5.6,34000,12,41050,0,0,0,0,0,0,22000,12000,10000,10000
20200520,710725,優群凱基9B購01,0.91,0.93,0.89,0.90,+0.02,2.27,125000,12,113940,0,0,0,0,0,0,9000,116000,-107000,-107000
20200520,710726,頎邦凱基9A購01,1.92,1.92,1.92,1.92,-0.02,-1.03,10000,1,19200,0,0,0,0,0,0,10000,0,10000,10000
20200520,710727,凡甲元大9B購01,1.07,1.08,1.03,1.05,-0.02,-1.87,51000,6,53550,0,0,0,0,0,0,30000,21000,9000,9000
20200520,710728,弘塑元大9B購02,1.22,1.24,1.22,1.24,-0.01,-0.8,298000,8,365110,0,0,0,0,0,0,178000,236000,-58000,-58000
20200520,710729,宏捷科元大9A購02,,,,,,0.00,0,0,0,0,0,0,0,0,0,0,0,0,0
20200520,710730,威剛元大9B購03,0.88,0.88,0.85,0.85,-0.03,-3.41,322000,25,276000,0,0,0,0,0,0,322000,317000,5000,5000
20200520,710731,網龍元大9A購03,,,,,,0.00,0,0,0,0,0,0,0,0,0,0,0,0,0
20200520,710732,雙鴻元大9C購03,1.05,1.05,1.04,1.04,0.00,0.0,80000,4,83800,0,0,0,0,0,0,60000,20000,40000,40000
20200520,710733,鈊象元大9A購06,1.82,1.82,1.78,1.80,-0.03,-1.64,102000,8,184860,0,0,0,0,0,0,22000,80000,-58000,-58000
20200520,710734,精測兆豐9B購01,0.58,0.58,0.58,0.58,-0.03,-4.92,105000,3,60900,0,0,0,0,0,0,5000,100000,-95000,-95000
20200520,710735,鈺太兆豐9B購01,1.10,1.10,1.05,1.07,+0.02,1.9,199000,8,214110,0,0,0,0,0,0,177000,22000,155000,155000
20200520,710736,宏捷科群益9A購02,,,,,,0.00,0,0,0,0,0,0,0,0,0,0,0,0,0
20200520,710737,璟德群益9A購01,1.58,1.58,1.58,1.58,+0.01,0.64,48000,2,75840,0,0,0,0,0,0,48000,0,48000,48000
20200520,710738,宏捷科國票9A購04,,,,,,0.00,0,0,0,0,0,0,0,0,0,0,0,0,0
20200520,710739,南光國票9A購01,2.69,2.69,2.69,2.69,+0.04,1.51,11000,1,29590,0,0,0,0,0,0,0,11000,-11000,-11000
20200520,710740,優群國票9A購03,3.98,4.12,3.97,4.03,+0.14,3.6,59000,6,238340,0,0,0,0,0,0,25000,34000,-9000,-9000
20200520,710741,雙美國票9A購01,,,,,,0.00,0,0,0,0,0,0,0,0,0,0,0,0,0
20200520,710742,聯亞中信9A購01,,,,,,0.00,0,0,0,0,0,0,0,0,0,0,0,0,0
20200520,710743,大學光元大9A購02,,,,,,0.00,0,0,0,0,0,0,0,0,0,0,0,0,0
20200520,710744,太醫元大9A購01,0.97,1.03,0.97,1.03,+0.04,4.04,275000,5,277950,0,0,0,0,0,0,5000,270000,-265000,-265000
20200520,710745,宏捷科元大9A購03,2.16,2.16,2.15,2.15,-0.11,-4.87,55000,2,118750,0,0,0,0,0,0,0,55000,-55000,-55000
20200520,710746,良維元大9A購02,2.04,2.08,1.99,2.04,-0.02,-0.97,407000,26,827890,0,0,0,0,0,0,398000,19000,379000,379000
20200520,710747,信昌電元大9A購01,1.44,1.51,1.42,1.50,+0.11,7.91,334000,13,495710,0,0,0,0,0,0,334000,0,334000,334000
20200520,710748,是方元大9A購01,1.55,1.72,1.55,1.70,+0.17,11.11,1844000,66,3041930,0,0,0,0,0,0,664000,1261000,-597000,-597000
20200520,710749,順達元大9A購01,1.82,2.11,1.82,2.07,+0.28,15.64,765000,52,1512670,0,0,0,0,0,0,44000,721000,-677000,-677000
20200520,710750,群聯元大9B購01,1.11,1.11,1.11,1.11,-0.01,-0.89,13000,1,14430,0,0,0,0,0,0,13000,13000,0,0
20200520,710751,璟德元大9A購01,1.46,1.46,1.42,1.45,-0.01,-0.68,117000,3,168070,0,0,0,0,0,0,49000,68000,-19000,-19000
20200520,710752,鈊象元大9A購07,2.68,2.68,2.60,2.60,-0.07,-2.62,15000,6,39940,0,0,0,0,0,0,15000,15000,0,0
20200520,710753,鈺太元大9A購03,1.70,1.70,1.66,1.66,+0.05,3.11,225000,12,382060,0,0,0,0,0,0,222000,35000,187000,187000
20200520,710754,精測富邦9B購01,0.39,0.39,0.38,0.39,-0.02,-4.88,65000,14,25190,0,0,0,0,0,0,60000,5000,55000,55000
20200520,710755,良維群益9A購01,1.71,1.73,1.63,1.70,-0.03,-1.73,820000,19,1364620,0,0,0,0,0,0,669000,229000,440000,440000
20200520,710756,順達群益9B購01,2.67,3.12,2.67,3.12,+0.48,18.18,467000,38,1332040,0,0,0,0,0,0,202000,431000,-229000,-229000
20200520,710757,頎邦群益9B購01,2.48,2.49,2.46,2.46,-0.08,-3.15,337000,24,835100,0,0,0,0,0,0,252000,130000,122000,122000
20200520,710758,凡甲國票9A購02,2.34,2.35,2.26,2.26,-0.14,-5.83,240000,9,550820,0,0,0,0,0,0,121000,119000,2000,2000
20200520,710759,優群國票9A購04,1.79,1.86,1.79,1.82,+0.06,3.41,136000,6,247650,0,0,0,0,0,0,28000,108000,-80000,-80000
20200520,710760,頎邦國票9A購01,4.46,4.46,4.46,4.46,-0.07,-1.55,7000,1,31220,0,0,0,0,0,0,7000,0,7000,7000
20200520,710761,穩懋中信9A購01,1.11,1.11,1.11,1.11,-0.09,-7.5,20000,1,22200,0,0,0,0,0,0,20000,0,20000,20000
20200520,710762,穩懋中信9C購01,1.23,1.23,1.23,1.23,-0.07,-5.38,2000,1,2460,0,0,0,0,0,0,2000,0,2000,2000
20200520,710763,頎邦中信9A購01,0.89,0.89,0.89,0.89,-0.01,-1.11,17000,2,15130,0,0,0,0,0,0,17000,0,17000,17000
20200520,710764,良維凱基9B購01,1.06,1.09,1.05,1.06,-0.02,-1.85,486000,20,518860,0,0,0,0,0,0,443000,93000,350000,350000
20200520,710765,大學光永豐9A購03,,,,,,0.00,0,0,0,0,0,0,0,0,0,0,0,0,0
20200520,710766,泰博永豐9A購03,2.65,2.99,2.65,2.99,+0.31,11.57,74000,6,205950,0,0,0,0,0,0,20000,54000,-34000,-34000
20200520,710767,雙鴻永豐9B購01,,,,,,0.00,0,0,0,0,0,0,0,0,0,0,0,0,0
20200520,710768,中美晶統一9C購01,0.92,0.92,0.90,0.90,-0.02,-2.17,125000,6,113550,0,0,0,0,0,0,65000,60000,5000,5000
20200520,710769,宏捷科統一9C購01,0.85,0.86,0.85,0.85,-0.02,-2.3,70000,7,59800,0,0,0,0,0,0,0,70000,-70000,-70000
20200520,710770,中美晶兆豐9B購01,1.03,1.03,0.99,1.00,-0.03,-2.91,184000,6,183380,0,0,0,0,0,0,119000,65000,54000,54000
20200520,710771,金可兆豐9A購01,1.20,1.20,1.19,1.19,-0.01,-0.83,22000,5,26380,0,0,0,0,0,0,18000,4000,14000,14000
20200520,710772,穩懋兆豐9B購02,1.48,1.48,1.44,1.44,-0.04,-2.7,337000,11,491360,0,0,0,0,0,0,60000,277000,-217000,-217000
20200520,710773,大學光元大9A購03,2.40,2.60,2.40,2.60,+0.21,8.79,108000,7,268200,0,0,0,0,0,0,20000,88000,-68000,-68000
20200520,710774,新普元大9A購02,1.59,1.63,1.55,1.56,-0.02,-1.27,328000,29,520090,0,0,0,0,0,0,72000,264000,-192000,-192000
20200520,710775,雍智元大9A購02,1.96,2.11,1.89,2.02,+0.20,10.99,471000,41,939450,0,0,0,0,0,0,212000,221000,-9000,-9000
20200520,710776,精華元大9A購01,2.04,2.04,2.01,2.01,-0.01,-0.5,51000,2,104010,0,0,0,0,0,0,51000,51000,0,0
20200520,710777,聚積元大9A購02,1.44,1.44,1.44,1.44,-0.04,-2.7,2000,1,2880,0,0,0,0,0,0,2000,0,2000,2000
20200520,710778,璟德元大9A購02,2.07,2.07,2.07,2.07,+0.04,1.97,4000,1,8280,0,0,0,0,0,0,4000,0,4000,4000
20200520,710779,頎邦元大9A購03,3.19,3.19,3.19,3.19,-0.01,-0.31,6000,1,19140,0,0,0,0,0,0,6000,0,6000,6000
20200520,710780,群聯群益9A購03,,,,,,0.00,0,0,0,0,0,0,0,0,0,0,0,0,0
20200520,710781,大學光凱基9A購05,1.99,2.62,1.99,2.57,+0.35,15.77,454000,54,1066860,0,0,0,0,0,0,222000,221000,1000,1000
20200520,710782,精測凱基9A購07,1.70,1.70,1.70,1.70,-0.15,-8.11,30000,1,51000,0,0,0,0,0,0,30000,0,30000,30000
20200520,710783,優群凱基9A購05,0.57,0.60,0.57,0.60,0.00,0.0,180000,3,105500,0,0,0,0,0,0,150000,30000,120000,120000
20200520,710784,寶雅凱基9A購02,1.91,2.00,1.91,2.00,+0.06,3.09,15000,2,29550,0,0,0,0,0,0,5000,10000,-5000,-5000
20200520,710785,鈊象凱基9B購02,2.77,2.85,2.77,2.85,+0.03,1.06,3000,3,8470,0,0,0,0,0,0,2000,3000,-1000,-1000
20200520,710786,神盾中信9C購01,0.95,0.96,0.88,0.88,-0.05,-5.38,343000,28,320060,0,0,0,0,0,0,279000,64000,215000,215000
20200520,710787,世界國票9A購01,3.21,3.31,3.13,3.13,-0.17,-5.15,72000,8,233200,0,0,0,0,0,0,29000,43000,-14000,-14000
20200520,710788,良維國票9A購02,4.88,4.90,4.77,4.77,-0.02,-0.42,141000,5,680040,0,0,0,0,0,0,141000,80000,61000,61000
20200520,710789,信驊國票9A購04,3.35,3.43,2.88,2.93,-0.24,-7.57,71000,9,231090,0,0,0,0,0,0,55000,16000,39000,39000
20200520,710790,原相國票9C購01,2.02,2.02,2.02,2.02,-0.06,-2.88,14000,1,28280,0,0,0,0,0,0,14000,0,14000,14000
20200520,710791,泰博國票9A購04,12.50,13.80,12.10,13.50,+1.40,11.57,125000,24,1578600,0,0,0,0,0,0,60000,65000,-5000,-5000
20200520,710792,聖暉國票9A購02,2.34,2.35,2.29,2.29,-0.07,-2.97,165000,6,385070,0,0,0,0,0,0,87000,78000,9000,9000
20200520,710793,璟德國票9A購01,2.47,2.47,2.47,2.47,0.00,0.0,23000,2,56810,0,0,0,0,0,0,23000,0,23000,23000
20200520,710794,雙美國票9A購02,2.03,2.03,1.99,2.00,0.00,0.0,5000,3,10000,0,0,0,0,0,0,5000,5000,0,0
20200520,710795,原相元大9B購05,0.96,0.96,0.96,0.96,-0.03,-3.03,103000,8,98880,0,0,0,0,0,0,103000,3000,100000,100000
20200520,710796,優群元大9A購04,1.40,1.40,1.40,1.40,+0.02,1.45,14000,1,19600,0,0,0,0,0,0,14000,0,14000,14000
20200520,710797,雙鴻元大9B購02,0.93,0.93,0.91,0.91,-0.03,-3.19,21000,2,19130,0,0,0,0,0,0,0,21000,-21000,-21000
20200520,710798,頎邦元大9A購04,2.86,2.86,2.82,2.84,-0.06,-2.07,103000,7,293720,0,0,0,0,0,0,103000,0,103000,103000
20200520,710799,網龍群益9A購02,3.51,3.51,3.37,3.39,-0.21,-5.83,7000,6,23980,0,0,0,0,0,0,5000,5000,0,0
20200520,710800,磐亞群益9A購01,0.93,0.93,0.92,0.92,-0.01,-1.08,199000,3,184060,0,0,0,0,0,0,98000,101000,-3000,-3000
20200520,710801,鈺太群益9A購02,2.05,2.05,2.02,2.02,+0.07,3.59,60000,2,121800,0,0,0,0,0,0,60000,40000,20000,20000
20200520,710802,金居凱基9A購02,1.92,1.92,1.88,1.89,-0.06,-3.08,912000,13,1739660,0,0,0,0,0,0,552000,360000,192000,192000
20200520,710803,信驊凱基9A購04,1.72,1.78,1.51,1.51,-0.13,-7.93,457000,27,777750,0,0,0,0,0,0,447000,10000,437000,437000
20200520,710804,鈊象凱基9A購04,,,,,,0.00,0,0,0,0,0,0,0,0,0,0,0,0,0
20200520,710805,精測統一9B購02,0.79,0.79,0.76,0.76,-0.05,-6.17,409000,16,315860,0,0,0,0,0,0,309000,100000,209000,209000
20200520,710806,久元永豐9A購01,1.74,1.91,1.62,1.87,+0.21,12.65,504000,37,869850,0,0,0,0,0,0,239000,265000,-26000,-26000
20200520,710807,亞泰永豐9A購01,,,,,,0.00,0,0,0,0,0,0,0,0,0,0,0,0,0
20200520,710808,宜特永豐9A購02,1.16,1.30,1.16,1.30,+0.09,7.44,414000,12,498530,0,0,0,0,0,0,234000,177000,57000,57000
20200520,710809,信驊永豐9A購01,1.20,1.22,1.15,1.15,0.00,0.0,270000,13,320800,0,0,0,0,0,0,225000,45000,180000,180000
20200520,710810,威剛永豐9A購03,0.80,0.82,0.79,0.79,-0.03,-3.66,320000,11,256690,0,0,0,0,0,0,282000,38000,244000,244000
20200520,710811,原相永豐9B購01,,,,,,0.00,0,0,0,0,0,0,0,0,0,0,0,0,0
20200520,710812,聖暉永豐9A購01,,,,,,0.00,0,0,0,0,0,0,0,0,0,0,0,0,0
20200520,710813,網家永豐9A購03,1.21,1.36,1.21,1.32,+0.15,12.82,443000,32,574910,0,0,0,0,0,0,129000,314000,-185000,-185000
20200520,710814,網龍永豐9A購04,1.91,1.91,1.83,1.83,0.00,0.0,3000,2,5650,0,0,0,0,0,0,3000,3000,0,0
20200520,710815,雙美永豐9A購02,1.46,1.46,1.39,1.39,-0.03,-2.11,5000,2,7160,0,0,0,0,0,0,5000,5000,0,0
20200520,710816,雙鴻永豐9A購03,,,,,,0.00,0,0,0,0,0,0,0,0,0,0,0,0,0
20200520,710817,群聯國票9A購03,4.50,4.50,4.34,4.48,+0.02,0.45,23000,10,102690,0,0,0,0,0,0,23000,9000,14000,14000
20200520,710818,雙鴻富邦9B購02,0.60,0.60,0.59,0.59,-0.02,-3.28,55000,3,32900,0,0,0,0,0,0,40000,15000,25000,25000
20200520,710819,原相元大9B購06,1.73,1.73,1.70,1.70,-0.06,-3.41,102000,10,174100,0,0,0,0,0,0,88000,17000,71000,71000
20200520,710820,泰博元大9A購04,4.40,4.87,4.40,4.87,+0.21,4.51,85000,9,389030,0,0,0,0,0,0,0,85000,-85000,-85000
20200520,710821,櫃200元大9A購02,3.73,3.73,3.73,3.73,+0.08,2.19,10000,1,37300,0,0,0,0,0,0,0,10000,-10000,-10000
20200520,710822,凡甲群益9A購02,1.91,1.91,1.84,1.84,-0.16,-8.0,186000,4,346590,0,0,0,0,0,0,86000,100000,-14000,-14000
20200520,710823,大江群益9A購02,,,,,,0.00,0,0,0,0,0,0,0,0,0,0,0,0,0
20200520,710824,新鉅科群益9A購03,2.23,2.32,2.23,2.32,+0.06,2.65,56000,2,125420,0,0,0,0,0,0,50000,6000,44000,44000
20200520,710825,群聯群益9A購04,1.93,1.96,1.91,1.91,-0.05,-2.55,376000,15,727180,0,0,0,0,0,0,375000,21000,354000,354000
20200520,710826,聚積群益9A購01,1.61,1.65,1.60,1.63,+0.03,1.88,322000,9,519710,0,0,0,0,0,0,33000,322000,-289000,-289000
20200520,710827,優群群益9A購02,2.07,2.21,2.07,2.09,-0.01,-0.48,410000,9,867940,0,0,0,0,0,0,62000,348000,-286000,-286000
20200520,710828,鈊象群益9A購06,2.87,2.91,2.82,2.82,-0.06,-2.08,26000,8,74590,0,0,0,0,0,0,26000,9000,17000,17000
20200520,710829,宜鼎國票9A購01,3.49,3.77,3.49,3.77,+0.19,5.31,41000,9,149360,0,0,0,0,0,0,6000,35000,-29000,-29000
20200520,710830,網龍國票9A購01,4.93,4.93,4.72,4.72,-0.16,-3.28,13000,5,63030,0,0,0,0,0,0,10000,13000,-3000,-3000
20200520,710831,宜鼎中信9B購01,0.75,0.81,0.75,0.81,+0.04,5.19,447000,13,352060,0,0,0,0,0,0,62000,335000,-273000,-273000
20200520,710832,信驊中信9A購01,1.05,1.11,0.95,0.95,-0.07,-6.86,859000,48,921380,0,0,0,0,0,0,471000,314000,157000,157000
20200520,710833,群聯中信9C購02,0.63,0.63,0.63,0.63,-0.02,-3.08,20000,1,12600,0,0,0,0,0,0,20000,0,20000,20000
20200520,710834,中美晶凱基9A購06,2.66,2.66,2.58,2.58,-0.14,-5.15,76000,3,201490,0,0,0,0,0,0,5000,71000,-66000,-66000
20200520,710835,宏捷科凱基9A購06,1.64,1.64,1.64,1.64,-0.06,-3.53,69000,2,113160,0,0,0,0,0,0,69000,0,69000,69000
20200520,710836,是方凱基9A購01,1.08,1.13,1.08,1.13,+0.11,10.78,351000,7,388190,0,0,0,0,0,0,0,351000,-351000,-351000
20200520,710837,碩禾凱基9A購02,1.43,1.43,1.43,1.43,+0.08,5.93,50000,1,71500,0,0,0,0,0,0,50000,50000,0,0
20200520,710838,精測凱基9B購01,1.43,1.43,1.43,1.43,-0.04,-2.72,123000,2,175890,0,0,0,0,0,0,65000,58000,7000,7000
20200520,710839,網家凱基9A購02,1.83,2.07,1.83,2.07,+0.35,20.35,194000,27,381180,0,0,0,0,0,0,110000,84000,26000,26000
20200520,710840,環球晶凱基9A購05,3.31,3.32,3.31,3.31,-0.03,-0.9,6000,3,19900,0,0,0,0,0,0,6000,6000,0,0
20200520,710841,穩懋凱基9A購07,2.09,2.09,1.97,1.97,-0.19,-8.8,60000,3,121400,0,0,0,0,0,0,30000,30000,0,0
20200520,710842,鈊象凱基9B購03,0.92,0.92,0.92,0.92,-0.02,-2.13,3000,1,2760,0,0,0,0,0,0,0,3000,-3000,-3000
20200520,710843,原相麥證9A購01,,,,,,0.00,0,0,0,0,0,0,0,0,0,0,0,0,0
20200520,710844,直得永豐9A購01,1.00,1.01,1.00,1.01,+0.06,6.32,80000,4,80050,0,0,0,0,0,0,0,80000,-80000,-80000
20200520,710845,是方永豐9A購02,0.80,0.87,0.80,0.86,+0.09,11.69,544000,11,451170,0,0,0,0,0,0,0,544000,-544000,-544000
20200520,710846,群聯元大9B購02,2.98,2.98,2.93,2.93,-0.03,-1.01,114000,10,335220,0,0,0,0,0,0,114000,0,114000,114000
20200520,710847,精測元大9B購01,1.41,1.41,1.34,1.37,-0.06,-4.2,105000,11,144370,0,0,0,0,0,0,65000,76000,-11000,-11000
20200520,710848,網家元大9B購01,1.45,1.63,1.44,1.55,+0.17,12.32,1535000,68,2310670,0,0,0,0,0,0,1003000,703000,300000,300000
20200520,710849,鈊象元大9B購06,,,,,,0.00,0,0,0,0,0,0,0,0,0,0,0,0,0
20200520,710850,鈊象元大9C購02,1.22,1.22,1.19,1.19,-0.03,-2.46,107000,6,129780,0,0,0,0,0,0,35000,72000,-37000,-37000
20200520,710851,力旺永豐9B購01,1.94,2.08,1.84,1.84,+0.08,4.55,266000,20,537800,0,0,0,0,0,0,31000,175000,-144000,-144000
20200520,710852,宇峻永豐9B購02,0.70,0.70,0.70,0.70,-0.03,-4.11,21000,1,14700,0,0,0,0,0,0,0,21000,-21000,-21000
20200520,710853,建榮永豐9B購03,1.62,1.62,1.62,1.62,+0.06,3.85,16000,1,25920,0,0,0,0,0,0,0,16000,-16000,-16000
20200520,710854,神盾永豐9C購01,1.07,1.07,1.01,1.03,+0.02,1.98,39000,4,40170,0,0,0,0,0,0,39000,4000,35000,35000
20200520,710855,神準永豐9B購01,0.66,0.68,0.66,0.68,+0.01,1.49,315000,4,210020,0,0,0,0,0,0,115000,200000,-85000,-85000
20200520,710856,廣明永豐9B購01,0.84,0.84,0.81,0.81,-0.10,-10.99,174000,7,143760,0,0,0,0,0,0,106000,68000,38000,38000
20200520,710857,優群永豐9B購01,0.70,0.72,0.70,0.72,+0.07,10.77,21000,2,14840,0,0,0,0,0,0,0,21000,-21000,-21000
20200520,710858,聯亞永豐9B購01,0.73,0.73,0.72,0.73,-0.03,-3.95,206000,6,149660,0,0,0,0,0,0,0,206000,-206000,-206000
20200520,710859,威剛國票9B購01,,,,,,0.00,0,0,0,0,0,0,0,0,0,0,0,0,0
20200520,710860,原相國票9C購02,2.28,2.31,2.28,2.31,-0.07,-2.94,60000,3,137820,0,0,0,0,0,0,34000,26000,8000,8000
20200520,710861,網家國票9B購01,2.66,2.86,2.63,2.86,+0.58,25.44,53000,6,146350,0,0,0,0,0,0,30000,23000,7000,7000
20200520,710862,雙鴻國票9B購01,1.50,1.50,1.49,1.50,0.00,0.0,40000,3,59990,0,0,0,0,0,0,2000,40000,-38000,-38000
20200520,710863,神盾麥證9C購01,0.72,0.72,0.68,0.68,-0.05,-6.85,229000,8,158750,175000,54000,121000,0,0,0,175000,54000,121000,121000
20200520,710864,群聯麥證9B購02,1.47,1.47,1.42,1.42,-0.03,-2.07,14000,3,20420,11000,3000,8000,0,0,0,11000,3000,8000,8000
20200520,710865,大江凱基9C購01,1.60,1.60,1.60,1.60,-0.03,-1.84,10000,1,16000,0,0,0,0,0,0,10000,0,10000,10000
20200520,710866,信昌電凱基9B購01,1.06,1.06,1.06,1.06,+0.02,1.92,40000,1,42400,0,0,0,0,0,0,40000,0,40000,40000
20200520,710867,原相凱基9B購03,,,,,,0.00,0,0,0,0,0,0,0,0,0,0,0,0,0
20200520,710868,群聯凱基9B購05,2.36,2.36,2.36,2.36,0.00,0.0,21000,1,49560,0,0,0,0,0,0,21000,0,21000,21000
20200520,710869,璟德凱基9B購01,0.87,0.88,0.87,0.88,0.00,0.0,78000,2,68160,0,0,0,0,0,0,48000,30000,18000,18000
20200520,710870,大學光群益9B購01,4.99,6.25,4.99,6.25,+1.05,20.19,299000,18,1644000,0,0,0,0,0,0,40000,259000,-219000,-219000
20200520,710871,中美晶群益9B購02,2.82,2.82,2.82,2.82,-0.05,-1.74,18000,1,50760,0,0,0,0,0,0,18000,0,18000,18000
20200520,710872,是方群益9B購01,1.26,1.34,1.26,1.34,+0.14,11.67,353000,11,457520,0,0,0,0,0,0,0,353000,-353000,-353000
20200520,710873,原相群益9B購02,1.33,1.33,1.31,1.33,-0.06,-4.32,190000,8,252200,0,0,0,0,0,0,179000,48000,131000,131000
20200520,710874,神盾群益9C購01,1.39,1.40,1.27,1.27,-0.07,-5.22,1876000,68,2521860,0,0,0,0,0,0,1686000,349000,1337000,1337000
20200520,710875,環球晶群益9B購01,1.87,1.87,1.82,1.82,-0.07,-3.7,36000,4,66470,0,0,0,0,0,0,1000,36000,-35000,-35000
20200520,710876,環球晶群益9B購02,,,,,,0.00,0,0,0,0,0,0,0,0,0,0,0,0,0
20200520,710877,聯亞群益9B購01,2.19,2.24,2.17,2.24,+0.04,1.82,40000,3,87800,0,0,0,0,0,0,25000,25000,0,0
20200520,710878,晟德群益9B購01,2.03,2.34,2.02,2.25,+0.18,8.7,1012000,44,2227670,0,0,0,0,0,0,163000,849000,-686000,-686000
20200520,710879,神盾國泰01購01,1.67,1.70,1.54,1.54,-0.09,-5.52,1606000,96,2596270,0,0,0,0,0,0,1222000,441000,781000,781000
20200520,710880,信昌電群益9B購01,2.11,2.15,2.02,2.02,0.00,0.0,131000,15,270650,0,0,0,0,0,0,119000,64000,55000,55000
20200520,710881,原相群益9B購03,1.33,1.33,1.30,1.30,-0.11,-7.8,140000,2,184580,0,0,0,0,0,0,140000,0,140000,140000
20200520,710882,泰博群益9B購02,2.15,2.50,2.11,2.36,+0.32,15.69,200000,36,459100,0,0,0,0,0,0,0,187000,-187000,-187000
20200520,710883,群聯群益9B購01,2.31,2.33,2.26,2.29,-0.09,-3.78,695000,25,1602560,0,0,0,0,0,0,635000,61000,574000,574000
20200520,710884,精測群益9B購01,2.01,2.09,2.01,2.03,-0.11,-5.14,320000,9,647640,0,0,0,0,0,0,214000,106000,108000,108000
20200520,710885,譜瑞群益9B購01,2.19,2.25,2.08,2.08,-0.07,-3.26,179000,18,390690,0,0,0,0,0,0,120000,49000,71000,71000
20200520,710886,六角凱基9B購01,1.01,1.01,1.01,1.01,0.00,0.0,50000,1,50500,0,0,0,0,0,0,50000,0,50000,50000
20200520,710887,建榮凱基9B購02,1.40,1.40,1.40,1.40,+0.05,3.7,10000,1,14000,0,0,0,0,0,0,0,10000,-10000,-10000
20200520,710888,網家凱基9B購01,1.16,1.30,1.14,1.30,+0.20,18.18,668000,66,813330,0,0,0,0,0,0,461000,310000,151000,151000
20200520,710889,廣明凱基9B購01,0.49,0.52,0.49,0.52,-0.03,-5.45,64000,3,31980,0,0,0,0,0,0,60000,4000,56000,56000
20200520,710890,聯亞統一9C購01,0.69,0.69,0.69,0.69,0.00,0.0,10000,1,6900,0,0,0,0,0,0,0,10000,-10000,-10000
20200520,710891,穩懋統一9C購03,1.22,1.23,1.22,1.22,-0.05,-3.94,55000,3,67350,0,0,0,0,0,0,5000,50000,-45000,-45000
20200520,710892,大江國票9B購01,4.82,4.92,4.82,4.92,+0.05,1.03,13000,2,63860,0,0,0,0,0,0,13000,13000,0,0
20200520,710893,宇峻國票9B購02,0.72,0.73,0.70,0.73,0.00,0.0,41000,4,29290,0,0,0,0,0,0,20000,21000,-1000,-1000
20200520,710894,是方國票9B購01,2.65,2.94,2.65,2.90,+0.29,11.11,81000,6,229020,0,0,0,0,0,0,15000,66000,-51000,-51000
20200520,710895,群聯國票9B購01,5.85,5.95,5.75,5.95,0.00,0.0,9000,9,52800,0,0,0,0,0,0,9000,9000,0,0
20200520,710896,聯亞國票9B購01,,,,,,0.00,0,0,0,0,0,0,0,0,0,0,0,0,0
20200520,710897,雙美國票9B購02,,,,,,0.00,0,0,0,0,0,0,0,0,0,0,0,0,0
20200520,710898,鈊象國票9B購03,2.95,3.03,2.92,2.92,-0.07,-2.34,6000,6,17880,0,0,0,0,0,0,6000,6000,0,0
20200520,710899,凡甲元大9B購02,2.41,2.41,2.28,2.32,-0.22,-8.66,96000,5,225880,0,0,0,0,0,0,45000,51000,-6000,-6000
20200520,710900,威剛元大9C購01,1.34,1.34,1.29,1.31,-0.02,-1.5,247000,15,325370,0,0,0,0,0,0,247000,0,247000,247000
20200520,710901,是方元大9B購01,2.34,2.57,2.34,2.56,+0.26,11.3,399000,21,983520,0,0,0,0,0,0,103000,396000,-293000,-293000
20200520,710902,群聯元大9B購03,2.99,2.99,2.89,2.89,-0.10,-3.34,179000,7,533870,0,0,0,0,0,0,179000,3000,176000,176000
20200520,710903,雍智元大9C購01,2.83,3.08,2.75,2.93,+0.34,13.13,620000,52,1782210,0,0,0,0,0,0,239000,364000,-125000,-125000
20200520,710904,璟德元大9B購01,2.44,2.44,2.40,2.40,0.00,0.0,31000,3,75200,0,0,0,0,0,0,20000,11000,9000,9000
20200520,710905,璟德元大9B購02,1.74,1.75,1.71,1.73,-0.01,-0.57,179000,11,309290,0,0,0,0,0,0,70000,139000,-69000,-69000
20200520,710906,聯亞元大9B購01,2.19,2.22,2.16,2.16,-0.04,-1.82,81000,4,177550,0,0,0,0,0,0,20000,61000,-41000,-41000
20200520,710907,聯亞元大9B購02,1.62,1.65,1.60,1.64,+0.02,1.23,233000,9,377990,0,0,0,0,0,0,112000,121000,-9000,-9000
20200520,710908,力旺中信9B購01,1.81,1.95,1.70,1.71,0.00,0.0,706000,102,1291930,0,0,0,0,0,0,384000,317000,67000,67000
20200520,710909,宜鼎永豐9B購01,0.94,0.94,0.94,0.94,+0.06,6.82,10000,1,9400,0,0,0,0,0,0,0,10000,-10000,-10000
20200520,710910,金可永豐9B購01,,,,,,0.00,0,0,0,0,0,0,0,0,0,0,0,0,0
20200520,710911,建榮永豐9B購04,1.02,1.02,1.02,1.02,+0.02,2.0,25000,1,25500,0,0,0,0,0,0,0,25000,-25000,-25000
20200520,710912,穩懋永豐9B購01,,,,,,0.00,0,0,0,0,0,0,0,0,0,0,0,0,0
20200520,710913,雙鴻國泰01購01,1.52,1.52,1.50,1.51,-0.01,-0.66,152000,6,230970,0,0,0,0,0,0,54000,102000,-48000,-48000
20200520,710914,原相元大01購01,1.17,1.17,1.12,1.12,-0.05,-4.27,116000,6,130350,0,0,0,0,0,0,116000,3000,113000,113000
20200520,710915,精測元大9B購02,2.57,2.57,2.40,2.44,-0.13,-5.06,139000,12,349370,0,0,0,0,0,0,111000,85000,26000,26000
20200520,710916,鈊象元大9C購03,2.61,2.61,2.50,2.50,-0.11,-4.21,10000,3,25220,0,0,0,0,0,0,10000,10000,0,0
20200520,710917,碩禾台新9C購01,1.07,1.07,1.07,1.07,+0.03,2.88,76000,1,81320,0,0,0,0,0,0,76000,76000,0,0
20200520,710918,威剛國票9B購02,4.81,4.81,4.81,4.81,-0.09,-1.84,18000,1,86580,0,0,0,0,0,0,18000,0,18000,18000
20200520,710919,網家國票9B購02,8.50,9.90,8.50,9.90,+1.95,24.53,108000,14,992800,0,0,0,0,0,0,56000,52000,4000,4000
20200520,710920,網龍國票9B購01,1.73,1.73,1.73,1.73,-0.03,-1.7,1000,1,1730,0,0,0,0,0,0,1000,1000,0,0
20200520,710921,雙鴻國票9B購02,1.66,1.66,1.65,1.66,-0.01,-0.6,156000,3,257760,0,0,0,0,0,0,126000,30000,96000,96000
20200520,710922,聯亞中信01購01,,,,,,0.00,0,0,0,0,0,0,0,0,0,0,0,0,0
20200520,710923,六角永豐9B購01,,,,,,0.00,0,0,0,0,0,0,0,0,0,0,0,0,0
20200520,710924,邦特永豐9B購01,0.92,1.07,0.92,1.04,+0.11,11.83,653000,37,663880,0,0,0,0,0,0,153000,500000,-347000,-347000
20200520,710925,金居永豐9B購01,0.93,0.93,0.93,0.93,0.00,0.0,16000,1,14880,0,0,0,0,0,0,16000,0,16000,16000
20200520,710926,新普永豐9B購01,1.02,1.02,1.01,1.01,-0.02,-1.94,32000,3,32610,0,0,0,0,0,0,32000,27000,5000,5000
20200520,710927,環球晶永豐9B購01,0.77,0.77,0.77,0.77,-0.01,-1.28,1000,1,770,0,0,0,0,0,0,1000,1000,0,0
20200520,710928,鈺太永豐9B購01,0.64,0.64,0.64,0.64,+0.02,3.23,10000,1,6400,0,0,0,0,0,0,10000,0,10000,10000
20200520,710929,神盾凱基9B購03,1.05,1.05,0.97,0.97,-0.02,-2.02,243000,27,248910,0,0,0,0,0,0,228000,15000,213000,213000
20200520,710930,群聯統一01購01,,,,,,0.00,0,0,0,0,0,0,0,0,0,0,0,0,0
20200520,710931,廣明統一9B購01,0.66,0.66,0.65,0.66,-0.05,-7.04,706000,14,463290,0,0,0,0,0,0,506000,200000,306000,306000
20200520,710932,群聯富邦9B購02,0.46,0.46,0.45,0.46,0.00,0.0,317000,5,143030,0,0,0,0,0,0,289000,237000,52000,52000
20200520,710933,泰博群益9B購03,7.95,7.95,7.95,7.95,+0.70,9.66,1000,1,7950,0,0,0,0,0,0,0,0,0,0
20200520,710934,神盾群益9B購03,1.72,1.72,1.57,1.58,-0.09,-5.39,1645000,88,2739940,0,0,0,0,0,0,1570000,160000,1410000,1410000
20200520,710935,聯亞群益9B購02,2.19,2.19,2.15,2.15,-0.04,-1.83,108000,3,234440,0,0,0,0,0,0,10000,98000,-88000,-88000
20200520,710936,鈊象群益9B購01,3.00,3.00,2.87,2.92,-0.06,-2.01,20000,7,58390,0,0,0,0,0,0,5000,20000,-15000,-15000
20200520,710937,精測台新9B購01,0.82,0.82,0.78,0.78,-0.04,-4.88,128000,6,103840,0,0,0,0,0,0,56000,72000,-16000,-16000
20200520,710938,環球晶國泰9C購01,1.81,1.81,1.71,1.72,-0.08,-4.44,112000,15,195950,0,0,0,0,0,0,60000,54000,6000,6000
20200520,710939,合晶群益9B購01,2.04,2.10,2.04,2.08,+0.14,7.22,587000,12,1208060,10000,0,10000,0,0,0,40000,557000,-517000,-507000
20200520,710940,原相群益9B購04,0.64,0.65,0.63,0.64,-0.04,-5.88,402000,8,253830,0,0,0,0,0,0,296000,106000,190000,190000
20200520,710941,博智群益9B購01,2.56,2.56,2.42,2.54,-0.14,-5.22,108000,5,273240,0,0,0,0,0,0,50000,58000,-8000,-8000
20200520,710942,網家群益9B購01,2.11,2.40,2.11,2.40,+0.50,26.32,133000,19,289810,0,0,0,0,0,0,86000,0,86000,86000
20200520,710943,六角元大9B購01,1.36,1.37,1.25,1.25,-0.08,-6.02,206000,11,274000,0,0,0,0,0,0,98000,108000,-10000,-10000
20200520,710944,宏捷科元大9B購04,,,,,,0.00,0,0,0,0,0,0,0,0,0,0,0,0,0
20200520,710945,博智元大9B購02,1.81,1.81,1.69,1.71,-0.11,-6.04,155000,9,270190,0,0,0,0,0,0,30000,125000,-95000,-95000
20200520,710946,群聯元大9B購04,2.45,2.45,2.36,2.40,-0.01,-0.41,141000,17,339770,0,0,0,0,0,0,131000,45000,86000,86000
20200520,710947,網龍元大9B購01,3.62,3.77,3.49,3.49,-0.11,-3.06,54000,10,195450,0,0,0,0,0,0,45000,19000,26000,26000
20200520,710948,穩懋元大9B購01,2.51,2.51,2.39,2.41,-0.21,-8.02,93000,13,225110,0,0,0,0,0,0,70000,85000,-15000,-15000
20200520,710949,金居中信9C購02,0.68,0.69,0.67,0.67,-0.05,-6.94,182000,13,123580,0,0,0,0,0,0,34000,148000,-114000,-114000
20200520,710950,譜瑞中信03購01,1.57,1.57,1.54,1.54,-0.03,-1.91,20000,3,30830,0,0,0,0,0,0,19000,0,19000,19000
20200520,710951,譜瑞中信05購01,1.48,1.48,1.48,1.48,-0.04,-2.63,20000,2,29600,0,0,0,0,0,0,10000,10000,0,0
20200520,710952,台燿永豐9B購01,0.69,0.70,0.69,0.69,0.00,0.0,59000,11,40730,0,0,0,0,0,0,37000,22000,15000,15000
20200520,710953,欣銓永豐9B購01,0.89,0.89,0.87,0.87,-0.02,-2.25,83000,3,73420,0,0,0,0,0,0,78000,5000,73000,73000
20200520,710954,博智永豐9B購01,0.75,0.75,0.75,0.75,0.00,0.0,5000,1,3750,0,0,0,0,0,0,0,5000,-5000,-5000
20200520,710955,譜瑞永豐9B購01,1.55,1.59,1.40,1.44,-0.06,-4.0,627000,29,958470,0,0,0,0,0,0,446000,171000,275000,275000
20200520,710956,大江凱基9B購02,1.76,1.77,1.76,1.76,+0.03,1.73,122000,3,215340,0,0,0,0,0,0,60000,62000,-2000,-2000
20200520,710957,泰博凱基9B購02,4.89,5.65,4.79,5.20,+0.65,14.29,266000,17,1325170,0,0,0,0,0,0,161000,100000,61000,61000
20200520,710958,博智凱基9B購02,0.89,0.89,0.87,0.88,-0.03,-3.3,111000,4,96660,0,0,0,0,0,0,102000,9000,93000,93000
20200520,710959,神盾統一9C購01,0.92,0.92,0.86,0.87,-0.03,-3.33,640000,15,563500,0,0,0,0,0,0,560000,80000,480000,480000
20200520,710960,群聯統一9B購02,1.24,1.25,1.20,1.21,-0.06,-4.72,413000,6,499620,0,0,0,0,0,0,365000,249000,116000,116000
20200520,710961,環球晶統一01購01,0.76,0.76,0.75,0.75,-0.04,-5.06,24000,3,18120,0,0,0,0,0,0,22000,2000,20000,20000
20200520,710962,環球晶統一9B購01,,,,,,0.00,0,0,0,0,0,0,0,0,0,0,0,0,0
20200520,710963,環球晶統一9B購02,,,,,,0.00,0,0,0,0,0,0,0,0,0,0,0,0,0
20200520,710964,環球晶統一9C購02,,,,,,0.00,0,0,0,0,0,0,0,0,0,0,0,0,0
20200520,710965,頎邦統一9C購01,1.27,1.27,1.25,1.25,-0.04,-3.1,299000,6,377680,0,0,0,0,0,0,201000,98000,103000,103000
20200520,710966,弘塑國票9B購01,2.58,2.58,2.58,2.58,-0.05,-1.9,90000,1,232200,0,0,0,0,0,0,90000,0,90000,90000
20200520,710967,宜鼎國票9B購01,2.69,2.84,2.69,2.84,+0.15,5.58,254000,10,714780,0,0,0,0,0,0,13000,241000,-228000,-228000
20200520,710968,環球晶國票9C購01,1.46,1.46,1.45,1.45,-0.03,-2.03,38000,3,55300,0,0,0,0,0,0,28000,10000,18000,18000
20200520,710969,雙鴻國票9B購03,1.75,1.75,1.75,1.75,+0.05,2.94,1000,1,1750,0,0,0,0,0,0,1000,1000,0,0
20200520,710970,元太元大9B購01,3.80,4.63,3.72,4.63,+0.84,22.16,632000,78,2562140,0,0,0,0,0,0,268000,465000,-197000,-197000
20200520,710971,弘塑元大9C購01,1.18,1.21,1.18,1.21,0.00,0.0,288000,8,343070,0,0,0,0,0,0,120000,285000,-165000,-165000
20200520,710972,金可元大9B購01,1.99,1.99,1.97,1.97,-0.05,-2.48,70000,3,138100,0,0,0,0,0,0,50000,20000,30000,30000
20200520,710973,金居元大9B購01,2.46,2.52,2.40,2.40,-0.18,-6.98,191000,15,471680,0,0,0,0,0,0,103000,89000,14000,14000
20200520,710974,南光元大9B購01,1.74,1.77,1.74,1.77,+0.06,3.51,100000,2,175500,0,0,0,0,0,0,0,100000,-100000,-100000
20200520,710975,威剛元大9B購04,2.38,2.38,2.29,2.33,-0.03,-1.27,350000,14,816200,0,0,0,0,0,0,350000,0,350000,350000
20200520,710976,原相元大01購02,2.75,2.75,2.70,2.70,-0.11,-3.91,54000,6,146900,0,0,0,0,0,0,54000,4000,50000,50000
20200520,710977,泰博元大01購01,7.20,7.90,7.15,7.80,+0.85,12.23,91000,13,693300,0,0,0,0,0,0,0,89000,-89000,-89000
20200520,710978,群聯元大9B購05,2.86,2.86,2.80,2.80,-0.03,-1.06,108000,4,307300,0,0,0,0,0,0,88000,20000,68000,68000
20200520,710979,精測元大9B購03,1.79,1.79,1.69,1.69,-0.10,-5.59,156000,13,268970,0,0,0,0,0,0,146000,27000,119000,119000
20200520,710980,網家元大9B購02,2.55,2.83,2.52,2.77,+0.38,15.9,446000,38,1183420,0,0,0,0,0,0,249000,236000,13000,13000
20200520,710981,璟德元大9B購03,2.50,2.50,2.42,2.43,-0.03,-1.22,80000,3,194950,0,0,0,0,0,0,15000,65000,-50000,-50000
20200520,710982,聯亞元大9B購03,1.28,1.28,1.23,1.24,-0.05,-3.88,75000,3,95690,0,0,0,0,0,0,0,75000,-75000,-75000
20200520,710983,雙鴻元大9C購04,,,,,,0.00,0,0,0,0,0,0,0,0,0,0,0,0,0
20200520,710984,鈊象元大9C購04,1.58,1.60,1.53,1.53,-0.04,-2.55,271000,11,424480,0,0,0,0,0,0,112000,159000,-47000,-47000
20200520,710985,鈺太元大9C購01,1.22,1.22,1.17,1.18,+0.04,3.51,90000,25,108480,0,0,0,0,0,0,70000,50000,20000,20000
20200520,710986,頎邦元大9B購01,3.03,3.03,3.03,3.03,-0.10,-3.19,4000,1,12120,0,0,0,0,0,0,4000,0,4000,4000
20200520,710987,頎邦元大9B購02,2.47,2.47,2.47,2.47,-0.02,-0.8,122000,5,301340,0,0,0,0,0,0,122000,0,122000,122000
20200520,710988,群聯中信01購01,0.56,0.56,0.54,0.54,-0.01,-1.82,25000,2,13900,0,0,0,0,0,0,25000,25000,0,0
20200520,710989,環球晶中信9C購02,,,,,,0.00,0,0,0,0,0,0,0,0,0,0,0,0,0
20200520,710990,頎邦中信01購01,0.58,0.58,0.58,0.58,-0.02,-3.33,66000,2,38280,0,0,0,0,0,0,60000,6000,54000,54000
20200520,710991,大江永豐9B購01,,,,,,0.00,0,0,0,0,0,0,0,0,0,0,0,0,0
20200520,710992,旺矽永豐9B購01,1.24,1.37,1.21,1.35,+0.11,8.87,739000,29,951360,0,0,0,0,0,0,75000,664000,-589000,-589000
20200520,710993,雍智永豐9B購01,1.12,1.21,1.04,1.12,+0.13,13.13,356000,41,393340,0,0,0,0,0,0,115000,239000,-124000,-124000
20200520,710994,環球晶麥證9B購01,,,,,,0.00,0,0,0,0,0,0,0,0,0,0,0,0,0
20200520,710995,群聯統一01購02,0.79,0.80,0.79,0.80,0.00,0.0,9000,3,7180,0,0,0,0,0,0,0,9000,-9000,-9000
20200520,710996,網家統一01購01,0.90,1.02,0.90,0.98,+0.11,12.64,1823000,81,1742770,0,0,0,0,0,0,1217000,593000,624000,624000
20200520,710997,穩懋統一9B購05,,,,,,0.00,0,0,0,0,0,0,0,0,0,0,0,0,0
20200520,710998,大江國泰01購01,1.51,1.51,1.42,1.44,-0.04,-2.7,84000,11,122750,0,0,0,0,0,0,22000,62000,-40000,-40000
20200520,710999,聯亞國泰01購01,1.20,1.21,1.14,1.17,-0.07,-5.65,255000,13,301780,0,0,0,0,0,0,163000,201000,-38000,-38000
20200520,711000,雙美國泰01購01,1.34,1.38,1.30,1.32,0.00,0.0,608000,9,822770,0,0,0,0,0,0,318000,328000,-10000,-10000
20200520,711001,環球晶富邦01購01,,,,,,0.00,0,0,0,0,0,0,0,0,0,0,0,0,0
20200520,711002,宏捷科群益9B購01,1.53,1.53,1.52,1.52,-0.08,-5.0,46000,4,70120,0,0,0,0,0,0,26000,20000,6000,6000
20200520,711003,環球晶群益9B購04,2.63,2.63,2.62,2.62,-0.02,-0.76,8000,2,21030,0,0,0,0,0,0,8000,8000,0,0
20200520,711004,大江元大9B購01,,,,,,0.00,0,0,0,0,0,0,0,0,0,0,0,0,0
20200520,711005,欣銓元大9B購01,1.99,2.04,1.93,1.96,-0.05,-2.49,399000,19,789940,0,0,0,0,0,0,344000,79000,265000,265000
20200520,711006,金居元大9B購02,2.25,2.28,2.23,2.23,-0.13,-5.51,150000,10,339050,0,0,0,0,0,0,90000,60000,30000,30000
20200520,711007,建榮元大9B購02,,,,,,0.00,0,0,0,0,0,0,0,0,0,0,0,0,0
20200520,711008,雙美元大9C購02,1.64,1.72,1.62,1.62,-0.01,-0.61,563000,10,948990,0,0,0,0,0,0,342000,223000,119000,119000
20200520,711009,鈺太元大9B購02,2.88,2.88,2.81,2.86,+0.11,4.0,150000,4,431190,0,0,0,0,0,0,149000,70000,79000,79000
20200520,711010,大江國票9B購02,5.15,5.15,5.15,5.15,-0.05,-0.96,3000,1,15450,0,0,0,0,0,0,0,3000,-3000,-3000
20200520,711011,神盾國票9C購02,2.19,2.19,2.05,2.05,-0.12,-5.53,180000,7,379360,0,0,0,0,0,0,60000,120000,-60000,-60000
20200520,711012,群聯國票9B購02,2.73,2.73,2.67,2.67,-0.07,-2.55,24000,3,65400,0,0,0,0,0,0,24000,2000,22000,22000
20200520,711013,環球晶國票9B購01,,,,,,0.00,0,0,0,0,0,0,0,0,0,0,0,0,0
20200520,711014,久元永豐9B購01,1.31,1.46,1.26,1.46,+0.20,15.87,511000,19,690100,0,0,0,0,0,0,122000,384000,-262000,-262000
20200520,711015,大學光永豐9B購01,2.44,3.02,2.44,3.02,+0.55,22.27,199000,16,557250,0,0,0,0,0,0,24000,175000,-151000,-151000
20200520,711016,直得永豐9B購01,,,,,,0.00,0,0,0,0,0,0,0,0,0,0,0,0,0
20200520,711017,南光永豐9B購01,0.74,0.74,0.74,0.74,-0.01,-1.33,49000,1,36260,0,0,0,0,0,0,0,49000,-49000,-49000
20200520,711018,泰博永豐9B購01,2.68,2.68,2.00,2.33,+0.35,17.68,1003000,105,2213030,0,0,0,0,0,0,205000,599000,-394000,-394000
20200520,711019,磐亞永豐9B購01,0.49,0.49,0.49,0.49,-0.03,-5.77,20000,1,9800,0,0,0,0,0,0,20000,0,20000,20000
20200520,711020,雙美永豐9B購01,,,,,,0.00,0,0,0,0,0,0,0,0,0,0,0,0,0
20200520,711021,力旺群益9B購01,2.82,2.92,2.52,2.52,+0.03,1.2,283000,16,784320,0,0,0,0,0,0,135000,236000,-101000,-101000
20200520,711022,大江群益9B購01,1.99,2.02,1.92,1.92,-0.06,-3.03,304000,5,606150,0,0,0,0,0,0,223000,81000,142000,142000
20200520,711023,宇峻群益9B購02,0.56,0.56,0.56,0.56,0.00,0.0,5000,1,2800,0,0,0,0,0,0,5000,0,5000,5000
20200520,711024,建榮群益9C購01,1.01,1.02,1.01,1.02,+0.05,5.15,81000,2,82410,0,0,0,0,0,0,0,81000,-81000,-81000
20200520,711025,原相群益9B購05,1.61,1.61,1.60,1.60,-0.08,-4.76,82000,2,131920,0,0,0,0,0,0,72000,10000,62000,62000
20200520,711026,群聯群益9B購02,2.53,2.55,2.48,2.48,-0.04,-1.59,88000,9,221570,0,0,0,0,0,0,78000,45000,33000,33000
20200520,711027,精測群益9B購02,2.20,2.22,2.19,2.19,-0.14,-6.01,54000,10,118630,0,0,0,0,0,0,54000,0,54000,54000
20200520,711028,網家群益9B購02,1.74,1.93,1.74,1.81,+0.35,23.97,282000,15,501060,0,0,0,0,0,0,0,282000,-282000,-282000
20200520,711029,網龍群益9B購01,2.47,2.47,2.41,2.42,-0.16,-6.2,26000,3,63360,0,0,0,0,0,0,6000,20000,-14000,-14000
20200520,711030,環球晶群益9B購05,1.76,1.76,1.67,1.67,-0.10,-5.65,28000,5,47570,0,0,0,0,0,0,26000,8000,18000,18000
20200520,711031,頎邦群益9C購01,1.70,1.70,1.70,1.70,-0.05,-2.86,10000,1,17000,0,0,0,0,0,0,10000,0,10000,10000
20200520,711032,博智群益9B購02,1.66,1.66,1.51,1.63,0.00,0.0,198000,10,312090,0,0,0,0,0,0,85000,113000,-28000,-28000
20200520,711033,大江凱基9C購02,1.22,1.22,1.17,1.17,-0.03,-2.5,82000,2,99340,0,0,0,0,0,0,14000,68000,-54000,-54000
20200520,711034,元太凱基9B購01,1.89,2.34,1.83,2.34,+0.46,24.47,1578000,106,3217100,0,0,0,0,0,0,378000,1253000,-875000,-875000
20200520,711035,欣銓凱基9B購01,1.26,1.29,1.19,1.22,-0.03,-2.4,354000,26,439250,0,0,0,0,0,0,233000,60000,173000,173000
20200520,711036,金居凱基9B購01,1.05,1.05,1.02,1.02,-0.06,-5.56,121000,4,125750,0,0,0,0,0,0,111000,10000,101000,101000
20200520,711037,威剛凱基9B購03,1.05,1.05,1.02,1.02,-0.04,-3.77,220000,5,225670,0,0,0,0,0,0,210000,10000,200000,200000
20200520,711038,新鉅科凱基9B購01,0.94,0.99,0.94,0.99,+0.03,3.12,141000,5,136990,0,0,0,0,0,0,52000,89000,-37000,-37000
20200520,711039,中美晶統一9B購03,,,,,,0.00,0,0,0,0,0,0,0,0,0,0,0,0,0
20200520,711040,穩懋統一9B購06,,,,,,0.00,0,0,0,0,0,0,0,0,0,0,0,0,0
20200520,711041,頎邦統一9B購01,0.97,0.97,0.97,0.97,-0.02,-2.02,191000,3,185270,0,0,0,0,0,0,191000,0,191000,191000
20200520,711042,弘塑麥證9B購01,1.00,1.00,1.00,1.00,-0.02,-1.96,293000,6,293000,50000,243000,-193000,0,0,0,50000,243000,-193000,-193000
20200520,711043,鈊象麥證9B購01,1.63,1.63,1.58,1.58,-0.04,-2.47,48000,4,77440,10000,38000,-28000,0,0,0,10000,38000,-28000,-28000
20200520,711044,久元元大9B購01,2.38,2.56,2.16,2.51,+0.29,13.06,1243000,107,2932570,0,0,0,0,0,0,536000,781000,-245000,-245000
20200520,711045,大江元大9C購01,2.93,2.96,2.81,2.81,-0.09,-3.1,223000,11,652490,0,0,0,0,0,0,182000,90000,92000,92000
20200520,711046,金居元大9B購03,1.84,1.89,1.83,1.89,-0.03,-1.56,56000,3,103040,0,0,0,0,0,0,5000,51000,-46000,-46000
20200520,711047,建榮元大9B購03,,,,,,0.00,0,0,0,0,0,0,0,0,0,0,0,0,0
20200520,711048,網家元大9B購03,3.05,3.42,3.01,3.30,+0.42,14.58,403000,35,1289140,25000,0,25000,0,0,0,228000,193000,35000,60000
20200520,711049,聯亞元大9B購04,1.09,1.09,1.09,1.09,-0.05,-4.39,49000,1,53410,0,0,0,0,0,0,0,49000,-49000,-49000
20200520,711050,鈊象國泰01購01,1.76,1.77,1.71,1.73,-0.02,-1.14,234000,8,403840,0,0,0,0,0,0,189000,46000,143000,143000
20200520,711051,弘塑群益9B購01,0.88,0.88,0.88,0.88,-0.02,-2.22,232000,4,204160,0,0,0,0,0,0,0,232000,-232000,-232000
20200520,711052,精測群益9B購03,1.16,1.19,1.13,1.13,-0.14,-11.02,223000,12,259370,0,0,0,0,0,0,125000,98000,27000,27000
20200520,711053,磐亞群益9B購01,0.77,0.77,0.77,0.77,-0.04,-4.94,108000,2,83160,0,0,0,0,0,0,0,108000,-108000,-108000
20200520,711054,優群群益9B購01,1.43,1.52,1.43,1.44,-0.01,-0.69,310000,4,451410,0,0,0,0,0,0,72000,238000,-166000,-166000
20200520,711055,鈺太群益9B購01,1.70,1.70,1.70,1.70,+0.07,4.29,22000,1,37400,0,0,0,0,0,0,0,22000,-22000,-22000
20200520,711056,碩禾中信03購01,,,,,,0.00,0,0,0,0,0,0,0,0,0,0,0,0,0
20200520,711057,良維永豐9B購01,0.73,0.74,0.71,0.73,-0.01,-1.35,259000,13,188250,0,0,0,0,0,0,232000,82000,150000,150000
20200520,711058,宜特永豐9B購01,0.86,0.90,0.85,0.90,+0.01,1.12,324000,8,278340,0,0,0,0,0,0,253000,71000,182000,182000
20200520,711059,建榮永豐9B購05,0.69,0.69,0.69,0.69,0.00,0.0,15000,1,10350,0,0,0,0,0,0,0,15000,-15000,-15000
20200520,711060,聚積永豐9B購01,0.77,0.78,0.77,0.78,0.00,0.0,208000,4,161400,0,0,0,0,0,0,0,208000,-208000,-208000
20200520,711061,環宇永豐9B購01,,,,,,0.00,0,0,0,0,0,0,0,0,0,0,0,0,0
20200520,711062,宏捷科凱基9C購03,2.73,2.73,2.73,2.73,-0.06,-2.15,68000,1,185640,0,0,0,0,0,0,0,68000,-68000,-68000
20200520,711063,頎邦凱基9C購01,3.05,3.07,3.02,3.02,-0.16,-5.03,175000,10,534500,0,0,0,0,0,0,125000,50000,75000,75000
20200520,711064,凡甲統一01購01,0.66,0.66,0.64,0.64,-0.04,-5.88,35000,3,22700,0,0,0,0,0,0,25000,10000,15000,15000
20200520,711065,穩懋統一9B購08,0.73,0.73,0.70,0.70,-0.08,-10.26,234000,8,168100,0,0,0,0,0,0,70000,164000,-94000,-94000
20200520,711066,大學光國票9C購01,7.05,7.85,6.90,7.75,+0.70,9.93,48000,8,358050,0,0,0,0,0,0,2000,46000,-44000,-44000
20200520,711067,宇峻國票9B購03,1.32,1.35,1.32,1.35,-0.05,-3.57,77000,4,102500,0,0,0,0,0,0,0,77000,-77000,-77000
20200520,711068,群聯國泰01購01,1.28,1.28,1.22,1.25,0.00,0.0,604000,13,747430,0,0,0,0,0,0,249000,375000,-126000,-126000
20200520,711069,台燿永豐9B購02,0.43,0.43,0.42,0.42,-0.02,-4.55,181000,2,77680,0,0,0,0,0,0,181000,0,181000,181000
20200520,711070,穩懋永豐9B購02,,,,,,0.00,0,0,0,0,0,0,0,0,0,0,0,0,0
20200520,711071,凡甲元大9C購01,1.60,1.60,1.59,1.59,-0.04,-2.45,15000,2,23950,0,0,0,0,0,0,5000,10000,-5000,-5000
20200520,711072,大江元大9C購02,1.08,1.08,1.02,1.02,-0.03,-2.86,211000,7,226270,0,0,0,0,0,0,56000,203000,-147000,-147000
20200520,711073,台燿元大9B購01,1.27,1.27,1.14,1.14,-0.12,-9.52,163000,7,196460,0,0,0,0,0,0,10000,148000,-138000,-138000
20200520,711074,台燿元大9C購01,1.77,1.77,1.67,1.67,-0.11,-6.18,100000,2,172000,0,0,0,0,0,0,0,100000,-100000,-100000
20200520,711075,宇峻元大01購01,1.11,1.11,1.09,1.10,0.00,0.0,98000,5,107480,0,0,0,0,0,0,30000,68000,-38000,-38000
20200520,711076,宏捷科元大9C購02,1.07,1.07,1.07,1.07,-0.04,-3.6,133000,3,142310,0,0,0,0,0,0,0,133000,-133000,-133000
20200520,711077,宜鼎元大9B購01,1.92,2.08,1.92,2.08,+0.14,7.22,856000,39,1744490,0,0,0,0,0,0,106000,796000,-690000,-690000
20200520,711078,泰博元大9C購02,4.20,4.48,3.95,4.37,+0.51,13.21,74000,12,304840,0,0,0,0,0,0,41000,31000,10000,10000
20200520,711079,群聯元大9B購06,1.85,1.85,1.79,1.80,-0.05,-2.7,174000,6,319480,0,0,0,0,0,0,106000,98000,8000,8000
20200520,711080,群聯元大9B購07,2.42,2.42,2.36,2.36,-0.01,-0.42,218000,21,520960,0,0,0,0,0,0,168000,50000,118000,118000
20200520,711081,雍智元大9C購02,1.82,1.99,1.77,1.84,+0.18,10.84,1978000,105,3736260,0,0,0,0,0,0,485000,1397000,-912000,-912000
20200520,711082,環球晶元大9C購01,1.76,1.76,1.75,1.75,-0.03,-1.69,11000,2,19260,0,0,0,0,0,0,11000,0,11000,11000
20200520,711083,精測富邦9C購01,0.43,0.44,0.42,0.43,-0.06,-12.24,332000,20,142660,0,0,0,0,0,0,330000,2000,328000,328000
20200520,711084,穩懋富邦01購01,0.77,0.77,0.74,0.74,-0.04,-5.13,45000,4,33900,0,0,0,0,0,0,0,45000,-45000,-45000
20200520,711085,台燿凱基9B購01,0.74,0.74,0.68,0.68,-0.03,-4.23,159000,26,114860,0,0,0,0,0,0,137000,12000,125000,125000
20200520,711086,威剛凱基01購01,0.99,0.99,0.97,0.98,0.00,0.0,230000,8,225400,0,0,0,0,0,0,210000,20000,190000,190000
20200520,711087,神盾凱基9B購04,2.59,2.62,2.37,2.37,-0.08,-3.27,235000,35,603810,0,0,0,0,0,0,195000,8000,187000,187000
20200520,711088,勝麗凱基9B購01,1.44,1.49,1.40,1.40,+0.05,3.7,214000,9,317550,0,0,0,0,0,0,9000,205000,-196000,-196000
20200520,711089,環球晶凱基9B購04,1.98,1.98,1.97,1.97,-0.02,-1.01,6000,2,11870,0,0,0,0,0,0,6000,6000,0,0
20200520,711090,網家麥證9B購01,1.54,1.74,1.54,1.70,+0.26,18.06,470000,31,794540,84000,380000,-296000,0,0,0,84000,380000,-296000,-296000
20200520,711091,弘塑統一01購01,0.78,0.78,0.77,0.77,-0.02,-2.53,180000,3,139600,0,0,0,0,0,0,0,180000,-180000,-180000
20200520,711092,金居統一9B購01,0.77,0.77,0.77,0.77,-0.01,-1.28,38000,1,29260,0,0,0,0,0,0,38000,0,38000,38000
20200520,711093,頎邦統一9C購02,1.24,1.24,1.24,1.24,-0.01,-0.8,140000,2,173600,0,0,0,0,0,0,140000,0,140000,140000
20200520,711094,信驊元大9B購01,4.28,4.32,4.24,4.24,+0.16,3.92,39000,7,166920,0,0,0,0,0,0,23000,30000,-7000,-7000
20200520,711095,精測元大9C購01,1.50,1.52,1.46,1.46,-0.08,-5.19,75000,7,112120,0,0,0,0,0,0,38000,53000,-15000,-15000
20200520,711096,網家元大9B購04,2.71,3.02,2.68,3.02,+0.46,17.97,424000,37,1205190,0,0,0,0,0,0,192000,147000,45000,45000
20200520,711097,中美晶國泰01購01,1.64,1.64,1.60,1.60,-0.03,-1.84,99000,5,160050,0,0,0,0,0,0,96000,3000,93000,93000
20200520,711098,大學光群益9B購02,2.42,3.01,2.39,3.01,+0.51,20.4,622000,49,1637540,0,0,0,0,0,0,225000,397000,-172000,-172000
20200520,711099,台燿群益9B購02,1.18,1.18,1.10,1.10,-0.22,-16.67,117000,15,137100,0,0,0,0,0,0,117000,0,117000,117000
20200520,711100,新普群益9C購01,2.12,2.12,2.01,2.03,-0.04,-1.93,115000,7,238290,0,0,0,0,0,0,82000,85000,-3000,-3000
20200520,711101,環宇群益9B購01,,,,,,0.00,0,0,0,0,0,0,0,0,0,0,0,0,0
20200520,711102,中美晶國票9B購01,,,,,,0.00,0,0,0,0,0,0,0,0,0,0,0,0,0
20200520,711103,元太國票9B購01,3.30,4.29,3.20,4.28,+0.84,24.42,418000,50,1531640,0,0,0,0,0,0,28000,390000,-362000,-362000
20200520,711104,磐亞國票9B購01,1.49,1.49,1.49,1.49,-0.01,-0.67,1000,1,1490,0,0,0,0,0,0,0,1000,-1000,-1000
20200520,711105,博智凱基9B購03,,,,,,0.00,0,0,0,0,0,0,0,0,0,0,0,0,0
20200520,711106,群聯凱基9B購06,2.72,2.73,2.66,2.66,-0.07,-2.56,25000,3,67500,0,0,0,0,0,0,15000,10000,5000,5000
20200520,711107,璟德凱基9B購02,2.35,2.40,2.35,2.40,+0.05,2.13,77000,4,182700,0,0,0,0,0,0,18000,59000,-41000,-41000
20200520,711108,鈺太凱基9C購01,,,,,,0.00,0,0,0,0,0,0,0,0,0,0,0,0,0
20200520,711109,頎邦凱基9B購01,0.83,0.84,0.83,0.84,-0.02,-2.33,50000,2,41800,0,0,0,0,0,0,50000,0,50000,50000
20200520,711110,台燿統一01購01,0.50,0.50,0.46,0.46,-0.03,-6.12,268000,32,133370,0,0,0,0,0,0,235000,13000,222000,222000
20200520,711111,群聯統一9C購01,0.71,0.71,0.70,0.70,-0.01,-1.41,8000,2,5640,0,0,0,0,0,0,4000,4000,0,0
20200520,711112,穩懋統一01購01,,,,,,0.00,0,0,0,0,0,0,0,0,0,0,0,0,0
20200520,711113,穩懋統一9C購04,0.60,0.60,0.60,0.60,-0.04,-6.25,10000,1,6000,0,0,0,0,0,0,0,10000,-10000,-10000
20200520,711114,寶雅中信9B購01,1.23,1.27,1.23,1.27,+0.03,2.42,232000,7,290480,0,0,0,0,0,0,0,232000,-232000,-232000
20200520,711115,中美晶永豐9B購01,,,,,,0.00,0,0,0,0,0,0,0,0,0,0,0,0,0
20200520,711116,台半永豐9B購01,0.73,0.73,0.73,0.73,+0.02,2.82,91000,2,66430,0,0,0,0,0,0,0,91000,-91000,-91000
20200520,711117,旺矽永豐9B購02,0.99,1.16,0.99,1.15,+0.12,11.65,728000,18,794010,0,0,0,0,0,0,110000,618000,-508000,-508000
20200520,711118,金居永豐9B購02,,,,,,0.00,0,0,0,0,0,0,0,0,0,0,0,0,0
20200520,711119,群聯永豐9B購02,0.78,0.79,0.77,0.78,-0.01,-1.27,334000,6,258340,0,0,0,0,0,0,324000,10000,314000,314000
20200520,711120,精華永豐9B購01,0.71,0.71,0.71,0.71,-0.03,-4.05,200000,1,142000,0,0,0,0,0,0,0,200000,-200000,-200000
20200520,711121,璟德永豐9B購01,,,,,,0.00,0,0,0,0,0,0,0,0,0,0,0,0,0
20200520,711122,雙美永豐9B購02,0.87,0.87,0.86,0.86,+0.02,2.38,132000,5,114600,0,0,0,0,0,0,0,132000,-132000,-132000
20200520,711123,大江元大9C購03,2.52,2.52,2.44,2.44,-0.05,-2.01,6000,2,14960,0,0,0,0,0,0,4000,2000,2000,2000
20200520,711124,原相元大9C購01,1.60,1.60,1.54,1.55,-0.05,-3.12,481000,42,751290,0,0,0,0,0,0,323000,207000,116000,116000
20200520,711125,神盾元大9C購02,1.98,2.01,1.82,1.82,-0.12,-6.19,415000,31,791660,0,0,0,0,0,0,360000,94000,266000,266000
20200520,711126,聯亞元大9B購05,1.04,1.04,1.04,1.04,-0.01,-0.95,75000,1,78000,0,0,0,0,0,0,75000,75000,0,0
20200520,711127,頎邦元大9B購03,,,,,,0.00,0,0,0,0,0,0,0,0,0,0,0,0,0
20200520,711128,金居國泰01購01,1.53,1.57,1.53,1.55,-0.04,-2.52,173000,10,268200,0,0,0,0,0,0,173000,0,173000,173000
20200520,711129,威剛國泰01購01,1.27,1.29,1.27,1.28,-0.05,-3.76,190000,3,243630,0,0,0,0,0,0,190000,0,190000,190000
20200520,711130,譜瑞國泰01購01,1.79,1.80,1.63,1.68,-0.05,-2.89,1223000,57,2145610,0,0,0,0,0,0,1143000,433000,710000,710000
20200520,711131,胡連永豐9B購01,1.01,1.02,1.01,1.02,+0.15,17.24,84000,4,85110,0,0,0,0,0,0,57000,27000,30000,30000
20200520,711132,僑威永豐9B購01,0.96,0.96,0.92,0.94,-0.02,-2.08,193000,19,181220,0,0,0,0,0,0,163000,30000,133000,133000
20200520,711133,寶雅永豐9B購01,1.14,1.22,1.14,1.22,+0.07,6.09,486000,8,558530,0,0,0,0,0,0,0,486000,-486000,-486000
20200520,711134,中美晶群益9B購03,,,,,,0.00,0,0,0,0,0,0,0,0,0,0,0,0,0
20200520,711135,元太群益9B購01,2.17,2.72,2.11,2.72,+0.48,21.43,1192000,48,2805550,0,0,0,0,0,0,61000,1189000,-1128000,-1128000
20200520,711136,威剛群益9C購01,1.20,1.20,1.15,1.18,-0.05,-4.07,218000,3,257010,0,0,0,0,0,0,218000,0,218000,218000
20200520,711137,胡連群益9B購01,1.18,1.40,1.18,1.34,+0.17,14.53,1052000,40,1390720,0,0,0,0,0,0,43000,1009000,-966000,-966000
20200520,711138,雙美群益9C購01,1.69,1.71,1.69,1.69,-0.01,-0.59,53000,4,90070,0,0,0,0,0,0,33000,32000,1000,1000
20200520,711139,中美晶凱基9B購02,,,,,,0.00,0,0,0,0,0,0,0,0,0,0,0,0,0
20200520,711140,旺矽凱基9B購01,1.19,1.29,1.13,1.29,+0.12,10.26,549000,25,666460,0,0,0,0,0,0,53000,496000,-443000,-443000
20200520,711141,胡連凱基9B購01,1.33,1.59,1.33,1.51,+0.19,14.39,1077000,55,1598150,0,0,0,0,0,0,38000,1039000,-1001000,-1001000
20200520,711142,鈊象凱基9C購01,2.51,2.51,2.51,2.51,-0.07,-2.71,3000,3,7530,0,0,0,0,0,0,3000,3000,0,0
20200520,711143,大學光統一02購01,0.93,1.12,0.93,1.09,+0.09,9.0,864000,53,890810,0,0,0,0,0,0,308000,549000,-241000,-241000
20200520,711144,寶雅統一01購01,0.90,0.95,0.90,0.93,+0.03,3.33,563000,9,519890,0,0,0,0,0,0,6000,557000,-551000,-551000
20200520,711145,環球晶國票9B購02,,,,,,0.00,0,0,0,0,0,0,0,0,0,0,0,0,0
20200520,711146,雍智群益9B購01,1.80,1.94,1.72,1.82,+0.19,11.66,468000,24,854460,0,0,0,0,0,0,189000,223000,-34000,-34000
20200520,711147,優群群益9B購02,1.25,1.33,1.25,1.33,+0.08,6.4,135000,4,174420,0,0,0,0,0,0,57000,78000,-21000,-21000
20200520,711148,凡甲國泰01購01,1.62,1.62,1.62,1.62,-0.09,-5.26,72000,3,116640,0,0,0,0,0,0,72000,0,72000,72000
20200520,711149,網龍國泰01購01,2.04,2.07,1.91,1.91,-0.05,-2.55,108000,11,218890,0,0,0,0,0,0,25000,97000,-72000,-72000
20200520,711150,環球晶國泰9B購01,2.80,2.80,2.72,2.73,-0.06,-2.15,19000,4,52300,0,0,0,0,0,0,13000,14000,-1000,-1000
20200520,711151,泰博中信01購01,0.67,0.88,0.64,0.72,+0.08,12.5,1107000,106,771320,0,0,0,0,0,0,307000,1055000,-748000,-748000
20200520,711152,大田永豐9B購01,1.20,1.25,1.14,1.25,+0.03,2.46,502000,12,587810,0,0,0,0,0,0,461000,143000,318000,318000
20200520,711153,大學光永豐9B購02,0.99,1.14,0.96,1.12,+0.19,20.43,521000,33,542990,0,0,0,0,0,0,16000,504000,-488000,-488000
20200520,711154,合晶永豐9B購01,,,,,,0.00,0,0,0,0,0,0,0,0,0,0,0,0,0
20200520,711155,泰博永豐9B購02,1.80,1.80,1.45,1.62,+0.22,15.71,624000,35,957010,0,0,0,0,0,0,56000,536000,-480000,-480000
20200520,711156,網龍永豐9B購01,1.07,1.07,1.06,1.06,-0.04,-3.64,15000,3,16000,0,0,0,0,0,0,0,15000,-15000,-15000
20200520,711157,大學光元大9C購02,1.96,2.27,1.88,2.22,+0.26,13.27,803000,48,1681220,0,0,0,0,0,0,217000,586000,-369000,-369000
20200520,711158,中美晶元大9B購02,,,,,,0.00,0,0,0,0,0,0,0,0,0,0,0,0,0
20200520,711159,中美晶元大9B購03,,,,,,0.00,0,0,0,0,0,0,0,0,0,0,0,0,0
20200520,711160,元太元大9B購02,3.08,3.84,3.07,3.82,+0.76,24.84,993000,93,3413160,0,0,0,0,0,0,187000,973000,-786000,-786000
20200520,711161,泰博元大9C購03,1.93,2.16,1.92,2.13,+0.27,14.52,260000,26,536000,0,0,0,0,0,0,26000,234000,-208000,-208000
20200520,711162,雍智元大9C購03,3.69,3.97,3.56,3.75,+0.35,10.29,428000,34,1616340,0,0,0,0,0,0,101000,327000,-226000,-226000
20200520,711163,網龍元大9B購02,1.83,1.83,1.78,1.78,-0.05,-2.73,252000,12,454860,0,0,0,0,0,0,2000,250000,-248000,-248000
20200520,711164,環球晶元大9C購02,1.57,1.57,1.57,1.57,-0.01,-0.63,1000,1,1570,0,0,0,0,0,0,1000,1000,0,0
20200520,711165,聯亞元大9C購01,1.19,1.21,1.19,1.19,-0.01,-0.83,698000,13,832280,0,0,0,0,0,0,608000,698000,-90000,-90000
20200520,711166,雙美元大9C購03,1.10,1.15,1.10,1.11,+0.01,0.91,799000,10,904140,0,0,0,0,0,0,444000,367000,77000,77000
20200520,711167,神盾麥證9C購02,,,,,,0.00,0,0,0,0,0,0,0,0,0,0,0,0,0
20200520,711168,原相凱基9B購04,1.63,1.63,1.57,1.57,-0.09,-5.42,8000,2,12980,0,0,0,0,0,0,8000,0,8000,8000
20200520,711169,精測凱基01購01,,,,,,0.00,0,0,0,0,0,0,0,0,0,0,0,0,0
20200520,711170,網家凱基9B購02,1.57,1.75,1.57,1.69,+0.19,12.67,376000,32,628640,0,0,0,0,0,0,116000,290000,-174000,-174000
20200520,711171,雙鴻凱基9B購02,1.85,1.85,1.83,1.83,-0.01,-0.54,21000,3,38450,0,0,0,0,0,0,2000,21000,-19000,-19000
20200520,711172,穩懋凱基9B購03,1.09,1.09,1.09,1.09,-0.10,-8.4,15000,1,16350,0,0,0,0,0,0,0,15000,-15000,-15000
20200520,711173,群聯統一9B購03,1.00,1.00,0.99,0.99,-0.03,-2.94,272000,4,269290,0,0,0,0,0,0,271000,1000,270000,270000
20200520,711174,寶雅統一01購02,0.95,0.99,0.95,0.98,+0.04,4.26,511000,9,496880,0,0,0,0,0,0,10000,501000,-491000,-491000
20200520,711175,寶雅統一9B購01,1.00,1.08,1.00,1.08,+0.07,6.93,753000,17,777970,0,0,0,0,0,0,20000,753000,-733000,-733000
20200520,711176,久元國票9B購01,3.19,3.65,3.19,3.59,+0.47,15.06,1017000,36,3394360,0,0,0,0,0,0,585000,508000,77000,77000
20200520,711177,大江國票9B購03,4.57,4.67,4.57,4.67,+0.05,1.08,13000,2,60610,0,0,0,0,0,0,13000,13000,0,0
20200520,711178,宇峻國票9B購04,1.03,1.04,1.03,1.04,+0.03,2.97,28000,2,28880,0,0,0,0,0,0,0,28000,-28000,-28000
20200520,711179,胡連國票9B購01,2.95,3.21,2.95,3.06,+0.40,15.04,1768000,16,5291260,0,0,0,0,0,0,0,1768000,-1768000,-1768000
20200520,711180,環球晶國票9C購02,,,,,,0.00,0,0,0,0,0,0,0,0,0,0,0,0,0
20200520,711181,譜瑞台新9B購01,1.52,1.52,1.37,1.37,-0.18,-11.61,170000,5,244120,0,0,0,0,0,0,15000,155000,-140000,-140000
20200520,711182,原相國泰9C購01,,,,,,0.00,0,0,0,0,0,0,0,0,0,0,0,0,0
20200520,711183,泰博國泰01購01,1.36,1.47,1.30,1.47,+0.17,13.08,339000,10,486850,0,0,0,0,0,0,309000,30000,279000,279000
20200520,711184,穩懋國泰9C購01,,,,,,0.00,0,0,0,0,0,0,0,0,0,0,0,0,0
20200520,711185,大學光元大9C購03,1.39,1.67,1.37,1.65,+0.21,14.58,1186000,69,1850070,0,0,0,0,0,0,243000,943000,-700000,-700000
20200520,711186,中美晶元大9B購04,2.01,2.01,2.01,2.01,-0.05,-2.43,3000,1,6030,0,0,0,0,0,0,3000,0,3000,3000
20200520,711187,環球晶元大9B購01,2.45,2.45,2.44,2.44,-0.02,-0.81,7000,2,17140,0,0,0,0,0,0,7000,7000,0,0
20200520,711188,穩懋元大9C購01,1.71,1.71,1.65,1.66,-0.13,-7.26,17000,6,28230,0,0,0,0,0,0,7000,17000,-10000,-10000
20200520,711189,久元凱基9B購01,2.32,2.63,2.21,2.50,+0.30,13.64,416000,51,1012690,0,0,0,0,0,0,81000,378000,-297000,-297000
20200520,711190,大江凱基9B購03,,,,,,0.00,0,0,0,0,0,0,0,0,0,0,0,0,0
20200520,711191,信驊凱基9B購01,,,,,,0.00,0,0,0,0,0,0,0,0,0,0,0,0,0
20200520,711192,群聯凱基9B購07,2.90,2.90,2.88,2.88,-0.05,-1.71,32000,3,92200,0,0,0,0,0,0,2000,32000,-30000,-30000
20200520,711193,碩禾凱基9B購03,,,,,,0.00,0,0,0,0,0,0,0,0,0,0,0,0,0
20200520,711194,環球晶凱基9B購05,1.12,1.12,1.12,1.12,0.00,0.0,1000,1,1120,0,0,0,0,0,0,1000,1000,0,0
20200520,711195,元太統一9B購01,0.67,0.85,0.66,0.85,+0.17,25.0,696000,29,513660,0,0,0,0,0,0,101000,595000,-494000,-494000
20200520,711196,世界統一9C購01,0.82,0.83,0.82,0.83,+0.02,2.47,103000,2,84580,0,0,0,0,0,0,0,103000,-103000,-103000
20200520,711197,精測統一9C購01,,,,,,0.00,0,0,0,0,0,0,0,0,0,0,0,0,0
20200520,711198,聯亞統一9B購01,,,,,,0.00,0,0,0,0,0,0,0,0,0,0,0,0,0
20200520,711199,元太富邦9C購01,0.98,1.21,0.96,1.21,+0.22,22.22,1394000,41,1471530,0,0,0,0,0,0,3000,1391000,-1388000,-1388000
20200520,711200,合晶富邦9C購01,0.57,0.58,0.57,0.58,+0.02,3.57,422000,6,243740,0,0,0,0,0,0,0,422000,-422000,-422000
20200520,711201,泰博群益9B購04,2.11,2.30,2.04,2.28,+0.30,15.15,560000,24,1227360,0,0,0,0,0,0,0,560000,-560000,-560000
20200520,711202,群聯群益9B購05,,,,,,0.00,0,0,0,0,0,0,0,0,0,0,0,0,0
20200520,711203,雍智群益9B購02,2.20,2.31,2.13,2.31,+0.33,16.67,370000,13,815020,0,0,0,0,0,0,181000,168000,13000,13000
20200520,711204,雙鴻群益9C購01,,,,,,0.00,0,0,0,0,0,0,0,0,0,0,0,0,0
20200520,711205,合晶兆豐9B購01,1.31,1.34,1.31,1.33,+0.04,3.1,155000,7,204440,0,0,0,0,0,0,3000,155000,-152000,-152000
20200520,711206,金可兆豐9B購01,1.27,1.27,1.26,1.26,-0.03,-2.33,62000,2,78720,0,0,0,0,0,0,0,62000,-62000,-62000
20200520,711207,群聯兆豐9C購01,0.91,0.91,0.91,0.91,-0.02,-2.15,6000,2,5460,0,0,0,0,0,0,0,6000,-6000,-6000
20200520,711208,群聯兆豐9C購02,,,,,,0.00,0,0,0,0,0,0,0,0,0,0,0,0,0
20200520,711209,譜瑞兆豐9B購01,1.76,1.78,1.61,1.61,-0.08,-4.73,19000,5,32950,0,0,0,0,0,0,3000,16000,-13000,-13000
20200520,711210,世界國票9B購01,2.03,2.03,1.92,1.92,-0.05,-2.54,26000,2,50580,0,0,0,0,0,0,0,26000,-26000,-26000
20200520,711211,是方國票9B購02,3.11,3.11,3.11,3.11,+0.25,8.74,106000,3,329660,0,0,0,0,0,0,0,106000,-106000,-106000
20200520,711212,聯亞國票9B購03,,,,,,0.00,0,0,0,0,0,0,0,0,0,0,0,0,0
20200520,711213,鈊象國票9B購04,2.39,2.39,2.32,2.32,-0.01,-0.43,3000,2,7030,0,0,0,0,0,0,1000,3000,-2000,-2000
20200520,711214,是方中信9B購01,0.72,0.72,0.72,0.72,+0.08,12.5,10000,1,7200,0,0,0,0,0,0,0,10000,-10000,-10000
20200520,711215,力旺永豐9B購02,1.80,1.83,1.63,1.66,+0.12,7.79,289000,16,488590,0,0,0,0,0,0,0,289000,-289000,-289000
20200520,711216,世界永豐9B購01,0.76,0.76,0.76,0.76,+0.02,2.7,13000,1,9880,0,0,0,0,0,0,0,13000,-13000,-13000
20200520,711217,建榮永豐9C購01,,,,,,0.00,0,0,0,0,0,0,0,0,0,0,0,0,0
20200520,711218,泰博永豐9C購01,1.13,1.15,1.13,1.15,+0.02,1.77,35000,2,40150,0,0,0,0,0,0,0,35000,-35000,-35000
20200520,711219,雍智永豐9B購02,,,,,,0.00,0,0,0,0,0,0,0,0,0,0,0,0,0
20200520,711220,信驊永豐9B購01,0.99,0.99,0.85,0.85,-0.02,-2.3,36000,8,32770,0,0,0,0,0,0,0,36000,-36000,-36000
20200520,711221,建榮永豐9B購06,,,,,,0.00,0,0,0,0,0,0,0,0,0,0,0,0,0
20200520,711222,泰博永豐9B購03,0.82,0.82,0.82,0.82,-0.01,-1.2,82000,4,67240,0,0,0,0,0,0,0,82000,-82000,-82000
20200520,711223,譜瑞永豐9B購02,,,,,,0.00,0,0,0,0,0,0,0,0,0,0,0,0,0
20200520,711224,凡甲元大9C購02,,,,,,0.00,0,0,0,0,0,0,0,0,0,0,0,0,0
20200520,711225,金居元大9B購04,,,,,,0.00,0,0,0,0,0,0,0,0,0,0,0,0,0
20200520,711226,新普元大9B購01,2.02,2.03,2.02,2.03,-0.05,-2.4,17000,3,34390,0,0,0,0,0,0,0,17000,-17000,-17000
20200520,711227,新鉅科元大9B購02,,,,,,0.00,0,0,0,0,0,0,0,0,0,0,0,0,0
20200520,711228,精測元大9C購02,1.82,1.82,1.81,1.81,-0.15,-7.65,80000,5,145200,0,0,0,0,0,0,0,80000,-80000,-80000
20200520,711229,廣明元大9B購01,1.90,1.90,1.90,1.90,-0.06,-3.06,4000,1,7600,0,0,0,0,0,0,4000,4000,0,0
20200520,711230,譜瑞元大9B購01,,,,,,0.00,0,0,0,0,0,0,0,0,0,0,0,0,0
20200520,711231,群聯統一9B購04,,,,,,0.00,0,0,0,0,0,0,0,0,0,0,0,0,0
20200520,711232,中美晶凱基9C購01,,,,,,0.00,0,0,0,0,0,0,0,0,0,0,0,0,0
20200520,711233,世界凱基9B購01,,,,,,0.00,0,0,0,0,0,0,0,0,0,0,0,0,0
20200520,711234,宏捷科凱基9C購04,,,,,,0.00,0,0,0,0,0,0,0,0,0,0,0,0,0
20200520,711235,網家凱基9C購02,,,,,,0.00,0,0,0,0,0,0,0,0,0,0,0,0,0
20200520,711236,元太國票9B購02,2.55,3.16,2.55,3.16,+2.36,295.0,50000,5,135850,40000,0,40000,0,0,0,0,50000,-50000,-10000
20200520,711237,信驊國票9B購01,2.69,2.69,2.69,2.69,+1.43,113.49,10000,1,26900,0,0,0,0,0,0,0,10000,-10000,-10000
20200520,711238,泰博國票9B購02,2.78,2.85,2.78,2.85,-0.28,-8.95,20000,2,56300,0,0,0,0,0,0,0,20000,-20000,-20000
20200520,711239,雍智國票9B購01,,,,,,0.00,0,0,0,0,0,0,0,0,0,0,0,0,0
20200520,711240,廣明國票9B購01,,,,,,0.00,0,0,0,0,0,0,0,0,0,0,0,0,0
20200520,711241,譜瑞國票9B購01,3.57,3.57,3.57,3.57,+2.33,187.9,6000,1,21420,0,0,0,0,0,0,0,6000,-6000,-6000
20200520,711242,世界群益9C購01,,,,,,0.00,0,0,0,0,0,0,0,0,0,0,0,0,0
20200520,711243,旺矽群益9B購01,1.19,1.31,1.19,1.31,+0.04,3.15,142000,12,182760,0,0,0,0,0,0,0,142000,-142000,-142000
20200520,711244,金可群益9B購01,,,,,,0.00,0,0,0,0,0,0,0,0,0,0,0,0,0
20200520,711245,大江兆豐9C購01,,,,,,0.00,0,0,0,0,0,0,0,0,0,0,0,0,0
20200520,711246,台燿兆豐9B購01,,,,,,0.00,0,0,0,0,0,0,0,0,0,0,0,0,0
20200520,711247,旺矽兆豐9B購01,1.16,1.23,1.16,1.22,+0.02,1.67,65000,9,78020,0,0,0,0,0,0,0,65000,-65000,-65000
20200520,711248,金居兆豐9B購01,,,,,,0.00,0,0,0,0,0,0,0,0,0,0,0,0,0
20200520,711249,頎邦兆豐9B購01,,,,,,0.00,0,0,0,0,0,0,0,0,0,0,0,0,0
20200520,711250,元太元富9B購01,1.60,1.88,1.60,1.88,+0.42,28.77,947000,18,1675090,0,0,0,0,0,0,0,947000,-947000,-947000
20200520,711251,金居元富9B購01,,,,,,0.00,0,0,0,0,0,0,0,0,0,0,0,0,0
20200520,711252,信驊元富9B購01,,,,,,0.00,0,0,0,0,0,0,0,0,0,0,0,0,0
20200520,711253,神盾元富9B購03,,,,,,0.00,0,0,0,0,0,0,0,0,0,0,0,0,0
20200520,711254,群聯麥證9C購01,,,,,,0.00,0,0,0,0,0,0,0,0,0,0,0,0,0
