date,sid,name,open,high,low,close,amplitude,amplitude_ratio,capacity,transaction,turnover,foreign_dealers_buy,foreign_dealers_sell,foreign_dealers_total,investment_trust_buy,investment_trust_sell,investment_trust_total,dealer_buy,dealer_sell,dealer_total,institutional_investors_total
20200430,0050,元大台灣50,84.45,85.50,84.40,85.50,+1.80,2.15,18785156,8305,1597420751,8120000,1000,8119000,0,0,0,3429000,3399000,30000,8149000
20200430,0051,元大中型100,33.09,33.51,33.09,33.51,+0.43,1.3,25086,20,836791,0,0,0,0,0,0,15000,2000,13000,13000
20200430,0052,富邦科技,64.50,64.85,64.50,64.75,+0.95,1.49,198947,56,12860519,0,0,0,0,0,0,155000,110000,45000,45000
20200430,0053,元大電子,38.63,39.00,38.63,39.00,+0.49,1.27,47042,30,1825025,0,0,0,0,0,0,17000,8000,9000,9000
20200430,0054,元大台商50,22.42,22.60,22.42,22.60,+0.29,1.3,4000,3,90170,0,0,0,0,0,0,4000,0,4000,4000
20200430,0055,元大MSCI金融,17.20,17.27,17.17,17.27,+0.36,2.13,76170,35,1310355,0,0,0,0,0,0,50000,0,50000,50000
20200430,0056,元大高股息,27.20,27.49,27.20,27.46,+0.39,1.44,35888109,13515,982193977,50000,34000,16000,0,0,0,19333000,377000,18956000,18972000
20200430,0057,富邦摩台,55.45,56.10,55.45,56.10,+1.40,2.56,72000,10,4032550,0,0,0,0,0,0,72000,71000,1000,1000
20200430,0061,元大寶滬深,17.31,17.38,17.25,17.30,+0.01,0.06,608700,227,10544659,4000,126000,-122000,0,0,0,41000,226000,-185000,-307000
20200430,006203,元大MSCI台灣,39.85,39.98,39.85,39.98,0.00,0.00,5000,5,199600,0,0,0,0,0,0,4000,0,4000,4000
20200430,006204,永豐臺灣加權,53.75,54.85,53.75,54.75,+1.45,2.72,17000,8,927100,0,0,0,0,0,0,16000,11000,5000,5000
20200430,006205,富邦上証,28.74,29.21,28.74,29.08,+0.36,1.25,1887217,295,54911882,173000,39000,134000,0,0,0,1082000,1306000,-224000,-90000
20200430,006206,元大上證50,30.50,30.77,30.37,30.50,+0.19,0.63,212647,70,6506292,15000,31000,-16000,0,0,0,61000,74000,-13000,-29000
20200430,006207,FH滬深,22.40,22.80,22.40,22.64,+0.27,1.21,493000,95,11172840,40000,8000,32000,0,0,0,188000,109000,79000,111000
20200430,006208,富邦台50,48.41,48.95,48.32,48.93,+1.03,2.15,1461250,615,71145800,2000,0,2000,0,0,0,851000,854000,-3000,-1000
20200430,00625K,富邦上証+R,6.94,6.94,6.94,6.94,+0.09,1.31,50000,2,347000,0,0,0,0,0,0,50000,50000,0,0
20200430,00631L,元大台灣50正2,43.65,44.78,43.56,44.69,+1.73,4.03,14580050,3472,643332053,187000,244000,-57000,0,0,0,5011000,3293000,1718000,1661000
20200430,00632R,元大台灣50反1,10.39,10.41,10.24,10.25,-0.22,-2.1,305482404,26455,3148319357,3020000,1924000,1096000,0,0,0,99325000,42556000,56769000,57865000
20200430,00633L,富邦上証正2,41.51,42.50,41.51,41.65,+0.52,1.26,14068651,2566,590253374,1127000,2892000,-1765000,0,0,0,4250000,2278000,1972000,207000
20200430,00634R,富邦上証反1,5.76,5.78,5.70,5.73,-0.06,-1.04,3634075,383,20795793,169000,0,169000,0,0,0,1919000,485000,1434000,1603000
20200430,00635U,元大S&P黃金,24.48,24.48,24.37,24.40,-0.06,-0.25,1105890,372,26990310,1000,17000,-16000,0,0,0,455000,16000,439000,423000
20200430,00636,國泰中國A50,20.20,20.47,20.20,20.27,+0.11,0.55,835244,276,16994432,175000,0,175000,0,0,0,178000,403000,-225000,-50000
20200430,00636K,國泰中國A50+U,6.80,6.80,6.80,6.80,+0.08,1.19,100,1,680,0,0,0,0,0,0,100,100,0,0
20200430,00637L,元大滬深300正2,16.09,16.39,16.02,16.05,+0.19,1.2,110014750,10410,1778771585,8329000,11436000,-3107000,0,0,0,39464000,29578000,9886000,6779000
20200430,00638R,元大滬深300反1,11.62,11.62,11.44,11.55,-0.11,-0.94,1520000,316,17478450,85000,88000,-3000,0,0,0,687000,195000,492000,489000
20200430,00639,富邦深100,11.04,11.20,11.04,11.15,+0.13,1.18,1625227,234,18156939,4000,8000,-4000,0,0,0,880000,1231000,-351000,-355000
20200430,00640L,富邦日本正2,16.45,16.56,16.32,16.42,-0.08,-0.48,2752000,523,45234750,0,294000,-294000,0,0,0,503000,2021000,-1518000,-1812000
20200430,00641R,富邦日本反1,15.00,15.06,14.94,15.01,+0.10,0.67,2523000,311,37820440,152000,0,152000,0,0,0,2121000,180000,1941000,2093000
20200430,00642U,元大S&P石油,8.35,8.69,8.35,8.69,+0.66,8.22,80454648,19318,683818249,72410,540000,-467590,0,0,0,2888000,3950000,-1062000,-1529590
20200430,00643,群益深証中小,13.30,13.56,13.30,13.50,+0.25,1.89,1034221,378,13955107,72000,111000,-39000,0,0,0,142000,145000,-3000,-42000
20200430,00643K,群益深証中小+R,,,,,0.00,0.00,0,0,0,0,0,0,0,0,0,0,0,0,0
20200430,00645,富邦日本,19.09,19.19,19.08,19.10,+0.08,0.42,107499,33,2056289,0,0,0,0,0,0,62000,100341,-38341,-38341
20200430,00646,元大S&P500,26.84,26.96,26.76,26.93,+0.45,1.7,1210353,525,32505393,47000,1000,46000,0,0,0,282000,216000,66000,112000
20200430,00647L,元大S&P500正2,32.33,32.80,32.22,32.70,+1.21,3.84,1959119,441,63680181,13000,19000,-6000,0,0,0,1076000,839000,237000,231000
20200430,00648R,元大S&P500反1,11.27,11.28,11.13,11.15,-0.25,-2.19,4125150,793,46205273,0,0,0,0,0,0,873000,987000,-114000,-114000
20200430,00650L,FH香港正2,22.74,22.96,22.74,22.92,+0.50,2.23,356000,92,8145820,132000,0,132000,0,0,0,51000,167000,-116000,16000
20200430,00651R,FH香港反1,8.79,8.79,8.68,8.71,-0.14,-1.58,765000,115,6673000,0,275000,-275000,0,0,0,264000,120000,144000,-131000
20200430,00652,富邦印度,17.75,18.26,17.75,18.26,+0.88,5.06,638192,279,11485301,40000,5000,35000,0,0,0,86000,155000,-69000,-34000
20200430,00653L,富邦印度正2,17.06,17.70,16.95,17.69,+1.29,7.87,9003250,1803,156148270,120000,848000,-728000,0,0,0,665000,2997000,-2332000,-3060000
20200430,00654R,富邦印度反1,15.49,15.49,15.15,15.16,-0.62,-3.93,685000,233,10487050,215000,38000,177000,0,0,0,76000,42000,34000,211000
20200430,00655L,國泰中國A50正2,30.17,31.00,30.17,30.35,+0.43,1.44,5058000,1115,154747110,27000,366000,-339000,0,0,0,2937000,1239000,1698000,1359000
20200430,00656R,國泰中國A50反1,10.51,10.54,10.40,10.49,-0.10,-0.94,624000,100,6536110,25000,118000,-93000,0,0,0,402000,63000,339000,246000
20200430,00657,國泰日經225,25.26,25.29,25.17,25.23,+0.13,0.52,137121,13,3456969,0,0,0,0,0,0,121000,136000,-15000,-15000
20200430,00657K,國泰日經225+U,8.46,8.46,8.46,8.46,+0.05,0.59,100,1,846,0,0,0,0,0,0,100,100,0,0
20200430,00660,元大歐洲50,21.14,21.40,21.13,21.35,+0.59,2.84,415000,75,8795800,0,0,0,0,0,0,202000,40000,162000,162000
20200430,00661,元大日經225,25.57,25.57,25.57,25.57,+0.12,0.47,1000,1,25570,0,0,0,0,0,0,0,1000,-1000,-1000
20200430,00662,富邦NASDAQ,34.57,34.88,34.50,34.83,+0.80,2.35,652556,230,22634860,2000,2000,0,0,0,0,116000,247000,-131000,-131000
20200430,00663L,國泰臺灣加權正2,38.90,39.97,38.90,39.90,+1.59,4.15,250000,69,9883880,0,0,0,0,0,0,143000,145000,-2000,-2000
20200430,00664R,國泰臺灣加權反1,11.80,11.82,11.65,11.66,-0.24,-2.02,10298998,1442,120753736,2000,1000,1000,0,0,0,3058000,5885000,-2827000,-2826000
20200430,00665L,富邦恒生國企正2,21.90,22.25,21.67,22.22,+0.61,2.82,144000,57,3187640,140000,0,140000,0,0,0,0,28000,-28000,112000
20200430,00666R,富邦恒生國企反1,13.20,13.20,13.20,13.20,-0.24,-1.79,6000,3,79200,0,6000,-6000,0,0,0,0,0,0,-6000
20200430,00668,國泰美國道瓊,26.59,26.78,26.54,26.75,+0.37,1.4,383507,167,10221609,0,1000,-1000,0,0,0,124000,47000,77000,76000
20200430,00668K,國泰美國道瓊+U,8.94,8.94,8.94,8.94,+0.16,1.82,100,1,894,0,0,0,0,0,0,100,100,0,0
20200430,00669R,國泰美國道瓊反1,12.23,12.25,12.10,12.11,-0.28,-2.26,17397000,2074,211835820,3595000,5000,3590000,0,0,0,5974000,1832000,4142000,7732000
20200430,00670L,富邦NASDAQ正2,42.81,43.45,42.70,43.18,+2.36,5.78,4050000,911,173854080,24000,9000,15000,0,0,0,2575000,213000,2362000,2377000
20200430,00671R,富邦NASDAQ反1,9.72,9.72,9.61,9.63,-0.33,-3.31,4425000,731,42795940,0,5000,-5000,0,0,0,1068000,1650000,-582000,-587000
20200430,00672L,元大S&P原油正2,3.00,3.00,2.80,2.95,+0.45,18.0,92829338,6931,270613124,6000,60000,-54000,0,0,0,1281000,195000,1086000,1032000
20200430,00673R,元大S&P原油反1,45.78,46.12,43.20,43.90,-3.91,-8.18,4610200,1295,205391178,0,0,0,0,0,0,2709000,1338000,1371000,1371000
20200430,00674R,元大S&P黃金反1,14.18,14.20,14.14,14.18,+0.02,0.14,868000,159,12298950,35000,0,35000,0,0,0,130000,374000,-244000,-209000
20200430,00675L,富邦臺灣加權正2,17.00,17.48,16.96,17.42,+0.68,4.06,768000,286,13267030,0,0,0,0,0,0,275000,212000,63000,63000
20200430,00676R,富邦臺灣加權反1,6.39,6.39,6.30,6.31,-0.12,-1.87,7558000,1252,47885900,10000,0,10000,0,0,0,723000,3142000,-2419000,-2409000
20200430,00677U,富邦VIX,6.62,6.64,6.46,6.48,-0.37,-5.4,238209000,24174,1560582828,16654000,13822000,2832000,0,0,0,8521000,25425000,-16904000,-14072000
20200430,00678,群益NBI生技,24.51,24.61,24.34,24.47,+0.07,0.29,324000,163,7931310,0,121000,-121000,0,0,0,12000,62000,-50000,-171000
20200430,00680L,元大美債20正2,33.90,33.97,33.86,33.97,-0.29,-0.85,251000,45,8507960,0,0,0,0,0,0,209000,189000,20000,20000
20200430,00681R,元大美債20反1,12.44,12.47,12.43,12.46,+0.08,0.65,30000,12,373740,0,0,0,0,0,0,6000,21000,-15000,-15000
20200430,00682U,元大美元指數,19.82,19.82,19.82,19.82,0.00,0.00,33000,7,654060,0,0,0,0,0,0,29000,0,29000,29000
20200430,00683L,元大美元指數正2,20.31,20.31,20.23,20.29,-0.02,-0.1,9000,6,182390,0,0,0,0,0,0,3000,5000,-2000,-2000
20200430,00684R,元大美元指數反1,17.97,17.97,17.97,17.97,-0.01,-0.06,3000,2,53910,0,0,0,0,0,0,1000,0,1000,1000
20200430,00685L,群益臺灣加權正2,14.79,15.16,14.77,15.12,+0.52,3.56,42000,32,628390,0,0,0,0,0,0,37000,4000,33000,33000
20200430,00686R,群益臺灣加權反1,6.96,6.97,6.86,6.88,-0.13,-1.85,1909000,176,13184710,0,0,0,0,0,0,901000,794000,107000,107000
20200430,00688L,國泰20年美債正2,34.45,34.45,34.42,34.44,-0.43,-1.23,103000,4,3545340,0,0,0,0,0,0,101000,102000,-1000,-1000
20200430,00689R,國泰20年美債反1,12.72,12.76,12.72,12.75,+0.07,0.55,114000,6,1453170,0,0,0,0,0,0,108000,101000,7000,7000
20200430,00690,兆豐藍籌30,21.80,22.10,21.80,22.10,+0.59,2.74,211000,44,4653230,0,0,0,0,0,0,197000,151000,46000,46000
20200430,00691R,兆豐藍籌30反1,14.09,14.09,13.96,13.96,0.00,0.00,3000,3,42070,0,0,0,0,0,0,3000,3000,0,0
20200430,00692,富邦公司治理,21.75,22.08,21.72,22.06,+0.45,2.08,3464237,1264,76108082,1000,0,1000,0,0,0,2051000,881000,1170000,1171000
20200430,00693U,街口S&P黃豆,13.98,14.14,13.95,14.10,+0.25,1.81,6428100,1272,90464663,60000,69000,-9000,0,0,0,252000,998000,-746000,-755000
20200430,00700,富邦恒生國企,,,,,0.00,0.00,885,4,16548,0,0,0,0,0,0,3,0,3,3
20200430,00701,國泰股利精選30,20.00,20.31,20.00,20.29,+0.40,2.01,3064607,1277,61834819,32000,1000,31000,0,0,0,566000,462000,104000,135000
20200430,00702,國泰標普低波高息,16.66,16.78,16.64,16.75,+0.30,1.82,121000,46,2018310,0,5000,-5000,0,0,0,0,88000,-88000,-93000
20200430,00703,台新MSCI中國,20.28,20.40,20.14,20.37,+0.17,0.84,116000,17,2357530,0,0,0,0,0,0,109000,86000,23000,23000
20200430,00706L,元大S&P日圓正2,17.60,17.64,17.60,17.63,-0.06,-0.34,45000,8,792440,0,0,0,0,0,0,40000,4000,36000,36000
20200430,00707R,元大S&P日圓反1,19.41,19.41,19.38,19.38,+0.04,0.21,13000,2,251970,0,0,0,0,0,0,1000,13000,-12000,-12000
20200430,00708L,元大S&P黃金正2,27.88,27.88,27.70,27.78,-0.13,-0.47,3377000,838,93794470,0,0,0,0,0,0,1043000,709000,334000,334000
20200430,00709,富邦歐洲,17.60,17.74,17.60,17.72,+0.52,3.02,167000,22,2944070,0,0,0,0,0,0,143000,116000,27000,27000
20200430,00710B,FH彭博高收益債,18.28,18.31,18.26,18.30,+0.02,0.11,175000,71,3198990,0,0,0,0,0,0,30000,89000,-59000,-59000
20200430,00711B,FH彭博新興債,20.10,20.24,20.06,20.17,+0.23,1.15,362000,42,7287250,129000,0,129000,0,0,0,208000,361000,-153000,-24000
20200430,00712,FH富時不動產,10.00,10.18,9.95,10.16,+0.68,7.17,5444763,1499,54660370,0,508000,-508000,0,0,0,16000,418000,-402000,-910000
20200430,00713,元大台灣高息低波,30.16,30.56,30.16,30.55,+0.50,1.66,80080,49,2433564,50000,1000,49000,0,0,0,3000,3000,0,49000
20200430,00714,群益道瓊美國地產,17.95,18.12,17.90,18.09,+0.14,0.78,175000,35,3155560,0,0,0,0,0,0,12000,132000,-120000,-120000
20200430,00715L,街口布蘭特油正2,5.50,5.73,5.41,5.73,+0.93,19.37,43505147,4200,241360454,58000,1020000,-962000,0,0,0,905000,922000,-17000,-979000
20200430,00717,富邦美國特別股,16.49,16.49,16.40,16.44,+0.06,0.37,1526676,435,25098103,0,0,0,0,0,0,509000,702042,-193042,-193042
20200430,00728,第一金工業30,18.23,18.78,18.23,18.78,+0.68,3.76,855228,146,15893759,0,0,0,0,0,0,638000,513000,125000,125000
20200430,00730,富邦臺灣優質高息,16.40,16.81,16.40,16.80,+0.43,2.63,800389,281,13355239,0,0,0,0,0,0,549000,250000,299000,299000
20200430,00731,FH富時高息低波,43.75,44.65,43.75,44.63,+1.06,2.43,54050,29,2404265,0,1000,-1000,0,0,0,43000,28000,15000,14000
20200430,00732,國泰RMB短期報酬,37.99,38.03,37.99,38.03,-0.05,-0.13,102000,4,3878980,0,0,0,0,0,0,101000,101000,0,0
20200430,00733,富邦臺灣中小,19.75,19.75,19.54,19.69,+0.14,0.72,221493,17,4357132,0,0,0,0,0,0,203000,212000,-9000,-9000
20200430,00735,國泰臺韓科技,19.30,19.41,19.29,19.41,+0.29,1.52,228000,24,4414290,119000,0,119000,0,0,0,103000,209000,-106000,13000
20200430,00736,國泰新興市場,17.00,17.24,17.00,17.23,+0.29,1.71,477000,38,8185570,329000,0,329000,0,0,0,142000,468000,-326000,3000
20200430,00737,國泰AI+Robo,20.63,21.01,20.63,20.97,+0.65,3.2,869003,343,18139600,327000,1000,326000,0,0,0,249000,103000,146000,472000
20200430,00738U,元大道瓊白銀,17.00,17.06,16.95,17.03,+0.09,0.53,1288000,290,21896780,0,105000,-105000,0,0,0,240000,337000,-97000,-202000
20200430,00739,元大MSCI A股,20.55,20.78,20.55,20.70,+0.20,0.98,436570,108,9033787,123000,0,123000,0,0,0,56000,307000,-251000,-128000
20200430,00742,新光內需收益,20.11,20.22,20.11,20.22,+0.27,1.35,102000,4,2062280,0,0,0,0,0,0,102000,100000,2000,2000
20200430,00743,國泰中國A150,20.20,20.43,20.10,20.43,+0.25,1.24,53695,26,1085886,0,0,0,0,0,0,22000,40000,-18000,-18000
20200430,00752,中信中國50,23.33,23.34,23.28,23.28,+0.15,0.65,509441,334,11872913,2000,0,2000,0,0,0,0,18000,-18000,-16000
20200430,00753L,中信中國50正2,23.40,23.93,23.37,23.91,+0.78,3.37,287000,124,6771550,89000,0,89000,0,0,0,79000,151000,-72000,17000
20200430,00757,統一FANG+,26.55,26.80,26.55,26.68,+0.78,3.01,466000,110,12422700,0,0,0,0,0,0,214000,302000,-88000,-88000
20200430,00762,元大全球AI,25.65,25.93,25.64,25.75,+0.82,3.29,1669700,316,43057037,1000,1000,0,0,0,0,1264000,137000,1127000,1127000
20200430,00763U,街口道瓊銅,16.28,16.33,16.23,16.33,+0.17,1.05,153000,40,2493780,0,0,0,0,0,0,16000,109000,-93000,-93000
20200430,00766L,台新MSCI中國正2,9.13,9.27,9.13,9.16,+0.07,0.77,237000,69,2178730,0,0,0,0,0,0,42000,25000,17000,17000
20200430,00767,FH美國金融股,18.03,18.47,18.03,18.47,+0.88,5.0,7000,7,127050,0,0,0,0,0,0,0,4000,-4000,-4000
20200430,00770,國泰北美科技,24.85,25.00,24.84,25.00,+1.00,4.17,168000,29,4176600,0,3000,-3000,0,0,0,123000,125000,-2000,-5000
20200430,00771,元大US高息特別股,18.71,18.71,18.61,18.65,+0.23,1.25,133170,49,2483997,0,0,0,0,0,0,53000,48000,5000,5000
20200430,00774B,新光中國政金綠債,40.19,40.19,40.19,40.19,+0.04,0.1,2000,2,80380,0,0,0,0,0,0,2000,2000,0,0
20200430,00774C,新光中政金綠債+R,,,,,0.00,0.00,0,0,0,0,0,0,0,0,0,0,0,0,0
20200430,00775B,新光投等債15+,45.10,45.10,45.10,45.10,-0.07,-0.15,2000,2,90200,0,0,0,0,0,0,2000,2000,0,0
20200430,00776,新光ICE美國權值,20.72,20.72,20.72,20.72,+0.34,1.67,100000,2,2072000,0,0,0,0,0,0,100000,100000,0,0
20200430,00783,富邦中証500,17.71,18.06,17.71,18.04,+0.34,1.92,1060000,57,19090460,112000,1000,111000,0,0,0,755000,1008000,-253000,-142000
20200430,008201,BP上證50,97.50,97.50,97.50,97.50,0.00,0.00,200,2,19500,0,0,0,0,0,0,200,0,200,200
20200430,00830,國泰費城半導體,16.95,17.11,16.94,17.09,+0.61,3.7,1982495,727,33755606,215000,5000,210000,0,0,0,877000,59000,818000,1028000
20200430,00850,元大臺灣ESG永續,21.15,21.40,21.14,21.37,+0.40,1.91,4039547,1509,85989302,107000,0,107000,0,0,0,2007000,733000,1274000,1381000
20200430,00851,台新全球AI,21.36,21.51,21.34,21.51,+0.58,2.77,122000,43,2613230,0,0,0,0,0,0,105000,11000,94000,94000
20200430,00852L,國泰美國道瓊正2,11.37,11.57,11.31,11.53,+0.40,3.59,30189150,2300,344772561,1844000,3150000,-1306000,0,0,0,6020000,7673000,-1653000,-2959000
20200430,00861,元大全球未來通訊,19.99,20.05,19.94,20.00,+0.14,0.7,8654812,2312,173042200,940000,1000,939000,0,0,0,4223000,351000,3872000,4811000
20200430,00865B,國泰US短期公債,39.39,39.39,39.30,39.30,-0.15,-0.38,133000,14,5229890,0,0,0,0,0,0,125000,103000,22000,22000
20200430,00866,新光Shiller CAPE,17.82,18.00,17.82,17.99,+0.46,2.62,67000,14,1201830,0,0,0,0,0,0,42000,46000,-4000,-4000
20200430,00875,國泰網路資安,22.00,22.19,21.97,22.15,+0.31,1.42,3372400,741,74332180,374000,0,374000,0,0,0,2356000,746000,1610000,1984000
20200430,01001T,土銀富邦R1,15.96,16.09,15.96,16.09,+0.13,0.81,12000,11,191880,0,0,0,0,0,0,0,0,0,0
20200430,01002T,土銀國泰R1,17.10,17.20,17.10,17.14,+0.05,0.29,70000,27,1200700,0,15000,-15000,0,0,0,0,0,0,-15000
20200430,01003T,兆豐新光R1,18.61,18.61,18.45,18.60,0.00,0.00,103000,32,1915680,98000,24000,74000,0,0,0,0,0,0,74000
20200430,01004T,土銀富邦R2,14.20,14.20,14.06,14.10,-0.01,-0.07,4000,3,56420,0,1000,-1000,0,0,0,0,0,0,-1000
20200430,01007T,兆豐國泰R2,17.38,17.45,17.38,17.44,+0.01,0.06,37000,12,644910,36000,0,36000,0,0,0,0,0,0,36000
20200430,01009T,王道圓滿R1,9.39,9.39,9.39,9.39,+0.02,0.21,61000,12,572790,0,0,0,0,0,0,0,0,0,0
20200430,01010T,京城樂富R1,9.88,9.88,9.81,9.88,0.00,0.00,105000,32,1034530,0,0,0,0,0,0,0,0,0,0
20200430,020000,富邦特選蘋果N,5.09,5.14,5.09,5.14,+0.09,1.78,233000,33,1191110,0,0,0,0,0,0,189000,9000,180000,180000
20200430,020002,元富新中國N,,,,,0.00,0.00,0,0,0,0,0,0,0,0,0,0,0,0,0
20200430,020004,兆豐電菁英30N,,,,,0.00,0.00,0,0,0,0,0,0,0,0,0,0,0,0,0
20200430,020006,永昌中小300N,20.46,20.46,20.46,20.46,0.00,0.00,1000,1,20460,0,0,0,0,0,0,0,1000,-1000,-1000
20200430,020007,凱基臺灣500N,,,,,0.00,0.00,0,0,0,0,0,0,0,0,0,0,0,0,0
20200430,020008,元大特股高息N,10.26,10.30,10.25,10.30,+0.07,0.68,113000,23,1160340,0,0,0,0,0,0,85000,28000,57000,57000
20200430,020011,統一微波高息20N,4.68,4.73,4.68,4.73,+0.12,2.6,31000,4,146540,0,0,0,0,0,0,10000,21000,-11000,-11000
20200430,020012,富邦行動通訊N,4.86,4.88,4.83,4.83,0.00,0.00,1619000,113,7845770,0,0,0,0,0,0,1419000,0,1419000,1419000
20200430,020015,統一MSCI美低波N,11.89,11.99,11.88,11.98,+0.06,0.5,97000,28,1157290,0,0,0,0,0,0,33000,49000,-16000,-16000
20200430,020016,統一MSCI美科技N,11.90,11.99,11.90,11.99,+0.44,3.81,147000,41,1752780,0,0,0,0,0,0,114000,30000,84000,84000
20200430,02001L,富邦蘋果正二N,5.85,5.85,5.85,5.85,+0.14,2.45,6000,2,35100,0,0,0,0,0,0,6000,0,6000,6000
20200430,02001R,富邦蘋果反一N,4.62,4.62,4.57,4.57,-0.08,-1.72,75000,9,344550,0,0,0,0,0,0,0,75000,-75000,-75000
20200430,03005X,元展05,,,,,0.00,0.00,0,0,0,0,0,0,0,0,0,0,0,0,0
20200430,03006X,元展06,25.20,26.10,25.20,25.90,+1.40,5.71,4000,4,102700,0,0,0,0,0,0,4000,0,4000,4000
20200430,03007X,元展07,18.70,18.70,18.70,18.70,0.00,0.00,19000,2,355300,0,0,0,0,0,0,19000,0,19000,19000
20200430,03009X,元展09,16.10,16.20,16.10,16.20,+0.70,4.52,2000,2,32300,0,0,0,0,0,0,1000,1000,0,0
20200430,03010X,元展10,26.70,27.10,26.70,27.10,+0.60,2.26,9000,5,243500,0,0,0,0,0,0,1000,8000,-7000,-7000
20200430,03012X,元展12,10.10,10.20,10.10,10.20,+0.65,6.81,5000,2,50900,0,0,0,0,0,0,4000,1000,3000,3000
20200430,03013X,元展13,,,,,0.00,0.00,0,0,0,0,0,0,0,0,0,0,0,0,0
20200430,03014X,元展14,,,,,0.00,0.00,0,0,0,0,0,0,0,0,0,0,0,0,0
20200430,03015X,元展15,,,,,0.00,0.00,0,0,0,0,0,0,0,0,0,0,0,0,0
20200430,03016X,元展16,,,,,0.00,0.00,0,0,0,0,0,0,0,0,0,0,0,0,0
20200430,03017X,元展17,,,,,0.00,0.00,0,0,0,0,0,0,0,0,0,0,0,0,0
20200430,03019X,元展19,,,,,0.00,0.00,0,0,0,0,0,0,0,0,0,0,0,0,0
20200430,03020X,元展20,,,,,0.00,0.00,0,0,0,0,0,0,0,0,0,0,0,0,0
20200430,03022X,富展01,13.60,14.10,13.50,14.00,+0.50,3.7,8000,5,111100,0,0,0,0,0,0,2000,5000,-3000,-3000
20200430,03025X,元展22,,,,,0.00,0.00,0,0,0,0,0,0,0,0,0,0,0,0,0
20200430,03026X,元展23,4.46,4.48,4.46,4.48,+0.10,2.28,2000,2,8940,0,0,0,0,0,0,0,1000,-1000,-1000
20200430,03027X,元展24,,,,,0.00,0.00,0,0,0,0,0,0,0,0,0,0,0,0,0
20200430,03028X,元展25,,,,,0.00,0.00,0,0,0,0,0,0,0,0,0,0,0,0,0
20200430,03029X,元展26,,,,,0.00,0.00,0,0,0,0,0,0,0,0,0,0,0,0,0
20200430,03033P,台積電中信95售05,0.02,0.02,0.01,0.02,0.00,0.00,1947000,41,32120,0,0,0,0,0,0,0,0,0,0
20200430,03033X,元展30,6.90,6.90,6.80,6.85,-0.10,-1.44,3000,3,20550,0,0,0,0,0,0,0,3000,-3000,-3000
20200430,03035X,元展32,7.35,7.65,7.35,7.65,+0.65,9.29,47000,9,350150,0,0,0,0,0,0,47000,0,47000,47000
20200430,03038X,元展35,,,,,0.00,0.00,0,0,0,0,0,0,0,0,0,0,0,0,0
20200430,03039X,元展36,,,,,0.00,0.00,0,0,0,0,0,0,0,0,0,0,0,0,0
20200430,03046X,元展43,,,,,0.00,0.00,0,0,0,0,0,0,0,0,0,0,0,0,0
20200430,03047X,元展44,,,,,0.00,0.00,0,0,0,0,0,0,0,0,0,0,0,0,0
20200430,03049X,元展46,4.42,4.55,4.42,4.55,+0.29,6.81,2000,2,8970,0,0,0,0,0,0,0,2000,-2000,-2000
20200430,03050X,元展47,2.05,2.06,2.03,2.03,0.00,0.00,388000,20,789040,0,0,0,0,0,0,316000,0,316000,316000
20200430,03052X,元展49,16.80,17.90,16.80,17.90,+1.30,7.83,14000,9,243100,0,0,0,0,0,0,13000,1000,12000,12000
20200430,03060X,元展55,10.80,11.40,10.80,11.40,+0.40,3.64,23000,4,261000,0,0,0,0,0,0,23000,0,23000,23000
20200430,03064X,元展59,4.78,4.88,4.78,4.88,+0.48,10.91,151000,10,721880,0,0,0,0,0,0,151000,0,151000,151000
20200430,03071X,元展66,35.40,35.50,35.40,35.50,+0.80,2.31,11000,2,390400,0,0,0,0,0,0,11000,0,11000,11000
20200430,03074X,元展69,,,,,0.00,0.00,0,0,0,0,0,0,0,0,0,0,0,0,0
20200430,03075X,元展70,6.00,6.00,5.95,5.95,+0.15,2.59,6000,2,35950,0,0,0,0,0,0,0,6000,-6000,-6000
20200430,03078X,元展73,,,,,0.00,0.00,0,0,0,0,0,0,0,0,0,0,0,0,0
20200430,03091X,元展85,,,,,0.00,0.00,0,0,0,0,0,0,0,0,0,0,0,0,0
20200430,03093X,永豐金元大61展01,,,,,0.00,0.00,0,0,0,0,0,0,0,0,0,0,0,0,0
20200430,03094X,大立光元大68展08,16.50,17.50,16.50,17.50,+1.50,9.38,94000,14,1626100,0,0,0,0,0,0,91000,0,91000,91000
20200430,03111P,元油2X富邦97售01,,,,,0.00,0.00,0,0,0,0,0,0,0,0,0,0,0,0,0
20200430,03162P,華邦電中信96售02,,,,,0.00,0.00,0,0,0,0,0,0,0,0,0,0,0,0,0
20200430,03181P,道瓊指中信96售01,0.06,0.06,0.05,0.05,-0.06,-54.55,80000,6,4060,0,0,0,0,0,0,0,0,0,0
20200430,03252P,玉晶光群益95售02,,,,,0.00,0.00,0,0,0,0,0,0,0,0,0,0,0,0,0
20200430,03253P,玉晶光群益96售01,0.10,0.10,0.03,0.03,-0.04,-57.14,222000,9,6980,0,0,0,0,0,0,191000,0,191000,191000
20200430,03267P,玉晶光國票95售01,,,,,0.00,0.00,0,0,0,0,0,0,0,0,0,0,0,0,0
20200430,03298P,元油2X凱基95售01,,,,,0.00,0.00,0,0,0,0,0,0,0,0,0,0,0,0,0
20200430,03307P,元油2X元大95售03,,,,,0.00,0.00,0,0,0,0,0,0,0,0,0,0,0,0,0
20200430,03314P,滬深2X群益96售02,,,,,0.00,0.00,0,0,0,0,0,0,0,0,0,0,0,0,0
20200430,03334P,元油2X凱基95售02,,,,,0.00,0.00,0,0,0,0,0,0,0,0,0,0,0,0,0
20200430,03365P,元油2X富邦98售01,,,,,0.00,0.00,0,0,0,0,0,0,0,0,0,0,0,0,0
20200430,03366P,元油2X元大95售05,,,,,0.00,0.00,0,0,0,0,0,0,0,0,0,0,0,0,0
20200430,03388P,元油2X元富98售02,,,,,0.00,0.00,0,0,0,0,0,0,0,0,0,0,0,0,0
20200430,03412P,滬深2X群益98售01,0.38,0.40,0.37,0.40,0.00,0.00,45000,4,17200,0,0,0,0,0,0,0,45000,-45000,-45000
20200430,03414B,臺股指凱基99熊01,2.46,2.47,2.32,2.33,-0.22,-8.63,1632000,106,3901190,40000,80000,-40000,0,0,0,706000,908000,-202000,-242000
20200430,03416B,臺股指凱基95熊05,2.18,2.18,2.05,2.05,-0.26,-11.26,21000,4,44530,0,0,0,0,0,0,21000,0,21000,21000
20200430,03417B,臺股指凱基95熊19,,,,,0.00,0.00,0,0,0,0,0,0,0,0,0,0,0,0,0
20200430,03418B,臺股指元大95熊20,2.22,2.26,2.12,2.12,-0.23,-9.79,84000,14,183100,0,0,0,0,0,0,50000,34000,16000,16000
20200430,03419B,臺股指元富99熊03,,,,,0.00,0.00,0,0,0,0,0,0,0,0,0,0,0,0,0
20200430,03420B,臺股指元大95熊31,2.69,2.69,2.61,2.61,-0.22,-7.77,10000,2,26500,0,0,0,0,0,0,10000,0,10000,10000
20200430,03421B,臺股指元大99熊01,3.38,3.38,3.22,3.22,-0.23,-6.67,514000,14,1687780,0,0,0,0,0,0,264000,250000,14000,14000
20200430,03422B,臺股指凱基96熊28,,,,,0.00,0.00,0,0,0,0,0,0,0,0,0,0,0,0,0
20200430,03424B,臺股指元大96熊26,,,,,0.00,0.00,0,0,0,0,0,0,0,0,0,0,0,0,0
20200430,03425B,臺股指元大9A熊01,3.40,3.40,3.40,3.40,0.00,0.00,11000,1,37400,0,0,0,0,0,0,11000,0,11000,11000
20200430,03427B,臺股指元大9A熊02,,,,,0.00,0.00,0,0,0,0,0,0,0,0,0,0,0,0,0
20200430,03428B,臺股指凱基97熊18,3.04,3.04,3.04,3.04,-0.22,-6.75,60000,2,182400,0,0,0,0,0,0,60000,0,60000,60000
20200430,03429B,臺股指元富97熊07,,,,,0.00,0.00,0,0,0,0,0,0,0,0,0,0,0,0,0
20200430,03430B,臺股指元大9B熊01,2.93,2.93,2.81,2.81,-0.22,-7.26,4000,3,11370,0,0,0,0,0,0,0,4000,-4000,-4000
20200430,03431B,元油2X凱基9B熊03,,,,,0.00,0.00,0,0,0,0,0,0,0,0,0,0,0,0,0
20200430,03432B,臺股指凱基98熊13,2.92,2.92,2.77,2.77,-0.23,-7.67,69000,14,196830,0,0,0,0,0,0,2000,67000,-65000,-65000
20200430,03433B,臺股指元大9C熊01,2.92,2.94,2.78,2.79,-0.22,-7.31,563000,48,1598090,0,0,0,0,0,0,175000,377000,-202000,-202000
20200430,03434B,臺股指元大99熊10,1.87,1.87,1.75,1.75,-0.23,-11.62,128000,13,233780,0,0,0,0,0,0,28000,82000,-54000,-54000
20200430,03437B,臺股指元富9C熊01,1.87,1.87,1.87,1.87,-0.18,-8.78,2000,2,3740,0,0,0,0,0,0,0,2000,-2000,-2000
20200430,03438P,群創群益98售03,,,,,0.00,0.00,0,0,0,0,0,0,0,0,0,0,0,0,0
20200430,03440B,臺股指元大9B熊02,1.32,1.32,1.13,1.15,-0.23,-16.67,7762000,338,9454220,1000,0,1000,0,0,0,4412000,3112000,1300000,1301000
20200430,03441B,臺股指凱基9A熊05,0.84,0.96,0.81,0.88,-0.16,-15.38,3728000,164,3261260,0,0,0,0,0,0,1771000,1685000,86000,86000
20200430,03442B,臺股指元大9A熊48,2.03,2.03,1.90,1.90,-0.23,-10.8,161000,13,307370,0,0,0,0,0,0,0,161000,-161000,-161000
20200430,03443B,臺股指凱基9A熊27,1.69,1.71,1.56,1.57,-0.22,-12.29,1278000,62,2046680,59000,0,59000,0,0,0,408000,870000,-462000,-403000
20200430,03450P,元油2X元富98售05,,,,,0.00,0.00,0,0,0,0,0,0,0,0,0,0,0,0,0
20200430,03454P,元油2X元大95售06,,,,,0.00,0.00,0,0,0,0,0,0,0,0,0,0,0,0,0
20200430,03497P,滬深2X元富95售02,,,,,0.00,0.00,0,0,0,0,0,0,0,0,0,0,0,0,0
20200430,035274,華新台新97購01,0.18,0.18,0.04,0.04,-0.09,-69.23,58000,8,7200,0,0,0,0,0,0,0,58000,-58000,-58000
20200430,035275,台積電台新97購01,22.00,22.50,21.50,22.00,+0.60,2.8,25000,14,545900,0,0,0,0,0,0,18000,0,18000,18000
20200430,035276,南亞科台新97購01,1.52,1.52,1.52,1.52,-2.14,-58.47,10000,3,15200,0,0,0,0,0,0,0,10000,-10000,-10000
20200430,035277,景碩台新97購01,4.64,5.20,4.64,5.20,+0.57,12.31,11000,3,54350,0,0,0,0,0,0,11000,0,11000,11000
20200430,03543P,T50正2中信95售02,,,,,0.00,0.00,0,0,0,0,0,0,0,0,0,0,0,0,0
20200430,03555P,台積電富邦95售01,0.01,0.01,0.01,0.01,0.00,0.00,713000,13,7130,0,0,0,0,0,0,0,0,0,0
20200430,03566P,群創群益96售01,0.74,0.74,0.74,0.74,-0.06,-7.5,22000,1,16280,0,0,0,0,0,0,22000,0,22000,22000
20200430,03603P,群創凱基98售04,1.55,1.55,1.55,1.55,-0.04,-2.52,11000,1,17050,0,0,0,0,0,0,11000,0,11000,11000
20200430,03604P,群創凱基98售05,1.06,1.06,1.05,1.05,-0.04,-3.67,11000,2,11600,0,0,0,0,0,0,11000,0,11000,11000
20200430,03607P,滬深2X富邦95售01,,,,,0.00,0.00,0,0,0,0,0,0,0,0,0,0,0,0,0
20200430,036084,台灣50台新98購01,5.80,5.95,5.80,5.85,0.00,0.00,16000,4,93700,0,0,0,0,0,0,16000,0,16000,16000
20200430,03618C,高股息凱基95牛01,2.01,2.07,2.01,2.07,+0.10,5.08,40000,7,81750,0,0,0,0,0,0,40000,0,40000,40000
20200430,03619C,臺股指元大95牛02,2.86,2.91,2.86,2.91,+0.21,7.78,23000,7,66440,0,0,0,0,0,0,23000,0,23000,23000
20200430,03647C,T50反1元富99牛02,2.25,2.25,2.15,2.15,-0.20,-8.51,112000,5,243520,0,0,0,0,0,0,51000,61000,-10000,-10000
20200430,03647P,京元電元富95售02,,,,,0.00,0.00,0,0,0,0,0,0,0,0,0,0,0,0,0
20200430,03648C,T50反1元大96牛07,1.78,1.78,1.63,1.63,-0.22,-11.89,222000,10,380860,0,0,0,0,0,0,0,222000,-222000,-222000
20200430,03649C,T50反1凱基99牛05,,,,,0.00,0.00,0,0,0,0,0,0,0,0,0,0,0,0,0
20200430,03650C,T50反1元大98牛05,1.74,1.74,1.74,1.74,0.00,0.00,5000,1,8700,0,0,0,0,0,0,5000,0,5000,5000
20200430,03657C,T50反1元大99牛01,1.76,1.80,1.66,1.66,-0.23,-12.17,372000,15,646770,0,0,0,0,0,0,100000,272000,-172000,-172000
20200430,03658C,T50反1元大9A牛02,1.98,1.98,1.91,1.91,-0.23,-10.75,64000,7,125750,0,0,0,0,0,0,0,64000,-64000,-64000
20200430,036628,統一台新99購01,0.30,0.30,0.30,0.30,-1.61,-84.29,10000,2,3000,0,0,0,0,0,0,0,10000,-10000,-10000
20200430,036629,智邦台新99購01,,,,,0.00,0.00,0,0,0,0,0,0,0,0,0,0,0,0,0
20200430,03662C,FBVIX凱基03牛01,4.23,4.23,4.11,4.12,-0.39,-8.65,79000,15,325840,0,0,0,0,0,0,4000,75000,-71000,-71000
20200430,036630,玉山金台新99購01,,,,,0.00,0.00,0,0,0,0,0,0,0,0,0,0,0,0,0
20200430,03669C,滬深2X元富09牛01,3.43,3.55,3.43,3.45,+0.10,2.99,38000,5,130950,0,0,0,0,0,0,23000,15000,8000,8000
20200430,03670C,元油2X元富99牛01,1.02,1.24,1.02,1.14,+0.19,20.0,40000,10,43710,0,0,0,0,0,0,1000,0,1000,1000
20200430,03671P,大立光凱基95售02,,,,,0.00,0.00,0,0,0,0,0,0,0,0,0,0,0,0,0
20200430,03674C,臺股指元富9C牛02,2.71,2.98,2.71,2.98,+0.27,9.96,18000,6,51930,0,0,0,0,0,0,10000,8000,2000,2000
20200430,03675C,臺股指元大04牛02,2.95,3.08,2.95,3.08,+0.22,7.69,13000,5,39070,0,0,0,0,0,0,10000,3000,7000,7000
20200430,03676C,臺股指元大04牛03,,,,,0.00,0.00,0,0,0,0,0,0,0,0,0,0,0,0,0
20200430,03677C,臺股指元大05牛02,4.58,4.58,4.58,4.58,+0.24,5.53,1000,1,4580,0,0,0,0,0,0,0,1000,-1000,-1000
20200430,03678C,臺股指凱基01牛02,2.17,2.31,2.15,2.30,+0.23,11.11,1217000,55,2685270,0,0,0,0,0,0,853000,363000,490000,490000
20200430,03679C,臺股指元大04牛04,,,,,0.00,0.00,0,0,0,0,0,0,0,0,0,0,0,0,0
20200430,03680C,臺股指凱基9A牛26,1.53,1.66,1.52,1.65,+0.21,14.58,886000,51,1395280,0,0,0,0,0,0,332000,554000,-222000,-222000
20200430,03686P,大立光統一98售02,0.48,0.50,0.43,0.47,-0.08,-14.55,145000,16,70460,0,0,0,0,0,0,0,89000,-89000,-89000
20200430,03720P,元油2X富邦95售01,,,,,0.00,0.00,0,0,0,0,0,0,0,0,0,0,0,0,0
20200430,03763P,聯發科元富96售01,0.02,0.09,0.02,0.09,-0.02,-18.18,148000,4,6320,0,0,0,0,0,0,0,0,0,0
20200430,03765P,大立光元富96售01,0.20,0.31,0.20,0.31,0.00,0.00,4000,2,910,0,0,0,0,0,0,3000,1000,2000,2000
20200430,03810P,大立光富邦98售01,0.51,0.52,0.50,0.50,-0.09,-15.25,66000,3,33800,0,0,0,0,0,0,65000,0,65000,65000
20200430,03840P,台積電統一99售02,0.31,0.35,0.30,0.34,-0.05,-12.82,919000,132,283250,0,0,0,0,0,0,0,550000,-550000,-550000
20200430,038489,T50反1台新9A購01,0.52,0.52,0.38,0.44,-0.09,-16.98,3572000,282,1588770,0,0,0,0,0,0,0,730000,-730000,-730000
20200430,03857P,聯發科元富99售02,0.26,0.40,0.11,0.36,0.00,0.00,255000,36,49010,0,0,0,0,0,0,0,118000,-118000,-118000
20200430,03860P,群創元富97售01,,,,,0.00,0.00,0,0,0,0,0,0,0,0,0,0,0,0,0
20200430,03861P,群創元富99售01,0.69,0.69,0.69,0.69,-0.04,-5.48,22000,3,15180,0,0,0,0,0,0,0,22000,-22000,-22000
20200430,03874P,臺股指群益95售01,,,,,0.00,0.00,0,0,0,0,0,0,0,0,0,0,0,0,0
20200430,03875P,滬深2X國票05售01,,,,,0.00,0.00,0,0,0,0,0,0,0,0,0,0,0,0,0
20200430,03885P,華新科統一96售01,,,,,0.00,0.00,0,0,0,0,0,0,0,0,0,0,0,0,0
20200430,03892P,元油2X中信95售01,,,,,0.00,0.00,0,0,0,0,0,0,0,0,0,0,0,0,0
20200430,03896P,長榮航凱基95售01,2.05,2.05,2.05,2.05,-0.15,-6.82,1000,1,2050,0,0,0,0,0,0,0,0,0,0
20200430,03899P,滬深2X群益95售03,,,,,0.00,0.00,0,0,0,0,0,0,0,0,0,0,0,0,0
20200430,039212,台達電台新9A購01,0.61,0.68,0.17,0.17,-0.40,-70.18,33000,7,16170,0,0,0,0,0,0,17000,11000,6000,6000
20200430,03935P,可成富邦95售01,,,,,0.00,0.00,0,0,0,0,0,0,0,0,0,0,0,0,0
20200430,03939P,康控元大95售02,,,,,0.00,0.00,0,0,0,0,0,0,0,0,0,0,0,0,0
20200430,03951P,新光金凱基95售01,,,,,0.00,0.00,0,0,0,0,0,0,0,0,0,0,0,0,0
20200430,03959P,義隆元富96售01,,,,,0.00,0.00,0,0,0,0,0,0,0,0,0,0,0,0,0
20200430,03960P,新日興元富96售02,,,,,0.00,0.00,0,0,0,0,0,0,0,0,0,0,0,0,0
20200430,03980P,群創凱基95售02,,,,,0.00,0.00,0,0,0,0,0,0,0,0,0,0,0,0,0
20200430,03995P,滬深2X國泰95售01,,,,,0.00,0.00,0,0,0,0,0,0,0,0,0,0,0,0,0
20200430,03996P,旺宏國泰95售01,,,,,0.00,0.00,0,0,0,0,0,0,0,0,0,0,0,0,0
20200430,04006P,滬深2X國票9B售01,1.44,1.44,1.44,1.44,0.00,0.00,131000,1,188640,0,0,0,0,0,0,131000,0,131000,131000
20200430,04022P,群創元富96售04,,,,,0.00,0.00,0,0,0,0,0,0,0,0,0,0,0,0,0
20200430,04023P,臺股指元富99售02,1.58,1.58,0.72,1.10,-0.19,-14.73,94000,18,102510,0,0,0,0,0,0,0,0,0,0
20200430,040380,SP黃豆元富95購02,,,,,0.00,0.00,0,0,0,0,0,0,0,0,0,0,0,0,0
20200430,040381,元金2X元富95購01,,,,,0.00,0.00,0,0,0,0,0,0,0,0,0,0,0,0,0
20200430,04049P,大立光元大95售02,0.50,0.50,0.34,0.34,-0.16,-32.0,30000,3,13400,0,0,0,0,0,0,10000,10000,0,0
20200430,04054P,滬深2X富邦96售02,,,,,0.00,0.00,0,0,0,0,0,0,0,0,0,0,0,0,0
20200430,040578,SP黃豆元富95購03,,,,,0.00,0.00,0,0,0,0,0,0,0,0,0,0,0,0,0
20200430,040760,T50反1凱基95購01,0.50,0.50,0.50,0.50,0.00,0.00,50000,1,25000,0,0,0,0,0,0,0,0,0,0
20200430,040761,T50反1凱基95購02,0.01,0.01,0.01,0.01,0.00,0.00,88000,3,880,0,0,0,0,0,0,0,0,0,0
20200430,04126P,滬深2X國票95售02,0.31,0.31,0.31,0.31,-0.09,-22.5,30000,1,9300,0,0,0,0,0,0,30000,0,30000,30000
20200430,04137P,元油反國票97售01,1.00,1.29,0.17,1.29,-0.01,-0.77,90000,8,31610,0,0,0,0,0,0,0,0,0,0
20200430,04142P,元油反凱基99售01,0.92,1.35,0.91,1.30,+0.43,49.43,740000,79,809190,0,0,0,0,0,0,0,0,0,0
20200430,041527,T50反1中信96購01,0.65,0.65,0.65,0.65,0.00,0.00,47000,1,30550,0,0,0,0,0,0,47000,0,47000,47000
20200430,041534,T50反1凱基96購01,0.20,0.20,0.10,0.15,-0.05,-25.0,53000,8,6180,0,0,0,0,0,0,0,0,0,0
20200430,04159P,滬深2X中信95售08,,,,,0.00,0.00,0,0,0,0,0,0,0,0,0,0,0,0,0
20200430,04165P,南亞科元富95售03,,,,,0.00,0.00,0,0,0,0,0,0,0,0,0,0,0,0,0
20200430,04167P,滬深反凱基99售01,,,,,0.00,0.00,0,0,0,0,0,0,0,0,0,0,0,0,0
20200430,04168P,元金2X凱基99售01,0.45,0.45,0.45,0.45,+0.06,15.38,2000,1,900,0,0,0,0,0,0,0,0,0,0
20200430,041824,元油2X國票96購01,,,,,0.00,0.00,0,0,0,0,0,0,0,0,0,0,0,0,0
20200430,041870,A50正2凱基96購01,,,,,0.00,0.00,0,0,0,0,0,0,0,0,0,0,0,0,0
20200430,041900,元油2X富邦96購01,0.04,0.04,0.04,0.04,0.00,0.00,18000,2,720,0,0,0,0,0,0,0,0,0,0
20200430,04198P,滬深2X群益95售04,,,,,0.00,0.00,0,0,0,0,0,0,0,0,0,0,0,0,0
20200430,041990,A50正2國票97購01,,,,,0.00,0.00,0,0,0,0,0,0,0,0,0,0,0,0,0
20200430,041991,元油2X國票98購01,0.06,0.06,0.06,0.06,0.00,0.00,50000,1,3000,0,0,0,0,0,0,0,0,0,0
20200430,042116,元油2X國票97購01,0.07,0.07,0.07,0.07,+0.01,16.67,1000,1,70,0,0,0,0,0,0,0,0,0,0
20200430,042168,台灣50凱基96購01,1.55,2.26,1.55,2.26,+1.08,91.53,189000,30,330540,0,0,0,0,0,0,186000,110000,76000,76000
20200430,042280,元石油富邦96購01,0.06,0.06,0.06,0.06,0.00,0.00,66000,2,3960,0,0,0,0,0,0,0,0,0,0
20200430,042281,元油2X富邦96購02,,,,,0.00,0.00,0,0,0,0,0,0,0,0,0,0,0,0,0
20200430,04229P,臺股指中信95售05,,,,,0.00,0.00,0,0,0,0,0,0,0,0,0,0,0,0,0
20200430,04230P,臺股指中信95售06,0.50,0.50,0.50,0.50,0.00,0.00,5000,1,2500,0,0,0,0,0,0,0,5000,-5000,-5000
20200430,042315,T50反1台新96購01,0.22,0.22,0.10,0.12,-0.01,-7.69,281000,14,32750,0,0,0,0,0,0,0,10000,-10000,-10000
20200430,042317,台灣50永豐96購01,0.65,0.65,0.64,0.64,+0.16,33.33,66000,12,42300,0,0,0,0,0,0,54000,0,54000,54000
20200430,04241P,欣興國泰95售02,,,,,0.00,0.00,0,0,0,0,0,0,0,0,0,0,0,0,0
20200430,042433,元油2X永豐96購01,,,,,0.00,0.00,0,0,0,0,0,0,0,0,0,0,0,0,0
20200430,042501,台灣50凱基96購06,3.09,3.09,3.09,3.09,+0.65,26.64,1000,1,3090,0,0,0,0,0,0,1000,0,1000,1000
20200430,04250P,嘉晶統一95售02,0.45,0.45,0.45,0.45,0.00,0.00,10000,1,4500,0,0,0,0,0,0,10000,0,10000,10000
20200430,042556,台灣50中信96購04,1.39,1.54,1.39,1.54,+0.43,38.74,61000,7,91890,0,0,0,0,0,0,61000,60000,1000,1000
20200430,042692,台灣50凱基96購09,,,,,0.00,0.00,0,0,0,0,0,0,0,0,0,0,0,0,0
20200430,042712,元石油國票95購01,0.01,0.01,0.01,0.01,0.00,0.00,416000,2,4160,0,0,0,0,0,0,416000,0,416000,416000
20200430,04273P,上証反凱基99售01,,,,,0.00,0.00,0,0,0,0,0,0,0,0,0,0,0,0,0
20200430,042752,台灣50元大96購03,1.61,2.17,1.59,2.05,+0.63,44.37,259000,30,466510,0,0,0,0,0,0,247000,100000,147000,147000
20200430,042792,T50反1台新9C購01,0.81,0.81,0.26,0.26,-0.59,-69.41,55000,9,38010,0,0,0,0,0,0,0,55000,-55000,-55000
20200430,042793,台積電台新9C購01,14.30,14.60,14.30,14.60,+0.30,2.1,18000,7,260600,0,0,0,0,0,0,0,0,0,0
20200430,04286P,滬深2X中信96售01,,,,,0.00,0.00,0,0,0,0,0,0,0,0,0,0,0,0,0
20200430,04287P,A50正2中信96售01,0.96,0.96,0.96,0.96,0.00,0.00,1000,1,960,0,0,0,0,0,0,1000,0,1000,1000
20200430,04288P,台積電中信95售06,,,,,0.00,0.00,0,0,0,0,0,0,0,0,0,0,0,0,0
20200430,04289P,臺股指中信95售07,0.44,0.44,0.32,0.32,0.00,0.00,12000,3,4480,0,0,0,0,0,0,0,7000,-7000,-7000
20200430,04290P,滬深2X富邦96售03,2.43,2.43,2.43,2.43,0.00,0.00,8000,1,19440,0,0,0,0,0,0,8000,0,8000,8000
20200430,04293P,滬深2X元大96售02,1.32,1.32,1.32,1.32,0.00,0.00,1000,1,1320,0,0,0,0,0,0,0,1000,-1000,-1000
20200430,04294P,台積電元大95售01,0.11,0.11,0.04,0.04,-0.03,-42.86,92000,6,4580,0,0,0,0,0,0,0,0,0,0
20200430,042953,鴻海台新01購01,2.15,2.15,2.15,2.15,0.00,0.00,3000,1,6450,0,0,0,0,0,0,0,0,0,0
20200430,04311P,奇力新統一95售01,,,,,0.00,0.00,0,0,0,0,0,0,0,0,0,0,0,0,0
20200430,04313P,國巨元富95售03,,,,,0.00,0.00,0,0,0,0,0,0,0,0,0,0,0,0,0
20200430,04327P,台積電國泰95售01,0.06,0.06,0.04,0.04,0.00,0.00,337000,2,13680,0,0,0,0,0,0,327000,0,327000,327000
20200430,043442,大立光台新01購01,1.93,2.14,1.46,1.46,-0.33,-18.44,114000,30,224220,0,0,0,0,0,0,52000,61000,-9000,-9000
20200430,043513,台灣50元大96購05,1.01,1.13,1.01,1.13,+0.16,16.49,30000,8,33180,0,0,0,0,0,0,30000,10000,20000,20000
20200430,043538,元石油國票97購01,0.04,0.05,0.04,0.04,-0.01,-20.0,170000,4,7300,0,0,0,0,0,0,0,0,0,0
20200430,043642,元金2X國票97購01,,,,,0.00,0.00,0,0,0,0,0,0,0,0,0,0,0,0,0
20200430,04373P,滬深2X元大97售01,0.90,0.90,0.78,0.78,0.00,0.00,12000,3,9540,0,0,0,0,0,0,11000,1000,10000,10000
20200430,043832,SP黃豆國票95購01,,,,,0.00,0.00,0,0,0,0,0,0,0,0,0,0,0,0,0
20200430,04384P,上証2X中信96售01,,,,,0.00,0.00,0,0,0,0,0,0,0,0,0,0,0,0,0
20200430,044088,國巨元富95購01,,,,,0.00,0.00,0,0,0,0,0,0,0,0,0,0,0,0,0
20200430,044104,鴻海中信95購03,0.01,0.01,0.01,0.01,0.00,0.00,10000,10,100,0,0,0,0,0,0,0,0,0,0
20200430,044105,聯詠中信95購01,,,,,0.00,0.00,0,0,0,0,0,0,0,0,0,0,0,0,0
20200430,04411P,智易統一96售01,,,,,0.00,0.00,0,0,0,0,0,0,0,0,0,0,0,0,0
20200430,044201,群創國票95購01,0.01,0.02,0.01,0.02,+0.01,100.0,746000,5,7470,0,0,0,0,0,0,745000,0,745000,745000
20200430,044247,道瓊反元富97購01,0.40,0.40,0.35,0.40,-0.10,-20.0,15000,6,5800,0,0,0,0,0,0,0,0,0,0
20200430,044265,滬深2X中信95購05,,,,,0.00,0.00,0,0,0,0,0,0,0,0,0,0,0,0,0
20200430,044269,群創中信95購01,,,,,0.00,0.00,0,0,0,0,0,0,0,0,0,0,0,0,0
20200430,044270,群創中信95購02,,,,,0.00,0.00,0,0,0,0,0,0,0,0,0,0,0,0,0
20200430,04427P,滬深2X元大97售02,,,,,0.00,0.00,0,0,0,0,0,0,0,0,0,0,0,0,0
20200430,04433P,上証2X國票95售01,,,,,0.00,0.00,0,0,0,0,0,0,0,0,0,0,0,0,0
20200430,044346,力山富邦95購01,,,,,0.00,0.00,0,0,0,0,0,0,0,0,0,0,0,0,0
20200430,04434P,玉晶光國票96售02,,,,,0.00,0.00,0,0,0,0,0,0,0,0,0,0,0,0,0
20200430,04435P,台積電中信95售07,,,,,0.00,0.00,0,0,0,0,0,0,0,0,0,0,0,0,0
20200430,04436P,聯發科中信96售02,,,,,0.00,0.00,0,0,0,0,0,0,0,0,0,0,0,0,0
20200430,04437P,滬深2X群益98售03,,,,,0.00,0.00,0,0,0,0,0,0,0,0,0,0,0,0,0
20200430,04441P,台積電台新95售01,0.01,0.01,0.01,0.01,0.00,0.00,50000,1,500,0,0,0,0,0,0,50000,0,50000,50000
20200430,044457,滬深2X國票97購01,0.02,0.02,0.02,0.02,0.00,0.00,650000,4,13000,0,0,0,0,0,0,600000,0,600000,600000
20200430,044464,滬深2X群益95購01,,,,,0.00,0.00,0,0,0,0,0,0,0,0,0,0,0,0,0
20200430,044465,元油2X群益97購01,0.04,0.04,0.04,0.04,0.00,0.00,217000,4,8680,0,0,0,0,0,0,0,0,0,0
20200430,044475,國巨元富95購02,,,,,0.00,0.00,0,0,0,0,0,0,0,0,0,0,0,0,0
20200430,04452P,超眾國泰95售01,0.01,0.01,0.01,0.01,0.00,0.00,350000,1,3500,0,0,0,0,0,0,350000,350000,0,0
20200430,04454P,大立光富邦98售02,1.06,1.06,1.06,1.06,0.00,0.00,10000,1,10600,0,0,0,0,0,0,0,10000,-10000,-10000
20200430,04458P,世紀鋼統一96售01,,,,,0.00,0.00,0,0,0,0,0,0,0,0,0,0,0,0,0
20200430,04460P,元油2X元富96售04,,,,,0.00,0.00,0,0,0,0,0,0,0,0,0,0,0,0,0
20200430,04462P,全新元富96售01,0.93,1.00,0.93,0.98,-0.04,-3.92,318000,15,310150,0,0,0,0,0,0,136000,182000,-46000,-46000
20200430,044643,滬深2X群益96購01,,,,,0.00,0.00,0,0,0,0,0,0,0,0,0,0,0,0,0
20200430,04471P,華通元大95售03,,,,,0.00,0.00,0,0,0,0,0,0,0,0,0,0,0,0,0
20200430,044784,華邦電中信96購01,,,,,0.00,0.00,0,0,0,0,0,0,0,0,0,0,0,0,0
20200430,04478P,元油2X中信95售03,,,,,0.00,0.00,0,0,0,0,0,0,0,0,0,0,0,0,0
20200430,04479P,同欣電中信96售02,0.41,0.41,0.36,0.36,-0.09,-20.0,9000,3,3490,0,0,0,0,0,0,8000,1000,7000,7000
20200430,04483P,元油2X凱基97售04,,,,,0.00,0.00,0,0,0,0,0,0,0,0,0,0,0,0,0
20200430,044864,道瓊反國票96購01,0.47,0.58,0.45,0.46,-0.12,-20.69,243000,30,116500,0,0,0,0,0,0,0,0,0,0
20200430,04495P,台積電國票95售01,,,,,0.00,0.00,0,0,0,0,0,0,0,0,0,0,0,0,0
20200430,044963,台積電中信96購01,1.22,1.40,1.22,1.29,+0.16,14.16,56000,13,72500,0,0,0,0,0,0,6000,9000,-3000,-3000
20200430,04496P,國巨國泰96售02,,,,,0.00,0.00,0,0,0,0,0,0,0,0,0,0,0,0,0
20200430,044972,元金2X國票96購01,,,,,0.00,0.00,0,0,0,0,0,0,0,0,0,0,0,0,0
20200430,04497P,元油2X富邦97售03,,,,,0.00,0.00,0,0,0,0,0,0,0,0,0,0,0,0,0
20200430,04501P,元油2X元富98售07,,,,,0.00,0.00,0,0,0,0,0,0,0,0,0,0,0,0,0
20200430,04502P,元油2X元富98售08,,,,,0.00,0.00,0,0,0,0,0,0,0,0,0,0,0,0,0
20200430,04503P,元油2X元富98售09,,,,,0.00,0.00,0,0,0,0,0,0,0,0,0,0,0,0,0
20200430,045053,聯發科元富98購01,0.77,0.91,0.75,0.91,+0.26,40.0,589000,53,467150,0,0,0,0,0,0,460000,0,460000,460000
20200430,045054,聯發科元富98購02,1.40,1.60,1.37,1.60,+0.35,28.0,333000,39,490260,0,0,0,0,0,0,192000,0,192000,192000
20200430,045055,聯發科元富98購03,2.70,3.00,2.64,3.00,+0.70,30.43,121000,36,331940,0,0,0,0,0,0,90000,0,90000,90000
20200430,04505P,佳世達元富96售03,1.20,1.20,1.20,1.20,-0.14,-10.45,5000,1,6000,0,0,0,0,0,0,5000,0,5000,5000
20200430,045106,玉晶光群益95購01,,,,,0.00,0.00,0,0,0,0,0,0,0,0,0,0,0,0,0
20200430,04514P,元石油中信97售01,5.40,5.40,5.30,5.30,0.00,0.00,8000,5,42500,0,0,0,0,0,0,1000,0,1000,1000
20200430,04515P,元油2X群益97售02,,,,,0.00,0.00,0,0,0,0,0,0,0,0,0,0,0,0,0
20200430,045173,A50正2國票95購01,,,,,0.00,0.00,0,0,0,0,0,0,0,0,0,0,0,0,0
20200430,04517P,宏達電群益95售01,,,,,0.00,0.00,0,0,0,0,0,0,0,0,0,0,0,0,0
20200430,045189,大立光元富98購01,0.34,0.45,0.34,0.41,+0.09,28.13,407000,43,156730,0,0,0,0,0,0,183000,0,183000,183000
20200430,04518P,高鐵群益95售01,,,,,0.00,0.00,0,0,0,0,0,0,0,0,0,0,0,0,0
20200430,045213,A50正2元大95購01,,,,,0.00,0.00,0,0,0,0,0,0,0,0,0,0,0,0,0
20200430,045287,元油2X元大95購01,,,,,0.00,0.00,0,0,0,0,0,0,0,0,0,0,0,0,0
20200430,045288,元油2X元大95購02,,,,,0.00,0.00,0,0,0,0,0,0,0,0,0,0,0,0,0
20200430,045337,滬深2X凱基95購01,,,,,0.00,0.00,0,0,0,0,0,0,0,0,0,0,0,0,0
20200430,045371,元石油元大95購01,,,,,0.00,0.00,0,0,0,0,0,0,0,0,0,0,0,0,0
20200430,04543P,鴻海富邦95售03,,,,,0.00,0.00,0,0,0,0,0,0,0,0,0,0,0,0,0
20200430,045443,群創元富98購01,,,,,0.00,0.00,0,0,0,0,0,0,0,0,0,0,0,0,0
20200430,045444,群創元富98購02,0.73,0.73,0.73,0.73,+0.05,7.35,2000,1,1460,0,0,0,0,0,0,0,0,0,0
20200430,04544P,欣興富邦96售02,,,,,0.00,0.00,0,0,0,0,0,0,0,0,0,0,0,0,0
20200430,045479,T50反1中信95購01,,,,,0.00,0.00,0,0,0,0,0,0,0,0,0,0,0,0,0
20200430,045517,元油2X元富98購01,0.07,0.09,0.07,0.09,0.00,0.00,429000,11,35120,0,0,0,0,0,0,0,0,0,0
20200430,04553P,S&P正2中信95售01,,,,,0.00,0.00,0,0,0,0,0,0,0,0,0,0,0,0,0
20200430,045547,滬深2X國票95購01,,,,,0.00,0.00,0,0,0,0,0,0,0,0,0,0,0,0,0
20200430,04555P,元油2X群益95售01,,,,,0.00,0.00,0,0,0,0,0,0,0,0,0,0,0,0,0
20200430,045568,上証2X元大95購01,,,,,0.00,0.00,0,0,0,0,0,0,0,0,0,0,0,0,0
20200430,045571,元油2X元大95購04,,,,,0.00,0.00,0,0,0,0,0,0,0,0,0,0,0,0,0
20200430,045572,元油2X元大98購01,,,,,0.00,0.00,0,0,0,0,0,0,0,0,0,0,0,0,0
20200430,045600,道瓊指國票95購01,,,,,0.00,0.00,0,0,0,0,0,0,0,0,0,0,0,0,0
20200430,045618,元油2X永豐98購01,,,,,0.00,0.00,0,0,0,0,0,0,0,0,0,0,0,0,0
20200430,045664,元油2X元富96購01,,,,,0.00,0.00,0,0,0,0,0,0,0,0,0,0,0,0,0
20200430,045678,華新科元大95購01,,,,,0.00,0.00,0,0,0,0,0,0,0,0,0,0,0,0,0
20200430,04567P,臺股指凱基95售01,,,,,0.00,0.00,0,0,0,0,0,0,0,0,0,0,0,0,0
20200430,045685,康控元大95購01,,,,,0.00,0.00,0,0,0,0,0,0,0,0,0,0,0,0,0
20200430,04571P,華新科國泰95售03,,,,,0.00,0.00,0,0,0,0,0,0,0,0,0,0,0,0,0
20200430,045767,大立光元富95購01,1.30,1.45,1.20,1.45,+0.34,30.63,15000,7,19950,0,0,0,0,0,0,14000,0,14000,14000
20200430,045768,大立光元富95購02,0.26,0.29,0.26,0.29,0.00,0.00,15000,2,4200,0,0,0,0,0,0,15000,0,15000,15000
20200430,04578P,微星富邦96售01,,,,,0.00,0.00,0,0,0,0,0,0,0,0,0,0,0,0,0
20200430,045817,滬深2X凱基95購02,,,,,0.00,0.00,0,0,0,0,0,0,0,0,0,0,0,0,0
20200430,045829,滬深2X群益95購02,,,,,0.00,0.00,0,0,0,0,0,0,0,0,0,0,0,0,0
20200430,045836,群創群益98購01,0.75,0.75,0.75,0.75,+0.05,7.14,60000,6,45000,0,0,0,0,0,0,0,60000,-60000,-60000
20200430,045837,群創群益98購02,,,,,0.00,0.00,0,0,0,0,0,0,0,0,0,0,0,0,0
20200430,045842,T50反1台新98購01,0.17,0.21,0.16,0.17,-0.04,-19.05,695000,25,116690,0,0,0,0,0,0,125000,10000,115000,115000
20200430,045869,滬深2X元富95購01,,,,,0.00,0.00,0,0,0,0,0,0,0,0,0,0,0,0,0
20200430,045870,元油2X元富96購02,0.02,0.02,0.02,0.02,0.00,0.00,70000,2,1400,0,0,0,0,0,0,0,0,0,0
20200430,045871,元油2X元富96購03,,,,,0.00,0.00,0,0,0,0,0,0,0,0,0,0,0,0,0
20200430,045872,元油2X元富98購03,0.13,0.15,0.12,0.15,+0.04,36.36,4251000,136,568750,106000,0,106000,0,0,0,0,0,0,106000
20200430,045873,元油2X元富98購04,0.07,0.07,0.06,0.06,0.00,0.00,291000,7,18270,0,0,0,0,0,0,0,0,0,0
20200430,045877,友達元富95購01,,,,,0.00,0.00,0,0,0,0,0,0,0,0,0,0,0,0,0
20200430,045882,滬深2X元大95購01,0.10,0.10,0.10,0.10,0.00,0.00,30000,1,3000,0,0,0,0,0,0,30000,0,30000,30000
20200430,045883,元油2X元大95購07,,,,,0.00,0.00,0,0,0,0,0,0,0,0,0,0,0,0,0
20200430,04590P,元石油元大97售01,6.90,6.90,6.45,6.45,0.00,0.00,11000,8,73000,0,0,0,0,0,0,0,0,0,0
20200430,045991,為升富邦95購01,,,,,0.00,0.00,0,0,0,0,0,0,0,0,0,0,0,0,0
20200430,046011,欣興元富95購01,0.31,0.31,0.31,0.31,-0.03,-8.82,29000,8,8990,0,0,0,0,0,0,29000,0,29000,29000
20200430,046020,滬深2X元大95購02,,,,,0.00,0.00,0,0,0,0,0,0,0,0,0,0,0,0,0
20200430,04604P,華新科國票95售01,,,,,0.00,0.00,0,0,0,0,0,0,0,0,0,0,0,0,0
20200430,046061,中石化凱基98購01,0.42,0.48,0.42,0.47,+0.06,14.63,192000,9,87240,0,0,0,0,0,0,92000,90000,2000,2000
20200430,04606P,高股息中信96售01,,,,,0.00,0.00,0,0,0,0,0,0,0,0,0,0,0,0,0
20200430,046108,A50正2元大95購02,,,,,0.00,0.00,0,0,0,0,0,0,0,0,0,0,0,0,0
20200430,04611P,元油2X群益98售02,,,,,0.00,0.00,0,0,0,0,0,0,0,0,0,0,0,0,0
20200430,046145,矽力元富95購01,,,,,0.00,0.00,0,0,0,0,0,0,0,0,0,0,0,0,0
20200430,046147,道瓊指中信96購02,0.04,0.04,0.04,0.04,+0.01,33.33,126000,5,5040,0,0,0,0,0,0,0,0,0,0
20200430,046159,群創群益98購04,,,,,0.00,0.00,0,0,0,0,0,0,0,0,0,0,0,0,0
20200430,04616P,臺股指群益95售02,1.10,1.13,0.91,0.93,-0.50,-34.97,408000,10,389140,0,0,0,0,0,0,358000,50000,308000,308000
20200430,04617P,臺股指群益95售03,1.43,1.43,1.22,1.22,0.00,0.00,51000,6,65730,0,0,0,0,0,0,1000,50000,-49000,-49000
20200430,046191,新光金凱基98購01,,,,,0.00,0.00,0,0,0,0,0,0,0,0,0,0,0,0,0
20200430,046208,滬深2X元富95購03,,,,,0.00,0.00,0,0,0,0,0,0,0,0,0,0,0,0,0
20200430,046220,滬深2X元大95購03,,,,,0.00,0.00,0,0,0,0,0,0,0,0,0,0,0,0,0
20200430,04628P,欣興元大95售01,0.39,0.41,0.37,0.41,-0.30,-42.25,184000,6,73800,0,0,0,0,0,0,54000,130000,-76000,-76000
20200430,04630P,嘉聯益元大95售02,,,,,0.00,0.00,0,0,0,0,0,0,0,0,0,0,0,0,0
20200430,04631P,臺股指中信95售08,,,,,0.00,0.00,0,0,0,0,0,0,0,0,0,0,0,0,0
20200430,04633P,旺宏群益96售04,0.69,0.69,0.69,0.69,-0.25,-26.6,83000,2,57270,0,0,0,0,0,0,83000,0,83000,83000
20200430,046340,滬深2X國票96購01,,,,,0.00,0.00,0,0,0,0,0,0,0,0,0,0,0,0,0
20200430,046375,友達凱基98購01,,,,,0.00,0.00,0,0,0,0,0,0,0,0,0,0,0,0,0
20200430,046383,群創凱基98購01,,,,,0.00,0.00,0,0,0,0,0,0,0,0,0,0,0,0,0
20200430,046384,群創凱基98購02,0.99,1.03,0.99,1.01,+0.03,3.06,46000,6,47020,0,0,0,0,0,0,14000,32000,-18000,-18000
20200430,046385,群創凱基98購03,0.48,0.48,0.48,0.48,+0.08,20.0,40000,1,19200,0,0,0,0,0,0,0,0,0,0
20200430,046438,群創群益95購01,,,,,0.00,0.00,0,0,0,0,0,0,0,0,0,0,0,0,0
20200430,046465,GIS凱基95購01,,,,,0.00,0.00,0,0,0,0,0,0,0,0,0,0,0,0,0
20200430,046476,鴻海統一96購01,,,,,0.00,0.00,0,0,0,0,0,0,0,0,0,0,0,0,0
20200430,046480,群創元富96購01,,,,,0.00,0.00,0,0,0,0,0,0,0,0,0,0,0,0,0
20200430,046491,滬深2X富邦95購02,,,,,0.00,0.00,0,0,0,0,0,0,0,0,0,0,0,0,0
20200430,046562,大立光凱基95購01,,,,,0.00,0.00,0,0,0,0,0,0,0,0,0,0,0,0,0
20200430,046568,臻鼎元富95購01,0.01,0.03,0.01,0.03,0.00,0.00,120000,4,1600,0,0,0,0,0,0,90000,0,90000,90000
20200430,046627,高鐵統一95購01,,,,,0.00,0.00,0,0,0,0,0,0,0,0,0,0,0,0,0
20200430,046628,大立光統一98購01,1.46,1.66,1.46,1.66,+0.30,22.06,791000,37,1234080,0,0,0,0,0,0,100000,681000,-581000,-581000
20200430,046629,群創統一98購01,0.78,0.79,0.78,0.79,+0.05,6.76,70000,3,54640,0,0,0,0,0,0,20000,50000,-30000,-30000
20200430,046630,京元電元富95購03,0.73,0.73,0.71,0.71,-0.04,-5.33,231000,5,166630,0,0,0,0,0,0,101000,130000,-29000,-29000
20200430,046680,上証反群益95購01,,,,,0.00,0.00,0,0,0,0,0,0,0,0,0,0,0,0,0
20200430,046703,瑞昱元富95購01,1.75,2.09,1.67,1.92,+0.43,28.86,44000,11,79300,0,0,0,0,0,0,44000,0,44000,44000
20200430,046719,元石油元大95購02,,,,,0.00,0.00,0,0,0,0,0,0,0,0,0,0,0,0,0
20200430,046720,元油2X元大95購08,,,,,0.00,0.00,0,0,0,0,0,0,0,0,0,0,0,0,0
20200430,04674P,全新統一95售01,,,,,0.00,0.00,0,0,0,0,0,0,0,0,0,0,0,0,0
20200430,046791,台郡統一96購01,,,,,0.00,0.00,0,0,0,0,0,0,0,0,0,0,0,0,0
20200430,046792,京元電元富96購01,,,,,0.00,0.00,0,0,0,0,0,0,0,0,0,0,0,0,0
20200430,046793,聯發科元富99購01,0.82,0.93,0.82,0.93,+0.26,38.81,67000,5,55970,0,0,0,0,0,0,67000,0,67000,67000
20200430,046797,T50反1元大96購01,0.10,0.10,0.10,0.10,0.00,0.00,298000,6,29800,0,0,0,0,0,0,0,0,0,0
20200430,046798,元油2X元大96購01,,,,,0.00,0.00,0,0,0,0,0,0,0,0,0,0,0,0,0
20200430,046813,聯電凱基96購01,2.16,2.16,2.13,2.13,+0.08,3.9,21000,2,44940,0,0,0,0,0,0,21000,0,21000,21000
20200430,04682P,臺股指統一96售01,,,,,0.00,0.00,0,0,0,0,0,0,0,0,0,0,0,0,0
20200430,046864,和大統一97購01,0.05,0.05,0.05,0.05,0.00,0.00,8000,1,400,0,0,0,0,0,0,0,0,0,0
20200430,046881,智原富邦99購01,0.34,0.36,0.34,0.36,+0.03,9.09,272000,15,94520,0,0,0,0,0,0,50000,222000,-172000,-172000
20200430,046882,智易富邦97購01,,,,,0.00,0.00,0,0,0,0,0,0,0,0,0,0,0,0,0
20200430,046903,友達凱基99購01,,,,,0.00,0.00,0,0,0,0,0,0,0,0,0,0,0,0,0
20200430,046905,新光金凱基99購01,,,,,0.00,0.00,0,0,0,0,0,0,0,0,0,0,0,0,0
20200430,046906,新光金凱基99購02,0.91,0.94,0.91,0.94,+0.03,3.3,211000,6,193660,0,0,0,0,0,0,156000,55000,101000,101000
20200430,046914,友達台新96購01,,,,,0.00,0.00,0,0,0,0,0,0,0,0,0,0,0,0,0
20200430,046928,奇鋐富邦97購01,0.53,0.54,0.49,0.53,+0.04,8.16,200000,10,102660,0,0,0,0,0,0,62000,138000,-76000,-76000
20200430,046934,智邦元富96購01,1.03,1.03,1.03,1.03,-0.17,-14.17,1000,1,1030,0,0,0,0,0,0,0,1000,-1000,-1000
20200430,046937,聯電元大99購01,2.08,2.15,2.05,2.15,+0.12,5.91,222000,10,466970,0,0,0,0,0,0,164000,58000,106000,106000
20200430,046939,燿華元大96購01,,,,,0.00,0.00,0,0,0,0,0,0,0,0,0,0,0,0,0
20200430,04693P,超眾群益95售01,,,,,0.00,0.00,0,0,0,0,0,0,0,0,0,0,0,0,0
20200430,046942,友達元大99購01,1.06,1.08,1.06,1.08,+0.03,2.86,104000,6,112060,0,0,0,0,0,0,104000,0,104000,104000
20200430,046944,奇力新元大96購01,2.98,3.14,2.98,3.14,+0.51,19.39,11000,2,34380,0,0,0,0,0,0,10000,11000,-1000,-1000
20200430,046949,群創元大99購01,0.35,0.35,0.35,0.35,+0.01,2.94,1000,1,350,0,0,0,0,0,0,0,0,0,0
20200430,04696P,亞德客國泰95售02,,,,,0.00,0.00,0,0,0,0,0,0,0,0,0,0,0,0,0
20200430,046999,康控富邦99購01,0.13,0.16,0.13,0.14,0.00,0.00,140000,8,19230,0,0,0,0,0,0,129000,0,129000,129000
20200430,047004,台積電統一99購01,2.49,2.50,2.39,2.50,-0.05,-1.96,38000,10,93360,0,0,0,0,0,0,12000,11000,1000,1000
20200430,047013,超眾元富96購01,,,,,0.00,0.00,0,0,0,0,0,0,0,0,0,0,0,0,0
20200430,047014,元油反元大99購01,,,,,0.00,0.00,0,0,0,0,0,0,0,0,0,0,0,0,0
20200430,047033,日月光中信95購01,,,,,0.00,0.00,0,0,0,0,0,0,0,0,0,0,0,0,0
20200430,04703P,樺漢統一95售01,,,,,0.00,0.00,0,0,0,0,0,0,0,0,0,0,0,0,0
20200430,047047,旺宏國票95購01,0.01,0.01,0.01,0.01,0.00,0.00,100000,3,1000,0,0,0,0,0,0,100000,0,100000,100000
20200430,04704P,臺股指統一95售01,,,,,0.00,0.00,0,0,0,0,0,0,0,0,0,0,0,0,0
20200430,04705P,臺股指統一95售02,,,,,0.00,0.00,0,0,0,0,0,0,0,0,0,0,0,0,0
20200430,047063,漢唐凱基95購01,,,,,0.00,0.00,0,0,0,0,0,0,0,0,0,0,0,0,0
20200430,04706P,力山元大95售01,0.18,0.28,0.18,0.28,-0.02,-6.67,450000,5,85000,0,0,0,0,0,0,430000,20000,410000,410000
20200430,047096,元油反國泰96購01,,,,,0.00,0.00,0,0,0,0,0,0,0,0,0,0,0,0,0
20200430,047102,潤泰全富邦95購01,,,,,0.00,0.00,0,0,0,0,0,0,0,0,0,0,0,0,0
20200430,047123,中石化中信95購01,0.01,0.01,0.01,0.01,0.00,0.00,40000,40,400,0,0,0,0,0,0,0,0,0,0
20200430,047127,臻鼎中信95購01,,,,,0.00,0.00,0,0,0,0,0,0,0,0,0,0,0,0,0
20200430,04713P,創意元大95售01,0.18,0.18,0.17,0.17,-0.07,-29.17,30000,3,5200,0,0,0,0,0,0,30000,0,30000,30000
20200430,047145,鴻海群益95購01,,,,,0.00,0.00,0,0,0,0,0,0,0,0,0,0,0,0,0
20200430,047154,新光金國票95購01,,,,,0.00,0.00,0,0,0,0,0,0,0,0,0,0,0,0,0
20200430,047169,滬深2X永豐95購01,,,,,0.00,0.00,0,0,0,0,0,0,0,0,0,0,0,0,0
20200430,047194,世紀鋼元大96購01,2.14,2.22,2.14,2.22,+0.21,10.45,20000,2,43600,0,0,0,0,0,0,0,10000,-10000,-10000
20200430,047196,上銀統一97購01,0.53,0.89,0.53,0.89,+0.40,81.63,340000,35,204550,0,0,0,0,0,0,258000,2000,256000,256000
20200430,047202,欣興元富96購01,,,,,0.00,0.00,0,0,0,0,0,0,0,0,0,0,0,0,0
20200430,047209,滬深2X富邦96購01,,,,,0.00,0.00,0,0,0,0,0,0,0,0,0,0,0,0,0
20200430,047210,漢唐富邦95購01,,,,,0.00,0.00,0,0,0,0,0,0,0,0,0,0,0,0,0
20200430,047211,華新科富邦99購01,2.56,2.56,2.56,2.56,+0.06,2.4,1000,1,2560,0,0,0,0,0,0,0,0,0,0
20200430,047212,宏達電富邦97購01,,,,,0.00,0.00,0,0,0,0,0,0,0,0,0,0,0,0,0
20200430,047213,新日興富邦97購01,,,,,0.00,0.00,0,0,0,0,0,0,0,0,0,0,0,0,0
20200430,047214,啟碁富邦97購01,0.02,0.12,0.02,0.12,0.00,0.00,22000,2,540,0,0,0,0,0,0,21000,1000,20000,20000
20200430,047231,大立光凱基95購03,,,,,0.00,0.00,0,0,0,0,0,0,0,0,0,0,0,0,0
20200430,047248,奇鋐群益95購01,0.09,0.09,0.09,0.09,0.00,0.00,50000,1,4500,0,0,0,0,0,0,50000,0,50000,50000
20200430,04727P,臺股指凱基96售03,0.45,0.55,0.45,0.55,0.00,0.00,11000,2,5050,0,0,0,0,0,0,0,10000,-10000,-10000
20200430,047285,鴻海統一95購02,,,,,0.00,0.00,0,0,0,0,0,0,0,0,0,0,0,0,0
20200430,047287,貿聯統一95購01,,,,,0.00,0.00,0,0,0,0,0,0,0,0,0,0,0,0,0
20200430,047289,啟碁統一97購01,,,,,0.00,0.00,0,0,0,0,0,0,0,0,0,0,0,0,0
20200430,047292,台光電元富96購01,,,,,0.00,0.00,0,0,0,0,0,0,0,0,0,0,0,0,0
20200430,047295,欣興元富96購02,,,,,0.00,0.00,0,0,0,0,0,0,0,0,0,0,0,0,0
20200430,047296,日月光元富96購01,,,,,0.00,0.00,0,0,0,0,0,0,0,0,0,0,0,0,0
20200430,047298,聯茂元富96購01,,,,,0.00,0.00,0,0,0,0,0,0,0,0,0,0,0,0,0
20200430,04729P,臺股指中信96售01,,,,,0.00,0.00,0,0,0,0,0,0,0,0,0,0,0,0,0
20200430,047302,為升富邦97購01,,,,,0.00,0.00,0,0,0,0,0,0,0,0,0,0,0,0,0
20200430,047303,寶滬深元大96購01,0.17,0.17,0.16,0.16,+0.01,6.67,14000,2,2340,0,0,0,0,0,0,14000,0,14000,14000
20200430,047304,元油2X元大96購02,,,,,0.00,0.00,0,0,0,0,0,0,0,0,0,0,0,0,0
20200430,04730P,臺股指中信96售02,,,,,0.00,0.00,0,0,0,0,0,0,0,0,0,0,0,0,0
20200430,04731P,臺股指中信96售03,0.93,0.93,0.87,0.87,-0.14,-13.86,72000,9,63210,0,0,0,0,0,0,0,72000,-72000,-72000
20200430,04733P,康控兆豐95售01,,,,,0.00,0.00,0,0,0,0,0,0,0,0,0,0,0,0,0
20200430,047342,T50反1中信99購01,,,,,0.00,0.00,0,0,0,0,0,0,0,0,0,0,0,0,0
20200430,047343,台達電中信95購01,,,,,0.00,0.00,0,0,0,0,0,0,0,0,0,0,0,0,0
20200430,047360,鴻海群益95購02,,,,,0.00,0.00,0,0,0,0,0,0,0,0,0,0,0,0,0
20200430,047379,元油2X元大96購03,,,,,0.00,0.00,0,0,0,0,0,0,0,0,0,0,0,0,0
20200430,047383,鴻海元大95購01,,,,,0.00,0.00,0,0,0,0,0,0,0,0,0,0,0,0,0
20200430,047388,京元電元大95購01,,,,,0.00,0.00,0,0,0,0,0,0,0,0,0,0,0,0,0
20200430,047405,香港2X統一96購01,,,,,0.00,0.00,0,0,0,0,0,0,0,0,0,0,0,0,0
20200430,047408,嘉晶統一95購01,0.03,0.03,0.03,0.03,0.00,0.00,3000,1,90,0,0,0,0,0,0,0,0,0,0
20200430,04740P,台積電富邦95售02,,,,,0.00,0.00,0,0,0,0,0,0,0,0,0,0,0,0,0
20200430,047410,上銀元富96購01,0.62,0.95,0.59,0.95,+0.42,79.25,1290000,52,891570,0,0,0,0,0,0,351000,939000,-588000,-588000
20200430,047417,台塑富邦97購01,0.14,0.15,0.14,0.15,+0.05,50.0,1095000,17,158980,0,0,0,0,0,0,910000,0,910000,910000
20200430,047418,智邦富邦97購01,1.75,1.84,1.57,1.57,-0.15,-8.72,27000,17,46590,0,0,0,0,0,0,20000,0,20000,20000
20200430,047419,聯發科富邦95購01,0.01,0.01,0.01,0.01,0.00,0.00,159000,4,1590,0,0,0,0,0,0,159000,0,159000,159000
20200430,047420,全新富邦97購01,0.19,0.19,0.19,0.19,+0.01,5.56,50000,1,9500,0,0,0,0,0,0,50000,0,50000,50000
20200430,047421,聯茂富邦97購01,0.28,0.28,0.24,0.27,-0.01,-3.57,574000,21,152500,0,0,0,0,0,0,479000,95000,384000,384000
20200430,047439,漢唐元大95購01,,,,,0.00,0.00,0,0,0,0,0,0,0,0,0,0,0,0,0
20200430,047454,滬深2X群益96購03,,,,,0.00,0.00,0,0,0,0,0,0,0,0,0,0,0,0,0
20200430,047457,旺宏群益95購01,0.16,0.16,0.15,0.15,+0.06,66.67,55000,5,8700,0,0,0,0,0,0,55000,0,55000,55000
20200430,047460,富邦金群益95購01,,,,,0.00,0.00,0,0,0,0,0,0,0,0,0,0,0,0,0
20200430,047466,新光金國泰95購01,,,,,0.00,0.00,0,0,0,0,0,0,0,0,0,0,0,0,0
20200430,047467,滬深2X中信95購06,,,,,0.00,0.00,0,0,0,0,0,0,0,0,0,0,0,0,0
20200430,047468,為升中信95購01,,,,,0.00,0.00,0,0,0,0,0,0,0,0,0,0,0,0,0
20200430,047482,新光金凱基99購03,,,,,0.00,0.00,0,0,0,0,0,0,0,0,0,0,0,0,0
20200430,047483,新光金凱基99購04,0.16,0.16,0.16,0.16,0.00,0.00,5000,1,800,0,0,0,0,0,0,5000,0,5000,5000
20200430,047493,旺宏元富96購01,0.36,0.36,0.36,0.36,0.00,0.00,120000,1,43200,0,0,0,0,0,0,120000,0,120000,120000
20200430,047494,華邦電元富96購01,,,,,0.00,0.00,0,0,0,0,0,0,0,0,0,0,0,0,0
20200430,047495,新日興元富96購01,,,,,0.00,0.00,0,0,0,0,0,0,0,0,0,0,0,0,0
20200430,047504,滬深2X國票9A購01,0.10,0.11,0.10,0.10,+0.01,11.11,380000,10,38100,0,0,0,0,0,0,0,0,0,0
20200430,047505,元金2X國票9B購01,1.36,1.41,1.36,1.41,-0.04,-2.76,28000,6,38550,0,0,0,0,0,0,0,0,0,0
20200430,047517,元油反元大96購01,,,,,0.00,0.00,0,0,0,0,0,0,0,0,0,0,0,0,0
20200430,04751P,智邦兆豐95售02,,,,,0.00,0.00,0,0,0,0,0,0,0,0,0,0,0,0,0
20200430,047547,友達凱基99購02,,,,,0.00,0.00,0,0,0,0,0,0,0,0,0,0,0,0,0
20200430,047548,友達凱基99購03,,,,,0.00,0.00,0,0,0,0,0,0,0,0,0,0,0,0,0
20200430,047556,群創凱基95購01,,,,,0.00,0.00,0,0,0,0,0,0,0,0,0,0,0,0,0
20200430,047564,滬深2X國票99購01,0.24,0.25,0.23,0.23,+0.02,9.52,80000,3,18700,0,0,0,0,0,0,0,80000,-80000,-80000
20200430,047571,滬深2X群益99購01,0.11,0.12,0.10,0.10,+0.04,66.67,63000,4,6840,0,0,0,0,0,0,0,13000,-13000,-13000
20200430,047572,深中小群益95購01,,,,,0.00,0.00,0,0,0,0,0,0,0,0,0,0,0,0,0
20200430,047582,滬深2X永豐95購02,,,,,0.00,0.00,0,0,0,0,0,0,0,0,0,0,0,0,0
20200430,047584,元金2X永豐95購01,0.48,0.65,0.48,0.65,0.00,0.00,45000,6,24410,0,0,0,0,0,0,0,0,0,0
20200430,047595,元石油元富97購01,0.05,0.08,0.05,0.06,-0.01,-14.29,417000,13,26140,0,0,0,0,0,0,0,0,0,0
20200430,047596,元油反元富97購01,,,,,0.00,0.00,0,0,0,0,0,0,0,0,0,0,0,0,0
20200430,047604,智原國泰95購01,,,,,0.00,0.00,0,0,0,0,0,0,0,0,0,0,0,0,0
20200430,047608,聯發科第一95購01,,,,,0.00,0.00,0,0,0,0,0,0,0,0,0,0,0,0,0
20200430,047628,新光金國票95購02,,,,,0.00,0.00,0,0,0,0,0,0,0,0,0,0,0,0,0
20200430,047629,深中小元大96購01,,,,,0.00,0.00,0,0,0,0,0,0,0,0,0,0,0,0,0
20200430,047630,元油反元大96購02,28.30,28.30,25.80,25.80,0.00,0.00,7000,5,188400,0,0,0,0,0,0,4000,2000,2000,2000
20200430,04763P,臺股指凱基96售05,,,,,0.00,0.00,0,0,0,0,0,0,0,0,0,0,0,0,0
20200430,047643,新光金元大95購02,,,,,0.00,0.00,0,0,0,0,0,0,0,0,0,0,0,0,0
20200430,047661,滬深2X永豐96購01,,,,,0.00,0.00,0,0,0,0,0,0,0,0,0,0,0,0,0
20200430,047673,瑞昱元富96購01,1.04,1.18,0.98,1.17,+0.26,28.57,860000,54,905510,0,0,0,0,0,0,348000,493000,-145000,-145000
20200430,047674,群創元富96購02,,,,,0.00,0.00,0,0,0,0,0,0,0,0,0,0,0,0,0
20200430,047675,群創元富96購03,0.47,0.48,0.47,0.48,+0.03,6.67,36000,4,16980,0,0,0,0,0,0,0,36000,-36000,-36000
20200430,047676,臺股指元富99購01,,,,,0.00,0.00,0,0,0,0,0,0,0,0,0,0,0,0,0
20200430,04767P,台積電國泰95售04,,,,,0.00,0.00,0,0,0,0,0,0,0,0,0,0,0,0,0
20200430,047680,上証反中信96購01,0.18,0.18,0.17,0.17,0.00,0.00,909000,3,163520,0,0,0,0,0,0,899000,10000,889000,889000
20200430,047681,滬深反中信95購01,0.10,0.10,0.10,0.10,0.00,0.00,8000,1,800,0,0,0,0,0,0,8000,0,8000,8000
20200430,047683,亞德客國泰95購01,,,,,0.00,0.00,0,0,0,0,0,0,0,0,0,0,0,0,0
20200430,047685,嘉聯益國泰95購01,,,,,0.00,0.00,0,0,0,0,0,0,0,0,0,0,0,0,0
20200430,047687,元金2X富邦96購01,,,,,0.00,0.00,0,0,0,0,0,0,0,0,0,0,0,0,0
20200430,047688,亞德客富邦95購01,,,,,0.00,0.00,0,0,0,0,0,0,0,0,0,0,0,0,0
20200430,047689,瑞昱富邦97購01,0.84,1.08,0.84,1.04,+0.30,40.54,46000,8,46440,0,0,0,0,0,0,10000,28000,-18000,-18000
20200430,04768P,大立光國泰96售03,1.47,1.47,1.42,1.42,0.00,0.00,23000,3,33720,0,0,0,0,0,0,21000,2000,19000,19000
20200430,047690,美律富邦97購01,0.12,0.15,0.12,0.14,+0.02,16.67,1160000,6,144800,0,0,0,0,0,0,1160000,0,1160000,1160000
20200430,047693,T50反1國票95購01,,,,,0.00,0.00,0,0,0,0,0,0,0,0,0,0,0,0,0
20200430,047694,SP黃豆國票9B購01,0.53,0.55,0.53,0.55,+0.03,5.77,50000,4,27200,0,0,0,0,0,0,0,0,0,0
20200430,047706,燿華凱基95購01,,,,,0.00,0.00,0,0,0,0,0,0,0,0,0,0,0,0,0
20200430,04771P,友達元大96售02,,,,,0.00,0.00,0,0,0,0,0,0,0,0,0,0,0,0,0
20200430,047733,友達兆豐95購01,,,,,0.00,0.00,0,0,0,0,0,0,0,0,0,0,0,0,0
20200430,047760,元油反元大96購03,,,,,0.00,0.00,0,0,0,0,0,0,0,0,0,0,0,0,0
20200430,047768,大立光元大95購01,,,,,0.00,0.00,0,0,0,0,0,0,0,0,0,0,0,0,0
20200430,047769,大立光元大96購01,0.65,0.82,0.65,0.82,+0.20,32.26,56000,14,40760,0,0,0,0,0,0,0,8000,-8000,-8000
20200430,047773,超眾元大96購01,,,,,0.00,0.00,0,0,0,0,0,0,0,0,0,0,0,0,0
20200430,047774,台表科元大95購01,,,,,0.00,0.00,0,0,0,0,0,0,0,0,0,0,0,0,0
20200430,047775,緯穎元大95購01,,,,,0.00,0.00,0,0,0,0,0,0,0,0,0,0,0,0,0
20200430,047780,友達中信96購01,,,,,0.00,0.00,0,0,0,0,0,0,0,0,0,0,0,0,0
20200430,047782,燿華國泰95購01,,,,,0.00,0.00,0,0,0,0,0,0,0,0,0,0,0,0,0
20200430,047802,滬深2X凱基95購03,,,,,0.00,0.00,0,0,0,0,0,0,0,0,0,0,0,0,0
20200430,047825,道瓊反元大96購01,,,,,0.00,0.00,0,0,0,0,0,0,0,0,0,0,0,0,0
20200430,04782P,智伸科統一96售01,,,,,0.00,0.00,0,0,0,0,0,0,0,0,0,0,0,0,0
20200430,047854,滬深2X國票96購02,0.40,0.40,0.40,0.40,+0.03,8.11,50000,1,20000,0,0,0,0,0,0,50000,0,50000,50000
20200430,04786P,鴻海永昌96售01,,,,,0.00,0.00,0,0,0,0,0,0,0,0,0,0,0,0,0
20200430,047877,滬深2X中信95購07,,,,,0.00,0.00,0,0,0,0,0,0,0,0,0,0,0,0,0
20200430,04787P,台積電永昌96售04,,,,,0.00,0.00,0,0,0,0,0,0,0,0,0,0,0,0,0
20200430,047881,和鑫國泰95購01,,,,,0.00,0.00,0,0,0,0,0,0,0,0,0,0,0,0,0
20200430,047885,元金2X富邦99購01,2.10,2.10,2.10,2.10,0.00,0.00,36000,7,75600,0,0,0,0,0,0,0,1000,-1000,-1000
20200430,047886,京元電富邦95購01,,,,,0.00,0.00,0,0,0,0,0,0,0,0,0,0,0,0,0
20200430,047887,智原富邦97購01,,,,,0.00,0.00,0,0,0,0,0,0,0,0,0,0,0,0,0
20200430,04788P,台積電永昌96售05,0.08,0.08,0.04,0.05,-0.04,-44.44,370000,7,18600,0,0,0,0,0,0,0,370000,-370000,-370000
20200430,04789P,台積電富邦95售03,,,,,0.00,0.00,0,0,0,0,0,0,0,0,0,0,0,0,0
20200430,047903,滬深2X元大96購01,,,,,0.00,0.00,0,0,0,0,0,0,0,0,0,0,0,0,0
20200430,047904,臺指反元大96購01,,,,,0.00,0.00,0,0,0,0,0,0,0,0,0,0,0,0,0
20200430,047905,元油反元大96購04,,,,,0.00,0.00,0,0,0,0,0,0,0,0,0,0,0,0,0
20200430,047937,元金2X國票97購02,,,,,0.00,0.00,0,0,0,0,0,0,0,0,0,0,0,0,0
20200430,047944,中石化元富96購01,,,,,0.00,0.00,0,0,0,0,0,0,0,0,0,0,0,0,0
20200430,04794P,友達元大96售03,,,,,0.00,0.00,0,0,0,0,0,0,0,0,0,0,0,0,0
20200430,047962,T50反1中信96購02,0.43,0.46,0.38,0.39,-0.10,-20.41,2911000,88,1181250,0,0,0,0,0,0,478000,2430000,-1952000,-1952000
20200430,047964,元油反中信95購01,,,,,0.00,0.00,0,0,0,0,0,0,0,0,0,0,0,0,0
20200430,047967,南亞科國泰95購01,,,,,0.00,0.00,0,0,0,0,0,0,0,0,0,0,0,0,0
20200430,047969,台達電富邦97購01,0.26,0.30,0.26,0.30,0.00,0.00,66000,7,18640,0,0,0,0,0,0,53000,0,53000,53000
20200430,047970,鴻海富邦95購01,,,,,0.00,0.00,0,0,0,0,0,0,0,0,0,0,0,0,0
20200430,047971,南亞科富邦95購01,,,,,0.00,0.00,0,0,0,0,0,0,0,0,0,0,0,0,0
20200430,047972,康控富邦95購01,,,,,0.00,0.00,0,0,0,0,0,0,0,0,0,0,0,0,0
20200430,047978,元油反群益97購01,,,,,0.00,0.00,0,0,0,0,0,0,0,0,0,0,0,0,0
20200430,047979,中石化群益95購01,,,,,0.00,0.00,0,0,0,0,0,0,0,0,0,0,0,0,0
20200430,047989,深中小元大96購02,,,,,0.00,0.00,0,0,0,0,0,0,0,0,0,0,0,0,0
20200430,04798P,牧德元大95售02,,,,,0.00,0.00,0,0,0,0,0,0,0,0,0,0,0,0,0
20200430,047990,臺指反元大96購02,,,,,0.00,0.00,0,0,0,0,0,0,0,0,0,0,0,0,0
20200430,047991,元油反元大96購05,,,,,0.00,0.00,0,0,0,0,0,0,0,0,0,0,0,0,0
20200430,047992,東陽元大96購01,,,,,0.00,0.00,0,0,0,0,0,0,0,0,0,0,0,0,0
20200430,047993,鑽全元大96購01,,,,,0.00,0.00,0,0,0,0,0,0,0,0,0,0,0,0,0
20200430,047995,台達電元大96購01,0.36,0.39,0.36,0.39,+0.08,25.81,88000,9,32580,0,0,0,0,0,0,68000,10000,58000,58000
20200430,048001,中工元大96購01,0.39,0.40,0.39,0.40,+0.04,11.11,22000,3,8700,0,0,0,0,0,0,11000,21000,-10000,-10000
20200430,048007,明基材元大96購01,0.20,0.20,0.20,0.20,0.00,0.00,5000,1,1000,0,0,0,0,0,0,0,0,0,0
20200430,048008,聯發科富邦95購02,0.10,0.15,0.10,0.15,0.00,0.00,23000,3,2850,0,0,0,0,0,0,23000,0,23000,23000
20200430,048010,嘉聯益富邦97購01,,,,,0.00,0.00,0,0,0,0,0,0,0,0,0,0,0,0,0
20200430,048020,滬深2X凱基96購02,,,,,0.00,0.00,0,0,0,0,0,0,0,0,0,0,0,0,0
20200430,048049,滬深反中信96購01,0.19,0.19,0.19,0.19,0.00,0.00,1000,1,190,0,0,0,0,0,0,0,1000,-1000,-1000
20200430,048054,鴻海國泰95購01,,,,,0.00,0.00,0,0,0,0,0,0,0,0,0,0,0,0,0
20200430,048055,燿華國泰95購02,,,,,0.00,0.00,0,0,0,0,0,0,0,0,0,0,0,0,0
20200430,048058,大立光國泰95購01,,,,,0.00,0.00,0,0,0,0,0,0,0,0,0,0,0,0,0
20200430,048059,欣興國泰95購01,0.14,0.14,0.12,0.14,+0.03,27.27,105000,3,14500,0,0,0,0,0,0,100000,0,100000,100000
20200430,048061,鴻海統一95購03,,,,,0.00,0.00,0,0,0,0,0,0,0,0,0,0,0,0,0
20200430,048068,南亞科元富95購01,,,,,0.00,0.00,0,0,0,0,0,0,0,0,0,0,0,0,0
20200430,048069,南亞科元富95購02,,,,,0.00,0.00,0,0,0,0,0,0,0,0,0,0,0,0,0
20200430,048070,聯發科元富99購03,0.54,0.60,0.53,0.60,+0.15,33.33,119000,5,65200,0,0,0,0,0,0,119000,0,119000,119000
20200430,048080,元石油凱基96購01,,,,,0.00,0.00,0,0,0,0,0,0,0,0,0,0,0,0,0
20200430,048081,元油反凱基96購01,,,,,0.00,0.00,0,0,0,0,0,0,0,0,0,0,0,0,0
20200430,048105,滬深2X群益99購02,0.22,0.22,0.22,0.22,0.00,0.00,5000,1,1100,0,0,0,0,0,0,5000,0,5000,5000
20200430,048119,臺指反元大96購03,,,,,0.00,0.00,0,0,0,0,0,0,0,0,0,0,0,0,0
20200430,048122,台達電元大96購02,0.15,0.15,0.15,0.15,0.00,0.00,80000,1,12000,0,0,0,0,0,0,80000,0,80000,80000
20200430,048124,大立光元大95購03,,,,,0.00,0.00,0,0,0,0,0,0,0,0,0,0,0,0,0
20200430,048125,和鑫元大96購01,0.06,0.06,0.06,0.06,0.00,0.00,10000,1,600,0,0,0,0,0,0,0,10000,-10000,-10000
20200430,048128,超眾元大95購01,,,,,0.00,0.00,0,0,0,0,0,0,0,0,0,0,0,0,0
20200430,04812P,國巨元大95售03,,,,,0.00,0.00,0,0,0,0,0,0,0,0,0,0,0,0,0
20200430,048130,美利達元大96購01,,,,,0.00,0.00,0,0,0,0,0,0,0,0,0,0,0,0,0
20200430,048147,元油反元富95購01,,,,,0.00,0.00,0,0,0,0,0,0,0,0,0,0,0,0,0
20200430,048149,泰鼎元富95購01,,,,,0.00,0.00,0,0,0,0,0,0,0,0,0,0,0,0,0
20200430,04814P,健策元大96售01,,,,,0.00,0.00,0,0,0,0,0,0,0,0,0,0,0,0,0
20200430,048158,大立光兆豐95購01,0.03,0.03,0.03,0.03,0.00,0.00,10000,1,300,0,0,0,0,0,0,10000,0,10000,10000
20200430,048160,GIS兆豐95購01,,,,,0.00,0.00,0,0,0,0,0,0,0,0,0,0,0,0,0
20200430,048166,滬深2X永豐96購02,,,,,0.00,0.00,0,0,0,0,0,0,0,0,0,0,0,0,0
20200430,048175,矽力國泰95購01,,,,,0.00,0.00,0,0,0,0,0,0,0,0,0,0,0,0,0
20200430,048177,臺指反富邦99購01,0.32,0.32,0.32,0.32,-0.07,-17.95,10000,1,3200,0,0,0,0,0,0,0,10000,-10000,-10000
20200430,048178,上銀富邦95購02,0.05,0.09,0.05,0.09,0.00,0.00,224000,6,14380,0,0,0,0,0,0,224000,0,224000,224000
20200430,048179,臻鼎富邦97購01,0.23,0.25,0.23,0.25,+0.05,25.0,53000,6,12990,0,0,0,0,0,0,0,0,0,0
20200430,04817P,創意國票95售02,0.55,0.55,0.55,0.55,-0.24,-30.38,38000,1,20900,0,0,0,0,0,0,38000,0,38000,38000
20200430,048181,A50正2群益95購01,,,,,0.00,0.00,0,0,0,0,0,0,0,0,0,0,0,0,0
20200430,048186,元黃金元大96購01,,,,,0.00,0.00,0,0,0,0,0,0,0,0,0,0,0,0,0
20200430,048187,臺指反元大96購04,,,,,0.00,0.00,0,0,0,0,0,0,0,0,0,0,0,0,0
20200430,048188,臺指反元大96購05,,,,,0.00,0.00,0,0,0,0,0,0,0,0,0,0,0,0,0
20200430,048189,臺指反元大96購06,0.90,0.90,0.88,0.88,-0.12,-12.0,252000,10,223900,0,0,0,0,0,0,150000,72000,78000,78000
20200430,048190,道瓊反元大96購02,,,,,0.00,0.00,0,0,0,0,0,0,0,0,0,0,0,0,0
20200430,048192,華通元大96購01,1.43,1.74,1.43,1.66,+0.43,34.96,65000,11,103350,0,0,0,0,0,0,45000,16000,29000,29000
20200430,048214,滬深2X凱基96購03,,,,,0.00,0.00,0,0,0,0,0,0,0,0,0,0,0,0,0
20200430,048215,A50正2凱基95購01,,,,,0.00,0.00,0,0,0,0,0,0,0,0,0,0,0,0,0
20200430,048221,鴻海凱基95購01,,,,,0.00,0.00,0,0,0,0,0,0,0,0,0,0,0,0,0
20200430,048236,A50正2國票97購02,,,,,0.00,0.00,0,0,0,0,0,0,0,0,0,0,0,0,0
20200430,048248,聯發科兆豐95購01,0.10,0.15,0.10,0.15,+0.08,114.29,209000,13,26960,0,0,0,0,0,0,209000,0,209000,209000
20200430,048261,鴻海元富95購01,,,,,0.00,0.00,0,0,0,0,0,0,0,0,0,0,0,0,0
20200430,048263,台積電元富95購01,,,,,0.00,0.00,0,0,0,0,0,0,0,0,0,0,0,0,0
20200430,048266,臺指反中信95購01,,,,,0.00,0.00,0,0,0,0,0,0,0,0,0,0,0,0,0
20200430,048268,長榮航中信95購01,,,,,0.00,0.00,0,0,0,0,0,0,0,0,0,0,0,0,0
20200430,048269,瀚宇博國泰95購01,0.20,0.20,0.20,0.20,+0.02,11.11,18000,2,3600,0,0,0,0,0,0,8000,10000,-2000,-2000
20200430,04826P,華新科麥證95售01,,,,,0.00,0.00,0,0,0,0,0,0,0,0,0,0,0,0,0
20200430,048270,T50反1富邦99購01,0.98,0.98,0.92,0.92,-0.12,-11.54,414000,22,399640,0,0,0,0,0,0,64000,349000,-285000,-285000
20200430,048271,可成富邦95購02,0.01,0.01,0.01,0.01,0.00,0.00,25000,3,250,0,0,0,0,0,0,25000,0,25000,25000
20200430,048272,新光金富邦98購01,,,,,0.00,0.00,0,0,0,0,0,0,0,0,0,0,0,0,0
20200430,048273,南電富邦97購01,2.61,2.61,2.61,2.61,+0.03,1.16,5000,1,13050,0,0,0,0,0,0,5000,0,5000,5000
20200430,048284,臺股指中信95購04,,,,,0.00,0.00,0,0,0,0,0,0,0,0,0,0,0,0,0
20200430,048289,臺指反群益95購01,,,,,0.00,0.00,0,0,0,0,0,0,0,0,0,0,0,0,0
20200430,048303,A50凱基96購01,0.01,0.01,0.01,0.01,0.00,0.00,9000,1,90,0,0,0,0,0,0,0,0,0,0
20200430,048305,深100凱基96購01,,,,,0.00,0.00,0,0,0,0,0,0,0,0,0,0,0,0,0
20200430,04831P,聯詠富邦96售01,0.46,0.47,0.44,0.44,-0.04,-8.33,35000,4,16050,0,0,0,0,0,0,25000,10000,15000,15000
20200430,048331,臺指反富邦97購01,,,,,0.00,0.00,0,0,0,0,0,0,0,0,0,0,0,0,0
20200430,048333,大立光富邦95購01,,,,,0.00,0.00,0,0,0,0,0,0,0,0,0,0,0,0,0
20200430,048334,A50正2元大96購01,,,,,0.00,0.00,0,0,0,0,0,0,0,0,0,0,0,0,0
20200430,048339,友達元大95購01,,,,,0.00,0.00,0,0,0,0,0,0,0,0,0,0,0,0,0
20200430,048346,智易元大95購01,0.06,0.06,0.06,0.06,-0.02,-25.0,2000,1,120,0,0,0,0,0,0,2000,0,2000,2000
20200430,048349,美利達元大96購02,,,,,0.00,0.00,0,0,0,0,0,0,0,0,0,0,0,0,0
20200430,048350,世紀鋼元大95購01,0.46,0.57,0.46,0.57,+0.09,18.75,692000,5,357070,0,0,0,0,0,0,0,692000,-692000,-692000
20200430,048373,A50正2元富95購01,0.27,0.27,0.21,0.21,0.00,0.00,90000,2,20700,0,0,0,0,0,0,90000,0,90000,90000
20200430,048379,台郡元富96購01,,,,,0.00,0.00,0,0,0,0,0,0,0,0,0,0,0,0,0
20200430,048382,T50反1國票96購01,0.12,0.12,0.12,0.12,0.00,0.00,6000,1,720,0,0,0,0,0,0,0,0,0,0
20200430,048383,元金2X國票99購01,2.78,2.78,2.70,2.70,-0.08,-2.88,113000,5,306000,0,0,0,0,0,0,43000,103000,-60000,-60000
20200430,04838P,宏達電元大95售02,1.37,1.37,1.33,1.33,-0.13,-8.9,100000,7,136340,0,0,0,0,0,0,100000,0,100000,100000
20200430,048402,聯茂兆豐95購01,,,,,0.00,0.00,0,0,0,0,0,0,0,0,0,0,0,0,0
20200430,048414,滬深2X統一98購01,,,,,0.00,0.00,0,0,0,0,0,0,0,0,0,0,0,0,0
20200430,048422,瑞昱元富96購02,0.98,1.16,0.96,1.14,+0.21,22.58,1831000,45,1931090,0,0,0,0,0,0,381000,1450000,-1069000,-1069000
20200430,048424,揚明光元富95購01,,,,,0.00,0.00,0,0,0,0,0,0,0,0,0,0,0,0,0
20200430,048425,聯茂元富96購02,,,,,0.00,0.00,0,0,0,0,0,0,0,0,0,0,0,0,0
20200430,048427,百和元富95購01,,,,,0.00,0.00,0,0,0,0,0,0,0,0,0,0,0,0,0
20200430,04842P,群創元大96售02,0.49,0.49,0.49,0.49,-0.06,-10.91,5000,1,2450,0,0,0,0,0,0,5000,0,5000,5000
20200430,048432,全新國票95購01,,,,,0.00,0.00,0,0,0,0,0,0,0,0,0,0,0,0,0
20200430,048456,利勤凱基95購01,,,,,0.00,0.00,0,0,0,0,0,0,0,0,0,0,0,0,0
20200430,048483,可成國泰95購01,,,,,0.00,0.00,0,0,0,0,0,0,0,0,0,0,0,0,0
20200430,048484,大立光國泰95購02,,,,,0.00,0.00,0,0,0,0,0,0,0,0,0,0,0,0,0
20200430,048486,傳奇國泰95購01,,,,,0.00,0.00,0,0,0,0,0,0,0,0,0,0,0,0,0
20200430,048499,達運元大96購01,0.03,0.05,0.03,0.05,+0.01,25.0,30000,2,1100,0,0,0,0,0,0,0,20000,-20000,-20000
20200430,048504,A50正2中信95購01,,,,,0.00,0.00,0,0,0,0,0,0,0,0,0,0,0,0,0
20200430,048505,滬深2X群益99購03,,,,,0.00,0.00,0,0,0,0,0,0,0,0,0,0,0,0,0
20200430,048509,上証反凱基99購02,0.28,0.28,0.28,0.28,0.00,0.00,1000,1,280,0,0,0,0,0,0,0,1000,-1000,-1000
20200430,048522,A50正2元富95購02,,,,,0.00,0.00,0,0,0,0,0,0,0,0,0,0,0,0,0
20200430,048549,滬深2X元大96購03,,,,,0.00,0.00,0,0,0,0,0,0,0,0,0,0,0,0,0
20200430,04854P,鴻海國泰96售04,,,,,0.00,0.00,0,0,0,0,0,0,0,0,0,0,0,0,0
20200430,048550,中鴻元大96購01,0.06,0.06,0.06,0.06,0.00,0.00,91000,2,5460,0,0,0,0,0,0,0,0,0,0
20200430,048562,宏達電元大95購01,,,,,0.00,0.00,0,0,0,0,0,0,0,0,0,0,0,0,0
20200430,048571,美利達元大96購03,0.24,0.24,0.24,0.24,0.00,0.00,1000,1,240,0,0,0,0,0,0,0,1000,-1000,-1000
20200430,048572,美利達元大96購04,0.52,0.53,0.52,0.53,0.00,0.00,22000,4,11540,0,0,0,0,0,0,21000,0,21000,21000
20200430,048574,台積電國泰95購02,,,,,0.00,0.00,0,0,0,0,0,0,0,0,0,0,0,0,0
20200430,048576,義隆國泰95購01,1.06,1.29,1.05,1.19,+0.13,12.26,289000,28,343280,0,0,0,0,0,0,36000,281000,-245000,-245000
20200430,048583,智原富邦98購01,,,,,0.00,0.00,0,0,0,0,0,0,0,0,0,0,0,0,0
20200430,048584,欣興富邦95購01,0.04,0.04,0.04,0.04,0.00,0.00,10000,1,400,0,0,0,0,0,0,10000,0,10000,10000
20200430,048589,國巨兆豐96購01,,,,,0.00,0.00,0,0,0,0,0,0,0,0,0,0,0,0,0
20200430,048595,儒鴻國票96購01,0.02,0.02,0.02,0.02,+0.01,100.0,10000,1,200,0,0,0,0,0,0,0,0,0,0
20200430,048599,和鑫國票96購01,,,,,0.00,0.00,0,0,0,0,0,0,0,0,0,0,0,0,0
20200430,048602,上緯控國票96購01,,,,,0.00,0.00,0,0,0,0,0,0,0,0,0,0,0,0,0
20200430,048627,T50反1元大96購02,,,,,0.00,0.00,0,0,0,0,0,0,0,0,0,0,0,0,0
20200430,048628,T50反1元大96購03,0.30,0.34,0.30,0.30,-0.02,-6.25,40000,6,12040,0,0,0,0,0,0,0,0,0,0
20200430,048629,滬深2X元大96購04,0.12,0.12,0.12,0.12,0.00,0.00,100000,1,12000,0,0,0,0,0,0,100000,0,100000,100000
20200430,048637,鴻海元大96購01,1.61,1.61,1.61,1.61,+0.15,10.27,2000,1,3220,0,0,0,0,0,0,0,2000,-2000,-2000
20200430,048651,美利達元大96購05,1.27,1.33,1.09,1.31,+0.07,5.65,252000,15,312500,0,0,0,0,0,0,45000,197000,-152000,-152000
20200430,048652,巨大元大96購01,0.25,0.29,0.25,0.29,+0.09,45.0,35000,3,8950,0,0,0,0,0,0,30000,5000,25000,25000
20200430,048653,巨大元大96購02,0.31,0.43,0.31,0.41,+0.11,36.67,167000,6,64990,0,0,0,0,0,0,155000,12000,143000,143000
20200430,048655,A50正2元富96購01,,,,,0.00,0.00,0,0,0,0,0,0,0,0,0,0,0,0,0
20200430,04865P,台積電亞東95售01,,,,,0.00,0.00,0,0,0,0,0,0,0,0,0,0,0,0,0
20200430,048663,聯發科統一96購01,,,,,0.00,0.00,0,0,0,0,0,0,0,0,0,0,0,0,0
20200430,04866P,台積電統一95售02,,,,,0.00,0.00,0,0,0,0,0,0,0,0,0,0,0,0,0
20200430,048681,漢唐富邦96購01,1.26,1.26,1.25,1.25,+0.03,2.46,30000,3,37700,0,0,0,0,0,0,30000,0,30000,30000
20200430,048682,奇力新富邦96購01,3.96,4.22,3.96,4.22,0.00,0.00,60000,12,248100,0,0,0,0,0,0,0,60000,-60000,-60000
20200430,048687,旺宏群益96購01,0.60,0.70,0.60,0.70,+0.20,40.0,195000,5,120700,0,0,0,0,0,0,170000,15000,155000,155000
20200430,048696,台達電國票96購01,1.50,1.85,1.50,1.70,+0.43,33.86,368000,32,619650,0,0,0,0,0,0,77000,291000,-214000,-214000
20200430,04869P,鴻海元富95售02,,,,,0.00,0.00,0,0,0,0,0,0,0,0,0,0,0,0,0
20200430,048744,儒鴻元富97購01,0.01,0.03,0.01,0.03,0.00,0.00,219000,4,2210,0,0,0,0,0,0,53000,0,53000,53000
20200430,048745,儒鴻元富97購02,0.02,0.02,0.02,0.02,0.00,0.00,12000,1,240,0,0,0,0,0,0,0,0,0,0
20200430,048747,華通元富97購01,1.03,1.21,1.03,1.21,0.00,0.00,73000,5,77770,0,0,0,0,0,0,53000,0,53000,53000
20200430,048748,國巨元富96購01,,,,,0.00,0.00,0,0,0,0,0,0,0,0,0,0,0,0,0
20200430,04874P,高股息中信97售01,,,,,0.00,0.00,0,0,0,0,0,0,0,0,0,0,0,0,0
20200430,048751,京鼎元富96購01,,,,,0.00,0.00,0,0,0,0,0,0,0,0,0,0,0,0,0
20200430,048754,瀚宇博元富97購01,0.61,0.61,0.61,0.61,0.00,0.00,25000,3,15250,0,0,0,0,0,0,25000,0,25000,25000
20200430,048755,志超元富96購01,,,,,0.00,0.00,0,0,0,0,0,0,0,0,0,0,0,0,0
20200430,048756,志超元富96購02,,,,,0.00,0.00,0,0,0,0,0,0,0,0,0,0,0,0,0
20200430,048757,美利達元富96購01,,,,,0.00,0.00,0,0,0,0,0,0,0,0,0,0,0,0,0
20200430,048758,美利達元富96購02,,,,,0.00,0.00,0,0,0,0,0,0,0,0,0,0,0,0,0
20200430,048759,巨大元富96購01,,,,,0.00,0.00,0,0,0,0,0,0,0,0,0,0,0,0,0
20200430,048781,臺股指凱基96購01,0.01,0.01,0.01,0.01,0.00,0.00,123000,3,1230,0,0,0,0,0,0,0,0,0,0
20200430,048785,台積電元大96購01,3.79,3.99,3.79,3.99,+0.43,12.08,9000,3,35560,0,0,0,0,0,0,9000,0,9000,9000
20200430,048794,易華電元大97購01,,,,,0.00,0.00,0,0,0,0,0,0,0,0,0,0,0,0,0
20200430,048801,漢唐富邦96購02,1.06,1.06,1.06,1.06,0.00,0.00,10000,1,10600,0,0,0,0,0,0,10000,0,10000,10000
20200430,048803,大立光富邦96購01,,,,,0.00,0.00,0,0,0,0,0,0,0,0,0,0,0,0,0
20200430,048812,上証2X凱基96購01,,,,,0.00,0.00,0,0,0,0,0,0,0,0,0,0,0,0,0
20200430,04881P,高股息凱基96售01,0.45,0.45,0.44,0.44,-0.11,-20.0,50000,3,22200,0,0,0,0,0,0,0,50000,-50000,-50000
20200430,048847,A50群益98購01,0.28,0.28,0.28,0.28,+0.02,7.69,1000,1,280,0,0,0,0,0,0,0,0,0,0
20200430,048848,滬深2X群益98購02,0.63,0.68,0.63,0.68,+0.14,25.93,3000,3,1970,0,0,0,0,0,0,3000,0,3000,3000
20200430,048850,聯電群益96購01,0.62,0.62,0.60,0.60,+0.04,7.14,275000,31,169010,0,0,0,0,0,0,0,270000,-270000,-270000
20200430,048852,旺宏群益96購02,2.43,2.62,2.43,2.62,+0.52,24.76,422000,4,1033370,0,0,0,0,0,0,422000,0,422000,422000
20200430,048859,玉晶光群益96購02,1.15,1.36,1.15,1.35,+0.23,20.54,193000,17,237170,0,0,0,0,0,0,70000,125000,-55000,-55000
20200430,048860,玉晶光群益96購03,,,,,0.00,0.00,0,0,0,0,0,0,0,0,0,0,0,0,0
20200430,048870,義隆國票96購01,0.35,0.46,0.35,0.46,+0.05,12.2,81000,5,34700,0,0,0,0,0,0,66000,15000,51000,51000
20200430,048874,玉晶光國票96購01,,,,,0.00,0.00,0,0,0,0,0,0,0,0,0,0,0,0,0
20200430,048882,智原統一96購01,,,,,0.00,0.00,0,0,0,0,0,0,0,0,0,0,0,0,0
20200430,04888P,臺股指凱基95售03,,,,,0.00,0.00,0,0,0,0,0,0,0,0,0,0,0,0,0
20200430,048890,傳奇元富97購01,,,,,0.00,0.00,0,0,0,0,0,0,0,0,0,0,0,0,0
20200430,048891,傳奇元富97購02,,,,,0.00,0.00,0,0,0,0,0,0,0,0,0,0,0,0,0
20200430,048892,台郡元富97購01,1.28,1.37,1.28,1.37,+0.21,18.1,20000,4,26410,0,0,0,0,0,0,0,19000,-19000,-19000
20200430,048898,晶相光國泰96購01,0.30,0.30,0.27,0.27,-0.06,-18.18,452000,7,134040,0,0,0,0,0,0,402000,50000,352000,352000
20200430,048902,昇陽半國泰96購01,,,,,0.00,0.00,0,0,0,0,0,0,0,0,0,0,0,0,0
20200430,048905,旺宏富邦96購01,0.57,0.57,0.53,0.53,0.00,0.00,20000,2,11200,0,0,0,0,0,0,20000,0,20000,20000
20200430,04890P,台積電元大95售05,,,,,0.00,0.00,0,0,0,0,0,0,0,0,0,0,0,0,0
20200430,048910,和鑫富邦98購01,,,,,0.00,0.00,0,0,0,0,0,0,0,0,0,0,0,0,0
20200430,048911,玉晶光富邦96購01,0.43,0.45,0.43,0.45,+0.02,4.65,19000,2,8370,0,0,0,0,0,0,19000,0,19000,19000
20200430,04896P,上証2X中信95售01,,,,,0.00,0.00,0,0,0,0,0,0,0,0,0,0,0,0,0
20200430,04898P,瑞儀中信95售01,,,,,0.00,0.00,0,0,0,0,0,0,0,0,0,0,0,0,0
20200430,048997,智原國票95購01,0.01,0.01,0.01,0.01,0.00,0.00,40000,1,400,0,0,0,0,0,0,40000,0,40000,40000
20200430,048998,玉晶光國票95購03,,,,,0.00,0.00,0,0,0,0,0,0,0,0,0,0,0,0,0
20200430,048999,康普國票95購01,,,,,0.00,0.00,0,0,0,0,0,0,0,0,0,0,0,0,0
20200430,049000,元油2X中信95購02,,,,,0.00,0.00,0,0,0,0,0,0,0,0,0,0,0,0,0
20200430,049003,智邦中信95購01,0.05,0.05,0.05,0.05,-0.26,-83.87,30000,1,1500,0,0,0,0,0,0,30000,0,30000,30000
20200430,049004,聯發科中信96購01,0.78,0.91,0.77,0.91,+0.27,42.19,141000,18,117700,0,0,0,0,0,0,111000,0,111000,111000
20200430,049005,可成中信95購01,,,,,0.00,0.00,0,0,0,0,0,0,0,0,0,0,0,0,0
20200430,049007,玉晶光中信96購01,0.29,0.35,0.28,0.35,+0.10,40.0,1183000,33,373610,0,0,0,0,0,0,893000,265000,628000,628000
20200430,049008,傳奇中信95購01,,,,,0.00,0.00,0,0,0,0,0,0,0,0,0,0,0,0,0
20200430,049010,台表科麥證95購01,,,,,0.00,0.00,0,0,0,0,0,0,0,0,0,0,0,0,0
20200430,049017,旺宏群益96購03,,,,,0.00,0.00,0,0,0,0,0,0,0,0,0,0,0,0,0
20200430,049023,玉晶光群益96購04,0.15,0.15,0.09,0.09,-0.07,-43.75,485000,7,49350,0,0,0,0,0,0,390000,0,390000,390000
20200430,049024,玉晶光群益97購01,1.45,1.71,1.44,1.71,+0.33,23.91,369000,15,579060,0,0,0,0,0,0,234000,140000,94000,94000
20200430,049036,燿華兆豐95購01,,,,,0.00,0.00,0,0,0,0,0,0,0,0,0,0,0,0,0
20200430,049040,亞光兆豐95購01,0.02,0.02,0.02,0.02,0.00,0.00,220000,1,4400,0,0,0,0,0,0,220000,0,220000,220000
20200430,049042,玉晶光兆豐95購01,,,,,0.00,0.00,0,0,0,0,0,0,0,0,0,0,0,0,0
20200430,049056,玉晶光永豐95購03,,,,,0.00,0.00,0,0,0,0,0,0,0,0,0,0,0,0,0
20200430,049064,T50反1凱基96購03,0.31,0.31,0.27,0.27,0.00,0.00,20000,3,5800,0,0,0,0,0,0,15000,0,15000,15000
20200430,049065,T50反1凱基96購04,,,,,0.00,0.00,0,0,0,0,0,0,0,0,0,0,0,0,0
20200430,049066,元石油凱基97購01,,,,,0.00,0.00,0,0,0,0,0,0,0,0,0,0,0,0,0
20200430,049068,元油2X凱基95購03,,,,,0.00,0.00,0,0,0,0,0,0,0,0,0,0,0,0,0
20200430,049069,元油2X凱基95購04,,,,,0.00,0.00,0,0,0,0,0,0,0,0,0,0,0,0,0
20200430,04906P,欣興國票95售01,1.73,1.79,1.71,1.79,-0.12,-6.28,28000,4,48520,0,0,0,0,0,0,20000,8000,12000,12000
20200430,04907P,超眾國票95售01,0.29,0.29,0.29,0.29,-0.05,-14.71,53000,1,15370,0,0,0,0,0,0,53000,0,53000,53000
20200430,04908P,南電國票95售03,0.10,0.11,0.10,0.11,+0.01,10.0,114000,13,11550,0,0,0,0,0,0,109000,5000,104000,104000
20200430,049097,國巨國泰95購03,,,,,0.00,0.00,0,0,0,0,0,0,0,0,0,0,0,0,0
20200430,049098,國巨國泰96購01,,,,,0.00,0.00,0,0,0,0,0,0,0,0,0,0,0,0,0
20200430,049099,華新科國泰95購02,,,,,0.00,0.00,0,0,0,0,0,0,0,0,0,0,0,0,0
20200430,049100,華新科國泰96購01,,,,,0.00,0.00,0,0,0,0,0,0,0,0,0,0,0,0,0
20200430,049101,聯詠國泰95購01,,,,,0.00,0.00,0,0,0,0,0,0,0,0,0,0,0,0,0
20200430,049102,智伸科國泰96購01,,,,,0.00,0.00,0,0,0,0,0,0,0,0,0,0,0,0,0
20200430,049103,易華電國泰96購01,,,,,0.00,0.00,0,0,0,0,0,0,0,0,0,0,0,0,0
20200430,049104,元油2X富邦97購02,,,,,0.00,0.00,0,0,0,0,0,0,0,0,0,0,0,0,0
20200430,049108,玉晶光富邦96購02,0.25,0.26,0.20,0.26,+0.05,23.81,12000,3,2510,0,0,0,0,0,0,0,1000,-1000,-1000
20200430,049109,嘉澤富邦95購01,,,,,0.00,0.00,0,0,0,0,0,0,0,0,0,0,0,0,0
20200430,049117,矽格統一96購01,1.02,1.05,1.00,1.05,+0.05,5.0,51000,6,51750,0,0,0,0,0,0,0,31000,-31000,-31000
20200430,049128,滬深2X元大97購03,,,,,0.00,0.00,0,0,0,0,0,0,0,0,0,0,0,0,0
20200430,049129,S&P反1元大97購01,0.33,0.33,0.33,0.33,0.00,0.00,10000,1,3300,0,0,0,0,0,0,0,10000,-10000,-10000
20200430,049130,臺指反元大98購01,0.55,0.55,0.49,0.49,-0.08,-14.04,210000,2,103500,0,0,0,0,0,0,210000,0,210000,210000
20200430,049134,為升元大95購01,,,,,0.00,0.00,0,0,0,0,0,0,0,0,0,0,0,0,0
20200430,049136,華通元大95購01,,,,,0.00,0.00,0,0,0,0,0,0,0,0,0,0,0,0,0
20200430,049137,華通元大95購02,0.56,0.56,0.56,0.56,0.00,0.00,60000,1,33600,0,0,0,0,0,0,60000,60000,0,0
20200430,049141,旺宏元大95購01,0.98,0.98,0.98,0.98,0.00,0.00,1000,1,980,0,0,0,0,0,0,1000,0,1000,1000
20200430,049148,全新元大95購01,,,,,0.00,0.00,0,0,0,0,0,0,0,0,0,0,0,0,0
20200430,049149,華新科元大95購03,0.32,0.32,0.29,0.29,0.00,0.00,560000,4,165400,0,0,0,0,0,0,560000,560000,0,0
20200430,04914P,國巨國泰95售06,0.05,0.05,0.05,0.05,0.00,0.00,5000,1,250,0,0,0,0,0,0,5000,0,5000,5000
20200430,049150,新光金元大96購01,,,,,0.00,0.00,0,0,0,0,0,0,0,0,0,0,0,0,0
20200430,049152,大立光元大95購06,,,,,0.00,0.00,0,0,0,0,0,0,0,0,0,0,0,0,0
20200430,049153,大立光元大96購02,0.07,0.10,0.07,0.10,+0.03,42.86,255000,15,23410,0,0,0,0,0,0,255000,0,255000,255000
20200430,049154,玉晶光元大95購02,,,,,0.00,0.00,0,0,0,0,0,0,0,0,0,0,0,0,0
20200430,049156,緯穎元大96購01,5.60,6.15,5.60,6.10,+1.25,25.77,32000,6,185550,0,0,0,0,0,0,6000,26000,-20000,-20000
20200430,049157,矽創元大95購01,,,,,0.00,0.00,0,0,0,0,0,0,0,0,0,0,0,0,0
20200430,049159,同欣電中信96購01,,,,,0.00,0.00,0,0,0,0,0,0,0,0,0,0,0,0,0
20200430,04915P,鴻海永昌96售02,,,,,0.00,0.00,0,0,0,0,0,0,0,0,0,0,0,0,0
20200430,049160,鴻海第一95購01,,,,,0.00,0.00,0,0,0,0,0,0,0,0,0,0,0,0,0
20200430,049165,元油2X凱基97購01,,,,,0.00,0.00,0,0,0,0,0,0,0,0,0,0,0,0,0
20200430,049166,元油2X凱基97購02,0.06,0.06,0.04,0.06,-0.06,-50.0,21000,3,1060,0,0,0,0,0,0,0,0,0,0
20200430,049167,元油2X凱基97購03,,,,,0.00,0.00,0,0,0,0,0,0,0,0,0,0,0,0,0
20200430,04916P,大立光永昌96售02,,,,,0.00,0.00,0,0,0,0,0,0,0,0,0,0,0,0,0
20200430,049191,元油2X永豐95購01,,,,,0.00,0.00,0,0,0,0,0,0,0,0,0,0,0,0,0
20200430,049192,元油2X永豐96購02,,,,,0.00,0.00,0,0,0,0,0,0,0,0,0,0,0,0,0
20200430,049193,元油2X永豐97購01,,,,,0.00,0.00,0,0,0,0,0,0,0,0,0,0,0,0,0
20200430,049199,茂林永豐95購01,1.00,1.00,0.88,0.94,0.00,0.00,30000,3,28200,0,0,0,0,0,0,0,30000,-30000,-30000
20200430,049200,元黃金群益98購01,,,,,0.00,0.00,0,0,0,0,0,0,0,0,0,0,0,0,0
20200430,049214,台達電國票95購01,,,,,0.00,0.00,0,0,0,0,0,0,0,0,0,0,0,0,0
20200430,049216,華邦電國票95購01,,,,,0.00,0.00,0,0,0,0,0,0,0,0,0,0,0,0,0
20200430,049217,智邦國票95購01,0.48,0.48,0.48,0.48,0.00,0.00,80000,1,38400,0,0,0,0,0,0,0,80000,-80000,-80000
20200430,049219,聯發科國票95購01,0.01,0.01,0.01,0.01,0.00,0.00,500000,2,5000,0,0,0,0,0,0,500000,0,500000,500000
20200430,049220,聯發科國票95購02,0.08,0.09,0.08,0.09,0.00,0.00,12000,2,1020,0,0,0,0,0,0,12000,0,12000,12000
20200430,049221,健策國票95購02,,,,,0.00,0.00,0,0,0,0,0,0,0,0,0,0,0,0,0
20200430,049223,鎧勝國票95購01,0.01,0.01,0.01,0.01,0.00,0.00,14000,1,140,0,0,0,0,0,0,14000,0,14000,14000
20200430,049224,致新國票95購01,,,,,0.00,0.00,0,0,0,0,0,0,0,0,0,0,0,0,0
20200430,049226,元石油富邦95購01,,,,,0.00,0.00,0,0,0,0,0,0,0,0,0,0,0,0,0
20200430,049227,元油2X富邦96購03,,,,,0.00,0.00,0,0,0,0,0,0,0,0,0,0,0,0,0
20200430,049230,台達電富邦96購01,0.31,0.34,0.31,0.34,0.00,0.00,57000,8,18350,0,0,0,0,0,0,0,57000,-57000,-57000
20200430,049231,鴻海富邦95購02,,,,,0.00,0.00,0,0,0,0,0,0,0,0,0,0,0,0,0
20200430,049235,元油2X元富96購05,0.05,0.05,0.03,0.04,0.00,0.00,844000,27,35800,0,0,0,0,0,0,0,0,0,0
20200430,049236,元油2X元富96購06,0.01,0.01,0.01,0.01,0.00,0.00,12000,1,120,0,0,0,0,0,0,0,0,0,0
20200430,049237,元油2X元富96購07,0.01,0.01,0.01,0.01,0.00,0.00,23000,1,230,0,0,0,0,0,0,0,23000,-23000,-23000
20200430,049238,元油2X元富96購08,,,,,0.00,0.00,0,0,0,0,0,0,0,0,0,0,0,0,0
20200430,049242,佳世達元富96購01,,,,,0.00,0.00,0,0,0,0,0,0,0,0,0,0,0,0,0
20200430,049243,佳世達元富96購02,,,,,0.00,0.00,0,0,0,0,0,0,0,0,0,0,0,0,0
20200430,049245,和鑫元富95購01,,,,,0.00,0.00,0,0,0,0,0,0,0,0,0,0,0,0,0
20200430,049250,華通元大95購04,,,,,0.00,0.00,0,0,0,0,0,0,0,0,0,0,0,0,0
20200430,049251,國巨元大95購02,6.95,7.20,6.95,7.20,+0.70,10.77,11000,4,77250,0,0,0,0,0,0,6000,5000,1000,1000
20200430,049252,國巨元大96購01,7.75,7.75,7.50,7.50,+0.35,4.9,5000,5,38150,0,0,0,0,0,0,2000,5000,-3000,-3000
20200430,049254,台積電元大96購02,2.70,2.88,2.70,2.88,+0.48,20.0,6000,2,17100,0,0,0,0,0,0,1000,5000,-4000,-4000
20200430,049255,旺宏元大97購02,3.61,3.61,3.27,3.33,+0.30,9.9,179000,21,610710,0,0,0,0,0,0,177000,96000,81000,81000
20200430,049260,華新科元大96購01,,,,,0.00,0.00,0,0,0,0,0,0,0,0,0,0,0,0,0
20200430,049264,奇鋐元大95購01,,,,,0.00,0.00,0,0,0,0,0,0,0,0,0,0,0,0,0
20200430,049267,瀚宇博元大95購02,0.55,0.55,0.55,0.55,0.00,0.00,5000,1,2750,0,0,0,0,0,0,5000,5000,0,0
20200430,049269,超眾元大96購02,,,,,0.00,0.00,0,0,0,0,0,0,0,0,0,0,0,0,0
20200430,04926P,聯發科凱基95售03,0.01,0.01,0.01,0.01,-0.14,-93.33,250000,2,2500,0,0,0,0,0,0,250000,0,250000,250000
20200430,049270,台表科元大95購02,,,,,0.00,0.00,0,0,0,0,0,0,0,0,0,0,0,0,0
20200430,049272,世紀鋼元大96購02,0.77,0.85,0.77,0.83,+0.09,12.16,369000,20,300010,0,0,0,0,0,0,95000,262000,-167000,-167000
20200430,04927P,大立光凱基95售06,,,,,0.00,0.00,0,0,0,0,0,0,0,0,0,0,0,0,0
20200430,049280,創意國票95購01,,,,,0.00,0.00,0,0,0,0,0,0,0,0,0,0,0,0,0
20200430,049281,嘉聯益國票95購01,,,,,0.00,0.00,0,0,0,0,0,0,0,0,0,0,0,0,0
20200430,049282,易華電國票95購01,,,,,0.00,0.00,0,0,0,0,0,0,0,0,0,0,0,0,0
20200430,049283,滬深2X中信95購10,0.08,0.08,0.08,0.08,+0.02,33.33,90000,1,7200,0,0,0,0,0,0,90000,0,90000,90000
20200430,049287,可成兆豐95購01,,,,,0.00,0.00,0,0,0,0,0,0,0,0,0,0,0,0,0
20200430,049288,聯茂兆豐95購02,,,,,0.00,0.00,0,0,0,0,0,0,0,0,0,0,0,0,0
20200430,04928P,大立光凱基95售07,,,,,0.00,0.00,0,0,0,0,0,0,0,0,0,0,0,0,0
20200430,049293,友訊群益95購01,,,,,0.00,0.00,0,0,0,0,0,0,0,0,0,0,0,0,0
20200430,049296,義隆群益96購01,,,,,0.00,0.00,0,0,0,0,0,0,0,0,0,0,0,0,0
20200430,049297,日電貿群益95購01,,,,,0.00,0.00,0,0,0,0,0,0,0,0,0,0,0,0,0
20200430,049298,矽格群益95購01,,,,,0.00,0.00,0,0,0,0,0,0,0,0,0,0,0,0,0
20200430,04929P,同欣電凱基95售01,0.98,0.98,0.98,0.98,-0.08,-7.55,28000,1,27440,0,0,0,0,0,0,28000,0,28000,28000
20200430,049301,致新群益95購01,,,,,0.00,0.00,0,0,0,0,0,0,0,0,0,0,0,0,0
20200430,049304,元油2X凱基95購05,,,,,0.00,0.00,0,0,0,0,0,0,0,0,0,0,0,0,0
20200430,049305,元油2X凱基95購06,,,,,0.00,0.00,0,0,0,0,0,0,0,0,0,0,0,0,0
20200430,049306,元油2X凱基96購01,,,,,0.00,0.00,0,0,0,0,0,0,0,0,0,0,0,0,0
20200430,04932P,香港2X中信96售01,,,,,0.00,0.00,0,0,0,0,0,0,0,0,0,0,0,0,0
20200430,049335,聯電統一97購01,1.73,1.73,1.70,1.73,+0.05,2.98,52000,4,89060,0,0,0,0,0,0,10000,42000,-32000,-32000
20200430,04933P,中石化中信96售01,,,,,0.00,0.00,0,0,0,0,0,0,0,0,0,0,0,0,0
20200430,049341,旺宏統一95購01,0.21,0.23,0.18,0.21,+0.09,75.0,330000,9,65600,0,0,0,0,0,0,200000,130000,70000,70000
20200430,049346,新光金統一95購01,,,,,0.00,0.00,0,0,0,0,0,0,0,0,0,0,0,0,0
20200430,049347,群創統一95購01,,,,,0.00,0.00,0,0,0,0,0,0,0,0,0,0,0,0,0
20200430,049352,泰鼎永豐95購01,,,,,0.00,0.00,0,0,0,0,0,0,0,0,0,0,0,0,0
20200430,049355,元油2X富邦96購04,,,,,0.00,0.00,0,0,0,0,0,0,0,0,0,0,0,0,0
20200430,04935P,鴻海中信96售01,0.39,0.39,0.38,0.38,0.00,0.00,553000,5,215640,0,0,0,0,0,0,553000,0,553000,553000
20200430,049367,全新元大96購01,,,,,0.00,0.00,0,0,0,0,0,0,0,0,0,0,0,0,0
20200430,049369,義隆元大95購01,0.06,0.09,0.06,0.09,+0.01,12.5,422000,5,29580,0,0,0,0,0,0,422000,0,422000,422000
20200430,04936P,大立光中信95售03,,,,,0.00,0.00,0,0,0,0,0,0,0,0,0,0,0,0,0
20200430,049372,華新科元大95購04,,,,,0.00,0.00,0,0,0,0,0,0,0,0,0,0,0,0,0
20200430,049379,智原元大95購01,,,,,0.00,0.00,0,0,0,0,0,0,0,0,0,0,0,0,0
20200430,049383,健策元大95購01,,,,,0.00,0.00,0,0,0,0,0,0,0,0,0,0,0,0,0
20200430,049386,嘉聯益元大95購01,,,,,0.00,0.00,0,0,0,0,0,0,0,0,0,0,0,0,0
20200430,049389,元石油中信97購02,0.07,0.09,0.07,0.09,+0.01,12.5,347000,13,25520,0,0,0,0,0,0,0,0,0,0
20200430,04938P,亞德客國票95售01,0.07,0.07,0.06,0.06,-0.05,-45.45,260000,5,17500,0,0,0,0,0,0,0,260000,-260000,-260000
20200430,049390,元油2X中信96購01,,,,,0.00,0.00,0,0,0,0,0,0,0,0,0,0,0,0,0
20200430,049396,元油2X群益97購03,,,,,0.00,0.00,0,0,0,0,0,0,0,0,0,0,0,0,0
20200430,04939P,國巨國票95售03,,,,,0.00,0.00,0,0,0,0,0,0,0,0,0,0,0,0,0
20200430,049402,奇鋐群益95購02,,,,,0.00,0.00,0,0,0,0,0,0,0,0,0,0,0,0,0
20200430,049406,T50反1日盛97購01,,,,,0.00,0.00,0,0,0,0,0,0,0,0,0,0,0,0,0
20200430,049409,滬深2X凱基96購04,,,,,0.00,0.00,0,0,0,0,0,0,0,0,0,0,0,0,0
20200430,04940P,台積電國票95售02,,,,,0.00,0.00,0,0,0,0,0,0,0,0,0,0,0,0,0
20200430,049423,臺股指凱基95購02,,,,,0.00,0.00,0,0,0,0,0,0,0,0,0,0,0,0,0
20200430,049425,喬山兆豐95購01,,,,,0.00,0.00,0,0,0,0,0,0,0,0,0,0,0,0,0
20200430,049426,為升兆豐95購01,,,,,0.00,0.00,0,0,0,0,0,0,0,0,0,0,0,0,0
20200430,049429,國巨國票95購01,,,,,0.00,0.00,0,0,0,0,0,0,0,0,0,0,0,0,0
20200430,049430,國巨國票95購02,2.50,2.50,2.50,2.50,0.00,0.00,50000,1,125000,0,0,0,0,0,0,50000,0,50000,50000
20200430,049431,光罩國票96購01,,,,,0.00,0.00,0,0,0,0,0,0,0,0,0,0,0,0,0
20200430,049432,聯詠國票95購01,,,,,0.00,0.00,0,0,0,0,0,0,0,0,0,0,0,0,0
20200430,049433,健策國票95購03,,,,,0.00,0.00,0,0,0,0,0,0,0,0,0,0,0,0,0
20200430,049434,茂林國票95購01,1.57,1.57,1.57,1.57,0.00,0.00,125000,1,196250,0,0,0,0,0,0,125000,125000,0,0
20200430,049435,S&P反1國泰96購01,,,,,0.00,0.00,0,0,0,0,0,0,0,0,0,0,0,0,0
20200430,049436,義隆國泰96購02,,,,,0.00,0.00,0,0,0,0,0,0,0,0,0,0,0,0,0
20200430,049437,可成國泰96購01,,,,,0.00,0.00,0,0,0,0,0,0,0,0,0,0,0,0,0
20200430,049438,嘉晶國泰96購01,,,,,0.00,0.00,0,0,0,0,0,0,0,0,0,0,0,0,0
20200430,049439,牧德國泰96購01,1.31,1.31,1.30,1.30,0.00,0.00,22000,2,28700,0,0,0,0,0,0,0,22000,-22000,-22000
20200430,049442,滬深2X統一99購01,,,,,0.00,0.00,0,0,0,0,0,0,0,0,0,0,0,0,0
20200430,049458,SP黃豆元富96購01,,,,,0.00,0.00,0,0,0,0,0,0,0,0,0,0,0,0,0
20200430,049459,全新元富95購02,,,,,0.00,0.00,0,0,0,0,0,0,0,0,0,0,0,0,0
20200430,049463,華新科富邦97購01,1.10,1.10,0.95,1.00,+0.06,6.38,7000,3,7450,0,0,0,0,0,0,1000,0,1000,1000
20200430,049464,燿華台新95購01,,,,,0.00,0.00,0,0,0,0,0,0,0,0,0,0,0,0,0
20200430,049472,楠梓電永豐95購01,,,,,0.00,0.00,0,0,0,0,0,0,0,0,0,0,0,0,0
20200430,049484,台積電元大95購02,,,,,0.00,0.00,0,0,0,0,0,0,0,0,0,0,0,0,0
20200430,049485,台積電元大96購03,,,,,0.00,0.00,0,0,0,0,0,0,0,0,0,0,0,0,0
20200430,049488,智邦元大95購01,1.28,1.28,0.96,1.12,+0.16,16.67,201000,3,240960,0,0,0,0,0,0,100000,101000,-1000,-1000
20200430,049490,京元電元大95購02,0.67,0.67,0.67,0.67,+0.01,1.52,50000,1,33500,0,0,0,0,0,0,50000,0,50000,50000
20200430,049491,聯發科元大95購01,0.40,0.58,0.40,0.58,+0.34,141.67,55000,5,28200,0,0,0,0,0,0,55000,0,55000,55000
20200430,049492,聯發科元大95購02,0.42,0.55,0.42,0.50,+0.18,56.25,54000,3,27250,0,0,0,0,0,0,23000,0,23000,23000
20200430,049494,華新科元大95購05,1.04,1.04,1.04,1.04,0.00,0.00,10000,1,10400,0,0,0,0,0,0,10000,0,10000,10000
20200430,049496,和鑫元大95購01,,,,,0.00,0.00,0,0,0,0,0,0,0,0,0,0,0,0,0
20200430,049498,茂林元大95購01,,,,,0.00,0.00,0,0,0,0,0,0,0,0,0,0,0,0,0
20200430,049499,康控元大96購01,,,,,0.00,0.00,0,0,0,0,0,0,0,0,0,0,0,0,0
20200430,049501,台郡元大95購01,0.88,0.88,0.88,0.88,-0.01,-1.12,380000,1,334400,0,0,0,0,0,0,380000,0,380000,380000
20200430,04950P,上証2X中信96售02,0.09,0.09,0.09,0.09,-0.10,-52.63,20000,2,1800,0,0,0,0,0,0,0,20000,-20000,-20000
20200430,049518,宏達電國票95購02,,,,,0.00,0.00,0,0,0,0,0,0,0,0,0,0,0,0,0
20200430,049519,新光金國票95購03,,,,,0.00,0.00,0,0,0,0,0,0,0,0,0,0,0,0,0
20200430,049520,TPK國票95購01,,,,,0.00,0.00,0,0,0,0,0,0,0,0,0,0,0,0,0
20200430,049521,致伸國票95購01,,,,,0.00,0.00,0,0,0,0,0,0,0,0,0,0,0,0,0
20200430,049524,可成兆豐95購02,,,,,0.00,0.00,0,0,0,0,0,0,0,0,0,0,0,0,0
20200430,049526,緯穎兆豐95購01,,,,,0.00,0.00,0,0,0,0,0,0,0,0,0,0,0,0,0
20200430,049527,國巨中信95購01,,,,,0.00,0.00,0,0,0,0,0,0,0,0,0,0,0,0,0
20200430,049529,華新科中信95購01,,,,,0.00,0.00,0,0,0,0,0,0,0,0,0,0,0,0,0
20200430,049537,元石油群益97購01,0.07,0.08,0.07,0.08,0.00,0.00,200000,7,15110,0,0,0,0,0,0,0,0,0,0
20200430,049538,元油2X群益98購01,,,,,0.00,0.00,0,0,0,0,0,0,0,0,0,0,0,0,0
20200430,049539,元油2X群益9A購01,0.17,0.17,0.08,0.10,-0.02,-16.67,172000,7,14770,0,0,0,0,0,0,0,0,0,0
20200430,04954P,健策國票96售01,,,,,0.00,0.00,0,0,0,0,0,0,0,0,0,0,0,0,0
20200430,049552,鴻海國泰96購01,,,,,0.00,0.00,0,0,0,0,0,0,0,0,0,0,0,0,0
20200430,049553,鴻海國泰96購02,,,,,0.00,0.00,0,0,0,0,0,0,0,0,0,0,0,0,0
20200430,049554,禾伸堂富邦96購01,1.20,1.20,1.14,1.14,+0.02,1.79,13000,3,15420,0,0,0,0,0,0,13000,0,13000,13000
20200430,049560,香港反統一95購01,,,,,0.00,0.00,0,0,0,0,0,0,0,0,0,0,0,0,0
20200430,049561,道瓊銀統一96購01,,,,,0.00,0.00,0,0,0,0,0,0,0,0,0,0,0,0,0
20200430,049563,華新統一95購01,0.17,0.17,0.17,0.17,0.00,0.00,20000,2,3400,0,0,0,0,0,0,0,20000,-20000,-20000
20200430,049573,長榮航統一95購01,,,,,0.00,0.00,0,0,0,0,0,0,0,0,0,0,0,0,0
20200430,04957P,上証2X凱基96售02,,,,,0.00,0.00,0,0,0,0,0,0,0,0,0,0,0,0,0
20200430,049582,台積電元大95購03,0.90,1.06,0.90,0.99,+0.16,19.28,17000,4,16100,0,0,0,0,0,0,12000,5000,7000,7000
20200430,049583,台積電元大95購04,0.08,0.08,0.08,0.08,0.00,0.00,9000,2,720,0,0,0,0,0,0,9000,0,9000,9000
20200430,049584,台積電元大96購04,0.84,0.93,0.84,0.93,+0.18,24.0,14000,5,12720,0,0,0,0,0,0,14000,0,14000,14000
20200430,049585,旺宏元大95購02,0.40,0.40,0.26,0.26,0.00,0.00,126000,9,43460,0,0,0,0,0,0,16000,60000,-44000,-44000
20200430,049587,美律元大95購01,,,,,0.00,0.00,0,0,0,0,0,0,0,0,0,0,0,0,0
20200430,049589,奇力新元大95購02,0.93,0.93,0.93,0.93,0.00,0.00,3000,1,2790,0,0,0,0,0,0,3000,0,3000,3000
20200430,049591,開發金元大98購01,,,,,0.00,0.00,0,0,0,0,0,0,0,0,0,0,0,0,0
20200430,049592,欣興元大96購01,,,,,0.00,0.00,0,0,0,0,0,0,0,0,0,0,0,0,0
20200430,049593,群創元大9A購01,0.40,0.40,0.40,0.40,0.00,0.00,11000,2,4400,0,0,0,0,0,0,0,11000,-11000,-11000
20200430,049594,揚明光元大95購01,,,,,0.00,0.00,0,0,0,0,0,0,0,0,0,0,0,0,0
20200430,049595,麗豐元大95購01,,,,,0.00,0.00,0,0,0,0,0,0,0,0,0,0,0,0,0
20200430,049596,智伸科元大95購01,,,,,0.00,0.00,0,0,0,0,0,0,0,0,0,0,0,0,0
20200430,049597,泰鼎元大96購01,,,,,0.00,0.00,0,0,0,0,0,0,0,0,0,0,0,0,0
20200430,049598,超眾元大95購03,,,,,0.00,0.00,0,0,0,0,0,0,0,0,0,0,0,0,0
20200430,049599,樺漢元大95購01,0.20,0.20,0.20,0.20,+0.04,25.0,30000,3,6000,0,0,0,0,0,0,30000,0,30000,30000
20200430,049600,緯穎元大95購02,4.16,5.50,4.16,5.50,+1.60,41.03,17000,4,87930,0,0,0,0,0,0,7000,10000,-3000,-3000
20200430,049601,矽創元大95購02,,,,,0.00,0.00,0,0,0,0,0,0,0,0,0,0,0,0,0
20200430,049602,南電元大95購01,3.05,3.05,2.58,2.62,-0.42,-13.82,72000,8,212760,0,0,0,0,0,0,70000,2000,68000,68000
20200430,049609,全新兆豐95購01,,,,,0.00,0.00,0,0,0,0,0,0,0,0,0,0,0,0,0
20200430,04960P,大立光凱基96售04,1.80,1.80,1.80,1.80,-0.65,-26.53,20000,1,36000,0,0,0,0,0,0,0,20000,-20000,-20000
20200430,049610,奇力新兆豐95購01,,,,,0.00,0.00,0,0,0,0,0,0,0,0,0,0,0,0,0
20200430,049611,緯穎兆豐95購02,3.22,3.22,3.22,3.22,0.00,0.00,6000,1,19320,0,0,0,0,0,0,6000,0,6000,6000
20200430,049612,香港反中信96購01,,,,,0.00,0.00,0,0,0,0,0,0,0,0,0,0,0,0,0
20200430,049615,香港2X群益98購01,,,,,0.00,0.00,0,0,0,0,0,0,0,0,0,0,0,0,0
20200430,049619,宏達電群益95購02,,,,,0.00,0.00,0,0,0,0,0,0,0,0,0,0,0,0,0
20200430,049625,智易群益95購01,,,,,0.00,0.00,0,0,0,0,0,0,0,0,0,0,0,0,0
20200430,04962P,易華電凱基96售01,,,,,0.00,0.00,0,0,0,0,0,0,0,0,0,0,0,0,0
20200430,049636,上証反凱基9A購01,,,,,0.00,0.00,0,0,0,0,0,0,0,0,0,0,0,0,0
20200430,049658,國巨台新95購01,,,,,0.00,0.00,0,0,0,0,0,0,0,0,0,0,0,0,0
20200430,049659,旺宏台新95購01,1.61,1.61,1.50,1.50,0.00,0.00,22000,3,33220,0,0,0,0,0,0,22000,0,22000,22000
20200430,049662,燿華永豐95購02,,,,,0.00,0.00,0,0,0,0,0,0,0,0,0,0,0,0,0
20200430,049665,TPK永昌95購01,,,,,0.00,0.00,0,0,0,0,0,0,0,0,0,0,0,0,0
20200430,049667,大立光國泰96購01,0.18,0.18,0.18,0.18,0.00,0.00,10000,1,1800,0,0,0,0,0,0,10000,0,10000,10000
20200430,049668,大立光國泰96購02,,,,,0.00,0.00,0,0,0,0,0,0,0,0,0,0,0,0,0
20200430,049669,訊芯國泰95購01,,,,,0.00,0.00,0,0,0,0,0,0,0,0,0,0,0,0,0
20200430,049670,鈺齊國泰96購01,0.58,0.58,0.58,0.58,0.00,0.00,5000,1,2900,0,0,0,0,0,0,0,5000,-5000,-5000
20200430,049671,上証2X富邦95購01,,,,,0.00,0.00,0,0,0,0,0,0,0,0,0,0,0,0,0
20200430,049675,台光電國票95購01,0.25,0.25,0.25,0.25,0.00,0.00,37000,2,9250,0,0,0,0,0,0,0,37000,-37000,-37000
20200430,049684,彩晶統一95購01,0.29,0.30,0.29,0.30,0.00,0.00,43000,3,12840,0,0,0,0,0,0,6000,37000,-31000,-31000
20200430,049690,義隆元大95購02,,,,,0.00,0.00,0,0,0,0,0,0,0,0,0,0,0,0,0
20200430,049694,華新科元大95購06,,,,,0.00,0.00,0,0,0,0,0,0,0,0,0,0,0,0,0
20200430,049695,新光金元大9A購01,,,,,0.00,0.00,0,0,0,0,0,0,0,0,0,0,0,0,0
20200430,049696,欣興元大95購02,,,,,0.00,0.00,0,0,0,0,0,0,0,0,0,0,0,0,0
20200430,049697,群創元大98購01,,,,,0.00,0.00,0,0,0,0,0,0,0,0,0,0,0,0,0
20200430,049698,TPK元大95購01,,,,,0.00,0.00,0,0,0,0,0,0,0,0,0,0,0,0,0
20200430,049700,瀚宇博元大97購01,2.15,2.25,2.09,2.25,+0.13,6.13,301000,17,647890,0,0,0,0,0,0,24000,247000,-223000,-223000
20200430,049702,台表科元大95購03,3.06,3.06,3.06,3.06,0.00,0.00,10000,1,30600,0,0,0,0,0,0,0,10000,-10000,-10000
20200430,049703,訊芯元大95購01,,,,,0.00,0.00,0,0,0,0,0,0,0,0,0,0,0,0,0
20200430,049704,羅麗芬元大95購01,,,,,0.00,0.00,0,0,0,0,0,0,0,0,0,0,0,0,0
20200430,049706,世紀鋼元大95購02,0.29,0.31,0.29,0.31,0.00,0.00,180000,3,53750,0,0,0,0,0,0,40000,140000,-100000,-100000
20200430,049726,道瓊反中信96購01,,,,,0.00,0.00,0,0,0,0,0,0,0,0,0,0,0,0,0
20200430,049736,宏達電群益95購03,,,,,0.00,0.00,0,0,0,0,0,0,0,0,0,0,0,0,0
20200430,049746,全新永豐95購01,,,,,0.00,0.00,0,0,0,0,0,0,0,0,0,0,0,0,0
20200430,04974P,聯發科凱基96售02,1.78,1.79,1.66,1.66,-0.37,-18.23,37000,12,65410,0,0,0,0,0,0,29000,8000,21000,21000
20200430,049751,牧德永豐95購01,0.44,0.44,0.44,0.44,0.00,0.00,499000,1,219560,0,0,0,0,0,0,499000,499000,0,0
20200430,049759,元黃金富邦9A購01,3.77,3.77,3.77,3.77,0.00,0.00,11000,2,41470,0,0,0,0,0,0,11000,0,11000,11000
20200430,04975P,華新科凱基96售02,,,,,0.00,0.00,0,0,0,0,0,0,0,0,0,0,0,0,0
20200430,049760,滬深2X國泰95購02,,,,,0.00,0.00,0,0,0,0,0,0,0,0,0,0,0,0,0
20200430,049761,亞德客國泰95購03,,,,,0.00,0.00,0,0,0,0,0,0,0,0,0,0,0,0,0
20200430,049762,華邦電國泰95購01,,,,,0.00,0.00,0,0,0,0,0,0,0,0,0,0,0,0,0
20200430,049763,美食國泰96購01,0.03,0.03,0.03,0.03,+0.01,50.0,50000,1,1500,0,0,0,0,0,0,0,0,0,0
20200430,049764,TPK國泰95購01,,,,,0.00,0.00,0,0,0,0,0,0,0,0,0,0,0,0,0
20200430,049769,和鑫元富96購01,,,,,0.00,0.00,0,0,0,0,0,0,0,0,0,0,0,0,0
20200430,049770,康控元富95購01,,,,,0.00,0.00,0,0,0,0,0,0,0,0,0,0,0,0,0
20200430,049775,旺宏統一95購02,1.07,1.07,0.97,1.06,+0.25,30.86,72000,4,72880,0,0,0,0,0,0,72000,0,72000,72000
20200430,049776,全新統一95購02,,,,,0.00,0.00,0,0,0,0,0,0,0,0,0,0,0,0,0
20200430,049779,創意統一95購01,,,,,0.00,0.00,0,0,0,0,0,0,0,0,0,0,0,0,0
20200430,04977P,力成凱基96售01,,,,,0.00,0.00,0,0,0,0,0,0,0,0,0,0,0,0,0
20200430,049783,元油2X兆豐95購01,,,,,0.00,0.00,0,0,0,0,0,0,0,0,0,0,0,0,0
20200430,049785,華新科兆豐95購01,,,,,0.00,0.00,0,0,0,0,0,0,0,0,0,0,0,0,0
20200430,049788,智伸科兆豐95購01,,,,,0.00,0.00,0,0,0,0,0,0,0,0,0,0,0,0,0
20200430,049790,滬深2X元大97購04,,,,,0.00,0.00,0,0,0,0,0,0,0,0,0,0,0,0,0
20200430,049795,華通元大96購02,0.16,0.21,0.16,0.21,+0.08,61.54,131000,8,25160,0,0,0,0,0,0,131000,0,131000,131000
20200430,049799,旺宏元大96購01,0.89,0.89,0.88,0.88,+0.07,8.64,180000,3,159400,0,0,0,0,0,0,160000,0,160000,160000
20200430,04979P,臺股指凱基96售07,,,,,0.00,0.00,0,0,0,0,0,0,0,0,0,0,0,0,0
20200430,049803,華新科元大95購07,,,,,0.00,0.00,0,0,0,0,0,0,0,0,0,0,0,0,0
20200430,049807,新光金元大96購02,,,,,0.00,0.00,0,0,0,0,0,0,0,0,0,0,0,0,0
20200430,04980P,臺股指凱基96售08,0.90,1.15,0.81,0.81,-0.19,-19.0,40000,13,37700,0,0,0,0,0,0,0,0,0,0
20200430,049810,欣興元大95購03,0.05,0.05,0.05,0.05,0.00,0.00,100000,1,5000,0,0,0,0,0,0,100000,0,100000,100000
20200430,049813,康控元大96購02,,,,,0.00,0.00,0,0,0,0,0,0,0,0,0,0,0,0,0
20200430,049814,超眾元大95購04,,,,,0.00,0.00,0,0,0,0,0,0,0,0,0,0,0,0,0
20200430,049820,世紀鋼元大96購03,0.77,0.77,0.77,0.77,+0.06,8.45,1000,1,770,0,0,0,0,0,0,1000,0,1000,1000
20200430,049837,臺股指凱基96購02,,,,,0.00,0.00,0,0,0,0,0,0,0,0,0,0,0,0,0
20200430,049842,道瓊反中信98購01,1.80,1.80,1.80,1.80,-0.15,-7.69,10000,1,18000,0,0,0,0,0,0,0,10000,-10000,-10000
20200430,049843,康友中信95購01,0.02,0.02,0.02,0.02,0.00,0.00,290000,3,5800,0,0,0,0,0,0,290000,0,290000,290000
20200430,049859,味全兆豐95購01,,,,,0.00,0.00,0,0,0,0,0,0,0,0,0,0,0,0,0
20200430,049865,和鑫兆豐95購01,,,,,0.00,0.00,0,0,0,0,0,0,0,0,0,0,0,0,0
20200430,049871,T50反1台新9A購02,0.46,0.58,0.42,0.58,+0.12,26.09,251000,20,107000,0,0,0,0,0,0,0,210000,-210000,-210000
20200430,049886,華通永昌95購01,,,,,0.00,0.00,0,0,0,0,0,0,0,0,0,0,0,0,0
20200430,049887,嘉聯益永昌95購01,,,,,0.00,0.00,0,0,0,0,0,0,0,0,0,0,0,0,0
20200430,049888,智邦國泰96購01,2.92,3.06,2.76,2.76,-0.08,-2.82,5000,5,14430,0,0,0,0,0,0,5000,0,5000,5000
20200430,049889,欣興國泰96購01,,,,,0.00,0.00,0,0,0,0,0,0,0,0,0,0,0,0,0
20200430,049890,嘉澤國泰95購01,,,,,0.00,0.00,0,0,0,0,0,0,0,0,0,0,0,0,0
20200430,049892,國巨富邦96購01,1.26,1.28,1.26,1.27,0.00,0.00,22000,3,27880,0,0,0,0,0,0,22000,0,22000,22000
20200430,049893,日月光富邦98購01,,,,,0.00,0.00,0,0,0,0,0,0,0,0,0,0,0,0,0
20200430,049894,嘉聯益富邦98購01,,,,,0.00,0.00,0,0,0,0,0,0,0,0,0,0,0,0,0
20200430,049898,緯穎統一95購01,,,,,0.00,0.00,0,0,0,0,0,0,0,0,0,0,0,0,0
20200430,049909,國巨元大95購01,,,,,0.00,0.00,0,0,0,0,0,0,0,0,0,0,0,0,0
20200430,049922,禾伸堂元大95購01,0.75,0.75,0.75,0.75,+0.11,17.19,15000,2,11250,0,0,0,0,0,0,15000,0,15000,15000
20200430,049923,智原元大95購02,,,,,0.00,0.00,0,0,0,0,0,0,0,0,0,0,0,0,0
20200430,049924,欣興元大95購04,,,,,0.00,0.00,0,0,0,0,0,0,0,0,0,0,0,0,0
20200430,049925,創意元大95購02,,,,,0.00,0.00,0,0,0,0,0,0,0,0,0,0,0,0,0
20200430,049926,智易元大95購02,,,,,0.00,0.00,0,0,0,0,0,0,0,0,0,0,0,0,0
20200430,04992P,元油2X富邦97售04,,,,,0.00,0.00,0,0,0,0,0,0,0,0,0,0,0,0,0
20200430,049933,GIS元大95購01,,,,,0.00,0.00,0,0,0,0,0,0,0,0,0,0,0,0,0
20200430,04993P,上銀兆豐96售01,,,,,0.00,0.00,0,0,0,0,0,0,0,0,0,0,0,0,0
20200430,049946,智邦兆豐95購01,1.16,1.21,0.94,0.94,-0.19,-16.81,102000,13,104290,0,0,0,0,0,0,102000,0,102000,102000
20200430,049947,S&P反1中信97購01,,,,,0.00,0.00,0,0,0,0,0,0,0,0,0,0,0,0,0
20200430,049949,燿華群益96購01,,,,,0.00,0.00,0,0,0,0,0,0,0,0,0,0,0,0,0
20200430,049954,健策群益95購01,3.44,3.44,3.44,3.44,0.00,0.00,40000,1,137600,0,0,0,0,0,0,40000,40000,0,0
20200430,049955,崇越群益95購01,,,,,0.00,0.00,0,0,0,0,0,0,0,0,0,0,0,0,0
20200430,049959,創意統一95購02,,,,,0.00,0.00,0,0,0,0,0,0,0,0,0,0,0,0,0
20200430,04995P,台達電凱基96售03,,,,,0.00,0.00,0,0,0,0,0,0,0,0,0,0,0,0,0
20200430,049966,旺宏國票95購02,0.10,0.10,0.10,0.10,0.00,0.00,300000,1,30000,0,0,0,0,0,0,300000,0,300000,300000
20200430,049968,麗豐國票95購01,,,,,0.00,0.00,0,0,0,0,0,0,0,0,0,0,0,0,0
20200430,049969,泰鼎國票95購01,,,,,0.00,0.00,0,0,0,0,0,0,0,0,0,0,0,0,0
20200430,049970,康控國票95購03,,,,,0.00,0.00,0,0,0,0,0,0,0,0,0,0,0,0,0
20200430,049971,台郡國票95購01,,,,,0.00,0.00,0,0,0,0,0,0,0,0,0,0,0,0,0
20200430,049972,南電國票95購02,2.54,2.68,2.48,2.48,+0.19,8.3,75000,16,191190,0,0,0,0,0,0,75000,0,75000,75000
20200430,049973,T50反1日盛9A購01,,,,,0.00,0.00,0,0,0,0,0,0,0,0,0,0,0,0,0
20200430,049991,臺股指凱基96購04,,,,,0.00,0.00,0,0,0,0,0,0,0,0,0,0,0,0,0
20200430,050011,S&P反1國泰95購01,,,,,0.00,0.00,0,0,0,0,0,0,0,0,0,0,0,0,0
20200430,050012,台積電國泰95購03,,,,,0.00,0.00,0,0,0,0,0,0,0,0,0,0,0,0,0
20200430,050013,淘帝國泰95購01,,,,,0.00,0.00,0,0,0,0,0,0,0,0,0,0,0,0,0
20200430,050014,國巨富邦98購01,2.02,2.08,1.93,1.94,+0.06,3.19,63000,13,123840,0,0,0,0,0,0,20000,40000,-20000,-20000
20200430,050015,友達富邦95購01,0.08,0.08,0.08,0.08,0.00,0.00,210000,1,16800,0,0,0,0,0,0,210000,0,210000,210000
20200430,050016,緯穎富邦95購01,,,,,0.00,0.00,0,0,0,0,0,0,0,0,0,0,0,0,0
20200430,050026,友達元大96購01,,,,,0.00,0.00,0,0,0,0,0,0,0,0,0,0,0,0,0
20200430,050031,嘉澤元大95購01,,,,,0.00,0.00,0,0,0,0,0,0,0,0,0,0,0,0,0
20200430,050047,奇鋐國票95購01,,,,,0.00,0.00,0,0,0,0,0,0,0,0,0,0,0,0,0
20200430,050049,華通群益96購01,0.34,0.44,0.34,0.44,+0.15,51.72,20000,6,7840,0,0,0,0,0,0,20000,0,20000,20000
20200430,050055,道瓊反凱基95購01,,,,,0.00,0.00,0,0,0,0,0,0,0,0,0,0,0,0,0
20200430,050077,臺股指凱基99購02,0.15,0.16,0.14,0.15,+0.05,50.0,66000,9,9860,0,0,0,0,0,0,35000,0,35000,35000
20200430,050078,臺指反統一97購01,,,,,0.00,0.00,0,0,0,0,0,0,0,0,0,0,0,0,0
20200430,050094,T50反1國泰95購01,,,,,0.00,0.00,0,0,0,0,0,0,0,0,0,0,0,0,0
20200430,050095,國巨國泰95購04,,,,,0.00,0.00,0,0,0,0,0,0,0,0,0,0,0,0,0
20200430,050096,國巨國泰95購05,,,,,0.00,0.00,0,0,0,0,0,0,0,0,0,0,0,0,0
20200430,050097,可成國泰96購02,,,,,0.00,0.00,0,0,0,0,0,0,0,0,0,0,0,0,0
20200430,050098,嘉聯益國泰95購02,,,,,0.00,0.00,0,0,0,0,0,0,0,0,0,0,0,0,0
20200430,050099,台積電永昌96購01,2.00,2.00,2.00,2.00,0.00,0.00,10000,1,20000,0,0,0,0,0,0,10000,10000,0,0
20200430,050100,台積電永昌96購02,,,,,0.00,0.00,0,0,0,0,0,0,0,0,0,0,0,0,0
20200430,050101,台積電永昌96購03,0.14,0.14,0.14,0.14,0.00,0.00,2000,1,280,0,0,0,0,0,0,0,2000,-2000,-2000
20200430,050102,鴻海富邦95購04,0.16,0.16,0.16,0.16,+0.01,6.67,20000,2,3200,0,0,0,0,0,0,0,0,0,0
20200430,050104,元石油元大97購02,0.04,0.07,0.03,0.07,0.00,0.00,13000,4,570,0,0,0,0,0,0,0,0,0,0
20200430,050105,力山元大95購02,0.16,0.16,0.16,0.16,0.00,0.00,15000,1,2400,0,0,0,0,0,0,15000,0,15000,15000
20200430,050111,全新元大95購02,,,,,0.00,0.00,0,0,0,0,0,0,0,0,0,0,0,0,0
20200430,050113,欣興元大95購05,,,,,0.00,0.00,0,0,0,0,0,0,0,0,0,0,0,0,0
20200430,050114,群創元大95購01,,,,,0.00,0.00,0,0,0,0,0,0,0,0,0,0,0,0,0
20200430,050115,群創元大96購01,,,,,0.00,0.00,0,0,0,0,0,0,0,0,0,0,0,0,0
20200430,050117,麗豐元大96購02,0.18,0.18,0.18,0.18,0.00,0.00,3000,1,540,0,0,0,0,0,0,3000,0,3000,3000
20200430,050119,瀚宇博元大95購03,,,,,0.00,0.00,0,0,0,0,0,0,0,0,0,0,0,0,0
20200430,05011P,南電國泰96售01,0.06,0.10,0.06,0.10,0.00,0.00,135000,4,9600,0,0,0,0,0,0,95000,40000,55000,55000
20200430,050120,GIS元大95購02,,,,,0.00,0.00,0,0,0,0,0,0,0,0,0,0,0,0,0
20200430,050121,南電元大95購02,6.45,6.55,5.90,5.95,-0.40,-6.3,40000,5,248500,0,0,0,0,0,0,35000,5000,30000,30000
20200430,050122,臺指反凱基96購01,,,,,0.00,0.00,0,0,0,0,0,0,0,0,0,0,0,0,0
20200430,050123,群臺反凱基96購01,,,,,0.00,0.00,0,0,0,0,0,0,0,0,0,0,0,0,0
20200430,050124,元金2X凱基95購01,,,,,0.00,0.00,0,0,0,0,0,0,0,0,0,0,0,0,0
20200430,050135,禾伸堂兆豐95購01,1.15,1.15,1.12,1.12,+0.07,6.67,15000,2,16950,0,0,0,0,0,0,15000,0,15000,15000
20200430,050137,臺指反國票96購01,,,,,0.00,0.00,0,0,0,0,0,0,0,0,0,0,0,0,0
20200430,050138,台表科國票95購02,1.89,1.89,1.89,1.89,0.00,0.00,25000,1,47250,0,0,0,0,0,0,25000,0,25000,25000
20200430,05013P,台積電元大96售05,,,,,0.00,0.00,0,0,0,0,0,0,0,0,0,0,0,0,0
20200430,050142,聯發科元富9A購01,1.13,1.23,1.12,1.23,+0.24,24.24,1202000,38,1413280,0,0,0,0,0,0,1078000,0,1078000,1078000
20200430,050144,宏達電台新95購01,,,,,0.00,0.00,0,0,0,0,0,0,0,0,0,0,0,0,0
20200430,050150,國巨群益95購01,,,,,0.00,0.00,0,0,0,0,0,0,0,0,0,0,0,0,0
20200430,050155,華新科群益95購01,1.70,1.70,1.70,1.70,+0.03,1.8,10000,1,17000,0,0,0,0,0,0,0,10000,-10000,-10000
20200430,050158,上海銀群益96購01,,,,,0.00,0.00,0,0,0,0,0,0,0,0,0,0,0,0,0
20200430,050160,中石化國泰95購01,,,,,0.00,0.00,0,0,0,0,0,0,0,0,0,0,0,0,0
20200430,050161,鴻海國泰96購03,,,,,0.00,0.00,0,0,0,0,0,0,0,0,0,0,0,0,0
20200430,050162,中環國泰95購01,,,,,0.00,0.00,0,0,0,0,0,0,0,0,0,0,0,0,0
20200430,050163,群創國泰95購01,,,,,0.00,0.00,0,0,0,0,0,0,0,0,0,0,0,0,0
20200430,050164,揚明光國泰95購01,,,,,0.00,0.00,0,0,0,0,0,0,0,0,0,0,0,0,0
20200430,050165,泰鼎國泰95購02,,,,,0.00,0.00,0,0,0,0,0,0,0,0,0,0,0,0,0
20200430,050166,彩晶國泰95購01,,,,,0.00,0.00,0,0,0,0,0,0,0,0,0,0,0,0,0
20200430,050167,T50反1富邦96購01,,,,,0.00,0.00,0,0,0,0,0,0,0,0,0,0,0,0,0
20200430,050168,緯創富邦95購01,0.16,0.16,0.16,0.16,+0.04,33.33,60000,1,9600,0,0,0,0,0,0,60000,0,60000,60000
20200430,050169,臺指反元大97購01,,,,,0.00,0.00,0,0,0,0,0,0,0,0,0,0,0,0,0
20200430,050170,臺指反元大97購02,0.91,0.93,0.85,0.86,-0.12,-12.24,1221000,41,1067140,0,0,0,0,0,0,569000,617000,-48000,-48000
20200430,050171,臺指反元大97購03,1.34,1.34,1.28,1.28,-0.13,-9.22,687000,14,905250,0,0,0,0,0,0,400000,287000,113000,113000
20200430,050172,臺指反元大98購02,0.65,0.65,0.65,0.65,-0.08,-10.96,200000,20,130000,0,0,0,0,0,0,0,200000,-200000,-200000
20200430,050173,旺宏元大96購02,0.58,0.62,0.57,0.60,0.00,0.00,225000,14,131120,0,0,0,0,0,0,220000,0,220000,220000
20200430,050179,全新元大96購02,,,,,0.00,0.00,0,0,0,0,0,0,0,0,0,0,0,0,0
20200430,050180,華新科元大95購08,1.40,1.40,1.40,1.40,0.00,0.00,20000,2,28000,0,0,0,0,0,0,0,20000,-20000,-20000
20200430,050183,奇鋐元大96購01,0.45,0.51,0.44,0.51,+0.07,15.91,123000,11,56940,0,0,0,0,0,0,10000,108000,-98000,-98000
20200430,050185,和鑫元大95購02,,,,,0.00,0.00,0,0,0,0,0,0,0,0,0,0,0,0,0
20200430,050188,貿聯元大96購01,0.28,0.39,0.28,0.39,+0.16,69.57,112000,9,36200,0,0,0,0,0,0,105000,7000,98000,98000
20200430,050190,麗豐元大95購02,,,,,0.00,0.00,0,0,0,0,0,0,0,0,0,0,0,0,0
20200430,050192,康控元大97購01,0.20,0.25,0.20,0.25,0.00,0.00,15000,4,3050,0,0,0,0,0,0,0,14000,-14000,-14000
20200430,050196,嘉聯益元大97購01,,,,,0.00,0.00,0,0,0,0,0,0,0,0,0,0,0,0,0
20200430,050202,建準群益95購01,0.54,0.54,0.54,0.54,-0.05,-8.47,30000,1,16200,0,0,0,0,0,0,30000,0,30000,30000
20200430,050207,百和群益95購01,,,,,0.00,0.00,0,0,0,0,0,0,0,0,0,0,0,0,0
20200430,050208,燿華兆豐95購02,,,,,0.00,0.00,0,0,0,0,0,0,0,0,0,0,0,0,0
20200430,050209,華通國票95購01,,,,,0.00,0.00,0,0,0,0,0,0,0,0,0,0,0,0,0
20200430,050211,貿聯國票95購01,,,,,0.00,0.00,0,0,0,0,0,0,0,0,0,0,0,0,0
20200430,050212,瀚宇博國票95購02,,,,,0.00,0.00,0,0,0,0,0,0,0,0,0,0,0,0,0
20200430,050215,TPK台新96購01,,,,,0.00,0.00,0,0,0,0,0,0,0,0,0,0,0,0,0
20200430,050219,台積電元富95購03,0.84,0.90,0.84,0.90,+0.23,34.33,30000,2,26400,0,0,0,0,0,0,30000,0,30000,30000
20200430,050220,台積電元富96購01,0.53,0.75,0.53,0.75,0.00,0.00,6000,2,3400,0,0,0,0,0,0,6000,0,6000,6000
20200430,050227,大立光中信96購01,0.15,0.19,0.14,0.19,+0.06,46.15,40000,3,6200,0,0,0,0,0,0,20000,20000,0,0
20200430,050228,中磊中信96購01,0.44,0.44,0.44,0.44,0.00,0.00,10000,1,4400,0,0,0,0,0,0,10000,0,10000,10000
20200430,050232,奇鋐麥證95購01,0.33,0.35,0.33,0.35,+0.01,2.94,80000,7,27170,0,80000,-80000,0,0,0,0,80000,-80000,-80000
20200430,050233,香港2X凱基96購01,,,,,0.00,0.00,0,0,0,0,0,0,0,0,0,0,0,0,0
20200430,05024P,華通國票96售01,1.09,1.09,1.06,1.06,-0.26,-19.7,33000,7,35760,0,0,0,0,0,0,26000,7000,19000,19000
20200430,050252,聯發科國泰95購01,3.14,3.71,3.14,3.71,+1.31,54.58,72000,9,232560,0,0,0,0,0,0,72000,0,72000,72000
20200430,050253,百和國泰96購01,0.15,0.15,0.15,0.15,-0.02,-11.76,65000,3,9750,0,0,0,0,0,0,65000,0,65000,65000
20200430,050254,大立光富邦96購02,0.67,0.73,0.67,0.73,+0.11,17.74,36000,4,25400,0,0,0,0,0,0,10000,26000,-16000,-16000
20200430,050255,GIS富邦95購01,,,,,0.00,0.00,0,0,0,0,0,0,0,0,0,0,0,0,0
20200430,050256,臺指反元大98購03,0.54,0.54,0.54,0.54,-0.07,-11.48,10000,1,5400,0,0,0,0,0,0,0,10000,-10000,-10000
20200430,050261,國巨元大95購04,0.83,0.83,0.82,0.82,+0.02,2.5,15000,3,12400,0,0,0,0,0,0,5000,0,5000,5000
20200430,050268,智原元大95購03,,,,,0.00,0.00,0,0,0,0,0,0,0,0,0,0,0,0,0
20200430,050271,上緯控元大96購01,,,,,0.00,0.00,0,0,0,0,0,0,0,0,0,0,0,0,0
20200430,050282,T50反1凱基97購01,1.48,1.48,1.48,1.48,-0.10,-6.33,100000,1,148000,0,0,0,0,0,0,0,100000,-100000,-100000
20200430,050283,T50反1凱基9A購01,0.58,0.58,0.58,0.58,0.00,0.00,10000,1,5800,0,0,0,0,0,0,0,10000,-10000,-10000
20200430,050303,S&P反1中信96購01,,,,,0.00,0.00,0,0,0,0,0,0,0,0,0,0,0,0,0
20200430,050305,正崴中信95購01,,,,,0.00,0.00,0,0,0,0,0,0,0,0,0,0,0,0,0
20200430,050306,聯發科中信97購01,0.75,0.89,0.75,0.89,+0.19,27.14,159000,19,131070,0,0,0,0,0,0,134000,2000,132000,132000
20200430,050307,欣興中信95購01,0.11,0.13,0.11,0.12,+0.03,33.33,110000,5,13200,0,0,0,0,0,0,0,110000,-110000,-110000
20200430,050308,矽創中信97購01,,,,,0.00,0.00,0,0,0,0,0,0,0,0,0,0,0,0,0
20200430,050311,上銀兆豐95購01,1.22,1.22,1.22,1.22,0.00,0.00,1000,1,1220,0,0,0,0,0,0,1000,0,1000,1000
20200430,050315,和碩兆豐95購01,1.04,1.07,0.96,0.98,+0.01,1.03,27000,9,26510,0,0,0,0,0,0,15000,12000,3000,3000
20200430,050316,上証2X國票98購01,0.08,0.08,0.08,0.08,0.00,0.00,2000,1,160,0,0,0,0,0,0,2000,0,2000,2000
20200430,050317,和鑫國票95購02,,,,,0.00,0.00,0,0,0,0,0,0,0,0,0,0,0,0,0
20200430,050319,康控國票95購04,,,,,0.00,0.00,0,0,0,0,0,0,0,0,0,0,0,0,0
20200430,050321,GIS國票95購02,,,,,0.00,0.00,0,0,0,0,0,0,0,0,0,0,0,0,0
20200430,050322,世紀鋼國票95購01,0.93,1.03,0.93,1.03,+0.10,10.75,430000,3,437710,0,0,0,0,0,0,0,430000,-430000,-430000
20200430,05032P,台積電國泰96售05,,,,,0.00,0.00,0,0,0,0,0,0,0,0,0,0,0,0,0
20200430,050332,鴻海國泰96購05,,,,,0.00,0.00,0,0,0,0,0,0,0,0,0,0,0,0,0
20200430,050333,鴻海國泰96購06,,,,,0.00,0.00,0,0,0,0,0,0,0,0,0,0,0,0,0
20200430,050334,鴻海國泰96購07,0.26,0.26,0.26,0.26,0.00,0.00,10000,1,2600,0,0,0,0,0,0,10000,0,10000,10000
20200430,050335,正崴國泰96購01,0.22,0.22,0.22,0.22,0.00,0.00,1000,1,220,0,0,0,0,0,0,1000,0,1000,1000
20200430,050337,南電國泰95購01,,,,,0.00,0.00,0,0,0,0,0,0,0,0,0,0,0,0,0
20200430,050338,TPK富邦96購01,0.01,0.01,0.01,0.01,0.00,0.00,20000,1,200,0,0,0,0,0,0,0,0,0,0
20200430,05033P,T50反1元大98售01,0.91,1.08,0.91,1.08,0.00,0.00,51000,2,46580,0,0,0,0,0,0,50000,1000,49000,49000
20200430,050344,鴻海元富96購01,,,,,0.00,0.00,0,0,0,0,0,0,0,0,0,0,0,0,0
20200430,050347,上証2X群益98購01,,,,,0.00,0.00,0,0,0,0,0,0,0,0,0,0,0,0,0
20200430,050351,華新科群益95購02,,,,,0.00,0.00,0,0,0,0,0,0,0,0,0,0,0,0,0
20200430,050352,欣興群益95購01,,,,,0.00,0.00,0,0,0,0,0,0,0,0,0,0,0,0,0
20200430,050353,華擎群益95購01,,,,,0.00,0.00,0,0,0,0,0,0,0,0,0,0,0,0,0
20200430,050363,臺指反元大98購04,1.00,1.00,1.00,1.00,0.00,0.00,15000,2,15000,0,0,0,0,0,0,0,0,0,0
20200430,050372,全新元大96購03,,,,,0.00,0.00,0,0,0,0,0,0,0,0,0,0,0,0,0
20200430,050374,上緯控元大95購01,,,,,0.00,0.00,0,0,0,0,0,0,0,0,0,0,0,0,0
20200430,050376,百和元大95購01,,,,,0.00,0.00,0,0,0,0,0,0,0,0,0,0,0,0,0
20200430,050378,上証2X群益98購02,0.19,0.24,0.16,0.24,+0.01,4.35,56000,7,10090,0,0,0,0,0,0,0,1000,-1000,-1000
20200430,050379,易華電群益96購01,,,,,0.00,0.00,0,0,0,0,0,0,0,0,0,0,0,0,0
20200430,050382,TPK兆豐95購02,,,,,0.00,0.00,0,0,0,0,0,0,0,0,0,0,0,0,0
20200430,050383,超眾兆豐95購01,,,,,0.00,0.00,0,0,0,0,0,0,0,0,0,0,0,0,0
20200430,050385,貿聯國票95購02,0.54,0.54,0.54,0.54,+0.24,80.0,56000,1,30240,0,0,0,0,0,0,0,56000,-56000,-56000
20200430,050389,鴻海統一95購04,,,,,0.00,0.00,0,0,0,0,0,0,0,0,0,0,0,0,0
20200430,050392,群創統一96購01,0.35,0.35,0.35,0.35,-0.02,-5.41,48000,1,16800,0,0,0,0,0,0,0,48000,-48000,-48000
20200430,050398,上証2X中信97購01,,,,,0.00,0.00,0,0,0,0,0,0,0,0,0,0,0,0,0
20200430,050399,潤泰全中信95購01,,,,,0.00,0.00,0,0,0,0,0,0,0,0,0,0,0,0,0
20200430,05039P,鴻海凱基95售10,,,,,0.00,0.00,0,0,0,0,0,0,0,0,0,0,0,0,0
20200430,050400,臻鼎中信97購01,0.03,0.05,0.03,0.05,-0.01,-16.67,21000,2,650,0,0,0,0,0,0,0,0,0,0
20200430,050402,緯穎中信96購01,1.41,1.75,1.41,1.75,0.00,0.00,11000,2,16190,0,0,0,0,0,0,11000,0,11000,11000
20200430,050406,台積電台新95購02,,,,,0.00,0.00,0,0,0,0,0,0,0,0,0,0,0,0,0
20200430,05040P,聯發科凱基95售05,,,,,0.00,0.00,0,0,0,0,0,0,0,0,0,0,0,0,0
20200430,050410,燿華永豐95購03,,,,,0.00,0.00,0,0,0,0,0,0,0,0,0,0,0,0,0
20200430,050416,高股息凱基96購02,0.06,0.08,0.06,0.08,+0.01,14.29,691000,8,48170,0,0,0,0,0,0,651000,0,651000,651000
20200430,050419,鴻海凱基95購02,0.06,0.07,0.06,0.07,+0.01,16.67,76000,3,4590,0,0,0,0,0,0,76000,0,76000,76000
20200430,05041P,大立光凱基95售09,0.77,0.77,0.77,0.77,0.00,0.00,550000,2,423500,0,0,0,0,0,0,550000,550000,0,0
20200430,050420,鴻海凱基95購03,,,,,0.00,0.00,0,0,0,0,0,0,0,0,0,0,0,0,0
20200430,050421,鴻海凱基95購04,,,,,0.00,0.00,0,0,0,0,0,0,0,0,0,0,0,0,0
20200430,050422,鴻海凱基96購01,,,,,0.00,0.00,0,0,0,0,0,0,0,0,0,0,0,0,0
20200430,050423,鴻海凱基96購02,,,,,0.00,0.00,0,0,0,0,0,0,0,0,0,0,0,0,0
20200430,050424,鴻海凱基96購03,,,,,0.00,0.00,0,0,0,0,0,0,0,0,0,0,0,0,0
20200430,05042P,GIS凱基95售03,,,,,0.00,0.00,0,0,0,0,0,0,0,0,0,0,0,0,0
20200430,05043P,佳世達元富95售01,,,,,0.00,0.00,0,0,0,0,0,0,0,0,0,0,0,0,0
20200430,050449,宏達電元大95購03,,,,,0.00,0.00,0,0,0,0,0,0,0,0,0,0,0,0,0
20200430,05044P,亞德客永豐95售01,,,,,0.00,0.00,0,0,0,0,0,0,0,0,0,0,0,0,0
20200430,050451,嘉晶元大95購01,0.54,0.68,0.54,0.68,+0.17,33.33,23000,2,12840,0,0,0,0,0,0,23000,0,23000,23000
20200430,050452,智原元大95購04,,,,,0.00,0.00,0,0,0,0,0,0,0,0,0,0,0,0,0
20200430,050453,創意元大95購03,,,,,0.00,0.00,0,0,0,0,0,0,0,0,0,0,0,0,0
20200430,05045P,台積電永豐95售01,,,,,0.00,0.00,0,0,0,0,0,0,0,0,0,0,0,0,0
20200430,050460,GIS元大95購03,,,,,0.00,0.00,0,0,0,0,0,0,0,0,0,0,0,0,0
20200430,050461,GIS元大95購04,,,,,0.00,0.00,0,0,0,0,0,0,0,0,0,0,0,0,0
20200430,050464,華通國泰95購01,,,,,0.00,0.00,0,0,0,0,0,0,0,0,0,0,0,0,0
20200430,05046P,台光電永豐95售02,,,,,0.00,0.00,0,0,0,0,0,0,0,0,0,0,0,0,0
20200430,050475,揚明光永豐95購01,,,,,0.00,0.00,0,0,0,0,0,0,0,0,0,0,0,0,0
20200430,050479,上証2X國票95購02,,,,,0.00,0.00,0,0,0,0,0,0,0,0,0,0,0,0,0
20200430,05047P,強茂永豐95售02,,,,,0.00,0.00,0,0,0,0,0,0,0,0,0,0,0,0,0
20200430,050480,健策國票95購04,4.50,4.75,4.50,4.75,+0.57,13.64,30000,3,138000,0,0,0,0,0,0,10000,30000,-20000,-20000
20200430,050481,泰鼎國票96購01,2.62,2.62,2.46,2.62,-0.41,-13.53,74000,9,185040,0,0,0,0,0,0,64000,10000,54000,54000
20200430,050484,世紀鋼國票95購02,0.95,0.98,0.95,0.98,0.00,0.00,327000,4,313930,0,0,0,0,0,0,0,327000,-327000,-327000
20200430,050485,國巨統一96購01,3.08,3.10,3.08,3.10,0.00,0.00,20000,2,61980,0,0,0,0,0,0,20000,0,20000,20000
20200430,05048P,同欣電永豐95售01,,,,,0.00,0.00,0,0,0,0,0,0,0,0,0,0,0,0,0
20200430,050490,上証2X國泰95購01,,,,,0.00,0.00,0,0,0,0,0,0,0,0,0,0,0,0,0
20200430,050491,旺宏國泰96購01,1.32,1.40,1.32,1.40,0.00,0.00,89000,11,121780,0,0,0,0,0,0,34000,5000,29000,29000
20200430,050492,漢唐國泰96購01,,,,,0.00,0.00,0,0,0,0,0,0,0,0,0,0,0,0,0
20200430,050493,聯發科永昌96購01,0.81,0.93,0.81,0.93,+0.40,75.47,27000,3,22210,0,0,0,0,0,0,25000,2000,23000,23000
20200430,050494,可成永昌96購01,,,,,0.00,0.00,0,0,0,0,0,0,0,0,0,0,0,0,0
20200430,050495,大立光永昌96購01,,,,,0.00,0.00,0,0,0,0,0,0,0,0,0,0,0,0,0
20200430,050496,鴻海富邦96購01,0.09,0.13,0.07,0.13,+0.04,44.44,691000,20,59470,0,0,0,0,0,0,283000,596000,-313000,-313000
20200430,050497,臺指反凱基96購02,,,,,0.00,0.00,0,0,0,0,0,0,0,0,0,0,0,0,0
20200430,05049P,矽創永豐95售01,,,,,0.00,0.00,0,0,0,0,0,0,0,0,0,0,0,0,0
20200430,050508,上証2X元大97購01,,,,,0.00,0.00,0,0,0,0,0,0,0,0,0,0,0,0,0
20200430,05050P,華通群益96售02,,,,,0.00,0.00,0,0,0,0,0,0,0,0,0,0,0,0,0
20200430,050515,聯電元大96購01,0.83,0.85,0.80,0.85,+0.05,6.25,381000,17,321130,0,0,0,0,0,0,316000,64000,252000,252000
20200430,050516,華通元大95購05,,,,,0.00,0.00,0,0,0,0,0,0,0,0,0,0,0,0,0
20200430,050519,旺宏元大95購03,1.09,1.09,1.00,1.04,+0.20,23.81,115000,5,122350,0,0,0,0,0,0,115000,0,115000,115000
20200430,05051P,鴻海群益95售05,,,,,0.00,0.00,0,0,0,0,0,0,0,0,0,0,0,0,0
20200430,050522,聯發科元大95購03,2.23,2.68,2.23,2.58,+0.73,39.46,95000,15,229750,0,0,0,0,0,0,63000,10000,53000,53000
20200430,050524,宏達電元大95購04,,,,,0.00,0.00,0,0,0,0,0,0,0,0,0,0,0,0,0
20200430,050525,嘉晶元大95購02,0.13,0.13,0.13,0.13,0.00,0.00,30000,1,3900,0,0,0,0,0,0,30000,0,30000,30000
20200430,050526,貿聯元大95購01,0.06,0.06,0.06,0.06,0.00,0.00,120000,1,7200,0,0,0,0,0,0,120000,0,120000,120000
20200430,050527,嘉聯益元大96購01,,,,,0.00,0.00,0,0,0,0,0,0,0,0,0,0,0,0,0
20200430,05052P,友達群益97售01,0.53,0.53,0.50,0.50,0.00,0.00,11000,2,5800,0,0,0,0,0,0,0,11000,-11000,-11000
20200430,050530,台表科元大95購04,,,,,0.00,0.00,0,0,0,0,0,0,0,0,0,0,0,0,0
20200430,050531,訊芯元大95購02,,,,,0.00,0.00,0,0,0,0,0,0,0,0,0,0,0,0,0
20200430,050536,亞泥凱基95購01,,,,,0.00,0.00,0,0,0,0,0,0,0,0,0,0,0,0,0
20200430,050537,鴻海凱基95購05,0.37,0.37,0.37,0.37,0.00,0.00,40000,2,14800,0,0,0,0,0,0,0,40000,-40000,-40000
20200430,050538,鴻海凱基95購06,,,,,0.00,0.00,0,0,0,0,0,0,0,0,0,0,0,0,0
20200430,050539,鴻海凱基95購07,,,,,0.00,0.00,0,0,0,0,0,0,0,0,0,0,0,0,0
20200430,05053P,新日興群益95售01,,,,,0.00,0.00,0,0,0,0,0,0,0,0,0,0,0,0,0
20200430,050542,宏碁凱基95購01,,,,,0.00,0.00,0,0,0,0,0,0,0,0,0,0,0,0,0
20200430,050543,聯發科凱基95購01,0.80,0.91,0.80,0.91,+0.51,127.5,4000,2,3420,0,0,0,0,0,0,4000,0,4000,4000
20200430,050544,聯發科凱基95購02,,,,,0.00,0.00,0,0,0,0,0,0,0,0,0,0,0,0,0
20200430,050545,奇力新凱基95購01,3.23,3.23,3.23,3.23,0.00,0.00,20000,2,64600,0,0,0,0,0,0,0,0,0,0
20200430,050547,華新科凱基95購01,1.67,1.67,1.67,1.67,0.00,0.00,4000,1,6680,0,0,0,0,0,0,0,4000,-4000,-4000
20200430,050548,華固凱基95購01,0.55,0.55,0.55,0.55,0.00,0.00,20000,1,11000,0,0,0,0,0,0,20000,0,20000,20000
20200430,050549,慧洋凱基95購01,,,,,0.00,0.00,0,0,0,0,0,0,0,0,0,0,0,0,0
20200430,05054P,臻鼎群益95售02,,,,,0.00,0.00,0,0,0,0,0,0,0,0,0,0,0,0,0
20200430,050550,大立光凱基95購04,,,,,0.00,0.00,0,0,0,0,0,0,0,0,0,0,0,0,0
20200430,050551,大立光凱基95購05,0.82,0.98,0.82,0.98,+0.12,13.95,166000,7,144890,0,0,0,0,0,0,96000,70000,26000,26000
20200430,050554,百和凱基95購01,,,,,0.00,0.00,0,0,0,0,0,0,0,0,0,0,0,0,0
20200430,050556,道瓊銀統一95購01,,,,,0.00,0.00,0,0,0,0,0,0,0,0,0,0,0,0,0
20200430,05055P,台表科群益95售01,,,,,0.00,0.00,0,0,0,0,0,0,0,0,0,0,0,0,0
20200430,050561,上証2X元富97購01,,,,,0.00,0.00,0,0,0,0,0,0,0,0,0,0,0,0,0
20200430,050566,高股息中信97購02,0.20,0.22,0.20,0.22,+0.06,37.5,271000,4,54440,0,0,0,0,0,0,259000,0,259000,259000
20200430,050567,道瓊銀中信96購01,,,,,0.00,0.00,0,0,0,0,0,0,0,0,0,0,0,0,0
20200430,050568,為升中信97購01,,,,,0.00,0.00,0,0,0,0,0,0,0,0,0,0,0,0,0
20200430,05056P,訊芯群益95售01,,,,,0.00,0.00,0,0,0,0,0,0,0,0,0,0,0,0,0
20200430,050570,聯發科中信97購02,0.26,0.31,0.26,0.31,0.00,0.00,2000,2,570,0,0,0,0,0,0,0,1000,-1000,-1000
20200430,050571,美食中信95購01,,,,,0.00,0.00,0,0,0,0,0,0,0,0,0,0,0,0,0
20200430,050572,大立光中信97購01,,,,,0.00,0.00,0,0,0,0,0,0,0,0,0,0,0,0,0
20200430,050576,南亞科國票95購01,,,,,0.00,0.00,0,0,0,0,0,0,0,0,0,0,0,0,0
20200430,050578,聯發科國票95購03,0.13,0.13,0.13,0.13,+0.08,160.0,60000,1,7800,0,0,0,0,0,0,60000,0,60000,60000
20200430,050579,聯發科國票95購04,1.56,1.70,1.56,1.70,+0.50,41.67,25000,3,39700,0,0,0,0,0,0,25000,0,25000,25000
20200430,05057P,鴻海國票96售01,,,,,0.00,0.00,0,0,0,0,0,0,0,0,0,0,0,0,0
20200430,050580,強茂國票95購01,0.38,0.38,0.38,0.38,-0.03,-7.32,71000,2,26980,0,0,0,0,0,0,71000,0,71000,71000
20200430,050584,瑞儀國票95購01,,,,,0.00,0.00,0,0,0,0,0,0,0,0,0,0,0,0,0
20200430,050588,矽創國票95購01,,,,,0.00,0.00,0,0,0,0,0,0,0,0,0,0,0,0,0
20200430,05058P,燿華國票97售01,,,,,0.00,0.00,0,0,0,0,0,0,0,0,0,0,0,0,0
20200430,050590,晶技永豐95購01,4.81,4.81,4.81,4.81,-0.03,-0.62,48000,1,230880,0,0,0,0,0,0,48000,48000,0,0
20200430,05059P,大立光國票96售02,1.55,1.55,1.49,1.49,-0.44,-22.8,172000,4,265640,0,0,0,0,0,0,156000,16000,140000,140000
20200430,050600,瑞儀國泰95購01,,,,,0.00,0.00,0,0,0,0,0,0,0,0,0,0,0,0,0
20200430,050601,台表科國泰96購01,0.38,0.41,0.38,0.41,0.00,0.00,72000,12,28500,0,0,0,0,0,0,11000,61000,-50000,-50000
20200430,050602,訊芯國泰96購01,,,,,0.00,0.00,0,0,0,0,0,0,0,0,0,0,0,0,0
20200430,050603,致新國泰96購01,,,,,0.00,0.00,0,0,0,0,0,0,0,0,0,0,0,0,0
20200430,050605,上証2X元大97購02,0.12,0.12,0.12,0.12,0.00,0.00,100000,1,12000,0,0,0,0,0,0,100000,0,100000,100000
20200430,05060P,台達電富邦97售02,0.38,0.38,0.35,0.35,-0.07,-16.67,120000,13,43650,0,0,0,0,0,0,0,115000,-115000,-115000
20200430,050611,鴻海元大95購02,,,,,0.00,0.00,0,0,0,0,0,0,0,0,0,0,0,0,0
20200430,050612,台積電元大95購06,,,,,0.00,0.00,0,0,0,0,0,0,0,0,0,0,0,0,0
20200430,050614,聯發科元大95購04,0.70,0.76,0.70,0.76,+0.23,43.4,30000,3,22100,0,0,0,0,0,0,30000,0,30000,30000
20200430,050615,奇力新元大95購03,,,,,0.00,0.00,0,0,0,0,0,0,0,0,0,0,0,0,0
20200430,050618,緯創元大95購01,0.96,1.01,0.96,1.01,0.00,0.00,11000,2,11060,0,0,0,0,0,0,1000,10000,-9000,-9000
20200430,050619,TPK元大95購02,,,,,0.00,0.00,0,0,0,0,0,0,0,0,0,0,0,0,0
20200430,05061P,鴻海富邦96售03,,,,,0.00,0.00,0,0,0,0,0,0,0,0,0,0,0,0,0
20200430,050621,易華電元大95購01,,,,,0.00,0.00,0,0,0,0,0,0,0,0,0,0,0,0,0
20200430,050626,A50正2中信96購02,,,,,0.00,0.00,0,0,0,0,0,0,0,0,0,0,0,0,0
20200430,050629,廣宇亞東96購01,,,,,0.00,0.00,0,0,0,0,0,0,0,0,0,0,0,0,0
20200430,05062P,大立光富邦98售03,,,,,0.00,0.00,0,0,0,0,0,0,0,0,0,0,0,0,0
20200430,050630,大立光亞東96購01,,,,,0.00,0.00,0,0,0,0,0,0,0,0,0,0,0,0,0
20200430,050633,義隆群益96購02,,,,,0.00,0.00,0,0,0,0,0,0,0,0,0,0,0,0,0
20200430,050634,華新科群益96購01,,,,,0.00,0.00,0,0,0,0,0,0,0,0,0,0,0,0,0
20200430,050639,GIS國票96購01,,,,,0.00,0.00,0,0,0,0,0,0,0,0,0,0,0,0,0
20200430,05063P,聯電元大96售03,0.24,0.24,0.19,0.19,-0.12,-38.71,48000,5,9900,0,0,0,0,0,0,28000,15000,13000,13000
20200430,050641,上証反凱基96購01,0.42,0.42,0.42,0.42,0.00,0.00,40000,1,16800,0,0,0,0,0,0,40000,0,40000,40000
20200430,050644,國巨凱基96購01,3.58,3.69,3.58,3.58,+0.29,8.81,8000,3,28970,0,0,0,0,0,0,8000,2000,6000,6000
20200430,050646,美律凱基96購01,,,,,0.00,0.00,0,0,0,0,0,0,0,0,0,0,0,0,0
20200430,050647,聯發科凱基96購01,,,,,0.00,0.00,0,0,0,0,0,0,0,0,0,0,0,0,0
20200430,050648,全新凱基96購01,0.06,0.06,0.06,0.06,0.00,0.00,28000,1,1680,0,0,0,0,0,0,28000,0,28000,28000
20200430,050649,華新科凱基96購01,1.33,1.33,1.33,1.33,0.00,0.00,50000,1,66500,0,0,0,0,0,0,50000,0,50000,50000
20200430,05064P,台積電元大95售10,,,,,0.00,0.00,0,0,0,0,0,0,0,0,0,0,0,0,0
20200430,050650,大立光凱基96購01,0.35,0.35,0.35,0.35,0.00,0.00,5000,1,1750,0,0,0,0,0,0,5000,0,5000,5000
20200430,050651,大立光凱基96購02,0.76,0.86,0.76,0.86,+0.08,10.26,174000,7,140820,0,0,0,0,0,0,104000,70000,34000,34000
20200430,050652,大立光凱基96購03,0.03,0.03,0.03,0.03,0.00,0.00,7000,1,210,0,0,0,0,0,0,7000,0,7000,7000
20200430,050653,聯鈞凱基96購01,,,,,0.00,0.00,0,0,0,0,0,0,0,0,0,0,0,0,0
20200430,050654,鎧勝凱基96購01,,,,,0.00,0.00,0,0,0,0,0,0,0,0,0,0,0,0,0
20200430,050655,中磊凱基96購01,,,,,0.00,0.00,0,0,0,0,0,0,0,0,0,0,0,0,0
20200430,050656,瑞儀凱基96購01,,,,,0.00,0.00,0,0,0,0,0,0,0,0,0,0,0,0,0
20200430,050658,台郡麥證96購01,1.28,1.28,1.28,1.28,-0.02,-1.54,1000,1,1280,0,1000,-1000,0,0,0,0,1000,-1000,-1000
20200430,050659,宏達電元大96購01,,,,,0.00,0.00,0,0,0,0,0,0,0,0,0,0,0,0,0
20200430,05065P,燿華元大96售03,,,,,0.00,0.00,0,0,0,0,0,0,0,0,0,0,0,0,0
20200430,050660,欣興元大96購02,0.06,0.06,0.06,0.06,0.00,0.00,2000,1,120,0,0,0,0,0,0,2000,0,2000,2000
20200430,050662,智易元大96購01,,,,,0.00,0.00,0,0,0,0,0,0,0,0,0,0,0,0,0
20200430,050663,麗豐元大96購03,,,,,0.00,0.00,0,0,0,0,0,0,0,0,0,0,0,0,0
20200430,050669,嘉晶永豐96購01,0.02,0.02,0.02,0.02,0.00,0.00,32000,1,640,0,0,0,0,0,0,32000,0,32000,32000
20200430,05066P,康控元大95售03,,,,,0.00,0.00,0,0,0,0,0,0,0,0,0,0,0,0,0
20200430,050672,上証2X富邦97購01,,,,,0.00,0.00,0,0,0,0,0,0,0,0,0,0,0,0,0
20200430,050673,旺宏富邦96購02,0.94,1.03,0.92,0.92,+0.10,12.2,235000,19,228660,0,0,0,0,0,0,87000,25000,62000,62000
20200430,050675,奇鋐富邦96購01,0.05,0.05,0.04,0.04,0.00,0.00,14000,2,600,0,0,0,0,0,0,10000,0,10000,10000
20200430,050676,道瓊銀統一96購02,,,,,0.00,0.00,0,0,0,0,0,0,0,0,0,0,0,0,0
20200430,050679,上証2X元富97購02,0.29,0.29,0.28,0.28,0.00,0.00,136000,2,39190,0,0,0,0,0,0,0,136000,-136000,-136000
20200430,05067P,欣興兆豐96售02,,,,,0.00,0.00,0,0,0,0,0,0,0,0,0,0,0,0,0
20200430,050686,欣興兆豐96購01,0.34,0.38,0.34,0.35,-0.02,-5.41,381000,18,134290,0,0,0,0,0,0,289000,50000,239000,239000
20200430,05068P,鴻海統一95售06,,,,,0.00,0.00,0,0,0,0,0,0,0,0,0,0,0,0,0
20200430,050690,台達電凱基96購01,0.83,1.05,0.79,1.01,+0.29,40.28,275000,39,260270,0,0,0,0,0,0,213000,202000,11000,11000
20200430,050691,楠梓電凱基96購01,,,,,0.00,0.00,0,0,0,0,0,0,0,0,0,0,0,0,0
20200430,050692,鴻海凱基96購04,,,,,0.00,0.00,0,0,0,0,0,0,0,0,0,0,0,0,0
20200430,050693,鴻海凱基96購05,,,,,0.00,0.00,0,0,0,0,0,0,0,0,0,0,0,0,0
20200430,050694,國巨凱基96購03,3.46,3.56,3.31,3.52,+0.32,10.0,38000,12,131090,0,0,0,0,0,0,24000,24000,0,0
20200430,050696,台光電凱基96購01,,,,,0.00,0.00,0,0,0,0,0,0,0,0,0,0,0,0,0
20200430,050697,冠德凱基96購01,,,,,0.00,0.00,0,0,0,0,0,0,0,0,0,0,0,0,0
20200430,050698,明泰凱基96購01,0.41,0.41,0.39,0.39,+0.01,2.63,60000,2,24000,0,0,0,0,0,0,30000,30000,0,0
20200430,050699,京鼎凱基96購01,,,,,0.00,0.00,0,0,0,0,0,0,0,0,0,0,0,0,0
20200430,05069P,鴻海統一96售03,,,,,0.00,0.00,0,0,0,0,0,0,0,0,0,0,0,0,0
20200430,050700,健策凱基96購01,,,,,0.00,0.00,0,0,0,0,0,0,0,0,0,0,0,0,0
20200430,050705,南電凱基96購01,1.69,1.69,1.55,1.55,-0.07,-4.32,21000,3,33190,0,0,0,0,0,0,21000,0,21000,21000
20200430,050708,臺股指凱基96購06,0.06,0.06,0.02,0.06,+0.02,50.0,129000,9,5160,0,0,0,0,0,0,0,0,0,0
20200430,050709,嘉聯益第一96購01,,,,,0.00,0.00,0,0,0,0,0,0,0,0,0,0,0,0,0
20200430,05070P,鴻海統一96售04,,,,,0.00,0.00,0,0,0,0,0,0,0,0,0,0,0,0,0
20200430,050710,元黃金中信96購01,,,,,0.00,0.00,0,0,0,0,0,0,0,0,0,0,0,0,0
20200430,050714,深中小群益98購01,0.44,0.46,0.44,0.46,+0.05,12.2,2000,2,900,0,0,0,0,0,0,2000,0,2000,2000
20200430,050715,台積電群益96購01,0.01,0.01,0.01,0.01,-0.01,-50.0,110000,7,1100,0,0,0,0,0,0,100000,0,100000,100000
20200430,050716,可成群益96購01,,,,,0.00,0.00,0,0,0,0,0,0,0,0,0,0,0,0,0
20200430,050717,京鼎群益96購01,,,,,0.00,0.00,0,0,0,0,0,0,0,0,0,0,0,0,0
20200430,050719,世紀鋼群益96購01,,,,,0.00,0.00,0,0,0,0,0,0,0,0,0,0,0,0,0
20200430,05071P,鴻海統一96售05,,,,,0.00,0.00,0,0,0,0,0,0,0,0,0,0,0,0,0
20200430,050722,聯電國票96購01,,,,,0.00,0.00,0,0,0,0,0,0,0,0,0,0,0,0,0
20200430,050724,國巨國票96購01,,,,,0.00,0.00,0,0,0,0,0,0,0,0,0,0,0,0,0
20200430,050725,光磊國票96購01,,,,,0.00,0.00,0,0,0,0,0,0,0,0,0,0,0,0,0
20200430,050726,可成國票96購01,,,,,0.00,0.00,0,0,0,0,0,0,0,0,0,0,0,0,0
20200430,05072P,聯電元富95售02,,,,,0.00,0.00,0,0,0,0,0,0,0,0,0,0,0,0,0
20200430,050731,昇陽半國票96購01,,,,,0.00,0.00,0,0,0,0,0,0,0,0,0,0,0,0,0
20200430,05073P,臺股指中信95售09,,,,,0.00,0.00,0,0,0,0,0,0,0,0,0,0,0,0,0
20200430,050749,道瓊銀統一96購03,,,,,0.00,0.00,0,0,0,0,0,0,0,0,0,0,0,0,0
20200430,05074P,鴻海麥證95售01,,,,,0.00,0.00,0,0,0,0,0,0,0,0,0,0,0,0,0
20200430,050754,元金2X元富9B購01,1.42,1.42,1.28,1.32,-0.01,-0.75,24000,5,31000,0,0,0,0,0,0,0,0,0,0
20200430,050758,聯發科元富9B購01,0.55,0.60,0.55,0.60,+0.17,39.53,147000,5,85700,0,0,0,0,0,0,87000,0,87000,87000
20200430,05075P,台積電麥證95售01,0.21,0.21,0.21,0.21,0.00,0.00,2000,1,420,2000,0,2000,0,0,0,2000,0,2000,2000
20200430,050765,鴻海元大96購02,,,,,0.00,0.00,0,0,0,0,0,0,0,0,0,0,0,0,0
20200430,050766,燿華元大96購02,,,,,0.00,0.00,0,0,0,0,0,0,0,0,0,0,0,0,0
20200430,050767,京元電元大96購01,,,,,0.00,0.00,0,0,0,0,0,0,0,0,0,0,0,0,0
20200430,05076P,深中小群益99售02,,,,,0.00,0.00,0,0,0,0,0,0,0,0,0,0,0,0,0
20200430,050774,健策元大96購02,2.03,2.03,1.92,2.03,+0.10,5.18,223000,17,437220,0,0,0,0,0,0,223000,17000,206000,206000
20200430,050775,TPK元大96購01,,,,,0.00,0.00,0,0,0,0,0,0,0,0,0,0,0,0,0
20200430,050776,康控元大96購03,,,,,0.00,0.00,0,0,0,0,0,0,0,0,0,0,0,0,0
20200430,050778,瑞儀元大96購01,0.06,0.06,0.06,0.06,0.00,0.00,60000,2,3600,0,0,0,0,0,0,60000,0,60000,60000
20200430,050779,超眾元大96購03,,,,,0.00,0.00,0,0,0,0,0,0,0,0,0,0,0,0,0
20200430,05077P,智易群益95售02,,,,,0.00,0.00,0,0,0,0,0,0,0,0,0,0,0,0,0
20200430,050780,台表科元大96購01,0.15,0.15,0.15,0.15,0.00,0.00,50000,1,7500,0,0,0,0,0,0,50000,0,50000,50000
20200430,050782,台積電國泰96購03,2.81,2.81,2.81,2.81,+0.19,7.25,5000,1,14050,0,0,0,0,0,0,5000,0,5000,5000
20200430,050783,旺宏國泰96購02,1.42,1.51,1.38,1.38,+0.28,25.45,64000,6,90210,0,0,0,0,0,0,52000,12000,40000,40000
20200430,050784,美律國泰96購01,0.32,0.32,0.32,0.32,+0.06,23.08,1000,1,320,0,0,0,0,0,0,1000,0,1000,1000
20200430,050785,全新國泰96購01,,,,,0.00,0.00,0,0,0,0,0,0,0,0,0,0,0,0,0
20200430,050786,健策國泰96購01,4.31,4.52,4.31,4.52,+0.46,11.33,95000,5,412150,0,0,0,0,0,0,10000,85000,-75000,-75000
20200430,050787,致伸國泰96購01,,,,,0.00,0.00,0,0,0,0,0,0,0,0,0,0,0,0,0
20200430,050788,台郡國泰96購01,,,,,0.00,0.00,0,0,0,0,0,0,0,0,0,0,0,0,0
20200430,050789,矽創國泰96購01,,,,,0.00,0.00,0,0,0,0,0,0,0,0,0,0,0,0,0
20200430,05078P,義隆永豐95售01,,,,,0.00,0.00,0,0,0,0,0,0,0,0,0,0,0,0,0
20200430,050790,昇陽半國泰96購02,,,,,0.00,0.00,0,0,0,0,0,0,0,0,0,0,0,0,0
20200430,050791,聯發科富邦96購01,0.32,0.35,0.32,0.35,+0.14,66.67,30000,4,10200,0,0,0,0,0,0,0,0,0,0
20200430,050792,可成富邦96購01,0.02,0.02,0.02,0.02,-0.01,-33.33,106000,3,2120,0,0,0,0,0,0,106000,0,106000,106000
20200430,050793,大立光富邦96購03,0.28,0.28,0.28,0.28,0.00,0.00,10000,1,2800,0,0,0,0,0,0,10000,0,10000,10000
20200430,050794,大立光富邦96購04,0.48,0.56,0.48,0.56,+0.09,19.15,1135000,17,573070,0,0,0,0,0,0,698000,407000,291000,291000
20200430,050797,聯發科中信99購01,0.48,0.52,0.48,0.52,+0.13,33.33,168000,10,84160,0,0,0,0,0,0,118000,0,118000,118000
20200430,050798,TPK中信96購01,,,,,0.00,0.00,0,0,0,0,0,0,0,0,0,0,0,0,0
20200430,050799,嘉聯益中信98購01,,,,,0.00,0.00,0,0,0,0,0,0,0,0,0,0,0,0,0
20200430,05079P,可成永豐95售01,,,,,0.00,0.00,0,0,0,0,0,0,0,0,0,0,0,0,0
20200430,050801,元金2X群益98購01,,,,,0.00,0.00,0,0,0,0,0,0,0,0,0,0,0,0,0
20200430,050803,康控兆豐96購01,,,,,0.00,0.00,0,0,0,0,0,0,0,0,0,0,0,0,0
20200430,050808,台達電凱基96購02,0.99,1.11,0.99,1.11,+0.30,37.04,50000,5,52800,0,0,0,0,0,0,0,50000,-50000,-50000
20200430,05080P,亞光永豐95售02,,,,,0.00,0.00,0,0,0,0,0,0,0,0,0,0,0,0,0
20200430,050813,旺宏凱基96購01,1.68,1.68,1.68,1.68,0.00,0.00,2000,1,3360,0,0,0,0,0,0,2000,0,2000,2000
20200430,05081P,京鼎永豐95售01,,,,,0.00,0.00,0,0,0,0,0,0,0,0,0,0,0,0,0
20200430,050829,臻鼎凱基96購01,,,,,0.00,0.00,0,0,0,0,0,0,0,0,0,0,0,0,0
20200430,05082P,健策永豐95售02,,,,,0.00,0.00,0,0,0,0,0,0,0,0,0,0,0,0,0
20200430,050835,GIS凱基96購01,,,,,0.00,0.00,0,0,0,0,0,0,0,0,0,0,0,0,0
20200430,050838,為升國票96購01,,,,,0.00,0.00,0,0,0,0,0,0,0,0,0,0,0,0,0
20200430,050839,楠梓電國票96購01,,,,,0.00,0.00,0,0,0,0,0,0,0,0,0,0,0,0,0
20200430,05083P,麗豐永豐95售02,,,,,0.00,0.00,0,0,0,0,0,0,0,0,0,0,0,0,0
20200430,050840,中環國票96購01,,,,,0.00,0.00,0,0,0,0,0,0,0,0,0,0,0,0,0
20200430,050841,國巨國票96購02,,,,,0.00,0.00,0,0,0,0,0,0,0,0,0,0,0,0,0
20200430,050842,旺宏國票97購01,4.44,4.46,4.00,4.46,+0.94,26.7,355000,4,1533300,0,0,0,0,0,0,350000,0,350000,350000
20200430,050843,富邦金國票96購01,,,,,0.00,0.00,0,0,0,0,0,0,0,0,0,0,0,0,0
20200430,050844,大立光國票96購01,,,,,0.00,0.00,0,0,0,0,0,0,0,0,0,0,0,0,0
20200430,050846,緯創國票96購01,1.35,1.41,1.34,1.41,+0.07,5.22,96000,10,131620,0,0,0,0,0,0,48000,48000,0,0
20200430,050847,創意國票96購01,0.30,0.30,0.30,0.30,0.00,0.00,13000,2,3900,0,0,0,0,0,0,0,13000,-13000,-13000
20200430,05084P,嘉聯益永豐95售02,,,,,0.00,0.00,0,0,0,0,0,0,0,0,0,0,0,0,0
20200430,050850,訊連國票96購01,,,,,0.00,0.00,0,0,0,0,0,0,0,0,0,0,0,0,0
20200430,050851,羅麗芬國票96購01,,,,,0.00,0.00,0,0,0,0,0,0,0,0,0,0,0,0,0
20200430,050853,南電國票96購01,1.43,1.43,1.03,1.03,-0.07,-6.36,156000,11,188030,0,0,0,0,0,0,143000,5000,138000,138000
20200430,050854,世紀鋼國票97購01,0.98,1.09,0.98,1.08,+0.12,12.5,345000,5,365040,0,0,0,0,0,0,5000,340000,-335000,-335000
20200430,05085P,鴻海日盛95售01,,,,,0.00,0.00,0,0,0,0,0,0,0,0,0,0,0,0,0
20200430,05086P,鴻海凱基95售13,0.92,0.92,0.90,0.90,0.00,0.00,70000,2,64000,0,0,0,0,0,0,70000,0,70000,70000
20200430,05087P,GIS國泰96售01,1.35,1.35,1.35,1.35,-0.07,-4.93,6000,1,8100,0,0,0,0,0,0,0,6000,-6000,-6000
20200430,050882,華泰國泰96購01,,,,,0.00,0.00,0,0,0,0,0,0,0,0,0,0,0,0,0
20200430,050883,嘉聯益國泰96購01,,,,,0.00,0.00,0,0,0,0,0,0,0,0,0,0,0,0,0
20200430,050884,聯茂國泰96購01,0.24,0.24,0.23,0.23,-0.04,-14.81,35000,5,8340,0,0,0,0,0,0,35000,0,35000,35000
20200430,05088P,大立光富邦99售01,1.01,1.01,1.01,1.01,0.00,0.00,5000,2,5050,0,0,0,0,0,0,0,3000,-3000,-3000
20200430,050890,南電富邦99購01,1.46,1.46,1.35,1.35,-0.02,-1.46,21000,4,30060,0,0,0,0,0,0,20000,5000,15000,15000
20200430,050892,聯電元大96購02,0.81,0.84,0.76,0.84,+0.09,12.0,349000,13,272350,0,0,0,0,0,0,222000,127000,95000,95000
20200430,050893,鴻海元大96購03,0.18,0.25,0.18,0.25,+0.09,56.25,2000,2,430,0,0,0,0,0,0,1000,0,1000,1000
20200430,050894,旺宏元大96購03,1.76,1.76,1.62,1.62,+0.02,1.25,430000,26,719360,0,0,0,0,0,0,374000,63000,311000,311000
20200430,050895,聯發科元大97購01,0.75,0.86,0.72,0.86,+0.25,40.98,170000,7,130370,0,0,0,0,0,0,143000,0,143000,143000
20200430,050896,華新科元大96購02,,,,,0.00,0.00,0,0,0,0,0,0,0,0,0,0,0,0,0
20200430,050898,智原元大96購01,,,,,0.00,0.00,0,0,0,0,0,0,0,0,0,0,0,0,0
20200430,05089P,亞德客元大95售01,,,,,0.00,0.00,0,0,0,0,0,0,0,0,0,0,0,0,0
20200430,050902,南電元大96購01,4.41,4.51,3.90,3.90,-0.20,-4.88,85000,10,368960,0,0,0,0,0,0,55000,30000,25000,25000
20200430,05090P,國巨元大95售05,,,,,0.00,0.00,0,0,0,0,0,0,0,0,0,0,0,0,0
20200430,050911,光磊中信98購01,0.11,0.11,0.11,0.11,0.00,0.00,240000,2,26400,0,0,0,0,0,0,0,240000,-240000,-240000
20200430,050913,全新中信97購01,,,,,0.00,0.00,0,0,0,0,0,0,0,0,0,0,0,0,0
20200430,050915,健策中信98購01,0.97,1.02,0.93,0.96,+0.04,4.35,645000,25,624180,0,0,0,0,0,0,218000,427000,-209000,-209000
20200430,050917,瀚宇博兆豐96購01,,,,,0.00,0.00,0,0,0,0,0,0,0,0,0,0,0,0,0
20200430,05091P,台積電元大95售11,,,,,0.00,0.00,0,0,0,0,0,0,0,0,0,0,0,0,0
20200430,05092P,全新元大95售03,2.30,2.30,2.30,2.30,0.00,0.00,1000,1,2300,0,0,0,0,0,0,1000,0,1000,1000
20200430,050932,台塑國票96購01,,,,,0.00,0.00,0,0,0,0,0,0,0,0,0,0,0,0,0
20200430,050934,喬山國票96購01,0.02,0.03,0.02,0.03,0.00,0.00,1198000,5,29950,0,0,0,0,0,0,1198000,0,1198000,1198000
20200430,050935,劍麟國票96購01,,,,,0.00,0.00,0,0,0,0,0,0,0,0,0,0,0,0,0
20200430,050937,可成國票96購02,,,,,0.00,0.00,0,0,0,0,0,0,0,0,0,0,0,0,0
20200430,050938,智原國票96購01,,,,,0.00,0.00,0,0,0,0,0,0,0,0,0,0,0,0,0
20200430,050939,健鼎國票96購01,,,,,0.00,0.00,0,0,0,0,0,0,0,0,0,0,0,0,0
20200430,05093P,可成元大95售03,,,,,0.00,0.00,0,0,0,0,0,0,0,0,0,0,0,0,0
20200430,050943,楠梓電群益96購01,,,,,0.00,0.00,0,0,0,0,0,0,0,0,0,0,0,0,0
20200430,050949,亞光群益96購01,,,,,0.00,0.00,0,0,0,0,0,0,0,0,0,0,0,0,0
20200430,05094P,大立光元大95售07,,,,,0.00,0.00,0,0,0,0,0,0,0,0,0,0,0,0,0
20200430,050950,健鼎群益96購01,,,,,0.00,0.00,0,0,0,0,0,0,0,0,0,0,0,0,0
20200430,050951,緯創群益96購01,,,,,0.00,0.00,0,0,0,0,0,0,0,0,0,0,0,0,0
20200430,050952,健策群益96購01,,,,,0.00,0.00,0,0,0,0,0,0,0,0,0,0,0,0,0
20200430,050955,達方群益97購01,0.66,0.70,0.66,0.70,0.00,0.00,88000,2,60080,0,0,0,0,0,0,0,88000,-88000,-88000
20200430,050957,T50反1台新05購01,0.70,0.75,0.61,0.61,-0.10,-14.08,20000,5,13550,0,0,0,0,0,0,9000,11000,-2000,-2000
20200430,05095P,景碩元大95售01,,,,,0.00,0.00,0,0,0,0,0,0,0,0,0,0,0,0,0
20200430,050965,揚明光永豐96購01,,,,,0.00,0.00,0,0,0,0,0,0,0,0,0,0,0,0,0
20200430,05096P,台積電日盛95售01,,,,,0.00,0.00,0,0,0,0,0,0,0,0,0,0,0,0,0
20200430,050979,鴻海元富96購02,,,,,0.00,0.00,0,0,0,0,0,0,0,0,0,0,0,0,0
20200430,05097P,聯發科日盛95售01,,,,,0.00,0.00,0,0,0,0,0,0,0,0,0,0,0,0,0
20200430,050982,台積電國泰96購04,,,,,0.00,0.00,0,0,0,0,0,0,0,0,0,0,0,0,0
20200430,050983,新光金國泰97購01,,,,,0.00,0.00,0,0,0,0,0,0,0,0,0,0,0,0,0
20200430,050984,大立光國泰97購01,0.55,0.68,0.55,0.68,0.00,0.00,4000,3,2460,0,0,0,0,0,0,4000,0,4000,4000
20200430,050985,易華電國泰96購02,,,,,0.00,0.00,0,0,0,0,0,0,0,0,0,0,0,0,0
20200430,050986,上証2X永昌97購01,,,,,0.00,0.00,0,0,0,0,0,0,0,0,0,0,0,0,0
20200430,05098P,鴻海凱基95售15,,,,,0.00,0.00,0,0,0,0,0,0,0,0,0,0,0,0,0
20200430,050991,元油2X元大96購04,0.01,0.01,0.01,0.01,0.00,0.00,160000,16,1600,0,0,0,0,0,0,0,0,0,0
20200430,050992,台積電元大97購01,0.87,0.90,0.87,0.90,+0.05,5.88,5000,2,4470,0,0,0,0,0,0,5000,0,5000,5000
20200430,050994,欣興元大96購03,,,,,0.00,0.00,0,0,0,0,0,0,0,0,0,0,0,0,0
20200430,05099P,台積電凱基95售06,,,,,0.00,0.00,0,0,0,0,0,0,0,0,0,0,0,0,0
20200430,051000,台郡元大96購01,,,,,0.00,0.00,0,0,0,0,0,0,0,0,0,0,0,0,0
20200430,051001,緯穎元大96購02,,,,,0.00,0.00,0,0,0,0,0,0,0,0,0,0,0,0,0
20200430,051002,華邦電亞東96購01,,,,,0.00,0.00,0,0,0,0,0,0,0,0,0,0,0,0,0
20200430,051003,中環中信97購01,,,,,0.00,0.00,0,0,0,0,0,0,0,0,0,0,0,0,0
20200430,051004,台新金中信95購02,,,,,0.00,0.00,0,0,0,0,0,0,0,0,0,0,0,0,0
20200430,051005,緯創中信95購02,,,,,0.00,0.00,0,0,0,0,0,0,0,0,0,0,0,0,0
20200430,051006,中磊中信95購01,,,,,0.00,0.00,0,0,0,0,0,0,0,0,0,0,0,0,0
20200430,051007,台光電麥證95購01,,,,,0.00,0.00,0,0,0,0,0,0,0,0,0,0,0,0,0
20200430,051008,大立光麥證95購01,,,,,0.00,0.00,0,0,0,0,0,0,0,0,0,0,0,0,0
20200430,051009,緯創麥證95購01,,,,,0.00,0.00,0,0,0,0,0,0,0,0,0,0,0,0,0
20200430,05100P,智邦凱基95售02,,,,,0.00,0.00,0,0,0,0,0,0,0,0,0,0,0,0,0
20200430,051010,美律日盛95購01,,,,,0.00,0.00,0,0,0,0,0,0,0,0,0,0,0,0,0
20200430,051011,國巨凱基95購03,,,,,0.00,0.00,0,0,0,0,0,0,0,0,0,0,0,0,0
20200430,051012,台積電凱基95購04,0.01,0.01,0.01,0.01,0.00,0.00,6000,6,60,0,0,0,0,0,0,0,0,0,0
20200430,051013,旺宏凱基95購03,0.59,0.59,0.59,0.59,0.00,0.00,1000,1,590,0,0,0,0,0,0,1000,0,1000,1000
20200430,051014,智邦凱基95購01,,,,,0.00,0.00,0,0,0,0,0,0,0,0,0,0,0,0,0
20200430,051015,南亞科凱基95購04,,,,,0.00,0.00,0,0,0,0,0,0,0,0,0,0,0,0,0
20200430,051016,京元電凱基95購03,,,,,0.00,0.00,0,0,0,0,0,0,0,0,0,0,0,0,0
20200430,051017,聯發科凱基95購04,,,,,0.00,0.00,0,0,0,0,0,0,0,0,0,0,0,0,0
20200430,051018,可成凱基95購03,,,,,0.00,0.00,0,0,0,0,0,0,0,0,0,0,0,0,0
20200430,051019,大立光凱基95購08,,,,,0.00,0.00,0,0,0,0,0,0,0,0,0,0,0,0,0
20200430,05101P,大立光凱基95售11,,,,,0.00,0.00,0,0,0,0,0,0,0,0,0,0,0,0,0
20200430,051020,健策凱基96購02,,,,,0.00,0.00,0,0,0,0,0,0,0,0,0,0,0,0,0
20200430,051021,啟碁凱基95購02,,,,,0.00,0.00,0,0,0,0,0,0,0,0,0,0,0,0,0
20200430,051022,GIS凱基95購02,,,,,0.00,0.00,0,0,0,0,0,0,0,0,0,0,0,0,0
20200430,051023,S&P反1統一95購02,,,,,0.00,0.00,0,0,0,0,0,0,0,0,0,0,0,0,0
20200430,051024,南亞科統一95購01,,,,,0.00,0.00,0,0,0,0,0,0,0,0,0,0,0,0,0
20200430,051025,晶華統一95購01,,,,,0.00,0.00,0,0,0,0,0,0,0,0,0,0,0,0,0
20200430,051026,健策統一96購01,2.79,2.83,2.79,2.83,+0.21,8.02,34000,3,95460,0,0,0,0,0,0,14000,20000,-6000,-6000
20200430,051027,楠梓電元富95購01,,,,,0.00,0.00,0,0,0,0,0,0,0,0,0,0,0,0,0
20200430,051028,台光電元富95購02,,,,,0.00,0.00,0,0,0,0,0,0,0,0,0,0,0,0,0
20200430,051029,緯創元富95購01,,,,,0.00,0.00,0,0,0,0,0,0,0,0,0,0,0,0,0
20200430,05102P,臺股指凱基96售09,3.27,3.27,3.18,3.18,0.00,0.00,10000,2,32250,0,0,0,0,0,0,0,10000,-10000,-10000
20200430,051030,康友元富95購01,,,,,0.00,0.00,0,0,0,0,0,0,0,0,0,0,0,0,0
20200430,051031,康友元富95購02,,,,,0.00,0.00,0,0,0,0,0,0,0,0,0,0,0,0,0
20200430,051032,南電元富95購01,,,,,0.00,0.00,0,0,0,0,0,0,0,0,0,0,0,0,0
20200430,051033,台積電兆豐95購03,,,,,0.00,0.00,0,0,0,0,0,0,0,0,0,0,0,0,0
20200430,051034,正崴兆豐95購01,,,,,0.00,0.00,0,0,0,0,0,0,0,0,0,0,0,0,0
20200430,051035,百和兆豐95購01,,,,,0.00,0.00,0,0,0,0,0,0,0,0,0,0,0,0,0
20200430,051036,喬山台新95購01,,,,,0.00,0.00,0,0,0,0,0,0,0,0,0,0,0,0,0
20200430,051037,大立光台新95購01,,,,,0.00,0.00,0,0,0,0,0,0,0,0,0,0,0,0,0
20200430,051038,健策台新95購01,,,,,0.00,0.00,0,0,0,0,0,0,0,0,0,0,0,0,0
20200430,051039,台表科康和95購01,,,,,0.00,0.00,0,0,0,0,0,0,0,0,0,0,0,0,0
20200430,05103P,臺股指凱基96售10,,,,,0.00,0.00,0,0,0,0,0,0,0,0,0,0,0,0,0
20200430,051040,漢唐永豐95購01,,,,,0.00,0.00,0,0,0,0,0,0,0,0,0,0,0,0,0
20200430,051041,大立光永豐95購01,,,,,0.00,0.00,0,0,0,0,0,0,0,0,0,0,0,0,0
20200430,051042,中磊永豐95購01,,,,,0.00,0.00,0,0,0,0,0,0,0,0,0,0,0,0,0
20200430,051043,瀚宇博永豐95購01,,,,,0.00,0.00,0,0,0,0,0,0,0,0,0,0,0,0,0
20200430,051044,GIS永豐95購01,,,,,0.00,0.00,0,0,0,0,0,0,0,0,0,0,0,0,0
20200430,051045,南茂永豐95購01,,,,,0.00,0.00,0,0,0,0,0,0,0,0,0,0,0,0,0
20200430,051046,寶成永豐95購01,,,,,0.00,0.00,0,0,0,0,0,0,0,0,0,0,0,0,0
20200430,051047,深中小群益99購01,,,,,0.00,0.00,0,0,0,0,0,0,0,0,0,0,0,0,0
20200430,051048,臺指反群益96購01,,,,,0.00,0.00,0,0,0,0,0,0,0,0,0,0,0,0,0
20200430,051049,亞德客群益95購01,1.10,2.02,1.00,2.02,+1.27,169.33,27000,3,44320,0,0,0,0,0,0,16000,10000,6000,6000
20200430,05104P,智邦台新95售02,,,,,0.00,0.00,0,0,0,0,0,0,0,0,0,0,0,0,0
20200430,051050,鴻海群益95購03,,,,,0.00,0.00,0,0,0,0,0,0,0,0,0,0,0,0,0
20200430,051051,鴻海群益95購04,,,,,0.00,0.00,0,0,0,0,0,0,0,0,0,0,0,0,0
20200430,051052,台積電群益95購01,,,,,0.00,0.00,0,0,0,0,0,0,0,0,0,0,0,0,0
20200430,051053,台光電群益95購01,,,,,0.00,0.00,0,0,0,0,0,0,0,0,0,0,0,0,0
20200430,051054,正崴群益95購01,,,,,0.00,0.00,0,0,0,0,0,0,0,0,0,0,0,0,0
20200430,051055,友達群益98購01,0.87,0.88,0.87,0.88,0.00,0.00,91000,2,79670,0,0,0,0,0,0,0,91000,-91000,-91000
20200430,051056,華新科群益95購03,,,,,0.00,0.00,0,0,0,0,0,0,0,0,0,0,0,0,0
20200430,051057,信邦群益95購01,,,,,0.00,0.00,0,0,0,0,0,0,0,0,0,0,0,0,0
20200430,051058,景碩群益96購01,1.50,1.52,1.50,1.52,-0.08,-5.0,29000,3,43740,0,0,0,0,0,0,29000,0,29000,29000
20200430,051059,康普群益95購01,,,,,0.00,0.00,0,0,0,0,0,0,0,0,0,0,0,0,0
20200430,05105P,大立光台新95售02,,,,,0.00,0.00,0,0,0,0,0,0,0,0,0,0,0,0,0
20200430,051060,鎧勝群益95購01,,,,,0.00,0.00,0,0,0,0,0,0,0,0,0,0,0,0,0
20200430,051061,中磊群益95購01,,,,,0.00,0.00,0,0,0,0,0,0,0,0,0,0,0,0,0
20200430,051062,超眾群益95購02,,,,,0.00,0.00,0,0,0,0,0,0,0,0,0,0,0,0,0
20200430,051063,台郡群益95購01,,,,,0.00,0.00,0,0,0,0,0,0,0,0,0,0,0,0,0
20200430,051064,鴻海國票95購01,,,,,0.00,0.00,0,0,0,0,0,0,0,0,0,0,0,0,0
20200430,051065,台積電國票96購01,,,,,0.00,0.00,0,0,0,0,0,0,0,0,0,0,0,0,0
20200430,051066,台積電國票96購02,0.18,0.18,0.18,0.18,0.00,0.00,1000,1,180,0,0,0,0,0,0,0,0,0,0
20200430,051067,台積電國票96購03,1.90,1.90,1.90,1.90,0.00,0.00,2000,1,3800,0,0,0,0,0,0,2000,0,2000,2000
20200430,051068,台積電國票97購01,,,,,0.00,0.00,0,0,0,0,0,0,0,0,0,0,0,0,0
20200430,051069,智邦國票96購01,3.63,3.63,3.63,3.63,-0.46,-11.25,11000,7,39930,0,0,0,0,0,0,11000,0,11000,11000
20200430,05106P,鴻海永豐95售02,,,,,0.00,0.00,0,0,0,0,0,0,0,0,0,0,0,0,0
20200430,051070,正崴國票96購01,,,,,0.00,0.00,0,0,0,0,0,0,0,0,0,0,0,0,0
20200430,051071,聯發科國票96購01,,,,,0.00,0.00,0,0,0,0,0,0,0,0,0,0,0,0,0
20200430,051072,強茂國票95購02,,,,,0.00,0.00,0,0,0,0,0,0,0,0,0,0,0,0,0
20200430,051073,同欣電國票96購01,,,,,0.00,0.00,0,0,0,0,0,0,0,0,0,0,0,0,0
20200430,051074,矽力國票96購01,,,,,0.00,0.00,0,0,0,0,0,0,0,0,0,0,0,0,0
20200430,051075,智邦國泰97購01,3.40,3.40,3.40,3.40,+0.31,10.03,3000,1,10200,0,0,0,0,0,0,0,3000,-3000,-3000
20200430,051076,緯創國泰96購01,,,,,0.00,0.00,0,0,0,0,0,0,0,0,0,0,0,0,0
20200430,051077,台郡國泰96購02,,,,,0.00,0.00,0,0,0,0,0,0,0,0,0,0,0,0,0
20200430,051078,力山富邦97購01,0.34,0.40,0.29,0.29,-0.01,-3.33,483000,64,163670,0,0,0,0,0,0,198000,274000,-76000,-76000
20200430,051079,鴻海富邦96購02,,,,,0.00,0.00,0,0,0,0,0,0,0,0,0,0,0,0,0
20200430,05107P,鴻海兆豐96售02,,,,,0.00,0.00,0,0,0,0,0,0,0,0,0,0,0,0,0
20200430,051080,全新富邦96購01,,,,,0.00,0.00,0,0,0,0,0,0,0,0,0,0,0,0,0
20200430,051081,聯茂富邦96購01,,,,,0.00,0.00,0,0,0,0,0,0,0,0,0,0,0,0,0
20200430,051082,上証2X元大98購01,0.40,0.40,0.40,0.40,0.00,0.00,2000,1,800,0,0,0,0,0,0,2000,0,2000,2000
20200430,051083,A50正2元大98購01,,,,,0.00,0.00,0,0,0,0,0,0,0,0,0,0,0,0,0
20200430,051084,華通元大95購06,,,,,0.00,0.00,0,0,0,0,0,0,0,0,0,0,0,0,0
20200430,051085,鴻海元大95購03,,,,,0.00,0.00,0,0,0,0,0,0,0,0,0,0,0,0,0
20200430,051086,鴻海元大96購04,,,,,0.00,0.00,0,0,0,0,0,0,0,0,0,0,0,0,0
20200430,051087,國巨元大97購01,2.64,2.68,2.62,2.68,+0.24,9.84,82000,4,219270,0,0,0,0,0,0,81000,1000,80000,80000
20200430,051088,台積電元大95購09,0.01,0.01,0.01,0.01,0.00,0.00,10000,10,100,0,0,0,0,0,0,0,0,0,0
20200430,051089,旺宏元大96購04,0.97,1.02,0.88,0.88,+0.08,10.0,79000,5,71460,0,0,0,0,0,0,63000,0,63000,63000
20200430,05108P,欣興中信95售02,,,,,0.00,0.00,0,0,0,0,0,0,0,0,0,0,0,0,0
20200430,051090,光磊元大96購01,,,,,0.00,0.00,0,0,0,0,0,0,0,0,0,0,0,0,0
20200430,051091,聯發科元大95購07,,,,,0.00,0.00,0,0,0,0,0,0,0,0,0,0,0,0,0
20200430,051092,禾伸堂元大95購02,2.00,2.00,2.00,2.00,0.00,0.00,209000,2,418000,0,0,0,0,0,0,209000,0,209000,209000
20200430,051093,聯詠元大95購01,,,,,0.00,0.00,0,0,0,0,0,0,0,0,0,0,0,0,0
20200430,051094,健策元大96購03,3.56,3.56,3.52,3.52,0.00,0.00,20000,2,70800,0,0,0,0,0,0,0,20000,-20000,-20000
20200430,051095,貿聯元大95購03,,,,,0.00,0.00,0,0,0,0,0,0,0,0,0,0,0,0,0
20200430,051096,日月光元大95購01,,,,,0.00,0.00,0,0,0,0,0,0,0,0,0,0,0,0,0
20200430,051097,嘉聯益元大96購02,0.04,0.04,0.04,0.04,0.00,0.00,10000,1,400,0,0,0,0,0,0,10000,0,10000,10000
20200430,051098,矽格元大95購01,,,,,0.00,0.00,0,0,0,0,0,0,0,0,0,0,0,0,0
20200430,051099,台郡元大95購03,,,,,0.00,0.00,0,0,0,0,0,0,0,0,0,0,0,0,0
20200430,05109P,臺股指麥證95售01,,,,,0.00,0.00,0,0,0,0,0,0,0,0,0,0,0,0,0
20200430,051100,同欣電元大95購01,,,,,0.00,0.00,0,0,0,0,0,0,0,0,0,0,0,0,0
20200430,051101,台表科元大96購02,,,,,0.00,0.00,0,0,0,0,0,0,0,0,0,0,0,0,0
20200430,051102,訊芯元大96購01,,,,,0.00,0.00,0,0,0,0,0,0,0,0,0,0,0,0,0
20200430,051103,緯穎元大96購03,2.02,2.57,2.02,2.57,+0.71,38.17,16000,4,40340,0,0,0,0,0,0,16000,0,16000,16000
20200430,051104,鈺齊元大96購01,,,,,0.00,0.00,0,0,0,0,0,0,0,0,0,0,0,0,0
20200430,051105,台光電國票96購01,,,,,0.00,0.00,0,0,0,0,0,0,0,0,0,0,0,0,0
20200430,051106,華通統一95購02,,,,,0.00,0.00,0,0,0,0,0,0,0,0,0,0,0,0,0
20200430,051107,鴻海統一95購05,0.01,0.01,0.01,0.01,0.00,0.00,100000,2,1000,0,0,0,0,0,0,100000,0,100000,100000
20200430,051108,鴻海統一96購02,,,,,0.00,0.00,0,0,0,0,0,0,0,0,0,0,0,0,0
20200430,051109,美律統一95購02,,,,,0.00,0.00,0,0,0,0,0,0,0,0,0,0,0,0,0
20200430,05110P,上銀統一95售01,,,,,0.00,0.00,0,0,0,0,0,0,0,0,0,0,0,0,0
20200430,051110,可成統一95購01,,,,,0.00,0.00,0,0,0,0,0,0,0,0,0,0,0,0,0
20200430,051111,可成統一95購02,,,,,0.00,0.00,0,0,0,0,0,0,0,0,0,0,0,0,0
20200430,051112,台郡統一95購01,,,,,0.00,0.00,0,0,0,0,0,0,0,0,0,0,0,0,0
20200430,051113,聯電元富95購01,,,,,0.00,0.00,0,0,0,0,0,0,0,0,0,0,0,0,0
20200430,051114,鈺齊中信95購01,,,,,0.00,0.00,0,0,0,0,0,0,0,0,0,0,0,0,0
20200430,051115,華通麥證96購01,0.19,0.19,0.13,0.13,+0.03,30.0,21000,2,2790,20000,1000,19000,0,0,0,20000,1000,19000,19000
20200430,051116,可成麥證95購01,0.01,0.01,0.01,0.01,0.00,0.00,200000,2,2000,200000,0,200000,0,0,0,200000,0,200000,200000
20200430,051117,臺指反群益95購02,,,,,0.00,0.00,0,0,0,0,0,0,0,0,0,0,0,0,0
20200430,051118,台塑群益95購01,,,,,0.00,0.00,0,0,0,0,0,0,0,0,0,0,0,0,0
20200430,051119,光寶科群益95購01,,,,,0.00,0.00,0,0,0,0,0,0,0,0,0,0,0,0,0
20200430,05111P,台積電統一95售04,,,,,0.00,0.00,0,0,0,0,0,0,0,0,0,0,0,0,0
20200430,051120,南亞科群益95購01,,,,,0.00,0.00,0,0,0,0,0,0,0,0,0,0,0,0,0
20200430,051121,裕民群益97購01,,,,,0.00,0.00,0,0,0,0,0,0,0,0,0,0,0,0,0
20200430,051122,美食群益95購01,,,,,0.00,0.00,0,0,0,0,0,0,0,0,0,0,0,0,0
20200430,051123,和鑫群益95購01,,,,,0.00,0.00,0,0,0,0,0,0,0,0,0,0,0,0,0
20200430,051124,創意群益95購01,,,,,0.00,0.00,0,0,0,0,0,0,0,0,0,0,0,0,0
20200430,051125,TPK群益95購01,,,,,0.00,0.00,0,0,0,0,0,0,0,0,0,0,0,0,0
20200430,051126,訊連群益95購01,,,,,0.00,0.00,0,0,0,0,0,0,0,0,0,0,0,0,0
20200430,051127,同欣電群益95購01,,,,,0.00,0.00,0,0,0,0,0,0,0,0,0,0,0,0,0
20200430,051128,台表科群益95購02,,,,,0.00,0.00,0,0,0,0,0,0,0,0,0,0,0,0,0
20200430,051129,GIS群益95購01,,,,,0.00,0.00,0,0,0,0,0,0,0,0,0,0,0,0,0
20200430,05112P,燿華統一95售01,,,,,0.00,0.00,0,0,0,0,0,0,0,0,0,0,0,0,0
20200430,051130,百和群益96購01,,,,,0.00,0.00,0,0,0,0,0,0,0,0,0,0,0,0,0
20200430,051131,玉山金台新95購01,,,,,0.00,0.00,0,0,0,0,0,0,0,0,0,0,0,0,0
20200430,051132,喬山永豐95購02,,,,,0.00,0.00,0,0,0,0,0,0,0,0,0,0,0,0,0
20200430,051133,台積電永豐95購02,,,,,0.00,0.00,0,0,0,0,0,0,0,0,0,0,0,0,0
20200430,051134,燿華永豐95購05,,,,,0.00,0.00,0,0,0,0,0,0,0,0,0,0,0,0,0
20200430,051135,建準永豐95購01,,,,,0.00,0.00,0,0,0,0,0,0,0,0,0,0,0,0,0
20200430,051136,可成永豐95購02,,,,,0.00,0.00,0,0,0,0,0,0,0,0,0,0,0,0,0
20200430,051137,聯詠永豐95購01,,,,,0.00,0.00,0,0,0,0,0,0,0,0,0,0,0,0,0
20200430,051138,訊連永豐95購01,,,,,0.00,0.00,0,0,0,0,0,0,0,0,0,0,0,0,0
20200430,051139,康友永豐95購01,,,,,0.00,0.00,0,0,0,0,0,0,0,0,0,0,0,0,0
20200430,05113P,臺股指元富95售01,,,,,0.00,0.00,0,0,0,0,0,0,0,0,0,0,0,0,0
20200430,051140,矽創永豐95購02,,,,,0.00,0.00,0,0,0,0,0,0,0,0,0,0,0,0,0
20200430,051141,鈺齊永豐95購01,,,,,0.00,0.00,0,0,0,0,0,0,0,0,0,0,0,0,0
20200430,051142,臺股指永豐95購02,,,,,0.00,0.00,0,0,0,0,0,0,0,0,0,0,0,0,0
20200430,051143,鴻海凱基95購11,,,,,0.00,0.00,0,0,0,0,0,0,0,0,0,0,0,0,0
20200430,051144,鴻海凱基95購12,0.01,0.01,0.01,0.01,0.00,0.00,10000,10,100,0,0,0,0,0,0,0,0,0,0
20200430,051145,台積電凱基95購05,,,,,0.00,0.00,0,0,0,0,0,0,0,0,0,0,0,0,0
20200430,051146,旺宏凱基95購04,,,,,0.00,0.00,0,0,0,0,0,0,0,0,0,0,0,0,0
20200430,051147,南亞科凱基95購05,,,,,0.00,0.00,0,0,0,0,0,0,0,0,0,0,0,0,0
20200430,051148,聯發科凱基95購06,,,,,0.00,0.00,0,0,0,0,0,0,0,0,0,0,0,0,0
20200430,051149,可成凱基95購04,,,,,0.00,0.00,0,0,0,0,0,0,0,0,0,0,0,0,0
20200430,05114P,臺股指元富95售02,,,,,0.00,0.00,0,0,0,0,0,0,0,0,0,0,0,0,0
20200430,051150,宏達電凱基95購02,,,,,0.00,0.00,0,0,0,0,0,0,0,0,0,0,0,0,0
20200430,051151,中磊凱基95購02,,,,,0.00,0.00,0,0,0,0,0,0,0,0,0,0,0,0,0
20200430,051152,鴻海國泰97購01,,,,,0.00,0.00,0,0,0,0,0,0,0,0,0,0,0,0,0
20200430,051153,鴻海國泰97購02,,,,,0.00,0.00,0,0,0,0,0,0,0,0,0,0,0,0,0
20200430,051154,國巨國泰96購03,5.45,5.45,5.45,5.45,+0.35,6.86,1000,1,5450,0,0,0,0,0,0,0,1000,-1000,-1000
20200430,051155,聯發科國泰96購01,0.73,0.73,0.73,0.73,+0.33,82.5,5000,1,3650,0,0,0,0,0,0,5000,0,5000,5000
20200430,051156,鴻海富邦97購01,0.03,0.08,0.03,0.08,-0.05,-38.46,15000,2,500,0,0,0,0,0,0,14000,0,14000,14000
20200430,051157,華新科富邦98購01,0.70,0.70,0.66,0.66,0.00,0.00,110000,5,76800,0,0,0,0,0,0,82000,0,82000,82000
20200430,051158,嘉晶富邦96購01,0.04,0.06,0.04,0.05,0.00,0.00,17000,3,760,0,0,0,0,0,0,17000,0,17000,17000
20200430,051159,力山元大96購01,0.75,0.75,0.58,0.58,+0.18,45.0,70000,3,49100,0,0,0,0,0,0,50000,20000,30000,30000
20200430,05115P,T50反1群益95售02,,,,,0.00,0.00,0,0,0,0,0,0,0,0,0,0,0,0,0
20200430,051160,亞德客元大95購02,1.65,1.93,1.65,1.93,+0.38,24.52,3000,3,5310,0,0,0,0,0,0,3000,0,3000,3000
20200430,051161,喬山元大95購02,,,,,0.00,0.00,0,0,0,0,0,0,0,0,0,0,0,0,0
20200430,051162,楠梓電元大95購01,,,,,0.00,0.00,0,0,0,0,0,0,0,0,0,0,0,0,0
20200430,051163,鴻海元大95購04,,,,,0.00,0.00,0,0,0,0,0,0,0,0,0,0,0,0,0
20200430,051164,鴻海元大95購05,,,,,0.00,0.00,0,0,0,0,0,0,0,0,0,0,0,0,0
20200430,051165,可成元大95購01,,,,,0.00,0.00,0,0,0,0,0,0,0,0,0,0,0,0,0
20200430,051166,可成元大95購02,,,,,0.00,0.00,0,0,0,0,0,0,0,0,0,0,0,0,0
20200430,051167,京鼎元大95購01,0.07,0.07,0.07,0.07,0.00,0.00,25000,1,1750,0,0,0,0,0,0,25000,0,25000,25000
20200430,051168,訊連元大95購02,,,,,0.00,0.00,0,0,0,0,0,0,0,0,0,0,0,0,0
20200430,051169,瀚宇博元大95購05,,,,,0.00,0.00,0,0,0,0,0,0,0,0,0,0,0,0,0
20200430,05116P,台積電群益95售03,,,,,0.00,0.00,0,0,0,0,0,0,0,0,0,0,0,0,0
20200430,051170,南電元大95購03,,,,,0.00,0.00,0,0,0,0,0,0,0,0,0,0,0,0,0
20200430,051171,T50反1第一95購01,,,,,0.00,0.00,0,0,0,0,0,0,0,0,0,0,0,0,0
20200430,051172,鴻海第一96購01,,,,,0.00,0.00,0,0,0,0,0,0,0,0,0,0,0,0,0
20200430,051173,元油2X凱基98購01,0.05,0.05,0.05,0.05,0.00,0.00,61000,2,3050,0,0,0,0,0,0,0,0,0,0
20200430,051174,鴻海凱基95購14,,,,,0.00,0.00,0,0,0,0,0,0,0,0,0,0,0,0,0
20200430,051175,國巨凱基95購04,,,,,0.00,0.00,0,0,0,0,0,0,0,0,0,0,0,0,0
20200430,051176,聯發科凱基95購07,,,,,0.00,0.00,0,0,0,0,0,0,0,0,0,0,0,0,0
20200430,051177,可成凱基95購05,,,,,0.00,0.00,0,0,0,0,0,0,0,0,0,0,0,0,0
20200430,051178,大立光凱基95購10,,,,,0.00,0.00,0,0,0,0,0,0,0,0,0,0,0,0,0
20200430,051179,臺股指凱基95購04,0.01,0.01,0.01,0.01,0.00,0.00,4000,1,40,0,0,0,0,0,0,4000,0,4000,4000
20200430,05117P,瑞昱群益95售02,,,,,0.00,0.00,0,0,0,0,0,0,0,0,0,0,0,0,0
20200430,051180,喬山永豐95購03,,,,,0.00,0.00,0,0,0,0,0,0,0,0,0,0,0,0,0
20200430,051181,鴻海永豐95購03,,,,,0.00,0.00,0,0,0,0,0,0,0,0,0,0,0,0,0
20200430,051182,旺宏永豐95購01,,,,,0.00,0.00,0,0,0,0,0,0,0,0,0,0,0,0,0
20200430,051183,建準永豐95購02,,,,,0.00,0.00,0,0,0,0,0,0,0,0,0,0,0,0,0
20200430,051184,聯發科永豐95購03,0.01,0.01,0.01,0.01,0.00,0.00,10000,10,100,0,0,0,0,0,0,0,0,0,0
20200430,051185,強茂永豐95購03,,,,,0.00,0.00,0,0,0,0,0,0,0,0,0,0,0,0,0
20200430,051186,創意永豐95購01,,,,,0.00,0.00,0,0,0,0,0,0,0,0,0,0,0,0,0
20200430,051187,晶相光永豐95購01,,,,,0.00,0.00,0,0,0,0,0,0,0,0,0,0,0,0,0
20200430,051188,鴻海兆豐95購01,,,,,0.00,0.00,0,0,0,0,0,0,0,0,0,0,0,0,0
20200430,051189,鴻海兆豐96購01,,,,,0.00,0.00,0,0,0,0,0,0,0,0,0,0,0,0,0
20200430,05118P,超眾元大96售04,0.07,0.07,0.07,0.07,-0.01,-12.5,25000,2,1750,0,0,0,0,0,0,5000,20000,-15000,-15000
20200430,051190,可成兆豐95購03,,,,,0.00,0.00,0,0,0,0,0,0,0,0,0,0,0,0,0
20200430,051191,可成兆豐96購01,0.01,0.01,0.01,0.01,0.00,0.00,10000,10,100,0,0,0,0,0,0,0,0,0,0
20200430,051192,緯創兆豐96購01,0.60,0.64,0.58,0.63,+0.05,8.62,712000,26,434500,0,0,0,0,0,0,429000,283000,146000,146000
20200430,051193,新日興兆豐96購01,0.82,0.82,0.78,0.79,-0.02,-2.47,95000,3,74580,0,0,0,0,0,0,1000,94000,-93000,-93000
20200430,051194,大立光中信96購02,,,,,0.00,0.00,0,0,0,0,0,0,0,0,0,0,0,0,0
20200430,051195,台郡中信95購01,,,,,0.00,0.00,0,0,0,0,0,0,0,0,0,0,0,0,0
20200430,051196,喬山麥證95購01,,,,,0.00,0.00,0,0,0,0,0,0,0,0,0,0,0,0,0
20200430,051197,光寶科麥證95購01,,,,,0.00,0.00,0,0,0,0,0,0,0,0,0,0,0,0,0
20200430,051198,鴻海麥證95購02,,,,,0.00,0.00,0,0,0,0,0,0,0,0,0,0,0,0,0
20200430,051199,鴻海麥證95購03,,,,,0.00,0.00,0,0,0,0,0,0,0,0,0,0,0,0,0
20200430,05119P,聯發科國泰96售02,,,,,0.00,0.00,0,0,0,0,0,0,0,0,0,0,0,0,0
20200430,051200,國巨麥證95購01,,,,,0.00,0.00,0,0,0,0,0,0,0,0,0,0,0,0,0
20200430,051201,台積電麥證95購02,0.09,0.10,0.09,0.10,0.00,0.00,65000,3,6200,65000,0,65000,0,0,0,65000,0,65000,65000
20200430,051202,智邦麥證95購01,,,,,0.00,0.00,0,0,0,0,0,0,0,0,0,0,0,0,0
20200430,051203,微星麥證95購01,0.01,0.01,0.01,0.01,0.00,0.00,31000,1,310,31000,0,31000,0,0,0,31000,0,31000,31000
20200430,051204,正崴麥證95購01,,,,,0.00,0.00,0,0,0,0,0,0,0,0,0,0,0,0,0
20200430,051205,華新科麥證95購02,,,,,0.00,0.00,0,0,0,0,0,0,0,0,0,0,0,0,0
20200430,051206,大立光麥證95購02,0.01,0.01,0.01,0.01,0.00,0.00,15000,1,150,15000,0,15000,0,0,0,15000,0,15000,15000
20200430,051207,聯茂麥證95購01,,,,,0.00,0.00,0,0,0,0,0,0,0,0,0,0,0,0,0
20200430,051208,GIS麥證95購01,,,,,0.00,0.00,0,0,0,0,0,0,0,0,0,0,0,0,0
20200430,051209,百和麥證95購01,,,,,0.00,0.00,0,0,0,0,0,0,0,0,0,0,0,0,0
20200430,05120P,聯發科國泰97售01,0.88,0.88,0.88,0.88,0.00,0.00,10000,1,8800,0,0,0,0,0,0,0,10000,-10000,-10000
20200430,051210,S&P反1統一97購01,,,,,0.00,0.00,0,0,0,0,0,0,0,0,0,0,0,0,0
20200430,051211,道瓊反統一95購01,,,,,0.00,0.00,0,0,0,0,0,0,0,0,0,0,0,0,0
20200430,051212,國巨統一95購01,,,,,0.00,0.00,0,0,0,0,0,0,0,0,0,0,0,0,0
20200430,051213,華新科統一95購01,,,,,0.00,0.00,0,0,0,0,0,0,0,0,0,0,0,0,0
20200430,051214,大立光統一95購02,,,,,0.00,0.00,0,0,0,0,0,0,0,0,0,0,0,0,0
20200430,051215,大立光統一95購03,,,,,0.00,0.00,0,0,0,0,0,0,0,0,0,0,0,0,0
20200430,051216,為升元富95購01,,,,,0.00,0.00,0,0,0,0,0,0,0,0,0,0,0,0,0
20200430,051217,聯發科元富95購01,,,,,0.00,0.00,0,0,0,0,0,0,0,0,0,0,0,0,0
20200430,051218,聯發科元富9B購02,,,,,0.00,0.00,0,0,0,0,0,0,0,0,0,0,0,0,0
20200430,051219,大立光元富95購07,,,,,0.00,0.00,0,0,0,0,0,0,0,0,0,0,0,0,0
20200430,05121P,創意國泰96售01,1.41,1.41,1.38,1.38,-0.19,-12.1,15000,10,21000,0,0,0,0,0,0,15000,0,15000,15000
20200430,051220,大立光元富95購08,,,,,0.00,0.00,0,0,0,0,0,0,0,0,0,0,0,0,0
20200430,051221,嘉聯益元富95購01,,,,,0.00,0.00,0,0,0,0,0,0,0,0,0,0,0,0,0
20200430,051222,世紀鋼元富95購01,,,,,0.00,0.00,0,0,0,0,0,0,0,0,0,0,0,0,0
20200430,051223,台化群益95購01,,,,,0.00,0.00,0,0,0,0,0,0,0,0,0,0,0,0,0
20200430,051224,華通群益96購03,0.07,0.10,0.07,0.10,0.00,0.00,54000,4,5030,0,0,0,0,0,0,54000,0,54000,54000
20200430,051225,台積電群益95購02,,,,,0.00,0.00,0,0,0,0,0,0,0,0,0,0,0,0,0
20200430,051226,英業達群益95購01,,,,,0.00,0.00,0,0,0,0,0,0,0,0,0,0,0,0,0
20200430,051227,技嘉群益97購01,,,,,0.00,0.00,0,0,0,0,0,0,0,0,0,0,0,0,0
20200430,051228,聯發科群益95購03,,,,,0.00,0.00,0,0,0,0,0,0,0,0,0,0,0,0,0
20200430,051229,亞光群益95購01,,,,,0.00,0.00,0,0,0,0,0,0,0,0,0,0,0,0,0
20200430,05122P,鴻海永昌96售06,,,,,0.00,0.00,0,0,0,0,0,0,0,0,0,0,0,0,0
20200430,051230,聯詠群益95購01,,,,,0.00,0.00,0,0,0,0,0,0,0,0,0,0,0,0,0
20200430,051231,健策群益97購01,,,,,0.00,0.00,0,0,0,0,0,0,0,0,0,0,0,0,0
20200430,051232,貿聯群益95購02,,,,,0.00,0.00,0,0,0,0,0,0,0,0,0,0,0,0,0
20200430,051233,力成群益97購01,2.14,2.14,2.14,2.14,0.00,0.00,10000,2,21400,0,0,0,0,0,0,0,10000,-10000,-10000
20200430,051234,南電群益95購02,,,,,0.00,0.00,0,0,0,0,0,0,0,0,0,0,0,0,0
20200430,051235,鴻海元大95購06,,,,,0.00,0.00,0,0,0,0,0,0,0,0,0,0,0,0,0
20200430,051236,鴻海元大96購05,0.16,0.16,0.16,0.16,0.00,0.00,20000,2,3200,0,0,0,0,0,0,0,20000,-20000,-20000
20200430,051237,鴻海元大97購01,,,,,0.00,0.00,0,0,0,0,0,0,0,0,0,0,0,0,0
20200430,051238,中環元大96購01,,,,,0.00,0.00,0,0,0,0,0,0,0,0,0,0,0,0,0
20200430,051239,國巨元大96購02,,,,,0.00,0.00,0,0,0,0,0,0,0,0,0,0,0,0,0
20200430,05123P,鴻海永昌96售07,2.67,2.71,2.41,2.41,-0.47,-16.32,9000,7,22510,0,0,0,0,0,0,6000,3000,3000,3000
20200430,051240,台積電元大95購12,,,,,0.00,0.00,0,0,0,0,0,0,0,0,0,0,0,0,0
20200430,051241,台積電元大95購13,,,,,0.00,0.00,0,0,0,0,0,0,0,0,0,0,0,0,0
20200430,051242,台積電元大96購06,,,,,0.00,0.00,0,0,0,0,0,0,0,0,0,0,0,0,0
20200430,051243,微星元大95購01,,,,,0.00,0.00,0,0,0,0,0,0,0,0,0,0,0,0,0
20200430,051244,正崴元大95購01,,,,,0.00,0.00,0,0,0,0,0,0,0,0,0,0,0,0,0
20200430,051245,南亞科元大95購01,,,,,0.00,0.00,0,0,0,0,0,0,0,0,0,0,0,0,0
20200430,051246,美律元大96購01,,,,,0.00,0.00,0,0,0,0,0,0,0,0,0,0,0,0,0
20200430,051247,可成元大95購04,,,,,0.00,0.00,0,0,0,0,0,0,0,0,0,0,0,0,0
20200430,051248,華固元大95購01,0.27,0.27,0.27,0.27,0.00,0.00,10000,1,2700,0,0,0,0,0,0,10000,0,10000,10000
20200430,051249,潤泰全元大95購01,0.05,0.05,0.05,0.05,0.00,0.00,40000,1,2000,0,0,0,0,0,0,40000,0,40000,40000
20200430,05124P,華新科富邦97售02,0.46,0.47,0.46,0.47,+0.01,2.17,14000,4,6480,0,0,0,0,0,0,0,14000,-14000,-14000
20200430,051250,大立光元大98購01,,,,,0.00,0.00,0,0,0,0,0,0,0,0,0,0,0,0,0
20200430,051251,信邦元大95購01,,,,,0.00,0.00,0,0,0,0,0,0,0,0,0,0,0,0,0
20200430,051252,健鼎元大95購01,,,,,0.00,0.00,0,0,0,0,0,0,0,0,0,0,0,0,0
20200430,051253,緯創元大95購02,0.15,0.15,0.15,0.15,+0.01,7.14,40000,2,6000,0,0,0,0,0,0,0,40000,-40000,-40000
20200430,051254,健策元大96購04,,,,,0.00,0.00,0,0,0,0,0,0,0,0,0,0,0,0,0
20200430,051255,康控元大96購04,,,,,0.00,0.00,0,0,0,0,0,0,0,0,0,0,0,0,0
20200430,051256,中磊元大95購01,,,,,0.00,0.00,0,0,0,0,0,0,0,0,0,0,0,0,0
20200430,051257,光寶科國泰96購01,0.29,0.29,0.29,0.29,0.00,0.00,490000,1,142100,0,0,0,0,0,0,490000,0,490000,490000
20200430,051258,鈺齊國泰97購01,,,,,0.00,0.00,0,0,0,0,0,0,0,0,0,0,0,0,0
20200430,051259,鴻海永昌96購03,0.10,0.10,0.07,0.07,0.00,0.00,41000,4,3490,0,0,0,0,0,0,15000,0,15000,15000
20200430,05125P,鴻海群益95售06,,,,,0.00,0.00,0,0,0,0,0,0,0,0,0,0,0,0,0
20200430,051260,鴻海永昌96購04,,,,,0.00,0.00,0,0,0,0,0,0,0,0,0,0,0,0,0
20200430,051261,鴻海永昌96購05,,,,,0.00,0.00,0,0,0,0,0,0,0,0,0,0,0,0,0
20200430,051262,A50富邦96購01,,,,,0.00,0.00,0,0,0,0,0,0,0,0,0,0,0,0,0
20200430,051263,深中小富邦96購01,,,,,0.00,0.00,0,0,0,0,0,0,0,0,0,0,0,0,0
20200430,051264,道瓊反富邦97購01,,,,,0.00,0.00,0,0,0,0,0,0,0,0,0,0,0,0,0
20200430,051265,鴻海富邦96購04,,,,,0.00,0.00,0,0,0,0,0,0,0,0,0,0,0,0,0
20200430,051266,國巨富邦99購01,1.72,2.00,1.71,1.72,+0.02,1.18,70000,19,122030,0,0,0,0,0,0,0,0,0,0
20200430,051267,美律富邦96購01,0.05,0.05,0.05,0.05,0.00,0.00,100000,1,5000,0,0,0,0,0,0,100000,0,100000,100000
20200430,051268,創意富邦97購01,0.41,0.42,0.40,0.41,0.00,0.00,20000,4,8200,0,0,0,0,0,0,0,20000,-20000,-20000
20200430,051269,康友富邦97購01,,,,,0.00,0.00,0,0,0,0,0,0,0,0,0,0,0,0,0
20200430,05126P,牧德群益95售01,,,,,0.00,0.00,0,0,0,0,0,0,0,0,0,0,0,0,0
20200430,051270,百和富邦95購01,,,,,0.00,0.00,0,0,0,0,0,0,0,0,0,0,0,0,0
20200430,051271,華新科群益95購04,,,,,0.00,0.00,0,0,0,0,0,0,0,0,0,0,0,0,0
20200430,051272,嘉晶群益95購01,,,,,0.00,0.00,0,0,0,0,0,0,0,0,0,0,0,0,0
20200430,051273,可成亞東95購01,,,,,0.00,0.00,0,0,0,0,0,0,0,0,0,0,0,0,0
20200430,051274,華新科亞東96購01,,,,,0.00,0.00,0,0,0,0,0,0,0,0,0,0,0,0,0
20200430,051275,群創亞東95購01,,,,,0.00,0.00,0,0,0,0,0,0,0,0,0,0,0,0,0
20200430,051276,SGBR2X中信97購01,0.08,0.08,0.08,0.08,-0.02,-20.0,5000,1,400,0,0,0,0,0,0,0,0,0,0
20200430,051277,聯發科中信9A購01,0.18,0.18,0.14,0.17,+0.01,6.25,1356000,59,231390,2000,0,2000,0,0,0,100000,0,100000,102000
20200430,051278,臻鼎中信97購02,,,,,0.00,0.00,0,0,0,0,0,0,0,0,0,0,0,0,0
20200430,051279,喬山兆豐96購01,,,,,0.00,0.00,0,0,0,0,0,0,0,0,0,0,0,0,0
20200430,05127P,鴻海亞東96售01,,,,,0.00,0.00,0,0,0,0,0,0,0,0,0,0,0,0,0
20200430,051280,台積電兆豐95購04,,,,,0.00,0.00,0,0,0,0,0,0,0,0,0,0,0,0,0
20200430,051281,健策兆豐96購01,1.45,1.52,1.45,1.52,+0.17,12.59,61000,6,89320,0,0,0,0,0,0,0,61000,-61000,-61000
20200430,051282,GIS兆豐95購02,,,,,0.00,0.00,0,0,0,0,0,0,0,0,0,0,0,0,0
20200430,051283,亞德客統一95購01,2.14,2.42,2.14,2.42,+1.27,110.43,15000,3,34900,0,0,0,0,0,0,15000,0,15000,15000
20200430,051284,上銀統一95購02,0.05,0.11,0.05,0.11,0.00,0.00,548000,2,30400,0,0,0,0,0,0,548000,0,548000,548000
20200430,051285,鴻海統一95購07,,,,,0.00,0.00,0,0,0,0,0,0,0,0,0,0,0,0,0
20200430,051286,國巨統一97購01,4.04,4.04,4.04,4.04,0.00,0.00,9000,1,36360,0,0,0,0,0,0,9000,0,9000,9000
20200430,051287,台積電統一95購05,,,,,0.00,0.00,0,0,0,0,0,0,0,0,0,0,0,0,0
20200430,051288,可成統一95購03,,,,,0.00,0.00,0,0,0,0,0,0,0,0,0,0,0,0,0
20200430,051289,大立光統一96購01,,,,,0.00,0.00,0,0,0,0,0,0,0,0,0,0,0,0,0
20200430,05128P,聯發科中信97售03,,,,,0.00,0.00,0,0,0,0,0,0,0,0,0,0,0,0,0
20200430,051290,大立光統一96購02,,,,,0.00,0.00,0,0,0,0,0,0,0,0,0,0,0,0,0
20200430,051291,聯詠統一95購01,,,,,0.00,0.00,0,0,0,0,0,0,0,0,0,0,0,0,0
20200430,051292,牧德統一97購01,2.57,2.71,2.50,2.67,+0.27,11.25,284000,27,740390,0,0,0,0,0,0,47000,237000,-190000,-190000
20200430,051293,鴻海元富95購05,,,,,0.00,0.00,0,0,0,0,0,0,0,0,0,0,0,0,0
20200430,051294,鴻海元富95購06,,,,,0.00,0.00,0,0,0,0,0,0,0,0,0,0,0,0,0
20200430,051295,國巨元富95購04,,,,,0.00,0.00,0,0,0,0,0,0,0,0,0,0,0,0,0
20200430,051296,鴻海凱基97購01,,,,,0.00,0.00,0,0,0,0,0,0,0,0,0,0,0,0,0
20200430,051297,台積電凱基95購07,,,,,0.00,0.00,0,0,0,0,0,0,0,0,0,0,0,0,0
20200430,051298,智邦凱基95購03,,,,,0.00,0.00,0,0,0,0,0,0,0,0,0,0,0,0,0
20200430,051299,致茂凱基95購01,,,,,0.00,0.00,0,0,0,0,0,0,0,0,0,0,0,0,0
20200430,05129P,鴻海兆豐95售02,,,,,0.00,0.00,0,0,0,0,0,0,0,0,0,0,0,0,0
20200430,051300,台光電凱基96購02,0.52,0.53,0.52,0.53,0.00,0.00,60000,3,31700,0,0,0,0,0,0,10000,50000,-40000,-40000
20200430,051301,聯發科凱基95購08,,,,,0.00,0.00,0,0,0,0,0,0,0,0,0,0,0,0,0
20200430,051302,可成凱基95購06,,,,,0.00,0.00,0,0,0,0,0,0,0,0,0,0,0,0,0
20200430,051303,奇鋐凱基95購01,0.01,0.01,0.01,0.01,0.00,0.00,225000,4,2250,0,0,0,0,0,0,225000,0,225000,225000
20200430,051304,緯創凱基96購01,,,,,0.00,0.00,0,0,0,0,0,0,0,0,0,0,0,0,0
20200430,051305,訊連凱基96購01,,,,,0.00,0.00,0,0,0,0,0,0,0,0,0,0,0,0,0
20200430,051306,嘉聯益凱基96購01,,,,,0.00,0.00,0,0,0,0,0,0,0,0,0,0,0,0,0
20200430,051307,康舒凱基95購01,,,,,0.00,0.00,0,0,0,0,0,0,0,0,0,0,0,0,0
20200430,051308,GIS凱基95購04,,,,,0.00,0.00,0,0,0,0,0,0,0,0,0,0,0,0,0
20200430,051309,卜蜂麥證95購01,,,,,0.00,0.00,0,0,0,0,0,0,0,0,0,0,0,0,0
20200430,05130P,聯發科統一95售03,0.43,0.43,0.43,0.43,0.00,0.00,6000,1,2580,0,0,0,0,0,0,6000,0,6000,6000
20200430,051310,台達電麥證95購01,,,,,0.00,0.00,0,0,0,0,0,0,0,0,0,0,0,0,0
20200430,051311,瑞昱麥證95購01,,,,,0.00,0.00,0,0,0,0,0,0,0,0,0,0,0,0,0
20200430,051312,國泰金麥證95購01,,,,,0.00,0.00,0,0,0,0,0,0,0,0,0,0,0,0,0
20200430,051313,緯創麥證95購02,,,,,0.00,0.00,0,0,0,0,0,0,0,0,0,0,0,0,0
20200430,051314,嘉聯益麥證96購01,,,,,0.00,0.00,0,0,0,0,0,0,0,0,0,0,0,0,0
20200430,051315,同欣電麥證95購01,,,,,0.00,0.00,0,0,0,0,0,0,0,0,0,0,0,0,0
20200430,051316,T50反1國票95購02,,,,,0.00,0.00,0,0,0,0,0,0,0,0,0,0,0,0,0
20200430,051317,亞德客國票96購01,2.00,2.96,1.90,2.96,+1.03,53.37,275000,11,621130,0,0,0,0,0,0,143000,148000,-5000,-5000
20200430,051318,上銀國票96購01,1.51,2.15,1.51,2.15,+0.75,53.57,126000,11,212790,0,0,0,0,0,0,45000,81000,-36000,-36000
20200430,051319,光磊國票96購02,0.43,0.44,0.43,0.43,-0.07,-14.0,146000,3,63160,0,0,0,0,0,0,38000,108000,-70000,-70000
20200430,05131P,聯詠統一97售01,,,,,0.00,0.00,0,0,0,0,0,0,0,0,0,0,0,0,0
20200430,051320,燿華國票96購01,0.03,0.03,0.03,0.03,0.00,0.00,10000,1,300,0,0,0,0,0,0,0,10000,-10000,-10000
20200430,051321,建準國票96購01,0.81,0.81,0.79,0.79,-0.12,-13.19,53000,2,41930,0,0,0,0,0,0,53000,0,53000,53000
20200430,051322,國泰金國票96購01,,,,,0.00,0.00,0,0,0,0,0,0,0,0,0,0,0,0,0
20200430,051323,康控國票96購01,0.32,0.35,0.32,0.35,0.00,0.00,46000,3,15020,0,0,0,0,0,0,0,46000,-46000,-46000
20200430,051324,康友國票96購01,,,,,0.00,0.00,0,0,0,0,0,0,0,0,0,0,0,0,0
20200430,051325,台光電台新96購01,0.24,0.24,0.01,0.01,0.00,0.00,50000,4,9700,0,0,0,0,0,0,0,50000,-50000,-50000
20200430,051326,聯發科台新95購01,,,,,0.00,0.00,0,0,0,0,0,0,0,0,0,0,0,0,0
20200430,051327,元油2X永豐95購02,,,,,0.00,0.00,0,0,0,0,0,0,0,0,0,0,0,0,0
20200430,051328,力山永豐95購01,0.06,0.06,0.06,0.06,0.00,0.00,30000,1,1800,0,0,0,0,0,0,30000,0,30000,30000
20200430,051329,智邦永豐95購01,0.37,0.40,0.32,0.32,-0.10,-23.81,120000,4,42520,0,0,0,0,0,0,55000,65000,-10000,-10000
20200430,05132P,鴻海元富95售07,,,,,0.00,0.00,0,0,0,0,0,0,0,0,0,0,0,0,0
20200430,051330,宏碁永豐95購01,,,,,0.00,0.00,0,0,0,0,0,0,0,0,0,0,0,0,0
20200430,051331,全新永豐96購01,,,,,0.00,0.00,0,0,0,0,0,0,0,0,0,0,0,0,0
20200430,051332,奇力新永豐95購01,0.06,0.06,0.03,0.03,0.00,0.00,31000,2,960,0,0,0,0,0,0,31000,0,31000,31000
20200430,051333,義隆永豐95購02,,,,,0.00,0.00,0,0,0,0,0,0,0,0,0,0,0,0,0
20200430,051334,宏達電永豐95購01,,,,,0.00,0.00,0,0,0,0,0,0,0,0,0,0,0,0,0
20200430,051335,華固永豐95購01,,,,,0.00,0.00,0,0,0,0,0,0,0,0,0,0,0,0,0
20200430,051336,智原永豐95購01,,,,,0.00,0.00,0,0,0,0,0,0,0,0,0,0,0,0,0
20200430,051337,欣興永豐95購02,,,,,0.00,0.00,0,0,0,0,0,0,0,0,0,0,0,0,0
20200430,051338,揚明光永豐95購02,,,,,0.00,0.00,0,0,0,0,0,0,0,0,0,0,0,0,0
20200430,051339,智易永豐95購02,0.08,0.08,0.08,0.08,-0.04,-33.33,20000,1,1600,0,0,0,0,0,0,20000,0,20000,20000
20200430,05133P,臺股指日盛95售01,,,,,0.00,0.00,0,0,0,0,0,0,0,0,0,0,0,0,0
20200430,051340,健策永豐95購03,,,,,0.00,0.00,0,0,0,0,0,0,0,0,0,0,0,0,0
20200430,051341,訊連永豐95購02,,,,,0.00,0.00,0,0,0,0,0,0,0,0,0,0,0,0,0
20200430,051342,光寶科元大95購01,,,,,0.00,0.00,0,0,0,0,0,0,0,0,0,0,0,0,0
20200430,051343,鴻海元大95購07,,,,,0.00,0.00,0,0,0,0,0,0,0,0,0,0,0,0,0
20200430,051344,鴻海元大95購08,,,,,0.00,0.00,0,0,0,0,0,0,0,0,0,0,0,0,0
20200430,051345,鴻海元大95購09,,,,,0.00,0.00,0,0,0,0,0,0,0,0,0,0,0,0,0
20200430,051346,仁寶元大95購01,0.06,0.06,0.06,0.06,-0.03,-33.33,200000,1,12000,0,0,0,0,0,0,200000,0,200000,200000
20200430,051347,國巨元大95購06,,,,,0.00,0.00,0,0,0,0,0,0,0,0,0,0,0,0,0
20200430,051348,國巨元大95購07,,,,,0.00,0.00,0,0,0,0,0,0,0,0,0,0,0,0,0
20200430,051349,國巨元大95購08,,,,,0.00,0.00,0,0,0,0,0,0,0,0,0,0,0,0,0
20200430,05134P,鴻海凱基96售06,,,,,0.00,0.00,0,0,0,0,0,0,0,0,0,0,0,0,0
20200430,051350,台積電元大95購14,,,,,0.00,0.00,0,0,0,0,0,0,0,0,0,0,0,0,0
20200430,051351,台積電元大95購15,,,,,0.00,0.00,0,0,0,0,0,0,0,0,0,0,0,0,0
20200430,051352,南亞科元大95購02,,,,,0.00,0.00,0,0,0,0,0,0,0,0,0,0,0,0,0
20200430,051353,聯發科元大95購08,,,,,0.00,0.00,0,0,0,0,0,0,0,0,0,0,0,0,0
20200430,051354,聯發科元大95購09,0.02,0.05,0.02,0.05,+0.04,400.0,212000,9,5940,0,0,0,0,0,0,212000,0,212000,212000
20200430,051355,聯發科元大96購01,,,,,0.00,0.00,0,0,0,0,0,0,0,0,0,0,0,0,0
20200430,051356,全新元大96購04,,,,,0.00,0.00,0,0,0,0,0,0,0,0,0,0,0,0,0
20200430,051357,可成元大95購05,,,,,0.00,0.00,0,0,0,0,0,0,0,0,0,0,0,0,0
20200430,051358,台新金元大95購01,,,,,0.00,0.00,0,0,0,0,0,0,0,0,0,0,0,0,0
20200430,051359,中信金元大95購01,,,,,0.00,0.00,0,0,0,0,0,0,0,0,0,0,0,0,0
20200430,05135P,鴻海凱基96售07,,,,,0.00,0.00,0,0,0,0,0,0,0,0,0,0,0,0,0
20200430,051360,緯創元大95購03,0.33,0.39,0.33,0.38,+0.06,18.75,567000,5,196370,0,0,0,0,0,0,0,567000,-567000,-567000
20200430,051361,泰鼎元大95購01,,,,,0.00,0.00,0,0,0,0,0,0,0,0,0,0,0,0,0
20200430,051362,台郡元大95購04,,,,,0.00,0.00,0,0,0,0,0,0,0,0,0,0,0,0,0
20200430,051363,矽創元大95購03,,,,,0.00,0.00,0,0,0,0,0,0,0,0,0,0,0,0,0
20200430,051364,鴻海國泰97購03,,,,,0.00,0.00,0,0,0,0,0,0,0,0,0,0,0,0,0
20200430,051365,瀚宇博國泰97購01,,,,,0.00,0.00,0,0,0,0,0,0,0,0,0,0,0,0,0
20200430,051366,康友國泰97購01,,,,,0.00,0.00,0,0,0,0,0,0,0,0,0,0,0,0,0
20200430,051367,可成富邦97購01,0.02,0.02,0.02,0.02,-0.01,-33.33,100000,1,2000,0,0,0,0,0,0,0,0,0,0
20200430,051368,國泰金富邦97購01,0.08,0.08,0.08,0.08,0.00,0.00,6000,1,480,0,0,0,0,0,0,6000,0,6000,6000
20200430,051369,新光金富邦9A購01,,,,,0.00,0.00,0,0,0,0,0,0,0,0,0,0,0,0,0
20200430,05136P,台積電凱基95售08,,,,,0.00,0.00,0,0,0,0,0,0,0,0,0,0,0,0,0
20200430,051370,聯詠富邦97購01,0.10,0.10,0.09,0.09,0.00,0.00,40000,4,3700,0,0,0,0,0,0,0,10000,-10000,-10000
20200430,051371,超眾富邦95購01,,,,,0.00,0.00,0,0,0,0,0,0,0,0,0,0,0,0,0
20200430,051372,樺漢富邦96購01,,,,,0.00,0.00,0,0,0,0,0,0,0,0,0,0,0,0,0
20200430,051373,華新亞東95購01,,,,,0.00,0.00,0,0,0,0,0,0,0,0,0,0,0,0,0
20200430,051374,國泰金亞東95購01,,,,,0.00,0.00,0,0,0,0,0,0,0,0,0,0,0,0,0
20200430,051375,道瓊反群益9A購01,2.38,2.38,2.32,2.32,0.00,0.00,53000,3,123100,0,0,0,0,0,0,0,53000,-53000,-53000
20200430,051376,力山群益95購01,,,,,0.00,0.00,0,0,0,0,0,0,0,0,0,0,0,0,0
20200430,051377,鴻海群益95購07,,,,,0.00,0.00,0,0,0,0,0,0,0,0,0,0,0,0,0
20200430,051378,奇力新群益95購01,,,,,0.00,0.00,0,0,0,0,0,0,0,0,0,0,0,0,0
20200430,051379,新光金群益95購01,,,,,0.00,0.00,0,0,0,0,0,0,0,0,0,0,0,0,0
20200430,05137P,華新科凱基96售03,,,,,0.00,0.00,0,0,0,0,0,0,0,0,0,0,0,0,0
20200430,051380,禾伸堂群益95購01,,,,,0.00,0.00,0,0,0,0,0,0,0,0,0,0,0,0,0
20200430,051381,玉晶光群益98購01,2.48,2.82,2.48,2.79,+0.34,13.88,504000,28,1308670,0,0,0,0,0,0,119000,390000,-271000,-271000
20200430,051382,玉晶光群益98購02,3.34,3.87,3.34,3.84,+0.71,22.68,195000,49,675130,0,0,0,0,0,0,88000,157000,-69000,-69000
20200430,051383,京鼎群益96購02,,,,,0.00,0.00,0,0,0,0,0,0,0,0,0,0,0,0,0
20200430,051384,康友群益95購01,,,,,0.00,0.00,0,0,0,0,0,0,0,0,0,0,0,0,0
20200430,051385,矽創群益95購01,,,,,0.00,0.00,0,0,0,0,0,0,0,0,0,0,0,0,0
20200430,051386,富邦金麥證96購01,,,,,0.00,0.00,0,0,0,0,0,0,0,0,0,0,0,0,0
20200430,051387,新光金麥證96購01,,,,,0.00,0.00,0,0,0,0,0,0,0,0,0,0,0,0,0
20200430,051388,大立光麥證95購03,,,,,0.00,0.00,0,0,0,0,0,0,0,0,0,0,0,0,0
20200430,051389,台達電兆豐95購01,,,,,0.00,0.00,0,0,0,0,0,0,0,0,0,0,0,0,0
20200430,05138P,嘉聯益凱基96售02,1.73,1.73,1.73,1.73,0.00,0.00,26000,1,44980,0,0,0,0,0,0,0,26000,-26000,-26000
20200430,051390,京元電兆豐95購01,0.30,0.30,0.30,0.30,0.00,0.00,4000,1,1200,0,0,0,0,0,0,0,4000,-4000,-4000
20200430,051391,聯發科兆豐95購02,0.01,0.01,0.01,0.01,0.00,0.00,100000,1,1000,0,0,0,0,0,0,0,0,0,0
20200430,051392,玉山金兆豐95購01,0.01,0.01,0.01,0.01,0.00,0.00,10000,1,100,0,0,0,0,0,0,10000,0,10000,10000
20200430,051393,新光金兆豐96購01,0.02,0.02,0.02,0.02,0.00,0.00,10000,1,200,0,0,0,0,0,0,0,10000,-10000,-10000
20200430,051394,奇鋐兆豐95購01,0.25,0.34,0.23,0.31,+0.03,10.71,100000,5,29500,0,0,0,0,0,0,90000,10000,80000,80000
20200430,051395,聯詠兆豐95購01,,,,,0.00,0.00,0,0,0,0,0,0,0,0,0,0,0,0,0
20200430,051396,健鼎兆豐95購01,0.04,0.04,0.04,0.04,0.00,0.00,451000,1,18040,0,0,0,0,0,0,451000,0,451000,451000
20200430,051397,聯茂兆豐95購03,,,,,0.00,0.00,0,0,0,0,0,0,0,0,0,0,0,0,0
20200430,051398,智原台新95購01,,,,,0.00,0.00,0,0,0,0,0,0,0,0,0,0,0,0,0
20200430,051399,玉晶光台新96購01,,,,,0.00,0.00,0,0,0,0,0,0,0,0,0,0,0,0,0
20200430,05139P,臺股指凱基95售06,,,,,0.00,0.00,0,0,0,0,0,0,0,0,0,0,0,0,0
20200430,051400,國巨永豐95購01,,,,,0.00,0.00,0,0,0,0,0,0,0,0,0,0,0,0,0
20200430,051401,華新科永豐95購01,,,,,0.00,0.00,0,0,0,0,0,0,0,0,0,0,0,0,0
20200430,051402,玉晶光永豐95購04,0.05,0.05,0.05,0.05,0.00,0.00,1000,1,50,0,0,0,0,0,0,1000,0,1000,1000
20200430,051403,玉晶光永豐95購05,0.90,1.17,0.90,1.17,+0.32,37.65,72000,9,73790,0,0,0,0,0,0,69000,8000,61000,61000
20200430,051404,牧德永豐96購01,0.55,0.62,0.55,0.62,+0.09,16.98,31000,7,18250,0,0,0,0,0,0,1000,30000,-29000,-29000
20200430,051405,世芯永豐95購01,0.86,1.21,0.86,1.21,+0.55,83.33,1063000,31,1151350,0,0,0,0,0,0,903000,0,903000,903000
20200430,051406,泰鼎永豐96購01,0.89,0.91,0.82,0.91,-0.05,-5.21,37000,4,32280,0,0,0,0,0,0,11000,26000,-15000,-15000
20200430,051407,南茂永豐95購02,,,,,0.00,0.00,0,0,0,0,0,0,0,0,0,0,0,0,0
20200430,051408,台積電國票95購03,0.03,0.03,0.03,0.03,0.00,0.00,30000,1,900,0,0,0,0,0,0,30000,0,30000,30000
20200430,051409,美律國票96購01,,,,,0.00,0.00,0,0,0,0,0,0,0,0,0,0,0,0,0
20200430,05140P,台表科國票96售01,0.87,0.91,0.85,0.86,-0.11,-11.34,236000,11,208820,0,0,0,0,0,0,78000,158000,-80000,-80000
20200430,051410,京元電國票96購01,,,,,0.00,0.00,0,0,0,0,0,0,0,0,0,0,0,0,0
20200430,051411,聯發科國票95購05,,,,,0.00,0.00,0,0,0,0,0,0,0,0,0,0,0,0,0
20200430,051412,奇力新國票96購01,1.92,2.24,1.92,2.24,0.00,0.00,14000,2,28800,0,0,0,0,0,0,0,14000,-14000,-14000
20200430,051413,富邦金國票96購02,0.36,0.36,0.36,0.36,0.00,0.00,15000,2,5400,0,0,0,0,0,0,0,15000,-15000,-15000
20200430,051414,新光金國票95購04,,,,,0.00,0.00,0,0,0,0,0,0,0,0,0,0,0,0,0
20200430,051415,晶技國票96購01,,,,,0.00,0.00,0,0,0,0,0,0,0,0,0,0,0,0,0
20200430,051416,創意國票96購02,,,,,0.00,0.00,0,0,0,0,0,0,0,0,0,0,0,0,0
20200430,051417,揚明光國票96購01,,,,,0.00,0.00,0,0,0,0,0,0,0,0,0,0,0,0,0
20200430,051418,智易國票97購01,,,,,0.00,0.00,0,0,0,0,0,0,0,0,0,0,0,0,0
20200430,051419,麗豐國票96購01,,,,,0.00,0.00,0,0,0,0,0,0,0,0,0,0,0,0,0
20200430,05141P,華通台新96售01,,,,,0.00,0.00,0,0,0,0,0,0,0,0,0,0,0,0,0
20200430,051420,康控國票95購05,,,,,0.00,0.00,0,0,0,0,0,0,0,0,0,0,0,0,0
20200430,051421,彩晶國票95購01,,,,,0.00,0.00,0,0,0,0,0,0,0,0,0,0,0,0,0
20200430,051422,超眾國票96購01,2.82,2.97,2.82,2.97,+0.14,4.95,76000,2,218820,0,0,0,0,0,0,0,76000,-76000,-76000
20200430,051423,GIS國票97購01,,,,,0.00,0.00,0,0,0,0,0,0,0,0,0,0,0,0,0
20200430,051424,緯穎國票97購01,14.90,16.00,14.90,16.00,+2.80,21.21,8000,2,121400,0,0,0,0,0,0,0,8000,-8000,-8000
20200430,051425,昇陽半國票97購01,,,,,0.00,0.00,0,0,0,0,0,0,0,0,0,0,0,0,0
20200430,051426,道瓊反統一95購02,,,,,0.00,0.00,0,0,0,0,0,0,0,0,0,0,0,0,0
20200430,051427,聯發科統一95購04,0.03,0.03,0.03,0.03,+0.02,200.0,1000,1,30,0,0,0,0,0,0,1000,0,1000,1000
20200430,051428,玉晶光統一96購01,1.13,1.40,1.13,1.40,+0.28,25.0,610000,48,781560,0,0,0,0,0,0,115000,518000,-403000,-403000
20200430,051429,智邦元富95購01,,,,,0.00,0.00,0,0,0,0,0,0,0,0,0,0,0,0,0
20200430,05142P,華新科台新95售01,,,,,0.00,0.00,0,0,0,0,0,0,0,0,0,0,0,0,0
20200430,051430,瑞昱元富95購02,,,,,0.00,0.00,0,0,0,0,0,0,0,0,0,0,0,0,0
20200430,051431,群創元富99購02,,,,,0.00,0.00,0,0,0,0,0,0,0,0,0,0,0,0,0
20200430,051432,群創元富99購03,,,,,0.00,0.00,0,0,0,0,0,0,0,0,0,0,0,0,0
20200430,051433,中磊元富95購01,,,,,0.00,0.00,0,0,0,0,0,0,0,0,0,0,0,0,0
20200430,051434,中磊元富95購02,,,,,0.00,0.00,0,0,0,0,0,0,0,0,0,0,0,0,0
20200430,051435,聯茂元富95購01,,,,,0.00,0.00,0,0,0,0,0,0,0,0,0,0,0,0,0
20200430,051436,訊芯元富95購01,,,,,0.00,0.00,0,0,0,0,0,0,0,0,0,0,0,0,0
20200430,051437,百和元富95購02,,,,,0.00,0.00,0,0,0,0,0,0,0,0,0,0,0,0,0
20200430,051438,喬山元大95購03,,,,,0.00,0.00,0,0,0,0,0,0,0,0,0,0,0,0,0
20200430,051439,川湖元大95購01,,,,,0.00,0.00,0,0,0,0,0,0,0,0,0,0,0,0,0
20200430,05143P,臻鼎台新95售01,,,,,0.00,0.00,0,0,0,0,0,0,0,0,0,0,0,0,0
20200430,051440,鴻海元大95購12,,,,,0.00,0.00,0,0,0,0,0,0,0,0,0,0,0,0,0
20200430,051441,鴻海元大95購13,,,,,0.00,0.00,0,0,0,0,0,0,0,0,0,0,0,0,0
20200430,051442,正崴元大95購02,,,,,0.00,0.00,0,0,0,0,0,0,0,0,0,0,0,0,0
20200430,051443,聯發科元大95購10,,,,,0.00,0.00,0,0,0,0,0,0,0,0,0,0,0,0,0
20200430,051444,聯發科元大95購11,,,,,0.00,0.00,0,0,0,0,0,0,0,0,0,0,0,0,0
20200430,051445,可成元大95購06,,,,,0.00,0.00,0,0,0,0,0,0,0,0,0,0,0,0,0
20200430,051446,中壽元大96購01,,,,,0.00,0.00,0,0,0,0,0,0,0,0,0,0,0,0,0
20200430,051447,新光金元大97購01,,,,,0.00,0.00,0,0,0,0,0,0,0,0,0,0,0,0,0
20200430,051448,聯詠元大95購02,,,,,0.00,0.00,0,0,0,0,0,0,0,0,0,0,0,0,0
20200430,051449,玉晶光元大96購01,1.11,1.25,1.11,1.25,+0.30,31.58,51000,5,58450,0,0,0,0,0,0,51000,0,51000,51000
20200430,05144P,美律永豐95售02,,,,,0.00,0.00,0,0,0,0,0,0,0,0,0,0,0,0,0
20200430,051450,世芯元大95購02,4.37,4.82,4.27,4.82,0.00,0.00,18000,4,84210,0,0,0,0,0,0,6000,12000,-6000,-6000
20200430,051451,世芯元大95購03,3.40,3.89,3.40,3.89,+0.58,17.52,13000,5,46250,0,0,0,0,0,0,12000,0,12000,12000
20200430,051452,貿聯元大95購04,,,,,0.00,0.00,0,0,0,0,0,0,0,0,0,0,0,0,0
20200430,051453,智伸科元大95購02,,,,,0.00,0.00,0,0,0,0,0,0,0,0,0,0,0,0,0
20200430,051454,致伸元大95購01,,,,,0.00,0.00,0,0,0,0,0,0,0,0,0,0,0,0,0
20200430,051455,樺漢元大96購01,0.02,0.02,0.02,0.02,0.00,0.00,5000,1,100,0,0,0,0,0,0,5000,0,5000,5000
20200430,051456,鈺齊元大95購01,,,,,0.00,0.00,0,0,0,0,0,0,0,0,0,0,0,0,0
20200430,051457,寶成元大95購01,,,,,0.00,0.00,0,0,0,0,0,0,0,0,0,0,0,0,0
20200430,051458,臺股指元大95購18,,,,,0.00,0.00,0,0,0,0,0,0,0,0,0,0,0,0,0
20200430,051459,臺股指元大95購19,0.45,0.45,0.45,0.45,0.00,0.00,1000,1,450,0,0,0,0,0,0,0,1000,-1000,-1000
20200430,05145P,道瓊反元大98售01,0.37,0.40,0.37,0.40,0.00,0.00,125000,6,48180,0,0,0,0,0,0,125000,0,125000,125000
20200430,051460,S&P反1國泰97購01,0.71,0.71,0.71,0.71,-0.10,-12.35,20000,1,14200,0,0,0,0,0,0,0,20000,-20000,-20000
20200430,051461,聯詠國泰96購01,0.21,0.24,0.21,0.24,0.00,0.00,42000,3,9560,0,0,0,0,0,0,42000,0,42000,42000
20200430,051462,世芯國泰97購01,4.20,4.36,4.20,4.36,+0.48,12.37,102000,2,444400,0,0,0,0,0,0,102000,0,102000,102000
20200430,051463,世芯國泰97購02,6.75,7.85,6.75,7.85,+1.65,26.61,11000,4,83000,0,0,0,0,0,0,9000,2000,7000,7000
20200430,051464,彩晶國泰96購01,,,,,0.00,0.00,0,0,0,0,0,0,0,0,0,0,0,0,0
20200430,051465,鴻海富邦97購02,,,,,0.00,0.00,0,0,0,0,0,0,0,0,0,0,0,0,0
20200430,051466,玉晶光富邦97購01,0.48,0.48,0.48,0.48,+0.04,9.09,1000,1,480,0,0,0,0,0,0,0,1000,-1000,-1000
20200430,051467,GIS富邦96購01,,,,,0.00,0.00,0,0,0,0,0,0,0,0,0,0,0,0,0
20200430,051468,智邦日盛95購01,,,,,0.00,0.00,0,0,0,0,0,0,0,0,0,0,0,0,0
20200430,051469,友達日盛9B購01,,,,,0.00,0.00,0,0,0,0,0,0,0,0,0,0,0,0,0
20200430,05146P,鴻海元大95售10,,,,,0.00,0.00,0,0,0,0,0,0,0,0,0,0,0,0,0
20200430,051470,玉晶光日盛95購01,,,,,0.00,0.00,0,0,0,0,0,0,0,0,0,0,0,0,0
20200430,051471,國巨凱基97購01,,,,,0.00,0.00,0,0,0,0,0,0,0,0,0,0,0,0,0
20200430,051472,台積電凱基95購09,0.20,0.20,0.20,0.20,+0.06,42.86,20000,1,4000,0,0,0,0,0,0,20000,0,20000,20000
20200430,051473,台積電凱基95購10,0.01,0.01,0.01,0.01,0.00,0.00,20000,20,200,0,0,0,0,0,0,0,0,0,0
20200430,051474,智邦凱基95購04,,,,,0.00,0.00,0,0,0,0,0,0,0,0,0,0,0,0,0
20200430,051475,宏碁凱基95購02,,,,,0.00,0.00,0,0,0,0,0,0,0,0,0,0,0,0,0
20200430,051476,聯發科凱基95購09,,,,,0.00,0.00,0,0,0,0,0,0,0,0,0,0,0,0,0
20200430,051477,可成凱基95購07,,,,,0.00,0.00,0,0,0,0,0,0,0,0,0,0,0,0,0
20200430,051478,宏達電凱基95購03,,,,,0.00,0.00,0,0,0,0,0,0,0,0,0,0,0,0,0
20200430,051479,兆豐金凱基95購01,,,,,0.00,0.00,0,0,0,0,0,0,0,0,0,0,0,0,0
20200430,05147P,鴻海元大95售11,,,,,0.00,0.00,0,0,0,0,0,0,0,0,0,0,0,0,0
20200430,051480,大立光凱基97購01,,,,,0.00,0.00,0,0,0,0,0,0,0,0,0,0,0,0,0
20200430,051481,聯詠凱基95購02,,,,,0.00,0.00,0,0,0,0,0,0,0,0,0,0,0,0,0
20200430,051482,玉晶光凱基96購01,,,,,0.00,0.00,0,0,0,0,0,0,0,0,0,0,0,0,0
20200430,051483,玉晶光凱基96購02,0.83,1.03,0.83,1.03,+0.24,30.38,374000,24,340660,0,0,0,0,0,0,100000,140000,-40000,-40000
20200430,051484,玉晶光凱基97購01,0.65,0.65,0.65,0.65,0.00,0.00,10000,1,6500,0,0,0,0,0,0,10000,0,10000,10000
20200430,051485,玉晶光凱基97購02,,,,,0.00,0.00,0,0,0,0,0,0,0,0,0,0,0,0,0
20200430,051486,玉晶光凱基97購03,0.80,0.80,0.80,0.80,0.00,0.00,8000,2,6400,0,0,0,0,0,0,0,0,0,0
20200430,051487,健策凱基96購03,0.42,0.42,0.42,0.42,0.00,0.00,40000,4,16800,0,0,0,0,0,0,21000,0,21000,21000
20200430,051488,健策凱基96購04,0.33,0.35,0.33,0.35,+0.08,29.63,21000,2,6950,0,0,0,0,0,0,21000,0,21000,21000
20200430,051489,世芯凱基95購01,3.72,3.72,3.72,3.72,+0.21,5.98,4000,1,14880,0,0,0,0,0,0,4000,0,4000,4000
20200430,05148P,臻鼎元大95售01,2.74,2.74,2.66,2.66,0.00,0.00,5000,2,13540,0,0,0,0,0,0,0,5000,-5000,-5000
20200430,051490,世芯凱基96購01,3.34,3.79,3.34,3.71,+0.97,35.4,21000,4,75010,0,0,0,0,0,0,1000,20000,-19000,-19000
20200430,051491,貿聯凱基95購01,,,,,0.00,0.00,0,0,0,0,0,0,0,0,0,0,0,0,0
20200430,051492,臻鼎凱基95購01,,,,,0.00,0.00,0,0,0,0,0,0,0,0,0,0,0,0,0
20200430,051493,台郡凱基95購02,,,,,0.00,0.00,0,0,0,0,0,0,0,0,0,0,0,0,0
20200430,051494,中環兆豐95購01,,,,,0.00,0.00,0,0,0,0,0,0,0,0,0,0,0,0,0
20200430,051495,玉晶光第一95購02,0.38,0.38,0.36,0.36,0.00,0.00,6000,2,2200,0,0,0,0,0,0,6000,0,6000,6000
20200430,051496,義隆亞東95購01,,,,,0.00,0.00,0,0,0,0,0,0,0,0,0,0,0,0,0
20200430,051497,中磊亞東96購01,,,,,0.00,0.00,0,0,0,0,0,0,0,0,0,0,0,0,0
20200430,051498,智易群益96購01,,,,,0.00,0.00,0,0,0,0,0,0,0,0,0,0,0,0,0
20200430,051499,康控群益95購02,,,,,0.00,0.00,0,0,0,0,0,0,0,0,0,0,0,0,0
20200430,05149P,緯穎國泰96售01,,,,,0.00,0.00,0,0,0,0,0,0,0,0,0,0,0,0,0
20200430,051500,聯茂群益95購01,,,,,0.00,0.00,0,0,0,0,0,0,0,0,0,0,0,0,0
20200430,051501,康友群益95購02,,,,,0.00,0.00,0,0,0,0,0,0,0,0,0,0,0,0,0
20200430,051502,南茂群益95購01,,,,,0.00,0.00,0,0,0,0,0,0,0,0,0,0,0,0,0
20200430,051503,玉晶光統一97購01,2.45,2.75,2.45,2.72,+0.39,16.74,414000,28,1067970,0,0,0,0,0,0,332000,88000,244000,244000
20200430,051504,TPK統一95購01,,,,,0.00,0.00,0,0,0,0,0,0,0,0,0,0,0,0,0
20200430,051505,台積電元富95購05,0.11,0.15,0.08,0.13,+0.01,8.33,944000,35,102960,0,0,0,0,0,0,511000,0,511000,511000
20200430,051506,台積電元富95購06,0.02,0.02,0.02,0.02,0.00,0.00,41000,2,820,0,0,0,0,0,0,0,0,0,0
20200430,051507,彩晶元富95購01,0.02,0.02,0.02,0.02,0.00,0.00,12000,12,240,0,0,0,0,0,0,0,0,0,0
20200430,051508,元黃金中信97購01,2.68,2.68,2.68,2.68,-0.05,-1.83,1000,1,2680,0,0,0,0,0,0,1000,0,1000,1000
20200430,051509,鴻海中信97購01,,,,,0.00,0.00,0,0,0,0,0,0,0,0,0,0,0,0,0
20200430,05150P,玉晶光第一95售01,,,,,0.00,0.00,0,0,0,0,0,0,0,0,0,0,0,0,0
20200430,051510,新光金中信97購01,0.04,0.04,0.04,0.04,0.00,0.00,20000,2,800,0,0,0,0,0,0,0,20000,-20000,-20000
20200430,051511,鈺齊中信97購01,,,,,0.00,0.00,0,0,0,0,0,0,0,0,0,0,0,0,0
20200430,051512,超眾麥證95購01,,,,,0.00,0.00,0,0,0,0,0,0,0,0,0,0,0,0,0
20200430,051513,台積電凱基95購13,,,,,0.00,0.00,0,0,0,0,0,0,0,0,0,0,0,0,0
20200430,051514,智邦凱基95購05,,,,,0.00,0.00,0,0,0,0,0,0,0,0,0,0,0,0,0
20200430,051515,聯發科凱基95購10,0.01,0.01,0.01,0.01,0.00,0.00,220000,1,2200,0,0,0,0,0,0,220000,0,220000,220000
20200430,051516,全新凱基96購02,,,,,0.00,0.00,0,0,0,0,0,0,0,0,0,0,0,0,0
20200430,051517,可成凱基95購08,,,,,0.00,0.00,0,0,0,0,0,0,0,0,0,0,0,0,0
20200430,051518,富邦金凱基95購01,,,,,0.00,0.00,0,0,0,0,0,0,0,0,0,0,0,0,0
20200430,051519,國泰金凱基95購02,,,,,0.00,0.00,0,0,0,0,0,0,0,0,0,0,0,0,0
20200430,05151P,台光電群益95售02,,,,,0.00,0.00,0,0,0,0,0,0,0,0,0,0,0,0,0
20200430,051520,新光金凱基97購01,,,,,0.00,0.00,0,0,0,0,0,0,0,0,0,0,0,0,0
20200430,051521,大立光凱基96購07,,,,,0.00,0.00,0,0,0,0,0,0,0,0,0,0,0,0,0
20200430,051522,玉晶光凱基95購05,0.01,0.01,0.01,0.01,0.00,0.00,40000,1,400,0,0,0,0,0,0,40000,0,40000,40000
20200430,051523,牧德凱基95購02,,,,,0.00,0.00,0,0,0,0,0,0,0,0,0,0,0,0,0
20200430,051524,貿聯凱基95購02,0.07,0.07,0.07,0.07,0.00,0.00,15000,1,1050,0,0,0,0,0,0,15000,0,15000,15000
20200430,051525,日月光凱基95購02,,,,,0.00,0.00,0,0,0,0,0,0,0,0,0,0,0,0,0
20200430,051526,超眾凱基95購02,,,,,0.00,0.00,0,0,0,0,0,0,0,0,0,0,0,0,0
20200430,051527,台郡凱基95購03,,,,,0.00,0.00,0,0,0,0,0,0,0,0,0,0,0,0,0
20200430,051528,亞泥國票96購01,,,,,0.00,0.00,0,0,0,0,0,0,0,0,0,0,0,0,0
20200430,051529,東元國票96購01,,,,,0.00,0.00,0,0,0,0,0,0,0,0,0,0,0,0,0
20200430,05152P,玉晶光群益96售05,0.68,0.68,0.56,0.56,-0.18,-24.32,420000,11,254650,0,0,0,0,0,0,325000,95000,230000,230000
20200430,051530,鴻海國票97購01,0.04,0.04,0.04,0.04,+0.01,33.33,81000,1,3240,0,0,0,0,0,0,0,0,0,0
20200430,051531,國巨國票96購04,4.42,4.42,4.42,4.42,+0.26,6.25,1000,1,4420,0,0,0,0,0,0,1000,0,1000,1000
20200430,051532,潤泰全國票96購01,,,,,0.00,0.00,0,0,0,0,0,0,0,0,0,0,0,0,0
20200430,051533,健鼎國票96購02,,,,,0.00,0.00,0,0,0,0,0,0,0,0,0,0,0,0,0
20200430,051534,景碩國票97購01,3.25,3.73,3.25,3.73,+0.51,15.84,3000,3,10340,0,0,0,0,0,0,1000,2000,-1000,-1000
20200430,051535,新日興國票96購01,,,,,0.00,0.00,0,0,0,0,0,0,0,0,0,0,0,0,0
20200430,051536,玉晶光國票97購01,2.17,2.68,2.16,2.65,+0.61,29.9,728000,47,1706560,0,0,0,0,0,0,164000,598000,-434000,-434000
20200430,051537,牧德國票96購01,0.96,0.96,0.86,0.86,+0.03,3.61,20000,2,18200,0,0,0,0,0,0,10000,10000,0,0
20200430,051538,和碩國票96購01,,,,,0.00,0.00,0,0,0,0,0,0,0,0,0,0,0,0,0
20200430,051539,瀚宇博國票97購01,0.80,0.83,0.80,0.83,0.00,0.00,41000,2,33880,0,0,0,0,0,0,0,41000,-41000,-41000
20200430,05153P,台表科群益96售01,,,,,0.00,0.00,0,0,0,0,0,0,0,0,0,0,0,0,0
20200430,051540,力成國票95購01,0.52,0.56,0.52,0.56,+0.04,7.69,168000,5,90880,0,0,0,0,0,0,88000,80000,8000,8000
20200430,051541,GIS國票96購02,,,,,0.00,0.00,0,0,0,0,0,0,0,0,0,0,0,0,0
20200430,051542,南茂國票96購01,,,,,0.00,0.00,0,0,0,0,0,0,0,0,0,0,0,0,0
20200430,051543,鈺齊國票96購01,0.05,0.05,0.05,0.05,0.00,0.00,50000,1,2500,0,0,0,0,0,0,0,0,0,0
20200430,051544,T50反1康和98購01,0.79,0.79,0.79,0.79,-0.07,-8.14,1000,1,790,0,0,0,0,0,0,0,1000,-1000,-1000
20200430,051545,裕隆康和95購01,,,,,0.00,0.00,0,0,0,0,0,0,0,0,0,0,0,0,0
20200430,051546,慧洋康和95購01,,,,,0.00,0.00,0,0,0,0,0,0,0,0,0,0,0,0,0
20200430,051547,健鼎康和95購01,,,,,0.00,0.00,0,0,0,0,0,0,0,0,0,0,0,0,0
20200430,051548,鈺齊康和95購01,,,,,0.00,0.00,0,0,0,0,0,0,0,0,0,0,0,0,0
20200430,051549,健鼎永豐95購01,,,,,0.00,0.00,0,0,0,0,0,0,0,0,0,0,0,0,0
20200430,05154P,台積電兆豐95售05,0.23,0.26,0.23,0.23,-0.14,-37.84,21000,4,4920,0,0,0,0,0,0,8000,10000,-2000,-2000
20200430,051550,日電貿永豐95購01,,,,,0.00,0.00,0,0,0,0,0,0,0,0,0,0,0,0,0
20200430,051551,新日興永豐95購01,,,,,0.00,0.00,0,0,0,0,0,0,0,0,0,0,0,0,0
20200430,051552,牧德永豐95購03,0.75,0.83,0.75,0.83,+0.14,20.29,20000,2,15800,0,0,0,0,0,0,10000,10000,0,0
20200430,051553,牧德永豐96購02,0.62,0.68,0.62,0.67,0.00,0.00,478000,4,298360,0,0,0,0,0,0,428000,478000,-50000,-50000
20200430,051554,鎧勝永豐95購01,,,,,0.00,0.00,0,0,0,0,0,0,0,0,0,0,0,0,0
20200430,051555,聯茂永豐95購01,,,,,0.00,0.00,0,0,0,0,0,0,0,0,0,0,0,0,0
20200430,051556,台表科永豐96購01,,,,,0.00,0.00,0,0,0,0,0,0,0,0,0,0,0,0,0
20200430,051557,昇陽半永豐96購01,,,,,0.00,0.00,0,0,0,0,0,0,0,0,0,0,0,0,0
20200430,051558,元金2X國泰97購01,,,,,0.00,0.00,0,0,0,0,0,0,0,0,0,0,0,0,0
20200430,051559,宏達電國泰96購01,,,,,0.00,0.00,0,0,0,0,0,0,0,0,0,0,0,0,0
20200430,05155P,聯發科兆豐95售03,,,,,0.00,0.00,0,0,0,0,0,0,0,0,0,0,0,0,0
20200430,051560,玉晶光國泰97購03,1.33,1.53,1.33,1.51,0.00,0.00,16000,8,23200,0,0,0,0,0,0,12000,2000,10000,10000
20200430,051561,玉晶光國泰97購04,1.58,1.85,1.57,1.85,+0.33,21.71,783000,153,1337260,0,0,0,0,0,0,274000,509000,-235000,-235000
20200430,051562,玉晶光國泰97購05,1.15,1.28,1.15,1.28,0.00,0.00,40000,3,49700,0,0,0,0,0,0,40000,0,40000,40000
20200430,051563,泰鼎國泰96購01,,,,,0.00,0.00,0,0,0,0,0,0,0,0,0,0,0,0,0
20200430,051564,和碩國泰96購01,,,,,0.00,0.00,0,0,0,0,0,0,0,0,0,0,0,0,0
20200430,051565,玉晶光永昌96購01,,,,,0.00,0.00,0,0,0,0,0,0,0,0,0,0,0,0,0
20200430,051566,鴻海富邦95購05,,,,,0.00,0.00,0,0,0,0,0,0,0,0,0,0,0,0,0
20200430,051567,台積電富邦95購06,,,,,0.00,0.00,0,0,0,0,0,0,0,0,0,0,0,0,0
20200430,051568,智邦富邦95購01,,,,,0.00,0.00,0,0,0,0,0,0,0,0,0,0,0,0,0
20200430,051569,緯創富邦95購02,0.02,0.02,0.02,0.02,0.00,0.00,227000,4,4540,0,0,0,0,0,0,227000,0,227000,227000
20200430,05156P,群創兆豐95售01,,,,,0.00,0.00,0,0,0,0,0,0,0,0,0,0,0,0,0
20200430,051570,和碩富邦97購01,0.35,0.36,0.34,0.36,-0.01,-2.7,75000,8,26200,0,0,0,0,0,0,15000,60000,-45000,-45000
20200430,051571,南茂富邦95購01,,,,,0.00,0.00,0,0,0,0,0,0,0,0,0,0,0,0,0
20200430,051572,上銀元大95購01,1.00,1.73,1.00,1.51,0.00,0.00,52000,6,68920,0,0,0,0,0,0,0,52000,-52000,-52000
20200430,051573,鴻海元大95購15,,,,,0.00,0.00,0,0,0,0,0,0,0,0,0,0,0,0,0
20200430,051574,鴻海元大96購06,,,,,0.00,0.00,0,0,0,0,0,0,0,0,0,0,0,0,0
20200430,051575,國巨元大96購03,1.71,1.80,1.71,1.80,+0.14,8.43,40000,5,71610,0,0,0,0,0,0,1000,39000,-38000,-38000
20200430,051576,台積電元大97購02,,,,,0.00,0.00,0,0,0,0,0,0,0,0,0,0,0,0,0
20200430,051577,台積電元大97購03,2.46,2.46,2.46,2.46,+0.06,2.5,1000,1,2460,0,0,0,0,0,0,0,0,0,0
20200430,051578,智邦元大96購01,,,,,0.00,0.00,0,0,0,0,0,0,0,0,0,0,0,0,0
20200430,051579,宏碁元大95購01,,,,,0.00,0.00,0,0,0,0,0,0,0,0,0,0,0,0,0
20200430,05157P,全新台新96售01,,,,,0.00,0.00,0,0,0,0,0,0,0,0,0,0,0,0,0
20200430,051580,宏碁元大95購02,,,,,0.00,0.00,0,0,0,0,0,0,0,0,0,0,0,0,0
20200430,051581,聯發科元大95購12,,,,,0.00,0.00,0,0,0,0,0,0,0,0,0,0,0,0,0
20200430,051582,聯發科元大97購02,1.20,1.36,1.20,1.36,+0.38,38.78,75000,7,97500,0,0,0,0,0,0,75000,0,75000,75000
20200430,051583,可成元大95購07,,,,,0.00,0.00,0,0,0,0,0,0,0,0,0,0,0,0,0
20200430,051584,可成元大95購08,,,,,0.00,0.00,0,0,0,0,0,0,0,0,0,0,0,0,0
20200430,051585,美食元大95購01,,,,,0.00,0.00,0,0,0,0,0,0,0,0,0,0,0,0,0
20200430,051586,國泰金元大96購01,,,,,0.00,0.00,0,0,0,0,0,0,0,0,0,0,0,0,0
20200430,051587,大立光元大95購08,,,,,0.00,0.00,0,0,0,0,0,0,0,0,0,0,0,0,0
20200430,051588,聯詠元大95購03,,,,,0.00,0.00,0,0,0,0,0,0,0,0,0,0,0,0,0
20200430,051589,健鼎元大95購02,,,,,0.00,0.00,0,0,0,0,0,0,0,0,0,0,0,0,0
20200430,05158P,華通永豐95售01,,,,,0.00,0.00,0,0,0,0,0,0,0,0,0,0,0,0,0
20200430,051590,玉晶光元大96購02,,,,,0.00,0.00,0,0,0,0,0,0,0,0,0,0,0,0,0
20200430,051591,玉晶光元大97購01,0.99,1.00,0.99,1.00,0.00,0.00,30000,3,29900,0,0,0,0,0,0,0,10000,-10000,-10000
20200430,051592,健策元大96購05,0.78,0.78,0.78,0.78,0.00,0.00,19000,1,14820,0,0,0,0,0,0,19000,0,19000,19000
20200430,051593,和碩元大95購01,,,,,0.00,0.00,0,0,0,0,0,0,0,0,0,0,0,0,0
20200430,051594,和碩元大96購01,1.83,1.92,1.81,1.87,-0.09,-4.59,195000,17,366430,0,0,0,0,0,0,20000,175000,-155000,-155000
20200430,051595,康控元大95購04,,,,,0.00,0.00,0,0,0,0,0,0,0,0,0,0,0,0,0
20200430,051596,超眾元大95購05,,,,,0.00,0.00,0,0,0,0,0,0,0,0,0,0,0,0,0
20200430,051597,T50反1中信99購02,,,,,0.00,0.00,0,0,0,0,0,0,0,0,0,0,0,0,0
20200430,051598,瑞昱兆豐95購01,0.75,0.90,0.75,0.90,+0.20,28.57,105000,4,87310,0,0,0,0,0,0,105000,0,105000,105000
20200430,051599,健鼎兆豐95購02,,,,,0.00,0.00,0,0,0,0,0,0,0,0,0,0,0,0,0
20200430,05159P,聯發科永豐95售04,,,,,0.00,0.00,0,0,0,0,0,0,0,0,0,0,0,0,0
20200430,051600,新日興兆豐96購02,0.71,0.71,0.66,0.66,-0.04,-5.71,55000,6,38800,0,0,0,0,0,0,55000,0,55000,55000
20200430,051601,群創兆豐95購02,0.06,0.07,0.06,0.07,0.00,0.00,20000,2,1300,0,0,0,0,0,0,20000,20000,0,0
20200430,051602,南茂兆豐96購01,0.14,0.14,0.14,0.14,0.00,0.00,1000,1,140,0,0,0,0,0,0,1000,0,1000,1000
20200430,051603,深中小群益99購03,,,,,0.00,0.00,0,0,0,0,0,0,0,0,0,0,0,0,0
20200430,051604,喬山群益95購01,,,,,0.00,0.00,0,0,0,0,0,0,0,0,0,0,0,0,0
20200430,051605,奇力新群益95購02,,,,,0.00,0.00,0,0,0,0,0,0,0,0,0,0,0,0,0
20200430,051606,華新科群益95購05,,,,,0.00,0.00,0,0,0,0,0,0,0,0,0,0,0,0,0
20200430,051607,緯創群益96購02,0.88,0.96,0.85,0.92,+0.02,2.22,493000,15,450530,0,0,0,0,0,0,306000,187000,119000,119000
20200430,051608,新日興群益96購01,,,,,0.00,0.00,0,0,0,0,0,0,0,0,0,0,0,0,0
20200430,051609,貿聯群益95購03,,,,,0.00,0.00,0,0,0,0,0,0,0,0,0,0,0,0,0
20200430,05160P,國巨國票96售03,0.61,0.64,0.60,0.61,-0.13,-17.57,270000,36,168350,0,0,0,0,0,0,35000,235000,-200000,-200000
20200430,051610,GIS群益95購02,,,,,0.00,0.00,0,0,0,0,0,0,0,0,0,0,0,0,0
20200430,051611,鈺齊群益95購02,,,,,0.00,0.00,0,0,0,0,0,0,0,0,0,0,0,0,0
20200430,051612,緯創日盛95購01,,,,,0.00,0.00,0,0,0,0,0,0,0,0,0,0,0,0,0
20200430,051613,S&P反1凱基96購01,,,,,0.00,0.00,0,0,0,0,0,0,0,0,0,0,0,0,0
20200430,051614,元金2X凱基97購01,2.94,2.94,2.00,2.89,0.00,0.00,22000,8,47430,0,0,0,0,0,0,0,19000,-19000,-19000
20200430,051615,華通凱基96購01,,,,,0.00,0.00,0,0,0,0,0,0,0,0,0,0,0,0,0
20200430,051616,鴻海凱基96購08,,,,,0.00,0.00,0,0,0,0,0,0,0,0,0,0,0,0,0
20200430,051617,台積電凱基95購14,,,,,0.00,0.00,0,0,0,0,0,0,0,0,0,0,0,0,0
20200430,051618,智邦凱基95購06,,,,,0.00,0.00,0,0,0,0,0,0,0,0,0,0,0,0,0
20200430,051619,智邦凱基95購07,,,,,0.00,0.00,0,0,0,0,0,0,0,0,0,0,0,0,0
20200430,05161P,華新科國票96售01,0.57,0.60,0.57,0.59,-0.04,-6.35,148000,31,86850,0,0,0,0,0,0,103000,45000,58000,58000
20200430,051620,可成凱基95購10,,,,,0.00,0.00,0,0,0,0,0,0,0,0,0,0,0,0,0
20200430,051621,欣興凱基95購02,,,,,0.00,0.00,0,0,0,0,0,0,0,0,0,0,0,0,0
20200430,051622,和碩凱基96購01,,,,,0.00,0.00,0,0,0,0,0,0,0,0,0,0,0,0,0
20200430,051623,和碩凱基96購02,,,,,0.00,0.00,0,0,0,0,0,0,0,0,0,0,0,0,0
20200430,051624,智邦麥證95購02,,,,,0.00,0.00,0,0,0,0,0,0,0,0,0,0,0,0,0
20200430,051625,聯發科麥證95購01,,,,,0.00,0.00,0,0,0,0,0,0,0,0,0,0,0,0,0
20200430,051626,可成麥證95購02,,,,,0.00,0.00,0,0,0,0,0,0,0,0,0,0,0,0,0
20200430,051627,華新科麥證95購03,,,,,0.00,0.00,0,0,0,0,0,0,0,0,0,0,0,0,0
20200430,051628,瀚宇博麥證95購01,,,,,0.00,0.00,0,0,0,0,0,0,0,0,0,0,0,0,0
20200430,051629,上証2X國票95購04,,,,,0.00,0.00,0,0,0,0,0,0,0,0,0,0,0,0,0
20200430,05162P,玉晶光國票96售03,,,,,0.00,0.00,0,0,0,0,0,0,0,0,0,0,0,0,0
20200430,051630,力山國票96購01,1.24,1.39,1.24,1.39,+0.21,17.8,290000,8,380960,0,0,0,0,0,0,210000,80000,130000,130000
20200430,051631,國巨國票96購06,,,,,0.00,0.00,0,0,0,0,0,0,0,0,0,0,0,0,0
20200430,051632,全新國票96購01,,,,,0.00,0.00,0,0,0,0,0,0,0,0,0,0,0,0,0
20200430,051633,可成國票96購03,,,,,0.00,0.00,0,0,0,0,0,0,0,0,0,0,0,0,0
20200430,051634,大立光國票96購03,,,,,0.00,0.00,0,0,0,0,0,0,0,0,0,0,0,0,0
20200430,051635,大立光國票96購04,0.65,0.74,0.65,0.74,+0.21,39.62,114000,3,79510,0,0,0,0,0,0,30000,84000,-54000,-54000
20200430,051636,嘉晶國票95購02,0.73,0.73,0.65,0.65,0.00,0.00,32000,3,22560,0,0,0,0,0,0,32000,0,32000,32000
20200430,051637,嘉聯益國票96購01,,,,,0.00,0.00,0,0,0,0,0,0,0,0,0,0,0,0,0
20200430,051638,聯茂國票96購01,,,,,0.00,0.00,0,0,0,0,0,0,0,0,0,0,0,0,0
20200430,051639,康友國票96購02,0.15,0.15,0.15,0.15,0.00,0.00,36000,2,5400,0,0,0,0,0,0,0,36000,-36000,-36000
20200430,05163P,聯發科統一96售02,,,,,0.00,0.00,0,0,0,0,0,0,0,0,0,0,0,0,0
20200430,051640,GIS國票96購03,,,,,0.00,0.00,0,0,0,0,0,0,0,0,0,0,0,0,0
20200430,051641,矽創國票96購01,,,,,0.00,0.00,0,0,0,0,0,0,0,0,0,0,0,0,0
20200430,051642,鈺齊台新95購01,,,,,0.00,0.00,0,0,0,0,0,0,0,0,0,0,0,0,0
20200430,051643,瑞昱康和95購01,0.45,0.46,0.45,0.46,0.00,0.00,60000,4,27200,0,0,0,0,0,0,0,60000,-60000,-60000
20200430,051644,聯茂康和95購01,0.44,0.44,0.44,0.44,-0.02,-4.35,50000,1,22000,0,0,0,0,0,0,50000,0,50000,50000
20200430,051645,光寶科永豐95購01,,,,,0.00,0.00,0,0,0,0,0,0,0,0,0,0,0,0,0
20200430,051646,華通永豐96購01,,,,,0.00,0.00,0,0,0,0,0,0,0,0,0,0,0,0,0
20200430,051647,華新科永豐95購02,,,,,0.00,0.00,0,0,0,0,0,0,0,0,0,0,0,0,0
20200430,051648,TPK永豐95購01,,,,,0.00,0.00,0,0,0,0,0,0,0,0,0,0,0,0,0
20200430,051649,中磊永豐95購02,,,,,0.00,0.00,0,0,0,0,0,0,0,0,0,0,0,0,0
20200430,05164P,南亞科元富95售04,,,,,0.00,0.00,0,0,0,0,0,0,0,0,0,0,0,0,0
20200430,051650,矽力永豐95購01,,,,,0.00,0.00,0,0,0,0,0,0,0,0,0,0,0,0,0
20200430,051651,易華電永豐95購01,,,,,0.00,0.00,0,0,0,0,0,0,0,0,0,0,0,0,0
20200430,051652,昇陽半永豐96購02,,,,,0.00,0.00,0,0,0,0,0,0,0,0,0,0,0,0,0
20200430,051653,南電永豐95購02,1.79,1.79,1.50,1.50,-0.08,-5.06,20000,2,32900,0,0,0,0,0,0,10000,10000,0,0
20200430,051654,致新永豐95購01,,,,,0.00,0.00,0,0,0,0,0,0,0,0,0,0,0,0,0
20200430,051655,欣興元富95購04,,,,,0.00,0.00,0,0,0,0,0,0,0,0,0,0,0,0,0
20200430,051656,嘉聯益元富95購02,,,,,0.00,0.00,0,0,0,0,0,0,0,0,0,0,0,0,0
20200430,051657,台郡元富98購01,,,,,0.00,0.00,0,0,0,0,0,0,0,0,0,0,0,0,0
20200430,051658,深中小國泰97購01,,,,,0.00,0.00,0,0,0,0,0,0,0,0,0,0,0,0,0
20200430,051659,力山國泰97購01,0.81,0.92,0.70,0.70,-0.02,-2.78,590000,41,484660,0,0,0,0,0,0,349000,241000,108000,108000
20200430,05165P,欣興元富95售03,,,,,0.00,0.00,0,0,0,0,0,0,0,0,0,0,0,0,0
20200430,051660,緯穎國泰96購02,,,,,0.00,0.00,0,0,0,0,0,0,0,0,0,0,0,0,0
20200430,051661,華新科永昌96購01,,,,,0.00,0.00,0,0,0,0,0,0,0,0,0,0,0,0,0
20200430,051662,大立光永昌96購03,0.19,0.19,0.19,0.19,0.00,0.00,10000,1,1900,0,0,0,0,0,0,10000,0,10000,10000
20200430,051663,鴻海元大95購18,,,,,0.00,0.00,0,0,0,0,0,0,0,0,0,0,0,0,0
20200430,051664,鴻海元大96購07,,,,,0.00,0.00,0,0,0,0,0,0,0,0,0,0,0,0,0
20200430,051665,台積電元大96購07,,,,,0.00,0.00,0,0,0,0,0,0,0,0,0,0,0,0,0
20200430,051666,旺宏元大96購05,1.71,1.71,1.71,1.71,0.00,0.00,4000,1,6840,0,0,0,0,0,0,4000,0,4000,4000
20200430,051667,光磊元大96購02,0.64,0.64,0.64,0.64,+0.01,1.59,19000,1,12160,0,0,0,0,0,0,19000,0,19000,19000
20200430,051668,智邦元大95購02,,,,,0.00,0.00,0,0,0,0,0,0,0,0,0,0,0,0,0
20200430,051669,建準元大95購01,,,,,0.00,0.00,0,0,0,0,0,0,0,0,0,0,0,0,0
20200430,05166P,中磊元富95售03,,,,,0.00,0.00,0,0,0,0,0,0,0,0,0,0,0,0,0
20200430,051670,欣興元大95購06,,,,,0.00,0.00,0,0,0,0,0,0,0,0,0,0,0,0,0
20200430,051671,和鑫元大96購02,,,,,0.00,0.00,0,0,0,0,0,0,0,0,0,0,0,0,0
20200430,051672,玉晶光元大96購03,,,,,0.00,0.00,0,0,0,0,0,0,0,0,0,0,0,0,0
20200430,051673,玉晶光元大96購04,0.72,0.84,0.72,0.84,0.00,0.00,55000,2,45000,0,0,0,0,0,0,55000,0,55000,55000
20200430,051674,臻鼎元大95購02,,,,,0.00,0.00,0,0,0,0,0,0,0,0,0,0,0,0,0
20200430,051675,瑞儀元大96購02,,,,,0.00,0.00,0,0,0,0,0,0,0,0,0,0,0,0,0
20200430,051676,康舒元大95購01,,,,,0.00,0.00,0,0,0,0,0,0,0,0,0,0,0,0,0
20200430,051677,達方元大95購01,,,,,0.00,0.00,0,0,0,0,0,0,0,0,0,0,0,0,0
20200430,051678,鈺齊元大95購02,,,,,0.00,0.00,0,0,0,0,0,0,0,0,0,0,0,0,0
20200430,051679,百和元大95購02,,,,,0.00,0.00,0,0,0,0,0,0,0,0,0,0,0,0,0
20200430,05167P,百和元富95售03,,,,,0.00,0.00,0,0,0,0,0,0,0,0,0,0,0,0,0
20200430,051680,國泰金第一95購01,,,,,0.00,0.00,0,0,0,0,0,0,0,0,0,0,0,0,0
20200430,051681,日月光兆豐95購01,,,,,0.00,0.00,0,0,0,0,0,0,0,0,0,0,0,0,0
20200430,051682,元黃金凱基97購01,,,,,0.00,0.00,0,0,0,0,0,0,0,0,0,0,0,0,0
20200430,051683,A50正2凱基97購01,,,,,0.00,0.00,0,0,0,0,0,0,0,0,0,0,0,0,0
20200430,051684,瑞昱凱基95購02,,,,,0.00,0.00,0,0,0,0,0,0,0,0,0,0,0,0,0
20200430,051685,台光電凱基95購01,0.02,0.02,0.02,0.02,+0.01,100.0,15000,1,300,0,0,0,0,0,0,15000,0,15000,15000
20200430,051686,宏達電凱基95購04,,,,,0.00,0.00,0,0,0,0,0,0,0,0,0,0,0,0,0
20200430,051687,大立光凱基95購12,,,,,0.00,0.00,0,0,0,0,0,0,0,0,0,0,0,0,0
20200430,051688,大立光凱基97購02,,,,,0.00,0.00,0,0,0,0,0,0,0,0,0,0,0,0,0
20200430,051689,智易凱基95購02,,,,,0.00,0.00,0,0,0,0,0,0,0,0,0,0,0,0,0
20200430,05168P,鴻海元大95售14,,,,,0.00,0.00,0,0,0,0,0,0,0,0,0,0,0,0,0
20200430,051690,超眾凱基95購03,,,,,0.00,0.00,0,0,0,0,0,0,0,0,0,0,0,0,0
20200430,051691,台表科凱基95購01,,,,,0.00,0.00,0,0,0,0,0,0,0,0,0,0,0,0,0
20200430,051692,深中小統一95購01,,,,,0.00,0.00,0,0,0,0,0,0,0,0,0,0,0,0,0
20200430,051693,華新科統一95購02,,,,,0.00,0.00,0,0,0,0,0,0,0,0,0,0,0,0,0
20200430,051694,A50正2中信96購03,,,,,0.00,0.00,0,0,0,0,0,0,0,0,0,0,0,0,0
20200430,051695,元金2X中信98購01,,,,,0.00,0.00,0,0,0,0,0,0,0,0,0,0,0,0,0
20200430,051696,新日興中信96購01,0.09,0.09,0.09,0.09,-0.02,-18.18,40000,4,3600,0,0,0,0,0,0,0,40000,-40000,-40000
20200430,051697,康友中信95購02,,,,,0.00,0.00,0,0,0,0,0,0,0,0,0,0,0,0,0
20200430,051698,旺宏麥證95購01,0.88,0.88,0.88,0.88,0.00,0.00,1000,1,880,1000,0,1000,0,0,0,1000,0,1000,1000
20200430,051699,世紀鋼麥證95購01,,,,,0.00,0.00,0,0,0,0,0,0,0,0,0,0,0,0,0
20200430,05169P,玉晶光元大95售03,0.05,0.05,0.05,0.05,0.00,0.00,5000,1,250,0,0,0,0,0,0,5000,0,5000,5000
20200430,051700,深中小群益99購04,,,,,0.00,0.00,0,0,0,0,0,0,0,0,0,0,0,0,0
20200430,051701,華通群益97購01,0.23,0.23,0.23,0.23,0.00,0.00,2000,1,460,0,0,0,0,0,0,2000,0,2000,2000
20200430,051702,鴻海群益95購08,,,,,0.00,0.00,0,0,0,0,0,0,0,0,0,0,0,0,0
20200430,051703,台積電群益95購04,,,,,0.00,0.00,0,0,0,0,0,0,0,0,0,0,0,0,0
20200430,051704,智邦群益95購02,2.50,2.50,2.38,2.38,-0.06,-2.46,35000,11,86900,0,0,0,0,0,0,35000,0,35000,35000
20200430,051705,富邦金群益97購01,0.06,0.08,0.06,0.08,+0.03,60.0,115000,6,8200,0,0,0,0,0,0,115000,0,115000,115000
20200430,051706,國泰金群益95購01,,,,,0.00,0.00,0,0,0,0,0,0,0,0,0,0,0,0,0
20200430,051707,欣興群益95購02,,,,,0.00,0.00,0,0,0,0,0,0,0,0,0,0,0,0,0
20200430,051708,創意群益95購02,,,,,0.00,0.00,0,0,0,0,0,0,0,0,0,0,0,0,0
20200430,051709,TPK群益95購02,,,,,0.00,0.00,0,0,0,0,0,0,0,0,0,0,0,0,0
20200430,05170P,世芯元大95售01,,,,,0.00,0.00,0,0,0,0,0,0,0,0,0,0,0,0,0
20200430,051710,和碩群益95購01,,,,,0.00,0.00,0,0,0,0,0,0,0,0,0,0,0,0,0
20200430,051711,臻鼎群益95購03,,,,,0.00,0.00,0,0,0,0,0,0,0,0,0,0,0,0,0
20200430,051712,嘉聯益群益95購01,,,,,0.00,0.00,0,0,0,0,0,0,0,0,0,0,0,0,0
20200430,051713,大立光台新95購03,,,,,0.00,0.00,0,0,0,0,0,0,0,0,0,0,0,0,0
20200430,051714,健鼎台新95購01,,,,,0.00,0.00,0,0,0,0,0,0,0,0,0,0,0,0,0
20200430,051715,和碩台新95購01,,,,,0.00,0.00,0,0,0,0,0,0,0,0,0,0,0,0,0
20200430,051716,康控康和95購01,,,,,0.00,0.00,0,0,0,0,0,0,0,0,0,0,0,0,0
20200430,051717,祥碩康和95購01,,,,,0.00,0.00,0,0,0,0,0,0,0,0,0,0,0,0,0
20200430,051718,上証2X永豐95購01,,,,,0.00,0.00,0,0,0,0,0,0,0,0,0,0,0,0,0
20200430,051719,鴻海永豐95購04,,,,,0.00,0.00,0,0,0,0,0,0,0,0,0,0,0,0,0
20200430,05171P,臺股指元大95售15,2.90,2.99,2.64,2.64,-0.58,-18.01,9000,6,25590,0,0,0,0,0,0,3000,6000,-3000,-3000
20200430,051720,燿華永豐95購06,,,,,0.00,0.00,0,0,0,0,0,0,0,0,0,0,0,0,0
20200430,051721,玉晶光永豐96購02,1.49,1.75,1.49,1.73,+0.30,20.98,312000,33,496940,0,0,0,0,0,0,170000,135000,35000,35000
20200430,051722,玉晶光永豐97購01,1.59,1.85,1.59,1.84,+0.30,19.48,666000,44,1143150,0,0,0,0,0,0,425000,193000,232000,232000
20200430,051723,嘉澤永豐95購01,,,,,0.00,0.00,0,0,0,0,0,0,0,0,0,0,0,0,0
20200430,051724,康控永豐95購03,,,,,0.00,0.00,0,0,0,0,0,0,0,0,0,0,0,0,0
20200430,051725,緯穎永豐95購02,,,,,0.00,0.00,0,0,0,0,0,0,0,0,0,0,0,0,0
20200430,051726,南茂永豐95購03,,,,,0.00,0.00,0,0,0,0,0,0,0,0,0,0,0,0,0
20200430,051727,S&P反1國票97購01,1.11,1.11,1.06,1.06,-0.16,-13.11,19000,3,20490,0,0,0,0,0,0,15000,4000,11000,11000
20200430,051728,道瓊反國票97購01,1.15,1.15,1.09,1.09,-0.15,-12.1,16000,3,18080,0,0,0,0,0,0,0,16000,-16000,-16000
20200430,051729,華新國票96購01,0.39,0.44,0.39,0.42,+0.07,20.0,112000,11,46670,0,0,0,0,0,0,69000,38000,31000,31000
20200430,05172P,臺股指元大95售16,,,,,0.00,0.00,0,0,0,0,0,0,0,0,0,0,0,0,0
20200430,051730,為升國票96購02,,,,,0.00,0.00,0,0,0,0,0,0,0,0,0,0,0,0,0
20200430,051731,聯電國票96購02,,,,,0.00,0.00,0,0,0,0,0,0,0,0,0,0,0,0,0
20200430,051732,華通國票97購01,0.05,0.05,0.05,0.05,-0.01,-16.67,100000,1,5000,0,0,0,0,0,0,0,0,0,0
20200430,051733,中環國票96購02,,,,,0.00,0.00,0,0,0,0,0,0,0,0,0,0,0,0,0
20200430,051734,台積電國票95購04,0.01,0.01,0.01,0.01,0.00,0.00,40000,2,400,0,0,0,0,0,0,0,0,0,0
20200430,051735,台積電國票96購06,,,,,0.00,0.00,0,0,0,0,0,0,0,0,0,0,0,0,0
20200430,051736,旺宏國票96購01,6.05,6.05,5.85,5.85,+0.60,11.43,12000,4,71650,0,0,0,0,0,0,12000,0,12000,12000
20200430,051737,瑞昱國票96購01,2.25,2.25,2.25,2.25,0.00,0.00,3000,1,6750,0,0,0,0,0,0,3000,0,3000,3000
20200430,051738,全新國票96購02,,,,,0.00,0.00,0,0,0,0,0,0,0,0,0,0,0,0,0
20200430,051739,奇力新國票97購01,,,,,0.00,0.00,0,0,0,0,0,0,0,0,0,0,0,0,0
20200430,05173P,臺股指元大95售17,,,,,0.00,0.00,0,0,0,0,0,0,0,0,0,0,0,0,0
20200430,051740,可成國票96購04,,,,,0.00,0.00,0,0,0,0,0,0,0,0,0,0,0,0,0
20200430,051741,可成國票97購01,,,,,0.00,0.00,0,0,0,0,0,0,0,0,0,0,0,0,0
20200430,051742,欣興國票96購01,0.02,0.02,0.02,0.02,0.00,0.00,81000,1,1620,0,0,0,0,0,0,81000,0,81000,81000
20200430,051743,揚明光國票96購02,0.71,0.71,0.69,0.69,-0.07,-9.21,80000,2,56020,0,0,0,0,0,0,80000,0,80000,80000
20200430,051744,嘉聯益國票97購01,,,,,0.00,0.00,0,0,0,0,0,0,0,0,0,0,0,0,0
20200430,051745,玉晶光國泰97購06,1.60,1.86,1.60,1.86,+0.33,21.57,586000,113,1007470,0,0,0,0,0,0,213000,361000,-148000,-148000
20200430,051746,玉晶光國泰97購07,2.01,2.01,2.01,2.01,+0.29,16.86,1000,1,2010,0,0,0,0,0,0,1000,0,1000,1000
20200430,051747,貿聯國泰96購01,0.20,0.27,0.20,0.27,+0.13,92.86,183000,33,43800,0,0,0,0,0,0,70000,113000,-43000,-43000
20200430,051748,超眾國泰96購01,1.67,1.67,1.67,1.67,-0.07,-4.02,6000,1,10020,0,0,0,0,0,0,6000,0,6000,6000
20200430,051749,矽力國泰97購01,,,,,0.00,0.00,0,0,0,0,0,0,0,0,0,0,0,0,0
20200430,05174P,元金2X富邦9B售01,1.04,1.04,1.04,1.04,0.00,0.00,6000,1,6240,0,0,0,0,0,0,6000,0,6000,6000
20200430,051750,華通富邦96購01,,,,,0.00,0.00,0,0,0,0,0,0,0,0,0,0,0,0,0
20200430,051751,聯茂富邦95購01,,,,,0.00,0.00,0,0,0,0,0,0,0,0,0,0,0,0,0
20200430,051752,緯穎富邦96購01,1.02,1.28,1.02,1.27,0.00,0.00,20000,3,22950,0,0,0,0,0,0,20000,0,20000,20000
20200430,051753,華通元大96購03,,,,,0.00,0.00,0,0,0,0,0,0,0,0,0,0,0,0,0
20200430,051754,廣宇元大95購01,,,,,0.00,0.00,0,0,0,0,0,0,0,0,0,0,0,0,0
20200430,051755,台積電元大96購08,0.77,0.77,0.77,0.77,0.00,0.00,10000,1,7700,0,0,0,0,0,0,10000,0,10000,10000
20200430,051756,台積電元大97購04,,,,,0.00,0.00,0,0,0,0,0,0,0,0,0,0,0,0,0
20200430,051757,佳世達元大95購02,,,,,0.00,0.00,0,0,0,0,0,0,0,0,0,0,0,0,0
20200430,051758,瑞昱元大95購01,0.72,1.14,0.72,1.08,+0.48,80.0,80000,6,71700,0,0,0,0,0,0,50000,30000,20000,20000
20200430,051759,全新元大95購04,,,,,0.00,0.00,0,0,0,0,0,0,0,0,0,0,0,0,0
20200430,05175P,TPK富邦99售01,,,,,0.00,0.00,0,0,0,0,0,0,0,0,0,0,0,0,0
20200430,051760,奇力新元大95購04,,,,,0.00,0.00,0,0,0,0,0,0,0,0,0,0,0,0,0
20200430,051761,富邦金元大96購01,,,,,0.00,0.00,0,0,0,0,0,0,0,0,0,0,0,0,0
20200430,051762,國泰金元大95購01,0.02,0.03,0.02,0.03,0.00,0.00,215000,2,6430,0,0,0,0,0,0,215000,0,215000,215000
20200430,051763,新光金元大98購01,,,,,0.00,0.00,0,0,0,0,0,0,0,0,0,0,0,0,0
20200430,051764,欣興元大95購07,,,,,0.00,0.00,0,0,0,0,0,0,0,0,0,0,0,0,0
20200430,051765,健鼎元大95購03,,,,,0.00,0.00,0,0,0,0,0,0,0,0,0,0,0,0,0
20200430,051766,泰鼎元大95購02,,,,,0.00,0.00,0,0,0,0,0,0,0,0,0,0,0,0,0
20200430,051767,臻鼎元大95購03,,,,,0.00,0.00,0,0,0,0,0,0,0,0,0,0,0,0,0
20200430,051768,臻鼎元大95購04,,,,,0.00,0.00,0,0,0,0,0,0,0,0,0,0,0,0,0
20200430,051769,矽力元大95購01,,,,,0.00,0.00,0,0,0,0,0,0,0,0,0,0,0,0,0
20200430,05176P,台積電凱基95售11,,,,,0.00,0.00,0,0,0,0,0,0,0,0,0,0,0,0,0
20200430,051770,南茂元大95購02,,,,,0.00,0.00,0,0,0,0,0,0,0,0,0,0,0,0,0
20200430,051771,上銀中信95購01,0.14,0.24,0.14,0.24,+0.21,700.0,410000,4,85400,0,0,0,0,0,0,310000,100000,210000,210000
20200430,051772,玉山金中信95購01,0.03,0.03,0.03,0.03,0.00,0.00,1000,1,30,0,0,0,0,0,0,1000,0,1000,1000
20200430,051773,元大金中信95購02,,,,,0.00,0.00,0,0,0,0,0,0,0,0,0,0,0,0,0
20200430,051774,聯茂中信96購01,0.61,0.61,0.58,0.58,-0.01,-1.69,141000,24,83980,0,0,0,0,0,0,110000,31000,79000,79000
20200430,051775,旺宏亞東95購01,0.57,0.61,0.57,0.61,0.00,0.00,10000,2,5900,0,0,0,0,0,0,10000,0,10000,10000
20200430,051776,上証2X群益99購01,0.44,0.44,0.44,0.44,0.00,0.00,10000,1,4400,0,0,0,0,0,0,10000,0,10000,10000
20200430,051777,聯發科群益95購04,,,,,0.00,0.00,0,0,0,0,0,0,0,0,0,0,0,0,0
20200430,051778,全新群益95購01,,,,,0.00,0.00,0,0,0,0,0,0,0,0,0,0,0,0,0
20200430,051779,大立光群益95購02,,,,,0.00,0.00,0,0,0,0,0,0,0,0,0,0,0,0,0
20200430,05177P,台積電凱基95售12,,,,,0.00,0.00,0,0,0,0,0,0,0,0,0,0,0,0,0
20200430,051780,矽力群益95購01,,,,,0.00,0.00,0,0,0,0,0,0,0,0,0,0,0,0,0
20200430,051781,緯穎群益96購01,4.85,4.99,4.85,4.99,+0.46,10.15,5000,2,24670,0,0,0,0,0,0,5000,0,5000,5000
20200430,051782,昇陽半群益95購01,,,,,0.00,0.00,0,0,0,0,0,0,0,0,0,0,0,0,0
20200430,051783,鴻海兆豐95購03,,,,,0.00,0.00,0,0,0,0,0,0,0,0,0,0,0,0,0
20200430,051784,國巨兆豐95購01,,,,,0.00,0.00,0,0,0,0,0,0,0,0,0,0,0,0,0
20200430,051785,臻鼎兆豐96購01,,,,,0.00,0.00,0,0,0,0,0,0,0,0,0,0,0,0,0
20200430,051786,A50正2國票95購02,,,,,0.00,0.00,0,0,0,0,0,0,0,0,0,0,0,0,0
20200430,051787,燿華國票96購02,,,,,0.00,0.00,0,0,0,0,0,0,0,0,0,0,0,0,0
20200430,051788,奇力新國票97購02,0.99,0.99,0.99,0.99,0.00,0.00,10000,1,9900,0,0,0,0,0,0,10000,0,10000,10000
20200430,051789,嘉澤國票96購01,3.32,3.74,3.32,3.74,+0.94,33.57,19000,3,66480,0,0,0,0,0,0,2000,17000,-15000,-15000
20200430,05178P,大立光凱基96售05,2.17,2.17,2.17,2.17,0.00,0.00,10000,1,21700,0,0,0,0,0,0,10000,0,10000,10000
20200430,051790,貿聯國票95購03,0.20,0.20,0.20,0.20,0.00,0.00,40000,2,8000,0,0,0,0,0,0,0,40000,-40000,-40000
20200430,051791,智伸科國票96購01,0.22,0.22,0.21,0.21,0.00,0.00,96000,2,20640,0,0,0,0,0,0,0,96000,-96000,-96000
20200430,051792,泰鼎國票96購02,,,,,0.00,0.00,0,0,0,0,0,0,0,0,0,0,0,0,0
20200430,051793,臻鼎國票95購02,,,,,0.00,0.00,0,0,0,0,0,0,0,0,0,0,0,0,0
20200430,051794,臻鼎國票96購02,0.01,0.01,0.01,0.01,0.00,0.00,300000,3,3000,0,0,0,0,0,0,0,0,0,0
20200430,051795,T50反1台新05購02,0.50,0.50,0.50,0.50,-0.16,-24.24,10000,2,5000,0,0,0,0,0,0,1000,10000,-9000,-9000
20200430,051796,和碩康和95購01,,,,,0.00,0.00,0,0,0,0,0,0,0,0,0,0,0,0,0
20200430,051797,卜蜂永豐95購01,,,,,0.00,0.00,0,0,0,0,0,0,0,0,0,0,0,0,0
20200430,051798,國巨永豐95購03,1.04,1.04,1.04,1.04,+0.16,18.18,1000,1,1040,0,0,0,0,0,0,0,0,0,0
20200430,051799,台積電永豐96購01,0.77,1.20,0.77,1.20,0.00,0.00,338000,15,371120,0,0,0,0,0,0,338000,210000,128000,128000
20200430,05179P,大立光凱基96售06,,,,,0.00,0.00,0,0,0,0,0,0,0,0,0,0,0,0,0
20200430,051800,旺宏永豐95購02,,,,,0.00,0.00,0,0,0,0,0,0,0,0,0,0,0,0,0
20200430,051801,牧德永豐95購04,0.25,0.25,0.23,0.23,0.00,0.00,35000,2,8450,0,0,0,0,0,0,20000,15000,5000,5000
20200430,051802,同欣電永豐95購02,,,,,0.00,0.00,0,0,0,0,0,0,0,0,0,0,0,0,0
20200430,051803,矽創永豐95購03,,,,,0.00,0.00,0,0,0,0,0,0,0,0,0,0,0,0,0
20200430,051804,新光金日盛95購01,,,,,0.00,0.00,0,0,0,0,0,0,0,0,0,0,0,0,0
20200430,051805,元黃金凱基97購02,,,,,0.00,0.00,0,0,0,0,0,0,0,0,0,0,0,0,0
20200430,051806,華通凱基96購02,,,,,0.00,0.00,0,0,0,0,0,0,0,0,0,0,0,0,0
20200430,051807,瑞昱凱基95購03,,,,,0.00,0.00,0,0,0,0,0,0,0,0,0,0,0,0,0
20200430,051808,美律凱基96購02,0.38,0.43,0.38,0.43,+0.05,13.16,23000,2,9740,0,0,0,0,0,0,3000,20000,-17000,-17000
20200430,051809,義隆凱基96購01,0.43,0.51,0.43,0.51,+0.06,13.33,62000,17,27800,0,0,0,0,0,0,62000,0,62000,62000
20200430,05180P,玉晶光凱基95售04,0.03,0.03,0.03,0.03,0.00,0.00,200000,3,6000,0,0,0,0,0,0,200000,0,200000,200000
20200430,051810,欣興凱基95購03,,,,,0.00,0.00,0,0,0,0,0,0,0,0,0,0,0,0,0
20200430,051811,致伸凱基95購03,,,,,0.00,0.00,0,0,0,0,0,0,0,0,0,0,0,0,0
20200430,051812,臻鼎凱基95購03,,,,,0.00,0.00,0,0,0,0,0,0,0,0,0,0,0,0,0
20200430,051813,GIS凱基96購02,,,,,0.00,0.00,0,0,0,0,0,0,0,0,0,0,0,0,0
20200430,051814,鈺齊凱基95購01,,,,,0.00,0.00,0,0,0,0,0,0,0,0,0,0,0,0,0
20200430,051815,百和凱基96購01,,,,,0.00,0.00,0,0,0,0,0,0,0,0,0,0,0,0,0
20200430,051816,臺股指凱基95購07,0.29,0.29,0.29,0.29,0.00,0.00,116000,1,33640,0,0,0,0,0,0,116000,0,116000,116000
20200430,051817,元金2X統一95購01,,,,,0.00,0.00,0,0,0,0,0,0,0,0,0,0,0,0,0
20200430,051818,國巨統一95購02,3.30,3.30,3.24,3.24,+0.28,9.46,4000,2,13080,0,0,0,0,0,0,4000,0,4000,4000
20200430,051819,燿華統一96購01,,,,,0.00,0.00,0,0,0,0,0,0,0,0,0,0,0,0,0
20200430,05181P,健策凱基95售01,,,,,0.00,0.00,0,0,0,0,0,0,0,0,0,0,0,0,0
20200430,051820,道瓊反元富95購01,,,,,0.00,0.00,0,0,0,0,0,0,0,0,0,0,0,0,0
20200430,051821,京元電元富95購04,,,,,0.00,0.00,0,0,0,0,0,0,0,0,0,0,0,0,0
20200430,051822,和碩元富95購01,,,,,0.00,0.00,0,0,0,0,0,0,0,0,0,0,0,0,0
20200430,051823,矽力元富95購02,,,,,0.00,0.00,0,0,0,0,0,0,0,0,0,0,0,0,0
20200430,051824,華通元大95購07,,,,,0.00,0.00,0,0,0,0,0,0,0,0,0,0,0,0,0
20200430,051825,中環元大95購01,0.01,0.02,0.01,0.02,0.00,0.00,579000,4,5890,0,0,0,0,0,0,569000,0,569000,569000
20200430,051826,智邦元大95購03,,,,,0.00,0.00,0,0,0,0,0,0,0,0,0,0,0,0,0
20200430,051827,智邦元大95購04,,,,,0.00,0.00,0,0,0,0,0,0,0,0,0,0,0,0,0
20200430,051828,微星元大95購03,,,,,0.00,0.00,0,0,0,0,0,0,0,0,0,0,0,0,0
20200430,051829,玉晶光元大98購02,1.34,1.46,1.34,1.46,0.00,0.00,2000,2,2800,0,0,0,0,0,0,2000,0,2000,2000
20200430,05182P,嘉晶統一95售03,,,,,0.00,0.00,0,0,0,0,0,0,0,0,0,0,0,0,0
20200430,051830,健策元大97購01,,,,,0.00,0.00,0,0,0,0,0,0,0,0,0,0,0,0,0
20200430,051831,緯穎元大96購04,,,,,0.00,0.00,0,0,0,0,0,0,0,0,0,0,0,0,0
20200430,051832,復盛元大95購01,0.25,0.26,0.25,0.26,0.00,0.00,80000,4,20400,0,0,0,0,0,0,0,80000,-80000,-80000
20200430,051833,昇陽半元大96購01,,,,,0.00,0.00,0,0,0,0,0,0,0,0,0,0,0,0,0
20200430,051834,南電元大96購02,,,,,0.00,0.00,0,0,0,0,0,0,0,0,0,0,0,0,0
20200430,051835,百和元大95購03,0.02,0.02,0.02,0.02,0.00,0.00,25000,1,500,0,0,0,0,0,0,25000,0,25000,25000
20200430,051836,華通國泰95購02,,,,,0.00,0.00,0,0,0,0,0,0,0,0,0,0,0,0,0
20200430,051837,國巨國泰96購04,,,,,0.00,0.00,0,0,0,0,0,0,0,0,0,0,0,0,0
20200430,051838,國巨國泰97購01,,,,,0.00,0.00,0,0,0,0,0,0,0,0,0,0,0,0,0
20200430,051839,和鑫國泰96購01,,,,,0.00,0.00,0,0,0,0,0,0,0,0,0,0,0,0,0
20200430,05183P,台積電元富95售07,,,,,0.00,0.00,0,0,0,0,0,0,0,0,0,0,0,0,0
20200430,051840,康友國泰97購02,0.33,0.37,0.33,0.37,0.00,0.00,2000,2,700,0,0,0,0,0,0,1000,1000,0,0
20200430,051841,南茂國泰96購01,,,,,0.00,0.00,0,0,0,0,0,0,0,0,0,0,0,0,0
20200430,051842,大成鋼富邦97購01,0.10,0.10,0.10,0.10,0.00,0.00,10000,1,1000,0,0,0,0,0,0,0,10000,-10000,-10000
20200430,051843,聯發科富邦99購01,0.62,0.70,0.61,0.69,+0.17,32.69,34000,6,22210,0,0,0,0,0,0,32000,0,32000,32000
20200430,051844,宏達電富邦96購01,0.04,0.04,0.04,0.04,0.00,0.00,20000,1,800,0,0,0,0,0,0,20000,0,20000,20000
20200430,051845,世紀鋼富邦96購01,0.42,0.47,0.42,0.47,0.00,0.00,201000,3,94420,0,0,0,0,0,0,1000,200000,-199000,-199000
20200430,051846,S&P反1中信96購02,,,,,0.00,0.00,0,0,0,0,0,0,0,0,0,0,0,0,0
20200430,051847,香港反中信99購01,0.55,0.55,0.53,0.53,0.00,0.00,20000,2,10800,0,0,0,0,0,0,0,20000,-20000,-20000
20200430,051848,元金2X中信98購02,,,,,0.00,0.00,0,0,0,0,0,0,0,0,0,0,0,0,0
20200430,051849,旺宏中信98購01,0.97,0.97,0.92,0.95,+0.11,13.1,125000,17,119540,0,0,0,0,0,0,102000,88000,14000,14000
20200430,05184P,緯穎元富95售01,,,,,0.00,0.00,0,0,0,0,0,0,0,0,0,0,0,0,0
20200430,051850,臻鼎中信96購01,0.02,0.02,0.02,0.02,0.00,0.00,200000,1,4000,0,0,0,0,0,0,200000,0,200000,200000
20200430,051851,TPK群益95購03,,,,,0.00,0.00,0,0,0,0,0,0,0,0,0,0,0,0,0
20200430,051852,啟碁群益95購01,,,,,0.00,0.00,0,0,0,0,0,0,0,0,0,0,0,0,0
20200430,051853,京元電亞東95購01,,,,,0.00,0.00,0,0,0,0,0,0,0,0,0,0,0,0,0
20200430,051854,鴻海麥證95購04,,,,,0.00,0.00,0,0,0,0,0,0,0,0,0,0,0,0,0
20200430,051855,道瓊反凱基97購01,,,,,0.00,0.00,0,0,0,0,0,0,0,0,0,0,0,0,0
20200430,051856,亞德客凱基95購01,,,,,0.00,0.00,0,0,0,0,0,0,0,0,0,0,0,0,0
20200430,051857,喬山凱基95購01,,,,,0.00,0.00,0,0,0,0,0,0,0,0,0,0,0,0,0
20200430,051858,上銀凱基95購01,,,,,0.00,0.00,0,0,0,0,0,0,0,0,0,0,0,0,0
20200430,051859,劍麟凱基96購01,,,,,0.00,0.00,0,0,0,0,0,0,0,0,0,0,0,0,0
20200430,05185P,鴻海中信95售04,,,,,0.00,0.00,0,0,0,0,0,0,0,0,0,0,0,0,0
20200430,051860,為升凱基95購01,,,,,0.00,0.00,0,0,0,0,0,0,0,0,0,0,0,0,0
20200430,051861,鴻海凱基98購01,,,,,0.00,0.00,0,0,0,0,0,0,0,0,0,0,0,0,0
20200430,051862,旺宏凱基95購05,,,,,0.00,0.00,0,0,0,0,0,0,0,0,0,0,0,0,0
20200430,051863,技嘉凱基95購01,,,,,0.00,0.00,0,0,0,0,0,0,0,0,0,0,0,0,0
20200430,051864,聯發科凱基96購03,0.23,0.25,0.23,0.25,0.00,0.00,30000,2,7300,0,0,0,0,0,0,30000,0,30000,30000
20200430,051865,聯發科凱基96購04,0.53,0.59,0.53,0.59,0.00,0.00,10000,2,5600,0,0,0,0,0,0,10000,0,10000,10000
20200430,051866,聯發科凱基96購05,0.02,0.07,0.02,0.07,0.00,0.00,456000,2,9170,0,0,0,0,0,0,455000,0,455000,455000
20200430,051867,潤泰全凱基95購01,,,,,0.00,0.00,0,0,0,0,0,0,0,0,0,0,0,0,0
20200430,051868,貿聯凱基96購01,,,,,0.00,0.00,0,0,0,0,0,0,0,0,0,0,0,0,0
20200430,051869,康控凱基96購01,0.12,0.12,0.12,0.12,0.00,0.00,100000,1,12000,0,0,0,0,0,0,0,100000,-100000,-100000
20200430,05186P,鈺齊中信95售02,,,,,0.00,0.00,0,0,0,0,0,0,0,0,0,0,0,0,0
20200430,051870,台郡凱基95購04,,,,,0.00,0.00,0,0,0,0,0,0,0,0,0,0,0,0,0
20200430,051871,同欣電凱基95購02,,,,,0.00,0.00,0,0,0,0,0,0,0,0,0,0,0,0,0
20200430,051872,矽力凱基96購01,,,,,0.00,0.00,0,0,0,0,0,0,0,0,0,0,0,0,0
20200430,051873,緯穎凱基95購02,2.01,2.01,2.01,2.01,+0.19,10.44,5000,1,10050,0,0,0,0,0,0,5000,0,5000,5000
20200430,051874,志超凱基95購01,,,,,0.00,0.00,0,0,0,0,0,0,0,0,0,0,0,0,0
20200430,051875,聯發科兆豐95購04,0.27,0.27,0.27,0.27,0.00,0.00,4000,1,1080,0,0,0,0,0,0,4000,0,4000,4000
20200430,051876,宏達電國票96購01,,,,,0.00,0.00,0,0,0,0,0,0,0,0,0,0,0,0,0
20200430,051877,嘉聯益國票97購02,,,,,0.00,0.00,0,0,0,0,0,0,0,0,0,0,0,0,0
20200430,051878,鴻海台新96購01,,,,,0.00,0.00,0,0,0,0,0,0,0,0,0,0,0,0,0
20200430,051879,健策台新96購01,1.47,1.62,1.47,1.62,0.00,0.00,18000,2,27960,0,0,0,0,0,0,10000,18000,-8000,-8000
20200430,05187P,力山凱基95售01,,,,,0.00,0.00,0,0,0,0,0,0,0,0,0,0,0,0,0
20200430,051880,健策康和95購01,,,,,0.00,0.00,0,0,0,0,0,0,0,0,0,0,0,0,0
20200430,051881,上証2X永豐95購02,,,,,0.00,0.00,0,0,0,0,0,0,0,0,0,0,0,0,0
20200430,051882,潤泰全永豐95購01,,,,,0.00,0.00,0,0,0,0,0,0,0,0,0,0,0,0,0
20200430,051883,智原永豐95購03,,,,,0.00,0.00,0,0,0,0,0,0,0,0,0,0,0,0,0
20200430,051884,樺漢永豐95購01,,,,,0.00,0.00,0,0,0,0,0,0,0,0,0,0,0,0,0
20200430,051885,易華電永豐95購02,,,,,0.00,0.00,0,0,0,0,0,0,0,0,0,0,0,0,0
20200430,051886,道瓊反統一95購03,,,,,0.00,0.00,0,0,0,0,0,0,0,0,0,0,0,0,0
20200430,051887,上証2X元富98購01,,,,,0.00,0.00,0,0,0,0,0,0,0,0,0,0,0,0,0
20200430,051888,國巨元富95購05,0.25,0.30,0.25,0.30,+0.07,30.43,20000,2,5500,0,0,0,0,0,0,10000,0,10000,10000
20200430,051889,智邦元富95購02,2.49,2.49,2.49,2.49,-0.22,-8.12,10000,1,24900,0,0,0,0,0,0,10000,0,10000,10000
20200430,05188P,可成凱基95售09,,,,,0.00,0.00,0,0,0,0,0,0,0,0,0,0,0,0,0
20200430,051890,智邦元富95購03,,,,,0.00,0.00,0,0,0,0,0,0,0,0,0,0,0,0,0
20200430,051891,智邦元富95購04,1.44,1.57,1.15,1.15,-0.52,-31.14,369000,20,524780,0,0,0,0,0,0,224000,10000,214000,214000
20200430,051892,台光電元富95購03,,,,,0.00,0.00,0,0,0,0,0,0,0,0,0,0,0,0,0
20200430,051893,瀚宇博元富95購01,,,,,0.00,0.00,0,0,0,0,0,0,0,0,0,0,0,0,0
20200430,051894,嘉聯益元富95購03,,,,,0.00,0.00,0,0,0,0,0,0,0,0,0,0,0,0,0
20200430,051895,聯茂元富95購02,,,,,0.00,0.00,0,0,0,0,0,0,0,0,0,0,0,0,0
20200430,051896,柏文元富95購01,,,,,0.00,0.00,0,0,0,0,0,0,0,0,0,0,0,0,0
20200430,051897,台光電國泰97購01,1.03,1.03,1.03,1.03,0.00,0.00,60000,1,61800,0,0,0,0,0,0,0,60000,-60000,-60000
20200430,051898,富邦金國泰97購01,0.98,1.09,0.95,1.09,+0.15,15.96,205000,17,205110,0,0,0,0,0,0,205000,0,205000,205000
20200430,051899,欣興國泰97購01,0.45,0.45,0.45,0.45,-0.02,-4.26,321000,1,144450,0,0,0,0,0,0,321000,321000,0,0
20200430,05189P,新光金凱基97售02,,,,,0.00,0.00,0,0,0,0,0,0,0,0,0,0,0,0,0
20200430,051900,臻鼎富邦95購01,,,,,0.00,0.00,0,0,0,0,0,0,0,0,0,0,0,0,0
20200430,051901,嘉聯益富邦96購01,,,,,0.00,0.00,0,0,0,0,0,0,0,0,0,0,0,0,0
20200430,051902,T50反1元大97購01,1.24,1.25,1.17,1.18,-0.13,-9.92,142000,9,172020,0,0,0,0,0,0,72000,70000,2000,2000
20200430,051903,T50反1元大97購02,1.19,1.20,1.13,1.13,-0.16,-12.4,86000,9,101540,0,0,0,0,0,0,0,86000,-86000,-86000
20200430,051904,深100元大95購01,0.22,0.23,0.22,0.23,0.00,0.00,2000,2,450,0,0,0,0,0,0,0,2000,-2000,-2000
20200430,051905,道瓊銀元大95購01,,,,,0.00,0.00,0,0,0,0,0,0,0,0,0,0,0,0,0
20200430,051906,國巨元大95購09,2.63,2.67,2.43,2.43,-0.06,-2.41,25000,6,63430,0,0,0,0,0,0,25000,5000,20000,20000
20200430,051907,台積電元大97購05,0.96,1.01,0.93,1.01,+0.18,21.69,175000,18,167650,0,0,0,0,0,0,0,130000,-130000,-130000
20200430,051908,國泰金元大96購02,,,,,0.00,0.00,0,0,0,0,0,0,0,0,0,0,0,0,0
20200430,051909,潤泰全元大95購02,,,,,0.00,0.00,0,0,0,0,0,0,0,0,0,0,0,0,0
20200430,05190P,鴻海國票96售02,,,,,0.00,0.00,0,0,0,0,0,0,0,0,0,0,0,0,0
20200430,051910,大立光元大97購01,,,,,0.00,0.00,0,0,0,0,0,0,0,0,0,0,0,0,0
20200430,051911,大立光元大98購02,0.48,0.57,0.48,0.55,+0.11,25.0,207000,27,109580,0,0,0,0,0,0,138000,0,138000,138000
20200430,051912,健鼎元大96購01,,,,,0.00,0.00,0,0,0,0,0,0,0,0,0,0,0,0,0
20200430,051913,緯創元大96購01,,,,,0.00,0.00,0,0,0,0,0,0,0,0,0,0,0,0,0
20200430,051914,健策元大96購06,,,,,0.00,0.00,0,0,0,0,0,0,0,0,0,0,0,0,0
20200430,051915,日月光元大96購01,,,,,0.00,0.00,0,0,0,0,0,0,0,0,0,0,0,0,0
20200430,051916,和碩元大95購02,0.12,0.12,0.12,0.12,0.00,0.00,90000,1,10800,0,0,0,0,0,0,90000,0,90000,90000
20200430,051917,瑞儀元大95購01,,,,,0.00,0.00,0,0,0,0,0,0,0,0,0,0,0,0,0
20200430,051918,聯茂元大95購01,0.92,0.92,0.88,0.88,-0.03,-3.3,103000,5,92760,0,0,0,0,0,0,53000,70000,-17000,-17000
20200430,051919,台郡元大96購02,,,,,0.00,0.00,0,0,0,0,0,0,0,0,0,0,0,0,0
20200430,05191P,鴻海台新95售01,1.11,1.11,1.11,1.11,0.00,0.00,200000,1,222000,0,0,0,0,0,0,200000,200000,0,0
20200430,051920,南茂元大95購03,,,,,0.00,0.00,0,0,0,0,0,0,0,0,0,0,0,0,0
20200430,051921,南茂元大95購04,,,,,0.00,0.00,0,0,0,0,0,0,0,0,0,0,0,0,0
20200430,051922,鴻海亞東96購02,,,,,0.00,0.00,0,0,0,0,0,0,0,0,0,0,0,0,0
20200430,051923,聯發科日盛95購02,0.01,0.01,0.01,0.01,0.00,0.00,10000,1,100,0,0,0,0,0,0,10000,0,10000,10000
20200430,051924,聯茂日盛95購01,0.30,0.30,0.28,0.28,-0.05,-15.15,300000,16,87530,0,0,0,0,0,0,300000,0,300000,300000
20200430,051925,瀚宇博第一95購01,,,,,0.00,0.00,0,0,0,0,0,0,0,0,0,0,0,0,0
20200430,051926,聯電中信97購01,0.39,0.39,0.39,0.39,-0.01,-2.5,12000,1,4680,0,0,0,0,0,0,12000,0,12000,12000
20200430,051927,國巨中信96購01,,,,,0.00,0.00,0,0,0,0,0,0,0,0,0,0,0,0,0
20200430,051928,大立光中信96購03,0.03,0.09,0.03,0.09,+0.03,50.0,31000,4,1290,0,0,0,0,0,0,0,21000,-21000,-21000
20200430,051929,GIS中信96購01,,,,,0.00,0.00,0,0,0,0,0,0,0,0,0,0,0,0,0
20200430,05192P,玉晶光台新96售02,0.32,0.32,0.04,0.04,0.00,0.00,147000,6,37000,0,0,0,0,0,0,115000,10000,105000,105000
20200430,051930,國泰金兆豐97購01,0.15,0.16,0.15,0.16,+0.06,60.0,110000,2,16600,0,0,0,0,0,0,110000,0,110000,110000
20200430,051931,美律國票96購02,0.75,0.75,0.75,0.75,0.00,0.00,10000,1,7500,0,0,0,0,0,0,0,10000,-10000,-10000
20200430,051932,康控國票96購02,0.03,0.04,0.03,0.04,0.00,0.00,140000,3,4800,0,0,0,0,0,0,140000,0,140000,140000
20200430,051933,嘉聯益國票97購03,0.05,0.05,0.05,0.05,0.00,0.00,100000,1,5000,0,0,0,0,0,0,100000,0,100000,100000
20200430,051934,緯穎國票96購01,8.95,10.90,8.95,10.90,0.00,0.00,41000,5,376900,0,0,0,0,0,0,0,41000,-41000,-41000
20200430,051935,味全群益95購01,,,,,0.00,0.00,0,0,0,0,0,0,0,0,0,0,0,0,0
20200430,051936,力山群益95購02,,,,,0.00,0.00,0,0,0,0,0,0,0,0,0,0,0,0,0
20200430,051937,廣達群益95購01,,,,,0.00,0.00,0,0,0,0,0,0,0,0,0,0,0,0,0
20200430,051938,旭富群益95購01,,,,,0.00,0.00,0,0,0,0,0,0,0,0,0,0,0,0,0
20200430,051939,同欣電群益97購01,,,,,0.00,0.00,0,0,0,0,0,0,0,0,0,0,0,0,0
20200430,05193P,台郡台新95售01,,,,,0.00,0.00,0,0,0,0,0,0,0,0,0,0,0,0,0
20200430,051940,康舒群益95購01,,,,,0.00,0.00,0,0,0,0,0,0,0,0,0,0,0,0,0
20200430,051941,樺漢群益95購02,,,,,0.00,0.00,0,0,0,0,0,0,0,0,0,0,0,0,0
20200430,051942,寶成群益95購01,,,,,0.00,0.00,0,0,0,0,0,0,0,0,0,0,0,0,0
20200430,051943,台積電麥證95購03,,,,,0.00,0.00,0,0,0,0,0,0,0,0,0,0,0,0,0
20200430,051944,智邦統一95購02,3.58,3.82,3.13,3.13,-0.34,-9.8,76000,5,286270,0,0,0,0,0,0,75000,1000,74000,74000
20200430,051945,智邦統一95購03,2.60,2.60,2.60,2.60,+0.22,9.24,5000,1,13000,0,0,0,0,0,0,5000,5000,0,0
20200430,051946,健策統一98購01,0.53,0.53,0.53,0.53,0.00,0.00,5000,1,2650,0,0,0,0,0,0,5000,0,5000,5000
20200430,051947,矽力統一95購01,0.39,0.39,0.39,0.39,0.00,0.00,50000,1,19500,0,0,0,0,0,0,50000,0,50000,50000
20200430,051948,滬深2X元富9B購01,0.38,0.42,0.38,0.42,+0.05,13.51,2000,2,800,0,0,0,0,0,0,2000,0,2000,2000
20200430,051949,鴻海元富95購08,,,,,0.00,0.00,0,0,0,0,0,0,0,0,0,0,0,0,0
20200430,05194P,玉晶光康和95售01,,,,,0.00,0.00,0,0,0,0,0,0,0,0,0,0,0,0,0
20200430,051950,旺宏元富95購02,,,,,0.00,0.00,0,0,0,0,0,0,0,0,0,0,0,0,0
20200430,051951,聯發科元富95購02,0.15,0.17,0.14,0.16,+0.08,100.0,380000,20,57300,0,0,0,0,0,0,380000,0,380000,380000
20200430,051952,聯發科元富95購03,,,,,0.00,0.00,0,0,0,0,0,0,0,0,0,0,0,0,0
20200430,051953,矽力元富95購03,,,,,0.00,0.00,0,0,0,0,0,0,0,0,0,0,0,0,0
20200430,051954,矽力元富95購04,,,,,0.00,0.00,0,0,0,0,0,0,0,0,0,0,0,0,0
20200430,051955,寶成元富95購01,,,,,0.00,0.00,0,0,0,0,0,0,0,0,0,0,0,0,0
20200430,051956,滬深2X台新96購01,,,,,0.00,0.00,0,0,0,0,0,0,0,0,0,0,0,0,0
20200430,051957,旺宏台新95購02,2.27,2.27,2.27,2.27,+0.56,32.75,3000,2,6810,0,0,0,0,0,0,3000,0,3000,3000
20200430,051958,貿聯台新95購01,,,,,0.00,0.00,0,0,0,0,0,0,0,0,0,0,0,0,0
20200430,051959,台郡台新95購03,,,,,0.00,0.00,0,0,0,0,0,0,0,0,0,0,0,0,0
20200430,05195P,南茂康和95售01,,,,,0.00,0.00,0,0,0,0,0,0,0,0,0,0,0,0,0
20200430,051960,美食永豐95購01,,,,,0.00,0.00,0,0,0,0,0,0,0,0,0,0,0,0,0
20200430,051961,泰碩永豐95購01,0.10,0.10,0.10,0.10,0.00,0.00,22000,2,2200,0,0,0,0,0,0,0,22000,-22000,-22000
20200430,051962,晶相光永豐95購02,,,,,0.00,0.00,0,0,0,0,0,0,0,0,0,0,0,0,0
20200430,051963,利勤永豐95購01,,,,,0.00,0.00,0,0,0,0,0,0,0,0,0,0,0,0,0
20200430,051965,傳奇永豐95購01,,,,,0.00,0.00,0,0,0,0,0,0,0,0,0,0,0,0,0
20200430,051966,台表科永豐95購01,,,,,0.00,0.00,0,0,0,0,0,0,0,0,0,0,0,0,0
20200430,051967,康友永豐95購02,,,,,0.00,0.00,0,0,0,0,0,0,0,0,0,0,0,0,0
20200430,051968,勤誠永豐95購01,,,,,0.00,0.00,0,0,0,0,0,0,0,0,0,0,0,0,0
20200430,051969,世紀鋼永豐95購01,,,,,0.00,0.00,0,0,0,0,0,0,0,0,0,0,0,0,0
20200430,05196P,台積電永豐95售03,,,,,0.00,0.00,0,0,0,0,0,0,0,0,0,0,0,0,0
20200430,051970,元黃金凱基98購01,,,,,0.00,0.00,0,0,0,0,0,0,0,0,0,0,0,0,0
20200430,051971,元金2X凱基97購02,1.50,1.50,1.05,1.39,-0.06,-4.14,62000,10,75550,0,0,0,0,0,0,0,0,0,0
20200430,051972,廣達凱基95購02,,,,,0.00,0.00,0,0,0,0,0,0,0,0,0,0,0,0,0
20200430,051973,華新科凱基96購04,,,,,0.00,0.00,0,0,0,0,0,0,0,0,0,0,0,0,0
20200430,051974,華新科凱基96購05,,,,,0.00,0.00,0,0,0,0,0,0,0,0,0,0,0,0,0
20200430,051975,美食凱基95購02,,,,,0.00,0.00,0,0,0,0,0,0,0,0,0,0,0,0,0
20200430,051976,淘帝凱基95購01,,,,,0.00,0.00,0,0,0,0,0,0,0,0,0,0,0,0,0
20200430,051977,泰碩凱基95購01,,,,,0.00,0.00,0,0,0,0,0,0,0,0,0,0,0,0,0
20200430,051978,泰碩凱基96購01,,,,,0.00,0.00,0,0,0,0,0,0,0,0,0,0,0,0,0
20200430,051979,群創凱基97購01,0.63,0.63,0.63,0.63,+0.04,6.78,53000,1,33390,0,0,0,0,0,0,0,53000,-53000,-53000
20200430,05197P,智原永豐95售02,,,,,0.00,0.00,0,0,0,0,0,0,0,0,0,0,0,0,0
20200430,051980,樺漢凱基96購01,,,,,0.00,0.00,0,0,0,0,0,0,0,0,0,0,0,0,0
20200430,051981,南茂凱基96購01,,,,,0.00,0.00,0,0,0,0,0,0,0,0,0,0,0,0,0
20200430,051982,深中小元大95購01,1.10,1.10,1.10,1.10,0.00,0.00,6000,1,6600,0,0,0,0,0,0,6000,0,6000,6000
20200430,051983,道瓊反元大95購01,,,,,0.00,0.00,0,0,0,0,0,0,0,0,0,0,0,0,0
20200430,051984,台塑元大95購01,,,,,0.00,0.00,0,0,0,0,0,0,0,0,0,0,0,0,0
20200430,051985,智邦元大95購05,2.22,2.22,2.22,2.22,-0.41,-15.59,50000,1,111000,0,0,0,0,0,0,0,50000,-50000,-50000
20200430,051986,燿華元大96購04,0.08,0.08,0.08,0.08,0.00,0.00,87000,1,6960,0,0,0,0,0,0,0,87000,-87000,-87000
20200430,051987,廣達元大95購01,,,,,0.00,0.00,0,0,0,0,0,0,0,0,0,0,0,0,0
20200430,051988,台光電元大95購01,,,,,0.00,0.00,0,0,0,0,0,0,0,0,0,0,0,0,0
20200430,051989,華固元大95購02,,,,,0.00,0.00,0,0,0,0,0,0,0,0,0,0,0,0,0
20200430,05198P,牧德永豐95售02,,,,,0.00,0.00,0,0,0,0,0,0,0,0,0,0,0,0,0
20200430,051990,泰碩元大95購01,,,,,0.00,0.00,0,0,0,0,0,0,0,0,0,0,0,0,0
20200430,051991,泰碩元大95購02,0.68,0.68,0.62,0.62,-0.21,-25.3,35000,3,23500,0,0,0,0,0,0,25000,0,25000,25000
20200430,051993,和碩元大95購03,,,,,0.00,0.00,0,0,0,0,0,0,0,0,0,0,0,0,0
20200430,051994,瀚宇博元大96購01,,,,,0.00,0.00,0,0,0,0,0,0,0,0,0,0,0,0,0
20200430,051995,矽力元大95購03,,,,,0.00,0.00,0,0,0,0,0,0,0,0,0,0,0,0,0
20200430,051996,康友元大95購01,,,,,0.00,0.00,0,0,0,0,0,0,0,0,0,0,0,0,0
20200430,051997,康友元大95購02,,,,,0.00,0.00,0,0,0,0,0,0,0,0,0,0,0,0,0
20200430,051998,昇陽半元大96購02,,,,,0.00,0.00,0,0,0,0,0,0,0,0,0,0,0,0,0
20200430,051999,勤誠元大95購01,1.01,1.01,1.01,1.01,-0.08,-7.34,240000,1,242400,0,0,0,0,0,0,240000,0,240000,240000
20200430,05199P,訊芯永豐95售02,,,,,0.00,0.00,0,0,0,0,0,0,0,0,0,0,0,0,0
20200430,052000,鈺齊元大95購03,,,,,0.00,0.00,0,0,0,0,0,0,0,0,0,0,0,0,0
20200430,052001,寶成元大95購02,,,,,0.00,0.00,0,0,0,0,0,0,0,0,0,0,0,0,0
20200430,052002,滬深2X國泰96購01,,,,,0.00,0.00,0,0,0,0,0,0,0,0,0,0,0,0,0
20200430,052003,泰碩國泰97購02,1.44,1.45,1.35,1.37,-0.03,-2.14,760000,27,1045170,0,0,0,0,0,0,618000,161000,457000,457000
20200430,052004,泰碩國泰97購03,1.10,1.12,1.04,1.05,-0.01,-0.94,390000,23,415970,0,0,0,0,0,0,55000,334000,-279000,-279000
20200430,052005,矽力國泰97購02,,,,,0.00,0.00,0,0,0,0,0,0,0,0,0,0,0,0,0
20200430,052006,康友富邦98購01,,,,,0.00,0.00,0,0,0,0,0,0,0,0,0,0,0,0,0
20200430,052007,滬深2X第一95購01,,,,,0.00,0.00,0,0,0,0,0,0,0,0,0,0,0,0,0
20200430,052008,創意第一95購01,,,,,0.00,0.00,0,0,0,0,0,0,0,0,0,0,0,0,0
20200430,052009,群創第一95購01,,,,,0.00,0.00,0,0,0,0,0,0,0,0,0,0,0,0,0
20200430,05200P,臺股指永豐95售03,,,,,0.00,0.00,0,0,0,0,0,0,0,0,0,0,0,0,0
20200430,052010,兆豐金中信95購01,0.54,0.64,0.51,0.64,+0.13,25.49,83000,10,44580,0,0,0,0,0,0,83000,0,83000,83000
20200430,052011,欣興中信96購01,0.05,0.05,0.04,0.04,0.00,0.00,1799000,13,76610,0,0,0,0,0,0,1739000,10000,1729000,1729000
20200430,052012,聯發科台新95購02,,,,,0.00,0.00,0,0,0,0,0,0,0,0,0,0,0,0,0
20200430,052013,台積電永豐95購04,,,,,0.00,0.00,0,0,0,0,0,0,0,0,0,0,0,0,0
20200430,052014,光罩永豐95購01,,,,,0.00,0.00,0,0,0,0,0,0,0,0,0,0,0,0,0
20200430,052015,漢唐永豐95購02,,,,,0.00,0.00,0,0,0,0,0,0,0,0,0,0,0,0,0
20200430,052016,神基永豐95購01,,,,,0.00,0.00,0,0,0,0,0,0,0,0,0,0,0,0,0
20200430,052017,奇鋐永豐95購01,,,,,0.00,0.00,0,0,0,0,0,0,0,0,0,0,0,0,0
20200430,052018,京鼎永豐95購02,,,,,0.00,0.00,0,0,0,0,0,0,0,0,0,0,0,0,0
20200430,052019,創意永豐95購02,,,,,0.00,0.00,0,0,0,0,0,0,0,0,0,0,0,0,0
20200430,05201P,玉晶光國泰97售02,,,,,0.00,0.00,0,0,0,0,0,0,0,0,0,0,0,0,0
20200430,052020,聯茂永豐95購02,0.47,0.47,0.46,0.46,-0.04,-8.0,42000,13,19730,0,0,0,0,0,0,42000,0,42000,42000
20200430,052021,易華電永豐95購03,,,,,0.00,0.00,0,0,0,0,0,0,0,0,0,0,0,0,0
20200430,052022,南電永豐95購03,0.77,0.77,0.59,0.59,-0.05,-7.81,2000,2,1360,0,0,0,0,0,0,2000,0,2000,2000
20200430,052023,鈺齊永豐95購02,,,,,0.00,0.00,0,0,0,0,0,0,0,0,0,0,0,0,0
20200430,052024,臺股指永豐95購04,,,,,0.00,0.00,0,0,0,0,0,0,0,0,0,0,0,0,0
20200430,052025,國巨群益96購01,3.79,3.95,3.79,3.95,+0.34,9.42,9000,7,34630,0,0,0,0,0,0,7000,9000,-2000,-2000
20200430,052026,漢唐群益95購01,1.47,1.47,1.47,1.47,0.00,0.00,8000,1,11760,0,0,0,0,0,0,8000,0,8000,8000
20200430,052027,智原群益95購01,,,,,0.00,0.00,0,0,0,0,0,0,0,0,0,0,0,0,0
20200430,052028,健策群益95購02,,,,,0.00,0.00,0,0,0,0,0,0,0,0,0,0,0,0,0
20200430,052029,矽力群益95購02,1.42,1.42,1.42,1.42,0.00,0.00,2000,1,2840,0,0,0,0,0,0,0,2000,-2000,-2000
20200430,05202P,鴻海元大95售16,,,,,0.00,0.00,0,0,0,0,0,0,0,0,0,0,0,0,0
20200430,052030,GIS群益95購04,,,,,0.00,0.00,0,0,0,0,0,0,0,0,0,0,0,0,0
20200430,052031,臺股指群益95購04,,,,,0.00,0.00,0,0,0,0,0,0,0,0,0,0,0,0,0
20200430,052032,臺股指群益95購05,0.05,0.05,0.05,0.05,0.00,0.00,159000,2,7950,0,0,0,0,0,0,159000,0,159000,159000
20200430,052033,臺股指群益95購06,,,,,0.00,0.00,0,0,0,0,0,0,0,0,0,0,0,0,0
20200430,052034,臺股指群益95購07,,,,,0.00,0.00,0,0,0,0,0,0,0,0,0,0,0,0,0
20200430,052035,臺股指群益95購08,,,,,0.00,0.00,0,0,0,0,0,0,0,0,0,0,0,0,0
20200430,052036,臺股指群益95購09,,,,,0.00,0.00,0,0,0,0,0,0,0,0,0,0,0,0,0
20200430,052037,全新國泰96購02,,,,,0.00,0.00,0,0,0,0,0,0,0,0,0,0,0,0,0
20200430,052038,國巨永昌96購01,,,,,0.00,0.00,0,0,0,0,0,0,0,0,0,0,0,0,0
20200430,052039,聯詠永昌96購01,,,,,0.00,0.00,0,0,0,0,0,0,0,0,0,0,0,0,0
20200430,05203P,華新科元大95售10,,,,,0.00,0.00,0,0,0,0,0,0,0,0,0,0,0,0,0
20200430,052040,臺股指永昌95購01,,,,,0.00,0.00,0,0,0,0,0,0,0,0,0,0,0,0,0
20200430,052041,鴻海日盛95購02,,,,,0.00,0.00,0,0,0,0,0,0,0,0,0,0,0,0,0
20200430,052042,台積電日盛95購02,,,,,0.00,0.00,0,0,0,0,0,0,0,0,0,0,0,0,0
20200430,052043,瑞昱日盛95購01,0.23,0.23,0.23,0.23,0.00,0.00,20000,1,4600,0,0,0,0,0,0,20000,0,20000,20000
20200430,052044,華通凱基97購01,0.05,0.06,0.05,0.06,0.00,0.00,10000,2,550,0,0,0,0,0,0,0,0,0,0
20200430,052045,瑞昱凱基96購01,1.21,1.43,1.16,1.39,+0.29,26.36,99000,31,129440,0,0,0,0,0,0,54000,51000,3000,3000
20200430,052046,漢唐凱基96購01,,,,,0.00,0.00,0,0,0,0,0,0,0,0,0,0,0,0,0
20200430,052047,建準凱基96購01,,,,,0.00,0.00,0,0,0,0,0,0,0,0,0,0,0,0,0
20200430,052048,景碩凱基95購01,,,,,0.00,0.00,0,0,0,0,0,0,0,0,0,0,0,0,0
20200430,052049,緯創凱基97購01,1.57,1.67,1.54,1.67,+0.12,7.74,121000,10,189940,0,0,0,0,0,0,87000,34000,53000,53000
20200430,05204P,TPK元大95售03,,,,,0.00,0.00,0,0,0,0,0,0,0,0,0,0,0,0,0
20200430,052050,明泰凱基95購01,,,,,0.00,0.00,0,0,0,0,0,0,0,0,0,0,0,0,0
20200430,052051,京鼎凱基95購01,,,,,0.00,0.00,0,0,0,0,0,0,0,0,0,0,0,0,0
20200430,052052,嘉澤凱基95購02,0.45,0.53,0.45,0.53,+0.03,6.0,40000,3,19500,0,0,0,0,0,0,40000,0,40000,40000
20200430,052053,泰鼎凱基96購01,,,,,0.00,0.00,0,0,0,0,0,0,0,0,0,0,0,0,0
20200430,052054,台表科凱基96購01,,,,,0.00,0.00,0,0,0,0,0,0,0,0,0,0,0,0,0
20200430,052055,緯穎凱基95購03,2.28,2.28,2.28,2.28,+0.27,13.43,10000,1,22800,0,0,0,0,0,0,10000,0,10000,10000
20200430,052056,緯穎凱基95購04,2.89,4.07,2.89,4.07,+1.51,58.98,33000,5,103700,0,0,0,0,0,0,33000,0,33000,33000
20200430,052057,臺股指凱基95購15,,,,,0.00,0.00,0,0,0,0,0,0,0,0,0,0,0,0,0
20200430,052058,臺股指凱基95購16,0.40,0.43,0.40,0.43,+0.13,43.33,9000,3,3780,0,9000,-9000,0,0,0,3000,0,3000,-6000
20200430,052059,臺股指凱基95購17,,,,,0.00,0.00,0,0,0,0,0,0,0,0,0,0,0,0,0
20200430,05205P,緯穎元大95售03,,,,,0.00,0.00,0,0,0,0,0,0,0,0,0,0,0,0,0
20200430,052060,旺宏國票96購02,1.95,1.95,1.95,1.95,+0.51,35.42,2000,2,3900,0,0,0,0,0,0,2000,0,2000,2000
20200430,052061,樺漢國票96購01,,,,,0.00,0.00,0,0,0,0,0,0,0,0,0,0,0,0,0
20200430,052062,臺股指國票95購09,0.60,0.76,0.57,0.76,+0.23,43.4,107000,5,68000,0,0,0,0,0,0,86000,21000,65000,65000
20200430,052063,臺股指國票95購10,,,,,0.00,0.00,0,0,0,0,0,0,0,0,0,0,0,0,0
20200430,052064,臺股指國票95購11,,,,,0.00,0.00,0,0,0,0,0,0,0,0,0,0,0,0,0
20200430,052065,臺股指國票95購12,,,,,0.00,0.00,0,0,0,0,0,0,0,0,0,0,0,0,0
20200430,052066,華邦電兆豐96購01,0.13,0.16,0.12,0.13,+0.01,8.33,115000,13,14710,0,0,0,0,0,0,0,90000,-90000,-90000
20200430,052067,中磊兆豐96購01,0.77,0.78,0.77,0.78,+0.01,1.3,43000,5,33460,0,0,0,0,0,0,11000,32000,-21000,-21000
20200430,052068,瑞儀兆豐96購01,0.33,0.35,0.33,0.34,0.00,0.00,75000,6,25120,0,0,0,0,0,0,73000,2000,71000,71000
20200430,052069,聯茂兆豐96購01,0.63,0.63,0.62,0.62,-0.02,-3.12,194000,2,121220,0,0,0,0,0,0,100000,94000,6000,6000
20200430,05206P,南茂元大95售01,,,,,0.00,0.00,0,0,0,0,0,0,0,0,0,0,0,0,0
20200430,052070,GIS兆豐95購03,,,,,0.00,0.00,0,0,0,0,0,0,0,0,0,0,0,0,0
20200430,052071,臺股指兆豐95購01,,,,,0.00,0.00,0,0,0,0,0,0,0,0,0,0,0,0,0
20200430,052072,健策統一95購02,1.21,1.46,1.21,1.32,0.00,0.00,148000,16,201880,0,0,0,0,0,0,140000,148000,-8000,-8000
20200430,052073,矽力統一95購03,,,,,0.00,0.00,0,0,0,0,0,0,0,0,0,0,0,0,0
20200430,052074,鴻海元富95購10,,,,,0.00,0.00,0,0,0,0,0,0,0,0,0,0,0,0,0
20200430,052075,旺宏元富95購03,1.46,1.46,1.28,1.35,+0.31,29.81,55000,3,75280,0,0,0,0,0,0,11000,44000,-33000,-33000
20200430,052076,可成元富98購01,1.37,1.37,1.28,1.31,-0.05,-3.68,38000,3,49840,0,0,0,0,0,0,28000,10000,18000,18000
20200430,052077,可成元富98購02,0.77,0.77,0.77,0.77,-0.05,-6.1,5000,1,3850,0,0,0,0,0,0,5000,0,5000,5000
20200430,052078,大立光元富95購10,,,,,0.00,0.00,0,0,0,0,0,0,0,0,0,0,0,0,0
20200430,052079,康友元富98購01,,,,,0.00,0.00,0,0,0,0,0,0,0,0,0,0,0,0,0
20200430,05207P,高股息中信97售03,,,,,0.00,0.00,0,0,0,0,0,0,0,0,0,0,0,0,0
20200430,052080,康友元富98購02,,,,,0.00,0.00,0,0,0,0,0,0,0,0,0,0,0,0,0
20200430,052081,臺股指元富95購03,,,,,0.00,0.00,0,0,0,0,0,0,0,0,0,0,0,0,0
20200430,052082,臺股指元富95購04,,,,,0.00,0.00,0,0,0,0,0,0,0,0,0,0,0,0,0
20200430,052083,S&P反1元大97購02,,,,,0.00,0.00,0,0,0,0,0,0,0,0,0,0,0,0,0
20200430,052084,台泥元大95購01,0.63,0.78,0.63,0.78,+0.11,16.42,502000,11,357580,0,0,0,0,0,0,300000,202000,98000,98000
20200430,052085,聯電元大95購01,,,,,0.00,0.00,0,0,0,0,0,0,0,0,0,0,0,0,0
20200430,052086,鴻海元大96購08,0.25,0.25,0.25,0.25,0.00,0.00,40000,1,10000,0,0,0,0,0,0,0,40000,-40000,-40000
20200430,052087,鴻海元大96購09,,,,,0.00,0.00,0,0,0,0,0,0,0,0,0,0,0,0,0
20200430,052088,漢唐元大95購02,0.41,0.41,0.40,0.40,+0.02,5.26,200000,3,80100,0,0,0,0,0,0,100000,100000,0,0
20200430,052089,聯發科元大96購02,0.58,0.58,0.58,0.58,+0.17,41.46,6000,2,3480,0,0,0,0,0,0,6000,0,6000,6000
20200430,05208P,TPK中信95售01,,,,,0.00,0.00,0,0,0,0,0,0,0,0,0,0,0,0,0
20200430,052090,聯發科元大97購03,0.30,0.36,0.30,0.36,+0.13,56.52,90000,4,30600,0,0,0,0,0,0,75000,0,75000,75000
20200430,052091,緯創元大95購04,0.26,0.26,0.25,0.25,+0.06,31.58,120000,2,30600,0,0,0,0,0,0,120000,0,120000,120000
20200430,052092,貿聯元大96購02,,,,,0.00,0.00,0,0,0,0,0,0,0,0,0,0,0,0,0
20200430,052093,麗豐元大96購04,,,,,0.00,0.00,0,0,0,0,0,0,0,0,0,0,0,0,0
20200430,052094,瀚宇博元大96購02,0.50,0.53,0.50,0.53,+0.02,3.92,65000,4,33850,0,0,0,0,0,0,0,65000,-65000,-65000
20200430,052095,彩晶元大97購01,0.74,0.76,0.72,0.73,+0.02,2.82,276000,10,204020,0,0,0,0,0,0,146000,130000,16000,16000
20200430,052096,力成元大95購01,0.87,0.99,0.87,0.99,+0.09,10.0,238000,5,220240,0,0,0,0,0,0,124000,114000,10000,10000
20200430,052097,GIS元大95購05,,,,,0.00,0.00,0,0,0,0,0,0,0,0,0,0,0,0,0
20200430,052098,臺股指富邦95購01,,,,,0.00,0.00,0,0,0,0,0,0,0,0,0,0,0,0,0
20200430,052099,臺股指富邦95購02,,,,,0.00,0.00,0,0,0,0,0,0,0,0,0,0,0,0,0
20200430,05209P,鴻海凱基96售09,0.36,0.36,0.36,0.36,-0.03,-7.69,40000,2,14400,0,0,0,0,0,0,40000,0,40000,40000
20200430,052100,滬深2X永昌96購01,,,,,0.00,0.00,0,0,0,0,0,0,0,0,0,0,0,0,0
20200430,052101,滬深2X兆豐96購01,0.36,0.36,0.28,0.28,0.00,0.00,20000,3,6500,0,0,0,0,0,0,0,15000,-15000,-15000
20200430,052102,台泥兆豐96購01,1.01,1.09,1.01,1.08,+0.06,5.88,764000,29,805780,0,0,0,0,0,0,197000,567000,-370000,-370000
20200430,052103,台積電兆豐95購06,0.06,0.06,0.06,0.06,+0.01,20.0,1288000,8,77280,0,0,0,0,0,0,1288000,1278000,10000,10000
20200430,052104,英業達兆豐96購01,0.60,0.60,0.57,0.57,-0.07,-10.94,110000,3,65700,0,0,0,0,0,0,110000,0,110000,110000
20200430,052105,南亞科兆豐95購01,,,,,0.00,0.00,0,0,0,0,0,0,0,0,0,0,0,0,0
20200430,052106,明泰兆豐95購01,,,,,0.00,0.00,0,0,0,0,0,0,0,0,0,0,0,0,0
20200430,052107,台積電統一95購06,,,,,0.00,0.00,0,0,0,0,0,0,0,0,0,0,0,0,0
20200430,052108,鴻海元富95購11,,,,,0.00,0.00,0,0,0,0,0,0,0,0,0,0,0,0,0
20200430,052109,可成元富95購01,,,,,0.00,0.00,0,0,0,0,0,0,0,0,0,0,0,0,0
20200430,05210P,台積電凱基95售15,,,,,0.00,0.00,0,0,0,0,0,0,0,0,0,0,0,0,0
20200430,052110,可成元富95購02,,,,,0.00,0.00,0,0,0,0,0,0,0,0,0,0,0,0,0
20200430,052111,智原元富95購01,,,,,0.00,0.00,0,0,0,0,0,0,0,0,0,0,0,0,0
20200430,052112,滬深2X中信99購01,0.15,0.18,0.15,0.18,0.00,0.00,30000,3,4800,0,0,0,0,0,0,0,20000,-20000,-20000
20200430,052113,漢唐中信98購01,0.41,0.41,0.41,0.41,+0.02,5.13,38000,2,15580,0,0,0,0,0,0,38000,0,38000,38000
20200430,052114,華固中信95購01,,,,,0.00,0.00,0,0,0,0,0,0,0,0,0,0,0,0,0
20200430,052115,T50反1國票95購03,,,,,0.00,0.00,0,0,0,0,0,0,0,0,0,0,0,0,0
20200430,052116,T50反1國票97購01,,,,,0.00,0.00,0,0,0,0,0,0,0,0,0,0,0,0,0
20200430,052117,鴻海國票96購03,,,,,0.00,0.00,0,0,0,0,0,0,0,0,0,0,0,0,0
20200430,052118,鴻海國票96購04,,,,,0.00,0.00,0,0,0,0,0,0,0,0,0,0,0,0,0
20200430,052119,漢唐國票96購01,,,,,0.00,0.00,0,0,0,0,0,0,0,0,0,0,0,0,0
20200430,05211P,國巨國票96售05,,,,,0.00,0.00,0,0,0,0,0,0,0,0,0,0,0,0,0
20200430,052120,友達國票96購01,,,,,0.00,0.00,0,0,0,0,0,0,0,0,0,0,0,0,0
20200430,052121,全新國票96購03,,,,,0.00,0.00,0,0,0,0,0,0,0,0,0,0,0,0,0
20200430,052122,新光金國票96購01,,,,,0.00,0.00,0,0,0,0,0,0,0,0,0,0,0,0,0
20200430,052123,泰碩國票95購01,,,,,0.00,0.00,0,0,0,0,0,0,0,0,0,0,0,0,0
20200430,052124,京鼎國票95購01,0.30,0.36,0.30,0.36,0.00,0.00,164000,7,54180,0,0,0,0,0,0,0,164000,-164000,-164000
20200430,052125,群創國票95購02,0.11,0.11,0.11,0.11,0.00,0.00,12000,1,1320,0,0,0,0,0,0,12000,0,12000,12000
20200430,052126,群創國票97購01,,,,,0.00,0.00,0,0,0,0,0,0,0,0,0,0,0,0,0
20200430,052127,日月光國票96購01,,,,,0.00,0.00,0,0,0,0,0,0,0,0,0,0,0,0,0
20200430,052128,聯發科日盛95購03,,,,,0.00,0.00,0,0,0,0,0,0,0,0,0,0,0,0,0
20200430,052129,鴻海凱基97購02,,,,,0.00,0.00,0,0,0,0,0,0,0,0,0,0,0,0,0
20200430,05212P,台積電國票96售04,2.65,2.66,2.56,2.56,-0.41,-13.8,202000,12,531570,0,0,0,0,0,0,50000,152000,-102000,-102000
20200430,052130,國巨凱基9B購01,2.00,2.02,1.88,1.99,+0.14,7.57,300000,28,592220,0,0,0,0,0,0,134000,88000,46000,46000
20200430,052131,台積電凱基96購01,0.05,0.06,0.05,0.05,-0.04,-44.44,40000,4,2100,0,0,0,0,0,0,0,0,0,0
20200430,052132,旺宏凱基9B購01,1.50,1.52,1.48,1.49,+0.24,19.2,26000,10,38920,0,0,0,0,0,0,10000,5000,5000,5000
20200430,052133,華邦電凱基9B購01,0.30,0.32,0.30,0.32,+0.14,77.78,6000,2,1900,0,0,0,0,0,0,0,5000,-5000,-5000
20200430,052134,智邦凱基95購09,3.85,3.85,3.85,3.85,+0.37,10.63,10000,1,38500,0,0,0,0,0,0,10000,0,10000,10000
20200430,052135,聯發科凱基9B購01,0.80,0.95,0.79,0.92,+0.17,22.67,554000,45,451400,0,0,0,0,0,0,435000,0,435000,435000
20200430,052136,瑞儀凱基95購01,,,,,0.00,0.00,0,0,0,0,0,0,0,0,0,0,0,0,0
20200430,052137,台表科凱基96購02,0.29,0.29,0.29,0.29,0.00,0.00,20000,1,5800,0,0,0,0,0,0,20000,0,20000,20000
20200430,052138,易華電凱基97購01,,,,,0.00,0.00,0,0,0,0,0,0,0,0,0,0,0,0,0
20200430,052139,矽創凱基95購01,,,,,0.00,0.00,0,0,0,0,0,0,0,0,0,0,0,0,0
20200430,05213P,台積電國票96售05,1.06,1.06,0.99,0.99,-0.31,-23.85,201000,3,211890,0,0,0,0,0,0,0,201000,-201000,-201000
20200430,052140,鈺齊凱基95購02,,,,,0.00,0.00,0,0,0,0,0,0,0,0,0,0,0,0,0
20200430,052141,百和凱基95購02,,,,,0.00,0.00,0,0,0,0,0,0,0,0,0,0,0,0,0
20200430,052142,滬深2X群益99購04,,,,,0.00,0.00,0,0,0,0,0,0,0,0,0,0,0,0,0
20200430,052143,鴻海群益95購09,,,,,0.00,0.00,0,0,0,0,0,0,0,0,0,0,0,0,0
20200430,052144,鴻海群益95購10,,,,,0.00,0.00,0,0,0,0,0,0,0,0,0,0,0,0,0
20200430,052145,京元電群益95購02,,,,,0.00,0.00,0,0,0,0,0,0,0,0,0,0,0,0,0
20200430,052146,泰碩群益95購01,0.26,0.29,0.26,0.27,-0.10,-27.03,306000,7,82430,0,0,0,0,0,0,306000,0,306000,306000
20200430,052147,上緯控群益95購01,,,,,0.00,0.00,0,0,0,0,0,0,0,0,0,0,0,0,0
20200430,052148,康友群益95購03,,,,,0.00,0.00,0,0,0,0,0,0,0,0,0,0,0,0,0
20200430,052149,電子類群益95購01,,,,,0.00,0.00,0,0,0,0,0,0,0,0,0,0,0,0,0
20200430,05214P,台積電國票97售02,0.09,0.09,0.09,0.09,0.00,0.00,10000,1,900,0,0,0,0,0,0,0,10000,-10000,-10000
20200430,052150,台積電富邦95購07,0.01,0.02,0.01,0.02,+0.01,100.0,845000,11,8550,0,0,0,0,0,0,829000,0,829000,829000
20200430,052151,義隆富邦96購01,,,,,0.00,0.00,0,0,0,0,0,0,0,0,0,0,0,0,0
20200430,052152,創意富邦98購01,0.26,0.26,0.26,0.26,0.00,0.00,10000,1,2600,0,0,0,0,0,0,10000,0,10000,10000
20200430,052153,GIS富邦96購02,0.17,0.20,0.16,0.20,+0.04,25.0,490000,10,83700,0,0,0,0,0,0,0,440000,-440000,-440000
20200430,052154,緯創台新95購01,,,,,0.00,0.00,0,0,0,0,0,0,0,0,0,0,0,0,0
20200430,052155,百和台新95購01,,,,,0.00,0.00,0,0,0,0,0,0,0,0,0,0,0,0,0
20200430,052156,滬深2X永豐95購03,,,,,0.00,0.00,0,0,0,0,0,0,0,0,0,0,0,0,0
20200430,052157,東元永豐95購01,,,,,0.00,0.00,0,0,0,0,0,0,0,0,0,0,0,0,0
20200430,052158,華泰永豐95購01,,,,,0.00,0.00,0,0,0,0,0,0,0,0,0,0,0,0,0
20200430,052159,瑞昱永豐95購01,1.20,1.20,1.13,1.14,+0.03,2.7,196000,8,230440,0,0,0,0,0,0,196000,0,196000,196000
20200430,05215P,台積電台新95售03,,,,,0.00,0.00,0,0,0,0,0,0,0,0,0,0,0,0,0
20200430,052160,美律永豐95購03,,,,,0.00,0.00,0,0,0,0,0,0,0,0,0,0,0,0,0
20200430,052161,義隆永豐95購03,,,,,0.00,0.00,0,0,0,0,0,0,0,0,0,0,0,0,0
20200430,052162,智伸科永豐95購01,,,,,0.00,0.00,0,0,0,0,0,0,0,0,0,0,0,0,0
20200430,052163,康舒永豐95購02,0.08,0.08,0.08,0.08,+0.01,14.29,300000,3,24000,0,0,0,0,0,0,300000,0,300000,300000
20200430,052164,啟碁永豐95購01,,,,,0.00,0.00,0,0,0,0,0,0,0,0,0,0,0,0,0
20200430,052165,訊芯永豐95購03,,,,,0.00,0.00,0,0,0,0,0,0,0,0,0,0,0,0,0
20200430,052166,元油反元大95購01,,,,,0.00,0.00,0,0,0,0,0,0,0,0,0,0,0,0,0
20200430,052167,亞泥元大96購01,0.80,0.80,0.80,0.80,0.00,0.00,5000,1,4000,0,0,0,0,0,0,0,0,0,0
20200430,052168,鴻海元大96購10,,,,,0.00,0.00,0,0,0,0,0,0,0,0,0,0,0,0,0
20200430,052169,鴻海元大97購02,,,,,0.00,0.00,0,0,0,0,0,0,0,0,0,0,0,0,0
20200430,05216P,國巨永豐95售02,,,,,0.00,0.00,0,0,0,0,0,0,0,0,0,0,0,0,0
20200430,052170,台積電元大95購20,0.01,0.01,0.01,0.01,0.00,0.00,20000,1,200,0,0,0,0,0,0,20000,0,20000,20000
20200430,052171,台積電元大95購21,,,,,0.00,0.00,0,0,0,0,0,0,0,0,0,0,0,0,0
20200430,052172,致茂元大95購01,0.65,0.65,0.65,0.65,+0.07,12.07,7000,1,4550,0,0,0,0,0,0,7000,0,7000,7000
20200430,052173,廣達元大95購02,0.43,0.48,0.43,0.48,-0.02,-4.0,81000,6,35770,0,0,0,0,0,0,59000,11000,48000,48000
20200430,052174,聯發科元大95購13,,,,,0.00,0.00,0,0,0,0,0,0,0,0,0,0,0,0,0
20200430,052175,可成元大95購10,,,,,0.00,0.00,0,0,0,0,0,0,0,0,0,0,0,0,0
20200430,052176,景碩元大96購01,,,,,0.00,0.00,0,0,0,0,0,0,0,0,0,0,0,0,0
20200430,052177,京鼎元大95購02,0.10,0.17,0.10,0.17,0.00,0.00,595000,5,100200,0,0,0,0,0,0,595000,0,595000,595000
20200430,052178,台郡元大96購03,,,,,0.00,0.00,0,0,0,0,0,0,0,0,0,0,0,0,0
20200430,052179,康友元大95購03,,,,,0.00,0.00,0,0,0,0,0,0,0,0,0,0,0,0,0
20200430,05217P,鴻海統一95售08,,,,,0.00,0.00,0,0,0,0,0,0,0,0,0,0,0,0,0
20200430,052180,緯穎元大96購05,3.48,4.18,3.38,4.18,+0.95,29.41,177000,18,613990,0,0,0,0,0,0,147000,30000,117000,117000
20200430,052181,南茂元大95購05,,,,,0.00,0.00,0,0,0,0,0,0,0,0,0,0,0,0,0
20200430,052182,鴻海群益96購01,0.63,0.65,0.63,0.65,0.00,0.00,14000,2,8900,0,0,0,0,0,0,0,14000,-14000,-14000
20200430,052183,華邦電群益95購01,,,,,0.00,0.00,0,0,0,0,0,0,0,0,0,0,0,0,0
20200430,052184,台光電群益95購03,0.69,0.69,0.69,0.69,0.00,0.00,2000,1,1380,0,0,0,0,0,0,2000,0,2000,2000
20200430,052185,奇力新群益95購03,1.12,1.22,1.12,1.22,0.00,0.00,20000,2,23400,0,0,0,0,0,0,0,20000,-20000,-20000
20200430,052186,宏達電群益95購04,,,,,0.00,0.00,0,0,0,0,0,0,0,0,0,0,0,0,0
20200430,052187,奇鋐群益95購03,0.31,0.31,0.31,0.31,0.00,0.00,10000,1,3100,0,0,0,0,0,0,0,10000,-10000,-10000
20200430,052188,欣興群益95購03,0.30,0.30,0.30,0.30,0.00,0.00,20000,2,6000,0,0,0,0,0,0,0,20000,-20000,-20000
20200430,052189,玉晶光群益96購06,2.31,2.31,2.31,2.31,0.00,0.00,1000,1,2310,0,0,0,0,0,0,0,1000,-1000,-1000
20200430,05218P,大立光永昌96售04,,,,,0.00,0.00,0,0,0,0,0,0,0,0,0,0,0,0,0
20200430,052190,創意群益95購03,,,,,0.00,0.00,0,0,0,0,0,0,0,0,0,0,0,0,0
20200430,052191,超眾群益96購01,6.25,6.25,6.25,6.25,-0.10,-1.57,6000,1,37500,0,0,0,0,0,0,0,6000,-6000,-6000
20200430,052192,SP黃豆元富95購04,,,,,0.00,0.00,0,0,0,0,0,0,0,0,0,0,0,0,0
20200430,052193,國巨元富95購06,,,,,0.00,0.00,0,0,0,0,0,0,0,0,0,0,0,0,0
20200430,052194,旺宏元富95購04,0.52,0.55,0.46,0.50,+0.11,28.21,1743000,19,829950,0,0,0,0,0,0,1732000,11000,1721000,1721000
20200430,052195,健策元富95購01,,,,,0.00,0.00,0,0,0,0,0,0,0,0,0,0,0,0,0
20200430,052196,TPK元富95購01,,,,,0.00,0.00,0,0,0,0,0,0,0,0,0,0,0,0,0
20200430,052197,台郡元富95購03,,,,,0.00,0.00,0,0,0,0,0,0,0,0,0,0,0,0,0
20200430,052198,鴻海統一95購10,,,,,0.00,0.00,0,0,0,0,0,0,0,0,0,0,0,0,0
20200430,052199,鴻海統一95購11,,,,,0.00,0.00,0,0,0,0,0,0,0,0,0,0,0,0,0
20200430,05219P,鴻海元大95售17,,,,,0.00,0.00,0,0,0,0,0,0,0,0,0,0,0,0,0
20200430,052200,台光電統一95購02,1.30,1.58,1.29,1.58,+0.36,29.51,379000,23,518880,0,0,0,0,0,0,66000,324000,-258000,-258000
20200430,052201,超眾統一96購01,,,,,0.00,0.00,0,0,0,0,0,0,0,0,0,0,0,0,0
20200430,052202,矽力統一96購01,2.61,2.61,2.60,2.60,0.00,0.00,10000,2,26090,0,0,0,0,0,0,0,10000,-10000,-10000
20200430,052203,T50反1中信99購03,1.08,1.11,1.05,1.05,-0.11,-9.48,120000,8,128600,0,0,0,0,0,0,10000,110000,-100000,-100000
20200430,052204,台泥中信96購01,,,,,0.00,0.00,0,0,0,0,0,0,0,0,0,0,0,0,0
20200430,052205,台積電中信95購09,0.05,0.05,0.05,0.05,0.00,0.00,300000,2,15000,0,0,0,0,0,0,300000,0,300000,300000
20200430,052206,燿華中信95購02,,,,,0.00,0.00,0,0,0,0,0,0,0,0,0,0,0,0,0
20200430,052207,台郡中信95購02,,,,,0.00,0.00,0,0,0,0,0,0,0,0,0,0,0,0,0
20200430,052208,力成麥證95購01,0.31,0.34,0.31,0.34,0.00,0.00,55000,2,17200,55000,0,55000,0,0,0,55000,0,55000,55000
20200430,052209,深中小元大95購02,,,,,0.00,0.00,0,0,0,0,0,0,0,0,0,0,0,0,0
20200430,05220P,台積電元大95售16,,,,,0.00,0.00,0,0,0,0,0,0,0,0,0,0,0,0,0
20200430,052210,華夏元大95購01,,,,,0.00,0.00,0,0,0,0,0,0,0,0,0,0,0,0,0
20200430,052211,台積電元大95購22,,,,,0.00,0.00,0,0,0,0,0,0,0,0,0,0,0,0,0
20200430,052212,可成元大95購11,0.05,0.05,0.05,0.05,0.00,0.00,390000,1,19500,0,0,0,0,0,0,390000,0,390000,390000
20200430,052213,富邦金元大95購01,,,,,0.00,0.00,0,0,0,0,0,0,0,0,0,0,0,0,0
20200430,052214,智伸科元大96購01,,,,,0.00,0.00,0,0,0,0,0,0,0,0,0,0,0,0,0
20200430,052215,樺漢元大96購02,,,,,0.00,0.00,0,0,0,0,0,0,0,0,0,0,0,0,0
20200430,052216,康友元大96購01,0.33,0.33,0.33,0.33,+0.04,13.79,8000,1,2640,0,0,0,0,0,0,8000,0,8000,8000
20200430,052217,台光電日盛95購01,,,,,0.00,0.00,0,0,0,0,0,0,0,0,0,0,0,0,0
20200430,052218,大立光日盛95購01,,,,,0.00,0.00,0,0,0,0,0,0,0,0,0,0,0,0,0
20200430,052219,大立光日盛95購02,,,,,0.00,0.00,0,0,0,0,0,0,0,0,0,0,0,0,0
20200430,05221P,玉晶光元大95售04,,,,,0.00,0.00,0,0,0,0,0,0,0,0,0,0,0,0,0
20200430,052220,T50反1凱基98購01,1.38,1.38,1.38,1.38,-0.12,-8.0,5000,1,6900,0,0,0,0,0,0,5000,0,5000,5000
20200430,052221,東元凱基95購01,0.28,0.29,0.28,0.29,0.00,0.00,20000,2,5700,0,0,0,0,0,0,0,20000,-20000,-20000
20200430,052222,力山凱基95購02,0.38,0.38,0.38,0.38,0.00,0.00,10000,1,3800,0,0,0,0,0,0,0,10000,-10000,-10000
20200430,052223,聯電凱基96購02,,,,,0.00,0.00,0,0,0,0,0,0,0,0,0,0,0,0,0
20200430,052224,楠梓電凱基97購01,,,,,0.00,0.00,0,0,0,0,0,0,0,0,0,0,0,0,0
20200430,052225,台積電凱基96購03,0.06,0.06,0.05,0.06,0.00,0.00,370000,13,21640,0,0,0,0,0,0,0,0,0,0
20200430,052226,旺宏凱基95購06,,,,,0.00,0.00,0,0,0,0,0,0,0,0,0,0,0,0,0
20200430,052227,瑞昱凱基95購05,1.13,1.32,1.11,1.24,+0.21,20.39,328000,29,379690,0,0,0,0,0,0,270000,57000,213000,213000
20200430,052228,聯發科凱基96購06,0.09,0.09,0.09,0.09,+0.05,125.0,50000,1,4500,0,0,0,0,0,0,50000,0,50000,50000
20200430,052229,奇力新凱基96購01,1.31,1.31,1.28,1.28,0.00,0.00,40000,5,52100,0,0,0,0,0,0,0,40000,-40000,-40000
20200430,05222P,致伸凱基95售02,2.34,2.34,2.29,2.29,+0.06,2.69,38000,10,88020,0,0,0,0,0,0,38000,0,38000,38000
20200430,052230,大立光凱基96購09,2.45,2.75,2.45,2.75,+0.30,12.24,134000,10,342290,0,0,0,0,0,0,59000,75000,-16000,-16000
20200430,052231,景碩凱基96購01,1.85,1.92,1.84,1.92,+0.11,6.08,54000,3,100060,0,0,0,0,0,0,46000,8000,38000,38000
20200430,052232,貿聯凱基96購02,0.25,0.28,0.24,0.28,0.00,0.00,4000,4,1020,0,0,0,0,0,0,4000,0,4000,4000
20200430,052233,台郡凱基96購01,,,,,0.00,0.00,0,0,0,0,0,0,0,0,0,0,0,0,0
20200430,052234,GIS凱基97購01,1.40,1.41,1.36,1.40,-0.01,-0.71,111000,8,155280,0,0,0,0,0,0,71000,48000,23000,23000
20200430,052235,聯發科國票96購02,1.58,1.83,1.53,1.81,+0.60,49.59,494000,15,781690,0,0,0,0,0,0,475000,19000,456000,456000
20200430,052236,聯發科國票96購03,,,,,0.00,0.00,0,0,0,0,0,0,0,0,0,0,0,0,0
20200430,052237,嘉澤國票96購02,2.20,2.43,2.20,2.40,+0.38,18.81,189000,10,435050,0,0,0,0,0,0,178000,119000,59000,59000
20200430,052238,智易國票96購01,0.67,0.67,0.67,0.67,-0.09,-11.84,50000,1,33500,0,0,0,0,0,0,0,50000,-50000,-50000
20200430,052239,泰鼎國票97購01,3.01,3.01,2.84,2.97,+0.03,1.02,74000,11,217570,0,0,0,0,0,0,21000,56000,-35000,-35000
20200430,05223P,臻鼎凱基95售02,,,,,0.00,0.00,0,0,0,0,0,0,0,0,0,0,0,0,0
20200430,052240,臻鼎國票96購03,,,,,0.00,0.00,0,0,0,0,0,0,0,0,0,0,0,0,0
20200430,052241,台郡國票96購01,,,,,0.00,0.00,0,0,0,0,0,0,0,0,0,0,0,0,0
20200430,052242,台達電台新96購01,0.50,0.55,0.04,0.04,-0.32,-88.89,34000,3,12600,0,0,0,0,0,0,24000,10000,14000,14000
20200430,052243,致茂康和95購01,,,,,0.00,0.00,0,0,0,0,0,0,0,0,0,0,0,0,0
20200430,052244,廣達康和95購01,,,,,0.00,0.00,0,0,0,0,0,0,0,0,0,0,0,0,0
20200430,052245,緯創康和95購01,,,,,0.00,0.00,0,0,0,0,0,0,0,0,0,0,0,0,0
20200430,052246,超眾康和95購01,,,,,0.00,0.00,0,0,0,0,0,0,0,0,0,0,0,0,0
20200430,052247,深中小永豐95購01,,,,,0.00,0.00,0,0,0,0,0,0,0,0,0,0,0,0,0
20200430,052248,元油反永豐95購01,,,,,0.00,0.00,0,0,0,0,0,0,0,0,0,0,0,0,0
20200430,052249,大成鋼永豐95購01,,,,,0.00,0.00,0,0,0,0,0,0,0,0,0,0,0,0,0
20200430,05224P,華通統一95售03,,,,,0.00,0.00,0,0,0,0,0,0,0,0,0,0,0,0,0
20200430,052250,光磊永豐95購01,,,,,0.00,0.00,0,0,0,0,0,0,0,0,0,0,0,0,0
20200430,052251,台光電永豐95購03,,,,,0.00,0.00,0,0,0,0,0,0,0,0,0,0,0,0,0
20200430,052252,大立光永豐95購03,,,,,0.00,0.00,0,0,0,0,0,0,0,0,0,0,0,0,0
20200430,052253,康控永豐95購04,,,,,0.00,0.00,0,0,0,0,0,0,0,0,0,0,0,0,0
20200430,052254,康友永豐95購03,,,,,0.00,0.00,0,0,0,0,0,0,0,0,0,0,0,0,0
20200430,052255,T50反1國泰96購01,,,,,0.00,0.00,0,0,0,0,0,0,0,0,0,0,0,0,0
20200430,052256,台泥國泰96購01,,,,,0.00,0.00,0,0,0,0,0,0,0,0,0,0,0,0,0
20200430,052257,燿華國泰96購01,,,,,0.00,0.00,0,0,0,0,0,0,0,0,0,0,0,0,0
20200430,052258,滬深2X富邦96購04,,,,,0.00,0.00,0,0,0,0,0,0,0,0,0,0,0,0,0
20200430,052259,深100富邦95購01,,,,,0.00,0.00,0,0,0,0,0,0,0,0,0,0,0,0,0
20200430,05225P,鴻海統一95售09,,,,,0.00,0.00,0,0,0,0,0,0,0,0,0,0,0,0,0
20200430,052260,為升富邦97購02,,,,,0.00,0.00,0,0,0,0,0,0,0,0,0,0,0,0,0
20200430,052261,台泥第一95購01,,,,,0.00,0.00,0,0,0,0,0,0,0,0,0,0,0,0,0
20200430,052262,華新亞東95購02,,,,,0.00,0.00,0,0,0,0,0,0,0,0,0,0,0,0,0
20200430,052263,聯電亞東95購01,,,,,0.00,0.00,0,0,0,0,0,0,0,0,0,0,0,0,0
20200430,052264,台達電亞東96購01,,,,,0.00,0.00,0,0,0,0,0,0,0,0,0,0,0,0,0
20200430,052265,聯發科亞東95購01,,,,,0.00,0.00,0,0,0,0,0,0,0,0,0,0,0,0,0
20200430,052266,義隆亞東95購02,,,,,0.00,0.00,0,0,0,0,0,0,0,0,0,0,0,0,0
20200430,052267,可成亞東95購02,,,,,0.00,0.00,0,0,0,0,0,0,0,0,0,0,0,0,0
20200430,052268,新光金亞東96購01,,,,,0.00,0.00,0,0,0,0,0,0,0,0,0,0,0,0,0
20200430,052269,T50反1日盛9B購01,0.90,0.90,0.53,0.53,-0.67,-55.83,21000,8,15830,0,0,0,0,0,0,0,10000,-10000,-10000
20200430,05226P,智邦統一95售01,0.05,0.06,0.05,0.06,0.00,0.00,165000,3,8300,0,0,0,0,0,0,165000,0,165000,165000
20200430,052270,力成日盛95購01,,,,,0.00,0.00,0,0,0,0,0,0,0,0,0,0,0,0,0
20200430,052271,力成日盛95購02,,,,,0.00,0.00,0,0,0,0,0,0,0,0,0,0,0,0,0
20200430,052272,T50反1群益95購03,,,,,0.00,0.00,0,0,0,0,0,0,0,0,0,0,0,0,0
20200430,052273,新光金群益95購02,,,,,0.00,0.00,0,0,0,0,0,0,0,0,0,0,0,0,0
20200430,052274,大立光群益95購03,1.07,1.07,1.07,1.07,0.00,0.00,10000,1,10700,0,0,0,0,0,0,0,10000,-10000,-10000
20200430,052275,日月光群益95購01,,,,,0.00,0.00,0,0,0,0,0,0,0,0,0,0,0,0,0
20200430,052276,力成群益96購01,1.90,1.90,1.90,1.90,0.00,0.00,41000,2,77900,0,0,0,0,0,0,41000,0,41000,41000
20200430,052277,台達電凱基97購01,,,,,0.00,0.00,0,0,0,0,0,0,0,0,0,0,0,0,0
20200430,052278,國巨凱基95購06,,,,,0.00,0.00,0,0,0,0,0,0,0,0,0,0,0,0,0
20200430,052279,旺宏凱基95購07,1.16,1.16,1.16,1.16,0.00,0.00,10000,1,11600,0,0,0,0,0,0,0,10000,-10000,-10000
20200430,05227P,大立光統一95售04,,,,,0.00,0.00,0,0,0,0,0,0,0,0,0,0,0,0,0
20200430,052280,聯發科凱基95購11,0.55,0.55,0.55,0.55,+0.32,139.13,10000,1,5500,0,0,0,0,0,0,10000,10000,0,0
20200430,052281,全新凱基97購01,,,,,0.00,0.00,0,0,0,0,0,0,0,0,0,0,0,0,0
20200430,052282,宏達電凱基95購05,,,,,0.00,0.00,0,0,0,0,0,0,0,0,0,0,0,0,0
20200430,052283,TPK凱基97購01,,,,,0.00,0.00,0,0,0,0,0,0,0,0,0,0,0,0,0
20200430,052284,日月光凱基96購01,,,,,0.00,0.00,0,0,0,0,0,0,0,0,0,0,0,0,0
20200430,052285,康控凱基95購02,,,,,0.00,0.00,0,0,0,0,0,0,0,0,0,0,0,0,0
20200430,052286,力成凱基95購02,,,,,0.00,0.00,0,0,0,0,0,0,0,0,0,0,0,0,0
20200430,052287,臺股指中信95購12,,,,,0.00,0.00,0,0,0,0,0,0,0,0,0,0,0,0,0
20200430,052288,敦南統一95購01,0.41,0.41,0.41,0.41,0.00,0.00,10000,1,4100,0,0,0,0,0,0,10000,0,10000,10000
20200430,052289,為升元富95購02,,,,,0.00,0.00,0,0,0,0,0,0,0,0,0,0,0,0,0
20200430,05228P,大立光元富95售09,,,,,0.00,0.00,0,0,0,0,0,0,0,0,0,0,0,0,0
20200430,052290,鴻海元富97購01,0.08,0.08,0.08,0.08,0.00,0.00,70000,1,5600,0,0,0,0,0,0,70000,0,70000,70000
20200430,052291,鴻海元富97購02,,,,,0.00,0.00,0,0,0,0,0,0,0,0,0,0,0,0,0
20200430,052292,緯穎元富95購02,,,,,0.00,0.00,0,0,0,0,0,0,0,0,0,0,0,0,0
20200430,052293,泰碩國票95購03,,,,,0.00,0.00,0,0,0,0,0,0,0,0,0,0,0,0,0
20200430,052294,創意國票96購03,1.29,1.39,1.29,1.39,+0.07,5.3,18000,3,23620,0,0,0,0,0,0,14000,4000,10000,10000
20200430,052295,揚明光國票96購03,0.75,0.75,0.75,0.75,-0.02,-2.6,39000,1,29250,0,0,0,0,0,0,39000,0,39000,39000
20200430,052296,TPK國票96購01,,,,,0.00,0.00,0,0,0,0,0,0,0,0,0,0,0,0,0
20200430,052297,旭富國票96購01,,,,,0.00,0.00,0,0,0,0,0,0,0,0,0,0,0,0,0
20200430,052298,易華電國票96購01,0.61,0.64,0.61,0.64,+0.02,3.23,185000,10,115180,0,0,0,0,0,0,49000,136000,-87000,-87000
20200430,052299,T50反1台新05購03,,,,,0.00,0.00,0,0,0,0,0,0,0,0,0,0,0,0,0
20200430,05229P,台積電群益95售05,,,,,0.00,0.00,0,0,0,0,0,0,0,0,0,0,0,0,0
20200430,052300,力成台新95購01,0.52,0.57,0.52,0.57,0.00,0.00,30000,2,16100,0,0,0,0,0,0,30000,0,30000,30000
20200430,052301,華通康和95購01,,,,,0.00,0.00,0,0,0,0,0,0,0,0,0,0,0,0,0
20200430,052302,鴻海永豐95購06,,,,,0.00,0.00,0,0,0,0,0,0,0,0,0,0,0,0,0
20200430,052303,聯發科永豐95購05,,,,,0.00,0.00,0,0,0,0,0,0,0,0,0,0,0,0,0
20200430,052304,可成永豐95購03,0.12,0.12,0.12,0.12,0.00,0.00,110000,1,13200,0,0,0,0,0,0,110000,0,110000,110000
20200430,052305,GIS永豐95購03,0.17,0.17,0.15,0.16,+0.01,6.67,60000,6,9400,0,0,0,0,0,0,0,60000,-60000,-60000
20200430,052306,鴻海國泰97購05,,,,,0.00,0.00,0,0,0,0,0,0,0,0,0,0,0,0,0
20200430,052307,潤泰全國泰96購01,,,,,0.00,0.00,0,0,0,0,0,0,0,0,0,0,0,0,0
20200430,052308,大立光國泰97購02,,,,,0.00,0.00,0,0,0,0,0,0,0,0,0,0,0,0,0
20200430,052309,健策國泰97購01,1.76,1.88,1.76,1.88,+0.12,6.82,55000,2,97400,0,0,0,0,0,0,55000,0,55000,55000
20200430,05230P,京元電群益95售01,,,,,0.00,0.00,0,0,0,0,0,0,0,0,0,0,0,0,0
20200430,052310,聯電富邦95購01,,,,,0.00,0.00,0,0,0,0,0,0,0,0,0,0,0,0,0
20200430,052311,台積電富邦95購09,,,,,0.00,0.00,0,0,0,0,0,0,0,0,0,0,0,0,0
20200430,052312,美律富邦96購02,0.20,0.20,0.20,0.20,+0.01,5.26,10000,1,2000,0,0,0,0,0,0,10000,0,10000,10000
20200430,052313,聯電元大98購01,0.86,0.86,0.82,0.82,+0.05,6.49,31000,2,25460,0,0,0,0,0,0,31000,0,31000,31000
20200430,052314,鴻海元大96購11,0.07,0.07,0.07,0.07,+0.01,16.67,1000,1,70,0,0,0,0,0,0,0,0,0,0
20200430,052315,廣宇元大95購02,,,,,0.00,0.00,0,0,0,0,0,0,0,0,0,0,0,0,0
20200430,052316,台積電元大96購10,0.36,0.36,0.36,0.36,-0.03,-7.69,20000,2,7200,0,0,0,0,0,0,20000,0,20000,20000
20200430,052317,台積電元大96購11,0.52,0.52,0.52,0.52,+0.02,4.0,20000,3,10400,0,0,0,0,0,0,0,0,0,0
20200430,052318,友達元大98購01,,,,,0.00,0.00,0,0,0,0,0,0,0,0,0,0,0,0,0
20200430,052319,可成元大95購12,,,,,0.00,0.00,0,0,0,0,0,0,0,0,0,0,0,0,0
20200430,05231P,GIS群益95售03,,,,,0.00,0.00,0,0,0,0,0,0,0,0,0,0,0,0,0
20200430,052320,緯創元大95購05,,,,,0.00,0.00,0,0,0,0,0,0,0,0,0,0,0,0,0
20200430,052321,華擎元大95購01,,,,,0.00,0.00,0,0,0,0,0,0,0,0,0,0,0,0,0
20200430,052322,力成元大96購01,,,,,0.00,0.00,0,0,0,0,0,0,0,0,0,0,0,0,0
20200430,052323,矽力元大95購04,,,,,0.00,0.00,0,0,0,0,0,0,0,0,0,0,0,0,0
20200430,052324,康友元大96購02,0.24,0.27,0.24,0.27,0.00,0.00,300000,5,72600,0,0,0,0,0,0,280000,20000,260000,260000
20200430,052325,高股息中信99購01,1.82,1.93,1.81,1.93,+0.18,10.29,59000,13,110700,0,0,0,0,0,0,55000,4000,51000,51000
20200430,052326,滬深反中信99購01,0.54,0.58,0.54,0.58,0.00,0.00,196000,3,105880,0,0,0,0,0,0,110000,86000,24000,24000
20200430,052327,聯詠中信95購03,,,,,0.00,0.00,0,0,0,0,0,0,0,0,0,0,0,0,0
20200430,052328,台表科中信99購01,0.17,0.19,0.17,0.19,+0.01,5.56,51000,2,8690,0,0,0,0,0,0,50000,1000,49000,49000
20200430,052329,台積電亞東96購01,,,,,0.00,0.00,0,0,0,0,0,0,0,0,0,0,0,0,0
20200430,05232P,緯穎群益95售01,,,,,0.00,0.00,0,0,0,0,0,0,0,0,0,0,0,0,0
20200430,052330,燿華亞東95購01,,,,,0.00,0.00,0,0,0,0,0,0,0,0,0,0,0,0,0
20200430,052331,漢唐亞東97購01,,,,,0.00,0.00,0,0,0,0,0,0,0,0,0,0,0,0,0
20200430,052332,美律亞東96購01,,,,,0.00,0.00,0,0,0,0,0,0,0,0,0,0,0,0,0
20200430,052333,嘉聯益兆豐96購01,,,,,0.00,0.00,0,0,0,0,0,0,0,0,0,0,0,0,0
20200430,052334,大成鋼日盛95購01,,,,,0.00,0.00,0,0,0,0,0,0,0,0,0,0,0,0,0
20200430,052335,新光金日盛95購02,,,,,0.00,0.00,0,0,0,0,0,0,0,0,0,0,0,0,0
20200430,052336,矽力日盛95購01,,,,,0.00,0.00,0,0,0,0,0,0,0,0,0,0,0,0,0
20200430,052337,臺股指日盛95購02,,,,,0.00,0.00,0,0,0,0,0,0,0,0,0,0,0,0,0
20200430,052338,道瓊反凱基97購02,,,,,0.00,0.00,0,0,0,0,0,0,0,0,0,0,0,0,0
20200430,052339,光寶科凱基95購01,,,,,0.00,0.00,0,0,0,0,0,0,0,0,0,0,0,0,0
20200430,05233P,台郡台新95售02,,,,,0.00,0.00,0,0,0,0,0,0,0,0,0,0,0,0,0
20200430,052340,燿華凱基96購01,,,,,0.00,0.00,0,0,0,0,0,0,0,0,0,0,0,0,0
20200430,052341,泰鼎凱基96購02,,,,,0.00,0.00,0,0,0,0,0,0,0,0,0,0,0,0,0
20200430,052342,茂林凱基96購01,,,,,0.00,0.00,0,0,0,0,0,0,0,0,0,0,0,0,0
20200430,052343,同欣電凱基95購03,,,,,0.00,0.00,0,0,0,0,0,0,0,0,0,0,0,0,0
20200430,052344,台表科凱基98購01,,,,,0.00,0.00,0,0,0,0,0,0,0,0,0,0,0,0,0
20200430,052345,矽力凱基95購01,,,,,0.00,0.00,0,0,0,0,0,0,0,0,0,0,0,0,0
20200430,052346,訊芯凱基95購01,,,,,0.00,0.00,0,0,0,0,0,0,0,0,0,0,0,0,0
20200430,052347,GIS凱基95購05,,,,,0.00,0.00,0,0,0,0,0,0,0,0,0,0,0,0,0
20200430,052348,台光電富邦95購01,,,,,0.00,0.00,0,0,0,0,0,0,0,0,0,0,0,0,0
20200430,052349,鴻海統一95購15,,,,,0.00,0.00,0,0,0,0,0,0,0,0,0,0,0,0,0
20200430,05234P,美食康和95售01,,,,,0.00,0.00,0,0,0,0,0,0,0,0,0,0,0,0,0
20200430,052350,鴻海統一96購06,,,,,0.00,0.00,0,0,0,0,0,0,0,0,0,0,0,0,0
20200430,052351,中環元富95購01,,,,,0.00,0.00,0,0,0,0,0,0,0,0,0,0,0,0,0
20200430,052352,力成元富95購01,,,,,0.00,0.00,0,0,0,0,0,0,0,0,0,0,0,0,0
20200430,052353,高鐵群益97購01,0.29,0.29,0.29,0.29,+0.02,7.41,10000,1,2900,0,0,0,0,0,0,10000,0,10000,10000
20200430,052354,健策群益96購02,1.20,1.25,1.20,1.25,0.00,0.00,20000,2,24500,0,0,0,0,0,0,20000,0,20000,20000
20200430,052355,為升永豐95購02,,,,,0.00,0.00,0,0,0,0,0,0,0,0,0,0,0,0,0
20200430,052356,聯詠永豐95購03,,,,,0.00,0.00,0,0,0,0,0,0,0,0,0,0,0,0,0
20200430,052357,揚明光永豐95購03,,,,,0.00,0.00,0,0,0,0,0,0,0,0,0,0,0,0,0
20200430,052358,台表科永豐95購02,,,,,0.00,0.00,0,0,0,0,0,0,0,0,0,0,0,0,0
20200430,052359,百和永豐95購01,0.04,0.04,0.04,0.04,0.00,0.00,10000,1,400,0,0,0,0,0,0,10000,0,10000,10000
20200430,05235P,健鼎康和95售02,,,,,0.00,0.00,0,0,0,0,0,0,0,0,0,0,0,0,0
20200430,052360,FB上証國票96購01,0.22,0.22,0.22,0.22,+0.04,22.22,10000,1,2200,0,0,0,0,0,0,10000,0,10000,10000
20200430,052361,大成鋼國票96購01,,,,,0.00,0.00,0,0,0,0,0,0,0,0,0,0,0,0,0
20200430,052362,瑞昱國票96購02,2.98,3.49,2.91,3.49,+0.60,20.76,146000,7,458700,0,0,0,0,0,0,71000,75000,-4000,-4000
20200430,052363,廣達國票96購01,0.19,0.22,0.19,0.22,+0.02,10.0,83000,4,17170,0,0,0,0,0,0,0,0,0,0
20200430,052364,全新國票95購02,,,,,0.00,0.00,0,0,0,0,0,0,0,0,0,0,0,0,0
20200430,052365,聯詠國票95購02,,,,,0.00,0.00,0,0,0,0,0,0,0,0,0,0,0,0,0
20200430,052366,聯詠國票96購01,0.04,0.04,0.04,0.04,0.00,0.00,10000,1,400,0,0,0,0,0,0,0,10000,-10000,-10000
20200430,052367,聯茂國票96購02,1.45,1.45,1.45,1.45,-0.15,-9.38,93000,1,134850,0,0,0,0,0,0,93000,0,93000,93000
20200430,052368,力成國票96購01,,,,,0.00,0.00,0,0,0,0,0,0,0,0,0,0,0,0,0
20200430,052369,矽力國票96購02,,,,,0.00,0.00,0,0,0,0,0,0,0,0,0,0,0,0,0
20200430,05236P,緯穎康和95售01,,,,,0.00,0.00,0,0,0,0,0,0,0,0,0,0,0,0,0
20200430,052370,滬深2X元大95購04,,,,,0.00,0.00,0,0,0,0,0,0,0,0,0,0,0,0,0
20200430,052371,元金2X元大95購01,,,,,0.00,0.00,0,0,0,0,0,0,0,0,0,0,0,0,0
20200430,052372,台泥元大95購02,0.36,0.36,0.36,0.36,0.00,0.00,68000,3,24480,0,0,0,0,0,0,68000,0,68000,68000
20200430,052373,鴻海元大95購22,,,,,0.00,0.00,0,0,0,0,0,0,0,0,0,0,0,0,0
20200430,052374,瑞昱元大95購02,2.61,3.02,2.61,3.02,+0.72,31.3,57000,5,157130,0,0,0,0,0,0,37000,26000,11000,11000
20200430,052375,奇力新元大96購02,,,,,0.00,0.00,0,0,0,0,0,0,0,0,0,0,0,0,0
20200430,052376,聯詠元大95購04,,,,,0.00,0.00,0,0,0,0,0,0,0,0,0,0,0,0,0
20200430,052377,景碩元大96購02,,,,,0.00,0.00,0,0,0,0,0,0,0,0,0,0,0,0,0
20200430,052378,矽力元大96購01,6.95,6.95,6.30,6.30,-1.00,-13.7,5000,5,33300,0,0,0,0,0,0,0,5000,-5000,-5000
20200430,052379,鈺齊元大95購04,0.09,0.09,0.09,0.09,0.00,0.00,1000,1,90,0,0,0,0,0,0,0,0,0,0
20200430,05237P,為升永豐95售01,,,,,0.00,0.00,0,0,0,0,0,0,0,0,0,0,0,0,0
20200430,052380,臺股指元大95購21,,,,,0.00,0.00,0,0,0,0,0,0,0,0,0,0,0,0,0
20200430,052381,臺股指元大95購22,,,,,0.00,0.00,0,0,0,0,0,0,0,0,0,0,0,0,0
20200430,052382,臺股指元大95購23,,,,,0.00,0.00,0,0,0,0,0,0,0,0,0,0,0,0,0
20200430,052383,臺股指元大95購29,,,,,0.00,0.00,0,0,0,0,0,0,0,0,0,0,0,0,0
20200430,052384,臺股指元大95購30,,,,,0.00,0.00,0,0,0,0,0,0,0,0,0,0,0,0,0
20200430,052385,滬深2X群益99購05,,,,,0.00,0.00,0,0,0,0,0,0,0,0,0,0,0,0,0
20200430,052386,鴻海群益96購02,0.19,0.19,0.19,0.19,0.00,0.00,50000,1,9500,0,0,0,0,0,0,50000,0,50000,50000
20200430,052387,台積電群益95購08,1.07,1.33,1.07,1.33,+0.40,43.01,25000,3,31950,0,0,0,0,0,0,5000,20000,-15000,-15000
20200430,052388,旺宏群益96購05,3.79,3.85,3.79,3.79,0.00,0.00,8000,3,30380,0,0,0,0,0,0,0,8000,-8000,-8000
20200430,052389,聯發科群益95購05,,,,,0.00,0.00,0,0,0,0,0,0,0,0,0,0,0,0,0
20200430,05238P,禾伸堂永豐95售01,,,,,0.00,0.00,0,0,0,0,0,0,0,0,0,0,0,0,0
20200430,052390,聯詠群益95購03,,,,,0.00,0.00,0,0,0,0,0,0,0,0,0,0,0,0,0
20200430,052391,瑞儀群益95購01,,,,,0.00,0.00,0,0,0,0,0,0,0,0,0,0,0,0,0
20200430,052392,台表科群益96購02,,,,,0.00,0.00,0,0,0,0,0,0,0,0,0,0,0,0,0
20200430,052393,康友群益95購05,,,,,0.00,0.00,0,0,0,0,0,0,0,0,0,0,0,0,0
20200430,052394,滬深2X日盛95購01,,,,,0.00,0.00,0,0,0,0,0,0,0,0,0,0,0,0,0
20200430,052395,上証2X凱基97購01,,,,,0.00,0.00,0,0,0,0,0,0,0,0,0,0,0,0,0
20200430,052396,台積電凱基97購01,,,,,0.00,0.00,0,0,0,0,0,0,0,0,0,0,0,0,0
20200430,052397,燿華凱基96購02,,,,,0.00,0.00,0,0,0,0,0,0,0,0,0,0,0,0,0
20200430,052398,瑞昱凱基95購06,,,,,0.00,0.00,0,0,0,0,0,0,0,0,0,0,0,0,0
20200430,052399,台光電凱基95購03,0.36,0.46,0.36,0.46,0.00,0.00,20000,3,8200,0,0,0,0,0,0,0,20000,-20000,-20000
20200430,05239P,欣興永豐95售03,,,,,0.00,0.00,0,0,0,0,0,0,0,0,0,0,0,0,0
20200430,052400,聯詠凱基97購01,,,,,0.00,0.00,0,0,0,0,0,0,0,0,0,0,0,0,0
20200430,052401,智原凱基95購01,,,,,0.00,0.00,0,0,0,0,0,0,0,0,0,0,0,0,0
20200430,052402,健策凱基97購01,,,,,0.00,0.00,0,0,0,0,0,0,0,0,0,0,0,0,0
20200430,052403,麗豐凱基96購01,,,,,0.00,0.00,0,0,0,0,0,0,0,0,0,0,0,0,0
20200430,052404,臻鼎凱基95購05,,,,,0.00,0.00,0,0,0,0,0,0,0,0,0,0,0,0,0
20200430,052405,聯茂凱基95購01,,,,,0.00,0.00,0,0,0,0,0,0,0,0,0,0,0,0,0
20200430,052406,力成凱基95購03,0.85,0.85,0.85,0.85,0.00,0.00,50000,1,42500,0,0,0,0,0,0,50000,0,50000,50000
20200430,052407,樺漢凱基95購01,,,,,0.00,0.00,0,0,0,0,0,0,0,0,0,0,0,0,0
20200430,052408,羅麗芬凱基95購01,,,,,0.00,0.00,0,0,0,0,0,0,0,0,0,0,0,0,0
20200430,052409,國巨亞東95購01,,,,,0.00,0.00,0,0,0,0,0,0,0,0,0,0,0,0,0
20200430,05240P,玉晶光永豐96售01,0.36,0.36,0.30,0.30,-0.10,-25.0,462000,10,152640,0,0,0,0,0,0,116000,346000,-230000,-230000
20200430,052410,智邦亞東96購01,4.05,4.09,3.88,3.88,+0.07,1.84,14000,6,56560,0,0,0,0,0,0,14000,0,14000,14000
20200430,052411,嘉聯益亞東95購02,,,,,0.00,0.00,0,0,0,0,0,0,0,0,0,0,0,0,0
20200430,052412,上証2X中信98購01,,,,,0.00,0.00,0,0,0,0,0,0,0,0,0,0,0,0,0
20200430,052413,上証反中信97購01,0.95,0.95,0.91,0.91,-0.07,-7.14,85000,2,78550,0,0,0,0,0,0,85000,0,85000,85000
20200430,052414,聯電麥證95購01,0.06,0.07,0.06,0.07,+0.01,16.67,30000,12,2000,20000,0,20000,0,0,0,20000,0,20000,20000
20200430,052415,台表科麥證95購02,,,,,0.00,0.00,0,0,0,0,0,0,0,0,0,0,0,0,0
20200430,052416,滬深2X兆豐96購02,0.16,0.17,0.16,0.17,0.00,0.00,2000,2,330,0,0,0,0,0,0,2000,0,2000,2000
20200430,052417,聯發科兆豐9B購01,1.00,1.20,1.00,1.20,+0.28,30.43,235000,15,256490,0,0,0,0,0,0,225000,20000,205000,205000
20200430,052418,玉晶光兆豐96購01,1.30,1.36,1.30,1.36,+0.13,10.57,7000,3,9280,0,0,0,0,0,0,7000,0,7000,7000
20200430,052419,上証2X國票96購02,,,,,0.00,0.00,0,0,0,0,0,0,0,0,0,0,0,0,0
20200430,05241P,鴻海國泰97售04,2.43,2.43,2.43,2.43,0.00,0.00,5000,1,12150,0,0,0,0,0,0,5000,5000,0,0
20200430,052420,道瓊反國票9B購01,,,,,0.00,0.00,0,0,0,0,0,0,0,0,0,0,0,0,0
20200430,052421,元油反國票9B購01,,,,,0.00,0.00,0,0,0,0,0,0,0,0,0,0,0,0,0
20200430,052422,聯電國票96購03,,,,,0.00,0.00,0,0,0,0,0,0,0,0,0,0,0,0,0
20200430,052423,宏達電國票96購02,0.92,0.94,0.92,0.94,-0.03,-3.09,115000,4,107160,0,0,0,0,0,0,31000,84000,-53000,-53000
20200430,052424,泰碩國票97購01,1.75,1.82,1.71,1.77,+0.04,2.31,312000,5,537440,0,0,0,0,0,0,295000,12000,283000,283000
20200430,052425,華通台新95購02,,,,,0.00,0.00,0,0,0,0,0,0,0,0,0,0,0,0,0
20200430,052426,國巨台新96購01,2.66,2.66,2.66,2.66,0.00,0.00,20000,1,53200,0,0,0,0,0,0,20000,0,20000,20000
20200430,052427,上証2X永豐96購01,,,,,0.00,0.00,0,0,0,0,0,0,0,0,0,0,0,0,0
20200430,052428,嘉晶永豐95購01,0.63,0.73,0.63,0.73,+0.12,19.67,127000,15,90200,0,0,0,0,0,0,0,127000,-127000,-127000
20200430,052429,禾伸堂永豐95購02,1.10,1.10,1.06,1.06,+0.10,10.42,6000,5,6480,0,0,0,0,0,0,6000,0,6000,6000
20200430,05242P,群創國泰97售01,0.84,0.84,0.84,0.84,-0.06,-6.67,475000,2,399000,0,0,0,0,0,0,470000,5000,465000,465000
20200430,052430,泰碩永豐95購02,0.09,0.09,0.09,0.09,-0.03,-25.0,10000,1,900,0,0,0,0,0,0,0,10000,-10000,-10000
20200430,052431,茂林永豐95購03,,,,,0.00,0.00,0,0,0,0,0,0,0,0,0,0,0,0,0
20200430,052432,康友永豐95購04,,,,,0.00,0.00,0,0,0,0,0,0,0,0,0,0,0,0,0
20200430,052433,滬深2X國泰96購02,,,,,0.00,0.00,0,0,0,0,0,0,0,0,0,0,0,0,0
20200430,052434,茂林國泰97購01,1.31,1.31,1.31,1.31,0.00,0.00,10000,1,13100,0,0,0,0,0,0,10000,0,10000,10000
20200430,052435,滬深2X富邦96購05,,,,,0.00,0.00,0,0,0,0,0,0,0,0,0,0,0,0,0
20200430,052436,正崴富邦95購01,,,,,0.00,0.00,0,0,0,0,0,0,0,0,0,0,0,0,0
20200430,052437,聯發科富邦99購02,0.63,0.73,0.63,0.72,+0.11,18.03,389000,29,259680,0,0,0,0,0,0,322000,0,322000,322000
20200430,052438,瑞儀富邦95購01,,,,,0.00,0.00,0,0,0,0,0,0,0,0,0,0,0,0,0
20200430,052439,寶成富邦97購01,0.06,0.06,0.06,0.06,0.00,0.00,3000,1,180,0,0,0,0,0,0,0,0,0,0
20200430,05243P,鴻海元大95售19,,,,,0.00,0.00,0,0,0,0,0,0,0,0,0,0,0,0,0
20200430,052440,上証2X元大95購02,,,,,0.00,0.00,0,0,0,0,0,0,0,0,0,0,0,0,0
20200430,052441,亞泥元大95購01,,,,,0.00,0.00,0,0,0,0,0,0,0,0,0,0,0,0,0
20200430,052442,中環元大95購02,,,,,0.00,0.00,0,0,0,0,0,0,0,0,0,0,0,0,0
20200430,052443,台積電元大95購23,,,,,0.00,0.00,0,0,0,0,0,0,0,0,0,0,0,0,0
20200430,052444,友訊元大95購01,,,,,0.00,0.00,0,0,0,0,0,0,0,0,0,0,0,0,0
20200430,052445,南亞科元大95購05,,,,,0.00,0.00,0,0,0,0,0,0,0,0,0,0,0,0,0
20200430,052446,聯發科元大96購03,0.48,0.49,0.48,0.49,+0.14,40.0,74000,2,36060,0,0,0,0,0,0,74000,0,74000,74000
20200430,052447,聯發科元大96購04,2.06,2.26,2.02,2.26,+0.45,24.86,169000,11,356910,0,0,0,0,0,0,72000,99000,-27000,-27000
20200430,052448,新光金元大96購03,,,,,0.00,0.00,0,0,0,0,0,0,0,0,0,0,0,0,0
20200430,052449,創意元大95購04,,,,,0.00,0.00,0,0,0,0,0,0,0,0,0,0,0,0,0
20200430,05244P,台積電元大95售17,,,,,0.00,0.00,0,0,0,0,0,0,0,0,0,0,0,0,0
20200430,052450,嘉澤元大95購03,,,,,0.00,0.00,0,0,0,0,0,0,0,0,0,0,0,0,0
20200430,052451,旭富元大95購02,1.33,1.33,1.33,1.33,0.00,0.00,3000,1,3990,0,0,0,0,0,0,0,3000,-3000,-3000
20200430,052452,茂林元大95購03,1.50,1.53,1.34,1.34,-0.44,-24.72,188000,7,275670,0,0,0,0,0,0,124000,64000,60000,60000
20200430,052453,崇越元大95購01,0.28,0.31,0.28,0.31,+0.06,24.0,500000,4,149000,0,0,0,0,0,0,500000,0,500000,500000
20200430,052454,力成元大95購02,1.15,1.24,1.15,1.24,+0.27,27.84,39000,6,47660,0,0,0,0,0,0,25000,4000,21000,21000
20200430,052455,樺漢元大96購03,,,,,0.00,0.00,0,0,0,0,0,0,0,0,0,0,0,0,0
20200430,052456,滬深2X元富9B購03,0.32,0.36,0.32,0.36,+0.05,16.13,24000,4,8600,0,0,0,0,0,0,24000,0,24000,24000
20200430,052457,日月光元富95購01,,,,,0.00,0.00,0,0,0,0,0,0,0,0,0,0,0,0,0
20200430,052458,T50反1統一97購01,0.96,0.96,0.96,0.96,+0.38,65.52,10000,1,9600,0,0,0,0,0,0,10000,0,10000,10000
20200430,052459,道瓊反統一95購04,1.00,1.00,1.00,1.00,0.00,0.00,1000,1,1000,0,0,0,0,0,0,0,1000,-1000,-1000
20200430,05245P,台積電元大95售18,,,,,0.00,0.00,0,0,0,0,0,0,0,0,0,0,0,0,0
20200430,052460,元油反統一95購01,,,,,0.00,0.00,0,0,0,0,0,0,0,0,0,0,0,0,0
20200430,052461,和大統一95購01,,,,,0.00,0.00,0,0,0,0,0,0,0,0,0,0,0,0,0
20200430,052462,上銀統一95購03,1.35,1.78,1.31,1.78,+0.55,44.72,869000,21,1289930,0,0,0,0,0,0,325000,544000,-219000,-219000
20200430,052463,聯電統一96購01,0.86,0.87,0.86,0.87,+0.04,4.82,128000,2,110280,0,0,0,0,0,0,20000,108000,-88000,-88000
20200430,052464,大立光統一95購05,,,,,0.00,0.00,0,0,0,0,0,0,0,0,0,0,0,0,0
20200430,052465,聯詠統一95購02,,,,,0.00,0.00,0,0,0,0,0,0,0,0,0,0,0,0,0
20200430,052466,聯詠統一95購03,,,,,0.00,0.00,0,0,0,0,0,0,0,0,0,0,0,0,0
20200430,052467,嘉聯益統一96購01,,,,,0.00,0.00,0,0,0,0,0,0,0,0,0,0,0,0,0
20200430,052468,超眾統一96購02,,,,,0.00,0.00,0,0,0,0,0,0,0,0,0,0,0,0,0
20200430,052469,宏碁亞東95購01,,,,,0.00,0.00,0,0,0,0,0,0,0,0,0,0,0,0,0
20200430,05246P,南電元大95售04,,,,,0.00,0.00,0,0,0,0,0,0,0,0,0,0,0,0,0
20200430,052470,華新科亞東97購01,,,,,0.00,0.00,0,0,0,0,0,0,0,0,0,0,0,0,0
20200430,052471,華固亞東95購01,,,,,0.00,0.00,0,0,0,0,0,0,0,0,0,0,0,0,0
20200430,052472,和碩亞東95購01,,,,,0.00,0.00,0,0,0,0,0,0,0,0,0,0,0,0,0
20200430,052473,臻鼎亞東95購01,,,,,0.00,0.00,0,0,0,0,0,0,0,0,0,0,0,0,0
20200430,052474,T50反1群益95購04,,,,,0.00,0.00,0,0,0,0,0,0,0,0,0,0,0,0,0
20200430,052475,滬深2X群益99購06,,,,,0.00,0.00,0,0,0,0,0,0,0,0,0,0,0,0,0
20200430,052476,台光電群益98購01,0.52,0.59,0.52,0.59,0.00,0.00,70000,7,38700,0,0,0,0,0,0,70000,0,70000,70000
20200430,052477,美律群益98購01,,,,,0.00,0.00,0,0,0,0,0,0,0,0,0,0,0,0,0
20200430,052478,大立光群益95購05,,,,,0.00,0.00,0,0,0,0,0,0,0,0,0,0,0,0,0
20200430,052479,TPK群益95購04,,,,,0.00,0.00,0,0,0,0,0,0,0,0,0,0,0,0,0
20200430,05247P,上銀群益95售01,,,,,0.00,0.00,0,0,0,0,0,0,0,0,0,0,0,0,0
20200430,052480,麗豐群益95購01,,,,,0.00,0.00,0,0,0,0,0,0,0,0,0,0,0,0,0
20200430,052481,利勤群益95購01,,,,,0.00,0.00,0,0,0,0,0,0,0,0,0,0,0,0,0
20200430,052482,茂林群益95購01,,,,,0.00,0.00,0,0,0,0,0,0,0,0,0,0,0,0,0
20200430,052483,超眾群益95購03,1.99,1.99,1.99,1.99,0.00,0.00,59000,1,117410,0,0,0,0,0,0,59000,0,59000,59000
20200430,052484,矽創群益95購02,,,,,0.00,0.00,0,0,0,0,0,0,0,0,0,0,0,0,0
20200430,052485,深中小國票96購01,,,,,0.00,0.00,0,0,0,0,0,0,0,0,0,0,0,0,0
20200430,052486,元油反國票96購01,,,,,0.00,0.00,0,0,0,0,0,0,0,0,0,0,0,0,0
20200430,052487,國巨國票96購07,,,,,0.00,0.00,0,0,0,0,0,0,0,0,0,0,0,0,0
20200430,052488,旺宏國票96購03,3.31,3.31,3.31,3.31,0.00,0.00,10000,1,33100,0,0,0,0,0,0,10000,0,10000,10000
20200430,052489,義隆國票96購02,1.59,1.77,1.59,1.77,0.00,0.00,151000,6,252370,0,0,0,0,0,0,0,151000,-151000,-151000
20200430,05248P,矽創群益96售01,,,,,0.00,0.00,0,0,0,0,0,0,0,0,0,0,0,0,0
20200430,052490,禾伸堂國票95購01,,,,,0.00,0.00,0,0,0,0,0,0,0,0,0,0,0,0,0
20200430,052491,泰碩國票99購01,1.47,1.49,1.43,1.44,-0.04,-2.7,142000,8,206950,0,0,0,0,0,0,67000,55000,12000,12000
20200430,052492,易華電國票96購02,0.38,0.41,0.38,0.41,+0.03,7.89,44000,5,17660,0,0,0,0,0,0,1000,43000,-42000,-42000
20200430,052493,上証2X中信97購02,,,,,0.00,0.00,0,0,0,0,0,0,0,0,0,0,0,0,0
20200430,052494,百和中信95購02,,,,,0.00,0.00,0,0,0,0,0,0,0,0,0,0,0,0,0
20200430,052495,滬深2X台新95購01,,,,,0.00,0.00,0,0,0,0,0,0,0,0,0,0,0,0,0
20200430,052496,華通台新96購02,0.04,0.04,0.04,0.04,+0.01,33.33,10000,1,400,0,0,0,0,0,0,10000,0,10000,10000
20200430,052497,楠梓電永豐96購01,,,,,0.00,0.00,0,0,0,0,0,0,0,0,0,0,0,0,0
20200430,052498,台積電永豐95購06,0.14,0.15,0.14,0.15,+0.05,50.0,281000,2,42140,0,0,0,0,0,0,281000,0,281000,281000
20200430,052499,合勤控永豐95購01,0.01,0.01,0.01,0.01,0.00,0.00,280000,3,2800,0,0,0,0,0,0,280000,0,280000,280000
20200430,05249P,臻鼎國票95售01,,,,,0.00,0.00,0,0,0,0,0,0,0,0,0,0,0,0,0
20200430,052500,元翎永豐95購01,,,,,0.00,0.00,0,0,0,0,0,0,0,0,0,0,0,0,0
20200430,052501,茂林永豐95購04,,,,,0.00,0.00,0,0,0,0,0,0,0,0,0,0,0,0,0
20200430,052502,瀚宇博永豐95購02,,,,,0.00,0.00,0,0,0,0,0,0,0,0,0,0,0,0,0
20200430,052503,大成鋼日盛95購02,,,,,0.00,0.00,0,0,0,0,0,0,0,0,0,0,0,0,0
20200430,052504,鴻海日盛95購03,,,,,0.00,0.00,0,0,0,0,0,0,0,0,0,0,0,0,0
20200430,052505,友達日盛9B購02,,,,,0.00,0.00,0,0,0,0,0,0,0,0,0,0,0,0,0
20200430,052506,日月光日盛95購01,,,,,0.00,0.00,0,0,0,0,0,0,0,0,0,0,0,0,0
20200430,052507,日月光日盛95購02,,,,,0.00,0.00,0,0,0,0,0,0,0,0,0,0,0,0,0
20200430,052508,矽力日盛95購02,,,,,0.00,0.00,0,0,0,0,0,0,0,0,0,0,0,0,0
20200430,052509,鴻海凱基96購10,,,,,0.00,0.00,0,0,0,0,0,0,0,0,0,0,0,0,0
20200430,05250P,臻鼎國票96售01,6.05,6.05,6.05,6.05,0.00,0.00,3000,1,18150,0,0,0,0,0,0,0,3000,-3000,-3000
20200430,052510,聯發科凱基95購13,0.80,0.80,0.80,0.80,0.00,0.00,10000,1,8000,0,0,0,0,0,0,0,10000,-10000,-10000
20200430,052511,聯發科凱基95購14,1.80,1.84,1.80,1.84,+0.48,35.29,20000,2,36400,0,0,0,0,0,0,0,20000,-20000,-20000
20200430,052512,全新凱基96購03,0.14,0.14,0.14,0.14,0.00,0.00,1000,1,140,0,0,0,0,0,0,1000,0,1000,1000
20200430,052513,大立光凱基95購13,0.54,0.59,0.54,0.59,+0.07,13.46,190000,2,111600,0,0,0,0,0,0,180000,10000,170000,170000
20200430,052514,嘉澤凱基96購01,0.31,0.31,0.31,0.31,+0.16,106.67,5000,1,1550,0,0,0,0,0,0,0,0,0,0
20200430,052515,矽力凱基95購02,,,,,0.00,0.00,0,0,0,0,0,0,0,0,0,0,0,0,0
20200430,052516,臺股指凱基95購20,,,,,0.00,0.00,0,0,0,0,0,0,0,0,0,0,0,0,0
20200430,052517,滬深2X元大95購05,,,,,0.00,0.00,0,0,0,0,0,0,0,0,0,0,0,0,0
20200430,052518,道瓊反元大95購02,0.09,0.17,0.09,0.17,+0.03,21.43,20000,2,2600,0,0,0,0,0,0,10000,10000,0,0
20200430,052519,旺宏元大95購05,2.23,2.23,2.23,2.23,+0.49,28.16,38000,1,84740,0,0,0,0,0,0,38000,38000,0,0
20200430,05251P,喬山台新95售02,,,,,0.00,0.00,0,0,0,0,0,0,0,0,0,0,0,0,0
20200430,052520,南亞科元大95購06,,,,,0.00,0.00,0,0,0,0,0,0,0,0,0,0,0,0,0
20200430,052521,友達元大9B購01,,,,,0.00,0.00,0,0,0,0,0,0,0,0,0,0,0,0,0
20200430,052522,聯發科元大96購05,0.30,0.30,0.30,0.30,+0.10,50.0,9000,2,2700,0,0,0,0,0,0,0,0,0,0
20200430,052523,奇力新元大97購01,1.10,1.10,1.10,1.10,+0.19,20.88,20000,1,22000,0,0,0,0,0,0,0,0,0,0
20200430,052524,新光金元大9B購01,,,,,0.00,0.00,0,0,0,0,0,0,0,0,0,0,0,0,0
20200430,052525,聯詠元大95購06,,,,,0.00,0.00,0,0,0,0,0,0,0,0,0,0,0,0,0
20200430,052526,智伸科元大96購02,,,,,0.00,0.00,0,0,0,0,0,0,0,0,0,0,0,0,0
20200430,052527,泰鼎元大96購02,2.05,2.05,1.94,2.02,-0.12,-5.61,180000,9,359870,0,0,0,0,0,0,55000,125000,-70000,-70000
20200430,052528,茂林元大95購05,,,,,0.00,0.00,0,0,0,0,0,0,0,0,0,0,0,0,0
20200430,052529,力成元大95購03,1.11,1.28,1.05,1.28,+0.20,18.52,338000,15,370320,0,0,0,0,0,0,180000,158000,22000,22000
20200430,05252P,華通凱基95售01,,,,,0.00,0.00,0,0,0,0,0,0,0,0,0,0,0,0,0
20200430,052530,台郡元大96購04,,,,,0.00,0.00,0,0,0,0,0,0,0,0,0,0,0,0,0
20200430,052531,台積電國泰96購06,,,,,0.00,0.00,0,0,0,0,0,0,0,0,0,0,0,0,0
20200430,052532,台積電國泰96購07,,,,,0.00,0.00,0,0,0,0,0,0,0,0,0,0,0,0,0
20200430,052533,聯發科國泰96購03,0.50,0.60,0.50,0.60,+0.21,53.85,30000,5,15360,0,0,0,0,0,0,27000,0,27000,27000
20200430,052534,貿聯國泰96購02,,,,,0.00,0.00,0,0,0,0,0,0,0,0,0,0,0,0,0
20200430,052535,日月光國泰96購01,,,,,0.00,0.00,0,0,0,0,0,0,0,0,0,0,0,0,0
20200430,052536,聯茂國泰97購01,1.47,1.47,1.41,1.41,-0.03,-2.08,31000,15,44960,0,0,0,0,0,0,31000,0,31000,31000
20200430,052537,力成富邦95購01,,,,,0.00,0.00,0,0,0,0,0,0,0,0,0,0,0,0,0
20200430,052538,和大統一95購02,0.27,0.27,0.27,0.27,0.00,0.00,134000,3,36180,0,0,0,0,0,0,0,134000,-134000,-134000
20200430,052539,華邦電統一95購01,,,,,0.00,0.00,0,0,0,0,0,0,0,0,0,0,0,0,0
20200430,05253P,智邦凱基95售08,,,,,0.00,0.00,0,0,0,0,0,0,0,0,0,0,0,0,0
20200430,052540,華新科統一95購03,,,,,0.00,0.00,0,0,0,0,0,0,0,0,0,0,0,0,0
20200430,052541,大立光統一95購06,,,,,0.00,0.00,0,0,0,0,0,0,0,0,0,0,0,0,0
20200430,052542,友達元富98購01,0.85,0.87,0.84,0.86,+0.02,2.38,739000,12,633580,0,0,0,0,0,0,236000,503000,-267000,-267000
20200430,052543,聯詠元富95購01,,,,,0.00,0.00,0,0,0,0,0,0,0,0,0,0,0,0,0
20200430,052544,牧德元富95購01,1.80,1.80,1.80,1.80,0.00,0.00,10000,1,18000,0,0,0,0,0,0,0,10000,-10000,-10000
20200430,052545,康控元富95購02,,,,,0.00,0.00,0,0,0,0,0,0,0,0,0,0,0,0,0
20200430,052546,友達中信98購01,,,,,0.00,0.00,0,0,0,0,0,0,0,0,0,0,0,0,0
20200430,052547,光磊兆豐96購01,,,,,0.00,0.00,0,0,0,0,0,0,0,0,0,0,0,0,0
20200430,052548,旺宏亞東96購01,,,,,0.00,0.00,0,0,0,0,0,0,0,0,0,0,0,0,0
20200430,052549,喬山國票97購01,,,,,0.00,0.00,0,0,0,0,0,0,0,0,0,0,0,0,0
20200430,05254P,瑞昱凱基95售04,,,,,0.00,0.00,0,0,0,0,0,0,0,0,0,0,0,0,0
20200430,052550,鴻海國票97購02,,,,,0.00,0.00,0,0,0,0,0,0,0,0,0,0,0,0,0
20200430,052551,台積電國票97購03,,,,,0.00,0.00,0,0,0,0,0,0,0,0,0,0,0,0,0
20200430,052552,智邦國票97購01,,,,,0.00,0.00,0,0,0,0,0,0,0,0,0,0,0,0,0
20200430,052553,技嘉國票96購01,,,,,0.00,0.00,0,0,0,0,0,0,0,0,0,0,0,0,0
20200430,052554,正崴國票97購01,,,,,0.00,0.00,0,0,0,0,0,0,0,0,0,0,0,0,0
20200430,052555,漢唐國票97購01,,,,,0.00,0.00,0,0,0,0,0,0,0,0,0,0,0,0,0
20200430,052556,聯發科國票97購01,,,,,0.00,0.00,0,0,0,0,0,0,0,0,0,0,0,0,0
20200430,052557,群創國票97購02,,,,,0.00,0.00,0,0,0,0,0,0,0,0,0,0,0,0,0
20200430,052558,新唐國票97購01,,,,,0.00,0.00,0,0,0,0,0,0,0,0,0,0,0,0,0
20200430,052559,茂林國票97購01,,,,,0.00,0.00,0,0,0,0,0,0,0,0,0,0,0,0,0
20200430,05255P,義隆凱基95售01,,,,,0.00,0.00,0,0,0,0,0,0,0,0,0,0,0,0,0
20200430,052560,康舒國票97購01,0.43,0.47,0.43,0.47,0.00,0.00,275000,3,121920,0,0,0,0,0,0,0,275000,-275000,-275000
20200430,052561,矽創國票97購01,0.82,0.83,0.80,0.82,+0.01,1.23,239000,8,196280,0,0,0,0,0,0,201000,38000,163000,163000
20200430,052562,南亞科日盛96購01,0.59,0.59,0.59,0.59,+0.05,9.26,20000,1,11800,0,0,0,0,0,0,20000,0,20000,20000
20200430,052563,京元電日盛96購01,0.13,0.13,0.06,0.06,0.00,0.00,170000,2,10900,0,0,0,0,0,0,160000,0,160000,160000
20200430,052564,美食日盛96購01,,,,,0.00,0.00,0,0,0,0,0,0,0,0,0,0,0,0,0
20200430,052565,上銀凱基96購01,0.86,0.86,0.86,0.86,0.00,0.00,5000,1,4300,0,0,0,0,0,0,0,5000,-5000,-5000
20200430,052566,國巨凱基96購04,,,,,0.00,0.00,0,0,0,0,0,0,0,0,0,0,0,0,0
20200430,052567,台積電凱基96購05,,,,,0.00,0.00,0,0,0,0,0,0,0,0,0,0,0,0,0
20200430,052568,漢唐凱基96購02,0.65,0.65,0.64,0.64,+0.02,3.23,50000,2,32200,0,0,0,0,0,0,20000,30000,-10000,-10000
20200430,052569,聯發科凱基96購08,0.06,0.06,0.06,0.06,+0.03,100.0,160000,5,9600,0,0,0,0,0,0,130000,0,130000,130000
20200430,05256P,義隆凱基95售02,,,,,0.00,0.00,0,0,0,0,0,0,0,0,0,0,0,0,0
20200430,052570,華新科凱基96購06,,,,,0.00,0.00,0,0,0,0,0,0,0,0,0,0,0,0,0
20200430,052571,新光金凱基98購02,,,,,0.00,0.00,0,0,0,0,0,0,0,0,0,0,0,0,0
20200430,052572,群創凱基99購01,1.00,1.00,1.00,1.00,+0.05,5.26,60000,2,60000,0,0,0,0,0,0,0,60000,-60000,-60000
20200430,052573,智伸科凱基97購01,,,,,0.00,0.00,0,0,0,0,0,0,0,0,0,0,0,0,0
20200430,052574,茂林凱基96購02,,,,,0.00,0.00,0,0,0,0,0,0,0,0,0,0,0,0,0
20200430,052575,茂林凱基96購04,0.28,0.28,0.28,0.28,0.00,0.00,10000,1,2800,0,0,0,0,0,0,10000,0,10000,10000
20200430,052576,聯茂凱基96購01,0.94,0.94,0.89,0.90,-0.11,-10.89,83000,8,76110,0,0,0,0,0,0,83000,64000,19000,19000
20200430,052577,台積電統一96購01,,,,,0.00,0.00,0,0,0,0,0,0,0,0,0,0,0,0,0
20200430,052578,大立光統一97購01,0.45,0.45,0.45,0.45,0.00,0.00,5000,1,2250,0,0,0,0,0,0,5000,0,5000,5000
20200430,052579,亞泥元富96購01,,,,,0.00,0.00,0,0,0,0,0,0,0,0,0,0,0,0,0
20200430,05257P,欣興凱基95售04,,,,,0.00,0.00,0,0,0,0,0,0,0,0,0,0,0,0,0
20200430,052580,高鐵元富96購01,,,,,0.00,0.00,0,0,0,0,0,0,0,0,0,0,0,0,0
20200430,052581,訊芯元富98購01,0.61,0.68,0.61,0.66,+0.05,8.2,120000,14,76900,0,0,0,0,0,0,40000,80000,-40000,-40000
20200430,052582,喬山台新96購01,0.01,0.01,0.01,0.01,0.00,0.00,10000,1,100,0,0,0,0,0,0,0,10000,-10000,-10000
20200430,052583,友達台新96購02,,,,,0.00,0.00,0,0,0,0,0,0,0,0,0,0,0,0,0
20200430,052584,喬山永豐96購01,,,,,0.00,0.00,0,0,0,0,0,0,0,0,0,0,0,0,0
20200430,052585,友達永豐97購01,,,,,0.00,0.00,0,0,0,0,0,0,0,0,0,0,0,0,0
20200430,052586,晶豪科永豐96購01,1.14,1.28,0.94,0.94,-0.03,-3.09,217000,34,245690,0,0,0,0,0,0,144000,73000,71000,71000
20200430,052587,景碩永豐97購01,0.46,0.55,0.46,0.54,+0.07,14.89,59000,6,28990,0,0,0,0,0,0,12000,47000,-35000,-35000
20200430,052588,玉晶光永豐98購01,1.21,1.34,1.20,1.34,+0.22,19.64,73000,7,91470,0,0,0,0,0,0,42000,31000,11000,11000
20200430,052589,群創永豐97購01,,,,,0.00,0.00,0,0,0,0,0,0,0,0,0,0,0,0,0
20200430,05258P,臺股指凱基96售11,,,,,0.00,0.00,0,0,0,0,0,0,0,0,0,0,0,0,0
20200430,052590,祥碩永豐96購01,2.26,2.30,1.57,1.57,-0.59,-27.31,459000,28,936030,0,0,0,0,0,0,231000,204000,27000,27000
20200430,052591,康友永豐97購01,,,,,0.00,0.00,0,0,0,0,0,0,0,0,0,0,0,0,0
20200430,052592,華通群益98購01,,,,,0.00,0.00,0,0,0,0,0,0,0,0,0,0,0,0,0
20200430,052593,台積電群益96購02,,,,,0.00,0.00,0,0,0,0,0,0,0,0,0,0,0,0,0
20200430,052594,友訊群益98購01,,,,,0.00,0.00,0,0,0,0,0,0,0,0,0,0,0,0,0
20200430,052595,奇力新群益96購01,0.12,0.12,0.11,0.11,0.00,0.00,20000,2,2300,0,0,0,0,0,0,10000,0,10000,10000
20200430,052596,群創群益98購05,,,,,0.00,0.00,0,0,0,0,0,0,0,0,0,0,0,0,0
20200430,052597,茂林群益96購01,,,,,0.00,0.00,0,0,0,0,0,0,0,0,0,0,0,0,0
20200430,052598,滬深2X元大96購05,,,,,0.00,0.00,0,0,0,0,0,0,0,0,0,0,0,0,0
20200430,052599,S&P反1元大96購01,0.48,0.48,0.45,0.45,-0.11,-19.64,94000,6,43110,0,0,0,0,0,0,74000,20000,54000,54000
20200430,05259P,臺股指凱基96售12,,,,,0.00,0.00,0,0,0,0,0,0,0,0,0,0,0,0,0
20200430,052600,力山元大97購01,,,,,0.00,0.00,0,0,0,0,0,0,0,0,0,0,0,0,0
20200430,052601,大成鋼元大96購01,,,,,0.00,0.00,0,0,0,0,0,0,0,0,0,0,0,0,0
20200430,052602,聯電元大97購01,0.32,0.44,0.32,0.44,+0.14,46.67,136000,11,48400,0,0,0,0,0,0,77000,1000,76000,76000
20200430,052603,鴻海元大96購15,,,,,0.00,0.00,0,0,0,0,0,0,0,0,0,0,0,0,0
20200430,052604,建準元大97購01,,,,,0.00,0.00,0,0,0,0,0,0,0,0,0,0,0,0,0
20200430,052605,聯發科元大96購06,,,,,0.00,0.00,0,0,0,0,0,0,0,0,0,0,0,0,0
20200430,052606,聯發科元大97購04,0.86,0.86,0.86,0.86,+0.43,100.0,10000,1,8600,0,0,0,0,0,0,10000,0,10000,10000
20200430,052607,大立光元大96購03,,,,,0.00,0.00,0,0,0,0,0,0,0,0,0,0,0,0,0
20200430,052608,欣興元大97購01,,,,,0.00,0.00,0,0,0,0,0,0,0,0,0,0,0,0,0
20200430,052609,智易元大97購01,,,,,0.00,0.00,0,0,0,0,0,0,0,0,0,0,0,0,0
20200430,05260P,和碩元富95售02,0.24,0.26,0.24,0.26,0.00,0.00,50000,2,12600,0,0,0,0,0,0,50000,0,50000,50000
20200430,052610,貿聯元大97購01,0.14,0.19,0.14,0.19,+0.01,5.56,89000,6,14460,0,0,0,0,0,0,79000,0,79000,79000
20200430,052611,力成元大96購02,1.08,1.19,1.03,1.19,+0.18,17.82,295000,18,316610,0,0,0,0,0,0,218000,77000,141000,141000
20200430,052612,康舒元大97購01,,,,,0.00,0.00,0,0,0,0,0,0,0,0,0,0,0,0,0
20200430,052613,易華電元大96購01,,,,,0.00,0.00,0,0,0,0,0,0,0,0,0,0,0,0,0
20200430,052614,聯電國泰97購01,,,,,0.00,0.00,0,0,0,0,0,0,0,0,0,0,0,0,0
20200430,052615,鴻海國泰98購01,0.12,0.12,0.12,0.12,+0.04,50.0,20000,1,2400,0,0,0,0,0,0,0,0,0,0
20200430,052616,鴻海國泰98購02,,,,,0.00,0.00,0,0,0,0,0,0,0,0,0,0,0,0,0
20200430,052617,景碩國泰98購01,,,,,0.00,0.00,0,0,0,0,0,0,0,0,0,0,0,0,0
20200430,052618,群創國泰98購01,0.25,0.25,0.24,0.25,0.00,0.00,280000,28,69000,0,0,0,0,0,0,280000,280000,0,0
20200430,052619,茂林國泰99購01,1.11,1.11,1.01,1.07,+0.03,2.88,273000,4,282430,0,0,0,0,0,0,210000,263000,-53000,-53000
20200430,05261P,鴻海元大95售20,,,,,0.00,0.00,0,0,0,0,0,0,0,0,0,0,0,0,0
20200430,052620,上証2X富邦97購02,0.10,0.10,0.10,0.10,0.00,0.00,11000,2,1100,0,0,0,0,0,0,0,0,0,0
20200430,052621,台郡富邦97購01,,,,,0.00,0.00,0,0,0,0,0,0,0,0,0,0,0,0,0
20200430,052622,貿聯兆豐97購01,0.16,0.23,0.16,0.22,+0.07,46.67,99000,14,20690,0,0,0,0,0,0,64000,33000,31000,31000
20200430,052623,台郡兆豐96購01,,,,,0.00,0.00,0,0,0,0,0,0,0,0,0,0,0,0,0
20200430,052624,微星亞東97購01,,,,,0.00,0.00,0,0,0,0,0,0,0,0,0,0,0,0,0
20200430,052625,南電亞東97購01,,,,,0.00,0.00,0,0,0,0,0,0,0,0,0,0,0,0,0
20200430,052626,上証2X中信9A購01,0.31,0.31,0.31,0.31,+0.04,14.81,4000,1,1240,0,0,0,0,0,0,4000,0,4000,4000
20200430,052627,中壽中信98購01,0.06,0.06,0.06,0.06,0.00,0.00,3000,1,180,0,0,0,0,0,0,0,0,0,0
20200430,052628,樺漢中信96購01,,,,,0.00,0.00,0,0,0,0,0,0,0,0,0,0,0,0,0
20200430,052629,訊芯中信99購01,0.10,0.10,0.10,0.10,0.00,0.00,145000,3,14500,0,0,0,0,0,0,145000,0,145000,145000
20200430,05262P,台積電元大95售19,,,,,0.00,0.00,0,0,0,0,0,0,0,0,0,0,0,0,0
20200430,052630,滬深2X日盛96購01,,,,,0.00,0.00,0,0,0,0,0,0,0,0,0,0,0,0,0
20200430,052631,T50反1凱基98購02,,,,,0.00,0.00,0,0,0,0,0,0,0,0,0,0,0,0,0
20200430,052632,喬山凱基96購01,,,,,0.00,0.00,0,0,0,0,0,0,0,0,0,0,0,0,0
20200430,052633,國巨凱基96購05,1.05,1.05,0.98,0.98,0.00,0.00,26000,3,25900,0,0,0,0,0,0,0,26000,-26000,-26000
20200430,052634,華邦電凱基96購01,,,,,0.00,0.00,0,0,0,0,0,0,0,0,0,0,0,0,0
20200430,052635,奇力新凱基98購01,0.33,0.33,0.33,0.33,0.00,0.00,5000,1,1650,0,0,0,0,0,0,5000,0,5000,5000
20200430,052636,大立光凱基96購10,,,,,0.00,0.00,0,0,0,0,0,0,0,0,0,0,0,0,0
20200430,052637,欣興凱基97購01,0.16,0.16,0.16,0.16,+0.04,33.33,106000,3,16960,0,0,0,0,0,0,106000,0,106000,106000
20200430,052638,緯創凱基96購02,,,,,0.00,0.00,0,0,0,0,0,0,0,0,0,0,0,0,0
20200430,052639,康控凱基96購02,,,,,0.00,0.00,0,0,0,0,0,0,0,0,0,0,0,0,0
20200430,05263P,台積電元大96售09,,,,,0.00,0.00,0,0,0,0,0,0,0,0,0,0,0,0,0
20200430,052640,台表科凱基97購01,,,,,0.00,0.00,0,0,0,0,0,0,0,0,0,0,0,0,0
20200430,052641,聯詠台新96購01,,,,,0.00,0.00,0,0,0,0,0,0,0,0,0,0,0,0,0
20200430,052642,滬深2X永豐96購03,0.50,0.50,0.50,0.50,+0.10,25.0,10000,1,5000,0,0,0,0,0,0,0,0,0,0
20200430,052643,華通永豐96購02,,,,,0.00,0.00,0,0,0,0,0,0,0,0,0,0,0,0,0
20200430,052644,聯發科永豐96購01,0.31,0.43,0.31,0.43,+0.20,86.96,158000,8,57580,0,0,0,0,0,0,148000,0,148000,148000
20200430,052645,美食永豐96購01,,,,,0.00,0.00,0,0,0,0,0,0,0,0,0,0,0,0,0
20200430,052646,淘帝永豐96購01,,,,,0.00,0.00,0,0,0,0,0,0,0,0,0,0,0,0,0
20200430,052647,晶技永豐97購01,6.30,6.70,6.30,6.70,+0.40,6.35,33000,3,212500,0,0,0,0,0,0,20000,13000,7000,7000
20200430,052648,茂林永豐96購01,,,,,0.00,0.00,0,0,0,0,0,0,0,0,0,0,0,0,0
20200430,052649,康控永豐96購01,,,,,0.00,0.00,0,0,0,0,0,0,0,0,0,0,0,0,0
20200430,05264P,微星元大95售02,,,,,0.00,0.00,0,0,0,0,0,0,0,0,0,0,0,0,0
20200430,052650,台郡永豐96購01,,,,,0.00,0.00,0,0,0,0,0,0,0,0,0,0,0,0,0
20200430,052651,台表科永豐96購02,,,,,0.00,0.00,0,0,0,0,0,0,0,0,0,0,0,0,0
20200430,052652,台虹永豐96購01,,,,,0.00,0.00,0,0,0,0,0,0,0,0,0,0,0,0,0
20200430,052653,臺股指永豐97購01,0.04,0.04,0.04,0.04,+0.03,300.0,120000,2,4800,0,0,0,0,0,0,120000,0,120000,120000
20200430,052654,友達統一97購01,0.50,0.52,0.50,0.52,+0.02,4.0,53000,2,26600,0,0,0,0,0,0,5000,48000,-43000,-43000
20200430,052655,群創統一97購01,0.05,0.10,0.05,0.10,0.00,0.00,11000,2,600,0,0,0,0,0,0,0,0,0,0
20200430,052656,力山元富96購01,,,,,0.00,0.00,0,0,0,0,0,0,0,0,0,0,0,0,0
20200430,052657,友達元富96購01,0.19,0.19,0.18,0.18,0.00,0.00,468000,3,85740,0,0,0,0,0,0,468000,0,468000,468000
20200430,052658,友達元富9C購01,,,,,0.00,0.00,0,0,0,0,0,0,0,0,0,0,0,0,0
20200430,052659,上証2X國票99購01,1.00,1.12,1.00,1.02,+0.08,8.51,75000,5,80950,0,0,0,0,0,0,65000,10000,55000,55000
20200430,05265P,正崴元大95售03,,,,,0.00,0.00,0,0,0,0,0,0,0,0,0,0,0,0,0
20200430,052660,京元電國票97購01,,,,,0.00,0.00,0,0,0,0,0,0,0,0,0,0,0,0,0
20200430,052661,奇力新國票97購03,,,,,0.00,0.00,0,0,0,0,0,0,0,0,0,0,0,0,0
20200430,052662,華新科國票97購01,,,,,0.00,0.00,0,0,0,0,0,0,0,0,0,0,0,0,0
20200430,052663,奇鋐國票97購01,1.04,1.04,1.04,1.04,+0.13,14.29,3000,1,3120,0,0,0,0,0,0,3000,0,3000,3000
20200430,052664,麗豐國票96購02,,,,,0.00,0.00,0,0,0,0,0,0,0,0,0,0,0,0,0
20200430,052665,緯穎國票96購03,2.73,2.87,2.73,2.87,+0.29,11.24,70000,7,194700,0,0,0,0,0,0,70000,0,70000,70000
20200430,052666,瑞昱群益96購01,0.06,0.06,0.06,0.06,0.00,0.00,10000,1,600,0,0,0,0,0,0,10000,0,10000,10000
20200430,052667,漢唐群益96購01,1.42,1.42,1.42,1.42,-0.08,-5.33,50000,1,71000,0,0,0,0,0,0,50000,0,50000,50000
20200430,052668,聯發科群益97購01,0.50,0.50,0.50,0.50,+0.19,61.29,10000,1,5000,0,0,0,0,0,0,10000,0,10000,10000
20200430,052669,群創群益98購06,,,,,0.00,0.00,0,0,0,0,0,0,0,0,0,0,0,0,0
20200430,05266P,華新科元大95售11,,,,,0.00,0.00,0,0,0,0,0,0,0,0,0,0,0,0,0
20200430,052670,茂林群益96購02,,,,,0.00,0.00,0,0,0,0,0,0,0,0,0,0,0,0,0
20200430,052671,祥碩群益96購01,,,,,0.00,0.00,0,0,0,0,0,0,0,0,0,0,0,0,0
20200430,052672,世紀鋼群益96購02,0.62,0.62,0.62,0.62,0.00,0.00,5000,1,3100,0,0,0,0,0,0,0,5000,-5000,-5000
20200430,052673,T50反1國泰97購01,,,,,0.00,0.00,0,0,0,0,0,0,0,0,0,0,0,0,0
20200430,052674,智邦國泰98購01,,,,,0.00,0.00,0,0,0,0,0,0,0,0,0,0,0,0,0
20200430,052675,新光金國泰98購01,,,,,0.00,0.00,0,0,0,0,0,0,0,0,0,0,0,0,0
20200430,052676,聯發科永昌98購01,1.46,1.74,1.46,1.74,+0.74,74.0,11000,2,18860,0,0,0,0,0,0,11000,10000,1000,1000
20200430,052677,景碩富邦97購01,0.08,0.09,0.08,0.09,+0.02,28.57,61000,7,5440,0,0,0,0,0,0,61000,0,61000,61000
20200430,052678,群創富邦96購01,,,,,0.00,0.00,0,0,0,0,0,0,0,0,0,0,0,0,0
20200430,052679,致伸富邦98購01,,,,,0.00,0.00,0,0,0,0,0,0,0,0,0,0,0,0,0
20200430,05267P,欣興元大95售08,0.79,0.81,0.74,0.78,-0.06,-7.14,95000,10,74540,0,0,0,0,0,0,27000,91000,-64000,-64000
20200430,052680,T50反1元大96購04,0.39,0.39,0.38,0.38,0.00,0.00,6000,3,2300,0,0,0,0,0,0,0,6000,-6000,-6000
20200430,052681,T50反1元大98購02,1.28,1.28,1.22,1.22,-0.11,-8.27,55000,3,67320,0,0,0,0,0,0,2000,53000,-51000,-51000
20200430,052682,上銀元大97購01,1.64,2.42,1.64,2.42,+1.00,70.42,46000,4,92420,0,0,0,0,0,0,45000,1000,44000,44000
20200430,052683,鴻海元大97購03,,,,,0.00,0.00,0,0,0,0,0,0,0,0,0,0,0,0,0
20200430,052684,旺宏元大98購01,0.80,0.83,0.79,0.81,+0.11,15.71,349000,10,287700,0,0,0,0,0,0,329000,0,329000,329000
20200430,052685,技嘉元大96購01,1.29,1.29,1.26,1.29,+0.01,0.78,261000,5,333660,0,0,0,0,0,0,61000,200000,-139000,-139000
20200430,052686,華新科元大96購03,,,,,0.00,0.00,0,0,0,0,0,0,0,0,0,0,0,0,0
20200430,052687,國泰金元大96購03,0.21,0.24,0.21,0.24,0.00,0.00,321000,5,71910,0,0,0,0,0,0,301000,0,301000,301000
20200430,052688,新日興元大96購01,,,,,0.00,0.00,0,0,0,0,0,0,0,0,0,0,0,0,0
20200430,052689,玉晶光元大98購03,,,,,0.00,0.00,0,0,0,0,0,0,0,0,0,0,0,0,0
20200430,05268P,玉晶光元大98售01,0.70,0.70,0.70,0.70,-0.04,-5.41,112000,15,78400,0,0,0,0,0,0,0,0,0,0
20200430,052690,台表科元大97購01,,,,,0.00,0.00,0,0,0,0,0,0,0,0,0,0,0,0,0
20200430,052691,GIS元大96購01,0.77,0.77,0.72,0.72,-0.02,-2.7,190000,17,141200,0,0,0,0,0,0,182000,86000,96000,96000
20200430,052692,滬深2X中信99購02,1.10,1.10,1.08,1.08,0.00,0.00,62000,5,67600,0,0,0,0,0,0,0,62000,-62000,-62000
20200430,052693,微星中信96購01,0.91,0.91,0.91,0.91,0.00,0.00,10000,1,9100,0,0,0,0,0,0,10000,0,10000,10000
20200430,052694,開發金中信98購01,,,,,0.00,0.00,0,0,0,0,0,0,0,0,0,0,0,0,0
20200430,052695,台表科中信98購01,0.03,0.03,0.03,0.03,0.00,0.00,65000,3,1950,0,0,0,0,0,0,0,20000,-20000,-20000
20200430,052696,玉晶光麥證97購01,3.23,3.61,3.23,3.60,+0.52,16.88,298000,28,1068010,9000,289000,-280000,0,0,0,24000,292000,-268000,-268000
20200430,052697,滬深2X國票98購01,,,,,0.00,0.00,0,0,0,0,0,0,0,0,0,0,0,0,0
20200430,052698,深中小國票99購01,,,,,0.00,0.00,0,0,0,0,0,0,0,0,0,0,0,0,0
20200430,052699,友達國票97購01,0.29,0.29,0.29,0.29,0.00,0.00,30000,1,8700,0,0,0,0,0,0,30000,0,30000,30000
20200430,05269P,臻鼎元大95售05,,,,,0.00,0.00,0,0,0,0,0,0,0,0,0,0,0,0,0
20200430,052700,奇鋐國票97購02,1.22,1.26,1.17,1.24,+0.11,9.73,141000,12,173520,0,0,0,0,0,0,68000,73000,-5000,-5000
20200430,052701,群創國票96購01,,,,,0.00,0.00,0,0,0,0,0,0,0,0,0,0,0,0,0
20200430,052702,群創國票97購03,0.22,0.22,0.21,0.21,0.00,0.00,78000,2,16960,0,0,0,0,0,0,20000,58000,-38000,-38000
20200430,052703,貿聯國票97購01,1.04,1.19,1.04,1.19,0.00,0.00,82000,3,90150,0,0,0,0,0,0,0,82000,-82000,-82000
20200430,052704,TPK國票97購01,0.22,0.22,0.22,0.22,-0.01,-4.35,70000,1,15400,0,0,0,0,0,0,0,70000,-70000,-70000
20200430,052705,超眾國票97購01,,,,,0.00,0.00,0,0,0,0,0,0,0,0,0,0,0,0,0
20200430,052706,台虹國票97購01,1.21,1.21,1.21,1.21,+0.04,3.42,16000,1,19360,0,0,0,0,0,0,16000,0,16000,16000
20200430,052707,景碩台新96購01,0.31,0.31,0.31,0.31,+0.08,34.78,50000,1,15500,0,0,0,0,0,0,50000,0,50000,50000
20200430,052708,楠梓電永豐97購01,,,,,0.00,0.00,0,0,0,0,0,0,0,0,0,0,0,0,0
20200430,052709,光寶科日盛96購01,,,,,0.00,0.00,0,0,0,0,0,0,0,0,0,0,0,0,0
20200430,05270P,台表科元大95售05,,,,,0.00,0.00,0,0,0,0,0,0,0,0,0,0,0,0,0
20200430,052710,玉晶光日盛96購01,,,,,0.00,0.00,0,0,0,0,0,0,0,0,0,0,0,0,0
20200430,052711,滬深2X凱基97購01,,,,,0.00,0.00,0,0,0,0,0,0,0,0,0,0,0,0,0
20200430,052712,旺宏凱基96購02,0.83,0.87,0.83,0.83,+0.12,16.9,366000,6,315940,0,0,0,0,0,0,350000,16000,334000,334000
20200430,052713,智邦凱基96購01,4.70,5.00,4.70,4.88,-0.04,-0.81,38000,22,182380,0,0,0,0,0,0,38000,0,38000,38000
20200430,052714,義隆凱基96購02,0.73,0.83,0.73,0.83,+0.14,20.29,105000,3,86860,0,0,0,0,0,0,5000,105000,-100000,-100000
20200430,052715,可成凱基96購01,0.33,0.33,0.33,0.33,0.00,0.00,10000,1,3300,0,0,0,0,0,0,0,10000,-10000,-10000
20200430,052716,欣興凱基96購01,,,,,0.00,0.00,0,0,0,0,0,0,0,0,0,0,0,0,0
20200430,052717,正文凱基96購01,,,,,0.00,0.00,0,0,0,0,0,0,0,0,0,0,0,0,0
20200430,052718,新唐凱基96購01,,,,,0.00,0.00,0,0,0,0,0,0,0,0,0,0,0,0,0
20200430,052719,致新凱基96購01,0.46,0.46,0.46,0.46,0.00,0.00,8000,1,3680,0,0,0,0,0,0,8000,0,8000,8000
20200430,05271P,國巨富邦97售01,0.18,0.18,0.18,0.18,-0.16,-47.06,28000,2,5040,0,0,0,0,0,0,0,0,0,0
20200430,052720,鴻海統一96購07,,,,,0.00,0.00,0,0,0,0,0,0,0,0,0,0,0,0,0
20200430,052721,友達統一96購01,,,,,0.00,0.00,0,0,0,0,0,0,0,0,0,0,0,0,0
20200430,052722,群創統一97購02,,,,,0.00,0.00,0,0,0,0,0,0,0,0,0,0,0,0,0
20200430,052723,新唐統一97購01,,,,,0.00,0.00,0,0,0,0,0,0,0,0,0,0,0,0,0
20200430,052724,力成統一97購01,,,,,0.00,0.00,0,0,0,0,0,0,0,0,0,0,0,0,0
20200430,052725,為升元富96購01,,,,,0.00,0.00,0,0,0,0,0,0,0,0,0,0,0,0,0
20200430,052726,鴻海元富96購03,,,,,0.00,0.00,0,0,0,0,0,0,0,0,0,0,0,0,0
20200430,052727,仁寶元富96購01,0.61,0.61,0.59,0.61,-0.03,-4.69,437000,9,264570,0,0,0,0,0,0,268000,169000,99000,99000
20200430,052728,上証2X國泰97購01,,,,,0.00,0.00,0,0,0,0,0,0,0,0,0,0,0,0,0
20200430,052729,國巨國泰97購03,,,,,0.00,0.00,0,0,0,0,0,0,0,0,0,0,0,0,0
20200430,05272P,臻鼎中信97售03,0.58,0.59,0.57,0.57,-0.15,-20.83,40000,3,23200,0,0,0,0,0,0,20000,20000,0,0
20200430,052730,華新科國泰98購01,,,,,0.00,0.00,0,0,0,0,0,0,0,0,0,0,0,0,0
20200430,052731,宏達電國泰98購01,0.35,0.37,0.35,0.37,0.00,0.00,205000,2,71850,0,0,0,0,0,0,200000,5000,195000,195000
20200430,052732,新唐國泰97購01,,,,,0.00,0.00,0,0,0,0,0,0,0,0,0,0,0,0,0
20200430,052733,台郡國泰97購01,0.67,0.73,0.67,0.73,+0.03,4.29,67000,2,48490,0,0,0,0,0,0,67000,0,67000,67000
20200430,052734,台表科國泰98購02,,,,,0.00,0.00,0,0,0,0,0,0,0,0,0,0,0,0,0
20200430,052735,燿華富邦98購01,,,,,0.00,0.00,0,0,0,0,0,0,0,0,0,0,0,0,0
20200430,052736,T50反1元大96購05,,,,,0.00,0.00,0,0,0,0,0,0,0,0,0,0,0,0,0
20200430,052737,滬深2X元大96購06,,,,,0.00,0.00,0,0,0,0,0,0,0,0,0,0,0,0,0
20200430,052738,聯電元大98購02,0.76,0.78,0.75,0.78,+0.04,5.41,245000,8,187150,0,0,0,0,0,0,245000,0,245000,245000
20200430,052739,國巨元大96購04,1.71,1.71,1.71,1.71,+0.16,10.32,5000,1,8550,0,0,0,0,0,0,0,5000,-5000,-5000
20200430,05273P,國巨群益95售02,,,,,0.00,0.00,0,0,0,0,0,0,0,0,0,0,0,0,0
20200430,052740,聯發科元大96購07,0.24,0.32,0.24,0.32,+0.13,68.42,390000,12,112200,0,0,0,0,0,0,370000,0,370000,370000
20200430,052741,聯發科元大96購08,0.35,0.38,0.34,0.37,+0.16,76.19,126000,6,44820,0,0,0,0,0,0,126000,0,126000,126000
20200430,052742,可成元大96購01,0.35,0.35,0.31,0.31,-0.08,-20.51,69000,7,22250,0,0,0,0,0,0,0,69000,-69000,-69000
20200430,052743,華新科元大97購01,,,,,0.00,0.00,0,0,0,0,0,0,0,0,0,0,0,0,0
20200430,052744,聯詠元大97購01,,,,,0.00,0.00,0,0,0,0,0,0,0,0,0,0,0,0,0
20200430,052745,欣興元大96購04,0.33,0.33,0.33,0.33,+0.06,22.22,10000,1,3300,0,0,0,0,0,0,10000,0,10000,10000
20200430,052746,泰碩元大97購01,,,,,0.00,0.00,0,0,0,0,0,0,0,0,0,0,0,0,0
20200430,052747,京鼎元大97購01,0.70,0.86,0.70,0.86,+0.27,45.76,63000,5,46990,0,0,0,0,0,0,8000,10000,-2000,-2000
20200430,052748,群創元大9A購02,,,,,0.00,0.00,0,0,0,0,0,0,0,0,0,0,0,0,0
20200430,052749,日月光元大96購02,,,,,0.00,0.00,0,0,0,0,0,0,0,0,0,0,0,0,0
20200430,05274P,嘉聯益亞東95售01,,,,,0.00,0.00,0,0,0,0,0,0,0,0,0,0,0,0,0
20200430,052750,臺股指元大96購04,0.18,0.26,0.17,0.24,+0.09,60.0,840000,32,197500,0,0,0,0,0,0,770000,0,770000,770000
20200430,052751,臺股指元大96購05,,,,,0.00,0.00,0,0,0,0,0,0,0,0,0,0,0,0,0
20200430,052752,臺股指元大96購06,,,,,0.00,0.00,0,0,0,0,0,0,0,0,0,0,0,0,0
20200430,052753,電子類元大96購02,0.22,0.26,0.22,0.26,+0.06,30.0,4000,2,960,0,0,0,0,0,0,4000,0,4000,4000
20200430,052754,上証2X群益9A購01,,,,,0.00,0.00,0,0,0,0,0,0,0,0,0,0,0,0,0
20200430,052755,滬深2X群益9A購01,,,,,0.00,0.00,0,0,0,0,0,0,0,0,0,0,0,0,0
20200430,052756,國巨群益96購02,,,,,0.00,0.00,0,0,0,0,0,0,0,0,0,0,0,0,0
20200430,052757,華邦電群益96購01,,,,,0.00,0.00,0,0,0,0,0,0,0,0,0,0,0,0,0
20200430,052758,友達群益99購01,,,,,0.00,0.00,0,0,0,0,0,0,0,0,0,0,0,0,0
20200430,052759,京元電群益96購01,1.22,1.22,1.22,1.22,-0.02,-1.61,49000,1,59780,0,0,0,0,0,0,0,49000,-49000,-49000
20200430,05275P,國巨凱基95售05,,,,,0.00,0.00,0,0,0,0,0,0,0,0,0,0,0,0,0
20200430,052760,盟立群益96購01,,,,,0.00,0.00,0,0,0,0,0,0,0,0,0,0,0,0,0
20200430,052761,可成群益96購02,,,,,0.00,0.00,0,0,0,0,0,0,0,0,0,0,0,0,0
20200430,052762,欣興群益96購01,,,,,0.00,0.00,0,0,0,0,0,0,0,0,0,0,0,0,0
20200430,052763,晶技群益97購01,,,,,0.00,0.00,0,0,0,0,0,0,0,0,0,0,0,0,0
20200430,052764,景碩群益98購01,1.75,2.03,1.75,2.03,+0.26,14.69,276000,9,499320,0,0,0,0,0,0,162000,114000,48000,48000
20200430,052765,新日興群益97購01,,,,,0.00,0.00,0,0,0,0,0,0,0,0,0,0,0,0,0
20200430,052766,玉晶光群益9A購01,4.12,4.52,4.00,4.52,0.00,0.00,14000,4,59110,0,0,0,0,0,0,11000,3000,8000,8000
20200430,052767,智伸科群益98購01,,,,,0.00,0.00,0,0,0,0,0,0,0,0,0,0,0,0,0
20200430,052768,泰鼎群益96購01,,,,,0.00,0.00,0,0,0,0,0,0,0,0,0,0,0,0,0
20200430,052769,達興群益96購01,,,,,0.00,0.00,0,0,0,0,0,0,0,0,0,0,0,0,0
20200430,05276P,GIS永豐95售02,,,,,0.00,0.00,0,0,0,0,0,0,0,0,0,0,0,0,0
20200430,052770,聯茂群益96購02,,,,,0.00,0.00,0,0,0,0,0,0,0,0,0,0,0,0,0
20200430,052771,GIS群益96購01,0.48,0.48,0.48,0.48,0.00,0.00,20000,1,9600,0,0,0,0,0,0,20000,0,20000,20000
20200430,052772,台虹群益96購01,0.88,0.89,0.86,0.86,-0.07,-7.53,194000,4,167330,0,0,0,0,0,0,183000,11000,172000,172000
20200430,052773,大成鋼亞東97購01,,,,,0.00,0.00,0,0,0,0,0,0,0,0,0,0,0,0,0
20200430,052774,京元電亞東96購01,,,,,0.00,0.00,0,0,0,0,0,0,0,0,0,0,0,0,0
20200430,052775,滬深2X國票99購02,0.80,0.90,0.80,0.85,+0.06,7.59,20000,6,16980,0,0,0,0,0,0,16000,4000,12000,12000
20200430,052776,力山國票97購01,0.46,0.58,0.34,0.34,-0.04,-10.53,20000,13,10150,0,0,0,0,0,0,13000,0,13000,13000
20200430,052777,燿華國票98購01,0.49,0.55,0.49,0.55,+0.03,5.77,645000,10,342050,0,0,0,0,0,0,14000,631000,-617000,-617000
20200430,052778,智原國票97購01,,,,,0.00,0.00,0,0,0,0,0,0,0,0,0,0,0,0,0
20200430,052779,欣興國票97購01,0.42,0.47,0.40,0.41,+0.01,2.5,391000,55,166220,0,0,0,0,0,0,93000,298000,-205000,-205000
20200430,05277P,深中小統一95售02,,,,,0.00,0.00,0,0,0,0,0,0,0,0,0,0,0,0,0
20200430,052780,玉晶光國票96購04,2.56,2.75,2.56,2.75,+0.61,28.5,10000,7,26170,0,0,0,0,0,0,10000,0,10000,10000
20200430,052781,瀚宇博國票97購03,2.28,2.35,2.24,2.34,+0.04,1.74,225000,10,522610,0,0,0,0,0,0,44000,181000,-137000,-137000
20200430,052782,超眾國票96購02,3.45,3.45,3.45,3.45,0.00,0.00,2000,1,6900,0,0,0,0,0,0,0,2000,-2000,-2000
20200430,052783,台郡國票97購01,,,,,0.00,0.00,0,0,0,0,0,0,0,0,0,0,0,0,0
20200430,052784,緯穎國票97購02,6.85,8.40,6.80,8.40,+2.10,33.33,24000,4,170450,0,0,0,0,0,0,24000,4000,20000,20000
20200430,052785,滬深2X中信99購03,0.78,0.78,0.78,0.78,0.00,0.00,10000,1,7800,0,0,0,0,0,0,0,10000,-10000,-10000
20200430,052786,S&P500中信96購01,0.02,0.03,0.02,0.03,+0.01,50.0,36000,2,1050,0,0,0,0,0,0,3000,0,3000,3000
20200430,052787,國巨中信96購02,,,,,0.00,0.00,0,0,0,0,0,0,0,0,0,0,0,0,0
20200430,052788,開發金中信98購02,,,,,0.00,0.00,0,0,0,0,0,0,0,0,0,0,0,0,0
20200430,052789,台積電麥證96購01,1.99,1.99,1.99,1.99,0.00,0.00,1000,1,1990,0,0,0,0,0,0,0,0,0,0
20200430,05278P,台郡元富95售02,,,,,0.00,0.00,0,0,0,0,0,0,0,0,0,0,0,0,0
20200430,052790,智邦兆豐97購01,,,,,0.00,0.00,0,0,0,0,0,0,0,0,0,0,0,0,0
20200430,052791,友達兆豐97購01,0.08,0.08,0.08,0.08,+0.01,14.29,10000,1,800,0,0,0,0,0,0,10000,10000,0,0
20200430,052792,大立光兆豐96購01,,,,,0.00,0.00,0,0,0,0,0,0,0,0,0,0,0,0,0
20200430,052793,健鼎兆豐96購01,,,,,0.00,0.00,0,0,0,0,0,0,0,0,0,0,0,0,0
20200430,052794,群創兆豐97購01,0.08,0.08,0.08,0.08,0.00,0.00,40000,2,3200,0,0,0,0,0,0,40000,10000,30000,30000
20200430,052795,健策兆豐97購01,1.62,1.66,1.62,1.66,+0.05,3.11,110000,4,180720,0,0,0,0,0,0,38000,72000,-34000,-34000
20200430,052796,和碩兆豐96購01,0.82,0.87,0.81,0.81,-0.07,-7.95,121000,7,100790,0,0,0,0,0,0,108000,13000,95000,95000
20200430,052797,樺漢兆豐96購01,,,,,0.00,0.00,0,0,0,0,0,0,0,0,0,0,0,0,0
20200430,052798,滬深2X元大96購07,0.43,0.43,0.43,0.43,+0.05,13.16,14000,1,6020,0,0,0,0,0,0,0,0,0,0
20200430,052799,上銀元大96購01,2.04,2.04,2.04,2.04,0.00,0.00,7000,1,14280,0,0,0,0,0,0,7000,0,7000,7000
20200430,05279P,上銀元大95售02,,,,,0.00,0.00,0,0,0,0,0,0,0,0,0,0,0,0,0
20200430,052800,國巨元大96購05,,,,,0.00,0.00,0,0,0,0,0,0,0,0,0,0,0,0,0
20200430,052801,友達元大9A購01,,,,,0.00,0.00,0,0,0,0,0,0,0,0,0,0,0,0,0
20200430,052802,華新科元大97購02,,,,,0.00,0.00,0,0,0,0,0,0,0,0,0,0,0,0,0
20200430,052803,冠德元大96購01,,,,,0.00,0.00,0,0,0,0,0,0,0,0,0,0,0,0,0
20200430,052804,淘帝元大96購01,,,,,0.00,0.00,0,0,0,0,0,0,0,0,0,0,0,0,0
20200430,052805,晶技元大97購01,,,,,0.00,0.00,0,0,0,0,0,0,0,0,0,0,0,0,0
20200430,052806,玉晶光元大98購04,3.00,3.00,3.00,3.00,0.00,0.00,10000,1,30000,0,0,0,0,0,0,0,10000,-10000,-10000
20200430,052807,貿聯元大98購01,0.34,0.42,0.34,0.42,+0.13,44.83,11000,2,3820,0,0,0,0,0,0,11000,0,11000,11000
20200430,052808,矽力元大96購02,,,,,0.00,0.00,0,0,0,0,0,0,0,0,0,0,0,0,0
20200430,052809,訊芯元大97購01,,,,,0.00,0.00,0,0,0,0,0,0,0,0,0,0,0,0,0
20200430,05280P,華通元大95售08,,,,,0.00,0.00,0,0,0,0,0,0,0,0,0,0,0,0,0
20200430,052810,易華電元大96購02,,,,,0.00,0.00,0,0,0,0,0,0,0,0,0,0,0,0,0
20200430,052811,玉晶光台新96購03,0.04,0.04,0.04,0.04,-1.06,-96.36,10000,1,400,0,0,0,0,0,0,0,10000,-10000,-10000
20200430,052812,致伸康和96購01,,,,,0.00,0.00,0,0,0,0,0,0,0,0,0,0,0,0,0
20200430,052813,T50正2永豐96購01,0.13,0.13,0.10,0.12,+0.05,71.43,278000,15,32950,0,0,0,0,0,0,255000,0,255000,255000
20200430,052814,上証2X永豐96購02,0.21,0.28,0.21,0.28,+0.07,33.33,202000,3,42560,0,0,0,0,0,0,0,2000,-2000,-2000
20200430,052815,滬深2X永豐97購01,,,,,0.00,0.00,0,0,0,0,0,0,0,0,0,0,0,0,0
20200430,052816,上銀永豐96購01,0.94,1.38,0.91,1.28,+0.40,45.45,929000,37,997370,0,0,0,0,0,0,455000,434000,21000,21000
20200430,052817,楠梓電永豐96購02,,,,,0.00,0.00,0,0,0,0,0,0,0,0,0,0,0,0,0
20200430,052818,智邦永豐96購01,1.92,1.95,1.62,1.62,-0.33,-16.92,196000,35,371290,0,0,0,0,0,0,166000,28000,138000,138000
20200430,052819,義隆永豐96購01,1.51,1.64,1.51,1.64,+0.32,24.24,237000,7,375260,0,0,0,0,0,0,0,237000,-237000,-237000
20200430,05281P,南亞科元大95售03,,,,,0.00,0.00,0,0,0,0,0,0,0,0,0,0,0,0,0
20200430,052820,宏達電永豐96購01,,,,,0.00,0.00,0,0,0,0,0,0,0,0,0,0,0,0,0
20200430,052821,晶技永豐96購01,2.45,2.73,2.35,2.36,-0.09,-3.67,108000,6,275680,0,0,0,0,0,0,94000,14000,80000,80000
20200430,052822,泰碩永豐97購01,1.14,1.16,1.14,1.15,-0.10,-8.0,125000,5,143600,0,0,0,0,0,0,85000,30000,55000,55000
20200430,052823,創意永豐96購02,0.32,0.32,0.31,0.31,0.00,0.00,54000,4,17080,0,0,0,0,0,0,0,54000,-54000,-54000
20200430,052824,揚明光永豐96購02,,,,,0.00,0.00,0,0,0,0,0,0,0,0,0,0,0,0,0
20200430,052825,TPK永豐96購01,,,,,0.00,0.00,0,0,0,0,0,0,0,0,0,0,0,0,0
20200430,052826,嘉聯益永豐96購01,,,,,0.00,0.00,0,0,0,0,0,0,0,0,0,0,0,0,0
20200430,052827,昇陽半永豐97購01,0.18,0.18,0.17,0.18,0.00,0.00,80000,5,14100,0,0,0,0,0,0,0,80000,-80000,-80000
20200430,052828,滬深2X群益9A購02,,,,,0.00,0.00,0,0,0,0,0,0,0,0,0,0,0,0,0
20200430,052829,上銀群益96購01,,,,,0.00,0.00,0,0,0,0,0,0,0,0,0,0,0,0,0
20200430,05282P,可成元大95售09,1.09,1.16,1.09,1.16,0.00,0.00,155000,2,175950,0,0,0,0,0,0,0,155000,-155000,-155000
20200430,052830,台光電群益96購01,,,,,0.00,0.00,0,0,0,0,0,0,0,0,0,0,0,0,0
20200430,052831,華固群益96購01,0.49,0.49,0.49,0.49,+0.03,6.52,30000,1,14700,0,0,0,0,0,0,0,0,0,0
20200430,052832,益航群益96購01,0.42,0.53,0.40,0.43,-0.11,-20.37,125000,7,52330,0,0,0,0,0,0,120000,3000,117000,117000
20200430,052833,康控群益96購01,,,,,0.00,0.00,0,0,0,0,0,0,0,0,0,0,0,0,0
20200430,052834,彩晶群益96購01,,,,,0.00,0.00,0,0,0,0,0,0,0,0,0,0,0,0,0
20200430,052835,滬深2X國泰98購01,,,,,0.00,0.00,0,0,0,0,0,0,0,0,0,0,0,0,0
20200430,052836,旺宏國泰98購01,1.15,1.15,1.15,1.15,+0.26,29.21,10000,1,11500,0,0,0,0,0,0,10000,0,10000,10000
20200430,052837,友達國泰97購01,0.52,0.52,0.52,0.52,+0.01,1.96,69000,1,35880,0,0,0,0,0,0,0,69000,-69000,-69000
20200430,052838,新唐國泰98購01,,,,,0.00,0.00,0,0,0,0,0,0,0,0,0,0,0,0,0
20200430,052839,上海銀國泰97購01,,,,,0.00,0.00,0,0,0,0,0,0,0,0,0,0,0,0,0
20200430,05283P,健鼎元大95售04,,,,,0.00,0.00,0,0,0,0,0,0,0,0,0,0,0,0,0
20200430,052840,友達富邦96購01,,,,,0.00,0.00,0,0,0,0,0,0,0,0,0,0,0,0,0
20200430,052841,群創富邦96購02,,,,,0.00,0.00,0,0,0,0,0,0,0,0,0,0,0,0,0
20200430,052842,滬深2X統一96購01,,,,,0.00,0.00,0,0,0,0,0,0,0,0,0,0,0,0,0
20200430,052843,鴻海統一96購09,,,,,0.00,0.00,0,0,0,0,0,0,0,0,0,0,0,0,0
20200430,052844,台積電統一96購02,,,,,0.00,0.00,0,0,0,0,0,0,0,0,0,0,0,0,0
20200430,052845,旺宏統一97購01,1.70,1.77,1.70,1.77,+0.24,15.69,11000,2,19400,0,0,0,0,0,0,11000,0,11000,11000
20200430,052846,智邦統一97購01,3.72,3.88,3.50,3.50,-0.46,-11.62,66000,9,250470,0,0,0,0,0,0,64000,2000,62000,62000
20200430,052847,漢唐統一99購01,0.70,0.70,0.68,0.68,-0.01,-1.45,42000,2,29000,0,0,0,0,0,0,42000,0,42000,42000
20200430,052848,聯發科統一96購03,,,,,0.00,0.00,0,0,0,0,0,0,0,0,0,0,0,0,0
20200430,052849,可成統一97購01,,,,,0.00,0.00,0,0,0,0,0,0,0,0,0,0,0,0,0
20200430,05284P,鴻海兆豐95售04,,,,,0.00,0.00,0,0,0,0,0,0,0,0,0,0,0,0,0
20200430,052850,華新科統一96購02,,,,,0.00,0.00,0,0,0,0,0,0,0,0,0,0,0,0,0
20200430,052851,滬深2X元富96購02,0.30,0.33,0.25,0.25,0.00,0.00,61000,4,16130,0,0,0,0,0,0,0,11000,-11000,-11000
20200430,052852,國巨元富96購02,0.25,0.38,0.25,0.38,+0.09,31.03,23000,3,6010,0,0,0,0,0,0,0,0,0,0
20200430,052853,友達日盛99購01,,,,,0.00,0.00,0,0,0,0,0,0,0,0,0,0,0,0,0
20200430,052854,聯詠日盛96購01,,,,,0.00,0.00,0,0,0,0,0,0,0,0,0,0,0,0,0
20200430,052855,群創日盛99購01,,,,,0.00,0.00,0,0,0,0,0,0,0,0,0,0,0,0,0
20200430,052856,滬深2X凱基98購01,,,,,0.00,0.00,0,0,0,0,0,0,0,0,0,0,0,0,0
20200430,052857,大成鋼凱基96購01,0.35,0.38,0.35,0.37,0.00,0.00,50000,4,18400,0,0,0,0,0,0,10000,40000,-30000,-30000
20200430,052858,華通凱基97購02,0.50,0.52,0.48,0.52,+0.10,23.81,119000,4,60680,0,0,0,0,0,0,0,119000,-119000,-119000
20200430,052859,國巨凱基96購07,1.08,1.08,1.07,1.07,+0.14,15.05,12000,2,12860,0,0,0,0,0,0,0,0,0,0
20200430,05285P,同欣電群益95售02,,,,,0.00,0.00,0,0,0,0,0,0,0,0,0,0,0,0,0
20200430,052860,旺宏凱基96購03,1.54,1.54,1.46,1.47,+0.21,16.67,32000,4,47110,0,0,0,0,0,0,12000,21000,-9000,-9000
20200430,052861,台光電凱基96購03,,,,,0.00,0.00,0,0,0,0,0,0,0,0,0,0,0,0,0
20200430,052862,正崴凱基96購01,,,,,0.00,0.00,0,0,0,0,0,0,0,0,0,0,0,0,0
20200430,052863,友達凱基98購02,0.61,0.61,0.61,0.61,0.00,0.00,4000,1,2440,0,0,0,0,0,0,0,4000,-4000,-4000
20200430,052864,奇力新凱基96購02,0.57,0.61,0.55,0.61,+0.05,8.93,230000,5,131100,0,0,0,0,0,0,220000,10000,210000,210000
20200430,052865,大立光凱基96購11,0.73,0.81,0.73,0.81,+0.06,8.0,198000,3,157930,0,0,0,0,0,0,128000,70000,58000,58000
20200430,052866,大立光凱基96購12,,,,,0.00,0.00,0,0,0,0,0,0,0,0,0,0,0,0,0
20200430,052867,晶技凱基96購01,4.61,4.68,4.61,4.68,+0.23,5.17,24000,3,111640,0,0,0,0,0,0,0,24000,-24000,-24000
20200430,052868,緯創凱基96購03,,,,,0.00,0.00,0,0,0,0,0,0,0,0,0,0,0,0,0
20200430,052869,新日興凱基96購01,,,,,0.00,0.00,0,0,0,0,0,0,0,0,0,0,0,0,0
20200430,05286P,矽力統一95售02,,,,,0.00,0.00,0,0,0,0,0,0,0,0,0,0,0,0,0
20200430,052870,玉晶光凱基96購03,,,,,0.00,0.00,0,0,0,0,0,0,0,0,0,0,0,0,0
20200430,052871,群創凱基98購07,,,,,0.00,0.00,0,0,0,0,0,0,0,0,0,0,0,0,0
20200430,052872,智易凱基96購01,0.47,0.47,0.47,0.47,-0.04,-7.84,10000,1,4700,0,0,0,0,0,0,10000,0,10000,10000
20200430,052873,新唐凱基96購02,,,,,0.00,0.00,0,0,0,0,0,0,0,0,0,0,0,0,0
20200430,052874,超眾凱基96購01,1.14,1.21,1.12,1.21,+0.10,9.01,96000,4,109190,0,0,0,0,0,0,96000,0,96000,96000
20200430,052875,樺漢凱基96購02,,,,,0.00,0.00,0,0,0,0,0,0,0,0,0,0,0,0,0
20200430,052876,GIS凱基96購03,,,,,0.00,0.00,0,0,0,0,0,0,0,0,0,0,0,0,0
20200430,052877,矽創凱基96購01,,,,,0.00,0.00,0,0,0,0,0,0,0,0,0,0,0,0,0
20200430,052878,台虹凱基96購01,,,,,0.00,0.00,0,0,0,0,0,0,0,0,0,0,0,0,0
20200430,052879,滬深2X凱基97購02,,,,,0.00,0.00,0,0,0,0,0,0,0,0,0,0,0,0,0
20200430,05287P,鴻海元富95售09,,,,,0.00,0.00,0,0,0,0,0,0,0,0,0,0,0,0,0
20200430,052880,台積電凱基96購06,0.38,0.38,0.38,0.38,0.00,0.00,1000,1,380,0,0,0,0,0,0,1000,0,1000,1000
20200430,052881,康控凱基97購01,0.16,0.16,0.16,0.16,+0.05,45.45,50000,1,8000,0,0,0,0,0,0,50000,0,50000,50000
20200430,052882,南電凱基96購02,2.91,2.91,2.91,2.91,+0.11,3.93,1000,1,2910,0,0,0,0,0,0,0,1000,-1000,-1000
20200430,052883,百和亞東97購01,,,,,0.00,0.00,0,0,0,0,0,0,0,0,0,0,0,0,0
20200430,052884,台積電兆豐96購01,0.54,0.54,0.54,0.54,0.00,0.00,20000,1,10800,0,0,0,0,0,0,20000,0,20000,20000
20200430,052885,高鐵兆豐98購01,0.46,0.46,0.46,0.46,+0.01,2.22,10000,1,4600,0,0,0,0,0,0,10000,0,10000,10000
20200430,052886,世紀鋼兆豐96購01,1.50,1.80,1.50,1.80,+0.55,44.0,2000,2,3300,0,0,0,0,0,0,0,0,0,0
20200430,052887,華通中信96購01,0.33,0.37,0.33,0.37,+0.10,37.04,180000,6,66000,0,0,0,0,0,0,170000,10000,160000,160000
20200430,052888,台表科中信9A購01,0.11,0.12,0.11,0.12,+0.01,9.09,15000,2,1750,0,0,0,0,0,0,0,15000,-15000,-15000
20200430,052889,致伸麥證97購01,,,,,0.00,0.00,0,0,0,0,0,0,0,0,0,0,0,0,0
20200430,05288P,寶成元富95售02,3.20,3.20,3.20,3.20,-0.29,-8.31,1000,1,3200,0,0,0,0,0,0,1000,0,1000,1000
20200430,052890,FB上証群益9B購01,,,,,0.00,0.00,0,0,0,0,0,0,0,0,0,0,0,0,0
20200430,052891,台泥群益96購01,,,,,0.00,0.00,0,0,0,0,0,0,0,0,0,0,0,0,0
20200430,052892,大成鋼群益96購01,,,,,0.00,0.00,0,0,0,0,0,0,0,0,0,0,0,0,0
20200430,052893,聯電群益98購01,,,,,0.00,0.00,0,0,0,0,0,0,0,0,0,0,0,0,0
20200430,052894,國巨群益96購03,,,,,0.00,0.00,0,0,0,0,0,0,0,0,0,0,0,0,0
20200430,052895,台積電群益96購04,3.25,3.38,3.18,3.38,+0.38,12.67,190000,13,622700,0,0,0,0,0,0,67000,125000,-58000,-58000
20200430,052896,宏達電群益96購01,0.24,0.24,0.24,0.24,+0.10,71.43,10000,1,2400,0,0,0,0,0,0,0,10000,-10000,-10000
20200430,052897,緯創群益96購03,1.19,1.30,1.15,1.26,+0.04,3.28,717000,24,870620,0,0,0,0,0,0,495000,222000,273000,273000
20200430,052898,樺漢群益96購01,0.44,0.45,0.43,0.43,-0.03,-6.52,104000,3,45020,0,0,0,0,0,0,104000,0,104000,104000
20200430,052899,和大國票97購01,,,,,0.00,0.00,0,0,0,0,0,0,0,0,0,0,0,0,0
20200430,05289P,鴻海永豐95售05,,,,,0.00,0.00,0,0,0,0,0,0,0,0,0,0,0,0,0
20200430,052900,大成鋼國票97購01,,,,,0.00,0.00,0,0,0,0,0,0,0,0,0,0,0,0,0
20200430,052901,台達電國票97購01,,,,,0.00,0.00,0,0,0,0,0,0,0,0,0,0,0,0,0
20200430,052902,鴻海國票97購04,,,,,0.00,0.00,0,0,0,0,0,0,0,0,0,0,0,0,0
20200430,052903,致茂國票97購01,0.64,0.64,0.64,0.64,-0.09,-12.33,38000,1,24320,0,0,0,0,0,0,0,38000,-38000,-38000
20200430,052904,冠德國票97購01,,,,,0.00,0.00,0,0,0,0,0,0,0,0,0,0,0,0,0
20200430,052905,潤泰全國票97購01,,,,,0.00,0.00,0,0,0,0,0,0,0,0,0,0,0,0,0
20200430,052906,緯創國票97購01,,,,,0.00,0.00,0,0,0,0,0,0,0,0,0,0,0,0,0
20200430,052907,嘉澤國票97購01,,,,,0.00,0.00,0,0,0,0,0,0,0,0,0,0,0,0,0
20200430,052908,大成鋼統一96購01,0.99,1.05,0.98,1.05,+0.03,2.94,539000,15,543720,0,0,0,0,0,0,272000,267000,5000,5000
20200430,052909,上銀統一96購01,0.41,0.56,0.41,0.56,0.00,0.00,105000,13,50780,0,0,0,0,0,0,0,105000,-105000,-105000
20200430,05290P,國巨永豐95售04,,,,,0.00,0.00,0,0,0,0,0,0,0,0,0,0,0,0,0
20200430,052910,鴻海統一96購10,,,,,0.00,0.00,0,0,0,0,0,0,0,0,0,0,0,0,0
20200430,052911,友達統一97購02,,,,,0.00,0.00,0,0,0,0,0,0,0,0,0,0,0,0,0
20200430,052912,日月光統一96購01,,,,,0.00,0.00,0,0,0,0,0,0,0,0,0,0,0,0,0
20200430,052913,鴻海元富96購05,,,,,0.00,0.00,0,0,0,0,0,0,0,0,0,0,0,0,0
20200430,052914,奇力新元富96購01,,,,,0.00,0.00,0,0,0,0,0,0,0,0,0,0,0,0,0
20200430,052915,創意元富96購01,0.85,0.89,0.85,0.89,+0.02,2.3,11000,2,9750,0,0,0,0,0,0,1000,10000,-9000,-9000
20200430,052916,華新科富邦96購01,,,,,0.00,0.00,0,0,0,0,0,0,0,0,0,0,0,0,0
20200430,052917,大立光富邦99購02,0.39,0.41,0.37,0.41,+0.05,13.89,327000,25,129580,0,0,0,0,0,0,0,0,0,0
20200430,052918,智易富邦97購02,,,,,0.00,0.00,0,0,0,0,0,0,0,0,0,0,0,0,0
20200430,052919,鈺齊富邦98購01,0.12,0.12,0.11,0.11,0.00,0.00,20000,2,2250,0,0,0,0,0,0,15000,0,15000,15000
20200430,05291P,鴻海凱基95售16,,,,,0.00,0.00,0,0,0,0,0,0,0,0,0,0,0,0,0
20200430,052920,景碩台新96購02,0.41,0.41,0.03,0.03,0.00,0.00,30000,2,8500,0,0,0,0,0,0,20000,10000,10000,10000
20200430,052921,大成鋼永豐96購01,,,,,0.00,0.00,0,0,0,0,0,0,0,0,0,0,0,0,0
20200430,052922,國巨永豐96購01,0.10,0.17,0.10,0.17,+0.01,6.25,81000,2,8170,0,0,0,0,0,0,80000,0,80000,80000
20200430,052923,台積電永豐96購02,,,,,0.00,0.00,0,0,0,0,0,0,0,0,0,0,0,0,0
20200430,052924,旺宏永豐96購01,0.04,0.05,0.04,0.05,0.00,0.00,30000,2,1300,0,0,0,0,0,0,30000,0,30000,30000
20200430,052925,日電貿永豐96購01,,,,,0.00,0.00,0,0,0,0,0,0,0,0,0,0,0,0,0
20200430,052926,旺宏元大98購02,0.78,0.84,0.78,0.83,+0.21,33.87,36000,5,29980,0,0,0,0,0,0,1000,17000,-16000,-16000
20200430,052927,友達元大98購02,,,,,0.00,0.00,0,0,0,0,0,0,0,0,0,0,0,0,0
20200430,052928,美律元大98購01,0.21,0.26,0.21,0.26,0.00,0.00,10000,3,2280,0,0,0,0,0,0,10000,0,10000,10000
20200430,052929,可成元大96購02,,,,,0.00,0.00,0,0,0,0,0,0,0,0,0,0,0,0,0
20200430,05292P,台積電凱基95售16,,,,,0.00,0.00,0,0,0,0,0,0,0,0,0,0,0,0,0
20200430,052930,華新科元大97購03,,,,,0.00,0.00,0,0,0,0,0,0,0,0,0,0,0,0,0
20200430,052931,麗豐元大97購01,,,,,0.00,0.00,0,0,0,0,0,0,0,0,0,0,0,0,0
20200430,052932,正文元大97購01,,,,,0.00,0.00,0,0,0,0,0,0,0,0,0,0,0,0,0
20200430,052933,祥碩元大96購01,6.35,6.35,6.35,6.35,+0.60,10.43,10000,1,63500,0,0,0,0,0,0,10000,0,10000,10000
20200430,052934,中磊元大96購01,1.08,1.09,0.99,0.99,+0.03,3.12,85000,9,90150,0,0,0,0,0,0,75000,10000,65000,65000
20200430,052935,康友元大96購03,,,,,0.00,0.00,0,0,0,0,0,0,0,0,0,0,0,0,0
20200430,052936,華通兆豐98購01,0.19,0.27,0.19,0.27,0.00,0.00,53000,7,13270,0,0,0,0,0,0,23000,0,23000,23000
20200430,052937,國巨兆豐97購01,0.46,0.50,0.44,0.45,0.00,0.00,53000,9,24030,0,0,0,0,0,0,37000,0,37000,37000
20200430,052938,華新科兆豐96購01,,,,,0.00,0.00,0,0,0,0,0,0,0,0,0,0,0,0,0
20200430,052939,富邦金兆豐96購01,0.28,0.38,0.27,0.38,+0.10,35.71,153000,10,47440,0,0,0,0,0,0,133000,0,133000,133000
20200430,05293P,廣達凱基95售01,,,,,0.00,0.00,0,0,0,0,0,0,0,0,0,0,0,0,0
20200430,052940,玉晶光兆豐97購01,1.33,1.33,1.33,1.33,0.00,0.00,2000,1,2660,0,0,0,0,0,0,2000,0,2000,2000
20200430,052941,康控兆豐97購01,0.25,0.26,0.22,0.26,0.00,0.00,264000,4,64940,0,0,0,0,0,0,214000,50000,164000,164000
20200430,052942,聯發科中信97購04,0.17,0.28,0.17,0.28,+0.13,86.67,906000,33,189050,0,0,0,0,0,0,781000,0,781000,781000
20200430,052943,奇力新國票96購02,0.64,0.67,0.64,0.67,+0.09,15.52,352000,4,233380,0,0,0,0,0,0,200000,152000,48000,48000
20200430,052944,宏達電國票97購01,,,,,0.00,0.00,0,0,0,0,0,0,0,0,0,0,0,0,0
20200430,052945,嘉晶國票97購01,0.65,0.88,0.65,0.86,0.00,0.00,253000,8,202640,0,0,0,0,0,0,2000,251000,-249000,-249000
20200430,052946,智原國票97購02,1.04,1.06,1.04,1.06,+0.02,1.92,44000,3,46400,0,0,0,0,0,0,0,44000,-44000,-44000
20200430,052947,晶技國票97購01,,,,,0.00,0.00,0,0,0,0,0,0,0,0,0,0,0,0,0
20200430,052948,景碩國票97購02,,,,,0.00,0.00,0,0,0,0,0,0,0,0,0,0,0,0,0
20200430,052949,智易國票97購02,,,,,0.00,0.00,0,0,0,0,0,0,0,0,0,0,0,0,0
20200430,05294P,亞光凱基95售02,,,,,0.00,0.00,0,0,0,0,0,0,0,0,0,0,0,0,0
20200430,052950,超眾國票98購01,,,,,0.00,0.00,0,0,0,0,0,0,0,0,0,0,0,0,0
20200430,052951,GIS國票97購02,,,,,0.00,0.00,0,0,0,0,0,0,0,0,0,0,0,0,0
20200430,052952,矽創國票97購02,,,,,0.00,0.00,0,0,0,0,0,0,0,0,0,0,0,0,0
20200430,052953,百和國票97購01,0.77,0.77,0.73,0.73,-0.03,-3.95,86000,7,65430,0,0,0,0,0,0,47000,39000,8000,8000
20200430,052954,大成鋼日盛96購01,,,,,0.00,0.00,0,0,0,0,0,0,0,0,0,0,0,0,0
20200430,052955,國巨日盛96購01,0.75,0.75,0.75,0.75,+0.38,102.7,40000,1,30000,0,0,0,0,0,0,0,0,0,0
20200430,052956,聯發科日盛96購01,,,,,0.00,0.00,0,0,0,0,0,0,0,0,0,0,0,0,0
20200430,052957,T50反1凱基99購01,,,,,0.00,0.00,0,0,0,0,0,0,0,0,0,0,0,0,0
20200430,052958,T50反1凱基99購02,,,,,0.00,0.00,0,0,0,0,0,0,0,0,0,0,0,0,0
20200430,052959,聯電凱基97購01,0.31,0.32,0.30,0.32,+0.01,3.23,203000,27,63720,0,0,0,0,0,0,173000,30000,143000,143000
20200430,05295P,緯創凱基95售01,,,,,0.00,0.00,0,0,0,0,0,0,0,0,0,0,0,0,0
20200430,052960,中環凱基96購01,,,,,0.00,0.00,0,0,0,0,0,0,0,0,0,0,0,0,0
20200430,052961,國巨凱基97購02,,,,,0.00,0.00,0,0,0,0,0,0,0,0,0,0,0,0,0
20200430,052962,台積電凱基97購03,,,,,0.00,0.00,0,0,0,0,0,0,0,0,0,0,0,0,0
20200430,052963,智邦凱基96購02,,,,,0.00,0.00,0,0,0,0,0,0,0,0,0,0,0,0,0
20200430,052964,台表科凱基96購03,,,,,0.00,0.00,0,0,0,0,0,0,0,0,0,0,0,0,0
20200430,052965,廣宇群益97購01,,,,,0.00,0.00,0,0,0,0,0,0,0,0,0,0,0,0,0
20200430,052966,光磊群益96購01,,,,,0.00,0.00,0,0,0,0,0,0,0,0,0,0,0,0,0
20200430,052967,智邦群益96購01,,,,,0.00,0.00,0,0,0,0,0,0,0,0,0,0,0,0,0
20200430,052968,燿華群益98購01,0.50,0.55,0.50,0.55,+0.07,14.58,221000,7,115140,0,0,0,0,0,0,100000,121000,-21000,-21000
20200430,052969,建準群益97購01,0.42,0.43,0.38,0.39,-0.03,-7.14,71000,5,28610,0,0,0,0,0,0,20000,51000,-31000,-31000
20200430,05296P,牧德凱基96售01,,,,,0.00,0.00,0,0,0,0,0,0,0,0,0,0,0,0,0
20200430,052970,美律群益96購01,,,,,0.00,0.00,0,0,0,0,0,0,0,0,0,0,0,0,0
20200430,052971,京元電群益98購01,,,,,0.00,0.00,0,0,0,0,0,0,0,0,0,0,0,0,0
20200430,052972,義隆群益96購04,1.77,2.08,1.77,2.00,+0.22,12.36,91000,7,176640,0,0,0,0,0,0,59000,31000,28000,28000
20200430,052973,冠德群益96購01,,,,,0.00,0.00,0,0,0,0,0,0,0,0,0,0,0,0,0
20200430,052974,瀚宇博群益96購01,,,,,0.00,0.00,0,0,0,0,0,0,0,0,0,0,0,0,0
20200430,052975,嘉聯益群益96購01,,,,,0.00,0.00,0,0,0,0,0,0,0,0,0,0,0,0,0
20200430,052976,台表科群益96購03,,,,,0.00,0.00,0,0,0,0,0,0,0,0,0,0,0,0,0
20200430,052977,奇力新麥證97購01,,,,,0.00,0.00,0,0,0,0,0,0,0,0,0,0,0,0,0
20200430,052978,貿聯麥證97購01,0.30,0.30,0.30,0.30,0.00,0.00,2000,1,600,0,2000,-2000,0,0,0,0,2000,-2000,-2000
20200430,052979,上銀元大96購02,0.70,0.97,0.70,0.97,+0.44,83.02,71000,11,58450,0,0,0,0,0,0,49000,0,49000,49000
20200430,05297P,臻鼎凱基95售04,1.53,1.53,1.53,1.53,0.00,0.00,40000,2,61200,0,0,0,0,0,0,40000,0,40000,40000
20200430,052980,上銀元大96購03,1.13,1.38,1.13,1.33,+0.64,92.75,50000,4,63350,0,0,0,0,0,0,45000,5000,40000,40000
20200430,052981,鴻海元大97購05,0.13,0.13,0.12,0.12,+0.01,9.09,20000,2,2500,0,0,0,0,0,0,10000,0,10000,10000
20200430,052982,鴻海元大97購06,,,,,0.00,0.00,0,0,0,0,0,0,0,0,0,0,0,0,0
20200430,052983,國巨元大96購07,,,,,0.00,0.00,0,0,0,0,0,0,0,0,0,0,0,0,0
20200430,052984,漢唐元大96購01,,,,,0.00,0.00,0,0,0,0,0,0,0,0,0,0,0,0,0
20200430,052985,美律元大96購02,,,,,0.00,0.00,0,0,0,0,0,0,0,0,0,0,0,0,0
20200430,052986,聯發科元大97購05,0.45,0.57,0.43,0.51,+0.15,41.67,1633000,83,760410,0,0,0,0,0,0,1540000,0,1540000,1540000
20200430,052987,華新科元大99購01,,,,,0.00,0.00,0,0,0,0,0,0,0,0,0,0,0,0,0
20200430,052988,智易元大96購02,0.20,0.20,0.20,0.20,0.00,0.00,1000,1,200,0,0,0,0,0,0,1000,0,1000,1000
20200430,052989,麗豐元大98購01,,,,,0.00,0.00,0,0,0,0,0,0,0,0,0,0,0,0,0
20200430,05298P,上銀元大95售03,,,,,0.00,0.00,0,0,0,0,0,0,0,0,0,0,0,0,0
20200430,052990,超眾元大97購01,2.63,2.63,2.55,2.57,+0.06,2.39,31000,3,81090,0,0,0,0,0,0,0,31000,-31000,-31000
20200430,052991,台積電台新96購01,,,,,0.00,0.00,0,0,0,0,0,0,0,0,0,0,0,0,0
20200430,052992,冠德台新96購01,,,,,0.00,0.00,0,0,0,0,0,0,0,0,0,0,0,0,0
20200430,052993,欣興台新97購01,0.05,0.05,0.05,0.05,0.00,0.00,10000,1,500,0,0,0,0,0,0,0,10000,-10000,-10000
20200430,052994,群創台新99購01,0.02,0.02,0.02,0.02,0.00,0.00,10000,1,200,0,0,0,0,0,0,0,10000,-10000,-10000
20200430,052995,上銀康和96購01,,,,,0.00,0.00,0,0,0,0,0,0,0,0,0,0,0,0,0
20200430,052996,聯電康和96購01,0.14,0.16,0.14,0.16,0.00,0.00,32000,2,5080,0,0,0,0,0,0,32000,0,32000,32000
20200430,052997,國巨康和96購01,1.00,1.00,0.92,0.97,+0.06,6.59,120000,8,115560,0,0,0,0,0,0,120000,0,120000,120000
20200430,052998,拓凱康和96購01,0.12,0.12,0.12,0.12,-0.03,-20.0,20000,1,2400,0,0,0,0,0,0,20000,0,20000,20000
20200430,052999,臺股指康和96購01,0.06,0.06,0.06,0.06,0.00,0.00,115000,2,6900,0,0,0,0,0,0,115000,0,115000,115000
20200430,05299P,旺宏元大95售04,,,,,0.00,0.00,0,0,0,0,0,0,0,0,0,0,0,0,0
20200430,053000,臺股指康和96購02,,,,,0.00,0.00,0,0,0,0,0,0,0,0,0,0,0,0,0
20200430,053001,力山永豐96購01,0.50,0.50,0.48,0.50,0.00,0.00,16000,3,7800,0,0,0,0,0,0,15000,0,15000,15000
20200430,053002,鴻海永豐96購01,,,,,0.00,0.00,0,0,0,0,0,0,0,0,0,0,0,0,0
20200430,053003,國巨永豐96購02,1.16,1.16,1.16,1.16,+0.05,4.5,1000,1,1160,0,0,0,0,0,0,1000,0,1000,1000
20200430,053004,燿華永豐96購01,,,,,0.00,0.00,0,0,0,0,0,0,0,0,0,0,0,0,0
20200430,053005,微星永豐96購01,0.29,0.29,0.29,0.29,-0.03,-9.38,15000,1,4350,0,0,0,0,0,0,0,15000,-15000,-15000
20200430,053006,玉晶光永豐96購03,1.42,1.65,1.41,1.65,+0.34,25.95,452000,21,659160,0,0,0,0,0,0,366000,93000,273000,273000
20200430,053007,致伸永豐96購01,,,,,0.00,0.00,0,0,0,0,0,0,0,0,0,0,0,0,0
20200430,053008,達方永豐96購01,,,,,0.00,0.00,0,0,0,0,0,0,0,0,0,0,0,0,0
20200430,053009,大成鋼統一96購02,,,,,0.00,0.00,0,0,0,0,0,0,0,0,0,0,0,0,0
20200430,05300P,健策元大95售02,,,,,0.00,0.00,0,0,0,0,0,0,0,0,0,0,0,0,0
20200430,053010,鴻海統一96購11,,,,,0.00,0.00,0,0,0,0,0,0,0,0,0,0,0,0,0
20200430,053011,鴻海統一98購01,,,,,0.00,0.00,0,0,0,0,0,0,0,0,0,0,0,0,0
20200430,053012,國巨統一96購03,,,,,0.00,0.00,0,0,0,0,0,0,0,0,0,0,0,0,0
20200430,053013,台積電統一97購01,,,,,0.00,0.00,0,0,0,0,0,0,0,0,0,0,0,0,0
20200430,053014,旺宏統一97購02,,,,,0.00,0.00,0,0,0,0,0,0,0,0,0,0,0,0,0
20200430,053015,緯創統一96購01,0.12,0.12,0.12,0.12,0.00,0.00,1000,1,120,0,0,0,0,0,0,0,1000,-1000,-1000
20200430,053016,鈺齊統一96購01,,,,,0.00,0.00,0,0,0,0,0,0,0,0,0,0,0,0,0
20200430,053017,世紀鋼統一96購02,2.34,2.53,2.34,2.53,+0.25,10.96,11000,6,26710,0,0,0,0,0,0,10000,1000,9000,9000
20200430,053018,旺宏元富96購02,1.80,1.91,1.77,1.77,+0.24,15.69,188000,17,351090,0,0,0,0,0,0,169000,0,169000,169000
20200430,053019,禾伸堂元富96購01,,,,,0.00,0.00,0,0,0,0,0,0,0,0,0,0,0,0,0
20200430,05301P,矽力元大95售02,0.03,0.04,0.03,0.04,0.00,0.00,23000,2,740,0,0,0,0,0,0,18000,0,18000,18000
20200430,053020,貿聯元富96購01,,,,,0.00,0.00,0,0,0,0,0,0,0,0,0,0,0,0,0
20200430,053021,國巨國泰97購04,,,,,0.00,0.00,0,0,0,0,0,0,0,0,0,0,0,0,0
20200430,053022,欣興國泰98購01,0.96,0.96,0.96,0.96,+0.32,50.0,1000,1,960,0,0,0,0,0,0,0,1000,-1000,-1000
20200430,053023,泰鼎國泰97購01,,,,,0.00,0.00,0,0,0,0,0,0,0,0,0,0,0,0,0
20200430,053024,國巨富邦97購02,,,,,0.00,0.00,0,0,0,0,0,0,0,0,0,0,0,0,0
20200430,053025,燿華富邦98購02,0.10,0.10,0.10,0.10,0.00,0.00,10000,1,1000,0,0,0,0,0,0,0,10000,-10000,-10000
20200430,053026,奇力新富邦98購01,,,,,0.00,0.00,0,0,0,0,0,0,0,0,0,0,0,0,0
20200430,053027,玉晶光富邦98購01,0.84,0.87,0.84,0.87,+0.07,8.75,47000,10,40210,0,0,0,0,0,0,31000,0,31000,31000
20200430,053028,康控富邦98購01,0.13,0.16,0.13,0.15,0.00,0.00,253000,7,37400,0,0,0,0,0,0,228000,0,228000,228000
20200430,053029,國巨第一96購01,0.38,0.45,0.30,0.30,+0.05,20.0,61000,7,24820,0,0,0,0,0,0,0,1000,-1000,-1000
20200430,05302P,華通國泰96售01,,,,,0.00,0.00,0,0,0,0,0,0,0,0,0,0,0,0,0
20200430,053030,南亞科第一96購01,,,,,0.00,0.00,0,0,0,0,0,0,0,0,0,0,0,0,0
20200430,053031,華新科第一96購01,,,,,0.00,0.00,0,0,0,0,0,0,0,0,0,0,0,0,0
20200430,053032,國巨兆豐97購02,0.36,0.36,0.36,0.36,+0.01,2.86,5000,2,1800,0,0,0,0,0,0,0,5000,-5000,-5000
20200430,053033,智易兆豐97購01,,,,,0.00,0.00,0,0,0,0,0,0,0,0,0,0,0,0,0
20200430,053034,上海銀兆豐96購01,,,,,0.00,0.00,0,0,0,0,0,0,0,0,0,0,0,0,0
20200430,053035,台表科兆豐97購01,,,,,0.00,0.00,0,0,0,0,0,0,0,0,0,0,0,0,0
20200430,053036,聯電凱基98購01,0.20,0.21,0.19,0.21,+0.02,10.53,50000,14,10210,0,0,0,0,0,0,21000,20000,1000,1000
20200430,053037,國巨凱基96購08,,,,,0.00,0.00,0,0,0,0,0,0,0,0,0,0,0,0,0
20200430,053038,華邦電凱基97購01,,,,,0.00,0.00,0,0,0,0,0,0,0,0,0,0,0,0,0
20200430,053039,聯發科凱基96購11,,,,,0.00,0.00,0,0,0,0,0,0,0,0,0,0,0,0,0
20200430,05303P,華通國泰97售01,,,,,0.00,0.00,0,0,0,0,0,0,0,0,0,0,0,0,0
20200430,053040,全新凱基98購01,,,,,0.00,0.00,0,0,0,0,0,0,0,0,0,0,0,0,0
20200430,053041,可成凱基96購02,0.56,0.56,0.56,0.56,-0.06,-9.68,2000,1,1120,0,0,0,0,0,0,0,2000,-2000,-2000
20200430,053042,大立光凱基97購03,0.74,0.75,0.74,0.75,+0.14,22.95,30000,2,22300,0,0,0,0,0,0,30000,0,30000,30000
20200430,053043,嘉晶凱基96購01,,,,,0.00,0.00,0,0,0,0,0,0,0,0,0,0,0,0,0
20200430,053044,南茂凱基96購02,,,,,0.00,0.00,0,0,0,0,0,0,0,0,0,0,0,0,0
20200430,053045,國巨中信97購01,0.34,0.34,0.34,0.34,+0.03,9.68,30000,1,10200,0,0,0,0,0,0,30000,0,30000,30000
20200430,053046,智易中信96購01,,,,,0.00,0.00,0,0,0,0,0,0,0,0,0,0,0,0,0
20200430,053047,寶成中信97購01,0.01,0.01,0.01,0.01,0.00,0.00,10000,1,100,0,0,0,0,0,0,0,0,0,0
20200430,053048,同欣電麥證96購01,0.13,0.13,0.13,0.13,0.00,0.00,2000,1,260,0,2000,-2000,0,0,0,0,2000,-2000,-2000
20200430,053049,T50反1國票98購01,,,,,0.00,0.00,0,0,0,0,0,0,0,0,0,0,0,0,0
20200430,05304P,國巨國泰97售02,,,,,0.00,0.00,0,0,0,0,0,0,0,0,0,0,0,0,0
20200430,053050,華通國票97購02,1.04,1.20,1.04,1.18,+0.28,31.11,261000,5,275560,0,0,0,0,0,0,33000,228000,-195000,-195000
20200430,053051,楠梓電國票97購01,0.27,0.27,0.27,0.27,-0.03,-10.0,25000,4,6750,0,0,0,0,0,0,25000,0,25000,25000
20200430,053052,旺宏國票97購02,,,,,0.00,0.00,0,0,0,0,0,0,0,0,0,0,0,0,0
20200430,053053,京元電國票97購02,0.47,0.47,0.47,0.47,0.00,0.00,10000,1,4700,0,0,0,0,0,0,0,0,0,0
20200430,053054,禾伸堂國票97購01,2.19,2.19,2.19,2.19,+0.17,8.42,8000,1,17520,0,0,0,0,0,0,0,8000,-8000,-8000
20200430,053055,聯詠國票97購01,0.39,0.43,0.37,0.43,+0.02,4.88,1111000,13,447390,0,0,0,0,0,0,338000,773000,-435000,-435000
20200430,053056,同欣電國票97購01,0.33,0.41,0.33,0.41,+0.08,24.24,215000,11,80810,0,0,0,0,0,0,8000,207000,-199000,-199000
20200430,053057,聯電國泰97購02,0.39,0.42,0.38,0.41,+0.03,7.89,195000,24,75900,0,0,0,0,0,0,70000,0,70000,70000
20200430,053058,台光電永昌99購01,,,,,0.00,0.00,0,0,0,0,0,0,0,0,0,0,0,0,0
20200430,053059,聯發科永昌99購01,,,,,0.00,0.00,0,0,0,0,0,0,0,0,0,0,0,0,0
20200430,05305P,華新科國泰97售01,,,,,0.00,0.00,0,0,0,0,0,0,0,0,0,0,0,0,0
20200430,053060,大立光永昌96購05,,,,,0.00,0.00,0,0,0,0,0,0,0,0,0,0,0,0,0
20200430,053061,GIS富邦97購01,0.10,0.10,0.10,0.10,0.00,0.00,3000,1,300,0,0,0,0,0,0,0,3000,-3000,-3000
20200430,053062,緯穎富邦97購01,2.11,2.41,2.06,2.41,+0.41,20.5,530000,39,1161480,0,0,0,0,0,0,229000,301000,-72000,-72000
20200430,053063,力山群益98購01,1.48,1.63,1.38,1.38,+0.07,5.34,1220000,91,1797020,0,0,0,0,0,0,235000,408000,-173000,-173000
20200430,053064,國巨群益96購04,4.37,4.61,4.22,4.38,+0.20,4.78,30000,29,132590,0,0,0,0,0,0,30000,30000,0,0
20200430,053065,大立光群益96購01,,,,,0.00,0.00,0,0,0,0,0,0,0,0,0,0,0,0,0
20200430,053066,欣興群益96購02,1.39,1.45,1.39,1.44,-0.02,-1.37,79000,6,110380,0,0,0,0,0,0,66000,14000,52000,52000
20200430,053067,牧德群益96購01,1.53,1.62,1.53,1.58,+0.19,13.67,142000,7,219660,0,0,0,0,0,0,0,132000,-132000,-132000
20200430,053068,智伸科群益96購01,,,,,0.00,0.00,0,0,0,0,0,0,0,0,0,0,0,0,0
20200430,053069,同欣電群益98購01,,,,,0.00,0.00,0,0,0,0,0,0,0,0,0,0,0,0,0
20200430,05306P,泰碩國泰97售01,0.65,0.69,0.65,0.68,-0.01,-1.45,100000,15,67480,0,0,0,0,0,0,60000,40000,20000,20000
20200430,053070,訊芯群益96購01,,,,,0.00,0.00,0,0,0,0,0,0,0,0,0,0,0,0,0
20200430,053071,南電群益96購01,,,,,0.00,0.00,0,0,0,0,0,0,0,0,0,0,0,0,0
20200430,053072,國巨台新97購01,1.90,1.99,1.87,1.92,+0.16,9.09,364000,23,708650,0,0,0,0,0,0,58000,307000,-249000,-249000
20200430,053073,技嘉康和96購01,0.41,0.43,0.41,0.43,+0.01,2.38,88000,2,37680,0,0,0,0,0,0,88000,0,88000,88000
20200430,053074,嘉晶永豐96購02,0.41,0.50,0.41,0.50,0.00,0.00,61000,3,29570,0,0,0,0,0,0,40000,21000,19000,19000
20200430,053075,欣興永豐96購01,,,,,0.00,0.00,0,0,0,0,0,0,0,0,0,0,0,0,0
20200430,053076,貿聯永豐96購01,,,,,0.00,0.00,0,0,0,0,0,0,0,0,0,0,0,0,0
20200430,053077,同欣電永豐96購01,,,,,0.00,0.00,0,0,0,0,0,0,0,0,0,0,0,0,0
20200430,053078,昇陽半永豐97購02,,,,,0.00,0.00,0,0,0,0,0,0,0,0,0,0,0,0,0
20200430,053079,世紀鋼永豐96購01,0.58,0.58,0.58,0.58,0.00,0.00,15000,1,8700,0,0,0,0,0,0,0,15000,-15000,-15000
20200430,05307P,光寶科中信95售01,,,,,0.00,0.00,0,0,0,0,0,0,0,0,0,0,0,0,0
20200430,053080,力山元大96購02,1.19,1.37,1.00,1.00,-0.03,-2.91,889000,78,1051270,180000,185000,-5000,0,0,0,465000,455000,10000,5000
20200430,053081,上銀元大97購02,1.71,1.71,1.71,1.71,+0.75,78.12,10000,1,17100,0,0,0,0,0,0,10000,0,10000,10000
20200430,053082,聯電元大98購03,0.30,0.32,0.30,0.32,+0.02,6.67,14000,2,4380,0,0,0,0,0,0,14000,0,14000,14000
20200430,053083,中環元大99購01,0.24,0.24,0.24,0.24,+0.03,14.29,125000,1,30000,0,0,0,0,0,0,0,125000,-125000,-125000
20200430,053084,國巨元大98購01,,,,,0.00,0.00,0,0,0,0,0,0,0,0,0,0,0,0,0
20200430,053085,華新科元大97購04,,,,,0.00,0.00,0,0,0,0,0,0,0,0,0,0,0,0,0
20200430,053086,宏達電元大97購01,,,,,0.00,0.00,0,0,0,0,0,0,0,0,0,0,0,0,0
20200430,053087,冠德元大96購02,,,,,0.00,0.00,0,0,0,0,0,0,0,0,0,0,0,0,0
20200430,053088,奇鋐元大98購01,0.53,0.53,0.53,0.53,0.00,0.00,498000,1,263940,0,0,0,0,0,0,498000,0,498000,498000
20200430,053089,貿聯元大97購02,0.17,0.21,0.17,0.21,0.00,0.00,30000,5,5600,0,0,0,0,0,0,30000,0,30000,30000
20200430,05308P,台積電中信95售08,,,,,0.00,0.00,0,0,0,0,0,0,0,0,0,0,0,0,0
20200430,053090,新唐元大96購01,0.12,0.12,0.12,0.12,0.00,0.00,30000,3,3600,0,0,0,0,0,0,30000,30000,0,0
20200430,053091,同欣電元大96購01,,,,,0.00,0.00,0,0,0,0,0,0,0,0,0,0,0,0,0
20200430,053092,台表科元大97購02,1.07,1.07,0.99,1.04,0.00,0.00,125000,8,128570,0,0,0,0,0,0,12000,115000,-103000,-103000
20200430,053093,緯穎元大96購06,3.65,3.85,3.65,3.85,0.00,0.00,266000,4,988600,0,0,0,0,0,0,266000,0,266000,266000
20200430,053094,聯電統一97購02,1.10,1.10,1.09,1.09,+0.01,0.93,32000,3,35110,0,0,0,0,0,0,23000,9000,14000,14000
20200430,053095,台光電統一98購01,0.96,1.12,0.94,1.12,+0.18,19.15,288000,10,289460,0,0,0,0,0,0,48000,240000,-192000,-192000
20200430,053096,康控統一96購01,,,,,0.00,0.00,0,0,0,0,0,0,0,0,0,0,0,0,0
20200430,053097,超眾統一96購03,,,,,0.00,0.00,0,0,0,0,0,0,0,0,0,0,0,0,0
20200430,053098,國巨元富96購04,,,,,0.00,0.00,0,0,0,0,0,0,0,0,0,0,0,0,0
20200430,053099,正崴元富96購01,,,,,0.00,0.00,0,0,0,0,0,0,0,0,0,0,0,0,0
20200430,05309P,康友中信95售03,,,,,0.00,0.00,0,0,0,0,0,0,0,0,0,0,0,0,0
20200430,053100,美律元富96購01,,,,,0.00,0.00,0,0,0,0,0,0,0,0,0,0,0,0,0
20200430,053101,創意元富96購03,0.90,0.91,0.90,0.91,+0.01,1.11,40000,2,36100,0,0,0,0,0,0,30000,10000,20000,20000
20200430,053102,祥碩元富96購01,,,,,0.00,0.00,0,0,0,0,0,0,0,0,0,0,0,0,0
20200430,053103,瀚宇博元富96購01,0.99,1.05,0.98,1.04,+0.04,4.0,276000,14,277240,0,0,0,0,0,0,115000,161000,-46000,-46000
20200430,053104,台表科元富96購02,0.24,0.24,0.22,0.23,0.00,0.00,6000,3,1380,0,0,0,0,0,0,0,4000,-4000,-4000
20200430,053105,鴻海兆豐97購01,,,,,0.00,0.00,0,0,0,0,0,0,0,0,0,0,0,0,0
20200430,053106,鴻海兆豐98購01,0.07,0.07,0.07,0.07,0.00,0.00,60000,2,4200,0,0,0,0,0,0,0,0,0,0
20200430,053107,旺宏兆豐97購01,1.02,1.19,1.02,1.06,+0.09,9.28,1434000,21,1517160,0,0,0,0,0,0,1338000,86000,1252000,1252000
20200430,053108,南亞科兆豐96購01,,,,,0.00,0.00,0,0,0,0,0,0,0,0,0,0,0,0,0
20200430,053109,聯發科兆豐96購01,,,,,0.00,0.00,0,0,0,0,0,0,0,0,0,0,0,0,0
20200430,05310P,智原永豐95售04,0.90,0.95,0.90,0.95,-0.09,-8.65,95000,3,87770,0,0,0,0,0,0,37000,58000,-21000,-21000
20200430,053110,大立光兆豐97購01,,,,,0.00,0.00,0,0,0,0,0,0,0,0,0,0,0,0,0
20200430,053111,緯創兆豐97購01,1.26,1.35,1.22,1.35,+0.09,7.14,283000,16,358370,0,0,0,0,0,0,96000,187000,-91000,-91000
20200430,053112,中磊兆豐97購01,1.10,1.11,1.06,1.08,0.00,0.00,338000,10,365910,0,0,0,0,0,0,138000,200000,-62000,-62000
20200430,053113,瀚宇博兆豐97購01,0.72,0.76,0.72,0.76,+0.04,5.56,260000,11,189220,0,0,0,0,0,0,121000,139000,-18000,-18000
20200430,053114,聯茂兆豐97購01,0.59,0.59,0.59,0.59,-0.03,-4.84,11000,4,6490,0,0,0,0,0,0,11000,0,11000,11000
20200430,053115,滬深2X中信97購01,0.45,0.46,0.42,0.42,+0.05,13.51,223000,22,95550,0,0,0,0,0,0,23000,200000,-177000,-177000
20200430,053116,華新科中信96購01,,,,,0.00,0.00,0,0,0,0,0,0,0,0,0,0,0,0,0
20200430,053117,大立光中信9A購02,,,,,0.00,0.00,0,0,0,0,0,0,0,0,0,0,0,0,0
20200430,053118,大立光中信9C購01,0.35,0.40,0.35,0.40,+0.07,21.21,622000,10,239950,0,0,0,0,0,0,7000,605000,-598000,-598000
20200430,053119,日月光中信97購01,,,,,0.00,0.00,0,0,0,0,0,0,0,0,0,0,0,0,0
20200430,05311P,臺股指群益95售10,,,,,0.00,0.00,0,0,0,0,0,0,0,0,0,0,0,0,0
20200430,053120,復盛中信9A購01,,,,,0.00,0.00,0,0,0,0,0,0,0,0,0,0,0,0,0
20200430,053121,上証2X凱基9C購01,1.14,1.16,1.14,1.16,0.00,0.00,91000,2,104060,0,0,0,0,0,0,91000,0,91000,91000
20200430,053122,美律凱基98購01,0.24,0.24,0.24,0.24,0.00,0.00,20000,1,4800,0,0,0,0,0,0,20000,0,20000,20000
20200430,053123,京元電凱基96購01,,,,,0.00,0.00,0,0,0,0,0,0,0,0,0,0,0,0,0
20200430,053124,聯發科凱基96購12,1.57,1.57,1.57,1.57,+0.39,33.05,23000,1,36110,0,0,0,0,0,0,0,23000,-23000,-23000
20200430,053125,宏達電凱基96購01,,,,,0.00,0.00,0,0,0,0,0,0,0,0,0,0,0,0,0
20200430,053126,健策凱基97購02,,,,,0.00,0.00,0,0,0,0,0,0,0,0,0,0,0,0,0
20200430,053127,貿聯凱基97購01,0.54,0.62,0.54,0.62,+0.11,21.57,71000,6,40750,0,0,0,0,0,0,36000,35000,1000,1000
20200430,053128,瀚宇博凱基96購01,,,,,0.00,0.00,0,0,0,0,0,0,0,0,0,0,0,0,0
20200430,053129,緯穎凱基96購01,2.51,2.55,2.49,2.49,+0.14,5.96,80000,8,202820,0,0,0,0,0,0,80000,30000,50000,50000
20200430,05312P,臺股指群益95售11,,,,,0.00,0.00,0,0,0,0,0,0,0,0,0,0,0,0,0
20200430,053130,聯發科麥證96購01,0.83,0.94,0.83,0.94,+0.26,38.24,101000,2,83940,101000,0,101000,0,0,0,101000,0,101000,101000
20200430,053131,華通國票97購03,0.02,0.02,0.02,0.02,0.00,0.00,20000,1,400,0,0,0,0,0,0,0,0,0,0
20200430,053132,國巨國票97購02,0.97,0.97,0.97,0.97,0.00,0.00,10000,1,9700,0,0,0,0,0,0,0,10000,-10000,-10000
20200430,053133,華邦電國票97購01,,,,,0.00,0.00,0,0,0,0,0,0,0,0,0,0,0,0,0
20200430,053134,南亞科國票97購01,1.63,1.64,1.63,1.64,+0.04,2.5,58000,2,94940,0,0,0,0,0,0,58000,0,58000,58000
20200430,053135,信邦國票96購01,,,,,0.00,0.00,0,0,0,0,0,0,0,0,0,0,0,0,0
20200430,053136,彩晶國票97購01,,,,,0.00,0.00,0,0,0,0,0,0,0,0,0,0,0,0,0
20200430,053137,旺宏富邦98購01,0.51,0.51,0.39,0.48,+0.09,23.08,17000,6,7900,0,0,0,0,0,0,4000,2000,2000,2000
20200430,053138,華邦電富邦96購01,,,,,0.00,0.00,0,0,0,0,0,0,0,0,0,0,0,0,0
20200430,053139,滬深2X永豐98購01,,,,,0.00,0.00,0,0,0,0,0,0,0,0,0,0,0,0,0
20200430,05313P,臺股指群益95售12,,,,,0.00,0.00,0,0,0,0,0,0,0,0,0,0,0,0,0
20200430,053140,燿華永豐96購02,,,,,0.00,0.00,0,0,0,0,0,0,0,0,0,0,0,0,0
20200430,053141,景碩永豐96購02,,,,,0.00,0.00,0,0,0,0,0,0,0,0,0,0,0,0,0
20200430,053142,緯穎永豐96購01,1.14,1.62,1.10,1.62,+0.62,62.0,307000,41,400520,0,0,0,0,0,0,84000,203000,-119000,-119000
20200430,053143,昇陽半永豐96購03,,,,,0.00,0.00,0,0,0,0,0,0,0,0,0,0,0,0,0
20200430,053144,上証2X元大96購01,,,,,0.00,0.00,0,0,0,0,0,0,0,0,0,0,0,0,0
20200430,053145,元黃金元大96購02,0.71,0.71,0.71,0.71,0.00,0.00,80000,1,56800,0,0,0,0,0,0,80000,0,80000,80000
20200430,053146,滬深2X元大96購08,0.12,0.13,0.12,0.13,0.00,0.00,80000,2,9800,0,0,0,0,0,0,80000,0,80000,80000
20200430,053147,楠梓電元大98購01,,,,,0.00,0.00,0,0,0,0,0,0,0,0,0,0,0,0,0
20200430,053148,華邦電元大96購01,,,,,0.00,0.00,0,0,0,0,0,0,0,0,0,0,0,0,0
20200430,053149,京元電元大96購02,1.25,1.25,1.16,1.20,+0.01,0.84,292000,10,346400,0,0,0,0,0,0,100000,192000,-92000,-92000
20200430,05314P,臺股指群益95售13,,,,,0.00,0.00,0,0,0,0,0,0,0,0,0,0,0,0,0
20200430,053150,聯發科元大96購11,,,,,0.00,0.00,0,0,0,0,0,0,0,0,0,0,0,0,0
20200430,053151,華新科元大96購04,,,,,0.00,0.00,0,0,0,0,0,0,0,0,0,0,0,0,0
20200430,053152,大立光元大99購01,,,,,0.00,0.00,0,0,0,0,0,0,0,0,0,0,0,0,0
20200430,053153,大立光元大99購02,0.51,0.59,0.51,0.59,+0.15,34.09,32000,5,18280,0,0,0,0,0,0,32000,0,32000,32000
20200430,053154,聯詠元大96購01,,,,,0.00,0.00,0,0,0,0,0,0,0,0,0,0,0,0,0
20200430,053155,晶技元大97購02,3.90,4.20,3.90,4.20,0.00,0.00,15000,3,60740,0,0,0,0,0,0,14000,0,14000,14000
20200430,053156,緯創元大96購02,,,,,0.00,0.00,0,0,0,0,0,0,0,0,0,0,0,0,0
20200430,053157,日月光元大96購03,,,,,0.00,0.00,0,0,0,0,0,0,0,0,0,0,0,0,0
20200430,053158,茂林元大96購01,1.04,1.06,1.01,1.02,-0.08,-7.27,194000,13,199280,0,0,0,0,0,0,193000,1000,192000,192000
20200430,053159,同欣電元大96購02,0.29,0.31,0.29,0.31,+0.06,24.0,60000,3,18200,0,0,0,0,0,0,0,60000,-60000,-60000
20200430,05315P,鴻海永昌96售08,,,,,0.00,0.00,0,0,0,0,0,0,0,0,0,0,0,0,0
20200430,053160,台表科元大96購03,,,,,0.00,0.00,0,0,0,0,0,0,0,0,0,0,0,0,0
20200430,053161,康友元大96購04,,,,,0.00,0.00,0,0,0,0,0,0,0,0,0,0,0,0,0
20200430,053162,緯穎元大97購01,,,,,0.00,0.00,0,0,0,0,0,0,0,0,0,0,0,0,0
20200430,053163,上証2X群益9A購02,,,,,0.00,0.00,0,0,0,0,0,0,0,0,0,0,0,0,0
20200430,053164,台光電群益96購02,,,,,0.00,0.00,0,0,0,0,0,0,0,0,0,0,0,0,0
20200430,053165,大立光群益96購03,0.09,0.09,0.09,0.09,+0.04,80.0,6000,1,540,0,0,0,0,0,0,6000,0,6000,6000
20200430,053166,聯詠群益96購02,0.17,0.17,0.17,0.17,0.00,0.00,70000,1,11900,0,0,0,0,0,0,70000,0,70000,70000
20200430,053167,欣興群益96購03,,,,,0.00,0.00,0,0,0,0,0,0,0,0,0,0,0,0,0
20200430,053168,晶技群益98購01,,,,,0.00,0.00,0,0,0,0,0,0,0,0,0,0,0,0,0
20200430,053169,貿聯群益97購01,,,,,0.00,0.00,0,0,0,0,0,0,0,0,0,0,0,0,0
20200430,05316P,台積電永昌96售06,0.60,0.60,0.60,0.60,0.00,0.00,2000,1,1200,0,0,0,0,0,0,0,0,0,0
20200430,053170,茂林群益96購04,2.34,2.34,2.11,2.11,-0.12,-5.38,358000,6,763930,0,0,0,0,0,0,354000,4000,350000,350000
20200430,053171,中磊群益96購01,1.16,1.16,1.14,1.15,-0.01,-0.86,255000,6,293420,0,0,0,0,0,0,146000,109000,37000,37000
20200430,053172,瑞儀群益97購01,,,,,0.00,0.00,0,0,0,0,0,0,0,0,0,0,0,0,0
20200430,053173,矽格群益97購01,0.88,0.96,0.88,0.96,+0.08,9.09,192000,4,171480,0,0,0,0,0,0,182000,10000,172000,172000
20200430,053174,同欣電群益98購02,0.67,0.67,0.67,0.67,0.00,0.00,2000,1,1340,0,0,0,0,0,0,2000,0,2000,2000
20200430,053175,矽力群益96購01,,,,,0.00,0.00,0,0,0,0,0,0,0,0,0,0,0,0,0
20200430,053176,矽力群益96購02,2.60,2.60,2.25,2.25,-0.88,-28.12,25000,3,60750,0,0,0,0,0,0,0,25000,-25000,-25000
20200430,053177,華邦電統一96購01,0.22,0.23,0.22,0.23,+0.05,27.78,203000,11,45490,0,0,0,0,0,0,68000,135000,-67000,-67000
20200430,053178,南亞科統一98購01,,,,,0.00,0.00,0,0,0,0,0,0,0,0,0,0,0,0,0
20200430,053179,大立光統一96購04,0.01,0.01,0.01,0.01,0.00,0.00,13000,13,130,0,0,0,0,0,0,0,0,0,0
20200430,05317P,臺股指永昌95售02,,,,,0.00,0.00,0,0,0,0,0,0,0,0,0,0,0,0,0
20200430,053180,同欣電統一96購01,,,,,0.00,0.00,0,0,0,0,0,0,0,0,0,0,0,0,0
20200430,053181,滬深2X元富99購02,,,,,0.00,0.00,0,0,0,0,0,0,0,0,0,0,0,0,0
20200430,053182,大立光元富96購02,0.01,0.01,0.01,0.01,0.00,0.00,35000,2,350,0,0,0,0,0,0,35000,0,35000,35000
20200430,053183,大立光元富96購03,0.48,0.48,0.48,0.48,0.00,0.00,22000,1,10560,0,0,0,0,0,0,22000,0,22000,22000
20200430,053184,世紀鋼元富96購01,1.67,1.87,1.65,1.87,+0.20,11.98,113000,13,190730,0,0,0,0,0,0,7000,106000,-99000,-99000
20200430,053185,友達中信99購01,,,,,0.00,0.00,0,0,0,0,0,0,0,0,0,0,0,0,0
20200430,053186,健策中信9C購01,0.80,0.83,0.76,0.80,+0.04,5.26,208000,17,164680,0,0,0,0,0,0,84000,124000,-40000,-40000
20200430,053187,國巨統一96購05,1.09,1.11,1.05,1.11,+0.15,15.62,118000,7,126830,0,0,0,0,0,0,110000,13000,97000,97000
20200430,053188,旺宏統一97購03,0.67,0.67,0.61,0.61,+0.12,24.49,175000,18,115900,0,0,0,0,0,0,155000,175000,-20000,-20000
20200430,053189,聯發科統一96購05,2.09,2.21,2.09,2.21,+0.53,31.55,262000,8,572020,0,0,0,0,0,0,37000,225000,-188000,-188000
20200430,05318P,臺股指永昌95售03,,,,,0.00,0.00,0,0,0,0,0,0,0,0,0,0,0,0,0
20200430,053190,聯發科統一99購01,0.21,0.24,0.21,0.24,+0.08,50.0,640000,5,142800,0,0,0,0,0,0,640000,0,640000,640000
20200430,053191,奇鋐統一96購01,,,,,0.00,0.00,0,0,0,0,0,0,0,0,0,0,0,0,0
20200430,053192,創意統一96購01,,,,,0.00,0.00,0,0,0,0,0,0,0,0,0,0,0,0,0
20200430,053193,超眾統一97購01,,,,,0.00,0.00,0,0,0,0,0,0,0,0,0,0,0,0,0
20200430,053194,緯穎統一99購01,2.04,2.04,2.02,2.02,0.00,0.00,4000,2,8120,0,0,0,0,0,0,0,4000,-4000,-4000
20200430,053195,玉晶光元富96購02,8.20,9.60,8.20,9.50,+1.55,19.5,69000,20,602050,0,0,0,0,0,0,27000,42000,-15000,-15000
20200430,053196,康控元富96購01,,,,,0.00,0.00,0,0,0,0,0,0,0,0,0,0,0,0,0
20200430,053197,超眾元富96購02,,,,,0.00,0.00,0,0,0,0,0,0,0,0,0,0,0,0,0
20200430,053198,亞德客日盛96購01,2.76,3.59,2.52,3.59,+1.08,43.03,717000,52,2022350,0,0,0,0,0,0,338000,409000,-71000,-71000
20200430,053199,旺宏日盛96購01,0.36,0.36,0.36,0.36,0.00,0.00,20000,1,7200,0,0,0,0,0,0,20000,0,20000,20000
20200430,05319P,上銀凱基95售02,,,,,0.00,0.00,0,0,0,0,0,0,0,0,0,0,0,0,0
20200430,053200,華邦電日盛96購01,,,,,0.00,0.00,0,0,0,0,0,0,0,0,0,0,0,0,0
20200430,053201,美律日盛96購01,,,,,0.00,0.00,0,0,0,0,0,0,0,0,0,0,0,0,0
20200430,053202,聯發科日盛96購02,0.92,0.92,0.92,0.92,0.00,0.00,36000,4,33120,0,0,0,0,0,0,0,36000,-36000,-36000
20200430,053203,智易日盛96購01,0.36,0.36,0.34,0.34,-0.06,-15.0,22000,3,7720,0,0,0,0,0,0,12000,10000,2000,2000
20200430,053204,旺宏麥證96購01,0.64,0.64,0.60,0.63,0.00,0.00,20000,3,12550,20000,0,20000,0,0,0,20000,0,20000,20000
20200430,053205,台光電麥證96購01,0.92,1.26,0.92,1.26,+0.37,41.57,205000,14,203200,60000,145000,-85000,0,0,0,60000,145000,-85000,-85000
20200430,053206,聯發科麥證96購02,,,,,0.00,0.00,0,0,0,0,0,0,0,0,0,0,0,0,0
20200430,053207,SP黃豆凱基96購01,,,,,0.00,0.00,0,0,0,0,0,0,0,0,0,0,0,0,0
20200430,053208,鴻海凱基96購13,,,,,0.00,0.00,0,0,0,0,0,0,0,0,0,0,0,0,0
20200430,053209,台積電凱基96購07,1.14,1.14,1.14,1.14,+0.17,17.53,5000,5,5700,0,0,0,0,0,0,0,5000,-5000,-5000
20200430,05320P,華通凱基96售03,,,,,0.00,0.00,0,0,0,0,0,0,0,0,0,0,0,0,0
20200430,053210,華邦電凱基97購02,,,,,0.00,0.00,0,0,0,0,0,0,0,0,0,0,0,0,0
20200430,053211,漢唐凱基96購03,1.28,1.28,1.28,1.28,+0.06,4.92,15000,1,19200,0,0,0,0,0,0,15000,0,15000,15000
20200430,053212,友達凱基99購04,,,,,0.00,0.00,0,0,0,0,0,0,0,0,0,0,0,0,0
20200430,053213,建準凱基96購02,,,,,0.00,0.00,0,0,0,0,0,0,0,0,0,0,0,0,0
20200430,053214,冠德凱基96購02,,,,,0.00,0.00,0,0,0,0,0,0,0,0,0,0,0,0,0
20200430,053215,禾伸堂凱基96購01,,,,,0.00,0.00,0,0,0,0,0,0,0,0,0,0,0,0,0
20200430,053216,京鼎凱基96購02,0.42,0.42,0.42,0.42,+0.03,7.69,77000,3,32340,0,0,0,0,0,0,37000,40000,-3000,-3000
20200430,053217,群創凱基99購02,,,,,0.00,0.00,0,0,0,0,0,0,0,0,0,0,0,0,0
20200430,053218,TPK凱基96購01,,,,,0.00,0.00,0,0,0,0,0,0,0,0,0,0,0,0,0
20200430,053219,祥碩凱基96購01,3.04,3.07,2.13,2.32,-0.44,-15.94,48000,14,119050,0,0,0,0,0,0,14000,34000,-20000,-20000
20200430,05321P,鴻海凱基95售17,,,,,0.00,0.00,0,0,0,0,0,0,0,0,0,0,0,0,0
20200430,053220,瀚宇博凱基98購01,0.20,0.20,0.20,0.20,0.00,0.00,10000,1,2000,0,0,0,0,0,0,10000,0,10000,10000
20200430,053221,彩晶凱基98購01,,,,,0.00,0.00,0,0,0,0,0,0,0,0,0,0,0,0,0
20200430,053222,聯茂凱基96購03,,,,,0.00,0.00,0,0,0,0,0,0,0,0,0,0,0,0,0
20200430,053223,台郡凱基96購02,,,,,0.00,0.00,0,0,0,0,0,0,0,0,0,0,0,0,0
20200430,053224,矽力凱基96購02,,,,,0.00,0.00,0,0,0,0,0,0,0,0,0,0,0,0,0
20200430,053225,昇陽半凱基96購01,,,,,0.00,0.00,0,0,0,0,0,0,0,0,0,0,0,0,0
20200430,053226,國巨台新97購02,,,,,0.00,0.00,0,0,0,0,0,0,0,0,0,0,0,0,0
20200430,053227,晶技台新96購01,,,,,0.00,0.00,0,0,0,0,0,0,0,0,0,0,0,0,0
20200430,053228,康友台新97購01,,,,,0.00,0.00,0,0,0,0,0,0,0,0,0,0,0,0,0
20200430,053229,南電台新97購01,,,,,0.00,0.00,0,0,0,0,0,0,0,0,0,0,0,0,0
20200430,05322P,台積電凱基95售17,,,,,0.00,0.00,0,0,0,0,0,0,0,0,0,0,0,0,0
20200430,053230,達方台新97購01,0.69,0.69,0.04,0.04,0.00,0.00,53000,2,30070,0,0,0,0,0,0,0,53000,-53000,-53000
20200430,053231,奇力新康和96購01,,,,,0.00,0.00,0,0,0,0,0,0,0,0,0,0,0,0,0
20200430,053232,友達永豐97購02,0.12,0.12,0.12,0.12,0.00,0.00,10000,1,1200,0,0,0,0,0,0,0,10000,-10000,-10000
20200430,053233,大立光永豐96購01,,,,,0.00,0.00,0,0,0,0,0,0,0,0,0,0,0,0,0
20200430,053234,奇鋐永豐96購01,,,,,0.00,0.00,0,0,0,0,0,0,0,0,0,0,0,0,0
20200430,053235,智原永豐96購01,,,,,0.00,0.00,0,0,0,0,0,0,0,0,0,0,0,0,0
20200430,053236,群創永豐97購02,,,,,0.00,0.00,0,0,0,0,0,0,0,0,0,0,0,0,0
20200430,053237,揚明光永豐96購03,,,,,0.00,0.00,0,0,0,0,0,0,0,0,0,0,0,0,0
20200430,053238,麗豐永豐96購01,0.34,0.36,0.34,0.35,+0.02,6.06,56000,7,19800,0,0,0,0,0,0,56000,0,56000,56000
20200430,053239,崇越永豐96購01,,,,,0.00,0.00,0,0,0,0,0,0,0,0,0,0,0,0,0
20200430,05323P,瑞昱凱基96售02,,,,,0.00,0.00,0,0,0,0,0,0,0,0,0,0,0,0,0
20200430,053240,巨路永豐96購01,,,,,0.00,0.00,0,0,0,0,0,0,0,0,0,0,0,0,0
20200430,053241,元油反國票9A購01,,,,,0.00,0.00,0,0,0,0,0,0,0,0,0,0,0,0,0
20200430,053242,聯電國票96購04,,,,,0.00,0.00,0,0,0,0,0,0,0,0,0,0,0,0,0
20200430,053243,楠梓電國票97購02,0.45,0.45,0.44,0.44,-0.05,-10.2,6000,3,2660,0,0,0,0,0,0,6000,0,6000,6000
20200430,053244,光磊國票97購01,0.86,0.86,0.86,0.86,0.00,0.00,35000,1,30100,0,0,0,0,0,0,0,35000,-35000,-35000
20200430,053245,全新國票97購01,,,,,0.00,0.00,0,0,0,0,0,0,0,0,0,0,0,0,0
20200430,053246,聯詠國票97購02,,,,,0.00,0.00,0,0,0,0,0,0,0,0,0,0,0,0,0
20200430,053247,麗豐國票97購01,,,,,0.00,0.00,0,0,0,0,0,0,0,0,0,0,0,0,0
20200430,053248,智伸科國票97購01,0.79,0.79,0.79,0.79,+0.14,21.54,1000,1,790,0,0,0,0,0,0,0,1000,-1000,-1000
20200430,053249,致伸國票97購02,,,,,0.00,0.00,0,0,0,0,0,0,0,0,0,0,0,0,0
20200430,05324P,臺股指凱基95售08,,,,,0.00,0.00,0,0,0,0,0,0,0,0,0,0,0,0,0
20200430,053250,百和國票97購02,1.48,1.48,1.34,1.43,+0.02,1.42,87000,5,118850,0,0,0,0,0,0,86000,0,86000,86000
20200430,053251,世紀鋼國票97購02,2.14,2.25,2.14,2.25,0.00,0.00,4000,2,8780,0,0,0,0,0,0,4000,0,4000,4000
20200430,053252,華邦電國泰98購01,,,,,0.00,0.00,0,0,0,0,0,0,0,0,0,0,0,0,0
20200430,053253,友達國泰97購02,,,,,0.00,0.00,0,0,0,0,0,0,0,0,0,0,0,0,0
20200430,053254,群創國泰98購02,0.20,0.20,0.20,0.20,0.00,0.00,50000,5,10000,0,0,0,0,0,0,50000,50000,0,0
20200430,053255,貿聯國泰97購01,0.57,0.76,0.55,0.76,+0.29,61.7,187000,25,118030,0,0,0,0,0,0,14000,172000,-158000,-158000
20200430,053256,上銀富邦98購01,0.57,0.86,0.57,0.86,+0.40,86.96,48000,7,38630,0,0,0,0,0,0,10000,35000,-25000,-25000
20200430,053257,華通富邦97購01,0.10,0.10,0.10,0.10,0.00,0.00,10000,1,1000,0,0,0,0,0,0,0,10000,-10000,-10000
20200430,053258,上証2X群益9A購03,,,,,0.00,0.00,0,0,0,0,0,0,0,0,0,0,0,0,0
20200430,053259,卜蜂群益97購01,,,,,0.00,0.00,0,0,0,0,0,0,0,0,0,0,0,0,0
20200430,05325P,臺股指凱基95售09,,,,,0.00,0.00,0,0,0,0,0,0,0,0,0,0,0,0,0
20200430,053260,喬山群益96購01,,,,,0.00,0.00,0,0,0,0,0,0,0,0,0,0,0,0,0
20200430,053261,國巨群益96購05,,,,,0.00,0.00,0,0,0,0,0,0,0,0,0,0,0,0,0
20200430,053262,華邦電群益96購02,,,,,0.00,0.00,0,0,0,0,0,0,0,0,0,0,0,0,0
20200430,053263,華邦電群益96購03,,,,,0.00,0.00,0,0,0,0,0,0,0,0,0,0,0,0,0
20200430,053264,南亞科群益96購01,,,,,0.00,0.00,0,0,0,0,0,0,0,0,0,0,0,0,0
20200430,053265,南亞科群益96購02,,,,,0.00,0.00,0,0,0,0,0,0,0,0,0,0,0,0,0
20200430,053266,全新群益98購01,,,,,0.00,0.00,0,0,0,0,0,0,0,0,0,0,0,0,0
20200430,053267,華新科群益96購02,,,,,0.00,0.00,0,0,0,0,0,0,0,0,0,0,0,0,0
20200430,053268,日月光群益96購01,,,,,0.00,0.00,0,0,0,0,0,0,0,0,0,0,0,0,0
20200430,053269,同欣電群益96購01,0.12,0.12,0.12,0.12,0.00,0.00,29000,2,3480,0,0,0,0,0,0,0,0,0,0
20200430,05326P,臺股指凱基95售10,,,,,0.00,0.00,0,0,0,0,0,0,0,0,0,0,0,0,0
20200430,053270,台塑元大96購01,0.22,0.22,0.22,0.22,0.00,0.00,5000,1,1100,0,0,0,0,0,0,5000,0,5000,5000
20200430,053271,喬山元大97購01,,,,,0.00,0.00,0,0,0,0,0,0,0,0,0,0,0,0,0
20200430,053272,鴻海元大96購17,,,,,0.00,0.00,0,0,0,0,0,0,0,0,0,0,0,0,0
20200430,053273,國巨元大96購08,,,,,0.00,0.00,0,0,0,0,0,0,0,0,0,0,0,0,0
20200430,053274,旺宏元大98購03,,,,,0.00,0.00,0,0,0,0,0,0,0,0,0,0,0,0,0
20200430,053275,燿華元大97購01,0.06,0.06,0.06,0.06,0.00,0.00,300000,1,18000,0,0,0,0,0,0,300000,0,300000,300000
20200430,053276,友達元大9C購01,,,,,0.00,0.00,0,0,0,0,0,0,0,0,0,0,0,0,0
20200430,053277,大立光元大96購04,,,,,0.00,0.00,0,0,0,0,0,0,0,0,0,0,0,0,0
20200430,053278,禾伸堂元大96購01,,,,,0.00,0.00,0,0,0,0,0,0,0,0,0,0,0,0,0
20200430,053279,景碩元大97購01,,,,,0.00,0.00,0,0,0,0,0,0,0,0,0,0,0,0,0
20200430,05327P,臺股指凱基95售11,,,,,0.00,0.00,0,0,0,0,0,0,0,0,0,0,0,0,0
20200430,053280,群創元大9C購01,,,,,0.00,0.00,0,0,0,0,0,0,0,0,0,0,0,0,0
20200430,053281,茂林元大96購02,1.20,1.20,1.16,1.17,+0.02,1.74,117000,6,140090,0,0,0,0,0,0,20000,97000,-77000,-77000
20200430,053282,彩晶元大9C購01,,,,,0.00,0.00,0,0,0,0,0,0,0,0,0,0,0,0,0
20200430,053283,同欣電元大96購03,,,,,0.00,0.00,0,0,0,0,0,0,0,0,0,0,0,0,0
20200430,053284,樺漢元大97購01,,,,,0.00,0.00,0,0,0,0,0,0,0,0,0,0,0,0,0
20200430,053285,臺股指元大96購08,2.56,2.56,2.56,2.56,0.00,0.00,3000,1,7680,0,0,0,0,0,0,0,3000,-3000,-3000
20200430,053286,臺股指元大96購14,,,,,0.00,0.00,0,0,0,0,0,0,0,0,0,0,0,0,0
20200430,053287,臺股指元大96購15,,,,,0.00,0.00,0,0,0,0,0,0,0,0,0,0,0,0,0
20200430,053288,臺股指元大96購16,,,,,0.00,0.00,0,0,0,0,0,0,0,0,0,0,0,0,0
20200430,053289,臺股指元大96購17,,,,,0.00,0.00,0,0,0,0,0,0,0,0,0,0,0,0,0
20200430,05328P,臺股指凱基95售12,1.70,1.70,1.70,1.70,-0.87,-33.85,5000,1,8500,0,0,0,0,0,0,5000,0,5000,5000
20200430,053290,元油反中信97購01,,,,,0.00,0.00,0,0,0,0,0,0,0,0,0,0,0,0,0
20200430,053291,旺宏中信9A購01,0.36,0.44,0.36,0.44,+0.08,22.22,95000,11,37490,0,0,0,0,0,0,77000,0,77000,77000
20200430,053292,美律中信98購01,0.60,0.68,0.60,0.64,+0.05,8.47,271000,11,174380,0,0,0,0,0,0,82000,189000,-107000,-107000
20200430,053293,聯發科中信9B購01,0.40,0.40,0.40,0.40,+0.08,25.0,26000,2,10400,0,0,0,0,0,0,26000,0,26000,26000
20200430,053294,聯發科中信9C購01,0.39,0.44,0.39,0.44,+0.10,29.41,186000,12,76570,0,0,0,0,0,0,144000,0,144000,144000
20200430,053295,奇力新中信96購01,0.35,0.40,0.35,0.40,0.00,0.00,130000,2,48000,0,0,0,0,0,0,130000,0,130000,130000
20200430,053296,貿聯中信98購01,0.21,0.26,0.21,0.26,+0.10,62.5,200000,2,47000,0,0,0,0,0,0,200000,0,200000,200000
20200430,053297,鎧勝中信98購01,0.32,0.40,0.29,0.38,+0.05,15.15,382000,15,143710,0,0,0,0,0,0,244000,138000,106000,106000
20200430,053298,SP黃豆凱基99購01,0.56,0.56,0.56,0.56,0.00,0.00,4000,2,2240,0,0,0,0,0,0,0,0,0,0
20200430,053299,台泥凱基96購01,,,,,0.00,0.00,0,0,0,0,0,0,0,0,0,0,0,0,0
20200430,05329P,臺股指凱基95售13,,,,,0.00,0.00,0,0,0,0,0,0,0,0,0,0,0,0,0
20200430,053300,大成鋼凱基96購02,0.34,0.34,0.34,0.34,+0.02,6.25,150000,4,51000,0,0,0,0,0,0,150000,0,150000,150000
20200430,053301,華通凱基96購04,,,,,0.00,0.00,0,0,0,0,0,0,0,0,0,0,0,0,0
20200430,053302,國巨凱基96購10,,,,,0.00,0.00,0,0,0,0,0,0,0,0,0,0,0,0,0
20200430,053303,建準凱基96購03,,,,,0.00,0.00,0,0,0,0,0,0,0,0,0,0,0,0,0
20200430,053304,可成凱基96購03,0.83,0.83,0.83,0.83,-0.16,-16.16,30000,1,24900,0,0,0,0,0,0,0,30000,-30000,-30000
20200430,053305,聯詠凱基96購02,0.21,0.21,0.21,0.21,+0.02,10.53,10000,1,2100,0,0,0,0,0,0,10000,0,10000,10000
20200430,053306,晶技凱基97購01,,,,,0.00,0.00,0,0,0,0,0,0,0,0,0,0,0,0,0
20200430,053307,泰碩凱基97購01,,,,,0.00,0.00,0,0,0,0,0,0,0,0,0,0,0,0,0
20200430,053308,智易凱基96購02,0.62,0.62,0.61,0.61,-0.09,-12.86,90000,7,55200,0,0,0,0,0,0,90000,0,90000,90000
20200430,053309,泰鼎凱基96購03,4.46,4.46,4.46,4.46,0.00,0.00,10000,1,44600,0,0,0,0,0,0,0,10000,-10000,-10000
20200430,05330P,臺股指凱基95售14,,,,,0.00,0.00,0,0,0,0,0,0,0,0,0,0,0,0,0
20200430,053310,彩晶凱基98購02,,,,,0.00,0.00,0,0,0,0,0,0,0,0,0,0,0,0,0
20200430,053311,同欣電凱基96購01,,,,,0.00,0.00,0,0,0,0,0,0,0,0,0,0,0,0,0
20200430,053312,緯穎凱基96購02,,,,,0.00,0.00,0,0,0,0,0,0,0,0,0,0,0,0,0
20200430,053313,世紀鋼凱基96購01,1.15,1.30,1.15,1.26,+0.10,8.62,130000,27,159470,0,0,0,0,0,0,23000,115000,-92000,-92000
20200430,053314,A50正2群益9A購01,0.77,0.77,0.69,0.69,0.00,0.00,15000,2,11150,0,0,0,0,0,0,15000,0,15000,15000
20200430,053315,漢唐群益96購02,0.78,0.78,0.78,0.78,+0.02,2.63,75000,1,58500,0,0,0,0,0,0,0,75000,-75000,-75000
20200430,053316,友達群益9A購01,0.88,0.90,0.87,0.90,+0.02,2.27,7000,7,6170,0,0,0,0,0,0,5000,2000,3000,3000
20200430,053317,友達群益9A購02,,,,,0.00,0.00,0,0,0,0,0,0,0,0,0,0,0,0,0
20200430,053318,全新群益99購01,,,,,0.00,0.00,0,0,0,0,0,0,0,0,0,0,0,0,0
20200430,053319,可成群益96購04,,,,,0.00,0.00,0,0,0,0,0,0,0,0,0,0,0,0,0
20200430,05331P,上証2X國票96售01,1.55,1.55,1.46,1.47,0.00,0.00,20000,4,29800,0,0,0,0,0,0,5000,15000,-10000,-10000
20200430,053320,華新科群益97購01,6.35,6.40,6.20,6.20,-0.30,-4.62,37000,3,234700,0,0,0,0,0,0,7000,30000,-23000,-23000
20200430,053321,智原群益96購02,0.21,0.21,0.21,0.21,+0.01,5.0,12000,1,2520,0,0,0,0,0,0,12000,0,12000,12000
20200430,053322,京鼎群益97購01,,,,,0.00,0.00,0,0,0,0,0,0,0,0,0,0,0,0,0
20200430,053323,群創群益98購07,,,,,0.00,0.00,0,0,0,0,0,0,0,0,0,0,0,0,0
20200430,053324,康舒群益96購01,,,,,0.00,0.00,0,0,0,0,0,0,0,0,0,0,0,0,0
20200430,053325,GIS群益96購02,0.43,0.44,0.43,0.44,0.00,0.00,369000,2,160860,0,0,0,0,0,0,369000,0,369000,369000
20200430,053326,瀚宇博台新96購01,0.42,0.42,0.08,0.08,0.00,0.00,40000,4,6600,0,0,0,0,0,0,0,40000,-40000,-40000
20200430,053327,彩晶台新97購01,,,,,0.00,0.00,0,0,0,0,0,0,0,0,0,0,0,0,0
20200430,053328,滬深2X永豐99購01,,,,,0.00,0.00,0,0,0,0,0,0,0,0,0,0,0,0,0
20200430,053329,元油反永豐97購01,,,,,0.00,0.00,0,0,0,0,0,0,0,0,0,0,0,0,0
20200430,05332P,臺股指國票95售01,,,,,0.00,0.00,0,0,0,0,0,0,0,0,0,0,0,0,0
20200430,053330,燿華永豐96購03,0.16,0.16,0.16,0.16,0.00,0.00,500000,3,80000,0,0,0,0,0,0,0,500000,-500000,-500000
20200430,053331,玉晶光永豐97購02,0.87,1.10,0.87,1.08,+0.26,31.71,513000,41,487190,0,0,0,0,0,0,294000,220000,74000,74000
20200430,053332,創意永豐96購03,0.68,0.72,0.68,0.72,+0.01,1.41,34000,5,23800,0,0,0,0,0,0,11000,23000,-12000,-12000
20200430,053333,新唐永豐96購01,0.09,0.09,0.09,0.09,0.00,0.00,5000,1,450,0,0,0,0,0,0,5000,0,5000,5000
20200430,053334,訊芯永豐96購01,,,,,0.00,0.00,0,0,0,0,0,0,0,0,0,0,0,0,0
20200430,053335,易華電永豐96購01,,,,,0.00,0.00,0,0,0,0,0,0,0,0,0,0,0,0,0
20200430,053336,元油反國票9B購02,,,,,0.00,0.00,0,0,0,0,0,0,0,0,0,0,0,0,0
20200430,053337,聯電國票97購01,0.78,0.79,0.74,0.79,+0.08,11.27,117000,15,90170,0,0,0,0,0,0,87000,0,87000,87000
20200430,053338,台光電國票97購01,,,,,0.00,0.00,0,0,0,0,0,0,0,0,0,0,0,0,0
20200430,053339,友達國票97購02,,,,,0.00,0.00,0,0,0,0,0,0,0,0,0,0,0,0,0
20200430,05333P,臺股指國票95售02,,,,,0.00,0.00,0,0,0,0,0,0,0,0,0,0,0,0,0
20200430,053340,建準國票97購01,,,,,0.00,0.00,0,0,0,0,0,0,0,0,0,0,0,0,0
20200430,053341,聯發科國票97購03,,,,,0.00,0.00,0,0,0,0,0,0,0,0,0,0,0,0,0
20200430,053342,全新國票99購01,,,,,0.00,0.00,0,0,0,0,0,0,0,0,0,0,0,0,0
20200430,053343,宏達電國票97購02,,,,,0.00,0.00,0,0,0,0,0,0,0,0,0,0,0,0,0
20200430,053344,嘉晶國票97購02,,,,,0.00,0.00,0,0,0,0,0,0,0,0,0,0,0,0,0
20200430,053345,欣興國票97購02,,,,,0.00,0.00,0,0,0,0,0,0,0,0,0,0,0,0,0
20200430,053346,群創國票97購04,,,,,0.00,0.00,0,0,0,0,0,0,0,0,0,0,0,0,0
20200430,053347,茂林國票98購01,2.32,2.32,2.21,2.25,+0.04,1.81,25000,5,56270,0,0,0,0,0,0,7000,18000,-11000,-11000
20200430,053348,彩晶國票97購02,,,,,0.00,0.00,0,0,0,0,0,0,0,0,0,0,0,0,0
20200430,053349,台郡國票97購02,2.04,2.04,2.04,2.04,0.00,0.00,44000,1,89760,0,0,0,0,0,0,0,44000,-44000,-44000
20200430,05334P,臺股指國票95售03,,,,,0.00,0.00,0,0,0,0,0,0,0,0,0,0,0,0,0
20200430,053350,台表科國票97購02,,,,,0.00,0.00,0,0,0,0,0,0,0,0,0,0,0,0,0
20200430,053351,A50正2兆豐97購01,,,,,0.00,0.00,0,0,0,0,0,0,0,0,0,0,0,0,0
20200430,053352,義隆兆豐96購01,1.06,1.17,1.06,1.17,+0.13,12.5,543000,15,619070,0,0,0,0,0,0,422000,121000,301000,301000
20200430,053353,玉晶光兆豐97購03,,,,,0.00,0.00,0,0,0,0,0,0,0,0,0,0,0,0,0
20200430,053354,康控兆豐97購02,,,,,0.00,0.00,0,0,0,0,0,0,0,0,0,0,0,0,0
20200430,053355,超眾兆豐97購01,1.66,1.75,1.66,1.72,+0.05,2.99,188000,7,325990,0,0,0,0,0,0,0,188000,-188000,-188000
20200430,053356,聯發科統一96購07,1.26,1.60,1.26,1.60,+0.56,53.85,313000,36,450440,0,0,0,0,0,0,313000,261000,52000,52000
20200430,053357,可成統一96購02,,,,,0.00,0.00,0,0,0,0,0,0,0,0,0,0,0,0,0
20200430,053358,晶技統一98購01,,,,,0.00,0.00,0,0,0,0,0,0,0,0,0,0,0,0,0
20200430,053359,矽力統一96購02,,,,,0.00,0.00,0,0,0,0,0,0,0,0,0,0,0,0,0
20200430,05335P,臺股指國票95售04,,,,,0.00,0.00,0,0,0,0,0,0,0,0,0,0,0,0,0
20200430,053360,上証2X元富96購01,,,,,0.00,0.00,0,0,0,0,0,0,0,0,0,0,0,0,0
20200430,053361,友達元富99購01,0.68,0.68,0.67,0.67,+0.01,1.52,602000,4,403350,0,0,0,0,0,0,602000,0,602000,602000
20200430,053362,元油反國泰98購01,,,,,0.00,0.00,0,0,0,0,0,0,0,0,0,0,0,0,0
20200430,053363,旺宏國泰98購02,0.85,0.85,0.82,0.82,+0.10,13.89,48000,9,40220,0,0,0,0,0,0,36000,35000,1000,1000
20200430,053364,友達國泰98購01,0.61,0.61,0.61,0.61,0.00,0.00,59000,1,35990,0,0,0,0,0,0,0,59000,-59000,-59000
20200430,053365,彩晶國泰98購01,,,,,0.00,0.00,0,0,0,0,0,0,0,0,0,0,0,0,0
20200430,053366,樺漢國泰98購01,0.13,0.14,0.11,0.14,+0.02,16.67,70000,6,9100,0,0,0,0,0,0,0,50000,-50000,-50000
20200430,053367,元油反富邦97購01,,,,,0.00,0.00,0,0,0,0,0,0,0,0,0,0,0,0,0
20200430,053368,京元電富邦98購01,0.16,0.16,0.16,0.16,+0.01,6.67,595000,12,95200,0,0,0,0,0,0,0,527000,-527000,-527000
20200430,053369,T50反1元大96購06,0.51,0.51,0.51,0.51,-0.14,-21.54,1000,1,510,0,0,0,0,0,0,0,1000,-1000,-1000
20200430,05336P,臺股指國票95售05,,,,,0.00,0.00,0,0,0,0,0,0,0,0,0,0,0,0,0
20200430,053370,上証2X元大97購03,0.33,0.33,0.33,0.33,0.00,0.00,5000,1,1650,0,0,0,0,0,0,5000,0,5000,5000
20200430,053371,滬深2X元大99購01,0.60,0.60,0.60,0.60,0.00,0.00,5000,1,3000,0,0,0,0,0,0,5000,0,5000,5000
20200430,053372,元油反元大98購01,,,,,0.00,0.00,0,0,0,0,0,0,0,0,0,0,0,0,0
20200430,053373,台泥元大96購01,,,,,0.00,0.00,0,0,0,0,0,0,0,0,0,0,0,0,0
20200430,053374,台達電元大96購03,0.71,0.82,0.71,0.82,0.00,0.00,50000,5,38900,0,0,0,0,0,0,0,50000,-50000,-50000
20200430,053375,鴻海元大96購18,0.39,0.39,0.39,0.39,0.00,0.00,10000,1,3900,0,0,0,0,0,0,10000,0,10000,10000
20200430,053376,鴻海元大96購19,0.60,0.61,0.59,0.61,+0.07,12.96,384000,5,229880,0,0,0,0,0,0,68000,316000,-248000,-248000
20200430,053377,台積電元大98購01,,,,,0.00,0.00,0,0,0,0,0,0,0,0,0,0,0,0,0
20200430,053378,台積電元大98購02,1.28,1.45,1.28,1.45,+0.22,17.89,29000,4,38890,0,0,0,0,0,0,28000,11000,17000,17000
20200430,053379,南亞科元大96購01,,,,,0.00,0.00,0,0,0,0,0,0,0,0,0,0,0,0,0
20200430,05337P,臺股指國票95售06,3.00,3.08,2.33,2.33,-1.27,-35.28,4000,3,10740,0,0,0,0,0,0,3000,1000,2000,2000
20200430,053380,南亞科元大97購01,,,,,0.00,0.00,0,0,0,0,0,0,0,0,0,0,0,0,0
20200430,053381,友達元大9A購02,,,,,0.00,0.00,0,0,0,0,0,0,0,0,0,0,0,0,0
20200430,053382,友達元大9C購02,,,,,0.00,0.00,0,0,0,0,0,0,0,0,0,0,0,0,0
20200430,053383,京元電元大97購01,,,,,0.00,0.00,0,0,0,0,0,0,0,0,0,0,0,0,0
20200430,053384,聯發科元大96購13,0.36,0.36,0.36,0.36,0.00,0.00,20000,1,7200,0,0,0,0,0,0,20000,0,20000,20000
20200430,053385,聯詠元大96購02,,,,,0.00,0.00,0,0,0,0,0,0,0,0,0,0,0,0,0
20200430,053386,聯詠元大96購03,,,,,0.00,0.00,0,0,0,0,0,0,0,0,0,0,0,0,0
20200430,053387,緯創元大97購01,,,,,0.00,0.00,0,0,0,0,0,0,0,0,0,0,0,0,0
20200430,053388,群創元大9C購02,0.19,0.20,0.19,0.20,0.00,0.00,9000,2,1780,0,0,0,0,0,0,2000,0,2000,2000
20200430,053389,彩晶元大98購01,0.57,0.57,0.57,0.57,+0.01,1.79,53000,1,30210,0,0,0,0,0,0,53000,0,53000,53000
20200430,05338P,臺股指國票95售07,,,,,0.00,0.00,0,0,0,0,0,0,0,0,0,0,0,0,0
20200430,053390,彩晶元大9A購01,,,,,0.00,0.00,0,0,0,0,0,0,0,0,0,0,0,0,0
20200430,053391,嘉聯益元大99購01,,,,,0.00,0.00,0,0,0,0,0,0,0,0,0,0,0,0,0
20200430,053392,致新元大96購01,0.93,1.02,0.88,1.01,+0.08,8.6,183000,12,175990,0,0,0,0,0,0,133000,75000,58000,58000
20200430,053393,元油反中信98購01,,,,,0.00,0.00,0,0,0,0,0,0,0,0,0,0,0,0,0
20200430,053394,鴻海中信9A購01,0.09,0.10,0.09,0.10,+0.03,42.86,397000,14,36230,0,0,0,0,0,0,0,0,0,0
20200430,053395,致茂中信96購01,0.27,0.27,0.27,0.27,-0.05,-15.62,1000,1,270,0,0,0,0,0,0,1000,0,1000,1000
20200430,053396,漢唐中信9A購01,0.42,0.42,0.41,0.41,0.00,0.00,98000,4,41030,0,0,0,0,0,0,98000,0,98000,98000
20200430,053397,國泰金中信96購01,0.14,0.14,0.14,0.14,0.00,0.00,417000,1,58380,0,0,0,0,0,0,417000,0,417000,417000
20200430,053398,和鑫中信99購01,0.15,0.15,0.13,0.14,-0.01,-6.67,924000,74,126080,0,0,0,0,0,0,638000,98000,540000,540000
20200430,053399,創意中信96購01,0.46,0.47,0.46,0.47,+0.04,9.3,117000,6,54140,0,0,0,0,0,0,0,117000,-117000,-117000
20200430,053400,緯穎中信9A購01,1.09,1.39,1.06,1.28,+0.29,29.29,423000,41,505270,0,0,0,0,0,0,87000,335000,-248000,-248000
20200430,053401,臺股指中信99購01,0.13,0.20,0.13,0.20,+0.08,66.67,4419000,36,703430,0,0,0,0,0,0,4084000,0,4084000,4084000
20200430,053402,A50正2群益9A購02,0.46,0.46,0.46,0.46,0.00,0.00,100000,1,46000,0,0,0,0,0,0,100000,0,100000,100000
20200430,053403,彩晶群益98購01,0.61,0.64,0.61,0.64,+0.02,3.23,309000,12,195570,0,0,0,0,0,0,19000,290000,-271000,-271000
20200430,053404,致新群益96購01,1.56,1.56,1.56,1.56,0.00,0.00,50000,1,78000,0,0,0,0,0,0,50000,0,50000,50000
20200430,053405,台達電兆豐96購01,2.52,2.85,2.43,2.85,+0.70,32.56,472000,11,1254350,0,0,0,0,0,0,130000,342000,-212000,-212000
20200430,053406,國巨兆豐96購02,0.83,0.83,0.83,0.83,0.00,0.00,39000,1,32370,0,0,0,0,0,0,39000,0,39000,39000
20200430,053407,台積電兆豐96購02,,,,,0.00,0.00,0,0,0,0,0,0,0,0,0,0,0,0,0
20200430,053408,友達兆豐98購01,,,,,0.00,0.00,0,0,0,0,0,0,0,0,0,0,0,0,0
20200430,053409,和碩兆豐96購02,0.94,0.95,0.94,0.95,-0.03,-3.06,19000,2,18020,0,0,0,0,0,0,0,19000,-19000,-19000
20200430,05340P,臺股指國票95售08,,,,,0.00,0.00,0,0,0,0,0,0,0,0,0,0,0,0,0
20200430,053410,啟碁兆豐96購01,0.46,0.46,0.45,0.46,-0.03,-6.12,163000,7,74780,0,0,0,0,0,0,163000,0,163000,163000
20200430,053411,深中小國票9B購01,,,,,0.00,0.00,0,0,0,0,0,0,0,0,0,0,0,0,0
20200430,053412,台達電國票97購02,,,,,0.00,0.00,0,0,0,0,0,0,0,0,0,0,0,0,0
20200430,053413,台積電國票99購01,0.60,0.68,0.60,0.68,+0.13,23.64,86000,9,55380,0,0,0,0,0,0,76000,0,76000,76000
20200430,053414,臻鼎國票97購01,0.06,0.07,0.06,0.07,0.00,0.00,9000,2,580,0,0,0,0,0,0,9000,0,9000,9000
20200430,053415,聯茂國票97購01,0.48,0.48,0.48,0.48,+0.02,4.35,10000,1,4800,0,0,0,0,0,0,0,10000,-10000,-10000
20200430,053416,光磊台新97購01,0.01,0.01,0.01,0.01,0.00,0.00,10000,1,100,0,0,0,0,0,0,0,10000,-10000,-10000
20200430,053417,上銀永豐96購02,,,,,0.00,0.00,0,0,0,0,0,0,0,0,0,0,0,0,0
20200430,053418,旺宏永豐96購02,,,,,0.00,0.00,0,0,0,0,0,0,0,0,0,0,0,0,0
20200430,053419,光罩永豐96購01,,,,,0.00,0.00,0,0,0,0,0,0,0,0,0,0,0,0,0
20200430,05341P,臺股指兆豐95售02,1.41,1.41,1.41,1.41,-0.97,-40.76,10000,1,14100,0,0,0,0,0,0,10000,10000,0,0
20200430,053420,華邦電永豐96購01,,,,,0.00,0.00,0,0,0,0,0,0,0,0,0,0,0,0,0
20200430,053421,南亞科永豐96購01,,,,,0.00,0.00,0,0,0,0,0,0,0,0,0,0,0,0,0
20200430,053422,可成永豐96購01,0.76,0.76,0.71,0.71,-0.09,-11.25,27000,3,20170,0,0,0,0,0,0,20000,7000,13000,13000
20200430,053423,亞光永豐96購01,0.32,0.33,0.32,0.33,+0.02,6.45,101000,6,32630,0,0,0,0,0,0,31000,81000,-50000,-50000
20200430,053424,欣興永豐96購02,1.40,1.50,1.37,1.37,-0.06,-4.2,56000,7,78290,0,0,0,0,0,0,43000,15000,28000,28000
20200430,053425,京鼎永豐96購01,,,,,0.00,0.00,0,0,0,0,0,0,0,0,0,0,0,0,0
20200430,053426,創意永豐96購04,0.67,0.71,0.67,0.71,0.00,0.00,67000,2,45890,0,0,0,0,0,0,0,67000,-67000,-67000
20200430,053427,鎧勝永豐96購02,0.46,0.58,0.46,0.58,0.00,0.00,15000,2,8100,0,0,0,0,0,0,5000,10000,-5000,-5000
20200430,053428,中磊永豐96購02,0.80,0.80,0.75,0.75,-0.01,-1.32,37000,6,29310,0,0,0,0,0,0,37000,0,37000,37000
20200430,053429,彩晶永豐96購01,,,,,0.00,0.00,0,0,0,0,0,0,0,0,0,0,0,0,0
20200430,05342P,臺股指兆豐95售03,,,,,0.00,0.00,0,0,0,0,0,0,0,0,0,0,0,0,0
20200430,053430,樺漢永豐96購01,0.57,0.60,0.55,0.59,0.00,0.00,69000,9,40820,0,0,0,0,0,0,46000,23000,23000,23000
20200430,053431,志超永豐96購01,0.36,0.36,0.35,0.36,-0.01,-2.7,180000,6,63380,0,0,0,0,0,0,180000,0,180000,180000
20200430,053432,世紀鋼永豐96購02,1.78,1.78,1.78,1.78,0.00,0.00,10000,1,17800,0,0,0,0,0,0,0,10000,-10000,-10000
20200430,053433,友達日盛99購06,,,,,0.00,0.00,0,0,0,0,0,0,0,0,0,0,0,0,0
20200430,053434,國泰金日盛96購01,0.23,0.23,0.23,0.23,0.00,0.00,80000,6,18400,0,0,0,0,0,0,0,80000,-80000,-80000
20200430,053435,新光金日盛96購01,,,,,0.00,0.00,0,0,0,0,0,0,0,0,0,0,0,0,0
20200430,053436,聯茂日盛96購01,0.86,0.86,0.83,0.83,-0.04,-4.6,222000,15,188320,0,0,0,0,0,0,222000,0,222000,222000
20200430,053437,啟碁日盛96購01,0.31,0.31,0.30,0.30,-0.03,-9.09,100000,27,30740,0,0,0,0,0,0,100000,0,100000,100000
20200430,053438,玉晶光麥證97購02,0.44,0.45,0.40,0.45,+0.07,18.42,53000,8,22280,0,5000,-5000,0,0,0,0,5000,-5000,-5000
20200430,053439,台積電凱基96購11,0.35,0.36,0.35,0.36,0.00,0.00,14000,3,4940,0,0,0,0,0,0,10000,10000,0,0
20200430,05343P,臺股指統一95售03,,,,,0.00,0.00,0,0,0,0,0,0,0,0,0,0,0,0,0
20200430,053440,台積電凱基96購12,,,,,0.00,0.00,0,0,0,0,0,0,0,0,0,0,0,0,0
20200430,053441,旺宏凱基98購01,0.30,0.33,0.30,0.32,+0.03,10.34,228000,13,71810,0,0,0,0,0,0,100000,0,100000,100000
20200430,053442,光罩凱基96購01,,,,,0.00,0.00,0,0,0,0,0,0,0,0,0,0,0,0,0
20200430,053443,智邦凱基97購01,5.10,5.60,5.10,5.45,+0.79,16.95,45000,9,246950,0,0,0,0,0,0,45000,0,45000,45000
20200430,053444,奇力新凱基96購03,,,,,0.00,0.00,0,0,0,0,0,0,0,0,0,0,0,0,0
20200430,053445,可成凱基96購04,,,,,0.00,0.00,0,0,0,0,0,0,0,0,0,0,0,0,0
20200430,053446,欣興凱基96購02,0.79,0.82,0.78,0.81,-0.02,-2.41,109000,8,86000,0,0,0,0,0,0,69000,40000,29000,29000
20200430,053447,京鼎凱基96購03,,,,,0.00,0.00,0,0,0,0,0,0,0,0,0,0,0,0,0
20200430,053448,智易凱基96購03,0.35,0.35,0.35,0.35,-0.05,-12.5,60000,1,21000,0,0,0,0,0,0,60000,0,60000,60000
20200430,053449,超眾凱基98購01,,,,,0.00,0.00,0,0,0,0,0,0,0,0,0,0,0,0,0
20200430,05344P,臺股指統一95售04,,,,,0.00,0.00,0,0,0,0,0,0,0,0,0,0,0,0,0
20200430,053450,同欣電凱基96購02,,,,,0.00,0.00,0,0,0,0,0,0,0,0,0,0,0,0,0
20200430,053451,致新凱基96購02,1.08,1.08,1.08,1.08,+0.11,11.34,20000,2,21600,0,0,0,0,0,0,0,20000,-20000,-20000
20200430,053452,臺股指凱基97購01,0.04,0.04,0.04,0.04,+0.01,33.33,363000,7,14520,0,0,0,0,0,0,0,0,0,0
20200430,053453,新光金統一98購01,0.57,0.57,0.56,0.57,+0.02,3.64,212000,5,120500,0,0,0,0,0,0,54000,158000,-104000,-104000
20200430,053454,創意統一96購02,0.76,0.76,0.75,0.75,0.00,0.00,998000,2,753490,0,0,0,0,0,0,0,998000,-998000,-998000
20200430,053455,台光電元富96購02,,,,,0.00,0.00,0,0,0,0,0,0,0,0,0,0,0,0,0
20200430,053456,大立光元富96購04,,,,,0.00,0.00,0,0,0,0,0,0,0,0,0,0,0,0,0
20200430,053457,旺宏國泰98購03,0.80,0.81,0.80,0.81,+0.16,24.62,26000,2,20960,0,0,0,0,0,0,26000,0,26000,26000
20200430,053458,聯詠國泰97購01,0.11,0.12,0.11,0.12,-0.01,-7.69,30000,3,3500,0,0,0,0,0,0,0,30000,-30000,-30000
20200430,053459,康控國泰97購01,0.12,0.14,0.12,0.13,+0.04,44.44,115000,9,15160,0,0,0,0,0,0,0,115000,-115000,-115000
20200430,05345P,臺股指統一95售05,,,,,0.00,0.00,0,0,0,0,0,0,0,0,0,0,0,0,0
20200430,053460,緯穎國泰97購01,2.73,3.20,2.66,3.20,+0.68,26.98,139000,14,397300,0,0,0,0,0,0,61000,81000,-20000,-20000
20200430,053461,台郡永昌99購01,,,,,0.00,0.00,0,0,0,0,0,0,0,0,0,0,0,0,0
20200430,053462,元油反富邦97購02,,,,,0.00,0.00,0,0,0,0,0,0,0,0,0,0,0,0,0
20200430,053463,可成富邦98購01,0.23,0.23,0.22,0.22,-0.04,-15.38,30000,2,6610,0,0,0,0,0,0,30000,0,30000,30000
20200430,053464,喬山元大96購01,,,,,0.00,0.00,0,0,0,0,0,0,0,0,0,0,0,0,0
20200430,053465,聯電元大96購05,,,,,0.00,0.00,0,0,0,0,0,0,0,0,0,0,0,0,0
20200430,053466,華通元大98購01,,,,,0.00,0.00,0,0,0,0,0,0,0,0,0,0,0,0,0
20200430,053467,鴻海元大96購20,,,,,0.00,0.00,0,0,0,0,0,0,0,0,0,0,0,0,0
20200430,053468,鴻海元大98購01,,,,,0.00,0.00,0,0,0,0,0,0,0,0,0,0,0,0,0
20200430,053469,光磊元大97購01,,,,,0.00,0.00,0,0,0,0,0,0,0,0,0,0,0,0,0
20200430,05346P,臺股指統一95售06,1.16,1.16,1.16,1.16,-0.31,-21.09,10000,1,11600,0,0,0,0,0,0,10000,10000,0,0
20200430,053470,華邦電元大96購02,,,,,0.00,0.00,0,0,0,0,0,0,0,0,0,0,0,0,0
20200430,053471,正崴元大96購01,,,,,0.00,0.00,0,0,0,0,0,0,0,0,0,0,0,0,0
20200430,053472,漢唐元大96購02,,,,,0.00,0.00,0,0,0,0,0,0,0,0,0,0,0,0,0
20200430,053473,聯發科元大96購15,2.51,2.68,2.51,2.68,+0.48,21.82,195000,10,503720,0,0,0,0,0,0,48000,147000,-99000,-99000
20200430,053474,聯發科元大97購06,0.62,0.73,0.62,0.73,+0.21,40.38,188000,7,124430,0,0,0,0,0,0,188000,0,188000,188000
20200430,053475,華新科元大96購05,,,,,0.00,0.00,0,0,0,0,0,0,0,0,0,0,0,0,0
20200430,053476,冠德元大96購03,,,,,0.00,0.00,0,0,0,0,0,0,0,0,0,0,0,0,0
20200430,053477,大立光元大97購03,0.35,0.35,0.35,0.35,0.00,0.00,5000,1,1750,0,0,0,0,0,0,5000,0,5000,5000
20200430,053478,京鼎元大96購01,,,,,0.00,0.00,0,0,0,0,0,0,0,0,0,0,0,0,0
20200430,053479,達興元大96購01,,,,,0.00,0.00,0,0,0,0,0,0,0,0,0,0,0,0,0
20200430,05347P,滬深2X元富9B售02,,,,,0.00,0.00,0,0,0,0,0,0,0,0,0,0,0,0,0
20200430,053480,祥碩元大96購02,7.60,7.60,6.15,6.15,-0.70,-10.22,90000,10,645000,0,0,0,0,0,0,50000,40000,10000,10000
20200430,053481,同欣電元大97購01,,,,,0.00,0.00,0,0,0,0,0,0,0,0,0,0,0,0,0
20200430,053482,矽力元大96購03,,,,,0.00,0.00,0,0,0,0,0,0,0,0,0,0,0,0,0
20200430,053483,嘉澤第一96購01,0.31,0.35,0.31,0.35,0.00,0.00,55000,7,17800,0,0,0,0,0,0,53000,0,53000,53000
20200430,053484,國巨國票97購03,,,,,0.00,0.00,0,0,0,0,0,0,0,0,0,0,0,0,0
20200430,053485,矽創國票97購04,0.56,0.61,0.53,0.60,+0.08,15.38,747000,43,423990,0,0,0,0,0,0,393000,316000,77000,77000
20200430,053486,T50反1兆豐96購01,0.98,1.00,0.92,0.93,-0.16,-14.68,231000,11,217910,0,0,0,0,0,0,158000,73000,85000,85000
20200430,053487,台泥兆豐97購01,3.41,3.60,3.40,3.60,+0.21,6.19,213000,23,743920,0,0,0,0,0,0,34000,179000,-145000,-145000
20200430,053488,中石化兆豐97購01,0.62,0.69,0.62,0.69,0.00,0.00,185000,11,123390,0,0,0,0,0,0,52000,99000,-47000,-47000
20200430,053489,上銀兆豐97購01,2.85,3.63,2.82,3.63,+0.94,34.94,218000,12,644980,0,0,0,0,0,0,127000,91000,36000,36000
20200430,05348P,美律元富98售01,0.89,0.89,0.85,0.87,0.00,0.00,1935000,11,1683250,0,0,0,0,0,0,1935000,0,1935000,1935000
20200430,053490,為升兆豐97購01,,,,,0.00,0.00,0,0,0,0,0,0,0,0,0,0,0,0,0
20200430,053491,鴻海兆豐97購02,,,,,0.00,0.00,0,0,0,0,0,0,0,0,0,0,0,0,0
20200430,053492,華邦電兆豐97購01,0.47,0.47,0.47,0.47,+0.04,9.3,38000,1,17860,0,0,0,0,0,0,38000,0,38000,38000
20200430,053493,智邦兆豐97購02,,,,,0.00,0.00,0,0,0,0,0,0,0,0,0,0,0,0,0
20200430,053494,南亞科兆豐96購02,1.36,1.37,1.31,1.31,+0.04,3.15,276000,11,364860,0,0,0,0,0,0,272000,0,272000,272000
20200430,053495,聯發科兆豐96購02,,,,,0.00,0.00,0,0,0,0,0,0,0,0,0,0,0,0,0
20200430,053496,義隆兆豐96購02,2.33,2.63,2.31,2.63,+0.30,12.88,113000,18,282020,0,0,0,0,0,0,13000,100000,-87000,-87000
20200430,053497,新光金兆豐97購01,,,,,0.00,0.00,0,0,0,0,0,0,0,0,0,0,0,0,0
20200430,053498,大立光兆豐96購03,,,,,0.00,0.00,0,0,0,0,0,0,0,0,0,0,0,0,0
20200430,053499,禾伸堂兆豐96購01,,,,,0.00,0.00,0,0,0,0,0,0,0,0,0,0,0,0,0
20200430,05349P,可成元富98售03,,,,,0.00,0.00,0,0,0,0,0,0,0,0,0,0,0,0,0
20200430,053500,新日興兆豐97購01,2.45,2.45,2.31,2.35,-0.08,-3.29,148000,8,349630,0,0,0,0,0,0,113000,35000,78000,78000
20200430,053501,明泰兆豐96購01,1.30,1.34,1.17,1.18,0.00,0.00,338000,27,435070,0,0,0,0,0,0,288000,50000,238000,238000
20200430,053502,智伸科兆豐97購01,0.97,0.97,0.89,0.89,+0.09,11.25,85000,7,77460,0,0,0,0,0,0,67000,18000,49000,49000
20200430,053503,臻鼎兆豐97購01,,,,,0.00,0.00,0,0,0,0,0,0,0,0,0,0,0,0,0
20200430,053504,祥碩兆豐96購01,6.40,6.40,6.05,6.05,0.00,0.00,28000,3,174500,0,0,0,0,0,0,28000,0,28000,28000
20200430,053505,瑞儀兆豐97購01,0.86,0.88,0.85,0.88,+0.01,1.15,72000,5,62610,0,0,0,0,0,0,21000,51000,-30000,-30000
20200430,053506,南茂兆豐97購01,1.66,1.72,1.66,1.72,0.00,0.00,61000,6,103650,0,0,0,0,0,0,0,61000,-61000,-61000
20200430,053507,百和兆豐96購01,0.87,0.87,0.76,0.83,-0.09,-9.78,437000,17,350520,0,0,0,0,0,0,377000,0,377000,377000
20200430,053508,元油反群益9A購01,,,,,0.00,0.00,0,0,0,0,0,0,0,0,0,0,0,0,0
20200430,053509,華新群益98購01,,,,,0.00,0.00,0,0,0,0,0,0,0,0,0,0,0,0,0
20200430,05350P,可成元富98售04,,,,,0.00,0.00,0,0,0,0,0,0,0,0,0,0,0,0,0
20200430,053510,聯電群益97購01,0.12,0.15,0.12,0.15,+0.03,25.0,155000,4,19900,0,0,0,0,0,0,125000,0,125000,125000
20200430,053511,鴻海群益96購04,,,,,0.00,0.00,0,0,0,0,0,0,0,0,0,0,0,0,0
20200430,053512,台積電群益96購06,,,,,0.00,0.00,0,0,0,0,0,0,0,0,0,0,0,0,0
20200430,053513,義隆群益96購05,1.72,2.02,1.72,2.02,+0.40,24.69,73000,7,134830,0,0,0,0,0,0,32000,43000,-11000,-11000
20200430,053514,麗豐群益96購01,,,,,0.00,0.00,0,0,0,0,0,0,0,0,0,0,0,0,0
20200430,053515,致伸群益96購02,,,,,0.00,0.00,0,0,0,0,0,0,0,0,0,0,0,0,0
20200430,053516,茂林群益96購05,1.85,1.85,1.76,1.78,+0.02,1.14,139000,10,249410,0,0,0,0,0,0,133000,6000,127000,127000
20200430,053517,崇越群益97購01,,,,,0.00,0.00,0,0,0,0,0,0,0,0,0,0,0,0,0
20200430,053518,聯茂群益96購03,,,,,0.00,0.00,0,0,0,0,0,0,0,0,0,0,0,0,0
20200430,053519,力成群益96購02,0.96,0.96,0.96,0.96,+0.17,21.52,98000,1,94080,0,0,0,0,0,0,0,98000,-98000,-98000
20200430,05351P,臺股指元富95售05,,,,,0.00,0.00,0,0,0,0,0,0,0,0,0,0,0,0,0
20200430,053520,康友群益96購01,,,,,0.00,0.00,0,0,0,0,0,0,0,0,0,0,0,0,0
20200430,053521,緯穎群益96購02,4.61,4.61,4.57,4.61,0.00,0.00,22000,6,100980,0,0,0,0,0,0,0,22000,-22000,-22000
20200430,053522,臺股指群益99購01,,,,,0.00,0.00,0,0,0,0,0,0,0,0,0,0,0,0,0
20200430,053523,T50反1中信9A購01,,,,,0.00,0.00,0,0,0,0,0,0,0,0,0,0,0,0,0
20200430,053524,聯電中信97購02,0.10,0.11,0.10,0.11,+0.01,10.0,529000,11,53250,0,0,0,0,0,0,519000,0,519000,519000
20200430,053525,台積電中信96購04,,,,,0.00,0.00,0,0,0,0,0,0,0,0,0,0,0,0,0
20200430,053526,正崴中信96購01,,,,,0.00,0.00,0,0,0,0,0,0,0,0,0,0,0,0,0
20200430,053527,創意中信97購01,0.36,0.36,0.36,0.36,0.00,0.00,50000,1,18000,0,0,0,0,0,0,0,50000,-50000,-50000
20200430,053528,南電中信9A購01,1.97,1.97,1.97,1.97,+0.07,3.68,5000,1,9850,0,0,0,0,0,0,5000,0,5000,5000
20200430,053529,國巨麥證96購01,0.59,0.60,0.59,0.59,0.00,0.00,70000,4,41350,65000,0,65000,0,0,0,65000,0,65000,65000
20200430,05352P,臺股指元富95售06,,,,,0.00,0.00,0,0,0,0,0,0,0,0,0,0,0,0,0
20200430,053530,聯發科康和96購01,0.24,0.24,0.24,0.24,+0.09,60.0,11000,2,2640,0,0,0,0,0,0,0,11000,-11000,-11000
20200430,053531,國泰金康和96購01,0.56,0.56,0.56,0.56,+0.10,21.74,80000,2,44800,0,0,0,0,0,0,50000,30000,20000,20000
20200430,053532,台積電永豐96購03,,,,,0.00,0.00,0,0,0,0,0,0,0,0,0,0,0,0,0
20200430,053533,光罩永豐96購03,,,,,0.00,0.00,0,0,0,0,0,0,0,0,0,0,0,0,0
20200430,053534,微星永豐96購02,1.33,1.33,1.26,1.29,0.00,0.00,112000,6,146170,0,0,0,0,0,0,65000,47000,18000,18000
20200430,053535,宏達電永豐96購02,,,,,0.00,0.00,0,0,0,0,0,0,0,0,0,0,0,0,0
20200430,053536,明泰永豐96購01,0.86,0.86,0.79,0.79,-0.01,-1.25,441000,23,362650,0,0,0,0,0,0,364000,77000,287000,287000
20200430,053537,玉晶光永豐98購02,0.46,0.52,0.46,0.51,0.00,0.00,129000,5,61110,0,0,0,0,0,0,70000,59000,11000,11000
20200430,053538,京鼎永豐96購03,,,,,0.00,0.00,0,0,0,0,0,0,0,0,0,0,0,0,0
20200430,053539,智易永豐96購01,0.87,0.87,0.86,0.86,-0.07,-7.53,17000,5,14730,0,0,0,0,0,0,17000,0,17000,17000
20200430,05353P,臺股指元富95售07,,,,,0.00,0.00,0,0,0,0,0,0,0,0,0,0,0,0,0
20200430,053540,健策永豐96購01,0.26,0.26,0.26,0.26,0.00,0.00,244000,1,63440,0,0,0,0,0,0,244000,0,244000,244000
20200430,053541,泰鼎永豐96購02,,,,,0.00,0.00,0,0,0,0,0,0,0,0,0,0,0,0,0
20200430,053542,超眾永豐96購01,,,,,0.00,0.00,0,0,0,0,0,0,0,0,0,0,0,0,0
20200430,053543,臺股指永豐96購02,,,,,0.00,0.00,0,0,0,0,0,0,0,0,0,0,0,0,0
20200430,053544,華新凱基96購01,,,,,0.00,0.00,0,0,0,0,0,0,0,0,0,0,0,0,0
20200430,053545,上銀凱基96購03,0.21,0.29,0.21,0.29,+0.22,314.29,25000,3,6850,0,0,0,0,0,0,5000,0,5000,5000
20200430,053546,台積電凱基96購13,,,,,0.00,0.00,0,0,0,0,0,0,0,0,0,0,0,0,0
20200430,053547,台積電凱基96購14,,,,,0.00,0.00,0,0,0,0,0,0,0,0,0,0,0,0,0
20200430,053548,旺宏凱基96購04,0.44,0.44,0.44,0.44,0.00,0.00,53000,3,23320,0,0,0,0,0,0,20000,0,20000,20000
20200430,053549,南亞科凱基96購02,,,,,0.00,0.00,0,0,0,0,0,0,0,0,0,0,0,0,0
20200430,05354P,臺股指元富95售08,,,,,0.00,0.00,0,0,0,0,0,0,0,0,0,0,0,0,0
20200430,053550,聯發科凱基96購15,0.28,0.28,0.28,0.28,+0.04,16.67,10000,1,2800,0,0,0,0,0,0,10000,0,10000,10000
20200430,053551,可成凱基96購05,0.55,0.55,0.52,0.52,-0.10,-16.13,20000,2,10700,0,0,0,0,0,0,0,20000,-20000,-20000
20200430,053552,華新科凱基96購08,,,,,0.00,0.00,0,0,0,0,0,0,0,0,0,0,0,0,0
20200430,053553,聯詠凱基96購03,0.37,0.39,0.37,0.39,0.00,0.00,110000,4,41500,0,0,0,0,0,0,0,110000,-110000,-110000
20200430,053554,欣興凱基97購02,,,,,0.00,0.00,0,0,0,0,0,0,0,0,0,0,0,0,0
20200430,053555,日月光凱基97購01,,,,,0.00,0.00,0,0,0,0,0,0,0,0,0,0,0,0,0
20200430,053556,康控凱基97購02,0.07,0.07,0.07,0.07,0.00,0.00,5000,1,350,0,0,0,0,0,0,5000,0,5000,5000
20200430,053557,聯茂凱基96購04,,,,,0.00,0.00,0,0,0,0,0,0,0,0,0,0,0,0,0
20200430,053558,訊芯凱基96購02,0.30,0.30,0.30,0.30,+0.04,15.38,40000,2,12000,0,0,0,0,0,0,0,40000,-40000,-40000
20200430,053559,台積電國泰98購01,0.57,0.57,0.57,0.57,-0.03,-5.0,20000,4,11400,0,0,0,0,0,0,0,0,0,0
20200430,05355P,臺股指元富95售09,,,,,0.00,0.00,0,0,0,0,0,0,0,0,0,0,0,0,0
20200430,053560,漢唐國泰98購01,1.23,1.23,1.23,1.23,0.00,0.00,5000,1,6150,0,0,0,0,0,0,0,5000,-5000,-5000
20200430,053561,玉晶光國泰98購01,0.96,1.12,0.96,1.11,0.00,0.00,40000,4,43000,0,0,0,0,0,0,10000,30000,-20000,-20000
20200430,053562,玉晶光國泰98購02,,,,,0.00,0.00,0,0,0,0,0,0,0,0,0,0,0,0,0
20200430,053563,台積電富邦97購01,0.10,0.13,0.10,0.13,0.00,0.00,177000,5,18720,0,0,0,0,0,0,0,0,0,0
20200430,053564,台積電富邦99購01,0.23,0.23,0.22,0.22,-0.01,-4.35,2595000,90,580760,22000,0,22000,0,0,0,0,640000,-640000,-618000
20200430,053565,台光電富邦98購01,0.39,0.46,0.39,0.46,+0.09,24.32,36000,4,15590,0,0,0,0,0,0,36000,0,36000,36000
20200430,053566,大立光富邦99購03,0.13,0.13,0.13,0.13,0.00,0.00,100000,1,13000,0,0,0,0,0,0,100000,0,100000,100000
20200430,053567,群創富邦97購01,,,,,0.00,0.00,0,0,0,0,0,0,0,0,0,0,0,0,0
20200430,053568,智伸科富邦98購01,0.19,0.20,0.19,0.19,+0.04,26.67,84000,5,15970,0,0,0,0,0,0,22000,62000,-40000,-40000
20200430,053569,漢唐統一98購01,0.65,0.65,0.64,0.64,+0.01,1.59,313000,5,200420,0,0,0,0,0,0,178000,135000,43000,43000
20200430,05356P,臺股指元富95售10,,,,,0.00,0.00,0,0,0,0,0,0,0,0,0,0,0,0,0
20200430,053570,京元電統一96購01,0.43,0.43,0.43,0.43,-0.06,-12.24,48000,1,20640,0,0,0,0,0,0,0,48000,-48000,-48000
20200430,053571,奇鋐統一96購02,0.74,0.77,0.74,0.77,+0.09,13.24,322000,4,243140,0,0,0,0,0,0,0,322000,-322000,-322000
20200430,053572,彩晶統一96購01,,,,,0.00,0.00,0,0,0,0,0,0,0,0,0,0,0,0,0
20200430,053573,臺股指統一99購01,0.66,0.66,0.66,0.66,0.00,0.00,10000,1,6600,0,0,0,0,0,0,10000,0,10000,10000
20200430,053574,奇力新元富99購01,,,,,0.00,0.00,0,0,0,0,0,0,0,0,0,0,0,0,0
20200430,053575,聯詠元富96購01,,,,,0.00,0.00,0,0,0,0,0,0,0,0,0,0,0,0,0
20200430,053576,智原元富96購01,,,,,0.00,0.00,0,0,0,0,0,0,0,0,0,0,0,0,0
20200430,053577,上証2X元大96購02,0.27,0.30,0.27,0.30,+0.07,30.43,20000,3,5800,0,0,0,0,0,0,20000,0,20000,20000
20200430,053578,華新元大98購01,,,,,0.00,0.00,0,0,0,0,0,0,0,0,0,0,0,0,0
20200430,053579,華通元大97購01,,,,,0.00,0.00,0,0,0,0,0,0,0,0,0,0,0,0,0
20200430,05357P,臺股指元富95售11,,,,,0.00,0.00,0,0,0,0,0,0,0,0,0,0,0,0,0
20200430,053580,國巨元大96購10,,,,,0.00,0.00,0,0,0,0,0,0,0,0,0,0,0,0,0
20200430,053581,台積電元大96購14,0.05,0.05,0.05,0.05,0.00,0.00,50000,3,2500,0,0,0,0,0,0,45000,0,45000,45000
20200430,053582,英業達元大97購01,,,,,0.00,0.00,0,0,0,0,0,0,0,0,0,0,0,0,0
20200430,053583,漢唐元大96購03,1.05,1.05,1.02,1.04,+0.01,0.97,358000,7,371760,0,0,0,0,0,0,258000,100000,158000,158000
20200430,053584,友達元大9B購02,0.89,0.90,0.89,0.90,+0.01,1.12,35000,3,31300,0,0,0,0,0,0,30000,5000,25000,25000
20200430,053585,友達元大9C購03,,,,,0.00,0.00,0,0,0,0,0,0,0,0,0,0,0,0,0
20200430,053586,建準元大96購01,0.34,0.34,0.34,0.34,-0.03,-8.11,200000,2,68000,0,0,0,0,0,0,200000,0,200000,200000
20200430,053587,京元電元大98購01,,,,,0.00,0.00,0,0,0,0,0,0,0,0,0,0,0,0,0
20200430,053588,聯發科元大97購07,0.58,0.71,0.58,0.71,+0.37,108.82,280000,4,173930,0,0,0,0,0,0,275000,0,275000,275000
20200430,053589,宏達電元大97購02,,,,,0.00,0.00,0,0,0,0,0,0,0,0,0,0,0,0,0
20200430,05358P,大立光元大95售09,,,,,0.00,0.00,0,0,0,0,0,0,0,0,0,0,0,0,0
20200430,053590,新光金元大9A購02,0.25,0.25,0.25,0.25,0.00,0.00,2000,1,500,0,0,0,0,0,0,0,2000,-2000,-2000
20200430,053591,大立光元大99購03,0.25,0.25,0.25,0.25,0.00,0.00,30000,1,7500,0,0,0,0,0,0,30000,0,30000,30000
20200430,053592,亞光元大96購01,,,,,0.00,0.00,0,0,0,0,0,0,0,0,0,0,0,0,0
20200430,053593,晶技元大98購01,3.23,3.33,3.13,3.32,+0.13,4.08,96000,17,309270,0,0,0,0,0,0,19000,77000,-58000,-58000
20200430,053594,京鼎元大96購02,,,,,0.00,0.00,0,0,0,0,0,0,0,0,0,0,0,0,0
20200430,053595,創意元大96購02,0.85,0.91,0.85,0.91,+0.07,8.33,131000,5,112690,0,0,0,0,0,0,10000,121000,-111000,-111000
20200430,053596,嘉澤元大96購01,,,,,0.00,0.00,0,0,0,0,0,0,0,0,0,0,0,0,0
20200430,053597,牧德元大99購01,1.07,1.07,1.04,1.07,0.00,0.00,5000,3,5260,0,0,0,0,0,0,0,4000,-4000,-4000
20200430,053598,日月光元大96購04,0.43,0.47,0.43,0.47,+0.05,11.9,108000,2,48040,0,0,0,0,0,0,40000,68000,-28000,-28000
20200430,053599,崇越元大96購01,0.26,0.31,0.26,0.29,+0.04,16.0,183000,3,53060,0,0,0,0,0,0,0,183000,-183000,-183000
20200430,05359P,嘉澤元大95售02,0.13,0.13,0.08,0.10,-0.07,-41.18,268000,10,28960,0,0,0,0,0,0,30000,138000,-108000,-108000
20200430,053600,同欣電元大96購04,,,,,0.00,0.00,0,0,0,0,0,0,0,0,0,0,0,0,0
20200430,053601,台表科元大98購01,,,,,0.00,0.00,0,0,0,0,0,0,0,0,0,0,0,0,0
20200430,053602,台虹元大96購01,,,,,0.00,0.00,0,0,0,0,0,0,0,0,0,0,0,0,0
20200430,053603,臺股指元大96購20,,,,,0.00,0.00,0,0,0,0,0,0,0,0,0,0,0,0,0
20200430,053604,臺股指元大96購21,,,,,0.00,0.00,0,0,0,0,0,0,0,0,0,0,0,0,0
20200430,053605,臺股指永昌96購01,,,,,0.00,0.00,0,0,0,0,0,0,0,0,0,0,0,0,0
20200430,053606,臺股指永昌96購02,,,,,0.00,0.00,0,0,0,0,0,0,0,0,0,0,0,0,0
20200430,053607,大立光第一96購01,,,,,0.00,0.00,0,0,0,0,0,0,0,0,0,0,0,0,0
20200430,053608,彩晶第一96購01,,,,,0.00,0.00,0,0,0,0,0,0,0,0,0,0,0,0,0
20200430,053609,華新中信9A購01,0.09,0.10,0.09,0.10,+0.02,25.0,240000,15,23000,0,0,0,0,0,0,100000,140000,-40000,-40000
20200430,05360P,健策元大95售03,,,,,0.00,0.00,0,0,0,0,0,0,0,0,0,0,0,0,0
20200430,053610,矽力中信98購01,,,,,0.00,0.00,0,0,0,0,0,0,0,0,0,0,0,0,0
20200430,053611,聯茂麥證96購01,0.96,0.96,0.96,0.96,-0.01,-1.03,60000,2,57600,10000,50000,-40000,0,0,0,10000,50000,-40000,-40000
20200430,053612,T50反1群益96購01,,,,,0.00,0.00,0,0,0,0,0,0,0,0,0,0,0,0,0
20200430,053613,元油反群益9A購02,,,,,0.00,0.00,0,0,0,0,0,0,0,0,0,0,0,0,0
20200430,053614,台積電群益96購08,,,,,0.00,0.00,0,0,0,0,0,0,0,0,0,0,0,0,0
20200430,053615,光罩群益96購01,,,,,0.00,0.00,0,0,0,0,0,0,0,0,0,0,0,0,0
20200430,053616,奇力新群益97購01,,,,,0.00,0.00,0,0,0,0,0,0,0,0,0,0,0,0,0
20200430,053617,宏達電群益96購02,,,,,0.00,0.00,0,0,0,0,0,0,0,0,0,0,0,0,0
20200430,053618,新唐群益96購01,,,,,0.00,0.00,0,0,0,0,0,0,0,0,0,0,0,0,0
20200430,053619,和碩群益96購01,1.59,1.64,1.59,1.60,-0.05,-3.03,305000,11,493880,0,0,0,0,0,0,188000,117000,71000,71000
20200430,05361P,聯發科富邦97售01,0.98,0.98,0.98,0.98,0.00,0.00,7000,2,6860,0,0,0,0,0,0,0,7000,-7000,-7000
20200430,053620,臺股指群益96購06,,,,,0.00,0.00,0,0,0,0,0,0,0,0,0,0,0,0,0
20200430,053621,臺股指群益96購07,,,,,0.00,0.00,0,0,0,0,0,0,0,0,0,0,0,0,0
20200430,053622,臺股指群益96購08,,,,,0.00,0.00,0,0,0,0,0,0,0,0,0,0,0,0,0
20200430,053623,臺股指群益96購09,,,,,0.00,0.00,0,0,0,0,0,0,0,0,0,0,0,0,0
20200430,053624,A50正2兆豐97購02,,,,,0.00,0.00,0,0,0,0,0,0,0,0,0,0,0,0,0
20200430,053625,國巨兆豐96購03,0.38,0.38,0.38,0.38,+0.08,26.67,20000,2,7600,0,0,0,0,0,0,10000,10000,0,0
20200430,053626,台積電兆豐96購03,,,,,0.00,0.00,0,0,0,0,0,0,0,0,0,0,0,0,0
20200430,053627,宏碁兆豐97購01,0.50,0.50,0.47,0.48,+0.02,4.35,139000,24,67440,0,0,0,0,0,0,80000,10000,70000,70000
20200430,053628,微星兆豐96購01,3.43,3.43,3.41,3.41,+0.03,0.89,23000,4,78830,0,0,0,0,0,0,0,23000,-23000,-23000
20200430,053629,玉山金兆豐96購01,0.84,0.86,0.84,0.86,+0.14,19.44,18000,11,15280,0,0,0,0,0,0,18000,0,18000,18000
20200430,05362P,可成富邦97售02,,,,,0.00,0.00,0,0,0,0,0,0,0,0,0,0,0,0,0
20200430,053630,奇鋐兆豐97購01,1.51,1.59,1.44,1.54,+0.09,6.21,453000,31,687470,0,0,0,0,0,0,124000,329000,-205000,-205000
20200430,053631,欣興兆豐97購01,1.95,1.95,1.82,1.87,-0.01,-0.53,97000,10,178780,0,0,0,0,0,0,95000,2000,93000,93000
20200430,053632,新唐兆豐96購01,0.50,0.50,0.48,0.49,0.00,0.00,105000,3,51550,0,0,0,0,0,0,0,105000,-105000,-105000
20200430,053633,臺股指兆豐96購01,,,,,0.00,0.00,0,0,0,0,0,0,0,0,0,0,0,0,0
20200430,053634,劍麟永豐96購01,0.04,0.04,0.04,0.04,0.00,0.00,10000,1,400,0,0,0,0,0,0,10000,0,10000,10000
20200430,053635,技嘉永豐96購01,0.71,0.71,0.71,0.71,+0.03,4.41,33000,2,23430,0,0,0,0,0,0,33000,0,33000,33000
20200430,053636,全新永豐96購02,,,,,0.00,0.00,0,0,0,0,0,0,0,0,0,0,0,0,0
20200430,053637,強茂永豐96購01,0.58,0.60,0.58,0.60,+0.03,5.26,86000,2,49980,0,0,0,0,0,0,86000,0,86000,86000
20200430,053638,信邦永豐96購01,0.58,0.58,0.56,0.57,-0.06,-9.52,188000,10,106390,0,0,0,0,0,0,79000,109000,-30000,-30000
20200430,053639,禾伸堂永豐96購01,,,,,0.00,0.00,0,0,0,0,0,0,0,0,0,0,0,0,0
20200430,05363P,臺股指富邦95售03,,,,,0.00,0.00,0,0,0,0,0,0,0,0,0,0,0,0,0
20200430,053640,上緯控永豐96購01,,,,,0.00,0.00,0,0,0,0,0,0,0,0,0,0,0,0,0
20200430,053641,正文永豐96購01,,,,,0.00,0.00,0,0,0,0,0,0,0,0,0,0,0,0,0
20200430,053642,瀚宇博永豐96購01,1.12,1.16,1.12,1.16,+0.04,3.57,26000,2,30120,0,0,0,0,0,0,1000,26000,-25000,-25000
20200430,053643,漢唐國票97購02,4.30,4.30,4.30,4.30,-0.01,-0.23,3000,1,12900,0,0,0,0,0,0,3000,0,3000,3000
20200430,053644,台表科國票97購03,,,,,0.00,0.00,0,0,0,0,0,0,0,0,0,0,0,0,0
20200430,053645,臺股指國票96購08,,,,,0.00,0.00,0,0,0,0,0,0,0,0,0,0,0,0,0
20200430,053646,臺股指國票96購09,0.39,0.50,0.39,0.50,+0.11,28.21,5000,4,2140,0,0,0,0,0,0,0,0,0,0
20200430,053647,臺股指國票96購10,,,,,0.00,0.00,0,0,0,0,0,0,0,0,0,0,0,0,0
20200430,053648,台積電凱基97購04,,,,,0.00,0.00,0,0,0,0,0,0,0,0,0,0,0,0,0
20200430,053649,台積電凱基97購05,0.08,0.12,0.08,0.11,+0.03,37.5,74000,4,6280,0,0,0,0,0,0,0,0,0,0
20200430,05364P,臺股指富邦95售04,,,,,0.00,0.00,0,0,0,0,0,0,0,0,0,0,0,0,0
20200430,053650,華邦電凱基98購01,,,,,0.00,0.00,0,0,0,0,0,0,0,0,0,0,0,0,0
20200430,053651,台光電凱基98購01,,,,,0.00,0.00,0,0,0,0,0,0,0,0,0,0,0,0,0
20200430,053652,友達凱基98購04,,,,,0.00,0.00,0,0,0,0,0,0,0,0,0,0,0,0,0
20200430,053653,京元電凱基96購02,0.84,0.84,0.84,0.84,-0.02,-2.33,50000,1,42000,0,0,0,0,0,0,50000,0,50000,50000
20200430,053654,聯發科凱基98購01,0.28,0.29,0.28,0.29,+0.01,3.57,150000,5,43200,0,0,0,0,0,0,150000,0,150000,150000
20200430,053655,全新凱基98購02,,,,,0.00,0.00,0,0,0,0,0,0,0,0,0,0,0,0,0
20200430,053656,可成凱基96購06,,,,,0.00,0.00,0,0,0,0,0,0,0,0,0,0,0,0,0
20200430,053657,元大金凱基96購01,0.11,0.11,0.11,0.11,0.00,0.00,3000,1,330,0,0,0,0,0,0,0,3000,-3000,-3000
20200430,053658,亞光凱基96購01,0.70,0.75,0.70,0.75,+0.03,4.17,50000,2,36500,0,0,0,0,0,0,20000,30000,-10000,-10000
20200430,053659,智原凱基97購01,,,,,0.00,0.00,0,0,0,0,0,0,0,0,0,0,0,0,0
20200430,05365P,臺股指富邦95售05,,,,,0.00,0.00,0,0,0,0,0,0,0,0,0,0,0,0,0
20200430,053660,群創凱基98購08,0.72,0.72,0.72,0.72,+0.05,7.46,150000,2,108000,0,0,0,0,0,0,0,150000,-150000,-150000
20200430,053661,嘉澤凱基97購01,,,,,0.00,0.00,0,0,0,0,0,0,0,0,0,0,0,0,0
20200430,053662,矽力凱基97購01,3.26,3.26,3.26,3.26,-0.41,-11.17,1000,1,3260,0,0,0,0,0,0,0,1000,-1000,-1000
20200430,053663,臺股指凱基96購24,,,,,0.00,0.00,0,0,0,0,0,0,0,0,0,0,0,0,0
20200430,053664,臺股指凱基96購25,,,,,0.00,0.00,0,0,0,0,0,0,0,0,0,0,0,0,0
20200430,053665,臺股指凱基96購26,0.10,0.10,0.10,0.10,0.00,0.00,7000,1,700,0,0,0,0,0,0,0,0,0,0
20200430,053666,臺股指凱基96購29,,,,,0.00,0.00,0,0,0,0,0,0,0,0,0,0,0,0,0
20200430,053667,鴻海統一96購12,,,,,0.00,0.00,0,0,0,0,0,0,0,0,0,0,0,0,0
20200430,053668,鴻海統一97購01,,,,,0.00,0.00,0,0,0,0,0,0,0,0,0,0,0,0,0
20200430,053669,台積電統一96購08,,,,,0.00,0.00,0,0,0,0,0,0,0,0,0,0,0,0,0
20200430,05366P,鴻海元富95售12,,,,,0.00,0.00,0,0,0,0,0,0,0,0,0,0,0,0,0
20200430,053670,台積電統一96購09,,,,,0.00,0.00,0,0,0,0,0,0,0,0,0,0,0,0,0
20200430,053671,可成統一96購03,1.05,1.05,0.90,0.90,-0.12,-11.76,12000,3,11090,0,0,0,0,0,0,0,12000,-12000,-12000
20200430,053672,嘉澤元富96購02,1.03,1.24,1.02,1.24,+0.25,25.25,1732000,50,1901530,0,0,0,0,0,0,914000,818000,96000,96000
20200430,053673,超眾元富96購03,2.40,2.44,2.40,2.44,0.00,0.00,2000,2,4840,0,0,0,0,0,0,0,0,0,0
20200430,053674,臺股指元富96購01,,,,,0.00,0.00,0,0,0,0,0,0,0,0,0,0,0,0,0
20200430,053675,臺股指元富96購02,0.02,0.02,0.02,0.02,+0.01,100.0,100000,2,2000,0,0,0,0,0,0,100000,0,100000,100000
20200430,053676,新光金國泰98購02,,,,,0.00,0.00,0,0,0,0,0,0,0,0,0,0,0,0,0
20200430,053677,同欣電國泰97購01,0.35,0.41,0.35,0.41,0.00,0.00,141000,8,57170,0,0,0,0,0,0,11000,130000,-119000,-119000
20200430,053678,南亞科富邦97購01,,,,,0.00,0.00,0,0,0,0,0,0,0,0,0,0,0,0,0
20200430,053679,緯創富邦96購01,,,,,0.00,0.00,0,0,0,0,0,0,0,0,0,0,0,0,0
20200430,05367P,鴻海元富95售13,,,,,0.00,0.00,0,0,0,0,0,0,0,0,0,0,0,0,0
20200430,053680,臺股指富邦96購01,,,,,0.00,0.00,0,0,0,0,0,0,0,0,0,0,0,0,0
20200430,053681,臺股指富邦96購02,,,,,0.00,0.00,0,0,0,0,0,0,0,0,0,0,0,0,0
20200430,053682,臺股指富邦96購03,,,,,0.00,0.00,0,0,0,0,0,0,0,0,0,0,0,0,0
20200430,053683,上証2X元大96購03,,,,,0.00,0.00,0,0,0,0,0,0,0,0,0,0,0,0,0
20200430,053684,台積電元大96購17,,,,,0.00,0.00,0,0,0,0,0,0,0,0,0,0,0,0,0
20200430,053685,台積電元大96購18,,,,,0.00,0.00,0,0,0,0,0,0,0,0,0,0,0,0,0
20200430,053686,台積電元大97購08,0.13,0.18,0.13,0.14,-0.04,-22.22,41000,7,6150,0,0,0,0,0,0,7000,0,7000,7000
20200430,053687,智邦元大96購02,3.43,3.43,3.43,3.43,-0.28,-7.55,6000,1,20580,0,0,0,0,0,0,6000,0,6000,6000
20200430,053688,燿華元大96購05,,,,,0.00,0.00,0,0,0,0,0,0,0,0,0,0,0,0,0
20200430,053689,台光電元大96購01,0.39,0.49,0.39,0.49,+0.13,36.11,15000,3,6550,0,0,0,0,0,0,15000,0,15000,15000
20200430,05368P,可成元富95售03,,,,,0.00,0.00,0,0,0,0,0,0,0,0,0,0,0,0,0
20200430,053690,南亞科元大96購02,,,,,0.00,0.00,0,0,0,0,0,0,0,0,0,0,0,0,0
20200430,053691,聯發科元大96購16,0.14,0.20,0.14,0.20,+0.10,100.0,507000,5,100920,0,0,0,0,0,0,499000,0,499000,499000
20200430,053692,聯詠元大96購04,,,,,0.00,0.00,0,0,0,0,0,0,0,0,0,0,0,0,0
20200430,053693,欣興元大96購05,0.63,0.66,0.63,0.66,+0.09,15.79,35000,4,22350,0,0,0,0,0,0,25000,0,25000,25000
20200430,053694,創意元大96購03,1.33,1.41,1.33,1.40,+0.08,6.06,158000,5,216560,0,0,0,0,0,0,15000,150000,-135000,-135000
20200430,053695,智易元大97購02,,,,,0.00,0.00,0,0,0,0,0,0,0,0,0,0,0,0,0
20200430,053696,日月光元大96購05,,,,,0.00,0.00,0,0,0,0,0,0,0,0,0,0,0,0,0
20200430,053697,臻鼎元大96購02,,,,,0.00,0.00,0,0,0,0,0,0,0,0,0,0,0,0,0
20200430,053698,中磊元大96購02,0.70,0.70,0.67,0.67,+0.04,6.35,140000,5,94700,0,0,0,0,0,0,140000,0,140000,140000
20200430,053699,臺股指元大96購22,,,,,0.00,0.00,0,0,0,0,0,0,0,0,0,0,0,0,0
20200430,05369P,可成元富95售04,,,,,0.00,0.00,0,0,0,0,0,0,0,0,0,0,0,0,0
20200430,053700,臺股指元大96購23,,,,,0.00,0.00,0,0,0,0,0,0,0,0,0,0,0,0,0
20200430,053701,台積電兆豐96購05,0.24,0.24,0.24,0.24,0.00,0.00,6000,1,1440,0,0,0,0,0,0,0,0,0,0
20200430,053702,智易兆豐97購02,,,,,0.00,0.00,0,0,0,0,0,0,0,0,0,0,0,0,0
20200430,053703,緯穎兆豐96購01,,,,,0.00,0.00,0,0,0,0,0,0,0,0,0,0,0,0,0
20200430,053704,國巨群益96購06,1.02,1.02,1.02,1.02,0.00,0.00,20000,1,20400,0,0,0,0,0,0,20000,0,20000,20000
20200430,053705,滬深2X凱基99購01,0.45,0.45,0.42,0.42,0.00,0.00,15000,2,6600,0,0,0,0,0,0,10000,0,10000,10000
20200430,053706,S&P反1凱基99購01,0.65,1.16,0.62,1.16,0.00,0.00,6000,3,4350,0,0,0,0,0,0,0,5000,-5000,-5000
20200430,053707,A50正2凱基99購02,0.35,0.37,0.35,0.37,0.00,0.00,110000,2,39300,0,0,0,0,0,0,110000,0,110000,110000
20200430,053708,道瓊反凱基98購01,1.22,1.22,1.22,1.22,0.00,0.00,40000,1,48800,0,0,0,0,0,0,40000,0,40000,40000
20200430,053709,台達電凱基96購04,0.17,0.20,0.17,0.20,0.00,0.00,66000,4,11400,0,0,0,0,0,0,6000,60000,-54000,-54000
20200430,05370P,矽創元富95售01,,,,,0.00,0.00,0,0,0,0,0,0,0,0,0,0,0,0,0
20200430,053710,華通凱基96購05,0.64,0.74,0.64,0.72,+0.11,18.03,184000,5,127660,0,0,0,0,0,0,45000,139000,-94000,-94000
20200430,053711,鴻海凱基96購14,,,,,0.00,0.00,0,0,0,0,0,0,0,0,0,0,0,0,0
20200430,053712,台光電凱基96購04,2.28,2.28,2.28,2.28,+0.03,1.33,10000,1,22800,0,0,0,0,0,0,10000,0,10000,10000
20200430,053713,漢唐凱基96購04,1.84,1.84,1.82,1.82,-0.03,-1.62,50000,3,91600,0,0,0,0,0,0,40000,10000,30000,30000
20200430,053714,南亞科凱基96購03,,,,,0.00,0.00,0,0,0,0,0,0,0,0,0,0,0,0,0
20200430,053715,美律凱基96購04,,,,,0.00,0.00,0,0,0,0,0,0,0,0,0,0,0,0,0
20200430,053716,京元電凱基97購01,,,,,0.00,0.00,0,0,0,0,0,0,0,0,0,0,0,0,0
20200430,053717,聯發科凱基96購17,0.01,0.01,0.01,0.01,0.00,0.00,8000,1,80,0,0,0,0,0,0,0,0,0,0
20200430,053718,全新凱基97購02,0.80,0.80,0.80,0.80,-0.10,-11.11,5000,1,4000,0,0,0,0,0,0,5000,0,5000,5000
20200430,053719,可成凱基96購08,1.63,1.63,1.63,1.63,-0.15,-8.43,10000,1,16300,0,0,0,0,0,0,10000,0,10000,10000
20200430,05371P,臺股指中信95售10,,,,,0.00,0.00,0,0,0,0,0,0,0,0,0,0,0,0,0
20200430,053720,宏達電凱基97購01,,,,,0.00,0.00,0,0,0,0,0,0,0,0,0,0,0,0,0
20200430,053721,國泰金凱基97購01,1.25,1.30,1.25,1.30,+0.18,16.07,76000,5,96300,0,0,0,0,0,0,50000,26000,24000,24000
20200430,053722,新光金凱基9C購01,,,,,0.00,0.00,0,0,0,0,0,0,0,0,0,0,0,0,0
20200430,053723,奇鋐凱基98購01,0.49,0.49,0.49,0.49,0.00,0.00,6000,1,2940,0,0,0,0,0,0,0,6000,-6000,-6000
20200430,053724,聯詠凱基96購04,,,,,0.00,0.00,0,0,0,0,0,0,0,0,0,0,0,0,0
20200430,053725,晶相光凱基96購01,,,,,0.00,0.00,0,0,0,0,0,0,0,0,0,0,0,0,0
20200430,053726,TPK凱基96購02,,,,,0.00,0.00,0,0,0,0,0,0,0,0,0,0,0,0,0
20200430,053727,麗豐凱基97購01,0.58,0.58,0.57,0.58,+0.03,5.45,50000,7,28960,0,0,0,0,0,0,30000,20000,10000,10000
20200430,053728,茂林凱基97購01,3.49,3.49,3.40,3.40,0.00,0.00,61000,6,210380,0,0,0,0,0,0,60000,1000,59000,59000
20200430,053729,聯茂凱基96購05,,,,,0.00,0.00,0,0,0,0,0,0,0,0,0,0,0,0,0
20200430,053730,樺漢凱基98購01,,,,,0.00,0.00,0,0,0,0,0,0,0,0,0,0,0,0,0
20200430,053731,矽創凱基96購03,0.28,0.28,0.28,0.28,0.00,0.00,110000,4,30800,0,0,0,0,0,0,50000,60000,-10000,-10000
20200430,053732,S&P反1中信9C購01,,,,,0.00,0.00,0,0,0,0,0,0,0,0,0,0,0,0,0
20200430,053733,華邦電中信98購01,,,,,0.00,0.00,0,0,0,0,0,0,0,0,0,0,0,0,0
20200430,053734,友達中信98購02,,,,,0.00,0.00,0,0,0,0,0,0,0,0,0,0,0,0,0
20200430,053735,矽力中信97購01,3.06,3.06,2.79,2.79,-0.21,-7.0,61000,6,177260,0,0,0,0,0,0,21000,40000,-19000,-19000
20200430,053736,友達麥證96購01,,,,,0.00,0.00,0,0,0,0,0,0,0,0,0,0,0,0,0
20200430,053737,華新科麥證96購01,,,,,0.00,0.00,0,0,0,0,0,0,0,0,0,0,0,0,0
20200430,053738,群創麥證96購01,,,,,0.00,0.00,0,0,0,0,0,0,0,0,0,0,0,0,0
20200430,053739,A50正2國票9A購01,,,,,0.00,0.00,0,0,0,0,0,0,0,0,0,0,0,0,0
20200430,05373P,臺股指中信95售11,,,,,0.00,0.00,0,0,0,0,0,0,0,0,0,0,0,0,0
20200430,053740,元油反國票99購01,,,,,0.00,0.00,0,0,0,0,0,0,0,0,0,0,0,0,0
20200430,053741,漢唐國票97購03,5.15,5.15,5.15,5.15,-0.05,-0.96,3000,1,15450,0,0,0,0,0,0,3000,0,3000,3000
20200430,053742,創意國票97購01,2.99,2.99,2.99,2.99,+0.13,4.55,6000,1,17940,0,0,0,0,0,0,6000,0,6000,6000
20200430,053743,康控國票97購02,,,,,0.00,0.00,0,0,0,0,0,0,0,0,0,0,0,0,0
20200430,053744,台郡國票97購03,1.08,1.15,1.02,1.15,+0.03,2.68,460000,30,491020,0,0,0,0,0,0,336000,112000,224000,224000
20200430,053745,康友國票97購01,0.13,0.14,0.13,0.14,+0.02,16.67,207000,6,27980,0,0,0,0,0,0,107000,100000,7000,7000
20200430,053746,彰銀康和96購01,,,,,0.00,0.00,0,0,0,0,0,0,0,0,0,0,0,0,0
20200430,053747,滬深2X永豐96購05,,,,,0.00,0.00,0,0,0,0,0,0,0,0,0,0,0,0,0
20200430,053748,燿華永豐96購04,,,,,0.00,0.00,0,0,0,0,0,0,0,0,0,0,0,0,0
20200430,053749,揚明光永豐97購01,0.16,0.16,0.16,0.16,0.00,0.00,20000,2,3200,0,0,0,0,0,0,0,20000,-20000,-20000
20200430,05374P,台積電國票96售07,,,,,0.00,0.00,0,0,0,0,0,0,0,0,0,0,0,0,0
20200430,053750,致伸永豐96購02,0.39,0.39,0.39,0.39,-0.06,-13.33,51000,1,19890,0,0,0,0,0,0,51000,0,51000,51000
20200430,053751,康控永豐96購02,,,,,0.00,0.00,0,0,0,0,0,0,0,0,0,0,0,0,0
20200430,053752,超眾永豐96購02,0.31,0.31,0.31,0.31,+0.01,3.33,12000,2,3720,0,0,0,0,0,0,0,12000,-12000,-12000
20200430,053753,啟碁永豐96購01,0.22,0.22,0.22,0.22,0.00,0.00,40000,1,8800,0,0,0,0,0,0,40000,0,40000,40000
20200430,053754,英業達元富96購02,0.52,0.53,0.50,0.52,0.00,0.00,984000,16,506250,0,0,0,0,0,0,763000,221000,542000,542000
20200430,053755,亞光元富96購01,0.27,0.27,0.27,0.27,0.00,0.00,45000,1,12150,0,0,0,0,0,0,45000,0,45000,45000
20200430,053756,亞光元富96購02,,,,,0.00,0.00,0,0,0,0,0,0,0,0,0,0,0,0,0
20200430,053757,聯發科國泰96購04,0.35,0.35,0.33,0.33,0.00,0.00,480000,48,162400,0,0,0,0,0,0,480000,480000,0,0
20200430,053758,華新科國泰97購02,,,,,0.00,0.00,0,0,0,0,0,0,0,0,0,0,0,0,0
20200430,053759,晶相光國泰98購01,0.71,0.71,0.71,0.71,-0.01,-1.39,4000,1,2840,0,0,0,0,0,0,0,4000,-4000,-4000
20200430,05375P,健策國票96售02,0.20,0.21,0.18,0.18,-0.06,-25.0,1610000,6,324100,0,0,0,0,0,0,0,1610000,-1610000,-1610000
20200430,053760,牧德國泰98購01,2.32,2.32,2.32,2.32,+1.02,78.46,5000,2,11600,0,0,0,0,0,0,0,0,0,0
20200430,053761,健策國泰98購01,0.85,0.90,0.85,0.90,+0.08,9.76,67000,6,59050,0,0,0,0,0,0,37000,0,37000,37000
20200430,053762,T50反1富邦97購01,,,,,0.00,0.00,0,0,0,0,0,0,0,0,0,0,0,0,0
20200430,053763,T50反1富邦98購01,,,,,0.00,0.00,0,0,0,0,0,0,0,0,0,0,0,0,0
20200430,053764,A50正2富邦99購01,,,,,0.00,0.00,0,0,0,0,0,0,0,0,0,0,0,0,0
20200430,053765,智邦富邦96購01,,,,,0.00,0.00,0,0,0,0,0,0,0,0,0,0,0,0,0
20200430,053766,友達富邦97購01,,,,,0.00,0.00,0,0,0,0,0,0,0,0,0,0,0,0,0
20200430,053767,臻鼎富邦97購02,,,,,0.00,0.00,0,0,0,0,0,0,0,0,0,0,0,0,0
20200430,053768,S&P反1元大99購01,1.24,1.24,1.18,1.18,-0.17,-12.59,151000,3,183480,0,0,0,0,0,0,61000,90000,-29000,-29000
20200430,053769,香港反元大99購01,0.78,0.78,0.78,0.78,0.00,0.00,22000,1,17160,0,0,0,0,0,0,22000,0,22000,22000
20200430,05376P,聯發科日盛95售04,,,,,0.00,0.00,0,0,0,0,0,0,0,0,0,0,0,0,0
20200430,053770,元金2X元大98購01,3.09,3.09,3.09,3.09,-0.05,-1.59,4000,1,12360,0,0,0,0,0,0,4000,0,4000,4000
20200430,053771,華新元大97購01,,,,,0.00,0.00,0,0,0,0,0,0,0,0,0,0,0,0,0
20200430,053772,大成鋼元大96購02,,,,,0.00,0.00,0,0,0,0,0,0,0,0,0,0,0,0,0
20200430,053773,上銀元大96購04,2.94,3.51,2.84,3.51,+0.76,27.64,266000,26,813490,0,0,0,0,0,0,149000,117000,32000,32000
20200430,053774,台達電元大96購04,0.39,0.52,0.39,0.48,+0.17,54.84,156000,18,71480,0,0,0,0,0,0,16000,146000,-130000,-130000
20200430,053775,鴻海元大96購21,,,,,0.00,0.00,0,0,0,0,0,0,0,0,0,0,0,0,0
20200430,053776,台積電元大96購19,,,,,0.00,0.00,0,0,0,0,0,0,0,0,0,0,0,0,0
20200430,053777,台積電元大96購20,0.12,0.12,0.12,0.12,0.00,0.00,4000,1,480,0,0,0,0,0,0,4000,0,4000,4000
20200430,053778,旺宏元大97購03,,,,,0.00,0.00,0,0,0,0,0,0,0,0,0,0,0,0,0
20200430,053779,台光電元大96購02,,,,,0.00,0.00,0,0,0,0,0,0,0,0,0,0,0,0,0
20200430,05377P,鴻海凱基95售18,,,,,0.00,0.00,0,0,0,0,0,0,0,0,0,0,0,0,0
20200430,053780,南亞科元大96購03,1.13,1.13,1.02,1.03,+0.02,1.98,98000,4,107740,0,0,0,0,0,0,30000,68000,-38000,-38000
20200430,053781,友達元大9B購03,,,,,0.00,0.00,0,0,0,0,0,0,0,0,0,0,0,0,0
20200430,053782,京元電元大98購02,,,,,0.00,0.00,0,0,0,0,0,0,0,0,0,0,0,0,0
20200430,053783,聯發科元大96購17,,,,,0.00,0.00,0,0,0,0,0,0,0,0,0,0,0,0,0
20200430,053784,奇力新元大97購02,1.84,1.99,1.81,1.81,+0.07,4.02,216000,16,412920,0,0,0,0,0,0,5000,211000,-206000,-206000
20200430,053785,聯詠元大96購05,,,,,0.00,0.00,0,0,0,0,0,0,0,0,0,0,0,0,0
20200430,053786,新日興元大96購02,1.17,1.17,1.17,1.17,0.00,0.00,100000,1,117000,0,0,0,0,0,0,100000,0,100000,100000
20200430,053787,健策元大97購02,,,,,0.00,0.00,0,0,0,0,0,0,0,0,0,0,0,0,0
20200430,053788,泰鼎元大97購01,,,,,0.00,0.00,0,0,0,0,0,0,0,0,0,0,0,0,0
20200430,053789,彩晶元大9C購02,,,,,0.00,0.00,0,0,0,0,0,0,0,0,0,0,0,0,0
20200430,05378P,台積電凱基96售02,,,,,0.00,0.00,0,0,0,0,0,0,0,0,0,0,0,0,0
20200430,053790,嘉聯益元大99購02,,,,,0.00,0.00,0,0,0,0,0,0,0,0,0,0,0,0,0
20200430,053791,同欣電元大96購05,,,,,0.00,0.00,0,0,0,0,0,0,0,0,0,0,0,0,0
20200430,053792,百和元大96購01,,,,,0.00,0.00,0,0,0,0,0,0,0,0,0,0,0,0,0
20200430,053793,致伸兆豐96購01,,,,,0.00,0.00,0,0,0,0,0,0,0,0,0,0,0,0,0
20200430,053794,燿華亞東96購01,,,,,0.00,0.00,0,0,0,0,0,0,0,0,0,0,0,0,0
20200430,053795,群創亞東96購01,,,,,0.00,0.00,0,0,0,0,0,0,0,0,0,0,0,0,0
20200430,053796,華通中信96購02,,,,,0.00,0.00,0,0,0,0,0,0,0,0,0,0,0,0,0
20200430,053797,台積電中信98購01,0.25,0.25,0.25,0.25,0.00,0.00,10000,1,2500,0,0,0,0,0,0,0,0,0,0
20200430,053798,台積電中信98購02,,,,,0.00,0.00,0,0,0,0,0,0,0,0,0,0,0,0,0
20200430,053799,矽創中信9A購01,0.18,0.21,0.18,0.21,0.00,0.00,35000,4,6800,0,0,0,0,0,0,0,35000,-35000,-35000
20200430,05379P,可成凱基95售11,,,,,0.00,0.00,0,0,0,0,0,0,0,0,0,0,0,0,0
20200430,053800,華通凱基97購03,1.31,1.31,1.24,1.24,0.00,0.00,34000,8,44050,0,0,0,0,0,0,0,34000,-34000,-34000
20200430,053801,台積電凱基96購18,,,,,0.00,0.00,0,0,0,0,0,0,0,0,0,0,0,0,0
20200430,053802,南亞科凱基96購04,,,,,0.00,0.00,0,0,0,0,0,0,0,0,0,0,0,0,0
20200430,053803,聯發科凱基96購18,,,,,0.00,0.00,0,0,0,0,0,0,0,0,0,0,0,0,0
20200430,053804,富邦金凱基96購01,1.35,1.52,1.32,1.52,+0.25,19.69,249000,35,341810,0,0,0,0,0,0,142000,152000,-10000,-10000
20200430,053805,奇鋐凱基98購02,,,,,0.00,0.00,0,0,0,0,0,0,0,0,0,0,0,0,0
20200430,053806,鎧勝凱基96購02,0.48,0.61,0.48,0.61,+0.09,17.31,350000,7,189400,0,0,0,0,0,0,170000,180000,-10000,-10000
20200430,053807,T50反1群益96購02,,,,,0.00,0.00,0,0,0,0,0,0,0,0,0,0,0,0,0
20200430,053808,大成鋼群益97購01,,,,,0.00,0.00,0,0,0,0,0,0,0,0,0,0,0,0,0
20200430,053809,上銀群益96購02,0.39,0.69,0.39,0.69,+0.30,76.92,17000,5,8370,0,0,0,0,0,0,16000,0,16000,16000
20200430,05380P,鴻海群益95售11,,,,,0.00,0.00,0,0,0,0,0,0,0,0,0,0,0,0,0
20200430,053810,台達電群益96購01,0.80,0.91,0.75,0.87,+0.14,19.18,287000,24,235770,0,0,0,0,0,0,175000,112000,63000,63000
20200430,053811,國巨群益98購02,,,,,0.00,0.00,0,0,0,0,0,0,0,0,0,0,0,0,0
20200430,053812,台積電群益96購09,,,,,0.00,0.00,0,0,0,0,0,0,0,0,0,0,0,0,0
20200430,053813,友達群益9A購03,0.15,0.15,0.15,0.15,0.00,0.00,5000,1,750,0,0,0,0,0,0,5000,0,5000,5000
20200430,053814,美律群益97購02,,,,,0.00,0.00,0,0,0,0,0,0,0,0,0,0,0,0,0
20200430,053815,聯發科群益96購01,0.17,0.20,0.17,0.20,0.00,0.00,6000,2,1170,0,0,0,0,0,0,6000,0,6000,6000
20200430,053816,聯發科群益96購02,,,,,0.00,0.00,0,0,0,0,0,0,0,0,0,0,0,0,0
20200430,053817,華新科群益97購02,,,,,0.00,0.00,0,0,0,0,0,0,0,0,0,0,0,0,0
20200430,053818,富邦金群益98購01,0.51,0.60,0.51,0.60,+0.13,27.66,25000,2,13200,0,0,0,0,0,0,20000,0,20000,20000
20200430,053819,大立光群益96購04,0.77,0.90,0.77,0.90,+0.12,15.38,162000,4,129100,0,0,0,0,0,0,118000,44000,74000,74000
20200430,05381P,聯詠群益95售02,,,,,0.00,0.00,0,0,0,0,0,0,0,0,0,0,0,0,0
20200430,053820,大立光群益96購05,,,,,0.00,0.00,0,0,0,0,0,0,0,0,0,0,0,0,0
20200430,053821,群創群益98購08,0.31,0.33,0.31,0.33,+0.02,6.45,45000,5,14770,0,0,0,0,0,0,4000,41000,-37000,-37000
20200430,053822,正文群益97購01,,,,,0.00,0.00,0,0,0,0,0,0,0,0,0,0,0,0,0
20200430,053823,茂林群益96購06,,,,,0.00,0.00,0,0,0,0,0,0,0,0,0,0,0,0,0
20200430,053824,樺漢群益96購02,,,,,0.00,0.00,0,0,0,0,0,0,0,0,0,0,0,0,0
20200430,053825,南電群益96購02,5.10,5.10,5.10,5.10,+0.14,2.82,10000,1,51000,0,0,0,0,0,0,10000,0,10000,10000
20200430,053826,光磊麥證97購01,,,,,0.00,0.00,0,0,0,0,0,0,0,0,0,0,0,0,0
20200430,053827,漢唐麥證9A購01,0.82,0.82,0.82,0.82,+0.02,2.5,50000,1,41000,0,50000,-50000,0,0,0,0,50000,-50000,-50000
20200430,053828,貿聯麥證96購01,,,,,0.00,0.00,0,0,0,0,0,0,0,0,0,0,0,0,0
20200430,053829,力成麥證96購01,,,,,0.00,0.00,0,0,0,0,0,0,0,0,0,0,0,0,0
20200430,05382P,電子類群益95售02,2.89,2.89,2.89,2.89,0.00,0.00,1000,1,2890,0,0,0,0,0,0,0,1000,-1000,-1000
20200430,053830,台積電台新96購02,,,,,0.00,0.00,0,0,0,0,0,0,0,0,0,0,0,0,0
20200430,053831,台積電台新97購02,,,,,0.00,0.00,0,0,0,0,0,0,0,0,0,0,0,0,0
20200430,053832,聯發科台新96購01,,,,,0.00,0.00,0,0,0,0,0,0,0,0,0,0,0,0,0
20200430,053833,彩晶台新97購02,,,,,0.00,0.00,0,0,0,0,0,0,0,0,0,0,0,0,0
20200430,053834,卜蜂永豐96購01,,,,,0.00,0.00,0,0,0,0,0,0,0,0,0,0,0,0,0
20200430,053835,南亞科永豐96購02,0.01,0.01,0.01,0.01,0.00,0.00,10000,10,100,0,0,0,0,0,0,0,10000,-10000,-10000
20200430,053836,亞光永豐96購02,0.59,0.59,0.58,0.58,0.00,0.00,130000,2,76080,0,0,0,0,0,0,62000,68000,-6000,-6000
20200430,053837,貿聯永豐96購02,0.23,0.34,0.23,0.34,0.00,0.00,42000,6,12880,0,0,0,0,0,0,10000,32000,-22000,-22000
20200430,053838,正文永豐96購02,,,,,0.00,0.00,0,0,0,0,0,0,0,0,0,0,0,0,0
20200430,053839,華通統一96購01,,,,,0.00,0.00,0,0,0,0,0,0,0,0,0,0,0,0,0
20200430,05383P,鴻海富邦95售06,,,,,0.00,0.00,0,0,0,0,0,0,0,0,0,0,0,0,0
20200430,053840,燿華統一96購02,,,,,0.00,0.00,0,0,0,0,0,0,0,0,0,0,0,0,0
20200430,053841,美律統一96購01,0.11,0.11,0.11,0.11,0.00,0.00,2000,1,220,0,0,0,0,0,0,2000,0,2000,2000
20200430,053842,聯發科統一96購08,,,,,0.00,0.00,0,0,0,0,0,0,0,0,0,0,0,0,0
20200430,053843,訊芯統一96購01,,,,,0.00,0.00,0,0,0,0,0,0,0,0,0,0,0,0,0
20200430,053844,GIS統一96購01,0.48,0.48,0.47,0.47,+0.02,4.44,65000,7,31150,0,0,0,0,0,0,65000,0,65000,65000
20200430,053845,和大元富96購01,,,,,0.00,0.00,0,0,0,0,0,0,0,0,0,0,0,0,0
20200430,053846,友達元富99購02,,,,,0.00,0.00,0,0,0,0,0,0,0,0,0,0,0,0,0
20200430,053847,美律元富96購02,0.24,0.24,0.24,0.24,0.00,0.00,6000,1,1440,0,0,0,0,0,0,6000,0,6000,6000
20200430,053848,聯發科元富96購03,,,,,0.00,0.00,0,0,0,0,0,0,0,0,0,0,0,0,0
20200430,053849,聯發科元富96購04,0.80,0.85,0.78,0.85,+0.16,23.19,188000,6,150820,0,0,0,0,0,0,150000,38000,112000,112000
20200430,05384P,大立光永豐95售02,,,,,0.00,0.00,0,0,0,0,0,0,0,0,0,0,0,0,0
20200430,053850,嘉澤元富96購03,,,,,0.00,0.00,0,0,0,0,0,0,0,0,0,0,0,0,0
20200430,053851,鴻海國泰98購03,,,,,0.00,0.00,0,0,0,0,0,0,0,0,0,0,0,0,0
20200430,053852,南亞科國泰98購01,,,,,0.00,0.00,0,0,0,0,0,0,0,0,0,0,0,0,0
20200430,053853,康控國泰97購02,,,,,0.00,0.00,0,0,0,0,0,0,0,0,0,0,0,0,0
20200430,053854,聯茂國泰97購02,2.71,2.72,2.66,2.66,-0.13,-4.66,26000,10,69970,0,0,0,0,0,0,26000,0,26000,26000
20200430,053855,康友國泰98購01,0.34,0.34,0.34,0.34,+0.05,17.24,2000,1,680,0,0,0,0,0,0,2000,0,2000,2000
20200430,053856,台積電富邦98購01,0.06,0.07,0.06,0.07,0.00,0.00,3170000,59,207580,0,0,0,0,0,0,0,77000,-77000,-77000
20200430,053857,宏達電富邦97購02,,,,,0.00,0.00,0,0,0,0,0,0,0,0,0,0,0,0,0
20200430,053858,台達電元大96購05,0.40,0.40,0.40,0.40,0.00,0.00,5000,1,2000,0,0,0,0,0,0,5000,0,5000,5000
20200430,053859,台積電元大97購09,0.32,0.32,0.32,0.32,0.00,0.00,40000,1,12800,0,0,0,0,0,0,40000,40000,0,0
20200430,053860,台積電元大98購03,0.45,0.45,0.43,0.43,+0.01,2.38,6000,2,2600,0,0,0,0,0,0,0,0,0,0
20200430,053861,台光電元大98購01,,,,,0.00,0.00,0,0,0,0,0,0,0,0,0,0,0,0,0
20200430,053862,南亞科元大97購02,,,,,0.00,0.00,0,0,0,0,0,0,0,0,0,0,0,0,0
20200430,053863,聯發科元大96購18,0.02,0.02,0.02,0.02,0.00,0.00,160000,1,3200,0,0,0,0,0,0,160000,0,160000,160000
20200430,053864,義隆元大96購01,1.30,1.48,1.23,1.48,+0.20,15.62,946000,29,1298490,0,0,0,0,0,0,542000,513000,29000,29000
20200430,053865,欣興元大97購02,2.30,2.39,2.25,2.26,+0.09,4.15,227000,20,519980,0,0,0,0,0,0,203000,25000,178000,178000
20200430,053866,景碩元大97購02,0.87,0.87,0.87,0.87,0.00,0.00,100000,1,87000,0,0,0,0,0,0,100000,0,100000,100000
20200430,053867,創意元大96購04,2.03,2.18,2.03,2.15,+0.09,4.37,66000,4,139630,0,0,0,0,0,0,16000,51000,-35000,-35000
20200430,053868,群創元大99購02,,,,,0.00,0.00,0,0,0,0,0,0,0,0,0,0,0,0,0
20200430,053869,嘉澤元大96購02,1.10,1.10,1.10,1.10,0.00,0.00,5000,1,5500,0,0,0,0,0,0,0,5000,-5000,-5000
20200430,05386P,臺股指永豐95售05,,,,,0.00,0.00,0,0,0,0,0,0,0,0,0,0,0,0,0
20200430,053870,正文元大96購01,,,,,0.00,0.00,0,0,0,0,0,0,0,0,0,0,0,0,0
20200430,053871,臻鼎元大96購03,0.54,0.66,0.50,0.66,+0.17,34.69,755000,15,417830,0,0,0,0,0,0,218000,537000,-319000,-319000
20200430,053872,臻鼎元大96購04,,,,,0.00,0.00,0,0,0,0,0,0,0,0,0,0,0,0,0
20200430,053873,力成元大96購03,,,,,0.00,0.00,0,0,0,0,0,0,0,0,0,0,0,0,0
20200430,053874,台表科元大96購05,,,,,0.00,0.00,0,0,0,0,0,0,0,0,0,0,0,0,0
20200430,053875,GIS元大97購01,1.65,1.67,1.58,1.59,0.00,0.00,450000,30,729090,0,0,0,0,0,0,398000,108000,290000,290000
20200430,053876,可成永昌98購01,,,,,0.00,0.00,0,0,0,0,0,0,0,0,0,0,0,0,0
20200430,053877,奇力新亞東96購01,,,,,0.00,0.00,0,0,0,0,0,0,0,0,0,0,0,0,0
20200430,053878,台表科亞東96購01,,,,,0.00,0.00,0,0,0,0,0,0,0,0,0,0,0,0,0
20200430,053879,元油反中信98購02,,,,,0.00,0.00,0,0,0,0,0,0,0,0,0,0,0,0,0
20200430,05387P,鴻海元大95售21,,,,,0.00,0.00,0,0,0,0,0,0,0,0,0,0,0,0,0
20200430,053880,智邦中信96購01,2.94,2.94,2.94,2.94,+0.15,5.38,4000,1,11760,0,0,0,0,0,0,4000,0,4000,4000
20200430,053881,南亞科中信97購01,,,,,0.00,0.00,0,0,0,0,0,0,0,0,0,0,0,0,0
20200430,053882,聯發科中信98購02,0.05,0.06,0.05,0.06,0.00,0.00,140000,4,7400,0,0,0,0,0,0,0,0,0,0
20200430,053883,大立光中信98購02,0.07,0.07,0.07,0.07,+0.03,75.0,2000,1,140,0,0,0,0,0,0,0,0,0,0
20200430,053884,緯穎第一96購01,1.02,1.02,1.02,1.02,+0.25,32.47,1000,1,1020,0,0,0,0,0,0,1000,0,1000,1000
20200430,053885,全新兆豐96購01,0.04,0.04,0.04,0.04,0.00,0.00,3000,1,120,0,0,0,0,0,0,0,3000,-3000,-3000
20200430,053886,亞光兆豐96購01,,,,,0.00,0.00,0,0,0,0,0,0,0,0,0,0,0,0,0
20200430,053887,聯茂兆豐97購02,1.34,1.34,1.31,1.31,-0.03,-2.24,210000,3,278900,0,0,0,0,0,0,0,210000,-210000,-210000
20200430,053888,和大群益97購01,0.15,0.26,0.15,0.25,0.00,0.00,111000,6,19640,0,0,0,0,0,0,22000,0,22000,22000
20200430,053889,致茂群益97購01,1.58,1.58,1.39,1.39,-0.14,-9.15,196000,15,292750,0,0,0,0,0,0,126000,70000,56000,56000
20200430,05388P,南亞科元大95售04,,,,,0.00,0.00,0,0,0,0,0,0,0,0,0,0,0,0,0
20200430,053890,華新科群益98購01,,,,,0.00,0.00,0,0,0,0,0,0,0,0,0,0,0,0,0
20200430,053891,欣興群益98購01,0.54,0.54,0.51,0.51,+0.05,10.87,117000,17,61510,0,0,0,0,0,0,95000,0,95000,95000
20200430,053892,景碩群益96購02,1.29,1.37,1.29,1.37,+0.04,3.01,287000,9,380310,0,0,0,0,0,0,123000,164000,-41000,-41000
20200430,053893,京鼎群益97購02,0.73,0.82,0.73,0.82,+0.15,22.39,197000,6,150070,0,0,0,0,0,0,81000,116000,-35000,-35000
20200430,053894,創意群益96購01,2.77,2.89,2.77,2.89,+0.21,7.84,25000,4,70850,0,0,0,0,0,0,0,25000,-25000,-25000
20200430,053895,智易群益96購02,0.53,0.53,0.53,0.53,-0.06,-10.17,11000,1,5830,0,0,0,0,0,0,11000,0,11000,11000
20200430,053896,麗豐群益97購01,0.53,0.56,0.52,0.53,+0.06,12.77,183000,7,100510,0,0,0,0,0,0,25000,158000,-133000,-133000
20200430,053897,台郡群益96購01,,,,,0.00,0.00,0,0,0,0,0,0,0,0,0,0,0,0,0
20200430,053898,康友群益97購01,0.59,0.61,0.59,0.61,+0.08,15.09,22000,2,13020,0,0,0,0,0,0,0,22000,-22000,-22000
20200430,053899,矽創群益96購02,,,,,0.00,0.00,0,0,0,0,0,0,0,0,0,0,0,0,0
20200430,053900,T50反1日盛99購01,0.78,0.78,0.62,0.62,-0.14,-18.42,236000,25,159240,0,0,0,0,0,0,0,195000,-195000,-195000
20200430,053901,T50反1凱基99購03,,,,,0.00,0.00,0,0,0,0,0,0,0,0,0,0,0,0,0
20200430,053902,S&P反1凱基97購01,,,,,0.00,0.00,0,0,0,0,0,0,0,0,0,0,0,0,0
20200430,053903,燿華凱基97購01,,,,,0.00,0.00,0,0,0,0,0,0,0,0,0,0,0,0,0
20200430,053904,漢唐凱基97購01,,,,,0.00,0.00,0,0,0,0,0,0,0,0,0,0,0,0,0
20200430,053905,華新科凱基96購10,,,,,0.00,0.00,0,0,0,0,0,0,0,0,0,0,0,0,0
20200430,053906,宏達電凱基96購02,,,,,0.00,0.00,0,0,0,0,0,0,0,0,0,0,0,0,0
20200430,053907,揚明光凱基96購01,,,,,0.00,0.00,0,0,0,0,0,0,0,0,0,0,0,0,0
20200430,053908,貿聯凱基98購01,,,,,0.00,0.00,0,0,0,0,0,0,0,0,0,0,0,0,0
20200430,053909,致伸凱基97購01,0.03,0.08,0.03,0.08,+0.05,166.67,215000,3,6800,0,0,0,0,0,0,0,0,0,0
20200430,05390P,康友群益95售04,,,,,0.00,0.00,0,0,0,0,0,0,0,0,0,0,0,0,0
20200430,053910,嘉聯益凱基98購01,,,,,0.00,0.00,0,0,0,0,0,0,0,0,0,0,0,0,0
20200430,053911,臺股指凱基96購31,,,,,0.00,0.00,0,0,0,0,0,0,0,0,0,0,0,0,0
20200430,053912,T50反1國票97購02,,,,,0.00,0.00,0,0,0,0,0,0,0,0,0,0,0,0,0
20200430,053913,華新國票97購01,0.79,0.84,0.77,0.81,+0.08,10.96,178000,13,143250,0,0,0,0,0,0,115000,63000,52000,52000
20200430,053914,國巨國票96購08,,,,,0.00,0.00,0,0,0,0,0,0,0,0,0,0,0,0,0
20200430,053915,光罩國票96購02,0.26,0.28,0.25,0.26,0.00,0.00,363000,32,95250,0,0,0,0,0,0,157000,206000,-49000,-49000
20200430,053916,漢唐國票97購04,2.20,2.20,2.16,2.16,0.00,0.00,16000,3,34800,0,0,0,0,0,0,16000,0,16000,16000
20200430,053917,友達國票97購03,,,,,0.00,0.00,0,0,0,0,0,0,0,0,0,0,0,0,0
20200430,053918,美律國票97購01,,,,,0.00,0.00,0,0,0,0,0,0,0,0,0,0,0,0,0
20200430,053919,可成國票97購02,1.62,1.62,1.62,1.62,-0.02,-1.22,5000,1,8100,0,0,0,0,0,0,5000,0,5000,5000
20200430,05391P,鴻海統一95售12,,,,,0.00,0.00,0,0,0,0,0,0,0,0,0,0,0,0,0
20200430,053920,新光金國票98購01,,,,,0.00,0.00,0,0,0,0,0,0,0,0,0,0,0,0,0
20200430,053921,嘉晶國票97購03,1.03,1.27,1.03,1.13,+0.10,9.71,382000,12,431510,0,0,0,0,0,0,41000,341000,-300000,-300000
20200430,053922,亞光國票96購01,0.57,0.58,0.57,0.58,+0.04,7.41,66000,3,37670,0,0,0,0,0,0,61000,5000,56000,56000
20200430,053923,亞光國票97購01,0.17,0.17,0.17,0.17,0.00,0.00,5000,2,850,0,0,0,0,0,0,0,2000,-2000,-2000
20200430,053924,京鼎國票97購01,0.63,0.72,0.63,0.72,0.00,0.00,114000,7,73710,0,0,0,0,0,0,0,114000,-114000,-114000
20200430,053925,群創國票98購01,,,,,0.00,0.00,0,0,0,0,0,0,0,0,0,0,0,0,0
20200430,053926,晶相光國票97購01,,,,,0.00,0.00,0,0,0,0,0,0,0,0,0,0,0,0,0
20200430,053927,牧德國票97購01,,,,,0.00,0.00,0,0,0,0,0,0,0,0,0,0,0,0,0
20200430,053928,智易國票97購03,1.91,1.91,1.90,1.90,-0.26,-12.04,21000,2,40040,0,0,0,0,0,0,21000,0,21000,21000
20200430,053929,正文國票97購01,0.58,0.58,0.56,0.57,-0.03,-5.0,142000,5,81020,0,0,0,0,0,0,94000,48000,46000,46000
20200430,05392P,鴻海統一95售13,,,,,0.00,0.00,0,0,0,0,0,0,0,0,0,0,0,0,0
20200430,053930,S&P反1統一98購01,,,,,0.00,0.00,0,0,0,0,0,0,0,0,0,0,0,0,0
20200430,053931,楠梓電統一96購01,0.42,0.42,0.42,0.42,0.00,0.00,50000,2,21000,0,0,0,0,0,0,0,50000,-50000,-50000
20200430,053932,華新科統一96購03,4.34,4.34,4.34,4.34,-0.01,-0.23,11000,1,47740,0,0,0,0,0,0,11000,0,11000,11000
20200430,053933,大立光統一96購06,,,,,0.00,0.00,0,0,0,0,0,0,0,0,0,0,0,0,0
20200430,053934,A50正2元富96購02,,,,,0.00,0.00,0,0,0,0,0,0,0,0,0,0,0,0,0
20200430,053935,華通元富96購02,0.57,0.68,0.57,0.66,+0.17,34.69,28000,5,18610,0,0,0,0,0,0,3000,25000,-22000,-22000
20200430,053936,旺宏元富96購04,,,,,0.00,0.00,0,0,0,0,0,0,0,0,0,0,0,0,0
20200430,053937,光磊元富96購01,,,,,0.00,0.00,0,0,0,0,0,0,0,0,0,0,0,0,0
20200430,053938,彩晶元富96購01,,,,,0.00,0.00,0,0,0,0,0,0,0,0,0,0,0,0,0
20200430,053939,台表科元富96購03,,,,,0.00,0.00,0,0,0,0,0,0,0,0,0,0,0,0,0
20200430,05393P,鴻海統一95售14,,,,,0.00,0.00,0,0,0,0,0,0,0,0,0,0,0,0,0
20200430,053940,康友元富96購01,,,,,0.00,0.00,0,0,0,0,0,0,0,0,0,0,0,0,0
20200430,053941,國巨國泰96購05,,,,,0.00,0.00,0,0,0,0,0,0,0,0,0,0,0,0,0
20200430,053942,超眾國泰96購02,,,,,0.00,0.00,0,0,0,0,0,0,0,0,0,0,0,0,0
20200430,053943,元油反富邦97購03,,,,,0.00,0.00,0,0,0,0,0,0,0,0,0,0,0,0,0
20200430,053944,亞泥富邦97購01,,,,,0.00,0.00,0,0,0,0,0,0,0,0,0,0,0,0,0
20200430,053945,國巨富邦98購02,0.41,0.55,0.41,0.55,+0.11,25.0,329000,14,166200,0,0,0,0,0,0,275000,20000,255000,255000
20200430,053946,全新富邦97購02,,,,,0.00,0.00,0,0,0,0,0,0,0,0,0,0,0,0,0
20200430,053947,義隆富邦97購01,1.13,1.23,1.13,1.18,+0.07,6.31,730000,20,853600,0,0,0,0,0,0,44000,689000,-645000,-645000
20200430,053948,大立光富邦99購04,0.11,0.11,0.11,0.11,0.00,0.00,10000,1,1100,0,0,0,0,0,0,0,0,0,0
20200430,053949,康控富邦9A購01,0.09,0.12,0.09,0.12,+0.05,71.43,39000,7,4140,0,0,0,0,0,0,17000,0,17000,17000
20200430,05394P,聯詠中信95售02,,,,,0.00,0.00,0,0,0,0,0,0,0,0,0,0,0,0,0
20200430,053950,緯穎富邦97購02,2.05,2.32,2.00,2.32,+0.38,19.59,270000,36,584870,0,0,0,0,0,0,107000,163000,-56000,-56000
20200430,053951,T50反1台新06購02,,,,,0.00,0.00,0,0,0,0,0,0,0,0,0,0,0,0,0
20200430,053952,南亞科台新96購01,,,,,0.00,0.00,0,0,0,0,0,0,0,0,0,0,0,0,0
20200430,053953,群創台新97購01,0.01,0.01,0.01,0.01,0.00,0.00,10000,1,100,0,0,0,0,0,0,0,10000,-10000,-10000
20200430,053954,貿聯康和96購01,0.65,0.66,0.65,0.66,0.00,0.00,144000,6,93700,0,0,0,0,0,0,0,144000,-144000,-144000
20200430,053955,華通永豐96購04,0.83,1.00,0.83,1.00,0.00,0.00,95000,3,83380,0,0,0,0,0,0,0,95000,-95000,-95000
20200430,053956,旺宏永豐96購04,1.13,1.16,1.06,1.06,+0.11,11.58,179000,10,201690,0,0,0,0,0,0,179000,0,179000,179000
20200430,053957,瑞昱永豐96購01,0.32,0.42,0.32,0.40,+0.13,48.15,210000,14,79020,0,0,0,0,0,0,126000,34000,92000,92000
20200430,053958,京元電永豐96購01,0.70,0.71,0.70,0.71,0.00,0.00,59000,2,41680,0,0,0,0,0,0,0,59000,-59000,-59000
20200430,053959,晶豪科永豐96購02,0.38,0.38,0.32,0.32,-0.01,-3.03,250000,3,80060,0,0,0,0,0,0,249000,0,249000,249000
20200430,05395P,旺宏元大96售06,,,,,0.00,0.00,0,0,0,0,0,0,0,0,0,0,0,0,0
20200430,053960,晶技永豐96購02,2.50,2.81,2.50,2.60,+0.10,4.0,39000,5,105100,0,0,0,0,0,0,4000,35000,-31000,-31000
20200430,053961,揚明光永豐96購04,,,,,0.00,0.00,0,0,0,0,0,0,0,0,0,0,0,0,0
20200430,053962,聯茂永豐96購01,,,,,0.00,0.00,0,0,0,0,0,0,0,0,0,0,0,0,0
20200430,053963,百和永豐96購01,0.18,0.20,0.18,0.20,-0.02,-9.09,183000,6,33400,0,0,0,0,0,0,183000,0,183000,183000
20200430,053964,上銀元大96購05,,,,,0.00,0.00,0,0,0,0,0,0,0,0,0,0,0,0,0
20200430,053965,聯電元大98購04,,,,,0.00,0.00,0,0,0,0,0,0,0,0,0,0,0,0,0
20200430,053966,旺宏元大96購08,,,,,0.00,0.00,0,0,0,0,0,0,0,0,0,0,0,0,0
20200430,053967,華邦電元大96購03,,,,,0.00,0.00,0,0,0,0,0,0,0,0,0,0,0,0,0
20200430,053968,華邦電元大97購01,,,,,0.00,0.00,0,0,0,0,0,0,0,0,0,0,0,0,0
20200430,053969,瑞昱元大97購01,0.90,0.92,0.85,0.92,+0.20,27.78,16000,4,14540,0,0,0,0,0,0,6000,0,6000,6000
20200430,05396P,台郡元大95售05,,,,,0.00,0.00,0,0,0,0,0,0,0,0,0,0,0,0,0
20200430,053970,聯發科元大97購08,2.51,2.61,2.48,2.61,+0.43,19.72,10000,3,25480,0,0,0,0,0,0,1000,10000,-9000,-9000
20200430,053971,聯發科元大97購09,0.18,0.21,0.18,0.21,+0.10,90.91,1000000,3,195000,0,0,0,0,0,0,1000000,0,1000000,1000000
20200430,053972,華新科元大96購06,,,,,0.00,0.00,0,0,0,0,0,0,0,0,0,0,0,0,0
20200430,053973,晶豪科元大96購01,2.75,2.82,2.38,2.38,-0.16,-6.3,245000,21,658420,0,0,0,0,0,0,142000,103000,39000,39000
20200430,053974,大立光元大96購10,,,,,0.00,0.00,0,0,0,0,0,0,0,0,0,0,0,0,0
20200430,053975,大立光元大98購04,0.16,0.16,0.16,0.16,0.00,0.00,10000,1,1600,0,0,0,0,0,0,10000,0,10000,10000
20200430,053976,亞光元大96購02,,,,,0.00,0.00,0,0,0,0,0,0,0,0,0,0,0,0,0
20200430,053977,新日興元大96購03,1.57,1.71,1.57,1.71,0.00,0.00,20000,2,32800,0,0,0,0,0,0,10000,10000,0,0
20200430,053978,創意元大96購05,,,,,0.00,0.00,0,0,0,0,0,0,0,0,0,0,0,0,0
20200430,053979,健策元大98購01,2.86,2.93,2.86,2.93,+0.23,8.52,22000,3,63060,0,0,0,0,0,0,22000,0,22000,22000
20200430,05397P,大立光凱基96售08,,,,,0.00,0.00,0,0,0,0,0,0,0,0,0,0,0,0,0
20200430,053980,泰鼎元大97購02,,,,,0.00,0.00,0,0,0,0,0,0,0,0,0,0,0,0,0
20200430,053981,康控元大96購05,,,,,0.00,0.00,0,0,0,0,0,0,0,0,0,0,0,0,0
20200430,053982,臻鼎元大96購05,,,,,0.00,0.00,0,0,0,0,0,0,0,0,0,0,0,0,0
20200430,053983,樺漢元大97購02,0.19,0.19,0.19,0.19,+0.04,26.67,30000,1,5700,0,0,0,0,0,0,30000,0,30000,30000
20200430,053984,康友元大96購05,0.55,0.60,0.55,0.60,0.00,0.00,477000,4,279390,0,0,0,0,0,0,0,477000,-477000,-477000
20200430,053985,矽創元大96購02,0.25,0.25,0.25,0.25,0.00,0.00,20000,1,5000,0,0,0,0,0,0,20000,0,20000,20000
20200430,053986,矽創第一96購01,,,,,0.00,0.00,0,0,0,0,0,0,0,0,0,0,0,0,0
20200430,053987,宏碁亞東96購01,,,,,0.00,0.00,0,0,0,0,0,0,0,0,0,0,0,0,0
20200430,053988,友達亞東96購01,0.05,0.05,0.05,0.05,0.00,0.00,25000,1,1250,0,0,0,0,0,0,25000,0,25000,25000
20200430,053989,奇力新兆豐97購01,,,,,0.00,0.00,0,0,0,0,0,0,0,0,0,0,0,0,0
20200430,05398P,康控國票96售03,,,,,0.00,0.00,0,0,0,0,0,0,0,0,0,0,0,0,0
20200430,053990,晶技兆豐96購01,,,,,0.00,0.00,0,0,0,0,0,0,0,0,0,0,0,0,0
20200430,053991,鴻海群益96購05,,,,,0.00,0.00,0,0,0,0,0,0,0,0,0,0,0,0,0
20200430,053992,中環群益96購01,,,,,0.00,0.00,0,0,0,0,0,0,0,0,0,0,0,0,0
20200430,053993,旺宏群益98購02,,,,,0.00,0.00,0,0,0,0,0,0,0,0,0,0,0,0,0
20200430,053994,微星群益96購01,0.78,0.78,0.78,0.78,-0.01,-1.27,30000,1,23400,0,0,0,0,0,0,0,30000,-30000,-30000
20200430,053995,奇力新群益97購02,,,,,0.00,0.00,0,0,0,0,0,0,0,0,0,0,0,0,0
20200430,053996,晶相光群益97購01,0.99,0.99,0.94,0.94,-0.11,-10.48,221000,6,216740,0,0,0,0,0,0,124000,138000,-14000,-14000
20200430,053997,健策群益97購02,2.00,2.16,1.99,2.16,+0.21,10.77,153000,14,310060,0,0,0,0,0,0,104000,50000,54000,54000
20200430,053998,泰鼎群益98購01,4.15,4.15,3.87,4.08,-0.51,-11.11,179000,10,704660,0,0,0,0,0,0,64000,165000,-101000,-101000
20200430,053999,台表科群益96購06,0.38,0.38,0.38,0.38,0.00,0.00,3000,1,1140,0,0,0,0,0,0,0,3000,-3000,-3000
20200430,05399P,GIS國票95售03,0.89,0.89,0.89,0.89,-0.10,-10.1,20000,1,17800,0,0,0,0,0,0,0,20000,-20000,-20000
20200430,054000,訊芯群益96購02,0.19,0.19,0.19,0.19,0.00,0.00,5000,1,950,0,0,0,0,0,0,5000,0,5000,5000
20200430,054001,康友群益96購02,0.50,0.53,0.50,0.53,+0.07,15.22,103000,2,53120,0,0,0,0,0,0,54000,49000,5000,5000
20200430,054002,GIS群益96購03,0.79,0.80,0.79,0.80,0.00,0.00,232000,3,185520,0,0,0,0,0,0,232000,0,232000,232000
20200430,054003,鴻海統一96購13,1.43,1.44,1.41,1.44,+0.03,2.13,121000,10,173000,0,0,0,0,0,0,63000,58000,5000,5000
20200430,054004,鴻海統一96購14,,,,,0.00,0.00,0,0,0,0,0,0,0,0,0,0,0,0,0
20200430,054005,旺宏統一97購04,,,,,0.00,0.00,0,0,0,0,0,0,0,0,0,0,0,0,0
20200430,054006,智易統一97購01,,,,,0.00,0.00,0,0,0,0,0,0,0,0,0,0,0,0,0
20200430,054007,貿聯統一96購01,0.25,0.27,0.25,0.27,+0.12,80.0,56000,6,14920,0,0,0,0,0,0,0,0,0,0
20200430,054008,大立光元富96購06,,,,,0.00,0.00,0,0,0,0,0,0,0,0,0,0,0,0,0
20200430,054009,欣興元富96購03,,,,,0.00,0.00,0,0,0,0,0,0,0,0,0,0,0,0,0
20200430,05400P,台積電永豐95售05,0.91,0.91,0.91,0.91,0.00,0.00,3000,1,2730,0,0,0,0,0,0,3000,0,3000,3000
20200430,054010,致伸元富96購01,,,,,0.00,0.00,0,0,0,0,0,0,0,0,0,0,0,0,0
20200430,054011,旺宏永豐96購05,0.04,0.04,0.04,0.04,0.00,0.00,3000,1,120,0,0,0,0,0,0,3000,0,3000,3000
20200430,054012,廣達永豐96購01,,,,,0.00,0.00,0,0,0,0,0,0,0,0,0,0,0,0,0
20200430,054013,聯發科永豐96購02,,,,,0.00,0.00,0,0,0,0,0,0,0,0,0,0,0,0,0
20200430,054014,宏達電永豐96購04,,,,,0.00,0.00,0,0,0,0,0,0,0,0,0,0,0,0,0
20200430,054015,晶豪科永豐96購03,0.26,0.31,0.26,0.26,+0.05,23.81,677000,22,188530,0,0,0,0,0,0,114000,554000,-440000,-440000
20200430,054016,嘉晶永豐96購04,0.16,0.21,0.16,0.19,+0.02,11.76,31000,4,6260,0,0,0,0,0,0,11000,20000,-9000,-9000
20200430,054017,茂林永豐96購02,0.52,0.52,0.52,0.52,+0.02,4.0,35000,1,18200,0,0,0,0,0,0,35000,0,35000,35000
20200430,054018,華新台新96購01,0.26,0.27,0.08,0.08,-0.13,-61.9,480000,10,123360,0,0,0,0,0,0,30000,450000,-420000,-420000
20200430,054019,燿華台新96購01,,,,,0.00,0.00,0,0,0,0,0,0,0,0,0,0,0,0,0
20200430,05401P,聯茂永豐95售03,,,,,0.00,0.00,0,0,0,0,0,0,0,0,0,0,0,0,0
20200430,054020,技嘉台新97購01,0.15,0.15,0.15,0.15,0.00,0.00,10000,1,1500,0,0,0,0,0,0,0,10000,-10000,-10000
20200430,054021,義隆台新96購01,0.84,1.03,0.22,0.22,-0.64,-74.42,137000,16,100470,0,0,0,0,0,0,65000,107000,-42000,-42000
20200430,054022,南亞康和96購01,,,,,0.00,0.00,0,0,0,0,0,0,0,0,0,0,0,0,0
20200430,054023,和大康和96購01,,,,,0.00,0.00,0,0,0,0,0,0,0,0,0,0,0,0,0
20200430,054024,中鋼康和96購01,,,,,0.00,0.00,0,0,0,0,0,0,0,0,0,0,0,0,0
20200430,054025,鴻海凱基96購17,0.82,0.84,0.82,0.84,+0.01,1.2,147000,6,121690,0,0,0,0,0,0,68000,79000,-11000,-11000
20200430,054026,台積電凱基97購08,0.05,0.05,0.04,0.04,0.00,0.00,219000,3,9950,0,0,0,0,0,0,200000,0,200000,200000
20200430,054027,欣興凱基96購04,0.90,0.96,0.89,0.90,+0.03,3.45,485000,20,439970,0,0,0,0,0,0,483000,2000,481000,481000
20200430,054028,臻鼎凱基96購03,,,,,0.00,0.00,0,0,0,0,0,0,0,0,0,0,0,0,0
20200430,054029,瀚宇博凱基96購02,,,,,0.00,0.00,0,0,0,0,0,0,0,0,0,0,0,0,0
20200430,05402P,台郡永豐95售02,,,,,0.00,0.00,0,0,0,0,0,0,0,0,0,0,0,0,0
20200430,054030,台苯中信98購01,,,,,0.00,0.00,0,0,0,0,0,0,0,0,0,0,0,0,0
20200430,054031,中鋼中信98購01,0.05,0.05,0.05,0.05,0.00,0.00,130000,5,6500,0,0,0,0,0,0,0,0,0,0
20200430,054032,上銀中信96購01,0.08,0.08,0.08,0.08,0.00,0.00,2000,2,160,0,0,0,0,0,0,2000,0,2000,2000
20200430,054033,欣興中信96購02,0.12,0.13,0.12,0.13,+0.01,8.33,495000,2,60150,0,0,0,0,0,0,420000,75000,345000,345000
20200430,054034,景碩中信96購01,,,,,0.00,0.00,0,0,0,0,0,0,0,0,0,0,0,0,0
20200430,054035,聯詠麥證96購01,,,,,0.00,0.00,0,0,0,0,0,0,0,0,0,0,0,0,0
20200430,054036,T50反1元大96購08,1.28,1.28,1.28,1.28,-0.16,-11.11,20000,1,25600,0,0,0,0,0,0,20000,0,20000,20000
20200430,054037,T50反1元大96購09,0.87,0.88,0.87,0.88,0.00,0.00,66000,2,57580,0,0,0,0,0,0,66000,0,66000,66000
20200430,054038,T50反1元大98購04,0.76,0.76,0.68,0.68,-0.18,-20.93,177000,37,127980,0,0,0,0,0,0,0,177000,-177000,-177000
20200430,054039,元油反元大96購08,,,,,0.00,0.00,0,0,0,0,0,0,0,0,0,0,0,0,0
20200430,05403P,台積電富邦95售08,,,,,0.00,0.00,0,0,0,0,0,0,0,0,0,0,0,0,0
20200430,054040,中石化元大9C購01,0.28,0.31,0.28,0.31,+0.05,19.23,8000,2,2330,0,0,0,0,0,0,5000,0,5000,5000
20200430,054041,鴻海元大96購22,0.65,0.65,0.65,0.65,+0.01,1.56,1000,1,650,0,0,0,0,0,0,0,1000,-1000,-1000
20200430,054042,華泰元大96購01,,,,,0.00,0.00,0,0,0,0,0,0,0,0,0,0,0,0,0
20200430,054043,漢唐元大97購01,2.12,2.14,2.09,2.09,-0.03,-1.42,100000,6,211920,0,0,0,0,0,0,100000,0,100000,100000
20200430,054044,京元電元大96購03,,,,,0.00,0.00,0,0,0,0,0,0,0,0,0,0,0,0,0
20200430,054045,奇力新元大97購03,1.77,1.93,1.74,1.80,+0.13,7.78,151000,8,273850,0,0,0,0,0,0,73000,78000,-5000,-5000
20200430,054046,義隆元大96購02,1.02,1.14,1.02,1.09,+0.11,11.22,41000,3,44870,0,0,0,0,0,0,41000,0,41000,41000
20200430,054047,富邦金元大97購01,0.25,0.25,0.25,0.25,+0.04,19.05,4000,1,1000,0,0,0,0,0,0,4000,0,4000,4000
20200430,054048,國泰金元大96購04,,,,,0.00,0.00,0,0,0,0,0,0,0,0,0,0,0,0,0
20200430,054049,亞光元大96購03,,,,,0.00,0.00,0,0,0,0,0,0,0,0,0,0,0,0,0
20200430,05404P,台積電群益95售06,,,,,0.00,0.00,0,0,0,0,0,0,0,0,0,0,0,0,0
20200430,054050,創意元大96購06,1.55,1.64,1.55,1.62,+0.03,1.89,87000,5,139200,0,0,0,0,0,0,87000,0,87000,87000
20200430,054051,貿聯元大97購03,,,,,0.00,0.00,0,0,0,0,0,0,0,0,0,0,0,0,0
20200430,054052,日月光元大96購06,0.53,0.56,0.53,0.56,+0.01,1.82,292000,3,161480,0,0,0,0,0,0,10000,282000,-272000,-272000
20200430,054053,聯茂元大96購01,2.13,2.19,2.13,2.19,-0.03,-1.35,6000,3,12930,0,0,0,0,0,0,3000,3000,0,0
20200430,054054,光磊國票97購02,,,,,0.00,0.00,0,0,0,0,0,0,0,0,0,0,0,0,0
20200430,054055,全新國票99購02,0.49,0.49,0.49,0.49,-0.02,-3.92,54000,1,26460,0,0,0,0,0,0,54000,0,54000,54000
20200430,054056,華新科國票96購02,,,,,0.00,0.00,0,0,0,0,0,0,0,0,0,0,0,0,0
20200430,054057,晶豪科國票97購01,2.10,2.21,2.10,2.15,+0.28,14.97,94000,17,201610,0,0,0,0,0,0,63000,26000,37000,37000
20200430,054058,晶豪科國票98購01,2.12,2.12,1.84,1.85,-0.04,-2.12,195000,5,367000,0,0,0,0,0,0,160000,35000,125000,125000
20200430,054059,欣興國票97購03,2.17,2.38,2.09,2.12,+0.03,1.44,595000,13,1285070,0,0,0,0,0,0,428000,167000,261000,261000
20200430,05405P,大立光群益95售04,,,,,0.00,0.00,0,0,0,0,0,0,0,0,0,0,0,0,0
20200430,054060,晶技國票97購02,,,,,0.00,0.00,0,0,0,0,0,0,0,0,0,0,0,0,0
20200430,054061,晶技國票97購03,11.00,11.60,10.70,10.70,-0.10,-0.93,128000,13,1425700,28000,0,28000,0,0,0,74000,54000,20000,48000
20200430,054062,TPK國票96購02,0.30,0.31,0.28,0.28,-0.03,-9.68,139000,11,41800,0,0,0,0,0,0,19000,120000,-101000,-101000
20200430,054063,聯茂國票97購02,,,,,0.00,0.00,0,0,0,0,0,0,0,0,0,0,0,0,0
20200430,054064,台郡國票97購04,2.74,2.85,2.64,2.85,+0.07,2.52,90000,6,243760,0,0,0,0,0,0,50000,40000,10000,10000
20200430,054065,樺漢國票97購01,1.43,1.45,1.43,1.45,+0.19,15.08,42000,2,60480,0,0,0,0,0,0,0,42000,-42000,-42000
20200430,054066,緯穎國票97購03,8.65,8.65,8.65,8.65,0.00,0.00,9000,1,77850,0,0,0,0,0,0,0,9000,-9000,-9000
20200430,054067,百和國票97購03,0.18,0.20,0.18,0.20,-0.01,-4.76,34000,3,6700,0,0,0,0,0,0,34000,0,34000,34000
20200430,054068,華通國泰96購02,,,,,0.00,0.00,0,0,0,0,0,0,0,0,0,0,0,0,0
20200430,054069,亞光國泰98購01,0.22,0.22,0.22,0.22,+0.02,10.0,10000,1,2200,0,0,0,0,0,0,10000,0,10000,10000
20200430,05406P,台光電凱基95售02,0.02,0.02,0.02,0.02,0.00,0.00,20000,1,400,0,0,0,0,0,0,20000,0,20000,20000
20200430,054070,創意國泰96購02,0.56,0.56,0.56,0.56,0.00,0.00,72000,1,40320,0,0,0,0,0,0,72000,0,72000,72000
20200430,054071,泰鼎國泰97購02,,,,,0.00,0.00,0,0,0,0,0,0,0,0,0,0,0,0,0
20200430,054072,台積電富邦98購02,0.38,0.41,0.32,0.39,+0.07,21.88,44000,7,16650,0,0,0,0,0,0,1000,0,1000,1000
20200430,054073,群創富邦96購03,0.09,0.09,0.09,0.09,0.00,0.00,40000,1,3600,0,0,0,0,0,0,0,0,0,0
20200430,054074,健策富邦98購01,0.60,0.60,0.59,0.59,+0.01,1.72,11000,2,6590,0,0,0,0,0,0,11000,0,11000,11000
20200430,054075,GIS富邦97購02,0.18,0.18,0.18,0.18,+0.01,5.88,30000,1,5400,0,0,0,0,0,0,0,30000,-30000,-30000
20200430,054076,義隆第一96購01,0.50,0.50,0.50,0.50,-0.03,-5.66,260000,4,130000,0,0,0,0,0,0,260000,0,260000,260000
20200430,054077,中石化中信98購01,0.08,0.09,0.08,0.09,+0.02,28.57,62000,5,5060,0,0,0,0,0,0,0,20000,-20000,-20000
20200430,054078,鴻海中信98購01,,,,,0.00,0.00,0,0,0,0,0,0,0,0,0,0,0,0,0
20200430,054079,鴻海中信98購02,0.22,0.23,0.22,0.22,0.00,0.00,109000,11,24730,0,0,0,0,0,0,0,0,0,0
20200430,05407P,超眾凱基95售04,,,,,0.00,0.00,0,0,0,0,0,0,0,0,0,0,0,0,0
20200430,054080,微星中信98購01,1.04,1.04,0.99,1.03,0.00,0.00,5000,5,5070,0,0,0,0,0,0,0,4000,-4000,-4000
20200430,054081,聯電元富96購01,,,,,0.00,0.00,0,0,0,0,0,0,0,0,0,0,0,0,0
20200430,054082,楠梓電元富96購01,0.64,0.64,0.62,0.64,-0.03,-4.48,154000,6,97520,0,0,0,0,0,0,154000,0,154000,154000
20200430,054083,智伸科元富96購01,,,,,0.00,0.00,0,0,0,0,0,0,0,0,0,0,0,0,0
20200430,054084,旺宏統一97購05,0.48,0.48,0.48,0.48,0.00,0.00,20000,1,9600,0,0,0,0,0,0,20000,0,20000,20000
20200430,054085,華新科統一96購04,,,,,0.00,0.00,0,0,0,0,0,0,0,0,0,0,0,0,0
20200430,054086,日月光亞東98購01,,,,,0.00,0.00,0,0,0,0,0,0,0,0,0,0,0,0,0
20200430,054087,矽創亞東96購01,,,,,0.00,0.00,0,0,0,0,0,0,0,0,0,0,0,0,0
20200430,054088,華新群益98購02,0.49,0.53,0.48,0.50,+0.06,13.64,305000,17,155380,0,0,0,0,0,0,20000,285000,-265000,-265000
20200430,054089,台積電群益96購11,0.13,0.13,0.13,0.13,0.00,0.00,10000,1,1300,0,0,0,0,0,0,10000,0,10000,10000
20200430,05408P,臺股指中信95售13,,,,,0.00,0.00,0,0,0,0,0,0,0,0,0,0,0,0,0
20200430,054090,瑞昱群益97購01,3.17,3.17,3.10,3.10,+0.33,11.91,14000,3,43820,0,0,0,0,0,0,14000,14000,0,0
20200430,054091,晶豪科群益96購01,1.79,1.87,1.58,1.58,-0.04,-2.47,476000,14,830140,0,0,0,0,0,0,417000,59000,358000,358000
20200430,054092,大立光群益97購01,,,,,0.00,0.00,0,0,0,0,0,0,0,0,0,0,0,0,0
20200430,054093,智原群益97購01,0.30,0.30,0.30,0.30,0.00,0.00,5000,1,1500,0,0,0,0,0,0,5000,0,5000,5000
20200430,054094,創意群益96購02,,,,,0.00,0.00,0,0,0,0,0,0,0,0,0,0,0,0,0
20200430,054095,同欣電群益98購03,,,,,0.00,0.00,0,0,0,0,0,0,0,0,0,0,0,0,0
20200430,054096,佳世達國票97購01,,,,,0.00,0.00,0,0,0,0,0,0,0,0,0,0,0,0,0
20200430,054097,淘帝國票97購01,0.22,0.22,0.22,0.22,0.00,0.00,3000,1,660,0,0,0,0,0,0,0,3000,-3000,-3000
20200430,054098,嘉晶國票97購04,1.56,1.66,1.56,1.66,+0.13,8.5,37000,2,59520,0,0,0,0,0,0,0,37000,-37000,-37000
20200430,054099,TPK國票98購01,,,,,0.00,0.00,0,0,0,0,0,0,0,0,0,0,0,0,0
20200430,05409P,京元電元富95售05,,,,,0.00,0.00,0,0,0,0,0,0,0,0,0,0,0,0,0
20200430,054100,致伸國票97購03,,,,,0.00,0.00,0,0,0,0,0,0,0,0,0,0,0,0,0
20200430,054101,茂林國票97購04,,,,,0.00,0.00,0,0,0,0,0,0,0,0,0,0,0,0,0
20200430,054102,百和國票97購04,0.75,0.76,0.68,0.71,-0.04,-5.33,386000,18,280200,0,0,0,0,0,0,308000,78000,230000,230000
20200430,054103,T50反1凱基99購04,2.33,2.33,2.25,2.25,-0.18,-7.41,35000,4,80350,0,0,0,0,0,0,0,35000,-35000,-35000
20200430,054104,T50反1凱基9A購02,,,,,0.00,0.00,0,0,0,0,0,0,0,0,0,0,0,0,0
20200430,054105,元油反凱基9A購01,,,,,0.00,0.00,0,0,0,0,0,0,0,0,0,0,0,0,0
20200430,054106,元油反凱基9C購01,,,,,0.00,0.00,0,0,0,0,0,0,0,0,0,0,0,0,0
20200430,054107,上銀凱基97購01,,,,,0.00,0.00,0,0,0,0,0,0,0,0,0,0,0,0,0
20200430,054108,台積電凱基96購22,,,,,0.00,0.00,0,0,0,0,0,0,0,0,0,0,0,0,0
20200430,054109,南亞科凱基96購05,0.59,0.60,0.57,0.58,-0.01,-1.69,170000,8,99200,0,0,0,0,0,0,110000,60000,50000,50000
20200430,05410P,聯發科元富95售04,,,,,0.00,0.00,0,0,0,0,0,0,0,0,0,0,0,0,0
20200430,054110,群創凱基98購09,,,,,0.00,0.00,0,0,0,0,0,0,0,0,0,0,0,0,0
20200430,054111,緯穎凱基97購01,2.91,3.31,2.91,3.31,+0.53,19.06,88000,8,268180,0,0,0,0,0,0,30000,88000,-58000,-58000
20200430,054112,台積電麥證96購02,0.03,0.12,0.03,0.12,0.00,0.00,11000,2,420,10000,0,10000,0,0,0,10000,10000,0,0
20200430,054113,奇力新台新97購01,,,,,0.00,0.00,0,0,0,0,0,0,0,0,0,0,0,0,0
20200430,054114,新光金台新97購01,,,,,0.00,0.00,0,0,0,0,0,0,0,0,0,0,0,0,0
20200430,054115,台塑康和96購01,,,,,0.00,0.00,0,0,0,0,0,0,0,0,0,0,0,0,0
20200430,054116,順德康和96購01,,,,,0.00,0.00,0,0,0,0,0,0,0,0,0,0,0,0,0
20200430,054117,宏全康和96購01,0.37,0.42,0.37,0.42,+0.05,13.51,171000,13,63720,0,0,0,0,0,0,166000,5000,161000,161000
20200430,054118,國巨永豐96購04,0.29,0.29,0.29,0.29,0.00,0.00,5000,1,1450,0,0,0,0,0,0,5000,0,5000,5000
20200430,054119,燿華永豐96購05,,,,,0.00,0.00,0,0,0,0,0,0,0,0,0,0,0,0,0
20200430,05411P,台積電國票96售08,0.50,0.50,0.46,0.46,0.00,0.00,11000,2,5460,0,0,0,0,0,0,0,11000,-11000,-11000
20200430,054120,奇力新永豐96購01,0.16,0.16,0.16,0.16,+0.02,14.29,190000,3,30400,0,0,0,0,0,0,180000,10000,170000,170000
20200430,054121,奇鋐永豐96購02,0.84,0.86,0.78,0.84,+0.09,12.0,181000,20,146020,0,0,0,0,0,0,11000,160000,-149000,-149000
20200430,054122,康友永豐96購01,,,,,0.00,0.00,0,0,0,0,0,0,0,0,0,0,0,0,0
20200430,054123,易華電永豐96購03,,,,,0.00,0.00,0,0,0,0,0,0,0,0,0,0,0,0,0
20200430,054124,達方永豐96購02,0.32,0.32,0.32,0.32,0.00,0.00,80000,2,25600,0,0,0,0,0,0,0,80000,-80000,-80000
20200430,054125,元油反元大96購09,,,,,0.00,0.00,0,0,0,0,0,0,0,0,0,0,0,0,0
20200430,054126,和大元大96購02,,,,,0.00,0.00,0,0,0,0,0,0,0,0,0,0,0,0,0
20200430,054127,台積電元大96購21,0.28,0.30,0.28,0.30,0.00,0.00,23000,2,6500,0,0,0,0,0,0,23000,0,23000,23000
20200430,054128,台積電元大97購10,0.58,0.58,0.58,0.58,+0.11,23.4,10000,1,5800,0,0,0,0,0,0,10000,0,10000,10000
20200430,054129,技嘉元大96購02,,,,,0.00,0.00,0,0,0,0,0,0,0,0,0,0,0,0,0
20200430,05412P,泰碩國票95售02,,,,,0.00,0.00,0,0,0,0,0,0,0,0,0,0,0,0,0
20200430,054130,漢唐元大97購02,1.28,1.30,1.28,1.28,+0.01,0.79,203000,8,260040,0,0,0,0,0,0,183000,20000,163000,163000
20200430,054131,南亞科元大96購04,,,,,0.00,0.00,0,0,0,0,0,0,0,0,0,0,0,0,0
20200430,054132,聯發科元大97購10,0.48,0.56,0.48,0.56,+0.16,40.0,70000,6,36950,0,0,0,0,0,0,70000,0,70000,70000
20200430,054133,奇力新元大97購04,,,,,0.00,0.00,0,0,0,0,0,0,0,0,0,0,0,0,0
20200430,054134,強茂元大96購01,1.00,1.01,0.96,0.97,0.00,0.00,423000,21,415730,0,0,0,0,0,0,265000,158000,107000,107000
20200430,054135,大立光元大97購04,1.42,1.50,1.42,1.50,+0.11,7.91,75000,6,109450,0,0,0,0,0,0,65000,10000,55000,55000
20200430,054136,亞光元大96購04,,,,,0.00,0.00,0,0,0,0,0,0,0,0,0,0,0,0,0
20200430,054137,聯詠元大97購02,,,,,0.00,0.00,0,0,0,0,0,0,0,0,0,0,0,0,0
20200430,054138,晶技元大98購02,,,,,0.00,0.00,0,0,0,0,0,0,0,0,0,0,0,0,0
20200430,054139,揚明光元大96購01,,,,,0.00,0.00,0,0,0,0,0,0,0,0,0,0,0,0,0
20200430,05413P,台郡國票96售02,,,,,0.00,0.00,0,0,0,0,0,0,0,0,0,0,0,0,0
20200430,054140,智易元大97購03,,,,,0.00,0.00,0,0,0,0,0,0,0,0,0,0,0,0,0
20200430,054141,TPK元大96購02,,,,,0.00,0.00,0,0,0,0,0,0,0,0,0,0,0,0,0
20200430,054142,致伸元大97購01,,,,,0.00,0.00,0,0,0,0,0,0,0,0,0,0,0,0,0
20200430,054143,茂林元大96購04,,,,,0.00,0.00,0,0,0,0,0,0,0,0,0,0,0,0,0
20200430,054144,康控元大97購02,,,,,0.00,0.00,0,0,0,0,0,0,0,0,0,0,0,0,0
20200430,054145,嘉聯益元大98購01,,,,,0.00,0.00,0,0,0,0,0,0,0,0,0,0,0,0,0
20200430,054146,康友元大96購06,,,,,0.00,0.00,0,0,0,0,0,0,0,0,0,0,0,0,0
20200430,054147,GIS元大96購02,0.98,1.00,0.94,0.94,0.00,0.00,448000,30,429770,0,0,0,0,0,0,380000,168000,212000,212000
20200430,054148,矽創元大96購03,0.74,0.81,0.74,0.80,0.00,0.00,845000,16,650870,0,0,0,0,0,0,780000,65000,715000,715000
20200430,054149,達方元大96購01,,,,,0.00,0.00,0,0,0,0,0,0,0,0,0,0,0,0,0
20200430,05414P,台表科國票96售02,,,,,0.00,0.00,0,0,0,0,0,0,0,0,0,0,0,0,0
20200430,054150,國巨國泰97購05,,,,,0.00,0.00,0,0,0,0,0,0,0,0,0,0,0,0,0
20200430,054151,瑞昱國泰97購01,3.80,4.18,3.65,4.11,+0.64,18.44,711000,83,2740100,0,0,0,0,0,0,495000,332000,163000,163000
20200430,054152,漢唐國泰98購02,,,,,0.00,0.00,0,0,0,0,0,0,0,0,0,0,0,0,0
20200430,054153,宏達電國泰97購01,,,,,0.00,0.00,0,0,0,0,0,0,0,0,0,0,0,0,0
20200430,054154,智易國泰97購01,0.34,0.34,0.34,0.34,-0.02,-5.56,4000,1,1360,0,0,0,0,0,0,4000,0,4000,4000
20200430,054155,美律第一96購01,0.03,0.03,0.03,0.03,0.00,0.00,10000,1,300,0,0,0,0,0,0,10000,0,10000,10000
20200430,054156,聯電亞東98購01,,,,,0.00,0.00,0,0,0,0,0,0,0,0,0,0,0,0,0
20200430,054157,國巨亞東96購01,,,,,0.00,0.00,0,0,0,0,0,0,0,0,0,0,0,0,0
20200430,054158,國巨日盛99購01,0.95,0.95,0.81,0.90,+0.12,15.38,87000,6,75690,0,0,0,0,0,0,47000,0,47000,47000
20200430,054159,T50正2凱基99購01,0.31,0.38,0.30,0.38,+0.12,46.15,766000,20,255910,0,0,0,0,0,0,706000,0,706000,706000
20200430,05415P,台積電台新95售04,,,,,0.00,0.00,0,0,0,0,0,0,0,0,0,0,0,0,0
20200430,054160,華泰凱基98購01,1.01,1.01,0.98,0.98,-0.01,-1.01,48000,7,47700,0,0,0,0,0,0,26000,22000,4000,4000
20200430,054161,友訊凱基98購01,1.69,1.73,1.68,1.73,+0.01,0.58,50000,5,84800,0,0,0,0,0,0,30000,20000,10000,10000
20200430,054162,光罩凱基98購01,0.52,0.53,0.50,0.53,+0.03,6.0,28000,3,14050,0,0,0,0,0,0,0,2000,-2000,-2000
20200430,054163,燿華凱基97購02,0.40,0.45,0.40,0.44,+0.04,10.0,288000,8,128000,0,0,0,0,0,0,13000,275000,-262000,-262000
20200430,054164,強茂凱基98購01,1.12,1.16,1.12,1.13,+0.04,3.67,223000,15,253550,0,0,0,0,0,0,29000,223000,-194000,-194000
20200430,054165,亞光凱基96購02,,,,,0.00,0.00,0,0,0,0,0,0,0,0,0,0,0,0,0
20200430,054166,日電貿凱基98購01,,,,,0.00,0.00,0,0,0,0,0,0,0,0,0,0,0,0,0
20200430,054167,揚明光凱基98購01,0.27,0.28,0.27,0.28,+0.02,7.69,54000,3,14600,0,0,0,0,0,0,54000,0,54000,54000
20200430,054168,貿聯凱基97購02,,,,,0.00,0.00,0,0,0,0,0,0,0,0,0,0,0,0,0
20200430,054169,上緯控凱基98購01,0.49,0.53,0.49,0.53,+0.07,15.22,46000,8,23670,0,0,0,0,0,0,40000,6000,34000,34000
20200430,05416P,喬山永豐95售04,,,,,0.00,0.00,0,0,0,0,0,0,0,0,0,0,0,0,0
20200430,054170,泰鼎凱基98購01,5.90,5.90,5.80,5.80,-0.20,-3.33,15000,5,87300,0,0,0,0,0,0,0,15000,-15000,-15000
20200430,054171,台郡凱基97購01,,,,,0.00,0.00,0,0,0,0,0,0,0,0,0,0,0,0,0
20200430,054172,易華電凱基98購01,,,,,0.00,0.00,0,0,0,0,0,0,0,0,0,0,0,0,0
20200430,054173,奇力新台新97購02,,,,,0.00,0.00,0,0,0,0,0,0,0,0,0,0,0,0,0
20200430,054174,宏達電台新97購01,0.02,0.02,0.02,0.02,0.00,0.00,10000,1,200,0,0,0,0,0,0,0,10000,-10000,-10000
20200430,054175,高鐵台新97購01,0.02,0.02,0.02,0.02,0.00,0.00,10000,1,200,0,0,0,0,0,0,0,10000,-10000,-10000
20200430,054176,亞光台新96購01,,,,,0.00,0.00,0,0,0,0,0,0,0,0,0,0,0,0,0
20200430,054177,牧德台新97購01,1.09,1.09,0.85,0.85,0.00,0.00,11000,2,9590,0,0,0,0,0,0,0,10000,-10000,-10000
20200430,054178,中磊台新97購01,0.71,0.71,0.71,0.71,-0.16,-18.39,10000,2,7100,0,0,0,0,0,0,0,10000,-10000,-10000
20200430,054179,上海銀台新97購01,,,,,0.00,0.00,0,0,0,0,0,0,0,0,0,0,0,0,0
20200430,05417P,燿華永豐95售07,,,,,0.00,0.00,0,0,0,0,0,0,0,0,0,0,0,0,0
20200430,054180,亞泥康和96購01,0.72,0.78,0.71,0.78,+0.07,9.86,99000,7,72140,0,0,0,0,0,0,35000,64000,-29000,-29000
20200430,054181,華新康和96購01,,,,,0.00,0.00,0,0,0,0,0,0,0,0,0,0,0,0,0
20200430,054182,台積電康和96購01,,,,,0.00,0.00,0,0,0,0,0,0,0,0,0,0,0,0,0
20200430,054183,亞光康和96購01,,,,,0.00,0.00,0,0,0,0,0,0,0,0,0,0,0,0,0
20200430,054184,A50正2永豐96購01,,,,,0.00,0.00,0,0,0,0,0,0,0,0,0,0,0,0,0
20200430,054185,喬山永豐96購02,0.27,0.28,0.27,0.28,+0.11,64.71,72000,4,19860,0,0,0,0,0,0,70000,2000,68000,68000
20200430,054186,高鐵永豐96購01,,,,,0.00,0.00,0,0,0,0,0,0,0,0,0,0,0,0,0
20200430,054187,亞光永豐96購03,,,,,0.00,0.00,0,0,0,0,0,0,0,0,0,0,0,0,0
20200430,054188,欣興永豐96購03,1.08,1.17,1.05,1.05,-0.05,-4.55,521000,34,562690,0,0,0,0,0,0,469000,52000,417000,417000
20200430,054189,貿聯永豐96購03,0.09,0.12,0.09,0.12,+0.06,100.0,6000,4,610,0,0,0,0,0,0,0,6000,-6000,-6000
20200430,05418P,瑞昱永豐95售02,,,,,0.00,0.00,0,0,0,0,0,0,0,0,0,0,0,0,0
20200430,054190,矽創永豐96購01,,,,,0.00,0.00,0,0,0,0,0,0,0,0,0,0,0,0,0
20200430,054191,香港2X中信98購01,,,,,0.00,0.00,0,0,0,0,0,0,0,0,0,0,0,0,0
20200430,054192,國巨中信98購01,,,,,0.00,0.00,0,0,0,0,0,0,0,0,0,0,0,0,0
20200430,054193,鴻海麥證96購02,,,,,0.00,0.00,0,0,0,0,0,0,0,0,0,0,0,0,0
20200430,054194,國巨麥證96購02,,,,,0.00,0.00,0,0,0,0,0,0,0,0,0,0,0,0,0
20200430,054195,亞泥國泰98購01,0.70,0.70,0.70,0.70,0.00,0.00,20000,1,14000,0,0,0,0,0,0,0,0,0,0
20200430,054196,台光電國泰97購02,0.93,1.09,0.93,1.09,0.00,0.00,69000,5,65260,0,0,0,0,0,0,9000,69000,-60000,-60000
20200430,054197,台積電永昌96購07,0.20,0.23,0.20,0.23,+0.08,53.33,10000,2,2150,0,0,0,0,0,0,0,0,0,0
20200430,054198,台積電永昌96購08,,,,,0.00,0.00,0,0,0,0,0,0,0,0,0,0,0,0,0
20200430,054199,大立光永昌96購07,,,,,0.00,0.00,0,0,0,0,0,0,0,0,0,0,0,0,0
20200430,05419P,矽力永豐95售02,,,,,0.00,0.00,0,0,0,0,0,0,0,0,0,0,0,0,0
20200430,054200,美律富邦97購02,,,,,0.00,0.00,0,0,0,0,0,0,0,0,0,0,0,0,0
20200430,054201,聯詠富邦97購02,0.30,0.32,0.25,0.28,0.00,0.00,41000,10,11170,0,0,0,0,0,0,0,39000,-39000,-39000
20200430,054202,樺漢富邦97購01,,,,,0.00,0.00,0,0,0,0,0,0,0,0,0,0,0,0,0
20200430,054203,滬深2X國票96購03,0.68,0.68,0.68,0.68,+0.04,6.25,10000,1,6800,0,0,0,0,0,0,10000,0,10000,10000
20200430,054204,元金2X國票9B購02,2.01,2.01,2.01,2.01,0.00,0.00,5000,1,10050,0,0,0,0,0,0,5000,0,5000,5000
20200430,054205,華新國票97購02,0.39,0.42,0.38,0.42,+0.07,20.0,260000,11,106010,0,0,0,0,0,0,200000,60000,140000,140000
20200430,054206,鴻海國票99購01,0.06,0.08,0.06,0.08,+0.02,33.33,120000,3,8500,0,0,0,0,0,0,0,0,0,0
20200430,054207,國巨國票98購01,,,,,0.00,0.00,0,0,0,0,0,0,0,0,0,0,0,0,0
20200430,054208,台積電國票97購07,,,,,0.00,0.00,0,0,0,0,0,0,0,0,0,0,0,0,0
20200430,054209,台積電國票97購08,,,,,0.00,0.00,0,0,0,0,0,0,0,0,0,0,0,0,0
20200430,05420P,大立光國泰97售03,,,,,0.00,0.00,0,0,0,0,0,0,0,0,0,0,0,0,0
20200430,054210,台光電國票97購03,3.99,4.06,3.99,4.06,0.00,0.00,12000,2,48160,0,0,0,0,0,0,0,12000,-12000,-12000
20200430,054211,奇鋐國票97購03,1.72,1.78,1.72,1.78,+0.11,6.59,10000,2,17260,0,0,0,0,0,0,0,10000,-10000,-10000
20200430,054212,聯詠國票97購03,0.73,0.78,0.73,0.78,+0.01,1.3,169000,5,126870,0,0,0,0,0,0,69000,100000,-31000,-31000
20200430,054213,欣興國票97購04,3.63,3.82,3.59,3.59,-0.13,-3.49,28000,7,102360,0,0,0,0,0,0,25000,3000,22000,22000
20200430,054214,京鼎國票97購02,0.40,0.46,0.40,0.46,+0.15,48.39,43000,2,19480,0,0,0,0,0,0,5000,38000,-33000,-33000
20200430,054215,創意國票97購02,3.20,3.36,3.20,3.36,+0.07,2.13,90000,4,296000,0,0,0,0,0,0,38000,52000,-14000,-14000
20200430,054216,聯茂國票97購03,8.80,8.80,8.20,8.20,-0.40,-4.65,45000,9,384600,0,0,0,0,0,0,23000,27000,-4000,-4000
20200430,054217,台表科國票97購05,0.81,0.81,0.81,0.81,-0.01,-1.22,5000,1,4050,0,0,0,0,0,0,0,5000,-5000,-5000
20200430,054218,S&P反1統一98購02,1.50,1.50,1.07,1.07,0.00,0.00,38000,6,44400,0,0,0,0,0,0,0,38000,-38000,-38000
20200430,054219,楠梓電統一97購01,,,,,0.00,0.00,0,0,0,0,0,0,0,0,0,0,0,0,0
20200430,05421P,鴻海元大96售12,,,,,0.00,0.00,0,0,0,0,0,0,0,0,0,0,0,0,0
20200430,054220,國巨統一97購02,1.00,1.00,0.90,0.90,0.00,0.00,42000,6,39950,0,0,0,0,0,0,0,0,0,0
20200430,054221,華新科統一96購05,,,,,0.00,0.00,0,0,0,0,0,0,0,0,0,0,0,0,0
20200430,054222,大立光統一98購03,,,,,0.00,0.00,0,0,0,0,0,0,0,0,0,0,0,0,0
20200430,054223,大立光統一98購04,,,,,0.00,0.00,0,0,0,0,0,0,0,0,0,0,0,0,0
20200430,054224,亞光統一98購01,0.05,0.05,0.05,0.05,0.00,0.00,50000,1,2500,0,0,0,0,0,0,50000,0,50000,50000
20200430,054225,華新元富96購01,,,,,0.00,0.00,0,0,0,0,0,0,0,0,0,0,0,0,0
20200430,054226,燿華元富96購02,,,,,0.00,0.00,0,0,0,0,0,0,0,0,0,0,0,0,0
20200430,054227,宏達電元富96購02,,,,,0.00,0.00,0,0,0,0,0,0,0,0,0,0,0,0,0
20200430,054228,貿聯元富96購03,,,,,0.00,0.00,0,0,0,0,0,0,0,0,0,0,0,0,0
20200430,054229,超眾元富96購05,1.73,1.90,1.73,1.81,+0.10,5.85,67000,8,124310,0,0,0,0,0,0,5000,67000,-62000,-62000
20200430,05422P,大立光中信97售02,0.49,0.49,0.45,0.45,0.00,0.00,18000,2,8700,0,0,0,0,0,0,18000,0,18000,18000
20200430,054230,上銀群益96購03,,,,,0.00,0.00,0,0,0,0,0,0,0,0,0,0,0,0,0
20200430,054231,國巨群益98購03,9.10,9.50,8.85,9.10,+0.35,4.0,33000,31,303000,0,0,0,0,0,0,33000,33000,0,0
20200430,054232,台積電群益96購12,0.05,0.05,0.05,0.05,+0.01,25.0,20000,2,1000,0,0,0,0,0,0,20000,0,20000,20000
20200430,054233,聯發科群益96購04,0.05,0.05,0.05,0.05,+0.02,66.67,400000,1,20000,0,0,0,0,0,0,400000,0,400000,400000
20200430,054234,可成群益96購05,,,,,0.00,0.00,0,0,0,0,0,0,0,0,0,0,0,0,0
20200430,054235,欣興群益96購06,3.27,3.38,3.27,3.30,-0.08,-2.37,123000,8,404800,0,0,0,0,0,0,123000,3000,120000,120000
20200430,054236,貿聯群益96購01,,,,,0.00,0.00,0,0,0,0,0,0,0,0,0,0,0,0,0
20200430,054237,茂林群益97購01,,,,,0.00,0.00,0,0,0,0,0,0,0,0,0,0,0,0,0
20200430,054238,聯茂群益96購04,,,,,0.00,0.00,0,0,0,0,0,0,0,0,0,0,0,0,0
20200430,054239,台郡群益96購02,1.03,1.13,0.99,1.13,+0.09,8.65,469000,12,478890,0,0,0,0,0,0,100000,369000,-269000,-269000
20200430,05423P,聯電亞東95售02,,,,,0.00,0.00,0,0,0,0,0,0,0,0,0,0,0,0,0
20200430,054240,訊芯群益96購03,0.37,0.44,0.37,0.44,+0.04,10.0,202000,4,77540,0,0,0,0,0,0,77000,125000,-48000,-48000
20200430,054241,深中小元大98購01,0.88,0.88,0.88,0.88,0.00,0.00,40000,4,35200,0,0,0,0,0,0,0,40000,-40000,-40000
20200430,054242,元油反元大98購02,,,,,0.00,0.00,0,0,0,0,0,0,0,0,0,0,0,0,0
20200430,054243,國喬元大96購01,,,,,0.00,0.00,0,0,0,0,0,0,0,0,0,0,0,0,0
20200430,054244,華新元大96購01,0.52,0.56,0.51,0.55,+0.10,22.22,221000,6,119990,0,0,0,0,0,0,85000,221000,-136000,-136000
20200430,054245,鴻海元大96購23,0.45,0.48,0.44,0.48,+0.04,9.09,168000,7,75410,0,0,0,0,0,0,88000,80000,8000,8000
20200430,054246,國巨元大96購12,1.30,1.30,1.30,1.30,0.00,0.00,9000,1,11700,0,0,0,0,0,0,9000,0,9000,9000
20200430,054247,華邦電元大96購04,,,,,0.00,0.00,0,0,0,0,0,0,0,0,0,0,0,0,0
20200430,054248,燿華元大97購02,,,,,0.00,0.00,0,0,0,0,0,0,0,0,0,0,0,0,0
20200430,054249,技嘉元大96購03,,,,,0.00,0.00,0,0,0,0,0,0,0,0,0,0,0,0,0
20200430,05424P,台達電亞東96售02,0.61,0.61,0.57,0.57,-0.09,-13.64,20000,2,11800,0,0,0,0,0,0,0,20000,-20000,-20000
20200430,054250,漢唐元大96購04,1.04,1.04,1.03,1.03,+0.03,3.0,169000,5,174270,0,0,0,0,0,0,120000,49000,71000,71000
20200430,054251,聯發科元大96購21,,,,,0.00,0.00,0,0,0,0,0,0,0,0,0,0,0,0,0
20200430,054252,奇力新元大96購04,1.40,1.43,1.37,1.43,+0.03,2.14,43000,3,60590,0,0,0,0,0,0,43000,0,43000,43000
20200430,054253,宏達電元大97購03,0.66,0.66,0.66,0.66,-0.04,-5.71,20000,1,13200,0,0,0,0,0,0,0,20000,-20000,-20000
20200430,054254,晶豪科元大96購02,1.23,1.23,1.23,1.23,+0.08,6.96,5000,1,6150,0,0,0,0,0,0,5000,0,5000,5000
20200430,054255,亞光元大96購05,,,,,0.00,0.00,0,0,0,0,0,0,0,0,0,0,0,0,0
20200430,054256,創意元大96購07,,,,,0.00,0.00,0,0,0,0,0,0,0,0,0,0,0,0,0
20200430,054257,揚明光元大96購02,,,,,0.00,0.00,0,0,0,0,0,0,0,0,0,0,0,0,0
20200430,054258,牧德元大97購01,3.30,3.53,3.22,3.44,+0.33,10.61,258000,25,864370,20000,0,20000,0,0,0,62000,199000,-137000,-117000
20200430,054259,健策元大97購03,,,,,0.00,0.00,0,0,0,0,0,0,0,0,0,0,0,0,0
20200430,05425P,華邦電亞東96售02,,,,,0.00,0.00,0,0,0,0,0,0,0,0,0,0,0,0,0
20200430,054260,貿聯元大96購03,1.06,1.10,1.06,1.10,+0.11,11.11,59000,3,63520,0,0,0,0,0,0,30000,29000,1000,1000
20200430,054261,智伸科元大96購03,0.50,0.50,0.50,0.50,0.00,0.00,68000,1,34000,0,0,0,0,0,0,0,68000,-68000,-68000
20200430,054262,瀚宇博元大96購03,,,,,0.00,0.00,0,0,0,0,0,0,0,0,0,0,0,0,0
20200430,054263,聯茂元大96購02,2.94,2.94,2.94,2.94,-0.09,-2.97,50000,2,147000,0,0,0,0,0,0,50000,0,50000,50000
20200430,054264,超眾元大97購02,,,,,0.00,0.00,0,0,0,0,0,0,0,0,0,0,0,0,0
20200430,054265,GIS元大96購03,0.91,0.92,0.87,0.88,-0.01,-1.12,533000,44,475920,0,0,0,0,0,0,498000,286000,212000,212000
20200430,054266,緯穎元大96購07,3.46,3.46,3.46,3.46,+0.34,10.9,10000,1,34600,0,0,0,0,0,0,10000,0,10000,10000
20200430,054267,上銀第一96購01,,,,,0.00,0.00,0,0,0,0,0,0,0,0,0,0,0,0,0
20200430,054268,健策第一96購01,,,,,0.00,0.00,0,0,0,0,0,0,0,0,0,0,0,0,0
20200430,054269,台光電亞東98購01,,,,,0.00,0.00,0,0,0,0,0,0,0,0,0,0,0,0,0
20200430,05426P,聯發科凱基95售12,2.21,2.21,2.21,2.21,0.00,0.00,1000,1,2210,0,0,0,0,0,0,0,1000,-1000,-1000
20200430,054270,寶滬深中信98購01,,,,,0.00,0.00,0,0,0,0,0,0,0,0,0,0,0,0,0
20200430,054271,中石化中信99購01,0.15,0.17,0.15,0.17,+0.03,21.43,25000,7,4220,0,0,0,0,0,0,5000,20000,-15000,-15000
20200430,054272,華通中信98購01,0.33,0.35,0.33,0.35,0.00,0.00,160000,4,53800,0,0,0,0,0,0,160000,0,160000,160000
20200430,054273,宏達電中信98購01,,,,,0.00,0.00,0,0,0,0,0,0,0,0,0,0,0,0,0
20200430,054274,智易中信96購02,0.67,0.67,0.65,0.65,-0.08,-10.96,30000,3,19620,0,0,0,0,0,0,30000,0,30000,30000
20200430,054275,華通群益97購03,,,,,0.00,0.00,0,0,0,0,0,0,0,0,0,0,0,0,0
20200430,054276,國巨群益96購07,,,,,0.00,0.00,0,0,0,0,0,0,0,0,0,0,0,0,0
20200430,054277,亞光群益97購01,0.24,0.24,0.24,0.24,0.00,0.00,1000,1,240,0,0,0,0,0,0,0,1000,-1000,-1000
20200430,054278,晶技群益97購02,,,,,0.00,0.00,0,0,0,0,0,0,0,0,0,0,0,0,0
20200430,054279,揚明光群益98購01,0.22,0.22,0.22,0.22,-0.02,-8.33,40000,1,8800,0,0,0,0,0,0,40000,0,40000,40000
20200430,05427P,聯發科凱基96售07,3.58,3.60,3.41,3.41,-0.55,-13.89,18000,7,63420,0,0,0,0,0,0,10000,8000,2000,2000
20200430,054280,牧德群益98購01,,,,,0.00,0.00,0,0,0,0,0,0,0,0,0,0,0,0,0
20200430,054281,世芯群益97購01,3.86,3.86,3.86,3.86,+0.46,13.53,1000,1,3860,0,0,0,0,0,0,1000,0,1000,1000
20200430,054282,泰鼎群益98購02,1.49,1.49,1.49,1.49,0.00,0.00,10000,1,14900,0,0,0,0,0,0,0,10000,-10000,-10000
20200430,054283,元油反元大99購02,,,,,0.00,0.00,0,0,0,0,0,0,0,0,0,0,0,0,0
20200430,054284,和大元大96購03,,,,,0.00,0.00,0,0,0,0,0,0,0,0,0,0,0,0,0
20200430,054285,國巨元大98購02,,,,,0.00,0.00,0,0,0,0,0,0,0,0,0,0,0,0,0
20200430,054286,台積電元大96購22,,,,,0.00,0.00,0,0,0,0,0,0,0,0,0,0,0,0,0
20200430,054287,台積電元大97購11,,,,,0.00,0.00,0,0,0,0,0,0,0,0,0,0,0,0,0
20200430,054288,華邦電元大96購05,,,,,0.00,0.00,0,0,0,0,0,0,0,0,0,0,0,0,0
20200430,054289,聯發科元大97購11,0.50,0.50,0.50,0.50,+0.18,56.25,2000,1,1000,0,0,0,0,0,0,2000,0,2000,2000
20200430,05428P,滬深2X統一95售01,,,,,0.00,0.00,0,0,0,0,0,0,0,0,0,0,0,0,0
20200430,054290,奇力新元大96購05,,,,,0.00,0.00,0,0,0,0,0,0,0,0,0,0,0,0,0
20200430,054291,高鐵元大97購01,,,,,0.00,0.00,0,0,0,0,0,0,0,0,0,0,0,0,0
20200430,054292,欣興元大96購06,1.33,1.44,1.33,1.44,+0.16,12.5,6000,2,8530,0,0,0,0,0,0,1000,5000,-4000,-4000
20200430,054293,健策元大98購02,,,,,0.00,0.00,0,0,0,0,0,0,0,0,0,0,0,0,0
20200430,054294,世芯元大96購02,3.17,3.46,3.17,3.41,+0.79,30.15,44000,5,149590,0,0,0,0,0,0,44000,40000,4000,4000
20200430,054295,世芯元大96購03,2.94,2.94,2.91,2.91,+0.55,23.31,11000,2,32040,0,0,0,0,0,0,11000,0,11000,11000
20200430,054296,世芯元大97購01,3.97,3.97,3.97,3.97,0.00,0.00,160000,1,635200,0,0,0,0,0,0,160000,160000,0,0
20200430,054297,台郡元大98購01,1.12,1.12,1.12,1.12,0.00,0.00,10000,1,11200,0,0,0,0,0,0,10000,0,10000,10000
20200430,054298,台表科元大97購03,1.32,1.32,1.30,1.32,-0.04,-2.94,70000,3,91040,0,0,0,0,0,0,70000,2000,68000,68000
20200430,054299,南電元大96購03,,,,,0.00,0.00,0,0,0,0,0,0,0,0,0,0,0,0,0
20200430,05429P,鴻海統一95售16,,,,,0.00,0.00,0,0,0,0,0,0,0,0,0,0,0,0,0
20200430,054300,華通凱基96購07,1.58,1.84,1.58,1.84,+0.30,19.48,150000,9,251920,0,0,0,0,0,0,73000,77000,-4000,-4000
20200430,054301,楠梓電凱基98購01,,,,,0.00,0.00,0,0,0,0,0,0,0,0,0,0,0,0,0
20200430,054302,鴻海凱基96購18,1.03,1.04,1.03,1.04,+0.02,1.96,53000,2,54940,0,0,0,0,0,0,18000,35000,-17000,-17000
20200430,054303,國巨凱基96購15,1.05,1.05,1.05,1.05,0.00,0.00,14000,2,14700,0,0,0,0,0,0,0,0,0,0
20200430,054304,台積電凱基96購23,1.16,1.19,1.16,1.19,+0.12,11.21,470000,5,545630,0,0,0,0,0,0,459000,11000,448000,448000
20200430,054305,光磊凱基98購01,,,,,0.00,0.00,0,0,0,0,0,0,0,0,0,0,0,0,0
20200430,054306,聯發科凱基96購23,2.41,2.52,2.41,2.52,+0.40,18.87,37000,3,90940,0,0,0,0,0,0,20000,17000,3000,3000
20200430,054307,高鐵凱基98購01,,,,,0.00,0.00,0,0,0,0,0,0,0,0,0,0,0,0,0
20200430,054308,嘉晶凱基98購01,,,,,0.00,0.00,0,0,0,0,0,0,0,0,0,0,0,0,0
20200430,054309,禾伸堂凱基98購01,,,,,0.00,0.00,0,0,0,0,0,0,0,0,0,0,0,0,0
20200430,05430P,台積電統一95售07,1.91,1.91,1.91,1.91,-0.28,-12.79,4000,1,7640,0,0,0,0,0,0,4000,0,4000,4000
20200430,054310,牧德凱基98購01,,,,,0.00,0.00,0,0,0,0,0,0,0,0,0,0,0,0,0
20200430,054311,世芯凱基96購02,2.28,2.68,2.23,2.60,+0.53,25.6,326000,33,801330,0,0,0,0,0,0,81000,266000,-185000,-185000
20200430,054312,TPK凱基98購01,,,,,0.00,0.00,0,0,0,0,0,0,0,0,0,0,0,0,0
20200430,054313,麗豐凱基96購02,,,,,0.00,0.00,0,0,0,0,0,0,0,0,0,0,0,0,0
20200430,054314,嘉聯益凱基97購01,,,,,0.00,0.00,0,0,0,0,0,0,0,0,0,0,0,0,0
20200430,054315,訊芯凱基98購01,0.31,0.31,0.31,0.31,-0.02,-6.06,1000,1,310,0,0,0,0,0,0,1000,0,1000,1000
20200430,054316,矽創凱基97購01,0.93,0.98,0.89,0.98,+0.18,22.5,136000,8,128300,0,0,0,0,0,0,28000,108000,-80000,-80000
20200430,054317,昇陽半凱基98購01,,,,,0.00,0.00,0,0,0,0,0,0,0,0,0,0,0,0,0
20200430,054318,台虹凱基98購01,,,,,0.00,0.00,0,0,0,0,0,0,0,0,0,0,0,0,0
20200430,054319,世紀鋼凱基96購02,0.76,0.89,0.76,0.88,+0.07,8.64,210000,26,183040,0,0,0,0,0,0,10000,200000,-190000,-190000
20200430,05431P,台光電統一97售01,0.66,0.66,0.66,0.66,-0.04,-5.71,4000,1,2640,0,0,0,0,0,0,4000,0,4000,4000
20200430,054320,國喬台新96購01,0.05,0.05,0.05,0.05,0.00,0.00,10000,1,500,0,0,0,0,0,0,0,10000,-10000,-10000
20200430,054321,上銀台新96購01,0.04,0.04,0.04,0.04,0.00,0.00,10000,1,400,0,0,0,0,0,0,0,10000,-10000,-10000
20200430,054322,國巨台新96購02,,,,,0.00,0.00,0,0,0,0,0,0,0,0,0,0,0,0,0
20200430,054323,旺宏台新96購02,0.99,1.01,0.20,0.20,-0.60,-75.0,431000,28,388350,0,0,0,0,0,0,210000,221000,-11000,-11000
20200430,054324,美律台新97購01,,,,,0.00,0.00,0,0,0,0,0,0,0,0,0,0,0,0,0
20200430,054325,奇力新台新97購03,,,,,0.00,0.00,0,0,0,0,0,0,0,0,0,0,0,0,0
20200430,054326,宏達電台新97購02,0.02,0.02,0.02,0.02,0.00,0.00,10000,1,200,0,0,0,0,0,0,0,10000,-10000,-10000
20200430,054327,亞光台新96購02,0.01,0.01,0.01,0.01,0.00,0.00,10000,1,100,0,0,0,0,0,0,0,10000,-10000,-10000
20200430,054328,台化康和96購01,,,,,0.00,0.00,0,0,0,0,0,0,0,0,0,0,0,0,0
20200430,054329,華新科永豐96購02,,,,,0.00,0.00,0,0,0,0,0,0,0,0,0,0,0,0,0
20200430,05432P,國巨元富95售07,,,,,0.00,0.00,0,0,0,0,0,0,0,0,0,0,0,0,0
20200430,054330,世芯永豐96購02,1.11,1.25,1.11,1.25,0.00,0.00,30000,3,35100,0,0,0,0,0,0,20000,10000,10000,10000
20200430,054331,世芯永豐96購03,1.65,1.93,1.65,1.93,+0.46,31.29,87000,12,157280,0,0,0,0,0,0,19000,70000,-51000,-51000
20200430,054332,世芯永豐97購01,1.59,1.68,1.59,1.68,+0.43,34.4,22000,4,35970,0,0,0,0,0,0,2000,20000,-18000,-18000
20200430,054333,茂林永豐96購03,0.27,0.27,0.27,0.27,-0.08,-22.86,9000,2,2430,0,0,0,0,0,0,9000,0,9000,9000
20200430,054334,超眾永豐96購04,0.15,0.18,0.15,0.18,+0.03,20.0,91000,3,14550,0,0,0,0,0,0,91000,0,91000,91000
20200430,054335,緯穎永豐96購02,0.68,1.08,0.68,1.04,+0.43,70.49,145000,14,129360,0,0,0,0,0,0,89000,56000,33000,33000
20200430,054336,台積電統一96購11,0.25,0.26,0.25,0.26,+0.05,23.81,120000,12,30900,0,0,0,0,0,0,120000,120000,0,0
20200430,054337,智邦統一96購01,6.40,6.40,6.40,6.40,0.00,0.00,2000,1,12800,0,0,0,0,0,0,2000,0,2000,2000
20200430,054338,全新統一96購01,,,,,0.00,0.00,0,0,0,0,0,0,0,0,0,0,0,0,0
20200430,054339,聯詠統一96購02,0.55,0.56,0.55,0.55,-0.03,-5.17,130000,6,72390,0,0,0,0,0,0,108000,22000,86000,86000
20200430,05433P,智原元富95售02,,,,,0.00,0.00,0,0,0,0,0,0,0,0,0,0,0,0,0
20200430,054340,大成鋼元富96購01,0.16,0.16,0.16,0.16,0.00,0.00,50000,1,8000,0,0,0,0,0,0,50000,0,50000,50000
20200430,054341,燿華元富96購03,,,,,0.00,0.00,0,0,0,0,0,0,0,0,0,0,0,0,0
20200430,054342,亞光元富99購01,,,,,0.00,0.00,0,0,0,0,0,0,0,0,0,0,0,0,0
20200430,054343,世紀鋼元富96購02,1.60,1.80,1.57,1.76,+0.21,13.55,331000,22,556480,0,0,0,0,0,0,66000,265000,-199000,-199000
20200430,054344,景碩國票97購04,0.29,0.38,0.29,0.38,0.00,0.00,101000,2,29380,0,0,0,0,0,0,100000,1000,99000,99000
20200430,054345,世芯國票96購02,2.40,2.40,2.40,2.40,0.00,0.00,1000,1,2400,0,0,0,0,0,0,1000,0,1000,1000
20200430,054346,世芯國票97購01,,,,,0.00,0.00,0,0,0,0,0,0,0,0,0,0,0,0,0
20200430,054347,上緯控國票96購02,,,,,0.00,0.00,0,0,0,0,0,0,0,0,0,0,0,0,0
20200430,054348,康控國票97購03,,,,,0.00,0.00,0,0,0,0,0,0,0,0,0,0,0,0,0
20200430,054349,同欣電國票97購02,0.35,0.51,0.35,0.51,+0.18,54.55,649000,27,282890,0,0,0,0,0,0,282000,366000,-84000,-84000
20200430,05434P,世紀鋼元富95售02,,,,,0.00,0.00,0,0,0,0,0,0,0,0,0,0,0,0,0
20200430,054350,美律國泰98購01,,,,,0.00,0.00,0,0,0,0,0,0,0,0,0,0,0,0,0
20200430,054351,華新科國泰97購03,3.28,3.33,3.12,3.14,+0.02,0.64,40000,5,127970,0,0,0,0,0,0,15000,25000,-10000,-10000
20200430,054352,世芯國泰98購01,10.50,12.40,10.50,12.30,+2.30,23.0,218000,88,2555600,0,0,0,0,0,0,108000,165000,-57000,-57000
20200430,054353,世紀鋼國泰98購01,,,,,0.00,0.00,0,0,0,0,0,0,0,0,0,0,0,0,0
20200430,054354,技嘉富邦97購01,0.64,0.64,0.62,0.62,+0.02,3.33,218000,5,136340,0,0,0,0,0,0,98000,120000,-22000,-22000
20200430,054355,上海銀富邦98購01,0.11,0.11,0.11,0.11,0.00,0.00,20000,3,2200,0,0,0,0,0,0,0,7000,-7000,-7000
20200430,054356,可成兆豐97購01,1.31,1.31,1.31,1.31,-0.10,-7.09,16000,1,20960,0,0,0,0,0,0,16000,0,16000,16000
20200430,054357,可成兆豐97購02,,,,,0.00,0.00,0,0,0,0,0,0,0,0,0,0,0,0,0
20200430,054358,矽創兆豐96購01,0.60,0.62,0.59,0.62,+0.08,14.81,103000,8,62030,0,0,0,0,0,0,74000,29000,45000,45000
20200430,054359,南亞科日盛96購02,,,,,0.00,0.00,0,0,0,0,0,0,0,0,0,0,0,0,0
20200430,05435P,鴻海群益95售12,,,,,0.00,0.00,0,0,0,0,0,0,0,0,0,0,0,0,0
20200430,054360,智邦凱基96購03,,,,,0.00,0.00,0,0,0,0,0,0,0,0,0,0,0,0,0
20200430,054361,技嘉凱基96購01,,,,,0.00,0.00,0,0,0,0,0,0,0,0,0,0,0,0,0
20200430,054362,亞光凱基96購03,,,,,0.00,0.00,0,0,0,0,0,0,0,0,0,0,0,0,0
20200430,054363,世芯凱基97購01,6.50,6.95,6.50,6.70,+1.05,18.58,22000,5,148500,0,0,0,0,0,0,5000,17000,-12000,-12000
20200430,054364,智伸科凱基96購01,,,,,0.00,0.00,0,0,0,0,0,0,0,0,0,0,0,0,0
20200430,054365,遠東新中信96購01,,,,,0.00,0.00,0,0,0,0,0,0,0,0,0,0,0,0,0
20200430,054366,和大中信98購01,0.07,0.10,0.07,0.10,+0.06,150.0,410000,7,33800,0,0,0,0,0,0,310000,0,310000,310000
20200430,054367,鴻海中信98購03,,,,,0.00,0.00,0,0,0,0,0,0,0,0,0,0,0,0,0
20200430,054368,鴻海中信9A購02,0.04,0.04,0.04,0.04,0.00,0.00,1000,1,40,0,0,0,0,0,0,0,0,0,0
20200430,054369,鴻海中信9C購01,0.18,0.24,0.17,0.24,+0.07,41.18,805000,38,151640,0,0,0,0,0,0,0,0,0,0
20200430,05436P,台積電群益95售07,,,,,0.00,0.00,0,0,0,0,0,0,0,0,0,0,0,0,0
20200430,054370,台積電中信9A購01,,,,,0.00,0.00,0,0,0,0,0,0,0,0,0,0,0,0,0
20200430,054371,台積電中信9C購01,0.75,0.76,0.75,0.75,0.00,0.00,10000,4,7550,0,0,0,0,0,0,0,0,0,0
20200430,054372,南亞科中信96購01,,,,,0.00,0.00,0,0,0,0,0,0,0,0,0,0,0,0,0
20200430,054373,富邦金中信97購01,0.62,0.69,0.62,0.69,+0.20,40.82,125000,7,81610,0,0,0,0,0,0,35000,90000,-55000,-55000
20200430,054374,信邦中信96購01,0.73,0.73,0.62,0.66,-0.06,-8.33,575000,24,392860,0,0,0,0,0,0,413000,161000,252000,252000
20200430,054375,貿聯中信99購01,,,,,0.00,0.00,0,0,0,0,0,0,0,0,0,0,0,0,0
20200430,054376,聯茂中信97購01,0.69,0.69,0.64,0.64,-0.07,-9.86,67000,19,45160,0,0,0,0,0,0,52000,15000,37000,37000
20200430,054377,臺股指中信99購09,0.16,0.16,0.13,0.16,+0.01,6.67,3766000,78,533210,0,0,0,0,0,0,2220000,0,2220000,2220000
20200430,054378,楠梓電群益98購01,1.86,1.90,1.85,1.86,-0.01,-0.53,288000,6,539760,0,0,0,0,0,0,169000,119000,50000,50000
20200430,054379,光磊群益98購01,,,,,0.00,0.00,0,0,0,0,0,0,0,0,0,0,0,0,0
20200430,05437P,聯詠永豐95售02,,,,,0.00,0.00,0,0,0,0,0,0,0,0,0,0,0,0,0
20200430,054380,世芯群益97購02,5.10,5.10,5.10,5.10,+1.08,26.87,10000,1,51000,0,0,0,0,0,0,10000,0,10000,10000
20200430,054381,世芯群益98購01,4.31,5.05,4.31,4.94,+0.80,19.32,192000,21,925380,0,0,0,0,0,0,148000,109000,39000,39000
20200430,054382,康控群益96購03,,,,,0.00,0.00,0,0,0,0,0,0,0,0,0,0,0,0,0
20200430,054383,傳奇群益97購01,0.32,0.32,0.25,0.27,+0.01,3.85,130000,11,37800,0,0,0,0,0,0,110000,20000,90000,90000
20200430,054384,瀚宇博群益96購02,1.63,1.63,1.63,1.63,+0.07,4.49,21000,3,34230,0,0,0,0,0,0,2000,21000,-19000,-19000
20200430,054385,矽創群益98購01,0.69,0.70,0.69,0.70,+0.06,9.38,8000,2,5550,0,0,0,0,0,0,8000,0,8000,8000
20200430,054386,鴻海統一98購03,,,,,0.00,0.00,0,0,0,0,0,0,0,0,0,0,0,0,0
20200430,054387,台積電統一98購02,0.40,0.40,0.40,0.40,0.00,0.00,20000,2,8000,0,0,0,0,0,0,10000,0,10000,10000
20200430,054388,漢唐統一97購02,,,,,0.00,0.00,0,0,0,0,0,0,0,0,0,0,0,0,0
20200430,054389,為升元富96購02,,,,,0.00,0.00,0,0,0,0,0,0,0,0,0,0,0,0,0
20200430,05438P,康控永豐95售05,,,,,0.00,0.00,0,0,0,0,0,0,0,0,0,0,0,0,0
20200430,054390,智邦元富96購03,,,,,0.00,0.00,0,0,0,0,0,0,0,0,0,0,0,0,0
20200430,054391,宏達電元富96購04,,,,,0.00,0.00,0,0,0,0,0,0,0,0,0,0,0,0,0
20200430,054392,華通永豐96購05,,,,,0.00,0.00,0,0,0,0,0,0,0,0,0,0,0,0,0
20200430,054393,漢唐永豐96購01,0.35,0.35,0.33,0.33,-0.03,-8.33,140000,2,47000,0,0,0,0,0,0,100000,40000,60000,60000
20200430,054394,奇力新永豐96購03,,,,,0.00,0.00,0,0,0,0,0,0,0,0,0,0,0,0,0
20200430,054395,華新科永豐96購03,,,,,0.00,0.00,0,0,0,0,0,0,0,0,0,0,0,0,0
20200430,054396,日電貿永豐96購02,0.06,0.06,0.06,0.06,0.00,0.00,30000,3,1800,0,0,0,0,0,0,0,30000,-30000,-30000
20200430,054397,創意永豐96購05,,,,,0.00,0.00,0,0,0,0,0,0,0,0,0,0,0,0,0
20200430,054398,牧德永豐96購03,0.11,0.11,0.11,0.11,0.00,0.00,15000,1,1650,0,0,0,0,0,0,15000,0,15000,15000
20200430,054399,智易永豐96購03,,,,,0.00,0.00,0,0,0,0,0,0,0,0,0,0,0,0,0
20200430,05439P,聯發科國票95售06,0.83,0.84,0.78,0.78,-0.48,-38.1,108000,8,85350,0,0,0,0,0,0,108000,85000,23000,23000
20200430,054400,健策永豐96購02,0.08,0.10,0.08,0.10,+0.03,42.86,244000,7,21250,0,0,0,0,0,0,240000,0,240000,240000
20200430,054401,康普永豐96購01,,,,,0.00,0.00,0,0,0,0,0,0,0,0,0,0,0,0,0
20200430,054402,康控永豐96購03,,,,,0.00,0.00,0,0,0,0,0,0,0,0,0,0,0,0,0
20200430,054403,同欣電永豐96購02,,,,,0.00,0.00,0,0,0,0,0,0,0,0,0,0,0,0,0
20200430,054404,新日興康和96購01,,,,,0.00,0.00,0,0,0,0,0,0,0,0,0,0,0,0,0
20200430,054405,樺漢康和96購01,0.70,0.71,0.70,0.71,-0.02,-2.74,105000,2,74140,0,0,0,0,0,0,105000,0,105000,105000
20200430,054406,旺宏國票98購01,2.21,2.21,2.21,2.21,+0.45,25.57,11000,1,24310,0,0,0,0,0,0,11000,0,11000,11000
20200430,054407,美律國票97購02,,,,,0.00,0.00,0,0,0,0,0,0,0,0,0,0,0,0,0
20200430,054408,義隆國票98購01,2.08,2.30,2.08,2.30,+0.24,11.65,22000,3,49420,0,0,0,0,0,0,0,22000,-22000,-22000
20200430,054409,亞光國票97購02,,,,,0.00,0.00,0,0,0,0,0,0,0,0,0,0,0,0,0
20200430,05440P,緯穎國票96售02,0.21,0.21,0.17,0.17,-0.07,-29.17,800000,10,151610,0,0,0,0,0,0,292000,508000,-216000,-216000
20200430,054410,國巨元大96購14,,,,,0.00,0.00,0,0,0,0,0,0,0,0,0,0,0,0,0
20200430,054411,光磊元大97購02,,,,,0.00,0.00,0,0,0,0,0,0,0,0,0,0,0,0,0
20200430,054412,智邦元大96購03,,,,,0.00,0.00,0,0,0,0,0,0,0,0,0,0,0,0,0
20200430,054413,台光電元大96購03,,,,,0.00,0.00,0,0,0,0,0,0,0,0,0,0,0,0,0
20200430,054414,全新元大97購02,,,,,0.00,0.00,0,0,0,0,0,0,0,0,0,0,0,0,0
20200430,054415,奇力新元大96購06,0.09,0.09,0.09,0.09,+0.02,28.57,1000,1,90,0,0,0,0,0,0,1000,0,1000,1000
20200430,054416,禾伸堂元大97購01,4.75,4.75,4.68,4.68,+0.22,4.93,40000,3,189300,0,0,0,0,0,0,40000,0,40000,40000
20200430,054417,牧德元大96購01,,,,,0.00,0.00,0,0,0,0,0,0,0,0,0,0,0,0,0
20200430,054418,茂林元大97購01,3.04,3.04,3.04,3.04,-0.16,-5.0,50000,1,152000,0,0,0,0,0,0,0,50000,-50000,-50000
20200430,054419,嘉聯益元大98購02,,,,,0.00,0.00,0,0,0,0,0,0,0,0,0,0,0,0,0
20200430,05441P,華通元大95售09,2.58,2.58,2.58,2.58,0.00,0.00,10000,1,25800,0,0,0,0,0,0,0,10000,-10000,-10000
20200430,054420,緯穎元大96購08,4.20,5.25,4.09,5.25,+1.42,37.08,89000,14,388470,0,0,0,0,0,0,43000,57000,-14000,-14000
20200430,054421,臺股指元大99購03,,,,,0.00,0.00,0,0,0,0,0,0,0,0,0,0,0,0,0
20200430,054422,T50反1富邦9A購01,,,,,0.00,0.00,0,0,0,0,0,0,0,0,0,0,0,0,0
20200430,054423,華新富邦96購01,,,,,0.00,0.00,0,0,0,0,0,0,0,0,0,0,0,0,0
20200430,054424,大成鋼富邦97購02,,,,,0.00,0.00,0,0,0,0,0,0,0,0,0,0,0,0,0
20200430,054425,聯發科富邦99購03,0.43,0.56,0.42,0.56,+0.18,47.37,2177000,66,1058300,0,0,0,0,0,0,1897000,10000,1887000,1887000
20200430,054426,國泰金富邦97購02,0.35,0.41,0.35,0.41,+0.10,32.26,509000,16,194610,0,0,0,0,0,0,234000,269000,-35000,-35000
20200430,054427,潤泰全富邦97購01,0.55,0.61,0.55,0.61,+0.08,15.09,168000,10,95480,0,0,0,0,0,0,10000,131000,-121000,-121000
20200430,054428,禾伸堂富邦98購01,,,,,0.00,0.00,0,0,0,0,0,0,0,0,0,0,0,0,0
20200430,054429,中石化台新97購01,,,,,0.00,0.00,0,0,0,0,0,0,0,0,0,0,0,0,0
20200430,05442P,鴻海元大96售13,,,,,0.00,0.00,0,0,0,0,0,0,0,0,0,0,0,0,0
20200430,054430,上銀台新96購02,0.05,0.05,0.05,0.05,0.00,0.00,10000,1,500,0,0,0,0,0,0,0,10000,-10000,-10000
20200430,054431,鴻海台新96購03,,,,,0.00,0.00,0,0,0,0,0,0,0,0,0,0,0,0,0
20200430,054432,台積電台新96購05,0.15,0.15,0.15,0.15,0.00,0.00,3000,1,450,0,0,0,0,0,0,3000,0,3000,3000
20200430,054433,南亞科台新96購02,,,,,0.00,0.00,0,0,0,0,0,0,0,0,0,0,0,0,0
20200430,054434,友達台新96購03,,,,,0.00,0.00,0,0,0,0,0,0,0,0,0,0,0,0,0
20200430,054435,華新科台新97購02,,,,,0.00,0.00,0,0,0,0,0,0,0,0,0,0,0,0,0
20200430,054436,高鐵台新97購02,0.22,0.22,0.22,0.22,0.00,0.00,10000,2,2200,0,0,0,0,0,0,0,10000,-10000,-10000
20200430,054437,欣興台新97購02,0.97,0.97,0.84,0.84,0.00,0.00,30000,3,27600,0,0,0,0,0,0,20000,10000,10000,10000
20200430,054438,群創台新96購01,,,,,0.00,0.00,0,0,0,0,0,0,0,0,0,0,0,0,0
20200430,054439,健策台新96購03,1.33,1.42,0.35,0.35,-0.91,-72.22,492000,29,627500,0,0,0,0,0,0,281000,211000,70000,70000
20200430,05443P,宏達電元大95售05,0.49,0.51,0.49,0.50,-0.04,-7.41,140000,3,69100,0,0,0,0,0,0,140000,0,140000,140000
20200430,054440,TPK台新98購01,0.02,0.02,0.02,0.02,0.00,0.00,10000,1,200,0,0,0,0,0,0,0,10000,-10000,-10000
20200430,054441,力成台新96購01,0.04,0.04,0.04,0.04,0.00,0.00,10000,2,400,0,0,0,0,0,0,0,10000,-10000,-10000
20200430,054442,啟碁台新96購01,0.53,0.53,0.22,0.22,-0.32,-59.26,101000,12,43590,0,0,0,0,0,0,71000,30000,41000,41000
20200430,054443,樺漢台新96購02,0.01,0.01,0.01,0.01,0.00,0.00,10000,1,100,0,0,0,0,0,0,0,10000,-10000,-10000
20200430,054444,緯穎台新97購01,2.50,2.87,2.50,2.87,0.00,0.00,30000,2,80550,0,0,0,0,0,0,30000,0,30000,30000
20200430,054445,技嘉兆豐96購01,2.04,2.04,2.04,2.04,-0.06,-2.86,1000,1,2040,0,0,0,0,0,0,1000,1000,0,0
20200430,054446,美食兆豐97購01,0.27,0.27,0.26,0.26,0.00,0.00,75000,2,19550,0,0,0,0,0,0,70000,5000,65000,65000
20200430,054447,國泰金兆豐96購01,0.21,0.22,0.21,0.22,0.00,0.00,20000,2,4300,0,0,0,0,0,0,0,20000,-20000,-20000
20200430,054448,矽力兆豐96購01,,,,,0.00,0.00,0,0,0,0,0,0,0,0,0,0,0,0,0
20200430,054449,中環第一96購01,,,,,0.00,0.00,0,0,0,0,0,0,0,0,0,0,0,0,0
20200430,05444P,大立光元大95售10,0.58,0.58,0.58,0.58,0.00,0.00,18000,1,10440,0,0,0,0,0,0,18000,18000,0,0
20200430,054450,聯茂第一96購01,0.61,0.61,0.61,0.61,0.00,0.00,1000,1,610,0,0,0,0,0,0,0,0,0,0
20200430,054451,上銀亞東98購01,2.27,2.27,2.10,2.10,0.00,0.00,20000,3,44150,0,0,0,0,0,0,0,20000,-20000,-20000
20200430,054452,華通亞東96購01,0.32,0.33,0.32,0.33,0.00,0.00,30000,2,9700,0,0,0,0,0,0,20000,10000,10000,10000
20200430,054453,上海銀亞東96購01,,,,,0.00,0.00,0,0,0,0,0,0,0,0,0,0,0,0,0
20200430,054454,滬深2X群益96購04,,,,,0.00,0.00,0,0,0,0,0,0,0,0,0,0,0,0,0
20200430,054455,楠梓電群益98購02,1.22,1.27,1.19,1.26,0.00,0.00,405000,9,504010,0,0,0,0,0,0,201000,204000,-3000,-3000
20200430,054456,華泰群益99購01,0.34,0.34,0.34,0.34,0.00,0.00,2000,1,680,0,0,0,0,0,0,0,2000,-2000,-2000
20200430,054457,強茂群益96購01,1.34,1.41,1.33,1.36,-0.11,-7.48,333000,8,452390,0,0,0,0,0,0,118000,211000,-93000,-93000
20200430,054458,復盛群益96購01,1.08,1.11,1.08,1.11,+0.01,0.91,233000,8,254350,0,0,0,0,0,0,218000,0,218000,218000
20200430,054459,鈺齊群益96購01,0.53,0.58,0.52,0.58,+0.03,5.45,526000,8,288640,0,0,0,0,0,0,328000,198000,130000,130000
20200430,05445P,聯詠元大95售05,2.83,2.83,2.83,2.83,-0.02,-0.7,1000,1,2830,0,0,0,0,0,0,1000,0,1000,1000
20200430,054460,和大凱基97購01,,,,,0.00,0.00,0,0,0,0,0,0,0,0,0,0,0,0,0
20200430,054461,台積電凱基97購09,0.40,1.10,0.40,1.10,+0.64,139.13,31000,7,31470,0,0,0,0,0,0,30000,0,30000,30000
20200430,054462,旺宏凱基96購08,0.44,0.44,0.44,0.44,+0.02,4.76,39000,1,17160,0,0,0,0,0,0,39000,0,39000,39000
20200430,054463,瑞昱凱基97購01,,,,,0.00,0.00,0,0,0,0,0,0,0,0,0,0,0,0,0
20200430,054464,奇力新凱基98購02,,,,,0.00,0.00,0,0,0,0,0,0,0,0,0,0,0,0,0
20200430,054465,亞光凱基97購01,0.02,0.08,0.02,0.08,-0.01,-11.11,53000,2,1240,0,0,0,0,0,0,0,0,0,0
20200430,054466,欣興凱基97購03,2.50,2.58,2.50,2.58,+0.38,17.27,19000,4,47720,0,0,0,0,0,0,6000,13000,-7000,-7000
20200430,054467,隆達凱基97購01,0.80,0.87,0.75,0.76,-0.12,-13.64,229000,20,180590,0,0,0,0,0,0,84000,90000,-6000,-6000
20200430,054468,台郡凱基98購01,,,,,0.00,0.00,0,0,0,0,0,0,0,0,0,0,0,0,0
20200430,054469,同欣電凱基97購01,,,,,0.00,0.00,0,0,0,0,0,0,0,0,0,0,0,0,0
20200430,05446P,緯穎元大95售04,,,,,0.00,0.00,0,0,0,0,0,0,0,0,0,0,0,0,0
20200430,054470,緯穎國票97購04,,,,,0.00,0.00,0,0,0,0,0,0,0,0,0,0,0,0,0
20200430,054471,T50反1中信9C購01,2.10,2.10,2.00,2.00,-0.18,-8.26,254000,21,521120,0,0,0,0,0,0,75000,179000,-104000,-104000
20200430,054472,道瓊反中信9A購01,,,,,0.00,0.00,0,0,0,0,0,0,0,0,0,0,0,0,0
20200430,054473,鴻海中信96購02,,,,,0.00,0.00,0,0,0,0,0,0,0,0,0,0,0,0,0
20200430,054474,鴻海中信96購03,,,,,0.00,0.00,0,0,0,0,0,0,0,0,0,0,0,0,0
20200430,054475,鴻海中信96購04,,,,,0.00,0.00,0,0,0,0,0,0,0,0,0,0,0,0,0
20200430,054476,聯發科中信96購03,,,,,0.00,0.00,0,0,0,0,0,0,0,0,0,0,0,0,0
20200430,054477,聯發科中信9C購02,0.28,0.34,0.25,0.34,+0.09,36.0,1094000,30,296580,0,0,0,0,0,0,863000,20000,843000,843000
20200430,054478,可成中信97購01,,,,,0.00,0.00,0,0,0,0,0,0,0,0,0,0,0,0,0
20200430,054479,緯創中信98購01,3.05,3.17,3.01,3.17,+0.19,6.38,165000,20,505480,0,0,0,0,0,0,65000,100000,-35000,-35000
20200430,05447P,臺股指元大95售24,,,,,0.00,0.00,0,0,0,0,0,0,0,0,0,0,0,0,0
20200430,054480,和碩中信98購01,1.19,1.21,1.18,1.19,-0.04,-3.25,114000,12,135760,0,0,0,0,0,0,60000,54000,6000,6000
20200430,054481,鎧勝中信96購01,1.03,1.27,1.03,1.22,+0.11,9.91,172000,10,208510,0,0,0,0,0,0,6000,166000,-160000,-160000
20200430,054482,大成鋼台新96購01,0.24,0.24,0.02,0.02,-0.19,-90.48,60000,4,12200,0,0,0,0,0,0,0,60000,-60000,-60000
20200430,054483,聯電台新96購01,0.01,0.01,0.01,0.01,0.00,0.00,10000,1,100,0,0,0,0,0,0,0,10000,-10000,-10000
20200430,054484,仁寶台新96購01,0.11,0.11,0.11,0.11,-0.36,-76.6,10000,1,1100,0,0,0,0,0,0,0,10000,-10000,-10000
20200430,054485,華邦電台新96購01,,,,,0.00,0.00,0,0,0,0,0,0,0,0,0,0,0,0,0
20200430,054486,漢唐台新96購01,0.02,0.02,0.02,0.02,0.00,0.00,10000,1,200,0,0,0,0,0,0,0,10000,-10000,-10000
20200430,054487,京元電台新97購01,0.06,0.06,0.06,0.06,-0.64,-91.43,10000,1,600,0,0,0,0,0,0,0,10000,-10000,-10000
20200430,054488,禾伸堂台新96購01,0.04,0.04,0.04,0.04,-0.78,-95.12,10000,1,400,0,0,0,0,0,0,0,10000,-10000,-10000
20200430,054489,牧德台新97購02,0.08,0.08,0.08,0.08,0.00,0.00,10000,1,800,0,0,0,0,0,0,0,10000,-10000,-10000
20200430,05448P,臺股指元大95售25,,,,,0.00,0.00,0,0,0,0,0,0,0,0,0,0,0,0,0
20200430,054490,臻鼎台新96購02,,,,,0.00,0.00,0,0,0,0,0,0,0,0,0,0,0,0,0
20200430,054491,瀚宇博台新96購02,0.04,0.04,0.04,0.04,0.00,0.00,10000,1,400,0,0,0,0,0,0,0,10000,-10000,-10000
20200430,054492,嘉聯益台新96購01,0.02,0.02,0.02,0.02,0.00,0.00,10000,1,200,0,0,0,0,0,0,0,10000,-10000,-10000
20200430,054493,同欣電台新96購01,,,,,0.00,0.00,0,0,0,0,0,0,0,0,0,0,0,0,0
20200430,054494,訊芯台新96購01,0.01,0.01,0.01,0.01,0.00,0.00,10000,1,100,0,0,0,0,0,0,0,10000,-10000,-10000
20200430,054495,滬深2X永豐97購02,0.27,0.27,0.27,0.27,0.00,0.00,4000,1,1080,0,0,0,0,0,0,0,0,0,0
20200430,054496,為升永豐96購01,,,,,0.00,0.00,0,0,0,0,0,0,0,0,0,0,0,0,0
20200430,054497,國巨永豐96購05,,,,,0.00,0.00,0,0,0,0,0,0,0,0,0,0,0,0,0
20200430,054498,燿華永豐96購06,,,,,0.00,0.00,0,0,0,0,0,0,0,0,0,0,0,0,0
20200430,054499,台光電永豐96購02,,,,,0.00,0.00,0,0,0,0,0,0,0,0,0,0,0,0,0
20200430,05449P,臺股指元大95售26,1.43,1.43,1.43,1.43,-0.86,-37.55,42000,1,60060,0,0,0,0,0,0,42000,0,42000,42000
20200430,054500,美律永豐96購02,,,,,0.00,0.00,0,0,0,0,0,0,0,0,0,0,0,0,0
20200430,054501,強茂永豐96購02,,,,,0.00,0.00,0,0,0,0,0,0,0,0,0,0,0,0,0
20200430,054502,泰碩永豐96購01,0.78,0.78,0.71,0.71,-0.04,-5.33,140000,7,101500,0,0,0,0,0,0,125000,15000,110000,110000
20200430,054503,京鼎永豐96購04,,,,,0.00,0.00,0,0,0,0,0,0,0,0,0,0,0,0,0
20200430,054504,聯鈞永豐96購01,0.96,0.96,0.89,0.89,0.00,0.00,54000,5,51140,0,0,0,0,0,0,10000,44000,-34000,-34000
20200430,054505,揚明光永豐97購02,,,,,0.00,0.00,0,0,0,0,0,0,0,0,0,0,0,0,0
20200430,054506,矽格永豐96購01,0.20,0.22,0.20,0.22,+0.01,4.76,130000,6,26700,0,0,0,0,0,0,100000,30000,70000,70000
20200430,054507,鈺齊永豐96購01,,,,,0.00,0.00,0,0,0,0,0,0,0,0,0,0,0,0,0
20200430,054508,臺股指永豐96購04,,,,,0.00,0.00,0,0,0,0,0,0,0,0,0,0,0,0,0
20200430,054509,上証反元大99購01,0.43,0.54,0.43,0.54,0.00,0.00,4000,2,1830,0,0,0,0,0,0,3000,1000,2000,2000
20200430,05450P,臺股指元大95售27,,,,,0.00,0.00,0,0,0,0,0,0,0,0,0,0,0,0,0
20200430,054510,S&P反1元大98購01,,,,,0.00,0.00,0,0,0,0,0,0,0,0,0,0,0,0,0
20200430,054511,香港反元大98購01,,,,,0.00,0.00,0,0,0,0,0,0,0,0,0,0,0,0,0
20200430,054512,元油反元大99購03,,,,,0.00,0.00,0,0,0,0,0,0,0,0,0,0,0,0,0
20200430,054513,元金2X元大96購01,,,,,0.00,0.00,0,0,0,0,0,0,0,0,0,0,0,0,0
20200430,054514,道瓊銀元大98購01,,,,,0.00,0.00,0,0,0,0,0,0,0,0,0,0,0,0,0
20200430,054515,華通元大98購02,,,,,0.00,0.00,0,0,0,0,0,0,0,0,0,0,0,0,0
20200430,054516,國巨元大97購02,0.64,0.64,0.64,0.64,0.00,0.00,4000,1,2560,0,0,0,0,0,0,4000,0,4000,4000
20200430,054517,高鐵元大96購01,,,,,0.00,0.00,0,0,0,0,0,0,0,0,0,0,0,0,0
20200430,054518,亞光元大97購01,0.04,0.04,0.04,0.04,+0.01,33.33,13000,1,520,0,0,0,0,0,0,0,0,0,0
20200430,054519,禾伸堂元大97購02,1.86,1.86,1.86,1.86,0.00,0.00,1000,1,1860,0,0,0,0,0,0,1000,0,1000,1000
20200430,05451P,臺股指元大95售28,,,,,0.00,0.00,0,0,0,0,0,0,0,0,0,0,0,0,0
20200430,054520,健鼎元大96購02,,,,,0.00,0.00,0,0,0,0,0,0,0,0,0,0,0,0,0
20200430,054521,TPK元大96購03,,,,,0.00,0.00,0,0,0,0,0,0,0,0,0,0,0,0,0
20200430,054522,康友元大96購07,,,,,0.00,0.00,0,0,0,0,0,0,0,0,0,0,0,0,0
20200430,054523,GIS元大96購05,0.93,0.93,0.90,0.92,+0.02,2.22,218000,9,199200,0,0,0,0,0,0,150000,68000,82000,82000
20200430,054524,華通元富96購03,0.12,0.12,0.12,0.12,0.00,0.00,1000,1,120,0,0,0,0,0,0,0,1000,-1000,-1000
20200430,054525,奇鋐元富96購01,0.94,1.03,0.87,1.03,+0.13,14.44,240000,14,223760,0,0,0,0,0,0,98000,142000,-44000,-44000
20200430,054526,道瓊反統一98購01,1.57,1.57,1.57,1.57,0.00,0.00,3000,1,4710,0,0,0,0,0,0,3000,0,3000,3000
20200430,054527,國巨統一97購03,2.28,2.34,2.17,2.27,+0.21,10.19,73000,11,166010,0,0,0,0,0,0,29000,46000,-17000,-17000
20200430,054528,台光電統一96購02,,,,,0.00,0.00,0,0,0,0,0,0,0,0,0,0,0,0,0
20200430,054529,T50反1國泰97購02,,,,,0.00,0.00,0,0,0,0,0,0,0,0,0,0,0,0,0
20200430,05452P,亞德客群益95售02,,,,,0.00,0.00,0,0,0,0,0,0,0,0,0,0,0,0,0
20200430,054530,台光電國泰97購03,1.91,2.04,1.91,2.04,+0.15,7.94,78000,5,156900,0,0,0,0,0,0,6000,72000,-66000,-66000
20200430,054531,聯發科國泰97購02,1.80,1.92,1.80,1.92,+0.41,27.15,221000,12,413100,0,0,0,0,0,0,25000,196000,-171000,-171000
20200430,054532,強茂國泰98購01,0.54,0.57,0.52,0.57,0.00,0.00,180000,38,96640,0,0,0,0,0,0,92000,1000,91000,91000
20200430,054533,泰碩國泰98購01,1.56,1.56,1.49,1.50,-0.03,-1.96,186000,29,280560,0,0,0,0,0,0,134000,42000,92000,92000
20200430,054534,台積電富邦98購03,,,,,0.00,0.00,0,0,0,0,0,0,0,0,0,0,0,0,0
20200430,054535,旺宏富邦97購02,0.74,0.74,0.73,0.73,+0.04,5.8,322000,4,236060,0,0,0,0,0,0,322000,0,322000,322000
20200430,054536,宏達電富邦97購03,,,,,0.00,0.00,0,0,0,0,0,0,0,0,0,0,0,0,0
20200430,054537,南亞科亞東97購01,,,,,0.00,0.00,0,0,0,0,0,0,0,0,0,0,0,0,0
20200430,054538,台光電國票98購01,1.79,2.13,1.79,2.13,+0.37,21.02,145000,4,284580,0,0,0,0,0,0,54000,91000,-37000,-37000
20200430,054539,欣興國票98購01,,,,,0.00,0.00,0,0,0,0,0,0,0,0,0,0,0,0,0
20200430,05453P,智邦群益95售03,,,,,0.00,0.00,0,0,0,0,0,0,0,0,0,0,0,0,0
20200430,054540,泰鼎國票99購01,2.00,2.00,1.87,1.97,-0.07,-3.43,165000,10,322610,0,0,0,0,0,0,12000,150000,-138000,-138000
20200430,054541,康控國票98購01,,,,,0.00,0.00,0,0,0,0,0,0,0,0,0,0,0,0,0
20200430,054542,台表科國票98購01,,,,,0.00,0.00,0,0,0,0,0,0,0,0,0,0,0,0,0
20200430,054543,元金2X中信01購01,,,,,0.00,0.00,0,0,0,0,0,0,0,0,0,0,0,0,0
20200430,054544,統一中信97購01,0.03,0.05,0.03,0.05,+0.01,25.0,25000,4,850,0,0,0,0,0,0,0,20000,-20000,-20000
20200430,054545,奇力新中信98購01,0.10,0.10,0.10,0.10,0.00,0.00,20000,2,2000,0,0,0,0,0,0,0,20000,-20000,-20000
20200430,054546,玉晶光中信9B購01,0.21,0.25,0.21,0.25,+0.06,31.58,1294000,48,289030,0,0,0,0,0,0,964000,258000,706000,706000
20200430,054547,鴻海凱基98購02,1.95,1.95,1.95,1.95,+0.03,1.56,10000,1,19500,0,0,0,0,0,0,10000,0,10000,10000
20200430,054548,鴻海凱基98購03,,,,,0.00,0.00,0,0,0,0,0,0,0,0,0,0,0,0,0
20200430,054549,台積電凱基98購01,0.21,0.21,0.21,0.21,+0.01,5.0,30000,3,6300,0,0,0,0,0,0,0,30000,-30000,-30000
20200430,05454P,奇鋐群益95售04,0.53,0.56,0.51,0.51,-0.08,-13.56,63000,5,33030,0,0,0,0,0,0,53000,10000,43000,43000
20200430,054550,旺宏凱基98購02,1.63,1.65,1.54,1.58,+0.21,15.33,392000,24,624650,0,0,0,0,0,0,352000,40000,312000,312000
20200430,054551,聯發科凱基98購02,,,,,0.00,0.00,0,0,0,0,0,0,0,0,0,0,0,0,0
20200430,054552,聯發科凱基98購03,0.20,0.20,0.20,0.20,0.00,0.00,1000,1,200,0,0,0,0,0,0,0,0,0,0
20200430,054553,宏達電凱基99購01,,,,,0.00,0.00,0,0,0,0,0,0,0,0,0,0,0,0,0
20200430,054554,大立光凱基98購02,2.18,2.40,2.18,2.40,0.00,0.00,27000,3,61440,0,0,0,0,0,0,3000,24000,-21000,-21000
20200430,054555,欣興凱基98購01,1.05,1.10,1.05,1.10,+0.05,4.76,60000,11,64200,0,0,0,0,0,0,50000,0,50000,50000
20200430,054556,世芯凱基99購01,0.70,0.80,0.64,0.80,+0.22,37.93,93000,17,69270,0,0,0,0,0,0,27000,21000,6000,6000
20200430,054557,臻鼎凱基98購01,,,,,0.00,0.00,0,0,0,0,0,0,0,0,0,0,0,0,0
20200430,054558,劍麟群益99購01,0.28,0.34,0.28,0.32,+0.06,23.08,518000,17,159850,0,0,0,0,0,0,368000,150000,218000,218000
20200430,054559,台光電群益99購01,2.10,2.41,2.09,2.41,+0.38,18.72,357000,15,774740,0,0,0,0,0,0,89000,293000,-204000,-204000
20200430,05455P,聯詠日盛95售01,,,,,0.00,0.00,0,0,0,0,0,0,0,0,0,0,0,0,0
20200430,054560,全新群益98購03,,,,,0.00,0.00,0,0,0,0,0,0,0,0,0,0,0,0,0
20200430,054561,奇力新群益97購03,,,,,0.00,0.00,0,0,0,0,0,0,0,0,0,0,0,0,0
20200430,054562,亞光群益98購01,,,,,0.00,0.00,0,0,0,0,0,0,0,0,0,0,0,0,0
20200430,054563,泰碩群益99購01,1.25,1.26,1.19,1.21,-0.02,-1.63,42000,6,50750,0,0,0,0,0,0,36000,3000,33000,33000
20200430,054564,玉晶光群益99購01,0.86,0.86,0.86,0.86,0.00,0.00,7000,1,6020,0,0,0,0,0,0,7000,0,7000,7000
20200430,054565,玉晶光群益99購02,1.00,1.11,1.00,1.11,0.00,0.00,10000,2,10550,0,0,0,0,0,0,10000,0,10000,10000
20200430,054566,貿聯群益97購02,,,,,0.00,0.00,0,0,0,0,0,0,0,0,0,0,0,0,0
20200430,054567,拓凱群益98購01,0.16,0.22,0.16,0.22,+0.05,29.41,1816000,39,341840,0,0,0,0,0,0,743000,975000,-232000,-232000
20200430,054568,訊芯群益97購01,,,,,0.00,0.00,0,0,0,0,0,0,0,0,0,0,0,0,0
20200430,054569,GIS群益98購01,0.48,0.48,0.48,0.48,0.00,0.00,2000,1,960,0,0,0,0,0,0,0,2000,-2000,-2000
20200430,05456P,鴻海凱基95售19,0.50,0.50,0.50,0.50,0.00,0.00,2000,1,1000,0,0,0,0,0,0,2000,0,2000,2000
20200430,054570,易華電群益98購01,,,,,0.00,0.00,0,0,0,0,0,0,0,0,0,0,0,0,0
20200430,054571,楠梓電元大99購01,0.64,0.69,0.63,0.63,-0.07,-10.0,17000,3,11200,0,0,0,0,0,0,17000,0,17000,17000
20200430,054572,國巨元大98購03,1.09,1.09,1.09,1.09,+0.13,13.54,2000,1,2180,0,0,0,0,0,0,0,2000,-2000,-2000
20200430,054573,漢唐元大98購01,0.63,0.64,0.61,0.63,+0.01,1.61,74000,7,46320,0,0,0,0,0,0,20000,54000,-34000,-34000
20200430,054574,美律元大99購01,,,,,0.00,0.00,0,0,0,0,0,0,0,0,0,0,0,0,0
20200430,054575,聯鈞元大97購01,2.24,2.24,2.24,2.24,-0.22,-8.94,2000,1,4480,0,0,0,0,0,0,2000,0,2000,2000
20200430,054576,健策元大98購03,0.83,0.83,0.83,0.83,0.00,0.00,18000,1,14940,0,0,0,0,0,0,18000,0,18000,18000
20200430,054577,世芯元大98購01,1.54,1.80,1.54,1.79,+0.39,27.86,101000,13,170880,0,0,0,0,0,0,95000,2000,93000,93000
20200430,054578,世芯元大99購01,1.82,2.04,1.82,2.04,0.00,0.00,21000,3,42420,0,0,0,0,0,0,21000,0,21000,21000
20200430,054579,聯茂元大97購01,3.94,3.99,3.77,3.77,-0.35,-8.5,66000,8,254890,0,0,0,0,0,0,66000,0,66000,66000
20200430,05457P,鴻海凱基95售20,,,,,0.00,0.00,0,0,0,0,0,0,0,0,0,0,0,0,0
20200430,054580,樺漢元大98購01,,,,,0.00,0.00,0,0,0,0,0,0,0,0,0,0,0,0,0
20200430,054581,訊芯元大97購02,0.19,0.23,0.19,0.23,0.00,0.00,15000,3,3150,0,0,0,0,0,0,15000,0,15000,15000
20200430,054582,致新元大97購01,1.42,1.51,1.35,1.51,+0.16,11.85,188000,15,265710,0,0,0,0,0,0,106000,82000,24000,24000
20200430,054583,玉晶光統一97購02,0.10,0.10,0.10,0.10,0.00,0.00,15000,1,1500,0,0,0,0,0,0,0,0,0,0
20200430,054584,貿聯元富97購01,0.86,0.86,0.25,0.37,+0.13,54.17,24000,3,17100,0,0,0,0,0,0,5000,1000,4000,4000
20200430,054585,禾伸堂國泰99購01,,,,,0.00,0.00,0,0,0,0,0,0,0,0,0,0,0,0,0
20200430,054586,健鼎國泰99購01,,,,,0.00,0.00,0,0,0,0,0,0,0,0,0,0,0,0,0
20200430,054587,玉晶光國泰99購01,0.87,0.87,0.87,0.87,+0.13,17.57,1000,1,870,0,0,0,0,0,0,0,1000,-1000,-1000
20200430,054588,玉晶光國泰99購02,0.59,0.65,0.59,0.65,+0.15,30.0,2000,2,1240,0,0,0,0,0,0,0,1000,-1000,-1000
20200430,054589,聯鈞國泰99購01,1.89,1.89,1.89,1.89,-0.09,-4.55,9000,2,17010,0,0,0,0,0,0,9000,0,9000,9000
20200430,05458P,台積電凱基97售02,,,,,0.00,0.00,0,0,0,0,0,0,0,0,0,0,0,0,0
20200430,054590,嘉聯益國泰98購01,0.71,0.75,0.71,0.75,+0.04,5.63,396000,27,291350,0,0,0,0,0,0,372000,0,372000,372000
20200430,054591,GIS國泰98購01,,,,,0.00,0.00,0,0,0,0,0,0,0,0,0,0,0,0,0
20200430,054592,美律永昌9A購01,,,,,0.00,0.00,0,0,0,0,0,0,0,0,0,0,0,0,0
20200430,054593,滬深2X永昌9A購01,1.25,1.25,1.25,1.25,+0.12,10.62,1000,1,1250,0,0,0,0,0,0,1000,0,1000,1000
20200430,054594,國巨麥證97購01,,,,,0.00,0.00,0,0,0,0,0,0,0,0,0,0,0,0,0
20200430,054595,正崴麥證97購01,,,,,0.00,0.00,0,0,0,0,0,0,0,0,0,0,0,0,0
20200430,054596,聯發科麥證97購01,1.30,1.30,1.30,1.30,0.00,0.00,24000,2,31200,0,24000,-24000,0,0,0,0,24000,-24000,-24000
20200430,054597,南亞台新97購01,0.27,0.33,0.02,0.02,-0.18,-90.0,227000,11,59770,0,0,0,0,0,0,200000,27000,173000,173000
20200430,054598,鴻海台新98購01,,,,,0.00,0.00,0,0,0,0,0,0,0,0,0,0,0,0,0
20200430,054599,正崴台新97購01,,,,,0.00,0.00,0,0,0,0,0,0,0,0,0,0,0,0,0
20200430,05459P,聯詠凱基95售03,2.88,2.88,2.88,2.88,-0.04,-1.37,10000,1,28800,0,0,0,0,0,0,0,10000,-10000,-10000
20200430,054600,中壽台新97購01,,,,,0.00,0.00,0,0,0,0,0,0,0,0,0,0,0,0,0
20200430,054601,奇鋐台新98購01,,,,,0.00,0.00,0,0,0,0,0,0,0,0,0,0,0,0,0
20200430,054602,聯詠台新97購01,,,,,0.00,0.00,0,0,0,0,0,0,0,0,0,0,0,0,0
20200430,054603,智易台新98購01,0.05,0.05,0.05,0.05,0.00,0.00,10000,1,500,0,0,0,0,0,0,0,10000,-10000,-10000
20200430,054604,麗豐台新98購01,0.02,0.02,0.02,0.02,0.00,0.00,10000,1,200,0,0,0,0,0,0,0,10000,-10000,-10000
20200430,054605,鴻海永豐97購01,0.10,0.10,0.10,0.10,+0.03,42.86,7000,1,700,0,0,0,0,0,0,0,7000,-7000,-7000
20200430,054606,台積電永豐97購02,0.03,0.03,0.03,0.03,-0.02,-40.0,199000,2,5970,0,0,0,0,0,0,0,0,0,0
20200430,054607,台積電永豐97購03,,,,,0.00,0.00,0,0,0,0,0,0,0,0,0,0,0,0,0
20200430,054608,致茂永豐97購01,0.14,0.14,0.14,0.14,-0.03,-17.65,28000,3,3920,0,0,0,0,0,0,18000,10000,8000,8000
20200430,054609,正崴永豐97購01,0.50,0.50,0.47,0.47,+0.09,23.68,33000,4,16200,0,0,0,0,0,0,23000,10000,13000,13000
20200430,05460P,台郡凱基95售05,,,,,0.00,0.00,0,0,0,0,0,0,0,0,0,0,0,0,0
20200430,054610,聯發科永豐97購01,,,,,0.00,0.00,0,0,0,0,0,0,0,0,0,0,0,0,0
20200430,054611,全新永豐97購01,,,,,0.00,0.00,0,0,0,0,0,0,0,0,0,0,0,0,0
20200430,054612,慧洋永豐97購01,,,,,0.00,0.00,0,0,0,0,0,0,0,0,0,0,0,0,0
20200430,054613,大立光永豐97購02,,,,,0.00,0.00,0,0,0,0,0,0,0,0,0,0,0,0,0
20200430,054614,玉晶光永豐97購03,0.08,0.11,0.08,0.10,+0.04,66.67,262000,8,24600,0,0,0,0,0,0,118000,134000,-16000,-16000
20200430,054615,牧德永豐98購01,,,,,0.00,0.00,0,0,0,0,0,0,0,0,0,0,0,0,0
20200430,054616,智伸科永豐97購01,,,,,0.00,0.00,0,0,0,0,0,0,0,0,0,0,0,0,0
20200430,054617,超眾永豐97購01,0.07,0.07,0.06,0.06,0.00,0.00,75000,3,4750,0,0,0,0,0,0,50000,25000,25000,25000
20200430,054618,訊芯永豐97購01,,,,,0.00,0.00,0,0,0,0,0,0,0,0,0,0,0,0,0
20200430,054619,昇陽半永豐97購03,,,,,0.00,0.00,0,0,0,0,0,0,0,0,0,0,0,0,0
20200430,05461P,台積電亞東97售01,,,,,0.00,0.00,0,0,0,0,0,0,0,0,0,0,0,0,0
20200430,054620,南茂永豐97購01,,,,,0.00,0.00,0,0,0,0,0,0,0,0,0,0,0,0,0
20200430,054621,華新科兆豐98購01,0.38,0.38,0.38,0.38,-0.01,-2.56,10000,1,3800,0,0,0,0,0,0,0,10000,-10000,-10000
20200430,054622,漢唐第一97購01,,,,,0.00,0.00,0,0,0,0,0,0,0,0,0,0,0,0,0
20200430,054623,華新科第一97購01,0.15,0.20,0.15,0.20,+0.04,25.0,21000,2,3200,0,0,0,0,0,0,20000,0,20000,20000
20200430,054624,台積電凱基98購03,,,,,0.00,0.00,0,0,0,0,0,0,0,0,0,0,0,0,0
20200430,054625,旺宏凱基98購03,,,,,0.00,0.00,0,0,0,0,0,0,0,0,0,0,0,0,0
20200430,054626,建準凱基98購01,,,,,0.00,0.00,0,0,0,0,0,0,0,0,0,0,0,0,0
20200430,054627,義隆凱基98購01,0.87,1.05,0.87,0.97,+0.11,12.79,226000,21,210780,0,0,0,0,0,0,120000,106000,14000,14000
20200430,054628,可成凱基98購01,,,,,0.00,0.00,0,0,0,0,0,0,0,0,0,0,0,0,0
20200430,054629,華新科凱基98購01,,,,,0.00,0.00,0,0,0,0,0,0,0,0,0,0,0,0,0
20200430,05462P,美律亞東97售01,,,,,0.00,0.00,0,0,0,0,0,0,0,0,0,0,0,0,0
20200430,054630,聯鈞凱基98購01,,,,,0.00,0.00,0,0,0,0,0,0,0,0,0,0,0,0,0
20200430,054631,台郡凱基98購02,,,,,0.00,0.00,0,0,0,0,0,0,0,0,0,0,0,0,0
20200430,054632,緯穎凱基9A購01,0.81,1.00,0.81,0.96,+0.21,28.0,22000,7,20810,0,0,0,0,0,0,14000,0,14000,14000
20200430,054633,臺股指凱基9A購02,0.07,0.08,0.07,0.08,+0.01,14.29,534000,19,41550,0,0,0,0,0,0,0,0,0,0
20200430,054634,FB上証中信99購01,0.25,0.29,0.25,0.28,+0.03,12.0,137000,38,35640,0,0,0,0,0,0,54000,64000,-10000,-10000
20200430,054635,台達電中信98購01,0.14,0.16,0.14,0.16,+0.06,60.0,22000,2,3480,0,0,0,0,0,0,22000,0,22000,22000
20200430,054636,華通中信97購01,0.06,0.06,0.06,0.06,0.00,0.00,600000,60,36000,0,0,0,0,0,0,0,590000,-590000,-590000
20200430,054637,智邦中信98購01,,,,,0.00,0.00,0,0,0,0,0,0,0,0,0,0,0,0,0
20200430,054638,國泰金中信99購01,0.29,0.29,0.29,0.29,0.00,0.00,15000,2,4350,0,0,0,0,0,0,0,15000,-15000,-15000
20200430,054639,台新金中信99購01,,,,,0.00,0.00,0,0,0,0,0,0,0,0,0,0,0,0,0
20200430,05463P,創意國票96售04,1.71,1.71,1.67,1.67,-0.16,-8.74,35000,6,59000,0,0,0,0,0,0,35000,0,35000,35000
20200430,054640,健策中信9B購01,0.45,0.46,0.45,0.45,+0.05,12.5,190000,5,85550,0,0,0,0,0,0,190000,0,190000,190000
20200430,054641,祥碩中信98購01,1.62,1.62,1.20,1.20,-0.19,-13.67,60000,6,87300,0,0,0,0,0,0,20000,40000,-20000,-20000
20200430,054642,訊芯中信9A購01,0.09,0.09,0.09,0.09,+0.01,12.5,10000,1,900,0,0,0,0,0,0,0,10000,-10000,-10000
20200430,054643,上証2X群益9B購01,0.58,0.58,0.58,0.58,0.00,0.00,1000,1,580,0,0,0,0,0,0,1000,0,1000,1000
20200430,054644,A50正2群益9B購01,,,,,0.00,0.00,0,0,0,0,0,0,0,0,0,0,0,0,0
20200430,054645,奇力新群益97購04,,,,,0.00,0.00,0,0,0,0,0,0,0,0,0,0,0,0,0
20200430,054646,華新科群益97購03,,,,,0.00,0.00,0,0,0,0,0,0,0,0,0,0,0,0,0
20200430,054647,禾伸堂群益99購01,1.34,1.34,1.34,1.34,0.00,0.00,11000,1,14740,0,0,0,0,0,0,11000,0,11000,11000
20200430,054648,智原群益98購01,,,,,0.00,0.00,0,0,0,0,0,0,0,0,0,0,0,0,0
20200430,054649,聯茂群益97購01,4.06,4.06,4.06,4.06,-0.17,-4.02,51000,1,207060,0,0,0,0,0,0,0,51000,-51000,-51000
20200430,05464P,華通康和95售02,0.24,0.24,0.16,0.16,-0.13,-44.83,1150000,16,226200,0,0,0,0,0,0,470000,680000,-210000,-210000
20200430,054650,南亞麥證97購01,,,,,0.00,0.00,0,0,0,0,0,0,0,0,0,0,0,0,0
20200430,054651,台化麥證97購01,,,,,0.00,0.00,0,0,0,0,0,0,0,0,0,0,0,0,0
20200430,054652,裕隆麥證97購01,0.32,0.32,0.32,0.32,+0.02,6.67,20000,2,6400,0,0,0,0,0,0,0,0,0,0
20200430,054653,聯發科麥證97購02,,,,,0.00,0.00,0,0,0,0,0,0,0,0,0,0,0,0,0
20200430,054654,全新麥證99購01,0.59,0.59,0.58,0.59,-0.02,-3.28,80000,7,46900,80000,0,80000,0,0,0,80000,0,80000,80000
20200430,054655,貿聯麥證98購01,0.41,0.49,0.41,0.49,0.00,0.00,149000,3,65090,0,149000,-149000,0,0,0,0,149000,-149000,-149000
20200430,054656,深中小元大97購01,,,,,0.00,0.00,0,0,0,0,0,0,0,0,0,0,0,0,0
20200430,054657,道瓊銀元大97購01,,,,,0.00,0.00,0,0,0,0,0,0,0,0,0,0,0,0,0
20200430,054658,道瓊銀元大9A購01,,,,,0.00,0.00,0,0,0,0,0,0,0,0,0,0,0,0,0
20200430,054659,亞光元大97購02,,,,,0.00,0.00,0,0,0,0,0,0,0,0,0,0,0,0,0
20200430,05465P,台表科永豐95售03,,,,,0.00,0.00,0,0,0,0,0,0,0,0,0,0,0,0,0
20200430,054660,禾伸堂元大97購03,,,,,0.00,0.00,0,0,0,0,0,0,0,0,0,0,0,0,0
20200430,054661,嘉聯益元大97購03,,,,,0.00,0.00,0,0,0,0,0,0,0,0,0,0,0,0,0
20200430,054662,同欣電元大97購02,0.33,0.39,0.33,0.39,+0.07,21.88,160000,7,58400,0,0,0,0,0,0,60000,100000,-40000,-40000
20200430,054663,同欣電元大97購03,,,,,0.00,0.00,0,0,0,0,0,0,0,0,0,0,0,0,0
20200430,054664,台表科元大97購04,,,,,0.00,0.00,0,0,0,0,0,0,0,0,0,0,0,0,0
20200430,054665,華通元富97購02,0.56,0.61,0.54,0.61,+0.24,64.86,64000,5,38350,0,0,0,0,0,0,64000,0,64000,64000
20200430,054666,強茂元富97購01,,,,,0.00,0.00,0,0,0,0,0,0,0,0,0,0,0,0,0
20200430,054667,神基元富97購01,,,,,0.00,0.00,0,0,0,0,0,0,0,0,0,0,0,0,0
20200430,054668,傳奇元富97購03,,,,,0.00,0.00,0,0,0,0,0,0,0,0,0,0,0,0,0
20200430,054669,凌華元富97購01,,,,,0.00,0.00,0,0,0,0,0,0,0,0,0,0,0,0,0
20200430,05466P,旺宏富邦97售01,,,,,0.00,0.00,0,0,0,0,0,0,0,0,0,0,0,0,0
20200430,054670,康友元富97購01,,,,,0.00,0.00,0,0,0,0,0,0,0,0,0,0,0,0,0
20200430,054671,國巨國泰98購01,,,,,0.00,0.00,0,0,0,0,0,0,0,0,0,0,0,0,0
20200430,054672,華新科國泰99購01,,,,,0.00,0.00,0,0,0,0,0,0,0,0,0,0,0,0,0
20200430,054673,京鼎國泰98購01,1.09,1.15,1.06,1.15,+0.17,17.35,123000,8,133490,0,0,0,0,0,0,71000,52000,19000,19000
20200430,054674,台光電台新97購01,0.36,0.36,0.04,0.04,-0.32,-88.89,76000,7,24160,0,0,0,0,0,0,26000,50000,-24000,-24000
20200430,054675,美律台新98購01,0.10,0.10,0.10,0.10,0.00,0.00,10000,1,1000,0,0,0,0,0,0,0,10000,-10000,-10000
20200430,054676,牧德台新98購01,,,,,0.00,0.00,0,0,0,0,0,0,0,0,0,0,0,0,0
20200430,054677,智易台新98購02,0.41,0.41,0.06,0.06,0.00,0.00,20000,2,4700,0,0,0,0,0,0,10000,10000,0,0
20200430,054678,麗豐台新98購02,0.02,0.02,0.02,0.02,0.00,0.00,10000,1,200,0,0,0,0,0,0,0,10000,-10000,-10000
20200430,054679,台積電康和99購01,,,,,0.00,0.00,0,0,0,0,0,0,0,0,0,0,0,0,0
20200430,05467P,聯電元大95售02,0.41,0.41,0.41,0.41,-0.08,-16.33,145000,1,59450,0,0,0,0,0,0,145000,0,145000,145000
20200430,054680,華新科康和97購02,0.33,0.33,0.33,0.33,0.00,0.00,30000,3,9900,0,0,0,0,0,0,0,30000,-30000,-30000
20200430,054681,味全永豐97購01,,,,,0.00,0.00,0,0,0,0,0,0,0,0,0,0,0,0,0
20200430,054682,東元永豐97購01,0.85,0.86,0.85,0.86,+0.01,1.18,63000,2,53760,0,0,0,0,0,0,0,63000,-63000,-63000
20200430,054683,川湖永豐97購01,0.09,0.09,0.07,0.07,-0.02,-22.22,150000,6,11150,0,0,0,0,0,0,95000,25000,70000,70000
20200430,054684,裕隆永豐97購01,0.22,0.22,0.22,0.22,+0.01,4.76,1000,1,220,0,0,0,0,0,0,0,1000,-1000,-1000
20200430,054685,國巨永豐97購02,0.07,0.07,0.06,0.06,-0.01,-14.29,362000,13,24120,0,0,0,0,0,0,0,0,0,0
20200430,054686,順德永豐97購01,,,,,0.00,0.00,0,0,0,0,0,0,0,0,0,0,0,0,0
20200430,054687,建準永豐97購02,,,,,0.00,0.00,0,0,0,0,0,0,0,0,0,0,0,0,0
20200430,054688,兆赫永豐97購01,0.05,0.05,0.05,0.05,0.00,0.00,20000,1,1000,0,0,0,0,0,0,20000,0,20000,20000
20200430,054689,華新科永豐97購01,0.03,0.03,0.03,0.03,0.00,0.00,27000,1,810,0,0,0,0,0,0,27000,0,27000,27000
20200430,05468P,鴻海元大96售14,1.98,1.98,1.98,1.98,0.00,0.00,4000,1,7920,0,0,0,0,0,0,4000,0,4000,4000
20200430,054690,新興永豐97購01,0.23,0.23,0.23,0.23,-0.02,-8.0,200000,2,46000,0,0,0,0,0,0,100000,100000,0,0
20200430,054691,裕民永豐97購01,,,,,0.00,0.00,0,0,0,0,0,0,0,0,0,0,0,0,0
20200430,054692,台航永豐97購01,,,,,0.00,0.00,0,0,0,0,0,0,0,0,0,0,0,0,0
20200430,054693,神基永豐97購01,0.22,0.24,0.22,0.24,+0.03,14.29,152000,5,33960,0,0,0,0,0,0,151000,1000,150000,150000
20200430,054694,聯鈞永豐97購01,0.53,0.53,0.44,0.46,-0.06,-11.54,215000,6,96580,0,0,0,0,0,0,172000,43000,129000,129000
20200430,054695,世芯永豐98購01,1.32,1.34,1.32,1.34,0.00,0.00,35000,2,46500,0,0,0,0,0,0,35000,0,35000,35000
20200430,054696,嘉聯益永豐97購01,,,,,0.00,0.00,0,0,0,0,0,0,0,0,0,0,0,0,0
20200430,054697,凌華永豐97購01,1.51,1.51,1.51,1.51,0.00,0.00,30000,1,45300,0,0,0,0,0,0,30000,0,30000,30000
20200430,054698,同欣電永豐97購01,0.10,0.10,0.10,0.10,+0.02,25.0,100000,1,10000,0,0,0,0,0,0,0,100000,-100000,-100000
20200430,054699,復盛永豐97購01,,,,,0.00,0.00,0,0,0,0,0,0,0,0,0,0,0,0,0
20200430,05469P,台積電元大95售24,,,,,0.00,0.00,0,0,0,0,0,0,0,0,0,0,0,0,0
20200430,054700,致新永豐97購01,,,,,0.00,0.00,0,0,0,0,0,0,0,0,0,0,0,0,0
20200430,054701,宏全永豐97購01,,,,,0.00,0.00,0,0,0,0,0,0,0,0,0,0,0,0,0
20200430,054702,智邦第一97購01,1.29,1.29,1.29,1.29,-0.02,-1.53,20000,1,25800,0,0,0,0,0,0,20000,0,20000,20000
20200430,054703,聯發科第一97購01,,,,,0.00,0.00,0,0,0,0,0,0,0,0,0,0,0,0,0
20200430,054704,玉晶光第一97購01,,,,,0.00,0.00,0,0,0,0,0,0,0,0,0,0,0,0,0
20200430,054705,欣興亞東97購01,,,,,0.00,0.00,0,0,0,0,0,0,0,0,0,0,0,0,0
20200430,054706,TPK亞東97購01,,,,,0.00,0.00,0,0,0,0,0,0,0,0,0,0,0,0,0
20200430,054707,聯茂亞東97購01,1.99,2.04,1.96,2.04,0.00,0.00,190000,7,378600,0,0,0,0,0,0,140000,50000,90000,90000
20200430,054708,華通統一97購02,,,,,0.00,0.00,0,0,0,0,0,0,0,0,0,0,0,0,0
20200430,054709,宏達電統一97購01,0.55,0.55,0.53,0.53,-0.03,-5.36,48000,2,25640,0,0,0,0,0,0,0,48000,-48000,-48000
20200430,05470P,康控元大95售05,,,,,0.00,0.00,0,0,0,0,0,0,0,0,0,0,0,0,0
20200430,054710,東元元富97購01,1.67,1.77,1.64,1.77,+0.10,5.99,420000,15,708780,0,0,0,0,0,0,198000,255000,-57000,-57000
20200430,054711,禾伸堂元富97購01,,,,,0.00,0.00,0,0,0,0,0,0,0,0,0,0,0,0,0
20200430,054712,上証2X中信98購02,,,,,0.00,0.00,0,0,0,0,0,0,0,0,0,0,0,0,0
20200430,054713,國巨中信9B購01,0.55,0.59,0.53,0.54,+0.01,1.89,2995000,163,1667080,0,0,0,0,0,0,0,0,0,0
20200430,054714,和鑫台新98購01,0.22,0.22,0.22,0.22,0.00,0.00,10000,1,2200,0,0,0,0,0,0,0,10000,-10000,-10000
20200430,054715,中橡康和97購01,,,,,0.00,0.00,0,0,0,0,0,0,0,0,0,0,0,0,0
20200430,054716,緯穎康和97購01,1.22,1.50,1.19,1.44,+0.29,25.22,458000,24,612720,0,0,0,0,0,0,102000,387000,-285000,-285000
20200430,054717,亞德客永豐97購01,2.07,2.65,1.88,2.65,+0.75,39.47,636000,35,1353560,0,0,0,0,0,0,204000,456000,-252000,-252000
20200430,054718,可成永豐97購01,,,,,0.00,0.00,0,0,0,0,0,0,0,0,0,0,0,0,0
20200430,054719,亞光永豐97購01,,,,,0.00,0.00,0,0,0,0,0,0,0,0,0,0,0,0,0
20200430,05471P,聯電統一95售01,0.39,0.39,0.39,0.39,0.00,0.00,6000,1,2340,0,0,0,0,0,0,0,6000,-6000,-6000
20200430,054720,禾伸堂永豐97購01,0.40,0.40,0.37,0.38,0.00,0.00,344000,11,130630,0,0,0,0,0,0,338000,6000,332000,332000
20200430,054721,揚明光永豐97購03,,,,,0.00,0.00,0,0,0,0,0,0,0,0,0,0,0,0,0
20200430,054722,傳奇永豐97購01,,,,,0.00,0.00,0,0,0,0,0,0,0,0,0,0,0,0,0
20200430,054723,鴻海日盛97購01,,,,,0.00,0.00,0,0,0,0,0,0,0,0,0,0,0,0,0
20200430,054724,鴻海日盛97購02,,,,,0.00,0.00,0,0,0,0,0,0,0,0,0,0,0,0,0
20200430,054725,國巨日盛97購01,,,,,0.00,0.00,0,0,0,0,0,0,0,0,0,0,0,0,0
20200430,054726,台積電日盛97購01,,,,,0.00,0.00,0,0,0,0,0,0,0,0,0,0,0,0,0
20200430,054727,台積電日盛97購02,,,,,0.00,0.00,0,0,0,0,0,0,0,0,0,0,0,0,0
20200430,054728,聯發科日盛97購01,1.36,1.44,1.36,1.44,+0.36,33.33,38000,5,52610,0,0,0,0,0,0,5000,33000,-28000,-28000
20200430,054729,聯發科日盛97購02,0.20,0.20,0.18,0.20,+0.05,33.33,40000,3,7600,0,0,0,0,0,0,39000,0,39000,39000
20200430,05472P,國巨統一96售02,,,,,0.00,0.00,0,0,0,0,0,0,0,0,0,0,0,0,0
20200430,054730,上証2X凱基98購02,,,,,0.00,0.00,0,0,0,0,0,0,0,0,0,0,0,0,0
20200430,054731,S&P反1凱基98購01,0.49,0.49,0.49,0.49,-0.06,-10.91,5000,1,2450,0,0,0,0,0,0,5000,0,5000,5000
20200430,054732,台化凱基98購01,,,,,0.00,0.00,0,0,0,0,0,0,0,0,0,0,0,0,0
20200430,054733,鴻海凱基98購04,0.13,0.20,0.13,0.20,0.00,0.00,97000,3,12680,0,0,0,0,0,0,96000,0,96000,96000
20200430,054734,燿華凱基97購03,,,,,0.00,0.00,0,0,0,0,0,0,0,0,0,0,0,0,0
20200430,054735,漢唐凱基98購01,1.49,1.49,1.49,1.49,+0.06,4.2,13000,1,19370,0,0,0,0,0,0,13000,0,13000,13000
20200430,054736,南亞科凱基98購01,,,,,0.00,0.00,0,0,0,0,0,0,0,0,0,0,0,0,0
20200430,054737,京元電凱基99購01,0.25,0.25,0.25,0.25,+0.01,4.17,20000,1,5000,0,0,0,0,0,0,0,0,0,0
20200430,054738,聯發科凱基97購01,1.96,2.00,1.96,2.00,+0.45,29.03,43000,4,84940,0,0,0,0,0,0,0,43000,-43000,-43000
20200430,054739,義隆凱基98購02,,,,,0.00,0.00,0,0,0,0,0,0,0,0,0,0,0,0,0
20200430,05473P,聯詠統一97售02,,,,,0.00,0.00,0,0,0,0,0,0,0,0,0,0,0,0,0
20200430,054740,強茂凱基99購01,,,,,0.00,0.00,0,0,0,0,0,0,0,0,0,0,0,0,0
20200430,054741,亞光凱基99購01,0.34,0.34,0.34,0.34,0.00,0.00,2000,1,680,0,0,0,0,0,0,0,0,0,0
20200430,054742,京鼎凱基99購01,1.42,1.55,1.42,1.55,+0.20,14.81,93000,5,138350,0,0,0,0,0,0,0,93000,-93000,-93000
20200430,054743,聯鈞凱基99購01,,,,,0.00,0.00,0,0,0,0,0,0,0,0,0,0,0,0,0
20200430,054744,晶相光凱基99購01,0.91,0.91,0.88,0.88,-0.07,-7.37,149000,9,132640,0,0,0,0,0,0,149000,0,149000,149000
20200430,054745,智易凱基97購01,0.89,0.89,0.86,0.86,-0.11,-11.34,30000,2,26100,0,0,0,0,0,0,10000,20000,-10000,-10000
20200430,054746,貿聯凱基98購02,,,,,0.00,0.00,0,0,0,0,0,0,0,0,0,0,0,0,0
20200430,054747,麗豐凱基98購01,0.72,0.73,0.72,0.73,0.00,0.00,77000,3,56110,0,0,0,0,0,0,0,77000,-77000,-77000
20200430,054748,正文凱基98購01,,,,,0.00,0.00,0,0,0,0,0,0,0,0,0,0,0,0,0
20200430,054749,聯茂凱基98購01,5.05,5.05,5.05,5.05,0.00,0.00,1000,1,5050,0,0,0,0,0,0,1000,1000,0,0
20200430,05474P,智邦亞東95售01,,,,,0.00,0.00,0,0,0,0,0,0,0,0,0,0,0,0,0
20200430,054750,聯茂凱基98購02,,,,,0.00,0.00,0,0,0,0,0,0,0,0,0,0,0,0,0
20200430,054751,GIS凱基98購01,1.65,1.69,1.64,1.64,-0.06,-3.53,199000,12,330250,0,0,0,0,0,0,169000,30000,139000,139000
20200430,054752,易華電凱基97購02,,,,,0.00,0.00,0,0,0,0,0,0,0,0,0,0,0,0,0
20200430,054753,復盛凱基98購01,0.37,0.38,0.36,0.38,-0.02,-5.0,32000,6,12030,0,0,0,0,0,0,12000,20000,-8000,-8000
20200430,054754,昇陽半凱基98購02,,,,,0.00,0.00,0,0,0,0,0,0,0,0,0,0,0,0,0
20200430,054755,世紀鋼凱基98購01,1.67,1.67,1.67,1.67,0.00,0.00,30000,1,50100,0,0,0,0,0,0,30000,0,30000,30000
20200430,054756,世紀鋼凱基99購01,,,,,0.00,0.00,0,0,0,0,0,0,0,0,0,0,0,0,0
20200430,054757,南亞國票98購01,0.51,0.77,0.49,0.77,+0.30,63.83,271000,19,166200,0,0,0,0,0,0,174000,96000,78000,78000
20200430,054758,南亞國票9A購01,1.31,1.77,1.30,1.73,+0.50,40.65,1165000,46,1735450,0,0,0,0,0,0,878000,282000,596000,596000
20200430,054759,台化國票98購01,0.39,0.67,0.39,0.66,+0.29,78.38,414000,31,223530,0,0,0,0,0,0,86000,328000,-242000,-242000
20200430,05475P,聯茂亞東95售01,,,,,0.00,0.00,0,0,0,0,0,0,0,0,0,0,0,0,0
20200430,054760,台化國票9A購01,2.01,2.46,2.01,2.46,+0.53,27.46,47000,4,101530,0,0,0,0,0,0,25000,22000,3000,3000
20200430,054761,台光電國票98購02,0.90,0.93,0.90,0.93,+0.16,20.78,30000,3,27300,0,0,0,0,0,0,30000,0,30000,30000
20200430,054762,奇力新國票99購01,,,,,0.00,0.00,0,0,0,0,0,0,0,0,0,0,0,0,0
20200430,054763,宏達電國票99購01,,,,,0.00,0.00,0,0,0,0,0,0,0,0,0,0,0,0,0
20200430,054764,亞光國票98購01,,,,,0.00,0.00,0,0,0,0,0,0,0,0,0,0,0,0,0
20200430,054765,亞光國票98購02,,,,,0.00,0.00,0,0,0,0,0,0,0,0,0,0,0,0,0
20200430,054766,智原國票98購01,0.98,1.00,0.98,1.00,+0.09,9.89,44000,5,43500,0,0,0,0,0,0,0,44000,-44000,-44000
20200430,054767,日電貿國票98購01,1.58,1.61,1.52,1.52,+0.05,3.4,39000,3,61590,0,0,0,0,0,0,0,39000,-39000,-39000
20200430,054768,泰碩國票99購02,2.21,2.21,2.14,2.14,-0.06,-2.73,40000,2,86300,0,0,0,0,0,0,40000,0,40000,40000
20200430,054769,創意國票98購01,,,,,0.00,0.00,0,0,0,0,0,0,0,0,0,0,0,0,0
20200430,05476P,聯發科群益95售06,1.64,1.65,1.58,1.58,-0.67,-29.78,25000,8,40940,0,0,0,0,0,0,25000,0,25000,25000
20200430,054770,健策國票98購01,0.72,0.72,0.72,0.72,0.00,0.00,1000,1,720,0,0,0,0,0,0,1000,0,1000,1000
20200430,054771,茂林國票98購02,1.46,1.46,1.36,1.36,-0.16,-10.53,173000,4,246240,0,0,0,0,0,0,173000,0,173000,173000
20200430,054772,康控國票98購02,0.91,0.97,0.87,0.97,+0.29,42.65,464000,11,432500,0,0,0,0,0,0,44000,420000,-376000,-376000
20200430,054773,台郡國票98購01,,,,,0.00,0.00,0,0,0,0,0,0,0,0,0,0,0,0,0
20200430,054774,同欣電國票98購01,0.07,0.07,0.07,0.07,+0.02,40.0,10000,1,700,0,0,0,0,0,0,0,0,0,0
20200430,054775,復盛國票98購01,,,,,0.00,0.00,0,0,0,0,0,0,0,0,0,0,0,0,0
20200430,054776,矽創國票98購01,,,,,0.00,0.00,0,0,0,0,0,0,0,0,0,0,0,0,0
20200430,054777,昇陽半國票98購01,,,,,0.00,0.00,0,0,0,0,0,0,0,0,0,0,0,0,0
20200430,054778,世紀鋼國票99購01,3.95,4.22,3.85,4.20,+0.35,9.09,152000,16,611700,0,0,0,0,0,0,43000,97000,-54000,-54000
20200430,054779,台塑群益98購01,0.11,0.23,0.11,0.23,+0.13,130.0,461000,18,57400,0,0,0,0,0,0,0,0,0,0
20200430,05477P,華新科群益95售06,,,,,0.00,0.00,0,0,0,0,0,0,0,0,0,0,0,0,0
20200430,054780,中石化群益99購01,0.16,0.16,0.16,0.16,0.00,0.00,50000,1,8000,0,0,0,0,0,0,0,50000,-50000,-50000
20200430,054781,台化群益99購01,,,,,0.00,0.00,0,0,0,0,0,0,0,0,0,0,0,0,0
20200430,054782,國巨群益97購01,,,,,0.00,0.00,0,0,0,0,0,0,0,0,0,0,0,0,0
20200430,054783,國巨群益98購04,,,,,0.00,0.00,0,0,0,0,0,0,0,0,0,0,0,0,0
20200430,054784,順德群益9A購01,0.43,0.43,0.43,0.43,0.00,0.00,2000,1,860,0,0,0,0,0,0,0,0,0,0
20200430,054785,建準群益98購01,0.50,0.50,0.48,0.48,-0.04,-7.69,45000,5,22050,0,0,0,0,0,0,45000,0,45000,45000
20200430,054786,全新群益99購02,,,,,0.00,0.00,0,0,0,0,0,0,0,0,0,0,0,0,0
20200430,054787,華新科群益97購04,,,,,0.00,0.00,0,0,0,0,0,0,0,0,0,0,0,0,0
20200430,054788,華新科群益98購02,,,,,0.00,0.00,0,0,0,0,0,0,0,0,0,0,0,0,0
20200430,054789,高鐵群益98購01,0.22,0.22,0.22,0.22,-0.05,-18.52,8000,1,1760,0,0,0,0,0,0,8000,0,8000,8000
20200430,05478P,智伸科國票96售02,,,,,0.00,0.00,0,0,0,0,0,0,0,0,0,0,0,0,0
20200430,054790,禾伸堂群益98購01,1.46,1.46,1.46,1.46,+0.02,1.39,170000,2,248200,0,0,0,0,0,0,170000,0,170000,170000
20200430,054791,泰碩群益99購02,1.49,1.54,1.45,1.48,-0.01,-0.67,63000,7,93080,0,0,0,0,0,0,20000,43000,-23000,-23000
20200430,054792,揚明光群益97購01,0.97,0.99,0.97,0.99,-0.03,-2.94,113000,3,109910,0,0,0,0,0,0,9000,104000,-95000,-95000
20200430,054793,牧德群益9A購01,,,,,0.00,0.00,0,0,0,0,0,0,0,0,0,0,0,0,0
20200430,054794,貿聯群益98購01,0.27,0.27,0.27,0.27,+0.11,68.75,100000,1,27000,0,0,0,0,0,0,100000,0,100000,100000
20200430,054795,合勤控群益98購01,0.92,0.92,0.79,0.79,+0.04,5.33,80000,6,70690,0,0,0,0,0,0,60000,20000,40000,40000
20200430,054796,康普群益98購01,0.35,0.45,0.35,0.45,+0.05,12.5,14000,3,5000,0,0,0,0,0,0,0,0,0,0
20200430,054797,臻鼎群益97購01,,,,,0.00,0.00,0,0,0,0,0,0,0,0,0,0,0,0,0
20200430,054798,超眾群益97購01,,,,,0.00,0.00,0,0,0,0,0,0,0,0,0,0,0,0,0
20200430,054799,超眾群益98購01,1.44,1.57,1.44,1.57,+0.10,6.8,51000,3,77980,0,0,0,0,0,0,1000,50000,-49000,-49000
20200430,05479P,華新科台新96售01,,,,,0.00,0.00,0,0,0,0,0,0,0,0,0,0,0,0,0
20200430,054800,訊芯群益99購01,,,,,0.00,0.00,0,0,0,0,0,0,0,0,0,0,0,0,0
20200430,054801,康友群益97購02,0.59,0.59,0.59,0.59,0.00,0.00,20000,1,11800,0,0,0,0,0,0,0,20000,-20000,-20000
20200430,054802,高股息元大97購01,,,,,0.00,0.00,0,0,0,0,0,0,0,0,0,0,0,0,0
20200430,054803,味全元大9A購01,0.89,0.90,0.89,0.89,0.00,0.00,7000,3,6240,0,0,0,0,0,0,7000,0,7000,7000
20200430,054804,南亞元大9A購01,0.35,0.55,0.35,0.55,+0.25,83.33,21000,4,9090,0,0,0,0,0,0,20000,0,20000,20000
20200430,054805,台苯元大9A購01,0.61,0.67,0.60,0.66,+0.06,10.0,1332000,30,867920,0,0,0,0,0,0,1006000,184000,822000,822000
20200430,054806,台化元大9A購01,0.57,0.74,0.57,0.72,0.00,0.00,46000,7,33790,0,0,0,0,0,0,5000,40000,-35000,-35000
20200430,054807,台化元大9A購02,2.28,2.81,2.28,2.78,+0.57,25.79,814000,44,2094830,0,0,0,0,0,0,251000,531000,-280000,-280000
20200430,054808,東元元大9A購01,1.45,1.45,1.45,1.45,0.00,0.00,5000,1,7250,0,0,0,0,0,0,0,5000,-5000,-5000
20200430,054809,大成鋼元大97購01,,,,,0.00,0.00,0,0,0,0,0,0,0,0,0,0,0,0,0
20200430,05480P,滬深2X凱基96售05,2.04,2.05,2.04,2.05,0.00,0.00,183000,7,373950,0,0,0,0,0,0,183000,183000,0,0
20200430,054810,中橡元大9A購01,0.20,0.20,0.20,0.20,-0.03,-13.04,5000,1,1000,0,0,0,0,0,0,0,0,0,0
20200430,054811,裕隆元大9A購01,,,,,0.00,0.00,0,0,0,0,0,0,0,0,0,0,0,0,0
20200430,054812,鴻海元大97購08,,,,,0.00,0.00,0,0,0,0,0,0,0,0,0,0,0,0,0
20200430,054813,鴻海元大97購09,,,,,0.00,0.00,0,0,0,0,0,0,0,0,0,0,0,0,0
20200430,054814,台積電元大97購13,,,,,0.00,0.00,0,0,0,0,0,0,0,0,0,0,0,0,0
20200430,054815,台積電元大97購14,,,,,0.00,0.00,0,0,0,0,0,0,0,0,0,0,0,0,0
20200430,054816,聯發科元大97購12,,,,,0.00,0.00,0,0,0,0,0,0,0,0,0,0,0,0,0
20200430,054817,聯發科元大97購13,,,,,0.00,0.00,0,0,0,0,0,0,0,0,0,0,0,0,0
20200430,054818,奇力新元大97購05,,,,,0.00,0.00,0,0,0,0,0,0,0,0,0,0,0,0,0
20200430,054819,裕民元大9A購01,0.94,0.99,0.93,0.99,+0.03,3.12,1108000,36,1059720,0,0,0,0,0,0,431000,576000,-145000,-145000
20200430,05481P,鴻海凱基95售21,,,,,0.00,0.00,0,0,0,0,0,0,0,0,0,0,0,0,0
20200430,054820,新日興元大97購01,,,,,0.00,0.00,0,0,0,0,0,0,0,0,0,0,0,0,0
20200430,054821,貿聯元大9A購01,0.37,0.54,0.37,0.52,+0.21,67.74,54000,8,23030,0,0,0,0,0,0,0,12000,-12000,-12000
20200430,054822,祥碩元大97購01,5.90,5.90,5.90,5.90,-0.50,-7.81,2000,1,11800,0,0,0,0,0,0,2000,0,2000,2000
20200430,054823,祥碩元大97購02,5.35,5.40,5.35,5.40,0.00,0.00,30000,3,161000,0,0,0,0,0,0,20000,30000,-10000,-10000
20200430,054824,同欣電元大97購04,,,,,0.00,0.00,0,0,0,0,0,0,0,0,0,0,0,0,0
20200430,054825,康友元大97購01,,,,,0.00,0.00,0,0,0,0,0,0,0,0,0,0,0,0,0
20200430,054826,復盛元大9A購01,2.22,2.33,2.13,2.33,+0.09,4.02,618000,26,1375700,0,0,0,0,0,0,571000,47000,524000,524000
20200430,054827,宏全元大9A購01,,,,,0.00,0.00,0,0,0,0,0,0,0,0,0,0,0,0,0
20200430,054828,正崴國泰99購01,0.85,0.85,0.84,0.85,+0.07,8.97,292000,11,248050,0,0,0,0,0,0,255000,0,255000,255000
20200430,054829,亞光國泰99購01,,,,,0.00,0.00,0,0,0,0,0,0,0,0,0,0,0,0,0
20200430,05482P,鴻海凱基95售22,,,,,0.00,0.00,0,0,0,0,0,0,0,0,0,0,0,0,0
20200430,054830,世芯國泰99購01,3.80,4.59,3.80,4.59,+1.28,38.67,20000,5,90060,0,0,0,0,0,0,4000,15000,-11000,-11000
20200430,054831,緯穎國泰98購01,3.78,4.74,3.71,4.48,+0.93,26.2,207000,40,890440,0,0,0,0,0,0,59000,161000,-102000,-102000
20200430,054832,興勤中信97購01,,,,,0.00,0.00,0,0,0,0,0,0,0,0,0,0,0,0,0
20200430,054833,京鼎中信97購01,,,,,0.00,0.00,0,0,0,0,0,0,0,0,0,0,0,0,0
20200430,054834,帆宣中信97購01,0.04,0.08,0.04,0.08,+0.04,100.0,140000,9,7420,0,0,0,0,0,0,125000,14000,111000,111000
20200430,054835,致新中信97購01,0.20,0.24,0.19,0.23,+0.03,15.0,310000,50,64010,0,0,0,0,0,0,140000,120000,20000,20000
20200430,054836,勤誠中信97購01,,,,,0.00,0.00,0,0,0,0,0,0,0,0,0,0,0,0,0
20200430,054837,欣興第一97購01,,,,,0.00,0.00,0,0,0,0,0,0,0,0,0,0,0,0,0
20200430,054838,京鼎第一97購01,,,,,0.00,0.00,0,0,0,0,0,0,0,0,0,0,0,0,0
20200430,054839,中石化亞東98購01,0.10,0.10,0.10,0.10,0.00,0.00,1000,1,100,0,0,0,0,0,0,0,1000,-1000,-1000
20200430,05483P,國巨凱基95售07,,,,,0.00,0.00,0,0,0,0,0,0,0,0,0,0,0,0,0
20200430,054840,T50反1兆豐98購01,1.30,1.30,1.30,1.30,-0.20,-13.33,5000,1,6500,0,0,0,0,0,0,0,5000,-5000,-5000
20200430,054841,亞德客兆豐97購01,2.55,3.00,2.55,3.00,+0.95,46.34,6000,6,15990,0,0,0,0,0,0,6000,0,6000,6000
20200430,054842,台達電兆豐98購01,2.14,2.40,2.09,2.40,+0.38,18.81,327000,26,744190,0,0,0,0,0,0,85000,242000,-157000,-157000
20200430,054843,中環兆豐97購01,0.19,0.20,0.17,0.17,+0.02,13.33,528000,10,98630,0,0,0,0,0,0,218000,309000,-91000,-91000
20200430,054844,華邦電兆豐98購01,0.50,0.54,0.50,0.53,0.00,0.00,108000,5,57620,0,0,0,0,0,0,22000,86000,-64000,-64000
20200430,054845,智邦兆豐98購01,3.55,3.55,3.40,3.40,-0.20,-5.56,52000,6,180100,0,0,0,0,0,0,28000,24000,4000,4000
20200430,054846,瑞昱兆豐97購01,3.63,4.10,3.59,4.10,+0.77,23.12,18000,4,65430,0,0,0,0,0,0,12000,6000,6000,6000
20200430,054847,創意兆豐97購01,0.39,0.39,0.39,0.39,+0.04,11.43,10000,1,3900,0,0,0,0,0,0,0,10000,-10000,-10000
20200430,054848,群創兆豐98購01,0.03,0.03,0.03,0.03,0.00,0.00,10000,2,300,0,0,0,0,0,0,0,10000,-10000,-10000
20200430,054849,日月光兆豐97購01,,,,,0.00,0.00,0,0,0,0,0,0,0,0,0,0,0,0,0
20200430,05484P,台積電凱基95售18,,,,,0.00,0.00,0,0,0,0,0,0,0,0,0,0,0,0,0
20200430,054850,上海銀兆豐97購01,0.09,0.09,0.09,0.09,0.00,0.00,10000,1,900,0,0,0,0,0,0,0,10000,-10000,-10000
20200430,054851,樺漢兆豐97購01,,,,,0.00,0.00,0,0,0,0,0,0,0,0,0,0,0,0,0
20200430,054852,奇鋐國票98購01,1.86,1.91,1.79,1.91,+0.14,7.91,166000,5,304600,0,0,0,0,0,0,88000,78000,10000,10000
20200430,054853,TPK國票98購02,,,,,0.00,0.00,0,0,0,0,0,0,0,0,0,0,0,0,0
20200430,054854,台積電麥證97購01,,,,,0.00,0.00,0,0,0,0,0,0,0,0,0,0,0,0,0
20200430,054855,得力群益98購01,0.65,0.69,0.65,0.69,+0.08,13.11,150000,2,99500,0,0,0,0,0,0,100000,50000,50000,50000
20200430,054856,得力群益99購01,,,,,0.00,0.00,0,0,0,0,0,0,0,0,0,0,0,0,0
20200430,054857,信錦群益97購01,,,,,0.00,0.00,0,0,0,0,0,0,0,0,0,0,0,0,0
20200430,054858,台肥群益97購01,0.28,0.28,0.28,0.28,0.00,0.00,10000,1,2800,0,0,0,0,0,0,0,10000,-10000,-10000
20200430,054859,鴻海群益97購02,0.53,0.56,0.53,0.56,+0.03,5.66,43000,4,24020,0,0,0,0,0,0,2000,41000,-39000,-39000
20200430,05485P,旺宏凱基95售08,0.33,0.35,0.32,0.35,-0.13,-27.08,340000,34,112700,0,0,0,0,0,0,10000,330000,-320000,-320000
20200430,054860,台積電群益98購01,0.06,0.08,0.06,0.08,+0.02,33.33,90000,3,6400,0,0,0,0,0,0,10000,0,10000,10000
20200430,054861,智邦群益97購01,9.95,9.95,8.30,8.40,-1.05,-11.11,12000,6,115800,0,0,0,0,0,0,10000,5000,5000,5000
20200430,054862,群光群益97購01,0.82,0.83,0.76,0.83,-0.01,-1.19,246000,10,197220,0,0,0,0,0,0,246000,0,246000,246000
20200430,054863,億光群益97購01,0.76,0.76,0.76,0.76,0.00,0.00,79000,1,60040,0,0,0,0,0,0,0,79000,-79000,-79000
20200430,054864,聯發科群益97購02,,,,,0.00,0.00,0,0,0,0,0,0,0,0,0,0,0,0,0
20200430,054865,可成群益97購01,,,,,0.00,0.00,0,0,0,0,0,0,0,0,0,0,0,0,0
20200430,054866,宏盛群益98購01,,,,,0.00,0.00,0,0,0,0,0,0,0,0,0,0,0,0,0
20200430,054867,華航群益99購01,0.36,0.37,0.34,0.34,+0.04,13.33,52000,3,18710,0,0,0,0,0,0,50000,0,50000,50000
20200430,054868,國泰金群益9A購01,0.22,0.22,0.20,0.22,+0.06,37.5,251000,13,53560,0,0,0,0,0,0,231000,0,231000,231000
20200430,054869,新光金群益97購01,,,,,0.00,0.00,0,0,0,0,0,0,0,0,0,0,0,0,0
20200430,05486P,大立光凱基95售14,1.92,1.92,1.92,1.92,0.00,0.00,37000,1,71040,0,0,0,0,0,0,37000,37000,0,0
20200430,054870,新日興群益98購01,,,,,0.00,0.00,0,0,0,0,0,0,0,0,0,0,0,0,0
20200430,054871,明泰群益98購01,0.73,0.73,0.66,0.67,-0.04,-5.63,10000,3,6980,0,0,0,0,0,0,8000,0,8000,8000
20200430,054872,瀚宇博群益98購01,2.28,2.32,2.27,2.32,0.00,0.00,59000,4,134800,0,0,0,0,0,0,0,59000,-59000,-59000
20200430,054873,帆宣群益99購01,0.66,0.75,0.66,0.75,+0.07,10.29,130000,6,90400,0,0,0,0,0,0,10000,120000,-110000,-110000
20200430,054874,帆宣群益99購02,0.74,0.82,0.74,0.82,0.00,0.00,139000,6,106980,0,0,0,0,0,0,0,139000,-139000,-139000
20200430,054875,群電群益97購01,0.47,0.47,0.47,0.47,0.00,0.00,98000,1,46060,0,0,0,0,0,0,0,98000,-98000,-98000
20200430,054876,群電群益97購02,,,,,0.00,0.00,0,0,0,0,0,0,0,0,0,0,0,0,0
20200430,054877,百和群益98購01,,,,,0.00,0.00,0,0,0,0,0,0,0,0,0,0,0,0,0
20200430,054878,和大統一97購02,,,,,0.00,0.00,0,0,0,0,0,0,0,0,0,0,0,0,0
20200430,054879,大成鋼統一97購01,,,,,0.00,0.00,0,0,0,0,0,0,0,0,0,0,0,0,0
20200430,05487P,台表科凱基95售02,,,,,0.00,0.00,0,0,0,0,0,0,0,0,0,0,0,0,0
20200430,054880,華泰統一97購01,0.70,0.70,0.65,0.65,-0.06,-8.45,99000,3,66750,0,0,0,0,0,0,51000,48000,3000,3000
20200430,054881,光罩統一97購01,1.01,1.07,0.98,1.07,+0.04,3.88,190000,9,194950,0,0,0,0,0,0,66000,124000,-58000,-58000
20200430,054882,台光電統一97購02,0.81,0.91,0.80,0.91,+0.14,18.18,354000,7,304710,0,0,0,0,0,0,96000,258000,-162000,-162000
20200430,054883,億光統一97購01,1.95,1.98,1.87,1.89,-0.02,-1.05,81000,5,155670,0,0,0,0,0,0,13000,68000,-55000,-55000
20200430,054884,友達統一99購01,,,,,0.00,0.00,0,0,0,0,0,0,0,0,0,0,0,0,0
20200430,054885,建準統一98購01,,,,,0.00,0.00,0,0,0,0,0,0,0,0,0,0,0,0,0
20200430,054886,大毅統一97購01,4.91,5.10,4.91,4.99,+0.49,10.89,34000,4,168670,0,0,0,0,0,0,12000,23000,-11000,-11000
20200430,054887,大毅統一98購01,,,,,0.00,0.00,0,0,0,0,0,0,0,0,0,0,0,0,0
20200430,054888,泰碩統一97購01,0.40,0.40,0.40,0.40,-0.20,-33.33,2000,1,800,0,0,0,0,0,0,2000,0,2000,2000
20200430,054889,京鼎統一99購01,,,,,0.00,0.00,0,0,0,0,0,0,0,0,0,0,0,0,0
20200430,05488P,臺股指凱基95售21,,,,,0.00,0.00,0,0,0,0,0,0,0,0,0,0,0,0,0
20200430,054890,聯鈞統一99購01,2.15,2.15,2.08,2.08,-0.21,-9.17,55000,4,117400,0,0,0,0,0,0,0,55000,-55000,-55000
20200430,054891,聯鈞統一99購02,0.40,0.40,0.40,0.40,-0.10,-20.0,3000,2,1200,0,0,0,0,0,0,2000,0,2000,2000
20200430,054892,彩晶統一99購01,,,,,0.00,0.00,0,0,0,0,0,0,0,0,0,0,0,0,0
20200430,054893,帆宣統一99購01,,,,,0.00,0.00,0,0,0,0,0,0,0,0,0,0,0,0,0
20200430,054894,GIS統一97購01,,,,,0.00,0.00,0,0,0,0,0,0,0,0,0,0,0,0,0
20200430,054895,南電統一97購01,6.05,6.05,6.05,6.05,-0.10,-1.63,1000,1,6050,0,0,0,0,0,0,1000,0,1000,1000
20200430,054896,聯茂日盛97購01,1.41,1.41,1.41,1.41,0.00,0.00,80000,2,112800,0,0,0,0,0,0,80000,0,80000,80000
20200430,054897,信錦康和97購01,0.88,0.89,0.88,0.88,-0.02,-2.22,78000,4,68830,0,0,0,0,0,0,59000,19000,40000,40000
20200430,054898,台肥康和97購01,0.50,0.53,0.50,0.53,+0.03,6.0,78000,2,39960,0,0,0,0,0,0,46000,32000,14000,14000
20200430,054899,南港康和97購01,,,,,0.00,0.00,0,0,0,0,0,0,0,0,0,0,0,0,0
20200430,05489P,臺股指凱基95售22,,,,,0.00,0.00,0,0,0,0,0,0,0,0,0,0,0,0,0
20200430,054900,金寶康和97購01,0.39,0.45,0.39,0.45,+0.01,2.27,31000,10,12710,0,0,0,0,0,0,21000,0,21000,21000
20200430,054901,群光康和97購01,,,,,0.00,0.00,0,0,0,0,0,0,0,0,0,0,0,0,0
20200430,054902,億光康和97購01,,,,,0.00,0.00,0,0,0,0,0,0,0,0,0,0,0,0,0
20200430,054903,億光康和97購02,,,,,0.00,0.00,0,0,0,0,0,0,0,0,0,0,0,0,0
20200430,054904,興勤康和97購01,0.56,0.58,0.56,0.58,0.00,0.00,69000,2,39220,0,0,0,0,0,0,40000,29000,11000,11000
20200430,054905,國揚康和97購01,3.76,3.76,3.42,3.71,+0.01,0.27,28000,4,100610,0,0,0,0,0,0,18000,10000,8000,8000
20200430,054906,神達康和97購01,,,,,0.00,0.00,0,0,0,0,0,0,0,0,0,0,0,0,0
20200430,054907,帆宣康和97購01,0.57,0.60,0.57,0.60,0.00,0.00,58000,2,33900,0,0,0,0,0,0,0,58000,-58000,-58000
20200430,054908,群電康和97購01,1.25,1.28,1.25,1.28,+0.08,6.67,34000,2,43100,0,0,0,0,0,0,0,34000,-34000,-34000
20200430,054909,福懋科康和97購01,0.63,0.63,0.63,0.63,0.00,0.00,8000,1,5040,0,0,0,0,0,0,8000,0,8000,8000
20200430,05490P,鴻海元大95售23,,,,,0.00,0.00,0,0,0,0,0,0,0,0,0,0,0,0,0
20200430,054910,信錦凱基97購01,,,,,0.00,0.00,0,0,0,0,0,0,0,0,0,0,0,0,0
20200430,054911,敬鵬凱基97購01,,,,,0.00,0.00,0,0,0,0,0,0,0,0,0,0,0,0,0
20200430,054912,群光凱基97購01,0.90,0.91,0.88,0.89,-0.02,-2.2,340000,24,304160,0,0,0,0,0,0,320000,37000,283000,283000
20200430,054913,億光凱基97購01,,,,,0.00,0.00,0,0,0,0,0,0,0,0,0,0,0,0,0
20200430,054914,億光凱基98購01,,,,,0.00,0.00,0,0,0,0,0,0,0,0,0,0,0,0,0
20200430,054915,興勤凱基97購01,0.68,0.72,0.68,0.72,+0.05,7.46,134000,6,94480,0,0,0,0,0,0,0,134000,-134000,-134000
20200430,054916,聯發科凱基98購04,,,,,0.00,0.00,0,0,0,0,0,0,0,0,0,0,0,0,0
20200430,054917,聯發科凱基98購05,,,,,0.00,0.00,0,0,0,0,0,0,0,0,0,0,0,0,0
20200430,054918,華新科凱基98購02,,,,,0.00,0.00,0,0,0,0,0,0,0,0,0,0,0,0,0
20200430,054919,興富發凱基97購01,1.06,1.12,1.06,1.12,-0.01,-0.88,224000,4,241470,0,0,0,0,0,0,174000,68000,106000,106000
20200430,05491P,茂林元大95售04,,,,,0.00,0.00,0,0,0,0,0,0,0,0,0,0,0,0,0
20200430,054920,智原凱基98購01,,,,,0.00,0.00,0,0,0,0,0,0,0,0,0,0,0,0,0
20200430,054921,文曄凱基97購01,0.99,0.99,0.97,0.99,0.00,0.00,355000,14,348660,0,0,0,0,0,0,283000,72000,211000,211000
20200430,054922,文曄凱基98購01,0.68,0.71,0.68,0.71,+0.01,1.43,127000,6,89330,0,0,0,0,0,0,127000,0,127000,127000
20200430,054923,晶技凱基98購01,8.35,8.80,8.25,8.80,+0.65,7.98,33000,9,277350,0,0,0,0,0,0,21000,12000,9000,9000
20200430,054924,景碩凱基98購01,0.95,0.95,0.95,0.95,0.00,0.00,1000,1,950,0,0,0,0,0,0,1000,0,1000,1000
20200430,054925,神達凱基97購01,1.68,1.68,1.67,1.67,+0.03,1.83,24000,3,40120,0,0,0,0,0,0,10000,14000,-4000,-4000
20200430,054926,神達凱基98購01,0.87,0.87,0.86,0.87,0.00,0.00,123000,3,106510,0,0,0,0,0,0,123000,0,123000,123000
20200430,054927,帆宣凱基97購01,,,,,0.00,0.00,0,0,0,0,0,0,0,0,0,0,0,0,0
20200430,054928,帆宣凱基98購01,0.80,0.98,0.80,0.98,+0.12,13.95,346000,14,299030,0,0,0,0,0,0,64000,282000,-218000,-218000
20200430,054929,群電凱基97購01,0.67,0.67,0.66,0.66,0.00,0.00,34000,3,22580,0,0,0,0,0,0,0,34000,-34000,-34000
20200430,05492P,聯茂元大95售02,,,,,0.00,0.00,0,0,0,0,0,0,0,0,0,0,0,0,0
20200430,054930,群電凱基98購01,1.72,1.82,1.72,1.82,+0.22,13.75,68000,5,122560,0,0,0,0,0,0,30000,38000,-8000,-8000
20200430,054931,緯穎凱基98購01,1.18,1.18,1.18,1.18,0.00,0.00,10000,1,11800,0,0,0,0,0,0,10000,0,10000,10000
20200430,054932,台肥元大97購01,0.68,0.70,0.68,0.70,+0.06,9.38,239000,4,166480,0,0,0,0,0,0,71000,168000,-97000,-97000
20200430,054933,南港元大97購01,0.72,0.72,0.72,0.72,+0.25,53.19,1000,1,720,0,0,0,0,0,0,0,0,0,0
20200430,054934,金寶元大97購01,0.81,0.83,0.78,0.79,-0.10,-11.24,86000,11,68830,0,0,0,0,0,0,0,81000,-81000,-81000
20200430,054935,華通元大98購03,1.19,1.36,1.19,1.36,+0.16,13.33,241000,10,308500,0,0,0,0,0,0,83000,158000,-75000,-75000
20200430,054936,鴻海元大97購10,0.65,0.67,0.64,0.67,+0.04,6.35,70000,6,45260,0,0,0,0,0,0,70000,0,70000,70000
20200430,054937,國巨元大97購03,0.33,0.33,0.33,0.33,0.00,0.00,1000,1,330,0,0,0,0,0,0,0,0,0,0
20200430,054938,國巨元大97購04,,,,,0.00,0.00,0,0,0,0,0,0,0,0,0,0,0,0,0
20200430,054939,台積電元大97購15,,,,,0.00,0.00,0,0,0,0,0,0,0,0,0,0,0,0,0
20200430,05493P,華新科富邦99售02,,,,,0.00,0.00,0,0,0,0,0,0,0,0,0,0,0,0,0
20200430,054940,台積電元大97購16,0.33,0.33,0.33,0.33,0.00,0.00,10000,1,3300,0,0,0,0,0,0,10000,0,10000,10000
20200430,054941,凱美元大97購01,0.62,0.62,0.60,0.60,+0.06,11.11,96000,3,59460,0,0,0,0,0,0,3000,93000,-90000,-90000
20200430,054942,凱美元大97購02,0.11,0.11,0.11,0.11,0.00,0.00,1000,1,110,0,0,0,0,0,0,1000,0,1000,1000
20200430,054943,群光元大97購01,1.69,1.69,1.60,1.67,+0.01,0.6,873000,24,1433840,0,0,0,0,0,0,673000,228000,445000,445000
20200430,054944,精元元大97購01,,,,,0.00,0.00,0,0,0,0,0,0,0,0,0,0,0,0,0
20200430,054945,正崴元大97購01,,,,,0.00,0.00,0,0,0,0,0,0,0,0,0,0,0,0,0
20200430,054946,億光元大97購01,,,,,0.00,0.00,0,0,0,0,0,0,0,0,0,0,0,0,0
20200430,054947,興勤元大97購01,0.82,0.89,0.80,0.89,+0.07,8.54,443000,18,373630,0,0,0,0,0,0,202000,241000,-39000,-39000
20200430,054948,聯發科元大97購14,,,,,0.00,0.00,0,0,0,0,0,0,0,0,0,0,0,0,0
20200430,054949,奇力新元大98購01,,,,,0.00,0.00,0,0,0,0,0,0,0,0,0,0,0,0,0
20200430,05494P,華邦電統一95售02,,,,,0.00,0.00,0,0,0,0,0,0,0,0,0,0,0,0,0
20200430,054950,奇力新元大98購02,0.72,0.77,0.70,0.73,+0.05,7.35,253000,9,184560,0,0,0,0,0,0,10000,243000,-233000,-233000
20200430,054951,大毅元大97購01,5.75,6.55,5.55,6.35,+1.38,27.77,125000,13,758700,0,0,0,0,0,0,70000,56000,14000,14000
20200430,054952,大毅元大97購02,4.18,4.18,4.18,4.18,+0.28,7.18,2000,1,8360,0,0,0,0,0,0,0,0,0,0
20200430,054953,華新科元大97購05,,,,,0.00,0.00,0,0,0,0,0,0,0,0,0,0,0,0,0
20200430,054954,華新科元大97購06,,,,,0.00,0.00,0,0,0,0,0,0,0,0,0,0,0,0,0
20200430,054955,宏達電元大98購01,,,,,0.00,0.00,0,0,0,0,0,0,0,0,0,0,0,0,0
20200430,054956,宏盛元大97購01,0.06,0.06,0.06,0.06,0.00,0.00,50000,5,3000,0,0,0,0,0,0,0,50000,-50000,-50000
20200430,054957,興富發元大97購01,2.34,2.34,2.19,2.19,-0.08,-3.52,109000,12,244710,0,0,0,0,0,0,109000,0,109000,109000
20200430,054958,亞光元大97購03,,,,,0.00,0.00,0,0,0,0,0,0,0,0,0,0,0,0,0
20200430,054959,禾伸堂元大98購01,,,,,0.00,0.00,0,0,0,0,0,0,0,0,0,0,0,0,0
20200430,05495P,大立光統一95售07,,,,,0.00,0.00,0,0,0,0,0,0,0,0,0,0,0,0,0
20200430,054960,新日興元大97購02,,,,,0.00,0.00,0,0,0,0,0,0,0,0,0,0,0,0,0
20200430,054961,玉晶光元大99購01,0.36,0.42,0.36,0.42,+0.10,31.25,86000,12,34070,0,0,0,0,0,0,78000,0,78000,78000
20200430,054962,玉晶光元大99購02,,,,,0.00,0.00,0,0,0,0,0,0,0,0,0,0,0,0,0
20200430,054963,牧德元大97購02,,,,,0.00,0.00,0,0,0,0,0,0,0,0,0,0,0,0,0
20200430,054964,智易元大99購01,,,,,0.00,0.00,0,0,0,0,0,0,0,0,0,0,0,0,0
20200430,054965,健策元大98購04,,,,,0.00,0.00,0,0,0,0,0,0,0,0,0,0,0,0,0
20200430,054966,貿聯元大98購02,0.24,0.24,0.24,0.24,0.00,0.00,20000,2,4800,0,0,0,0,0,0,0,20000,-20000,-20000
20200430,054967,神達元大97購01,2.19,2.19,2.19,2.19,0.00,0.00,15000,2,32850,0,0,0,0,0,0,15000,0,15000,15000
20200430,054968,佐登元大97購01,,,,,0.00,0.00,0,0,0,0,0,0,0,0,0,0,0,0,0
20200430,054969,亞翔元大97購01,0.55,0.55,0.55,0.55,0.00,0.00,80000,3,44000,0,0,0,0,0,0,70000,10000,60000,60000
20200430,05496P,聯詠統一95售04,,,,,0.00,0.00,0,0,0,0,0,0,0,0,0,0,0,0,0
20200430,054970,帆宣元大97購01,0.63,0.82,0.63,0.82,+0.13,18.84,314000,5,208900,0,0,0,0,0,0,200000,114000,86000,86000
20200430,054971,帆宣元大97購02,0.63,0.63,0.63,0.63,+0.14,28.57,13000,1,8190,0,0,0,0,0,0,13000,0,13000,13000
20200430,054972,聯茂元大97購02,,,,,0.00,0.00,0,0,0,0,0,0,0,0,0,0,0,0,0
20200430,054973,台郡元大98購02,,,,,0.00,0.00,0,0,0,0,0,0,0,0,0,0,0,0,0
20200430,054974,台表科元大98購02,1.21,1.21,1.16,1.18,+0.01,0.85,138000,4,163520,0,0,0,0,0,0,70000,70000,0,0
20200430,054975,福懋科元大97購01,1.08,1.09,1.08,1.09,0.00,0.00,40000,2,43400,0,0,0,0,0,0,40000,0,40000,40000
20200430,054976,上証2X元富9A購01,,,,,0.00,0.00,0,0,0,0,0,0,0,0,0,0,0,0,0
20200430,054977,SP黃豆元富9B購01,0.50,0.50,0.50,0.50,+0.03,6.38,50000,7,25000,0,0,0,0,0,0,0,5000,-5000,-5000
20200430,054978,堤維西元富97購01,0.54,0.54,0.54,0.54,0.00,0.00,26000,1,14040,0,0,0,0,0,0,26000,0,26000,26000
20200430,054979,南港元富97購01,,,,,0.00,0.00,0,0,0,0,0,0,0,0,0,0,0,0,0
20200430,05497P,聯詠統一96售01,,,,,0.00,0.00,0,0,0,0,0,0,0,0,0,0,0,0,0
20200430,054980,國巨元富97購01,0.22,0.25,0.20,0.22,-0.02,-8.33,277000,9,61200,0,0,0,0,0,0,149000,0,149000,149000
20200430,054981,國巨元富97購02,0.16,0.16,0.16,0.16,0.00,0.00,5000,2,800,0,0,0,0,0,0,0,0,0,0
20200430,054982,國巨元富97購03,0.12,0.13,0.08,0.11,+0.03,37.5,142000,12,15760,0,0,0,0,0,0,0,0,0,0
20200430,054983,國巨元富97購04,0.07,0.07,0.05,0.06,-0.01,-14.29,704000,18,45400,0,0,0,0,0,0,0,0,0,0
20200430,054984,華泰元富97購01,0.10,0.10,0.10,0.10,-0.10,-50.0,30000,2,3000,0,0,0,0,0,0,0,0,0,0
20200430,054985,光罩元富97購01,,,,,0.00,0.00,0,0,0,0,0,0,0,0,0,0,0,0,0
20200430,054986,藍天元富97購01,,,,,0.00,0.00,0,0,0,0,0,0,0,0,0,0,0,0,0
20200430,054987,凱美元富97購01,,,,,0.00,0.00,0,0,0,0,0,0,0,0,0,0,0,0,0
20200430,054988,凱美元富97購02,,,,,0.00,0.00,0,0,0,0,0,0,0,0,0,0,0,0,0
20200430,054989,精元元富97購01,1.15,1.18,1.09,1.14,-0.01,-0.87,85000,9,97600,0,0,0,0,0,0,30000,55000,-25000,-25000
20200430,05498P,友達元富95售02,0.60,0.60,0.60,0.60,0.00,0.00,110000,11,66000,0,0,0,0,0,0,0,110000,-110000,-110000
20200430,054990,凌陽元富97購01,0.08,0.08,0.08,0.08,0.00,0.00,1000,1,80,0,0,0,0,0,0,1000,0,1000,1000
20200430,054991,南亞科元富97購01,,,,,0.00,0.00,0,0,0,0,0,0,0,0,0,0,0,0,0
20200430,054992,南亞科元富97購02,,,,,0.00,0.00,0,0,0,0,0,0,0,0,0,0,0,0,0
20200430,054993,南亞科元富97購03,,,,,0.00,0.00,0,0,0,0,0,0,0,0,0,0,0,0,0
20200430,054994,建準元富97購01,0.57,0.57,0.53,0.53,-0.10,-15.87,30000,11,16700,0,0,0,0,0,0,30000,0,30000,30000
20200430,054995,宏盛元富97購01,,,,,0.00,0.00,0,0,0,0,0,0,0,0,0,0,0,0,0
20200430,054996,聯陽元富97購01,1.19,1.22,1.19,1.19,0.00,0.00,36000,5,43440,0,0,0,0,0,0,36000,0,36000,36000
20200430,054997,文曄元富97購01,,,,,0.00,0.00,0,0,0,0,0,0,0,0,0,0,0,0,0
20200430,054998,玉晶光元富97購02,,,,,0.00,0.00,0,0,0,0,0,0,0,0,0,0,0,0,0
20200430,054999,玉晶光元富97購03,,,,,0.00,0.00,0,0,0,0,0,0,0,0,0,0,0,0,0
20200430,05499P,聯詠元富95售02,,,,,0.00,0.00,0,0,0,0,0,0,0,0,0,0,0,0,0
20200430,055000,玉晶光元富97購04,0.14,0.14,0.14,0.14,0.00,0.00,245000,1,34300,0,0,0,0,0,0,245000,0,245000,245000
20200430,055001,京鼎元富97購01,0.36,0.36,0.36,0.36,0.00,0.00,1000,1,360,0,0,0,0,0,0,1000,0,1000,1000
20200430,055002,群創元富99購04,,,,,0.00,0.00,0,0,0,0,0,0,0,0,0,0,0,0,0
20200430,055003,群創元富99購05,0.15,0.15,0.15,0.15,0.00,0.00,10000,1,1500,0,0,0,0,0,0,0,0,0,0
20200430,055004,群創元富99購06,0.07,0.07,0.07,0.07,0.00,0.00,10000,1,700,0,0,0,0,0,0,10000,0,10000,10000
20200430,055005,晶相光元富97購01,0.68,0.70,0.64,0.64,-0.03,-4.48,113000,6,77420,0,0,0,0,0,0,40000,106000,-66000,-66000
20200430,055006,晶相光元富9A購01,1.03,1.03,1.02,1.02,-0.05,-4.67,96000,4,97940,0,0,0,0,0,0,96000,0,96000,96000
20200430,055007,晶相光元富9A購02,0.82,0.82,0.82,0.82,-0.03,-3.53,17000,5,13940,0,0,0,0,0,0,17000,0,17000,17000
20200430,055008,隆達元富97購01,1.01,1.01,0.96,0.96,-0.31,-24.41,2000,2,1970,0,0,0,0,0,0,0,2000,-2000,-2000
20200430,055009,合勤控元富97購01,0.21,0.21,0.21,0.21,0.00,0.00,10000,1,2100,0,0,0,0,0,0,0,10000,-10000,-10000
20200430,05500P,臺股指中信96售04,1.88,1.88,1.68,1.68,-0.64,-27.59,57000,8,100810,0,0,0,0,0,0,27000,30000,-3000,-3000
20200430,055010,佐登元富97購01,,,,,0.00,0.00,0,0,0,0,0,0,0,0,0,0,0,0,0
20200430,055011,元翎元富97購01,0.07,0.07,0.07,0.07,0.00,0.00,30000,1,2100,0,0,0,0,0,0,30000,0,30000,30000
20200430,055012,茂林元富97購01,,,,,0.00,0.00,0,0,0,0,0,0,0,0,0,0,0,0,0
20200430,055013,訊連元富97購01,0.85,0.85,0.85,0.85,0.00,0.00,20000,1,17000,0,0,0,0,0,0,20000,0,20000,20000
20200430,055014,達興元富97購01,0.63,0.63,0.63,0.63,0.00,0.00,47000,1,29610,0,0,0,0,0,0,47000,0,47000,47000
20200430,055015,帆宣元富97購01,0.64,0.75,0.64,0.75,0.00,0.00,80000,14,56900,0,0,0,0,0,0,0,80000,-80000,-80000
20200430,055016,群電元富97購01,,,,,0.00,0.00,0,0,0,0,0,0,0,0,0,0,0,0,0
20200430,055017,緯穎元富97購01,1.78,1.78,1.71,1.71,+0.59,52.68,35000,7,61950,0,0,0,0,0,0,14000,0,14000,14000
20200430,055018,緯穎元富97購02,0.93,0.96,0.93,0.96,+0.31,47.69,8000,2,7590,0,0,0,0,0,0,8000,0,8000,8000
20200430,055019,福懋科元富97購01,1.71,1.72,1.64,1.67,0.00,0.00,130000,13,220600,0,0,0,0,0,0,0,130000,-130000,-130000
20200430,05501P,健策國票97售01,,,,,0.00,0.00,0,0,0,0,0,0,0,0,0,0,0,0,0
20200430,055020,上証2X國泰98購01,,,,,0.00,0.00,0,0,0,0,0,0,0,0,0,0,0,0,0
20200430,055021,亞德客國泰98購01,3.75,3.75,3.75,3.75,+1.13,43.13,10000,1,37500,0,0,0,0,0,0,0,10000,-10000,-10000
20200430,055022,精元國泰99購01,0.66,0.66,0.66,0.66,-0.06,-8.33,25000,1,16500,0,0,0,0,0,0,25000,0,25000,25000
20200430,055023,億光國泰98購01,0.73,0.73,0.73,0.73,0.00,0.00,51000,1,37230,0,0,0,0,0,0,51000,0,51000,51000
20200430,055024,興勤國泰98購01,0.31,0.31,0.31,0.31,-0.03,-8.82,50000,1,15500,0,0,0,0,0,0,50000,0,50000,50000
20200430,055025,華新科國泰98購02,2.27,2.28,2.27,2.28,+0.05,2.24,15000,3,34160,0,0,0,0,0,0,0,15000,-15000,-15000
20200430,055026,健和興國泰98購01,0.41,0.41,0.41,0.41,+0.01,2.5,3000,1,1230,0,0,0,0,0,0,0,3000,-3000,-3000
20200430,055027,牧德國泰99購01,0.54,0.55,0.52,0.55,+0.07,14.58,135000,5,72450,0,0,0,0,0,0,135000,0,135000,135000
20200430,055028,佐登國泰98購01,0.40,0.40,0.40,0.40,0.00,0.00,20000,1,8000,0,0,0,0,0,0,0,20000,-20000,-20000
20200430,055029,帆宣國泰99購01,0.59,0.69,0.59,0.68,+0.13,23.64,132000,19,87870,0,0,0,0,0,0,29000,96000,-67000,-67000
20200430,05502P,台表科國票97售01,,,,,0.00,0.00,0,0,0,0,0,0,0,0,0,0,0,0,0
20200430,055030,帆宣國泰99購02,0.98,1.16,0.96,1.16,+0.19,19.59,624000,36,656370,0,0,0,0,0,0,230000,416000,-186000,-186000
20200430,055031,南港富邦99購01,,,,,0.00,0.00,0,0,0,0,0,0,0,0,0,0,0,0,0
20200430,055032,億光富邦99購01,0.47,0.47,0.47,0.47,-0.05,-9.62,24000,1,11280,0,0,0,0,0,0,24000,0,24000,24000
20200430,055033,漢唐富邦98購01,0.16,0.16,0.16,0.16,0.00,0.00,12000,2,1920,0,0,0,0,0,0,12000,0,12000,12000
20200430,055034,建準富邦99購01,,,,,0.00,0.00,0,0,0,0,0,0,0,0,0,0,0,0,0
20200430,055035,興勤富邦98購01,,,,,0.00,0.00,0,0,0,0,0,0,0,0,0,0,0,0,0
20200430,055036,中工富邦9B購01,0.62,0.66,0.62,0.65,+0.05,8.33,220000,16,141700,0,0,0,0,0,0,160000,60000,100000,100000
20200430,055037,宏盛富邦99購01,0.14,0.14,0.11,0.11,+0.01,10.0,60000,4,7200,0,0,0,0,0,0,0,60000,-60000,-60000
20200430,055038,華航富邦99購01,0.36,0.37,0.35,0.35,+0.04,12.9,174000,7,61780,0,0,0,0,0,0,99000,0,99000,99000
20200430,055039,神達富邦99購01,,,,,0.00,0.00,0,0,0,0,0,0,0,0,0,0,0,0,0
20200430,05503P,智邦日盛96售01,,,,,0.00,0.00,0,0,0,0,0,0,0,0,0,0,0,0,0
20200430,055040,台虹富邦99購01,1.23,1.23,1.23,1.23,-0.05,-3.91,28000,4,34440,0,0,0,0,0,0,28000,0,28000,28000
20200430,055041,致新富邦97購01,0.45,0.48,0.43,0.48,+0.02,4.35,642000,31,291170,0,0,0,0,0,0,202000,290000,-88000,-88000
20200430,055042,得力永豐97購01,,,,,0.00,0.00,0,0,0,0,0,0,0,0,0,0,0,0,0
20200430,055043,中砂永豐97購01,,,,,0.00,0.00,0,0,0,0,0,0,0,0,0,0,0,0,0
20200430,055044,信錦永豐97購01,,,,,0.00,0.00,0,0,0,0,0,0,0,0,0,0,0,0,0
20200430,055045,台肥永豐97購01,0.13,0.13,0.12,0.12,0.00,0.00,83000,5,10290,0,0,0,0,0,0,0,83000,-83000,-83000
20200430,055046,上銀永豐97購01,,,,,0.00,0.00,0,0,0,0,0,0,0,0,0,0,0,0,0
20200430,055047,南港永豐97購01,,,,,0.00,0.00,0,0,0,0,0,0,0,0,0,0,0,0,0
20200430,055048,台積電永豐97購04,,,,,0.00,0.00,0,0,0,0,0,0,0,0,0,0,0,0,0
20200430,055049,智邦永豐97購01,1.04,1.13,0.87,0.94,-0.13,-12.15,568000,53,577340,0,0,0,0,0,0,284000,289000,-5000,-5000
20200430,05504P,台積電凱基96售04,,,,,0.00,0.00,0,0,0,0,0,0,0,0,0,0,0,0,0
20200430,055050,敬鵬永豐97購01,,,,,0.00,0.00,0,0,0,0,0,0,0,0,0,0,0,0,0
20200430,055051,藍天永豐97購01,0.33,0.34,0.33,0.34,+0.01,3.03,53000,3,17720,0,0,0,0,0,0,0,53000,-53000,-53000
20200430,055052,凱美永豐97購01,,,,,0.00,0.00,0,0,0,0,0,0,0,0,0,0,0,0,0
20200430,055053,瑞昱永豐97購01,0.30,0.38,0.30,0.38,+0.10,35.71,249000,7,84110,0,0,0,0,0,0,100000,149000,-49000,-49000
20200430,055054,群光永豐97購01,0.60,0.64,0.59,0.64,-0.02,-3.03,75000,3,45550,0,0,0,0,0,0,52000,23000,29000,29000
20200430,055055,精元永豐97購01,,,,,0.00,0.00,0,0,0,0,0,0,0,0,0,0,0,0,0
20200430,055056,億光永豐97購01,,,,,0.00,0.00,0,0,0,0,0,0,0,0,0,0,0,0,0
20200430,055057,興勤永豐97購01,,,,,0.00,0.00,0,0,0,0,0,0,0,0,0,0,0,0,0
20200430,055058,大毅永豐97購01,2.27,2.91,2.24,2.24,+0.21,10.34,165000,16,391280,0,0,0,0,0,0,102000,63000,39000,39000
20200430,055059,健和興永豐97購01,,,,,0.00,0.00,0,0,0,0,0,0,0,0,0,0,0,0,0
20200430,05505P,聯發科凱基96售09,,,,,0.00,0.00,0,0,0,0,0,0,0,0,0,0,0,0,0
20200430,055060,聯陽永豐97購01,0.53,0.57,0.53,0.57,+0.01,1.79,217000,8,119230,0,0,0,0,0,0,147000,70000,77000,77000
20200430,055061,聯詠永豐97購01,,,,,0.00,0.00,0,0,0,0,0,0,0,0,0,0,0,0,0
20200430,055062,文曄永豐97購01,,,,,0.00,0.00,0,0,0,0,0,0,0,0,0,0,0,0,0
20200430,055063,玉晶光永豐99購01,0.20,0.26,0.20,0.26,+0.07,36.84,914000,13,205570,0,0,0,0,0,0,547000,362000,185000,185000
20200430,055064,碩天永豐97購01,,,,,0.00,0.00,0,0,0,0,0,0,0,0,0,0,0,0,0
20200430,055065,神達永豐97購01,0.30,0.30,0.30,0.30,0.00,0.00,12000,2,3600,0,0,0,0,0,0,12000,0,12000,12000
20200430,055066,佐登永豐97購01,,,,,0.00,0.00,0,0,0,0,0,0,0,0,0,0,0,0,0
20200430,055067,禾聯碩永豐97購01,0.22,0.22,0.22,0.22,-0.01,-4.35,10000,1,2200,0,0,0,0,0,0,0,10000,-10000,-10000
20200430,055068,亞翔永豐97購01,,,,,0.00,0.00,0,0,0,0,0,0,0,0,0,0,0,0,0
20200430,055069,帆宣永豐97購01,0.37,0.46,0.37,0.46,+0.04,9.52,97000,8,42790,0,0,0,0,0,0,17000,80000,-63000,-63000
20200430,05506P,茂林凱基96售03,,,,,0.00,0.00,0,0,0,0,0,0,0,0,0,0,0,0,0
20200430,055070,聯茂永豐97購01,,,,,0.00,0.00,0,0,0,0,0,0,0,0,0,0,0,0,0
20200430,055071,群電永豐97購01,0.88,0.98,0.88,0.98,0.00,0.00,242000,8,224690,0,0,0,0,0,0,0,242000,-242000,-242000
20200430,055072,康友永豐97購02,,,,,0.00,0.00,0,0,0,0,0,0,0,0,0,0,0,0,0
20200430,055073,易華電永豐97購01,,,,,0.00,0.00,0,0,0,0,0,0,0,0,0,0,0,0,0
20200430,055074,台虹永豐97購01,,,,,0.00,0.00,0,0,0,0,0,0,0,0,0,0,0,0,0
20200430,055075,南電永豐97購01,,,,,0.00,0.00,0,0,0,0,0,0,0,0,0,0,0,0,0
20200430,055076,福懋科永豐97購01,,,,,0.00,0.00,0,0,0,0,0,0,0,0,0,0,0,0,0
20200430,055077,臺股指永豐97購02,,,,,0.00,0.00,0,0,0,0,0,0,0,0,0,0,0,0,0
20200430,055078,亞泥中信98購01,0.14,0.14,0.14,0.14,0.00,0.00,170000,2,23800,0,0,0,0,0,0,170000,0,170000,170000
20200430,055079,台光電中信97購01,,,,,0.00,0.00,0,0,0,0,0,0,0,0,0,0,0,0,0
20200430,05507P,聯茂凱基96售02,,,,,0.00,0.00,0,0,0,0,0,0,0,0,0,0,0,0,0
20200430,055080,正崴中信99購01,0.12,0.13,0.12,0.13,0.00,0.00,31000,4,3980,0,0,0,0,0,0,16000,15000,1000,1000
20200430,055081,健鼎中信97購01,,,,,0.00,0.00,0,0,0,0,0,0,0,0,0,0,0,0,0
20200430,055082,台郡中信97購01,,,,,0.00,0.00,0,0,0,0,0,0,0,0,0,0,0,0,0
20200430,055083,康友中信97購01,,,,,0.00,0.00,0,0,0,0,0,0,0,0,0,0,0,0,0
20200430,055084,國巨第一97購01,0.15,0.15,0.15,0.15,0.00,0.00,10000,1,1500,0,0,0,0,0,0,10000,0,10000,10000
20200430,055085,大毅國票97購01,6.00,7.55,5.65,5.65,+0.67,13.45,30000,8,185200,0,0,0,0,0,0,21000,13000,8000,8000
20200430,055086,華邦電亞東98購01,,,,,0.00,0.00,0,0,0,0,0,0,0,0,0,0,0,0,0
20200430,055087,瑞昱亞東97購01,,,,,0.00,0.00,0,0,0,0,0,0,0,0,0,0,0,0,0
20200430,055088,聯詠亞東97購01,,,,,0.00,0.00,0,0,0,0,0,0,0,0,0,0,0,0,0
20200430,055089,金寶群益98購01,0.77,0.79,0.77,0.79,+0.09,12.86,16000,3,12360,0,0,0,0,0,0,16000,0,16000,16000
20200430,05508P,華通統一97售01,,,,,0.00,0.00,0,0,0,0,0,0,0,0,0,0,0,0,0
20200430,055090,國巨群益97購03,2.23,2.28,2.23,2.24,+0.06,2.75,54000,3,121730,0,0,0,0,0,0,1000,53000,-52000,-52000
20200430,055091,微星群益97購01,0.84,0.84,0.84,0.84,0.00,0.00,98000,3,82320,0,0,0,0,0,0,0,94000,-94000,-94000
20200430,055092,開發金群益9B購01,1.30,1.31,1.28,1.30,+0.04,3.17,234000,11,303800,0,0,0,0,0,0,95000,138000,-43000,-43000
20200430,055093,京鼎群益98購01,1.06,1.31,1.03,1.31,+0.33,33.67,359000,13,384710,0,0,0,0,0,0,101000,261000,-160000,-160000
20200430,055094,智易群益98購01,0.74,0.74,0.71,0.71,-0.08,-10.13,36000,4,26360,0,0,0,0,0,0,36000,0,36000,36000
20200430,055095,啟碁群益98購01,,,,,0.00,0.00,0,0,0,0,0,0,0,0,0,0,0,0,0
20200430,055096,緯穎群益97購01,1.02,1.02,1.01,1.01,0.00,0.00,31000,2,31320,0,0,0,0,0,0,31000,0,31000,31000
20200430,055097,福懋科群益97購01,1.60,1.60,1.56,1.57,0.00,0.00,63000,6,99700,0,0,0,0,0,0,63000,63000,0,0
20200430,055098,臺股指群益97購01,,,,,0.00,0.00,0,0,0,0,0,0,0,0,0,0,0,0,0
20200430,055099,可成日盛97購01,,,,,0.00,0.00,0,0,0,0,0,0,0,0,0,0,0,0,0
20200430,05509P,智邦元富96售02,0.17,0.17,0.17,0.17,+0.02,13.33,22000,2,3740,0,0,0,0,0,0,22000,0,22000,22000
20200430,055100,得力凱基97購01,,,,,0.00,0.00,0,0,0,0,0,0,0,0,0,0,0,0,0
20200430,055101,台肥凱基97購01,0.14,0.14,0.14,0.14,+0.01,7.69,410000,3,57400,0,0,0,0,0,0,0,410000,-410000,-410000
20200430,055102,上銀凱基98購01,1.05,1.05,1.05,1.05,+0.57,118.75,50000,1,52500,0,0,0,0,0,0,50000,0,50000,50000
20200430,055103,南港凱基97購01,,,,,0.00,0.00,0,0,0,0,0,0,0,0,0,0,0,0,0
20200430,055104,台達電凱基98購01,0.69,0.80,0.69,0.80,+0.21,35.59,105000,28,77550,0,0,0,0,0,0,40000,65000,-25000,-25000
20200430,055105,鴻海凱基98購05,,,,,0.00,0.00,0,0,0,0,0,0,0,0,0,0,0,0,0
20200430,055106,台積電凱基98購05,0.24,0.25,0.24,0.25,0.00,0.00,29000,3,7060,0,0,0,0,0,0,29000,0,29000,29000
20200430,055107,旺宏凱基98購04,0.38,0.38,0.38,0.38,+0.01,2.7,3000,1,1140,0,0,0,0,0,0,0,0,0,0
20200430,055108,智邦凱基98購01,3.21,3.21,2.73,2.73,-0.68,-19.94,135000,17,409370,0,0,0,0,0,0,135000,0,135000,135000
20200430,055109,正崴凱基98購01,0.78,0.78,0.74,0.76,+0.12,18.75,118000,12,89690,0,0,0,0,0,0,77000,41000,36000,36000
20200430,05510P,燿華元富96售01,,,,,0.00,0.00,0,0,0,0,0,0,0,0,0,0,0,0,0
20200430,055110,美律凱基98購02,0.21,0.22,0.21,0.22,0.00,0.00,68000,4,14580,0,0,0,0,0,0,38000,0,38000,38000
20200430,055111,宏盛凱基97購01,,,,,0.00,0.00,0,0,0,0,0,0,0,0,0,0,0,0,0
20200430,055112,晶豪科凱基98購01,2.59,2.68,2.28,2.28,0.00,0.00,137000,25,346730,0,0,0,0,0,0,58000,20000,38000,38000
20200430,055113,大立光凱基98購06,,,,,0.00,0.00,0,0,0,0,0,0,0,0,0,0,0,0,0
20200430,055114,新日興凱基98購01,1.18,1.21,1.18,1.18,-0.05,-4.07,27000,4,32220,0,0,0,0,0,0,17000,10000,7000,7000
20200430,055115,日月光凱基98購01,,,,,0.00,0.00,0,0,0,0,0,0,0,0,0,0,0,0,0
20200430,055116,康控凱基98購01,,,,,0.00,0.00,0,0,0,0,0,0,0,0,0,0,0,0,0
20200430,055117,臻鼎凱基98購02,0.14,0.14,0.14,0.14,0.00,0.00,20000,1,2800,0,0,0,0,0,0,20000,0,20000,20000
20200430,055118,嘉聯益凱基98購02,,,,,0.00,0.00,0,0,0,0,0,0,0,0,0,0,0,0,0
20200430,055119,力成凱基98購01,,,,,0.00,0.00,0,0,0,0,0,0,0,0,0,0,0,0,0
20200430,05511P,T50反1台新06售01,0.59,0.59,0.59,0.59,+0.08,15.69,20000,1,11800,0,0,0,0,0,0,20000,0,20000,20000
20200430,055120,南港兆豐97購01,0.58,0.58,0.58,0.58,+0.25,75.76,1000,1,580,0,0,0,0,0,0,0,0,0,0
20200430,055121,鴻海兆豐97購03,0.66,0.66,0.65,0.66,+0.02,3.12,277000,6,181820,0,0,0,0,0,0,232000,0,232000,232000
20200430,055122,國巨兆豐98購01,0.34,0.37,0.34,0.37,+0.06,19.35,14000,2,5060,0,0,0,0,0,0,14000,10000,4000,4000
20200430,055123,億光兆豐97購01,,,,,0.00,0.00,0,0,0,0,0,0,0,0,0,0,0,0,0
20200430,055124,建準兆豐97購01,,,,,0.00,0.00,0,0,0,0,0,0,0,0,0,0,0,0,0
20200430,055125,智原兆豐97購01,0.19,0.19,0.18,0.18,0.00,0.00,60000,2,11300,0,0,0,0,0,0,0,60000,-60000,-60000
20200430,055126,嘉澤兆豐97購01,0.41,0.41,0.41,0.41,+0.05,13.89,127000,3,52070,0,0,0,0,0,0,127000,0,127000,127000
20200430,055127,台虹兆豐97購01,1.07,1.08,1.04,1.04,-0.05,-4.59,221000,11,233980,0,0,0,0,0,0,32000,189000,-157000,-157000
20200430,055128,致新兆豐97購01,,,,,0.00,0.00,0,0,0,0,0,0,0,0,0,0,0,0,0
20200430,055129,鈺齊兆豐97購01,0.14,0.14,0.14,0.14,+0.03,27.27,1000,1,140,0,0,0,0,0,0,0,1000,-1000,-1000
20200430,05512P,華新科台新97售01,,,,,0.00,0.00,0,0,0,0,0,0,0,0,0,0,0,0,0
20200430,055130,京鼎康和97購01,0.42,0.42,0.42,0.42,+0.09,27.27,22000,1,9240,0,0,0,0,0,0,22000,0,22000,22000
20200430,055131,茂林康和97購01,0.50,0.50,0.46,0.48,+0.01,2.13,1065000,12,509580,0,0,0,0,0,0,963000,102000,861000,861000
20200430,055132,台虹康和97購01,,,,,0.00,0.00,0,0,0,0,0,0,0,0,0,0,0,0,0
20200430,055133,致新康和97購01,,,,,0.00,0.00,0,0,0,0,0,0,0,0,0,0,0,0,0
20200430,055134,元油反國泰99購01,,,,,0.00,0.00,0,0,0,0,0,0,0,0,0,0,0,0,0
20200430,055135,聯發科富邦99購05,,,,,0.00,0.00,0,0,0,0,0,0,0,0,0,0,0,0,0
20200430,055136,聯發科富邦99購06,2.14,2.28,2.14,2.28,+0.37,19.37,345000,13,767660,0,0,0,0,0,0,78000,268000,-190000,-190000
20200430,055137,GIS富邦98購01,0.21,0.21,0.21,0.21,0.00,0.00,3000,1,630,0,0,0,0,0,0,3000,0,3000,3000
20200430,055138,大毅永豐97購02,1.73,2.22,1.68,1.68,+0.22,15.07,245000,27,452850,0,0,0,0,0,0,144000,94000,50000,50000
20200430,055139,欣興永豐97購01,,,,,0.00,0.00,0,0,0,0,0,0,0,0,0,0,0,0,0
20200430,05513P,玉山金台新96售01,0.10,0.11,0.10,0.11,0.00,0.00,60000,5,6300,0,0,0,0,0,0,0,10000,-10000,-10000
20200430,055140,晶相光永豐97購01,,,,,0.00,0.00,0,0,0,0,0,0,0,0,0,0,0,0,0
20200430,055141,牧德永豐98購02,,,,,0.00,0.00,0,0,0,0,0,0,0,0,0,0,0,0,0
20200430,055142,健策永豐98購01,0.92,0.97,0.92,0.96,+0.06,6.67,351000,14,330930,0,0,0,0,0,0,144000,213000,-69000,-69000
20200430,055143,臻鼎永豐97購01,0.04,0.05,0.04,0.05,+0.01,25.0,21000,3,850,0,0,0,0,0,0,1000,20000,-19000,-19000
20200430,055144,T50反1元大97購03,0.99,1.00,0.90,0.90,-0.21,-18.92,58000,6,56400,0,0,0,0,0,0,0,58000,-58000,-58000
20200430,055145,T50反1元大97購04,1.14,1.14,1.14,1.14,0.00,0.00,10000,1,11400,0,0,0,0,0,0,0,10000,-10000,-10000
20200430,055146,華通元大98購04,0.61,0.61,0.61,0.61,+0.20,48.78,5000,1,3050,0,0,0,0,0,0,0,5000,-5000,-5000
20200430,055147,鴻海元大97購11,0.66,0.66,0.66,0.66,+0.02,3.12,3000,2,1980,0,0,0,0,0,0,1000,2000,-1000,-1000
20200430,055148,鴻海元大98購02,,,,,0.00,0.00,0,0,0,0,0,0,0,0,0,0,0,0,0
20200430,055149,國巨元大97購06,0.28,0.28,0.28,0.28,0.00,0.00,8000,2,2240,0,0,0,0,0,0,0,0,0,0
20200430,05514P,康舒永豐96售01,,,,,0.00,0.00,0,0,0,0,0,0,0,0,0,0,0,0,0
20200430,055150,台積電元大98購04,,,,,0.00,0.00,0,0,0,0,0,0,0,0,0,0,0,0,0
20200430,055151,台積電元大98購05,,,,,0.00,0.00,0,0,0,0,0,0,0,0,0,0,0,0,0
20200430,055152,旺宏元大98購04,0.66,0.66,0.66,0.66,+0.06,10.0,50000,1,33000,0,0,0,0,0,0,50000,0,50000,50000
20200430,055153,台光電元大98購02,1.06,1.20,1.06,1.20,+0.18,17.65,361000,18,397650,0,0,0,0,0,0,163000,252000,-89000,-89000
20200430,055154,聯發科元大98購01,0.84,0.84,0.82,0.82,+0.16,24.24,59000,3,49080,0,0,0,0,0,0,59000,0,59000,59000
20200430,055155,奇力新元大99購01,,,,,0.00,0.00,0,0,0,0,0,0,0,0,0,0,0,0,0
20200430,055156,華新科元大99購02,,,,,0.00,0.00,0,0,0,0,0,0,0,0,0,0,0,0,0
20200430,055157,晶豪科元大97購01,,,,,0.00,0.00,0,0,0,0,0,0,0,0,0,0,0,0,0
20200430,055158,亞光元大99購01,,,,,0.00,0.00,0,0,0,0,0,0,0,0,0,0,0,0,0
20200430,055159,玉晶光元大98購05,0.21,0.21,0.21,0.21,0.00,0.00,100000,1,21000,0,0,0,0,0,0,100000,0,100000,100000
20200430,05515P,台積電群益96售03,3.18,3.18,3.15,3.15,0.00,0.00,150000,3,474000,0,0,0,0,0,0,150000,150000,0,0
20200430,055160,玉晶光元大99購03,0.33,0.39,0.33,0.39,+0.08,25.81,44000,5,17030,0,0,0,0,0,0,44000,0,44000,44000
20200430,055161,貿聯元大98購03,0.42,0.42,0.42,0.42,+0.11,35.48,20000,1,8400,0,0,0,0,0,0,20000,0,20000,20000
20200430,055162,新唐元大97購01,,,,,0.00,0.00,0,0,0,0,0,0,0,0,0,0,0,0,0
20200430,055163,訊芯元大98購01,,,,,0.00,0.00,0,0,0,0,0,0,0,0,0,0,0,0,0
20200430,055164,矽創元大98購01,,,,,0.00,0.00,0,0,0,0,0,0,0,0,0,0,0,0,0
20200430,055165,元油反統一98購01,,,,,0.00,0.00,0,0,0,0,0,0,0,0,0,0,0,0,0
20200430,055166,台積電統一97購05,0.25,0.25,0.25,0.25,0.00,0.00,2000,1,500,0,0,0,0,0,0,0,0,0,0
20200430,055167,友訊統一97購01,,,,,0.00,0.00,0,0,0,0,0,0,0,0,0,0,0,0,0
20200430,055168,光罩統一98購01,1.27,1.31,1.24,1.31,+0.06,4.8,495000,20,638590,0,0,0,0,0,0,63000,436000,-373000,-373000
20200430,055169,光罩統一99購01,,,,,0.00,0.00,0,0,0,0,0,0,0,0,0,0,0,0,0
20200430,05516P,台積電元大96售12,,,,,0.00,0.00,0,0,0,0,0,0,0,0,0,0,0,0,0
20200430,055170,光磊統一97購01,0.43,0.45,0.43,0.44,-0.01,-2.22,106000,4,46920,0,0,0,0,0,0,58000,48000,10000,10000
20200430,055171,凱美統一97購01,0.36,0.36,0.36,0.36,0.00,0.00,48000,1,17280,0,0,0,0,0,0,0,48000,-48000,-48000
20200430,055172,凱美統一97購02,0.60,0.65,0.59,0.59,+0.01,1.72,256000,7,156230,0,0,0,0,0,0,106000,150000,-44000,-44000
20200430,055173,瑞昱統一97購01,3.55,3.94,3.55,3.94,0.00,0.00,131000,13,484390,0,0,0,0,0,0,0,131000,-131000,-131000
20200430,055174,精元統一97購01,0.88,0.94,0.88,0.90,+0.03,3.45,414000,19,383160,0,0,0,0,0,0,89000,325000,-236000,-236000
20200430,055175,建準統一97購01,0.71,0.71,0.68,0.68,-0.13,-16.05,332000,11,229040,0,0,0,0,0,0,284000,48000,236000,236000
20200430,055176,大毅統一98購02,5.50,6.25,5.40,5.60,+0.64,12.9,40000,6,223200,0,0,0,0,0,0,38000,2000,36000,36000
20200430,055177,宏達電統一99購01,0.46,0.46,0.45,0.45,-0.02,-4.26,5000,2,2280,0,0,0,0,0,0,0,5000,-5000,-5000
20200430,055178,晶豪科統一97購01,2.60,2.73,2.56,2.56,+0.03,1.19,262000,8,686630,0,0,0,0,0,0,197000,65000,132000,132000
20200430,055179,大立光統一97購04,,,,,0.00,0.00,0,0,0,0,0,0,0,0,0,0,0,0,0
20200430,05517P,臻鼎元大96售01,,,,,0.00,0.00,0,0,0,0,0,0,0,0,0,0,0,0,0
20200430,055180,文曄統一97購01,,,,,0.00,0.00,0,0,0,0,0,0,0,0,0,0,0,0,0
20200430,055181,日電貿統一97購01,0.69,0.69,0.69,0.69,0.00,0.00,5000,1,3450,0,0,0,0,0,0,5000,0,5000,5000
20200430,055182,京鼎統一98購01,,,,,0.00,0.00,0,0,0,0,0,0,0,0,0,0,0,0,0
20200430,055183,聯鈞統一97購01,1.91,1.91,1.75,1.76,-0.12,-6.38,250000,16,451310,0,0,0,0,0,0,180000,154000,26000,26000
20200430,055184,群創統一98購02,,,,,0.00,0.00,0,0,0,0,0,0,0,0,0,0,0,0,0
20200430,055185,晶相光統一97購01,,,,,0.00,0.00,0,0,0,0,0,0,0,0,0,0,0,0,0
20200430,055186,正文統一97購01,,,,,0.00,0.00,0,0,0,0,0,0,0,0,0,0,0,0,0
20200430,055187,彩晶統一98購01,,,,,0.00,0.00,0,0,0,0,0,0,0,0,0,0,0,0,0
20200430,055188,亞翔統一97購01,0.43,0.45,0.43,0.45,+0.03,7.14,27000,3,11910,0,0,0,0,0,0,7000,20000,-13000,-13000
20200430,055189,台虹統一97購01,,,,,0.00,0.00,0,0,0,0,0,0,0,0,0,0,0,0,0
20200430,05518P,T50反1凱基98售03,,,,,0.00,0.00,0,0,0,0,0,0,0,0,0,0,0,0,0
20200430,055190,華新科元富97購01,,,,,0.00,0.00,0,0,0,0,0,0,0,0,0,0,0,0,0
20200430,055191,牧德元富97購01,,,,,0.00,0.00,0,0,0,0,0,0,0,0,0,0,0,0,0
20200430,055192,世芯元富97購01,1.60,1.68,1.60,1.68,+0.42,33.33,53000,6,87540,0,0,0,0,0,0,33000,0,33000,33000
20200430,055193,世芯元富97購02,2.20,2.30,2.20,2.30,+0.47,25.68,51000,2,112300,0,0,0,0,0,0,51000,0,51000,51000
20200430,055194,昇陽半元富97購01,,,,,0.00,0.00,0,0,0,0,0,0,0,0,0,0,0,0,0
20200430,055195,昇陽半元富97購02,,,,,0.00,0.00,0,0,0,0,0,0,0,0,0,0,0,0,0
20200430,055196,致新元富97購01,1.34,1.43,1.26,1.43,+0.15,11.72,931000,57,1233330,0,0,0,0,0,0,407000,435000,-28000,-28000
20200430,055197,致新元富97購02,1.63,1.75,1.48,1.72,+0.09,5.52,823000,49,1352910,0,0,0,0,0,0,224000,507000,-283000,-283000
20200430,055198,奇力新第一97購01,0.08,0.08,0.08,0.08,+0.01,14.29,5000,1,400,0,0,0,0,0,0,5000,0,5000,5000
20200430,055199,國喬群益97購01,,,,,0.00,0.00,0,0,0,0,0,0,0,0,0,0,0,0,0
20200430,05519P,上証2X凱基98售01,,,,,0.00,0.00,0,0,0,0,0,0,0,0,0,0,0,0,0
20200430,055200,和大群益98購01,0.13,0.13,0.13,0.13,0.00,0.00,15000,2,1950,0,0,0,0,0,0,15000,0,15000,15000
20200430,055201,興勤群益98購01,,,,,0.00,0.00,0,0,0,0,0,0,0,0,0,0,0,0,0
20200430,055202,神達群益97購01,0.53,0.53,0.53,0.53,0.00,0.00,30000,1,15900,0,0,0,0,0,0,30000,0,30000,30000
20200430,055203,建準中信97購01,,,,,0.00,0.00,0,0,0,0,0,0,0,0,0,0,0,0,0
20200430,055204,宏達電中信99購01,,,,,0.00,0.00,0,0,0,0,0,0,0,0,0,0,0,0,0
20200430,055205,京鼎中信99購01,0.22,0.24,0.21,0.24,0.00,0.00,61000,3,13120,0,0,0,0,0,0,50000,11000,39000,39000
20200430,055206,台虹中信97購01,,,,,0.00,0.00,0,0,0,0,0,0,0,0,0,0,0,0,0
20200430,055207,致新中信99購01,0.39,0.42,0.37,0.41,+0.02,5.13,752000,28,291440,0,0,0,0,0,0,460000,286000,174000,174000
20200430,055208,京鼎康和97購02,0.44,0.44,0.44,0.44,+0.02,4.76,39000,1,17160,0,0,0,0,0,0,0,39000,-39000,-39000
20200430,055209,勤誠康和97購01,0.64,0.64,0.63,0.64,0.00,0.00,55000,4,35100,0,0,0,0,0,0,0,55000,-55000,-55000
20200430,05520P,聯詠凱基96售01,2.01,2.01,1.94,1.94,-0.21,-9.77,28000,2,56070,0,0,0,0,0,0,0,28000,-28000,-28000
20200430,055210,S&P正2凱基97購01,0.04,0.05,0.04,0.05,0.00,0.00,51000,2,2050,0,0,0,0,0,0,0,0,0,0
20200430,055211,A50反1凱基9A購01,0.56,0.66,0.56,0.66,0.00,0.00,51000,3,28660,0,0,0,0,0,0,50000,1000,49000,49000
20200430,055212,和大凱基97購02,,,,,0.00,0.00,0,0,0,0,0,0,0,0,0,0,0,0,0
20200430,055213,大成鋼凱基98購01,,,,,0.00,0.00,0,0,0,0,0,0,0,0,0,0,0,0,0
20200430,055214,聯電凱基97購02,0.42,0.42,0.42,0.42,+0.05,13.51,20000,1,8400,0,0,0,0,0,0,20000,0,20000,20000
20200430,055215,智邦凱基98購02,7.15,7.15,7.15,7.15,+0.15,2.14,1000,1,7150,0,0,0,0,0,0,1000,0,1000,1000
20200430,055216,友達凱基98購05,0.94,0.94,0.93,0.93,0.00,0.00,203000,16,189090,0,0,0,0,0,0,203000,0,203000,203000
20200430,055217,緯創凱基97購02,2.10,2.21,2.05,2.21,+0.11,5.24,240000,26,510240,0,0,0,0,0,0,123000,117000,6000,6000
20200430,055218,彩晶凱基99購01,,,,,0.00,0.00,0,0,0,0,0,0,0,0,0,0,0,0,0
20200430,055219,啟碁凱基98購01,,,,,0.00,0.00,0,0,0,0,0,0,0,0,0,0,0,0,0
20200430,05521P,創意永豐96售01,1.30,1.30,1.27,1.27,-0.13,-9.29,74000,2,95600,0,0,0,0,0,0,74000,0,74000,74000
20200430,055220,緯穎凱基98購02,,,,,0.00,0.00,0,0,0,0,0,0,0,0,0,0,0,0,0
20200430,055221,矽創凱基97購02,0.72,0.76,0.72,0.76,+0.08,11.76,92000,11,67360,0,0,0,0,0,0,82000,10000,72000,72000
20200430,055222,臺股指凱基97購05,0.10,0.12,0.10,0.12,+0.05,71.43,325000,4,38800,0,0,0,0,0,0,325000,0,325000,325000
20200430,055223,和大國票98購01,,,,,0.00,0.00,0,0,0,0,0,0,0,0,0,0,0,0,0
20200430,055224,鴻海國票99購02,,,,,0.00,0.00,0,0,0,0,0,0,0,0,0,0,0,0,0
20200430,055225,華邦電國票99購01,0.19,0.19,0.19,0.19,0.00,0.00,36000,1,6840,0,0,0,0,0,0,0,36000,-36000,-36000
20200430,055226,聯發科國票97購05,,,,,0.00,0.00,0,0,0,0,0,0,0,0,0,0,0,0,0
20200430,055227,聯發科國票98購02,1.91,2.01,1.89,2.01,+0.32,18.93,384000,14,734930,0,0,0,0,0,0,300000,84000,216000,216000
20200430,055228,聯發科國票98購03,0.88,0.88,0.88,0.88,+0.24,37.5,5000,1,4400,0,0,0,0,0,0,5000,0,5000,5000
20200430,055229,大毅國票97購02,6.20,7.75,5.95,5.95,+0.90,17.82,38000,13,237100,0,0,0,0,0,0,29000,12000,17000,17000
20200430,05522P,友達元富96售02,,,,,0.00,0.00,0,0,0,0,0,0,0,0,0,0,0,0,0
20200430,055230,大毅國票98購01,7.30,8.70,7.20,7.25,+0.75,11.54,131000,29,990700,0,0,0,0,0,0,101000,34000,67000,67000
20200430,055231,大毅國票98購02,5.15,5.80,4.98,5.80,+1.21,26.36,6000,3,31210,0,0,0,0,0,0,5000,1000,4000,4000
20200430,055232,泰碩國票98購01,2.13,2.15,2.07,2.07,-0.03,-1.43,285000,10,604490,0,0,0,0,0,0,245000,40000,205000,205000
20200430,055233,康友國票98購01,0.15,0.15,0.15,0.15,+0.02,15.38,62000,2,9300,0,0,0,0,0,0,62000,0,62000,62000
20200430,055234,昇陽半國票98購02,0.50,0.51,0.47,0.51,+0.06,13.33,94000,4,47050,0,0,0,0,0,0,0,94000,-94000,-94000
20200430,055235,金寶台新98購01,1.09,1.09,1.00,1.02,-0.05,-4.67,80000,9,85350,0,0,0,0,0,0,26000,49000,-23000,-23000
20200430,055236,建準台新98購01,0.58,0.58,0.18,0.18,-0.45,-71.43,84000,2,44720,0,0,0,0,0,0,74000,10000,64000,64000
20200430,055237,晶豪科台新97購01,,,,,0.00,0.00,0,0,0,0,0,0,0,0,0,0,0,0,0
20200430,055238,茂林台新97購01,,,,,0.00,0.00,0,0,0,0,0,0,0,0,0,0,0,0,0
20200430,055239,帆宣台新97購01,0.30,0.37,0.01,0.01,-0.31,-96.88,23000,5,4240,0,0,0,0,0,0,0,18000,-18000,-18000
20200430,05523P,聯發科國票96售04,,,,,0.00,0.00,0,0,0,0,0,0,0,0,0,0,0,0,0
20200430,055240,京元電元富97購01,1.78,1.78,1.76,1.78,0.00,0.00,141000,3,250800,0,0,0,0,0,0,98000,43000,55000,55000
20200430,055241,T50反1統一99購01,,,,,0.00,0.00,0,0,0,0,0,0,0,0,0,0,0,0,0
20200430,055242,道瓊銀統一98購01,,,,,0.00,0.00,0,0,0,0,0,0,0,0,0,0,0,0,0
20200430,055243,國巨統一97購04,,,,,0.00,0.00,0,0,0,0,0,0,0,0,0,0,0,0,0
20200430,055244,國巨統一98購01,,,,,0.00,0.00,0,0,0,0,0,0,0,0,0,0,0,0,0
20200430,055245,凱美統一99購01,0.55,0.55,0.51,0.51,0.00,0.00,83000,3,44570,0,0,0,0,0,0,0,83000,-83000,-83000
20200430,055246,美律統一98購01,,,,,0.00,0.00,0,0,0,0,0,0,0,0,0,0,0,0,0
20200430,055247,聯發科統一98購01,0.68,0.69,0.68,0.69,+0.16,30.19,220000,4,151200,0,0,0,0,0,0,220000,10000,210000,210000
20200430,055248,可成統一97購02,1.20,1.20,1.10,1.12,0.00,0.00,67000,3,78840,0,0,0,0,0,0,17000,50000,-33000,-33000
20200430,055249,大毅統一99購01,1.33,1.42,1.33,1.42,+0.33,30.28,9000,3,12450,0,0,0,0,0,0,6000,0,6000,6000
20200430,05524P,瀚宇博國票97售02,1.85,1.85,1.85,1.85,-0.05,-2.63,10000,1,18500,0,0,0,0,0,0,0,10000,-10000,-10000
20200430,055250,華新科統一97購02,,,,,0.00,0.00,0,0,0,0,0,0,0,0,0,0,0,0,0
20200430,055251,華新科統一99購01,,,,,0.00,0.00,0,0,0,0,0,0,0,0,0,0,0,0,0
20200430,055252,新光金統一98購02,0.71,0.72,0.70,0.71,+0.03,4.41,380000,11,270460,0,0,0,0,0,0,184000,196000,-12000,-12000
20200430,055253,大立光統一97購06,,,,,0.00,0.00,0,0,0,0,0,0,0,0,0,0,0,0,0
20200430,055254,聯詠統一97購03,0.87,0.93,0.85,0.93,+0.18,24.0,99000,7,89320,0,0,0,0,0,0,48000,51000,-3000,-3000
20200430,055255,欣興統一97購02,0.65,0.65,0.65,0.65,+0.06,10.17,10000,1,6500,0,0,0,0,0,0,10000,0,10000,10000
20200430,055256,日電貿統一99購01,1.21,1.25,1.17,1.17,0.00,0.00,122000,8,149200,0,0,0,0,0,0,0,122000,-122000,-122000
20200430,055257,景碩統一97購01,2.82,3.19,2.77,3.15,+0.36,12.9,564000,26,1643440,0,0,0,0,0,0,225000,345000,-120000,-120000
20200430,055258,玉晶光統一97購03,,,,,0.00,0.00,0,0,0,0,0,0,0,0,0,0,0,0,0
20200430,055259,玉晶光統一9A購01,,,,,0.00,0.00,0,0,0,0,0,0,0,0,0,0,0,0,0
20200430,05525P,奇力新群益96售02,0.55,0.55,0.54,0.54,0.00,0.00,125000,3,67750,0,0,0,0,0,0,25000,100000,-75000,-75000
20200430,055260,晶相光統一98購01,,,,,0.00,0.00,0,0,0,0,0,0,0,0,0,0,0,0,0
20200430,055261,帆宣統一98購01,0.94,1.16,0.93,1.14,+0.16,16.33,786000,33,794860,0,0,0,0,0,0,99000,687000,-588000,-588000
20200430,055262,台虹國泰98購01,0.77,0.77,0.77,0.77,0.00,0.00,50000,1,38500,0,0,0,0,0,0,0,50000,-50000,-50000
20200430,055263,華新科富邦9A購01,0.28,0.31,0.27,0.30,+0.04,15.38,464000,35,134830,0,0,0,0,0,0,0,0,0,0
20200430,055264,國巨永豐98購01,1.29,1.29,1.29,1.29,+0.04,3.2,1000,1,1290,0,0,0,0,0,0,0,1000,-1000,-1000
20200430,055265,玉晶光永豐98購03,0.17,0.17,0.17,0.17,+0.02,13.33,55000,1,9350,0,0,0,0,0,0,55000,0,55000,55000
20200430,055266,京鼎永豐97購01,,,,,0.00,0.00,0,0,0,0,0,0,0,0,0,0,0,0,0
20200430,055267,百和永豐97購01,0.17,0.17,0.17,0.17,-0.03,-15.0,300000,4,51000,0,0,0,0,0,0,300000,0,300000,300000
20200430,055268,和大元大97購01,0.28,0.28,0.28,0.28,+0.14,100.0,5000,1,1400,0,0,0,0,0,0,5000,0,5000,5000
20200430,055269,和大元大97購02,,,,,0.00,0.00,0,0,0,0,0,0,0,0,0,0,0,0,0
20200430,05526P,茂林群益96售03,,,,,0.00,0.00,0,0,0,0,0,0,0,0,0,0,0,0,0
20200430,055270,上銀元大97購03,2.05,2.05,2.05,2.05,0.00,0.00,1000,1,2050,0,0,0,0,0,0,1000,0,1000,1000
20200430,055271,鴻海元大98購03,,,,,0.00,0.00,0,0,0,0,0,0,0,0,0,0,0,0,0
20200430,055272,國巨元大98購04,,,,,0.00,0.00,0,0,0,0,0,0,0,0,0,0,0,0,0
20200430,055273,華泰元大97購01,,,,,0.00,0.00,0,0,0,0,0,0,0,0,0,0,0,0,0
20200430,055274,華泰元大97購02,0.31,0.31,0.25,0.28,0.00,0.00,9000,3,2580,0,0,0,0,0,0,0,3000,-3000,-3000
20200430,055275,台積電元大97購19,,,,,0.00,0.00,0,0,0,0,0,0,0,0,0,0,0,0,0
20200430,055276,台積電元大97購20,0.35,0.40,0.35,0.40,+0.06,17.65,12000,3,4750,0,0,0,0,0,0,1000,0,1000,1000
20200430,055277,旺宏元大97購04,0.13,0.28,0.13,0.28,+0.05,21.74,8000,3,2040,0,0,0,0,0,0,7000,0,7000,7000
20200430,055278,旺宏元大98購05,0.58,0.59,0.58,0.59,0.00,0.00,74000,4,43520,0,0,0,0,0,0,0,0,0,0
20200430,055279,華邦電元大97購02,0.26,0.26,0.26,0.26,+0.02,8.33,20000,1,5200,0,0,0,0,0,0,20000,0,20000,20000
20200430,05527P,聯茂群益96售01,,,,,0.00,0.00,0,0,0,0,0,0,0,0,0,0,0,0,0
20200430,055280,智邦元大97購01,7.90,8.20,7.30,7.60,0.00,0.00,30000,6,238000,0,0,0,0,0,0,18000,10000,8000,8000
20200430,055281,台光電元大98購03,,,,,0.00,0.00,0,0,0,0,0,0,0,0,0,0,0,0,0
20200430,055282,聯發科元大97購15,0.90,1.12,0.90,1.12,+0.37,49.33,48000,13,51150,0,0,0,0,0,0,11000,28000,-17000,-17000
20200430,055283,聯發科元大97購16,1.00,1.10,0.96,1.10,+0.32,41.03,65000,5,65950,0,0,0,0,0,0,65000,0,65000,65000
20200430,055284,全新元大99購01,,,,,0.00,0.00,0,0,0,0,0,0,0,0,0,0,0,0,0
20200430,055285,華新科元大99購03,,,,,0.00,0.00,0,0,0,0,0,0,0,0,0,0,0,0,0
20200430,055286,晶技元大98購03,,,,,0.00,0.00,0,0,0,0,0,0,0,0,0,0,0,0,0
20200430,055287,日電貿元大97購01,1.45,1.53,1.43,1.43,+0.06,4.38,195000,7,286480,0,0,0,0,0,0,50000,145000,-95000,-95000
20200430,055288,日電貿元大97購02,1.43,1.48,1.43,1.48,+0.11,8.03,141000,7,205680,0,0,0,0,0,0,50000,91000,-41000,-41000
20200430,055289,泰碩元大98購01,,,,,0.00,0.00,0,0,0,0,0,0,0,0,0,0,0,0,0
20200430,05528P,臺股指群益96售01,1.70,1.70,1.43,1.45,-0.54,-27.14,512000,25,816220,0,0,0,0,0,0,391000,120000,271000,271000
20200430,055290,玉晶光元大98購08,,,,,0.00,0.00,0,0,0,0,0,0,0,0,0,0,0,0,0
20200430,055291,京鼎元大97購02,1.76,2.11,1.76,1.99,+0.33,19.88,451000,38,846850,0,0,0,0,0,0,224000,383000,-159000,-159000
20200430,055292,聯鈞元大97購02,,,,,0.00,0.00,0,0,0,0,0,0,0,0,0,0,0,0,0
20200430,055293,晶相光元大97購01,,,,,0.00,0.00,0,0,0,0,0,0,0,0,0,0,0,0,0
20200430,055294,智易元大98購01,0.39,0.39,0.36,0.36,-0.04,-10.0,61000,2,23760,0,0,0,0,0,0,61000,0,61000,61000
20200430,055295,瀚宇博元大97購02,1.84,1.90,1.78,1.90,+0.13,7.34,297000,17,546590,0,0,0,0,0,0,69000,230000,-161000,-161000
20200430,055296,康舒元大97購02,0.42,0.44,0.42,0.44,+0.04,10.0,45000,2,19400,0,0,0,0,0,0,45000,0,45000,45000
20200430,055297,啟碁元大97購01,1.24,1.24,1.23,1.23,-0.01,-0.81,91000,2,112160,0,0,0,0,0,0,23000,68000,-45000,-45000
20200430,055298,啟碁元大97購02,,,,,0.00,0.00,0,0,0,0,0,0,0,0,0,0,0,0,0
20200430,055299,康友元大97購02,0.30,0.30,0.30,0.30,0.00,0.00,20000,1,6000,0,0,0,0,0,0,0,20000,-20000,-20000
20200430,05529P,臺股指群益96售02,2.17,2.21,1.93,1.93,-0.55,-22.18,70000,8,146630,2000,0,2000,0,0,0,67000,3000,64000,66000
20200430,055300,緯穎元大98購01,2.09,2.42,2.09,2.42,+0.62,34.44,29000,8,66390,0,0,0,0,0,0,21000,0,21000,21000
20200430,055301,台虹元大97購01,1.42,1.42,1.37,1.37,-0.03,-2.14,262000,17,364330,0,0,0,0,0,0,211000,51000,160000,160000
20200430,055302,達方元大97購01,0.81,0.81,0.81,0.81,+0.05,6.58,20000,1,16200,0,0,0,0,0,0,0,20000,-20000,-20000
20200430,055303,鈺齊元大97購01,0.15,0.15,0.15,0.15,+0.02,15.38,1000,1,150,0,0,0,0,0,0,0,0,0,0
20200430,055304,瑞昱第一98購01,0.66,0.78,0.66,0.78,+0.18,30.0,48000,6,33240,0,0,0,0,0,0,10000,0,10000,10000
20200430,055305,旺宏群益99購01,2.98,3.05,2.93,2.95,+0.39,15.23,1270000,10,3766520,0,0,0,0,0,0,1250000,20000,1230000,1230000
20200430,055306,燿華群益97購01,,,,,0.00,0.00,0,0,0,0,0,0,0,0,0,0,0,0,0
20200430,055307,瑞昱群益97購02,,,,,0.00,0.00,0,0,0,0,0,0,0,0,0,0,0,0,0
20200430,055308,聯發科群益97購04,0.61,0.61,0.61,0.61,+0.24,64.86,155000,1,94550,0,0,0,0,0,0,155000,0,155000,155000
20200430,055309,冠德群益97購01,,,,,0.00,0.00,0,0,0,0,0,0,0,0,0,0,0,0,0
20200430,05530P,臺股指群益96售03,,,,,0.00,0.00,0,0,0,0,0,0,0,0,0,0,0,0,0
20200430,055310,聯詠群益97購02,0.39,0.39,0.39,0.39,+0.04,11.43,1000,1,390,0,0,0,0,0,0,0,1000,-1000,-1000
20200430,055311,健策群益98購02,1.27,1.27,1.27,1.27,+0.06,4.96,25000,3,31750,0,0,0,0,0,0,1000,25000,-24000,-24000
20200430,055312,台虹群益99購01,,,,,0.00,0.00,0,0,0,0,0,0,0,0,0,0,0,0,0
20200430,055313,南電群益97購01,,,,,0.00,0.00,0,0,0,0,0,0,0,0,0,0,0,0,0
20200430,055314,華邦電中信99購01,,,,,0.00,0.00,0,0,0,0,0,0,0,0,0,0,0,0,0
20200430,055315,晶技麥證97購01,,,,,0.00,0.00,0,0,0,0,0,0,0,0,0,0,0,0,0
20200430,055316,上銀國票98購01,0.47,0.63,0.47,0.63,0.00,0.00,303000,7,147340,0,0,0,0,0,0,243000,0,243000,243000
20200430,055317,金寶國票98購01,,,,,0.00,0.00,0,0,0,0,0,0,0,0,0,0,0,0,0
20200430,055318,華通國票98購01,1.44,1.74,1.44,1.70,+0.33,24.09,452000,15,715400,0,0,0,0,0,0,405000,28000,377000,377000
20200430,055319,國巨國票98購03,,,,,0.00,0.00,0,0,0,0,0,0,0,0,0,0,0,0,0
20200430,05531P,臺股指群益96售04,,,,,0.00,0.00,0,0,0,0,0,0,0,0,0,0,0,0,0
20200430,055320,建準國票98購01,1.44,1.44,1.38,1.38,-0.11,-7.38,94000,7,132940,0,0,0,0,0,0,94000,0,94000,94000
20200430,055321,大立光國票98購02,,,,,0.00,0.00,0,0,0,0,0,0,0,0,0,0,0,0,0
20200430,055322,欣興國票97購06,1.38,1.38,1.38,1.38,+0.19,15.97,1000,1,1380,0,0,0,0,0,0,1000,0,1000,1000
20200430,055323,貿聯國票98購01,1.01,1.17,1.01,1.17,0.00,0.00,135000,6,146070,0,0,0,0,0,0,0,135000,-135000,-135000
20200430,055324,TPK國票98購03,1.05,1.05,1.05,1.05,-0.06,-5.41,14000,1,14700,0,0,0,0,0,0,14000,0,14000,14000
20200430,055325,佐登國票98購01,0.11,0.11,0.11,0.11,-0.02,-15.38,200000,1,22000,0,0,0,0,0,0,200000,200000,0,0
20200430,055326,緯穎國票97購06,,,,,0.00,0.00,0,0,0,0,0,0,0,0,0,0,0,0,0
20200430,055327,致新國票98購01,3.75,3.93,3.69,3.93,+0.37,10.39,91000,4,347490,0,0,0,0,0,0,48000,43000,5000,5000
20200430,055328,鈺齊國票98購01,,,,,0.00,0.00,0,0,0,0,0,0,0,0,0,0,0,0,0
20200430,055329,百和國票98購01,,,,,0.00,0.00,0,0,0,0,0,0,0,0,0,0,0,0,0
20200430,05532P,臺股指群益96售05,,,,,0.00,0.00,0,0,0,0,0,0,0,0,0,0,0,0,0
20200430,055330,上銀兆豐98購02,2.22,2.71,2.19,2.71,+0.63,30.29,237000,18,555590,0,0,0,0,0,0,137000,100000,37000,37000
20200430,055331,國巨兆豐99購01,1.39,1.39,1.39,1.39,0.00,0.00,10000,1,13900,0,0,0,0,0,0,10000,10000,0,0
20200430,055332,奇力新兆豐98購01,,,,,0.00,0.00,0,0,0,0,0,0,0,0,0,0,0,0,0
20200430,055333,晶豪科兆豐97購01,2.90,3.08,2.65,2.71,-0.09,-3.21,80000,12,231820,0,0,0,0,0,0,43000,37000,6000,6000
20200430,055334,禾伸堂兆豐97購01,2.05,2.05,1.87,1.87,-0.02,-1.06,55000,2,109150,0,0,0,0,0,0,20000,35000,-15000,-15000
20200430,055335,健策兆豐98購01,1.67,1.70,1.67,1.70,+0.17,11.11,81000,3,136620,0,0,0,0,0,0,0,81000,-81000,-81000
20200430,055336,茂林兆豐98購01,1.30,1.30,1.25,1.25,-0.02,-1.57,29000,5,36650,0,0,0,0,0,0,9000,20000,-11000,-11000
20200430,055337,超眾兆豐98購01,0.71,0.71,0.67,0.67,-0.04,-5.63,110000,3,74100,0,0,0,0,0,0,100000,110000,-10000,-10000
20200430,055338,GIS兆豐97購01,,,,,0.00,0.00,0,0,0,0,0,0,0,0,0,0,0,0,0
20200430,055339,緯穎兆豐98購01,4.47,4.47,4.47,4.47,+0.21,4.93,3000,1,13410,0,0,0,0,0,0,0,3000,-3000,-3000
20200430,05533P,滬深2X富邦97售01,0.64,0.65,0.64,0.65,-0.14,-17.72,3000,2,1930,0,0,0,0,0,0,3000,0,3000,3000
20200430,055340,華新科日盛97購01,0.19,0.19,0.19,0.19,+0.04,26.67,40000,2,7600,0,0,0,0,0,0,40000,0,40000,40000
20200430,055341,台達電凱基97購02,,,,,0.00,0.00,0,0,0,0,0,0,0,0,0,0,0,0,0
20200430,055342,鴻海凱基97購04,,,,,0.00,0.00,0,0,0,0,0,0,0,0,0,0,0,0,0
20200430,055343,國巨凱基97購03,0.86,0.86,0.81,0.81,+0.07,9.46,164000,6,134280,0,0,0,0,0,0,148000,16000,132000,132000
20200430,055344,國巨凱基97購04,2.09,2.09,1.98,2.07,+0.17,8.95,60000,4,125060,0,0,0,0,0,0,12000,50000,-38000,-38000
20200430,055345,國巨凱基98購01,,,,,0.00,0.00,0,0,0,0,0,0,0,0,0,0,0,0,0
20200430,055346,國巨凱基98購02,,,,,0.00,0.00,0,0,0,0,0,0,0,0,0,0,0,0,0
20200430,055347,台積電凱基97購10,,,,,0.00,0.00,0,0,0,0,0,0,0,0,0,0,0,0,0
20200430,055348,旺宏凱基97購01,1.21,1.21,1.11,1.11,+0.15,15.62,539000,7,623310,0,0,0,0,0,0,479000,60000,419000,419000
20200430,055349,京元電凱基97購02,1.95,1.96,1.95,1.96,+0.01,0.51,77000,3,150450,0,0,0,0,0,0,47000,30000,17000,17000
20200430,05534P,元油反元大96售06,,,,,0.00,0.00,0,0,0,0,0,0,0,0,0,0,0,0,0
20200430,055350,聯發科凱基97購02,,,,,0.00,0.00,0,0,0,0,0,0,0,0,0,0,0,0,0
20200430,055351,聯發科凱基97購03,4.82,4.98,4.82,4.98,+1.06,27.04,26000,4,127470,0,0,0,0,0,0,0,26000,-26000,-26000
20200430,055352,奇力新凱基97購01,0.56,0.61,0.56,0.61,+0.07,12.96,11000,2,6460,0,0,0,0,0,0,5000,6000,-1000,-1000
20200430,055353,華新科凱基98購03,,,,,0.00,0.00,0,0,0,0,0,0,0,0,0,0,0,0,0
20200430,055354,宏達電凱基98購01,,,,,0.00,0.00,0,0,0,0,0,0,0,0,0,0,0,0,0
20200430,055355,大立光凱基97購05,,,,,0.00,0.00,0,0,0,0,0,0,0,0,0,0,0,0,0
20200430,055356,大立光凱基97購06,,,,,0.00,0.00,0,0,0,0,0,0,0,0,0,0,0,0,0
20200430,055357,欣興凱基97購04,2.98,2.98,2.88,2.93,+0.34,13.13,25000,4,73400,0,0,0,0,0,0,15000,10000,5000,5000
20200430,055358,臻鼎凱基97購01,,,,,0.00,0.00,0,0,0,0,0,0,0,0,0,0,0,0,0
20200430,055359,超眾凱基97購01,1.44,1.48,1.44,1.48,+0.10,7.25,15000,3,22000,0,0,0,0,0,0,8000,15000,-7000,-7000
20200430,05535P,台積電元大97售06,0.85,0.85,0.85,0.85,-0.30,-26.09,2000,1,1700,0,0,0,0,0,0,0,2000,-2000,-2000
20200430,055360,台表科凱基97購02,0.67,0.67,0.64,0.65,-0.01,-1.52,68000,4,44880,0,0,0,0,0,0,0,68000,-68000,-68000
20200430,055361,樺漢凱基97購01,,,,,0.00,0.00,0,0,0,0,0,0,0,0,0,0,0,0,0
20200430,055362,GIS凱基97購03,,,,,0.00,0.00,0,0,0,0,0,0,0,0,0,0,0,0,0
20200430,055363,緯穎凱基98購03,2.28,2.74,2.28,2.65,+0.52,24.41,43000,11,105750,0,0,0,0,0,0,33000,35000,-2000,-2000
20200430,055364,矽創凱基97購03,,,,,0.00,0.00,0,0,0,0,0,0,0,0,0,0,0,0,0
20200430,055365,華通元大97購03,,,,,0.00,0.00,0,0,0,0,0,0,0,0,0,0,0,0,0
20200430,055366,國巨元大98購05,,,,,0.00,0.00,0,0,0,0,0,0,0,0,0,0,0,0,0
20200430,055367,台積電元大97購23,0.95,0.95,0.95,0.95,0.00,0.00,66000,1,62700,0,0,0,0,0,0,66000,66000,0,0
20200430,055368,台積電元大97購24,0.44,0.47,0.35,0.47,+0.10,27.03,26000,3,9310,0,0,0,0,0,0,24000,26000,-2000,-2000
20200430,055369,友訊元大97購01,,,,,0.00,0.00,0,0,0,0,0,0,0,0,0,0,0,0,0
20200430,05536P,奇力新元大96售03,,,,,0.00,0.00,0,0,0,0,0,0,0,0,0,0,0,0,0
20200430,055370,旺宏元大97購05,,,,,0.00,0.00,0,0,0,0,0,0,0,0,0,0,0,0,0
20200430,055371,正崴元大97購02,0.64,0.65,0.64,0.65,0.00,0.00,20000,3,12900,0,0,0,0,0,0,20000,0,20000,20000
20200430,055372,宏達電元大97購04,,,,,0.00,0.00,0,0,0,0,0,0,0,0,0,0,0,0,0
20200430,055373,聯詠元大97購03,,,,,0.00,0.00,0,0,0,0,0,0,0,0,0,0,0,0,0
20200430,055374,明泰元大97購01,1.75,1.75,1.46,1.46,-0.03,-2.01,65000,9,104800,0,0,0,0,0,0,0,65000,-65000,-65000
20200430,055375,京鼎元大97購03,,,,,0.00,0.00,0,0,0,0,0,0,0,0,0,0,0,0,0
20200430,055376,群創元大01購01,0.65,0.65,0.64,0.64,-0.05,-7.25,100000,3,64800,0,0,0,0,0,0,100000,0,100000,100000
20200430,055377,揚明光元大98購01,0.72,0.72,0.70,0.70,+0.02,2.94,1102000,25,775820,0,0,0,0,0,0,332000,770000,-438000,-438000
20200430,055378,晶相光元大97購02,,,,,0.00,0.00,0,0,0,0,0,0,0,0,0,0,0,0,0
20200430,055379,牧德元大97購03,,,,,0.00,0.00,0,0,0,0,0,0,0,0,0,0,0,0,0
20200430,05537P,群創中信98售01,,,,,0.00,0.00,0,0,0,0,0,0,0,0,0,0,0,0,0
20200430,055380,智易元大98購02,1.70,1.70,1.64,1.64,-0.15,-8.38,235000,9,394720,0,0,0,0,0,0,235000,0,235000,235000
20200430,055381,茂林元大97購02,3.00,3.00,3.00,3.00,-0.37,-10.98,2000,1,6000,0,0,0,0,0,0,2000,0,2000,2000
20200430,055382,台郡元大99購01,3.51,3.51,3.51,3.51,+0.26,8.0,10000,1,35100,0,0,0,0,0,0,0,10000,-10000,-10000
20200430,055383,GIS元大97購02,0.70,0.71,0.70,0.71,0.00,0.00,90000,2,63300,0,0,0,0,0,0,90000,0,90000,90000
20200430,055384,緯穎元大98購02,,,,,0.00,0.00,0,0,0,0,0,0,0,0,0,0,0,0,0
20200430,055385,昇陽半元大98購01,,,,,0.00,0.00,0,0,0,0,0,0,0,0,0,0,0,0,0
20200430,055386,致新元大97購02,1.04,1.04,1.04,1.04,+0.11,11.83,10000,1,10400,0,0,0,0,0,0,10000,0,10000,10000
20200430,055387,世紀鋼元大97購01,1.80,1.88,1.80,1.88,+0.11,6.21,41000,3,74480,0,0,0,0,0,0,21000,20000,1000,1000
20200430,055388,華通統一97購03,1.73,2.05,1.71,2.04,+0.38,22.89,248000,14,472790,0,0,0,0,0,0,79000,171000,-92000,-92000
20200430,055389,國巨統一98購02,,,,,0.00,0.00,0,0,0,0,0,0,0,0,0,0,0,0,0
20200430,05538P,玉晶光國票97售02,2.24,2.24,2.00,2.07,-0.41,-16.53,135000,9,276020,0,0,0,0,0,0,70000,65000,5000,5000
20200430,055390,國巨統一98購03,4.04,4.04,4.04,4.04,0.00,0.00,1000,1,4040,0,0,0,0,0,0,1000,0,1000,1000
20200430,055391,光罩統一97購02,0.25,0.25,0.25,0.25,+0.03,13.64,30000,1,7500,0,0,0,0,0,0,30000,0,30000,30000
20200430,055392,凱美統一97購03,0.19,0.19,0.19,0.19,0.00,0.00,20000,1,3800,0,0,0,0,0,0,0,20000,-20000,-20000
20200430,055393,華新科統一97購03,2.09,2.16,2.09,2.11,0.00,0.00,119000,4,251110,0,0,0,0,0,0,0,119000,-119000,-119000
20200430,055394,健策統一97購01,1.00,1.00,0.94,0.94,+0.13,16.05,42000,5,41880,0,0,0,0,0,0,0,42000,-42000,-42000
20200430,055395,泰鼎統一97購01,,,,,0.00,0.00,0,0,0,0,0,0,0,0,0,0,0,0,0
20200430,055396,瑞儀統一97購01,,,,,0.00,0.00,0,0,0,0,0,0,0,0,0,0,0,0,0
20200430,055397,超眾統一97購02,0.38,0.41,0.37,0.37,-0.03,-7.5,812000,8,313350,0,0,0,0,0,0,50000,762000,-712000,-712000
20200430,055398,超眾統一97購03,,,,,0.00,0.00,0,0,0,0,0,0,0,0,0,0,0,0,0
20200430,055399,超眾統一99購01,0.49,0.49,0.39,0.39,0.00,0.00,55000,2,21950,0,0,0,0,0,0,50000,5000,45000,45000
20200430,05539P,鎧勝永豐96售01,,,,,0.00,0.00,0,0,0,0,0,0,0,0,0,0,0,0,0
20200430,055400,緯穎統一97購01,3.90,4.46,3.85,4.41,+0.78,21.49,94000,11,399790,0,0,0,0,0,0,24000,70000,-46000,-46000
20200430,055401,亞光元富9A購01,0.08,0.08,0.08,0.08,0.00,0.00,12000,1,960,0,0,0,0,0,0,12000,0,12000,12000
20200430,055402,正文元富97購02,0.95,0.95,0.92,0.94,-0.02,-2.08,178000,11,167120,0,0,0,0,0,0,80000,98000,-18000,-18000
20200430,055403,泰鼎元富97購01,3.52,3.54,3.41,3.54,-0.13,-3.54,294000,15,1023160,0,0,0,0,0,0,94000,200000,-106000,-106000
20200430,055404,超眾元富97購01,0.69,0.77,0.69,0.69,+0.01,1.47,477000,14,350410,0,0,0,0,0,0,285000,192000,93000,93000
20200430,055405,華泰國泰98購01,0.30,0.30,0.30,0.30,0.00,0.00,5000,1,1500,0,0,0,0,0,0,5000,0,5000,5000
20200430,055406,大毅國泰99購01,2.53,2.60,2.44,2.44,0.00,0.00,30000,5,75700,0,0,0,0,0,0,8000,20000,-12000,-12000
20200430,055407,祥碩國泰98購01,5.20,5.20,4.39,4.57,-0.48,-9.5,62000,7,280730,0,0,0,0,0,0,27000,35000,-8000,-8000
20200430,055408,力成國泰98購01,,,,,0.00,0.00,0,0,0,0,0,0,0,0,0,0,0,0,0
20200430,055409,元黃金富邦01購01,1.66,1.66,1.61,1.61,0.00,0.00,19000,2,30640,0,0,0,0,0,0,18000,0,18000,18000
20200430,05540P,亞德客凱基96售01,0.04,0.04,0.04,0.04,-0.11,-73.33,10000,1,400,0,0,0,0,0,0,10000,0,10000,10000
20200430,055410,元油反富邦9A購01,,,,,0.00,0.00,0,0,0,0,0,0,0,0,0,0,0,0,0
20200430,055411,國巨富邦9A購02,0.33,0.33,0.29,0.31,0.00,0.00,91000,8,28110,0,0,0,0,0,0,0,0,0,0
20200430,055412,旺宏富邦99購01,0.30,0.30,0.30,0.30,+0.09,42.86,1000,1,300,0,0,0,0,0,0,1000,0,1000,1000
20200430,055413,全新富邦98購01,0.10,0.10,0.10,0.10,0.00,0.00,40000,1,4000,0,0,0,0,0,0,0,40000,-40000,-40000
20200430,055414,奇力新富邦9B購01,0.24,0.30,0.24,0.30,+0.04,15.38,11000,2,3240,0,0,0,0,0,0,1000,0,1000,1000
20200430,055415,禾伸堂富邦9B購01,,,,,0.00,0.00,0,0,0,0,0,0,0,0,0,0,0,0,0
20200430,055416,欣興富邦98購01,0.43,0.52,0.43,0.51,+0.11,27.5,48000,17,21530,0,0,0,0,0,0,42000,3000,39000,39000
20200430,055417,健策富邦98購02,0.24,0.26,0.24,0.25,+0.02,8.7,18000,3,4440,0,0,0,0,0,0,14000,10000,4000,4000
20200430,055418,華通永豐97購01,0.06,0.06,0.06,0.06,0.00,0.00,3000,1,180,0,0,0,0,0,0,3000,0,3000,3000
20200430,055419,國巨永豐97購03,1.30,1.30,1.30,1.30,0.00,0.00,10000,1,13000,0,0,0,0,0,0,10000,0,10000,10000
20200430,05541P,鴻海統一96售08,,,,,0.00,0.00,0,0,0,0,0,0,0,0,0,0,0,0,0
20200430,055420,欣興永豐98購01,1.35,1.35,1.30,1.30,+0.08,6.56,15000,2,19750,0,0,0,0,0,0,0,15000,-15000,-15000
20200430,055421,玉晶光永豐98購04,0.61,0.69,0.61,0.69,+0.12,21.05,78000,2,48780,0,0,0,0,0,0,63000,15000,48000,48000
20200430,055422,康控永豐97購01,,,,,0.00,0.00,0,0,0,0,0,0,0,0,0,0,0,0,0
20200430,055423,亞光亞東99購01,,,,,0.00,0.00,0,0,0,0,0,0,0,0,0,0,0,0,0
20200430,055424,聚陽群益98購01,,,,,0.00,0.00,0,0,0,0,0,0,0,0,0,0,0,0,0
20200430,055425,聚陽群益99購01,0.25,0.28,0.25,0.28,+0.03,12.0,90000,3,24900,0,0,0,0,0,0,90000,0,90000,90000
20200430,055426,旺宏群益99購02,2.14,2.14,2.11,2.13,+0.35,19.66,491000,5,1042630,0,0,0,0,0,0,460000,31000,429000,429000
20200430,055427,技嘉群益98購01,,,,,0.00,0.00,0,0,0,0,0,0,0,0,0,0,0,0,0
20200430,055428,友達群益9C購01,0.13,0.22,0.13,0.22,+0.04,22.22,71000,2,9320,0,0,0,0,0,0,0,0,0,0
20200430,055429,華新科群益99購01,0.58,0.58,0.58,0.58,0.00,0.00,10000,1,5800,0,0,0,0,0,0,10000,0,10000,10000
20200430,05542P,滬深2X元富96售01,,,,,0.00,0.00,0,0,0,0,0,0,0,0,0,0,0,0,0
20200430,055430,宏達電群益97購01,,,,,0.00,0.00,0,0,0,0,0,0,0,0,0,0,0,0,0
20200430,055431,和鑫群益98購01,0.21,0.21,0.21,0.21,-0.03,-12.5,50000,1,10500,0,0,0,0,0,0,50000,0,50000,50000
20200430,055432,臻鼎群益97購02,1.17,1.34,1.15,1.32,+0.17,14.78,842000,21,1007800,0,0,0,0,0,0,432000,410000,22000,22000
20200430,055433,嘉聯益群益99購01,1.00,1.03,1.00,1.01,+0.02,2.02,272000,4,277720,0,0,0,0,0,0,114000,158000,-44000,-44000
20200430,055434,樺漢群益97購01,,,,,0.00,0.00,0,0,0,0,0,0,0,0,0,0,0,0,0
20200430,055435,佳世達中信99購01,,,,,0.00,0.00,0,0,0,0,0,0,0,0,0,0,0,0,0
20200430,055436,晶豪科中信99購01,1.23,1.23,1.13,1.13,+0.04,3.67,17000,2,20710,0,0,0,0,0,0,15000,2000,13000,13000
20200430,055437,禾伸堂中信99購01,1.71,1.72,1.58,1.58,0.00,0.00,253000,30,427730,0,0,0,0,0,0,105000,133000,-28000,-28000
20200430,055438,鴻海國票98購01,,,,,0.00,0.00,0,0,0,0,0,0,0,0,0,0,0,0,0
20200430,055439,台表科國票98購02,,,,,0.00,0.00,0,0,0,0,0,0,0,0,0,0,0,0,0
20200430,05543P,鴻海元富96售04,,,,,0.00,0.00,0,0,0,0,0,0,0,0,0,0,0,0,0
20200430,055440,矽力國票98購01,7.90,7.90,7.90,7.90,-0.20,-2.47,3000,1,23700,0,0,0,0,0,0,0,3000,-3000,-3000
20200430,055441,緯穎國票98購01,5.25,5.25,5.25,5.25,+0.20,3.96,10000,1,52500,0,0,0,0,0,0,10000,0,10000,10000
20200430,055442,矽創國票98購02,1.55,1.67,1.55,1.67,+0.20,13.61,200000,16,315500,0,0,0,0,0,0,130000,70000,60000,60000
20200430,055443,台虹國票98購01,2.20,2.20,2.17,2.17,-0.04,-1.81,14000,2,30650,0,0,0,0,0,0,9000,5000,4000,4000
20200430,055444,致新台新97購01,1.47,1.59,0.65,0.65,-0.75,-53.57,445000,38,635520,0,0,0,0,0,0,235000,200000,35000,35000
20200430,055445,旺宏統一99購01,0.73,0.76,0.73,0.76,+0.11,16.92,33000,2,24510,0,0,0,0,0,0,33000,0,33000,33000
20200430,055446,奇力新統一9A購01,0.70,0.70,0.46,0.58,+0.03,5.45,153000,3,70740,0,0,0,0,0,0,151000,0,151000,151000
20200430,055447,華新科統一97購04,,,,,0.00,0.00,0,0,0,0,0,0,0,0,0,0,0,0,0
20200430,055448,健策統一97購02,0.75,0.75,0.65,0.65,0.00,0.00,40000,4,28300,0,0,0,0,0,0,40000,40000,0,0
20200430,055449,超眾統一9A購01,2.02,2.10,2.02,2.10,+0.10,5.0,59000,4,122540,0,0,0,0,0,0,6000,53000,-47000,-47000
20200430,05544P,台表科元富96售01,,,,,0.00,0.00,0,0,0,0,0,0,0,0,0,0,0,0,0
20200430,055450,台積電元富97購01,,,,,0.00,0.00,0,0,0,0,0,0,0,0,0,0,0,0,0
20200430,055451,台積電元富97購02,,,,,0.00,0.00,0,0,0,0,0,0,0,0,0,0,0,0,0
20200430,055452,台積電元富97購03,,,,,0.00,0.00,0,0,0,0,0,0,0,0,0,0,0,0,0
20200430,055453,華邦電元富97購01,,,,,0.00,0.00,0,0,0,0,0,0,0,0,0,0,0,0,0
20200430,055454,華邦電元富97購02,,,,,0.00,0.00,0,0,0,0,0,0,0,0,0,0,0,0,0
20200430,055455,健策國泰98購02,0.69,0.70,0.67,0.67,0.00,0.00,40000,3,27300,0,0,0,0,0,0,40000,0,40000,40000
20200430,055456,上銀富邦99購01,0.95,1.20,0.95,1.20,+0.38,46.34,114000,6,122100,0,0,0,0,0,0,114000,0,114000,114000
20200430,055457,聚陽永豐97購01,0.10,0.10,0.09,0.09,0.00,0.00,37000,3,3530,0,0,0,0,0,0,0,0,0,0
20200430,055458,燿華永豐98購01,0.52,0.58,0.52,0.58,+0.02,3.57,752000,15,432610,0,0,0,0,0,0,15000,737000,-722000,-722000
20200430,055459,建準永豐97購03,1.19,1.19,1.19,1.19,-0.01,-0.83,25000,1,29750,0,0,0,0,0,0,25000,25000,0,0
20200430,05545P,台表科國泰98售01,1.42,1.48,1.42,1.45,-0.04,-2.68,74000,12,108270,0,0,0,0,0,0,49000,20000,29000,29000
20200430,055460,華擎永豐97購01,2.78,2.78,2.68,2.69,0.00,0.00,58000,7,159040,0,0,0,0,0,0,0,58000,-58000,-58000
20200430,055461,TPK永豐97購01,0.40,0.40,0.40,0.40,-0.03,-6.98,4000,4,1600,0,0,0,0,0,0,4000,0,4000,4000
20200430,055462,華邦電日盛97購01,,,,,0.00,0.00,0,0,0,0,0,0,0,0,0,0,0,0,0
20200430,055463,國喬凱基97購01,,,,,0.00,0.00,0,0,0,0,0,0,0,0,0,0,0,0,0
20200430,055464,聚陽凱基97購01,,,,,0.00,0.00,0,0,0,0,0,0,0,0,0,0,0,0,0
20200430,055465,和大凱基97購03,0.05,0.05,0.05,0.05,0.00,0.00,2000,1,100,0,0,0,0,0,0,2000,0,2000,2000
20200430,055466,台達電凱基97購03,0.91,1.04,0.84,0.97,+0.11,12.79,370000,47,355310,0,0,0,0,0,0,140000,210000,-70000,-70000
20200430,055467,國巨凱基97購05,1.12,1.12,1.12,1.12,0.00,0.00,1000,1,1120,0,0,0,0,0,0,1000,0,1000,1000
20200430,055468,智邦凱基97購04,8.15,8.55,8.15,8.55,+0.15,1.79,5000,5,41750,0,0,0,0,0,0,5000,0,5000,5000
20200430,055469,台光電凱基97購01,2.40,2.40,2.40,2.40,0.00,0.00,10000,1,24000,0,0,0,0,0,0,0,10000,-10000,-10000
20200430,05546P,全新元大97售01,1.75,1.79,1.71,1.78,-0.03,-1.66,184000,10,323060,0,0,0,0,0,0,0,181000,-181000,-181000
20200430,055470,南亞科凱基97購01,1.03,1.03,1.01,1.01,+0.04,4.12,14000,3,14340,0,0,0,0,0,0,14000,0,14000,14000
20200430,055471,聯發科凱基97購04,3.72,3.95,3.70,3.95,+0.69,21.17,153000,6,595660,0,0,0,0,0,0,36000,117000,-81000,-81000
20200430,055472,大立光凱基97購07,1.35,1.45,1.35,1.45,+0.18,14.17,34000,2,46300,0,0,0,0,0,0,30000,4000,26000,26000
20200430,055473,禾伸堂凱基97購01,,,,,0.00,0.00,0,0,0,0,0,0,0,0,0,0,0,0,0
20200430,055474,欣興凱基97購05,1.40,1.40,1.40,1.40,+0.17,13.82,10000,2,14000,0,0,0,0,0,0,0,9000,-9000,-9000
20200430,055475,臻鼎凱基97購02,1.22,1.39,1.22,1.39,+0.24,20.87,93000,7,117480,0,0,0,0,0,0,49000,44000,5000,5000
20200430,055476,台郡凱基97購02,,,,,0.00,0.00,0,0,0,0,0,0,0,0,0,0,0,0,0
20200430,055477,同欣電凱基98購01,0.40,0.40,0.40,0.40,0.00,0.00,10000,1,4000,0,0,0,0,0,0,0,10000,-10000,-10000
20200430,055478,訊芯凱基97購01,,,,,0.00,0.00,0,0,0,0,0,0,0,0,0,0,0,0,0
20200430,055479,GIS凱基97購04,1.40,1.43,1.38,1.38,-0.02,-1.43,474000,12,656400,0,0,0,0,0,0,460000,0,460000,460000
20200430,05547P,群創元大96售03,,,,,0.00,0.00,0,0,0,0,0,0,0,0,0,0,0,0,0
20200430,055480,元上證元大97購02,0.35,0.35,0.35,0.35,0.00,0.00,5000,5,1750,0,0,0,0,0,0,5000,0,5000,5000
20200430,055481,聚陽元大97購01,0.30,0.33,0.30,0.33,+0.12,57.14,140000,14,43800,0,0,0,0,0,0,0,140000,-140000,-140000
20200430,055482,聚陽元大97購02,,,,,0.00,0.00,0,0,0,0,0,0,0,0,0,0,0,0,0
20200430,055483,和大元大97購03,,,,,0.00,0.00,0,0,0,0,0,0,0,0,0,0,0,0,0
20200430,055484,華通元大97購04,0.42,0.42,0.42,0.42,0.00,0.00,60000,1,25200,0,0,0,0,0,0,60000,0,60000,60000
20200430,055485,國巨元大97購09,,,,,0.00,0.00,0,0,0,0,0,0,0,0,0,0,0,0,0
20200430,055486,國巨元大98購06,1.51,1.51,1.51,1.51,0.00,0.00,2000,1,3020,0,0,0,0,0,0,2000,0,2000,2000
20200430,055487,國巨元大98購07,1.37,1.37,1.37,1.37,0.00,0.00,8000,1,10960,0,0,0,0,0,0,8000,0,8000,8000
20200430,055488,華邦電元大98購01,,,,,0.00,0.00,0,0,0,0,0,0,0,0,0,0,0,0,0
20200430,055489,瑞昱元大97購02,2.22,2.66,2.22,2.58,+0.55,27.09,82000,15,199220,0,0,0,0,0,0,46000,28000,18000,18000
20200430,05548P,臺股指元大96售02,,,,,0.00,0.00,0,0,0,0,0,0,0,0,0,0,0,0,0
20200430,055490,台光電元大97購01,1.32,1.32,1.32,1.32,+0.05,3.94,135000,5,178200,0,0,0,0,0,0,68000,67000,1000,1000
20200430,055491,奇力新元大98購03,,,,,0.00,0.00,0,0,0,0,0,0,0,0,0,0,0,0,0
20200430,055492,華新科元大97購08,0.46,0.47,0.46,0.47,0.00,0.00,18000,3,8430,0,0,0,0,0,0,18000,0,18000,18000
20200430,055493,華新科元大97購09,,,,,0.00,0.00,0,0,0,0,0,0,0,0,0,0,0,0,0
20200430,055494,華新科元大98購01,,,,,0.00,0.00,0,0,0,0,0,0,0,0,0,0,0,0,0
20200430,055495,長榮航元大97購01,0.17,0.17,0.17,0.17,+0.04,30.77,20000,2,3400,0,0,0,0,0,0,0,0,0,0
20200430,055496,高鐵元大97購02,,,,,0.00,0.00,0,0,0,0,0,0,0,0,0,0,0,0,0
20200430,055497,開發金元大97購01,0.78,0.79,0.75,0.79,+0.05,6.76,1144000,27,885780,0,20000,-20000,0,0,0,758000,376000,382000,362000
20200430,055498,大立光元大97購07,,,,,0.00,0.00,0,0,0,0,0,0,0,0,0,0,0,0,0
20200430,055499,大立光元大98購05,0.40,0.40,0.40,0.40,0.00,0.00,16000,1,6400,0,0,0,0,0,0,16000,0,16000,16000
20200430,05549P,臺股指元大96售03,0.88,0.88,0.78,0.78,-0.37,-32.17,35000,2,29300,0,0,0,0,0,0,35000,0,35000,35000
20200430,055500,京鼎元大97購04,,,,,0.00,0.00,0,0,0,0,0,0,0,0,0,0,0,0,0
20200430,055501,創意元大97購01,1.66,1.66,1.66,1.66,0.00,0.00,2000,1,3320,0,0,0,0,0,0,0,2000,-2000,-2000
20200430,055502,群創元大9C購03,,,,,0.00,0.00,0,0,0,0,0,0,0,0,0,0,0,0,0
20200430,055503,健策元大98購05,0.66,0.66,0.66,0.66,+0.02,3.12,20000,2,13200,0,0,0,0,0,0,10000,0,10000,10000
20200430,055504,貿聯元大98購04,,,,,0.00,0.00,0,0,0,0,0,0,0,0,0,0,0,0,0
20200430,055505,新唐元大97購02,0.41,0.41,0.40,0.40,+0.01,2.56,40000,2,16200,0,0,0,0,0,0,20000,20000,0,0
20200430,055506,台郡元大99購02,,,,,0.00,0.00,0,0,0,0,0,0,0,0,0,0,0,0,0
20200430,055507,樺漢元大98購02,0.26,0.37,0.26,0.37,+0.12,48.0,20000,2,6300,0,0,0,0,0,0,0,0,0,0
20200430,055508,矽力元大97購01,,,,,0.00,0.00,0,0,0,0,0,0,0,0,0,0,0,0,0
20200430,055509,訊芯元大97購03,0.61,0.70,0.61,0.69,+0.08,13.11,236000,8,154720,0,0,0,0,0,0,25000,211000,-186000,-186000
20200430,05550P,臺股指元大96售07,,,,,0.00,0.00,0,0,0,0,0,0,0,0,0,0,0,0,0
20200430,055510,GIS元大97購03,2.22,2.26,2.15,2.15,-0.01,-0.46,304000,17,662900,0,0,0,0,0,0,304000,0,304000,304000
20200430,055511,大立光兆豐97購02,,,,,0.00,0.00,0,0,0,0,0,0,0,0,0,0,0,0,0
20200430,055512,聯詠兆豐97購01,0.33,0.33,0.33,0.33,+0.01,3.12,1000,1,330,0,0,0,0,0,0,1000,0,1000,1000
20200430,055513,旺宏亞東98購01,0.56,0.56,0.56,0.56,0.00,0.00,3000,1,1680,0,0,0,0,0,0,3000,0,3000,3000
20200430,055514,亞光麥證97購01,,,,,0.00,0.00,0,0,0,0,0,0,0,0,0,0,0,0,0
20200430,055515,聚陽中信9A購01,0.20,0.24,0.20,0.24,+0.03,14.29,78000,9,17280,0,0,0,0,0,0,18000,60000,-42000,-42000
20200430,055516,上銀中信97購01,0.52,0.70,0.52,0.70,0.00,0.00,103000,2,54100,0,0,0,0,0,0,100000,0,100000,100000
20200430,055517,國巨中信97購03,,,,,0.00,0.00,0,0,0,0,0,0,0,0,0,0,0,0,0
20200430,055518,華新科中信99購01,0.31,0.35,0.29,0.31,-0.01,-3.12,321000,33,101540,0,0,0,0,0,0,80000,0,80000,80000
20200430,055519,茂林中信99購01,0.94,0.94,0.88,0.88,-0.12,-12.0,60000,5,54700,0,0,0,0,0,0,40000,20000,20000,20000
20200430,05551P,電子類元大96售01,1.14,1.14,1.14,1.14,-0.23,-16.79,25000,4,28500,0,0,0,0,0,0,5000,0,5000,5000
20200430,055520,矽力中信97購02,,,,,0.00,0.00,0,0,0,0,0,0,0,0,0,0,0,0,0
20200430,055521,S&P反1群益01購01,2.54,2.54,2.54,2.54,-0.11,-4.15,2000,1,5080,0,0,0,0,0,0,2000,0,2000,2000
20200430,055522,道瓊反群益01購01,,,,,0.00,0.00,0,0,0,0,0,0,0,0,0,0,0,0,0
20200430,055523,道瓊銀群益9A購01,0.70,0.70,0.70,0.70,0.00,0.00,15000,2,10500,0,0,0,0,0,0,0,0,0,0
20200430,055524,鴻海群益98購01,,,,,0.00,0.00,0,0,0,0,0,0,0,0,0,0,0,0,0
20200430,055525,國巨群益98購05,2.96,2.96,2.83,2.89,+0.17,6.25,58000,9,167390,0,0,0,0,0,0,0,58000,-58000,-58000
20200430,055526,台積電群益97購02,,,,,0.00,0.00,0,0,0,0,0,0,0,0,0,0,0,0,0
20200430,055527,旺宏群益99購03,2.19,2.19,2.14,2.17,+0.37,20.56,310000,9,672680,0,0,0,0,0,0,308000,10000,298000,298000
20200430,055528,華邦電群益97購01,,,,,0.00,0.00,0,0,0,0,0,0,0,0,0,0,0,0,0
20200430,055529,華邦電群益97購02,,,,,0.00,0.00,0,0,0,0,0,0,0,0,0,0,0,0,0
20200430,05552P,聯詠群益96售01,,,,,0.00,0.00,0,0,0,0,0,0,0,0,0,0,0,0,0
20200430,055530,聯發科群益98購01,0.66,0.70,0.66,0.70,+0.26,59.09,106000,2,70200,0,0,0,0,0,0,106000,0,106000,106000
20200430,055531,華新科群益98購03,1.30,1.35,1.26,1.27,+0.02,1.6,131000,6,170150,0,0,0,0,0,0,35000,96000,-61000,-61000
20200430,055532,中工群益98購01,,,,,0.00,0.00,0,0,0,0,0,0,0,0,0,0,0,0,0
20200430,055533,大立光群益97購03,2.23,2.53,2.23,2.53,+0.32,14.48,104000,6,238640,0,0,0,0,0,0,37000,67000,-30000,-30000
20200430,055534,晶技群益97購03,,,,,0.00,0.00,0,0,0,0,0,0,0,0,0,0,0,0,0
20200430,055535,緯創群益98購01,,,,,0.00,0.00,0,0,0,0,0,0,0,0,0,0,0,0,0
20200430,055536,嘉聯益群益99購02,1.34,1.34,1.34,1.34,0.00,0.00,63000,2,84420,0,0,0,0,0,0,0,63000,-63000,-63000
20200430,055537,康友群益97購03,0.38,0.38,0.38,0.38,+0.04,11.76,20000,1,7600,0,0,0,0,0,0,0,20000,-20000,-20000
20200430,055538,鴻海日盛97購04,0.10,0.13,0.10,0.13,-0.01,-7.14,3000,2,330,0,0,0,0,0,0,0,0,0,0
20200430,055539,億光台新97購01,0.02,0.02,0.02,0.02,0.00,0.00,10000,1,200,0,0,0,0,0,0,0,10000,-10000,-10000
20200430,05553P,智原群益96售01,,,,,0.00,0.00,0,0,0,0,0,0,0,0,0,0,0,0,0
20200430,055540,京鼎台新97購01,0.40,0.40,0.40,0.40,-0.01,-2.44,56000,2,22400,0,0,0,0,0,0,56000,0,56000,56000
20200430,055541,聚陽凱基98購01,,,,,0.00,0.00,0,0,0,0,0,0,0,0,0,0,0,0,0
20200430,055542,亞德客凱基97購01,0.48,0.48,0.48,0.48,0.00,0.00,1000,1,480,0,0,0,0,0,0,1000,0,1000,1000
20200430,055543,為升凱基97購01,,,,,0.00,0.00,0,0,0,0,0,0,0,0,0,0,0,0,0
20200430,055544,鴻海凱基97購05,,,,,0.00,0.00,0,0,0,0,0,0,0,0,0,0,0,0,0
20200430,055545,國巨凱基97購06,2.88,2.99,2.76,2.89,+0.18,6.64,73000,12,211220,0,0,0,0,0,0,58000,18000,40000,40000
20200430,055546,台積電凱基97購12,,,,,0.00,0.00,0,0,0,0,0,0,0,0,0,0,0,0,0
20200430,055547,台積電凱基97購13,,,,,0.00,0.00,0,0,0,0,0,0,0,0,0,0,0,0,0
20200430,055548,旺宏凱基97購02,,,,,0.00,0.00,0,0,0,0,0,0,0,0,0,0,0,0,0
20200430,055549,旺宏凱基97購03,,,,,0.00,0.00,0,0,0,0,0,0,0,0,0,0,0,0,0
20200430,05554P,群創群益96售02,,,,,0.00,0.00,0,0,0,0,0,0,0,0,0,0,0,0,0
20200430,055550,華邦電凱基97購03,,,,,0.00,0.00,0,0,0,0,0,0,0,0,0,0,0,0,0
20200430,055551,致茂凱基98購01,,,,,0.00,0.00,0,0,0,0,0,0,0,0,0,0,0,0,0
20200430,055552,瑞昱凱基97購02,1.07,1.07,1.07,1.07,+0.26,32.1,40000,1,42800,0,0,0,0,0,0,40000,0,40000,40000
20200430,055553,聯發科凱基97購05,0.13,0.13,0.13,0.13,+0.05,62.5,1000,1,130,0,0,0,0,0,0,1000,0,1000,1000
20200430,055554,聯發科凱基97購06,4.16,4.16,4.14,4.14,+0.41,10.99,46000,3,190920,0,0,0,0,0,0,46000,0,46000,46000
20200430,055555,全新凱基9A購01,0.64,0.65,0.61,0.61,-0.02,-3.17,138000,10,86620,0,0,0,0,0,0,138000,0,138000,138000
20200430,055556,奇力新凱基98購03,0.74,0.74,0.74,0.74,0.00,0.00,10000,2,7400,0,0,0,0,0,0,0,10000,-10000,-10000
20200430,055557,華新科凱基97購01,,,,,0.00,0.00,0,0,0,0,0,0,0,0,0,0,0,0,0
20200430,055558,大立光凱基97購08,1.98,2.12,1.98,2.12,+0.16,8.16,39000,2,77360,0,0,0,0,0,0,39000,0,39000,39000
20200430,055559,大立光凱基97購09,1.85,2.05,1.85,2.05,+0.25,13.89,84000,4,161560,0,0,0,0,0,0,35000,49000,-14000,-14000
20200430,05555P,健策群益98售01,,,,,0.00,0.00,0,0,0,0,0,0,0,0,0,0,0,0,0
20200430,055560,大立光凱基97購10,0.59,0.59,0.59,0.59,0.00,0.00,10000,1,5900,0,0,0,0,0,0,0,10000,-10000,-10000
20200430,055561,奇鋐凱基97購01,1.59,1.66,1.58,1.66,0.00,0.00,62000,9,99290,0,0,0,0,0,0,9000,62000,-53000,-53000
20200430,055562,欣興凱基97購06,2.70,2.70,2.70,2.70,+0.25,10.2,11000,1,29700,0,0,0,0,0,0,11000,0,11000,11000
20200430,055563,智易凱基97購02,1.27,1.27,1.27,1.27,-0.08,-5.93,10000,1,12700,0,0,0,0,0,0,10000,0,10000,10000
20200430,055564,茂林凱基98購01,,,,,0.00,0.00,0,0,0,0,0,0,0,0,0,0,0,0,0
20200430,055565,祥碩凱基97購01,3.01,3.01,2.10,2.22,-0.62,-21.83,125000,14,265910,0,0,0,0,0,0,25000,90000,-65000,-65000
20200430,055566,台表科凱基97購03,0.72,0.72,0.72,0.72,-0.06,-7.69,10000,1,7200,0,0,0,0,0,0,0,10000,-10000,-10000
20200430,055567,訊芯凱基98購02,,,,,0.00,0.00,0,0,0,0,0,0,0,0,0,0,0,0,0
20200430,055568,緯穎凱基97購02,,,,,0.00,0.00,0,0,0,0,0,0,0,0,0,0,0,0,0
20200430,055569,聚陽統一98購01,0.22,0.22,0.22,0.22,0.00,0.00,6000,1,1320,0,0,0,0,0,0,6000,0,6000,6000
20200430,05556P,全新國票96售04,,,,,0.00,0.00,0,0,0,0,0,0,0,0,0,0,0,0,0
20200430,055570,華通統一98購03,,,,,0.00,0.00,0,0,0,0,0,0,0,0,0,0,0,0,0
20200430,055571,鴻海統一97購03,,,,,0.00,0.00,0,0,0,0,0,0,0,0,0,0,0,0,0
20200430,055572,鴻海統一98購04,2.73,2.79,2.73,2.79,+0.02,0.72,163000,6,448430,0,0,0,0,0,0,85000,78000,7000,7000
20200430,055573,國巨統一97購06,,,,,0.00,0.00,0,0,0,0,0,0,0,0,0,0,0,0,0
20200430,055574,美律統一97購01,,,,,0.00,0.00,0,0,0,0,0,0,0,0,0,0,0,0,0
20200430,055575,華新科統一98購01,1.53,1.53,1.45,1.45,0.00,0.00,93000,3,136530,0,0,0,0,0,0,0,93000,-93000,-93000
20200430,055576,嘉晶統一98購01,2.41,2.70,2.41,2.62,+0.41,18.55,201000,10,531650,0,0,0,0,0,0,0,201000,-201000,-201000
20200430,055577,晶技統一97購02,,,,,0.00,0.00,0,0,0,0,0,0,0,0,0,0,0,0,0
20200430,055578,群創統一98購03,,,,,0.00,0.00,0,0,0,0,0,0,0,0,0,0,0,0,0
20200430,055579,健策統一9A購01,,,,,0.00,0.00,0,0,0,0,0,0,0,0,0,0,0,0,0
20200430,05557P,S&P500中信96售02,,,,,0.00,0.00,0,0,0,0,0,0,0,0,0,0,0,0,0
20200430,055580,南茂統一97購01,,,,,0.00,0.00,0,0,0,0,0,0,0,0,0,0,0,0,0
20200430,055581,和大元大97購04,,,,,0.00,0.00,0,0,0,0,0,0,0,0,0,0,0,0,0
20200430,055582,亞德客元大97購01,2.89,2.89,2.64,2.64,+0.09,3.53,3000,2,8170,0,0,0,0,0,0,3000,3000,0,0
20200430,055583,國巨元大97購10,3.79,3.92,3.61,3.74,+0.12,3.31,28000,19,105160,0,0,0,0,0,0,19000,28000,-9000,-9000
20200430,055584,國巨元大97購11,1.31,1.33,1.27,1.31,+0.10,8.26,36000,6,46920,0,0,0,0,0,0,12000,24000,-12000,-12000
20200430,055585,國巨元大98購08,,,,,0.00,0.00,0,0,0,0,0,0,0,0,0,0,0,0,0
20200430,055586,旺宏元大98購06,3.60,3.60,3.37,3.48,+0.39,12.62,97000,23,337180,0,0,0,0,0,0,84000,27000,57000,57000
20200430,055587,智邦元大97購02,6.95,7.20,6.95,7.20,-0.10,-1.37,2000,2,14150,0,0,0,0,0,0,2000,2000,0,0
20200430,055588,瑞昱元大97購03,1.50,1.67,1.50,1.67,0.00,0.00,11000,3,16670,0,0,0,0,0,0,10000,1000,9000,9000
20200430,055589,台光電元大98購04,3.40,3.90,3.40,3.90,+0.61,18.54,47000,6,172030,0,0,0,0,0,0,0,47000,-47000,-47000
20200430,05558P,鴻海麥證96售01,,,,,0.00,0.00,0,0,0,0,0,0,0,0,0,0,0,0,0
20200430,055590,聯發科元大98購02,1.35,1.51,1.35,1.51,+0.41,37.27,336000,34,472490,0,0,0,0,0,0,177000,10000,167000,167000
20200430,055591,全新元大98購01,0.86,0.86,0.86,0.86,+0.03,3.61,34000,1,29240,0,0,0,0,0,0,34000,0,34000,34000
20200430,055592,奇力新元大97購07,,,,,0.00,0.00,0,0,0,0,0,0,0,0,0,0,0,0,0
20200430,055593,華新科元大97購10,0.29,0.29,0.29,0.29,0.00,0.00,13000,1,3770,0,0,0,0,0,0,13000,0,13000,13000
20200430,055594,華新科元大98購02,3.83,3.83,3.71,3.71,-0.05,-1.33,11000,2,41770,0,0,0,0,0,0,11000,0,11000,11000
20200430,055595,宏達電元大98購02,,,,,0.00,0.00,0,0,0,0,0,0,0,0,0,0,0,0,0
20200430,055596,新光金元大9B購02,0.36,0.36,0.36,0.36,0.00,0.00,3000,2,1080,0,0,0,0,0,0,0,0,0,0
20200430,055597,禾伸堂元大98購02,4.36,4.41,4.12,4.18,+0.08,1.95,51000,5,220920,0,0,0,0,0,0,18000,33000,-15000,-15000
20200430,055598,欣興元大97購03,1.53,1.64,1.53,1.64,+0.20,13.89,16000,5,25730,0,0,0,0,0,0,1000,12000,-11000,-11000
20200430,055599,TPK元大97購01,0.52,0.52,0.52,0.52,+0.02,4.0,10000,1,5200,0,0,0,0,0,0,10000,0,10000,10000
20200430,05559P,臺股指麥證96售01,,,,,0.00,0.00,0,0,0,0,0,0,0,0,0,0,0,0,0
20200430,055600,致伸元大97購02,0.32,0.32,0.31,0.31,0.00,0.00,2000,2,630,0,0,0,0,0,0,0,2000,-2000,-2000
20200430,055601,茂林元大97購03,,,,,0.00,0.00,0,0,0,0,0,0,0,0,0,0,0,0,0
20200430,055602,康控元大97購03,,,,,0.00,0.00,0,0,0,0,0,0,0,0,0,0,0,0,0
20200430,055603,超眾元大97購04,2.36,2.51,2.32,2.32,-0.01,-0.43,176000,14,417390,0,0,0,0,0,0,115000,61000,54000,54000
20200430,055604,訊芯元大98購02,0.58,0.63,0.58,0.63,+0.03,5.0,211000,6,129790,0,0,0,0,0,0,0,211000,-211000,-211000
20200430,055605,緯穎元大97購02,,,,,0.00,0.00,0,0,0,0,0,0,0,0,0,0,0,0,0
20200430,055606,矽創元大97購01,0.42,0.42,0.42,0.42,0.00,0.00,2000,1,840,0,0,0,0,0,0,2000,0,2000,2000
20200430,055607,華通康和97購01,,,,,0.00,0.00,0,0,0,0,0,0,0,0,0,0,0,0,0
20200430,055608,華邦電康和97購01,,,,,0.00,0.00,0,0,0,0,0,0,0,0,0,0,0,0,0
20200430,055609,旺宏國票99購01,0.50,0.55,0.50,0.53,0.00,0.00,100000,3,51540,0,0,0,0,0,0,98000,0,98000,98000
20200430,05560P,友達兆豐96售01,,,,,0.00,0.00,0,0,0,0,0,0,0,0,0,0,0,0,0
20200430,055610,光磊國票98購01,0.63,0.63,0.63,0.63,-0.03,-4.55,10000,1,6300,0,0,0,0,0,0,10000,0,10000,10000
20200430,055611,燿華國票98購02,0.23,0.23,0.22,0.22,+0.02,10.0,100000,2,22500,0,0,0,0,0,0,0,100000,-100000,-100000
20200430,055612,台光電國票97購04,,,,,0.00,0.00,0,0,0,0,0,0,0,0,0,0,0,0,0
20200430,055613,全新國票98購01,,,,,0.00,0.00,0,0,0,0,0,0,0,0,0,0,0,0,0
20200430,055614,華新科國票97購02,0.28,0.49,0.24,0.49,+0.18,58.06,41000,4,11350,0,0,0,0,0,0,9000,0,9000,9000
20200430,055615,宏達電國票99購02,,,,,0.00,0.00,0,0,0,0,0,0,0,0,0,0,0,0,0
20200430,055616,智原國票97購03,,,,,0.00,0.00,0,0,0,0,0,0,0,0,0,0,0,0,0
20200430,055617,TPK國票98購04,1.19,1.19,1.19,1.19,-0.07,-5.56,1000,1,1190,0,0,0,0,0,0,1000,0,1000,1000
20200430,055618,麗豐國票98購01,1.74,1.79,1.72,1.76,+0.23,15.03,104000,4,182670,0,0,0,0,0,0,0,104000,-104000,-104000
20200430,055619,同欣電國票98購02,1.25,1.46,1.24,1.46,+0.23,18.7,480000,29,649560,0,0,0,0,0,0,76000,412000,-336000,-336000
20200430,05561P,大立光兆豐96售02,,,,,0.00,0.00,0,0,0,0,0,0,0,0,0,0,0,0,0
20200430,055620,樺漢國票98購01,2.03,2.20,2.03,2.20,+0.10,4.76,134000,13,285100,0,0,0,0,0,0,84000,50000,34000,34000
20200430,055621,國巨國泰98購03,,,,,0.00,0.00,0,0,0,0,0,0,0,0,0,0,0,0,0
20200430,055622,群創國泰99購01,0.04,0.04,0.04,0.04,0.00,0.00,10000,1,400,0,0,0,0,0,0,0,10000,-10000,-10000
20200430,055623,貿聯國泰99購01,0.63,0.76,0.63,0.76,+0.26,52.0,126000,29,87290,0,0,0,0,0,0,19000,117000,-98000,-98000
20200430,055624,聯發科富邦99購07,1.03,1.08,1.02,1.08,+0.26,31.71,116000,9,119680,0,0,0,0,0,0,106000,0,106000,106000
20200430,055625,亞光富邦98購01,,,,,0.00,0.00,0,0,0,0,0,0,0,0,0,0,0,0,0
20200430,055626,力山永豐97購01,1.75,1.91,1.49,1.49,-0.03,-1.97,67000,13,118770,0,0,0,0,0,0,21000,44000,-23000,-23000
20200430,055627,亞德客永豐97購02,2.12,2.92,2.06,2.92,+0.88,43.14,294000,31,767870,0,0,0,0,0,0,68000,253000,-185000,-185000
20200430,055628,旺宏永豐97購01,0.55,0.55,0.50,0.50,+0.04,8.7,190000,6,102900,0,0,0,0,0,0,189000,0,189000,189000
20200430,055629,華新科永豐97購04,,,,,0.00,0.00,0,0,0,0,0,0,0,0,0,0,0,0,0
20200430,05562P,鴻海元大96售16,2.98,2.98,2.98,2.98,-0.07,-2.3,42000,3,125160,0,0,0,0,0,0,42000,42000,0,0
20200430,055630,聯詠永豐97購02,,,,,0.00,0.00,0,0,0,0,0,0,0,0,0,0,0,0,0
20200430,055631,創意永豐98購01,1.60,1.68,1.60,1.68,+0.05,3.07,62000,7,101250,0,0,0,0,0,0,23000,39000,-16000,-16000
20200430,055632,群創永豐98購01,,,,,0.00,0.00,0,0,0,0,0,0,0,0,0,0,0,0,0
20200430,055633,牧德永豐97購02,,,,,0.00,0.00,0,0,0,0,0,0,0,0,0,0,0,0,0
20200430,055634,訊芯永豐97購02,,,,,0.00,0.00,0,0,0,0,0,0,0,0,0,0,0,0,0
20200430,055635,緯穎永豐97購01,,,,,0.00,0.00,0,0,0,0,0,0,0,0,0,0,0,0,0
20200430,055636,元油反元富97購02,,,,,0.00,0.00,0,0,0,0,0,0,0,0,0,0,0,0,0
20200430,055637,亞德客元富97購01,2.98,3.10,2.98,3.10,+0.33,11.91,13000,2,39100,0,0,0,0,0,0,10000,3000,7000,7000
20200430,055638,上銀元富97購01,0.26,0.43,0.26,0.43,+0.23,115.0,21000,2,8860,0,0,0,0,0,0,21000,0,21000,21000
20200430,055639,上銀元富97購02,1.32,1.74,1.28,1.73,+0.50,40.65,1246000,60,1750040,0,0,0,0,0,0,514000,774000,-260000,-260000
20200430,05563P,台積電元大97售07,,,,,0.00,0.00,0,0,0,0,0,0,0,0,0,0,0,0,0
20200430,055640,鴻海元富97購03,,,,,0.00,0.00,0,0,0,0,0,0,0,0,0,0,0,0,0
20200430,055641,鴻海元富97購04,,,,,0.00,0.00,0,0,0,0,0,0,0,0,0,0,0,0,0
20200430,055642,廣宇元富97購01,,,,,0.00,0.00,0,0,0,0,0,0,0,0,0,0,0,0,0
20200430,055643,宏碁元富97購01,,,,,0.00,0.00,0,0,0,0,0,0,0,0,0,0,0,0,0
20200430,055644,致茂元富97購01,,,,,0.00,0.00,0,0,0,0,0,0,0,0,0,0,0,0,0
20200430,055645,技嘉元富97購01,1.11,1.12,1.11,1.12,-0.06,-5.08,20000,2,22300,0,0,0,0,0,0,0,20000,-20000,-20000
20200430,055646,漢唐元富97購01,,,,,0.00,0.00,0,0,0,0,0,0,0,0,0,0,0,0,0
20200430,055647,義隆元富97購01,2.33,2.54,2.33,2.54,+0.19,8.09,77000,6,188980,0,0,0,0,0,0,8000,69000,-61000,-61000
20200430,055648,可成元富97購01,1.42,1.42,1.42,1.42,-0.03,-2.07,10000,1,14200,0,0,0,0,0,0,0,10000,-10000,-10000
20200430,055649,華新科元富97購03,,,,,0.00,0.00,0,0,0,0,0,0,0,0,0,0,0,0,0
20200430,05564P,玉晶光元大97售02,0.20,0.20,0.19,0.19,-0.08,-29.63,86000,7,16390,0,0,0,0,0,0,11000,0,11000,11000
20200430,055650,華新科元富98購01,,,,,0.00,0.00,0,0,0,0,0,0,0,0,0,0,0,0,0
20200430,055651,富邦金元富97購01,,,,,0.00,0.00,0,0,0,0,0,0,0,0,0,0,0,0,0
20200430,055652,聯詠元富01購01,0.61,0.64,0.61,0.64,+0.12,23.08,12000,4,7510,0,0,0,0,0,0,7000,5000,2000,2000
20200430,055653,聯詠元富01購02,0.56,0.60,0.54,0.60,+0.05,9.09,49000,14,28300,0,0,0,0,0,0,37000,0,37000,37000
20200430,055654,景碩元富97購01,2.55,2.87,2.55,2.87,+0.28,10.81,70000,6,187700,0,0,0,0,0,0,30000,40000,-10000,-10000
20200430,055655,群創元富99購07,,,,,0.00,0.00,0,0,0,0,0,0,0,0,0,0,0,0,0
20200430,055656,新唐元富97購01,,,,,0.00,0.00,0,0,0,0,0,0,0,0,0,0,0,0,0
20200430,055657,超眾元富97購02,1.57,1.64,1.51,1.51,+0.03,2.03,733000,26,1152810,0,0,0,0,0,0,203000,543000,-340000,-340000
20200430,055658,南電元富97購01,8.35,8.35,8.35,8.35,-0.05,-0.6,6000,1,50100,0,0,0,0,0,0,6000,0,6000,6000
20200430,055659,百和元富97購01,0.50,0.50,0.43,0.46,-0.07,-13.21,442000,29,202760,0,0,0,0,0,0,298000,128000,170000,170000
20200430,05565P,鎧勝元大96售01,0.90,0.98,0.79,0.80,-0.17,-17.53,286000,13,260470,0,0,0,0,0,0,187000,99000,88000,88000
20200430,055660,台光電兆豐97購01,,,,,0.00,0.00,0,0,0,0,0,0,0,0,0,0,0,0,0
20200430,055661,亞德客中信98購01,0.73,0.84,0.73,0.84,0.00,0.00,47000,11,37390,0,0,0,0,0,0,0,47000,-47000,-47000
20200430,055662,上銀中信99購01,0.54,0.82,0.54,0.82,+0.33,67.35,183000,16,128810,0,0,0,0,0,0,98000,10000,88000,88000
20200430,055663,崇越中信97購01,0.23,0.23,0.10,0.20,+0.02,11.11,476000,10,53600,0,0,0,0,0,0,158000,310000,-152000,-152000
20200430,055664,和大群益98購02,,,,,0.00,0.00,0,0,0,0,0,0,0,0,0,0,0,0,0
20200430,055665,亞德客群益97購01,3.11,3.68,2.93,3.68,+0.75,25.6,170000,19,545480,0,0,0,0,0,0,116000,84000,32000,32000
20200430,055666,鴻海群益97購05,,,,,0.00,0.00,0,0,0,0,0,0,0,0,0,0,0,0,0
20200430,055667,致茂群益98購01,1.32,1.33,1.23,1.23,-0.12,-8.89,350000,7,455700,0,0,0,0,0,0,320000,30000,290000,290000
20200430,055668,欣興群益97購01,2.87,3.07,2.87,2.98,+0.29,10.78,125000,6,379350,0,0,0,0,0,0,124000,2000,122000,122000
20200430,055669,緯穎群益97購02,0.70,1.25,0.70,1.25,+0.60,92.31,164000,22,179490,0,0,0,0,0,0,161000,1000,160000,160000
20200430,05566P,景碩永豐96售01,,,,,0.00,0.00,0,0,0,0,0,0,0,0,0,0,0,0,0
20200430,055670,矽創群益98購02,1.78,1.88,1.76,1.88,+0.19,11.24,584000,30,1057330,0,0,0,0,0,0,362000,291000,71000,71000
20200430,055671,世紀鋼群益97購01,,,,,0.00,0.00,0,0,0,0,0,0,0,0,0,0,0,0,0
20200430,055672,國巨日盛97購02,0.81,0.85,0.81,0.85,+0.07,8.97,30000,3,25000,0,0,0,0,0,0,30000,0,30000,30000
20200430,055673,旺宏日盛97購01,0.72,0.73,0.72,0.73,+0.19,35.19,40000,2,29000,0,0,0,0,0,0,40000,40000,0,0
20200430,055674,南港康和97購02,,,,,0.00,0.00,0,0,0,0,0,0,0,0,0,0,0,0,0
20200430,055675,亞德客凱基97購02,1.21,1.60,1.11,1.60,+0.49,44.14,82000,17,103090,0,0,0,0,0,0,47000,39000,8000,8000
20200430,055676,亞德客凱基97購03,0.88,1.20,0.88,1.20,+0.38,46.34,282000,8,298530,0,0,0,0,0,0,277000,0,277000,277000
20200430,055677,喬山凱基97購01,0.25,0.25,0.24,0.24,0.00,0.00,3000,3,740,0,0,0,0,0,0,3000,0,3000,3000
20200430,055678,上銀凱基97購02,,,,,0.00,0.00,0,0,0,0,0,0,0,0,0,0,0,0,0
20200430,055679,華通凱基99購01,0.33,0.35,0.32,0.35,0.00,0.00,8000,3,2680,0,0,0,0,0,0,5000,0,5000,5000
20200430,05567P,致伸群益96售01,,,,,0.00,0.00,0,0,0,0,0,0,0,0,0,0,0,0,0
20200430,055680,美律凱基99購01,,,,,0.00,0.00,0,0,0,0,0,0,0,0,0,0,0,0,0
20200430,055681,奇鋐凱基98購03,0.99,1.05,0.99,1.05,+0.03,2.94,11000,2,10950,0,0,0,0,0,0,0,10000,-10000,-10000
20200430,055682,智原凱基98購02,0.38,0.38,0.38,0.38,0.00,0.00,2000,1,760,0,0,0,0,0,0,2000,0,2000,2000
20200430,055683,晶技凱基99購01,,,,,0.00,0.00,0,0,0,0,0,0,0,0,0,0,0,0,0
20200430,055684,京鼎凱基97購01,0.73,0.73,0.73,0.73,+0.04,5.8,47000,3,34310,0,0,0,0,0,0,7000,40000,-33000,-33000
20200430,055685,日月光凱基97購02,,,,,0.00,0.00,0,0,0,0,0,0,0,0,0,0,0,0,0
20200430,055686,致伸凱基97購02,,,,,0.00,0.00,0,0,0,0,0,0,0,0,0,0,0,0,0
20200430,055687,瀚宇博凱基97購01,1.81,1.86,1.81,1.86,+0.08,4.49,22000,3,40550,0,0,0,0,0,0,0,22000,-22000,-22000
20200430,055688,力成凱基98購02,0.52,0.54,0.52,0.54,0.00,0.00,20000,2,10600,0,0,0,0,0,0,10000,0,10000,10000
20200430,055689,台郡凱基99購01,1.55,1.55,1.55,1.55,+0.02,1.31,10000,1,15500,0,0,0,0,0,0,0,10000,-10000,-10000
20200430,05568P,台積電統一96售03,0.68,0.68,0.68,0.68,0.00,0.00,5000,1,3400,0,0,0,0,0,0,0,5000,-5000,-5000
20200430,055690,矽力凱基97購02,,,,,0.00,0.00,0,0,0,0,0,0,0,0,0,0,0,0,0
20200430,055691,訊芯凱基97購02,0.34,0.34,0.34,0.34,+0.04,13.33,42000,3,14280,0,0,0,0,0,0,0,42000,-42000,-42000
20200430,055692,緯穎凱基97購03,1.65,1.97,1.64,1.97,+0.43,27.92,79000,8,136140,0,0,0,0,0,0,50000,79000,-29000,-29000
20200430,055693,南茂凱基97購01,0.35,0.35,0.35,0.35,0.00,0.00,100000,4,35000,0,0,0,0,0,0,0,100000,-100000,-100000
20200430,055694,光罩國票98購01,,,,,0.00,0.00,0,0,0,0,0,0,0,0,0,0,0,0,0
20200430,055695,大毅國票98購03,8.05,9.40,8.05,9.40,+2.05,27.89,20000,4,172800,0,0,0,0,0,0,6000,14000,-8000,-8000
20200430,055696,華新科國票98購01,,,,,0.00,0.00,0,0,0,0,0,0,0,0,0,0,0,0,0
20200430,055697,牧德國票98購01,,,,,0.00,0.00,0,0,0,0,0,0,0,0,0,0,0,0,0
20200430,055698,茂林國票98購03,0.96,0.96,0.96,0.96,-0.16,-14.29,25000,1,24000,0,0,0,0,0,0,25000,0,25000,25000
20200430,055699,康控國票97購04,0.12,0.12,0.08,0.09,0.00,0.00,100000,3,8140,0,0,0,0,0,0,99000,0,99000,99000
20200430,05569P,漢唐統一97售01,,,,,0.00,0.00,0,0,0,0,0,0,0,0,0,0,0,0,0
20200430,055700,緯穎國泰98購02,1.93,2.52,1.93,2.49,+0.68,37.57,53000,13,117490,0,0,0,0,0,0,14000,40000,-26000,-26000
20200430,055701,亞德客富邦99購01,1.08,1.14,1.01,1.14,+0.14,14.0,280000,16,296350,0,0,0,0,0,0,165000,127000,38000,38000
20200430,055702,美律富邦98購01,0.34,0.34,0.34,0.34,0.00,0.00,11000,1,3740,0,0,0,0,0,0,11000,0,11000,11000
20200430,055703,緯穎富邦98購01,0.26,0.41,0.25,0.34,+0.10,41.67,596000,33,194070,0,0,0,0,0,0,523000,55000,468000,468000
20200430,055704,亞德客永豐97購04,1.12,1.58,1.07,1.58,+0.48,43.64,246000,13,315800,0,0,0,0,0,0,145000,121000,24000,24000
20200430,055705,微星永豐97購01,0.30,0.30,0.29,0.29,-0.02,-6.45,86000,6,25710,0,0,0,0,0,0,0,86000,-86000,-86000
20200430,055706,大立光永豐97購03,,,,,0.00,0.00,0,0,0,0,0,0,0,0,0,0,0,0,0
20200430,055707,聯鈞永豐98購01,1.36,1.36,1.36,1.36,-0.15,-9.93,68000,1,92480,0,0,0,0,0,0,68000,0,68000,68000
20200430,055708,茂林永豐97購02,,,,,0.00,0.00,0,0,0,0,0,0,0,0,0,0,0,0,0
20200430,055709,深中小元大97購03,0.24,0.24,0.24,0.24,+0.05,26.32,10000,1,2400,0,0,0,0,0,0,0,10000,-10000,-10000
20200430,05570P,聯發科統一96售04,2.29,2.30,2.27,2.29,-0.42,-15.5,49000,6,112120,0,0,0,0,0,0,49000,0,49000,49000
20200430,055710,亞德客元大97購03,2.90,3.61,2.65,3.61,+0.99,37.79,320000,53,936510,0,0,0,0,0,0,184000,190000,-6000,-6000
20200430,055711,上銀元大97購04,0.80,0.90,0.80,0.90,+0.38,73.08,7000,2,6100,0,0,0,0,0,0,7000,0,7000,7000
20200430,055712,金寶元大97購02,,,,,0.00,0.00,0,0,0,0,0,0,0,0,0,0,0,0,0
20200430,055713,國巨元大98購09,4.98,5.05,4.98,5.05,+0.13,2.64,37000,3,186360,0,0,0,0,0,0,0,37000,-37000,-37000
20200430,055714,智邦元大97購03,5.45,5.70,5.45,5.70,+0.30,5.56,3000,2,16600,0,0,0,0,0,0,3000,3000,0,0
20200430,055715,智邦元大97購04,,,,,0.00,0.00,0,0,0,0,0,0,0,0,0,0,0,0,0
20200430,055716,致茂元大97購01,1.50,1.55,1.45,1.45,-0.12,-7.64,100000,6,149920,0,0,0,0,0,0,79000,20000,59000,59000
20200430,055717,聯發科元大97購19,0.68,0.81,0.68,0.81,+0.33,68.75,35000,4,26200,0,0,0,0,0,0,30000,0,30000,30000
20200430,055718,可成元大97購02,,,,,0.00,0.00,0,0,0,0,0,0,0,0,0,0,0,0,0
20200430,055719,可成元大97購03,,,,,0.00,0.00,0,0,0,0,0,0,0,0,0,0,0,0,0
20200430,05571P,大立光統一96售03,2.92,2.92,2.73,2.73,0.00,0.00,97000,11,277430,0,0,0,0,0,0,1000,96000,-95000,-95000
20200430,055720,宏達電元大97購05,0.73,0.73,0.71,0.71,-0.04,-5.33,95000,3,68450,0,0,0,0,0,0,50000,45000,5000,5000
20200430,055721,聯詠元大97購04,,,,,0.00,0.00,0,0,0,0,0,0,0,0,0,0,0,0,0
20200430,055722,聯鈞元大97購03,,,,,0.00,0.00,0,0,0,0,0,0,0,0,0,0,0,0,0
20200430,055723,康控元大97購04,0.47,0.48,0.45,0.47,0.00,0.00,436000,8,200070,0,0,0,0,0,0,10000,426000,-416000,-416000
20200430,055724,祥碩元大97購03,5.80,5.80,4.62,4.65,-0.95,-16.96,8000,5,39600,0,0,0,0,0,0,5000,3000,2000,2000
20200430,055725,嘉聯益元大98購03,0.92,0.95,0.91,0.92,+0.02,2.22,270000,11,251780,0,0,0,0,0,0,190000,116000,74000,74000
20200430,055726,台表科元大98購03,1.88,1.88,1.82,1.88,0.00,0.00,141000,6,262910,0,0,0,0,0,0,66000,76000,-10000,-10000
20200430,055727,矽力元大97購02,6.45,6.45,6.45,6.45,+0.10,1.57,2000,1,12900,0,0,0,0,0,0,0,2000,-2000,-2000
20200430,055728,緯穎元大97購03,1.17,1.18,1.17,1.18,+0.35,42.17,2000,2,2350,0,0,0,0,0,0,1000,1000,0,0
20200430,055729,金寶元富99購01,0.44,0.45,0.44,0.45,-0.16,-26.23,64000,6,28380,0,0,0,0,0,0,52000,0,52000,52000
20200430,05572P,群創統一96售02,,,,,0.00,0.00,0,0,0,0,0,0,0,0,0,0,0,0,0
20200430,055730,建準元富97購02,0.51,0.52,0.48,0.48,-0.13,-21.31,335000,20,168650,0,0,0,0,0,0,335000,0,335000,335000
20200430,055731,美律元富97購01,0.76,0.87,0.76,0.84,+0.09,12.0,521000,11,414330,0,0,0,0,0,0,198000,323000,-125000,-125000
20200430,055732,全新元富9A購01,0.75,0.75,0.75,0.75,+0.02,2.74,5000,1,3750,0,0,0,0,0,0,5000,0,5000,5000
20200430,055733,奇力新元富97購01,0.70,0.78,0.70,0.70,+0.03,4.48,346000,31,253640,0,0,0,0,0,0,55000,285000,-230000,-230000
20200430,055734,奇力新元富97購02,0.07,0.07,0.07,0.07,0.00,0.00,1000,1,70,0,0,0,0,0,0,1000,0,1000,1000
20200430,055735,宏達電元富98購01,0.23,0.23,0.22,0.22,0.00,0.00,50000,3,11100,0,0,0,0,0,0,0,20000,-20000,-20000
20200430,055736,宏達電元富99購01,,,,,0.00,0.00,0,0,0,0,0,0,0,0,0,0,0,0,0
20200430,055737,開發金元富97購01,,,,,0.00,0.00,0,0,0,0,0,0,0,0,0,0,0,0,0
20200430,055738,玉山金元富97購01,1.12,1.20,1.12,1.20,+0.14,13.21,54000,4,60880,0,0,0,0,0,0,49000,0,49000,49000
20200430,055739,健鼎元富97購01,,,,,0.00,0.00,0,0,0,0,0,0,0,0,0,0,0,0,0
20200430,05573P,仁寶元富96售02,0.33,0.33,0.33,0.33,-0.02,-5.71,3000,1,990,0,0,0,0,0,0,3000,0,3000,3000
20200430,055740,智易元富97購01,,,,,0.00,0.00,0,0,0,0,0,0,0,0,0,0,0,0,0
20200430,055741,健策元富97購01,,,,,0.00,0.00,0,0,0,0,0,0,0,0,0,0,0,0,0
20200430,055742,健策元富97購02,,,,,0.00,0.00,0,0,0,0,0,0,0,0,0,0,0,0,0
20200430,055743,TPK元富98購01,,,,,0.00,0.00,0,0,0,0,0,0,0,0,0,0,0,0,0
20200430,055744,茂林元富97購02,0.53,0.55,0.53,0.55,-0.09,-14.06,134000,2,72700,0,0,0,0,0,0,84000,50000,34000,34000
20200430,055745,臻鼎元富97購01,0.26,0.33,0.25,0.31,+0.06,24.0,244000,17,64160,0,0,0,0,0,0,213000,21000,192000,192000
20200430,055746,同欣電元富97購01,0.49,0.63,0.49,0.63,+0.16,34.04,609000,28,335810,0,0,0,0,0,0,50000,559000,-509000,-509000
20200430,055747,康舒元富97購01,0.76,0.77,0.74,0.77,0.00,0.00,158000,16,118600,0,0,0,0,0,0,20000,138000,-118000,-118000
20200430,055748,GIS元富97購01,0.74,0.74,0.74,0.74,+0.07,10.45,20000,2,14800,0,0,0,0,0,0,20000,0,20000,20000
20200430,055749,智邦永昌9C購01,,,,,0.00,0.00,0,0,0,0,0,0,0,0,0,0,0,0,0
20200430,05574P,英業達元富96售01,,,,,0.00,0.00,0,0,0,0,0,0,0,0,0,0,0,0,0
20200430,055750,瑞昱永昌9C購01,,,,,0.00,0.00,0,0,0,0,0,0,0,0,0,0,0,0,0
20200430,055751,南亞科永昌9C購01,,,,,0.00,0.00,0,0,0,0,0,0,0,0,0,0,0,0,0
20200430,055752,臺股指永昌97購01,0.19,0.19,0.19,0.19,0.00,0.00,17000,1,3230,0,0,0,0,0,0,17000,0,17000,17000
20200430,055753,貿聯第一98購01,0.15,0.23,0.15,0.23,+0.02,9.52,18000,3,2880,0,0,0,0,0,0,17000,0,17000,17000
20200430,055754,和大兆豐97購01,,,,,0.00,0.00,0,0,0,0,0,0,0,0,0,0,0,0,0
20200430,055755,禾伸堂兆豐97購02,2.07,2.07,2.07,2.07,+0.12,6.15,26000,1,53820,0,0,0,0,0,0,26000,0,26000,26000
20200430,055756,臺股指兆豐97購01,,,,,0.00,0.00,0,0,0,0,0,0,0,0,0,0,0,0,0
20200430,055757,大成鋼群益99購01,0.16,0.16,0.11,0.11,0.00,0.00,70000,3,8700,0,0,0,0,0,0,0,20000,-20000,-20000
20200430,055758,旺宏群益97購01,1.40,1.48,1.40,1.41,+0.39,38.24,353000,4,503730,0,0,0,0,0,0,353000,0,353000,353000
20200430,055759,技嘉群益98購02,,,,,0.00,0.00,0,0,0,0,0,0,0,0,0,0,0,0,0
20200430,05575P,玉晶光元富96售01,,,,,0.00,0.00,0,0,0,0,0,0,0,0,0,0,0,0,0
20200430,055760,新日興群益98購02,,,,,0.00,0.00,0,0,0,0,0,0,0,0,0,0,0,0,0
20200430,055761,創意群益97購01,,,,,0.00,0.00,0,0,0,0,0,0,0,0,0,0,0,0,0
20200430,055762,智伸科群益97購01,0.48,0.53,0.48,0.49,+0.05,11.36,143000,4,69990,0,0,0,0,0,0,15000,128000,-113000,-113000
20200430,055763,鎧勝群益97購01,0.51,0.67,0.50,0.61,+0.08,15.09,268000,9,145060,0,0,0,0,0,0,245000,23000,222000,222000
20200430,055764,臺股指群益97購02,0.60,0.78,0.60,0.78,+0.41,110.81,80000,9,55800,0,0,0,0,0,0,65000,0,65000,65000
20200430,055765,臺股指群益97購03,0.30,0.34,0.30,0.34,+0.14,70.0,14000,2,4360,0,0,0,0,0,0,14000,0,14000,14000
20200430,055766,臺股指群益97購04,,,,,0.00,0.00,0,0,0,0,0,0,0,0,0,0,0,0,0
20200430,055767,臺股指群益97購05,,,,,0.00,0.00,0,0,0,0,0,0,0,0,0,0,0,0,0
20200430,055768,臺股指群益97購06,,,,,0.00,0.00,0,0,0,0,0,0,0,0,0,0,0,0,0
20200430,055769,智伸科中信97購01,,,,,0.00,0.00,0,0,0,0,0,0,0,0,0,0,0,0,0
20200430,05576P,群創日盛99售02,,,,,0.00,0.00,0,0,0,0,0,0,0,0,0,0,0,0,0
20200430,055770,欣興麥證97購01,0.47,0.47,0.47,0.47,+0.06,14.63,3000,1,1410,3000,0,3000,0,0,0,3000,0,3000,3000
20200430,055771,台積電日盛97購04,,,,,0.00,0.00,0,0,0,0,0,0,0,0,0,0,0,0,0
20200430,055772,致茂凱基97購01,0.42,0.42,0.40,0.40,-0.04,-9.09,6000,2,2460,0,0,0,0,0,0,6000,0,6000,6000
20200430,055773,瑞昱凱基97購03,4.20,4.63,4.08,4.63,+0.87,23.14,30000,6,132300,0,0,0,0,0,0,7000,23000,-16000,-16000
20200430,055774,台光電凱基97購02,,,,,0.00,0.00,0,0,0,0,0,0,0,0,0,0,0,0,0
20200430,055775,友達凱基9A購01,0.56,0.56,0.56,0.56,0.00,0.00,11000,2,6160,0,0,0,0,0,0,0,11000,-11000,-11000
20200430,055776,宏達電凱基98購02,1.29,1.29,1.29,1.29,+0.02,1.57,20000,1,25800,0,0,0,0,0,0,20000,0,20000,20000
20200430,055777,冠德凱基97購01,0.44,0.46,0.42,0.46,+0.04,9.52,80000,11,34960,0,0,0,0,0,0,52000,28000,24000,24000
20200430,055778,美食凱基97購01,,,,,0.00,0.00,0,0,0,0,0,0,0,0,0,0,0,0,0
20200430,055779,國泰金凱基97購02,2.45,2.54,2.42,2.54,+0.39,18.14,44000,6,108690,0,0,0,0,0,0,8000,36000,-28000,-28000
20200430,05577P,上銀凱基96售02,,,,,0.00,0.00,0,0,0,0,0,0,0,0,0,0,0,0,0
20200430,055780,禾伸堂凱基99購01,,,,,0.00,0.00,0,0,0,0,0,0,0,0,0,0,0,0,0
20200430,055781,聯詠凱基98購01,,,,,0.00,0.00,0,0,0,0,0,0,0,0,0,0,0,0,0
20200430,055782,新日興凱基99購01,1.12,1.12,1.08,1.09,-0.01,-0.91,83000,13,90870,0,0,0,0,0,0,83000,0,83000,83000
20200430,055783,群創凱基99購03,,,,,0.00,0.00,0,0,0,0,0,0,0,0,0,0,0,0,0
20200430,055784,TPK凱基97購02,,,,,0.00,0.00,0,0,0,0,0,0,0,0,0,0,0,0,0
20200430,055785,祥碩凱基97購02,3.63,3.63,2.55,2.72,-0.46,-14.47,390000,32,1239920,0,0,0,0,0,0,210000,255000,-45000,-45000
20200430,055786,彩晶凱基99購02,,,,,0.00,0.00,0,0,0,0,0,0,0,0,0,0,0,0,0
20200430,055787,聯茂凱基99購01,,,,,0.00,0.00,0,0,0,0,0,0,0,0,0,0,0,0,0
20200430,055788,緯穎凱基97購04,3.02,3.02,3.02,3.02,+0.18,6.34,6000,1,18120,0,0,0,0,0,0,6000,0,6000,6000
20200430,055789,台虹凱基97購01,,,,,0.00,0.00,0,0,0,0,0,0,0,0,0,0,0,0,0
20200430,05578P,鴻海凱基96售11,,,,,0.00,0.00,0,0,0,0,0,0,0,0,0,0,0,0,0
20200430,055790,南電凱基97購01,5.25,5.25,5.25,5.25,0.00,0.00,12000,1,63000,0,0,0,0,0,0,12000,0,12000,12000
20200430,055791,臺股指凱基97購14,0.24,0.30,0.24,0.29,+0.11,61.11,45000,4,12500,0,0,0,0,0,0,45000,0,45000,45000
20200430,055792,臺股指凱基97購15,,,,,0.00,0.00,0,0,0,0,0,0,0,0,0,0,0,0,0
20200430,055793,臺股指凱基97購16,0.14,0.14,0.14,0.14,+0.08,133.33,100000,1,14000,0,0,0,0,0,0,100000,0,100000,100000
20200430,055794,聯發科國泰99購01,0.30,0.36,0.30,0.36,+0.15,71.43,30000,2,9600,0,0,0,0,0,0,20000,0,20000,20000
20200430,055795,茂林國泰98購01,0.88,0.88,0.79,0.81,-0.01,-1.22,281000,3,229070,0,0,0,0,0,0,200000,281000,-81000,-81000
20200430,055796,南電國泰98購01,5.40,5.45,5.40,5.45,0.00,0.00,11000,2,59700,0,0,0,0,0,0,11000,0,11000,11000
20200430,055797,華通富邦98購01,0.18,0.18,0.18,0.18,0.00,0.00,27000,4,4860,0,0,0,0,0,0,0,20000,-20000,-20000
20200430,055798,聯茂富邦98購01,0.56,0.58,0.55,0.56,-0.02,-3.45,79000,6,43760,0,0,0,0,0,0,18000,62000,-44000,-44000
20200430,055799,致茂永豐97購02,,,,,0.00,0.00,0,0,0,0,0,0,0,0,0,0,0,0,0
20200430,05579P,友達凱基98售03,,,,,0.00,0.00,0,0,0,0,0,0,0,0,0,0,0,0,0
20200430,055800,欣興永豐97購02,0.14,0.17,0.13,0.17,+0.08,88.89,45000,4,6550,0,0,0,0,0,0,30000,0,30000,30000
20200430,055801,景碩永豐97購02,,,,,0.00,0.00,0,0,0,0,0,0,0,0,0,0,0,0,0
20200430,055802,新日興永豐97購01,,,,,0.00,0.00,0,0,0,0,0,0,0,0,0,0,0,0,0
20200430,055803,鎧勝永豐97購01,0.84,1.06,0.84,1.00,+0.06,6.38,162000,15,162310,0,0,0,0,0,0,55000,107000,-52000,-52000
20200430,055804,祥碩永豐97購02,1.35,1.35,0.85,0.95,-0.22,-18.8,695000,48,840460,0,0,0,0,0,0,421000,274000,147000,147000
20200430,055805,矽力永豐97購01,0.37,0.37,0.34,0.36,-0.09,-20.0,89000,4,32100,0,0,0,0,0,0,74000,13000,61000,61000
20200430,055806,致新永豐97購02,0.60,0.61,0.60,0.61,+0.02,3.39,66000,3,39950,0,0,0,0,0,0,31000,35000,-4000,-4000
20200430,055807,勤誠永豐97購01,,,,,0.00,0.00,0,0,0,0,0,0,0,0,0,0,0,0,0
20200430,055808,世紀鋼永豐97購01,0.66,0.66,0.66,0.66,0.00,0.00,17000,1,11220,0,0,0,0,0,0,17000,0,17000,17000
20200430,055809,T50反1國票98購02,1.10,1.10,1.07,1.07,-0.15,-12.3,25000,5,27050,0,0,0,0,0,0,0,25000,-25000,-25000
20200430,05580P,美律凱基96售03,1.21,1.21,1.16,1.16,0.00,0.00,2000,2,2370,0,0,0,0,0,0,2000,0,2000,2000
20200430,055810,T50反1國票99購01,,,,,0.00,0.00,0,0,0,0,0,0,0,0,0,0,0,0,0
20200430,055811,國巨國票98購05,,,,,0.00,0.00,0,0,0,0,0,0,0,0,0,0,0,0,0
20200430,055812,台積電國票99購02,1.30,1.30,0.70,0.70,0.00,0.00,31000,4,22300,0,0,0,0,0,0,0,0,0,0
20200430,055813,聯發科國票98購04,3.28,3.58,3.28,3.58,+0.68,23.45,27000,7,94600,0,0,0,0,0,0,5000,22000,-17000,-17000
20200430,055814,晶豪科國票97購02,3.13,3.13,2.66,2.66,-0.21,-7.32,24000,4,67690,0,0,0,0,0,0,9000,15000,-6000,-6000
20200430,055815,亞光國票99購01,0.75,0.75,0.75,0.75,+0.09,13.64,40000,2,30000,0,0,0,0,0,0,0,30000,-30000,-30000
20200430,055816,新日興國票98購01,2.81,2.81,2.45,2.45,-0.29,-10.58,69000,2,175890,0,0,0,0,0,0,69000,0,69000,69000
20200430,055817,京鼎國票99購01,0.78,0.94,0.78,0.94,+0.18,23.68,42000,4,38050,0,0,0,0,0,0,16000,26000,-10000,-10000
20200430,055818,晶相光國票97購02,0.72,0.75,0.68,0.68,-0.04,-5.56,185000,6,135440,0,0,0,0,0,0,23000,162000,-139000,-139000
20200430,055819,晶相光國票98購01,,,,,0.00,0.00,0,0,0,0,0,0,0,0,0,0,0,0,0
20200430,05581P,華新科凱基96售07,0.18,0.18,0.18,0.18,+0.01,5.88,20000,1,3600,0,0,0,0,0,0,0,20000,-20000,-20000
20200430,055820,矽力國票98購02,3.58,3.64,3.40,3.58,-0.87,-19.55,35000,7,123800,0,0,0,0,0,0,0,35000,-35000,-35000
20200430,055821,勤誠國票98購01,,,,,0.00,0.00,0,0,0,0,0,0,0,0,0,0,0,0,0
20200430,055822,臺股指國票97購09,0.76,0.89,0.76,0.88,+0.19,27.54,50000,4,43450,0,0,0,0,0,0,25000,25000,0,0
20200430,055823,臺股指國票97購10,,,,,0.00,0.00,0,0,0,0,0,0,0,0,0,0,0,0,0
20200430,055824,臺股指國票97購11,1.60,1.75,1.60,1.75,+0.25,16.67,205000,2,358000,0,0,0,0,0,0,5000,200000,-195000,-195000
20200430,055825,臺股指國票97購12,0.06,0.06,0.06,0.06,0.00,0.00,5000,1,300,0,0,0,0,0,0,0,0,0,0
20200430,055826,中石化元大97購01,,,,,0.00,0.00,0,0,0,0,0,0,0,0,0,0,0,0,0
20200430,055827,中石化元大98購01,0.32,0.32,0.32,0.32,+0.06,23.08,20000,1,6400,0,0,0,0,0,0,20000,0,20000,20000
20200430,055828,上銀元大97購05,1.00,1.55,1.00,1.55,+0.76,96.2,3000,2,3550,0,0,0,0,0,0,3000,0,3000,3000
20200430,055829,上銀元大97購06,3.43,4.11,3.31,4.11,+0.98,31.31,176000,20,626380,0,0,0,0,0,0,96000,80000,16000,16000
20200430,05582P,群創凱基98售06,,,,,0.00,0.00,0,0,0,0,0,0,0,0,0,0,0,0,0
20200430,055830,上銀元大97購07,3.23,3.87,3.16,3.87,+0.89,29.87,270000,25,903060,0,0,0,0,0,0,137000,133000,4000,4000
20200430,055831,台達電元大97購01,0.62,0.75,0.62,0.75,0.00,0.00,13000,4,8990,0,0,0,0,0,0,0,0,0,0
20200430,055832,台達電元大97購02,,,,,0.00,0.00,0,0,0,0,0,0,0,0,0,0,0,0,0
20200430,055833,華通元大98購05,0.32,0.32,0.32,0.32,0.00,0.00,1000,1,320,0,0,0,0,0,0,1000,0,1000,1000
20200430,055834,國巨元大97購13,4.21,4.28,4.03,4.12,+0.17,4.3,69000,11,289210,0,0,0,0,0,0,15000,58000,-43000,-43000
20200430,055835,華邦電元大97購03,0.39,0.43,0.38,0.43,+0.07,19.44,143000,9,56670,0,0,0,0,0,0,68000,75000,-7000,-7000
20200430,055836,華邦電元大97購04,,,,,0.00,0.00,0,0,0,0,0,0,0,0,0,0,0,0,0
20200430,055837,致茂元大97購02,0.78,0.78,0.65,0.65,-0.04,-5.8,163000,4,120650,0,0,0,0,0,0,95000,68000,27000,27000
20200430,055838,致茂元大97購03,0.51,0.51,0.42,0.42,-0.04,-8.7,240000,3,106100,0,0,0,0,0,0,220000,20000,200000,200000
20200430,055839,瑞昱元大97購04,1.50,1.92,1.50,1.92,+0.52,37.14,117000,3,207440,0,0,0,0,0,0,110000,7000,103000,103000
20200430,05583P,訊芯凱基96售01,,,,,0.00,0.00,0,0,0,0,0,0,0,0,0,0,0,0,0
20200430,055840,南亞科元大97購03,,,,,0.00,0.00,0,0,0,0,0,0,0,0,0,0,0,0,0
20200430,055841,南亞科元大97購04,1.38,1.38,1.38,1.38,+0.09,6.98,68000,1,93840,0,0,0,0,0,0,68000,0,68000,68000
20200430,055842,建準元大98購01,,,,,0.00,0.00,0,0,0,0,0,0,0,0,0,0,0,0,0
20200430,055843,美律元大97購02,,,,,0.00,0.00,0,0,0,0,0,0,0,0,0,0,0,0,0
20200430,055844,大毅元大98購01,2.34,2.58,2.23,2.28,+0.22,10.68,108000,13,246890,0,0,0,0,0,0,27000,74000,-47000,-47000
20200430,055845,大立光元大97購08,0.34,0.34,0.34,0.34,0.00,0.00,45000,1,15300,0,0,0,0,0,0,45000,0,45000,45000
20200430,055846,大立光元大97購09,1.63,1.90,1.62,1.90,+0.26,15.85,644000,11,1106040,0,0,0,0,0,0,516000,128000,388000,388000
20200430,055847,大立光元大97購10,1.33,1.55,1.33,1.55,+0.26,20.16,787000,11,1116660,0,0,0,0,0,0,545000,242000,303000,303000
20200430,055848,大立光元大97購11,1.54,1.58,1.54,1.58,+0.07,4.64,142000,6,223160,0,0,0,0,0,0,50000,92000,-42000,-42000
20200430,055849,聯詠元大97購05,0.33,0.37,0.32,0.37,+0.03,8.82,182000,8,61700,0,0,0,0,0,0,130000,52000,78000,78000
20200430,05584P,臺股指凱基96售13,3.96,3.96,3.80,3.80,-0.46,-10.8,21000,3,82900,0,0,0,0,0,0,0,21000,-21000,-21000
20200430,055850,聯詠元大97購06,,,,,0.00,0.00,0,0,0,0,0,0,0,0,0,0,0,0,0
20200430,055851,智原元大98購01,,,,,0.00,0.00,0,0,0,0,0,0,0,0,0,0,0,0,0
20200430,055852,聯鈞元大98購01,,,,,0.00,0.00,0,0,0,0,0,0,0,0,0,0,0,0,0
20200430,055853,群創元大98購03,0.30,0.30,0.30,0.30,+0.02,7.14,5000,1,1500,0,0,0,0,0,0,0,5000,-5000,-5000
20200430,055854,群創元大98購04,,,,,0.00,0.00,0,0,0,0,0,0,0,0,0,0,0,0,0
20200430,055855,牧德元大99購02,0.29,0.29,0.29,0.29,0.00,0.00,2000,1,580,0,0,0,0,0,0,2000,0,2000,2000
20200430,055856,新唐元大97購03,,,,,0.00,0.00,0,0,0,0,0,0,0,0,0,0,0,0,0
20200430,055857,嘉聯益元大97購04,,,,,0.00,0.00,0,0,0,0,0,0,0,0,0,0,0,0,0
20200430,055858,聯茂元大97購03,1.51,1.51,1.44,1.44,-0.05,-3.36,137000,9,203840,0,0,0,0,0,0,89000,88000,1000,1000
20200430,055859,啟碁元大97購03,0.84,0.84,0.82,0.82,-0.01,-1.2,103000,2,85160,0,0,0,0,0,0,35000,68000,-33000,-33000
20200430,05585P,臺股指凱基96售14,,,,,0.00,0.00,0,0,0,0,0,0,0,0,0,0,0,0,0
20200430,055860,啟碁元大97購04,,,,,0.00,0.00,0,0,0,0,0,0,0,0,0,0,0,0,0
20200430,055861,矽力元大97購03,2.19,2.19,1.93,1.93,-0.35,-15.35,131000,5,263690,0,0,0,0,0,0,41000,90000,-49000,-49000
20200430,055862,矽力元大97購04,2.53,2.53,2.53,2.53,-0.15,-5.6,24000,1,60720,0,0,0,0,0,0,24000,0,24000,24000
20200430,055863,緯穎元大97購05,0.75,0.96,0.75,0.88,+0.27,44.26,84000,10,74030,0,0,0,0,0,0,59000,10000,49000,49000
20200430,055864,臺股指元大97購01,0.11,0.11,0.11,0.11,+0.02,22.22,1000,1,110,0,0,0,0,0,0,1000,0,1000,1000
20200430,055865,臺股指元大97購02,,,,,0.00,0.00,0,0,0,0,0,0,0,0,0,0,0,0,0
20200430,055866,臺股指元大97購03,0.39,0.39,0.39,0.39,0.00,0.00,1000,1,390,0,0,0,0,0,0,1000,0,1000,1000
20200430,055867,臺股指元大97購05,0.10,0.12,0.10,0.12,+0.05,71.43,294000,4,33400,0,0,0,0,0,0,294000,0,294000,294000
20200430,055868,臺股指元大97購07,0.01,0.01,0.01,0.01,-0.01,-50.0,3000,1,30,0,0,0,0,0,0,0,0,0,0
20200430,055869,臺股指元大97購08,0.02,0.02,0.02,0.02,0.00,0.00,20000,1,400,0,0,0,0,0,0,20000,0,20000,20000
20200430,05586P,臺股指凱基96售15,2.90,2.90,2.90,2.90,0.00,0.00,1000,1,2900,0,0,0,0,0,0,0,0,0,0
20200430,055870,智原台新97購01,0.02,0.02,0.02,0.02,0.00,0.00,10000,1,200,0,0,0,0,0,0,0,10000,-10000,-10000
20200430,055871,群創台新97購02,,,,,0.00,0.00,0,0,0,0,0,0,0,0,0,0,0,0,0
20200430,055872,亞泥元富97購01,0.75,0.85,0.74,0.85,+0.11,14.86,113000,14,89430,0,0,0,0,0,0,30000,83000,-53000,-53000
20200430,055873,聚陽元富97購01,0.15,0.15,0.14,0.14,0.00,0.00,3000,2,430,0,0,0,0,0,0,0,0,0,0
20200430,055874,中環元富9A購01,0.73,0.81,0.72,0.77,+0.07,10.0,1774000,51,1369580,0,0,0,0,0,0,845000,929000,-84000,-84000
20200430,055875,光罩元富97購02,0.96,1.01,0.96,1.00,+0.03,3.09,110000,11,108500,0,0,0,0,0,0,50000,60000,-10000,-10000
20200430,055876,美食元富9A購01,0.45,0.49,0.45,0.49,0.00,0.00,22000,2,10700,0,0,0,0,0,0,22000,0,22000,22000
20200430,055877,奇鋐元富97購01,2.01,2.12,1.91,2.04,+0.16,8.51,391000,26,794360,0,0,0,0,0,0,105000,286000,-181000,-181000
20200430,055878,泰碩元富97購02,0.73,0.73,0.73,0.73,-0.01,-1.35,1000,1,730,0,0,0,0,0,0,0,1000,-1000,-1000
20200430,055879,神達元富97購01,0.81,0.81,0.81,0.81,0.00,0.00,11000,1,8910,0,0,0,0,0,0,11000,0,11000,11000
20200430,05587P,鴻海凱基96售12,,,,,0.00,0.00,0,0,0,0,0,0,0,0,0,0,0,0,0
20200430,055880,神達元富97購02,,,,,0.00,0.00,0,0,0,0,0,0,0,0,0,0,0,0,0
20200430,055881,康控元富97購01,0.19,0.25,0.19,0.25,0.00,0.00,82000,4,18780,0,0,0,0,0,0,32000,0,32000,32000
20200430,055882,嘉聯益元富97購01,0.79,0.83,0.79,0.83,+0.05,6.41,20000,2,16200,0,0,0,0,0,0,10000,10000,0,0
20200430,055883,樺漢元富97購01,,,,,0.00,0.00,0,0,0,0,0,0,0,0,0,0,0,0,0
20200430,055884,臺股指元富97購01,,,,,0.00,0.00,0,0,0,0,0,0,0,0,0,0,0,0,0
20200430,055885,大成鋼統一97購02,0.49,0.52,0.48,0.51,+0.02,4.08,288000,10,145370,0,0,0,0,0,0,31000,257000,-226000,-226000
20200430,055886,上銀統一97購02,,,,,0.00,0.00,0,0,0,0,0,0,0,0,0,0,0,0,0
20200430,055887,上銀統一97購03,0.69,0.84,0.65,0.84,+0.23,37.7,639000,21,464760,0,0,0,0,0,0,124000,515000,-391000,-391000
20200430,055888,鴻海統一97購04,,,,,0.00,0.00,0,0,0,0,0,0,0,0,0,0,0,0,0
20200430,055889,鴻海統一97購05,0.71,0.71,0.71,0.71,0.00,0.00,40000,4,28400,0,0,0,0,0,0,0,40000,-40000,-40000
20200430,05588P,群創兆豐97售02,,,,,0.00,0.00,0,0,0,0,0,0,0,0,0,0,0,0,0
20200430,055890,鴻海統一99購01,,,,,0.00,0.00,0,0,0,0,0,0,0,0,0,0,0,0,0
20200430,055891,鴻海統一9A購01,0.57,0.61,0.57,0.61,+0.08,15.09,218000,19,128740,0,0,0,0,0,0,0,62000,-62000,-62000
20200430,055892,國巨統一99購01,1.42,1.42,1.42,1.42,0.00,0.00,1000,1,1420,0,0,0,0,0,0,1000,0,1000,1000
20200430,055893,大立光統一97購07,0.57,0.62,0.57,0.62,+0.09,16.98,175000,3,101250,0,0,0,0,0,0,30000,145000,-115000,-115000
20200430,055894,欣興統一97購03,0.67,0.67,0.60,0.62,0.00,0.00,76000,7,49440,0,0,0,0,0,0,0,76000,-76000,-76000
20200430,055895,群創統一97購04,,,,,0.00,0.00,0,0,0,0,0,0,0,0,0,0,0,0,0
20200430,055896,南電統一97購02,4.58,4.58,4.33,4.33,-0.20,-4.42,65000,7,295160,0,0,0,0,0,0,65000,0,65000,65000
20200430,055897,TXFI0永昌99購01,,,,,0.00,0.00,0,0,0,0,0,0,0,0,0,0,0,0,0
20200430,055898,訊芯第一97購01,,,,,0.00,0.00,0,0,0,0,0,0,0,0,0,0,0,0,0
20200430,055899,群創中信99購01,,,,,0.00,0.00,0,0,0,0,0,0,0,0,0,0,0,0,0
20200430,05589P,大立光中信9A售01,1.01,1.01,0.89,0.89,0.00,0.00,16000,3,15260,0,0,0,0,0,0,5000,11000,-6000,-6000
20200430,055900,瀚宇博中信97購01,0.15,0.15,0.15,0.15,0.00,0.00,10000,1,1500,0,0,0,0,0,0,10000,10000,0,0
20200430,055901,超眾中信97購01,0.50,0.50,0.50,0.50,+0.03,6.38,20000,1,10000,0,0,0,0,0,0,0,20000,-20000,-20000
20200430,055902,同欣電中信99購01,0.23,0.27,0.23,0.27,0.00,0.00,243000,8,63210,0,0,0,0,0,0,45000,98000,-53000,-53000
20200430,055903,鈺齊中信97購02,,,,,0.00,0.00,0,0,0,0,0,0,0,0,0,0,0,0,0
20200430,055904,貿聯亞東99購01,0.50,0.61,0.45,0.61,+0.17,38.64,19000,5,9210,0,0,0,0,0,0,16000,3000,13000,13000
20200430,055905,可成兆豐97購03,,,,,0.00,0.00,0,0,0,0,0,0,0,0,0,0,0,0,0
20200430,055906,大立光兆豐97購03,0.06,0.08,0.06,0.06,+0.01,20.0,25000,4,1650,0,0,0,0,0,0,5000,10000,-5000,-5000
20200430,055907,台虹兆豐98購01,0.89,0.91,0.89,0.91,-0.01,-1.09,84000,7,75350,0,0,0,0,0,0,84000,0,84000,84000
20200430,055908,GIS日盛97購01,,,,,0.00,0.00,0,0,0,0,0,0,0,0,0,0,0,0,0
20200430,055909,大成鋼凱基98購02,0.91,0.96,0.89,0.95,+0.05,5.56,163000,9,153550,0,0,0,0,0,0,70000,93000,-23000,-23000
20200430,05590P,臺股指中信96售05,0.95,0.95,0.83,0.83,-0.23,-21.7,251000,24,218810,0,0,0,0,0,0,24000,227000,-203000,-203000
20200430,055910,瑞昱凱基98購01,5.25,5.65,5.25,5.65,+0.79,16.26,12000,2,65400,0,0,0,0,0,0,6000,6000,0,0
20200430,055911,可成凱基98購02,3.43,3.43,3.21,3.24,-0.32,-8.99,3000,3,9880,0,0,0,0,0,0,3000,3000,0,0
20200430,055912,宏達電凱基98購03,1.15,1.15,1.15,1.15,0.00,0.00,50000,1,57500,0,0,0,0,0,0,0,50000,-50000,-50000
20200430,055913,中信金凱基97購01,0.14,0.14,0.14,0.14,+0.01,7.69,6000,6,840,0,0,0,0,0,0,0,0,0,0
20200430,055914,大立光凱基97購13,,,,,0.00,0.00,0,0,0,0,0,0,0,0,0,0,0,0,0
20200430,055915,大立光凱基98購07,0.16,0.18,0.16,0.18,+0.05,38.46,4000,2,680,0,0,0,0,0,0,4000,0,4000,4000
20200430,055916,奇鋐凱基99購01,1.13,1.18,1.08,1.15,+0.08,7.48,114000,14,129950,0,0,0,0,0,0,52000,61000,-9000,-9000
20200430,055917,禾伸堂凱基98購02,1.06,1.06,1.01,1.01,+0.09,9.78,100000,11,102700,0,0,0,0,0,0,0,100000,-100000,-100000
20200430,055918,和鑫凱基97購01,,,,,0.00,0.00,0,0,0,0,0,0,0,0,0,0,0,0,0
20200430,055919,景碩凱基98購02,4.23,4.54,4.23,4.54,+0.36,8.61,45000,5,192840,0,0,0,0,0,0,29000,16000,13000,13000
20200430,05591P,義隆群益96售03,,,,,0.00,0.00,0,0,0,0,0,0,0,0,0,0,0,0,0
20200430,055920,智伸科凱基97購02,0.33,0.33,0.33,0.33,0.00,0.00,10000,1,3300,0,0,0,0,0,0,0,10000,-10000,-10000
20200430,055921,新唐凱基98購01,,,,,0.00,0.00,0,0,0,0,0,0,0,0,0,0,0,0,0
20200430,055922,台郡凱基98購03,,,,,0.00,0.00,0,0,0,0,0,0,0,0,0,0,0,0,0
20200430,055923,矽力凱基98購01,,,,,0.00,0.00,0,0,0,0,0,0,0,0,0,0,0,0,0
20200430,055924,深中小群益9B購01,0.43,0.47,0.43,0.47,+0.06,14.63,85000,7,38350,0,0,0,0,0,0,85000,0,85000,85000
20200430,055925,上銀群益97購01,3.44,4.02,3.44,4.02,+0.69,20.72,203000,8,752290,0,0,0,0,0,0,82000,105000,-23000,-23000
20200430,055926,國巨群益98購06,,,,,0.00,0.00,0,0,0,0,0,0,0,0,0,0,0,0,0
20200430,055927,南亞科群益97購01,,,,,0.00,0.00,0,0,0,0,0,0,0,0,0,0,0,0,0
20200430,055928,南亞科群益97購02,,,,,0.00,0.00,0,0,0,0,0,0,0,0,0,0,0,0,0
20200430,055929,聯發科群益97購05,,,,,0.00,0.00,0,0,0,0,0,0,0,0,0,0,0,0,0
20200430,05592P,可成群益96售03,,,,,0.00,0.00,0,0,0,0,0,0,0,0,0,0,0,0,0
20200430,055930,可成群益98購01,,,,,0.00,0.00,0,0,0,0,0,0,0,0,0,0,0,0,0
20200430,055931,冠德群益97購02,,,,,0.00,0.00,0,0,0,0,0,0,0,0,0,0,0,0,0
20200430,055932,玉山金群益99購01,,,,,0.00,0.00,0,0,0,0,0,0,0,0,0,0,0,0,0
20200430,055933,欣興群益98購02,3.99,4.27,3.97,4.08,+0.02,0.49,53000,7,216160,0,0,0,0,0,0,39000,17000,22000,22000
20200430,055934,景碩群益98購03,3.46,3.64,3.46,3.64,+0.21,6.12,123000,12,431770,0,0,0,0,0,0,53000,72000,-19000,-19000
20200430,055935,創意群益97購02,1.21,1.30,1.21,1.30,-1.13,-46.5,200000,8,248330,0,0,0,0,0,0,0,200000,-200000,-200000
20200430,055936,彩晶群益98購02,0.42,0.44,0.42,0.44,+0.01,2.33,286000,8,122440,0,0,0,0,0,0,67000,219000,-152000,-152000
20200430,055937,康舒群益97購01,0.40,0.40,0.40,0.40,-0.01,-2.44,56000,1,22400,0,0,0,0,0,0,56000,0,56000,56000
20200430,055938,矽力群益97購01,2.60,2.60,2.20,2.20,-0.51,-18.82,110000,3,267940,0,0,0,0,0,0,110000,0,110000,110000
20200430,055939,GIS群益97購01,,,,,0.00,0.00,0,0,0,0,0,0,0,0,0,0,0,0,0
20200430,05593P,鴻海國票97售03,,,,,0.00,0.00,0,0,0,0,0,0,0,0,0,0,0,0,0
20200430,055940,致新群益98購01,2.24,2.34,2.15,2.33,+0.20,9.39,326000,25,715780,0,0,0,0,0,0,235000,51000,184000,184000
20200430,055941,百和群益98購02,,,,,0.00,0.00,0,0,0,0,0,0,0,0,0,0,0,0,0
20200430,055942,臺股指群益9C購01,0.55,0.60,0.55,0.60,0.00,0.00,45000,6,26550,0,0,0,0,0,0,5000,0,5000,5000
20200430,055943,瑞昱麥證97購01,1.35,1.50,1.31,1.50,+0.28,22.95,163000,11,230940,163000,0,163000,0,0,0,163000,0,163000,163000
20200430,055944,日月光麥證97購01,,,,,0.00,0.00,0,0,0,0,0,0,0,0,0,0,0,0,0
20200430,055945,上証2X元大97購04,,,,,0.00,0.00,0,0,0,0,0,0,0,0,0,0,0,0,0
20200430,055946,元油反元大97購02,,,,,0.00,0.00,0,0,0,0,0,0,0,0,0,0,0,0,0
20200430,055947,元油反元大98購03,,,,,0.00,0.00,0,0,0,0,0,0,0,0,0,0,0,0,0
20200430,055948,道瓊銀元大98購02,,,,,0.00,0.00,0,0,0,0,0,0,0,0,0,0,0,0,0
20200430,055949,亞德客元大97購04,2.96,3.67,2.72,3.67,+0.98,36.43,303000,52,928340,0,0,0,0,0,0,114000,226000,-112000,-112000
20200430,05594P,旺宏國票96售04,0.73,0.74,0.70,0.74,-0.18,-19.57,52000,4,37510,0,0,0,0,0,0,35000,17000,18000,18000
20200430,055950,華新元大97購02,,,,,0.00,0.00,0,0,0,0,0,0,0,0,0,0,0,0,0
20200430,055951,大成鋼元大97購02,0.42,0.42,0.42,0.42,0.00,0.00,20000,1,8400,0,0,0,0,0,0,0,20000,-20000,-20000
20200430,055952,上銀元大97購08,0.70,1.12,0.70,1.12,0.00,0.00,18000,6,17340,0,0,0,0,0,0,18000,0,18000,18000
20200430,055953,上銀元大97購09,3.02,3.80,2.95,3.80,+1.02,36.69,243000,33,765610,0,0,0,0,0,0,83000,160000,-77000,-77000
20200430,055954,南港元大97購02,0.37,0.37,0.37,0.37,0.00,0.00,6000,1,2220,0,0,0,0,0,0,0,6000,-6000,-6000
20200430,055955,微星元大97購01,2.41,2.46,2.41,2.46,+0.05,2.07,170000,8,417850,0,0,0,0,0,0,20000,155000,-135000,-135000
20200430,055956,瑞昱元大97購05,,,,,0.00,0.00,0,0,0,0,0,0,0,0,0,0,0,0,0
20200430,055957,瑞昱元大97購06,,,,,0.00,0.00,0,0,0,0,0,0,0,0,0,0,0,0,0
20200430,055958,台光電元大97購02,1.21,1.35,1.21,1.35,+0.18,15.38,169000,12,214550,0,0,0,0,0,0,120000,99000,21000,21000
20200430,055959,美律元大97購03,,,,,0.00,0.00,0,0,0,0,0,0,0,0,0,0,0,0,0
20200430,05595P,友達統一96售02,,,,,0.00,0.00,0,0,0,0,0,0,0,0,0,0,0,0,0
20200430,055960,義隆元大97購01,,,,,0.00,0.00,0,0,0,0,0,0,0,0,0,0,0,0,0
20200430,055961,國泰金元大97購01,,,,,0.00,0.00,0,0,0,0,0,0,0,0,0,0,0,0,0
20200430,055962,晶豪科元大97購02,4.02,4.07,3.92,4.00,+0.22,5.82,110000,13,437030,0,0,0,0,0,0,110000,0,110000,110000
20200430,055963,欣興元大97購04,2.57,2.58,2.55,2.58,+0.25,10.73,66000,8,168830,0,0,0,0,0,0,36000,21000,15000,15000
20200430,055964,正文元大97購02,,,,,0.00,0.00,0,0,0,0,0,0,0,0,0,0,0,0,0
20200430,055965,泰鼎元大97購03,,,,,0.00,0.00,0,0,0,0,0,0,0,0,0,0,0,0,0
20200430,055966,茂林元大99購01,,,,,0.00,0.00,0,0,0,0,0,0,0,0,0,0,0,0,0
20200430,055967,臻鼎元大97購01,,,,,0.00,0.00,0,0,0,0,0,0,0,0,0,0,0,0,0
20200430,055968,祥碩元大97購04,6.20,6.20,5.05,5.05,-0.70,-12.17,70000,14,407950,0,0,0,0,0,0,30000,70000,-40000,-40000
20200430,055969,彩晶元大99購02,,,,,0.00,0.00,0,0,0,0,0,0,0,0,0,0,0,0,0
20200430,05596P,可成統一96售01,1.63,1.71,1.63,1.71,0.00,0.00,33000,3,55550,0,0,0,0,0,0,0,33000,-33000,-33000
20200430,055970,聯茂元大97購04,3.91,3.91,3.73,3.73,-0.32,-7.9,20000,3,76050,0,0,0,0,0,0,20000,0,20000,20000
20200430,055971,矽力元大97購05,,,,,0.00,0.00,0,0,0,0,0,0,0,0,0,0,0,0,0
20200430,055972,GIS元大97購04,0.67,0.67,0.67,0.67,+0.08,13.56,30000,2,20100,0,0,0,0,0,0,20000,10000,10000,10000
20200430,055973,亞德客統一97購01,1.46,1.88,1.46,1.88,0.00,0.00,4000,4,6600,0,0,0,0,0,0,3000,0,3000,3000
20200430,055974,上銀統一97購05,2.11,2.72,1.99,2.66,+0.99,59.28,516000,21,1163690,0,0,0,0,0,0,55000,461000,-406000,-406000
20200430,055975,鴻海統一98購05,0.15,0.15,0.15,0.15,0.00,0.00,1000,1,150,0,0,0,0,0,0,0,0,0,0
20200430,055976,台積電統一99購03,0.21,0.23,0.15,0.22,0.00,0.00,1040000,107,224280,0,0,0,0,0,0,957000,1000000,-43000,-43000
20200430,055977,南亞科統一97購01,,,,,0.00,0.00,0,0,0,0,0,0,0,0,0,0,0,0,0
20200430,055978,大立光統一98購05,0.11,0.11,0.11,0.11,0.00,0.00,14000,1,1540,0,0,0,0,0,0,0,0,0,0
20200430,055979,聯鈞統一97購03,0.60,0.60,0.60,0.60,0.00,0.00,18000,1,10800,0,0,0,0,0,0,0,18000,-18000,-18000
20200430,05597P,鴻海元富96售06,,,,,0.00,0.00,0,0,0,0,0,0,0,0,0,0,0,0,0
20200430,055980,祥碩統一98購01,,,,,0.00,0.00,0,0,0,0,0,0,0,0,0,0,0,0,0
20200430,055981,臺股指統一97購03,,,,,0.00,0.00,0,0,0,0,0,0,0,0,0,0,0,0,0
20200430,055982,T50反1元富97購01,,,,,0.00,0.00,0,0,0,0,0,0,0,0,0,0,0,0,0
20200430,055983,全新元富9A購02,,,,,0.00,0.00,0,0,0,0,0,0,0,0,0,0,0,0,0
20200430,055984,大立光元富97購02,0.63,0.70,0.63,0.70,+0.13,22.81,573000,7,372530,0,0,0,0,0,0,108000,465000,-357000,-357000
20200430,055985,聯鈞元富97購01,,,,,0.00,0.00,0,0,0,0,0,0,0,0,0,0,0,0,0
20200430,055986,祥碩元富97購01,1.89,1.89,1.40,1.40,-0.32,-18.6,73000,13,119360,0,0,0,0,0,0,3000,61000,-58000,-58000
20200430,055987,台表科元富97購01,,,,,0.00,0.00,0,0,0,0,0,0,0,0,0,0,0,0,0
20200430,055988,矽力元富97購01,1.01,1.01,1.01,1.01,0.00,0.00,2000,1,2020,0,0,0,0,0,0,0,2000,-2000,-2000
20200430,055989,矽力元富9A購01,1.81,1.81,1.52,1.65,-0.13,-7.3,156000,14,255720,0,0,0,0,0,0,38000,156000,-118000,-118000
20200430,05598P,國巨元富96售03,,,,,0.00,0.00,0,0,0,0,0,0,0,0,0,0,0,0,0
20200430,055990,矽創元富97購01,0.39,0.39,0.39,0.39,+0.06,18.18,5000,1,1950,0,0,0,0,0,0,5000,0,5000,5000
20200430,055991,鈺齊元富97購01,,,,,0.00,0.00,0,0,0,0,0,0,0,0,0,0,0,0,0
20200430,055992,智原台新97購02,0.44,0.44,0.07,0.07,-0.34,-82.93,69000,4,19260,0,0,0,0,0,0,0,69000,-69000,-69000
20200430,055993,致茂國泰99購01,,,,,0.00,0.00,0,0,0,0,0,0,0,0,0,0,0,0,0
20200430,055994,聯發科國泰99購02,1.26,1.39,1.24,1.39,+0.24,20.87,16000,8,21100,0,0,0,0,0,0,8000,3000,5000,5000
20200430,055995,華擎國泰99購01,,,,,0.00,0.00,0,0,0,0,0,0,0,0,0,0,0,0,0
20200430,055996,矽力國泰99購01,1.67,1.67,1.43,1.50,-0.26,-14.77,70000,7,108400,0,0,0,0,0,0,0,70000,-70000,-70000
20200430,055997,矽創國泰99購01,0.37,0.37,0.37,0.37,0.00,0.00,30000,1,11100,0,0,0,0,0,0,30000,0,30000,30000
20200430,055998,臺股指富邦99購01,0.04,0.04,0.03,0.03,0.00,0.00,227000,2,7080,0,0,0,0,0,0,0,0,0,0
20200430,055999,電子類富邦99購01,0.10,0.10,0.10,0.10,0.00,0.00,5000,1,500,0,0,0,0,0,0,5000,0,5000,5000
20200430,05599P,欣興台新96售01,0.14,0.14,0.14,0.14,0.00,0.00,10000,1,1400,0,0,0,0,0,0,0,10000,-10000,-10000
20200430,056000,佳世達永豐97購01,0.52,0.55,0.52,0.55,+0.04,7.84,232000,9,124510,0,0,0,0,0,0,232000,0,232000,232000
20200430,056001,美食永豐97購01,,,,,0.00,0.00,0,0,0,0,0,0,0,0,0,0,0,0,0
20200430,056002,嘉晶永豐97購01,0.25,0.25,0.23,0.23,0.00,0.00,22000,2,5300,0,0,0,0,0,0,0,22000,-22000,-22000
20200430,056003,智伸科永豐97購02,0.36,0.39,0.36,0.39,+0.06,18.18,228000,4,86620,0,0,0,0,0,0,100000,128000,-28000,-28000
20200430,056004,南電永豐97購02,6.05,6.05,5.55,5.55,-0.35,-5.93,69000,6,409550,0,0,0,0,0,0,69000,0,69000,69000
20200430,056005,臺股指永豐97購04,0.02,0.03,0.02,0.03,+0.02,200.0,292000,3,7340,0,0,0,0,0,0,0,0,0,0
20200430,056006,義隆亞東97購01,,,,,0.00,0.00,0,0,0,0,0,0,0,0,0,0,0,0,0
20200430,056007,上銀中信97購02,0.06,0.08,0.06,0.08,+0.05,166.67,216000,3,14880,0,0,0,0,0,0,120000,0,120000,120000
20200430,056008,全新中信9B購01,,,,,0.00,0.00,0,0,0,0,0,0,0,0,0,0,0,0,0
20200430,056009,奇力新中信98購03,,,,,0.00,0.00,0,0,0,0,0,0,0,0,0,0,0,0,0
20200430,05600P,玉晶光台新96售04,0.15,0.15,0.15,0.15,0.00,0.00,10000,1,1500,0,0,0,0,0,0,0,10000,-10000,-10000
20200430,056010,力成中信97購01,0.15,0.15,0.12,0.12,-0.03,-20.0,40000,2,5700,0,0,0,0,0,0,10000,30000,-20000,-20000
20200430,056011,矽力中信99購01,,,,,0.00,0.00,0,0,0,0,0,0,0,0,0,0,0,0,0
20200430,056012,勤誠中信99購01,0.23,0.23,0.23,0.23,-0.01,-4.17,170000,6,39100,0,0,0,0,0,0,120000,0,120000,120000
20200430,056013,T50反1群益97購01,,,,,0.00,0.00,0,0,0,0,0,0,0,0,0,0,0,0,0
20200430,056014,上銀群益97購02,,,,,0.00,0.00,0,0,0,0,0,0,0,0,0,0,0,0,0
20200430,056015,華通群益99購01,0.49,0.50,0.49,0.50,0.00,0.00,13000,3,6400,0,0,0,0,0,0,13000,0,13000,13000
20200430,056016,鴻海群益97購06,0.14,0.15,0.14,0.15,0.00,0.00,546000,2,79100,0,0,0,0,0,0,546000,0,546000,546000
20200430,056017,台積電群益97購04,,,,,0.00,0.00,0,0,0,0,0,0,0,0,0,0,0,0,0
20200430,056018,旺宏群益97購02,,,,,0.00,0.00,0,0,0,0,0,0,0,0,0,0,0,0,0
20200430,056019,燿華群益97購02,,,,,0.00,0.00,0,0,0,0,0,0,0,0,0,0,0,0,0
20200430,05601P,鴻海元大97售04,,,,,0.00,0.00,0,0,0,0,0,0,0,0,0,0,0,0,0
20200430,056020,義隆群益97購01,2.64,3.05,2.64,3.05,+0.39,14.66,155000,8,456490,0,0,0,0,0,0,107000,56000,51000,51000
20200430,056021,興富發群益97購01,2.04,2.05,1.98,1.98,-0.08,-3.88,32000,3,64600,0,0,0,0,0,0,32000,0,32000,32000
20200430,056022,新光金群益97購02,,,,,0.00,0.00,0,0,0,0,0,0,0,0,0,0,0,0,0
20200430,056023,晶豪科群益97購01,3.43,3.59,3.12,3.12,-0.03,-0.95,315000,29,1077460,0,0,0,0,0,0,313000,150000,163000,163000
20200430,056024,大立光群益97購05,,,,,0.00,0.00,0,0,0,0,0,0,0,0,0,0,0,0,0
20200430,056025,嘉晶群益97購01,1.17,1.17,1.17,1.17,0.00,0.00,102000,2,119340,0,0,0,0,0,0,0,102000,-102000,-102000
20200430,056026,智易群益97購01,2.04,2.04,2.01,2.01,-0.20,-9.05,63000,5,127310,0,0,0,0,0,0,63000,0,63000,63000
20200430,056027,樺漢群益97購02,,,,,0.00,0.00,0,0,0,0,0,0,0,0,0,0,0,0,0
20200430,056028,GIS群益97購02,0.89,0.90,0.88,0.90,0.00,0.00,647000,8,576110,0,0,0,0,0,0,647000,0,647000,647000
20200430,056029,國巨麥證98購01,,,,,0.00,0.00,0,0,0,0,0,0,0,0,0,0,0,0,0
20200430,05602P,國巨元大96售06,,,,,0.00,0.00,0,0,0,0,0,0,0,0,0,0,0,0,0
20200430,056030,華通日盛97購01,,,,,0.00,0.00,0,0,0,0,0,0,0,0,0,0,0,0,0
20200430,056031,勤誠康和97購02,,,,,0.00,0.00,0,0,0,0,0,0,0,0,0,0,0,0,0
20200430,056032,勤誠康和97購03,,,,,0.00,0.00,0,0,0,0,0,0,0,0,0,0,0,0,0
20200430,056033,T50正2凱基99購02,0.32,0.40,0.32,0.38,+0.05,15.15,449000,14,153700,0,0,0,0,0,0,427000,0,427000,427000
20200430,056034,華通凱基98購01,,,,,0.00,0.00,0,0,0,0,0,0,0,0,0,0,0,0,0
20200430,056035,鴻海凱基97購06,,,,,0.00,0.00,0,0,0,0,0,0,0,0,0,0,0,0,0
20200430,056036,鴻海凱基97購07,1.79,1.83,1.79,1.83,+0.06,3.39,68000,3,122120,0,0,0,0,0,0,58000,10000,48000,48000
20200430,056037,美律凱基98購03,0.12,0.12,0.12,0.12,0.00,0.00,10000,1,1200,0,0,0,0,0,0,10000,0,10000,10000
20200430,056038,可成凱基97購01,2.32,2.32,2.27,2.27,-0.07,-2.99,8000,2,18510,0,0,0,0,0,0,7000,1000,6000,6000
20200430,056039,宏達電凱基97購02,,,,,0.00,0.00,0,0,0,0,0,0,0,0,0,0,0,0,0
20200430,05603P,聯發科元大96售09,,,,,0.00,0.00,0,0,0,0,0,0,0,0,0,0,0,0,0
20200430,056040,亞光凱基98購01,,,,,0.00,0.00,0,0,0,0,0,0,0,0,0,0,0,0,0
20200430,056041,禾伸堂凱基98購03,,,,,0.00,0.00,0,0,0,0,0,0,0,0,0,0,0,0,0
20200430,056042,京鼎凱基97購02,,,,,0.00,0.00,0,0,0,0,0,0,0,0,0,0,0,0,0
20200430,056043,力成凱基97購01,,,,,0.00,0.00,0,0,0,0,0,0,0,0,0,0,0,0,0
20200430,056044,同欣電凱基97購03,0.35,0.36,0.35,0.36,+0.02,5.88,115000,5,41300,0,0,0,0,0,0,0,115000,-115000,-115000
20200430,056045,勤誠凱基97購01,0.63,0.63,0.62,0.63,+0.01,1.61,71000,3,44630,0,0,0,0,0,0,71000,0,71000,71000
20200430,056046,百和凱基97購01,,,,,0.00,0.00,0,0,0,0,0,0,0,0,0,0,0,0,0
20200430,056047,台積電兆豐97購02,0.49,0.65,0.16,0.17,-0.13,-43.33,301000,10,136360,0,0,0,0,0,0,200000,100000,100000,100000
20200430,056048,同欣電兆豐97購01,0.05,0.05,0.05,0.05,0.00,0.00,10000,1,500,0,0,0,0,0,0,0,10000,-10000,-10000
20200430,056049,奇力新國票98購01,0.85,0.94,0.85,0.88,+0.06,7.32,187000,10,170110,0,0,0,0,0,0,23000,164000,-141000,-141000
20200430,05604P,聯發科元大96售10,,,,,0.00,0.00,0,0,0,0,0,0,0,0,0,0,0,0,0
20200430,056050,晶技國票98購01,4.72,4.72,4.72,4.72,+0.11,2.39,3000,1,14160,0,0,0,0,0,0,3000,0,3000,3000
20200430,056051,T50反1元大97購05,,,,,0.00,0.00,0,0,0,0,0,0,0,0,0,0,0,0,0
20200430,056052,T50反1元大97購06,,,,,0.00,0.00,0,0,0,0,0,0,0,0,0,0,0,0,0
20200430,056053,和大元大97購05,,,,,0.00,0.00,0,0,0,0,0,0,0,0,0,0,0,0,0
20200430,056054,亞德客元大97購05,3.20,4.03,2.93,4.03,+1.19,41.9,295000,62,941480,0,0,0,0,0,0,214000,140000,74000,74000
20200430,056055,國巨元大97購15,0.59,0.59,0.59,0.59,+0.04,7.27,20000,2,11800,0,0,0,0,0,0,0,20000,-20000,-20000
20200430,056056,旺宏元大97購06,,,,,0.00,0.00,0,0,0,0,0,0,0,0,0,0,0,0,0
20200430,056057,華邦電元大97購05,0.56,0.63,0.56,0.63,0.00,0.00,373000,6,228430,0,0,0,0,0,0,0,373000,-373000,-373000
20200430,056058,建準元大97購02,,,,,0.00,0.00,0,0,0,0,0,0,0,0,0,0,0,0,0
20200430,056059,美律元大98購02,0.31,0.31,0.31,0.31,0.00,0.00,1000,1,310,0,0,0,0,0,0,0,0,0,0
20200430,05605P,嘉聯益元大97售02,0.76,0.76,0.76,0.76,-0.04,-5.0,11000,2,8360,0,0,0,0,0,0,0,11000,-11000,-11000
20200430,056060,宏達電元大99購01,,,,,0.00,0.00,0,0,0,0,0,0,0,0,0,0,0,0,0
20200430,056061,國泰金元大97購02,0.69,0.69,0.69,0.69,0.00,0.00,10000,1,6900,0,0,0,0,0,0,0,10000,-10000,-10000
20200430,056062,大立光元大97購12,,,,,0.00,0.00,0,0,0,0,0,0,0,0,0,0,0,0,0
20200430,056063,大立光元大97購13,0.41,0.42,0.41,0.42,0.00,0.00,20000,2,8300,0,0,0,0,0,0,20000,0,20000,20000
20200430,056064,大立光元大97購14,0.59,0.64,0.59,0.64,0.00,0.00,2000,2,1230,0,0,0,0,0,0,0,0,0,0
20200430,056065,奇鋐元大97購01,3.30,3.46,3.25,3.46,+0.36,11.61,167000,17,558760,0,0,0,0,0,0,0,167000,-167000,-167000
20200430,056066,奇鋐元大98購02,0.76,0.80,0.76,0.80,+0.11,15.94,11000,2,8760,0,0,0,0,0,0,1000,0,1000,1000
20200430,056067,智原元大97購01,0.75,0.76,0.75,0.76,+0.04,5.56,179000,2,135040,0,0,0,0,0,0,0,179000,-179000,-179000
20200430,056068,欣興元大97購05,,,,,0.00,0.00,0,0,0,0,0,0,0,0,0,0,0,0,0
20200430,056069,新日興元大97購03,,,,,0.00,0.00,0,0,0,0,0,0,0,0,0,0,0,0,0
20200430,05606P,TPK國票97售02,2.55,2.61,2.53,2.61,-0.01,-0.38,23000,6,59010,0,0,0,0,0,0,15000,8000,7000,7000
20200430,056070,新日興元大97購04,,,,,0.00,0.00,0,0,0,0,0,0,0,0,0,0,0,0,0
20200430,056071,創意元大97購02,,,,,0.00,0.00,0,0,0,0,0,0,0,0,0,0,0,0,0
20200430,056072,群創元大97購01,,,,,0.00,0.00,0,0,0,0,0,0,0,0,0,0,0,0,0
20200430,056073,智伸科元大97購01,,,,,0.00,0.00,0,0,0,0,0,0,0,0,0,0,0,0,0
20200430,056074,茂林元大97購04,,,,,0.00,0.00,0,0,0,0,0,0,0,0,0,0,0,0,0
20200430,056075,瀚宇博元大97購03,2.14,2.22,2.09,2.20,+0.13,6.28,231000,18,497180,0,0,0,0,0,0,20000,217000,-197000,-197000
20200430,056076,超眾元大97購05,2.93,3.02,2.89,3.02,+0.23,8.24,92000,8,269950,0,0,0,0,0,0,50000,42000,8000,8000
20200430,056077,矽力元大97購07,2.38,2.38,2.04,2.12,-0.28,-11.67,82000,4,181820,0,0,0,0,0,0,34000,48000,-14000,-14000
20200430,056078,勤誠元大97購01,,,,,0.00,0.00,0,0,0,0,0,0,0,0,0,0,0,0,0
20200430,056079,世紀鋼元大97購02,,,,,0.00,0.00,0,0,0,0,0,0,0,0,0,0,0,0,0
20200430,05607P,華通日盛96售01,,,,,0.00,0.00,0,0,0,0,0,0,0,0,0,0,0,0,0
20200430,056080,世紀鋼元大97購03,1.35,1.47,1.35,1.47,0.00,0.00,30000,4,42650,0,0,0,0,0,0,0,30000,-30000,-30000
20200430,056081,T50反1統一99購02,1.30,1.30,1.30,1.30,-0.18,-12.16,10000,1,13000,0,0,0,0,0,0,0,10000,-10000,-10000
20200430,056082,旺宏統一99購02,0.33,0.33,0.32,0.32,0.00,0.00,5000,2,1630,0,0,0,0,0,0,5000,0,5000,5000
20200430,056083,億光統一97購03,1.21,1.22,1.15,1.15,+0.01,0.88,163000,7,195880,0,0,0,0,0,0,0,163000,-163000,-163000
20200430,056084,漢唐統一97購03,1.84,1.84,1.81,1.84,-0.03,-1.6,178000,5,324070,0,0,0,0,0,0,115000,63000,52000,52000
20200430,056085,聯發科統一97購01,3.01,3.24,2.96,3.24,+0.62,23.66,272000,15,829250,0,0,0,0,0,0,83000,189000,-106000,-106000
20200430,056086,奇力新統一98購01,,,,,0.00,0.00,0,0,0,0,0,0,0,0,0,0,0,0,0
20200430,056087,世芯統一97購01,1.05,1.05,1.05,1.05,+0.25,31.25,27000,2,28350,0,0,0,0,0,0,25000,2000,23000,23000
20200430,056088,台郡統一97購02,1.31,1.34,1.31,1.34,+0.08,6.35,21000,2,27570,0,0,0,0,0,0,21000,0,21000,21000
20200430,056089,同欣電統一98購01,0.12,0.12,0.12,0.12,0.00,0.00,20000,1,2400,0,0,0,0,0,0,0,20000,-20000,-20000
20200430,05608P,聯發科凱基96售10,,,,,0.00,0.00,0,0,0,0,0,0,0,0,0,0,0,0,0
20200430,056090,康舒統一97購01,,,,,0.00,0.00,0,0,0,0,0,0,0,0,0,0,0,0,0
20200430,056091,百和統一97購01,0.80,0.83,0.79,0.83,0.00,0.00,261000,4,210330,0,0,0,0,0,0,213000,48000,165000,165000
20200430,056092,亞德客元富97購02,2.29,2.97,2.10,2.92,+0.83,39.71,656000,97,1601150,0,0,0,0,0,0,264000,416000,-152000,-152000
20200430,056093,大毅元富97購01,2.57,2.71,2.57,2.71,+0.42,18.34,30000,2,78500,0,0,0,0,0,0,20000,10000,10000,10000
20200430,056094,大立光元富97購03,1.12,1.25,1.12,1.25,+0.25,25.0,30000,5,35050,0,0,0,0,0,0,15000,15000,0,0
20200430,056095,臻鼎元富9A購01,0.35,0.38,0.35,0.38,0.00,0.00,21000,3,7940,0,0,0,0,0,0,21000,0,21000,21000
20200430,056096,超眾元富9A購01,,,,,0.00,0.00,0,0,0,0,0,0,0,0,0,0,0,0,0
20200430,056097,訊芯元富97購02,0.47,0.51,0.46,0.51,+0.04,8.51,80000,6,38100,0,0,0,0,0,0,30000,50000,-20000,-20000
20200430,056098,矽創元富97購02,0.62,0.67,0.60,0.65,+0.06,10.17,607000,21,391370,0,0,0,0,0,0,257000,350000,-93000,-93000
20200430,056099,上銀永豐97購02,,,,,0.00,0.00,0,0,0,0,0,0,0,0,0,0,0,0,0
20200430,05609P,國泰金凱基96售01,0.26,0.27,0.23,0.23,-0.12,-34.29,295000,30,73900,0,0,0,0,0,0,0,285000,-285000,-285000
20200430,056100,楠梓電永豐97購02,,,,,0.00,0.00,0,0,0,0,0,0,0,0,0,0,0,0,0
20200430,056101,光磊永豐98購01,,,,,0.00,0.00,0,0,0,0,0,0,0,0,0,0,0,0,0
20200430,056102,億光永豐97購02,,,,,0.00,0.00,0,0,0,0,0,0,0,0,0,0,0,0,0
20200430,056103,聯發科永豐97購03,1.86,1.98,1.86,1.98,+0.30,17.86,66000,4,127170,0,0,0,0,0,0,30000,36000,-6000,-6000
20200430,056104,義隆永豐97購01,0.91,1.07,0.90,1.06,+0.12,12.77,163000,16,160700,0,0,0,0,0,0,38000,152000,-114000,-114000
20200430,056105,智原永豐97購01,0.49,0.50,0.48,0.48,0.00,0.00,148000,16,72770,0,0,0,0,0,0,13000,130000,-117000,-117000
20200430,056106,晶相光永豐97購02,0.16,0.16,0.16,0.16,-0.02,-11.11,5000,1,800,0,0,0,0,0,0,5000,0,5000,5000
20200430,056107,智易永豐97購02,1.63,1.63,1.61,1.61,-0.07,-4.17,26000,7,42080,0,0,0,0,0,0,26000,0,26000,26000
20200430,056108,麗豐永豐97購01,,,,,0.00,0.00,0,0,0,0,0,0,0,0,0,0,0,0,0
20200430,056109,彩晶永豐98購01,,,,,0.00,0.00,0,0,0,0,0,0,0,0,0,0,0,0,0
20200430,05610P,國巨群益98售01,,,,,0.00,0.00,0,0,0,0,0,0,0,0,0,0,0,0,0
20200430,056110,嘉聯益永豐97購02,0.83,0.86,0.82,0.86,+0.08,10.26,201000,6,171650,0,0,0,0,0,0,30000,171000,-141000,-141000
20200430,056111,力成永豐97購01,,,,,0.00,0.00,0,0,0,0,0,0,0,0,0,0,0,0,0
20200430,056112,勤誠永豐97購02,,,,,0.00,0.00,0,0,0,0,0,0,0,0,0,0,0,0,0
20200430,056113,新日興兆豐98購01,,,,,0.00,0.00,0,0,0,0,0,0,0,0,0,0,0,0,0
20200430,056114,台達電群益97購02,1.48,1.63,1.48,1.63,+0.38,30.4,240000,22,369990,0,0,0,0,0,0,98000,142000,-44000,-44000
20200430,056115,奇力新群益97購06,,,,,0.00,0.00,0,0,0,0,0,0,0,0,0,0,0,0,0
20200430,056116,義隆群益97購02,2.39,2.67,2.34,2.57,+0.16,6.64,347000,19,846270,0,0,0,0,0,0,134000,225000,-91000,-91000
20200430,056117,宏達電群益97購02,,,,,0.00,0.00,0,0,0,0,0,0,0,0,0,0,0,0,0
20200430,056118,聯詠群益97購03,,,,,0.00,0.00,0,0,0,0,0,0,0,0,0,0,0,0,0
20200430,056119,欣興群益97購02,1.64,1.75,1.64,1.69,+0.15,9.74,362000,6,628580,0,0,0,0,0,0,283000,80000,203000,203000
20200430,05611P,康控群益96售02,2.51,2.51,2.51,2.51,0.00,0.00,1000,1,2510,0,0,0,0,0,0,1000,0,1000,1000
20200430,056120,聯茂群益97購02,4.51,4.51,4.38,4.38,-0.17,-3.74,23000,5,102980,0,0,0,0,0,0,23000,0,23000,23000
20200430,056121,勤誠群益97購01,0.89,0.89,0.85,0.86,-0.04,-4.44,527000,12,454900,0,0,0,0,0,0,273000,324000,-51000,-51000
20200430,056122,勤誠群益97購02,1.77,1.77,1.69,1.70,-0.08,-4.49,312000,8,533970,0,0,0,0,0,0,197000,165000,32000,32000
20200430,056123,鈺齊群益97購01,,,,,0.00,0.00,0,0,0,0,0,0,0,0,0,0,0,0,0
20200430,056124,華通國票98購02,1.97,2.15,1.97,2.14,+0.34,18.89,66000,4,138290,0,0,0,0,0,0,37000,29000,8000,8000
20200430,056125,旺宏國票98購02,,,,,0.00,0.00,0,0,0,0,0,0,0,0,0,0,0,0,0
20200430,056126,台郡國票98購02,2.94,2.94,2.94,2.94,+1.69,135.2,8000,1,23520,0,0,0,0,0,0,0,8000,-8000,-8000
20200430,056127,致新國票98購02,1.42,1.48,1.34,1.48,+0.14,10.45,989000,43,1405370,0,0,0,0,0,0,591000,356000,235000,235000
20200430,056128,和大中信99購01,0.08,0.08,0.08,0.08,0.00,0.00,100000,1,8000,0,0,0,0,0,0,100000,0,100000,100000
20200430,056129,義隆麥證97購01,1.15,1.15,1.14,1.14,+0.02,1.79,55000,6,63200,55000,0,55000,0,0,0,55000,0,55000,55000
20200430,05612P,台積電元大96售13,0.13,0.14,0.08,0.08,+0.03,60.0,185000,8,18000,0,0,0,0,0,0,0,27000,-27000,-27000
20200430,056130,新日興麥證97購01,,,,,0.00,0.00,0,0,0,0,0,0,0,0,0,0,0,0,0
20200430,056131,鴻海元大97購12,,,,,0.00,0.00,0,0,0,0,0,0,0,0,0,0,0,0,0
20200430,056132,台光電元大97購03,2.91,3.14,2.91,3.14,+0.34,12.14,58000,7,174890,0,0,0,0,0,0,15000,43000,-28000,-28000
20200430,056133,可成元大97購05,2.31,2.31,2.14,2.14,-0.15,-6.55,36000,3,80540,0,0,0,0,0,0,25000,11000,14000,14000
20200430,056134,可成元大97購06,,,,,0.00,0.00,0,0,0,0,0,0,0,0,0,0,0,0,0
20200430,056135,緯創元大98購01,4.39,4.57,4.31,4.57,+0.23,5.3,335000,29,1475790,0,0,0,0,0,0,264000,71000,193000,193000
20200430,056136,京鼎元大98購01,0.75,0.83,0.75,0.83,+0.12,16.9,228000,5,179000,0,0,0,0,0,0,0,228000,-228000,-228000
20200430,056137,聯鈞元大9A購01,1.43,1.43,1.43,1.43,0.00,0.00,6000,1,8580,0,0,0,0,0,0,6000,0,6000,6000
20200430,056138,群創元大9B購01,0.59,0.59,0.59,0.59,+0.05,9.26,192000,3,113280,0,0,0,0,0,0,0,192000,-192000,-192000
20200430,056139,貿聯元大97購04,1.20,1.53,1.20,1.53,+0.39,34.21,527000,32,728380,0,0,0,0,0,0,283000,214000,69000,69000
20200430,05613P,臻鼎台新96售01,,,,,0.00,0.00,0,0,0,0,0,0,0,0,0,0,0,0,0
20200430,056140,康控元大98購01,0.37,0.42,0.35,0.42,0.00,0.00,97000,7,37530,0,0,0,0,0,0,57000,0,57000,57000
20200430,056141,聯茂元大97購05,2.88,2.88,2.75,2.85,-0.15,-5.0,16000,3,45800,0,0,0,0,0,0,15000,1000,14000,14000
20200430,056142,超眾元大97購06,1.14,1.19,1.13,1.13,+0.02,1.8,161000,12,188860,0,0,0,0,0,0,10000,151000,-141000,-141000
20200430,056143,訊芯元大97購04,0.73,0.82,0.73,0.82,+0.08,10.81,186000,6,144510,0,0,0,0,0,0,0,186000,-186000,-186000
20200430,056144,GIS元大98購01,1.70,1.72,1.66,1.66,+0.01,0.61,979000,48,1642210,0,0,0,0,0,0,893000,234000,659000,659000
20200430,056145,緯穎元大98購03,1.00,1.33,1.00,1.33,+0.43,47.78,90000,12,100700,0,0,0,0,0,0,90000,1000,89000,89000
20200430,056146,台虹元大98購01,1.80,1.80,1.72,1.72,-0.07,-3.91,654000,20,1160460,0,0,0,0,0,0,414000,238000,176000,176000
20200430,056147,鴻海日盛97購05,,,,,0.00,0.00,0,0,0,0,0,0,0,0,0,0,0,0,0
20200430,056148,臺股指日盛97購03,,,,,0.00,0.00,0,0,0,0,0,0,0,0,0,0,0,0,0
20200430,056149,亞光康和97購01,,,,,0.00,0.00,0,0,0,0,0,0,0,0,0,0,0,0,0
20200430,05614P,臺股指康和96售03,1.15,1.15,1.14,1.14,-0.17,-12.98,4000,2,4580,0,0,0,0,0,0,0,4000,-4000,-4000
20200430,056150,台光電凱基98購02,,,,,0.00,0.00,0,0,0,0,0,0,0,0,0,0,0,0,0
20200430,056151,建準凱基97購01,0.91,0.93,0.86,0.88,-0.16,-15.38,404000,22,362420,0,0,0,0,0,0,404000,0,404000,404000
20200430,056152,可成凱基97購02,,,,,0.00,0.00,0,0,0,0,0,0,0,0,0,0,0,0,0
20200430,056153,華新科凱基97購02,,,,,0.00,0.00,0,0,0,0,0,0,0,0,0,0,0,0,0
20200430,056154,宏達電凱基97購03,,,,,0.00,0.00,0,0,0,0,0,0,0,0,0,0,0,0,0
20200430,056155,嘉晶凱基97購01,,,,,0.00,0.00,0,0,0,0,0,0,0,0,0,0,0,0,0
20200430,056156,禾伸堂凱基98購04,2.81,2.81,2.74,2.74,-0.01,-0.36,20000,2,55500,0,0,0,0,0,0,20000,10000,10000,10000
20200430,056157,聯詠凱基97購03,0.98,1.01,0.98,1.01,+0.14,16.09,77000,4,76570,0,0,0,0,0,0,0,77000,-77000,-77000
20200430,056158,新日興凱基98購02,,,,,0.00,0.00,0,0,0,0,0,0,0,0,0,0,0,0,0
20200430,056159,牧德凱基99購01,,,,,0.00,0.00,0,0,0,0,0,0,0,0,0,0,0,0,0
20200430,05615P,臺股指康和96售04,,,,,0.00,0.00,0,0,0,0,0,0,0,0,0,0,0,0,0
20200430,056160,智易凱基97購03,1.98,1.99,1.93,1.93,-0.12,-5.85,50000,8,97760,0,0,0,0,0,0,50000,0,50000,50000
20200430,056161,康控凱基98購02,,,,,0.00,0.00,0,0,0,0,0,0,0,0,0,0,0,0,0
20200430,056162,祥碩凱基97購03,3.00,3.00,2.85,2.85,+0.14,5.17,94000,18,274360,0,0,0,0,0,0,94000,0,94000,94000
20200430,056163,嘉聯益凱基98購03,0.77,0.78,0.76,0.78,+0.01,1.3,61000,7,46780,0,0,0,0,0,0,61000,0,61000,61000
20200430,056164,聯茂凱基98購03,5.45,5.45,5.45,5.45,-0.20,-3.54,10000,1,54500,0,0,0,0,0,0,0,10000,-10000,-10000
20200430,056165,矽力凱基98購02,0.91,0.91,0.89,0.89,-0.03,-3.26,160000,16,143600,0,0,0,0,0,0,60000,160000,-100000,-100000
20200430,056166,微星台新97購01,0.11,0.11,0.11,0.11,0.00,0.00,30000,3,3300,0,0,0,0,0,0,0,30000,-30000,-30000
20200430,056167,力成台新97購01,0.02,0.02,0.02,0.02,0.00,0.00,10000,2,200,0,0,0,0,0,0,0,10000,-10000,-10000
20200430,056168,鴻海元富97購07,1.90,1.94,1.90,1.94,+0.10,5.43,21000,3,40600,0,0,0,0,0,0,1000,20000,-19000,-19000
20200430,056169,鴻海元富97購08,1.68,1.73,1.67,1.73,+0.09,5.49,211000,4,352980,0,0,0,0,0,0,201000,10000,191000,191000
20200430,05616P,台光電永豐96售01,,,,,0.00,0.00,0,0,0,0,0,0,0,0,0,0,0,0,0
20200430,056170,鴻海元富97購09,1.89,1.94,1.89,1.94,+0.10,5.43,30000,3,57600,0,0,0,0,0,0,10000,20000,-10000,-10000
20200430,056171,鴻海元富97購10,,,,,0.00,0.00,0,0,0,0,0,0,0,0,0,0,0,0,0
20200430,056172,鴻海元富97購11,,,,,0.00,0.00,0,0,0,0,0,0,0,0,0,0,0,0,0
20200430,056173,廣達元富97購01,0.83,0.92,0.83,0.92,+0.04,4.55,29000,4,25360,0,0,0,0,0,0,0,28000,-28000,-28000
20200430,056174,億光元富97購01,,,,,0.00,0.00,0,0,0,0,0,0,0,0,0,0,0,0,0
20200430,056175,可成元富97購03,2.31,2.31,2.31,2.31,-0.06,-2.53,19000,1,43890,0,0,0,0,0,0,19000,0,19000,19000
20200430,056176,創意元富97購01,0.77,0.80,0.76,0.80,+0.06,8.11,72000,5,56430,0,0,0,0,0,0,42000,30000,12000,12000
20200430,056177,嘉澤元富97購01,1.23,1.41,1.23,1.39,+0.11,8.59,1494000,61,1935930,0,0,0,0,0,0,756000,718000,38000,38000
20200430,056178,嘉澤元富97購02,1.31,1.54,1.27,1.54,+0.21,15.79,938000,46,1303480,0,0,0,0,0,0,195000,743000,-548000,-548000
20200430,056179,康友元富97購02,0.76,0.76,0.76,0.76,+0.03,4.11,15000,2,11400,0,0,0,0,0,0,15000,0,15000,15000
20200430,05617P,大立光統一97售02,,,,,0.00,0.00,0,0,0,0,0,0,0,0,0,0,0,0,0
20200430,056180,南茂元富97購01,,,,,0.00,0.00,0,0,0,0,0,0,0,0,0,0,0,0,0
20200430,056181,百和元富97購02,,,,,0.00,0.00,0,0,0,0,0,0,0,0,0,0,0,0,0
20200430,056182,台光電統一97購03,,,,,0.00,0.00,0,0,0,0,0,0,0,0,0,0,0,0,0
20200430,056183,南亞科統一97購02,1.03,1.03,0.99,0.99,+0.06,6.45,119000,4,119690,0,0,0,0,0,0,92000,27000,65000,65000
20200430,056184,南亞科統一97購03,,,,,0.00,0.00,0,0,0,0,0,0,0,0,0,0,0,0,0
20200430,056185,全新統一98購01,,,,,0.00,0.00,0,0,0,0,0,0,0,0,0,0,0,0,0
20200430,056186,智原統一97購01,0.44,0.45,0.43,0.43,-0.02,-4.44,478000,7,209130,0,0,0,0,0,0,115000,363000,-248000,-248000
20200430,056187,京鼎統一97購01,0.48,0.50,0.48,0.50,+0.02,4.17,201000,8,97160,0,0,0,0,0,0,47000,154000,-107000,-107000
20200430,056188,晶相光統一99購01,0.14,0.14,0.14,0.14,+0.01,7.69,10000,1,1400,0,0,0,0,0,0,0,0,0,0
20200430,056189,樺漢統一97購02,1.02,1.10,1.02,1.09,+0.07,6.86,287000,14,307620,0,0,0,0,0,0,58000,229000,-171000,-171000
20200430,05618P,聯發科元富96售02,,,,,0.00,0.00,0,0,0,0,0,0,0,0,0,0,0,0,0
20200430,056190,昇陽半統一97購01,0.50,0.51,0.50,0.51,0.00,0.00,68000,2,34590,0,0,0,0,0,0,0,68000,-68000,-68000
20200430,056191,世紀鋼統一97購01,2.69,2.84,2.69,2.84,+0.18,6.77,116000,6,319790,0,0,0,0,0,0,0,116000,-116000,-116000
20200430,056192,智邦富邦98購01,1.35,1.40,1.23,1.23,-0.10,-7.52,54000,27,72110,0,0,0,0,0,0,45000,0,45000,45000
20200430,056193,聯發科富邦99購08,0.99,1.10,0.99,1.09,+0.19,21.11,147000,20,150760,0,0,0,0,0,0,117000,0,117000,117000
20200430,056194,聯發科富邦9B購01,1.32,1.57,1.32,1.57,+0.33,26.61,127000,11,169310,0,0,0,0,0,0,126000,1000,125000,125000
20200430,056195,群創富邦98購01,,,,,0.00,0.00,0,0,0,0,0,0,0,0,0,0,0,0,0
20200430,056196,聯茂富邦98購02,0.84,0.84,0.81,0.82,-0.02,-2.38,514000,23,422580,0,0,0,0,0,0,514000,0,514000,514000
20200430,056197,友訊永豐97購01,,,,,0.00,0.00,0,0,0,0,0,0,0,0,0,0,0,0,0
20200430,056198,台光電永豐97購02,0.76,0.87,0.76,0.87,+0.12,16.0,278000,12,227320,0,0,0,0,0,0,46000,232000,-186000,-186000
20200430,056199,美律永豐97購01,0.53,0.58,0.53,0.58,+0.06,11.54,212000,6,118560,0,0,0,0,0,0,69000,143000,-74000,-74000
20200430,05619P,創意元富96售02,,,,,0.00,0.00,0,0,0,0,0,0,0,0,0,0,0,0,0
20200430,056200,大毅永豐98購01,1.26,1.53,1.24,1.36,+0.23,20.35,517000,50,719390,0,0,0,0,0,0,210000,311000,-101000,-101000
20200430,056201,華新科永豐98購01,,,,,0.00,0.00,0,0,0,0,0,0,0,0,0,0,0,0,0
20200430,056202,國揚永豐97購01,2.02,2.02,1.73,1.93,+0.04,2.12,977000,43,1847930,0,0,0,0,0,0,244000,733000,-489000,-489000
20200430,056203,興富發永豐97購01,1.82,1.87,1.82,1.87,+0.06,3.31,39000,2,71430,0,0,0,0,0,0,30000,9000,21000,21000
20200430,056204,嘉澤永豐97購01,,,,,0.00,0.00,0,0,0,0,0,0,0,0,0,0,0,0,0
20200430,056205,貿聯永豐97購01,0.49,0.54,0.49,0.54,+0.10,22.73,188000,7,97250,0,0,0,0,0,0,0,188000,-188000,-188000
20200430,056206,泰鼎永豐97購01,,,,,0.00,0.00,0,0,0,0,0,0,0,0,0,0,0,0,0
20200430,056207,茂林永豐97購03,,,,,0.00,0.00,0,0,0,0,0,0,0,0,0,0,0,0,0
20200430,056208,崇越永豐97購01,0.35,0.35,0.35,0.35,0.00,0.00,68000,1,23800,0,0,0,0,0,0,0,68000,-68000,-68000
20200430,056209,超眾永豐97購02,1.18,1.26,1.14,1.21,+0.08,7.08,257000,19,307680,0,0,0,0,0,0,103000,136000,-33000,-33000
20200430,05620P,大立光富邦9B售01,0.86,0.86,0.77,0.77,-0.17,-18.09,183000,7,141860,0,0,0,0,0,0,164000,5000,159000,159000
20200430,056210,矽創永豐97購02,,,,,0.00,0.00,0,0,0,0,0,0,0,0,0,0,0,0,0
20200430,056211,南港國票98購01,0.73,0.75,0.58,0.67,-0.10,-12.99,453000,23,307630,0,0,0,0,0,0,172000,281000,-109000,-109000
20200430,056212,台光電國票98購03,2.92,3.24,2.87,3.24,+0.43,15.3,197000,8,586250,0,0,0,0,0,0,8000,189000,-181000,-181000
20200430,056213,建準國票98購02,1.53,1.53,1.49,1.49,-0.19,-11.31,27000,4,40500,0,0,0,0,0,0,27000,0,27000,27000
20200430,056214,義隆國票99購01,2.55,2.83,2.51,2.83,+0.30,11.86,141000,10,368390,0,0,0,0,0,0,17000,124000,-107000,-107000
20200430,056215,華新科國票97購03,,,,,0.00,0.00,0,0,0,0,0,0,0,0,0,0,0,0,0
20200430,056216,智原第一97購01,,,,,0.00,0.00,0,0,0,0,0,0,0,0,0,0,0,0,0
20200430,056217,A50正2中信99購02,0.60,0.60,0.60,0.60,0.00,0.00,10000,2,6000,0,0,0,0,0,0,0,10000,-10000,-10000
20200430,056218,億光中信98購01,,,,,0.00,0.00,0,0,0,0,0,0,0,0,0,0,0,0,0
20200430,056219,T50反1日盛02購01,1.47,1.47,1.21,1.30,-0.22,-14.47,4000,4,5210,0,0,0,0,0,0,0,3000,-3000,-3000
20200430,05621P,聯電中信96售01,,,,,0.00,0.00,0,0,0,0,0,0,0,0,0,0,0,0,0
20200430,056220,上証2X凱基99購01,,,,,0.00,0.00,0,0,0,0,0,0,0,0,0,0,0,0,0
20200430,056221,鴻海凱基99購01,,,,,0.00,0.00,0,0,0,0,0,0,0,0,0,0,0,0,0
20200430,056222,台積電凱基9A購01,1.07,1.07,1.07,1.07,0.00,0.00,10000,1,10700,0,0,0,0,0,0,10000,0,10000,10000
20200430,056223,華邦電凱基97購04,0.80,0.84,0.80,0.84,+0.07,9.09,30000,3,24500,0,0,0,0,0,0,0,30000,-30000,-30000
20200430,056224,聯發科凱基97購08,3.27,3.27,3.27,3.27,0.00,0.00,7000,1,22890,0,0,0,0,0,0,0,7000,-7000,-7000
20200430,056225,聯發科凱基97購09,,,,,0.00,0.00,0,0,0,0,0,0,0,0,0,0,0,0,0
20200430,056226,聯發科凱基97購10,,,,,0.00,0.00,0,0,0,0,0,0,0,0,0,0,0,0,0
20200430,056227,奇力新凱基98購04,,,,,0.00,0.00,0,0,0,0,0,0,0,0,0,0,0,0,0
20200430,056228,可成凱基97購03,1.04,1.04,1.04,1.04,0.00,0.00,10000,1,10400,0,0,0,0,0,0,0,10000,-10000,-10000
20200430,056229,可成凱基97購04,,,,,0.00,0.00,0,0,0,0,0,0,0,0,0,0,0,0,0
20200430,05622P,台積電中信96售02,,,,,0.00,0.00,0,0,0,0,0,0,0,0,0,0,0,0,0
20200430,056230,可成凱基98購03,1.88,1.88,1.85,1.85,-0.13,-6.57,10000,2,18770,0,0,0,0,0,0,9000,1000,8000,8000
20200430,056231,嘉聯益凱基97購02,1.25,1.28,1.25,1.27,+0.04,3.25,130000,5,165200,0,0,0,0,0,0,80000,50000,30000,30000
20200430,056232,瑞儀凱基98購01,,,,,0.00,0.00,0,0,0,0,0,0,0,0,0,0,0,0,0
20200430,056233,超眾凱基97購02,3.60,3.60,3.60,3.60,+0.11,3.15,19000,1,68400,0,0,0,0,0,0,0,19000,-19000,-19000
20200430,056234,GIS麥證97購01,,,,,0.00,0.00,0,0,0,0,0,0,0,0,0,0,0,0,0
20200430,056235,鴻海群益97購07,0.03,0.03,0.03,0.03,0.00,0.00,128000,1,3840,0,0,0,0,0,0,128000,0,128000,128000
20200430,056236,台積電群益97購06,,,,,0.00,0.00,0,0,0,0,0,0,0,0,0,0,0,0,0
20200430,056237,智邦群益97購02,7.80,7.80,6.75,6.85,-0.35,-4.86,167000,22,1231100,0,0,0,0,0,0,166000,82000,84000,84000
20200430,056238,聯發科群益98購02,1.48,1.48,1.48,1.48,+0.41,38.32,10000,1,14800,0,0,0,0,0,0,10000,0,10000,10000
20200430,056239,宏達電群益98購01,1.04,1.04,1.04,1.04,-0.05,-4.59,98000,2,101920,0,0,0,0,0,0,0,98000,-98000,-98000
20200430,05623P,台積電中信96售03,,,,,0.00,0.00,0,0,0,0,0,0,0,0,0,0,0,0,0
20200430,056240,嘉晶群益97購02,0.53,0.55,0.51,0.51,0.00,0.00,70000,7,37100,0,0,0,0,0,0,30000,70000,-40000,-40000
20200430,056241,緯創群益97購01,2.19,2.27,2.19,2.26,+0.09,4.15,238000,10,527730,0,0,0,0,0,0,107000,131000,-24000,-24000
20200430,056242,緯創群益9A購01,0.60,0.60,0.60,0.60,0.00,0.00,20000,1,12000,0,0,0,0,0,0,20000,0,20000,20000
20200430,056243,創意群益97購03,1.14,2.18,1.14,1.26,0.00,0.00,868000,64,1032580,0,0,0,0,0,0,0,868000,-868000,-868000
20200430,056244,群創群益98購09,,,,,0.00,0.00,0,0,0,0,0,0,0,0,0,0,0,0,0
20200430,056245,嘉澤群益97購01,1.76,2.03,1.74,2.03,+0.31,18.02,370000,28,687460,0,0,0,0,0,0,270000,193000,77000,77000
20200430,056246,祥碩群益97購01,,,,,0.00,0.00,0,0,0,0,0,0,0,0,0,0,0,0,0
20200430,056247,台郡群益97購01,1.31,1.31,1.31,1.31,-0.03,-2.24,27000,4,35370,0,0,0,0,0,0,2000,25000,-23000,-23000
20200430,056248,康友群益97購04,,,,,0.00,0.00,0,0,0,0,0,0,0,0,0,0,0,0,0
20200430,056249,鴻海兆豐97購05,0.19,0.19,0.19,0.19,0.00,0.00,200000,2,38000,0,0,0,0,0,0,200000,0,200000,200000
20200430,05624P,同欣電中信98售01,0.69,0.69,0.61,0.61,-0.13,-17.57,35000,6,23100,0,0,0,0,0,0,25000,10000,15000,15000
20200430,056250,瑞昱兆豐97購02,1.17,1.27,1.14,1.26,+0.14,12.5,516000,25,615240,0,0,0,0,0,0,412000,104000,308000,308000
20200430,056251,聯發科兆豐97購02,0.85,0.85,0.85,0.85,+0.27,46.55,10000,1,8500,0,0,0,0,0,0,10000,0,10000,10000
20200430,056252,聯發科兆豐97購03,0.70,0.70,0.70,0.70,+0.12,20.69,34000,1,23800,0,0,0,0,0,0,34000,0,34000,34000
20200430,056253,京鼎兆豐98購01,,,,,0.00,0.00,0,0,0,0,0,0,0,0,0,0,0,0,0
20200430,056254,為升元富97購01,,,,,0.00,0.00,0,0,0,0,0,0,0,0,0,0,0,0,0
20200430,056255,華新科元富97購05,2.42,2.50,2.29,2.37,+0.06,2.6,236000,15,569620,0,0,0,0,0,0,110000,126000,-16000,-16000
20200430,056256,聯茂元富97購03,1.09,1.09,1.04,1.08,-0.01,-0.92,80000,14,85890,0,0,0,0,0,0,40000,40000,0,0
20200430,056257,聯茂元富97購04,,,,,0.00,0.00,0,0,0,0,0,0,0,0,0,0,0,0,0
20200430,056258,訊芯元富97購04,,,,,0.00,0.00,0,0,0,0,0,0,0,0,0,0,0,0,0
20200430,056259,T50反1統一9A購01,1.74,1.74,1.74,1.74,-0.11,-5.95,20000,2,34800,0,0,0,0,0,0,0,20000,-20000,-20000
20200430,05625P,國巨國票97售01,0.92,0.96,0.91,0.94,-0.09,-8.74,173000,10,160530,0,0,0,0,0,0,143000,30000,113000,113000
20200430,056260,鴻海統一98購07,,,,,0.00,0.00,0,0,0,0,0,0,0,0,0,0,0,0,0
20200430,056261,台積電統一97購07,,,,,0.00,0.00,0,0,0,0,0,0,0,0,0,0,0,0,0
20200430,056262,台積電統一98購04,0.48,0.52,0.47,0.52,0.00,0.00,250000,25,124800,0,0,0,0,0,0,250000,250000,0,0
20200430,056263,友訊統一99購01,1.11,1.11,1.11,1.11,0.00,0.00,22000,1,24420,0,0,0,0,0,0,0,22000,-22000,-22000
20200430,056264,聯發科統一98購02,4.19,4.45,4.19,4.45,0.00,0.00,87000,5,383610,0,0,0,0,0,0,0,87000,-87000,-87000
20200430,056265,國泰金統一97購01,0.73,0.78,0.73,0.78,+0.12,18.18,546000,22,405070,0,0,0,0,0,0,190000,356000,-166000,-166000
20200430,056266,開發金統一9A購01,1.54,1.56,1.51,1.56,+0.06,4.0,1069000,30,1643180,0,0,0,0,0,0,760000,539000,221000,221000
20200430,056267,文曄統一97購02,1.79,1.79,1.75,1.79,+0.03,1.7,377000,12,670940,0,0,0,0,0,0,259000,118000,141000,141000
20200430,056268,新日興統一97購01,,,,,0.00,0.00,0,0,0,0,0,0,0,0,0,0,0,0,0
20200430,056269,新日興統一98購01,,,,,0.00,0.00,0,0,0,0,0,0,0,0,0,0,0,0,0
20200430,05626P,景碩國票97售03,1.23,1.27,1.23,1.27,-0.22,-14.77,8000,2,10000,0,0,0,0,0,0,4000,4000,0,0
20200430,056270,群創統一98購04,,,,,0.00,0.00,0,0,0,0,0,0,0,0,0,0,0,0,0
20200430,056271,嘉澤統一97購01,2.38,2.69,2.35,2.69,+0.32,13.5,431000,31,1100910,0,0,0,0,0,0,29000,428000,-399000,-399000
20200430,056272,嘉澤統一99購01,1.41,1.51,1.41,1.51,0.00,0.00,20000,2,29200,0,0,0,0,0,0,20000,0,20000,20000
20200430,056273,祥碩統一97購02,,,,,0.00,0.00,0,0,0,0,0,0,0,0,0,0,0,0,0
20200430,056274,彩晶統一98購02,0.40,0.43,0.40,0.43,+0.02,4.88,69000,6,28930,0,0,0,0,0,0,12000,57000,-45000,-45000
20200430,056275,國巨國泰98購04,1.37,1.37,1.37,1.37,-0.01,-0.72,10000,1,13700,0,0,0,0,0,0,10000,0,10000,10000
20200430,056276,同欣電國泰98購01,,,,,0.00,0.00,0,0,0,0,0,0,0,0,0,0,0,0,0
20200430,056277,上銀富邦99購02,0.38,0.64,0.37,0.64,+0.30,88.24,213000,33,93780,0,0,0,0,0,0,172000,1000,171000,171000
20200430,056278,全新富邦98購02,,,,,0.00,0.00,0,0,0,0,0,0,0,0,0,0,0,0,0
20200430,056279,新日興富邦99購01,,,,,0.00,0.00,0,0,0,0,0,0,0,0,0,0,0,0,0
20200430,05627P,致伸國票97售01,2.99,3.15,2.99,3.10,0.00,0.00,97000,9,298260,0,0,0,0,0,0,73000,24000,49000,49000
20200430,056280,上証2X永豐98購01,2.01,2.15,2.01,2.05,+0.10,5.13,23000,3,47750,0,0,0,0,0,0,10000,13000,-3000,-3000
20200430,056281,深中小永豐97購01,0.90,1.03,0.90,1.03,+0.14,15.73,37000,5,36830,0,0,0,0,0,0,5000,32000,-27000,-27000
20200430,056282,S&P反1永豐97購01,,,,,0.00,0.00,0,0,0,0,0,0,0,0,0,0,0,0,0
20200430,056283,鴻海永豐97購03,0.12,0.12,0.12,0.12,+0.02,20.0,90000,3,10800,0,0,0,0,0,0,90000,0,90000,90000
20200430,056284,台積電永豐97購06,,,,,0.00,0.00,0,0,0,0,0,0,0,0,0,0,0,0,0
20200430,056285,可成永豐97購02,,,,,0.00,0.00,0,0,0,0,0,0,0,0,0,0,0,0,0
20200430,056286,奇鋐永豐97購01,1.54,1.64,1.54,1.64,+0.09,5.81,119000,13,187560,0,0,0,0,0,0,20000,99000,-79000,-79000
20200430,056287,亞光永豐97購02,1.05,1.12,1.04,1.12,+0.02,1.82,189000,12,207740,0,0,0,0,0,0,50000,155000,-105000,-105000
20200430,056288,健鼎永豐97購01,0.40,0.45,0.40,0.45,+0.04,9.76,469000,11,203140,0,0,0,0,0,0,34000,435000,-401000,-401000
20200430,056289,合勤控永豐97購01,0.64,0.64,0.57,0.57,-0.13,-18.57,88000,3,50230,0,0,0,0,0,0,88000,0,88000,88000
20200430,05628P,茂林國票97售02,,,,,0.00,0.00,0,0,0,0,0,0,0,0,0,0,0,0,0
20200430,056290,正文永豐98購01,,,,,0.00,0.00,0,0,0,0,0,0,0,0,0,0,0,0,0
20200430,056291,聯茂永豐97購03,0.79,0.79,0.75,0.78,-0.03,-3.7,102000,13,78430,0,0,0,0,0,0,72000,42000,30000,30000
20200430,056292,統一元大97購01,1.02,1.02,1.02,1.02,-0.01,-0.97,6000,1,6120,0,0,0,0,0,0,6000,0,6000,6000
20200430,056293,上銀元大97購10,0.55,0.55,0.55,0.55,0.00,0.00,14000,1,7700,0,0,0,0,0,0,14000,0,14000,14000
20200430,056294,上銀元大97購11,0.72,0.72,0.72,0.72,+0.20,38.46,2000,1,1440,0,0,0,0,0,0,2000,0,2000,2000
20200430,056295,國巨元大97購16,3.47,3.54,3.42,3.42,+0.05,1.48,3000,3,10430,0,0,0,0,0,0,3000,2000,1000,1000
20200430,056296,旺宏元大97購07,1.73,1.73,1.65,1.67,+0.22,15.17,335000,16,560600,0,0,0,0,0,0,167000,177000,-10000,-10000
20200430,056297,台光電元大97購04,1.36,1.54,1.36,1.54,+0.19,14.07,252000,17,365940,0,0,0,0,0,0,73000,252000,-179000,-179000
20200430,056298,億光元大97購02,1.44,1.44,1.39,1.39,-0.04,-2.8,120000,2,167800,0,0,0,0,0,0,20000,100000,-80000,-80000
20200430,056299,友達元大9B購04,,,,,0.00,0.00,0,0,0,0,0,0,0,0,0,0,0,0,0
20200430,05629P,聯發科永昌99售02,2.89,2.89,2.64,2.64,-0.76,-22.35,15000,3,40350,0,0,0,0,0,0,10000,5000,5000,5000
20200430,056300,聯發科元大97購23,1.63,1.63,1.63,1.63,+0.34,26.36,3000,1,4890,0,0,0,0,0,0,3000,0,3000,3000
20200430,056301,開發金元大9A購01,0.45,0.45,0.45,0.45,0.00,0.00,5000,1,2250,0,0,0,0,0,0,5000,0,5000,5000
20200430,056302,大立光元大97購17,,,,,0.00,0.00,0,0,0,0,0,0,0,0,0,0,0,0,0
20200430,056303,亞光元大97購04,,,,,0.00,0.00,0,0,0,0,0,0,0,0,0,0,0,0,0
20200430,056304,創意元大97購03,1.00,1.06,1.00,1.06,+0.13,13.98,135000,7,139640,0,0,0,0,0,0,3000,133000,-130000,-130000
20200430,056305,群創元大9A購03,,,,,0.00,0.00,0,0,0,0,0,0,0,0,0,0,0,0,0
20200430,056306,晶相光元大98購01,,,,,0.00,0.00,0,0,0,0,0,0,0,0,0,0,0,0,0
20200430,056307,貿聯元大97購05,1.07,1.30,1.07,1.30,+0.31,31.31,65000,3,72710,0,0,0,0,0,0,0,65000,-65000,-65000
20200430,056308,TPK元大97購02,1.14,1.14,1.02,1.02,-0.16,-13.56,103000,5,114120,0,0,0,0,0,0,35000,68000,-33000,-33000
20200430,056309,合勤控元大97購01,1.48,1.57,1.37,1.41,+0.04,2.92,145000,10,210320,0,0,0,0,0,0,145000,0,145000,145000
20200430,05630P,大立光永昌96售06,,,,,0.00,0.00,0,0,0,0,0,0,0,0,0,0,0,0,0
20200430,056310,神達元大97購02,,,,,0.00,0.00,0,0,0,0,0,0,0,0,0,0,0,0,0
20200430,056311,泰鼎元大98購01,,,,,0.00,0.00,0,0,0,0,0,0,0,0,0,0,0,0,0
20200430,056312,茂林元大98購01,,,,,0.00,0.00,0,0,0,0,0,0,0,0,0,0,0,0,0
20200430,056313,聯茂元大98購01,1.36,1.36,1.34,1.34,0.00,0.00,40000,4,53800,0,0,0,0,0,0,0,40000,-40000,-40000
20200430,056314,力成元大97購01,1.68,1.82,1.61,1.82,+0.24,15.19,546000,29,906060,0,0,0,0,0,0,425000,111000,314000,314000
20200430,056315,同欣電元大97購05,0.15,0.15,0.15,0.15,0.00,0.00,12000,1,1800,0,0,0,0,0,0,12000,0,12000,12000
20200430,056316,訊芯元大98購03,0.28,0.28,0.28,0.28,0.00,0.00,100000,1,28000,0,0,0,0,0,0,100000,0,100000,100000
20200430,056317,華通群益99購02,,,,,0.00,0.00,0,0,0,0,0,0,0,0,0,0,0,0,0
20200430,056318,鴻海群益98購02,0.47,0.48,0.47,0.48,0.00,0.00,30000,2,14200,0,0,0,0,0,0,20000,10000,10000,10000
20200430,056319,智原群益98購02,0.44,0.45,0.44,0.45,+0.02,4.65,64000,2,28480,0,0,0,0,0,0,0,64000,-64000,-64000
20200430,05631P,國巨富邦9A售01,0.54,0.54,0.54,0.54,0.00,0.00,11000,2,5940,0,0,0,0,0,0,11000,0,11000,11000
20200430,056320,京鼎群益99購01,1.01,1.22,1.00,1.12,+0.18,19.15,421000,18,437460,0,0,0,0,0,0,104000,319000,-215000,-215000
20200430,056321,創意群益98購02,1.96,2.03,1.96,1.99,+0.04,2.05,317000,12,629910,0,0,0,0,0,0,90000,227000,-137000,-137000
20200430,056322,臺股指群益98購01,0.10,0.10,0.10,0.10,0.00,0.00,7000,2,700,0,0,0,0,0,0,7000,0,7000,7000
20200430,056323,旺宏兆豐98購01,0.70,0.75,0.70,0.75,+0.04,5.63,669000,5,469600,0,0,0,0,0,0,668000,1000,667000,667000
20200430,056324,南亞科兆豐98購01,0.48,0.48,0.48,0.48,+0.02,4.35,20000,1,9600,0,0,0,0,0,0,20000,0,20000,20000
20200430,056325,群創兆豐9A購01,0.06,0.06,0.06,0.06,+0.01,20.0,383000,38,22980,0,0,0,0,0,0,0,383000,-383000,-383000
20200430,056326,TPK兆豐98購01,0.43,0.43,0.38,0.39,-0.07,-15.22,267000,6,107770,0,0,0,0,0,0,267000,0,267000,267000
20200430,056327,樺漢兆豐98購01,,,,,0.00,0.00,0,0,0,0,0,0,0,0,0,0,0,0,0
20200430,056328,訊芯兆豐98購01,0.26,0.26,0.26,0.26,0.00,0.00,20000,2,5200,0,0,0,0,0,0,0,20000,-20000,-20000
20200430,056329,上銀國票98購02,0.17,0.31,0.17,0.28,+0.16,133.33,170000,7,40600,0,0,0,0,0,0,170000,0,170000,170000
20200430,05632P,大立光群益96售02,,,,,0.00,0.00,0,0,0,0,0,0,0,0,0,0,0,0,0
20200430,056330,玉晶光國票99購03,1.28,1.40,1.28,1.40,+0.14,11.11,38000,9,51440,0,0,0,0,0,0,27000,18000,9000,9000
20200430,056331,聯鈞國票99購01,,,,,0.00,0.00,0,0,0,0,0,0,0,0,0,0,0,0,0
20200430,056332,台郡國票99購01,2.97,2.97,2.94,2.94,-0.02,-0.68,16000,2,47280,0,0,0,0,0,0,8000,8000,0,0
20200430,056333,台積電日盛9B購01,0.89,0.89,0.89,0.89,+0.18,25.35,2000,1,1780,0,0,0,0,0,0,2000,0,2000,2000
20200430,056334,台積電凱基98購06,,,,,0.00,0.00,0,0,0,0,0,0,0,0,0,0,0,0,0
20200430,056335,微星凱基98購01,0.73,0.74,0.73,0.73,0.00,0.00,55000,5,40250,0,0,0,0,0,0,0,55000,-55000,-55000
20200430,056336,南亞科凱基98購02,0.26,0.26,0.26,0.26,0.00,0.00,1000,1,260,0,0,0,0,0,0,1000,0,1000,1000
20200430,056337,聯發科凱基98購06,4.08,4.08,4.07,4.07,+0.38,10.3,36000,3,146760,0,0,0,0,0,0,36000,0,36000,36000
20200430,056338,聯發科凱基99購01,2.01,2.32,2.01,2.31,+0.83,56.08,22000,5,50170,0,0,0,0,0,0,22000,0,22000,22000
20200430,056339,聯發科凱基99購02,,,,,0.00,0.00,0,0,0,0,0,0,0,0,0,0,0,0,0
20200430,05633P,台表科群益96售04,,,,,0.00,0.00,0,0,0,0,0,0,0,0,0,0,0,0,0
20200430,056340,可成凱基98購04,,,,,0.00,0.00,0,0,0,0,0,0,0,0,0,0,0,0,0
20200430,056341,宏達電凱基9A購01,,,,,0.00,0.00,0,0,0,0,0,0,0,0,0,0,0,0,0
20200430,056342,中工凱基98購01,0.50,0.51,0.50,0.51,0.00,0.00,20000,2,10100,0,0,0,0,0,0,10000,10000,0,0
20200430,056343,高鐵凱基98購02,0.69,0.69,0.68,0.68,+0.03,4.62,91000,11,62600,0,0,0,0,0,0,34000,57000,-23000,-23000
20200430,056344,嘉晶凱基98購02,,,,,0.00,0.00,0,0,0,0,0,0,0,0,0,0,0,0,0
20200430,056345,嘉聯益凱基99購01,,,,,0.00,0.00,0,0,0,0,0,0,0,0,0,0,0,0,0
20200430,056346,聯茂凱基99購02,0.66,0.66,0.66,0.66,0.00,0.00,8000,1,5280,0,0,0,0,0,0,8000,0,8000,8000
20200430,056347,GIS凱基9A購01,,,,,0.00,0.00,0,0,0,0,0,0,0,0,0,0,0,0,0
20200430,056348,S&P反1元大9A購01,,,,,0.00,0.00,0,0,0,0,0,0,0,0,0,0,0,0,0
20200430,056349,道瓊銀元大9B購01,,,,,0.00,0.00,0,0,0,0,0,0,0,0,0,0,0,0,0
20200430,05634P,玉晶光台新97售01,0.45,0.54,0.45,0.47,-0.17,-26.56,139000,17,72070,0,0,0,0,0,0,0,117000,-117000,-117000
20200430,056350,上銀元大98購02,0.43,0.43,0.40,0.40,+0.14,53.85,41000,3,16430,0,0,0,0,0,0,38000,1000,37000,37000
20200430,056351,鴻海元大98購06,1.11,1.13,1.08,1.13,+0.06,5.61,543000,12,600580,0,0,0,0,0,0,200000,343000,-143000,-143000
20200430,056352,鴻海元大99購01,1.56,1.60,1.52,1.60,+0.06,3.9,248000,9,385880,0,0,0,0,0,0,0,248000,-248000,-248000
20200430,056353,鴻海元大99購02,,,,,0.00,0.00,0,0,0,0,0,0,0,0,0,0,0,0,0
20200430,056354,國巨元大98購10,4.13,4.24,4.03,4.03,0.00,0.00,4000,4,16550,0,0,0,0,0,0,4000,4000,0,0
20200430,056355,台積電元大98購08,0.84,0.84,0.84,0.84,0.00,0.00,40000,1,33600,0,0,0,0,0,0,40000,40000,0,0
20200430,056356,台積電元大99購01,,,,,0.00,0.00,0,0,0,0,0,0,0,0,0,0,0,0,0
20200430,056357,台積電元大9A購01,0.88,0.95,0.88,0.92,+0.14,17.95,86000,3,76070,0,0,0,0,0,0,80000,0,80000,80000
20200430,056358,友訊元大99購01,1.60,1.71,1.56,1.56,-0.10,-6.02,196000,8,318890,0,0,0,0,0,0,60000,136000,-76000,-76000
20200430,056359,旺宏元大9A購01,0.83,0.83,0.83,0.83,+0.13,18.57,7000,2,5810,0,0,0,0,0,0,1000,0,1000,1000
20200430,05635P,健策台新96售02,0.10,0.10,0.10,0.10,-0.35,-77.78,10000,1,1000,0,0,0,0,0,0,0,10000,-10000,-10000
20200430,056360,智邦元大98購01,6.95,7.20,6.90,7.00,+0.35,5.26,44000,8,309750,0,0,0,0,0,0,44000,5000,39000,39000
20200430,056361,美律元大99購02,,,,,0.00,0.00,0,0,0,0,0,0,0,0,0,0,0,0,0
20200430,056362,聯發科元大99購01,1.43,1.55,1.43,1.55,+0.30,24.0,129000,14,191320,0,0,0,0,0,0,88000,0,88000,88000
20200430,056363,華新科元大99購04,,,,,0.00,0.00,0,0,0,0,0,0,0,0,0,0,0,0,0
20200430,056364,亞光元大99購02,0.72,0.75,0.71,0.74,+0.06,8.82,223000,12,161360,0,0,0,0,0,0,161000,60000,101000,101000
20200430,056365,欣興元大98購01,3.64,3.77,3.48,3.61,+0.25,7.44,195000,37,703220,0,0,0,0,0,0,188000,130000,58000,58000
20200430,056366,玉晶光元大99購04,2.35,2.66,2.35,2.66,+0.34,14.66,147000,30,361180,0,0,0,0,0,0,99000,72000,27000,27000
20200430,056367,祥碩元大98購01,3.23,3.23,3.23,3.23,+0.07,2.22,5000,1,16150,0,0,0,0,0,0,5000,5000,0,0
20200430,056368,祥碩元大98購02,3.03,3.03,2.26,2.26,-0.45,-16.61,72000,22,184650,0,0,0,0,0,0,21000,51000,-30000,-30000
20200430,056369,彩晶元大01購01,,,,,0.00,0.00,0,0,0,0,0,0,0,0,0,0,0,0,0
20200430,05636P,國巨永豐96售03,,,,,0.00,0.00,0,0,0,0,0,0,0,0,0,0,0,0,0
20200430,056370,台郡元大98購03,,,,,0.00,0.00,0,0,0,0,0,0,0,0,0,0,0,0,0
20200430,056371,樺漢元大98購03,,,,,0.00,0.00,0,0,0,0,0,0,0,0,0,0,0,0,0
20200430,056372,訊芯元大98購04,0.39,0.39,0.39,0.39,+0.01,2.63,68000,4,26520,0,0,0,0,0,0,68000,0,68000,68000
20200430,056373,上銀統一99購02,,,,,0.00,0.00,0,0,0,0,0,0,0,0,0,0,0,0,0
20200430,056374,聯發科統一9B購01,1.42,1.59,1.42,1.59,+0.39,32.5,40000,4,59900,0,0,0,0,0,0,40000,0,40000,40000
20200430,056375,玉晶光統一01購01,0.51,0.56,0.51,0.56,0.00,0.00,85000,5,46300,0,0,0,0,0,0,65000,0,65000,65000
20200430,056376,玉晶光統一98購01,0.42,0.42,0.42,0.42,+0.04,10.53,1000,1,420,0,0,0,0,0,0,1000,0,1000,1000
20200430,056377,智伸科統一9A購01,0.12,0.13,0.12,0.13,0.00,0.00,10000,2,1250,0,0,0,0,0,0,10000,0,10000,10000
20200430,056378,欣興元富98購01,3.23,3.31,3.09,3.16,+0.13,4.29,319000,13,1012360,0,0,0,0,0,0,229000,40000,189000,189000
20200430,056379,玉晶光元富98購01,2.00,2.16,2.00,2.16,+0.25,13.09,52000,7,106180,0,0,0,0,0,0,23000,29000,-6000,-6000
20200430,05637P,聯電元大96售04,0.72,0.75,0.72,0.75,-0.04,-5.06,65000,3,46830,0,0,0,0,0,0,64000,1000,63000,63000
20200430,056380,麗豐元富98購01,0.63,0.67,0.63,0.63,+0.06,10.53,368000,16,241460,0,0,0,0,0,0,101000,267000,-166000,-166000
20200430,056381,台虹元富98購01,,,,,0.00,0.00,0,0,0,0,0,0,0,0,0,0,0,0,0
20200430,056382,道瓊反國泰9A購01,0.97,0.97,0.97,0.97,0.00,0.00,26000,1,25220,0,0,0,0,0,0,26000,0,26000,26000
20200430,056383,上銀國泰99購01,2.64,3.54,2.57,3.50,+1.12,47.06,459000,43,1367600,0,0,0,0,0,0,267000,196000,71000,71000
20200430,056384,玉晶光國泰9A購02,,,,,0.00,0.00,0,0,0,0,0,0,0,0,0,0,0,0,0
20200430,056385,創意國泰99購01,0.98,1.00,0.98,1.00,0.00,0.00,7000,2,6900,0,0,0,0,0,0,7000,0,7000,7000
20200430,056386,TPK國泰99購01,0.60,0.60,0.58,0.58,-0.13,-18.31,50000,3,29800,0,0,0,0,0,0,40000,50000,-10000,-10000
20200430,056387,智伸科國泰99購01,0.31,0.31,0.30,0.30,0.00,0.00,26000,4,7960,0,0,0,0,0,0,0,26000,-26000,-26000
20200430,056388,勤誠國泰99購01,,,,,0.00,0.00,0,0,0,0,0,0,0,0,0,0,0,0,0
20200430,056389,鴻海富邦99購01,,,,,0.00,0.00,0,0,0,0,0,0,0,0,0,0,0,0,0
20200430,05638P,國巨統一96售04,,,,,0.00,0.00,0,0,0,0,0,0,0,0,0,0,0,0,0
20200430,056390,台積電富邦9B購01,0.38,0.39,0.37,0.39,+0.06,18.18,110000,10,41820,0,0,0,0,0,0,52000,70000,-18000,-18000
20200430,056391,大立光富邦9C購01,0.23,0.26,0.23,0.24,+0.03,14.29,257000,22,61060,0,0,0,0,0,0,0,67000,-67000,-67000
20200430,056392,玉晶光富邦9C購01,0.32,0.35,0.32,0.35,0.00,0.00,27000,3,9300,0,0,0,0,0,0,27000,0,27000,27000
20200430,056393,精元永豐98購01,,,,,0.00,0.00,0,0,0,0,0,0,0,0,0,0,0,0,0
20200430,056394,晶豪科永豐98購01,2.01,2.11,1.89,1.89,+0.07,3.85,97000,24,195590,0,0,0,0,0,0,63000,34000,29000,29000
20200430,056395,玉晶光永豐9B購01,0.91,0.99,0.90,0.99,+0.17,20.73,191000,9,175660,0,0,0,0,0,0,100000,91000,9000,9000
20200430,056396,祥碩永豐98購01,0.66,0.67,0.41,0.45,-0.13,-22.41,260000,28,134240,0,0,0,0,0,0,88000,172000,-84000,-84000
20200430,056397,彩晶永豐99購01,0.77,0.82,0.77,0.82,+0.03,3.8,357000,9,285330,0,0,0,0,0,0,125000,232000,-107000,-107000
20200430,056398,南茂永豐98購01,0.92,0.97,0.90,0.97,+0.08,8.99,377000,27,354260,0,0,0,0,0,0,166000,200000,-34000,-34000
20200430,056399,上証2X群益9C購01,,,,,0.00,0.00,0,0,0,0,0,0,0,0,0,0,0,0,0
20200430,05639P,欣興統一97售01,1.41,1.46,1.40,1.46,0.00,0.00,30000,5,42960,0,0,0,0,0,0,0,30000,-30000,-30000
20200430,056400,道瓊反群益9C購01,,,,,0.00,0.00,0,0,0,0,0,0,0,0,0,0,0,0,0
20200430,056401,國巨群益98購07,2.04,2.04,1.89,1.89,0.00,0.00,60000,3,118800,0,0,0,0,0,0,0,60000,-60000,-60000
20200430,056402,智易群益98購02,,,,,0.00,0.00,0,0,0,0,0,0,0,0,0,0,0,0,0
20200430,056403,茂林群益98購01,1.77,1.77,1.71,1.71,-0.12,-6.56,8000,2,13800,0,0,0,0,0,0,2000,6000,-4000,-4000
20200430,056404,嘉聯益群益9A購01,1.44,1.51,1.44,1.51,+0.07,4.86,313000,10,461390,0,0,0,0,0,0,123000,230000,-107000,-107000
20200430,056405,聯茂群益98購01,6.40,6.40,6.30,6.30,-0.35,-5.26,5000,2,31900,0,0,0,0,0,0,5000,1000,4000,4000
20200430,056406,建準國票99購01,,,,,0.00,0.00,0,0,0,0,0,0,0,0,0,0,0,0,0
20200430,056407,嘉晶國票99購01,2.67,2.92,2.67,2.92,+0.26,9.77,125000,5,347700,0,0,0,0,0,0,38000,87000,-49000,-49000
20200430,056408,奇鋐國票99購01,3.78,3.93,3.60,3.93,+0.30,8.26,153000,10,574530,0,0,0,0,0,0,48000,105000,-57000,-57000
20200430,056409,麗豐國票99購01,1.13,1.15,1.08,1.08,0.00,0.00,74000,4,84730,0,0,0,0,0,0,5000,69000,-64000,-64000
20200430,05640P,旺宏元富96售03,,,,,0.00,0.00,0,0,0,0,0,0,0,0,0,0,0,0,0
20200430,056410,康控國票99購01,2.37,2.55,2.37,2.55,+0.59,30.1,409000,13,1006130,0,0,0,0,0,0,226000,183000,43000,43000
20200430,056411,緯穎國票99購01,,,,,0.00,0.00,0,0,0,0,0,0,0,0,0,0,0,0,0
20200430,056412,上証2X中信9A購02,1.22,1.22,1.22,1.22,+0.08,7.02,10000,1,12200,0,0,0,0,0,0,10000,0,10000,10000
20200430,056413,上証反中信9A購01,0.37,0.37,0.37,0.37,0.00,0.00,300000,3,111000,0,0,0,0,0,0,0,300000,-300000,-300000
20200430,056414,國巨中信98購02,0.55,0.55,0.51,0.51,+0.04,8.51,8000,4,4200,0,0,0,0,0,0,0,0,0,0
20200430,056415,聯發科中信98購04,0.94,0.99,0.91,0.99,+0.17,20.73,211000,13,199290,0,0,0,0,0,0,73000,138000,-65000,-65000
20200430,056416,華新科中信98購01,0.54,0.54,0.50,0.50,+0.02,4.17,12000,3,6050,0,0,0,0,0,0,0,12000,-12000,-12000
20200430,056417,欣興中信98購01,0.55,0.60,0.54,0.54,+0.01,1.89,54000,9,31110,0,0,0,0,0,0,49000,5000,44000,44000
20200430,056418,台光電元富98購01,1.57,1.77,1.54,1.77,+0.24,15.69,989000,35,1600870,0,0,0,0,0,0,251000,753000,-502000,-502000
20200430,056419,欣興元富98購02,3.32,3.60,3.28,3.34,+0.11,3.41,725000,58,2468760,0,0,0,0,0,0,574000,89000,485000,485000
20200430,05641P,貿聯元富96售02,1.51,1.51,1.51,1.51,0.00,0.00,40000,4,60400,0,0,0,0,0,0,0,40000,-40000,-40000
20200430,056420,台表科元富98購01,,,,,0.00,0.00,0,0,0,0,0,0,0,0,0,0,0,0,0
20200430,056421,鴻海統一98購08,,,,,0.00,0.00,0,0,0,0,0,0,0,0,0,0,0,0,0
20200430,056422,全新統一98購02,0.93,0.93,0.89,0.89,-0.09,-9.18,207000,4,186530,0,0,0,0,0,0,148000,59000,89000,89000
20200430,056423,奇鋐統一98購01,1.90,2.03,1.90,2.03,+0.13,6.84,29000,3,56940,0,0,0,0,0,0,0,29000,-29000,-29000
20200430,056424,泰碩統一98購01,,,,,0.00,0.00,0,0,0,0,0,0,0,0,0,0,0,0,0
20200430,056425,聯發科日盛9A購01,,,,,0.00,0.00,0,0,0,0,0,0,0,0,0,0,0,0,0
20200430,056426,上証2X凱基9A購01,2.50,2.59,2.50,2.53,+0.10,4.12,29000,4,74650,0,0,0,0,0,0,14000,15000,-1000,-1000
20200430,056427,上銀凱基98購03,2.00,2.00,2.00,2.00,0.00,0.00,15000,1,30000,0,0,0,0,0,0,15000,0,15000,15000
20200430,056428,台達電凱基99購01,1.16,1.30,1.16,1.30,+0.27,26.21,43000,5,53530,0,0,0,0,0,0,3000,0,3000,3000
20200430,056429,華通凱基98購02,,,,,0.00,0.00,0,0,0,0,0,0,0,0,0,0,0,0,0
20200430,05642P,玉晶光兆豐97售02,0.43,0.43,0.41,0.41,-0.02,-4.65,21000,4,8780,0,0,0,0,0,0,0,21000,-21000,-21000
20200430,056430,鴻海凱基98購06,1.21,1.26,1.21,1.26,+0.07,5.88,52000,6,63820,0,0,0,0,0,0,22000,52000,-30000,-30000
20200430,056431,鴻海凱基98購07,,,,,0.00,0.00,0,0,0,0,0,0,0,0,0,0,0,0,0
20200430,056432,鴻海凱基98購08,0.69,0.74,0.69,0.74,0.00,0.00,3000,2,2170,0,0,0,0,0,0,3000,0,3000,3000
20200430,056433,鴻海凱基98購09,1.23,1.23,1.23,1.23,+0.01,0.82,10000,1,12300,0,0,0,0,0,0,10000,0,10000,10000
20200430,056434,國巨凱基98購03,3.43,3.56,3.35,3.48,+0.12,3.57,142000,23,494680,0,0,0,0,0,0,77000,108000,-31000,-31000
20200430,056435,台積電凱基98購09,,,,,0.00,0.00,0,0,0,0,0,0,0,0,0,0,0,0,0
20200430,056436,台積電凱基98購10,,,,,0.00,0.00,0,0,0,0,0,0,0,0,0,0,0,0,0
20200430,056437,台積電凱基98購11,1.56,1.56,1.54,1.54,+0.07,4.76,14000,2,21720,0,0,0,0,0,0,0,14000,-14000,-14000
20200430,056438,旺宏凱基98購05,2.40,2.40,2.32,2.32,+0.21,9.95,5000,4,11860,0,0,0,0,0,0,4000,1000,3000,3000
20200430,056439,華邦電凱基98購02,,,,,0.00,0.00,0,0,0,0,0,0,0,0,0,0,0,0,0
20200430,05643P,大立光中信98售01,,,,,0.00,0.00,0,0,0,0,0,0,0,0,0,0,0,0,0
20200430,056440,智邦凱基98購03,,,,,0.00,0.00,0,0,0,0,0,0,0,0,0,0,0,0,0
20200430,056441,燿華凱基98購01,0.86,0.94,0.86,0.91,+0.03,3.41,198000,10,176890,0,0,0,0,0,0,168000,30000,138000,138000
20200430,056442,瑞昱凱基98購02,1.23,1.36,1.20,1.36,+0.21,18.26,57000,15,71510,0,0,0,0,0,0,37000,30000,7000,7000
20200430,056443,南亞科凱基98購03,,,,,0.00,0.00,0,0,0,0,0,0,0,0,0,0,0,0,0
20200430,056444,南亞科凱基99購01,,,,,0.00,0.00,0,0,0,0,0,0,0,0,0,0,0,0,0
20200430,056445,聯發科凱基98購07,2.85,2.85,2.85,2.85,0.00,0.00,2000,1,5700,0,0,0,0,0,0,0,2000,-2000,-2000
20200430,056446,聯發科凱基98購08,,,,,0.00,0.00,0,0,0,0,0,0,0,0,0,0,0,0,0
20200430,056447,聯發科凱基98購09,1.88,1.88,1.88,1.88,+0.63,50.4,40000,1,75200,0,0,0,0,0,0,40000,0,40000,40000
20200430,056448,全新凱基99購01,,,,,0.00,0.00,0,0,0,0,0,0,0,0,0,0,0,0,0
20200430,056449,義隆凱基98購03,2.32,2.52,2.32,2.42,+0.12,5.22,235000,20,564440,0,0,0,0,0,0,57000,203000,-146000,-146000
20200430,05644P,大立光中信9A售03,0.51,0.51,0.45,0.45,-0.11,-19.64,718000,25,335840,0,0,0,0,0,0,209000,509000,-300000,-300000
20200430,056450,可成凱基98購05,,,,,0.00,0.00,0,0,0,0,0,0,0,0,0,0,0,0,0
20200430,056451,可成凱基99購01,1.97,1.97,1.88,1.88,-0.17,-8.29,20000,2,38500,0,0,0,0,0,0,10000,10000,0,0
20200430,056452,亞光凱基98購02,0.86,0.88,0.86,0.88,0.00,0.00,55000,2,48300,0,0,0,0,0,0,0,55000,-55000,-55000
20200430,056453,禾伸堂凱基99購02,,,,,0.00,0.00,0,0,0,0,0,0,0,0,0,0,0,0,0
20200430,056454,欣興凱基98購02,4.27,4.51,4.27,4.51,+0.74,19.63,22000,3,94720,0,0,0,0,0,0,22000,0,22000,22000
20200430,056455,群創凱基9A購01,,,,,0.00,0.00,0,0,0,0,0,0,0,0,0,0,0,0,0
20200430,056456,群創凱基9B購01,,,,,0.00,0.00,0,0,0,0,0,0,0,0,0,0,0,0,0
20200430,056457,嘉澤凱基98購01,1.43,1.65,1.43,1.65,+0.30,22.22,34000,4,50420,0,0,0,0,0,0,24000,0,24000,24000
20200430,056458,日月光凱基98購02,1.78,1.86,1.78,1.86,+0.15,8.77,124000,15,226310,0,0,0,0,0,0,20000,104000,-84000,-84000
20200430,056459,茂林凱基99購01,1.17,1.17,1.14,1.14,-0.08,-6.56,58000,2,67710,0,0,0,0,0,0,53000,5000,48000,48000
20200430,05645P,聯發科凱基96售13,,,,,0.00,0.00,0,0,0,0,0,0,0,0,0,0,0,0,0
20200430,056460,同欣電凱基99購01,0.31,0.33,0.30,0.33,0.00,0.00,12000,6,3760,0,0,0,0,0,0,0,12000,-12000,-12000
20200430,056461,樺漢凱基98購02,,,,,0.00,0.00,0,0,0,0,0,0,0,0,0,0,0,0,0
20200430,056462,訊芯凱基98購03,0.92,1.00,0.92,0.99,+0.08,8.79,168000,11,162920,0,0,0,0,0,0,35000,133000,-98000,-98000
20200430,056463,台虹凱基98購02,1.18,1.19,1.15,1.15,0.00,0.00,62000,9,72600,0,0,0,0,0,0,53000,9000,44000,44000
20200430,056464,臺股指凱基99購06,0.28,0.28,0.28,0.28,+0.11,64.71,15000,2,4200,0,0,0,0,0,0,0,0,0,0
20200430,056465,臺股指凱基99購07,0.35,0.35,0.35,0.35,+0.10,40.0,10000,1,3500,0,0,0,0,0,0,10000,0,10000,10000
20200430,056466,臺股指凱基99購08,0.25,0.25,0.25,0.25,+0.05,25.0,100000,1,25000,0,0,0,0,0,0,100000,0,100000,100000
20200430,056467,上証2X元大98購02,,,,,0.00,0.00,0,0,0,0,0,0,0,0,0,0,0,0,0
20200430,056468,鴻海元大98購07,0.81,0.81,0.81,0.81,0.00,0.00,20000,1,16200,0,0,0,0,0,0,20000,0,20000,20000
20200430,056469,國巨元大99購01,2.46,2.48,2.46,2.48,+0.09,3.77,17000,3,42140,0,0,0,0,0,0,17000,1000,16000,16000
20200430,05646P,聯發科國票96售05,1.62,1.65,1.49,1.49,-0.43,-22.4,26000,14,40800,0,0,0,0,0,0,13000,13000,0,0
20200430,056470,旺宏元大99購01,1.70,1.70,1.67,1.67,+0.28,20.14,2000,2,3370,0,0,0,0,0,0,2000,1000,1000,1000
20200430,056471,台光電元大99購01,3.59,4.02,3.59,4.02,+0.59,17.2,28000,4,108060,0,0,0,0,0,0,0,28000,-28000,-28000
20200430,056472,美律元大99購03,,,,,0.00,0.00,0,0,0,0,0,0,0,0,0,0,0,0,0
20200430,056473,奇力新元大99購02,1.18,1.27,1.18,1.25,+0.12,10.62,124000,6,146730,0,0,0,0,0,0,12000,112000,-100000,-100000
20200430,056474,華新科元大99購05,,,,,0.00,0.00,0,0,0,0,0,0,0,0,0,0,0,0,0
20200430,056475,宏達電元大99購02,,,,,0.00,0.00,0,0,0,0,0,0,0,0,0,0,0,0,0
20200430,056476,智原元大98購02,,,,,0.00,0.00,0,0,0,0,0,0,0,0,0,0,0,0,0
20200430,056477,欣興元大98購02,2.92,3.02,2.82,2.88,+0.12,4.35,201000,27,585760,0,0,0,0,0,0,181000,22000,159000,159000
20200430,056478,晶技元大99購01,4.48,4.61,4.48,4.60,+0.18,4.07,20000,4,91360,0,0,0,0,0,0,0,20000,-20000,-20000
20200430,056479,玉晶光元大99購05,2.36,2.68,2.34,2.68,+0.44,19.64,146000,18,366380,0,0,0,0,0,0,113000,41000,72000,72000
20200430,05647P,聯發科國票97售02,3.93,3.95,3.65,3.65,-0.99,-21.34,29000,11,110430,0,0,0,0,0,0,19000,10000,9000,9000
20200430,056480,京鼎元大98購02,1.38,1.60,1.35,1.45,+0.14,10.69,739000,31,1065700,0,0,0,0,0,0,73000,671000,-598000,-598000
20200430,056481,創意元大98購01,1.80,1.93,1.80,1.93,+0.10,5.46,62000,5,115260,0,0,0,0,0,0,16000,46000,-30000,-30000
20200430,056482,貿聯元大99購01,,,,,0.00,0.00,0,0,0,0,0,0,0,0,0,0,0,0,0
20200430,056483,TPK元大98購01,,,,,0.00,0.00,0,0,0,0,0,0,0,0,0,0,0,0,0
20200430,056484,聯茂元大98購02,4.39,4.39,4.23,4.23,-0.37,-8.04,50000,3,213100,0,0,0,0,0,0,50000,0,50000,50000
20200430,056485,同欣電元大98購01,0.34,0.37,0.31,0.31,0.00,0.00,31000,4,11010,0,0,0,0,0,0,1000,20000,-19000,-19000
20200430,056486,樺漢元大98購04,1.99,2.15,1.99,2.15,+0.11,5.39,255000,19,525690,0,0,0,0,0,0,150000,105000,45000,45000
20200430,056487,康友元大98購01,,,,,0.00,0.00,0,0,0,0,0,0,0,0,0,0,0,0,0
20200430,056488,致新元大99購01,1.90,1.99,1.82,1.99,+0.18,9.94,408000,40,771420,0,0,0,0,0,0,248000,164000,84000,84000
20200430,056489,S&P反1國泰9A購01,,,,,0.00,0.00,0,0,0,0,0,0,0,0,0,0,0,0,0
20200430,05648P,康控國票97售01,,,,,0.00,0.00,0,0,0,0,0,0,0,0,0,0,0,0,0
20200430,056490,台積電國泰99購01,,,,,0.00,0.00,0,0,0,0,0,0,0,0,0,0,0,0,0
20200430,056491,南亞科國泰99購01,,,,,0.00,0.00,0,0,0,0,0,0,0,0,0,0,0,0,0
20200430,056492,全新國泰9A購01,0.85,0.88,0.81,0.85,+0.02,2.41,212000,21,176520,0,0,0,0,0,0,172000,40000,132000,132000
20200430,056493,晶技國泰99購01,,,,,0.00,0.00,0,0,0,0,0,0,0,0,0,0,0,0,0
20200430,056494,緯創國泰99購01,1.81,1.81,1.74,1.74,0.00,0.00,110000,6,196300,0,0,0,0,0,0,0,110000,-110000,-110000
20200430,056495,泰鼎國泰99購01,,,,,0.00,0.00,0,0,0,0,0,0,0,0,0,0,0,0,0
20200430,056496,康控國泰99購01,1.09,1.37,1.09,1.37,+0.36,35.64,347000,13,430650,0,0,0,0,0,0,154000,193000,-39000,-39000
20200430,056497,GIS國泰99購01,1.87,1.93,1.85,1.93,+0.02,1.05,516000,15,968160,0,0,0,0,0,0,516000,0,516000,516000
20200430,056498,A50正2富邦9B購01,,,,,0.00,0.00,0,0,0,0,0,0,0,0,0,0,0,0,0
20200430,056499,鴻海富邦98購02,,,,,0.00,0.00,0,0,0,0,0,0,0,0,0,0,0,0,0
20200430,05649P,矽創國票97售03,2.46,2.46,2.30,2.30,-0.25,-9.8,29000,4,70240,0,0,0,0,0,0,0,29000,-29000,-29000
20200430,056500,大立光富邦9B購02,0.30,0.31,0.30,0.31,+0.01,3.33,171000,4,51450,0,0,0,0,0,0,0,0,0,0
20200430,056501,貿聯富邦99購01,0.44,0.44,0.44,0.44,0.00,0.00,500000,3,220000,0,0,0,0,0,0,500000,0,500000,500000
20200430,056502,A50正2永豐98購01,2.15,2.15,2.15,2.15,0.00,0.00,10000,1,21500,0,0,0,0,0,0,0,10000,-10000,-10000
20200430,056503,楠梓電永豐98購01,,,,,0.00,0.00,0,0,0,0,0,0,0,0,0,0,0,0,0
20200430,056504,國巨永豐98購02,,,,,0.00,0.00,0,0,0,0,0,0,0,0,0,0,0,0,0
20200430,056505,聯發科永豐98購01,1.07,1.20,1.01,1.20,+0.26,27.66,46000,21,52380,0,0,0,0,0,0,33000,0,33000,33000
20200430,056506,晶豪科永豐98購02,4.18,4.21,3.84,3.84,-0.10,-2.54,83000,7,344830,0,0,0,0,0,0,83000,0,83000,83000
20200430,056507,創意永豐98購02,1.65,1.67,1.65,1.67,+0.01,0.6,16000,3,26520,0,0,0,0,0,0,10000,6000,4000,4000
20200430,056508,揚明光永豐98購01,,,,,0.00,0.00,0,0,0,0,0,0,0,0,0,0,0,0,0
20200430,056509,晶相光永豐98購01,1.13,1.16,1.12,1.12,-0.07,-5.88,64000,6,72540,0,0,0,0,0,0,64000,18000,46000,46000
20200430,05650P,台積電富邦96售01,0.90,0.90,0.07,0.16,-0.03,-15.79,662000,18,63540,0,0,0,0,0,0,455000,0,455000,455000
20200430,056510,正文永豐98購02,,,,,0.00,0.00,0,0,0,0,0,0,0,0,0,0,0,0,0
20200430,056511,超眾永豐98購01,1.65,1.74,1.65,1.74,+0.03,1.75,43000,2,71850,0,0,0,0,0,0,0,43000,-43000,-43000
20200430,056512,易華電永豐98購01,0.48,0.53,0.48,0.53,0.00,0.00,20000,3,10100,0,0,0,0,0,0,0,20000,-20000,-20000
20200430,056513,臻鼎亞東99購01,0.27,0.31,0.27,0.31,0.00,0.00,10000,2,2900,0,0,0,0,0,0,10000,0,10000,10000
20200430,056514,訊芯亞東99購01,,,,,0.00,0.00,0,0,0,0,0,0,0,0,0,0,0,0,0
20200430,056515,燿華兆豐99購01,0.25,0.26,0.24,0.24,+0.02,9.09,474000,18,117030,0,0,0,0,0,0,80000,20000,60000,60000
20200430,056516,晶豪科兆豐98購01,2.56,2.56,2.33,2.33,+0.12,5.43,8000,4,19580,0,0,0,0,0,0,4000,4000,0,0
20200430,056517,茂林兆豐99購01,0.85,0.85,0.85,0.85,-0.08,-8.6,10000,1,8500,0,0,0,0,0,0,0,10000,-10000,-10000
20200430,056518,美律國票99購01,2.81,2.81,2.81,2.81,+0.29,11.51,9000,1,25290,0,0,0,0,0,0,9000,0,9000,9000
20200430,056519,創意國票99購01,4.25,4.34,4.25,4.34,+0.11,2.6,54000,6,231230,0,0,0,0,0,0,4000,50000,-46000,-46000
20200430,05651P,大立光元大97售02,3.08,3.08,3.08,3.08,0.00,0.00,10000,1,30800,0,0,0,0,0,0,10000,10000,0,0
20200430,056520,鴻海日盛99購01,,,,,0.00,0.00,0,0,0,0,0,0,0,0,0,0,0,0,0
20200430,056521,群創日盛98購01,,,,,0.00,0.00,0,0,0,0,0,0,0,0,0,0,0,0,0
20200430,056522,T50反1中信9B購01,,,,,0.00,0.00,0,0,0,0,0,0,0,0,0,0,0,0,0
20200430,056523,光寶科中信98購01,0.66,0.72,0.64,0.72,+0.12,20.0,51000,6,33010,0,0,0,0,0,0,23000,28000,-5000,-5000
20200430,056524,欣興中信98購02,0.68,0.73,0.66,0.67,+0.04,6.35,730000,33,505760,0,0,0,0,0,0,509000,213000,296000,296000
20200430,056525,T50反1凱基99購06,,,,,0.00,0.00,0,0,0,0,0,0,0,0,0,0,0,0,0
20200430,056526,力山凱基98購01,4.32,4.65,3.89,3.89,0.00,0.00,502000,66,2182840,0,0,0,0,0,0,302000,178000,124000,124000
20200430,056527,大成鋼凱基98購03,,,,,0.00,0.00,0,0,0,0,0,0,0,0,0,0,0,0,0
20200430,056528,為升凱基98購01,,,,,0.00,0.00,0,0,0,0,0,0,0,0,0,0,0,0,0
20200430,056529,中環凱基98購01,1.18,1.30,1.18,1.30,+0.14,12.07,182000,15,225400,0,0,0,0,0,0,50000,132000,-82000,-82000
20200430,05652P,臻鼎群益96售01,,,,,0.00,0.00,0,0,0,0,0,0,0,0,0,0,0,0,0
20200430,056530,旺宏凱基98購06,1.18,1.18,1.18,1.18,0.00,0.00,1000,1,1180,0,0,0,0,0,0,0,1000,-1000,-1000
20200430,056531,佳世達凱基98購01,0.28,0.28,0.28,0.28,+0.02,7.69,18000,2,5040,0,0,0,0,0,0,18000,0,18000,18000
20200430,056532,技嘉凱基98購01,,,,,0.00,0.00,0,0,0,0,0,0,0,0,0,0,0,0,0
20200430,056533,友達凱基9A購02,,,,,0.00,0.00,0,0,0,0,0,0,0,0,0,0,0,0,0
20200430,056534,京元電凱基98購01,5.65,5.70,5.65,5.65,+0.05,0.89,8000,6,45300,0,0,0,0,0,0,0,8000,-8000,-8000
20200430,056535,全新凱基99購02,1.76,1.77,1.71,1.71,-0.03,-1.72,52000,6,91320,0,0,0,0,0,0,52000,0,52000,52000
20200430,056536,義隆凱基98購04,3.98,4.36,3.98,4.36,+0.36,9.0,176000,29,733210,0,0,0,0,0,0,60000,176000,-116000,-116000
20200430,056537,冠德凱基98購01,2.19,2.34,2.13,2.31,+0.13,5.96,227000,14,489620,0,0,0,0,0,0,200000,27000,173000,173000
20200430,056538,國泰金凱基98購01,0.70,0.79,0.69,0.79,+0.24,43.64,252000,40,185030,0,0,0,0,0,0,61000,181000,-120000,-120000
20200430,056539,新光金凱基9A購01,0.28,0.28,0.28,0.28,0.00,0.00,1000,1,280,0,0,0,0,0,0,0,0,0,0
20200430,05653P,華邦電統一96售02,,,,,0.00,0.00,0,0,0,0,0,0,0,0,0,0,0,0,0
20200430,056540,聯詠凱基98購02,0.63,0.64,0.63,0.64,+0.06,10.34,320000,2,203200,0,0,0,0,0,0,320000,0,320000,320000
20200430,056541,智原凱基98購03,,,,,0.00,0.00,0,0,0,0,0,0,0,0,0,0,0,0,0
20200430,056542,緯創凱基98購01,,,,,0.00,0.00,0,0,0,0,0,0,0,0,0,0,0,0,0
20200430,056543,京鼎凱基98購01,,,,,0.00,0.00,0,0,0,0,0,0,0,0,0,0,0,0,0
20200430,056544,貿聯凱基98購03,1.49,1.54,1.49,1.54,+0.14,10.0,40000,2,60100,0,0,0,0,0,0,30000,10000,20000,20000
20200430,056545,TPK凱基98購02,,,,,0.00,0.00,0,0,0,0,0,0,0,0,0,0,0,0,0
20200430,056546,致伸凱基98購01,,,,,0.00,0.00,0,0,0,0,0,0,0,0,0,0,0,0,0
20200430,056547,臻鼎凱基99購01,,,,,0.00,0.00,0,0,0,0,0,0,0,0,0,0,0,0,0
20200430,056548,瀚宇博凱基98購02,3.51,3.61,3.51,3.61,0.00,0.00,96000,10,343140,0,0,0,0,0,0,1000,96000,-95000,-95000
20200430,056549,嘉聯益凱基98購04,0.76,0.79,0.75,0.77,+0.02,2.67,227000,17,176630,0,0,0,0,0,0,50000,177000,-127000,-127000
20200430,05654P,台光電統一96售01,,,,,0.00,0.00,0,0,0,0,0,0,0,0,0,0,0,0,0
20200430,056550,瑞儀凱基99購01,,,,,0.00,0.00,0,0,0,0,0,0,0,0,0,0,0,0,0
20200430,056551,台郡凱基98購04,3.64,3.64,3.64,3.64,+0.12,3.41,5000,1,18200,0,0,0,0,0,0,5000,0,5000,5000
20200430,056552,台表科凱基99購01,,,,,0.00,0.00,0,0,0,0,0,0,0,0,0,0,0,0,0
20200430,056553,啟碁凱基98購02,,,,,0.00,0.00,0,0,0,0,0,0,0,0,0,0,0,0,0
20200430,056554,GIS凱基99購01,,,,,0.00,0.00,0,0,0,0,0,0,0,0,0,0,0,0,0
20200430,056555,矽創凱基98購01,0.88,1.04,0.88,1.04,0.00,0.00,35000,4,34000,0,0,0,0,0,0,15000,20000,-5000,-5000
20200430,056556,南電凱基98購01,,,,,0.00,0.00,0,0,0,0,0,0,0,0,0,0,0,0,0
20200430,056557,世紀鋼凱基98購02,4.81,5.05,4.81,4.96,+0.26,5.53,106000,13,523600,0,0,0,0,0,0,21000,85000,-64000,-64000
20200430,056558,台達電群益98購01,2.47,2.71,2.39,2.71,+0.40,17.32,604000,35,1540060,0,0,0,0,0,0,191000,447000,-256000,-256000
20200430,056559,華通群益98購02,0.69,0.81,0.68,0.81,+0.15,22.73,1042000,50,773290,0,0,0,0,0,0,199000,843000,-644000,-644000
20200430,05655P,南亞科統一96售01,,,,,0.00,0.00,0,0,0,0,0,0,0,0,0,0,0,0,0
20200430,056560,旺宏群益98購03,,,,,0.00,0.00,0,0,0,0,0,0,0,0,0,0,0,0,0
20200430,056561,台光電群益98購02,3.49,3.93,3.42,3.93,+0.58,17.31,548000,29,1967110,0,0,0,0,0,0,122000,454000,-332000,-332000
20200430,056562,奇力新群益98購01,0.94,1.04,0.94,0.95,+0.06,6.74,425000,20,407930,0,0,0,0,0,0,152000,273000,-121000,-121000
20200430,056563,華新科群益98購04,,,,,0.00,0.00,0,0,0,0,0,0,0,0,0,0,0,0,0
20200430,056564,亞光群益98購02,0.53,0.56,0.52,0.56,+0.01,1.82,231000,8,125470,0,0,0,0,0,0,80000,151000,-71000,-71000
20200430,056565,欣興群益98購03,,,,,0.00,0.00,0,0,0,0,0,0,0,0,0,0,0,0,0
20200430,056566,臻鼎群益98購01,,,,,0.00,0.00,0,0,0,0,0,0,0,0,0,0,0,0,0
20200430,056567,瀚宇博群益98購02,3.45,3.57,3.45,3.57,+0.18,5.31,51000,9,178570,0,0,0,0,0,0,9000,46000,-37000,-37000
20200430,056568,台表科群益98購01,2.36,2.37,2.34,2.37,-0.01,-0.42,98000,4,229990,0,0,0,0,0,0,77000,23000,54000,54000
20200430,056569,T50正2元大9B購02,0.70,0.75,0.68,0.68,+0.14,25.93,23000,3,16540,0,0,0,0,0,0,3000,10000,-7000,-7000
20200430,05656P,台表科統一96售01,1.30,1.30,1.25,1.25,-0.05,-3.85,48000,2,61400,0,0,0,0,0,0,20000,28000,-8000,-8000
20200430,056570,旺宏元大98購07,,,,,0.00,0.00,0,0,0,0,0,0,0,0,0,0,0,0,0
20200430,056571,燿華元大98購02,1.32,1.40,1.30,1.36,+0.09,7.09,489000,33,650300,0,0,0,0,0,0,333000,146000,187000,187000
20200430,056572,義隆元大99購01,1.69,1.92,1.67,1.82,+0.13,7.69,805000,43,1447670,0,0,0,0,0,0,558000,356000,202000,202000
20200430,056573,華新科元大99購06,2.18,2.18,2.11,2.12,-0.03,-1.4,23000,4,49030,0,0,0,0,0,0,10000,13000,-3000,-3000
20200430,056574,亞光元大99購03,1.91,1.98,1.87,1.92,+0.02,1.05,304000,22,585290,0,0,0,0,0,0,182000,125000,57000,57000
20200430,056575,禾伸堂元大99購01,,,,,0.00,0.00,0,0,0,0,0,0,0,0,0,0,0,0,0
20200430,056576,晶技元大99購02,,,,,0.00,0.00,0,0,0,0,0,0,0,0,0,0,0,0,0
20200430,056577,玉晶光元大99購06,,,,,0.00,0.00,0,0,0,0,0,0,0,0,0,0,0,0,0
20200430,056578,智易元大99購02,2.35,2.35,2.28,2.28,-0.11,-4.6,330000,14,759200,0,0,0,0,0,0,120000,210000,-90000,-90000
20200430,056579,麗豐元大99購01,1.19,1.27,1.19,1.19,+0.04,3.48,734000,33,900380,0,0,0,0,0,0,532000,399000,133000,133000
20200430,05657P,樺漢統一97售01,,,,,0.00,0.00,0,0,0,0,0,0,0,0,0,0,0,0,0
20200430,056580,泰鼎元大9A購01,1.07,1.07,1.07,1.07,-0.05,-4.46,70000,1,74900,0,0,0,0,0,0,70000,0,70000,70000
20200430,056581,超眾元大99購01,3.94,4.11,3.94,4.11,+0.24,6.2,48000,4,195240,0,0,0,0,0,0,34000,36000,-2000,-2000
20200430,056582,易華電元大98購01,0.98,1.05,0.98,1.05,+0.05,5.0,333000,13,338330,0,0,0,0,0,0,103000,230000,-127000,-127000
20200430,056583,昇陽半元大98購02,1.08,1.11,1.05,1.10,+0.10,10.0,618000,33,667980,0,0,0,0,0,0,415000,200000,215000,215000
20200430,056584,鴻海統一9B購01,1.29,1.32,1.25,1.31,+0.09,7.38,250000,13,326900,0,0,0,0,0,0,135000,143000,-8000,-8000
20200430,056585,台積電統一9A購01,0.60,0.60,0.60,0.60,0.00,0.00,12000,1,7200,0,0,0,0,0,0,0,0,0,0
20200430,056586,光罩統一98購02,1.29,1.35,1.27,1.30,+0.02,1.56,963000,41,1260380,0,0,0,0,0,0,481000,510000,-29000,-29000
20200430,056587,聯發科統一9A購01,,,,,0.00,0.00,0,0,0,0,0,0,0,0,0,0,0,0,0
20200430,056588,聯發科統一9A購02,2.63,2.86,2.59,2.86,+0.56,24.35,286000,14,782340,0,0,0,0,0,0,72000,214000,-142000,-142000
20200430,056589,康控統一98購01,0.90,1.00,0.90,0.94,0.00,0.00,517000,23,480460,0,0,0,0,0,0,5000,497000,-492000,-492000
20200430,05658P,日月光元富96售02,4.15,4.21,4.15,4.18,-0.01,-0.24,8000,5,33530,0,0,0,0,0,0,0,8000,-8000,-8000
20200430,056590,樺漢統一9A購01,0.40,0.40,0.38,0.38,0.00,0.00,30000,2,11800,0,0,0,0,0,0,10000,0,10000,10000
20200430,056591,S&P正2元富9A購01,0.14,0.14,0.14,0.14,0.00,0.00,211000,7,29540,0,0,0,0,0,0,136000,0,136000,136000
20200430,056592,台積電元富98購01,1.08,1.50,1.08,1.50,+0.49,48.51,51000,5,57300,0,0,0,0,0,0,40000,0,40000,40000
20200430,056593,台積電元富98購02,,,,,0.00,0.00,0,0,0,0,0,0,0,0,0,0,0,0,0
20200430,056594,台積電元富98購03,,,,,0.00,0.00,0,0,0,0,0,0,0,0,0,0,0,0,0
20200430,056595,台積電元富98購04,,,,,0.00,0.00,0,0,0,0,0,0,0,0,0,0,0,0,0
20200430,056596,光磊元富98購01,1.56,1.56,1.55,1.56,0.00,0.00,70000,3,109100,0,0,0,0,0,0,50000,20000,30000,30000
20200430,056597,宏碁元富98購01,,,,,0.00,0.00,0,0,0,0,0,0,0,0,0,0,0,0,0
20200430,056598,京元電元富98購01,2.33,2.33,2.33,2.33,+0.10,4.48,10000,1,23300,0,0,0,0,0,0,0,10000,-10000,-10000
20200430,056599,臻鼎元富98購01,1.08,1.28,1.05,1.28,+0.24,23.08,478000,20,525260,0,0,0,0,0,0,265000,213000,52000,52000
20200430,05659P,A50正2中信97售01,,,,,0.00,0.00,0,0,0,0,0,0,0,0,0,0,0,0,0
20200430,056600,聯茂元富98購01,1.83,1.83,1.83,1.83,-0.02,-1.08,10000,1,18300,0,0,0,0,0,0,0,10000,-10000,-10000
20200430,056601,鈺齊元富98購01,,,,,0.00,0.00,0,0,0,0,0,0,0,0,0,0,0,0,0
20200430,056602,嘉澤國泰99購01,1.65,1.65,1.65,1.65,0.00,0.00,7000,1,11550,0,0,0,0,0,0,0,0,0,0
20200430,056603,嘉聯益國泰9A購01,2.24,2.30,2.21,2.28,+0.08,3.64,227000,39,507710,0,0,0,0,0,0,211000,17000,194000,194000
20200430,056604,鴻海富邦9A購01,0.41,0.41,0.41,0.41,+0.04,10.81,25000,1,10250,0,0,0,0,0,0,0,25000,-25000,-25000
20200430,056605,台積電富邦9B購02,0.51,0.51,0.45,0.49,+0.04,8.89,123000,11,58210,0,0,0,0,0,0,1000,62000,-61000,-61000
20200430,056606,華新科富邦9A購02,,,,,0.00,0.00,0,0,0,0,0,0,0,0,0,0,0,0,0
20200430,056607,貿聯富邦99購02,0.33,0.40,0.33,0.40,0.00,0.00,20000,12,7110,0,0,0,0,0,0,19000,1000,18000,18000
20200430,056608,力山永豐98購01,,,,,0.00,0.00,0,0,0,0,0,0,0,0,0,0,0,0,0
20200430,056609,楠梓電永豐98購02,,,,,0.00,0.00,0,0,0,0,0,0,0,0,0,0,0,0,0
20200430,05660P,玉晶光第一96售01,,,,,0.00,0.00,0,0,0,0,0,0,0,0,0,0,0,0,0
20200430,056610,鴻海永豐98購01,,,,,0.00,0.00,0,0,0,0,0,0,0,0,0,0,0,0,0
20200430,056611,國巨永豐98購03,1.68,1.77,1.68,1.75,+0.13,8.02,756000,22,1314600,0,0,0,0,0,0,377000,319000,58000,58000
20200430,056612,台積電永豐98購01,,,,,0.00,0.00,0,0,0,0,0,0,0,0,0,0,0,0,0
20200430,056613,旺宏永豐98購01,2.04,2.04,2.04,2.04,+0.28,15.91,1000,1,2040,0,0,0,0,0,0,1000,1000,0,0
20200430,056614,智邦永豐98購01,2.71,2.79,2.43,2.45,-0.23,-8.58,243000,35,653790,0,0,0,0,0,0,196000,53000,143000,143000
20200430,056615,燿華永豐98購02,0.73,0.79,0.73,0.79,+0.01,1.28,189000,6,147270,0,0,0,0,0,0,189000,0,189000,189000
20200430,056616,台光電永豐98購01,0.94,1.08,0.94,1.08,+0.16,17.39,545000,40,545200,0,0,0,0,0,0,72000,472000,-400000,-400000
20200430,056617,美律永豐98購01,0.74,0.81,0.74,0.80,+0.09,12.68,1267000,21,965060,0,0,0,0,0,0,290000,951000,-661000,-661000
20200430,056618,京元電永豐98購01,1.43,1.45,1.41,1.43,+0.04,2.88,195000,17,279500,0,0,0,0,0,0,121000,74000,47000,47000
20200430,056619,強茂永豐98購01,1.18,1.22,1.17,1.22,+0.09,7.96,88000,8,104420,0,0,0,0,0,0,8000,80000,-72000,-72000
20200430,05661P,聯發科統一96售06,,,,,0.00,0.00,0,0,0,0,0,0,0,0,0,0,0,0,0
20200430,056620,華新科永豐98購02,1.18,1.18,1.07,1.07,0.00,0.00,135000,3,145000,0,0,0,0,0,0,130000,5000,125000,125000
20200430,056621,宏達電永豐98購01,0.94,0.94,0.89,0.89,-0.04,-4.3,36000,3,33340,0,0,0,0,0,0,10000,26000,-16000,-16000
20200430,056622,高鐵永豐98購01,1.18,1.18,1.16,1.16,-0.01,-0.85,204000,6,238600,0,0,0,0,0,0,204000,0,204000,204000
20200430,056623,禾伸堂永豐98購01,1.78,1.78,1.78,1.78,+0.08,4.71,5000,1,8900,0,0,0,0,0,0,5000,0,5000,5000
20200430,056624,景碩永豐98購01,,,,,0.00,0.00,0,0,0,0,0,0,0,0,0,0,0,0,0
20200430,056625,致伸永豐98購01,0.70,0.70,0.70,0.70,0.00,0.00,17000,2,11900,0,0,0,0,0,0,0,17000,-17000,-17000
20200430,056626,同欣電永豐98購01,0.47,0.47,0.47,0.47,0.00,0.00,28000,1,13160,0,0,0,0,0,0,0,28000,-28000,-28000
20200430,056627,訊芯永豐98購01,0.43,0.43,0.43,0.43,+0.04,10.26,10000,1,4300,0,0,0,0,0,0,0,10000,-10000,-10000
20200430,056628,矽創永豐98購01,,,,,0.00,0.00,0,0,0,0,0,0,0,0,0,0,0,0,0
20200430,056629,昇陽半永豐98購01,0.60,0.63,0.59,0.63,+0.07,12.5,373000,18,229690,0,0,0,0,0,0,30000,343000,-313000,-313000
20200430,05662P,景碩元富96售01,,,,,0.00,0.00,0,0,0,0,0,0,0,0,0,0,0,0,0
20200430,056630,臺股指永豐98購02,,,,,0.00,0.00,0,0,0,0,0,0,0,0,0,0,0,0,0
20200430,056631,臺股指永豐98購03,,,,,0.00,0.00,0,0,0,0,0,0,0,0,0,0,0,0,0
20200430,056632,鴻海永昌98購01,,,,,0.00,0.00,0,0,0,0,0,0,0,0,0,0,0,0,0
20200430,056633,鴻海永昌98購02,,,,,0.00,0.00,0,0,0,0,0,0,0,0,0,0,0,0,0
20200430,056634,為升兆豐99購01,0.34,0.40,0.33,0.33,+0.03,10.0,369000,41,128660,0,30000,-30000,0,0,0,49000,272000,-223000,-253000
20200430,056635,亞德客日盛99購01,2.32,2.32,2.32,2.32,+0.14,6.42,10000,1,23200,0,0,0,0,0,0,10000,0,10000,10000
20200430,056636,台積電日盛9A購01,,,,,0.00,0.00,0,0,0,0,0,0,0,0,0,0,0,0,0
20200430,056637,台光電日盛9A購01,1.93,2.07,1.93,2.07,+0.23,12.5,3000,2,6070,0,0,0,0,0,0,3000,0,3000,3000
20200430,056638,臺股指日盛98購01,0.54,0.55,0.54,0.55,0.00,0.00,110000,2,60200,0,0,0,0,0,0,80000,30000,50000,50000
20200430,056639,國產康和98購01,,,,,0.00,0.00,0,0,0,0,0,0,0,0,0,0,0,0,0
20200430,05663P,創意元富96售04,,,,,0.00,0.00,0,0,0,0,0,0,0,0,0,0,0,0,0
20200430,056640,元油2X凱基9A購01,,,,,0.00,0.00,0,0,0,0,0,0,0,0,0,0,0,0,0
20200430,056641,華通凱基98購03,2.56,2.95,2.56,2.84,+0.28,10.94,298000,33,827670,0,0,0,0,0,0,86000,212000,-126000,-126000
20200430,056642,旺宏凱基98購07,2.87,2.87,2.76,2.78,+0.21,8.17,57000,8,160080,0,0,0,0,0,0,52000,29000,23000,23000
20200430,056643,奇力新凱基99購01,1.42,1.42,1.42,1.42,+0.12,9.23,20000,2,28400,0,0,0,0,0,0,0,20000,-20000,-20000
20200430,056644,宏達電凱基98購04,,,,,0.00,0.00,0,0,0,0,0,0,0,0,0,0,0,0,0
20200430,056645,大立光凱基98購12,,,,,0.00,0.00,0,0,0,0,0,0,0,0,0,0,0,0,0
20200430,056646,奇鋐凱基99購02,,,,,0.00,0.00,0,0,0,0,0,0,0,0,0,0,0,0,0
20200430,056647,晶技凱基98購02,,,,,0.00,0.00,0,0,0,0,0,0,0,0,0,0,0,0,0
20200430,056648,牧德凱基99購02,,,,,0.00,0.00,0,0,0,0,0,0,0,0,0,0,0,0,0
20200430,056649,智易凱基98購01,,,,,0.00,0.00,0,0,0,0,0,0,0,0,0,0,0,0,0
20200430,05664P,國巨凱基96售09,,,,,0.00,0.00,0,0,0,0,0,0,0,0,0,0,0,0,0
20200430,056650,彩晶凱基9A購01,,,,,0.00,0.00,0,0,0,0,0,0,0,0,0,0,0,0,0
20200430,056651,聯茂凱基98購04,,,,,0.00,0.00,0,0,0,0,0,0,0,0,0,0,0,0,0
20200430,056652,上証反元大9B購01,0.15,0.18,0.15,0.18,-0.02,-10.0,57000,8,8810,0,0,0,0,0,0,0,0,0,0
20200430,056653,元石油元大98購01,0.13,0.14,0.12,0.14,+0.02,16.67,514000,23,67090,0,0,0,0,0,0,0,0,0,0
20200430,056654,元油2X元大98購02,,,,,0.00,0.00,0,0,0,0,0,0,0,0,0,0,0,0,0
20200430,056655,旺宏元大99購02,3.77,3.77,3.57,3.57,+0.26,7.85,205000,21,740970,0,0,0,0,0,0,59000,199000,-140000,-140000
20200430,056656,華邦電元大98購02,,,,,0.00,0.00,0,0,0,0,0,0,0,0,0,0,0,0,0
20200430,056657,華邦電元大99購01,1.76,1.89,1.76,1.89,+0.18,10.53,397000,26,730560,0,0,0,0,0,0,35000,362000,-327000,-327000
20200430,056658,美食元大98購01,1.00,1.36,1.00,1.35,+0.35,35.0,453000,31,566540,0,0,0,0,0,0,254000,189000,65000,65000
20200430,056659,泰碩元大99購01,,,,,0.00,0.00,0,0,0,0,0,0,0,0,0,0,0,0,0
20200430,05665P,台積電凱基96售08,,,,,0.00,0.00,0,0,0,0,0,0,0,0,0,0,0,0,0
20200430,056660,臺股指元大9A購07,,,,,0.00,0.00,0,0,0,0,0,0,0,0,0,0,0,0,0
20200430,056661,臺股指元大9A購08,0.68,0.70,0.68,0.70,+0.12,20.69,30000,3,20600,0,0,0,0,0,0,30000,0,30000,30000
20200430,056662,臺股指元大9A購09,0.75,0.88,0.75,0.82,+0.17,26.15,62000,5,50630,0,0,0,0,0,0,54000,0,54000,54000
20200430,056663,臺股指元大9A購10,0.94,1.20,0.94,1.11,+0.21,23.33,124000,10,141900,0,0,0,0,0,0,6000,0,6000,6000
20200430,056664,上証反中信9B購01,,,,,0.00,0.00,0,0,0,0,0,0,0,0,0,0,0,0,0
20200430,056665,上証2X國票99購02,1.03,1.03,0.99,0.99,+0.09,10.0,5000,2,5030,0,0,0,0,0,0,2000,3000,-1000,-1000
20200430,056666,元油2X國票9A購01,0.05,0.05,0.04,0.04,+0.01,33.33,304000,7,14000,0,0,0,0,0,0,0,0,0,0
20200430,056667,上銀國票99購01,,,,,0.00,0.00,0,0,0,0,0,0,0,0,0,0,0,0,0
20200430,056668,光磊國票99購01,3.35,3.35,3.35,3.35,-0.04,-1.18,34000,2,113900,0,0,0,0,0,0,0,34000,-34000,-34000
20200430,056669,貿聯國票99購01,1.79,1.94,1.79,1.94,0.00,0.00,74000,3,134710,0,0,0,0,0,0,0,74000,-74000,-74000
20200430,05666P,聯發科凱基96售14,,,,,0.00,0.00,0,0,0,0,0,0,0,0,0,0,0,0,0
20200430,056670,樺漢國票99購01,1.99,2.17,1.99,2.15,+0.11,5.39,173000,11,352740,0,0,0,0,0,0,128000,45000,83000,83000
20200430,056671,台灣50元富9A購01,0.41,0.48,0.41,0.48,+0.04,9.09,335000,20,155700,0,0,0,0,0,0,30000,0,30000,30000
20200430,056672,元油2X元富98購10,0.08,0.12,0.08,0.12,+0.04,50.0,533000,14,47750,0,0,0,0,0,0,0,0,0,0
20200430,056673,中石化元富9B購01,0.81,0.89,0.81,0.89,+0.11,14.1,746000,20,643020,0,0,0,0,0,0,383000,367000,16000,16000
20200430,056674,華邦電元富98購01,0.96,1.04,0.96,1.04,+0.16,18.18,483000,17,475710,0,0,0,0,0,0,120000,363000,-243000,-243000
20200430,056675,聯發科元富02購01,1.34,1.40,1.31,1.40,+0.26,22.81,26000,3,34840,0,0,0,0,0,0,26000,0,26000,26000
20200430,056676,國產元富98購01,,,,,0.00,0.00,0,0,0,0,0,0,0,0,0,0,0,0,0
20200430,056677,智伸科元富98購01,1.39,1.63,1.39,1.43,+0.13,10.0,311000,21,468580,0,0,0,0,0,0,58000,253000,-195000,-195000
20200430,056678,力成元富98購01,0.68,0.68,0.68,0.68,0.00,0.00,5000,1,3400,0,0,0,0,0,0,5000,0,5000,5000
20200430,056679,元油2X統一98購01,,,,,0.00,0.00,0,0,0,0,0,0,0,0,0,0,0,0,0
20200430,05667P,旺宏台新96售01,0.20,0.20,0.20,0.20,0.00,0.00,30000,3,6000,0,0,0,0,0,0,0,30000,-30000,-30000
20200430,056680,華通統一98購04,0.46,0.57,0.46,0.53,+0.10,23.26,125000,7,63450,0,0,0,0,0,0,110000,15000,95000,95000
20200430,056681,鴻海統一98購09,2.15,2.17,2.15,2.17,+0.07,3.33,48000,6,103320,0,0,0,0,0,0,42000,6000,36000,36000
20200430,056682,鴻海統一98購10,1.78,1.79,1.74,1.79,+0.05,2.87,42000,6,74410,0,0,0,0,0,0,35000,8000,27000,27000
20200430,056683,台積電統一98購05,0.82,0.86,0.82,0.86,+0.11,14.67,342000,12,283240,0,0,0,0,0,0,0,342000,-342000,-342000
20200430,056684,旺宏統一98購02,2.26,2.26,2.15,2.16,+0.26,13.68,73000,9,159730,0,0,0,0,0,0,73000,0,73000,73000
20200430,056685,光罩統一98購03,0.83,0.83,0.83,0.83,+0.05,6.41,10000,1,8300,0,0,0,0,0,0,0,10000,-10000,-10000
20200430,056686,可成統一98購01,1.15,1.15,1.10,1.11,-0.04,-3.48,68000,6,75620,0,0,0,0,0,0,13000,57000,-44000,-44000
20200430,056687,元大金統一98購01,,,,,0.00,0.00,0,0,0,0,0,0,0,0,0,0,0,0,0
20200430,056688,聯詠統一98購01,0.41,0.41,0.39,0.41,0.00,0.00,558000,13,220840,0,0,0,0,0,0,272000,86000,186000,186000
20200430,056689,玉晶光統一9A購03,2.02,2.15,2.02,2.15,+0.15,7.5,619000,24,1314350,0,0,0,0,0,0,408000,227000,181000,181000
20200430,05668P,滬深2X永豐96售04,2.02,2.02,2.02,2.02,0.00,0.00,1000,1,2020,0,0,0,0,0,0,1000,0,1000,1000
20200430,056691,元油2X群益9B購01,0.13,0.14,0.12,0.14,+0.02,16.67,304000,13,40960,0,0,0,0,0,0,0,0,0,0
20200430,056692,燿華群益98購03,,,,,0.00,0.00,0,0,0,0,0,0,0,0,0,0,0,0,0
20200430,056693,國產群益98購01,0.86,0.86,0.75,0.80,-0.03,-3.61,1335000,34,1077300,0,0,0,0,0,0,911000,394000,517000,517000
20200430,056694,欣興群益98購04,5.30,5.75,5.20,5.30,+0.30,6.0,351000,60,1890900,0,0,0,0,0,0,277000,85000,192000,192000
20200430,056695,景碩群益99購01,2.44,2.44,2.44,2.44,+0.26,11.93,10000,1,24400,0,0,0,0,0,0,10000,0,10000,10000
20200430,056696,茂林群益98購02,,,,,0.00,0.00,0,0,0,0,0,0,0,0,0,0,0,0,0
20200430,056697,緯穎群益98購01,2.77,3.49,2.75,3.33,+0.72,27.59,144000,15,442120,0,0,0,0,0,0,71000,104000,-33000,-33000
20200430,056698,T50反1國泰9A購01,,,,,0.00,0.00,0,0,0,0,0,0,0,0,0,0,0,0,0
20200430,056699,光罩國泰99購01,1.46,1.57,1.46,1.50,0.00,0.00,112000,13,170580,0,0,0,0,0,0,0,112000,-112000,-112000
20200430,05669P,嘉晶永豐96售03,0.75,0.75,0.66,0.66,-0.14,-17.5,117000,4,86090,0,0,0,0,0,0,117000,0,117000,117000
20200430,056700,華新科國泰99購03,1.46,1.46,1.46,1.46,+0.10,7.35,1000,1,1460,0,0,0,0,0,0,1000,0,1000,1000
20200430,056701,國產國泰9A購01,,,,,0.00,0.00,0,0,0,0,0,0,0,0,0,0,0,0,0
20200430,056702,欣興國泰9A購01,1.81,1.88,1.78,1.78,+0.11,6.59,42000,5,75900,0,0,0,0,0,0,32000,22000,10000,10000
20200430,056703,群創國泰9A購01,0.14,0.15,0.14,0.14,+0.02,16.67,31000,3,4440,0,0,0,0,0,0,31000,0,31000,31000
20200430,056704,健策國泰99購01,1.45,1.45,1.45,1.45,0.00,0.00,1000,1,1450,0,0,0,0,0,0,0,1000,-1000,-1000
20200430,056705,超眾國泰99購01,2.85,2.97,2.83,2.92,+0.12,4.29,81000,5,232650,0,0,0,0,0,0,10000,71000,-61000,-61000
20200430,056706,元油2X富邦9B購01,0.06,0.06,0.06,0.06,0.00,0.00,75000,1,4500,0,0,0,0,0,0,0,0,0,0
20200430,056707,鴻海富邦99購03,0.63,0.70,0.62,0.70,+0.08,12.9,65000,5,43430,0,0,0,0,0,0,65000,33000,32000,32000
20200430,056708,元油2X永豐98購02,,,,,0.00,0.00,0,0,0,0,0,0,0,0,0,0,0,0,0
20200430,056709,華通永豐98購01,2.08,2.36,2.08,2.36,+0.28,13.46,93000,14,207150,0,0,0,0,0,0,12000,81000,-69000,-69000
20200430,05670P,台積電國票98售01,0.62,0.62,0.60,0.60,+0.15,33.33,34000,5,20720,0,0,0,0,0,0,20000,34000,-14000,-14000
20200430,056710,漢唐永豐98購01,,,,,0.00,0.00,0,0,0,0,0,0,0,0,0,0,0,0,0
20200430,056711,亞光永豐98購01,0.99,1.03,0.99,1.03,-0.02,-1.9,114000,6,115800,0,0,0,0,0,0,114000,4000,110000,110000
20200430,056712,京鼎永豐98購01,,,,,0.00,0.00,0,0,0,0,0,0,0,0,0,0,0,0,0
20200430,056713,華擎永豐98購01,1.56,1.56,1.47,1.50,-0.09,-5.66,40000,4,60300,0,0,0,0,0,0,10000,40000,-30000,-30000
20200430,056714,晶相光永豐98購02,1.52,1.54,1.48,1.48,-0.11,-6.92,64000,10,97370,0,0,0,0,0,0,54000,17000,37000,37000
20200430,056715,瀚宇博永豐98購01,1.24,1.32,1.21,1.31,+0.10,8.26,298000,23,375590,0,0,0,0,0,0,108000,231000,-123000,-123000
20200430,056716,康舒永豐98購01,0.56,0.61,0.54,0.59,+0.02,3.51,147000,10,83030,0,0,0,0,0,0,107000,40000,67000,67000
20200430,056717,康友永豐98購01,0.14,0.14,0.14,0.14,+0.03,27.27,15000,1,2100,0,0,0,0,0,0,0,15000,-15000,-15000
20200430,056718,GIS永豐98購01,0.64,0.64,0.60,0.60,+0.07,13.21,15000,3,9400,0,0,0,0,0,0,10000,5000,5000,5000
20200430,056719,台虹永豐98購01,0.83,0.85,0.82,0.82,-0.03,-3.53,129000,11,107390,0,0,0,0,0,0,129000,0,129000,129000
20200430,05671P,友達國泰97售03,,,,,0.00,0.00,0,0,0,0,0,0,0,0,0,0,0,0,0
20200430,056720,世紀鋼永豐98購01,2.32,2.49,2.32,2.48,+0.24,10.71,53000,9,129230,0,0,0,0,0,0,43000,53000,-10000,-10000
20200430,056721,台灣50永昌9A購01,1.08,1.15,1.05,1.13,+0.18,18.95,310000,26,348210,0,0,0,0,0,0,288000,180000,108000,108000
20200430,056722,滬深反中信9B購01,,,,,0.00,0.00,0,0,0,0,0,0,0,0,0,0,0,0,0
20200430,056723,國巨中信9A購01,1.01,1.02,0.97,0.97,0.00,0.00,31000,4,31120,0,0,0,0,0,0,0,26000,-26000,-26000
20200430,056724,臻鼎中信9A購01,0.19,0.26,0.19,0.26,0.00,0.00,201000,9,48260,0,0,0,0,0,0,30000,171000,-141000,-141000
20200430,056725,鴻海國票99購03,0.15,0.15,0.15,0.15,0.00,0.00,8000,1,1200,0,0,0,0,0,0,0,8000,-8000,-8000
20200430,056726,友達日盛9A購01,0.60,0.60,0.60,0.60,0.00,0.00,200000,2,120000,0,0,0,0,0,0,0,200000,-200000,-200000
20200430,056727,滬深反凱基9B購01,,,,,0.00,0.00,0,0,0,0,0,0,0,0,0,0,0,0,0
20200430,056728,元油2X凱基9A購02,,,,,0.00,0.00,0,0,0,0,0,0,0,0,0,0,0,0,0
20200430,056729,元油2X凱基9A購03,,,,,0.00,0.00,0,0,0,0,0,0,0,0,0,0,0,0,0
20200430,05672P,鴻海群益96售03,,,,,0.00,0.00,0,0,0,0,0,0,0,0,0,0,0,0,0
20200430,056730,元油2X凱基9A購04,0.07,0.07,0.06,0.07,+0.01,16.67,270000,4,16400,0,0,0,0,0,0,0,0,0,0
20200430,056731,國巨凱基98購04,1.25,1.30,1.24,1.30,+0.07,5.69,55000,3,68990,0,0,0,0,0,0,1000,54000,-53000,-53000
20200430,056732,國巨凱基98購07,1.49,1.49,1.49,1.49,0.00,0.00,5000,1,7450,0,0,0,0,0,0,0,5000,-5000,-5000
20200430,056733,國巨凱基98購10,,,,,0.00,0.00,0,0,0,0,0,0,0,0,0,0,0,0,0
20200430,056734,國巨凱基99購01,,,,,0.00,0.00,0,0,0,0,0,0,0,0,0,0,0,0,0
20200430,056735,國巨凱基99購02,,,,,0.00,0.00,0,0,0,0,0,0,0,0,0,0,0,0,0
20200430,056736,國巨凱基99購03,2.77,2.77,2.77,2.77,+0.21,8.2,3000,1,8310,0,0,0,0,0,0,0,3000,-3000,-3000
20200430,056737,國巨凱基9A購01,,,,,0.00,0.00,0,0,0,0,0,0,0,0,0,0,0,0,0
20200430,056738,國巨凱基9A購02,1.74,1.74,1.74,1.74,+0.12,7.41,10000,1,17400,0,0,0,0,0,0,0,10000,-10000,-10000
20200430,056739,美律凱基98購04,0.42,0.42,0.42,0.42,-0.03,-6.67,5000,2,2100,0,0,0,0,0,0,2000,0,2000,2000
20200430,05673P,台積電群益96售05,,,,,0.00,0.00,0,0,0,0,0,0,0,0,0,0,0,0,0
20200430,056740,大立光凱基98購13,4.74,5.20,4.74,5.20,+0.67,14.79,39000,5,198070,0,0,0,0,0,0,28000,11000,17000,17000
20200430,056741,大立光凱基98購14,2.05,2.05,2.03,2.05,+0.07,3.54,22000,4,45060,0,0,0,0,0,0,22000,0,22000,22000
20200430,056742,玉晶光凱基9A購01,0.42,0.47,0.42,0.47,0.00,0.00,25000,3,11000,0,0,0,0,0,0,0,10000,-10000,-10000
20200430,056743,貿聯凱基98購04,1.27,1.42,1.27,1.42,+0.22,18.33,99000,12,131950,0,0,0,0,0,0,48000,51000,-3000,-3000
20200430,056744,麗豐凱基9A購01,0.66,0.68,0.66,0.66,+0.05,8.2,141000,15,93260,0,0,0,0,0,0,131000,130000,1000,1000
20200430,056745,聯茂凱基99購03,,,,,0.00,0.00,0,0,0,0,0,0,0,0,0,0,0,0,0
20200430,056746,超眾凱基99購01,,,,,0.00,0.00,0,0,0,0,0,0,0,0,0,0,0,0,0
20200430,056747,致新凱基99購01,,,,,0.00,0.00,0,0,0,0,0,0,0,0,0,0,0,0,0
20200430,056748,T50反1兆豐99購01,1.06,1.06,1.04,1.04,-0.16,-13.33,100000,2,105000,0,0,0,0,0,0,0,100000,-100000,-100000
20200430,056749,滬深2X兆豐99購01,1.10,1.24,1.06,1.07,+0.07,7.0,248000,40,280780,0,0,0,0,0,0,0,155000,-155000,-155000
20200430,05674P,瑞昱群益96售02,,,,,0.00,0.00,0,0,0,0,0,0,0,0,0,0,0,0,0
20200430,056750,元油2X兆豐9A購01,0.02,0.02,0.02,0.02,0.00,0.00,10000,1,200,0,0,0,0,0,0,0,10000,-10000,-10000
20200430,056751,和大兆豐98購01,,,,,0.00,0.00,0,0,0,0,0,0,0,0,0,0,0,0,0
20200430,056752,國巨兆豐98購02,0.66,0.66,0.66,0.66,+0.01,1.54,10000,1,6600,0,0,0,0,0,0,10000,10000,0,0
20200430,056753,群創兆豐98購02,,,,,0.00,0.00,0,0,0,0,0,0,0,0,0,0,0,0,0
20200430,056754,智易兆豐99購01,1.30,1.33,1.30,1.33,-0.02,-1.48,50000,3,65300,0,0,0,0,0,0,40000,10000,30000,30000
20200430,056755,聯茂兆豐98購01,1.58,1.58,1.58,1.58,-0.02,-1.25,9000,1,14220,0,0,0,0,0,0,9000,0,9000,9000
20200430,056756,T50反1元大98購06,,,,,0.00,0.00,0,0,0,0,0,0,0,0,0,0,0,0,0
20200430,056757,T50反1元大98購07,1.36,1.36,1.36,1.36,0.00,0.00,5000,1,6800,0,0,0,0,0,0,0,5000,-5000,-5000
20200430,056758,元石油元大98購02,0.14,0.15,0.14,0.14,+0.01,7.69,658000,22,96730,0,0,0,0,0,0,0,0,0,0
20200430,056759,元油2X元大98購05,0.05,0.05,0.05,0.05,+0.02,66.67,30000,1,1500,0,0,0,0,0,0,0,0,0,0
20200430,05675P,美律群益97售01,1.23,1.23,1.23,1.23,-0.12,-8.89,10000,1,12300,0,0,0,0,0,0,0,10000,-10000,-10000
20200430,056760,元油2X元大98購06,0.06,0.06,0.06,0.06,0.00,0.00,156000,2,9360,0,0,0,0,0,0,0,156000,-156000,-156000
20200430,056761,元油2X元大98購07,0.07,0.08,0.06,0.08,+0.02,33.33,1681000,9,101280,0,0,0,0,0,0,0,0,0,0
20200430,056762,亞德客元大98購01,2.65,3.13,2.45,3.10,+0.65,26.53,592000,63,1600440,0,0,0,0,0,0,250000,364000,-114000,-114000
20200430,056763,國巨元大99購02,3.81,3.88,3.62,3.73,+0.21,5.97,540000,16,2011580,0,0,0,0,0,0,350000,190000,160000,160000
20200430,056764,友達元大9A購03,,,,,0.00,0.00,0,0,0,0,0,0,0,0,0,0,0,0,0
20200430,056765,友達元大9B購05,,,,,0.00,0.00,0,0,0,0,0,0,0,0,0,0,0,0,0
20200430,056766,義隆元大98購01,2.57,2.78,2.55,2.64,+0.13,5.18,118000,14,307610,0,0,0,0,0,0,20000,117000,-97000,-97000
20200430,056767,大毅元大99購01,1.96,2.22,1.88,1.90,+0.15,8.57,384000,50,780850,0,0,0,0,0,0,218000,217000,1000,1000
20200430,056768,宏達電元大99購03,,,,,0.00,0.00,0,0,0,0,0,0,0,0,0,0,0,0,0
20200430,056769,國產元大98購01,1.00,1.03,0.86,0.92,-0.03,-3.16,1076000,42,1027650,0,0,0,0,0,0,689000,281000,408000,408000
20200430,05676P,欣興群益96售04,,,,,0.00,0.00,0,0,0,0,0,0,0,0,0,0,0,0,0
20200430,056770,國產元大98購02,1.11,1.15,0.95,1.04,-0.09,-7.96,765000,25,777780,0,0,0,0,0,0,645000,120000,525000,525000
20200430,056771,嘉晶元大99購01,7.00,7.00,7.00,7.00,+0.30,4.48,30000,1,210000,0,0,0,0,0,0,0,30000,-30000,-30000
20200430,056772,欣興元大99購01,5.10,5.30,5.05,5.05,+0.19,3.91,136000,32,691300,0,0,0,0,0,0,128000,74000,54000,54000
20200430,056773,晶技元大99購03,,,,,0.00,0.00,0,0,0,0,0,0,0,0,0,0,0,0,0
20200430,056774,和鑫元大98購01,0.92,0.95,0.80,0.84,-0.07,-7.69,452000,20,387280,0,0,0,0,0,0,373000,79000,294000,294000
20200430,056775,康控元大99購01,,,,,0.00,0.00,0,0,0,0,0,0,0,0,0,0,0,0,0
20200430,056776,聯茂元大99購01,5.35,5.35,5.30,5.30,-0.10,-1.85,49000,3,259900,0,0,0,0,0,0,4000,45000,-41000,-41000
20200430,056777,矽力元大98購02,,,,,0.00,0.00,0,0,0,0,0,0,0,0,0,0,0,0,0
20200430,056778,元石油群益9B購01,0.27,0.30,0.27,0.30,0.00,0.00,352000,11,96580,0,0,0,0,0,0,0,0,0,0
20200430,056779,元油2X群益9A購02,,,,,0.00,0.00,0,0,0,0,0,0,0,0,0,0,0,0,0
20200430,05677P,玉晶光群益98售03,0.30,0.30,0.29,0.29,-0.11,-27.5,8000,2,2340,0,0,0,0,0,0,0,0,0,0
20200430,056780,元油2X群益9A購03,0.09,0.09,0.09,0.09,-0.01,-10.0,99000,5,8910,0,0,0,0,0,0,0,0,0,0
20200430,056781,元油2X群益9B購02,0.10,0.11,0.09,0.11,+0.02,22.22,563000,9,55310,0,0,0,0,0,0,0,0,0,0
20200430,056782,鴻海群益98購04,0.91,0.99,0.91,0.99,0.00,0.00,59000,2,56090,0,0,0,0,0,0,59000,0,59000,59000
20200430,056783,國巨群益99購01,2.33,2.33,2.21,2.26,+0.13,6.1,226000,16,512830,0,0,0,0,0,0,140000,138000,2000,2000
20200430,056784,南亞科群益98購01,1.58,1.58,1.58,1.58,+0.16,11.27,12000,1,18960,0,0,0,0,0,0,12000,0,12000,12000
20200430,056785,可成群益99購01,0.76,0.76,0.76,0.76,0.00,0.00,10000,1,7600,0,0,0,0,0,0,0,10000,-10000,-10000
20200430,056786,亞光群益98購03,0.85,0.89,0.85,0.88,+0.02,2.33,343000,7,300190,0,0,0,0,0,0,186000,157000,29000,29000
20200430,056787,健鼎群益98購01,1.19,1.26,1.14,1.24,+0.08,6.9,321000,7,383080,0,0,0,0,0,0,98000,222000,-124000,-124000
20200430,056788,日月光群益98購01,1.32,1.42,1.31,1.42,+0.15,11.81,150000,6,202420,0,0,0,0,0,0,8000,142000,-134000,-134000
20200430,056789,和碩群益98購01,1.38,1.38,1.38,1.38,-0.09,-6.12,27000,1,37260,0,0,0,0,0,0,27000,0,27000,27000
20200430,05678P,群創群益97售01,,,,,0.00,0.00,0,0,0,0,0,0,0,0,0,0,0,0,0
20200430,056790,彩晶群益98購03,,,,,0.00,0.00,0,0,0,0,0,0,0,0,0,0,0,0,0
20200430,056791,嘉聯益群益98購01,3.04,3.25,3.04,3.25,+0.18,5.86,219000,17,692490,0,0,0,0,0,0,110000,139000,-29000,-29000
20200430,056792,訊芯群益98購01,0.26,0.26,0.26,0.26,0.00,0.00,10000,1,2600,0,0,0,0,0,0,10000,0,10000,10000
20200430,056793,臺股指群益98購03,,,,,0.00,0.00,0,0,0,0,0,0,0,0,0,0,0,0,0
20200430,056794,上銀麥證98購01,1.33,1.55,1.33,1.55,+0.55,55.0,40000,7,58160,10000,30000,-20000,0,0,0,10000,30000,-20000,-20000
20200430,056795,鴻海麥證98購01,,,,,0.00,0.00,0,0,0,0,0,0,0,0,0,0,0,0,0
20200430,056796,國巨麥證98購02,2.36,2.36,2.35,2.35,0.00,0.00,7000,2,16480,0,7000,-7000,0,0,0,0,7000,-7000,-7000
20200430,056797,台積電麥證98購01,1.24,1.24,1.24,1.24,0.00,0.00,230000,1,285200,230000,0,230000,0,0,0,230000,230000,0,0
20200430,056798,華新科麥證98購01,,,,,0.00,0.00,0,0,0,0,0,0,0,0,0,0,0,0,0
20200430,056799,群創麥證98購01,,,,,0.00,0.00,0,0,0,0,0,0,0,0,0,0,0,0,0
20200430,05679P,台表科群益96售05,,,,,0.00,0.00,0,0,0,0,0,0,0,0,0,0,0,0,0
20200430,056800,臺股指麥證98購01,1.00,1.07,1.00,1.07,0.00,0.00,8000,3,8270,8000,0,8000,0,0,0,8000,0,8000,8000
20200430,056801,國巨台新98購01,1.04,1.04,0.15,0.15,-0.82,-84.54,53000,6,28330,0,0,0,0,0,0,3000,50000,-47000,-47000
20200430,056802,友達台新98購01,,,,,0.00,0.00,0,0,0,0,0,0,0,0,0,0,0,0,0
20200430,056803,群創台新99購02,0.02,0.02,0.02,0.02,-0.24,-92.31,20000,2,400,0,0,0,0,0,0,0,20000,-20000,-20000
20200430,056804,T50反1統一9A購03,,,,,0.00,0.00,0,0,0,0,0,0,0,0,0,0,0,0,0
20200430,056805,元石油統一9B購01,0.37,0.38,0.35,0.38,+0.02,5.56,62000,8,22990,0,0,0,0,0,0,0,0,0,0
20200430,056806,元油2X統一98購02,,,,,0.00,0.00,0,0,0,0,0,0,0,0,0,0,0,0,0
20200430,056807,元油2X統一9B購01,0.09,0.12,0.09,0.12,+0.03,33.33,259000,8,27790,168000,118000,50000,0,0,0,0,0,0,50000
20200430,056808,台積電統一98購06,,,,,0.00,0.00,0,0,0,0,0,0,0,0,0,0,0,0,0
20200430,056809,旺宏統一98購03,1.41,1.41,1.28,1.28,+0.20,18.52,82000,5,106880,0,0,0,0,0,0,13000,69000,-56000,-56000
20200430,05680P,聯發科元大96售12,,,,,0.00,0.00,0,0,0,0,0,0,0,0,0,0,0,0,0
20200430,056810,群創統一9A購01,0.37,0.37,0.37,0.37,0.00,0.00,48000,1,17760,0,0,0,0,0,0,0,48000,-48000,-48000
20200430,056811,健策統一9B購01,0.42,0.48,0.42,0.45,+0.04,9.76,151000,10,69540,0,0,0,0,0,0,89000,10000,79000,79000
20200430,056812,泰鼎統一98購01,1.97,1.98,1.97,1.98,+0.03,1.54,26000,2,51230,0,0,0,0,0,0,0,26000,-26000,-26000
20200430,056813,聯茂統一99購01,1.85,1.85,1.85,1.85,0.00,0.00,15000,1,27750,0,0,0,0,0,0,0,15000,-15000,-15000
20200430,056814,元油2X永豐98購04,,,,,0.00,0.00,0,0,0,0,0,0,0,0,0,0,0,0,0
20200430,056815,元油2X永豐98購05,,,,,0.00,0.00,0,0,0,0,0,0,0,0,0,0,0,0,0
20200430,056816,華通永豐98購02,,,,,0.00,0.00,0,0,0,0,0,0,0,0,0,0,0,0,0
20200430,056817,國巨永豐98購04,1.71,1.77,1.71,1.77,+0.15,9.26,20000,2,34800,0,0,0,0,0,0,0,20000,-20000,-20000
20200430,056818,正崴永豐98購01,1.79,1.79,1.70,1.73,+0.21,13.82,178000,8,304960,0,0,0,0,0,0,118000,55000,63000,63000
20200430,056819,奇力新永豐98購01,0.44,0.48,0.43,0.43,+0.04,10.26,118000,5,54020,0,0,0,0,0,0,0,118000,-118000,-118000
20200430,05681P,大立光元大96售05,3.62,3.62,3.49,3.53,0.00,0.00,36000,4,125870,0,0,0,0,0,0,33000,36000,-3000,-3000
20200430,056820,欣興永豐98購02,3.01,3.01,2.95,2.95,-0.09,-2.96,51000,3,153030,0,0,0,0,0,0,51000,1000,50000,50000
20200430,056821,日電貿永豐98購01,0.57,0.61,0.57,0.58,0.00,0.00,79000,6,47060,0,0,0,0,0,0,2000,77000,-75000,-75000
20200430,056822,佐登永豐98購01,,,,,0.00,0.00,0,0,0,0,0,0,0,0,0,0,0,0,0
20200430,056823,智伸科永豐98購01,0.61,0.70,0.61,0.62,+0.04,6.9,425000,8,292090,0,0,0,0,0,0,10000,415000,-405000,-405000
20200430,056824,元石油富邦9B購01,0.15,0.19,0.15,0.19,+0.06,46.15,60000,3,11000,0,0,0,0,0,0,0,0,0,0
20200430,056825,深中小富邦9B購01,0.56,0.64,0.56,0.64,+0.07,12.28,3000,3,1810,0,0,0,0,0,0,3000,0,3000,3000
20200430,056826,A50正2富邦9B購02,,,,,0.00,0.00,0,0,0,0,0,0,0,0,0,0,0,0,0
20200430,056827,元油2X富邦02購01,0.35,0.38,0.31,0.38,+0.09,31.03,377000,28,135380,0,0,0,0,0,0,0,0,0,0
20200430,056828,國巨富邦9A購03,0.42,0.43,0.41,0.41,+0.01,2.5,128000,7,52780,0,0,0,0,0,0,107000,0,107000,107000
20200430,056829,台積電富邦9A購01,0.53,0.54,0.51,0.51,0.00,0.00,3277000,141,1723980,0,0,0,0,0,0,10000,59000,-49000,-49000
20200430,05682P,大立光元大98售03,,,,,0.00,0.00,0,0,0,0,0,0,0,0,0,0,0,0,0
20200430,056830,友達富邦99購01,,,,,0.00,0.00,0,0,0,0,0,0,0,0,0,0,0,0,0
20200430,056831,元油2X元富98購11,,,,,0.00,0.00,0,0,0,0,0,0,0,0,0,0,0,0,0
20200430,056832,元油2X元富98購12,,,,,0.00,0.00,0,0,0,0,0,0,0,0,0,0,0,0,0
20200430,056833,和大元富9B購01,0.34,0.36,0.33,0.36,0.00,0.00,118000,4,39390,0,0,0,0,0,0,115000,0,115000,115000
20200430,056834,華新元富99購01,,,,,0.00,0.00,0,0,0,0,0,0,0,0,0,0,0,0,0
20200430,056835,聯電元富99購01,,,,,0.00,0.00,0,0,0,0,0,0,0,0,0,0,0,0,0
20200430,056836,國巨元富98購01,,,,,0.00,0.00,0,0,0,0,0,0,0,0,0,0,0,0,0
20200430,056837,國巨元富98購02,,,,,0.00,0.00,0,0,0,0,0,0,0,0,0,0,0,0,0
20200430,056838,旺宏元富98購01,1.98,1.99,1.89,1.92,+0.18,10.34,681000,17,1320710,0,0,0,0,0,0,631000,50000,581000,581000
20200430,056839,台光電元富98購02,2.04,2.25,2.01,2.25,+0.28,14.21,440000,16,933960,0,0,0,0,0,0,56000,384000,-328000,-328000
20200430,05683P,矽創元大96售01,1.47,1.47,1.47,1.47,-0.23,-13.53,10000,1,14700,0,0,0,0,0,0,0,10000,-10000,-10000
20200430,056840,友達元富98購02,,,,,0.00,0.00,0,0,0,0,0,0,0,0,0,0,0,0,0
20200430,056841,友達元富98購03,0.20,0.20,0.20,0.20,0.00,0.00,50000,1,10000,0,0,0,0,0,0,50000,0,50000,50000
20200430,056842,全新元富98購01,0.98,0.98,0.98,0.98,+0.06,6.52,33000,6,32340,0,0,0,0,0,0,33000,0,33000,33000
20200430,056843,冠德元富98購01,,,,,0.00,0.00,0,0,0,0,0,0,0,0,0,0,0,0,0
20200430,056844,欣興元富98購03,4.11,4.38,4.11,4.21,+0.06,1.45,419000,26,1761370,0,0,0,0,0,0,419000,0,419000,419000
20200430,056845,揚明光元富98購01,1.52,1.52,1.51,1.52,-0.03,-1.94,110000,4,166600,0,0,0,0,0,0,110000,0,110000,110000
20200430,056846,晶相光元富98購01,2.55,2.55,2.46,2.46,-0.06,-2.38,148000,10,370500,0,0,0,0,0,0,46000,102000,-56000,-56000
20200430,056847,佐登元富98購01,1.46,1.50,1.37,1.37,-0.06,-4.2,769000,43,1093270,0,0,0,0,0,0,421000,242000,179000,179000
20200430,056848,泰鼎元富98購01,,,,,0.00,0.00,0,0,0,0,0,0,0,0,0,0,0,0,0
20200430,056849,瀚宇博元富98購01,3.34,3.48,3.31,3.43,+0.09,2.69,277000,34,941710,0,0,0,0,0,0,58000,219000,-161000,-161000
20200430,05684P,臺股指元大96售09,,,,,0.00,0.00,0,0,0,0,0,0,0,0,0,0,0,0,0
20200430,056850,彩晶元富99購01,0.71,0.74,0.71,0.74,+0.04,5.71,538000,19,387740,0,0,0,0,0,0,197000,341000,-144000,-144000
20200430,056851,瑞儀元富98購01,2.30,2.31,2.25,2.31,+0.01,0.43,386000,15,878390,0,0,0,0,0,0,120000,266000,-146000,-146000
20200430,056852,矽格元富98購01,2.83,2.83,2.83,2.83,+0.09,3.28,10000,1,28300,0,0,0,0,0,0,10000,10000,0,0
20200430,056853,元油2X中信9B購02,,,,,0.00,0.00,0,0,0,0,0,0,0,0,0,0,0,0,0
20200430,056854,友達中信9A購01,,,,,0.00,0.00,0,0,0,0,0,0,0,0,0,0,0,0,0
20200430,056855,祥碩中信98購02,0.37,0.38,0.25,0.28,-0.06,-17.65,2559000,55,734540,0,0,0,0,0,0,466000,2053000,-1587000,-1587000
20200430,056856,華通群益9A購01,3.26,3.65,3.26,3.65,+0.57,18.51,69000,8,235630,0,0,0,0,0,0,21000,48000,-27000,-27000
20200430,056857,國巨群益99購02,,,,,0.00,0.00,0,0,0,0,0,0,0,0,0,0,0,0,0
20200430,056858,國巨群益99購03,,,,,0.00,0.00,0,0,0,0,0,0,0,0,0,0,0,0,0
20200430,056859,台積電群益98購02,0.55,0.55,0.55,0.55,0.00,0.00,30000,1,16500,0,0,0,0,0,0,30000,0,30000,30000
20200430,05685P,臺股指元大96售10,,,,,0.00,0.00,0,0,0,0,0,0,0,0,0,0,0,0,0
20200430,056860,正崴群益98購01,3.07,3.07,2.97,2.99,+0.41,15.89,574000,14,1720740,0,0,0,0,0,0,504000,70000,434000,434000
20200430,056861,美律群益99購01,,,,,0.00,0.00,0,0,0,0,0,0,0,0,0,0,0,0,0
20200430,056862,聯發科群益98購03,1.89,2.03,1.89,1.97,+0.38,23.9,30000,7,58640,0,0,0,0,0,0,30000,0,30000,30000
20200430,056863,義隆群益98購01,4.79,5.20,4.79,5.20,+0.49,10.4,107000,13,531000,0,0,0,0,0,0,46000,67000,-21000,-21000
20200430,056864,新日興群益99購01,,,,,0.00,0.00,0,0,0,0,0,0,0,0,0,0,0,0,0
20200430,056865,樺漢群益98購01,0.27,0.27,0.27,0.27,0.00,0.00,10000,1,2700,0,0,0,0,0,0,10000,0,10000,10000
20200430,056866,矽創群益98購03,,,,,0.00,0.00,0,0,0,0,0,0,0,0,0,0,0,0,0
20200430,056867,華通麥證98購01,,,,,0.00,0.00,0,0,0,0,0,0,0,0,0,0,0,0,0
20200430,056868,奇力新麥證98購01,,,,,0.00,0.00,0,0,0,0,0,0,0,0,0,0,0,0,0
20200430,056869,國巨日盛99購03,,,,,0.00,0.00,0,0,0,0,0,0,0,0,0,0,0,0,0
20200430,05686P,臺股指元大96售11,,,,,0.00,0.00,0,0,0,0,0,0,0,0,0,0,0,0,0
20200430,056870,全新日盛9A購01,,,,,0.00,0.00,0,0,0,0,0,0,0,0,0,0,0,0,0
20200430,056871,新日興日盛99購01,,,,,0.00,0.00,0,0,0,0,0,0,0,0,0,0,0,0,0
20200430,056872,旺宏凱基98購08,2.31,2.32,2.20,2.20,+0.21,10.55,1542000,15,3440980,0,0,0,0,0,0,1508000,14000,1494000,1494000
20200430,056873,友達凱基98購07,,,,,0.00,0.00,0,0,0,0,0,0,0,0,0,0,0,0,0
20200430,056874,友達凱基98購08,,,,,0.00,0.00,0,0,0,0,0,0,0,0,0,0,0,0,0
20200430,056875,亞光凱基98購03,0.31,0.31,0.31,0.31,0.00,0.00,1000,1,310,0,0,0,0,0,0,1000,0,1000,1000
20200430,056876,群創凱基98購11,,,,,0.00,0.00,0,0,0,0,0,0,0,0,0,0,0,0,0
20200430,056877,群創凱基99購04,,,,,0.00,0.00,0,0,0,0,0,0,0,0,0,0,0,0,0
20200430,056878,元油2X國票99購02,,,,,0.00,0.00,0,0,0,0,0,0,0,0,0,0,0,0,0
20200430,056879,旺宏國票99購02,2.47,2.47,2.47,2.47,+0.40,19.32,7000,1,17290,0,0,0,0,0,0,7000,0,7000,7000
20200430,05687P,臺股指元大96售12,,,,,0.00,0.00,0,0,0,0,0,0,0,0,0,0,0,0,0
20200430,056880,緯穎國票98購02,,,,,0.00,0.00,0,0,0,0,0,0,0,0,0,0,0,0,0
20200430,056881,台灣50康和9A購01,0.24,0.29,0.24,0.29,+0.09,45.0,98000,3,25680,0,0,0,0,0,0,90000,0,90000,90000
20200430,056882,華邦電康和98購01,0.74,0.74,0.74,0.74,0.00,0.00,120000,7,88800,0,0,0,0,0,0,0,120000,-120000,-120000
20200430,056883,美食康和98購01,0.65,0.82,0.65,0.82,+0.19,30.16,154000,6,114460,0,0,0,0,0,0,124000,30000,94000,94000
20200430,056884,元油2X元大99購02,,,,,0.00,0.00,0,0,0,0,0,0,0,0,0,0,0,0,0
20200430,056885,元油2X元大99購03,0.53,0.54,0.53,0.54,+0.12,28.57,50000,3,26700,0,0,0,0,0,0,50000,0,50000,50000
20200430,056886,元油2X元大99購04,,,,,0.00,0.00,0,0,0,0,0,0,0,0,0,0,0,0,0
20200430,056887,元油2X元大99購05,,,,,0.00,0.00,0,0,0,0,0,0,0,0,0,0,0,0,0
20200430,056888,元油2X元大99購06,,,,,0.00,0.00,0,0,0,0,0,0,0,0,0,0,0,0,0
20200430,056889,元油2X元大99購07,,,,,0.00,0.00,0,0,0,0,0,0,0,0,0,0,0,0,0
20200430,05688P,臺股指元大96售13,4.61,4.61,4.58,4.58,0.00,0.00,2000,2,9190,0,0,0,0,0,0,0,2000,-2000,-2000
20200430,056890,國巨元大98購11,2.61,2.61,2.61,2.61,+0.16,6.53,10000,1,26100,0,0,0,0,0,0,10000,0,10000,10000
20200430,056891,國巨元大99購03,,,,,0.00,0.00,0,0,0,0,0,0,0,0,0,0,0,0,0
20200430,056892,旺宏元大9A購02,1.61,1.67,1.58,1.60,+0.26,19.4,30000,4,48200,0,0,0,0,0,0,20000,0,20000,20000
20200430,056893,智邦元大98購02,3.65,3.80,3.38,3.41,-0.08,-2.29,76000,10,270070,0,0,0,0,0,0,52000,45000,7000,7000
20200430,056894,佳世達元大99購01,0.83,0.88,0.83,0.87,+0.08,10.13,286000,19,243870,0,0,0,0,0,0,136000,102000,34000,34000
20200430,056895,技嘉元大98購01,2.37,2.43,2.37,2.43,-0.07,-2.8,18000,4,43020,0,0,0,0,0,0,18000,2000,16000,16000
20200430,056896,南亞科元大98購01,,,,,0.00,0.00,0,0,0,0,0,0,0,0,0,0,0,0,0
20200430,056897,南亞科元大98購02,2.02,2.02,1.91,1.91,+0.02,1.06,53000,7,104780,0,0,0,0,0,0,53000,0,53000,53000
20200430,056898,全新元大98購02,0.74,0.74,0.70,0.71,0.00,0.00,183000,6,133690,0,0,0,0,0,0,159000,24000,135000,135000
20200430,056899,可成元大98購01,2.26,2.26,2.16,2.16,-0.17,-7.3,75000,4,163950,0,0,0,0,0,0,25000,50000,-25000,-25000
20200430,05689P,滬深2X中信97售02,,,,,0.00,0.00,0,0,0,0,0,0,0,0,0,0,0,0,0
20200430,056900,可成元大98購02,2.33,2.33,2.33,2.33,-0.13,-5.28,50000,1,116500,0,0,0,0,0,0,0,50000,-50000,-50000
20200430,056901,華新科元大98購03,,,,,0.00,0.00,0,0,0,0,0,0,0,0,0,0,0,0,0
20200430,056902,大立光元大98購12,2.10,2.10,2.10,2.10,+0.11,5.53,6000,1,12600,0,0,0,0,0,0,0,6000,-6000,-6000
20200430,056903,大立光元大99購04,2.00,2.19,2.00,2.19,+0.23,11.73,30000,7,61620,0,0,0,0,0,0,20000,10000,10000,10000
20200430,056904,大立光元大99購05,0.99,0.99,0.99,0.99,0.00,0.00,5000,1,4950,0,0,0,0,0,0,0,5000,-5000,-5000
20200430,056905,欣興元大98購03,3.78,3.92,3.65,3.65,+0.06,1.67,87000,11,332800,0,0,0,0,0,0,61000,8000,53000,53000
20200430,056906,玉晶光元大9B購01,0.86,0.99,0.86,0.99,+0.19,23.75,51000,6,48390,0,0,0,0,0,0,16000,0,16000,16000
20200430,056907,群創元大9C購04,0.65,0.66,0.65,0.65,+0.03,4.84,28000,3,18260,0,0,0,0,0,0,2000,26000,-24000,-24000
20200430,056908,牧德元大99購03,,,,,0.00,0.00,0,0,0,0,0,0,0,0,0,0,0,0,0
20200430,056909,嘉聯益元大99購03,2.45,2.52,2.40,2.52,+0.18,7.69,338000,30,829930,0,0,0,0,0,0,165000,175000,-10000,-10000
20200430,05690P,友達中信96售02,,,,,0.00,0.00,0,0,0,0,0,0,0,0,0,0,0,0,0
20200430,056910,超眾元大99購02,2.65,2.75,2.55,2.73,+0.22,8.76,156000,13,405730,0,0,0,0,0,0,95000,61000,34000,34000
20200430,056911,緯穎元大99購01,1.71,2.03,1.67,1.94,+0.34,21.25,622000,26,1197060,0,0,0,0,0,0,31000,591000,-560000,-560000
20200430,056912,臺股指元大99購04,3.26,3.35,3.26,3.35,+0.39,13.18,11000,2,36310,0,0,0,0,0,0,0,11000,-11000,-11000
20200430,056913,臺股指元大99購05,1.10,1.12,1.10,1.12,0.00,0.00,32000,2,35400,0,0,0,0,0,0,32000,0,32000,32000
20200430,056914,臺股指元大99購09,2.50,2.50,2.50,2.50,+0.38,17.92,10000,1,25000,0,0,0,0,0,0,10000,0,10000,10000
20200430,056915,上銀兆豐99購01,0.95,1.18,0.94,1.15,+0.27,30.68,39000,6,44610,0,0,0,0,0,0,38000,1000,37000,37000
20200430,056916,台達電兆豐98購02,0.68,0.76,0.65,0.74,+0.13,21.31,512000,27,345580,0,0,0,0,0,0,450000,52000,398000,398000
20200430,056917,國巨兆豐98購03,0.45,0.48,0.45,0.48,+0.07,17.07,15000,2,7050,0,0,0,0,0,0,15000,10000,5000,5000
20200430,056918,台積電兆豐98購01,0.50,0.51,0.50,0.51,+0.05,10.87,16000,2,8120,0,0,0,0,0,0,16000,0,16000,16000
20200430,056919,英業達兆豐98購01,1.51,1.52,1.45,1.52,+0.01,0.66,171000,14,256970,0,0,0,0,0,0,76000,95000,-19000,-19000
20200430,05691P,聯發科中信98售01,,,,,0.00,0.00,0,0,0,0,0,0,0,0,0,0,0,0,0
20200430,056920,友達兆豐98購02,0.17,0.17,0.17,0.17,0.00,0.00,30000,1,5100,0,0,0,0,0,0,30000,0,30000,30000
20200430,056921,京元電兆豐98購01,1.81,1.85,1.80,1.80,+0.05,2.86,511000,12,929100,0,0,0,0,0,0,315000,156000,159000,159000
20200430,056922,全新兆豐99購01,,,,,0.00,0.00,0,0,0,0,0,0,0,0,0,0,0,0,0
20200430,056923,奇力新兆豐99購02,,,,,0.00,0.00,0,0,0,0,0,0,0,0,0,0,0,0,0
20200430,056924,亞光兆豐98購01,0.35,0.35,0.35,0.35,-0.02,-5.41,37000,4,12950,0,0,0,0,0,0,37000,0,37000,37000
20200430,056925,群創兆豐98購03,0.07,0.07,0.06,0.06,0.00,0.00,20000,2,1300,0,0,0,0,0,0,0,10000,-10000,-10000
20200430,056926,日月光兆豐98購01,0.34,0.39,0.34,0.39,+0.07,21.88,20000,4,7300,0,0,0,0,0,0,0,20000,-20000,-20000
20200430,056927,T50反1台新02購01,1.07,1.07,1.07,1.07,-0.17,-13.71,20000,1,21400,0,0,0,0,0,0,20000,0,20000,20000
20200430,056928,旺宏台新98購01,0.59,0.60,0.07,0.07,0.00,0.00,94000,8,39210,0,0,0,0,0,0,10000,84000,-74000,-74000
20200430,056929,華新科台新98購01,0.17,0.17,0.17,0.17,0.00,0.00,10000,1,1700,0,0,0,0,0,0,0,10000,-10000,-10000
20200430,05692P,聯發科中信9A售02,0.95,0.95,0.90,0.90,-0.13,-12.62,6000,4,5570,0,0,0,0,0,0,0,2000,-2000,-2000
20200430,056930,晶豪科台新98購01,3.85,3.85,3.85,3.85,+0.28,7.84,6000,1,23100,0,0,0,0,0,0,6000,0,6000,6000
20200430,056931,智原台新98購01,0.18,0.18,0.18,0.18,-0.55,-75.34,30000,3,5400,0,0,0,0,0,0,0,30000,-30000,-30000
20200430,056932,T50反1元富98購01,,,,,0.00,0.00,0,0,0,0,0,0,0,0,0,0,0,0,0
20200430,056933,國巨元富98購03,,,,,0.00,0.00,0,0,0,0,0,0,0,0,0,0,0,0,0
20200430,056934,國巨元富98購04,0.26,0.26,0.26,0.26,0.00,0.00,15000,2,3900,0,0,0,0,0,0,15000,0,15000,15000
20200430,056935,華新科元富98購02,,,,,0.00,0.00,0,0,0,0,0,0,0,0,0,0,0,0,0
20200430,056936,禾伸堂元富98購01,3.11,3.14,2.97,3.04,+0.10,3.4,114000,9,349990,0,0,0,0,0,0,90000,24000,66000,66000
20200430,056937,智原元富98購01,0.76,0.78,0.74,0.74,0.00,0.00,94000,3,70380,0,0,0,0,0,0,70000,24000,46000,46000
20200430,056938,泰碩元富98購01,,,,,0.00,0.00,0,0,0,0,0,0,0,0,0,0,0,0,0
20200430,056939,康控元富98購01,1.67,1.80,1.67,1.80,+0.36,25.0,586000,29,1010990,0,0,0,0,0,0,183000,403000,-220000,-220000
20200430,05693P,滬深2X凱基98售02,1.65,1.65,1.65,1.65,0.00,0.00,2000,1,3300,0,0,0,0,0,0,2000,0,2000,2000
20200430,056940,嘉聯益元富98購01,2.38,2.44,2.38,2.44,+0.11,4.72,39000,8,93360,0,0,0,0,0,0,30000,9000,21000,21000
20200430,056941,台郡元富9B購01,1.63,1.70,1.63,1.70,+0.09,5.59,31000,2,50600,0,0,0,0,0,0,31000,0,31000,31000
20200430,056942,昇陽半元富98購01,,,,,0.00,0.00,0,0,0,0,0,0,0,0,0,0,0,0,0
20200430,056943,華通統一99購01,1.55,1.79,1.55,1.79,+0.35,24.31,359000,11,599120,0,0,0,0,0,0,43000,316000,-273000,-273000
20200430,056944,鴻海統一98購11,0.97,0.99,0.95,0.99,+0.07,7.61,170000,12,162680,0,0,0,0,0,0,170000,20000,150000,150000
20200430,056945,鴻海統一98購12,,,,,0.00,0.00,0,0,0,0,0,0,0,0,0,0,0,0,0
20200430,056946,國巨統一98購05,1.40,1.47,1.39,1.43,+0.08,5.93,173000,16,246550,0,0,0,0,0,0,49000,124000,-75000,-75000
20200430,056947,國巨統一9A購01,,,,,0.00,0.00,0,0,0,0,0,0,0,0,0,0,0,0,0
20200430,056948,旺宏統一9A購01,,,,,0.00,0.00,0,0,0,0,0,0,0,0,0,0,0,0,0
20200430,056949,義隆統一98購01,2.43,2.65,2.43,2.65,+0.46,21.0,165000,11,419260,0,0,0,0,0,0,0,165000,-165000,-165000
20200430,05694P,台積電凱基96售09,,,,,0.00,0.00,0,0,0,0,0,0,0,0,0,0,0,0,0
20200430,056950,亞光統一99購01,,,,,0.00,0.00,0,0,0,0,0,0,0,0,0,0,0,0,0
20200430,056951,牧德統一99購01,0.72,0.72,0.72,0.72,+0.04,5.88,92000,2,66240,0,0,0,0,0,0,0,92000,-92000,-92000
20200430,056952,元油2X國泰99購01,,,,,0.00,0.00,0,0,0,0,0,0,0,0,0,0,0,0,0
20200430,056953,智邦富邦98購02,1.30,1.39,1.20,1.20,-0.07,-5.51,80000,6,100600,0,0,0,0,0,0,60000,20000,40000,40000
20200430,056954,聯詠富邦9A購01,0.39,0.41,0.38,0.41,0.00,0.00,78000,20,31250,0,0,0,0,0,0,72000,6000,66000,66000
20200430,056955,台灣50永豐98購01,0.08,0.09,0.08,0.09,+0.02,28.57,1302000,27,106210,0,0,0,0,0,0,0,0,0,0
20200430,056956,元油2X永豐99購01,,,,,0.00,0.00,0,0,0,0,0,0,0,0,0,0,0,0,0
20200430,056957,元油2X永豐9A購02,,,,,0.00,0.00,0,0,0,0,0,0,0,0,0,0,0,0,0
20200430,056958,喬山永豐98購01,0.90,1.13,0.90,1.10,+0.23,26.44,428000,15,420120,0,0,0,0,0,0,10000,418000,-408000,-408000
20200430,056959,鴻海永豐98購03,0.95,0.95,0.95,0.95,+0.02,2.15,30000,1,28500,0,0,0,0,0,0,30000,0,30000,30000
20200430,05695P,台積電凱基96售10,,,,,0.00,0.00,0,0,0,0,0,0,0,0,0,0,0,0,0
20200430,056960,光罩永豐98購01,1.22,1.30,1.20,1.24,+0.02,1.64,287000,24,352860,0,0,0,0,0,0,123000,164000,-41000,-41000
20200430,056961,凱美永豐98購01,0.75,0.78,0.72,0.72,+0.01,1.41,522000,17,395220,0,0,0,0,0,0,0,522000,-522000,-522000
20200430,056962,技嘉永豐98購01,0.46,0.46,0.45,0.45,0.00,0.00,17000,2,7760,0,0,0,0,0,0,0,17000,-17000,-17000
20200430,056963,建準永豐98購01,0.85,0.85,0.85,0.85,-0.08,-8.6,105000,5,89250,0,0,0,0,0,0,105000,0,105000,105000
20200430,056964,聯發科永豐98購03,0.82,0.90,0.82,0.90,+0.22,32.35,31000,2,27820,0,0,0,0,0,0,31000,0,31000,31000
20200430,056965,全新永豐98購01,,,,,0.00,0.00,0,0,0,0,0,0,0,0,0,0,0,0,0
20200430,056966,嘉晶永豐98購01,1.73,2.01,1.72,1.88,+0.20,11.9,134000,11,240670,0,0,0,0,0,0,68000,63000,5000,5000
20200430,056967,奇鋐永豐98購01,1.96,2.06,1.92,2.04,+0.09,4.62,31000,9,61660,0,0,0,0,0,0,7000,22000,-15000,-15000
20200430,056968,揚明光永豐98購02,,,,,0.00,0.00,0,0,0,0,0,0,0,0,0,0,0,0,0
20200430,056969,智易永豐98購01,2.41,2.41,2.32,2.32,-0.02,-0.85,73000,10,172070,0,0,0,0,0,0,35000,38000,-3000,-3000
20200430,05696P,南亞科凱基96售01,,,,,0.00,0.00,0,0,0,0,0,0,0,0,0,0,0,0,0
20200430,056970,TPK永豐98購01,0.63,0.63,0.59,0.59,-0.07,-10.61,249000,19,147800,0,0,0,0,0,0,59000,210000,-151000,-151000
20200430,056971,麗豐永豐98購01,0.68,0.78,0.68,0.73,+0.09,14.06,220000,21,159060,0,0,0,0,0,0,122000,98000,24000,24000
20200430,056972,祥碩永豐98購02,0.47,0.47,0.33,0.33,-0.10,-23.26,16000,3,5760,0,0,0,0,0,0,0,16000,-16000,-16000
20200430,056973,T50反1永昌9C購01,,,,,0.00,0.00,0,0,0,0,0,0,0,0,0,0,0,0,0
20200430,056974,臻鼎永昌9C購01,,,,,0.00,0.00,0,0,0,0,0,0,0,0,0,0,0,0,0
20200430,056975,元油2X群益98購03,0.05,0.07,0.05,0.07,+0.02,40.0,339000,7,22750,249000,200000,49000,0,0,0,0,0,0,49000
20200430,056976,喬山群益98購01,,,,,0.00,0.00,0,0,0,0,0,0,0,0,0,0,0,0,0
20200430,056977,國巨群益9A購01,,,,,0.00,0.00,0,0,0,0,0,0,0,0,0,0,0,0,0
20200430,056978,技嘉群益99購01,1.90,1.90,1.86,1.89,-0.05,-2.58,100000,5,187240,0,0,0,0,0,0,2000,100000,-98000,-98000
20200430,056979,微星群益98購01,1.85,1.85,1.82,1.82,0.00,0.00,181000,11,333680,0,0,0,0,0,0,94000,181000,-87000,-87000
20200430,05697P,友達凱基96售01,1.93,1.94,1.91,1.92,-0.02,-1.03,60000,6,115400,0,0,0,0,0,0,0,60000,-60000,-60000
20200430,056980,建準群益98購02,0.45,0.47,0.45,0.47,-0.01,-2.08,416000,5,192940,0,0,0,0,0,0,316000,100000,216000,216000
20200430,056981,全新群益99購03,1.04,1.04,1.00,1.00,-0.07,-6.54,145000,4,146930,0,0,0,0,0,0,145000,0,145000,145000
20200430,056982,華新科群益98購05,,,,,0.00,0.00,0,0,0,0,0,0,0,0,0,0,0,0,0
20200430,056983,大立光群益99購02,1.53,1.70,1.53,1.70,+0.26,18.06,85000,4,135580,0,0,0,0,0,0,25000,60000,-35000,-35000
20200430,056984,嘉晶群益98購01,2.00,2.27,2.00,2.11,+0.14,7.11,115000,8,243020,0,0,0,0,0,0,20000,95000,-75000,-75000
20200430,056985,智原群益98購03,,,,,0.00,0.00,0,0,0,0,0,0,0,0,0,0,0,0,0
20200430,056986,超眾群益98購03,2.65,2.65,2.65,2.65,+0.08,3.11,10000,1,26500,0,0,0,0,0,0,0,10000,-10000,-10000
20200430,056987,南茂群益98購01,0.85,0.91,0.82,0.90,+0.08,9.76,311000,13,269690,0,0,0,0,0,0,77000,261000,-184000,-184000
20200430,056988,聚陽兆豐98購01,0.24,0.26,0.24,0.25,+0.03,13.64,20000,4,4950,0,0,0,0,0,0,10000,10000,0,0
20200430,056989,鴻海兆豐98購02,0.83,0.85,0.83,0.85,+0.02,2.41,20000,3,16800,0,0,0,0,0,0,10000,5000,5000,5000
20200430,05698P,群創凱基96售01,,,,,0.00,0.00,0,0,0,0,0,0,0,0,0,0,0,0,0
20200430,056990,聯發科兆豐98購01,,,,,0.00,0.00,0,0,0,0,0,0,0,0,0,0,0,0,0
20200430,056991,牧德兆豐98購01,0.72,0.77,0.72,0.77,+0.13,20.31,28000,6,20290,0,0,0,0,0,0,0,28000,-28000,-28000
20200430,056992,祥碩兆豐98購01,,,,,0.00,0.00,0,0,0,0,0,0,0,0,0,0,0,0,0
20200430,056993,GIS兆豐99購01,0.62,0.62,0.62,0.62,+0.07,12.73,15000,2,9300,0,0,0,0,0,0,0,15000,-15000,-15000
20200430,056994,緯穎兆豐98購02,0.90,1.01,0.88,0.95,+0.26,37.68,93000,4,83110,0,0,0,0,0,0,91000,2000,89000,89000
20200430,056995,華新科日盛99購01,1.80,1.80,1.66,1.74,-0.01,-0.57,361000,6,625880,0,0,0,0,0,0,100000,261000,-161000,-161000
20200430,056996,矽力日盛99購01,1.85,1.85,1.67,1.78,-0.19,-9.64,456000,18,796040,0,0,0,0,0,0,0,456000,-456000,-456000
20200430,056997,台灣50康和9A購02,0.28,0.32,0.28,0.32,0.00,0.00,60000,4,18600,0,0,0,0,0,0,60000,0,60000,60000
20200430,056998,麗豐康和98購01,,,,,0.00,0.00,0,0,0,0,0,0,0,0,0,0,0,0,0
20200430,056999,元油2X國票98購02,0.05,0.05,0.05,0.05,0.00,0.00,45000,1,2250,0,0,0,0,0,0,0,0,0,0
20200430,05699P,茂林凱基96售05,0.16,0.16,0.16,0.16,0.00,0.00,10000,2,1600,0,0,0,0,0,0,4000,0,4000,4000
20200430,057000,亞德客國票99購01,4.42,5.20,4.16,5.20,+1.01,24.11,96000,17,442340,0,0,0,0,0,0,43000,71000,-28000,-28000
20200430,057001,華邦電國票99購02,0.59,0.61,0.59,0.61,0.00,0.00,199000,8,118990,0,0,0,0,0,0,0,199000,-199000,-199000
20200430,057002,友達國票98購01,,,,,0.00,0.00,0,0,0,0,0,0,0,0,0,0,0,0,0
20200430,057003,立積國票98購01,5.40,6.20,5.40,6.20,+0.85,15.89,141000,15,825550,0,0,0,0,0,0,37000,104000,-67000,-67000
20200430,057004,滬深反中信9A購01,1.18,1.18,1.18,1.18,-0.08,-6.35,2000,1,2360,0,0,0,0,0,0,0,2000,-2000,-2000
20200430,057005,元油2X中信9C購01,0.02,0.20,0.02,0.20,0.00,0.00,6000,2,300,0,0,0,0,0,0,0,0,0,0
20200430,057006,國巨中信98購03,,,,,0.00,0.00,0,0,0,0,0,0,0,0,0,0,0,0,0
20200430,057007,奇力新中信98購04,0.26,0.27,0.25,0.25,+0.02,8.7,171000,6,44820,0,0,0,0,0,0,10000,161000,-151000,-151000
20200430,057008,華新科中信99購02,1.00,1.00,0.91,0.91,-0.07,-7.14,28000,3,25990,0,0,0,0,0,0,20000,8000,12000,12000
20200430,057009,信邦中信99購01,0.95,0.95,0.87,0.91,-0.03,-3.19,445000,13,392210,0,0,0,0,0,0,426000,14000,412000,412000
20200430,05700P,臻鼎凱基96售02,,,,,0.00,0.00,0,0,0,0,0,0,0,0,0,0,0,0,0
20200430,057010,景碩中信98購01,0.63,0.73,0.62,0.71,+0.04,5.97,278000,12,181450,0,0,0,0,0,0,242000,36000,206000,206000
20200430,057011,日月光中信99購01,,,,,0.00,0.00,0,0,0,0,0,0,0,0,0,0,0,0,0
20200430,057012,康控中信98購01,0.32,0.41,0.32,0.41,+0.15,57.69,494000,20,196590,0,0,0,0,0,0,20000,474000,-454000,-454000
20200430,057013,聯發科麥證98購01,2.80,2.87,2.80,2.87,+0.69,31.65,11000,2,31500,11000,0,11000,0,0,0,11000,10000,1000,1000
20200430,057014,元油2X凱基9A購05,,,,,0.00,0.00,0,0,0,0,0,0,0,0,0,0,0,0,0
20200430,057015,元油2X凱基9B購04,,,,,0.00,0.00,0,0,0,0,0,0,0,0,0,0,0,0,0
20200430,057016,中石化凱基9B購01,0.63,0.72,0.63,0.70,+0.07,11.11,348000,28,241530,0,0,0,0,0,0,78000,240000,-162000,-162000
20200430,057017,和大凱基98購01,0.53,0.64,0.53,0.64,+0.21,48.84,245000,9,153650,0,0,0,0,0,0,110000,135000,-25000,-25000
20200430,057018,亞德客凱基98購01,0.90,1.13,0.90,1.13,+0.45,66.18,71000,9,73660,0,0,0,0,0,0,71000,0,71000,71000
20200430,057019,台積電凱基98購14,,,,,0.00,0.00,0,0,0,0,0,0,0,0,0,0,0,0,0
20200430,05701P,彩晶凱基96售01,0.71,0.71,0.71,0.71,0.00,0.00,20000,2,14200,0,0,0,0,0,0,0,20000,-20000,-20000
20200430,057020,台積電凱基99購02,0.44,0.44,0.44,0.44,0.00,0.00,20000,1,8800,0,0,0,0,0,0,20000,20000,0,0
20200430,057021,台積電凱基9A購02,,,,,0.00,0.00,0,0,0,0,0,0,0,0,0,0,0,0,0
20200430,057022,智邦凱基98購04,,,,,0.00,0.00,0,0,0,0,0,0,0,0,0,0,0,0,0
20200430,057023,美律凱基99購02,1.92,1.92,1.92,1.92,0.00,0.00,3000,1,5760,0,0,0,0,0,0,0,3000,-3000,-3000
20200430,057024,義隆凱基99購01,2.66,2.89,2.66,2.89,+0.21,7.84,121000,19,339550,0,0,0,0,0,0,59000,72000,-13000,-13000
20200430,057025,華新科凱基98購04,,,,,0.00,0.00,0,0,0,0,0,0,0,0,0,0,0,0,0
20200430,057026,長榮航凱基98購01,0.39,0.50,0.39,0.49,+0.04,8.89,61000,9,28490,0,0,0,0,0,0,0,0,0,0
20200430,057027,祥碩凱基98購01,0.34,0.34,0.34,0.34,0.00,0.00,122000,2,41480,0,0,0,0,0,0,122000,0,122000,122000
20200430,057028,台郡凱基99購02,3.00,3.00,2.96,3.00,+0.01,0.33,16000,3,47880,0,0,0,0,0,0,3000,13000,-10000,-10000
20200430,057029,緯穎凱基98購04,2.39,2.39,2.39,2.39,+0.26,12.21,5000,1,11950,0,0,0,0,0,0,5000,0,5000,5000
20200430,05702P,矽創凱基96售02,,,,,0.00,0.00,0,0,0,0,0,0,0,0,0,0,0,0,0
20200430,057030,滬深反元大9B購01,,,,,0.00,0.00,0,0,0,0,0,0,0,0,0,0,0,0,0
20200430,057031,滬深反元大9B購02,0.98,0.98,0.98,0.98,-0.07,-6.67,100000,1,98000,0,0,0,0,0,0,100000,0,100000,100000
20200430,057032,A50反1元大9B購01,0.82,0.82,0.82,0.82,0.00,0.00,3000,1,2460,0,0,0,0,0,0,0,3000,-3000,-3000
20200430,057033,A50反1元大9B購02,0.23,0.23,0.23,0.23,-0.03,-11.54,50000,1,11500,0,0,0,0,0,0,50000,0,50000,50000
20200430,057034,道瓊反元大9B購01,,,,,0.00,0.00,0,0,0,0,0,0,0,0,0,0,0,0,0
20200430,057035,元油2X元大9B購03,,,,,0.00,0.00,0,0,0,0,0,0,0,0,0,0,0,0,0
20200430,057036,元油2X元大9B購04,0.05,0.05,0.05,0.05,0.00,0.00,644000,6,32200,0,0,0,0,0,0,0,0,0,0
20200430,057037,元油2X元大9B購05,0.09,0.10,0.09,0.10,+0.02,25.0,50000,4,4800,0,0,0,0,0,0,0,0,0,0
20200430,057038,元油2X元大9B購06,0.09,0.13,0.08,0.13,+0.02,18.18,581000,9,64430,0,0,0,0,0,0,259000,0,259000,259000
20200430,057039,元油2X元大9B購07,0.14,0.16,0.14,0.15,+0.03,25.0,2342000,41,338290,0,0,0,0,0,0,0,0,0,0
20200430,05703P,矽力群益96售03,,,,,0.00,0.00,0,0,0,0,0,0,0,0,0,0,0,0,0
20200430,057040,國巨元大98購12,3.76,3.79,3.76,3.79,+0.11,2.99,7000,2,26500,0,0,0,0,0,0,7000,1000,6000,6000
20200430,057041,國巨元大99購04,1.40,1.40,1.40,1.40,0.00,0.00,13000,1,18200,0,0,0,0,0,0,13000,0,13000,13000
20200430,057042,台積電元大98購10,0.96,0.96,0.96,0.96,0.00,0.00,10000,1,9600,0,0,0,0,0,0,10000,10000,0,0
20200430,057043,台積電元大99購02,0.77,0.80,0.77,0.80,0.00,0.00,46000,2,35480,0,0,0,0,0,0,46000,44000,2000,2000
20200430,057044,旺宏元大98購08,2.41,2.41,2.26,2.26,+0.25,12.44,73000,12,174080,0,0,0,0,0,0,18000,65000,-47000,-47000
20200430,057045,美律元大99購04,1.56,1.77,1.56,1.67,+0.12,7.74,369000,14,606890,0,0,0,0,0,0,93000,300000,-207000,-207000
20200430,057046,奇力新元大99購03,1.39,1.39,1.39,1.39,0.00,0.00,30000,1,41700,0,0,0,0,0,0,30000,0,30000,30000
20200430,057047,華新科元大99購07,,,,,0.00,0.00,0,0,0,0,0,0,0,0,0,0,0,0,0
20200430,057048,新日興元大98購01,1.39,1.39,1.28,1.28,-0.09,-6.57,180000,11,236800,0,0,0,0,0,0,180000,0,180000,180000
20200430,057049,新日興元大98購02,0.73,0.73,0.64,0.64,-0.06,-8.57,125000,9,87310,0,0,0,0,0,0,90000,95000,-5000,-5000
20200430,05704P,矽力群益96售04,0.10,0.14,0.10,0.14,+0.07,100.0,24000,3,2800,0,0,0,0,0,0,14000,0,14000,14000
20200430,057050,群創元大99購03,,,,,0.00,0.00,0,0,0,0,0,0,0,0,0,0,0,0,0
20200430,057051,群創元大9B購03,,,,,0.00,0.00,0,0,0,0,0,0,0,0,0,0,0,0,0
20200430,057052,華擎元大98購01,,,,,0.00,0.00,0,0,0,0,0,0,0,0,0,0,0,0,0
20200430,057053,立積元大98購02,3.22,3.54,3.14,3.24,+0.22,7.28,178000,18,598390,0,0,0,0,0,0,21000,157000,-136000,-136000
20200430,057054,立積元大98購03,2.61,2.94,2.61,2.78,+0.29,11.65,183000,18,492740,0,0,0,0,0,0,123000,60000,63000,63000
20200430,057055,立積元大99購01,2.66,2.91,2.66,2.70,+0.14,5.47,325000,28,898760,0,0,0,0,0,0,95000,223000,-128000,-128000
20200430,057056,立積元大99購02,4.04,4.40,3.98,4.01,+0.20,5.25,154000,23,642720,0,0,0,0,0,0,50000,94000,-44000,-44000
20200430,057057,立積元大9A購01,4.66,5.00,4.66,4.72,+0.32,7.27,35000,10,170490,0,0,0,0,0,0,0,33000,-33000,-33000
20200430,057058,祥碩元大98購04,1.67,1.67,1.43,1.43,-0.27,-15.88,7000,5,11020,0,0,0,0,0,0,0,7000,-7000,-7000
20200430,057059,易華電元大99購01,1.19,1.23,1.19,1.20,+0.06,5.26,202000,6,243400,0,0,0,0,0,0,1000,200000,-199000,-199000
20200430,05705P,上証2X永豐96售03,,,,,0.00,0.00,0,0,0,0,0,0,0,0,0,0,0,0,0
20200430,057060,緯穎元大98購05,1.25,1.48,1.25,1.48,+0.37,33.33,11000,3,15120,0,0,0,0,0,0,11000,0,11000,11000
20200430,057061,華擎國泰9A購01,2.47,2.50,2.36,2.36,-0.01,-0.42,142000,5,343100,0,0,0,0,0,0,92000,50000,42000,42000
20200430,057062,立積國泰99購01,1.77,1.90,1.77,1.86,+0.12,6.9,45000,5,82500,0,0,0,0,0,0,35000,0,35000,35000
20200430,057063,立積國泰9A購01,1.56,1.74,1.56,1.62,+0.12,8.0,111000,17,179860,0,0,0,0,0,0,51000,37000,14000,14000
20200430,057064,華新科富邦9B購01,0.52,0.52,0.52,0.52,0.00,0.00,44000,3,22880,0,0,0,0,0,0,0,0,0,0
20200430,057065,牧德富邦99購01,,,,,0.00,0.00,0,0,0,0,0,0,0,0,0,0,0,0,0
20200430,057066,緯穎富邦99購01,0.34,0.42,0.34,0.41,+0.09,28.13,112000,7,45910,0,0,0,0,0,0,3000,109000,-106000,-106000
20200430,057067,元油2X永豐9B購01,,,,,0.00,0.00,0,0,0,0,0,0,0,0,0,0,0,0,0
20200430,057068,國巨永豐98購06,0.79,0.79,0.79,0.79,+0.12,17.91,7000,1,5530,0,0,0,0,0,0,7000,0,7000,7000
20200430,057069,台積電永豐98購02,,,,,0.00,0.00,0,0,0,0,0,0,0,0,0,0,0,0,0
20200430,05706P,TPK永豐96售02,,,,,0.00,0.00,0,0,0,0,0,0,0,0,0,0,0,0,0
20200430,057070,美律永豐98購02,0.78,0.80,0.78,0.80,+0.12,17.65,149000,4,117930,0,0,0,0,0,0,0,149000,-149000,-149000
20200430,057071,華擎永豐98購02,0.68,0.68,0.60,0.62,-0.01,-1.59,674000,20,419650,0,0,0,0,0,0,426000,248000,178000,178000
20200430,057072,日月光永豐98購01,1.85,2.02,1.85,2.02,+0.18,9.78,579000,17,1084750,0,0,0,0,0,0,500000,79000,421000,421000
20200430,057073,康控永豐98購01,0.65,0.81,0.65,0.79,+0.18,29.51,139000,9,102490,0,0,0,0,0,0,63000,83000,-20000,-20000
20200430,057074,立積永豐98購01,0.83,0.97,0.81,0.87,+0.08,10.13,1718000,64,1568880,0,0,0,0,0,0,730000,948000,-218000,-218000
20200430,057075,嘉聯益永豐98購01,1.36,1.44,1.36,1.44,+0.08,5.88,140000,9,195450,0,0,0,0,0,0,10000,130000,-120000,-120000
20200430,057076,緯穎永豐98購01,2.30,2.46,2.30,2.46,0.00,0.00,43000,4,101900,0,0,0,0,0,0,0,43000,-43000,-43000
20200430,057077,國巨統一98購06,0.94,0.98,0.94,0.96,+0.07,7.87,47000,8,45550,0,0,0,0,0,0,4000,43000,-39000,-39000
20200430,057078,國巨統一9A購02,0.76,0.76,0.63,0.63,0.00,0.00,276000,3,178180,0,0,0,0,0,0,166000,10000,156000,156000
20200430,057079,台積電統一9A購02,,,,,0.00,0.00,0,0,0,0,0,0,0,0,0,0,0,0,0
20200430,05707P,中磊永豐96售01,0.85,0.87,0.85,0.87,0.00,0.00,55000,2,47350,0,0,0,0,0,0,0,55000,-55000,-55000
20200430,057080,華新科統一99購02,,,,,0.00,0.00,0,0,0,0,0,0,0,0,0,0,0,0,0
20200430,057081,大立光統一98購07,0.78,0.78,0.78,0.78,+0.11,16.42,58000,3,45240,0,0,0,0,0,0,0,58000,-58000,-58000
20200430,057082,玉晶光統一9A購04,,,,,0.00,0.00,0,0,0,0,0,0,0,0,0,0,0,0,0
20200430,057083,立積統一98購01,,,,,0.00,0.00,0,0,0,0,0,0,0,0,0,0,0,0,0
20200430,057084,立積統一9B購01,1.56,1.67,1.56,1.58,+0.09,6.04,632000,19,1016230,0,0,0,0,0,0,310000,294000,16000,16000
20200430,057085,立積統一9B購02,0.95,1.10,0.95,1.00,+0.09,9.89,1175000,35,1194940,0,0,0,0,0,0,34000,1129000,-1095000,-1095000
20200430,057086,立積統一9C購01,2.76,2.76,2.76,2.76,+0.15,5.75,20000,1,55200,0,0,0,0,0,0,20000,0,20000,20000
20200430,057087,台郡統一99購01,1.56,1.63,1.56,1.63,+0.06,3.82,24000,3,38140,0,0,0,0,0,0,0,24000,-24000,-24000
20200430,057088,上銀元富98購01,0.55,0.80,0.55,0.75,+0.24,47.06,606000,33,400610,0,0,0,0,0,0,171000,455000,-284000,-284000
20200430,057089,奇力新元富98購01,0.70,0.75,0.70,0.71,+0.03,4.41,276000,16,196520,0,0,0,0,0,0,0,276000,-276000,-276000
20200430,05708P,奇力新國票97售04,0.68,0.70,0.68,0.70,-0.08,-10.26,84000,3,57220,0,0,0,0,0,0,84000,0,84000,84000
20200430,057090,奇力新元富98購02,0.63,0.70,0.63,0.64,+0.01,1.59,154000,14,101970,0,0,0,0,0,0,12000,142000,-130000,-130000
20200430,057091,華新科元富9A購01,,,,,0.00,0.00,0,0,0,0,0,0,0,0,0,0,0,0,0
20200430,057092,健策元富98購01,2.13,2.22,2.12,2.22,+0.14,6.73,135000,9,291890,0,0,0,0,0,0,45000,90000,-45000,-45000
20200430,057093,臻鼎元富98購02,0.75,1.00,0.75,1.00,+0.30,42.86,79000,13,69550,0,0,0,0,0,0,42000,5000,37000,37000
20200430,057094,祥碩元富98購01,0.85,0.85,0.85,0.85,-0.16,-15.84,12000,1,10200,0,0,0,0,0,0,12000,0,12000,12000
20200430,057095,祥碩元富98購02,0.66,0.66,0.56,0.56,-0.09,-13.85,21000,5,12280,0,0,0,0,0,0,5000,16000,-11000,-11000
20200430,057096,緯穎元富98購01,1.91,2.40,1.91,2.25,+0.43,23.63,379000,14,789110,0,0,0,0,0,0,41000,338000,-297000,-297000
20200430,057097,致新元富98購01,3.48,3.63,3.48,3.63,+0.28,8.36,5000,4,17700,0,0,0,0,0,0,0,5000,-5000,-5000
20200430,057098,新光金台新98購01,0.05,0.05,0.05,0.05,0.00,0.00,10000,1,500,0,0,0,0,0,0,0,10000,-10000,-10000
20200430,057099,元油2X中信9B購03,,,,,0.00,0.00,0,0,0,0,0,0,0,0,0,0,0,0,0
20200430,05709P,大立光國票97售01,,,,,0.00,0.00,0,0,0,0,0,0,0,0,0,0,0,0,0
20200430,057100,國巨中信9A購02,,,,,0.00,0.00,0,0,0,0,0,0,0,0,0,0,0,0,0
20200430,057101,新光金中信9A購01,0.71,0.71,0.71,0.71,+0.01,1.43,20000,1,14200,0,0,0,0,0,0,20000,0,20000,20000
20200430,057102,亞光中信9A購01,0.93,0.96,0.92,0.95,+0.05,5.56,436000,26,408400,0,0,0,0,0,0,243000,193000,50000,50000
20200430,057103,禾伸堂中信9A購01,1.53,1.55,1.44,1.50,+0.08,5.63,260000,14,388000,0,0,0,0,0,0,188000,62000,126000,126000
20200430,057104,康友中信99購01,0.16,0.16,0.16,0.16,0.00,0.00,20000,1,3200,0,0,0,0,0,0,20000,0,20000,20000
20200430,057105,致茂群益9A購01,1.20,1.20,1.12,1.12,-0.09,-7.44,218000,7,249710,0,0,0,0,0,0,203000,15000,188000,188000
20200430,057106,美律群益98購03,1.05,1.22,1.05,1.17,+0.10,9.35,398000,8,464620,0,0,0,0,0,0,378000,22000,356000,356000
20200430,057107,華新科群益98購06,1.24,1.24,1.21,1.21,+0.02,1.68,40000,3,49000,0,0,0,0,0,0,30000,10000,20000,20000
20200430,057108,潤泰全群益98購01,0.62,0.62,0.62,0.62,0.00,0.00,20000,1,12400,0,0,0,0,0,0,0,20000,-20000,-20000
20200430,057109,信邦群益98購01,1.94,1.95,1.85,1.91,-0.11,-5.45,218000,13,417240,0,0,0,0,0,0,176000,31000,145000,145000
20200430,05710P,禾伸堂國票97售02,0.33,0.35,0.33,0.35,-0.03,-7.89,405000,9,136850,0,0,0,0,0,0,180000,225000,-45000,-45000
20200430,057110,立積群益98購01,1.57,1.72,1.56,1.62,+0.17,11.72,317000,18,506100,0,0,0,0,0,0,33000,257000,-224000,-224000
20200430,057111,立積群益98購02,4.01,4.47,4.01,4.47,+0.63,16.41,66000,5,271240,0,0,0,0,0,0,50000,16000,34000,34000
20200430,057112,立積群益99購01,2.37,2.85,2.37,2.47,+0.19,8.33,677000,26,1688390,0,0,0,0,0,0,429000,246000,183000,183000
20200430,057113,祥碩群益98購01,2.66,2.66,2.06,2.19,-0.27,-10.98,416000,14,1029380,0,0,0,0,0,0,313000,103000,210000,210000
20200430,057114,台虹群益98購01,,,,,0.00,0.00,0,0,0,0,0,0,0,0,0,0,0,0,0
20200430,057115,元油2X日盛9A購01,,,,,0.00,0.00,0,0,0,0,0,0,0,0,0,0,0,0,0
20200430,057116,鴻海日盛9A購01,0.96,1.00,0.96,1.00,+0.07,7.53,4000,2,3880,0,0,0,0,0,0,4000,0,4000,4000
20200430,057117,開發金日盛9B購01,0.65,0.67,0.60,0.60,0.00,0.00,12000,6,7530,0,0,0,0,0,0,4000,0,4000,4000
20200430,057118,欣興日盛9A購01,2.20,2.20,2.20,2.20,0.00,0.00,100000,1,220000,0,0,0,0,0,0,0,100000,-100000,-100000
20200430,057119,微星康和98購01,,,,,0.00,0.00,0,0,0,0,0,0,0,0,0,0,0,0,0
20200430,05711P,茂林國票97售03,0.62,0.67,0.62,0.66,-0.01,-1.49,571000,18,367540,0,0,0,0,0,0,213000,358000,-145000,-145000
20200430,057120,茂林康和98購01,0.54,0.54,0.54,0.54,-0.07,-11.48,300000,1,162000,0,0,0,0,0,0,300000,0,300000,300000
20200430,057121,立積康和98購01,0.97,1.10,0.97,1.10,+0.14,14.58,41000,6,41460,0,0,0,0,0,0,10000,31000,-21000,-21000
20200430,057122,元油2X凱基9B購05,,,,,0.00,0.00,0,0,0,0,0,0,0,0,0,0,0,0,0
20200430,057123,上銀凱基98購05,3.73,3.73,3.71,3.71,+0.54,17.03,29000,2,107990,0,0,0,0,0,0,29000,0,29000,29000
20200430,057124,為升凱基98購02,0.05,0.06,0.05,0.06,-0.09,-60.0,58000,2,3400,0,0,0,0,0,0,0,0,0,0
20200430,057125,國巨凱基98購12,1.32,1.36,1.32,1.36,+0.10,7.94,266000,2,361720,0,0,0,0,0,0,266000,0,266000,266000
20200430,057126,台積電凱基99購03,,,,,0.00,0.00,0,0,0,0,0,0,0,0,0,0,0,0,0
20200430,057127,旺宏凱基98購09,1.87,1.87,1.87,1.87,+0.29,18.35,45000,1,84150,0,0,0,0,0,0,45000,0,45000,45000
20200430,057128,台光電凱基98購03,2.16,2.35,2.16,2.35,+0.25,11.9,71000,6,157170,0,0,0,0,0,0,38000,43000,-5000,-5000
20200430,057129,聯發科凱基99購03,4.14,4.39,4.14,4.39,+0.62,16.45,45000,5,192650,0,0,0,0,0,0,16000,29000,-13000,-13000
20200430,05712P,友達統一97售03,,,,,0.00,0.00,0,0,0,0,0,0,0,0,0,0,0,0,0
20200430,057130,全新凱基98購03,0.52,0.52,0.50,0.51,+0.01,2.0,80000,9,41000,0,0,0,0,0,0,80000,0,80000,80000
20200430,057131,奇力新凱基98購05,,,,,0.00,0.00,0,0,0,0,0,0,0,0,0,0,0,0,0
20200430,057132,華新科凱基98購05,1.47,1.47,1.47,1.47,+0.05,3.52,10000,1,14700,0,0,0,0,0,0,0,10000,-10000,-10000
20200430,057133,京鼎凱基98購02,,,,,0.00,0.00,0,0,0,0,0,0,0,0,0,0,0,0,0
20200430,057134,茂林凱基98購02,,,,,0.00,0.00,0,0,0,0,0,0,0,0,0,0,0,0,0
20200430,057135,立積凱基98購01,2.42,2.42,2.42,2.42,0.00,0.00,1000,1,2420,0,0,0,0,0,0,0,1000,-1000,-1000
20200430,057136,立積凱基98購02,2.86,3.35,2.86,3.00,+0.31,11.52,187000,31,592210,0,2000,-2000,0,0,0,111000,99000,12000,10000
20200430,057137,鈺齊凱基98購01,0.59,0.59,0.59,0.59,-0.02,-3.28,59000,3,34810,0,0,0,0,0,0,59000,0,59000,59000
20200430,057138,亞德客兆豐98購01,1.30,1.30,1.30,1.30,0.00,0.00,10000,1,13000,0,0,0,0,0,0,10000,0,10000,10000
20200430,057139,華新科兆豐98購02,,,,,0.00,0.00,0,0,0,0,0,0,0,0,0,0,0,0,0
20200430,05713P,大立光統一96售05,,,,,0.00,0.00,0,0,0,0,0,0,0,0,0,0,0,0,0
20200430,057140,宏達電兆豐98購01,,,,,0.00,0.00,0,0,0,0,0,0,0,0,0,0,0,0,0
20200430,057141,嘉聯益兆豐99購01,0.96,1.00,0.96,1.00,+0.06,6.38,274000,7,265780,0,0,0,0,0,0,203000,71000,132000,132000
20200430,057142,力成兆豐98購01,0.32,0.32,0.27,0.27,+0.03,12.5,112000,13,31340,0,0,0,0,0,0,0,70000,-70000,-70000
20200430,057143,台郡兆豐98購01,0.60,0.66,0.60,0.62,-0.01,-1.59,131000,5,80000,0,0,0,0,0,0,101000,10000,91000,91000
20200430,057144,南電兆豐98購01,,,,,0.00,0.00,0,0,0,0,0,0,0,0,0,0,0,0,0
20200430,057145,上銀國票98購03,,,,,0.00,0.00,0,0,0,0,0,0,0,0,0,0,0,0,0
20200430,057146,技嘉國票98購01,1.92,1.95,1.92,1.95,0.00,0.00,40000,3,76850,0,0,0,0,0,0,2000,40000,-38000,-38000
20200430,057147,新日興國票99購01,2.85,2.85,2.63,2.63,-0.27,-9.31,81000,3,226230,0,0,0,0,0,0,81000,0,81000,81000
20200430,057148,玉晶光國票99購04,2.20,2.41,2.20,2.38,+0.22,10.19,96000,33,221330,0,0,0,0,0,0,36000,89000,-53000,-53000
20200430,057149,京鼎國票99購02,1.34,1.55,1.32,1.41,+0.13,10.16,498000,24,706850,0,0,0,0,0,0,225000,457000,-232000,-232000
20200430,05714P,群創統一97售03,,,,,0.00,0.00,0,0,0,0,0,0,0,0,0,0,0,0,0
20200430,057150,貿聯國票99購02,1.72,2.09,1.72,2.09,+0.46,28.22,148000,11,295220,0,0,0,0,0,0,9000,139000,-130000,-130000
20200430,057151,易華電國票99購01,0.93,0.99,0.93,0.95,+0.06,6.74,76000,11,72960,0,0,0,0,0,0,1000,75000,-74000,-74000
20200430,057152,緯穎國票99購03,3.99,4.20,3.99,4.20,0.00,0.00,33000,3,135590,0,0,0,0,0,0,0,33000,-33000,-33000
20200430,057153,祥碩國泰99購01,1.43,1.51,1.02,1.02,-0.32,-23.88,391000,32,524430,0,0,0,0,0,0,364000,16000,348000,348000
20200430,057154,易華電國泰99購01,0.44,0.44,0.44,0.44,0.00,0.00,2000,1,880,0,0,0,0,0,0,2000,0,2000,2000
20200430,057155,元油2X富邦9B購02,0.07,0.07,0.07,0.07,0.00,0.00,2000,1,140,0,0,0,0,0,0,0,0,0,0
20200430,057156,元油2X富邦9C購01,0.19,0.20,0.19,0.19,0.00,0.00,11000,3,2100,0,0,0,0,0,0,0,0,0,0
20200430,057157,群創富邦98購02,,,,,0.00,0.00,0,0,0,0,0,0,0,0,0,0,0,0,0
20200430,057158,義隆永豐99購01,0.90,1.07,0.90,1.06,+0.15,16.48,548000,33,528130,0,0,0,0,0,0,480000,71000,409000,409000
20200430,057159,晶技永豐98購01,,,,,0.00,0.00,0,0,0,0,0,0,0,0,0,0,0,0,0
20200430,05715P,創意元富96售05,,,,,0.00,0.00,0,0,0,0,0,0,0,0,0,0,0,0,0
20200430,057160,佐登永豐98購02,0.56,0.56,0.55,0.56,+0.02,3.7,80000,3,44520,0,0,0,0,0,0,80000,0,80000,80000
20200430,057161,亞德客元大98購02,2.32,2.73,2.14,2.73,+0.58,26.98,359000,44,863810,0,0,0,0,0,0,233000,143000,90000,90000
20200430,057162,上銀元大98購03,2.85,3.16,2.79,3.16,+0.52,19.7,185000,14,549360,0,0,0,0,0,0,62000,123000,-61000,-61000
20200430,057163,上銀元大98購04,1.60,2.04,1.58,1.90,+0.47,32.87,76000,14,138680,0,0,0,0,0,0,14000,62000,-48000,-48000
20200430,057164,國巨元大98購14,2.78,2.82,2.69,2.69,-0.02,-0.74,23000,4,63270,0,0,0,0,0,0,17000,6000,11000,11000
20200430,057165,國巨元大99購05,,,,,0.00,0.00,0,0,0,0,0,0,0,0,0,0,0,0,0
20200430,057166,國巨元大99購06,,,,,0.00,0.00,0,0,0,0,0,0,0,0,0,0,0,0,0
20200430,057167,台積電元大99購03,1.41,1.56,1.41,1.56,+0.28,21.88,105000,8,152360,0,0,0,0,0,0,53000,59000,-6000,-6000
20200430,057168,旺宏元大99購03,1.15,1.15,1.10,1.10,+0.07,6.8,38000,7,42840,0,0,0,0,0,0,38000,1000,37000,37000
20200430,057169,微星元大98購01,2.02,2.07,1.98,2.07,-0.01,-0.48,75000,5,153850,0,0,0,0,0,0,20000,55000,-35000,-35000
20200430,05716P,T50反1元大98售03,,,,,0.00,0.00,0,0,0,0,0,0,0,0,0,0,0,0,0
20200430,057170,瑞昱元大98購01,3.02,3.29,2.93,3.22,+0.46,16.67,705000,82,2161130,0,0,0,0,0,0,488000,285000,203000,203000
20200430,057171,台光電元大9B購01,2.15,2.35,2.13,2.35,+0.25,11.9,295000,24,652040,0,0,0,0,0,0,114000,295000,-181000,-181000
20200430,057172,南亞科元大98購03,1.97,1.97,1.97,1.97,+0.10,5.35,20000,2,39400,0,0,0,0,0,0,20000,0,20000,20000
20200430,057173,南亞科元大98購04,1.76,1.76,1.67,1.67,+0.01,0.6,75000,3,131830,0,0,0,0,0,0,3000,72000,-69000,-69000
20200430,057174,南亞科元大98購05,1.72,1.72,1.69,1.69,+0.05,3.05,71000,2,120080,0,0,0,0,0,0,71000,0,71000,71000
20200430,057175,美律元大98購03,0.66,0.74,0.66,0.74,+0.11,17.46,2000,2,1400,0,0,0,0,0,0,0,2000,-2000,-2000
20200430,057176,全新元大99購02,1.33,1.34,1.32,1.32,-0.04,-2.94,122000,12,162540,0,0,0,0,0,0,122000,0,122000,122000
20200430,057177,奇力新元大99購04,,,,,0.00,0.00,0,0,0,0,0,0,0,0,0,0,0,0,0
20200430,057178,可成元大98購03,2.34,2.34,2.24,2.24,-0.08,-3.45,50000,3,113500,0,0,0,0,0,0,50000,0,50000,50000
20200430,057179,可成元大98購04,2.45,2.45,2.29,2.29,-0.17,-6.91,62000,5,147780,0,0,0,0,0,0,50000,12000,38000,38000
20200430,05717P,鴻海元大97售07,,,,,0.00,0.00,0,0,0,0,0,0,0,0,0,0,0,0,0
20200430,057180,華新科元大99購08,0.92,0.92,0.92,0.92,+0.02,2.22,50000,5,46000,0,0,0,0,0,0,0,50000,-50000,-50000
20200430,057181,亞光元大98購02,1.77,1.84,1.74,1.84,+0.15,8.88,409000,30,726850,0,0,0,0,0,0,189000,222000,-33000,-33000
20200430,057182,禾伸堂元大99購02,,,,,0.00,0.00,0,0,0,0,0,0,0,0,0,0,0,0,0
20200430,057183,玉晶光元大99購07,,,,,0.00,0.00,0,0,0,0,0,0,0,0,0,0,0,0,0
20200430,057184,群創元大98購05,,,,,0.00,0.00,0,0,0,0,0,0,0,0,0,0,0,0,0
20200430,057185,群創元大98購06,,,,,0.00,0.00,0,0,0,0,0,0,0,0,0,0,0,0,0
20200430,057186,群創元大99購04,,,,,0.00,0.00,0,0,0,0,0,0,0,0,0,0,0,0,0
20200430,057187,群創元大9B購04,,,,,0.00,0.00,0,0,0,0,0,0,0,0,0,0,0,0,0
20200430,057188,佐登元大98購01,1.28,1.28,1.28,1.28,+0.06,4.92,32000,3,40960,0,0,0,0,0,0,32000,0,32000,32000
20200430,057189,康控元大98購02,1.75,2.07,1.75,2.07,+0.32,18.29,127000,9,237910,0,0,0,0,0,0,71000,56000,15000,15000
20200430,05718P,國巨元大96售09,,,,,0.00,0.00,0,0,0,0,0,0,0,0,0,0,0,0,0
20200430,057190,立積元大9A購02,1.83,1.83,1.83,1.83,0.00,0.00,10000,1,18300,0,0,0,0,0,0,10000,0,10000,10000
20200430,057191,祥碩元大98購05,3.18,3.19,2.58,2.61,-0.31,-10.62,149000,14,438190,0,0,0,0,0,0,98000,51000,47000,47000
20200430,057192,力成元大98購01,,,,,0.00,0.00,0,0,0,0,0,0,0,0,0,0,0,0,0
20200430,057193,力成元大98購02,,,,,0.00,0.00,0,0,0,0,0,0,0,0,0,0,0,0,0
20200430,057194,南電元大98購01,,,,,0.00,0.00,0,0,0,0,0,0,0,0,0,0,0,0,0
20200430,057195,南茂元大98購01,1.52,1.60,1.46,1.58,+0.12,8.22,735000,71,1130040,0,0,0,0,0,0,255000,585000,-330000,-330000
20200430,057196,茂林台新98購01,,,,,0.00,0.00,0,0,0,0,0,0,0,0,0,0,0,0,0
20200430,057197,立積台新98購01,,,,,0.00,0.00,0,0,0,0,0,0,0,0,0,0,0,0,0
20200430,057198,智伸科統一9B購01,0.41,0.41,0.36,0.36,0.00,0.00,23000,2,8780,0,0,0,0,0,0,13000,0,13000,13000
20200430,057199,台達電元富02購01,1.20,1.31,1.20,1.31,+0.15,12.93,1383000,84,1728070,0,0,0,0,0,0,406000,921000,-515000,-515000
20200430,05719P,可成元大96售03,2.01,2.01,1.98,1.98,+0.20,11.24,63000,2,125130,0,0,0,0,0,0,0,63000,-63000,-63000
20200430,057200,技嘉元富98購01,,,,,0.00,0.00,0,0,0,0,0,0,0,0,0,0,0,0,0
20200430,057201,華擎元富98購01,2.57,2.57,2.39,2.39,+0.02,0.84,169000,6,415310,0,0,0,0,0,0,169000,4000,165000,165000
20200430,057202,TPK元富98購02,1.14,1.15,1.06,1.06,-0.11,-9.4,242000,14,270230,0,0,0,0,0,0,209000,33000,176000,176000
20200430,057203,麗豐元富98購02,0.91,0.96,0.90,0.90,+0.06,7.14,584000,24,545700,0,0,0,0,0,0,136000,448000,-312000,-312000
20200430,057204,利勤元富98購01,,,,,0.00,0.00,0,0,0,0,0,0,0,0,0,0,0,0,0
20200430,057205,元翎元富98購01,,,,,0.00,0.00,0,0,0,0,0,0,0,0,0,0,0,0,0
20200430,057206,立積元富98購01,2.94,3.36,2.91,3.06,+0.19,6.62,1281000,92,4003630,0,0,0,0,0,0,360000,837000,-477000,-477000
20200430,057207,立積元富98購02,3.51,4.15,3.51,3.65,+0.34,10.27,563000,86,2159780,0,0,0,0,0,0,72000,458000,-386000,-386000
20200430,057208,上海銀元富98購01,,,,,0.00,0.00,0,0,0,0,0,0,0,0,0,0,0,0,0
20200430,057209,元油2X第一98購01,,,,,0.00,0.00,0,0,0,0,0,0,0,0,0,0,0,0,0
20200430,05720P,可成中信98售01,0.55,0.57,0.55,0.57,0.00,0.00,30000,3,16800,0,0,0,0,0,0,0,30000,-30000,-30000
20200430,057210,T50反1群益98購01,,,,,0.00,0.00,0,0,0,0,0,0,0,0,0,0,0,0,0
20200430,057211,鴻海群益98購05,2.84,2.96,2.77,2.94,+0.22,8.09,308000,25,876430,0,0,0,0,0,0,177000,157000,20000,20000
20200430,057212,台積電群益98購03,0.30,0.30,0.30,0.30,0.00,0.00,10000,1,3000,0,0,0,0,0,0,10000,0,10000,10000
20200430,057213,華邦電群益98購01,,,,,0.00,0.00,0,0,0,0,0,0,0,0,0,0,0,0,0
20200430,057214,瑞昱群益98購01,3.00,3.25,2.95,3.15,+0.31,10.92,521000,44,1589530,0,0,0,0,0,0,339000,251000,88000,88000
20200430,057215,友達群益98購03,,,,,0.00,0.00,0,0,0,0,0,0,0,0,0,0,0,0,0
20200430,057216,聯發科群益99購01,2.94,3.13,2.94,3.13,+0.48,18.11,106000,10,322550,0,0,0,0,0,0,2000,106000,-104000,-104000
20200430,057217,奇力新群益99購01,,,,,0.00,0.00,0,0,0,0,0,0,0,0,0,0,0,0,0
20200430,057218,可成群益99購03,,,,,0.00,0.00,0,0,0,0,0,0,0,0,0,0,0,0,0
20200430,057219,群創群益98購10,,,,,0.00,0.00,0,0,0,0,0,0,0,0,0,0,0,0,0
20200430,05721P,全新群益98售02,,,,,0.00,0.00,0,0,0,0,0,0,0,0,0,0,0,0,0
20200430,057220,鈺齊群益98購01,,,,,0.00,0.00,0,0,0,0,0,0,0,0,0,0,0,0,0
20200430,057221,華通國票98購03,3.24,3.78,3.24,3.78,+0.54,16.67,44000,15,155460,0,0,0,0,0,0,15000,29000,-14000,-14000
20200430,057222,鴻海國票99購04,2.20,2.20,2.20,2.20,0.00,0.00,48000,2,105600,0,0,0,0,0,0,0,48000,-48000,-48000
20200430,057223,富邦金日盛99購01,0.45,0.48,0.45,0.48,0.00,0.00,63000,4,29140,0,0,0,0,0,0,63000,0,63000,63000
20200430,057224,和碩日盛9A購01,,,,,0.00,0.00,0,0,0,0,0,0,0,0,0,0,0,0,0
20200430,057225,華新凱基98購01,0.72,0.78,0.71,0.73,+0.10,15.87,114000,14,84800,0,0,0,0,0,0,10000,104000,-94000,-94000
20200430,057226,上銀凱基98購06,2.59,3.14,2.59,3.14,+0.73,30.29,94000,14,266600,0,0,0,0,0,0,52000,42000,10000,10000
20200430,057227,台積電凱基98購15,,,,,0.00,0.00,0,0,0,0,0,0,0,0,0,0,0,0,0
20200430,057228,友達凱基9B購01,1.08,1.08,1.08,1.08,0.00,0.00,4000,1,4320,0,0,0,0,0,0,0,4000,-4000,-4000
20200430,057229,友達凱基9B購02,,,,,0.00,0.00,0,0,0,0,0,0,0,0,0,0,0,0,0
20200430,05722P,玉晶光國票97售03,1.29,1.29,1.20,1.20,0.00,0.00,36000,6,46030,0,0,0,0,0,0,0,36000,-36000,-36000
20200430,057230,建準凱基98購02,1.63,1.63,1.56,1.58,-0.19,-10.73,353000,12,556790,0,0,0,0,0,0,306000,47000,259000,259000
20200430,057231,美律凱基98購05,,,,,0.00,0.00,0,0,0,0,0,0,0,0,0,0,0,0,0
20200430,057232,京元電凱基98購02,,,,,0.00,0.00,0,0,0,0,0,0,0,0,0,0,0,0,0
20200430,057233,聯發科凱基98購14,1.70,1.93,1.70,1.91,+0.54,39.42,471000,50,899080,0,0,0,0,0,0,11000,460000,-449000,-449000
20200430,057234,宏達電凱基98購05,1.15,1.15,1.11,1.11,0.00,0.00,20000,2,22600,0,0,0,0,0,0,0,20000,-20000,-20000
20200430,057235,亞光凱基98購04,,,,,0.00,0.00,0,0,0,0,0,0,0,0,0,0,0,0,0
20200430,057236,聯詠凱基98購03,0.67,0.71,0.67,0.71,+0.05,7.58,140000,11,98680,0,0,0,0,0,0,20000,120000,-100000,-100000
20200430,057237,群創凱基9B購02,,,,,0.00,0.00,0,0,0,0,0,0,0,0,0,0,0,0,0
20200430,057238,群創凱基9B購03,,,,,0.00,0.00,0,0,0,0,0,0,0,0,0,0,0,0,0
20200430,057239,貿聯凱基98購05,2.88,2.97,2.88,2.97,0.00,0.00,28000,3,81780,0,0,0,0,0,0,0,28000,-28000,-28000
20200430,05723P,華通永豐96售03,1.20,1.20,1.20,1.20,-0.18,-13.04,8000,1,9600,0,0,0,0,0,0,0,8000,-8000,-8000
20200430,057240,茂林凱基9A購01,0.59,0.59,0.56,0.56,0.00,0.00,306000,2,171540,0,0,0,0,0,0,306000,0,306000,306000
20200430,057241,超眾凱基99購02,5.55,5.55,5.55,5.55,0.00,0.00,10000,1,55500,0,0,0,0,0,0,10000,0,10000,10000
20200430,057242,台郡凱基98購05,,,,,0.00,0.00,0,0,0,0,0,0,0,0,0,0,0,0,0
20200430,057243,樺漢凱基99購01,2.66,2.69,2.66,2.69,+0.06,2.28,30000,2,80400,0,0,0,0,0,0,30000,0,30000,30000
20200430,057244,鈺齊凱基99購01,,,,,0.00,0.00,0,0,0,0,0,0,0,0,0,0,0,0,0
20200430,057245,福懋科台新98購01,0.22,0.22,0.22,0.22,0.00,0.00,10000,2,2200,0,0,0,0,0,0,0,10000,-10000,-10000
20200430,057246,元油2X統一99購01,,,,,0.00,0.00,0,0,0,0,0,0,0,0,0,0,0,0,0
20200430,057247,元油2X統一9A購01,,,,,0.00,0.00,0,0,0,0,0,0,0,0,0,0,0,0,0
20200430,057248,台積電統一98購08,0.63,0.65,0.63,0.65,+0.18,38.3,30000,3,19200,0,0,0,0,0,0,0,30000,-30000,-30000
20200430,057249,華邦電統一9A購01,0.78,0.82,0.78,0.81,+0.07,9.46,1233000,33,977600,0,0,0,0,0,0,337000,891000,-554000,-554000
20200430,05724P,致茂永豐96售01,0.65,0.67,0.65,0.67,0.00,0.00,232000,3,153120,0,0,0,0,0,0,0,232000,-232000,-232000
20200430,057250,大立光統一98購08,,,,,0.00,0.00,0,0,0,0,0,0,0,0,0,0,0,0,0
20200430,057251,泰鼎統一98購02,3.80,3.80,3.69,3.69,-0.25,-6.35,24000,2,89660,0,0,0,0,0,0,10000,14000,-4000,-4000
20200430,057252,牧德元富98購01,0.65,0.69,0.62,0.69,+0.07,11.29,195000,19,128250,0,0,0,0,0,0,45000,150000,-105000,-105000
20200430,057253,高股息中信99購02,0.70,0.77,0.70,0.76,0.00,0.00,47000,5,34180,0,0,0,0,0,0,45000,0,45000,45000
20200430,057254,友達麥證98購01,,,,,0.00,0.00,0,0,0,0,0,0,0,0,0,0,0,0,0
20200430,057255,聯發科麥證98購02,2.12,2.24,2.08,2.24,+0.36,19.15,116000,14,246080,78000,38000,40000,0,0,0,78000,38000,40000,40000
20200430,057256,元油2X兆豐98購01,,,,,0.00,0.00,0,0,0,0,0,0,0,0,0,0,0,0,0
20200430,057257,台泥兆豐99購01,1.68,1.75,1.67,1.75,+0.08,4.79,569000,36,977870,0,0,0,0,0,0,148000,421000,-273000,-273000
20200430,057258,中環兆豐98購01,0.61,0.68,0.60,0.68,+0.08,13.33,668000,24,429610,0,0,0,0,0,0,259000,409000,-150000,-150000
20200430,057259,台積電兆豐98購03,,,,,0.00,0.00,0,0,0,0,0,0,0,0,0,0,0,0,0
20200430,05725P,嘉聯益永豐96售02,,,,,0.00,0.00,0,0,0,0,0,0,0,0,0,0,0,0,0
20200430,057260,微星兆豐98購01,1.23,1.25,1.23,1.25,0.00,0.00,3000,2,3730,0,0,0,0,0,0,1000,2000,-1000,-1000
20200430,057261,瑞昱兆豐98購01,0.92,1.05,0.91,1.05,+0.17,19.32,52000,4,51260,0,0,0,0,0,0,51000,1000,50000,50000
20200430,057262,友達兆豐98購03,0.03,0.03,0.03,0.03,0.00,0.00,10000,1,300,0,0,0,0,0,0,0,10000,-10000,-10000
20200430,057263,可成兆豐99購01,0.63,0.63,0.63,0.63,0.00,0.00,10000,2,6300,0,0,0,0,0,0,0,10000,-10000,-10000
20200430,057264,新光金兆豐98購01,0.12,0.12,0.12,0.12,0.00,0.00,5000,1,600,0,0,0,0,0,0,5000,0,5000,5000
20200430,057265,聯詠兆豐98購01,0.35,0.39,0.33,0.38,+0.01,2.7,155000,19,53430,0,0,0,0,0,0,134000,10000,124000,124000
20200430,057266,TPK兆豐98購02,0.80,0.80,0.73,0.73,-0.06,-7.59,17000,3,13360,0,0,0,0,0,0,17000,0,17000,17000
20200430,057267,康控兆豐99購01,0.75,0.83,0.75,0.81,+0.17,26.56,402000,17,314430,0,0,0,0,0,0,289000,38000,251000,251000
20200430,057268,臻鼎兆豐99購01,0.46,0.58,0.45,0.52,+0.10,23.81,260000,34,128990,0,0,0,0,0,0,162000,26000,136000,136000
20200430,057269,鈺齊兆豐98購01,0.39,0.43,0.39,0.43,-0.02,-4.44,114000,3,45010,0,0,0,0,0,0,104000,10000,94000,94000
20200430,05726P,易華電永豐96售02,,,,,0.00,0.00,0,0,0,0,0,0,0,0,0,0,0,0,0
20200430,057270,遠東新元大98購01,0.80,0.90,0.80,0.90,+0.24,36.36,316000,10,277350,0,0,0,0,0,0,29000,252000,-223000,-223000
20200430,057271,國巨元大98購17,,,,,0.00,0.00,0,0,0,0,0,0,0,0,0,0,0,0,0
20200430,057272,台積電元大98購14,1.70,1.70,1.70,1.70,+0.10,6.25,121000,1,205700,0,0,0,0,0,0,121000,121000,0,0
20200430,057273,智邦元大98購05,7.10,7.40,6.50,6.75,-0.35,-4.93,109000,20,765650,0,0,0,0,0,0,99000,81000,18000,18000
20200430,057274,友達元大98購03,,,,,0.00,0.00,0,0,0,0,0,0,0,0,0,0,0,0,0
20200430,057275,友達元大9A購04,0.58,0.58,0.58,0.58,-0.01,-1.69,27000,1,15660,0,0,0,0,0,0,27000,0,27000,27000
20200430,057276,全新元大99購03,0.81,0.81,0.81,0.81,0.00,0.00,36000,1,29160,0,0,0,0,0,0,36000,0,36000,36000
20200430,057277,可成元大98購05,3.01,3.01,2.83,2.83,-0.17,-5.67,70000,5,204670,0,0,0,0,0,0,12000,60000,-48000,-48000
20200430,057278,可成元大98購06,1.77,1.77,1.63,1.65,-0.10,-5.71,166000,9,283120,0,0,0,0,0,0,66000,100000,-34000,-34000
20200430,057279,國揚元大98購01,6.90,6.90,6.80,6.80,-0.10,-1.45,17000,2,115800,0,0,0,0,0,0,15000,0,15000,15000
20200430,05727P,新光金日盛96售02,,,,,0.00,0.00,0,0,0,0,0,0,0,0,0,0,0,0,0
20200430,057280,大立光元大98購15,1.93,2.04,1.93,2.04,0.00,0.00,23000,5,45450,0,0,0,0,0,0,0,23000,-23000,-23000
20200430,057281,大立光元大98購16,2.15,2.15,2.15,2.15,0.00,0.00,5000,1,10750,0,0,0,0,0,0,0,5000,-5000,-5000
20200430,057282,大立光元大99購06,1.14,1.22,1.14,1.22,+0.14,12.96,89000,16,105850,0,0,0,0,0,0,15000,74000,-59000,-59000
20200430,057283,欣興元大98購07,2.97,3.07,2.86,2.93,+0.11,3.9,489000,42,1452700,0,0,0,0,0,0,444000,46000,398000,398000
20200430,057284,新日興元大98購03,2.44,2.44,2.34,2.34,-0.06,-2.5,78000,9,184440,0,0,0,0,0,0,78000,0,78000,78000
20200430,057285,群創元大98購07,,,,,0.00,0.00,0,0,0,0,0,0,0,0,0,0,0,0,0
20200430,057286,群創元大9B購05,0.43,0.45,0.43,0.45,0.00,0.00,74000,4,32470,0,0,0,0,0,0,73000,1000,72000,72000
20200430,057287,彩晶元大9C購03,1.27,1.30,1.26,1.26,+0.03,2.44,122000,6,156930,0,0,0,0,0,0,24000,98000,-74000,-74000
20200430,057288,聯茂元大98購03,4.24,4.24,3.97,4.19,-0.20,-4.56,148000,9,613270,0,0,0,0,0,0,23000,125000,-102000,-102000
20200430,057289,力成元大98購03,0.75,0.83,0.73,0.81,+0.09,12.5,283000,24,215040,0,0,0,0,0,0,232000,36000,196000,196000
20200430,05728P,滬深2X凱基98售03,,,,,0.00,0.00,0,0,0,0,0,0,0,0,0,0,0,0,0
20200430,057290,元油2X國泰99購02,,,,,0.00,0.00,0,0,0,0,0,0,0,0,0,0,0,0,0
20200430,057291,國巨國泰9A購01,,,,,0.00,0.00,0,0,0,0,0,0,0,0,0,0,0,0,0
20200430,057292,國巨國泰9B購01,,,,,0.00,0.00,0,0,0,0,0,0,0,0,0,0,0,0,0
20200430,057293,力成國泰99購01,,,,,0.00,0.00,0,0,0,0,0,0,0,0,0,0,0,0,0
20200430,057294,台灣50永豐99購01,0.25,0.25,0.25,0.25,+0.08,47.06,10000,1,2500,0,0,0,0,0,0,0,0,0,0
20200430,057295,可成永豐98購02,,,,,0.00,0.00,0,0,0,0,0,0,0,0,0,0,0,0,0
20200430,057296,智原永豐98購01,1.61,1.63,1.61,1.63,+0.04,2.52,36000,4,58660,0,0,0,0,0,0,1000,36000,-35000,-35000
20200430,057297,新日興永豐98購01,,,,,0.00,0.00,0,0,0,0,0,0,0,0,0,0,0,0,0
20200430,057298,旭富永豐98購01,0.92,0.92,0.86,0.87,+0.04,4.82,187000,11,166180,0,0,0,0,0,0,44000,143000,-99000,-99000
20200430,057299,立積永豐98購02,0.78,0.93,0.78,0.82,+0.08,10.81,515000,28,440290,0,0,0,0,0,0,184000,328000,-144000,-144000
20200430,05729P,臺股指凱基97售02,3.78,3.78,3.51,3.52,-0.52,-12.87,159000,21,570750,0,0,0,0,0,0,40000,119000,-79000,-79000
20200430,057300,訊連永豐98購01,0.56,0.56,0.53,0.53,-0.02,-3.64,535000,3,299450,0,0,0,0,0,0,530000,5000,525000,525000
20200430,057301,嘉聯益永豐98購02,1.18,1.20,1.16,1.20,+0.10,9.09,147000,9,173760,0,0,0,0,0,0,36000,115000,-79000,-79000
20200430,057302,福懋科中信98購01,,,,,0.00,0.00,0,0,0,0,0,0,0,0,0,0,0,0,0
20200430,057303,喬山兆豐99購01,0.57,0.70,0.57,0.70,0.00,0.00,45000,13,29350,0,0,0,0,0,0,31000,14000,17000,17000
20200430,057304,為升兆豐99購02,0.11,0.11,0.11,0.11,0.00,0.00,41000,3,4510,0,0,0,0,0,0,0,0,0,0
20200430,057305,南亞科兆豐98購02,0.12,0.12,0.12,0.12,+0.01,9.09,32000,2,3840,0,0,0,0,0,0,30000,2000,28000,28000
20200430,057306,玉晶光兆豐99購01,,,,,0.00,0.00,0,0,0,0,0,0,0,0,0,0,0,0,0
20200430,057307,瀚宇博兆豐99購01,1.18,1.21,1.16,1.21,+0.03,2.54,1081000,34,1286210,0,0,0,0,0,0,38000,1023000,-985000,-985000
20200430,057308,同欣電兆豐99購01,0.27,0.30,0.27,0.30,+0.07,30.43,22000,4,6280,0,0,0,0,0,0,0,22000,-22000,-22000
20200430,057309,南茂兆豐99購01,,,,,0.00,0.00,0,0,0,0,0,0,0,0,0,0,0,0,0
20200430,05730P,臺股指凱基97售03,3.84,3.84,3.84,3.84,-0.49,-11.32,3000,1,11520,0,0,0,0,0,0,0,3000,-3000,-3000
20200430,057310,聯發科日盛99購01,,,,,0.00,0.00,0,0,0,0,0,0,0,0,0,0,0,0,0
20200430,057311,玉晶光日盛9A購01,,,,,0.00,0.00,0,0,0,0,0,0,0,0,0,0,0,0,0
20200430,057312,美律麥證98購01,0.57,0.57,0.56,0.56,+0.08,16.67,138000,2,78260,0,138000,-138000,0,0,0,0,138000,-138000,-138000
20200430,057313,聯發科麥證99購01,4.69,4.92,4.69,4.92,+0.59,13.63,30000,6,143960,11000,19000,-8000,0,0,0,11000,19000,-8000,-8000
20200430,057314,全新麥證98購01,0.32,0.32,0.31,0.32,0.00,0.00,108000,4,34510,3000,105000,-102000,0,0,0,3000,105000,-102000,-102000
20200430,057315,台灣50康和9A購03,0.30,0.40,0.30,0.40,0.00,0.00,81000,2,24400,0,0,0,0,0,0,80000,0,80000,80000
20200430,057316,國巨凱基99購04,0.79,0.80,0.77,0.77,+0.04,5.48,85000,5,65810,0,0,0,0,0,0,50000,35000,15000,15000
20200430,057317,技嘉凱基98購02,,,,,0.00,0.00,0,0,0,0,0,0,0,0,0,0,0,0,0
20200430,057318,台光電凱基9A購01,0.94,1.13,0.94,1.13,0.00,0.00,6000,2,5830,0,0,0,0,0,0,0,6000,-6000,-6000
20200430,057319,奇力新凱基99購02,1.03,1.03,1.03,1.03,0.00,0.00,10000,1,10300,0,0,0,0,0,0,10000,0,10000,10000
20200430,05731P,創意統一96售03,1.40,1.40,1.36,1.36,-0.09,-6.21,94000,11,130760,0,0,0,0,0,0,94000,0,94000,94000
20200430,057320,玉晶光凱基98購01,1.57,1.85,1.56,1.85,+0.32,20.92,205000,16,344600,0,0,0,0,0,0,145000,65000,80000,80000
20200430,057321,台泥群益98購01,4.46,4.65,4.46,4.65,0.00,0.00,80000,5,365470,0,0,0,0,0,0,0,80000,-80000,-80000
20200430,057322,旺宏群益98購04,1.51,1.62,1.51,1.58,+0.27,20.61,9000,4,14250,0,0,0,0,0,0,5000,4000,1000,1000
20200430,057323,智邦群益98購01,8.60,8.65,8.10,8.10,-0.20,-2.41,131000,30,1121400,0,0,0,0,0,0,131000,6000,125000,125000
20200430,057324,億光群益98購01,0.95,0.99,0.95,0.96,+0.04,4.35,67000,4,66100,0,0,0,0,0,0,1000,66000,-65000,-65000
20200430,057325,可成群益9A購01,2.68,2.68,2.60,2.60,-0.12,-4.41,108000,3,285390,0,0,0,0,0,0,0,108000,-108000,-108000
20200430,057326,景碩群益99購02,1.87,1.87,1.87,1.87,+0.25,15.43,1000,1,1870,0,0,0,0,0,0,1000,0,1000,1000
20200430,057327,玉晶光群益9A購04,2.52,2.74,2.52,2.74,+0.24,9.6,197000,18,527400,0,0,0,0,0,0,133000,78000,55000,55000
20200430,057328,京鼎群益99購02,1.28,1.45,1.28,1.45,+0.23,18.85,204000,8,270690,0,0,0,0,0,0,6000,204000,-198000,-198000
20200430,057329,緯穎群益98購02,1.96,2.66,1.96,2.61,+0.77,41.85,262000,10,525000,0,0,0,0,0,0,99000,163000,-64000,-64000
20200430,05732P,臺股指統一96售02,,,,,0.00,0.00,0,0,0,0,0,0,0,0,0,0,0,0,0
20200430,057330,台積電國票99購03,,,,,0.00,0.00,0,0,0,0,0,0,0,0,0,0,0,0,0
20200430,057331,台積電國票99購04,6.85,6.85,6.85,6.85,+0.25,3.79,1000,1,6850,0,0,0,0,0,0,1000,0,1000,1000
20200430,057332,旺宏國票99購03,2.85,2.91,2.74,2.79,+0.23,8.98,2368000,25,6620860,0,0,0,0,0,0,1676000,609000,1067000,1067000
20200430,057333,智邦國票99購01,,,,,0.00,0.00,0,0,0,0,0,0,0,0,0,0,0,0,0
20200430,057334,技嘉國票98購02,2.05,2.05,1.98,2.00,0.00,0.00,17000,3,34730,0,0,0,0,0,0,2000,17000,-15000,-15000
20200430,057335,技嘉國票99購01,,,,,0.00,0.00,0,0,0,0,0,0,0,0,0,0,0,0,0
20200430,057336,聯發科國票99購01,,,,,0.00,0.00,0,0,0,0,0,0,0,0,0,0,0,0,0
20200430,057337,聯發科國票99購02,,,,,0.00,0.00,0,0,0,0,0,0,0,0,0,0,0,0,0
20200430,057338,群創國票99購01,,,,,0.00,0.00,0,0,0,0,0,0,0,0,0,0,0,0,0
20200430,057339,群創國票99購02,,,,,0.00,0.00,0,0,0,0,0,0,0,0,0,0,0,0,0
20200430,05733P,臺股指統一96售03,,,,,0.00,0.00,0,0,0,0,0,0,0,0,0,0,0,0,0
20200430,057340,玉晶光元富98購04,2.33,2.61,2.33,2.61,+0.42,19.18,274000,26,671350,0,0,0,0,0,0,140000,224000,-84000,-84000
20200430,057341,技嘉台新98購01,0.17,0.17,0.17,0.17,0.00,0.00,10000,1,1700,0,0,0,0,0,0,0,10000,-10000,-10000
20200430,057342,玉晶光台新98購01,0.17,0.17,0.17,0.17,0.00,0.00,10000,1,1700,0,0,0,0,0,0,0,10000,-10000,-10000
20200430,057343,道瓊反統一9A購01,,,,,0.00,0.00,0,0,0,0,0,0,0,0,0,0,0,0,0
20200430,057344,元油2X統一98購03,,,,,0.00,0.00,0,0,0,0,0,0,0,0,0,0,0,0,0
20200430,057345,中50統一98購01,,,,,0.00,0.00,0,0,0,0,0,0,0,0,0,0,0,0,0
20200430,057346,鴻海統一98購13,1.34,1.34,1.34,1.34,0.00,0.00,22000,1,29480,0,0,0,0,0,0,0,22000,-22000,-22000
20200430,057347,國巨統一9A購03,0.83,0.86,0.80,0.83,+0.08,10.67,3790000,56,3161830,0,0,0,0,0,0,272000,3518000,-3246000,-3246000
20200430,057348,台積電統一98購09,0.25,0.25,0.21,0.21,+0.03,16.67,57000,5,13850,0,0,0,0,0,0,57000,0,57000,57000
20200430,057349,聯發科統一98購04,1.88,1.88,1.88,1.88,+0.23,13.94,10000,1,18800,0,0,0,0,0,0,10000,0,10000,10000
20200430,05734P,臺股指統一96售04,3.44,3.44,3.44,3.44,-0.33,-8.75,10000,1,34400,0,0,0,0,0,0,10000,0,10000,10000
20200430,057350,全新統一98購03,,,,,0.00,0.00,0,0,0,0,0,0,0,0,0,0,0,0,0
20200430,057351,奇力新統一98購02,0.69,0.72,0.69,0.69,+0.06,9.52,155000,10,108900,0,0,0,0,0,0,95000,50000,45000,45000
20200430,057352,大立光統一9A購02,1.93,1.93,1.93,1.93,+0.28,16.97,48000,1,92640,0,0,0,0,0,0,48000,0,48000,48000
20200430,057353,玉晶光統一99購01,1.11,1.22,0.44,1.22,+0.13,11.93,92000,9,106300,0,0,0,0,0,0,46000,46000,0,0
20200430,057354,聯鈞統一99購03,1.54,1.54,1.41,1.41,0.00,0.00,12000,2,17830,0,0,0,0,0,0,5000,7000,-2000,-2000
20200430,057355,彩晶統一98購03,0.37,0.39,0.37,0.39,+0.02,5.41,95000,6,36730,0,0,0,0,0,0,15000,80000,-65000,-65000
20200430,057356,彩晶統一98購04,0.69,0.73,0.68,0.73,+0.04,5.8,344000,8,239540,0,0,0,0,0,0,222000,122000,100000,100000
20200430,057357,超眾統一98購01,1.41,1.41,1.41,1.41,+0.08,6.02,35000,1,49350,0,0,0,0,0,0,0,35000,-35000,-35000
20200430,057358,元油2X元大98購08,,,,,0.00,0.00,0,0,0,0,0,0,0,0,0,0,0,0,0
20200430,057359,元油2X元大98購09,,,,,0.00,0.00,0,0,0,0,0,0,0,0,0,0,0,0,0
20200430,05735P,臺股指統一96售05,,,,,0.00,0.00,0,0,0,0,0,0,0,0,0,0,0,0,0
20200430,057360,元油2X元大98購10,,,,,0.00,0.00,0,0,0,0,0,0,0,0,0,0,0,0,0
20200430,057361,元油2X元大98購11,,,,,0.00,0.00,0,0,0,0,0,0,0,0,0,0,0,0,0
20200430,057362,元油2X元大98購12,0.05,0.06,0.05,0.06,+0.01,20.0,60000,4,3200,0,0,0,0,0,0,0,0,0,0
20200430,057363,華通元大99購02,4.91,5.35,4.91,5.35,+0.56,11.69,80000,9,407690,0,0,0,0,0,0,66000,25000,41000,41000
20200430,057364,國巨元大98購18,2.00,2.00,2.00,2.00,+0.06,3.09,1000,1,2000,0,0,0,0,0,0,1000,1000,0,0
20200430,057365,智邦元大98購07,7.40,7.70,7.15,7.15,0.00,0.00,34000,7,251500,0,0,0,0,0,0,32000,5000,27000,27000
20200430,057366,智邦元大98購08,4.33,4.48,3.95,4.01,-0.19,-4.52,156000,21,641340,0,0,0,0,0,0,81000,85000,-4000,-4000
20200430,057367,技嘉元大98購02,1.70,1.70,1.70,1.70,0.00,0.00,1000,1,1700,0,0,0,0,0,0,1000,1000,0,0
20200430,057368,微星元大98購02,2.05,2.05,2.04,2.04,+0.02,0.99,105000,3,214700,0,0,0,0,0,0,5000,105000,-100000,-100000
20200430,057369,奇力新元大99購05,2.37,2.48,2.37,2.48,+0.20,8.77,28000,3,68070,0,0,0,0,0,0,10000,18000,-8000,-8000
20200430,05736P,臺股指統一96售06,,,,,0.00,0.00,0,0,0,0,0,0,0,0,0,0,0,0,0
20200430,057370,可成元大98購07,,,,,0.00,0.00,0,0,0,0,0,0,0,0,0,0,0,0,0
20200430,057371,可成元大98購08,2.82,2.82,2.63,2.63,-0.14,-5.05,71000,5,194080,0,0,0,0,0,0,61000,10000,51000,51000
20200430,057372,華新科元大99購10,,,,,0.00,0.00,0,0,0,0,0,0,0,0,0,0,0,0,0
20200430,057373,大立光元大98購17,1.99,2.00,1.99,2.00,+0.04,2.04,12000,3,23960,0,0,0,0,0,0,12000,0,12000,12000
20200430,057374,禾伸堂元大99購03,2.70,2.70,2.56,2.61,+0.06,2.35,130000,5,344840,0,0,0,0,0,0,11000,119000,-108000,-108000
20200430,057375,欣興元大98購09,3.41,3.52,3.35,3.42,+0.21,6.54,237000,23,808740,0,0,0,0,0,0,237000,2000,235000,235000
20200430,057376,新日興元大98購04,1.96,1.96,1.76,1.76,-0.17,-8.81,155000,12,292720,0,0,0,0,0,0,105000,50000,55000,55000
20200430,057377,康控元大99購02,1.33,1.59,1.33,1.59,+0.32,25.2,729000,47,1109890,0,0,0,0,0,0,496000,424000,72000,72000
20200430,057378,康友元大98購02,0.84,0.88,0.84,0.88,+0.10,12.82,110000,5,93800,0,0,0,0,0,0,10000,100000,-90000,-90000
20200430,057379,寶成元大98購02,,,,,0.00,0.00,0,0,0,0,0,0,0,0,0,0,0,0,0
20200430,05737P,臺股指統一96售07,,,,,0.00,0.00,0,0,0,0,0,0,0,0,0,0,0,0,0
20200430,057380,技嘉國泰9A購01,0.89,0.89,0.89,0.89,0.00,0.00,30000,2,26700,0,0,0,0,0,0,0,30000,-30000,-30000
20200430,057381,微星國泰9A購01,,,,,0.00,0.00,0,0,0,0,0,0,0,0,0,0,0,0,0
20200430,057382,聯發科國泰9A購01,,,,,0.00,0.00,0,0,0,0,0,0,0,0,0,0,0,0,0
20200430,057383,玉晶光富邦9A購01,0.82,0.86,0.82,0.86,+0.08,10.26,50000,5,41600,0,0,0,0,0,0,50000,0,50000,50000
20200430,057384,台灣50永豐99購02,0.14,0.14,0.14,0.14,+0.05,55.56,5000,1,700,0,0,0,0,0,0,5000,0,5000,5000
20200430,057385,光罩永豐99購01,0.62,0.65,0.59,0.64,+0.02,3.23,100000,13,62360,0,0,0,0,0,0,40000,60000,-20000,-20000
20200430,057386,聯發科永豐98購04,2.98,3.09,2.98,3.09,+0.36,13.19,34000,8,103310,0,0,0,0,0,0,5000,30000,-25000,-25000
20200430,057387,奇力新永豐98購03,0.50,0.54,0.50,0.54,+0.08,17.39,219000,3,114860,0,0,0,0,0,0,85000,134000,-49000,-49000
20200430,057388,奇鋐永豐98購02,2.85,3.01,2.82,2.97,+0.09,3.12,24000,8,69340,0,0,0,0,0,0,1000,23000,-22000,-22000
20200430,057389,玉晶光永豐98購06,0.63,0.74,0.63,0.74,+0.14,23.33,212000,5,144580,0,0,0,0,0,0,61000,151000,-90000,-90000
20200430,05738P,臺股指統一97售01,,,,,0.00,0.00,0,0,0,0,0,0,0,0,0,0,0,0,0
20200430,057390,台表科永豐98購01,0.56,0.59,0.56,0.59,+0.01,1.72,266000,15,152540,0,0,0,0,0,0,130000,130000,0,0
20200430,057391,樺漢永豐98購01,0.11,0.11,0.11,0.11,0.00,0.00,100000,9,11000,0,0,0,0,0,0,0,100000,-100000,-100000
20200430,057392,福懋科永豐98購01,,,,,0.00,0.00,0,0,0,0,0,0,0,0,0,0,0,0,0
20200430,057393,台積電中信02購01,0.43,0.48,0.43,0.44,+0.03,7.32,1638000,90,751740,0,0,0,0,0,0,1416000,225000,1191000,1191000
20200430,057394,台積電中信9C購02,0.34,0.36,0.34,0.36,+0.05,16.13,180000,18,63500,0,0,0,0,0,0,180000,180000,0,0
20200430,057395,旺宏中信98購03,0.20,0.20,0.18,0.18,+0.03,20.0,906000,11,169230,0,0,0,0,0,0,635000,271000,364000,364000
20200430,057396,健鼎中信99購01,0.48,0.48,0.48,0.48,+0.09,23.08,2000,1,960,0,0,0,0,0,0,0,0,0,0
20200430,057397,茂林中信9A購01,0.98,0.99,0.97,0.98,-0.03,-2.97,109000,9,107020,0,0,0,0,0,0,109000,0,109000,109000
20200430,057398,台郡中信99購01,,,,,0.00,0.00,0,0,0,0,0,0,0,0,0,0,0,0,0
20200430,057399,滬深反群益9C購01,0.77,0.78,0.77,0.78,-0.06,-7.14,35000,2,27050,0,0,0,0,0,0,35000,0,35000,35000
20200430,05739P,臺股指統一97售02,,,,,0.00,0.00,0,0,0,0,0,0,0,0,0,0,0,0,0
20200430,057400,全新群益9A購01,,,,,0.00,0.00,0,0,0,0,0,0,0,0,0,0,0,0,0
20200430,057401,晶豪科群益99購01,4.57,4.67,4.29,4.29,-0.03,-0.69,166000,10,758680,0,0,0,0,0,0,160000,6000,154000,154000
20200430,057402,嘉晶群益98購02,1.25,1.48,1.25,1.37,0.00,0.00,245000,14,325860,0,0,0,0,0,0,0,245000,-245000,-245000
20200430,057403,亞光群益98購04,1.74,1.83,1.68,1.76,+0.03,1.73,542000,21,948500,0,0,0,0,0,0,249000,317000,-68000,-68000
20200430,057404,貿聯群益99購01,1.20,1.42,1.20,1.41,+0.29,25.89,267000,11,351020,0,0,0,0,0,0,0,267000,-267000,-267000
20200430,057405,麗豐群益98購01,0.85,0.89,0.85,0.88,+0.14,18.92,175000,6,153530,0,0,0,0,0,0,0,175000,-175000,-175000
20200430,057406,茂林群益98購03,0.75,0.75,0.75,0.75,-0.05,-6.25,2000,1,1500,0,0,0,0,0,0,2000,0,2000,2000
20200430,057407,超眾群益99購01,1.28,1.28,1.28,1.28,+0.06,4.92,65000,2,83200,0,0,0,0,0,0,0,65000,-65000,-65000
20200430,057408,台郡群益98購01,0.55,0.56,0.52,0.53,0.00,0.00,64000,7,34510,0,0,0,0,0,0,30000,31000,-1000,-1000
20200430,057409,台虹群益98購02,,,,,0.00,0.00,0,0,0,0,0,0,0,0,0,0,0,0,0
20200430,05740P,宏達電元富96售01,,,,,0.00,0.00,0,0,0,0,0,0,0,0,0,0,0,0,0
20200430,057410,南電群益98購01,,,,,0.00,0.00,0,0,0,0,0,0,0,0,0,0,0,0,0
20200430,057411,臺股指群益99購05,0.28,0.34,0.28,0.34,+0.11,47.83,12000,4,3720,0,0,0,0,0,0,9000,0,9000,9000
20200430,057412,臺股指群益99購06,,,,,0.00,0.00,0,0,0,0,0,0,0,0,0,0,0,0,0
20200430,057413,臺股指群益9C購04,4.74,4.97,4.74,4.97,+0.38,8.28,22000,3,107480,0,0,0,0,0,0,2000,20000,-18000,-18000
20200430,057414,華新科日盛9A購01,0.96,0.97,0.96,0.97,+0.03,3.19,40000,4,38700,0,0,0,0,0,0,0,40000,-40000,-40000
20200430,057415,和碩日盛98購01,,,,,0.00,0.00,0,0,0,0,0,0,0,0,0,0,0,0,0
20200430,057416,T50反1凱基9C購01,0.90,0.93,0.85,0.93,0.00,0.00,21000,3,18180,0,0,0,0,0,0,15000,1000,14000,14000
20200430,057417,國巨凱基9A購03,0.47,0.47,0.47,0.47,+0.13,38.24,1000,1,470,0,0,0,0,0,0,0,1000,-1000,-1000
20200430,057418,台光電凱基98購04,,,,,0.00,0.00,0,0,0,0,0,0,0,0,0,0,0,0,0
20200430,057419,奇力新凱基98購06,0.84,0.84,0.83,0.83,0.00,0.00,16000,2,13340,0,0,0,0,0,0,0,16000,-16000,-16000
20200430,05741P,聯發科元大96售14,1.00,1.00,0.95,0.95,-0.57,-37.5,5000,2,4900,0,0,0,0,0,0,0,5000,-5000,-5000
20200430,057420,美食凱基98購01,0.72,0.90,0.71,0.89,+0.21,30.88,463000,18,381740,0,0,0,0,0,0,132000,331000,-199000,-199000
20200430,057421,智原凱基98購04,1.90,1.91,1.89,1.91,+0.06,3.24,65000,6,123660,0,0,0,0,0,0,49000,16000,33000,33000
20200430,057422,欣興凱基98購04,2.29,2.29,2.27,2.27,+0.03,1.34,11000,2,25070,0,0,0,0,0,0,11000,0,11000,11000
20200430,057423,台郡凱基98購06,1.27,1.35,1.27,1.35,+0.14,11.57,90000,5,119100,0,0,0,0,0,0,0,90000,-90000,-90000
20200430,057424,訊芯凱基98購04,0.72,0.74,0.72,0.73,+0.06,8.96,79000,7,58210,0,0,0,0,0,0,20000,59000,-39000,-39000
20200430,057425,臺股指凱基9C購02,0.26,0.96,0.26,0.60,+0.35,140.0,122000,18,58370,0,0,0,0,0,0,0,0,0,0
20200430,057426,元油2X兆豐9B購01,0.13,0.15,0.12,0.15,+0.04,36.36,211000,4,27370,0,0,0,0,0,0,0,0,0,0
20200430,057427,華通兆豐99購01,0.45,0.57,0.45,0.55,+0.13,30.95,65000,9,34050,0,0,0,0,0,0,55000,10000,45000,45000
20200430,057428,正崴兆豐98購01,1.12,1.13,1.06,1.10,+0.15,15.79,677000,33,729790,0,0,0,0,0,0,606000,12000,594000,594000
20200430,057429,華新科兆豐98購03,0.55,0.55,0.52,0.52,+0.03,6.12,14000,2,7400,0,0,0,0,0,0,14000,10000,4000,4000
20200430,05742P,可成元大96售04,0.83,0.83,0.83,0.83,0.00,0.00,5000,1,4150,0,0,0,0,0,0,0,5000,-5000,-5000
20200430,057430,富邦金兆豐98購01,0.30,0.34,0.30,0.34,+0.09,36.0,155000,5,51130,0,0,0,0,0,0,1000,154000,-153000,-153000
20200430,057431,京鼎兆豐98購02,0.62,0.81,0.61,0.71,+0.13,22.41,151000,18,107640,0,0,0,0,0,0,46000,85000,-39000,-39000
20200430,057432,T50反1國票9B購01,,,,,0.00,0.00,0,0,0,0,0,0,0,0,0,0,0,0,0
20200430,057433,上銀國票98購04,3.21,3.61,3.19,3.61,+0.57,18.75,38000,4,125400,0,0,0,0,0,0,28000,10000,18000,18000
20200430,057434,國巨國票99購03,,,,,0.00,0.00,0,0,0,0,0,0,0,0,0,0,0,0,0
20200430,057435,旺宏國票99購04,,,,,0.00,0.00,0,0,0,0,0,0,0,0,0,0,0,0,0
20200430,057436,義隆國票99購02,3.28,3.60,3.17,3.60,+0.38,11.8,72000,6,233370,0,0,0,0,0,0,23000,49000,-26000,-26000
20200430,057437,可成國票99購01,,,,,0.00,0.00,0,0,0,0,0,0,0,0,0,0,0,0,0
20200430,057438,禾伸堂國票99購01,2.76,2.83,2.59,2.60,-0.06,-2.26,180000,14,496990,0,0,0,0,0,0,110000,70000,40000,40000
20200430,057439,元油2X統一99購02,0.94,0.97,0.94,0.97,0.00,0.00,100000,2,95500,0,0,0,0,0,0,0,100000,-100000,-100000
20200430,05743P,創意元大96售01,,,,,0.00,0.00,0,0,0,0,0,0,0,0,0,0,0,0,0
20200430,057440,台積電統一98購10,0.33,0.42,0.33,0.42,0.00,0.00,24000,2,8460,0,0,0,0,0,0,18000,0,18000,18000
20200430,057441,奇力新統一98購03,,,,,0.00,0.00,0,0,0,0,0,0,0,0,0,0,0,0,0
20200430,057442,玉晶光統一98購03,0.83,0.83,0.80,0.80,0.00,0.00,12000,2,9900,0,0,0,0,0,0,12000,0,12000,12000
20200430,057443,臺股指統一99購04,,,,,0.00,0.00,0,0,0,0,0,0,0,0,0,0,0,0,0
20200430,057444,台泥元富98購01,,,,,0.00,0.00,0,0,0,0,0,0,0,0,0,0,0,0,0
20200430,057445,華通元富02購01,,,,,0.00,0.00,0,0,0,0,0,0,0,0,0,0,0,0,0
20200430,057446,旺宏元富02購01,2.57,2.59,2.48,2.48,+0.14,5.98,235000,16,594620,0,0,0,0,0,0,149000,86000,63000,63000
20200430,057447,智邦元富02購01,3.94,4.14,3.69,3.69,-0.39,-9.56,399000,48,1575590,0,0,0,0,0,0,368000,16000,352000,352000
20200430,057448,致茂元富98購01,,,,,0.00,0.00,0,0,0,0,0,0,0,0,0,0,0,0,0
20200430,057449,華新科元富99購02,3.46,3.48,3.29,3.39,+0.30,9.71,19000,5,64850,0,0,0,0,0,0,16000,3000,13000,13000
20200430,05744P,台表科元大96售04,1.92,2.00,1.92,2.00,-0.03,-1.48,79000,5,155320,0,0,0,0,0,0,28000,51000,-23000,-23000
20200430,057450,國泰金元富98購01,2.32,2.48,2.30,2.46,+0.39,18.84,552000,37,1293480,0,0,0,0,0,0,144000,408000,-264000,-264000
20200430,057451,大立光元富9B購01,2.14,2.40,2.14,2.40,+0.32,15.38,424000,28,955250,0,0,0,0,0,0,212000,212000,0,0
20200430,057452,新日興元富98購01,1.03,1.03,0.99,0.99,-0.03,-2.94,58000,4,58460,0,0,0,0,0,0,48000,10000,38000,38000
20200430,057453,矽創元富98購01,1.12,1.12,1.12,1.12,0.00,0.00,1000,1,1120,0,0,0,0,0,0,0,1000,-1000,-1000
20200430,057454,上銀國泰99購02,1.41,1.78,1.38,1.77,+0.45,34.09,570000,51,872310,0,0,0,0,0,0,336000,257000,79000,79000
20200430,057455,景碩國泰99購01,,,,,0.00,0.00,0,0,0,0,0,0,0,0,0,0,0,0,0
20200430,057456,道瓊銀富邦9C購01,,,,,0.00,0.00,0,0,0,0,0,0,0,0,0,0,0,0,0
20200430,057457,華邦電富邦98購01,1.19,1.19,1.19,1.19,+0.12,11.21,1000,1,1190,0,0,0,0,0,0,0,1000,-1000,-1000
20200430,057458,TPK富邦9A購01,0.41,0.44,0.41,0.44,0.00,0.00,7000,4,2990,0,0,0,0,0,0,0,0,0,0
20200430,057459,臺股指富邦99購03,,,,,0.00,0.00,0,0,0,0,0,0,0,0,0,0,0,0,0
20200430,05745P,富邦金兆豐96售02,,,,,0.00,0.00,0,0,0,0,0,0,0,0,0,0,0,0,0
20200430,057460,楠梓電永豐98購03,1.04,1.04,1.04,1.04,-0.04,-3.7,40000,5,41600,0,0,0,0,0,0,40000,6000,34000,34000
20200430,057461,國巨永豐98購07,0.28,0.28,0.28,0.28,0.00,0.00,110000,2,30800,0,0,0,0,0,0,110000,0,110000,110000
20200430,057462,光磊永豐98購02,1.29,1.31,1.28,1.28,-0.05,-3.76,52000,3,67600,0,0,0,0,0,0,25000,27000,-2000,-2000
20200430,057463,華邦電永豐98購01,,,,,0.00,0.00,0,0,0,0,0,0,0,0,0,0,0,0,0
20200430,057464,大立光永豐98購02,,,,,0.00,0.00,0,0,0,0,0,0,0,0,0,0,0,0,0
20200430,057465,智易永豐98購02,2.31,2.31,2.23,2.23,-0.15,-6.3,62000,5,139740,0,0,0,0,0,0,62000,0,62000,62000
20200430,057466,泰鼎永豐98購01,0.44,0.44,0.44,0.44,-0.14,-24.14,3000,1,1320,0,0,0,0,0,0,3000,0,3000,3000
20200430,057467,祥碩永豐98購04,0.22,0.22,0.14,0.16,-0.04,-20.0,1063000,26,173640,0,0,0,0,0,0,119000,944000,-825000,-825000
20200430,057468,台郡永豐98購01,,,,,0.00,0.00,0,0,0,0,0,0,0,0,0,0,0,0,0
20200430,057469,康友永豐98購02,0.18,0.18,0.18,0.18,0.00,0.00,1000,1,180,0,0,0,0,0,0,1000,0,1000,1000
20200430,05746P,台積電群益96售07,,,,,0.00,0.00,0,0,0,0,0,0,0,0,0,0,0,0,0
20200430,057470,易華電永豐98購02,0.56,0.59,0.56,0.59,+0.04,7.27,219000,13,124920,0,0,0,0,0,0,72000,147000,-75000,-75000
20200430,057471,昇陽半永豐98購02,0.45,0.46,0.44,0.44,+0.03,7.32,81000,4,36730,0,0,0,0,0,0,10000,71000,-61000,-61000
20200430,057472,T50正2元大9B購03,0.25,0.30,0.25,0.30,+0.08,36.36,334000,8,86740,0,0,0,0,0,0,262000,0,262000,262000
20200430,057473,T50反1元大98購08,,,,,0.00,0.00,0,0,0,0,0,0,0,0,0,0,0,0,0
20200430,057474,T50反1元大98購09,,,,,0.00,0.00,0,0,0,0,0,0,0,0,0,0,0,0,0
20200430,057475,聯電元大9A購01,0.60,0.63,0.57,0.63,+0.06,10.53,865000,23,519290,0,0,0,0,0,0,286000,492000,-206000,-206000
20200430,057476,國巨元大98購19,,,,,0.00,0.00,0,0,0,0,0,0,0,0,0,0,0,0,0
20200430,057477,智邦元大98購09,5.45,5.65,5.45,5.60,+0.15,2.75,20000,7,109750,0,0,0,0,0,0,20000,4000,16000,16000
20200430,057478,智邦元大99購01,2.80,2.80,2.72,2.72,-0.30,-9.93,10000,2,27600,0,0,0,0,0,0,5000,5000,0,0
20200430,057479,致茂元大98購03,2.10,2.10,2.03,2.03,-0.15,-6.88,5000,2,10290,0,0,0,0,0,0,0,5000,-5000,-5000
20200430,05747P,漢唐群益96售03,,,,,0.00,0.00,0,0,0,0,0,0,0,0,0,0,0,0,0
20200430,057480,技嘉元大98購03,2.32,2.32,2.26,2.28,+0.01,0.44,101000,6,232260,0,0,0,0,0,0,52000,51000,1000,1000
20200430,057481,技嘉元大98購04,2.40,2.42,2.31,2.31,-0.02,-0.86,53000,6,126530,0,0,0,0,0,0,53000,0,53000,53000
20200430,057482,微星元大98購03,2.12,2.12,2.12,2.12,+0.02,0.95,50000,2,106000,0,0,0,0,0,0,0,50000,-50000,-50000
20200430,057483,微星元大98購04,1.55,1.55,1.52,1.52,+0.02,1.33,378000,14,579870,0,0,0,0,0,0,58000,320000,-262000,-262000
20200430,057484,南亞科元大98購06,1.50,1.50,1.41,1.41,+0.04,2.92,143000,4,207950,0,0,0,0,0,0,75000,68000,7000,7000
20200430,057485,友達元大9C購04,,,,,0.00,0.00,0,0,0,0,0,0,0,0,0,0,0,0,0
20200430,057486,美律元大98購04,1.37,1.53,1.34,1.49,+0.15,11.19,258000,23,374830,0,0,0,0,0,0,45000,213000,-168000,-168000
20200430,057487,聯發科元大98購10,2.34,2.34,2.34,2.34,+0.42,21.88,10000,1,23400,0,0,0,0,0,0,10000,0,10000,10000
20200430,057488,聯發科元大99購02,1.89,2.09,1.80,2.09,+0.41,24.4,82000,7,152440,0,0,0,0,0,0,75000,6000,69000,69000
20200430,057489,奇力新元大99購06,2.21,2.32,2.17,2.32,+0.16,7.41,63000,5,140920,0,0,0,0,0,0,50000,13000,37000,37000
20200430,05748P,臺股指群益99售02,9.70,9.70,9.55,9.55,-0.95,-9.05,2000,2,19250,0,0,0,0,0,0,1000,1000,0,0
20200430,057490,可成元大98購10,2.22,2.22,2.09,2.09,-0.01,-0.48,77000,6,164940,0,0,0,0,0,0,72000,38000,34000,34000
20200430,057491,美食元大98購03,1.40,1.83,1.40,1.80,+0.42,30.43,684000,34,1103240,0,0,0,0,0,0,281000,383000,-102000,-102000
20200430,057492,大立光元大98購18,3.06,3.17,3.06,3.17,0.00,0.00,45000,4,140780,0,0,0,0,0,0,0,45000,-45000,-45000
20200430,057493,聯詠元大98購02,,,,,0.00,0.00,0,0,0,0,0,0,0,0,0,0,0,0,0
20200430,057494,玉晶光元大99購09,2.57,2.88,2.57,2.88,+0.33,12.94,130000,21,357060,0,0,0,0,0,0,65000,82000,-17000,-17000
20200430,057495,牧德元大99購04,2.34,2.44,2.31,2.43,+0.21,9.46,227000,18,540390,0,0,0,0,0,0,18000,214000,-196000,-196000
20200430,057496,佐登元大98購02,,,,,0.00,0.00,0,0,0,0,0,0,0,0,0,0,0,0,0
20200430,057497,祥碩元大98購06,1.69,1.69,1.69,1.69,-0.03,-1.74,3000,1,5070,0,0,0,0,0,0,0,3000,-3000,-3000
20200430,057498,台郡元大98購04,1.76,1.82,1.73,1.82,+0.14,8.33,132000,9,234270,0,0,0,0,0,0,60000,82000,-22000,-22000
20200430,057499,奇鋐群益98購01,3.41,3.51,3.38,3.51,+0.25,7.67,86000,11,296510,0,0,0,0,0,0,1000,83000,-82000,-82000
20200430,05749P,臺股指群益99售03,,,,,0.00,0.00,0,0,0,0,0,0,0,0,0,0,0,0,0
20200430,057500,神達群益98購01,,,,,0.00,0.00,0,0,0,0,0,0,0,0,0,0,0,0,0
20200430,057501,超眾群益98購04,4.98,4.98,4.98,4.98,+0.24,5.06,10000,1,49800,0,0,0,0,0,0,0,10000,-10000,-10000
20200430,057502,訊芯群益98購02,1.16,1.27,1.15,1.25,+0.10,8.7,370000,12,442150,0,0,0,0,0,0,100000,272000,-172000,-172000
20200430,057503,世紀鋼群益98購02,,,,,0.00,0.00,0,0,0,0,0,0,0,0,0,0,0,0,0
20200430,057504,技嘉麥證98購01,0.72,0.72,0.72,0.72,-0.02,-2.7,1000,1,720,0,1000,-1000,0,0,0,0,1000,-1000,-1000
20200430,057505,健策麥證98購01,0.92,0.94,0.92,0.94,0.00,0.00,128000,5,118360,0,128000,-128000,0,0,0,0,128000,-128000,-128000
20200430,057506,聯鈞國票99購02,,,,,0.00,0.00,0,0,0,0,0,0,0,0,0,0,0,0,0
20200430,057507,貿聯國票98購02,1.34,1.64,1.34,1.64,+0.36,28.13,640000,17,948830,0,0,0,0,0,0,0,640000,-640000,-640000
20200430,057508,康控國票99購03,0.82,0.89,0.79,0.89,+0.24,36.92,537000,14,453390,0,0,0,0,0,0,155000,382000,-227000,-227000
20200430,057509,聯發科統一9A購03,2.72,2.81,2.72,2.81,+0.35,14.23,113000,6,315600,0,0,0,0,0,0,46000,67000,-21000,-21000
20200430,05750P,臺股指群益99售04,,,,,0.00,0.00,0,0,0,0,0,0,0,0,0,0,0,0,0
20200430,057510,泰碩統一98購02,2.58,2.61,2.58,2.61,0.00,0.00,20000,2,51900,0,0,0,0,0,0,0,20000,-20000,-20000
20200430,057511,健策統一98購02,1.10,1.15,1.07,1.11,+0.05,4.72,373000,17,406050,0,0,0,0,0,0,237000,264000,-27000,-27000
20200430,057512,華邦電台新98購01,0.04,0.04,0.04,0.04,0.00,0.00,10000,1,400,0,0,0,0,0,0,0,10000,-10000,-10000
20200430,057513,智邦台新98購01,,,,,0.00,0.00,0,0,0,0,0,0,0,0,0,0,0,0,0
20200430,057514,華新科元富99購03,2.11,2.11,1.99,1.99,-0.05,-2.45,21000,3,44190,0,0,0,0,0,0,1000,20000,-19000,-19000
20200430,057515,智原元富98購02,0.35,0.35,0.35,0.35,0.00,0.00,100000,1,35000,0,0,0,0,0,0,100000,0,100000,100000
20200430,057516,和鑫元富98購01,0.81,0.81,0.81,0.81,+0.11,15.71,10000,1,8100,0,0,0,0,0,0,0,10000,-10000,-10000
20200430,057517,矽創元富98購02,0.75,0.79,0.72,0.78,+0.04,5.41,1228000,45,931410,0,0,0,0,0,0,623000,605000,18000,18000
20200430,057518,世紀鋼元富98購01,2.86,2.97,2.86,2.97,0.00,0.00,8000,2,23210,0,0,0,0,0,0,8000,0,8000,8000
20200430,057519,元油2X元大98購14,,,,,0.00,0.00,0,0,0,0,0,0,0,0,0,0,0,0,0
20200430,05751P,台積電中信96售05,,,,,0.00,0.00,0,0,0,0,0,0,0,0,0,0,0,0,0
20200430,057520,元油2X元大98購15,,,,,0.00,0.00,0,0,0,0,0,0,0,0,0,0,0,0,0
20200430,057521,元油2X元大98購16,,,,,0.00,0.00,0,0,0,0,0,0,0,0,0,0,0,0,0
20200430,057522,元油2X元大98購17,,,,,0.00,0.00,0,0,0,0,0,0,0,0,0,0,0,0,0
20200430,057523,大成鋼元大99購01,1.33,1.37,1.27,1.34,+0.08,6.35,695000,43,919800,0,0,0,0,0,0,461000,219000,242000,242000
20200430,057524,旺宏元大99購04,3.89,3.89,3.70,3.71,+0.28,8.16,140000,23,526480,0,0,0,0,0,0,111000,99000,12000,12000
20200430,057525,光磊元大99購01,,,,,0.00,0.00,0,0,0,0,0,0,0,0,0,0,0,0,0
20200430,057526,智邦元大98購10,4.36,4.54,4.30,4.30,-0.06,-1.38,58000,14,254200,0,0,0,0,0,0,58000,10000,48000,48000
20200430,057527,億光元大98購01,1.33,1.33,1.28,1.28,-0.02,-1.54,140000,4,181750,0,0,0,0,0,0,71000,69000,2000,2000
20200430,057528,南亞科元大99購01,,,,,0.00,0.00,0,0,0,0,0,0,0,0,0,0,0,0,0
20200430,057529,嘉晶元大99購02,3.15,3.50,3.15,3.30,+0.16,5.1,192000,17,635620,0,0,0,0,0,0,0,192000,-192000,-192000
20200430,05752P,台積電中信96售06,1.72,1.72,1.70,1.70,-0.15,-8.11,118000,4,202040,0,0,0,0,0,0,84000,34000,50000,50000
20200430,057530,奇鋐元大99購01,5.75,5.80,5.55,5.80,+0.30,5.45,60000,8,338250,0,0,0,0,0,0,33000,30000,3000,3000
20200430,057531,禾伸堂元大99購04,2.40,2.40,2.29,2.29,+0.04,1.78,55000,5,131270,0,0,0,0,0,0,52000,3000,49000,49000
20200430,057532,智原元大98購03,1.51,1.54,1.48,1.48,+0.01,0.68,308000,14,461700,0,0,0,0,0,0,113000,195000,-82000,-82000
20200430,057533,晶相光元大98購02,1.96,1.98,1.87,1.91,-0.03,-1.55,190000,14,367230,0,0,0,0,0,0,139000,67000,72000,72000
20200430,057534,旭富元大98購01,2.81,2.81,2.74,2.74,0.00,0.00,30000,3,83200,0,0,0,0,0,0,0,30000,-30000,-30000
20200430,057535,泰鼎元大99購01,,,,,0.00,0.00,0,0,0,0,0,0,0,0,0,0,0,0,0
20200430,057536,康控元大99購03,1.86,2.12,1.86,2.10,+0.25,13.51,123000,8,240960,0,0,0,0,0,0,82000,41000,41000,41000
20200430,057537,聯茂元大98購04,2.70,2.70,2.60,2.60,0.00,0.00,40000,2,106000,0,0,0,0,0,0,0,40000,-40000,-40000
20200430,057538,緯穎元大98購07,,,,,0.00,0.00,0,0,0,0,0,0,0,0,0,0,0,0,0
20200430,057539,南茂元大98購02,1.57,1.67,1.55,1.66,+0.13,8.5,586000,31,945770,0,0,0,0,0,0,99000,492000,-393000,-393000
20200430,05753P,臺股指中信99售02,,,,,0.00,0.00,0,0,0,0,0,0,0,0,0,0,0,0,0
20200430,057540,緯穎日盛99購01,1.40,1.78,1.40,1.78,0.00,0.00,4000,2,5980,0,0,0,0,0,0,0,1000,-1000,-1000
20200430,057541,台灣50康和9A購04,0.27,0.29,0.27,0.29,+0.06,26.09,17000,3,4680,0,0,0,0,0,0,17000,0,17000,17000
20200430,057542,上銀凱基99購01,0.39,0.55,0.39,0.55,+0.27,96.43,79000,6,36630,0,0,0,0,0,0,43000,0,43000,43000
20200430,057543,華通凱基99購02,1.35,1.49,1.35,1.49,+0.17,12.88,96000,3,135780,0,0,0,0,0,0,27000,69000,-42000,-42000
20200430,057544,鴻海凱基02購01,0.55,0.55,0.55,0.55,0.00,0.00,1000,1,550,0,0,0,0,0,0,0,0,0,0
20200430,057545,國巨凱基99購05,0.41,0.41,0.38,0.40,0.00,0.00,51000,3,20010,0,0,0,0,0,0,51000,0,51000,51000
20200430,057546,台積電凱基02購01,0.63,0.63,0.48,0.59,-0.01,-1.67,23000,5,13170,0,0,0,0,0,0,2000,0,2000,2000
20200430,057547,技嘉凱基99購01,,,,,0.00,0.00,0,0,0,0,0,0,0,0,0,0,0,0,0
20200430,057548,微星凱基99購01,0.47,0.48,0.47,0.48,+0.01,2.13,40000,2,18900,0,0,0,0,0,0,30000,10000,20000,20000
20200430,057549,台光電凱基98購05,1.33,1.54,1.33,1.54,0.00,0.00,32000,3,45420,0,0,0,0,0,0,2000,30000,-28000,-28000
20200430,05754P,臺股指中信99售03,,,,,0.00,0.00,0,0,0,0,0,0,0,0,0,0,0,0,0
20200430,057550,聯發科凱基02購01,0.93,1.01,0.93,0.96,+0.15,18.52,23000,3,21530,0,0,0,0,0,0,23000,0,23000,23000
20200430,057551,華新科凱基98購06,,,,,0.00,0.00,0,0,0,0,0,0,0,0,0,0,0,0,0
20200430,057552,禾伸堂凱基98購05,1.03,1.03,1.03,1.03,0.00,0.00,50000,1,51500,0,0,0,0,0,0,50000,0,50000,50000
20200430,057553,景碩凱基98購03,1.80,2.01,1.79,1.97,+0.20,11.3,83000,17,153490,0,0,0,0,0,0,41000,42000,-1000,-1000
20200430,057554,新日興凱基99購02,,,,,0.00,0.00,0,0,0,0,0,0,0,0,0,0,0,0,0
20200430,057555,玉晶光凱基9A購02,,,,,0.00,0.00,0,0,0,0,0,0,0,0,0,0,0,0,0
20200430,057556,智易凱基99購01,1.65,1.66,1.59,1.59,-0.01,-0.62,174000,14,281300,0,0,0,0,0,0,54000,130000,-76000,-76000
20200430,057557,聯茂凱基99購04,,,,,0.00,0.00,0,0,0,0,0,0,0,0,0,0,0,0,0
20200430,057558,致新凱基98購01,3.00,3.15,2.94,3.15,+0.08,2.61,61000,9,186820,0,0,0,0,0,0,10000,51000,-41000,-41000
20200430,057559,可成兆豐99購02,,,,,0.00,0.00,0,0,0,0,0,0,0,0,0,0,0,0,0
20200430,05755P,臺股指中信99售04,1.67,1.67,1.58,1.58,-0.15,-8.67,344000,16,561440,0,0,0,0,0,0,41000,303000,-262000,-262000
20200430,057560,華新科兆豐99購01,,,,,0.00,0.00,0,0,0,0,0,0,0,0,0,0,0,0,0
20200430,057561,大立光兆豐98購02,0.26,0.27,0.26,0.27,+0.05,22.73,20000,2,5350,0,0,0,0,0,0,20000,0,20000,20000
20200430,057562,奇鋐兆豐98購01,1.67,1.75,1.67,1.75,+0.12,7.36,13000,2,21790,0,0,0,0,0,0,12000,1000,11000,11000
20200430,057563,旭富國泰9A購01,2.27,2.33,2.21,2.21,+0.11,5.24,26000,6,58190,0,0,0,0,0,0,22000,3000,19000,19000
20200430,057564,台積電富邦9B購03,,,,,0.00,0.00,0,0,0,0,0,0,0,0,0,0,0,0,0
20200430,057565,可成富邦99購01,,,,,0.00,0.00,0,0,0,0,0,0,0,0,0,0,0,0,0
20200430,057566,欣興富邦99購01,0.54,0.63,0.54,0.58,+0.09,18.37,32000,16,17960,0,0,0,0,0,0,20000,0,20000,20000
20200430,057567,嘉聯益富邦9A購01,0.67,0.69,0.66,0.68,+0.04,6.25,891000,77,603630,0,0,0,0,0,0,551000,315000,236000,236000
20200430,057568,友訊永豐99購01,0.85,0.85,0.82,0.85,-0.02,-2.3,169000,6,140440,0,0,0,0,0,0,149000,20000,129000,129000
20200430,057569,光磊永豐98購03,1.02,1.05,1.02,1.05,-0.01,-0.94,136000,2,140760,0,0,0,0,0,0,68000,68000,0,0
20200430,05756P,臺股指中信99售05,2.89,2.89,2.89,2.89,0.00,0.00,1000,1,2890,0,0,0,0,0,0,0,1000,-1000,-1000
20200430,057570,技嘉永豐98購02,0.17,0.17,0.17,0.17,0.00,0.00,12000,1,2040,0,0,0,0,0,0,12000,0,12000,12000
20200430,057571,泰碩永豐98購01,1.99,1.99,1.87,1.89,-0.06,-3.08,101000,11,198430,0,0,0,0,0,0,45000,55000,-10000,-10000
20200430,057572,明泰永豐98購01,1.44,1.44,1.34,1.34,-0.07,-4.96,95000,6,131910,0,0,0,0,0,0,91000,4000,87000,87000
20200430,057573,京鼎永豐98購02,0.86,0.98,0.86,0.98,+0.13,15.29,66000,6,59860,0,0,0,0,0,0,1000,65000,-64000,-64000
20200430,057574,中磊永豐98購01,1.19,1.19,1.18,1.18,+0.07,6.31,11000,4,13050,0,0,0,0,0,0,11000,0,11000,11000
20200430,057575,世紀鋼永豐98購02,1.47,1.65,1.47,1.62,+0.17,11.72,197000,31,313010,0,0,0,0,0,0,120000,197000,-77000,-77000
20200430,057576,南亞科第一9C購01,,,,,0.00,0.00,0,0,0,0,0,0,0,0,0,0,0,0,0
20200430,057577,廣宇中信9A購01,0.57,0.60,0.57,0.59,+0.03,5.36,204000,9,119250,0,0,0,0,0,0,147000,57000,90000,90000
20200430,057578,可成中信99購01,,,,,0.00,0.00,0,0,0,0,0,0,0,0,0,0,0,0,0
20200430,057579,長榮航中信9A購01,0.50,0.60,0.43,0.56,+0.10,21.74,109000,17,55080,0,0,0,0,0,0,22000,21000,1000,1000
20200430,05757P,旺宏永豐96售03,0.84,0.88,0.84,0.88,-0.12,-12.0,13000,4,10980,0,0,0,0,0,0,0,13000,-13000,-13000
20200430,057580,玉山金中信9A購01,0.64,0.66,0.64,0.65,+0.04,6.56,32000,7,20790,0,0,0,0,0,0,0,0,0,0
20200430,057581,元大金中信9A購01,0.67,0.67,0.67,0.67,+0.29,76.32,1000,1,670,0,0,0,0,0,0,0,0,0,0
20200430,057582,亞光中信9A購02,0.53,0.55,0.52,0.54,0.00,0.00,91000,7,48390,0,0,0,0,0,0,86000,5000,81000,81000
20200430,057583,啟碁中信9A購01,0.62,0.62,0.60,0.61,0.00,0.00,299000,16,180520,0,0,0,0,0,0,27000,267000,-240000,-240000
20200430,057584,國巨亞東99購01,,,,,0.00,0.00,0,0,0,0,0,0,0,0,0,0,0,0,0
20200430,057585,鴻海國票99購05,0.15,0.15,0.15,0.15,0.00,0.00,97000,2,14550,0,0,0,0,0,0,91000,97000,-6000,-6000
20200430,057586,台積電國票99購06,0.92,0.92,0.92,0.92,0.00,0.00,15000,2,13800,0,0,0,0,0,0,15000,0,15000,15000
20200430,057587,微星國票99購01,,,,,0.00,0.00,0,0,0,0,0,0,0,0,0,0,0,0,0
20200430,057588,南亞科國票99購01,,,,,0.00,0.00,0,0,0,0,0,0,0,0,0,0,0,0,0
20200430,057589,超眾國票9A購01,3.63,3.63,3.63,3.63,+0.11,3.12,25000,1,90750,0,0,0,0,0,0,0,25000,-25000,-25000
20200430,05758P,光罩永豐96售02,0.94,0.94,0.91,0.91,-0.06,-6.19,88000,4,81220,0,0,0,0,0,0,50000,38000,12000,12000
20200430,057590,元油2X兆豐98購02,0.03,0.03,0.03,0.03,0.00,0.00,10000,1,300,0,0,0,0,0,0,0,10000,-10000,-10000
20200430,057591,鴻海兆豐99購01,1.03,1.03,1.03,1.03,0.00,0.00,2000,1,2060,0,0,0,0,0,0,2000,0,2000,2000
20200430,057592,美律兆豐99購01,0.91,1.01,0.91,1.00,+0.09,9.89,1415000,19,1365460,0,0,0,0,0,0,475000,930000,-455000,-455000
20200430,057593,聯發科兆豐98購03,,,,,0.00,0.00,0,0,0,0,0,0,0,0,0,0,0,0,0
20200430,057594,宏達電兆豐99購01,,,,,0.00,0.00,0,0,0,0,0,0,0,0,0,0,0,0,0
20200430,057595,健鼎兆豐98購01,0.86,0.92,0.84,0.90,+0.05,5.88,87000,15,76650,0,0,0,0,0,0,25000,60000,-35000,-35000
20200430,057596,聯茂兆豐99購01,,,,,0.00,0.00,0,0,0,0,0,0,0,0,0,0,0,0,0
20200430,057597,華通群益9A購02,0.59,0.60,0.59,0.60,0.00,0.00,102000,2,60200,0,0,0,0,0,0,102000,0,102000,102000
20200430,057598,鴻海群益98購07,0.75,0.75,0.75,0.75,+0.06,8.7,10000,2,7500,0,0,0,0,0,0,0,10000,-10000,-10000
20200430,057599,技嘉群益9A購01,1.39,1.39,1.39,1.39,-0.08,-5.44,50000,1,69500,0,0,0,0,0,0,0,50000,-50000,-50000
20200430,05759P,智邦永豐96售02,0.07,0.09,0.07,0.09,+0.01,12.5,50000,2,4000,0,0,0,0,0,0,25000,50000,-25000,-25000
20200430,057600,大立光群益99購03,0.86,1.05,0.86,1.05,+0.20,23.53,13000,5,12560,0,0,0,0,0,0,11000,1000,10000,10000
20200430,057601,中磊群益98購01,2.32,2.32,2.23,2.23,+0.01,0.45,166000,7,374800,0,0,0,0,0,0,63000,103000,-40000,-40000
20200430,057602,聯茂群益98購02,,,,,0.00,0.00,0,0,0,0,0,0,0,0,0,0,0,0,0
20200430,057603,樺漢群益98購02,1.36,1.47,1.36,1.47,+0.07,5.0,287000,11,408510,0,0,0,0,0,0,54000,213000,-159000,-159000
20200430,057604,鴻海統一9C購01,1.21,1.21,1.21,1.21,0.00,0.00,38000,1,45980,0,0,0,0,0,0,38000,0,38000,38000
20200430,057605,旺宏統一99購03,0.97,0.97,0.94,0.96,+0.12,14.29,134000,15,128300,0,0,0,0,0,0,59000,75000,-16000,-16000
20200430,057606,健策統一98購03,0.95,0.98,0.93,0.98,+0.05,5.38,336000,15,319770,0,0,0,0,0,0,133000,203000,-70000,-70000
20200430,057607,旺宏台新98購02,1.14,1.14,1.12,1.13,+0.16,16.49,120000,4,134800,0,0,0,0,0,0,120000,0,120000,120000
20200430,057608,南亞科台新98購01,,,,,0.00,0.00,0,0,0,0,0,0,0,0,0,0,0,0,0
20200430,057609,友訊元富98購01,1.29,1.38,1.24,1.24,-0.04,-3.12,788000,28,1047940,0,0,0,0,0,0,328000,460000,-132000,-132000
20200430,05760P,京鼎永豐96售02,1.19,1.20,1.11,1.12,-0.17,-13.18,291000,8,341910,0,0,0,0,0,0,251000,40000,211000,211000
20200430,057610,致茂元富98購02,,,,,0.00,0.00,0,0,0,0,0,0,0,0,0,0,0,0,0
20200430,057611,技嘉元富98購02,,,,,0.00,0.00,0,0,0,0,0,0,0,0,0,0,0,0,0
20200430,057612,瑞昱元富02購01,2.31,2.41,2.24,2.40,+0.23,10.6,1413000,64,3266830,0,0,0,0,0,0,861000,493000,368000,368000
20200430,057613,瑞昱元富02購02,2.69,2.81,2.57,2.77,+0.26,10.36,505000,34,1335940,0,0,0,0,0,0,423000,68000,355000,355000
20200430,057614,華新科元富99購04,1.39,1.39,1.34,1.34,-0.01,-0.74,12000,4,16410,0,0,0,0,0,0,4000,8000,-4000,-4000
20200430,057615,元油2X凱基98購02,0.09,0.10,0.09,0.10,+0.02,25.0,414000,15,38560,0,0,0,0,0,0,0,0,0,0
20200430,057616,聯電凱基99購01,0.56,0.57,0.55,0.57,+0.03,5.56,186000,24,104970,0,0,0,0,0,0,106000,159000,-53000,-53000
20200430,057617,國巨凱基99購06,,,,,0.00,0.00,0,0,0,0,0,0,0,0,0,0,0,0,0
20200430,057618,台光電凱基99購01,,,,,0.00,0.00,0,0,0,0,0,0,0,0,0,0,0,0,0
20200430,057619,玉晶光凱基98購02,1.21,1.40,1.21,1.40,+0.20,16.67,227000,13,300150,0,0,0,0,0,0,159000,70000,89000,89000
20200430,05761P,嘉澤永豐96售01,0.38,0.38,0.32,0.32,-0.10,-23.81,48000,2,18180,0,0,0,0,0,0,0,48000,-48000,-48000
20200430,057620,康控凱基99購01,,,,,0.00,0.00,0,0,0,0,0,0,0,0,0,0,0,0,0
20200430,057621,崇越凱基98購01,0.31,0.32,0.31,0.32,+0.04,14.29,105000,7,32850,0,0,0,0,0,0,15000,90000,-75000,-75000
20200430,057622,元油2X國泰99購03,0.26,0.26,0.26,0.26,+0.04,18.18,4000,1,1040,0,0,0,0,0,0,0,0,0,0
20200430,057623,友訊國泰99購01,1.17,1.17,1.16,1.16,-0.07,-5.69,60000,4,70100,0,0,0,0,0,0,60000,0,60000,60000
20200430,057624,新日興國泰99購01,1.10,1.12,1.10,1.12,-0.13,-10.4,230000,11,254470,0,0,0,0,0,0,230000,0,230000,230000
20200430,057625,泰鼎國泰9A購01,0.47,0.49,0.46,0.47,0.00,0.00,179000,24,85030,0,0,0,0,0,0,0,156000,-156000,-156000
20200430,057626,技嘉富邦9A購01,0.48,0.50,0.48,0.50,+0.01,2.04,31000,3,15480,0,0,0,0,0,0,1000,30000,-29000,-29000
20200430,057627,和大永豐98購01,0.08,0.11,0.08,0.11,0.00,0.00,231000,21,21190,0,0,0,0,0,0,0,221000,-221000,-221000
20200430,057628,旺宏永豐98購02,2.25,2.28,2.20,2.20,+0.27,13.99,53000,6,116980,0,0,0,0,0,0,2000,53000,-51000,-51000
20200430,057629,泰碩永豐98購02,3.14,3.14,3.14,3.14,-0.14,-4.27,3000,1,9420,0,0,0,0,0,0,0,3000,-3000,-3000
20200430,05762P,昇陽半永豐96售04,1.75,1.80,1.75,1.80,-0.12,-6.25,58000,4,102800,0,0,0,0,0,0,16000,42000,-26000,-26000
20200430,057630,茂林永豐98購01,0.42,0.42,0.42,0.42,-0.08,-16.0,70000,3,29400,0,0,0,0,0,0,70000,0,70000,70000
20200430,057631,康控永豐98購02,0.52,0.63,0.51,0.63,+0.13,26.0,136000,12,81140,0,0,0,0,0,0,23000,113000,-90000,-90000
20200430,057632,傳奇永豐98購01,0.24,0.24,0.20,0.22,+0.01,4.76,770000,19,170020,0,0,0,0,0,0,197000,544000,-347000,-347000
20200430,057633,緯穎永豐98購02,0.48,0.63,0.48,0.63,0.00,0.00,25000,3,12750,0,0,0,0,0,0,0,25000,-25000,-25000
20200430,057634,道瓊反元大99購01,1.04,1.04,1.03,1.03,-0.17,-14.17,8000,2,8290,0,0,0,0,0,0,0,8000,-8000,-8000
20200430,057635,中鋼元大98購01,0.19,0.21,0.19,0.21,0.00,0.00,50000,4,9700,0,0,0,0,0,0,20000,30000,-10000,-10000
20200430,057636,上銀元大98購06,1.63,1.94,1.60,1.94,+0.57,41.61,55000,10,96830,0,0,0,0,0,0,11000,44000,-33000,-33000
20200430,057637,上銀元大98購07,1.25,1.51,1.25,1.51,+0.43,39.81,98000,10,133790,0,0,0,0,0,0,28000,70000,-42000,-42000
20200430,057638,上銀元大99購01,1.60,1.80,1.60,1.80,+0.34,23.29,74000,4,121720,0,0,0,0,0,0,25000,49000,-24000,-24000
20200430,057639,國巨元大99購07,1.98,1.98,1.97,1.97,+0.09,4.79,295000,3,581160,0,0,0,0,0,0,294000,1000,293000,293000
20200430,05763P,致新永豐96售01,0.43,0.44,0.43,0.44,-0.09,-16.98,440000,3,191080,0,0,0,0,0,0,420000,20000,400000,400000
20200430,057640,台積電元大98購16,0.97,1.00,0.97,1.00,0.00,0.00,60000,3,59400,0,0,0,0,0,0,60000,40000,20000,20000
20200430,057641,旺宏元大98購10,1.43,1.43,1.43,1.43,+0.06,4.38,10000,1,14300,0,0,0,0,0,0,10000,0,10000,10000
20200430,057642,南亞科元大98購07,1.45,1.45,1.41,1.41,+0.11,8.46,69000,2,100010,0,0,0,0,0,0,0,69000,-69000,-69000
20200430,057643,聯發科元大99購03,,,,,0.00,0.00,0,0,0,0,0,0,0,0,0,0,0,0,0
20200430,057644,奇力新元大98購04,1.25,1.37,1.23,1.37,+0.14,11.38,118000,4,154740,0,0,0,0,0,0,68000,50000,18000,18000
20200430,057645,華新科元大99購11,,,,,0.00,0.00,0,0,0,0,0,0,0,0,0,0,0,0,0
20200430,057646,玉山金元大98購01,2.97,3.03,2.97,3.03,+0.17,5.94,106000,25,317940,0,0,0,0,0,0,59000,81000,-22000,-22000
20200430,057647,欣興元大98購10,2.31,2.39,2.28,2.29,+0.10,4.57,522000,24,1198340,0,0,0,0,0,0,458000,64000,394000,394000
20200430,057648,和碩元大98購01,,,,,0.00,0.00,0,0,0,0,0,0,0,0,0,0,0,0,0
20200430,057649,嘉聯益元大99購04,1.68,1.73,1.65,1.73,+0.12,7.45,328000,22,550700,0,0,0,0,0,0,232000,98000,134000,134000
20200430,05764P,世紀鋼永豐96售03,,,,,0.00,0.00,0,0,0,0,0,0,0,0,0,0,0,0,0
20200430,057650,力成元大98購04,1.78,1.93,1.77,1.93,+0.23,13.53,133000,4,248810,0,0,0,0,0,0,133000,0,133000,133000
20200430,057651,矽力元大98購03,5.35,5.35,4.87,4.87,-0.58,-10.64,45000,4,221590,0,0,0,0,0,0,3000,42000,-39000,-39000
20200430,057652,欣興永昌9C購01,,,,,0.00,0.00,0,0,0,0,0,0,0,0,0,0,0,0,0
20200430,057653,臺股指永昌98購01,,,,,0.00,0.00,0,0,0,0,0,0,0,0,0,0,0,0,0
20200430,057654,A50正2中信98購01,0.77,0.78,0.70,0.70,+0.06,9.38,223000,19,161330,0,0,0,0,0,0,2000,221000,-219000,-219000
20200430,057655,奇力新中信98購05,,,,,0.00,0.00,0,0,0,0,0,0,0,0,0,0,0,0,0
20200430,057656,大成鋼兆豐98購01,0.66,0.70,0.66,0.68,+0.03,4.62,302000,22,205610,0,0,0,0,0,0,76000,206000,-130000,-130000
20200430,057657,國巨兆豐98購04,0.26,0.26,0.17,0.17,+0.01,6.25,37000,6,7520,0,0,0,0,0,0,0,20000,-20000,-20000
20200430,057658,玉晶光兆豐99購02,0.58,0.58,0.58,0.58,0.00,0.00,23000,1,13340,0,0,0,0,0,0,23000,0,23000,23000
20200430,057659,台表科兆豐98購01,0.37,0.40,0.35,0.38,0.00,0.00,334000,17,130670,0,0,0,0,0,0,23000,291000,-268000,-268000
20200430,05765P,臺股指永豐96售01,,,,,0.00,0.00,0,0,0,0,0,0,0,0,0,0,0,0,0
20200430,057660,訊芯兆豐98購02,0.44,0.44,0.43,0.43,+0.04,10.26,59000,3,25760,0,0,0,0,0,0,20000,39000,-19000,-19000
20200430,057661,臺股指兆豐98購01,,,,,0.00,0.00,0,0,0,0,0,0,0,0,0,0,0,0,0
20200430,057662,上銀元大9A購01,1.80,2.14,1.78,2.07,+0.37,21.76,692000,36,1354750,0,0,0,0,0,0,440000,252000,188000,188000
20200430,057663,國巨元大99購08,,,,,0.00,0.00,0,0,0,0,0,0,0,0,0,0,0,0,0
20200430,057664,台積電元大9A購03,0.85,0.85,0.85,0.85,+0.05,6.25,24000,4,20400,0,0,0,0,0,0,0,0,0,0
20200430,057665,技嘉元大99購01,2.15,2.15,2.15,2.15,0.00,0.00,1000,1,2150,0,0,0,0,0,0,1000,1000,0,0
20200430,057666,奇力新元大9A購01,,,,,0.00,0.00,0,0,0,0,0,0,0,0,0,0,0,0,0
20200430,057667,可成元大99購01,2.16,2.16,2.10,2.10,0.00,0.00,29000,2,61800,0,0,0,0,0,0,0,29000,-29000,-29000
20200430,057668,華新科元大9A購01,,,,,0.00,0.00,0,0,0,0,0,0,0,0,0,0,0,0,0
20200430,057669,嘉晶元大99購03,,,,,0.00,0.00,0,0,0,0,0,0,0,0,0,0,0,0,0
20200430,05766P,A50正2凱基99售01,,,,,0.00,0.00,0,0,0,0,0,0,0,0,0,0,0,0,0
20200430,057670,欣興元大99購02,3.49,3.55,3.39,3.39,+0.06,1.8,194000,24,674010,0,0,0,0,0,0,144000,52000,92000,92000
20200430,057671,群創元大9B購06,0.89,0.89,0.89,0.89,+0.03,3.49,100000,1,89000,0,0,0,0,0,0,0,100000,-100000,-100000
20200430,057672,茂林元大98購02,2.26,2.29,2.26,2.29,-0.23,-9.13,54000,2,123540,0,0,0,0,0,0,4000,50000,-46000,-46000
20200430,057673,臻鼎元大98購01,,,,,0.00,0.00,0,0,0,0,0,0,0,0,0,0,0,0,0
20200430,057674,台郡元大99購03,1.01,1.04,0.98,1.04,+0.03,2.97,288000,17,290660,0,0,0,0,0,0,156000,226000,-70000,-70000
20200430,057675,同欣電元大98購02,0.69,0.80,0.68,0.80,+0.13,19.4,410000,22,300240,0,0,0,0,0,0,155000,255000,-100000,-100000
20200430,057676,臺股指元大98購06,,,,,0.00,0.00,0,0,0,0,0,0,0,0,0,0,0,0,0
20200430,057677,臺股指元大98購07,,,,,0.00,0.00,0,0,0,0,0,0,0,0,0,0,0,0,0
20200430,057678,臺股指元大98購08,0.37,0.45,0.37,0.45,0.00,0.00,3000,2,1270,0,0,0,0,0,0,3000,0,3000,3000
20200430,057679,臺股指元大98購09,,,,,0.00,0.00,0,0,0,0,0,0,0,0,0,0,0,0,0
20200430,05767P,國巨凱基96售11,,,,,0.00,0.00,0,0,0,0,0,0,0,0,0,0,0,0,0
20200430,057680,臺股指元大98購10,,,,,0.00,0.00,0,0,0,0,0,0,0,0,0,0,0,0,0
20200430,057681,T50反1日盛9C購01,0.88,0.88,0.85,0.85,0.00,0.00,60000,6,51900,0,0,0,0,0,0,0,60000,-60000,-60000
20200430,057682,台積電日盛9A購03,,,,,0.00,0.00,0,0,0,0,0,0,0,0,0,0,0,0,0
20200430,057683,技嘉日盛98購01,1.54,1.54,1.54,1.54,-0.06,-3.75,1000,1,1540,0,0,0,0,0,0,1000,1000,0,0
20200430,057684,聯茂日盛99購01,2.10,2.13,2.08,2.08,-0.06,-2.8,139000,5,290590,0,0,0,0,0,0,139000,0,139000,139000
20200430,057685,台灣50凱基9C購01,0.40,0.48,0.40,0.48,0.00,0.00,118000,8,55790,0,0,0,0,0,0,118000,0,118000,118000
20200430,057686,中50凱基99購01,,,,,0.00,0.00,0,0,0,0,0,0,0,0,0,0,0,0,0
20200430,057687,中502X凱基98購01,,,,,0.00,0.00,0,0,0,0,0,0,0,0,0,0,0,0,0
20200430,057688,國巨凱基99購07,,,,,0.00,0.00,0,0,0,0,0,0,0,0,0,0,0,0,0
20200430,057689,南亞科凱基99購02,1.04,1.04,1.04,1.04,+0.06,6.12,3000,1,3120,0,0,0,0,0,0,3000,0,3000,3000
20200430,05768P,台積電凱基96售15,,,,,0.00,0.00,0,0,0,0,0,0,0,0,0,0,0,0,0
20200430,057690,美律凱基99購03,1.44,1.52,1.44,1.52,+0.13,9.35,28000,4,41490,0,0,0,0,0,0,0,28000,-28000,-28000
20200430,057691,健策凱基99購01,1.34,1.39,1.34,1.37,+0.08,6.2,87000,9,117760,0,0,0,0,0,0,56000,22000,34000,34000
20200430,057692,臺股指凱基98購10,0.46,0.46,0.46,0.46,+0.11,31.43,20000,2,9200,0,0,0,0,0,0,0,0,0,0
20200430,057693,臺股指凱基98購11,0.17,0.20,0.17,0.17,+0.07,70.0,39000,4,6850,0,0,0,0,0,0,30000,0,30000,30000
20200430,057694,臺股指凱基98購12,0.11,0.12,0.11,0.12,+0.03,33.33,136000,9,15610,0,0,0,0,0,0,0,0,0,0
20200430,057695,S&P反1群益9B購01,2.77,2.77,2.77,2.77,-0.17,-5.78,1000,1,2770,0,0,0,0,0,0,0,1000,-1000,-1000
20200430,057696,聯電群益9A購01,0.27,0.32,0.27,0.32,+0.05,18.52,1173000,91,339710,0,0,0,0,0,0,475000,0,475000,475000
20200430,057697,國巨群益98購09,0.50,0.53,0.48,0.49,+0.03,6.52,361000,17,177180,0,0,0,0,0,0,256000,83000,173000,173000
20200430,057698,奇力新群益98購02,1.18,1.25,1.13,1.13,+0.02,1.8,218000,9,259990,0,0,0,0,0,0,32000,168000,-136000,-136000
20200430,057699,可成群益9A購02,2.05,2.05,1.94,1.94,-0.13,-6.28,53000,4,106620,0,0,0,0,0,0,40000,13000,27000,27000
20200430,05769P,台積電凱基96售16,,,,,0.00,0.00,0,0,0,0,0,0,0,0,0,0,0,0,0
20200430,057700,新日興群益9A購01,1.60,1.60,1.48,1.49,-0.10,-6.29,528000,29,807560,0,0,0,0,0,0,513000,10000,503000,503000
20200430,057701,嘉聯益群益98購02,1.19,1.23,1.18,1.23,+0.10,8.85,117000,4,141840,0,0,0,0,0,0,68000,51000,17000,17000
20200430,057702,同欣電群益99購01,,,,,0.00,0.00,0,0,0,0,0,0,0,0,0,0,0,0,0
20200430,057703,矽力群益98購01,0.83,0.83,0.83,0.83,0.00,0.00,100000,2,83000,0,0,0,0,0,0,100000,100000,0,0
20200430,057704,台虹群益98購03,1.77,1.80,1.75,1.75,0.00,0.00,722000,12,1275710,0,0,0,0,0,0,452000,270000,182000,182000
20200430,057705,臺股指群益98購05,1.57,1.69,1.57,1.69,+0.23,15.75,305000,9,495750,0,0,0,0,0,0,285000,20000,265000,265000
20200430,057706,臺股指群益98購06,,,,,0.00,0.00,0,0,0,0,0,0,0,0,0,0,0,0,0
20200430,057707,臺股指群益98購07,2.20,2.46,2.20,2.46,+0.39,18.84,264000,21,594590,0,0,0,0,0,0,127000,137000,-10000,-10000
20200430,057708,臺股指群益98購08,,,,,0.00,0.00,0,0,0,0,0,0,0,0,0,0,0,0,0
20200430,057709,電子類群益98購01,0.67,0.67,0.67,0.67,0.00,0.00,150000,1,100500,0,0,0,0,0,0,150000,0,150000,150000
20200430,05770P,聯發科凱基96售16,,,,,0.00,0.00,0,0,0,0,0,0,0,0,0,0,0,0,0
20200430,057710,金融類群益98購01,,,,,0.00,0.00,0,0,0,0,0,0,0,0,0,0,0,0,0
20200430,057711,台積電統一9A購03,0.36,0.36,0.36,0.36,0.00,0.00,10000,1,3600,0,0,0,0,0,0,0,0,0,0
20200430,057712,南亞科統一9A購01,1.34,1.34,1.27,1.27,+0.03,2.42,151000,7,200740,0,0,0,0,0,0,142000,9000,133000,133000
20200430,057713,美律統一99購01,0.72,0.79,0.71,0.77,+0.08,11.59,300000,11,218270,0,0,0,0,0,0,284000,16000,268000,268000
20200430,057714,聯發科統一98購05,2.28,2.37,2.26,2.37,+0.31,15.05,75000,9,173100,0,0,0,0,0,0,42000,33000,9000,9000
20200430,057715,聯發科統一99購03,,,,,0.00,0.00,0,0,0,0,0,0,0,0,0,0,0,0,0
20200430,057716,神達統一98購01,1.13,1.13,1.08,1.08,0.00,0.00,9000,2,10070,0,0,0,0,0,0,0,9000,-9000,-9000
20200430,057717,友訊元富98購02,1.06,1.14,1.02,1.04,-0.02,-1.89,693000,29,752940,0,0,0,0,0,0,328000,365000,-37000,-37000
20200430,057718,旺宏元富02購02,1.22,1.27,1.14,1.16,0.00,0.00,8000,6,9800,0,0,0,0,0,0,0,3000,-3000,-3000
20200430,057719,欣興元富02購01,2.39,2.44,2.39,2.44,+0.10,4.27,15000,3,36150,0,0,0,0,0,0,9000,6000,3000,3000
20200430,05771P,大立光凱基96售13,,,,,0.00,0.00,0,0,0,0,0,0,0,0,0,0,0,0,0
20200430,057720,日電貿元富98購01,1.44,1.48,1.44,1.48,+0.14,10.45,113000,6,164310,0,0,0,0,0,0,0,113000,-113000,-113000
20200430,057721,華擎元富98購02,1.53,1.53,1.37,1.40,-0.04,-2.78,567000,41,805960,0,0,0,0,0,0,141000,410000,-269000,-269000
20200430,057722,臺股指元富98購01,0.13,0.19,0.13,0.19,0.00,0.00,195000,8,35030,0,0,0,0,0,0,195000,0,195000,195000
20200430,057723,臺股指元富98購02,0.38,0.38,0.38,0.38,-0.12,-24.0,1000,1,380,0,0,0,0,0,0,0,0,0,0
20200430,057724,亞德客國泰99購01,2.04,2.52,1.91,2.47,+0.54,27.98,1168000,82,2449820,0,0,0,0,0,0,622000,637000,-15000,-15000
20200430,057725,台達電國泰9A購01,1.44,1.60,1.44,1.58,+0.19,13.67,766000,58,1178820,0,0,0,0,0,0,427000,303000,124000,124000
20200430,057726,華通國泰9A購01,,,,,0.00,0.00,0,0,0,0,0,0,0,0,0,0,0,0,0
20200430,057727,華邦電國泰9A購01,1.33,1.41,1.32,1.39,+0.17,13.93,1031000,30,1391270,0,0,0,0,0,0,381000,650000,-269000,-269000
20200430,057728,瑞昱國泰99購01,,,,,0.00,0.00,0,0,0,0,0,0,0,0,0,0,0,0,0
20200430,057729,華新科國泰99購04,1.82,1.83,1.82,1.83,+0.03,1.67,10000,2,18250,0,0,0,0,0,0,0,10000,-10000,-10000
20200430,05772P,景碩凱基96售02,0.28,0.28,0.28,0.28,0.00,0.00,15000,1,4200,0,0,0,0,0,0,15000,15000,0,0
20200430,057730,聯鈞國泰9A購01,1.74,1.74,1.60,1.63,-0.07,-4.12,944000,33,1571250,0,0,0,0,0,0,932000,162000,770000,770000
20200430,057731,華擎國泰9A購02,2.42,2.44,2.32,2.32,0.00,0.00,89000,4,210460,0,0,0,0,0,0,34000,55000,-21000,-21000
20200430,057732,牧德國泰9A購01,,,,,0.00,0.00,0,0,0,0,0,0,0,0,0,0,0,0,0
20200430,057733,嘉聯益國泰99購01,1.36,1.37,1.31,1.33,+0.01,0.76,333000,22,445270,0,0,0,0,0,0,284000,0,284000,284000
20200430,057734,訊芯國泰9A購01,0.62,0.62,0.62,0.62,+0.01,1.64,10000,1,6200,0,0,0,0,0,0,10000,0,10000,10000
20200430,057735,台灣50富邦9C購02,1.60,1.71,1.60,1.71,+0.25,17.12,21000,6,34110,0,0,0,0,0,0,20000,0,20000,20000
20200430,057736,鴻海富邦99購04,2.56,2.61,2.55,2.61,+0.09,3.57,107000,9,275010,0,0,0,0,0,0,51000,56000,-5000,-5000
20200430,057737,國巨富邦99購02,0.22,0.22,0.19,0.19,+0.02,11.76,140000,7,30000,0,0,0,0,0,0,20000,0,20000,20000
20200430,057738,旺宏富邦9A購01,0.78,0.78,0.74,0.74,+0.07,10.45,290000,9,222080,0,0,0,0,0,0,280000,0,280000,280000
20200430,057739,新日興富邦9B購01,0.62,0.62,0.56,0.57,-0.04,-6.56,281000,42,166140,0,0,0,0,0,0,189000,203000,-14000,-14000
20200430,05773P,臺股指凱基99售03,,,,,0.00,0.00,0,0,0,0,0,0,0,0,0,0,0,0,0
20200430,057740,茂林富邦9A購01,0.40,0.40,0.38,0.39,+0.01,2.63,219000,13,84640,0,0,0,0,0,0,71000,148000,-77000,-77000
20200430,057741,超眾富邦98購01,,,,,0.00,0.00,0,0,0,0,0,0,0,0,0,0,0,0,0
20200430,057742,喬山永豐98購02,0.73,0.92,0.73,0.91,+0.22,31.88,334000,11,258900,0,0,0,0,0,0,0,334000,-334000,-334000
20200430,057743,華擎永豐98購03,0.64,0.64,0.58,0.59,+0.02,3.51,74000,7,46010,0,0,0,0,0,0,54000,20000,34000,34000
20200430,057744,健策永豐98購02,1.55,1.58,1.53,1.58,+0.07,4.64,129000,8,199540,0,0,0,0,0,0,25000,105000,-80000,-80000
20200430,057745,泰鼎永豐99購01,,,,,0.00,0.00,0,0,0,0,0,0,0,0,0,0,0,0,0
20200430,057746,同欣電永豐98購02,,,,,0.00,0.00,0,0,0,0,0,0,0,0,0,0,0,0,0
20200430,057747,致新永豐98購01,0.98,1.06,0.96,1.02,+0.03,3.03,495000,30,494600,0,0,0,0,0,0,249000,246000,3000,3000
20200430,057748,華通國票98購04,2.06,2.37,2.06,2.26,+0.26,13.0,42000,4,94780,0,0,0,0,0,0,16000,26000,-10000,-10000
20200430,057749,華新科國票99購01,,,,,0.00,0.00,0,0,0,0,0,0,0,0,0,0,0,0,0
20200430,05774P,臺股指凱基99售04,,,,,0.00,0.00,0,0,0,0,0,0,0,0,0,0,0,0,0
20200430,057750,神達國票99購01,,,,,0.00,0.00,0,0,0,0,0,0,0,0,0,0,0,0,0
20200430,057751,神達國票99購02,2.25,2.25,2.25,2.25,0.00,0.00,5000,1,11250,0,0,0,0,0,0,0,5000,-5000,-5000
20200430,057752,臺股指國票98購08,1.77,1.77,1.77,1.77,+0.26,17.22,10000,1,17700,0,0,0,0,0,0,10000,0,10000,10000
20200430,057753,臺股指國票98購09,0.28,0.28,0.27,0.27,0.00,0.00,25000,2,6950,0,0,0,0,0,0,25000,0,25000,25000
20200430,057754,臺股指國票98購10,,,,,0.00,0.00,0,0,0,0,0,0,0,0,0,0,0,0,0
20200430,057755,鴻海日盛98購01,0.43,0.46,0.43,0.46,0.00,0.00,13000,2,5680,0,0,0,0,0,0,0,13000,-13000,-13000
20200430,057756,瑞昱日盛99購01,1.18,1.33,1.18,1.33,+0.30,29.13,2000,2,2510,0,0,0,0,0,0,2000,0,2000,2000
20200430,057757,鴻海凱基98購13,3.39,3.51,3.32,3.51,+0.22,6.69,22000,5,73410,0,0,0,0,0,0,22000,22000,0,0
20200430,057758,鴻海凱基99購03,,,,,0.00,0.00,0,0,0,0,0,0,0,0,0,0,0,0,0
20200430,057759,聯發科凱基98購17,2.61,2.61,2.61,2.61,+0.49,23.11,10000,1,26100,0,0,0,0,0,0,10000,0,10000,10000
20200430,05775P,台積電國泰98售02,,,,,0.00,0.00,0,0,0,0,0,0,0,0,0,0,0,0,0
20200430,057760,聯發科凱基98購18,3.65,3.65,3.65,3.65,0.00,0.00,5000,1,18250,0,0,0,0,0,0,0,5000,-5000,-5000
20200430,057761,聯發科凱基99購04,,,,,0.00,0.00,0,0,0,0,0,0,0,0,0,0,0,0,0
20200430,057762,全新凱基99購03,,,,,0.00,0.00,0,0,0,0,0,0,0,0,0,0,0,0,0
20200430,057763,康控凱基99購02,0.46,0.46,0.45,0.46,+0.06,15.0,60000,4,27400,0,0,0,0,0,0,60000,0,60000,60000
20200430,057764,台表科凱基9A購01,0.32,0.32,0.32,0.32,0.00,0.00,2000,1,640,0,0,0,0,0,0,2000,0,2000,2000
20200430,057765,康舒凱基98購01,0.37,0.37,0.37,0.37,0.00,0.00,20000,1,7400,0,0,0,0,0,0,0,20000,-20000,-20000
20200430,057766,矽力凱基98購03,2.77,2.77,2.48,2.60,-0.30,-10.34,23000,9,60330,0,0,0,0,0,0,0,22000,-22000,-22000
20200430,057767,緯穎凱基98購06,,,,,0.00,0.00,0,0,0,0,0,0,0,0,0,0,0,0,0
20200430,057768,華新科中信9A購01,,,,,0.00,0.00,0,0,0,0,0,0,0,0,0,0,0,0,0
20200430,057769,T50反1群益98購02,,,,,0.00,0.00,0,0,0,0,0,0,0,0,0,0,0,0,0
20200430,05776P,鴻海統一98售02,,,,,0.00,0.00,0,0,0,0,0,0,0,0,0,0,0,0,0
20200430,057770,亞德客群益98購01,2.36,2.91,2.18,2.90,+0.74,34.26,2463000,51,6186160,0,0,0,0,0,0,2093000,409000,1684000,1684000
20200430,057771,鴻海群益99購01,1.63,1.63,1.63,1.63,0.00,0.00,10000,1,16300,0,0,0,0,0,0,10000,0,10000,10000
20200430,057772,台積電群益99購01,,,,,0.00,0.00,0,0,0,0,0,0,0,0,0,0,0,0,0
20200430,057773,技嘉群益9A購02,1.69,1.69,1.69,1.69,+0.03,1.81,200000,2,338000,0,0,0,0,0,0,0,200000,-200000,-200000
20200430,057774,台光電群益99購02,3.60,4.01,3.52,4.01,+0.55,15.9,255000,17,934230,0,0,0,0,0,0,62000,219000,-157000,-157000
20200430,057775,南亞科群益98購02,0.87,0.87,0.86,0.86,0.00,0.00,121000,9,105200,0,0,0,0,0,0,114000,7000,107000,107000
20200430,057776,京元電群益98購02,3.67,3.67,3.66,3.66,0.00,0.00,110000,2,402700,0,0,0,0,0,0,0,110000,-110000,-110000
20200430,057777,可成群益9A購03,1.73,1.73,1.68,1.72,-0.11,-6.01,66000,3,113040,0,0,0,0,0,0,0,66000,-66000,-66000
20200430,057778,大立光群益98購02,3.70,4.11,3.70,4.11,+0.49,13.54,164000,15,618640,0,0,0,0,0,0,111000,53000,58000,58000
20200430,057779,禾伸堂群益98購02,3.74,3.74,3.53,3.53,+0.03,0.86,63000,2,233520,0,0,0,0,0,0,10000,53000,-43000,-43000
20200430,05777P,台積電統一96售04,,,,,0.00,0.00,0,0,0,0,0,0,0,0,0,0,0,0,0
20200430,057780,台郡群益98購02,1.75,1.78,1.72,1.78,+0.06,3.49,405000,12,702840,0,0,0,0,0,0,219000,186000,33000,33000
20200430,057781,國巨國票99購04,,,,,0.00,0.00,0,0,0,0,0,0,0,0,0,0,0,0,0
20200430,057782,台積電國票99購07,,,,,0.00,0.00,0,0,0,0,0,0,0,0,0,0,0,0,0
20200430,057783,台積電國票9A購01,,,,,0.00,0.00,0,0,0,0,0,0,0,0,0,0,0,0,0
20200430,057784,台積電國票9B購01,,,,,0.00,0.00,0,0,0,0,0,0,0,0,0,0,0,0,0
20200430,057785,智邦國票99購02,,,,,0.00,0.00,0,0,0,0,0,0,0,0,0,0,0,0,0
20200430,057786,聯發科國票98購05,1.45,1.54,1.45,1.54,+0.44,40.0,3000,2,4440,0,0,0,0,0,0,3000,0,3000,3000
20200430,057787,TPK國票99購01,2.72,2.72,2.46,2.46,-0.17,-6.46,91000,5,229720,0,0,0,0,0,0,0,91000,-91000,-91000
20200430,057788,嘉聯益國票99購01,1.29,1.32,1.28,1.32,+0.15,12.82,72000,6,92920,0,0,0,0,0,0,64000,34000,30000,30000
20200430,057789,上銀統一9A購01,1.35,1.64,1.31,1.64,+0.45,37.82,401000,15,588140,0,0,0,0,0,0,51000,350000,-299000,-299000
20200430,05778P,台積電統一96售05,2.84,2.84,2.84,2.84,0.00,0.00,10000,1,28400,0,0,0,0,0,0,10000,10000,0,0
20200430,057790,台積電統一99購04,,,,,0.00,0.00,0,0,0,0,0,0,0,0,0,0,0,0,0
20200430,057791,可成統一99購01,,,,,0.00,0.00,0,0,0,0,0,0,0,0,0,0,0,0,0
20200430,057792,群創統一99購01,0.32,0.32,0.32,0.32,+0.01,3.23,15000,1,4800,0,0,0,0,0,0,15000,0,15000,15000
20200430,057793,群創統一99購02,0.47,0.47,0.47,0.47,-0.04,-7.84,432000,4,203040,0,0,0,0,0,0,0,432000,-432000,-432000
20200430,057794,T50反1兆豐99購02,0.75,0.75,0.75,0.75,-0.11,-12.79,10000,1,7500,0,0,0,0,0,0,0,10000,-10000,-10000
20200430,057795,鴻海兆豐99購02,0.92,0.94,0.91,0.94,+0.03,3.3,12000,5,11110,0,0,0,0,0,0,6000,6000,0,0
20200430,057796,鴻海兆豐99購03,,,,,0.00,0.00,0,0,0,0,0,0,0,0,0,0,0,0,0
20200430,057797,大立光兆豐99購01,0.47,0.47,0.47,0.47,+0.04,9.3,10000,1,4700,0,0,0,0,0,0,10000,0,10000,10000
20200430,057798,貿聯兆豐99購01,0.80,0.95,0.80,0.94,+0.17,22.08,1424000,58,1223130,0,0,0,0,0,0,291000,1127000,-836000,-836000
20200430,057799,世紀鋼兆豐98購01,1.05,1.12,1.05,1.12,+0.08,7.69,38000,3,41140,0,0,0,0,0,0,19000,0,19000,19000
20200430,05779P,台積電統一96售06,,,,,0.00,0.00,0,0,0,0,0,0,0,0,0,0,0,0,0
20200430,057800,元油2X元大98購18,,,,,0.00,0.00,0,0,0,0,0,0,0,0,0,0,0,0,0
20200430,057801,元油2X元大98購19,,,,,0.00,0.00,0,0,0,0,0,0,0,0,0,0,0,0,0
20200430,057802,卜蜂元大98購01,1.81,1.81,1.71,1.73,-0.01,-0.57,30000,4,51660,0,0,0,0,0,0,28000,2000,26000,26000
20200430,057803,上銀元大98購08,1.38,1.69,1.34,1.69,+0.51,43.22,697000,36,983590,0,0,0,0,0,0,347000,350000,-3000,-3000
20200430,057804,為升元大98購01,0.96,1.01,0.96,0.97,+0.02,2.11,268000,12,265380,0,0,0,0,0,0,0,268000,-268000,-268000
20200430,057805,華通元大98購06,2.52,2.86,2.52,2.86,+0.45,18.67,370000,40,978230,0,0,0,0,0,0,197000,111000,86000,86000
20200430,057806,國巨元大98購20,,,,,0.00,0.00,0,0,0,0,0,0,0,0,0,0,0,0,0
20200430,057807,友訊元大98購02,,,,,0.00,0.00,0,0,0,0,0,0,0,0,0,0,0,0,0
20200430,057808,旺宏元大99購05,1.90,1.91,1.82,1.82,+0.11,6.43,495000,39,910390,0,0,0,0,0,0,467000,31000,436000,436000
20200430,057809,英業達元大98購01,2.21,2.21,2.16,2.19,-0.01,-0.45,152000,12,333850,0,0,0,0,0,0,98000,54000,44000,44000
20200430,05780P,台積電統一96售07,,,,,0.00,0.00,0,0,0,0,0,0,0,0,0,0,0,0,0
20200430,057810,技嘉元大98購06,,,,,0.00,0.00,0,0,0,0,0,0,0,0,0,0,0,0,0
20200430,057811,南亞科元大98購08,,,,,0.00,0.00,0,0,0,0,0,0,0,0,0,0,0,0,0
20200430,057812,友達元大9A購05,0.62,0.63,0.61,0.62,+0.02,3.33,506000,24,313720,0,0,0,0,0,0,315000,191000,124000,124000
20200430,057813,京元電元大98購03,,,,,0.00,0.00,0,0,0,0,0,0,0,0,0,0,0,0,0
20200430,057814,聯發科元大98購12,2.34,2.47,2.34,2.47,+0.43,21.08,5000,2,11960,0,0,0,0,0,0,5000,0,5000,5000
20200430,057815,信邦元大98購01,2.95,2.95,2.68,2.74,-0.17,-5.84,171000,17,475910,0,0,0,0,0,0,171000,0,171000,171000
20200430,057816,欣興元大98購13,2.52,2.53,2.44,2.44,+0.04,1.67,134000,8,338190,0,0,0,0,0,0,84000,51000,33000,33000
20200430,057817,景碩元大98購01,2.57,2.78,2.52,2.70,+0.21,8.43,546000,40,1408730,0,0,0,0,0,0,281000,260000,21000,21000
20200430,057818,泰碩元大9A購01,,,,,0.00,0.00,0,0,0,0,0,0,0,0,0,0,0,0,0
20200430,057819,新日興元大99購01,2.33,2.33,2.21,2.21,-0.09,-3.91,132000,12,296880,0,0,0,0,0,0,132000,0,132000,132000
20200430,05781P,臺股指統一99售02,,,,,0.00,0.00,0,0,0,0,0,0,0,0,0,0,0,0,0
20200430,057820,華擎元大98購02,1.44,1.44,1.38,1.38,+0.01,0.73,183000,15,257310,0,0,0,0,0,0,183000,103000,80000,80000
20200430,057821,晶相光元大98購03,1.37,1.38,1.29,1.33,-0.07,-5.0,65000,9,88470,0,0,0,0,0,0,65000,15000,50000,50000
20200430,057822,牧德元大9A購01,,,,,0.00,0.00,0,0,0,0,0,0,0,0,0,0,0,0,0
20200430,057823,神達元大98購01,,,,,0.00,0.00,0,0,0,0,0,0,0,0,0,0,0,0,0
20200430,057824,日月光元大98購01,1.96,2.09,1.93,2.09,+0.20,10.58,344000,21,685630,0,0,0,0,0,0,168000,176000,-8000,-8000
20200430,057825,和碩元大98購02,,,,,0.00,0.00,0,0,0,0,0,0,0,0,0,0,0,0,0
20200430,057826,祥碩元大98購08,2.34,2.34,1.88,1.89,-0.27,-12.5,107000,11,221860,0,0,0,0,0,0,71000,36000,35000,35000
20200430,057827,康友元大98購03,0.66,0.68,0.66,0.68,+0.04,6.25,104000,5,69040,0,0,0,0,0,0,84000,20000,64000,64000
20200430,057828,緯穎元大99購02,2.54,3.05,2.54,3.05,+0.61,25.0,34000,3,89360,0,0,0,0,0,0,0,34000,-34000,-34000
20200430,057829,臺股指元大98購12,,,,,0.00,0.00,0,0,0,0,0,0,0,0,0,0,0,0,0
20200430,05782P,聯詠元富96售02,,,,,0.00,0.00,0,0,0,0,0,0,0,0,0,0,0,0,0
20200430,057830,T50反1台新02購02,,,,,0.00,0.00,0,0,0,0,0,0,0,0,0,0,0,0,0
20200430,057831,聯發科元富02購04,2.73,2.88,2.73,2.88,+0.38,15.2,47000,6,132760,0,0,0,0,0,0,1000,46000,-45000,-45000
20200430,057832,聯發科元富02購05,3.60,3.72,3.60,3.72,+0.35,10.39,47000,9,172850,0,0,0,0,0,0,12000,35000,-23000,-23000
20200430,057833,聯發科元富02購06,3.35,3.40,3.31,3.39,+0.40,13.38,90000,8,302460,0,0,0,0,0,0,0,90000,-90000,-90000
20200430,057834,聯發科元富02購07,4.06,4.10,4.01,4.10,+0.57,16.15,10000,4,40660,0,0,0,0,0,0,0,10000,-10000,-10000
20200430,057835,華擎元富9B購01,2.13,2.13,1.92,2.01,-0.01,-0.5,352000,12,702270,0,0,0,0,0,0,215000,142000,73000,73000
20200430,057836,南亞科國泰9A購01,1.35,1.35,1.27,1.29,0.00,0.00,158000,8,206380,0,0,0,0,0,0,157000,1000,156000,156000
20200430,057837,康控國泰99購02,1.01,1.27,1.01,1.27,+0.34,36.56,252000,8,281530,0,0,0,0,0,0,108000,144000,-36000,-36000
20200430,057838,台郡國泰99購01,,,,,0.00,0.00,0,0,0,0,0,0,0,0,0,0,0,0,0
20200430,057839,台積電富邦9A購02,,,,,0.00,0.00,0,0,0,0,0,0,0,0,0,0,0,0,0
20200430,05783P,嘉澤元富96售01,,,,,0.00,0.00,0,0,0,0,0,0,0,0,0,0,0,0,0
20200430,057840,健策富邦99購01,,,,,0.00,0.00,0,0,0,0,0,0,0,0,0,0,0,0,0
20200430,057841,茂林富邦9A購02,0.38,0.38,0.35,0.37,0.00,0.00,903000,19,324090,0,0,0,0,0,0,835000,50000,785000,785000
20200430,057842,緯穎富邦99購02,0.41,0.54,0.41,0.54,+0.16,42.11,214000,8,96940,0,0,0,0,0,0,44000,160000,-116000,-116000
20200430,057843,晶技永豐98購02,6.85,7.25,6.80,7.25,+0.40,5.84,63000,10,436200,0,0,0,0,0,0,14000,49000,-35000,-35000
20200430,057844,新日興永豐99購01,0.21,0.21,0.21,0.21,-0.02,-8.7,13000,2,2730,0,0,0,0,0,0,0,13000,-13000,-13000
20200430,057845,晶相光永豐98購03,0.24,0.24,0.24,0.24,-0.01,-4.0,50000,1,12000,0,0,0,0,0,0,50000,0,50000,50000
20200430,057846,神達永豐98購01,0.28,0.28,0.28,0.28,+0.01,3.7,15000,1,4200,0,0,0,0,0,0,15000,0,15000,15000
20200430,057847,聯茂永豐98購01,0.52,0.53,0.51,0.51,-0.03,-5.56,30000,10,15780,0,0,0,0,0,0,30000,0,30000,30000
20200430,057848,台表科永豐98購02,,,,,0.00,0.00,0,0,0,0,0,0,0,0,0,0,0,0,0
20200430,057849,南茂永豐98購02,1.16,1.18,1.16,1.18,+0.07,6.31,61000,3,70880,0,0,0,0,0,0,0,61000,-61000,-61000
20200430,05784P,臺股指元大96售18,,,,,0.00,0.00,0,0,0,0,0,0,0,0,0,0,0,0,0
20200430,057850,上銀兆豐99購02,,,,,0.00,0.00,0,0,0,0,0,0,0,0,0,0,0,0,0
20200430,057851,鴻海國票99購06,,,,,0.00,0.00,0,0,0,0,0,0,0,0,0,0,0,0,0
20200430,057852,國巨國票99購05,,,,,0.00,0.00,0,0,0,0,0,0,0,0,0,0,0,0,0
20200430,057853,旺宏國票99購05,3.23,3.23,3.14,3.14,+0.30,10.56,205000,2,644150,0,0,0,0,0,0,205000,0,205000,205000
20200430,057854,聯發科國票99購03,,,,,0.00,0.00,0,0,0,0,0,0,0,0,0,0,0,0,0
20200430,057855,晶技國票99購01,,,,,0.00,0.00,0,0,0,0,0,0,0,0,0,0,0,0,0
20200430,057856,聯鈞國票99購03,3.21,3.21,2.95,2.95,-0.20,-6.35,14000,2,42340,0,0,0,0,0,0,14000,0,14000,14000
20200430,057857,牧德國票99購01,1.09,1.14,1.09,1.13,+0.10,9.71,420000,11,466400,0,0,0,0,0,0,17000,403000,-386000,-386000
20200430,057858,T50正2康和98購01,0.13,0.18,0.13,0.18,+0.06,50.0,361000,12,53890,0,0,0,0,0,0,321000,0,321000,321000
20200430,057859,神達康和98購01,1.34,1.34,1.34,1.34,+0.02,1.52,13000,1,17420,0,0,0,0,0,0,0,13000,-13000,-13000
20200430,05785P,臺股指元大96售19,,,,,0.00,0.00,0,0,0,0,0,0,0,0,0,0,0,0,0
20200430,057860,金寶凱基98購01,,,,,0.00,0.00,0,0,0,0,0,0,0,0,0,0,0,0,0
20200430,057861,台積電凱基98購16,0.61,0.61,0.61,0.61,+0.04,7.02,3000,1,1830,0,0,0,0,0,0,3000,0,3000,3000
20200430,057862,智邦凱基99購01,2.21,2.21,1.95,1.95,-0.45,-18.75,14000,5,28080,0,0,0,0,0,0,14000,0,14000,14000
20200430,057863,美律凱基9A購01,0.87,0.94,0.86,0.92,+0.07,8.24,59000,9,52650,0,0,0,0,0,0,38000,58000,-20000,-20000
20200430,057864,奇力新凱基99購03,,,,,0.00,0.00,0,0,0,0,0,0,0,0,0,0,0,0,0
20200430,057865,富邦金凱基98購01,1.04,1.14,1.02,1.14,+0.16,16.33,385000,38,409850,0,0,0,0,0,0,131000,266000,-135000,-135000
20200430,057866,玉山金凱基98購01,0.28,0.28,0.28,0.28,-0.06,-17.65,10000,1,2800,0,0,0,0,0,0,10000,0,10000,10000
20200430,057867,大立光凱基98購17,1.29,1.39,1.29,1.39,+0.15,12.1,56000,9,74420,0,0,0,0,0,0,45000,11000,34000,34000
20200430,057868,大立光凱基98購18,3.30,3.30,3.30,3.30,0.00,0.00,3000,1,9900,0,0,0,0,0,0,0,3000,-3000,-3000
20200430,057869,大立光凱基99購01,,,,,0.00,0.00,0,0,0,0,0,0,0,0,0,0,0,0,0
20200430,05786P,臺股指永昌96售03,8.60,8.60,8.60,8.60,0.00,0.00,10000,1,86000,0,0,0,0,0,0,10000,10000,0,0
20200430,057870,大立光凱基99購02,3.06,3.38,3.06,3.38,+0.37,12.29,34000,4,105720,0,0,0,0,0,0,25000,9000,16000,16000
20200430,057871,國巨元大99購09,,,,,0.00,0.00,0,0,0,0,0,0,0,0,0,0,0,0,0
20200430,057872,旺宏元大99購06,2.41,2.41,2.33,2.35,+0.17,7.8,401000,29,946860,0,0,0,0,0,0,355000,55000,300000,300000
20200430,057873,義隆元大98購03,2.80,3.15,2.76,2.97,+0.14,4.95,648000,50,1910880,0,0,0,0,0,0,278000,485000,-207000,-207000
20200430,057874,可成元大99購02,1.83,1.83,1.83,1.83,-0.04,-2.14,50000,1,91500,0,0,0,0,0,0,0,50000,-50000,-50000
20200430,057875,京鼎元大98購03,1.43,1.68,1.42,1.53,+0.17,12.5,790000,16,1141320,0,0,0,0,0,0,458000,334000,124000,124000
20200430,057876,隆達元大98購01,2.54,2.54,2.32,2.32,-0.40,-14.71,8000,4,19880,0,0,0,0,0,0,6000,2000,4000,4000
20200430,057877,神達元大99購01,2.98,2.99,2.90,2.90,+0.08,2.84,109000,7,319680,0,0,0,0,0,0,51000,58000,-7000,-7000
20200430,057878,台郡元大99購04,2.39,2.51,2.32,2.51,+0.10,4.15,105000,6,251330,0,0,0,0,0,0,10000,95000,-85000,-85000
20200430,057879,電子類元大99購02,,,,,0.00,0.00,0,0,0,0,0,0,0,0,0,0,0,0,0
20200430,05787P,臺股指永昌96售04,8.50,8.50,8.50,8.50,-2.00,-19.05,10000,1,85000,0,0,0,0,0,0,10000,10000,0,0
20200430,057880,金融類元大99購02,,,,,0.00,0.00,0,0,0,0,0,0,0,0,0,0,0,0,0
20200430,057881,SP黃豆群益9A購01,0.69,0.69,0.69,0.69,+0.25,56.82,1000,1,690,0,0,0,0,0,0,0,0,0,0
20200430,057882,華通群益9A購03,2.46,2.60,2.46,2.60,+0.38,17.12,122000,6,309250,0,0,0,0,0,0,17000,107000,-90000,-90000
20200430,057883,中環群益98購01,0.61,0.68,0.61,0.66,+0.04,6.45,826000,14,535180,0,0,0,0,0,0,228000,598000,-370000,-370000
20200430,057884,華邦電群益98購02,,,,,0.00,0.00,0,0,0,0,0,0,0,0,0,0,0,0,0
20200430,057885,台光電群益98購04,2.11,2.38,2.11,2.38,+0.31,14.98,319000,17,688050,0,0,0,0,0,0,67000,259000,-192000,-192000
20200430,057886,聯詠群益98購01,1.27,1.34,1.23,1.34,+0.08,6.35,558000,18,710950,0,0,0,0,0,0,289000,269000,20000,20000
20200430,057887,智原群益98購04,1.40,1.43,1.39,1.39,+0.02,1.46,67000,7,94470,0,0,0,0,0,0,19000,46000,-27000,-27000
20200430,057888,貿聯群益98購02,2.80,3.28,2.80,3.28,+0.61,22.85,128000,10,383480,0,0,0,0,0,0,29000,99000,-70000,-70000
20200430,057889,致新群益99購01,1.12,1.12,1.12,1.12,+0.13,13.13,1000,1,1120,0,0,0,0,0,0,1000,0,1000,1000
20200430,05788P,臺股指永昌96售05,9.00,9.00,9.00,9.00,0.00,0.00,10000,1,90000,0,0,0,0,0,0,10000,10000,0,0
20200430,057890,滬深反統一98購01,0.91,0.91,0.85,0.85,-0.10,-10.53,20000,2,17600,0,0,0,0,0,0,0,20000,-20000,-20000
20200430,057891,華新科統一9A購01,,,,,0.00,0.00,0,0,0,0,0,0,0,0,0,0,0,0,0
20200430,057892,上証2X元富02購01,,,,,0.00,0.00,0,0,0,0,0,0,0,0,0,0,0,0,0
20200430,057893,亞德客元富98購03,2.16,2.60,2.16,2.60,+0.58,28.71,119000,9,269780,0,0,0,0,0,0,60000,59000,1000,1000
20200430,057894,華通元富02購02,2.44,2.74,2.44,2.74,+0.33,13.69,354000,31,898310,0,0,0,0,0,0,188000,166000,22000,22000
20200430,057895,全新元富9B購01,0.74,0.74,0.74,0.74,-0.01,-1.33,25000,2,18500,0,0,0,0,0,0,10000,15000,-5000,-5000
20200430,057896,嘉晶元富98購01,2.28,2.28,2.28,2.28,+0.15,7.04,20000,1,45600,0,0,0,0,0,0,20000,0,20000,20000
20200430,057897,華通富邦99購01,,,,,0.00,0.00,0,0,0,0,0,0,0,0,0,0,0,0,0
20200430,057898,元油2X永豐98購06,,,,,0.00,0.00,0,0,0,0,0,0,0,0,0,0,0,0,0
20200430,057899,台積電永豐98購04,0.51,0.51,0.51,0.51,0.00,0.00,10000,1,5100,0,0,0,0,0,0,10000,10000,0,0
20200430,05789P,臺股指永昌96售06,9.50,9.50,9.50,9.50,0.00,0.00,10000,1,95000,0,0,0,0,0,0,10000,10000,0,0
20200430,057900,南亞科永豐98購01,1.39,1.39,1.37,1.37,+0.04,3.01,32000,3,44080,0,0,0,0,0,0,32000,0,32000,32000
20200430,057901,大立光永豐98購04,1.29,1.39,1.29,1.39,+0.14,11.2,51000,10,66910,0,0,0,0,0,0,32000,19000,13000,13000
20200430,057902,嘉晶永豐98購02,0.52,0.52,0.52,0.52,+0.07,15.56,10000,1,5200,0,0,0,0,0,0,10000,0,10000,10000
20200430,057903,聯鈞永豐99購01,0.52,0.52,0.50,0.50,-0.04,-7.41,233000,9,117700,0,0,0,0,0,0,203000,30000,173000,173000
20200430,057904,矽力永豐98購01,0.78,0.78,0.64,0.70,-0.10,-12.5,556000,27,383950,0,0,0,0,0,0,75000,481000,-406000,-406000
20200430,057905,臺股指永豐98購06,,,,,0.00,0.00,0,0,0,0,0,0,0,0,0,0,0,0,0
20200430,057906,福懋科中信99購01,,,,,0.00,0.00,0,0,0,0,0,0,0,0,0,0,0,0,0
20200430,057907,台達電亞東99購01,,,,,0.00,0.00,0,0,0,0,0,0,0,0,0,0,0,0,0
20200430,057908,國泰金亞東99購01,0.56,0.56,0.56,0.56,0.00,0.00,2000,1,1120,0,0,0,0,0,0,2000,0,2000,2000
20200430,057909,台光電兆豐98購01,1.15,1.22,1.15,1.22,0.00,0.00,234000,4,277780,0,0,0,0,0,0,0,234000,-234000,-234000
20200430,05790P,臺股指永昌96售07,10.50,10.50,10.50,10.50,0.00,0.00,10000,1,105000,0,0,0,0,0,0,10000,10000,0,0
20200430,057910,華新科兆豐99購02,0.37,0.37,0.37,0.37,+0.03,8.82,10000,1,3700,0,0,0,0,0,0,10000,10000,0,0
20200430,057911,國巨日盛98購01,,,,,0.00,0.00,0,0,0,0,0,0,0,0,0,0,0,0,0
20200430,057912,美律日盛99購01,0.97,1.06,0.97,1.02,+0.06,6.25,1377000,35,1405220,0,0,0,0,0,0,355000,1077000,-722000,-722000
20200430,057913,健策日盛98購01,,,,,0.00,0.00,0,0,0,0,0,0,0,0,0,0,0,0,0
20200430,057914,日月光日盛9A購01,,,,,0.00,0.00,0,0,0,0,0,0,0,0,0,0,0,0,0
20200430,057915,台泥凱基98購01,2.14,2.28,2.14,2.25,+0.14,6.64,125000,11,277590,0,0,0,0,0,0,40000,85000,-45000,-45000
20200430,057916,國巨凱基98購13,0.82,0.87,0.81,0.81,+0.03,3.85,76000,6,64310,0,0,0,0,0,0,47000,29000,18000,18000
20200430,057917,台積電凱基98購17,2.36,2.36,2.36,2.36,+0.16,7.27,10000,1,23600,0,0,0,0,0,0,10000,0,10000,10000
20200430,057918,旺宏凱基99購01,2.02,2.02,1.95,1.95,+0.11,5.98,247000,12,493610,0,0,0,0,0,0,227000,21000,206000,206000
20200430,057919,技嘉凱基98購03,0.97,0.97,0.97,0.97,-0.02,-2.02,10000,1,9700,0,0,0,0,0,0,10000,10000,0,0
20200430,05791P,臺股指中信99售06,,,,,0.00,0.00,0,0,0,0,0,0,0,0,0,0,0,0,0
20200430,057920,奇力新凱基98購08,1.18,1.20,1.18,1.20,+0.09,8.11,20000,3,23800,0,0,0,0,0,0,0,20000,-20000,-20000
20200430,057921,可成凱基98購09,,,,,0.00,0.00,0,0,0,0,0,0,0,0,0,0,0,0,0
20200430,057922,華新科凱基99購01,,,,,0.00,0.00,0,0,0,0,0,0,0,0,0,0,0,0,0
20200430,057923,晶豪科凱基98購02,1.90,1.90,1.76,1.76,+0.22,14.29,4000,2,7180,0,0,0,0,0,0,1000,3000,-2000,-2000
20200430,057924,健策凱基98購02,1.50,1.50,1.50,1.50,+0.05,3.45,30000,2,45000,0,0,0,0,0,0,0,30000,-30000,-30000
20200430,057925,貿聯凱基99購01,1.19,1.29,1.19,1.29,+0.17,15.18,79000,10,96570,0,0,0,0,0,0,50000,29000,21000,21000
20200430,057926,帆宣凱基98購02,0.83,0.97,0.83,0.97,0.00,0.00,292000,13,260680,0,0,0,0,0,0,0,292000,-292000,-292000
20200430,057927,勤誠凱基98購01,1.46,1.46,1.44,1.45,-0.01,-0.68,66000,3,95550,0,0,0,0,0,0,25000,41000,-16000,-16000
20200430,057928,鈺齊凱基98購02,1.14,1.19,1.09,1.13,+0.02,1.8,421000,24,473750,0,0,0,0,0,0,240000,185000,55000,55000
20200430,057929,上銀群益98購02,2.02,3.02,2.02,2.90,+0.92,46.46,676000,25,1483180,0,0,0,0,0,0,558000,118000,440000,440000
20200430,05792P,臺股指中信99售07,,,,,0.00,0.00,0,0,0,0,0,0,0,0,0,0,0,0,0
20200430,057930,旺宏群益99購04,5.85,5.85,5.60,5.70,+0.45,8.57,129000,21,732600,0,0,0,0,0,0,129000,50000,79000,79000
20200430,057931,正崴群益98購02,3.27,3.29,3.27,3.29,+0.45,15.85,189000,4,619290,0,0,0,0,0,0,107000,82000,25000,25000
20200430,057932,美律群益98購04,,,,,0.00,0.00,0,0,0,0,0,0,0,0,0,0,0,0,0
20200430,057933,聯發科群益98購06,7.75,7.75,7.75,7.75,+1.15,17.42,2000,1,15500,0,0,0,0,0,0,2000,0,2000,2000
20200430,057934,華新科群益98購07,3.72,3.72,3.72,3.72,0.00,0.00,10000,1,37200,0,0,0,0,0,0,0,10000,-10000,-10000
20200430,057935,晶技群益98購02,8.40,8.40,8.40,8.40,+0.60,7.69,7000,2,58800,0,0,0,0,0,0,0,7000,-7000,-7000
20200430,057936,健策群益99購01,3.29,3.44,3.29,3.44,+0.13,3.93,115000,6,388620,0,0,0,0,0,0,25000,92000,-67000,-67000
20200430,057937,神達群益98購02,,,,,0.00,0.00,0,0,0,0,0,0,0,0,0,0,0,0,0
20200430,057938,台表科群益98購02,1.79,1.79,1.79,1.79,-0.04,-2.19,1000,1,1790,0,0,0,0,0,0,0,1000,-1000,-1000
20200430,057939,鈺齊群益98購02,0.20,0.20,0.20,0.20,+0.01,5.26,6000,2,1200,0,0,0,0,0,0,6000,0,6000,6000
20200430,05793P,臺股指中信99售08,2.44,2.44,2.40,2.40,0.00,0.00,6000,2,14600,0,0,0,0,0,0,0,6000,-6000,-6000
20200430,057940,和大國票99購01,1.07,1.34,0.97,1.34,+0.55,69.62,507000,26,568500,0,0,0,0,0,0,302000,119000,183000,183000
20200430,057941,聯電國票99購01,0.79,0.79,0.79,0.79,+0.06,8.22,25000,1,19750,0,0,0,0,0,0,25000,0,25000,25000
20200430,057942,可成國票99購02,,,,,0.00,0.00,0,0,0,0,0,0,0,0,0,0,0,0,0
20200430,057943,可成國票99購03,3.00,3.00,2.76,2.79,-0.25,-8.22,4000,3,11310,0,0,0,0,0,0,4000,4000,0,0
20200430,057944,新日興國票99購02,3.08,3.08,2.87,2.91,-0.24,-7.62,86000,4,257880,0,0,0,0,0,0,48000,38000,10000,10000
20200430,057945,京鼎國票99購03,1.19,1.29,1.19,1.29,+0.14,12.17,34000,4,42980,0,0,0,0,0,0,11000,34000,-23000,-23000
20200430,057946,晶相光國票99購01,1.25,1.25,1.25,1.25,+0.02,1.63,49000,2,61250,0,0,0,0,0,0,25000,24000,1000,1000
20200430,057947,和碩國票99購01,,,,,0.00,0.00,0,0,0,0,0,0,0,0,0,0,0,0,0
20200430,057948,嘉聯益國票99購02,1.94,2.00,1.94,2.00,+0.11,5.82,24000,4,46980,0,0,0,0,0,0,24000,8000,16000,16000
20200430,057949,南電國票99購01,13.90,14.00,12.90,12.90,-0.40,-3.01,67000,13,921400,0,0,0,0,0,0,52000,48000,4000,4000
20200430,05794P,華邦電群益96售04,,,,,0.00,0.00,0,0,0,0,0,0,0,0,0,0,0,0,0
20200430,057950,T50正2元大9B購04,,,,,0.00,0.00,0,0,0,0,0,0,0,0,0,0,0,0,0
20200430,057951,元油2X元大98購20,,,,,0.00,0.00,0,0,0,0,0,0,0,0,0,0,0,0,0
20200430,057952,元油2X元大98購21,,,,,0.00,0.00,0,0,0,0,0,0,0,0,0,0,0,0,0
20200430,057953,聚陽元大98購01,0.48,0.50,0.47,0.48,+0.04,9.09,245000,8,116190,0,0,0,0,0,0,225000,0,225000,225000
20200430,057954,宏碁元大99購01,1.31,1.35,1.21,1.29,+0.03,2.38,347000,30,438370,0,0,0,0,0,0,267000,70000,197000,197000
20200430,057955,技嘉元大98購07,1.16,1.17,1.12,1.12,+0.02,1.82,79000,7,90720,0,0,0,0,0,0,79000,11000,68000,68000
20200430,057956,全新元大99購04,1.14,1.14,1.14,1.14,-0.03,-2.56,100000,6,114000,0,0,0,0,0,0,100000,0,100000,100000
20200430,057957,嘉晶元大98購01,3.59,4.05,3.59,3.79,+0.33,9.54,132000,10,512760,0,0,0,0,0,0,11000,116000,-105000,-105000
20200430,057958,禾伸堂元大99購05,2.30,2.30,2.18,2.18,-0.01,-0.46,24000,3,55080,0,0,0,0,0,0,24000,13000,11000,11000
20200430,057959,欣興元大98購14,4.30,4.54,4.21,4.21,+0.10,2.43,109000,16,478400,0,0,0,0,0,0,66000,53000,13000,13000
20200430,05795P,華邦電群益96售05,,,,,0.00,0.00,0,0,0,0,0,0,0,0,0,0,0,0,0
20200430,057960,聯鈞元大98購02,1.54,1.54,1.50,1.52,-0.08,-5.0,184000,9,279970,0,0,0,0,0,0,90000,94000,-4000,-4000
20200430,057961,茂林元大9A購01,1.24,1.24,1.21,1.21,-0.02,-1.63,40000,4,48900,0,0,0,0,0,0,30000,10000,20000,20000
20200430,057962,超眾元大99購03,,,,,0.00,0.00,0,0,0,0,0,0,0,0,0,0,0,0,0
20200430,057963,緯穎元大98購08,2.81,3.31,2.81,3.31,+0.75,29.3,70000,4,206220,0,0,0,0,0,0,0,70000,-70000,-70000
20200430,057964,緯穎元大99購03,3.06,3.56,3.05,3.56,+0.65,22.34,186000,21,602440,0,0,0,0,0,0,27000,159000,-132000,-132000
20200430,057965,臺股指元大98購14,0.51,0.51,0.51,0.51,0.00,0.00,3000,1,1530,0,0,0,0,0,0,3000,0,3000,3000
20200430,057966,金融類元大98購01,0.20,0.22,0.20,0.22,+0.02,10.0,120000,3,25800,0,0,0,0,0,0,0,120000,-120000,-120000
20200430,057967,聯發科國泰9A購02,2.89,3.14,2.89,3.14,+0.45,16.73,438000,18,1299770,0,0,0,0,0,0,287000,413000,-126000,-126000
20200430,057968,可成國泰9A購01,,,,,0.00,0.00,0,0,0,0,0,0,0,0,0,0,0,0,0
20200430,057969,緯穎國泰99購01,2.08,2.55,2.05,2.41,+0.46,23.59,829000,64,1856100,0,0,0,0,0,0,333000,550000,-217000,-217000
20200430,05796P,臺股指群益96售10,13.20,13.20,13.20,13.20,0.00,0.00,5000,1,66000,0,0,0,0,0,0,0,5000,-5000,-5000
20200430,057970,國巨富邦99購03,,,,,0.00,0.00,0,0,0,0,0,0,0,0,0,0,0,0,0
20200430,057971,華新科富邦9B購02,1.46,1.46,1.36,1.36,0.00,0.00,69000,5,97220,0,0,0,0,0,0,50000,19000,31000,31000
20200430,057972,群創富邦9C購01,1.04,1.05,1.04,1.05,+0.02,1.94,14000,2,14670,0,0,0,0,0,0,11000,3000,8000,8000
20200430,057973,神達富邦9A購01,0.70,0.70,0.70,0.70,0.00,0.00,35000,2,24500,0,0,0,0,0,0,30000,5000,25000,25000
20200430,057974,上銀永豐98購02,0.12,0.18,0.12,0.18,+0.08,80.0,156000,6,20820,0,0,0,0,0,0,120000,36000,84000,84000
20200430,057975,台積電永豐98購05,2.92,2.92,2.91,2.92,+0.19,6.96,107000,5,311550,0,0,0,0,0,0,89000,18000,71000,71000
20200430,057976,旺宏永豐98購03,2.32,2.35,2.32,2.35,+0.35,17.5,3000,3,6990,0,0,0,0,0,0,2000,3000,-1000,-1000
20200430,057977,台光電永豐98購02,1.20,1.20,1.20,1.20,0.00,0.00,29000,2,34800,0,0,0,0,0,0,0,29000,-29000,-29000
20200430,057978,聯發科永豐98購05,1.08,1.08,1.08,1.08,+0.09,9.09,1000,1,1080,0,0,0,0,0,0,0,0,0,0
20200430,057979,華新科永豐98購03,,,,,0.00,0.00,0,0,0,0,0,0,0,0,0,0,0,0,0
20200430,05797P,臺股指群益96售11,,,,,0.00,0.00,0,0,0,0,0,0,0,0,0,0,0,0,0
20200430,057980,聯詠永豐98購01,1.15,1.20,1.12,1.20,+0.03,2.56,268000,8,304810,0,0,0,0,0,0,206000,62000,144000,144000
20200430,057981,臻鼎永豐98購01,0.19,0.22,0.19,0.22,0.00,0.00,18000,4,3810,0,0,0,0,0,0,8000,10000,-2000,-2000
20200430,057982,帆宣永豐98購01,0.74,0.89,0.74,0.89,+0.13,17.11,314000,14,247170,0,0,0,0,0,0,0,314000,-314000,-314000
20200430,057983,緯穎永豐98購03,,,,,0.00,0.00,0,0,0,0,0,0,0,0,0,0,0,0,0
20200430,057984,聯發科台新98購01,1.61,1.61,1.61,1.61,+0.20,14.18,2000,1,3220,0,0,0,0,0,0,2000,0,2000,2000
20200430,057985,華通元富02購03,2.52,2.85,2.52,2.85,+0.32,12.65,260000,24,678310,0,0,0,0,0,0,140000,90000,50000,50000
20200430,057986,華新科元富99購05,,,,,0.00,0.00,0,0,0,0,0,0,0,0,0,0,0,0,0
20200430,057987,大立光元富98購02,1.22,1.41,1.22,1.40,+0.24,20.69,2057000,111,2693460,0,0,0,0,0,0,1223000,826000,397000,397000
20200430,057988,鈺齊元富98購02,1.51,1.57,1.47,1.57,+0.03,1.95,292000,24,444740,0,0,0,0,0,0,176000,116000,60000,60000
20200430,057989,旺宏統一99購04,0.99,0.99,0.95,0.95,+0.08,9.2,537000,8,521330,0,0,0,0,0,0,537000,0,537000,537000
20200430,05798P,臺股指群益96售12,,,,,0.00,0.00,0,0,0,0,0,0,0,0,0,0,0,0,0
20200430,057990,美律統一99購02,1.36,1.38,1.36,1.38,+0.20,16.95,16000,3,21960,0,0,0,0,0,0,0,16000,-16000,-16000
20200430,057991,健策統一9C購01,,,,,0.00,0.00,0,0,0,0,0,0,0,0,0,0,0,0,0
20200430,057992,大立光日盛98購01,,,,,0.00,0.00,0,0,0,0,0,0,0,0,0,0,0,0,0
20200430,057993,中環中信98購01,0.66,0.70,0.65,0.70,+0.06,9.38,114000,7,75600,0,0,0,0,0,0,94000,20000,74000,74000
20200430,057994,技嘉中信98購01,1.70,1.73,1.70,1.73,0.00,0.00,14000,3,23890,0,0,0,0,0,0,4000,11000,-7000,-7000
20200430,057995,華新科中信98購02,0.74,0.76,0.70,0.72,+0.01,1.41,1109000,21,807830,0,0,0,0,0,0,66000,1043000,-977000,-977000
20200430,057996,臻鼎中信98購01,1.41,1.43,1.35,1.35,+0.02,1.5,40000,3,56200,0,0,0,0,0,0,20000,20000,0,0
20200430,057997,旺宏第一9C購01,1.58,1.59,1.54,1.54,+0.14,10.0,346000,8,537250,0,0,0,0,0,0,262000,84000,178000,178000
20200430,057998,玉晶光麥證9A購01,,,,,0.00,0.00,0,0,0,0,0,0,0,0,0,0,0,0,0
20200430,057999,智邦亞東99購02,,,,,0.00,0.00,0,0,0,0,0,0,0,0,0,0,0,0,0
20200430,05799P,臺股指群益96售13,,,,,0.00,0.00,0,0,0,0,0,0,0,0,0,0,0,0,0
20200430,058000,FBVIX群益9B購01,,,,,0.00,0.00,0,0,0,0,0,0,0,0,0,0,0,0,0
20200430,058001,FBVIX群益9B購02,,,,,0.00,0.00,0,0,0,0,0,0,0,0,0,0,0,0,0
20200430,058002,FBVIX群益9C購01,,,,,0.00,0.00,0,0,0,0,0,0,0,0,0,0,0,0,0
20200430,058003,FBVIX群益9C購02,,,,,0.00,0.00,0,0,0,0,0,0,0,0,0,0,0,0,0
20200430,058004,大立光群益98購03,2.25,2.26,2.25,2.26,+0.34,17.71,13000,2,29280,0,0,0,0,0,0,13000,0,13000,13000
20200430,058005,茂林群益98購04,0.99,1.00,0.97,0.97,0.00,0.00,22000,5,21870,0,0,0,0,0,0,10000,12000,-2000,-2000
20200430,058006,台郡群益98購04,3.31,3.46,3.31,3.46,+0.33,10.54,86000,3,293210,0,0,0,0,0,0,57000,29000,28000,28000
20200430,058007,南電群益98購02,4.80,4.86,4.80,4.86,+0.27,5.88,48000,2,230460,0,0,0,0,0,0,48000,0,48000,48000
20200430,058008,禾伸堂國票99購02,3.07,3.10,3.07,3.10,+0.15,5.08,16000,2,49360,0,0,0,0,0,0,8000,8000,0,0
20200430,058009,智易國票99購01,5.95,6.05,5.95,6.05,-0.25,-3.97,82000,3,488500,0,0,0,0,0,0,82000,0,82000,82000
20200430,05800P,台積電兆豐96售04,4.80,4.81,4.38,4.38,-1.62,-27.0,143000,15,677570,0,0,0,0,0,0,143000,141000,2000,2000
20200430,058010,帆宣國票98購01,2.58,3.08,2.47,3.02,+0.56,22.76,136000,20,386110,0,0,0,0,0,0,4000,136000,-132000,-132000
20200430,058011,台虹國票99購01,3.64,3.64,3.60,3.60,0.00,0.00,61000,4,220240,0,0,0,0,0,0,61000,0,61000,61000
20200430,058012,鈺齊國票99購01,2.07,2.25,1.98,2.22,0.00,0.00,517000,20,1099790,0,0,0,0,0,0,332000,192000,140000,140000
20200430,058013,SP黃豆凱基9A購01,,,,,0.00,0.00,0,0,0,0,0,0,0,0,0,0,0,0,0
20200430,058014,上銀凱基99購02,1.98,2.08,1.96,2.08,+0.18,9.47,45000,3,89500,0,0,0,0,0,0,5000,40000,-35000,-35000
20200430,058015,旺宏凱基99購02,4.93,4.93,4.79,4.93,+0.53,12.05,28000,4,137360,0,0,0,0,0,0,6000,22000,-16000,-16000
20200430,058016,智邦凱基98購06,6.60,6.85,6.60,6.85,+0.30,4.58,16000,12,107100,0,0,0,0,0,0,16000,0,16000,16000
20200430,058017,漢唐凱基99購01,2.14,2.14,2.14,2.14,+0.03,1.42,60000,1,128400,0,0,0,0,0,0,60000,0,60000,60000
20200430,058018,南亞科凱基99購03,,,,,0.00,0.00,0,0,0,0,0,0,0,0,0,0,0,0,0
20200430,058019,美律凱基99購04,1.59,1.67,1.59,1.67,0.00,0.00,32000,5,52240,0,0,0,0,0,0,0,32000,-32000,-32000
20200430,05801P,正崴兆豐96售01,2.75,2.75,2.75,2.75,0.00,0.00,7000,1,19250,0,0,0,0,0,0,0,7000,-7000,-7000
20200430,058020,大立光凱基99購03,,,,,0.00,0.00,0,0,0,0,0,0,0,0,0,0,0,0,0
20200430,058021,牧德凱基98購02,0.91,0.97,0.91,0.97,0.00,0.00,89000,8,83690,0,0,0,0,0,0,19000,70000,-51000,-51000
20200430,058022,樺漢凱基99購02,2.66,2.82,2.66,2.82,+0.11,4.06,61000,4,166770,0,0,0,0,0,0,40000,21000,19000,19000
20200430,058023,南電凱基98購02,,,,,0.00,0.00,0,0,0,0,0,0,0,0,0,0,0,0,0
20200430,058024,台積電國泰9A購01,,,,,0.00,0.00,0,0,0,0,0,0,0,0,0,0,0,0,0
20200430,058025,聯茂國泰99購01,2.21,2.21,2.14,2.14,-0.18,-7.76,100000,12,217150,0,0,0,0,0,0,100000,0,100000,100000
20200430,058026,上銀富邦9A購01,1.23,1.50,1.19,1.50,+0.35,30.43,1907000,90,2435760,0,0,0,0,0,0,934000,988000,-54000,-54000
20200430,058027,鴻海富邦98購04,2.54,2.58,2.50,2.58,+0.08,3.2,108000,10,274220,0,0,0,0,0,0,44000,64000,-20000,-20000
20200430,058028,國巨富邦99購04,,,,,0.00,0.00,0,0,0,0,0,0,0,0,0,0,0,0,0
20200430,058029,台灣50永豐9A購01,,,,,0.00,0.00,0,0,0,0,0,0,0,0,0,0,0,0,0
20200430,05802P,臺股指兆豐96售02,,,,,0.00,0.00,0,0,0,0,0,0,0,0,0,0,0,0,0
20200430,058030,國巨永豐98購08,,,,,0.00,0.00,0,0,0,0,0,0,0,0,0,0,0,0,0
20200430,058031,旺宏永豐98購04,2.60,2.60,2.54,2.54,+0.30,13.39,17000,10,43900,0,0,0,0,0,0,17000,10000,7000,7000
20200430,058032,大立光永豐98購05,1.90,2.14,1.90,2.14,+0.29,15.68,49000,6,97230,0,0,0,0,0,0,25000,24000,1000,1000
20200430,058033,景碩永豐98購02,2.11,2.33,2.09,2.33,+0.28,13.66,150000,7,329120,0,0,0,0,0,0,30000,120000,-90000,-90000
20200430,058034,神達永豐98購02,0.14,0.15,0.14,0.15,0.00,0.00,40000,2,5850,0,0,0,0,0,0,40000,0,40000,40000
20200430,058035,旭富永豐98購02,0.81,0.83,0.76,0.77,+0.02,2.67,424000,30,339820,0,0,0,0,0,0,173000,248000,-75000,-75000
20200430,058036,南電永豐98購01,4.76,4.85,4.74,4.85,+0.16,3.41,23000,4,109940,0,0,0,0,0,0,23000,0,23000,23000
20200430,058037,台灣50元大9B購02,0.79,0.92,0.79,0.92,+0.19,26.03,106000,17,88920,0,0,0,0,0,0,88000,0,88000,88000
20200430,058038,滬深反元大98購01,0.54,0.54,0.54,0.54,0.00,0.00,10000,1,5400,0,0,0,0,0,0,0,10000,-10000,-10000
20200430,058039,元石油元大98購03,0.18,0.21,0.18,0.19,+0.02,11.76,1281000,49,244890,0,0,0,0,0,0,0,0,0,0
20200430,05803P,臺股指兆豐96售03,2.98,2.98,1.90,1.90,-0.20,-9.52,30000,5,73800,0,0,0,0,0,0,0,10000,-10000,-10000
20200430,058040,FBVIX元大98購01,4.31,4.31,4.31,4.31,0.00,0.00,4000,1,17240,0,0,0,0,0,0,4000,0,4000,4000
20200430,058041,FBVIX元大98購02,4.41,4.41,4.32,4.32,-0.31,-6.7,57000,3,246690,0,0,0,0,0,0,0,57000,-57000,-57000
20200430,058042,鴻海元大98購12,2.84,2.84,2.83,2.83,0.00,0.00,29000,4,82280,0,0,0,0,0,0,8000,29000,-21000,-21000
20200430,058043,鴻海元大98購13,2.40,2.43,2.40,2.42,+0.19,8.52,95000,4,229600,0,0,0,0,0,0,50000,45000,5000,5000
20200430,058044,鴻海元大99購07,,,,,0.00,0.00,0,0,0,0,0,0,0,0,0,0,0,0,0
20200430,058045,鴻海元大99購08,,,,,0.00,0.00,0,0,0,0,0,0,0,0,0,0,0,0,0
20200430,058046,國巨元大9A購01,1.25,1.25,1.25,1.25,0.00,0.00,10000,1,12500,0,0,0,0,0,0,10000,0,10000,10000
20200430,058047,可成元大98購11,1.38,1.38,1.29,1.31,-0.01,-0.76,66000,4,88240,0,0,0,0,0,0,48000,18000,30000,30000
20200430,058048,群創元大9B購07,1.00,1.00,1.00,1.00,0.00,0.00,21000,1,21000,0,0,0,0,0,0,21000,0,21000,21000
20200430,058049,帆宣元大98購01,0.85,1.03,0.85,1.00,+0.17,20.48,279000,8,263990,0,0,0,0,0,0,30000,249000,-219000,-219000
20200430,05804P,美律永豐96售01,,,,,0.00,0.00,0,0,0,0,0,0,0,0,0,0,0,0,0
20200430,058050,台郡元大99購05,1.36,1.36,1.30,1.36,+0.03,2.26,286000,13,384110,0,0,0,0,0,0,206000,80000,126000,126000
20200430,058051,同欣電元大98購03,1.13,1.21,1.13,1.19,+0.14,13.33,332000,10,393400,0,0,0,0,0,0,0,332000,-332000,-332000
20200430,058052,南電元大98購02,,,,,0.00,0.00,0,0,0,0,0,0,0,0,0,0,0,0,0
20200430,058053,上銀統一9B購01,0.87,1.08,0.84,1.05,+0.25,31.25,990000,24,921180,0,0,0,0,0,0,102000,888000,-786000,-786000
20200430,058054,台積電統一9C購01,0.73,0.73,0.73,0.73,+0.04,5.8,17000,11,12410,0,0,0,0,0,0,0,3000,-3000,-3000
20200430,058055,華擎統一9A購01,0.85,0.85,0.79,0.81,+0.01,1.25,130000,9,105920,0,0,0,0,0,0,22000,108000,-86000,-86000
20200430,058056,FBVIX元富98購01,,,,,0.00,0.00,0,0,0,0,0,0,0,0,0,0,0,0,0
20200430,058057,FBVIX元富98購02,,,,,0.00,0.00,0,0,0,0,0,0,0,0,0,0,0,0,0
20200430,058058,大立光元富9B購02,1.16,1.23,1.16,1.23,+0.19,18.27,22000,4,26610,0,0,0,0,0,0,20000,0,20000,20000
20200430,058059,晶技元富98購01,,,,,0.00,0.00,0,0,0,0,0,0,0,0,0,0,0,0,0
20200430,05805P,義隆永豐96售02,0.59,0.59,0.50,0.53,-0.07,-11.67,155000,15,81850,0,0,0,0,0,0,15000,140000,-125000,-125000
20200430,058060,貿聯元富98購01,1.12,1.12,1.12,1.12,0.00,0.00,1000,1,1120,0,0,0,0,0,0,0,1000,-1000,-1000
20200430,058061,貿聯元富9B購01,2.35,2.83,2.35,2.83,+0.57,25.22,467000,97,1196580,0,0,0,0,0,0,75000,392000,-317000,-317000
20200430,058062,上銀中信98購01,0.28,0.42,0.28,0.40,+0.17,73.91,215000,23,72320,0,0,0,0,0,0,100000,115000,-15000,-15000
20200430,058063,旺宏中信98購04,3.31,3.31,3.20,3.20,+0.32,11.11,38000,4,123680,0,0,0,0,0,0,20000,18000,2000,2000
20200430,058064,華邦電亞東99購01,,,,,0.00,0.00,0,0,0,0,0,0,0,0,0,0,0,0,0
20200430,058065,南亞科亞東99購01,,,,,0.00,0.00,0,0,0,0,0,0,0,0,0,0,0,0,0
20200430,058066,可成亞東99購01,,,,,0.00,0.00,0,0,0,0,0,0,0,0,0,0,0,0,0
20200430,058067,台積電第一9C購01,0.48,0.48,0.48,0.48,0.00,0.00,20000,2,9600,0,0,0,0,0,0,0,0,0,0
20200430,058068,旺宏凱基98購11,2.84,2.86,2.74,2.84,+0.31,12.25,191000,18,536000,0,0,0,0,0,0,190000,115000,75000,75000
20200430,058069,美律凱基99購05,3.47,3.47,3.47,3.47,0.00,0.00,10000,1,34700,0,0,0,0,0,0,0,10000,-10000,-10000
20200430,05806P,宏達電永豐96售03,,,,,0.00,0.00,0,0,0,0,0,0,0,0,0,0,0,0,0
20200430,058070,華新科凱基98購07,1.98,1.98,1.98,1.98,+0.01,0.51,5000,1,9900,0,0,0,0,0,0,0,5000,-5000,-5000
20200430,058071,大立光凱基98購19,,,,,0.00,0.00,0,0,0,0,0,0,0,0,0,0,0,0,0
20200430,058072,大立光凱基98購20,1.50,1.61,1.50,1.61,+0.19,13.38,47000,5,72430,0,0,0,0,0,0,25000,22000,3000,3000
20200430,058073,大立光凱基99購04,1.44,1.44,1.44,1.44,0.00,0.00,11000,1,15840,0,0,0,0,0,0,11000,0,11000,11000
20200430,058074,欣興凱基99購01,3.45,3.59,3.42,3.43,+0.33,10.65,62000,10,216800,0,0,0,0,0,0,56000,6000,50000,50000
20200430,058075,貿聯凱基99購02,1.09,1.09,1.09,1.09,0.00,0.00,10000,1,10900,0,0,0,0,0,0,0,10000,-10000,-10000
20200430,058076,神達凱基98購02,,,,,0.00,0.00,0,0,0,0,0,0,0,0,0,0,0,0,0
20200430,058077,超眾凱基98購02,2.49,2.61,2.48,2.48,+0.03,1.22,43000,4,108090,0,0,0,0,0,0,3000,43000,-40000,-40000
20200430,058078,景碩國票99購01,4.07,4.20,4.07,4.20,+0.15,3.7,53000,6,220680,0,0,0,0,0,0,21000,35000,-14000,-14000
20200430,058079,鴻海群益98購08,2.70,2.85,2.66,2.84,+0.19,7.17,195000,17,530980,0,0,0,0,0,0,162000,63000,99000,99000
20200430,05807P,泰鼎永豐96售03,0.19,0.19,0.16,0.16,0.00,0.00,30000,3,5100,0,0,0,0,0,0,10000,10000,0,0
20200430,058080,台積電群益98購06,5.15,5.15,5.10,5.10,+0.28,5.81,15000,8,77000,0,0,0,0,0,0,15000,15000,0,0
20200430,058081,技嘉群益9A購03,2.09,2.09,1.99,2.02,+0.04,2.02,220000,4,450100,0,0,0,0,0,0,170000,50000,120000,120000
20200430,058082,美律群益98購05,0.93,1.02,0.93,1.02,+0.10,10.87,149000,4,148470,0,0,0,0,0,0,149000,12000,137000,137000
20200430,058083,聯發科群益98購08,3.35,3.56,3.35,3.56,0.00,0.00,200000,2,678400,0,0,0,0,0,0,200000,0,200000,200000
20200430,058084,大立光群益98購04,,,,,0.00,0.00,0,0,0,0,0,0,0,0,0,0,0,0,0
20200430,058085,景碩群益9A購01,3.22,3.53,3.22,3.45,+0.15,4.55,240000,15,802560,0,0,0,0,0,0,133000,72000,61000,61000
20200430,058086,鴻海元大98購14,3.42,3.42,3.42,3.42,+0.18,5.56,24000,2,82080,0,0,0,0,0,0,24000,24000,0,0
20200430,058087,鴻海元大98購15,,,,,0.00,0.00,0,0,0,0,0,0,0,0,0,0,0,0,0
20200430,058088,鴻海元大9A購01,1.29,1.29,1.29,1.29,+0.03,2.38,10000,1,12900,0,0,0,0,0,0,10000,0,10000,10000
20200430,058089,聯發科元大98購15,3.31,3.35,3.31,3.35,+0.47,16.32,2000,2,6660,0,0,0,0,0,0,2000,0,2000,2000
20200430,05808P,臺股指國票96售01,,,,,0.00,0.00,0,0,0,0,0,0,0,0,0,0,0,0,0
20200430,058090,聯發科元大98購16,3.23,3.41,3.19,3.41,+0.44,14.81,245000,18,796710,0,0,0,0,0,0,185000,173000,12000,12000
20200430,058091,欣興元大99購03,3.32,3.33,3.27,3.31,+0.14,4.42,62000,11,205030,0,0,0,0,0,0,51000,6000,45000,45000
20200430,058092,牧德元大98購02,,,,,0.00,0.00,0,0,0,0,0,0,0,0,0,0,0,0,0
20200430,058093,神達元大9A購01,2.55,2.55,2.50,2.50,+0.09,3.73,682000,13,1712400,0,0,0,0,0,0,630000,52000,578000,578000
20200430,058094,祥碩元大98購09,1.64,1.64,1.44,1.44,0.00,0.00,63000,2,91320,0,0,0,0,0,0,60000,3000,57000,57000
20200430,058095,昇陽半元大98購03,1.74,1.78,1.68,1.77,+0.16,9.94,630000,52,1098460,0,0,0,0,0,0,121000,498000,-377000,-377000
20200430,058096,南電元大98購04,6.00,6.00,5.85,5.85,-0.05,-0.85,44000,6,262800,0,0,0,0,0,0,44000,0,44000,44000
20200430,058097,台灣50國泰99購01,1.86,1.86,1.86,1.86,+0.19,11.38,37000,1,68820,0,0,0,0,0,0,37000,37000,0,0
20200430,058098,T50反1國泰9A購02,0.88,0.88,0.88,0.88,-0.11,-11.11,6000,1,5280,0,0,0,0,0,0,0,6000,-6000,-6000
20200430,058099,鴻海國泰9A購02,0.49,0.55,0.49,0.55,+0.07,14.58,9000,3,4650,0,0,0,0,0,0,6000,0,6000,6000
20200430,05809P,臺股指國票96售02,,,,,0.00,0.00,0,0,0,0,0,0,0,0,0,0,0,0,0
20200430,058100,聯茂國泰99購02,1.62,1.63,1.55,1.63,-0.03,-1.81,123000,21,196350,0,0,0,0,0,0,92000,31000,61000,61000
20200430,058101,台積電富邦9C購01,0.38,0.45,0.38,0.41,+0.05,13.89,1920000,187,766750,0,0,0,0,0,0,1880000,1801000,79000,79000
20200430,058102,楠梓電永豐98購04,0.73,0.81,0.73,0.75,-0.04,-5.06,276000,20,208990,0,0,0,0,0,0,184000,92000,92000,92000
20200430,058103,台積電永豐98購06,0.64,0.66,0.64,0.66,0.00,0.00,3000,2,1940,0,0,0,0,0,0,3000,1000,2000,2000
20200430,058104,國巨統一9A購04,0.38,0.39,0.36,0.37,+0.04,12.12,283000,13,104940,0,0,0,0,0,0,40000,243000,-203000,-203000
20200430,058105,旺宏統一9A購02,1.70,1.74,1.64,1.64,+0.10,6.49,2061000,41,3422430,0,0,0,0,0,0,1872000,129000,1743000,1743000
20200430,058106,神達統一98購02,,,,,0.00,0.00,0,0,0,0,0,0,0,0,0,0,0,0,0
20200430,058107,全新台新99購01,,,,,0.00,0.00,0,0,0,0,0,0,0,0,0,0,0,0,0
20200430,058108,台郡台新99購01,1.37,1.37,1.37,1.37,+0.08,6.2,20000,1,27400,0,0,0,0,0,0,0,20000,-20000,-20000
20200430,058109,台灣50元富9B購01,0.57,0.62,0.57,0.62,+0.15,31.91,117000,7,70360,0,0,0,0,0,0,0,0,0,0
20200430,05810P,臺股指國票96售03,,,,,0.00,0.00,0,0,0,0,0,0,0,0,0,0,0,0,0
20200430,058110,光寶科元富98購01,2.34,2.42,2.24,2.38,+0.18,8.18,1160000,35,2699530,0,0,0,0,0,0,867000,83000,784000,784000
20200430,058111,健鼎元富98購01,1.82,1.92,1.79,1.92,+0.12,6.67,190000,19,350200,0,0,0,0,0,0,70000,120000,-50000,-50000
20200430,058112,神達元富98購01,,,,,0.00,0.00,0,0,0,0,0,0,0,0,0,0,0,0,0
20200430,058113,百和元富98購01,1.15,1.16,1.07,1.14,-0.01,-0.87,796000,45,886300,0,0,0,0,0,0,769000,27000,742000,742000
20200430,058114,台積電第一01購01,2.13,2.15,2.13,2.15,+0.16,8.04,166000,10,355980,0,0,0,0,0,0,0,166000,-166000,-166000
20200430,058115,台光電中信99購01,2.56,2.94,2.53,2.94,+0.48,19.51,313000,20,836110,0,0,0,0,0,0,87000,226000,-139000,-139000
20200430,058116,正崴中信99購02,2.00,2.07,1.91,1.96,+0.24,13.95,207000,14,412640,0,0,0,0,0,0,176000,30000,146000,146000
20200430,058117,元石油群益9B購02,0.22,0.23,0.21,0.21,+0.01,5.0,205000,16,45450,0,0,0,0,0,0,0,10000,-10000,-10000
20200430,058118,瑞昱群益99購01,6.40,7.10,6.20,7.10,+1.25,21.37,166000,32,1065000,0,0,0,0,0,0,137000,147000,-10000,-10000
20200430,058119,華新亞東99購01,,,,,0.00,0.00,0,0,0,0,0,0,0,0,0,0,0,0,0
20200430,05811P,臺股指國票96售04,,,,,0.00,0.00,0,0,0,0,0,0,0,0,0,0,0,0,0
20200430,058120,台灣50國票99購03,0.83,0.88,0.83,0.88,+0.24,37.5,2000,2,1710,0,0,0,0,0,0,1000,0,1000,1000
20200430,058121,國巨國票9A購01,,,,,0.00,0.00,0,0,0,0,0,0,0,0,0,0,0,0,0
20200430,058122,美律國票9A購01,2.48,2.72,2.46,2.72,+0.33,13.81,150000,11,390540,0,0,0,0,0,0,10000,140000,-130000,-130000
20200430,058123,亞光國票9A購01,1.25,1.26,1.23,1.23,-0.05,-3.91,204000,4,254180,0,0,0,0,0,0,106000,98000,8000,8000
20200430,058124,玉晶光國票9A購01,1.24,1.32,1.24,1.32,+0.16,13.79,4000,4,5090,0,0,0,0,0,0,4000,4000,0,0
20200430,058125,元油2X元大9C購01,0.11,0.13,0.11,0.13,+0.04,44.44,333000,20,39630,0,0,0,0,0,0,0,0,0,0
20200430,058126,元油2X元大9C購02,0.11,0.13,0.10,0.13,+0.03,30.0,1042000,21,120310,0,0,0,0,0,0,280000,260000,20000,20000
20200430,058127,FBVIX元大9C購01,4.79,4.79,4.76,4.76,-0.24,-4.8,12000,2,57180,0,0,0,0,0,0,0,12000,-12000,-12000
20200430,058128,FBVIX元大9C購02,4.67,4.67,4.67,4.67,-0.38,-7.52,10000,1,46700,0,0,0,0,0,0,0,10000,-10000,-10000
20200430,058129,國巨元大99購10,1.98,2.01,1.89,1.97,+0.15,8.24,222000,11,441090,0,0,0,0,0,0,10000,212000,-202000,-202000
20200430,05812P,臺股指國票96售05,,,,,0.00,0.00,0,0,0,0,0,0,0,0,0,0,0,0,0
20200430,058130,瑞昱元大99購01,3.15,3.15,3.15,3.15,0.00,0.00,1000,1,3150,0,0,0,0,0,0,0,1000,-1000,-1000
20200430,058131,義隆元大99購02,1.50,1.68,1.47,1.59,+0.09,6.0,863000,46,1346720,0,0,0,0,0,0,606000,379000,227000,227000
20200430,058132,義隆元大99購03,1.43,1.57,1.40,1.48,+0.06,4.23,350000,23,534730,0,0,0,0,0,0,246000,109000,137000,137000
20200430,058133,華新科元大9A購02,0.84,0.84,0.84,0.84,+0.01,1.2,20000,1,16800,0,0,0,0,0,0,20000,0,20000,20000
20200430,058134,信邦元大99購01,2.09,2.09,1.92,1.99,-0.06,-2.93,212000,23,417580,0,0,0,0,0,0,99000,113000,-14000,-14000
20200430,058135,景碩元大99購01,2.99,3.19,2.99,3.19,+0.15,4.93,198000,14,598680,0,0,0,0,0,0,101000,98000,3000,3000
20200430,058136,景碩元大99購02,2.82,3.06,2.75,3.06,+0.22,7.75,316000,25,900580,0,0,0,0,0,0,122000,212000,-90000,-90000
20200430,058137,玉晶光元大99購11,0.84,0.88,0.84,0.88,+0.09,11.39,283000,9,245280,0,0,0,0,0,0,216000,67000,149000,149000
20200430,058138,晶相光元大9C購01,0.56,0.56,0.56,0.56,-0.07,-11.11,10000,1,5600,0,0,0,0,0,0,0,0,0,0
20200430,058139,臻鼎元大99購01,1.01,1.13,0.97,1.12,+0.18,19.15,303000,21,309620,0,0,0,0,0,0,198000,105000,93000,93000
20200430,05813P,臺股指國票96售06,11.00,11.00,10.00,10.00,-2.00,-16.67,33000,3,352000,0,0,0,0,0,0,30000,3000,27000,27000
20200430,058140,臻鼎元大99購02,1.16,1.26,1.13,1.25,+0.14,12.61,326000,24,378950,0,0,0,0,0,0,112000,181000,-69000,-69000
20200430,058141,嘉聯益元大99購05,0.96,0.98,0.96,0.98,+0.06,6.52,432000,9,420220,0,0,0,0,0,0,32000,400000,-368000,-368000
20200430,058142,瑞儀元大99購01,1.63,1.66,1.60,1.66,+0.04,2.47,140000,10,227640,0,0,0,0,0,0,71000,64000,7000,7000
20200430,058143,瑞儀元大99購02,1.43,1.45,1.41,1.44,+0.02,1.41,597000,14,855060,0,0,0,0,0,0,332000,260000,72000,72000
20200430,058144,聯茂元大99購02,1.37,1.37,1.30,1.35,-0.02,-1.46,240000,6,322700,0,0,0,0,0,0,10000,220000,-210000,-210000
20200430,058145,聯茂元大99購03,1.35,1.37,1.32,1.33,0.00,0.00,547000,12,725280,0,0,0,0,0,0,250000,317000,-67000,-67000
20200430,058146,勤誠元大99購01,1.61,1.61,1.52,1.55,-0.05,-3.12,519000,23,804060,0,0,0,0,0,0,387000,173000,214000,214000
20200430,058147,鈺齊元大99購01,1.42,1.43,1.33,1.42,+0.07,5.19,718000,34,992090,0,0,0,0,0,0,485000,241000,244000,244000
20200430,058148,百和元大99購01,2.19,2.19,2.01,2.04,-0.07,-3.32,394000,32,820970,0,0,0,0,0,0,354000,38000,316000,316000
20200430,058149,百和元大99購02,1.85,1.85,1.71,1.80,-0.02,-1.1,612000,40,1080320,0,0,0,0,0,0,589000,69000,520000,520000
20200430,05814P,臺股指國票96售07,10.10,10.10,9.00,9.05,0.00,0.00,84000,4,809200,0,0,0,0,0,0,80000,4000,76000,76000
20200430,058150,中502X統一9B購01,,,,,0.00,0.00,0,0,0,0,0,0,0,0,0,0,0,0,0
20200430,058151,台積電統一9A購04,0.93,0.93,0.93,0.93,+0.08,9.41,5000,1,4650,0,0,0,0,0,0,5000,0,5000,5000
20200430,058152,聯發科統一9B購02,2.24,2.30,2.23,2.30,+0.26,12.75,248000,10,561730,0,0,0,0,0,0,35000,213000,-178000,-178000
20200430,058153,景碩統一9B購01,1.11,1.25,1.11,1.22,+0.08,7.02,1119000,36,1304670,0,0,0,0,0,0,385000,778000,-393000,-393000
20200430,058154,泰碩統一9A購01,1.81,1.81,1.77,1.77,0.00,0.00,13000,3,23130,0,0,0,0,0,0,0,13000,-13000,-13000
20200430,058155,牧德統一9A購01,,,,,0.00,0.00,0,0,0,0,0,0,0,0,0,0,0,0,0
20200430,058156,超眾統一9A購02,0.90,0.92,0.87,0.87,-0.02,-2.25,283000,10,256990,0,0,0,0,0,0,15000,283000,-268000,-268000
20200430,058157,華通台新99購01,0.74,0.92,0.18,0.18,-0.50,-73.53,63000,5,46510,0,0,0,0,0,0,23000,40000,-17000,-17000
20200430,058158,台積電台新99購01,0.59,0.59,0.59,0.59,0.00,0.00,10000,1,5900,0,0,0,0,0,0,10000,10000,0,0
20200430,058159,健策台新9A購01,1.69,1.77,1.67,1.77,+0.14,8.59,135000,7,231150,0,0,0,0,0,0,40000,95000,-55000,-55000
20200430,05815P,台積電凱基97售06,,,,,0.00,0.00,0,0,0,0,0,0,0,0,0,0,0,0,0
20200430,058160,奇鋐元富99購01,5.60,5.75,5.60,5.75,+0.40,7.48,36000,5,204250,0,0,0,0,0,0,0,36000,-36000,-36000
20200430,058161,T50反1日盛03購01,0.89,0.89,0.86,0.86,-0.12,-12.24,20000,5,17610,0,0,0,0,0,0,0,20000,-20000,-20000
20200430,058162,上銀日盛9B購01,0.40,0.48,0.38,0.48,+0.08,20.0,54000,8,21800,0,0,0,0,0,0,54000,0,54000,54000
20200430,058163,道瓊反凱基9B購01,,,,,0.00,0.00,0,0,0,0,0,0,0,0,0,0,0,0,0
20200430,058164,FBVIX凱基03購02,,,,,0.00,0.00,0,0,0,0,0,0,0,0,0,0,0,0,0
20200430,058165,FBVIX凱基9C購01,,,,,0.00,0.00,0,0,0,0,0,0,0,0,0,0,0,0,0
20200430,058166,鴻海凱基9A購01,2.87,2.90,2.87,2.90,+0.10,3.57,51000,3,146550,0,0,0,0,0,0,45000,6000,39000,39000
20200430,058167,鴻海凱基9A購03,4.09,4.09,4.09,4.09,+0.04,0.99,10000,1,40900,0,0,0,0,0,0,10000,0,10000,10000
20200430,058168,國巨凱基9A購04,,,,,0.00,0.00,0,0,0,0,0,0,0,0,0,0,0,0,0
20200430,058169,國巨凱基9A購05,,,,,0.00,0.00,0,0,0,0,0,0,0,0,0,0,0,0,0
20200430,05816P,台積電凱基97售07,,,,,0.00,0.00,0,0,0,0,0,0,0,0,0,0,0,0,0
20200430,058170,國巨凱基9A購06,0.95,0.95,0.93,0.95,+0.05,5.56,80000,4,75300,0,0,0,0,0,0,35000,45000,-10000,-10000
20200430,058171,國巨凱基9A購07,1.08,1.09,1.08,1.09,+0.06,5.83,260000,6,283300,0,0,0,0,0,0,260000,0,260000,260000
20200430,058172,國巨凱基9B購02,0.33,0.33,0.32,0.32,0.00,0.00,51000,3,16520,0,0,0,0,0,0,41000,0,41000,41000
20200430,058173,台積電凱基99購04,1.23,1.23,1.23,1.23,0.00,0.00,20000,1,24600,0,0,0,0,0,0,20000,20000,0,0
20200430,058174,台積電凱基9A購05,1.88,1.91,1.88,1.91,+0.06,3.24,16000,3,30210,0,0,0,0,0,0,10000,6000,4000,4000
20200430,058175,旺宏凱基99購03,2.40,2.40,2.35,2.40,+0.25,11.63,26000,4,62250,0,0,0,0,0,0,13000,3000,10000,10000
20200430,058176,聯發科凱基99購05,4.04,4.04,4.04,4.04,0.00,0.00,10000,1,40400,0,0,0,0,0,0,0,10000,-10000,-10000
20200430,058177,華新科凱基99購02,,,,,0.00,0.00,0,0,0,0,0,0,0,0,0,0,0,0,0
20200430,058178,國巨國泰9A購02,1.29,1.32,1.26,1.30,+0.10,8.33,455000,15,592170,0,0,0,0,0,0,3000,452000,-449000,-449000
20200430,058179,國巨國泰9B購02,,,,,0.00,0.00,0,0,0,0,0,0,0,0,0,0,0,0,0
20200430,05817P,可成凱基96售07,1.89,2.01,1.89,2.01,+0.08,4.15,104000,5,204290,0,0,0,0,0,0,32000,72000,-40000,-40000
20200430,058180,華新科國泰9A購01,1.54,1.58,1.44,1.46,0.00,0.00,231000,17,345820,0,0,0,0,0,0,109000,122000,-13000,-13000
20200430,058181,華新科國泰9B購01,1.49,1.51,1.40,1.42,-0.06,-4.05,221000,17,325450,0,0,0,0,0,0,52000,169000,-117000,-117000
20200430,058182,日電貿國泰9A購01,1.66,1.72,1.66,1.72,0.00,0.00,277000,8,470310,0,0,0,0,0,0,0,277000,-277000,-277000
20200430,058183,國巨富邦9A購06,,,,,0.00,0.00,0,0,0,0,0,0,0,0,0,0,0,0,0
20200430,058184,鴻海永豐99購01,0.60,0.60,0.60,0.60,+0.04,7.14,2000,1,1200,0,0,0,0,0,0,2000,0,2000,2000
20200430,058185,國巨永豐99購01,0.62,0.64,0.62,0.64,+0.09,16.36,20000,2,12600,0,0,0,0,0,0,0,20000,-20000,-20000
20200430,058186,聯發科永豐99購01,1.57,1.57,1.54,1.54,+0.24,18.46,5000,2,7730,0,0,0,0,0,0,5000,0,5000,5000
20200430,058187,泰碩永豐99購01,3.03,3.03,3.03,3.03,-0.04,-1.3,2000,1,6060,0,0,0,0,0,0,2000,0,2000,2000
20200430,058188,華擎永豐99購01,0.69,0.69,0.63,0.64,-0.02,-3.03,159000,10,103160,0,0,0,0,0,0,0,159000,-159000,-159000
20200430,058189,嘉澤永豐99購01,1.17,1.17,1.17,1.17,0.00,0.00,1000,1,1170,0,0,0,0,0,0,1000,0,1000,1000
20200430,05818P,大立光凱基96售14,,,,,0.00,0.00,0,0,0,0,0,0,0,0,0,0,0,0,0
20200430,058190,貿聯永豐99購01,1.10,1.34,1.10,1.34,+0.29,27.62,129000,7,157860,0,0,0,0,0,0,77000,40000,37000,37000
20200430,058191,祥碩永豐99購01,1.17,1.20,0.85,0.92,-0.16,-14.81,338000,21,364340,0,0,0,0,0,0,227000,111000,116000,116000
20200430,058192,訊芯永豐99購01,0.58,0.65,0.58,0.64,+0.04,6.67,77000,3,46560,0,0,0,0,0,0,0,77000,-77000,-77000
20200430,058193,緯穎永豐99購01,1.07,1.32,1.07,1.32,0.00,0.00,15000,2,18550,0,0,0,0,0,0,15000,10000,5000,5000
20200430,058194,勤誠永豐99購01,1.19,1.19,1.19,1.19,-0.01,-0.83,22000,2,26180,0,0,0,0,0,0,22000,22000,0,0
20200430,058195,鈺齊永豐99購01,0.28,0.30,0.28,0.30,+0.02,7.14,300000,12,87000,0,0,0,0,0,0,200000,100000,100000,100000
20200430,058196,台塑中信99購01,0.88,1.10,0.88,1.10,+0.30,37.5,112000,15,114590,0,0,0,0,0,0,1000,110000,-109000,-109000
20200430,058197,國巨中信99購02,0.40,0.47,0.40,0.47,+0.14,42.42,106000,7,49170,0,0,0,0,0,0,5000,12000,-7000,-7000
20200430,058198,瑞昱亞東99購01,3.05,3.05,3.05,3.05,0.00,0.00,1000,1,3050,0,0,0,0,0,0,0,1000,-1000,-1000
20200430,058199,國巨康和99購01,,,,,0.00,0.00,0,0,0,0,0,0,0,0,0,0,0,0,0
20200430,05819P,臺股指凱基96售16,,,,,0.00,0.00,0,0,0,0,0,0,0,0,0,0,0,0,0
20200430,058200,世芯康和99購01,1.22,1.45,1.22,1.43,+0.27,23.28,1034000,81,1407950,0,0,0,0,0,0,297000,727000,-430000,-430000
20200430,058201,華通凱基9A購01,1.74,1.91,1.74,1.90,+0.22,13.1,29000,10,51960,0,0,0,0,0,0,29000,0,29000,29000
20200430,058202,鴻海凱基9A購04,,,,,0.00,0.00,0,0,0,0,0,0,0,0,0,0,0,0,0
20200430,058203,信邦凱基99購01,1.70,1.70,1.59,1.59,-0.09,-5.36,187000,13,307760,0,0,0,0,0,0,177000,0,177000,177000
20200430,058204,世芯凱基9A購01,2.95,3.36,2.95,3.34,+0.46,15.97,465000,48,1502230,0,0,0,0,0,0,250000,337000,-87000,-87000
20200430,058205,神達凱基9B購01,0.57,0.61,0.57,0.61,0.00,0.00,230000,5,131900,0,0,0,0,0,0,210000,0,210000,210000
20200430,058206,祥碩凱基99購01,2.48,2.48,1.95,2.03,-0.19,-8.56,441000,38,998640,0,0,0,0,0,0,401000,264000,137000,137000
20200430,058207,南茂凱基99購01,0.95,1.00,0.93,0.98,+0.05,5.38,83000,9,78840,0,0,0,0,0,0,20000,83000,-63000,-63000
20200430,058208,百和凱基99購01,2.49,2.49,2.40,2.48,-0.02,-0.8,75000,9,184720,0,0,0,0,0,0,75000,29000,46000,46000
20200430,058209,臺股指凱基01購01,0.47,0.67,0.47,0.67,+0.22,48.89,299000,24,173840,0,0,0,0,0,0,109000,5000,104000,104000
20200430,05820P,臺股指凱基96售17,,,,,0.00,0.00,0,0,0,0,0,0,0,0,0,0,0,0,0
20200430,058210,臺股指凱基9C購04,0.80,0.89,0.80,0.88,+0.09,11.39,339000,17,283210,0,0,0,0,0,0,8000,310000,-302000,-302000
20200430,058211,國巨群益9A購02,,,,,0.00,0.00,0,0,0,0,0,0,0,0,0,0,0,0,0
20200430,058212,華新科群益9A購01,2.45,2.45,2.37,2.40,-0.08,-3.23,33000,4,79070,0,0,0,0,0,0,12000,21000,-9000,-9000
20200430,058213,欣興群益99購01,2.88,3.08,2.84,2.87,+0.12,4.36,217000,15,648070,0,0,0,0,0,0,179000,86000,93000,93000
20200430,058214,世芯群益9A購01,4.05,4.58,4.05,4.41,+0.51,13.08,102000,18,443170,0,0,0,0,0,0,40000,87000,-47000,-47000
20200430,058215,貿聯群益99購02,1.64,1.89,1.64,1.89,+0.32,20.38,527000,25,929470,0,0,0,0,0,0,72000,455000,-383000,-383000
20200430,058216,TPK群益99購01,2.06,2.06,1.94,1.94,-0.19,-8.92,156000,7,313420,0,0,0,0,0,0,79000,77000,2000,2000
20200430,058217,新唐群益99購01,0.95,0.95,0.95,0.95,0.00,0.00,1000,1,950,0,0,0,0,0,0,0,1000,-1000,-1000
20200430,058218,緯穎群益99購01,3.04,3.78,3.04,3.59,+0.75,26.41,173000,24,604370,0,0,0,0,0,0,65000,172000,-107000,-107000
20200430,058219,台灣50國票9A購02,,,,,0.00,0.00,0,0,0,0,0,0,0,0,0,0,0,0,0
20200430,05821P,臺股指凱基96售18,,,,,0.00,0.00,0,0,0,0,0,0,0,0,0,0,0,0,0
20200430,058220,世芯國票9A購01,4.97,5.60,4.97,5.55,+0.74,15.38,168000,7,928610,0,0,0,0,0,0,158000,165000,-7000,-7000
20200430,058221,上銀統一99購04,0.53,0.69,0.53,0.67,+0.21,45.65,339000,6,213870,0,0,0,0,0,0,0,339000,-339000,-339000
20200430,058222,玉晶光統一9B購01,0.59,0.65,0.58,0.65,+0.09,16.07,555000,15,343370,0,0,0,0,0,0,82000,453000,-371000,-371000
20200430,058223,世芯統一9B購01,3.40,3.40,3.40,3.40,+0.47,16.04,10000,1,34000,0,0,0,0,0,0,0,10000,-10000,-10000
20200430,058224,世芯統一9B購02,2.24,2.46,2.24,2.46,+0.31,14.42,480000,10,1165690,0,0,0,0,0,0,480000,352000,128000,128000
20200430,058225,旺宏元富99購01,3.88,3.91,3.71,3.75,+0.28,8.07,57000,7,216800,0,0,0,0,0,0,33000,24000,9000,9000
20200430,058226,世芯元富99購01,7.40,8.40,7.40,8.40,+1.35,19.15,108000,34,826500,0,0,0,0,0,0,68000,30000,38000,38000
20200430,058227,台灣50元大9C購01,1.50,1.60,1.50,1.60,+0.45,39.13,21000,7,32600,0,0,0,0,0,0,10000,11000,-1000,-1000
20200430,058228,為升元大99購01,0.29,0.45,0.29,0.32,+0.03,10.34,342000,38,114200,0,0,0,0,0,0,0,226000,-226000,-226000
20200430,058229,為升元大99購02,,,,,0.00,0.00,0,0,0,0,0,0,0,0,0,0,0,0,0
20200430,05822P,臺股指凱基96售19,,,,,0.00,0.00,0,0,0,0,0,0,0,0,0,0,0,0,0
20200430,058230,國巨元大99購11,2.59,2.59,2.59,2.59,+0.08,3.19,50000,1,129500,0,0,0,0,0,0,50000,0,50000,50000
20200430,058231,技嘉元大99購02,2.65,2.67,2.56,2.60,-0.03,-1.14,220000,7,570200,0,0,0,0,0,0,50000,170000,-120000,-120000
20200430,058232,聯發科元大99購05,5.45,5.65,5.45,5.65,+0.71,14.37,15000,3,84350,0,0,0,0,0,0,2000,15000,-13000,-13000
20200430,058233,聯發科元大99購06,5.45,5.80,5.45,5.80,+0.85,17.17,21000,3,117700,0,0,0,0,0,0,15000,6000,9000,9000
20200430,058234,華新科元大99購12,1.09,1.11,1.06,1.06,+0.02,1.92,275000,7,295450,0,0,0,0,0,0,55000,220000,-165000,-165000
20200430,058235,大立光元大99購08,1.46,1.65,1.46,1.65,0.00,0.00,60000,4,96000,0,0,0,0,0,0,58000,0,58000,58000
20200430,058236,大立光元大99購09,2.85,3.03,2.85,3.03,+0.33,12.22,29000,2,83370,0,0,0,0,0,0,25000,4000,21000,21000
20200430,058237,嘉晶元大99購04,3.17,3.41,3.15,3.20,+0.23,7.74,180000,23,590250,0,0,0,0,0,0,28000,175000,-147000,-147000
20200430,058238,奇鋐元大99購02,5.50,5.80,5.50,5.80,+0.25,4.5,7000,4,40000,0,0,0,0,0,0,2000,5000,-3000,-3000
20200430,058239,景碩元大99購03,3.19,3.42,3.15,3.42,+0.18,5.56,213000,19,684430,0,0,0,0,0,0,128000,86000,42000,42000
20200430,05823P,臺股指凱基96售20,,,,,0.00,0.00,0,0,0,0,0,0,0,0,0,0,0,0,0
20200430,058240,景碩元大99購04,3.40,3.69,3.40,3.69,+0.21,6.03,302000,28,1038950,0,0,0,0,0,0,171000,133000,38000,38000
20200430,058241,景碩元大99購05,2.98,3.22,2.90,3.14,+0.26,9.03,501000,50,1516230,0,0,0,0,0,0,263000,248000,15000,15000
20200430,058242,玉晶光元大9A購01,0.88,0.90,0.88,0.90,0.00,0.00,51000,2,45880,0,0,0,0,0,0,1000,50000,-49000,-49000
20200430,058243,華擎元大99購01,1.32,1.32,1.23,1.27,+0.02,1.6,406000,16,508740,0,0,0,0,0,0,198000,276000,-78000,-78000
20200430,058244,神達元大99購02,1.85,1.85,1.78,1.78,+0.03,1.71,405000,13,733750,0,0,0,0,0,0,210000,195000,15000,15000
20200430,058245,訊連元大99購01,1.30,1.30,1.21,1.22,-0.05,-3.94,2014000,37,2486960,0,0,0,0,0,0,1579000,425000,1154000,1154000
20200430,058246,帆宣元大99購01,0.85,1.03,0.85,1.01,+0.17,20.24,536000,29,512290,0,0,0,0,0,0,40000,496000,-456000,-456000
20200430,058247,聯茂元大99購04,1.69,1.70,1.63,1.69,-0.04,-2.31,210000,11,353140,0,0,0,0,0,0,39000,201000,-162000,-162000
20200430,058248,聯茂元大99購05,1.69,1.69,1.66,1.68,-0.06,-3.45,150000,5,251840,0,0,0,0,0,0,150000,40000,110000,110000
20200430,058249,緯穎元大99購04,3.56,4.17,3.56,4.02,+0.64,18.93,117000,20,442340,0,0,0,0,0,0,20000,97000,-77000,-77000
20200430,05824P,臺股指凱基96售21,,,,,0.00,0.00,0,0,0,0,0,0,0,0,0,0,0,0,0
20200430,058250,台虹元大99購01,2.95,2.96,2.89,2.90,+0.02,0.69,237000,14,693690,0,0,0,0,0,0,155000,82000,73000,73000
20200430,058251,百和元大99購03,1.67,1.67,1.53,1.63,-0.06,-3.55,438000,26,698240,0,0,0,0,0,0,438000,0,438000,438000
20200430,058252,臺股指元大9A購16,,,,,0.00,0.00,0,0,0,0,0,0,0,0,0,0,0,0,0
20200430,058253,臺股指元大9A購17,0.92,0.94,0.92,0.94,0.00,0.00,4000,4,3730,0,0,0,0,0,0,4000,0,4000,4000
20200430,058254,臺股指元大9A購18,,,,,0.00,0.00,0,0,0,0,0,0,0,0,0,0,0,0,0
20200430,058255,臺股指元大9A購19,,,,,0.00,0.00,0,0,0,0,0,0,0,0,0,0,0,0,0
20200430,058256,臺股指元大9A購20,1.29,1.39,1.27,1.39,+0.32,29.91,127000,13,165930,0,0,0,0,0,0,54000,40000,14000,14000
20200430,058257,聯陽國泰9B購01,,,,,0.00,0.00,0,0,0,0,0,0,0,0,0,0,0,0,0
20200430,058258,世芯國泰9A購01,3.31,3.88,3.31,3.79,+0.49,14.85,369000,56,1350050,0,0,0,0,0,0,117000,272000,-155000,-155000
20200430,058259,訊連國泰9B購01,1.43,1.43,1.35,1.35,-0.05,-3.57,129000,5,176690,0,0,0,0,0,0,79000,0,79000,79000
20200430,05825P,臺股指凱基96售22,,,,,0.00,0.00,0,0,0,0,0,0,0,0,0,0,0,0,0
20200430,058260,華新科富邦9C購01,,,,,0.00,0.00,0,0,0,0,0,0,0,0,0,0,0,0,0
20200430,058261,大立光富邦03購01,0.40,0.43,0.40,0.42,+0.04,10.53,114000,11,48210,0,0,0,0,0,0,0,0,0,0
20200430,058262,大立光富邦9C購02,1.57,1.74,1.57,1.74,+0.18,11.54,623000,23,1023880,0,0,0,0,0,0,317000,306000,11000,11000
20200430,058263,大成鋼永豐99購01,1.19,1.19,1.19,1.19,+0.04,3.48,120000,2,142800,0,0,0,0,0,0,120000,0,120000,120000
20200430,058264,瑞昱永豐99購01,2.50,2.72,2.46,2.72,+0.31,12.86,272000,35,702480,0,0,0,0,0,0,141000,174000,-33000,-33000
20200430,058265,奇力新永豐9A購01,1.01,1.03,1.01,1.01,+0.04,4.12,163000,6,167630,0,0,0,0,0,0,0,163000,-163000,-163000
20200430,058266,宏達電永豐99購01,1.47,1.47,1.47,1.47,+0.09,6.52,12000,1,17640,0,0,0,0,0,0,0,12000,-12000,-12000
20200430,058267,奇鋐永豐99購01,1.46,1.59,1.39,1.59,+0.17,11.97,69000,11,103010,0,0,0,0,0,0,4000,65000,-61000,-61000
20200430,058268,泰碩永豐9A購01,1.87,1.87,1.73,1.75,-0.15,-7.89,25000,3,44150,0,0,0,0,0,0,10000,15000,-5000,-5000
20200430,058269,世芯永豐9A購01,2.31,2.31,2.31,2.31,0.00,0.00,1000,1,2310,0,0,0,0,0,0,1000,0,1000,1000
20200430,05826P,臺股指凱基96售23,,,,,0.00,0.00,0,0,0,0,0,0,0,0,0,0,0,0,0
20200430,058270,上緯控永豐99購01,0.64,0.66,0.64,0.66,+0.05,8.2,109000,2,70960,0,0,0,0,0,0,109000,0,109000,109000
20200430,058271,訊連永豐99購01,0.73,0.73,0.70,0.70,-0.02,-2.78,57000,2,41550,0,0,0,0,0,0,55000,2000,53000,53000
20200430,058272,超眾永豐9A購01,1.97,1.97,1.97,1.97,+0.03,1.55,1000,1,1970,0,0,0,0,0,0,1000,0,1000,1000
20200430,058273,同欣電永豐99購01,0.51,0.59,0.51,0.59,+0.07,13.46,328000,14,176060,0,0,0,0,0,0,0,328000,-328000,-328000
20200430,058274,世紀鋼永豐99購01,1.56,1.72,1.56,1.71,+0.12,7.55,82000,11,134240,0,0,0,0,0,0,20000,62000,-42000,-42000
20200430,058275,S&P500中信9B購01,,,,,0.00,0.00,0,0,0,0,0,0,0,0,0,0,0,0,0
20200430,058276,道瓊指中信9C購01,0.45,0.45,0.45,0.45,+0.06,15.38,5000,1,2250,0,0,0,0,0,0,0,0,0,0
20200430,058277,FBVIX中信03購01,,,,,0.00,0.00,0,0,0,0,0,0,0,0,0,0,0,0,0
20200430,058278,FBVIX中信03購02,,,,,0.00,0.00,0,0,0,0,0,0,0,0,0,0,0,0,0
20200430,058279,FBVIX中信03購03,6.10,6.10,6.10,6.10,-0.35,-5.43,15000,2,91500,0,0,0,0,0,0,0,15000,-15000,-15000
20200430,05827P,台積電統一96售10,,,,,0.00,0.00,0,0,0,0,0,0,0,0,0,0,0,0,0
20200430,058280,SGBR2X中信99購01,0.19,0.22,0.18,0.22,+0.02,10.0,238000,14,45090,0,0,0,0,0,0,0,0,0,0
20200430,058281,奇力新中信99購01,,,,,0.00,0.00,0,0,0,0,0,0,0,0,0,0,0,0,0
20200430,058282,聯茂中信99購01,0.44,0.44,0.39,0.43,0.00,0.00,235000,24,98930,0,0,0,0,0,0,125000,105000,20000,20000
20200430,058283,世紀鋼中信99購01,1.03,1.15,1.00,1.10,+0.09,8.91,521000,30,563380,0,0,0,0,0,0,166000,355000,-189000,-189000
20200430,058284,滬深反群益01購01,,,,,0.00,0.00,0,0,0,0,0,0,0,0,0,0,0,0,0
20200430,058285,牧德群益9A購02,,,,,0.00,0.00,0,0,0,0,0,0,0,0,0,0,0,0,0
20200430,058286,道瓊指國票9B購01,1.42,1.42,1.42,1.42,+0.10,7.58,1000,1,1420,0,0,0,0,0,0,1000,0,1000,1000
20200430,058287,國巨國票9A購02,,,,,0.00,0.00,0,0,0,0,0,0,0,0,0,0,0,0,0
20200430,058288,南亞科國票9A購01,0.21,0.21,0.19,0.21,+0.01,5.0,137000,3,27770,0,0,0,0,0,0,100000,0,100000,100000
20200430,058289,奇鋐國票9A購01,6.40,6.70,6.40,6.70,+0.45,7.2,45000,7,293600,0,0,0,0,0,0,10000,35000,-25000,-25000
20200430,05828P,台積電統一97售02,,,,,0.00,0.00,0,0,0,0,0,0,0,0,0,0,0,0,0
20200430,058290,南電國票9A購01,11.90,12.00,10.90,10.90,-0.50,-4.39,82000,11,962100,0,0,0,0,0,0,52000,45000,7000,7000
20200430,058291,元油2X日盛99購01,,,,,0.00,0.00,0,0,0,0,0,0,0,0,0,0,0,0,0
20200430,058292,上銀凱基9A購01,0.70,0.90,0.70,0.90,+0.38,73.08,3000,3,2380,0,0,0,0,0,0,3000,0,3000,3000
20200430,058293,光寶科凱基9A購01,1.31,1.36,1.28,1.35,+0.11,8.87,691000,51,914310,0,0,0,0,0,0,260000,484000,-224000,-224000
20200430,058294,華新科凱基9A購01,,,,,0.00,0.00,0,0,0,0,0,0,0,0,0,0,0,0,0
20200430,058295,欣興凱基99購02,2.48,2.59,2.43,2.47,+0.08,3.35,359000,14,892650,0,0,0,0,0,0,203000,156000,47000,47000
20200430,058296,明泰凱基99購01,1.20,1.20,1.20,1.20,+0.09,8.11,1000,1,1200,0,0,0,0,0,0,0,1000,-1000,-1000
20200430,058297,茂林凱基9A購02,1.19,1.20,1.18,1.18,-0.03,-2.48,40000,3,47600,0,0,0,0,0,0,0,40000,-40000,-40000
20200430,058298,聯茂凱基99購05,,,,,0.00,0.00,0,0,0,0,0,0,0,0,0,0,0,0,0
20200430,058299,同欣電凱基9A購01,0.30,0.30,0.30,0.30,+0.07,30.43,2000,1,600,0,0,0,0,0,0,2000,0,2000,2000
20200430,05829P,臺股指統一96售08,3.84,3.84,3.70,3.70,-0.70,-15.91,12000,2,45800,0,0,0,0,0,0,10000,2000,8000,8000
20200430,058300,元油2X元大99購09,,,,,0.00,0.00,0,0,0,0,0,0,0,0,0,0,0,0,0
20200430,058301,元油2X元大99購10,,,,,0.00,0.00,0,0,0,0,0,0,0,0,0,0,0,0,0
20200430,058302,元油2X元大99購11,,,,,0.00,0.00,0,0,0,0,0,0,0,0,0,0,0,0,0
20200430,058303,華通元大99購03,,,,,0.00,0.00,0,0,0,0,0,0,0,0,0,0,0,0,0
20200430,058304,鴻海元大99購12,2.15,2.15,2.15,2.15,+0.07,3.37,2000,1,4300,0,0,0,0,0,0,2000,0,2000,2000
20200430,058305,華邦電元大99購02,0.64,0.65,0.64,0.65,0.00,0.00,46000,7,29800,0,0,0,0,0,0,0,40000,-40000,-40000
20200430,058306,聯發科元大99購07,,,,,0.00,0.00,0,0,0,0,0,0,0,0,0,0,0,0,0
20200430,058307,聯發科元大99購08,,,,,0.00,0.00,0,0,0,0,0,0,0,0,0,0,0,0,0
20200430,058308,全新元大9B購01,0.69,0.70,0.68,0.69,+0.01,1.47,161000,9,111200,0,0,0,0,0,0,50000,111000,-61000,-61000
20200430,058309,大毅元大99購02,4.44,4.98,4.36,4.50,+0.47,11.66,185000,22,846930,0,0,0,0,0,0,107000,83000,24000,24000
20200430,05830P,滬深2X元富99售03,2.45,2.50,2.34,2.50,-0.15,-5.66,63000,9,151350,0,0,0,0,0,0,20000,50000,-30000,-30000
20200430,058310,大立光元大99購10,1.72,1.87,1.72,1.87,+0.18,10.65,166000,8,303670,0,0,0,0,0,0,161000,143000,18000,18000
20200430,058311,緯穎元大99購05,4.60,5.15,4.60,5.15,+0.90,21.18,61000,11,290600,0,0,0,0,0,0,3000,58000,-55000,-55000
20200430,058312,大毅國泰9B購01,2.08,2.37,2.03,2.06,+0.13,6.74,1181000,68,2534960,0,0,0,0,0,0,501000,591000,-90000,-90000
20200430,058313,台積電富邦9B購04,0.71,0.72,0.70,0.72,0.00,0.00,80000,8,57100,0,0,0,0,0,0,80000,80000,0,0
20200430,058314,欣興富邦9B購01,0.83,0.83,0.76,0.76,+0.02,2.7,75000,6,57800,0,0,0,0,0,0,0,73000,-73000,-73000
20200430,058315,TPK富邦9C購01,1.20,1.20,1.13,1.13,-0.10,-8.13,117000,12,138910,0,0,0,0,0,0,117000,0,117000,117000
20200430,058316,元油2X永豐9A購03,,,,,0.00,0.00,0,0,0,0,0,0,0,0,0,0,0,0,0
20200430,058317,國巨永豐99購02,1.21,1.21,1.21,1.21,+0.03,2.54,1000,1,1210,0,0,0,0,0,0,1000,0,1000,1000
20200430,058318,致茂永豐9A購01,0.59,0.59,0.59,0.59,-0.05,-7.81,370000,7,218300,0,0,0,0,0,0,332000,22000,310000,310000
20200430,058319,大毅永豐9A購01,1.30,1.59,1.30,1.40,+0.26,22.81,125000,12,177050,0,0,0,0,0,0,50000,75000,-25000,-25000
20200430,05831P,臺股指元富96售03,,,,,0.00,0.00,0,0,0,0,0,0,0,0,0,0,0,0,0
20200430,058320,華新科永豐99購02,,,,,0.00,0.00,0,0,0,0,0,0,0,0,0,0,0,0,0
20200430,058321,大立光永豐99購01,0.89,0.90,0.89,0.90,+0.18,25.0,20000,2,17900,0,0,0,0,0,0,20000,10000,10000,10000
20200430,058322,玉晶光永豐99購02,0.78,0.86,0.76,0.86,+0.16,22.86,152000,11,127280,10000,0,10000,0,0,0,122000,20000,102000,112000
20200430,058323,泰鼎永豐9A購01,,,,,0.00,0.00,0,0,0,0,0,0,0,0,0,0,0,0,0
20200430,058324,嘉聯益永豐9A購01,1.74,1.78,1.74,1.78,0.00,0.00,43000,4,75540,0,0,0,0,0,0,6000,43000,-37000,-37000
20200430,058325,昇陽半永豐99購01,0.51,0.54,0.51,0.54,0.00,0.00,151000,16,78550,0,0,0,0,0,0,0,151000,-151000,-151000
20200430,058326,祥碩台新99購01,3.15,3.15,2.48,2.48,-0.38,-13.29,72000,13,217790,0,0,0,0,0,0,59000,13000,46000,46000
20200430,058327,大毅統一9B購01,0.90,1.15,0.87,0.90,+0.09,11.11,3795000,144,3541960,0,0,0,0,0,0,1187000,2412000,-1225000,-1225000
20200430,058328,世紀鋼統一9B購01,0.70,0.75,0.70,0.74,+0.01,1.37,324000,5,232270,0,0,0,0,0,0,0,324000,-324000,-324000
20200430,058329,S&P正2元富01購01,0.45,0.60,0.45,0.60,0.00,0.00,28000,4,15850,0,0,0,0,0,0,0,0,0,0
20200430,05832P,臺股指元富96售04,,,,,0.00,0.00,0,0,0,0,0,0,0,0,0,0,0,0,0
20200430,058330,鴻海元富99購01,1.23,1.23,1.23,1.23,+0.02,1.65,1000,1,1230,0,0,0,0,0,0,1000,0,1000,1000
20200430,058331,鴻海元富99購02,1.08,1.08,1.08,1.08,+0.08,8.0,7000,2,7560,0,0,0,0,0,0,0,7000,-7000,-7000
20200430,058332,鴻海元富99購03,,,,,0.00,0.00,0,0,0,0,0,0,0,0,0,0,0,0,0
20200430,058333,鴻海元富99購04,2.60,2.64,2.57,2.64,+0.08,3.12,36000,4,93240,0,0,0,0,0,0,30000,6000,24000,24000
20200430,058334,鴻海元富99購05,2.52,2.53,2.52,2.53,+0.15,6.3,20000,2,50500,0,0,0,0,0,0,0,20000,-20000,-20000
20200430,058335,鴻海元富99購06,2.47,2.51,2.47,2.51,+0.18,7.73,20000,3,49800,0,0,0,0,0,0,10000,10000,0,0
20200430,058336,鴻海元富99購07,,,,,0.00,0.00,0,0,0,0,0,0,0,0,0,0,0,0,0
20200430,058337,日月光元富99購01,1.50,1.66,1.50,1.66,+0.22,15.28,646000,42,1006660,0,0,0,0,0,0,159000,487000,-328000,-328000
20200430,058338,康友元富99購01,0.90,0.95,0.90,0.95,+0.11,13.1,30000,3,27900,0,0,0,0,0,0,10000,20000,-10000,-10000
20200430,058339,康友元富99購02,0.82,0.87,0.82,0.87,+0.10,12.99,25000,3,21000,0,0,0,0,0,0,15000,10000,5000,5000
20200430,05833P,臺股指元富96售05,,,,,0.00,0.00,0,0,0,0,0,0,0,0,0,0,0,0,0
20200430,058340,高股息群益99購01,,,,,0.00,0.00,0,0,0,0,0,0,0,0,0,0,0,0,0
20200430,058341,T50反1群益99購01,,,,,0.00,0.00,0,0,0,0,0,0,0,0,0,0,0,0,0
20200430,058342,鴻海群益9A購01,2.71,2.80,2.71,2.80,+0.16,6.06,43000,4,118030,0,0,0,0,0,0,23000,20000,3000,3000
20200430,058343,台積電群益99購02,0.93,0.93,0.93,0.93,0.00,0.00,10000,5,9300,0,0,0,0,0,0,2000,0,2000,2000
20200430,058344,旺宏群益99購05,3.14,3.14,3.11,3.11,+0.32,11.47,4000,2,12470,0,0,0,0,0,0,4000,0,4000,4000
20200430,058345,台光電群益99購03,1.97,2.21,1.94,2.21,+0.28,14.51,886000,24,1822350,0,0,0,0,0,0,185000,713000,-528000,-528000
20200430,058346,嘉晶群益99購01,0.71,0.85,0.71,0.80,0.00,0.00,405000,12,324170,0,0,0,0,0,0,0,404000,-404000,-404000
20200430,058347,玉晶光群益9B購01,7.40,8.20,7.35,8.15,+1.10,15.6,110000,47,826950,0,0,0,0,0,0,82000,110000,-28000,-28000
20200430,058348,台表科群益99購01,1.76,1.76,1.74,1.75,-0.01,-0.57,85000,4,148990,0,0,0,0,0,0,41000,45000,-4000,-4000
20200430,058349,滬深2X日盛9A購01,1.11,1.11,1.11,1.11,+0.09,8.82,499000,1,553890,0,0,0,0,0,0,499000,0,499000,499000
20200430,05834P,臺股指元富96售06,,,,,0.00,0.00,0,0,0,0,0,0,0,0,0,0,0,0,0
20200430,058350,T50正2凱基9B購01,,,,,0.00,0.00,0,0,0,0,0,0,0,0,0,0,0,0,0
20200430,058351,上銀凱基9A購02,,,,,0.00,0.00,0,0,0,0,0,0,0,0,0,0,0,0,0
20200430,058352,鴻海凱基9A購05,1.60,1.63,1.57,1.63,+0.08,5.16,75000,9,120740,0,0,0,0,0,0,75000,22000,53000,53000
20200430,058353,國巨凱基99購09,1.42,1.44,1.39,1.43,+0.11,8.33,28000,4,39770,0,0,0,0,0,0,2000,28000,-26000,-26000
20200430,058354,台積電凱基9A購06,1.18,1.19,1.18,1.19,0.00,0.00,255000,2,303350,0,0,0,0,0,0,255000,245000,10000,10000
20200430,058355,旺宏凱基99購04,3.81,3.82,3.69,3.69,+0.22,6.34,12000,3,45670,0,0,0,0,0,0,11000,8000,3000,3000
20200430,058356,華邦電凱基99購01,1.09,1.17,1.09,1.17,+0.12,11.43,240000,37,274810,0,0,0,0,0,0,36000,204000,-168000,-168000
20200430,058357,智邦凱基99購02,,,,,0.00,0.00,0,0,0,0,0,0,0,0,0,0,0,0,0
20200430,058358,技嘉凱基9A購01,2.41,2.41,2.33,2.36,+0.06,2.61,91000,5,214960,0,0,0,0,0,0,61000,31000,30000,30000
20200430,058359,瑞昱凱基99購01,3.58,3.86,3.51,3.84,+0.48,14.29,95000,21,345630,0,0,0,0,0,0,77000,12000,65000,65000
20200430,05835P,臺股指元富96售07,,,,,0.00,0.00,0,0,0,0,0,0,0,0,0,0,0,0,0
20200430,058360,台光電凱基9A購02,2.54,2.54,2.54,2.54,0.00,0.00,18000,1,45720,0,0,0,0,0,0,0,18000,-18000,-18000
20200430,058361,美律凱基99購06,1.54,1.64,1.52,1.60,+0.11,7.38,81000,10,128000,0,0,0,0,0,0,47000,81000,-34000,-34000
20200430,058362,聯發科凱基99購06,5.70,5.70,5.70,5.70,0.00,0.00,10000,1,57000,0,0,0,0,0,0,10000,0,10000,10000
20200430,058363,全新凱基9A購02,,,,,0.00,0.00,0,0,0,0,0,0,0,0,0,0,0,0,0
20200430,058364,奇力新凱基99購04,,,,,0.00,0.00,0,0,0,0,0,0,0,0,0,0,0,0,0
20200430,058365,奇力新凱基9A購01,,,,,0.00,0.00,0,0,0,0,0,0,0,0,0,0,0,0,0
20200430,058366,元大金凱基99購01,,,,,0.00,0.00,0,0,0,0,0,0,0,0,0,0,0,0,0
20200430,058367,大立光凱基9A購01,,,,,0.00,0.00,0,0,0,0,0,0,0,0,0,0,0,0,0
20200430,058368,奇鋐凱基9A購01,2.62,2.72,2.62,2.66,+0.18,7.26,58000,8,154070,0,0,0,0,0,0,53000,1000,52000,52000
20200430,058369,亞光凱基99購02,1.93,2.01,1.91,2.01,+0.13,6.91,183000,14,362030,0,0,0,0,0,0,39000,144000,-105000,-105000
20200430,05836P,臺股指元富96售08,,,,,0.00,0.00,0,0,0,0,0,0,0,0,0,0,0,0,0
20200430,058370,聯詠凱基99購01,,,,,0.00,0.00,0,0,0,0,0,0,0,0,0,0,0,0,0
20200430,058371,智原凱基9A購01,,,,,0.00,0.00,0,0,0,0,0,0,0,0,0,0,0,0,0
20200430,058372,欣興凱基99購03,2.70,2.72,2.65,2.68,+0.13,5.1,39000,7,105440,0,0,0,0,0,0,13000,26000,-13000,-13000
20200430,058373,晶技凱基99購02,,,,,0.00,0.00,0,0,0,0,0,0,0,0,0,0,0,0,0
20200430,058374,玉晶光凱基9A購03,1.63,1.76,1.63,1.76,+0.19,12.1,87000,4,150440,0,0,0,0,0,0,4000,83000,-79000,-79000
20200430,058375,群創凱基9B購04,1.39,1.39,1.39,1.39,+0.01,0.72,3000,1,4170,0,0,0,0,0,0,3000,0,3000,3000
20200430,058376,貿聯凱基9A購01,1.01,1.20,1.01,1.20,+0.32,36.36,19000,3,20340,0,0,0,0,0,0,9000,19000,-10000,-10000
20200430,058377,茂林凱基9A購03,1.43,1.43,1.39,1.39,-0.01,-0.71,105000,4,146270,0,0,0,0,0,0,75000,30000,45000,45000
20200430,058378,南電凱基99購01,4.83,4.83,4.82,4.82,+0.02,0.42,21000,4,101400,0,0,0,0,0,0,21000,0,21000,21000
20200430,058379,臺股指凱基99購14,0.57,0.68,0.57,0.68,+0.18,36.0,713000,62,455900,0,0,0,0,0,0,267000,120000,147000,147000
20200430,05837P,臺股指富邦96售04,,,,,0.00,0.00,0,0,0,0,0,0,0,0,0,0,0,0,0
20200430,058380,臺股指凱基99購15,0.46,0.54,0.45,0.54,+0.14,35.0,463000,12,232510,0,0,0,0,0,0,387000,225000,162000,162000
20200430,058381,元石油中信9C購01,0.39,0.39,0.39,0.39,+0.01,2.63,110000,7,42900,0,0,0,0,0,0,0,0,0,0
20200430,058382,S&P500中信99購01,,,,,0.00,0.00,0,0,0,0,0,0,0,0,0,0,0,0,0
20200430,058383,道瓊指中信9C購02,0.44,0.45,0.44,0.45,0.00,0.00,103000,3,46340,0,0,0,0,0,0,103000,0,103000,103000
20200430,058384,大成鋼中信99購01,0.23,0.23,0.23,0.23,0.00,0.00,20000,1,4600,0,0,0,0,0,0,0,0,0,0
20200430,058385,創意中信99購01,1.48,1.57,1.48,1.55,+0.07,4.73,63000,7,95970,0,0,0,0,0,0,10000,53000,-43000,-43000
20200430,058386,A50正2國票9B購01,,,,,0.00,0.00,0,0,0,0,0,0,0,0,0,0,0,0,0
20200430,058387,國巨國票9A購03,4.59,4.68,4.39,4.50,+0.09,2.04,10000,8,45640,0,0,0,0,0,0,10000,6000,4000,4000
20200430,058388,健策國票9A購01,,,,,0.00,0.00,0,0,0,0,0,0,0,0,0,0,0,0,0
20200430,058389,聯茂國票9A購01,10.30,10.30,9.65,9.65,-0.65,-6.31,8000,5,81250,0,0,0,0,0,0,8000,4000,4000,4000
20200430,05838P,臺股指富邦96售05,,,,,0.00,0.00,0,0,0,0,0,0,0,0,0,0,0,0,0
20200430,058390,樺漢國票9A購01,6.15,6.60,6.15,6.60,+0.35,5.6,59000,10,379250,0,0,0,0,0,0,22000,37000,-15000,-15000
20200430,058391,T50反1元大99購02,0.56,0.63,0.56,0.62,-0.06,-8.82,145000,7,84800,0,0,0,0,0,0,75000,40000,35000,35000
20200430,058392,元油2X元大99購12,0.07,0.07,0.07,0.07,+0.01,16.67,320000,6,22400,0,0,0,0,0,0,0,0,0,0
20200430,058393,元油2X元大99購13,0.06,0.07,0.06,0.07,+0.01,16.67,217000,7,14340,0,0,0,0,0,0,0,0,0,0
20200430,058394,元油2X元大99購14,0.07,0.08,0.05,0.05,-0.03,-37.5,301000,4,19080,0,0,0,0,0,0,0,0,0,0
20200430,058395,元油2X元大99購15,0.06,0.07,0.06,0.07,+0.01,16.67,452000,4,30860,0,0,0,0,0,0,0,0,0,0
20200430,058396,力山元大99購01,4.79,5.05,4.44,4.48,-0.05,-1.1,398000,47,1944580,0,0,0,0,0,0,344000,114000,230000,230000
20200430,058397,大成鋼元大99購02,1.38,1.42,1.33,1.42,+0.12,9.23,527000,24,724300,0,0,0,0,0,0,262000,265000,-3000,-3000
20200430,058398,中環元大99購02,1.06,1.16,1.06,1.12,+0.05,4.67,401000,12,451860,0,0,0,0,0,0,150000,251000,-101000,-101000
20200430,058399,美律元大99購05,0.92,1.02,0.92,0.97,+0.08,8.99,395000,22,385330,0,0,0,0,0,0,90000,375000,-285000,-285000
20200430,05839P,臺股指富邦96售06,,,,,0.00,0.00,0,0,0,0,0,0,0,0,0,0,0,0,0
20200430,058400,聯發科元大99購09,,,,,0.00,0.00,0,0,0,0,0,0,0,0,0,0,0,0,0
20200430,058401,華航元大9A購01,0.89,0.91,0.81,0.91,+0.12,15.19,37000,8,32720,0,0,0,0,0,0,7000,17000,-10000,-10000
20200430,058402,欣興元大99購04,4.44,4.56,4.31,4.31,-0.14,-3.15,233000,35,1030320,0,0,0,0,0,0,148000,129000,19000,19000
20200430,058403,玉晶光元大99購12,3.63,4.05,3.61,4.05,+0.57,16.38,433000,91,1642970,0,0,0,0,0,0,220000,259000,-39000,-39000
20200430,058404,貿聯元大99購02,,,,,0.00,0.00,0,0,0,0,0,0,0,0,0,0,0,0,0
20200430,058405,訊連元大99購02,1.34,1.34,1.25,1.25,-0.06,-4.58,610000,13,786650,0,0,0,0,0,0,573000,37000,536000,536000
20200430,058406,聯茂元大99購06,1.32,1.33,1.28,1.32,0.00,0.00,519000,9,676470,0,0,0,0,0,0,269000,290000,-21000,-21000
20200430,058407,滬深2X兆豐9A購01,,,,,0.00,0.00,0,0,0,0,0,0,0,0,0,0,0,0,0
20200430,058408,華通兆豐99購02,1.49,1.67,1.49,1.66,+0.25,17.73,68000,8,106150,0,0,0,0,0,0,54000,14000,40000,40000
20200430,058409,鴻海兆豐99購05,1.07,1.11,1.06,1.11,+0.06,5.71,99000,9,107750,0,0,0,0,0,0,26000,73000,-47000,-47000
20200430,05840P,臺股指富邦96售07,,,,,0.00,0.00,0,0,0,0,0,0,0,0,0,0,0,0,0
20200430,058410,國巨兆豐99購03,1.91,1.96,1.91,1.96,+0.21,12.0,28000,3,54220,0,0,0,0,0,0,28000,10000,18000,18000
20200430,058411,技嘉兆豐99購01,1.02,1.02,1.01,1.01,-0.01,-0.98,8000,2,8120,0,0,0,0,0,0,0,8000,-8000,-8000
20200430,058412,聯發科兆豐99購01,1.43,1.57,1.43,1.57,+0.37,30.83,94000,5,147120,0,0,0,0,0,0,94000,0,94000,94000
20200430,058413,義隆兆豐99購01,1.46,1.61,1.42,1.53,+0.08,5.52,114000,14,169310,0,0,0,0,0,0,74000,40000,34000,34000
20200430,058414,大立光兆豐99購02,0.69,0.90,0.69,0.80,+0.20,33.33,132000,6,94200,0,0,0,0,0,0,132000,20000,112000,112000
20200430,058415,祥碩兆豐99購01,1.34,1.34,1.01,1.03,-0.11,-9.65,27000,14,31060,0,0,0,0,0,0,7000,17000,-10000,-10000
20200430,058416,鴻海麥證99購01,2.01,2.01,1.99,1.99,0.00,0.00,20000,3,40020,12000,8000,4000,0,0,0,12000,8000,4000,4000
20200430,058417,國巨麥證99購01,,,,,0.00,0.00,0,0,0,0,0,0,0,0,0,0,0,0,0
20200430,058418,台積電麥證99購01,,,,,0.00,0.00,0,0,0,0,0,0,0,0,0,0,0,0,0
20200430,058419,聯發科麥證99購02,,,,,0.00,0.00,0,0,0,0,0,0,0,0,0,0,0,0,0
20200430,05841P,華通元大96售04,,,,,0.00,0.00,0,0,0,0,0,0,0,0,0,0,0,0,0
20200430,058420,聯發科麥證99購03,,,,,0.00,0.00,0,0,0,0,0,0,0,0,0,0,0,0,0
20200430,058421,國泰金麥證01購01,1.59,1.62,1.58,1.62,+0.27,20.0,114000,10,182900,35000,79000,-44000,0,0,0,35000,79000,-44000,-44000
20200430,058422,百和麥證99購01,2.17,2.17,2.00,2.10,-0.02,-0.94,210000,21,435030,169000,31000,138000,0,0,0,169000,31000,138000,138000
20200430,058423,臺股指麥證99購01,2.20,2.20,2.20,2.20,0.00,0.00,4000,1,8800,4000,0,4000,0,0,0,4000,0,4000,4000
20200430,058424,滬深2X元富99購04,1.63,1.77,1.60,1.64,+0.12,7.89,241000,14,406730,0,0,0,0,0,0,30000,239000,-209000,-209000
20200430,058425,S&P正2元富01購02,,,,,0.00,0.00,0,0,0,0,0,0,0,0,0,0,0,0,0
20200430,058426,旺宏元富99購02,2.65,2.65,2.59,2.59,+0.40,18.26,41000,2,106250,0,0,0,0,0,0,41000,0,41000,41000
20200430,058427,大毅元富99購01,2.34,2.67,2.18,2.18,+0.17,8.46,88000,13,211300,0,0,0,0,0,0,17000,81000,-64000,-64000
20200430,058428,大立光元富99購02,2.42,2.66,2.42,2.66,+0.31,13.19,540000,34,1363000,0,0,0,0,0,0,233000,308000,-75000,-75000
20200430,058429,欣興元富99購01,3.66,3.88,3.66,3.69,-0.08,-2.12,603000,47,2263030,0,0,0,0,0,0,473000,110000,363000,363000
20200430,05842P,台積電元大96售15,,,,,0.00,0.00,0,0,0,0,0,0,0,0,0,0,0,0,0
20200430,058430,滬深2X統一99購02,,,,,0.00,0.00,0,0,0,0,0,0,0,0,0,0,0,0,0
20200430,058431,國巨統一9B購01,1.49,1.52,1.45,1.48,+0.10,7.25,353000,19,524040,0,0,0,0,0,0,66000,327000,-261000,-261000
20200430,058432,台積電統一9B購03,,,,,0.00,0.00,0,0,0,0,0,0,0,0,0,0,0,0,0
20200430,058433,台積電統一9B購04,,,,,0.00,0.00,0,0,0,0,0,0,0,0,0,0,0,0,0
20200430,058434,旺宏統一9B購01,1.69,1.69,1.63,1.68,+0.16,10.53,539000,4,880670,0,0,0,0,0,0,529000,10000,519000,519000
20200430,058435,旺宏統一9B購02,1.54,1.55,1.49,1.49,+0.07,4.93,435000,13,660940,0,0,0,0,0,0,395000,40000,355000,355000
20200430,058436,聯發科統一9B購03,1.67,1.82,1.66,1.82,+0.34,22.97,340000,35,584500,0,0,0,0,0,0,340000,335000,5000,5000
20200430,058437,可成統一9B購01,,,,,0.00,0.00,0,0,0,0,0,0,0,0,0,0,0,0,0
20200430,058438,大立光統一9B購01,1.70,1.83,1.70,1.83,+0.14,8.28,239000,6,429670,0,0,0,0,0,0,183000,56000,127000,127000
20200430,058439,玉晶光統一01購02,2.10,2.27,2.10,2.27,+0.17,8.1,222000,8,488970,0,0,0,0,0,0,132000,98000,34000,34000
20200430,05843P,台積電元大96售16,,,,,0.00,0.00,0,0,0,0,0,0,0,0,0,0,0,0,0
20200430,058440,玉晶光統一99購02,1.26,1.38,1.24,1.38,+0.18,15.0,65000,5,85490,0,0,0,0,0,0,17000,50000,-33000,-33000
20200430,058441,T50反1台新03購01,1.10,1.10,1.10,1.10,0.00,0.00,10000,1,11000,0,0,0,0,0,0,0,0,0,0
20200430,058442,玉晶光台新99購01,,,,,0.00,0.00,0,0,0,0,0,0,0,0,0,0,0,0,0
20200430,058443,T50正2富邦01購01,,,,,0.00,0.00,0,0,0,0,0,0,0,0,0,0,0,0,0
20200430,058444,國巨富邦9B購01,1.05,1.10,1.05,1.06,+0.02,1.92,53000,10,57530,0,0,0,0,0,0,44000,46000,-2000,-2000
20200430,058445,旺宏富邦9C購01,1.01,1.01,0.91,0.91,+0.07,8.33,186000,12,173160,0,0,0,0,0,0,66000,10000,56000,56000
20200430,058446,新光金富邦9C購01,0.48,0.54,0.48,0.54,+0.06,12.5,202000,23,107880,0,0,0,0,0,0,170000,170000,0,0
20200430,058447,玉晶光富邦9A購02,0.75,0.75,0.75,0.75,0.00,0.00,4000,1,3000,0,0,0,0,0,0,4000,0,4000,4000
20200430,058448,滬深2X永豐9A購01,0.58,0.58,0.53,0.53,0.00,0.00,7000,2,3910,0,0,0,0,0,0,3000,4000,-1000,-1000
20200430,058449,台積電永豐99購01,,,,,0.00,0.00,0,0,0,0,0,0,0,0,0,0,0,0,0
20200430,05844P,旺宏元大96售07,,,,,0.00,0.00,0,0,0,0,0,0,0,0,0,0,0,0,0
20200430,058450,旺宏永豐99購01,2.89,2.91,2.81,2.81,+0.25,9.77,211000,12,599900,0,0,0,0,0,0,211000,9000,202000,202000
20200430,058451,智邦永豐9A購01,2.38,2.38,2.26,2.26,-0.34,-13.08,47000,9,108310,0,0,0,0,0,0,0,47000,-47000,-47000
20200430,058452,義隆永豐99購02,,,,,0.00,0.00,0,0,0,0,0,0,0,0,0,0,0,0,0
20200430,058453,可成永豐99購01,1.35,1.35,1.30,1.30,-0.05,-3.7,11000,2,14800,0,0,0,0,0,0,10000,1000,9000,9000
20200430,058454,嘉晶永豐99購01,0.80,0.93,0.78,0.93,+0.15,19.23,58000,6,50390,0,0,0,0,0,0,28000,30000,-2000,-2000
20200430,058455,玉晶光永豐99購03,1.76,1.89,1.71,1.85,+0.19,11.45,76000,8,135190,0,0,0,0,0,0,36000,47000,-11000,-11000
20200430,058456,京鼎永豐99購01,1.19,1.29,1.16,1.29,+0.15,13.16,49000,9,59670,0,0,0,0,0,0,32000,17000,15000,15000
20200430,058457,創意永豐99購01,1.27,1.34,1.27,1.32,+0.11,9.09,133000,16,175000,0,0,0,0,0,0,44000,99000,-55000,-55000
20200430,058458,牧德永豐9A購01,,,,,0.00,0.00,0,0,0,0,0,0,0,0,0,0,0,0,0
20200430,058459,南電永豐99購01,3.41,3.41,3.41,3.41,-0.03,-0.87,3000,1,10230,0,0,0,0,0,0,3000,0,3000,3000
20200430,05845P,大立光元大96售06,,,,,0.00,0.00,0,0,0,0,0,0,0,0,0,0,0,0,0
20200430,058460,臺股指永豐99購01,,,,,0.00,0.00,0,0,0,0,0,0,0,0,0,0,0,0,0
20200430,058461,滬深2X永昌9C購01,3.90,3.90,3.90,3.90,0.00,0.00,2000,1,7800,0,0,0,0,0,0,0,2000,-2000,-2000
20200430,058462,台積電兆豐99購01,,,,,0.00,0.00,0,0,0,0,0,0,0,0,0,0,0,0,0
20200430,058463,宏達電兆豐99購02,0.57,0.57,0.57,0.57,+0.01,1.79,20000,1,11400,0,0,0,0,0,0,0,20000,-20000,-20000
20200430,058464,矽創兆豐9A購01,0.80,0.82,0.78,0.82,+0.14,20.59,43000,6,34140,0,0,0,0,0,0,11000,20000,-9000,-9000
20200430,058465,元石油中信01購01,1.00,1.00,1.00,1.00,+0.58,138.1,20000,4,20000,0,0,0,0,0,0,0,10000,-10000,-10000
20200430,058466,SGBR2X中信99購02,0.20,0.25,0.19,0.22,+0.04,22.22,922000,50,194330,0,0,0,0,0,0,0,0,0,0
20200430,058467,日月光中信9A購01,0.54,0.63,0.54,0.63,+0.11,21.15,115000,5,72010,0,0,0,0,0,0,115000,0,115000,115000
20200430,058468,聯茂中信99購02,0.91,0.92,0.86,0.90,-0.04,-4.26,258000,24,232660,0,0,0,0,0,0,160000,98000,62000,62000
20200430,058469,臺股指中信9A購05,0.55,0.55,0.55,0.55,+0.07,14.58,5000,1,2750,0,0,0,0,0,0,0,0,0,0
20200430,05846P,大立光元大96售07,3.08,3.08,2.85,2.85,-1.18,-29.28,41000,2,117080,0,0,0,0,0,0,40000,1000,39000,39000
20200430,058470,台灣50日盛9B購02,0.53,0.65,0.53,0.65,+0.17,35.42,26000,6,14570,0,0,0,0,0,0,23000,0,23000,23000
20200430,058471,台積電日盛9C購01,,,,,0.00,0.00,0,0,0,0,0,0,0,0,0,0,0,0,0
20200430,058472,亞德客凱基9A購01,,,,,0.00,0.00,0,0,0,0,0,0,0,0,0,0,0,0,0
20200430,058473,上銀凱基9A購03,2.29,2.63,2.29,2.63,+0.44,20.09,115000,11,285840,0,0,0,0,0,0,4000,111000,-107000,-107000
20200430,058474,鴻海凱基9A購06,,,,,0.00,0.00,0,0,0,0,0,0,0,0,0,0,0,0,0
20200430,058475,台積電凱基99購06,0.80,0.80,0.80,0.80,0.00,0.00,10000,1,8000,0,0,0,0,0,0,10000,10000,0,0
20200430,058476,旺宏凱基9A購01,3.34,3.34,3.30,3.30,+0.25,8.2,9000,2,29940,0,0,0,0,0,0,6000,3000,3000,3000
20200430,058477,億光凱基9A購01,0.87,0.87,0.87,0.87,0.00,0.00,4000,1,3480,0,0,0,0,0,0,4000,0,4000,4000
20200430,058478,聯發科凱基9A購01,4.67,4.69,4.67,4.69,+0.52,12.47,23000,5,107630,0,0,0,0,0,0,0,23000,-23000,-23000
20200430,058479,亞光凱基9A購01,1.80,1.87,1.77,1.83,+0.02,1.1,337000,24,614590,0,0,0,0,0,0,80000,257000,-177000,-177000
20200430,05847P,大立光元大96售08,,,,,0.00,0.00,0,0,0,0,0,0,0,0,0,0,0,0,0
20200430,058480,新日興凱基9A購01,1.35,1.35,1.33,1.33,-0.02,-1.48,40000,5,53800,0,0,0,0,0,0,40000,0,40000,40000
20200430,058481,玉晶光凱基9A購04,1.74,1.94,1.74,1.94,+0.25,14.79,51000,8,95990,0,0,0,0,0,0,28000,21000,7000,7000
20200430,058482,祥碩凱基99購02,,,,,0.00,0.00,0,0,0,0,0,0,0,0,0,0,0,0,0
20200430,058483,道瓊指國票9A購01,0.43,0.46,0.43,0.46,+0.03,6.98,83000,6,37410,0,0,0,0,0,0,0,0,0,0
20200430,058484,元金2X國票04購01,,,,,0.00,0.00,0,0,0,0,0,0,0,0,0,0,0,0,0
20200430,058485,智邦國票9A購01,,,,,0.00,0.00,0,0,0,0,0,0,0,0,0,0,0,0,0
20200430,058486,大立光國票9A購01,,,,,0.00,0.00,0,0,0,0,0,0,0,0,0,0,0,0,0
20200430,058487,晶技國票9A購01,10.40,10.90,10.40,10.40,0.00,0.00,145000,12,1515300,0,0,0,0,0,0,144000,43000,101000,101000
20200430,058488,華擎國票9A購01,3.91,3.94,3.83,3.83,0.00,0.00,42000,4,164040,0,0,0,0,0,0,16000,26000,-10000,-10000
20200430,058489,台灣50群益9B購01,,,,,0.00,0.00,0,0,0,0,0,0,0,0,0,0,0,0,0
20200430,05848P,臺股指元大96售24,6.10,6.10,5.75,5.75,-0.50,-8.0,195000,7,1144250,0,0,0,0,0,0,105000,90000,15000,15000
20200430,058490,元黃金群益9B購01,,,,,0.00,0.00,0,0,0,0,0,0,0,0,0,0,0,0,0
20200430,058491,滬深2X群益01購01,,,,,0.00,0.00,0,0,0,0,0,0,0,0,0,0,0,0,0
20200430,058492,華通群益9B購01,,,,,0.00,0.00,0,0,0,0,0,0,0,0,0,0,0,0,0
20200430,058493,台積電群益9A購01,0.92,0.92,0.90,0.90,0.00,0.00,40000,4,36500,0,0,0,0,0,0,0,40000,-40000,-40000
20200430,058494,可成群益9B購01,2.84,2.84,2.84,2.84,-0.06,-2.07,73000,1,207320,0,0,0,0,0,0,0,73000,-73000,-73000
20200430,058495,元大金群益9B購01,2.04,2.16,2.04,2.16,+0.17,8.54,773000,57,1588100,0,0,0,0,0,0,137000,622000,-485000,-485000
20200430,058496,文曄群益99購01,1.30,1.30,1.29,1.29,+0.02,1.57,123000,8,159580,0,0,0,0,0,0,123000,0,123000,123000
20200430,058497,新日興群益9B購01,1.69,1.69,1.55,1.63,-0.03,-1.81,683000,20,1094230,0,0,0,0,0,0,582000,62000,520000,520000
20200430,058498,世紀鋼群益99購01,1.95,2.09,1.95,2.09,+0.13,6.63,127000,16,257370,0,0,0,0,0,0,0,127000,-127000,-127000
20200430,058499,滬深2X元大9C購01,0.72,0.72,0.72,0.72,+0.07,10.77,5000,1,3600,0,0,0,0,0,0,5000,0,5000,5000
20200430,05849P,臺股指元大96售25,4.38,4.38,4.31,4.31,-0.35,-7.51,2000,2,8690,0,0,0,0,0,0,0,2000,-2000,-2000
20200430,058500,元石油元大9C購01,0.36,0.43,0.36,0.41,+0.08,24.24,862000,64,338880,0,0,0,0,0,0,0,0,0,0
20200430,058501,S&P正2元大99購01,0.74,0.80,0.74,0.80,0.00,0.00,34000,2,26900,0,0,0,0,0,0,34000,0,34000,34000
20200430,058502,鴻海元大99購13,3.06,3.20,3.06,3.19,0.00,0.00,50000,5,158880,0,0,0,0,0,0,50000,45000,5000,5000
20200430,058503,鴻海元大99購14,3.47,3.58,3.40,3.58,+0.24,7.19,164000,11,576980,0,0,0,0,0,0,138000,103000,35000,35000
20200430,058504,台積電元大99購07,1.16,1.16,1.16,1.16,0.00,0.00,20000,2,23200,0,0,0,0,0,0,20000,0,20000,20000
20200430,058505,台積電元大99購08,2.03,2.03,2.03,2.03,+0.23,12.78,66000,1,133980,0,0,0,0,0,0,66000,66000,0,0
20200430,058506,台積電元大99購09,2.07,2.10,2.07,2.10,+0.19,9.95,200000,2,418170,0,0,0,0,0,0,200000,200000,0,0
20200430,058507,美律元大9A購01,0.93,1.04,0.93,0.99,+0.07,7.61,648000,33,634900,0,0,0,0,0,0,266000,385000,-119000,-119000
20200430,058508,聯發科元大99購11,,,,,0.00,0.00,0,0,0,0,0,0,0,0,0,0,0,0,0
20200430,058509,聯發科元大99購12,4.55,4.81,4.55,4.81,+0.59,13.98,249000,20,1160480,0,0,0,0,0,0,197000,246000,-49000,-49000
20200430,05850P,台積電兆豐96售06,4.45,7.00,4.12,4.14,-1.36,-24.73,841000,32,3560170,0,0,0,0,0,0,805000,798000,7000,7000
20200430,058510,全新元大9B購02,0.60,0.60,0.60,0.60,0.00,0.00,10000,1,6000,0,0,0,0,0,0,10000,0,10000,10000
20200430,058511,華新科元大9B購01,,,,,0.00,0.00,0,0,0,0,0,0,0,0,0,0,0,0,0
20200430,058512,宏達電元大99購04,1.45,1.45,1.41,1.41,-0.05,-3.42,124000,4,177080,0,0,0,0,0,0,56000,68000,-12000,-12000
20200430,058513,宏達電元大99購05,1.84,1.85,1.84,1.85,-0.02,-1.07,50000,2,92400,0,0,0,0,0,0,50000,0,50000,50000
20200430,058514,潤泰全元大99購01,1.41,1.54,1.41,1.54,+0.14,10.0,692000,26,1011250,0,0,0,0,0,0,244000,406000,-162000,-162000
20200430,058515,健鼎元大99購01,1.32,1.42,1.32,1.38,+0.11,8.66,306000,16,416580,0,0,0,0,0,0,14000,292000,-278000,-278000
20200430,058516,健鼎元大99購02,1.37,1.46,1.37,1.44,+0.13,9.92,176000,12,246460,0,0,0,0,0,0,23000,153000,-130000,-130000
20200430,058517,景碩元大99購06,3.54,3.78,3.49,3.78,+0.20,5.59,178000,17,633810,0,0,0,0,0,0,105000,74000,31000,31000
20200430,058518,玉晶光元大99購13,0.95,1.02,0.95,1.02,0.00,0.00,575000,7,546800,0,0,0,0,0,0,450000,125000,325000,325000
20200430,058519,嘉澤元大99購01,5.05,5.50,4.94,5.50,+0.74,15.55,334000,29,1728580,0,0,0,0,0,0,289000,219000,70000,70000
20200430,05851P,力山群益97售01,1.17,1.30,1.09,1.30,0.00,0.00,100000,10,116700,0,0,0,0,0,0,0,100000,-100000,-100000
20200430,058520,智易元大99購03,3.84,3.84,3.70,3.74,+0.04,1.08,62000,9,235950,0,0,0,0,0,0,61000,11000,50000,50000
20200430,058521,日月光元大99購01,3.24,3.50,3.24,3.48,0.00,0.00,155000,16,524580,0,0,0,0,0,0,25000,130000,-105000,-105000
20200430,058522,聯茂元大99購07,1.11,1.11,1.05,1.09,+0.01,0.93,420000,22,454500,0,0,0,0,0,0,80000,382000,-302000,-302000
20200430,058523,聯茂元大99購08,0.95,0.95,0.93,0.93,-0.06,-6.06,98000,4,91540,0,0,0,0,0,0,30000,88000,-58000,-58000
20200430,058524,超眾元大99購04,,,,,0.00,0.00,0,0,0,0,0,0,0,0,0,0,0,0,0
20200430,058525,台虹元大99購02,1.23,1.23,1.18,1.18,-0.02,-1.67,354000,19,426280,0,0,0,0,0,0,246000,108000,138000,138000
20200430,058526,鈺齊元大99購02,1.28,1.28,1.21,1.28,+0.05,4.07,620000,21,774640,0,0,0,0,0,0,526000,97000,429000,429000
20200430,058527,世紀鋼元大99購01,,,,,0.00,0.00,0,0,0,0,0,0,0,0,0,0,0,0,0
20200430,058528,世紀鋼元大99購02,0.69,0.69,0.68,0.68,0.00,0.00,7000,2,4770,0,0,0,0,0,0,7000,0,7000,7000
20200430,058529,S&P正2元富9B購01,,,,,0.00,0.00,0,0,0,0,0,0,0,0,0,0,0,0,0
20200430,05852P,嘉晶群益96售01,,,,,0.00,0.00,0,0,0,0,0,0,0,0,0,0,0,0,0
20200430,058530,為升元富99購01,0.27,0.28,0.27,0.28,+0.03,12.0,11000,2,3030,0,0,0,0,0,0,11000,0,11000,11000
20200430,058531,華通元富99購01,3.04,3.41,3.01,3.41,+0.53,18.4,354000,33,1100030,0,0,0,0,0,0,224000,90000,134000,134000
20200430,058532,禾伸堂元富99購01,3.04,3.08,3.04,3.04,+0.18,6.29,61000,9,186520,0,0,0,0,0,0,61000,0,61000,61000
20200430,058533,玉晶光元富99購01,,,,,0.00,0.00,0,0,0,0,0,0,0,0,0,0,0,0,0
20200430,058534,友達統一9B購01,0.77,0.79,0.77,0.77,+0.01,1.32,147000,10,114450,0,0,0,0,0,0,71000,76000,-5000,-5000
20200430,058535,玉晶光統一9A購06,0.91,0.93,0.90,0.92,+0.06,6.98,43000,4,39290,0,0,0,0,0,0,40000,3000,37000,37000
20200430,058536,群創統一9B購01,0.78,0.78,0.78,0.78,0.00,0.00,46000,1,35880,0,0,0,0,0,0,0,46000,-46000,-46000
20200430,058537,彩晶統一9B購01,1.00,1.05,0.99,1.05,+0.04,3.96,373000,16,374640,0,0,0,0,0,0,237000,146000,91000,91000
20200430,058538,智邦台新99購02,4.21,4.21,4.21,4.21,-0.09,-2.09,13000,1,54730,0,0,0,0,0,0,13000,13000,0,0
20200430,058539,聯發科台新99購01,,,,,0.00,0.00,0,0,0,0,0,0,0,0,0,0,0,0,0
20200430,05853P,欣興群益96售05,1.64,1.64,1.64,1.64,0.00,0.00,4000,1,6560,0,0,0,0,0,0,0,4000,-4000,-4000
20200430,058540,嘉聯益國泰9A購02,1.99,2.04,1.99,2.03,+0.05,2.53,173000,12,347270,0,0,0,0,0,0,173000,0,173000,173000
20200430,058541,T50反1富邦01購01,2.11,2.11,2.03,2.03,-0.14,-6.45,10000,2,20700,0,0,0,0,0,0,5000,5000,0,0
20200430,058542,T50反1富邦9B購01,,,,,0.00,0.00,0,0,0,0,0,0,0,0,0,0,0,0,0
20200430,058543,滬深2X富邦9A購01,,,,,0.00,0.00,0,0,0,0,0,0,0,0,0,0,0,0,0
20200430,058544,FBVIX富邦9B購01,,,,,0.00,0.00,0,0,0,0,0,0,0,0,0,0,0,0,0
20200430,058545,義隆富邦9C購01,1.31,1.39,1.28,1.33,+0.05,3.91,85000,14,113300,0,0,0,0,0,0,69000,20000,49000,49000
20200430,058546,玉晶光富邦9B購01,0.69,0.74,0.67,0.74,0.00,0.00,151000,4,102260,0,0,0,0,0,0,0,151000,-151000,-151000
20200430,058547,世紀鋼富邦9A購01,0.53,0.59,0.52,0.59,+0.08,15.69,801000,39,444070,0,0,0,0,0,0,202000,494000,-292000,-292000
20200430,058548,元石油永豐99購01,,,,,0.00,0.00,0,0,0,0,0,0,0,0,0,0,0,0,0
20200430,058549,藍天永豐99購01,0.87,0.87,0.80,0.84,0.00,0.00,169000,11,138060,0,0,0,0,0,0,154000,5000,149000,149000
20200430,05854P,華新科凱基96售09,,,,,0.00,0.00,0,0,0,0,0,0,0,0,0,0,0,0,0
20200430,058550,南亞科永豐99購01,,,,,0.00,0.00,0,0,0,0,0,0,0,0,0,0,0,0,0
20200430,058551,義隆永豐99購03,2.05,2.05,1.97,1.97,+0.21,11.93,20000,2,40200,0,0,0,0,0,0,0,20000,-20000,-20000
20200430,058552,欣興永豐99購01,,,,,0.00,0.00,0,0,0,0,0,0,0,0,0,0,0,0,0
20200430,058553,合勤控永豐99購01,1.09,1.09,0.98,0.98,-0.56,-36.36,131000,5,129810,0,0,0,0,0,0,131000,0,131000,131000
20200430,058554,瀚宇博永豐99購01,1.48,1.48,1.48,1.48,0.00,0.00,68000,1,100640,0,0,0,0,0,0,68000,0,68000,68000
20200430,058555,矽創永豐9A購01,1.27,1.35,1.24,1.35,+0.15,12.5,473000,24,612630,0,0,0,0,0,0,345000,248000,97000,97000
20200430,058556,百和永豐99購01,1.77,1.77,1.72,1.72,-0.14,-7.53,164000,7,286720,0,0,0,0,0,0,131000,33000,98000,98000
20200430,058557,健策第一01購01,1.59,1.61,1.59,1.61,0.00,0.00,22000,4,35240,0,0,0,0,0,0,0,22000,-22000,-22000
20200430,058558,鴻海日盛9A購02,1.00,1.00,1.00,1.00,+0.06,6.38,3000,1,3000,0,0,0,0,0,0,0,3000,-3000,-3000
20200430,058559,華新科日盛99購02,2.21,2.21,2.08,2.08,-0.11,-5.02,17000,2,36270,0,0,0,0,0,0,0,17000,-17000,-17000
20200430,05855P,滬深2X中信9C售01,0.66,0.68,0.66,0.68,-0.03,-4.23,100000,2,66020,0,0,0,0,0,0,99000,1000,98000,98000
20200430,058560,T50反1凱基9A購04,,,,,0.00,0.00,0,0,0,0,0,0,0,0,0,0,0,0,0
20200430,058561,T50反1凱基9A購05,1.61,1.61,1.61,1.61,-0.14,-8.0,5000,1,8050,0,0,0,0,0,0,0,5000,-5000,-5000
20200430,058562,元油2X凱基99購01,,,,,0.00,0.00,0,0,0,0,0,0,0,0,0,0,0,0,0
20200430,058563,元油2X凱基9B購07,,,,,0.00,0.00,0,0,0,0,0,0,0,0,0,0,0,0,0
20200430,058564,元金2X凱基9C購01,,,,,0.00,0.00,0,0,0,0,0,0,0,0,0,0,0,0,0
20200430,058565,鴻海凱基9A購07,1.97,1.97,1.97,1.97,+0.04,2.07,4000,4,7880,0,0,0,0,0,0,4000,0,4000,4000
20200430,058566,聯發科凱基9A購02,,,,,0.00,0.00,0,0,0,0,0,0,0,0,0,0,0,0,0
20200430,058567,華新科凱基9A購02,1.49,1.49,1.42,1.47,+0.02,1.38,26000,5,37210,0,0,0,0,0,0,2000,24000,-22000,-22000
20200430,058568,宏達電凱基9A購02,1.22,1.25,1.20,1.20,-0.02,-1.64,256000,7,319790,0,0,0,0,0,0,2000,254000,-252000,-252000
20200430,058569,健策凱基9A購01,2.35,2.46,2.29,2.36,+0.10,4.42,322000,36,758750,0,0,0,0,0,0,211000,167000,44000,44000
20200430,05856P,A50正2中信99售01,,,,,0.00,0.00,0,0,0,0,0,0,0,0,0,0,0,0,0
20200430,058570,臻鼎凱基9A購01,1.68,1.73,1.64,1.73,+0.10,6.13,110000,8,185200,0,0,0,0,0,0,50000,60000,-10000,-10000
20200430,058571,緯穎凱基9A購02,,,,,0.00,0.00,0,0,0,0,0,0,0,0,0,0,0,0,0
20200430,058572,百和凱基9A購01,3.46,3.46,3.32,3.44,-0.02,-0.58,69000,9,236240,0,0,0,0,0,0,69000,30000,39000,39000
20200430,058573,鴻海群益9A購02,3.58,3.69,3.50,3.69,+0.25,7.27,134000,19,479730,0,0,0,0,0,0,85000,86000,-1000,-1000
20200430,058574,台積電群益99購03,,,,,0.00,0.00,0,0,0,0,0,0,0,0,0,0,0,0,0
20200430,058575,智邦群益99購01,8.20,8.20,7.75,7.75,-0.10,-1.27,52000,5,413850,0,0,0,0,0,0,52000,5000,47000,47000
20200430,058576,南亞科群益99購01,1.41,1.41,1.37,1.39,+0.04,2.96,336000,24,465930,0,0,0,0,0,0,69000,267000,-198000,-198000
20200430,058577,南亞科群益99購02,2.45,2.45,2.34,2.37,+0.09,3.95,86000,6,206200,0,0,0,0,0,0,46000,40000,6000,6000
20200430,058578,聯發科群益99購03,4.83,5.05,4.83,5.05,+0.60,13.48,21000,7,103400,0,0,0,0,0,0,13000,7000,6000,6000
20200430,058579,聯發科群益99購04,9.80,9.80,9.80,9.80,0.00,0.00,2000,1,19600,0,0,0,0,0,0,0,2000,-2000,-2000
20200430,05857P,旺宏中信98售02,,,,,0.00,0.00,0,0,0,0,0,0,0,0,0,0,0,0,0
20200430,058580,華新科群益99購02,2.12,2.12,2.06,2.06,+0.01,0.49,50000,4,105000,0,0,0,0,0,0,29000,21000,8000,8000
20200430,058581,大立光群益99購05,3.93,4.39,3.91,4.39,+0.69,18.65,40000,11,167540,0,0,0,0,0,0,10000,30000,-20000,-20000
20200430,058582,禾伸堂群益99購02,,,,,0.00,0.00,0,0,0,0,0,0,0,0,0,0,0,0,0
20200430,058583,臻鼎群益99購01,1.95,2.14,1.92,2.14,+0.25,13.23,506000,17,1012720,0,0,0,0,0,0,340000,166000,174000,174000
20200430,058584,百和群益9A購01,2.04,2.05,1.93,2.03,0.00,0.00,414000,27,834540,0,0,0,0,0,0,312000,124000,188000,188000
20200430,058585,S&P正2中信9B購02,0.66,0.66,0.66,0.66,0.00,0.00,10000,2,6600,0,0,0,0,0,0,0,10000,-10000,-10000
20200430,058586,鴻海中信01購02,0.73,0.75,0.70,0.72,-0.04,-5.26,71000,11,50610,0,0,0,0,0,0,0,55000,-55000,-55000
20200430,058587,台積電中信9C購03,0.72,0.81,0.72,0.73,-0.04,-5.19,232000,16,182320,0,0,0,0,0,0,0,180000,-180000,-180000
20200430,058588,致茂中信9B購01,1.79,1.79,1.65,1.66,-0.05,-2.92,364000,18,614210,0,0,0,0,0,0,253000,0,253000,253000
20200430,058589,群創中信01購01,1.25,1.25,1.25,1.25,+0.05,4.17,48000,1,60000,0,0,0,0,0,0,48000,0,48000,48000
20200430,05858P,矽力中信96售01,0.24,0.24,0.24,0.24,+0.02,9.09,2000,2,480,0,0,0,0,0,0,0,0,0,0
20200430,058590,南電中信9A購02,1.51,1.51,1.32,1.32,-0.13,-8.97,40000,12,57900,0,0,0,0,0,0,30000,10000,20000,20000
20200430,058591,台灣50統一9B購02,2.08,2.15,2.08,2.15,+0.18,9.14,68000,2,142840,0,0,0,0,0,0,0,68000,-68000,-68000
20200430,058592,聯發科統一9C購01,1.92,1.98,1.92,1.98,+0.21,11.86,133000,7,260440,0,0,0,0,0,0,60000,73000,-13000,-13000
20200430,058593,大立光統一9B購02,,,,,0.00,0.00,0,0,0,0,0,0,0,0,0,0,0,0,0
20200430,058594,台灣50元富9B購03,0.83,0.83,0.83,0.83,+0.23,38.33,1000,1,830,0,0,0,0,0,0,1000,0,1000,1000
20200430,058595,T50正2元富99購01,,,,,0.00,0.00,0,0,0,0,0,0,0,0,0,0,0,0,0
20200430,058596,旺宏台新99購01,2.16,2.22,2.15,2.15,+0.15,7.5,15000,4,33030,0,0,0,0,0,0,5000,10000,-5000,-5000
20200430,058597,瑞昱台新99購01,1.83,1.83,1.83,1.83,+0.24,15.09,5000,1,9150,0,0,0,0,0,0,0,0,0,0
20200430,058598,T50反1元大99購04,,,,,0.00,0.00,0,0,0,0,0,0,0,0,0,0,0,0,0
20200430,058599,T50反1元大99購05,,,,,0.00,0.00,0,0,0,0,0,0,0,0,0,0,0,0,0
20200430,05859P,台表科國票97售04,5.05,5.05,5.05,5.05,-0.30,-5.61,3000,3,15150,0,0,0,0,0,0,3000,0,3000,3000
20200430,058600,國巨元大99購15,,,,,0.00,0.00,0,0,0,0,0,0,0,0,0,0,0,0,0
20200430,058601,台積電元大99購10,,,,,0.00,0.00,0,0,0,0,0,0,0,0,0,0,0,0,0
20200430,058602,台積電元大99購11,1.90,1.90,1.90,1.90,+0.07,3.83,82000,1,155800,0,0,0,0,0,0,82000,82000,0,0
20200430,058603,台積電元大99購12,2.80,2.80,2.70,2.80,+0.25,9.8,39000,8,106840,0,0,0,0,0,0,34000,1000,33000,33000
20200430,058604,華邦電元大99購03,0.92,0.98,0.91,0.97,+0.10,11.49,469000,18,446840,0,0,0,0,0,0,88000,380000,-292000,-292000
20200430,058605,華邦電元大99購04,0.89,0.96,0.89,0.96,+0.11,12.94,311000,10,292600,0,0,0,0,0,0,0,301000,-301000,-301000
20200430,058606,聯發科元大99購13,5.85,5.95,5.85,5.95,+0.55,10.19,14000,2,82300,0,0,0,0,0,0,14000,0,14000,14000
20200430,058607,聯發科元大99購14,4.21,4.21,4.21,4.21,+0.63,17.6,1000,1,4210,0,0,0,0,0,0,1000,1000,0,0
20200430,058608,華新科元大99購13,,,,,0.00,0.00,0,0,0,0,0,0,0,0,0,0,0,0,0
20200430,058609,玉山金元大99購01,0.73,0.73,0.73,0.73,+0.09,14.06,1000,1,730,0,0,0,0,0,0,1000,0,1000,1000
20200430,05860P,旺宏康和96售01,0.84,0.84,0.83,0.83,-0.07,-7.78,18000,3,15090,0,0,0,0,0,0,15000,3000,12000,12000
20200430,058610,欣興元大99購05,3.80,3.93,3.74,3.81,0.00,0.00,134000,16,512870,0,0,0,0,0,0,104000,32000,72000,72000
20200430,058611,欣興元大99購06,3.89,4.00,3.83,3.87,+0.20,5.45,226000,22,882000,0,0,0,0,0,0,221000,21000,200000,200000
20200430,058612,健策元大99購02,3.02,3.02,3.02,3.02,+0.20,7.09,58000,1,175160,0,0,0,0,0,0,58000,0,58000,58000
20200430,058613,茂林元大99購03,1.58,1.58,1.52,1.55,+0.02,1.31,160000,5,247950,0,0,0,0,0,0,110000,50000,60000,60000
20200430,058614,台郡元大9A購01,0.65,0.71,0.64,0.71,+0.05,7.58,90000,6,59500,0,0,0,0,0,0,75000,0,75000,75000
20200430,058615,矽創元大99購01,1.00,1.00,1.00,1.00,+0.14,16.28,10000,1,10000,0,0,0,0,0,0,0,10000,-10000,-10000
20200430,058616,台虹元大9A購01,0.75,0.75,0.73,0.73,0.00,0.00,143000,4,106200,0,0,0,0,0,0,93000,50000,43000,43000
20200430,058617,南電元大99購01,6.80,6.85,6.50,6.50,-0.10,-1.52,24000,4,162550,0,0,0,0,0,0,23000,1000,22000,22000
20200430,058618,南電元大99購02,,,,,0.00,0.00,0,0,0,0,0,0,0,0,0,0,0,0,0
20200430,058619,台灣50國票99購04,,,,,0.00,0.00,0,0,0,0,0,0,0,0,0,0,0,0,0
20200430,05861P,瀚宇博永豐96售02,1.21,1.23,1.17,1.17,-0.10,-7.87,35000,4,42350,0,0,0,0,0,0,0,35000,-35000,-35000
20200430,058620,滬深2X國票9A購02,1.17,1.17,1.17,1.17,0.00,0.00,3000,1,3510,0,0,0,0,0,0,0,3000,-3000,-3000
20200430,058621,華通國票9A購01,2.19,2.45,2.19,2.45,+0.43,21.29,34000,3,80430,0,0,0,0,0,0,7000,27000,-20000,-20000
20200430,058622,國巨國票99購07,3.15,3.27,3.15,3.19,+0.18,5.98,512000,48,1636030,0,0,0,0,0,0,459000,1000,458000,458000
20200430,058623,國巨國票99購08,2.79,2.79,2.79,2.79,+0.14,5.28,10000,1,27900,0,0,0,0,0,0,10000,0,10000,10000
20200430,058624,台積電國票99購09,,,,,0.00,0.00,0,0,0,0,0,0,0,0,0,0,0,0,0
20200430,058625,旺宏國票9A購01,3.93,3.93,3.79,3.87,+0.50,14.84,157000,7,600430,0,0,0,0,0,0,114000,43000,71000,71000
20200430,058626,瑞昱國票9A購01,4.93,5.30,4.92,5.25,+0.61,13.15,44000,11,225400,0,0,0,0,0,0,4000,40000,-36000,-36000
20200430,058627,聯發科國票99購04,,,,,0.00,0.00,0,0,0,0,0,0,0,0,0,0,0,0,0
20200430,058628,宏達電國票9A購01,1.39,1.39,1.32,1.32,-0.08,-5.71,31000,2,42390,0,0,0,0,0,0,21000,10000,11000,11000
20200430,058629,嘉晶國票9A購01,1.28,1.35,1.28,1.34,+0.08,6.35,88000,3,114600,0,0,0,0,0,0,0,88000,-88000,-88000
20200430,05862P,大立光國泰98售01,,,,,0.00,0.00,0,0,0,0,0,0,0,0,0,0,0,0,0
20200430,058630,日月光國票9A購01,4.11,4.48,4.11,4.48,+0.50,12.56,66000,10,280540,0,0,0,0,0,0,6000,60000,-54000,-54000
20200430,058631,鈺齊國票9A購01,7.85,8.20,7.80,8.20,+0.20,2.5,27000,12,215150,0,0,0,0,0,0,23000,21000,2000,2000
20200430,058632,世紀鋼國票9A購01,5.25,5.60,5.25,5.60,+0.45,8.74,15000,3,79650,0,0,0,0,0,0,13000,2000,11000,11000
20200430,058633,台灣50兆豐99購01,0.30,0.42,0.30,0.42,+0.13,44.83,36000,3,14400,0,0,0,0,0,0,36000,0,36000,36000
20200430,058634,可成兆豐99購03,,,,,0.00,0.00,0,0,0,0,0,0,0,0,0,0,0,0,0
20200430,058635,華新科兆豐99購03,0.96,0.96,0.92,0.92,+0.02,2.22,21000,2,19760,0,0,0,0,0,0,11000,10000,1000,1000
20200430,058636,亞光兆豐9A購01,,,,,0.00,0.00,0,0,0,0,0,0,0,0,0,0,0,0,0
20200430,058637,晶技兆豐99購01,3.13,3.28,3.13,3.25,+0.12,3.83,44000,4,141140,0,0,0,0,0,0,6000,38000,-32000,-32000
20200430,058638,矽力兆豐99購01,,,,,0.00,0.00,0,0,0,0,0,0,0,0,0,0,0,0,0
20200430,058639,南電兆豐99購01,4.49,4.49,4.49,4.49,+0.10,2.28,10000,1,44900,0,0,0,0,0,0,10000,0,10000,10000
20200430,05863P,滬深2X元大96售09,,,,,0.00,0.00,0,0,0,0,0,0,0,0,0,0,0,0,0
20200430,058640,台灣50麥證9A購01,,,,,0.00,0.00,0,0,0,0,0,0,0,0,0,0,0,0,0
20200430,058641,鴻海麥證99購02,,,,,0.00,0.00,0,0,0,0,0,0,0,0,0,0,0,0,0
20200430,058642,旺宏麥證9A購01,1.93,1.95,1.86,1.88,+0.19,11.24,275000,12,516410,153000,122000,31000,0,0,0,153000,122000,31000,31000
20200430,058643,T50正2富邦03購01,0.62,0.62,0.62,0.62,+0.04,6.9,6000,1,3720,0,0,0,0,0,0,6000,0,6000,6000
20200430,058644,元黃金富邦03購01,1.40,1.40,1.40,1.40,0.00,0.00,10000,7,14000,0,0,0,0,0,0,0,10000,-10000,-10000
20200430,058645,康控富邦01購01,0.58,0.66,0.58,0.66,+0.11,20.0,574000,26,370550,0,0,0,0,0,0,84000,490000,-406000,-406000
20200430,058646,聯茂富邦9A購01,0.45,0.45,0.42,0.43,-0.02,-4.44,408000,21,176860,0,0,0,0,0,0,216000,238000,-22000,-22000
20200430,058647,華新科永豐99購03,1.71,1.71,1.71,1.71,-0.02,-1.16,10000,1,17100,0,0,0,0,0,0,10000,0,10000,10000
20200430,058648,聯陽永豐99購01,0.61,0.61,0.61,0.61,-0.01,-1.61,20000,1,12200,0,0,0,0,0,0,20000,0,20000,20000
20200430,058649,健策永豐99購01,2.58,2.68,2.58,2.68,+0.16,6.35,23000,6,59740,0,0,0,0,0,0,1000,23000,-22000,-22000
20200430,05864P,元油反元大96售07,,,,,0.00,0.00,0,0,0,0,0,0,0,0,0,0,0,0,0
20200430,058650,台虹永豐9A購01,0.86,0.89,0.86,0.89,-0.01,-1.11,56000,4,49000,0,0,0,0,0,0,56000,0,56000,56000
20200430,058651,FBVIX中信9C購01,,,,,0.00,0.00,0,0,0,0,0,0,0,0,0,0,0,0,0
20200430,058652,SGBR2X中信01購01,0.32,0.49,0.30,0.48,0.00,0.00,278000,17,122520,0,0,0,0,0,0,0,0,0,0
20200430,058653,光寶科中信9A購01,3.24,3.37,3.20,3.37,+0.23,7.32,392000,36,1288270,0,0,0,0,0,0,221000,304000,-83000,-83000
20200430,058654,鴻海中信03購01,2.45,2.45,2.43,2.43,+0.05,2.1,41000,2,99750,0,0,0,0,0,0,41000,0,41000,41000
20200430,058655,鴻海中信03購02,,,,,0.00,0.00,0,0,0,0,0,0,0,0,0,0,0,0,0
20200430,058656,燿華中信99購01,0.66,0.75,0.65,0.70,+0.06,9.38,1066000,93,732350,0,0,0,0,0,0,574000,374000,200000,200000
20200430,058657,大立光中信99購01,1.69,1.80,1.69,1.80,+0.26,16.88,20000,2,34900,0,0,0,0,0,0,10000,10000,0,0
20200430,058658,瑞儀中信99購01,1.77,1.82,1.74,1.82,+0.06,3.41,221000,9,391540,0,0,0,0,0,0,36000,185000,-149000,-149000
20200430,058659,力成中信99購01,1.69,1.83,1.64,1.83,+0.23,14.37,663000,41,1139510,0,0,0,0,0,0,236000,427000,-191000,-191000
20200430,05865P,大立光元大96售09,,,,,0.00,0.00,0,0,0,0,0,0,0,0,0,0,0,0,0
20200430,058660,樺漢中信9A購01,1.17,1.28,1.17,1.25,+0.12,10.62,831000,36,1010690,0,0,0,0,0,0,314000,517000,-203000,-203000
20200430,058661,臺股指中信9C購01,0.69,0.75,0.69,0.75,+0.16,27.12,115000,5,83450,0,0,0,0,0,0,100000,15000,85000,85000
20200430,058662,禾伸堂兆豐99購01,3.25,3.25,3.10,3.10,+0.03,0.98,19000,2,61300,0,0,0,0,0,0,19000,0,19000,19000
20200430,058663,瑞儀兆豐9A購01,1.25,1.28,1.24,1.28,+0.04,3.23,286000,10,357170,0,0,0,0,0,0,97000,189000,-92000,-92000
20200430,058664,百和兆豐99購01,1.29,1.29,1.21,1.25,-0.01,-0.79,650000,39,821650,0,0,0,0,0,0,576000,24000,552000,552000
20200430,058665,台灣50群益9B購02,,,,,0.00,0.00,0,0,0,0,0,0,0,0,0,0,0,0,0
20200430,058666,上証反群益01購01,0.65,0.65,0.64,0.64,-0.04,-5.88,205000,3,133220,0,0,0,0,0,0,202000,3000,199000,199000
20200430,058667,元油2X群益99購01,0.07,0.07,0.07,0.07,+0.01,16.67,32000,2,2240,0,0,0,0,0,0,0,0,0,0
20200430,058668,元油2X群益9B購04,0.12,0.14,0.12,0.14,+0.03,27.27,599000,15,79590,0,0,0,0,0,0,0,0,0,0
20200430,058669,上銀群益99購01,3.58,4.06,3.58,4.06,+0.77,23.4,40000,7,149320,0,0,0,0,0,0,0,40000,-40000,-40000
20200430,05866P,致伸元大96售01,2.19,2.33,2.17,2.33,+0.10,4.48,211000,10,471370,0,0,0,0,0,0,133000,78000,55000,55000
20200430,058670,鴻海群益9A購03,1.12,1.20,1.12,1.20,+0.11,10.09,290000,6,336400,0,0,0,0,0,0,40000,250000,-210000,-210000
20200430,058671,旺宏群益9A購01,6.50,6.50,6.25,6.25,+0.50,8.7,20000,10,127150,0,0,0,0,0,0,20000,10000,10000,10000
20200430,058672,可成群益9B購02,2.29,2.29,2.06,2.06,-0.29,-12.34,98000,4,217080,0,0,0,0,0,0,10000,90000,-80000,-80000
20200430,058673,華新科群益9A購02,,,,,0.00,0.00,0,0,0,0,0,0,0,0,0,0,0,0,0
20200430,058674,宏達電群益99購01,,,,,0.00,0.00,0,0,0,0,0,0,0,0,0,0,0,0,0
20200430,058675,康控群益9B購01,0.72,0.74,0.72,0.74,+0.09,13.85,53000,5,38880,0,0,0,0,0,0,33000,20000,13000,13000
20200430,058676,聯茂群益99購01,1.40,1.40,1.36,1.36,+0.01,0.74,86000,3,117480,0,0,0,0,0,0,16000,70000,-54000,-54000
20200430,058677,矽格群益99購01,0.79,0.81,0.79,0.81,+0.03,3.85,75000,3,60250,0,0,0,0,0,0,73000,0,73000,73000
20200430,058678,南亞科日盛99購01,,,,,0.00,0.00,0,0,0,0,0,0,0,0,0,0,0,0,0
20200430,058679,可成日盛99購01,,,,,0.00,0.00,0,0,0,0,0,0,0,0,0,0,0,0,0
20200430,05867P,友達兆豐97售02,,,,,0.00,0.00,0,0,0,0,0,0,0,0,0,0,0,0,0
20200430,058680,國巨麥證99購02,,,,,0.00,0.00,0,0,0,0,0,0,0,0,0,0,0,0,0
20200430,058681,大立光康和9B購01,1.35,1.35,1.33,1.33,0.00,0.00,48000,2,63860,0,0,0,0,0,0,0,48000,-48000,-48000
20200430,058682,聯發科凱基99購07,4.65,4.76,4.65,4.76,0.00,0.00,67000,10,315630,0,0,0,0,0,0,0,67000,-67000,-67000
20200430,058683,可成凱基9A購01,1.84,1.84,1.84,1.84,-0.09,-4.66,10000,1,18400,0,0,0,0,0,0,0,10000,-10000,-10000
20200430,058684,健策凱基99購02,2.52,2.64,2.51,2.58,+0.15,6.17,96000,12,244680,0,0,0,0,0,0,67000,66000,1000,1000
20200430,058685,TPK凱基99購01,1.94,1.98,1.92,1.92,-0.01,-0.52,140000,16,271760,0,0,0,0,0,0,135000,5000,130000,130000
20200430,058686,祥碩凱基99購03,1.48,1.48,1.16,1.23,-0.15,-10.87,1076000,52,1454460,0,0,0,0,0,0,728000,600000,128000,128000
20200430,058687,聯茂凱基9A購01,,,,,0.00,0.00,0,0,0,0,0,0,0,0,0,0,0,0,0
20200430,058688,矽創凱基9A購01,1.60,1.68,1.59,1.68,+0.15,9.8,234000,23,384760,0,0,0,0,0,0,72000,162000,-90000,-90000
20200430,058689,元油2X國票99購03,0.06,0.09,0.06,0.06,0.00,0.00,135000,5,8130,0,0,0,0,0,0,0,0,0,0
20200430,05868P,台積電凱基96售17,,,,,0.00,0.00,0,0,0,0,0,0,0,0,0,0,0,0,0
20200430,058690,元油2X國票9A購03,,,,,0.00,0.00,0,0,0,0,0,0,0,0,0,0,0,0,0
20200430,058691,友訊國票9A購01,1.98,2.01,1.97,1.98,+0.03,1.54,99000,5,195610,0,0,0,0,0,0,38000,61000,-23000,-23000
20200430,058692,華邦電國票9B購01,0.54,0.57,0.54,0.57,+0.07,14.0,420000,13,236610,0,0,0,0,0,0,10000,410000,-400000,-400000
20200430,058693,旭富國票9A購01,5.15,5.15,4.89,4.89,0.00,0.00,105000,10,530080,0,0,0,0,0,0,36000,69000,-33000,-33000
20200430,058694,鈺齊國票9A購02,3.78,3.88,3.78,3.88,-0.19,-4.67,23000,2,88440,0,0,0,0,0,0,23000,8000,15000,15000
20200430,058695,元油2X元大9C購03,,,,,0.00,0.00,0,0,0,0,0,0,0,0,0,0,0,0,0
20200430,058696,元油2X元大9C購04,0.12,0.14,0.12,0.14,+0.01,7.69,309000,7,40070,0,0,0,0,0,0,0,0,0,0
20200430,058697,亞德客元大99購01,3.72,3.72,3.50,3.70,+0.22,6.32,11000,3,40520,0,0,0,0,0,0,11000,2000,9000,9000
20200430,058698,華通元大99購05,0.97,1.07,0.97,1.07,+0.14,15.05,254000,13,262670,0,0,0,0,0,0,248000,6000,242000,242000
20200430,058699,楠梓電元大99購02,1.74,1.84,1.74,1.82,+0.03,1.68,301000,16,536370,0,0,0,0,0,0,107000,194000,-87000,-87000
20200430,05869P,旺宏凱基96售05,1.41,1.46,1.41,1.46,-0.27,-15.61,52000,5,74820,0,0,0,0,0,0,52000,0,52000,52000
20200430,058700,鴻海元大99購15,2.82,2.82,2.81,2.81,+0.09,3.31,117000,5,329210,0,0,0,0,0,0,83000,30000,53000,53000
20200430,058701,鴻海元大99購16,1.35,1.35,1.35,1.35,+0.08,6.3,8000,1,10800,0,0,0,0,0,0,8000,8000,0,0
20200430,058702,國巨元大99購16,1.39,1.39,1.32,1.36,+0.08,6.25,87000,6,118190,0,0,0,0,0,0,25000,62000,-37000,-37000
20200430,058703,台積電元大99購16,1.43,1.47,1.43,1.47,+0.13,9.7,302000,18,434340,0,0,0,0,0,0,148000,154000,-6000,-6000
20200430,058704,台積電元大99購17,2.28,2.39,2.28,2.39,+0.20,9.13,103000,6,238230,0,0,0,0,0,0,31000,72000,-41000,-41000
20200430,058705,長榮航元大99購01,1.84,1.84,1.68,1.73,+0.15,9.49,338000,15,577570,0,0,0,0,0,0,320000,17000,303000,303000
20200430,058706,聯鈞元大9C購01,0.61,0.61,0.61,0.61,0.00,0.00,3000,1,1830,0,0,0,0,0,0,3000,0,3000,3000
20200430,058707,泰鼎元大99購02,2.47,2.57,2.47,2.57,-0.14,-5.17,163000,5,415210,0,0,0,0,0,0,13000,163000,-150000,-150000
20200430,058708,臺股指元大9A購21,2.60,2.60,2.60,2.60,+0.29,12.55,2000,1,5200,0,0,0,0,0,0,2000,0,2000,2000
20200430,058709,臺股指元大9A購22,,,,,0.00,0.00,0,0,0,0,0,0,0,0,0,0,0,0,0
20200430,05870P,聯發科凱基96售19,,,,,0.00,0.00,0,0,0,0,0,0,0,0,0,0,0,0,0
20200430,058710,臺股指元大9A購23,,,,,0.00,0.00,0,0,0,0,0,0,0,0,0,0,0,0,0
20200430,058711,鴻海統一9A購02,1.03,1.06,1.00,1.06,+0.07,7.07,78000,11,79550,0,0,0,0,0,0,74000,53000,21000,21000
20200430,058712,鴻海統一9B購03,1.02,1.02,1.01,1.02,+0.04,4.08,230000,14,233530,0,0,0,0,0,0,210000,30000,180000,180000
20200430,058713,國巨統一9B購02,0.66,0.66,0.66,0.66,0.00,0.00,10000,1,6600,0,0,0,0,0,0,0,10000,-10000,-10000
20200430,058714,美律統一9B購01,0.99,1.09,0.99,1.04,+0.06,6.12,1503000,38,1568630,0,0,0,0,0,0,360000,1093000,-733000,-733000
20200430,058715,鴻海台新99購02,,,,,0.00,0.00,0,0,0,0,0,0,0,0,0,0,0,0,0
20200430,058716,華新科台新99購02,1.52,1.52,1.52,1.52,0.00,0.00,10000,1,15200,0,0,0,0,0,0,10000,10000,0,0
20200430,058717,南電台新99購02,,,,,0.00,0.00,0,0,0,0,0,0,0,0,0,0,0,0,0
20200430,058718,台灣50元富03購01,1.54,1.72,1.54,1.72,+0.27,18.62,32000,11,51100,0,0,0,0,0,0,0,0,0,0
20200430,058719,智邦元富99購01,5.10,5.30,4.79,4.79,-0.86,-15.22,201000,22,1041180,0,0,0,0,0,0,201000,0,201000,201000
20200430,05871P,全新凱基96售04,1.01,1.01,1.01,1.01,+0.01,1.0,10000,1,10100,0,0,0,0,0,0,10000,0,10000,10000
20200430,058720,旭富元富99購01,2.77,2.77,2.63,2.63,0.00,0.00,217000,12,584390,0,0,0,0,0,0,152000,65000,87000,87000
20200430,058721,立積元富9C購01,2.50,2.82,2.49,2.58,+0.19,7.95,1449000,119,3806460,0,0,0,0,0,0,409000,1030000,-621000,-621000
20200430,058722,台郡元富99購01,1.13,1.17,1.11,1.17,+0.07,6.36,332000,14,377290,0,0,0,0,0,0,108000,219000,-111000,-111000
20200430,058723,元石油國泰9A購01,0.62,0.70,0.62,0.70,0.00,0.00,93000,13,59000,0,0,0,0,0,0,0,0,0,0
20200430,058724,大立光國泰9B購01,,,,,0.00,0.00,0,0,0,0,0,0,0,0,0,0,0,0,0
20200430,058725,美律富邦9A購01,0.90,0.98,0.89,0.96,+0.08,9.09,962000,21,896260,0,0,0,0,0,0,83000,879000,-796000,-796000
20200430,058726,宏達電富邦9A購01,0.10,0.10,0.10,0.10,+0.01,11.11,35000,3,3500,0,0,0,0,0,0,0,35000,-35000,-35000
20200430,058727,嘉晶富邦9A購01,0.35,0.40,0.35,0.37,+0.02,5.71,311000,11,121400,0,0,0,0,0,0,216000,95000,121000,121000
20200430,058728,SP黃豆永豐99購01,0.80,0.85,0.80,0.85,0.00,0.00,15000,3,12250,0,0,0,0,0,0,0,0,0,0
20200430,058729,國巨永豐99購03,2.46,2.46,2.46,2.46,-0.01,-0.4,10000,1,24600,0,0,0,0,0,0,10000,0,10000,10000
20200430,05872P,大立光凱基96售15,,,,,0.00,0.00,0,0,0,0,0,0,0,0,0,0,0,0,0
20200430,058730,玉晶光永豐9A購01,1.47,1.66,1.47,1.66,+0.22,15.28,110000,20,167680,0,0,0,0,0,0,75000,36000,39000,39000
20200430,058731,貿聯永豐99購02,0.84,1.08,0.84,1.06,+0.31,41.33,504000,64,490260,0,0,0,0,0,0,95000,428000,-333000,-333000
20200430,058732,矽格永豐99購01,0.74,0.78,0.74,0.78,+0.05,6.85,140000,8,106970,0,0,0,0,0,0,50000,90000,-40000,-40000
20200430,058733,同欣電永豐99購02,0.77,0.88,0.77,0.88,+0.13,17.33,495000,17,395060,0,0,0,0,0,0,15000,480000,-465000,-465000
20200430,058734,康友永豐99購01,0.27,0.29,0.27,0.27,0.00,0.00,106000,9,28920,0,0,0,0,0,0,26000,80000,-54000,-54000
20200430,058735,南茂永豐99購01,0.61,0.62,0.61,0.61,-0.01,-1.61,202000,3,124220,0,0,0,0,0,0,202000,0,202000,202000
20200430,058736,鈺齊永豐99購02,0.30,0.33,0.30,0.32,0.00,0.00,1597000,11,494340,0,0,0,0,0,0,1541000,56000,1485000,1485000
20200430,058737,鴻海第一01購01,,,,,0.00,0.00,0,0,0,0,0,0,0,0,0,0,0,0,0
20200430,058738,FBVIX中信03購04,2.25,2.26,2.24,2.24,-0.11,-4.68,6000,3,13500,0,0,0,0,0,0,0,6000,-6000,-6000
20200430,058739,喬山中信99購01,0.62,0.82,0.59,0.77,+0.20,35.09,542000,32,366880,0,0,0,0,0,0,91000,451000,-360000,-360000
20200430,05873P,華通群益97售02,,,,,0.00,0.00,0,0,0,0,0,0,0,0,0,0,0,0,0
20200430,058740,T50反1日盛9B購02,,,,,0.00,0.00,0,0,0,0,0,0,0,0,0,0,0,0,0
20200430,058741,欣興日盛99購01,2.25,2.29,2.23,2.28,+0.16,7.55,113000,13,256100,0,0,0,0,0,0,56000,57000,-1000,-1000
20200430,058742,鴻海康和99購01,,,,,0.00,0.00,0,0,0,0,0,0,0,0,0,0,0,0,0
20200430,058743,可成康和99購01,,,,,0.00,0.00,0,0,0,0,0,0,0,0,0,0,0,0,0
20200430,058744,FBVIX凱基9C購03,,,,,0.00,0.00,0,0,0,0,0,0,0,0,0,0,0,0,0
20200430,058745,元金2X凱基9C購02,,,,,0.00,0.00,0,0,0,0,0,0,0,0,0,0,0,0,0
20200430,058746,華通凱基9A購02,1.74,1.94,1.74,1.91,+0.23,13.69,111000,12,204900,0,0,0,0,0,0,55000,56000,-1000,-1000
20200430,058747,友達凱基9A購03,,,,,0.00,0.00,0,0,0,0,0,0,0,0,0,0,0,0,0
20200430,058748,景碩凱基9A購01,1.47,1.62,1.46,1.57,+0.02,1.29,144000,14,214700,0,0,0,0,0,0,98000,60000,38000,38000
20200430,058749,康控凱基99購03,0.97,1.11,0.97,1.11,+0.20,21.98,45000,3,47960,0,0,0,0,0,0,45000,0,45000,45000
20200430,05874P,台積電群益96售10,,,,,0.00,0.00,0,0,0,0,0,0,0,0,0,0,0,0,0
20200430,058750,緯穎凱基9A購03,1.50,1.82,1.50,1.70,+0.27,18.88,122000,17,191170,0,0,0,0,0,0,40000,72000,-32000,-32000
20200430,058751,南茂凱基9A購01,2.73,2.81,2.73,2.81,+0.11,4.07,40000,5,110900,0,0,0,0,0,0,0,40000,-40000,-40000
20200430,058752,鈺齊凱基9A購01,1.23,1.27,1.18,1.27,+0.06,4.96,550000,26,676390,0,0,0,0,0,0,354000,223000,131000,131000
20200430,058753,元石油群益9B購03,0.46,0.46,0.45,0.46,+0.06,15.0,51000,6,23250,0,0,0,0,0,0,0,0,0,0
20200430,058754,元油2X群益99購02,0.11,0.12,0.11,0.12,+0.02,20.0,727000,14,80040,5000,0,5000,0,0,0,0,0,0,5000
20200430,058755,SGBR2X群益99購01,0.23,0.23,0.23,0.23,0.00,0.00,19000,1,4370,0,0,0,0,0,0,0,0,0,0
20200430,058756,SGBR2X群益99購02,,,,,0.00,0.00,0,0,0,0,0,0,0,0,0,0,0,0,0
20200430,058757,道瓊銀群益9A購02,,,,,0.00,0.00,0,0,0,0,0,0,0,0,0,0,0,0,0
20200430,058758,台積電群益99購05,1.13,1.13,1.13,1.13,0.00,0.00,20000,1,22600,0,0,0,0,0,0,20000,20000,0,0
20200430,058759,義隆群益99購01,3.84,4.18,3.84,4.18,+0.34,8.85,185000,38,741150,0,0,0,0,0,0,43000,155000,-112000,-112000
20200430,05875P,旺宏群益98售01,2.06,2.10,2.06,2.10,-0.19,-8.3,26000,2,53600,0,0,0,0,0,0,25000,1000,24000,24000
20200430,058760,嘉晶群益9A購01,0.99,1.13,0.99,1.07,+0.09,9.18,352000,9,363000,0,0,0,0,0,0,0,342000,-342000,-342000
20200430,058761,欣興群益99購02,2.69,2.77,2.63,2.63,+0.02,0.77,24000,5,64630,0,0,0,0,0,0,19000,7000,12000,12000
20200430,058762,貿聯群益99購03,1.62,1.84,1.62,1.84,+0.31,20.26,741000,34,1292700,0,0,0,0,0,0,133000,608000,-475000,-475000
20200430,058763,和碩群益99購01,3.44,3.51,3.44,3.48,-0.09,-2.52,249000,14,866990,0,0,0,0,0,0,96000,153000,-57000,-57000
20200430,058764,康友群益99購01,1.03,1.10,1.03,1.09,+0.13,13.54,290000,12,306590,0,0,0,0,0,0,57000,240000,-183000,-183000
20200430,058765,緯穎群益99購03,4.02,4.73,3.99,4.57,+0.74,19.32,215000,16,920380,0,0,0,0,0,0,69000,146000,-77000,-77000
20200430,058766,力山兆豐99購01,2.75,2.99,2.46,2.48,-0.06,-2.36,1205000,95,3313670,0,0,0,0,0,0,647000,369000,278000,278000
20200430,058767,亞德客兆豐99購01,1.74,1.88,1.71,1.88,+0.20,11.9,5000,5,8920,0,0,0,0,0,0,5000,2000,3000,3000
20200430,058768,南港兆豐99購01,1.15,1.15,0.97,0.98,-0.12,-10.91,450000,24,474390,0,0,0,0,0,0,101000,333000,-232000,-232000
20200430,058769,友達兆豐99購01,,,,,0.00,0.00,0,0,0,0,0,0,0,0,0,0,0,0,0
20200430,05876P,聯發科群益96售03,,,,,0.00,0.00,0,0,0,0,0,0,0,0,0,0,0,0,0
20200430,058770,貿聯兆豐9A購01,1.47,1.68,1.46,1.68,+0.31,22.63,313000,20,491800,0,0,0,0,0,0,1000,312000,-311000,-311000
20200430,058771,神達兆豐99購01,0.91,0.91,0.91,0.91,+0.01,1.11,6000,2,5460,0,0,0,0,0,0,3000,3000,0,0
20200430,058772,茂林兆豐9A購01,0.99,0.99,0.94,0.94,-0.01,-1.05,69000,3,67310,0,0,0,0,0,0,69000,0,69000,69000
20200430,058773,和碩兆豐99購01,2.36,2.41,2.36,2.40,+0.03,1.27,96000,13,229600,0,0,0,0,0,0,10000,86000,-76000,-76000
20200430,058774,台郡兆豐9A購01,0.97,0.99,0.94,0.97,+0.02,2.11,129000,9,122410,0,0,0,0,0,0,98000,16000,82000,82000
20200430,058775,台積電國票9A購02,4.28,4.38,4.24,4.38,+0.38,9.5,477000,15,2055060,0,0,0,0,0,0,367000,113000,254000,254000
20200430,058776,台積電國票9A購03,,,,,0.00,0.00,0,0,0,0,0,0,0,0,0,0,0,0,0
20200430,058777,台光電國票9A購01,14.50,14.50,14.40,14.40,+0.40,2.86,2000,2,28900,0,0,0,0,0,0,1000,1000,0,0
20200430,058778,聯發科國票9A購01,,,,,0.00,0.00,0,0,0,0,0,0,0,0,0,0,0,0,0
20200430,058779,大立光國票9A購02,,,,,0.00,0.00,0,0,0,0,0,0,0,0,0,0,0,0,0
20200430,05877P,大立光群益96售06,4.01,4.01,4.01,4.01,-0.72,-15.22,4000,1,16040,0,0,0,0,0,0,4000,0,4000,4000
20200430,058780,牧德國票9A購01,2.14,2.28,2.14,2.26,+0.19,9.18,85000,10,187430,0,0,0,0,0,0,5000,81000,-76000,-76000
20200430,058781,康友國票9A購01,1.10,1.18,1.09,1.16,+0.10,9.43,267000,11,308500,0,0,0,0,0,0,107000,163000,-56000,-56000
20200430,058782,臺股指國票99購01,2.82,2.82,2.82,2.82,+0.46,19.49,10000,1,28200,0,0,0,0,0,0,10000,0,10000,10000
20200430,058783,臺股指國票99購02,2.26,2.47,2.26,2.47,+0.39,18.75,60000,10,140660,0,0,0,0,0,0,21000,39000,-18000,-18000
20200430,058784,臺股指國票99購03,3.01,3.01,3.01,3.01,+1.46,94.19,13000,1,39130,0,0,0,0,0,0,0,13000,-13000,-13000
20200430,058785,臺股指國票99購04,,,,,0.00,0.00,0,0,0,0,0,0,0,0,0,0,0,0,0
20200430,058786,元黃金元大99購01,,,,,0.00,0.00,0,0,0,0,0,0,0,0,0,0,0,0,0
20200430,058787,元石油元大9A購01,0.24,0.24,0.24,0.24,0.00,0.00,25000,4,6000,0,0,0,0,0,0,0,0,0,0
20200430,058788,喬山元大99購01,1.61,1.93,1.61,1.90,+0.33,21.02,1103000,52,2013780,0,0,0,0,0,0,8000,1095000,-1087000,-1087000
20200430,058789,喬山元大99購02,1.10,1.10,1.10,1.10,0.00,0.00,1000,1,1100,0,0,0,0,0,0,0,1000,-1000,-1000
20200430,05878P,創意群益98售01,,,,,0.00,0.00,0,0,0,0,0,0,0,0,0,0,0,0,0
20200430,058790,楠梓電元大99購03,1.86,1.95,1.85,1.87,-0.05,-2.6,228000,23,431400,0,0,0,0,0,0,150000,79000,71000,71000
20200430,058791,鴻海元大99購17,2.29,2.29,2.29,2.29,0.00,0.00,8000,1,18320,0,0,0,0,0,0,8000,8000,0,0
20200430,058792,鴻海元大99購18,3.33,3.44,3.33,3.44,+0.18,5.52,57000,4,193660,0,0,0,0,0,0,57000,57000,0,0
20200430,058793,鴻海元大99購19,2.97,2.99,2.92,2.92,+0.05,1.74,72000,7,214190,0,0,0,0,0,0,57000,22000,35000,35000
20200430,058794,旺宏元大99購09,3.07,3.07,3.07,3.07,0.00,0.00,10000,1,30700,0,0,0,0,0,0,10000,0,10000,10000
20200430,058795,可成元大99購03,2.43,2.43,2.43,2.43,-0.10,-3.95,20000,2,48600,0,0,0,0,0,0,0,20000,-20000,-20000
20200430,058796,可成元大99購04,1.57,1.57,1.46,1.46,-0.09,-5.81,192000,13,287620,0,0,0,0,0,0,84000,148000,-64000,-64000
20200430,058797,大毅元大99購03,4.49,5.00,4.35,4.39,+0.30,7.33,455000,62,2070030,0,0,0,0,0,0,232000,223000,9000,9000
20200430,058798,大立光元大99購11,,,,,0.00,0.00,0,0,0,0,0,0,0,0,0,0,0,0,0
20200430,058799,晶技元大99購04,10.20,10.20,9.75,9.75,-0.05,-0.51,8000,3,80050,0,0,0,0,0,0,0,8000,-8000,-8000
20200430,05879P,台積電台新96售03,1.52,1.52,1.52,1.52,-0.32,-17.39,10000,1,15200,0,0,0,0,0,0,10000,10000,0,0
20200430,058800,健策元大99購03,4.27,4.41,4.20,4.41,+0.31,7.56,123000,21,525280,0,0,0,0,0,0,72000,99000,-27000,-27000
20200430,058801,致伸元大99購01,1.66,1.66,1.62,1.63,-0.09,-5.23,168000,16,273760,0,0,0,0,0,0,72000,165000,-93000,-93000
20200430,058802,矽創元大99購02,3.32,3.42,3.18,3.42,+0.44,14.77,347000,33,1148840,0,0,0,0,0,0,236000,221000,15000,15000
20200430,058803,世紀鋼元大99購03,2.30,2.45,2.24,2.41,+0.17,7.59,366000,34,861370,0,0,0,0,0,0,105000,334000,-229000,-229000
20200430,058804,T50反1統一9B購01,,,,,0.00,0.00,0,0,0,0,0,0,0,0,0,0,0,0,0
20200430,058805,元石油統一9B購02,0.84,0.84,0.80,0.80,+0.02,2.56,30000,5,24600,0,0,0,0,0,0,0,0,0,0
20200430,058806,道瓊銀統一9B購01,,,,,0.00,0.00,0,0,0,0,0,0,0,0,0,0,0,0,0
20200430,058807,和大統一9B購01,0.28,0.34,0.28,0.34,+0.07,25.93,95000,12,29120,0,0,0,0,0,0,0,93000,-93000,-93000
20200430,058808,大成鋼統一9B購01,0.58,0.60,0.58,0.60,0.00,0.00,476000,11,283160,0,0,0,0,0,0,152000,324000,-172000,-172000
20200430,058809,國巨統一9B購03,,,,,0.00,0.00,0,0,0,0,0,0,0,0,0,0,0,0,0
20200430,05880P,創意康和96售01,0.57,0.57,0.55,0.55,-0.04,-6.78,50000,3,28080,0,0,0,0,0,0,49000,1000,48000,48000
20200430,058810,國巨統一9B購04,,,,,0.00,0.00,0,0,0,0,0,0,0,0,0,0,0,0,0
20200430,058811,台積電統一9A購05,1.33,1.36,1.33,1.36,0.00,0.00,34000,4,45790,0,0,0,0,0,0,0,34000,-34000,-34000
20200430,058812,台積電統一9B購06,,,,,0.00,0.00,0,0,0,0,0,0,0,0,0,0,0,0,0
20200430,058813,旺宏統一9B購04,1.79,1.79,1.72,1.72,+0.13,8.18,103000,2,180520,0,0,0,0,0,0,103000,0,103000,103000
20200430,058814,南亞科台新99購01,,,,,0.00,0.00,0,0,0,0,0,0,0,0,0,0,0,0,0
20200430,058815,華新科台新99購03,,,,,0.00,0.00,0,0,0,0,0,0,0,0,0,0,0,0,0
20200430,058816,祥碩台新99購02,2.00,2.00,1.52,1.52,-0.28,-15.56,131000,12,230390,0,0,0,0,0,0,86000,45000,41000,41000
20200430,058817,嘉聯益台新99購01,0.22,0.22,0.22,0.22,0.00,0.00,10000,1,2200,0,0,0,0,0,0,0,10000,-10000,-10000
20200430,058818,南電台新99購03,,,,,0.00,0.00,0,0,0,0,0,0,0,0,0,0,0,0,0
20200430,058819,華通國泰9B購01,2.27,2.53,2.26,2.53,+0.33,15.0,1159000,134,2734350,0,0,0,0,0,0,707000,406000,301000,301000
20200430,05881P,彩晶康和96售01,1.02,1.02,1.02,1.02,0.00,0.00,470000,1,479400,0,0,0,0,0,0,470000,0,470000,470000
20200430,058820,致茂國泰9B購01,1.91,1.91,1.90,1.90,-0.11,-5.47,32000,2,60820,0,0,0,0,0,0,32000,0,32000,32000
20200430,058821,泰鼎國泰9B購01,2.86,2.87,2.84,2.87,+0.01,0.35,100000,3,284710,0,0,0,0,0,0,0,100000,-100000,-100000
20200430,058822,樺漢國泰9B購01,1.87,1.98,1.87,1.96,+0.08,4.26,236000,17,458710,0,0,0,0,0,0,6000,227000,-221000,-221000
20200430,058823,聯發科富邦9C購01,4.94,5.00,4.89,5.00,+0.52,11.61,59000,25,291960,0,0,0,0,0,0,59000,10000,49000,49000
20200430,058824,晶技富邦9A購01,,,,,0.00,0.00,0,0,0,0,0,0,0,0,0,0,0,0,0
20200430,058825,同欣電富邦9A購01,,,,,0.00,0.00,0,0,0,0,0,0,0,0,0,0,0,0,0
20200430,058826,台積電永豐99購02,,,,,0.00,0.00,0,0,0,0,0,0,0,0,0,0,0,0,0
20200430,058827,聯發科永豐9A購01,,,,,0.00,0.00,0,0,0,0,0,0,0,0,0,0,0,0,0
20200430,058828,大毅永豐99購01,1.21,1.50,1.15,1.20,+0.19,18.81,599000,67,787470,0,0,0,0,0,0,123000,475000,-352000,-352000
20200430,058829,華新科永豐99購04,,,,,0.00,0.00,0,0,0,0,0,0,0,0,0,0,0,0,0
20200430,05882P,華新科永豐96售01,0.11,0.11,0.11,0.11,0.00,0.00,2000,1,220,0,0,0,0,0,0,0,2000,-2000,-2000
20200430,058830,健策永豐99購02,,,,,0.00,0.00,0,0,0,0,0,0,0,0,0,0,0,0,0
20200430,058831,茂林永豐99購01,1.14,1.14,1.08,1.08,-0.02,-1.82,111000,12,121620,0,0,0,0,0,0,5000,106000,-101000,-101000
20200430,058832,立積永豐99購01,0.83,0.91,0.83,0.86,+0.09,11.69,208000,11,183600,0,0,0,0,0,0,105000,103000,2000,2000
20200430,058833,台表科永豐99購01,1.08,1.08,1.04,1.04,0.00,0.00,136000,9,142220,0,0,0,0,0,0,101000,136000,-35000,-35000
20200430,058834,GIS永豐99購01,1.00,1.02,1.00,1.02,+0.04,4.08,11000,2,11020,0,0,0,0,0,0,11000,0,11000,11000
20200430,058835,元油2X中信9C購02,0.93,0.93,0.90,0.90,+0.17,23.29,14000,2,12870,0,0,0,0,0,0,9000,5000,4000,4000
20200430,058836,FBVIX中信03購05,1.07,1.08,1.05,1.05,-0.07,-6.25,425000,24,451660,0,0,0,0,0,0,148000,238000,-90000,-90000
20200430,058837,SGBR2X中信9C購01,0.65,0.65,0.51,0.63,+0.05,8.62,131000,18,71530,0,0,0,0,0,0,0,0,0,0
20200430,058838,國巨中信99購03,1.10,1.10,1.07,1.09,+0.08,7.92,104000,6,113270,0,0,0,0,0,0,103000,0,103000,103000
20200430,058839,瑞儀中信99購02,0.82,0.87,0.81,0.87,+0.05,6.1,214000,14,178440,0,0,0,0,0,0,104000,110000,-6000,-6000
20200430,05883P,致伸永豐96售03,,,,,0.00,0.00,0,0,0,0,0,0,0,0,0,0,0,0,0
20200430,058840,T50反1群益99購02,,,,,0.00,0.00,0,0,0,0,0,0,0,0,0,0,0,0,0
20200430,058841,深中小群益01購01,0.66,0.73,0.66,0.72,+0.07,10.77,892000,12,611910,0,0,0,0,0,0,415000,477000,-62000,-62000
20200430,058842,元油2X群益9C購01,2.00,2.00,2.00,2.00,+0.50,33.33,5000,4,10000,0,0,0,0,0,0,0,0,0,0
20200430,058843,元油2X群益9C購02,1.00,1.07,1.00,1.00,+0.12,13.64,79000,12,80240,0,0,0,0,0,0,0,0,0,0
20200430,058844,元油2X群益9C購03,2.44,2.47,2.44,2.47,0.00,0.00,100000,2,245500,0,0,0,0,0,0,50000,50000,0,0
20200430,058845,元油2X群益9C購04,2.28,2.28,2.28,2.28,0.00,0.00,50000,1,114000,0,0,0,0,0,0,0,50000,-50000,-50000
20200430,058846,鴻海群益99購03,3.12,3.21,3.09,3.21,+0.18,5.94,77000,12,241760,0,0,0,0,0,0,29000,61000,-32000,-32000
20200430,058847,國巨群益99購05,2.03,2.09,1.99,2.04,+0.05,2.51,230000,16,468570,0,0,0,0,0,0,51000,225000,-174000,-174000
20200430,058848,台積電群益99購07,1.34,1.40,1.34,1.40,+0.15,12.0,131000,5,180640,0,0,0,0,0,0,23000,0,23000,23000
20200430,058849,奇力新群益99購02,1.03,1.11,1.03,1.05,+0.08,8.25,1032000,32,1096530,0,0,0,0,0,0,134000,896000,-762000,-762000
20200430,05884P,旺宏統一96售01,,,,,0.00,0.00,0,0,0,0,0,0,0,0,0,0,0,0,0
20200430,058850,華新科群益99購03,,,,,0.00,0.00,0,0,0,0,0,0,0,0,0,0,0,0,0
20200430,058851,大立光群益99購07,2.28,2.41,2.25,2.41,+0.36,17.56,74000,10,171860,0,0,0,0,0,0,11000,64000,-53000,-53000
20200430,058852,貿聯群益99購04,2.51,2.96,2.51,2.93,+0.50,20.58,456000,38,1216330,0,0,0,0,0,0,179000,249000,-70000,-70000
20200430,058853,日月光群益99購01,,,,,0.00,0.00,0,0,0,0,0,0,0,0,0,0,0,0,0
20200430,058854,樺漢群益9B購01,1.59,1.64,1.58,1.62,+0.05,3.18,483000,12,781240,0,0,0,0,0,0,307000,176000,131000,131000
20200430,058855,台積電兆豐99購02,,,,,0.00,0.00,0,0,0,0,0,0,0,0,0,0,0,0,0
20200430,058856,新光金兆豐99購01,,,,,0.00,0.00,0,0,0,0,0,0,0,0,0,0,0,0,0
20200430,058857,元油2X日盛99購02,0.40,0.40,0.29,0.37,+0.17,85.0,317000,9,96110,0,0,0,0,0,0,0,0,0,0
20200430,058858,元油2X凱基9A購07,,,,,0.00,0.00,0,0,0,0,0,0,0,0,0,0,0,0,0
20200430,058859,元油2X凱基9A購08,,,,,0.00,0.00,0,0,0,0,0,0,0,0,0,0,0,0,0
20200430,05885P,牧德統一96售01,0.79,0.79,0.79,0.79,-0.09,-10.23,10000,1,7900,0,0,0,0,0,0,0,10000,-10000,-10000
20200430,058860,SGBR2X凱基9A購01,,,,,0.00,0.00,0,0,0,0,0,0,0,0,0,0,0,0,0
20200430,058861,國巨凱基9A購08,1.72,1.78,1.72,1.73,+0.08,4.85,4000,4,6950,0,0,0,0,0,0,3000,1000,2000,2000
20200430,058862,聯發科凱基99購08,,,,,0.00,0.00,0,0,0,0,0,0,0,0,0,0,0,0,0
20200430,058863,可成凱基99購02,1.77,1.77,1.77,1.77,-0.08,-4.32,10000,1,17700,0,0,0,0,0,0,0,10000,-10000,-10000
20200430,058864,欣興凱基99購04,3.53,3.53,3.46,3.46,+0.29,9.15,37000,3,128450,0,0,0,0,0,0,37000,0,37000,37000
20200430,058865,群創凱基01購01,0.78,0.79,0.77,0.78,+0.02,2.63,315000,8,245750,0,0,0,0,0,0,0,315000,-315000,-315000
20200430,058866,元油2X國票99購04,,,,,0.00,0.00,0,0,0,0,0,0,0,0,0,0,0,0,0
20200430,058867,元油2X國票99購05,,,,,0.00,0.00,0,0,0,0,0,0,0,0,0,0,0,0,0
20200430,058868,元油2X國票99購06,,,,,0.00,0.00,0,0,0,0,0,0,0,0,0,0,0,0,0
20200430,058869,元油2X國票9A購04,,,,,0.00,0.00,0,0,0,0,0,0,0,0,0,0,0,0,0
20200430,05886P,華通元富96售01,4.19,4.21,4.15,4.15,-0.44,-9.59,11000,10,46150,0,0,0,0,0,0,9000,2000,7000,7000
20200430,058870,元油2X國票9A購05,,,,,0.00,0.00,0,0,0,0,0,0,0,0,0,0,0,0,0
20200430,058871,元油2X國票9A購06,,,,,0.00,0.00,0,0,0,0,0,0,0,0,0,0,0,0,0
20200430,058872,元油2X國票9B購01,,,,,0.00,0.00,0,0,0,0,0,0,0,0,0,0,0,0,0
20200430,058873,美律國票9A購02,1.73,1.86,1.73,1.86,+0.22,13.41,281000,12,507120,0,0,0,0,0,0,15000,266000,-251000,-251000
20200430,058874,聯鈞國票9A購01,4.60,4.60,4.60,4.60,-0.01,-0.22,1000,1,4600,0,0,0,0,0,0,1000,1000,0,0
20200430,058875,台表科國票9A購02,5.80,5.80,5.80,5.80,0.00,0.00,23000,3,133400,0,0,0,0,0,0,9000,14000,-5000,-5000
20200430,058876,南電國票9A購02,12.00,12.10,12.00,12.10,+0.10,0.83,6000,3,72300,0,0,0,0,0,0,6000,1000,5000,5000
20200430,058877,T50反1國泰9B購01,1.10,1.10,1.03,1.03,-0.12,-10.43,144000,14,152320,0,0,0,0,0,0,50000,84000,-34000,-34000
20200430,058878,旭富國泰9B購01,2.78,2.78,2.64,2.66,+0.08,3.1,181000,11,485140,0,0,0,0,0,0,160000,19000,141000,141000
20200430,058879,智邦富邦99購01,5.00,5.05,4.97,4.97,+0.08,1.64,98000,24,491820,0,0,0,0,0,0,98000,0,98000,98000
20200430,05887P,友達元富99售03,,,,,0.00,0.00,0,0,0,0,0,0,0,0,0,0,0,0,0
20200430,058880,台灣50永豐99購04,,,,,0.00,0.00,0,0,0,0,0,0,0,0,0,0,0,0,0
20200430,058881,全新永豐99購01,,,,,0.00,0.00,0,0,0,0,0,0,0,0,0,0,0,0,0
20200430,058882,晶相光永豐99購01,,,,,0.00,0.00,0,0,0,0,0,0,0,0,0,0,0,0,0
20200430,058883,旭富永豐99購01,0.87,0.87,0.81,0.83,+0.03,3.75,147000,10,121260,0,0,0,0,0,0,64000,83000,-19000,-19000
20200430,058884,世紀鋼永豐99購02,1.72,1.72,1.72,1.72,0.00,0.00,10000,1,17200,0,0,0,0,0,0,0,10000,-10000,-10000
20200430,058885,元石油元大9C購02,,,,,0.00,0.00,0,0,0,0,0,0,0,0,0,0,0,0,0
20200430,058886,元石油元大9C購03,1.50,1.51,1.50,1.51,+0.11,7.86,19000,5,28510,0,0,0,0,0,0,0,0,0,0
20200430,058887,元石油元大9C購04,1.20,1.20,1.20,1.20,0.00,0.00,3000,1,3600,0,0,0,0,0,0,0,0,0,0
20200430,058888,元油2X元大99購16,,,,,0.00,0.00,0,0,0,0,0,0,0,0,0,0,0,0,0
20200430,058889,元油2X元大9C購05,1.18,1.18,1.12,1.12,0.00,0.00,37000,5,43000,0,0,0,0,0,0,0,0,0,0
20200430,05888P,友達元大97售01,1.79,1.79,1.79,1.79,0.00,0.00,5000,1,8950,0,0,0,0,0,0,5000,0,5000,5000
20200430,058890,元油2X元大9C購06,,,,,0.00,0.00,0,0,0,0,0,0,0,0,0,0,0,0,0
20200430,058891,元油2X元大9C購07,,,,,0.00,0.00,0,0,0,0,0,0,0,0,0,0,0,0,0
20200430,058892,元油2X元大9C購08,1.17,1.17,1.09,1.16,+0.23,24.73,44000,6,49910,0,0,0,0,0,0,30000,14000,16000,16000
20200430,058893,元油2X元大9C購10,,,,,0.00,0.00,0,0,0,0,0,0,0,0,0,0,0,0,0
20200430,058894,元油2X元大9C購11,,,,,0.00,0.00,0,0,0,0,0,0,0,0,0,0,0,0,0
20200430,058895,鴻海元大99購20,3.29,3.29,3.29,3.29,+0.17,5.45,16000,2,52640,0,0,0,0,0,0,0,16000,-16000,-16000
20200430,058896,中環元大99購03,1.26,1.36,1.24,1.32,+0.09,7.32,970000,35,1273320,0,0,0,0,0,0,495000,455000,40000,40000
20200430,058897,國巨元大99購17,2.81,2.81,2.76,2.76,+0.08,2.99,16000,3,44710,0,0,0,0,0,0,6000,0,6000,6000
20200430,058898,台積電元大99購20,,,,,0.00,0.00,0,0,0,0,0,0,0,0,0,0,0,0,0
20200430,058899,旺宏元大99購10,,,,,0.00,0.00,0,0,0,0,0,0,0,0,0,0,0,0,0
20200430,05889P,群創元大98售02,2.28,2.28,2.28,2.28,-0.06,-2.56,7000,1,15960,0,0,0,0,0,0,7000,0,7000,7000
20200430,058900,旺宏元大99購11,,,,,0.00,0.00,0,0,0,0,0,0,0,0,0,0,0,0,0
20200430,058901,美律元大99購07,1.23,1.35,1.23,1.29,+0.10,8.4,289000,17,372240,0,0,0,0,0,0,77000,262000,-185000,-185000
20200430,058902,聯發科元大99購15,,,,,0.00,0.00,0,0,0,0,0,0,0,0,0,0,0,0,0
20200430,058903,聯發科元大99購16,5.00,5.00,4.89,4.96,+0.37,8.06,257000,13,1269700,0,0,0,0,0,0,257000,254000,3000,3000
20200430,058904,晶技元大99購05,,,,,0.00,0.00,0,0,0,0,0,0,0,0,0,0,0,0,0
20200430,058905,京鼎元大99購01,2.14,2.45,2.14,2.28,+0.19,9.09,468000,41,1068550,0,0,0,0,0,0,33000,438000,-405000,-405000
20200430,058906,晶相光元大99購01,0.76,0.77,0.75,0.76,-0.01,-1.3,426000,15,322500,0,0,0,0,0,0,226000,200000,26000,26000
20200430,058907,健策元大99購04,4.59,4.72,4.44,4.69,+0.28,6.35,188000,30,859460,0,0,0,0,0,0,111000,130000,-19000,-19000
20200430,058908,貿聯元大99購03,1.54,1.81,1.52,1.80,+0.33,22.45,1020000,61,1750750,0,0,0,0,0,0,109000,903000,-794000,-794000
20200430,058909,神達元大99購03,2.87,2.87,2.77,2.77,0.00,0.00,10000,2,28500,0,0,0,0,0,0,2000,8000,-6000,-6000
20200430,05890P,彩晶元大99售01,1.21,1.21,1.21,1.21,-0.03,-2.42,15000,1,18150,0,0,0,0,0,0,15000,0,15000,15000
20200430,058910,泰鼎元大99購03,1.22,1.22,1.16,1.21,+0.01,0.83,508000,24,606840,0,0,0,0,0,0,120000,376000,-256000,-256000
20200430,058911,茂林元大99購04,2.02,2.02,1.93,1.93,-0.01,-0.52,133000,8,261760,0,0,0,0,0,0,14000,119000,-105000,-105000
20200430,058912,祥碩元大99購01,3.98,4.00,3.26,3.27,-0.37,-10.16,380000,28,1409560,0,0,0,0,0,0,369000,225000,144000,144000
20200430,058913,元油2X元富01購01,0.45,0.48,0.44,0.48,0.00,0.00,1142000,19,511650,0,0,0,0,0,0,0,30000,-30000,-30000
20200430,058914,元油2X元富01購02,0.40,0.41,0.39,0.40,+0.03,8.11,771000,44,306770,0,0,0,0,0,0,0,50000,-50000,-50000
20200430,058915,SGBR2X元富99購01,3.08,3.20,3.03,3.20,+0.64,25.0,4000,4,12460,0,0,0,0,0,0,2000,0,2000,2000
20200430,058916,SGBR2X元富99購02,3.27,3.37,3.22,3.37,+0.64,23.44,241000,28,790400,0,0,0,0,0,0,15000,221000,-206000,-206000
20200430,058917,SGBR2X元富99購03,,,,,0.00,0.00,0,0,0,0,0,0,0,0,0,0,0,0,0
20200430,058918,SGBR2X元富99購04,2.78,2.92,2.70,2.92,+0.64,28.07,160000,3,463600,0,0,0,0,0,0,150000,10000,140000,140000
20200430,058919,SGBR2X元富99購05,4.01,4.01,3.35,3.52,+0.67,23.51,146000,15,501650,0,0,0,0,0,0,31000,111000,-80000,-80000
20200430,05891P,聯發科中信98售03,,,,,0.00,0.00,0,0,0,0,0,0,0,0,0,0,0,0,0
20200430,058920,SGBR2X元富99購06,3.59,4.00,3.53,3.80,+0.77,25.41,262000,44,949680,0,0,0,0,0,0,77000,145000,-68000,-68000
20200430,058921,聯發科元富03購01,3.84,4.04,3.80,4.04,0.00,0.00,71000,8,273240,0,0,0,0,0,0,0,71000,-71000,-71000
20200430,058922,聯發科元富03購02,4.13,4.34,4.10,4.34,+0.78,21.91,81000,9,335040,0,0,0,0,0,0,0,81000,-81000,-81000
20200430,058923,華新科元富99購06,3.74,3.74,3.74,3.74,+0.28,8.09,10000,1,37400,0,0,0,0,0,0,10000,0,10000,10000
20200430,058924,晶相光元富99購02,1.13,1.15,1.11,1.13,-0.05,-4.24,185000,9,210990,0,0,0,0,0,0,185000,0,185000,185000
20200430,058925,旭富元富99購02,1.42,1.42,1.42,1.42,0.00,0.00,10000,1,14200,0,0,0,0,0,0,0,10000,-10000,-10000
20200430,058926,勤誠元富99購01,1.45,1.45,1.38,1.40,-0.05,-3.45,561000,14,782870,0,0,0,0,0,0,353000,203000,150000,150000
20200430,058927,勤誠元富99購02,2.30,2.30,2.21,2.21,-0.02,-0.9,171000,8,379960,0,0,0,0,0,0,144000,27000,117000,117000
20200430,058928,國巨統一9C購01,0.78,0.80,0.77,0.80,+0.03,3.9,121000,13,95450,0,0,0,0,0,0,0,74000,-74000,-74000
20200430,058929,可成統一9C購01,1.39,1.39,1.35,1.35,-0.01,-0.74,74000,3,101380,0,0,0,0,0,0,37000,37000,0,0
20200430,05892P,大立光中信98售03,,,,,0.00,0.00,0,0,0,0,0,0,0,0,0,0,0,0,0
20200430,058930,華新科統一9B購01,1.69,1.69,1.63,1.64,-0.04,-2.38,66000,4,109430,0,0,0,0,0,0,30000,36000,-6000,-6000
20200430,058931,玉晶光統一9C購01,1.27,1.37,1.26,1.37,+0.16,13.22,1338000,32,1736200,0,0,0,0,0,0,974000,363000,611000,611000
20200430,058932,FBVIX台新99購01,1.60,1.60,0.15,0.15,-1.54,-91.12,41000,9,21940,0,0,0,0,0,0,5000,36000,-31000,-31000
20200430,058933,FBVIX台新9B購01,1.77,1.77,0.13,0.13,-1.71,-92.93,33000,6,9210,0,0,0,0,0,0,0,33000,-33000,-33000
20200430,058934,台灣50中信03購03,3.00,3.07,3.00,3.07,+0.23,8.1,35000,2,107100,0,0,0,0,0,0,5000,30000,-25000,-25000
20200430,058935,元油2X中信9C購03,,,,,0.00,0.00,0,0,0,0,0,0,0,0,0,0,0,0,0
20200430,058936,國喬中信99購01,1.19,1.32,1.19,1.29,+0.23,21.7,695000,32,888430,0,0,0,0,0,0,62000,623000,-561000,-561000
20200430,058937,仁寶中信99購01,1.54,1.54,1.51,1.51,-0.03,-1.95,65000,6,98900,0,0,0,0,0,0,50000,15000,35000,35000
20200430,058938,台積電中信01購03,1.42,1.42,1.42,1.42,+0.04,2.9,130000,1,184600,0,0,0,0,0,0,130000,130000,0,0
20200430,058939,台積電中信9B購01,,,,,0.00,0.00,0,0,0,0,0,0,0,0,0,0,0,0,0
20200430,05893P,國巨兆豐96售04,,,,,0.00,0.00,0,0,0,0,0,0,0,0,0,0,0,0,0
20200430,058940,聯發科中信9A購03,3.68,3.78,3.68,3.78,+0.59,18.5,20000,5,74990,0,0,0,0,0,0,0,20000,-20000,-20000
20200430,058941,華新科中信99購03,1.37,1.37,1.37,1.37,+0.09,7.03,4000,1,5480,0,0,0,0,0,0,0,4000,-4000,-4000
20200430,058942,南茂中信99購01,1.16,1.19,1.16,1.19,+0.08,7.21,111000,3,129150,0,0,0,0,0,0,98000,13000,85000,85000
20200430,058943,元石油群益9C購01,1.20,1.20,1.20,1.20,+0.19,18.81,20000,2,24000,0,0,0,0,0,0,0,0,0,0
20200430,058944,元石油群益9C購02,1.68,1.78,1.68,1.78,+0.27,17.88,172000,16,296090,0,0,0,0,0,0,57000,75000,-18000,-18000
20200430,058945,S&P正2群益9C購01,0.60,0.61,0.60,0.61,+0.06,10.91,12000,4,7300,0,0,0,0,0,0,12000,0,12000,12000
20200430,058946,SGBR2X群益9B購01,1.99,2.30,1.98,2.30,0.00,0.00,92000,9,188550,0,0,0,0,0,0,85000,0,85000,85000
20200430,058947,SGBR2X群益9B購02,3.71,3.90,3.64,3.90,+0.75,23.81,385000,33,1431850,0,0,0,0,0,0,46000,340000,-294000,-294000
20200430,058948,道瓊銀群益9C購01,0.93,0.95,0.93,0.95,0.00,0.00,40000,4,37500,0,0,0,0,0,0,0,40000,-40000,-40000
20200430,058949,上銀群益99購02,2.61,3.02,2.56,3.02,+0.51,20.32,337000,18,904840,0,0,0,0,0,0,135000,202000,-67000,-67000
20200430,05894P,友達群益98售02,,,,,0.00,0.00,0,0,0,0,0,0,0,0,0,0,0,0,0
20200430,058950,國巨群益99購06,4.27,4.33,4.08,4.23,+0.35,9.02,80000,18,338420,0,0,0,0,0,0,52000,37000,15000,15000
20200430,058951,南電群益99購01,3.85,3.85,3.62,3.67,-0.19,-4.92,43000,5,159880,0,0,0,0,0,0,3000,40000,-37000,-37000
20200430,058952,南茂群益99購01,1.19,1.26,1.15,1.26,+0.09,7.69,391000,11,470340,0,0,0,0,0,0,148000,243000,-95000,-95000
20200430,058953,S&P反1國票03購01,,,,,0.00,0.00,0,0,0,0,0,0,0,0,0,0,0,0,0
20200430,058954,元油2X國票9A購07,,,,,0.00,0.00,0,0,0,0,0,0,0,0,0,0,0,0,0
20200430,058955,台積電國票9A購04,6.45,6.65,6.30,6.65,+0.65,10.83,599000,27,3956800,0,0,0,0,0,0,76000,541000,-465000,-465000
20200430,058956,健策國票9A購02,4.11,4.44,4.11,4.12,+0.03,0.73,172000,16,735140,0,0,0,0,0,0,69000,103000,-34000,-34000
20200430,058957,貿聯國票9A購01,2.60,2.97,2.60,2.92,+0.45,18.22,129000,12,349130,0,0,0,0,0,0,35000,94000,-59000,-59000
20200430,058958,台表科國票9A購03,2.73,2.83,2.73,2.83,-0.01,-0.35,54000,5,150880,0,0,0,0,0,0,15000,39000,-24000,-24000
20200430,058959,南茂國票9A購01,2.62,2.62,2.62,2.62,0.00,0.00,28000,3,73360,0,0,0,0,0,0,0,28000,-28000,-28000
20200430,05895P,奇力新群益96售03,,,,,0.00,0.00,0,0,0,0,0,0,0,0,0,0,0,0,0
20200430,058960,臺股指國票99購05,5.90,6.40,5.90,6.40,+0.85,15.32,19000,3,117100,0,0,0,0,0,0,10000,9000,1000,1000
20200430,058961,台灣50兆豐9C購01,0.82,0.83,0.82,0.83,+0.18,27.69,53000,2,43490,0,0,0,0,0,0,53000,0,53000,53000
20200430,058962,元油2X兆豐9A購02,0.40,0.40,0.37,0.38,+0.04,11.76,43000,8,16740,0,0,0,0,0,0,0,0,0,0
20200430,058963,華新科兆豐99購05,1.79,1.79,1.75,1.75,-0.07,-3.85,70000,4,123120,0,0,0,0,0,0,35000,62000,-27000,-27000
20200430,058964,群創兆豐99購01,,,,,0.00,0.00,0,0,0,0,0,0,0,0,0,0,0,0,0
20200430,058965,祥碩兆豐99購02,1.78,1.78,1.44,1.44,-0.29,-16.76,105000,9,180350,0,0,0,0,0,0,95000,10000,85000,85000
20200430,058966,元油2X日盛99購03,0.79,0.82,0.67,0.82,+0.12,17.14,438000,39,329910,0,0,0,0,0,0,0,0,0,0
20200430,058967,可成麥證99購01,,,,,0.00,0.00,0,0,0,0,0,0,0,0,0,0,0,0,0
20200430,058968,T50正2永豐99購01,,,,,0.00,0.00,0,0,0,0,0,0,0,0,0,0,0,0,0
20200430,058969,亞德客永豐99購01,3.53,4.22,3.38,4.22,+0.87,25.97,144000,29,533000,0,0,0,0,0,0,83000,102000,-19000,-19000
20200430,05896P,宏達電群益96售03,,,,,0.00,0.00,0,0,0,0,0,0,0,0,0,0,0,0,0
20200430,058970,鴻海永豐99購02,1.39,1.44,1.35,1.44,+0.10,7.46,566000,11,798030,0,0,0,0,0,0,278000,288000,-10000,-10000
20200430,058971,台積電永豐99購03,,,,,0.00,0.00,0,0,0,0,0,0,0,0,0,0,0,0,0
20200430,058972,新日興永豐9A購01,1.04,1.04,1.01,1.01,-0.02,-1.94,14000,2,14530,0,0,0,0,0,0,13000,1000,12000,12000
20200430,058973,麗豐永豐99購01,1.43,1.58,1.43,1.49,+0.14,10.37,227000,31,338260,0,35000,-35000,0,0,0,148000,78000,70000,35000
20200430,058974,臺股指永豐99購03,,,,,0.00,0.00,0,0,0,0,0,0,0,0,0,0,0,0,0
20200430,058975,台灣50凱基01購02,4.27,4.28,4.27,4.28,+0.21,5.16,79000,3,338070,0,0,0,0,0,0,5000,74000,-69000,-69000
20200430,058976,元油2X凱基9A購09,,,,,0.00,0.00,0,0,0,0,0,0,0,0,0,0,0,0,0
20200430,058977,SGBR2X凱基03購01,3.57,3.75,3.50,3.75,+0.70,22.95,799000,45,2874710,0,0,0,0,0,0,316000,405000,-89000,-89000
20200430,058978,SGBR2X凱基9A購03,,,,,0.00,0.00,0,0,0,0,0,0,0,0,0,0,0,0,0
20200430,058979,上銀凱基99購04,1.27,1.56,1.27,1.56,+0.46,41.82,35000,9,50670,0,0,0,0,0,0,23000,0,23000,23000
20200430,05897P,國巨凱基96售12,,,,,0.00,0.00,0,0,0,0,0,0,0,0,0,0,0,0,0
20200430,058980,鴻海凱基99購06,7.05,7.25,6.95,7.25,+0.30,4.32,27000,6,188300,0,0,0,0,0,0,27000,27000,0,0
20200430,058981,國巨凱基99購10,1.75,1.75,1.69,1.70,+0.04,2.41,21000,4,35600,0,0,0,0,0,0,21000,0,21000,21000
20200430,058982,台積電凱基99購08,1.61,1.63,1.61,1.63,+0.16,10.88,40000,3,64800,0,0,0,0,0,0,20000,0,20000,20000
20200430,058983,旺宏凱基99購05,,,,,0.00,0.00,0,0,0,0,0,0,0,0,0,0,0,0,0
20200430,058984,全新凱基9A購03,1.08,1.09,1.08,1.08,-0.01,-0.92,87000,7,94770,0,0,0,0,0,0,37000,50000,-13000,-13000
20200430,058985,可成凱基99購03,1.55,1.55,1.55,1.55,-0.11,-6.63,10000,1,15500,0,0,0,0,0,0,0,10000,-10000,-10000
20200430,058986,華新科凱基9A購03,1.95,1.95,1.86,1.88,+0.01,0.53,15000,4,28870,0,0,0,0,0,0,10000,5000,5000,5000
20200430,058987,華新科凱基9B購01,2.76,2.76,2.76,2.76,+0.02,0.73,10000,1,27600,0,0,0,0,0,0,10000,0,10000,10000
20200430,058988,大立光凱基9A購02,1.37,1.41,1.37,1.41,0.00,0.00,40000,6,55640,0,0,0,0,0,0,3000,37000,-34000,-34000
20200430,058989,茂林凱基99購02,1.58,1.58,1.52,1.52,-0.04,-2.56,7000,2,10940,0,0,0,0,0,0,7000,0,7000,7000
20200430,05898P,旺宏凱基96售06,0.24,0.26,0.24,0.26,-0.13,-33.33,460000,4,114600,0,0,0,0,0,0,460000,0,460000,460000
20200430,058990,GIS凱基99購02,2.60,2.60,2.54,2.58,+0.03,1.18,466000,41,1196510,0,0,0,0,0,0,466000,50000,416000,416000
20200430,058991,台灣50元大03購01,,,,,0.00,0.00,0,0,0,0,0,0,0,0,0,0,0,0,0
20200430,058992,上証反元大99購02,0.58,0.58,0.58,0.58,-0.02,-3.33,5000,1,2900,0,0,0,0,0,0,5000,0,5000,5000
20200430,058993,滬深反元大9C購01,,,,,0.00,0.00,0,0,0,0,0,0,0,0,0,0,0,0,0
20200430,058994,道瓊指元大99購01,,,,,0.00,0.00,0,0,0,0,0,0,0,0,0,0,0,0,0
20200430,058995,台達電元大99購01,1.58,1.76,1.58,1.76,+0.25,16.56,245000,30,413280,0,0,0,0,0,0,46000,199000,-153000,-153000
20200430,058996,台達電元大99購02,1.50,1.70,1.50,1.68,+0.23,15.86,450000,49,728420,0,0,0,0,0,0,225000,262000,-37000,-37000
20200430,058997,鴻海元大99購21,1.45,1.49,1.45,1.49,+0.05,3.47,126000,4,183360,0,0,0,0,0,0,103000,23000,80000,80000
20200430,058998,鴻海元大99購22,3.87,3.96,3.83,3.96,+0.15,3.94,80000,6,309950,0,0,0,0,0,0,70000,40000,30000,30000
20200430,058999,台積電元大99購24,1.55,1.59,1.53,1.59,+0.11,7.43,874000,20,1371190,0,0,0,0,0,0,779000,94000,685000,685000
20200430,05899P,臺股指凱基96售30,,,,,0.00,0.00,0,0,0,0,0,0,0,0,0,0,0,0,0
20200430,059000,台積電元大99購25,3.08,3.18,3.08,3.14,+0.15,5.02,36000,5,114180,0,0,0,0,0,0,6000,30000,-24000,-24000
20200430,059001,聯發科元大99購17,7.25,7.25,7.25,7.25,+0.80,12.4,6000,2,43500,0,0,0,0,0,0,0,6000,-6000,-6000
20200430,059002,聯發科元大99購18,,,,,0.00,0.00,0,0,0,0,0,0,0,0,0,0,0,0,0
20200430,059003,中壽元大99購01,2.85,3.02,2.85,3.02,+0.23,8.24,38000,4,110820,0,0,0,0,0,0,24000,14000,10000,10000
20200430,059004,嘉晶元大99購05,1.59,1.77,1.56,1.67,+0.12,7.74,371000,19,628950,0,0,0,0,0,0,73000,298000,-225000,-225000
20200430,059005,嘉晶元大99購06,1.08,1.20,1.08,1.13,+0.07,6.6,492000,26,558360,0,0,0,0,0,0,105000,452000,-347000,-347000
20200430,059006,樺漢元大99購01,2.41,2.55,2.41,2.53,+0.18,7.66,449000,37,1116410,0,0,0,0,0,0,202000,227000,-25000,-25000
20200430,059007,南電元大99購05,7.80,7.80,7.35,7.40,-0.05,-0.67,40000,4,301950,0,0,0,0,0,0,39000,1000,38000,38000
20200430,059008,鈺齊元大99購03,1.21,1.24,1.16,1.24,+0.06,5.08,746000,29,900900,0,0,0,0,0,0,581000,171000,410000,410000
20200430,059009,世紀鋼元大99購04,3.43,3.72,3.43,3.69,+0.34,10.15,249000,25,883770,0,0,0,0,0,0,64000,223000,-159000,-159000
20200430,05900P,臺股指凱基99售05,,,,,0.00,0.00,0,0,0,0,0,0,0,0,0,0,0,0,0
20200430,059010,臺股指元大99購12,,,,,0.00,0.00,0,0,0,0,0,0,0,0,0,0,0,0,0
20200430,059011,臺股指元大9A購30,,,,,0.00,0.00,0,0,0,0,0,0,0,0,0,0,0,0,0
20200430,059012,臺股指元大9A購31,,,,,0.00,0.00,0,0,0,0,0,0,0,0,0,0,0,0,0
20200430,059013,臺股指元大9A購32,4.21,4.21,4.21,4.21,0.00,0.00,5000,1,21050,0,0,0,0,0,0,5000,0,5000,5000
20200430,059014,SGBR2X元富03購01,4.31,4.50,4.31,4.48,+0.82,22.4,53000,8,233380,0,0,0,0,0,0,16000,34000,-18000,-18000
20200430,059015,華通元富99購02,4.25,4.27,4.16,4.27,+0.06,1.43,184000,19,777360,0,0,0,0,0,0,135000,0,135000,135000
20200430,059016,晶相光元富99購03,1.42,1.46,1.35,1.35,-0.14,-9.4,238000,6,334930,0,0,0,0,0,0,217000,21000,196000,196000
20200430,059017,台灣50統一9B購03,3.94,3.94,3.94,3.94,0.00,0.00,10000,1,39400,0,0,0,0,0,0,10000,0,10000,10000
20200430,059018,滬深2X統一9A購01,,,,,0.00,0.00,0,0,0,0,0,0,0,0,0,0,0,0,0
20200430,059019,元石油統一9B購03,2.04,2.18,2.04,2.18,+0.29,15.34,860000,17,1790950,0,0,0,0,0,0,465000,395000,70000,70000
20200430,05901P,臺股指凱基9C售01,3.30,4.10,3.30,3.85,-0.30,-7.23,42000,15,154900,0,0,0,0,0,0,1000,14000,-13000,-13000
20200430,059020,元油2X統一9B購02,1.66,1.69,1.57,1.67,+0.31,22.79,94000,10,151880,0,0,0,0,0,0,65000,29000,36000,36000
20200430,059021,台積電統一9B購07,,,,,0.00,0.00,0,0,0,0,0,0,0,0,0,0,0,0,0
20200430,059022,聯發科統一9B購04,2.28,2.29,2.28,2.29,+0.30,15.08,61000,3,139100,0,0,0,0,0,0,2000,59000,-57000,-57000
20200430,059023,可成統一9B購02,1.50,1.50,1.47,1.50,-0.02,-1.32,305000,9,454480,0,0,0,0,0,0,226000,79000,147000,147000
20200430,059024,大立光統一9B購04,0.68,0.68,0.68,0.68,0.00,0.00,5000,1,3400,0,0,0,0,0,0,0,0,0,0
20200430,059025,台灣50台新9B購02,0.23,0.23,0.23,0.23,-1.52,-86.86,10000,1,2300,0,0,0,0,0,0,0,10000,-10000,-10000
20200430,059026,FBVIX台新99購03,,,,,0.00,0.00,0,0,0,0,0,0,0,0,0,0,0,0,0
20200430,059027,神達台新99購02,1.78,1.78,1.78,1.78,0.00,0.00,10000,1,17800,0,0,0,0,0,0,0,10000,-10000,-10000
20200430,059028,嘉聯益台新99購02,0.27,0.27,0.27,0.27,0.00,0.00,10000,2,2700,0,0,0,0,0,0,0,10000,-10000,-10000
20200430,059029,旺宏兆豐99購01,1.63,1.63,1.57,1.62,+0.27,20.0,32000,4,51440,0,0,0,0,0,0,30000,22000,8000,8000
20200430,05902P,華通國票96售02,4.19,4.19,4.19,4.19,0.00,0.00,1000,1,4190,0,0,0,0,0,0,0,1000,-1000,-1000
20200430,059030,奇力新兆豐99購03,1.35,1.46,1.33,1.36,+0.07,5.43,831000,32,1168840,0,0,0,0,0,0,41000,770000,-729000,-729000
20200430,059031,元石油中信03購01,1.56,1.67,1.56,1.67,+0.25,17.61,52000,9,81760,0,0,0,0,0,0,7000,42000,-35000,-35000
20200430,059032,元石油群益9C購03,0.70,0.70,0.70,0.70,0.00,0.00,8000,2,5600,0,0,0,0,0,0,0,0,0,0
20200430,059033,元油2X群益9C購05,2.21,2.26,2.21,2.26,+0.46,25.56,7000,2,15570,0,0,0,0,0,0,5000,2000,3000,3000
20200430,059034,華通群益9B購02,,,,,0.00,0.00,0,0,0,0,0,0,0,0,0,0,0,0,0
20200430,059035,旺宏群益99購06,4.53,4.53,4.40,4.51,+0.44,10.81,14000,4,62410,0,0,0,0,0,0,14000,9000,5000,5000
20200430,059036,可成群益9B購03,2.80,2.80,2.73,2.77,-0.15,-5.14,36000,5,99150,0,0,0,0,0,0,26000,10000,16000,16000
20200430,059037,宏達電群益99購02,3.30,3.30,3.30,3.30,-0.13,-3.79,1000,1,3300,0,0,0,0,0,0,1000,1000,0,0
20200430,059038,健策群益9A購02,3.06,3.22,3.06,3.17,+0.19,6.38,92000,10,285960,0,0,0,0,0,0,48000,57000,-9000,-9000
20200430,059039,致伸群益99購01,2.95,2.95,2.82,2.82,-0.20,-6.62,18000,3,52000,0,0,0,0,0,0,13000,5000,8000,8000
20200430,05903P,聯發科統一96售09,2.35,4.55,2.15,4.55,+1.76,63.08,11000,5,27280,0,0,0,0,0,0,0,10000,-10000,-10000
20200430,059040,訊芯群益99購03,1.57,1.67,1.54,1.65,+0.11,7.14,680000,24,1080600,0,0,0,0,0,0,108000,572000,-464000,-464000
20200430,059041,南茂群益99購02,2.21,2.28,2.21,2.27,+0.11,5.09,215000,11,479170,0,0,0,0,0,0,20000,195000,-175000,-175000
20200430,059042,世紀鋼群益99購02,1.46,1.57,1.46,1.57,+0.10,6.8,262000,5,394280,0,0,0,0,0,0,98000,164000,-66000,-66000
20200430,059043,聯電日盛99購01,,,,,0.00,0.00,0,0,0,0,0,0,0,0,0,0,0,0,0
20200430,059044,聯電日盛99購02,1.20,1.20,1.20,1.20,0.00,0.00,85000,4,102000,0,0,0,0,0,0,0,85000,-85000,-85000
20200430,059045,高股息凱基99購01,,,,,0.00,0.00,0,0,0,0,0,0,0,0,0,0,0,0,0
20200430,059046,滬深2X凱基9C購01,,,,,0.00,0.00,0,0,0,0,0,0,0,0,0,0,0,0,0
20200430,059047,元油2X凱基9A購10,1.62,1.64,1.52,1.63,+0.37,29.37,1421000,59,2241290,0,0,0,0,0,0,766000,497000,269000,269000
20200430,059048,元油2X凱基9A購11,1.03,1.03,1.03,1.03,0.00,0.00,100000,1,103000,0,0,0,0,0,0,100000,0,100000,100000
20200430,059049,元油2X凱基9A購12,,,,,0.00,0.00,0,0,0,0,0,0,0,0,0,0,0,0,0
20200430,05904P,大立光統一96售07,,,,,0.00,0.00,0,0,0,0,0,0,0,0,0,0,0,0,0
20200430,059050,元油2X凱基9B購08,1.69,1.69,1.60,1.69,+0.34,25.19,1087000,11,1784090,0,0,0,0,0,0,567000,620000,-53000,-53000
20200430,059051,和大凱基9A購01,0.87,1.09,0.87,1.09,+0.26,31.33,760000,36,754590,0,0,0,0,0,0,334000,376000,-42000,-42000
20200430,059052,為升凱基99購01,,,,,0.00,0.00,0,0,0,0,0,0,0,0,0,0,0,0,0
20200430,059053,鴻海凱基99購07,4.46,4.46,4.46,4.46,-0.01,-0.22,1000,1,4460,0,0,0,0,0,0,1000,1000,0,0
20200430,059054,國巨凱基99購11,2.17,2.21,2.13,2.13,+0.01,0.47,33000,5,71850,0,0,0,0,0,0,33000,33000,0,0
20200430,059055,旺宏凱基9B購02,,,,,0.00,0.00,0,0,0,0,0,0,0,0,0,0,0,0,0
20200430,059056,技嘉凱基99購02,2.45,2.46,2.45,2.46,-0.05,-1.99,2000,2,4910,0,0,0,0,0,0,2000,2000,0,0
20200430,059057,聯發科凱基99購10,,,,,0.00,0.00,0,0,0,0,0,0,0,0,0,0,0,0,0
20200430,059058,可成凱基9B購01,,,,,0.00,0.00,0,0,0,0,0,0,0,0,0,0,0,0,0
20200430,059059,宏達電凱基99購03,1.36,1.36,1.33,1.33,+0.04,3.1,30000,2,40200,0,0,0,0,0,0,20000,10000,10000,10000
20200430,05905P,晶技統一97售01,0.60,0.61,0.60,0.60,-0.03,-4.76,72000,7,43420,0,0,0,0,0,0,20000,42000,-22000,-22000
20200430,059060,大立光凱基9A購03,,,,,0.00,0.00,0,0,0,0,0,0,0,0,0,0,0,0,0
20200430,059061,晶技凱基9A購01,3.81,4.07,3.68,3.72,-0.06,-1.59,417000,34,1602590,15000,0,15000,0,0,0,265000,320000,-55000,-40000
20200430,059062,群創凱基99購05,1.27,1.28,1.26,1.28,+0.04,3.23,11000,5,13920,0,0,0,0,0,0,11000,0,11000,11000
20200430,059063,康控凱基99購04,1.50,1.62,1.50,1.62,+0.22,15.71,26000,3,40740,0,0,0,0,0,0,26000,0,26000,26000
20200430,059064,緯穎凱基99購02,1.52,1.67,1.52,1.67,+0.28,20.14,115000,5,183100,0,0,0,0,0,0,5000,110000,-105000,-105000
20200430,059065,南電凱基9A購01,3.47,3.52,3.25,3.25,-0.08,-2.4,155000,32,524060,0,0,0,0,0,0,143000,13000,130000,130000
20200430,059066,道瓊指國票04購01,,,,,0.00,0.00,0,0,0,0,0,0,0,0,0,0,0,0,0
20200430,059067,上銀國票9A購02,7.40,7.40,7.40,7.40,+1.25,20.33,3000,1,22200,0,0,0,0,0,0,3000,0,3000,3000
20200430,059068,台虹國票9A購01,2.78,2.95,2.78,2.95,+0.12,4.24,61000,3,171870,0,0,0,0,0,0,61000,0,61000,61000
20200430,059069,臺指反元大9C購01,2.02,2.04,1.96,1.96,-0.13,-6.22,146000,12,291520,0,0,0,0,0,0,61000,85000,-24000,-24000
20200430,05906P,國巨元富96售05,,,,,0.00,0.00,0,0,0,0,0,0,0,0,0,0,0,0,0
20200430,059070,道瓊指元大99購02,1.58,1.62,1.56,1.62,+0.12,8.0,62000,6,98360,0,0,0,0,0,0,14000,40000,-26000,-26000
20200430,059071,元油2X元大9C購12,,,,,0.00,0.00,0,0,0,0,0,0,0,0,0,0,0,0,0
20200430,059072,元油2X元大9C購13,1.99,1.99,1.85,1.97,+0.38,23.9,523000,47,1011160,0,0,0,0,0,0,195000,378000,-183000,-183000
20200430,059073,元油2X元大9C購14,1.95,1.95,1.84,1.87,+0.31,19.87,51000,7,94550,0,0,0,0,0,0,0,51000,-51000,-51000
20200430,059074,元油2X元大9C購15,,,,,0.00,0.00,0,0,0,0,0,0,0,0,0,0,0,0,0
20200430,059075,FBVIX元大99購01,2.04,2.04,1.97,1.97,-0.17,-7.94,50000,7,100100,0,0,0,0,0,0,0,50000,-50000,-50000
20200430,059076,FBVIX元大99購04,1.87,1.88,1.87,1.88,-0.12,-6.0,77000,4,144560,0,0,0,0,0,0,70000,7000,63000,63000
20200430,059077,FBVIX元大99購05,1.96,1.96,1.96,1.96,0.00,0.00,3000,1,5880,0,0,0,0,0,0,0,3000,-3000,-3000
20200430,059078,FBVIX元大99購06,1.97,1.98,1.97,1.97,-0.13,-6.19,41000,4,80950,0,0,0,0,0,0,20000,21000,-1000,-1000
20200430,059079,SGBR2X元大99購01,,,,,0.00,0.00,0,0,0,0,0,0,0,0,0,0,0,0,0
20200430,05907P,聯發科元富96售05,,,,,0.00,0.00,0,0,0,0,0,0,0,0,0,0,0,0,0
20200430,059080,亞泥元大99購01,2.39,2.68,2.38,2.67,+0.29,12.18,583000,53,1459130,0,0,0,0,0,0,207000,384000,-177000,-177000
20200430,059081,和大元大99購01,0.87,1.00,0.87,1.00,0.00,0.00,35000,5,33450,0,0,0,0,0,0,13000,0,13000,13000
20200430,059082,華通元大99購06,1.12,1.19,1.12,1.19,0.00,0.00,15000,2,17150,0,0,0,0,0,0,10000,5000,5000,5000
20200430,059083,華通元大99購07,1.12,1.25,1.11,1.25,+0.18,16.82,141000,12,169190,0,0,0,0,0,0,125000,22000,103000,103000
20200430,059084,鴻海元大99購24,,,,,0.00,0.00,0,0,0,0,0,0,0,0,0,0,0,0,0
20200430,059085,鴻海元大99購25,4.38,4.53,4.30,4.53,+0.27,6.34,82000,12,357810,0,0,0,0,0,0,67000,68000,-1000,-1000
20200430,059086,國巨元大99購18,1.15,1.17,1.12,1.15,+0.03,2.68,407000,20,466600,0,0,0,0,0,0,269000,79000,190000,190000
20200430,059087,台積電元大99購26,4.97,4.97,4.97,4.97,+0.04,0.81,6000,1,29820,0,0,0,0,0,0,6000,0,6000,6000
20200430,059088,台積電元大99購27,4.80,4.80,4.80,4.80,+0.18,3.9,6000,1,28800,0,0,0,0,0,0,6000,0,6000,6000
20200430,059089,聯發科元大99購19,3.13,3.15,3.13,3.15,+0.41,14.96,36000,3,113000,0,0,0,0,0,0,36000,31000,5000,5000
20200430,05908P,大立光元富96售05,,,,,0.00,0.00,0,0,0,0,0,0,0,0,0,0,0,0,0
20200430,059090,台新金元大99購01,1.19,1.26,1.19,1.26,+0.14,12.5,373000,12,454960,0,0,0,0,0,0,38000,335000,-297000,-297000
20200430,059091,中信金元大99購01,0.90,0.90,0.90,0.90,+0.02,2.27,1000,1,900,0,0,0,0,0,0,0,0,0,0
20200430,059092,聯陽元大99購01,,,,,0.00,0.00,0,0,0,0,0,0,0,0,0,0,0,0,0
20200430,059093,旭富元大99購01,,,,,0.00,0.00,0,0,0,0,0,0,0,0,0,0,0,0,0
20200430,059094,臻鼎元大99購03,,,,,0.00,0.00,0,0,0,0,0,0,0,0,0,0,0,0,0
20200430,059095,訊芯元大99購01,1.25,1.35,1.22,1.31,+0.08,6.5,1240000,65,1580530,0,0,0,0,0,0,611000,787000,-176000,-176000
20200430,059096,百和元大99購04,2.38,2.38,2.20,2.28,-0.10,-4.2,265000,30,603660,0,0,0,0,0,0,232000,28000,204000,204000
20200430,059097,世紀鋼元大99購05,1.05,1.12,1.05,1.09,+0.07,6.86,239000,6,257160,0,0,0,0,0,0,80000,159000,-79000,-79000
20200430,059098,元油2X統一9B購03,0.60,0.73,0.60,0.73,+0.22,43.14,63000,23,43630,0,0,0,0,0,0,0,0,0,0
20200430,059099,元油2X統一9C購01,1.38,1.40,1.38,1.40,0.00,0.00,35000,2,48800,0,0,0,0,0,0,10000,25000,-15000,-15000
20200430,05909P,康友元富96售02,,,,,0.00,0.00,0,0,0,0,0,0,0,0,0,0,0,0,0
20200430,059100,元油2X統一9C購02,0.88,0.94,0.87,0.93,+0.17,22.37,3028000,91,2774500,0,0,0,0,0,0,816000,1944000,-1128000,-1128000
20200430,059101,康控統一9A購01,0.95,0.98,0.91,0.97,0.00,0.00,877000,25,845860,0,0,0,0,0,0,0,877000,-877000,-877000
20200430,059102,聯鈞元富99購01,,,,,0.00,0.00,0,0,0,0,0,0,0,0,0,0,0,0,0
20200430,059103,旭富元富99購03,2.62,2.62,2.50,2.50,+0.09,3.73,150000,13,384300,0,0,0,0,0,0,100000,50000,50000,50000
20200430,059104,臺股指元富99購05,,,,,0.00,0.00,0,0,0,0,0,0,0,0,0,0,0,0,0
20200430,059105,臺股指元富99購06,,,,,0.00,0.00,0,0,0,0,0,0,0,0,0,0,0,0,0
20200430,059106,臺股指元富99購07,,,,,0.00,0.00,0,0,0,0,0,0,0,0,0,0,0,0,0
20200430,059107,南茂國泰9A購01,1.88,1.94,1.83,1.94,+0.11,6.01,424000,12,798480,0,0,0,0,0,0,179000,245000,-66000,-66000
20200430,059108,台灣50富邦9B購01,,,,,0.00,0.00,0,0,0,0,0,0,0,0,0,0,0,0,0
20200430,059109,台積電富邦9C購03,1.30,1.32,1.30,1.32,+0.07,5.6,154000,6,202170,0,0,0,0,0,0,2000,152000,-150000,-150000
20200430,05910P,力山永豐96售02,0.74,0.86,0.70,0.86,-0.03,-3.37,408000,25,313590,0,0,0,0,0,0,140000,268000,-128000,-128000
20200430,059110,元油2X永豐99購02,,,,,0.00,0.00,0,0,0,0,0,0,0,0,0,0,0,0,0
20200430,059111,元油2X永豐99購03,,,,,0.00,0.00,0,0,0,0,0,0,0,0,0,0,0,0,0
20200430,059112,上銀永豐99購01,1.11,1.34,1.11,1.34,+0.44,48.89,2000,2,2450,0,0,0,0,0,0,2000,0,2000,2000
20200430,059113,群光永豐99購01,2.64,2.70,2.62,2.70,-0.03,-1.1,83000,5,218000,0,0,0,0,0,0,77000,6000,71000,71000
20200430,059114,華新科永豐99購05,1.34,1.41,1.34,1.41,0.00,0.00,16000,3,21810,0,0,0,0,0,0,0,6000,-6000,-6000
20200430,059115,美食永豐99購01,2.24,2.73,2.21,2.70,+0.53,24.42,456000,32,1132420,0,0,0,0,0,0,339000,117000,222000,222000
20200430,059116,晶豪科永豐99購01,3.17,3.20,3.00,3.00,-0.18,-5.66,222000,11,698180,0,0,0,0,0,0,181000,41000,140000,140000
20200430,059117,禾伸堂永豐99購01,2.90,2.90,2.70,2.70,0.00,0.00,70000,7,191580,0,0,0,0,0,0,60000,10000,50000,50000
20200430,059118,晶技永豐9A購01,4.52,4.72,4.52,4.70,+0.18,3.98,16000,4,73620,0,0,0,0,0,0,8000,8000,0,0
20200430,059119,華擎永豐99購02,2.26,2.26,2.15,2.15,+0.01,0.47,25000,3,55150,0,0,0,0,0,0,10000,15000,-5000,-5000
20200430,05911P,南亞科永豐96售03,,,,,0.00,0.00,0,0,0,0,0,0,0,0,0,0,0,0,0
20200430,059120,致伸永豐99購01,3.03,3.09,3.03,3.09,-0.10,-3.13,64000,2,194520,0,0,0,0,0,0,64000,0,64000,64000
20200430,059121,瑞儀永豐99購01,2.46,2.49,2.44,2.49,+0.04,1.63,264000,7,653400,0,0,0,0,0,0,169000,95000,74000,74000
20200430,059122,超眾永豐99購01,,,,,0.00,0.00,0,0,0,0,0,0,0,0,0,0,0,0,0
20200430,059123,訊芯永豐99購03,1.19,1.28,1.16,1.24,+0.07,5.98,658000,27,787110,0,0,0,0,0,0,323000,335000,-12000,-12000
20200430,059124,台積電第一03購01,,,,,0.00,0.00,0,0,0,0,0,0,0,0,0,0,0,0,0
20200430,059125,台積電第一03購02,1.39,1.39,1.39,1.39,+0.05,3.73,9000,2,12510,0,0,0,0,0,0,0,0,0,0
20200430,059126,臺指反中信9B購01,1.80,1.80,1.73,1.73,-0.13,-6.99,20000,3,35500,0,0,0,0,0,0,0,20000,-20000,-20000
20200430,059127,國巨中信99購04,0.99,0.99,0.95,0.98,+0.05,5.38,206000,16,200670,0,0,0,0,0,0,34000,172000,-138000,-138000
20200430,059128,友達中信99購02,1.00,1.02,0.98,1.01,+0.04,4.12,772000,30,776740,0,50000,-50000,0,0,0,178000,594000,-416000,-466000
20200430,059129,麗豐中信99購01,1.90,2.00,1.87,1.87,+0.10,5.65,85000,13,165010,0,0,0,0,0,0,25000,60000,-35000,-35000
20200430,05912P,和大元大96售01,2.66,2.69,2.34,2.36,-0.89,-27.38,31000,7,75290,0,0,0,0,0,0,24000,2000,22000,22000
20200430,059130,台灣50群益9B購05,,,,,0.00,0.00,0,0,0,0,0,0,0,0,0,0,0,0,0
20200430,059131,國巨群益99購07,3.82,3.90,3.82,3.90,+0.17,4.56,15000,4,58030,0,0,0,0,0,0,13000,15000,-2000,-2000
20200430,059132,臺股指群益99購07,,,,,0.00,0.00,0,0,0,0,0,0,0,0,0,0,0,0,0
20200430,059133,臺股指群益99購08,5.00,5.15,4.99,5.15,+0.34,7.07,7000,4,35540,0,0,0,0,0,0,6000,1000,5000,5000
20200430,059134,臺股指群益99購09,5.85,6.15,5.85,6.15,+0.60,10.81,11000,2,64650,0,0,0,0,0,0,11000,0,11000,11000
20200430,059135,臺股指群益99購10,6.00,6.40,6.00,6.40,+0.60,10.34,60000,2,364000,0,0,0,0,0,0,50000,10000,40000,40000
20200430,059136,臺股指群益99購11,,,,,0.00,0.00,0,0,0,0,0,0,0,0,0,0,0,0,0
20200430,059137,電子類群益99購01,2.44,2.45,2.44,2.45,+0.07,2.94,23000,2,56190,0,0,0,0,0,0,23000,0,23000,23000
20200430,059138,台積電兆豐99購04,1.85,1.90,1.85,1.90,0.00,0.00,417000,4,792050,0,0,0,0,0,0,417000,412000,5000,5000
20200430,059139,全新兆豐9A購01,1.70,1.70,1.64,1.66,+0.03,1.84,58000,9,96750,0,0,0,0,0,0,48000,10000,38000,38000
20200430,05913P,國巨元大96售11,,,,,0.00,0.00,0,0,0,0,0,0,0,0,0,0,0,0,0
20200430,059140,大立光兆豐9A購02,1.44,1.48,1.44,1.48,+0.35,30.97,8000,4,11760,0,0,0,0,0,0,0,8000,-8000,-8000
20200430,059141,臺股指兆豐99購01,,,,,0.00,0.00,0,0,0,0,0,0,0,0,0,0,0,0,0
20200430,059142,道瓊指國票9B購02,2.07,2.10,2.07,2.10,+0.10,5.0,6000,3,12540,0,0,0,0,0,0,0,6000,-6000,-6000
20200430,059143,國巨國票9A購04,8.80,9.00,8.45,8.75,+0.55,6.71,121000,31,1061900,0,0,0,0,0,0,74000,58000,16000,16000
20200430,059144,嘉晶國票9A購02,2.87,3.14,2.87,3.14,+0.35,12.54,21000,5,63820,0,0,0,0,0,0,0,20000,-20000,-20000
20200430,059145,創意國票99購02,23.40,24.10,23.20,24.10,+1.50,6.64,12000,8,282900,0,0,0,0,0,0,9000,7000,2000,2000
20200430,059146,貿聯國票9A購02,3.52,4.15,3.52,4.15,+0.85,25.76,97000,10,374620,0,0,0,0,0,0,59000,36000,23000,23000
20200430,059147,矽創國票99購01,5.70,6.10,5.70,6.10,+0.60,10.91,67000,7,397100,0,0,0,0,0,0,16000,51000,-35000,-35000
20200430,059148,百和國票9A購01,7.10,7.15,6.85,6.85,-0.10,-1.44,30000,8,212800,0,0,0,0,0,0,27000,3000,24000,24000
20200430,059149,臺股指國票99購12,6.05,6.45,6.05,6.45,+0.75,13.16,6000,2,38300,0,0,0,0,0,0,6000,0,6000,6000
20200430,05914P,友達元大96售04,,,,,0.00,0.00,0,0,0,0,0,0,0,0,0,0,0,0,0
20200430,059150,臺股指國票99購13,,,,,0.00,0.00,0,0,0,0,0,0,0,0,0,0,0,0,0
20200430,059151,臺股指國票99購14,4.59,4.97,4.58,4.97,+0.61,13.99,193000,17,905870,0,0,0,0,0,0,188000,5000,183000,183000
20200430,059152,臺股指國票99購15,,,,,0.00,0.00,0,0,0,0,0,0,0,0,0,0,0,0,0
20200430,059153,臺股指國票99購16,3.62,3.95,3.59,3.92,+0.51,14.96,458000,43,1728810,0,0,0,0,0,0,171000,286000,-115000,-115000
20200430,059154,可成日盛99購02,2.16,2.16,2.16,2.16,-0.05,-2.26,10000,1,21600,0,0,0,0,0,0,0,10000,-10000,-10000
20200430,059155,台表科日盛99購01,1.52,1.52,1.43,1.50,+0.03,2.04,409000,27,610360,0,0,0,0,0,0,243000,166000,77000,77000
20200430,059156,台灣50凱基01購03,,,,,0.00,0.00,0,0,0,0,0,0,0,0,0,0,0,0,0
20200430,059157,元石油凱基9C購01,1.28,1.30,1.28,1.30,+0.24,22.64,60000,2,77800,0,0,0,0,0,0,0,60000,-60000,-60000
20200430,059158,S&P正2凱基99購01,,,,,0.00,0.00,0,0,0,0,0,0,0,0,0,0,0,0,0
20200430,059159,上銀凱基99購05,2.56,2.89,2.55,2.89,+0.45,18.44,191000,21,524860,0,0,0,0,0,0,39000,152000,-113000,-113000
20200430,05915P,聯發科元大96售19,3.38,3.38,3.19,3.19,-0.51,-13.78,53000,5,172020,0,0,0,0,0,0,23000,30000,-7000,-7000
20200430,059160,華通凱基99購03,2.21,2.46,2.20,2.44,+0.30,14.02,318000,18,724880,0,0,0,0,0,0,118000,111000,7000,7000
20200430,059161,鴻海凱基9A購09,5.10,5.10,5.10,5.10,0.00,0.00,3000,1,15300,0,0,0,0,0,0,0,3000,-3000,-3000
20200430,059162,國巨凱基99購12,4.61,4.70,4.54,4.54,+0.15,3.42,34000,5,157570,0,0,0,0,0,0,24000,14000,10000,10000
20200430,059163,台積電凱基99購10,,,,,0.00,0.00,0,0,0,0,0,0,0,0,0,0,0,0,0
20200430,059164,旺宏凱基99購06,6.05,6.05,6.05,6.05,0.00,0.00,1000,1,6050,0,0,0,0,0,0,1000,0,1000,1000
20200430,059165,南亞科凱基99購04,5.20,5.20,5.00,5.10,+0.18,3.66,8000,3,40700,0,0,0,0,0,0,7000,1000,6000,6000
20200430,059166,友達凱基99購05,1.34,1.37,1.34,1.37,+0.04,3.01,195000,5,264510,0,0,0,0,0,0,10000,185000,-175000,-175000
20200430,059167,聯發科凱基99購11,11.10,11.10,11.10,11.10,+1.75,18.72,23000,2,255300,0,0,0,0,0,0,20000,3000,17000,17000
20200430,059168,奇力新凱基99購05,1.32,1.42,1.32,1.33,+0.05,3.91,87000,10,117190,0,0,0,0,0,0,70000,26000,44000,44000
20200430,059169,可成凱基99購04,2.99,2.99,2.94,2.94,-0.12,-3.92,11000,2,32390,0,0,0,0,0,0,1000,11000,-10000,-10000
20200430,05916P,聯發科元大96售20,,,,,0.00,0.00,0,0,0,0,0,0,0,0,0,0,0,0,0
20200430,059170,康控凱基9B購01,1.18,1.31,1.18,1.31,+0.23,21.3,62000,11,78340,0,0,0,0,0,0,62000,30000,32000,32000
20200430,059171,祥碩凱基99購04,2.52,2.52,2.07,2.12,-0.16,-7.02,105000,10,255370,0,0,0,0,0,0,95000,10000,85000,85000
20200430,059172,台郡凱基99購03,2.30,2.33,2.30,2.33,+0.07,3.1,15000,2,34650,0,0,0,0,0,0,5000,10000,-5000,-5000
20200430,059173,矽力凱基99購01,2.78,2.78,2.46,2.54,-0.22,-7.97,359000,43,909940,0,0,0,0,0,0,31000,328000,-297000,-297000
20200430,059174,訊芯凱基99購01,2.20,2.38,2.18,2.27,+0.11,5.09,167000,19,379970,0,0,0,0,0,0,40000,155000,-115000,-115000
20200430,059175,臺股指凱基99購26,,,,,0.00,0.00,0,0,0,0,0,0,0,0,0,0,0,0,0
20200430,059176,臺股指凱基99購27,2.67,3.00,2.61,3.00,+0.57,23.46,791000,26,2146850,0,0,0,0,0,0,25000,766000,-741000,-741000
20200430,059177,臺股指凱基99購28,2.25,2.47,2.21,2.47,+0.41,19.9,42000,7,95570,0,0,0,0,0,0,38000,4000,34000,34000
20200430,059178,臺股指凱基99購30,2.93,2.93,2.93,2.93,0.00,0.00,50000,1,146500,0,0,0,0,0,0,50000,0,50000,50000
20200430,059179,祥碩元富99購01,3.11,3.11,2.49,2.63,-0.34,-11.45,348000,43,1004530,0,0,0,0,0,0,231000,178000,53000,53000
20200430,05917P,宏達電元大96售02,,,,,0.00,0.00,0,0,0,0,0,0,0,0,0,0,0,0,0
20200430,059180,祥碩元富9A購01,2.36,2.36,1.93,2.02,-0.18,-8.18,548000,69,1192900,0,0,0,0,0,0,397000,247000,150000,150000
20200430,059181,世紀鋼元富9C購01,2.04,2.15,2.04,2.11,+0.11,5.5,358000,17,752440,0,0,0,0,0,0,0,358000,-358000,-358000
20200430,059182,台灣50台新9B購03,,,,,0.00,0.00,0,0,0,0,0,0,0,0,0,0,0,0,0
20200430,059183,T50反1台新03購02,0.55,0.80,0.44,0.44,-0.13,-22.81,404000,45,206940,0,0,0,0,0,0,0,366000,-366000,-366000
20200430,059184,晶技台新99購01,,,,,0.00,0.00,0,0,0,0,0,0,0,0,0,0,0,0,0
20200430,059185,臺股指台新99購12,0.55,0.55,0.55,0.55,-6.65,-92.36,30000,6,16500,0,0,0,0,0,0,0,30000,-30000,-30000
20200430,059186,華通富邦9A購01,,,,,0.00,0.00,0,0,0,0,0,0,0,0,0,0,0,0,0
20200430,059187,國巨富邦9B購02,1.63,1.65,1.63,1.65,0.00,0.00,55000,2,90650,0,0,0,0,0,0,5000,50000,-45000,-45000
20200430,059188,京元電富邦9B購01,1.54,1.54,1.52,1.52,+0.02,1.33,246000,15,376360,0,0,0,0,0,0,165000,229000,-64000,-64000
20200430,059189,國泰金富邦9B購01,2.55,2.67,2.48,2.67,+0.41,18.14,579000,36,1468570,0,0,0,0,0,0,216000,363000,-147000,-147000
20200430,05918P,大立光元大96售11,,,,,0.00,0.00,0,0,0,0,0,0,0,0,0,0,0,0,0
20200430,059190,欣興富邦9A購01,2.21,2.21,2.12,2.18,+0.47,27.49,205000,21,446100,0,0,0,0,0,0,0,205000,-205000,-205000
20200430,059191,茂林富邦9B購01,1.13,1.13,1.13,1.13,0.00,0.00,1000,1,1130,0,0,0,0,0,0,1000,0,1000,1000
20200430,059192,臺股指富邦9C購01,3.84,3.84,3.84,3.84,0.00,0.00,4000,1,15360,0,0,0,0,0,0,4000,0,4000,4000
20200430,059193,台灣50永豐99購05,,,,,0.00,0.00,0,0,0,0,0,0,0,0,0,0,0,0,0
20200430,059194,元金2X永豐99購01,1.81,1.81,1.79,1.79,-0.05,-2.72,250000,12,449840,0,0,0,0,0,0,73000,175000,-102000,-102000
20200430,059195,國巨永豐99購04,,,,,0.00,0.00,0,0,0,0,0,0,0,0,0,0,0,0,0
20200430,059196,聯發科永豐99購02,2.70,2.94,2.70,2.94,+0.49,20.0,175000,13,490420,0,0,0,0,0,0,86000,89000,-3000,-3000
20200430,059197,可成永豐99購02,3.12,3.12,3.10,3.10,-0.19,-5.78,5000,2,15540,0,0,0,0,0,0,0,5000,-5000,-5000
20200430,059198,華新科永豐99購06,2.05,2.05,2.05,2.05,-0.09,-4.21,1000,1,2050,0,0,0,0,0,0,1000,0,1000,1000
20200430,059199,欣興永豐99購02,5.35,5.45,5.30,5.40,0.00,0.00,33000,9,177700,0,0,0,0,0,0,20000,17000,3000,3000
20200430,05919P,京鼎元大96售03,1.64,1.66,1.50,1.50,-0.26,-14.77,249000,17,396300,0,0,0,0,0,0,129000,197000,-68000,-68000
20200430,059200,京鼎永豐99購02,1.91,2.13,1.88,2.13,+0.30,16.39,258000,27,513000,0,0,0,0,0,0,67000,189000,-122000,-122000
20200430,059201,祥碩永豐99購02,2.10,2.10,1.72,1.76,-0.17,-8.81,511000,15,975620,0,0,0,0,0,0,283000,228000,55000,55000
20200430,059202,禾聯碩永豐99購01,1.08,1.11,1.08,1.11,0.00,0.00,24000,4,26410,0,0,0,0,0,0,4000,20000,-16000,-16000
20200430,059203,勤誠永豐99購02,2.28,2.28,2.26,2.26,-0.01,-0.44,218000,3,492960,0,0,0,0,0,0,218000,18000,200000,200000
20200430,059204,台灣50元大01購02,,,,,0.00,0.00,0,0,0,0,0,0,0,0,0,0,0,0,0
20200430,059205,元石油元大99購01,1.57,1.59,1.57,1.59,+0.22,16.06,119000,3,188190,0,0,0,0,0,0,0,119000,-119000,-119000
20200430,059206,元石油元大99購02,,,,,0.00,0.00,0,0,0,0,0,0,0,0,0,0,0,0,0
20200430,059207,臺指反元大9C購02,1.52,1.52,1.50,1.50,0.00,0.00,30000,3,45400,0,0,0,0,0,0,0,30000,-30000,-30000
20200430,059208,SGBR2X元大99購02,1.01,1.50,1.01,1.50,+0.57,61.29,176000,35,220800,0,0,0,0,0,0,1000,0,1000,1000
20200430,059209,華通元大99購08,1.66,1.68,1.65,1.68,+0.21,14.29,93000,4,155730,0,0,0,0,0,0,0,93000,-93000,-93000
20200430,05920P,力成元大96售04,0.97,0.98,0.83,0.85,-0.18,-17.48,330000,10,295320,0,0,0,0,0,0,227000,103000,124000,124000
20200430,059210,鴻海元大99購26,,,,,0.00,0.00,0,0,0,0,0,0,0,0,0,0,0,0,0
20200430,059211,鴻海元大99購27,4.22,4.31,4.15,4.31,+0.16,3.86,91000,13,387240,0,0,0,0,0,0,79000,84000,-5000,-5000
20200430,059212,鴻海元大99購28,4.42,4.51,4.35,4.51,+0.23,5.37,75000,11,336130,0,0,0,0,0,0,70000,61000,9000,9000
20200430,059213,國巨元大99購19,4.50,4.62,4.41,4.52,+0.25,5.85,106000,13,477630,0,0,0,0,0,0,30000,78000,-48000,-48000
20200430,059214,國巨元大99購20,4.98,4.98,4.95,4.95,+0.14,2.91,28000,4,139410,0,0,0,0,0,0,28000,2000,26000,26000
20200430,059215,台積電元大99購28,2.07,2.15,2.07,2.15,+0.14,6.97,326000,17,685620,0,0,0,0,0,0,176000,150000,26000,26000
20200430,059216,台積電元大99購29,4.92,4.99,4.92,4.99,0.00,0.00,18000,2,88630,0,0,0,0,0,0,1000,17000,-16000,-16000
20200430,059217,台積電元大99購30,,,,,0.00,0.00,0,0,0,0,0,0,0,0,0,0,0,0,0
20200430,059218,台積電元大99購31,1.71,1.71,1.60,1.60,+0.03,1.91,3000,2,4910,0,0,0,0,0,0,2000,0,2000,2000
20200430,059219,旺宏元大99購12,2.36,2.36,2.25,2.25,+0.13,6.13,173000,19,395100,0,0,0,0,0,0,154000,28000,126000,126000
20200430,05921P,同欣電元大96售06,1.50,1.50,1.36,1.36,-0.16,-10.53,30000,8,43720,0,0,0,0,0,0,15000,15000,0,0
20200430,059220,聯發科元大99購20,5.70,5.80,5.60,5.80,+0.65,12.62,109000,10,611500,0,0,0,0,0,0,109000,105000,4000,4000
20200430,059221,聯發科元大99購21,6.20,6.25,6.10,6.25,+0.55,9.65,119000,7,737750,0,0,0,0,0,0,119000,119000,0,0
20200430,059222,聯發科元大99購22,6.00,6.30,5.95,6.25,+0.75,13.64,597000,23,3679200,0,0,0,0,0,0,597000,597000,0,0
20200430,059223,大立光元大99購14,3.82,4.18,3.80,4.18,+0.52,14.21,175000,32,692600,0,0,0,0,0,0,64000,110000,-46000,-46000
20200430,059224,大立光元大99購15,3.47,3.78,3.47,3.76,+0.38,11.24,143000,32,517350,0,0,0,0,0,0,74000,64000,10000,10000
20200430,059225,臺股指元大99購18,,,,,0.00,0.00,0,0,0,0,0,0,0,0,0,0,0,0,0
20200430,059226,臺股指元大99購19,,,,,0.00,0.00,0,0,0,0,0,0,0,0,0,0,0,0,0
20200430,059227,臺股指元大99購20,,,,,0.00,0.00,0,0,0,0,0,0,0,0,0,0,0,0,0
20200430,059228,臺股指元大99購21,,,,,0.00,0.00,0,0,0,0,0,0,0,0,0,0,0,0,0
20200430,059229,臺股指元大99購22,4.95,5.05,4.94,5.05,+0.24,4.99,175000,4,871750,0,0,0,0,0,0,80000,95000,-15000,-15000
20200430,05922P,京元電兆豐96售01,,,,,0.00,0.00,0,0,0,0,0,0,0,0,0,0,0,0,0
20200430,059230,滬深2X國票9B購02,,,,,0.00,0.00,0,0,0,0,0,0,0,0,0,0,0,0,0
20200430,059231,華通國票9A購04,7.75,8.65,7.75,8.65,+1.25,16.89,27000,5,225150,0,0,0,0,0,0,0,27000,-27000,-27000
20200430,059232,台灣50凱基03購01,,,,,0.00,0.00,0,0,0,0,0,0,0,0,0,0,0,0,0
20200430,059233,台灣50凱基9C購02,,,,,0.00,0.00,0,0,0,0,0,0,0,0,0,0,0,0,0
20200430,059234,台灣50凱基9C購03,6.30,6.40,6.30,6.40,+0.50,8.47,10000,2,63500,0,0,0,0,0,0,10000,0,10000,10000
20200430,059235,鴻海凱基99購08,2.96,3.04,2.96,3.04,+0.08,2.7,125000,4,370480,0,0,0,0,0,0,119000,6000,113000,113000
20200430,059236,鴻海凱基99購09,2.27,2.34,2.27,2.33,+0.12,5.43,71000,13,164380,0,0,0,0,0,0,31000,58000,-27000,-27000
20200430,059237,鴻海凱基9A購10,,,,,0.00,0.00,0,0,0,0,0,0,0,0,0,0,0,0,0
20200430,059238,台積電凱基99購11,3.37,3.37,3.37,3.37,+0.05,1.51,10000,1,33700,0,0,0,0,0,0,10000,0,10000,10000
20200430,059239,台積電凱基99購12,2.41,2.50,2.41,2.50,+0.13,5.49,20000,6,49430,0,0,0,0,0,0,5000,0,5000,5000
20200430,05923P,旺宏元富96售05,0.98,1.00,0.98,1.00,0.00,0.00,17000,3,16800,0,0,0,0,0,0,0,17000,-17000,-17000
20200430,059240,台積電凱基9A購09,9.65,9.80,9.55,9.80,+0.50,5.38,86000,12,834550,0,0,0,0,0,0,56000,40000,16000,16000
20200430,059241,旺宏凱基99購07,3.70,3.70,3.62,3.62,+0.26,7.74,23000,6,84590,0,0,0,0,0,0,13000,22000,-9000,-9000
20200430,059242,南亞科凱基99購06,1.81,1.81,1.81,1.81,+0.07,4.02,3000,2,5430,0,0,0,0,0,0,0,3000,-3000,-3000
20200430,059243,聯發科凱基99購12,,,,,0.00,0.00,0,0,0,0,0,0,0,0,0,0,0,0,0
20200430,059244,聯發科凱基99購13,2.97,2.97,2.97,2.97,+0.26,9.59,30000,1,89100,0,0,0,0,0,0,30000,0,30000,30000
20200430,059245,聯發科凱基9A購03,9.35,9.35,9.30,9.30,+1.50,19.23,3000,2,27950,0,0,0,0,0,0,0,1000,-1000,-1000
20200430,059246,奇力新凱基9A購02,2.07,2.07,2.02,2.02,+0.02,1.0,16000,2,32620,0,0,0,0,0,0,10000,6000,4000,4000
20200430,059247,可成凱基99購05,3.59,3.59,3.59,3.59,0.00,0.00,10000,1,35900,0,0,0,0,0,0,0,10000,-10000,-10000
20200430,059248,華新科凱基99購04,,,,,0.00,0.00,0,0,0,0,0,0,0,0,0,0,0,0,0
20200430,059249,大立光凱基99購05,2.24,2.41,2.24,2.41,+0.23,10.55,174000,8,409910,0,0,0,0,0,0,170000,4000,166000,166000
20200430,05924P,超眾元富96售04,,,,,0.00,0.00,0,0,0,0,0,0,0,0,0,0,0,0,0
20200430,059250,大立光凱基99購06,1.88,1.97,1.87,1.97,+0.15,8.24,91000,5,173340,0,0,0,0,0,0,70000,21000,49000,49000
20200430,059251,大立光凱基9A購04,,,,,0.00,0.00,0,0,0,0,0,0,0,0,0,0,0,0,0
20200430,059252,聯詠凱基99購03,1.96,1.98,1.96,1.98,+0.08,4.21,30000,10,59320,0,0,0,0,0,0,30000,0,30000,30000
20200430,059253,康控凱基9B購02,2.07,2.21,2.07,2.21,+0.39,21.43,76000,11,160770,0,0,0,0,0,0,76000,60000,16000,16000
20200430,059254,台表科凱基9A購02,1.86,1.91,1.86,1.91,+0.01,0.53,16000,6,30390,0,0,0,0,0,0,2000,14000,-12000,-12000
20200430,059255,臺股指凱基99購33,2.44,2.60,2.44,2.59,+0.27,11.64,34000,7,86630,0,0,0,0,0,0,24000,10000,14000,14000
20200430,059256,臺股指凱基99購34,2.62,2.84,2.62,2.84,+0.35,14.06,514000,9,1370320,0,0,0,0,0,0,512000,2000,510000,510000
20200430,059257,臺股指凱基99購35,3.93,3.93,3.93,3.93,+0.26,7.08,5000,1,19650,0,0,0,0,0,0,5000,0,5000,5000
20200430,059258,台灣50群益99購01,11.90,12.00,11.90,12.00,+0.50,4.35,2000,2,23900,0,0,0,0,0,0,2000,0,2000,2000
20200430,059259,FBVIX中信03購06,0.98,0.98,0.95,0.95,-0.06,-5.94,374000,27,360590,0,0,0,0,0,0,271000,83000,188000,188000
20200430,05925P,晶技永豐96售03,0.10,0.11,0.10,0.11,-0.01,-8.33,17000,2,1770,0,0,0,0,0,0,10000,7000,3000,3000
20200430,059260,國巨中信99購05,2.06,2.06,2.04,2.04,+0.08,4.08,20000,2,41000,0,0,0,0,0,0,10000,10000,0,0
20200430,059261,華邦電中信01購01,,,,,0.00,0.00,0,0,0,0,0,0,0,0,0,0,0,0,0
20200430,059262,致茂中信01購01,1.38,1.39,1.37,1.37,-0.06,-4.2,30000,3,41400,0,0,0,0,0,0,20000,10000,10000,10000
20200430,059263,瑞昱中信01購01,1.57,1.66,1.55,1.63,+0.15,10.14,256000,38,412580,0,0,0,0,0,0,123000,126000,-3000,-3000
20200430,059264,台光電中信99購02,1.18,1.31,1.17,1.31,+0.15,12.93,584000,32,705880,0,0,0,0,0,0,186000,472000,-286000,-286000
20200430,059265,美律中信01購01,1.21,1.21,1.11,1.16,+0.07,6.42,50000,8,58440,0,0,0,0,0,0,4000,42000,-38000,-38000
20200430,059266,緯創中信01購01,2.04,2.09,2.02,2.09,+0.07,3.47,124000,16,252840,0,0,0,0,0,0,76000,38000,38000,38000
20200430,059267,群創中信01購02,1.48,1.48,1.48,1.48,+0.03,2.07,10000,1,14800,0,0,0,0,0,0,10000,0,10000,10000
20200430,059268,鎧勝中信01購01,1.52,1.59,1.52,1.57,0.00,0.00,30000,3,46800,0,0,0,0,0,0,10000,20000,-10000,-10000
20200430,059269,臺股指中信9B購03,,,,,0.00,0.00,0,0,0,0,0,0,0,0,0,0,0,0,0
20200430,05926P,智易永豐96售02,,,,,0.00,0.00,0,0,0,0,0,0,0,0,0,0,0,0,0
20200430,059270,台灣50元大01購03,,,,,0.00,0.00,0,0,0,0,0,0,0,0,0,0,0,0,0
20200430,059271,台灣50元大01購05,,,,,0.00,0.00,0,0,0,0,0,0,0,0,0,0,0,0,0
20200430,059272,台灣50元大99購01,4.26,4.34,4.26,4.34,+0.31,7.69,32000,2,136480,0,0,0,0,0,0,30000,2000,28000,28000
20200430,059273,臺指反元大9C購03,1.04,1.04,1.00,1.00,-0.10,-9.09,52000,7,53060,0,0,0,0,0,0,0,52000,-52000,-52000
20200430,059274,國巨元大99購22,1.81,1.84,1.75,1.81,+0.11,6.47,193000,21,347890,0,0,0,0,0,0,129000,64000,65000,65000
20200430,059275,可成元大99購05,5.60,5.60,5.35,5.40,-0.10,-1.82,18000,3,96900,0,0,0,0,0,0,11000,8000,3000,3000
20200430,059276,可成元大99購06,,,,,0.00,0.00,0,0,0,0,0,0,0,0,0,0,0,0,0
20200430,059277,群創元大99購05,,,,,0.00,0.00,0,0,0,0,0,0,0,0,0,0,0,0,0
20200430,059278,群創元大9A購04,1.07,1.09,1.07,1.09,+0.06,5.83,757000,13,813380,0,0,0,0,0,0,0,757000,-757000,-757000
20200430,059279,台灣50富邦9C購03,,,,,0.00,0.00,0,0,0,0,0,0,0,0,0,0,0,0,0
20200430,05927P,正文永豐96售03,,,,,0.00,0.00,0,0,0,0,0,0,0,0,0,0,0,0,0
20200430,059280,台灣50永豐99購06,,,,,0.00,0.00,0,0,0,0,0,0,0,0,0,0,0,0,0
20200430,059281,創意永豐99購02,2.21,2.25,2.21,2.22,+0.10,4.72,42000,7,93780,0,0,0,0,0,0,5000,42000,-37000,-37000
20200430,059282,嘉聯益永豐99購01,2.83,2.91,2.78,2.91,+0.14,5.05,81000,9,229830,0,0,0,0,0,0,37000,46000,-9000,-9000
20200430,059283,康友永豐99購02,1.08,1.16,1.06,1.13,+0.08,7.62,177000,11,198340,0,0,0,0,0,0,101000,76000,25000,25000
20200430,059284,緯穎永豐99購03,2.20,2.61,2.18,2.61,+0.56,27.32,183000,7,448650,0,0,0,0,0,0,7000,176000,-169000,-169000
20200430,059285,台灣50元富01購02,,,,,0.00,0.00,0,0,0,0,0,0,0,0,0,0,0,0,0
20200430,059286,S&P正2元富01購03,1.40,1.46,1.40,1.46,+0.11,8.15,142000,9,199330,0,0,0,0,0,0,141000,0,141000,141000
20200430,059287,華通元富99購03,4.68,5.15,4.64,5.10,+0.60,13.33,315000,32,1502010,0,0,0,0,0,0,253000,6000,247000,247000
20200430,059288,旺宏元富99購03,4.89,5.05,4.85,4.86,+0.32,7.05,45000,8,222100,0,0,0,0,0,0,45000,0,45000,45000
20200430,059289,瑞昱元富99購01,4.65,4.99,4.57,4.99,+0.50,11.14,425000,41,2015700,0,0,0,0,0,0,207000,224000,-17000,-17000
20200430,05928P,華邦電康和96售01,,,,,0.00,0.00,0,0,0,0,0,0,0,0,0,0,0,0,0
20200430,059290,全新元富99購01,2.10,2.11,2.03,2.03,0.00,0.00,182000,23,379760,0,0,0,0,0,0,155000,27000,128000,128000
20200430,059291,華新科元富9B購01,,,,,0.00,0.00,0,0,0,0,0,0,0,0,0,0,0,0,0
20200430,059292,華新科元富9B購02,3.25,3.25,3.21,3.21,0.00,0.00,20000,2,64600,0,0,0,0,0,0,10000,10000,0,0
20200430,059293,宏達電元富9B購01,1.45,1.45,1.45,1.45,0.00,0.00,200000,2,290000,0,0,0,0,0,0,200000,0,200000,200000
20200430,059294,宏達電元富9B購02,,,,,0.00,0.00,0,0,0,0,0,0,0,0,0,0,0,0,0
20200430,059295,大立光元富99購05,3.58,3.97,3.58,3.97,+0.52,15.07,1358000,100,5043800,0,0,0,0,0,0,796000,551000,245000,245000
20200430,059296,大立光元富99購06,3.18,3.54,3.17,3.52,+0.49,16.17,1678000,90,5575400,0,0,0,0,0,0,981000,694000,287000,287000
20200430,059297,大立光元富9C購01,3.36,3.69,3.36,3.69,+0.44,13.54,581000,57,2048560,0,0,0,0,0,0,293000,289000,4000,4000
20200430,059298,大立光元富9C購02,4.15,4.58,4.14,4.58,+0.50,12.25,680000,74,2953790,0,0,0,0,0,0,378000,302000,76000,76000
20200430,059299,欣興元富99購03,6.20,6.20,6.20,6.20,+0.90,16.98,2000,1,12400,0,0,0,0,0,0,0,2000,-2000,-2000
20200430,05929P,宏達電康和96售01,,,,,0.00,0.00,0,0,0,0,0,0,0,0,0,0,0,0,0
20200430,059300,國巨群益99購08,,,,,0.00,0.00,0,0,0,0,0,0,0,0,0,0,0,0,0
20200430,059301,華新科群益99購04,,,,,0.00,0.00,0,0,0,0,0,0,0,0,0,0,0,0,0
20200430,059302,大立光群益99購08,3.61,3.86,3.61,3.86,+0.37,10.6,46000,5,173160,0,0,0,0,0,0,22000,24000,-2000,-2000
20200430,059303,國巨兆豐99購04,4.77,4.77,4.77,4.77,0.00,0.00,10000,1,47700,0,0,0,0,0,0,10000,10000,0,0
20200430,059304,華新科兆豐99購06,3.36,3.36,3.36,3.36,0.00,0.00,10000,1,33600,0,0,0,0,0,0,0,10000,-10000,-10000
20200430,059305,台灣50元大99購02,,,,,0.00,0.00,0,0,0,0,0,0,0,0,0,0,0,0,0
20200430,059306,台灣50元大99購03,6.55,6.70,6.55,6.70,0.00,0.00,17000,2,112400,0,0,0,0,0,0,0,17000,-17000,-17000
20200430,059307,T50反1元大99購06,0.94,0.95,0.89,0.89,-0.11,-11.0,1746000,30,1605410,0,0,0,0,0,0,1341000,392000,949000,949000
20200430,059308,T50反1元大99購07,1.00,1.00,0.95,0.95,-0.10,-9.52,1129000,9,1114900,0,0,0,0,0,0,1065000,64000,1001000,1001000
20200430,059309,滬深2X元大99購02,1.13,1.13,1.13,1.13,0.00,0.00,25000,1,28250,0,0,0,0,0,0,25000,0,25000,25000
20200430,05930P,景碩康和96售01,0.48,0.48,0.41,0.45,-0.06,-11.76,818000,15,351160,0,0,0,0,0,0,648000,768000,-120000,-120000
20200430,059310,元石油元大99購03,1.40,1.40,1.40,1.40,+0.20,16.67,6000,2,8400,0,0,0,0,0,0,6000,0,6000,6000
20200430,059311,元石油元大99購04,1.44,1.55,1.44,1.55,+0.24,18.32,28000,6,41770,0,0,0,0,0,0,27000,1000,26000,26000
20200430,059312,元石油元大99購05,1.60,1.68,1.56,1.68,+0.25,17.48,1085000,39,1763270,0,0,0,0,0,0,553000,710000,-157000,-157000
20200430,059313,元石油元大99購06,1.69,1.84,1.69,1.84,+0.27,17.2,910000,27,1580040,0,0,0,0,0,0,430000,455000,-25000,-25000
20200430,059314,上銀元大99購03,6.80,6.80,6.80,6.80,+0.35,5.43,40000,5,272000,0,0,0,0,0,0,40000,0,40000,40000
20200430,059315,鴻海元大99購30,4.44,4.55,4.44,4.55,+0.23,5.32,67000,10,302050,0,0,0,0,0,0,55000,37000,18000,18000
20200430,059316,國巨元大99購23,6.85,6.85,6.85,6.85,+0.25,3.79,10000,1,68500,0,0,0,0,0,0,10000,0,10000,10000
20200430,059317,台積電元大99購34,5.45,5.45,5.45,5.45,+0.25,4.81,46000,3,250700,0,0,0,0,0,0,46000,0,46000,46000
20200430,059318,旺宏元大99購13,5.60,5.60,5.35,5.35,+0.35,7.0,22000,3,120100,0,0,0,0,0,0,22000,3000,19000,19000
20200430,059319,台光電元大99購04,3.24,3.52,3.24,3.52,+0.31,9.66,152000,19,500990,0,0,0,0,0,0,94000,86000,8000,8000
20200430,05931P,鴻海凱基96售15,,,,,0.00,0.00,0,0,0,0,0,0,0,0,0,0,0,0,0
20200430,059320,華新科元大99購15,7.85,7.85,7.85,7.85,+0.05,0.64,2000,1,15700,0,0,0,0,0,0,0,2000,-2000,-2000
20200430,059321,欣興元大99購07,10.10,10.10,10.10,10.10,+0.85,9.19,1000,1,10100,0,0,0,0,0,0,1000,0,1000,1000
20200430,059322,晶技元大99購06,4.13,4.13,4.13,4.13,0.00,0.00,1000,1,4130,0,0,0,0,0,0,1000,0,1000,1000
20200430,059323,新日興元大99購02,4.19,4.19,4.07,4.07,+0.02,0.49,31000,5,128570,0,0,0,0,0,0,31000,1000,30000,30000
20200430,059324,智易元大99購04,5.55,5.55,5.50,5.50,-0.30,-5.17,22000,2,122000,0,0,0,0,0,0,20000,2000,18000,18000
20200430,059325,超眾元大99購05,,,,,0.00,0.00,0,0,0,0,0,0,0,0,0,0,0,0,0
20200430,059326,康友元大99購01,1.77,1.89,1.77,1.86,+0.15,8.77,704000,37,1301140,0,0,0,0,0,0,112000,573000,-461000,-461000
20200430,059327,南茂元大99購01,3.92,4.08,3.92,4.06,0.00,0.00,141000,17,565570,0,0,0,0,0,0,1000,141000,-140000,-140000
20200430,059328,台灣50國票99購08,12.50,12.50,12.50,12.50,0.00,0.00,1000,1,12500,0,0,0,0,0,0,0,1000,-1000,-1000
20200430,059329,台灣50國票99購09,,,,,0.00,0.00,0,0,0,0,0,0,0,0,0,0,0,0,0
20200430,05932P,鴻海凱基96售16,,,,,0.00,0.00,0,0,0,0,0,0,0,0,0,0,0,0,0
20200430,059330,台灣50國票99購10,,,,,0.00,0.00,0,0,0,0,0,0,0,0,0,0,0,0,0
20200430,059331,台灣50國票9A購06,7.35,7.35,7.35,7.35,+0.35,5.0,229000,3,1683150,0,0,0,0,0,0,229000,229000,0,0
20200430,059332,台灣50國票9A購07,5.70,5.70,5.70,5.70,0.00,0.00,21000,1,119700,0,0,0,0,0,0,0,21000,-21000,-21000
20200430,059333,滬深2X國票9A購03,,,,,0.00,0.00,0,0,0,0,0,0,0,0,0,0,0,0,0
20200430,059334,A50正2國票9A購02,1.95,1.95,1.95,1.95,+0.22,12.72,2000,1,3900,0,0,0,0,0,0,0,2000,-2000,-2000
20200430,059335,台灣50凱基03購02,,,,,0.00,0.00,0,0,0,0,0,0,0,0,0,0,0,0,0
20200430,059336,台灣50凱基9A購02,,,,,0.00,0.00,0,0,0,0,0,0,0,0,0,0,0,0,0
20200430,059337,台灣50凱基9C購05,,,,,0.00,0.00,0,0,0,0,0,0,0,0,0,0,0,0,0
20200430,059338,滬深2X凱基9C購02,,,,,0.00,0.00,0,0,0,0,0,0,0,0,0,0,0,0,0
20200430,059339,上銀凱基99購06,3.88,4.37,3.88,4.37,+0.60,15.92,120000,14,483540,0,0,0,0,0,0,100000,20000,80000,80000
20200430,05933P,鴻海凱基97售03,,,,,0.00,0.00,0,0,0,0,0,0,0,0,0,0,0,0,0
20200430,059340,鴻海凱基9A購12,2.03,2.03,2.01,2.02,+0.03,1.51,93000,6,188390,0,0,0,0,0,0,73000,30000,43000,43000
20200430,059341,台積電凱基99購15,3.33,3.41,3.33,3.41,+0.25,7.91,14000,5,46890,0,0,0,0,0,0,12000,0,12000,12000
20200430,059342,聯發科凱基9A購05,,,,,0.00,0.00,0,0,0,0,0,0,0,0,0,0,0,0,0
20200430,059343,宏達電凱基99購04,,,,,0.00,0.00,0,0,0,0,0,0,0,0,0,0,0,0,0
20200430,059344,長榮航凱基99購01,2.30,2.30,2.23,2.23,+0.12,5.69,20000,2,45300,0,0,0,0,0,0,0,10000,-10000,-10000
20200430,059345,禾伸堂凱基99購03,,,,,0.00,0.00,0,0,0,0,0,0,0,0,0,0,0,0,0
20200430,059346,新日興凱基99購03,,,,,0.00,0.00,0,0,0,0,0,0,0,0,0,0,0,0,0
20200430,059347,京鼎凱基99購02,3.66,4.04,3.66,4.04,+0.44,12.22,89000,17,340570,0,0,0,0,0,0,59000,10000,49000,49000
20200430,059348,日月光凱基99購01,3.64,3.85,3.64,3.84,+0.25,6.96,106000,13,398230,0,0,0,0,0,0,3000,103000,-100000,-100000
20200430,059349,台郡凱基99購04,1.65,1.69,1.62,1.69,+0.02,1.2,153000,12,251210,0,0,0,0,0,0,128000,59000,69000,69000
20200430,05934P,國巨凱基96售13,,,,,0.00,0.00,0,0,0,0,0,0,0,0,0,0,0,0,0
20200430,059350,樺漢凱基9A購01,1.51,1.62,1.51,1.60,+0.09,5.96,345000,40,544970,0,0,0,0,0,0,226000,113000,113000,113000
20200430,059351,台虹凱基99購01,2.86,2.89,2.84,2.85,+0.03,1.06,178000,11,508700,0,0,0,0,0,0,78000,100000,-22000,-22000
20200430,059352,台灣50富邦01購01,,,,,0.00,0.00,0,0,0,0,0,0,0,0,0,0,0,0,0
20200430,059353,滬深2X富邦9A購02,2.38,2.38,2.38,2.38,+0.13,5.78,10000,1,23800,0,0,0,0,0,0,10000,0,10000,10000
20200430,059354,臺指反富邦9B購01,0.45,0.45,0.37,0.37,-0.10,-21.28,28000,3,10940,0,0,0,0,0,0,0,0,0,0
20200430,059355,國巨富邦9B購03,1.64,1.68,1.62,1.65,+0.09,5.77,168000,21,276570,0,0,0,0,0,0,109000,133000,-24000,-24000
20200430,059356,滬深2X永豐99購02,,,,,0.00,0.00,0,0,0,0,0,0,0,0,0,0,0,0,0
20200430,059357,華通永豐99購01,2.99,3.28,2.99,3.28,+0.52,18.84,44000,7,138020,0,0,0,0,0,0,0,44000,-44000,-44000
20200430,059358,旺宏永豐99購02,2.86,2.97,2.85,2.87,+0.27,10.38,1339000,20,3905830,0,0,0,0,0,0,1249000,89000,1160000,1160000
20200430,059359,精元永豐99購01,1.78,1.88,1.71,1.88,+0.09,5.03,154000,8,279850,0,0,0,0,0,0,94000,60000,34000,34000
20200430,05935P,台積電凱基96售19,3.99,3.99,3.99,3.99,0.00,0.00,200000,1,798000,0,0,0,0,0,0,200000,200000,0,0
20200430,059360,全新永豐99購02,2.89,2.89,2.78,2.78,-0.08,-2.8,30000,3,83840,0,0,0,0,0,0,30000,0,30000,30000
20200430,059361,玉晶光永豐99購04,2.49,2.68,2.49,2.68,+0.27,11.2,55000,11,139030,0,0,0,0,0,0,42000,15000,27000,27000
20200430,059362,健策永豐99購03,2.84,2.84,2.80,2.80,0.00,0.00,7000,2,19680,0,0,0,0,0,0,7000,0,7000,7000
20200430,059363,超眾永豐99購02,2.47,2.51,2.41,2.47,+0.09,3.78,79000,7,193450,0,0,0,0,0,0,30000,49000,-19000,-19000
20200430,059364,昇陽半永豐99購02,2.01,2.11,2.01,2.11,+0.19,9.9,207000,21,429180,0,0,0,0,0,0,82000,116000,-34000,-34000
20200430,059365,T50反1台新99購01,0.01,0.01,0.01,0.01,0.00,0.00,10000,1,100,0,0,0,0,0,0,0,10000,-10000,-10000
20200430,059366,台積電台新99購04,,,,,0.00,0.00,0,0,0,0,0,0,0,0,0,0,0,0,0
20200430,059367,台灣50元富01購03,,,,,0.00,0.00,0,0,0,0,0,0,0,0,0,0,0,0,0
20200430,059368,T50正2元富99購02,4.73,4.84,4.73,4.84,+0.38,8.52,47000,2,223630,0,0,0,0,0,0,12000,35000,-23000,-23000
20200430,059369,滬深2X元富9C購01,3.40,3.40,3.35,3.35,+0.13,4.04,7000,3,23700,0,0,0,0,0,0,3000,4000,-1000,-1000
20200430,05936P,台積電凱基96售20,3.94,3.94,3.94,3.94,0.00,0.00,1000,1,3940,0,0,0,0,0,0,0,1000,-1000,-1000
20200430,059370,玉晶光元富99購02,1.70,1.84,1.69,1.84,+0.23,14.29,293000,50,511760,0,0,0,0,0,0,150000,143000,7000,7000
20200430,059371,聯鈞元富99購02,1.24,1.24,1.18,1.18,-0.05,-4.07,105000,7,124760,0,0,0,0,0,0,100000,2000,98000,98000
20200430,059372,台灣50群益99購02,,,,,0.00,0.00,0,0,0,0,0,0,0,0,0,0,0,0,0
20200430,059373,滬深2X群益01購03,,,,,0.00,0.00,0,0,0,0,0,0,0,0,0,0,0,0,0
20200430,059374,A50正2群益01購01,,,,,0.00,0.00,0,0,0,0,0,0,0,0,0,0,0,0,0
20200430,059375,道瓊反群益9C購02,0.43,0.44,0.41,0.42,-0.04,-8.7,859000,25,366000,0,0,0,0,0,0,626000,174000,452000,452000
20200430,059376,國巨群益99購09,,,,,0.00,0.00,0,0,0,0,0,0,0,0,0,0,0,0,0
20200430,059377,台積電群益99購09,2.57,2.57,2.57,2.57,+0.04,1.58,5000,1,12850,0,0,0,0,0,0,0,0,0,0
20200430,059378,台光電群益9B購01,2.22,2.26,2.20,2.26,+0.12,5.61,154000,11,343400,0,0,0,0,0,0,29000,144000,-115000,-115000
20200430,059379,聯電亞東99購02,1.06,1.06,1.05,1.06,+0.01,0.95,4000,4,4230,0,0,0,0,0,0,3000,0,3000,3000
20200430,05937P,台積電凱基96售21,,,,,0.00,0.00,0,0,0,0,0,0,0,0,0,0,0,0,0
20200430,059380,鴻海亞東99購01,,,,,0.00,0.00,0,0,0,0,0,0,0,0,0,0,0,0,0
20200430,059381,TPK亞東99購01,,,,,0.00,0.00,0,0,0,0,0,0,0,0,0,0,0,0,0
20200430,059382,台灣50凱基99購02,4.00,4.00,4.00,4.00,0.00,0.00,8000,1,32000,0,0,0,0,0,0,0,8000,-8000,-8000
20200430,059383,台灣50凱基99購03,2.46,2.52,2.46,2.52,+0.12,5.0,11000,2,27120,0,0,0,0,0,0,11000,0,11000,11000
20200430,059384,上証2X凱基9B購01,,,,,0.00,0.00,0,0,0,0,0,0,0,0,0,0,0,0,0
20200430,059385,滬深2X凱基9C購03,2.92,2.92,2.92,2.92,+0.07,2.46,100000,1,292000,0,0,0,0,0,0,0,100000,-100000,-100000
20200430,059386,上銀凱基99購07,2.70,3.01,2.69,3.01,+0.40,15.33,93000,14,256670,0,0,0,0,0,0,60000,33000,27000,27000
20200430,059387,華通凱基9A購03,1.94,2.10,1.93,2.08,+0.22,11.83,42000,11,85610,0,0,0,0,0,0,42000,0,42000,42000
20200430,059388,國巨凱基99購13,3.46,3.46,3.46,3.46,+0.05,1.47,1000,1,3460,0,0,0,0,0,0,1000,0,1000,1000
20200430,059389,國巨凱基99購14,,,,,0.00,0.00,0,0,0,0,0,0,0,0,0,0,0,0,0
20200430,05938P,旺宏凱基96售07,1.29,1.36,1.28,1.35,0.00,0.00,97000,6,125680,0,0,0,0,0,0,72000,25000,47000,47000
20200430,059390,華新科凱基99購05,2.37,2.37,2.26,2.26,0.00,0.00,6000,2,14110,0,0,0,0,0,0,1000,5000,-4000,-4000
20200430,059391,立積凱基9A購01,1.80,1.80,1.80,1.80,+0.08,4.65,12000,1,21600,0,0,0,0,0,0,12000,0,12000,12000
20200430,059392,臺股指凱基99購38,4.44,4.44,4.44,4.44,+0.29,6.99,20000,1,88800,0,0,0,0,0,0,20000,0,20000,20000
20200430,059393,臺股指凱基99購39,,,,,0.00,0.00,0,0,0,0,0,0,0,0,0,0,0,0,0
20200430,059394,臺股指凱基99購40,,,,,0.00,0.00,0,0,0,0,0,0,0,0,0,0,0,0,0
20200430,059395,T50反1元富99購03,0.52,0.52,0.48,0.49,-0.06,-10.91,2456000,77,1207480,0,0,0,0,0,0,1454000,503000,951000,951000
20200430,059396,T50反1元富99購04,0.37,0.37,0.32,0.35,-0.03,-7.89,1040000,53,343430,0,0,0,0,0,0,317000,317000,0,0
20200430,059397,T50反1元富99購05,0.74,0.74,0.69,0.70,-0.10,-12.5,118000,15,85030,0,0,0,0,0,0,25000,91000,-66000,-66000
20200430,059398,滬深2X元富9C購02,,,,,0.00,0.00,0,0,0,0,0,0,0,0,0,0,0,0,0
20200430,059399,滬深2X元富9C購03,,,,,0.00,0.00,0,0,0,0,0,0,0,0,0,0,0,0,0
20200430,05939P,聯發科凱基96售20,,,,,0.00,0.00,0,0,0,0,0,0,0,0,0,0,0,0,0
20200430,059400,滬深2X元富9C購04,4.43,4.67,4.43,4.67,+0.39,9.11,104000,2,461920,0,0,0,0,0,0,104000,0,104000,104000
20200430,059401,牧德元富99購01,2.08,2.08,2.06,2.08,+0.12,6.12,50000,7,103800,0,0,0,0,0,0,0,50000,-50000,-50000
20200430,059402,台灣50台新99購01,,,,,0.00,0.00,0,0,0,0,0,0,0,0,0,0,0,0,0
20200430,059403,T50反1台新03購03,0.64,0.64,0.59,0.59,-0.09,-13.24,367000,20,224160,0,0,0,0,0,0,54000,313000,-259000,-259000
20200430,059404,鴻海台新99購03,,,,,0.00,0.00,0,0,0,0,0,0,0,0,0,0,0,0,0
20200430,059405,台灣50國票01購01,,,,,0.00,0.00,0,0,0,0,0,0,0,0,0,0,0,0,0
20200430,059406,台灣50國票9A購08,,,,,0.00,0.00,0,0,0,0,0,0,0,0,0,0,0,0,0
20200430,059407,台灣50國票9B購01,,,,,0.00,0.00,0,0,0,0,0,0,0,0,0,0,0,0,0
20200430,059408,台灣50國票9B購02,,,,,0.00,0.00,0,0,0,0,0,0,0,0,0,0,0,0,0
20200430,059409,台灣50國票9C購01,8.00,8.00,8.00,8.00,0.00,0.00,2000,1,16000,0,0,0,0,0,0,0,2000,-2000,-2000
20200430,05940P,聯發科凱基96售21,,,,,0.00,0.00,0,0,0,0,0,0,0,0,0,0,0,0,0
20200430,059410,滬深2X國票9A購04,3.35,3.41,3.35,3.37,+0.09,2.74,309000,7,1039430,0,0,0,0,0,0,309000,0,309000,309000
20200430,059411,臺股指國票99購17,,,,,0.00,0.00,0,0,0,0,0,0,0,0,0,0,0,0,0
20200430,059412,臺股指國票99購18,,,,,0.00,0.00,0,0,0,0,0,0,0,0,0,0,0,0,0
20200430,059413,台灣50元大99購05,,,,,0.00,0.00,0,0,0,0,0,0,0,0,0,0,0,0,0
20200430,059414,台灣50元大9A購02,,,,,0.00,0.00,0,0,0,0,0,0,0,0,0,0,0,0,0
20200430,059415,台灣50元大9A購03,5.10,5.25,5.10,5.25,+0.30,6.06,28000,2,146250,0,0,0,0,0,0,28000,0,28000,28000
20200430,059416,T50反1元大99購08,,,,,0.00,0.00,0,0,0,0,0,0,0,0,0,0,0,0,0
20200430,059417,上証反元大9C購01,0.82,0.82,0.82,0.82,0.00,0.00,13000,1,10660,0,0,0,0,0,0,13000,0,13000,13000
20200430,059418,上証反元大9C購02,,,,,0.00,0.00,0,0,0,0,0,0,0,0,0,0,0,0,0
20200430,059419,滬深2X元大99購03,,,,,0.00,0.00,0,0,0,0,0,0,0,0,0,0,0,0,0
20200430,05941P,聯發科凱基96售22,,,,,0.00,0.00,0,0,0,0,0,0,0,0,0,0,0,0,0
20200430,059420,滬深2X元大99購04,,,,,0.00,0.00,0,0,0,0,0,0,0,0,0,0,0,0,0
20200430,059421,滬深2X元大99購05,,,,,0.00,0.00,0,0,0,0,0,0,0,0,0,0,0,0,0
20200430,059422,滬深2X元大99購06,,,,,0.00,0.00,0,0,0,0,0,0,0,0,0,0,0,0,0
20200430,059423,滬深2X元大9A購01,,,,,0.00,0.00,0,0,0,0,0,0,0,0,0,0,0,0,0
20200430,059424,SGBR2X元大9A購01,1.78,1.90,1.77,1.89,+0.36,23.53,933000,107,1686400,0,0,0,0,0,0,289000,550000,-261000,-261000
20200430,059425,SGBR2X元大9A購02,1.75,2.10,1.75,1.93,+0.37,23.72,1101000,111,2080490,0,0,0,0,0,0,350000,432000,-82000,-82000
20200430,059426,鴻海元大99購31,,,,,0.00,0.00,0,0,0,0,0,0,0,0,0,0,0,0,0
20200430,059427,國巨元大99購24,8.20,8.20,7.90,7.90,0.00,0.00,4000,3,32300,0,0,0,0,0,0,1000,4000,-3000,-3000
20200430,059428,國巨元大99購25,,,,,0.00,0.00,0,0,0,0,0,0,0,0,0,0,0,0,0
20200430,059429,台積電元大99購35,6.45,6.50,6.45,6.50,+0.20,3.17,17000,3,110400,0,0,0,0,0,0,17000,0,17000,17000
20200430,05942P,奇力新凱基96售04,,,,,0.00,0.00,0,0,0,0,0,0,0,0,0,0,0,0,0
20200430,059430,台積電元大99購36,7.15,7.25,7.15,7.25,+0.35,5.07,58000,8,415850,0,0,0,0,0,0,37000,21000,16000,16000
20200430,059431,旺宏元大99購14,6.05,6.05,5.90,5.90,+0.45,8.26,24000,10,142600,0,0,0,0,0,0,24000,9000,15000,15000
20200430,059432,聯發科元大99購26,7.35,7.45,7.30,7.45,+0.70,10.37,13000,4,95400,0,0,0,0,0,0,8000,5000,3000,3000
20200430,059433,聯發科元大99購27,,,,,0.00,0.00,0,0,0,0,0,0,0,0,0,0,0,0,0
20200430,059434,全新元大99購05,5.75,5.75,5.75,5.75,-0.10,-1.71,16000,4,92000,0,0,0,0,0,0,16000,0,16000,16000
20200430,059435,大立光元大99購17,5.00,5.30,5.00,5.30,+0.38,7.72,66000,7,336000,0,0,0,0,0,0,48000,18000,30000,30000
20200430,059436,大立光元大99購18,4.84,5.25,4.84,5.25,+0.48,10.06,53000,8,260670,0,0,0,0,0,0,44000,6000,38000,38000
20200430,059437,京鼎元大99購02,,,,,0.00,0.00,0,0,0,0,0,0,0,0,0,0,0,0,0
20200430,059438,群創元大99購06,1.47,1.51,1.46,1.49,+0.07,4.93,541000,20,801060,0,0,0,0,0,0,240000,301000,-61000,-61000
20200430,059439,健策元大9B購01,,,,,0.00,0.00,0,0,0,0,0,0,0,0,0,0,0,0,0
20200430,05943P,欣興凱基96售03,2.09,2.12,2.02,2.12,-0.14,-6.19,47000,9,98010,0,0,0,0,0,0,26000,21000,5000,5000
20200430,059440,康控元大9B購01,3.05,3.05,3.05,3.05,+0.33,12.13,30000,1,91500,0,0,0,0,0,0,30000,30000,0,0
20200430,059441,祥碩元大99購02,7.25,7.25,6.15,6.35,-0.40,-5.93,45000,11,292300,0,0,0,0,0,0,12000,33000,-21000,-21000
20200430,059442,祥碩元大99購03,6.25,6.25,5.50,5.50,-0.45,-7.56,14000,3,81350,0,0,0,0,0,0,11000,3000,8000,8000
20200430,059443,嘉聯益元大9B購01,6.85,6.90,6.80,6.90,+0.30,4.55,45000,5,308500,0,0,0,0,0,0,45000,0,45000,45000
20200430,059444,臺股指元大99購25,,,,,0.00,0.00,0,0,0,0,0,0,0,0,0,0,0,0,0
20200430,059445,臺股指元大99購26,,,,,0.00,0.00,0,0,0,0,0,0,0,0,0,0,0,0,0
20200430,059446,臺股指元大99購27,,,,,0.00,0.00,0,0,0,0,0,0,0,0,0,0,0,0,0
20200430,059447,臺股指元大99購28,,,,,0.00,0.00,0,0,0,0,0,0,0,0,0,0,0,0,0
20200430,059448,上証2X永豐99購01,,,,,0.00,0.00,0,0,0,0,0,0,0,0,0,0,0,0,0
20200430,059449,滬深2X永豐99購03,,,,,0.00,0.00,0,0,0,0,0,0,0,0,0,0,0,0,0
20200430,05944P,富邦金中信96售01,,,,,0.00,0.00,0,0,0,0,0,0,0,0,0,0,0,0,0
20200430,059450,和大永豐99購01,1.50,1.78,1.50,1.78,+0.44,32.84,192000,16,308490,0,0,0,0,0,0,1000,191000,-190000,-190000
20200430,059451,國巨永豐99購05,,,,,0.00,0.00,0,0,0,0,0,0,0,0,0,0,0,0,0
20200430,059452,全新永豐99購03,2.33,2.33,2.21,2.21,-0.15,-6.36,44000,5,100120,0,0,0,0,0,0,34000,10000,24000,24000
20200430,059453,奇力新永豐99購01,,,,,0.00,0.00,0,0,0,0,0,0,0,0,0,0,0,0,0
20200430,059454,亞光永豐99購01,2.25,2.35,2.21,2.31,+0.08,3.59,109000,15,249610,0,0,0,0,0,0,47000,62000,-15000,-15000
20200430,059455,玉晶光永豐99購05,3.14,3.41,3.14,3.40,+0.25,7.94,106000,17,346420,0,0,0,0,0,0,87000,17000,70000,70000
20200430,059456,智易永豐99購01,3.85,3.86,3.75,3.75,-0.07,-1.83,38000,3,145700,0,0,0,0,0,0,38000,0,38000,38000
20200430,059457,立積永豐99購02,,,,,0.00,0.00,0,0,0,0,0,0,0,0,0,0,0,0,0
20200430,059458,鎧勝永豐99購01,2.37,2.62,2.37,2.55,+0.14,5.81,89000,11,223880,1000,0,1000,0,0,0,0,89000,-89000,-88000
20200430,059459,訊芯永豐99購04,2.81,2.90,2.81,2.90,+0.12,4.32,55000,3,155990,0,0,0,0,0,0,10000,45000,-35000,-35000
20200430,05945P,聯詠中信96售01,,,,,0.00,0.00,0,0,0,0,0,0,0,0,0,0,0,0,0
20200430,059460,GIS永豐99購02,2.90,2.92,2.81,2.86,+0.02,0.7,231000,14,660940,0,0,0,0,0,0,173000,58000,115000,115000
20200430,059461,鈺齊永豐99購03,1.75,1.77,1.65,1.74,+0.05,2.96,342000,21,588160,0,0,0,0,0,0,296000,56000,240000,240000
20200430,059462,台灣50元大9C購06,,,,,0.00,0.00,0,0,0,0,0,0,0,0,0,0,0,0,0
20200430,059463,台灣50元大9C購07,5.70,5.70,5.70,5.70,+0.25,4.59,2000,1,11400,0,0,0,0,0,0,0,2000,-2000,-2000
20200430,059464,台灣50元大9C購08,,,,,0.00,0.00,0,0,0,0,0,0,0,0,0,0,0,0,0
20200430,059465,台灣50元大9C購09,,,,,0.00,0.00,0,0,0,0,0,0,0,0,0,0,0,0,0
20200430,059466,國巨元大99購26,8.55,8.55,8.20,8.20,+0.20,2.5,2000,2,16750,0,0,0,0,0,0,1000,2000,-1000,-1000
20200430,059467,旺宏元大99購15,,,,,0.00,0.00,0,0,0,0,0,0,0,0,0,0,0,0,0
20200430,059468,智邦元大99購02,3.40,3.40,3.19,3.19,-0.26,-7.54,6000,4,19830,0,0,0,0,0,0,6000,1000,5000,5000
20200430,059469,智邦元大99購03,3.99,4.13,3.68,3.73,-0.21,-5.33,245000,37,941410,0,0,0,0,0,0,99000,170000,-71000,-71000
20200430,05946P,和碩中信96售01,,,,,0.00,0.00,0,0,0,0,0,0,0,0,0,0,0,0,0
20200430,059470,華新科元大99購16,,,,,0.00,0.00,0,0,0,0,0,0,0,0,0,0,0,0,0
20200430,059471,華新科元大99購17,,,,,0.00,0.00,0,0,0,0,0,0,0,0,0,0,0,0,0
20200430,059472,T50正2群益99購01,,,,,0.00,0.00,0,0,0,0,0,0,0,0,0,0,0,0,0
20200430,059473,T50反1群益99購03,0.80,0.80,0.75,0.75,-0.09,-10.71,8000,2,6200,0,0,0,0,0,0,4000,4000,0,0
20200430,059474,元石油群益99購01,1.88,2.13,1.88,2.13,+0.36,20.34,264000,46,524840,0,0,0,0,0,0,3000,31000,-28000,-28000
20200430,059475,元石油群益99購02,1.30,1.50,1.30,1.50,+0.39,35.14,134000,29,184610,0,0,0,0,0,0,23000,13000,10000,10000
20200430,059476,道瓊指群益9C購01,,,,,0.00,0.00,0,0,0,0,0,0,0,0,0,0,0,0,0
20200430,059477,FBVIX群益99購01,,,,,0.00,0.00,0,0,0,0,0,0,0,0,0,0,0,0,0
20200430,059478,FBVIX群益9A購01,1.28,1.28,1.28,1.28,0.00,0.00,2000,1,2560,0,0,0,0,0,0,2000,0,2000,2000
20200430,059479,國巨群益99購10,,,,,0.00,0.00,0,0,0,0,0,0,0,0,0,0,0,0,0
20200430,05947P,大成鋼元大96售03,2.78,2.78,2.78,2.78,+0.01,0.36,22000,1,61160,0,0,0,0,0,0,0,22000,-22000,-22000
20200430,059480,美律群益9A購01,1.26,1.37,1.26,1.33,+0.09,7.26,278000,19,368790,0,0,0,0,0,0,96000,189000,-93000,-93000
20200430,059481,華新科群益99購05,,,,,0.00,0.00,0,0,0,0,0,0,0,0,0,0,0,0,0
20200430,059482,貿聯群益99購05,5.00,5.40,5.00,5.40,0.00,0.00,19000,5,98800,0,0,0,0,0,0,19000,0,19000,19000
20200430,059483,臺股指群益99購17,,,,,0.00,0.00,0,0,0,0,0,0,0,0,0,0,0,0,0
20200430,059484,臺股指群益99購18,,,,,0.00,0.00,0,0,0,0,0,0,0,0,0,0,0,0,0
20200430,059485,台灣50兆豐99購02,5.25,5.60,5.25,5.60,+0.64,12.9,195000,8,1041100,0,0,0,0,0,0,195000,163000,32000,32000
20200430,059486,A50正2兆豐9A購01,,,,,0.00,0.00,0,0,0,0,0,0,0,0,0,0,0,0,0
20200430,059487,聯發科兆豐99購03,,,,,0.00,0.00,0,0,0,0,0,0,0,0,0,0,0,0,0
20200430,059488,大立光兆豐99購03,2.73,2.94,2.73,2.94,+0.41,16.21,47000,4,133590,0,0,0,0,0,0,9000,38000,-29000,-29000
20200430,059489,上証2X國票9A購01,4.10,4.10,4.01,4.01,0.00,0.00,2000,2,8110,0,0,0,0,0,0,0,2000,-2000,-2000
20200430,05948P,茂林元大96售03,0.40,0.40,0.40,0.40,0.00,0.00,20000,1,8000,0,0,0,0,0,0,20000,0,20000,20000
20200430,059490,國巨國票99購09,8.35,8.35,8.35,8.35,0.00,0.00,1000,1,8350,0,0,0,0,0,0,0,1000,-1000,-1000
20200430,059491,國巨國票9A購05,7.15,7.15,7.15,7.15,0.00,0.00,2000,1,14300,0,0,0,0,0,0,0,2000,-2000,-2000
20200430,059492,國巨國票9A購06,,,,,0.00,0.00,0,0,0,0,0,0,0,0,0,0,0,0,0
20200430,059493,國巨國票9B購01,12.40,12.50,12.10,12.10,+0.40,3.42,47000,7,579400,0,0,0,0,0,0,0,35000,-35000,-35000
20200430,059494,國巨國票9C購01,9.40,9.40,9.40,9.40,+0.20,2.17,1000,1,9400,0,0,0,0,0,0,1000,0,1000,1000
20200430,059495,台灣50元富9C購02,,,,,0.00,0.00,0,0,0,0,0,0,0,0,0,0,0,0,0
20200430,059496,T50正2元富99購03,,,,,0.00,0.00,0,0,0,0,0,0,0,0,0,0,0,0,0
20200430,059497,滬深2X元富9C購05,,,,,0.00,0.00,0,0,0,0,0,0,0,0,0,0,0,0,0
20200430,059498,滬深2X元富9C購06,,,,,0.00,0.00,0,0,0,0,0,0,0,0,0,0,0,0,0
20200430,059499,滬深2X元富9C購07,,,,,0.00,0.00,0,0,0,0,0,0,0,0,0,0,0,0,0
20200430,05949P,台積電國票96售09,,,,,0.00,0.00,0,0,0,0,0,0,0,0,0,0,0,0,0
20200430,059500,鴻海元富99購11,3.00,3.16,3.00,3.11,+0.16,5.42,35000,5,108260,0,0,0,0,0,0,25000,15000,10000,10000
20200430,059501,可成元富99購01,2.16,2.17,2.09,2.10,-0.08,-3.67,120000,4,252850,0,0,0,0,0,0,115000,5000,110000,110000
20200430,059502,台灣50台新9B購04,2.07,2.07,2.07,2.07,+0.05,2.48,20000,2,41400,0,0,0,0,0,0,20000,0,20000,20000
20200430,059503,大立光富邦9B購04,0.86,0.94,0.86,0.94,+0.12,14.63,2076000,78,1900840,0,0,0,0,0,0,820000,1174000,-354000,-354000
20200430,059504,台灣50永豐99購08,,,,,0.00,0.00,0,0,0,0,0,0,0,0,0,0,0,0,0
20200430,059505,上証2X永豐99購02,,,,,0.00,0.00,0,0,0,0,0,0,0,0,0,0,0,0,0
20200430,059506,滬深2X永豐99購04,,,,,0.00,0.00,0,0,0,0,0,0,0,0,0,0,0,0,0
20200430,059507,鴻海永豐99購03,1.66,1.70,1.66,1.70,+0.06,3.66,166000,8,279740,0,0,0,0,0,0,0,166000,-166000,-166000
20200430,059508,聯發科永豐99購03,3.79,3.97,3.79,3.97,+0.52,15.07,43000,8,167220,0,0,0,0,0,0,5000,38000,-33000,-33000
20200430,059509,奇力新永豐99購02,3.86,3.86,3.80,3.80,+0.01,0.26,21000,4,79980,0,0,0,0,0,0,0,21000,-21000,-21000
20200430,05950P,台積電國票97售04,7.15,7.15,7.15,7.15,-1.00,-12.27,3000,1,21450,0,0,0,0,0,0,3000,0,3000,3000
20200430,059510,華新科永豐99購07,,,,,0.00,0.00,0,0,0,0,0,0,0,0,0,0,0,0,0
20200430,059511,宏達電永豐99購02,,,,,0.00,0.00,0,0,0,0,0,0,0,0,0,0,0,0,0
20200430,059512,晶豪科永豐99購02,4.44,4.44,4.44,4.44,+0.49,12.41,4000,1,17760,0,0,0,0,0,0,4000,0,4000,4000
20200430,059513,揚明光永豐99購01,2.13,2.14,2.13,2.13,-0.04,-1.84,74000,3,157910,0,0,0,0,0,0,59000,15000,44000,44000
20200430,059514,嘉澤永豐99購02,3.57,3.86,3.53,3.86,+0.39,11.24,281000,21,1027340,0,0,0,0,0,0,190000,161000,29000,29000
20200430,059515,牧德永豐99購01,3.02,3.14,2.99,3.14,+0.27,9.41,69000,7,211600,0,0,0,0,0,0,13000,57000,-44000,-44000
20200430,059516,TPK永豐99購01,2.06,2.13,1.98,1.98,-0.08,-3.88,120000,17,248180,0,0,0,0,0,0,88000,32000,56000,56000
20200430,059517,茂林永豐99購02,,,,,0.00,0.00,0,0,0,0,0,0,0,0,0,0,0,0,0
20200430,059518,康控永豐99購01,,,,,0.00,0.00,0,0,0,0,0,0,0,0,0,0,0,0,0
20200430,059519,台郡永豐99購01,1.75,1.75,1.75,1.75,0.00,0.00,20000,1,35000,0,0,0,0,0,0,20000,0,20000,20000
20200430,05951P,台積電國票97售05,9.80,9.80,9.40,9.40,-1.60,-14.55,40000,2,384000,0,0,0,0,0,0,20000,20000,0,0
20200430,059520,台表科永豐99購02,2.86,2.86,2.86,2.86,-0.08,-2.72,65000,2,185900,0,0,0,0,0,0,65000,0,65000,65000
20200430,059521,南電永豐99購03,,,,,0.00,0.00,0,0,0,0,0,0,0,0,0,0,0,0,0
20200430,059522,上証2X凱基9B購02,,,,,0.00,0.00,0,0,0,0,0,0,0,0,0,0,0,0,0
20200430,059523,滬深2X凱基9C購04,,,,,0.00,0.00,0,0,0,0,0,0,0,0,0,0,0,0,0
20200430,059524,FBVIX凱基9A購02,1.12,1.12,1.09,1.10,-0.09,-7.56,506000,15,555950,0,0,0,0,0,0,308000,198000,110000,110000
20200430,059525,上銀凱基99購08,2.99,3.34,2.99,3.34,+0.45,15.57,77000,9,241240,0,0,0,0,0,0,18000,59000,-41000,-41000
20200430,059526,鴻海凱基99購12,2.14,2.17,2.13,2.17,+0.05,2.36,183000,15,392360,0,0,0,0,0,0,183000,0,183000,183000
20200430,059527,聯發科凱基99購16,3.06,3.16,3.06,3.16,+0.32,11.27,6000,2,18760,0,0,0,0,0,0,6000,0,6000,6000
20200430,059528,華新科凱基99購06,2.33,2.33,2.33,2.33,0.00,0.00,5000,1,11650,0,0,0,0,0,0,0,5000,-5000,-5000
20200430,059529,華新科凱基9A購04,2.12,2.12,2.12,2.12,-0.08,-3.64,20000,2,42400,0,0,0,0,0,0,20000,0,20000,20000
20200430,05952P,台積電國票97售06,,,,,0.00,0.00,0,0,0,0,0,0,0,0,0,0,0,0,0
20200430,059530,華新科凱基9A購05,2.52,2.52,2.45,2.45,-0.06,-2.39,15000,2,37450,0,0,0,0,0,0,10000,5000,5000,5000
20200430,059531,華新科凱基9B購02,,,,,0.00,0.00,0,0,0,0,0,0,0,0,0,0,0,0,0
20200430,059532,華新科凱基9B購03,3.88,3.88,3.74,3.74,-0.07,-1.84,16000,4,61680,0,0,0,0,0,0,12000,4000,8000,8000
20200430,059533,富邦金凱基99購01,2.05,2.18,2.05,2.15,+0.16,8.04,360000,64,758330,0,0,0,0,0,0,198000,260000,-62000,-62000
20200430,059534,國泰金凱基99購01,2.15,2.24,2.14,2.23,+0.21,10.4,168000,25,366660,0,0,0,0,0,0,80000,88000,-8000,-8000
20200430,059535,玉山金凱基99購01,2.95,3.04,2.95,3.04,+0.18,6.29,73000,16,217900,0,0,0,0,0,0,19000,60000,-41000,-41000
20200430,059536,新光金凱基99購05,1.77,1.79,1.74,1.79,+0.06,3.47,288000,14,506380,0,0,0,0,0,0,253000,35000,218000,218000
20200430,059537,大立光凱基99購09,2.16,2.21,2.16,2.21,+0.09,4.25,276000,4,609710,0,0,0,0,0,0,171000,105000,66000,66000
20200430,059538,健策凱基99購03,3.27,3.41,3.22,3.34,+0.13,4.05,25000,4,82770,0,0,0,0,0,0,22000,3000,19000,19000
20200430,059539,緯穎凱基99購03,1.69,1.84,1.69,1.84,+0.32,21.05,121000,9,208800,0,0,0,0,0,0,15000,92000,-77000,-77000
20200430,05953P,台積電國票98售02,,,,,0.00,0.00,0,0,0,0,0,0,0,0,0,0,0,0,0
20200430,059540,新光金日盛99購01,1.43,1.43,1.25,1.29,+0.07,5.74,67000,14,85180,0,0,0,0,0,0,0,44000,-44000,-44000
20200430,059541,T50正2康和99購01,3.90,4.01,3.90,4.01,+0.26,6.93,15000,6,59680,0,0,0,0,0,0,3000,12000,-9000,-9000
20200430,059542,聯發科亞東99購01,,,,,0.00,0.00,0,0,0,0,0,0,0,0,0,0,0,0,0
20200430,059543,可成亞東99購02,,,,,0.00,0.00,0,0,0,0,0,0,0,0,0,0,0,0,0
20200430,059544,創意亞東99購01,4.57,4.61,4.54,4.54,+0.35,8.35,12000,3,54580,0,0,0,0,0,0,10000,2000,8000,8000
20200430,059545,台灣50群益99購04,7.50,7.50,7.50,7.50,0.00,0.00,4000,1,30000,0,0,0,0,0,0,0,4000,-4000,-4000
20200430,059546,FBVIX群益99購03,,,,,0.00,0.00,0,0,0,0,0,0,0,0,0,0,0,0,0
20200430,059547,國巨群益99購11,,,,,0.00,0.00,0,0,0,0,0,0,0,0,0,0,0,0,0
20200430,059548,台積電群益99購10,2.65,2.65,2.65,2.65,-0.03,-1.12,5000,1,13250,0,0,0,0,0,0,5000,0,5000,5000
20200430,059549,台光電群益99購04,,,,,0.00,0.00,0,0,0,0,0,0,0,0,0,0,0,0,0
20200430,05954P,旺宏國票97售03,2.71,2.71,2.71,2.71,-0.31,-10.26,2000,2,5420,0,0,0,0,0,0,0,2000,-2000,-2000
20200430,059550,台灣50日盛99購02,,,,,0.00,0.00,0,0,0,0,0,0,0,0,0,0,0,0,0
20200430,059551,T50正2康和99購02,5.30,5.30,5.30,5.30,+0.50,10.42,10000,1,53000,0,0,0,0,0,0,10000,0,10000,10000
20200430,059552,台灣50凱基99購04,2.00,2.01,2.00,2.01,0.00,0.00,40000,3,80200,0,0,0,0,0,0,0,39000,-39000,-39000
20200430,059553,台灣50凱基99購05,,,,,0.00,0.00,0,0,0,0,0,0,0,0,0,0,0,0,0
20200430,059554,台灣50凱基99購08,,,,,0.00,0.00,0,0,0,0,0,0,0,0,0,0,0,0,0
20200430,059555,台灣50凱基9A購06,,,,,0.00,0.00,0,0,0,0,0,0,0,0,0,0,0,0,0
20200430,059556,台灣50凱基9A購07,,,,,0.00,0.00,0,0,0,0,0,0,0,0,0,0,0,0,0
20200430,059557,台灣50凱基9C購07,,,,,0.00,0.00,0,0,0,0,0,0,0,0,0,0,0,0,0
20200430,059558,T50正2凱基9C購03,,,,,0.00,0.00,0,0,0,0,0,0,0,0,0,0,0,0,0
20200430,059559,T50反1凱基99購07,0.28,0.28,0.26,0.26,-0.05,-16.13,953000,23,261060,0,0,0,0,0,0,380000,548000,-168000,-168000
20200430,05955P,台光電國票97售02,1.32,1.34,1.32,1.34,0.00,0.00,40000,4,53200,0,0,0,0,0,0,0,40000,-40000,-40000
20200430,059560,T50反1凱基99購08,0.24,0.25,0.23,0.24,-0.03,-11.11,1845000,37,445260,0,0,0,0,0,0,275000,1404000,-1129000,-1129000
20200430,059561,滬深2X凱基9C購05,,,,,0.00,0.00,0,0,0,0,0,0,0,0,0,0,0,0,0
20200430,059562,上銀凱基99購09,2.87,3.14,2.86,3.14,+0.35,12.54,76000,9,220660,0,0,0,0,0,0,67000,9000,58000,58000
20200430,059563,鴻海凱基9A購14,1.48,1.48,1.48,1.48,+0.04,2.78,4000,1,5920,0,0,0,0,0,0,4000,0,4000,4000
20200430,059564,鴻海凱基9A購15,,,,,0.00,0.00,0,0,0,0,0,0,0,0,0,0,0,0,0
20200430,059565,國巨凱基99購16,,,,,0.00,0.00,0,0,0,0,0,0,0,0,0,0,0,0,0
20200430,059566,台積電凱基9A購11,,,,,0.00,0.00,0,0,0,0,0,0,0,0,0,0,0,0,0
20200430,059567,台積電凱基9A購12,1.90,1.93,1.90,1.93,+0.06,3.21,4000,3,7630,0,0,0,0,0,0,0,2000,-2000,-2000
20200430,059568,台積電凱基9A購13,1.99,2.02,1.99,2.01,+0.04,2.03,5000,3,10000,0,0,0,0,0,0,3000,2000,1000,1000
20200430,059569,旺宏凱基99購09,,,,,0.00,0.00,0,0,0,0,0,0,0,0,0,0,0,0,0
20200430,05956P,漢唐國票96售02,,,,,0.00,0.00,0,0,0,0,0,0,0,0,0,0,0,0,0
20200430,059570,全新凱基99購04,2.32,2.33,2.32,2.33,-0.03,-1.27,25000,2,58200,0,0,0,0,0,0,25000,0,25000,25000
20200430,059571,奇力新凱基99購06,2.58,2.63,2.58,2.63,+0.13,5.2,21000,4,54680,0,0,0,0,0,0,0,21000,-21000,-21000
20200430,059572,華新科凱基99購08,2.74,2.74,2.74,2.74,+0.01,0.37,7000,2,19180,0,0,0,0,0,0,2000,5000,-3000,-3000
20200430,059573,健策凱基9A購02,,,,,0.00,0.00,0,0,0,0,0,0,0,0,0,0,0,0,0
20200430,059574,台表科凱基99購02,,,,,0.00,0.00,0,0,0,0,0,0,0,0,0,0,0,0,0
20200430,059575,臺股指凱基99購41,,,,,0.00,0.00,0,0,0,0,0,0,0,0,0,0,0,0,0
20200430,059576,臺股指凱基99購42,,,,,0.00,0.00,0,0,0,0,0,0,0,0,0,0,0,0,0
20200430,059577,旺宏元富99購04,,,,,0.00,0.00,0,0,0,0,0,0,0,0,0,0,0,0,0
20200430,059578,智邦元富99購02,4.94,5.10,4.94,4.99,+0.08,1.63,13000,4,65040,0,0,0,0,0,0,13000,10000,3000,3000
20200430,059579,聯發科元富99購06,,,,,0.00,0.00,0,0,0,0,0,0,0,0,0,0,0,0,0
20200430,05957P,友達國票97售04,,,,,0.00,0.00,0,0,0,0,0,0,0,0,0,0,0,0,0
20200430,059580,大立光元富99購07,3.71,4.07,3.69,4.07,+0.40,10.9,662000,58,2571660,0,0,0,0,0,0,333000,330000,3000,3000
20200430,059581,日月光元富99購02,3.23,3.45,3.21,3.45,+0.35,11.29,897000,48,2931320,0,0,0,0,0,0,409000,488000,-79000,-79000
20200430,059582,台灣50台新99購03,,,,,0.00,0.00,0,0,0,0,0,0,0,0,0,0,0,0,0
20200430,059583,台灣50元大01購10,,,,,0.00,0.00,0,0,0,0,0,0,0,0,0,0,0,0,0
20200430,059584,台灣50元大01購11,,,,,0.00,0.00,0,0,0,0,0,0,0,0,0,0,0,0,0
20200430,059585,台灣50元大9C購10,,,,,0.00,0.00,0,0,0,0,0,0,0,0,0,0,0,0,0
20200430,059586,上銀元大9A購02,9.00,9.45,9.00,9.45,+1.10,13.17,30000,6,272100,0,0,0,0,0,0,26000,4000,22000,22000
20200430,059587,華通元大9A購01,5.25,5.25,5.25,5.25,0.00,0.00,2000,1,10500,0,0,0,0,0,0,0,0,0,0
20200430,059588,鴻海元大99購32,4.63,4.67,4.63,4.63,+0.09,1.98,40000,5,185920,0,0,0,0,0,0,38000,0,38000,38000
20200430,059589,國巨元大9A購02,,,,,0.00,0.00,0,0,0,0,0,0,0,0,0,0,0,0,0
20200430,05958P,聯發科國票97售04,,,,,0.00,0.00,0,0,0,0,0,0,0,0,0,0,0,0,0
20200430,059590,台積電元大99購39,,,,,0.00,0.00,0,0,0,0,0,0,0,0,0,0,0,0,0
20200430,059591,台積電元大9A購04,,,,,0.00,0.00,0,0,0,0,0,0,0,0,0,0,0,0,0
20200430,059592,聯發科元大99購28,,,,,0.00,0.00,0,0,0,0,0,0,0,0,0,0,0,0,0
20200430,059593,聯發科元大99購29,,,,,0.00,0.00,0,0,0,0,0,0,0,0,0,0,0,0,0
20200430,059594,奇力新元大9B購01,,,,,0.00,0.00,0,0,0,0,0,0,0,0,0,0,0,0,0
20200430,059595,華新科元大9A購03,,,,,0.00,0.00,0,0,0,0,0,0,0,0,0,0,0,0,0
20200430,059596,大立光元大99購20,8.00,8.25,8.00,8.25,0.00,0.00,4000,2,32750,0,0,0,0,0,0,3000,1000,2000,2000
20200430,059597,大立光元大99購21,4.57,4.92,4.57,4.92,+0.46,10.31,34000,7,156620,0,0,0,0,0,0,32000,0,32000,32000
20200430,059598,欣興元大99購08,7.95,7.95,7.85,7.85,+0.30,3.97,10000,4,79100,0,0,0,0,0,0,10000,6000,4000,4000
20200430,059599,健策元大9B購02,9.30,9.30,9.30,9.30,0.00,0.00,1000,1,9300,0,0,0,0,0,0,1000,0,1000,1000
20200430,05959P,聯發科國票98售01,8.00,8.00,8.00,8.00,-0.70,-8.05,3000,1,24000,0,0,0,0,0,0,3000,0,3000,3000
20200430,059600,緯穎元大99購07,,,,,0.00,0.00,0,0,0,0,0,0,0,0,0,0,0,0,0
20200430,059601,臺股指元大9A購38,,,,,0.00,0.00,0,0,0,0,0,0,0,0,0,0,0,0,0
20200430,059602,臺股指元大9A購39,,,,,0.00,0.00,0,0,0,0,0,0,0,0,0,0,0,0,0
20200430,059603,臺股指元大9A購40,,,,,0.00,0.00,0,0,0,0,0,0,0,0,0,0,0,0,0
20200430,059604,臺股指元大9A購41,,,,,0.00,0.00,0,0,0,0,0,0,0,0,0,0,0,0,0
20200430,059605,臺股指元大9A購42,5.60,5.60,5.60,5.60,+0.05,0.9,12000,2,67200,0,0,0,0,0,0,12000,0,12000,12000
20200430,059606,上銀富邦9B購02,3.05,3.05,3.05,3.05,+0.59,23.98,10000,1,30500,0,0,0,0,0,0,10000,0,10000,10000
20200430,059607,台積電富邦9C購04,2.14,2.18,2.12,2.18,+0.14,6.86,138000,13,298430,0,0,0,0,0,0,112000,0,112000,112000
20200430,059608,聯發科富邦9B購04,2.72,2.80,2.72,2.80,+0.24,9.38,6000,3,16510,0,0,0,0,0,0,6000,0,6000,6000
20200430,059609,A50正2永豐99購01,,,,,0.00,0.00,0,0,0,0,0,0,0,0,0,0,0,0,0
20200430,05960P,欣興統一96售01,,,,,0.00,0.00,0,0,0,0,0,0,0,0,0,0,0,0,0
20200430,059610,上銀永豐99購02,2.52,2.95,2.52,2.94,+0.55,23.01,194000,22,510860,0,0,0,0,0,0,124000,85000,39000,39000
20200430,059611,台積電永豐99購05,2.22,2.26,2.22,2.26,+0.15,7.11,22000,3,49040,0,0,0,0,0,0,22000,0,22000,22000
20200430,059612,奇鋐永豐99購02,2.73,2.84,2.73,2.73,+0.13,5.0,49000,5,135450,0,0,0,0,0,0,40000,9000,31000,31000
20200430,059613,泰鼎永豐99購02,1.00,1.00,0.95,1.00,+0.01,1.01,164000,16,161790,0,0,0,0,0,0,82000,122000,-40000,-40000
20200430,059614,致新永豐99購01,2.56,2.69,2.51,2.61,+0.13,5.24,163000,16,421600,0,0,0,0,0,0,60000,103000,-43000,-43000
20200430,059615,台灣50群益99購05,,,,,0.00,0.00,0,0,0,0,0,0,0,0,0,0,0,0,0
20200430,059616,滬深2X群益01購04,4.45,4.48,4.45,4.48,+0.15,3.46,2000,2,8930,0,0,0,0,0,0,0,2000,-2000,-2000
20200430,059617,A50正2群益01購02,,,,,0.00,0.00,0,0,0,0,0,0,0,0,0,0,0,0,0
20200430,059618,台積電日盛99購01,3.49,3.56,3.41,3.56,+0.30,9.2,509000,45,1778690,0,0,0,0,0,0,342000,129000,213000,213000
20200430,059619,台積電日盛9A購04,4.53,4.69,4.53,4.69,+0.42,9.84,118000,7,539370,0,0,0,0,0,0,2000,116000,-114000,-114000
20200430,05961P,鴻海群益97售01,,,,,0.00,0.00,0,0,0,0,0,0,0,0,0,0,0,0,0
20200430,059620,聯發科日盛99購02,7.30,7.30,7.30,7.30,0.00,0.00,1000,1,7300,0,0,0,0,0,0,0,1000,-1000,-1000
20200430,059621,T50正2凱基9C購04,,,,,0.00,0.00,0,0,0,0,0,0,0,0,0,0,0,0,0
20200430,059622,上銀凱基99購10,2.09,2.09,2.09,2.09,+0.10,5.03,20000,2,41800,0,0,0,0,0,0,20000,0,20000,20000
20200430,059623,聯電凱基99購02,1.26,1.29,1.24,1.28,+0.06,4.92,210000,13,264740,0,0,0,0,0,0,54000,156000,-102000,-102000
20200430,059624,鴻海凱基01購01,1.29,1.31,1.29,1.31,+0.01,0.77,58000,4,75650,0,0,0,0,0,0,45000,13000,32000,32000
20200430,059625,國巨凱基99購17,2.40,2.41,2.40,2.41,+0.11,4.78,9000,2,21680,0,0,0,0,0,0,9000,0,9000,9000
20200430,059626,台積電凱基01購01,1.61,1.61,1.61,1.61,+0.06,3.87,215000,3,346150,0,0,0,0,0,0,0,215000,-215000,-215000
20200430,059627,旺宏凱基99購10,,,,,0.00,0.00,0,0,0,0,0,0,0,0,0,0,0,0,0
20200430,059628,智邦凱基99購04,2.14,2.14,1.98,1.98,-0.07,-3.41,38000,3,80040,0,0,0,0,0,0,38000,0,38000,38000
20200430,059629,友達凱基99購06,1.18,1.18,1.18,1.18,0.00,0.00,4000,1,4720,0,0,0,0,0,0,4000,0,4000,4000
20200430,05962P,大立光群益96售07,,,,,0.00,0.00,0,0,0,0,0,0,0,0,0,0,0,0,0
20200430,059630,美律凱基99購07,1.31,1.38,1.31,1.36,+0.07,5.43,156000,13,207780,0,0,0,0,0,0,80000,75000,5000,5000
20200430,059631,京元電凱基99購02,1.50,1.50,1.47,1.48,+0.03,2.07,110000,10,163400,0,0,0,0,0,0,58000,52000,6000,6000
20200430,059632,聯發科凱基01購01,1.85,1.92,1.85,1.92,+0.16,9.09,10000,3,18690,0,0,0,0,0,0,8000,2000,6000,6000
20200430,059633,聯發科凱基9A購07,2.30,2.30,2.30,2.30,+0.30,15.0,20000,1,46000,0,0,0,0,0,0,20000,0,20000,20000
20200430,059634,可成凱基99購07,1.56,1.56,1.52,1.52,-0.06,-3.8,30000,2,46600,0,0,0,0,0,0,0,30000,-30000,-30000
20200430,059635,華新科凱基9A購06,,,,,0.00,0.00,0,0,0,0,0,0,0,0,0,0,0,0,0
20200430,059636,宏達電凱基99購05,,,,,0.00,0.00,0,0,0,0,0,0,0,0,0,0,0,0,0
20200430,059637,大立光凱基01購01,0.99,1.05,0.99,1.05,+0.08,8.25,111000,15,114410,0,0,0,0,0,0,79000,32000,47000,47000
20200430,059638,大立光凱基99購11,2.09,2.16,2.09,2.16,+0.09,4.35,238000,4,513800,0,0,0,0,0,0,238000,0,238000,238000
20200430,059639,大立光凱基9A購06,1.26,1.34,1.26,1.34,+0.11,8.94,192000,10,255490,0,0,0,0,0,0,176000,16000,160000,160000
20200430,05963P,貿聯國票97售02,1.88,1.88,1.88,1.88,-0.27,-12.56,17000,1,31960,0,0,0,0,0,0,17000,0,17000,17000
20200430,059640,聯詠凱基99購04,1.34,1.40,1.34,1.39,+0.04,2.96,427000,18,587160,0,0,0,0,0,0,377000,43000,334000,334000
20200430,059641,群創凱基99購06,1.43,1.43,1.41,1.41,+0.03,2.17,62000,2,88060,0,0,0,0,0,0,30000,32000,-2000,-2000
20200430,059642,健策凱基99購04,3.00,3.00,2.93,2.93,-0.01,-0.34,20000,3,59330,0,0,0,0,0,0,19000,0,19000,19000
20200430,059643,日月光凱基99購02,1.88,1.94,1.88,1.94,+0.13,7.18,107000,8,204330,0,0,0,0,0,0,57000,50000,7000,7000
20200430,059644,茂林凱基99購03,,,,,0.00,0.00,0,0,0,0,0,0,0,0,0,0,0,0,0
20200430,059645,祥碩凱基99購05,2.13,2.13,1.82,1.84,-0.19,-9.36,215000,19,419030,0,0,0,0,0,0,187000,28000,159000,159000
20200430,059646,聯茂凱基99購06,1.30,1.31,1.26,1.31,+0.01,0.77,278000,16,356780,0,0,0,0,0,0,190000,138000,52000,52000
20200430,059647,超眾凱基99購04,1.24,1.30,1.24,1.24,-0.01,-0.8,313000,12,397070,0,0,0,0,0,0,158000,155000,3000,3000
20200430,059648,台表科凱基99購03,,,,,0.00,0.00,0,0,0,0,0,0,0,0,0,0,0,0,0
20200430,059649,矽力凱基99購02,2.34,2.34,2.34,2.34,-0.21,-8.24,1000,1,2340,0,0,0,0,0,0,1000,0,1000,1000
20200430,05964P,華通凱基96售06,,,,,0.00,0.00,0,0,0,0,0,0,0,0,0,0,0,0,0
20200430,059650,緯穎凱基99購04,1.42,1.63,1.39,1.58,+0.22,16.18,322000,16,477980,0,0,0,0,0,0,127000,195000,-68000,-68000
20200430,059651,台灣50元大99購06,,,,,0.00,0.00,0,0,0,0,0,0,0,0,0,0,0,0,0
20200430,059652,台灣50元大99購07,,,,,0.00,0.00,0,0,0,0,0,0,0,0,0,0,0,0,0
20200430,059653,台灣50元大99購08,,,,,0.00,0.00,0,0,0,0,0,0,0,0,0,0,0,0,0
20200430,059654,T50反1元大99購09,0.59,0.59,0.59,0.59,-0.06,-9.23,10000,1,5900,0,0,0,0,0,0,0,10000,-10000,-10000
20200430,059655,T50反1元大99購10,0.71,0.71,0.71,0.71,-0.08,-10.13,12000,1,8520,0,0,0,0,0,0,0,12000,-12000,-12000
20200430,059656,T50反1元大99購11,0.58,0.59,0.55,0.55,-0.07,-11.29,384000,27,219160,0,0,0,0,0,0,203000,160000,43000,43000
20200430,059657,華通元大99購09,13.40,14.00,13.40,14.00,+2.10,17.65,51000,6,693600,0,0,0,0,0,0,0,51000,-51000,-51000
20200430,059658,國巨元大9A購03,,,,,0.00,0.00,0,0,0,0,0,0,0,0,0,0,0,0,0
20200430,059659,旺宏元大9A購03,,,,,0.00,0.00,0,0,0,0,0,0,0,0,0,0,0,0,0
20200430,05965P,健策凱基96售05,,,,,0.00,0.00,0,0,0,0,0,0,0,0,0,0,0,0,0
20200430,059660,華新科元大9A購04,4.45,4.47,4.34,4.34,-0.11,-2.47,53000,4,233290,0,0,0,0,0,0,21000,32000,-11000,-11000
20200430,059661,大立光元大99購22,5.50,5.80,5.50,5.80,+0.50,9.43,81000,7,454250,0,0,0,0,0,0,66000,0,66000,66000
20200430,059662,旭富元大9C購01,6.95,6.95,6.70,6.75,+0.15,2.27,169000,10,1143050,0,0,0,0,0,0,15000,168000,-153000,-153000
20200430,059663,旭富元大9C購02,4.30,4.30,4.18,4.18,+0.03,0.72,98000,5,414200,0,0,0,0,0,0,48000,78000,-30000,-30000
20200430,059664,立積元大9C購01,,,,,0.00,0.00,0,0,0,0,0,0,0,0,0,0,0,0,0
20200430,059665,嘉聯益元大99購06,5.45,5.45,5.45,5.45,+0.25,4.81,45000,3,245250,0,0,0,0,0,0,0,45000,-45000,-45000
20200430,059666,台表科元大9B購01,8.20,8.20,8.10,8.20,0.00,0.00,7000,3,56900,0,0,0,0,0,0,2000,7000,-5000,-5000
20200430,059667,矽力元大99購01,6.40,6.40,5.65,5.85,-0.50,-7.87,23000,8,135050,0,0,0,0,0,0,2000,21000,-19000,-19000
20200430,059668,台灣50元富9B購04,,,,,0.00,0.00,0,0,0,0,0,0,0,0,0,0,0,0,0
20200430,059669,台灣50元富9B購05,4.17,4.17,4.14,4.15,+0.17,4.27,334000,7,1390300,0,0,0,0,0,0,299000,334000,-35000,-35000
20200430,05966P,矽力凱基96售03,,,,,0.00,0.00,0,0,0,0,0,0,0,0,0,0,0,0,0
20200430,059670,T50正2元富99購04,,,,,0.00,0.00,0,0,0,0,0,0,0,0,0,0,0,0,0
20200430,059671,滬深2X元富99購05,4.25,4.25,4.25,4.25,0.00,0.00,5000,1,21250,0,0,0,0,0,0,0,5000,-5000,-5000
20200430,059672,滬深2X元富99購06,3.20,3.20,3.20,3.20,+0.18,5.96,3000,1,9600,0,0,0,0,0,0,3000,0,3000,3000
20200430,059673,玉山金元富99購01,6.35,6.50,6.35,6.50,+0.30,4.84,110000,20,705500,0,0,0,0,0,0,37000,73000,-36000,-36000
20200430,059674,玉山金元富99購02,7.90,7.90,7.90,7.90,+0.20,2.6,3000,2,23700,0,0,0,0,0,0,3000,0,3000,3000
20200430,059675,大立光元富99購08,4.19,4.57,4.14,4.57,+0.58,14.54,854000,88,3719080,0,0,0,0,0,0,595000,250000,345000,345000
20200430,059676,台積電台新99購05,2.04,2.08,2.04,2.08,+0.08,4.0,70000,3,143400,0,0,0,0,0,0,20000,50000,-30000,-30000
20200430,059677,大立光台新99購01,,,,,0.00,0.00,0,0,0,0,0,0,0,0,0,0,0,0,0
20200430,059678,鴻海國泰9A購03,2.21,2.28,2.18,2.28,+0.14,6.54,192000,18,426520,0,0,0,0,0,0,54000,148000,-94000,-94000
20200430,059679,國巨國泰9B購03,3.90,3.90,3.90,3.90,0.00,0.00,10000,1,39000,0,0,0,0,0,0,0,0,0,0
20200430,05967P,臺股指麥證96售02,,,,,0.00,0.00,0,0,0,0,0,0,0,0,0,0,0,0,0
20200430,059680,台積電國泰9A購03,3.39,3.50,3.39,3.50,+0.25,7.69,519000,34,1785450,0,0,0,0,0,0,194000,183000,11000,11000
20200430,059681,華新科國泰9B購02,,,,,0.00,0.00,0,0,0,0,0,0,0,0,0,0,0,0,0
20200430,059682,可成富邦9A購01,,,,,0.00,0.00,0,0,0,0,0,0,0,0,0,0,0,0,0
20200430,059683,康控富邦9C購01,1.37,1.50,1.35,1.42,+0.23,19.33,322000,19,445700,0,0,0,0,0,0,68000,249000,-181000,-181000
20200430,059684,台灣50永豐99購09,,,,,0.00,0.00,0,0,0,0,0,0,0,0,0,0,0,0,0
20200430,059685,T50正2永豐99購02,2.81,2.96,2.81,2.96,+0.23,8.42,185000,8,533410,0,0,0,0,0,0,63000,122000,-59000,-59000
20200430,059686,上証2X永豐9A購01,,,,,0.00,0.00,0,0,0,0,0,0,0,0,0,0,0,0,0
20200430,059687,卜蜂永豐99購01,1.45,1.45,1.45,1.45,-0.05,-3.33,25000,2,36250,0,0,0,0,0,0,25000,0,25000,25000
20200430,059688,燿華永豐99購01,1.94,2.06,1.94,2.04,+0.09,4.62,231000,14,461990,0,0,0,0,0,0,151000,75000,76000,76000
20200430,059689,南亞科永豐99購02,2.21,2.21,2.16,2.17,+0.04,1.88,37000,4,80540,0,0,0,0,0,0,25000,12000,13000,13000
20200430,05968P,鴻海台新96售02,,,,,0.00,0.00,0,0,0,0,0,0,0,0,0,0,0,0,0
20200430,059690,建準永豐99購01,2.16,2.19,2.12,2.12,-0.22,-9.4,167000,7,358130,0,0,0,0,0,0,93000,137000,-44000,-44000
20200430,059691,大立光永豐99購02,1.50,1.65,1.50,1.65,+0.16,10.74,210000,16,330570,0,0,0,0,0,0,43000,167000,-124000,-124000
20200430,059692,聯詠永豐99購01,1.48,1.54,1.45,1.54,+0.04,2.67,117000,11,175130,0,0,0,0,0,0,57000,60000,-3000,-3000
20200430,059693,智原永豐99購01,2.17,2.19,2.16,2.16,+0.03,1.41,25000,5,54620,0,0,0,0,0,0,5000,21000,-16000,-16000
20200430,059694,創意永豐99購03,3.04,3.13,3.04,3.10,+0.06,1.97,13000,5,39840,0,0,0,0,0,0,8000,5000,3000,3000
20200430,059695,聯鈞永豐99購02,2.09,2.09,2.02,2.02,-0.06,-2.88,85000,4,172390,0,0,0,0,0,0,17000,68000,-51000,-51000
20200430,059696,立積永豐99購03,2.81,3.03,2.81,2.99,+0.23,8.33,45000,5,132850,0,0,0,0,0,0,0,45000,-45000,-45000
20200430,059697,上証2X凱基9A購03,,,,,0.00,0.00,0,0,0,0,0,0,0,0,0,0,0,0,0
20200430,059698,滬深2X凱基9A購02,3.55,3.55,3.50,3.50,+0.10,2.94,8000,2,28150,0,0,0,0,0,0,3000,5000,-2000,-2000
20200430,059699,華通凱基99購04,,,,,0.00,0.00,0,0,0,0,0,0,0,0,0,0,0,0,0
20200430,05969P,台積電台新96售04,0.85,0.86,0.76,0.76,0.00,0.00,390000,39,324900,0,0,0,0,0,0,390000,390000,0,0
20200430,059700,鴻海凱基9A購16,1.31,1.32,1.31,1.32,+0.01,0.76,9000,3,11810,0,0,0,0,0,0,0,9000,-9000,-9000
20200430,059701,國巨凱基9A購09,,,,,0.00,0.00,0,0,0,0,0,0,0,0,0,0,0,0,0
20200430,059702,台積電凱基9A購14,1.21,1.23,1.21,1.23,+0.06,5.13,39000,5,47750,0,0,0,0,0,0,34000,5000,29000,29000
20200430,059703,旺宏凱基99購11,,,,,0.00,0.00,0,0,0,0,0,0,0,0,0,0,0,0,0
20200430,059704,聯發科凱基9A購08,1.79,1.80,1.79,1.79,+0.12,7.19,13000,3,23280,0,0,0,0,0,0,12000,1000,11000,11000
20200430,059705,華新科凱基9A購07,2.52,2.52,2.52,2.52,+0.08,3.28,10000,1,25200,0,0,0,0,0,0,0,10000,-10000,-10000
20200430,059706,嘉晶凱基99購01,1.35,1.46,1.35,1.40,+0.07,5.26,285000,15,402610,0,0,0,0,0,0,0,255000,-255000,-255000
20200430,059707,健策凱基9A購03,3.25,3.25,3.25,3.25,+0.04,1.25,10000,1,32500,0,0,0,0,0,0,10000,0,10000,10000
20200430,059708,立積凱基9A購02,2.83,2.83,2.83,2.83,0.00,0.00,10000,1,28300,0,0,0,0,0,0,0,10000,-10000,-10000
20200430,059709,上証2X元大9C購01,2.20,2.20,2.17,2.17,+0.09,4.33,6000,2,13110,0,0,0,0,0,0,0,6000,-6000,-6000
20200430,05970P,超眾永豐96售03,,,,,0.00,0.00,0,0,0,0,0,0,0,0,0,0,0,0,0
20200430,059710,上証2X元大9C購02,,,,,0.00,0.00,0,0,0,0,0,0,0,0,0,0,0,0,0
20200430,059711,滬深2X元大9C購02,,,,,0.00,0.00,0,0,0,0,0,0,0,0,0,0,0,0,0
20200430,059712,滬深2X元大9C購03,2.05,2.05,2.00,2.00,0.00,0.00,2000,2,4050,0,0,0,0,0,0,0,2000,-2000,-2000
20200430,059713,滬深2X元大9C購04,1.80,1.80,1.78,1.78,+0.04,2.3,82000,3,147260,0,0,0,0,0,0,2000,80000,-78000,-78000
20200430,059714,A50正2元大9C購01,2.03,2.15,2.03,2.15,0.00,0.00,31000,5,64530,0,0,0,0,0,0,0,31000,-31000,-31000
20200430,059715,A50正2元大9C購02,,,,,0.00,0.00,0,0,0,0,0,0,0,0,0,0,0,0,0
20200430,059716,鴻海元大99購35,,,,,0.00,0.00,0,0,0,0,0,0,0,0,0,0,0,0,0
20200430,059717,國巨元大99購21,10.60,10.60,10.60,10.60,+0.40,3.92,10000,1,106000,0,0,0,0,0,0,10000,0,10000,10000
20200430,059718,國巨元大9A購04,,,,,0.00,0.00,0,0,0,0,0,0,0,0,0,0,0,0,0
20200430,059719,台積電元大99購42,6.85,7.00,6.85,6.95,+0.40,6.11,184000,6,1275750,0,0,0,0,0,0,180000,104000,76000,76000
20200430,05971P,世紀鋼永豐96售04,0.62,0.62,0.55,0.56,-0.08,-12.5,22000,3,12370,0,0,0,0,0,0,21000,1000,20000,20000
20200430,059720,台積電元大99購43,6.15,6.15,6.15,6.15,+0.20,3.36,30000,1,184500,0,0,0,0,0,0,0,30000,-30000,-30000
20200430,059721,旺宏元大99購16,12.10,12.10,11.80,11.80,+0.90,8.26,9000,7,108000,0,0,0,0,0,0,9000,9000,0,0
20200430,059722,南亞科元大99購02,8.25,8.25,7.90,8.00,+0.10,1.27,21000,6,170500,0,0,0,0,0,0,20000,1000,19000,19000
20200430,059723,美律元大9A購02,2.75,3.02,2.75,3.02,+0.31,11.44,161000,13,462640,0,0,0,0,0,0,74000,161000,-87000,-87000
20200430,059724,聯發科元大99購30,,,,,0.00,0.00,0,0,0,0,0,0,0,0,0,0,0,0,0
20200430,059725,聯發科元大99購31,,,,,0.00,0.00,0,0,0,0,0,0,0,0,0,0,0,0,0
20200430,059726,華新科元大99購18,,,,,0.00,0.00,0,0,0,0,0,0,0,0,0,0,0,0,0
20200430,059727,大立光元大9A購01,5.70,5.90,5.70,5.80,+0.35,6.42,37000,3,211800,0,0,0,0,0,0,37000,0,37000,37000
20200430,059728,聯鈞元大99購01,6.65,6.65,6.45,6.45,-0.10,-1.53,2000,2,13100,0,0,0,0,0,0,2000,2000,0,0
20200430,059729,群創元大9C購05,2.10,2.14,2.09,2.13,+0.09,4.41,199000,12,420390,0,0,0,0,0,0,37000,158000,-121000,-121000
20200430,05972P,瑞昱元大96售01,,,,,0.00,0.00,0,0,0,0,0,0,0,0,0,0,0,0,0
20200430,059730,晶相光元大9C購02,2.74,2.76,2.64,2.69,0.00,0.00,677000,28,1819600,0,0,0,0,0,0,121000,567000,-446000,-446000
20200430,059731,康控元大99購04,4.32,4.83,4.32,4.83,+0.53,12.33,122000,5,575760,0,0,0,0,0,0,114000,108000,6000,6000
20200430,059732,超眾元大9A購01,4.50,4.67,4.45,4.47,+0.05,1.13,77000,12,350340,0,0,0,0,0,0,13000,62000,-49000,-49000
20200430,059733,緯穎元大99購08,6.25,6.75,6.25,6.40,+0.90,16.36,39000,10,249000,0,0,0,0,0,0,24000,15000,9000,9000
20200430,059734,T50正2元富99購05,,,,,0.00,0.00,0,0,0,0,0,0,0,0,0,0,0,0,0
20200430,059735,T50反1元富99購06,0.56,0.56,0.56,0.56,0.00,0.00,10000,1,5600,0,0,0,0,0,0,0,10000,-10000,-10000
20200430,059736,T50反1元富99購07,,,,,0.00,0.00,0,0,0,0,0,0,0,0,0,0,0,0,0
20200430,059737,T50反1元富99購08,,,,,0.00,0.00,0,0,0,0,0,0,0,0,0,0,0,0,0
20200430,059738,上証2X元富99購01,3.01,3.16,3.01,3.16,0.00,0.00,3000,2,9180,0,0,0,0,0,0,0,3000,-3000,-3000
20200430,059739,華通元富99購04,2.92,2.92,2.91,2.91,+0.07,2.46,15000,2,43750,0,0,0,0,0,0,15000,0,15000,15000
20200430,05973P,聯詠元大96售06,2.79,2.79,2.79,2.79,-0.29,-9.42,50000,1,139500,0,0,0,0,0,0,0,50000,-50000,-50000
20200430,059740,瑞昱元富99購02,5.55,5.75,5.50,5.75,+0.50,9.52,74000,12,419550,0,0,0,0,0,0,27000,47000,-20000,-20000
20200430,059741,聯發科元富99購07,4.89,4.89,4.89,4.89,+0.38,8.43,1000,1,4890,0,0,0,0,0,0,1000,0,1000,1000
20200430,059742,富邦金元富99購01,4.04,4.23,3.99,4.20,+0.27,6.87,384000,61,1563720,0,0,0,0,0,0,180000,204000,-24000,-24000
20200430,059743,開發金元富99購01,2.11,2.15,2.11,2.15,+0.08,3.86,230000,25,491520,0,0,0,0,0,0,132000,98000,34000,34000
20200430,059744,禾伸堂元富99購02,,,,,0.00,0.00,0,0,0,0,0,0,0,0,0,0,0,0,0
20200430,059745,欣興元富99購04,,,,,0.00,0.00,0,0,0,0,0,0,0,0,0,0,0,0,0
20200430,059746,聯鈞元富99購03,,,,,0.00,0.00,0,0,0,0,0,0,0,0,0,0,0,0,0
20200430,059747,台達電台新99購01,2.21,2.34,2.14,2.32,+0.28,13.73,479000,54,1077890,0,0,0,0,0,0,256000,223000,33000,33000
20200430,059748,聯發科台新99購03,2.13,2.24,2.12,2.24,+0.30,15.46,257000,25,551840,0,0,0,0,0,0,165000,142000,23000,23000
20200430,059749,台灣50群益9A購04,,,,,0.00,0.00,0,0,0,0,0,0,0,0,0,0,0,0,0
20200430,05974P,國巨富邦97售03,0.55,0.55,0.55,0.55,-0.17,-23.61,24000,2,13200,0,0,0,0,0,0,24000,0,24000,24000
20200430,059750,台灣50群益9A購05,,,,,0.00,0.00,0,0,0,0,0,0,0,0,0,0,0,0,0
20200430,059751,華通群益9B購03,4.69,5.10,4.69,5.10,+0.74,16.97,103000,12,506980,0,0,0,0,0,0,77000,1000,76000,76000
20200430,059752,國巨群益9B購01,,,,,0.00,0.00,0,0,0,0,0,0,0,0,0,0,0,0,0
20200430,059753,貿聯群益99購06,4.65,4.65,4.65,4.65,+0.75,19.23,10000,1,46500,0,0,0,0,0,0,0,10000,-10000,-10000
20200430,059754,訊芯群益9A購01,2.89,3.05,2.86,3.05,+0.21,7.39,34000,7,98580,0,0,0,0,0,0,10000,14000,-4000,-4000
20200430,059755,宏達電國泰9A購01,2.26,2.30,2.26,2.30,+0.03,1.32,11000,2,25140,0,0,0,0,0,0,0,11000,-11000,-11000
20200430,059756,奇力新富邦9C購01,,,,,0.00,0.00,0,0,0,0,0,0,0,0,0,0,0,0,0
20200430,059757,上証2X永豐99購03,,,,,0.00,0.00,0,0,0,0,0,0,0,0,0,0,0,0,0
20200430,059758,滬深2X永豐99購05,,,,,0.00,0.00,0,0,0,0,0,0,0,0,0,0,0,0,0
20200430,059759,A50正2永豐99購02,,,,,0.00,0.00,0,0,0,0,0,0,0,0,0,0,0,0,0
20200430,05975P,國巨日盛99售02,0.94,0.94,0.94,0.94,0.00,0.00,6000,1,5640,0,0,0,0,0,0,6000,0,6000,6000
20200430,059760,楠梓電永豐99購01,1.58,1.68,1.56,1.61,+0.05,3.21,288000,56,462490,0,0,0,0,0,0,192000,98000,94000,94000
20200430,059761,國巨永豐99購06,,,,,0.00,0.00,0,0,0,0,0,0,0,0,0,0,0,0,0
20200430,059762,禾伸堂永豐99購02,2.48,2.48,2.41,2.41,+0.07,2.99,34000,4,82900,0,0,0,0,0,0,24000,10000,14000,14000
20200430,059763,華擎永豐99購03,1.76,1.76,1.74,1.74,+0.06,3.57,70000,2,122400,0,0,0,0,0,0,70000,0,70000,70000
20200430,059764,健策永豐99購04,,,,,0.00,0.00,0,0,0,0,0,0,0,0,0,0,0,0,0
20200430,059765,嘉聯益永豐99購02,1.68,1.73,1.67,1.73,+0.10,6.13,120000,10,202550,0,0,0,0,0,0,16000,104000,-88000,-88000
20200430,059766,同欣電永豐99購03,1.59,1.76,1.59,1.76,+0.22,14.29,383000,16,637190,0,0,0,0,0,0,0,375000,-375000,-375000
20200430,059767,矽力永豐99購01,1.96,1.96,1.74,1.82,-0.15,-7.61,893000,46,1633850,0,0,0,0,0,0,31000,862000,-831000,-831000
20200430,059768,上証2X群益9C購02,,,,,0.00,0.00,0,0,0,0,0,0,0,0,0,0,0,0,0
20200430,059769,滬深2X群益9C購01,2.92,2.93,2.92,2.93,+0.12,4.27,12000,2,35140,0,0,0,0,0,0,2000,10000,-8000,-8000
20200430,05976P,國巨凱基96售14,1.48,1.59,1.48,1.51,-0.23,-13.22,66000,7,100230,0,0,0,0,0,0,53000,13000,40000,40000
20200430,059770,A50正2群益9C購01,,,,,0.00,0.00,0,0,0,0,0,0,0,0,0,0,0,0,0
20200430,059771,台積電群益99購11,2.30,2.36,2.28,2.36,+0.18,8.26,358000,33,825120,0,0,0,0,0,0,249000,109000,140000,140000
20200430,059772,可成群益9A購05,3.49,3.50,3.33,3.48,-0.03,-0.85,26000,5,90290,0,0,0,0,0,0,3000,26000,-23000,-23000
20200430,059773,康控群益99購01,,,,,0.00,0.00,0,0,0,0,0,0,0,0,0,0,0,0,0
20200430,059774,臺股指群益99購21,,,,,0.00,0.00,0,0,0,0,0,0,0,0,0,0,0,0,0
20200430,059775,台灣50元大9C購16,,,,,0.00,0.00,0,0,0,0,0,0,0,0,0,0,0,0,0
20200430,059776,台灣50元大9C購17,4.35,4.35,4.35,4.35,0.00,0.00,5000,1,21750,0,0,0,0,0,0,5000,0,5000,5000
20200430,059777,台灣50元大9C購18,,,,,0.00,0.00,0,0,0,0,0,0,0,0,0,0,0,0,0
20200430,059778,上証2X元大9C購03,,,,,0.00,0.00,0,0,0,0,0,0,0,0,0,0,0,0,0
20200430,059779,滬深2X元大9C購05,,,,,0.00,0.00,0,0,0,0,0,0,0,0,0,0,0,0,0
20200430,05977P,旺宏永豐96售06,0.60,0.62,0.57,0.60,-0.15,-20.0,159000,8,92080,0,0,0,0,0,0,131000,28000,103000,103000
20200430,059780,滬深2X元大9C購06,,,,,0.00,0.00,0,0,0,0,0,0,0,0,0,0,0,0,0
20200430,059781,A50正2元大9C購03,,,,,0.00,0.00,0,0,0,0,0,0,0,0,0,0,0,0,0
20200430,059782,A50正2元大9C購04,2.09,2.18,2.09,2.10,+0.05,2.44,54000,9,114110,0,0,0,0,0,0,20000,34000,-14000,-14000
20200430,059783,旺宏元大99購17,11.20,11.20,10.90,11.00,+0.90,8.91,17000,12,188200,0,0,0,0,0,0,17000,14000,3000,3000
20200430,059784,台光電元大9A購01,5.55,6.05,5.55,6.05,+0.65,12.04,91000,16,518050,0,0,0,0,0,0,51000,82000,-31000,-31000
20200430,059785,美律元大9A購03,2.59,2.86,2.56,2.75,+0.18,7.0,140000,16,380920,0,0,0,0,0,0,72000,130000,-58000,-58000
20200430,059786,全新元大99購06,4.05,4.07,3.87,3.87,-0.01,-0.26,115000,11,460040,0,0,0,0,0,0,115000,5000,110000,110000
20200430,059787,奇力新元大9A購02,6.55,6.70,6.55,6.70,+0.45,7.2,28000,4,184500,0,0,0,0,0,0,10000,18000,-8000,-8000
20200430,059788,華新科元大9A購05,7.90,7.90,7.90,7.90,+0.10,1.28,1000,1,7900,0,0,0,0,0,0,1000,0,1000,1000
20200430,059789,貿聯元大9A購02,2.29,2.62,2.29,2.62,+0.42,19.09,235000,13,565340,0,0,0,0,0,0,44000,191000,-147000,-147000
20200430,05978P,麗豐永豐96售02,,,,,0.00,0.00,0,0,0,0,0,0,0,0,0,0,0,0,0
20200430,059790,立積元大9C購02,,,,,0.00,0.00,0,0,0,0,0,0,0,0,0,0,0,0,0
20200430,059791,超眾元大99購06,3.11,3.17,3.01,3.07,+0.09,3.02,132000,14,411380,0,0,0,0,0,0,70000,66000,4000,4000
20200430,059792,台灣50國票9A購09,,,,,0.00,0.00,0,0,0,0,0,0,0,0,0,0,0,0,0
20200430,059793,滬深2X國票99購03,2.35,2.35,2.35,2.35,0.00,0.00,10000,1,23500,0,0,0,0,0,0,0,10000,-10000,-10000
20200430,059794,滬深2X國票99購04,,,,,0.00,0.00,0,0,0,0,0,0,0,0,0,0,0,0,0
20200430,059795,鴻海國票99購07,2.81,2.81,2.81,2.81,0.00,0.00,11000,1,30910,0,0,0,0,0,0,0,11000,-11000,-11000
20200430,059796,台積電國票99購10,3.39,3.42,3.39,3.42,+0.08,2.4,8000,2,27240,0,0,0,0,0,0,4000,4000,0,0
20200430,059797,大立光國票99購01,3.37,3.37,3.37,3.37,0.00,0.00,4000,2,13480,0,0,0,0,0,0,0,4000,-4000,-4000
20200430,059798,臺股指國票99購21,,,,,0.00,0.00,0,0,0,0,0,0,0,0,0,0,0,0,0
20200430,059799,台灣50元富01購05,,,,,0.00,0.00,0,0,0,0,0,0,0,0,0,0,0,0,0
20200430,05979P,華新科中信96售02,0.44,0.46,0.44,0.44,-0.03,-6.38,35000,4,15600,0,0,0,0,0,0,10000,25000,-15000,-15000
20200430,059800,T50反1元富99購09,,,,,0.00,0.00,0,0,0,0,0,0,0,0,0,0,0,0,0
20200430,059801,T50反1元富99購10,1.59,1.59,1.59,1.59,-0.11,-6.47,7000,1,11130,0,0,0,0,0,0,7000,0,7000,7000
20200430,059802,上証2X元富99購02,,,,,0.00,0.00,0,0,0,0,0,0,0,0,0,0,0,0,0
20200430,059803,S&P正2元富9B購03,,,,,0.00,0.00,0,0,0,0,0,0,0,0,0,0,0,0,0
20200430,059804,台積電元富99購01,,,,,0.00,0.00,0,0,0,0,0,0,0,0,0,0,0,0,0
20200430,059805,台積電元富99購02,3.46,3.51,3.44,3.51,+0.20,6.04,135000,7,467400,0,0,0,0,0,0,115000,20000,95000,95000
20200430,059806,聯發科元富99購08,2.83,2.88,2.83,2.88,+0.29,11.2,35000,3,100250,0,0,0,0,0,0,30000,5000,25000,25000
20200430,059807,大立光元富99購09,2.36,2.62,2.36,2.61,+0.31,13.48,1711000,52,4358400,0,40000,-40000,0,0,0,872000,838000,34000,-6000
20200430,059808,創意元富99購01,,,,,0.00,0.00,0,0,0,0,0,0,0,0,0,0,0,0,0
20200430,059809,貿聯元富99購01,4.31,4.39,4.31,4.39,+0.55,14.32,8000,2,34560,0,0,0,0,0,0,8000,0,8000,8000
20200430,05980P,台積電永昌96售09,1.81,1.81,1.71,1.76,-0.26,-12.87,54000,4,94840,0,0,0,0,0,0,54000,30000,24000,24000
20200430,059810,台灣50台新99購04,,,,,0.00,0.00,0,0,0,0,0,0,0,0,0,0,0,0,0
20200430,059811,高股息凱基99購02,1.91,1.93,1.91,1.93,0.00,0.00,22000,4,42140,0,0,0,0,0,0,17000,5000,12000,12000
20200430,059812,上証2X凱基9A購04,,,,,0.00,0.00,0,0,0,0,0,0,0,0,0,0,0,0,0
20200430,059813,滬深2X凱基9B購01,,,,,0.00,0.00,0,0,0,0,0,0,0,0,0,0,0,0,0
20200430,059814,SP黃豆凱基9A購02,1.59,1.59,1.56,1.57,+0.08,5.37,854000,14,1355540,0,0,0,0,0,0,650000,194000,456000,456000
20200430,059815,SP黃豆凱基9A購03,1.05,1.05,1.04,1.04,+0.06,6.12,138000,7,143930,0,0,0,0,0,0,138000,0,138000,138000
20200430,059816,聯電凱基99購03,1.34,1.36,1.34,1.36,+0.06,4.62,248000,14,336660,0,0,0,0,0,0,132000,110000,22000,22000
20200430,059817,華通凱基99購05,2.25,2.37,2.25,2.37,+0.11,4.87,65000,7,147800,0,0,0,0,0,0,55000,10000,45000,45000
20200430,059818,鴻海凱基99購14,0.89,0.91,0.89,0.91,+0.03,3.41,30000,3,27200,0,0,0,0,0,0,25000,5000,20000,20000
20200430,059819,台積電凱基99購17,0.89,0.91,0.89,0.90,+0.05,5.88,150000,11,134700,0,0,0,0,0,0,70000,69000,1000,1000
20200430,05981P,可成永昌98售02,1.76,1.76,1.76,1.76,0.00,0.00,50000,1,88000,0,0,0,0,0,0,50000,50000,0,0
20200430,059820,南亞科凱基99購07,1.59,1.59,1.56,1.56,+0.03,1.96,95000,13,149710,0,0,0,0,0,0,67000,28000,39000,39000
20200430,059821,美律凱基99購08,1.21,1.32,1.21,1.32,+0.10,8.2,207000,8,252460,0,0,0,0,0,0,171000,36000,135000,135000
20200430,059822,聯發科凱基99購19,1.13,1.19,1.12,1.19,+0.13,12.26,199000,7,224890,0,0,0,0,0,0,183000,6000,177000,177000
20200430,059823,奇力新凱基99購07,2.09,2.11,2.09,2.11,+0.07,3.43,46000,5,96540,0,0,0,0,0,0,0,46000,-46000,-46000
20200430,059824,大立光凱基99購13,0.90,0.95,0.90,0.95,+0.09,10.47,31000,6,28390,0,0,0,0,0,0,31000,0,31000,31000
20200430,059825,嘉晶凱基99購02,1.17,1.25,1.16,1.22,+0.09,7.96,175000,7,214160,0,0,0,0,0,0,99000,76000,23000,23000
20200430,059826,欣興凱基99購06,2.20,2.22,2.20,2.22,0.00,0.00,3000,2,6620,0,0,0,0,0,0,0,3000,-3000,-3000
20200430,059827,晶技凱基99購03,2.57,2.59,2.57,2.59,0.00,0.00,32000,4,82580,0,0,0,0,0,0,0,30000,-30000,-30000
20200430,059828,健策凱基99購05,2.90,3.03,2.90,3.03,+0.12,4.12,13000,4,38430,0,0,0,0,0,0,4000,9000,-5000,-5000
20200430,059829,超眾凱基99購05,1.17,1.22,1.16,1.19,+0.03,2.59,183000,10,219560,0,0,0,0,0,0,15000,168000,-153000,-153000
20200430,05982P,漢唐國票96售03,2.17,2.17,2.17,2.17,0.00,0.00,17000,1,36890,0,0,0,0,0,0,0,17000,-17000,-17000
20200430,059830,台郡凱基99購05,1.38,1.40,1.34,1.40,+0.03,2.19,644000,24,873430,0,0,0,0,0,0,436000,174000,262000,262000
20200430,059831,聯詠康和99購01,1.84,1.90,1.82,1.90,+0.03,1.6,557000,26,1026720,0,0,0,0,0,0,522000,30000,492000,492000
20200430,059832,超眾康和99購01,,,,,0.00,0.00,0,0,0,0,0,0,0,0,0,0,0,0,0
20200430,059833,緯穎康和99購01,2.22,2.22,2.22,2.22,0.00,0.00,5000,1,11100,0,0,0,0,0,0,0,5000,-5000,-5000
20200430,059834,友達國泰9B購01,2.31,2.31,2.31,2.31,+0.04,1.76,62000,3,143220,0,0,0,0,0,0,32000,0,32000,32000
20200430,059835,聯發科國泰9B購01,3.19,3.32,3.19,3.32,+0.34,11.41,293000,14,955590,0,0,0,0,0,0,293000,250000,43000,43000
20200430,059836,大立光國泰9B購02,2.23,2.45,2.23,2.45,+0.26,11.87,499000,16,1176360,0,1000,-1000,0,0,0,100000,400000,-300000,-301000
20200430,059837,健策國泰9B購01,,,,,0.00,0.00,0,0,0,0,0,0,0,0,0,0,0,0,0
20200430,059838,茂林國泰9B購01,,,,,0.00,0.00,0,0,0,0,0,0,0,0,0,0,0,0,0
20200430,059839,T50反1富邦99購02,,,,,0.00,0.00,0,0,0,0,0,0,0,0,0,0,0,0,0
20200430,05983P,聯詠國票96售02,2.95,2.95,2.95,2.95,0.00,0.00,25000,1,73750,0,0,0,0,0,0,0,25000,-25000,-25000
20200430,059840,鴻海富邦9A購02,1.71,1.71,1.70,1.71,+0.03,1.79,181000,12,308710,0,0,0,0,0,0,146000,35000,111000,111000
20200430,059841,國巨富邦9C購01,1.62,1.69,1.60,1.65,+0.06,3.77,3179000,105,5168580,0,0,0,0,0,0,1980000,861000,1119000,1119000
20200430,059842,台積電富邦9C購05,1.02,1.03,1.01,1.03,+0.03,3.0,80000,5,81790,0,0,0,0,0,0,80000,0,80000,80000
20200430,059843,華新科富邦9B購03,,,,,0.00,0.00,0,0,0,0,0,0,0,0,0,0,0,0,0
20200430,059844,大立光富邦9C購04,0.92,0.97,0.91,0.97,+0.09,10.23,83000,9,78800,0,0,0,0,0,0,80000,3000,77000,77000
20200430,059845,欣興富邦9A購02,2.15,2.26,2.13,2.16,+0.05,2.37,718000,91,1548390,0,0,0,0,0,0,633000,77000,556000,556000
20200430,059846,力山永豐99購01,3.82,3.82,3.70,3.70,0.00,0.00,5000,2,18740,0,0,0,0,0,0,3000,2000,1000,1000
20200430,059847,喬山永豐99購01,2.28,2.68,2.28,2.62,+0.37,16.44,273000,27,678070,0,0,0,0,0,0,34000,239000,-205000,-205000
20200430,059848,智邦永豐99購01,2.34,2.44,2.21,2.21,-0.10,-4.33,225000,22,525640,0,0,0,0,0,0,189000,69000,120000,120000
20200430,059849,興勤永豐99購01,1.27,1.34,1.26,1.33,+0.05,3.91,531000,17,684330,0,0,0,0,0,0,430000,91000,339000,339000
20200430,05984P,台積電統一98售01,1.39,1.39,1.39,1.39,0.00,0.00,170000,17,236300,0,0,0,0,0,0,170000,170000,0,0
20200430,059850,日電貿永豐99購01,1.97,2.05,1.97,2.05,+0.10,5.13,82000,9,166900,0,0,0,0,0,0,1000,81000,-80000,-80000
20200430,059851,晶相光永豐99購02,1.74,1.75,1.68,1.72,-0.07,-3.91,170000,13,295300,0,0,0,0,0,0,164000,13000,151000,151000
20200430,059852,康控永豐99購02,2.00,2.18,2.00,2.18,+0.32,17.2,399000,20,840160,0,0,0,0,0,0,237000,183000,54000,54000
20200430,059853,超眾永豐99購03,1.19,1.25,1.18,1.18,+0.02,1.72,226000,10,270840,0,0,0,0,0,0,31000,195000,-164000,-164000
20200430,059854,台表科永豐99購03,2.27,2.27,2.25,2.25,0.00,0.00,5000,3,11270,0,0,0,0,0,0,1000,5000,-4000,-4000
20200430,059855,緯穎永豐99購04,1.15,1.35,1.15,1.35,+0.27,25.0,158000,8,199880,0,0,0,0,0,0,131000,27000,104000,104000
20200430,059856,昇陽半永豐99購03,1.60,1.62,1.57,1.58,+0.11,7.48,130000,8,206610,0,0,0,0,0,0,0,130000,-130000,-130000
20200430,059857,台灣50群益99購06,,,,,0.00,0.00,0,0,0,0,0,0,0,0,0,0,0,0,0
20200430,059858,台灣50群益9A購09,4.19,4.27,4.19,4.27,+0.37,9.49,37000,2,157430,0,0,0,0,0,0,30000,7000,23000,23000
20200430,059859,國巨群益9A購03,4.99,4.99,4.99,4.99,0.00,0.00,12000,2,59880,0,0,0,0,0,0,0,12000,-12000,-12000
20200430,05985P,燿華統一96售03,,,,,0.00,0.00,0,0,0,0,0,0,0,0,0,0,0,0,0
20200430,059860,台積電群益9A購02,4.53,4.62,4.51,4.62,+0.19,4.29,85000,10,385140,0,0,0,0,0,0,69000,17000,52000,52000
20200430,059861,聯發科群益9A購01,4.32,4.42,4.32,4.42,+0.46,11.62,151000,13,665840,0,0,0,0,0,0,19000,135000,-116000,-116000
20200430,059862,全新群益99購04,1.44,1.44,1.44,1.44,+0.02,1.41,24000,2,34560,0,0,0,0,0,0,24000,0,24000,24000
20200430,059863,和大凱基99購01,1.71,1.78,1.71,1.78,+0.18,11.25,136000,9,237880,0,0,0,0,0,0,78000,58000,20000,20000
20200430,059864,亞德客凱基99購01,1.84,2.15,1.77,2.11,+0.38,21.97,89000,14,166300,0,0,0,0,0,0,54000,31000,23000,23000
20200430,059865,國巨凱基01購01,1.65,1.65,1.42,1.47,+0.09,6.52,655000,58,950780,0,0,0,0,0,0,233000,382000,-149000,-149000
20200430,059866,國巨凱基99購18,1.84,1.84,1.79,1.79,+0.04,2.29,230000,3,415700,0,0,0,0,0,0,230000,0,230000,230000
20200430,059867,華邦電凱基99購02,1.40,1.49,1.40,1.47,+0.11,8.09,175000,13,255390,0,0,0,0,0,0,45000,160000,-115000,-115000
20200430,059868,台光電凱基99購03,1.34,1.45,1.32,1.45,+0.15,11.54,74000,10,101870,0,0,0,0,0,0,42000,34000,8000,8000
20200430,059869,友達凱基99購07,1.08,1.10,1.08,1.09,+0.01,0.93,29000,10,31520,0,0,0,0,0,0,14000,14000,0,0
20200430,05986P,大立光統一97售03,2.37,2.37,2.37,2.37,0.00,0.00,8000,1,18960,0,0,0,0,0,0,8000,0,8000,8000
20200430,059870,全新凱基99購05,1.09,1.09,1.06,1.06,+0.01,0.95,224000,19,242100,0,0,0,0,0,0,222000,0,222000,222000
20200430,059871,義隆凱基99購03,1.25,1.35,1.23,1.31,+0.06,4.8,539000,21,681050,0,0,0,0,0,0,337000,213000,124000,124000
20200430,059872,華新科凱基01購01,1.29,1.32,1.28,1.29,+0.02,1.57,433000,26,561800,0,0,0,0,0,0,117000,301000,-184000,-184000
20200430,059873,華新科凱基99購09,1.58,1.58,1.54,1.54,-0.01,-0.65,25000,2,39300,0,0,0,0,0,0,0,25000,-25000,-25000
20200430,059874,大立光凱基99購15,0.81,0.81,0.81,0.81,+0.07,9.46,21000,2,17010,0,0,0,0,0,0,20000,1000,19000,19000
20200430,059875,信邦凱基99購02,1.62,1.62,1.53,1.57,-0.06,-3.68,492000,37,777640,0,0,0,0,0,0,184000,302000,-118000,-118000
20200430,059876,智易凱基99購02,1.36,1.36,1.33,1.34,-0.01,-0.74,329000,27,443940,0,0,0,0,0,0,283000,46000,237000,237000
20200430,059877,康控凱基99購05,1.85,1.98,1.85,1.98,+0.20,11.24,12000,2,22850,0,0,0,0,0,0,12000,0,12000,12000
20200430,059878,聯茂凱基99購07,1.22,1.22,1.18,1.22,-0.01,-0.81,66000,12,79490,0,0,0,0,0,0,35000,54000,-19000,-19000
20200430,059879,GIS凱基99購03,1.61,1.62,1.58,1.60,+0.01,0.63,167000,16,266740,0,0,0,0,0,0,159000,8000,151000,151000
20200430,05987P,健策統一96售02,,,,,0.00,0.00,0,0,0,0,0,0,0,0,0,0,0,0,0
20200430,059880,世紀鋼凱基99購02,1.01,1.06,1.01,1.05,+0.06,6.06,80000,6,84080,0,0,0,0,0,0,0,80000,-80000,-80000
20200430,059881,臺股指凱基99購46,2.17,2.29,2.13,2.29,+0.22,10.63,19000,5,41920,0,0,0,0,0,0,17000,2000,15000,15000
20200430,059882,臺股指凱基9C購06,1.73,1.85,1.73,1.85,+0.18,10.78,477000,21,872500,0,0,0,0,0,0,260000,217000,43000,43000
20200430,059883,T50反1國票99購02,0.73,0.73,0.68,0.69,-0.10,-12.66,246000,7,173630,0,0,0,0,0,0,107000,139000,-32000,-32000
20200430,059884,鴻海國票99購09,2.11,2.14,2.11,2.14,0.00,0.00,52000,2,109780,0,0,0,0,0,0,50000,2000,48000,48000
20200430,059885,台積電國票99購12,4.82,4.82,4.79,4.79,+0.30,6.68,21000,5,100740,0,0,0,0,0,0,5000,21000,-16000,-16000
20200430,059886,可成國票99購04,3.01,3.01,2.83,2.86,-0.14,-4.67,22000,4,63150,0,0,0,0,0,0,22000,22000,0,0
20200430,059887,華新科國票99購02,12.30,12.30,12.20,12.20,0.00,0.00,20000,2,245000,0,0,0,0,0,0,0,20000,-20000,-20000
20200430,059888,華新科國票99購03,,,,,0.00,0.00,0,0,0,0,0,0,0,0,0,0,0,0,0
20200430,059889,華新科國票99購04,,,,,0.00,0.00,0,0,0,0,0,0,0,0,0,0,0,0,0
20200430,05988P,光磊元富96售02,,,,,0.00,0.00,0,0,0,0,0,0,0,0,0,0,0,0,0
20200430,059890,大立光國票99購03,,,,,0.00,0.00,0,0,0,0,0,0,0,0,0,0,0,0,0
20200430,059891,臺股指國票99購25,6.40,6.40,6.40,6.40,0.00,0.00,2000,1,12800,0,0,0,0,0,0,0,2000,-2000,-2000
20200430,059892,台灣50台新9A購02,,,,,0.00,0.00,0,0,0,0,0,0,0,0,0,0,0,0,0
20200430,059893,台積電台新9A購02,,,,,0.00,0.00,0,0,0,0,0,0,0,0,0,0,0,0,0
20200430,059894,台灣50元大9C購19,,,,,0.00,0.00,0,0,0,0,0,0,0,0,0,0,0,0,0
20200430,059895,T50反1元大99購12,,,,,0.00,0.00,0,0,0,0,0,0,0,0,0,0,0,0,0
20200430,059896,T50反1元大99購13,0.84,0.84,0.84,0.84,0.00,0.00,15000,1,12600,0,0,0,0,0,0,15000,0,15000,15000
20200430,059897,T50反1元大99購14,0.87,0.87,0.87,0.87,0.00,0.00,50000,1,43500,0,0,0,0,0,0,0,50000,-50000,-50000
20200430,059898,T50反1元大99購15,0.95,0.95,0.90,0.90,-0.09,-9.09,60000,7,55450,0,0,0,0,0,0,0,60000,-60000,-60000
20200430,059899,上証2X元大9C購04,2.39,2.39,2.35,2.35,+0.06,2.62,5000,5,11870,0,0,0,0,0,0,0,5000,-5000,-5000
20200430,05989P,健策元富96售01,,,,,0.00,0.00,0,0,0,0,0,0,0,0,0,0,0,0,0
20200430,059900,上証反元大99購03,,,,,0.00,0.00,0,0,0,0,0,0,0,0,0,0,0,0,0
20200430,059901,滬深2X元大9C購07,1.68,1.72,1.68,1.69,+0.10,6.29,75000,6,127050,0,0,0,0,0,0,0,75000,-75000,-75000
20200430,059902,滬深2X元大9C購08,1.92,1.92,1.92,1.92,0.00,0.00,3000,1,5760,0,0,0,0,0,0,0,3000,-3000,-3000
20200430,059903,S&P正2元大99購02,1.95,2.01,1.95,2.01,+0.17,9.24,38000,4,75010,0,0,0,0,0,0,3000,35000,-32000,-32000
20200430,059904,A50正2元大9C購05,2.26,2.26,2.26,2.26,0.00,0.00,1000,1,2260,0,0,0,0,0,0,0,1000,-1000,-1000
20200430,059905,A50正2元大9C購06,1.66,1.72,1.65,1.72,+0.12,7.5,586000,4,972910,0,0,0,0,0,0,583000,3000,580000,580000
20200430,059906,臺指反元大9C購04,,,,,0.00,0.00,0,0,0,0,0,0,0,0,0,0,0,0,0
20200430,059907,道瓊指元大99購03,2.31,2.35,2.31,2.35,+0.13,5.86,1005000,8,2326070,0,0,0,0,0,0,0,1005000,-1005000,-1005000
20200430,059908,元金2X元大99購01,1.76,1.76,1.76,1.76,-0.02,-1.12,13000,4,22880,0,0,0,0,0,0,5000,8000,-3000,-3000
20200430,059909,鴻海元大99購36,1.89,1.89,1.89,1.89,+0.04,2.16,1000,1,1890,0,0,0,0,0,0,1000,0,1000,1000
20200430,05990P,台積電群益96售13,6.85,6.85,6.55,6.55,-0.95,-12.67,264000,11,1770700,0,0,0,0,0,0,124000,140000,-16000,-16000
20200430,059910,鴻海元大99購37,3.56,3.64,3.56,3.64,+0.18,5.2,9000,5,32520,0,0,0,0,0,0,3000,6000,-3000,-3000
20200430,059911,國巨元大99購27,3.00,3.14,3.00,3.07,+0.19,6.6,662000,31,2017820,0,0,0,0,0,0,588000,573000,15000,15000
20200430,059912,國巨元大99購28,6.10,6.10,5.90,6.00,+0.15,2.56,57000,7,343900,0,0,0,0,0,0,8000,49000,-41000,-41000
20200430,059913,台積電元大99購44,2.22,2.22,2.21,2.22,+0.10,4.72,35000,5,77650,0,0,0,0,0,0,15000,19000,-4000,-4000
20200430,059914,台積電元大99購47,2.32,2.40,2.32,2.40,+0.14,6.19,71000,8,165870,0,0,0,0,0,0,7000,64000,-57000,-57000
20200430,059915,聯發科元大99購32,2.58,2.62,2.52,2.59,+0.22,9.28,390000,27,993910,0,0,0,0,0,0,375000,323000,52000,52000
20200430,059916,聯發科元大99購33,2.42,2.46,2.39,2.44,+0.22,9.91,77000,9,185680,0,0,0,0,0,0,67000,12000,55000,55000
20200430,059917,華新科元大99購19,4.21,4.21,4.16,4.16,-0.12,-2.8,12000,2,50270,0,0,0,0,0,0,7000,5000,2000,2000
20200430,059918,華新科元大99購20,2.84,2.84,2.72,2.77,-0.05,-1.77,55000,7,152330,0,0,0,0,0,0,27000,28000,-1000,-1000
20200430,059919,宏達電元大99購06,,,,,0.00,0.00,0,0,0,0,0,0,0,0,0,0,0,0,0
20200430,05991P,聯茂群益96售05,,,,,0.00,0.00,0,0,0,0,0,0,0,0,0,0,0,0,0
20200430,059920,宏達電元大99購07,2.66,2.68,2.60,2.60,-0.06,-2.26,70000,5,184100,0,0,0,0,0,0,0,70000,-70000,-70000
20200430,059921,大立光元大99購24,1.94,2.11,1.94,2.11,+0.21,11.05,80000,13,162700,0,0,0,0,0,0,22000,58000,-36000,-36000
20200430,059922,大立光元大99購25,1.46,1.60,1.46,1.60,+0.18,12.68,589000,33,915890,0,0,0,0,0,0,363000,226000,137000,137000
20200430,059923,緯穎元大99購09,3.30,3.86,3.30,3.72,+0.54,16.98,147000,24,516050,0,0,0,0,0,0,29000,144000,-115000,-115000
20200430,059924,世紀鋼元大99購06,2.31,2.44,2.31,2.42,+0.15,6.61,146000,15,347500,0,0,0,0,0,0,7000,139000,-132000,-132000
20200430,059925,可成國泰9B購01,3.06,3.06,2.97,2.98,-0.01,-0.33,42000,4,126510,0,0,0,0,0,0,25000,18000,7000,7000
20200430,059926,世紀鋼國泰9B購01,2.17,2.27,2.17,2.27,+0.09,4.13,447000,9,987960,0,0,0,0,0,0,200000,247000,-47000,-47000
20200430,059927,台灣50富邦9A購01,,,,,0.00,0.00,0,0,0,0,0,0,0,0,0,0,0,0,0
20200430,059928,道瓊銀富邦03購01,,,,,0.00,0.00,0,0,0,0,0,0,0,0,0,0,0,0,0
20200430,059929,華新科富邦9C購03,,,,,0.00,0.00,0,0,0,0,0,0,0,0,0,0,0,0,0
20200430,05992P,華通元大96售05,,,,,0.00,0.00,0,0,0,0,0,0,0,0,0,0,0,0,0
20200430,059930,健策富邦9B購01,2.61,2.69,2.58,2.64,+0.09,3.53,172000,18,452450,0,0,0,0,0,0,126000,96000,30000,30000
20200430,059931,緯穎富邦9A購01,0.65,0.77,0.65,0.75,+0.12,19.05,96000,11,67990,0,0,0,0,0,0,83000,13000,70000,70000
20200430,059932,世紀鋼富邦9A購02,0.64,0.67,0.62,0.67,+0.06,9.84,948000,14,619280,0,0,0,0,0,0,144000,685000,-541000,-541000
20200430,059933,台灣50永豐99購11,,,,,0.00,0.00,0,0,0,0,0,0,0,0,0,0,0,0,0
20200430,059934,華通永豐99購02,1.67,1.84,1.67,1.83,+0.24,15.09,56000,11,98930,0,0,0,0,0,0,38000,23000,15000,15000
20200430,059935,國巨永豐99購07,1.85,1.85,1.78,1.78,+0.02,1.14,20000,2,36300,0,0,0,0,0,0,10000,10000,0,0
20200430,059936,台積電永豐99購06,1.03,1.03,1.03,1.03,0.00,0.00,2000,1,2060,0,0,0,0,0,0,2000,0,2000,2000
20200430,059937,旺宏永豐99購03,1.73,1.76,1.69,1.69,+0.14,9.03,787000,16,1339590,0,0,0,0,0,0,570000,226000,344000,344000
20200430,059938,凱美永豐99購01,1.51,1.59,1.48,1.50,+0.03,2.04,219000,13,335270,0,0,0,0,0,0,10000,209000,-199000,-199000
20200430,059939,技嘉永豐99購01,1.42,1.42,1.42,1.42,0.00,0.00,16000,1,22720,0,0,0,0,0,0,16000,0,16000,16000
20200430,05993P,國巨元大96售13,,,,,0.00,0.00,0,0,0,0,0,0,0,0,0,0,0,0,0
20200430,059940,微星永豐99購01,1.30,1.30,1.29,1.29,+0.03,2.38,149000,4,193550,0,0,0,0,0,0,0,149000,-149000,-149000
20200430,059941,聯發科永豐99購04,,,,,0.00,0.00,0,0,0,0,0,0,0,0,0,0,0,0,0
20200430,059942,全新永豐99購04,1.42,1.42,1.39,1.39,-0.07,-4.79,57000,4,79440,0,0,0,0,0,0,57000,0,57000,57000
20200430,059943,信邦永豐99購01,1.31,1.32,1.24,1.27,-0.04,-3.05,243000,16,310410,0,0,0,0,0,0,201000,40000,161000,161000
20200430,059944,欣興永豐99購03,1.96,2.05,1.94,1.96,+0.09,4.81,657000,26,1295280,0,0,0,0,0,0,456000,196000,260000,260000
20200430,059945,嘉澤永豐99購03,1.32,1.46,1.31,1.46,+0.20,15.87,1368000,70,1871670,0,0,0,0,0,0,899000,489000,410000,410000
20200430,059946,健策永豐99購05,2.36,2.36,2.36,2.36,+0.06,2.61,25000,5,59000,0,0,0,0,0,0,1000,25000,-24000,-24000
20200430,059947,貿聯永豐99購03,1.57,1.80,1.57,1.80,+0.32,21.62,181000,19,303910,0,0,0,0,0,0,0,181000,-181000,-181000
20200430,059948,正文永豐99購01,1.08,1.12,1.08,1.11,-0.01,-0.89,123000,5,136130,0,0,0,0,0,0,93000,30000,63000,63000
20200430,059949,啟碁永豐99購01,1.66,1.66,1.64,1.64,0.00,0.00,83000,7,136440,0,0,0,0,0,0,23000,60000,-37000,-37000
20200430,05994P,奇鋐元大96售02,0.39,0.42,0.37,0.39,-0.04,-9.3,208000,15,81810,0,0,0,0,0,0,30000,168000,-138000,-138000
20200430,059950,百和永豐99購02,1.83,1.83,1.75,1.78,-0.08,-4.3,276000,18,495120,0,0,0,0,0,0,268000,10000,258000,258000
20200430,059951,台塑康和99購01,2.02,2.32,2.02,2.32,+0.34,17.17,134000,19,290090,0,0,0,0,0,0,35000,99000,-64000,-64000
20200430,059952,旺宏康和99購01,,,,,0.00,0.00,0,0,0,0,0,0,0,0,0,0,0,0,0
20200430,059953,聯發科康和99購01,2.75,2.91,2.75,2.91,+0.40,15.94,27000,10,77030,0,0,0,0,0,0,22000,15000,7000,7000
20200430,059954,華新科康和99購01,3.44,3.48,3.44,3.48,+0.15,4.5,18000,2,62440,0,0,0,0,0,0,18000,0,18000,18000
20200430,059955,美食康和99購01,2.39,2.85,2.39,2.83,+0.53,23.04,477000,35,1249510,0,0,0,0,0,0,227000,249000,-22000,-22000
20200430,059956,玉山金康和99購01,1.94,2.01,1.94,2.01,+0.15,8.06,114000,18,223450,0,0,0,0,0,0,57000,81000,-24000,-24000
20200430,059957,中信金康和99購01,2.20,2.27,2.20,2.26,+0.12,5.61,188000,7,423490,0,0,0,0,0,0,14000,174000,-160000,-160000
20200430,059958,鎧勝康和99購01,2.57,2.93,2.53,2.84,+0.17,6.37,167000,14,450080,0,0,0,0,0,0,71000,96000,-25000,-25000
20200430,059959,訊芯康和99購01,2.94,3.19,2.94,3.19,0.00,0.00,16000,3,49190,0,0,0,0,0,0,0,16000,-16000,-16000
20200430,05995P,T50正2中信9C售01,,,,,0.00,0.00,0,0,0,0,0,0,0,0,0,0,0,0,0
20200430,059960,健策國票99購01,4.55,4.55,4.54,4.54,+0.18,4.13,210000,3,953500,0,0,0,0,0,0,200000,210000,-10000,-10000
20200430,059961,T50反1凱基99購09,0.50,0.50,0.47,0.47,-0.05,-9.62,420000,7,204600,0,0,0,0,0,0,0,420000,-420000,-420000
20200430,059962,S&P正2凱基99購02,,,,,0.00,0.00,0,0,0,0,0,0,0,0,0,0,0,0,0
20200430,059963,臺指反凱基99購01,,,,,0.00,0.00,0,0,0,0,0,0,0,0,0,0,0,0,0
20200430,059964,元金2X凱基99購02,1.50,1.50,1.50,1.50,-0.01,-0.66,9000,3,13500,0,0,0,0,0,0,7000,2000,5000,5000
20200430,059965,鴻海凱基99購16,0.70,0.72,0.70,0.72,+0.03,4.35,171000,10,121130,0,0,0,0,0,0,97000,74000,23000,23000
20200430,059966,台積電凱基99購19,,,,,0.00,0.00,0,0,0,0,0,0,0,0,0,0,0,0,0
20200430,059967,聯發科凱基99購20,1.09,1.17,1.09,1.17,+0.15,14.71,97000,6,106360,0,0,0,0,0,0,82000,15000,67000,67000
20200430,059968,世紀鋼凱基99購03,0.79,0.79,0.79,0.79,0.00,0.00,25000,1,19750,0,0,0,0,0,0,0,25000,-25000,-25000
20200430,059969,台灣50元大9B購06,3.63,3.63,3.63,3.63,+0.18,5.22,35000,1,127050,0,0,0,0,0,0,35000,0,35000,35000
20200430,05996P,華新科群益96售03,4.26,4.32,4.18,4.32,-0.30,-6.49,5000,4,21300,0,0,0,0,0,0,3000,2000,1000,1000
20200430,059970,台灣50元大9B購07,,,,,0.00,0.00,0,0,0,0,0,0,0,0,0,0,0,0,0
20200430,059971,台灣50元大9B購08,,,,,0.00,0.00,0,0,0,0,0,0,0,0,0,0,0,0,0
20200430,059972,S&P正2元大99購03,3.22,3.30,3.22,3.30,+0.22,7.14,3000,2,9820,0,0,0,0,0,0,1000,2000,-1000,-1000
20200430,059973,A50正2元大99購02,1.58,1.58,1.58,1.58,0.00,0.00,1000,1,1580,0,0,0,0,0,0,0,1000,-1000,-1000
20200430,059974,臺指反元大9C購05,1.80,1.80,1.80,1.80,-0.05,-2.7,2000,1,3600,0,0,0,0,0,0,0,2000,-2000,-2000
20200430,059975,元金2X元大99購02,1.71,1.71,1.69,1.69,-0.02,-1.17,186000,14,315300,0,0,0,0,0,0,20000,164000,-144000,-144000
20200430,059976,道瓊銀元大99購01,0.98,0.98,0.98,0.98,0.00,0.00,200000,1,196000,0,0,0,0,0,0,200000,0,200000,200000
20200430,059977,鴻海元大99購40,2.00,2.05,1.98,2.04,+0.09,4.62,236000,15,475570,0,0,0,0,0,0,92000,130000,-38000,-38000
20200430,059978,國巨元大99購29,2.95,2.95,2.95,2.95,+0.13,4.61,5000,1,14750,0,0,0,0,0,0,5000,0,5000,5000
20200430,059979,台積電元大99購49,2.31,2.34,2.31,2.34,+0.05,2.18,13000,2,30060,0,0,0,0,0,0,13000,0,13000,13000
20200430,05997P,嘉聯益群益96售02,,,,,0.00,0.00,0,0,0,0,0,0,0,0,0,0,0,0,0
20200430,059980,台積電元大99購50,2.17,2.21,2.15,2.21,+0.14,6.76,56000,6,121920,0,0,0,0,0,0,50000,6000,44000,44000
20200430,059981,聯發科元大99購36,2.43,2.49,2.43,2.49,+0.25,11.16,62000,4,151230,0,0,0,0,0,0,2000,62000,-60000,-60000
20200430,059982,聯發科元大99購37,3.54,3.68,3.49,3.68,+0.38,11.52,58000,14,209590,0,0,0,0,0,0,52000,0,52000,52000
20200430,059983,聯發科元大99購38,2.55,2.62,2.51,2.62,+0.31,13.42,25000,7,63930,0,0,0,0,0,0,5000,21000,-16000,-16000
20200430,059984,華新科元大99購21,2.87,2.87,2.87,2.87,0.00,0.00,20000,1,57400,0,0,0,0,0,0,0,20000,-20000,-20000
20200430,059985,華新科元大99購22,,,,,0.00,0.00,0,0,0,0,0,0,0,0,0,0,0,0,0
20200430,059986,宏達電元大99購08,2.28,2.32,2.25,2.25,-0.08,-3.43,65000,3,149350,0,0,0,0,0,0,50000,15000,35000,35000
20200430,059987,大立光元大99購28,2.10,2.26,2.10,2.24,+0.19,9.27,123000,19,262690,0,0,0,0,0,0,109000,14000,95000,95000
20200430,059988,大立光元大9A購02,1.95,2.12,1.95,2.12,+0.22,11.58,105000,16,210540,0,0,0,0,0,0,56000,49000,7000,7000
20200430,059989,嘉晶元大9A購01,2.87,3.04,2.87,2.92,+0.20,7.35,104000,10,303270,0,0,0,0,0,0,11000,93000,-82000,-82000
20200430,05998P,台積電元大97售12,2.10,2.10,2.10,2.10,0.00,0.00,2000,1,4200,0,0,0,0,0,0,0,2000,-2000,-2000
20200430,059990,健策元大9A購01,5.65,5.85,5.60,5.70,+0.25,4.59,61000,11,346250,0,0,0,0,0,0,51000,32000,19000,19000
20200430,059991,超眾元大9A購02,3.55,3.62,3.53,3.53,+0.08,2.32,81000,6,290370,0,0,0,0,0,0,10000,61000,-51000,-51000
20200430,059992,S&P正2元富9B購04,2.14,2.14,2.14,2.14,+0.11,5.42,3000,1,6420,0,0,0,0,0,0,3000,0,3000,3000
20200430,059993,上銀元富99購01,4.54,5.40,4.49,5.40,+1.03,23.57,546000,49,2551770,0,0,0,0,0,0,267000,279000,-12000,-12000
20200430,059994,國巨元富99購01,4.27,4.27,4.27,4.27,0.00,0.00,185000,1,789950,0,0,0,0,0,0,185000,0,185000,185000
20200430,059995,南亞科元富99購01,3.44,3.44,3.30,3.36,+0.10,3.07,956000,82,3221270,0,0,0,0,0,0,595000,300000,295000,295000
20200430,059996,美律元富99購01,2.89,3.20,2.89,3.09,+0.26,9.19,586000,42,1772920,0,0,0,0,0,0,257000,387000,-130000,-130000
20200430,059997,華航元富99購01,2.19,2.22,2.15,2.15,+0.05,2.38,150000,7,328300,0,0,0,0,0,0,140000,10000,130000,130000
20200430,059998,華航元富99購02,3.34,3.34,2.57,2.63,+0.10,3.95,139000,15,373660,0,0,0,0,0,0,109000,20000,89000,89000
20200430,059999,緯穎元富99購01,2.61,3.07,2.60,2.94,+0.45,18.07,298000,21,863360,0,0,0,0,0,0,18000,280000,-262000,-262000
20200430,05999P,世芯元大96售01,0.40,0.40,0.40,0.40,0.00,0.00,15000,2,6000,0,0,0,0,0,0,0,15000,-15000,-15000
20200430,060000,國巨台新99購01,,,,,0.00,0.00,0,0,0,0,0,0,0,0,0,0,0,0,0
20200430,060001,台灣50群益9A購10,,,,,0.00,0.00,0,0,0,0,0,0,0,0,0,0,0,0,0
20200430,060002,T50反1群益9A購01,0.54,0.54,0.47,0.47,-0.08,-14.55,414000,9,202460,0,0,0,0,0,0,150000,264000,-114000,-114000
20200430,060003,上証2X群益9B購02,,,,,0.00,0.00,0,0,0,0,0,0,0,0,0,0,0,0,0
20200430,060004,臺指反群益9A購01,1.48,1.48,1.44,1.44,-0.10,-6.49,14000,2,20680,0,0,0,0,0,0,0,14000,-14000,-14000
20200430,060005,上銀群益99購03,,,,,0.00,0.00,0,0,0,0,0,0,0,0,0,0,0,0,0
20200430,060006,華通群益9A購04,3.09,3.21,3.08,3.20,+0.23,7.74,462000,15,1426670,0,0,0,0,0,0,462000,0,462000,462000
20200430,060007,鴻海群益99購04,2.51,2.57,2.50,2.57,+0.10,4.05,130000,8,330300,0,0,0,0,0,0,54000,88000,-34000,-34000
20200430,060008,華邦電群益9A購01,1.92,2.05,1.92,2.05,+0.19,10.22,1006000,51,2001390,0,0,0,0,0,0,74000,976000,-902000,-902000
20200430,060009,南亞科群益99購03,3.36,3.36,3.36,3.36,+0.08,2.44,31000,2,104160,0,0,0,0,0,0,31000,0,31000,31000
20200430,06000P,GIS元大96售04,2.57,2.57,2.57,2.57,0.00,0.00,10000,1,25700,0,0,0,0,0,0,0,10000,-10000,-10000
20200430,060010,義隆群益99購02,3.91,4.24,3.83,4.14,+0.33,8.66,183000,40,735430,0,0,0,0,0,0,68000,132000,-64000,-64000
20200430,060011,臺股指群益9C購06,3.57,3.72,3.57,3.72,+0.26,7.51,40000,8,144020,0,0,0,0,0,0,29000,11000,18000,18000
20200430,060012,電子類群益99購02,3.54,3.62,3.48,3.62,+0.21,6.16,5000,4,17680,0,0,0,0,0,0,4000,1000,3000,3000
20200430,060013,S&P正2康和99購01,3.42,3.42,3.42,3.42,+0.22,6.88,1000,1,3420,0,0,0,0,0,0,1000,0,1000,1000
20200430,060014,中鋼康和99購01,1.56,1.58,1.53,1.58,+0.06,3.95,211000,7,329020,0,0,0,0,0,0,132000,68000,64000,64000
20200430,060015,國巨康和99購03,3.53,3.60,3.44,3.44,+0.15,4.56,57000,7,201680,0,0,0,0,0,0,2000,56000,-54000,-54000
20200430,060016,廣達康和99購01,1.70,1.83,1.68,1.83,+0.10,5.78,554000,44,957790,0,0,0,0,0,0,282000,272000,10000,10000
20200430,060017,全新康和99購01,2.25,2.25,2.23,2.23,+0.05,2.29,100000,18,224560,0,0,0,0,0,0,100000,0,100000,100000
20200430,060018,國產康和99購01,2.69,2.72,2.69,2.72,+0.17,6.67,23000,2,62170,0,0,0,0,0,0,23000,0,23000,23000
20200430,060019,彰銀康和99購01,1.53,1.53,1.53,1.53,0.00,0.00,71000,2,108630,0,0,0,0,0,0,68000,3000,65000,65000
20200430,06001P,樺漢台新96售01,,,,,0.00,0.00,0,0,0,0,0,0,0,0,0,0,0,0,0
20200430,060020,康控康和99購01,2.98,3.18,2.98,3.15,+0.47,17.54,50000,7,151580,0,0,0,0,0,0,50000,15000,35000,35000
20200430,060021,立積康和99購01,3.54,3.54,3.54,3.54,+0.11,3.21,10000,1,35400,0,0,0,0,0,0,10000,0,10000,10000
20200430,060022,勤誠康和99購01,3.37,3.37,3.37,3.37,-0.26,-7.16,6000,1,20220,0,0,0,0,0,0,6000,0,6000,6000
20200430,060023,T50反1國泰9A購03,0.86,0.87,0.81,0.81,-0.11,-11.96,155000,6,126360,0,0,0,0,0,0,135000,15000,120000,120000
20200430,060024,T50反1國泰9B購02,0.96,0.96,0.91,0.91,-0.09,-9.0,135000,4,127100,0,0,0,0,0,0,0,135000,-135000,-135000
20200430,060025,台積電富邦9C購06,0.87,0.88,0.86,0.88,+0.04,4.76,120000,12,104740,0,0,0,0,0,0,105000,15000,90000,90000
20200430,060026,聯發科富邦9B購05,1.86,1.95,1.86,1.95,+0.21,12.07,395000,20,757020,0,0,0,0,0,0,67000,322000,-255000,-255000
20200430,060027,元金2X永豐99購02,0.96,0.96,0.95,0.95,-0.02,-2.06,136000,4,130200,0,0,0,0,0,0,36000,100000,-64000,-64000
20200430,060028,國揚永豐99購01,2.77,2.77,2.52,2.67,+0.05,1.91,300000,23,780880,0,0,0,0,0,0,274000,26000,248000,248000
20200430,060029,嘉晶永豐99購03,1.09,1.15,1.09,1.15,+0.11,10.58,131000,8,149150,0,0,0,0,0,0,0,131000,-131000,-131000
20200430,06002P,華通康和96售01,,,,,0.00,0.00,0,0,0,0,0,0,0,0,0,0,0,0,0
20200430,060030,晶相光永豐99購03,1.81,1.81,1.76,1.78,-0.09,-4.81,209000,10,377410,0,0,0,0,0,0,209000,13000,196000,196000
20200430,060031,旭富永豐99購02,0.80,0.80,0.76,0.76,+0.03,4.11,157000,14,122460,0,0,0,0,0,0,76000,81000,-5000,-5000
20200430,060032,利勤永豐99購01,1.02,1.05,1.02,1.05,-0.01,-0.94,12000,2,12300,0,0,0,0,0,0,10000,2000,8000,8000
20200430,060033,臻鼎永豐99購01,1.12,1.21,1.09,1.20,+0.12,11.11,473000,35,544170,0,0,0,0,0,0,80000,392000,-312000,-312000
20200430,060034,立積永豐99購04,2.06,2.22,2.06,2.08,+0.05,2.46,276000,19,583330,0,0,0,0,0,0,6000,268000,-262000,-262000
20200430,060035,臺股指永豐99購04,,,,,0.00,0.00,0,0,0,0,0,0,0,0,0,0,0,0,0
20200430,060036,上証2X國票99購03,1.40,1.49,1.40,1.44,+0.07,5.11,370000,9,534000,0,0,0,0,0,0,120000,250000,-130000,-130000
20200430,060037,鴻海國票99購10,3.27,3.27,3.27,3.27,+0.11,3.48,2000,2,6540,0,0,0,0,0,0,2000,2000,0,0
20200430,060038,台積電國票99購13,2.88,2.91,2.86,2.91,+0.15,5.43,74000,6,213320,0,0,0,0,0,0,35000,39000,-4000,-4000
20200430,060039,大立光國票99購04,2.86,2.86,2.86,2.86,0.00,0.00,1000,1,2860,0,0,0,0,0,0,1000,1000,0,0
20200430,06003P,亞光康和96售02,,,,,0.00,0.00,0,0,0,0,0,0,0,0,0,0,0,0,0
20200430,060040,康控國票99購04,8.05,8.80,8.05,8.80,+1.50,20.55,87000,10,742500,0,0,0,0,0,0,75000,12000,63000,63000
20200430,060041,T50反1群益99購04,,,,,0.00,0.00,0,0,0,0,0,0,0,0,0,0,0,0,0
20200430,060042,台積電群益99購12,1.64,1.67,1.62,1.67,+0.11,7.05,116000,12,190750,0,0,0,0,0,0,78000,38000,40000,40000
20200430,060043,全新群益9B購02,2.28,2.29,2.19,2.23,+0.02,0.9,36000,10,80280,0,0,0,0,0,0,21000,15000,6000,6000
20200430,060044,大立光群益99購09,2.95,2.99,2.93,2.98,+0.08,2.76,104000,4,310180,0,0,0,0,0,0,104000,0,104000,104000
20200430,060045,嘉晶群益99購02,1.74,1.93,1.74,1.82,+0.06,3.41,208000,15,379110,0,0,0,0,0,0,0,208000,-208000,-208000
20200430,060046,S&P反1凱基99購02,0.42,0.42,0.41,0.41,-0.04,-8.89,150000,4,61700,0,0,0,0,0,0,149000,0,149000,149000
20200430,060047,道瓊反凱基99購01,0.40,0.40,0.37,0.38,-0.05,-11.63,258000,16,100840,0,0,0,0,0,0,59000,198000,-139000,-139000
20200430,060048,元金2X凱基99購03,1.42,1.42,1.42,1.42,0.00,0.00,24000,3,34080,0,0,0,0,0,0,4000,20000,-16000,-16000
20200430,060049,華通凱基99購06,1.68,1.84,1.68,1.84,+0.21,12.88,62000,4,113880,0,0,0,0,0,0,51000,11000,40000,40000
20200430,06004P,奇力新永豐96售02,1.18,1.18,1.16,1.16,-0.12,-9.38,50000,4,58400,0,0,0,0,0,0,50000,0,50000,50000
20200430,060050,鴻海凱基9B購01,1.50,1.54,1.49,1.54,+0.07,4.76,193000,20,289500,0,0,0,0,0,0,150000,43000,107000,107000
20200430,060051,台積電凱基9B購01,1.13,1.16,1.13,1.16,+0.08,7.41,158000,11,182160,0,0,0,0,0,0,43000,114000,-71000,-71000
20200430,060052,宏碁凱基99購01,1.61,1.61,1.54,1.54,-0.01,-0.65,215000,22,335750,0,0,0,0,0,0,195000,20000,175000,175000
20200430,060053,聯發科凱基9B購02,1.66,1.74,1.66,1.74,+0.18,11.54,24000,2,40240,0,0,0,0,0,0,24000,0,24000,24000
20200430,060054,華新科凱基9B購04,1.71,1.71,1.71,1.71,0.00,0.00,1000,1,1710,0,0,0,0,0,0,1000,0,1000,1000
20200430,060055,宏達電凱基99購06,0.87,0.87,0.87,0.87,+0.01,1.16,10000,1,8700,0,0,0,0,0,0,10000,0,10000,10000
20200430,060056,大立光凱基9B購01,0.99,1.05,0.99,1.05,+0.07,7.14,36000,8,36290,0,0,0,0,0,0,22000,14000,8000,8000
20200430,060057,欣興凱基9B購01,1.71,1.76,1.70,1.70,+0.03,1.8,101000,13,173380,0,0,0,0,0,0,101000,0,101000,101000
20200430,060058,牧德凱基9B購01,1.81,1.89,1.77,1.87,+0.14,8.09,376000,29,688770,0,0,0,0,0,0,95000,324000,-229000,-229000
20200430,060059,鴻海兆豐99購06,,,,,0.00,0.00,0,0,0,0,0,0,0,0,0,0,0,0,0
20200430,06005P,晶豪科永豐96售04,0.79,0.87,0.74,0.87,-0.02,-2.25,351000,12,275780,0,0,0,0,0,0,319000,32000,287000,287000
20200430,060060,台積電兆豐99購05,0.98,1.02,0.98,1.02,+0.06,6.25,41000,17,41180,0,0,0,0,0,0,17000,23000,-6000,-6000
20200430,060061,旺宏兆豐99購02,2.38,2.40,2.31,2.31,+0.19,8.96,62000,6,144430,0,0,0,0,0,0,62000,0,62000,62000
20200430,060062,聯發科兆豐99購04,3.50,3.66,3.50,3.64,+0.41,12.69,21000,5,75790,0,0,0,0,0,0,1000,20000,-19000,-19000
20200430,060063,可成兆豐9B購01,,,,,0.00,0.00,0,0,0,0,0,0,0,0,0,0,0,0,0
20200430,060064,華新科兆豐99購07,2.42,2.42,2.42,2.42,+0.03,1.26,10000,1,24200,0,0,0,0,0,0,0,10000,-10000,-10000
20200430,060065,大立光兆豐9B購01,1.90,2.03,1.90,2.03,+0.17,9.14,258000,14,504060,0,0,0,0,0,0,148000,110000,38000,38000
20200430,060066,欣興兆豐9B購01,,,,,0.00,0.00,0,0,0,0,0,0,0,0,0,0,0,0,0
20200430,060067,T50反1元富99購11,,,,,0.00,0.00,0,0,0,0,0,0,0,0,0,0,0,0,0
20200430,060068,T50反1元富99購12,,,,,0.00,0.00,0,0,0,0,0,0,0,0,0,0,0,0,0
20200430,060069,T50反1元富99購13,,,,,0.00,0.00,0,0,0,0,0,0,0,0,0,0,0,0,0
20200430,06006P,欣興永豐96售04,,,,,0.00,0.00,0,0,0,0,0,0,0,0,0,0,0,0,0
20200430,060070,國巨元富99購02,2.80,2.83,2.75,2.79,+0.12,4.49,119000,7,332810,0,0,0,0,0,0,79000,20000,59000,59000
20200430,060071,國巨元富99購03,3.68,3.74,3.68,3.74,+0.15,4.18,10000,2,37100,0,0,0,0,0,0,10000,0,10000,10000
20200430,060072,國巨元富99購04,3.28,3.31,3.20,3.26,+0.04,1.24,314000,31,1027200,0,0,0,0,0,0,103000,164000,-61000,-61000
20200430,060073,台積電元富99購03,2.27,2.33,2.26,2.33,+0.13,5.91,48000,7,108920,0,0,0,0,0,0,43000,5000,38000,38000
20200430,060074,台積電元富99購04,,,,,0.00,0.00,0,0,0,0,0,0,0,0,0,0,0,0,0
20200430,060075,台積電元富99購05,2.10,2.10,2.10,2.10,+0.06,2.94,5000,1,10500,0,0,0,0,0,0,0,5000,-5000,-5000
20200430,060076,台灣50台新9B購05,,,,,0.00,0.00,0,0,0,0,0,0,0,0,0,0,0,0,0
20200430,060077,台積電台新9B購01,1.29,1.30,1.27,1.30,+0.08,6.56,58000,6,74660,0,0,0,0,0,0,26000,32000,-6000,-6000
20200430,060078,旺宏台新99購03,,,,,0.00,0.00,0,0,0,0,0,0,0,0,0,0,0,0,0
20200430,060079,台郡台新99購03,1.53,1.58,1.48,1.58,+0.04,2.6,403000,23,612040,0,0,0,0,0,0,177000,226000,-49000,-49000
20200430,06007P,世芯永豐96售01,0.15,0.17,0.15,0.17,0.00,0.00,8000,4,1300,0,0,0,0,0,0,3000,5000,-2000,-2000
20200430,060080,台灣50元大02購01,,,,,0.00,0.00,0,0,0,0,0,0,0,0,0,0,0,0,0
20200430,060081,台灣50元大02購02,,,,,0.00,0.00,0,0,0,0,0,0,0,0,0,0,0,0,0
20200430,060082,臺指反元大9C購06,,,,,0.00,0.00,0,0,0,0,0,0,0,0,0,0,0,0,0
20200430,060083,和大元大99購02,2.88,3.40,2.87,3.39,+0.76,28.9,372000,33,1188230,0,0,0,0,0,0,137000,235000,-98000,-98000
20200430,060084,聯電元大99購02,2.07,2.08,2.02,2.08,+0.11,5.58,267000,10,549850,0,0,0,0,0,0,117000,150000,-33000,-33000
20200430,060085,華通元大99購10,3.22,3.52,3.20,3.52,+0.45,14.66,388000,36,1295020,0,0,0,0,0,0,185000,216000,-31000,-31000
20200430,060086,鴻海元大99購42,3.13,3.19,3.12,3.19,+0.12,3.91,153000,8,479370,0,0,0,0,0,0,75000,78000,-3000,-3000
20200430,060087,鴻海元大99購43,2.67,2.72,2.65,2.72,+0.10,3.82,119000,10,318400,0,0,0,0,0,0,75000,44000,31000,31000
20200430,060088,國巨元大99購30,,,,,0.00,0.00,0,0,0,0,0,0,0,0,0,0,0,0,0
20200430,060089,台積電元大99購54,2.25,2.29,2.25,2.29,+0.06,2.69,21000,2,48050,0,0,0,0,0,0,20000,1000,19000,19000
20200430,06008P,燿華統一96售04,3.01,3.01,3.01,3.01,-0.22,-6.81,5000,1,15050,0,0,0,0,0,0,0,5000,-5000,-5000
20200430,060090,台積電元大99購55,2.30,2.33,2.30,2.30,+0.03,1.32,185000,6,427800,0,0,0,0,0,0,135000,50000,85000,85000
20200430,060091,技嘉元大99購03,2.52,2.52,2.52,2.52,+0.02,0.8,9000,1,22680,0,0,0,0,0,0,9000,0,9000,9000
20200430,060092,瑞昱元大99購03,3.09,3.30,3.02,3.24,+0.32,10.96,319000,66,997560,0,0,0,0,0,0,218000,189000,29000,29000
20200430,060093,友達元大03購01,2.41,2.41,2.38,2.40,+0.04,1.69,169000,16,404750,0,0,0,0,0,0,139000,30000,109000,109000
20200430,060094,聯發科元大99購41,2.92,3.06,2.90,3.06,+0.34,12.5,124000,10,370880,0,0,0,0,0,0,16000,109000,-93000,-93000
20200430,060095,聯發科元大99購42,4.85,5.00,4.85,5.00,+0.61,13.9,63000,8,311780,0,0,0,0,0,0,4000,63000,-59000,-59000
20200430,060096,聯發科元大99購43,2.81,2.87,2.81,2.86,+0.32,12.6,63000,8,178720,0,0,0,0,0,0,53000,63000,-10000,-10000
20200430,060097,華新科元大99購23,,,,,0.00,0.00,0,0,0,0,0,0,0,0,0,0,0,0,0
20200430,060098,華新科元大99購24,,,,,0.00,0.00,0,0,0,0,0,0,0,0,0,0,0,0,0
20200430,060099,宏達電元大99購09,2.08,2.08,2.08,2.08,-0.06,-2.8,39000,1,81120,0,0,0,0,0,0,0,39000,-39000,-39000
20200430,06009P,宏達電元富96售03,,,,,0.00,0.00,0,0,0,0,0,0,0,0,0,0,0,0,0
20200430,060100,新光金元大9C購01,1.72,1.74,1.72,1.73,+0.07,4.22,267000,16,459970,0,0,0,0,0,0,244000,23000,221000,221000
20200430,060101,大立光元大99購31,2.57,2.73,2.57,2.73,+0.21,8.33,52000,6,136640,0,0,0,0,0,0,32000,20000,12000,12000
20200430,060102,禾伸堂元大99購06,4.35,4.35,4.35,4.35,+0.21,5.07,5000,1,21750,0,0,0,0,0,0,0,5000,-5000,-5000
20200430,060103,聯詠元大99購01,2.37,2.50,2.35,2.48,+0.16,6.9,545000,44,1320360,0,0,0,0,0,0,190000,359000,-169000,-169000
20200430,060104,新日興元大99購03,2.68,2.68,2.47,2.60,-0.02,-0.76,146000,19,380400,0,0,0,0,0,0,125000,20000,105000,105000
20200430,060105,牧德元大9B購01,5.40,5.60,5.20,5.55,+0.40,7.77,194000,22,1039800,0,0,0,0,0,0,156000,54000,102000,102000
20200430,060106,旭富元大99購02,2.73,2.73,2.70,2.70,+0.11,4.25,62000,7,168300,0,0,0,0,0,0,62000,0,62000,62000
20200430,060107,旭富元大99購03,2.11,2.11,2.02,2.05,+0.04,1.99,77000,9,161300,0,0,0,0,0,0,65000,12000,53000,53000
20200430,060108,泰鼎元大99購04,2.60,2.60,2.45,2.56,+0.03,1.19,293000,22,738170,0,0,0,0,0,0,17000,289000,-272000,-272000
20200430,060109,茂林元大99購05,3.09,3.12,3.07,3.07,-0.09,-2.85,55000,5,170960,0,0,0,0,0,0,24000,31000,-7000,-7000
20200430,06010P,國泰金元富96售01,2.01,2.04,1.85,1.85,-0.46,-19.91,151000,18,292020,0,0,0,0,0,0,75000,76000,-1000,-1000
20200430,060110,茂林元大99購06,2.24,2.24,2.13,2.13,-0.06,-2.74,63000,6,139090,0,0,0,0,0,0,48000,25000,23000,23000
20200430,060111,臻鼎元大99購04,2.66,2.89,2.60,2.89,+0.35,13.78,240000,23,645560,0,0,0,0,0,0,100000,140000,-40000,-40000
20200430,060112,祥碩元大99購04,2.67,2.68,2.25,2.32,-0.16,-6.45,477000,60,1166130,0,0,0,0,0,0,405000,317000,88000,88000
20200430,060113,祥碩元大9B購01,4.02,4.03,3.37,3.39,-0.46,-11.95,279000,31,1079140,0,0,0,0,0,0,267000,22000,245000,245000
20200430,060114,緯穎元大99購10,2.29,2.58,2.27,2.56,+0.37,16.89,132000,20,316990,0,0,0,0,0,0,80000,52000,28000,28000
20200430,060115,南電元大99購06,,,,,0.00,0.00,0,0,0,0,0,0,0,0,0,0,0,0,0
20200430,060116,世紀鋼元大99購07,2.37,2.48,2.36,2.44,+0.07,2.95,424000,24,1033490,0,0,0,0,0,0,7000,417000,-410000,-410000
20200430,060117,國巨國泰9B購04,,,,,0.00,0.00,0,0,0,0,0,0,0,0,0,0,0,0,0
20200430,060118,臺指反富邦9C購01,,,,,0.00,0.00,0,0,0,0,0,0,0,0,0,0,0,0,0
20200430,060119,上銀富邦9B購03,2.19,2.45,2.16,2.45,+0.47,23.74,393000,22,901130,0,0,0,0,0,0,151000,242000,-91000,-91000
20200430,06011P,貿聯元富96售04,,,,,0.00,0.00,0,0,0,0,0,0,0,0,0,0,0,0,0
20200430,060120,聯電富邦9B購01,1.40,1.45,1.40,1.45,+0.10,7.41,13000,4,18450,0,0,0,0,0,0,13000,0,13000,13000
20200430,060121,新光金富邦99購01,0.91,0.93,0.90,0.92,+0.06,6.98,510000,31,464200,0,0,0,0,0,0,456000,54000,402000,402000
20200430,060122,亞德客永豐99購02,1.32,1.60,1.28,1.58,+0.30,23.44,754000,44,1056920,0,0,0,0,0,0,264000,538000,-274000,-274000
20200430,060123,光罩永豐99購02,1.43,1.50,1.42,1.44,+0.01,0.7,302000,23,439860,0,0,0,0,0,0,125000,151000,-26000,-26000
20200430,060124,奇力新永豐99購03,1.88,1.95,1.86,1.86,+0.08,4.49,290000,10,554260,0,0,0,0,0,0,80000,210000,-130000,-130000
20200430,060125,強茂永豐99購01,1.71,1.78,1.71,1.78,+0.10,5.95,117000,6,204000,0,0,0,0,0,0,30000,87000,-57000,-57000
20200430,060126,創意永豐99購04,1.63,1.70,1.63,1.69,+0.10,6.29,220000,15,370660,0,0,0,0,0,0,34000,181000,-147000,-147000
20200430,060127,牧德永豐99購02,1.86,1.98,1.86,1.98,+0.18,10.0,222000,5,424830,0,0,0,0,0,0,110000,112000,-2000,-2000
20200430,060128,健策永豐99購06,1.51,1.57,1.48,1.57,+0.09,6.08,486000,15,742260,0,0,0,0,0,0,139000,348000,-209000,-209000
20200430,060129,祥碩永豐99購03,1.23,1.23,1.02,1.02,-0.15,-12.82,202000,10,240060,0,0,0,0,0,0,199000,3000,196000,196000
20200430,06012P,世芯國票96售01,0.25,0.25,0.19,0.19,-0.12,-38.71,91000,7,19420,0,0,0,0,0,0,31000,50000,-19000,-19000
20200430,060130,瀚宇博永豐99購02,1.35,1.38,1.35,1.38,+0.08,6.15,50000,4,67670,0,0,0,0,0,0,0,50000,-50000,-50000
20200430,060131,GIS永豐99購03,1.57,1.58,1.52,1.57,+0.03,1.95,425000,13,665920,0,0,0,0,0,0,273000,152000,121000,121000
20200430,060132,滬深2X群益9C購02,,,,,0.00,0.00,0,0,0,0,0,0,0,0,0,0,0,0,0
20200430,060133,牧德群益9B購01,2.72,2.79,2.66,2.79,+0.17,6.49,455000,12,1223310,0,0,0,0,0,0,370000,86000,284000,284000
20200430,060134,鈺齊群益9A購01,1.81,1.89,1.77,1.83,+0.03,1.67,260000,21,473250,0,0,0,0,0,0,201000,52000,149000,149000
20200430,060135,台灣50國票9C購02,,,,,0.00,0.00,0,0,0,0,0,0,0,0,0,0,0,0,0
20200430,060136,T50反1國票9A購01,0.69,0.69,0.69,0.69,0.00,0.00,10000,1,6900,0,0,0,0,0,0,0,10000,-10000,-10000
20200430,060137,T50反1國票9A購02,,,,,0.00,0.00,0,0,0,0,0,0,0,0,0,0,0,0,0
20200430,060138,T50反1國票9A購03,,,,,0.00,0.00,0,0,0,0,0,0,0,0,0,0,0,0,0
20200430,060139,T50反1國票9A購04,0.59,0.59,0.54,0.54,0.00,0.00,121000,7,68740,0,0,0,0,0,0,51000,70000,-19000,-19000
20200430,06013P,世芯國泰97售03,0.35,0.35,0.31,0.33,-0.05,-13.16,132000,12,43560,0,0,0,0,0,0,20000,70000,-50000,-50000
20200430,060140,T50反1國票9A購05,,,,,0.00,0.00,0,0,0,0,0,0,0,0,0,0,0,0,0
20200430,060141,T50反1國票9B購02,,,,,0.00,0.00,0,0,0,0,0,0,0,0,0,0,0,0,0
20200430,060142,臺指反國票9B購01,0.90,0.90,0.87,0.87,-0.08,-8.42,1113000,6,993420,0,0,0,0,0,0,598000,515000,83000,83000
20200430,060143,台積電國票9B購03,4.44,4.52,4.39,4.52,+0.28,6.6,25000,4,111750,0,0,0,0,0,0,22000,3000,19000,19000
20200430,060144,全新國票9B購01,2.97,2.97,2.84,2.84,-0.14,-4.7,26000,5,75520,0,0,0,0,0,0,11000,15000,-4000,-4000
20200430,060145,牧德國票9A購02,8.10,8.35,7.90,8.35,+0.65,8.44,72000,31,584350,0,0,0,0,0,0,25000,66000,-41000,-41000
20200430,060146,健策國票9A購03,5.75,5.90,5.70,5.90,+0.35,6.31,15000,3,86850,0,0,0,0,0,0,9000,6000,3000,3000
20200430,060147,臺股指國票9A購07,3.77,3.91,3.72,3.91,+0.29,8.01,27000,5,102090,0,0,0,0,0,0,2000,25000,-23000,-23000
20200430,060148,臺股指國票9A購08,4.98,4.98,4.96,4.96,+0.24,5.08,9000,2,44720,0,0,0,0,0,0,9000,0,9000,9000
20200430,060149,元金2X富邦04購01,6.00,6.00,6.00,6.00,-0.05,-0.83,42000,1,252000,0,0,0,0,0,0,42000,0,42000,42000
20200430,06014P,聯發科富邦97售02,,,,,0.00,0.00,0,0,0,0,0,0,0,0,0,0,0,0,0
20200430,060150,華通富邦9B購01,1.12,1.25,1.11,1.25,+0.17,15.74,639000,60,728700,0,0,0,0,0,0,588000,56000,532000,532000
20200430,060151,旺宏富邦9A購02,1.49,1.49,1.43,1.45,+0.10,7.41,94000,16,138000,0,0,0,0,0,0,84000,29000,55000,55000
20200430,060152,上証2X永豐9A購02,,,,,0.00,0.00,0,0,0,0,0,0,0,0,0,0,0,0,0
20200430,060153,A50正2永豐9A購01,,,,,0.00,0.00,0,0,0,0,0,0,0,0,0,0,0,0,0
20200430,060154,堤維西永豐9A購01,1.35,1.35,1.33,1.33,0.00,0.00,47000,5,63180,0,0,0,0,0,0,47000,0,47000,47000
20200430,060155,友訊永豐9A購01,0.88,0.91,0.87,0.87,-0.02,-2.25,388000,15,341140,0,0,0,0,0,0,249000,139000,110000,110000
20200430,060156,光磊永豐9A購01,1.32,1.32,1.31,1.31,-0.03,-2.24,120000,3,157620,0,0,0,0,0,0,52000,68000,-16000,-16000
20200430,060157,致茂永豐9A購02,1.04,1.04,1.00,1.00,-0.06,-5.66,516000,15,530800,0,0,0,0,0,0,516000,0,516000,516000
20200430,060158,廣達永豐9A購01,1.06,1.16,1.04,1.16,+0.08,7.41,494000,41,557110,0,0,0,0,0,0,68000,376000,-308000,-308000
20200430,060159,健和興永豐9A購01,1.72,1.72,1.72,1.72,+0.08,4.88,18000,1,30960,0,0,0,0,0,0,18000,0,18000,18000
20200430,06015P,大立光富邦98售04,0.46,0.46,0.33,0.33,-0.17,-34.0,60000,4,23700,0,0,0,0,0,0,30000,30000,0,0
20200430,060160,聯陽永豐9A購01,1.53,1.54,1.50,1.54,+0.01,0.65,165000,10,249390,0,0,0,0,0,0,154000,11000,143000,143000
20200430,060161,牧德永豐9A購02,1.72,1.81,1.72,1.80,+0.15,9.09,46000,11,81650,0,0,0,0,0,0,36000,9000,27000,27000
20200430,060162,碩天永豐9A購01,1.27,1.33,1.27,1.33,+0.09,7.26,170000,4,224240,0,0,0,0,0,0,0,170000,-170000,-170000
20200430,060163,健策永豐9B購01,1.54,1.59,1.51,1.58,+0.07,4.64,382000,17,594990,0,0,0,0,0,0,234000,154000,80000,80000
20200430,060164,合勤控永豐9A購01,1.62,1.62,1.45,1.45,-0.10,-6.45,287000,14,439840,0,0,0,0,0,0,100000,187000,-87000,-87000
20200430,060165,上緯控永豐9A購01,1.48,1.56,1.47,1.54,+0.09,6.21,336000,11,514900,0,0,0,0,0,0,198000,138000,60000,60000
20200430,060166,佐登永豐9A購01,1.36,1.36,1.34,1.34,+0.01,0.75,190000,6,254830,0,0,0,0,0,0,153000,37000,116000,116000
20200430,060167,禾聯碩永豐9A購01,1.01,1.04,1.01,1.04,0.00,0.00,22000,4,22850,0,0,0,0,0,0,1000,21000,-20000,-20000
20200430,060168,台表科永豐9A購01,1.76,1.76,1.76,1.76,0.00,0.00,1000,1,1760,0,0,0,0,0,0,1000,1000,0,0
20200430,060169,群電永豐9A購01,1.32,1.42,1.32,1.42,+0.13,10.08,152000,10,210640,0,0,0,0,0,0,47000,105000,-58000,-58000
20200430,06016P,京元電凱基96售03,,,,,0.00,0.00,0,0,0,0,0,0,0,0,0,0,0,0,0
20200430,060170,世紀鋼永豐9A購01,1.15,1.23,1.15,1.23,+0.10,8.85,50000,4,57860,0,0,0,0,0,0,0,50000,-50000,-50000
20200430,060171,宏達電台新9A購01,1.14,1.14,1.14,1.14,0.00,0.00,25000,1,28500,0,0,0,0,0,0,25000,0,25000,25000
20200430,060172,智原台新9A購01,1.41,1.41,1.41,1.41,0.00,0.00,112000,3,157920,0,0,0,0,0,0,112000,0,112000,112000
20200430,060173,台灣50元富02購01,,,,,0.00,0.00,0,0,0,0,0,0,0,0,0,0,0,0,0
20200430,060174,T50反1元富04購01,0.91,0.91,0.91,0.91,-0.05,-5.21,1000,1,910,0,0,0,0,0,0,0,1000,-1000,-1000
20200430,060175,T50反1元富04購02,,,,,0.00,0.00,0,0,0,0,0,0,0,0,0,0,0,0,0
20200430,060176,T50反1元富04購03,,,,,0.00,0.00,0,0,0,0,0,0,0,0,0,0,0,0,0
20200430,060177,T50反1元富04購04,,,,,0.00,0.00,0,0,0,0,0,0,0,0,0,0,0,0,0
20200430,060178,T50反1元富04購05,,,,,0.00,0.00,0,0,0,0,0,0,0,0,0,0,0,0,0
20200430,060179,T50反1元富04購06,,,,,0.00,0.00,0,0,0,0,0,0,0,0,0,0,0,0,0
20200430,06017P,亞光凱基96售04,2.52,2.52,2.52,2.52,-0.06,-2.33,10000,1,25200,0,0,0,0,0,0,0,10000,-10000,-10000
20200430,060180,上証2X元富9A購02,,,,,0.00,0.00,0,0,0,0,0,0,0,0,0,0,0,0,0
20200430,060181,華通元富9A購01,,,,,0.00,0.00,0,0,0,0,0,0,0,0,0,0,0,0,0
20200430,060182,旺宏元富9A購01,,,,,0.00,0.00,0,0,0,0,0,0,0,0,0,0,0,0,0
20200430,060183,南亞科元富9A購01,3.78,3.78,3.71,3.74,+0.03,0.81,34000,9,127450,0,0,0,0,0,0,10000,24000,-14000,-14000
20200430,060184,建準元富9A購01,2.03,2.04,1.98,2.00,-0.16,-7.41,269000,13,538540,0,0,0,0,0,0,209000,60000,149000,149000
20200430,060185,聯發科元富04購01,2.43,2.66,2.43,2.66,+0.27,11.3,409000,48,1058050,0,0,0,0,0,0,314000,92000,222000,222000
20200430,060186,義隆元富9A購01,1.72,1.85,1.69,1.79,+0.09,5.29,873000,35,1550160,0,0,0,0,0,0,652000,221000,431000,431000
20200430,060187,華新科元富9A購02,2.32,2.32,2.30,2.30,+0.04,1.77,15000,3,34600,0,0,0,0,0,0,10000,5000,5000,5000
20200430,060188,華新科元富9A購03,2.78,2.82,2.77,2.82,+0.02,0.71,18000,4,50160,0,0,0,0,0,0,10000,8000,2000,2000
20200430,060189,宏達電元富9B購03,,,,,0.00,0.00,0,0,0,0,0,0,0,0,0,0,0,0,0
20200430,06018P,康控凱基96售03,,,,,0.00,0.00,0,0,0,0,0,0,0,0,0,0,0,0,0
20200430,060190,國泰金元富9A購01,2.76,2.88,2.74,2.87,+0.33,12.99,598000,37,1665920,0,0,0,0,0,0,136000,462000,-326000,-326000
20200430,060191,亞光元富9A購02,2.33,2.42,2.29,2.40,+0.16,7.14,591000,45,1383060,0,0,0,0,0,0,458000,233000,225000,225000
20200430,060192,欣興元富9A購01,,,,,0.00,0.00,0,0,0,0,0,0,0,0,0,0,0,0,0
20200430,060193,群創元富9A購01,1.55,1.58,1.52,1.57,+0.07,4.67,413000,8,639960,0,0,0,0,0,0,136000,277000,-141000,-141000
20200430,060194,旭富元富9A購01,1.60,1.60,1.54,1.55,+0.05,3.33,93000,5,144190,0,0,0,0,0,0,82000,1000,81000,81000
20200430,060195,旭富元富9A購02,1.64,1.64,1.56,1.56,0.00,0.00,314000,11,499760,0,0,0,0,0,0,202000,112000,90000,90000
20200430,060196,泰鼎元富9A購01,2.55,2.65,2.55,2.65,-0.09,-3.28,500000,5,1302000,0,0,0,0,0,0,0,500000,-500000,-500000
20200430,060197,臻鼎元富9A購02,1.74,1.94,1.68,1.88,+0.24,14.63,2452000,102,4339100,0,0,0,0,0,0,1201000,1228000,-27000,-27000
20200430,060198,祥碩元富9A購02,2.01,2.01,1.68,1.68,-0.18,-9.68,64000,9,123380,0,0,0,0,0,0,59000,5000,54000,54000
20200430,060199,台郡元富9A購01,2.59,2.69,2.59,2.69,+0.13,5.08,121000,8,315580,0,0,0,0,0,0,0,121000,-121000,-121000
20200430,06019P,緯穎凱基96售03,,,,,0.00,0.00,0,0,0,0,0,0,0,0,0,0,0,0,0
20200430,060200,同欣電元富9A購01,2.72,3.04,2.72,3.04,+0.36,13.43,951000,62,2714770,0,0,0,0,0,0,151000,773000,-622000,-622000
20200430,060201,台表科元富9A購01,2.54,2.54,2.54,2.54,+0.02,0.79,120000,3,304800,0,0,0,0,0,0,0,120000,-120000,-120000
20200430,060202,康友元富9A購01,2.68,2.78,2.66,2.78,+0.19,7.34,118000,13,321240,0,0,0,0,0,0,30000,88000,-58000,-58000
20200430,060203,緯穎元富9A購01,2.43,2.91,2.38,2.77,+0.45,19.4,1013000,55,2618410,0,0,0,0,0,0,298000,737000,-439000,-439000
20200430,060204,矽創元富9A購01,2.26,2.37,2.20,2.37,+0.28,13.4,988000,62,2226200,0,0,0,0,0,0,527000,453000,74000,74000
20200430,060205,台灣50麥證02購01,,,,,0.00,0.00,0,0,0,0,0,0,0,0,0,0,0,0,0
20200430,060206,臺股指麥證9A購01,,,,,0.00,0.00,0,0,0,0,0,0,0,0,0,0,0,0,0
20200430,060207,臺股指麥證9A購02,,,,,0.00,0.00,0,0,0,0,0,0,0,0,0,0,0,0,0
20200430,060208,卜蜂康和9A購01,1.72,1.72,1.68,1.68,-0.01,-0.59,81000,2,136600,0,0,0,0,0,0,81000,0,81000,81000
20200430,060209,喬山康和9A購01,2.95,3.42,2.95,3.37,+0.54,19.08,389000,22,1231660,0,0,0,0,0,0,10000,379000,-369000,-369000
20200430,06020P,燿華元富96售04,,,,,0.00,0.00,0,0,0,0,0,0,0,0,0,0,0,0,0
20200430,060210,上銀康和9A購01,4.14,4.63,4.14,4.63,+0.82,21.52,20000,3,86000,0,0,0,0,0,0,12000,8000,4000,4000
20200430,060211,智邦康和9A購01,4.73,4.92,4.73,4.87,+0.04,0.83,60000,15,291050,0,0,0,0,0,0,43000,0,43000,43000
20200430,060212,華航康和9A購01,1.42,1.42,1.27,1.27,+0.03,2.42,402000,21,521020,20000,0,20000,0,0,0,218000,184000,34000,54000
20200430,060213,牧德康和9A購01,3.09,3.09,3.09,3.09,+0.16,5.46,6000,1,18540,0,0,0,0,0,0,0,6000,-6000,-6000
20200430,060214,茂林康和9A購01,2.66,2.66,2.60,2.60,-0.29,-10.03,19000,2,50060,0,0,0,0,0,0,19000,0,19000,19000
20200430,060215,柏文康和9A購01,2.68,2.96,2.58,2.58,+0.20,8.4,275000,24,751610,0,0,0,0,0,0,173000,101000,72000,72000
20200430,060216,鴻海凱基9A購17,1.19,1.22,1.19,1.22,+0.04,3.39,97000,3,115490,0,0,0,0,0,0,85000,12000,73000,73000
20200430,060217,國巨凱基9A購10,2.22,2.22,2.10,2.10,0.00,0.00,120000,5,255200,0,0,0,0,0,0,80000,20000,60000,60000
20200430,060218,台積電凱基9A購15,1.43,1.43,1.43,1.43,+0.07,5.15,3000,1,4290,0,0,0,0,0,0,3000,0,3000,3000
20200430,060219,聯發科凱基9A購09,1.53,1.54,1.53,1.54,+0.18,13.24,72000,3,110860,0,0,0,0,0,0,70000,2000,68000,68000
20200430,06021P,世紀鋼元富96售03,0.89,0.89,0.83,0.83,-0.11,-11.7,131000,9,116210,0,0,0,0,0,0,130000,1000,129000,129000
20200430,060220,華新科凱基9A購08,1.80,1.80,1.74,1.74,-0.06,-3.33,11000,2,19740,0,0,0,0,0,0,0,11000,-11000,-11000
20200430,060221,大立光凱基9A購07,0.99,1.04,0.99,1.03,+0.08,8.42,42000,5,42070,0,0,0,0,0,0,42000,0,42000,42000
20200430,060222,貿聯凱基9A購02,1.40,1.65,1.40,1.65,+0.31,23.13,220000,24,326200,0,0,0,0,0,0,88000,121000,-33000,-33000
20200430,060223,台灣50元大9A購05,,,,,0.00,0.00,0,0,0,0,0,0,0,0,0,0,0,0,0
20200430,060224,台灣50元大9A購09,,,,,0.00,0.00,0,0,0,0,0,0,0,0,0,0,0,0,0
20200430,060225,S&P反1元大9A購02,,,,,0.00,0.00,0,0,0,0,0,0,0,0,0,0,0,0,0
20200430,060226,道瓊反元大9A購01,0.56,0.57,0.53,0.53,-0.07,-11.67,905000,24,497350,0,0,0,0,0,0,860000,45000,815000,815000
20200430,060227,和大元大9A購01,3.08,3.70,3.07,3.70,+0.88,31.21,171000,16,564280,0,0,0,0,0,0,51000,120000,-69000,-69000
20200430,060228,亞德客元大9A購01,3.62,4.14,3.42,4.14,+0.75,22.12,464000,67,1701880,0,0,0,0,0,0,252000,249000,3000,3000
20200430,060229,楠梓電元大9C購01,3.94,4.11,3.93,4.11,+0.09,2.24,106000,11,424040,0,0,0,0,0,0,65000,41000,24000,24000
20200430,06022P,緯穎永豐96售03,,,,,0.00,0.00,0,0,0,0,0,0,0,0,0,0,0,0,0
20200430,060230,台積電元大9A購07,2.69,2.69,2.69,2.69,+0.11,4.26,47000,1,126430,0,0,0,0,0,0,47000,0,47000,47000
20200430,060231,台積電元大9A購08,2.05,2.08,2.05,2.08,+0.10,5.05,11000,3,22680,0,0,0,0,0,0,11000,0,11000,11000
20200430,060232,友訊元大9C購01,1.70,1.79,1.70,1.71,-0.03,-1.72,205000,18,356430,0,0,0,0,0,0,166000,39000,127000,127000
20200430,060233,宏碁元大9A購01,1.94,1.98,1.82,1.87,-0.01,-0.53,497000,23,937450,0,0,0,0,0,0,333000,164000,169000,169000
20200430,060234,凱美元大9C購01,2.70,2.82,2.67,2.68,+0.06,2.29,315000,29,863330,0,0,0,0,0,0,10000,299000,-289000,-289000
20200430,060235,瑞昱元大9A購01,4.13,4.43,4.03,4.33,+0.45,11.6,301000,58,1259620,0,0,0,0,0,0,195000,182000,13000,13000
20200430,060236,精元元大9C購01,3.51,3.62,3.42,3.50,+0.04,1.16,222000,29,783610,0,0,0,0,0,0,124000,119000,5000,5000
20200430,060237,友達元大9A購06,2.18,2.18,2.13,2.18,+0.04,1.87,165000,18,357650,0,0,0,0,0,0,38000,142000,-104000,-104000
20200430,060238,強茂元大9C購01,3.96,4.00,3.88,4.00,+0.16,4.17,130000,20,514000,0,0,0,0,0,0,46000,84000,-38000,-38000
20200430,060239,國揚元大9C購01,4.38,4.38,3.78,4.28,+0.12,2.88,502000,35,2105820,0,0,0,0,0,0,325000,177000,148000,148000
20200430,06023P,超眾國票96售03,1.59,1.67,1.58,1.66,-0.08,-4.6,186000,18,302390,0,0,0,0,0,0,158000,28000,130000,130000
20200430,060240,富邦金元大9A購01,3.01,3.25,3.01,3.20,+0.30,10.34,451000,71,1394700,0,0,0,0,0,0,270000,250000,20000,20000
20200430,060241,國泰金元大9A購01,2.79,2.99,2.79,2.99,+0.34,12.83,233000,22,678740,0,0,0,0,0,0,34000,194000,-160000,-160000
20200430,060242,潤泰全元大9C購01,1.26,1.37,1.26,1.37,+0.11,8.73,729000,20,945400,0,0,0,0,0,0,289000,415000,-126000,-126000
20200430,060243,潤泰全元大9C購02,1.10,1.19,1.10,1.18,+0.09,8.26,542000,24,612870,0,0,0,0,0,0,219000,330000,-111000,-111000
20200430,060244,大立光元大9B購02,2.57,2.80,2.57,2.80,+0.32,12.9,129000,17,343280,0,0,0,0,0,0,70000,59000,11000,11000
20200430,060245,聯陽元大9C購01,2.77,2.77,2.70,2.75,+0.01,0.36,282000,28,771870,0,0,0,0,0,0,219000,5000,214000,214000
20200430,060246,晶相光元大9C購03,3.42,3.45,3.35,3.35,-0.17,-4.83,53000,9,180730,0,0,0,0,0,0,43000,18000,25000,25000
20200430,060247,牧德元大9A購02,4.17,4.28,4.14,4.28,+0.35,8.91,105000,11,440230,0,0,0,0,0,0,2000,83000,-81000,-81000
20200430,060248,日月光元大9A購01,3.07,3.25,3.07,3.25,+0.23,7.62,108000,13,344760,0,0,0,0,0,0,5000,103000,-98000,-98000
20200430,060249,正文元大9C購01,2.27,2.27,2.22,2.25,-0.04,-1.75,136000,8,304600,0,0,0,0,0,0,76000,60000,16000,16000
20200430,06024P,台郡國票97售05,,,,,0.00,0.00,0,0,0,0,0,0,0,0,0,0,0,0,0
20200430,060250,台表科元大9A購01,4.21,4.21,4.09,4.16,+0.06,1.46,29000,6,120290,0,0,0,0,0,0,4000,27000,-23000,-23000
20200430,060251,易華電元大9C購01,2.79,2.93,2.78,2.86,+0.03,1.06,394000,35,1123860,0,0,0,0,0,0,150000,244000,-94000,-94000
20200430,060252,緯穎元大9A購02,2.24,2.62,2.24,2.53,+0.40,18.78,333000,26,798730,0,0,0,0,0,0,68000,265000,-197000,-197000
20200430,060253,昇陽半元大9C購01,3.87,3.96,3.82,3.92,+0.26,7.1,253000,20,984590,0,0,0,0,0,0,60000,153000,-93000,-93000
20200430,060254,世紀鋼元大9A購01,2.34,2.40,2.34,2.39,+0.13,5.75,83000,6,197420,0,0,0,0,0,0,20000,63000,-43000,-43000
20200430,060255,臺股指元大9B購06,,,,,0.00,0.00,0,0,0,0,0,0,0,0,0,0,0,0,0
20200430,060256,臺股指元大9B購07,,,,,0.00,0.00,0,0,0,0,0,0,0,0,0,0,0,0,0
20200430,060257,臺股指元大9B購08,4.56,4.56,4.56,4.56,+0.10,2.24,55000,1,250800,0,0,0,0,0,0,0,55000,-55000,-55000
20200430,060258,T50反1凱基9A購06,1.12,1.12,1.02,1.02,-0.13,-11.3,453000,8,479010,0,0,0,0,0,0,441000,12000,429000,429000
20200430,060259,潤泰全凱基9C購01,0.80,0.88,0.80,0.88,+0.05,6.02,959000,28,807890,0,0,0,0,0,0,160000,795000,-635000,-635000
20200430,06025P,臺股指元大99售02,2.29,2.30,2.21,2.24,-0.13,-5.49,585000,46,1319040,0,0,0,0,0,0,318000,116000,202000,202000
20200430,060260,京鼎凱基9C購01,2.23,2.46,2.23,2.46,+0.29,13.36,99000,10,229610,0,0,0,0,0,0,3000,99000,-96000,-96000
20200430,060261,臺股指凱基9A購04,,,,,0.00,0.00,0,0,0,0,0,0,0,0,0,0,0,0,0
20200430,060262,臺股指凱基9B購02,4.46,4.76,4.42,4.76,+0.55,13.06,204000,9,922730,0,0,0,0,0,0,154000,50000,104000,104000
20200430,060263,臺指反國票9C購01,,,,,0.00,0.00,0,0,0,0,0,0,0,0,0,0,0,0,0
20200430,060264,華新科國票9A購02,7.95,7.95,7.75,7.75,-0.15,-1.9,7000,2,54650,0,0,0,0,0,0,0,7000,-7000,-7000
20200430,060265,宏達電國票9A購02,,,,,0.00,0.00,0,0,0,0,0,0,0,0,0,0,0,0,0
20200430,060266,潤泰全國票9A購01,2.07,2.40,2.07,2.40,+0.24,11.11,76000,4,169760,0,0,0,0,0,0,22000,54000,-32000,-32000
20200430,060267,上緯控國票9C購01,2.75,2.83,2.75,2.80,+0.14,5.26,187000,7,523930,0,0,0,0,0,0,96000,91000,5000,5000
20200430,060268,台灣50元大9C購20,,,,,0.00,0.00,0,0,0,0,0,0,0,0,0,0,0,0,0
20200430,060269,台灣50元大9C購21,,,,,0.00,0.00,0,0,0,0,0,0,0,0,0,0,0,0,0
20200430,06026P,華通台新97售01,,,,,0.00,0.00,0,0,0,0,0,0,0,0,0,0,0,0,0
20200430,060270,台灣50元大9C購22,,,,,0.00,0.00,0,0,0,0,0,0,0,0,0,0,0,0,0
20200430,060271,台灣50元大9C購23,,,,,0.00,0.00,0,0,0,0,0,0,0,0,0,0,0,0,0
20200430,060272,台灣50元大9C購25,,,,,0.00,0.00,0,0,0,0,0,0,0,0,0,0,0,0,0
20200430,060273,T50反1元大9A購03,,,,,0.00,0.00,0,0,0,0,0,0,0,0,0,0,0,0,0
20200430,060274,T50反1元大9A購04,,,,,0.00,0.00,0,0,0,0,0,0,0,0,0,0,0,0,0
20200430,060275,元黃金元大9A購01,1.53,1.53,1.52,1.53,-0.01,-0.65,34000,5,51980,0,0,0,0,0,0,0,34000,-34000,-34000
20200430,060276,S&P反1元大9A購03,,,,,0.00,0.00,0,0,0,0,0,0,0,0,0,0,0,0,0
20200430,060277,道瓊反元大9A購02,0.87,0.87,0.83,0.83,-0.09,-9.78,188000,10,160400,0,0,0,0,0,0,56000,132000,-76000,-76000
20200430,060278,道瓊反元大9A購03,0.84,0.84,0.84,0.84,-0.09,-9.68,60000,1,50400,0,0,0,0,0,0,60000,0,60000,60000
20200430,060279,SP黃豆元大9A購01,1.02,1.02,0.98,1.01,+0.08,8.6,370000,5,376400,0,0,0,0,0,0,0,370000,-370000,-370000
20200430,06027P,鴻海台新96售04,0.50,0.50,0.50,0.50,0.00,0.00,10000,1,5000,0,0,0,0,0,0,0,10000,-10000,-10000
20200430,060280,元金2X元大9A購01,2.14,2.14,2.14,2.14,-0.01,-0.47,117000,4,250380,0,0,0,0,0,0,50000,67000,-17000,-17000
20200430,060281,卜蜂元大9C購01,2.49,2.49,2.41,2.43,+0.01,0.41,121000,6,293130,0,0,0,0,0,0,41000,80000,-39000,-39000
20200430,060282,聚陽元大9A購01,3.31,3.50,3.31,3.46,+0.22,6.79,409000,20,1404470,0,0,0,0,0,0,264000,145000,119000,119000
20200430,060283,台肥元大9C購01,2.04,2.06,2.04,2.06,+0.06,3.0,324000,12,662620,0,0,0,0,0,0,35000,256000,-221000,-221000
20200430,060284,南港元大01購01,2.21,2.23,1.99,2.03,-0.15,-6.88,1035000,28,2235730,0,0,0,0,0,0,862000,173000,689000,689000
20200430,060285,聯電元大9C購01,2.10,2.12,2.06,2.12,+0.11,5.47,197000,14,413200,0,0,0,0,0,0,45000,100000,-55000,-55000
20200430,060286,佳世達元大9C購01,2.37,2.51,2.37,2.51,+0.18,7.73,133000,12,324220,0,0,0,0,0,0,62000,112000,-50000,-50000
20200430,060287,燿華元大9A購01,2.96,3.09,2.91,3.06,+0.20,6.99,621000,46,1851740,0,0,0,0,0,0,258000,361000,-103000,-103000
20200430,060288,群光元大9C購01,2.87,2.87,2.79,2.84,+0.04,1.43,220000,24,622830,0,0,0,0,0,0,209000,53000,156000,156000
20200430,060289,京元電元大9A購01,,,,,0.00,0.00,0,0,0,0,0,0,0,0,0,0,0,0,0
20200430,06028P,智邦台新97售01,,,,,0.00,0.00,0,0,0,0,0,0,0,0,0,0,0,0,0
20200430,060290,興富發元大9C購01,2.71,2.71,2.62,2.62,-0.04,-1.5,153000,15,405080,0,0,0,0,0,0,153000,17000,136000,136000
20200430,060291,高鐵元大9A購01,5.95,5.95,5.75,5.75,+0.05,0.88,148000,16,862550,0,0,0,0,0,0,136000,27000,109000,109000
20200430,060292,聯詠元大9A購01,2.29,2.41,2.25,2.41,+0.17,7.59,360000,38,832420,0,0,0,0,0,0,265000,127000,138000,138000
20200430,060293,緯創元大9A購01,3.10,3.25,3.03,3.16,+0.11,3.61,652000,46,2016860,0,0,0,0,0,0,507000,145000,362000,362000
20200430,060294,嘉澤元大9A購01,3.75,4.09,3.68,4.09,+0.41,11.14,606000,60,2346840,0,0,0,0,0,0,429000,384000,45000,45000
20200430,060295,貿聯元大9A購03,3.24,3.80,3.24,3.75,+0.66,21.36,147000,20,518020,0,0,0,0,0,0,10000,137000,-127000,-127000
20200430,060296,和碩元大9A購01,3.55,3.63,3.53,3.55,-0.08,-2.2,161000,18,576870,0,0,0,0,0,0,35000,111000,-76000,-76000
20200430,060297,和碩元大9A購02,2.85,2.91,2.84,2.85,-0.03,-1.04,193000,17,553270,0,0,0,0,0,0,39000,149000,-110000,-110000
20200430,060298,鎧勝元大9C購01,3.99,4.34,3.99,4.20,+0.17,4.22,403000,31,1681600,0,0,0,0,0,0,115000,288000,-173000,-173000
20200430,060299,友訊國泰9B購01,1.09,1.14,1.05,1.05,-0.01,-0.94,1043000,19,1121570,0,0,0,0,0,0,98000,945000,-847000,-847000
20200430,06029P,聯發科台新96售02,1.57,1.57,0.32,0.32,0.00,0.00,35000,4,42400,0,0,0,0,0,0,20000,35000,-15000,-15000
20200430,060300,佐登國泰9B購01,1.91,1.91,1.87,1.89,+0.05,2.72,194000,8,368540,0,0,0,0,0,0,163000,69000,94000,94000
20200430,060301,國巨富邦9C購02,1.41,1.41,1.41,1.41,+0.05,3.68,22000,3,31020,0,0,0,0,0,0,17000,5000,12000,12000
20200430,060302,台積電富邦02購01,0.97,0.99,0.96,0.99,+0.07,7.61,1167000,50,1136470,0,0,0,0,0,0,358000,756000,-398000,-398000
20200430,060303,宏達電富邦9B購01,0.79,0.79,0.78,0.79,+0.02,2.6,34000,3,26660,0,0,0,0,0,0,0,34000,-34000,-34000
20200430,060304,大立光富邦9C購05,0.67,0.67,0.66,0.66,+0.06,10.0,2000,2,1330,0,0,0,0,0,0,0,2000,-2000,-2000
20200430,060305,得力永豐9A購01,1.66,1.66,1.66,1.66,+0.17,11.41,60000,1,99600,0,0,0,0,0,0,0,60000,-60000,-60000
20200430,060306,台肥永豐9A購01,1.14,1.18,1.14,1.18,+0.05,4.42,173000,9,200170,0,0,0,0,0,0,73000,100000,-27000,-27000
20200430,060307,南港永豐9A購01,1.12,1.14,1.01,1.06,-0.04,-3.64,645000,27,700240,0,0,0,0,0,0,296000,339000,-43000,-43000
20200430,060308,劍麟永豐9A購01,1.36,1.50,1.36,1.44,+0.11,8.27,562000,25,804110,0,0,0,0,0,0,65000,497000,-432000,-432000
20200430,060309,佳世達永豐9A購01,1.12,1.12,1.12,1.12,+0.10,9.8,15000,1,16800,0,0,0,0,0,0,0,15000,-15000,-15000
20200430,06030P,友達兆豐96售02,,,,,0.00,0.00,0,0,0,0,0,0,0,0,0,0,0,0,0
20200430,060310,瑞昱永豐9A購01,1.38,1.53,1.38,1.53,+0.17,12.5,506000,30,736090,0,0,0,0,0,0,210000,282000,-72000,-72000
20200430,060311,盟立永豐9A購01,,,,,0.00,0.00,0,0,0,0,0,0,0,0,0,0,0,0,0
20200430,060312,潤泰全永豐9A購01,0.72,0.80,0.72,0.80,+0.05,6.67,597000,28,457240,0,0,0,0,0,0,243000,354000,-111000,-111000
20200430,060313,淘帝永豐9A購01,1.30,1.33,1.30,1.32,+0.07,5.6,153000,9,201280,0,0,0,0,0,0,83000,70000,13000,13000
20200430,060314,元翎永豐9A購01,1.19,1.25,1.15,1.25,+0.11,9.65,218000,21,261740,0,0,0,0,0,0,88000,130000,-42000,-42000
20200430,060315,易華電永豐9A購01,1.43,1.49,1.43,1.45,+0.07,5.07,328000,20,478540,0,0,0,0,0,0,1000,327000,-326000,-326000
20200430,060316,福懋科永豐9A購01,1.20,1.20,1.20,1.20,0.00,0.00,1000,1,1200,0,0,0,0,0,0,0,1000,-1000,-1000
20200430,060317,台灣50群益02購01,2.66,2.66,2.66,2.66,+0.14,5.56,1000,1,2660,0,0,0,0,0,0,1000,0,1000,1000
20200430,060318,上証2X群益9C購03,,,,,0.00,0.00,0,0,0,0,0,0,0,0,0,0,0,0,0
20200430,060319,臺指反群益9A購02,,,,,0.00,0.00,0,0,0,0,0,0,0,0,0,0,0,0,0
20200430,06031P,新光金兆豐96售02,,,,,0.00,0.00,0,0,0,0,0,0,0,0,0,0,0,0,0
20200430,060320,元金2X群益02購01,1.40,1.40,1.38,1.40,-0.01,-0.71,269000,13,374250,0,0,0,0,0,0,102000,163000,-61000,-61000
20200430,060321,元金2X群益9B購01,2.05,2.05,2.05,2.05,0.00,0.00,5000,1,10250,0,0,0,0,0,0,0,5000,-5000,-5000
20200430,060322,卜蜂群益9A購01,1.73,1.73,1.73,1.73,-0.04,-2.26,12000,1,20760,0,0,0,0,0,0,12000,0,12000,12000
20200430,060323,華通群益9C購01,2.05,2.25,2.04,2.25,+0.28,14.21,691000,35,1448250,0,0,0,0,0,0,625000,60000,565000,565000
20200430,060324,台積電群益9B購02,2.35,2.35,2.35,2.35,+0.09,3.98,33000,1,77550,0,0,0,0,0,0,33000,0,33000,33000
20200430,060325,旺宏群益9A購02,,,,,0.00,0.00,0,0,0,0,0,0,0,0,0,0,0,0,0
20200430,060326,群光群益9A購01,3.00,3.01,2.92,3.01,-0.01,-0.33,110000,7,328010,0,0,0,0,0,0,110000,20000,90000,90000
20200430,060327,美律群益9A購02,1.74,1.91,1.73,1.86,+0.17,10.06,527000,22,959460,0,0,0,0,0,0,63000,479000,-416000,-416000
20200430,060328,可成群益9A購06,3.69,3.71,3.46,3.46,-0.19,-5.21,14000,4,51580,0,0,0,0,0,0,14000,4000,10000,10000
20200430,060329,鎧勝群益9B購01,2.18,2.31,2.17,2.24,+0.13,6.16,236000,9,526290,0,0,0,0,0,0,25000,211000,-186000,-186000
20200430,06032P,健策群益97售03,,,,,0.00,0.00,0,0,0,0,0,0,0,0,0,0,0,0,0
20200430,060330,台灣50麥證9A購03,1.77,1.80,1.77,1.80,+0.14,8.43,6000,2,10680,4000,2000,2000,0,0,0,4000,2000,2000,2000
20200430,060331,台積電麥證9A購01,1.63,1.63,1.63,1.63,+0.01,0.62,9000,1,14670,9000,0,9000,0,0,0,9000,0,9000,9000
20200430,060332,聯發科麥證9A購01,2.49,2.55,2.49,2.55,+0.26,11.35,59000,7,148970,26000,33000,-7000,0,0,0,26000,33000,-7000,-7000
20200430,060333,金寶康和9A購01,2.65,2.70,2.53,2.70,+0.05,1.89,128000,34,339030,0,0,0,0,0,0,108000,20000,88000,88000
20200430,060334,群光康和9A購01,4.20,4.21,4.20,4.21,+0.10,2.43,35000,3,147060,0,0,0,0,0,0,35000,0,35000,35000
20200430,060335,明泰康和9A購01,3.78,3.78,3.41,3.44,-0.15,-4.18,128000,23,476470,0,0,0,0,0,0,101000,27000,74000,74000
20200430,060336,南電康和9A購01,3.70,3.78,3.39,3.54,-0.01,-0.28,251000,35,928260,0,15000,-15000,0,0,0,246000,6000,240000,225000
20200430,060337,FBVIX統一9A購01,0.51,0.52,0.50,0.50,-0.05,-9.09,217000,9,110620,0,0,0,0,0,0,155000,62000,93000,93000
20200430,060338,鴻海統一9C購02,1.02,1.03,1.02,1.03,+0.01,0.98,30000,2,30850,0,0,0,0,0,0,30000,0,30000,30000
20200430,060339,國巨統一01購01,2.15,2.16,2.14,2.16,+0.09,4.35,116000,4,249310,0,0,0,0,0,0,11000,105000,-94000,-94000
20200430,06033P,可成凱基96售09,0.05,0.05,0.05,0.05,0.00,0.00,14000,1,700,0,0,0,0,0,0,14000,0,14000,14000
20200430,060340,國巨統一01購02,1.65,1.65,1.62,1.62,+0.04,2.53,32000,7,52250,0,0,0,0,0,0,23000,4000,19000,19000
20200430,060341,國巨統一9C購02,1.56,1.56,1.56,1.56,0.00,0.00,10000,1,15600,0,0,0,0,0,0,0,10000,-10000,-10000
20200430,060342,台積電統一02購01,1.39,1.41,1.39,1.41,+0.04,2.92,145000,13,202380,0,0,0,0,0,0,52000,93000,-41000,-41000
20200430,060343,台積電統一9C購02,1.15,1.16,1.15,1.16,+0.04,3.57,10000,2,11580,0,0,0,0,0,0,2000,8000,-6000,-6000
20200430,060344,聯發科統一01購01,1.27,1.30,1.27,1.29,+0.09,7.5,320000,15,411740,0,0,0,0,0,0,282000,38000,244000,244000
20200430,060345,聯發科統一9B購05,1.62,1.62,1.62,1.62,+0.12,8.0,52000,2,84240,0,0,0,0,0,0,52000,0,52000,52000
20200430,060346,華新科統一01購01,2.02,2.02,1.96,1.96,-0.05,-2.49,218000,3,435880,0,0,0,0,0,0,0,218000,-218000,-218000
20200430,060347,大立光統一02購01,1.16,1.23,1.16,1.23,+0.09,7.89,107000,12,126170,0,0,0,0,0,0,14000,93000,-79000,-79000
20200430,060348,上証2X元富9A購03,,,,,0.00,0.00,0,0,0,0,0,0,0,0,0,0,0,0,0
20200430,060349,上証2X元富9A購04,2.87,2.87,2.87,2.87,0.00,0.00,4000,1,11480,0,0,0,0,0,0,0,4000,-4000,-4000
20200430,06034P,世芯凱基96售03,0.18,0.18,0.17,0.17,-0.08,-32.0,103000,3,17960,0,0,0,0,0,0,103000,0,103000,103000
20200430,060350,元黃金元富9B購01,1.77,1.77,1.76,1.76,-0.03,-1.68,35000,4,61900,0,0,0,0,0,0,25000,10000,15000,15000
20200430,060351,滬深2X元富9A購01,2.31,2.46,2.30,2.31,+0.08,3.59,51000,13,121030,0,0,0,0,0,0,47000,44000,3000,3000
20200430,060352,滬深2X元富9A購02,2.06,2.09,1.98,1.98,+0.12,6.45,28000,7,57280,0,0,0,0,0,0,28000,28000,0,0
20200430,060353,A50正2元富9A購01,,,,,0.00,0.00,0,0,0,0,0,0,0,0,0,0,0,0,0
20200430,060354,A50正2元富9A購02,3.75,3.75,3.75,3.75,+0.15,4.17,10000,1,37500,0,0,0,0,0,0,10000,0,10000,10000
20200430,060355,元金2X元富9C購01,1.79,1.79,1.78,1.78,-0.02,-1.11,40000,2,71400,0,0,0,0,0,0,0,40000,-40000,-40000
20200430,060356,上銀元富9A購01,7.40,8.40,7.40,8.40,+1.35,19.15,46000,16,343700,0,0,0,0,0,0,44000,2000,42000,42000
20200430,060357,上銀元富9A購02,,,,,0.00,0.00,0,0,0,0,0,0,0,0,0,0,0,0,0
20200430,060358,國巨元富9A購01,4.20,4.20,4.20,4.20,0.00,0.00,5000,1,21000,0,0,0,0,0,0,5000,0,5000,5000
20200430,060359,國巨元富9A購02,,,,,0.00,0.00,0,0,0,0,0,0,0,0,0,0,0,0,0
20200430,06035P,同欣電凱基96售03,1.15,1.15,1.08,1.08,-0.12,-10.0,110000,6,121600,0,0,0,0,0,0,110000,0,110000,110000
20200430,060360,南亞科元富9A購02,3.25,3.26,3.20,3.21,+0.11,3.55,403000,39,1311330,0,0,0,0,0,0,402000,1000,401000,401000
20200430,060361,南亞科元富9A購03,2.83,2.83,2.76,2.78,+0.04,1.46,397000,38,1116180,0,0,0,0,0,0,337000,60000,277000,277000
20200430,060362,建準元富9A購02,2.49,2.51,2.39,2.45,-0.14,-5.41,367000,26,894250,0,0,0,0,0,0,313000,50000,263000,263000
20200430,060363,美律元富9A購01,2.08,2.27,2.08,2.20,+0.14,6.8,558000,31,1199390,0,0,0,0,0,0,205000,423000,-218000,-218000
20200430,060364,奇力新元富9A購01,4.12,4.43,4.07,4.17,+0.19,4.77,247000,20,1051060,0,0,0,0,0,0,81000,246000,-165000,-165000
20200430,060365,京鼎元富9A購01,4.45,5.10,4.45,4.67,+0.38,8.86,170000,15,797450,0,0,0,0,0,0,80000,90000,-10000,-10000
20200430,060366,健策元富9A購01,2.14,2.21,2.10,2.21,+0.13,6.25,430000,35,922370,0,0,0,0,0,0,210000,220000,-10000,-10000
20200430,060367,緯穎元富9A購02,2.29,2.51,2.28,2.51,+0.33,15.14,619000,33,1456340,0,0,0,0,0,0,152000,467000,-315000,-315000
20200430,060368,緯穎元富9A購03,2.63,3.09,2.61,2.94,+0.38,14.84,874000,55,2462100,0,0,0,0,0,0,249000,654000,-405000,-405000
20200430,060369,滬深2X元富01購01,2.39,2.43,2.27,2.27,+0.07,3.18,138000,18,325230,0,0,0,0,0,0,3000,138000,-135000,-135000
20200430,06036P,台表科凱基96售04,1.77,1.85,1.77,1.84,0.00,0.00,156000,4,287120,0,0,0,0,0,0,0,156000,-156000,-156000
20200430,060370,滬深2X元富04購01,,,,,0.00,0.00,0,0,0,0,0,0,0,0,0,0,0,0,0
20200430,060371,A50正2元富01購01,3.22,3.22,3.22,3.22,+0.23,7.69,5000,1,16100,0,0,0,0,0,0,5000,0,5000,5000
20200430,060372,A50正2元富9A購04,3.38,3.38,3.38,3.38,+0.33,10.82,1000,1,3380,0,0,0,0,0,0,1000,0,1000,1000
20200430,060373,元金2X元富9A購01,1.43,1.44,1.43,1.44,-0.02,-1.37,40000,2,57300,0,0,0,0,0,0,0,40000,-40000,-40000
20200430,060374,儒鴻元富9A購01,3.02,3.18,2.99,3.18,+0.30,10.42,582000,44,1803530,0,0,0,0,0,0,230000,367000,-137000,-137000
20200430,060375,葡萄王元富9A購01,1.65,1.69,1.65,1.69,+0.04,2.42,184000,6,308640,0,0,0,0,0,0,27000,148000,-121000,-121000
20200430,060376,瑞祺元富9A購01,2.88,2.91,2.71,2.77,+0.03,1.09,769000,40,2155230,0,0,0,0,0,0,177000,588000,-411000,-411000
20200430,060377,鴻海台新9A購01,2.25,2.25,2.25,2.25,0.00,0.00,18000,1,40500,0,0,0,0,0,0,0,18000,-18000,-18000
20200430,060378,台灣50凱基04購01,,,,,0.00,0.00,0,0,0,0,0,0,0,0,0,0,0,0,0
20200430,060379,T50反1凱基9A購07,0.62,0.63,0.58,0.58,-0.08,-12.12,241000,11,143990,0,0,0,0,0,0,156000,85000,71000,71000
20200430,06037P,超眾國票98售02,,,,,0.00,0.00,0,0,0,0,0,0,0,0,0,0,0,0,0
20200430,060380,T50反1凱基9A購08,0.88,0.88,0.82,0.83,-0.12,-12.63,1489000,15,1298390,0,0,0,0,0,0,1178000,211000,967000,967000
20200430,060381,元黃金凱基9A購01,0.64,0.64,0.64,0.64,-0.02,-3.03,62000,5,39680,0,0,0,0,0,0,59000,0,59000,59000
20200430,060382,儒鴻凱基9A購01,2.29,2.42,2.28,2.42,+0.20,9.01,310000,24,728440,0,0,0,0,0,0,159000,151000,8000,8000
20200430,060383,葡萄王凱基9A購01,0.92,0.94,0.92,0.94,+0.01,1.08,179000,5,165260,0,0,0,0,0,0,0,179000,-179000,-179000
20200430,060384,葡萄王凱基9B購01,1.17,1.18,1.17,1.17,0.00,0.00,30000,4,35250,0,0,0,0,0,0,15000,10000,5000,5000
20200430,060385,台勝科凱基9A購01,1.23,1.53,1.23,1.50,+0.29,23.97,750000,73,1010830,0,0,0,0,0,0,192000,399000,-207000,-207000
20200430,060386,台勝科凱基9B購01,1.61,1.95,1.61,1.95,+0.41,26.62,293000,16,498650,0,0,0,0,0,0,13000,280000,-267000,-267000
20200430,060387,盛群凱基9A購01,1.62,1.64,1.61,1.64,-0.01,-0.61,105000,6,170270,0,0,0,0,0,0,25000,80000,-55000,-55000
20200430,060388,世紀鋼凱基9B購01,1.74,1.74,1.74,1.74,+0.11,6.75,1000,1,1740,0,0,0,0,0,0,0,1000,-1000,-1000
20200430,060389,世紀鋼凱基9B購02,0.84,0.85,0.84,0.85,0.00,0.00,39000,6,33000,0,0,0,0,0,0,0,39000,-39000,-39000
20200430,06038P,國泰金台新96售01,0.30,0.30,0.09,0.09,-0.33,-78.57,246000,15,64480,0,0,0,0,0,0,0,246000,-246000,-246000
20200430,060390,聯鈞群益9A購01,1.47,1.47,1.46,1.46,-0.05,-3.31,32000,2,47010,0,0,0,0,0,0,32000,0,32000,32000
20200430,060391,華擎群益9C購01,1.96,1.96,1.92,1.92,+0.01,0.52,271000,4,522260,0,0,0,0,0,0,271000,0,271000,271000
20200430,060392,華擎群益9C購02,2.29,2.30,2.20,2.22,+0.04,1.83,1061000,29,2365490,0,0,0,0,0,0,470000,591000,-121000,-121000
20200430,060393,泰鼎群益9A購01,3.14,3.14,3.00,3.10,-0.08,-2.52,207000,17,633220,0,0,0,0,0,0,101000,157000,-56000,-56000
20200430,060394,欣興麥證9A購01,3.33,3.47,3.31,3.34,+0.11,3.41,109000,18,369440,51000,58000,-7000,0,0,0,51000,58000,-7000,-7000
20200430,060395,儒鴻國票9A購01,4.65,4.97,4.65,4.97,+0.51,11.43,112000,17,533440,0,0,0,0,0,0,2000,110000,-108000,-108000
20200430,060396,友達國票9A購01,,,,,0.00,0.00,0,0,0,0,0,0,0,0,0,0,0,0,0
20200430,060397,群創國票9A購01,1.15,1.18,1.13,1.18,+0.06,5.36,567000,13,662090,0,0,0,0,0,0,223000,344000,-121000,-121000
20200430,060398,立積國票9B購01,2.97,3.25,2.97,3.18,+0.21,7.07,74000,5,233140,0,0,0,0,0,0,73000,1000,72000,72000
20200430,060399,康友國票9A購02,3.95,4.20,3.95,4.20,+0.41,10.82,686000,12,2843040,0,0,0,0,0,0,672000,18000,654000,654000
20200430,06039P,亞光台新96售03,,,,,0.00,0.00,0,0,0,0,0,0,0,0,0,0,0,0,0
20200430,060400,南電國票9A購03,7.40,7.40,7.40,7.40,0.00,0.00,9000,2,66600,0,0,0,0,0,0,9000,0,9000,9000
20200430,060401,世紀鋼國票9B購01,2.91,3.09,2.84,3.09,+0.24,8.42,1086000,11,3128250,0,0,0,0,0,0,499000,582000,-83000,-83000
20200430,060402,神隆國泰9B購01,1.63,1.63,1.60,1.60,+0.02,1.27,60000,4,96900,0,0,0,0,0,0,60000,0,60000,60000
20200430,060403,上銀國泰9B購01,2.65,2.80,2.65,2.80,+0.43,18.14,83000,6,223100,0,0,0,0,0,0,61000,22000,39000,39000
20200430,060404,台勝科國泰9B購01,1.88,2.30,1.88,2.28,+0.45,24.59,1439000,84,2977170,0,0,0,0,0,0,393000,1085000,-692000,-692000
20200430,060405,中租國泰9C購01,3.42,3.50,3.38,3.50,+0.26,8.02,78000,7,270790,0,0,0,0,0,0,73000,5000,68000,68000
20200430,060406,瑞祺國泰9B購01,1.79,1.79,1.69,1.72,0.00,0.00,142000,10,244930,0,0,0,0,0,0,77000,50000,27000,27000
20200430,060407,南六國泰9C購01,3.99,3.99,3.95,3.99,0.00,0.00,27000,3,107650,0,0,0,0,0,0,27000,0,27000,27000
20200430,060408,和潤國泰9C購01,2.58,2.60,2.54,2.54,+0.02,0.79,87000,4,224880,0,0,0,0,0,0,87000,0,87000,87000
20200430,060409,味全永豐9A購01,1.14,1.18,1.13,1.18,+0.07,6.31,240000,13,281510,0,0,0,0,0,0,20000,220000,-200000,-200000
20200430,06040P,亞光康和96售03,,,,,0.00,0.00,0,0,0,0,0,0,0,0,0,0,0,0,0
20200430,060410,台苯永豐9A購01,1.31,1.39,1.31,1.39,+0.05,3.73,162000,11,220820,0,0,0,0,0,0,130000,30000,100000,100000
20200430,060411,達新永豐9A購01,0.88,0.88,0.88,0.88,+0.01,1.15,1000,1,880,0,0,0,0,0,0,1000,0,1000,1000
20200430,060412,儒鴻永豐9A購01,1.49,1.60,1.49,1.60,+0.17,11.89,328000,29,509610,0,0,0,0,0,0,61000,303000,-242000,-242000
20200430,060413,東元永豐9A購01,1.59,1.64,1.59,1.64,0.00,0.00,143000,5,231880,0,0,0,0,0,0,44000,99000,-55000,-55000
20200430,060414,中興電永豐9A購01,1.26,1.35,1.23,1.35,+0.13,10.66,256000,5,321380,0,0,0,0,0,0,116000,140000,-24000,-24000
20200430,060415,葡萄王永豐9A購01,0.89,0.90,0.89,0.90,0.00,0.00,138000,9,123350,0,0,0,0,0,0,78000,78000,0,0
20200430,060416,神隆永豐9A購01,,,,,0.00,0.00,0,0,0,0,0,0,0,0,0,0,0,0,0
20200430,060417,正隆永豐9A購01,1.01,1.01,1.01,1.01,-0.01,-0.98,41000,3,41410,0,0,0,0,0,0,18000,23000,-5000,-5000
20200430,060418,中橡永豐9A購01,1.20,1.21,1.20,1.21,-0.01,-0.82,160000,8,192510,0,0,0,0,0,0,109000,51000,58000,58000
20200430,060419,漢翔永豐9A購01,1.10,1.11,1.10,1.11,+0.12,12.12,24000,2,26520,0,0,0,0,0,0,0,24000,-24000,-24000
20200430,06041P,全新永豐96售03,,,,,0.00,0.00,0,0,0,0,0,0,0,0,0,0,0,0,0
20200430,060420,神基永豐9A購01,1.10,1.13,1.07,1.12,+0.02,1.82,129000,8,142950,0,0,0,0,0,0,27000,102000,-75000,-75000
20200430,060421,華擎永豐9A購01,0.69,0.69,0.69,0.69,-0.01,-1.43,1000,1,690,0,0,0,0,0,0,1000,0,1000,1000
20200430,060422,台勝科永豐9A購01,0.99,1.23,0.99,1.19,+0.22,22.68,1554000,79,1727160,0,0,0,0,0,0,164000,1379000,-1215000,-1215000
20200430,060423,智易永豐9A購01,1.35,1.35,1.33,1.33,+0.01,0.76,33000,7,44110,0,0,0,0,0,0,33000,0,33000,33000
20200430,060424,中租永豐9A購01,1.62,1.72,1.62,1.69,+0.16,10.46,450000,20,748410,0,0,0,0,0,0,2000,448000,-446000,-446000
20200430,060425,凌華永豐9A購01,0.78,0.78,0.78,0.78,0.00,0.00,75000,2,58500,0,0,0,0,0,0,0,75000,-75000,-75000
20200430,060426,盛群永豐9A購01,1.10,1.10,1.08,1.08,-0.05,-4.42,28000,3,30760,0,0,0,0,0,0,26000,2000,24000,24000
20200430,060427,聯茂永豐9A購01,1.05,1.05,1.01,1.04,-0.02,-1.89,264000,10,273850,0,0,0,0,0,0,204000,62000,142000,142000
20200430,060428,瑞祺永豐9A購01,1.07,1.07,1.01,1.03,-0.01,-0.96,382000,31,399910,0,0,0,0,0,0,258000,102000,156000,156000
20200430,060429,南六永豐9A購01,2.42,2.42,2.15,2.27,-0.27,-10.63,161000,25,371800,0,0,0,0,0,0,93000,64000,29000,29000
20200430,06042P,華新科永豐96售04,0.25,0.27,0.25,0.27,0.00,0.00,100000,3,26000,0,0,0,0,0,0,50000,50000,0,0
20200430,060430,和潤永豐9A購01,1.82,1.82,1.77,1.77,-0.03,-1.67,420000,25,759390,0,0,0,0,0,0,404000,15000,389000,389000
20200430,060431,復盛永豐9A購01,1.03,1.05,0.98,1.01,-0.01,-0.98,1245000,32,1268020,0,0,0,0,0,0,1215000,0,1215000,1215000
20200430,060432,達方永豐9A購01,1.51,1.57,1.50,1.53,+0.05,3.38,223000,11,340810,0,0,0,0,0,0,118000,101000,17000,17000
20200430,060433,億豐永豐9A購01,1.55,1.72,1.55,1.68,-0.01,-0.59,119000,11,194260,0,0,0,0,0,0,87000,32000,55000,55000
20200430,060434,台汽電永豐9A購01,1.11,1.14,1.11,1.13,+0.02,1.8,395000,21,445670,0,0,0,0,0,0,73000,322000,-249000,-249000
20200430,060435,鈺齊永豐9A購01,1.23,1.27,1.20,1.26,+0.03,2.44,983000,31,1214030,0,0,0,0,0,0,753000,231000,522000,522000
20200430,060436,巨大永豐9A購01,1.50,1.79,1.49,1.65,+0.19,13.01,1627000,92,2579530,0,0,0,0,0,0,683000,912000,-229000,-229000
20200430,060437,宏全永豐9A購01,1.14,1.24,1.12,1.24,+0.09,7.83,1185000,41,1399190,0,0,0,0,0,0,483000,692000,-209000,-209000
20200430,060438,台灣50元大9A購11,,,,,0.00,0.00,0,0,0,0,0,0,0,0,0,0,0,0,0
20200430,060439,台灣50元大9C購26,,,,,0.00,0.00,0,0,0,0,0,0,0,0,0,0,0,0,0
20200430,06043P,創意永豐96售06,0.39,0.39,0.35,0.36,-0.04,-10.0,60000,6,21800,0,0,0,0,0,0,30000,30000,0,0
20200430,060440,台灣50元大9C購27,,,,,0.00,0.00,0,0,0,0,0,0,0,0,0,0,0,0,0
20200430,060441,上証2X元大9A購01,,,,,0.00,0.00,0,0,0,0,0,0,0,0,0,0,0,0,0
20200430,060442,滬深2X元大9A購02,1.80,1.80,1.76,1.76,0.00,0.00,6000,3,10680,0,0,0,0,0,0,0,6000,-6000,-6000
20200430,060443,滬深2X元大9A購03,,,,,0.00,0.00,0,0,0,0,0,0,0,0,0,0,0,0,0
20200430,060444,滬深2X元大9A購04,1.22,1.22,1.18,1.18,0.00,0.00,3000,2,3580,0,0,0,0,0,0,1000,2000,-1000,-1000
20200430,060445,S&P反1元大9A購04,,,,,0.00,0.00,0,0,0,0,0,0,0,0,0,0,0,0,0
20200430,060446,A50正2元大9A購01,,,,,0.00,0.00,0,0,0,0,0,0,0,0,0,0,0,0,0
20200430,060447,A50正2元大9A購02,2.43,2.43,2.43,2.43,0.00,0.00,1000,1,2430,0,0,0,0,0,0,0,1000,-1000,-1000
20200430,060448,道瓊反元大9A購04,0.74,0.74,0.71,0.71,-0.07,-8.97,302000,5,220420,0,0,0,0,0,0,0,302000,-302000,-302000
20200430,060449,元金2X元大9A購02,2.22,2.22,2.22,2.22,0.00,0.00,5000,1,11100,0,0,0,0,0,0,0,5000,-5000,-5000
20200430,06044P,同欣電永豐96售03,1.56,1.56,1.45,1.45,-0.20,-12.12,80000,6,120100,0,0,0,0,0,0,0,80000,-80000,-80000
20200430,060450,南亞元大9A購02,2.97,3.33,2.95,3.33,+0.48,16.84,250000,16,802940,0,0,0,0,0,0,77000,124000,-47000,-47000
20200430,060451,中石化元大9C購02,1.41,1.52,1.40,1.49,+0.09,6.43,966000,47,1436030,0,0,0,0,0,0,489000,483000,6000,6000
20200430,060452,儒鴻元大9A購01,4.03,4.28,4.03,4.28,+0.40,10.31,252000,40,1042800,0,0,0,0,0,0,77000,184000,-107000,-107000
20200430,060453,儒鴻元大9A購02,3.33,3.50,3.30,3.50,+0.31,9.72,429000,40,1459750,0,0,0,0,0,0,196000,258000,-62000,-62000
20200430,060454,葡萄王元大9A購01,2.06,2.06,2.06,2.06,-0.01,-0.48,38000,3,78280,0,0,0,0,0,0,33000,24000,9000,9000
20200430,060455,葡萄王元大9A購02,2.01,2.01,2.01,2.01,-0.01,-0.5,56000,5,112560,0,0,0,0,0,0,33000,41000,-8000,-8000
20200430,060456,正隆元大9A購01,2.17,2.20,2.13,2.20,+0.03,1.38,75000,7,162230,0,0,0,0,0,0,65000,10000,55000,55000
20200430,060457,中橡元大9A購02,2.66,2.68,2.55,2.60,-0.04,-1.52,193000,12,505710,0,0,0,0,0,0,131000,112000,19000,19000
20200430,060458,華通元大9A購02,3.07,3.32,3.07,3.32,+0.41,14.09,130000,9,415830,0,0,0,0,0,0,14000,117000,-103000,-103000
20200430,060459,鴻海元大9A購07,3.29,3.35,3.29,3.35,+0.12,3.72,85000,8,281770,0,0,0,0,0,0,22000,60000,-38000,-38000
20200430,06045P,臺股指永豐96售03,,,,,0.00,0.00,0,0,0,0,0,0,0,0,0,0,0,0,0
20200430,060460,鴻海元大9A購08,2.65,2.72,2.61,2.72,+0.13,5.02,115000,11,307700,0,0,0,0,0,0,60000,55000,5000,5000
20200430,060461,鴻海元大9A購09,4.14,4.22,4.07,4.21,+0.13,3.19,103000,14,430010,0,0,0,0,0,0,61000,103000,-42000,-42000
20200430,060462,鴻海元大9A購10,,,,,0.00,0.00,0,0,0,0,0,0,0,0,0,0,0,0,0
20200430,060463,台積電元大9A購10,2.59,2.71,2.59,2.71,+0.16,6.27,57000,5,149430,0,0,0,0,0,0,0,57000,-57000,-57000
20200430,060464,台積電元大9A購11,4.12,4.17,4.12,4.17,+0.03,0.72,62000,3,257040,0,0,0,0,0,0,32000,30000,2000,2000
20200430,060465,聯發科元大9A購02,3.43,3.53,3.41,3.53,+0.36,11.36,22000,8,76590,0,0,0,0,0,0,10000,3000,7000,7000
20200430,060466,玉山金元大9A購01,3.43,3.51,3.43,3.51,+0.18,5.41,121000,32,418430,0,0,0,0,0,0,79000,58000,21000,21000
20200430,060467,神基元大9A購01,2.27,2.36,2.27,2.36,+0.14,6.31,490000,23,1137120,0,0,0,0,0,0,410000,80000,330000,330000
20200430,060468,聯鈞元大9A購02,3.43,3.43,3.25,3.25,-0.12,-3.56,107000,5,353250,0,0,0,0,0,0,57000,52000,5000,5000
20200430,060469,台勝科元大9A購02,2.93,3.56,2.90,3.50,+0.64,22.38,495000,37,1558750,0,0,0,0,0,0,151000,269000,-118000,-118000
20200430,06046P,健策統一96售03,1.64,1.66,1.54,1.58,-0.13,-7.6,268000,9,433720,0,0,0,0,0,0,90000,216000,-126000,-126000
20200430,060470,台勝科元大9A購03,2.21,2.66,2.21,2.62,+0.44,20.18,468000,46,1141420,0,0,0,0,0,0,104000,361000,-257000,-257000
20200430,060471,台勝科元大9B購01,3.66,4.18,3.66,4.04,+0.57,16.43,242000,22,929990,0,0,0,0,0,0,50000,189000,-139000,-139000
20200430,060472,中租元大9A購02,4.23,4.48,4.18,4.38,+0.38,9.5,258000,27,1102790,0,0,0,0,0,0,152000,93000,59000,59000
20200430,060473,中租元大9A購03,3.25,3.42,3.18,3.42,+0.41,13.62,242000,25,793560,0,0,0,0,0,0,158000,75000,83000,83000
20200430,060474,中租元大9B購01,3.22,3.41,3.15,3.34,+0.32,10.6,335000,31,1100270,0,0,0,0,0,0,146000,189000,-43000,-43000
20200430,060475,瑞祺元大9A購01,2.91,2.91,2.77,2.81,+0.01,0.36,69000,14,197080,0,0,0,0,0,0,67000,22000,45000,45000
20200430,060476,瑞祺元大9A購02,2.78,2.80,2.67,2.74,-0.01,-0.36,188000,24,515030,0,0,0,0,0,0,60000,148000,-88000,-88000
20200430,060477,和潤元大9A購01,3.78,3.82,3.67,3.67,-0.05,-1.34,527000,39,1985970,0,0,0,0,0,0,420000,105000,315000,315000
20200430,060478,南電元大9A購01,,,,,0.00,0.00,0,0,0,0,0,0,0,0,0,0,0,0,0
20200430,060479,億豐元大9A購01,4.05,4.26,3.91,4.12,-0.02,-0.48,160000,18,651780,0,0,0,0,0,0,140000,20000,120000,120000
20200430,06047P,聯發科富邦99售04,,,,,0.00,0.00,0,0,0,0,0,0,0,0,0,0,0,0,0
20200430,060480,億豐元大9A購02,3.40,3.55,3.29,3.46,-0.01,-0.29,228000,19,780270,0,0,0,0,0,0,158000,70000,88000,88000
20200430,060481,巨大元大9A購01,3.68,4.52,3.68,4.52,+0.69,18.02,376000,37,1543410,0,0,0,0,0,0,293000,86000,207000,207000
20200430,060482,東元富邦9A購01,,,,,0.00,0.00,0,0,0,0,0,0,0,0,0,0,0,0,0
20200430,060483,友達富邦9A購01,1.17,1.17,1.15,1.15,0.00,0.00,43000,5,49850,0,0,0,0,0,0,43000,0,43000,43000
20200430,060484,聯發科富邦9C購02,1.71,1.81,1.71,1.79,+0.22,14.01,383000,19,677480,0,0,0,0,0,0,44000,339000,-295000,-295000
20200430,060485,華新科富邦9C購04,1.11,1.13,1.09,1.13,+0.05,4.63,264000,8,288500,0,0,0,0,0,0,259000,3000,256000,256000
20200430,060486,中租富邦9A購01,1.46,1.51,1.44,1.51,+0.11,7.86,271000,33,394910,0,0,0,0,0,0,246000,0,246000,246000
20200430,060487,盛群富邦9B購01,1.43,1.43,1.43,1.43,0.00,0.00,10000,1,14300,0,0,0,0,0,0,0,10000,-10000,-10000
20200430,060488,台灣50群益9C購01,2.30,2.30,2.30,2.30,+0.27,13.3,19000,1,43700,0,0,0,0,0,0,19000,0,19000,19000
20200430,060489,世紀鋼群益9A購01,0.94,1.02,0.94,1.02,+0.09,9.68,217000,8,217020,0,0,0,0,0,0,90000,127000,-37000,-37000
20200430,06048P,大立光富邦96售05,,,,,0.00,0.00,0,0,0,0,0,0,0,0,0,0,0,0,0
20200430,060490,華新科台新9A購01,,,,,0.00,0.00,0,0,0,0,0,0,0,0,0,0,0,0,0
20200430,060491,台灣50元富04購01,,,,,0.00,0.00,0,0,0,0,0,0,0,0,0,0,0,0,0
20200430,060492,元黃金元富9A購01,1.21,1.21,1.21,1.21,0.00,0.00,2000,1,2420,0,0,0,0,0,0,0,2000,-2000,-2000
20200430,060493,美律元富01購01,2.40,2.58,2.40,2.53,+0.17,7.2,557000,36,1372640,0,0,0,0,0,0,220000,404000,-184000,-184000
20200430,060494,台灣50元大01購12,,,,,0.00,0.00,0,0,0,0,0,0,0,0,0,0,0,0,0
20200430,060495,台灣50元大01購13,,,,,0.00,0.00,0,0,0,0,0,0,0,0,0,0,0,0,0
20200430,060496,滬深2X元大9A購05,2.12,2.12,2.07,2.07,0.00,0.00,52000,6,109890,0,0,0,0,0,0,0,52000,-52000,-52000
20200430,060497,臺指反元大01購02,,,,,0.00,0.00,0,0,0,0,0,0,0,0,0,0,0,0,0
20200430,060498,華通元大9A購03,2.32,2.51,2.32,2.46,+0.23,10.31,158000,5,385400,0,0,0,0,0,0,125000,33000,92000,92000
20200430,060499,鴻海元大9A購11,2.75,2.80,2.71,2.80,+0.14,5.26,138000,12,380620,0,0,0,0,0,0,50000,88000,-38000,-38000
20200430,06049P,創意亞東97售01,,,,,0.00,0.00,0,0,0,0,0,0,0,0,0,0,0,0,0
20200430,060500,鴻海元大9A購12,,,,,0.00,0.00,0,0,0,0,0,0,0,0,0,0,0,0,0
20200430,060501,鴻海元大9A購13,2.15,2.15,2.15,2.15,0.00,0.00,17000,1,36550,0,0,0,0,0,0,0,17000,-17000,-17000
20200430,060502,國巨元大9A購07,6.25,6.35,6.10,6.20,+0.30,5.08,13000,5,80350,0,0,0,0,0,0,7000,6000,1000,1000
20200430,060503,技嘉元大9A購01,,,,,0.00,0.00,0,0,0,0,0,0,0,0,0,0,0,0,0
20200430,060504,技嘉元大9A購02,1.46,1.46,1.43,1.43,+0.04,2.88,90000,2,129000,0,0,0,0,0,0,90000,0,90000,90000
20200430,060505,友達元大9C購05,1.94,1.94,1.94,1.94,+0.02,1.04,20000,2,38800,0,0,0,0,0,0,0,20000,-20000,-20000
20200430,060506,京元電元大9A購02,2.16,2.17,2.15,2.17,+0.04,1.88,74000,5,160050,0,0,0,0,0,0,0,74000,-74000,-74000
20200430,060507,聯發科元大9A購03,4.30,4.50,4.27,4.50,+0.59,15.09,50000,10,217950,0,0,0,0,0,0,12000,45000,-33000,-33000
20200430,060508,聯發科元大9A購04,3.25,3.33,3.25,3.29,+0.31,10.4,93000,11,307420,0,0,0,0,0,0,3000,93000,-90000,-90000
20200430,060509,宏達電元大9A購02,,,,,0.00,0.00,0,0,0,0,0,0,0,0,0,0,0,0,0
20200430,06050P,玉晶光國票98售01,,,,,0.00,0.00,0,0,0,0,0,0,0,0,0,0,0,0,0
20200430,060510,大立光元大9A購03,1.46,1.46,1.46,1.46,0.00,0.00,20000,1,29200,0,0,0,0,0,0,0,20000,-20000,-20000
20200430,060511,群創元大9B購08,1.70,1.73,1.70,1.72,+0.07,4.24,158000,11,271960,0,0,0,0,0,0,10000,128000,-118000,-118000
20200430,060512,祥碩元大9A購02,1.36,1.36,1.12,1.17,-0.10,-7.87,324000,36,398450,0,0,0,0,0,0,112000,234000,-122000,-122000
20200430,060513,緯穎元大9B購01,1.71,2.00,1.70,1.89,+0.26,15.95,421000,20,767870,0,0,0,0,0,0,254000,121000,133000,133000
20200430,060514,南電元大9A購02,3.15,3.15,2.96,3.02,-0.02,-0.66,33000,6,103220,0,0,0,0,0,0,30000,3000,27000,27000
20200430,060515,臺股指元大9B購12,2.00,2.00,2.00,2.00,+0.15,8.11,20000,1,40000,0,0,0,0,0,0,0,20000,-20000,-20000
20200430,060516,臺股指元大9B購13,,,,,0.00,0.00,0,0,0,0,0,0,0,0,0,0,0,0,0
20200430,060517,臺股指元大9B購14,,,,,0.00,0.00,0,0,0,0,0,0,0,0,0,0,0,0,0
20200430,060518,台灣50中信01購01,,,,,0.00,0.00,0,0,0,0,0,0,0,0,0,0,0,0,0
20200430,060519,S&P500中信01購01,,,,,0.00,0.00,0,0,0,0,0,0,0,0,0,0,0,0,0
20200430,06051P,嘉聯益國票97售04,2.42,2.46,2.39,2.46,-0.28,-10.22,56000,8,134930,0,0,0,0,0,0,49000,7000,42000,42000
20200430,060520,臺指2X中信01購02,2.89,2.96,2.89,2.94,+0.17,6.14,86000,5,248870,0,0,0,0,0,0,84000,2000,82000,82000
20200430,060521,鴻海中信01購03,1.06,1.08,1.06,1.08,+0.06,5.88,131000,9,140380,0,0,0,0,0,0,6000,125000,-119000,-119000
20200430,060522,鴻海中信9A購03,1.08,1.11,1.07,1.11,+0.07,6.73,36000,8,38950,0,0,0,0,0,0,29000,7000,22000,22000
20200430,060523,鴻海中信9C購03,1.09,1.09,1.09,1.09,0.00,0.00,8000,1,8720,0,0,0,0,0,0,8000,0,8000,8000
20200430,060524,國巨中信9A購03,2.04,2.04,2.00,2.00,+0.04,2.04,20000,2,40400,0,0,0,0,0,0,10000,10000,0,0
20200430,060525,台積電中信01購04,1.56,1.58,1.56,1.58,+0.04,2.6,40000,3,62900,0,0,0,0,0,0,10000,30000,-20000,-20000
20200430,060526,台積電中信9A購02,,,,,0.00,0.00,0,0,0,0,0,0,0,0,0,0,0,0,0
20200430,060527,台積電中信9C購04,1.62,1.63,1.62,1.63,+0.07,4.49,7000,2,11370,0,0,0,0,0,0,7000,0,7000,7000
20200430,060528,友達中信9C購01,1.50,1.50,1.46,1.49,+0.04,2.76,491000,16,726960,0,0,0,0,0,0,451000,40000,411000,411000
20200430,060529,聯發科中信9A購04,1.14,1.20,1.12,1.20,+0.17,16.5,323000,31,367970,0,0,0,0,0,0,310000,13000,297000,297000
20200430,06052P,台郡國票97售06,0.81,0.81,0.77,0.77,-0.09,-10.47,115000,3,88830,0,0,0,0,0,0,108000,7000,101000,101000
20200430,060530,聯發科中信9C購03,1.02,1.05,1.02,1.05,+0.11,11.7,136000,7,139150,0,0,0,0,0,0,136000,0,136000,136000
20200430,060531,大立光中信9A購04,0.79,0.79,0.79,0.79,0.00,0.00,3000,1,2370,0,0,0,0,0,0,0,3000,-3000,-3000
20200430,060532,欣興中信9A購01,1.74,1.77,1.71,1.71,+0.05,3.01,123000,17,213430,0,0,0,0,0,0,81000,43000,38000,38000
20200430,060533,臺股指中信9B購05,1.83,1.96,1.81,1.96,+0.22,12.64,32000,12,59280,0,0,0,0,0,0,29000,3000,26000,26000
20200430,060534,友達麥證9A購01,1.41,1.42,1.40,1.42,+0.02,1.43,11000,4,15470,8000,3000,5000,0,0,0,8000,3000,5000,5000
20200430,060535,群創麥證9A購01,1.40,1.40,1.40,1.40,+0.01,0.72,1000,1,1400,1000,0,1000,0,0,0,1000,0,1000,1000
20200430,060536,祥碩麥證9A購01,1.96,1.96,1.93,1.93,+0.11,6.04,17000,4,33090,17000,0,17000,0,0,0,17000,0,17000,17000
20200430,060537,台灣50凱基9B購01,2.09,2.20,2.09,2.20,+0.22,11.11,14000,3,30400,0,0,0,0,0,0,14000,0,14000,14000
20200430,060538,S&P反1凱基9A購01,0.73,0.73,0.73,0.73,-0.06,-7.59,15000,2,10950,0,0,0,0,0,0,0,15000,-15000,-15000
20200430,060539,道瓊反凱基9A購01,0.64,0.65,0.62,0.62,-0.07,-10.14,85000,6,54160,0,0,0,0,0,0,74000,11000,63000,63000
20200430,06053P,緯穎國票97售05,,,,,0.00,0.00,0,0,0,0,0,0,0,0,0,0,0,0,0
20200430,060540,南亞凱基9A購01,2.01,2.36,2.01,2.34,+0.37,18.78,375000,44,816600,0,0,0,0,0,0,186000,157000,29000,29000
20200430,060541,正隆凱基9A購01,1.85,1.85,1.85,1.85,+0.03,1.65,10000,1,18500,0,0,0,0,0,0,0,10000,-10000,-10000
20200430,060542,上銀凱基9A購04,2.43,2.84,2.43,2.84,+0.64,29.09,131000,13,339380,0,0,0,0,0,0,8000,123000,-115000,-115000
20200430,060543,鴻海凱基9B購02,1.72,1.79,1.70,1.79,+0.08,4.68,364000,8,623220,0,0,0,0,0,0,213000,151000,62000,62000
20200430,060544,國巨凱基9B購03,,,,,0.00,0.00,0,0,0,0,0,0,0,0,0,0,0,0,0
20200430,060545,台積電凱基9B購02,1.47,1.50,1.47,1.50,+0.04,2.74,40000,2,59100,0,0,0,0,0,0,40000,0,40000,40000
20200430,060546,旺宏凱基9A購02,,,,,0.00,0.00,0,0,0,0,0,0,0,0,0,0,0,0,0
20200430,060547,瑞昱凱基9A購01,1.89,2.03,1.85,2.00,+0.22,12.36,587000,73,1132170,0,0,0,0,0,0,330000,233000,97000,97000
20200430,060548,友達凱基9B購03,1.88,1.93,1.88,1.92,+0.03,1.59,48000,5,92190,0,0,0,0,0,0,2000,46000,-44000,-44000
20200430,060549,聯發科凱基9B購03,2.23,2.31,2.23,2.30,+0.29,14.43,38000,4,86940,0,0,0,0,0,0,4000,34000,-30000,-30000
20200430,06054P,臺股指中信9A售01,2.78,2.78,2.74,2.74,-0.12,-4.2,113000,3,312740,0,0,0,0,0,0,100000,13000,87000,87000
20200430,060550,可成凱基9A購02,,,,,0.00,0.00,0,0,0,0,0,0,0,0,0,0,0,0,0
20200430,060551,大立光凱基9B購02,0.88,0.95,0.88,0.95,+0.10,11.76,299000,8,277460,0,0,0,0,0,0,215000,82000,133000,133000
20200430,060552,群創凱基9B購05,1.62,1.62,1.62,1.62,+0.06,3.85,5000,1,8100,0,0,0,0,0,0,5000,0,5000,5000
20200430,060553,祥碩凱基9A購01,1.40,1.40,1.20,1.20,-0.15,-11.11,452000,23,584370,0,0,0,0,0,0,240000,212000,28000,28000
20200430,060554,中租凱基9A購01,2.26,2.39,2.26,2.33,+0.37,18.88,126000,17,293350,0,0,0,0,0,0,41000,83000,-42000,-42000
20200430,060555,台表科凱基9A購03,,,,,0.00,0.00,0,0,0,0,0,0,0,0,0,0,0,0,0
20200430,060556,緯穎凱基9A購04,1.63,1.83,1.62,1.80,+0.25,16.13,360000,21,620670,0,0,0,0,0,0,64000,286000,-222000,-222000
20200430,060557,南電凱基9A購02,2.47,2.51,2.37,2.37,0.00,0.00,68000,8,165440,0,0,0,0,0,0,68000,0,68000,68000
20200430,060558,億豐凱基9A購01,2.13,2.31,2.13,2.31,+0.03,1.32,110000,9,244950,0,0,0,0,0,0,50000,60000,-10000,-10000
20200430,060559,世紀鋼凱基9C購01,1.58,1.58,1.56,1.56,+0.10,6.85,150000,2,235000,0,0,0,0,0,0,0,150000,-150000,-150000
20200430,06055P,華通凱基97售04,2.33,2.33,2.33,2.33,-0.23,-8.98,2000,1,4660,0,0,0,0,0,0,2000,0,2000,2000
20200430,060560,欣興國泰9C購01,2.83,2.92,2.78,2.78,+0.03,1.09,211000,15,594940,0,0,0,0,0,0,188000,16000,172000,172000
20200430,060561,台積電富邦04購01,1.06,1.09,1.05,1.09,+0.09,9.0,836000,43,895150,5000,0,5000,0,0,0,302000,487000,-185000,-180000
20200430,060562,旺宏富邦9C購02,1.76,1.76,1.71,1.72,+0.14,8.86,691000,46,1189040,0,0,0,0,0,0,691000,686000,5000,5000
20200430,060563,智邦富邦9A購01,1.76,1.76,1.58,1.58,-0.09,-5.39,144000,15,238660,0,0,0,0,0,0,138000,6000,132000,132000
20200430,060564,南亞科富邦9C購01,1.43,1.43,1.42,1.42,+0.03,2.16,40000,6,57060,0,0,0,0,0,0,25000,15000,10000,10000
20200430,060565,大立光富邦01購01,0.45,0.49,0.45,0.49,+0.05,11.36,284000,18,131400,0,0,0,0,0,0,170000,114000,56000,56000
20200430,060566,聯詠富邦9C購01,1.01,1.06,0.99,1.05,+0.04,3.96,529000,32,536260,0,0,0,0,0,0,94000,435000,-341000,-341000
20200430,060567,華擎富邦9C購01,0.87,0.87,0.85,0.85,0.00,0.00,120000,2,104000,0,0,0,0,0,0,100000,20000,80000,80000
20200430,060568,SP黃豆永豐9A購01,,,,,0.00,0.00,0,0,0,0,0,0,0,0,0,0,0,0,0
20200430,060569,台積電永豐9A購01,1.76,1.76,1.76,1.76,+0.04,2.33,8000,1,14080,0,0,0,0,0,0,0,8000,-8000,-8000
20200430,06056P,台積電凱基98售02,,,,,0.00,0.00,0,0,0,0,0,0,0,0,0,0,0,0,0
20200430,060570,南亞科永豐9A購01,1.41,1.42,1.39,1.39,+0.06,4.51,21000,7,29610,0,0,0,0,0,0,9000,12000,-3000,-3000
20200430,060571,京元電永豐9A購01,1.80,1.80,1.76,1.79,+0.03,1.7,283000,6,505390,0,0,0,0,0,0,55000,228000,-173000,-173000
20200430,060572,景碩永豐9A購01,1.55,1.67,1.53,1.67,+0.10,6.37,183000,17,286670,0,0,0,0,0,0,31000,153000,-122000,-122000
20200430,060573,力成永豐9A購01,1.21,1.30,1.21,1.30,+0.11,9.24,293000,9,367840,0,0,0,0,0,0,0,293000,-293000,-293000
20200430,060574,高股息中信9C購01,,,,,0.00,0.00,0,0,0,0,0,0,0,0,0,0,0,0,0
20200430,060575,大立光中信9B購02,0.85,0.90,0.85,0.90,+0.09,11.11,206000,7,180720,0,0,0,0,0,0,196000,10000,186000,186000
20200430,060576,欣興中信9B購01,2.79,2.83,2.69,2.72,+0.11,4.21,175000,32,482350,0,0,0,0,0,0,88000,86000,2000,2000
20200430,060577,玉晶光中信9A購02,0.99,1.03,0.99,1.03,0.00,0.00,171000,2,172490,0,0,0,0,0,0,0,171000,-171000,-171000
20200430,060578,臺股指中信9C購03,1.17,1.24,1.17,1.24,+0.12,10.71,56000,6,67890,0,0,0,0,0,0,6000,50000,-44000,-44000
20200430,060579,上証2X群益9C購04,3.86,3.86,3.86,3.86,0.00,0.00,7000,1,27020,0,0,0,0,0,0,7000,0,7000,7000
20200430,06057P,大立光凱基98售01,,,,,0.00,0.00,0,0,0,0,0,0,0,0,0,0,0,0,0
20200430,060580,A50正2群益9C購03,,,,,0.00,0.00,0,0,0,0,0,0,0,0,0,0,0,0,0
20200430,060581,玉晶光群益9B購02,2.42,2.59,2.42,2.56,+0.16,6.67,174000,7,436400,0,0,0,0,0,0,100000,76000,24000,24000
20200430,060582,玉晶光群益9C購01,2.53,2.75,2.53,2.75,+0.24,9.56,97000,9,250840,0,0,0,0,0,0,67000,35000,32000,32000
20200430,060583,南亞科元富9A購05,2.72,2.72,2.69,2.69,-0.01,-0.37,258000,26,701100,0,0,0,0,0,0,256000,2000,254000,254000
20200430,060584,玉晶光元富9A購01,3.49,3.76,3.49,3.76,+0.33,9.62,43000,19,155440,0,0,0,0,0,0,17000,26000,-9000,-9000
20200430,060585,玉晶光元富9A購02,2.69,2.88,2.69,2.88,+0.26,9.92,37000,13,101480,0,0,0,0,0,0,30000,7000,23000,23000
20200430,060586,玉晶光元富9A購03,3.06,3.30,3.06,3.30,+0.32,10.74,47000,14,148560,0,0,0,0,0,0,22000,25000,-3000,-3000
20200430,060587,牧德元富9A購01,2.05,2.05,2.05,2.05,+0.12,6.22,10000,1,20500,0,0,0,0,0,0,0,10000,-10000,-10000
20200430,060588,台灣50台新9A購03,0.15,0.15,0.15,0.15,0.00,0.00,30000,3,4500,0,0,0,0,0,0,0,30000,-30000,-30000
20200430,060589,台灣50台新9B購06,,,,,0.00,0.00,0,0,0,0,0,0,0,0,0,0,0,0,0
20200430,06058P,玉晶光凱基97售04,2.09,2.13,1.98,1.98,-0.32,-13.91,166000,15,344850,0,0,0,0,0,0,131000,35000,96000,96000
20200430,060590,台積電台新9C購02,,,,,0.00,0.00,0,0,0,0,0,0,0,0,0,0,0,0,0
20200430,060591,富邦金台新9A購01,1.74,1.78,1.74,1.78,+0.14,8.54,60000,5,105270,0,0,0,0,0,0,24000,36000,-12000,-12000
20200430,060592,上銀麥證9A購01,4.14,4.65,4.14,4.65,+1.10,30.99,28000,15,120440,0,28000,-28000,0,0,0,0,28000,-28000,-28000
20200430,060593,華通麥證9A購01,3.00,3.30,3.00,3.30,+0.41,14.19,88000,14,275830,10000,78000,-68000,0,0,0,10000,78000,-68000,-68000
20200430,060594,國巨麥證9A購01,3.05,3.05,2.98,3.01,+0.09,3.08,14000,4,42110,5000,9000,-4000,0,0,0,5000,9000,-4000,-4000
20200430,060595,台灣50凱基04購04,2.72,2.72,2.72,2.72,+0.21,8.37,3000,1,8160,0,0,0,0,0,0,0,3000,-3000,-3000
20200430,060596,元黃金凱基9A購02,0.39,0.40,0.38,0.40,0.00,0.00,43000,9,16790,0,0,0,0,0,0,7000,32000,-25000,-25000
20200430,060597,華通凱基9A購04,1.84,1.84,1.84,1.84,+0.28,17.95,17000,1,31280,0,0,0,0,0,0,0,17000,-17000,-17000
20200430,060598,鴻海凱基9A購20,1.73,1.81,1.73,1.81,+0.07,4.02,265000,5,464930,0,0,0,0,0,0,144000,121000,23000,23000
20200430,060599,國巨凱基9C購01,2.51,2.54,2.45,2.48,+0.09,3.77,103000,8,258210,0,0,0,0,0,0,1000,102000,-101000,-101000
20200430,06059P,泰碩元大97售02,0.75,0.78,0.75,0.77,-0.02,-2.53,52000,7,40100,0,0,0,0,0,0,9000,0,9000,9000
20200430,060600,台積電凱基9C購01,,,,,0.00,0.00,0,0,0,0,0,0,0,0,0,0,0,0,0
20200430,060601,技嘉凱基9A購02,0.89,0.90,0.89,0.89,0.00,0.00,120000,3,107800,0,0,0,0,0,0,10000,110000,-100000,-100000
20200430,060602,京元電凱基9A購01,1.83,1.85,1.81,1.85,+0.04,2.21,16000,6,29150,0,0,0,0,0,0,8000,6000,2000,2000
20200430,060603,聯發科凱基9A購12,1.64,1.75,1.64,1.74,+0.19,12.26,164000,14,277880,0,0,0,0,0,0,154000,8000,146000,146000
20200430,060604,宏達電凱基9B購01,,,,,0.00,0.00,0,0,0,0,0,0,0,0,0,0,0,0,0
20200430,060605,大立光凱基9C購01,1.50,1.61,1.49,1.61,+0.13,8.78,90000,8,138550,0,0,0,0,0,0,49000,41000,8000,8000
20200430,060606,玉晶光凱基9A購05,1.25,1.39,1.25,1.39,+0.18,14.88,77000,8,103330,0,0,0,0,0,0,7000,70000,-63000,-63000
20200430,060607,玉晶光凱基9A購06,,,,,0.00,0.00,0,0,0,0,0,0,0,0,0,0,0,0,0
20200430,060608,玉晶光凱基9A購08,1.21,1.30,1.21,1.30,+0.16,14.04,80000,7,99300,0,0,0,0,0,0,50000,30000,20000,20000
20200430,060609,玉晶光凱基9B購01,1.83,1.89,1.83,1.89,+0.15,8.62,120000,7,223740,0,0,0,0,0,0,69000,51000,18000,18000
20200430,06060P,玉晶光元大97售03,,,,,0.00,0.00,0,0,0,0,0,0,0,0,0,0,0,0,0
20200430,060610,玉晶光凱基9B購02,3.44,3.82,3.44,3.79,+0.35,10.17,202000,29,730170,0,0,0,0,0,0,134000,98000,36000,36000
20200430,060611,同欣電凱基9A購02,1.00,1.13,1.00,1.13,+0.15,15.31,344000,26,367040,0,0,0,0,0,0,139000,188000,-49000,-49000
20200430,060612,世紀鋼凱基9A購01,1.31,1.36,1.31,1.36,+0.06,4.62,60000,3,79100,0,0,0,0,0,0,0,60000,-60000,-60000
20200430,060613,T50反1元大9A購05,,,,,0.00,0.00,0,0,0,0,0,0,0,0,0,0,0,0,0
20200430,060614,T50反1元大9A購06,,,,,0.00,0.00,0,0,0,0,0,0,0,0,0,0,0,0,0
20200430,060615,T50反1元大9A購07,,,,,0.00,0.00,0,0,0,0,0,0,0,0,0,0,0,0,0
20200430,060616,宏碁元大9A購02,2.05,2.09,1.97,2.01,+0.03,1.52,310000,20,627400,0,0,0,0,0,0,221000,88000,133000,133000
20200430,060617,華新科元大9A購08,3.13,3.13,3.08,3.08,-0.11,-3.45,35000,3,108450,0,0,0,0,0,0,25000,10000,15000,15000
20200430,060618,玉晶光元大9A購02,,,,,0.00,0.00,0,0,0,0,0,0,0,0,0,0,0,0,0
20200430,060619,玉晶光元大9A購03,2.30,2.37,2.30,2.33,+0.21,9.91,82000,11,194100,0,0,0,0,0,0,3000,81000,-78000,-78000
20200430,06061P,訊芯統一97售01,,,,,0.00,0.00,0,0,0,0,0,0,0,0,0,0,0,0,0
20200430,060620,玉晶光元大9A購04,2.11,2.26,2.10,2.23,+0.21,10.4,156000,18,339690,0,0,0,0,0,0,88000,71000,17000,17000
20200430,060621,玉晶光元大9A購05,3.05,3.40,3.03,3.40,+0.47,16.04,286000,43,906430,0,0,0,0,0,0,166000,146000,20000,20000
20200430,060622,玉晶光元大9B購02,1.63,1.76,1.62,1.76,+0.16,10.0,145000,13,241330,0,0,0,0,0,0,94000,51000,43000,43000
20200430,060623,玉晶光元大9C購01,1.62,1.75,1.62,1.75,+0.18,11.46,262000,22,434930,0,0,0,0,0,0,188000,74000,114000,114000
20200430,060624,玉晶光元大9C購02,3.12,3.35,3.10,3.35,+0.24,7.72,347000,43,1128720,0,0,0,0,0,0,161000,189000,-28000,-28000
20200430,060625,華擎元大9A購01,1.25,1.25,1.16,1.16,-0.01,-0.85,138000,7,167660,0,0,0,0,0,0,68000,70000,-2000,-2000
20200430,060626,貿聯元大9A購04,1.59,1.82,1.59,1.81,+0.28,18.3,541000,34,942820,0,0,0,0,0,0,27000,514000,-487000,-487000
20200430,060627,國巨國泰9B購05,3.67,3.67,3.61,3.61,+0.22,6.49,12000,6,43480,0,0,0,0,0,0,1000,8000,-7000,-7000
20200430,060628,和大富邦9B購01,1.09,1.40,1.09,1.40,+0.39,38.61,1954000,96,2350690,0,0,0,0,0,0,576000,1458000,-882000,-882000
20200430,060629,鴻海富邦9B購01,1.36,1.39,1.33,1.39,+0.08,6.11,488000,35,660480,0,0,0,0,0,0,364000,149000,215000,215000
20200430,06062P,宏達電元富97售01,,,,,0.00,0.00,0,0,0,0,0,0,0,0,0,0,0,0,0
20200430,060630,國巨富邦9C購03,1.17,1.18,1.14,1.18,+0.09,8.26,239000,33,276220,0,0,0,0,0,0,100000,26000,74000,74000
20200430,060631,微星富邦9B購01,0.59,0.60,0.59,0.59,+0.02,3.51,73000,4,43270,0,0,0,0,0,0,0,73000,-73000,-73000
20200430,060632,可成富邦9B購01,0.87,0.87,0.82,0.85,0.00,0.00,452000,13,389110,0,0,0,0,0,0,73000,379000,-306000,-306000
20200430,060633,玉晶光富邦02購01,1.33,1.45,1.33,1.45,+0.16,12.4,568000,40,795940,0,0,0,0,0,0,161000,407000,-246000,-246000
20200430,060634,矽創富邦9B購01,0.88,0.90,0.81,0.90,+0.10,12.5,1729000,98,1503950,0,0,0,0,0,0,989000,850000,139000,139000
20200430,060635,義隆永豐9A購01,1.50,1.63,1.50,1.63,+0.18,12.41,166000,7,261830,0,0,0,0,0,0,6000,163000,-157000,-157000
20200430,060636,大毅永豐9A購02,1.67,1.91,1.65,1.65,+0.11,7.14,291000,21,513420,0,0,0,0,0,0,5000,290000,-285000,-285000
20200430,060637,玉晶光永豐9A購03,1.43,1.58,1.43,1.58,+0.22,16.18,70000,10,102840,0,0,0,0,0,0,33000,38000,-5000,-5000
20200430,060638,玉晶光永豐9A購04,1.80,1.97,1.77,1.95,+0.22,12.72,138000,17,256230,0,0,0,0,0,0,40000,102000,-62000,-62000
20200430,060639,玉晶光永豐9A購05,1.83,2.07,1.83,2.05,+0.26,14.53,281000,27,540540,0,0,0,0,0,0,187000,98000,89000,89000
20200430,06063P,玉晶光元富97售01,,,,,0.00,0.00,0,0,0,0,0,0,0,0,0,0,0,0,0
20200430,060640,京鼎永豐9A購01,1.49,1.62,1.49,1.62,+0.20,14.08,227000,12,354190,0,0,0,0,0,0,4000,227000,-223000,-223000
20200430,060641,聯鈞永豐9A購01,1.31,1.31,1.31,1.31,-0.12,-8.39,1000,1,1310,0,0,0,0,0,0,1000,1000,0,0
20200430,060642,華擎永豐9A購02,0.57,0.57,0.57,0.57,+0.01,1.79,5000,1,2850,0,0,0,0,0,0,0,5000,-5000,-5000
20200430,060643,牧德永豐9A購03,1.47,1.52,1.47,1.50,+0.11,7.91,255000,16,378760,0,0,0,0,0,0,1000,255000,-254000,-254000
20200430,060644,泰鼎永豐9A購02,1.20,1.24,1.18,1.24,-0.04,-3.12,137000,11,165480,0,0,0,0,0,0,74000,112000,-38000,-38000
20200430,060645,台表科永豐9A購02,1.32,1.32,1.28,1.29,-0.03,-2.27,33000,3,42790,0,0,0,0,0,0,23000,10000,13000,13000
20200430,060646,南電永豐9A購01,2.07,2.07,1.93,1.95,-0.03,-1.52,177000,15,361320,0,0,0,0,0,0,166000,11000,155000,155000
20200430,060647,T50反1第一9A購01,,,,,0.00,0.00,0,0,0,0,0,0,0,0,0,0,0,0,0
20200430,060648,鴻海第一9A購01,,,,,0.00,0.00,0,0,0,0,0,0,0,0,0,0,0,0,0
20200430,060649,國巨第一9A購01,1.29,1.33,1.28,1.30,+0.07,5.69,233000,5,305770,0,0,0,0,0,0,23000,210000,-187000,-187000
20200430,06064P,台積電台新98售01,1.51,1.51,1.51,1.51,-0.27,-15.17,10000,1,15100,0,0,0,0,0,0,10000,10000,0,0
20200430,060650,奇力新中信9A購01,1.10,1.20,1.10,1.12,+0.05,4.67,694000,30,797830,0,0,0,0,0,0,162000,512000,-350000,-350000
20200430,060651,瑞儀中信9B購01,1.01,1.03,1.01,1.03,+0.02,1.98,211000,8,214960,0,0,0,0,0,0,15000,196000,-181000,-181000
20200430,060652,滬深2X群益9C購04,,,,,0.00,0.00,0,0,0,0,0,0,0,0,0,0,0,0,0
20200430,060653,全新群益9A購02,2.06,2.06,2.06,2.06,+0.03,1.48,105000,2,216300,0,0,0,0,0,0,7000,98000,-91000,-91000
20200430,060654,大毅群益9B購01,1.30,1.48,1.29,1.29,+0.09,7.5,542000,43,737990,0,0,0,0,0,0,239000,312000,-73000,-73000
20200430,060655,國巨統一9B購06,1.51,1.51,1.50,1.50,+0.02,1.35,137000,3,205800,0,0,0,0,0,0,135000,2000,133000,133000
20200430,060656,國巨統一9C購03,,,,,0.00,0.00,0,0,0,0,0,0,0,0,0,0,0,0,0
20200430,060657,旺宏統一9B購05,1.38,1.38,1.33,1.33,+0.08,6.4,812000,21,1092330,0,0,0,0,0,0,786000,26000,760000,760000
20200430,060658,台灣50凱基01購04,1.84,1.93,1.83,1.93,+0.17,9.66,136000,14,252100,0,0,0,0,0,0,113000,23000,90000,90000
20200430,060659,鴻海凱基9B購03,3.42,3.42,3.42,3.42,+0.19,5.88,2000,1,6840,0,0,0,0,0,0,0,2000,-2000,-2000
20200430,06065P,大立光台新97售01,1.78,1.78,1.78,1.78,0.00,0.00,1000,1,1780,0,0,0,0,0,0,0,1000,-1000,-1000
20200430,060660,國巨凱基9B購04,,,,,0.00,0.00,0,0,0,0,0,0,0,0,0,0,0,0,0
20200430,060661,台積電凱基9A購18,1.64,1.69,1.64,1.69,+0.11,6.96,125000,5,210000,0,0,0,0,0,0,75000,50000,25000,25000
20200430,060662,旺宏凱基9A購03,1.75,1.75,1.72,1.72,+0.15,9.55,85000,4,147680,0,0,0,0,0,0,82000,3000,79000,79000
20200430,060663,聯發科凱基9A購13,4.64,4.84,4.62,4.84,+0.65,15.51,67000,12,318390,0,0,0,0,0,0,7000,60000,-53000,-53000
20200430,060664,聯詠凱基9A購01,1.10,1.10,1.10,1.10,0.00,0.00,50000,1,55000,0,0,0,0,0,0,0,50000,-50000,-50000
20200430,060665,康控凱基9A購01,1.68,1.84,1.68,1.82,+0.30,19.74,60000,9,106010,0,0,0,0,0,0,60000,21000,39000,39000
20200430,060666,聯茂凱基9A購02,1.14,1.14,1.10,1.10,-0.07,-5.98,62000,4,69060,0,0,0,0,0,0,52000,32000,20000,20000
20200430,060667,力成凱基9A購01,1.43,1.55,1.43,1.55,+0.13,9.15,925000,43,1370230,0,0,0,0,0,0,688000,194000,494000,494000
20200430,060668,上証2X元大9A購02,,,,,0.00,0.00,0,0,0,0,0,0,0,0,0,0,0,0,0
20200430,060669,上証2X元大9A購03,1.52,1.52,1.52,1.52,0.00,0.00,3000,1,4560,0,0,0,0,0,0,0,3000,-3000,-3000
20200430,06066P,群創台新98售01,,,,,0.00,0.00,0,0,0,0,0,0,0,0,0,0,0,0,0
20200430,060670,臺指反元大01購03,0.73,0.75,0.72,0.72,-0.05,-6.49,187000,6,138950,0,0,0,0,0,0,20000,167000,-147000,-147000
20200430,060671,亞德客元大9A購03,2.19,2.53,2.06,2.45,+0.38,18.36,323000,38,732670,1000,0,1000,0,0,0,111000,236000,-125000,-124000
20200430,060672,鴻海元大9A購14,5.30,5.30,5.30,5.30,+0.05,0.95,6000,1,31800,0,0,0,0,0,0,6000,0,6000,6000
20200430,060673,旺宏元大9A購04,2.38,2.38,2.27,2.28,+0.18,8.57,65000,17,150870,0,0,0,0,0,0,55000,19000,36000,36000
20200430,060674,瑞昱元大9A購03,2.44,2.62,2.40,2.61,+0.29,12.5,622000,89,1534240,0,0,0,0,0,0,343000,328000,15000,15000
20200430,060675,南亞科元大9A購02,2.47,2.47,2.37,2.37,-0.01,-0.42,65000,8,158270,0,0,0,0,0,0,65000,0,65000,65000
20200430,060676,京元電元大9A購03,2.04,2.04,2.01,2.04,0.00,0.00,78000,3,158580,0,0,0,0,0,0,10000,68000,-58000,-58000
20200430,060677,京元電元大9A購04,2.75,2.75,2.66,2.71,+0.08,3.04,153000,11,411140,0,0,0,0,0,0,72000,81000,-9000,-9000
20200430,060678,聯詠元大9A購03,1.80,1.90,1.78,1.90,+0.04,2.15,404000,22,732280,0,0,0,0,0,0,323000,81000,242000,242000
20200430,060679,聯詠元大9A購04,1.47,1.55,1.44,1.55,+0.06,4.03,352000,25,520200,0,0,0,0,0,0,219000,137000,82000,82000
20200430,06067P,華新科康和97售01,0.66,0.66,0.66,0.66,-0.02,-2.94,20000,1,13200,0,0,0,0,0,0,20000,0,20000,20000
20200430,060680,玉晶光元大9C購03,3.96,4.32,3.94,4.32,+0.50,13.09,205000,46,832080,0,0,0,0,0,0,160000,73000,87000,87000
20200430,060681,華擎元大9A購02,,,,,0.00,0.00,0,0,0,0,0,0,0,0,0,0,0,0,0
20200430,060682,牧德元大9A購03,1.77,1.85,1.74,1.78,+0.09,5.33,300000,22,538490,0,0,0,0,0,0,25000,279000,-254000,-254000
20200430,060683,泰鼎元大9A購02,2.63,2.63,2.50,2.59,+0.03,1.17,270000,13,694380,0,0,0,0,0,0,68000,215000,-147000,-147000
20200430,060684,同欣電元大9A購01,1.48,1.68,1.48,1.66,+0.21,14.48,302000,24,484090,0,0,0,0,0,0,27000,275000,-248000,-248000
20200430,060685,康友元大9A購01,2.70,2.90,2.70,2.87,+0.23,8.71,111000,15,311800,0,0,0,0,0,0,13000,100000,-87000,-87000
20200430,060686,康友元大9A購02,1.91,2.01,1.90,2.01,+0.16,8.65,219000,17,427240,0,0,0,0,0,0,22000,203000,-181000,-181000
20200430,060687,GIS元大9A購01,2.50,2.52,2.43,2.46,+0.02,0.82,777000,45,1918970,0,0,0,0,0,0,777000,58000,719000,719000
20200430,060688,世紀鋼元大9C購01,1.89,1.99,1.89,1.99,+0.09,4.74,11000,3,21320,0,0,0,0,0,0,0,11000,-11000,-11000
20200430,060689,臺股指元大9A購43,,,,,0.00,0.00,0,0,0,0,0,0,0,0,0,0,0,0,0
20200430,06068P,玉晶光康和97售01,0.96,0.96,0.87,0.87,-0.17,-16.35,145000,15,134520,0,0,0,0,0,0,59000,86000,-27000,-27000
20200430,060690,臺股指元大9A購46,,,,,0.00,0.00,0,0,0,0,0,0,0,0,0,0,0,0,0
20200430,060691,臺股指元大9A購47,,,,,0.00,0.00,0,0,0,0,0,0,0,0,0,0,0,0,0
20200430,060692,鴻海麥證9A購01,1.93,1.93,1.93,1.93,+0.01,0.52,18000,2,34740,0,18000,-18000,0,0,0,0,18000,-18000,-18000
20200430,060693,台積電麥證9A購02,1.59,1.59,1.57,1.57,+0.08,5.37,260000,2,413200,250000,10000,240000,0,0,0,250000,10000,240000,240000
20200430,060694,旺宏麥證9A購02,2.46,2.47,2.45,2.46,+0.26,11.82,33000,4,81080,2000,31000,-29000,0,0,0,2000,31000,-29000,-29000
20200430,060695,同欣電麥證9A購01,0.73,0.87,0.73,0.87,+0.16,22.54,154000,8,121590,133000,21000,112000,0,0,0,133000,21000,112000,112000
20200430,060696,道瓊反國泰9C購01,1.01,1.02,0.99,0.99,-0.06,-5.71,309000,8,310300,0,0,0,0,0,0,144000,165000,-21000,-21000
20200430,060697,鴻海國泰9C購01,1.93,1.97,1.91,1.97,+0.10,5.35,155000,15,298640,0,0,0,0,0,0,116000,52000,64000,64000
20200430,060698,旺宏國泰9C購01,2.41,2.63,2.41,2.53,+0.16,6.75,722000,58,1853060,0,0,0,0,0,0,606000,298000,308000,308000
20200430,060699,華新科國泰9B購03,2.88,2.90,2.77,2.77,0.00,0.00,46000,5,130260,0,0,0,0,0,0,15000,31000,-16000,-16000
20200430,06069P,台積電永豐97售01,,,,,0.00,0.00,0,0,0,0,0,0,0,0,0,0,0,0,0
20200430,060700,華新科國泰9C購01,2.71,2.73,2.59,2.65,+0.06,2.32,219000,17,581860,0,0,0,0,0,0,57000,160000,-103000,-103000
20200430,060701,玉晶光國泰9C購01,1.88,2.08,1.87,2.08,+0.26,14.29,782000,113,1550090,0,0,0,0,0,0,331000,437000,-106000,-106000
20200430,060702,玉晶光國泰9C購02,1.69,1.85,1.68,1.85,+0.17,10.12,458000,79,802430,0,0,0,0,0,0,272000,179000,93000,93000
20200430,060703,T50反1富邦9C購01,,,,,0.00,0.00,0,0,0,0,0,0,0,0,0,0,0,0,0
20200430,060704,台積電富邦01購01,0.90,0.91,0.87,0.91,+0.06,7.06,563000,13,495690,0,0,0,0,0,0,413000,141000,272000,272000
20200430,060705,台光電富邦9B購01,0.78,0.87,0.78,0.87,+0.10,12.99,1713000,51,1410250,0,0,0,0,0,0,167000,1565000,-1398000,-1398000
20200430,060706,群創富邦9A購01,0.78,0.79,0.78,0.79,+0.03,3.95,188000,3,147600,0,0,0,0,0,0,0,188000,-188000,-188000
20200430,060707,台郡富邦9A購01,0.71,0.73,0.68,0.73,+0.03,4.29,424000,47,299790,0,0,0,0,0,0,118000,98000,20000,20000
20200430,060708,康友富邦9B購01,0.82,0.87,0.82,0.86,+0.07,8.86,357000,18,303740,0,0,0,0,0,0,40000,316000,-276000,-276000
20200430,060709,緯穎富邦9B購01,0.53,0.63,0.53,0.62,+0.11,21.57,246000,25,151230,0,0,0,0,0,0,40000,206000,-166000,-166000
20200430,06070P,漢唐永豐97售01,,,,,0.00,0.00,0,0,0,0,0,0,0,0,0,0,0,0,0
20200430,060710,上銀永豐9A購01,1.55,1.82,1.53,1.82,+0.37,25.52,500000,35,792840,0,0,0,0,0,0,216000,284000,-68000,-68000
20200430,060711,旺宏永豐9A購01,1.37,1.37,1.35,1.35,+0.14,11.57,9000,8,12270,0,0,0,0,0,0,9000,9000,0,0
20200430,060712,建準永豐9A購01,1.16,1.16,1.13,1.14,-0.09,-7.32,236000,9,270160,0,0,0,0,0,0,236000,10000,226000,226000
20200430,060713,聯詠永豐9A購01,0.79,0.81,0.78,0.81,+0.03,3.85,369000,12,291270,0,0,0,0,0,0,222000,140000,82000,82000
20200430,060714,晶技永豐9A購02,2.08,2.16,2.05,2.07,+0.01,0.49,115000,11,241000,0,0,0,0,0,0,6000,109000,-103000,-103000
20200430,060715,日電貿永豐9A購01,1.07,1.09,1.07,1.09,+0.06,5.83,134000,3,145220,0,0,0,0,0,0,0,134000,-134000,-134000
20200430,060716,新唐永豐9A購01,1.21,1.22,1.21,1.22,+0.03,2.52,102000,2,123640,0,0,0,0,0,0,80000,22000,58000,58000
20200430,060717,康控永豐9A購01,0.94,1.12,0.94,1.12,+0.19,20.43,366000,24,364850,0,0,0,0,0,0,269000,130000,139000,139000
20200430,060718,中磊永豐9A購01,1.64,1.65,1.59,1.59,+0.02,1.27,106000,11,170310,0,0,0,0,0,0,74000,32000,42000,42000
20200430,060719,瀚宇博永豐9A購01,0.95,1.00,0.95,1.00,+0.04,4.17,117000,8,114460,0,0,0,0,0,0,12000,77000,-65000,-65000
20200430,06071P,大立光永豐97售01,,,,,0.00,0.00,0,0,0,0,0,0,0,0,0,0,0,0,0
20200430,060720,嘉聯益永豐9A購02,0.99,1.01,0.99,1.01,+0.04,4.12,63000,2,63370,0,0,0,0,0,0,63000,0,63000,63000
20200430,060721,瑞儀永豐9A購01,1.14,1.18,1.13,1.18,+0.01,0.85,92000,8,105950,0,0,0,0,0,0,56000,36000,20000,20000
20200430,060722,矽格永豐9A購01,1.16,1.22,1.16,1.22,+0.05,4.27,238000,8,282970,0,0,0,0,0,0,164000,74000,90000,90000
20200430,060723,致新永豐9A購01,1.04,1.10,1.02,1.08,+0.05,4.85,553000,24,591580,0,0,0,0,0,0,180000,373000,-193000,-193000
20200430,060724,台灣50第一9A購02,,,,,0.00,0.00,0,0,0,0,0,0,0,0,0,0,0,0,0
20200430,060725,台積電第一9A購01,,,,,0.00,0.00,0,0,0,0,0,0,0,0,0,0,0,0,0
20200430,060726,聯發科第一9A購01,1.34,1.35,1.33,1.35,+0.17,14.41,156000,5,209450,0,0,0,0,0,0,5000,151000,-146000,-146000
20200430,060727,高股息中信9C購02,1.00,1.00,1.00,1.00,+0.03,3.09,10000,1,10000,0,0,0,0,0,0,10000,0,10000,10000
20200430,060728,上証2X群益9C購05,,,,,0.00,0.00,0,0,0,0,0,0,0,0,0,0,0,0,0
20200430,060729,國巨群益9A購05,2.73,2.73,2.73,2.73,0.00,0.00,1000,1,2730,0,0,0,0,0,0,0,1000,-1000,-1000
20200430,06072P,牧德永豐97售01,0.55,0.56,0.55,0.55,-0.10,-15.38,40000,4,22100,0,0,0,0,0,0,20000,20000,0,0
20200430,060730,台積電群益9A購03,3.38,3.41,3.38,3.41,+0.10,3.02,48000,4,163290,0,0,0,0,0,0,30000,19000,11000,11000
20200430,060731,奇力新群益9A購01,1.19,1.28,1.18,1.20,+0.06,5.26,246000,7,301320,0,0,0,0,0,0,126000,120000,6000,6000
20200430,060732,玉晶光群益9C購02,1.81,1.93,1.81,1.93,+0.12,6.63,241000,5,457370,0,0,0,0,0,0,189000,54000,135000,135000
20200430,060733,和大統一9C購01,1.07,1.35,1.07,1.35,+0.36,36.36,1398000,47,1619400,0,0,0,0,0,0,421000,924000,-503000,-503000
20200430,060734,華通統一9C購01,1.06,1.16,1.05,1.16,+0.14,13.73,364000,22,398790,0,0,0,0,0,0,277000,156000,121000,121000
20200430,060735,鴻海統一9C購03,1.04,1.04,1.03,1.03,+0.02,1.98,190000,4,196200,0,0,0,0,0,0,180000,10000,170000,170000
20200430,060736,旺宏統一01購01,1.45,1.45,1.40,1.40,+0.07,5.26,479000,26,682450,0,0,0,0,0,0,243000,234000,9000,9000
20200430,060737,瑞儀統一9C購01,1.21,1.24,1.21,1.24,+0.03,2.48,251000,8,307000,0,0,0,0,0,0,20000,231000,-211000,-211000
20200430,060738,矽格統一9C購01,,,,,0.00,0.00,0,0,0,0,0,0,0,0,0,0,0,0,0
20200430,060739,台灣50台新9A購04,,,,,0.00,0.00,0,0,0,0,0,0,0,0,0,0,0,0,0
20200430,06073P,健策永豐97售01,1.35,1.41,1.35,1.41,-0.08,-5.37,100000,3,138120,0,0,0,0,0,0,48000,52000,-4000,-4000
20200430,060740,T50反1台新9C購02,,,,,0.00,0.00,0,0,0,0,0,0,0,0,0,0,0,0,0
20200430,060741,滬深2X國票9A購05,,,,,0.00,0.00,0,0,0,0,0,0,0,0,0,0,0,0,0
20200430,060742,臺指反國票9B購02,0.46,0.46,0.42,0.43,-0.05,-10.42,274000,16,119350,0,0,0,0,0,0,76000,198000,-122000,-122000
20200430,060743,鴻海國票9A購03,1.56,1.56,1.56,1.56,0.00,0.00,50000,1,78000,0,0,0,0,0,0,0,50000,-50000,-50000
20200430,060744,鴻海國票9A購04,2.51,2.63,2.47,2.62,+0.14,5.65,275000,10,694300,0,0,0,0,0,0,95000,180000,-85000,-85000
20200430,060745,京元電國票9A購01,,,,,0.00,0.00,0,0,0,0,0,0,0,0,0,0,0,0,0
20200430,060746,玉晶光國票9B購02,2.17,2.42,2.17,2.42,+0.29,13.62,596000,18,1395220,0,0,0,0,0,0,588000,18000,570000,570000
20200430,060747,聯鈞國票9A購02,4.13,4.13,3.91,3.95,-0.04,-1.0,30000,4,119540,0,0,0,0,0,0,19000,11000,8000,8000
20200430,060748,臻鼎國票9A購01,1.49,1.73,1.49,1.73,+0.26,17.69,261000,16,418170,0,0,0,0,0,0,230000,31000,199000,199000
20200430,060749,祥碩國票9A購01,2.41,2.41,2.11,2.11,-0.22,-9.44,86000,5,206460,0,0,0,0,0,0,83000,3000,80000,80000
20200430,06074P,台積電凱基98售04,16.80,16.80,16.80,16.80,0.00,0.00,5000,1,84000,0,0,0,0,0,0,0,5000,-5000,-5000
20200430,060750,高股息元大9A購01,1.95,1.95,1.95,1.95,0.00,0.00,1000,1,1950,0,0,0,0,0,0,0,1000,-1000,-1000
20200430,060751,高股息元大9B購01,1.52,1.56,1.52,1.56,+0.07,4.7,14000,5,21560,0,0,0,0,0,0,12000,2000,10000,10000
20200430,060752,上銀元大9A購04,2.40,2.77,2.37,2.77,+0.47,20.43,620000,53,1536570,0,0,0,0,0,0,341000,277000,64000,64000
20200430,060753,上銀元大9A購05,3.18,3.68,3.12,3.63,+0.62,20.6,526000,49,1705190,0,0,0,0,0,0,307000,219000,88000,88000
20200430,060754,華通元大9A購04,2.25,2.45,2.25,2.45,+0.24,10.86,175000,14,407600,0,0,0,0,0,0,85000,90000,-5000,-5000
20200430,060755,鴻海元大9A購15,1.66,1.71,1.66,1.71,+0.08,4.91,190000,6,318320,0,0,0,0,0,0,101000,89000,12000,12000
20200430,060756,鴻海元大9A購16,1.63,1.63,1.63,1.63,+0.05,3.16,50000,1,81500,0,0,0,0,0,0,0,50000,-50000,-50000
20200430,060757,台積電元大9A購18,2.98,3.00,2.96,3.00,+0.15,5.26,90000,4,267300,0,0,0,0,0,0,90000,0,90000,90000
20200430,060758,台積電元大9A購19,1.49,1.53,1.48,1.53,+0.12,8.51,225000,20,339620,0,0,0,0,0,0,175000,50000,125000,125000
20200430,060759,南亞科元大9A購03,2.16,2.16,2.07,2.10,+0.02,0.96,67000,5,143790,0,0,0,0,0,0,3000,64000,-61000,-61000
20200430,06075P,智邦凱基97售02,,,,,0.00,0.00,0,0,0,0,0,0,0,0,0,0,0,0,0
20200430,060760,南亞科元大9A購04,3.07,3.07,2.96,2.96,+0.05,1.72,187000,16,560100,0,0,0,0,0,0,80000,107000,-27000,-27000
20200430,060761,南亞科元大9A購05,1.63,1.63,1.57,1.59,+0.04,2.58,536000,25,846760,0,0,0,0,0,0,325000,211000,114000,114000
20200430,060762,長榮航元大9A購02,2.80,3.00,2.77,2.84,+0.19,7.17,250000,16,716000,0,0,0,0,0,0,155000,85000,70000,70000
20200430,060763,聯鈞元大9A購03,1.85,1.85,1.75,1.77,-0.05,-2.75,94000,7,167640,0,0,0,0,0,0,52000,42000,10000,10000
20200430,060764,華擎元大9A購03,1.09,1.11,1.06,1.06,+0.03,2.91,47000,6,50200,0,0,0,0,0,0,47000,0,47000,47000
20200430,060765,世芯元大9A購01,3.11,3.39,3.11,3.35,+0.41,13.95,115000,11,377790,0,0,0,0,0,0,87000,28000,59000,59000
20200430,060766,世芯元大9A購02,2.74,3.07,2.74,3.05,+0.43,16.41,193000,23,564330,0,0,0,0,0,0,97000,107000,-10000,-10000
20200430,060767,世紀鋼元大9A購02,0.94,0.99,0.94,0.98,+0.05,5.38,227000,3,214610,0,0,0,0,0,0,227000,0,227000,227000
20200430,060768,鴻海麥證9A購02,1.41,1.41,1.41,1.41,0.00,0.00,11000,1,15510,0,11000,-11000,0,0,0,0,11000,-11000,-11000
20200430,060769,國巨麥證9A購02,3.06,3.06,3.01,3.01,0.00,0.00,20000,3,60360,16000,4000,12000,0,0,0,16000,4000,12000,12000
20200430,06076P,大立光凱基98售03,2.37,2.37,2.05,2.05,-0.57,-21.76,40000,4,91600,0,0,0,0,0,0,30000,40000,-10000,-10000
20200430,060770,宏達電麥證9A購01,1.72,1.72,1.72,1.72,-0.06,-3.37,50000,1,86000,50000,0,50000,0,0,0,50000,0,50000,50000
20200430,060771,滬深2X凱基9B購02,,,,,0.00,0.00,0,0,0,0,0,0,0,0,0,0,0,0,0
20200430,060772,FBVIX凱基9A購03,1.65,1.65,1.60,1.60,-0.13,-7.51,12000,4,19410,0,0,0,0,0,0,0,12000,-12000,-12000
20200430,060773,FBVIX凱基9A購04,1.53,1.53,1.53,1.53,0.00,0.00,30000,1,45900,0,0,0,0,0,0,0,30000,-30000,-30000
20200430,060774,南亞科凱基9A購01,1.31,1.32,1.28,1.30,+0.03,2.36,104000,17,135860,0,0,0,0,0,0,86000,18000,68000,68000
20200430,060775,世芯凱基9A購02,2.63,2.89,2.63,2.86,+0.42,17.21,524000,13,1498840,0,0,0,0,0,0,506000,128000,378000,378000
20200430,060776,世芯凱基9B購01,2.05,2.35,2.05,2.30,+0.33,16.75,423000,37,959520,0,0,0,0,0,0,275000,340000,-65000,-65000
20200430,060777,茂林凱基9C購01,1.68,1.69,1.67,1.67,+0.01,0.6,9000,3,15110,0,0,0,0,0,0,0,9000,-9000,-9000
20200430,060778,臺股指凱基9A購06,2.81,2.96,2.81,2.95,+0.45,18.0,6000,5,17410,0,0,0,0,0,0,3000,3000,0,0
20200430,060779,臺股指凱基9A購07,3.30,3.42,3.28,3.42,+0.31,9.97,43000,8,144070,0,0,0,0,0,0,22000,21000,1000,1000
20200430,06077P,GIS凱基97售02,2.06,2.06,2.06,2.06,0.00,0.00,20000,1,41200,0,0,0,0,0,0,0,20000,-20000,-20000
20200430,060780,祥碩國泰9B購01,2.49,2.50,2.04,2.16,-0.17,-7.3,643000,82,1479140,0,0,0,0,0,0,516000,126000,390000,390000
20200430,060781,台郡國泰9B購01,2.02,2.11,2.02,2.11,+0.10,4.98,60000,8,123040,0,0,0,0,0,0,23000,27000,-4000,-4000
20200430,060782,道瓊指富邦9C購01,0.80,0.80,0.78,0.80,+0.04,5.26,53000,4,41650,0,0,0,0,0,0,35000,18000,17000,17000
20200430,060783,亞德客富邦9B購01,1.24,1.47,1.17,1.46,+0.28,23.73,1408000,104,1788670,0,0,0,0,0,0,738000,704000,34000,34000
20200430,060784,鴻海富邦9C購01,0.94,0.98,0.93,0.98,+0.08,8.89,2670000,54,2540680,0,0,0,0,0,0,646000,2005000,-1359000,-1359000
20200430,060785,國巨富邦9B購04,0.89,0.91,0.88,0.89,+0.05,5.95,269000,13,239800,0,0,0,0,0,0,139000,130000,9000,9000
20200430,060786,聯發科富邦9B購06,1.32,1.39,1.31,1.39,+0.16,13.01,158000,10,215510,0,0,0,0,0,0,42000,116000,-74000,-74000
20200430,060787,奇力新富邦9A購01,0.88,0.88,0.88,0.88,+0.06,7.32,105000,2,92400,0,0,0,0,0,0,0,105000,-105000,-105000
20200430,060788,嘉晶富邦9B購01,0.72,0.80,0.72,0.76,+0.05,7.04,1131000,28,854290,0,0,0,0,0,0,55000,1046000,-991000,-991000
20200430,060789,禾伸堂富邦9B購02,1.24,1.25,1.16,1.18,-0.01,-0.84,446000,47,539260,0,0,0,0,0,0,261000,142000,119000,119000
20200430,06078P,臺股指凱基9A售01,,,,,0.00,0.00,0,0,0,0,0,0,0,0,0,0,0,0,0
20200430,060790,日月光富邦9A購01,0.73,0.78,0.72,0.78,+0.08,11.43,374000,19,275160,0,0,0,0,0,0,0,347000,-347000,-347000
20200430,060791,聯茂富邦9A購02,0.67,0.67,0.63,0.63,-0.04,-5.97,388000,20,254100,0,0,0,0,0,0,368000,20000,348000,348000
20200430,060792,信錦永豐9A購01,1.18,1.19,1.18,1.19,+0.01,0.85,254000,13,299880,0,0,0,0,0,0,254000,0,254000,254000
20200430,060793,微星永豐9A購01,2.09,2.09,2.08,2.08,-0.01,-0.48,45000,2,93850,0,0,0,0,0,0,25000,20000,5000,5000
20200430,060794,景碩永豐9A購02,2.20,2.40,2.20,2.31,+0.14,6.45,224000,25,507830,0,0,0,0,0,0,127000,97000,30000,30000
20200430,060795,世芯永豐9A購02,2.06,2.36,2.06,2.36,+0.36,18.0,366000,31,798460,0,0,0,0,0,0,68000,298000,-230000,-230000
20200430,060796,世芯永豐9A購03,2.05,2.34,2.05,2.25,+0.30,15.38,329000,32,719050,0,0,0,0,0,0,83000,243000,-160000,-160000
20200430,060797,世芯永豐9A購04,2.58,2.73,2.58,2.73,+0.18,7.06,7000,2,18210,0,0,0,0,0,0,7000,0,7000,7000
20200430,060798,旭富永豐9A購01,0.65,0.65,0.65,0.65,0.00,0.00,10000,1,6500,0,0,0,0,0,0,0,10000,-10000,-10000
20200430,060799,茂林永豐9A購01,1.12,1.12,1.05,1.06,-0.02,-1.85,386000,14,413520,0,0,0,0,0,0,265000,121000,144000,144000
20200430,06079P,燿華群益98售02,,,,,0.00,0.00,0,0,0,0,0,0,0,0,0,0,0,0,0
20200430,060800,華新科第一9A購01,1.28,1.28,1.21,1.25,+0.05,4.17,44000,7,54350,0,0,0,0,0,0,23000,21000,2000,2000
20200430,060801,滬深2X中信01購01,1.45,1.56,1.45,1.49,0.00,0.00,289000,5,434330,0,0,0,0,0,0,0,289000,-289000,-289000
20200430,060802,道瓊指中信9C購03,,,,,0.00,0.00,0,0,0,0,0,0,0,0,0,0,0,0,0
20200430,060803,台灣50群益9A購13,3.45,3.61,3.45,3.61,+0.34,10.4,145000,5,501380,0,0,0,0,0,0,48000,97000,-49000,-49000
20200430,060804,T50反1群益9A購02,0.48,0.48,0.44,0.45,-0.05,-10.0,2072000,15,949830,0,0,0,0,0,0,1642000,420000,1222000,1222000
20200430,060805,國巨群益9A購06,3.05,3.05,2.99,2.99,+0.13,4.55,9000,3,27180,0,0,0,0,0,0,0,9000,-9000,-9000
20200430,060806,華新科群益9A購03,3.18,3.18,3.09,3.09,-0.12,-3.74,20000,2,61890,0,0,0,0,0,0,0,20000,-20000,-20000
20200430,060807,新光金群益9A購01,0.91,0.92,0.88,0.92,+0.05,5.75,683000,19,613480,0,0,0,0,0,0,371000,312000,59000,59000
20200430,060808,欣興群益9A購01,2.74,2.74,2.74,2.74,0.00,0.00,1000,1,2740,0,0,0,0,0,0,1000,0,1000,1000
20200430,060809,康友群益9A購01,1.65,1.74,1.65,1.74,+0.17,10.83,287000,9,481850,0,0,0,0,0,0,103000,189000,-86000,-86000
20200430,06080P,景碩群益98售02,1.80,1.80,1.80,1.80,+0.94,109.3,3000,1,5400,0,0,0,0,0,0,0,0,0,0
20200430,060810,滬深2X凱基9B購03,,,,,0.00,0.00,0,0,0,0,0,0,0,0,0,0,0,0,0
20200430,060811,亞德客凱基9A購02,1.88,2.12,1.82,2.12,+0.34,19.1,133000,22,255270,0,0,0,0,0,0,65000,74000,-9000,-9000
20200430,060812,智邦凱基9A購01,2.23,2.23,2.06,2.06,-0.09,-4.19,42000,8,90170,0,0,0,0,0,0,37000,35000,2000,2000
20200430,060813,高鐵凱基9A購01,1.26,1.27,1.21,1.22,0.00,0.00,387000,29,478250,0,0,0,0,0,0,387000,4000,383000,383000
20200430,060814,健策凱基9B購01,1.80,1.85,1.76,1.82,+0.07,4.0,294000,19,529370,0,0,0,0,0,0,149000,176000,-27000,-27000
20200430,060815,茂林凱基9B購01,1.78,1.78,1.78,1.78,-0.03,-1.66,18000,1,32040,0,0,0,0,0,0,0,18000,-18000,-18000
20200430,060816,世紀鋼凱基9C購02,0.66,0.70,0.66,0.69,+0.04,6.15,210000,13,144830,0,0,0,0,0,0,2000,208000,-206000,-206000
20200430,060817,華邦電台新9A購01,1.43,1.50,1.43,1.50,+0.13,9.49,208000,8,299920,0,0,0,0,0,0,139000,69000,70000,70000
20200430,060818,上銀統一9C購01,1.38,1.65,1.38,1.65,+0.29,21.32,1209000,54,1781610,0,0,0,0,0,0,584000,640000,-56000,-56000
20200430,060819,國巨統一9C購04,1.06,1.09,1.04,1.07,+0.04,3.88,392000,17,420640,0,0,0,0,0,0,256000,136000,120000,120000
20200430,06081P,深中小元大97售02,0.34,0.44,0.33,0.44,0.00,0.00,71000,8,24040,0,0,0,0,0,0,0,71000,-71000,-71000
20200430,060820,上証2X元大9A購04,,,,,0.00,0.00,0,0,0,0,0,0,0,0,0,0,0,0,0
20200430,060821,SP黃豆元大9A購02,1.31,1.39,1.31,1.38,+0.12,9.52,856000,30,1167660,0,0,0,0,0,0,692000,154000,538000,538000
20200430,060822,華通元大9A購05,2.54,2.69,2.52,2.69,+0.18,7.17,95000,10,248610,0,0,0,0,0,0,94000,13000,81000,81000
20200430,060823,旺宏元大9A購05,2.48,2.48,2.36,2.38,+0.19,8.68,326000,36,785080,0,0,0,0,0,0,211000,256000,-45000,-45000
20200430,060824,旺宏元大9A購06,3.75,3.75,3.55,3.55,+0.20,5.97,259000,39,947450,0,0,0,0,0,0,193000,150000,43000,43000
20200430,060825,聯詠元大9A購05,1.35,1.41,1.31,1.40,+0.08,6.06,559000,35,762260,0,0,0,0,0,0,288000,275000,13000,13000
20200430,060826,牧德元大9B購02,1.63,1.67,1.60,1.67,+0.11,7.05,446000,20,729060,0,0,0,0,0,0,123000,297000,-174000,-174000
20200430,060827,健策元大9A購02,2.13,2.20,2.07,2.12,+0.06,2.91,441000,33,931250,0,0,0,0,0,0,326000,175000,151000,151000
20200430,060828,高股息國票9A購01,2.43,2.47,2.43,2.47,+0.16,6.93,76000,2,186200,0,0,0,0,0,0,38000,38000,0,0
20200430,060829,T50反1國票9A購06,0.69,0.69,0.65,0.65,-0.11,-14.47,28000,2,18600,0,0,0,0,0,0,28000,0,28000,28000
20200430,06082P,華通統一98售01,,,,,0.00,0.00,0,0,0,0,0,0,0,0,0,0,0,0,0
20200430,060830,T50反1國票9A購07,0.65,0.66,0.65,0.66,-0.05,-7.04,74000,3,48350,0,0,0,0,0,0,49000,25000,24000,24000
20200430,060831,T50反1國票9B購03,,,,,0.00,0.00,0,0,0,0,0,0,0,0,0,0,0,0,0
20200430,060832,臺指反國票9A購01,,,,,0.00,0.00,0,0,0,0,0,0,0,0,0,0,0,0,0
20200430,060833,道瓊反國票9A購01,,,,,0.00,0.00,0,0,0,0,0,0,0,0,0,0,0,0,0
20200430,060834,道瓊反國票9C購01,,,,,0.00,0.00,0,0,0,0,0,0,0,0,0,0,0,0,0
20200430,060835,亞德客國票9A購01,3.06,3.78,2.92,3.73,+0.83,28.62,308000,62,972370,0,0,0,0,0,0,183000,271000,-88000,-88000
20200430,060836,上銀國票9A購03,4.98,5.50,4.98,5.50,+0.80,17.02,41000,6,213790,0,0,0,0,0,0,18000,23000,-5000,-5000
20200430,060837,上銀國票9A購04,5.15,6.20,5.15,6.20,+1.43,29.98,84000,12,451500,0,0,0,0,0,0,42000,42000,0,0
20200430,060838,華通國票9A購05,6.00,6.00,6.00,6.00,+0.55,10.09,3000,1,18000,0,0,0,0,0,0,3000,0,3000,3000
20200430,060839,聯發科國票9A購02,3.81,3.85,3.81,3.85,+0.49,14.58,8000,2,30680,0,0,0,0,0,0,0,8000,-8000,-8000
20200430,06083P,華通統一98售02,,,,,0.00,0.00,0,0,0,0,0,0,0,0,0,0,0,0,0
20200430,060840,可成國票9B購01,2.83,2.83,2.83,2.83,0.00,0.00,35000,1,99050,0,0,0,0,0,0,35000,0,35000,35000
20200430,060841,宏達電國票9B購01,1.47,1.47,1.45,1.45,-0.01,-0.68,24000,2,34940,0,0,0,0,0,0,0,24000,-24000,-24000
20200430,060842,新光金國票9B購01,0.90,0.90,0.88,0.88,+0.02,2.33,13000,6,11560,0,0,0,0,0,0,8000,5000,3000,3000
20200430,060843,大立光國票9A購06,2.90,3.20,2.90,3.20,+0.35,12.28,20000,4,59460,0,0,0,0,0,0,17000,4000,13000,13000
20200430,060844,大立光國票9A購07,2.84,3.04,2.83,3.04,+0.35,13.01,20000,3,56870,0,0,0,0,0,0,20000,1000,19000,19000
20200430,060845,欣興國票9A購01,6.60,6.75,6.55,6.75,+0.40,6.3,31000,5,205650,0,0,0,0,0,0,22000,9000,13000,13000
20200430,060846,欣興國票9A購02,5.10,5.35,5.10,5.20,+0.24,4.84,207000,13,1081850,0,0,0,0,0,0,102000,123000,-21000,-21000
20200430,060847,康控國票9A購01,3.51,3.69,3.51,3.69,+0.79,27.24,280000,12,998870,0,0,0,0,0,0,162000,118000,44000,44000
20200430,060848,聯茂國票9A購02,2.97,2.97,2.82,2.87,-0.07,-2.38,38000,3,110560,0,0,0,0,0,0,30000,8000,22000,22000
20200430,060849,力成國票9A購01,4.70,4.89,4.70,4.89,+0.30,6.54,27000,2,130700,0,0,0,0,0,0,27000,0,27000,27000
20200430,06084P,宏達電元富97售02,,,,,0.00,0.00,0,0,0,0,0,0,0,0,0,0,0,0,0
20200430,060850,康友國票9A購03,2.85,2.99,2.81,2.99,+0.25,9.12,344000,25,987560,0,0,0,0,0,0,110000,240000,-130000,-130000
20200430,060851,國巨國泰9C購01,2.70,2.77,2.64,2.72,+0.16,6.25,438000,40,1183260,0,0,0,0,0,0,285000,205000,80000,80000
20200430,060852,京鼎國泰9B購01,2.28,2.52,2.28,2.48,+0.29,13.24,162000,8,377560,0,0,0,0,0,0,132000,30000,102000,102000
20200430,060853,健策國泰9B購02,2.44,2.50,2.44,2.46,+0.14,6.03,119000,4,292370,0,0,0,0,0,0,105000,90000,15000,15000
20200430,060854,台積電富邦9C購08,0.77,0.78,0.77,0.78,+0.04,5.41,50000,4,38900,0,0,0,0,0,0,50000,0,50000,50000
20200430,060855,華新科富邦01購01,0.87,0.88,0.86,0.86,+0.02,2.38,64000,11,55270,0,0,0,0,0,0,0,45000,-45000,-45000
20200430,060856,健策富邦9B購02,0.95,0.99,0.92,0.96,+0.04,4.35,851000,48,815480,0,0,0,0,0,0,521000,464000,57000,57000
20200430,060857,旭富富邦9B購01,0.51,0.51,0.51,0.51,+0.01,2.0,8000,1,4080,0,0,0,0,0,0,8000,0,8000,8000
20200430,060858,T50反1永豐9A購01,,,,,0.00,0.00,0,0,0,0,0,0,0,0,0,0,0,0,0
20200430,060859,鴻海永豐9A購01,1.78,1.79,1.78,1.79,+0.02,1.13,99000,3,177130,0,0,0,0,0,0,99000,0,99000,99000
20200430,06085P,義隆台新97售01,0.32,0.38,0.13,0.13,-0.27,-67.5,547000,14,157180,0,0,0,0,0,0,483000,31000,452000,452000
20200430,060860,國巨永豐9A購02,,,,,0.00,0.00,0,0,0,0,0,0,0,0,0,0,0,0,0
20200430,060861,漢唐永豐9A購01,1.35,1.35,1.32,1.34,+0.01,0.75,241000,12,321330,0,0,0,0,0,0,93000,143000,-50000,-50000
20200430,060862,美律永豐9A購01,1.15,1.23,1.15,1.22,+0.07,6.09,694000,14,826630,0,0,0,0,0,0,218000,466000,-248000,-248000
20200430,060863,聯發科永豐9A購02,2.03,2.18,2.03,2.18,+0.30,15.96,99000,7,207660,0,0,0,0,0,0,12000,87000,-75000,-75000
20200430,060864,可成永豐9A購01,1.55,1.55,1.55,1.55,-0.02,-1.27,23000,1,35650,0,0,0,0,0,0,23000,0,23000,23000
20200430,060865,創意永豐9A購01,1.25,1.31,1.25,1.27,+0.04,3.25,329000,11,419750,0,0,0,0,0,0,69000,260000,-191000,-191000
20200430,060866,世芯永豐9B購01,2.61,2.91,2.60,2.89,+0.34,13.33,122000,25,340800,0,0,0,0,0,0,74000,48000,26000,26000
20200430,060867,智伸科永豐9A購01,1.12,1.26,1.12,1.16,+0.05,4.5,473000,23,570410,0,0,0,0,0,0,101000,357000,-256000,-256000
20200430,060868,致伸永豐9A購01,,,,,0.00,0.00,0,0,0,0,0,0,0,0,0,0,0,0,0
20200430,060869,超眾永豐9A購02,1.05,1.12,1.05,1.10,+0.02,1.85,86000,4,90980,0,0,0,0,0,0,75000,11000,64000,64000
20200430,06086P,台積電康和97售01,,,,,0.00,0.00,0,0,0,0,0,0,0,0,0,0,0,0,0
20200430,060870,旭富群益9A購01,1.67,1.67,1.61,1.61,+0.05,3.21,161000,4,265410,0,0,0,0,0,0,141000,20000,121000,121000
20200430,060871,台灣50中信01購03,0.99,1.04,0.97,1.04,+0.10,10.64,198000,15,200600,0,0,0,0,0,0,83000,115000,-32000,-32000
20200430,060872,高股息中信02購01,0.95,0.95,0.95,0.95,0.00,0.00,20000,1,19000,0,0,0,0,0,0,0,20000,-20000,-20000
20200430,060873,道瓊反中信9C購01,,,,,0.00,0.00,0,0,0,0,0,0,0,0,0,0,0,0,0
20200430,060874,中鋼中信02購01,1.02,1.04,1.01,1.04,+0.02,1.96,308000,13,316950,0,0,0,0,0,0,26000,252000,-226000,-226000
20200430,060875,華通中信02購01,1.45,1.50,1.45,1.50,+0.10,7.14,17000,2,25150,0,0,0,0,0,0,7000,10000,-3000,-3000
20200430,060876,國巨中信9A購04,1.77,1.78,1.70,1.70,+0.06,3.66,229000,9,400190,0,0,0,0,0,0,105000,124000,-19000,-19000
20200430,060877,華邦電中信02購01,1.00,1.07,1.00,1.03,+0.05,5.1,345000,39,358990,0,0,0,0,0,0,12000,333000,-321000,-321000
20200430,060878,奇力新中信9C購01,1.55,1.63,1.53,1.53,+0.05,3.38,333000,14,520870,0,0,0,0,0,0,85000,248000,-163000,-163000
20200430,060879,華新科中信9A購02,1.35,1.35,1.35,1.35,0.00,0.00,11000,1,14850,0,0,0,0,0,0,0,11000,-11000,-11000
20200430,06087P,國巨永豐97售01,1.23,1.23,1.23,1.23,-0.21,-14.58,21000,1,25830,0,0,0,0,0,0,21000,0,21000,21000
20200430,060880,中壽中信9C購01,0.82,0.87,0.81,0.86,+0.06,7.5,626000,28,525140,0,0,0,0,0,0,112000,514000,-402000,-402000
20200430,060881,玉山金中信02購01,1.25,1.28,1.25,1.28,+0.06,4.92,85000,11,107510,0,0,0,0,0,0,65000,65000,0,0
20200430,060882,大立光中信9A購05,0.85,0.88,0.85,0.88,+0.10,12.82,411000,6,359640,0,0,0,0,0,0,407000,4000,403000,403000
20200430,060884,超眾中信9B購01,0.79,0.79,0.78,0.78,0.00,0.00,55000,2,43100,0,0,0,0,0,0,55000,0,55000,55000
20200430,060885,世紀鋼中信9A購01,,,,,0.00,0.00,0,0,0,0,0,0,0,0,0,0,0,0,0
20200430,060886,國巨統一01購03,1.81,1.81,1.77,1.80,+0.05,2.86,24000,4,43390,0,0,0,0,0,0,22000,0,22000,22000
20200430,060887,台積電統一01購01,1.27,1.28,1.27,1.28,+0.02,1.59,144000,5,182930,0,0,0,0,0,0,34000,110000,-76000,-76000
20200430,060888,金像電統一9C購01,1.18,1.26,1.18,1.24,+0.07,5.98,711000,40,871440,0,0,0,0,0,0,208000,502000,-294000,-294000
20200430,060889,國泰金統一9C購01,1.44,1.49,1.44,1.48,+0.11,8.03,264000,14,387130,0,0,0,0,0,0,87000,157000,-70000,-70000
20200430,06088P,建準永豐97售01,1.02,1.02,1.02,1.02,0.00,0.00,35000,1,35700,0,0,0,0,0,0,0,35000,-35000,-35000
20200430,060890,大立光統一01購01,1.05,1.13,1.04,1.13,+0.12,11.88,550000,10,608500,0,0,0,0,0,0,430000,120000,310000,310000
20200430,060891,世芯統一9A購01,2.32,2.52,2.32,2.48,+0.31,14.29,43000,10,106420,0,0,0,0,0,0,17000,43000,-26000,-26000
20200430,060892,超眾統一9C購01,0.67,0.69,0.67,0.68,+0.01,1.49,29000,6,19630,0,0,0,0,0,0,13000,16000,-3000,-3000
20200430,060893,台灣50凱基01購07,2.88,3.03,2.88,3.03,0.00,0.00,685000,10,1983690,0,0,0,0,0,0,600000,685000,-85000,-85000
20200430,060894,奇力新凱基9A購03,1.42,1.42,1.42,1.42,+0.10,7.58,15000,1,21300,0,0,0,0,0,0,0,15000,-15000,-15000
20200430,060895,華新科凱基9B購05,2.18,2.18,2.18,2.18,-0.02,-0.91,3000,1,6540,0,0,0,0,0,0,3000,0,3000,3000
20200430,060896,晶技凱基9A購02,2.03,2.11,1.98,1.98,-0.02,-1.0,381000,30,769390,0,0,0,0,0,0,237000,240000,-3000,-3000
20200430,060897,健策凱基9A購04,1.76,1.82,1.74,1.80,+0.08,4.65,354000,29,624770,0,0,0,0,0,0,242000,149000,93000,93000
20200430,060898,世芯凱基9A購03,1.98,2.24,1.98,2.16,+0.25,13.09,72000,5,153870,0,0,0,0,0,0,65000,17000,48000,48000
20200430,060899,超眾凱基9A購01,1.35,1.35,1.35,1.35,0.00,0.00,93000,2,125550,0,0,0,0,0,0,0,93000,-93000,-93000
20200430,06089P,矽創永豐97售01,,,,,0.00,0.00,0,0,0,0,0,0,0,0,0,0,0,0,0
20200430,060900,超眾凱基9B購01,1.55,1.63,1.55,1.63,+0.08,5.16,128000,4,203620,0,0,0,0,0,0,27000,101000,-74000,-74000
20200430,060901,臺股指凱基9A購13,2.78,3.01,2.78,3.01,+0.44,17.12,34000,6,100920,0,0,0,0,0,0,5000,29000,-24000,-24000
20200430,060902,上証2X元大9A購05,,,,,0.00,0.00,0,0,0,0,0,0,0,0,0,0,0,0,0
20200430,060903,臺指反元大9A購01,,,,,0.00,0.00,0,0,0,0,0,0,0,0,0,0,0,0,0
20200430,060904,臺指反元大9C購07,1.57,1.58,1.54,1.54,0.00,0.00,12000,3,18820,0,0,0,0,0,0,0,12000,-12000,-12000
20200430,060905,台積電元大9A購20,3.34,3.38,3.34,3.38,+0.13,4.0,43000,2,144220,0,0,0,0,0,0,15000,28000,-13000,-13000
20200430,060906,旺宏元大9A購07,4.49,4.49,4.31,4.39,+0.41,10.3,66000,20,287720,0,0,0,0,0,0,62000,63000,-1000,-1000
20200430,060907,金像電元大9A購02,3.18,3.38,3.09,3.25,+0.19,6.21,778000,73,2501430,0,0,0,0,0,0,438000,329000,109000,109000
20200430,060908,金像電元大9A購03,2.68,2.83,2.61,2.76,+0.19,7.39,812000,69,2201830,0,2000,-2000,0,0,0,386000,424000,-38000,-40000
20200430,060909,金像電元大9B購01,4.78,5.05,4.70,4.90,+0.32,6.99,254000,27,1237580,0,0,0,0,0,0,41000,213000,-172000,-172000
20200430,06090P,旺宏統一97售06,2.28,2.28,2.28,2.28,-0.33,-12.64,8000,2,18240,0,0,0,0,0,0,0,8000,-8000,-8000
20200430,060910,聯發科元大9A購05,3.66,3.81,3.61,3.81,+0.50,15.11,90000,11,333810,0,0,0,0,0,0,45000,47000,-2000,-2000
20200430,060911,大毅元大9A購01,3.33,3.67,2.27,3.24,+0.23,7.64,363000,32,1252130,0,0,0,0,0,0,166000,200000,-34000,-34000
20200430,060912,華新科元大9A購10,2.43,2.43,2.43,2.43,+0.01,0.41,9000,2,21870,0,0,0,0,0,0,0,9000,-9000,-9000
20200430,060913,宏達電元大9A購03,1.98,1.98,1.91,1.91,+0.01,0.53,100000,2,194500,0,0,0,0,0,0,50000,50000,0,0
20200430,060914,健策元大9A購03,1.61,1.66,1.55,1.63,+0.08,5.16,399000,28,636170,0,0,0,0,0,0,218000,236000,-18000,-18000
20200430,060915,旭富元大9A購01,1.35,1.37,1.29,1.29,+0.03,2.38,241000,14,316430,0,0,0,0,0,0,167000,89000,78000,78000
20200430,060916,金像電國泰9C購01,1.97,2.11,1.92,2.05,+0.15,7.89,554000,41,1114830,0,0,0,0,0,0,200000,398000,-198000,-198000
20200430,060917,台表科國泰9B購01,2.14,2.21,2.14,2.21,+0.04,1.84,60000,5,129940,0,0,0,0,0,0,20000,40000,-20000,-20000
20200430,060918,康友國泰9C購01,1.91,2.03,1.89,2.00,+0.13,6.95,909000,43,1779880,0,0,0,0,0,0,139000,775000,-636000,-636000
20200430,060919,滬深2X富邦9B購01,,,,,0.00,0.00,0,0,0,0,0,0,0,0,0,0,0,0,0
20200430,06091P,華新科統一97售01,2.62,2.62,2.62,2.62,-0.11,-4.03,3000,3,7860,0,0,0,0,0,0,3000,0,3000,3000
20200430,060920,超眾富邦9B購01,0.46,0.48,0.45,0.46,+0.02,4.55,721000,12,335850,0,0,0,0,0,0,661000,444000,217000,217000
20200430,060921,中橡永豐9A購02,0.93,0.94,0.90,0.94,+0.01,1.08,532000,13,491480,0,0,0,0,0,0,479000,53000,426000,426000
20200430,060922,金像電永豐9A購01,1.37,1.49,1.36,1.49,+0.15,11.19,405000,28,574840,17000,0,17000,0,0,0,296000,109000,187000,204000
20200430,060923,全新永豐9A購01,1.12,1.12,1.11,1.11,-0.01,-0.89,34000,2,37870,0,0,0,0,0,0,34000,0,34000,34000
20200430,060924,大毅永豐9A購03,1.41,1.62,1.39,1.39,+0.10,7.75,219000,23,329260,0,0,0,0,0,0,9000,210000,-201000,-201000
20200430,060925,華新科永豐9A購01,,,,,0.00,0.00,0,0,0,0,0,0,0,0,0,0,0,0,0
20200430,060926,宏達電永豐9A購01,1.46,1.46,1.46,1.46,-0.02,-1.35,1000,1,1460,0,0,0,0,0,0,1000,0,1000,1000
20200430,060927,嘉晶永豐9A購01,1.45,1.58,1.45,1.50,+0.07,4.9,231000,16,356080,0,0,0,0,0,0,0,231000,-231000,-231000
20200430,060928,明泰永豐9A購01,1.17,1.17,1.17,1.17,-0.04,-3.31,35000,1,40950,0,0,0,0,0,0,35000,0,35000,35000
20200430,060929,健策永豐9A購01,1.35,1.40,1.35,1.40,+0.08,6.06,131000,9,177840,0,0,0,0,0,0,86000,51000,35000,35000
20200430,06092P,嘉聯益統一97售01,,,,,0.00,0.00,0,0,0,0,0,0,0,0,0,0,0,0,0
20200430,060930,超眾永豐9A購03,0.91,0.92,0.89,0.90,+0.03,3.45,47000,8,42790,0,0,0,0,0,0,0,47000,-47000,-47000
20200430,060931,GIS永豐9A購01,1.46,1.48,1.43,1.48,+0.03,2.07,379000,9,548970,0,0,0,0,0,0,285000,44000,241000,241000
20200430,060932,南六永豐9A購02,1.91,1.91,1.74,1.84,-0.24,-11.54,398000,34,726700,0,0,0,0,0,0,360000,37000,323000,323000
20200430,060933,南電永豐9A購02,1.84,1.85,1.74,1.75,-0.11,-5.91,339000,16,618320,0,0,0,0,0,0,328000,6000,322000,322000
20200430,060934,台汽電永豐9A購02,0.78,0.82,0.78,0.82,0.00,0.00,152000,9,122040,0,0,0,0,0,0,56000,96000,-40000,-40000
20200430,060935,T50反1國票9A購08,0.83,0.83,0.77,0.77,-0.11,-12.5,377000,8,301400,0,0,0,0,0,0,0,377000,-377000,-377000
20200430,060936,T50反1國票9A購09,0.95,0.96,0.89,0.89,-0.14,-13.59,221000,13,204210,0,0,0,0,0,0,144000,77000,67000,67000
20200430,060937,T50反1國票9A購10,0.77,0.77,0.66,0.67,-0.11,-14.1,2326000,33,1581190,0,0,0,0,0,0,1459000,1860000,-401000,-401000
20200430,060938,臺指反國票9B購03,,,,,0.00,0.00,0,0,0,0,0,0,0,0,0,0,0,0,0
20200430,060939,鴻海國票9A購06,3.11,3.11,3.11,3.11,0.00,0.00,10000,1,31100,0,0,0,0,0,0,0,10000,-10000,-10000
20200430,06093P,華通元富97售03,,,,,0.00,0.00,0,0,0,0,0,0,0,0,0,0,0,0,0
20200430,060940,國巨國票9B購03,4.57,4.65,4.55,4.56,+0.15,3.4,153000,7,710450,0,0,0,0,0,0,3000,153000,-150000,-150000
20200430,060941,台積電國票9B購04,,,,,0.00,0.00,0,0,0,0,0,0,0,0,0,0,0,0,0
20200430,060942,智邦國票9A購02,4.14,4.14,3.64,3.64,-0.30,-7.61,204000,16,783850,0,0,0,0,0,0,103000,193000,-90000,-90000
20200430,060943,宏達電國票9B購02,,,,,0.00,0.00,0,0,0,0,0,0,0,0,0,0,0,0,0
20200430,060944,國泰金國票9A購01,2.00,2.08,1.99,2.08,+0.32,18.18,201000,5,405430,0,0,0,0,0,0,81000,120000,-39000,-39000
20200430,060945,緯穎國票9A購02,3.43,3.98,3.41,3.96,+0.70,21.47,134000,14,497420,0,0,0,0,0,0,98000,129000,-31000,-31000
20200430,060946,世紀鋼國票9A購02,,,,,0.00,0.00,0,0,0,0,0,0,0,0,0,0,0,0,0
20200430,060947,台積電統一9C購03,1.41,1.41,1.41,1.41,+0.01,0.71,14000,1,19740,0,0,0,0,0,0,14000,0,14000,14000
20200430,060948,可成第一9A購01,0.90,0.90,0.90,0.90,-0.04,-4.26,1000,1,900,0,0,0,0,0,0,1000,0,1000,1000
20200430,060949,祥碩中信9A購01,1.26,1.26,1.02,1.07,-0.09,-7.76,801000,48,887910,0,0,0,0,0,0,153000,638000,-485000,-485000
20200430,06094P,台達電中信97售01,,,,,0.00,0.00,0,0,0,0,0,0,0,0,0,0,0,0,0
20200430,060950,T50反1群益9A購03,,,,,0.00,0.00,0,0,0,0,0,0,0,0,0,0,0,0,0
20200430,060951,元黃金群益9A購01,,,,,0.00,0.00,0,0,0,0,0,0,0,0,0,0,0,0,0
20200430,060952,滬深2X群益9C購05,,,,,0.00,0.00,0,0,0,0,0,0,0,0,0,0,0,0,0
20200430,060953,富邦金群益9A購01,1.62,1.76,1.59,1.73,+0.22,14.57,868000,75,1439840,0,0,0,0,0,0,248000,645000,-397000,-397000
20200430,060954,國泰金群益9A購02,1.43,1.46,1.42,1.46,+0.20,15.87,216000,8,309260,0,0,0,0,0,0,32000,184000,-152000,-152000
20200430,060955,大立光群益9A購02,1.50,1.64,1.50,1.64,+0.17,11.56,290000,7,466870,0,0,0,0,0,0,268000,22000,246000,246000
20200430,060956,超眾群益9A購01,1.35,1.35,1.35,1.35,+0.10,8.0,66000,2,89100,0,0,0,0,0,0,0,66000,-66000,-66000
20200430,060957,SP黃豆凱基9A購04,1.18,1.24,1.18,1.21,+0.07,6.14,166000,13,200820,0,0,0,0,0,0,23000,141000,-118000,-118000
20200430,060958,儒鴻凱基9A購02,0.88,0.95,0.86,0.94,+0.09,10.59,756000,34,690940,0,0,0,0,0,0,314000,451000,-137000,-137000
20200430,060959,金像電凱基9A購01,1.53,1.63,1.51,1.62,+0.13,8.72,636000,37,1010300,0,0,0,0,0,0,194000,442000,-248000,-248000
20200430,06095P,燿華永豐97售01,,,,,0.00,0.00,0,0,0,0,0,0,0,0,0,0,0,0,0
20200430,060960,金像電凱基9B購01,1.98,2.15,1.95,2.10,+0.18,9.37,448000,33,915830,0,0,0,0,0,0,203000,245000,-42000,-42000
20200430,060961,台光電凱基9A購03,1.23,1.34,1.23,1.34,+0.16,13.56,190000,14,247600,0,0,0,0,0,0,30000,190000,-160000,-160000
20200430,060962,義隆凱基9B購01,0.67,0.73,0.66,0.71,+0.04,5.97,870000,41,596130,0,0,0,0,0,0,722000,152000,570000,570000
20200430,060963,禾伸堂凱基9A購01,1.70,1.73,1.64,1.64,0.00,0.00,227000,35,382730,0,0,0,0,0,0,72000,154000,-82000,-82000
20200430,060964,日月光凱基9A購01,1.06,1.09,1.06,1.09,+0.06,5.83,24000,3,25740,0,0,0,0,0,0,0,24000,-24000,-24000
20200430,060965,中租凱基9B購01,1.15,1.21,1.09,1.17,+0.02,1.74,693000,49,790120,0,0,0,0,0,0,384000,277000,107000,107000
20200430,060966,台表科凱基9B購01,1.30,1.30,1.27,1.28,+0.01,0.79,68000,8,86800,0,0,0,0,0,0,32000,36000,-4000,-4000
20200430,060967,鈺齊凱基9A購02,1.63,1.68,1.58,1.64,+0.03,1.86,928000,49,1523050,0,0,0,0,0,0,752000,644000,108000,108000
20200430,060968,台灣50元大9C購28,,,,,0.00,0.00,0,0,0,0,0,0,0,0,0,0,0,0,0
20200430,060969,台灣50元大9C購29,,,,,0.00,0.00,0,0,0,0,0,0,0,0,0,0,0,0,0
20200430,06096P,全新永豐97售02,1.55,1.61,1.55,1.61,+0.08,5.23,55000,4,87460,0,0,0,0,0,0,16000,39000,-23000,-23000
20200430,060970,T50反1元大9A購08,1.33,1.33,1.33,1.33,0.00,0.00,1000,1,1330,0,0,0,0,0,0,0,1000,-1000,-1000
20200430,060971,T50反1元大9A購09,,,,,0.00,0.00,0,0,0,0,0,0,0,0,0,0,0,0,0
20200430,060972,T50反1元大9A購10,,,,,0.00,0.00,0,0,0,0,0,0,0,0,0,0,0,0,0
20200430,060973,T50反1元大9A購11,,,,,0.00,0.00,0,0,0,0,0,0,0,0,0,0,0,0,0
20200430,060974,滬深2X元大01購01,,,,,0.00,0.00,0,0,0,0,0,0,0,0,0,0,0,0,0
20200430,060975,滬深2X元大01購02,2.32,2.43,2.32,2.43,0.00,0.00,4000,2,9500,0,0,0,0,0,0,0,4000,-4000,-4000
20200430,060976,SP黃豆元大9A購03,0.99,1.00,0.97,0.98,+0.08,8.89,305000,5,300700,0,0,0,0,0,0,200000,105000,95000,95000
20200430,060977,亞德客元大9A購04,4.00,4.58,3.80,4.58,+0.82,21.81,294000,47,1188460,0,0,0,0,0,0,180000,153000,27000,27000
20200430,060978,國巨元大9A購13,3.05,3.05,2.96,2.97,+0.11,3.85,75000,8,223670,0,0,0,0,0,0,72000,3000,69000,69000
20200430,060979,國巨元大9A購14,2.15,2.15,2.15,2.15,+0.07,3.37,1000,1,2150,0,0,0,0,0,0,1000,0,1000,1000
20200430,06097P,茂林永豐97售01,,,,,0.00,0.00,0,0,0,0,0,0,0,0,0,0,0,0,0
20200430,060980,台積電元大9A購21,3.88,3.95,3.88,3.95,+0.15,3.95,40000,3,155860,0,0,0,0,0,0,38000,2000,36000,36000
20200430,060981,旺宏元大9A購08,3.75,3.86,3.66,3.68,+0.22,6.36,275000,50,1027910,0,0,0,0,0,0,269000,100000,169000,169000
20200430,060982,旺宏元大9A購09,4.15,4.15,3.93,3.93,+0.21,5.65,206000,33,826850,0,0,0,0,0,0,203000,172000,31000,31000
20200430,060983,南亞科元大9A購06,2.94,2.94,2.85,2.86,+0.08,2.88,42000,5,121750,0,0,0,0,0,0,32000,10000,22000,22000
20200430,060984,南亞科元大9A購07,3.12,3.12,3.00,3.03,+0.09,3.06,57000,6,175790,0,0,0,0,0,0,42000,15000,27000,27000
20200430,060985,聯發科元大9A購06,4.08,4.32,4.03,4.32,+0.57,15.2,18000,5,74530,0,0,0,0,0,0,4000,18000,-14000,-14000
20200430,060986,聯發科元大9A購07,2.14,2.25,2.09,2.24,+0.29,14.87,2391000,72,5082910,0,0,0,0,0,0,2134000,2105000,29000,29000
20200430,060987,華新科元大9A購11,2.32,2.33,2.29,2.32,-0.01,-0.43,121000,8,279300,0,0,0,0,0,0,71000,50000,21000,21000
20200430,060988,華新科元大9A購12,1.72,1.72,1.67,1.68,+0.01,0.6,161000,6,271600,0,0,0,0,0,0,21000,140000,-119000,-119000
20200430,060989,國泰金元大9A購02,2.29,2.45,2.29,2.44,+0.29,13.49,412000,32,970990,0,0,0,0,0,0,204000,202000,2000,2000
20200430,06098P,T50反1日盛97售02,,,,,0.00,0.00,0,0,0,0,0,0,0,0,0,0,0,0,0
20200430,060990,新光金元大9B購03,1.57,1.58,1.57,1.57,+0.03,1.95,139000,13,218530,0,0,0,0,0,0,139000,0,139000,139000
20200430,060991,京鼎元大9A購01,2.31,2.56,2.26,2.56,+0.35,15.84,285000,38,674460,0,0,0,0,0,0,82000,218000,-136000,-136000
20200430,060992,健策元大9A購05,1.70,1.74,1.64,1.70,+0.07,4.29,575000,30,965210,0,0,0,0,0,0,329000,316000,13000,13000
20200430,060993,健策元大9B購03,1.55,1.59,1.49,1.52,+0.02,1.33,1107000,62,1688000,0,0,0,0,0,0,937000,339000,598000,598000
20200430,060994,世芯元大9A購03,3.48,3.94,3.47,3.83,+0.49,14.67,163000,17,593970,0,0,0,0,0,0,87000,76000,11000,11000
20200430,060995,泰鼎元大9A購03,2.14,2.14,2.03,2.10,+0.03,1.45,318000,21,661340,0,0,0,0,0,0,59000,272000,-213000,-213000
20200430,060996,臻鼎元大9A購01,2.56,2.78,2.50,2.78,+0.33,13.47,180000,21,462690,0,0,0,0,0,0,90000,90000,0,0
20200430,060997,上銀兆豐9B購01,1.93,2.20,1.91,2.20,+0.38,20.88,58000,4,112470,0,0,0,0,0,0,58000,0,58000,58000
20200430,060998,華通兆豐9A購01,1.00,1.13,1.00,1.12,+0.16,16.67,715000,32,740830,0,0,0,0,0,0,649000,42000,607000,607000
20200430,060999,國巨兆豐9A購01,2.47,2.55,2.47,2.50,+0.09,3.73,42000,4,105400,0,0,0,0,0,0,20000,22000,-2000,-2000
20200430,06099P,鴻海日盛97售03,4.46,4.46,4.46,4.46,0.00,0.00,1000,1,4460,0,0,0,0,0,0,0,1000,-1000,-1000
20200430,061000,旺宏兆豐9A購02,1.87,1.87,1.85,1.85,+0.27,17.09,85000,3,157410,0,0,0,0,0,0,0,85000,-85000,-85000
20200430,061001,智邦兆豐9B購01,1.79,1.79,1.51,1.61,-0.07,-4.17,177000,23,288610,0,0,0,0,0,0,70000,92000,-22000,-22000
20200430,061002,瑞昱兆豐9B購01,1.61,1.73,1.58,1.73,+0.20,13.07,756000,35,1233180,0,0,0,0,0,0,617000,108000,509000,509000
20200430,061003,南亞科兆豐9A購01,1.79,1.79,1.75,1.77,+0.06,3.51,190000,16,336220,0,0,0,0,0,0,75000,109000,-34000,-34000
20200430,061004,友達兆豐9A購01,1.39,1.40,1.39,1.40,0.00,0.00,86000,2,119970,0,0,0,0,0,0,0,86000,-86000,-86000
20200430,061005,可成兆豐9A購01,1.36,1.36,1.30,1.30,-0.06,-4.41,7000,7,9280,0,0,0,0,0,0,1000,7000,-6000,-6000
20200430,061006,新光金兆豐9A購01,0.99,1.00,0.97,1.00,+0.05,5.26,85000,9,84160,0,0,0,0,0,0,70000,15000,55000,55000
20200430,061007,聯詠兆豐9A購01,0.88,0.91,0.87,0.91,+0.05,5.81,438000,13,389680,0,0,0,0,0,0,112000,326000,-214000,-214000
20200430,061008,群創兆豐9A購02,1.11,1.14,1.08,1.14,+0.07,6.54,238000,9,264330,0,0,0,0,0,0,60000,178000,-118000,-118000
20200430,061009,台灣50麥證02購02,,,,,0.00,0.00,0,0,0,0,0,0,0,0,0,0,0,0,0
20200430,06100P,台積電日盛97售03,1.18,1.60,1.17,1.17,-1.02,-46.58,50000,5,62900,0,0,0,0,0,0,10000,40000,-30000,-30000
20200430,061010,上銀麥證9A購02,2.90,3.44,2.89,3.44,+0.68,24.64,41000,16,127800,8000,33000,-25000,0,0,0,8000,33000,-25000,-25000
20200430,061011,華通麥證9A購02,1.52,1.65,1.52,1.65,+0.18,12.24,151000,11,237940,107000,44000,63000,0,0,0,107000,44000,63000,63000
20200430,061012,國巨麥證9A購03,2.12,2.12,2.12,2.12,0.00,0.00,100000,1,212000,100000,0,100000,0,0,0,100000,100000,0,0
20200430,061013,台積電麥證9A購03,2.10,2.16,2.10,2.16,+0.14,6.93,60000,2,129000,60000,0,60000,0,0,0,60000,0,60000,60000
20200430,061014,台積電麥證9A購04,2.95,2.95,2.95,2.95,+0.07,2.43,4000,1,11800,4000,0,4000,0,0,0,4000,0,4000,4000
20200430,061015,旺宏麥證9A購03,3.25,3.27,3.23,3.27,+0.35,11.99,18000,5,58400,3000,15000,-12000,0,0,0,3000,15000,-12000,-12000
20200430,061016,可成麥證9A購01,,,,,0.00,0.00,0,0,0,0,0,0,0,0,0,0,0,0,0
20200430,061017,國泰金麥證9A購01,1.53,1.62,1.52,1.62,+0.27,20.0,93000,13,143600,26000,67000,-41000,0,0,0,26000,67000,-41000,-41000
20200430,061018,台積電國票9B購05,4.92,4.92,4.88,4.88,+0.28,6.09,14000,3,68760,0,0,0,0,0,0,14000,1000,13000,13000
20200430,061019,大毅國票9A購01,4.56,5.30,4.56,4.67,+0.61,15.02,92000,17,440780,0,0,0,0,0,0,34000,69000,-35000,-35000
20200430,06101P,聯發科日盛97售03,1.12,1.12,1.12,1.12,-0.52,-31.71,2000,1,2240,0,0,0,0,0,0,0,2000,-2000,-2000
20200430,061020,超眾國票9A購02,2.34,2.41,2.34,2.40,+0.12,5.26,329000,4,773620,0,0,0,0,0,0,275000,54000,221000,221000
20200430,061021,聯電國泰9B購01,1.56,1.60,1.52,1.60,+0.13,8.84,470000,18,729550,0,0,0,0,0,0,470000,100000,370000,370000
20200430,061022,健策國泰9B購03,2.79,2.91,2.75,2.83,+0.12,4.43,521000,32,1473790,0,0,0,0,0,0,286000,496000,-210000,-210000
20200430,061023,茂林國泰9B購02,2.71,2.71,2.71,2.71,-0.06,-2.17,8000,1,21680,0,0,0,0,0,0,8000,0,8000,8000
20200430,061024,南電國泰9B購01,2.96,2.96,2.70,2.79,0.00,0.00,428000,59,1240580,0,0,0,0,0,0,323000,117000,206000,206000
20200430,061025,創意富邦9B購01,0.79,0.83,0.79,0.81,+0.03,3.85,501000,19,411610,0,0,0,0,0,0,44000,457000,-413000,-413000
20200430,061026,南電富邦9B購01,1.01,1.02,0.94,0.95,-0.01,-1.04,467000,51,458140,0,0,0,0,0,0,394000,44000,350000,350000
20200430,061027,儒鴻永豐9A購02,0.86,0.90,0.85,0.90,+0.08,9.76,243000,14,212050,0,0,0,0,0,0,50000,203000,-153000,-153000
20200430,061028,聚陽永豐9A購01,0.88,0.92,0.88,0.92,+0.05,5.75,102000,6,92480,0,0,0,0,0,0,100000,2000,98000,98000
20200430,061029,力山永豐9A購01,2.77,2.95,2.56,2.56,-0.05,-1.92,317000,37,875050,0,0,0,0,0,0,142000,178000,-36000,-36000
20200430,06102P,智邦凱基97售03,0.26,0.27,0.26,0.27,-0.02,-6.9,304000,4,82040,0,0,0,0,0,0,0,304000,-304000,-304000
20200430,061030,喬山永豐9A購01,1.25,1.46,1.25,1.43,+0.20,16.26,849000,34,1170690,0,0,0,0,0,0,26000,849000,-823000,-823000
20200430,061031,神隆永豐9A購02,0.77,0.77,0.77,0.77,+0.03,4.05,77000,5,59290,0,0,0,0,0,0,0,77000,-77000,-77000
20200430,061032,金像電永豐9A購03,1.14,1.25,1.13,1.22,+0.11,9.91,336000,36,400190,0,0,0,0,0,0,147000,189000,-42000,-42000
20200430,061033,台光電永豐9A購01,0.81,0.90,0.81,0.90,+0.10,12.5,619000,12,533260,0,0,0,0,0,0,19000,600000,-581000,-581000
20200430,061034,晶豪科永豐9A購01,1.47,1.58,1.41,1.42,-0.01,-0.7,509000,27,760860,0,0,0,0,0,0,428000,75000,353000,353000
20200430,061035,亞光永豐9A購01,0.98,1.06,0.98,1.06,+0.04,3.92,489000,22,500480,0,0,0,0,0,0,259000,249000,10000,10000
20200430,061036,晶技永豐9A購03,1.57,1.59,1.51,1.59,+0.10,6.71,122000,9,189350,0,0,0,0,0,0,54000,68000,-14000,-14000
20200430,061037,嘉澤永豐9A購01,1.05,1.15,1.05,1.15,+0.13,12.75,946000,24,1049810,0,0,0,0,0,0,667000,379000,288000,288000
20200430,061038,TPK永豐9A購01,0.93,0.93,0.92,0.92,0.00,0.00,46000,3,42620,0,0,0,0,0,0,46000,16000,30000,30000
20200430,061039,台表科永豐9A購03,0.98,0.98,0.96,0.96,-0.01,-1.03,20000,2,19400,0,0,0,0,0,0,20000,0,20000,20000
20200430,06103P,漢唐凱基97售02,,,,,0.00,0.00,0,0,0,0,0,0,0,0,0,0,0,0,0
20200430,061040,康友永豐9A購01,0.87,0.92,0.86,0.91,+0.06,7.06,227000,13,203480,0,0,0,0,0,0,162000,65000,97000,97000
20200430,061041,南電永豐9A購03,1.45,1.45,1.37,1.37,-0.10,-6.8,195000,6,269510,0,0,0,0,0,0,195000,0,195000,195000
20200430,061042,致新永豐9A購02,0.90,0.92,0.87,0.92,+0.04,4.55,60000,5,52820,0,0,0,0,0,0,40000,20000,20000,20000
20200430,061043,百和永豐9A購01,1.10,1.11,1.04,1.09,-0.05,-4.39,379000,15,400410,0,0,0,0,0,0,292000,94000,198000,198000
20200430,061044,世紀鋼永豐9A購02,,,,,0.00,0.00,0,0,0,0,0,0,0,0,0,0,0,0,0
20200430,061045,儒鴻第一9A購01,0.96,0.99,0.95,0.99,+0.07,7.61,220000,8,216680,0,0,0,0,0,0,4000,216000,-212000,-212000
20200430,061046,上銀第一9A購01,1.22,1.44,1.21,1.39,+0.23,19.83,862000,41,1106790,0,0,0,0,0,0,315000,547000,-232000,-232000
20200430,061047,大立光第一9A購01,0.74,0.75,0.74,0.74,+0.08,12.12,96000,4,71140,0,0,0,0,0,0,26000,70000,-44000,-44000
20200430,061048,國巨中信9A購05,0.92,0.92,0.92,0.92,+0.03,3.37,50000,1,46000,0,0,0,0,0,0,0,50000,-50000,-50000
20200430,061049,奇力新中信9A購02,0.90,0.94,0.89,0.93,+0.07,8.14,495000,18,452070,0,0,0,0,0,0,135000,360000,-225000,-225000
20200430,06104P,大立光凱基97售04,,,,,0.00,0.00,0,0,0,0,0,0,0,0,0,0,0,0,0
20200430,061050,康友中信9A購01,0.93,0.99,0.92,0.99,+0.09,10.0,169000,10,161140,0,0,0,0,0,0,0,169000,-169000,-169000
20200430,061051,臺股指中信9A購06,,,,,0.00,0.00,0,0,0,0,0,0,0,0,0,0,0,0,0
20200430,061052,和大群益9A購01,1.71,2.05,1.71,2.05,+0.46,28.93,272000,16,496220,0,0,0,0,0,0,53000,219000,-166000,-166000
20200430,061053,國巨群益9A購08,2.65,2.65,2.57,2.62,+0.15,6.07,69000,10,180860,0,0,0,0,0,0,10000,59000,-49000,-49000
20200430,061054,台積電群益9A購04,3.05,3.13,3.02,3.12,+0.18,6.12,198000,11,603930,0,0,0,0,0,0,99000,99000,0,0
20200430,061055,康控群益9A購01,1.70,2.02,1.70,2.02,+0.34,20.24,743000,28,1432830,0,0,0,0,0,0,294000,500000,-206000,-206000
20200430,061056,臺指反國票02購01,1.52,1.53,1.46,1.46,-0.15,-9.32,108000,5,158030,0,0,0,0,0,0,0,108000,-108000,-108000
20200430,061057,華新科國票9A購04,,,,,0.00,0.00,0,0,0,0,0,0,0,0,0,0,0,0,0
20200430,061058,健策國票9A購05,5.90,6.10,5.90,6.00,+0.25,4.35,45000,5,270850,0,0,0,0,0,0,31000,42000,-11000,-11000
20200430,061059,世芯國票9B購01,6.05,6.80,6.05,6.80,+1.05,18.26,91000,8,569600,0,0,0,0,0,0,64000,27000,37000,37000
20200430,06105P,國巨國票98售02,,,,,0.00,0.00,0,0,0,0,0,0,0,0,0,0,0,0,0
20200430,061060,台灣50麥證9B購01,2.35,2.35,2.35,2.35,+0.15,6.82,27000,1,63450,27000,0,27000,0,0,0,27000,0,27000,27000
20200430,061061,聯發科麥證9A購02,1.98,2.03,1.98,2.02,+0.19,10.38,41000,6,82130,26000,15000,11000,0,0,0,26000,15000,11000,11000
20200430,061062,和大凱基9A購02,1.28,1.50,1.28,1.42,+0.22,18.33,408000,12,555490,0,0,0,0,0,0,220000,188000,32000,32000
20200430,061063,國巨凱基9A購14,1.74,1.74,1.69,1.71,0.00,0.00,7000,3,12050,0,0,0,0,0,0,1000,6000,-5000,-5000
20200430,061064,可成凱基9B購02,1.54,1.54,1.54,1.54,0.00,0.00,10000,1,15400,0,0,0,0,0,0,0,10000,-10000,-10000
20200430,061065,神基凱基9A購01,0.78,0.81,0.78,0.80,+0.02,2.56,156000,7,123390,0,0,0,0,0,0,38000,118000,-80000,-80000
20200430,061066,嘉晶凱基9B購01,0.87,0.96,0.87,0.91,+0.07,8.33,151000,6,135930,0,0,0,0,0,0,0,151000,-151000,-151000
20200430,061067,貿聯凱基9A購03,1.13,1.33,1.13,1.33,+0.26,24.3,216000,23,261720,0,0,0,0,0,0,96000,120000,-24000,-24000
20200430,061068,祥碩凱基9B購01,1.47,1.47,1.25,1.29,-0.09,-6.52,384000,42,532460,0,0,0,0,0,0,308000,110000,198000,198000
20200430,061069,嘉聯益凱基9A購01,1.05,1.09,1.05,1.07,+0.02,1.9,172000,15,184390,0,0,0,0,0,0,147000,50000,97000,97000
20200430,06106P,國巨群益97售02,,,,,0.00,0.00,0,0,0,0,0,0,0,0,0,0,0,0,0
20200430,061070,超眾凱基9C購01,1.44,1.50,1.44,1.50,+0.05,3.45,36000,3,53840,0,0,0,0,0,0,0,36000,-36000,-36000
20200430,061071,復盛凱基9A購01,1.31,1.31,1.26,1.29,-0.01,-0.77,192000,21,247530,0,0,0,0,0,0,29000,153000,-124000,-124000
20200430,061072,南電凱基9B購01,1.45,1.47,1.36,1.36,-0.04,-2.86,80000,14,116230,0,0,0,0,0,0,61000,19000,42000,42000
20200430,061073,T50反1兆豐9A購01,,,,,0.00,0.00,0,0,0,0,0,0,0,0,0,0,0,0,0
20200430,061074,儒鴻兆豐9B購01,1.05,1.11,1.04,1.11,+0.11,11.0,655000,28,695170,0,0,0,0,0,0,390000,265000,125000,125000
20200430,061075,亞德客兆豐9A購01,1.51,1.83,1.47,1.76,+0.28,18.92,309000,32,496200,0,0,0,0,0,0,134000,209000,-75000,-75000
20200430,061076,台達電兆豐9A購01,1.27,1.41,1.24,1.41,+0.17,13.71,749000,34,990650,0,0,0,0,0,0,553000,186000,367000,367000
20200430,061077,國巨兆豐9B購01,1.34,1.34,1.27,1.32,+0.09,7.32,252000,15,329940,0,0,0,0,0,0,33000,219000,-186000,-186000
20200430,061078,台積電兆豐9A購01,1.46,1.46,1.46,1.46,+0.06,4.29,10000,1,14600,0,0,0,0,0,0,0,10000,-10000,-10000
20200430,061079,台積電兆豐9A購02,,,,,0.00,0.00,0,0,0,0,0,0,0,0,0,0,0,0,0
20200430,06107P,美律群益98售02,,,,,0.00,0.00,0,0,0,0,0,0,0,0,0,0,0,0,0
20200430,061080,華邦電兆豐9B購01,1.10,1.17,1.10,1.16,+0.10,9.43,83000,9,94020,0,0,0,0,0,0,44000,73000,-29000,-29000
20200430,061081,宏碁兆豐9A購01,1.05,1.05,0.96,1.01,0.00,0.00,1206000,76,1209860,0,0,0,0,0,0,774000,428000,346000,346000
20200430,061082,台光電兆豐9A購01,1.26,1.35,1.26,1.35,+0.09,7.14,89000,6,115720,0,0,0,0,0,0,15000,74000,-59000,-59000
20200430,061083,京元電兆豐9A購01,1.09,1.11,1.09,1.11,0.00,0.00,81000,7,89590,0,0,0,0,0,0,10000,71000,-61000,-61000
20200430,061084,京元電兆豐9A購02,1.14,1.15,1.14,1.15,+0.03,2.68,65000,4,74530,0,0,0,0,0,0,0,65000,-65000,-65000
20200430,061085,聯茂兆豐9A購01,0.69,0.69,0.65,0.66,-0.02,-2.94,594000,17,403620,0,0,0,0,0,0,357000,237000,120000,120000
20200430,061086,FBVIX統一01購01,1.03,1.03,1.01,1.01,0.00,0.00,41000,4,41430,0,0,0,0,0,0,32000,0,32000,32000
20200430,061087,國巨統一01購04,1.28,1.29,1.24,1.27,+0.06,4.96,367000,32,467080,0,0,0,0,0,0,114000,243000,-129000,-129000
20200430,061088,國巨統一9C購05,1.23,1.24,1.23,1.24,+0.01,0.81,21000,4,25890,0,0,0,0,0,0,16000,5000,11000,11000
20200430,061089,台積電統一9C購04,1.12,1.14,1.12,1.14,+0.04,3.64,48000,3,54160,0,0,0,0,0,0,28000,20000,8000,8000
20200430,06108P,奇力新群益97售05,,,,,0.00,0.00,0,0,0,0,0,0,0,0,0,0,0,0,0
20200430,061090,奇力新統一9C購01,1.03,1.03,1.00,1.00,+0.07,7.53,101000,4,103430,0,0,0,0,0,0,0,101000,-101000,-101000
20200430,061091,奇力新統一9C購02,0.85,0.89,0.84,0.86,+0.04,4.88,629000,21,540460,0,0,0,0,0,0,162000,467000,-305000,-305000
20200430,061092,可成統一9C購02,1.21,1.21,1.14,1.18,-0.01,-0.84,97000,9,114870,0,0,0,0,0,0,42000,55000,-13000,-13000
20200430,061093,華新科統一9B購03,,,,,0.00,0.00,0,0,0,0,0,0,0,0,0,0,0,0,0
20200430,061094,彩晶統一9B購02,0.93,0.97,0.92,0.97,+0.03,3.19,36000,6,34380,0,0,0,0,0,0,6000,30000,-24000,-24000
20200430,061095,台積電台新9B購03,1.10,1.13,1.10,1.13,+0.08,7.62,10000,2,11150,0,0,0,0,0,0,10000,0,10000,10000
20200430,061096,上証2X元大9A購06,,,,,0.00,0.00,0,0,0,0,0,0,0,0,0,0,0,0,0
20200430,061097,上証2X元大9A購07,,,,,0.00,0.00,0,0,0,0,0,0,0,0,0,0,0,0,0
20200430,061098,滬深2X元大9A購06,,,,,0.00,0.00,0,0,0,0,0,0,0,0,0,0,0,0,0
20200430,061099,滬深2X元大9A購07,,,,,0.00,0.00,0,0,0,0,0,0,0,0,0,0,0,0,0
20200430,06109P,華新科群益97售05,3.22,3.22,3.22,3.22,+0.03,0.94,1000,1,3220,0,0,0,0,0,0,1000,0,1000,1000
20200430,061100,SP黃豆元大9A購04,0.68,0.72,0.68,0.71,0.00,0.00,517000,11,355910,0,0,0,0,0,0,406000,111000,295000,295000
20200430,061101,道瓊銀元大9A購02,,,,,0.00,0.00,0,0,0,0,0,0,0,0,0,0,0,0,0
20200430,061102,台積電元大9A購22,1.91,1.94,1.89,1.94,+0.13,7.18,220000,9,420350,0,0,0,0,0,0,150000,70000,80000,80000
20200430,061103,聯發科元大9A購08,4.54,4.64,4.54,4.60,+0.52,12.75,102000,8,466240,0,0,0,0,0,0,71000,102000,-31000,-31000
20200430,061104,華新科元大9A購13,2.51,2.51,2.51,2.51,+0.02,0.8,4000,1,10040,0,0,0,0,0,0,0,4000,-4000,-4000
20200430,061105,宏達電元大9A購04,1.93,1.93,1.88,1.88,-0.05,-2.59,131000,4,248290,0,0,0,0,0,0,50000,81000,-31000,-31000
20200430,061106,群創元大9B購09,1.47,1.51,1.47,1.49,+0.04,2.76,201000,10,299720,0,0,0,0,0,0,0,201000,-201000,-201000
20200430,061107,世芯元大9A購05,3.40,3.81,3.40,3.75,+0.36,10.62,100000,18,351250,0,0,0,0,0,0,46000,61000,-15000,-15000
20200430,061108,臻鼎元大9A購02,1.62,1.73,1.59,1.72,+0.17,10.97,389000,33,635350,0,0,0,0,0,0,154000,215000,-61000,-61000
20200430,061109,臻鼎元大9A購03,1.68,1.81,1.62,1.81,+0.22,13.84,380000,24,639990,0,0,0,0,0,0,193000,187000,6000,6000
20200430,06110P,國巨國泰98售02,,,,,0.00,0.00,0,0,0,0,0,0,0,0,0,0,0,0,0
20200430,061110,超眾元大9A購03,2.29,2.39,2.25,2.29,+0.08,3.62,138000,7,318770,0,0,0,0,0,0,84000,88000,-4000,-4000
20200430,061111,台表科元大9A購02,1.62,1.62,1.57,1.59,0.00,0.00,68000,7,108710,0,0,0,0,0,0,22000,47000,-25000,-25000
20200430,061112,台表科元大9A購03,2.13,2.14,2.12,2.14,+0.03,1.42,53000,5,113070,0,0,0,0,0,0,7000,48000,-41000,-41000
20200430,061113,南電元大9A購03,2.81,2.81,2.56,2.64,0.00,0.00,216000,22,600130,0,0,0,0,0,0,208000,8000,200000,200000
20200430,061114,南電元大9A購04,2.06,2.06,1.89,1.95,-0.01,-0.51,566000,29,1119230,0,0,0,0,0,0,481000,85000,396000,396000
20200430,061115,電子類元大9A購02,3.17,3.17,3.17,3.17,+0.07,2.26,1000,1,3170,0,0,0,0,0,0,1000,0,1000,1000
20200430,061116,金融類元大9A購02,1.55,1.55,1.55,1.55,+0.06,4.03,10000,1,15500,0,0,0,0,0,0,0,10000,-10000,-10000
20200430,061117,美律國泰9C購01,1.88,2.06,1.88,2.02,+0.17,9.19,316000,15,624240,0,0,0,0,0,0,123000,304000,-181000,-181000
20200430,061118,GIS富邦9A購01,0.89,0.91,0.87,0.90,+0.02,2.27,1453000,78,1302200,0,0,0,0,0,0,1257000,149000,1108000,1108000
20200430,061119,國巨永豐9A購03,1.28,1.28,1.27,1.27,+0.07,5.83,51000,2,64780,0,0,0,0,0,0,0,51000,-51000,-51000
20200430,06111P,上銀兆豐98售01,,,,,0.00,0.00,0,0,0,0,0,0,0,0,0,0,0,0,0
20200430,061120,台積電永豐9A購03,1.36,1.37,1.36,1.37,+0.07,5.38,21000,2,28760,0,0,0,0,0,0,21000,0,21000,21000
20200430,061121,智邦永豐9A購02,1.50,1.59,1.43,1.43,-0.13,-8.33,225000,18,342560,0,0,0,0,0,0,213000,18000,195000,195000
20200430,061122,敬鵬永豐9A購01,1.03,1.08,1.03,1.08,+0.02,1.89,94000,6,98950,0,0,0,0,0,0,60000,34000,26000,26000
20200430,061123,燿華永豐9A購01,0.89,0.95,0.89,0.93,0.00,0.00,807000,15,751730,0,0,0,0,0,0,807000,0,807000,807000
20200430,061124,微星永豐9A購02,0.89,0.89,0.89,0.89,0.00,0.00,22000,2,19580,0,0,0,0,0,0,0,22000,-22000,-22000
20200430,061125,億光永豐9A購01,1.35,1.37,1.31,1.31,-0.01,-0.76,246000,12,330000,0,0,0,0,0,0,90000,156000,-66000,-66000
20200430,061126,京元電永豐9A購02,0.87,0.87,0.86,0.86,-0.01,-1.15,30000,2,26000,0,0,0,0,0,0,30000,0,30000,30000
20200430,061127,美食永豐9A購01,1.06,1.29,1.04,1.28,+0.24,23.08,1261000,43,1503070,0,0,0,0,0,0,1020000,70000,950000,950000
20200430,061128,大立光永豐9A購02,1.40,1.50,1.40,1.50,+0.12,8.7,71000,6,100510,0,0,0,0,0,0,66000,5000,61000,61000
20200430,061129,文曄永豐9A購01,0.94,0.96,0.93,0.96,+0.02,2.13,168000,12,158610,0,0,0,0,0,0,168000,0,168000,168000
20200430,06112P,台積電兆豐97售01,,,,,0.00,0.00,0,0,0,0,0,0,0,0,0,0,0,0,0
20200430,061130,牧德永豐9A購04,1.19,1.25,1.19,1.24,+0.12,10.71,278000,16,337100,0,0,0,0,0,0,1000,278000,-277000,-277000
20200430,061131,崇越永豐9A購01,0.95,1.01,0.95,1.01,+0.05,5.21,362000,9,356580,0,0,0,0,0,0,294000,0,294000,294000
20200430,061132,志超永豐9A購01,1.17,1.19,1.14,1.19,-0.01,-0.83,603000,24,696150,0,0,0,0,0,0,590000,13000,577000,577000
20200430,061133,玉晶光第一9A購01,1.03,1.03,1.03,1.03,0.00,0.00,10000,1,10300,0,0,0,0,0,0,0,10000,-10000,-10000
20200430,061134,大成鋼統一9C購01,0.89,0.91,0.88,0.91,0.00,0.00,321000,12,285610,0,0,0,0,0,0,321000,33000,288000,288000
20200430,061135,聯發科統一9C購03,1.10,1.21,1.10,1.21,+0.14,13.08,279000,11,327530,0,0,0,0,0,0,61000,204000,-143000,-143000
20200430,061136,可成統一9A購01,,,,,0.00,0.00,0,0,0,0,0,0,0,0,0,0,0,0,0
20200430,061137,晶技統一9B購01,0.84,0.89,0.83,0.83,-0.01,-1.19,424000,29,362560,0,0,0,0,0,0,64000,360000,-296000,-296000
20200430,061138,晶技統一9C購01,0.85,0.90,0.85,0.85,+0.01,1.19,261000,14,227850,0,0,0,0,0,0,0,261000,-261000,-261000
20200430,061139,玉晶光統一9C購02,1.05,1.10,1.05,1.10,0.00,0.00,31000,2,34050,0,0,0,0,0,0,1000,31000,-30000,-30000
20200430,06113P,台積電群益97售01,,,,,0.00,0.00,0,0,0,0,0,0,0,0,0,0,0,0,0
20200430,061140,華擎統一9C購01,0.89,0.89,0.79,0.79,+0.04,5.33,12000,2,9680,0,0,0,0,0,0,0,12000,-12000,-12000
20200430,061141,臻鼎統一9A購01,0.87,1.00,0.87,1.00,+0.21,26.58,223000,10,207380,0,0,0,0,0,0,10000,213000,-203000,-203000
20200430,061142,南電統一9A購01,1.14,1.15,1.04,1.04,-0.04,-3.7,1251000,24,1336770,25000,0,25000,0,0,0,1211000,97000,1114000,1139000
20200430,061143,道瓊指中信9C購04,0.80,0.80,0.80,0.80,+0.04,5.26,15000,1,12000,0,0,0,0,0,0,0,15000,-15000,-15000
20200430,061144,玉晶光中信9B購02,0.65,0.70,0.65,0.67,+0.06,9.84,149000,6,98250,0,0,0,0,0,0,0,149000,-149000,-149000
20200430,061145,臻鼎中信9A購02,0.71,0.78,0.69,0.75,+0.06,8.7,682000,21,480690,0,0,0,0,0,0,355000,242000,113000,113000
20200430,061146,台表科中信9A購02,0.81,0.81,0.81,0.81,0.00,0.00,60000,1,48600,0,0,0,0,0,0,0,60000,-60000,-60000
20200430,061147,上証2X群益9C購06,3.61,3.61,3.61,3.61,0.00,0.00,14000,1,50540,0,0,0,0,0,0,0,14000,-14000,-14000
20200430,061148,道瓊反群益9A購02,,,,,0.00,0.00,0,0,0,0,0,0,0,0,0,0,0,0,0
20200430,061149,華通群益9A購05,2.04,2.29,2.03,2.22,+0.21,10.45,265000,15,565140,0,0,0,0,0,0,128000,150000,-22000,-22000
20200430,06114P,台積電統一97售03,,,,,0.00,0.00,0,0,0,0,0,0,0,0,0,0,0,0,0
20200430,061150,國巨群益9A購09,2.74,2.79,2.73,2.75,+0.20,7.84,94000,16,259360,0,0,0,0,0,0,60000,82000,-22000,-22000
20200430,061151,友訊群益9A購01,1.71,1.82,1.69,1.69,-0.10,-5.59,376000,16,651900,0,0,0,0,0,0,205000,121000,84000,84000
20200430,061152,微星群益9A購01,2.05,2.05,1.98,2.02,-0.02,-0.98,288000,7,578280,0,0,0,0,0,0,88000,200000,-112000,-112000
20200430,061153,奇力新群益9A購02,1.81,1.88,1.81,1.81,+0.09,5.23,368000,9,681450,0,0,0,0,0,0,197000,207000,-10000,-10000
20200430,061154,可成群益9B購04,,,,,0.00,0.00,0,0,0,0,0,0,0,0,0,0,0,0,0
20200430,061155,華新科群益9A購06,2.65,2.70,2.59,2.62,+0.05,1.95,113000,5,299270,0,0,0,0,0,0,84000,29000,55000,55000
20200430,061156,玉晶光群益9A購07,1.71,1.86,1.71,1.84,+0.19,11.52,256000,10,460210,0,0,0,0,0,0,94000,162000,-68000,-68000
20200430,061157,聯鈞群益9A購02,,,,,0.00,0.00,0,0,0,0,0,0,0,0,0,0,0,0,0
20200430,061158,世芯群益9A購02,2.97,3.29,2.97,3.27,+0.51,18.48,99000,5,315860,0,0,0,0,0,0,99000,98000,1000,1000
20200430,061159,同欣電群益9A購01,1.04,1.20,1.04,1.20,+0.19,18.81,1011000,42,1132150,0,0,0,0,0,0,137000,901000,-764000,-764000
20200430,06115P,台積電統一97售04,,,,,0.00,0.00,0,0,0,0,0,0,0,0,0,0,0,0,0
20200430,061160,瑞祺群益9A購01,1.64,1.64,1.53,1.58,+0.01,0.64,185000,28,292760,0,0,0,0,0,0,142000,73000,69000,69000
20200430,061161,南六群益9A購01,2.66,2.76,2.54,2.76,0.00,0.00,19000,5,51200,0,0,0,0,0,0,7000,12000,-5000,-5000
20200430,061162,南電群益9A購02,2.19,2.19,1.99,2.04,-0.02,-0.97,188000,13,400920,0,0,0,0,0,0,172000,16000,156000,156000
20200430,061163,台灣50兆豐9A購04,,,,,0.00,0.00,0,0,0,0,0,0,0,0,0,0,0,0,0
20200430,061164,燿華兆豐9B購01,1.01,1.09,1.01,1.08,+0.06,5.88,1227000,48,1303180,0,0,0,0,0,0,306000,901000,-595000,-595000
20200430,061165,美律兆豐9A購01,1.15,1.19,1.15,1.19,0.00,0.00,29000,2,33910,0,0,0,0,0,0,0,29000,-29000,-29000
20200430,061166,玉晶光兆豐9B購01,1.13,1.26,1.13,1.25,+0.17,15.74,189000,26,228870,0,0,0,0,0,0,32000,156000,-124000,-124000
20200430,061167,臻鼎兆豐9B購01,1.23,1.30,1.19,1.30,+0.12,10.17,169000,17,205910,0,0,0,0,0,0,80000,89000,-9000,-9000
20200430,061168,力成兆豐9A購01,1.21,1.31,1.21,1.25,+0.07,5.93,572000,40,714200,0,0,0,0,0,0,166000,378000,-212000,-212000
20200430,061169,GIS兆豐9A購01,1.66,1.68,1.62,1.64,-0.01,-0.61,573000,22,946830,0,0,0,0,0,0,463000,110000,353000,353000
20200430,06116P,臺股指日盛97售01,,,,,0.00,0.00,0,0,0,0,0,0,0,0,0,0,0,0,0
20200430,061170,南茂兆豐9B購01,1.12,1.14,1.10,1.14,0.00,0.00,167000,10,186160,0,0,0,0,0,0,1000,157000,-156000,-156000
20200430,061171,大立光麥證9A購01,1.63,1.63,1.63,1.63,+0.03,1.88,6000,3,9780,6000,0,6000,0,0,0,6000,0,6000,6000
20200430,061172,大立光麥證9A購02,2.74,2.74,2.73,2.74,+0.05,1.86,4000,4,10950,4000,0,4000,0,0,0,4000,0,4000,4000
20200430,061173,T50反1凱基04購01,1.01,1.01,0.99,0.99,-0.07,-6.6,215000,5,214000,0,0,0,0,0,0,0,215000,-215000,-215000
20200430,061174,鴻海凱基9A購23,2.74,2.88,2.72,2.88,+0.12,4.35,176000,7,482860,0,0,0,0,0,0,166000,24000,142000,142000
20200430,061175,台積電凱基9A購19,,,,,0.00,0.00,0,0,0,0,0,0,0,0,0,0,0,0,0
20200430,061176,聯發科凱基9A購14,4.80,5.00,4.80,5.00,+0.70,16.28,20000,4,97850,0,0,0,0,0,0,5000,5000,0,0
20200430,061177,大立光凱基9A購10,3.36,3.42,3.36,3.42,+0.16,4.91,55000,3,186900,0,0,0,0,0,0,55000,0,55000,55000
20200430,061178,晶技凱基9B購01,1.53,1.59,1.53,1.55,+0.07,4.73,96000,7,151280,0,0,0,0,0,0,20000,76000,-56000,-56000
20200430,061179,華擎凱基9A購01,1.15,1.15,1.11,1.11,+0.05,4.72,40000,3,45200,0,0,0,0,0,0,0,40000,-40000,-40000
20200430,06117P,臺股指日盛97售02,,,,,0.00,0.00,0,0,0,0,0,0,0,0,0,0,0,0,0
20200430,061180,華擎凱基9B購01,1.48,1.48,1.48,1.48,+0.02,1.37,30000,1,44400,0,0,0,0,0,0,30000,0,30000,30000
20200430,061181,牧德凱基9A購01,1.16,1.21,1.16,1.17,+0.08,7.34,570000,29,674890,0,0,0,0,0,0,77000,570000,-493000,-493000
20200430,061182,南六凱基9A購01,1.68,1.73,1.61,1.68,-0.15,-8.2,173000,16,291890,0,0,0,0,0,0,83000,90000,-7000,-7000
20200430,061183,友達國泰9B購02,1.58,1.59,1.56,1.56,+0.02,1.3,194000,8,305430,0,0,0,0,0,0,47000,147000,-100000,-100000
20200430,061184,大立光國泰9C購01,1.71,1.85,1.71,1.85,+0.21,12.8,328000,28,586040,0,0,0,0,0,0,61000,268000,-207000,-207000
20200430,061185,嘉晶國泰9B購01,1.55,1.70,1.55,1.61,+0.09,5.92,327000,15,533410,0,0,0,0,0,0,0,327000,-327000,-327000
20200430,061186,牧德國泰9C購01,1.75,1.83,1.71,1.78,+0.11,6.59,1057000,41,1878920,0,0,0,0,0,0,233000,829000,-596000,-596000
20200430,061187,瀚宇博國泰9C購01,1.71,1.74,1.70,1.74,+0.04,2.35,610000,21,1052020,0,0,0,0,0,0,78000,582000,-504000,-504000
20200430,061188,大成鋼富邦9B購01,0.76,0.79,0.75,0.78,+0.04,5.41,1922000,52,1484680,0,0,0,0,0,0,555000,1345000,-790000,-790000
20200430,061189,可成富邦9B購02,0.67,0.67,0.63,0.66,0.00,0.00,132000,3,87480,0,0,0,0,0,0,56000,76000,-20000,-20000
20200430,06118P,上証2X凱基98售03,2.69,2.69,2.69,2.69,-0.25,-8.5,60000,3,161400,0,0,0,0,0,0,60000,60000,0,0
20200430,061190,力山永豐9A購02,2.26,2.42,2.10,2.10,+0.01,0.48,658000,28,1477400,0,0,0,0,0,0,613000,38000,575000,575000
20200430,061191,可成永豐9A購02,1.07,1.07,1.07,1.07,+0.03,2.88,68000,1,72760,0,0,0,0,0,0,68000,0,68000,68000
20200430,061192,奇鋐永豐9A購01,1.39,1.48,1.36,1.44,+0.10,7.46,92000,12,130230,0,0,0,0,0,0,46000,46000,0,0
20200430,061193,玉晶光永豐9B購02,1.95,2.14,1.95,2.11,+0.15,7.65,382000,17,774290,0,0,0,0,0,0,290000,93000,197000,197000
20200430,061194,聯鈞永豐9A購02,0.99,0.99,0.97,0.97,-0.05,-4.9,8000,2,7820,0,0,0,0,0,0,8000,0,8000,8000
20200430,061195,健策永豐9B購02,1.06,1.09,1.06,1.09,+0.06,5.83,189000,9,200520,0,0,0,0,0,0,65000,130000,-65000,-65000
20200430,061196,世芯永豐9A購06,1.66,1.92,1.66,1.87,+0.28,17.61,237000,28,428120,0,0,0,0,0,0,49000,188000,-139000,-139000
20200430,061197,矽創永豐9A購02,1.02,1.04,1.00,1.04,+0.08,8.33,311000,13,317570,0,0,0,0,0,0,67000,294000,-227000,-227000
20200430,061198,世紀鋼永豐9A購03,1.89,1.89,1.89,1.89,0.00,0.00,10000,1,18900,0,0,0,0,0,0,0,10000,-10000,-10000
20200430,061199,道瓊反元大9A購05,1.15,1.15,1.15,1.15,-0.06,-4.96,20000,1,23000,0,0,0,0,0,0,20000,0,20000,20000
20200430,06119P,大立光凱基98售04,,,,,0.00,0.00,0,0,0,0,0,0,0,0,0,0,0,0,0
20200430,061200,道瓊反元大9A購06,1.17,1.17,1.13,1.13,-0.10,-8.13,153000,5,174610,0,0,0,0,0,0,3000,150000,-147000,-147000
20200430,061201,FBVIX元大01購03,1.28,1.28,1.28,1.28,-0.11,-7.91,5000,1,6400,0,0,0,0,0,0,5000,0,5000,5000
20200430,061202,和大元大9A購02,1.96,2.37,1.96,2.30,+0.52,29.21,246000,23,523650,0,0,0,0,0,0,50000,196000,-146000,-146000
20200430,061203,國巨元大9A購15,2.30,2.36,2.30,2.30,+0.04,1.77,60000,5,140000,0,0,0,0,0,0,60000,0,60000,60000
20200430,061204,國巨元大9A購16,4.19,4.34,4.19,4.25,+0.20,4.94,39000,9,165810,0,0,0,0,0,0,15000,24000,-9000,-9000
20200430,061205,旺宏元大9A購11,2.70,2.70,2.57,2.59,+0.19,7.92,94000,13,246280,0,0,0,0,0,0,94000,79000,15000,15000
20200430,061206,旺宏元大9A購12,3.18,3.18,3.01,3.02,+0.24,8.63,222000,47,688290,0,0,0,0,0,0,217000,182000,35000,35000
20200430,061207,美律元大9A購04,2.17,2.39,2.12,2.30,+0.20,9.52,163000,19,367260,0,0,0,0,0,0,81000,138000,-57000,-57000
20200430,061208,聯發科元大9A購09,2.32,2.41,2.28,2.41,+0.31,14.76,667000,29,1536180,0,0,0,0,0,0,573000,667000,-94000,-94000
20200430,061209,聯發科元大9A購10,4.34,4.59,4.29,4.59,+0.66,16.79,59000,15,260450,0,0,0,0,0,0,22000,39000,-17000,-17000
20200430,06120P,大立光凱基98售05,7.75,7.75,7.60,7.60,0.00,0.00,13000,2,100300,0,0,0,0,0,0,0,13000,-13000,-13000
20200430,061210,玉山金元大9A購02,2.24,2.32,2.24,2.32,+0.13,5.94,353000,30,804980,0,0,0,0,0,0,100000,260000,-160000,-160000
20200430,061211,玉晶光元大9A購12,,,,,0.00,0.00,0,0,0,0,0,0,0,0,0,0,0,0,0
20200430,061212,聯鈞元大9A購04,2.29,2.29,2.13,2.13,-0.09,-4.05,35000,4,77900,0,0,0,0,0,0,15000,20000,-5000,-5000
20200430,061213,群創元大9A購05,1.44,1.46,1.44,1.46,+0.09,6.57,106000,9,154010,0,0,0,0,0,0,0,106000,-106000,-106000
20200430,061214,華擎元大9A購04,1.41,1.41,1.34,1.34,-0.01,-0.74,133000,6,181140,0,0,0,0,0,0,56000,77000,-21000,-21000
20200430,061215,健策元大9A購06,1.58,1.64,1.52,1.59,+0.07,4.61,252000,18,397210,0,0,0,0,0,0,234000,131000,103000,103000
20200430,061216,世芯元大9A購06,3.27,3.71,3.27,3.60,+0.43,13.56,175000,27,602560,0,0,0,0,0,0,111000,81000,30000,30000
20200430,061217,臺股指元大9A購54,,,,,0.00,0.00,0,0,0,0,0,0,0,0,0,0,0,0,0
20200430,061218,臺股指元大9A購55,1.51,1.59,1.51,1.59,+0.12,8.16,25000,5,38720,0,0,0,0,0,0,20000,5000,15000,15000
20200430,061219,臺股指元大9A購56,,,,,0.00,0.00,0,0,0,0,0,0,0,0,0,0,0,0,0
20200430,06121P,同欣電凱基97售02,0.30,0.30,0.25,0.25,-0.07,-21.88,30000,2,8000,0,0,0,0,0,0,30000,0,30000,30000
20200430,061220,臺股指元大9A購57,,,,,0.00,0.00,0,0,0,0,0,0,0,0,0,0,0,0,0
20200430,061221,臺股指元大9A購58,,,,,0.00,0.00,0,0,0,0,0,0,0,0,0,0,0,0,0
20200430,061222,台灣50中信9A購02,,,,,0.00,0.00,0,0,0,0,0,0,0,0,0,0,0,0,0
20200430,061223,T50反1中信01購01,1.08,1.08,1.03,1.03,-0.10,-8.85,125000,4,130400,0,0,0,0,0,0,0,125000,-125000,-125000
20200430,061224,道瓊反中信01購01,1.18,1.18,1.18,1.18,-0.04,-3.28,18000,1,21240,0,0,0,0,0,0,0,18000,-18000,-18000
20200430,061225,台積電中信9A購04,,,,,0.00,0.00,0,0,0,0,0,0,0,0,0,0,0,0,0
20200430,061226,台積電中信9A購05,,,,,0.00,0.00,0,0,0,0,0,0,0,0,0,0,0,0,0
20200430,061227,日月光中信9B購01,1.31,1.42,1.31,1.42,+0.13,10.08,731000,29,989710,0,0,0,0,0,0,180000,550000,-370000,-370000
20200430,061228,聯茂中信9A購01,0.81,0.83,0.81,0.83,-0.03,-3.49,77000,3,62570,0,0,0,0,0,0,0,77000,-77000,-77000
20200430,061229,緯穎中信9B購01,0.77,0.95,0.77,0.95,+0.23,31.94,145000,12,115420,0,0,0,0,0,0,100000,45000,55000,55000
20200430,06122P,亞光元大98售01,,,,,0.00,0.00,0,0,0,0,0,0,0,0,0,0,0,0,0
20200430,061230,臺指反元大01購04,1.07,1.07,1.07,1.07,-0.04,-3.6,20000,1,21400,0,0,0,0,0,0,20000,0,20000,20000
20200430,061231,聚陽元大9A購02,1.32,1.41,1.32,1.39,+0.08,6.11,673000,43,920370,0,0,0,0,0,0,276000,378000,-102000,-102000
20200430,061232,和大元大9A購03,2.36,2.76,2.35,2.75,+0.60,27.91,265000,15,674520,0,0,0,0,0,0,105000,160000,-55000,-55000
20200430,061233,國巨元大9A購17,1.26,1.28,1.26,1.28,+0.06,4.92,121000,8,153850,0,0,0,0,0,0,85000,26000,59000,59000
20200430,061234,國巨元大9A購18,3.07,3.16,3.07,3.09,+0.17,5.82,29000,13,90420,0,0,0,0,0,0,8000,20000,-12000,-12000
20200430,061235,台積電元大9A購23,0.99,1.01,0.99,1.01,+0.06,6.32,143000,5,143390,0,0,0,0,0,0,100000,43000,57000,57000
20200430,061236,台積電元大9A購24,2.91,2.94,2.91,2.94,+0.21,7.69,91000,2,266310,0,0,0,0,0,0,50000,41000,9000,9000
20200430,061237,晶技元大9A購01,2.06,2.18,2.02,2.06,+0.01,0.49,185000,14,384600,0,0,0,0,0,0,123000,62000,61000,61000
20200430,061238,晶技元大9A購02,1.71,1.76,1.68,1.68,+0.01,0.6,186000,13,317950,0,2000,-2000,0,0,0,36000,148000,-112000,-114000
20200430,061239,聯發科兆豐9A購01,2.21,2.25,2.21,2.25,0.00,0.00,40000,2,88920,0,0,0,0,0,0,0,40000,-40000,-40000
20200430,06123P,玉晶光元大97售04,1.52,1.52,1.42,1.42,-0.18,-11.25,220000,12,323350,0,0,0,0,0,0,77000,143000,-66000,-66000
20200430,061240,華新科兆豐9A購01,1.62,1.65,1.56,1.56,-0.01,-0.64,112000,5,177170,0,0,0,0,0,0,24000,88000,-64000,-64000
20200430,061241,晶技兆豐9A購01,1.42,1.47,1.38,1.39,0.00,0.00,52000,10,73510,0,0,0,0,0,0,28000,19000,9000,9000
20200430,061242,玉晶光兆豐9B購02,1.08,1.18,1.08,1.16,+0.16,16.0,66000,16,73410,0,0,0,0,0,0,19000,46000,-27000,-27000
20200430,061243,麗豐兆豐9A購01,1.35,1.39,1.35,1.39,+0.11,8.59,84000,6,114380,0,0,0,0,0,0,59000,25000,34000,34000
20200430,061244,和碩兆豐9A購01,1.12,1.15,1.12,1.12,-0.04,-3.45,895000,34,1014630,0,0,0,0,0,0,429000,421000,8000,8000
20200430,061245,晶技群益9A購01,1.67,1.75,1.67,1.75,+0.10,6.06,192000,9,332290,0,0,0,0,0,0,0,192000,-192000,-192000
20200430,061246,玉晶光群益9A購08,3.13,3.56,3.13,3.56,+0.54,17.88,168000,45,550830,0,0,0,0,0,0,112000,105000,7000,7000
20200430,061247,玉晶光群益9A購09,2.08,2.42,2.08,2.42,+0.35,16.91,259000,28,574520,0,0,0,0,0,0,176000,97000,79000,79000
20200430,061248,健策群益9A購03,1.01,1.06,0.99,1.04,+0.05,5.05,764000,16,776380,0,0,0,0,0,0,616000,258000,358000,358000
20200430,061249,億豐群益9A購01,1.89,2.05,1.89,2.05,+0.02,0.99,364000,11,729050,0,0,0,0,0,0,257000,107000,150000,150000
20200430,06124P,超眾元大97售03,,,,,0.00,0.00,0,0,0,0,0,0,0,0,0,0,0,0,0
20200430,061250,臺股指群益9A購01,3.55,3.67,3.55,3.67,+0.44,13.62,2000,2,7220,0,0,0,0,0,0,1000,1000,0,0
20200430,061251,臺股指群益9A購02,4.08,4.08,4.08,4.08,0.00,0.00,1000,1,4080,0,0,0,0,0,0,0,1000,-1000,-1000
20200430,061252,臺股指群益9A購03,3.24,3.24,3.24,3.24,+0.50,18.25,2000,1,6480,0,0,0,0,0,0,2000,0,2000,2000
20200430,061253,臺股指群益9A購04,2.47,2.53,2.47,2.53,0.00,0.00,9000,2,22710,0,0,0,0,0,0,0,9000,-9000,-9000
20200430,061254,道瓊反凱基9A購02,,,,,0.00,0.00,0,0,0,0,0,0,0,0,0,0,0,0,0
20200430,061255,道瓊反凱基9C購01,,,,,0.00,0.00,0,0,0,0,0,0,0,0,0,0,0,0,0
20200430,061256,亞德客凱基9B購01,1.43,1.53,1.40,1.53,+0.22,16.79,81000,15,118320,0,0,0,0,0,0,26000,58000,-32000,-32000
20200430,061257,上銀凱基9A購06,1.49,1.78,1.49,1.77,+0.37,26.43,174000,12,290960,0,0,0,0,0,0,1000,173000,-172000,-172000
20200430,061258,華通凱基9A購06,1.40,1.50,1.40,1.50,+0.16,11.94,123000,7,180700,0,0,0,0,0,0,123000,13000,110000,110000
20200430,061259,台積電凱基9A購21,,,,,0.00,0.00,0,0,0,0,0,0,0,0,0,0,0,0,0
20200430,06125P,楠梓電元富99售01,,,,,0.00,0.00,0,0,0,0,0,0,0,0,0,0,0,0,0
20200430,061260,台積電凱基9A購23,0.90,0.90,0.90,0.90,0.00,0.00,50000,1,45000,0,0,0,0,0,0,0,50000,-50000,-50000
20200430,061261,台積電凱基9B購03,1.06,1.06,1.06,1.06,+0.04,3.92,5000,1,5300,0,0,0,0,0,0,5000,0,5000,5000
20200430,061262,智邦凱基9A購02,1.47,1.53,1.35,1.35,-0.12,-8.16,81000,21,116510,0,0,0,0,0,0,58000,23000,35000,35000
20200430,061263,微星凱基9A購01,1.00,1.02,1.00,1.02,+0.03,3.03,59000,2,59980,0,0,0,0,0,0,0,59000,-59000,-59000
20200430,061264,全新凱基9B購01,0.88,0.90,0.85,0.86,-0.03,-3.37,315000,14,277050,0,0,0,0,0,0,295000,20000,275000,275000
20200430,061265,富邦金凱基9B購01,1.41,1.49,1.40,1.49,+0.12,8.76,463000,42,664010,0,0,0,0,0,0,82000,421000,-339000,-339000
20200430,061266,國泰金凱基9B購01,1.58,1.63,1.58,1.63,0.00,0.00,87000,13,139220,0,0,0,0,0,0,0,87000,-87000,-87000
20200430,061267,玉山金凱基9B購01,1.03,1.05,1.03,1.04,+0.04,4.0,217000,18,224400,0,0,0,0,0,0,80000,139000,-59000,-59000
20200430,061268,玉晶光凱基9B購04,,,,,0.00,0.00,0,0,0,0,0,0,0,0,0,0,0,0,0
20200430,061269,嘉澤凱基9A購01,1.03,1.14,1.01,1.12,+0.09,8.74,1032000,37,1111900,0,0,0,0,0,0,345000,687000,-342000,-342000
20200430,06126P,凌陽元富97售02,,,,,0.00,0.00,0,0,0,0,0,0,0,0,0,0,0,0,0
20200430,061270,彩晶凱基9A購02,1.08,1.13,1.08,1.13,+0.04,3.67,156000,8,171640,0,0,0,0,0,0,60000,116000,-56000,-56000
20200430,061271,聯茂凱基9A購04,,,,,0.00,0.00,0,0,0,0,0,0,0,0,0,0,0,0,0
20200430,061272,超眾凱基9A購03,,,,,0.00,0.00,0,0,0,0,0,0,0,0,0,0,0,0,0
20200430,061273,臺股指凱基9A購23,3.06,3.42,3.01,3.42,+0.54,18.75,304000,22,939000,0,0,0,0,0,0,141000,163000,-22000,-22000
20200430,061274,臺股指凱基9A購24,2.80,3.00,2.70,3.00,+0.52,20.97,122000,5,339110,0,0,0,0,0,0,10000,112000,-102000,-102000
20200430,061275,臺股指凱基9A購25,2.55,2.93,2.51,2.92,+0.59,25.32,173000,14,470680,0,0,0,0,0,0,73000,100000,-27000,-27000
20200430,061276,T50反1台新9A購03,0.24,0.24,0.24,0.24,0.00,0.00,30000,3,7200,0,0,0,0,0,0,0,30000,-30000,-30000
20200430,061277,智邦台新9A購01,2.43,2.46,2.41,2.43,-0.27,-10.0,76000,7,186080,0,0,0,0,0,0,50000,26000,24000,24000
20200430,061278,和大統一9A購01,1.12,1.34,1.12,1.33,+0.31,30.39,868000,25,1074890,0,0,0,0,0,0,290000,673000,-383000,-383000
20200430,061279,鴻海統一9C購04,1.09,1.12,1.08,1.12,+0.04,3.7,252000,14,272860,0,0,0,0,0,0,19000,252000,-233000,-233000
20200430,06127P,泰碩元富97售01,,,,,0.00,0.00,0,0,0,0,0,0,0,0,0,0,0,0,0
20200430,061280,國巨統一9C購06,1.50,1.50,1.47,1.48,0.00,0.00,69000,7,102360,0,0,0,0,0,0,0,69000,-69000,-69000
20200430,061281,台積電統一9C購05,0.86,0.89,0.86,0.89,+0.07,8.54,569000,65,493580,0,0,0,0,0,0,347000,222000,125000,125000
20200430,061282,台積電統一9C購06,,,,,0.00,0.00,0,0,0,0,0,0,0,0,0,0,0,0,0
20200430,061283,智邦統一9A購01,1.26,1.32,1.17,1.18,-0.09,-7.09,627000,45,763320,0,0,0,0,0,0,105000,490000,-385000,-385000
20200430,061284,友達統一9C購01,1.15,1.17,1.14,1.15,0.00,0.00,946000,11,1086050,0,0,0,0,0,0,443000,463000,-20000,-20000
20200430,061285,大立光統一9A購04,1.03,1.03,1.03,1.03,0.00,0.00,29000,1,29870,0,0,0,0,0,0,0,29000,-29000,-29000
20200430,061286,大立光統一9A購05,2.94,3.23,2.94,3.23,+0.51,18.75,240000,21,751890,0,0,0,0,0,0,41000,199000,-158000,-158000
20200430,061287,大立光統一9B購06,0.89,0.96,0.89,0.96,+0.09,10.34,466000,8,438350,0,0,0,0,0,0,461000,0,461000,461000
20200430,061288,大立光統一9C購01,0.92,0.93,0.92,0.93,0.00,0.00,25000,2,23150,0,0,0,0,0,0,0,25000,-25000,-25000
20200430,061289,玉晶光統一01購03,1.23,1.31,1.23,1.28,+0.06,4.92,150000,11,190540,0,0,0,0,0,0,56000,97000,-41000,-41000
20200430,06128P,玉晶光元富97售05,,,,,0.00,0.00,0,0,0,0,0,0,0,0,0,0,0,0,0
20200430,061290,玉晶光統一01購04,1.04,1.11,1.04,1.11,0.00,0.00,51000,3,55640,0,0,0,0,0,0,1000,51000,-50000,-50000
20200430,061291,玉晶光統一01購05,1.22,1.29,1.22,1.28,+0.07,5.79,360000,9,448090,0,0,0,0,0,0,348000,15000,333000,333000
20200430,061292,玉晶光統一01購06,1.50,1.61,1.50,1.61,+0.18,12.59,304000,8,476280,0,0,0,0,0,0,9000,296000,-287000,-287000
20200430,061293,聯茂統一9A購01,0.94,0.94,0.93,0.93,-0.01,-1.06,53000,3,49390,0,0,0,0,0,0,53000,0,53000,53000
20200430,061294,奇力新麥證9A購01,1.61,1.61,1.61,1.61,-0.01,-0.62,10000,1,16100,0,10000,-10000,0,0,0,0,10000,-10000,-10000
20200430,061295,台積電國泰9B購02,2.66,2.74,2.66,2.72,+0.23,9.24,191000,12,513270,0,0,0,0,0,0,57000,135000,-78000,-78000
20200430,061296,台積電國泰9C購01,2.25,2.36,2.25,2.36,+0.11,4.89,289000,16,667820,0,0,0,0,0,0,125000,165000,-40000,-40000
20200430,061297,台積電富邦9C購09,0.49,0.51,0.49,0.51,+0.04,8.51,178000,11,89560,0,0,0,0,0,0,1000,177000,-176000,-176000
20200430,061298,華新科富邦01購02,1.02,1.02,0.98,0.98,+0.01,1.03,9000,5,8980,0,0,0,0,0,0,0,9000,-9000,-9000
20200430,061299,臺股指富邦9A購01,,,,,0.00,0.00,0,0,0,0,0,0,0,0,0,0,0,0,0
20200430,06129P,玉晶光元富97售06,,,,,0.00,0.00,0,0,0,0,0,0,0,0,0,0,0,0,0
20200430,061300,臺股指富邦9A購02,1.29,1.29,1.29,1.29,0.00,0.00,10000,1,12900,0,0,0,0,0,0,10000,0,10000,10000
20200430,061301,華新科永豐9A購03,1.30,1.32,1.24,1.28,-0.02,-1.54,233000,13,292740,0,0,0,0,0,0,58000,170000,-112000,-112000
20200430,061302,晶技永豐9A購04,1.05,1.11,1.04,1.04,+0.01,0.97,231000,12,247170,0,0,0,0,0,0,0,231000,-231000,-231000
20200430,061303,玉晶光永豐9B購03,1.15,1.23,1.15,1.23,+0.09,7.89,59000,8,70560,0,0,0,0,0,0,27000,36000,-9000,-9000
20200430,061304,創意永豐9A購02,0.87,0.90,0.87,0.90,+0.02,2.27,93000,7,82270,0,0,0,0,0,0,17000,76000,-59000,-59000
20200430,061305,帆宣永豐9A購01,0.98,1.15,0.97,1.14,+0.11,10.68,575000,36,601860,0,0,0,0,0,0,149000,428000,-279000,-279000
20200430,061306,瑞祺永豐9A購02,0.94,0.96,0.92,0.95,+0.01,1.06,165000,7,155500,0,0,0,0,0,0,20000,120000,-100000,-100000
20200430,061307,和潤永豐9A購02,1.17,1.17,1.12,1.12,-0.03,-2.61,135000,9,154310,0,0,0,0,0,0,71000,64000,7000,7000
20200430,061308,元金2X中信9A購01,0.92,0.92,0.90,0.91,-0.03,-3.19,50000,4,45500,0,0,0,0,0,0,0,50000,-50000,-50000
20200430,061309,鴻海統一9C購05,0.86,0.89,0.86,0.89,+0.05,5.95,70000,11,61700,0,0,0,0,0,0,19000,70000,-51000,-51000
20200430,06130P,玉晶光元富97售07,2.10,2.10,2.10,2.10,0.00,0.00,100000,1,210000,0,0,0,0,0,0,100000,0,100000,100000
20200430,061310,華新科麥證9A購01,1.78,1.78,1.78,1.78,-0.01,-0.56,8000,1,14240,8000,0,8000,0,0,0,8000,0,8000,8000
20200430,061311,元黃金凱基9A購03,,,,,0.00,0.00,0,0,0,0,0,0,0,0,0,0,0,0,0
20200430,061312,滬深2X凱基9A購05,,,,,0.00,0.00,0,0,0,0,0,0,0,0,0,0,0,0,0
20200430,061313,滬深2X凱基9B購05,,,,,0.00,0.00,0,0,0,0,0,0,0,0,0,0,0,0,0
20200430,061314,滬深2X凱基9B購06,,,,,0.00,0.00,0,0,0,0,0,0,0,0,0,0,0,0,0
20200430,061315,滬深2X凱基9C購06,,,,,0.00,0.00,0,0,0,0,0,0,0,0,0,0,0,0,0
20200430,061316,台積電凱基9A購24,,,,,0.00,0.00,0,0,0,0,0,0,0,0,0,0,0,0,0
20200430,061317,旺宏凱基9A購05,1.85,1.86,1.80,1.82,+0.13,7.69,309000,25,564660,0,0,0,0,0,0,254000,124000,130000,130000
20200430,061318,智邦凱基9B購01,1.34,1.37,1.23,1.23,-0.07,-5.38,245000,35,314930,0,0,0,0,0,0,142000,103000,39000,39000
20200430,061319,聯發科凱基9A購16,2.01,2.01,2.01,2.01,+0.14,7.49,15000,1,30150,0,0,0,0,0,0,15000,0,15000,15000
20200430,06131P,京鼎元富97售02,1.05,1.05,1.05,1.05,-0.02,-1.87,5000,1,5250,0,0,0,0,0,0,0,5000,-5000,-5000
20200430,061320,奇力新凱基9A購04,1.28,1.36,1.28,1.31,+0.08,6.5,25000,7,32320,0,0,0,0,0,0,12000,13000,-1000,-1000
20200430,061321,華新科凱基9A購09,1.77,1.77,1.77,1.77,+0.01,0.57,2000,1,3540,0,0,0,0,0,0,0,2000,-2000,-2000
20200430,061322,華新科凱基9A購12,1.39,1.39,1.39,1.39,+0.03,2.21,1000,1,1390,0,0,0,0,0,0,0,1000,-1000,-1000
20200430,061323,華新科凱基9B購06,,,,,0.00,0.00,0,0,0,0,0,0,0,0,0,0,0,0,0
20200430,061324,華新科凱基9C購01,,,,,0.00,0.00,0,0,0,0,0,0,0,0,0,0,0,0,0
20200430,061325,晶技凱基9A購03,1.08,1.12,1.05,1.05,-0.01,-0.94,171000,7,182690,0,0,0,0,0,0,0,171000,-171000,-171000
20200430,061326,新日興凱基9B購01,1.19,1.19,1.15,1.15,-0.04,-3.36,107000,8,124870,0,0,0,0,0,0,45000,62000,-17000,-17000
20200430,061327,台郡凱基9A購02,1.27,1.30,1.25,1.30,+0.02,1.56,156000,10,199700,0,0,0,0,0,0,98000,108000,-10000,-10000
20200430,061328,T50反1元大9A購12,,,,,0.00,0.00,0,0,0,0,0,0,0,0,0,0,0,0,0
20200430,061329,T50反1元大9A購13,,,,,0.00,0.00,0,0,0,0,0,0,0,0,0,0,0,0,0
20200430,06132P,正文元富97售01,,,,,0.00,0.00,0,0,0,0,0,0,0,0,0,0,0,0,0
20200430,061330,T50反1元大9A購14,1.49,1.50,1.49,1.50,0.00,0.00,20000,2,29900,0,0,0,0,0,0,10000,10000,0,0
20200430,061331,T50反1元大9A購15,,,,,0.00,0.00,0,0,0,0,0,0,0,0,0,0,0,0,0
20200430,061332,T50反1元大9A購16,,,,,0.00,0.00,0,0,0,0,0,0,0,0,0,0,0,0,0
20200430,061333,華通元大9A購08,3.28,3.59,3.25,3.57,+0.45,14.42,375000,37,1273350,0,0,0,0,0,0,218000,180000,38000,38000
20200430,061334,華通元大9A購09,3.08,3.37,3.05,3.37,+0.45,15.41,159000,19,507620,0,0,0,0,0,0,43000,120000,-77000,-77000
20200430,061335,國巨元大9A購19,2.35,2.35,2.35,2.35,+0.05,2.17,1000,1,2350,0,0,0,0,0,0,0,1000,-1000,-1000
20200430,061336,國巨元大9A購20,3.31,3.36,3.21,3.30,+0.15,4.76,53000,11,173900,0,0,0,0,0,0,28000,25000,3000,3000
20200430,061337,台積電元大9A購27,1.67,1.67,1.67,1.67,0.00,0.00,68000,1,113560,0,0,0,0,0,0,0,68000,-68000,-68000
20200430,061338,台積電元大9A購28,2.98,2.98,2.98,2.98,+0.14,4.93,2000,1,5960,0,0,0,0,0,0,2000,0,2000,2000
20200430,061339,京元電元大9A購05,2.27,2.29,2.27,2.29,0.00,0.00,122000,3,278380,0,0,0,0,0,0,50000,72000,-22000,-22000
20200430,06133P,帆宣元富97售02,,,,,0.00,0.00,0,0,0,0,0,0,0,0,0,0,0,0,0
20200430,061340,義隆元大9A購01,2.58,2.79,2.52,2.68,+0.17,6.77,417000,27,1115150,0,0,0,0,0,0,184000,288000,-104000,-104000
20200430,061341,華新科元大9A購16,3.64,3.64,3.64,3.64,0.00,0.00,6000,1,21840,0,0,0,0,0,0,0,6000,-6000,-6000
20200430,061342,華新科元大9A購17,2.16,2.16,2.16,2.16,0.00,0.00,44000,1,95040,0,0,0,0,0,0,0,44000,-44000,-44000
20200430,061343,大立光元大9A購04,3.22,3.50,3.22,3.50,+0.37,11.82,134000,17,446420,0,0,0,0,0,0,69000,65000,4000,4000
20200430,061344,禾伸堂元大9A購02,2.33,2.33,2.22,2.26,+0.04,1.8,122000,10,281320,0,0,0,0,0,0,32000,115000,-83000,-83000
20200430,061345,玉晶光元大9A購14,1.31,1.31,1.31,1.31,+0.05,3.97,15000,1,19650,0,0,0,0,0,0,15000,0,15000,15000
20200430,061346,玉晶光元大9B購03,1.30,1.37,1.27,1.37,+0.17,14.17,742000,32,973220,0,0,0,0,0,0,183000,559000,-376000,-376000
20200430,061347,創意元大9A購02,1.57,1.65,1.57,1.63,+0.08,5.16,450000,35,727410,0,0,0,0,0,0,125000,357000,-232000,-232000
20200430,061348,聯鈞元大9A購05,1.72,1.72,1.68,1.68,+0.01,0.6,94000,3,159800,0,0,0,0,0,0,94000,0,94000,94000
20200430,061349,嘉澤元大9A購02,1.96,2.14,1.92,2.13,+0.27,14.52,305000,31,618540,0,0,0,0,0,0,204000,266000,-62000,-62000
20200430,06134P,緯穎元富97售03,,,,,0.00,0.00,0,0,0,0,0,0,0,0,0,0,0,0,0
20200430,061350,牧德元大9B購03,1.55,1.57,1.51,1.55,+0.10,6.9,301000,24,468020,0,0,0,0,0,0,133000,295000,-162000,-162000
20200430,061351,智伸科元大9A購01,1.97,1.98,1.89,1.89,+0.12,6.78,90000,9,175550,0,0,0,0,0,0,11000,79000,-68000,-68000
20200430,061352,茂林元大9A購04,2.89,2.89,2.89,2.89,-0.03,-1.03,3000,1,8670,0,0,0,0,0,0,0,3000,-3000,-3000
20200430,061353,康控元大9A購01,1.80,2.09,1.80,2.08,+0.38,22.35,340000,40,684520,0,0,0,0,0,0,220000,182000,38000,38000
20200430,061354,瑞儀元大9A購01,1.90,1.95,1.87,1.94,+0.05,2.65,936000,33,1776960,10000,0,10000,0,0,0,729000,233000,496000,506000
20200430,061355,康友元大9A購03,2.09,2.24,2.09,2.20,+0.15,7.32,161000,14,350700,0,0,0,0,0,0,25000,137000,-112000,-112000
20200430,061356,南電元大9A購06,2.79,2.79,2.74,2.74,+0.10,3.79,147000,9,407520,0,0,0,0,0,0,147000,0,147000,147000
20200430,061357,寶成元大9A購01,1.91,1.98,1.90,1.98,+0.08,4.21,292000,21,568510,0,0,0,0,0,0,180000,111000,69000,69000
20200430,061358,世紀鋼元大9A購04,3.06,3.22,3.06,3.22,+0.25,8.42,86000,13,270000,0,0,0,0,0,0,0,86000,-86000,-86000
20200430,061359,台灣50兆豐9C購02,,,,,0.00,0.00,0,0,0,0,0,0,0,0,0,0,0,0,0
20200430,06135P,志超元富97售01,0.53,0.53,0.53,0.53,-0.06,-10.17,68000,1,36040,0,0,0,0,0,0,0,68000,-68000,-68000
20200430,061360,智邦兆豐9B購02,1.51,1.51,1.37,1.38,-0.06,-4.17,648000,23,914630,0,0,0,0,0,0,377000,271000,106000,106000
20200430,061361,世紀鋼兆豐9A購01,1.01,1.06,1.01,1.05,+0.06,6.06,340000,14,349320,0,0,0,0,0,0,13000,324000,-311000,-311000
20200430,061362,台塑國票9B購01,3.11,3.48,3.11,3.48,+0.52,17.57,166000,9,546730,0,0,0,0,0,0,97000,69000,28000,28000
20200430,061363,儒鴻國票9B購01,2.75,2.90,2.75,2.90,+0.24,9.02,70000,10,196440,0,0,0,0,0,0,14000,56000,-42000,-42000
20200430,061364,國巨國票9A購09,4.40,4.57,4.40,4.47,+0.24,5.67,117000,11,521250,0,0,0,0,0,0,113000,8000,105000,105000
20200430,061365,國巨國票9B購05,5.40,5.40,5.40,5.40,+0.15,2.86,3000,1,16200,0,0,0,0,0,0,0,3000,-3000,-3000
20200430,061366,台勝科國票9A購01,1.92,2.48,1.90,2.45,+0.60,32.43,601000,31,1260440,0,0,0,0,0,0,13000,588000,-575000,-575000
20200430,061367,瑞祺國票9A購01,2.26,2.31,2.15,2.20,0.00,0.00,573000,30,1273180,0,0,0,0,0,0,132000,472000,-340000,-340000
20200430,061368,南六國票9A購01,4.18,4.24,3.82,4.05,-0.65,-13.83,58000,13,237950,0,0,0,0,0,0,28000,27000,1000,1000
20200430,061369,T50反1國泰9B購03,,,,,0.00,0.00,0,0,0,0,0,0,0,0,0,0,0,0,0
20200430,06136P,華新科國泰99售02,,,,,0.00,0.00,0,0,0,0,0,0,0,0,0,0,0,0,0
20200430,061370,晶技國泰9C購01,1.22,2.06,1.22,1.97,-0.01,-0.51,876000,47,1733970,0,0,0,0,0,0,457000,579000,-122000,-122000
20200430,061371,嘉澤國泰9C購01,1.87,2.01,1.87,2.01,+0.22,12.29,977000,33,1915200,0,0,0,0,0,0,146000,977000,-831000,-831000
20200430,061372,世紀鋼國泰9C購01,1.44,1.55,1.44,1.53,+0.10,6.99,973000,22,1448770,0,0,0,0,0,0,210000,763000,-553000,-553000
20200430,061373,華通富邦9A購02,0.70,0.82,0.70,0.82,+0.16,24.24,292000,34,216990,0,0,0,0,0,0,165000,127000,38000,38000
20200430,061374,力山永豐9A購04,1.31,1.43,1.21,1.22,-0.02,-1.61,1112000,33,1405590,0,0,0,0,0,0,926000,140000,786000,786000
20200430,061375,華通永豐9A購02,1.09,1.09,1.09,1.09,+0.03,2.83,3000,1,3270,0,0,0,0,0,0,3000,3000,0,0
20200430,061376,瑞昱永豐9A購02,1.21,1.28,1.18,1.28,+0.16,14.29,128000,17,154960,0,0,0,0,0,0,127000,53000,74000,74000
20200430,061377,聯發科永豐9A購04,1.68,1.73,1.68,1.73,+0.29,20.14,16000,3,27530,0,0,0,0,0,0,3000,13000,-10000,-10000
20200430,061378,南六永豐9A購03,1.46,1.46,1.31,1.39,-0.20,-12.58,306000,28,422750,0,0,0,0,0,0,282000,21000,261000,261000
20200430,061379,鈺齊永豐9A購02,1.06,1.12,1.04,1.12,+0.07,6.67,1429000,20,1549820,0,0,0,0,0,0,851000,581000,270000,270000
20200430,06137P,玉晶光永豐97售04,0.99,1.02,0.93,0.93,-0.16,-14.68,298000,16,293360,0,0,0,0,0,0,20000,278000,-258000,-258000
20200430,061380,巨大永豐9A購02,1.25,1.50,1.25,1.50,+0.30,25.0,1090000,42,1456120,0,0,0,0,0,0,464000,626000,-162000,-162000
20200430,061381,台灣50群益9B購07,2.10,2.15,2.07,2.15,+0.21,10.82,168000,5,352860,0,0,0,0,0,0,82000,86000,-4000,-4000
20200430,061382,台灣50群益9C購02,,,,,0.00,0.00,0,0,0,0,0,0,0,0,0,0,0,0,0
20200430,061383,高股息群益9A購01,,,,,0.00,0.00,0,0,0,0,0,0,0,0,0,0,0,0,0
20200430,061384,T50反1群益9A購04,0.88,0.88,0.83,0.83,-0.12,-12.63,1132000,8,984670,0,0,0,0,0,0,1001000,128000,873000,873000
20200430,061385,上証2X群益9C購07,,,,,0.00,0.00,0,0,0,0,0,0,0,0,0,0,0,0,0
20200430,061386,道瓊銀群益9A購03,,,,,0.00,0.00,0,0,0,0,0,0,0,0,0,0,0,0,0
20200430,061387,鴻海群益9A購05,3.18,3.25,3.12,3.25,+0.15,4.84,53000,5,167380,0,0,0,0,0,0,49000,13000,36000,36000
20200430,061388,台積電群益9A購05,3.56,3.60,3.56,3.60,+0.33,10.09,25000,2,89120,0,0,0,0,0,0,25000,0,25000,25000
20200430,061389,華新科群益9B購01,3.37,3.37,3.30,3.30,-0.11,-3.23,38000,3,126700,0,0,0,0,0,0,10000,28000,-18000,-18000
20200430,06138P,台積電中信99售01,1.06,1.06,1.06,1.06,0.00,0.00,1000,1,1060,0,0,0,0,0,0,1000,0,1000,1000
20200430,061390,大立光群益9A購04,1.56,1.77,1.56,1.77,+0.22,14.19,229000,8,390050,0,0,0,0,0,0,201000,28000,173000,173000
20200430,061391,晶技群益9A購02,1.16,1.23,1.14,1.14,-0.03,-2.56,562000,12,661440,0,0,0,0,0,0,0,562000,-562000,-562000
20200430,061392,泰鼎群益9A購02,1.57,1.58,1.52,1.58,0.00,0.00,197000,10,306100,0,0,0,0,0,0,61000,186000,-125000,-125000
20200430,061393,緯穎群益9A購01,2.98,3.35,2.94,3.33,+0.54,19.35,130000,14,413020,0,0,0,0,0,0,110000,59000,51000,51000
20200430,061394,FBVIX統一9B購01,,,,,0.00,0.00,0,0,0,0,0,0,0,0,0,0,0,0,0
20200430,061395,健策統一9C購02,1.06,1.11,1.03,1.04,+0.01,0.97,1060000,34,1128060,0,0,0,0,0,0,664000,575000,89000,89000
20200430,061396,台灣50台新9C購03,,,,,0.00,0.00,0,0,0,0,0,0,0,0,0,0,0,0,0
20200430,061397,上銀台新9A購01,1.39,1.53,1.39,1.53,+0.30,24.39,53000,3,76910,0,0,0,0,0,0,29000,24000,5000,5000
20200430,061398,力成中信9A購01,0.85,0.92,0.82,0.90,+0.06,7.14,302000,17,263260,0,0,0,0,0,0,130000,172000,-42000,-42000
20200430,061399,喬山兆豐9B購01,1.68,1.92,1.68,1.92,+0.28,17.07,441000,25,769730,0,0,0,0,0,0,22000,408000,-386000,-386000
20200430,06139P,台積電中信99售02,0.95,0.95,0.94,0.94,-0.07,-6.93,3000,2,2840,0,0,0,0,0,0,0,3000,-3000,-3000
20200430,061400,可成兆豐9B購02,,,,,0.00,0.00,0,0,0,0,0,0,0,0,0,0,0,0,0
20200430,061401,華擎兆豐9B購01,1.11,1.12,1.09,1.09,+0.01,0.93,75000,5,83450,0,0,0,0,0,0,50000,25000,25000,25000
20200430,061402,矽創兆豐9B購01,1.65,1.72,1.62,1.72,+0.18,11.69,62000,8,102830,0,0,0,0,0,0,30000,32000,-2000,-2000
20200430,061403,滬深2X國票9A購06,2.56,2.56,2.56,2.56,+0.20,8.47,3000,1,7680,0,0,0,0,0,0,0,3000,-3000,-3000
20200430,061404,臺指反國票04購01,,,,,0.00,0.00,0,0,0,0,0,0,0,0,0,0,0,0,0
20200430,061405,亞德客國票9B購01,3.07,3.29,2.99,3.29,+0.27,8.94,97000,5,300090,0,0,0,0,0,0,97000,29000,68000,68000
20200430,061406,華通國票9A購06,4.42,4.88,4.40,4.88,+0.79,19.32,54000,6,244470,0,0,0,0,0,0,42000,12000,30000,30000
20200430,061407,鴻海國票9A購07,1.87,1.87,1.87,1.87,+0.04,2.19,30000,2,56100,0,0,0,0,0,0,30000,0,30000,30000
20200430,061408,華新科國票9A購06,3.72,3.75,3.72,3.75,+0.05,1.35,16000,2,59760,0,0,0,0,0,0,0,16000,-16000,-16000
20200430,061409,力成國票9A購02,4.71,5.05,4.71,5.05,+0.50,10.99,13000,3,63270,0,0,0,0,0,0,7000,6000,1000,1000
20200430,06140P,華新科群益97售06,3.68,3.76,3.63,3.76,-0.11,-2.84,10000,5,36880,0,0,0,0,0,0,10000,0,10000,10000
20200430,061410,緯穎國票9A購03,3.68,4.42,3.68,4.42,+1.22,38.12,22000,4,84720,0,0,0,0,0,0,0,22000,-22000,-22000
20200430,061411,T50反1群益9A購05,0.64,0.65,0.58,0.59,-0.10,-14.49,1760000,20,1052420,0,0,0,0,0,0,800000,960000,-160000,-160000
20200430,061412,儒鴻群益9A購01,3.38,3.62,3.36,3.62,+0.41,12.77,315000,32,1102800,0,0,0,0,0,0,141000,231000,-90000,-90000
20200430,061413,台勝科群益9A購01,1.24,1.55,1.24,1.55,+0.36,30.25,775000,32,1056860,0,0,0,0,0,0,147000,686000,-539000,-539000
20200430,061414,牧德群益9B購02,1.14,1.19,1.12,1.18,+0.11,10.28,581000,23,680310,0,0,0,0,0,0,57000,525000,-468000,-468000
20200430,061415,健策群益9A購04,1.48,1.57,1.48,1.57,+0.09,6.08,63000,6,97020,0,0,0,0,0,0,2000,62000,-60000,-60000
20200430,061416,聯茂群益9A購01,1.75,1.75,1.70,1.72,-0.09,-4.97,574000,11,996670,0,0,0,0,0,0,329000,245000,84000,84000
20200430,061417,力成群益9A購01,1.47,1.59,1.46,1.59,+0.11,7.43,118000,8,179200,0,0,0,0,0,0,118000,0,118000,118000
20200430,061418,世紀鋼群益9A購02,1.42,1.52,1.39,1.50,+0.10,7.14,589000,8,855330,0,0,0,0,0,0,100000,489000,-389000,-389000
20200430,061419,國巨元大9A購21,2.40,2.40,2.36,2.38,+0.11,4.85,181000,11,430230,0,0,0,0,0,0,146000,35000,111000,111000
20200430,06141P,大立光日盛97售01,,,,,0.00,0.00,0,0,0,0,0,0,0,0,0,0,0,0,0
20200430,061420,國巨元大9A購22,2.77,2.81,2.68,2.76,+0.12,4.55,32000,7,88140,0,0,0,0,0,0,20000,12000,8000,8000
20200430,061421,台積電元大9A購29,1.91,1.91,1.91,1.91,0.00,0.00,50000,1,95500,0,0,0,0,0,0,0,50000,-50000,-50000
20200430,061422,台積電元大9A購30,,,,,0.00,0.00,0,0,0,0,0,0,0,0,0,0,0,0,0
20200430,061423,廣達元大9A購01,1.74,1.86,1.69,1.86,+0.14,8.14,1455000,80,2601350,0,0,0,0,0,0,538000,780000,-242000,-242000
20200430,061424,華新科元大9A購18,2.83,2.83,2.83,2.83,-0.02,-0.7,20000,1,56600,0,0,0,0,0,0,0,20000,-20000,-20000
20200430,061425,華新科元大9A購19,4.25,4.25,4.25,4.25,+0.09,2.16,7000,1,29750,0,0,0,0,0,0,7000,0,7000,7000
20200430,061426,玉晶光元大9A購15,1.24,1.29,1.24,1.29,+0.08,6.61,27000,4,34730,0,0,0,0,0,0,7000,20000,-13000,-13000
20200430,061427,旭富元大9A購02,1.47,1.50,1.40,1.41,+0.03,2.17,203000,11,296000,0,0,0,0,0,0,186000,58000,128000,128000
20200430,061428,南六元大9A購01,2.88,2.88,2.61,2.72,-0.33,-10.82,129000,11,352600,0,0,0,0,0,0,65000,64000,1000,1000
20200430,061429,南六元大9A購02,2.28,2.28,2.05,2.14,-0.27,-11.2,575000,36,1217270,0,0,0,0,0,0,277000,298000,-21000,-21000
20200430,06142P,台虹康和97售02,0.60,0.60,0.58,0.60,0.00,0.00,16000,3,9560,0,0,0,0,0,0,16000,10000,6000,6000
20200430,061430,致新元大9A購01,1.81,1.88,1.76,1.83,+0.09,5.17,559000,35,1025250,0,0,0,0,0,0,202000,508000,-306000,-306000
20200430,061431,鈺齊元大9A購01,2.85,2.90,2.72,2.82,+0.05,1.81,360000,34,1011090,0,0,0,0,0,0,282000,93000,189000,189000
20200430,061432,世紀鋼元大9A購05,1.16,1.22,1.16,1.22,+0.09,7.96,126000,4,147960,0,0,0,0,0,0,44000,126000,-82000,-82000
20200430,061433,華通麥證9A購03,1.38,1.41,1.38,1.41,0.00,0.00,44000,4,61320,0,44000,-44000,0,0,0,0,44000,-44000,-44000
20200430,061434,國巨麥證9A購04,,,,,0.00,0.00,0,0,0,0,0,0,0,0,0,0,0,0,0
20200430,061435,元金2X凱基9C購03,,,,,0.00,0.00,0,0,0,0,0,0,0,0,0,0,0,0,0
20200430,061436,上銀凱基9A購07,1.36,1.53,1.34,1.53,+0.27,21.43,462000,21,628730,0,0,0,0,0,0,389000,73000,316000,316000
20200430,061437,燿華凱基9A購01,1.16,1.25,1.16,1.23,+0.08,6.96,484000,29,586930,0,0,0,0,0,0,303000,181000,122000,122000
20200430,061438,牧德凱基9B購02,1.51,1.55,1.51,1.55,+0.11,7.64,233000,11,356280,0,0,0,0,0,0,2000,233000,-231000,-231000
20200430,061439,寶成凱基9A購01,1.42,1.47,1.38,1.47,+0.08,5.76,363000,25,513730,0,0,0,0,0,0,135000,228000,-93000,-93000
20200430,06143P,鴻海永豐97售02,,,,,0.00,0.00,0,0,0,0,0,0,0,0,0,0,0,0,0
20200430,061440,台灣50永豐9A購04,1.16,1.16,1.16,1.16,+0.05,4.5,10000,1,11600,0,0,0,0,0,0,10000,0,10000,10000
20200430,061441,大毅永豐9A購04,1.16,1.30,1.11,1.11,+0.11,11.0,175000,20,211570,0,0,0,0,0,0,60000,119000,-59000,-59000
20200430,061442,玉晶光永豐9A購07,1.13,1.17,1.12,1.17,+0.10,9.35,104000,5,118690,0,0,0,0,0,0,94000,10000,84000,84000
20200430,061443,大立光統一9C購02,1.04,1.12,1.04,1.12,+0.11,10.89,182000,11,192110,0,0,0,0,0,0,65000,117000,-52000,-52000
20200430,061444,聯發科台新9A購01,2.50,2.50,2.48,2.48,+0.23,10.22,150000,6,372520,0,0,0,0,0,0,150000,150000,0,0
20200430,061445,道瓊指中信9A購01,0.93,0.93,0.93,0.93,0.00,0.00,20000,1,18600,0,0,0,0,0,0,0,20000,-20000,-20000
20200430,061446,鴻海中信04購01,1.52,1.55,1.51,1.55,+0.08,5.44,39000,5,59670,0,0,0,0,0,0,10000,29000,-19000,-19000
20200430,061447,鴻海中信04購02,1.24,1.25,1.24,1.25,+0.06,5.04,135000,5,168250,0,0,0,0,0,0,0,135000,-135000,-135000
20200430,061448,旺宏中信9A購02,1.05,1.11,1.04,1.07,+0.08,8.08,395000,15,422360,0,0,0,0,0,0,344000,31000,313000,313000
20200430,061449,大立光中信9C購02,,,,,0.00,0.00,0,0,0,0,0,0,0,0,0,0,0,0,0
20200430,06144P,台光電永豐97售01,0.82,0.82,0.82,0.82,-0.02,-2.38,44000,1,36080,0,0,0,0,0,0,0,44000,-44000,-44000
20200430,061450,嘉晶中信9A購01,0.74,0.81,0.74,0.81,+0.08,10.96,174000,5,137270,0,0,0,0,0,0,0,174000,-174000,-174000
20200430,061451,南電中信9A購03,0.96,0.97,0.87,0.87,-0.06,-6.45,445000,13,417840,0,0,0,0,0,0,395000,50000,345000,345000
20200430,061452,大成鋼凱基9A購01,1.19,1.24,1.19,1.24,+0.02,1.64,325000,19,400460,0,0,0,0,0,0,20000,315000,-295000,-295000
20200430,061453,台達電凱基9B購01,1.40,1.48,1.40,1.48,+0.14,10.45,135000,14,194030,0,0,0,0,0,0,28000,107000,-79000,-79000
20200430,061454,國巨凱基9A購16,4.39,4.41,4.31,4.41,+0.16,3.76,62000,5,272400,0,0,0,0,0,0,2000,62000,-60000,-60000
20200430,061455,京元電凱基9B購01,1.34,1.34,1.34,1.34,+0.03,2.29,65000,3,87100,0,0,0,0,0,0,28000,37000,-9000,-9000
20200430,061456,玉晶光凱基9B購05,1.55,1.70,1.55,1.70,+0.18,11.84,307000,21,503060,10000,0,10000,0,0,0,126000,181000,-55000,-45000
20200430,061457,TPK凱基9A購01,1.09,1.12,1.04,1.05,-0.04,-3.67,264000,17,287400,0,0,0,0,0,0,89000,175000,-86000,-86000
20200430,061458,臻鼎凱基9A購02,1.14,1.27,1.13,1.26,+0.13,11.5,161000,17,189440,0,0,0,0,0,0,90000,71000,19000,19000
20200430,061459,台灣50群益9B購08,,,,,0.00,0.00,0,0,0,0,0,0,0,0,0,0,0,0,0
20200430,06145P,華新科永豐97售02,,,,,0.00,0.00,0,0,0,0,0,0,0,0,0,0,0,0,0
20200430,061460,FBVIX群益9A購02,,,,,0.00,0.00,0,0,0,0,0,0,0,0,0,0,0,0,0
20200430,061461,元金2X群益9A購01,1.26,1.26,1.26,1.26,-0.03,-2.33,15000,1,18900,0,0,0,0,0,0,15000,0,15000,15000
20200430,061462,國巨群益9A購11,2.06,2.06,1.96,2.02,+0.14,7.45,38000,9,76090,0,0,0,0,0,0,7000,33000,-26000,-26000
20200430,061463,智邦群益9A購02,2.57,2.57,2.28,2.28,-0.28,-10.94,151000,15,372940,0,0,0,0,0,0,111000,44000,67000,67000
20200430,061464,瑞昱群益9A購01,1.86,2.02,1.82,2.00,+0.25,14.29,2191000,61,4153140,0,0,0,0,0,0,301000,1904000,-1603000,-1603000
20200430,061465,聯詠群益9A購01,1.68,1.79,1.65,1.78,+0.08,4.71,349000,18,597390,0,0,0,0,0,0,238000,120000,118000,118000
20200430,061466,創意群益9A購01,1.98,2.05,1.98,2.05,0.00,0.00,134000,8,270450,0,0,0,0,0,0,1000,134000,-133000,-133000
20200430,061467,嘉澤群益9A購01,2.44,2.67,2.43,2.62,+0.25,10.55,194000,10,503270,0,0,0,0,0,0,80000,107000,-27000,-27000
20200430,061468,神達群益9A購01,,,,,0.00,0.00,0,0,0,0,0,0,0,0,0,0,0,0,0
20200430,061469,瑞祺群益9A購02,1.35,1.35,1.27,1.28,-0.02,-1.54,206000,14,263190,0,0,0,0,0,0,198000,36000,162000,162000
20200430,06146P,S&P反1元大97售03,,,,,0.00,0.00,0,0,0,0,0,0,0,0,0,0,0,0,0
20200430,061470,鈺齊群益9A購02,2.28,2.40,2.23,2.40,+0.05,2.13,246000,12,569490,0,0,0,0,0,0,181000,72000,109000,109000
20200430,061471,台積電元大9A購31,1.72,1.76,1.72,1.76,+0.09,5.39,25000,5,43870,0,0,0,0,0,0,0,25000,-25000,-25000
20200430,061472,台積電元大9A購32,2.50,2.50,2.50,2.50,+0.16,6.84,16000,2,40000,0,0,0,0,0,0,2000,14000,-12000,-12000
20200430,061473,台積電元大9A購33,1.72,1.74,1.72,1.74,+0.07,4.19,148000,2,256360,0,0,0,0,0,0,90000,58000,32000,32000
20200430,061474,瑞昱元大9A購04,2.39,2.57,2.35,2.54,+0.29,12.89,539000,68,1307640,0,0,0,0,0,0,346000,261000,85000,85000
20200430,061475,漢唐元大9A購01,1.78,1.78,1.78,1.78,+0.01,0.56,17000,1,30260,0,0,0,0,0,0,17000,0,17000,17000
20200430,061476,大毅元大9A購02,2.09,2.32,2.03,2.05,+0.15,7.89,394000,37,844730,0,0,0,0,0,0,178000,217000,-39000,-39000
20200430,061477,晶豪科元大9A購01,2.26,2.30,2.05,2.09,-0.01,-0.48,1100000,82,2411830,1000,0,1000,0,0,0,854000,377000,477000,478000
20200430,061478,奇鋐元大9A購01,2.66,2.70,2.50,2.63,+0.14,5.62,802000,68,2077540,0,0,0,0,0,0,184000,618000,-434000,-434000
20200430,061479,泰碩元大9A購02,2.43,2.44,2.38,2.38,-0.01,-0.42,100000,14,241250,0,0,0,0,0,0,63000,37000,26000,26000
20200430,06147P,國巨元大97售05,,,,,0.00,0.00,0,0,0,0,0,0,0,0,0,0,0,0,0
20200430,061480,泰碩元大9B購01,2.09,2.09,2.01,2.01,-0.02,-0.99,176000,26,356910,0,0,0,0,0,0,66000,110000,-44000,-44000
20200430,061481,嘉澤元大9A購03,2.43,2.64,2.38,2.64,+0.34,14.78,535000,53,1334530,0,0,0,0,0,0,364000,394000,-30000,-30000
20200430,061482,健策元大9C購01,3.79,3.90,3.70,3.89,+0.24,6.58,219000,29,825600,0,0,0,0,0,0,162000,67000,95000,95000
20200430,061483,TPK元大9A購01,2.57,2.57,2.44,2.44,-0.12,-4.69,31000,4,79340,0,0,0,0,0,0,31000,0,31000,31000
20200430,061484,華通兆豐9B購01,1.42,1.56,1.42,1.56,+0.20,14.71,286000,17,430980,0,0,0,0,0,0,142000,144000,-2000,-2000
20200430,061485,鴻海兆豐9A購01,1.40,1.42,1.40,1.42,+0.06,4.41,37000,4,52000,0,0,0,0,0,0,11000,26000,-15000,-15000
20200430,061486,國巨兆豐9B購02,2.48,2.57,2.48,2.52,+0.06,2.44,47000,7,118730,0,0,0,0,0,0,1000,46000,-45000,-45000
20200430,061487,聯發科兆豐9B購02,2.30,2.30,2.29,2.30,+0.32,16.16,53000,3,121490,0,0,0,0,0,0,46000,7000,39000,39000
20200430,061488,奇力新兆豐9A購01,1.33,1.38,1.33,1.37,+0.07,5.38,19000,4,25880,0,0,0,0,0,0,0,19000,-19000,-19000
20200430,061489,高鐵兆豐9A購01,1.44,1.44,1.39,1.41,+0.01,0.71,638000,16,912170,0,0,0,0,0,0,638000,0,638000,638000
20200430,06148P,台積電元大97售17,3.99,3.99,3.95,3.95,-0.40,-9.2,20000,2,79400,0,0,0,0,0,0,20000,20000,0,0
20200430,061490,茂林兆豐9B購01,1.27,1.30,1.26,1.26,0.00,0.00,40000,3,51300,0,0,0,0,0,0,20000,20000,0,0
20200430,061491,嘉聯益兆豐9B購01,1.39,1.44,1.39,1.44,+0.06,4.35,207000,11,290970,0,0,0,0,0,0,154000,53000,101000,101000
20200430,061492,超眾兆豐9B購01,0.99,1.06,0.99,1.04,+0.06,6.12,573000,13,580620,0,0,0,0,0,0,435000,118000,317000,317000
20200430,061493,T50反1國票9B購04,,,,,0.00,0.00,0,0,0,0,0,0,0,0,0,0,0,0,0
20200430,061494,聯發科國票9A購04,5.20,5.60,5.20,5.60,+0.95,20.43,11000,2,61200,0,0,0,0,0,0,1000,10000,-9000,-9000
20200430,061495,聯發科國票9B購01,4.95,5.05,4.95,5.05,+0.53,11.73,7000,3,35200,0,0,0,0,0,0,7000,0,7000,7000
20200430,061496,華新科國票9A購07,,,,,0.00,0.00,0,0,0,0,0,0,0,0,0,0,0,0,0
20200430,061497,大立光國票9A購09,2.76,3.09,2.76,3.09,+0.48,18.39,37000,4,107430,0,0,0,0,0,0,11000,26000,-15000,-15000
20200430,061498,大立光國票9A購10,3.03,3.35,3.03,3.35,+0.36,12.04,441000,18,1403730,0,0,0,0,0,0,328000,114000,214000,214000
20200430,061499,嘉晶國票9A購03,4.10,4.63,4.10,4.34,+0.25,6.11,57000,8,240820,0,0,0,0,0,0,7000,50000,-43000,-43000
20200430,06149P,台積電元大97售18,,,,,0.00,0.00,0,0,0,0,0,0,0,0,0,0,0,0,0
20200430,061500,京鼎國票9B購01,2.73,2.96,2.73,2.96,+0.30,11.28,126000,14,351440,0,0,0,0,0,0,13000,114000,-101000,-101000
20200430,061501,嘉澤國票9A購01,3.84,4.13,3.83,4.13,+0.35,9.26,80000,12,312780,0,0,0,0,0,0,16000,64000,-48000,-48000
20200430,061502,嘉澤國票9A購02,3.01,3.13,3.01,3.13,+0.15,5.03,132000,4,401620,0,0,0,0,0,0,94000,38000,56000,56000
20200430,061503,臻鼎國票9B購01,2.66,3.00,2.58,3.00,+0.36,13.64,151000,15,416910,0,0,0,0,0,0,87000,64000,23000,23000
20200430,061504,祥碩國票9A購02,2.45,2.45,2.04,2.04,-0.25,-10.92,213000,19,491060,0,0,0,0,0,0,143000,70000,73000,73000
20200430,061505,力成國票9A購03,3.89,3.95,3.89,3.95,+0.25,6.76,12000,2,46920,0,0,0,0,0,0,0,12000,-12000,-12000
20200430,061506,瑞祺國票9A購02,3.42,3.42,3.19,3.19,-0.10,-3.04,55000,13,182430,0,0,0,0,0,0,43000,48000,-5000,-5000
20200430,061507,南電國票9A購05,8.85,8.85,8.85,8.85,0.00,0.00,10000,1,88500,0,0,0,0,0,0,0,10000,-10000,-10000
20200430,061508,南六國泰9C購02,2.43,2.43,2.25,2.25,-0.30,-11.76,16000,3,37880,0,0,0,0,0,0,14000,2000,12000,12000
20200430,061509,SP黃豆富邦9C購01,0.93,0.94,0.93,0.93,+0.05,5.68,95000,7,88550,0,0,0,0,0,0,15000,80000,-65000,-65000
20200430,06150P,奇力新元大97售06,1.38,1.40,1.34,1.37,-0.07,-4.86,225000,4,312960,0,0,0,0,0,0,225000,15000,210000,210000
20200430,061510,嘉澤富邦9C購01,0.73,0.74,0.73,0.74,+0.06,8.82,191000,10,139440,0,0,0,0,0,0,0,191000,-191000,-191000
20200430,061511,緯穎富邦9B購02,0.80,0.95,0.79,0.92,+0.17,22.67,958000,41,839350,0,0,0,0,0,0,16000,957000,-941000,-941000
20200430,061512,國巨永豐9A購04,2.46,2.46,2.46,2.46,+0.08,3.36,2000,1,4920,0,0,0,0,0,0,2000,0,2000,2000
20200430,061513,華新科永豐9A購04,0.98,0.99,0.98,0.99,+0.03,3.12,14000,4,13730,0,0,0,0,0,0,2000,12000,-10000,-10000
20200430,061514,泰碩永豐9A購02,1.23,1.23,1.23,1.23,-0.07,-5.38,10000,1,12300,0,0,0,0,0,0,10000,0,10000,10000
20200430,061515,泰碩永豐9A購03,1.90,1.90,1.90,1.90,0.00,0.00,2000,1,3800,0,0,0,0,0,0,0,2000,-2000,-2000
20200430,061516,力成永豐9A購02,0.89,0.96,0.89,0.96,+0.06,6.67,137000,7,128600,0,0,0,0,0,0,29000,108000,-79000,-79000
20200430,061517,瑞祺永豐9A購03,0.95,0.95,0.92,0.93,0.00,0.00,489000,17,454940,0,0,0,0,0,0,336000,177000,159000,159000
20200430,061518,達方永豐9A購02,1.06,1.07,1.04,1.07,+0.03,2.88,124000,5,131860,0,0,0,0,0,0,34000,90000,-56000,-56000
20200430,061519,T50反1中信03購01,,,,,0.00,0.00,0,0,0,0,0,0,0,0,0,0,0,0,0
20200430,06151P,華新科元大97售07,1.67,1.72,1.64,1.72,-0.04,-2.27,58000,7,96610,0,0,0,0,0,0,50000,8000,42000,42000
20200430,061520,健策中信9A購01,0.76,0.79,0.75,0.79,+0.06,8.22,92000,8,71160,0,0,0,0,0,0,23000,69000,-46000,-46000
20200430,061521,亞光兆豐9A購02,1.25,1.30,1.25,1.26,+0.04,3.28,193000,14,245150,0,0,0,0,0,0,46000,147000,-101000,-101000
20200430,061522,元黃金凱基01購01,,,,,0.00,0.00,0,0,0,0,0,0,0,0,0,0,0,0,0
20200430,061523,SP黃豆凱基9B購01,,,,,0.00,0.00,0,0,0,0,0,0,0,0,0,0,0,0,0
20200430,061524,華通凱基9A購07,3.24,3.35,3.22,3.35,0.00,0.00,22000,4,71820,0,0,0,0,0,0,0,22000,-22000,-22000
20200430,061525,華新科凱基9A購13,3.40,3.40,3.40,3.40,+0.11,3.34,1000,1,3400,0,0,0,0,0,0,1000,0,1000,1000
20200430,061526,宏達電凱基9A購04,,,,,0.00,0.00,0,0,0,0,0,0,0,0,0,0,0,0,0
20200430,061527,牧德凱基9A購02,1.42,1.47,1.42,1.47,+0.12,8.89,250000,12,359930,0,0,0,0,0,0,2000,250000,-248000,-248000
20200430,061528,超眾凱基9A購04,,,,,0.00,0.00,0,0,0,0,0,0,0,0,0,0,0,0,0
20200430,061529,國巨台新9A購02,1.65,1.69,1.65,1.69,+0.08,4.97,15000,3,25240,0,0,0,0,0,0,5000,10000,-5000,-5000
20200430,06152P,玉晶光元大98售06,,,,,0.00,0.00,0,0,0,0,0,0,0,0,0,0,0,0,0
20200430,061530,智邦台新9A購02,,,,,0.00,0.00,0,0,0,0,0,0,0,0,0,0,0,0,0
20200430,061531,奇鋐台新9A購01,2.18,2.32,2.18,2.30,+0.08,3.6,32000,7,72710,0,0,0,0,0,0,0,32000,-32000,-32000
20200430,061532,和大統一9C購02,1.05,1.23,1.05,1.23,+0.24,24.24,728000,20,829410,0,0,0,0,0,0,365000,363000,2000,2000
20200430,061533,友達統一9C購02,1.09,1.10,1.08,1.10,+0.03,2.8,145000,6,158360,0,0,0,0,0,0,52000,93000,-41000,-41000
20200430,061534,聯發科統一9C購04,1.39,1.42,1.38,1.42,+0.14,10.94,99000,9,138480,0,0,0,0,0,0,47000,52000,-5000,-5000
20200430,061535,群創統一9C購01,1.09,1.12,1.09,1.12,0.00,0.00,48000,2,52770,0,0,0,0,0,0,0,48000,-48000,-48000
20200430,061536,華擎統一9C購02,0.73,0.73,0.71,0.71,+0.01,1.43,158000,4,114180,0,0,0,0,0,0,0,158000,-158000,-158000
20200430,061537,SP黃豆群益9A購02,,,,,0.00,0.00,0,0,0,0,0,0,0,0,0,0,0,0,0
20200430,061538,SP黃豆群益9A購03,0.97,0.97,0.97,0.97,0.00,0.00,100000,10,97000,0,0,0,0,0,0,0,100000,-100000,-100000
20200430,061539,國巨群益9B購03,6.25,6.25,6.05,6.05,0.00,0.00,2000,2,12300,0,0,0,0,0,0,0,2000,-2000,-2000
20200430,06153P,健策元大97售04,0.75,0.75,0.75,0.75,0.00,0.00,10000,1,7500,0,0,0,0,0,0,10000,0,10000,10000
20200430,061540,台積電群益9A購07,3.71,3.73,3.71,3.73,+0.25,7.18,91000,3,338010,0,0,0,0,0,0,71000,20000,51000,51000
20200430,061541,旺宏群益9A購03,4.04,4.06,3.93,3.93,+0.35,9.78,54000,14,217030,0,0,0,0,0,0,44000,18000,26000,26000
20200430,061542,旺宏群益9A購04,3.28,3.30,3.17,3.26,+0.54,19.85,96000,11,307200,0,0,0,0,0,0,8000,96000,-88000,-88000
20200430,061543,南亞科群益9A購01,2.74,2.74,2.70,2.71,+0.05,1.88,51000,6,139130,0,0,0,0,0,0,33000,18000,15000,15000
20200430,061544,大毅群益9B購02,2.49,2.91,2.45,2.48,+0.24,10.71,639000,22,1711320,0,0,0,0,0,0,233000,571000,-338000,-338000
20200430,061545,華新科群益9A購09,3.09,3.15,2.97,3.06,+0.09,3.03,27000,6,81870,0,0,0,0,0,0,5000,22000,-17000,-17000
20200430,061546,大立光群益9A購05,4.36,4.77,4.36,4.77,+0.58,13.84,106000,19,481020,0,0,0,0,0,0,59000,47000,12000,12000
20200430,061547,禾伸堂群益9A購01,2.13,2.13,2.02,2.02,0.00,0.00,92000,4,187020,0,0,0,0,0,0,2000,90000,-88000,-88000
20200430,061548,聯詠群益9A購02,1.59,1.69,1.59,1.67,+0.09,5.7,70000,10,114540,0,0,0,0,0,0,38000,41000,-3000,-3000
20200430,061549,泰碩群益9A購01,2.20,2.20,2.17,2.17,-0.10,-4.41,9000,3,19640,0,0,0,0,0,0,4000,5000,-1000,-1000
20200430,06154P,超眾元大98售01,0.90,0.91,0.85,0.91,-0.03,-3.19,59000,5,52400,0,0,0,0,0,0,49000,0,49000,49000
20200430,061550,聯鈞群益9A購03,1.48,1.48,1.45,1.45,0.00,0.00,22000,4,32130,0,0,0,0,0,0,0,22000,-22000,-22000
20200430,061551,GIS群益9A購01,3.43,3.49,3.43,3.49,+0.08,2.35,368000,12,1268780,0,0,0,0,0,0,368000,26000,342000,342000
20200430,061552,南六群益9A購02,1.73,1.73,1.56,1.56,-0.30,-16.13,212000,4,363440,0,0,0,0,0,0,207000,5000,202000,202000
20200430,061553,南電群益9A購03,1.94,1.94,1.74,1.74,-0.14,-7.45,115000,4,220720,0,0,0,0,0,0,2000,113000,-111000,-111000
20200430,061554,T50反1國票9B購05,,,,,0.00,0.00,0,0,0,0,0,0,0,0,0,0,0,0,0
20200430,061555,聯電國票9B購01,1.14,1.14,1.11,1.11,+0.01,0.91,43000,2,48390,0,0,0,0,0,0,22000,21000,1000,1000
20200430,061556,台積電國票9A購08,2.29,2.32,2.29,2.32,0.00,0.00,27000,2,62430,0,0,0,0,0,0,0,27000,-27000,-27000
20200430,061557,台積電國票9C購02,,,,,0.00,0.00,0,0,0,0,0,0,0,0,0,0,0,0,0
20200430,061558,旺宏國票9B購02,2.39,2.41,2.31,2.38,+0.37,18.41,60000,6,141740,0,0,0,0,0,0,18000,53000,-35000,-35000
20200430,061559,南亞科國票9A購02,4.72,4.72,4.60,4.62,+0.14,3.12,85000,8,393980,0,0,0,0,0,0,20000,65000,-45000,-45000
20200430,06155P,智邦統一97售02,0.73,0.87,0.73,0.86,+0.09,11.69,67000,5,55140,0,0,0,0,0,0,55000,12000,43000,43000
20200430,061560,友達國票9B購01,1.83,1.86,1.83,1.86,0.00,0.00,37000,3,68570,0,0,0,0,0,0,0,37000,-37000,-37000
20200430,061561,義隆國票9A購02,1.62,1.68,1.62,1.68,0.00,0.00,117000,8,192620,0,0,0,0,0,0,10000,107000,-97000,-97000
20200430,061562,群創國票9B購01,1.40,1.40,1.40,1.40,0.00,0.00,26000,1,36400,0,0,0,0,0,0,0,26000,-26000,-26000
20200430,061563,群創國票9B購02,0.92,0.92,0.92,0.92,0.00,0.00,33000,1,30360,0,0,0,0,0,0,0,33000,-33000,-33000
20200430,061564,華擎國票9A購02,2.13,2.13,1.95,1.95,-0.09,-4.41,73000,5,148790,0,0,0,0,0,0,12000,61000,-49000,-49000
20200430,061565,滬深2X元大9A購08,,,,,0.00,0.00,0,0,0,0,0,0,0,0,0,0,0,0,0
20200430,061566,華通元大9A購10,3.59,3.94,3.56,3.94,+0.39,10.99,397000,31,1483920,0,0,0,0,0,0,184000,244000,-60000,-60000
20200430,061567,華通元大9A購11,2.35,2.60,2.33,2.60,+0.27,11.59,370000,12,894720,0,0,0,0,0,0,36000,334000,-298000,-298000
20200430,061568,國巨元大9A購25,3.43,3.43,3.28,3.36,+0.08,2.44,14000,10,46990,0,0,0,0,0,0,1000,13000,-12000,-12000
20200430,061569,旺宏元大9A購14,4.20,4.20,4.00,4.00,+0.27,7.24,179000,28,736630,0,0,0,0,0,0,153000,81000,72000,72000
20200430,06156P,大立光統一97售05,,,,,0.00,0.00,0,0,0,0,0,0,0,0,0,0,0,0,0
20200430,061570,瑞昱元大9A購05,1.98,2.12,1.95,2.11,+0.24,12.83,625000,77,1257720,0,0,0,0,0,0,468000,339000,129000,129000
20200430,061571,奇力新元大9A購03,3.02,3.13,3.02,3.06,+0.12,4.08,152000,22,469340,0,0,0,0,0,0,5000,147000,-142000,-142000
20200430,061572,奇力新元大9A購04,3.76,3.85,3.76,3.85,0.00,0.00,18000,4,68670,0,0,0,0,0,0,0,18000,-18000,-18000
20200430,061573,義隆元大9A購02,1.56,1.72,1.56,1.65,+0.15,10.0,86000,9,145730,0,0,0,0,0,0,8000,82000,-74000,-74000
20200430,061574,大毅元大9B購01,2.98,3.38,2.98,3.05,+0.26,9.32,185000,14,587040,0,0,0,0,0,0,114000,72000,42000,42000
20200430,061575,華新科元大9A購20,3.41,3.41,3.41,3.41,0.00,0.00,6000,1,20460,0,0,0,0,0,0,0,6000,-6000,-6000
20200430,061576,華新科元大9A購21,3.53,3.53,3.53,3.53,0.00,0.00,6000,1,21180,0,0,0,0,0,0,0,6000,-6000,-6000
20200430,061577,泰碩元大9A購03,1.87,1.90,1.87,1.89,+0.01,0.53,38000,8,71480,0,0,0,0,0,0,34000,4000,30000,30000
20200430,061578,玉晶光元大9A購16,1.67,1.83,1.66,1.83,+0.23,14.37,878000,22,1532060,0,0,0,0,0,0,500000,378000,122000,122000
20200430,061579,京鼎元大9A購02,2.23,2.46,2.19,2.37,+0.27,12.86,238000,35,545770,0,0,0,0,0,0,36000,210000,-174000,-174000
20200430,06157P,聯鈞統一97售02,,,,,0.00,0.00,0,0,0,0,0,0,0,0,0,0,0,0,0
20200430,061580,華擎元大9A購06,,,,,0.00,0.00,0,0,0,0,0,0,0,0,0,0,0,0,0
20200430,061581,貿聯元大9A購05,1.85,2.14,1.85,2.14,+0.35,19.55,343000,35,701900,0,0,0,0,0,0,7000,336000,-329000,-329000
20200430,061582,麗豐元大9A購01,2.05,2.16,2.05,2.11,+0.14,7.11,189000,10,398390,0,0,0,0,0,0,10000,179000,-169000,-169000
20200430,061583,矽創元大9A購01,2.01,2.05,1.96,2.04,+0.12,6.25,701000,43,1397400,0,0,0,0,0,0,305000,496000,-191000,-191000
20200430,061584,勤誠元大9A購01,1.70,1.70,1.64,1.66,-0.01,-0.6,612000,30,1017050,0,0,0,0,0,0,358000,294000,64000,64000
20200430,061585,台積電富邦9B購06,0.81,0.81,0.81,0.81,+0.05,6.58,20000,1,16200,0,0,0,0,0,0,0,20000,-20000,-20000
20200430,061586,智邦富邦9A購02,1.15,1.15,1.01,1.07,-0.09,-7.76,180000,22,187350,0,0,0,0,0,0,13000,161000,-148000,-148000
20200430,061587,美律富邦9A購02,0.56,0.61,0.55,0.59,+0.06,11.32,844000,15,498710,0,0,0,0,0,0,142000,702000,-560000,-560000
20200430,061588,聯發科富邦9B購07,1.15,1.22,1.14,1.22,+0.15,14.02,295000,18,348170,0,0,0,0,0,0,89000,206000,-117000,-117000
20200430,061589,世紀鋼富邦9B購01,0.60,0.63,0.60,0.63,+0.03,5.0,186000,6,113680,0,0,0,0,0,0,16000,170000,-154000,-154000
20200430,06158P,玉晶光元富97售08,,,,,0.00,0.00,0,0,0,0,0,0,0,0,0,0,0,0,0
20200430,061590,金寶永豐9A購01,0.84,0.99,0.77,0.82,-0.01,-1.2,1916000,41,1514900,0,0,0,0,0,0,1554000,302000,1252000,1252000
20200430,061591,旺宏永豐9A購02,1.28,1.28,1.26,1.26,+0.15,13.51,9000,7,11440,0,0,0,0,0,0,9000,9000,0,0
20200430,061592,義隆永豐9A購03,0.82,0.90,0.82,0.89,+0.08,9.88,237000,10,208490,0,0,0,0,0,0,131000,112000,19000,19000
20200430,061593,智原永豐9A購01,0.90,0.90,0.90,0.90,0.00,0.00,51000,3,45900,0,0,0,0,0,0,0,51000,-51000,-51000
20200430,061594,玉晶光永豐9A購08,1.51,1.55,1.51,1.54,0.00,0.00,11000,5,16850,0,0,0,0,0,0,3000,11000,-8000,-8000
20200430,061595,智易永豐9A購02,1.03,1.03,1.03,1.03,0.00,0.00,20000,1,20600,0,0,0,0,0,0,0,20000,-20000,-20000
20200430,061596,健策永豐9A購03,1.14,1.18,1.14,1.18,+0.08,7.27,57000,6,65460,0,0,0,0,0,0,1000,57000,-56000,-56000
20200430,061597,南六永豐9A購04,1.18,1.18,1.04,1.08,-0.17,-13.6,112000,11,123270,0,0,0,0,0,0,83000,29000,54000,54000
20200430,061598,南電永豐9A購04,1.12,1.12,1.02,1.03,-0.02,-1.9,105000,9,116510,0,0,0,0,0,0,4000,91000,-87000,-87000
20200430,061599,元金反中信9C購01,0.96,0.96,0.95,0.95,0.00,0.00,42000,2,39920,0,0,0,0,0,0,0,42000,-42000,-42000
20200430,06159P,牧德元富97售02,,,,,0.00,0.00,0,0,0,0,0,0,0,0,0,0,0,0,0
20200430,061600,聯電凱基9B購01,0.89,0.89,0.88,0.88,+0.03,3.53,12000,2,10580,0,0,0,0,0,0,12000,0,12000,12000
20200430,061601,台積電凱基9A購26,,,,,0.00,0.00,0,0,0,0,0,0,0,0,0,0,0,0,0
20200430,061602,旺宏凱基9A購06,1.71,1.77,1.71,1.77,+0.21,13.46,215000,20,369450,0,0,0,0,0,0,200000,15000,185000,185000
20200430,061603,瑞昱凱基9A購02,1.42,1.54,1.39,1.54,+0.21,15.79,417000,30,609890,0,0,0,0,0,0,48000,369000,-321000,-321000
20200430,061604,台光電凱基9B購01,1.28,1.33,1.28,1.33,0.00,0.00,15000,3,19400,0,0,0,0,0,0,0,15000,-15000,-15000
20200430,061605,華新科凱基9A購14,1.01,1.02,1.01,1.01,-0.03,-2.88,41000,4,41710,0,0,0,0,0,0,1000,40000,-39000,-39000
20200430,061606,景碩凱基9A購02,1.22,1.27,1.22,1.27,+0.09,7.63,154000,12,192220,0,0,0,0,0,0,1000,154000,-153000,-153000
20200430,061607,台表科凱基9B購02,1.10,1.13,1.10,1.13,+0.02,1.8,105000,2,115650,0,0,0,0,0,0,0,105000,-105000,-105000
20200430,061608,SP黃豆統一9A購01,,,,,0.00,0.00,0,0,0,0,0,0,0,0,0,0,0,0,0
20200430,061609,華新科統一9C購01,0.70,0.72,0.68,0.68,0.00,0.00,828000,26,575730,0,0,0,0,0,0,91000,728000,-637000,-637000
20200430,06160P,台達電群益97售01,1.49,1.49,1.49,1.49,0.00,0.00,10000,1,14900,0,0,0,0,0,0,0,10000,-10000,-10000
20200430,061610,力成統一9C購01,0.72,0.77,0.72,0.76,+0.06,8.57,104000,6,78150,0,0,0,0,0,0,10000,94000,-84000,-84000
20200430,061611,南六統一01購01,0.75,0.75,0.68,0.68,-0.10,-12.82,80000,4,55540,0,0,0,0,0,0,75000,5000,70000,70000
20200430,061612,南六統一9A購01,0.89,0.89,0.89,0.89,-0.13,-12.75,5000,1,4450,0,0,0,0,0,0,0,5000,-5000,-5000
20200430,061613,南六統一9C購01,0.95,0.95,0.92,0.92,-0.05,-5.15,19000,3,17920,0,0,0,0,0,0,9000,10000,-1000,-1000
20200430,061614,亞德客群益9A購01,3.90,4.25,3.88,4.25,+0.54,14.56,50000,9,205320,0,0,0,0,0,0,7000,50000,-43000,-43000
20200430,061615,鴻海群益9A購06,3.15,3.27,3.15,3.27,+0.25,8.28,7000,3,22770,0,0,0,0,0,0,1000,7000,-6000,-6000
20200430,061616,鴻海群益9A購07,2.56,2.66,2.56,2.66,0.00,0.00,228000,4,586480,0,0,0,0,0,0,0,228000,-228000,-228000
20200430,061617,微星群益9A購02,2.13,2.13,2.10,2.10,0.00,0.00,59000,4,125370,0,0,0,0,0,0,0,59000,-59000,-59000
20200430,061618,友達群益9A購04,1.55,1.55,1.55,1.55,0.00,0.00,6000,1,9300,0,0,0,0,0,0,0,6000,-6000,-6000
20200430,061619,大立光群益9B購01,3.22,3.30,3.22,3.30,+0.37,12.63,13000,2,42100,0,0,0,0,0,0,10000,3000,7000,7000
20200430,06161P,聯發科群益97售03,,,,,0.00,0.00,0,0,0,0,0,0,0,0,0,0,0,0,0
20200430,061620,禾伸堂群益9A購02,1.67,1.67,1.67,1.67,-0.04,-2.34,4000,1,6680,0,0,0,0,0,0,4000,4000,0,0
20200430,061621,健策群益9A購05,2.58,2.71,2.57,2.62,+0.13,5.22,114000,16,302110,0,0,0,0,0,0,25000,90000,-65000,-65000
20200430,061622,臻鼎群益9A購01,2.01,2.28,1.99,2.28,+0.34,17.53,278000,17,584970,0,0,0,0,0,0,5000,273000,-268000,-268000
20200430,061623,祥碩群益9A購01,,,,,0.00,0.00,0,0,0,0,0,0,0,0,0,0,0,0,0
20200430,061624,中租群益9A購01,3.11,3.30,3.07,3.22,+0.27,9.15,253000,19,803280,0,0,0,0,0,0,176000,77000,99000,99000
20200430,061625,聯茂群益9A購02,1.82,1.84,1.78,1.84,+0.03,1.66,255000,6,465740,0,0,0,0,0,0,100000,155000,-55000,-55000
20200430,061626,超眾群益9A購02,2.54,2.57,2.54,2.57,0.00,0.00,89000,5,227080,0,0,0,0,0,0,0,89000,-89000,-89000
20200430,061627,台表科群益9A購01,2.07,2.07,2.05,2.06,+0.03,1.48,58000,3,119340,0,0,0,0,0,0,10000,48000,-38000,-38000
20200430,061628,緯穎群益9A購04,2.40,2.40,2.40,2.40,0.00,0.00,31000,1,74400,0,0,0,0,0,0,0,31000,-31000,-31000
20200430,061629,FBVIX元大9A購01,,,,,0.00,0.00,0,0,0,0,0,0,0,0,0,0,0,0,0
20200430,06162P,大立光群益97售02,,,,,0.00,0.00,0,0,0,0,0,0,0,0,0,0,0,0,0
20200430,061630,FBVIX元大9A購02,,,,,0.00,0.00,0,0,0,0,0,0,0,0,0,0,0,0,0
20200430,061631,SP黃豆元大9A購05,,,,,0.00,0.00,0,0,0,0,0,0,0,0,0,0,0,0,0
20200430,061632,SP黃豆元大9A購06,,,,,0.00,0.00,0,0,0,0,0,0,0,0,0,0,0,0,0
20200430,061633,統一元大9A購01,2.41,2.44,2.40,2.44,0.00,0.00,131000,7,317290,0,0,0,0,0,0,0,131000,-131000,-131000
20200430,061634,遠東新元大9A購01,1.92,1.92,1.89,1.90,+0.19,11.11,20000,11,38180,0,0,0,0,0,0,0,20000,-20000,-20000
20200430,061635,台積電元大9A購34,,,,,0.00,0.00,0,0,0,0,0,0,0,0,0,0,0,0,0
20200430,061636,聯發科元大9A購11,2.64,2.75,2.62,2.75,+0.35,14.58,151000,9,404920,0,0,0,0,0,0,51000,101000,-50000,-50000
20200430,061637,華新科元大9A購22,,,,,0.00,0.00,0,0,0,0,0,0,0,0,0,0,0,0,0
20200430,061638,國泰金元大9A購03,2.58,2.66,2.58,2.66,0.00,0.00,63000,14,164770,0,0,0,0,0,0,0,63000,-63000,-63000
20200430,061639,晶豪科元大9A購02,3.02,3.13,2.81,2.82,-0.01,-0.35,114000,5,344150,0,0,0,0,0,0,37000,77000,-40000,-40000
20200430,06163P,聯詠群益97售01,2.21,2.21,2.10,2.10,-0.25,-10.64,60000,4,130200,0,0,0,0,0,0,20000,40000,-20000,-20000
20200430,061640,智原元大9A購01,2.52,2.56,2.50,2.50,+0.03,1.21,115000,9,291350,0,0,0,0,0,0,36000,115000,-79000,-79000
20200430,061641,玉晶光元大9A購17,1.99,2.20,1.99,2.20,+0.26,13.4,97000,12,209310,0,0,0,0,0,0,5000,97000,-92000,-92000
20200430,061642,創意元大9A購04,1.73,1.77,1.72,1.76,+0.03,1.73,414000,18,723000,0,0,0,0,0,0,1000,414000,-413000,-413000
20200430,061643,嘉澤元大9A購05,2.67,2.88,2.62,2.86,+0.30,11.72,238000,31,656240,0,0,0,0,0,0,99000,238000,-139000,-139000
20200430,061644,健策元大9C購02,3.05,3.15,2.95,3.15,+0.21,7.14,224000,18,675830,0,0,0,0,0,0,151000,74000,77000,77000
20200430,061645,超眾元大9A購06,1.76,1.76,1.76,1.76,0.00,0.00,45000,2,79200,0,0,0,0,0,0,0,45000,-45000,-45000
20200430,061646,力成元大9A購02,1.49,1.61,1.49,1.59,+0.12,8.16,300000,25,466500,0,0,0,0,0,0,70000,230000,-160000,-160000
20200430,061647,南六元大9A購03,2.23,2.23,2.23,2.23,0.00,0.00,10000,1,22300,0,0,0,0,0,0,0,10000,-10000,-10000
20200430,061648,緯穎元大9A購04,2.45,2.81,2.45,2.71,+0.35,14.83,101000,9,267400,0,0,0,0,0,0,12000,89000,-77000,-77000
20200430,061649,緯穎元大9A購06,2.66,3.03,2.66,3.03,0.00,0.00,44000,7,122130,0,0,0,0,0,0,0,44000,-44000,-44000
20200430,06164P,臺股指凱基97售04,,,,,0.00,0.00,0,0,0,0,0,0,0,0,0,0,0,0,0
20200430,061650,南電元大9A購07,3.14,3.14,3.14,3.14,+0.10,3.29,69000,1,216660,0,0,0,0,0,0,69000,0,69000,69000
20200430,061651,世紀鋼元大9C購02,2.29,2.42,2.29,2.38,0.00,0.00,502000,29,1190210,0,0,0,0,0,0,0,502000,-502000,-502000
20200430,061652,T50反1國票9C購01,,,,,0.00,0.00,0,0,0,0,0,0,0,0,0,0,0,0,0
20200430,061653,上証2X國票9A購02,2.50,2.50,2.50,2.50,+0.14,5.93,1000,1,2500,0,0,0,0,0,0,1000,0,1000,1000
20200430,061654,旺宏國票9A購02,4.19,4.19,4.19,4.19,+0.58,16.07,2000,1,8380,0,0,0,0,0,0,0,2000,-2000,-2000
20200430,061655,微星國票9A購01,,,,,0.00,0.00,0,0,0,0,0,0,0,0,0,0,0,0,0
20200430,061656,華新科國票9A購08,3.70,3.70,3.56,3.56,-0.14,-3.78,6000,3,22060,0,0,0,0,0,0,1000,5000,-4000,-4000
20200430,061657,智原國票9A購01,3.34,3.34,3.34,3.34,0.00,0.00,10000,2,33400,0,0,0,0,0,0,0,10000,-10000,-10000
20200430,061658,聯茂富邦9A購03,0.62,0.62,0.62,0.62,-0.03,-4.62,10000,1,6200,0,0,0,0,0,0,10000,0,10000,10000
20200430,061659,信邦永豐9A購01,1.10,1.10,1.10,1.10,-0.05,-4.35,1000,1,1100,0,0,0,0,0,0,1000,0,1000,1000
20200430,06165P,臺股指凱基9A售03,2.50,2.50,2.50,2.50,-0.22,-8.09,10000,1,25000,0,0,0,0,0,0,0,10000,-10000,-10000
20200430,061660,禾伸堂永豐9A購01,0.87,0.87,0.87,0.87,0.00,0.00,55000,1,47850,0,0,0,0,0,0,55000,0,55000,55000
20200430,061661,京鼎永豐9A購02,1.16,1.27,1.16,1.27,+0.15,13.39,172000,10,209820,0,0,0,0,0,0,4000,172000,-168000,-168000
20200430,061662,瑞儀永豐9A購02,1.13,1.13,1.11,1.11,0.00,0.00,94000,3,105040,0,0,0,0,0,0,35000,94000,-59000,-59000
20200430,061663,南六永豐9A購05,0.98,0.98,0.98,0.98,0.00,0.00,30000,1,29400,0,0,0,0,0,0,0,30000,-30000,-30000
20200430,061664,上銀中信9A購01,,,,,0.00,0.00,0,0,0,0,0,0,0,0,0,0,0,0,0
20200430,061665,旺宏中信9C購01,0.79,0.79,0.77,0.77,+0.08,11.59,10000,4,7730,0,0,0,0,0,0,0,10000,-10000,-10000
20200430,061666,友達中信01購01,,,,,0.00,0.00,0,0,0,0,0,0,0,0,0,0,0,0,0
20200430,061667,友達中信9A購02,,,,,0.00,0.00,0,0,0,0,0,0,0,0,0,0,0,0,0
20200430,061668,信邦中信9B購01,,,,,0.00,0.00,0,0,0,0,0,0,0,0,0,0,0,0,0
20200430,061669,崇越中信9A購01,,,,,0.00,0.00,0,0,0,0,0,0,0,0,0,0,0,0,0
20200430,06166P,大立光國票98售01,,,,,0.00,0.00,0,0,0,0,0,0,0,0,0,0,0,0,0
20200430,061670,台灣50元大9A購20,2.09,2.13,2.08,2.13,+0.19,9.79,7000,3,14640,0,0,0,0,0,0,0,7000,-7000,-7000
20200430,061671,台灣50元大9A購21,1.42,1.42,1.42,1.42,+0.09,6.77,8000,1,11360,0,0,0,0,0,0,0,8000,-8000,-8000
20200430,061672,臺指反元大01購05,0.55,0.55,0.54,0.54,-0.06,-10.0,20000,2,10900,0,0,0,0,0,0,0,20000,-20000,-20000
20200430,061673,仁寶元大9B購01,,,,,0.00,0.00,0,0,0,0,0,0,0,0,0,0,0,0,0
20200430,061674,聯發科元大9A購12,4.79,4.85,4.73,4.85,+1.11,29.68,32000,3,153280,0,0,0,0,0,0,17000,32000,-15000,-15000
20200430,061675,華新科元大9A購23,,,,,0.00,0.00,0,0,0,0,0,0,0,0,0,0,0,0,0
20200430,061676,新光金元大9A購03,,,,,0.00,0.00,0,0,0,0,0,0,0,0,0,0,0,0,0
20200430,061677,泰碩元大9A購05,,,,,0.00,0.00,0,0,0,0,0,0,0,0,0,0,0,0,0
20200430,061678,玉晶光元大9B購04,1.93,2.03,1.93,2.00,+0.28,16.28,28000,9,55300,0,0,0,0,0,0,6000,28000,-22000,-22000
20200430,061679,健策元大9B購04,1.51,1.58,1.51,1.58,+0.14,9.72,50000,7,78660,0,0,0,0,0,0,10000,50000,-40000,-40000
20200430,06167P,欣興國票97售05,1.48,1.50,1.46,1.50,-0.25,-14.29,71000,4,106320,0,0,0,0,0,0,0,71000,-71000,-71000
20200430,061680,崇越元大9A購01,,,,,0.00,0.00,0,0,0,0,0,0,0,0,0,0,0,0,0
20200430,061681,南電元大9A購08,1.94,1.96,1.80,1.83,+0.06,3.39,385000,21,738650,0,0,0,0,0,0,0,385000,-385000,-385000
20200430,061682,南電元大9B購01,1.93,1.93,1.79,1.82,+0.06,3.41,500000,35,950750,0,0,0,0,0,0,0,500000,-500000,-500000
20200430,061683,台灣50群益9B購09,,,,,0.00,0.00,0,0,0,0,0,0,0,0,0,0,0,0,0
20200430,061684,T50反1群益9A購06,1.07,1.07,1.07,1.07,-0.20,-15.75,20000,2,21400,0,0,0,0,0,0,0,20000,-20000,-20000
20200430,061685,道瓊反群益9A購03,,,,,0.00,0.00,0,0,0,0,0,0,0,0,0,0,0,0,0
20200430,061686,SP黃豆群益9A購04,,,,,0.00,0.00,0,0,0,0,0,0,0,0,0,0,0,0,0
20200430,061687,大成鋼群益9A購01,,,,,0.00,0.00,0,0,0,0,0,0,0,0,0,0,0,0,0
20200430,061688,華通群益9A購07,2.86,2.86,2.79,2.79,+0.38,15.77,88000,11,249510,0,0,0,0,0,0,0,88000,-88000,-88000
20200430,061689,國巨群益9A購12,4.47,4.47,4.23,4.38,+0.43,10.89,112000,8,484540,0,0,0,0,0,0,2000,112000,-110000,-110000
20200430,06168P,台表科國票97售06,,,,,0.00,0.00,0,0,0,0,0,0,0,0,0,0,0,0,0
20200430,061690,旺宏群益9A購05,4.32,4.32,4.28,4.28,+0.93,27.76,19000,3,81480,0,0,0,0,0,0,0,19000,-19000,-19000
20200430,061691,聯發科群益9A購03,,,,,0.00,0.00,0,0,0,0,0,0,0,0,0,0,0,0,0
20200430,061692,聯發科群益9A購04,,,,,0.00,0.00,0,0,0,0,0,0,0,0,0,0,0,0,0
20200430,061693,華新科群益9B購02,,,,,0.00,0.00,0,0,0,0,0,0,0,0,0,0,0,0,0
20200430,061694,玉山金群益9A購01,2.57,2.60,2.57,2.60,+0.42,19.27,15000,4,38820,0,0,0,0,0,0,9000,15000,-6000,-6000
20200430,061695,群創群益9A購01,,,,,0.00,0.00,0,0,0,0,0,0,0,0,0,0,0,0,0
20200430,061696,南茂群益9A購01,,,,,0.00,0.00,0,0,0,0,0,0,0,0,0,0,0,0,0
20200430,061697,世紀鋼群益9A購03,1.98,1.99,1.96,1.96,+0.23,13.29,114000,6,224670,0,0,0,0,0,0,0,114000,-114000,-114000
20200430,061698,智邦國票9A購04,,,,,0.00,0.00,0,0,0,0,0,0,0,0,0,0,0,0,0
20200430,061699,燿華國票9A購01,2.04,2.04,2.03,2.03,+0.13,6.84,5000,2,10170,0,0,0,0,0,0,0,5000,-5000,-5000
20200430,06169P,華新科元富97售02,,,,,0.00,0.00,0,0,0,0,0,0,0,0,0,0,0,0,0
20200430,061700,瑞昱國票9A購02,2.03,2.10,2.03,2.10,+0.46,28.05,58000,11,118880,0,0,0,0,0,0,0,58000,-58000,-58000
20200430,061701,友達國票9B購02,,,,,0.00,0.00,0,0,0,0,0,0,0,0,0,0,0,0,0
20200430,061702,奇鋐國票9A購02,,,,,0.00,0.00,0,0,0,0,0,0,0,0,0,0,0,0,0
20200430,061703,信邦國票9A購01,2.75,2.75,2.61,2.61,+0.27,11.54,3000,3,8050,0,0,0,0,0,0,0,3000,-3000,-3000
20200430,061704,景碩國票9A購01,3.39,3.39,3.39,3.39,+0.65,23.72,4000,2,13560,0,0,0,0,0,0,0,4000,-4000,-4000
20200430,061705,健策國票9A購06,6.70,6.70,6.70,6.70,+0.55,8.94,3000,1,20100,0,0,0,0,0,0,0,3000,-3000,-3000
20200430,061706,旭富國票9A購02,1.79,1.81,1.77,1.77,-0.02,-1.12,3000,3,5370,0,0,0,0,0,0,0,3000,-3000,-3000
20200430,061707,超眾國票9B購01,2.31,2.31,2.31,2.31,+0.09,4.05,5000,1,11550,0,0,0,0,0,0,0,5000,-5000,-5000
20200430,061708,同欣電國票9A購02,1.70,1.82,1.70,1.82,+0.29,18.95,89000,8,158560,0,0,0,0,0,0,9000,89000,-80000,-80000
20200430,061709,SP黃豆凱基01購02,,,,,0.00,0.00,0,0,0,0,0,0,0,0,0,0,0,0,0
20200430,06170P,禾伸堂元富97售02,,,,,0.00,0.00,0,0,0,0,0,0,0,0,0,0,0,0,0
20200430,061710,國巨凱基9A購18,3.43,3.43,3.43,3.43,+0.20,6.19,1000,1,3430,0,0,0,0,0,0,0,1000,-1000,-1000
20200430,061711,台積電凱基9A購27,,,,,0.00,0.00,0,0,0,0,0,0,0,0,0,0,0,0,0
20200430,061712,旺宏凱基9A購08,,,,,0.00,0.00,0,0,0,0,0,0,0,0,0,0,0,0,0
20200430,061713,華邦電凱基9A購01,1.42,1.42,1.42,1.42,+0.11,8.4,28000,4,39760,0,0,0,0,0,0,0,28000,-28000,-28000
20200430,061714,華新科凱基9A購15,1.82,1.82,1.74,1.74,-1.35,-43.69,3000,2,5380,0,0,0,0,0,0,0,3000,-3000,-3000
20200430,061715,牧德凱基9B購03,1.42,1.42,1.42,1.42,-0.10,-6.58,5000,1,7100,0,0,0,0,0,0,0,5000,-5000,-5000
20200430,061716,瑞儀凱基9B購01,0.78,0.78,0.77,0.77,-0.14,-15.38,148000,3,114310,0,0,0,0,0,0,135000,148000,-13000,-13000
20200430,061717,力成凱基9B購01,,,,,0.00,0.00,0,0,0,0,0,0,0,0,0,0,0,0,0
20200430,061718,GIS凱基9B購01,,,,,0.00,0.00,0,0,0,0,0,0,0,0,0,0,0,0,0
20200430,061719,緯穎凱基9A購06,2.85,2.85,2.85,2.85,+0.36,14.46,6000,2,17100,0,0,0,0,0,0,0,6000,-6000,-6000
20200430,06171P,台積電統一97售06,,,,,0.00,0.00,0,0,0,0,0,0,0,0,0,0,0,0,0
20200430,061720,智邦國泰9C購01,1.77,1.77,1.77,1.77,-0.03,-1.67,2000,1,3540,0,0,0,0,0,0,0,2000,-2000,-2000
20200430,061721,道瓊反富邦9B購01,,,,,0.00,0.00,0,0,0,0,0,0,0,0,0,0,0,0,0
20200430,061722,健策永豐9B購03,1.09,1.13,1.09,1.13,+0.09,8.65,5000,3,5570,0,0,0,0,0,0,5000,5000,0,0
20200430,061723,嘉聯益永豐9A購03,,,,,0.00,0.00,0,0,0,0,0,0,0,0,0,0,0,0,0
20200430,061724,訊芯永豐9A購01,0.86,0.86,0.86,0.86,+0.05,6.17,23000,2,19780,0,0,0,0,0,0,0,23000,-23000,-23000
20200430,061725,國巨麥證9A購05,,,,,0.00,0.00,0,0,0,0,0,0,0,0,0,0,0,0,0
20200430,061726,台積電麥證9A購05,,,,,0.00,0.00,0,0,0,0,0,0,0,0,0,0,0,0,0
20200430,061727,旺宏麥證9A購04,,,,,0.00,0.00,0,0,0,0,0,0,0,0,0,0,0,0,0
20200430,061728,華新科麥證9A購02,,,,,0.00,0.00,0,0,0,0,0,0,0,0,0,0,0,0,0
20200430,061729,祥碩麥證9A購02,1.26,1.26,1.26,1.26,+0.01,0.8,1000,1,1260,0,1000,-1000,0,0,0,0,1000,-1000,-1000
20200430,06172P,台虹永豐97售02,0.75,0.75,0.75,0.75,0.00,0.00,24000,1,18000,0,0,0,0,0,0,0,24000,-24000,-24000
20200430,061730,旺宏統一01購02,1.42,1.42,1.42,1.42,+0.12,9.23,50000,1,71000,0,0,0,0,0,0,0,50000,-50000,-50000
20200430,061731,旺宏統一9B購06,1.69,1.71,1.69,1.71,+0.13,8.23,107000,4,181970,0,0,0,0,0,0,0,107000,-107000,-107000
20200430,06173P,華通元大97售02,1.70,1.70,1.66,1.66,-0.28,-14.43,17000,3,28420,0,0,0,0,0,0,12000,5000,7000,7000
20200430,06174P,國巨元大97售07,1.87,1.87,1.87,1.87,0.00,0.00,3000,1,5610,0,0,0,0,0,0,0,3000,-3000,-3000
20200430,06175P,台積電元大97售21,4.70,4.70,4.63,4.63,0.00,0.00,30000,3,139600,0,0,0,0,0,0,30000,30000,0,0
20200430,06176P,台積電元大97售22,,,,,0.00,0.00,0,0,0,0,0,0,0,0,0,0,0,0,0
20200430,06177P,玉晶光元大98售07,2.12,2.12,2.05,2.05,-0.16,-7.24,80000,5,167300,0,0,0,0,0,0,30000,50000,-20000,-20000
20200430,06178P,大立光第一99售01,,,,,0.00,0.00,0,0,0,0,0,0,0,0,0,0,0,0,0
20200430,06179P,國巨群益97售04,5.85,6.00,5.85,5.85,-0.45,-7.14,7000,3,41400,0,0,0,0,0,0,3000,4000,-1000,-1000
20200430,06180P,禾伸堂群益97售01,0.85,0.90,0.85,0.89,-0.05,-5.32,166000,17,144040,0,0,0,0,0,0,166000,0,166000,166000
20200430,06181P,國巨中信97售02,,,,,0.00,0.00,0,0,0,0,0,0,0,0,0,0,0,0,0
20200430,06182P,群創兆豐97售03,,,,,0.00,0.00,0,0,0,0,0,0,0,0,0,0,0,0,0
20200430,06183P,大立光元大97售05,,,,,0.00,0.00,0,0,0,0,0,0,0,0,0,0,0,0,0
20200430,06184P,大立光元大97售06,,,,,0.00,0.00,0,0,0,0,0,0,0,0,0,0,0,0,0
20200430,06185P,台表科元大97售05,2.12,2.13,2.12,2.13,+0.03,1.43,70000,3,148600,0,0,0,0,0,0,0,70000,-70000,-70000
20200430,06186P,鴻海統一97售02,,,,,0.00,0.00,0,0,0,0,0,0,0,0,0,0,0,0,0
20200430,06187P,國巨統一97售05,2.91,2.96,2.89,2.96,-0.12,-3.9,10000,5,29260,0,0,0,0,0,0,3000,7000,-4000,-4000
20200430,06188P,大立光元富97售01,,,,,0.00,0.00,0,0,0,0,0,0,0,0,0,0,0,0,0
20200430,06189P,華新科永豐97售03,,,,,0.00,0.00,0,0,0,0,0,0,0,0,0,0,0,0,0
20200430,06190P,玉晶光永豐97售05,,,,,0.00,0.00,0,0,0,0,0,0,0,0,0,0,0,0,0
20200430,06191P,鴻海群益97售03,,,,,0.00,0.00,0,0,0,0,0,0,0,0,0,0,0,0,0
20200430,06192P,高股息中信98售01,1.90,1.90,1.77,1.77,-0.23,-11.5,21000,5,38570,0,0,0,0,0,0,0,17000,-17000,-17000
20200430,06193P,台積電元富97售04,,,,,0.00,0.00,0,0,0,0,0,0,0,0,0,0,0,0,0
20200430,06194P,台積電元富97售05,,,,,0.00,0.00,0,0,0,0,0,0,0,0,0,0,0,0,0
20200430,06195P,台積電元富97售06,0.70,1.84,0.70,1.84,0.00,0.00,21000,2,15840,0,0,0,0,0,0,21000,1000,20000,20000
20200430,06196P,元上證元大97售01,1.87,1.87,1.87,1.87,0.00,0.00,30000,1,56100,0,0,0,0,0,0,30000,0,30000,30000
20200430,06197P,國巨元大97售08,,,,,0.00,0.00,0,0,0,0,0,0,0,0,0,0,0,0,0
20200430,06198P,台積電元大98售06,2.07,2.07,2.07,2.07,0.00,0.00,1000,1,2070,0,0,0,0,0,0,0,1000,-1000,-1000
20200430,06199P,聯發科元大97售17,2.09,2.19,2.09,2.13,-0.73,-25.52,35000,4,75350,0,0,0,0,0,0,30000,25000,5000,5000
20200430,06200P,聯發科元大97售18,7.35,7.35,7.35,7.35,-1.65,-18.33,20000,1,147000,0,0,0,0,0,0,20000,0,20000,20000
20200430,06201P,可成元大97售01,,,,,0.00,0.00,0,0,0,0,0,0,0,0,0,0,0,0,0
20200430,06202P,大立光元大98售06,,,,,0.00,0.00,0,0,0,0,0,0,0,0,0,0,0,0,0
20200430,06203P,奇力新中信98售02,,,,,0.00,0.00,0,0,0,0,0,0,0,0,0,0,0,0,0
20200430,06204P,鴻海群益97售04,,,,,0.00,0.00,0,0,0,0,0,0,0,0,0,0,0,0,0
20200430,06205P,台積電群益97售03,,,,,0.00,0.00,0,0,0,0,0,0,0,0,0,0,0,0,0
20200430,06206P,台積電凱基97售11,,,,,0.00,0.00,0,0,0,0,0,0,0,0,0,0,0,0,0
20200430,06207P,聯發科凱基97售07,,,,,0.00,0.00,0,0,0,0,0,0,0,0,0,0,0,0,0
20200430,06208P,台郡凱基97售03,1.55,1.55,1.52,1.52,-0.08,-5.0,50000,3,76900,0,0,0,0,0,0,50000,50000,0,0
20200430,06209P,旺宏統一97售07,,,,,0.00,0.00,0,0,0,0,0,0,0,0,0,0,0,0,0
20200430,06210P,元油反元大97售01,,,,,0.00,0.00,0,0,0,0,0,0,0,0,0,0,0,0,0
20200430,06211P,鴻海元大98售04,2.70,2.70,2.70,2.70,0.00,0.00,2000,1,5400,0,0,0,0,0,0,2000,0,2000,2000
20200430,06212P,華新科元大97售11,1.88,1.88,1.88,1.88,0.00,0.00,5000,1,9400,0,0,0,0,0,0,5000,0,5000,5000
20200430,06213P,大立光元大98售07,,,,,0.00,0.00,0,0,0,0,0,0,0,0,0,0,0,0,0
20200430,06214P,國巨國票98售04,4.36,4.37,4.36,4.37,-0.17,-3.74,2000,2,8730,0,0,0,0,0,0,2000,0,2000,2000
20200430,06215P,康控永豐97售02,,,,,0.00,0.00,0,0,0,0,0,0,0,0,0,0,0,0,0
20200430,06216P,上銀元富97售03,1.45,1.45,1.45,1.45,-0.69,-32.24,10000,1,14500,0,0,0,0,0,0,0,10000,-10000,-10000
20200430,06217P,鴻海元富97售05,,,,,0.00,0.00,0,0,0,0,0,0,0,0,0,0,0,0,0
20200430,06218P,鴻海元富97售06,,,,,0.00,0.00,0,0,0,0,0,0,0,0,0,0,0,0,0
20200430,06219P,國巨元富97售05,,,,,0.00,0.00,0,0,0,0,0,0,0,0,0,0,0,0,0
20200430,06220P,廣宇元富97售02,,,,,0.00,0.00,0,0,0,0,0,0,0,0,0,0,0,0,0
20200430,06222P,致茂元富97售02,,,,,0.00,0.00,0,0,0,0,0,0,0,0,0,0,0,0,0
20200430,06223P,漢唐元富97售02,,,,,0.00,0.00,0,0,0,0,0,0,0,0,0,0,0,0,0
20200430,06224P,可成元富97售02,,,,,0.00,0.00,0,0,0,0,0,0,0,0,0,0,0,0,0
20200430,06225P,華新科元富97售04,,,,,0.00,0.00,0,0,0,0,0,0,0,0,0,0,0,0,0
20200430,06226P,聯發科麥證97售03,1.70,1.70,1.70,1.70,0.00,0.00,3000,1,5100,0,3000,-3000,0,0,0,0,3000,-3000,-3000
20200430,06227P,大立光群益97售04,,,,,0.00,0.00,0,0,0,0,0,0,0,0,0,0,0,0,0
20200430,06228P,亞德客凱基97售04,0.28,0.28,0.28,0.28,-0.04,-12.5,5000,1,1400,0,0,0,0,0,0,0,5000,-5000,-5000
20200430,06229P,欣興凱基97售07,,,,,0.00,0.00,0,0,0,0,0,0,0,0,0,0,0,0,0
20200430,06230P,亞德客永豐97售03,0.97,0.98,0.75,0.75,-0.26,-25.74,73000,4,67090,0,0,0,0,0,0,0,73000,-73000,-73000
20200430,06231P,台積電永豐97售05,,,,,0.00,0.00,0,0,0,0,0,0,0,0,0,0,0,0,0
20200430,06232P,智易永豐97售01,1.63,1.64,1.63,1.64,+0.04,2.5,66000,3,107800,0,0,0,0,0,0,0,66000,-66000,-66000
20200430,06233P,訊芯永豐97售03,,,,,0.00,0.00,0,0,0,0,0,0,0,0,0,0,0,0,0
20200430,06234P,亞德客元大97售02,0.86,0.87,0.66,0.70,-0.23,-24.73,357000,41,259280,0,0,0,0,0,0,0,357000,-357000,-357000
20200430,06235P,國巨元大97售12,,,,,0.00,0.00,0,0,0,0,0,0,0,0,0,0,0,0,0
20200430,06236P,台積電元大97售25,,,,,0.00,0.00,0,0,0,0,0,0,0,0,0,0,0,0,0
20200430,06237P,台積電元大97售26,4.34,4.34,4.34,4.34,0.00,0.00,48000,1,208320,0,0,0,0,0,0,48000,0,48000,48000
20200430,06238P,台積電元大98售07,4.63,4.63,4.63,4.63,0.00,0.00,20000,2,92600,0,0,0,0,0,0,20000,20000,0,0
20200430,06239P,奇力新元大97售08,,,,,0.00,0.00,0,0,0,0,0,0,0,0,0,0,0,0,0
20200430,06240P,奇力新元富97售03,1.43,1.46,1.43,1.46,-0.07,-4.58,36000,4,51780,0,0,0,0,0,0,10000,26000,-16000,-16000
20200430,06241P,大立光元富9A售01,3.00,3.00,2.80,2.80,-0.36,-11.39,12000,3,35600,0,0,0,0,0,0,9000,12000,-3000,-3000
20200430,06242P,大立光元富9A售02,,,,,0.00,0.00,0,0,0,0,0,0,0,0,0,0,0,0,0
20200430,06243P,亞光元富97售01,4.09,4.14,4.09,4.14,-0.02,-0.48,16000,2,65890,0,0,0,0,0,0,0,16000,-16000,-16000
20200430,06244P,智易元富97售02,1.39,1.39,1.39,1.39,0.00,0.00,1000,1,1390,0,0,0,0,0,0,0,1000,-1000,-1000
20200430,06245P,健策元富97售03,,,,,0.00,0.00,0,0,0,0,0,0,0,0,0,0,0,0,0
20200430,06246P,茂林元富97售03,1.01,1.07,1.01,1.06,-0.02,-1.85,478000,23,498400,0,0,0,0,0,0,249000,229000,20000,20000
20200430,06247P,同欣電元富97售02,2.45,2.49,2.45,2.49,0.00,0.00,11000,2,27350,0,0,0,0,0,0,1000,10000,-9000,-9000
20200430,06248P,國巨統一97售07,2.28,2.28,2.28,2.28,0.00,0.00,10000,1,22800,0,0,0,0,0,0,10000,0,10000,10000
20200430,06249P,億光統一97售02,,,,,0.00,0.00,0,0,0,0,0,0,0,0,0,0,0,0,0
20200430,06250P,臺股指永昌97售02,,,,,0.00,0.00,0,0,0,0,0,0,0,0,0,0,0,0,0
20200430,06251P,臺股指永昌97售03,,,,,0.00,0.00,0,0,0,0,0,0,0,0,0,0,0,0,0
20200430,06252P,臺股指兆豐97售02,,,,,0.00,0.00,0,0,0,0,0,0,0,0,0,0,0,0,0
20200430,06253P,臺股指兆豐97售03,,,,,0.00,0.00,0,0,0,0,0,0,0,0,0,0,0,0,0
20200430,06254P,臺股指群益97售07,4.77,4.84,4.28,4.30,-1.05,-19.63,298000,21,1350030,0,0,0,0,0,0,105000,193000,-88000,-88000
20200430,06255P,臺股指群益97售08,,,,,0.00,0.00,0,0,0,0,0,0,0,0,0,0,0,0,0
20200430,06256P,臺股指群益97售09,6.00,6.00,5.85,5.85,-0.75,-11.36,4000,2,23700,0,0,0,0,0,0,2000,2000,0,0
20200430,06257P,臺股指群益97售10,,,,,0.00,0.00,0,0,0,0,0,0,0,0,0,0,0,0,0
20200430,06258P,臺股指群益97售11,,,,,0.00,0.00,0,0,0,0,0,0,0,0,0,0,0,0,0
20200430,06259P,臺股指群益97售12,,,,,0.00,0.00,0,0,0,0,0,0,0,0,0,0,0,0,0
20200430,06260P,臺股指群益97售13,,,,,0.00,0.00,0,0,0,0,0,0,0,0,0,0,0,0,0
20200430,06261P,上銀凱基97售03,,,,,0.00,0.00,0,0,0,0,0,0,0,0,0,0,0,0,0
20200430,06262P,國巨凱基97售07,1.87,1.87,1.87,1.87,-0.23,-10.95,8000,1,14960,0,0,0,0,0,0,8000,0,8000,8000
20200430,06263P,燿華凱基97售04,0.91,0.93,0.91,0.93,-0.16,-14.68,60000,2,55000,0,0,0,0,0,0,60000,0,60000,60000
20200430,06264P,友達凱基98售06,,,,,0.00,0.00,0,0,0,0,0,0,0,0,0,0,0,0,0
20200430,06265P,美律凱基97售01,,,,,0.00,0.00,0,0,0,0,0,0,0,0,0,0,0,0,0
20200430,06266P,大立光凱基97售11,,,,,0.00,0.00,0,0,0,0,0,0,0,0,0,0,0,0,0
20200430,06267P,大立光凱基97售12,,,,,0.00,0.00,0,0,0,0,0,0,0,0,0,0,0,0,0
20200430,06268P,聯詠凱基97售02,3.29,3.29,3.29,3.29,-0.16,-4.64,10000,1,32900,0,0,0,0,0,0,0,10000,-10000,-10000
20200430,06269P,群創凱基98售10,,,,,0.00,0.00,0,0,0,0,0,0,0,0,0,0,0,0,0
20200430,06270P,致伸凱基97售03,1.13,1.20,1.13,1.20,+0.07,6.19,130000,7,151100,0,0,0,0,0,0,70000,60000,10000,10000
20200430,06271P,彩晶凱基97售01,,,,,0.00,0.00,0,0,0,0,0,0,0,0,0,0,0,0,0
20200430,06272P,台郡凱基97售04,,,,,0.00,0.00,0,0,0,0,0,0,0,0,0,0,0,0,0
20200430,06273P,台表科凱基97售04,1.02,1.02,1.02,1.02,0.00,0.00,14000,2,14280,0,0,0,0,0,0,14000,0,14000,14000
20200430,06274P,臺股指凱基97售06,,,,,0.00,0.00,0,0,0,0,0,0,0,0,0,0,0,0,0
20200430,06275P,臺股指凱基97售07,,,,,0.00,0.00,0,0,0,0,0,0,0,0,0,0,0,0,0
20200430,06276P,臺股指凱基97售08,,,,,0.00,0.00,0,0,0,0,0,0,0,0,0,0,0,0,0
20200430,06277P,臺股指凱基97售09,,,,,0.00,0.00,0,0,0,0,0,0,0,0,0,0,0,0,0
20200430,06278P,臺股指凱基97售10,,,,,0.00,0.00,0,0,0,0,0,0,0,0,0,0,0,0,0
20200430,06279P,臺股指凱基97售11,,,,,0.00,0.00,0,0,0,0,0,0,0,0,0,0,0,0,0
20200430,06280P,臺股指凱基97售12,,,,,0.00,0.00,0,0,0,0,0,0,0,0,0,0,0,0,0
20200430,06281P,臺股指凱基97售13,,,,,0.00,0.00,0,0,0,0,0,0,0,0,0,0,0,0,0
20200430,06282P,聯鈞永豐97售02,1.51,1.58,1.51,1.58,+0.03,1.94,285000,11,445650,0,0,0,0,0,0,28000,257000,-229000,-229000
20200430,06283P,祥碩永豐97售01,0.29,0.37,0.29,0.37,+0.05,15.62,227000,7,66360,0,0,0,0,0,0,210000,17000,193000,193000
20200430,06284P,台積電國票98售03,7.80,7.95,7.80,7.90,-0.60,-7.06,121000,3,949950,0,0,0,0,0,0,60000,61000,-1000,-1000
20200430,06285P,台積電國票98售04,,,,,0.00,0.00,0,0,0,0,0,0,0,0,0,0,0,0,0
20200430,06286P,世芯國票97售02,0.56,0.56,0.55,0.55,-0.11,-16.67,13000,5,7170,0,0,0,0,0,0,2000,0,2000,2000
20200430,06287P,臺股指國票97售01,,,,,0.00,0.00,0,0,0,0,0,0,0,0,0,0,0,0,0
20200430,06288P,臺股指國票97售02,,,,,0.00,0.00,0,0,0,0,0,0,0,0,0,0,0,0,0
20200430,06289P,臺股指國票97售03,,,,,0.00,0.00,0,0,0,0,0,0,0,0,0,0,0,0,0
20200430,06290P,臺股指國票97售04,,,,,0.00,0.00,0,0,0,0,0,0,0,0,0,0,0,0,0
20200430,06291P,臺股指國票97售05,,,,,0.00,0.00,0,0,0,0,0,0,0,0,0,0,0,0,0
20200430,06292P,臺股指國票97售06,,,,,0.00,0.00,0,0,0,0,0,0,0,0,0,0,0,0,0
20200430,06293P,臺股指國票97售07,,,,,0.00,0.00,0,0,0,0,0,0,0,0,0,0,0,0,0
20200430,06294P,臺股指國票97售08,29.40,29.40,29.40,29.40,0.00,0.00,2000,1,58800,0,0,0,0,0,0,0,2000,-2000,-2000
20200430,06295P,國巨元大97售14,,,,,0.00,0.00,0,0,0,0,0,0,0,0,0,0,0,0,0
20200430,06296P,燿華元大98售01,1.96,1.96,1.93,1.93,-0.12,-5.85,69000,3,134940,0,0,0,0,0,0,59000,10000,49000,49000
20200430,06297P,美律元大97售01,,,,,0.00,0.00,0,0,0,0,0,0,0,0,0,0,0,0,0
20200430,06298P,聯發科元大97售20,2.09,2.09,2.09,2.09,0.00,0.00,10000,1,20900,0,0,0,0,0,0,10000,10000,0,0
20200430,06299P,可成元大97售04,,,,,0.00,0.00,0,0,0,0,0,0,0,0,0,0,0,0,0
20200430,06300P,緯穎元大97售04,,,,,0.00,0.00,0,0,0,0,0,0,0,0,0,0,0,0,0
20200430,06301P,臺股指元大97售04,,,,,0.00,0.00,0,0,0,0,0,0,0,0,0,0,0,0,0
20200430,06302P,臺股指元大97售06,,,,,0.00,0.00,0,0,0,0,0,0,0,0,0,0,0,0,0
20200430,06303P,臺股指元大97售09,,,,,0.00,0.00,0,0,0,0,0,0,0,0,0,0,0,0,0
20200430,06304P,臺股指元大97售10,,,,,0.00,0.00,0,0,0,0,0,0,0,0,0,0,0,0,0
20200430,06305P,臺股指元大97售11,,,,,0.00,0.00,0,0,0,0,0,0,0,0,0,0,0,0,0
20200430,06306P,臺股指元大97售12,,,,,0.00,0.00,0,0,0,0,0,0,0,0,0,0,0,0,0
20200430,06307P,聚陽元富97售02,,,,,0.00,0.00,0,0,0,0,0,0,0,0,0,0,0,0,0
20200430,06308P,國巨元富97售06,,,,,0.00,0.00,0,0,0,0,0,0,0,0,0,0,0,0,0
20200430,06309P,光罩元富97售03,,,,,0.00,0.00,0,0,0,0,0,0,0,0,0,0,0,0,0
20200430,06310P,精元元富97售02,,,,,0.00,0.00,0,0,0,0,0,0,0,0,0,0,0,0,0
20200430,06311P,嘉聯益元富97售02,,,,,0.00,0.00,0,0,0,0,0,0,0,0,0,0,0,0,0
20200430,06312P,樺漢元富97售02,,,,,0.00,0.00,0,0,0,0,0,0,0,0,0,0,0,0,0
20200430,06313P,訊芯元富97售01,,,,,0.00,0.00,0,0,0,0,0,0,0,0,0,0,0,0,0
20200430,06314P,GIS元富97售02,,,,,0.00,0.00,0,0,0,0,0,0,0,0,0,0,0,0,0
20200430,06315P,臺股指元富97售02,,,,,0.00,0.00,0,0,0,0,0,0,0,0,0,0,0,0,0
20200430,06316P,臺股指元富97售03,,,,,0.00,0.00,0,0,0,0,0,0,0,0,0,0,0,0,0
20200430,06317P,臺股指元富97售04,,,,,0.00,0.00,0,0,0,0,0,0,0,0,0,0,0,0,0
20200430,06318P,臺股指元富97售05,,,,,0.00,0.00,0,0,0,0,0,0,0,0,0,0,0,0,0
20200430,06319P,臺股指元富97售06,,,,,0.00,0.00,0,0,0,0,0,0,0,0,0,0,0,0,0
20200430,06320P,上銀統一97售04,,,,,0.00,0.00,0,0,0,0,0,0,0,0,0,0,0,0,0
20200430,06321P,台積電統一98售03,,,,,0.00,0.00,0,0,0,0,0,0,0,0,0,0,0,0,0
20200430,06322P,超眾統一97售04,,,,,0.00,0.00,0,0,0,0,0,0,0,0,0,0,0,0,0
20200430,06323P,台郡統一97售01,2.32,2.34,2.32,2.34,-0.02,-0.85,40000,5,93440,0,0,0,0,0,0,40000,0,40000,40000
20200430,06324P,TXFI0永昌99售02,,,,,0.00,0.00,0,0,0,0,0,0,0,0,0,0,0,0,0
20200430,06325P,TXFI0永昌99售03,,,,,0.00,0.00,0,0,0,0,0,0,0,0,0,0,0,0,0
20200430,06326P,鴻海中信01售01,1.39,1.40,1.39,1.40,0.00,0.00,10000,3,13950,0,0,0,0,0,0,0,0,0,0
20200430,06327P,台積電中信01售01,,,,,0.00,0.00,0,0,0,0,0,0,0,0,0,0,0,0,0
20200430,06328P,台積電中信01售02,1.10,1.10,1.10,1.10,-0.11,-9.09,15000,3,16500,0,0,0,0,0,0,6000,0,6000,6000
20200430,06329P,大立光兆豐97售04,2.00,2.00,1.91,1.91,-0.30,-13.57,9000,2,17370,0,0,0,0,0,0,9000,9000,0,0
20200430,06330P,南亞科群益97售03,,,,,0.00,0.00,0,0,0,0,0,0,0,0,0,0,0,0,0
20200430,06331P,南亞科群益97售04,,,,,0.00,0.00,0,0,0,0,0,0,0,0,0,0,0,0,0
20200430,06332P,世紀鋼群益98售01,0.72,0.72,0.67,0.68,-0.07,-9.33,390000,9,273830,0,0,0,0,0,0,151000,239000,-88000,-88000
20200430,06333P,臺股指群益9C售02,,,,,0.00,0.00,0,0,0,0,0,0,0,0,0,0,0,0,0
20200430,06334P,臺股指群益9C售03,,,,,0.00,0.00,0,0,0,0,0,0,0,0,0,0,0,0,0
20200430,06335P,台積電麥證97售02,,,,,0.00,0.00,0,0,0,0,0,0,0,0,0,0,0,0,0
20200430,06336P,鴻海元大98售05,,,,,0.00,0.00,0,0,0,0,0,0,0,0,0,0,0,0,0
20200430,06337P,祥碩元大97售05,0.61,0.79,0.61,0.78,+0.12,18.18,1703000,96,1230930,0,0,0,0,0,0,681000,1621000,-940000,-940000
20200430,06338P,亞德客統一97售02,1.54,1.54,1.25,1.25,-0.33,-20.89,18000,5,25930,0,0,0,0,0,0,2000,16000,-14000,-14000
20200430,06339P,上銀統一97售06,,,,,0.00,0.00,0,0,0,0,0,0,0,0,0,0,0,0,0
20200430,06340P,鴻海統一98售06,,,,,0.00,0.00,0,0,0,0,0,0,0,0,0,0,0,0,0
20200430,06341P,大立光統一97售08,,,,,0.00,0.00,0,0,0,0,0,0,0,0,0,0,0,0,0
20200430,06342P,世芯統一98售01,0.69,0.69,0.64,0.64,-0.13,-16.88,182000,16,121570,0,0,0,0,0,0,20000,162000,-142000,-142000
20200430,06343P,臺股指統一98售01,,,,,0.00,0.00,0,0,0,0,0,0,0,0,0,0,0,0,0
20200430,06344P,臺股指統一99售03,,,,,0.00,0.00,0,0,0,0,0,0,0,0,0,0,0,0,0
20200430,06345P,臺股指統一9A售01,,,,,0.00,0.00,0,0,0,0,0,0,0,0,0,0,0,0,0
20200430,06346P,聯鈞元富97售02,,,,,0.00,0.00,0,0,0,0,0,0,0,0,0,0,0,0,0
20200430,06347P,祥碩元富97售02,0.37,0.46,0.37,0.46,+0.06,15.0,107000,3,40130,0,0,0,0,0,0,107000,6000,101000,101000
20200430,06348P,鈺齊元富97售02,,,,,0.00,0.00,0,0,0,0,0,0,0,0,0,0,0,0,0
20200430,06349P,臺股指台新99售01,,,,,0.00,0.00,0,0,0,0,0,0,0,0,0,0,0,0,0
20200430,06350P,臺股指台新99售02,,,,,0.00,0.00,0,0,0,0,0,0,0,0,0,0,0,0,0
20200430,06351P,臺股指台新99售03,,,,,0.00,0.00,0,0,0,0,0,0,0,0,0,0,0,0,0
20200430,06352P,臺股指富邦99售02,,,,,0.00,0.00,0,0,0,0,0,0,0,0,0,0,0,0,0
20200430,06353P,電子類富邦99售02,0.97,0.97,0.97,0.97,-0.08,-7.62,1000,1,970,0,0,0,0,0,0,0,1000,-1000,-1000
20200430,06354P,大立光永豐97售04,,,,,0.00,0.00,0,0,0,0,0,0,0,0,0,0,0,0,0
20200430,06355P,聯茂永豐97售02,0.66,0.66,0.64,0.64,0.00,0.00,37000,4,24120,0,0,0,0,0,0,10000,27000,-17000,-17000
20200430,06356P,啟碁永豐97售01,,,,,0.00,0.00,0,0,0,0,0,0,0,0,0,0,0,0,0
20200430,06357P,臺股指永豐97售03,,,,,0.00,0.00,0,0,0,0,0,0,0,0,0,0,0,0,0
20200430,06358P,力成中信97售02,,,,,0.00,0.00,0,0,0,0,0,0,0,0,0,0,0,0,0
20200430,06359P,上銀群益97售03,4.66,4.66,4.66,4.66,0.00,0.00,1000,1,4660,0,0,0,0,0,0,0,1000,-1000,-1000
20200430,06360P,台積電群益97售05,,,,,0.00,0.00,0,0,0,0,0,0,0,0,0,0,0,0,0
20200430,06361P,聯發科群益97售06,,,,,0.00,0.00,0,0,0,0,0,0,0,0,0,0,0,0,0
20200430,06362P,臺股指麥證97售01,,,,,0.00,0.00,0,0,0,0,0,0,0,0,0,0,0,0,0
20200430,06363P,臺股指麥證97售02,,,,,0.00,0.00,0,0,0,0,0,0,0,0,0,0,0,0,0
20200430,06364P,鴻海凱基97售08,2.41,2.41,2.36,2.36,-0.11,-4.45,20000,2,47700,0,0,0,0,0,0,20000,0,20000,20000
20200430,06365P,鴻海凱基97售09,,,,,0.00,0.00,0,0,0,0,0,0,0,0,0,0,0,0,0
20200430,06366P,鴻海凱基97售10,,,,,0.00,0.00,0,0,0,0,0,0,0,0,0,0,0,0,0
20200430,06367P,台積電凱基97售14,,,,,0.00,0.00,0,0,0,0,0,0,0,0,0,0,0,0,0
20200430,06368P,台積電凱基97售15,4.88,4.94,4.70,4.70,0.00,0.00,46000,9,221660,0,0,0,0,0,0,39000,46000,-7000,-7000
20200430,06369P,台積電凱基97售16,,,,,0.00,0.00,0,0,0,0,0,0,0,0,0,0,0,0,0
20200430,06370P,貿聯凱基97售03,0.99,0.99,0.98,0.98,0.00,0.00,35000,2,34620,0,0,0,0,0,0,35000,35000,0,0
20200430,06371P,茂林國票98售04,2.26,2.35,2.26,2.31,-0.03,-1.28,44000,7,101360,0,0,0,0,0,0,25000,19000,6000,6000
20200430,06372P,聯發科元大97售21,,,,,0.00,0.00,0,0,0,0,0,0,0,0,0,0,0,0,0
20200430,06373P,聯發科元大97售22,1.27,1.27,1.27,1.27,-0.55,-30.22,20000,2,25400,0,0,0,0,0,0,20000,20000,0,0
20200430,06374P,台表科元大97售06,2.24,2.24,2.24,2.24,+0.02,0.9,22000,3,49280,0,0,0,0,0,0,2000,20000,-18000,-18000
20200430,06375P,矽力元大97售06,0.69,0.69,0.69,0.69,0.00,0.00,5000,1,3450,0,0,0,0,0,0,0,0,0,0
20200430,06376P,上銀統一99售01,2.72,2.72,2.41,2.45,0.00,0.00,31000,4,80750,0,0,0,0,0,0,0,31000,-31000,-31000
20200430,06377P,華通統一97售04,,,,,0.00,0.00,0,0,0,0,0,0,0,0,0,0,0,0,0
20200430,06378P,國巨統一97售08,4.03,4.08,4.01,4.08,-0.10,-2.39,10000,5,40530,0,0,0,0,0,0,1000,9000,-8000,-8000
20200430,06379P,群創統一97售05,,,,,0.00,0.00,0,0,0,0,0,0,0,0,0,0,0,0,0
20200430,06380P,臺股指統一98售02,9.95,9.95,9.95,9.95,0.00,0.00,2000,1,19900,0,0,0,0,0,0,0,2000,-2000,-2000
20200430,06381P,臺股指統一98售03,,,,,0.00,0.00,0,0,0,0,0,0,0,0,0,0,0,0,0
20200430,06382P,大毅元富97售02,0.51,0.51,0.49,0.50,-0.08,-13.79,24000,4,12000,0,0,0,0,0,0,0,24000,-24000,-24000
20200430,06383P,聯茂元富97售01,,,,,0.00,0.00,0,0,0,0,0,0,0,0,0,0,0,0,0
20200430,06384P,訊芯元富97售03,,,,,0.00,0.00,0,0,0,0,0,0,0,0,0,0,0,0,0
20200430,06385P,聯發科永豐97售02,0.93,0.94,0.90,0.90,-0.28,-23.73,209000,18,192960,0,0,0,0,0,0,142000,178000,-36000,-36000
20200430,06386P,欣興永豐97售03,2.51,2.55,2.51,2.55,0.00,0.00,9000,3,22680,0,0,0,0,0,0,0,9000,-9000,-9000
20200430,06387P,緯穎永豐97售02,0.59,0.64,0.47,0.49,-0.22,-30.99,356000,15,193340,0,0,0,0,0,0,267000,89000,178000,178000
20200430,06388P,鴻海兆豐97售04,,,,,0.00,0.00,0,0,0,0,0,0,0,0,0,0,0,0,0
20200430,06389P,聯發科兆豐97售01,,,,,0.00,0.00,0,0,0,0,0,0,0,0,0,0,0,0,0
20200430,06390P,美律國票97售03,,,,,0.00,0.00,0,0,0,0,0,0,0,0,0,0,0,0,0
20200430,06391P,上銀中信97售03,,,,,0.00,0.00,0,0,0,0,0,0,0,0,0,0,0,0,0
20200430,06392P,T50反1元大9A售01,1.49,1.51,1.49,1.51,+0.05,3.42,10000,2,15000,0,0,0,0,0,0,10000,0,10000,10000
20200430,06393P,台積電元大97售27,,,,,0.00,0.00,0,0,0,0,0,0,0,0,0,0,0,0,0
20200430,06394P,台積電元大97售28,4.16,4.16,4.16,4.16,0.00,0.00,10000,1,41600,0,0,0,0,0,0,0,10000,-10000,-10000
20200430,06395P,台積電元大97售29,3.71,3.71,3.71,3.71,0.00,0.00,50000,1,185500,0,0,0,0,0,0,50000,0,50000,50000
20200430,06396P,新日興康和97售01,1.33,1.39,1.33,1.39,+0.03,2.21,136000,5,183940,0,0,0,0,0,0,0,136000,-136000,-136000
20200430,06397P,T50反1凱基9A售03,0.92,0.92,0.92,0.92,+0.09,10.84,1000,1,920,0,0,0,0,0,0,1000,0,1000,1000
20200430,06398P,禾伸堂凱基97售02,0.67,0.67,0.65,0.65,-0.04,-5.8,20000,2,13200,0,0,0,0,0,0,10000,10000,0,0
20200430,06399P,台表科凱基97售05,2.50,2.58,2.50,2.53,-0.07,-2.69,24000,3,60920,0,0,0,0,0,0,14000,10000,4000,4000
20200430,06400P,鴻海元富97售12,,,,,0.00,0.00,0,0,0,0,0,0,0,0,0,0,0,0,0
20200430,06401P,鴻海元富97售13,,,,,0.00,0.00,0,0,0,0,0,0,0,0,0,0,0,0,0
20200430,06402P,鴻海元富97售14,,,,,0.00,0.00,0,0,0,0,0,0,0,0,0,0,0,0,0
20200430,06403P,鴻海元富97售15,,,,,0.00,0.00,0,0,0,0,0,0,0,0,0,0,0,0,0
20200430,06404P,鴻海元富97售16,,,,,0.00,0.00,0,0,0,0,0,0,0,0,0,0,0,0,0
20200430,06405P,億光元富97售02,,,,,0.00,0.00,0,0,0,0,0,0,0,0,0,0,0,0,0
20200430,06406P,可成元富97售04,,,,,0.00,0.00,0,0,0,0,0,0,0,0,0,0,0,0,0
20200430,06407P,創意元富97售02,,,,,0.00,0.00,0,0,0,0,0,0,0,0,0,0,0,0,0
20200430,06408P,聯茂元富97售02,,,,,0.00,0.00,0,0,0,0,0,0,0,0,0,0,0,0,0
20200430,06409P,康友元富97售03,,,,,0.00,0.00,0,0,0,0,0,0,0,0,0,0,0,0,0
20200430,06410P,祥碩統一97售01,,,,,0.00,0.00,0,0,0,0,0,0,0,0,0,0,0,0,0
20200430,06411P,晶相光永豐97售03,1.03,1.05,1.03,1.05,0.00,0.00,372000,6,388510,0,0,0,0,0,0,0,372000,-372000,-372000
20200430,06412P,南亞科日盛97售01,2.39,2.39,2.39,2.39,0.00,0.00,10000,1,23900,0,0,0,0,0,0,0,10000,-10000,-10000
20200430,06413P,聯發科凱基97售11,,,,,0.00,0.00,0,0,0,0,0,0,0,0,0,0,0,0,0
20200430,06414P,矽力凱基97售03,,,,,0.00,0.00,0,0,0,0,0,0,0,0,0,0,0,0,0
20200430,06415P,台積電群益97售07,,,,,0.00,0.00,0,0,0,0,0,0,0,0,0,0,0,0,0
20200430,06416P,大立光群益97售06,1.40,1.40,1.30,1.35,0.00,0.00,85000,5,116000,0,0,0,0,0,0,0,0,0,0
20200430,06417P,台積電兆豐97售03,,,,,0.00,0.00,0,0,0,0,0,0,0,0,0,0,0,0,0
20200430,06418P,T50反1統一9A售02,0.70,0.70,0.70,0.70,0.00,0.00,58000,3,40600,0,0,0,0,0,0,58000,0,58000,58000
20200430,06419P,國巨統一97售09,,,,,0.00,0.00,0,0,0,0,0,0,0,0,0,0,0,0,0
20200430,06420P,大立光統一98售06,,,,,0.00,0.00,0,0,0,0,0,0,0,0,0,0,0,0,0
20200430,06421P,嘉澤統一97售02,1.90,1.90,1.90,1.90,-0.04,-2.06,9000,1,17100,0,0,0,0,0,0,0,9000,-9000,-9000
20200430,06422P,勤誠統一98售01,,,,,0.00,0.00,0,0,0,0,0,0,0,0,0,0,0,0,0
20200430,06423P,亞光台新97售01,,,,,0.00,0.00,0,0,0,0,0,0,0,0,0,0,0,0,0
20200430,06424P,大成鋼永豐97售01,2.06,2.09,2.06,2.09,+0.01,0.48,19000,2,39440,0,0,0,0,0,0,9000,10000,-1000,-1000
20200430,06425P,TPK永豐97售02,,,,,0.00,0.00,0,0,0,0,0,0,0,0,0,0,0,0,0
20200430,06426P,T50正2元大9B售01,,,,,0.00,0.00,0,0,0,0,0,0,0,0,0,0,0,0,0
20200430,06427P,鴻海元大97售13,4.36,4.38,4.32,4.32,-0.15,-3.36,85000,5,369240,0,0,0,0,0,0,70000,85000,-15000,-15000
20200430,06428P,國巨元大97售17,,,,,0.00,0.00,0,0,0,0,0,0,0,0,0,0,0,0,0
20200430,06429P,大立光元大97售15,,,,,0.00,0.00,0,0,0,0,0,0,0,0,0,0,0,0,0
20200430,06430P,大立光元大97售16,,,,,0.00,0.00,0,0,0,0,0,0,0,0,0,0,0,0,0
20200430,06431P,新日興元大97售05,2.61,2.78,2.61,2.73,0.00,0.00,88000,7,236460,0,0,0,0,0,0,0,88000,-88000,-88000
20200430,06432P,上銀群益98售01,,,,,0.00,0.00,0,0,0,0,0,0,0,0,0,0,0,0,0
20200430,06433P,大立光群益99售01,,,,,0.00,0.00,0,0,0,0,0,0,0,0,0,0,0,0,0
20200430,06434P,超眾群益98售02,0.71,0.75,0.69,0.75,-0.01,-1.32,526000,17,377530,0,0,0,0,0,0,441000,435000,6000,6000
20200430,06435P,臺股指群益98售02,,,,,0.00,0.00,0,0,0,0,0,0,0,0,0,0,0,0,0
20200430,06436P,台光電國票98售04,,,,,0.00,0.00,0,0,0,0,0,0,0,0,0,0,0,0,0
20200430,06437P,玉晶光國票99售01,9.45,9.45,9.45,9.45,0.00,0.00,6000,1,56700,0,0,0,0,0,0,0,6000,-6000,-6000
20200430,06438P,玉晶光國票99售02,,,,,0.00,0.00,0,0,0,0,0,0,0,0,0,0,0,0,0
20200430,06439P,上銀凱基98售02,2.72,2.75,2.72,2.75,-0.11,-3.85,3000,2,8220,0,0,0,0,0,0,1000,2000,-1000,-1000
20200430,06440P,台積電凱基98售07,,,,,0.00,0.00,0,0,0,0,0,0,0,0,0,0,0,0,0
20200430,06441P,台積電凱基98售08,,,,,0.00,0.00,0,0,0,0,0,0,0,0,0,0,0,0,0
20200430,06443P,台積電凱基99售01,,,,,0.00,0.00,0,0,0,0,0,0,0,0,0,0,0,0,0
20200430,06444P,大立光凱基98售08,,,,,0.00,0.00,0,0,0,0,0,0,0,0,0,0,0,0,0
20200430,06445P,大立光凱基98售09,,,,,0.00,0.00,0,0,0,0,0,0,0,0,0,0,0,0,0
20200430,06446P,大立光凱基98售10,,,,,0.00,0.00,0,0,0,0,0,0,0,0,0,0,0,0,0
20200430,06447P,上銀元大98售01,3.07,3.08,2.71,2.76,-0.64,-18.82,298000,15,849300,0,0,0,0,0,0,130000,168000,-38000,-38000
20200430,06448P,華通元大99售01,,,,,0.00,0.00,0,0,0,0,0,0,0,0,0,0,0,0,0
20200430,06449P,台積電元大98售09,,,,,0.00,0.00,0,0,0,0,0,0,0,0,0,0,0,0,0
20200430,06450P,聯發科元大98售03,,,,,0.00,0.00,0,0,0,0,0,0,0,0,0,0,0,0,0
20200430,06451P,聯發科元大98售04,2.71,2.71,2.40,2.40,-0.84,-25.93,33000,7,84560,0,0,0,0,0,0,0,33000,-33000,-33000
20200430,06452P,大立光元大98售08,5.45,5.45,5.25,5.25,0.00,0.00,100000,10,535000,0,0,0,0,0,0,0,100000,-100000,-100000
20200430,06453P,群創元大9B售02,3.02,3.05,3.02,3.05,-0.02,-0.65,22000,3,66470,0,0,0,0,0,0,21000,1000,20000,20000
20200430,06454P,緯穎元大98售04,0.75,0.75,0.62,0.70,-0.15,-17.65,39000,6,27760,0,0,0,0,0,0,3000,25000,-22000,-22000
20200430,06455P,上銀統一99售03,,,,,0.00,0.00,0,0,0,0,0,0,0,0,0,0,0,0,0
20200430,06456P,聯發科統一98售03,1.24,1.27,1.14,1.14,-0.31,-21.38,106000,16,127170,0,0,0,0,0,0,41000,65000,-24000,-24000
20200430,06457P,玉晶光統一98售02,3.01,3.01,2.78,2.80,-0.34,-10.83,446000,27,1302040,0,0,0,0,0,0,216000,230000,-14000,-14000
20200430,06458P,玉晶光統一9A售02,2.72,2.72,2.55,2.56,-0.24,-8.57,233000,17,619380,0,0,0,0,0,0,39000,194000,-155000,-155000
20200430,06459P,亞德客元富98售01,2.17,2.17,2.17,2.17,0.00,0.00,1000,1,2170,0,0,0,0,0,0,0,1000,-1000,-1000
20200430,06460P,亞德客元富98售02,,,,,0.00,0.00,0,0,0,0,0,0,0,0,0,0,0,0,0
20200430,06461P,玉晶光國泰9A售01,2.62,2.62,2.45,2.45,-0.27,-9.93,6000,4,15280,0,0,0,0,0,0,4000,2000,2000,2000
20200430,06462P,鴻海富邦98售01,2.28,2.28,2.28,2.28,0.00,0.00,6000,2,13680,0,0,0,0,0,0,6000,0,6000,6000
20200430,06463P,大立光富邦9A售01,,,,,0.00,0.00,0,0,0,0,0,0,0,0,0,0,0,0,0
20200430,06464P,台光電亞東99售01,,,,,0.00,0.00,0,0,0,0,0,0,0,0,0,0,0,0,0
20200430,06465P,國巨統一98售04,1.28,1.33,1.26,1.33,-0.06,-4.32,252000,6,323810,0,0,0,0,0,0,87000,165000,-78000,-78000
20200430,06466P,台積電統一9B售01,2.97,2.97,2.94,2.94,-0.12,-3.92,11000,2,32640,0,0,0,0,0,0,1000,10000,-9000,-9000
20200430,06467P,旺宏統一98售01,1.95,1.95,1.95,1.95,-0.21,-9.72,13000,1,25350,0,0,0,0,0,0,13000,0,13000,13000
20200430,06468P,華新科統一98售02,,,,,0.00,0.00,0,0,0,0,0,0,0,0,0,0,0,0,0
20200430,06469P,臺股指凱基99售09,,,,,0.00,0.00,0,0,0,0,0,0,0,0,0,0,0,0,0
20200430,06470P,臺股指凱基99售10,,,,,0.00,0.00,0,0,0,0,0,0,0,0,0,0,0,0,0
20200430,06471P,臺股指凱基99售11,,,,,0.00,0.00,0,0,0,0,0,0,0,0,0,0,0,0,0
20200430,06472P,道瓊銀元大98售03,,,,,0.00,0.00,0,0,0,0,0,0,0,0,0,0,0,0,0
20200430,06473P,鴻海元大99售03,4.44,4.44,4.44,4.44,-0.20,-4.31,60000,3,266400,0,0,0,0,0,0,60000,60000,0,0
20200430,06474P,鴻海富邦98售03,,,,,0.00,0.00,0,0,0,0,0,0,0,0,0,0,0,0,0
20200430,06475P,牧德永豐98售03,1.25,1.25,1.25,1.25,-0.15,-10.71,15000,1,18750,0,0,0,0,0,0,15000,0,15000,15000
20200430,06476P,臺股指永豐98售01,,,,,0.00,0.00,0,0,0,0,0,0,0,0,0,0,0,0,0
20200430,06477P,緯穎國票99售02,1.04,1.04,0.93,0.94,-0.16,-14.55,1193000,9,1125370,0,0,0,0,0,0,1173000,129000,1044000,1044000
20200430,06478P,臺股指日盛9A售01,6.20,6.20,6.20,6.20,0.00,0.00,4000,1,24800,0,0,0,0,0,0,0,4000,-4000,-4000
20200430,06479P,聯發科中信99售02,0.43,0.46,0.40,0.40,-0.10,-20.0,422000,12,180690,0,0,0,0,0,0,76000,336000,-260000,-260000
20200430,06480P,上銀凱基98售04,6.70,6.95,6.70,6.95,0.00,0.00,10000,2,67500,0,0,0,0,0,0,10000,0,10000,10000
20200430,06481P,台積電凱基98售12,,,,,0.00,0.00,0,0,0,0,0,0,0,0,0,0,0,0,0
20200430,06482P,台積電凱基98售13,,,,,0.00,0.00,0,0,0,0,0,0,0,0,0,0,0,0,0
20200430,06483P,聯發科凱基98售10,5.05,5.05,5.05,5.05,-0.70,-12.17,1000,1,5050,0,0,0,0,0,0,1000,0,1000,1000
20200430,06484P,聯發科凱基98售11,,,,,0.00,0.00,0,0,0,0,0,0,0,0,0,0,0,0,0
20200430,06485P,玉晶光群益9A售02,4.00,4.00,4.00,4.00,-0.38,-8.68,1000,1,4000,0,0,0,0,0,0,0,1000,-1000,-1000
20200430,06486P,麗豐元大98售02,0.87,0.89,0.84,0.89,-0.04,-4.3,39000,5,33880,0,0,0,0,0,0,4000,39000,-35000,-35000
20200430,06487P,聯發科統一99售02,1.94,1.96,1.91,1.91,-0.33,-14.73,6000,6,11650,0,0,0,0,0,0,5000,1000,4000,4000
20200430,06488P,台積電元富98售05,,,,,0.00,0.00,0,0,0,0,0,0,0,0,0,0,0,0,0
20200430,06489P,台積電元富98售06,,,,,0.00,0.00,0,0,0,0,0,0,0,0,0,0,0,0,0
20200430,06490P,鴻海富邦99售02,0.75,0.75,0.74,0.74,-0.05,-6.33,53000,2,39720,0,0,0,0,0,0,50000,0,50000,50000
20200430,06491P,台積電富邦99售02,,,,,0.00,0.00,0,0,0,0,0,0,0,0,0,0,0,0,0
20200430,06492P,上銀永豐98售01,0.81,0.82,0.77,0.82,-0.36,-30.51,13000,4,10390,0,0,0,0,0,0,8000,5000,3000,3000
20200430,06493P,聯發科永豐98售02,,,,,0.00,0.00,0,0,0,0,0,0,0,0,0,0,0,0,0
20200430,06494P,鴻海永昌98售03,2.21,2.21,2.21,2.21,-0.15,-6.36,7000,1,15470,0,0,0,0,0,0,0,7000,-7000,-7000
20200430,06495P,華新科亞東9A售01,,,,,0.00,0.00,0,0,0,0,0,0,0,0,0,0,0,0,0
20200430,06496P,台灣50日盛98售01,3.25,3.30,3.20,3.20,-0.60,-15.79,81000,15,264490,0,0,0,0,0,0,0,66000,-66000,-66000
20200430,06497P,大立光凱基98售11,5.10,5.10,5.10,5.10,-0.25,-4.67,1000,1,5100,0,0,0,0,0,0,0,1000,-1000,-1000
20200430,06498P,臺股指元大9A售03,,,,,0.00,0.00,0,0,0,0,0,0,0,0,0,0,0,0,0
20200430,06499P,臺股指元大9A售04,,,,,0.00,0.00,0,0,0,0,0,0,0,0,0,0,0,0,0
20200430,06500P,臺股指元大9A售05,,,,,0.00,0.00,0,0,0,0,0,0,0,0,0,0,0,0,0
20200430,06501P,臺股指元大9A售06,7.60,7.60,7.40,7.40,-0.40,-5.13,9000,4,66900,0,0,0,0,0,0,0,9000,-9000,-9000
20200430,06502P,A50中信98售01,0.44,0.44,0.44,0.44,-0.06,-12.0,10000,1,4400,0,0,0,0,0,0,10000,0,10000,10000
20200430,06503P,臺股指中信9A售02,1.10,1.10,1.02,1.04,-0.13,-11.11,571000,30,601890,0,0,0,0,0,0,95000,475000,-380000,-380000
20200430,06504P,麗豐國票99售02,,,,,0.00,0.00,0,0,0,0,0,0,0,0,0,0,0,0,0
20200430,06505P,康控國票99售02,2.53,2.53,2.48,2.48,-0.52,-17.33,36000,3,89940,0,0,0,0,0,0,16000,20000,-4000,-4000
20200430,06506P,台郡國票99售02,1.00,1.01,0.99,0.99,-0.01,-1.0,68000,4,67980,0,0,0,0,0,0,0,68000,-68000,-68000
20200430,06507P,台表科國票99售01,1.36,1.40,1.36,1.39,-0.06,-4.14,79000,10,109260,0,0,0,0,0,0,28000,51000,-23000,-23000
20200430,06508P,台灣50統一98售01,,,,,0.00,0.00,0,0,0,0,0,0,0,0,0,0,0,0,0
20200430,06509P,鴻海群益98售03,,,,,0.00,0.00,0,0,0,0,0,0,0,0,0,0,0,0,0
20200430,06510P,燿華永豐98售03,,,,,0.00,0.00,0,0,0,0,0,0,0,0,0,0,0,0,0
20200430,06511P,元油2X中信9B售01,,,,,0.00,0.00,0,0,0,0,0,0,0,0,0,0,0,0,0
20200430,06512P,元油2X凱基9B售01,,,,,0.00,0.00,0,0,0,0,0,0,0,0,0,0,0,0,0
20200430,06513P,鴻海凱基98售10,,,,,0.00,0.00,0,0,0,0,0,0,0,0,0,0,0,0,0
20200430,06514P,國巨凱基98售05,1.30,1.30,1.30,1.30,0.00,0.00,30000,1,39000,0,0,0,0,0,0,30000,0,30000,30000
20200430,06515P,國巨凱基98售06,2.10,2.17,2.07,2.09,-0.15,-6.7,116000,10,243420,0,0,0,0,0,0,93000,23000,70000,70000
20200430,06516P,國巨凱基98售08,,,,,0.00,0.00,0,0,0,0,0,0,0,0,0,0,0,0,0
20200430,06517P,國巨凱基98售09,,,,,0.00,0.00,0,0,0,0,0,0,0,0,0,0,0,0,0
20200430,06518P,奇力新兆豐99售01,,,,,0.00,0.00,0,0,0,0,0,0,0,0,0,0,0,0,0
20200430,06519P,元油2X元大98售03,,,,,0.00,0.00,0,0,0,0,0,0,0,0,0,0,0,0,0
20200430,06520P,元油2X元大98售04,,,,,0.00,0.00,0,0,0,0,0,0,0,0,0,0,0,0,0
20200430,06521P,矽力元大98售01,,,,,0.00,0.00,0,0,0,0,0,0,0,0,0,0,0,0,0
20200430,06522P,元油2X群益9B售03,,,,,0.00,0.00,0,0,0,0,0,0,0,0,0,0,0,0,0
20200430,06523P,台積電麥證98售02,,,,,0.00,0.00,0,0,0,0,0,0,0,0,0,0,0,0,0
20200430,06524P,臺股指麥證98售02,,,,,0.00,0.00,0,0,0,0,0,0,0,0,0,0,0,0,0
20200430,06525P,上証2X國泰99售01,1.19,1.19,1.11,1.18,-0.06,-4.84,104000,8,121430,0,0,0,0,0,0,90000,14000,76000,76000
20200430,06526P,元油2X永豐98售03,,,,,0.00,0.00,0,0,0,0,0,0,0,0,0,0,0,0,0
20200430,06527P,T50正2富邦9C售01,4.27,4.27,4.27,4.27,-0.06,-1.39,2000,1,8540,0,0,0,0,0,0,0,2000,-2000,-2000
20200430,06528P,台積電富邦99售03,,,,,0.00,0.00,0,0,0,0,0,0,0,0,0,0,0,0,0
20200430,06529P,貿聯富邦99售03,1.04,1.04,1.01,1.03,-0.07,-6.36,175000,7,180350,0,0,0,0,0,0,75000,100000,-25000,-25000
20200430,06530P,元油2X元富98售13,,,,,0.00,0.00,0,0,0,0,0,0,0,0,0,0,0,0,0
20200430,06531P,元油2X元富98售14,,,,,0.00,0.00,0,0,0,0,0,0,0,0,0,0,0,0,0
20200430,06532P,友達元富98售04,,,,,0.00,0.00,0,0,0,0,0,0,0,0,0,0,0,0,0
20200430,06533P,上証2X中信9B售01,,,,,0.00,0.00,0,0,0,0,0,0,0,0,0,0,0,0,0
20200430,06534P,聯發科群益98售04,3.35,3.36,3.33,3.36,-0.39,-10.4,3000,3,10040,0,0,0,0,0,0,3000,0,3000,3000
20200430,06535P,可成群益99售02,3.24,3.24,3.15,3.15,+0.05,1.61,39000,2,124560,0,0,0,0,0,0,20000,19000,1000,1000
20200430,06536P,臺股指群益98售04,,,,,0.00,0.00,0,0,0,0,0,0,0,0,0,0,0,0,0
20200430,06537P,華通凱基98售04,1.02,1.02,1.02,1.02,0.00,0.00,2000,1,2040,0,0,0,0,0,0,2000,0,2000,2000
20200430,06538P,國巨凱基98售11,,,,,0.00,0.00,0,0,0,0,0,0,0,0,0,0,0,0,0
20200430,06539P,聯發科凱基98售12,,,,,0.00,0.00,0,0,0,0,0,0,0,0,0,0,0,0,0
20200430,06540P,聯發科凱基98售13,,,,,0.00,0.00,0,0,0,0,0,0,0,0,0,0,0,0,0
20200430,06541P,元油2X國票9A售02,,,,,0.00,0.00,0,0,0,0,0,0,0,0,0,0,0,0,0
20200430,06542P,台光電國票98售05,,,,,0.00,0.00,0,0,0,0,0,0,0,0,0,0,0,0,0
20200430,06543P,鴻海元大98售08,4.16,4.18,4.14,4.14,-0.19,-4.39,96000,5,399520,0,0,0,0,0,0,96000,96000,0,0
20200430,06544P,鴻海元大98售09,,,,,0.00,0.00,0,0,0,0,0,0,0,0,0,0,0,0,0
20200430,06545P,致茂元大98售01,2.47,2.70,2.47,2.70,-0.02,-0.74,82000,6,215360,0,0,0,0,0,0,60000,62000,-2000,-2000
20200430,06546P,聯發科元大98售05,,,,,0.00,0.00,0,0,0,0,0,0,0,0,0,0,0,0,0
20200430,06547P,大立光元大98售09,,,,,0.00,0.00,0,0,0,0,0,0,0,0,0,0,0,0,0
20200430,06548P,大立光元大98售10,9.70,9.70,9.25,9.25,0.00,0.00,8000,3,75700,0,0,0,0,0,0,8000,0,8000,8000
20200430,06549P,大立光元大98售11,4.74,4.74,4.74,4.74,0.00,0.00,1000,1,4740,0,0,0,0,0,0,0,1000,-1000,-1000
20200430,06550P,健策元大99售01,0.80,0.80,0.76,0.77,-0.05,-6.1,87000,9,68620,0,0,0,0,0,0,15000,72000,-57000,-57000
20200430,06551P,貿聯元大98售05,2.55,2.55,2.34,2.34,-0.32,-12.03,76000,4,183170,0,0,0,0,0,0,26000,50000,-24000,-24000
20200430,06552P,茂林元大99售02,,,,,0.00,0.00,0,0,0,0,0,0,0,0,0,0,0,0,0
20200430,06553P,訊芯元大98售05,,,,,0.00,0.00,0,0,0,0,0,0,0,0,0,0,0,0,0
20200430,06554P,臺股指元大99售06,,,,,0.00,0.00,0,0,0,0,0,0,0,0,0,0,0,0,0
20200430,06555P,臺股指元大99售07,,,,,0.00,0.00,0,0,0,0,0,0,0,0,0,0,0,0,0
20200430,06556P,臺股指元大99售08,,,,,0.00,0.00,0,0,0,0,0,0,0,0,0,0,0,0,0
20200430,06557P,台積電兆豐98售02,,,,,0.00,0.00,0,0,0,0,0,0,0,0,0,0,0,0,0
20200430,06558P,旺宏元富98售02,5.60,5.60,5.60,5.60,-0.50,-8.2,3000,1,16800,0,0,0,0,0,0,3000,0,3000,3000
20200430,06559P,玉晶光元富98售02,,,,,0.00,0.00,0,0,0,0,0,0,0,0,0,0,0,0,0
20200430,06560P,台積電統一98售07,,,,,0.00,0.00,0,0,0,0,0,0,0,0,0,0,0,0,0
20200430,06561P,台灣50國泰9A售01,,,,,0.00,0.00,0,0,0,0,0,0,0,0,0,0,0,0,0
20200430,06562P,台積電國泰99售02,,,,,0.00,0.00,0,0,0,0,0,0,0,0,0,0,0,0,0
20200430,06563P,元油2X富邦02售02,,,,,0.00,0.00,0,0,0,0,0,0,0,0,0,0,0,0,0
20200430,06564P,國巨富邦9A售04,,,,,0.00,0.00,0,0,0,0,0,0,0,0,0,0,0,0,0
20200430,06565P,元油2X永豐9A售01,,,,,0.00,0.00,0,0,0,0,0,0,0,0,0,0,0,0,0
20200430,06566P,華通永豐98售03,1.03,1.03,0.88,0.88,-0.32,-26.67,82000,9,76760,0,0,0,0,0,0,0,82000,-82000,-82000
20200430,06567P,鴻海永豐98售02,,,,,0.00,0.00,0,0,0,0,0,0,0,0,0,0,0,0,0
20200430,06568P,國巨永豐98售05,1.89,1.98,1.85,1.98,-0.07,-3.41,65000,8,124030,0,0,0,0,0,0,50000,15000,35000,35000
20200430,06569P,可成永豐98售01,0.73,0.73,0.73,0.73,0.00,0.00,49000,1,35770,0,0,0,0,0,0,0,49000,-49000,-49000
20200430,06570P,大立光永豐98售01,,,,,0.00,0.00,0,0,0,0,0,0,0,0,0,0,0,0,0
20200430,06571P,欣興永豐98售03,,,,,0.00,0.00,0,0,0,0,0,0,0,0,0,0,0,0,0
20200430,06572P,台積電永昌99售01,1.63,1.63,1.62,1.62,-0.17,-9.5,230000,5,374600,0,0,0,0,0,0,230000,210000,20000,20000
20200430,06573P,台積電永昌99售02,,,,,0.00,0.00,0,0,0,0,0,0,0,0,0,0,0,0,0
20200430,06574P,大立光永昌99售01,,,,,0.00,0.00,0,0,0,0,0,0,0,0,0,0,0,0,0
20200430,06575P,大立光永昌99售02,,,,,0.00,0.00,0,0,0,0,0,0,0,0,0,0,0,0,0
20200430,06576P,台光電群益98售03,,,,,0.00,0.00,0,0,0,0,0,0,0,0,0,0,0,0,0
20200430,06577P,聯發科日盛9A售02,,,,,0.00,0.00,0,0,0,0,0,0,0,0,0,0,0,0,0
20200430,06578P,華新科國票98售02,5.15,5.30,5.10,5.30,-0.20,-3.64,96000,4,491800,0,0,0,0,0,0,8000,88000,-80000,-80000
20200430,06579P,臺股指麥證98售03,1.50,1.50,1.50,1.50,0.00,0.00,1000,1,1500,0,0,0,0,0,0,0,0,0,0
20200430,06580P,元油2X凱基9A售06,,,,,0.00,0.00,0,0,0,0,0,0,0,0,0,0,0,0,0
20200430,06581P,南亞科凱基98售04,5.35,5.35,5.35,5.35,-0.20,-3.6,5000,1,26750,0,0,0,0,0,0,0,5000,-5000,-5000
20200430,06582P,可成凱基98售06,2.46,2.47,2.46,2.47,+0.02,0.82,5000,3,12340,0,0,0,0,0,0,5000,0,5000,5000
20200430,06583P,可成凱基98售07,,,,,0.00,0.00,0,0,0,0,0,0,0,0,0,0,0,0,0
20200430,06584P,欣興凱基98售03,1.34,1.36,1.34,1.36,-0.08,-5.56,67000,5,90390,0,0,0,0,0,0,12000,55000,-43000,-43000
20200430,06585P,鴻海元大99售04,,,,,0.00,0.00,0,0,0,0,0,0,0,0,0,0,0,0,0
20200430,06586P,鴻海元大9C售01,,,,,0.00,0.00,0,0,0,0,0,0,0,0,0,0,0,0,0
20200430,06587P,國巨元大98售13,3.03,3.09,3.03,3.07,0.00,0.00,30000,3,91900,0,0,0,0,0,0,0,30000,-30000,-30000
20200430,06588P,台積電元大98售11,,,,,0.00,0.00,0,0,0,0,0,0,0,0,0,0,0,0,0
20200430,06589P,台積電元大98售12,,,,,0.00,0.00,0,0,0,0,0,0,0,0,0,0,0,0,0
20200430,06590P,大立光元大98售13,,,,,0.00,0.00,0,0,0,0,0,0,0,0,0,0,0,0,0
20200430,06591P,大立光元大98售14,,,,,0.00,0.00,0,0,0,0,0,0,0,0,0,0,0,0,0
20200430,06592P,欣興元大98售04,2.52,2.52,2.52,2.52,0.00,0.00,25000,1,63000,0,0,0,0,0,0,0,25000,-25000,-25000
20200430,06593P,欣興元大98售05,2.18,2.23,2.12,2.23,-0.06,-2.62,148000,11,323900,0,0,0,0,0,0,118000,30000,88000,88000
20200430,06594P,立積元大98售01,1.20,1.21,1.10,1.17,-0.11,-8.59,482000,17,565810,0,0,0,0,0,0,352000,308000,44000,44000
20200430,06595P,祥碩元大98售03,1.92,1.92,1.92,1.92,0.00,0.00,3000,1,5760,0,0,0,0,0,0,3000,0,3000,3000
20200430,06596P,元油2X富邦02售03,,,,,0.00,0.00,0,0,0,0,0,0,0,0,0,0,0,0,0
20200430,06597P,國巨富邦9A售05,,,,,0.00,0.00,0,0,0,0,0,0,0,0,0,0,0,0,0
20200430,06598P,奇力新永豐98售02,1.70,1.70,1.70,1.70,-0.07,-3.95,68000,1,115600,0,0,0,0,0,0,68000,0,68000,68000
20200430,06599P,宏達電永豐98售02,1.97,1.97,1.96,1.97,-0.05,-2.48,19000,7,37280,0,0,0,0,0,0,19000,0,19000,19000
20200430,06600P,貿聯永豐98售01,1.00,1.00,1.00,1.00,0.00,0.00,2000,1,2000,0,0,0,0,0,0,2000,0,2000,2000
20200430,06601P,臺股指永豐98售04,,,,,0.00,0.00,0,0,0,0,0,0,0,0,0,0,0,0,0
20200430,06602P,國巨統一99售02,2.50,2.54,2.50,2.54,-0.04,-1.55,43000,7,107760,0,0,0,0,0,0,33000,10000,23000,23000
20200430,06603P,立積統一99售01,1.56,1.56,1.45,1.45,0.00,0.00,30000,2,44600,0,0,0,0,0,0,0,30000,-30000,-30000
20200430,06604P,聯發科元富02售02,,,,,0.00,0.00,0,0,0,0,0,0,0,0,0,0,0,0,0
20200430,06605P,玉晶光元富98售03,,,,,0.00,0.00,0,0,0,0,0,0,0,0,0,0,0,0,0
20200430,06606P,訊芯元富98售02,,,,,0.00,0.00,0,0,0,0,0,0,0,0,0,0,0,0,0
20200430,06607P,友達台新98售02,,,,,0.00,0.00,0,0,0,0,0,0,0,0,0,0,0,0,0
20200430,06608P,立積群益99售02,0.60,0.62,0.57,0.62,-0.04,-6.06,805000,9,471700,0,0,0,0,0,0,145000,660000,-515000,-515000
20200430,06609P,元油2X凱基9B售06,,,,,0.00,0.00,0,0,0,0,0,0,0,0,0,0,0,0,0
20200430,06610P,台積電凱基9A售03,,,,,0.00,0.00,0,0,0,0,0,0,0,0,0,0,0,0,0
20200430,06611P,祥碩國票98售01,1.62,1.89,1.62,1.87,+0.14,8.09,61000,8,110340,0,0,0,0,0,0,11000,50000,-39000,-39000
20200430,06612P,元油2X富邦9B售03,,,,,0.00,0.00,0,0,0,0,0,0,0,0,0,0,0,0,0
20200430,06613P,華新科富邦9A售03,,,,,0.00,0.00,0,0,0,0,0,0,0,0,0,0,0,0,0
20200430,06614P,祥碩永豐98售03,0.78,0.92,0.78,0.89,+0.07,8.54,365000,14,319920,0,0,0,0,0,0,6000,358000,-352000,-352000
20200430,06615P,鴻海元大9C售02,2.66,2.66,2.60,2.60,-0.23,-8.13,56000,2,145960,0,0,0,0,0,0,56000,0,56000,56000
20200430,06616P,國巨元大98售15,,,,,0.00,0.00,0,0,0,0,0,0,0,0,0,0,0,0,0
20200430,06617P,智邦元大98售03,0.52,0.60,0.52,0.58,+0.01,1.75,445000,25,254700,0,0,0,0,0,0,16000,421000,-405000,-405000
20200430,06618P,智邦元大98售04,0.29,0.38,0.29,0.38,0.00,0.00,4000,2,1430,0,0,0,0,0,0,1000,0,1000,1000
20200430,06619P,聯發科元大98售06,,,,,0.00,0.00,0,0,0,0,0,0,0,0,0,0,0,0,0
20200430,06620P,聯發科元大98售07,,,,,0.00,0.00,0,0,0,0,0,0,0,0,0,0,0,0,0
20200430,06621P,欣興元大98售06,2.69,2.69,2.69,2.69,-0.19,-6.6,25000,1,67250,0,0,0,0,0,0,0,25000,-25000,-25000
20200430,06622P,牧德元大98售01,1.64,1.65,1.57,1.61,-0.08,-4.73,103000,9,168860,0,0,0,0,0,0,20000,77000,-57000,-57000
20200430,06623P,立積元大98售04,1.04,1.04,1.04,1.04,0.00,0.00,10000,1,10400,0,0,0,0,0,0,0,10000,-10000,-10000
20200430,06624P,訊芯元大98售06,1.60,1.60,1.60,1.60,0.00,0.00,52000,2,83200,0,0,0,0,0,0,0,52000,-52000,-52000
20200430,06625P,華新科統一98售03,3.78,3.86,3.78,3.86,0.00,0.00,42000,5,160420,0,0,0,0,0,0,0,42000,-42000,-42000
20200430,06626P,大立光統一9A售01,2.78,2.78,2.75,2.76,-0.14,-4.83,85000,8,235360,0,0,0,0,0,0,27000,58000,-31000,-31000
20200430,06627P,華新科元富99售01,,,,,0.00,0.00,0,0,0,0,0,0,0,0,0,0,0,0,0
20200430,06628P,訊芯元富98售03,,,,,0.00,0.00,0,0,0,0,0,0,0,0,0,0,0,0,0
20200430,06629P,台灣50第一98售01,,,,,0.00,0.00,0,0,0,0,0,0,0,0,0,0,0,0,0
20200430,06630P,國巨群益98售08,,,,,0.00,0.00,0,0,0,0,0,0,0,0,0,0,0,0,0
20200430,06631P,玉晶光群益9A售03,2.39,2.40,2.30,2.30,-0.22,-8.73,92000,5,215380,0,0,0,0,0,0,77000,15000,62000,62000
20200430,06632P,創意群益98售03,1.42,1.42,1.36,1.36,0.00,0.00,150000,3,210000,0,0,0,0,0,0,0,150000,-150000,-150000
20200430,06633P,國巨國票99售01,4.61,4.61,4.59,4.60,-0.10,-2.13,53000,3,243550,0,0,0,0,0,0,0,53000,-53000,-53000
20200430,06634P,欣興國票98售02,2.31,2.31,2.30,2.30,-0.16,-6.5,2000,2,4610,0,0,0,0,0,0,2000,0,2000,2000
20200430,06635P,聯發科凱基98售15,,,,,0.00,0.00,0,0,0,0,0,0,0,0,0,0,0,0,0
20200430,06636P,可成凱基98售08,1.02,1.02,1.02,1.02,+0.04,4.08,1000,1,1020,0,0,0,0,0,0,1000,0,1000,1000
20200430,06637P,大立光凱基98售15,2.90,2.90,2.59,2.59,0.00,0.00,37000,6,103960,0,0,0,0,0,0,20000,37000,-17000,-17000
20200430,06638P,鴻海統一99售02,1.31,1.34,1.31,1.34,0.00,0.00,39000,4,51960,0,0,0,0,0,0,0,39000,-39000,-39000
20200430,06639P,訊芯元富98售04,,,,,0.00,0.00,0,0,0,0,0,0,0,0,0,0,0,0,0
20200430,06640P,國巨兆豐99售02,1.03,1.03,1.03,1.03,-0.08,-7.21,2000,1,2060,0,0,0,0,0,0,0,2000,-2000,-2000
20200430,06641P,智邦兆豐99售01,0.36,0.36,0.36,0.36,+0.01,2.86,25000,1,9000,0,0,0,0,0,0,25000,0,25000,25000
20200430,06642P,可成兆豐98售01,,,,,0.00,0.00,0,0,0,0,0,0,0,0,0,0,0,0,0
20200430,06643P,大立光兆豐98售01,1.30,1.30,1.30,1.30,0.00,0.00,2000,1,2600,0,0,0,0,0,0,2000,0,2000,2000
20200430,06644P,亞德客元大98售03,1.78,1.78,1.42,1.42,0.00,0.00,9000,5,14220,0,0,0,0,0,0,4000,5000,-1000,-1000
20200430,06645P,上銀元大98售05,2.74,2.74,2.41,2.41,0.00,0.00,13000,4,33160,0,0,0,0,0,0,0,13000,-13000,-13000
20200430,06646P,國巨元大98售16,,,,,0.00,0.00,0,0,0,0,0,0,0,0,0,0,0,0,0
20200430,06647P,台積電元大98售13,3.87,3.87,3.87,3.87,-0.39,-9.15,10000,1,38700,0,0,0,0,0,0,10000,10000,0,0
20200430,06648P,華邦電元大98售03,1.88,1.88,1.88,1.88,0.00,0.00,143000,1,268840,0,0,0,0,0,0,143000,0,143000,143000
20200430,06649P,聯發科元大98售08,1.54,1.54,1.35,1.35,-0.42,-23.73,60000,8,83130,0,0,0,0,0,0,50000,10000,40000,40000
20200430,06650P,聯發科元大98售09,0.73,0.73,0.73,0.73,-0.14,-16.09,7000,1,5110,0,0,0,0,0,0,0,0,0,0
20200430,06651P,華新科元大99售09,,,,,0.00,0.00,0,0,0,0,0,0,0,0,0,0,0,0,0
20200430,06652P,長榮航元大98售01,0.93,0.97,0.92,0.97,-0.07,-6.73,90000,16,84800,0,0,0,0,0,0,0,20000,-20000,-20000
20200430,06653P,美食元大98售02,1.46,1.46,1.25,1.25,-0.26,-17.22,315000,9,424170,0,0,0,0,0,0,289000,26000,263000,263000
20200430,06654P,欣興元大98售08,1.71,1.83,1.71,1.79,-0.12,-6.28,319000,16,566830,0,0,0,0,0,0,214000,105000,109000,109000
20200430,06655P,TPK元大98售02,1.22,1.30,1.22,1.30,+0.07,5.69,238000,5,303550,0,0,0,0,0,0,2000,236000,-234000,-234000
20200430,06656P,GIS元大98售02,1.90,1.93,1.90,1.93,-0.06,-3.02,80000,9,153400,0,0,0,0,0,0,80000,80000,0,0
20200430,06657P,寶成元大98售01,3.13,3.22,3.10,3.10,-0.12,-3.73,450000,40,1412210,0,0,0,0,0,0,220000,204000,16000,16000
20200430,06658P,台灣50富邦9C售01,6.90,6.90,6.60,6.60,-0.70,-9.59,300000,30,2043500,0,0,0,0,0,0,300000,300000,0,0
20200430,06659P,T50正2富邦9A售01,,,,,0.00,0.00,0,0,0,0,0,0,0,0,0,0,0,0,0
20200430,06660P,大立光富邦9B售03,1.65,1.65,1.63,1.64,-0.22,-11.83,25000,5,41070,0,0,0,0,0,0,0,12000,-12000,-12000
20200430,06661P,玉晶光永豐98售05,1.00,1.00,0.90,0.90,-0.19,-17.43,97000,7,92490,0,0,0,0,0,0,77000,20000,57000,57000
20200430,06662P,玉晶光中信9A售01,0.49,0.49,0.45,0.46,-0.06,-11.54,1078000,38,511860,0,0,0,0,0,0,282000,731000,-449000,-449000
20200430,06663P,鴻海兆豐98售03,,,,,0.00,0.00,0,0,0,0,0,0,0,0,0,0,0,0,0
20200430,06664P,聯發科兆豐98售02,,,,,0.00,0.00,0,0,0,0,0,0,0,0,0,0,0,0,0
20200430,06665P,欣興兆豐99售01,,,,,0.00,0.00,0,0,0,0,0,0,0,0,0,0,0,0,0
20200430,06666P,台積電日盛9A售02,2.44,2.44,2.44,2.44,0.00,0.00,20000,1,48800,0,0,0,0,0,0,20000,0,20000,20000
20200430,06667P,鴻海凱基98售11,2.03,2.03,1.95,1.95,-0.15,-7.14,28000,5,55480,0,0,0,0,0,0,11000,17000,-6000,-6000
20200430,06668P,祥碩凱基98售02,0.84,1.00,0.84,0.97,+0.06,6.59,177000,10,158910,0,0,0,0,0,0,116000,160000,-44000,-44000
20200430,06669P,緯穎凱基98售05,,,,,0.00,0.00,0,0,0,0,0,0,0,0,0,0,0,0,0
20200430,06670P,鴻海群益98售06,,,,,0.00,0.00,0,0,0,0,0,0,0,0,0,0,0,0,0
20200430,06671P,台積電群益98售04,,,,,0.00,0.00,0,0,0,0,0,0,0,0,0,0,0,0,0
20200430,06672P,聯發科群益98售05,2.29,2.29,2.27,2.27,-0.33,-12.69,10000,10,22860,0,0,0,0,0,0,10000,0,10000,10000
20200430,06673P,大立光群益98售01,4.43,4.43,4.40,4.40,-0.25,-5.38,10000,2,44150,0,0,0,0,0,0,10000,0,10000,10000
20200430,06674P,祥碩群益98售02,1.11,1.33,1.11,1.29,+0.09,7.5,1222000,51,1485040,0,0,0,0,0,0,652000,721000,-69000,-69000
20200430,06675P,國巨國票99售02,,,,,0.00,0.00,0,0,0,0,0,0,0,0,0,0,0,0,0
20200430,06676P,華新科國票98售03,3.91,3.98,3.85,3.98,-0.10,-2.45,42000,7,163650,0,0,0,0,0,0,26000,16000,10000,10000
20200430,06677P,牧德國票98售02,4.60,4.75,4.58,4.58,-0.36,-7.29,25000,13,116610,0,0,0,0,0,0,13000,12000,1000,1000
20200430,06678P,大立光統一99售01,,,,,0.00,0.00,0,0,0,0,0,0,0,0,0,0,0,0,0
20200430,06679P,旺宏元大98售09,1.40,1.41,1.40,1.41,-0.14,-9.03,20000,2,28100,0,0,0,0,0,0,0,20000,-20000,-20000
20200430,06680P,智邦元大98售06,0.74,0.84,0.70,0.82,+0.05,6.49,1210000,57,947100,0,0,0,0,0,0,542000,803000,-261000,-261000
20200430,06681P,致茂元大98售02,2.63,2.90,2.63,2.90,-0.03,-1.02,29000,3,80000,0,0,0,0,0,0,10000,19000,-9000,-9000
20200430,06682P,玉晶光元大99售08,,,,,0.00,0.00,0,0,0,0,0,0,0,0,0,0,0,0,0
20200430,06683P,訊芯元大98售07,,,,,0.00,0.00,0,0,0,0,0,0,0,0,0,0,0,0,0
20200430,06684P,緯穎元大98售06,1.07,1.07,0.98,0.99,-0.14,-12.39,136000,15,142590,0,0,0,0,0,0,0,136000,-136000,-136000
20200430,06685P,鴻海國泰9A售01,,,,,0.00,0.00,0,0,0,0,0,0,0,0,0,0,0,0,0
20200430,06686P,麗豐永豐98售02,,,,,0.00,0.00,0,0,0,0,0,0,0,0,0,0,0,0,0
20200430,06687P,A50正2中信9A售01,1.19,1.19,1.19,1.19,0.00,0.00,10000,1,11900,0,0,0,0,0,0,0,10000,-10000,-10000
20200430,06688P,鴻海中信02售01,,,,,0.00,0.00,0,0,0,0,0,0,0,0,0,0,0,0,0
20200430,06689P,鴻海中信9C售02,,,,,0.00,0.00,0,0,0,0,0,0,0,0,0,0,0,0,0
20200430,06690P,玉晶光群益9A售05,,,,,0.00,0.00,0,0,0,0,0,0,0,0,0,0,0,0,0
20200430,06691P,臺股指群益9C售05,14.90,14.90,14.50,14.50,-0.90,-5.84,13000,5,191200,0,0,0,0,0,0,5000,8000,-3000,-3000
20200430,06692P,瑞昱凱基98售03,,,,,0.00,0.00,0,0,0,0,0,0,0,0,0,0,0,0,0
20200430,06693P,臺股指凱基98售01,,,,,0.00,0.00,0,0,0,0,0,0,0,0,0,0,0,0,0
20200430,06694P,臺股指凱基99售13,,,,,0.00,0.00,0,0,0,0,0,0,0,0,0,0,0,0,0
20200430,06695P,群創兆豐98售04,,,,,0.00,0.00,0,0,0,0,0,0,0,0,0,0,0,0,0
20200430,06696P,台灣50國票99售01,,,,,0.00,0.00,0,0,0,0,0,0,0,0,0,0,0,0,0
20200430,06697P,台積電國票99售05,,,,,0.00,0.00,0,0,0,0,0,0,0,0,0,0,0,0,0
20200430,06698P,玉晶光國票99售05,,,,,0.00,0.00,0,0,0,0,0,0,0,0,0,0,0,0,0
20200430,06699P,台積電統一98售11,,,,,0.00,0.00,0,0,0,0,0,0,0,0,0,0,0,0,0
20200430,06700P,臺股指統一99售05,,,,,0.00,0.00,0,0,0,0,0,0,0,0,0,0,0,0,0
20200430,06701P,臺股指統一99售06,2.94,2.95,2.72,2.72,-0.44,-13.92,152000,12,429830,0,0,0,0,0,0,52000,100000,-48000,-48000
20200430,06702P,智邦元富98售01,0.69,0.79,0.68,0.79,+0.04,5.33,232000,15,170920,0,0,0,0,0,0,62000,170000,-108000,-108000
20200430,06703P,新日興元富98售02,,,,,0.00,0.00,0,0,0,0,0,0,0,0,0,0,0,0,0
20200430,06704P,玉晶光元富98售05,,,,,0.00,0.00,0,0,0,0,0,0,0,0,0,0,0,0,0
20200430,06705P,臻鼎元富98售03,,,,,0.00,0.00,0,0,0,0,0,0,0,0,0,0,0,0,0
20200430,06706P,智原台新98售02,1.19,1.19,1.19,1.19,0.00,0.00,1000,1,1190,0,0,0,0,0,0,0,1000,-1000,-1000
20200430,06707P,臺股指台新99售04,,,,,0.00,0.00,0,0,0,0,0,0,0,0,0,0,0,0,0
20200430,06708P,臺股指台新99售05,,,,,0.00,0.00,0,0,0,0,0,0,0,0,0,0,0,0,0
20200430,06709P,臺股指台新99售06,,,,,0.00,0.00,0,0,0,0,0,0,0,0,0,0,0,0,0
20200430,06710P,臺股指台新99售07,9.75,9.75,9.25,9.25,0.00,0.00,140000,14,1319000,0,0,0,0,0,0,140000,120000,20000,20000
20200430,06711P,臺股指台新99售08,10.00,10.00,10.00,10.00,0.00,0.00,10000,1,100000,0,0,0,0,0,0,10000,10000,0,0
20200430,06712P,臺股指台新99售09,0.30,0.30,0.30,0.30,0.00,0.00,30000,7,9000,0,0,0,0,0,0,0,30000,-30000,-30000
20200430,06713P,臺股指富邦99售04,,,,,0.00,0.00,0,0,0,0,0,0,0,0,0,0,0,0,0
20200430,06714P,台積電元大98售15,,,,,0.00,0.00,0,0,0,0,0,0,0,0,0,0,0,0,0
20200430,06715P,台積電元大99售04,,,,,0.00,0.00,0,0,0,0,0,0,0,0,0,0,0,0,0
20200430,06716P,台積電元大9A售02,4.15,4.15,4.15,4.15,-0.43,-9.39,10000,1,41500,0,0,0,0,0,0,10000,10000,0,0
20200430,06717P,可成元大98售09,,,,,0.00,0.00,0,0,0,0,0,0,0,0,0,0,0,0,0
20200430,06718P,聯詠元大98售01,4.42,4.42,4.10,4.10,-0.24,-5.53,40000,2,173600,0,0,0,0,0,0,0,40000,-40000,-40000
20200430,06719P,台灣50群益9A售01,,,,,0.00,0.00,0,0,0,0,0,0,0,0,0,0,0,0,0
20200430,06720P,智邦亞東99售01,0.37,0.40,0.37,0.40,+0.04,11.11,23000,3,8600,0,0,0,0,0,0,0,0,0,0
20200430,06721P,臺股指中信9A售03,1.94,1.95,1.86,1.87,-0.15,-7.43,384000,13,725720,0,0,0,0,0,0,248000,136000,112000,112000
20200430,06722P,臺股指中信9A售04,2.60,2.60,2.59,2.59,-0.33,-11.3,31000,4,80300,0,0,0,0,0,0,0,31000,-31000,-31000
20200430,06723P,台灣50麥證99售01,6.80,6.80,6.50,6.50,-0.80,-10.96,192000,21,1280150,0,192000,-192000,0,0,0,190000,192000,-2000,-2000
20200430,06724P,台灣50國票98售01,,,,,0.00,0.00,0,0,0,0,0,0,0,0,0,0,0,0,0
20200430,06725P,聯電元富98售01,1.36,1.36,1.36,1.36,0.00,0.00,3000,1,4080,0,0,0,0,0,0,0,3000,-3000,-3000
20200430,06726P,欣興元富98售04,3.25,3.26,3.24,3.26,-0.17,-4.96,3000,3,9750,0,0,0,0,0,0,1000,2000,-1000,-1000
20200430,06727P,台光電元大98售05,,,,,0.00,0.00,0,0,0,0,0,0,0,0,0,0,0,0,0
20200430,06728P,全新元大98售03,2.11,2.14,2.10,2.11,+0.02,0.96,144000,6,304380,0,0,0,0,0,0,26000,113000,-87000,-87000
20200430,06729P,聯詠元大98售03,4.51,4.51,4.51,4.51,-0.03,-0.66,30000,1,135300,0,0,0,0,0,0,0,30000,-30000,-30000
20200430,06730P,祥碩元大98售07,,,,,0.00,0.00,0,0,0,0,0,0,0,0,0,0,0,0,0
20200430,06731P,聯茂元大98售05,,,,,0.00,0.00,0,0,0,0,0,0,0,0,0,0,0,0,0
20200430,06732P,台灣50日盛9A售01,,,,,0.00,0.00,0,0,0,0,0,0,0,0,0,0,0,0,0
20200430,06733P,鴻海凱基99售02,,,,,0.00,0.00,0,0,0,0,0,0,0,0,0,0,0,0,0
20200430,06734P,智邦凱基98售05,0.89,1.00,0.89,0.99,+0.03,3.12,58000,5,55980,0,0,0,0,0,0,55000,3000,52000,52000
20200430,06735P,奇力新凱基98售07,,,,,0.00,0.00,0,0,0,0,0,0,0,0,0,0,0,0,0
20200430,06736P,新日興凱基98售03,0.83,0.85,0.83,0.83,+0.01,1.22,82000,23,68560,0,0,0,0,0,0,20000,42000,-22000,-22000
20200430,06737P,台郡凱基98售07,1.62,1.62,1.59,1.59,-0.04,-2.45,30000,3,48200,0,0,0,0,0,0,10000,30000,-20000,-20000
20200430,06738P,瑞昱兆豐98售02,0.72,0.72,0.69,0.69,-0.10,-12.66,15000,2,10500,0,0,0,0,0,0,5000,10000,-5000,-5000
20200430,06739P,聯詠兆豐98售02,1.07,1.07,1.03,1.03,-0.04,-3.74,32000,4,33560,0,0,0,0,0,0,2000,30000,-28000,-28000
20200430,06740P,台灣50國泰9A售02,,,,,0.00,0.00,0,0,0,0,0,0,0,0,0,0,0,0,0
20200430,06741P,台積電富邦98售04,2.48,2.48,2.40,2.40,-0.30,-11.11,240000,24,584300,0,0,0,0,0,0,240000,240000,0,0
20200430,06742P,可成富邦99售02,,,,,0.00,0.00,0,0,0,0,0,0,0,0,0,0,0,0,0
20200430,06743P,創意永豐98售03,0.98,0.98,0.96,0.96,-0.06,-5.88,189000,17,183250,0,0,0,0,0,0,83000,68000,15000,15000
20200430,06744P,嘉聯益永豐98售03,1.60,1.64,1.60,1.64,-0.09,-5.2,77000,2,124080,0,0,0,0,0,0,55000,77000,-22000,-22000
20200430,06745P,台積電群益98售05,,,,,0.00,0.00,0,0,0,0,0,0,0,0,0,0,0,0,0
20200430,06746P,聯發科群益99售02,,,,,0.00,0.00,0,0,0,0,0,0,0,0,0,0,0,0,0
20200430,06747P,大立光群益99售04,,,,,0.00,0.00,0,0,0,0,0,0,0,0,0,0,0,0,0
20200430,06748P,智邦台新98售02,0.47,0.56,0.47,0.50,0.00,0.00,830000,38,434350,0,0,0,0,0,0,600000,155000,445000,445000
20200430,06749P,技嘉元富98售03,,,,,0.00,0.00,0,0,0,0,0,0,0,0,0,0,0,0,0
20200430,06750P,聯發科元富02售03,2.54,2.54,2.44,2.44,-0.23,-8.61,261000,28,651680,0,0,0,0,0,0,47000,204000,-157000,-157000
20200430,06751P,旺宏凱基98售10,2.45,2.51,2.45,2.47,-0.21,-7.84,91000,10,224930,0,0,0,0,0,0,40000,51000,-11000,-11000
20200430,06752P,訊芯凱基98售05,1.82,1.82,1.82,1.82,-0.04,-2.15,25000,1,45500,0,0,0,0,0,0,25000,0,25000,25000
20200430,06753P,智邦富邦98售03,0.93,0.93,0.92,0.92,+0.02,2.22,61000,2,56610,0,0,0,0,0,0,61000,0,61000,61000
20200430,06754P,台積電永豐98售03,,,,,0.00,0.00,0,0,0,0,0,0,0,0,0,0,0,0,0
20200430,06755P,大立光永豐98售03,,,,,0.00,0.00,0,0,0,0,0,0,0,0,0,0,0,0,0
20200430,06756P,臺股指永豐98售05,,,,,0.00,0.00,0,0,0,0,0,0,0,0,0,0,0,0,0
20200430,06757P,台灣50元大9B售01,,,,,0.00,0.00,0,0,0,0,0,0,0,0,0,0,0,0,0
20200430,06758P,鴻海元大98售10,,,,,0.00,0.00,0,0,0,0,0,0,0,0,0,0,0,0,0
20200430,06759P,台積電元大98售17,3.62,3.62,3.62,3.62,-0.37,-9.27,2000,1,7240,0,0,0,0,0,0,2000,2000,0,0
20200430,06760P,台積電元大98售18,,,,,0.00,0.00,0,0,0,0,0,0,0,0,0,0,0,0,0
20200430,06761P,台積電元大99售05,2.87,2.87,2.87,2.87,0.00,0.00,2000,1,5740,0,0,0,0,0,0,2000,0,2000,2000
20200430,06762P,智邦元大98售11,0.80,0.80,0.80,0.80,+0.04,5.26,5000,1,4000,0,0,0,0,0,0,5000,0,5000,5000
20200430,06763P,技嘉元大98售05,3.48,3.61,3.48,3.59,-0.04,-1.1,66000,6,235640,0,0,0,0,0,0,38000,11000,27000,27000
20200430,06764P,聯發科元大98售11,2.08,2.08,2.08,2.08,0.00,0.00,1000,1,2080,0,0,0,0,0,0,0,1000,-1000,-1000
20200430,06765P,欣興元大98售11,2.41,2.53,2.41,2.50,-0.14,-5.3,95000,19,236760,0,0,0,0,0,0,12000,83000,-71000,-71000
20200430,06766P,玉晶光元大99售10,1.88,1.88,1.79,1.79,-0.16,-8.21,365000,20,674810,0,0,0,0,0,0,227000,138000,89000,89000
20200430,06767P,台積電永昌99售03,3.02,3.02,2.90,2.90,-0.53,-15.45,36000,7,106160,0,0,0,0,0,0,20000,36000,-16000,-16000
20200430,06768P,臺股指永昌98售02,,,,,0.00,0.00,0,0,0,0,0,0,0,0,0,0,0,0,0
20200430,06769P,臺股指永昌98售03,,,,,0.00,0.00,0,0,0,0,0,0,0,0,0,0,0,0,0
20200430,06770P,台灣50第一9C售01,,,,,0.00,0.00,0,0,0,0,0,0,0,0,0,0,0,0,0
20200430,06771P,台灣50中信02售01,3.56,3.56,3.51,3.51,-0.18,-4.88,17000,3,60190,0,0,0,0,0,0,0,17000,-17000,-17000
20200430,06772P,國巨中信99售01,,,,,0.00,0.00,0,0,0,0,0,0,0,0,0,0,0,0,0
20200430,06773P,台灣50兆豐9A售01,1.80,1.80,1.71,1.71,-0.25,-12.76,71000,7,124510,0,0,0,0,0,0,20000,51000,-31000,-31000
20200430,06774P,臺股指兆豐98售02,,,,,0.00,0.00,0,0,0,0,0,0,0,0,0,0,0,0,0
20200430,06775P,臺股指兆豐98售03,,,,,0.00,0.00,0,0,0,0,0,0,0,0,0,0,0,0,0
20200430,06776P,鴻海元大99售05,,,,,0.00,0.00,0,0,0,0,0,0,0,0,0,0,0,0,0
20200430,06777P,鴻海元大99售06,,,,,0.00,0.00,0,0,0,0,0,0,0,0,0,0,0,0,0
20200430,06778P,台積電元大99售06,,,,,0.00,0.00,0,0,0,0,0,0,0,0,0,0,0,0,0
20200430,06779P,智邦元大98售12,0.65,0.75,0.62,0.74,+0.08,12.12,889000,31,613580,0,0,0,0,0,0,384000,485000,-101000,-101000
20200430,06780P,義隆元大98售02,1.48,1.49,1.33,1.39,-0.11,-7.33,571000,46,816900,0,0,0,0,0,0,122000,449000,-327000,-327000
20200430,06781P,大立光元大98售19,8.45,8.45,8.45,8.45,0.00,0.00,2000,1,16900,0,0,0,0,0,0,2000,0,2000,2000
20200430,06782P,大立光元大99售07,2.70,2.70,2.70,2.70,-0.32,-10.6,103000,1,278100,0,0,0,0,0,0,103000,0,103000,103000
20200430,06783P,亞光元大98售03,3.73,3.75,3.73,3.75,-0.04,-1.06,23000,2,85930,0,0,0,0,0,0,0,23000,-23000,-23000
20200430,06784P,臺股指元大98售01,,,,,0.00,0.00,0,0,0,0,0,0,0,0,0,0,0,0,0
20200430,06785P,臺股指元大98售02,,,,,0.00,0.00,0,0,0,0,0,0,0,0,0,0,0,0,0
20200430,06786P,臺股指元大98售03,,,,,0.00,0.00,0,0,0,0,0,0,0,0,0,0,0,0,0
20200430,06787P,臺股指元大98售04,,,,,0.00,0.00,0,0,0,0,0,0,0,0,0,0,0,0,0
20200430,06788P,臺股指元大98售05,,,,,0.00,0.00,0,0,0,0,0,0,0,0,0,0,0,0,0
20200430,06789P,鴻海凱基98售12,,,,,0.00,0.00,0,0,0,0,0,0,0,0,0,0,0,0,0
20200430,06790P,台積電凱基9A售04,,,,,0.00,0.00,0,0,0,0,0,0,0,0,0,0,0,0,0
20200430,06791P,聯發科凱基98售16,,,,,0.00,0.00,0,0,0,0,0,0,0,0,0,0,0,0,0
20200430,06792P,臺股指凱基98售02,,,,,0.00,0.00,0,0,0,0,0,0,0,0,0,0,0,0,0
20200430,06793P,臺股指凱基98售03,9.30,9.30,9.30,9.30,0.00,0.00,10000,1,93000,0,0,0,0,0,0,0,10000,-10000,-10000
20200430,06794P,臺股指凱基98售04,,,,,0.00,0.00,0,0,0,0,0,0,0,0,0,0,0,0,0
20200430,06795P,臺股指凱基98售05,,,,,0.00,0.00,0,0,0,0,0,0,0,0,0,0,0,0,0
20200430,06796P,臺股指凱基98售06,,,,,0.00,0.00,0,0,0,0,0,0,0,0,0,0,0,0,0
20200430,06797P,臺股指凱基98售07,,,,,0.00,0.00,0,0,0,0,0,0,0,0,0,0,0,0,0
20200430,06798P,臺股指凱基98售08,,,,,0.00,0.00,0,0,0,0,0,0,0,0,0,0,0,0,0
20200430,06799P,臺股指凱基98售09,6.20,6.20,6.20,6.20,-0.20,-3.12,1000,1,6200,0,0,0,0,0,0,0,1000,-1000,-1000
20200430,06800P,台灣50群益9A售02,3.48,3.48,3.40,3.40,-0.68,-16.67,15000,4,51160,0,0,0,0,0,0,1000,14000,-13000,-13000
20200430,06801P,技嘉群益99售02,2.01,2.07,2.01,2.05,-0.03,-1.44,83000,11,169040,0,0,0,0,0,0,44000,39000,5000,5000
20200430,06802P,緯穎群益98售03,1.55,1.55,1.31,1.31,-0.28,-17.61,370000,15,544600,0,0,0,0,0,0,50000,320000,-270000,-270000
20200430,06803P,臺股指群益98售09,12.00,12.00,12.00,12.00,-1.40,-10.45,10000,1,120000,0,0,0,0,0,0,10000,0,10000,10000
20200430,06804P,臺股指群益98售10,,,,,0.00,0.00,0,0,0,0,0,0,0,0,0,0,0,0,0
20200430,06805P,臺股指群益98售11,,,,,0.00,0.00,0,0,0,0,0,0,0,0,0,0,0,0,0
20200430,06806P,臺股指群益98售12,,,,,0.00,0.00,0,0,0,0,0,0,0,0,0,0,0,0,0
20200430,06807P,臺股指群益98售13,,,,,0.00,0.00,0,0,0,0,0,0,0,0,0,0,0,0,0
20200430,06808P,電子類群益98售02,,,,,0.00,0.00,0,0,0,0,0,0,0,0,0,0,0,0,0
20200430,06809P,電子類群益98售03,,,,,0.00,0.00,0,0,0,0,0,0,0,0,0,0,0,0,0
20200430,06810P,國巨統一99售03,1.84,1.84,1.84,1.84,-0.07,-3.66,11000,1,20240,0,0,0,0,0,0,11000,11000,0,0
20200430,06811P,聯發科統一98售06,0.90,0.90,0.90,0.90,0.00,0.00,3000,1,2700,0,0,0,0,0,0,0,3000,-3000,-3000
20200430,06812P,台灣50元富9C售01,,,,,0.00,0.00,0,0,0,0,0,0,0,0,0,0,0,0,0
20200430,06813P,友訊元富98售03,,,,,0.00,0.00,0,0,0,0,0,0,0,0,0,0,0,0,0
20200430,06814P,臺股指元富98售03,,,,,0.00,0.00,0,0,0,0,0,0,0,0,0,0,0,0,0
20200430,06815P,臺股指元富98售04,,,,,0.00,0.00,0,0,0,0,0,0,0,0,0,0,0,0,0
20200430,06816P,臺股指元富98售05,,,,,0.00,0.00,0,0,0,0,0,0,0,0,0,0,0,0,0
20200430,06817P,臺股指元富98售06,,,,,0.00,0.00,0,0,0,0,0,0,0,0,0,0,0,0,0
20200430,06818P,臺股指元富98售07,,,,,0.00,0.00,0,0,0,0,0,0,0,0,0,0,0,0,0
20200430,06819P,臺股指元富98售08,,,,,0.00,0.00,0,0,0,0,0,0,0,0,0,0,0,0,0
20200430,06820P,臺股指元富98售09,,,,,0.00,0.00,0,0,0,0,0,0,0,0,0,0,0,0,0
20200430,06821P,臺股指元富98售10,2.50,2.60,2.30,2.60,0.00,0.00,17000,5,40850,0,0,0,0,0,0,1000,17000,-16000,-16000
20200430,06822P,上銀富邦99售03,2.00,2.04,1.78,1.78,-0.38,-17.59,23000,13,45300,0,0,0,0,0,0,13000,10000,3000,3000
20200430,06823P,台灣50永豐98售02,,,,,0.00,0.00,0,0,0,0,0,0,0,0,0,0,0,0,0
20200430,06824P,台灣50國票99售02,,,,,0.00,0.00,0,0,0,0,0,0,0,0,0,0,0,0,0
20200430,06825P,臺股指國票98售01,14.10,14.10,13.00,13.00,-2.30,-15.03,13000,4,180900,0,0,0,0,0,0,12000,1000,11000,11000
20200430,06826P,臺股指國票98售02,,,,,0.00,0.00,0,0,0,0,0,0,0,0,0,0,0,0,0
20200430,06827P,臺股指國票98售03,,,,,0.00,0.00,0,0,0,0,0,0,0,0,0,0,0,0,0
20200430,06828P,臺股指國票98售04,9.65,9.65,9.40,9.45,-1.15,-10.85,16000,3,151100,0,0,0,0,0,0,0,16000,-16000,-16000
20200430,06829P,臺股指國票98售05,,,,,0.00,0.00,0,0,0,0,0,0,0,0,0,0,0,0,0
20200430,06830P,臺股指國票98售06,,,,,0.00,0.00,0,0,0,0,0,0,0,0,0,0,0,0,0
20200430,06831P,臺股指國票98售07,,,,,0.00,0.00,0,0,0,0,0,0,0,0,0,0,0,0,0
20200430,06832P,玉晶光凱基98售03,,,,,0.00,0.00,0,0,0,0,0,0,0,0,0,0,0,0,0
20200430,06833P,矽力群益99售01,0.72,0.86,0.72,0.78,+0.04,5.41,122000,21,98790,0,0,0,0,0,0,55000,0,55000,55000
20200430,06834P,訊芯群益99售02,,,,,0.00,0.00,0,0,0,0,0,0,0,0,0,0,0,0,0
20200430,06835P,台灣50國票9A售01,,,,,0.00,0.00,0,0,0,0,0,0,0,0,0,0,0,0,0
20200430,06836P,玉晶光國票99售06,2.44,2.44,2.32,2.32,-0.23,-9.02,343000,11,813020,0,0,0,0,0,0,21000,322000,-301000,-301000
20200430,06837P,上銀統一9A售02,1.66,1.66,1.47,1.47,0.00,0.00,5000,4,7670,0,0,0,0,0,0,0,5000,-5000,-5000
20200430,06838P,台積電統一99售05,2.66,2.68,2.66,2.68,-0.06,-2.19,16000,2,42580,0,0,0,0,0,0,15000,1000,14000,14000
20200430,06839P,玉晶光統一9A售05,1.55,1.55,1.47,1.49,-0.13,-8.02,291000,15,436730,0,0,0,0,0,0,248000,133000,115000,115000
20200430,06840P,臺股指統一98售04,3.07,3.07,3.07,3.07,-0.58,-15.89,30000,3,92100,0,0,0,0,0,0,30000,30000,0,0
20200430,06841P,臺股指統一9A售02,3.00,3.00,3.00,3.00,0.00,0.00,2000,1,6000,0,0,0,0,0,0,0,2000,-2000,-2000
20200430,06842P,臺股指統一9A售03,,,,,0.00,0.00,0,0,0,0,0,0,0,0,0,0,0,0,0
20200430,06843P,鴻海元大98售11,4.02,4.02,3.98,3.98,-0.14,-3.4,53000,2,211540,0,0,0,0,0,0,53000,53000,0,0
20200430,06844P,智邦元大98售13,1.15,1.31,1.15,1.30,+0.03,2.36,245000,11,311850,0,0,0,0,0,0,177000,68000,109000,109000
20200430,06845P,億光元大98售02,2.11,2.17,2.10,2.17,-0.10,-4.41,155000,3,330000,0,0,0,0,0,0,105000,50000,55000,55000
20200430,06846P,美律元大98售05,2.64,2.64,2.64,2.64,-0.14,-5.04,22000,1,58080,0,0,0,0,0,0,22000,0,22000,22000
20200430,06847P,奇力新元大98售05,1.82,1.88,1.82,1.88,-0.11,-5.53,56000,3,102280,0,0,0,0,0,0,56000,0,56000,56000
20200430,06848P,聯詠元大98售04,3.68,3.68,3.51,3.51,-0.48,-12.03,33000,2,120930,0,0,0,0,0,0,0,33000,-33000,-33000
20200430,06849P,欣興元大98售12,2.40,2.40,2.39,2.39,-0.24,-9.13,27000,2,64550,0,0,0,0,0,0,0,27000,-27000,-27000
20200430,06850P,聯茂元大98售06,,,,,0.00,0.00,0,0,0,0,0,0,0,0,0,0,0,0,0
20200430,06851P,鈺齊元大98售01,2.17,2.17,2.13,2.17,0.00,0.00,140000,8,302300,0,0,0,0,0,0,20000,120000,-100000,-100000
20200430,06852P,臺股指元大98售11,0.79,0.81,0.74,0.76,-0.10,-11.63,3993000,186,3066790,0,0,0,0,0,0,1450000,2307000,-857000,-857000
20200430,06853P,華擎元富98售03,1.84,1.92,1.83,1.85,-0.09,-4.64,256000,22,478410,0,0,0,0,0,0,49000,202000,-153000,-153000
20200430,06854P,鴻海富邦99售05,1.56,1.56,1.56,1.56,-0.05,-3.11,10000,1,15600,0,0,0,0,0,0,0,10000,-10000,-10000
20200430,06855P,聯發科富邦9A售01,1.60,1.60,1.60,1.60,-0.31,-16.23,8000,4,12800,0,0,0,0,0,0,0,0,0,0
20200430,06856P,台灣50永豐99售03,,,,,0.00,0.00,0,0,0,0,0,0,0,0,0,0,0,0,0
20200430,06857P,超眾永豐98售02,0.63,0.63,0.63,0.63,-0.04,-5.97,55000,2,34650,0,0,0,0,0,0,55000,0,55000,55000
20200430,06858P,道瓊指中信9B售01,,,,,0.00,0.00,0,0,0,0,0,0,0,0,0,0,0,0,0
20200430,06859P,元金2X中信9C售01,1.50,1.50,1.49,1.50,0.00,0.00,78000,6,116970,0,0,0,0,0,0,37000,40000,-3000,-3000
20200430,06860P,台灣50兆豐98售01,2.45,11.00,2.38,11.00,0.00,0.00,23000,3,64130,0,0,0,0,0,0,22000,22000,0,0
20200430,06861P,台積電國票99售08,,,,,0.00,0.00,0,0,0,0,0,0,0,0,0,0,0,0,0
20200430,06862P,大立光凱基98售16,,,,,0.00,0.00,0,0,0,0,0,0,0,0,0,0,0,0,0
20200430,06863P,欣興凱基98售05,,,,,0.00,0.00,0,0,0,0,0,0,0,0,0,0,0,0,0
20200430,06864P,健策凱基98售01,1.56,1.56,1.47,1.50,-0.08,-5.06,96000,11,147530,0,0,0,0,0,0,24000,72000,-48000,-48000
20200430,06865P,亞德客元大98售04,3.85,3.91,3.29,3.29,-0.96,-22.59,57000,6,211050,0,0,0,0,0,0,15000,42000,-27000,-27000
20200430,06866P,聯發科元大98售13,1.34,1.41,1.21,1.21,-0.44,-26.67,69000,7,89890,0,0,0,0,0,0,10000,59000,-49000,-49000
20200430,06867P,訊芯元大98售08,2.21,2.21,2.21,2.21,-0.08,-3.49,5000,1,11050,0,0,0,0,0,0,5000,0,5000,5000
20200430,06868P,電子類元大99售01,2.34,2.35,2.18,2.24,-0.21,-8.57,81000,16,180860,0,0,0,0,0,0,3000,17000,-14000,-14000
20200430,06869P,金融類元大99售01,1.51,1.56,1.51,1.56,0.00,0.00,17000,3,26420,0,0,0,0,0,0,2000,10000,-8000,-8000
20200430,06870P,台灣50群益9A售03,,,,,0.00,0.00,0,0,0,0,0,0,0,0,0,0,0,0,0
20200430,06871P,元油2X群益98售04,,,,,0.00,0.00,0,0,0,0,0,0,0,0,0,0,0,0,0
20200430,06872P,亞德客元富98售04,1.06,1.06,1.04,1.04,0.00,0.00,9000,2,9440,0,0,0,0,0,0,9000,0,9000,9000
20200430,06873P,嘉晶元富98售02,,,,,0.00,0.00,0,0,0,0,0,0,0,0,0,0,0,0,0
20200430,06874P,台積電台新98售02,0.27,0.27,0.27,0.27,0.00,0.00,10000,1,2700,0,0,0,0,0,0,10000,10000,0,0
20200430,06875P,台灣50永昌9A售02,,,,,0.00,0.00,0,0,0,0,0,0,0,0,0,0,0,0,0
20200430,06876P,台灣50兆豐9B售01,2.46,2.46,2.46,2.46,-0.40,-13.99,12000,2,29520,0,0,0,0,0,0,12000,0,12000,12000
20200430,06877P,台積電兆豐98售04,,,,,0.00,0.00,0,0,0,0,0,0,0,0,0,0,0,0,0
20200430,06878P,台灣50日盛9B售01,,,,,0.00,0.00,0,0,0,0,0,0,0,0,0,0,0,0,0
20200430,06879P,長榮航凱基98售02,1.10,1.10,0.98,1.01,-0.14,-12.17,61000,8,63340,0,0,0,0,0,0,0,21000,-21000,-21000
20200430,06880P,鈺齊凱基98售03,,,,,0.00,0.00,0,0,0,0,0,0,0,0,0,0,0,0,0
20200430,06881P,國巨群益98售10,,,,,0.00,0.00,0,0,0,0,0,0,0,0,0,0,0,0,0
20200430,06882P,聯發科群益98售07,3.50,3.50,3.32,3.32,-0.43,-11.47,40000,9,135270,0,0,0,0,0,0,39000,1000,38000,38000
20200430,06883P,聯茂群益98售03,,,,,0.00,0.00,0,0,0,0,0,0,0,0,0,0,0,0,0
20200430,06884P,台郡群益98售03,2.57,2.63,2.49,2.51,-0.10,-3.83,56000,7,143510,0,0,0,0,0,0,44000,12000,32000,32000
20200430,06885P,國巨國票99售06,11.20,11.20,11.20,11.20,-0.70,-5.88,3000,2,33600,0,0,0,0,0,0,0,3000,-3000,-3000
20200430,06886P,旺宏元大99售07,4.15,4.30,4.15,4.30,-0.37,-7.92,59000,9,251100,0,0,0,0,0,0,6000,53000,-47000,-47000
20200430,06887P,華新科元大98售04,,,,,0.00,0.00,0,0,0,0,0,0,0,0,0,0,0,0,0
20200430,06888P,日月光元大98售02,5.85,5.85,5.50,5.50,-0.60,-9.84,55000,5,311250,0,0,0,0,0,0,20000,35000,-15000,-15000
20200430,06889P,臺股指元大98售13,1.17,1.17,1.12,1.12,-0.18,-13.85,307000,17,349030,0,0,0,0,0,0,245000,62000,183000,183000
20200430,06890P,金融類元大98售02,0.73,0.73,0.70,0.70,0.00,0.00,75000,8,54200,0,0,0,0,0,0,20000,55000,-35000,-35000
20200430,06891P,緯穎富邦99售03,0.52,0.52,0.44,0.44,-0.11,-20.0,98000,5,46230,0,0,0,0,0,0,76000,22000,54000,54000
20200430,06892P,聯鈞元富98售01,,,,,0.00,0.00,0,0,0,0,0,0,0,0,0,0,0,0,0
20200430,06893P,致新元富98售02,1.62,1.65,1.56,1.56,-0.14,-8.24,239000,9,389940,0,0,0,0,0,0,162000,77000,85000,85000
20200430,06894P,鈺齊元富98售03,,,,,0.00,0.00,0,0,0,0,0,0,0,0,0,0,0,0,0
20200430,06895P,台灣50統一9A售01,,,,,0.00,0.00,0,0,0,0,0,0,0,0,0,0,0,0,0
20200430,06896P,信邦中信98售01,0.58,0.63,0.58,0.63,+0.02,3.28,250000,11,152250,0,0,0,0,0,0,195000,55000,140000,140000
20200430,06897P,FBVIX群益01售01,0.74,0.74,0.73,0.73,0.00,0.00,220000,3,161180,0,0,0,0,0,0,162000,0,162000,162000
20200430,06898P,FBVIX群益9C售03,,,,,0.00,0.00,0,0,0,0,0,0,0,0,0,0,0,0,0
20200430,06899P,嘉澤群益98售01,1.02,1.02,0.93,0.93,0.00,0.00,33000,3,32190,0,0,0,0,0,0,13000,10000,3000,3000
20200430,06900P,FBVIX國票12售01,0.46,0.47,0.46,0.47,+0.01,2.17,142000,14,66080,0,0,0,0,0,0,66000,57000,9000,9000
20200430,06901P,亞德客凱基98售02,0.81,0.81,0.61,0.61,0.00,0.00,65000,6,44170,0,0,0,0,0,0,44000,20000,24000,24000
20200430,06902P,聯電凱基98售02,1.04,1.04,1.02,1.02,-0.11,-9.73,16000,4,16360,0,0,0,0,0,0,16000,0,16000,16000
20200430,06903P,技嘉凱基98售04,1.52,1.59,1.52,1.58,-0.04,-2.47,217000,13,340490,0,0,0,0,0,0,117000,72000,45000,45000
20200430,06904P,TPK凱基98售03,1.73,1.79,1.73,1.78,+0.06,3.49,271000,10,478120,0,0,0,0,0,0,0,271000,-271000,-271000
20200430,06905P,上証2X國泰99售02,,,,,0.00,0.00,0,0,0,0,0,0,0,0,0,0,0,0,0
20200430,06906P,國巨國泰99售01,,,,,0.00,0.00,0,0,0,0,0,0,0,0,0,0,0,0,0
20200430,06907P,華新科國泰99售05,,,,,0.00,0.00,0,0,0,0,0,0,0,0,0,0,0,0,0
20200430,06908P,健策國泰99售02,1.26,1.29,1.23,1.23,0.00,0.00,45000,7,57180,0,0,0,0,0,0,0,45000,-45000,-45000
20200430,06909P,元油2X元大98售22,,,,,0.00,0.00,0,0,0,0,0,0,0,0,0,0,0,0,0
20200430,06910P,元油2X元大98售23,,,,,0.00,0.00,0,0,0,0,0,0,0,0,0,0,0,0,0
20200430,06911P,鴻海元大99售09,4.41,4.43,4.31,4.31,-0.26,-5.69,114000,5,502840,0,0,0,0,0,0,112000,114000,-2000,-2000
20200430,06912P,台光電元大99售02,,,,,0.00,0.00,0,0,0,0,0,0,0,0,0,0,0,0,0
20200430,06913P,聯發科元大98售14,,,,,0.00,0.00,0,0,0,0,0,0,0,0,0,0,0,0,0
20200430,06914P,南茂元大98售03,,,,,0.00,0.00,0,0,0,0,0,0,0,0,0,0,0,0,0
20200430,06915P,晶技元富98售02,0.20,0.23,0.19,0.23,0.00,0.00,63000,5,12570,0,0,0,0,0,0,0,10000,-10000,-10000
20200430,06916P,聯鈞元富98售02,,,,,0.00,0.00,0,0,0,0,0,0,0,0,0,0,0,0,0
20200430,06917P,聯電亞東99售01,,,,,0.00,0.00,0,0,0,0,0,0,0,0,0,0,0,0,0
20200430,06918P,嘉聯益亞東99售01,,,,,0.00,0.00,0,0,0,0,0,0,0,0,0,0,0,0,0
20200430,06919P,臺股指日盛98售02,7.20,7.20,7.20,7.20,-1.10,-13.25,10000,1,72000,0,0,0,0,0,0,10000,10000,0,0
20200430,06920P,台灣50凱基9A售01,,,,,0.00,0.00,0,0,0,0,0,0,0,0,0,0,0,0,0
20200430,06921P,台光電凱基98售06,,,,,0.00,0.00,0,0,0,0,0,0,0,0,0,0,0,0,0
20200430,06922P,元上證群益9C售01,,,,,0.00,0.00,0,0,0,0,0,0,0,0,0,0,0,0,0
20200430,06923P,鴻海群益98售09,,,,,0.00,0.00,0,0,0,0,0,0,0,0,0,0,0,0,0
20200430,06924P,台積電群益98售07,,,,,0.00,0.00,0,0,0,0,0,0,0,0,0,0,0,0,0
20200430,06925P,致茂群益9A售02,2.36,2.36,2.36,2.36,0.00,0.00,100000,2,236000,0,0,0,0,0,0,100000,100000,0,0
20200430,06926P,可成群益9A售04,5.20,5.45,5.20,5.45,+0.10,1.87,35000,5,187450,0,0,0,0,0,0,6000,29000,-23000,-23000
20200430,06927P,台灣50元大9B售03,,,,,0.00,0.00,0,0,0,0,0,0,0,0,0,0,0,0,0
20200430,06928P,鴻海元大99售10,3.99,3.99,3.92,3.92,-0.14,-3.45,56000,5,222330,0,0,0,0,0,0,36000,56000,-20000,-20000
20200430,06929P,鴻海元大99售11,,,,,0.00,0.00,0,0,0,0,0,0,0,0,0,0,0,0,0
20200430,06930P,台積電元大98售19,,,,,0.00,0.00,0,0,0,0,0,0,0,0,0,0,0,0,0
20200430,06931P,大立光元大98售20,,,,,0.00,0.00,0,0,0,0,0,0,0,0,0,0,0,0,0
20200430,06932P,大立光元大98售21,,,,,0.00,0.00,0,0,0,0,0,0,0,0,0,0,0,0,0
20200430,06933P,禾伸堂元大98售03,1.39,1.45,1.39,1.44,-0.01,-0.69,58000,4,82700,0,0,0,0,0,0,20000,38000,-18000,-18000
20200430,06934P,聯鈞元大98售03,1.97,2.14,1.97,2.14,+0.09,4.39,420000,15,864860,0,0,0,0,0,0,200000,320000,-120000,-120000
20200430,06935P,神達元大98售02,,,,,0.00,0.00,0,0,0,0,0,0,0,0,0,0,0,0,0
20200430,06936P,瑞儀元大98售01,3.32,3.32,3.25,3.25,-0.08,-2.4,53000,5,172910,0,0,0,0,0,0,30000,23000,7000,7000
20200430,06937P,GIS元大98售03,2.41,2.41,2.41,2.41,-0.05,-2.03,11000,1,26510,0,0,0,0,0,0,0,11000,-11000,-11000
20200430,06938P,南電元大98售03,2.17,2.28,2.16,2.28,-0.03,-1.3,126000,10,284240,0,0,0,0,0,0,56000,70000,-14000,-14000
20200430,06939P,國巨永豐98售09,,,,,0.00,0.00,0,0,0,0,0,0,0,0,0,0,0,0,0
20200430,06940P,旺宏永豐98售05,1.82,1.82,1.82,1.82,-0.21,-10.34,10000,2,18200,0,0,0,0,0,0,5000,5000,0,0
20200430,06941P,國巨統一98售07,,,,,0.00,0.00,0,0,0,0,0,0,0,0,0,0,0,0,0
20200430,06942P,台灣50台新02售01,1.80,1.80,1.80,1.80,0.00,0.00,10000,1,18000,0,0,0,0,0,0,10000,10000,0,0
20200430,06943P,致茂元富98售03,,,,,0.00,0.00,0,0,0,0,0,0,0,0,0,0,0,0,0
20200430,06944P,健鼎元富98售02,,,,,0.00,0.00,0,0,0,0,0,0,0,0,0,0,0,0,0
20200430,06945P,國巨群益99售04,,,,,0.00,0.00,0,0,0,0,0,0,0,0,0,0,0,0,0
20200430,06946P,T50正2元大9C售01,4.44,4.44,4.43,4.43,-0.47,-9.59,50000,5,221600,0,0,0,0,0,0,0,50000,-50000,-50000
20200430,06947P,FBVIX元大01售01,,,,,0.00,0.00,0,0,0,0,0,0,0,0,0,0,0,0,0
20200430,06948P,FBVIX元大01售02,,,,,0.00,0.00,0,0,0,0,0,0,0,0,0,0,0,0,0
20200430,06949P,台表科元大99售01,2.86,2.99,2.86,2.90,-0.06,-2.03,137000,9,400950,0,0,0,0,0,0,101000,24000,77000,77000
20200430,06950P,鴻海統一9B售02,2.43,2.43,2.42,2.42,-0.05,-2.02,21000,2,50900,0,0,0,0,0,0,13000,8000,5000,5000
20200430,06951P,台積電統一9B售02,,,,,0.00,0.00,0,0,0,0,0,0,0,0,0,0,0,0,0
20200430,06952P,大立光統一9A售03,,,,,0.00,0.00,0,0,0,0,0,0,0,0,0,0,0,0,0
20200430,06953P,景碩統一9A售01,,,,,0.00,0.00,0,0,0,0,0,0,0,0,0,0,0,0,0
20200430,06954P,大立光元富99售01,4.35,4.35,4.03,4.03,-0.54,-11.82,178000,29,744490,0,0,0,0,0,0,57000,121000,-64000,-64000
20200430,06955P,臻鼎元富99售01,,,,,0.00,0.00,0,0,0,0,0,0,0,0,0,0,0,0,0
20200430,06956P,國巨日盛99售04,2.06,2.06,2.06,2.06,0.00,0.00,30000,1,61800,0,0,0,0,0,0,30000,30000,0,0
20200430,06957P,FBVIX凱基01售01,,,,,0.00,0.00,0,0,0,0,0,0,0,0,0,0,0,0,0
20200430,06958P,FBVIX凱基9C售02,,,,,0.00,0.00,0,0,0,0,0,0,0,0,0,0,0,0,0
20200430,06959P,鴻海凱基9A售02,,,,,0.00,0.00,0,0,0,0,0,0,0,0,0,0,0,0,0
20200430,06960P,國巨凱基99售08,2.72,2.77,2.70,2.77,-0.04,-1.42,32000,3,87090,0,0,0,0,0,0,25000,7000,18000,18000
20200430,06961P,台積電凱基99售05,,,,,0.00,0.00,0,0,0,0,0,0,0,0,0,0,0,0,0
20200430,06962P,華新科永豐99售01,0.84,0.85,0.84,0.85,-0.05,-5.56,40000,3,33800,0,0,0,0,0,0,20000,20000,0,0
20200430,06963P,鴻海凱基99售04,,,,,0.00,0.00,0,0,0,0,0,0,0,0,0,0,0,0,0
20200430,06964P,臺股指凱基9B售01,,,,,0.00,0.00,0,0,0,0,0,0,0,0,0,0,0,0,0
20200430,06965P,台積電台新99售02,1.11,1.11,1.02,1.02,0.00,0.00,400000,40,435600,0,0,0,0,0,0,400000,400000,0,0
20200430,06966P,健策台新9A售02,0.40,0.40,0.40,0.40,0.00,0.00,10000,2,4000,0,0,0,0,0,0,0,10000,-10000,-10000
20200430,06967P,台郡台新99售02,0.53,0.53,0.53,0.53,0.00,0.00,10000,1,5300,0,0,0,0,0,0,0,10000,-10000,-10000
20200430,06968P,元油2X元大99售08,,,,,0.00,0.00,0,0,0,0,0,0,0,0,0,0,0,0,0
20200430,06969P,上銀元大99售02,1.36,1.36,1.13,1.15,-0.40,-25.81,142000,4,166720,0,0,0,0,0,0,140000,132000,8000,8000
20200430,06970P,旺宏元大99售08,0.75,0.75,0.75,0.75,0.00,0.00,10000,1,7500,0,0,0,0,0,0,10000,0,10000,10000
20200430,06971P,台光電元大99售03,1.08,1.08,1.01,1.01,-0.11,-9.82,120000,6,124080,0,0,0,0,0,0,119000,1000,118000,118000
20200430,06972P,聯發科元大99售04,,,,,0.00,0.00,0,0,0,0,0,0,0,0,0,0,0,0,0
20200430,06973P,臺股指元大9A售11,,,,,0.00,0.00,0,0,0,0,0,0,0,0,0,0,0,0,0
20200430,06974P,臺股指元大9A售12,,,,,0.00,0.00,0,0,0,0,0,0,0,0,0,0,0,0,0
20200430,06975P,臺股指元大9A售13,,,,,0.00,0.00,0,0,0,0,0,0,0,0,0,0,0,0,0
20200430,06976P,臺股指元大9A售14,,,,,0.00,0.00,0,0,0,0,0,0,0,0,0,0,0,0,0
20200430,06977P,臺股指元大9A售15,,,,,0.00,0.00,0,0,0,0,0,0,0,0,0,0,0,0,0
20200430,06978P,聯發科富邦9B售02,0.53,0.53,0.53,0.53,-0.15,-22.06,31000,1,16430,0,0,0,0,0,0,31000,0,31000,31000
20200430,06979P,台灣50永豐9A售02,,,,,0.00,0.00,0,0,0,0,0,0,0,0,0,0,0,0,0
20200430,06980P,緯穎永豐99售02,1.12,1.12,0.99,0.99,-0.23,-18.85,129000,11,136560,0,0,0,0,0,0,63000,66000,-3000,-3000
20200430,06981P,台灣50麥證99售02,,,,,0.00,0.00,0,0,0,0,0,0,0,0,0,0,0,0,0
20200430,06982P,義隆凱基99售02,0.70,1.00,0.63,1.00,+0.22,28.21,55000,6,41230,0,0,0,0,0,0,1000,0,1000,1000
20200430,06983P,台積電國泰9A售02,2.42,2.43,2.34,2.34,-0.23,-8.95,56000,11,135210,0,0,0,0,0,0,31000,25000,6000,6000
20200430,06984P,上銀富邦9B售01,,,,,0.00,0.00,0,0,0,0,0,0,0,0,0,0,0,0,0
20200430,06985P,華新科富邦9C售02,1.05,1.05,1.05,1.05,0.00,0.00,18000,2,18900,0,0,0,0,0,0,18000,0,18000,18000
20200430,06986P,台積電台新9A售01,0.08,0.08,0.08,0.08,-1.15,-93.5,10000,1,800,0,0,0,0,0,0,10000,10000,0,0
20200430,06987P,鴻海元富99售08,,,,,0.00,0.00,0,0,0,0,0,0,0,0,0,0,0,0,0
20200430,06988P,鴻海元富99售09,,,,,0.00,0.00,0,0,0,0,0,0,0,0,0,0,0,0,0
20200430,06989P,鴻海元富99售10,,,,,0.00,0.00,0,0,0,0,0,0,0,0,0,0,0,0,0
20200430,06990P,康友元富99售03,,,,,0.00,0.00,0,0,0,0,0,0,0,0,0,0,0,0,0
20200430,06991P,矽創群益99售01,1.50,1.53,1.45,1.45,-0.16,-9.94,113000,10,168350,0,0,0,0,0,0,13000,100000,-87000,-87000
20200430,06992P,玉晶光日盛9B售01,,,,,0.00,0.00,0,0,0,0,0,0,0,0,0,0,0,0,0
20200430,06993P,鴻海凱基99售05,2.06,2.06,2.02,2.02,-0.08,-3.81,40000,3,82000,0,0,0,0,0,0,15000,25000,-10000,-10000
20200430,06994P,台光電凱基99售02,,,,,0.00,0.00,0,0,0,0,0,0,0,0,0,0,0,0,0
20200430,06995P,臺股指凱基99售16,,,,,0.00,0.00,0,0,0,0,0,0,0,0,0,0,0,0,0
20200430,06996P,臺股指凱基99售17,,,,,0.00,0.00,0,0,0,0,0,0,0,0,0,0,0,0,0
20200430,06997P,台灣50中信03售01,,,,,0.00,0.00,0,0,0,0,0,0,0,0,0,0,0,0,0
20200430,06998P,S&P正2中信9B售01,,,,,0.00,0.00,0,0,0,0,0,0,0,0,0,0,0,0,0
20200430,06999P,玉晶光國票9B售01,,,,,0.00,0.00,0,0,0,0,0,0,0,0,0,0,0,0,0
20200430,07000P,T50反1元大99售03,,,,,0.00,0.00,0,0,0,0,0,0,0,0,0,0,0,0,0
20200430,07001P,國巨元大99售12,1.25,1.25,1.25,1.25,0.00,0.00,12000,2,15000,0,0,0,0,0,0,0,0,0,0
20200430,07002P,鴻海兆豐99售04,,,,,0.00,0.00,0,0,0,0,0,0,0,0,0,0,0,0,0
20200430,07003P,聯發科兆豐99售02,,,,,0.00,0.00,0,0,0,0,0,0,0,0,0,0,0,0,0
20200430,07004P,大立光兆豐9A售01,0.97,0.97,0.97,0.97,-0.14,-12.61,2000,1,1940,0,0,0,0,0,0,0,2000,-2000,-2000
20200430,07005P,台積電統一9B售05,0.99,0.99,0.96,0.96,0.00,0.00,33000,4,32070,0,0,0,0,0,0,10000,33000,-23000,-23000
20200430,07006P,旺宏統一9B售03,1.11,1.13,1.10,1.12,-0.07,-5.88,117000,9,130750,0,0,0,0,0,0,12000,105000,-93000,-93000
20200430,07007P,台灣50台新01售02,,,,,0.00,0.00,0,0,0,0,0,0,0,0,0,0,0,0,0
20200430,07008P,台郡中信99售02,,,,,0.00,0.00,0,0,0,0,0,0,0,0,0,0,0,0,0
20200430,07009P,臺股指中信9B售01,1.73,1.73,1.72,1.73,-0.21,-10.82,12000,3,20710,0,0,0,0,0,0,0,12000,-12000,-12000
20200430,07010P,T50正2凱基9C售01,4.43,4.44,4.36,4.36,-0.15,-3.33,151000,4,665880,0,0,0,0,0,0,100000,51000,49000,49000
20200430,07011P,宏達電凱基99售02,1.68,1.69,1.68,1.69,-0.04,-2.31,36000,2,60630,0,0,0,0,0,0,36000,0,36000,36000
20200430,07012P,智邦群益9A售01,0.48,0.48,0.48,0.48,0.00,0.00,5000,1,2400,0,0,0,0,0,0,0,0,0,0
20200430,07013P,玉晶光群益9A售06,,,,,0.00,0.00,0,0,0,0,0,0,0,0,0,0,0,0,0
20200430,07014P,華通元大99售04,1.93,1.93,1.77,1.77,-0.23,-11.5,231000,32,425260,0,0,0,0,0,0,89000,136000,-47000,-47000
20200430,07015P,國巨元大99售13,1.10,1.10,1.10,1.10,-0.06,-5.17,85000,1,93500,0,0,0,0,0,0,85000,0,85000,85000
20200430,07016P,聯發科元大99售10,1.71,1.71,1.56,1.56,-0.46,-22.77,10000,2,16350,0,0,0,0,0,0,5000,5000,0,0
20200430,07017P,台灣50元富9B售02,,,,,0.00,0.00,0,0,0,0,0,0,0,0,0,0,0,0,0
20200430,07018P,台灣50統一9B售01,,,,,0.00,0.00,0,0,0,0,0,0,0,0,0,0,0,0,0
20200430,07019P,鴻海台新99售01,,,,,0.00,0.00,0,0,0,0,0,0,0,0,0,0,0,0,0
20200430,07020P,玉晶光台新99售02,,,,,0.00,0.00,0,0,0,0,0,0,0,0,0,0,0,0,0
20200430,07021P,台積電富邦9C售02,1.99,1.99,1.99,1.99,-0.01,-0.5,1000,1,1990,0,0,0,0,0,0,0,1000,-1000,-1000
20200430,07022P,嘉晶永豐99售02,1.39,1.39,1.30,1.31,-0.12,-8.39,167000,4,230620,0,0,0,0,0,0,150000,17000,133000,133000
20200430,07023P,南電永豐99售02,,,,,0.00,0.00,0,0,0,0,0,0,0,0,0,0,0,0,0
20200430,07024P,臺股指永豐99售02,,,,,0.00,0.00,0,0,0,0,0,0,0,0,0,0,0,0,0
20200430,07025P,玉晶光凱基99售01,1.15,1.15,1.08,1.08,-0.11,-9.24,73000,5,79020,0,0,0,0,0,0,68000,0,68000,68000
20200430,07026P,超眾凱基99售03,0.82,0.82,0.80,0.82,-0.03,-3.53,36000,5,28920,0,0,0,0,0,0,36000,1000,35000,35000
20200430,07027P,台積電群益99售04,,,,,0.00,0.00,0,0,0,0,0,0,0,0,0,0,0,0,0
20200430,07028P,大立光群益99售06,,,,,0.00,0.00,0,0,0,0,0,0,0,0,0,0,0,0,0
20200430,07029P,緯穎群益99售02,,,,,0.00,0.00,0,0,0,0,0,0,0,0,0,0,0,0,0
20200430,07030P,鈺齊群益99售01,,,,,0.00,0.00,0,0,0,0,0,0,0,0,0,0,0,0,0
20200430,07031P,台灣50中信03售02,0.97,0.97,0.97,0.97,-0.17,-14.91,300000,1,291000,0,0,0,0,0,0,300000,0,300000,300000
20200430,07032P,聯發科統一9C售02,1.32,1.32,1.28,1.28,-0.12,-8.57,613000,4,790960,0,0,0,0,0,0,13000,600000,-587000,-587000
20200430,07033P,大立光統一9B售03,,,,,0.00,0.00,0,0,0,0,0,0,0,0,0,0,0,0,0
20200430,07034P,大立光元富99售03,,,,,0.00,0.00,0,0,0,0,0,0,0,0,0,0,0,0,0
20200430,07035P,大立光元富99售04,,,,,0.00,0.00,0,0,0,0,0,0,0,0,0,0,0,0,0
20200430,07036P,台灣50台新9C售01,2.77,2.77,2.77,2.77,-1.13,-28.97,1000,1,2770,0,0,0,0,0,0,1000,1000,0,0
20200430,07037P,台積電台新99售03,1.43,1.44,1.31,1.31,0.00,0.00,220000,22,312700,0,0,0,0,0,0,220000,220000,0,0
20200430,07038P,華新科台新99售01,,,,,0.00,0.00,0,0,0,0,0,0,0,0,0,0,0,0,0
20200430,07039P,南電台新99售01,0.76,0.82,0.76,0.79,+0.01,1.28,50000,9,39830,0,0,0,0,0,0,15000,20000,-5000,-5000
20200430,07040P,台灣50元大9C售02,,,,,0.00,0.00,0,0,0,0,0,0,0,0,0,0,0,0,0
20200430,07041P,T50反1元大9C售01,,,,,0.00,0.00,0,0,0,0,0,0,0,0,0,0,0,0,0
20200430,07042P,T50反1元大9C售02,,,,,0.00,0.00,0,0,0,0,0,0,0,0,0,0,0,0,0
20200430,07043P,國巨元大99售14,,,,,0.00,0.00,0,0,0,0,0,0,0,0,0,0,0,0,0
20200430,07044P,台積電元大99售13,,,,,0.00,0.00,0,0,0,0,0,0,0,0,0,0,0,0,0
20200430,07045P,上銀國票9A售01,,,,,0.00,0.00,0,0,0,0,0,0,0,0,0,0,0,0,0
20200430,07046P,大立光富邦9C售03,1.04,1.07,1.00,1.00,-0.07,-6.54,51000,11,52610,0,0,0,0,0,0,0,21000,-21000,-21000
20200430,07047P,S&P500中信9B售02,,,,,0.00,0.00,0,0,0,0,0,0,0,0,0,0,0,0,0
20200430,07048P,台積電中信03售01,,,,,0.00,0.00,0,0,0,0,0,0,0,0,0,0,0,0,0
20200430,07049P,聯發科中信99售03,1.08,1.08,1.02,1.02,-0.15,-12.82,63000,6,66460,0,0,0,0,0,0,10000,53000,-43000,-43000
20200430,07050P,宏達電中信9B售01,1.19,1.19,1.19,1.19,-0.01,-0.83,27000,4,32130,0,0,0,0,0,0,24000,3000,21000,21000
20200430,07051P,大立光中信99售02,,,,,0.00,0.00,0,0,0,0,0,0,0,0,0,0,0,0,0
20200430,07052P,臺股指中信9C售02,,,,,0.00,0.00,0,0,0,0,0,0,0,0,0,0,0,0,0
20200430,07053P,台灣50兆豐01售01,1.87,1.87,1.71,1.71,-0.69,-28.75,47000,5,84960,0,0,0,0,0,0,31000,27000,4000,4000
20200430,07054P,華新科兆豐99售04,,,,,0.00,0.00,0,0,0,0,0,0,0,0,0,0,0,0,0
20200430,07055P,景碩群益9A售02,2.65,2.65,2.58,2.58,-0.21,-7.53,12000,2,31660,0,0,0,0,0,0,10000,2000,8000,8000
20200430,07056P,臺股指麥證99售02,,,,,0.00,0.00,0,0,0,0,0,0,0,0,0,0,0,0,0
20200430,07057P,大立光康和9B售02,2.10,2.10,2.05,2.05,-0.17,-7.66,13000,4,26810,0,0,0,0,0,0,0,13000,-13000,-13000
20200430,07058P,台積電凱基9A售07,,,,,0.00,0.00,0,0,0,0,0,0,0,0,0,0,0,0,0
20200430,07059P,華通國票9A售02,3.27,3.27,3.08,3.08,-0.33,-9.68,413000,10,1302070,0,0,0,0,0,0,395000,18000,377000,377000
20200430,07060P,台表科國票9A售01,1.59,1.63,1.58,1.60,-0.04,-2.44,155000,14,249990,0,0,0,0,0,0,36000,119000,-83000,-83000
20200430,07061P,台積電元大99售14,,,,,0.00,0.00,0,0,0,0,0,0,0,0,0,0,0,0,0
20200430,07062P,台積電元大99售15,,,,,0.00,0.00,0,0,0,0,0,0,0,0,0,0,0,0,0
20200430,07063P,臺股指元大9A售24,9.50,9.50,9.50,9.50,0.00,0.00,10000,1,95000,0,0,0,0,0,0,0,10000,-10000,-10000
20200430,07064P,臺股指元大9A售25,,,,,0.00,0.00,0,0,0,0,0,0,0,0,0,0,0,0,0
20200430,07065P,臺股指元大9A售26,8.70,8.70,8.20,8.20,-1.15,-12.3,7000,3,58300,0,0,0,0,0,0,0,7000,-7000,-7000
20200430,07066P,台灣50台新9B售01,0.30,0.30,0.30,0.30,0.00,0.00,10000,2,3000,0,0,0,0,0,0,0,10000,-10000,-10000
20200430,07067P,旺宏台新99售02,1.19,1.22,1.18,1.21,-0.11,-8.33,23000,6,27640,0,0,0,0,0,0,10000,13000,-3000,-3000
20200430,07068P,欣興台新99售01,,,,,0.00,0.00,0,0,0,0,0,0,0,0,0,0,0,0,0
20200430,07069P,欣興元富99售02,4.55,4.55,4.55,4.55,0.00,0.00,4000,1,18200,0,0,0,0,0,0,0,4000,-4000,-4000
20200430,07070P,晶相光元富99售01,3.00,3.13,3.00,3.10,+0.01,0.32,171000,9,526490,0,0,0,0,0,0,2000,169000,-167000,-167000
20200430,07071P,立積元富99售01,1.25,1.25,1.14,1.14,-0.18,-13.64,435000,17,529350,0,0,0,0,0,0,370000,65000,305000,305000
20200430,07072P,元油2X凱基9C售01,,,,,0.00,0.00,0,0,0,0,0,0,0,0,0,0,0,0,0
20200430,07073P,臺股指中信9B售02,,,,,0.00,0.00,0,0,0,0,0,0,0,0,0,0,0,0,0
20200430,07074P,FBVIX凱基9A售01,1.15,1.15,1.10,1.11,+0.02,1.83,80000,6,88640,0,0,0,0,0,0,69000,0,69000,69000
20200430,07075P,FBVIX凱基9C售04,0.95,0.95,0.95,0.95,0.00,0.00,7000,1,6650,0,0,0,0,0,0,7000,0,7000,7000
20200430,07076P,鴻海凱基9A售08,2.78,2.78,2.78,2.78,-0.15,-5.12,1000,1,2780,0,0,0,0,0,0,1000,0,1000,1000
20200430,07077P,緯穎凱基99售01,,,,,0.00,0.00,0,0,0,0,0,0,0,0,0,0,0,0,0
20200430,07078P,鴻海群益99售02,,,,,0.00,0.00,0,0,0,0,0,0,0,0,0,0,0,0,0
20200430,07079P,台積電群益99售06,,,,,0.00,0.00,0,0,0,0,0,0,0,0,0,0,0,0,0
20200430,07080P,健策群益9A售01,1.06,1.10,1.06,1.10,-0.01,-0.9,95000,4,101780,0,0,0,0,0,0,68000,26000,42000,42000
20200430,07081P,南電群益9A售01,0.40,1.30,0.40,1.27,-0.02,-1.55,415000,24,520360,0,0,0,0,0,0,141000,264000,-123000,-123000
20200430,07082P,美律元大99售06,0.99,0.99,0.99,0.99,-0.08,-7.48,56000,1,55440,0,0,0,0,0,0,56000,0,56000,56000
20200430,07083P,台積電統一9A售06,1.25,1.25,1.24,1.24,0.00,0.00,27000,4,33580,0,0,0,0,0,0,0,27000,-27000,-27000
20200430,07084P,S&P正2元富9B售02,0.99,0.99,0.94,0.96,-0.03,-3.03,230000,27,223020,0,0,0,0,0,0,0,190000,-190000,-190000
20200430,07085P,超眾元富9C售01,1.91,1.95,1.85,1.95,-0.03,-1.52,478000,19,919390,0,0,0,0,0,0,354000,324000,30000,30000
20200430,07086P,力成元富9C售01,2.39,2.39,2.39,2.39,0.00,0.00,83000,2,198370,0,0,0,0,0,0,0,83000,-83000,-83000
20200430,07087P,聯發科台新99售02,,,,,0.00,0.00,0,0,0,0,0,0,0,0,0,0,0,0,0
20200430,07088P,訊芯永豐99售02,,,,,0.00,0.00,0,0,0,0,0,0,0,0,0,0,0,0,0
20200430,07089P,臺指2X中信01售01,1.54,1.54,1.47,1.47,-0.15,-9.26,140000,18,211240,0,0,0,0,0,0,6000,134000,-128000,-128000
20200430,07090P,台灣50凱基01售01,3.47,3.47,3.30,3.30,-0.40,-10.81,55000,7,184210,0,0,0,0,0,0,0,55000,-55000,-55000
20200430,07091P,SGBR2X凱基9A售02,,,,,0.00,0.00,0,0,0,0,0,0,0,0,0,0,0,0,0
20200430,07092P,上銀凱基99售03,1.52,1.52,1.24,1.24,-0.39,-23.93,224000,29,298070,0,0,0,0,0,0,0,221000,-221000,-221000
20200430,07093P,台積電凱基99售07,,,,,0.00,0.00,0,0,0,0,0,0,0,0,0,0,0,0,0
20200430,07094P,華通國票9A售03,2.58,2.58,2.37,2.37,-0.36,-13.19,68000,13,166220,0,0,0,0,0,0,35000,33000,2000,2000
20200430,07095P,台灣50元大9C售03,,,,,0.00,0.00,0,0,0,0,0,0,0,0,0,0,0,0,0
20200430,07096P,元石油元大9C售05,,,,,0.00,0.00,0,0,0,0,0,0,0,0,0,0,0,0,0
20200430,07097P,元油2X元大9C售09,,,,,0.00,0.00,0,0,0,0,0,0,0,0,0,0,0,0,0
20200430,07098P,台積電元大99售18,,,,,0.00,0.00,0,0,0,0,0,0,0,0,0,0,0,0,0
20200430,07099P,台積電元大99售19,,,,,0.00,0.00,0,0,0,0,0,0,0,0,0,0,0,0,0
20200430,07100P,華航元大99售01,0.85,0.96,0.85,0.93,-0.06,-6.06,74000,17,67730,0,0,0,0,0,0,0,37000,-37000,-37000
20200430,07101P,台郡元大99售06,,,,,0.00,0.00,0,0,0,0,0,0,0,0,0,0,0,0,0
20200430,07102P,南電元大99售03,,,,,0.00,0.00,0,0,0,0,0,0,0,0,0,0,0,0,0
20200430,07103P,南電元大99售04,2.21,2.34,2.20,2.34,0.00,0.00,180000,15,411170,0,0,0,0,0,0,78000,100000,-22000,-22000
20200430,07104P,聯發科元富99售04,,,,,0.00,0.00,0,0,0,0,0,0,0,0,0,0,0,0,0
20200430,07105P,大毅元富99售02,0.65,0.65,0.57,0.65,-0.08,-10.96,156000,11,97640,0,0,0,0,0,0,120000,36000,84000,84000
20200430,07106P,國巨統一9B售05,1.11,1.15,1.11,1.11,-0.06,-5.13,594000,13,671000,0,0,0,0,0,0,97000,497000,-400000,-400000
20200430,07107P,臺股指統一99售07,3.48,3.48,3.48,3.48,-0.15,-4.13,8000,1,27840,0,0,0,0,0,0,0,8000,-8000,-8000
20200430,07108P,FBVIX台新99售02,0.79,0.79,0.07,0.07,0.00,0.00,39000,6,9210,0,0,0,0,0,0,8000,30000,-22000,-22000
20200430,07109P,聯發科中信9B售02,0.98,0.99,0.92,0.92,-0.15,-14.02,80000,5,76100,0,0,0,0,0,0,40000,40000,0,0
20200430,07110P,台灣50群益9B售03,,,,,0.00,0.00,0,0,0,0,0,0,0,0,0,0,0,0,0
20200430,07111P,台積電群益99售08,,,,,0.00,0.00,0,0,0,0,0,0,0,0,0,0,0,0,0
20200430,07112P,聯發科群益99售05,3.45,3.45,3.45,3.45,-0.44,-11.31,1000,1,3450,0,0,0,0,0,0,1000,0,1000,1000
20200430,07113P,台積電兆豐99售03,0.85,0.85,0.85,0.85,-0.13,-13.27,1000,1,850,0,0,0,0,0,0,1000,0,1000,1000
20200430,07114P,旺宏兆豐9A售01,1.62,1.68,1.62,1.68,-0.16,-8.7,11000,2,17880,0,0,0,0,0,0,10000,1000,9000,9000
20200430,07115P,T50反1日盛9C售02,,,,,0.00,0.00,0,0,0,0,0,0,0,0,0,0,0,0,0
20200430,07116P,台灣50麥證9A售02,,,,,0.00,0.00,0,0,0,0,0,0,0,0,0,0,0,0,0
20200430,07117P,SGBR2X凱基9C售01,,,,,0.00,0.00,0,0,0,0,0,0,0,0,0,0,0,0,0
20200430,07118P,台積電凱基99售09,1.46,1.46,1.46,1.46,-0.19,-11.52,8000,1,11680,0,0,0,0,0,0,8000,0,8000,8000
20200430,07119P,台積電凱基9A售08,,,,,0.00,0.00,0,0,0,0,0,0,0,0,0,0,0,0,0
20200430,07120P,聯發科凱基99售09,,,,,0.00,0.00,0,0,0,0,0,0,0,0,0,0,0,0,0
20200430,07121P,華新科凱基99售03,1.77,1.77,1.77,1.77,+0.01,0.57,2000,1,3540,0,0,0,0,0,0,0,2000,-2000,-2000
20200430,07122P,欣興凱基99售05,1.50,1.52,1.44,1.51,-0.09,-5.62,170000,10,253680,0,0,0,0,0,0,60000,110000,-50000,-50000
20200430,07123P,鴻海元大99售23,,,,,0.00,0.00,0,0,0,0,0,0,0,0,0,0,0,0,0
20200430,07124P,台積電元大99售21,1.28,1.28,1.27,1.27,-0.13,-9.29,4000,2,5100,0,0,0,0,0,0,2000,0,2000,2000
20200430,07125P,台積電元大99售22,,,,,0.00,0.00,0,0,0,0,0,0,0,0,0,0,0,0,0
20200430,07126P,台積電元大99售23,1.11,1.11,1.11,1.11,-0.21,-15.91,9000,1,9990,0,0,0,0,0,0,9000,0,9000,9000
20200430,07127P,精元元大99售01,3.21,3.24,3.19,3.24,-0.08,-2.41,42000,4,135060,0,0,0,0,0,0,15000,9000,6000,6000
20200430,07128P,大毅元大99售04,0.66,0.68,0.60,0.68,-0.04,-5.56,944000,32,603930,0,0,0,0,0,0,626000,310000,316000,316000
20200430,07129P,華新科元大99售14,3.79,3.90,3.79,3.88,-0.09,-2.27,307000,10,1180520,0,0,0,0,0,0,150000,157000,-7000,-7000
20200430,07130P,台郡元大9B售01,0.97,0.98,0.95,0.95,-0.04,-4.04,150000,7,146020,0,0,0,0,0,0,8000,142000,-134000,-134000
20200430,07131P,緯穎元大99售06,2.73,2.76,2.38,2.46,-0.44,-15.17,277000,13,739230,0,0,0,0,0,0,224000,92000,132000,132000
20200430,07132P,臺股指元大99售11,,,,,0.00,0.00,0,0,0,0,0,0,0,0,0,0,0,0,0
20200430,07133P,臺股指元大9A售27,3.03,3.03,2.82,2.86,-0.33,-10.34,121000,11,354710,0,0,0,0,0,0,58000,63000,-5000,-5000
20200430,07134P,臺股指元大9A售28,4.25,4.26,4.09,4.10,-0.28,-6.39,158000,25,654790,0,0,0,0,0,0,91000,67000,24000,24000
20200430,07135P,臺股指元大9A售29,4.85,4.85,4.85,4.85,-0.20,-3.96,1000,1,4850,0,0,0,0,0,0,0,1000,-1000,-1000
20200430,07136P,T50反1台新01售01,,,,,0.00,0.00,0,0,0,0,0,0,0,0,0,0,0,0,0
20200430,07137P,大立光中信9B售01,,,,,0.00,0.00,0,0,0,0,0,0,0,0,0,0,0,0,0
20200430,07138P,台灣50群益9B售04,4.32,4.32,4.32,4.32,0.00,0.00,5000,1,21600,0,0,0,0,0,0,5000,0,5000,5000
20200430,07139P,元油2X群益9C售06,3.38,3.42,3.38,3.39,0.00,0.00,27000,4,91490,0,0,0,0,0,0,21000,0,21000,21000
20200430,07140P,台灣50日盛99售01,3.90,3.90,3.90,3.90,+0.92,30.87,1000,1,3900,0,0,0,0,0,0,0,0,0,0
20200430,07141P,台灣50國票9A售03,5.30,5.30,5.30,5.30,-0.75,-12.4,10000,1,53000,0,0,0,0,0,0,0,10000,-10000,-10000
20200430,07142P,台灣50元大01售01,,,,,0.00,0.00,0,0,0,0,0,0,0,0,0,0,0,0,0
20200430,07143P,FBVIX元大99售02,,,,,0.00,0.00,0,0,0,0,0,0,0,0,0,0,0,0,0
20200430,07144P,FBVIX元大99售03,1.11,1.11,1.11,1.11,0.00,0.00,1000,1,1110,0,0,0,0,0,0,0,1000,-1000,-1000
20200430,07145P,為升元大99售03,1.66,1.67,1.66,1.67,-0.08,-4.57,9000,2,14960,0,0,0,0,0,0,9000,0,9000,9000
20200430,07146P,瑞昱元大99售02,1.42,1.42,1.35,1.35,-0.25,-15.62,13000,3,18250,0,0,0,0,0,0,9000,0,9000,9000
20200430,07147P,高鐵元大99售01,1.00,1.01,0.97,1.01,-0.03,-2.88,248000,6,250090,0,0,0,0,0,0,0,248000,-248000,-248000
20200430,07148P,富邦金元大99售01,1.95,1.97,1.80,1.82,-0.29,-13.74,431000,26,805390,0,0,0,0,0,0,173000,258000,-85000,-85000
20200430,07149P,健鼎元大99售03,2.53,2.53,2.50,2.50,-0.18,-6.72,140000,4,353000,0,0,0,0,0,0,140000,0,140000,140000
20200430,07150P,和碩元大99售01,,,,,0.00,0.00,0,0,0,0,0,0,0,0,0,0,0,0,0
20200430,07151P,台灣50統一9B售04,,,,,0.00,0.00,0,0,0,0,0,0,0,0,0,0,0,0,0
20200430,07152P,臺股指元富99售08,,,,,0.00,0.00,0,0,0,0,0,0,0,0,0,0,0,0,0
20200430,07153P,臺股指元富99售09,,,,,0.00,0.00,0,0,0,0,0,0,0,0,0,0,0,0,0
20200430,07155P,臺股指元富99售10,,,,,0.00,0.00,0,0,0,0,0,0,0,0,0,0,0,0,0
20200430,07156P,臺股指元富99售11,,,,,0.00,0.00,0,0,0,0,0,0,0,0,0,0,0,0,0
20200430,07157P,臺股指元富99售12,,,,,0.00,0.00,0,0,0,0,0,0,0,0,0,0,0,0,0
20200430,07158P,FBVIX國泰9C售01,1.45,1.45,1.45,1.45,+0.01,0.69,1000,1,1450,0,0,0,0,0,0,1000,0,1000,1000
20200430,07159P,台積電永豐99售04,0.62,0.62,0.60,0.60,0.00,0.00,90000,2,55600,0,0,0,0,0,0,90000,0,90000,90000
20200430,07160P,台灣50中信03售04,3.27,3.27,3.22,3.22,-0.13,-3.88,16000,4,52250,0,0,0,0,0,0,10000,6000,4000,4000
20200430,07161P,臺股指群益99售12,6.40,6.40,6.30,6.30,-0.45,-6.67,4000,3,25400,0,0,0,0,0,0,0,4000,-4000,-4000
20200430,07162P,臺股指群益99售13,2.71,2.73,2.50,2.52,-0.36,-12.5,2039000,103,5355220,0,0,0,0,0,0,1179000,850000,329000,329000
20200430,07163P,臺股指群益99售14,2.97,2.97,2.77,2.80,-0.35,-11.11,281000,20,798520,0,0,0,0,0,0,111000,170000,-59000,-59000
20200430,07164P,臺股指群益99售15,2.97,2.99,2.79,2.79,-0.37,-11.71,303000,16,868650,0,0,0,0,0,0,131000,172000,-41000,-41000
20200430,07165P,臺股指群益99售16,4.70,4.72,4.70,4.72,-0.43,-8.35,8000,2,37680,0,0,0,0,0,0,0,8000,-8000,-8000
20200430,07166P,台灣50兆豐03售01,0.95,0.95,0.81,0.81,-0.27,-25.0,288000,44,258960,0,0,0,0,0,0,0,223000,-223000,-223000
20200430,07167P,臺股指兆豐99售02,,,,,0.00,0.00,0,0,0,0,0,0,0,0,0,0,0,0,0
20200430,07168P,臺股指兆豐99售03,,,,,0.00,0.00,0,0,0,0,0,0,0,0,0,0,0,0,0
20200430,07169P,臺股指國票99售06,,,,,0.00,0.00,0,0,0,0,0,0,0,0,0,0,0,0,0
20200430,07170P,臺股指國票99售07,3.41,3.46,3.18,3.19,-0.48,-13.08,187000,10,609390,0,0,0,0,0,0,91000,96000,-5000,-5000
20200430,07171P,臺股指國票99售08,2.71,2.71,2.48,2.51,-0.39,-13.45,160000,21,411890,0,0,0,0,0,0,101000,59000,42000,42000
20200430,07172P,臺股指國票99售09,2.81,2.81,2.59,2.59,-0.39,-13.09,508000,50,1375690,0,0,0,0,0,0,195000,313000,-118000,-118000
20200430,07173P,臺股指國票99售10,2.20,2.20,2.00,2.01,-0.33,-14.1,680000,36,1393870,0,0,0,0,0,0,403000,277000,126000,126000
20200430,07174P,臺股指國票99售11,4.09,4.15,3.78,3.80,-0.61,-13.83,959000,48,3805710,0,0,0,0,0,0,483000,476000,7000,7000
20200430,07175P,聯詠凱基99售02,1.71,1.71,1.67,1.67,-0.08,-4.57,108000,4,184600,0,0,0,0,0,0,106000,2000,104000,104000
20200430,07176P,臺股指凱基99售18,4.30,4.30,4.30,4.30,-0.21,-4.66,2000,1,8600,0,0,0,0,0,0,2000,0,2000,2000
20200430,07177P,臺股指凱基99售19,,,,,0.00,0.00,0,0,0,0,0,0,0,0,0,0,0,0,0
20200430,07178P,臺股指凱基99售20,3.83,3.83,3.61,3.61,-0.39,-9.75,181000,11,677810,0,0,0,0,0,0,71000,110000,-39000,-39000
20200430,07179P,臺股指凱基99售21,,,,,0.00,0.00,0,0,0,0,0,0,0,0,0,0,0,0,0
20200430,07180P,臺股指凱基99售22,4.24,4.24,4.24,4.24,-0.32,-7.02,32000,1,135680,0,0,0,0,0,0,32000,0,32000,32000
20200430,07181P,臺股指凱基99售23,3.63,3.63,3.45,3.45,-0.35,-9.21,103000,12,366170,0,0,0,0,0,0,28000,75000,-47000,-47000
20200430,07182P,臺股指凱基99售24,,,,,0.00,0.00,0,0,0,0,0,0,0,0,0,0,0,0,0
20200430,07183P,臺股指凱基99售25,,,,,0.00,0.00,0,0,0,0,0,0,0,0,0,0,0,0,0
20200430,07184P,台灣50元富01售01,4.32,4.32,4.32,4.32,-0.23,-5.05,84000,2,362880,0,0,0,0,0,0,41000,43000,-2000,-2000
20200430,07185P,臺股指統一9C售01,,,,,0.00,0.00,0,0,0,0,0,0,0,0,0,0,0,0,0
20200430,07186P,臺股指統一9C售02,,,,,0.00,0.00,0,0,0,0,0,0,0,0,0,0,0,0,0
20200430,07187P,臺股指台新99售10,1.56,1.56,1.38,1.38,-0.18,-11.54,111000,12,157120,0,0,0,0,0,0,23000,83000,-60000,-60000
20200430,07188P,臺股指台新99售11,0.14,0.14,0.14,0.14,0.00,0.00,30000,4,4200,0,0,0,0,0,0,0,30000,-30000,-30000
20200430,07189P,聯發科富邦9B售03,1.12,1.12,1.10,1.10,-0.11,-9.09,71000,13,79060,0,0,0,0,0,0,16000,52000,-36000,-36000
20200430,07190P,臺股指富邦9C售02,2.04,2.04,2.00,2.00,-0.09,-4.31,85000,10,171550,0,0,0,0,0,0,69000,15000,54000,54000
20200430,07191P,台積電元大99售32,,,,,0.00,0.00,0,0,0,0,0,0,0,0,0,0,0,0,0
20200430,07192P,聯發科元大99售23,4.27,4.30,4.27,4.30,-0.63,-12.78,34000,2,145480,0,0,0,0,0,0,24000,10000,14000,14000
20200430,07193P,聯發科元大99售24,,,,,0.00,0.00,0,0,0,0,0,0,0,0,0,0,0,0,0
20200430,07194P,聯發科元大99售25,4.64,4.64,4.33,4.33,-0.87,-16.73,25000,4,115470,0,0,0,0,0,0,23000,2000,21000,21000
20200430,07195P,大立光元大99售12,,,,,0.00,0.00,0,0,0,0,0,0,0,0,0,0,0,0,0
20200430,07196P,大立光元大99售13,,,,,0.00,0.00,0,0,0,0,0,0,0,0,0,0,0,0,0
20200430,07197P,臺股指元大99售13,4.97,4.97,4.76,4.78,-0.42,-8.08,167000,8,814690,0,0,0,0,0,0,6000,161000,-155000,-155000
20200430,07198P,臺股指元大99售14,,,,,0.00,0.00,0,0,0,0,0,0,0,0,0,0,0,0,0
20200430,07199P,臺股指元大99售15,,,,,0.00,0.00,0,0,0,0,0,0,0,0,0,0,0,0,0
20200430,07200P,臺股指元大99售16,,,,,0.00,0.00,0,0,0,0,0,0,0,0,0,0,0,0,0
20200430,07201P,臺股指元大99售17,4.31,4.31,4.31,4.31,0.00,0.00,5000,1,21550,0,0,0,0,0,0,5000,0,5000,5000
20200430,07202P,台灣50凱基9C售04,1.91,1.91,1.80,1.81,-0.21,-10.4,142000,13,261880,0,0,0,0,0,0,31000,111000,-80000,-80000
20200430,07203P,T50正2凱基9C售02,1.66,1.66,1.57,1.57,0.00,0.00,15000,2,24000,0,0,0,0,0,0,10000,5000,5000,5000
20200430,07204P,鴻海凱基99售10,,,,,0.00,0.00,0,0,0,0,0,0,0,0,0,0,0,0,0
20200430,07205P,鴻海凱基99售11,,,,,0.00,0.00,0,0,0,0,0,0,0,0,0,0,0,0,0
20200430,07206P,鴻海凱基9A售11,1.23,1.23,1.23,1.23,-0.04,-3.15,8000,1,9840,0,0,0,0,0,0,0,8000,-8000,-8000
20200430,07207P,台積電凱基99售13,2.28,2.28,2.28,2.28,0.00,0.00,11000,1,25080,0,0,0,0,0,0,11000,0,11000,11000
20200430,07208P,台積電凱基99售14,1.02,1.02,0.95,1.02,0.00,0.00,96000,10,93910,0,0,0,0,0,0,61000,0,61000,61000
20200430,07209P,台積電凱基9A售10,,,,,0.00,0.00,0,0,0,0,0,0,0,0,0,0,0,0,0
20200430,07210P,智邦凱基99售03,0.40,0.47,0.40,0.47,+0.01,2.17,105000,15,47320,0,0,0,0,0,0,83000,22000,61000,61000
20200430,07211P,南亞科凱基99售05,,,,,0.00,0.00,0,0,0,0,0,0,0,0,0,0,0,0,0
20200430,07212P,聯發科凱基99售14,0.59,0.59,0.59,0.59,-0.14,-19.18,25000,3,14750,0,0,0,0,0,0,25000,0,25000,25000
20200430,07213P,聯發科凱基99售15,,,,,0.00,0.00,0,0,0,0,0,0,0,0,0,0,0,0,0
20200430,07214P,聯發科凱基9A售04,0.91,0.91,0.85,0.85,-0.10,-10.53,21000,4,17910,0,0,0,0,0,0,0,21000,-21000,-21000
20200430,07215P,大立光凱基99售07,1.37,1.37,1.31,1.31,-0.13,-9.03,660000,4,902700,0,0,0,0,0,0,630000,30000,600000,600000
20200430,07216P,大立光凱基99售08,1.32,1.32,1.30,1.30,0.00,0.00,34000,2,44600,0,0,0,0,0,0,34000,0,34000,34000
20200430,07217P,大立光凱基9A售05,1.18,1.18,1.15,1.15,-0.11,-8.73,41000,3,48130,0,0,0,0,0,0,31000,10000,21000,21000
20200430,07218P,臺股指凱基99售31,2.29,2.32,2.15,2.16,-0.27,-11.11,212000,18,483970,0,0,0,0,0,0,14000,198000,-184000,-184000
20200430,07219P,臺股指凱基99售32,2.72,2.77,2.60,2.60,-0.32,-10.96,149000,14,397020,0,0,0,0,0,0,113000,36000,77000,77000
20200430,07220P,台灣50中信03售05,2.96,2.96,2.93,2.93,-0.07,-2.33,25000,4,73540,0,0,0,0,0,0,24000,1000,23000,23000
20200430,07221P,臺股指中信9B售04,,,,,0.00,0.00,0,0,0,0,0,0,0,0,0,0,0,0,0
20200430,07222P,台灣50元大01售04,,,,,0.00,0.00,0,0,0,0,0,0,0,0,0,0,0,0,0
20200430,07223P,鴻海元大99售29,2.42,2.42,2.42,2.42,-0.08,-3.2,3000,1,7260,0,0,0,0,0,0,0,3000,-3000,-3000
20200430,07224P,鴻海元大9A售02,1.09,1.10,1.09,1.09,0.00,0.00,509000,5,556410,0,0,0,0,0,0,509000,499000,10000,10000
20200430,07225P,台積電元大99售33,,,,,0.00,0.00,0,0,0,0,0,0,0,0,0,0,0,0,0
20200430,07226P,貿聯富邦9B售01,0.44,0.44,0.40,0.40,-0.07,-14.89,11000,6,4520,0,0,0,0,0,0,0,11000,-11000,-11000
20200430,07227P,聯發科元富99售05,1.24,1.25,1.21,1.21,-0.21,-14.79,190000,4,236000,0,0,0,0,0,0,70000,120000,-50000,-50000
20200430,07228P,台灣50群益9B售06,2.63,2.63,2.63,2.63,-0.17,-6.07,125000,2,328750,0,0,0,0,0,0,61000,64000,-3000,-3000
20200430,07229P,T50正2群益9A售01,,,,,0.00,0.00,0,0,0,0,0,0,0,0,0,0,0,0,0
20200430,07230P,滬深2X群益01售02,,,,,0.00,0.00,0,0,0,0,0,0,0,0,0,0,0,0,0
20200430,07231P,台灣50元大01售06,5.55,5.55,5.55,5.55,0.00,0.00,1000,1,5550,0,0,0,0,0,0,1000,0,1000,1000
20200430,07232P,台灣50元大01售07,,,,,0.00,0.00,0,0,0,0,0,0,0,0,0,0,0,0,0
20200430,07233P,台灣50元大99售04,2.88,2.88,2.77,2.77,-0.22,-7.36,89000,8,249230,0,0,0,0,0,0,55000,34000,21000,21000
20200430,07234P,台灣50元大9B售04,,,,,0.00,0.00,0,0,0,0,0,0,0,0,0,0,0,0,0
20200430,07235P,T50正2元大9C售02,3.79,3.79,3.69,3.70,-0.18,-4.64,52000,13,193960,0,0,0,0,0,0,15000,37000,-22000,-22000
20200430,07236P,台灣50國票99售05,,,,,0.00,0.00,0,0,0,0,0,0,0,0,0,0,0,0,0
20200430,07237P,台灣50國票99售06,,,,,0.00,0.00,0,0,0,0,0,0,0,0,0,0,0,0,0
20200430,07238P,台灣50國票99售07,,,,,0.00,0.00,0,0,0,0,0,0,0,0,0,0,0,0,0
20200430,07239P,台灣50國票9A售04,3.55,3.55,3.46,3.46,-0.40,-10.36,2000,2,7010,0,0,0,0,0,0,1000,1000,0,0
20200430,07241P,台灣50國票9A售05,4.68,4.68,4.53,4.53,-0.47,-9.4,158000,4,723380,0,0,0,0,0,0,33000,125000,-92000,-92000
20200430,07242P,台灣50凱基9A售03,1.84,1.84,1.77,1.77,-0.14,-7.33,90000,8,162250,0,0,0,0,0,0,15000,75000,-60000,-60000
20200430,07243P,台灣50凱基9A售04,2.06,2.06,1.99,1.99,-0.17,-7.87,16000,8,32690,0,1000,-1000,0,0,0,11000,5000,6000,5000
20200430,07244P,鴻海凱基9A售13,1.78,1.78,1.78,1.78,0.00,0.00,10000,1,17800,0,0,0,0,0,0,10000,0,10000,10000
20200430,07245P,台積電凱基99售16,2.44,2.45,2.40,2.41,-0.14,-5.49,324000,10,787990,0,0,0,0,0,0,200000,124000,76000,76000
20200430,07246P,旺宏凱基99售08,1.08,1.10,1.08,1.10,-0.07,-5.98,36000,6,39580,0,0,0,0,0,0,31000,5000,26000,26000
20200430,07247P,聯發科凱基9A售06,0.80,0.80,0.75,0.75,-0.14,-15.73,330000,14,257100,0,0,0,0,0,0,80000,250000,-170000,-170000
20200430,07248P,可成凱基99售06,0.65,0.67,0.65,0.67,-0.02,-2.9,47000,2,31090,0,0,0,0,0,0,20000,27000,-7000,-7000
20200430,07249P,T50正2富邦03售02,0.60,0.61,0.50,0.59,+0.01,1.72,49000,7,26890,0,0,0,0,0,0,15000,13000,2000,2000
20200430,07250P,台灣50永豐99售07,0.99,0.99,0.99,0.99,0.00,0.00,5000,1,4950,0,0,0,0,0,0,0,5000,-5000,-5000
20200430,07251P,台灣50元富01售04,1.37,1.37,1.35,1.35,-0.12,-8.16,5000,2,6830,0,0,0,0,0,0,0,5000,-5000,-5000
20200430,07252P,台灣50凱基99售01,1.76,1.78,1.68,1.68,-0.21,-11.11,155000,8,266200,0,0,0,0,0,0,70000,85000,-15000,-15000
20200430,07253P,台灣50凱基9A售05,,,,,0.00,0.00,0,0,0,0,0,0,0,0,0,0,0,0,0
20200430,07254P,台灣50凱基9C售06,1.66,1.66,1.66,1.66,0.00,0.00,2000,1,3320,0,0,0,0,0,0,2000,0,2000,2000
20200430,07255P,國巨凱基99售15,0.71,0.72,0.68,0.70,-0.04,-5.41,368000,28,258610,0,0,0,0,0,0,195000,158000,37000,37000
20200430,07256P,臺股指凱基99售36,2.26,2.26,2.19,2.19,-0.16,-6.81,52000,5,115510,0,0,0,0,0,0,49000,3000,46000,46000
20200430,07257P,臺股指凱基99售37,2.12,2.13,2.06,2.07,-0.13,-5.91,400000,20,840330,0,0,0,0,0,0,294000,86000,208000,208000
20200430,07258P,台灣50台新9A售01,0.61,0.61,0.56,0.56,-0.09,-13.85,558000,17,329250,0,0,0,0,0,0,105000,453000,-348000,-348000
20200430,07259P,滬深2X國票01售01,0.64,0.64,0.60,0.64,-0.02,-3.03,108000,9,67290,0,0,0,0,0,0,83000,25000,58000,58000
20200430,07260P,台灣50元大9A售01,2.99,2.99,2.91,2.91,-0.21,-6.73,45000,3,133250,0,0,0,0,0,0,0,45000,-45000,-45000
20200430,07261P,台灣50元大9A售04,,,,,0.00,0.00,0,0,0,0,0,0,0,0,0,0,0,0,0
20200430,07262P,台灣50元大9B售05,,,,,0.00,0.00,0,0,0,0,0,0,0,0,0,0,0,0,0
20200430,07263P,台積電元大99售37,1.56,1.57,1.51,1.51,-0.17,-10.12,801000,26,1232110,0,0,0,0,0,0,527000,464000,63000,63000
20200430,07264P,台積電元大99售38,2.64,2.64,2.61,2.61,-0.21,-7.45,322000,6,843470,0,0,0,0,0,0,307000,210000,97000,97000
20200430,07265P,大立光元大99售16,1.91,1.91,1.86,1.86,-0.21,-10.14,116000,7,218070,0,0,0,0,0,0,80000,31000,49000,49000
20200430,07266P,大立光元大99售19,2.23,2.23,2.23,2.23,-0.23,-9.35,3000,1,6690,0,0,0,0,0,0,3000,0,3000,3000
20200430,07267P,臺股指元大99售23,3.82,3.82,3.69,3.69,-0.24,-6.11,57000,3,212340,0,0,0,0,0,0,35000,22000,13000,13000
20200430,07268P,臺股指元大99售24,,,,,0.00,0.00,0,0,0,0,0,0,0,0,0,0,0,0,0
20200430,07269P,台灣50元大01售08,,,,,0.00,0.00,0,0,0,0,0,0,0,0,0,0,0,0,0
20200430,07270P,台灣50元大01售09,3.96,3.96,3.91,3.91,-0.17,-4.17,76000,4,297210,0,0,0,0,0,0,75000,1000,74000,74000
20200430,07271P,台灣50元大9C售04,3.29,3.29,3.29,3.29,-0.11,-3.24,2000,1,6580,0,0,0,0,0,0,2000,0,2000,2000
20200430,07272P,台灣50元大9C售05,3.62,3.62,3.60,3.60,-0.17,-4.51,12000,2,43400,0,0,0,0,0,0,10000,2000,8000,8000
20200430,07273P,台灣50群益99售03,,,,,0.00,0.00,0,0,0,0,0,0,0,0,0,0,0,0,0
20200430,07274P,上証2X群益01售01,2.06,2.07,2.06,2.07,0.00,0.00,7000,2,14440,0,0,0,0,0,0,5000,2000,3000,3000
20200430,07275P,FBVIX群益99售02,,,,,0.00,0.00,0,0,0,0,0,0,0,0,0,0,0,0,0
20200430,07276P,臺股指群益99售19,1.82,1.82,1.74,1.75,-0.14,-7.41,645000,32,1140240,0,0,0,0,0,0,538000,97000,441000,441000
20200430,07277P,臺股指群益99售20,,,,,0.00,0.00,0,0,0,0,0,0,0,0,0,0,0,0,0
20200430,07278P,台灣50元富9C售03,,,,,0.00,0.00,0,0,0,0,0,0,0,0,0,0,0,0,0
20200430,07279P,台灣50台新99售02,0.28,0.28,0.25,0.25,-0.06,-19.35,725000,25,200140,0,0,0,0,0,0,35000,647000,-612000,-612000
20200430,07280P,FBVIX凱基99售01,1.56,1.58,1.56,1.58,+0.03,1.94,108000,5,170500,0,0,0,0,0,0,8000,100000,-92000,-92000
20200430,07281P,鴻海凱基99售13,1.22,1.22,1.20,1.20,-0.05,-4.0,170000,8,206590,0,0,0,0,0,0,31000,138000,-107000,-107000
20200430,07282P,聯發科凱基99售17,1.07,1.07,1.05,1.05,-0.11,-9.48,358000,4,383000,0,0,0,0,0,0,358000,0,358000,358000
20200430,07283P,華新科凱基99售07,0.50,0.50,0.50,0.50,0.00,0.00,6000,1,3000,0,0,0,0,0,0,0,6000,-6000,-6000
20200430,07284P,大立光凱基99售10,1.44,1.44,1.38,1.38,-0.10,-6.76,149000,15,210110,0,0,0,0,0,0,80000,49000,31000,31000
20200430,07285P,上証2X群益01售02,,,,,0.00,0.00,0,0,0,0,0,0,0,0,0,0,0,0,0
20200430,07286P,元石油群益99售03,,,,,0.00,0.00,0,0,0,0,0,0,0,0,0,0,0,0,0
20200430,07287P,全新群益9B售01,,,,,0.00,0.00,0,0,0,0,0,0,0,0,0,0,0,0,0
20200430,07288P,台灣50凱基99售06,0.73,0.73,0.71,0.71,-0.04,-5.33,19000,5,13640,0,0,0,0,0,0,11000,8000,3000,3000
20200430,07289P,台灣50凱基99售07,0.68,0.68,0.68,0.68,-0.04,-5.56,40000,1,27200,0,0,0,0,0,0,0,40000,-40000,-40000
20200430,07290P,台灣50凱基9A售08,0.71,0.71,0.71,0.71,-0.05,-6.58,50000,1,35500,0,0,0,0,0,0,0,50000,-50000,-50000
20200430,07291P,臺股指凱基99售43,0.89,0.89,0.86,0.87,-0.05,-5.43,327000,12,286640,0,0,0,0,0,0,307000,15000,292000,292000
20200430,07292P,臺股指凱基99售44,0.78,0.78,0.75,0.76,-0.04,-5.0,3225000,86,2461360,0,0,0,0,0,0,1591000,1035000,556000,556000
20200430,07293P,臺股指凱基99售45,1.10,1.11,1.07,1.07,-0.06,-5.31,487000,21,531400,0,0,0,0,0,0,439000,39000,400000,400000
20200430,07294P,滬深2X元富9C售08,1.96,2.01,1.96,2.01,-0.08,-3.83,66000,5,130150,0,0,0,0,0,0,66000,15000,51000,51000
20200430,07295P,滬深2X元富9C售09,1.64,1.64,1.61,1.61,-0.07,-4.17,20000,2,32350,0,0,0,0,0,0,20000,0,20000,20000
20200430,07296P,T50反1台新99售02,,,,,0.00,0.00,0,0,0,0,0,0,0,0,0,0,0,0,0
20200430,07297P,台灣50元大9C售11,,,,,0.00,0.00,0,0,0,0,0,0,0,0,0,0,0,0,0
20200430,07298P,台灣50元大9C售12,,,,,0.00,0.00,0,0,0,0,0,0,0,0,0,0,0,0,0
20200430,07299P,台灣50元大9C售13,,,,,0.00,0.00,0,0,0,0,0,0,0,0,0,0,0,0,0
20200430,07300P,臺股指元大9A售33,1.12,1.13,1.08,1.08,-0.07,-6.09,300000,22,328650,0,0,0,0,0,0,121000,179000,-58000,-58000
20200430,07301P,臺股指元大9A售34,1.12,1.12,1.10,1.10,-0.07,-5.98,13000,4,14430,0,0,0,0,0,0,0,13000,-13000,-13000
20200430,07302P,臺股指元大9A售35,1.25,1.27,1.21,1.21,-0.09,-6.92,200000,5,246440,0,0,0,0,0,0,92000,108000,-16000,-16000
20200430,07303P,臺股指元大9A售36,1.26,1.27,1.21,1.21,-0.10,-7.63,578000,25,717670,0,0,0,0,0,0,351000,227000,124000,124000
20200430,07304P,臺股指元大9A售37,1.41,1.41,1.35,1.35,-0.10,-6.9,879000,20,1206340,0,0,0,0,0,0,569000,310000,259000,259000
20200430,07305P,T50正2群益99售02,1.00,1.00,0.99,0.99,-0.08,-7.48,30000,5,29900,0,0,0,0,0,0,20000,10000,10000,10000
20200430,07306P,台灣50凱基9A售09,0.69,0.70,0.68,0.68,-0.04,-5.56,8000,3,5540,0,0,0,0,0,0,2000,6000,-4000,-4000
20200430,07307P,上証2X凱基9A售02,,,,,0.00,0.00,0,0,0,0,0,0,0,0,0,0,0,0,0
20200430,07308P,滬深2X凱基9A售01,,,,,0.00,0.00,0,0,0,0,0,0,0,0,0,0,0,0,0
20200430,07309P,聯發科凱基99售18,0.60,0.61,0.60,0.60,-0.06,-9.09,22000,3,13240,0,0,0,0,0,0,18000,4000,14000,14000
20200430,07310P,大立光凱基99售12,0.62,0.63,0.61,0.61,-0.03,-4.69,112000,6,69440,0,0,0,0,0,0,0,112000,-112000,-112000
20200430,07311P,台灣50元大99售09,1.29,1.29,1.29,1.29,-0.06,-4.44,74000,2,95460,0,0,0,0,0,0,0,74000,-74000,-74000
20200430,07312P,台灣50元大99售10,1.17,1.17,1.11,1.12,-0.11,-8.94,773000,24,884130,0,0,0,0,0,0,573000,197000,376000,376000
20200430,07313P,台灣50元大99售11,1.12,1.12,1.09,1.09,-0.10,-8.4,15000,2,16650,0,0,0,0,0,0,15000,0,15000,15000
20200430,07314P,T50正2元大9C售03,2.02,2.02,1.99,1.99,0.00,0.00,22000,2,43840,0,0,0,0,0,0,2000,20000,-18000,-18000
20200430,07315P,台積電台新99售06,0.40,0.40,0.19,0.19,-0.27,-58.7,147000,8,49050,0,0,0,0,0,0,100000,45000,55000,55000
20200430,07316P,長榮航康和99售01,0.58,0.58,0.56,0.58,-0.03,-4.92,131000,5,74980,0,0,0,0,0,0,0,131000,-131000,-131000
20200430,07317P,T50正2凱基9B售02,0.90,0.90,0.87,0.87,-0.07,-7.45,447000,6,393250,0,0,0,0,0,0,430000,17000,413000,413000
20200430,07318P,鴻海凱基01售02,0.73,0.73,0.73,0.73,-0.01,-1.35,60000,1,43800,0,0,0,0,0,0,60000,0,60000,60000
20200430,07319P,台積電凱基01售02,0.64,0.65,0.63,0.63,-0.02,-3.08,479000,18,305060,0,0,0,0,0,0,299000,89000,210000,210000
20200430,07320P,台灣50元大9C售14,,,,,0.00,0.00,0,0,0,0,0,0,0,0,0,0,0,0,0
20200430,07321P,台灣50元大9C售15,,,,,0.00,0.00,0,0,0,0,0,0,0,0,0,0,0,0,0
20200430,07322P,鴻海元大99售33,2.58,2.58,2.58,2.58,-0.08,-3.01,1000,1,2580,0,0,0,0,0,0,1000,1000,0,0
20200430,07323P,鴻海元大99售34,,,,,0.00,0.00,0,0,0,0,0,0,0,0,0,0,0,0,0
20200430,07324P,台積電元大99售40,2.26,2.26,2.20,2.20,-0.19,-7.95,265000,4,591900,0,0,0,0,0,0,265000,200000,65000,65000
20200430,07325P,台積電元大99售41,2.37,2.37,2.34,2.34,-0.15,-6.02,232000,3,543240,0,0,0,0,0,0,232000,200000,32000,32000
20200430,07326P,大立光元大99售23,,,,,0.00,0.00,0,0,0,0,0,0,0,0,0,0,0,0,0
20200430,07327P,台灣50群益9A售06,1.98,1.98,1.91,1.92,-0.13,-6.34,110000,4,212000,0,0,0,0,0,0,40000,70000,-30000,-30000
20200430,07328P,FBVIX國泰9B售01,1.89,1.91,1.89,1.91,+0.03,1.6,31000,4,58950,0,0,0,0,0,0,21000,10000,11000,11000
20200430,07329P,台灣50群益9A售07,2.65,2.65,2.65,2.65,0.00,0.00,10000,1,26500,0,0,0,0,0,0,0,10000,-10000,-10000
20200430,07330P,台灣50群益9A售08,,,,,0.00,0.00,0,0,0,0,0,0,0,0,0,0,0,0,0
20200430,07331P,臺股指群益99售22,,,,,0.00,0.00,0,0,0,0,0,0,0,0,0,0,0,0,0
20200430,07332P,臺股指群益99售23,,,,,0.00,0.00,0,0,0,0,0,0,0,0,0,0,0,0,0
20200430,07333P,台灣50國票9B售03,2.59,2.59,2.50,2.50,0.00,0.00,22000,2,55990,0,0,0,0,0,0,11000,11000,0,0
20200430,07334P,臺股指國票99售19,1.15,1.17,1.07,1.07,-0.17,-13.71,814000,28,899680,0,0,0,0,0,0,407000,407000,0,0
20200430,07335P,臺股指國票99售20,1.19,1.19,1.12,1.12,-0.20,-15.15,6000,3,6860,0,0,0,0,0,0,2000,4000,-2000,-2000
20200430,07336P,台灣50台新99售05,0.12,0.12,0.12,0.12,0.00,0.00,30000,5,3600,0,0,0,0,0,0,0,30000,-30000,-30000
20200430,07337P,台灣50凱基99售09,0.87,0.87,0.84,0.84,-0.06,-6.67,30000,3,25750,0,0,0,0,0,0,5000,25000,-20000,-20000
20200430,07338P,滬深2X凱基99售02,0.97,0.97,0.97,0.97,-0.03,-3.0,30000,1,29100,0,0,0,0,0,0,30000,0,30000,30000
20200430,07339P,滬深2X凱基9A售03,,,,,0.00,0.00,0,0,0,0,0,0,0,0,0,0,0,0,0
20200430,07340P,鴻海凱基99售15,0.56,0.56,0.56,0.56,-0.03,-5.08,2000,1,1120,0,0,0,0,0,0,2000,0,2000,2000
20200430,07341P,台積電凱基99售18,0.55,0.55,0.54,0.54,-0.04,-6.9,343000,10,188300,0,0,0,0,0,0,260000,55000,205000,205000
20200430,07342P,大立光凱基99售14,0.85,0.85,0.81,0.81,-0.06,-6.9,675000,11,553950,0,0,0,0,0,0,635000,30000,605000,605000
20200430,07343P,高鐵康和99售01,,,,,0.00,0.00,0,0,0,0,0,0,0,0,0,0,0,0,0
20200430,07344P,鴻海富邦9A售03,1.11,1.11,1.09,1.09,0.00,0.00,49000,4,54160,0,0,0,0,0,0,0,49000,-49000,-49000
20200430,07345P,台灣50永豐99售10,,,,,0.00,0.00,0,0,0,0,0,0,0,0,0,0,0,0,0
20200430,07346P,FBVIX群益99售04,1.54,1.54,1.54,1.54,+0.01,0.65,1000,1,1540,0,0,0,0,0,0,1000,0,1000,1000
20200430,07347P,上証2X凱基99售02,1.09,1.09,1.09,1.09,-0.08,-6.84,7000,1,7630,0,0,0,0,0,0,7000,0,7000,7000
20200430,07348P,滬深2X凱基9A售04,,,,,0.00,0.00,0,0,0,0,0,0,0,0,0,0,0,0,0
20200430,07349P,大立光凱基99售16,0.94,0.94,0.94,0.94,-0.05,-5.05,100000,4,94000,0,0,0,0,0,0,80000,20000,60000,60000
20200430,07350P,台灣50國票99售11,2.43,2.43,2.43,2.43,0.00,0.00,6000,1,14580,0,0,0,0,0,0,6000,0,6000,6000
20200430,07351P,鴻海國票99售08,,,,,0.00,0.00,0,0,0,0,0,0,0,0,0,0,0,0,0
20200430,07352P,台積電國票99售11,1.90,1.92,1.86,1.86,-0.18,-8.82,255000,12,485080,0,0,0,0,0,0,248000,2000,246000,246000
20200430,07353P,大立光國票99售02,,,,,0.00,0.00,0,0,0,0,0,0,0,0,0,0,0,0,0
20200430,07354P,臺股指國票99售22,1.54,1.56,1.44,1.44,-0.20,-12.2,615000,14,910000,0,0,0,0,0,0,310000,305000,5000,5000
20200430,07355P,臺股指國票99售23,1.91,1.92,1.80,1.80,-0.22,-10.89,130000,10,243080,0,0,0,0,0,0,0,130000,-130000,-130000
20200430,07356P,臺股指國票99售24,1.58,1.58,1.58,1.58,-0.07,-4.24,30000,1,47400,0,0,0,0,0,0,30000,0,30000,30000
20200430,07357P,鴻海元大99售38,,,,,0.00,0.00,0,0,0,0,0,0,0,0,0,0,0,0,0
20200430,07358P,鴻海元大99售39,1.81,1.84,1.79,1.79,-0.08,-4.28,105000,8,191000,0,0,0,0,0,0,30000,75000,-45000,-45000
20200430,07359P,台積電元大99售45,1.48,1.48,1.44,1.44,-0.08,-5.26,50000,4,73100,0,0,0,0,0,0,30000,20000,10000,10000
20200430,07360P,台積電元大99售46,,,,,0.00,0.00,0,0,0,0,0,0,0,0,0,0,0,0,0
20200430,07361P,聯發科元大99售34,1.06,1.06,1.02,1.03,-0.10,-8.85,383000,11,399690,0,0,0,0,0,0,163000,220000,-57000,-57000
20200430,07362P,聯發科元大99售35,1.27,1.27,1.27,1.27,-0.12,-8.63,9000,1,11430,0,0,0,0,0,0,9000,0,9000,9000
20200430,07363P,大立光元大99售26,1.46,1.46,1.39,1.39,0.00,0.00,36000,2,52490,0,0,0,0,0,0,35000,1000,34000,34000
20200430,07364P,大立光元大99售27,,,,,0.00,0.00,0,0,0,0,0,0,0,0,0,0,0,0,0
20200430,07365P,超眾元大99售07,2.22,2.27,2.21,2.26,-0.03,-1.31,101000,12,225680,0,0,0,0,0,0,65000,36000,29000,29000
20200430,07366P,國巨康和99售02,1.05,1.07,1.03,1.04,-0.08,-7.14,2063000,48,2153950,0,0,0,0,0,0,970000,1093000,-123000,-123000
20200430,07367P,鴻海凱基99售17,0.54,0.54,0.54,0.54,0.00,0.00,2000,1,1080,0,0,0,0,0,0,2000,0,2000,2000
20200430,07368P,國巨凱基99售19,0.48,0.48,0.47,0.47,-0.02,-4.08,250000,9,119400,0,0,0,0,0,0,45000,195000,-150000,-150000
20200430,07369P,台積電凱基99售20,0.61,0.61,0.59,0.60,-0.03,-4.76,389000,7,229950,0,0,0,0,0,0,345000,16000,329000,329000
20200430,07370P,南亞科凱基99售08,0.64,0.65,0.64,0.65,-0.03,-4.41,31000,5,20100,0,0,0,0,0,0,4000,27000,-23000,-23000
20200430,07371P,滬深2X元大99售07,0.53,0.53,0.53,0.53,0.00,0.00,2000,1,1060,0,0,0,0,0,0,0,2000,-2000,-2000
20200430,07372P,滬深2X元大99售08,,,,,0.00,0.00,0,0,0,0,0,0,0,0,0,0,0,0,0
20200430,07373P,A50正2元大99售01,0.87,0.87,0.84,0.87,-0.04,-4.4,64000,5,54990,0,0,0,0,0,0,63000,1000,62000,62000
20200430,07374P,鴻海元大99售41,,,,,0.00,0.00,0,0,0,0,0,0,0,0,0,0,0,0,0
20200430,07375P,台積電元大99售48,1.47,1.47,1.47,1.47,0.00,0.00,20000,1,29400,0,0,0,0,0,0,20000,0,20000,20000
20200430,07376P,聯發科元大99售39,0.93,0.93,0.90,0.90,-0.15,-14.29,40000,4,36600,0,0,0,0,0,0,10000,30000,-20000,-20000
20200430,07377P,聯發科元大99售40,1.14,1.14,1.12,1.13,-0.09,-7.38,148000,4,166620,0,0,0,0,0,0,133000,15000,118000,118000
20200430,07378P,大立光元大99售29,1.87,1.87,1.80,1.81,0.00,0.00,14000,3,25300,0,0,0,0,0,0,10000,4000,6000,6000
20200430,07379P,大立光元大99售30,,,,,0.00,0.00,0,0,0,0,0,0,0,0,0,0,0,0,0
20200430,07380P,台灣50群益9A售11,,,,,0.00,0.00,0,0,0,0,0,0,0,0,0,0,0,0,0
20200430,07381P,鴻海群益99售05,,,,,0.00,0.00,0,0,0,0,0,0,0,0,0,0,0,0,0
20200430,07382P,台積電群益9B售01,,,,,0.00,0.00,0,0,0,0,0,0,0,0,0,0,0,0,0
20200430,07383P,聯發科群益99售06,0.80,0.82,0.77,0.77,-0.13,-14.44,393000,46,313430,0,0,0,0,0,0,161000,232000,-71000,-71000
20200430,07384P,大立光群益9A售01,,,,,0.00,0.00,0,0,0,0,0,0,0,0,0,0,0,0,0
20200430,07385P,緯穎群益99售04,3.71,3.72,3.69,3.72,-0.18,-4.62,19000,7,70350,0,0,0,0,0,0,19000,0,19000,19000
20200430,07386P,臺股指群益99售24,1.96,1.96,1.87,1.89,-0.14,-6.9,181000,9,344460,0,0,0,0,0,0,80000,101000,-21000,-21000
20200430,07387P,臺股指群益99售25,2.28,2.28,2.23,2.23,-0.15,-6.3,36000,4,80880,0,0,0,0,0,0,0,36000,-36000,-36000
20200430,07388P,臺股指群益9C售07,2.63,2.63,2.60,2.60,-0.14,-5.11,10000,2,26150,0,0,0,0,0,0,0,10000,-10000,-10000
20200430,07389P,臺股指群益9C售08,2.31,2.31,2.23,2.23,-0.14,-5.91,288000,19,658540,0,0,0,0,0,0,236000,51000,185000,185000
20200430,07390P,華新科康和99售02,0.73,0.73,0.73,0.73,-0.04,-5.19,20000,1,14600,0,0,0,0,0,0,20000,0,20000,20000
20200430,07391P,台灣50國泰02售01,0.74,0.74,0.71,0.71,-0.06,-7.79,30000,7,21610,0,0,0,0,0,0,0,24000,-24000,-24000
20200430,07392P,台積電國泰02售01,0.73,0.75,0.73,0.73,-0.02,-2.67,192000,8,141980,0,0,0,0,0,0,110000,72000,38000,38000
20200430,07393P,台灣50富邦9B售02,,,,,0.00,0.00,0,0,0,0,0,0,0,0,0,0,0,0,0
20200430,07394P,國巨群益99售12,1.21,1.25,1.21,1.25,-0.03,-2.34,28000,4,34390,0,0,0,0,0,0,15000,13000,2000,2000
20200430,07395P,台積電群益99售13,2.06,2.08,2.05,2.05,-0.14,-6.39,102000,3,209900,0,0,0,0,0,0,82000,20000,62000,62000
20200430,07396P,聯發科群益9B售01,1.17,1.17,1.13,1.13,-0.11,-8.87,53000,4,60550,0,0,0,0,0,0,20000,33000,-13000,-13000
20200430,07397P,大立光群益99售10,1.16,1.16,1.12,1.12,-0.11,-8.94,55000,2,62600,0,0,0,0,0,0,55000,0,55000,55000
20200430,07398P,鴻海凱基99售18,,,,,0.00,0.00,0,0,0,0,0,0,0,0,0,0,0,0,0
20200430,07399P,鴻海凱基99售19,,,,,0.00,0.00,0,0,0,0,0,0,0,0,0,0,0,0,0
20200430,07400P,國巨凱基99售20,0.53,0.55,0.53,0.55,-0.02,-3.51,129000,8,69500,0,0,0,0,0,0,94000,15000,79000,79000
20200430,07401P,台積電凱基99售21,,,,,0.00,0.00,0,0,0,0,0,0,0,0,0,0,0,0,0
20200430,07402P,瑞昱凱基99售02,0.69,0.71,0.67,0.67,-0.05,-6.94,331000,9,224710,0,0,0,0,0,0,46000,285000,-239000,-239000
20200430,07403P,聯發科凱基99售21,,,,,0.00,0.00,0,0,0,0,0,0,0,0,0,0,0,0,0
20200430,07404P,華新科凱基99售10,0.61,0.61,0.61,0.61,-0.01,-1.61,15000,2,9150,0,0,0,0,0,0,10000,5000,5000,5000
20200430,07405P,大立光凱基99售17,,,,,0.00,0.00,0,0,0,0,0,0,0,0,0,0,0,0,0
20200430,07406P,大立光凱基99售18,1.03,1.03,1.00,1.00,-0.06,-5.66,26000,5,26300,0,0,0,0,0,0,0,26000,-26000,-26000
20200430,07407P,欣興凱基99售07,0.50,0.51,0.48,0.51,-0.01,-1.92,2049000,32,1024020,0,0,0,0,0,0,43000,1960000,-1917000,-1917000
20200430,07408P,台積電兆豐99售06,0.41,0.41,0.41,0.41,-0.04,-8.89,55000,2,22550,0,0,0,0,0,0,0,55000,-55000,-55000
20200430,07409P,台積電台新99售07,0.20,0.20,0.20,0.20,0.00,0.00,30000,4,6000,0,0,0,0,0,0,0,30000,-30000,-30000
20200430,07410P,鴻海元大99售44,,,,,0.00,0.00,0,0,0,0,0,0,0,0,0,0,0,0,0
20200430,07411P,國巨元大99售31,1.38,1.38,1.37,1.37,-0.08,-5.52,22000,4,30260,0,0,0,0,0,0,22000,0,22000,22000
20200430,07412P,國巨元大99售32,,,,,0.00,0.00,0,0,0,0,0,0,0,0,0,0,0,0,0
20200430,07413P,國巨元大99售33,1.04,1.05,1.02,1.02,-0.06,-5.56,25000,4,25950,0,0,0,0,0,0,20000,5000,15000,15000
20200430,07414P,台積電元大99售51,,,,,0.00,0.00,0,0,0,0,0,0,0,0,0,0,0,0,0
20200430,07415P,台積電元大99售52,1.62,2.59,1.62,2.58,-0.10,-3.73,166000,6,344620,0,0,0,0,0,0,63000,16000,47000,47000
20200430,07416P,台積電元大99售53,1.97,1.99,1.94,1.95,-0.10,-4.88,751000,39,1475680,0,0,0,0,0,0,348000,383000,-35000,-35000
20200430,07417P,聯發科元大99售44,1.80,1.80,1.80,1.80,-0.20,-10.0,50000,3,90000,0,0,0,0,0,0,50000,0,50000,50000
20200430,07418P,聯發科元大99售45,1.48,1.48,1.46,1.46,-0.11,-7.01,26000,6,38300,0,0,0,0,0,0,0,26000,-26000,-26000
20200430,07419P,聯發科元大99售46,,,,,0.00,0.00,0,0,0,0,0,0,0,0,0,0,0,0,0
20200430,07420P,可成元大99售07,1.25,1.33,1.25,1.28,-0.02,-1.54,436000,8,559560,0,0,0,0,0,0,300000,136000,164000,164000
20200430,07421P,國泰金元大99售01,1.23,1.23,1.21,1.21,-0.21,-14.79,10000,2,12200,0,0,0,0,0,0,5000,5000,0,0
20200430,07422P,大立光元大99售32,1.94,1.94,1.94,1.94,-0.16,-7.62,10000,1,19400,0,0,0,0,0,0,10000,0,10000,10000
20200430,07423P,大立光元大99售33,3.24,3.24,3.13,3.13,-0.28,-8.21,10000,2,31850,0,0,0,0,0,0,0,10000,-10000,-10000
20200430,07424P,大立光元大9B售01,1.98,1.98,1.98,1.98,-0.09,-4.35,12000,2,23760,0,0,0,0,0,0,2000,10000,-8000,-8000
20200430,07425P,台灣50國票9A售10,,,,,0.00,0.00,0,0,0,0,0,0,0,0,0,0,0,0,0
20200430,07426P,上証2X國票9B售01,,,,,0.00,0.00,0,0,0,0,0,0,0,0,0,0,0,0,0
20200430,07427P,台積電國票9B售02,,,,,0.00,0.00,0,0,0,0,0,0,0,0,0,0,0,0,0
20200430,07428P,華新科國票9A售01,,,,,0.00,0.00,0,0,0,0,0,0,0,0,0,0,0,0,0
20200430,07429P,臺股指國票9A售01,,,,,0.00,0.00,0,0,0,0,0,0,0,0,0,0,0,0,0
20200430,07430P,臺股指國票9A售02,,,,,0.00,0.00,0,0,0,0,0,0,0,0,0,0,0,0,0
20200430,07431P,臺股指國票9A售03,,,,,0.00,0.00,0,0,0,0,0,0,0,0,0,0,0,0,0
20200430,07432P,臺股指國票9A售04,,,,,0.00,0.00,0,0,0,0,0,0,0,0,0,0,0,0,0
20200430,07433P,臺股指國票9A售05,,,,,0.00,0.00,0,0,0,0,0,0,0,0,0,0,0,0,0
20200430,07434P,臺股指國票9A售06,1.23,1.23,1.14,1.14,-0.16,-12.31,228000,18,265340,0,0,0,0,0,0,91000,137000,-46000,-46000
20200430,07435P,台積電富邦9C售07,0.67,0.67,0.67,0.67,-0.03,-4.29,20000,1,13400,0,0,0,0,0,0,0,20000,-20000,-20000
20200430,07436P,臺股指麥證9A售03,,,,,0.00,0.00,0,0,0,0,0,0,0,0,0,0,0,0,0
20200430,07437P,臺股指麥證9A售04,0.87,0.87,0.83,0.84,-0.06,-6.67,141000,10,118690,70000,71000,-1000,0,0,0,70000,71000,-1000,-1000
20200430,07438P,臺股指麥證9A售05,,,,,0.00,0.00,0,0,0,0,0,0,0,0,0,0,0,0,0
20200430,07439P,臺股指麥證9B售01,,,,,0.00,0.00,0,0,0,0,0,0,0,0,0,0,0,0,0
20200430,07440P,臺股指麥證9B售02,,,,,0.00,0.00,0,0,0,0,0,0,0,0,0,0,0,0,0
20200430,07441P,臺股指麥證9B售03,1.96,1.96,1.96,1.96,0.00,0.00,1000,1,1960,0,1000,-1000,0,0,0,0,1000,-1000,-1000
20200430,07442P,華航康和9A售02,0.43,0.44,0.42,0.43,-0.03,-6.52,153000,12,66090,0,0,0,0,0,0,45000,103000,-58000,-58000
20200430,07443P,鴻海凱基9A售18,0.62,0.62,0.62,0.62,0.00,0.00,3000,1,1860,0,0,0,0,0,0,0,3000,-3000,-3000
20200430,07444P,聯發科凱基9A售10,0.74,0.74,0.73,0.73,-0.06,-7.59,37000,4,27210,0,0,0,0,0,0,25000,12000,13000,13000
20200430,07445P,大立光凱基9A售08,0.83,0.83,0.80,0.80,-0.05,-5.88,33000,4,26920,0,0,0,0,0,0,23000,10000,13000,13000
20200430,07446P,台灣50元大9A售06,1.85,1.85,1.81,1.81,-0.11,-5.73,103000,3,188430,0,0,0,0,0,0,0,103000,-103000,-103000
20200430,07447P,台灣50元大9A售07,,,,,0.00,0.00,0,0,0,0,0,0,0,0,0,0,0,0,0
20200430,07448P,台灣50元大9A售08,1.64,1.64,1.60,1.60,-0.11,-6.43,607000,9,979510,0,0,0,0,0,0,586000,21000,565000,565000
20200430,07449P,臺指反元大01售01,,,,,0.00,0.00,0,0,0,0,0,0,0,0,0,0,0,0,0
20200430,07450P,鴻海元大9A售03,,,,,0.00,0.00,0,0,0,0,0,0,0,0,0,0,0,0,0
20200430,07451P,鴻海元大9B售01,,,,,0.00,0.00,0,0,0,0,0,0,0,0,0,0,0,0,0
20200430,07452P,國巨元大9A售05,1.14,1.14,1.05,1.05,-0.09,-7.89,98000,7,103870,0,0,0,0,0,0,12000,85000,-73000,-73000
20200430,07453P,台積電元大9A售05,1.41,1.41,1.41,1.41,0.00,0.00,5000,1,7050,0,0,0,0,0,0,5000,0,5000,5000
20200430,07454P,台積電元大9A售06,,,,,0.00,0.00,0,0,0,0,0,0,0,0,0,0,0,0,0
20200430,07455P,聯發科元大9A售01,,,,,0.00,0.00,0,0,0,0,0,0,0,0,0,0,0,0,0
20200430,07456P,華新科元大9A售06,1.05,1.07,1.05,1.06,-0.04,-3.64,115000,3,121550,0,0,0,0,0,0,50000,65000,-15000,-15000
20200430,07457P,宏達電元大9A售01,1.53,1.58,1.53,1.56,-0.05,-3.11,23000,5,35760,0,0,0,0,0,0,17000,2000,15000,15000
20200430,07458P,長榮航元大9A售01,0.58,0.62,0.58,0.60,-0.06,-9.09,748000,22,452130,0,0,0,0,0,0,176000,470000,-294000,-294000
20200430,07459P,緯穎元大9A售01,1.24,1.26,1.12,1.15,-0.16,-12.21,808000,36,957680,0,0,0,0,0,0,343000,463000,-120000,-120000
20200430,07460P,臺股指元大9B售03,2.10,2.10,2.05,2.05,-0.13,-5.96,47000,2,98600,0,0,0,0,0,0,47000,0,47000,47000
20200430,07461P,臺股指元大9B售04,2.22,2.22,2.22,2.22,0.00,0.00,100000,1,222000,0,0,0,0,0,0,100000,0,100000,100000
20200430,07462P,臺股指元大9B售05,1.30,1.30,1.26,1.26,-0.08,-5.97,553000,12,708360,0,0,0,0,0,0,433000,120000,313000,313000
20200430,07463P,台積電國票9A售05,0.85,0.85,0.82,0.82,-0.09,-9.89,100000,8,84500,0,0,0,0,0,0,50000,50000,0,0
20200430,07464P,台灣50兆豐9A售02,,,,,0.00,0.00,0,0,0,0,0,0,0,0,0,0,0,0,0
20200430,07465P,台灣50元大9C售24,1.97,1.97,1.97,1.97,0.00,0.00,5000,1,9850,0,0,0,0,0,0,0,5000,-5000,-5000
20200430,07466P,亞德客元大9A售02,1.58,1.64,1.41,1.41,-0.26,-15.57,400000,24,605820,0,0,0,0,0,0,280000,130000,150000,150000
20200430,07467P,上銀元大9A售03,1.31,1.33,1.15,1.16,-0.24,-17.14,216000,13,263500,0,0,0,0,0,0,41000,175000,-134000,-134000
20200430,07468P,聯電元大9A售02,0.63,0.66,0.62,0.62,-0.04,-6.06,213000,15,134720,0,0,0,0,0,0,134000,77000,57000,57000
20200430,07469P,台達電元大9A售01,0.98,0.98,0.91,0.91,-0.13,-12.5,33000,7,30520,0,0,0,0,0,0,1000,32000,-31000,-31000
20200430,07470P,國巨元大9A售06,1.27,1.27,1.20,1.23,-0.04,-3.15,57000,5,69690,0,0,0,0,0,0,45000,12000,33000,33000
20200430,07471P,南亞科元大9A售01,1.74,1.75,1.72,1.73,-0.06,-3.35,85000,8,147650,0,0,0,0,0,0,30000,55000,-25000,-25000
20200430,07472P,和碩元大9A售03,1.97,1.98,1.97,1.98,0.00,0.00,52000,3,102940,50000,0,50000,0,0,0,2000,50000,-48000,2000
20200430,07473P,祥碩元大9A售01,1.75,1.94,1.75,1.91,+0.11,6.11,366000,12,675700,0,0,0,0,0,0,220000,356000,-136000,-136000
20200430,07474P,滬深2X群益9C售03,1.41,1.43,1.41,1.43,-0.05,-3.38,19000,2,26850,0,0,0,0,0,0,16000,3000,13000,13000
20200430,07475P,A50正2群益9C售02,,,,,0.00,0.00,0,0,0,0,0,0,0,0,0,0,0,0,0
20200430,07476P,鴻海群益9A售04,,,,,0.00,0.00,0,0,0,0,0,0,0,0,0,0,0,0,0
20200430,07477P,國巨群益9A售04,0.82,0.82,0.82,0.82,-0.01,-1.2,12000,1,9840,0,0,0,0,0,0,0,12000,-12000,-12000
20200430,07478P,南電康和9A售02,0.54,0.61,0.53,0.57,0.00,0.00,2086000,67,1193290,0,0,0,0,0,0,1061000,1025000,36000,36000
20200430,07479P,A50正2元富9A售03,,,,,0.00,0.00,0,0,0,0,0,0,0,0,0,0,0,0,0
20200430,07481P,大立光台新9A售01,0.97,0.97,0.97,0.97,0.00,0.00,9000,1,8730,0,0,0,0,0,0,9000,0,9000,9000
20200430,07482P,南亞科元富9A售04,1.10,1.10,1.07,1.07,-0.04,-3.6,134000,11,146110,0,0,0,0,0,0,10000,124000,-114000,-114000
20200430,07483P,國巨台新9A售01,,,,,0.00,0.00,0,0,0,0,0,0,0,0,0,0,0,0,0
20200430,07484P,台灣50凱基04售02,,,,,0.00,0.00,0,0,0,0,0,0,0,0,0,0,0,0,0
20200430,07485P,台灣50凱基04售03,,,,,0.00,0.00,0,0,0,0,0,0,0,0,0,0,0,0,0
20200430,07486P,上証2X國票9B售02,,,,,0.00,0.00,0,0,0,0,0,0,0,0,0,0,0,0,0
20200430,07487P,鴻海國票9A售01,,,,,0.00,0.00,0,0,0,0,0,0,0,0,0,0,0,0,0
20200430,07488P,鴻海國票9A售02,,,,,0.00,0.00,0,0,0,0,0,0,0,0,0,0,0,0,0
20200430,07489P,國巨國票9A售07,1.38,1.41,1.36,1.41,0.00,0.00,80000,3,111200,0,0,0,0,0,0,40000,40000,0,0
20200430,07490P,大立光國票9A售03,2.59,2.59,2.44,2.44,-0.27,-9.96,70000,7,175170,0,0,0,0,0,0,12000,58000,-46000,-46000
20200430,07491P,臺股指國票9A售09,0.89,0.89,0.84,0.84,-0.11,-11.58,310000,2,275400,0,0,0,0,0,0,300000,10000,290000,290000
20200430,07492P,臺股指國票9A售10,,,,,0.00,0.00,0,0,0,0,0,0,0,0,0,0,0,0,0
20200430,07493P,台灣50元大9A售10,1.76,1.76,1.73,1.73,-0.11,-5.98,20000,2,34900,0,0,0,0,0,0,0,20000,-20000,-20000
20200430,07494P,葡萄王元大9A售03,2.10,2.10,2.10,2.10,-0.02,-0.94,55000,2,115500,0,0,0,0,0,0,55000,0,55000,55000
20200430,07495P,鴻海元大9A售04,,,,,0.00,0.00,0,0,0,0,0,0,0,0,0,0,0,0,0
20200430,07496P,鴻海元大9A售05,,,,,0.00,0.00,0,0,0,0,0,0,0,0,0,0,0,0,0
20200430,07497P,鴻海元大9A售06,,,,,0.00,0.00,0,0,0,0,0,0,0,0,0,0,0,0,0
20200430,07498P,台積電元大9A售09,,,,,0.00,0.00,0,0,0,0,0,0,0,0,0,0,0,0,0
20200430,07499P,台積電元大9A售12,1.01,1.01,1.01,1.01,0.00,0.00,40000,2,40400,0,0,0,0,0,0,0,40000,-40000,-40000
20200430,07500P,微星元大9A售01,2.08,2.08,2.08,2.08,-0.06,-2.8,56000,1,116480,0,0,0,0,0,0,56000,0,56000,56000
20200430,07501P,華新科元大9A售07,,,,,0.00,0.00,0,0,0,0,0,0,0,0,0,0,0,0,0
20200430,07502P,美食元大9A售01,1.76,1.76,1.76,1.76,-0.16,-8.33,250000,1,440000,0,0,0,0,0,0,250000,0,250000,250000
20200430,07503P,禾伸堂元大9A售01,1.04,1.04,1.04,1.04,-0.02,-1.89,15000,2,15600,0,0,0,0,0,0,15000,0,15000,15000
20200430,07504P,聯詠元大9A售02,2.33,2.40,2.33,2.33,+0.01,0.43,75000,3,178250,0,0,0,0,0,0,5000,70000,-65000,-65000
20200430,07505P,台勝科元大9A售01,1.62,1.62,1.55,1.55,-0.13,-7.74,40000,2,64520,0,0,0,0,0,0,40000,0,40000,40000
20200430,07506P,中租元大9A售01,1.24,1.24,1.18,1.22,-0.10,-7.58,126000,5,149760,0,0,0,0,0,0,100000,26000,74000,74000
20200430,07507P,國巨國票9B售02,,,,,0.00,0.00,0,0,0,0,0,0,0,0,0,0,0,0,0
20200430,07508P,華新科國票9A售03,3.00,3.00,3.00,3.00,-0.16,-5.06,9000,1,27000,0,0,0,0,0,0,9000,0,9000,9000
20200430,07509P,牧德國票9A售03,1.08,1.12,1.04,1.04,-0.16,-13.33,169000,14,186140,0,0,0,0,0,0,102000,67000,35000,35000
20200430,07510P,台灣50元富04售02,,,,,0.00,0.00,0,0,0,0,0,0,0,0,0,0,0,0,0
20200430,07511P,鴻海元大9B售02,,,,,0.00,0.00,0,0,0,0,0,0,0,0,0,0,0,0,0
20200430,07512P,國巨元大9A售08,,,,,0.00,0.00,0,0,0,0,0,0,0,0,0,0,0,0,0
20200430,07513P,台積電元大9A售13,,,,,0.00,0.00,0,0,0,0,0,0,0,0,0,0,0,0,0
20200430,07514P,台積電元大9A售14,0.93,0.93,0.93,0.93,-0.02,-2.11,15000,1,13950,0,0,0,0,0,0,15000,0,15000,15000
20200430,07515P,台積電元大9A售15,,,,,0.00,0.00,0,0,0,0,0,0,0,0,0,0,0,0,0
20200430,07516P,台積電元大9A售16,,,,,0.00,0.00,0,0,0,0,0,0,0,0,0,0,0,0,0
20200430,07517P,台積電元大9A售17,0.70,0.70,0.70,0.70,-0.05,-6.67,20000,2,14000,0,0,0,0,0,0,5000,15000,-10000,-10000
20200430,07518P,臺股指元大9B售09,,,,,0.00,0.00,0,0,0,0,0,0,0,0,0,0,0,0,0
20200430,07519P,臺股指元大9B售10,1.08,1.08,1.07,1.07,-0.05,-4.46,30000,2,32300,0,0,0,0,0,0,20000,10000,10000,10000
20200430,07520P,臺股指元大9B售11,1.09,1.10,1.05,1.06,-0.07,-6.19,450000,15,492030,0,0,0,0,0,0,137000,313000,-176000,-176000
20200430,07521P,台積電中信01售05,,,,,0.00,0.00,0,0,0,0,0,0,0,0,0,0,0,0,0
20200430,07522P,台積電中信9A售03,0.79,0.79,0.77,0.77,-0.06,-7.23,60000,6,46900,0,0,0,0,0,0,40000,20000,20000,20000
20200430,07523P,台積電中信9C售05,,,,,0.00,0.00,0,0,0,0,0,0,0,0,0,0,0,0,0
20200430,07524P,臺股指中信9B售06,0.80,0.80,0.77,0.77,-0.07,-8.33,414000,22,326980,0,0,0,0,0,0,177000,214000,-37000,-37000
20200430,07525P,臺股指中信9B售07,0.67,0.67,0.66,0.66,-0.04,-5.71,250000,3,167000,0,0,0,0,0,0,0,250000,-250000,-250000
20200430,07526P,臺股指中信9B售08,0.67,0.67,0.67,0.67,-0.03,-4.29,60000,2,40200,0,0,0,0,0,0,50000,10000,40000,40000
20200430,07527P,台灣50凱基9B售02,1.20,1.21,1.14,1.14,-0.13,-10.24,425000,26,503900,0,0,0,0,0,0,22000,396000,-374000,-374000
20200430,07528P,鴻海凱基9A售19,,,,,0.00,0.00,0,0,0,0,0,0,0,0,0,0,0,0,0
20200430,07529P,國巨凱基9A售11,,,,,0.00,0.00,0,0,0,0,0,0,0,0,0,0,0,0,0
20200430,07530P,聯發科凱基9A售11,0.81,0.81,0.78,0.79,-0.08,-9.2,296000,15,236150,0,0,0,0,0,0,89000,162000,-73000,-73000
20200430,07531P,大立光國泰9B售03,1.87,1.87,1.76,1.76,-0.16,-8.33,89000,12,162410,0,0,0,0,0,0,12000,77000,-65000,-65000
20200430,07532P,台灣50中信01售02,0.73,0.73,0.73,0.73,-0.05,-6.41,36000,3,26280,0,0,0,0,0,0,3000,33000,-30000,-30000
20200430,07533P,臺股指中信9C售04,0.82,0.82,0.82,0.82,0.00,0.00,30000,1,24600,0,0,0,0,0,0,0,30000,-30000,-30000
20200430,07534P,台灣50群益9A售12,,,,,0.00,0.00,0,0,0,0,0,0,0,0,0,0,0,0,0
20200430,07535P,上銀元富9A售03,1.55,1.55,1.34,1.34,-0.30,-18.29,236000,14,322240,0,0,0,0,0,0,186000,50000,136000,136000
20200430,07536P,華新科元富9A售04,1.21,1.22,1.18,1.22,-0.03,-2.4,18000,5,21730,0,0,0,0,0,0,17000,1000,16000,16000
20200430,07537P,玉晶光元富9A售04,1.81,1.82,1.81,1.82,-0.10,-5.21,6000,2,10910,0,0,0,0,0,0,6000,0,6000,6000
20200430,07538P,玉晶光元富9A售05,,,,,0.00,0.00,0,0,0,0,0,0,0,0,0,0,0,0,0
20200430,07539P,玉山金台新9A售01,0.85,0.85,0.47,0.47,-0.42,-47.19,32000,5,15790,0,0,0,0,0,0,0,32000,-32000,-32000
20200430,07540P,鴻海凱基9A售21,,,,,0.00,0.00,0,0,0,0,0,0,0,0,0,0,0,0,0
20200430,07541P,國巨凱基9A售12,0.73,0.73,0.73,0.73,-0.02,-2.67,10000,1,7300,0,0,0,0,0,0,10000,0,10000,10000
20200430,07542P,台積電凱基9A售16,1.31,1.31,1.31,1.31,-0.04,-2.96,16000,3,20960,0,0,0,0,0,0,3000,13000,-10000,-10000
20200430,07543P,台積電凱基9A售17,1.09,1.09,1.06,1.06,-0.05,-4.5,45000,5,48050,0,0,0,0,0,0,40000,5000,35000,35000
20200430,07544P,大立光凱基9A售09,1.52,1.52,1.52,1.52,-0.06,-3.8,10000,1,15200,0,0,0,0,0,0,0,10000,-10000,-10000
20200430,07545P,玉晶光凱基9A售07,0.90,0.90,0.88,0.88,-0.05,-5.38,466000,16,414000,0,0,0,0,0,0,150000,301000,-151000,-151000
20200430,07546P,玉晶光凱基9A售09,0.61,0.62,0.59,0.60,-0.05,-7.69,756000,24,461820,0,0,0,0,0,0,157000,539000,-382000,-382000
20200430,07547P,緯穎凱基9A售05,1.32,1.32,1.24,1.24,-0.13,-9.49,9000,4,11350,0,0,0,0,0,0,0,9000,-9000,-9000
20200430,07548P,台灣50元大9A售12,,,,,0.00,0.00,0,0,0,0,0,0,0,0,0,0,0,0,0
20200430,07549P,台灣50元大9A售13,,,,,0.00,0.00,0,0,0,0,0,0,0,0,0,0,0,0,0
20200430,07550P,國巨元大9A售09,,,,,0.00,0.00,0,0,0,0,0,0,0,0,0,0,0,0,0
20200430,07551P,國巨元大9A售10,1.34,1.34,1.34,1.34,-0.05,-3.6,2000,2,2680,0,0,0,0,0,0,2000,0,2000,2000
20200430,07552P,技嘉元大9A售03,1.44,1.49,1.44,1.47,-0.04,-2.65,283000,8,418010,30000,0,30000,0,0,0,103000,139000,-36000,-6000
20200430,07553P,嘉晶元大9A售02,1.68,1.70,1.59,1.59,-0.14,-8.09,210000,9,352260,0,0,0,0,0,0,210000,56000,154000,154000
20200430,07554P,玉晶光元大9A售06,1.55,1.55,1.55,1.55,-0.07,-4.32,1000,1,1550,0,0,0,0,0,0,1000,0,1000,1000
20200430,07555P,玉晶光元大9A售07,1.44,1.44,1.43,1.43,-0.09,-5.92,6000,2,8600,0,0,0,0,0,0,2000,4000,-2000,-2000
20200430,07556P,玉晶光元大9A售08,,,,,0.00,0.00,0,0,0,0,0,0,0,0,0,0,0,0,0
20200430,07557P,玉晶光元大9A售09,1.16,1.16,1.10,1.10,-0.10,-8.33,233000,16,261280,0,0,0,0,0,0,138000,75000,63000,63000
20200430,07558P,玉晶光元大9A售10,1.90,1.90,1.90,1.90,-0.17,-8.21,4000,2,7600,0,0,0,0,0,0,4000,0,4000,4000
20200430,07559P,祥碩元大9A售03,1.18,1.29,1.18,1.26,+0.06,5.0,234000,5,293240,0,0,0,0,0,0,233000,1000,232000,232000
20200430,07560P,台積電國泰9B售01,2.34,2.34,2.31,2.31,-0.14,-5.71,480000,9,1115290,0,0,0,0,0,0,400000,480000,-80000,-80000
20200430,07561P,玉晶光永豐9A售02,0.96,0.96,0.94,0.94,-0.06,-6.0,11000,2,10540,0,0,0,0,0,0,10000,1000,9000,9000
20200430,07562P,台灣50第一9A售01,,,,,0.00,0.00,0,0,0,0,0,0,0,0,0,0,0,0,0
20200430,07563P,台灣50中信04售01,,,,,0.00,0.00,0,0,0,0,0,0,0,0,0,0,0,0,0
20200430,07564P,臺股指中信01售01,1.57,1.57,1.53,1.53,-0.08,-4.97,36000,3,55300,0,0,0,0,0,0,30000,6000,24000,24000
20200430,07565P,台灣50台新9C售02,0.13,0.13,0.13,0.13,0.00,0.00,30000,5,3900,0,0,0,0,0,0,0,30000,-30000,-30000
20200430,07566P,台積電台新9B售02,,,,,0.00,0.00,0,0,0,0,0,0,0,0,0,0,0,0,0
20200430,07567P,台灣50凱基01售05,,,,,0.00,0.00,0,0,0,0,0,0,0,0,0,0,0,0,0
20200430,07568P,鴻海凱基9A售22,0.88,0.88,0.88,0.88,0.00,0.00,1000,1,880,0,0,0,0,0,0,0,1000,-1000,-1000
20200430,07569P,國巨凱基9A售13,0.79,0.79,0.79,0.79,0.00,0.00,10000,1,7900,0,0,0,0,0,0,10000,0,10000,10000
20200430,07570P,旺宏凱基9A售04,0.92,0.93,0.92,0.92,-0.05,-5.15,27000,5,24890,0,0,0,0,0,0,21000,6000,15000,15000
20200430,07571P,台灣50元大9A售14,,,,,0.00,0.00,0,0,0,0,0,0,0,0,0,0,0,0,0
20200430,07572P,台灣50元大9A售15,1.98,1.98,1.92,1.92,0.00,0.00,25000,2,48600,0,0,0,0,0,0,15000,10000,5000,5000
20200430,07573P,國巨元大9A售11,1.17,1.19,1.17,1.18,-0.05,-4.07,39000,7,46100,0,0,0,0,0,0,12000,27000,-15000,-15000
20200430,07574P,國巨元大9A售12,1.51,1.54,1.51,1.51,-0.08,-5.03,41000,5,62150,0,0,0,0,0,0,1000,40000,-39000,-39000
20200430,07575P,瑞昱元大9A售02,1.38,1.41,1.32,1.34,-0.11,-7.59,177000,28,238240,0,0,0,0,0,0,2000,175000,-173000,-173000
20200430,07576P,可成元大9A售01,1.50,1.60,1.49,1.55,0.00,0.00,487000,6,745500,0,0,0,0,0,0,470000,277000,193000,193000
20200430,07577P,華新科元大9A售09,1.05,1.07,1.05,1.07,-0.02,-1.83,26000,2,27800,0,0,0,0,0,0,1000,25000,-24000,-24000
20200430,07578P,高鐵元大9A售02,1.34,1.35,1.34,1.35,0.00,0.00,108000,3,145600,0,0,0,0,0,0,0,108000,-108000,-108000
20200430,07579P,聯茂元大9A售01,1.65,1.70,1.65,1.70,+0.04,2.41,128000,7,213600,0,0,0,0,0,0,92000,78000,14000,14000
20200430,07580P,緯穎元大9A售03,1.56,1.56,1.40,1.44,-0.18,-11.11,46000,16,70500,0,0,0,0,0,0,31000,15000,16000,16000
20200430,07581P,臺股指元大9A售44,,,,,0.00,0.00,0,0,0,0,0,0,0,0,0,0,0,0,0
20200430,07582P,臺股指元大9A售45,2.11,2.11,2.11,2.11,-0.08,-3.65,100000,1,211000,0,0,0,0,0,0,100000,0,100000,100000
20200430,07583P,台積電富邦9B售05,0.66,0.67,0.64,0.64,-0.06,-8.57,251000,14,164260,0,0,0,0,0,0,38000,211000,-173000,-173000
20200430,07584P,台積電永豐9A售02,0.75,0.75,0.75,0.75,-0.02,-2.6,1000,1,750,0,0,0,0,0,0,0,1000,-1000,-1000
20200430,07585P,台灣50中信03售06,0.61,0.62,0.59,0.59,-0.05,-7.81,1662000,11,998310,0,0,0,0,0,0,1002000,658000,344000,344000
20200430,07586P,FBVIX台新9A售01,1.11,1.11,0.02,0.02,-1.09,-98.2,15000,3,5750,0,0,0,0,0,0,5000,10000,-5000,-5000
20200430,07587P,台灣50國票9A售11,1.78,1.78,1.77,1.77,-0.18,-9.23,6000,2,10630,0,0,0,0,0,0,1000,5000,-4000,-4000
20200430,07588P,滬深2X國票9C售01,0.34,0.36,0.34,0.36,0.00,0.00,22000,6,7600,0,0,0,0,0,0,0,22000,-22000,-22000
20200430,07589P,玉晶光國票9A售02,2.71,2.71,2.65,2.65,-0.27,-9.25,40000,2,107200,0,0,0,0,0,0,20000,20000,0,0
20200430,07590P,玉晶光國票9A售03,2.08,2.08,1.93,1.93,-0.24,-11.06,32000,4,62750,0,0,0,0,0,0,12000,20000,-8000,-8000
20200430,07591P,台灣50元大9A售16,,,,,0.00,0.00,0,0,0,0,0,0,0,0,0,0,0,0,0
20200430,07592P,台灣50元大9A售17,1.62,1.62,1.62,1.62,0.00,0.00,126000,2,204120,0,0,0,0,0,0,126000,0,126000,126000
20200430,07593P,臺股指凱基9A售08,1.94,1.95,1.85,1.85,-0.19,-9.31,107000,13,201390,0,0,0,0,0,0,12000,95000,-83000,-83000
20200430,07594P,大立光永豐9A售01,,,,,0.00,0.00,0,0,0,0,0,0,0,0,0,0,0,0,0
20200430,07595P,台灣50中信03售07,0.87,0.87,0.84,0.84,-0.08,-8.7,71000,4,60070,0,0,0,0,0,0,61000,10000,51000,51000
20200430,07596P,上証2X中信01售01,,,,,0.00,0.00,0,0,0,0,0,0,0,0,0,0,0,0,0
20200430,07597P,臺股指中信01售02,0.79,0.80,0.75,0.76,-0.06,-7.32,2748000,103,2133160,0,0,0,0,0,0,612000,2020000,-1408000,-1408000
20200430,07598P,臺股指中信01售03,,,,,0.00,0.00,0,0,0,0,0,0,0,0,0,0,0,0,0
20200430,07599P,台灣50凱基04售05,,,,,0.00,0.00,0,0,0,0,0,0,0,0,0,0,0,0,0
20200430,07600P,台灣50凱基04售06,,,,,0.00,0.00,0,0,0,0,0,0,0,0,0,0,0,0,0
20200430,07601P,國巨統一9A售05,0.60,0.60,0.60,0.60,0.00,0.00,5000,1,3000,0,0,0,0,0,0,0,5000,-5000,-5000
20200430,07602P,台積電統一9A售07,0.64,0.64,0.64,0.64,0.00,0.00,45000,1,28800,0,0,0,0,0,0,45000,0,45000,45000
20200430,07603P,台積電統一9B售08,1.08,1.08,1.07,1.07,0.00,0.00,30000,3,32350,0,0,0,0,0,0,5000,25000,-20000,-20000
20200430,07604P,台灣50元大9B售09,,,,,0.00,0.00,0,0,0,0,0,0,0,0,0,0,0,0,0
20200430,07605P,台灣50元大9B售10,,,,,0.00,0.00,0,0,0,0,0,0,0,0,0,0,0,0,0
20200430,07606P,台灣50國票01售02,2.65,2.66,2.56,2.56,-0.22,-7.91,25000,9,65730,0,0,0,0,0,0,0,25000,-25000,-25000
20200430,07607P,台灣50國票01售03,,,,,0.00,0.00,0,0,0,0,0,0,0,0,0,0,0,0,0
20200430,07608P,台灣50國票9C售03,2.16,2.16,2.16,2.16,-0.26,-10.74,200000,1,432000,0,0,0,0,0,0,200000,0,200000,200000
20200430,07609P,台灣50國票9C售04,2.53,2.53,2.48,2.48,0.00,0.00,2000,2,5010,0,0,0,0,0,0,0,2000,-2000,-2000
20200430,07610P,大立光國票9A售04,,,,,0.00,0.00,0,0,0,0,0,0,0,0,0,0,0,0,0
20200430,07611P,大立光國票9A售05,,,,,0.00,0.00,0,0,0,0,0,0,0,0,0,0,0,0,0
20200430,07612P,國巨國泰9B售06,0.74,0.76,0.74,0.75,-0.03,-3.85,551000,12,413420,0,0,0,0,0,0,152000,399000,-247000,-247000
20200430,07613P,國巨永豐9A售01,0.74,0.75,0.74,0.75,0.00,0.00,26000,3,19350,0,0,0,0,0,0,26000,0,26000,26000
20200430,07614P,華新科群益9A售04,1.08,1.09,1.07,1.09,-0.02,-1.8,4000,4,4320,0,0,0,0,0,0,3000,1000,2000,2000
20200430,07615P,華通中信02售02,0.67,0.67,0.67,0.67,-0.05,-6.94,60000,3,40200,0,0,0,0,0,0,10000,45000,-35000,-35000
20200430,07616P,瑞昱中信02售01,,,,,0.00,0.00,0,0,0,0,0,0,0,0,0,0,0,0,0
20200430,07617P,聯發科中信9C售04,0.44,0.45,0.44,0.44,-0.04,-8.33,169000,11,75720,0,0,0,0,0,0,3000,166000,-163000,-163000
20200430,07618P,大立光中信9A售06,0.47,0.47,0.45,0.45,-0.04,-8.16,343000,10,157950,0,0,0,0,0,0,323000,20000,303000,303000
20200430,07619P,鴻海統一9A售03,0.75,0.75,0.75,0.75,-0.02,-2.6,10000,1,7500,0,0,0,0,0,0,0,10000,-10000,-10000
20200430,07620P,國巨統一9B售07,1.01,1.02,1.00,1.01,-0.02,-1.94,131000,5,133290,0,0,0,0,0,0,5000,126000,-121000,-121000
20200430,07621P,台積電統一9B售09,0.67,0.67,0.67,0.67,-0.03,-4.29,25000,1,16750,0,0,0,0,0,0,25000,0,25000,25000
20200430,07622P,華新科統一9B售02,,,,,0.00,0.00,0,0,0,0,0,0,0,0,0,0,0,0,0
20200430,07623P,大立光統一9B售05,0.88,0.88,0.86,0.86,-0.05,-5.49,285000,7,246950,0,0,0,0,0,0,270000,15000,255000,255000
20200430,07624P,台灣50台新9B售07,0.17,0.17,0.17,0.17,0.00,0.00,30000,6,5100,0,0,0,0,0,0,0,30000,-30000,-30000
20200430,07625P,台灣50凱基01售06,2.23,2.23,2.15,2.15,0.00,0.00,6000,3,13010,0,0,0,0,0,0,2000,4000,-2000,-2000
20200430,07626P,台灣50凱基04售07,2.10,2.10,1.98,1.99,-0.12,-5.69,98000,7,198520,0,0,0,0,0,0,60000,38000,22000,22000
20200430,07627P,超眾凱基9A售02,0.78,0.79,0.77,0.79,0.00,0.00,50000,3,39200,0,0,0,0,0,0,50000,0,50000,50000
20200430,07628P,臺股指凱基9A售09,1.50,1.50,1.43,1.43,-0.14,-8.92,21000,5,30800,0,0,0,0,0,0,0,21000,-21000,-21000
20200430,07629P,臺股指凱基9A售10,2.35,2.35,2.35,2.35,-0.28,-10.65,20000,1,47000,0,0,0,0,0,0,20000,0,20000,20000
20200430,07630P,臺股指凱基9A售11,1.95,1.97,1.85,1.85,-0.20,-9.76,411000,36,773320,0,0,0,0,0,0,98000,313000,-215000,-215000
20200430,07631P,臺股指凱基9A售12,,,,,0.00,0.00,0,0,0,0,0,0,0,0,0,0,0,0,0
20200430,07632P,臺股指凱基9A售14,1.31,1.31,1.25,1.25,0.00,0.00,135000,6,173100,0,0,0,0,0,0,5000,130000,-125000,-125000
20200430,07633P,台灣50元大9A售18,1.85,1.85,1.85,1.85,-0.12,-6.09,4000,1,7400,0,0,0,0,0,0,4000,0,4000,4000
20200430,07634P,金像電元大9A售01,1.48,1.48,1.39,1.41,-0.09,-6.0,358000,32,510800,0,0,0,0,0,0,189000,154000,35000,35000
20200430,07635P,世芯永豐9A售05,0.67,0.67,0.62,0.62,-0.09,-12.68,156000,16,99640,0,0,0,0,0,0,20000,136000,-116000,-116000
20200430,07636P,鴻海國票9A售05,,,,,0.00,0.00,0,0,0,0,0,0,0,0,0,0,0,0,0
20200430,07637P,國巨國票9A售08,2.37,2.37,2.37,2.37,-0.11,-4.44,102000,2,241740,0,0,0,0,0,0,0,102000,-102000,-102000
20200430,07638P,長榮航國票9A售01,0.64,0.70,0.64,0.67,-0.06,-8.22,506000,14,337520,0,0,0,0,0,0,133000,373000,-240000,-240000
20200430,07639P,緯穎國票9A售01,,,,,0.00,0.00,0,0,0,0,0,0,0,0,0,0,0,0,0
20200430,07640P,國巨群益9A售07,1.42,1.46,1.40,1.42,-0.07,-4.7,52000,12,74270,0,0,0,0,0,0,42000,10000,32000,32000
20200430,07641P,上銀凱基9A售05,0.75,0.75,0.67,0.67,-0.11,-14.1,302000,17,207840,0,0,0,0,0,0,150000,132000,18000,18000
20200430,07642P,華通凱基9A售05,0.97,0.97,0.97,0.97,-0.05,-4.9,1000,1,970,0,0,0,0,0,0,0,1000,-1000,-1000
20200430,07643P,禾伸堂凱基9A售02,0.69,0.71,0.69,0.70,-0.01,-1.41,111000,11,77010,0,0,0,0,0,0,20000,91000,-71000,-71000
20200430,07644P,南電凱基9A售03,0.73,0.76,0.73,0.75,+0.02,2.74,91000,9,67620,0,0,0,0,0,0,55000,26000,29000,29000
20200430,07645P,華通元大9A售06,,,,,0.00,0.00,0,0,0,0,0,0,0,0,0,0,0,0,0
20200430,07646P,世芯元大9A售04,1.38,1.38,1.27,1.28,-0.15,-10.49,189000,16,250560,0,0,0,0,0,0,15000,174000,-159000,-159000
20200430,07647P,健策國票9A售04,2.38,2.39,2.38,2.39,-0.12,-4.78,18000,2,42930,0,0,0,0,0,0,0,18000,-18000,-18000
20200430,07648P,祥碩國票9B售01,2.04,2.18,2.04,2.18,+0.13,6.34,33000,4,71780,0,0,0,0,0,0,0,33000,-33000,-33000
20200430,07649P,金像電永豐9A售02,0.70,0.70,0.66,0.66,-0.04,-5.71,628000,37,421610,0,0,0,0,0,0,324000,298000,26000,26000
20200430,07650P,台灣50中信9A售01,,,,,0.00,0.00,0,0,0,0,0,0,0,0,0,0,0,0,0
20200430,07651P,道瓊指中信01售01,,,,,0.00,0.00,0,0,0,0,0,0,0,0,0,0,0,0,0
20200430,07652P,臺股指中信9A售07,0.89,0.91,0.84,0.85,-0.09,-9.57,602000,37,532160,0,0,0,0,0,0,7000,590000,-583000,-583000
20200430,07653P,華新科群益9A售05,1.70,1.72,1.70,1.72,-0.03,-1.71,12000,3,20520,0,0,0,0,0,0,11000,1000,10000,10000
20200430,07654P,台灣50凱基01售08,2.12,2.12,2.10,2.10,0.00,0.00,164000,4,347660,0,0,0,0,0,0,161000,3000,158000,158000
20200430,07655P,台灣50凱基01售09,,,,,0.00,0.00,0,0,0,0,0,0,0,0,0,0,0,0,0
20200430,07656P,國巨凱基9A售15,0.95,0.95,0.95,0.95,0.00,0.00,10000,1,9500,0,0,0,0,0,0,10000,0,10000,10000
20200430,07657P,技嘉凱基9A售03,0.80,0.82,0.80,0.82,-0.01,-1.2,5000,3,4020,0,0,0,0,0,0,5000,0,5000,5000
20200430,07658P,國泰金凱基9A售01,0.73,0.73,0.73,0.73,-0.10,-12.05,11000,1,8030,0,0,0,0,0,0,11000,0,11000,11000
20200430,07659P,中租凱基9A售02,0.71,0.71,0.70,0.70,-0.05,-6.67,27000,3,19100,0,0,0,0,0,0,0,27000,-27000,-27000
20200430,07660P,聯茂凱基9A售03,1.10,1.14,1.10,1.14,+0.02,1.79,24000,2,27320,0,0,0,0,0,0,1000,23000,-22000,-22000
20200430,07661P,台灣50兆豐9A售03,,,,,0.00,0.00,0,0,0,0,0,0,0,0,0,0,0,0,0
20200430,07662P,台積電兆豐9A售03,,,,,0.00,0.00,0,0,0,0,0,0,0,0,0,0,0,0,0
20200430,07663P,台灣50台新01售03,,,,,0.00,0.00,0,0,0,0,0,0,0,0,0,0,0,0,0
20200430,07664P,台灣50元大9C售30,1.64,1.64,1.62,1.62,0.00,0.00,88000,4,144120,0,0,0,0,0,0,0,88000,-88000,-88000
20200430,07665P,台灣50元大9C售31,,,,,0.00,0.00,0,0,0,0,0,0,0,0,0,0,0,0,0
20200430,07666P,台灣50元大9C售32,,,,,0.00,0.00,0,0,0,0,0,0,0,0,0,0,0,0,0
20200430,07667P,亞德客元大9A售05,1.50,1.53,1.34,1.34,-0.24,-15.19,395000,28,570140,0,0,0,0,0,0,95000,300000,-205000,-205000
20200430,07668P,旺宏元大9A售10,,,,,0.00,0.00,0,0,0,0,0,0,0,0,0,0,0,0,0
20200430,07669P,華新科元大9A售14,1.17,1.19,1.16,1.19,-0.01,-0.83,54000,5,63410,0,0,0,0,0,0,24000,30000,-6000,-6000
20200430,07670P,茂林元大9A售02,1.75,1.78,1.73,1.78,+0.01,0.56,202000,5,352510,0,0,0,0,0,0,137000,65000,72000,72000
20200430,07671P,超眾元大9A售04,2.02,2.07,2.02,2.07,-0.01,-0.48,69000,11,142200,0,0,0,0,0,0,37000,32000,5000,5000
20200430,07672P,南電元大9A售05,1.42,1.47,1.38,1.44,-0.01,-0.69,188000,22,266900,0,0,0,0,0,0,131000,40000,91000,91000
20200430,07673P,電子類元大9A售01,1.92,1.92,1.88,1.88,-0.11,-5.53,327000,8,618740,0,0,0,0,0,0,0,327000,-327000,-327000
20200430,07674P,金融類元大9A售01,1.45,1.45,1.44,1.44,0.00,0.00,15000,2,21700,0,0,0,0,0,0,0,15000,-15000,-15000
20200430,07675P,全新永豐9A售02,0.86,0.86,0.86,0.86,-0.05,-5.49,85000,1,73100,0,0,0,0,0,0,85000,0,85000,85000
20200430,07676P,華新科永豐9A售02,,,,,0.00,0.00,0,0,0,0,0,0,0,0,0,0,0,0,0
20200430,07677P,祥碩永豐9A售01,0.78,0.78,0.78,0.78,0.00,0.00,3000,1,2340,0,0,0,0,0,0,3000,0,3000,3000
20200430,07678P,大立光群益9A售03,2.40,2.41,2.40,2.41,-0.17,-6.59,6000,2,14410,0,0,0,0,0,0,5000,1000,4000,4000
20200430,07679P,台灣50凱基01售10,,,,,0.00,0.00,0,0,0,0,0,0,0,0,0,0,0,0,0
20200430,07680P,鴻海凱基9A售24,,,,,0.00,0.00,0,0,0,0,0,0,0,0,0,0,0,0,0
20200430,07681P,台積電凱基9A售20,,,,,0.00,0.00,0,0,0,0,0,0,0,0,0,0,0,0,0
20200430,07682P,聯發科凱基9A售15,,,,,0.00,0.00,0,0,0,0,0,0,0,0,0,0,0,0,0
20200430,07683P,宏達電凱基9A售03,1.14,1.14,1.14,1.14,-0.04,-3.39,30000,1,34200,0,0,0,0,0,0,30000,0,30000,30000
20200430,07684P,大立光凱基9A售11,,,,,0.00,0.00,0,0,0,0,0,0,0,0,0,0,0,0,0
20200430,07685P,玉晶光凱基9B售03,0.75,0.75,0.72,0.72,-0.05,-6.49,561000,11,416050,0,0,0,0,0,0,300000,261000,39000,39000
20200430,07686P,祥碩凱基9A售02,0.93,0.97,0.93,0.97,+0.05,5.43,41000,3,39610,0,0,0,0,0,0,0,41000,-41000,-41000
20200430,07687P,上銀元大9A售06,1.79,1.79,1.58,1.58,-0.40,-20.2,9000,2,15060,0,0,0,0,0,0,0,9000,-9000,-9000
20200430,07688P,華通元大9A售07,,,,,0.00,0.00,0,0,0,0,0,0,0,0,0,0,0,0,0
20200430,07689P,旺宏元大9A售13,1.85,1.85,1.85,1.85,-0.16,-7.96,17000,2,31450,0,0,0,0,0,0,3000,14000,-11000,-11000
20200430,07690P,華新科元大9A售15,1.93,1.95,1.93,1.95,-0.03,-1.52,21000,2,40930,0,0,0,0,0,0,21000,0,21000,21000
20200430,07691P,宏達電元大9A售05,,,,,0.00,0.00,0,0,0,0,0,0,0,0,0,0,0,0,0
20200430,07692P,玉晶光元大9A售11,2.93,2.93,2.93,2.93,-0.11,-3.62,30000,1,87900,0,0,0,0,0,0,30000,0,30000,30000
20200430,07693P,群創元大9B售10,,,,,0.00,0.00,0,0,0,0,0,0,0,0,0,0,0,0,0
20200430,07694P,超眾元大9A售05,1.42,1.45,1.42,1.45,0.00,0.00,139000,8,200340,0,0,0,0,0,0,98000,41000,57000,57000
20200430,07695P,台郡元大9A售02,,,,,0.00,0.00,0,0,0,0,0,0,0,0,0,0,0,0,0
20200430,07696P,臺股指元大9A售49,,,,,0.00,0.00,0,0,0,0,0,0,0,0,0,0,0,0,0
20200430,07697P,臺股指元大9A售50,1.23,1.23,1.19,1.19,-0.07,-5.56,12000,6,14560,0,0,0,0,0,0,0,12000,-12000,-12000
20200430,07698P,臺股指元大9A售51,1.20,1.20,1.20,1.20,0.00,0.00,5000,1,6000,0,0,0,0,0,0,0,5000,-5000,-5000
20200430,07699P,臺股指元大9A售52,1.30,1.31,1.28,1.28,-0.05,-3.76,25000,4,32500,0,0,0,0,0,0,5000,20000,-15000,-15000
20200430,07700P,臺股指元大9A售53,1.39,1.39,1.36,1.36,-0.08,-5.56,402000,10,557180,0,0,0,0,0,0,76000,326000,-250000,-250000
20200430,07701P,玉晶光第一9A售02,,,,,0.00,0.00,0,0,0,0,0,0,0,0,0,0,0,0,0
20200430,07702P,台積電中信9A售06,,,,,0.00,0.00,0,0,0,0,0,0,0,0,0,0,0,0,0
20200430,07703P,玉晶光中信9B售03,0.64,0.64,0.61,0.61,0.00,0.00,85000,6,53400,0,0,0,0,0,0,0,85000,-85000,-85000
20200430,07704P,台積電元大9A售25,3.26,3.26,3.26,3.26,-0.18,-5.23,30000,1,97800,0,0,0,0,0,0,30000,0,30000,30000
20200430,07705P,台積電元大9A售26,2.32,2.33,2.32,2.33,-0.08,-3.32,10000,2,23250,0,0,0,0,0,0,0,10000,-10000,-10000
20200430,07706P,長榮航元大9A售03,,,,,0.00,0.00,0,0,0,0,0,0,0,0,0,0,0,0,0
20200430,07707P,玉山金元大9A售03,2.25,2.25,2.25,2.25,-0.10,-4.26,5000,1,11250,0,0,0,0,0,0,5000,0,5000,5000
20200430,07708P,玉晶光元大9A售13,,,,,0.00,0.00,0,0,0,0,0,0,0,0,0,0,0,0,0
20200430,07709P,創意元大9A售01,2.13,2.13,2.09,2.11,-0.07,-3.21,104000,7,218710,0,0,0,0,0,0,88000,66000,22000,22000
20200430,07710P,華擎元大9A售05,1.55,1.61,1.54,1.59,-0.02,-1.24,447000,19,702710,0,0,0,0,0,0,229000,218000,11000,11000
20200430,07711P,世芯元大9A售07,0.80,0.80,0.73,0.73,-0.09,-10.98,285000,18,216440,0,0,0,0,0,0,74000,211000,-137000,-137000
20200430,07712P,茂林元大9A售03,1.27,1.31,1.27,1.31,-0.01,-0.76,32000,3,41450,0,0,0,0,0,0,12000,20000,-8000,-8000
20200430,07713P,台郡元大9A售03,2.05,2.05,2.04,2.04,-0.04,-1.92,48000,4,98030,0,0,0,0,0,0,37000,48000,-11000,-11000
20200430,07714P,世紀鋼元大9A售03,1.47,1.48,1.44,1.44,-0.06,-4.0,91000,3,134390,0,0,0,0,0,0,86000,5000,81000,81000
20200430,07715P,台灣50群益9A售14,2.22,2.22,2.13,2.13,-0.23,-9.75,172000,9,380850,0,0,0,0,0,0,66000,106000,-40000,-40000
20200430,07716P,臺股指群益9A售05,,,,,0.00,0.00,0,0,0,0,0,0,0,0,0,0,0,0,0
20200430,07717P,臺股指群益9A售06,2.91,2.91,2.81,2.81,-0.20,-6.64,52000,14,149060,0,0,0,0,0,0,15000,37000,-22000,-22000
20200430,07718P,臺股指群益9A售07,,,,,0.00,0.00,0,0,0,0,0,0,0,0,0,0,0,0,0
20200430,07719P,臺股指群益9A售08,2.49,2.49,2.33,2.34,-0.30,-11.36,232000,24,561110,0,0,0,0,0,0,100000,132000,-32000,-32000
20200430,07720P,臺股指群益9A售09,3.13,3.13,2.95,2.96,-0.32,-9.76,68000,6,208110,0,0,0,0,0,0,26000,42000,-16000,-16000
20200430,07721P,台積電凱基9A售22,3.00,3.00,3.00,3.00,-0.13,-4.15,50000,1,150000,0,0,0,0,0,0,50000,0,50000,50000
20200430,07722P,玉晶光凱基9A售10,0.88,0.88,0.85,0.85,-0.07,-7.61,86000,4,74150,0,0,0,0,0,0,0,86000,-86000,-86000
20200430,07723P,臺股指凱基9A售15,,,,,0.00,0.00,0,0,0,0,0,0,0,0,0,0,0,0,0
20200430,07724P,臺股指凱基9A售16,,,,,0.00,0.00,0,0,0,0,0,0,0,0,0,0,0,0,0
20200430,07725P,臺股指凱基9A售17,,,,,0.00,0.00,0,0,0,0,0,0,0,0,0,0,0,0,0
20200430,07726P,臺股指凱基9A售18,,,,,0.00,0.00,0,0,0,0,0,0,0,0,0,0,0,0,0
20200430,07727P,臺股指凱基9A售19,,,,,0.00,0.00,0,0,0,0,0,0,0,0,0,0,0,0,0
20200430,07728P,臺股指凱基9A售20,2.45,2.45,2.39,2.39,-0.24,-9.13,26000,3,63490,0,0,0,0,0,0,20000,6000,14000,14000
20200430,07729P,臺股指凱基9A售21,2.33,2.34,2.21,2.21,-0.21,-8.68,127000,10,287190,0,0,0,0,0,0,30000,77000,-47000,-47000
20200430,07730P,臺股指凱基9A售22,2.45,2.46,2.33,2.33,-0.23,-8.98,17000,5,40510,0,0,0,0,0,0,2000,15000,-13000,-13000
20200430,07731P,臺股指凱基9A售28,2.72,2.72,2.57,2.58,-0.25,-8.83,538000,30,1435670,0,0,0,0,0,0,130000,408000,-278000,-278000
20200430,07732P,台灣50台新9A售05,,,,,0.00,0.00,0,0,0,0,0,0,0,0,0,0,0,0,0
20200430,07733P,台積電統一9B售10,,,,,0.00,0.00,0,0,0,0,0,0,0,0,0,0,0,0,0
20200430,07734P,台積電富邦9C售10,0.67,0.67,0.64,0.64,0.00,0.00,35000,3,22700,0,0,0,0,0,0,30000,5000,25000,25000
20200430,07735P,臺股指富邦9A售03,,,,,0.00,0.00,0,0,0,0,0,0,0,0,0,0,0,0,0
20200430,07736P,台灣50永豐9A售03,,,,,0.00,0.00,0,0,0,0,0,0,0,0,0,0,0,0,0
20200430,07737P,華通永豐9A售01,0.86,0.86,0.86,0.86,-0.12,-12.24,5000,1,4300,0,0,0,0,0,0,5000,0,5000,5000
20200430,07738P,玉晶光永豐9A售06,0.87,0.87,0.84,0.84,-0.06,-6.67,10000,3,8490,0,0,0,0,0,0,7000,3000,4000,4000
20200430,07739P,緯穎永豐9A售01,,,,,0.00,0.00,0,0,0,0,0,0,0,0,0,0,0,0,0
20200430,07740P,臺股指永豐9A售01,,,,,0.00,0.00,0,0,0,0,0,0,0,0,0,0,0,0,0
20200430,07741P,滬深2X凱基9B售04,1.39,1.39,1.39,1.39,-0.04,-2.8,5000,1,6950,0,0,0,0,0,0,5000,0,5000,5000
20200430,07742P,台積電凱基9A售25,,,,,0.00,0.00,0,0,0,0,0,0,0,0,0,0,0,0,0
20200430,07743P,智邦凱基9A售03,0.52,0.55,0.52,0.55,+0.01,1.85,75000,7,40350,0,0,0,0,0,0,10000,45000,-35000,-35000
20200430,07744P,奇力新凱基9A售05,0.90,0.91,0.90,0.91,-0.03,-3.19,138000,3,124300,0,0,0,0,0,0,128000,10000,118000,118000
20200430,07745P,華新科凱基9A售10,,,,,0.00,0.00,0,0,0,0,0,0,0,0,0,0,0,0,0
20200430,07746P,華新科凱基9A售11,,,,,0.00,0.00,0,0,0,0,0,0,0,0,0,0,0,0,0
20200430,07747P,晶技凱基9A售04,1.21,1.22,1.19,1.20,-0.03,-2.44,85000,9,102630,0,0,0,0,0,0,67000,18000,49000,49000
20200430,07748P,茂林凱基9A售04,0.88,0.89,0.88,0.89,-0.01,-1.11,12000,3,10570,0,0,0,0,0,0,12000,0,12000,12000
20200430,07749P,台郡凱基9A售01,1.00,1.00,1.00,1.00,-0.01,-0.99,2000,1,2000,0,0,0,0,0,0,2000,0,2000,2000
20200430,07750P,台表科凱基9A售04,,,,,0.00,0.00,0,0,0,0,0,0,0,0,0,0,0,0,0
20200430,07751P,世紀鋼凱基9A售02,1.00,1.00,0.98,0.98,-0.04,-3.92,17000,3,16860,0,0,0,0,0,0,13000,4000,9000,9000
20200430,07752P,台灣50元大9C售33,1.78,1.78,1.75,1.75,0.00,0.00,36000,5,63500,0,0,0,0,0,0,0,36000,-36000,-36000
20200430,07753P,台灣50元大9C售34,,,,,0.00,0.00,0,0,0,0,0,0,0,0,0,0,0,0,0
20200430,07754P,日月光元大9A售02,1.92,1.94,1.92,1.92,-0.09,-4.48,20000,6,38440,0,0,0,0,0,0,20000,0,20000,20000
20200430,07755P,台灣50國票03售01,,,,,0.00,0.00,0,0,0,0,0,0,0,0,0,0,0,0,0
20200430,07756P,台灣50國票04售01,4.31,4.31,4.31,4.31,0.00,0.00,20000,1,86200,0,0,0,0,0,0,0,20000,-20000,-20000
20200430,07757P,國巨國票9B售04,1.92,1.95,1.92,1.92,-0.10,-4.95,185000,4,357680,0,0,0,0,0,0,60000,125000,-65000,-65000
20200430,07758P,台積電國票9A售06,3.26,3.28,3.22,3.22,-0.17,-5.01,12000,5,38960,0,0,0,0,0,0,0,12000,-12000,-12000
20200430,07759P,臺股指富邦9A售04,,,,,0.00,0.00,0,0,0,0,0,0,0,0,0,0,0,0,0
20200430,07760P,力山永豐9A售03,0.77,0.83,0.74,0.83,-0.01,-1.19,115000,9,91700,0,0,0,0,0,0,65000,50000,15000,15000
20200430,07761P,智邦永豐9A售03,0.66,0.68,0.66,0.68,+0.03,4.62,164000,13,111260,0,0,0,0,0,0,79000,85000,-6000,-6000
20200430,07762P,聯發科永豐9A售03,,,,,0.00,0.00,0,0,0,0,0,0,0,0,0,0,0,0,0
20200430,07763P,嘉澤永豐9A售02,,,,,0.00,0.00,0,0,0,0,0,0,0,0,0,0,0,0,0
20200430,07764P,世紀鋼永豐9A售04,0.95,0.95,0.93,0.93,-0.05,-5.1,66000,3,61900,0,0,0,0,0,0,66000,0,66000,66000
20200430,07765P,台積電群益9A售06,1.76,1.76,1.71,1.71,-0.12,-6.56,23000,5,40010,0,0,0,0,0,0,1000,22000,-21000,-21000
20200430,07766P,美律群益9A售03,,,,,0.00,0.00,0,0,0,0,0,0,0,0,0,0,0,0,0
20200430,07767P,華新科群益9A售07,2.01,2.06,2.00,2.02,-0.06,-2.88,72000,7,145950,0,0,0,0,0,0,59000,13000,46000,46000
20200430,07768P,緯穎群益9A售02,,,,,0.00,0.00,0,0,0,0,0,0,0,0,0,0,0,0,0
20200430,07769P,國巨國票9A售10,2.18,2.24,2.18,2.19,-0.13,-5.6,75000,4,165580,0,0,0,0,0,0,30000,45000,-15000,-15000
20200430,07770P,台積電國票9A售07,,,,,0.00,0.00,0,0,0,0,0,0,0,0,0,0,0,0,0
20200430,07771P,義隆國票9A售01,1.57,1.57,1.57,1.57,-0.05,-3.09,30000,1,47100,0,0,0,0,0,0,30000,0,30000,30000
20200430,07772P,華新科國票9A售05,2.57,2.57,2.57,2.57,0.00,0.00,12000,1,30840,0,0,0,0,0,0,0,12000,-12000,-12000
20200430,07773P,台灣50群益9A售15,,,,,0.00,0.00,0,0,0,0,0,0,0,0,0,0,0,0,0
20200430,07774P,台灣50群益9A售16,1.10,1.11,1.09,1.09,-0.10,-8.4,60000,3,66000,0,0,0,0,0,0,0,60000,-60000,-60000
20200430,07775P,國巨群益9A售10,2.14,2.19,2.14,2.19,-0.04,-1.79,13000,3,28100,0,0,0,0,0,0,9000,4000,5000,5000
20200430,07776P,國巨群益9B售02,1.54,1.54,1.54,1.54,-0.07,-4.35,22000,3,33880,0,0,0,0,0,0,12000,10000,2000,2000
20200430,07777P,創意元大9A售03,2.28,2.28,2.22,2.23,-0.12,-5.11,103000,3,231790,0,0,0,0,0,0,103000,50000,53000,53000
20200430,07778P,台灣50凱基9C售08,1.96,1.96,1.96,1.96,-0.09,-4.39,35000,1,68600,0,0,0,0,0,0,35000,0,35000,35000
20200430,07779P,鴻海凱基9B售04,,,,,0.00,0.00,0,0,0,0,0,0,0,0,0,0,0,0,0
20200430,07780P,美律凱基9A售02,1.11,1.11,1.11,1.11,-0.04,-3.48,26000,1,28860,0,0,0,0,0,0,26000,0,26000,26000
20200430,07781P,高鐵凱基9A售02,0.67,0.67,0.67,0.67,-0.04,-5.63,40000,1,26800,0,0,0,0,0,0,0,40000,-40000,-40000
20200430,07782P,寶成凱基9A售02,0.97,0.98,0.96,0.96,-0.03,-3.03,188000,12,182410,0,0,0,0,0,0,0,182000,-182000,-182000
20200430,07783P,聯發科富邦9C售03,0.67,0.67,0.66,0.66,-0.06,-8.33,100000,4,66950,0,0,0,0,0,0,40000,60000,-20000,-20000
20200430,07784P,華新科富邦9B售04,,,,,0.00,0.00,0,0,0,0,0,0,0,0,0,0,0,0,0
20200430,07785P,鴻海中信04售03,1.04,1.04,1.04,1.04,0.00,0.00,30000,1,31200,0,0,0,0,0,0,30000,0,30000,30000
20200430,07786P,南電中信9C售01,0.48,0.51,0.48,0.50,0.00,0.00,79000,9,38670,0,0,0,0,0,0,12000,67000,-55000,-55000
20200430,07787P,國巨凱基9A售17,,,,,0.00,0.00,0,0,0,0,0,0,0,0,0,0,0,0,0
20200430,07788P,華新科群益9A售08,1.38,1.39,1.38,1.39,-0.04,-2.8,36000,4,49900,0,0,0,0,0,0,14000,22000,-8000,-8000
20200430,07789P,緯穎群益9A售03,,,,,0.00,0.00,0,0,0,0,0,0,0,0,0,0,0,0,0
20200430,07790P,台灣50元大9A售19,,,,,0.00,0.00,0,0,0,0,0,0,0,0,0,0,0,0,0
20200430,07791P,奇鋐元大9A售02,1.34,1.40,1.34,1.36,-0.07,-4.9,30000,5,41100,0,0,0,0,0,0,10000,20000,-10000,-10000
20200430,07792P,牧德元大9A售04,1.24,1.26,1.23,1.23,-0.07,-5.38,70000,8,87360,0,0,0,0,0,0,47000,23000,24000,24000
20200430,07793P,同欣電元大9A售02,1.61,1.61,1.58,1.58,-0.08,-4.82,279000,4,446880,0,0,0,0,0,0,279000,0,279000,279000
20200430,07794P,智邦國票9A售03,1.82,2.00,1.82,2.00,+0.03,1.52,163000,19,314420,0,0,0,0,0,0,71000,92000,-21000,-21000
20200430,07795P,美律國票9A售03,1.55,1.55,1.55,1.55,-0.18,-10.4,21000,1,32550,0,0,0,0,0,0,21000,0,21000,21000
20200430,07796P,聯發科國票9A售03,1.07,1.07,1.01,1.01,-0.17,-14.41,135000,7,140820,0,0,0,0,0,0,67000,68000,-1000,-1000
20200430,07797P,大立光國票9A售08,,,,,0.00,0.00,0,0,0,0,0,0,0,0,0,0,0,0,0
20200430,07798P,同欣電國票9A售01,1.69,1.69,1.69,1.69,-0.04,-2.31,18000,2,30420,0,0,0,0,0,0,18000,0,18000,18000
20200430,07799P,南電國票9A售04,2.32,2.44,2.28,2.44,-0.03,-1.21,81000,9,191100,0,0,0,0,0,0,18000,63000,-45000,-45000
20200430,07800P,華新科國泰9B售04,1.96,2.01,1.96,2.01,+0.01,0.5,20000,3,39720,0,0,0,0,0,0,10000,10000,0,0
20200430,07801P,上銀永豐9A售02,0.74,0.74,0.74,0.74,0.00,0.00,20000,1,14800,0,0,0,0,0,0,0,20000,-20000,-20000
20200430,07802P,瑞昱永豐9A售03,0.81,0.81,0.80,0.80,-0.09,-10.11,200000,2,161000,0,0,0,0,0,0,0,200000,-200000,-200000
20200430,07803P,南亞科永豐9A售02,,,,,0.00,0.00,0,0,0,0,0,0,0,0,0,0,0,0,0
20200430,07804P,美律永豐9A售02,,,,,0.00,0.00,0,0,0,0,0,0,0,0,0,0,0,0,0
20200430,07805P,義隆永豐9A售02,1.01,1.01,0.98,0.98,-0.04,-3.92,144000,9,143140,0,0,0,0,0,0,62000,48000,14000,14000
20200430,07806P,健策永豐9A售02,,,,,0.00,0.00,0,0,0,0,0,0,0,0,0,0,0,0,0
20200430,07807P,聯茂永豐9A售02,0.85,0.89,0.85,0.89,+0.03,3.49,35000,4,30670,0,0,0,0,0,0,12000,23000,-11000,-11000
20200430,07808P,超眾永豐9A售04,0.96,0.96,0.96,0.96,-0.03,-3.03,62000,1,59520,0,0,0,0,0,0,62000,0,62000,62000
20200430,07809P,國巨中信9A售06,,,,,0.00,0.00,0,0,0,0,0,0,0,0,0,0,0,0,0
20200430,07810P,台積電統一9A售08,,,,,0.00,0.00,0,0,0,0,0,0,0,0,0,0,0,0,0
20200430,07811P,華新科統一9A售02,,,,,0.00,0.00,0,0,0,0,0,0,0,0,0,0,0,0,0
20200430,07812P,大立光統一9A售06,0.53,0.53,0.50,0.50,-0.05,-9.09,14000,3,7220,0,0,0,0,0,0,0,14000,-14000,-14000
20200430,07813P,台灣50群益9C售03,,,,,0.00,0.00,0,0,0,0,0,0,0,0,0,0,0,0,0
20200430,07814P,華通群益9A售06,1.95,1.95,1.81,1.81,-0.24,-11.71,5000,4,9300,0,0,0,0,0,0,0,5000,-5000,-5000
20200430,07815P,美律群益9A售04,1.67,1.67,1.57,1.57,-0.18,-10.29,21000,3,34830,0,0,0,0,0,0,17000,4000,13000,13000
20200430,07816P,聯發科群益9A售02,,,,,0.00,0.00,0,0,0,0,0,0,0,0,0,0,0,0,0
20200430,07817P,同欣電群益9A售02,1.81,1.81,1.81,1.81,-0.05,-2.69,36000,3,65160,0,0,0,0,0,0,36000,0,36000,36000
20200430,07818P,台積電國票9C售01,,,,,0.00,0.00,0,0,0,0,0,0,0,0,0,0,0,0,0
20200430,07819P,旺宏國票9B售01,,,,,0.00,0.00,0,0,0,0,0,0,0,0,0,0,0,0,0
20200430,07820P,臺股指國票9A售11,,,,,0.00,0.00,0,0,0,0,0,0,0,0,0,0,0,0,0
20200430,07821P,臺股指國票9A售12,1.75,1.76,1.64,1.64,-0.21,-11.35,181000,16,308240,0,0,0,0,0,0,75000,106000,-31000,-31000
20200430,07822P,滬深2X元大9A售09,,,,,0.00,0.00,0,0,0,0,0,0,0,0,0,0,0,0,0
20200430,07823P,國巨元大9A售23,2.80,2.80,2.74,2.74,-0.07,-2.49,13000,3,36160,0,0,0,0,0,0,0,13000,-13000,-13000
20200430,07824P,國巨元大9A售24,,,,,0.00,0.00,0,0,0,0,0,0,0,0,0,0,0,0,0
20200430,07825P,健策國泰9B售04,1.42,1.42,1.35,1.35,0.00,0.00,39000,3,55170,0,0,0,0,0,0,36000,39000,-3000,-3000
20200430,07826P,台積電富邦9B售07,0.69,0.69,0.67,0.67,-0.04,-5.63,65000,6,44100,0,0,0,0,0,0,30000,30000,0,0
20200430,07827P,台灣50中信9C售01,,,,,0.00,0.00,0,0,0,0,0,0,0,0,0,0,0,0,0
20200430,07828P,SP黃豆凱基01售01,,,,,0.00,0.00,0,0,0,0,0,0,0,0,0,0,0,0,0
20200430,07829P,旺宏凱基9A售07,,,,,0.00,0.00,0,0,0,0,0,0,0,0,0,0,0,0,0
20200430,07830P,牧德凱基9A售03,0.80,0.81,0.78,0.78,-0.06,-7.14,67000,4,53470,0,0,0,0,0,0,25000,42000,-17000,-17000
20200430,07831P,大立光統一9B售07,,,,,0.00,0.00,0,0,0,0,0,0,0,0,0,0,0,0,0
20200430,07832P,台積電群益9A售08,3.08,3.08,3.08,3.08,0.00,0.00,11000,1,33880,0,0,0,0,0,0,0,11000,-11000,-11000
20200430,07833P,大立光群益9B售02,,,,,0.00,0.00,0,0,0,0,0,0,0,0,0,0,0,0,0
20200430,07834P,聯詠群益9A售03,1.32,1.32,1.32,1.32,0.00,0.00,6000,1,7920,0,0,0,0,0,0,0,6000,-6000,-6000
20200430,07835P,台表科群益9A售02,,,,,0.00,0.00,0,0,0,0,0,0,0,0,0,0,0,0,0
20200430,07836P,大成鋼元大9A售01,1.77,1.77,1.76,1.76,-0.04,-2.22,115000,3,202550,0,0,0,0,0,0,0,115000,-115000,-115000
20200430,07837P,華邦電元大9A售01,1.76,1.76,1.72,1.72,0.00,0.00,2000,2,3480,0,0,0,0,0,0,0,2000,-2000,-2000
20200430,07838P,泰碩元大9A售04,1.71,1.71,1.71,1.71,0.00,0.00,5000,1,8550,0,0,0,0,0,0,5000,0,5000,5000
20200430,07839P,嘉澤元大9A售04,,,,,0.00,0.00,0,0,0,0,0,0,0,0,0,0,0,0,0
20200430,07840P,康控元大9A售02,1.46,1.46,1.46,1.46,0.00,0.00,7000,1,10220,0,0,0,0,0,0,0,7000,-7000,-7000
20200430,07841P,臻鼎元大9A售04,,,,,0.00,0.00,0,0,0,0,0,0,0,0,0,0,0,0,0
20200430,07842P,力成元大9A售01,,,,,0.00,0.00,0,0,0,0,0,0,0,0,0,0,0,0,0
20200430,07843P,緯穎元大9A售05,1.36,1.38,1.32,1.38,0.00,0.00,42000,5,57320,0,0,0,0,0,0,0,42000,-42000,-42000
20200430,07844P,可成國票9A售01,2.32,2.32,2.32,2.32,0.00,0.00,52000,1,120640,0,0,0,0,0,0,0,52000,-52000,-52000
20200430,07845P,南亞科元大9A售08,,,,,0.00,0.00,0,0,0,0,0,0,0,0,0,0,0,0,0
20200430,07846P,台灣50群益9A售17,,,,,0.00,0.00,0,0,0,0,0,0,0,0,0,0,0,0,0
20200430,07847P,國巨群益9A售13,2.39,2.39,2.35,2.35,-0.36,-13.28,14000,2,33060,0,0,0,0,0,0,0,14000,-14000,-14000
20200430,07848P,旺宏群益9B售01,2.53,2.55,2.53,2.55,+0.14,5.81,3000,2,7630,0,0,0,0,0,0,0,3000,-3000,-3000
20200430,07849P,大立光群益9A售06,2.04,2.04,2.02,2.02,-0.06,-2.88,15000,2,30500,0,0,0,0,0,0,0,15000,-15000,-15000
20200430,07850P,健策群益9A售06,,,,,0.00,0.00,0,0,0,0,0,0,0,0,0,0,0,0,0
20200430,07851P,聯發科國票9A售05,,,,,0.00,0.00,0,0,0,0,0,0,0,0,0,0,0,0,0
20200430,07852P,臺股指國票9A售13,,,,,0.00,0.00,0,0,0,0,0,0,0,0,0,0,0,0,0
20200430,07853P,國巨凱基9A售19,,,,,0.00,0.00,0,0,0,0,0,0,0,0,0,0,0,0,0
20200430,07854P,台積電凱基9A售28,,,,,0.00,0.00,0,0,0,0,0,0,0,0,0,0,0,0,0
20200430,07855P,旺宏凱基9A售09,1.55,1.55,1.55,1.55,-0.08,-4.91,1000,1,1550,0,0,0,0,0,0,0,1000,-1000,-1000
20200430,07856P,力成凱基9A售02,,,,,0.00,0.00,0,0,0,0,0,0,0,0,0,0,0,0,0
20200430,07857P,國巨永豐9A售05,,,,,0.00,0.00,0,0,0,0,0,0,0,0,0,0,0,0,0
20200430,07858P,旺宏永豐9A售03,,,,,0.00,0.00,0,0,0,0,0,0,0,0,0,0,0,0,0
20200430,07859P,台灣50麥證9A售04,,,,,0.00,0.00,0,0,0,0,0,0,0,0,0,0,0,0,0
20200430,07860P,臺股指麥證9A售06,,,,,0.00,0.00,0,0,0,0,0,0,0,0,0,0,0,0,0
20200430,07866P,上証2X國票97售01,,,,,0.00,0.00,0,0,0,0,0,0,0,0,0,0,0,0,0
20200430,08100P,台灣50元富95售01,0.04,0.04,0.01,0.01,0.00,0.00,137000,3,3070,0,0,0,0,0,0,67000,0,67000,67000
20200430,08163P,T50正2中信95售01,0.04,0.05,0.04,0.05,+0.02,66.67,25000,2,1100,0,0,0,0,0,0,0,0,0,0
20200430,08164P,滬深2X中信95售04,,,,,0.00,0.00,0,0,0,0,0,0,0,0,0,0,0,0,0
20200430,08217P,T50反1凱基96售02,,,,,0.00,0.00,0,0,0,0,0,0,0,0,0,0,0,0,0
20200430,08218P,滬深2X凱基96售01,0.09,0.09,0.09,0.09,-0.13,-59.09,9000,1,810,0,0,0,0,0,0,9000,0,9000,9000
20200430,08484P,台灣50中信96售01,0.18,0.19,0.18,0.18,-0.07,-28.0,112000,5,20300,0,0,0,0,0,0,0,0,0,0
20200430,08506P,台灣50中信96售02,,,,,0.00,0.00,0,0,0,0,0,0,0,0,0,0,0,0,0
20200430,08525P,台灣50凱基96售02,0.07,0.07,0.06,0.06,-0.14,-70.0,110000,3,7100,0,0,0,0,0,0,0,0,0,0
20200430,08539P,元油2X國票99售01,,,,,0.00,0.00,0,0,0,0,0,0,0,0,0,0,0,0,0
20200430,08570P,台灣50凱基96售03,,,,,0.00,0.00,0,0,0,0,0,0,0,0,0,0,0,0,0
20200430,08602P,台灣50凱基96售04,,,,,0.00,0.00,0,0,0,0,0,0,0,0,0,0,0,0,0
20200430,08609P,世紀鋼永豐9C售03,,,,,0.00,0.00,0,0,0,0,0,0,0,0,0,0,0,0,0
20200430,08625P,台灣50凱基96售05,,,,,0.00,0.00,0,0,0,0,0,0,0,0,0,0,0,0,0
20200430,08637P,台灣50中信96售03,0.56,0.56,0.47,0.47,-0.14,-22.95,412000,45,209260,0,0,0,0,0,0,0,165000,-165000,-165000
20200430,08653P,台灣50凱基96售07,0.33,0.33,0.14,0.14,-0.25,-64.1,255000,11,41700,0,0,0,0,0,0,0,0,0,0
20200430,08663P,台灣50元大96售01,0.20,0.20,0.19,0.19,-0.06,-24.0,600000,8,115050,0,0,0,0,0,0,0,0,0,0
20200430,08671P,友訊國票01售01,0.15,0.15,0.15,0.15,0.00,0.00,2000,1,300,0,0,0,0,0,0,0,0,0,0
20200430,08674P,嘉晶元富07售02,0.59,0.59,0.51,0.57,-0.09,-13.64,331000,9,185490,0,0,0,0,0,0,100000,300000,-200000,-200000
20200430,08679P,台灣50元大01售15,0.25,0.25,0.16,0.16,-0.08,-33.33,67000,5,14020,0,0,0,0,0,0,55000,0,55000,55000
20200430,08714P,華碩元富01售03,0.23,0.23,0.13,0.17,-0.18,-51.43,1090000,15,162100,0,0,0,0,0,0,200000,120000,80000,80000
20200430,08801P,聯發科元大01售13,0.10,0.10,0.10,0.10,0.00,0.00,21000,4,2100,0,0,0,0,0,0,0,21000,-21000,-21000
20200430,08818P,台灣50元大97售01,0.39,0.39,0.22,0.29,-0.16,-35.56,1036000,79,306550,0,0,0,0,0,0,0,116000,-116000,-116000
20200430,08852P,台灣50台新01售01,1.20,1.23,1.10,1.13,-0.07,-5.83,149000,16,165980,0,0,0,0,0,0,0,10000,-10000,-10000
20200430,08864P,台積電中信95售03,,,,,0.00,0.00,0,0,0,0,0,0,0,0,0,0,0,0,0
20200430,08865P,台積電中信95售04,,,,,0.00,0.00,0,0,0,0,0,0,0,0,0,0,0,0,0
20200430,1101,台泥,42.55,43.35,42.55,43.20,+0.65,1.53,18924976,6948,816168818,7957000,5977000,1980000,2821000,0,2821000,260000,699000,-439000,4362000
20200430,1101B,台泥乙特,54.00,54.20,54.00,54.20,+0.10,0.18,21045,14,1137725,1000,0,1000,0,0,0,1000,0,1000,2000
20200430,1102,亞泥,42.95,44.10,42.90,43.90,+0.95,2.21,10138313,4339,442577279,5089000,4131000,958000,1607000,0,1607000,302000,577000,-275000,2290000
20200430,1103,嘉泥,17.20,17.20,16.85,17.20,+0.55,3.3,2517577,806,42949019,631000,89000,542000,34000,0,34000,0,0,0,576000
20200430,1104,環泥,17.45,17.65,17.45,17.60,+0.20,1.15,604759,293,10610973,261000,34000,227000,5000,0,5000,0,0,0,232000
20200430,1108,幸福,7.40,7.53,7.40,7.52,+0.10,1.35,279106,117,2091074,116000,0,116000,0,0,0,0,0,0,116000
20200430,1109,信大,17.30,17.60,17.30,17.60,+0.35,2.03,268631,172,4703142,92000,17000,75000,10000,0,10000,0,0,0,85000
20200430,1110,東泥,16.30,16.50,16.10,16.10,0.00,0.00,107325,66,1751150,61000,3000,58000,0,0,0,1000,0,1000,59000
20200430,1201,味全,21.60,21.85,21.50,21.85,+0.50,2.34,2902907,1170,63060751,639000,159000,480000,0,0,0,28000,0,28000,508000
20200430,1203,味王,27.45,27.75,27.40,27.70,+0.15,0.54,113055,88,3122260,61000,15000,46000,0,0,0,0,0,0,46000
20200430,1210,大成,41.65,41.75,41.10,41.45,0.00,0.00,3825856,2241,158352448,590000,702000,-112000,702000,0,702000,12000,45000,-33000,557000
20200430,1213,大飲,5.59,5.99,5.59,5.97,0.00,0.00,20405,22,120030,0,0,0,0,0,0,0,0,0,0
20200430,1215,卜蜂,63.90,63.90,62.30,63.10,+0.10,0.16,1018586,668,64271647,145000,165000,-20000,4000,218000,-214000,20000,5000,15000,-219000
20200430,1216,統一,69.20,70.00,69.20,69.50,+0.50,0.72,10128339,4866,706418839,5290000,6631760,-1341760,259000,60000,199000,46000,41000,5000,-1137760
20200430,1217,愛之味,7.20,7.20,7.15,7.16,+0.02,0.28,2337599,726,16763067,284000,134000,150000,0,0,0,0,0,0,150000
20200430,1218,泰山,23.70,23.90,23.50,23.55,-0.15,-0.63,1086600,611,25722853,259000,204000,55000,0,0,0,3000,2000,1000,56000
20200430,1219,福壽,18.65,18.75,18.65,18.70,+0.05,0.27,102502,66,1917033,43000,0,43000,0,0,0,0,0,0,43000
20200430,1220,台榮,10.70,10.70,10.60,10.60,0.00,0.00,264000,100,2806650,23000,5000,18000,0,0,0,0,0,0,18000
20200430,1225,福懋油,39.00,39.20,38.60,38.90,+0.20,0.52,189558,146,7370493,74000,46000,28000,0,0,0,0,0,0,28000
20200430,1227,佳格,67.60,67.80,67.20,67.30,0.00,0.00,1301298,943,87832544,730000,749514,-19514,14000,72000,-58000,6000,3000,3000,-74514
20200430,1229,聯華,43.30,43.40,42.60,43.10,+0.20,0.47,5305554,3116,227973890,837000,1202000,-365000,23000,0,23000,2000,4000,-2000,-344000
20200430,1231,聯華食,41.50,41.50,41.00,41.25,+0.10,0.24,334897,274,13812593,86000,33000,53000,0,0,0,11000,1000,10000,63000
20200430,1232,大統益,116.50,118.00,116.50,118.00,+2.00,1.72,68629,88,8044722,18000,4000,14000,1000,0,1000,0,0,0,15000
20200430,1233,天仁,35.20,36.05,35.15,36.05,+0.90,2.56,57180,48,2041257,21000,1000,20000,0,0,0,0,0,0,20000
20200430,1234,黑松,32.40,32.70,32.05,32.40,+0.10,0.31,140850,107,4564569,112000,38000,74000,0,0,0,0,0,0,74000
20200430,1235,興泰,26.00,26.35,26.00,26.30,+0.30,1.15,84750,26,2227873,14000,0,14000,0,0,0,0,0,0,14000
20200430,1236,宏亞,12.55,12.70,12.35,12.70,+0.15,1.2,53126,44,667538,18000,0,18000,0,0,0,0,0,0,18000
20200430,1256,鮮活果汁-KY,200.00,204.00,200.00,203.00,+4.00,2.01,88316,134,17904302,8000,8000,0,0,0,0,0,0,0,0
20200430,1301,台塑,85.00,88.00,84.50,87.90,+4.10,4.89,16349434,9045,1423897992,6855813,4175100,2680713,1146000,0,1146000,317000,148000,169000,3995713
20200430,1303,南亞,63.00,66.80,63.00,66.20,+3.70,5.92,15989935,9251,1053186355,6386000,4617000,1769000,1595000,0,1595000,46000,52000,-6000,3358000
20200430,1304,台聚,12.20,12.50,12.15,12.45,+0.35,2.89,3800925,1312,46985454,1089000,135000,954000,15000,0,15000,10000,19000,-9000,960000
20200430,1305,華夏,17.35,18.30,17.35,18.20,+1.05,6.12,6441331,2369,116086622,772000,735000,37000,4000,0,4000,0,34000,-34000,7000
20200430,1307,三芳,24.30,24.35,23.30,23.65,-0.65,-2.67,2559524,1289,60777660,121000,152000,-31000,0,0,0,0,0,0,-31000
20200430,1308,亞聚,16.90,17.20,16.80,17.20,+0.60,3.61,4720534,1706,80355908,1228000,220000,1008000,0,0,0,0,2000,-2000,1006000
20200430,1309,台達化,9.70,9.88,9.63,9.85,+0.22,2.28,2230569,735,21845682,466000,223000,243000,0,0,0,1000,0,1000,244000
20200430,1310,台苯,16.70,17.10,16.65,16.95,+0.25,1.5,6142839,2089,103876956,571000,700000,-129000,19000,0,19000,19000,84000,-65000,-175000
20200430,1312,國喬,14.60,15.10,14.60,15.05,+0.60,4.15,13281441,4013,198410479,2533000,2427000,106000,7000,0,7000,297000,4000,293000,406000
20200430,1312A,國喬特,31.00,31.05,30.80,31.00,-0.35,-1.12,30000,17,927950,0,0,0,0,0,0,1000,0,1000,1000
20200430,1313,聯成,9.80,10.05,9.80,10.00,+0.25,2.56,3015445,960,30056799,1336000,353000,983000,12000,0,12000,3000,0,3000,998000
20200430,1314,中石化,7.93,8.12,7.93,8.09,+0.24,3.06,30434440,6425,245413561,4927000,2643000,2284000,0,0,0,380000,367000,13000,2297000
20200430,1315,達新,49.00,49.45,49.00,49.15,+0.30,0.61,720240,409,35454710,194000,37000,157000,5000,0,5000,0,0,0,162000
20200430,1316,上曜,10.50,10.65,10.45,10.55,+0.10,0.96,513641,225,5418278,93000,79000,14000,0,0,0,0,0,0,14000
20200430,1319,東陽,35.00,35.95,35.00,35.95,+1.20,3.45,2703881,1708,95952267,930000,478000,452000,168000,0,168000,34000,29000,5000,625000
20200430,1321,大洋,30.20,30.40,30.00,30.05,+0.05,0.17,649000,250,19598750,81000,13000,68000,0,0,0,0,0,0,68000
20200430,1323,永裕,32.40,32.85,32.15,32.85,+0.45,1.39,178319,122,5792785,37000,17000,20000,0,0,0,0,0,0,20000
20200430,1324,地球,8.45,8.88,8.41,8.87,+0.44,5.22,196612,78,1713848,21000,1000,20000,0,0,0,0,0,0,20000
20200430,1325,恆大,90.00,90.00,83.10,87.50,-2.50,-2.78,4596716,2439,394860092,105000,25000,80000,0,40000,-40000,170000,0,170000,210000
20200430,1326,台化,72.60,76.60,72.60,75.90,+4.10,5.71,15201627,8607,1140789681,5515000,2838000,2677000,28000,0,28000,60000,175000,-115000,2590000
20200430,1337,再生-KY,4.52,4.65,4.52,4.58,+0.08,1.78,1140897,369,5223575,114000,87000,27000,0,0,0,1000,0,1000,28000
20200430,1338,廣華-KY,53.00,56.70,52.70,56.10,+4.10,7.88,2069428,1583,113740632,363000,338000,25000,0,0,0,0,0,0,25000
20200430,1339,昭輝,41.30,41.70,41.10,41.30,+0.60,1.47,537338,392,22222808,136000,109000,27000,0,0,0,0,0,0,27000
20200430,1340,勝悅-KY,10.45,10.70,10.10,10.10,-0.20,-1.94,769636,403,7945028,31000,85000,-54000,0,0,0,0,0,0,-54000
20200430,1341,富林-KY,60.10,60.40,58.90,60.00,+0.10,0.17,22005,19,1321395,7000,1000,6000,0,0,0,0,0,0,6000
20200430,1402,遠東新,25.60,26.20,25.60,26.00,+0.90,3.59,21055483,8937,546162959,5820000,2984414,2835586,1027000,0,1027000,59000,30000,29000,3891586
20200430,1409,新纖,10.85,11.00,10.75,11.00,+0.25,2.33,3518038,1145,38313252,1488000,299000,1189000,0,0,0,0,0,0,1189000
20200430,1410,南染,30.45,31.00,30.45,30.45,0.00,0.00,37191,23,1140430,9000,0,9000,0,0,0,0,0,0,9000
20200430,1413,宏洲,7.09,7.09,7.00,7.03,+0.11,1.59,44404,42,311759,11000,8000,3000,0,0,0,0,0,0,3000
20200430,1414,東和,6.30,6.48,6.27,6.40,+0.16,2.56,443629,154,2820790,78000,2000,76000,0,0,0,0,0,0,76000
20200430,1416,廣豐,10.65,11.05,10.50,10.85,+0.40,3.83,710470,216,7622918,49000,0,49000,0,0,0,0,0,0,49000
20200430,1417,嘉裕,7.96,8.03,7.95,8.00,+0.10,1.27,1516923,419,12117264,235000,7000,228000,0,0,0,0,0,0,228000
20200430,1418,東華,6.04,6.05,6.04,6.05,0.00,0.00,3001,4,18136,0,0,0,0,0,0,0,0,0,0
20200430,1419,新紡,40.15,41.20,40.00,41.15,+1.00,2.49,47987,50,1952167,43000,11000,32000,0,0,0,0,0,0,32000
20200430,1423,利華,10.80,10.80,10.70,10.75,-0.05,-0.46,48502,31,521341,5000,0,5000,0,0,0,0,0,0,5000
20200430,1432,大魯閣,5.04,5.07,4.99,5.05,+0.06,1.2,107272,79,540090,31000,0,31000,0,0,0,0,0,0,31000
20200430,1434,福懋,33.50,34.10,33.40,34.05,+0.80,2.41,3069549,1550,103871166,1388000,601000,787000,0,0,0,180000,0,180000,967000
20200430,1435,中福,8.24,8.49,8.23,8.35,+0.12,1.46,260003,134,2173174,54000,22000,32000,0,0,0,0,0,0,32000
20200430,1436,華友聯,37.80,37.90,37.45,37.75,+0.05,0.13,109636,111,4122488,45000,1000,44000,0,0,0,0,0,0,44000
20200430,1437,勤益控,20.70,21.00,20.65,20.85,+0.35,1.71,330331,167,6876917,73000,52000,21000,0,0,0,0,0,0,21000
20200430,1438,裕豐,11.05,11.40,10.85,11.40,+0.30,2.7,38056,15,420738,8000,0,8000,0,0,0,0,0,0,8000
20200430,1439,中和,37.60,37.70,36.80,36.80,-0.55,-1.47,2049135,1128,76041065,215000,82000,133000,0,0,0,0,0,0,133000
20200430,1440,南紡,8.90,9.15,8.88,9.15,+0.35,3.98,2911927,1008,26222827,1644000,386000,1258000,0,0,0,0,0,0,1258000
20200430,1441,大東,7.34,7.36,7.29,7.30,+0.07,0.97,267908,115,1963160,24000,2000,22000,0,0,0,0,0,0,22000
20200430,1442,名軒,17.00,17.40,17.00,17.40,+0.80,4.82,314796,168,5426039,70000,6000,64000,34000,0,34000,1000,0,1000,99000
20200430,1443,立益,8.61,8.80,8.60,8.75,+0.11,1.27,95071,35,828811,28000,4000,24000,0,0,0,0,0,0,24000
20200430,1444,力麗,7.05,7.15,7.05,7.14,+0.11,1.56,2013607,775,14300784,622000,542000,80000,0,0,0,0,0,0,80000
20200430,1445,大宇,7.98,8.39,7.98,8.27,+0.39,4.95,830682,246,6858023,33000,12000,21000,0,0,0,0,0,0,21000
20200430,1446,宏和,28.60,28.85,28.40,28.60,+0.25,0.88,119200,92,3416799,42000,10000,32000,0,0,0,0,0,0,32000
20200430,1447,力鵬,6.08,6.15,6.07,6.11,+0.04,0.66,880924,370,5380581,355000,148000,207000,0,0,0,0,0,0,207000
20200430,1449,佳和,12.75,13.15,12.75,13.05,+0.35,2.76,1191226,406,15493535,159000,18000,141000,0,0,0,0,0,0,141000
20200430,1451,年興,15.95,16.10,15.90,15.95,+0.10,0.63,262941,140,4200551,33000,18000,15000,0,0,0,4000,0,4000,19000
20200430,1452,宏益,17.05,17.35,17.05,17.30,+0.25,1.47,243800,140,4193808,109000,23000,86000,0,0,0,0,0,0,86000
20200430,1453,大將,6.98,7.13,6.98,7.07,+0.11,1.58,95279,42,669193,28000,0,28000,0,0,0,0,0,0,28000
20200430,1454,台富,7.90,8.00,7.85,7.96,+0.16,2.05,118121,59,934620,22000,2000,20000,0,0,0,0,0,0,20000
20200430,1455,集盛,7.73,7.73,7.65,7.68,-0.01,-0.13,1836340,543,14103412,733000,119000,614000,0,0,0,0,0,0,614000
20200430,1456,怡華,8.12,8.29,8.12,8.29,+0.15,1.84,62318,30,513491,13000,1000,12000,0,0,0,0,0,0,12000
20200430,1457,宜進,11.70,11.80,11.60,11.75,+0.10,0.86,743716,297,8693687,144000,68000,76000,0,0,0,0,0,0,76000
20200430,1459,聯發,6.58,6.93,6.56,6.91,+0.32,4.86,260260,111,1777945,73000,1000,72000,0,0,0,0,0,0,72000
20200430,1460,宏遠,7.52,7.75,7.40,7.59,+0.20,2.71,1472307,596,11189937,296000,173000,123000,0,0,0,0,0,0,123000
20200430,1463,強盛,11.45,11.50,11.35,11.45,+0.05,0.44,223000,107,2551850,32000,2000,30000,0,0,0,0,0,0,30000
20200430,1464,得力,20.80,21.30,20.80,21.30,+0.85,4.16,2207717,1024,46517942,360000,100000,260000,15000,0,15000,15000,0,15000,290000
20200430,1465,偉全,16.20,16.20,16.00,16.05,+0.05,0.31,473380,207,7605680,17000,0,17000,0,0,0,0,0,0,17000
20200430,1466,聚隆,8.30,8.30,8.03,8.22,-0.08,-0.96,26002,21,212366,13000,1000,12000,0,0,0,0,0,0,12000
20200430,1467,南緯,10.65,10.80,10.40,10.75,-0.05,-0.46,1272129,420,13487676,43000,50000,-7000,0,0,0,0,0,0,-7000
20200430,1468,昶和,10.00,10.00,9.93,10.00,0.00,0.00,20020,19,199524,14000,10000,4000,0,0,0,0,0,0,4000
20200430,1470,大統新創,19.40,19.50,19.40,19.50,+0.20,1.04,6000,6,116500,5000,3000,2000,0,0,0,0,0,0,2000
20200430,1471,首利,2.00,2.07,1.96,2.07,+0.06,2.99,61611,24,121973,0,0,0,0,0,0,0,0,0,0
20200430,1472,三洋紡,14.00,14.45,13.35,13.35,-0.55,-3.96,1172187,571,16107341,26000,9000,17000,0,0,0,0,0,0,17000
20200430,1473,台南,20.60,20.85,20.55,20.80,+0.40,1.96,445100,262,9210219,176000,15000,161000,0,0,0,0,0,0,161000
20200430,1474,弘裕,10.40,10.40,9.82,9.95,-0.05,-0.5,2270227,849,23052850,26000,120000,-94000,0,0,0,0,0,0,-94000
20200430,1475,本盟,15.60,15.60,15.60,15.60,+1.40,9.86,77255,34,1205112,0,2000,-2000,0,0,0,0,0,0,-2000
20200430,1476,儒鴻,291.50,300.00,291.50,300.00,+12.00,4.17,2195506,1774,650475542,887000,373607,513393,42000,0,42000,23000,33000,-10000,545393
20200430,1477,聚陽,125.00,128.00,124.50,127.50,+3.50,2.82,2618745,1993,330880860,677000,465850,211150,1000,0,1000,65000,50000,15000,227150
20200430,1503,士電,41.85,42.55,41.85,42.30,+0.45,1.08,201613,153,8530016,144000,17000,127000,0,0,0,0,15000,-15000,112000
20200430,1504,東元,26.85,27.10,26.80,26.85,+0.15,0.56,4849015,1214,130492694,3149000,2899000,250000,8000,0,8000,14000,9000,5000,263000
20200430,1506,正道,11.75,13.00,11.75,13.00,-0.05,-0.38,5497924,2750,65828412,87000,4000,83000,0,0,0,0,14000,-14000,69000
20200430,1507,永大,58.90,61.00,58.50,60.00,+1.10,1.87,199594,186,11956399,140000,101000,39000,0,0,0,0,17000,-17000,22000
20200430,1512,瑞利,3.23,3.32,3.23,3.32,+0.02,0.61,50108,21,165668,0,0,0,0,0,0,0,0,0,0
20200430,1513,中興電,25.10,25.80,24.95,25.30,+0.30,1.2,3987854,1743,100375120,325000,140000,185000,8000,0,8000,0,0,0,193000
20200430,1514,亞力,19.35,19.55,19.30,19.50,+0.30,1.56,2546615,868,49420479,295000,260000,35000,0,0,0,0,0,0,35000
20200430,1515,力山,74.60,77.50,72.10,72.20,-0.80,-1.1,15066190,9452,1121056011,730000,1842000,-1112000,350000,0,350000,86000,256000,-170000,-932000
20200430,1516,川飛,13.70,13.80,13.40,13.55,0.00,0.00,277795,95,3776680,2000,1000,1000,0,0,0,0,0,0,1000
20200430,1517,利奇,7.35,7.49,7.35,7.42,+0.10,1.37,278066,133,2058588,48000,7000,41000,0,0,0,0,0,0,41000
20200430,1519,華城,25.90,27.10,25.75,26.60,+1.05,4.11,1654793,731,43945622,167000,113000,54000,0,0,0,0,3000,-3000,51000
20200430,1521,大億,57.60,58.30,57.60,58.20,+0.80,1.39,117090,78,6792655,24000,8000,16000,0,0,0,0,0,0,16000
20200430,1522,堤維西,24.50,24.65,24.20,24.35,+0.20,0.83,1232056,630,30043326,426000,88000,338000,7000,0,7000,0,2000,-2000,343000
20200430,1524,耿鼎,8.78,8.95,8.70,8.95,+0.26,2.99,710695,369,6282524,87000,23000,64000,0,0,0,0,0,0,64000
20200430,1525,江申,43.40,45.90,43.40,45.25,+2.40,5.6,119000,105,5264900,22000,0,22000,0,15000,-15000,0,2000,-2000,5000
20200430,1526,日馳,19.80,19.80,18.85,19.05,0.00,0.00,969407,397,18605201,109000,57000,52000,0,0,0,0,0,0,52000
20200430,1527,鑽全,41.65,42.50,41.60,42.50,+1.05,2.53,898858,616,37777360,356000,214000,142000,8000,0,8000,0,0,0,150000
20200430,1528,恩德,8.20,8.20,8.00,8.02,-0.12,-1.47,554401,227,4464307,80000,10000,70000,0,0,0,0,0,0,70000
20200430,1529,樂士,13.45,13.85,13.45,13.75,+0.05,0.36,49001,39,671713,12000,10000,2000,0,0,0,3000,3000,0,2000
20200430,1530,亞崴,29.95,30.50,29.95,30.40,+0.50,1.67,103650,68,3140295,19000,0,19000,0,0,0,0,0,0,19000
20200430,1531,高林股,12.60,12.80,12.50,12.80,+0.20,1.59,122707,62,1561891,26000,29000,-3000,0,0,0,0,0,0,-3000
20200430,1532,勤美,25.00,25.60,25.00,25.30,+0.40,1.61,549620,347,13913843,247000,82000,165000,0,0,0,0,0,0,165000
20200430,1533,車王電,26.80,27.30,26.80,27.15,+0.40,1.5,116306,97,3152155,26000,15000,11000,0,0,0,0,0,0,11000
20200430,1535,中宇,31.90,32.75,31.80,32.60,+0.20,0.62,30003,28,970996,14000,2000,12000,0,0,0,0,0,0,12000
20200430,1536,和大,89.50,95.40,89.50,95.40,+8.60,9.91,8521708,5546,794351433,1561000,1030085,530915,0,0,0,279000,47000,232000,762915
20200430,1537,廣隆,144.00,146.00,143.50,145.50,+2.00,1.39,223418,185,32365734,68000,16000,52000,4000,0,4000,0,0,0,56000
20200430,1538,正峰新,2.40,2.40,2.40,2.40,-0.21,-8.05,2010,7,4821,0,0,0,0,0,0,0,0,0,0
20200430,1539,巨庭,15.45,15.50,15.25,15.50,+0.30,1.97,58000,48,891650,11000,0,11000,0,0,0,0,0,0,11000
20200430,1540,喬福,16.00,16.00,15.90,16.00,+0.20,1.27,240540,113,3838034,50000,4000,46000,0,0,0,0,0,0,46000
20200430,1541,錩泰,31.70,32.40,31.65,32.05,+0.45,1.42,43000,37,1370300,9000,4000,5000,0,0,0,0,0,0,5000
20200430,1558,伸興,129.00,130.50,129.00,130.50,+1.50,1.16,102802,108,13379657,20000,6000,14000,0,0,0,0,0,0,14000
20200430,1560,中砂,57.50,59.00,57.40,58.90,+1.70,2.97,1008837,616,58957898,245000,17000,228000,29000,0,29000,0,20000,-20000,237000
20200430,1568,倉佑,15.00,15.30,14.90,15.00,+0.05,0.33,111185,83,1668573,15000,2000,13000,0,0,0,0,0,0,13000
20200430,1582,信錦,79.20,79.20,78.30,78.40,+0.30,0.38,625633,466,49147322,97000,124000,-27000,1000,0,1000,13000,10000,3000,-23000
20200430,1583,程泰,62.00,62.00,61.10,61.50,+0.10,0.16,9311,10,572433,7000,0,7000,0,0,0,0,0,0,7000
20200430,1587,吉茂,13.45,13.45,13.15,13.45,+0.05,0.37,16187,17,215136,5000,1000,4000,0,0,0,0,0,0,4000
20200430,1589,永冠-KY,62.50,63.20,61.90,61.90,-0.20,-0.32,546300,393,34139570,222000,52000,170000,0,0,0,0,3000,-3000,167000
20200430,1590,亞德客-KY,552.00,590.00,535.00,579.00,+41.00,7.62,4193265,3214,2357310970,2791200,2090296,700904,76000,0,76000,73000,59000,14000,790904
20200430,1592,英瑞-KY,12.20,12.50,11.85,12.15,+0.10,0.83,1747719,654,21076428,64000,232000,-168000,0,0,0,0,0,0,-168000
20200430,1598,岱宇,37.00,37.75,36.95,37.50,+0.60,1.63,985034,539,36770625,250000,89000,161000,0,0,0,3000,0,3000,164000
20200430,1603,華電,28.15,28.15,27.50,27.75,-0.35,-1.25,118150,75,3265569,41000,13000,28000,0,0,0,0,0,0,28000
20200430,1604,聲寶,20.45,20.45,19.20,19.30,+0.50,2.66,1846277,856,36075157,157000,397000,-240000,13000,0,13000,0,0,0,-227000
20200430,1605,華新,13.05,13.40,13.00,13.15,+0.20,1.54,12481046,3138,165056898,4917000,3078000,1839000,0,0,0,226000,1450000,-1224000,615000
20200430,1608,華榮,9.65,9.75,9.65,9.71,+0.09,0.94,934099,403,9071348,322000,11000,311000,0,0,0,0,0,0,311000
20200430,1609,大亞,9.81,9.92,9.78,9.85,+0.14,1.44,3436027,992,33819555,980000,353000,627000,0,0,0,0,0,0,627000
20200430,1611,中電,12.80,13.00,12.60,12.90,+0.15,1.18,2769987,824,35605768,1097000,29000,1068000,0,0,0,0,0,0,1068000
20200430,1612,宏泰,10.45,10.60,10.40,10.55,+0.15,1.44,656359,217,6871718,188000,9000,179000,0,0,0,0,0,0,179000
20200430,1614,三洋電,30.80,30.80,30.50,30.75,+0.20,0.65,161031,113,4939148,60000,26000,34000,0,0,0,0,0,0,34000
20200430,1615,大山,21.30,21.30,20.75,20.85,0.00,0.00,467366,233,9788526,40000,8000,32000,0,0,0,0,0,0,32000
20200430,1616,億泰,4.12,4.22,4.12,4.20,+0.09,2.19,51000,35,212620,25000,1000,24000,0,0,0,0,0,0,24000
20200430,1617,榮星,10.50,11.15,10.35,11.10,+0.80,7.77,97603,54,1025711,29000,0,29000,0,0,0,0,0,0,29000
20200430,1618,合機,7.64,7.73,7.60,7.70,+0.13,1.72,131000,76,1004170,66000,0,66000,0,0,0,0,5000,-5000,61000
20200430,1626,艾美特-KY,26.50,26.70,26.15,26.40,0.00,0.00,267036,127,7060252,95000,30036,64964,0,0,0,0,0,0,64964
20200430,1701,中化,21.95,22.10,21.15,21.20,+0.90,4.43,9130192,4171,196744348,558000,1691000,-1133000,0,0,0,0,4000,-4000,-1137000
20200430,1702,南僑,45.00,45.30,44.35,45.30,+1.10,2.49,357909,282,16060465,160000,57000,103000,4000,0,4000,0,0,0,107000
20200430,1707,葡萄王,196.50,198.00,196.00,198.00,+2.00,1.02,478282,416,94376336,246000,63000,183000,1000,26000,-25000,1000,13000,-12000,146000
20200430,1708,東鹼,23.80,24.45,23.80,24.30,+0.55,2.32,1309131,407,31684723,117000,50000,67000,0,0,0,0,378000,-378000,-311000
20200430,1709,和益,12.75,12.80,12.65,12.70,+0.10,0.79,854092,393,10844460,298000,41000,257000,0,0,0,0,0,0,257000
20200430,1710,東聯,16.50,16.95,16.50,16.90,+0.50,3.05,2612396,949,43813526,703000,174000,529000,0,0,0,0,128000,-128000,401000
20200430,1711,永光,14.00,14.20,13.95,14.10,+0.30,2.17,1374311,572,19364004,543000,48000,495000,0,0,0,0,0,0,495000
20200430,1712,興農,18.85,18.95,18.80,18.85,+0.10,0.53,1324751,527,24987642,155000,175000,-20000,5000,0,5000,42000,7000,35000,20000
20200430,1713,國化,17.90,17.90,17.75,17.80,+0.15,0.85,82029,37,1459612,19000,0,19000,0,0,0,0,0,0,19000
20200430,1714,和桐,7.52,7.55,7.36,7.41,-0.04,-0.54,4690367,1548,34914937,1454000,779000,675000,0,0,0,0,0,0,675000
20200430,1717,長興,27.15,27.25,26.70,26.75,-0.40,-1.47,1796210,1087,48282452,574000,425246,148754,0,0,0,0,15000,-15000,133754
20200430,1718,中纖,6.49,6.57,6.45,6.51,+0.09,1.4,4645241,1267,30298391,1044000,600000,444000,0,0,0,3000,20000,-17000,427000
20200430,1720,生達,37.40,39.05,37.20,38.95,+1.90,5.13,8477139,4878,324868130,461000,530000,-69000,0,0,0,0,11000,-11000,-80000
20200430,1721,三晃,10.10,10.10,9.95,10.10,+0.10,1.0,207588,96,2081150,57000,0,57000,0,0,0,0,0,0,57000
20200430,1722,台肥,46.00,46.40,46.00,46.10,+0.25,0.55,3048051,1629,140935948,1005000,1091000,-86000,3000,0,3000,197000,14000,183000,100000
20200430,1723,中碳,101.50,105.00,101.50,105.00,+4.50,4.48,1009414,768,104305470,285000,453000,-168000,0,0,0,0,2000,-2000,-170000
20200430,1724,台硝,11.90,12.00,11.80,12.00,+0.20,1.69,37251,31,443636,14000,0,14000,0,0,0,0,0,0,14000
20200430,1725,元禎,13.90,14.35,13.90,14.25,+0.20,1.42,30405,32,430091,19000,10000,9000,0,0,0,0,0,0,9000
20200430,1726,永記,67.70,69.30,67.70,68.60,+0.30,0.44,37001,33,2548068,24000,9000,15000,0,0,0,0,0,0,15000
20200430,1727,中華化,9.62,9.83,9.62,9.75,+0.13,1.35,101500,71,991765,19000,0,19000,0,0,0,0,0,0,19000
20200430,1730,花仙子,64.50,65.20,64.50,64.80,+0.60,0.93,372685,316,24178328,117000,88000,29000,0,0,0,0,0,0,29000
20200430,1731,美吾華,13.10,13.10,12.85,13.05,+0.05,0.38,889554,337,11523727,66000,58000,8000,0,0,0,0,0,0,8000
20200430,1732,毛寶,29.60,30.85,29.40,29.85,+0.25,0.84,5717441,2877,171526447,165000,160000,5000,0,0,0,7000,7000,0,5000
20200430,1733,五鼎,23.35,23.60,23.25,23.45,+0.20,0.86,496501,238,11600572,111000,9000,102000,0,0,0,2000,1000,1000,103000
20200430,1734,杏輝,19.35,19.55,19.25,19.55,+0.35,1.82,776233,385,15052510,155000,48000,107000,0,0,0,0,0,0,107000
20200430,1735,日勝化,16.35,17.00,16.35,17.00,+0.60,3.66,28050,18,463750,8000,0,8000,0,0,0,0,0,0,8000
20200430,1736,喬山,62.60,66.50,61.80,65.70,+3.70,5.97,5502823,3766,355320418,799000,683000,116000,162000,0,162000,328000,34000,294000,572000
20200430,1737,臺鹽,31.05,31.30,31.05,31.15,+0.15,0.48,346191,172,10797471,74000,31000,43000,0,0,0,0,0,0,43000
20200430,1760,寶齡富錦,121.50,123.50,117.50,120.00,0.00,0.00,8139008,5372,979226953,322000,654000,-332000,20000,0,20000,0,0,0,-312000
20200430,1762,中化生,50.80,50.80,49.35,50.80,+4.55,9.84,12319216,3445,625573514,144000,208000,-64000,215000,0,215000,0,15000,-15000,136000
20200430,1773,勝一,95.60,95.90,95.10,95.30,+0.30,0.32,332631,254,31731646,94000,52000,42000,1000,0,1000,7000,0,7000,50000
20200430,1776,展宇,17.10,17.10,16.95,17.00,0.00,0.00,19100,16,324914,3000,0,3000,0,0,0,0,0,0,3000
20200430,1783,和康生,28.70,28.70,27.50,27.80,+1.55,5.9,3644036,2001,102286295,101000,129000,-28000,0,0,0,0,0,0,-28000
20200430,1786,科妍,61.80,63.00,61.80,62.50,+0.50,0.81,598800,407,37396097,140000,19000,121000,0,0,0,0,0,0,121000
20200430,1789,神隆,29.40,29.45,28.95,28.95,+0.20,0.7,2155222,1264,62734439,402000,232000,170000,0,0,0,5000,8000,-3000,167000
20200430,1795,美時,73.90,77.60,72.60,74.90,+2.10,2.88,6336236,4392,477192900,416000,1116000,-700000,0,0,0,0,0,0,-700000
20200430,1802,台玻,8.96,8.99,8.90,8.96,+0.10,1.13,2415750,980,21597533,1514000,451996,1062004,0,0,0,0,0,0,1062004
20200430,1805,寶徠,8.77,8.78,8.36,8.58,-0.20,-2.28,41040,34,348714,8000,4000,4000,0,0,0,0,0,0,4000
20200430,1806,冠軍,4.81,4.94,4.77,4.94,+0.14,2.92,590666,221,2881356,95000,0,95000,0,0,0,0,0,0,95000
20200430,1808,潤隆,58.50,59.30,58.50,59.20,+0.90,1.54,280222,240,16532640,216000,87000,129000,0,0,0,0,0,0,129000
20200430,1809,中釉,8.88,8.99,8.81,8.94,+0.19,2.17,639641,263,5694175,177000,107000,70000,0,0,0,0,0,0,70000
20200430,1810,和成,7.34,7.50,7.30,7.42,+0.12,1.64,369591,149,2732082,118000,2000,116000,0,0,0,0,0,0,116000
20200430,1817,凱撒衛,29.25,29.50,29.25,29.40,+0.30,1.03,142400,109,4181670,22000,16000,6000,0,0,0,0,0,0,6000
20200430,1902,台紙,20.60,20.65,20.60,20.60,0.00,0.00,1181872,276,24352397,367000,0,367000,0,0,0,0,0,0,367000
20200430,1903,士紙,39.80,40.70,38.90,39.45,-0.45,-1.13,426515,249,16827515,61000,25000,36000,0,0,0,0,0,0,36000
20200430,1904,正隆,21.05,21.20,21.00,21.20,+0.15,0.71,3000057,1139,63348335,1253000,391000,862000,184000,0,184000,2000,31000,-29000,1017000
20200430,1905,華紙,7.49,7.64,7.45,7.62,+0.20,2.7,1865864,619,14096474,544000,94000,450000,0,0,0,0,0,0,450000
20200430,1906,寶隆,12.30,12.50,12.25,12.40,+0.15,1.22,276100,149,3411670,84000,15000,69000,0,0,0,0,0,0,69000
20200430,1907,永豐餘,12.70,12.80,12.60,12.80,+0.20,1.59,2818910,1194,35887600,1421000,486000,935000,55000,0,55000,8000,0,8000,998000
20200430,1909,榮成,13.20,13.50,13.20,13.40,+0.25,1.9,7356753,1829,98464793,4114000,651000,3463000,8000,0,8000,94000,2000,92000,3563000
20200430,2002,中鋼,19.95,20.10,19.85,20.00,+0.15,0.76,37550070,10457,750255964,20178000,10268323,9909677,64000,0,64000,1304000,3000,1301000,11274677
20200430,2002A,中鋼特,53.50,53.50,53.30,53.50,0.00,0.00,10010,11,534658,0,0,0,0,0,0,1000,1000,0,0
20200430,2006,東和鋼鐵,22.85,23.25,22.85,23.10,+0.30,1.32,2093660,1000,48222130,884000,448000,436000,4000,0,4000,0,22000,-22000,418000
20200430,2007,燁興,3.91,3.96,3.91,3.94,+0.02,0.51,90731,55,358672,56000,10000,46000,0,0,0,0,0,0,46000
20200430,2008,高興昌,12.40,12.70,12.40,12.70,+0.25,2.01,18638,8,231975,14000,1000,13000,0,0,0,0,0,0,13000
20200430,2009,第一銅,7.38,7.60,7.38,7.53,+0.20,2.73,299966,161,2250263,96000,11000,85000,0,0,0,0,0,0,85000
20200430,2010,春源,9.37,9.47,9.36,9.45,+0.11,1.18,670477,244,6307929,213000,142000,71000,0,0,0,0,0,0,71000
20200430,2012,春雨,17.20,17.30,17.15,17.30,+0.25,1.47,262319,114,4524386,67000,39000,28000,0,0,0,0,0,0,28000
20200430,2013,中鋼構,21.40,21.40,21.15,21.40,+0.30,1.42,285290,181,6082175,77000,7000,70000,0,0,0,0,0,0,70000
20200430,2014,中鴻,7.70,7.85,7.62,7.83,+0.36,4.82,5970423,1648,46326018,1267000,500000,767000,0,0,0,0,0,0,767000
20200430,2015,豐興,51.60,52.50,51.60,52.20,+0.60,1.16,773479,492,40376208,426000,358000,68000,57000,0,57000,0,15000,-15000,110000
20200430,2017,官田鋼,6.35,6.44,6.35,6.40,+0.05,0.79,288576,128,1845690,83000,0,83000,0,0,0,0,0,0,83000
20200430,2020,美亞,17.75,18.00,17.55,17.80,+1.35,8.21,5730572,1811,101912919,335000,91000,244000,0,0,0,0,0,0,244000
20200430,2022,聚亨,4.12,4.14,4.10,4.13,+0.05,1.23,364988,134,1502307,132000,7000,125000,0,0,0,0,0,0,125000
20200430,2023,燁輝,9.00,9.00,8.86,8.93,+0.02,0.22,1378120,690,12335248,765000,484000,281000,0,0,0,0,0,0,281000
20200430,2024,志聯,12.25,12.30,12.10,12.20,0.00,0.00,13003,12,158886,2000,0,2000,0,0,0,0,0,0,2000
20200430,2025,千興,1.50,1.65,1.50,1.65,+0.15,10.0,298002,37,482142,0,0,0,0,0,0,0,0,0,0
20200430,2027,大成鋼,26.60,26.80,26.40,26.65,+0.35,1.33,6970028,2761,185479985,2095000,754148,1340852,0,0,0,302000,846000,-544000,796852
20200430,2028,威致,9.50,9.65,9.40,9.63,+0.07,0.73,175877,70,1687675,52000,12000,40000,0,0,0,0,0,0,40000
20200430,2029,盛餘,15.90,16.20,15.75,16.20,+0.45,2.86,268642,155,4299728,79000,65000,14000,0,0,0,0,0,0,14000
20200430,2030,彰源,10.30,10.50,10.30,10.50,+0.25,2.44,883575,323,9197428,119000,51000,68000,0,0,0,0,0,0,68000
20200430,2031,新光鋼,23.95,24.50,23.70,24.00,+0.70,3.0,1181648,625,28369813,279000,113000,166000,2000,100000,-98000,0,0,0,68000
20200430,2032,新鋼,8.30,8.39,8.30,8.36,+0.08,0.97,174010,72,1452920,32000,2000,30000,0,0,0,0,0,0,30000
20200430,2033,佳大,9.00,9.35,8.91,9.34,+0.46,5.18,252203,103,2315884,29000,5000,24000,0,0,0,0,4000,-4000,20000
20200430,2034,允強,23.65,24.10,23.50,23.90,+0.40,1.7,1044206,492,24818636,452000,70000,382000,0,0,0,0,0,0,382000
20200430,2038,海光,5.59,5.98,5.55,5.93,+0.38,6.85,403150,174,2279914,41000,0,41000,0,0,0,0,0,0,41000
20200430,2049,上銀,274.00,293.00,272.00,288.00,+18.00,6.67,6734888,5504,1905566856,2518200,1693414,824786,52000,0,52000,345000,182000,163000,1039786
20200430,2059,川湖,315.50,318.50,310.50,310.50,-4.00,-1.27,597299,555,186962185,116000,276000,-160000,2000,0,2000,0,3000,-3000,-161000
20200430,2062,橋椿,21.30,21.60,21.25,21.45,+0.15,0.7,460050,265,9854627,69000,31000,38000,0,0,0,0,0,0,38000
20200430,2069,運錩,15.65,15.90,15.60,15.90,+0.30,1.92,99000,59,1557550,36000,3000,33000,0,0,0,0,0,0,33000
20200430,2101,南港,41.30,41.65,39.80,40.30,-0.70,-1.71,13377292,3329,538815662,2234000,1418000,816000,0,0,0,136000,202000,-66000,750000
20200430,2102,泰豐,16.80,17.05,16.45,16.45,-0.30,-1.79,6127930,2014,102190087,1405000,758000,647000,0,0,0,0,0,0,647000
20200430,2103,台橡,16.35,16.40,16.25,16.25,0.00,0.00,5203663,1437,84916894,994000,2206000,-1212000,0,0,0,0,4000,-4000,-1216000
20200430,2104,國際中橡,21.45,21.50,21.05,21.10,-0.15,-0.71,6944597,2750,147582170,1846000,1427500,418500,2000,0,2000,0,69000,-69000,351500
20200430,2105,正新,34.55,34.95,34.35,34.55,+0.05,0.14,9959821,4386,345458451,3987000,5604050,-1617050,2505000,0,2505000,76000,41000,35000,922950
20200430,2106,建大,25.80,26.65,25.70,26.55,+0.75,2.91,4132948,1222,109009715,1258000,1551143,-293143,885000,0,885000,0,30000,-30000,561857
20200430,2107,厚生,17.95,18.00,17.90,18.00,+0.15,0.84,1202232,484,21592506,310000,31000,279000,35000,0,35000,2000,0,2000,316000
20200430,2108,南帝,30.20,30.40,29.80,30.25,+0.65,2.2,1570069,639,47202418,385000,158000,227000,12000,0,12000,9000,3000,6000,245000
20200430,2109,華豐,12.30,12.60,12.20,12.20,+0.05,0.41,553005,237,6865910,170000,3000,167000,0,0,0,0,0,0,167000
20200430,2114,鑫永銓,79.30,80.20,79.30,79.90,+0.90,1.14,226925,170,18105500,60000,1000,59000,0,0,0,0,0,0,59000
20200430,2115,六暉-KY,38.70,39.20,38.35,38.50,+0.50,1.32,48200,47,1864279,11000,0,11000,0,0,0,0,0,0,11000
20200430,2201,裕隆,17.75,17.85,17.35,17.40,-0.15,-0.85,6065290,2155,106151148,1535000,1161000,374000,0,0,0,0,40000,-40000,334000
20200430,2204,中華,31.55,32.05,31.55,31.95,+0.45,1.43,1063968,616,33817724,519000,129600,389400,0,0,0,0,48000,-48000,341400
20200430,2206,三陽工業,19.75,19.90,19.75,19.80,+0.10,0.51,758962,442,15034546,414000,280000,134000,0,0,0,0,0,0,134000
20200430,2207,和泰車,555.00,575.00,549.00,557.00,+14.00,2.58,946704,887,530433832,356000,449438,-93438,3000,30000,-27000,3000,8000,-5000,-125438
20200430,2208,台船,22.00,22.00,21.50,22.00,+0.30,1.38,1393873,673,30426823,423000,70000,353000,0,0,0,0,0,0,353000
20200430,2227,裕日車,268.00,275.00,268.00,269.50,+8.50,3.26,954816,879,258487717,131000,31000,100000,4000,0,4000,2000,21000,-19000,85000
20200430,2228,劍麟,90.10,94.20,89.80,92.50,+3.30,3.7,1957092,1476,180106866,279000,228000,51000,0,0,0,15000,0,15000,66000
20200430,2231,為升,143.00,147.00,142.50,144.50,+3.00,2.12,2617778,1814,379956088,346000,158467,187533,2000,0,2000,10000,2000,8000,197533
20200430,2233,宇隆,57.60,60.50,57.60,59.10,+2.10,3.68,1029687,757,61062098,68000,92000,-24000,0,0,0,50000,10000,40000,16000
20200430,2236,百達-KY,17.50,17.80,17.25,17.35,-0.05,-0.29,71000,60,1236800,6000,0,6000,0,0,0,0,0,0,6000
20200430,2239,英利-KY,62.10,64.10,61.80,63.50,+2.10,3.42,310139,270,19605807,67000,25000,42000,0,0,0,0,0,0,42000
20200430,2243,宏旭-KY,10.40,10.75,10.30,10.70,+0.45,4.39,36000,29,379050,4000,1000,3000,0,0,0,0,0,0,3000
20200430,2301,光寶科,46.15,46.65,45.95,46.50,+1.10,2.42,15302104,5441,709594361,6234000,7917000,-1683000,789000,0,789000,325000,522135,-197135,-1091135
20200430,2302,麗正,7.45,7.46,7.33,7.45,0.00,0.00,139714,82,1035122,40000,0,40000,0,0,0,0,0,0,40000
20200430,2303,聯電,15.45,15.60,15.35,15.55,+0.25,1.63,64768656,11380,1003539346,35158000,16787420,18370580,951000,0,951000,200000,2243000,-2043000,17278580
20200430,2305,全友,5.13,5.25,5.08,5.25,+0.17,3.35,443944,172,2292755,75000,7000,68000,0,0,0,0,20000,-20000,48000
20200430,2308,台達電,139.00,143.00,138.50,140.00,+2.00,1.45,15700190,6657,2211724100,9190200,5077300,4112900,12000,665000,-653000,911000,93000,818000,4277900
20200430,2312,金寶,12.95,13.05,12.65,13.05,+0.10,0.77,26978008,6649,347708690,1307000,2875000,-1568000,16000,0,16000,56000,277000,-221000,-1773000
20200430,2313,華通,38.05,40.00,38.05,39.95,+2.40,6.39,63244865,26035,2483643928,6400000,5921000,479000,8088000,0,8088000,4549000,1483000,3066000,11633000
20200430,2314,台揚,21.30,21.60,21.10,21.25,-0.05,-0.23,2744512,1306,58450473,496000,262000,234000,0,0,0,0,1000,-1000,233000
20200430,2316,楠梓電,30.25,31.20,30.25,30.70,+0.65,2.16,3743479,1695,114817103,1163000,808000,355000,0,0,0,35000,61000,-26000,329000
20200430,2317,鴻海,76.20,77.00,76.00,77.00,+1.40,1.85,50247112,21023,3846340874,24599012,14545769,10053243,80000,0,80000,1387000,909000,478000,10611243
20200430,2321,東訊,1.38,1.38,1.38,1.38,0.00,0.00,2136,6,2945,0,0,0,0,0,0,0,0,0,0
20200430,2323,中環,7.79,7.98,7.75,7.88,+0.18,2.34,17104458,3447,134912236,4128000,2184000,1944000,0,7000,-7000,601000,292000,309000,2246000
20200430,2324,仁寶,19.10,19.15,18.95,19.10,0.00,0.00,23493369,5414,447740226,15876000,15119127,756873,0,0,0,50000,840000,-790000,-33127
20200430,2327,國巨,390.00,395.00,385.00,391.00,+11.00,2.89,26927142,19420,10509493531,2430000,5540805,-3110805,572000,0,572000,656000,307000,349000,-2189805
20200430,2328,廣宇,18.90,19.20,18.90,19.05,+0.25,1.33,2900234,1152,55257396,665000,600000,65000,16000,0,16000,2000,0,2000,83000
20200430,2329,華泰,12.45,12.55,12.25,12.35,+0.10,0.82,7250143,2091,89675396,989000,673000,316000,26000,0,26000,1000,4000,-3000,339000
20200430,2330,台積電,302.00,305.00,301.50,304.50,+5.50,1.84,58439085,26219,17753466901,39217594,25511135,13706459,1868000,65000,1803000,1112000,484000,628000,16137459
20200430,2331,精英,10.70,11.05,10.65,10.90,+0.30,2.83,829878,406,9014228,197000,167000,30000,0,0,0,37000,8000,29000,59000
20200430,2332,友訊,12.35,12.60,12.20,12.20,-0.10,-0.81,9821792,2108,121522201,724000,1876000,-1152000,0,0,0,501000,264000,237000,-915000
20200430,2337,旺宏,36.65,37.00,36.00,36.10,+0.95,2.7,143263270,54191,5218005458,14046000,7043200,7002800,8655000,14000,8641000,2097000,4382000,-2285000,13358800
20200430,2338,光罩,29.80,30.20,29.40,29.80,+0.30,1.02,8691402,3934,259360084,1485000,366000,1119000,13000,0,13000,195000,86000,109000,1241000
20200430,2340,光磊,21.45,21.75,21.35,21.55,+0.25,1.17,1297441,686,27950377,364000,130000,234000,5000,0,5000,65000,6000,59000,298000
20200430,2342,茂矽,25.10,25.45,24.50,24.55,-0.05,-0.2,6046342,2828,150692373,533000,765000,-232000,0,0,0,0,0,0,-232000
20200430,2344,華邦電,13.80,14.00,13.65,14.00,+0.50,3.7,52938061,12448,734047254,18748000,7839329,10908671,10000,0,10000,1330000,362000,968000,11886671
20200430,2345,智邦,220.00,226.00,216.00,217.50,-6.00,-2.68,8799430,6056,1926727451,2634000,3038000,-404000,7000,210000,-203000,109000,246000,-137000,-744000
20200430,2347,聯強,39.95,40.15,39.75,39.90,+0.15,0.38,4947868,2267,197410615,2658000,1078500,1579500,123000,0,123000,74000,408000,-334000,1368500
20200430,2348,海悅,54.70,55.60,54.50,55.40,+1.10,2.03,403277,252,22207432,64000,21000,43000,0,0,0,0,2000,-2000,41000
20200430,2349,錸德,5.05,5.08,5.02,5.04,+0.05,1.0,5678538,1287,28681250,1576000,1056000,520000,0,6000,-6000,0,0,0,514000
20200430,2351,順德,46.15,48.90,46.00,48.50,+2.90,6.36,935000,654,44535750,160000,107000,53000,0,0,0,4000,4000,0,53000
20200430,2352,佳世達,16.80,17.10,16.80,16.95,+0.30,1.8,10351451,2397,175623329,1844000,2507000,-663000,28000,0,28000,10000,67000,-57000,-692000
20200430,2353,宏碁,16.70,16.90,16.40,16.65,+0.10,0.6,18857440,5264,313144530,4890000,6311144,-1421144,7000,0,7000,259000,506000,-247000,-1661144
20200430,2354,鴻準,57.40,58.50,57.20,57.60,+2.70,4.92,15348371,8061,887711937,1858000,3432098,-1574098,3000,0,3000,51000,13000,38000,-1533098
20200430,2355,敬鵬,25.55,25.80,25.35,25.80,+0.55,2.18,1359263,668,34877560,366000,117000,249000,0,0,0,1000,23000,-22000,227000
20200430,2356,英業達,23.55,23.55,23.30,23.50,+0.15,0.64,10747245,3855,252361374,6634000,7522000,-888000,0,0,0,128000,689000,-561000,-1449000
20200430,2357,華碩,203.00,203.50,200.00,202.50,0.00,0.00,3246172,1903,655227820,1826000,2419000,-593000,5000,25000,-20000,24000,60000,-36000,-649000
20200430,2358,廷鑫,13.05,13.15,12.95,13.15,+0.35,2.73,259350,108,3386100,49000,6000,43000,0,0,0,0,0,0,43000
20200430,2359,所羅門,19.15,19.45,18.85,19.00,+0.35,1.88,4050667,1638,77776967,294000,573000,-279000,0,0,0,0,2000,-2000,-281000
20200430,2360,致茂,144.00,145.50,139.00,139.00,-3.00,-2.11,1972617,1563,277331263,458000,932869,-474869,21000,0,21000,60000,69000,-9000,-462869
20200430,2362,藍天,33.10,33.70,33.00,33.00,-0.10,-0.3,1490363,794,49829554,250000,386000,-136000,2000,0,2000,0,9000,-9000,-143000
20200430,2363,矽統,11.70,11.80,11.50,11.55,+0.10,0.87,21280701,4407,248529501,894500,2594000,-1699500,0,0,0,1000,1000,0,-1699500
20200430,2364,倫飛,2.23,2.23,2.20,2.21,+0.11,5.24,73249,22,161033,0,0,0,0,0,0,0,0,0,0
20200430,2365,昆盈,8.06,8.14,8.05,8.09,+0.06,0.75,1064151,329,8606337,316000,15000,301000,0,0,0,10000,1000,9000,310000
20200430,2367,燿華,22.50,23.00,22.40,22.75,+0.55,2.48,24674020,8678,560906510,5252000,1775000,3477000,15000,0,15000,278000,225000,53000,3545000
20200430,2368,金像電,32.75,33.65,32.20,33.05,+0.95,2.96,63422149,22885,2089846867,10518000,4957000,5561000,150000,150000,0,1878000,902000,976000,6537000
20200430,2369,菱生,10.10,10.15,9.93,9.99,-0.01,-0.1,2744119,946,27456561,512000,325000,187000,0,0,0,0,1000,-1000,186000
20200430,2371,大同,21.15,21.95,21.15,21.50,+0.45,2.14,9625185,3140,207811943,3561000,3243000,318000,0,0,0,90000,175000,-85000,233000
20200430,2373,震旦行,89.80,90.00,88.40,90.00,+0.40,0.45,71374,77,6386472,39000,22000,17000,0,0,0,0,0,0,17000
20200430,2374,佳能,12.35,12.40,12.10,12.30,+0.10,0.82,293548,156,3596781,85000,35000,50000,0,0,0,0,0,0,50000
20200430,2375,凱美,34.65,35.40,34.40,34.40,+0.25,0.73,6907309,3609,240306117,1005000,975000,30000,0,0,0,101000,10000,91000,121000
20200430,2376,技嘉,52.20,52.40,51.60,52.00,+0.20,0.39,4944714,2685,256595728,1299000,1543000,-244000,14000,760000,-746000,81000,364000,-283000,-1273000
20200430,2377,微星,92.90,93.20,92.20,93.00,+0.80,0.87,2643726,1459,245337048,1463000,1130000,333000,156000,30000,126000,92000,196000,-104000,355000
20200430,2379,瑞昱,251.00,258.00,249.00,257.50,+11.00,4.46,6834278,4966,1738809564,2502000,1607491,894509,616000,20000,596000,350000,211000,139000,1629509
20200430,2380,虹光,3.59,3.59,3.50,3.58,+0.04,1.13,413915,125,1465699,38000,50000,-12000,0,0,0,0,0,0,-12000
20200430,2382,廣達,63.60,64.90,63.40,64.90,+1.70,2.69,14997987,7061,964049528,8276000,2466319,5809681,1280000,20000,1260000,494000,310000,184000,7253681
20200430,2383,台光電,125.50,130.00,124.50,130.00,+5.50,4.42,6807098,4209,867831642,1782000,986000,796000,321000,0,321000,553000,107000,446000,1563000
20200430,2385,群光,85.00,85.20,83.70,84.40,-0.10,-0.12,3530856,2250,298982914,2395000,1612826,782174,3000,0,3000,6000,229000,-223000,562174
20200430,2387,精元,33.35,33.95,32.95,33.45,+0.05,0.15,3357020,1505,112378915,526000,745000,-219000,0,0,0,34000,46000,-12000,-231000
20200430,2388,威盛,31.85,32.25,31.55,31.55,-0.10,-0.32,1475005,836,46889556,298000,234000,64000,0,1000,-1000,0,0,0,63000
20200430,2390,云辰,8.00,8.09,7.91,7.97,+0.06,0.76,939514,317,7500930,140000,39000,101000,0,0,0,0,0,0,101000
20200430,2392,正崴,38.80,39.00,38.10,38.45,+1.35,3.64,12893509,6044,496048459,511000,2546000,-2035000,17000,0,17000,34000,272000,-238000,-2256000
20200430,2393,億光,32.80,32.95,32.10,32.60,+0.20,0.62,3195259,1717,103964815,899000,687000,212000,0,0,0,32000,30000,2000,214000
20200430,2395,研華,279.00,284.00,277.00,284.00,+4.50,1.61,918580,741,258301060,726800,440609,286191,2000,0,2000,0,6000,-6000,282191
20200430,2397,友通,74.60,75.50,74.40,74.80,+0.70,0.94,75404,74,5647800,22000,14000,8000,0,0,0,0,3000,-3000,5000
20200430,2399,映泰,10.25,10.30,9.90,10.00,-0.15,-1.48,3009452,1190,30274520,188000,331000,-143000,0,0,0,0,0,0,-143000
20200430,2401,凌陽,10.60,10.70,10.50,10.60,+0.10,0.95,2282271,723,24182763,730000,88000,642000,0,0,0,8000,7000,1000,643000
20200430,2402,毅嘉,13.35,13.75,13.25,13.45,+0.25,1.89,6716005,1563,90770420,261000,1260000,-999000,0,0,0,0,1000,-1000,-1000000
20200430,2404,漢唐,189.00,190.50,188.00,189.50,+1.00,0.53,1110118,778,210066420,324000,151000,173000,2000,2000,0,26000,99000,-73000,100000
20200430,2405,浩鑫,10.55,10.55,10.15,10.15,-0.25,-2.4,1988537,690,20470328,61000,325000,-264000,0,0,0,0,0,0,-264000
20200430,2406,國碩,10.05,10.30,9.96,10.05,+0.07,0.7,2388461,761,24190650,253000,171000,82000,0,0,0,0,1000,-1000,81000
20200430,2408,南亞科,65.70,66.00,64.70,65.00,+0.80,1.25,23952836,11329,1560005891,9670160,9187000,483160,171000,0,171000,211000,695000,-484000,170160
20200430,2409,友達,7.88,7.93,7.83,7.90,+0.07,0.89,63146075,9630,498045929,25307000,19946100,5360900,0,0,0,468000,660000,-192000,5168900
20200430,2412,中華電,110.00,110.00,109.50,109.50,-0.50,-0.45,8916427,4742,978232213,3389231,5000589,-1611358,39000,110000,-71000,32000,7000,25000,-1657358
20200430,2413,環科,11.70,11.75,11.50,11.70,+0.30,2.63,276027,159,3208814,71000,27000,44000,0,0,0,0,0,0,44000
20200430,2414,精技,23.25,23.50,23.20,23.30,+0.10,0.43,238231,165,5551329,52000,30000,22000,0,0,0,0,0,0,22000
20200430,2415,錩新,14.70,14.75,14.60,14.70,+0.15,1.03,169638,93,2488862,25000,15000,10000,0,0,0,0,0,0,10000
20200430,2417,圓剛,12.30,12.45,12.20,12.20,+0.10,0.83,3247765,1058,39847453,887000,320000,567000,0,0,0,0,8000,-8000,559000
20200430,2419,仲琦,20.35,20.35,20.05,20.05,-0.05,-0.25,829263,385,16710066,193000,42000,151000,0,0,0,0,1000,-1000,150000
20200430,2420,新巨,35.95,35.95,35.50,35.95,+3.25,9.94,3457142,1659,124199497,146000,119000,27000,0,0,0,0,0,0,27000
20200430,2421,建準,39.30,39.90,39.00,39.20,0.00,0.00,1834563,1088,71980924,445000,107000,338000,0,495000,-495000,35000,153000,-118000,-275000
20200430,2423,固緯,23.65,23.95,23.65,23.85,+0.40,1.71,242539,167,5766504,34000,29000,5000,0,0,0,0,1000,-1000,4000
20200430,2424,隴華,19.80,19.80,19.80,19.80,0.00,0.00,1060,2,20988,0,0,0,0,0,0,0,0,0,0
20200430,2425,承啟,25.40,25.70,25.25,25.60,+0.35,1.39,222700,161,5666983,132000,61000,71000,0,0,0,0,0,0,71000
20200430,2426,鼎元,12.65,12.90,12.65,12.80,+0.05,0.39,1602450,618,20405081,392000,166000,226000,0,0,0,0,2000,-2000,224000
20200430,2427,三商電,10.15,10.20,10.10,10.10,-0.05,-0.49,421000,101,4264200,22000,8000,14000,0,0,0,7000,0,7000,21000
20200430,2428,興勤,83.10,84.80,82.90,84.30,+1.30,1.57,976712,720,81699608,107000,80000,27000,4000,0,4000,8000,21000,-13000,18000
20200430,2429,銘旺科,23.80,24.00,23.10,23.30,+0.10,0.43,280001,160,6534523,5000,55000,-50000,0,0,0,0,0,0,-50000
20200430,2430,燦坤,15.65,16.10,15.65,15.95,+0.75,4.93,493815,273,7877142,41000,32000,9000,0,0,0,0,3000,-3000,6000
20200430,2431,聯昌,8.61,8.61,8.31,8.43,+0.44,5.51,1013708,376,8593482,61000,106000,-45000,0,0,0,0,0,0,-45000
20200430,2433,互盛電,52.70,52.90,52.40,52.80,+0.80,1.54,95406,85,5019918,27000,18000,9000,0,0,0,0,3000,-3000,6000
20200430,2434,統懋,5.85,5.90,5.85,5.90,-0.03,-0.51,5100,5,30040,0,0,0,0,0,0,0,0,0,0
20200430,2436,偉詮電,26.90,26.90,26.50,26.70,+0.30,1.14,2434932,1249,64926280,304000,258000,46000,0,0,0,0,1000,-1000,45000
20200430,2438,翔耀,6.75,6.75,6.42,6.62,-0.17,-2.5,560471,39,3897221,24000,0,24000,0,0,0,0,0,0,24000
20200430,2439,美律,137.50,142.00,137.00,140.00,+3.50,2.56,5190210,3779,723802495,753000,941177,-188177,5000,0,5000,250000,187000,63000,-120177
20200430,2440,太空梭,8.81,8.96,8.68,8.91,+0.10,1.14,21553,21,191833,15000,4000,11000,0,0,0,0,0,0,11000
20200430,2441,超豐,45.30,45.50,44.90,45.50,+0.95,2.13,722193,585,32737830,288000,101000,187000,14000,0,14000,1000,29000,-28000,173000
20200430,2442,新美齊,8.30,8.30,8.16,8.20,+0.10,1.23,1117370,423,9178482,213000,121000,92000,0,0,0,1000,1000,0,92000
20200430,2443,億麗,2.96,2.99,2.94,2.99,+0.04,1.36,180187,89,535792,25000,0,25000,0,0,0,0,0,0,25000
20200430,2444,兆勁,15.85,16.15,15.75,16.15,+0.40,2.54,1293343,275,20737488,195000,46000,149000,0,0,0,0,0,0,149000
20200430,2448,晶電,39.20,39.60,38.20,38.40,-0.80,-2.04,57215782,23187,2212163730,9926000,6922000,3004000,50000,3032000,-2982000,1095000,1116000,-21000,1000
20200430,2449,京元電子,36.25,36.30,35.85,36.00,+0.25,0.7,10187861,4165,367104096,2479000,3286000,-807000,144000,0,144000,334000,448000,-114000,-777000
20200430,2450,神腦,28.80,29.50,28.80,29.10,+0.30,1.04,417183,269,12185208,123000,174000,-51000,0,0,0,0,7000,-7000,-58000
20200430,2451,創見,70.20,70.60,70.00,70.60,+0.50,0.71,1354871,871,95303790,367000,405000,-38000,3000,0,3000,2000,199000,-197000,-232000
20200430,2453,凌群,16.70,16.75,16.50,16.60,+0.05,0.3,914002,306,15172133,123000,66000,57000,0,0,0,8000,0,8000,65000
20200430,2454,聯發科,412.00,415.50,405.00,415.00,+17.00,4.27,22045679,14050,9056156448,17060374,5142583,11917791,213000,0,213000,329000,570000,-241000,11889791
20200430,2455,全新,90.00,90.00,88.10,88.80,+0.60,0.68,2504253,1822,222790065,674000,289000,385000,1000,175000,-174000,59000,83000,-24000,187000
20200430,2456,奇力新,106.00,109.00,105.50,106.00,+1.50,1.44,13166945,8846,1411211670,1104000,1079000,25000,206000,0,206000,428000,93000,335000,566000
20200430,2457,飛宏,7.20,7.41,7.20,7.35,+0.15,2.08,1044098,365,7638792,123000,53000,70000,0,0,0,0,0,0,70000
20200430,2458,義隆,94.80,97.50,94.10,96.50,+2.10,2.22,13401941,8547,1284788511,6520000,748000,5772000,408000,364000,44000,375000,314000,61000,5877000
20200430,2459,敦吉,40.35,40.70,40.35,40.65,+0.35,0.87,210439,156,8537633,86000,12000,74000,0,0,0,2000,5000,-3000,71000
20200430,2460,建通,8.00,8.08,7.89,7.99,+0.10,1.27,78561,54,628362,24000,8000,16000,0,0,0,0,0,0,16000
20200430,2461,光群雷,14.20,14.40,14.00,14.25,+0.15,1.06,1886651,569,26860889,193000,235000,-42000,0,0,0,0,1000,-1000,-43000
20200430,2462,良得電,25.75,26.10,25.55,26.10,+0.40,1.56,65567,46,1694483,27000,0,27000,0,0,0,0,1000,-1000,26000
20200430,2464,盟立,33.05,33.70,33.05,33.55,+0.55,1.67,866762,540,29026251,245000,139000,106000,2000,0,2000,0,51000,-51000,57000
20200430,2465,麗臺,9.10,9.38,8.96,8.96,+0.10,1.13,505733,219,4583539,7000,32000,-25000,0,0,0,0,0,0,-25000
20200430,2466,冠西電,31.85,32.80,31.85,32.80,+1.10,3.47,73000,58,2367450,32000,4000,28000,0,0,0,0,4000,-4000,24000
20200430,2467,志聖,28.60,28.75,28.20,28.35,-0.05,-0.18,1875889,958,53373550,99000,345000,-246000,0,0,0,0,1000,-1000,-247000
20200430,2468,華經,12.45,12.50,12.35,12.45,+0.10,0.81,384040,133,4772602,19000,0,19000,0,0,0,0,1000,-1000,18000
20200430,2471,資通,24.75,25.60,24.40,25.05,+0.55,2.24,1727488,1045,43120796,102000,324000,-222000,0,0,0,0,0,0,-222000
20200430,2472,立隆電,40.05,41.00,39.80,40.35,+0.60,1.51,3295400,1793,133303920,397000,375000,22000,2000,0,2000,3000,1000,2000,26000
20200430,2474,可成,232.00,232.00,226.00,228.00,0.00,0.00,5123969,3044,1168203932,1464000,2938990,-1474990,302000,0,302000,157000,58000,99000,-1073990
20200430,2476,鉅祥,20.20,20.40,19.90,20.35,+0.30,1.5,414578,200,8369350,136000,42000,94000,0,0,0,19000,0,19000,113000
20200430,2477,美隆電,21.50,21.50,21.10,21.15,+0.15,0.71,151312,87,3219697,36000,44000,-8000,0,0,0,3000,1000,2000,-6000
20200430,2478,大毅,81.50,86.50,80.40,80.50,+1.50,1.9,46309142,27860,3841690264,3493000,5873000,-2380000,75000,0,75000,496000,301000,195000,-2110000
20200430,2480,敦陽科,61.10,61.50,60.60,60.90,+0.20,0.33,631068,436,38468830,91000,98000,-7000,4000,0,4000,6000,0,6000,3000
20200430,2481,強茂,24.70,24.85,24.45,24.55,+0.15,0.61,4431011,1938,109138912,1598000,276000,1322000,0,0,0,53000,27000,26000,1348000
20200430,2482,連宇,10.30,10.35,10.20,10.20,0.00,0.00,126999,66,1301137,7000,1000,6000,0,0,0,0,0,0,6000
20200430,2483,百容,18.30,18.35,18.20,18.30,+0.05,0.27,131000,45,2397550,13000,0,13000,0,0,0,0,0,0,13000
20200430,2484,希華,20.40,20.50,20.10,20.10,-0.10,-0.5,1614301,753,32719543,216000,173000,43000,0,0,0,0,0,0,43000
20200430,2485,兆赫,16.25,16.35,16.00,16.00,+0.05,0.31,1548583,642,24971171,354000,98000,256000,0,0,0,2000,22000,-20000,236000
20200430,2486,一詮,7.38,7.59,7.38,7.53,+0.17,2.31,306969,156,2298307,71000,11000,60000,0,0,0,0,1000,-1000,59000
20200430,2488,漢平,28.40,28.80,28.30,28.60,+0.40,1.42,422640,255,12081621,101000,30000,71000,0,0,0,0,0,0,71000
20200430,2489,瑞軒,7.52,7.69,7.46,7.69,+0.25,3.36,2807159,942,21429970,915000,365000,550000,0,0,0,18000,37000,-19000,531000
20200430,2491,吉祥全,7.92,8.23,7.73,8.18,+0.48,6.23,597672,266,4756466,29000,2000,27000,0,0,0,0,0,0,27000
20200430,2492,華新科,215.00,217.00,211.00,213.00,+2.00,0.95,15853381,10743,3388177653,2368245,3271000,-902755,3000,74000,-71000,324000,539000,-215000,-1188755
20200430,2493,揚博,29.15,29.20,29.00,29.05,+0.05,0.17,695394,343,20222993,61000,62000,-1000,0,0,0,0,0,0,-1000
20200430,2495,普安,11.70,11.85,11.65,11.75,+0.10,0.86,343001,143,4033011,87000,1000,86000,0,0,0,0,0,0,86000
20200430,2496,卓越,61.30,61.30,60.80,61.20,-0.10,-0.16,19250,20,1174000,1000,1000,0,0,0,0,0,0,0,0
20200430,2497,怡利電,16.15,16.15,15.70,15.80,0.00,0.00,158000,94,2496850,21000,14000,7000,0,0,0,0,0,0,7000
20200430,2498,宏達電,30.25,30.40,29.95,30.00,+0.15,0.5,5070529,2534,152590932,1142000,920000,222000,0,0,0,33000,51000,-18000,204000
20200430,2501,國建,19.75,19.80,19.40,19.80,+0.55,2.86,1231689,650,24173919,671000,487000,184000,0,0,0,0,1000,-1000,183000
20200430,2504,國產,13.90,14.10,13.45,13.80,+0.05,0.36,16144919,4472,222214131,992000,2021000,-1029000,0,0,0,399000,185000,214000,-815000
20200430,2505,國揚,25.90,26.50,24.20,25.75,+0.25,0.98,14629800,4689,370299570,1286000,1152000,134000,0,0,0,209000,255000,-46000,88000
20200430,2506,太設,9.12,9.12,9.02,9.06,+0.03,0.33,191296,106,1731911,92000,2000,90000,0,0,0,0,0,0,90000
20200430,2509,全坤建,21.00,21.40,21.00,21.30,+0.25,1.19,59640,53,1264929,28000,0,28000,0,0,0,0,0,0,28000
20200430,2511,太子,9.80,10.10,9.80,10.10,+0.38,3.91,2645722,763,26344968,1049000,110000,939000,0,0,0,0,0,0,939000
20200430,2514,龍邦,13.80,14.45,13.80,14.25,+0.45,3.26,564111,309,7956661,166000,19000,147000,0,0,0,0,0,0,147000
20200430,2515,中工,7.03,7.16,7.03,7.12,+0.14,2.01,9374515,1700,66644860,1873000,376000,1497000,0,0,0,262000,88000,174000,1671000
20200430,2516,新建,4.70,4.71,4.60,4.70,+0.14,3.07,311867,85,1460878,57000,4000,53000,0,0,0,0,0,0,53000
20200430,2520,冠德,26.00,26.35,25.85,26.20,+0.45,1.75,1962203,957,51330208,466000,479000,-13000,0,0,0,104000,1000,103000,90000
20200430,2524,京城,34.10,34.35,33.50,34.05,+0.10,0.29,464930,321,15819534,161000,122000,39000,12000,0,12000,0,2000,-2000,49000
20200430,2527,宏璟,20.40,20.40,20.10,20.35,+0.35,1.75,522300,310,10595989,171000,32000,139000,0,0,0,0,0,0,139000
20200430,2528,皇普,19.25,19.40,19.20,19.30,+0.10,0.52,144545,65,2785536,34000,9000,25000,0,0,0,1000,1000,0,25000
20200430,2530,華建,17.80,18.00,17.50,17.90,+1.50,9.15,2152315,694,38645448,222000,46000,176000,0,0,0,0,0,0,176000
20200430,2534,宏盛,17.75,17.75,17.45,17.70,+0.20,1.14,1247189,635,22000114,545000,185000,360000,0,0,0,0,0,0,360000
20200430,2535,達欣工,21.45,21.55,21.35,21.45,+0.15,0.7,1338454,578,28723057,206000,53000,153000,2000,0,2000,170000,0,170000,325000
20200430,2536,宏普,21.80,22.15,21.70,21.95,+0.30,1.39,512290,294,11229935,120000,149000,-29000,0,0,0,0,0,0,-29000
20200430,2537,聯上發,9.20,9.85,9.20,9.82,+0.78,8.63,2950312,1072,28406542,526000,341000,185000,0,0,0,0,0,0,185000
20200430,2538,基泰,9.49,10.00,9.38,9.76,+0.34,3.61,1107642,447,10792222,143000,146000,-3000,0,0,0,0,0,0,-3000
20200430,2539,櫻花建,33.55,33.75,33.35,33.70,+0.15,0.45,334757,199,11244703,102000,79000,23000,0,0,0,0,1000,-1000,22000
20200430,2540,愛山林,27.10,27.40,26.80,27.10,0.00,0.00,109153,63,2950065,27000,14000,13000,0,0,0,0,0,0,13000
20200430,2542,興富發,44.50,44.50,43.65,43.65,-0.05,-0.11,3016881,1890,132730216,1127000,1352500,-225500,0,0,0,0,38000,-38000,-263500
20200430,2543,皇昌,6.76,7.00,6.56,6.90,+0.11,1.62,69001,38,469376,21000,3000,18000,0,0,0,0,0,0,18000
20200430,2545,皇翔,33.00,33.65,32.85,33.60,+0.60,1.82,611644,164,20457038,129644,14000,115644,0,0,0,0,0,0,115644
20200430,2546,根基,38.00,38.15,37.85,37.90,+0.10,0.26,175020,129,6654611,40000,20000,20000,0,0,0,0,5000,-5000,15000
20200430,2547,日勝生,10.50,10.60,10.50,10.60,+0.25,2.42,1560875,590,16446718,654000,85000,569000,0,0,0,0,0,0,569000
20200430,2548,華固,91.00,91.50,90.10,91.30,+1.60,1.78,1470881,971,133723688,308000,184000,124000,8000,300000,-292000,39000,14000,25000,-143000
20200430,2597,潤弘,61.00,61.80,60.50,61.60,+0.30,0.49,120253,103,7369934,41000,3000,38000,0,0,0,0,0,0,38000
20200430,2601,益航,10.40,10.40,10.15,10.30,0.00,0.00,9588303,1929,98522502,1133000,845000,288000,26000,0,26000,0,6000,-6000,308000
20200430,2603,長榮,11.00,11.15,10.75,11.10,+0.40,3.74,43075507,10610,475161627,7328000,6010232,1317768,4313000,0,4313000,85000,244000,-159000,5471768
20200430,2605,新興,15.00,15.10,14.65,14.80,-0.15,-1.0,2754422,940,40831833,406000,338000,68000,8000,0,8000,60000,8000,52000,128000
20200430,2606,裕民,29.30,29.60,29.15,29.55,+0.30,1.03,4302497,1297,126675531,1282000,1367000,-85000,7000,0,7000,291000,0,291000,213000
20200430,2607,榮運,13.30,13.35,13.05,13.20,+0.25,1.93,1391590,469,18318316,237000,146000,91000,0,0,0,0,0,0,91000
20200430,2608,嘉里大榮,40.75,40.95,40.45,40.95,+0.50,1.24,402385,282,16388978,226000,11000,215000,0,0,0,0,1000,-1000,214000
20200430,2609,陽明,6.80,6.87,6.50,6.77,-0.02,-0.29,10184365,2441,68704195,1193000,842000,351000,0,0,0,0,0,0,351000
20200430,2610,華航,8.21,8.50,8.13,8.25,+0.13,1.6,54102509,14839,447472232,9398100,7324000,2074100,60000,0,60000,70000,192000,-122000,2012100
20200430,2611,志信,6.12,6.19,6.11,6.17,-0.01,-0.16,465117,129,2860743,53000,0,53000,0,0,0,0,0,0,53000
20200430,2612,中航,25.00,25.20,24.75,25.00,+0.30,1.21,272413,189,6806675,108000,33000,75000,0,0,0,0,0,0,75000
20200430,2613,中櫃,13.35,13.60,13.30,13.50,+0.20,1.5,115360,77,1555068,25000,0,25000,0,0,0,0,0,0,25000
20200430,2614,東森,13.70,13.75,13.25,13.25,+0.15,1.15,8958278,2719,120801697,448000,1243000,-795000,0,0,0,0,0,0,-795000
20200430,2615,萬海,16.95,17.05,16.70,16.90,+0.20,1.2,2882701,1040,48778107,1313000,566000,747000,12000,0,12000,15000,0,15000,774000
20200430,2616,山隆,29.50,29.60,29.30,29.45,+0.05,0.17,127876,116,3774192,38000,8000,30000,0,0,0,0,0,0,30000
20200430,2617,台航,16.00,16.25,15.85,16.10,+0.35,2.22,1058097,415,16968460,278000,185000,93000,0,0,0,0,0,0,93000
20200430,2618,長榮航,11.55,11.85,11.30,11.50,+0.20,1.77,58483071,14705,676752477,6097000,12925484,-6828484,6469000,0,6469000,1147000,238000,909000,549516
20200430,2630,亞航,15.50,15.50,14.95,15.15,-0.05,-0.33,161100,108,2435850,24000,12000,12000,0,0,0,0,0,0,12000
20200430,2633,台灣高鐵,34.60,34.65,34.05,34.10,+0.10,0.29,9030380,3427,309363108,1987000,1773000,214000,7000,0,7000,566000,204000,362000,583000
20200430,2634,漢翔,28.20,28.90,28.20,28.70,+0.65,2.32,3569993,1731,101874992,982000,426000,556000,2000,0,2000,0,32000,-32000,526000
20200430,2636,台驊投控,21.80,21.90,21.75,21.85,+0.15,0.69,216306,135,4723872,31000,20000,11000,0,0,0,0,0,0,11000
20200430,2637,慧洋-KY,24.55,25.25,24.55,25.15,+0.75,3.07,2492046,1044,62293850,738000,413000,325000,0,0,0,0,7000,-7000,318000
20200430,2642,宅配通,30.50,30.60,30.25,30.35,0.00,0.00,505100,277,15363434,60000,21000,39000,0,0,0,90000,0,90000,129000
20200430,2701,萬企,11.60,11.90,11.60,11.80,+0.25,2.16,207475,146,2443197,72000,9000,63000,0,0,0,0,0,0,63000
20200430,2702,華園,13.00,13.90,12.90,13.90,+1.25,9.88,904157,400,12327330,32000,29000,3000,0,0,0,0,0,0,3000
20200430,2704,國賓,25.00,27.35,25.00,27.05,+2.05,8.2,612556,419,16149353,169000,28000,141000,0,0,0,0,0,0,141000
20200430,2705,六福,10.80,11.00,10.60,11.00,+0.55,5.26,621004,268,6745279,54000,0,54000,0,0,0,0,0,0,54000
20200430,2706,第一店,12.90,13.25,12.75,13.15,+0.30,2.33,395696,173,5151499,118000,13000,105000,0,0,0,0,0,0,105000
20200430,2707,晶華,136.00,144.00,136.00,141.50,+7.50,5.6,1382074,1144,194774508,129000,162000,-33000,0,0,0,0,0,0,-33000
20200430,2712,遠雄來,33.00,34.25,32.65,33.45,+1.05,3.24,27000,25,909100,14000,9000,5000,0,0,0,0,0,0,5000
20200430,2722,夏都,23.10,23.25,22.80,23.00,-0.15,-0.65,22200,22,512450,12000,6000,6000,0,0,0,0,0,0,6000
20200430,2723,美食-KY,89.60,97.30,89.60,96.50,+7.00,7.82,3379460,2511,321331720,605000,407573,197427,542000,287000,255000,141000,73000,68000,520427
20200430,2727,王品,65.80,67.90,65.80,67.20,+2.00,3.07,869343,755,58219301,163000,23000,140000,0,0,0,0,0,0,140000
20200430,2731,雄獅,71.50,72.50,70.60,71.20,+1.70,2.45,564600,454,40288919,72000,45000,27000,0,0,0,0,0,0,27000
20200430,2739,寒舍,23.15,23.45,23.00,23.30,+0.30,1.3,215199,98,5005456,31000,5000,26000,0,0,0,0,0,0,26000
20200430,2748,雲品,43.00,43.85,43.00,43.60,+1.00,2.35,204594,153,8903945,21000,0,21000,0,30000,-30000,0,0,0,-9000
20200430,2801,彰銀,19.70,19.85,19.60,19.60,0.00,0.00,16202946,2902,319488162,9559000,12775120,-3216120,71000,0,71000,89000,53000,36000,-3109120
20200430,2809,京城銀,31.35,32.40,31.25,31.95,+0.85,2.73,2757576,1209,88321782,795000,482000,313000,6000,0,6000,5000,7000,-2000,317000
20200430,2812,台中銀,11.40,11.50,11.40,11.45,+0.15,1.33,10162646,2719,116538041,2539000,2871245,-332245,16000,0,16000,10000,4000,6000,-310245
20200430,2816,旺旺保,19.90,20.10,19.75,19.85,+0.10,0.51,263416,152,5234394,96000,1000,95000,0,0,0,0,0,0,95000
20200430,2820,華票,14.60,14.70,14.60,14.65,+0.10,0.69,852145,447,12491615,265000,377000,-112000,0,0,0,0,7000,-7000,-119000
20200430,2823,中壽,20.40,20.80,20.30,20.50,+0.35,1.74,22026536,5651,453139178,8111000,4305000,3806000,27000,0,27000,62000,376000,-314000,3519000
20200430,2832,台產,19.65,19.80,19.50,19.75,+0.15,0.77,275004,154,5420026,136000,23000,113000,0,0,0,0,0,0,113000
20200430,2834,臺企銀,10.75,10.85,10.70,10.85,+0.20,1.88,29479316,5757,318153644,9587000,3941019,5645981,7000,0,7000,0,23000,-23000,5629981
20200430,2836,高雄銀,9.56,9.57,9.51,9.56,+0.06,0.63,1217832,361,11630664,537000,114000,423000,0,0,0,0,0,0,423000
20200430,2838,聯邦銀,10.75,10.80,10.60,10.70,+0.05,0.47,3771727,812,40355701,1206000,336000,870000,0,0,0,0,9000,-9000,861000
20200430,2838A,聯邦銀甲特,52.20,52.80,52.20,52.80,+0.60,1.15,241500,146,12682350,21000,0,21000,0,0,0,0,0,0,21000
20200430,2841,台開,6.92,6.96,6.85,6.92,+0.02,0.29,4263143,920,29453542,1142000,253000,889000,0,0,0,0,0,0,889000
20200430,2845,遠東銀,10.65,10.75,10.60,10.65,+0.15,1.43,5413215,2182,57838874,1702000,1128000,574000,7000,0,7000,15000,2000,13000,594000
20200430,2849,安泰銀,14.45,14.70,14.40,14.65,+0.25,1.74,225000,139,3272650,184000,53000,131000,0,0,0,0,13000,-13000,118000
20200430,2850,新產,36.70,36.90,36.60,36.85,+0.55,1.52,250585,193,9214403,146000,47000,99000,0,0,0,0,0,0,99000
20200430,2851,中再保,18.00,18.40,17.90,18.35,+0.35,1.94,447080,302,8118162,312000,113000,199000,0,0,0,0,5000,-5000,194000
20200430,2852,第一保,14.10,14.20,14.10,14.10,-0.25,-1.74,1165200,260,16464050,108000,19000,89000,0,0,0,0,0,0,89000
20200430,2855,統一證,13.30,13.50,13.30,13.45,+0.25,1.89,2864899,795,38404643,928000,355000,573000,51000,0,51000,0,0,0,624000
20200430,2867,三商壽,9.66,9.79,9.61,9.61,+0.05,0.52,6022602,1588,58437819,2342000,1930000,412000,0,0,0,172000,10000,162000,574000
20200430,2880,華南金,19.30,19.60,19.25,19.45,+0.25,1.3,26318446,6167,511455281,12183000,8015551,4167449,93000,0,93000,36000,34000,2000,4262449
20200430,2881,富邦金,41.60,42.50,41.60,42.30,+1.25,3.05,20246120,6914,851364671,11703000,5362000,6341000,70000,0,70000,250000,61000,189000,6600000
20200430,2881A,富邦特,64.70,65.00,64.60,65.00,+0.40,0.62,190910,542,12364116,3000,0,3000,0,0,0,0,0,0,3000
20200430,2881B,富邦金乙特,62.90,63.10,62.90,62.90,0.00,0.00,75670,602,4763330,5000,20000,-15000,0,0,0,0,0,0,-15000
20200430,2882,國泰金,39.25,39.90,39.20,39.90,+1.45,3.77,42317052,14031,1678356401,23315389,9520814,13794575,78000,0,78000,384000,730000,-346000,13526575
20200430,2882A,國泰特,62.80,63.00,62.70,63.00,+0.20,0.32,482817,187,30376921,51000,0,51000,0,0,0,1000,95000,-94000,-43000
20200430,2882B,國泰金乙特,62.80,62.80,62.70,62.80,0.00,0.00,97246,36,6103974,0,0,0,0,0,0,0,65000,-65000,-65000
20200430,2883,開發金,9.10,9.10,9.02,9.06,+0.08,0.89,44178967,7716,400821093,15792000,16211000,-419000,38000,0,38000,193000,464000,-271000,-652000
20200430,2884,玉山金,27.00,27.40,26.95,27.30,+0.55,2.06,47957805,12696,1305429139,19486500,10584050,8902450,67000,0,67000,881000,2041000,-1160000,7809450
20200430,2885,元大金,16.80,17.25,16.75,17.10,+0.35,2.09,45298622,8529,772669175,21259000,25312988,-4053988,67000,0,67000,3925000,10000,3915000,-71988
20200430,2886,兆豐金,30.05,30.65,30.05,30.10,+0.15,0.5,39206740,10511,1189426640,16289350,13539954,2749396,1690000,0,1690000,7000,2070000,-2063000,2376396
20200430,2887,台新金,12.55,12.75,12.50,12.75,+0.40,3.24,35822385,6641,453561232,19287000,11690000,7597000,51000,0,51000,135000,11000,124000,7772000
20200430,2887E,台新戊特,53.90,54.20,53.80,54.20,+0.40,0.74,233105,57,12580148,0,0,0,0,0,0,0,0,0,0
20200430,2887F,台新戊特二,52.20,52.40,52.10,52.40,+0.20,0.38,63801,35,3328230,0,0,0,0,0,0,0,10000,-10000,-10000
20200430,2888,新光金,8.51,8.56,8.47,8.54,+0.13,1.55,58893453,9384,502087364,25091812,15967290,9124522,21000,1495000,-1474000,480000,461000,19000,7669522
20200430,2888A,新光金甲特,44.05,44.20,44.00,44.00,0.00,0.00,89447,58,3939286,1000,0,1000,0,0,0,0,0,0,1000
20200430,2889,國票金,10.85,11.00,10.85,10.95,+0.15,1.39,6749205,1646,73769146,1728000,1069000,659000,20000,0,20000,10000,10000,0,679000
20200430,2890,永豐金,11.85,12.25,11.85,12.20,+0.45,3.83,25587617,5369,308880564,19903000,6366184,13536816,0,0,0,15000,403000,-388000,13148816
20200430,2891,中信金,19.90,20.25,19.85,20.00,+0.30,1.52,69091028,15471,1387289160,39576513,16114664,23461849,178000,0,178000,331000,128000,203000,23842849
20200430,2891B,中信金乙特,64.80,66.00,64.70,66.00,+0.20,0.3,23013,14,1511050,0,0,0,0,0,0,1000,0,1000,1000
20200430,2891C,中信金丙特,62.00,62.40,61.80,62.40,+0.40,0.65,41160,29,2554120,0,0,0,0,0,0,1000,0,1000,1000
20200430,2892,第一金,21.75,22.30,21.75,22.05,+0.40,1.85,35128117,8487,777475434,17807000,9483262,8323738,194000,0,194000,40000,24000,16000,8533738
20200430,2897,王道銀行,7.10,7.29,7.10,7.26,+0.16,2.25,2022750,644,14570483,1448000,297000,1151000,0,0,0,0,21000,-21000,1130000
20200430,2897A,王道銀甲特,10.15,10.25,10.15,10.25,+0.10,0.99,91011,31,927061,0,0,0,0,0,0,0,0,0,0
20200430,2901,欣欣,22.85,22.85,22.75,22.80,+0.10,0.44,19001,9,433223,2000,0,2000,0,0,0,0,0,0,2000
20200430,2903,遠百,23.25,23.40,23.05,23.05,-0.05,-0.22,1726527,600,40011113,739000,300000,439000,0,0,0,14000,0,14000,453000
20200430,2904,匯僑,23.10,23.10,22.95,23.00,-0.10,-0.43,166003,100,3819869,24000,0,24000,0,0,0,0,0,0,24000
20200430,2905,三商,21.70,22.05,21.70,22.00,+0.30,1.38,1617087,773,35510200,916000,77000,839000,0,0,0,8000,34000,-26000,813000
20200430,2906,高林,10.80,10.80,10.65,10.65,-0.10,-0.93,123346,56,1317416,38000,0,38000,0,0,0,0,0,0,38000
20200430,2908,特力,18.80,19.20,18.70,19.20,+0.35,1.86,727492,275,13834620,362000,92000,270000,0,0,0,0,0,0,270000
20200430,2910,統領,31.00,31.90,29.50,31.30,+0.60,1.95,45000,44,1389350,32000,20000,12000,0,0,0,0,0,0,12000
20200430,2911,麗嬰房,6.06,6.20,6.05,6.15,+0.02,0.33,190513,120,1171771,48000,1000,47000,0,0,0,0,0,0,47000
20200430,2912,統一超,305.50,310.00,305.50,308.00,+3.50,1.15,2829690,1715,870950640,2562685,1023000,1539685,5000,9000,-4000,0,9000,-9000,1526685
20200430,2913,農林,14.10,14.25,14.05,14.25,+0.20,1.42,790108,346,11188823,317000,95000,222000,0,0,0,1000,0,1000,223000
20200430,2915,潤泰全,67.60,69.00,67.60,68.50,+1.10,1.63,2887953,1894,197670772,1485600,920000,565600,3000,0,3000,104000,269000,-165000,403600
20200430,2923,鼎固-KY,24.80,26.35,24.80,26.20,+1.40,5.65,315262,216,8135862,275000,0,275000,0,0,0,0,0,0,275000
20200430,2929,淘帝-KY,69.50,70.70,69.50,70.20,+1.10,1.59,893202,639,62637970,192000,85192,106808,0,0,0,0,1000,-1000,105808
20200430,2936,客思達-KY,14.30,14.35,14.00,14.25,+0.10,0.71,23000,16,327400,14000,0,14000,0,0,0,0,0,0,14000
20200430,2939,凱羿-KY,163.00,171.00,162.00,168.00,+3.50,2.13,453110,342,75203260,78000,69000,9000,0,0,0,0,0,0,9000
20200430,3002,歐格,10.75,10.75,10.40,10.65,0.00,0.00,255000,110,2690050,20000,1000,19000,0,0,0,9000,0,9000,28000
20200430,3003,健和興,38.80,38.90,38.10,38.35,+0.25,0.66,824779,520,31661995,239000,74000,165000,5000,0,5000,0,26000,-26000,144000
20200430,3004,豐達科,57.90,62.40,57.60,61.30,+4.50,7.92,1726455,1247,104500716,156000,194000,-38000,0,0,0,3000,0,3000,-35000
20200430,3005,神基,44.00,44.50,43.85,44.50,+0.80,1.83,1602170,914,70943633,655000,172000,483000,0,0,0,38000,384000,-346000,137000
20200430,3006,晶豪科,42.00,42.45,40.35,41.00,+0.20,0.49,14268002,7469,591671076,2579000,1248000,1331000,457000,15000,442000,93000,373000,-280000,1493000
20200430,3008,大立光,4000.00,4120.00,3985.00,4110.00,+170.00,4.31,1130697,1685,4595294670,482001,425342,56659,11000,1000,10000,25000,15000,10000,76659
20200430,3010,華立,54.00,54.50,53.80,54.40,+0.50,0.93,465512,337,25231451,149000,129000,20000,7000,0,7000,0,22000,-22000,5000
20200430,3011,今皓,5.55,5.55,5.33,5.40,+0.10,1.89,110103,55,594069,20000,11000,9000,0,0,0,0,0,0,9000
20200430,3013,晟銘電,12.90,13.10,12.50,12.70,0.00,0.00,350000,159,4475050,38000,22000,16000,0,0,0,5000,1000,4000,20000
20200430,3014,聯陽,47.45,47.50,46.95,47.15,+0.10,0.21,1827669,1085,86221631,380299,207000,173299,12000,0,12000,19000,25000,-6000,179299
20200430,3015,全漢,24.10,24.55,23.75,24.30,+0.30,1.25,1339280,639,32342344,103000,179000,-76000,0,0,0,0,16000,-16000,-92000
20200430,3016,嘉晶,50.90,52.90,50.70,51.80,+1.50,2.98,7322173,4596,381112552,622000,591000,31000,0,0,0,446000,24000,422000,453000
20200430,3017,奇鋐,40.95,41.40,40.05,40.80,+0.50,1.24,16963524,9028,690533960,2484000,1363000,1121000,502000,260000,242000,467000,204000,263000,1626000
20200430,3018,同開,18.50,18.50,18.05,18.10,-0.05,-0.28,503933,268,9182729,64000,15000,49000,0,0,0,0,0,0,49000
20200430,3019,亞光,72.30,73.30,71.60,72.60,+1.30,1.82,4773701,3193,346624840,808000,405000,403000,0,0,0,188000,92000,96000,499000
20200430,3021,鴻名,13.30,13.80,13.30,13.80,+0.40,2.99,129000,60,1759450,16000,2000,14000,0,0,0,0,1000,-1000,13000
20200430,3022,威強電,35.00,35.50,34.65,35.25,+0.60,1.73,305708,252,10717580,168000,29000,139000,0,0,0,0,1000,-1000,138000
20200430,3023,信邦,150.00,150.50,145.00,146.50,-2.50,-1.68,1688599,1350,248187454,348000,390268,-42268,1000,60000,-59000,5000,2000,3000,-98268
20200430,3024,憶聲,7.32,7.32,7.24,7.26,-0.03,-0.41,310003,112,2254260,83000,15000,68000,0,0,0,0,0,0,68000
20200430,3025,星通,20.50,20.50,20.10,20.10,0.00,0.00,84599,61,1709080,17000,8000,9000,0,0,0,0,0,0,9000
20200430,3026,禾伸堂,127.00,127.50,124.00,124.50,-0.50,-0.4,5755182,4303,722019643,1101000,250000,851000,0,0,0,14000,59000,-45000,806000
20200430,3027,盛達,7.60,7.77,7.57,7.76,+0.16,2.11,150477,82,1154720,20000,1000,19000,0,0,0,0,0,0,19000
20200430,3028,增你強,18.60,18.75,18.60,18.75,+0.25,1.35,301354,189,5630586,82000,36000,46000,0,0,0,0,0,0,46000
20200430,3029,零壹,33.50,33.60,33.10,33.35,0.00,0.00,2084757,1194,69537235,157000,298000,-141000,0,0,0,14000,0,14000,-127000
20200430,3030,德律,51.30,51.90,51.00,51.90,+1.10,2.17,727697,470,37450874,195000,97000,98000,8000,0,8000,24000,0,24000,130000
20200430,3031,佰鴻,15.10,15.10,14.95,15.00,+0.05,0.33,347089,213,5206484,59000,31000,28000,0,0,0,0,1000,-1000,27000
20200430,3032,偉訓,26.30,26.70,26.30,26.65,+0.45,1.72,365207,165,9700934,85000,22000,63000,0,0,0,0,0,0,63000
20200430,3033,威健,14.85,15.15,14.85,15.00,+0.20,1.35,849288,406,12728370,100000,8000,92000,0,0,0,0,1000,-1000,91000
20200430,3034,聯詠,183.50,187.50,183.00,186.50,+3.00,1.63,5939812,4023,1102071844,1529000,2201000,-672000,427000,8000,419000,91000,188000,-97000,-350000
20200430,3035,智原,43.45,43.80,43.25,43.35,+0.15,0.35,2871568,1630,124770521,585000,222000,363000,0,327000,-327000,89000,33000,56000,92000
20200430,3036,文曄,38.35,38.80,38.35,38.55,+0.20,0.52,2012660,892,77737017,360000,468000,-108000,19000,0,19000,10000,307670,-297670,-386670
20200430,3037,欣興,42.90,43.50,42.35,42.85,+0.85,2.02,59548016,25345,2550971906,9493000,10645000,-1152000,3842000,314000,3528000,1254000,2833000,-1579000,797000
20200430,3038,全台,19.15,19.20,18.80,18.80,-0.10,-0.53,5046382,1883,95497579,387000,407000,-20000,0,0,0,0,1000,-1000,-21000
20200430,3040,遠見,34.80,35.40,32.85,35.40,+3.20,9.94,2909170,1648,101250465,118000,61000,57000,0,0,0,0,0,0,57000
20200430,3041,揚智,15.45,15.80,15.25,15.45,+0.20,1.31,2648495,1151,41101407,816000,154000,662000,0,0,0,0,0,0,662000
20200430,3042,晶技,65.80,66.70,64.60,64.70,-0.50,-0.77,11664994,6790,763728690,1574322,2787000,-1212678,732000,0,732000,763000,295000,468000,-12678
20200430,3043,科風,1.37,1.45,1.37,1.37,+0.01,0.74,267636,44,373756,0,0,0,0,0,0,0,0,0,0
20200430,3044,健鼎,105.00,108.00,104.00,106.50,+2.50,2.4,3634461,2233,386047594,1350000,1003241,346759,3000,38000,-35000,28000,74000,-46000,265759
20200430,3045,台灣大,107.00,108.00,106.50,107.50,+1.00,0.94,4142100,2359,445261745,2487533,2174200,313333,16000,16000,0,17000,1000,16000,329333
20200430,3046,建碁,10.00,10.20,10.00,10.10,-0.10,-0.98,15048,11,152189,0,0,0,0,0,0,0,0,0,0
20200430,3047,訊舟,8.27,8.93,8.24,8.76,+0.60,7.35,7052106,2243,61814978,379000,585000,-206000,0,0,0,0,0,0,-206000
20200430,3048,益登,16.50,16.65,16.45,16.55,+0.15,0.91,929428,454,15380055,118000,53000,65000,0,0,0,4000,2000,2000,67000
20200430,3049,和鑫,11.30,11.40,10.90,11.15,-0.05,-0.45,23646165,5408,263048077,823000,3157000,-2334000,37000,0,37000,12000,1000,11000,-2286000
20200430,3050,鈺德,9.64,9.76,9.63,9.76,+0.19,1.99,424001,138,4114468,31000,10000,21000,0,0,0,0,0,0,21000
20200430,3051,力特,3.08,3.10,2.98,3.10,+0.02,0.65,193719,32,590497,0,0,0,0,0,0,0,0,0,0
20200430,3052,夆典,10.65,11.10,10.65,11.00,+0.35,3.29,1464612,445,15947947,226000,48000,178000,0,0,0,0,0,0,178000
20200430,3054,立萬利,24.75,24.75,24.45,24.65,+0.20,0.82,37516,24,922366,10000,0,10000,0,0,0,0,0,0,10000
20200430,3055,蔚華科,28.40,28.45,28.10,28.40,+0.05,0.18,89499,65,2536821,28000,4000,24000,0,0,0,0,0,0,24000
20200430,3056,總太,32.20,32.65,32.20,32.40,+0.40,1.25,2622496,1159,85209984,313000,159000,154000,21000,0,21000,0,0,0,175000
20200430,3057,喬鼎,4.65,5.06,4.65,5.06,+0.46,10.0,1078098,317,5362425,19000,39000,-20000,0,0,0,0,0,0,-20000
20200430,3058,立德,6.12,6.53,6.10,6.44,+0.32,5.23,1497225,369,9602782,73000,56000,17000,0,0,0,0,21000,-21000,-4000
20200430,3059,華晶科,19.60,19.65,19.25,19.45,+0.05,0.26,699417,361,13602136,147000,39000,108000,0,0,0,0,1000,-1000,107000
20200430,3060,銘異,12.90,12.90,12.50,12.65,+0.05,0.4,1021540,488,12960673,104000,83000,21000,0,0,0,0,0,0,21000
20200430,3062,建漢,14.90,15.10,14.80,14.90,0.00,0.00,2137872,886,31852930,242000,292000,-50000,0,0,0,0,22000,-22000,-72000
20200430,3090,日電貿,49.35,49.90,49.00,49.10,+0.55,1.13,2801209,1948,138439959,710000,354000,356000,0,0,0,55000,2000,53000,409000
20200430,3094,聯傑,17.15,17.30,16.95,17.25,+0.25,1.47,433897,213,7426971,72000,52000,20000,0,0,0,0,0,0,20000
20200430,3130,一零四,155.00,155.50,152.00,152.00,-1.00,-0.65,15332,22,2352628,2000,2000,0,0,0,0,1000,0,1000,1000
20200430,3149,正達,6.47,6.59,6.31,6.39,+0.01,0.16,557803,238,3574885,52000,71000,-19000,0,0,0,0,0,0,-19000
20200430,3164,景岳,23.75,24.15,23.60,24.00,+0.25,1.05,179001,93,4284474,31000,6000,25000,0,0,0,0,0,0,25000
20200430,3167,大量,39.60,40.50,39.60,40.50,+0.50,1.25,141979,82,5692803,22000,14000,8000,0,0,0,0,0,0,8000
20200430,3189,景碩,51.90,53.50,51.30,52.80,+1.80,3.53,8415703,4824,441309930,2426000,815000,1611000,70000,15000,55000,486000,263000,223000,1889000
20200430,3209,全科,19.25,19.30,19.15,19.25,+0.15,0.79,591146,293,11373352,60000,18000,42000,0,0,0,1000,0,1000,43000
20200430,3229,晟鈦,9.55,9.55,9.30,9.52,+0.22,2.37,132031,64,1236273,8000,0,8000,0,0,0,0,0,0,8000
20200430,3231,緯創,27.80,28.35,27.70,28.25,+0.55,1.99,27302723,10899,767674756,8941000,6402000,2539000,20000,0,20000,365000,750000,-385000,2174000
20200430,3257,虹冠電,56.00,56.10,55.10,55.60,+0.60,1.09,200084,119,11100144,17000,15000,2000,0,0,0,0,0,0,2000
20200430,3266,昇陽,13.15,13.25,12.95,13.25,-0.05,-0.38,456000,123,5942550,189000,0,189000,0,0,0,0,3000,-3000,186000
20200430,3296,勝德,13.40,13.45,13.30,13.35,+0.05,0.38,15000,13,200700,4000,0,4000,0,0,0,0,0,0,4000
20200430,3305,昇貿,19.20,19.65,19.15,19.50,+0.35,1.83,193300,130,3740515,53000,2000,51000,0,0,0,0,0,0,51000
20200430,3308,聯德,5.39,5.39,4.85,4.93,-0.07,-1.4,20000,19,101050,9000,9000,0,0,0,0,0,0,0,0
20200430,3311,閎暉,26.05,28.60,26.05,28.60,+2.60,10.0,2155802,830,60740610,77000,71000,6000,0,0,0,0,0,0,6000
20200430,3312,弘憶股,15.30,15.30,15.10,15.20,+0.10,0.66,573212,209,8710269,83000,93000,-10000,0,0,0,0,1000,-1000,-11000
20200430,3321,同泰,9.20,9.20,8.60,8.75,-0.08,-0.91,597901,217,5275455,38000,34000,4000,0,0,0,0,0,0,4000
20200430,3338,泰碩,98.00,98.70,96.70,96.70,-0.30,-0.31,5704847,4230,554909259,242000,274070,-32070,0,543000,-543000,66000,318000,-252000,-827070
20200430,3346,麗清,25.40,27.00,25.10,25.10,+0.25,1.01,805913,534,20880046,73000,68000,5000,0,0,0,0,0,0,5000
20200430,3356,奇偶,21.30,21.35,21.10,21.30,+0.35,1.67,303537,198,6447383,87000,13000,74000,0,0,0,0,0,0,74000
20200430,3376,新日興,133.00,134.00,129.00,132.00,-0.50,-0.38,3158959,2163,413012104,291000,490000,-199000,33000,632000,-599000,184000,147000,37000,-761000
20200430,3380,明泰,22.65,22.95,22.05,22.15,-0.20,-0.89,5727280,2393,128548392,540000,862000,-322000,0,0,0,141000,263000,-122000,-444000
20200430,3383,新世紀,4.70,4.70,4.55,4.67,-0.01,-0.21,173228,82,799266,22000,0,22000,0,0,0,0,0,0,22000
20200430,3406,玉晶光,464.00,487.00,464.00,485.50,+27.50,6.0,12177215,9663,5798059858,1667000,579000,1088000,42000,0,42000,887000,129000,758000,1888000
20200430,3413,京鼎,163.50,171.00,160.50,165.00,+5.00,3.12,3827412,2892,633930186,538000,365000,173000,12000,0,12000,202000,69000,133000,318000
20200430,3416,融程電,52.60,52.80,52.00,52.60,+0.20,0.38,92614,50,4850050,14000,0,14000,0,0,0,0,0,0,14000
20200430,3419,譁裕,14.30,14.30,13.90,13.95,0.00,0.00,450123,240,6301331,47000,53000,-6000,0,0,0,0,0,0,-6000
20200430,3432,台端,10.40,10.50,10.35,10.40,+0.05,0.48,57000,32,593100,8000,2000,6000,0,0,0,0,0,0,6000
20200430,3437,榮創,16.65,17.45,16.65,17.10,+0.55,3.32,3332701,1436,56872146,994000,170000,824000,0,0,0,0,0,0,824000
20200430,3443,創意,238.00,244.00,238.00,242.50,+4.50,1.89,1976502,1589,478363732,573000,346000,227000,0,10000,-10000,94000,22000,72000,289000
20200430,3450,聯鈞,72.50,72.90,70.70,71.00,-1.00,-1.39,4697549,3175,335559679,708000,291000,417000,4000,613000,-609000,7000,157000,-150000,-342000
20200430,3454,晶睿,70.60,72.30,70.60,72.10,+1.70,2.41,452601,392,32403068,123000,164000,-41000,1000,0,1000,0,0,0,-40000
20200430,3481,群創,6.52,6.59,6.46,6.54,+0.10,1.55,99297151,13522,648852076,44771492,24752051,20019441,0,0,0,2159000,227000,1932000,21951441
20200430,3494,誠研,3.54,3.62,3.52,3.59,+0.07,1.99,271287,83,962639,58000,0,58000,0,0,0,0,0,0,58000
20200430,3501,維熹,44.50,45.00,44.50,44.80,+0.55,1.24,177622,141,7954724,48000,13000,35000,0,0,0,0,2000,-2000,33000
20200430,3504,揚明光,60.20,60.50,59.30,59.80,+0.80,1.36,782010,599,46908001,231000,56000,175000,0,0,0,0,0,0,175000
20200430,3515,華擎,118.50,119.50,115.50,117.00,+1.00,0.86,4424826,3261,518409968,476000,621000,-145000,9000,669000,-660000,37000,35000,2000,-803000
20200430,3518,柏騰,29.10,29.75,28.80,29.10,+0.45,1.57,737001,441,21539928,95000,121000,-26000,0,0,0,0,0,0,-26000
20200430,3528,安馳,38.25,38.30,38.05,38.25,+0.25,0.66,98662,80,3771918,9000,0,9000,0,0,0,0,0,0,9000
20200430,3530,晶相光,92.80,93.70,91.20,91.50,-0.80,-0.87,1963770,1492,181357848,346000,227000,119000,0,0,0,21000,55000,-34000,85000
20200430,3532,台勝科,138.50,150.50,138.50,148.50,+11.00,8.0,6469320,4814,944109540,1794000,396000,1398000,0,0,0,144000,209000,-65000,1333000
20200430,3533,嘉澤,326.00,336.00,323.00,335.00,+12.00,3.72,2158916,1732,714142028,203000,358000,-155000,297000,130000,167000,157000,65000,92000,104000
20200430,3535,晶彩科,16.65,16.80,16.10,16.10,-0.30,-1.83,4230330,1794,69323161,120000,751000,-631000,0,0,0,0,0,0,-631000
20200430,3536,誠創,3.12,3.12,2.93,2.93,-0.17,-5.48,65003,13,199578,0,0,0,0,0,0,0,0,0,0
20200430,3543,州巧,18.75,19.80,18.75,19.55,+0.80,4.27,2068132,961,39986567,46000,0,46000,0,0,0,0,0,0,46000
20200430,3545,敦泰,32.05,32.35,31.40,32.20,+0.15,0.47,10537940,4649,335484180,612000,4626864,-4014864,0,0,0,0,17000,-17000,-4031864
20200430,3550,聯穎,12.20,12.35,12.10,12.30,+0.20,1.65,127006,71,1552078,14000,0,14000,0,0,0,1000,0,1000,15000
20200430,3557,嘉威,57.70,58.00,56.40,57.50,+1.50,2.68,1599345,1045,91373065,82000,159000,-77000,0,0,0,0,0,0,-77000
20200430,3563,牧德,338.00,343.50,332.50,337.50,+7.00,2.12,1818509,1532,613307060,154000,187000,-33000,28000,0,28000,64000,15000,49000,44000
20200430,3576,聯合再生,5.20,5.29,5.17,5.28,+0.17,3.33,10064464,2358,52806361,3449000,273000,3176000,0,0,0,0,0,0,3176000
20200430,3583,辛耘,47.60,48.35,47.00,47.40,+0.25,0.53,679000,421,32363550,136000,114000,22000,0,0,0,0,0,0,22000
20200430,3588,通嘉,29.30,29.70,28.80,29.20,+0.10,0.34,342357,224,9942203,54000,48000,6000,0,0,0,0,0,0,6000
20200430,3591,艾笛森,12.60,12.75,12.45,12.75,+0.25,2.0,212365,102,2675863,18000,4000,14000,0,0,0,0,0,0,14000
20200430,3593,力銘,6.89,7.19,6.87,7.15,+0.28,4.08,142599,50,994093,22000,2000,20000,0,0,0,0,0,0,20000
20200430,3596,智易,81.50,82.00,80.60,80.90,-0.30,-0.37,2349895,1668,190442291,396000,562000,-166000,5000,0,5000,7000,56000,-49000,-210000
20200430,3605,宏致,25.10,25.60,24.60,24.65,+0.05,0.2,6059002,2502,152265748,105000,975000,-870000,0,0,0,0,1000,-1000,-871000
20200430,3607,谷崧,12.30,12.40,12.10,12.20,+0.10,0.83,523600,245,6391619,30000,31000,-1000,0,0,0,0,0,0,-1000
20200430,3617,碩天,81.70,83.90,81.70,83.70,+2.40,2.95,366049,287,30363916,43000,12000,31000,6000,0,6000,8000,3000,5000,42000
20200430,3622,洋華,19.40,19.50,19.25,19.40,+0.05,0.26,202150,103,3918943,50000,18000,32000,0,0,0,0,0,0,32000
20200430,3645,達邁,36.20,37.15,36.10,37.10,+1.25,3.49,635088,420,23288209,123000,61000,62000,0,0,0,0,0,0,62000
20200430,3653,健策,220.00,224.00,217.00,218.00,+0.50,0.23,4078658,2969,901513286,372000,379006,-7006,486000,111000,375000,140000,68000,72000,439994
20200430,3661,世芯-KY,277.50,295.50,277.00,294.00,+19.00,6.91,9191197,7185,2650371418,1226000,910000,316000,120000,45000,75000,219000,141000,78000,469000
20200430,3665,貿聯-KY,187.00,198.50,186.50,196.50,+13.00,7.08,6040860,4723,1163853200,511000,514517,-3517,315000,0,315000,229000,28000,201000,512483
20200430,3669,圓展,33.50,34.15,32.95,33.05,-0.30,-0.9,2666680,1472,88921773,99000,156000,-57000,0,0,0,0,1000,-1000,-58000
20200430,3673,TPK-KY,43.00,43.15,41.95,42.05,-0.45,-1.06,4907043,2851,207900315,599000,1503000,-904000,0,0,0,85000,105000,-20000,-924000
20200430,3679,新至陞,59.90,60.20,59.00,59.60,+0.10,0.17,142000,90,8495400,23000,33000,-10000,0,0,0,12000,0,12000,2000
20200430,3682,亞太電,6.94,6.98,6.84,6.90,+0.03,0.44,6993919,1875,48335195,2993752,832850,2160902,0,0,0,0,0,0,2160902
20200430,3686,達能,4.07,4.20,3.96,4.10,+0.03,0.74,682623,262,2773098,55000,4000,51000,0,0,0,0,0,0,51000
20200430,3694,海華,14.45,14.65,14.40,14.50,+0.15,1.05,135999,88,1974133,26000,2000,24000,0,0,0,0,0,0,24000
20200430,3698,隆達,18.15,18.25,17.60,17.60,-0.55,-3.03,7535935,3057,134174603,744000,769000,-25000,0,0,0,42000,70000,-28000,-53000
20200430,3701,大眾控,13.50,13.65,13.40,13.65,0.00,0.00,30998,44,419662,23000,0,23000,0,0,0,0,0,0,23000
20200430,3702,大聯大,38.65,38.95,38.60,38.95,+0.30,0.78,3523411,1771,136708714,1729000,1239800,489200,6000,0,6000,13000,492000,-479000,16200
20200430,3702A,大聯大甲特,49.50,49.65,49.50,49.60,+0.15,0.3,132062,78,6545519,11000,0,11000,0,0,0,0,0,0,11000
20200430,3703,欣陸,10.75,11.05,10.75,11.05,+0.30,2.79,1169105,325,12813905,243000,147000,96000,0,0,0,0,0,0,96000
20200430,3704,合勤控,16.20,16.65,15.60,15.80,-0.05,-0.32,9444797,3760,151178804,640000,995000,-355000,0,0,0,0,9000,-9000,-364000
20200430,3705,永信,44.95,45.00,44.55,44.55,-0.30,-0.67,744605,559,33344702,217000,433000,-216000,0,0,0,1000,0,1000,-215000
20200430,3706,神達,30.75,31.00,30.60,30.60,+0.10,0.33,8924607,3999,274085996,865000,2243207,-1378207,3000,175000,-172000,12000,9000,3000,-1547207
20200430,3708,上緯投控,71.60,73.10,71.40,72.60,+2.40,3.42,779264,592,56353736,205000,23000,182000,0,0,0,0,4000,-4000,178000
20200430,3711,日月光投控,65.90,67.50,65.70,67.10,+1.80,2.76,11778763,5296,785136613,7718062,5701700,2016362,73000,210000,-137000,110000,399000,-289000,1590362
20200430,3712,永崴投控,13.40,13.45,13.15,13.20,+0.05,0.38,449022,251,5943831,65000,59000,6000,0,0,0,0,0,0,6000
20200430,4104,佳醫,53.60,54.20,53.60,53.90,+0.40,0.75,389009,274,20953874,62000,37000,25000,1000,0,1000,1000,5000,-4000,22000
20200430,4106,雃博,26.00,26.35,25.45,26.00,+0.30,1.17,2808211,1380,72702837,348000,272000,76000,0,0,0,0,0,0,76000
20200430,4108,懷特,20.10,20.10,19.20,19.35,-0.75,-3.73,1403699,768,27371540,42000,124000,-82000,0,0,0,0,0,0,-82000
20200430,4119,旭富,136.00,138.00,133.00,133.50,+1.00,0.75,3143370,2366,424692950,146000,580000,-434000,6000,5000,1000,14000,19000,-5000,-438000
20200430,4133,亞諾法,42.20,43.10,41.20,41.90,+0.10,0.24,3255202,2145,136655750,85000,440000,-355000,0,0,0,0,0,0,-355000
20200430,4137,麗豐-KY,196.00,204.00,196.00,197.00,+2.00,1.03,936175,799,186346975,60000,374000,-314000,33000,0,33000,73000,9000,64000,-217000
20200430,4141,龍燈-KY,15.10,15.30,14.45,14.55,-0.05,-0.34,562100,212,8295050,66000,34000,32000,0,0,0,0,0,0,32000
20200430,4142,國光生,29.60,29.90,29.00,29.00,+0.05,0.17,10070789,4371,294611042,205000,1479000,-1274000,0,0,0,0,0,0,-1274000
20200430,4144,康聯-KY,20.45,21.30,20.35,20.75,+0.45,2.22,330680,264,6865030,50000,6000,44000,0,0,0,0,0,0,44000
20200430,4148,全宇生技-KY,35.70,35.70,33.05,34.20,+1.20,3.64,806109,587,27699475,68000,29000,39000,0,0,0,0,2000,-2000,37000
20200430,4155,訊映,28.35,28.35,27.95,28.25,+0.15,0.53,513398,309,14454072,101000,53000,48000,0,0,0,0,0,0,48000
20200430,4164,承業醫,36.10,36.40,35.90,36.00,+0.30,0.84,283747,194,10216823,80000,27000,53000,2000,0,2000,0,0,0,55000
20200430,4190,佐登-KY,83.80,84.00,82.30,82.40,+0.10,0.12,585000,470,48413000,76000,157000,-81000,0,150000,-150000,28000,27000,1000,-230000
20200430,4306,炎洲,11.20,11.20,11.05,11.10,+0.25,2.3,1104668,494,12282348,239000,53000,186000,0,0,0,0,0,0,186000
20200430,4414,如興,9.25,9.39,9.11,9.30,+0.22,2.42,3712332,1003,34197462,987000,231000,756000,0,0,0,10000,0,10000,766000
20200430,4426,利勤,32.40,32.50,31.85,32.30,+0.45,1.41,815094,518,26184031,252000,79000,173000,0,0,0,0,4000,-4000,169000
20200430,4438,廣越,121.00,126.50,121.00,126.50,+7.00,5.86,292716,255,36180716,66000,56000,10000,0,0,0,0,0,0,10000
20200430,4439,冠星-KY,126.00,136.50,125.50,136.50,+12.00,9.64,207000,162,27562000,2000,0,2000,0,0,0,0,0,0,2000
20200430,4526,東台,13.50,13.50,13.05,13.25,+0.05,0.38,784563,353,10408630,67000,228000,-161000,0,0,0,0,0,0,-161000
20200430,4532,瑞智,17.10,17.30,17.00,17.10,+0.35,2.09,1454288,890,24838023,205000,200000,5000,0,0,0,0,0,0,5000
20200430,4536,拓凱,108.00,112.50,105.50,111.00,+4.50,4.23,1610462,973,176137244,95000,275000,-180000,0,0,0,29000,2000,27000,-153000
20200430,4540,全球傳動,53.90,56.00,53.70,54.10,+0.40,0.74,1311618,939,71720093,149000,110000,39000,0,0,0,0,0,0,39000
20200430,4545,銘鈺,27.80,27.80,26.30,26.45,+0.35,1.34,199001,106,5309126,19000,11000,8000,0,0,0,0,1000,-1000,7000
20200430,4551,智伸科,139.00,146.00,138.50,141.50,+4.50,3.28,2166207,1697,308970015,194000,261000,-67000,99000,0,99000,50000,18000,32000,64000
20200430,4552,力達-KY,32.00,32.35,31.90,32.10,+0.45,1.42,233630,180,7506073,77000,5000,72000,0,0,0,0,0,0,72000
20200430,4555,氣立,57.50,58.30,55.50,55.90,-1.60,-2.78,407209,326,23078986,26000,28000,-2000,0,0,0,0,0,0,-2000
20200430,4557,永新-KY,66.30,67.90,66.30,67.50,+1.50,2.27,50101,41,3364067,8000,0,8000,0,0,0,0,0,0,8000
20200430,4560,強信-KY,48.85,50.20,48.50,49.00,+0.50,1.03,409017,278,20084944,178000,174000,4000,0,0,0,0,0,0,4000
20200430,4562,穎漢,19.60,19.60,17.85,18.05,+0.20,1.12,764000,330,14480150,34000,28000,6000,0,0,0,0,0,0,6000
20200430,4564,元翎,31.25,32.60,31.20,32.55,+1.45,4.66,1290566,768,41248421,219000,120000,99000,0,0,0,6000,0,6000,105000
20200430,4566,時碩工業,37.50,38.90,37.25,38.40,+1.15,3.09,524200,380,19856210,129000,20000,109000,0,0,0,0,3000,-3000,106000
20200430,4571,鈞興-KY,60.40,62.20,59.50,59.90,+0.10,0.17,63014,57,3795438,27000,8000,19000,0,0,0,0,1000,-1000,18000
20200430,4572,駐龍,86.00,88.60,85.90,88.00,+3.00,3.53,124040,108,10866544,18000,5000,13000,0,0,0,0,0,0,13000
20200430,4576,大銀微系統,72.80,77.00,72.60,76.70,+4.40,6.09,556230,430,41952238,73000,67000,6000,0,0,0,0,0,0,6000
20200430,4581,光隆精密-KY,39.45,39.80,39.40,39.45,+0.05,0.13,37000,34,1463300,0,2000,-2000,0,0,0,0,0,0,-2000
20200430,4720,德淵,14.80,15.05,14.30,14.45,-0.55,-3.67,1840816,892,26942908,51000,65000,-14000,0,0,0,0,0,0,-14000
20200430,4722,國精化,26.00,26.25,26.00,26.20,+0.30,1.16,226501,121,5923426,54000,9000,45000,0,0,0,1000,0,1000,46000
20200430,4725,信昌化,8.85,8.96,8.82,8.84,+0.06,0.68,844042,344,7480335,158000,80000,78000,0,0,0,0,0,0,78000
20200430,4737,華廣,68.00,68.40,67.60,67.80,+0.10,0.15,96016,71,6516594,10000,41000,-31000,0,0,0,0,0,0,-31000
20200430,4739,康普,63.00,65.00,63.00,63.90,+0.90,1.43,1520467,978,97441755,155000,198000,-43000,100000,0,100000,0,0,0,57000
20200430,4746,台耀,50.30,50.30,48.10,50.30,+4.55,9.95,23594937,11123,1176673550,899000,629000,270000,300000,0,300000,7000,14000,-7000,563000
20200430,4755,三福化,44.40,45.40,44.40,44.85,+0.55,1.24,61000,53,2733800,14000,10000,4000,0,0,0,1000,0,1000,5000
20200430,4763,材料-KY,112.50,112.50,111.00,112.00,+1.00,0.9,168479,147,18810408,21000,1000,20000,0,0,0,2000,2000,0,20000
20200430,4764,雙鍵,60.10,60.50,60.00,60.00,0.00,0.00,21500,22,1291800,6000,10000,-4000,0,0,0,0,0,0,-4000
20200430,4766,南寶,134.50,134.50,128.50,130.50,-1.00,-0.76,401102,325,52428464,55000,49000,6000,0,0,0,1000,0,1000,7000
20200430,4807,日成-KY,23.05,24.20,23.05,23.75,+0.30,1.28,55001,50,1316224,4000,1000,3000,0,0,0,0,0,0,3000
20200430,4904,遠傳,66.40,67.00,66.40,66.40,0.00,0.00,4465694,2308,297486181,2901000,3280000,-379000,10000,28000,-18000,42000,15000,27000,-370000
20200430,4906,正文,20.85,20.95,20.70,20.80,+0.10,0.48,2597027,1058,54037952,548000,170000,378000,0,0,0,4000,20000,-16000,362000
20200430,4912,聯德控股-KY,81.40,81.90,80.20,80.40,+0.20,0.25,119000,90,9617100,24000,1000,23000,0,0,0,0,0,0,23000
20200430,4915,致伸,47.80,48.10,47.00,47.10,-0.70,-1.46,5751444,3438,272236747,796000,2234000,-1438000,5000,0,5000,3000,15000,-12000,-1445000
20200430,4916,事欣科,26.95,27.10,26.85,27.10,+0.30,1.12,643294,352,17376213,126000,12000,114000,0,0,0,0,0,0,114000
20200430,4919,新唐,37.65,37.95,37.40,37.70,+0.40,1.07,1595683,878,60040825,293000,76000,217000,2000,0,2000,7000,10000,-3000,216000
20200430,4927,泰鼎-KY,56.70,57.00,55.60,56.30,0.00,0.00,5544343,3772,310769073,345000,404000,-59000,0,524000,-524000,333000,207000,126000,-457000
20200430,4930,燦星網,9.67,9.76,9.65,9.65,-0.02,-0.21,81093,65,786270,26000,10000,16000,0,0,0,0,0,0,16000
20200430,4934,太極,15.25,15.35,15.00,15.05,-0.10,-0.66,2861092,1202,43261380,164000,281000,-117000,0,0,0,0,0,0,-117000
20200430,4935,茂林-KY,129.50,130.50,126.50,128.50,+1.00,0.78,2582090,1819,331101474,276000,218000,58000,0,0,0,53000,72000,-19000,39000
20200430,4938,和碩,66.00,66.40,65.70,66.10,+0.60,0.92,13207118,5397,871815488,7673000,5910000,1763000,24000,0,24000,179000,262000,-83000,1704000
20200430,4942,嘉彰,33.00,33.40,33.00,33.10,+0.30,0.91,600000,340,19887700,83000,287000,-204000,15000,0,15000,0,3000,-3000,-192000
20200430,4943,康控-KY,120.50,128.50,120.50,128.50,+11.50,9.83,10306146,5877,1311381756,740000,647000,93000,0,0,0,93000,31000,62000,155000
20200430,4952,凌通,29.90,29.90,29.60,29.70,0.00,0.00,387000,224,11509600,47000,11000,36000,0,0,0,0,0,0,36000
20200430,4956,光鋐,18.60,19.25,18.40,19.25,+1.75,10.0,12398222,5134,234458170,1862000,367000,1495000,0,0,0,0,0,0,1495000
20200430,4958,臻鼎-KY,105.00,109.50,104.00,108.00,+4.00,3.85,12936697,7645,1386401473,1649000,4676000,-3027000,1439000,0,1439000,341000,70000,271000,-1317000
20200430,4960,誠美材,7.33,7.33,7.10,7.12,-0.11,-1.52,2214184,661,15939003,354000,239000,115000,0,0,0,0,2000,-2000,113000
20200430,4961,天鈺,28.10,28.25,27.80,28.00,+0.40,1.45,734000,394,20589850,225000,44000,181000,0,0,0,0,0,0,181000
20200430,4967,十銓,42.90,42.90,41.50,41.50,-0.60,-1.43,7810993,3935,329952004,681000,646000,35000,0,0,0,0,0,0,35000
20200430,4968,立積,179.00,186.50,177.00,180.00,+4.00,2.27,11006981,8038,2002157080,974000,759000,215000,131000,0,131000,269000,65000,204000,550000
20200430,4976,佳凌,18.45,18.45,18.20,18.45,+0.40,2.22,349556,206,6406506,94000,50000,44000,0,0,0,0,1000,-1000,43000
20200430,4977,眾達-KY,112.00,113.50,110.50,112.50,+2.50,2.27,3880492,2611,435676104,519000,385000,134000,0,0,0,20000,3000,17000,151000
20200430,4989,榮科,19.50,19.50,18.80,19.00,-0.25,-1.3,1044056,546,20085842,42000,88000,-46000,0,0,0,0,0,0,-46000
20200430,4994,傳奇,64.20,67.20,64.20,64.80,+0.60,0.93,430328,351,28184391,68328,92000,-23672,0,0,0,9000,4000,5000,-18672
20200430,4999,鑫禾,39.50,39.75,39.25,39.30,+0.30,0.77,116691,90,4601854,14000,22000,-8000,0,0,0,0,0,0,-8000
20200430,5007,三星,46.00,46.50,45.90,46.45,+0.45,0.98,164100,119,7598995,124000,18000,106000,0,0,0,0,0,0,106000
20200430,5203,訊連,119.00,119.00,115.00,115.50,-2.00,-1.7,1359432,1099,158638112,106000,143000,-37000,0,0,0,5000,54000,-49000,-86000
20200430,5215,科嘉-KY,79.00,79.60,74.80,75.70,-1.00,-1.3,5425428,3553,417685810,267000,454000,-187000,0,124000,-124000,0,10000,-10000,-321000
20200430,5225,東科-KY,26.40,26.90,26.20,26.90,+0.80,3.07,612000,377,16220150,185000,41000,144000,0,0,0,0,0,0,144000
20200430,5234,達興材料,85.50,86.00,84.40,85.20,0.00,0.00,261300,216,22276020,37000,20000,17000,1000,0,1000,0,0,0,18000
20200430,5243,乙盛-KY,29.60,30.00,29.50,29.85,+0.40,1.36,711100,383,21176345,182000,111000,71000,0,0,0,0,0,0,71000
20200430,5258,虹堡,24.60,25.00,24.30,24.40,+0.15,0.62,506219,310,12407460,26000,86000,-60000,0,0,0,0,1000,-1000,-61000
20200430,5264,鎧勝-KY,45.70,47.30,44.65,46.85,+1.60,3.54,3788644,2288,175126557,581000,724689,-143689,400000,0,400000,84000,10000,74000,330311
20200430,5269,祥碩,886.00,895.00,823.00,838.00,-38.00,-4.34,2640097,2574,2240868480,646500,393000,253500,0,487000,-487000,31000,85000,-54000,-287500
20200430,5283,禾聯碩,95.40,96.30,95.40,96.10,+0.70,0.73,210078,143,20165705,48000,10000,38000,0,0,0,1000,0,1000,39000
20200430,5284,jpp-KY,34.05,35.20,33.80,34.65,+1.05,3.12,138000,99,4770750,5000,3000,2000,0,0,0,0,0,0,2000
20200430,5285,界霖,44.40,45.45,44.15,45.20,+1.25,2.84,719300,438,32329325,75000,30000,45000,0,0,0,0,3000,-3000,42000
20200430,5288,豐祥-KY,96.70,98.20,95.60,98.20,+3.40,3.59,477086,382,46362679,173000,13000,160000,15000,30000,-15000,0,1000,-1000,144000
20200430,5305,敦南,41.30,41.30,41.15,41.30,+0.10,0.24,226911,149,9353890,182000,69000,113000,0,0,0,0,0,0,113000
20200430,5388,中磊,75.20,75.90,74.60,74.90,+0.40,0.54,2147554,1146,161139889,250000,394000,-144000,7000,0,7000,15000,29000,-14000,-151000
20200430,5434,崇越,101.00,103.00,100.50,103.00,+3.00,3.0,1274076,970,129887828,317000,248000,69000,2000,0,2000,10000,56000,-46000,25000
20200430,5469,瀚宇博,39.45,40.00,39.10,40.00,+1.10,2.83,7783296,3307,308065922,2006000,619000,1387000,17000,0,17000,314000,43000,271000,1675000
20200430,5471,松翰,48.00,48.10,46.00,46.10,-1.65,-3.46,13233214,7824,616045127,306000,2151000,-1845000,0,0,0,9000,62000,-53000,-1898000
20200430,5484,慧友,8.69,9.30,8.69,9.30,+0.20,2.2,40068,33,361613,7000,0,7000,0,0,0,1000,0,1000,8000
20200430,5515,建國,10.10,10.10,9.98,10.00,-0.05,-0.5,1419883,253,14205908,93000,560000,-467000,0,0,0,0,0,0,-467000
20200430,5519,隆大,14.15,14.45,14.10,14.45,+0.40,2.85,1628592,590,23365083,351000,34000,317000,0,0,0,0,0,0,317000
20200430,5521,工信,9.12,9.25,8.87,9.12,+0.03,0.33,3192835,808,28839313,426000,406000,20000,0,0,0,0,0,0,20000
20200430,5522,遠雄,42.90,43.00,42.35,43.00,+0.15,0.35,1733966,982,74299138,598000,959000,-361000,0,0,0,0,0,0,-361000
20200430,5525,順天,20.05,20.30,20.05,20.25,+0.30,1.5,109900,76,2221674,65000,3000,62000,0,0,0,0,0,0,62000
20200430,5531,鄉林,9.04,9.20,9.03,9.11,+0.13,1.45,961498,403,8761637,642000,300000,342000,0,0,0,0,0,0,342000
20200430,5533,皇鼎,15.60,15.65,15.45,15.65,+0.20,1.29,65500,24,1020699,17000,0,17000,0,0,0,0,0,0,17000
20200430,5534,長虹,82.80,82.80,81.40,82.40,+0.80,0.98,838138,577,68730867,183000,368000,-185000,5000,0,5000,0,4000,-4000,-184000
20200430,5538,東明-KY,29.50,29.50,28.55,28.80,-0.70,-2.37,27000,23,791150,20000,13000,7000,0,0,0,0,0,0,7000
20200430,5607,遠雄港,22.35,22.40,21.85,22.25,+0.45,2.06,1248180,457,27629346,188000,344000,-156000,0,0,0,0,0,0,-156000
20200430,5608,四維航,5.81,5.93,5.80,5.88,+0.18,3.16,1586462,518,9290544,149000,103000,46000,0,0,0,0,0,0,46000
20200430,5706,鳳凰,31.25,32.20,31.25,32.05,+1.10,3.55,255668,192,8135903,40000,9000,31000,0,0,0,0,0,0,31000
20200430,5871,中租-KY,112.50,116.00,112.50,114.50,+3.50,3.15,10325331,6006,1178918870,3565000,3494218,70782,217000,0,217000,59000,51000,8000,295782
20200430,5876,上海商銀,44.10,44.60,43.75,44.15,+0.45,1.03,6983969,2612,309177367,4088000,2383518,1704482,28000,0,28000,52000,3412,48588,1781070
20200430,5880,合庫金,20.10,20.20,20.05,20.10,+0.10,0.5,24388622,5736,490576623,13032000,6563338,6468662,55000,0,55000,88000,0,88000,6611662
20200430,5906,台南-KY,16.40,16.75,16.40,16.55,+0.05,0.3,145000,81,2396600,8000,5000,3000,0,0,0,0,0,0,3000
20200430,5907,大洋-KY,25.30,25.30,24.00,24.50,+1.50,6.52,3130199,1298,77979275,122000,259000,-137000,0,0,0,0,0,0,-137000
20200430,6005,群益證,9.70,9.86,9.67,9.82,+0.20,2.08,4877826,1603,47746991,2013000,1463000,550000,41000,0,41000,0,0,0,591000
20200430,6024,群益期,38.55,39.45,38.50,39.40,+1.05,2.74,645299,388,25235675,151000,54241,96759,0,0,0,0,0,0,96759
20200430,6108,競國,21.90,22.20,21.90,22.05,+0.20,0.92,325003,202,7159066,63000,43000,20000,0,0,0,0,5000,-5000,15000
20200430,6112,聚碩,35.55,35.65,35.45,35.55,+0.10,0.28,725269,443,25776502,124000,36000,88000,0,0,0,0,0,0,88000
20200430,6115,鎰勝,43.50,43.95,43.50,43.85,+0.35,0.8,257179,194,11222144,67000,29000,38000,0,0,0,0,0,0,38000
20200430,6116,彩晶,6.31,6.39,6.29,6.32,+0.06,0.96,18753375,3351,118725212,5511000,2135000,3376000,0,0,0,655000,320000,335000,3711000
20200430,6117,迎廣,15.65,15.95,15.55,15.90,+0.30,1.92,39050,24,616285,9000,2000,7000,0,0,0,0,0,0,7000
20200430,6120,達運,11.70,11.80,11.60,11.75,+0.15,1.29,1668728,655,19535915,546000,165000,381000,0,0,0,0,2000,-2000,379000
20200430,6128,上福,28.70,29.00,28.70,28.95,+0.30,1.05,134000,97,3872650,44000,0,44000,0,0,0,0,0,0,44000
20200430,6131,鈞泰,3.05,3.05,3.00,3.00,-0.10,-3.23,48005,13,144765,0,0,0,0,0,0,0,0,0,0
20200430,6133,金橋,6.91,7.00,6.91,6.93,+0.05,0.73,83200,41,579195,18000,0,18000,0,0,0,0,5000,-5000,13000
20200430,6136,富爾特,18.40,18.55,18.40,18.50,+0.10,0.54,255431,133,4717341,37000,0,37000,0,0,0,0,0,0,37000
20200430,6139,亞翔,25.50,25.80,25.35,25.70,+0.40,1.58,835500,492,21394999,236000,25000,211000,21000,0,21000,0,6000,-6000,226000
20200430,6141,柏承,18.25,18.95,18.15,18.50,+0.30,1.65,2282541,1072,42109585,570000,235000,335000,0,0,0,0,0,0,335000
20200430,6142,友勁,6.40,6.69,6.40,6.64,+0.17,2.63,255446,147,1682217,89000,16000,73000,0,0,0,5000,0,5000,78000
20200430,6152,百一,6.50,6.70,6.50,6.50,+0.02,0.31,293225,134,1918482,37000,1000,36000,0,0,0,0,0,0,36000
20200430,6153,嘉聯益,28.45,28.75,28.25,28.45,+0.45,1.61,5968911,3022,169958511,1011000,657000,354000,0,0,0,235000,195000,40000,394000
20200430,6155,鈞寶,23.80,24.40,23.80,24.05,+0.15,0.63,1128659,688,27239717,196000,138000,58000,0,0,0,0,0,0,58000
20200430,6164,華興,5.63,5.76,5.63,5.68,+0.05,0.89,255690,118,1447524,16000,5000,11000,0,0,0,0,3000,-3000,8000
20200430,6165,捷泰,25.55,26.50,25.55,26.50,+1.00,3.92,1838885,894,48182062,184000,43000,141000,0,0,0,0,0,0,141000
20200430,6166,凌華,64.70,66.40,63.80,66.20,+1.50,2.32,416968,314,26999295,118000,114000,4000,2000,0,2000,3000,4000,-1000,5000
20200430,6168,宏齊,11.90,12.00,11.80,12.00,+0.15,1.27,590985,246,7022270,72000,25000,47000,0,0,0,0,1000,-1000,46000
20200430,6172,互億,22.40,22.40,21.85,21.85,-0.55,-2.46,328200,169,7258259,7000,17000,-10000,0,0,0,0,0,0,-10000
20200430,6176,瑞儀,97.80,98.80,97.30,98.80,+1.20,1.23,7694948,5121,753982846,1415000,3221000,-1806000,33000,530000,-497000,28000,174000,-146000,-2449000
20200430,6177,達麗,29.50,29.60,29.25,29.35,+0.20,0.69,878089,495,25837902,157000,66000,91000,0,0,0,0,0,0,91000
20200430,6183,關貿,42.10,42.25,41.90,42.25,+0.25,0.6,132551,112,5569216,29000,19000,10000,0,0,0,0,0,0,10000
20200430,6184,大豐電,41.50,41.70,41.35,41.70,+0.35,0.85,135020,88,5612184,63000,4000,59000,0,0,0,0,0,0,59000
20200430,6189,豐藝,33.10,33.25,32.90,33.25,+0.35,1.06,426629,267,14138069,85000,2000,83000,0,0,0,0,1000,-1000,82000
20200430,6191,精成科,14.15,14.25,14.00,14.25,+0.25,1.79,3727161,1036,52844668,1256000,238000,1018000,14000,0,14000,0,1000,-1000,1031000
20200430,6192,巨路,64.80,65.50,64.10,65.00,+1.10,1.72,264755,202,17209251,52000,71000,-19000,1000,0,1000,0,8000,-8000,-26000
20200430,6196,帆宣,71.80,75.70,71.10,74.50,+3.50,4.93,5455242,3749,402664751,637000,537000,100000,0,90000,-90000,125000,25000,100000,110000
20200430,6197,佳必琪,31.00,31.35,30.95,31.30,+0.50,1.62,842102,492,26241215,137000,57000,80000,0,0,0,0,1000,-1000,79000
20200430,6201,亞弘電,33.00,33.20,32.90,33.00,+0.25,0.76,75000,52,2476550,23000,0,23000,0,0,0,0,0,0,23000
20200430,6202,盛群,66.50,66.70,66.00,66.30,+0.10,0.15,1560130,1140,103343644,165000,300000,-135000,2000,281000,-279000,1000,0,1000,-413000
20200430,6205,詮欣,23.30,23.75,23.25,23.75,+0.80,3.49,78139,61,1837226,8000,0,8000,0,0,0,0,0,0,8000
20200430,6206,飛捷,68.50,68.70,67.50,68.40,+0.50,0.74,269666,193,18411452,58000,98000,-40000,1000,0,1000,0,0,0,-39000
20200430,6209,今國光,22.65,23.10,22.05,23.10,+1.20,5.48,1826912,789,41065205,338000,121000,217000,0,0,0,0,0,0,217000
20200430,6213,聯茂,146.50,147.00,143.00,145.00,+0.50,0.35,4686890,3383,678918050,671399,369804,301595,284000,601000,-317000,191000,265000,-74000,-89405
20200430,6214,精誠,80.50,81.30,80.50,81.30,+1.10,1.37,690296,490,55843976,262000,89000,173000,6000,0,6000,0,3000,-3000,176000
20200430,6215,和椿,14.20,14.40,14.05,14.15,+0.10,0.71,217106,126,3080299,12000,11000,1000,0,0,0,0,0,0,1000
20200430,6216,居易,27.50,27.60,27.35,27.55,+0.10,0.36,176640,104,4856095,33000,9000,24000,0,0,0,0,0,0,24000
20200430,6224,聚鼎,61.20,61.70,61.20,61.50,+0.50,0.82,437707,324,26890977,52000,19000,33000,2000,0,2000,3000,2000,1000,36000
20200430,6225,天瀚,2.71,2.71,2.71,2.71,-0.30,-9.97,19748,13,53516,0,0,0,0,0,0,0,0,0,0
20200430,6226,光鼎,8.30,8.30,8.16,8.16,-0.11,-1.33,1585689,535,13006679,55000,27000,28000,0,0,0,0,0,0,28000
20200430,6230,超眾,252.50,256.50,250.00,250.50,+0.50,0.2,1522365,1275,384327480,178000,188000,-10000,20000,0,20000,45000,42000,3000,13000
20200430,6235,華孚,11.10,11.20,11.00,11.00,0.00,0.00,540873,181,5983403,126000,11000,115000,0,0,0,0,0,0,115000
20200430,6239,力成,99.60,102.00,99.00,101.00,+2.70,2.75,7818044,4676,786897015,3384000,3098000,286000,357000,0,357000,77000,70000,7000,650000
20200430,6243,迅杰,8.50,8.70,8.50,8.67,+0.24,2.85,279506,123,2412104,39000,4000,35000,0,0,0,0,0,0,35000
20200430,6251,定穎,19.65,19.90,19.20,19.30,-0.30,-1.53,20737542,7216,405362447,1137000,2923000,-1786000,22000,798000,-776000,550000,201000,349000,-2213000
20200430,6257,矽格,36.50,36.70,36.25,36.60,+0.50,1.39,5758001,2925,210191365,1134000,568000,566000,364000,0,364000,340000,65729,274271,1204271
20200430,6269,台郡,109.00,110.00,107.00,108.50,0.00,0.00,10324509,5843,1119802219,514000,3822788,-3308788,898000,918000,-20000,190000,100000,90000,-3238788
20200430,6271,同欣電,118.00,123.00,116.50,122.50,+6.50,5.6,7207395,4824,865348883,1078000,789000,289000,853000,588000,265000,186000,93000,93000,647000
20200430,6277,宏正,91.50,92.30,90.80,91.80,+0.60,0.66,393228,287,36020062,137000,14000,123000,0,0,0,0,1000,-1000,122000
20200430,6278,台表科,91.80,91.90,89.60,90.50,+0.20,0.22,6224636,4219,563313155,1363000,887000,476000,2000,361000,-359000,49000,98000,-49000,68000
20200430,6281,全國電,66.70,67.20,66.50,67.10,+0.40,0.6,128434,93,8596519,45000,4000,41000,0,0,0,10000,4000,6000,47000
20200430,6282,康舒,20.70,21.00,20.55,20.90,+0.40,1.95,3460703,1453,71886746,680000,179000,501000,28000,0,28000,48000,99000,-51000,478000
20200430,6283,淳安,19.60,19.60,19.00,19.10,+0.05,0.26,220050,124,4235800,82000,23000,59000,0,0,0,0,0,0,59000
20200430,6285,啟碁,62.40,62.50,61.70,62.40,+0.50,0.81,1955420,1286,121476000,815000,323288,491712,0,40000,-40000,6000,31000,-25000,426712
20200430,6288,聯嘉,19.30,19.40,19.05,19.25,+0.35,1.85,2757176,1084,53011051,527000,120000,407000,0,0,0,2000,3000,-1000,406000
20200430,6289,華上,1.87,1.90,1.81,1.90,+0.04,2.15,65368,27,119347,0,0,0,0,0,0,0,0,0,0
20200430,6405,悅城,13.90,13.95,13.55,13.95,+0.30,2.2,78000,36,1070500,7000,0,7000,0,0,0,0,1000,-1000,6000
20200430,6409,旭隼,711.00,719.00,697.00,710.00,+8.00,1.14,65893,75,46484565,39000,46450,-7450,0,0,0,0,1000,-1000,-8450
20200430,6412,群電,57.10,58.70,56.60,58.60,+1.60,2.81,1329375,923,77290800,673000,573000,100000,50000,0,50000,24000,0,24000,174000
20200430,6414,樺漢,193.00,196.00,191.50,195.50,+4.50,2.36,1359934,1129,264264498,255000,65000,190000,0,0,0,17000,38000,-21000,169000
20200430,6415,矽力-KY,1240.00,1245.00,1160.00,1195.00,-45.00,-3.63,811601,813,970678195,429000,432268,-3268,0,142000,-142000,8000,7000,1000,-144268
20200430,6416,瑞祺電通,134.50,136.00,131.50,133.50,+0.50,0.38,2592562,1871,346056308,88000,107000,-19000,40000,0,40000,72000,87000,-15000,6000
20200430,6431,光麗-KY,23.30,23.75,23.00,23.70,-0.05,-0.21,78050,37,1825975,11000,0,11000,0,0,0,0,0,0,11000
20200430,6442,光聖,35.40,36.20,35.40,36.20,+0.30,0.84,26000,13,935450,7000,0,7000,0,0,0,0,1000,-1000,6000
20200430,6443,元晶,5.65,5.67,5.57,5.61,+0.05,0.9,1851566,462,10398314,327000,89000,238000,0,0,0,0,0,0,238000
20200430,6449,鈺邦,32.10,32.40,31.30,32.00,+0.30,0.95,230055,164,7313942,19000,78000,-59000,0,0,0,3000,3000,0,-59000
20200430,6451,訊芯-KY,113.50,117.50,112.00,115.50,+3.50,3.12,4036409,2841,463201329,495000,316000,179000,0,0,0,29000,14000,15000,194000
20200430,6452,康友-KY,161.00,165.50,159.50,164.00,+5.00,3.14,1623500,1258,265410000,191000,161000,30000,0,0,0,54000,10000,44000,74000
20200430,6456,GIS-KY,95.80,96.80,95.10,95.60,+0.40,0.42,3769856,2563,361261876,745000,950000,-205000,166000,0,166000,66000,267000,-201000,-240000
20200430,6464,台數科,114.00,114.50,113.00,114.50,+0.50,0.44,39320,24,4483480,7000,2000,5000,0,0,0,0,0,0,5000
20200430,6477,安集,19.55,19.70,19.55,19.70,+0.20,1.03,231182,108,4544348,31000,12000,19000,0,0,0,0,2000,-2000,17000
20200430,6491,晶碩,122.50,132.00,122.00,127.50,+7.00,5.81,591033,514,75132724,46000,86000,-40000,0,0,0,16000,0,16000,-24000
20200430,6504,南六,224.00,224.00,212.00,216.50,-11.00,-4.84,3797882,3139,824621946,599051,356000,243051,0,38000,-38000,32000,25000,7000,212051
20200430,6505,台塑化,83.90,90.30,83.90,89.70,+6.00,7.17,11768238,7264,1037106400,4896000,3451000,1445000,486000,0,486000,9000,103000,-94000,1837000
20200430,6525,捷敏-KY,56.80,57.20,56.60,57.00,+0.60,1.06,222704,186,12666628,51000,32000,19000,0,0,0,0,7000,-7000,12000
20200430,6531,愛普,179.00,195.00,179.00,195.00,+17.50,9.86,16162126,10757,3040259570,958000,1043000,-85000,0,0,0,0,0,0,-85000
20200430,6533,晶心科,106.50,110.00,104.50,106.00,+1.50,1.44,2155098,1718,230754780,76000,306000,-230000,0,0,0,0,0,0,-230000
20200430,6541,泰福-KY,38.15,38.70,37.95,38.05,0.00,0.00,332386,233,12696845,83000,43000,40000,0,0,0,0,0,0,40000
20200430,6552,易華電,56.10,57.40,56.10,56.50,+0.60,1.07,2004515,1166,113898055,447000,248000,199000,0,0,0,37000,0,37000,236000
20200430,6558,興能高,44.40,44.45,43.85,43.85,-0.15,-0.34,1309131,896,57713714,75000,134000,-59000,0,0,0,0,1000,-1000,-60000
20200430,6573,虹揚-KY,18.20,18.35,18.00,18.05,-0.05,-0.28,34388,30,625134,3000,1000,2000,0,0,0,0,0,0,2000
20200430,6579,研揚,64.40,65.20,64.00,64.80,+1.00,1.57,77000,68,4985800,42000,6000,36000,0,0,0,0,0,0,36000
20200430,6581,鋼聯,61.50,64.50,61.50,63.40,+2.50,4.11,245269,195,15439152,30000,25000,5000,0,0,0,0,0,0,5000
20200430,6582,申豐,90.30,90.30,88.00,89.00,-1.30,-1.44,592477,478,52745753,113000,35000,78000,0,0,0,8000,4000,4000,82000
20200430,6591,動力-KY,42.90,46.35,42.60,45.90,+3.55,8.38,1866519,1314,84646644,151000,272000,-121000,0,0,0,0,3000,-3000,-124000
20200430,6592,和潤企業,80.70,81.30,80.00,80.00,-0.30,-0.37,2713922,1645,218583560,298000,229000,69000,10000,0,10000,7000,106000,-99000,-20000
20200430,6605,帝寶,47.40,47.40,46.90,47.20,+0.60,1.29,366770,259,17305974,95000,20000,75000,2000,0,2000,0,0,0,77000
20200430,6625,必應,38.00,38.20,38.00,38.20,+0.20,0.53,5624,10,213785,0,0,0,0,0,0,0,0,0,0
20200430,6641,基士德-KY,67.10,67.10,65.50,66.50,-0.10,-0.15,28110,26,1868170,2000,0,2000,0,0,0,0,0,0,2000
20200430,6655,科定,41.90,42.00,41.25,41.95,+0.05,0.12,77000,47,3227050,25000,3000,22000,0,0,0,0,0,0,22000
20200430,6666,羅麗芬-KY,123.50,130.00,123.50,125.50,+4.00,3.29,295210,270,37340854,15000,46000,-31000,0,0,0,0,100,-100,-31100
20200430,6668,中揚光,62.50,63.90,61.80,63.70,+2.20,3.58,825200,576,51796679,147000,81000,66000,0,0,0,0,0,0,66000
20200430,6669,緯穎,735.00,785.00,731.00,770.00,+45.00,6.21,3043818,2784,2306170134,1079000,477000,602000,261000,89000,172000,85000,89000,-4000,770000
20200430,6670,復盛應用,165.50,168.00,163.50,165.50,+1.50,0.91,1030155,739,170577650,125000,196000,-71000,10000,0,10000,0,26000,-26000,-87000
20200430,6671,三能-KY,36.50,37.50,36.50,36.60,+0.10,0.27,129000,51,4736650,11000,3000,8000,0,0,0,0,0,0,8000
20200430,6672,騰輝電子-KY,87.00,89.60,86.30,89.00,+3.00,3.49,1431620,1092,125631890,165000,91000,74000,0,0,0,0,0,0,74000
20200430,6674,鋐寶科技,23.05,25.00,22.95,24.95,+2.00,8.71,78000,64,1865450,18000,4000,14000,0,0,0,0,2000,-2000,12000
20200430,6698,旭暉應材,55.50,58.70,55.40,58.00,+4.50,8.41,1291917,946,73717789,44000,121000,-77000,0,0,0,50000,0,50000,-27000
20200430,6706,惠特,93.40,93.90,91.60,92.70,0.00,0.00,1149098,884,106304794,81000,76928,4072,0,0,0,0,0,0,4072
20200430,6715,嘉基,93.40,95.90,93.30,94.70,+1.50,1.61,165438,141,15646772,19000,18000,1000,0,0,0,0,0,0,1000
20200430,8011,台通,14.95,16.40,14.85,16.40,+1.45,9.7,5127257,2470,80497271,398000,259000,139000,0,0,0,0,0,0,139000
20200430,8016,矽創,144.50,146.50,142.00,146.50,+7.50,5.4,3449667,2636,499537549,600000,372000,228000,185000,0,185000,46000,43000,3000,416000
20200430,8021,尖點,19.40,19.75,19.40,19.50,+0.15,0.78,1039304,388,20301626,165000,97000,68000,0,0,0,8000,0,8000,76000
20200430,8028,昇陽半導體,52.50,53.00,51.60,52.80,+1.60,3.13,5252880,3051,275583640,717000,660000,57000,0,0,0,92000,9000,83000,140000
20200430,8033,雷虎,7.72,7.78,7.64,7.68,+0.04,0.52,199061,125,1532223,39000,12000,27000,0,0,0,0,0,0,27000
20200430,8039,台虹,47.40,47.45,46.75,46.75,+0.05,0.11,1909622,1191,89749745,262000,268000,-6000,0,0,0,77000,88000,-11000,-17000
20200430,8046,南電,73.50,73.50,70.40,71.30,-0.70,-0.97,10163381,6087,730881153,1987000,2022000,-35000,480000,0,480000,172000,448000,-276000,169000
20200430,8070,長華,162.50,162.50,160.00,161.50,+2.00,1.25,133027,106,21442860,10000,39000,-29000,3000,0,3000,4000,10000,-6000,-32000
20200430,8072,陞泰,21.70,21.80,21.10,21.10,-0.20,-0.94,173284,139,3717736,13000,0,13000,0,0,0,0,0,0,13000
20200430,8081,致新,131.00,133.50,128.50,131.50,+3.50,2.73,3645277,2475,478717787,822000,248000,574000,303000,0,303000,180000,54000,126000,1003000
20200430,8101,華冠,4.52,4.60,4.50,4.57,+0.07,1.56,665080,240,3014336,55000,7000,48000,0,0,0,0,0,0,48000
20200430,8103,瀚荃,23.00,24.35,22.75,23.90,+1.15,5.05,427257,287,10109315,40000,7000,33000,0,0,0,0,1000,-1000,32000
20200430,8104,錸寶,34.20,35.05,34.20,34.90,+0.80,2.35,347364,237,12064025,121000,8000,113000,0,0,0,0,0,0,113000
20200430,8105,凌巨,9.52,9.54,9.45,9.50,+0.08,0.85,1038004,399,9858397,209000,145000,64000,0,0,0,0,0,0,64000
20200430,8110,華東,10.50,10.80,10.30,10.50,+0.30,2.94,6425360,2029,67886993,244000,739000,-495000,35000,0,35000,16000,20000,-4000,-464000
20200430,8112,至上,34.40,34.45,33.50,33.70,-0.50,-1.46,9597644,4640,323684727,1582000,1953000,-371000,13000,169000,-156000,22000,9000,13000,-514000
20200430,8114,振樺電,90.30,91.80,90.30,91.80,+1.70,1.89,143523,111,13084008,23000,25000,-2000,2000,0,2000,0,5000,-5000,-5000
20200430,8131,福懋科,37.50,37.70,37.05,37.55,+0.25,0.67,731250,417,27366236,234000,88000,146000,6000,0,6000,14000,2000,12000,164000
20200430,8150,南茂,30.40,30.75,30.25,30.70,+0.55,1.82,6764362,3172,206534145,1005000,1074000,-69000,0,0,0,432000,50000,382000,313000
20200430,8163,達方,37.20,37.70,37.05,37.30,+0.35,0.95,2928373,1436,109345886,483000,490000,-7000,2000,0,2000,56000,16000,40000,35000
20200430,8201,無敵,8.28,8.65,8.28,8.41,+0.19,2.31,83786,65,704479,11000,3000,8000,0,0,0,0,0,0,8000
20200430,8210,勤誠,92.20,92.90,90.70,91.20,-0.80,-0.87,1337760,1066,122240260,105000,329000,-224000,4000,0,4000,65000,65000,0,-220000
20200430,8213,志超,33.85,34.00,33.50,33.80,+0.30,0.9,2989161,1278,100793788,264000,351000,-87000,13000,0,13000,44000,81000,-37000,-111000
20200430,8215,明基材,17.20,17.20,17.00,17.15,+0.15,0.88,2037802,846,34838647,699000,165000,534000,12000,0,12000,0,1000,-1000,545000
20200430,8222,寶一,13.65,14.30,13.65,14.00,+0.35,2.56,185109,115,2581985,18000,7000,11000,0,0,0,0,0,0,11000
20200430,8249,菱光,18.25,18.50,18.20,18.40,+0.25,1.38,225008,142,4117906,57000,23000,34000,0,0,0,0,1000,-1000,33000
20200430,8261,富鼎,22.90,23.30,22.80,23.30,+0.65,2.87,430778,298,9922421,80000,51000,29000,0,0,0,0,0,0,29000
20200430,8271,宇瞻,48.00,48.10,47.05,47.20,-0.40,-0.84,2591965,1601,123204038,457000,241000,216000,0,0,0,3000,3000,0,216000
20200430,8341,日友,255.50,258.00,255.50,258.00,+2.50,0.98,186471,181,47922018,117000,40000,77000,24000,0,24000,1000,0,1000,102000
20200430,8367,建新國際,24.90,25.40,24.90,25.15,+0.25,1.0,75500,56,1896724,19000,5000,14000,0,0,0,0,0,0,14000
20200430,8374,羅昇,20.25,20.35,20.15,20.25,0.00,0.00,95000,45,1921850,8000,1000,7000,0,0,0,0,0,0,7000
20200430,8404,百和興業-KY,31.50,31.85,30.60,31.00,+0.25,0.81,835942,528,25994002,112000,168000,-56000,0,0,0,0,0,0,-56000
20200430,8411,福貞-KY,10.95,10.95,10.85,10.95,0.00,0.00,85299,59,931252,20000,4000,16000,0,0,0,0,0,0,16000
20200430,8422,可寧衛,155.00,156.00,154.50,156.00,+2.00,1.3,236771,231,36819547,33000,30000,3000,5000,0,5000,5000,0,5000,13000
20200430,8427,基勝-KY,48.90,49.70,48.90,49.05,+0.65,1.34,16000,11,789600,10000,3000,7000,0,0,0,0,0,0,7000
20200430,8429,金麗-KY,7.39,7.58,7.36,7.50,+0.18,2.46,640106,329,4768493,50000,5000,45000,0,0,0,0,0,0,45000
20200430,8442,威宏-KY,43.00,43.50,43.00,43.50,+0.35,0.81,37600,31,1625460,7000,1000,6000,0,0,0,0,1000,-1000,5000
20200430,8443,阿瘦,8.51,8.65,8.50,8.65,+0.15,1.76,72050,47,618681,10000,0,10000,0,0,0,0,0,0,10000
20200430,8454,富邦媒,477.00,481.50,470.00,480.50,+7.50,1.59,191466,201,91392908,123000,21000,102000,0,0,0,15000,4000,11000,113000
20200430,8462,柏文,169.50,178.00,167.50,168.00,+2.50,1.51,1134424,1062,194179080,54000,204000,-150000,22000,0,22000,2000,26000,-24000,-152000
20200430,8463,潤泰材,34.70,36.50,34.55,36.00,+1.45,4.2,528001,334,18831536,96000,35000,61000,0,0,0,0,0,0,61000
20200430,8464,億豐,232.00,236.00,224.00,230.00,-3.00,-1.29,1207098,908,280300040,561000,759000,-198000,1000,0,1000,0,29000,-29000,-226000
20200430,8466,美吉吉-KY,64.90,67.30,64.30,67.00,+2.50,3.88,56000,40,3690600,36000,12000,24000,0,0,0,0,0,0,24000
20200430,8467,波力-KY,47.50,47.50,46.65,47.00,+0.35,0.75,9000,9,423250,3000,0,3000,0,0,0,0,0,0,3000
20200430,8473,山林水,41.90,42.35,41.90,42.30,+0.25,0.59,91427,70,3847796,44000,0,44000,0,0,0,0,0,0,44000
20200430,8478,東哥遊艇,33.80,36.55,33.80,36.45,+2.90,8.64,373014,309,13248613,25000,5000,20000,0,0,0,0,3000,-3000,17000
20200430,8480,泰昇-KY,135.00,137.50,134.50,134.50,+1.00,0.75,26000,24,3537500,11000,5000,6000,0,0,0,0,0,0,6000
20200430,8481,政伸,53.40,54.90,53.20,54.10,+0.50,0.93,15000,15,812200,6000,6000,0,0,0,0,0,0,0,0
20200430,8482,商億-KY,102.50,104.50,101.00,101.50,+0.50,0.5,77035,66,7856552,6000,1000,5000,0,0,0,0,0,0,5000
20200430,8488,吉源-KY,13.95,14.15,13.80,13.95,0.00,0.00,21000,16,292550,4000,0,4000,0,0,0,0,0,0,4000
20200430,8497,格威傳媒,67.70,67.70,67.50,67.50,-0.40,-0.59,4150,6,280280,2000,0,2000,0,0,0,0,0,0,2000
20200430,8499,鼎炫-KY,96.80,99.90,96.80,97.90,+1.90,1.98,375334,327,37007798,43000,32000,11000,0,0,0,0,0,0,11000
20200430,8926,台汽電,32.75,33.05,32.60,33.05,+0.50,1.54,1868319,938,61346217,647000,85000,562000,24000,0,24000,63000,5000,58000,644000
20200430,8940,新天地,9.42,9.57,9.30,9.43,+0.01,0.11,96015,57,903785,10000,0,10000,0,0,0,0,0,0,10000
20200430,8996,高力,64.20,66.30,64.00,64.20,+0.90,1.42,3881402,2673,252719164,449000,514000,-65000,68000,0,68000,10000,0,10000,13000
20200430,9103,美德醫療-DR,3.84,3.85,3.72,3.83,-0.08,-2.05,1631500,272,6205950,0,0,0,0,0,0,0,0,0,0
20200430,910322,康師傅-DR,28.00,28.00,28.00,28.00,+0.90,3.32,2000,1,56000,0,0,0,0,0,0,0,0,0,0
20200430,910482,聖馬丁-DR,0.27,0.28,0.27,0.28,0.00,0.00,617994,20,168038,0,0,0,0,0,0,0,0,0,0
20200430,9105,泰金寶-DR,2.70,2.70,2.64,2.67,+0.01,0.38,5758466,720,15326463,166000,229000,-63000,0,0,0,0,0,0,-63000
20200430,910861,神州-DR,,,,,0.00,0.00,0,0,0,0,0,0,0,0,0,0,0,0,0
20200430,9110,越南控-DR,1.38,1.50,1.37,1.47,+0.07,5.0,203000,48,289250,0,0,0,0,0,0,0,0,0,0
20200430,911608,明輝-DR,1.16,1.19,1.13,1.19,+0.03,2.59,113500,17,129850,0,0,0,0,0,0,0,0,0,0
20200430,911616,杜康-DR,0.90,0.93,0.87,0.92,0.00,0.00,119000,41,106390,0,0,0,0,0,0,0,0,0,0
20200430,911622,泰聚亨-DR,,,,,0.00,0.00,0,0,0,0,0,0,0,0,0,0,0,0,0
20200430,911868,同方友友-DR,0.94,0.94,0.93,0.93,-0.02,-2.11,116000,10,108890,0,0,0,0,0,0,0,0,0,0
20200430,912000,晨訊科-DR,1.84,1.89,1.84,1.87,+0.05,2.75,9000,5,16700,0,0,0,0,0,0,0,0,0,0
20200430,912398,友佳-DR,2.75,2.77,2.67,2.76,-0.03,-1.08,175666,29,480897,0,0,0,0,0,0,0,0,0,0
20200430,9136,巨騰-DR,8.38,9.01,8.38,8.95,+0.69,8.35,4428000,503,38882510,547000,2000,545000,0,0,0,0,0,0,545000
20200430,9188,精熙-DR,2.41,2.43,2.40,2.40,-0.02,-0.83,220000,47,528970,0,19000,-19000,0,0,0,0,0,0,-19000
20200430,9802,鈺齊-KY,96.70,98.50,96.00,97.40,+0.90,0.93,3181256,2298,310682888,596000,662000,-66000,381000,0,381000,9000,120000,-111000,204000
20200430,9902,台火,8.64,8.83,8.57,8.82,+0.18,2.08,461504,193,4029023,37000,22000,15000,0,0,0,0,0,0,15000
20200430,9904,寶成,27.80,28.20,27.70,28.20,+0.35,1.26,17991600,8696,503302889,6277090,3032000,3245090,15000,0,15000,12000,22000,-10000,3250090
20200430,9905,大華,21.20,21.30,20.85,21.25,+0.45,2.16,151520,125,3208769,71000,31000,40000,0,0,0,0,0,0,40000
20200430,9906,欣巴巴,22.00,22.40,21.95,22.30,0.00,0.00,61832,45,1370369,13000,0,13000,0,0,0,0,0,0,13000
20200430,9907,統一實,9.03,9.20,9.02,9.19,+0.20,2.22,2927576,1270,26679200,1079000,907000,172000,0,0,0,0,0,0,172000
20200430,9908,大台北,30.25,30.40,30.10,30.30,+0.05,0.17,248100,180,7512600,132000,25000,107000,0,0,0,0,0,0,107000
20200430,9910,豐泰,169.50,173.50,167.00,171.00,+2.50,1.48,2896781,1938,493548051,904000,1111009,-207009,79000,7000,72000,81000,59000,22000,-113009
20200430,9911,櫻花,47.10,47.55,47.05,47.30,+0.35,0.75,385237,289,18227439,94000,53000,41000,5000,0,5000,2000,0,2000,48000
20200430,9912,偉聯,6.45,6.45,6.24,6.44,+0.20,3.21,78003,58,496488,9000,0,9000,0,0,0,0,0,0,9000
20200430,9914,美利達,154.50,157.00,150.00,153.50,0.00,0.00,2229240,1685,342067337,924000,739000,185000,1000,30000,-29000,77000,42000,35000,191000
20200430,9917,中保科,88.30,88.40,87.30,88.10,-0.10,-0.11,313033,300,27559116,271000,140000,131000,5000,58000,-53000,0,0,0,78000
20200430,9918,欣天然,33.90,34.45,33.90,34.45,+0.35,1.03,31209,29,1073548,24000,4000,20000,0,0,0,0,0,0,20000
20200430,9919,康那香,30.60,30.65,30.45,30.65,+2.75,9.86,11583567,3488,354650914,115000,334000,-219000,0,0,0,0,0,0,-219000
20200430,9921,巨大,172.00,184.00,171.00,177.50,+6.00,3.5,4196376,2980,741459928,2770372,1270081,1500291,59000,0,59000,81000,24000,57000,1616291
20200430,9924,福興,39.60,40.05,39.60,39.95,+0.60,1.52,287360,211,11467110,99000,23000,76000,0,0,0,0,0,0,76000
20200430,9925,新保,36.00,36.70,36.00,36.25,+0.10,0.28,341030,209,12382890,190000,0,190000,0,0,0,7000,0,7000,197000
20200430,9926,新海,41.80,41.95,41.50,41.60,-0.15,-0.36,65000,55,2716950,27000,22000,5000,0,0,0,0,0,0,5000
20200430,9927,泰銘,30.70,30.85,30.50,30.70,+0.20,0.66,193801,141,5932685,80000,36000,44000,0,0,0,0,0,0,44000
20200430,9928,中視,3.37,3.37,3.37,3.37,0.00,0.00,3000,2,10110,0,0,0,0,0,0,0,0,0,0
20200430,9929,秋雨,11.20,11.20,10.90,10.95,-0.15,-1.35,11000,11,121150,7000,1000,6000,0,0,0,0,0,0,6000
20200430,9930,中聯資源,44.55,45.40,44.55,45.40,+1.10,2.48,256400,209,11547537,143000,18000,125000,0,0,0,0,0,0,125000
20200430,9931,欣高,39.55,39.90,39.50,39.90,+0.25,0.63,17007,18,674477,6000,2000,4000,0,0,0,0,0,0,4000
20200430,9933,中鼎,31.80,32.95,31.80,32.95,+1.35,4.27,5099930,2729,165840924,897000,1988000,-1091000,150000,0,150000,1000,0,1000,-940000
20200430,9934,成霖,13.05,13.40,13.00,13.20,+0.35,2.72,978475,392,12830415,150000,80000,70000,12000,0,12000,0,0,0,82000
20200430,9935,慶豐富,25.20,26.45,24.50,26.35,+1.65,6.68,4049443,1944,103822195,447000,709000,-262000,0,0,0,0,0,0,-262000
20200430,9937,全國,43.80,43.90,43.75,43.85,0.00,0.00,47234,31,2072396,45000,3000,42000,0,0,0,0,0,0,42000
20200430,9938,百和,69.80,70.00,67.60,69.00,+0.10,0.15,3460574,2310,238000006,438000,521000,-83000,1000,0,1000,52000,307000,-255000,-337000
20200430,9939,宏全,53.20,54.60,53.10,54.50,+1.30,2.44,3035993,1588,163455314,404000,1096000,-692000,4000,0,4000,62000,49000,13000,-675000
20200430,9940,信義,26.00,26.40,25.95,26.40,+0.65,2.52,626192,384,16391024,240000,37000,203000,0,0,0,0,0,0,203000
20200430,9941,裕融,101.00,102.00,101.00,101.00,+1.20,1.2,926550,603,93944815,94000,96000,-2000,0,310000,-310000,0,0,0,-312000
20200430,9941A,裕融甲特,52.70,52.70,52.40,52.70,+0.10,0.19,14873,17,781244,0,0,0,0,0,0,0,0,0,0
20200430,9942,茂順,65.60,66.50,65.60,66.50,+0.90,1.37,128255,104,8490459,45000,20000,25000,0,0,0,0,0,0,25000
20200430,9943,好樂迪,62.00,63.80,62.00,63.50,+1.50,2.42,617400,502,38938496,93000,12000,81000,0,0,0,0,0,0,81000
20200430,9944,新麗,22.50,24.40,22.35,22.55,0.00,0.00,15259427,6790,359193424,441000,611000,-170000,0,0,0,0,0,0,-170000
20200430,9945,潤泰新,44.70,45.00,44.35,44.60,-0.05,-0.11,4961708,2430,221375800,1144000,580980,563020,6000,0,6000,4000,29000,-25000,544020
20200430,9946,三發地產,16.95,16.95,16.50,16.80,+0.30,1.82,237396,108,3934342,0,54000,-54000,0,0,0,0,0,0,-54000
20200430,9955,佳龍,15.80,15.85,15.65,15.75,+0.10,0.64,244113,132,3843373,46000,13000,33000,0,0,0,0,0,0,33000
20200430,9958,世紀鋼,82.70,84.20,81.90,83.80,+2.00,2.44,5273109,3474,439162128,1006000,245000,761000,0,60000,-60000,482000,59000,423000,1124000
20200430,00679B,元大美債20年,51.25,51.25,50.95,51.00,-0.40,-0.78,674000,305,34402300,0,62000,-62000,0,0,0,191000,89000,102000,40000
20200430,00687B,國泰20年美債,53.55,53.55,53.30,53.30,-0.55,-1.02,279000,45,14883800,0,161000,-161000,0,0,0,130000,101000,29000,-132000
20200430,00694B,富邦美債1-3,40.44,40.46,40.39,40.39,-0.13,-0.32,344000,28,13901390,0,0,0,0,0,0,311000,324000,-13000,-13000
20200430,00695B,富邦美債7-10,42.29,42.29,42.19,42.19,-0.17,-0.4,308000,10,12994720,0,0,0,0,0,0,300000,303000,-3000,-3000
20200430,00696B,富邦美債20年,53.40,53.45,53.35,53.40,-0.35,-0.65,522000,33,27855900,0,0,0,0,0,0,447000,495000,-48000,-48000
20200430,00697B,元大美債7-10,44.80,44.80,44.67,44.68,-0.32,-0.71,215000,18,9612800,5000,0,5000,0,0,0,161000,173000,-12000,-7000
20200430,00718B,富邦中國政策債,19.95,19.95,19.93,19.95,-0.01,-0.05,449000,25,8952900,0,0,0,0,0,0,396000,432000,-36000,-36000
20200430,00719B,元大美債1-3,32.23,32.23,32.16,32.16,-0.09,-0.28,160000,16,5146940,0,0,0,0,0,0,140000,108000,32000,32000
20200430,00720B,元大投資級公司債,44.85,44.85,44.70,44.78,-0.08,-0.18,336000,128,15034390,0,0,0,0,0,0,129000,296000,-167000,-167000
20200430,00721B,元大中國債3-5,45.81,45.81,45.75,45.76,-0.01,-0.02,149000,5,6818630,0,0,0,0,0,0,108000,109000,-1000,-1000
20200430,00722B,群益15年IG電信債,49.55,49.55,49.23,49.48,-0.22,-0.44,125000,17,6182580,0,0,0,0,0,0,110000,110000,0,0
20200430,00723B,群益15年IG科技債,46.55,46.55,46.40,46.51,-0.14,-0.3,103000,5,4788460,0,0,0,0,0,0,100000,102000,-2000,-2000
20200430,00724B,群益10年IG金融債,43.49,43.50,43.45,43.50,-0.06,-0.14,109000,9,4736240,0,0,0,0,0,0,100000,106000,-6000,-6000
20200430,00725B,國泰投資級公司債,42.78,42.78,42.64,42.73,-0.05,-0.12,182000,60,7766190,0,0,0,0,0,0,101000,156000,-55000,-55000
20200430,00726B,國泰5Y+新興債,40.20,40.45,40.12,40.42,+0.38,0.95,242000,25,9733070,135000,0,135000,0,0,0,100000,241000,-141000,-6000
20200430,00727B,國泰1-5Y高收債,37.78,37.83,37.78,37.78,-0.02,-0.05,119000,15,4496240,0,0,0,0,0,0,104000,112000,-8000,-8000
20200430,00734B,台新JPM新興債,19.59,19.59,19.55,19.58,+0.13,0.67,1037000,41,20274790,0,0,0,0,142000,-142000,777000,867700,-90700,-232700
20200430,00740B,富邦全球投等債,47.03,47.03,46.90,46.90,-0.07,-0.15,167000,9,7834120,0,0,0,0,0,0,160000,163000,-3000,-3000
20200430,00741B,富邦全球高收債,37.15,37.15,37.07,37.15,-0.01,-0.03,130000,8,4826780,0,0,0,0,0,0,123000,126000,-3000,-3000
20200430,00744B,國泰中國政金債5+,42.05,42.05,42.05,42.05,-0.11,-0.26,100000,2,4205000,0,0,0,0,0,0,100000,100000,0,0
20200430,00745B,富邦中政債0-1,39.14,39.14,39.14,39.14,-0.06,-0.15,50000,2,1957000,0,0,0,0,0,0,50000,50000,0,0
20200430,00746B,富邦A級公司債,47.15,47.38,47.15,47.38,+0.01,0.02,53000,5,2510770,0,0,0,0,0,0,52000,52000,0,0
20200430,00747B,FH中國政策債,51.75,51.75,51.75,51.75,+0.10,0.19,100000,2,5175000,0,0,0,0,0,0,100000,100000,0,0
20200430,00748B,凱基中國債3-10,41.90,41.90,41.90,41.90,-0.10,-0.24,100000,2,4190000,0,0,0,0,0,0,100000,100000,0,0
20200430,00749B,凱基新興債10+,41.60,42.02,41.60,42.01,+0.66,1.6,173000,17,7220650,73000,0,73000,0,0,0,100000,172000,-72000,1000
20200430,00750B,凱基科技債10+,47.60,47.60,47.60,47.60,-0.25,-0.52,100000,2,4760000,0,0,0,0,0,0,100000,100000,0,0
20200430,00751B,元大AAA至A公司債,49.45,49.45,49.30,49.39,-0.06,-0.12,357000,115,17627260,0,35000,-35000,0,0,0,134000,208000,-74000,-109000
20200430,00754B,群益AAA-AA公司債,50.40,50.40,50.40,50.40,-0.15,-0.3,100000,2,5040000,0,0,0,0,0,0,100000,100000,0,0
20200430,00755B,群益15年IG公用債,48.09,48.09,47.79,48.00,-0.09,-0.19,111000,12,5331140,0,0,0,0,0,0,100000,104000,-4000,-4000
20200430,00756B,群益15年EM主權債,44.35,44.72,44.35,44.72,+0.58,1.31,254000,23,11303700,152000,0,152000,0,0,0,100000,254000,-154000,-2000
20200430,00758B,FH能源債,56.95,57.00,56.80,56.80,+0.10,0.18,104000,6,5907950,0,0,0,0,0,0,100000,101000,-1000,-1000
20200430,00759B,FH製藥債,77.00,77.00,77.00,77.00,-0.50,-0.65,100000,2,7700000,0,0,0,0,0,0,100000,100000,0,0
20200430,00760B,FH新興企業債,60.20,60.80,60.20,60.75,+0.70,1.17,259000,16,15646450,159000,0,159000,0,0,0,100000,259000,-159000,0
20200430,00761B,國泰A級公司債,49.57,49.60,49.57,49.60,-0.20,-0.4,103000,5,5108770,0,0,0,0,0,0,101000,102000,-1000,-1000
20200430,00764B,群益25年美債,54.45,54.45,54.45,54.45,-0.40,-0.73,100000,2,5445000,0,0,0,0,0,0,100000,100000,0,0
20200430,00765B,群益中國政金債,40.27,40.27,40.20,40.20,+0.04,0.1,120000,4,4831000,0,0,0,0,0,0,120000,120000,0,0
20200430,00768B,FH20年美債,84.10,84.10,84.10,84.10,-1.00,-1.18,100000,2,8410000,0,0,0,0,0,0,100000,100000,0,0
20200430,00769B,FH中國信用債,59.50,59.50,59.50,59.50,-0.30,-0.5,100000,2,5950000,0,0,0,0,0,0,100000,100000,0,0
20200430,00772B,中信高評級公司債,48.31,48.31,48.19,48.30,-0.01,-0.02,261000,25,12600120,0,0,0,0,0,0,250000,255000,-5000,-5000
20200430,00773B,中信優先金融債,47.64,47.65,47.59,47.65,+0.06,0.13,234000,16,11148410,0,0,0,0,0,0,210000,234000,-24000,-24000
20200430,00777B,凱基AAA至A公司債,47.60,47.60,47.60,47.60,-0.29,-0.61,100000,2,4760000,0,0,0,0,0,0,100000,100000,0,0
20200430,00778B,凱基金融債20+,,,,,,0.00,0,0,0,0,0,0,0,0,0,0,0,0,0
20200430,00779B,凱基美債25+,54.90,54.90,54.90,54.90,-0.65,-1.17,100000,2,5490000,0,0,0,0,0,0,100000,100000,0,0
20200430,00780B,國泰A級金融債,42.25,42.28,42.25,42.26,+0.01,0.02,104000,6,4395080,0,0,0,0,0,0,104000,100000,4000,4000
20200430,00781B,國泰A級科技債,47.30,47.30,47.30,47.30,-0.25,-0.53,100000,2,4730000,0,0,0,0,0,0,100000,100000,0,0
20200430,00782B,國泰A級公用債,46.65,46.65,46.61,46.61,-0.04,-0.09,106000,6,4940700,0,0,0,0,0,0,100000,103000,-3000,-3000
20200430,00784B,富邦中國投等債,40.00,40.00,40.00,40.00,-0.16,-0.4,100000,3,4000000,46000,0,46000,0,0,0,54000,100000,-46000,0
20200430,00785B,富邦金融投等債,44.65,44.65,44.65,44.65,-0.05,-0.11,100000,2,4465000,0,0,0,0,0,0,100000,100000,0,0
20200430,00786B,元大10年IG銀行債,43.92,43.94,43.92,43.92,-0.10,-0.23,8000,4,351460,0,0,0,0,0,0,6000,8000,-2000,-2000
20200430,00787B,元大10年IG醫療債,46.47,46.47,46.38,46.44,-0.27,-0.58,7000,7,324890,0,0,0,0,0,0,3000,3000,0,0
20200430,00788B,元大10年IG電能債,44.97,44.97,44.91,44.96,-0.30,-0.66,113000,11,5080230,0,0,0,0,0,0,110000,103000,7000,7000
20200430,00789B,FH公司債A3,71.35,71.35,71.35,71.35,-0.20,-0.28,102000,7,7277700,0,0,0,0,0,0,102000,102000,0,0
20200430,00790B,FH次順位IG金融債,65.45,65.45,65.45,65.45,-0.15,-0.23,100000,2,6545000,0,0,0,0,0,0,100000,100000,0,0
20200430,00791B,FH美元信用債1-5Y,57.80,57.80,57.80,57.80,-0.15,-0.26,100000,2,5780000,0,0,0,0,0,0,100000,100000,0,0
20200430,00792B,群益A級公司債,46.31,46.33,46.27,46.27,-0.31,-0.67,156000,14,7219470,0,0,0,0,0,0,100000,155000,-55000,-55000
20200430,00793B,群益AAA-A醫療債,47.10,47.10,46.95,46.95,-0.50,-1.05,102000,4,4792050,0,0,0,0,0,0,100000,100000,0,0
20200430,00794B,群益7+中國政金債,40.71,40.71,40.69,40.71,+0.07,0.17,109000,5,4437310,0,0,0,0,0,0,109000,109000,0,0
20200430,00795B,中信美國公債20年,51.45,51.50,51.45,51.45,-0.40,-0.77,237000,27,12201450,0,1000,-1000,0,0,0,220000,213000,7000,6000
20200430,00796B,中信中國債7-10,40.26,40.26,40.24,40.25,+0.03,0.07,210000,6,8452500,0,0,0,0,0,0,210000,210000,0,0
20200430,00797B,中信中國美元IG債,41.30,41.46,41.26,41.36,-0.12,-0.29,215000,10,8899660,0,0,0,0,0,0,215000,210000,5000,5000
20200430,00798B,國泰中企A級債7+,42.40,42.40,42.40,42.40,+0.17,0.4,100000,2,4240000,0,0,0,0,0,0,100000,100000,0,0
20200430,00799B,國泰A級醫療債,46.10,46.20,46.10,46.20,+0.10,0.22,128000,13,5911280,0,0,0,0,0,0,126000,102000,24000,24000
20200430,00831B,新光美債1-3,39.80,39.81,39.80,39.81,-0.15,-0.38,55000,3,2189050,0,0,0,0,0,0,55000,55000,0,0
20200430,00832B,新光美債20+,52.45,52.45,52.45,52.45,-0.40,-0.76,50000,2,2622500,0,0,0,0,0,0,50000,50000,0,0
20200430,00833B,第一金美債20+,50.80,50.80,50.35,50.40,-0.50,-0.98,116000,13,5846950,0,0,0,0,0,0,101000,101000,0,0
20200430,00834B,第一金金融債10+,44.20,44.20,43.95,44.00,-0.20,-0.45,152000,31,6702990,0,0,0,0,0,0,100000,100000,0,0
20200430,00835B,第一金科技債10+,45.08,45.08,45.07,45.07,-0.09,-0.2,100000,4,4507500,0,0,0,0,0,0,100000,100000,0,0
20200430,00836B,永豐10年A公司債,43.50,43.50,43.35,43.35,-0.32,-0.73,101000,3,4378500,0,0,0,0,0,0,100000,101000,-1000,-1000
20200430,00837B,永豐15年金融債,37.00,37.00,36.70,36.70,-0.26,-0.7,102000,8,3753700,0,0,0,0,0,0,100000,101000,-1000,-1000
20200430,00838B,永豐7-10年中國債,40.03,40.03,40.03,40.03,+0.01,0.02,100000,2,4003000,0,0,0,0,0,0,100000,100000,0,0
20200430,00839B,凱基醫療保健債,45.30,45.30,45.30,45.30,-0.30,-0.66,101000,3,4575300,0,0,0,0,0,0,100000,100000,0,0
20200430,00840B,凱基IG精選15+,43.65,43.65,43.65,43.65,-0.25,-0.57,101000,3,4408650,0,0,0,0,0,0,100000,100000,0,0
20200430,00841B,凱基AAA-AA公司債,43.95,44.05,43.95,44.05,-0.32,-0.72,102000,4,4483000,0,0,0,0,0,0,100000,100000,0,0
20200430,00842B,台新美元銀行債,41.86,41.98,41.77,41.98,-0.05,-0.12,53000,5,2223110,0,0,0,0,0,0,53000,40000,13000,13000
20200430,00843B,台新中國政策債,40.07,40.07,40.07,40.07,+0.09,0.23,50000,2,2003500,0,0,0,0,0,0,50000,50000,0,0
20200430,00844B,新光15年IG金融債,41.90,41.90,41.88,41.88,-0.26,-0.62,3000,3,125680,0,0,0,0,0,0,3000,2000,1000,1000
20200430,00845B,富邦新興投等債,35.65,35.65,35.45,35.45,-0.16,-0.45,215000,9,7623370,0,0,0,0,0,0,200000,215000,-15000,-15000
20200430,00846B,富邦歐洲銀行債,39.21,39.21,39.21,39.21,-0.11,-0.28,200000,2,7842000,0,0,0,0,0,0,200000,200000,0,0
20200430,00847B,中信美國市政債,38.20,38.20,38.10,38.14,-0.10,-0.26,228000,22,8695040,0,0,0,0,0,0,212000,213000,-1000,-1000
20200430,00848B,中信新興亞洲債,37.48,37.48,37.46,37.48,-0.05,-0.13,218000,9,8170600,0,0,0,0,0,0,210000,218000,-8000,-8000
20200430,00849B,中信EM主權債0-5,38.38,38.38,38.35,38.35,-0.04,-0.1,212000,8,8133050,0,0,0,0,0,0,210000,212000,-2000,-2000
20200430,00853B,統一美債10年Aa-A,,,,,,0.00,0,0,0,0,0,0,0,0,0,0,0,0,0
20200430,00854B,富邦全球保險債,40.96,40.96,40.96,40.96,-0.19,-0.46,100000,2,4096000,0,0,0,0,0,0,100000,100000,0,0
20200430,00855B,富邦全球能源債,35.65,35.78,35.65,35.78,+0.08,0.22,103000,5,3685150,0,0,0,0,0,0,100000,101000,-1000,-1000
20200430,00856B,永豐1-3年美公債,39.36,39.36,39.34,39.34,-0.16,-0.41,101000,3,3975340,0,0,0,0,0,0,101000,100000,1000,1000
20200430,00857B,永豐20年美公債,45.44,45.44,45.44,45.44,-0.39,-0.85,100000,2,4544000,0,0,0,0,0,0,100000,100000,0,0
20200430,00858,永豐美國500大,20.08,20.16,20.08,20.16,+0.30,1.51,106000,6,2129680,0,0,0,0,0,0,104000,102000,2000,2000
20200430,00859B,群益0-1年美債,39.01,39.01,38.98,38.98,-0.13,-0.33,105000,7,4095930,0,0,0,0,0,0,100000,105000,-5000,-5000
20200430,00860B,群益1-5年IG債,39.14,39.14,39.14,39.14,-0.10,-0.25,100000,2,3914000,0,0,0,0,0,0,100000,100000,0,0
20200430,00862B,中信投資級公司債,40.27,40.27,40.10,40.18,-0.15,-0.37,213000,9,8565350,0,0,0,0,0,0,211000,211000,0,0
20200430,00863B,中信全球電信債,41.66,41.68,41.60,41.68,-0.07,-0.17,215000,9,8955200,0,0,0,0,0,0,210000,214000,-4000,-4000
20200430,00864B,中信美國公債0-1,39.33,39.34,39.33,39.34,-0.08,-0.2,210000,6,8260000,0,0,0,0,0,0,210000,210000,0,0
20200430,00867B,新光A-BBB電信債,42.30,42.30,42.30,42.30,-0.30,-0.7,2000,2,84600,0,0,0,0,0,0,2000,2000,0,0
20200430,00868B,FT1-3年美公債,40.24,40.24,40.23,40.23,-0.11,-0.27,110000,3,4425400,0,0,0,0,0,0,110000,110000,0,0
20200430,00869B,FT10-25年公司債,39.28,39.28,39.28,39.28,-0.02,-0.05,100000,2,3928000,0,0,0,0,0,0,100000,100000,0,0
20200430,00870B,元大15年EM主權債,37.13,37.14,37.11,37.14,+0.21,0.57,205000,6,7613610,0,0,0,0,0,0,202000,203000,-1000,-1000
20200430,00871B,元大中國政金債,40.46,40.47,40.46,40.47,+0.09,0.22,200000,4,8093000,0,0,0,0,0,0,200000,200000,0,0
20200430,00872B,凱基美債1-3,40.60,40.60,40.60,40.60,-0.15,-0.37,100000,2,4060000,0,0,0,0,0,0,100000,100000,0,0
20200430,00873B,凱基新興債1-5,38.15,38.15,38.15,38.15,-0.10,-0.26,100000,2,3815000,0,0,0,0,0,0,100000,100000,0,0
20200430,00874B,凱基BBB公司債15+,38.25,38.25,38.25,38.25,-0.23,-0.6,100000,2,3825000,0,0,0,0,0,0,100000,100000,0,0
20200430,1240,茂生農經,52.90,53.20,52.50,52.80,+0.10,0.19,71000,60,3753700,5000,0,5000,0,0,0,0,0,0,5000
20200430,1258,其祥-KY,12.70,12.70,12.70,12.70,+1.15,9.96,28000,15,355600,0,0,0,0,0,0,0,0,0,0
20200430,1259,安心,69.20,70.10,69.20,70.10,+1.60,2.34,14000,14,974300,0,0,0,0,0,0,0,0,0,0
20200430,1264,德麥,211.50,214.50,211.50,212.50,+2.00,0.95,24000,20,5114500,0,4000,-4000,0,0,0,0,0,0,-4000
20200430,1268,漢來美食,124.00,124.00,123.00,123.00,+0.50,0.41,39000,39,4816000,0,0,0,0,0,0,0,0,0,0
20200430,1336,台翰,15.00,15.35,14.95,15.25,+0.35,2.35,538000,151,8192200,41000,1000,40000,0,0,0,0,0,0,40000
20200430,1565,精華,338.50,354.50,337.50,350.50,+15.00,4.47,724000,616,249945500,111000,15000,96000,0,0,0,23000,1000,22000,118000
20200430,1569,濱川,24.30,24.60,24.05,24.50,+0.35,1.45,1308000,643,31786150,366000,40000,326000,0,0,0,0,0,0,326000
20200430,1570,力肯,12.90,13.05,12.90,13.05,+0.15,1.16,71000,27,922150,8000,0,8000,0,0,0,0,0,0,8000
20200430,1580,新麥,94.10,95.70,93.90,95.00,+1.90,2.04,189000,160,17939200,22000,65000,-43000,0,0,0,0,0,0,-43000
20200430,1584,精剛,7.81,7.96,7.61,7.80,-0.08,-1.02,253000,78,1956420,0,0,0,0,0,0,3000,0,3000,3000
20200430,1586,和勤,35.10,35.90,35.10,35.35,+0.60,1.73,450000,209,15917300,23000,1000,22000,0,0,0,0,0,0,22000
20200430,1591,駿吉-KY,18.80,18.80,18.15,18.25,-0.55,-2.93,14000,14,257100,0,0,0,0,0,0,0,0,0,0
20200430,1593,祺驊,45.20,45.55,45.20,45.50,+0.30,0.66,47000,27,2136900,6000,0,6000,0,0,0,0,0,0,6000
20200430,1595,川寶,30.70,30.80,30.15,30.75,+0.05,0.16,114000,75,3478900,2000,1000,1000,0,0,0,0,0,0,1000
20200430,1597,直得,87.50,93.80,86.40,91.00,+5.70,6.68,4309000,2798,394717700,154000,219000,-65000,546000,0,546000,42000,11000,31000,512000
20200430,1599,宏佳騰,29.75,30.30,29.60,30.10,+0.40,1.35,110000,80,3300850,0,0,0,0,0,0,0,0,0,0
20200430,1742,台蠟,20.55,20.80,20.40,20.60,+0.10,0.49,120000,63,2464500,4000,0,4000,0,0,0,0,0,0,4000
20200430,1752,南光,45.40,45.55,44.85,44.95,+0.25,0.56,1027000,656,46276450,178000,51000,127000,0,0,0,63000,14000,49000,176000
20200430,1777,生泰,77.50,78.40,77.50,78.40,+0.90,1.16,261000,184,20370800,23000,0,23000,0,0,0,0,0,0,23000
20200430,1781,合世,12.60,12.95,12.00,12.50,-0.70,-5.3,597000,354,7426550,0,24000,-24000,0,0,0,0,0,0,-24000
20200430,1784,訊聯,33.60,33.80,33.20,33.35,+0.30,0.91,840000,489,28119700,140000,53000,87000,0,0,0,0,0,0,87000
20200430,1785,光洋科,19.35,19.65,19.30,19.40,+0.15,0.78,2980000,783,58200550,172000,134000,38000,0,0,0,0,0,0,38000
20200430,1788,杏昌,106.00,106.00,105.00,105.00,0.00,0.0,34000,29,3595500,0,0,0,0,0,0,0,0,0,0
20200430,1796,金穎生技,25.00,25.00,24.80,24.80,-0.20,-0.8,16000,12,398250,0,0,0,0,0,0,0,0,0,0
20200430,1799,易威,11.40,11.50,10.90,11.30,0.00,0.0,635000,284,7145700,28000,7000,21000,0,0,0,0,0,0,21000
20200430,1813,寶利徠,20.75,20.90,20.60,20.65,-0.10,-0.48,93000,55,1925100,0,0,0,0,0,0,0,0,0,0
20200430,1815,富喬,10.65,10.85,10.60,10.65,0.00,0.0,1930000,614,20623650,29000,113000,-84000,0,0,0,8000,24000,-16000,-100000
20200430,2035,唐榮,39.20,39.20,39.10,39.10,-0.25,-0.64,6000,6,234950,0,0,0,0,0,0,0,0,0,0
20200430,2061,風青,7.30,7.48,7.30,7.43,+0.01,0.13,38000,21,281670,0,0,0,0,0,0,0,0,0,0
20200430,2063,世鎧,32.35,32.90,32.35,32.80,+0.45,1.39,130000,74,4246100,1000,0,1000,0,0,0,0,0,0,1000
20200430,2064,晉椿,11.55,11.55,11.50,11.50,-0.05,-0.43,21000,11,242000,0,0,0,0,0,0,0,0,0,0
20200430,2065,世豐,53.20,53.50,52.60,53.20,+0.50,0.95,284000,187,15072800,14000,7000,7000,0,0,0,0,0,0,7000
20200430,2066,世德,51.80,53.30,51.50,53.30,+2.40,4.72,65000,51,3403400,0,0,0,0,0,0,0,0,0,0
20200430,2067,嘉鋼,8.88,9.48,8.68,9.48,+0.58,6.52,38000,17,336600,2000,0,2000,0,0,0,0,0,0,2000
20200430,2070,精湛,25.70,26.25,25.50,26.05,+0.75,2.96,49000,43,1268150,0,0,0,0,0,0,0,0,0,0
20200430,2221,大甲,24.60,25.10,24.55,24.80,+0.45,1.85,111000,85,2754350,1000,1000,0,0,0,0,0,0,0,0
20200430,2230,泰茂,10.35,10.45,10.15,10.35,+0.15,1.47,109000,39,1117600,0,0,0,0,0,0,0,0,0,0
20200430,2235,謚源,44.50,45.50,44.10,45.45,+1.40,3.18,39000,29,1742000,0,0,0,0,0,0,0,0,0,0
20200430,2596,綠意,18.65,18.80,18.50,18.80,+0.15,0.8,58000,38,1081050,0,0,0,0,0,0,0,0,0,0
20200430,2640,大車隊,76.40,76.80,75.80,76.20,+0.30,0.4,23000,22,1752200,0,0,0,0,0,0,0,0,0,0
20200430,2641,正德,5.98,6.09,5.98,6.00,+0.04,0.67,416000,119,2498250,0,1000,-1000,0,0,0,0,0,0,-1000
20200430,2643,捷迅,40.20,40.90,40.10,40.30,+0.35,0.88,343000,221,13900500,18000,5000,13000,0,0,0,0,0,0,13000
20200430,2718,晶悅,17.10,17.10,16.75,16.75,+0.05,0.3,15000,8,254350,0,0,0,0,0,0,0,0,0,0
20200430,2719,燦星旅,7.03,7.40,7.03,7.40,+0.40,5.71,39000,22,280970,0,0,0,0,0,0,0,0,0,0
20200430,2724,富驛-KY,2.29,2.29,2.29,2.29,+0.09,4.09,7000,3,16030,0,0,0,0,0,0,0,0,0,0
20200430,2726,雅茗-KY,58.80,59.40,58.00,58.70,+1.00,1.73,118000,96,6939700,4000,0,4000,0,0,0,0,0,0,4000
20200430,2729,瓦城,224.50,231.00,223.00,229.00,+8.50,3.85,217000,192,49487000,26000,99500,-73500,0,0,0,3000,0,3000,-70500
20200430,2732,六角,147.00,153.50,146.00,150.50,+6.50,4.51,2308000,1829,345334000,21000,117000,-96000,8000,0,8000,76000,33000,43000,-45000
20200430,2734,易飛網,9.80,9.80,9.80,9.80,+0.26,2.73,1000,1,9800,0,0,0,0,0,0,0,0,0,0
20200430,2736,高野,12.35,13.05,12.35,12.85,+0.60,4.9,110000,55,1412350,6000,1000,5000,0,0,0,0,0,0,5000
20200430,2740,天蔥,10.30,10.30,10.10,10.10,0.00,0.0,12000,6,121500,0,0,0,0,0,0,0,0,0,0
20200430,2743,山富,13.85,14.10,13.80,14.10,+0.35,2.55,154000,90,2155400,1000,0,1000,0,0,0,0,0,0,1000
20200430,2745,五福,15.30,15.80,15.30,15.80,+0.75,4.98,64000,32,989100,6000,1000,5000,0,0,0,0,0,0,5000
20200430,2752,豆府,101.00,101.00,100.50,100.50,+0.60,0.6,13000,11,1308500,0,0,0,0,0,0,0,0,0,0
20200430,2916,滿心,16.15,16.45,16.15,16.40,+0.30,1.86,97000,45,1575500,0,0,0,0,0,0,0,0,0,0
20200430,2924,東凌-KY,20.20,20.35,20.15,20.35,+0.05,0.25,4000,3,81050,0,0,0,0,0,0,0,0,0,0
20200430,2926,誠品生活,82.50,85.50,82.30,85.50,+3.20,3.89,21000,21,1762700,0,0,0,0,0,0,0,0,0,0
20200430,2928,紅馬-KY,40.40,41.80,39.45,39.75,+0.30,0.76,403000,287,16243350,10000,60000,-50000,0,0,0,0,0,0,-50000
20200430,2937,集雅社,25.60,25.60,25.35,25.35,-0.35,-1.36,11000,6,280350,0,0,0,0,0,0,0,0,0,0
20200430,3064,泰偉,14.50,14.50,14.50,14.50,+0.20,1.4,10000,7,145000,0,5000,-5000,0,0,0,0,0,0,-5000
20200430,3066,李洲,6.85,6.88,6.85,6.88,0.00,0.0,4000,3,27430,0,0,0,0,0,0,0,0,0,0
20200430,3067,全域,27.00,27.15,24.30,27.15,+0.15,0.56,168000,128,4159100,4000,2642120,-2638120,0,0,0,0,0,0,-2638120
20200430,3071,協禧,17.00,17.00,16.75,16.80,+0.05,0.3,318000,142,5350750,23000,6000,17000,0,0,0,0,0,0,17000
20200430,3073,凱柏實業,8.20,8.80,8.20,8.58,+0.58,7.25,63000,20,552980,0,0,0,0,0,0,0,0,0,0
20200430,3078,僑威,23.00,23.45,22.85,23.40,+0.65,2.86,1568000,686,36346450,186000,25000,161000,0,0,0,0,0,0,161000
20200430,3081,聯亞,287.00,297.00,277.00,281.00,-8.50,-2.94,3508000,2736,995807000,53000,820000,-767000,13000,71000,-58000,231000,121000,110000,-715000
20200430,3083,網龍,70.80,71.80,69.00,69.90,-0.90,-1.27,1321000,1026,92910600,92000,125000,-33000,0,0,0,15000,82000,-67000,-100000
20200430,3085,新零售,2.15,2.22,1.94,1.94,-0.21,-9.77,138000,35,276090,0,0,0,0,0,0,0,0,0,0
20200430,3086,華義,16.05,16.05,15.85,15.85,-0.20,-1.25,2000,2,31900,0,0,0,0,0,0,0,0,0,0
20200430,3088,艾訊,54.50,54.60,54.30,54.50,+0.60,1.11,243000,170,13229600,19000,11000,8000,0,0,0,0,0,0,8000
20200430,3089,元炬,18.90,20.30,18.90,20.00,+1.20,6.38,47000,21,927400,0,0,0,0,0,0,0,0,0,0
20200430,3092,鴻碩,41.80,41.80,41.05,41.45,+0.25,0.61,283000,208,11712700,18000,11000,7000,0,0,0,0,0,0,7000
20200430,3093,港建,27.80,27.85,27.75,27.80,0.00,0.0,7000,6,194450,0,0,0,0,0,0,0,0,0,0
20200430,3095,及成,1.90,1.93,1.90,1.93,+0.04,2.12,31000,9,59020,0,0,0,0,0,0,0,0,0,0
20200430,3105,穩懋,270.00,272.00,265.00,269.00,+7.50,2.87,14324000,10312,3847430000,3760429,1667000,2093429,417000,298000,119000,406000,472000,-66000,2146429
20200430,3114,好德,21.40,22.00,21.40,22.00,+0.65,3.04,280000,150,6083950,9000,8000,1000,0,0,0,0,0,0,1000
20200430,3115,寶島極,9.30,9.30,9.30,9.30,-0.20,-2.11,1000,1,9300,0,0,0,0,0,0,0,0,0,0
20200430,3118,進階,30.25,32.90,30.25,32.90,+2.95,9.85,2424000,1015,79008050,33000,18000,15000,0,0,0,0,0,0,15000
20200430,3122,笙泉,9.18,9.18,9.02,9.02,0.00,0.0,30000,21,271500,0,1000,-1000,0,0,0,0,0,0,-1000
20200430,3128,昇銳,12.20,12.20,12.05,12.15,+0.10,0.83,33000,17,399800,0,0,0,0,0,0,0,0,0,0
20200430,3131,弘塑,220.00,236.00,220.00,231.50,+13.50,6.19,2453000,2051,560124500,111000,83000,28000,63000,0,63000,232000,60000,172000,263000
20200430,3141,晶宏,22.00,22.20,21.70,21.80,+0.10,0.46,449000,250,9789300,40000,15000,25000,0,0,0,0,0,0,25000
20200430,3144,新揚科,25.95,26.20,25.65,26.05,+0.25,0.97,838000,373,21772900,109000,18000,91000,0,0,0,0,0,0,91000
20200430,3147,大綜,32.45,32.60,31.70,32.10,+0.20,0.63,103000,72,3311050,0,2000,-2000,0,0,0,0,0,0,-2000
20200430,3152,璟德,313.00,321.50,309.50,314.00,+4.00,1.29,822000,757,259127500,64000,159000,-95000,40000,50000,-10000,95000,45000,50000,-55000
20200430,3162,精確,7.72,7.72,7.50,7.50,-0.22,-2.85,12000,7,90320,0,0,0,0,0,0,0,0,0,0
20200430,3163,波若威,38.70,39.35,38.55,39.00,+0.35,0.91,693000,477,26879100,57000,42000,15000,0,0,0,1000,18000,-17000,-2000
20200430,3169,亞信,33.20,34.00,33.05,33.30,+0.10,0.3,323000,180,10741050,0,35000,-35000,0,0,0,0,0,0,-35000
20200430,3171,新洲,18.10,18.20,17.90,17.90,0.00,0.0,239000,86,4308750,2000,15000,-13000,0,0,0,0,0,0,-13000
20200430,3176,基亞,54.60,54.90,53.80,53.90,+0.30,0.56,774000,565,41885900,15000,46000,-31000,0,0,0,0,0,0,-31000
20200430,3178,公準,39.25,40.00,39.00,39.15,-0.10,-0.25,476000,362,18767700,19000,41000,-22000,0,0,0,0,0,0,-22000
20200430,3188,鑫龍騰,14.05,14.20,14.05,14.15,+0.10,0.71,32000,24,452200,0,0,0,0,0,0,0,0,0,0
20200430,3191,和進,45.55,46.55,44.85,45.40,+0.05,0.11,298000,155,13634450,25000,3000,22000,0,0,0,0,0,0,22000
20200430,3202,樺晟,16.80,17.00,16.50,16.65,+0.25,1.52,432000,164,7231150,67000,4000,63000,0,0,0,0,0,0,63000
20200430,3205,佰研,37.20,38.00,37.20,37.65,+0.45,1.21,121000,99,4554550,9000,0,9000,0,0,0,0,0,0,9000
20200430,3206,志豐,27.80,27.95,27.55,27.80,+0.30,1.09,159000,101,4416050,2000,6000,-4000,0,0,0,0,0,0,-4000
20200430,3207,耀勝,10.50,10.50,10.40,10.40,-0.10,-0.95,3000,2,31300,0,0,0,0,0,0,0,0,0,0
20200430,3211,順達,71.50,72.20,71.30,71.30,0.00,0.0,1552000,996,110997900,118000,155000,-37000,0,0,0,67000,70000,-3000,-40000
20200430,3213,茂訊,47.10,47.45,47.00,47.25,+0.20,0.43,194000,146,9150900,0,11000,-11000,0,0,0,0,0,0,-11000
20200430,3217,優群,98.60,99.00,96.10,96.60,-1.50,-1.53,2817000,2170,273359000,211000,133000,78000,278000,395000,-117000,26000,62000,-36000,-75000
20200430,3218,大學光,87.40,88.30,85.20,86.00,-1.10,-1.26,2052000,1521,177427600,232000,108000,124000,0,0,0,3000,69000,-66000,58000
20200430,3221,台嘉碩,21.45,21.75,21.15,21.50,+0.15,0.7,1217000,618,26043400,160000,21000,139000,0,0,0,0,0,0,139000
20200430,3224,三顧,49.80,51.00,49.40,50.80,+1.30,2.63,361000,209,18041200,60000,6000,54000,0,0,0,6000,0,6000,60000
20200430,3226,至寶電,51.50,52.40,51.50,52.00,+1.10,2.16,14000,7,727800,0,0,0,0,0,0,0,0,0,0
20200430,3227,原相,178.00,179.50,176.00,176.50,0.00,0.0,4037000,3151,714935000,291000,151000,140000,0,317000,-317000,25000,120000,-95000,-272000
20200430,3228,金麗科,34.40,34.70,32.95,33.15,-0.55,-1.63,529000,340,17736800,35000,3000,32000,0,0,0,0,1000,-1000,31000
20200430,3230,錦明,5.47,5.47,5.36,5.36,+0.06,1.13,39000,14,211210,0,15000,-15000,0,0,0,0,0,0,-15000
20200430,3232,昱捷,19.90,20.50,19.00,20.15,+0.25,1.26,1139000,587,22296150,21000,15000,6000,0,0,0,6000,2000,4000,10000
20200430,3234,光環,34.20,35.00,33.55,33.80,-0.40,-1.17,2768000,1622,94350350,195000,93000,102000,0,0,0,0,0,0,102000
20200430,3236,千如,17.00,17.60,16.85,17.50,+0.80,4.79,868000,478,14890100,25000,16000,9000,0,0,0,0,0,0,9000
20200430,3252,海灣,16.70,16.80,16.15,16.40,-0.10,-0.61,138000,90,2288950,0,0,0,0,0,0,0,0,0,0
20200430,3259,鑫創,14.30,14.30,13.90,14.20,0.00,0.0,31000,20,439200,0,0,0,0,0,0,0,0,0,0
20200430,3260,威剛,57.20,58.00,57.00,57.20,+1.00,1.78,11393000,5947,653888900,1210000,312000,898000,0,0,0,210000,78000,132000,1030000
20200430,3264,欣銓,26.10,26.50,25.90,26.35,+0.60,2.33,4451000,1721,116501700,1131000,46000,1085000,666000,0,666000,53000,16000,37000,1788000
20200430,3265,台星科,24.25,24.30,23.95,24.10,+0.10,0.42,341000,195,8214100,33000,8000,25000,0,0,0,0,0,0,25000
20200430,3268,海德威,9.98,10.10,9.80,9.98,+0.01,0.1,81000,29,801230,0,1000,-1000,0,0,0,0,0,0,-1000
20200430,3272,東碩,22.35,22.50,22.00,22.20,+0.20,0.91,304000,175,6753450,39000,10000,29000,0,0,0,0,0,0,29000
20200430,3276,宇環,8.07,8.28,8.07,8.28,+0.31,3.89,3000,2,24630,0,0,0,0,0,0,0,0,0,0
20200430,3284,太普高,12.05,12.10,11.80,11.95,-0.10,-0.83,76000,50,910500,0,0,0,0,0,0,0,0,0,0
20200430,3285,微端,15.55,15.55,14.80,14.95,-0.35,-2.29,102000,52,1522650,0,0,0,0,0,0,4000,0,4000,4000
20200430,3287,廣寰科,8.00,8.00,7.85,7.95,-0.04,-0.5,31000,20,245650,0,0,0,0,0,0,0,0,0,0
20200430,3288,點晶,8.15,8.79,8.09,8.09,+0.08,1.0,4000,4,33730,0,0,0,0,0,0,0,0,0,0
20200430,3289,宜特,45.35,46.00,45.00,45.60,+0.90,2.01,1935000,1204,88014250,373000,85000,288000,0,0,0,3000,0,3000,291000
20200430,3290,東浦,13.25,13.35,13.20,13.20,0.00,0.0,84000,46,1113550,3000,0,3000,0,0,0,0,0,0,3000
20200430,3293,鈊象,583.00,584.00,553.00,558.00,-20.00,-3.46,2762000,2532,1562468000,143000,713600,-570600,0,378000,-378000,30000,77000,-47000,-995600
20200430,3294,英濟,12.90,13.40,12.85,13.00,+0.25,1.96,164000,101,2138450,15000,0,15000,0,0,0,0,0,0,15000
20200430,3297,杭特,12.10,12.70,12.05,12.25,+0.10,0.82,41000,16,503000,0,0,0,0,0,0,1000,0,1000,1000
20200430,3303,岱稜,24.00,24.20,23.65,23.80,-0.15,-0.63,349000,171,8330800,22000,23000,-1000,0,0,0,0,0,0,-1000
20200430,3306,鼎天,16.80,17.00,16.80,17.00,+0.15,0.89,18000,10,303900,0,0,0,0,0,0,0,0,0,0
20200430,3310,佳穎,28.60,29.00,28.60,28.95,+0.40,1.4,48000,25,1381200,2000,0,2000,0,0,0,0,0,0,2000
20200430,3313,斐成,14.30,15.00,13.80,14.40,+0.20,1.41,345000,182,4943500,0,0,0,0,0,0,0,0,0,0
20200430,3317,尼克森,37.40,37.60,37.05,37.15,+0.30,0.81,1760000,1009,65557050,109000,88000,21000,0,0,0,14000,37000,-23000,-2000
20200430,3322,建舜電,6.84,6.94,6.80,6.86,+0.02,0.29,147000,62,1006030,0,13000,-13000,0,0,0,0,0,0,-13000
20200430,3323,加百裕,27.70,28.60,27.70,28.45,+0.75,2.71,478000,256,13470450,32000,17000,15000,0,0,0,0,0,0,15000
20200430,3324,雙鴻,175.00,176.50,172.50,174.00,+0.50,0.29,3619000,2694,630772500,95000,248000,-153000,0,63000,-63000,45000,47000,-2000,-218000
20200430,3325,旭品,11.25,11.25,11.00,11.20,+0.10,0.9,121000,50,1339500,0,0,0,0,0,0,0,0,0,0
20200430,3332,幸康,30.50,30.75,30.50,30.75,+0.45,1.49,2000,2,61250,0,0,0,0,0,0,0,0,0,0
20200430,3339,泰谷,2.87,3.00,2.87,3.00,0.00,0.0,8000,7,23610,0,0,0,0,0,0,0,0,0,0
20200430,3354,律勝,13.30,13.30,12.70,13.05,+0.25,1.95,139000,83,1801300,0,6000,-6000,0,0,0,0,0,0,-6000
20200430,3360,尚立,14.50,14.75,14.50,14.65,+0.15,1.03,259000,132,3792000,57000,6000,51000,0,0,0,0,0,0,51000
20200430,3362,先進光,34.60,34.60,33.85,34.20,+0.20,0.59,338000,209,11516150,57000,9000,48000,0,0,0,0,0,0,48000
20200430,3363,上詮,26.70,26.70,25.70,26.00,-0.05,-0.19,1064000,596,27813800,6000,138000,-132000,0,0,0,12000,3000,9000,-123000
20200430,3372,典範,9.05,9.25,8.90,9.25,+0.14,1.54,129000,58,1181270,0,0,0,0,0,0,0,0,0,0
20200430,3373,熱映,96.50,96.80,93.00,96.80,+8.80,10.0,6521000,3312,626750200,903000,37000,866000,0,0,0,1000,19000,-18000,848000
20200430,3374,精材,83.00,84.50,82.30,82.70,+0.80,0.98,10888000,6623,905943000,178000,284000,-106000,977000,0,977000,45000,20000,25000,896000
20200430,3379,彬台,8.93,9.16,8.80,9.16,+0.23,2.58,137000,58,1228520,0,0,0,0,0,0,0,0,0,0
20200430,3388,崇越電,65.90,66.00,65.60,65.80,+0.30,0.46,74000,59,4871300,0,7000,-7000,0,0,0,0,0,0,-7000
20200430,3390,旭軟,15.55,16.50,15.10,15.15,+0.15,1.0,1382000,642,21804700,10000,32000,-22000,0,0,0,0,0,0,-22000
20200430,3402,漢科,27.50,27.50,26.90,27.20,+0.20,0.74,306000,147,8287050,5000,19000,-14000,0,0,0,0,0,0,-14000
20200430,3426,台興,34.00,34.90,34.00,34.90,-0.05,-0.14,6000,5,205850,0,0,0,0,0,0,0,0,0,0
20200430,3434,哲固,11.50,11.65,11.35,11.35,-0.20,-1.73,28000,16,320150,0,0,0,0,0,0,0,0,0,0
20200430,3438,類比科,31.15,31.15,30.50,30.80,+0.40,1.32,439000,263,13487950,80000,3000,77000,0,0,0,0,0,0,77000
20200430,3441,聯一光,26.25,26.25,25.95,26.00,+0.10,0.39,184000,120,4788750,9000,8000,1000,0,0,0,0,0,0,1000
20200430,3444,利機,33.55,36.70,33.55,36.00,+2.60,7.78,2198000,1057,78981750,53000,32000,21000,0,0,0,17000,2000,15000,36000
20200430,3455,由田,49.10,49.40,48.85,49.20,+0.35,0.72,485000,299,23784100,23000,9000,14000,0,0,0,0,4000,-4000,10000
20200430,3465,進泰電子,50.00,50.00,49.95,49.95,-0.35,-0.7,14000,14,699950,0,0,0,0,0,0,0,0,0,0
20200430,3466,致振,16.05,16.40,15.90,16.40,+0.45,2.82,19000,17,304650,0,0,0,0,0,0,0,0,0,0
20200430,3479,安勤,68.70,70.80,67.70,70.10,+2.10,3.09,2199000,1362,152682900,85000,82000,3000,0,0,0,62000,17000,45000,48000
20200430,3483,力致,63.50,65.80,62.50,64.70,+2.70,4.35,9393000,5588,603239400,292000,328000,-36000,76000,0,76000,145000,357000,-212000,-172000
20200430,3484,崧騰,24.10,24.70,24.10,24.35,+0.35,1.46,98000,76,2396700,0,15000,-15000,0,0,0,0,0,0,-15000
20200430,3489,森寶,11.25,11.35,11.00,11.30,+0.10,0.89,154000,78,1719550,6000,1000,5000,0,0,0,0,0,0,5000
20200430,3490,單井,17.45,17.60,17.35,17.40,+0.05,0.29,178000,110,3104900,32000,4000,28000,0,0,0,0,0,0,28000
20200430,3491,昇達科,75.20,76.00,74.50,75.20,+1.00,1.35,601000,448,45144400,57000,40000,17000,0,0,0,5000,2000,3000,20000
20200430,3492,長盛,15.00,15.30,14.95,15.20,+0.25,1.67,28000,22,421700,0,0,0,0,0,0,0,0,0,0
20200430,3498,陽程,22.20,22.40,21.70,22.10,+0.30,1.38,167000,118,3670550,3000,26000,-23000,0,0,0,0,0,0,-23000
20200430,3499,環天科,10.80,10.95,10.75,10.95,+0.20,1.86,143000,81,1549000,0,4000,-4000,0,0,0,0,0,0,-4000
20200430,3508,位速,20.95,21.00,20.40,20.40,0.00,0.0,436000,256,9025600,27000,47000,-20000,0,0,0,0,0,0,-20000
20200430,3511,矽瑪,28.40,29.80,28.30,29.05,+0.85,3.01,2891000,1633,84307850,196000,143000,53000,0,0,0,0,0,0,53000
20200430,3512,皇龍,28.15,28.40,28.15,28.30,+0.20,0.71,34000,12,961550,0,0,0,0,0,0,0,0,0,0
20200430,3516,亞帝歐,10.90,10.90,10.85,10.85,-0.20,-1.81,5000,4,54300,0,0,0,0,0,0,0,0,0,0
20200430,3520,振維,11.10,11.40,10.90,11.30,+0.10,0.89,398000,186,4419450,23000,8000,15000,0,0,0,0,1000,-1000,14000
20200430,3521,鴻翊,12.65,13.00,12.35,12.45,-0.05,-0.4,391000,232,4949200,0,9000,-9000,0,0,0,0,0,0,-9000
20200430,3522,御頂,10.20,11.05,10.15,10.45,+0.35,3.47,407000,188,4302950,5000,12000,-7000,0,0,0,0,0,0,-7000
20200430,3523,迎輝,10.00,10.10,9.55,10.00,0.00,0.0,83000,38,806910,0,3000,-3000,0,0,0,1000,0,1000,-2000
20200430,3526,凡甲,92.10,93.50,91.50,91.50,-1.40,-1.51,5458000,4023,502502800,78000,264000,-186000,0,447000,-447000,97000,38000,59000,-574000
20200430,3527,聚積,93.40,94.80,93.40,93.50,+0.60,0.65,339000,287,31824100,67000,18000,49000,0,0,0,0,1000,-1000,48000
20200430,3529,力旺,270.00,282.50,266.50,282.50,+16.50,6.2,1171000,1068,322557500,165600,63000,102600,20000,3000,17000,7000,6000,1000,120600
20200430,3531,先益,23.00,23.15,22.90,23.00,0.00,0.0,85000,47,1955850,0,1000,-1000,0,0,0,0,0,0,-1000
20200430,3537,堡達,33.75,34.30,33.70,34.20,+0.85,2.55,1336000,636,45440500,166000,13000,153000,0,0,0,0,0,0,153000
20200430,3540,曜越,20.60,21.60,20.35,21.50,+1.40,6.97,589000,271,12300600,26000,29000,-3000,0,0,0,0,0,0,-3000
20200430,3541,西柏,74.80,75.80,74.80,75.80,+1.30,1.74,313000,235,23591700,39000,11000,28000,0,0,0,0,0,0,28000
20200430,3546,宇峻,97.00,97.50,94.70,95.20,-1.40,-1.45,1921000,1419,183674500,62000,132000,-70000,0,0,0,17000,67000,-50000,-120000
20200430,3548,兆利,71.60,72.80,70.80,70.90,+0.70,1.0,1003000,614,71691700,51000,29000,22000,0,0,0,5000,14000,-9000,13000
20200430,3551,世禾,38.95,39.50,38.60,39.25,+0.80,2.08,814000,483,31884400,163000,36000,127000,0,0,0,1000,9000,-8000,119000
20200430,3552,同致,47.10,48.90,47.10,48.90,+2.25,4.82,333000,205,16117500,0,1000,-1000,0,0,0,16000,3000,13000,12000
20200430,3555,重鵬,29.00,29.40,28.45,29.15,-0.35,-1.19,16000,15,462400,0,0,0,0,0,0,0,0,0,0
20200430,3556,禾瑞亞,48.20,48.20,47.95,48.10,+0.10,0.21,274000,174,13168950,16000,0,16000,0,0,0,0,0,0,16000
20200430,3558,神準,107.50,108.00,104.00,107.50,+1.00,0.94,481000,338,51051500,20000,14000,6000,0,0,0,0,0,0,6000
20200430,3564,其陽,27.10,27.65,27.10,27.50,+0.45,1.66,47000,38,1287750,0,0,0,0,0,0,0,0,0,0
20200430,3567,逸昌,23.35,23.70,23.30,23.45,+0.25,1.08,62000,45,1454900,0,1000,-1000,0,0,0,0,0,0,-1000
20200430,3570,大塚,91.80,94.00,90.60,94.00,+3.20,3.52,88000,71,8088900,9000,0,9000,0,0,0,1000,0,1000,10000
20200430,3577,泓格,30.65,30.65,29.85,29.90,-0.20,-0.66,39000,29,1172750,0,0,0,0,0,0,1000,0,1000,1000
20200430,3580,友威科,23.15,23.45,23.15,23.30,+0.30,1.3,160000,115,3735750,28000,0,28000,0,0,0,0,0,0,28000
20200430,3581,博磊,14.35,14.70,14.35,14.70,+0.40,2.8,60000,39,871800,0,0,0,0,0,0,0,0,0,0
20200430,3587,閎康,76.30,76.70,75.00,75.90,-0.10,-0.13,1031000,700,78108500,36000,37000,-1000,0,42000,-42000,0,33000,-33000,-76000
20200430,3594,磐儀,19.90,20.00,19.80,19.90,+0.20,1.02,79000,49,1574750,11000,0,11000,0,0,0,0,0,0,11000
20200430,3597,映興,15.35,15.60,15.35,15.60,+0.30,1.96,71000,52,1099950,1000,0,1000,0,0,0,0,0,0,1000
20200430,3609,東林,19.25,19.75,19.25,19.60,+0.30,1.55,20000,17,391050,3000,0,3000,0,0,0,0,0,0,3000
20200430,3611,鼎翰,199.50,204.50,199.50,203.50,+7.50,3.83,161000,150,32588500,8000,1000,7000,10000,0,10000,0,0,0,17000
20200430,3615,安可,12.75,12.85,12.60,12.75,+0.05,0.39,133000,59,1688350,0,3000,-3000,0,0,0,0,0,0,-3000
20200430,3623,富晶通,15.05,15.50,14.80,15.10,+0.05,0.33,34000,29,513600,0,0,0,0,0,0,0,2000,-2000,-2000
20200430,3624,光頡,28.85,30.20,28.50,28.50,+0.50,1.79,7392000,4624,217217600,223000,640000,-417000,0,0,0,117000,7000,110000,-307000
20200430,3625,西勝,17.20,17.30,16.80,17.00,+0.10,0.59,833000,326,14189650,8000,115000,-107000,0,0,0,0,0,0,-107000
20200430,3628,盈正,28.90,29.45,28.90,29.35,+0.30,1.03,22000,19,645150,2000,2000,0,0,0,0,0,0,0,0
20200430,3629,地心引力,61.20,61.20,60.50,61.00,0.00,0.0,22000,16,1341600,0,0,0,0,0,0,0,0,0,0
20200430,3630,新鉅科,54.80,55.00,53.50,53.70,-0.20,-0.37,3745000,2053,202402000,193000,168000,25000,0,0,0,0,22000,-22000,3000
20200430,3631,晟楠,46.00,48.95,45.50,45.50,+0.75,1.68,581000,380,26981200,5000,14000,-9000,0,0,0,0,0,0,-9000
20200430,3632,研勤,8.77,9.30,8.77,9.08,+0.32,3.65,142000,83,1273190,3000,0,3000,0,0,0,0,0,0,3000
20200430,3642,駿熠電,16.55,18.20,16.55,17.80,+1.25,7.55,380000,178,6724900,3000,2000,1000,0,0,0,0,0,0,1000
20200430,3646,艾恩特,15.45,15.55,15.20,15.45,+0.10,0.65,52000,37,800300,0,0,0,0,0,0,0,0,0,0
20200430,3652,精聯,15.05,15.15,14.80,15.00,+0.10,0.67,38000,24,569400,0,0,0,0,0,0,0,0,0,0
20200430,3663,鑫科,18.80,19.05,18.80,19.05,+0.30,1.6,117000,57,2211650,0,0,0,0,0,0,0,0,0,0
20200430,3664,安瑞-KY,10.15,10.30,10.10,10.30,0.00,0.0,13000,9,132000,0,2000,-2000,0,0,0,0,0,0,-2000
20200430,3666,光耀,15.35,15.40,15.25,15.40,+0.05,0.33,33000,20,506900,0,0,0,0,0,0,0,0,0,0
20200430,3672,康聯訊,11.80,12.30,11.75,11.95,+0.40,3.46,44000,24,523300,3000,1000,2000,0,0,0,0,0,0,2000
20200430,3675,德微,44.90,45.00,44.10,44.90,+1.30,2.98,72000,51,3219050,0,0,0,0,0,0,0,0,0,0
20200430,3680,家登,154.50,166.50,154.00,166.50,+15.00,9.9,8855000,6085,1430962000,805000,150000,655000,0,0,0,50000,25000,25000,680000
20200430,3684,榮昌,33.45,34.90,33.45,34.50,+1.10,3.29,70000,49,2390700,0,3000,-3000,0,0,0,0,0,0,-3000
20200430,3685,元創精密,20.45,21.00,19.80,19.80,-0.75,-3.65,45000,40,910850,0,5000,-5000,0,0,0,0,0,0,-5000
20200430,3687,歐買尬,39.75,40.05,39.20,39.20,0.00,0.0,248000,183,9824950,43000,10000,33000,0,0,0,0,0,0,33000
20200430,3689,湧德,20.10,20.45,20.10,20.45,+0.60,3.02,102000,67,2076700,5000,0,5000,0,0,0,0,0,0,5000
20200430,3691,碩禾,91.70,93.00,91.10,92.40,+1.40,1.54,450000,347,41425400,81000,12000,69000,0,0,0,2000,2000,0,69000
20200430,3693,營邦,32.10,32.85,32.10,32.50,+0.40,1.25,48000,42,1563800,2000,0,2000,0,0,0,0,0,0,2000
20200430,3707,漢磊,25.05,25.50,24.80,25.10,+0.35,1.41,6481000,3211,163452900,179000,504000,-325000,0,0,0,2000,4000,-2000,-327000
20200430,3709,鑫聯大投控,21.20,21.20,20.85,20.90,-0.10,-0.48,45000,23,944250,24000,0,24000,0,0,0,0,0,0,24000
20200430,3710,連展投控,6.52,6.84,6.46,6.68,+0.17,2.61,514000,106,3384230,45000,25000,20000,0,0,0,0,52000,-52000,-32000
20200430,3713,新晶投控,12.90,13.30,12.60,13.30,+0.60,4.72,81000,42,1041500,2000,1000,1000,0,0,0,0,0,0,1000
20200430,4102,永日,20.80,20.85,20.45,20.70,+0.30,1.47,521000,312,10751800,9000,10000,-1000,0,0,0,0,0,0,-1000
20200430,4105,東洋,70.00,71.00,69.90,71.00,+1.50,2.16,864000,540,60841100,153000,190000,-37000,0,0,0,31000,1000,30000,-7000
20200430,4107,邦特,114.00,116.50,113.50,114.50,+1.50,1.33,643000,454,73667000,5000,86000,-81000,0,45000,-45000,40000,0,40000,-86000
20200430,4109,加捷生醫,13.20,13.35,13.10,13.15,0.00,0.0,167000,98,2202550,22000,0,22000,0,0,0,0,0,0,22000
20200430,4111,濟生,25.90,26.00,25.40,26.00,+0.45,1.76,282000,144,7259300,7000,5000,2000,0,0,0,0,0,0,2000
20200430,4113,聯上,12.70,13.35,12.60,13.10,+0.50,3.97,485000,241,6317200,48000,14000,34000,0,0,0,0,0,0,34000
20200430,4114,健喬,23.20,23.20,22.85,22.85,-0.05,-0.22,494000,245,11341350,34000,34000,0,0,0,0,0,0,0,0
20200430,4116,明基醫,30.25,30.60,30.25,30.30,+0.30,1.0,88000,69,2676850,0,0,0,0,0,0,0,0,0,0
20200430,4120,友華,42.55,43.20,42.55,43.20,+0.70,1.65,138000,102,5931300,11000,1000,10000,0,0,0,0,0,0,10000
20200430,4121,優盛,20.75,21.15,19.90,20.10,-0.60,-2.9,6312000,2885,127924400,436000,236000,200000,0,0,0,0,0,0,200000
20200430,4123,晟德,48.80,49.00,47.65,48.20,-0.10,-0.21,1483000,827,71499750,129000,166000,-37000,0,0,0,64000,26000,38000,1000
20200430,4126,太醫,81.60,81.80,79.90,79.90,-1.00,-1.24,576000,449,46548600,99000,69000,30000,0,0,0,9000,6000,3000,33000
20200430,4127,天良,9.35,9.35,9.23,9.26,-0.09,-0.96,313000,123,2901540,0,0,0,0,0,0,0,0,0,0
20200430,4128,中天,19.35,19.90,19.35,19.45,+0.35,1.83,2524000,1152,49525700,9000,51000,-42000,0,0,0,0,8000,-8000,-50000
20200430,4129,聯合,31.95,33.80,31.95,33.30,+1.45,4.55,367000,258,12148900,19000,0,19000,0,0,0,0,0,0,19000
20200430,4129A,聯合甲特,48.55,49.45,48.55,49.45,+0.85,1.75,14000,12,685000,0,0,0,0,0,0,0,0,0,0
20200430,4130,健亞,27.20,28.20,27.15,27.70,+0.50,1.84,1653000,1090,45765700,48000,143000,-95000,0,0,0,0,0,0,-95000
20200430,4131,晶宇,4.93,4.95,4.93,4.95,-0.40,-7.48,3000,2,14830,0,0,0,0,0,0,0,0,0,0
20200430,4138,曜亞,45.20,45.60,45.20,45.45,+0.25,0.55,90000,53,4081600,0,0,0,0,0,0,0,0,0,0
20200430,4139,馬光-KY,40.00,40.10,39.60,39.85,-0.05,-0.13,73000,51,2908650,0,1000,-1000,0,0,0,0,0,0,-1000
20200430,4147,中裕,98.70,98.90,96.80,96.90,-0.60,-0.62,1489000,1081,144970600,198000,199000,-1000,0,0,0,21000,0,21000,20000
20200430,4152,台微體,71.80,71.80,70.50,70.60,+1.00,1.44,12000,10,848400,0,0,0,0,0,0,0,0,0,0
20200430,4153,鈺緯,27.90,28.50,27.50,28.00,+0.10,0.36,47000,29,1314050,0,2000,-2000,0,0,0,0,0,0,-2000
20200430,4154,康樂-KY,29.75,30.45,29.50,30.30,+0.55,1.85,30000,25,909950,0,2000,-2000,0,0,0,0,0,0,-2000
20200430,4157,太景*-KY,14.50,14.80,14.45,14.50,+0.15,1.05,1838000,739,26780000,70000,145000,-75000,0,0,0,29000,0,29000,-46000
20200430,4160,創源,25.90,26.15,25.90,25.95,0.00,0.0,28000,24,728000,0,0,0,0,0,0,0,0,0,0
20200430,4161,聿新科,29.90,29.95,29.50,29.60,+0.20,0.68,33000,24,977800,1000,0,1000,0,0,0,0,0,0,1000
20200430,4162,智擎,52.70,53.30,51.90,52.70,+0.20,0.38,960000,501,50610900,70000,191000,-121000,0,0,0,0,6000,-6000,-127000
20200430,4163,鐿鈦,123.00,124.50,123.00,124.50,+1.50,1.22,235000,181,29137000,9000,17000,-8000,0,0,0,0,0,0,-8000
20200430,4167,展旺,24.35,24.80,23.95,24.40,+0.30,1.24,2081000,923,50606050,165000,46000,119000,0,0,0,0,0,0,119000
20200430,4168,醣聯,15.00,15.05,14.60,14.75,+0.05,0.34,156000,80,2303200,0,0,0,0,0,0,0,0,0,0
20200430,4171,瑞基,164.00,172.50,151.50,172.50,+15.50,9.87,881000,557,140647500,107000,0,107000,0,0,0,26000,14000,12000,119000
20200430,4173,久裕,18.95,19.00,18.80,19.00,0.00,0.0,853000,417,16135000,91000,0,91000,0,0,0,0,0,0,91000
20200430,4174,浩鼎,91.90,92.00,89.70,89.70,0.00,0.0,379000,286,34299700,8000,9000,-1000,0,0,0,0,0,0,-1000
20200430,4175,杏一,70.40,71.20,70.40,70.80,+0.50,0.71,39000,33,2761300,0,0,0,0,0,0,0,0,0,0
20200430,4183,福永生技,18.00,18.55,18.00,18.55,+0.40,2.2,6000,6,109300,0,0,0,0,0,0,0,0,0,0
20200430,4188,安克,16.10,16.10,15.40,15.55,-0.15,-0.96,131000,69,2030750,0,0,0,0,0,0,0,0,0,0
20200430,4192,杏國,27.45,28.25,27.45,28.10,+0.85,3.12,66000,43,1838150,0,0,0,0,0,0,0,0,0,0
20200430,4198,環瑞醫,2.18,2.22,2.13,2.14,-0.02,-0.93,613000,71,1314880,0,0,0,0,0,0,0,0,0,0
20200430,4205,中華食,86.70,86.70,86.50,86.60,0.00,0.0,18000,17,1559000,0,1000,-1000,0,0,0,0,0,0,-1000
20200430,4207,環泰,10.65,10.70,10.60,10.65,0.00,0.0,329000,85,3504450,0,0,0,0,0,0,0,0,0,0
20200430,4303,信立,18.60,18.80,18.50,18.80,+0.30,1.62,47000,18,872300,0,3000,-3000,0,0,0,0,0,0,-3000
20200430,4304,勝昱,4.49,5.00,4.49,5.00,+0.35,7.53,5000,3,23120,0,0,0,0,0,0,0,0,0,0
20200430,4305,世坤,33.70,34.00,33.70,34.00,+0.05,0.15,16000,7,540500,0,0,0,0,0,0,0,0,0,0
20200430,4401,東隆興,25.15,27.20,25.15,27.20,+2.45,9.9,3579000,1363,96907850,94000,36000,58000,0,28000,-28000,3000,5000,-2000,28000
20200430,4402,福大,5.10,5.10,5.02,5.02,0.00,0.0,27000,11,135640,0,0,0,0,0,0,0,0,0,0
20200430,4406,新昕纖,8.67,8.90,8.65,8.79,+0.07,0.8,29000,17,254440,0,0,0,0,0,0,0,0,0,0
20200430,4413,飛寶企業,12.40,12.70,12.40,12.60,0.00,0.0,13000,7,163400,0,0,0,0,0,0,0,0,0,0
20200430,4416,三圓,77.10,77.10,77.10,77.10,-3.40,-4.22,2000,2,154200,0,0,0,0,0,0,0,0,0,0
20200430,4417,金洲,30.25,30.45,30.15,30.45,+0.20,0.66,163000,90,4944050,0,13000,-13000,0,0,0,0,0,0,-13000
20200430,4419,元勝,,,,,,0.00,0,0,0,0,0,0,0,0,0,0,0,0,0
20200430,4420,光明,22.80,23.30,22.55,23.10,+0.65,2.9,126000,94,2891350,0,0,0,0,0,0,0,0,0,0
20200430,4429,聚紡,37.80,37.85,37.05,37.30,-0.50,-1.32,19000,18,716250,0,0,0,0,0,0,0,0,0,0
20200430,4430,耀億,25.30,25.40,24.90,24.95,0.00,0.0,71000,59,1775700,5000,10000,-5000,0,0,0,0,0,0,-5000
20200430,4432,銘旺實,13.40,13.65,13.25,13.40,+0.20,1.52,129000,89,1735500,0,1000,-1000,0,0,0,0,0,0,-1000
20200430,4433,興采,32.30,32.30,31.70,31.70,-0.15,-0.47,129000,90,4107200,6000,0,6000,0,0,0,0,0,0,6000
20200430,4502,健信,51.40,51.40,50.10,51.00,0.00,0.0,25000,21,1274800,0,1000,-1000,0,0,0,0,0,0,-1000
20200430,4503,金雨,17.50,17.60,17.20,17.20,-0.40,-2.27,39000,31,676500,0,8000,-8000,0,0,0,0,0,0,-8000
20200430,4506,崇友,56.50,57.00,56.50,57.00,+0.50,0.88,86000,56,4871200,11000,15000,-4000,0,0,0,4000,0,4000,0
20200430,4510,高鋒,9.99,10.25,9.84,10.00,+0.04,0.4,160000,71,1616080,0,0,0,0,0,0,0,0,0,0
20200430,4513,福裕,7.30,7.34,7.22,7.29,+0.01,0.14,291000,80,2117410,0,9000,-9000,0,0,0,0,0,0,-9000
20200430,4523,永彰,20.45,21.20,20.25,20.35,+0.20,0.99,104000,83,2140350,0,13000,-13000,0,0,0,0,0,0,-13000
20200430,4527,方土霖,24.30,24.45,24.30,24.40,+0.10,0.41,18000,14,439100,0,0,0,0,0,0,0,0,0,0
20200430,4528,江興鍛,38.05,40.00,38.05,39.50,+2.05,5.47,261000,209,10164150,6000,14000,-8000,0,0,0,0,0,0,-8000
20200430,4529,淳紳,8.48,8.48,8.30,8.41,-0.03,-0.36,9000,7,75230,0,0,0,0,0,0,0,2000,-2000,-2000
20200430,4530,宏易,10.65,10.70,10.65,10.70,-0.10,-0.93,9000,7,95900,0,0,0,0,0,0,0,0,0,0
20200430,4533,協易機,10.80,11.00,10.80,10.85,+0.10,0.93,155000,66,1695700,0,1000,-1000,0,0,0,0,0,0,-1000
20200430,4534,慶騰,6.65,6.70,6.56,6.66,+0.05,0.76,104000,32,691070,0,2000,-2000,0,0,0,0,0,0,-2000
20200430,4535,至興,23.60,24.40,23.60,24.20,+0.60,2.54,23000,14,550050,0,0,0,0,0,0,0,0,0,0
20200430,4538,大詠城,15.60,15.60,15.35,15.35,0.00,0.0,3000,3,46300,0,0,0,0,0,0,0,0,0,0
20200430,4541,晟田,18.35,18.85,18.35,18.80,+0.50,2.73,178000,101,3315150,0,0,0,0,0,0,0,0,0,0
20200430,4542,科嶠,21.30,21.30,20.40,20.85,+0.10,0.48,35000,26,723550,0,0,0,0,0,0,0,0,0,0
20200430,4543,萬在,15.40,15.45,15.20,15.35,+0.20,1.32,23000,11,353350,0,0,0,0,0,0,0,0,0,0
20200430,4549,桓達,69.20,71.00,69.20,70.80,+1.60,2.31,128000,110,8972700,8000,6000,2000,0,0,0,0,0,0,2000
20200430,4550,長佳,26.70,26.70,26.40,26.65,+0.40,1.52,106000,76,2814100,14000,2000,12000,0,0,0,0,0,0,12000
20200430,4554,橙的,19.05,19.15,18.35,18.70,-0.35,-1.84,31000,29,584400,0,0,0,0,0,0,0,0,0,0
20200430,4556,旭然,33.00,33.15,32.95,33.15,+0.20,0.61,11000,8,363000,0,0,0,0,0,0,0,0,0,0
20200430,4561,健椿,25.10,25.30,24.90,25.30,0.00,0.0,37000,32,928850,0,0,0,0,0,0,0,0,0,0
20200430,4563,百德,36.00,36.80,36.00,36.20,+0.60,1.69,80000,64,2900800,3000,5000,-2000,0,0,0,0,10000,-10000,-12000
20200430,4568,科際精密,51.00,51.50,51.00,51.00,0.00,0.0,58000,19,2958700,0,0,0,0,0,0,0,0,0,0
20200430,4580,捷流閥業,90.00,90.50,89.60,89.70,+0.90,1.01,99000,65,8916100,3000,6000,-3000,0,0,0,0,3000,-3000,-6000
20200430,4609,唐鋒,8.30,8.60,8.30,8.60,+0.37,4.5,7000,5,59850,0,0,0,0,0,0,0,0,0,0
20200430,4702,中美實,10.90,10.90,10.60,10.70,-0.05,-0.47,52000,28,557800,0,0,0,0,0,0,0,0,0,0
20200430,4706,大恭,16.20,16.30,16.00,16.30,+0.15,0.93,35000,25,566450,0,0,0,0,0,0,0,0,0,0
20200430,4707,磐亞,12.40,12.45,12.20,12.30,+0.05,0.41,3685000,1108,45398900,262000,71000,191000,0,0,0,70000,0,70000,261000
20200430,4711,永純,13.45,13.75,13.45,13.55,+0.10,0.74,29000,18,391650,0,0,0,0,0,0,0,0,0,0
20200430,4712,南璋,6.05,6.10,5.91,6.10,+0.05,0.83,39000,11,235230,0,0,0,0,0,0,0,0,0,0
20200430,4714,永捷,14.75,14.95,14.60,14.95,+0.35,2.4,1423000,385,21054950,135000,26000,109000,0,0,0,0,2000,-2000,107000
20200430,4716,大立,14.20,14.35,14.15,14.20,+0.10,0.71,203000,91,2890700,0,0,0,0,0,0,0,0,0,0
20200430,4721,美琪瑪,54.60,56.30,54.50,55.60,+1.30,2.39,1114000,787,61777100,49000,72000,-23000,0,0,0,3000,2000,1000,-22000
20200430,4726,永昕,19.65,19.90,18.30,18.90,-0.65,-3.32,392000,223,7446100,7000,5000,2000,0,0,0,0,0,0,2000
20200430,4728,雙美,68.00,68.90,67.30,68.10,+0.70,1.04,389000,297,26497000,21000,8000,13000,0,0,0,29000,0,29000,42000
20200430,4729,熒茂,14.50,14.50,13.50,13.50,-0.50,-3.57,602000,313,8275950,0,0,0,0,0,0,0,0,0,0
20200430,4735,豪展,70.30,71.80,68.00,69.10,-4.70,-6.37,6301000,3868,440379200,488000,141000,347000,0,0,0,0,97000,-97000,250000
20200430,4736,泰博,193.00,193.50,187.00,190.50,+1.00,0.53,1227000,975,233416000,234100,142000,92100,0,50000,-50000,15000,55000,-40000,2100
20200430,4741,泓瀚,25.25,26.50,25.20,25.50,+0.70,2.82,152000,114,3898050,0,1000,-1000,0,0,0,0,0,0,-1000
20200430,4743,合一,53.50,56.00,53.50,56.00,+3.20,6.06,2527000,1167,138975100,21000,1000,20000,0,0,0,0,0,0,20000
20200430,4744,皇將,32.80,33.25,32.75,32.90,+0.05,0.15,138000,101,4541800,2000,1000,1000,0,0,0,2000,2000,0,1000
20200430,4745,合富-KY,30.85,31.25,30.85,31.05,+0.20,0.65,110000,82,3407050,3000,0,3000,0,0,0,0,0,0,3000
20200430,4747,強生,45.35,45.35,44.50,44.90,+0.45,1.01,175000,126,7850400,1000,1000,0,0,0,0,0,0,0,0
20200430,4754,國碳科,53.10,53.50,53.10,53.10,+0.10,0.19,21000,19,1118600,0,0,0,0,0,0,0,0,0,0
20200430,4760,勤凱,93.50,96.10,87.80,91.00,-0.40,-0.44,1316000,1026,120222800,12000,50000,-38000,0,0,0,0,0,0,-38000
20200430,4767,誠泰科技,23.20,23.95,23.20,23.95,+0.05,0.21,17000,7,396850,0,0,0,0,0,0,0,0,0,0
20200430,4803,VHQ-KY,88.50,89.50,87.60,87.90,+0.30,0.34,623000,523,55116500,46000,41000,5000,0,0,0,1000,46000,-45000,-40000
20200430,4804,大略-KY,9.15,9.15,9.00,9.01,-0.04,-0.44,113000,54,1021290,0,0,0,0,0,0,0,0,0,0
20200430,4806,昇華,7.69,7.80,7.21,7.57,+0.37,5.14,8000,8,60460,0,0,0,0,0,0,0,0,0,0
20200430,4903,聯光通,10.45,10.70,10.30,10.40,-0.05,-0.48,114000,36,1177150,0,0,0,0,0,0,0,0,0,0
20200430,4905,台聯電,49.60,49.80,49.60,49.60,+0.10,0.2,15000,9,746000,0,0,0,0,0,0,0,0,0,0
20200430,4907,富宇,23.00,23.65,23.00,23.50,+0.65,2.84,128000,66,2987950,8000,12000,-4000,0,0,0,0,0,0,-4000
20200430,4908,前鼎,37.80,38.05,37.05,37.45,+0.10,0.27,1243000,742,46573900,101000,30000,71000,0,0,0,8000,22000,-14000,57000
20200430,4909,新復興,14.90,14.90,14.70,14.80,0.00,0.0,135000,79,1994900,9000,0,9000,0,0,0,0,0,0,9000
20200430,4911,德英,31.50,31.70,30.50,30.50,-0.85,-2.71,60000,52,1861450,0,2000,-2000,0,0,0,0,0,0,-2000
20200430,4924,欣厚-KY,5.95,6.09,5.85,5.94,+0.11,1.89,174000,35,1028830,109000,106000,3000,0,0,0,0,0,0,3000
20200430,4931,新盛力,30.05,30.05,29.55,29.85,+0.30,1.02,239000,159,7138600,30000,6000,24000,0,0,0,0,0,0,24000
20200430,4933,友輝,20.20,20.45,20.20,20.40,+0.20,0.99,120000,82,2443900,9000,7000,2000,0,0,0,0,0,0,2000
20200430,4939,亞電,14.60,14.60,13.60,13.95,+0.55,4.1,618000,296,8634350,6000,50000,-44000,0,0,0,0,0,0,-44000
20200430,4944,兆遠,8.82,9.20,8.82,9.20,+0.07,0.77,72000,27,656200,0,0,0,0,0,0,0,0,0,0
20200430,4946,辣椒,19.40,19.55,18.80,19.55,+0.25,1.3,314000,211,6053650,47000,0,47000,0,0,0,0,0,0,47000
20200430,4947,昂寶-KY,228.00,228.00,227.50,228.00,+0.50,0.22,93000,58,21171000,23000,5000,18000,0,0,0,0,0,0,18000
20200430,4950,牧東,6.19,6.19,6.17,6.17,+0.05,0.82,18000,6,111400,1000,0,1000,0,0,0,0,0,0,1000
20200430,4953,緯軟,76.20,80.50,75.80,77.50,+3.00,4.03,3387000,2469,264872800,106099,131000,-24901,0,0,0,81000,33000,48000,23099
20200430,4966,譜瑞-KY,733.00,739.00,725.00,738.00,+10.00,1.37,625000,581,458803000,136000,86311,49689,16,21000,-20984,26000,18000,8000,36705
20200430,4971,IET-KY,51.00,51.20,50.50,50.70,+0.60,1.2,87000,68,4421900,11000,2000,9000,0,0,0,0,0,0,9000
20200430,4972,湯石照明,29.45,29.55,29.30,29.50,+0.20,0.68,42000,35,1238050,0,0,0,0,0,0,0,0,0,0
20200430,4973,廣穎,25.00,25.20,24.70,24.80,+0.20,0.81,856000,457,21280200,60000,21000,39000,0,0,0,0,0,0,39000
20200430,4974,亞泰,53.00,53.50,52.70,53.20,+0.60,1.14,686000,485,36499900,175000,42000,133000,0,0,0,0,18000,-18000,115000
20200430,4979,華星光,19.50,19.80,19.10,19.15,+0.25,1.32,3677000,1827,71356750,42000,305000,-263000,0,0,0,0,0,0,-263000
20200430,4987,科誠,50.30,50.80,50.10,50.70,+0.70,1.4,60000,38,3026500,2000,0,2000,0,0,0,0,0,0,2000
20200430,4991,環宇-KY,53.70,53.90,53.20,53.30,+0.10,0.19,718000,466,38428500,52000,83000,-31000,0,0,0,0,0,0,-31000
20200430,4995,晶達,45.10,45.50,45.00,45.40,+0.40,0.89,38000,33,1718150,0,0,0,0,0,0,0,0,0,0
20200430,5009,榮剛,15.75,16.15,15.60,16.15,+0.60,3.86,1002000,420,15963650,185000,86000,99000,0,0,0,6000,0,6000,105000
20200430,5011,久陽,14.90,15.10,14.90,15.10,-0.10,-0.66,53000,13,798450,0,0,0,0,0,0,0,0,0,0
20200430,5013,強新,24.50,24.50,24.50,24.50,0.00,0.0,1000,1,24500,0,0,0,0,0,0,0,0,0,0
20200430,5014,建錩,8.20,8.55,8.13,8.13,0.00,0.0,1017000,515,8341770,35000,6000,29000,0,0,0,0,0,0,29000
20200430,5015,華祺,34.95,35.40,34.95,35.30,+0.35,1.0,51000,30,1798350,0,0,0,0,0,0,0,0,0,0
20200430,5016,松和,26.75,27.20,26.75,27.20,+0.45,1.68,8000,6,216550,0,0,0,0,0,0,0,0,0,0
20200430,5102,富強,15.25,15.30,15.25,15.30,+0.05,0.33,32000,10,488100,0,0,0,0,0,0,0,0,0,0
20200430,5201,凱衛,34.10,34.10,33.80,33.90,+0.10,0.3,72000,43,2439000,2000,4000,-2000,0,0,0,0,0,0,-2000
20200430,5202,力新,11.40,12.30,11.10,12.30,+1.10,9.82,98000,61,1191750,1000,0,1000,0,0,0,0,0,0,1000
20200430,5205,中茂,5.85,5.85,5.85,5.85,-0.64,-9.86,22000,3,128700,0,0,0,0,0,0,0,0,0,0
20200430,5206,坤悅,15.15,15.30,15.15,15.25,+0.25,1.67,158000,82,2402250,23000,0,23000,0,0,0,0,0,0,23000
20200430,5209,新鼎,56.70,57.70,56.30,57.00,+0.30,0.53,160000,140,9089300,1000,0,1000,0,0,0,0,0,0,1000
20200430,5210,寶碩,6.45,6.69,6.45,6.57,+0.10,1.55,79000,42,516310,0,4000,-4000,0,0,0,0,0,0,-4000
20200430,5211,蒙恬,13.10,13.30,13.00,13.10,0.00,0.0,80000,47,1051000,1000,0,1000,0,0,0,1000,0,1000,2000
20200430,5212,凌網,58.50,58.50,56.10,56.10,-1.70,-2.94,529000,400,30050800,14000,42000,-28000,0,0,0,7000,50000,-43000,-71000
20200430,5213,亞昕,15.20,15.20,15.05,15.10,+0.05,0.33,163000,67,2458200,2000,8000,-6000,0,0,0,0,0,0,-6000
20200430,5220,萬達光電,27.00,27.15,26.90,27.05,+0.05,0.19,199000,57,5372950,0,0,0,0,0,0,0,0,0,0
20200430,5223,安力-KY,29.50,30.45,29.45,30.40,+0.70,2.36,112000,79,3334000,5000,1000,4000,0,0,0,0,0,0,4000
20200430,5227,立凱-KY,9.70,10.15,9.70,9.75,+0.25,2.63,2823000,1124,27921270,21000,74000,-53000,0,0,0,0,0,0,-53000
20200430,5230,雷笛克光學,23.70,23.75,23.30,23.50,0.00,0.0,87000,49,2043450,0,0,0,0,0,0,0,0,0,0
20200430,5245,智晶,29.30,29.90,29.10,29.75,+0.65,2.23,321000,221,9461150,80000,2000,78000,0,0,0,0,0,0,78000
20200430,5251,天鉞電,10.85,11.10,10.45,10.65,-0.05,-0.47,214000,130,2289300,0,1000,-1000,0,0,0,0,0,0,-1000
20200430,5263,智崴,118.00,120.00,117.00,119.00,+2.00,1.71,428000,336,50609000,9000,18000,-9000,0,0,0,0,609,-609,-9609
20200430,5272,笙科,19.40,19.40,18.95,19.30,+0.15,0.78,228000,120,4356550,24000,10000,14000,0,0,0,0,0,0,14000
20200430,5274,信驊,1200.00,1200.00,1170.00,1190.00,+35.00,3.03,428000,409,507860000,186000,35099,150901,10000,15000,-5000,10000,20000,-10000,135901
20200430,5276,達輝-KY,9.30,9.62,9.24,9.54,+0.24,2.58,13000,11,122030,0,0,0,0,0,0,0,0,0,0
20200430,5278,尚凡,133.00,135.00,127.00,128.00,-1.50,-1.16,142000,137,18493000,1000,9000,-8000,0,0,0,0,0,0,-8000
20200430,5281,大峽谷-KY,21.75,22.30,21.70,21.85,+0.25,1.16,57000,37,1253400,6000,0,6000,0,0,0,0,0,0,6000
20200430,5287,數字,213.00,220.00,213.00,217.50,+4.50,2.11,61000,60,13277000,13000,9000,4000,0,0,0,0,0,0,4000
20200430,5289,宜鼎,184.50,187.00,183.50,187.00,+6.00,3.31,1387000,1070,257397500,284000,69200,214800,35000,0,35000,58000,53000,5000,254800
20200430,5291,邑昇,22.15,22.45,22.15,22.25,+0.30,1.37,320000,176,7129950,5000,6000,-1000,0,0,0,0,0,0,-1000
20200430,5299,杰力,99.70,99.90,98.50,99.00,+0.40,0.41,553000,447,54829800,71000,18000,53000,0,0,0,2000,5000,-3000,50000
20200430,5301,寶得利,9.20,9.20,8.97,9.15,-0.18,-1.93,160000,81,1451150,0,0,0,0,0,0,0,0,0,0
20200430,5302,太欣,5.93,6.03,5.86,5.94,0.00,0.0,292000,106,1730470,14000,3000,11000,0,0,0,0,0,0,11000
20200430,5304,鼎創達,2.33,2.43,2.26,2.43,+0.10,4.29,7000,7,16360,0,0,0,0,0,0,0,0,0,0
20200430,5306,桂盟,86.00,88.00,85.10,86.00,+2.00,2.38,1410000,951,121945200,78000,737000,-659000,29000,0,29000,0,0,0,-630000
20200430,5309,系統電,24.50,25.00,23.60,23.60,-0.20,-0.84,6634000,2833,159575350,348170,443000,-94830,0,0,0,50000,0,50000,-44830
20200430,5310,天剛,13.50,13.50,13.25,13.25,-0.05,-0.38,18000,6,239200,0,0,0,0,0,0,0,0,0,0
20200430,5312,寶島科,62.80,63.10,62.80,63.10,+0.90,1.45,36000,33,2266200,1000,1000,0,0,0,0,0,0,0,0
20200430,5314,世紀,4.10,4.44,4.09,4.15,-0.09,-2.12,15000,12,64590,0,0,0,0,0,0,0,0,0,0
20200430,5315,光聯,12.95,13.05,12.85,13.00,+0.05,0.39,311000,137,4026150,5000,9000,-4000,0,0,0,0,0,0,-4000
20200430,5321,友銓,23.05,23.10,22.80,22.80,-0.25,-1.08,84000,63,1921700,0,0,0,0,0,0,1000,0,1000,1000
20200430,5324,士開,7.50,7.55,7.43,7.55,+0.06,0.8,80000,34,598810,4000,0,4000,0,0,0,0,0,0,4000
20200430,5328,華容,8.38,8.87,8.35,8.75,+0.48,5.8,1694000,709,14643150,104000,33000,71000,0,0,0,0,1000,-1000,70000
20200430,5340,建榮,42.35,42.35,40.00,41.10,+2.60,6.75,4037000,2163,166524250,138000,465000,-327000,0,0,0,330000,16000,314000,-13000
20200430,5344,立衛,10.45,10.80,10.20,10.30,-0.25,-2.37,285000,139,2969600,7000,0,7000,0,0,0,0,0,0,7000
20200430,5345,天揚,5.25,5.25,5.24,5.24,-0.06,-1.13,11000,9,57700,0,0,0,0,0,0,0,0,0,0
20200430,5347,世界,68.90,69.90,68.90,69.90,+1.30,1.9,6760000,4120,469731900,4267000,1033000,3234000,300000,0,300000,127000,44000,83000,3617000
20200430,5348,系通,6.77,6.77,6.47,6.55,-0.22,-3.25,34000,25,223190,0,0,0,0,0,0,0,0,0,0
20200430,5349,先豐,19.00,19.60,18.85,19.55,+0.80,4.27,2730000,1244,52507200,539000,91000,448000,0,0,0,10000,6000,4000,452000
20200430,5351,鈺創,6.45,6.85,6.40,6.70,+0.38,6.01,3377000,1008,22587800,98000,103000,-5000,0,0,0,0,0,0,-5000
20200430,5353,台林,16.90,17.25,16.90,17.15,+0.35,2.08,195000,79,3306850,0,0,0,0,0,0,0,0,0,0
20200430,5355,佳總,4.68,4.68,4.50,4.58,0.00,0.0,158000,56,720450,0,3000,-3000,0,0,0,0,0,0,-3000
20200430,5356,協益,29.20,29.40,28.85,28.90,-0.10,-0.34,283000,214,8227800,4000,18000,-14000,0,0,0,0,0,0,-14000
20200430,5364,力麗店,13.90,13.90,13.90,13.90,0.00,0.0,11000,2,152900,0,0,0,0,0,0,0,0,0,0
20200430,5371,中光電,32.40,32.55,32.00,32.00,-0.30,-0.93,2428000,1377,78319900,298000,1033600,-735600,0,0,0,5000,4000,1000,-734600
20200430,5381,合正,,,,,,0.00,0,0,0,0,0,0,0,0,0,0,0,0,0
20200430,5383,金利,22.85,22.90,22.35,22.55,-0.30,-1.31,89000,47,2014500,3000,1000,2000,0,0,0,0,0,0,2000
20200430,5386,青雲,30.55,30.80,30.00,30.00,+0.45,1.52,349000,224,10586900,13000,10000,3000,0,0,0,0,0,0,3000
20200430,5392,應華,25.45,25.65,24.80,25.05,-0.75,-2.91,1436000,805,36061950,63000,120000,-57000,0,0,0,11000,17000,-6000,-63000
20200430,5398,慕康生醫,24.60,24.60,24.00,24.40,+0.80,3.39,30000,9,726750,0,0,0,0,0,0,0,0,0,0
20200430,5403,中菲,44.85,45.30,44.85,45.15,+0.30,0.67,192000,128,8678950,45000,8000,37000,0,0,0,0,0,0,37000
20200430,5410,國眾,19.60,19.70,19.60,19.70,+0.15,0.77,311000,140,6107700,3000,4000,-1000,0,0,0,0,0,0,-1000
20200430,5425,台半,38.55,38.75,38.00,38.30,+0.20,0.52,2530000,1304,96962900,445000,44000,401000,0,0,0,167000,13000,154000,555000
20200430,5426,振發,9.74,9.96,9.70,9.96,+0.22,2.26,178000,61,1740140,0,0,0,0,0,0,0,0,0,0
20200430,5432,達威,16.00,16.15,15.85,15.85,-0.15,-0.94,22000,12,351750,0,0,0,0,0,0,0,0,0,0
20200430,5438,東友,12.45,13.45,12.40,13.35,+1.00,8.1,787000,477,10404800,12000,14000,-2000,0,0,0,0,0,0,-2000
20200430,5439,高技,42.30,42.30,41.60,42.00,+0.20,0.48,651000,399,27249050,56000,1000,55000,0,0,0,0,1000,-1000,54000
20200430,5443,均豪,18.55,18.65,18.40,18.45,+0.05,0.27,478000,274,8838500,78000,128000,-50000,0,0,0,0,0,0,-50000
20200430,5450,寶聯通,14.90,15.45,14.90,15.20,+0.25,1.67,106000,55,1600050,0,0,0,0,0,0,0,0,0,0
20200430,5452,佶優,6.18,6.30,6.13,6.21,+0.12,1.97,355000,115,2206790,1000,3000,-2000,0,0,0,0,0,0,-2000
20200430,5455,昇益,16.00,16.70,16.00,16.70,-1.05,-5.92,13000,11,209500,0,0,0,0,0,0,0,0,0,0
20200430,5457,宣德,67.40,69.70,67.20,69.30,+2.40,3.59,3639000,2308,249020900,326000,128000,198000,30000,0,30000,76000,34000,42000,270000
20200430,5460,同協,10.80,10.85,10.75,10.85,+0.05,0.46,81000,31,874250,0,0,0,0,0,0,0,0,0,0
20200430,5464,霖宏,11.25,12.00,11.25,11.45,+0.25,2.23,84000,56,974850,0,1000,-1000,0,0,0,0,0,0,-1000
20200430,5465,富驊,12.55,12.60,12.45,12.55,+0.05,0.4,161000,47,2014850,0,5000,-5000,0,0,0,0,0,0,-5000
20200430,5468,凱鈺,9.51,9.51,9.51,9.51,-0.30,-3.06,1000,1,9510,0,0,0,0,0,0,0,0,0,0
20200430,5474,聰泰,77.00,77.90,76.50,76.90,+0.70,0.92,106000,90,8176400,1000,10000,-9000,0,0,0,0,0,0,-9000
20200430,5475,德宏,2.25,2.34,2.25,2.33,0.00,0.0,176000,24,402080,0,0,0,0,0,0,0,0,0,0
20200430,5478,智冠,85.50,85.70,82.50,83.60,-1.40,-1.65,674000,496,56564300,21000,47000,-26000,0,0,0,0,70000,-70000,-96000
20200430,5481,新華,13.05,13.25,13.05,13.10,+0.15,1.16,229000,72,3009700,11000,0,11000,0,0,0,0,0,0,11000
20200430,5483,中美晶,88.00,89.80,87.30,89.10,+2.10,2.41,14921000,9172,1325775700,581000,521381,59619,0,486000,-486000,1013000,134000,879000,452619
20200430,5487,通泰,30.35,31.05,30.35,31.05,+0.85,2.81,25000,20,774950,0,0,0,0,0,0,0,0,0,0
20200430,5488,松普,4.99,5.00,4.94,4.98,+0.03,0.61,59000,28,293200,0,3000,-3000,0,0,0,0,0,0,-3000
20200430,5489,彩富,32.80,32.80,32.60,32.75,+0.05,0.15,86000,35,2809600,0,0,0,0,0,0,0,0,0,0
20200430,5490,同亨,25.20,25.60,25.10,25.20,+0.30,1.2,323000,156,8143350,5000,27000,-22000,0,0,0,0,0,0,-22000
20200430,5493,三聯,39.95,39.95,39.50,39.65,+0.05,0.13,212000,149,8414050,7000,8000,-1000,0,0,0,0,0,0,-1000
20200430,5498,凱崴,10.30,10.50,10.05,10.50,+0.20,1.94,1230000,426,12657650,115000,8000,107000,0,0,0,0,0,0,107000
20200430,5508,永信建,31.00,31.30,30.90,31.30,+0.40,1.29,112000,58,3484150,11000,1000,10000,0,0,0,0,0,0,10000
20200430,5511,德昌,29.15,29.30,29.05,29.20,+0.20,0.69,51000,39,1486250,21000,4000,17000,0,0,0,0,0,0,17000
20200430,5512,力麒,9.29,9.35,9.26,9.32,+0.12,1.3,1360000,390,12671700,193000,20000,173000,0,0,0,0,20000,-20000,153000
20200430,5514,三豐,18.45,19.00,18.45,19.00,+0.10,0.53,7000,6,132150,2000,0,2000,0,0,0,0,0,0,2000
20200430,5516,雙喜,15.10,15.10,15.00,15.00,-0.35,-2.28,26000,8,390300,0,0,0,0,0,0,0,0,0,0
20200430,5520,力泰,31.90,32.00,31.80,32.00,+0.20,0.63,5000,5,159600,1000,0,1000,0,0,0,0,0,0,1000
20200430,5523,豐謙,10.65,10.70,10.40,10.70,+0.05,0.47,86000,23,909300,0,1000,-1000,0,0,0,0,0,0,-1000
20200430,5529,志嘉,6.79,7.20,6.66,6.78,+0.02,0.3,304000,83,2050530,13000,12000,1000,0,0,0,0,0,0,1000
20200430,5530,龍巖,55.30,56.00,55.30,56.00,+0.70,1.27,352000,198,19601700,196000,17000,179000,0,0,0,0,0,0,179000
20200430,5536,聖暉,212.50,215.00,211.50,214.00,+4.00,1.9,1072000,901,228593000,281000,13000,268000,0,0,0,14000,37000,-23000,245000
20200430,5543,崇佑-KY,22.25,22.25,22.00,22.25,-0.50,-2.2,16000,9,353250,0,0,0,0,0,0,2000,0,2000,2000
20200430,5601,台聯櫃,,,,,,0.00,0,0,0,0,0,0,0,0,0,0,0,0,0
20200430,5603,陸海,10.05,10.10,9.96,10.10,0.00,0.0,37000,20,370900,0,0,0,0,0,0,0,0,0,0
20200430,5604,中連貨,48.90,49.90,48.90,49.25,+0.50,1.03,320000,215,15762250,9000,0,9000,0,0,0,0,0,0,9000
20200430,5609,中菲行,24.90,25.15,24.80,24.95,+0.25,1.01,513000,262,12818400,44000,11000,33000,0,0,0,2000,0,2000,35000
20200430,5701,劍湖山,1.31,1.45,1.31,1.45,+0.09,6.62,298000,46,427050,0,0,0,0,0,0,0,0,0,0
20200430,5703,亞都,,,,,,0.00,0,0,0,0,0,0,0,0,0,0,0,0,0
20200430,5704,老爺知,,,,,,0.00,0,0,0,0,0,0,0,0,0,0,0,0,0
20200430,5820,日盛金,9.39,9.43,9.36,9.43,+0.02,0.21,2761000,689,25933080,738000,431000,307000,0,0,0,0,0,0,307000
20200430,5864,致和證,7.97,7.99,7.84,7.91,+0.03,0.38,303000,83,2389400,0,0,0,0,0,0,0,0,0,0
20200430,5878,台名,46.10,46.10,46.00,46.10,0.00,0.0,22000,19,1012700,0,2000,-2000,0,0,0,0,0,0,-2000
20200430,5902,德記,10.15,10.15,10.00,10.05,-0.10,-0.99,23000,11,232600,0,8000,-8000,0,0,0,0,0,0,-8000
20200430,5903,全家,222.00,223.00,222.00,222.00,0.00,0.0,50000,42,11119000,6000,3000,3000,0,0,0,0,0,0,3000
20200430,5904,寶雅,510.00,513.00,497.00,500.00,-1.00,-0.2,165000,160,82823500,30000,68364,-38364,10000,7000,3000,12000,2000,10000,-25364
20200430,5905,南仁湖,8.53,8.94,8.52,8.90,+0.43,5.08,1723000,780,15126080,176000,284000,-108000,0,0,0,0,11000,-11000,-119000
20200430,6015,宏遠證,5.91,6.04,5.91,5.98,+0.09,1.53,329000,107,1968140,5000,5000,0,0,0,0,0,0,0,0
20200430,6016,康和證,6.92,7.02,6.92,7.00,+0.11,1.6,1674000,315,11682380,104000,999000,-895000,0,0,0,0,0,0,-895000
20200430,6020,大展證,12.40,12.50,12.30,12.30,0.00,0.0,19000,8,235600,0,0,0,0,0,0,0,0,0,0
20200430,6021,大慶證,12.90,13.10,12.90,12.95,0.00,0.0,93000,29,1208250,34000,4000,30000,0,0,0,0,0,0,30000
20200430,6023,元大期,53.90,54.10,53.80,53.90,0.00,0.0,300000,175,16198500,17000,19000,-2000,0,0,0,0,28000,-28000,-30000
20200430,6026,福邦證,8.10,8.19,8.08,8.19,+0.14,1.74,1026000,276,8370320,94000,0,94000,0,0,0,0,0,0,94000
20200430,6101,寬魚國際,26.40,26.90,26.25,26.60,0.00,0.0,59000,32,1565100,0,4000,-4000,0,0,0,0,0,0,-4000
20200430,6103,合邦,,,,,,0.00,0,0,0,0,0,0,0,0,0,0,0,0,0
20200430,6104,創惟,33.50,34.15,33.40,33.60,+0.45,1.36,1932000,931,65250550,162000,43000,119000,0,0,0,0,0,0,119000
20200430,6109,亞元,10.15,10.20,10.05,10.20,+0.20,2.0,69000,22,696450,1000,0,1000,0,0,0,0,0,0,1000
20200430,6111,大宇資,68.50,68.70,67.70,67.90,+0.20,0.3,407000,343,27646900,23000,12000,11000,0,0,0,0,0,0,11000
20200430,6113,亞矽,5.43,5.52,5.28,5.47,+0.02,0.37,97000,43,524220,0,0,0,0,0,0,0,0,0,0
20200430,6114,久威,23.15,23.35,23.00,23.15,+0.35,1.54,69000,50,1592900,1000,4000,-3000,0,0,0,0,0,0,-3000
20200430,6118,建達,8.28,8.30,8.12,8.20,-0.04,-0.49,85000,39,699200,0,11000,-11000,0,0,0,0,0,0,-11000
20200430,6121,新普,311.00,312.50,309.50,312.00,+1.00,0.32,910000,758,282772000,175000,85020,89980,123000,199000,-76000,7000,22000,-15000,-1020
20200430,6122,擎邦,15.80,15.85,15.65,15.75,+0.05,0.32,713000,309,11237950,180000,11000,169000,0,0,0,0,0,0,169000
20200430,6123,上奇,40.50,40.75,40.45,40.70,+0.35,0.87,141000,89,5727800,4000,3000,1000,0,0,0,0,0,0,1000
20200430,6124,業強,31.55,32.15,31.10,31.65,+0.65,2.1,233000,183,7346900,40000,13000,27000,0,0,0,0,4000,-4000,23000
20200430,6125,廣運,15.50,15.50,15.20,15.35,0.00,0.0,2416000,771,36968450,175000,189000,-14000,0,0,0,0,0,0,-14000
20200430,6126,信音,14.30,14.30,14.10,14.15,+0.10,0.71,694000,216,9811950,83000,19000,64000,0,0,0,0,0,0,64000
20200430,6127,九豪,15.35,16.50,15.10,16.50,+1.50,10.0,5526000,1825,89515100,109000,87000,22000,0,0,0,0,0,0,22000
20200430,6129,普誠,6.39,6.43,6.32,6.36,+0.06,0.95,512000,175,3269630,1000,25000,-24000,0,0,0,0,0,0,-24000
20200430,6130,星寶國際,26.30,26.50,26.20,26.50,-0.20,-0.75,12000,11,315350,0,0,0,0,0,0,0,0,0,0
20200430,6134,萬旭,6.44,6.44,6.18,6.31,+0.17,2.77,51000,23,318040,0,0,0,0,0,0,0,0,0,0
20200430,6138,茂達,67.20,68.70,66.60,68.00,+1.80,2.72,1065000,740,72096500,69000,14000,55000,0,0,0,2000,3000,-1000,54000
20200430,6140,訊達,9.94,9.94,9.92,9.92,+0.12,1.22,2000,2,19860,0,0,0,0,0,0,0,0,0,0
20200430,6143,振曜,34.00,34.15,33.90,34.00,+0.15,0.44,122000,95,4147850,18000,5000,13000,0,0,0,0,0,0,13000
20200430,6144,得利影,7.40,7.85,7.40,7.84,+0.44,5.95,9000,4,67490,0,0,0,0,0,0,0,0,0,0
20200430,6146,耕興,192.50,197.50,191.50,197.50,+6.00,3.13,151000,117,29093000,107600,13000,94600,0,0,0,0,1000,-1000,93600
20200430,6147,頎邦,54.90,56.60,54.40,56.60,+2.40,4.43,12595000,6465,697928800,828000,577000,251000,410000,0,410000,403000,16000,387000,1048000
20200430,6148,驊宏資,9.94,9.94,9.88,9.88,0.00,0.0,48000,26,475490,0,13000,-13000,0,0,0,0,0,0,-13000
20200430,6150,撼訊,45.20,46.85,44.50,45.50,+1.70,3.88,2597000,1816,118627050,55000,78000,-23000,0,0,0,0,34000,-34000,-57000
20200430,6151,晉倫,19.60,19.60,19.35,19.50,0.00,0.0,70000,33,1360350,0,4000,-4000,0,0,0,0,0,0,-4000
20200430,6154,順發,12.05,12.50,11.95,12.50,+0.50,4.17,43000,34,520450,0,0,0,0,0,0,0,0,0,0
20200430,6156,松上,11.10,11.40,11.10,11.30,+0.20,1.8,151000,66,1704600,0,0,0,0,0,0,0,0,0,0
20200430,6158,禾昌,19.25,20.95,19.20,20.50,+1.40,7.33,293000,224,5903350,20000,4000,16000,0,0,0,0,0,0,16000
20200430,6160,欣技,12.45,12.80,12.35,12.65,+0.30,2.43,108000,67,1350000,2000,0,2000,0,0,0,0,0,0,2000
20200430,6161,捷波,16.60,16.90,16.55,16.60,+0.25,1.53,210000,83,3512350,0,13000,-13000,0,0,0,0,0,0,-13000
20200430,6163,華電網,14.35,14.55,14.20,14.50,+0.25,1.75,481000,167,6951600,23000,20000,3000,0,0,0,0,0,0,3000
20200430,6167,久正,6.09,6.19,6.09,6.10,+0.01,0.16,346000,126,2125340,0,0,0,0,0,0,0,0,0,0
20200430,6169,昱泉,36.05,36.30,34.10,34.75,-1.30,-3.61,299000,231,10592600,8000,12000,-4000,0,0,0,4000,0,4000,0
20200430,6170,統振,16.40,16.60,15.85,16.20,0.00,0.0,4475000,1871,72638600,381000,386000,-5000,0,0,0,0,0,0,-5000
20200430,6171,亞銳士,19.65,20.15,19.65,20.10,+0.95,4.96,168000,80,3351650,10000,0,10000,0,0,0,0,0,0,10000
20200430,6173,信昌電,60.20,61.80,59.30,59.80,+1.50,2.57,11169000,7806,674327100,389000,737000,-348000,0,0,0,144000,145000,-1000,-349000
20200430,6174,安碁,11.20,11.25,10.90,11.05,-0.15,-1.34,165000,78,1826450,0,0,0,0,0,0,0,0,0,0
20200430,6175,立敦,19.05,20.15,19.05,19.55,+0.75,3.99,1741000,1045,34434400,57000,66000,-9000,0,0,0,0,0,0,-9000
20200430,6179,亞通,30.35,31.55,30.00,30.60,+0.25,0.82,223000,121,6834900,0,2000,-2000,0,0,0,0,0,0,-2000
20200430,6180,橘子,52.70,53.00,52.40,52.90,+0.60,1.15,1351000,925,71202000,302000,377000,-75000,0,0,0,0,0,0,-75000
20200430,6182,合晶,31.50,32.70,31.20,32.70,+1.80,5.83,18224000,8805,584026100,2999000,588000,2411000,0,0,0,803000,77000,726000,3137000
20200430,6185,幃翔,14.60,15.30,14.60,14.90,+0.55,3.83,2464000,848,36850950,96000,114000,-18000,0,0,0,11000,6000,5000,-13000
20200430,6186,新潤,29.40,30.15,29.40,29.90,+0.50,1.7,736000,379,21944500,5000,15000,-10000,0,0,0,2000,0,2000,-8000
20200430,6187,萬潤,43.50,43.50,41.00,41.60,+1.40,3.48,645000,403,27181950,7000,58000,-51000,0,0,0,0,0,0,-51000
20200430,6188,廣明,36.20,36.50,35.20,35.35,-0.85,-2.35,6786000,4018,241484500,223000,564000,-341000,0,0,0,15000,207000,-192000,-533000
20200430,6190,萬泰科,15.45,15.75,15.35,15.70,+0.35,2.28,1532000,498,23784700,104000,6000,98000,0,0,0,0,0,0,98000
20200430,6194,育富,23.80,23.80,23.60,23.75,+0.05,0.21,74000,37,1753500,0,0,0,0,0,0,0,0,0,0
20200430,6195,詩肯,31.00,31.10,30.70,30.95,+0.40,1.31,32000,25,990100,0,0,0,0,0,0,0,0,0,0
20200430,6198,凌泰,,,,,,0.00,0,0,0,0,0,0,0,0,0,0,0,0,0
20200430,6199,天品,11.85,11.85,11.85,11.85,+0.30,2.6,1000,1,11850,0,0,0,0,0,0,0,0,0,0
20200430,006201,元大富櫃50,12.98,13.02,12.96,13.02,+0.19,1.48,89000,52,1155900,0,0,0,0,0,0,61000,0,61000,61000
20200430,6203,海韻電,41.90,42.25,41.50,41.70,+0.05,0.12,638000,358,26706500,66000,24000,42000,0,0,0,8000,71000,-63000,-21000
20200430,6204,艾華,24.20,24.60,24.15,24.20,+0.05,0.21,29000,23,705050,0,0,0,0,0,0,0,0,0,0
20200430,6207,雷科,22.35,22.50,22.15,22.35,+0.30,1.36,284000,161,6353600,31000,3000,28000,0,0,0,0,0,0,28000
20200430,6208,日揚,24.50,24.65,24.40,24.50,+0.20,0.82,193000,130,4728700,19000,2000,17000,0,0,0,0,0,0,17000
20200430,6210,慶生,42.90,43.80,42.90,43.10,+0.40,0.94,168000,131,7242600,2000,21000,-19000,0,0,0,0,0,0,-19000
20200430,6212,理銘,45.80,48.00,45.55,46.50,+2.00,4.49,23000,10,1089700,0,0,0,0,0,0,0,0,0,0
20200430,6217,中探針,30.90,31.05,30.55,30.85,+0.40,1.31,626000,333,19327350,50000,24000,26000,0,0,0,0,0,0,26000
20200430,6218,豪勉,20.10,20.15,19.90,20.05,+0.05,0.25,49000,26,981800,0,2000,-2000,0,0,0,0,0,0,-2000
20200430,6219,富旺,17.30,17.45,17.00,17.00,-0.35,-2.02,4390000,854,75448750,687000,51000,636000,0,0,0,0,0,0,636000
20200430,6220,岳豐,18.40,18.40,18.10,18.20,0.00,0.0,364000,190,6624700,0,51000,-51000,0,0,0,2000,0,2000,-49000
20200430,6221,晉泰,57.80,57.80,56.60,57.00,0.00,0.0,80000,67,4569300,0,0,0,0,0,0,0,0,0,0
20200430,6222,上揚,,,,,,0.00,0,0,0,0,0,0,0,0,0,0,0,0,0
20200430,6223,旺矽,64.50,67.30,63.80,66.40,+2.70,4.24,2077000,1438,137273500,165000,97000,68000,0,0,0,43000,63000,-20000,48000
20200430,6227,茂綸,19.20,20.85,19.00,20.85,+1.85,9.74,418000,190,8318450,13000,11000,2000,0,0,0,0,0,0,2000
20200430,6228,全譜,6.03,6.03,6.02,6.03,+0.07,1.17,12000,5,72340,0,0,0,0,0,0,0,0,0,0
20200430,6229,研通,12.30,12.60,12.30,12.45,+0.15,1.22,113000,48,1409300,4000,0,4000,0,0,0,0,0,0,4000
20200430,6231,系微,62.20,63.20,61.50,61.90,-0.10,-0.16,626000,428,38888100,67000,23000,44000,0,0,0,0,0,0,44000
20200430,6233,旺玖,11.35,11.95,11.35,11.45,+0.15,1.33,2272000,685,26646450,37000,245000,-208000,0,0,0,0,0,0,-208000
20200430,6234,高僑,22.70,22.75,22.40,22.55,+0.30,1.35,311000,160,7022200,26000,20000,6000,0,0,0,0,0,0,6000
20200430,6236,康呈,,,,,,0.00,0,0,0,0,0,0,0,0,0,0,0,0,0
20200430,6237,驊訊,15.10,15.10,14.55,14.80,-0.05,-0.34,447000,167,6575100,0,24000,-24000,0,0,0,0,0,0,-24000
20200430,6238,勝麗,139.50,145.00,138.00,145.00,+7.50,5.45,1051000,855,149307500,156000,23000,133000,100000,0,100000,8000,2000,6000,239000
20200430,6240,松崗,12.50,12.60,12.35,12.35,-0.15,-1.2,50000,28,624550,0,0,0,0,0,0,0,0,0,0
20200430,6241,易通展,10.40,10.75,10.40,10.40,-0.10,-0.95,13000,9,136750,0,0,0,0,0,0,0,0,0,0
20200430,6242,立康,32.80,35.00,32.80,35.00,+2.15,6.54,6000,6,202200,0,0,0,0,0,0,0,0,0,0
20200430,6244,茂迪,5.42,5.47,5.39,5.45,+0.07,1.3,1333000,453,7240800,135000,22000,113000,0,0,0,0,0,0,113000
20200430,6245,立端,58.50,59.50,57.80,58.90,+1.30,2.26,898000,648,52644800,140000,43000,97000,0,0,0,17000,5000,12000,109000
20200430,6246,臺龍,7.25,7.26,7.20,7.20,-0.05,-0.69,32000,10,231860,0,0,0,0,0,0,0,0,0,0
20200430,6247,淇譽電,9.16,9.30,9.15,9.20,+0.09,0.99,8000,8,73710,0,0,0,0,0,0,0,0,0,0
20200430,6248,沛波,28.05,28.85,28.00,28.15,-0.05,-0.18,61000,33,1715850,0,0,0,0,0,0,0,0,0,0
20200430,6259,百徽,1.91,1.93,1.86,1.86,-0.04,-2.11,104000,20,195910,0,0,0,0,0,0,0,0,0,0
20200430,6261,久元,51.00,51.20,50.50,50.70,+0.20,0.4,761000,481,38623900,108000,45000,63000,0,0,0,1000,5000,-4000,59000
20200430,6263,普萊德,62.20,62.40,62.00,62.30,+0.30,0.48,94000,66,5844900,100,5000,-4900,0,0,0,0,0,0,-4900
20200430,6264,富裔,5.25,5.30,5.25,5.25,+0.07,1.35,21000,6,110600,0,0,0,0,0,0,0,0,0,0
20200430,6265,方土昶,5.61,5.63,5.57,5.62,+0.05,0.9,139000,53,776630,0,0,0,0,0,0,0,0,0,0
20200430,6266,泰詠,19.90,20.20,19.80,20.20,+0.45,2.28,569000,230,11377750,64000,0,64000,0,0,0,0,0,0,64000
20200430,6270,倍微,15.40,15.50,15.35,15.45,+0.15,0.98,409000,175,6312350,2000,0,2000,0,0,0,0,0,0,2000
20200430,6274,台燿,132.50,136.00,132.00,136.00,+7.00,5.43,4832000,3428,647908000,956000,797000,159000,48000,0,48000,80000,73000,7000,214000
20200430,6275,元山,16.60,16.85,16.45,16.60,+0.20,1.22,298000,113,4958950,1000,9000,-8000,0,0,0,0,0,0,-8000
20200430,6276,安鈦克,16.45,17.45,16.35,16.80,+0.45,2.75,1483000,748,24996850,28000,73000,-45000,0,0,0,0,0,0,-45000
20200430,6279,胡連,72.10,73.00,71.20,72.00,+1.00,1.41,807000,647,58123900,32000,67000,-35000,0,0,0,5000,25000,-20000,-55000
20200430,6284,佳邦,32.00,32.40,31.70,32.00,+0.35,1.11,1254000,801,40169950,180000,97000,83000,0,0,0,0,0,0,83000
20200430,6287,元隆,2.10,2.31,2.10,2.20,+0.10,4.76,19000,11,42080,0,0,0,0,0,0,0,0,0,0
20200430,6290,良維,63.40,63.50,62.20,62.90,+0.70,1.13,2908000,1808,183068900,900000,235000,665000,0,630000,-630000,7000,82000,-75000,-40000
20200430,6291,沛亨,,,,,,0.00,0,0,0,0,0,0,0,0,0,0,0,0,0
20200430,6292,迅德,38.65,39.30,38.50,39.00,+0.50,1.3,253000,150,9832250,34000,0,34000,0,0,0,0,0,0,34000
20200430,6294,智基,101.50,102.50,101.50,102.00,+0.50,0.49,34000,31,3466500,3000,0,3000,0,0,0,0,0,0,3000
20200430,6404,通訊-KY,3.18,3.18,3.01,3.16,+0.01,0.32,9000,7,27890,0,0,0,0,0,0,0,0,0,0
20200430,6411,晶焱,86.00,86.90,85.50,86.80,+1.40,1.64,1544000,1080,133212500,132000,248000,-116000,0,0,0,9000,19000,-10000,-126000
20200430,6417,韋僑,57.70,57.70,57.70,57.70,+0.90,1.58,3000,3,173100,0,0,0,0,0,0,0,0,0,0
20200430,6418,詠昇,13.45,13.65,13.45,13.60,+0.30,2.26,13000,13,176000,0,0,0,0,0,0,0,0,0,0
20200430,6419,京晨科,16.35,16.35,15.85,16.20,+0.30,1.89,26000,22,418800,0,1000,-1000,0,0,0,0,0,0,-1000
20200430,6425,易發,25.85,25.85,25.30,25.40,-0.45,-1.74,19000,14,483750,0,2000,-2000,0,0,0,0,0,0,-2000
20200430,6426,統新,151.00,154.50,146.50,146.50,-3.00,-2.01,3032000,2516,453749500,47000,75000,-28000,0,0,0,7000,27000,-20000,-48000
20200430,6432,今展科,28.40,29.50,28.40,29.30,+1.00,3.53,661000,408,19271000,50000,16000,34000,0,0,0,0,0,0,34000
20200430,6435,大中,88.80,88.80,86.90,87.20,+0.50,0.58,586000,461,51318200,17000,79000,-62000,0,0,0,3000,15000,-12000,-74000
20200430,6438,迅得,60.40,61.50,59.50,60.30,+0.30,0.5,1717000,1078,103799600,52000,4000,48000,0,0,0,6000,12000,-6000,42000
20200430,6441,廣錠,79.00,81.70,78.00,80.00,+3.00,3.9,3673000,2735,295002700,103000,183000,-80000,316000,0,316000,85000,0,85000,321000
20200430,6446,藥華藥,94.50,95.40,92.60,93.20,-0.40,-0.43,267000,214,25019700,0,42000,-42000,0,0,0,0,0,0,-42000
20200430,6457,紘康,83.00,84.00,77.10,81.90,-2.50,-2.96,3207000,2247,257305200,30000,87000,-57000,0,0,0,0,6000,-6000,-63000
20200430,6461,益得,16.90,16.90,16.50,16.55,+0.05,0.3,115000,69,1911100,5000,3000,2000,0,0,0,0,0,0,2000
20200430,6462,神盾,192.50,195.00,187.50,191.50,+1.50,0.79,8395000,6662,1602481500,173000,727000,-554000,0,51000,-51000,43000,101000,-58000,-663000
20200430,6465,威潤,38.90,38.90,37.85,37.85,-1.05,-2.7,162000,119,6193250,2000,1000,1000,0,0,0,0,0,0,1000
20200430,6469,大樹,81.50,82.20,81.30,81.80,0.00,0.0,77000,57,6307600,0,35000,-35000,0,0,0,0,0,0,-35000
20200430,6470,宇智,40.50,40.50,40.25,40.35,+0.35,0.87,99000,72,3993700,0,1000,-1000,0,0,0,0,0,0,-1000
20200430,6472,保瑞,148.50,150.50,148.00,148.50,+1.00,0.68,260000,219,38757000,43000,11000,32000,0,0,0,0,0,0,32000
20200430,6482,弘煜科,27.40,27.40,27.15,27.15,+0.55,2.07,6000,5,163450,0,0,0,0,0,0,0,0,0,0
20200430,6485,點序,26.60,28.70,26.55,28.70,+2.60,9.96,799000,384,22466100,2000,17000,-15000,0,0,0,0,0,0,-15000
20200430,6486,互動,74.70,75.10,74.70,74.70,0.00,0.0,244000,193,18254300,28000,5000,23000,0,0,0,0,0,0,23000
20200430,6488,環球晶,373.50,388.50,372.50,385.00,+17.00,4.62,11062000,8766,4214726000,2598212,1629000,969212,277000,0,277000,827000,14000,813000,2059212
20200430,6492,生華科,81.00,81.50,76.90,79.10,-2.90,-3.54,1362000,954,107378100,33000,22000,11000,0,0,0,0,0,0,11000
20200430,6494,九齊,31.15,31.25,30.90,30.95,-0.05,-0.16,167000,121,5183600,18000,13999,4001,0,0,0,0,0,0,4001
20200430,6496,科懋,28.35,28.45,27.90,27.95,0.00,0.0,133000,76,3727950,0,2000,-2000,0,0,0,0,0,0,-2000
20200430,6497,亞獅康-KY,4.10,4.10,4.00,4.00,-0.07,-1.72,30000,14,121700,0,0,0,0,0,0,0,0,0,0
20200430,6499,益安,51.30,53.40,51.30,52.80,+1.80,3.53,79000,61,4155700,1000,0,1000,0,0,0,0,0,0,1000
20200430,6506,雙邦,17.90,18.00,17.80,17.95,+0.05,0.28,106000,58,1896350,8000,1000,7000,0,0,0,0,0,0,7000
20200430,6508,惠光,29.30,29.80,29.30,29.65,+0.40,1.37,246000,144,7271700,0,0,0,0,0,0,0,0,0,0
20200430,6509,聚和,17.90,17.95,17.75,17.85,+0.15,0.85,246000,128,4385000,18000,23000,-5000,0,0,0,0,0,0,-5000
20200430,6510,精測,654.00,664.00,650.00,655.00,+13.00,2.02,1504000,1415,987268000,114000,104000,10000,0,15000,-15000,40000,23000,17000,12000
20200430,6512,啟發電,12.15,12.35,12.00,12.15,0.00,0.0,32000,23,387550,0,0,0,0,0,0,0,0,0,0
20200430,6514,芮特-KY,55.40,57.50,55.20,56.90,+2.20,4.02,209000,176,11730200,19000,4000,15000,0,0,0,0,0,0,15000
20200430,6516,勤崴國際,86.00,87.60,86.00,87.00,+2.00,2.35,27000,25,2343000,0,0,0,0,0,0,0,0,0,0
20200430,6523,達爾膚,63.90,64.70,63.00,63.60,+0.80,1.27,406000,350,25855700,54000,14000,40000,0,0,0,0,0,0,40000
20200430,6527,明達醫,54.00,54.90,53.20,53.50,-0.10,-0.19,268000,199,14419200,10000,5000,5000,0,0,0,0,0,0,5000
20200430,6530,創威,18.05,18.80,17.20,17.75,0.00,0.0,350000,193,6276450,0,0,0,0,0,0,2000,1000,1000,1000
20200430,6532,瑞耘,46.30,47.35,45.80,46.30,+0.10,0.22,1393000,764,64473200,134000,26000,108000,0,0,0,0,0,0,108000
20200430,6535,順藥,27.40,27.40,26.65,26.85,-0.25,-0.92,116000,81,3130150,7000,5000,2000,0,0,0,0,0,0,2000
20200430,6538,倉和,237.00,242.00,236.00,238.00,+3.00,1.28,1818000,1491,432678500,44000,82000,-38000,0,0,0,0,0,0,-38000
20200430,6542,隆中,50.50,51.20,50.50,51.20,+1.20,2.4,3000,3,152200,0,0,0,0,0,0,0,0,0,0
20200430,6547,高端疫苗,54.90,56.50,53.60,53.60,+0.30,0.56,5859000,3706,319326800,2000,226000,-224000,0,0,0,0,0,0,-224000
20200430,6548,長科*,30.40,30.60,29.50,30.10,+0.15,0.5,857000,352,25695250,24000,80000,-56000,0,0,0,0,0,0,-56000
20200430,6556,勝品,47.00,47.00,46.00,46.95,+0.10,0.21,28000,10,1293650,0,0,0,0,0,0,0,0,0,0
20200430,6560,欣普羅,29.95,29.95,29.30,29.30,-0.10,-0.34,43000,28,1262750,0,1000,-1000,0,0,0,0,0,0,-1000
20200430,6561,是方,300.00,303.50,295.00,297.00,-1.50,-0.5,415000,384,123817000,115000,12000,103000,0,0,0,0,4000,-4000,99000
20200430,6568,宏觀,127.50,127.50,125.50,126.00,+0.50,0.4,101000,91,12760000,5000,4000,1000,0,9000,-9000,0,0,0,-8000
20200430,6569,醫揚,173.00,173.00,172.00,173.00,0.00,0.0,23000,19,3965000,0,2000,-2000,0,0,0,0,0,0,-2000
20200430,6570,維田,39.45,39.45,39.00,39.40,-0.20,-0.51,26000,20,1022600,0,1000,-1000,0,0,0,0,0,0,-1000
20200430,6574,霈方,58.10,59.30,58.00,59.30,+1.60,2.77,10000,10,584200,0,0,0,0,0,0,0,0,0,0
20200430,6576,逸達,48.00,48.00,46.55,47.05,+0.15,0.32,175000,128,8237150,16000,0,16000,0,0,0,0,0,0,16000
20200430,6577,勁豐,73.30,74.50,73.30,74.00,+0.20,0.27,62000,51,4575300,1000,0,1000,0,0,0,0,0,0,1000
20200430,6578,達邦蛋白,20.00,20.25,19.90,20.20,+0.60,3.06,57000,45,1143250,0,0,0,0,0,0,0,0,0,0
20200430,6589,台康生技,46.65,48.00,45.15,46.30,-0.35,-0.75,6353000,4034,294702150,120000,424000,-304000,0,0,0,0,0,0,-304000
20200430,6590,普鴻,32.65,33.95,32.50,33.50,0.00,0.0,28000,16,936800,0,0,0,0,0,0,0,0,0,0
20200430,6593,台灣銘板,,,,,,0.00,0,0,0,0,0,0,0,0,0,0,0,0,0
20200430,6594,展匯科,20.10,20.15,19.75,19.95,-0.05,-0.25,92000,64,1829500,0,0,0,0,0,0,0,0,0,0
20200430,6596,寬宏藝術,49.85,52.50,49.85,51.20,+1.85,3.75,144000,118,7312850,7000,4000,3000,0,0,0,0,0,0,3000
20200430,6603,富強鑫,10.00,10.15,9.72,10.00,+0.01,0.1,361000,131,3575310,0,0,0,0,0,0,3000,0,3000,3000
20200430,6609,瀧澤科,25.00,26.30,25.00,26.15,+1.05,4.18,178000,117,4613750,2000,2000,0,0,0,0,0,0,0,0
20200430,6612,奈米醫材,66.60,67.50,66.40,67.30,+0.70,1.05,126000,100,8408600,7000,6000,1000,0,0,0,0,0,0,1000
20200430,6613,朋億,152.50,152.50,151.00,152.00,+2.00,1.33,63000,61,9561000,0,6000,-6000,0,0,0,0,0,0,-6000
20200430,6615,慧智,61.70,62.20,61.70,62.20,+0.60,0.97,13000,13,804800,0,0,0,0,0,0,0,0,0,0
20200430,6616,特昇-KY,26.25,26.25,26.00,26.20,0.00,0.0,55000,42,1439600,0,0,0,0,0,0,0,0,0,0
20200430,6624,萬年清,36.50,36.50,35.90,36.20,+0.20,0.56,18000,9,651900,0,0,0,0,0,0,0,0,0,0
20200430,6629,泰金-KY,47.25,48.00,47.25,47.90,+1.00,2.13,14000,13,665750,0,0,0,0,0,0,0,0,0,0
20200430,6640,均華,46.00,47.00,45.70,46.70,+0.40,0.86,122000,52,5671500,0,0,0,0,0,0,0,0,0,0
20200430,6642,富致,33.50,34.05,33.50,33.95,+0.65,1.95,17000,16,577200,0,0,0,0,0,0,0,0,0,0
20200430,6643,M31,267.50,274.50,267.50,273.50,+8.50,3.21,506000,472,137284500,43000,16000,27000,0,0,0,28000,0,28000,55000
20200430,6649,台生材,30.00,30.00,28.80,28.80,-1.30,-4.32,48000,34,1403000,3000,0,3000,0,0,0,0,0,0,3000
20200430,6654,天正國際,41.45,41.50,40.60,41.50,-0.50,-1.19,21000,17,868100,0,0,0,0,0,0,1000,0,1000,1000
20200430,6662,樂斯科,40.90,42.60,40.50,41.95,-0.05,-0.12,168000,125,6960600,2000,1000,1000,0,0,0,0,0,0,1000
20200430,6664,群翊,60.80,61.70,60.70,61.50,+1.00,1.65,189000,151,11577000,38000,8000,30000,0,0,0,0,0,0,30000
20200430,6667,信紘科,72.50,74.80,71.40,74.00,+2.70,3.79,1146000,940,83798600,39000,20000,19000,0,0,0,0,0,0,19000
20200430,6679,鈺太,158.00,159.50,155.00,156.00,-2.00,-1.27,2318000,1831,364574000,61000,179000,-118000,75000,10000,65000,23000,65000,-42000,-95000
20200430,6680,鑫創電子,65.80,65.80,65.50,65.50,+1.70,2.66,8000,6,526000,0,0,0,0,0,0,0,0,0,0
20200430,6683,雍智科技,205.00,213.00,203.00,210.50,+9.50,4.73,1675000,1421,350451500,32000,46000,-14000,148000,0,148000,78000,21000,57000,191000
20200430,6690,安碁資訊,148.50,152.00,143.50,144.50,-4.00,-2.69,248000,225,36440500,1000,5000,-4000,0,0,0,0,0,0,-4000
20200430,6697,東捷資訊,38.40,40.60,38.30,40.55,+2.75,7.28,198000,141,7796750,14000,0,14000,0,0,0,0,0,0,14000
20200430,6716,應廣,71.10,71.80,67.00,69.00,-2.00,-2.82,340000,261,23816700,0,18000,-18000,0,0,0,0,0,0,-18000
20200430,6803,崑鼎,209.50,210.50,209.50,210.00,+2.00,0.96,46000,43,9658000,0,0,0,0,0,0,0,0,0,0
20200430,7402,邑錡,33.00,33.10,32.00,32.80,-0.20,-0.61,23000,22,750500,0,0,0,0,0,0,0,0,0,0
20200430,8024,佑華,8.36,8.85,8.36,8.67,+0.45,5.47,212000,96,1829930,0,3000,-3000,0,0,0,0,0,0,-3000
20200430,8027,鈦昇,34.00,34.55,33.80,34.45,+0.65,1.92,437000,168,14973250,68000,8000,60000,0,0,0,0,0,0,60000
20200430,8032,光菱,22.60,22.70,22.55,22.70,+0.20,0.89,16000,13,361650,0,0,0,0,0,0,0,0,0,0
20200430,8034,榮群,22.45,24.45,22.25,24.45,+2.20,9.89,4920000,2170,117870150,329000,205000,124000,0,0,0,0,0,0,124000
20200430,8038,長園科,32.50,32.50,32.00,32.10,-0.20,-0.62,194000,128,6255450,5000,0,5000,0,0,0,0,0,0,5000
20200430,8040,九暘,19.10,19.20,18.75,18.80,+0.10,0.53,1195000,622,22597600,63000,111000,-48000,0,0,0,0,0,0,-48000
20200430,8042,金山電,31.80,32.10,31.55,31.90,+0.60,1.92,124000,99,3948350,18000,0,18000,0,0,0,0,0,0,18000
20200430,8043,蜜望實,24.85,26.45,24.60,26.45,+2.40,9.98,1749000,916,45273550,49000,19000,30000,0,0,0,0,0,0,30000
20200430,8044,網家,98.60,100.50,97.60,98.60,+1.60,1.65,3088000,2225,305749600,154000,196000,-42000,60000,0,60000,93000,59000,34000,52000
20200430,8047,星雲,10.10,10.10,9.95,10.00,+0.08,0.81,11000,8,110100,0,0,0,0,0,0,0,0,0,0
20200430,8048,德勝,33.25,33.30,32.90,33.15,+0.25,0.76,178000,134,5890950,10000,1000,9000,0,30000,-30000,0,0,0,-21000
20200430,8049,晶采,20.60,21.00,20.60,20.90,+0.45,2.2,651000,323,13536900,34000,0,34000,0,0,0,0,0,0,34000
20200430,8050,廣積,37.60,38.65,37.60,38.10,+0.70,1.87,555000,277,21225700,23000,0,23000,0,0,0,0,0,0,23000
20200430,8054,安國,12.10,12.30,12.05,12.15,+0.10,0.83,214000,86,2589900,21000,0,21000,0,0,0,0,0,0,21000
20200430,8059,凱碩,14.90,15.00,14.45,14.45,-0.40,-2.69,224000,119,3291600,0,28000,-28000,0,0,0,0,0,0,-28000
20200430,8064,東捷,14.85,14.95,14.80,14.85,+0.05,0.34,622000,270,9241700,76000,6000,70000,0,0,0,0,0,0,70000
20200430,8066,來思達,65.30,66.00,64.60,65.00,+0.50,0.78,176000,132,11475600,11000,1000,10000,0,0,0,0,0,0,10000
20200430,8067,志旭,7.40,7.61,7.40,7.60,+0.18,2.43,5000,3,37810,0,0,0,0,0,0,0,0,0,0
20200430,8068,全達,26.30,26.85,26.15,26.45,+0.20,0.76,30000,25,795650,0,2000,-2000,0,0,0,0,0,0,-2000
20200430,8069,元太,31.00,31.20,30.70,31.00,+0.25,0.81,6658000,2901,206177800,783000,1576000,-793000,0,0,0,27000,46000,-19000,-812000
20200430,8071,能率網通,13.40,13.40,13.10,13.25,+0.05,0.38,467000,199,6176700,31000,0,31000,0,0,0,0,0,0,31000
20200430,8074,鉅橡,16.65,16.90,16.20,16.60,-0.05,-0.3,277000,142,4589000,0,0,0,0,0,0,3000,0,3000,3000
20200430,8076,伍豐,28.95,29.10,28.60,29.05,+0.25,0.87,670000,427,19321000,221000,92345,128655,0,0,0,0,6000,-6000,122655
20200430,8077,洛碁,10.00,10.05,10.00,10.00,0.00,0.0,18000,13,180550,0,0,0,0,0,0,0,0,0,0
20200430,8080,永利聯合,2.93,2.93,2.91,2.91,+0.01,0.34,22000,3,64220,0,0,0,0,0,0,0,0,0,0
20200430,8083,瑞穎,150.00,150.00,149.50,150.00,+0.50,0.33,30000,21,4490500,2000,0,2000,0,0,0,0,0,0,2000
20200430,8084,巨虹,35.00,39.00,35.00,38.65,+0.55,1.44,140000,69,5350950,0,0,0,0,0,0,0,0,0,0
20200430,8085,福華,3.49,3.68,3.49,3.60,+0.13,3.75,428000,107,1508030,0,3000,-3000,0,0,0,0,0,0,-3000
20200430,8086,宏捷科,93.20,93.80,90.60,90.60,-0.90,-0.98,10678000,7223,980230000,482000,1968000,-1486000,0,0,0,24000,95000,-71000,-1557000
20200430,8087,華鎂鑫,,,,,,0.00,0,0,0,0,0,0,0,0,0,0,0,0,0
20200430,8088,品安,30.90,30.95,30.55,30.65,+0.10,0.33,2567000,1154,78819800,503000,65000,438000,0,0,0,0,0,0,438000
20200430,8091,翔名,50.50,51.80,49.80,50.60,+1.00,2.02,151000,119,7613500,12000,8000,4000,0,0,0,3000,0,3000,7000
20200430,8092,建暐,8.20,8.20,7.60,7.79,-0.09,-1.14,30000,20,231980,0,0,0,0,0,0,0,0,0,0
20200430,8093,保銳,4.35,4.35,4.26,4.34,0.00,0.0,82000,32,351960,0,4000,-4000,0,0,0,0,0,0,-4000
20200430,8096,擎亞,11.80,11.85,11.50,11.60,+0.05,0.43,1443000,485,16810350,30000,128000,-98000,0,0,0,0,0,0,-98000
20200430,8097,常珵,11.25,11.35,11.15,11.25,-0.10,-0.88,22000,10,247350,0,0,0,0,0,0,0,0,0,0
20200430,8099,大世科,16.35,16.55,16.35,16.45,+0.15,0.92,73000,49,1200850,0,0,0,0,0,0,0,0,0,0
20200430,8107,大億金茂,17.00,17.20,17.00,17.10,+0.20,1.18,136000,53,2321800,0,0,0,0,0,0,0,0,0,0
20200430,8109,博大,70.00,70.30,69.70,70.00,+0.40,0.57,38000,34,2661900,2000,0,2000,0,0,0,0,0,0,2000
20200430,8111,立碁,9.34,9.37,9.20,9.23,-0.08,-0.86,620000,215,5751690,38000,11000,27000,0,0,0,0,26000,-26000,1000
20200430,8121,越峰,9.83,9.99,9.70,9.81,+0.21,2.19,224000,122,2193640,19000,4000,15000,0,0,0,0,0,0,15000
20200430,8147,正淩,28.20,30.25,28.00,30.00,+2.50,9.09,200000,111,5906250,6000,8000,-2000,0,0,0,0,0,0,-2000
20200430,8155,博智,165.50,169.50,164.50,165.50,+2.50,1.53,3952000,2962,659691500,115000,80000,35000,4000,0,4000,186000,35000,151000,190000
20200430,8171,天宇,12.30,12.30,11.65,11.65,-0.35,-2.92,1053000,295,12518850,0,24000,-24000,0,0,0,0,0,0,-24000
20200430,8176,智捷,9.20,9.47,9.20,9.39,+0.26,2.85,441000,178,4126350,31000,20000,11000,0,0,0,0,0,0,11000
20200430,8182,加高,28.85,28.90,28.50,28.55,0.00,0.0,878000,482,25157350,115000,30000,85000,0,0,0,0,0,0,85000
20200430,8183,精星,17.90,18.20,17.60,18.20,+1.65,9.97,6052000,2089,109139850,21000,130000,-109000,0,0,0,0,0,0,-109000
20200430,8234,新漢,22.40,22.45,22.15,22.35,+0.35,1.59,193000,64,4308950,8000,11000,-3000,0,0,0,0,0,0,-3000
20200430,8240,華宏,23.50,23.95,23.50,23.80,+0.50,2.15,216000,108,5145200,14000,2000,12000,0,0,0,0,0,0,12000
20200430,8255,朋程,87.50,88.50,87.50,87.90,+1.00,1.15,261000,196,22966500,11000,2000,9000,0,0,0,4000,0,4000,13000
20200430,8277,商丞,5.56,5.67,5.45,5.60,+0.07,1.27,249000,82,1374540,5000,0,5000,0,0,0,0,0,0,5000
20200430,8279,生展,100.00,105.50,100.00,104.50,+5.50,5.56,115000,106,11880000,0,0,0,0,0,0,0,0,0,0
20200430,8287,英格爾,0.73,0.73,0.73,0.73,-0.08,-9.88,3706000,282,2705380,0,0,0,0,0,0,0,0,0,0
20200430,8289,泰藝,11.50,11.85,11.50,11.60,+0.20,1.75,614000,248,7156950,48000,1000,47000,0,0,0,0,0,0,47000
20200430,8291,尚茂,3.39,3.39,3.39,3.39,+0.09,2.73,3000,2,10170,0,0,0,0,0,0,0,0,0,0
20200430,8299,群聯,287.50,288.50,283.50,286.50,+7.50,2.69,3800000,3037,1087521500,568000,440000,128000,351000,0,351000,121000,26000,95000,574000
20200430,8342,益張,47.00,48.30,47.00,47.90,+1.30,2.79,81000,52,3860500,0,0,0,0,0,0,0,0,0,0
20200430,8349,恒耀,43.70,46.00,43.70,46.00,+2.30,5.26,315000,229,14058150,2000,36000,-34000,0,0,0,0,3000,-3000,-37000
20200430,8349A,恒耀甲特,43.40,44.20,43.35,44.20,+0.85,1.96,62000,34,2693850,0,0,0,0,0,0,0,0,0,0
20200430,8354,冠好,18.05,18.05,17.80,18.00,+0.15,0.84,502000,15,9021400,0,0,0,0,0,0,0,0,0,0
20200430,8358,金居,39.20,40.50,38.50,40.50,+3.65,9.91,24876000,12518,986166300,1642000,1116000,526000,0,0,0,610000,461000,149000,675000
20200430,8383,千附,34.50,34.65,34.40,34.60,+0.25,0.73,390000,225,13463550,27000,19000,8000,0,0,0,0,0,0,8000
20200430,8390,金益鼎,18.00,18.05,17.90,17.95,0.00,0.0,336000,133,6041000,37000,8000,29000,0,0,0,0,0,0,29000
20200430,8401,白紗科,11.85,12.20,11.80,12.15,+0.30,2.53,209000,60,2515500,0,0,0,0,0,0,0,0,0,0
20200430,8403,盛弘,45.65,48.35,45.65,46.30,+1.95,4.4,19828000,11398,930408500,1240000,870000,370000,0,0,0,58000,14000,44000,414000
20200430,8406,金可-KY,149.50,162.50,148.00,158.00,+9.00,6.04,1707000,1372,265929500,90000,256000,-166000,8000,0,8000,142000,44000,98000,-60000
20200430,8409,商之器,18.00,18.35,17.70,18.20,+0.25,1.39,152000,88,2736000,4000,3000,1000,0,0,0,0,0,0,1000
20200430,8410,森田,32.65,34.10,31.80,34.10,+1.95,6.07,1176000,592,39019400,16000,42000,-26000,0,0,0,0,0,0,-26000
20200430,8415,大國鋼,25.80,26.05,25.70,25.80,+0.20,0.78,564000,247,14598150,235000,95000,140000,0,0,0,0,0,0,140000
20200430,8416,實威,114.50,116.00,114.50,114.50,+1.00,0.88,35000,33,4032000,0,1000,-1000,0,0,0,0,0,0,-1000
20200430,8418,捷必勝-KY,13.40,13.50,13.40,13.50,0.00,0.0,4000,4,53800,0,0,0,0,0,0,0,0,0,0
20200430,8420,明揚,24.90,25.50,24.90,25.50,+0.40,1.59,10000,7,251150,0,0,0,0,0,0,0,0,0,0
20200430,8421,旭源,9.77,9.91,9.76,9.91,+0.17,1.75,74000,42,729300,0,0,0,0,0,0,0,0,0,0
20200430,8423,保綠-KY,17.00,17.10,17.00,17.10,+0.10,0.59,5000,3,85300,0,0,0,0,0,0,0,0,0,0
20200430,8424,惠普,52.30,52.70,52.20,52.70,+0.60,1.15,48000,42,2521800,6000,0,6000,0,0,0,0,0,0,6000
20200430,8426,紅木-KY,14.10,14.15,14.00,14.00,0.00,0.0,20000,15,281550,0,0,0,0,0,0,0,0,0,0
20200430,8431,匯鑽科,51.40,54.80,50.90,52.50,+1.60,3.14,689000,398,36157800,32000,14000,18000,0,0,0,0,0,0,18000
20200430,8432,東生華,69.90,70.80,69.00,69.40,-0.10,-0.14,106000,106,7363200,0,0,0,0,0,0,0,0,0,0
20200430,8433,弘帆,43.70,44.20,43.20,44.20,+0.65,1.49,47000,41,2051300,0,0,0,0,0,0,0,0,0,0
20200430,8435,鉅邁,50.20,50.30,49.90,50.00,0.00,0.0,186000,86,9305100,1000,90000,-89000,0,0,0,0,0,0,-89000
20200430,8436,大江,234.00,239.00,230.50,230.50,+0.50,0.22,2326000,1937,544629000,161000,274282,-113282,0,223000,-223000,15000,19000,-4000,-340282
20200430,8437,大地-KY,186.50,196.00,186.50,191.00,+7.50,4.09,164000,159,31419000,1000,103501,-102501,0,0,0,0,0,0,-102501
20200430,8440,綠電,12.30,12.35,12.25,12.25,-0.05,-0.41,87000,46,1070500,2000,0,2000,0,0,0,0,0,0,2000
20200430,8444,綠河-KY,41.10,41.50,41.00,41.50,+0.45,1.1,16000,15,658600,0,0,0,0,10000,-10000,0,0,0,-10000
20200430,8446,華研,111.00,114.00,111.00,113.00,+2.50,2.26,197000,151,22209500,11000,0,11000,0,0,0,1000,0,1000,12000
20200430,8450,霹靂,24.60,25.00,24.40,24.70,+0.45,1.86,48000,38,1183600,0,0,0,0,0,0,0,0,0,0
20200430,8455,大拓-KY,20.65,21.25,20.65,21.20,-0.10,-0.47,3000,3,63100,0,0,0,0,0,0,0,0,0,0
20200430,8472,夠麻吉,29.00,29.00,28.80,28.80,-0.40,-1.37,10000,8,289100,0,0,0,0,0,0,0,0,0,0
20200430,8476,台境,23.80,23.95,23.50,23.85,+0.35,1.49,86000,60,2047250,4000,3000,1000,0,0,0,0,0,0,1000
20200430,8477,創業家,41.60,41.70,39.55,41.40,+2.70,6.98,706000,503,28808900,8000,16000,-8000,0,0,0,0,3000,-3000,-11000
20200430,8489,三貝德,66.90,67.50,66.20,66.30,+0.20,0.3,467000,339,31121500,63000,10000,53000,0,0,0,0,7000,-7000,46000
20200430,8905,裕國,14.50,14.75,14.50,14.65,+0.15,1.03,173000,96,2535700,0,0,0,0,0,0,0,0,0,0
20200430,8906,花王,14.25,14.30,14.25,14.30,+0.10,0.7,7000,6,100050,0,0,0,0,0,0,0,0,0,0
20200430,8908,欣雄,46.40,46.55,46.40,46.40,+0.15,0.32,20000,19,929750,0,0,0,0,0,0,0,0,0,0
20200430,8916,光隆,40.70,41.00,40.70,41.00,+0.45,1.11,200000,145,8168550,36000,0,36000,0,0,0,0,0,0,36000
20200430,8916A,光隆甲特,52.40,52.40,52.30,52.40,+0.10,0.19,3000,3,157100,0,0,0,0,0,0,0,0,0,0
20200430,8917,欣泰,58.10,59.00,58.10,59.00,+1.00,1.72,37000,23,2159300,0,0,0,0,0,0,0,0,0,0
20200430,8921,沈氏,,,,,,0.00,0,0,0,0,0,0,0,0,0,0,0,0,0
20200430,8923,時報,15.00,15.15,15.00,15.10,+0.10,0.67,4000,4,60350,0,0,0,0,0,0,0,0,0,0
20200430,8924,大田,41.90,43.30,41.00,42.80,+1.95,4.77,1270000,769,53722750,89000,70000,19000,0,0,0,43000,3000,40000,59000
20200430,8927,北基,15.35,15.35,15.35,15.35,+0.05,0.33,1000,1,15350,0,0,0,0,0,0,0,0,0,0
20200430,8928,鉅明,26.70,27.20,26.70,27.00,+0.50,1.89,248000,145,6688650,7000,4000,3000,0,0,0,0,0,0,3000
20200430,8929,富堡,25.00,25.70,23.85,24.40,-0.10,-0.41,498000,330,12328700,0,8000,-8000,0,0,0,0,0,0,-8000
20200430,8930,青鋼,11.45,11.60,11.30,11.55,+0.15,1.32,122000,42,1399450,0,0,0,0,0,0,0,0,0,0
20200430,8931,大汽電,27.75,28.40,27.75,28.00,+0.35,1.27,56000,36,1557150,0,0,0,0,0,0,0,0,0,0
20200430,8932,宏大,12.20,12.20,12.20,12.20,+1.10,9.91,133000,60,1622600,0,0,0,0,0,0,0,0,0,0
20200430,8933,愛地雅,4.72,4.85,4.72,4.85,+0.14,2.97,380000,116,1823620,5000,0,5000,0,0,0,0,0,0,5000
20200430,8934,衡平,32.00,32.00,32.00,32.00,0.00,0.0,3000,1,96000,0,0,0,0,0,0,0,0,0,0
20200430,8935,邦泰,8.07,8.20,8.07,8.17,+0.07,0.86,11000,9,89520,0,0,0,0,0,0,0,1000,-1000,-1000
20200430,8936,國統,17.55,17.85,17.25,17.30,-0.40,-2.26,1085000,495,18962100,37000,27000,10000,0,0,0,0,0,0,10000
20200430,8937,合騏,14.00,14.10,14.00,14.05,+0.20,1.44,29000,12,407350,0,0,0,0,0,0,0,0,0,0
20200430,8938,明安,32.40,33.05,32.40,32.95,+0.60,1.85,363000,195,11855050,35000,20000,15000,0,0,0,0,0,0,15000
20200430,8941,關中,35.50,35.60,35.40,35.60,+0.40,1.14,5000,4,177700,0,0,0,0,0,0,0,0,0,0
20200430,8942,森鉅,53.90,54.40,53.90,54.30,+0.80,1.5,462000,315,25009000,47000,0,47000,0,0,0,0,0,0,47000
20200430,9949,琉園,15.40,15.70,14.90,15.70,+1.40,9.79,1160000,418,18058300,6000,11000,-5000,0,0,0,0,0,0,-5000
20200430,9950,萬國通,10.00,10.15,9.96,9.98,-0.02,-0.2,84000,26,838760,0,5000,-5000,0,0,0,0,0,0,-5000
20200430,9951,皇田,68.00,69.30,67.70,68.80,+1.60,2.38,610000,511,41858200,79000,15000,64000,0,0,0,0,0,0,64000
20200430,9960,邁達康,26.95,27.05,26.95,27.05,+0.50,1.88,14000,9,378100,0,0,0,0,0,0,1000,0,1000,1000
20200430,9962,有益,8.25,8.31,8.23,8.29,+0.07,0.85,52000,26,429220,0,0,0,0,0,0,0,0,0,0
20200430,020001,富邦存股雙十N,4.97,5.02,4.97,5.01,+0.08,1.62,744000,188,3721570,0,0,0,0,0,0,688000,0,688000,688000
20200430,020003,統一漲升股利150N,10.13,10.17,10.13,10.17,+0.23,2.31,21000,3,213230,0,0,0,0,0,0,0,21000,-21000,-21000
20200430,020009,群益A50綠碳N,,,,,,0.00,0,0,0,0,0,0,0,0,0,0,0,0,0
20200430,020010,永昌富櫃200N,9.85,9.98,9.85,9.98,+0.19,1.94,6000,4,59610,0,0,0,0,0,0,0,4000,-4000,-4000
20200430,020013,元富亞洲高股息N,12.77,12.77,12.77,12.77,+0.14,1.11,3000,1,38310,0,0,0,0,0,0,3000,0,3000,3000
20200430,020014,元大富櫃200N,4.58,4.60,4.58,4.60,+0.09,2.0,37000,17,169780,0,0,0,0,0,0,29000,8000,21000,21000
20200430,72501P,大江富邦95售01,,,,,,0.00,0,0,0,0,0,0,0,0,0,0,0,0,0
20200430,72510P,原相群益96售02,,,,,,0.00,0,0,0,0,0,0,0,0,0,0,0,0,0
20200430,72535P,雙鴻群益95售01,,,,,,0.00,0,0,0,0,0,0,0,0,0,0,0,0,0
20200430,72548P,大江統一96售01,,,,,,0.00,0,0,0,0,0,0,0,0,0,0,0,0,0
20200430,72568P,新普群益96售01,0.03,0.03,0.03,0.03,-0.02,-40.0,30000,1,900,0,0,0,0,0,0,30000,0,30000,30000
20200430,72572P,網家元富96售02,,,,,,0.00,0,0,0,0,0,0,0,0,0,0,0,0,0
20200430,72575P,環球晶元富95售02,,,,,,0.00,0,0,0,0,0,0,0,0,0,0,0,0,0
20200430,72578P,雙鴻元大95售01,0.05,0.05,0.05,0.05,-0.04,-44.44,75000,1,3750,0,0,0,0,0,0,75000,0,75000,75000
20200430,72583P,聯亞國票95售02,,,,,,0.00,0,0,0,0,0,0,0,0,0,0,0,0,0
20200430,72586P,宏捷科國泰95售02,,,,,,0.00,0,0,0,0,0,0,0,0,0,0,0,0,0
20200430,72587P,宏捷科國票95售01,,,,,,0.00,0,0,0,0,0,0,0,0,0,0,0,0,0
20200430,72591P,神盾元大95售04,,,,,,0.00,0,0,0,0,0,0,0,0,0,0,0,0,0
20200430,72594P,雙鴻國泰96售03,,,,,,0.00,0,0,0,0,0,0,0,0,0,0,0,0,0
20200430,72595P,大江富邦96售01,,,,,,0.00,0,0,0,0,0,0,0,0,0,0,0,0,0
20200430,72602P,中美晶兆豐95售01,0.05,0.05,0.05,0.05,-0.03,-37.5,70000,2,3500,0,0,0,0,0,0,70000,0,70000,70000
20200430,72611P,雙鴻凱基96售02,0.95,0.95,0.95,0.95,-0.03,-3.06,55000,2,52250,0,0,0,0,0,0,0,55000,-55000,-55000
20200430,72613P,緯軟群益95售01,,,,,,0.00,0,0,0,0,0,0,0,0,0,0,0,0,0
20200430,72615P,晶焱元大95售02,0.33,0.33,0.33,0.33,-0.06,-15.38,64000,4,21120,0,0,0,0,0,0,64000,64000,0,0
20200430,72617P,原相兆豐95售01,,,,,,0.00,0,0,0,0,0,0,0,0,0,0,0,0,0
20200430,72623P,穩懋富邦96售02,0.80,0.80,0.80,0.80,-0.07,-8.05,20000,1,16000,0,0,0,0,0,0,20000,0,20000,20000
20200430,72624P,櫃200第一96售02,,,,,,0.00,0,0,0,0,0,0,0,0,0,0,0,0,0
20200430,72626P,環球晶兆豐95售03,,,,,,0.00,0,0,0,0,0,0,0,0,0,0,0,0,0
20200430,72633P,聯亞元大95售02,0.06,0.07,0.06,0.07,+0.01,16.67,450000,3,30500,0,0,0,0,0,0,300000,150000,150000,150000
20200430,72638P,中美晶元富95售03,,,,,,0.00,0,0,0,0,0,0,0,0,0,0,0,0,0
20200430,72655P,穩懋統一96售03,,,,,,0.00,0,0,0,0,0,0,0,0,0,0,0,0,0
20200430,72658P,建榮國票95售03,,,,,,0.00,0,0,0,0,0,0,0,0,0,0,0,0,0
20200430,72661P,穩懋中信96售01,0.79,0.81,0.79,0.79,-0.06,-7.06,78000,3,62220,0,0,0,0,0,0,38000,40000,-2000,-2000
20200430,72662P,穩懋中信98售01,0.71,0.75,0.71,0.74,-0.06,-7.5,417000,8,307650,0,0,0,0,0,0,332000,339000,-7000,-7000
20200430,72663P,神盾元富96售01,,,,,,0.00,0,0,0,0,0,0,0,0,0,0,0,0,0
20200430,72672P,穩懋國票96售01,,,,,,0.00,0,0,0,0,0,0,0,0,0,0,0,0,0
20200430,72673P,穩懋國泰96售01,,,,,,0.00,0,0,0,0,0,0,0,0,0,0,0,0,0
20200430,72674P,環球晶富邦97售02,0.33,0.33,0.30,0.30,-0.14,-31.82,11000,2,3600,0,0,0,0,0,0,11000,0,11000,11000
20200430,72679P,譜瑞中信95售02,,,,,,0.00,0,0,0,0,0,0,0,0,0,0,0,0,0
20200430,72680P,穩懋元大95售01,,,,,,0.00,0,0,0,0,0,0,0,0,0,0,0,0,0
20200430,72681P,合晶永豐95售01,,,,,,0.00,0,0,0,0,0,0,0,0,0,0,0,0,0
20200430,72682P,良維永豐95售01,,,,,,0.00,0,0,0,0,0,0,0,0,0,0,0,0,0
20200430,72683P,碩禾永豐95售02,,,,,,0.00,0,0,0,0,0,0,0,0,0,0,0,0,0
20200430,72684P,大江國票96售02,,,,,,0.00,0,0,0,0,0,0,0,0,0,0,0,0,0
20200430,72685P,中美晶元富95售05,,,,,,0.00,0,0,0,0,0,0,0,0,0,0,0,0,0
20200430,72686P,新普群益97售03,0.32,0.32,0.32,0.32,-0.05,-13.51,162000,1,51840,0,0,0,0,0,0,162000,0,162000,162000
20200430,72687P,譜瑞元大95售03,,,,,,0.00,0,0,0,0,0,0,0,0,0,0,0,0,0
20200430,72688P,環球晶凱基95售05,0.16,0.16,0.16,0.16,-0.35,-68.63,8000,1,1280,0,0,0,0,0,0,8000,0,8000,8000
20200430,72689P,環宇國票96售01,,,,,,0.00,0,0,0,0,0,0,0,0,0,0,0,0,0
20200430,72690P,聯亞台新95售02,,,,,,0.00,0,0,0,0,0,0,0,0,0,0,0,0,0
20200430,72691P,穩懋台新95售01,,,,,,0.00,0,0,0,0,0,0,0,0,0,0,0,0,0
20200430,72692P,中美晶群益95售01,,,,,,0.00,0,0,0,0,0,0,0,0,0,0,0,0,0
20200430,72693P,環球晶凱基95售07,,,,,,0.00,0,0,0,0,0,0,0,0,0,0,0,0,0
20200430,72694P,櫃200元大95售02,0.01,0.01,0.01,0.01,-0.03,-75.0,95000,1,950,0,0,0,0,0,0,95000,0,95000,95000
20200430,72695P,穩懋元大95售03,,,,,,0.00,0,0,0,0,0,0,0,0,0,0,0,0,0
20200430,72696P,穩懋兆豐95售02,0.21,0.21,0.21,0.21,-0.07,-25.0,10000,1,2100,0,0,0,0,0,0,10000,10000,0,0
20200430,72697P,穩懋亞東96售01,2.16,2.16,2.16,2.16,-0.35,-13.94,56000,1,120960,0,0,0,0,0,0,56000,56000,0,0
20200430,72698P,環球晶凱基95售08,,,,,,0.00,0,0,0,0,0,0,0,0,0,0,0,0,0
20200430,72699P,大江元大95售03,,,,,,0.00,0,0,0,0,0,0,0,0,0,0,0,0,0
20200430,72700P,中美晶元大95售03,,,,,,0.00,0,0,0,0,0,0,0,0,0,0,0,0,0
20200430,72701P,穩懋元大95售05,0.74,0.84,0.74,0.84,-0.39,-31.71,20000,2,15800,0,0,0,0,0,0,10000,10000,0,0
20200430,72702P,精華元富95售02,,,,,,0.00,0,0,0,0,0,0,0,0,0,0,0,0,0
20200430,72703P,聯亞群益96售01,0.79,0.93,0.79,0.93,+0.09,10.71,307000,10,264830,0,0,0,0,0,0,63000,235000,-172000,-172000
20200430,72704P,大江國票96售03,,,,,,0.00,0,0,0,0,0,0,0,0,0,0,0,0,0
20200430,72705P,原相永豐95售01,,,,,,0.00,0,0,0,0,0,0,0,0,0,0,0,0,0
20200430,72706P,環球晶國泰96售02,0.59,0.59,0.48,0.48,-0.19,-28.36,1060000,8,541150,0,0,0,0,0,0,1050000,1030000,20000,20000
20200430,72707P,中美晶國票96售02,0.56,0.56,0.56,0.56,-0.11,-16.42,5000,1,2800,0,0,0,0,0,0,5000,0,5000,5000
20200430,72708P,環球晶群益95售03,0.04,0.04,0.04,0.04,-0.14,-77.78,400000,1,16000,0,0,0,0,0,0,400000,400000,0,0
20200430,72709P,新鉅科康和95售01,,,,,,0.00,0,0,0,0,0,0,0,0,0,0,0,0,0
20200430,72710P,神盾元大95售06,,,,,,0.00,0,0,0,0,0,0,0,0,0,0,0,0,0
20200430,72711P,櫃200永昌96售05,,,,,,0.00,0,0,0,0,0,0,0,0,0,0,0,0,0
20200430,72712P,環球晶元大95售11,,,,,,0.00,0,0,0,0,0,0,0,0,0,0,0,0,0
20200430,72713P,櫃200元大96售01,,,,,,0.00,0,0,0,0,0,0,0,0,0,0,0,0,0
20200430,72714P,櫃200元大96售02,,,,,,0.00,0,0,0,0,0,0,0,0,0,0,0,0,0
20200430,72715P,雙鴻統一95售01,,,,,,0.00,0,0,0,0,0,0,0,0,0,0,0,0,0
20200430,72716P,穩懋統一96售04,2.55,2.61,2.55,2.61,-0.21,-7.45,19000,3,49250,0,0,0,0,0,0,0,19000,-19000,-19000
20200430,72717P,穩懋元富95售07,,,,,,0.00,0,0,0,0,0,0,0,0,0,0,0,0,0
20200430,72718P,穩懋元富95售08,,,,,,0.00,0,0,0,0,0,0,0,0,0,0,0,0,0
20200430,72719P,原相亞東96售02,,,,,,0.00,0,0,0,0,0,0,0,0,0,0,0,0,0
20200430,72720P,元太元大95售03,0.35,0.35,0.35,0.35,-0.05,-12.5,171000,1,59850,0,0,0,0,0,0,0,171000,-171000,-171000
20200430,72721P,宣德永豐95售02,,,,,,0.00,0,0,0,0,0,0,0,0,0,0,0,0,0
20200430,72722P,穩懋統一95售01,,,,,,0.00,0,0,0,0,0,0,0,0,0,0,0,0,0
20200430,72723P,穩懋統一95售02,,,,,,0.00,0,0,0,0,0,0,0,0,0,0,0,0,0
20200430,72724P,威剛凱基95售01,,,,,,0.00,0,0,0,0,0,0,0,0,0,0,0,0,0
20200430,72725P,環球晶元大95售13,,,,,,0.00,0,0,0,0,0,0,0,0,0,0,0,0,0
20200430,72726P,穩懋元大95售08,,,,,,0.00,0,0,0,0,0,0,0,0,0,0,0,0,0
20200430,72727P,雙鴻康和95售01,,,,,,0.00,0,0,0,0,0,0,0,0,0,0,0,0,0
20200430,72728P,穩懋元大95售09,2.17,2.17,2.17,2.17,-0.27,-11.07,50000,1,108500,0,0,0,0,0,0,50000,0,50000,50000
20200430,72729P,櫃200富邦95售04,,,,,,0.00,0,0,0,0,0,0,0,0,0,0,0,0,0
20200430,72730P,櫃200富邦95售05,,,,,,0.00,0,0,0,0,0,0,0,0,0,0,0,0,0
20200430,72731P,櫃200富邦95售06,,,,,,0.00,0,0,0,0,0,0,0,0,0,0,0,0,0
20200430,72732P,櫃200T永昌96售05,,,,,,0.00,0,0,0,0,0,0,0,0,0,0,0,0,0
20200430,72733P,櫃200凱基96售01,,,,,,0.00,0,0,0,0,0,0,0,0,0,0,0,0,0
20200430,72734P,櫃200凱基96售02,,,,,,0.00,0,0,0,0,0,0,0,0,0,0,0,0,0
20200430,72735P,穩懋元大95售10,,,,,,0.00,0,0,0,0,0,0,0,0,0,0,0,0,0
20200430,72736P,穩懋元大95售11,1.35,1.35,1.35,1.35,-0.50,-27.03,10000,1,13500,0,0,0,0,0,0,0,10000,-10000,-10000
20200430,72737P,櫃200富邦9A售03,,,,,,0.00,0,0,0,0,0,0,0,0,0,0,0,0,0
20200430,72738P,櫃200富邦9A售04,,,,,,0.00,0,0,0,0,0,0,0,0,0,0,0,0,0
20200430,72739P,中美晶永豐95售04,0.35,0.35,0.35,0.35,-0.09,-20.45,35000,1,12250,0,0,0,0,0,0,35000,0,35000,35000
20200430,72740P,中美晶元大95售05,,,,,,0.00,0,0,0,0,0,0,0,0,0,0,0,0,0
20200430,72741P,良維元大95售03,0.62,0.62,0.62,0.62,-0.04,-6.06,25000,2,15500,0,0,0,0,0,0,25000,0,25000,25000
20200430,72742P,雙鴻元大95售03,0.79,0.79,0.79,0.79,-0.02,-2.47,76000,1,60040,0,0,0,0,0,0,0,76000,-76000,-76000
20200430,72743P,群聯永豐95售02,0.33,0.34,0.33,0.34,-0.14,-29.17,46000,11,15480,0,0,0,0,0,0,16000,30000,-14000,-14000
20200430,72744P,神盾元大95售07,1.09,1.25,1.09,1.19,-0.10,-7.75,95000,10,111600,0,0,0,0,0,0,15000,80000,-65000,-65000
20200430,72745P,威剛國票96售01,0.38,0.38,0.37,0.37,-0.05,-11.9,98000,4,36860,0,0,0,0,0,0,38000,60000,-22000,-22000
20200430,72746P,大江富邦97售02,,,,,,0.00,0,0,0,0,0,0,0,0,0,0,0,0,0
20200430,72747P,櫃200T永昌9C售05,,,,,,0.00,0,0,0,0,0,0,0,0,0,0,0,0,0
20200430,72748P,穩懋康和95售01,0.17,0.17,0.17,0.17,-0.08,-32.0,470000,2,79900,0,0,0,0,0,0,470000,0,470000,470000
20200430,72749P,金居元大95售04,0.47,0.47,0.39,0.39,-0.29,-42.65,40000,2,17200,0,0,0,0,0,0,0,40000,-40000,-40000
20200430,72750P,精華元大95售04,,,,,,0.00,0,0,0,0,0,0,0,0,0,0,0,0,0
20200430,72751P,元太中信95售02,0.12,0.12,0.12,0.12,-0.03,-20.0,125000,1,15000,0,0,0,0,0,0,125000,0,125000,125000
20200430,72752P,環球晶凱基96售02,,,,,,0.00,0,0,0,0,0,0,0,0,0,0,0,0,0
20200430,72753P,新普永豐95售02,,,,,,0.00,0,0,0,0,0,0,0,0,0,0,0,0,0
20200430,72754P,大江群益95售02,,,,,,0.00,0,0,0,0,0,0,0,0,0,0,0,0,0
20200430,72755P,精華凱基95售02,1.63,1.63,1.63,1.63,-0.33,-16.84,10000,1,16300,0,0,0,0,0,0,0,10000,-10000,-10000
20200430,72756P,穩懋凱基95售02,,,,,,0.00,0,0,0,0,0,0,0,0,0,0,0,0,0
20200430,72757P,精華統一95售01,,,,,,0.00,0,0,0,0,0,0,0,0,0,0,0,0,0
20200430,72758P,環球晶凱基95售14,,,,,,0.00,0,0,0,0,0,0,0,0,0,0,0,0,0
20200430,72759P,精華永豐95售03,,,,,,0.00,0,0,0,0,0,0,0,0,0,0,0,0,0
20200430,72760P,精測元大95售01,,,,,,0.00,0,0,0,0,0,0,0,0,0,0,0,0,0
20200430,72761P,中美晶富邦96售01,,,,,,0.00,0,0,0,0,0,0,0,0,0,0,0,0,0
20200430,72762P,穩懋富邦97售02,0.61,0.66,0.60,0.63,-0.08,-11.27,1014000,36,645400,0,0,0,0,0,0,349000,656000,-307000,-307000
20200430,72763P,精測中信96售01,1.46,1.46,1.46,1.46,-0.05,-3.31,30000,3,43800,0,0,0,0,0,0,0,30000,-30000,-30000
20200430,72764P,中美晶凱基96售02,0.06,0.06,0.06,0.06,-0.13,-68.42,4000,1,240,0,0,0,0,0,0,4000,0,4000,4000
20200430,72765P,精測國泰97售01,,,,,,0.00,0,0,0,0,0,0,0,0,0,0,0,0,0
20200430,72766P,中美晶富邦97售01,0.45,0.45,0.43,0.43,-0.05,-10.42,25000,2,11150,0,0,0,0,0,0,25000,0,25000,25000
20200430,72767P,精測康和96售01,,,,,,0.00,0,0,0,0,0,0,0,0,0,0,0,0,0
20200430,72768P,精測凱基96售02,,,,,,0.00,0,0,0,0,0,0,0,0,0,0,0,0,0
20200430,72769P,雙鴻兆豐97售01,,,,,,0.00,0,0,0,0,0,0,0,0,0,0,0,0,0
20200430,72770P,精測永豐96售03,1.39,1.41,1.38,1.41,-0.14,-9.03,5000,4,7000,0,0,0,0,0,0,1000,4000,-3000,-3000
20200430,72771P,鈊象元大96售01,,,,,,0.00,0,0,0,0,0,0,0,0,0,0,0,0,0
20200430,72772P,同致國票97售01,,,,,,0.00,0,0,0,0,0,0,0,0,0,0,0,0,0
20200430,72773P,鈊象國票96售01,,,,,,0.00,0,0,0,0,0,0,0,0,0,0,0,0,0
20200430,72774P,精測群益96售02,,,,,,0.00,0,0,0,0,0,0,0,0,0,0,0,0,0
20200430,72775P,精測統一96售02,,,,,,0.00,0,0,0,0,0,0,0,0,0,0,0,0,0
20200430,72776P,精測凱基96售05,1.25,1.25,1.25,1.25,-0.07,-5.3,2000,1,2500,0,0,0,0,0,0,2000,0,2000,2000
20200430,72777P,櫃200凱基96售04,,,,,,0.00,0,0,0,0,0,0,0,0,0,0,0,0,0
20200430,72778P,櫃200凱基96售05,,,,,,0.00,0,0,0,0,0,0,0,0,0,0,0,0,0
20200430,72779P,鈊象凱基96售02,,,,,,0.00,0,0,0,0,0,0,0,0,0,0,0,0,0
20200430,72780P,鈊象台新96售01,0.01,0.01,0.01,0.01,-0.02,-66.67,329000,2,3290,0,0,0,0,0,0,319000,329000,-10000,-10000
20200430,72781P,鈊象永豐96售02,,,,,,0.00,0,0,0,0,0,0,0,0,0,0,0,0,0
20200430,72782P,鈊象康和96售01,0.10,0.11,0.10,0.11,+0.02,22.22,130000,4,14090,0,0,0,0,0,0,0,129000,-129000,-129000
20200430,72783P,鈊象群益96售01,0.05,0.05,0.05,0.05,+0.01,25.0,5000,1,250,0,0,0,0,0,0,0,5000,-5000,-5000
20200430,72784P,精測統一96售03,0.64,0.64,0.64,0.64,-0.24,-27.27,10000,1,6400,0,0,0,0,0,0,10000,0,10000,10000
20200430,72785P,鈊象元富96售02,,,,,,0.00,0,0,0,0,0,0,0,0,0,0,0,0,0
20200430,72786P,聯亞國票97售02,0.58,0.70,0.58,0.67,+0.04,6.35,420000,12,270850,0,0,0,0,0,0,76000,344000,-268000,-268000
20200430,72787P,精測永豐96售05,,,,,,0.00,0,0,0,0,0,0,0,0,0,0,0,0,0
20200430,72788P,群聯群益96售03,,,,,,0.00,0,0,0,0,0,0,0,0,0,0,0,0,0
20200430,72789P,精測群益96售03,2.97,3.01,2.97,3.01,-0.52,-14.73,16000,2,47920,0,0,0,0,0,0,16000,0,16000,16000
20200430,72790P,精華群益96售01,,,,,,0.00,0,0,0,0,0,0,0,0,0,0,0,0,0
20200430,72791P,精測凱基96售06,,,,,,0.00,0,0,0,0,0,0,0,0,0,0,0,0,0
20200430,72792P,穩懋國票96售04,2.26,2.26,2.26,2.26,-0.54,-19.29,5000,1,11300,0,0,0,0,0,0,0,5000,-5000,-5000
20200430,72793P,穩懋兆豐96售03,,,,,,0.00,0,0,0,0,0,0,0,0,0,0,0,0,0
20200430,72794P,穩懋兆豐97售01,0.45,0.46,0.45,0.46,-0.10,-17.86,22000,2,9920,0,0,0,0,0,0,20000,2000,18000,18000
20200430,72795P,鈊象元大96售02,,,,,,0.00,0,0,0,0,0,0,0,0,0,0,0,0,0
20200430,72796P,穩懋統一97售02,1.85,1.85,1.81,1.81,-0.20,-9.95,8000,2,14680,0,0,0,0,0,0,3000,5000,-2000,-2000
20200430,72797P,鈊象統一97售01,,,,,,0.00,0,0,0,0,0,0,0,0,0,0,0,0,0
20200430,72798P,穩懋凱基96售08,,,,,,0.00,0,0,0,0,0,0,0,0,0,0,0,0,0
20200430,72799P,世界永豐96售01,0.74,0.74,0.70,0.72,-0.15,-17.24,83000,4,61220,0,0,0,0,0,0,83000,0,83000,83000
20200430,72800P,鈊象元富96售03,,,,,,0.00,0,0,0,0,0,0,0,0,0,0,0,0,0
20200430,72801P,中美晶元大96售01,0.73,0.73,0.73,0.73,-0.12,-14.12,10000,1,7300,0,0,0,0,0,0,10000,0,10000,10000
20200430,72802P,世界元大96售04,1.47,1.47,1.40,1.40,-0.21,-13.04,141000,5,202290,0,0,0,0,0,0,141000,0,141000,141000
20200430,72803P,中美晶中信98售01,1.10,1.10,1.10,1.10,-0.02,-1.79,27000,1,29700,0,0,0,0,0,0,0,27000,-27000,-27000
20200430,72804P,世界中信96售02,,,,,,0.00,0,0,0,0,0,0,0,0,0,0,0,0,0
20200430,72805P,鈊象元富96售04,,,,,,0.00,0,0,0,0,0,0,0,0,0,0,0,0,0
20200430,72806P,世界康和96售02,1.19,1.19,1.19,1.19,-0.08,-6.3,28000,1,33320,0,0,0,0,0,0,28000,0,28000,28000
20200430,72807P,網龍群益98售02,0.81,0.83,0.81,0.81,+0.05,6.58,72000,3,58380,0,0,0,0,0,0,0,72000,-72000,-72000
20200430,72808P,力旺康和96售01,,,,,,0.00,0,0,0,0,0,0,0,0,0,0,0,0,0
20200430,72809P,聯亞元富96售01,0.79,0.79,0.79,0.79,+0.15,23.44,2000,1,1580,0,0,0,0,0,0,0,2000,-2000,-2000
20200430,72810P,雙鴻元富96售02,,,,,,0.00,0,0,0,0,0,0,0,0,0,0,0,0,0
20200430,72811P,鈊象元富96售05,,,,,,0.00,0,0,0,0,0,0,0,0,0,0,0,0,0
20200430,72812P,世界統一96售01,,,,,,0.00,0,0,0,0,0,0,0,0,0,0,0,0,0
20200430,72813P,宣德統一97售01,,,,,,0.00,0,0,0,0,0,0,0,0,0,0,0,0,0
20200430,72814P,世界群益98售03,1.77,1.77,1.77,1.77,-0.08,-4.32,55000,3,97350,0,0,0,0,0,0,55000,0,55000,55000
20200430,72815P,宣德元大96售05,2.10,2.10,1.96,1.96,-0.20,-9.26,8000,2,16660,0,0,0,0,0,0,8000,7000,1000,1000
20200430,72816P,信昌電國票97售02,0.94,0.98,0.94,0.98,-0.09,-8.41,30000,4,28400,0,0,0,0,0,0,25000,30000,-5000,-5000
20200430,72817P,網龍國票97售03,1.59,1.70,1.58,1.70,+0.07,4.29,41000,15,67840,0,0,0,0,0,0,40000,1000,39000,39000
20200430,72818P,櫃200第一96售05,,,,,,0.00,0,0,0,0,0,0,0,0,0,0,0,0,0
20200430,72819P,櫃200第一96售06,,,,,,0.00,0,0,0,0,0,0,0,0,0,0,0,0,0
20200430,72820P,中美晶兆豐97售01,1.01,1.01,1.01,1.01,-0.10,-9.01,10000,1,10100,0,0,0,0,0,0,10000,0,10000,10000
20200430,72821P,櫃200永昌97售02,,,,,,0.00,0,0,0,0,0,0,0,0,0,0,0,0,0
20200430,72822P,櫃200永昌97售03,,,,,,0.00,0,0,0,0,0,0,0,0,0,0,0,0,0
20200430,72823P,櫃200永昌99售04,,,,,,0.00,0,0,0,0,0,0,0,0,0,0,0,0,0
20200430,72824P,櫃200永昌99售05,,,,,,0.00,0,0,0,0,0,0,0,0,0,0,0,0,0
20200430,72825P,緯軟永豐96售01,,,,,,0.00,0,0,0,0,0,0,0,0,0,0,0,0,0
20200430,72826P,穩懋統一96售11,1.96,1.96,1.96,1.96,-0.54,-21.6,5000,1,9800,0,0,0,0,0,0,5000,0,5000,5000
20200430,72827P,穩懋統一96售12,,,,,,0.00,0,0,0,0,0,0,0,0,0,0,0,0,0
20200430,72828P,新普凱基96售01,,,,,,0.00,0,0,0,0,0,0,0,0,0,0,0,0,0
20200430,72829P,神盾群益98售02,,,,,,0.00,0,0,0,0,0,0,0,0,0,0,0,0,0
20200430,72830P,櫃200永昌9B售02,,,,,,0.00,0,0,0,0,0,0,0,0,0,0,0,0,0
20200430,72831P,櫃200永昌9B售03,,,,,,0.00,0,0,0,0,0,0,0,0,0,0,0,0,0
20200430,72832P,櫃200永昌9C售04,1.32,1.32,1.31,1.31,-0.17,-11.49,20000,2,26300,0,0,0,0,0,0,20000,0,20000,20000
20200430,72833P,櫃200永昌9C售05,,,,,,0.00,0,0,0,0,0,0,0,0,0,0,0,0,0
20200430,72834P,威剛元富99售01,,,,,,0.00,0,0,0,0,0,0,0,0,0,0,0,0,0
20200430,72835P,環球晶中信9A售01,0.78,0.78,0.71,0.71,-0.14,-16.47,139000,5,100290,0,0,0,0,0,0,119000,20000,99000,99000
20200430,72836P,聯亞永豐96售02,0.63,0.70,0.63,0.70,+0.05,7.69,91000,4,59160,0,0,0,0,0,0,5000,86000,-81000,-81000
20200430,72837P,雙鴻永豐96售01,,,,,,0.00,0,0,0,0,0,0,0,0,0,0,0,0,0
20200430,72838P,M31元大96售03,,,,,,0.00,0,0,0,0,0,0,0,0,0,0,0,0,0
20200430,72839P,世界元富96售03,,,,,,0.00,0,0,0,0,0,0,0,0,0,0,0,0,0
20200430,72840P,聖暉統一97售01,0.40,0.40,0.40,0.40,-0.10,-20.0,10000,1,4000,0,0,0,0,0,0,10000,0,10000,10000
20200430,72841P,環球晶凱基96售09,,,,,,0.00,0,0,0,0,0,0,0,0,0,0,0,0,0
20200430,72842P,宣德永豐96售02,1.46,1.53,1.46,1.53,-0.06,-3.77,70000,7,105520,0,0,0,0,0,0,70000,0,70000,70000
20200430,72843P,精測永豐96售11,,,,,,0.00,0,0,0,0,0,0,0,0,0,0,0,0,0
20200430,72844P,精測國泰97售03,,,,,,0.00,0,0,0,0,0,0,0,0,0,0,0,0,0
20200430,72845P,精測元大96售05,,,,,,0.00,0,0,0,0,0,0,0,0,0,0,0,0,0
20200430,72846P,穩懋元大96售08,0.79,0.79,0.79,0.79,-0.12,-13.19,262000,1,206980,0,0,0,0,0,0,262000,262000,0,0
20200430,72847P,鈊象元大96售05,,,,,,0.00,0,0,0,0,0,0,0,0,0,0,0,0,0
20200430,72848P,信驊康和96售01,0.26,0.26,0.26,0.26,-0.03,-10.34,10000,1,2600,0,0,0,0,0,0,10000,0,10000,10000
20200430,72849P,櫃200永昌98售03,,,,,,0.00,0,0,0,0,0,0,0,0,0,0,0,0,0
20200430,72850P,櫃200永昌98售04,,,,,,0.00,0,0,0,0,0,0,0,0,0,0,0,0,0
20200430,72851P,佳邦永豐96售02,,,,,,0.00,0,0,0,0,0,0,0,0,0,0,0,0,0
20200430,72852P,信昌電永豐96售01,0.96,0.96,0.96,0.96,-0.10,-9.43,38000,1,36480,0,0,0,0,0,0,0,38000,-38000,-38000
20200430,72853P,穩懋元大96售09,0.98,0.98,0.94,0.94,-0.21,-18.26,276000,2,259480,0,0,0,0,0,0,275000,276000,-1000,-1000
20200430,72854P,勝麗國票97售02,0.98,0.99,0.94,0.94,-0.08,-7.84,57000,3,55880,0,0,0,0,0,0,39000,18000,21000,21000
20200430,72855P,精測元大96售06,,,,,,0.00,0,0,0,0,0,0,0,0,0,0,0,0,0
20200430,72856P,閎康統一96售01,,,,,,0.00,0,0,0,0,0,0,0,0,0,0,0,0,0
20200430,72857P,聯亞凱基96售02,,,,,,0.00,0,0,0,0,0,0,0,0,0,0,0,0,0
20200430,72858P,直得永豐96售02,0.64,0.64,0.53,0.55,-0.20,-26.67,58000,4,31050,0,0,0,0,0,0,51000,7000,44000,44000
20200430,72859P,原相永豐96售02,0.07,0.07,0.07,0.07,-0.01,-12.5,23000,1,1610,0,0,0,0,0,0,23000,0,23000,23000
20200430,72860P,環球晶永豐96售01,0.42,0.42,0.36,0.36,-0.12,-25.0,200000,2,72600,0,0,0,0,0,0,200000,190000,10000,10000
20200430,72861P,精測群益96售07,,,,,,0.00,0,0,0,0,0,0,0,0,0,0,0,0,0
20200430,72862P,力旺國票96售01,,,,,,0.00,0,0,0,0,0,0,0,0,0,0,0,0,0
20200430,72863P,群聯元大96售05,,,,,,0.00,0,0,0,0,0,0,0,0,0,0,0,0,0
20200430,72864P,良維永豐96售04,,,,,,0.00,0,0,0,0,0,0,0,0,0,0,0,0,0
20200430,72865P,聯亞國票97售03,0.88,1.05,0.88,1.00,+0.06,6.38,614000,22,610110,0,0,0,0,0,0,64000,549000,-485000,-485000
20200430,72866P,原相台新96售01,0.01,0.01,0.01,0.01,-0.13,-92.86,10000,1,100,0,0,0,0,0,0,0,10000,-10000,-10000
20200430,72867P,頎邦元富96售03,,,,,,0.00,0,0,0,0,0,0,0,0,0,0,0,0,0
20200430,72868P,頎邦永豐96售01,1.21,1.23,1.13,1.13,-0.20,-15.04,198000,3,242440,0,0,0,0,0,0,198000,0,198000,198000
20200430,72869P,頎邦元大96售01,2.34,2.44,2.26,2.26,-0.30,-11.72,163000,24,387000,0,0,0,0,0,0,163000,74000,89000,89000
20200430,72870P,頎邦群益97售03,1.61,1.61,1.53,1.54,-0.14,-8.33,102000,4,161880,0,0,0,0,0,0,102000,0,102000,102000
20200430,72871P,鈊象國票97售02,0.18,0.18,0.10,0.10,-0.08,-44.44,48000,7,7800,0,0,0,0,0,0,0,0,0,0
20200430,72872P,大江永豐96售04,1.55,1.55,1.55,1.55,-0.02,-1.27,59000,2,91450,0,0,0,0,0,0,0,59000,-59000,-59000
20200430,72873P,穩懋凱基96售14,1.17,1.17,1.17,1.17,-0.26,-18.18,60000,6,70200,0,0,0,0,0,0,60000,60000,0,0
20200430,72874P,台燿元富96售01,,,,,,0.00,0,0,0,0,0,0,0,0,0,0,0,0,0
20200430,72875P,碩禾台新97售02,,,,,,0.00,0,0,0,0,0,0,0,0,0,0,0,0,0
20200430,72876P,頎邦康和96售02,0.85,0.85,0.82,0.82,-0.13,-13.68,139000,4,118030,0,0,0,0,0,0,139000,0,139000,139000
20200430,72877P,環球晶統一96售03,1.54,1.54,1.44,1.45,-0.19,-11.59,113000,11,171600,0,0,0,0,0,0,91000,22000,69000,69000
20200430,72878P,穩懋統一96售13,2.16,2.18,2.15,2.15,-0.26,-10.79,27000,3,58410,0,0,0,0,0,0,0,27000,-27000,-27000
20200430,72879P,環球晶中信96售03,,,,,,0.00,0,0,0,0,0,0,0,0,0,0,0,0,0
20200430,72880P,台燿凱基96售04,,,,,,0.00,0,0,0,0,0,0,0,0,0,0,0,0,0
20200430,72881P,穩懋凱基96售15,,,,,,0.00,0,0,0,0,0,0,0,0,0,0,0,0,0
20200430,72882P,威剛國票96售02,,,,,,0.00,0,0,0,0,0,0,0,0,0,0,0,0,0
20200430,72883P,雍智國泰97售01,0.93,0.93,0.90,0.90,-0.13,-12.62,100000,8,92740,0,0,0,0,0,0,100000,0,100000,100000
20200430,72884P,中美晶元富97售01,,,,,,0.00,0,0,0,0,0,0,0,0,0,0,0,0,0
20200430,72885P,晶焱永豐97售02,,,,,,0.00,0,0,0,0,0,0,0,0,0,0,0,0,0
20200430,72886P,旺矽康和97售01,0.87,0.88,0.86,0.86,-0.07,-7.53,53000,3,46380,0,0,0,0,0,0,50000,3000,47000,47000
20200430,72887P,威剛康和97售01,0.64,0.69,0.64,0.69,-0.03,-4.17,129000,16,87400,0,0,0,0,0,0,1000,121000,-120000,-120000
20200430,72888P,中美晶中信99售01,0.63,0.63,0.63,0.63,-0.04,-5.97,8000,1,5040,0,0,0,0,0,0,8000,0,8000,8000
20200430,72889P,合晶永豐97售02,2.12,2.12,2.10,2.10,-0.19,-8.3,83000,2,175760,0,0,0,0,0,0,73000,10000,63000,63000
20200430,72890P,金居永豐97售01,2.08,2.08,2.08,2.08,-0.45,-17.79,15000,1,31200,0,0,0,0,0,0,0,15000,-15000,-15000
20200430,72891P,優群永豐97售02,0.20,0.20,0.20,0.20,+0.02,11.11,30000,3,6000,0,0,0,0,0,0,0,0,0,0
20200430,72892P,精測康和97售01,,,,,,0.00,0,0,0,0,0,0,0,0,0,0,0,0,0
20200430,72893P,櫃200群益97售03,1.72,1.72,1.70,1.70,-0.21,-10.99,20000,2,34200,0,0,0,0,0,0,0,20000,-20000,-20000
20200430,72894P,中美晶凱基97售03,,,,,,0.00,0,0,0,0,0,0,0,0,0,0,0,0,0
20200430,72895P,穩懋日盛97售03,,,,,,0.00,0,0,0,0,0,0,0,0,0,0,0,0,0
20200430,72896P,廣明永豐97售02,1.45,1.60,1.45,1.60,+0.06,3.9,66000,11,103340,0,0,0,0,0,0,49000,17000,32000,32000
20200430,72897P,璟德永豐97售01,0.80,0.81,0.76,0.78,-0.04,-4.88,141000,12,109110,0,0,0,0,0,0,85000,56000,29000,29000
20200430,72898P,雙鴻國票98售01,1.15,1.15,1.15,1.15,-0.03,-2.54,5000,1,5750,0,0,0,0,0,0,0,5000,-5000,-5000
20200430,72899P,中美晶群益97售02,1.32,1.32,1.32,1.32,-0.04,-2.94,23000,1,30360,0,0,0,0,0,0,0,23000,-23000,-23000
20200430,72900P,聯亞群益97售01,1.61,1.87,1.61,1.85,+0.12,6.94,354000,15,623170,0,0,0,0,0,0,102000,252000,-150000,-150000
20200430,72901P,穩懋統一97售04,2.21,2.30,2.21,2.22,-0.26,-10.48,149000,6,338120,0,0,0,0,0,0,19000,130000,-111000,-111000
20200430,72902P,精測元富97售01,,,,,,0.00,0,0,0,0,0,0,0,0,0,0,0,0,0
20200430,72903P,中美晶國票97售03,3.53,3.58,3.52,3.58,-0.17,-4.53,29000,8,102730,0,0,0,0,0,0,21000,8000,13000,13000
20200430,72904P,大江群益97售03,,,,,,0.00,0,0,0,0,0,0,0,0,0,0,0,0,0
20200430,72905P,穩懋國泰98售01,,,,,,0.00,0,0,0,0,0,0,0,0,0,0,0,0,0
20200430,72906P,穩懋國泰99售01,1.21,1.25,1.19,1.24,-0.19,-13.29,79000,6,95420,0,0,0,0,0,0,69000,10000,59000,59000
20200430,72907P,穩懋兆豐98售01,,,,,,0.00,0,0,0,0,0,0,0,0,0,0,0,0,0
20200430,72908P,原相永豐97售01,0.23,0.23,0.23,0.23,-0.01,-4.17,2000,1,460,0,0,0,0,0,0,0,2000,-2000,-2000
20200430,72909P,穩懋永豐97售01,0.89,0.96,0.89,0.96,-0.16,-14.29,51000,4,47820,0,0,0,0,0,0,51000,0,51000,51000
20200430,72910P,穩懋統一99售02,2.56,2.56,2.56,2.56,-0.19,-6.91,1000,1,2560,0,0,0,0,0,0,0,1000,-1000,-1000
20200430,72911P,穩懋元大97售05,1.23,1.36,1.23,1.29,-0.27,-17.31,1311000,52,1760950,0,0,0,0,0,0,1041000,1218000,-177000,-177000
20200430,72912P,原相中信99售02,0.58,0.58,0.57,0.57,-0.02,-3.39,48000,2,27740,0,0,0,0,0,0,48000,0,48000,48000
20200430,72913P,旺矽統一97售02,,,,,,0.00,0,0,0,0,0,0,0,0,0,0,0,0,0
20200430,72914P,穩懋元大97售06,1.32,1.46,1.31,1.41,-0.23,-14.02,3017000,55,4260480,0,0,0,0,0,0,2836000,2929000,-93000,-93000
20200430,72915P,中美晶凱基97售06,,,,,,0.00,0,0,0,0,0,0,0,0,0,0,0,0,0
20200430,72916P,穩懋凱基97售04,1.00,1.00,0.92,0.92,-0.22,-19.3,169000,2,155720,0,0,0,0,0,0,166000,169000,-3000,-3000
20200430,72917P,網龍國票98售01,1.67,1.74,1.66,1.74,+0.07,4.19,49000,14,83360,0,0,0,0,0,0,23000,25000,-2000,-2000
20200430,72918P,環球晶元富97售02,1.17,1.17,1.17,1.17,-0.23,-16.43,1000,1,1170,0,0,0,0,0,0,1000,0,1000,1000
20200430,72919P,聯亞元富97售02,,,,,,0.00,0,0,0,0,0,0,0,0,0,0,0,0,0
20200430,72920P,雙鴻元富97售02,,,,,,0.00,0,0,0,0,0,0,0,0,0,0,0,0,0
20200430,72921P,雙鴻元大98售01,,,,,,0.00,0,0,0,0,0,0,0,0,0,0,0,0,0
20200430,72922P,原相亞東99售01,,,,,,0.00,0,0,0,0,0,0,0,0,0,0,0,0,0
20200430,72923P,台燿永豐97售01,0.45,0.45,0.42,0.42,-0.12,-22.22,156000,7,67590,0,0,0,0,0,0,35000,121000,-86000,-86000
20200430,72924P,精測凱基97售05,,,,,,0.00,0,0,0,0,0,0,0,0,0,0,0,0,0
20200430,72925P,鈊象凱基97售02,,,,,,0.00,0,0,0,0,0,0,0,0,0,0,0,0,0
20200430,72926P,精華元大97售02,3.77,3.77,3.37,3.37,-0.71,-17.4,77000,8,277890,0,0,0,0,0,0,0,77000,-77000,-77000
20200430,72927P,大江元富97售02,,,,,,0.00,0,0,0,0,0,0,0,0,0,0,0,0,0
20200430,72928P,宜鼎元富97售02,,,,,,0.00,0,0,0,0,0,0,0,0,0,0,0,0,0
20200430,72929P,信驊元富97售02,0.41,0.42,0.41,0.42,-0.11,-20.75,553000,7,227010,0,0,0,0,0,0,528000,0,528000,528000
20200430,72930P,威剛元富97售03,,,,,,0.00,0,0,0,0,0,0,0,0,0,0,0,0,0
20200430,72931P,新普元富97售02,0.81,0.81,0.81,0.81,-0.10,-10.99,2000,1,1620,0,0,0,0,0,0,2000,0,2000,2000
20200430,72932P,網家元富97售02,0.56,0.60,0.56,0.59,-0.04,-6.35,42000,5,24880,0,0,0,0,0,0,4000,38000,-34000,-34000
20200430,72933P,碩禾永豐97售01,,,,,,0.00,0,0,0,0,0,0,0,0,0,0,0,0,0
20200430,72934P,晟德永豐97售01,2.58,2.60,2.58,2.60,-0.08,-2.99,19000,3,49240,0,0,0,0,0,0,0,19000,-19000,-19000
20200430,72935P,鈊象永豐97售03,0.47,0.47,0.47,0.47,+0.18,62.07,5000,1,2350,0,0,0,0,0,0,0,5000,-5000,-5000
20200430,72936P,鈊象元富97售03,0.18,0.34,0.18,0.34,+0.06,21.43,513000,17,106070,0,0,0,0,0,0,447000,402000,45000,45000
20200430,72937P,櫃200元大99售01,,,,,,0.00,0,0,0,0,0,0,0,0,0,0,0,0,0
20200430,72938P,櫃200元大99售02,,,,,,0.00,0,0,0,0,0,0,0,0,0,0,0,0,0
20200430,72939P,網龍元大97售02,3.83,3.83,3.83,3.83,+0.16,4.36,15000,1,57450,0,0,0,0,0,0,15000,0,15000,15000
20200430,72940P,環球晶群益97售04,1.96,1.96,1.85,1.85,-0.25,-11.9,55000,6,105110,0,0,0,0,0,0,55000,20000,35000,35000
20200430,72941P,環球晶統一97售03,,,,,,0.00,0,0,0,0,0,0,0,0,0,0,0,0,0
20200430,72942P,群聯元富97售01,,,,,,0.00,0,0,0,0,0,0,0,0,0,0,0,0,0
20200430,72943P,雙鴻元富97售03,,,,,,0.00,0,0,0,0,0,0,0,0,0,0,0,0,0
20200430,72944P,信昌電元富97售01,,,,,,0.00,0,0,0,0,0,0,0,0,0,0,0,0,0
20200430,72945P,大江永豐97售04,2.13,2.18,2.13,2.18,-0.02,-0.91,162000,7,352260,0,0,0,0,0,0,80000,82000,-2000,-2000
20200430,72946P,穩懋富邦99售02,1.14,1.16,1.14,1.16,-0.14,-10.77,714000,3,828040,0,0,0,0,0,0,714000,704000,10000,10000
20200430,72947P,環球晶凱基97售08,2.30,2.32,2.08,2.09,-0.34,-13.99,151000,24,334320,0,0,0,0,0,0,83000,68000,15000,15000
20200430,72948P,大江元大97售06,0.95,0.96,0.95,0.95,-0.02,-2.06,66000,3,62980,0,0,0,0,0,0,10000,56000,-46000,-46000
20200430,72949P,環球晶永豐97售02,1.54,1.54,1.37,1.37,-0.31,-18.45,78000,4,111480,0,0,0,0,0,0,78000,67000,11000,11000
20200430,72950P,中美晶元富97售02,,,,,,0.00,0,0,0,0,0,0,0,0,0,0,0,0,0
20200430,72951P,宣德元富97售02,,,,,,0.00,0,0,0,0,0,0,0,0,0,0,0,0,0
20200430,72952P,群聯元富97售02,7.85,7.85,7.85,7.85,-0.35,-4.27,10000,1,78500,0,0,0,0,0,0,0,10000,-10000,-10000
20200430,72953P,環球晶元富97售05,2.16,2.16,2.16,2.16,-0.25,-10.37,21000,2,45360,0,0,0,0,0,0,21000,21000,0,0
20200430,72954P,穩懋元富97售05,,,,,,0.00,0,0,0,0,0,0,0,0,0,0,0,0,0
20200430,72955P,中美晶元大98售02,,,,,,0.00,0,0,0,0,0,0,0,0,0,0,0,0,0
20200430,72956P,信驊元大98售01,0.75,0.75,0.73,0.74,-0.09,-10.84,169000,11,125720,0,0,0,0,0,0,147000,22000,125000,125000
20200430,72957P,精測元富98售01,,,,,,0.00,0,0,0,0,0,0,0,0,0,0,0,0,0
20200430,72958P,威剛元大98售03,1.51,1.51,1.51,1.51,-0.04,-2.58,89000,2,134390,0,0,0,0,0,0,89000,0,89000,89000
20200430,72959P,大江永豐98售02,,,,,,0.00,0,0,0,0,0,0,0,0,0,0,0,0,0
20200430,72960P,中美晶永豐98售01,1.09,1.09,1.03,1.03,-0.09,-8.04,10000,2,10600,0,0,0,0,0,0,0,10000,-10000,-10000
20200430,72961P,環球晶國泰99售01,,,,,,0.00,0,0,0,0,0,0,0,0,0,0,0,0,0
20200430,72962P,鈊象元富98售01,0.45,0.51,0.45,0.50,-0.04,-7.41,15000,9,7160,0,0,0,0,0,0,7000,0,7000,7000
20200430,72963P,環球晶凱基98售03,1.85,1.85,1.76,1.76,-0.40,-18.52,24000,4,43170,0,0,0,0,0,0,0,24000,-24000,-24000
20200430,72964P,環球晶元大98售05,2.34,2.35,2.34,2.35,-0.56,-19.24,15000,2,35200,0,0,0,0,0,0,15000,0,15000,15000
20200430,72965P,環球晶元大98售06,,,,,,0.00,0,0,0,0,0,0,0,0,0,0,0,0,0
20200430,72966P,環球晶元大98售07,2.36,2.38,2.23,2.23,-0.25,-10.08,61000,4,141830,0,0,0,0,0,0,50000,11000,39000,39000
20200430,72967P,精測國泰9A售02,,,,,,0.00,0,0,0,0,0,0,0,0,0,0,0,0,0
20200430,72968P,大江元富98售03,,,,,,0.00,0,0,0,0,0,0,0,0,0,0,0,0,0
20200430,72969P,精測元大98售03,,,,,,0.00,0,0,0,0,0,0,0,0,0,0,0,0,0
20200430,72970P,原相永豐98售01,0.74,0.74,0.74,0.74,-0.03,-3.9,10000,1,7400,0,0,0,0,0,0,10000,0,10000,10000
20200430,72971P,穩懋凱基98售05,2.81,2.83,2.81,2.83,-0.23,-7.52,10000,2,28200,0,0,0,0,0,0,5000,5000,0,0
20200430,72972P,大江元富98售04,1.74,1.74,1.74,1.74,-0.05,-2.79,10000,1,17400,0,0,0,0,0,0,0,10000,-10000,-10000
20200430,72973P,大江富邦9A售03,0.65,0.70,0.65,0.70,0.00,0.0,214000,5,149600,0,0,0,0,0,0,4000,210000,-206000,-206000
20200430,72974P,精測元大98售04,,,,,,0.00,0,0,0,0,0,0,0,0,0,0,0,0,0
20200430,72975P,緯軟元大9A售01,,,,,,0.00,0,0,0,0,0,0,0,0,0,0,0,0,0
20200430,72976P,環球晶元大98售08,1.98,1.98,1.57,1.65,-0.45,-21.43,114000,8,188150,0,0,0,0,0,0,90000,54000,36000,36000
20200430,72977P,晶焱永豐98售02,1.01,1.01,0.97,0.97,-0.05,-4.9,240000,4,235800,0,0,0,0,0,0,120000,120000,0,0
20200430,72978P,新鉅科元大98售02,3.48,3.58,3.48,3.54,+0.04,1.14,140000,12,496960,0,0,0,0,0,0,17000,123000,-106000,-106000
20200430,72979P,聯亞元大98售02,2.44,2.66,2.44,2.65,-0.17,-6.03,168000,8,441980,0,0,0,0,0,0,20000,148000,-128000,-128000
20200430,72980P,穩懋元大98售03,3.85,3.87,3.85,3.87,-0.43,-10.0,3000,2,11590,0,0,0,0,0,0,2000,1000,1000,1000
20200430,72981P,聯亞凱基98售03,,,,,,0.00,0,0,0,0,0,0,0,0,0,0,0,0,0
20200430,72982P,精測元大98售05,,,,,,0.00,0,0,0,0,0,0,0,0,0,0,0,0,0
20200430,72983P,穩懋元大98售04,4.42,4.42,4.42,4.42,-0.33,-6.95,2000,1,8840,0,0,0,0,0,0,0,2000,-2000,-2000
20200430,72984P,威剛永豐98售02,1.46,1.48,1.46,1.48,-0.05,-3.27,189000,7,278040,0,0,0,0,0,0,84000,105000,-21000,-21000
20200430,72985P,群聯元富98售03,,,,,,0.00,0,0,0,0,0,0,0,0,0,0,0,0,0
20200430,72986P,環球晶元大98售11,,,,,,0.00,0,0,0,0,0,0,0,0,0,0,0,0,0
20200430,72987P,環球晶元大98售12,4.06,4.06,4.02,4.02,-0.20,-4.74,32000,2,129360,0,0,0,0,0,0,32000,0,32000,32000
20200430,72988P,聯亞元大98售03,,,,,,0.00,0,0,0,0,0,0,0,0,0,0,0,0,0
20200430,72989P,信昌電永豐98售02,1.21,1.23,1.21,1.23,-0.10,-7.52,39000,2,47770,0,0,0,0,0,0,0,39000,-39000,-39000
20200430,72990P,環球晶凱基98售06,,,,,,0.00,0,0,0,0,0,0,0,0,0,0,0,0,0
20200430,72991P,穩懋凱基98售08,3.41,3.50,3.41,3.50,-0.21,-5.66,29000,6,100180,0,0,0,0,0,0,12000,17000,-5000,-5000
20200430,72992P,穩懋永豐98售02,2.67,2.67,2.67,2.67,-0.17,-5.99,21000,4,56070,0,0,0,0,0,0,0,21000,-21000,-21000
20200430,72993P,穩懋元富98售01,,,,,,0.00,0,0,0,0,0,0,0,0,0,0,0,0,0
20200430,72994P,穩懋元富98售02,4.38,4.38,4.38,4.38,-0.17,-3.74,2000,1,8760,0,0,0,0,0,0,0,2000,-2000,-2000
20200430,72995P,雙鴻兆豐99售02,0.51,0.53,0.51,0.52,-0.01,-1.89,152000,17,79710,0,0,0,0,0,0,3000,124000,-121000,-121000
20200430,72996P,力旺元富98售02,,,,,,0.00,0,0,0,0,0,0,0,0,0,0,0,0,0
20200430,72997P,精測台新98售02,,,,,,0.00,0,0,0,0,0,0,0,0,0,0,0,0,0
20200430,72998P,穩懋台新98售01,,,,,,0.00,0,0,0,0,0,0,0,0,0,0,0,0,0
20200430,72999P,環球晶群益98售03,,,,,,0.00,0,0,0,0,0,0,0,0,0,0,0,0,0
20200430,73000P,穩懋富邦99售03,2.25,2.25,2.25,2.25,-0.21,-8.54,1000,1,2250,0,0,0,0,0,0,1000,0,1000,1000
20200430,73001P,譜瑞元大98售05,4.09,4.14,4.09,4.14,+0.08,1.97,48000,3,197820,0,0,0,0,0,0,28000,20000,8000,8000
20200430,73002P,精測元富98售03,3.53,3.53,3.53,3.53,-0.13,-3.55,7000,2,24710,0,0,0,0,0,0,0,7000,-7000,-7000
20200430,73003P,神盾群益9A售04,1.47,1.47,1.46,1.46,+0.12,8.96,76000,3,111620,0,0,0,0,0,0,5000,71000,-66000,-66000
20200430,73004P,譜瑞台新99售01,0.98,0.99,0.60,0.60,-0.42,-41.18,328000,8,312240,0,0,0,0,0,0,273000,55000,218000,218000
20200430,73005P,中美晶元大98售07,2.63,2.63,2.56,2.56,-0.13,-4.83,120000,17,310460,0,0,0,0,0,0,120000,95000,25000,25000
20200430,73006P,聯亞元大98售04,1.64,1.64,1.64,1.64,-0.03,-1.8,5000,1,8200,0,0,0,0,0,0,0,5000,-5000,-5000
20200430,73007P,中美晶元富98售01,,,,,,0.00,0,0,0,0,0,0,0,0,0,0,0,0,0
20200430,73008P,合晶元富98售02,,,,,,0.00,0,0,0,0,0,0,0,0,0,0,0,0,0
20200430,73009P,原相元富98售02,,,,,,0.00,0,0,0,0,0,0,0,0,0,0,0,0,0
20200430,73010P,勝麗元富98售01,,,,,,0.00,0,0,0,0,0,0,0,0,0,0,0,0,0
20200430,73011P,原相台新98售01,0.05,0.05,0.05,0.05,-0.82,-94.25,10000,2,500,0,0,0,0,0,0,0,10000,-10000,-10000
20200430,73012P,威剛統一98售02,1.77,1.77,1.77,1.77,-0.08,-4.32,10000,1,17700,0,0,0,0,0,0,10000,0,10000,10000
20200430,73013P,中美晶群益98售05,,,,,,0.00,0,0,0,0,0,0,0,0,0,0,0,0,0
20200430,73014P,環球晶國泰9A售02,2.61,2.61,2.54,2.54,-0.33,-11.5,5000,2,12840,0,0,0,0,0,0,5000,0,5000,5000
20200430,73015P,碩禾元大99售04,1.92,1.92,1.92,1.92,-0.03,-1.54,16000,1,30720,0,0,0,0,0,0,0,16000,-16000,-16000
20200430,73016P,精測元大98售06,5.70,5.70,5.65,5.65,-0.25,-4.24,173000,6,978450,0,0,0,0,0,0,166000,5000,161000,161000
20200430,73017P,環球晶統一99售05,1.77,1.87,1.77,1.87,-0.08,-4.1,11000,2,19570,0,0,0,0,0,0,10000,1000,9000,9000
20200430,73018P,威剛國票99售02,2.20,2.21,2.16,2.21,-0.06,-2.64,280000,21,616330,0,0,0,0,0,0,35000,245000,-210000,-210000
20200430,73019P,穩懋國泰99售02,1.86,1.88,1.86,1.88,-0.62,-24.8,4000,2,7460,0,0,0,0,0,0,4000,0,4000,4000
20200430,73020P,穩懋亞東98售02,1.92,2.04,1.92,2.04,-0.33,-13.92,15000,2,29400,0,0,0,0,0,0,10000,15000,-5000,-5000
20200430,73021P,原相元大99售02,1.18,1.18,1.18,1.18,0.00,0.0,10000,1,11800,0,0,0,0,0,0,10000,0,10000,10000
20200430,73022P,台燿中信9A售02,0.79,0.80,0.76,0.76,-0.11,-12.64,115000,6,89800,0,0,0,0,0,0,10000,105000,-95000,-95000
20200430,73023P,新普中信9C售01,,,,,,0.00,0,0,0,0,0,0,0,0,0,0,0,0,0
20200430,73024P,譜瑞中信9C售01,0.54,0.55,0.54,0.54,-0.01,-1.82,14000,3,7570,0,0,0,0,0,0,14000,0,14000,14000
20200430,73025P,譜瑞凱基98售03,0.93,0.95,0.93,0.95,-0.01,-1.04,80000,4,75400,0,0,0,0,0,0,80000,0,80000,80000
20200430,73026P,泰博永豐98售02,0.58,0.59,0.57,0.57,-0.02,-3.39,210000,8,121570,0,0,0,0,0,0,108000,102000,6000,6000
20200430,73027P,雙鴻元大9A售02,0.93,0.94,0.93,0.94,-0.04,-4.08,56000,3,52630,0,0,0,0,0,0,56000,50000,6000,6000
20200430,73028P,中美晶統一9B售01,,,,,,0.00,0,0,0,0,0,0,0,0,0,0,0,0,0
20200430,73029P,中美晶凱基99售06,,,,,,0.00,0,0,0,0,0,0,0,0,0,0,0,0,0
20200430,73030P,大江群益99售01,1.39,1.47,1.39,1.47,-0.01,-0.68,212000,9,309610,0,0,0,0,0,0,12000,200000,-188000,-188000
20200430,73031P,宏捷科康和99售02,2.27,2.32,2.27,2.32,-0.01,-0.43,211000,14,481220,0,0,0,0,0,0,209000,2000,207000,207000
20200430,73032P,雙鴻群益9B售01,0.84,0.84,0.84,0.84,-0.04,-4.55,145000,3,121800,0,0,0,0,0,0,145000,125000,20000,20000
20200430,73033P,宏捷科國票99售01,2.15,2.28,2.15,2.28,+0.02,0.88,10000,3,22590,0,0,0,0,0,0,1000,9000,-8000,-8000
20200430,73034P,大江富邦9B售01,0.75,0.76,0.75,0.76,-0.01,-1.3,57000,7,42860,0,0,0,0,0,0,55000,2000,53000,53000
20200430,73035P,中美晶台新99售01,,,,,,0.00,0,0,0,0,0,0,0,0,0,0,0,0,0
20200430,73036P,鈊象永豐99售02,0.84,1.01,0.84,1.01,+0.10,10.99,143000,22,134070,0,0,0,0,0,0,54000,111000,-57000,-57000
20200430,73037P,海韻電元富99售02,1.38,1.38,1.38,1.38,-0.14,-9.21,10000,1,13800,0,0,0,0,0,0,10000,0,10000,10000
20200430,73038P,中美晶台新99售02,,,,,,0.00,0,0,0,0,0,0,0,0,0,0,0,0,0
20200430,73039P,原相台新99售01,,,,,,0.00,0,0,0,0,0,0,0,0,0,0,0,0,0
20200430,73040P,穩懋凱基99售04,1.21,1.21,1.21,1.21,-0.20,-14.18,5000,1,6050,0,0,0,0,0,0,5000,0,5000,5000
20200430,73041P,穩懋統一9B售02,,,,,,0.00,0,0,0,0,0,0,0,0,0,0,0,0,0
20200430,73042P,原相元大99售04,,,,,,0.00,0,0,0,0,0,0,0,0,0,0,0,0,0
20200430,73043P,穩懋元大99售04,2.53,2.53,2.47,2.47,-0.42,-14.53,15000,2,37350,0,0,0,0,0,0,10000,5000,5000,5000
20200430,73044P,原相國票9A售01,1.88,1.90,1.88,1.90,0.00,0.0,45000,2,85200,0,0,0,0,0,0,0,45000,-45000,-45000
20200430,73045P,雙鴻國票9A售02,1.22,1.22,1.22,1.22,-0.02,-1.61,15000,1,18300,0,0,0,0,0,0,0,15000,-15000,-15000
20200430,73046P,神盾群益9A售05,1.58,1.66,1.58,1.61,-0.06,-3.59,326000,20,530570,0,0,0,0,0,0,192000,264000,-72000,-72000
20200430,73047P,宏捷科元富9C售03,1.70,1.77,1.69,1.75,+0.01,0.57,135000,15,235520,0,0,0,0,0,0,29000,106000,-77000,-77000
20200430,73048P,中美晶中信9B售01,1.10,1.10,1.10,1.10,-0.05,-4.35,15000,1,16500,0,0,0,0,0,0,15000,0,15000,15000
20200430,73049P,宏捷科元大99售05,1.03,1.03,1.03,1.03,+0.13,14.44,2000,1,2060,0,0,0,0,0,0,0,2000,-2000,-2000
20200430,73050P,雍智元大99售02,0.76,0.76,0.72,0.72,-0.05,-6.49,250000,5,185600,0,0,0,0,0,0,30000,220000,-190000,-190000
20200430,73051P,台燿元富9C售02,2.88,2.92,2.82,2.82,-0.31,-9.9,125000,5,360700,0,0,0,0,0,0,30000,95000,-65000,-65000
20200430,73052P,原相統一99售03,1.17,1.17,1.16,1.17,-0.02,-1.68,428000,9,500600,0,0,0,0,0,0,312000,116000,196000,196000
20200430,73053P,原相統一9A售02,,,,,,0.00,0,0,0,0,0,0,0,0,0,0,0,0,0
20200430,73054P,穩懋元大99售08,1.54,1.62,1.54,1.62,-0.13,-7.43,95000,11,153110,0,0,0,0,0,0,74000,32000,42000,42000
20200430,73055P,信驊永豐99售03,0.80,0.80,0.78,0.78,-0.07,-8.24,280000,13,220100,0,0,0,0,0,0,128000,150000,-22000,-22000
20200430,73056P,原相永豐99售02,0.82,0.83,0.82,0.83,-0.03,-3.49,210000,6,174200,0,0,0,0,0,0,210000,80000,130000,130000
20200430,73057P,環球晶兆豐99售02,2.05,2.05,2.05,2.05,-0.06,-2.84,30000,3,61500,0,0,0,0,0,0,0,30000,-30000,-30000
20200430,73058P,原相統一9B售02,1.07,1.07,1.07,1.07,0.00,0.0,26000,1,27820,0,0,0,0,0,0,26000,0,26000,26000
20200430,73059P,鈊象元大99售05,1.49,1.65,1.49,1.63,+0.05,3.16,972000,47,1513380,0,0,0,0,0,0,303000,662000,-359000,-359000
20200430,73060P,環球晶凱基99售06,1.37,1.37,1.30,1.30,-0.16,-10.96,15000,2,20200,0,0,0,0,0,0,0,15000,-15000,-15000
20200430,73061P,群聯元大9A售01,,,,,,0.00,0,0,0,0,0,0,0,0,0,0,0,0,0
20200430,73062P,群聯凱基99售02,,,,,,0.00,0,0,0,0,0,0,0,0,0,0,0,0,0
20200430,73063P,環球晶凱基99售10,1.28,1.28,1.28,1.28,-0.15,-10.49,20000,1,25600,0,0,0,0,0,0,20000,0,20000,20000
20200430,73064P,中美晶富邦9B售02,0.88,0.88,0.87,0.87,-0.03,-3.33,40000,4,34900,0,0,0,0,0,0,0,40000,-40000,-40000
20200430,73065P,鈊象元富99售01,2.61,2.78,2.61,2.78,+0.16,6.11,19000,7,52090,0,0,0,0,0,0,4000,15000,-11000,-11000
20200430,73066P,環球晶元大99售07,1.63,1.63,1.45,1.45,-0.26,-15.2,173000,17,268440,0,0,0,0,0,0,121000,52000,69000,69000
20200430,73067P,環球晶元大99售08,1.53,1.53,1.41,1.42,-0.19,-11.8,241000,13,351880,0,0,0,0,0,0,241000,0,241000,241000
20200430,73068P,穩懋元大99售12,2.03,2.03,2.00,2.00,-0.14,-6.54,12000,3,24060,0,0,0,0,0,0,10000,2000,8000,8000
20200430,73069P,聯亞富邦9B售01,0.54,0.54,0.54,0.54,+0.01,1.89,2000,1,1080,0,0,0,0,0,0,2000,0,2000,2000
20200430,73070P,元太亞東99售02,,,,,,0.00,0,0,0,0,0,0,0,0,0,0,0,0,0
20200430,73071P,雙鴻元富99售02,,,,,,0.00,0,0,0,0,0,0,0,0,0,0,0,0,0
20200430,73072P,環球晶元大99售12,2.48,2.48,2.30,2.30,-0.30,-11.54,38000,2,92440,0,0,0,0,0,0,38000,0,38000,38000
20200430,73073P,穩懋元大99售19,,,,,,0.00,0,0,0,0,0,0,0,0,0,0,0,0,0
20200430,73074P,聯亞國票99售04,1.93,2.07,1.93,2.07,-0.07,-3.27,31000,3,63050,0,0,0,0,0,0,8000,23000,-15000,-15000
20200430,73075P,中美晶元大99售06,1.53,1.53,1.53,1.53,-0.04,-2.55,27000,2,41310,0,0,0,0,0,0,0,27000,-27000,-27000
20200430,73076P,中美晶元大99售07,1.38,1.38,1.31,1.32,-0.08,-5.71,93000,7,124030,0,0,0,0,0,0,74000,93000,-19000,-19000
20200430,73077P,環球晶元大99售16,2.12,2.12,2.05,2.05,-0.10,-4.65,6000,2,12510,0,0,0,0,0,0,0,6000,-6000,-6000
20200430,73078P,環球晶元大99售17,,,,,,0.00,0,0,0,0,0,0,0,0,0,0,0,0,0
20200430,73079P,環球晶凱基99售14,,,,,,0.00,0,0,0,0,0,0,0,0,0,0,0,0,0
20200430,73080P,穩懋凱基99售11,0.54,0.77,0.54,0.76,-0.04,-5.0,200000,16,149740,0,0,0,0,0,0,115000,70000,45000,45000
20200430,73081P,環球晶國泰9A售04,1.32,1.32,1.22,1.22,-0.16,-11.59,231000,6,303800,0,0,0,0,0,0,231000,0,231000,231000
20200430,73082P,精測元富9A售01,1.53,1.56,1.53,1.56,-0.05,-3.11,124000,7,191750,0,0,0,0,0,0,84000,0,84000,84000
20200430,73083P,環球晶凱基9A售03,0.54,0.54,0.52,0.52,-0.05,-8.77,15000,2,7900,0,0,0,0,0,0,15000,0,15000,15000
20200430,73084P,穩懋凱基9A售03,0.82,0.83,0.81,0.83,-0.04,-4.6,396000,12,324480,0,0,0,0,0,0,366000,23000,343000,343000
20200430,73085P,群聯國票9A售02,1.92,1.96,1.90,1.90,-0.23,-10.8,38000,5,73290,0,0,0,0,0,0,19000,19000,0,0
20200430,73086P,鈊象國票9A售01,2.41,2.60,2.41,2.60,+0.09,3.59,89000,7,224960,0,0,0,0,0,0,48000,41000,7000,7000
20200430,73087P,穩懋元大9A售03,1.95,2.02,1.95,1.98,-0.09,-4.35,219000,12,430380,0,0,0,0,0,0,144000,75000,69000,69000
20200430,73088P,穩懋元大9A售04,1.95,1.97,1.95,1.96,-0.11,-5.31,135000,8,264770,0,0,0,0,0,0,80000,55000,25000,25000
20200430,73089P,群聯凱基9A售03,0.56,0.56,0.56,0.56,-0.02,-3.45,10000,1,5600,0,0,0,0,0,0,0,10000,-10000,-10000
20200430,73090P,環球晶國票9A售01,2.17,2.17,2.09,2.09,-0.18,-7.93,68000,2,142760,0,0,0,0,0,0,68000,0,68000,68000
20200430,73091P,穩懋康和9A售01,,,,,,0.00,0,0,0,0,0,0,0,0,0,0,0,0,0
20200430,73092P,新普元大9A售01,1.69,1.71,1.69,1.69,-0.08,-4.52,163000,7,276650,0,0,0,0,0,0,128000,35000,93000,93000
20200430,73093P,精測凱基9A售03,0.83,0.84,0.83,0.84,-0.02,-2.33,230000,14,192300,0,0,0,0,0,0,200000,0,200000,200000
20200430,73094P,中美晶國票9A售03,,,,,,0.00,0,0,0,0,0,0,0,0,0,0,0,0,0
20200430,73095P,穩懋元大9A售05,1.55,1.57,1.53,1.57,-0.06,-3.68,307000,9,477510,0,0,0,0,0,0,247000,60000,187000,187000
20200430,73096P,世界元大9A售02,1.35,1.36,1.31,1.31,-0.11,-7.75,96000,4,128910,0,0,0,0,0,0,95000,1000,94000,94000
20200430,73097P,群聯元大9A售04,2.64,2.69,2.64,2.69,-0.06,-2.18,20000,2,53300,0,0,0,0,0,0,0,20000,-20000,-20000
20200430,73098P,信驊凱基9A售02,0.94,0.94,0.92,0.93,-0.05,-5.1,134000,10,124520,0,0,0,0,0,0,100000,34000,66000,66000
20200430,73099P,穩懋國泰9B售02,2.00,2.05,2.00,2.04,-0.06,-2.86,79000,7,160450,0,0,0,0,0,0,40000,39000,1000,1000
20200430,73100P,神盾元富9A售02,1.12,1.12,1.09,1.09,-0.04,-3.54,584000,8,653720,0,0,0,0,0,0,572000,584000,-12000,-12000
20200430,73101P,中美晶凱基9A售05,,,,,,0.00,0,0,0,0,0,0,0,0,0,0,0,0,0
20200430,73102P,原相元大9A售06,1.19,1.19,1.19,1.19,-0.01,-0.83,49000,3,58310,0,0,0,0,0,0,30000,19000,11000,11000
20200430,73103P,穩懋富邦9C售01,0.99,1.01,0.99,1.01,-0.05,-4.72,247000,17,246920,0,0,0,0,0,0,64000,183000,-119000,-119000
20200430,73104P,原相元大9A售07,1.21,1.21,1.21,1.21,-0.02,-1.63,29000,1,35090,0,0,0,0,0,0,29000,0,29000,29000
20200430,73105P,穩懋國票9A售03,2.89,2.92,2.89,2.92,-0.18,-5.81,11000,2,31820,0,0,0,0,0,0,0,11000,-11000,-11000
20200430,73106P,原相永豐9A售03,0.88,0.88,0.88,0.88,-0.02,-2.22,30000,2,26400,0,0,0,0,0,0,0,30000,-30000,-30000
20200430,73107P,原相國票9B售02,,,,,,0.00,0,0,0,0,0,0,0,0,0,0,0,0,0
20200430,73108P,鈊象國票9A售03,3.39,3.49,3.39,3.49,-0.06,-1.69,15000,2,51350,0,0,0,0,0,0,10000,5000,5000,5000
20200430,73109P,神盾永豐9A售04,0.78,0.78,0.75,0.75,-0.04,-5.06,75000,9,57480,0,0,0,0,0,0,1000,73000,-72000,-72000
20200430,73110P,環球晶統一9A售01,0.71,0.71,0.68,0.68,-0.04,-5.56,56000,3,39580,0,0,0,0,0,0,52000,4000,48000,48000
20200430,73111P,穩懋統一9A售03,0.76,0.76,0.75,0.76,-0.05,-6.17,79000,5,59900,0,0,0,0,0,0,79000,0,79000,79000
20200430,73112P,信驊國票9A售03,1.59,1.60,1.58,1.60,-0.12,-6.98,134000,4,213080,0,0,0,0,0,0,21000,113000,-92000,-92000
20200430,73113P,穩懋國票9A售04,,,,,,0.00,0,0,0,0,0,0,0,0,0,0,0,0,0
20200430,73114P,穩懋元大9A售06,2.64,2.64,2.64,2.64,-0.25,-8.65,2000,1,5280,0,0,0,0,0,0,0,2000,-2000,-2000
20200430,73115P,鈊象元大9A售03,3.21,3.34,3.21,3.33,+0.13,4.06,175000,11,569030,0,0,0,0,0,0,41000,132000,-91000,-91000
20200430,73116P,原相凱基9A售04,0.98,0.98,0.98,0.98,-0.01,-1.01,36000,1,35280,0,0,0,0,0,0,36000,0,36000,36000
20200430,73117P,鈊象永豐9A售04,0.88,0.95,0.88,0.95,+0.03,3.26,101000,12,94270,0,0,0,0,0,0,70000,31000,39000,39000
20200430,73118P,精測群益9A售01,1.41,1.43,1.40,1.43,-0.03,-2.05,205000,15,292190,0,0,0,0,0,0,28000,177000,-149000,-149000
20200430,73119P,原相凱基9A售05,0.96,0.96,0.96,0.96,0.00,0.0,37000,1,35520,0,0,0,0,0,0,37000,0,37000,37000
20200430,73120P,群聯凱基9A售05,0.72,0.72,0.72,0.72,-0.03,-4.0,100000,1,72000,0,0,0,0,0,0,100000,0,100000,100000
20200430,73121P,中美晶元大9A售03,2.34,2.37,2.29,2.29,-0.12,-4.98,22000,8,51560,0,0,0,0,0,0,6000,16000,-10000,-10000
20200430,73122P,宏捷科元大9B售03,,,,,,0.00,0,0,0,0,0,0,0,0,0,0,0,0,0
20200430,73123P,信驊元大9A售04,1.92,1.96,1.91,1.91,-0.12,-5.91,54000,5,103850,0,0,0,0,0,0,54000,0,54000,54000
20200430,73124P,穩懋元大9A售07,2.61,2.69,2.61,2.65,-0.18,-6.36,38000,4,100360,0,0,0,0,0,0,28000,10000,18000,18000
20200430,73125P,精測元大9A售06,,,,,,0.00,0,0,0,0,0,0,0,0,0,0,0,0,0
20200430,73126P,聯亞元大9A售02,1.46,1.50,1.46,1.50,+0.07,4.9,197000,5,293390,0,0,0,0,0,0,0,197000,-197000,-197000
20200430,73127P,鈊象元大9B售05,1.24,1.24,1.23,1.24,+0.04,3.33,11000,4,13620,0,0,0,0,0,0,4000,7000,-3000,-3000
20200430,73128P,鈊象群益9A售04,1.91,2.07,1.90,2.05,+0.05,2.5,254000,18,499390,0,0,0,0,0,0,94000,160000,-66000,-66000
20200430,73129P,中美晶永豐9A售02,,,,,,0.00,0,0,0,0,0,0,0,0,0,0,0,0,0
20200430,73130P,碩禾永豐9A售02,,,,,,0.00,0,0,0,0,0,0,0,0,0,0,0,0,0
20200430,73131P,聯亞凱基9A售03,,,,,,0.00,0,0,0,0,0,0,0,0,0,0,0,0,0
20200430,73132P,大江國票9A售07,1.86,1.86,1.86,1.86,-0.03,-1.59,19000,1,35340,0,0,0,0,0,0,0,19000,-19000,-19000
20200430,73133P,神盾國票9B售02,1.17,1.17,1.13,1.14,-0.04,-3.39,68000,10,78470,0,0,0,0,0,0,21000,47000,-26000,-26000
20200430,73134P,神盾國票9B售03,,,,,,0.00,0,0,0,0,0,0,0,0,0,0,0,0,0
20200430,73135P,雙鴻國票9A售04,2.69,2.69,2.69,2.69,-0.08,-2.89,7000,1,18830,0,0,0,0,0,0,0,7000,-7000,-7000
20200430,73136P,宏捷科永豐9A售02,0.85,0.88,0.85,0.88,+0.02,2.33,26000,3,22370,0,0,0,0,0,0,0,26000,-26000,-26000
20200430,73137P,頎邦永豐9A售03,0.80,0.81,0.80,0.81,-0.06,-6.9,75000,2,60340,0,0,0,0,0,0,75000,0,75000,75000
20200430,73138P,宏捷科凱基9A售04,,,,,,0.00,0,0,0,0,0,0,0,0,0,0,0,0,0
20200430,73139P,精測凱基9A售06,1.07,1.07,1.07,1.07,-0.04,-3.6,39000,3,41730,0,0,0,0,0,0,39000,0,39000,39000
20200430,73140P,穩懋凱基9A售06,1.49,1.52,1.49,1.52,-0.09,-5.59,51000,4,76920,0,0,0,0,0,0,50000,1000,49000,49000
20200430,73141P,神盾元大9A售07,0.98,1.03,0.98,1.02,-0.01,-0.97,226000,10,227460,0,0,0,0,0,0,153000,176000,-23000,-23000
20200430,73142P,精測群益9A售03,,,,,,0.00,0,0,0,0,0,0,0,0,0,0,0,0,0
20200430,73143P,環球晶富邦9B售04,,,,,,0.00,0,0,0,0,0,0,0,0,0,0,0,0,0
20200430,73144P,大江元大9A售06,1.47,1.48,1.46,1.48,-0.02,-1.33,282000,5,413900,0,0,0,0,0,0,0,282000,-282000,-282000
20200430,73145P,宏捷科元大9A售04,1.70,1.70,1.70,1.70,+0.01,0.59,35000,1,59500,0,0,0,0,0,0,0,35000,-35000,-35000
20200430,73146P,頎邦元大9A售02,1.19,1.19,1.13,1.13,-0.15,-11.72,36000,2,42360,0,0,0,0,0,0,28000,8000,20000,20000
20200430,73147P,信驊群益9A售03,2.04,2.04,2.04,2.04,-0.08,-3.77,4000,2,8160,0,0,0,0,0,0,0,4000,-4000,-4000
20200430,73148P,宏捷科國票9A售05,2.58,2.58,2.58,2.58,+0.04,1.57,7000,1,18060,0,0,0,0,0,0,0,7000,-7000,-7000
20200430,73149P,穩懋中信9C售02,,,,,,0.00,0,0,0,0,0,0,0,0,0,0,0,0,0
20200430,73150P,威剛永豐9A售02,,,,,,0.00,0,0,0,0,0,0,0,0,0,0,0,0,0
20200430,73151P,精測永豐9A售04,1.01,1.01,1.01,1.01,-0.02,-1.94,10000,1,10100,0,0,0,0,0,0,0,10000,-10000,-10000
20200430,73152P,穩懋永豐9A售03,0.87,0.87,0.87,0.87,-0.08,-8.42,2000,1,1740,0,0,0,0,0,0,2000,0,2000,2000
20200430,73153P,威剛元大9A售07,1.13,1.13,1.13,1.13,-0.02,-1.74,30000,1,33900,0,0,0,0,0,0,0,30000,-30000,-30000
20200430,73154P,神盾元大9B售03,0.92,0.92,0.91,0.91,-0.02,-2.15,13000,2,11930,0,0,0,0,0,0,3000,10000,-7000,-7000
20200430,73155P,群聯元大9A售12,1.35,1.36,1.35,1.36,-0.07,-4.9,31000,2,41950,0,0,0,0,0,0,21000,10000,11000,11000
20200430,73156P,聯亞群益9A售01,1.79,1.93,1.79,1.93,-0.05,-2.53,149000,7,278910,0,0,0,0,0,0,38000,111000,-73000,-73000
20200430,73157P,宏捷科凱基9A售05,2.25,2.26,2.25,2.26,+0.02,0.89,88000,4,198480,0,0,0,0,0,0,0,88000,-88000,-88000
20200430,73158P,環球晶凱基9A售04,1.25,1.26,1.25,1.25,-0.06,-4.58,99000,4,123850,0,0,0,0,0,0,99000,0,99000,99000
20200430,73159P,聯亞國票9A售02,2.24,2.28,2.24,2.28,+0.06,2.7,47000,2,106840,0,0,0,0,0,0,0,47000,-47000,-47000
20200430,73160P,精測元大9A售07,,,,,,0.00,0,0,0,0,0,0,0,0,0,0,0,0,0
20200430,73161P,鈊象群益9A售05,3.40,3.56,3.40,3.56,+0.11,3.19,7000,7,24530,0,0,0,0,0,0,0,7000,-7000,-7000
20200430,73162P,穩懋統一9B售04,,,,,,0.00,0,0,0,0,0,0,0,0,0,0,0,0,0
20200430,73163P,大江國票9A售08,3.22,3.22,3.22,3.22,-0.08,-2.42,5000,1,16100,0,0,0,0,0,0,0,5000,-5000,-5000
20200430,73164P,台燿元大9A售01,,,,,,0.00,0,0,0,0,0,0,0,0,0,0,0,0,0
20200430,73165P,緯軟元大9A售02,,,,,,0.00,0,0,0,0,0,0,0,0,0,0,0,0,0
20200430,73166P,聯亞元大9A售03,1.34,1.34,1.34,1.34,+0.06,4.69,5000,1,6700,0,0,0,0,0,0,0,5000,-5000,-5000
20200430,73167P,櫃200元大9A售01,,,,,,0.00,0,0,0,0,0,0,0,0,0,0,0,0,0
20200430,73168P,信驊群益9A售04,,,,,,0.00,0,0,0,0,0,0,0,0,0,0,0,0,0
20200430,73169P,信驊國票9A售05,,,,,,0.00,0,0,0,0,0,0,0,0,0,0,0,0,0
20200430,73170P,穩懋國票9A售05,,,,,,0.00,0,0,0,0,0,0,0,0,0,0,0,0,0
20200430,73171P,神盾凱基9A售03,,,,,,0.00,0,0,0,0,0,0,0,0,0,0,0,0,0
20200430,702038,中光電台新97購01,1.06,1.06,0.06,0.06,-1.00,-94.34,90000,13,63550,0,0,0,0,0,0,25000,55000,-30000,-30000
20200430,702039,群聯台新97購01,5.40,5.40,4.75,4.75,+0.41,9.45,35000,12,179550,0,0,0,0,0,0,7000,11000,-4000,-4000
20200430,704875,穩懋中信95購01,0.48,0.48,0.43,0.43,+0.05,13.16,427000,28,193790,0,0,0,0,0,0,387000,121000,266000,266000
20200430,705010,穩懋中信95購02,0.21,0.21,0.21,0.21,+0.01,5.0,30000,1,6300,0,0,0,0,0,0,30000,0,30000,30000
20200430,705174,神盾元大95購01,0.01,0.01,0.01,0.01,-0.01,-50.0,1018000,5,10180,0,0,0,0,0,0,1018000,0,1018000,1018000
20200430,705203,緯軟元大95購01,,,,,,0.00,0,0,0,0,0,0,0,0,0,0,0,0,0
20200430,705503,保瑞國泰98購01,0.34,0.34,0.33,0.33,+0.01,3.12,19000,2,6300,0,0,0,0,0,0,19000,0,19000,19000
20200430,705580,昂寶富邦95購01,,,,,,0.00,0,0,0,0,0,0,0,0,0,0,0,0,0
20200430,705608,威剛元富95購01,,,,,,0.00,0,0,0,0,0,0,0,0,0,0,0,0,0
20200430,705684,建榮統一96購01,,,,,,0.00,0,0,0,0,0,0,0,0,0,0,0,0,0
20200430,705685,建榮統一96購02,,,,,,0.00,0,0,0,0,0,0,0,0,0,0,0,0,0
20200430,705730,群聯元富96購01,,,,,,0.00,0,0,0,0,0,0,0,0,0,0,0,0,0
20200430,705741,富喬統一96購01,,,,,,0.00,0,0,0,0,0,0,0,0,0,0,0,0,0
20200430,705744,宣德元大95購01,,,,,,0.00,0,0,0,0,0,0,0,0,0,0,0,0,0
20200430,705767,環球晶元大95購01,,,,,,0.00,0,0,0,0,0,0,0,0,0,0,0,0,0
20200430,705775,宜鼎群益96購01,,,,,,0.00,0,0,0,0,0,0,0,0,0,0,0,0,0
20200430,705776,原相群益96購01,,,,,,0.00,0,0,0,0,0,0,0,0,0,0,0,0,0
20200430,705781,群聯統一95購01,,,,,,0.00,0,0,0,0,0,0,0,0,0,0,0,0,0
20200430,705788,緯軟元大96購01,,,,,,0.00,0,0,0,0,0,0,0,0,0,0,0,0,0
20200430,705802,金居富邦95購01,,,,,,0.00,0,0,0,0,0,0,0,0,0,0,0,0,0
20200430,705803,原相富邦97購01,,,,,,0.00,0,0,0,0,0,0,0,0,0,0,0,0,0
20200430,705804,晶焱富邦95購01,,,,,,0.00,0,0,0,0,0,0,0,0,0,0,0,0,0
20200430,705805,環球晶富邦97購01,1.10,1.31,1.10,1.31,+0.33,33.67,174000,15,219230,0,0,0,0,0,0,106000,51000,55000,55000
20200430,705846,台燿統一95購01,,,,,,0.00,0,0,0,0,0,0,0,0,0,0,0,0,0
20200430,705847,環球晶統一99購01,2.58,3.00,2.58,3.00,+0.58,23.97,267000,45,746710,0,0,0,0,0,0,110000,250000,-140000,-140000
20200430,705848,禾昌元富96購01,,,,,,0.00,0,0,0,0,0,0,0,0,0,0,0,0,0
20200430,705869,穩懋元大96購01,0.59,0.59,0.50,0.53,+0.09,20.45,150000,18,80970,0,0,0,0,0,0,69000,81000,-12000,-12000
20200430,705901,建榮國票95購02,,,,,,0.00,0,0,0,0,0,0,0,0,0,0,0,0,0
20200430,705904,六角富邦97購01,0.16,0.17,0.16,0.17,+0.08,88.89,23000,4,3790,0,0,0,0,0,0,0,23000,-23000,-23000
20200430,705905,昇達科富邦97購01,,,,,,0.00,0,0,0,0,0,0,0,0,0,0,0,0,0
20200430,705924,大江元富96購01,,,,,,0.00,0,0,0,0,0,0,0,0,0,0,0,0,0
20200430,705937,中美晶元富95購01,1.10,1.10,1.10,1.10,+0.17,18.28,2000,1,2200,0,0,0,0,0,0,2000,0,2000,2000
20200430,705954,網龍國泰95購01,,,,,,0.00,0,0,0,0,0,0,0,0,0,0,0,0,0
20200430,705955,聯亞國泰95購01,,,,,,0.00,0,0,0,0,0,0,0,0,0,0,0,0,0
20200430,705969,皇田國泰95購01,,,,,,0.00,0,0,0,0,0,0,0,0,0,0,0,0,0
20200430,705994,環球晶台新95購01,,,,,,0.00,0,0,0,0,0,0,0,0,0,0,0,0,0
20200430,706003,神盾國票95購01,,,,,,0.00,0,0,0,0,0,0,0,0,0,0,0,0,0
20200430,706005,中美晶元大95購01,1.58,1.69,1.58,1.60,+0.20,14.29,130000,7,214920,0,0,0,0,0,0,0,130000,-130000,-130000
20200430,706023,原相國票95購01,,,,,,0.00,0,0,0,0,0,0,0,0,0,0,0,0,0
20200430,706024,建榮國泰95購02,,,,,,0.00,0,0,0,0,0,0,0,0,0,0,0,0,0
20200430,706025,建榮國泰95購03,,,,,,0.00,0,0,0,0,0,0,0,0,0,0,0,0,0
20200430,706026,雙鴻國泰95購01,0.48,0.48,0.48,0.48,+0.03,6.67,100000,1,48000,0,0,0,0,0,0,100000,0,100000,100000
20200430,706054,穩懋中信95購03,,,,,,0.00,0,0,0,0,0,0,0,0,0,0,0,0,0
20200430,706056,穩懋元富95購01,,,,,,0.00,0,0,0,0,0,0,0,0,0,0,0,0,0
20200430,706108,威剛富邦97購01,0.84,0.86,0.84,0.84,+0.07,9.09,31000,4,26340,0,0,0,0,0,0,1000,30000,-29000,-29000
20200430,706109,雙鴻富邦97購01,0.23,0.23,0.22,0.23,+0.01,4.55,280000,8,64100,0,0,0,0,0,0,40000,230000,-190000,-190000
20200430,706112,原相元大95購01,,,,,,0.00,0,0,0,0,0,0,0,0,0,0,0,0,0
20200430,706130,雙美群益95購01,0.01,0.01,0.01,0.01,-0.02,-66.67,620000,2,6200,0,0,0,0,0,0,620000,0,620000,620000
20200430,706133,鈺太國票95購02,,,,,,0.00,0,0,0,0,0,0,0,0,0,0,0,0,0
20200430,706134,穩懋富邦95購01,,,,,,0.00,0,0,0,0,0,0,0,0,0,0,0,0,0
20200430,706164,博智元大95購01,,,,,,0.00,0,0,0,0,0,0,0,0,0,0,0,0,0
20200430,706167,三貝德國票95購01,,,,,,0.00,0,0,0,0,0,0,0,0,0,0,0,0,0
20200430,706171,鐿鈦國票95購01,,,,,,0.00,0,0,0,0,0,0,0,0,0,0,0,0,0
20200430,706173,神盾國泰95購01,,,,,,0.00,0,0,0,0,0,0,0,0,0,0,0,0,0
20200430,706175,譜瑞國泰95購01,,,,,,0.00,0,0,0,0,0,0,0,0,0,0,0,0,0
20200430,706194,博智國票95購01,,,,,,0.00,0,0,0,0,0,0,0,0,0,0,0,0,0
20200430,706199,昇達科國泰95購01,,,,,,0.00,0,0,0,0,0,0,0,0,0,0,0,0,0
20200430,706200,保瑞國泰95購02,,,,,,0.00,0,0,0,0,0,0,0,0,0,0,0,0,0
20200430,706256,神盾富邦96購01,,,,,,0.00,0,0,0,0,0,0,0,0,0,0,0,0,0
20200430,706262,美琪瑪麥證95購01,,,,,,0.00,0,0,0,0,0,0,0,0,0,0,0,0,0
20200430,706267,合晶元大96購01,0.07,0.08,0.07,0.08,+0.04,100.0,11000,2,780,0,0,0,0,0,0,10000,1000,9000,9000
20200430,706296,穩懋統一96購01,,,,,,0.00,0,0,0,0,0,0,0,0,0,0,0,0,0
20200430,706302,三貝德國票96購01,,,,,,0.00,0,0,0,0,0,0,0,0,0,0,0,0,0
20200430,706312,大學光國泰95購01,,,,,,0.00,0,0,0,0,0,0,0,0,0,0,0,0,0
20200430,706357,網家元富96購01,,,,,,0.00,0,0,0,0,0,0,0,0,0,0,0,0,0
20200430,706360,東洋統一95購01,,,,,,0.00,0,0,0,0,0,0,0,0,0,0,0,0,0
20200430,706369,優群國票95購01,,,,,,0.00,0,0,0,0,0,0,0,0,0,0,0,0,0
20200430,706370,穩懋國票95購01,,,,,,0.00,0,0,0,0,0,0,0,0,0,0,0,0,0
20200430,706371,迅得國泰95購01,,,,,,0.00,0,0,0,0,0,0,0,0,0,0,0,0,0
20200430,706372,新揚科國泰95購01,,,,,,0.00,0,0,0,0,0,0,0,0,0,0,0,0,0
20200430,706373,雙鴻國泰96購01,,,,,,0.00,0,0,0,0,0,0,0,0,0,0,0,0,0
20200430,706374,中美晶富邦95購01,,,,,,0.00,0,0,0,0,0,0,0,0,0,0,0,0,0
20200430,706375,晶焱兆豐95購01,,,,,,0.00,0,0,0,0,0,0,0,0,0,0,0,0,0
20200430,706379,宏觀群益95購01,,,,,,0.00,0,0,0,0,0,0,0,0,0,0,0,0,0
20200430,706383,群聯群益96購01,,,,,,0.00,0,0,0,0,0,0,0,0,0,0,0,0,0
20200430,706385,大學光永豐95購01,2.04,2.04,2.04,2.04,-0.27,-11.69,3000,1,6120,0,0,0,0,0,0,3000,3000,0,0
20200430,706386,迅得永豐95購01,,,,,,0.00,0,0,0,0,0,0,0,0,0,0,0,0,0
20200430,706387,新揚科永豐95購01,,,,,,0.00,0,0,0,0,0,0,0,0,0,0,0,0,0
20200430,706389,金居元富95購01,0.02,0.03,0.02,0.03,0.00,0.0,315000,2,6450,0,0,0,0,0,0,315000,0,315000,315000
20200430,706390,大江元大95購01,,,,,,0.00,0,0,0,0,0,0,0,0,0,0,0,0,0
20200430,706393,昇達科元大96購01,,,,,,0.00,0,0,0,0,0,0,0,0,0,0,0,0,0
20200430,706395,威剛元大95購01,,,,,,0.00,0,0,0,0,0,0,0,0,0,0,0,0,0
20200430,706396,神盾元大95購02,,,,,,0.00,0,0,0,0,0,0,0,0,0,0,0,0,0
20200430,706398,優群元大95購01,,,,,,0.00,0,0,0,0,0,0,0,0,0,0,0,0,0
20200430,706405,原相元富95購01,,,,,,0.00,0,0,0,0,0,0,0,0,0,0,0,0,0
20200430,706408,昂寶元大96購01,,,,,,0.00,0,0,0,0,0,0,0,0,0,0,0,0,0
20200430,706409,金居元大95購01,,,,,,0.00,0,0,0,0,0,0,0,0,0,0,0,0,0
20200430,706410,信昌電元大96購01,,,,,,0.00,0,0,0,0,0,0,0,0,0,0,0,0,0
20200430,706411,保瑞元大95購01,,,,,,0.00,0,0,0,0,0,0,0,0,0,0,0,0,0
20200430,706412,宣德元大95購02,,,,,,0.00,0,0,0,0,0,0,0,0,0,0,0,0,0
20200430,706414,晶焱元大95購01,,,,,,0.00,0,0,0,0,0,0,0,0,0,0,0,0,0
20200430,706415,緯軟元大96購02,0.03,0.03,0.03,0.03,-0.02,-40.0,50000,1,1500,0,0,0,0,0,0,50000,0,50000,50000
20200430,706417,雙鴻元大97購01,0.23,0.23,0.21,0.21,+0.01,5.0,40000,5,8500,0,0,0,0,0,0,0,40000,-40000,-40000
20200430,706419,鈺太元大96購01,,,,,,0.00,0,0,0,0,0,0,0,0,0,0,0,0,0
20200430,706423,宏觀群益96購01,,,,,,0.00,0,0,0,0,0,0,0,0,0,0,0,0,0
20200430,706427,雙鴻群益96購01,,,,,,0.00,0,0,0,0,0,0,0,0,0,0,0,0,0
20200430,706428,鐿鈦群益95購01,,,,,,0.00,0,0,0,0,0,0,0,0,0,0,0,0,0
20200430,706429,宇峻國票95購01,,,,,,0.00,0,0,0,0,0,0,0,0,0,0,0,0,0
20200430,706430,建榮國票96購01,,,,,,0.00,0,0,0,0,0,0,0,0,0,0,0,0,0
20200430,706432,環球晶國票95購01,,,,,,0.00,0,0,0,0,0,0,0,0,0,0,0,0,0
20200430,706434,宏捷科國泰95購01,0.26,0.28,0.26,0.28,-0.05,-15.15,66000,2,18380,0,0,0,0,0,0,66000,0,66000,66000
20200430,706435,保瑞國泰95購03,,,,,,0.00,0,0,0,0,0,0,0,0,0,0,0,0,0
20200430,706436,穩懋富邦96購01,0.65,0.65,0.65,0.65,+0.05,8.33,25000,2,16250,0,0,0,0,0,0,20000,0,20000,20000
20200430,706440,宏捷科永豐95購01,,,,,,0.00,0,0,0,0,0,0,0,0,0,0,0,0,0
20200430,706445,緯軟麥證95購01,,,,,,0.00,0,0,0,0,0,0,0,0,0,0,0,0,0
20200430,706446,雙鴻麥證96購01,0.20,0.20,0.20,0.20,0.00,0.0,20000,1,4000,0,20000,-20000,0,0,0,0,20000,-20000,-20000
20200430,706447,中美晶元富95購02,,,,,,0.00,0,0,0,0,0,0,0,0,0,0,0,0,0
20200430,706448,威剛元富97購01,,,,,,0.00,0,0,0,0,0,0,0,0,0,0,0,0,0
20200430,706453,美琪瑪元大95購01,,,,,,0.00,0,0,0,0,0,0,0,0,0,0,0,0,0
20200430,706456,神盾元大95購03,,,,,,0.00,0,0,0,0,0,0,0,0,0,0,0,0,0
20200430,706458,群聯元大95購03,,,,,,0.00,0,0,0,0,0,0,0,0,0,0,0,0,0
20200430,706461,元太富邦96購01,0.47,0.47,0.47,0.47,+0.01,2.17,61000,4,28670,0,0,0,0,0,0,61000,0,61000,61000
20200430,706462,鐿鈦國票95購02,,,,,,0.00,0,0,0,0,0,0,0,0,0,0,0,0,0
20200430,706475,元太兆豐95購01,,,,,,0.00,0,0,0,0,0,0,0,0,0,0,0,0,0
20200430,706477,雙鴻兆豐95購01,,,,,,0.00,0,0,0,0,0,0,0,0,0,0,0,0,0
20200430,706481,雙鴻群益96購02,,,,,,0.00,0,0,0,0,0,0,0,0,0,0,0,0,0
20200430,706488,雙鴻永豐95購02,,,,,,0.00,0,0,0,0,0,0,0,0,0,0,0,0,0
20200430,706501,網龍永豐95購01,,,,,,0.00,0,0,0,0,0,0,0,0,0,0,0,0,0
20200430,706502,雙鴻永豐95購03,,,,,,0.00,0,0,0,0,0,0,0,0,0,0,0,0,0
20200430,706508,大江兆豐95購01,,,,,,0.00,0,0,0,0,0,0,0,0,0,0,0,0,0
20200430,706511,精華兆豐95購01,,,,,,0.00,0,0,0,0,0,0,0,0,0,0,0,0,0
20200430,706513,金居群益96購01,0.11,0.11,0.11,0.11,+0.03,37.5,19000,1,2090,0,0,0,0,0,0,19000,0,19000,19000
20200430,706516,大田元大96購01,0.19,0.19,0.19,0.19,+0.04,26.67,11000,1,2090,0,0,0,0,0,0,11000,0,11000,11000
20200430,706517,大江元大95購02,,,,,,0.00,0,0,0,0,0,0,0,0,0,0,0,0,0
20200430,706518,杰力元大96購01,0.13,0.13,0.13,0.13,-0.02,-13.33,409000,1,53170,0,0,0,0,0,0,409000,0,409000,409000
20200430,706523,M31國票95購01,,,,,,0.00,0,0,0,0,0,0,0,0,0,0,0,0,0
20200430,706527,晶焱國票95購01,,,,,,0.00,0,0,0,0,0,0,0,0,0,0,0,0,0
20200430,706528,廣明國票95購01,,,,,,0.00,0,0,0,0,0,0,0,0,0,0,0,0,0
20200430,706529,M31國泰96購01,,,,,,0.00,0,0,0,0,0,0,0,0,0,0,0,0,0
20200430,706530,群聯國泰96購01,0.74,0.87,0.74,0.87,+0.19,27.94,20000,2,16100,0,0,0,0,0,0,10000,10000,0,0
20200430,706531,雙鴻國泰96購02,,,,,,0.00,0,0,0,0,0,0,0,0,0,0,0,0,0
20200430,706536,大中元大95購01,,,,,,0.00,0,0,0,0,0,0,0,0,0,0,0,0,0
20200430,706537,元太元大95購01,0.49,0.55,0.49,0.55,-0.01,-1.79,489000,2,250950,0,0,0,0,0,0,189000,300000,-111000,-111000
20200430,706538,宏觀元大95購01,,,,,,0.00,0,0,0,0,0,0,0,0,0,0,0,0,0
20200430,706539,信昌電元大95購01,0.11,0.11,0.09,0.09,+0.01,12.5,280000,3,27200,0,0,0,0,0,0,0,280000,-280000,-280000
20200430,706540,保瑞元大95購02,,,,,,0.00,0,0,0,0,0,0,0,0,0,0,0,0,0
20200430,706541,神盾元大95購05,,,,,,0.00,0,0,0,0,0,0,0,0,0,0,0,0,0
20200430,706542,精華元大95購01,,,,,,0.00,0,0,0,0,0,0,0,0,0,0,0,0,0
20200430,706543,聯亞元大95購01,,,,,,0.00,0,0,0,0,0,0,0,0,0,0,0,0,0
20200430,706544,譜瑞元大95購01,4.25,4.25,4.25,4.25,+0.09,2.16,10000,1,42500,0,0,0,0,0,0,10000,0,10000,10000
20200430,706546,建榮元富95購01,,,,,,0.00,0,0,0,0,0,0,0,0,0,0,0,0,0
20200430,706547,昇達科兆豐95購01,,,,,,0.00,0,0,0,0,0,0,0,0,0,0,0,0,0
20200430,706548,M31國票95購02,,,,,,0.00,0,0,0,0,0,0,0,0,0,0,0,0,0
20200430,706549,大江國票95購01,,,,,,0.00,0,0,0,0,0,0,0,0,0,0,0,0,0
20200430,706550,宏捷科國票95購02,0.02,0.02,0.01,0.01,-0.02,-66.67,62000,3,1220,0,0,0,0,0,0,60000,0,60000,60000
20200430,706551,雙鴻國票95購01,,,,,,0.00,0,0,0,0,0,0,0,0,0,0,0,0,0
20200430,706554,神盾群益96購01,,,,,,0.00,0,0,0,0,0,0,0,0,0,0,0,0,0
20200430,706556,由田富邦96購01,0.11,0.11,0.11,0.11,+0.01,10.0,90000,9,9900,0,0,0,0,0,0,0,90000,-90000,-90000
20200430,706561,雙美永豐95購01,,,,,,0.00,0,0,0,0,0,0,0,0,0,0,0,0,0
20200430,706564,元太群益95購01,,,,,,0.00,0,0,0,0,0,0,0,0,0,0,0,0,0
20200430,706569,金居國票95購01,,,,,,0.00,0,0,0,0,0,0,0,0,0,0,0,0,0
20200430,706570,泰博國票95購02,,,,,,0.00,0,0,0,0,0,0,0,0,0,0,0,0,0
20200430,706572,宏捷科元大95購01,,,,,,0.00,0,0,0,0,0,0,0,0,0,0,0,0,0
20200430,706574,建榮元大97購01,,,,,,0.00,0,0,0,0,0,0,0,0,0,0,0,0,0
20200430,706584,神盾國票95購02,,,,,,0.00,0,0,0,0,0,0,0,0,0,0,0,0,0
20200430,706585,宏捷科國泰95購03,0.04,0.04,0.04,0.04,-0.01,-20.0,667000,7,26680,0,0,0,0,0,0,469000,0,469000,469000
20200430,706586,凡甲統一95購01,,,,,,0.00,0,0,0,0,0,0,0,0,0,0,0,0,0
20200430,706587,凡甲統一95購02,0.90,0.90,0.90,0.90,+0.17,23.29,1000,1,900,0,0,0,0,0,0,0,1000,-1000,-1000
20200430,706588,雙美統一95購01,,,,,,0.00,0,0,0,0,0,0,0,0,0,0,0,0,0
20200430,706596,建榮永豐96購01,,,,,,0.00,0,0,0,0,0,0,0,0,0,0,0,0,0
20200430,706598,碩禾永豐95購01,,,,,,0.00,0,0,0,0,0,0,0,0,0,0,0,0,0
20200430,706602,大江元大96購01,,,,,,0.00,0,0,0,0,0,0,0,0,0,0,0,0,0
20200430,706604,勝麗元大95購01,0.54,0.62,0.54,0.62,+0.10,19.23,144000,7,82200,0,0,0,0,0,0,30000,114000,-84000,-84000
20200430,706607,中美晶兆豐95購02,0.07,0.07,0.07,0.07,+0.01,16.67,3000,1,210,0,0,0,0,0,0,3000,0,3000,3000
20200430,706610,昂寶群益95購01,,,,,,0.00,0,0,0,0,0,0,0,0,0,0,0,0,0
20200430,706612,原相群益97購01,,,,,,0.00,0,0,0,0,0,0,0,0,0,0,0,0,0
20200430,706614,櫃200永昌96購01,,,,,,0.00,0,0,0,0,0,0,0,0,0,0,0,0,0
20200430,706615,櫃200永昌96購02,,,,,,0.00,0,0,0,0,0,0,0,0,0,0,0,0,0
20200430,706616,櫃200永昌96購03,,,,,,0.00,0,0,0,0,0,0,0,0,0,0,0,0,0
20200430,706617,M31中信95購01,,,,,,0.00,0,0,0,0,0,0,0,0,0,0,0,0,0
20200430,706618,原相國泰96購01,,,,,,0.00,0,0,0,0,0,0,0,0,0,0,0,0,0
20200430,706619,環球晶國泰95購01,,,,,,0.00,0,0,0,0,0,0,0,0,0,0,0,0,0
20200430,706624,雙鴻凱基96購01,0.05,0.05,0.05,0.05,0.00,0.0,88000,1,4400,0,0,0,0,0,0,88000,0,88000,88000
20200430,706631,櫃200第一96購01,,,,,,0.00,0,0,0,0,0,0,0,0,0,0,0,0,0
20200430,706633,合晶台新95購01,0.13,0.15,0.13,0.15,+0.04,36.36,105000,2,13750,0,0,0,0,0,0,105000,0,105000,105000
20200430,706642,中美晶元大95購02,0.07,0.07,0.07,0.07,0.00,0.0,5000,1,350,0,0,0,0,0,0,5000,0,5000,5000
20200430,706645,昂寶元大97購01,,,,,,0.00,0,0,0,0,0,0,0,0,0,0,0,0,0
20200430,706646,昇達科元大96購02,,,,,,0.00,0,0,0,0,0,0,0,0,0,0,0,0,0
20200430,706647,金居元大95購02,0.12,0.16,0.12,0.16,+0.06,60.0,79000,5,12090,0,0,0,0,0,0,74000,0,74000,74000
20200430,706651,雙美元大96購01,,,,,,0.00,0,0,0,0,0,0,0,0,0,0,0,0,0
20200430,706653,環球晶麥證95購01,,,,,,0.00,0,0,0,0,0,0,0,0,0,0,0,0,0
20200430,706656,緯軟兆豐95購02,,,,,,0.00,0,0,0,0,0,0,0,0,0,0,0,0,0
20200430,706657,環球晶兆豐95購02,,,,,,0.00,0,0,0,0,0,0,0,0,0,0,0,0,0
20200430,706658,穩懋兆豐95購01,,,,,,0.00,0,0,0,0,0,0,0,0,0,0,0,0,0
20200430,706659,中美晶台新95購01,,,,,,0.00,0,0,0,0,0,0,0,0,0,0,0,0,0
20200430,706666,雙鴻群益95購02,,,,,,0.00,0,0,0,0,0,0,0,0,0,0,0,0,0
20200430,706668,昂寶元大96購02,,,,,,0.00,0,0,0,0,0,0,0,0,0,0,0,0,0
20200430,706690,環球晶富邦98購01,0.43,0.52,0.42,0.52,+0.13,33.33,214000,19,101890,0,0,0,0,0,0,133000,81000,52000,52000
20200430,706698,大學光永豐95購02,,,,,,0.00,0,0,0,0,0,0,0,0,0,0,0,0,0
20200430,706703,信昌電兆豐95購01,,,,,,0.00,0,0,0,0,0,0,0,0,0,0,0,0,0
20200430,706704,保瑞兆豐95購01,,,,,,0.00,0,0,0,0,0,0,0,0,0,0,0,0,0
20200430,706705,建榮兆豐95購01,,,,,,0.00,0,0,0,0,0,0,0,0,0,0,0,0,0
20200430,706726,M31元大96購01,,,,,,0.00,0,0,0,0,0,0,0,0,0,0,0,0,0
20200430,706731,良維元大97購01,,,,,,0.00,0,0,0,0,0,0,0,0,0,0,0,0,0
20200430,706733,神盾元大96購01,,,,,,0.00,0,0,0,0,0,0,0,0,0,0,0,0,0
20200430,706739,新鉅科國泰95購01,,,,,,0.00,0,0,0,0,0,0,0,0,0,0,0,0,0
20200430,706740,新鉅科國泰95購02,,,,,,0.00,0,0,0,0,0,0,0,0,0,0,0,0,0
20200430,706741,精華國泰95購01,,,,,,0.00,0,0,0,0,0,0,0,0,0,0,0,0,0
20200430,706742,群聯富邦95購01,,,,,,0.00,0,0,0,0,0,0,0,0,0,0,0,0,0
20200430,706747,安勤統一95購01,,,,,,0.00,0,0,0,0,0,0,0,0,0,0,0,0,0
20200430,706748,安勤統一95購02,,,,,,0.00,0,0,0,0,0,0,0,0,0,0,0,0,0
20200430,706751,同致國票95購01,,,,,,0.00,0,0,0,0,0,0,0,0,0,0,0,0,0
20200430,706752,波若威國票95購01,0.01,0.01,0.01,0.01,-0.01,-50.0,100000,1,1000,0,0,0,0,0,0,100000,0,100000,100000
20200430,706754,碩禾台新96購01,0.02,0.02,0.02,0.02,-0.08,-80.0,10000,1,200,0,0,0,0,0,0,0,10000,-10000,-10000
20200430,706758,六角國泰96購01,0.43,0.49,0.42,0.49,+0.09,22.5,96000,5,42780,0,0,0,0,0,0,42000,96000,-54000,-54000
20200430,706759,雙美國泰95購01,,,,,,0.00,0,0,0,0,0,0,0,0,0,0,0,0,0
20200430,706760,鈺太國泰95購01,1.18,1.19,1.06,1.06,-0.11,-9.4,35000,16,39530,0,0,0,0,0,0,35000,0,35000,35000
20200430,706761,鐿鈦國泰96購01,,,,,,0.00,0,0,0,0,0,0,0,0,0,0,0,0,0
20200430,706762,大江兆豐95購02,0.01,0.01,0.01,0.01,0.00,0.0,19000,2,190,0,0,0,0,0,0,0,10000,-10000,-10000
20200430,706763,勝麗兆豐95購01,,,,,,0.00,0,0,0,0,0,0,0,0,0,0,0,0,0
20200430,706765,六角元大96購01,0.55,0.55,0.55,0.55,+0.05,10.0,2000,1,1100,0,0,0,0,0,0,2000,0,2000,2000
20200430,706767,群聯元大95購04,,,,,,0.00,0,0,0,0,0,0,0,0,0,0,0,0,0
20200430,706769,環球晶元大95購02,,,,,,0.00,0,0,0,0,0,0,0,0,0,0,0,0,0
20200430,706773,優群群益95購01,7.95,7.95,7.95,7.95,-0.90,-10.17,5000,1,39750,0,0,0,0,0,0,5000,0,5000,5000
20200430,706774,雙美群益96購01,,,,,,0.00,0,0,0,0,0,0,0,0,0,0,0,0,0
20200430,706787,博智國票95購02,,,,,,0.00,0,0,0,0,0,0,0,0,0,0,0,0,0
20200430,706788,大學光國泰96購01,,,,,,0.00,0,0,0,0,0,0,0,0,0,0,0,0,0
20200430,706792,威剛元大96購01,1.35,1.35,1.35,1.35,+0.08,6.3,5000,1,6750,0,0,0,0,0,0,0,0,0,0
20200430,706796,鈺太元大96購02,0.85,0.85,0.85,0.85,+0.05,6.25,10000,1,8500,0,0,0,0,0,0,10000,0,10000,10000
20200430,706800,原相元大96購01,,,,,,0.00,0,0,0,0,0,0,0,0,0,0,0,0,0
20200430,706803,環球晶中信97購01,0.14,0.19,0.14,0.19,+0.05,35.71,993000,20,160490,0,0,0,0,0,0,883000,110000,773000,773000
20200430,706804,由田國泰96購01,,,,,,0.00,0,0,0,0,0,0,0,0,0,0,0,0,0
20200430,706809,神盾元富95購01,,,,,,0.00,0,0,0,0,0,0,0,0,0,0,0,0,0
20200430,706811,環球晶元富95購03,,,,,,0.00,0,0,0,0,0,0,0,0,0,0,0,0,0
20200430,706821,雙鴻永豐95購04,,,,,,0.00,0,0,0,0,0,0,0,0,0,0,0,0,0
20200430,706822,立端群益95購01,,,,,,0.00,0,0,0,0,0,0,0,0,0,0,0,0,0
20200430,706825,穩懋統一96購02,0.09,0.09,0.09,0.09,-0.07,-43.75,90000,1,8100,0,0,0,0,0,0,90000,0,90000,90000
20200430,706830,迅得元大95購01,,,,,,0.00,0,0,0,0,0,0,0,0,0,0,0,0,0
20200430,706833,鈺太元大96購03,,,,,,0.00,0,0,0,0,0,0,0,0,0,0,0,0,0
20200430,706840,良維國票95購01,,,,,,0.00,0,0,0,0,0,0,0,0,0,0,0,0,0
20200430,706841,保瑞國票95購01,,,,,,0.00,0,0,0,0,0,0,0,0,0,0,0,0,0
20200430,706843,碩禾國票95購01,,,,,,0.00,0,0,0,0,0,0,0,0,0,0,0,0,0
20200430,706844,新鉅科富邦98購01,,,,,,0.00,0,0,0,0,0,0,0,0,0,0,0,0,0
20200430,706853,神盾元富95購02,,,,,,0.00,0,0,0,0,0,0,0,0,0,0,0,0,0
20200430,706855,原相兆豐95購02,,,,,,0.00,0,0,0,0,0,0,0,0,0,0,0,0,0
20200430,706856,環球晶兆豐95購04,0.12,0.17,0.12,0.17,+0.05,41.67,237000,9,38810,0,0,0,0,0,0,47000,190000,-143000,-143000
20200430,706858,由田群益96購01,,,,,,0.00,0,0,0,0,0,0,0,0,0,0,0,0,0
20200430,706866,凡甲國票95購01,0.43,0.43,0.41,0.42,-0.03,-6.67,13000,4,5450,0,0,0,0,0,0,1000,12000,-11000,-11000
20200430,706867,中美晶國票95購01,0.94,1.07,0.94,1.07,+0.13,13.83,92000,4,94070,0,0,0,0,0,0,19000,73000,-54000,-54000
20200430,706868,神盾國票96購01,0.01,0.01,0.01,0.01,0.00,0.0,250000,1,2500,0,0,0,0,0,0,0,0,0,0
20200430,706869,環球晶國票95購02,,,,,,0.00,0,0,0,0,0,0,0,0,0,0,0,0,0
20200430,706870,原相群益97購02,,,,,,0.00,0,0,0,0,0,0,0,0,0,0,0,0,0
20200430,706872,波若威永豐95購01,,,,,,0.00,0,0,0,0,0,0,0,0,0,0,0,0,0
20200430,706876,大宇資元大96購01,,,,,,0.00,0,0,0,0,0,0,0,0,0,0,0,0,0
20200430,706877,合晶元大95購01,0.12,0.14,0.12,0.14,+0.03,27.27,13000,2,1720,0,0,0,0,0,0,13000,0,13000,13000
20200430,706879,信昌電元大95購02,0.55,0.55,0.55,0.55,+0.14,34.15,10000,1,5500,0,0,0,0,0,0,10000,0,10000,10000
20200430,706882,緯軟元大96購03,,,,,,0.00,0,0,0,0,0,0,0,0,0,0,0,0,0
20200430,706884,環球晶元大95購03,1.28,1.32,1.28,1.32,+0.23,21.1,3000,2,3920,0,0,0,0,0,0,3000,0,3000,3000
20200430,706889,雙鴻元富96購01,,,,,,0.00,0,0,0,0,0,0,0,0,0,0,0,0,0
20200430,706890,信驊凱基95購01,,,,,,0.00,0,0,0,0,0,0,0,0,0,0,0,0,0
20200430,706892,網家凱基95購01,,,,,,0.00,0,0,0,0,0,0,0,0,0,0,0,0,0
20200430,706894,M31元大95購01,,,,,,0.00,0,0,0,0,0,0,0,0,0,0,0,0,0
20200430,706898,勝麗元大95購02,0.74,0.74,0.74,0.74,+0.05,7.25,100000,1,74000,0,0,0,0,0,0,0,100000,-100000,-100000
20200430,706899,閎康元大95購01,,,,,,0.00,0,0,0,0,0,0,0,0,0,0,0,0,0
20200430,706902,迅得永豐95購02,,,,,,0.00,0,0,0,0,0,0,0,0,0,0,0,0,0
20200430,706906,大學光國票96購01,,,,,,0.00,0,0,0,0,0,0,0,0,0,0,0,0,0
20200430,706907,合晶國票95購01,,,,,,0.00,0,0,0,0,0,0,0,0,0,0,0,0,0
20200430,706908,皇田國票95購01,,,,,,0.00,0,0,0,0,0,0,0,0,0,0,0,0,0
20200430,706910,閎康國票95購01,0.44,0.45,0.43,0.43,-0.13,-23.21,73000,3,32070,0,0,0,0,0,0,73000,0,73000,73000
20200430,706912,鐿鈦國票96購01,0.69,0.69,0.69,0.69,+0.08,13.11,25000,1,17250,0,0,0,0,0,0,0,25000,-25000,-25000
20200430,706916,M31元大96購02,,,,,,0.00,0,0,0,0,0,0,0,0,0,0,0,0,0
20200430,706918,大學光元大96購01,1.32,1.34,1.32,1.34,-0.06,-4.29,11000,2,14720,0,0,0,0,0,0,1000,11000,-10000,-10000
20200430,706919,良維元大96購01,0.19,0.19,0.16,0.16,-0.01,-5.88,51000,2,8190,0,0,0,0,0,0,51000,0,51000,51000
20200430,706920,宣德元大96購01,,,,,,0.00,0,0,0,0,0,0,0,0,0,0,0,0,0
20200430,706923,聚積元大96購01,,,,,,0.00,0,0,0,0,0,0,0,0,0,0,0,0,0
20200430,706928,大學光永豐96購01,0.87,0.87,0.81,0.81,-0.10,-10.99,207000,8,173680,0,0,0,0,0,0,207000,0,207000,207000
20200430,706933,神盾中信97購01,0.02,0.02,0.02,0.02,-0.02,-50.0,20000,2,400,0,0,0,0,0,0,0,20000,-20000,-20000
20200430,706934,環宇中信97購01,,,,,,0.00,0,0,0,0,0,0,0,0,0,0,0,0,0
20200430,706935,VHQ凱基96購01,,,,,,0.00,0,0,0,0,0,0,0,0,0,0,0,0,0
20200430,706936,台燿凱基96購01,1.06,1.06,1.01,1.05,+0.28,36.36,50000,3,52400,0,0,0,0,0,0,40000,10000,30000,30000
20200430,706937,宜鼎凱基96購01,2.78,2.95,2.78,2.95,+0.21,7.66,50000,6,143340,0,0,0,0,0,0,30000,20000,10000,10000
20200430,706940,穩懋凱基96購01,,,,,,0.00,0,0,0,0,0,0,0,0,0,0,0,0,0
20200430,706941,譜瑞凱基96購01,,,,,,0.00,0,0,0,0,0,0,0,0,0,0,0,0,0
20200430,706942,大中國票96購01,,,,,,0.00,0,0,0,0,0,0,0,0,0,0,0,0,0
20200430,706945,碩禾國票96購01,,,,,,0.00,0,0,0,0,0,0,0,0,0,0,0,0,0
20200430,706946,環球晶國票96購01,,,,,,0.00,0,0,0,0,0,0,0,0,0,0,0,0,0
20200430,706947,大田國泰96購01,,,,,,0.00,0,0,0,0,0,0,0,0,0,0,0,0,0
20200430,706950,雙鴻富邦96購01,,,,,,0.00,0,0,0,0,0,0,0,0,0,0,0,0,0
20200430,706952,新鉅科元富96購01,,,,,,0.00,0,0,0,0,0,0,0,0,0,0,0,0,0
20200430,706956,原相群益96購03,,,,,,0.00,0,0,0,0,0,0,0,0,0,0,0,0,0
20200430,706960,雙鴻元大96購01,0.02,0.02,0.02,0.02,-0.01,-33.33,30000,1,600,0,0,0,0,0,0,0,0,0,0
20200430,706961,金可中信96購01,0.02,0.05,0.02,0.05,+0.01,25.0,1089000,7,37350,0,0,0,0,0,0,1069000,20000,1049000,1049000
20200430,706962,勝麗中信97購01,0.25,0.25,0.25,0.25,+0.02,8.7,20000,1,5000,0,0,0,0,0,0,20000,0,20000,20000
20200430,706963,群聯中信97購01,0.35,0.35,0.25,0.31,+0.06,24.0,21000,5,6100,0,0,0,0,0,0,10000,21000,-11000,-11000
20200430,706965,群聯統一96購01,1.87,1.87,1.83,1.86,+0.20,12.05,213000,12,393980,0,0,0,0,0,0,63000,150000,-87000,-87000
20200430,706966,三貝德凱基96購01,,,,,,0.00,0,0,0,0,0,0,0,0,0,0,0,0,0
20200430,706969,信驊凱基96購01,,,,,,0.00,0,0,0,0,0,0,0,0,0,0,0,0,0
20200430,706970,茂達凱基96購01,,,,,,0.00,0,0,0,0,0,0,0,0,0,0,0,0,0
20200430,706973,穩懋凱基96購02,,,,,,0.00,0,0,0,0,0,0,0,0,0,0,0,0,0
20200430,706974,穩懋富邦96購03,0.02,0.03,0.02,0.03,0.00,0.0,132000,4,2740,0,0,0,0,0,0,0,0,0,0
20200430,706975,穩懋富邦96購04,,,,,,0.00,0,0,0,0,0,0,0,0,0,0,0,0,0
20200430,706976,大江國泰96購01,,,,,,0.00,0,0,0,0,0,0,0,0,0,0,0,0,0
20200430,706977,神盾國泰96購01,,,,,,0.00,0,0,0,0,0,0,0,0,0,0,0,0,0
20200430,706984,合晶國票96購01,0.55,0.55,0.55,0.55,+0.09,19.57,60000,3,33000,0,0,0,0,0,0,0,60000,-60000,-60000
20200430,706985,建榮國票96購02,,,,,,0.00,0,0,0,0,0,0,0,0,0,0,0,0,0
20200430,706986,網家國票96購01,,,,,,0.00,0,0,0,0,0,0,0,0,0,0,0,0,0
20200430,706990,中美晶中信97購01,0.49,0.54,0.48,0.54,+0.06,12.5,346000,10,170060,0,0,0,0,0,0,267000,79000,188000,188000
20200430,706991,弘塑中信97購01,0.58,0.74,0.56,0.73,+0.19,35.19,1271000,27,761880,0,0,0,0,0,0,960000,311000,649000,649000
20200430,706992,神盾中信96購01,,,,,,0.00,0,0,0,0,0,0,0,0,0,0,0,0,0
20200430,706993,環球晶中信96購01,0.13,0.17,0.13,0.17,+0.07,70.0,39000,4,5860,0,0,0,0,0,0,19000,20000,-1000,-1000
20200430,706995,弘塑統一96購01,,,,,,0.00,0,0,0,0,0,0,0,0,0,0,0,0,0
20200430,706996,群聯統一96購02,,,,,,0.00,0,0,0,0,0,0,0,0,0,0,0,0,0
20200430,707000,台燿凱基96購02,0.43,0.45,0.39,0.39,+0.10,34.48,30000,11,12620,0,0,0,0,0,0,10000,20000,-10000,-10000
20200430,707003,神盾凱基96購01,,,,,,0.00,0,0,0,0,0,0,0,0,0,0,0,0,0
20200430,707013,良維兆豐96購01,,,,,,0.00,0,0,0,0,0,0,0,0,0,0,0,0,0
20200430,707018,合晶元大96購02,0.27,0.27,0.27,0.27,+0.06,28.57,13000,1,3510,0,0,0,0,0,0,13000,0,13000,13000
20200430,707019,金居元大96購01,,,,,,0.00,0,0,0,0,0,0,0,0,0,0,0,0,0
20200430,707020,信昌電元大96購02,,,,,,0.00,0,0,0,0,0,0,0,0,0,0,0,0,0
20200430,707024,由田國票96購01,0.13,0.13,0.13,0.13,-0.01,-7.14,40000,1,5200,0,0,0,0,0,0,40000,0,40000,40000
20200430,707025,杰力國票96購01,,,,,,0.00,0,0,0,0,0,0,0,0,0,0,0,0,0
20200430,707026,晶焱國票96購01,,,,,,0.00,0,0,0,0,0,0,0,0,0,0,0,0,0
20200430,707027,網龍國票96購01,,,,,,0.00,0,0,0,0,0,0,0,0,0,0,0,0,0
20200430,707029,大宇資國泰97購01,,,,,,0.00,0,0,0,0,0,0,0,0,0,0,0,0,0
20200430,707030,建榮國泰97購01,,,,,,0.00,0,0,0,0,0,0,0,0,0,0,0,0,0
20200430,707038,譜瑞富邦97購01,1.19,1.19,1.19,1.19,+0.06,5.31,10000,2,11900,0,0,0,0,0,0,10000,0,10000,10000
20200430,707046,大宇資元大97購01,,,,,,0.00,0,0,0,0,0,0,0,0,0,0,0,0,0
20200430,707048,昇達科元大96購03,,,,,,0.00,0,0,0,0,0,0,0,0,0,0,0,0,0
20200430,707049,杰力元大96購02,,,,,,0.00,0,0,0,0,0,0,0,0,0,0,0,0,0
20200430,707050,信昌電元大96購03,,,,,,0.00,0,0,0,0,0,0,0,0,0,0,0,0,0
20200430,707051,神盾元大97購01,,,,,,0.00,0,0,0,0,0,0,0,0,0,0,0,0,0
20200430,707053,群聯元大96購01,,,,,,0.00,0,0,0,0,0,0,0,0,0,0,0,0,0
20200430,707054,合晶國泰97購01,0.64,0.66,0.64,0.66,+0.09,15.79,100000,2,65000,0,0,0,0,0,0,0,100000,-100000,-100000
20200430,707055,大江國票96購01,,,,,,0.00,0,0,0,0,0,0,0,0,0,0,0,0,0
20200430,707056,台半國票96購01,,,,,,0.00,0,0,0,0,0,0,0,0,0,0,0,0,0
20200430,707061,聯亞國票96購01,1.67,1.67,1.37,1.37,-0.24,-14.91,254000,10,379850,0,0,0,0,0,0,174000,80000,94000,94000
20200430,707063,中美晶兆豐96購01,,,,,,0.00,0,0,0,0,0,0,0,0,0,0,0,0,0
20200430,707065,新普群益97購01,1.69,1.76,1.69,1.74,+0.04,2.35,49000,4,85160,0,0,0,0,0,0,34000,49000,-15000,-15000
20200430,707074,昂寶永豐96購01,,,,,,0.00,0,0,0,0,0,0,0,0,0,0,0,0,0
20200430,707075,廣明永豐96購01,,,,,,0.00,0,0,0,0,0,0,0,0,0,0,0,0,0
20200430,707076,東洋中信95購01,,,,,,0.00,0,0,0,0,0,0,0,0,0,0,0,0,0
20200430,707077,精華中信97購01,,,,,,0.00,0,0,0,0,0,0,0,0,0,0,0,0,0
20200430,707078,環宇中信97購02,,,,,,0.00,0,0,0,0,0,0,0,0,0,0,0,0,0
20200430,707079,晟德中信97購01,0.02,0.03,0.02,0.03,0.00,0.0,30000,3,700,0,0,0,0,0,0,0,20000,-20000,-20000
20200430,707080,弘塑統一98購01,0.42,0.55,0.40,0.53,+0.10,23.26,228000,11,106400,0,0,0,0,0,0,165000,0,165000,165000
20200430,707081,世界凱基95購01,,,,,,0.00,0,0,0,0,0,0,0,0,0,0,0,0,0
20200430,707082,環球晶凱基95購04,,,,,,0.00,0,0,0,0,0,0,0,0,0,0,0,0,0
20200430,707083,大江元大96購02,,,,,,0.00,0,0,0,0,0,0,0,0,0,0,0,0,0
20200430,707084,原相元大97購01,,,,,,0.00,0,0,0,0,0,0,0,0,0,0,0,0,0
20200430,707085,群聯元大96購02,0.92,0.92,0.92,0.92,+0.12,15.0,10000,1,9200,0,0,0,0,0,0,10000,0,10000,10000
20200430,707086,網龍元大95購01,,,,,,0.00,0,0,0,0,0,0,0,0,0,0,0,0,0
20200430,707087,環宇元大95購01,,,,,,0.00,0,0,0,0,0,0,0,0,0,0,0,0,0
20200430,707088,兆利永豐95購01,,,,,,0.00,0,0,0,0,0,0,0,0,0,0,0,0,0
20200430,707089,亞泰永豐95購01,,,,,,0.00,0,0,0,0,0,0,0,0,0,0,0,0,0
20200430,707090,順達永豐95購01,,,,,,0.00,0,0,0,0,0,0,0,0,0,0,0,0,0
20200430,707091,緯軟永豐95購01,,,,,,0.00,0,0,0,0,0,0,0,0,0,0,0,0,0
20200430,707092,環宇永豐95購02,,,,,,0.00,0,0,0,0,0,0,0,0,0,0,0,0,0
20200430,707093,廣明國泰96購01,,,,,,0.00,0,0,0,0,0,0,0,0,0,0,0,0,0
20200430,707094,中美晶國票96購01,0.95,0.95,0.95,0.95,+0.03,3.26,28000,1,26600,0,0,0,0,0,0,0,28000,-28000,-28000
20200430,707095,宜鼎國票96購01,4.27,4.68,4.27,4.68,+0.66,16.42,24000,9,104760,0,0,0,0,0,0,20000,4000,16000,16000
20200430,707096,環宇國票95購01,,,,,,0.00,0,0,0,0,0,0,0,0,0,0,0,0,0
20200430,707097,穩懋國票96購02,0.12,0.12,0.10,0.10,+0.01,11.11,59000,4,6300,0,0,0,0,0,0,39000,20000,19000,19000
20200430,707098,台燿兆豐96購01,0.77,0.77,0.68,0.77,+0.19,32.76,219000,12,157110,0,0,0,0,0,0,115000,94000,21000,21000
20200430,707099,穩懋兆豐96購01,0.24,0.24,0.23,0.23,+0.04,21.05,60000,4,14300,0,0,0,0,0,0,50000,10000,40000,40000
20200430,707100,台半群益95購01,,,,,,0.00,0,0,0,0,0,0,0,0,0,0,0,0,0
20200430,707101,合晶群益95購01,,,,,,0.00,0,0,0,0,0,0,0,0,0,0,0,0,0
20200430,707102,原相群益96購04,,,,,,0.00,0,0,0,0,0,0,0,0,0,0,0,0,0
20200430,707103,合晶元富95購01,,,,,,0.00,0,0,0,0,0,0,0,0,0,0,0,0,0
20200430,707104,六角兆豐96購01,0.23,0.26,0.23,0.25,+0.04,19.05,53000,4,12930,0,0,0,0,0,0,50000,3000,47000,47000
20200430,707105,弘塑台新95購01,,,,,,0.00,0,0,0,0,0,0,0,0,0,0,0,0,0
20200430,707106,原相台新97購01,,,,,,0.00,0,0,0,0,0,0,0,0,0,0,0,0,0
20200430,707107,聯亞台新95購01,,,,,,0.00,0,0,0,0,0,0,0,0,0,0,0,0,0
20200430,707108,新普群益97購02,1.47,1.47,1.47,1.47,+0.06,4.26,11000,1,16170,0,0,0,0,0,0,11000,0,11000,11000
20200430,707109,環宇群益97購01,,,,,,0.00,0,0,0,0,0,0,0,0,0,0,0,0,0
20200430,707110,環球晶群益95購01,,,,,,0.00,0,0,0,0,0,0,0,0,0,0,0,0,0
20200430,707111,元太元大95購02,,,,,,0.00,0,0,0,0,0,0,0,0,0,0,0,0,0
20200430,707112,台燿元大95購01,0.46,0.46,0.46,0.46,+0.18,64.29,15000,1,6900,0,0,0,0,0,0,15000,0,15000,15000
20200430,707113,金居元大96購02,0.09,0.09,0.09,0.09,+0.04,80.0,10000,1,900,0,0,0,0,0,0,10000,0,10000,10000
20200430,707114,建榮元大96購01,,,,,,0.00,0,0,0,0,0,0,0,0,0,0,0,0,0
20200430,707115,神準元大95購01,,,,,,0.00,0,0,0,0,0,0,0,0,0,0,0,0,0
20200430,707116,環宇元大95購02,,,,,,0.00,0,0,0,0,0,0,0,0,0,0,0,0,0
20200430,707117,聯亞元大96購01,,,,,,0.00,0,0,0,0,0,0,0,0,0,0,0,0,0
20200430,707118,穩懋元大95購02,,,,,,0.00,0,0,0,0,0,0,0,0,0,0,0,0,0
20200430,707119,群聯凱基95購01,,,,,,0.00,0,0,0,0,0,0,0,0,0,0,0,0,0
20200430,707120,環球晶凱基95購06,,,,,,0.00,0,0,0,0,0,0,0,0,0,0,0,0,0
20200430,707121,大江國票97購01,,,,,,0.00,0,0,0,0,0,0,0,0,0,0,0,0,0
20200430,707122,昂寶國票96購01,,,,,,0.00,0,0,0,0,0,0,0,0,0,0,0,0,0
20200430,707123,保瑞國票96購01,,,,,,0.00,0,0,0,0,0,0,0,0,0,0,0,0,0
20200430,707124,環宇國泰96購01,,,,,,0.00,0,0,0,0,0,0,0,0,0,0,0,0,0
20200430,707125,環球晶國泰96購01,,,,,,0.00,0,0,0,0,0,0,0,0,0,0,0,0,0
20200430,707126,久元永豐95購01,,,,,,0.00,0,0,0,0,0,0,0,0,0,0,0,0,0
20200430,707127,弘塑永豐95購02,,,,,,0.00,0,0,0,0,0,0,0,0,0,0,0,0,0
20200430,707128,神準永豐95購01,,,,,,0.00,0,0,0,0,0,0,0,0,0,0,0,0,0
20200430,707129,穩懋永豐95購02,0.01,0.01,0.01,0.01,0.00,0.0,10000,10,100,0,0,0,0,0,0,0,10000,-10000,-10000
20200430,707130,合晶元富95購02,,,,,,0.00,0,0,0,0,0,0,0,0,0,0,0,0,0
20200430,707131,金居台新95購01,,,,,,0.00,0,0,0,0,0,0,0,0,0,0,0,0,0
20200430,707132,晟德國泰96購01,,,,,,0.00,0,0,0,0,0,0,0,0,0,0,0,0,0
20200430,707133,中光電群益96購01,,,,,,0.00,0,0,0,0,0,0,0,0,0,0,0,0,0
20200430,707134,元太群益96購01,,,,,,0.00,0,0,0,0,0,0,0,0,0,0,0,0,0
20200430,707135,原相群益97購03,,,,,,0.00,0,0,0,0,0,0,0,0,0,0,0,0,0
20200430,707136,群聯群益97購01,0.21,0.21,0.21,0.21,+0.02,10.53,1000,1,210,0,0,0,0,0,0,1000,0,1000,1000
20200430,707137,VHQ永豐95購01,,,,,,0.00,0,0,0,0,0,0,0,0,0,0,0,0,0
20200430,707138,大宇資永豐95購01,,,,,,0.00,0,0,0,0,0,0,0,0,0,0,0,0,0
20200430,707139,台星科永豐95購01,,,,,,0.00,0,0,0,0,0,0,0,0,0,0,0,0,0
20200430,707140,立端永豐95購01,,,,,,0.00,0,0,0,0,0,0,0,0,0,0,0,0,0
20200430,707141,合晶永豐95購02,,,,,,0.00,0,0,0,0,0,0,0,0,0,0,0,0,0
20200430,707142,直得永豐95購01,0.29,0.29,0.21,0.21,+0.08,61.54,20000,2,4440,0,0,0,0,0,0,20000,0,20000,20000
20200430,707143,精華永豐95購01,,,,,,0.00,0,0,0,0,0,0,0,0,0,0,0,0,0
20200430,707144,璟德永豐95購01,,,,,,0.00,0,0,0,0,0,0,0,0,0,0,0,0,0
20200430,707145,環球晶永豐95購01,,,,,,0.00,0,0,0,0,0,0,0,0,0,0,0,0,0
20200430,707146,群聯凱基95購02,,,,,,0.00,0,0,0,0,0,0,0,0,0,0,0,0,0
20200430,707147,大江元大96購03,,,,,,0.00,0,0,0,0,0,0,0,0,0,0,0,0,0
20200430,707148,金可元大95購01,,,,,,0.00,0,0,0,0,0,0,0,0,0,0,0,0,0
20200430,707149,群聯元大96購03,,,,,,0.00,0,0,0,0,0,0,0,0,0,0,0,0,0
20200430,707150,網家元大95購01,,,,,,0.00,0,0,0,0,0,0,0,0,0,0,0,0,0
20200430,707151,環球晶元大95購04,,,,,,0.00,0,0,0,0,0,0,0,0,0,0,0,0,0
20200430,707152,環球晶元大95購05,,,,,,0.00,0,0,0,0,0,0,0,0,0,0,0,0,0
20200430,707153,櫃200元大95購01,,,,,,0.00,0,0,0,0,0,0,0,0,0,0,0,0,0
20200430,707154,雙鴻元大97購02,0.09,0.09,0.09,0.09,+0.01,12.5,5000,1,450,0,0,0,0,0,0,5000,0,5000,5000
20200430,707155,大宇資元富95購01,,,,,,0.00,0,0,0,0,0,0,0,0,0,0,0,0,0
20200430,707156,昂寶元富95購01,,,,,,0.00,0,0,0,0,0,0,0,0,0,0,0,0,0
20200430,707157,同致兆豐96購01,0.03,0.03,0.03,0.03,0.00,0.0,340000,31,10200,0,0,0,0,0,0,40000,300000,-260000,-260000
20200430,707158,威剛兆豐96購01,,,,,,0.00,0,0,0,0,0,0,0,0,0,0,0,0,0
20200430,707159,網龍兆豐96購01,0.16,0.16,0.14,0.14,-0.01,-6.67,160000,4,22600,0,0,0,0,0,0,150000,10000,140000,140000
20200430,707160,環球晶群益95購02,,,,,,0.00,0,0,0,0,0,0,0,0,0,0,0,0,0
20200430,707161,元太國票96購01,0.23,0.24,0.23,0.24,-0.04,-14.29,25000,2,5800,0,0,0,0,0,0,25000,0,25000,25000
20200430,707162,旺矽國票96購01,1.25,1.54,1.25,1.45,+0.19,15.08,217000,9,300490,0,0,0,0,0,0,40000,177000,-137000,-137000
20200430,707163,信昌電國票96購01,1.46,1.65,1.46,1.62,+0.33,25.58,30000,4,46220,0,0,0,0,0,0,0,30000,-30000,-30000
20200430,707164,宣德國票96購01,0.57,0.64,0.57,0.64,+0.02,3.23,28000,2,17010,0,0,0,0,0,0,13000,15000,-2000,-2000
20200430,707165,聚積國票96購01,,,,,,0.00,0,0,0,0,0,0,0,0,0,0,0,0,0
20200430,707166,譜瑞國票96購01,1.01,1.01,1.01,1.01,+0.09,9.78,17000,1,17170,0,0,0,0,0,0,17000,0,17000,17000
20200430,707167,中美晶國泰96購01,0.65,0.65,0.65,0.65,+0.11,20.37,3000,1,1950,0,0,0,0,0,0,3000,0,3000,3000
20200430,707168,群聯國泰97購01,0.64,0.69,0.64,0.69,+0.20,40.82,24000,3,16460,0,0,0,0,0,0,24000,0,24000,24000
20200430,707169,群聯富邦96購01,,,,,,0.00,0,0,0,0,0,0,0,0,0,0,0,0,0
20200430,707170,環宇富邦97購01,,,,,,0.00,0,0,0,0,0,0,0,0,0,0,0,0,0
20200430,707171,弘塑中信99購01,0.38,0.47,0.37,0.45,+0.09,25.0,1109000,25,435580,0,0,0,0,0,0,993000,116000,877000,877000
20200430,707172,環球晶中信99購01,0.17,0.21,0.17,0.21,+0.02,10.53,193000,12,37830,0,0,0,0,0,0,70000,20000,50000,50000
20200430,707173,鈺太中信96購01,0.20,0.21,0.18,0.21,0.00,0.0,75000,29,15160,0,0,0,0,0,0,65000,10000,55000,55000
20200430,707174,凡甲凱基96購01,0.57,0.57,0.57,0.57,-0.05,-8.06,20000,1,11400,0,0,0,0,0,0,0,20000,-20000,-20000
20200430,707175,大江凱基96購01,,,,,,0.00,0,0,0,0,0,0,0,0,0,0,0,0,0
20200430,707176,中美晶凱基95購02,,,,,,0.00,0,0,0,0,0,0,0,0,0,0,0,0,0
20200430,707177,合晶凱基95購02,,,,,,0.00,0,0,0,0,0,0,0,0,0,0,0,0,0
20200430,707178,威剛凱基97購01,0.30,0.30,0.30,0.30,0.00,0.0,128000,1,38400,0,0,0,0,0,0,128000,0,128000,128000
20200430,707179,神盾凱基95購01,,,,,,0.00,0,0,0,0,0,0,0,0,0,0,0,0,0
20200430,707180,新鉅科凱基95購01,,,,,,0.00,0,0,0,0,0,0,0,0,0,0,0,0,0
20200430,707181,由田永豐95購01,,,,,,0.00,0,0,0,0,0,0,0,0,0,0,0,0,0
20200430,707182,同致永豐95購01,,,,,,0.00,0,0,0,0,0,0,0,0,0,0,0,0,0
20200430,707183,良維永豐95購02,0.01,0.01,0.01,0.01,0.00,0.0,40000,1,400,0,0,0,0,0,0,40000,0,40000,40000
20200430,707184,昇達科永豐95購01,,,,,,0.00,0,0,0,0,0,0,0,0,0,0,0,0,0
20200430,707185,杰力永豐95購01,,,,,,0.00,0,0,0,0,0,0,0,0,0,0,0,0,0
20200430,707186,金可永豐95購01,,,,,,0.00,0,0,0,0,0,0,0,0,0,0,0,0,0
20200430,707187,中美晶元大95購04,,,,,,0.00,0,0,0,0,0,0,0,0,0,0,0,0,0
20200430,707188,六角元大95購01,,,,,,0.00,0,0,0,0,0,0,0,0,0,0,0,0,0
20200430,707189,美琪瑪元大96購01,,,,,,0.00,0,0,0,0,0,0,0,0,0,0,0,0,0
20200430,707190,神盾元大96購02,0.06,0.06,0.06,0.06,0.00,0.0,100000,1,6000,0,0,0,0,0,0,100000,0,100000,100000
20200430,707191,穩懋元大95購04,,,,,,0.00,0,0,0,0,0,0,0,0,0,0,0,0,0
20200430,707192,穩懋元大95購06,,,,,,0.00,0,0,0,0,0,0,0,0,0,0,0,0,0
20200430,707193,穩懋元大95購07,,,,,,0.00,0,0,0,0,0,0,0,0,0,0,0,0,0
20200430,707194,廣明兆豐95購01,0.08,0.08,0.08,0.08,-0.13,-61.9,100000,1,8000,0,0,0,0,0,0,100000,0,100000,100000
20200430,707195,弘塑群益95購01,0.28,0.28,0.28,0.28,+0.06,27.27,5000,1,1400,0,0,0,0,0,0,5000,0,5000,5000
20200430,707196,閎康群益96購01,0.71,0.71,0.71,0.71,-0.06,-7.79,50000,1,35500,0,0,0,0,0,0,50000,0,50000,50000
20200430,707197,順達群益96購01,0.79,0.79,0.76,0.77,-0.07,-8.33,167000,4,128430,0,0,0,0,0,0,162000,5000,157000,157000
20200430,707198,VHQ國票96購01,,,,,,0.00,0,0,0,0,0,0,0,0,0,0,0,0,0
20200430,707199,新鉅科國票95購01,,,,,,0.00,0,0,0,0,0,0,0,0,0,0,0,0,0
20200430,707200,網龍國票97購01,0.65,0.65,0.64,0.65,-0.09,-12.16,11000,5,7130,0,0,0,0,0,0,11000,0,11000,11000
20200430,707201,環球晶國票96購02,,,,,,0.00,0,0,0,0,0,0,0,0,0,0,0,0,0
20200430,707202,聯亞國票96購02,1.85,1.85,1.85,1.85,+0.22,13.5,18000,1,33300,0,0,0,0,0,0,18000,0,18000,18000
20200430,707203,晟德國票95購01,,,,,,0.00,0,0,0,0,0,0,0,0,0,0,0,0,0
20200430,707204,弘塑麥證95購01,,,,,,0.00,0,0,0,0,0,0,0,0,0,0,0,0,0
20200430,707205,大田元大95購02,,,,,,0.00,0,0,0,0,0,0,0,0,0,0,0,0,0
20200430,707206,六角元大95購02,,,,,,0.00,0,0,0,0,0,0,0,0,0,0,0,0,0
20200430,707207,宇峻元大97購01,0.66,0.66,0.66,0.66,-0.02,-2.94,70000,1,46200,0,0,0,0,0,0,0,0,0,0
20200430,707208,東洋元大95購01,,,,,,0.00,0,0,0,0,0,0,0,0,0,0,0,0,0
20200430,707209,環球晶元大95購06,0.70,0.88,0.70,0.87,+0.19,27.94,380000,8,293900,0,0,0,0,0,0,100000,280000,-180000,-180000
20200430,707210,聯亞元大95購03,,,,,,0.00,0,0,0,0,0,0,0,0,0,0,0,0,0
20200430,707211,晟德元大95購02,,,,,,0.00,0,0,0,0,0,0,0,0,0,0,0,0,0
20200430,707212,鈺太元大95購01,0.46,0.49,0.42,0.42,-0.01,-2.33,200000,3,91500,0,0,0,0,0,0,200000,0,200000,200000
20200430,707213,順達統一97購01,0.94,1.15,0.94,1.15,+0.13,12.75,4000,4,4160,0,0,0,0,0,0,3000,1000,2000,2000
20200430,707214,六角永豐95購01,,,,,,0.00,0,0,0,0,0,0,0,0,0,0,0,0,0
20200430,707215,晶焱永豐95購01,,,,,,0.00,0,0,0,0,0,0,0,0,0,0,0,0,0
20200430,707216,順達永豐95購02,,,,,,0.00,0,0,0,0,0,0,0,0,0,0,0,0,0
20200430,707217,聯亞永豐95購01,,,,,,0.00,0,0,0,0,0,0,0,0,0,0,0,0,0
20200430,707218,鐿鈦永豐95購01,,,,,,0.00,0,0,0,0,0,0,0,0,0,0,0,0,0
20200430,707219,弘塑凱基95購01,0.02,0.02,0.02,0.02,+0.01,100.0,2000,1,40,0,0,0,0,0,0,2000,0,2000,2000
20200430,707220,合晶凱基95購03,,,,,,0.00,0,0,0,0,0,0,0,0,0,0,0,0,0
20200430,707221,原相凱基95購02,,,,,,0.00,0,0,0,0,0,0,0,0,0,0,0,0,0
20200430,707222,群聯凱基95購03,,,,,,0.00,0,0,0,0,0,0,0,0,0,0,0,0,0
20200430,707223,緯軟凱基95購01,,,,,,0.00,0,0,0,0,0,0,0,0,0,0,0,0,0
20200430,707224,環球晶凱基95購09,,,,,,0.00,0,0,0,0,0,0,0,0,0,0,0,0,0
20200430,707225,中美晶元富95購06,,,,,,0.00,0,0,0,0,0,0,0,0,0,0,0,0,0
20200430,707226,精華元富95購01,,,,,,0.00,0,0,0,0,0,0,0,0,0,0,0,0,0
20200430,707227,環球晶元富95購05,0.04,0.05,0.04,0.05,0.00,0.0,50000,3,2300,0,0,0,0,0,0,20000,0,20000,20000
20200430,707228,穩懋元富95購05,,,,,,0.00,0,0,0,0,0,0,0,0,0,0,0,0,0
20200430,707229,穩懋元富95購06,0.01,0.01,0.01,0.01,0.00,0.0,58000,2,580,0,0,0,0,0,0,0,0,0,0
20200430,707230,M31台新95購01,,,,,,0.00,0,0,0,0,0,0,0,0,0,0,0,0,0
20200430,707231,大宇資康和95購01,,,,,,0.00,0,0,0,0,0,0,0,0,0,0,0,0,0
20200430,707232,大學光群益95購01,,,,,,0.00,0,0,0,0,0,0,0,0,0,0,0,0,0
20200430,707233,迅得群益97購01,0.92,0.92,0.81,0.91,+0.04,4.6,25000,3,22300,0,0,0,0,0,0,25000,0,25000,25000
20200430,707234,勝麗群益95購01,,,,,,0.00,0,0,0,0,0,0,0,0,0,0,0,0,0
20200430,707235,群聯群益96購02,0.28,0.28,0.28,0.28,+0.06,27.27,50000,1,14000,0,0,0,0,0,0,50000,0,50000,50000
20200430,707236,聚積群益97購01,,,,,,0.00,0,0,0,0,0,0,0,0,0,0,0,0,0
20200430,707237,雙美麥證95購01,,,,,,0.00,0,0,0,0,0,0,0,0,0,0,0,0,0
20200430,707238,合晶元富95購03,,,,,,0.00,0,0,0,0,0,0,0,0,0,0,0,0,0
20200430,707239,金可元富95購01,,,,,,0.00,0,0,0,0,0,0,0,0,0,0,0,0,0
20200430,707240,昂寶國票97購01,,,,,,0.00,0,0,0,0,0,0,0,0,0,0,0,0,0
20200430,707241,昇達科國票96購01,,,,,,0.00,0,0,0,0,0,0,0,0,0,0,0,0,0
20200430,707242,信驊國票96購01,,,,,,0.00,0,0,0,0,0,0,0,0,0,0,0,0,0
20200430,707243,新普國票96購01,,,,,,0.00,0,0,0,0,0,0,0,0,0,0,0,0,0
20200430,707244,精華國票96購01,,,,,,0.00,0,0,0,0,0,0,0,0,0,0,0,0,0
20200430,707245,大江元大95購04,,,,,,0.00,0,0,0,0,0,0,0,0,0,0,0,0,0
20200430,707246,弘塑元大96購01,0.58,0.65,0.58,0.65,+0.17,35.42,15000,2,9400,0,0,0,0,0,0,15000,0,15000,15000
20200430,707247,安勤元大95購01,0.02,0.03,0.02,0.03,-0.01,-25.0,67000,2,1640,0,0,0,0,0,0,67000,0,67000,67000
20200430,707248,建榮元大96購02,,,,,,0.00,0,0,0,0,0,0,0,0,0,0,0,0,0
20200430,707249,群聯元大95購06,,,,,,0.00,0,0,0,0,0,0,0,0,0,0,0,0,0
20200430,707250,環球晶元大95購07,0.90,1.26,0.90,1.26,+0.33,35.48,61000,5,60890,0,0,0,0,0,0,11000,50000,-39000,-39000
20200430,707251,環球晶元大95購08,,,,,,0.00,0,0,0,0,0,0,0,0,0,0,0,0,0
20200430,707252,鐿鈦元大96購01,,,,,,0.00,0,0,0,0,0,0,0,0,0,0,0,0,0
20200430,707253,穩懋亞東96購02,,,,,,0.00,0,0,0,0,0,0,0,0,0,0,0,0,0
20200430,707254,同致中信97購01,,,,,,0.00,0,0,0,0,0,0,0,0,0,0,0,0,0
20200430,707255,環球晶凱基95購10,,,,,,0.00,0,0,0,0,0,0,0,0,0,0,0,0,0
20200430,707256,環球晶凱基95購11,,,,,,0.00,0,0,0,0,0,0,0,0,0,0,0,0,0
20200430,707257,兆利永豐95購02,,,,,,0.00,0,0,0,0,0,0,0,0,0,0,0,0,0
20200430,707258,信昌電永豐95購01,0.35,0.45,0.35,0.41,+0.12,41.38,170000,9,71600,0,0,0,0,0,0,0,170000,-170000,-170000
20200430,707259,信驊永豐95購01,0.62,0.62,0.62,0.62,+0.14,29.17,13000,2,8060,0,0,0,0,0,0,10000,3000,7000,7000
20200430,707260,新揚科永豐95購02,,,,,,0.00,0,0,0,0,0,0,0,0,0,0,0,0,0
20200430,707261,新普永豐95購01,0.01,0.01,0.01,0.01,0.00,0.0,60000,1,600,0,0,0,0,0,0,60000,0,60000,60000
20200430,707262,大宇資凱基97購01,,,,,,0.00,0,0,0,0,0,0,0,0,0,0,0,0,0
20200430,707263,神盾凱基96購02,0.23,0.23,0.23,0.23,+0.09,64.29,1000,1,230,0,0,0,0,0,0,0,1000,-1000,-1000
20200430,707264,網家凱基95購02,,,,,,0.00,0,0,0,0,0,0,0,0,0,0,0,0,0
20200430,707265,環球晶凱基95購12,,,,,,0.00,0,0,0,0,0,0,0,0,0,0,0,0,0
20200430,707266,宇峻永豐95購01,,,,,,0.00,0,0,0,0,0,0,0,0,0,0,0,0,0
20200430,707267,邦特永豐95購01,,,,,,0.00,0,0,0,0,0,0,0,0,0,0,0,0,0
20200430,707268,皇田永豐95購01,,,,,,0.00,0,0,0,0,0,0,0,0,0,0,0,0,0
20200430,707269,原相永豐95購02,1.16,1.16,1.16,1.16,+0.05,4.5,14000,2,16240,0,0,0,0,0,0,4000,10000,-6000,-6000
20200430,707270,神盾永豐95購01,,,,,,0.00,0,0,0,0,0,0,0,0,0,0,0,0,0
20200430,707271,勝麗永豐95購01,,,,,,0.00,0,0,0,0,0,0,0,0,0,0,0,0,0
20200430,707272,廣明永豐95購01,0.24,0.24,0.24,0.24,-0.18,-42.86,8000,1,1920,0,0,0,0,0,0,8000,0,8000,8000
20200430,707273,環球晶永豐95購02,,,,,,0.00,0,0,0,0,0,0,0,0,0,0,0,0,0
20200430,707274,雙鴻永豐95購05,,,,,,0.00,0,0,0,0,0,0,0,0,0,0,0,0,0
20200430,707275,元太元大96購01,0.83,0.83,0.77,0.83,+0.04,5.06,316000,11,252350,0,0,0,0,0,0,198000,213000,-15000,-15000
20200430,707276,皇田元大95購01,,,,,,0.00,0,0,0,0,0,0,0,0,0,0,0,0,0
20200430,707277,神盾元大97購02,0.16,0.16,0.16,0.16,-0.01,-5.88,110000,3,17600,0,0,0,0,0,0,110000,0,110000,110000
20200430,707278,勝麗元大96購01,0.63,0.71,0.63,0.71,+0.15,26.79,195000,5,130050,0,0,0,0,0,0,0,195000,-195000,-195000
20200430,707279,新鉅科元大95購01,,,,,,0.00,0,0,0,0,0,0,0,0,0,0,0,0,0
20200430,707280,碩禾元大96購01,0.10,0.10,0.10,0.10,-0.09,-47.37,50000,1,5000,0,0,0,0,0,0,50000,0,50000,50000
20200430,707281,精華元大95購02,,,,,,0.00,0,0,0,0,0,0,0,0,0,0,0,0,0
20200430,707282,環球晶元大95購09,1.12,1.26,1.12,1.26,+0.39,44.83,103000,4,127440,0,0,0,0,0,0,0,103000,-103000,-103000
20200430,707283,環球晶元大95購10,0.88,1.09,0.88,1.09,+0.28,34.57,64000,4,66340,0,0,0,0,0,0,0,64000,-64000,-64000
20200430,707284,晟德元大95購03,,,,,,0.00,0,0,0,0,0,0,0,0,0,0,0,0,0
20200430,707285,弘塑國泰97購01,0.85,1.12,0.85,1.12,+0.29,34.94,42000,10,41350,0,0,0,0,0,0,34000,0,34000,34000
20200430,707286,信昌電富邦95購01,,,,,,0.00,0,0,0,0,0,0,0,0,0,0,0,0,0
20200430,707287,同致國票96購01,,,,,,0.00,0,0,0,0,0,0,0,0,0,0,0,0,0
20200430,707288,良維國票97購01,,,,,,0.00,0,0,0,0,0,0,0,0,0,0,0,0,0
20200430,707289,緯軟國票97購01,,,,,,0.00,0,0,0,0,0,0,0,0,0,0,0,0,0
20200430,707290,優群國票96購01,,,,,,0.00,0,0,0,0,0,0,0,0,0,0,0,0,0
20200430,707291,元太兆豐95購02,,,,,,0.00,0,0,0,0,0,0,0,0,0,0,0,0,0
20200430,707292,金可兆豐95購02,,,,,,0.00,0,0,0,0,0,0,0,0,0,0,0,0,0
20200430,707293,泰博兆豐96購01,,,,,,0.00,0,0,0,0,0,0,0,0,0,0,0,0,0
20200430,707294,VHQ群益96購01,,,,,,0.00,0,0,0,0,0,0,0,0,0,0,0,0,0
20200430,707295,邦特群益95購01,,,,,,0.00,0,0,0,0,0,0,0,0,0,0,0,0,0
20200430,707296,鈺太群益95購01,,,,,,0.00,0,0,0,0,0,0,0,0,0,0,0,0,0
20200430,707297,台燿凱基96購03,0.66,0.66,0.61,0.61,+0.10,19.61,31000,4,19460,0,0,0,0,0,0,11000,20000,-9000,-9000
20200430,707298,晶焱凱基95購01,,,,,,0.00,0,0,0,0,0,0,0,0,0,0,0,0,0
20200430,707299,緯軟中信95購01,,,,,,0.00,0,0,0,0,0,0,0,0,0,0,0,0,0
20200430,707300,雙鴻麥證95購01,0.01,0.01,0.01,0.01,0.00,0.0,140000,3,1400,140000,0,140000,0,0,0,140000,0,140000,140000
20200430,707301,中美晶元富95購07,,,,,,0.00,0,0,0,0,0,0,0,0,0,0,0,0,0
20200430,707302,原相亞東96購01,,,,,,0.00,0,0,0,0,0,0,0,0,0,0,0,0,0
20200430,707303,群聯亞東95購01,,,,,,0.00,0,0,0,0,0,0,0,0,0,0,0,0,0
20200430,707304,杰力永豐95購02,,,,,,0.00,0,0,0,0,0,0,0,0,0,0,0,0,0
20200430,707305,波若威永豐95購02,,,,,,0.00,0,0,0,0,0,0,0,0,0,0,0,0,0
20200430,707306,保瑞永豐95購01,,,,,,0.00,0,0,0,0,0,0,0,0,0,0,0,0,0
20200430,707307,智崴永豐95購01,,,,,,0.00,0,0,0,0,0,0,0,0,0,0,0,0,0
20200430,707308,聯亞永豐95購02,,,,,,0.00,0,0,0,0,0,0,0,0,0,0,0,0,0
20200430,707309,合晶國票96購02,0.71,0.86,0.70,0.83,+0.21,33.87,234000,8,178580,0,0,0,0,0,0,94000,190000,-96000,-96000
20200430,707310,原相國票96購01,6.05,6.05,6.05,6.05,-0.05,-0.82,35000,1,211750,0,0,0,0,0,0,35000,0,35000,35000
20200430,707311,昂寶國泰96購01,,,,,,0.00,0,0,0,0,0,0,0,0,0,0,0,0,0
20200430,707312,宣德兆豐95購01,0.41,0.42,0.41,0.42,-0.08,-16.0,20000,6,8260,0,0,0,0,0,0,20000,0,20000,20000
20200430,707313,智崴群益95購01,,,,,,0.00,0,0,0,0,0,0,0,0,0,0,0,0,0
20200430,707314,廣明群益95購01,,,,,,0.00,0,0,0,0,0,0,0,0,0,0,0,0,0
20200430,707315,大江元大96購04,,,,,,0.00,0,0,0,0,0,0,0,0,0,0,0,0,0
20200430,707316,同致元大96購01,,,,,,0.00,0,0,0,0,0,0,0,0,0,0,0,0,0
20200430,707317,良維元大95購02,,,,,,0.00,0,0,0,0,0,0,0,0,0,0,0,0,0
20200430,707318,金可元大95購02,,,,,,0.00,0,0,0,0,0,0,0,0,0,0,0,0,0
20200430,707319,信驊元大95購01,3.02,3.02,3.02,3.02,+0.34,12.69,2000,1,6040,0,0,0,0,0,0,2000,0,2000,2000
20200430,707320,智崴元大95購01,,,,,,0.00,0,0,0,0,0,0,0,0,0,0,0,0,0
20200430,707321,智崴元大95購02,,,,,,0.00,0,0,0,0,0,0,0,0,0,0,0,0,0
20200430,707322,新普元大95購01,,,,,,0.00,0,0,0,0,0,0,0,0,0,0,0,0,0
20200430,707323,環宇元大96購01,0.13,0.13,0.13,0.13,0.00,0.0,60000,4,7800,0,0,0,0,0,0,0,40000,-40000,-40000
20200430,707324,櫃200永昌96購04,,,,,,0.00,0,0,0,0,0,0,0,0,0,0,0,0,0
20200430,707325,M31中信96購01,,,,,,0.00,0,0,0,0,0,0,0,0,0,0,0,0,0
20200430,707326,穩懋中信97購01,0.77,0.77,0.77,0.77,+0.12,18.46,50000,1,38500,0,0,0,0,0,0,50000,0,50000,50000
20200430,707327,鐿鈦中信95購01,,,,,,0.00,0,0,0,0,0,0,0,0,0,0,0,0,0
20200430,707328,中美晶凱基96購01,,,,,,0.00,0,0,0,0,0,0,0,0,0,0,0,0,0
20200430,707329,環球晶凱基95購13,,,,,,0.00,0,0,0,0,0,0,0,0,0,0,0,0,0
20200430,707330,原相第一95購01,,,,,,0.00,0,0,0,0,0,0,0,0,0,0,0,0,0
20200430,707331,中美晶永豐95購03,,,,,,0.00,0,0,0,0,0,0,0,0,0,0,0,0,0
20200430,707332,亞泰永豐95購02,,,,,,0.00,0,0,0,0,0,0,0,0,0,0,0,0,0
20200430,707333,大江國票96購04,,,,,,0.00,0,0,0,0,0,0,0,0,0,0,0,0,0
20200430,707334,合晶國票97購01,,,,,,0.00,0,0,0,0,0,0,0,0,0,0,0,0,0
20200430,707335,勝麗國票97購01,0.67,0.77,0.67,0.77,+0.15,24.19,105000,8,71670,0,0,0,0,0,0,0,105000,-105000,-105000
20200430,707336,群聯國票96購01,1.65,1.74,1.65,1.74,+0.25,16.78,60000,4,101700,0,0,0,0,0,0,30000,30000,0,0
20200430,707337,網龍國票97購02,0.65,0.67,0.58,0.59,-0.09,-13.24,348000,23,211200,0,0,0,0,0,0,166000,172000,-6000,-6000
20200430,707338,環球晶國票96購03,1.71,1.99,1.67,1.99,+0.43,27.56,323000,11,621630,0,0,0,0,0,0,33000,290000,-257000,-257000
20200430,707339,晟德國票97購01,0.76,0.76,0.71,0.71,-0.02,-2.74,5000,4,3700,0,0,0,0,0,0,3000,2000,1000,1000
20200430,707340,神盾國泰97購01,,,,,,0.00,0,0,0,0,0,0,0,0,0,0,0,0,0
20200430,707341,博智國泰97購01,,,,,,0.00,0,0,0,0,0,0,0,0,0,0,0,0,0
20200430,707342,原相富邦99購01,,,,,,0.00,0,0,0,0,0,0,0,0,0,0,0,0,0
20200430,707343,聯亞兆豐96購01,1.36,1.37,1.15,1.21,-0.12,-9.02,196000,16,265020,0,0,0,0,0,0,196000,0,196000,196000
20200430,707344,杰力群益95購01,,,,,,0.00,0,0,0,0,0,0,0,0,0,0,0,0,0
20200430,707345,宣德群益96購01,,,,,,0.00,0,0,0,0,0,0,0,0,0,0,0,0,0
20200430,707346,皇田群益97購01,,,,,,0.00,0,0,0,0,0,0,0,0,0,0,0,0,0
20200430,707347,金居元大96購03,0.30,0.32,0.30,0.32,+0.12,60.0,230000,4,72000,0,0,0,0,0,0,150000,0,150000,150000
20200430,707348,保瑞元大96購01,,,,,,0.00,0,0,0,0,0,0,0,0,0,0,0,0,0
20200430,707349,茂達元大96購01,,,,,,0.00,0,0,0,0,0,0,0,0,0,0,0,0,0
20200430,707350,優群元大96購01,,,,,,0.00,0,0,0,0,0,0,0,0,0,0,0,0,0
20200430,707351,環球晶元大96購01,1.57,1.81,1.57,1.81,+0.31,20.67,60000,8,95770,0,0,0,0,0,0,8000,52000,-44000,-44000
20200430,707352,櫃200元大96購03,,,,,,0.00,0,0,0,0,0,0,0,0,0,0,0,0,0
20200430,707353,櫃200元大96購04,,,,,,0.00,0,0,0,0,0,0,0,0,0,0,0,0,0
20200430,707354,昇達科中信97購01,0.10,0.11,0.09,0.11,+0.01,10.0,50000,3,5000,0,0,0,0,0,0,20000,30000,-10000,-10000
20200430,707355,群聯凱基95購04,,,,,,0.00,0,0,0,0,0,0,0,0,0,0,0,0,0
20200430,707356,精華凱基95購01,,,,,,0.00,0,0,0,0,0,0,0,0,0,0,0,0,0
20200430,707357,大江國票97購02,,,,,,0.00,0,0,0,0,0,0,0,0,0,0,0,0,0
20200430,707358,昂寶永豐95購01,,,,,,0.00,0,0,0,0,0,0,0,0,0,0,0,0,0
20200430,707359,宣德永豐95購01,0.38,0.40,0.38,0.39,-0.02,-4.88,60000,11,23250,0,0,0,0,0,0,60000,0,60000,60000
20200430,707360,環球晶永豐95購03,,,,,,0.00,0,0,0,0,0,0,0,0,0,0,0,0,0
20200430,707361,元太元大96購02,0.49,0.49,0.49,0.49,-0.02,-3.92,1000,1,490,0,0,0,0,0,0,1000,0,1000,1000
20200430,707362,兆利元大95購01,,,,,,0.00,0,0,0,0,0,0,0,0,0,0,0,0,0
20200430,707363,合晶元大96購03,0.64,0.74,0.64,0.74,+0.15,25.42,894000,9,597410,0,0,0,0,0,0,0,894000,-894000,-894000
20200430,707364,邦特元大95購01,,,,,,0.00,0,0,0,0,0,0,0,0,0,0,0,0,0
20200430,707365,群聯元大97購01,0.21,0.21,0.21,0.21,-0.01,-4.55,40000,1,8400,0,0,0,0,0,0,40000,0,40000,40000
20200430,707366,廣明元大96購01,0.42,0.43,0.42,0.42,+0.03,7.69,60000,7,25250,0,0,0,0,0,0,0,60000,-60000,-60000
20200430,707367,環球晶元大95購12,1.84,2.11,1.84,2.08,+0.11,5.58,149000,13,303670,0,0,0,0,0,0,42000,107000,-65000,-65000
20200430,707368,茂達永豐96購01,,,,,,0.00,0,0,0,0,0,0,0,0,0,0,0,0,0
20200430,707369,原相永豐95購03,0.34,0.34,0.34,0.34,-0.03,-8.11,30000,2,10200,0,0,0,0,0,0,0,30000,-30000,-30000
20200430,707370,杰力國票96購02,,,,,,0.00,0,0,0,0,0,0,0,0,0,0,0,0,0
20200430,707371,大江富邦97購01,0.08,0.08,0.08,0.08,+0.02,33.33,150000,3,12000,0,0,0,0,0,0,0,0,0,0
20200430,707372,原相凱基96購01,0.70,0.70,0.70,0.70,-0.14,-16.67,10000,1,7000,0,0,0,0,0,0,10000,0,10000,10000
20200430,707373,新普凱基95購01,,,,,,0.00,0,0,0,0,0,0,0,0,0,0,0,0,0
20200430,707374,緯軟凱基95購02,,,,,,0.00,0,0,0,0,0,0,0,0,0,0,0,0,0
20200430,707375,聯亞凱基95購01,,,,,,0.00,0,0,0,0,0,0,0,0,0,0,0,0,0
20200430,707376,雙鴻凱基96購03,,,,,,0.00,0,0,0,0,0,0,0,0,0,0,0,0,0
20200430,707377,群聯麥證95購01,,,,,,0.00,0,0,0,0,0,0,0,0,0,0,0,0,0
20200430,707378,原相元富95購02,,,,,,0.00,0,0,0,0,0,0,0,0,0,0,0,0,0
20200430,707379,優群元富95購01,,,,,,0.00,0,0,0,0,0,0,0,0,0,0,0,0,0
20200430,707380,環球晶元富95購06,0.67,0.73,0.67,0.73,-0.03,-3.95,111000,3,76070,0,0,0,0,0,0,68000,43000,25000,25000
20200430,707381,兆利台新95購01,,,,,,0.00,0,0,0,0,0,0,0,0,0,0,0,0,0
20200430,707382,僑威台新95購01,,,,,,0.00,0,0,0,0,0,0,0,0,0,0,0,0,0
20200430,707383,先豐元大95購01,,,,,,0.00,0,0,0,0,0,0,0,0,0,0,0,0,0
20200430,707384,皇田元大95購02,,,,,,0.00,0,0,0,0,0,0,0,0,0,0,0,0,0
20200430,707385,晶焱元大96購01,1.11,1.13,1.04,1.13,+0.07,6.6,590000,20,646430,0,0,0,0,0,0,390000,322000,68000,68000
20200430,707386,僑威元大95購01,,,,,,0.00,0,0,0,0,0,0,0,0,0,0,0,0,0
20200430,707387,網龍元大95購02,,,,,,0.00,0,0,0,0,0,0,0,0,0,0,0,0,0
20200430,707388,鐿鈦元大95購01,,,,,,0.00,0,0,0,0,0,0,0,0,0,0,0,0,0
20200430,707389,業強康和95購01,,,,,,0.00,0,0,0,0,0,0,0,0,0,0,0,0,0
20200430,707390,環球晶元富95購07,0.87,1.11,0.86,1.11,+0.15,15.62,328000,7,324530,0,0,0,0,0,0,11000,317000,-306000,-306000
20200430,707391,順達台新95購01,,,,,,0.00,0,0,0,0,0,0,0,0,0,0,0,0,0
20200430,707392,大江凱基95購01,,,,,,0.00,0,0,0,0,0,0,0,0,0,0,0,0,0
20200430,707393,同致凱基95購01,,,,,,0.00,0,0,0,0,0,0,0,0,0,0,0,0,0
20200430,707394,聯亞凱基95購02,,,,,,0.00,0,0,0,0,0,0,0,0,0,0,0,0,0
20200430,707395,大宇資群益97購01,,,,,,0.00,0,0,0,0,0,0,0,0,0,0,0,0,0
20200430,707396,亞泰群益95購01,,,,,,0.00,0,0,0,0,0,0,0,0,0,0,0,0,0
20200430,707397,聯亞群益95購01,,,,,,0.00,0,0,0,0,0,0,0,0,0,0,0,0,0
20200430,707398,亞泰元大95購01,,,,,,0.00,0,0,0,0,0,0,0,0,0,0,0,0,0
20200430,707399,信驊元大95購02,,,,,,0.00,0,0,0,0,0,0,0,0,0,0,0,0,0
20200430,707400,威剛元大96購02,,,,,,0.00,0,0,0,0,0,0,0,0,0,0,0,0,0
20200430,707401,聯亞元大95購04,2.04,2.04,1.68,1.68,-0.26,-13.4,118000,9,219320,0,0,0,0,0,0,58000,62000,-4000,-4000
20200430,707402,大宇資永豐96購01,,,,,,0.00,0,0,0,0,0,0,0,0,0,0,0,0,0
20200430,707403,旺矽永豐96購01,,,,,,0.00,0,0,0,0,0,0,0,0,0,0,0,0,0
20200430,707404,信驊永豐95購02,0.41,0.44,0.41,0.44,+0.09,25.71,39000,3,16890,0,0,0,0,0,0,39000,0,39000,39000
20200430,707405,優群永豐96購01,,,,,,0.00,0,0,0,0,0,0,0,0,0,0,0,0,0
20200430,707406,M31國票96購01,,,,,,0.00,0,0,0,0,0,0,0,0,0,0,0,0,0
20200430,707407,中美晶國票96購03,,,,,,0.00,0,0,0,0,0,0,0,0,0,0,0,0,0
20200430,707408,兆利國票96購01,0.66,0.66,0.60,0.60,0.00,0.0,71000,2,44580,0,0,0,0,0,0,71000,0,71000,71000
20200430,707409,環球晶國票95購03,,,,,,0.00,0,0,0,0,0,0,0,0,0,0,0,0,0
20200430,707410,雙美國票96購01,,,,,,0.00,0,0,0,0,0,0,0,0,0,0,0,0,0
20200430,707411,金居富邦95購02,0.09,0.13,0.09,0.13,+0.09,225.0,13000,2,1290,0,0,0,0,0,0,13000,0,13000,13000
20200430,707412,櫃200富邦95購01,,,,,,0.00,0,0,0,0,0,0,0,0,0,0,0,0,0
20200430,707413,櫃200富邦95購02,,,,,,0.00,0,0,0,0,0,0,0,0,0,0,0,0,0
20200430,707414,櫃200富邦95購03,,,,,,0.00,0,0,0,0,0,0,0,0,0,0,0,0,0
20200430,707415,櫃200T永昌96購01,,,,,,0.00,0,0,0,0,0,0,0,0,0,0,0,0,0
20200430,707416,櫃200T永昌96購02,,,,,,0.00,0,0,0,0,0,0,0,0,0,0,0,0,0
20200430,707417,櫃200T永昌96購03,,,,,,0.00,0,0,0,0,0,0,0,0,0,0,0,0,0
20200430,707418,櫃200T永昌96購04,,,,,,0.00,0,0,0,0,0,0,0,0,0,0,0,0,0
20200430,707419,台燿凱基95購01,,,,,,0.00,0,0,0,0,0,0,0,0,0,0,0,0,0
20200430,707420,信驊凱基95購02,,,,,,0.00,0,0,0,0,0,0,0,0,0,0,0,0,0
20200430,707421,緯軟凱基96購01,,,,,,0.00,0,0,0,0,0,0,0,0,0,0,0,0,0
20200430,707422,櫃200凱基99購01,,,,,,0.00,0,0,0,0,0,0,0,0,0,0,0,0,0
20200430,707423,三貝德國票96購02,,,,,,0.00,0,0,0,0,0,0,0,0,0,0,0,0,0
20200430,707424,大學光國票96購02,,,,,,0.00,0,0,0,0,0,0,0,0,0,0,0,0,0
20200430,707425,台燿國票96購01,1.28,1.31,1.28,1.31,+0.33,33.67,78000,3,101250,0,0,0,0,0,0,78000,0,78000,78000
20200430,707426,穩懋國票96購03,0.39,0.39,0.39,0.39,+0.04,11.43,30000,1,11700,0,0,0,0,0,0,0,30000,-30000,-30000
20200430,707427,新普國泰96購01,1.66,1.70,1.61,1.69,+0.15,9.74,307000,14,507330,0,0,0,0,0,0,247000,99000,148000,148000
20200430,707428,譜瑞國泰97購01,2.53,2.62,2.42,2.56,+0.08,3.23,90000,7,225650,0,0,0,0,0,0,86000,63000,23000,23000
20200430,707429,信驊元富95購01,,,,,,0.00,0,0,0,0,0,0,0,0,0,0,0,0,0
20200430,707430,信驊元富95購02,,,,,,0.00,0,0,0,0,0,0,0,0,0,0,0,0,0
20200430,707431,雙鴻元富95購01,,,,,,0.00,0,0,0,0,0,0,0,0,0,0,0,0,0
20200430,707432,雙鴻台新96購01,0.05,0.05,0.05,0.05,-0.45,-90.0,10000,1,500,0,0,0,0,0,0,0,10000,-10000,-10000
20200430,707433,新普元大95購02,0.30,0.31,0.29,0.31,-0.02,-6.06,580000,9,177960,0,0,0,0,0,0,182000,398000,-216000,-216000
20200430,707434,環球晶元大96購02,2.79,3.15,2.79,3.15,+0.39,14.13,122000,14,352670,0,0,0,0,0,0,35000,122000,-87000,-87000
20200430,707435,雙鴻元大95購02,,,,,,0.00,0,0,0,0,0,0,0,0,0,0,0,0,0
20200430,707436,譜瑞元大95購04,1.38,1.42,1.38,1.42,+0.06,4.41,25000,2,34900,0,0,0,0,0,0,15000,0,15000,15000
20200430,707437,群聯兆豐96購01,0.59,0.59,0.59,0.59,+0.07,13.46,40000,2,23600,0,0,0,0,0,0,40000,0,40000,40000
20200430,707438,環球晶兆豐95購05,1.02,1.02,1.02,1.02,+0.20,24.39,100000,1,102000,0,0,0,0,0,0,100000,100000,0,0
20200430,707439,台燿群益95購01,0.48,0.50,0.48,0.50,+0.14,38.89,60000,4,29400,0,0,0,0,0,0,60000,0,60000,60000
20200430,707440,昇達科群益97購01,,,,,,0.00,0,0,0,0,0,0,0,0,0,0,0,0,0
20200430,707441,晶焱群益96購01,0.43,0.43,0.43,0.43,+0.02,4.88,88000,1,37840,0,0,0,0,0,0,88000,0,88000,88000
20200430,707442,櫃200富邦9A購01,,,,,,0.00,0,0,0,0,0,0,0,0,0,0,0,0,0
20200430,707443,櫃200富邦9A購02,0.71,0.71,0.71,0.71,+0.05,7.58,7000,1,4970,0,0,0,0,0,0,7000,0,7000,7000
20200430,707444,雙鴻富邦96購02,0.08,0.08,0.08,0.08,-0.02,-20.0,10000,1,800,0,0,0,0,0,0,10000,0,10000,10000
20200430,707445,雙鴻第一95購01,,,,,,0.00,0,0,0,0,0,0,0,0,0,0,0,0,0
20200430,707446,大江永豐95購02,,,,,,0.00,0,0,0,0,0,0,0,0,0,0,0,0,0
20200430,707447,宜鼎永豐95購01,0.63,0.64,0.63,0.64,+0.13,25.49,37000,2,23410,0,0,0,0,0,0,37000,0,37000,37000
20200430,707448,保瑞永豐95購02,,,,,,0.00,0,0,0,0,0,0,0,0,0,0,0,0,0
20200430,707449,群聯永豐95購01,,,,,,0.00,0,0,0,0,0,0,0,0,0,0,0,0,0
20200430,707450,大江中信96購01,,,,,,0.00,0,0,0,0,0,0,0,0,0,0,0,0,0
20200430,707451,大江台新95購01,,,,,,0.00,0,0,0,0,0,0,0,0,0,0,0,0,0
20200430,707452,兆利元大96購01,0.12,0.12,0.12,0.12,+0.02,20.0,1000,1,120,0,0,0,0,0,0,1000,0,1000,1000
20200430,707453,迅得元大95購02,,,,,,0.00,0,0,0,0,0,0,0,0,0,0,0,0,0
20200430,707454,博智元大95購03,,,,,,0.00,0,0,0,0,0,0,0,0,0,0,0,0,0
20200430,707455,神盾康和95購01,,,,,,0.00,0,0,0,0,0,0,0,0,0,0,0,0,0
20200430,707456,勝麗群益95購02,0.23,0.26,0.23,0.26,+0.04,18.18,80000,8,19900,0,0,0,0,0,0,0,80000,-80000,-80000
20200430,707457,緯軟群益96購01,,,,,,0.00,0,0,0,0,0,0,0,0,0,0,0,0,0
20200430,707458,金居統一95購01,0.44,0.52,0.44,0.52,+0.32,160.0,7000,3,3360,0,0,0,0,0,0,7000,0,7000,7000
20200430,707459,迅得凱基98購01,0.64,0.64,0.64,0.64,-0.02,-3.03,27000,1,17280,0,0,0,0,0,0,27000,0,27000,27000
20200430,707460,邦特凱基95購01,,,,,,0.00,0,0,0,0,0,0,0,0,0,0,0,0,0
20200430,707461,信昌電凱基97購01,,,,,,0.00,0,0,0,0,0,0,0,0,0,0,0,0,0
20200430,707462,茂達凱基9B購01,,,,,,0.00,0,0,0,0,0,0,0,0,0,0,0,0,0
20200430,707463,神盾凱基9B購01,,,,,,0.00,0,0,0,0,0,0,0,0,0,0,0,0,0
20200430,707464,勝麗凱基97購01,,,,,,0.00,0,0,0,0,0,0,0,0,0,0,0,0,0
20200430,707465,閎康凱基97購01,0.41,0.41,0.40,0.40,-0.07,-14.89,16000,2,6540,0,0,0,0,0,0,16000,0,16000,16000
20200430,707466,環宇凱基97購01,,,,,,0.00,0,0,0,0,0,0,0,0,0,0,0,0,0
20200430,707467,環球晶凱基96購01,4.69,5.25,4.69,5.25,+0.66,14.38,34000,6,172430,0,0,0,0,0,0,2000,34000,-32000,-32000
20200430,707468,穩懋凱基96購03,,,,,,0.00,0,0,0,0,0,0,0,0,0,0,0,0,0
20200430,707469,鈺太凱基97購01,,,,,,0.00,0,0,0,0,0,0,0,0,0,0,0,0,0
20200430,707470,鐿鈦凱基96購01,,,,,,0.00,0,0,0,0,0,0,0,0,0,0,0,0,0
20200430,707471,信昌電國票96購02,1.69,1.92,1.69,1.85,+0.31,20.13,176000,8,302290,0,0,0,0,0,0,36000,144000,-108000,-108000
20200430,707472,晶焱國票96購02,,,,,,0.00,0,0,0,0,0,0,0,0,0,0,0,0,0
20200430,707473,群聯國票96購02,1.19,1.21,1.19,1.21,+0.27,28.72,200000,2,239000,0,0,0,0,0,0,0,200000,-200000,-200000
20200430,707474,穩懋富邦97購01,0.34,0.34,0.27,0.31,+0.01,3.33,229000,22,67600,0,0,0,0,0,0,0,25000,-25000,-25000
20200430,707475,光洋科永豐95購01,,,,,,0.00,0,0,0,0,0,0,0,0,0,0,0,0,0
20200430,707476,穩懋永豐95購03,,,,,,0.00,0,0,0,0,0,0,0,0,0,0,0,0,0
20200430,707477,網龍中信95購01,,,,,,0.00,0,0,0,0,0,0,0,0,0,0,0,0,0
20200430,707478,中美晶凱基95購03,0.84,0.84,0.84,0.84,+0.11,15.07,10000,1,8400,0,0,0,0,0,0,0,10000,-10000,-10000
20200430,707479,晶焱凱基96購01,,,,,,0.00,0,0,0,0,0,0,0,0,0,0,0,0,0
20200430,707480,環球晶凱基97購01,,,,,,0.00,0,0,0,0,0,0,0,0,0,0,0,0,0
20200430,707481,三貝德永豐95購01,,,,,,0.00,0,0,0,0,0,0,0,0,0,0,0,0,0
20200430,707482,神盾永豐95購02,,,,,,0.00,0,0,0,0,0,0,0,0,0,0,0,0,0
20200430,707483,環球晶永豐95購04,1.34,1.63,1.34,1.63,+0.19,13.19,272000,13,411200,0,0,0,0,0,0,72000,200000,-128000,-128000
20200430,707484,大江元大96購05,,,,,,0.00,0,0,0,0,0,0,0,0,0,0,0,0,0
20200430,707485,同致元大97購01,,,,,,0.00,0,0,0,0,0,0,0,0,0,0,0,0,0
20200430,707486,昂寶元大95購01,,,,,,0.00,0,0,0,0,0,0,0,0,0,0,0,0,0
20200430,707487,迅得國票96購01,0.10,0.10,0.10,0.10,-0.01,-9.09,50000,1,5000,0,0,0,0,0,0,50000,0,50000,50000
20200430,707488,宜鼎國票96購02,3.96,4.08,3.92,4.01,+0.23,6.08,73000,9,290650,0,0,0,0,0,0,69000,4000,65000,65000
20200430,707489,美琪瑪國票96購01,0.31,0.31,0.29,0.29,-0.01,-3.33,150000,4,43700,0,0,0,0,0,0,150000,0,150000,150000
20200430,707490,智崴國泰96購01,,,,,,0.00,0,0,0,0,0,0,0,0,0,0,0,0,0
20200430,707491,櫃200T永昌9C購01,,,,,,0.00,0,0,0,0,0,0,0,0,0,0,0,0,0
20200430,707492,櫃200T永昌9C購02,,,,,,0.00,0,0,0,0,0,0,0,0,0,0,0,0,0
20200430,707493,櫃200T永昌9C購03,,,,,,0.00,0,0,0,0,0,0,0,0,0,0,0,0,0
20200430,707494,櫃200T永昌9C購04,,,,,,0.00,0,0,0,0,0,0,0,0,0,0,0,0,0
20200430,707495,穩懋康和95購02,,,,,,0.00,0,0,0,0,0,0,0,0,0,0,0,0,0
20200430,707496,精華群益95購03,,,,,,0.00,0,0,0,0,0,0,0,0,0,0,0,0,0
20200430,707497,宜鼎元大95購02,1.42,1.49,1.42,1.49,+0.15,11.19,4000,2,5820,0,0,0,0,0,0,4000,2000,2000,2000
20200430,707498,旺矽元大96購01,,,,,,0.00,0,0,0,0,0,0,0,0,0,0,0,0,0
20200430,707499,精華元大95購03,,,,,,0.00,0,0,0,0,0,0,0,0,0,0,0,0,0
20200430,707500,智崴國票96購01,,,,,,0.00,0,0,0,0,0,0,0,0,0,0,0,0,0
20200430,707501,閎康國票97購01,1.11,1.11,1.05,1.05,-0.04,-3.67,291000,8,319660,0,0,0,0,0,0,276000,15000,261000,261000
20200430,707502,金可國泰97購01,0.10,0.10,0.10,0.10,+0.04,66.67,50000,1,5000,0,0,0,0,0,0,50000,0,50000,50000
20200430,707503,精華國泰97購01,0.08,0.08,0.08,0.08,+0.02,33.33,1000,1,80,0,0,0,0,0,0,0,1000,-1000,-1000
20200430,707504,環球晶國泰96購03,1.93,2.17,1.93,2.17,+0.16,7.96,11000,2,21470,0,0,0,0,0,0,11000,0,11000,11000
20200430,707505,穩懋國泰96購02,,,,,,0.00,0,0,0,0,0,0,0,0,0,0,0,0,0
20200430,707506,穩懋統一96購05,0.82,0.82,0.77,0.77,+0.04,5.48,35000,6,28350,0,0,0,0,0,0,35000,28000,7000,7000
20200430,707507,三貝德凱基96購02,,,,,,0.00,0,0,0,0,0,0,0,0,0,0,0,0,0
20200430,707508,中美晶凱基95購04,,,,,,0.00,0,0,0,0,0,0,0,0,0,0,0,0,0
20200430,707509,元太凱基96購01,,,,,,0.00,0,0,0,0,0,0,0,0,0,0,0,0,0
20200430,707510,昂寶凱基96購01,,,,,,0.00,0,0,0,0,0,0,0,0,0,0,0,0,0
20200430,707511,建榮凱基97購01,,,,,,0.00,0,0,0,0,0,0,0,0,0,0,0,0,0
20200430,707512,穩懋凱基96購04,,,,,,0.00,0,0,0,0,0,0,0,0,0,0,0,0,0
20200430,707513,元太第一95購01,,,,,,0.00,0,0,0,0,0,0,0,0,0,0,0,0,0
20200430,707514,晶焱永豐95購02,,,,,,0.00,0,0,0,0,0,0,0,0,0,0,0,0,0
20200430,707515,精華永豐95購02,,,,,,0.00,0,0,0,0,0,0,0,0,0,0,0,0,0
20200430,707516,聚積永豐95購01,,,,,,0.00,0,0,0,0,0,0,0,0,0,0,0,0,0
20200430,707517,穩懋兆豐96購02,0.16,0.16,0.14,0.14,+0.03,27.27,20000,2,3100,0,0,0,0,0,0,0,5000,-5000,-5000
20200430,707518,金可康和95購01,,,,,,0.00,0,0,0,0,0,0,0,0,0,0,0,0,0
20200430,707519,金可群益95購01,,,,,,0.00,0,0,0,0,0,0,0,0,0,0,0,0,0
20200430,707520,優群群益97購01,,,,,,0.00,0,0,0,0,0,0,0,0,0,0,0,0,0
20200430,707521,環球晶群益95購04,,,,,,0.00,0,0,0,0,0,0,0,0,0,0,0,0,0
20200430,707522,聯亞群益95購02,,,,,,0.00,0,0,0,0,0,0,0,0,0,0,0,0,0
20200430,707523,群聯元富95購02,,,,,,0.00,0,0,0,0,0,0,0,0,0,0,0,0,0
20200430,707524,鈺太兆豐95購01,0.44,0.44,0.42,0.42,-0.02,-4.55,70000,24,30060,0,0,0,0,0,0,70000,0,70000,70000
20200430,707525,泰博中信97購01,1.86,1.86,1.86,1.86,+0.01,0.54,10000,1,18600,0,0,0,0,0,0,10000,0,10000,10000
20200430,707526,建榮凱基96購01,,,,,,0.00,0,0,0,0,0,0,0,0,0,0,0,0,0
20200430,707527,新普凱基95購02,,,,,,0.00,0,0,0,0,0,0,0,0,0,0,0,0,0
20200430,707528,精華凱基96購01,,,,,,0.00,0,0,0,0,0,0,0,0,0,0,0,0,0
20200430,707529,精華統一97購01,,,,,,0.00,0,0,0,0,0,0,0,0,0,0,0,0,0
20200430,707530,精華統一97購02,,,,,,0.00,0,0,0,0,0,0,0,0,0,0,0,0,0
20200430,707531,神盾國票97購01,0.25,0.25,0.25,0.25,+0.01,4.17,1000,1,250,0,0,0,0,0,0,0,1000,-1000,-1000
20200430,707532,群聯國票96購03,,,,,,0.00,0,0,0,0,0,0,0,0,0,0,0,0,0
20200430,707533,緯軟國票97購02,,,,,,0.00,0,0,0,0,0,0,0,0,0,0,0,0,0
20200430,707534,碩禾元大98購01,,,,,,0.00,0,0,0,0,0,0,0,0,0,0,0,0,0
20200430,707535,精華元大96購01,,,,,,0.00,0,0,0,0,0,0,0,0,0,0,0,0,0
20200430,707536,穩懋元大95購12,,,,,,0.00,0,0,0,0,0,0,0,0,0,0,0,0,0
20200430,707537,穩懋元大95購13,,,,,,0.00,0,0,0,0,0,0,0,0,0,0,0,0,0
20200430,707538,世界永豐95購01,0.06,0.06,0.06,0.06,-0.01,-14.29,10000,1,600,0,0,0,0,0,0,10000,0,10000,10000
20200430,707539,合晶永豐95購03,,,,,,0.00,0,0,0,0,0,0,0,0,0,0,0,0,0
20200430,707540,宇峻永豐95購02,0.06,0.06,0.06,0.06,-0.02,-25.0,140000,10,8400,0,0,0,0,0,0,0,110000,-110000,-110000
20200430,707541,佳邦永豐95購01,,,,,,0.00,0,0,0,0,0,0,0,0,0,0,0,0,0
20200430,707542,金居永豐95購01,,,,,,0.00,0,0,0,0,0,0,0,0,0,0,0,0,0
20200430,707543,泰博永豐95購01,1.57,1.57,1.39,1.49,-0.01,-0.67,163000,10,249660,0,0,0,0,0,0,130000,33000,97000,97000
20200430,707544,勝麗永豐95購02,,,,,,0.00,0,0,0,0,0,0,0,0,0,0,0,0,0
20200430,707545,晟德永豐95購02,,,,,,0.00,0,0,0,0,0,0,0,0,0,0,0,0,0
20200430,707546,台半亞東96購01,,,,,,0.00,0,0,0,0,0,0,0,0,0,0,0,0,0
20200430,707547,世界中信96購01,0.50,0.50,0.49,0.49,+0.02,4.26,20000,3,9900,0,0,0,0,0,0,20000,0,20000,20000
20200430,707548,精測中信95購01,,,,,,0.00,0,0,0,0,0,0,0,0,0,0,0,0,0
20200430,707549,精測凱基96購01,,,,,,0.00,0,0,0,0,0,0,0,0,0,0,0,0,0
20200430,707550,聯亞凱基95購03,1.28,1.28,1.07,1.08,-0.14,-11.48,13000,3,16020,0,0,0,0,0,0,13000,0,13000,13000
20200430,707551,穩懋凱基95購03,,,,,,0.00,0,0,0,0,0,0,0,0,0,0,0,0,0
20200430,707552,精測統一96購01,,,,,,0.00,0,0,0,0,0,0,0,0,0,0,0,0,0
20200430,707553,安勤永豐95購01,,,,,,0.00,0,0,0,0,0,0,0,0,0,0,0,0,0
20200430,707554,金可永豐95購02,,,,,,0.00,0,0,0,0,0,0,0,0,0,0,0,0,0
20200430,707555,宣德永豐95購03,0.32,0.32,0.32,0.32,+0.06,23.08,10000,1,3200,0,0,0,0,0,0,0,10000,-10000,-10000
20200430,707556,精測永豐96購01,,,,,,0.00,0,0,0,0,0,0,0,0,0,0,0,0,0
20200430,707557,廣明永豐95購02,,,,,,0.00,0,0,0,0,0,0,0,0,0,0,0,0,0
20200430,707558,台燿亞東95購01,,,,,,0.00,0,0,0,0,0,0,0,0,0,0,0,0,0
20200430,707559,信昌電亞東95購01,,,,,,0.00,0,0,0,0,0,0,0,0,0,0,0,0,0
20200430,707560,精測元富95購01,,,,,,0.00,0,0,0,0,0,0,0,0,0,0,0,0,0
20200430,707561,M31國票96購02,,,,,,0.00,0,0,0,0,0,0,0,0,0,0,0,0,0
20200430,707562,由田國票97購01,,,,,,0.00,0,0,0,0,0,0,0,0,0,0,0,0,0
20200430,707563,宇峻國票96購01,0.26,0.26,0.26,0.26,-0.09,-25.71,20000,1,5200,0,0,0,0,0,0,20000,0,20000,20000
20200430,707564,環球晶國票96購04,1.88,2.43,1.88,2.41,+0.70,40.94,310000,23,647750,0,0,0,0,0,0,40000,270000,-230000,-230000
20200430,707565,精測國泰95購01,,,,,,0.00,0,0,0,0,0,0,0,0,0,0,0,0,0
20200430,707566,大江元大96購06,,,,,,0.00,0,0,0,0,0,0,0,0,0,0,0,0,0
20200430,707567,合晶元大96購04,0.56,0.56,0.56,0.56,+0.16,40.0,5000,1,2800,0,0,0,0,0,0,0,5000,-5000,-5000
20200430,707568,勝麗元大95購03,,,,,,0.00,0,0,0,0,0,0,0,0,0,0,0,0,0
20200430,707569,群聯元大95購07,,,,,,0.00,0,0,0,0,0,0,0,0,0,0,0,0,0
20200430,707570,精測元大95購02,,,,,,0.00,0,0,0,0,0,0,0,0,0,0,0,0,0
20200430,707571,優群元大97購01,,,,,,0.00,0,0,0,0,0,0,0,0,0,0,0,0,0
20200430,707572,穩懋元大95購14,,,,,,0.00,0,0,0,0,0,0,0,0,0,0,0,0,0
20200430,707573,穩懋元大96購02,0.19,0.19,0.18,0.18,0.00,0.0,9000,2,1640,0,0,0,0,0,0,9000,0,9000,9000
20200430,707574,大江富邦97購03,0.23,0.25,0.23,0.25,0.00,0.0,20000,5,4720,0,0,0,0,0,0,0,0,0,0
20200430,707575,雙鴻康和95購02,,,,,,0.00,0,0,0,0,0,0,0,0,0,0,0,0,0
20200430,707576,元太群益95購02,0.44,0.44,0.41,0.43,0.00,0.0,150000,6,65300,0,0,0,0,0,0,100000,50000,50000,50000
20200430,707577,神盾群益97購01,,,,,,0.00,0,0,0,0,0,0,0,0,0,0,0,0,0
20200430,707578,精測群益95購01,0.16,0.16,0.16,0.16,+0.02,14.29,10000,1,1600,0,0,0,0,0,0,10000,0,10000,10000
20200430,707579,聯亞群益95購03,,,,,,0.00,0,0,0,0,0,0,0,0,0,0,0,0,0
20200430,707580,雙鴻群益96購03,,,,,,0.00,0,0,0,0,0,0,0,0,0,0,0,0,0
20200430,707581,世界元大96購01,0.42,0.46,0.42,0.46,+0.08,21.05,378000,6,166360,0,0,0,0,0,0,78000,300000,-222000,-222000
20200430,707582,金可元大96購01,,,,,,0.00,0,0,0,0,0,0,0,0,0,0,0,0,0
20200430,707583,順達元大96購01,1.37,1.40,1.30,1.30,-0.15,-10.34,415000,15,554140,0,0,0,0,0,0,415000,0,415000,415000
20200430,707584,精測元大97購01,0.14,0.14,0.04,0.04,-0.09,-69.23,46000,3,2280,0,0,0,0,0,0,36000,2000,34000,34000
20200430,707585,精華元大96購02,,,,,,0.00,0,0,0,0,0,0,0,0,0,0,0,0,0
20200430,707586,新鉅科元富96購02,,,,,,0.00,0,0,0,0,0,0,0,0,0,0,0,0,0
20200430,707587,精測元富96購01,,,,,,0.00,0,0,0,0,0,0,0,0,0,0,0,0,0
20200430,707588,廣明元富96購01,,,,,,0.00,0,0,0,0,0,0,0,0,0,0,0,0,0
20200430,707589,宣德統一96購01,,,,,,0.00,0,0,0,0,0,0,0,0,0,0,0,0,0
20200430,707590,群聯統一96購03,,,,,,0.00,0,0,0,0,0,0,0,0,0,0,0,0,0
20200430,707591,精測統一97購01,,,,,,0.00,0,0,0,0,0,0,0,0,0,0,0,0,0
20200430,707592,穩懋統一97購01,0.91,0.91,0.91,0.91,+0.12,15.19,45000,2,40950,0,0,0,0,0,0,45000,0,45000,45000
20200430,707593,穩懋統一98購01,1.08,1.08,1.01,1.03,+0.11,11.96,52000,5,54060,0,0,0,0,0,0,22000,30000,-8000,-8000
20200430,707594,昂寶凱基98購01,,,,,,0.00,0,0,0,0,0,0,0,0,0,0,0,0,0
20200430,707595,精測凱基97購01,,,,,,0.00,0,0,0,0,0,0,0,0,0,0,0,0,0
20200430,707596,精測凱基97購02,0.16,0.16,0.15,0.15,+0.02,15.38,65000,2,10250,0,0,0,0,0,0,65000,0,65000,65000
20200430,707597,雙鴻凱基96購04,,,,,,0.00,0,0,0,0,0,0,0,0,0,0,0,0,0
20200430,707598,穩懋凱基96購05,,,,,,0.00,0,0,0,0,0,0,0,0,0,0,0,0,0
20200430,707599,大江永豐96購01,0.01,0.01,0.01,0.01,0.00,0.0,10000,10,100,0,0,0,0,0,0,0,10000,-10000,-10000
20200430,707600,中美晶永豐96購01,0.76,0.76,0.72,0.73,+0.11,17.74,140000,14,102200,0,0,0,0,0,0,0,140000,-140000,-140000
20200430,707601,精測永豐96購02,,,,,,0.00,0,0,0,0,0,0,0,0,0,0,0,0,0
20200430,707602,精測永豐97購01,0.27,0.27,0.27,0.27,+0.03,12.5,10000,1,2700,0,0,0,0,0,0,0,10000,-10000,-10000
20200430,707603,邦特國票97購01,0.09,0.09,0.09,0.09,-0.01,-10.0,57000,2,5130,0,0,0,0,0,0,57000,0,57000,57000
20200430,707604,金可國票97購01,,,,,,0.00,0,0,0,0,0,0,0,0,0,0,0,0,0
20200430,707605,群聯富邦97購01,,,,,,0.00,0,0,0,0,0,0,0,0,0,0,0,0,0
20200430,707606,精測富邦96購01,,,,,,0.00,0,0,0,0,0,0,0,0,0,0,0,0,0
20200430,707607,精測兆豐97購01,,,,,,0.00,0,0,0,0,0,0,0,0,0,0,0,0,0
20200430,707608,東洋群益96購01,,,,,,0.00,0,0,0,0,0,0,0,0,0,0,0,0,0
20200430,707609,金居群益98購01,0.59,0.69,0.58,0.69,+0.23,50.0,700000,17,424920,0,0,0,0,0,0,480000,220000,260000,260000
20200430,707610,保瑞群益98購01,0.30,0.30,0.29,0.29,+0.02,7.41,19000,3,5620,0,0,0,0,0,0,0,19000,-19000,-19000
20200430,707611,新鉅科群益96購01,,,,,,0.00,0,0,0,0,0,0,0,0,0,0,0,0,0
20200430,707612,精測群益96購01,,,,,,0.00,0,0,0,0,0,0,0,0,0,0,0,0,0
20200430,707613,鈊象台新97購01,,,,,,0.00,0,0,0,0,0,0,0,0,0,0,0,0,0
20200430,707614,精測中信96購02,,,,,,0.00,0,0,0,0,0,0,0,0,0,0,0,0,0
20200430,707615,鈊象中信96購01,,,,,,0.00,0,0,0,0,0,0,0,0,0,0,0,0,0
20200430,707616,M31凱基97購01,,,,,,0.00,0,0,0,0,0,0,0,0,0,0,0,0,0
20200430,707617,宣德凱基96購01,,,,,,0.00,0,0,0,0,0,0,0,0,0,0,0,0,0
20200430,707618,精測凱基97購03,,,,,,0.00,0,0,0,0,0,0,0,0,0,0,0,0,0
20200430,707619,璟德凱基96購01,,,,,,0.00,0,0,0,0,0,0,0,0,0,0,0,0,0
20200430,707620,鐿鈦凱基96購02,,,,,,0.00,0,0,0,0,0,0,0,0,0,0,0,0,0
20200430,707621,精測統一97購02,0.33,0.34,0.33,0.34,+0.04,13.33,153000,3,51020,0,0,0,0,0,0,53000,100000,-47000,-47000
20200430,707622,鈊象統一96購01,,,,,,0.00,0,0,0,0,0,0,0,0,0,0,0,0,0
20200430,707623,勝麗兆豐96購01,,,,,,0.00,0,0,0,0,0,0,0,0,0,0,0,0,0
20200430,707624,精測康和96購02,,,,,,0.00,0,0,0,0,0,0,0,0,0,0,0,0,0
20200430,707625,鈊象康和96購01,2.26,2.26,2.04,2.04,-0.30,-12.82,5000,2,10860,0,0,0,0,0,0,3000,2000,1000,1000
20200430,707626,環球晶永昌99購01,2.64,3.28,2.54,3.28,+0.90,37.82,89000,13,251220,0,0,0,0,0,0,24000,74000,-50000,-50000
20200430,707627,迅得永豐97購01,,,,,,0.00,0,0,0,0,0,0,0,0,0,0,0,0,0
20200430,707628,旺矽永豐97購01,,,,,,0.00,0,0,0,0,0,0,0,0,0,0,0,0,0
20200430,707629,昇達科永豐97購01,,,,,,0.00,0,0,0,0,0,0,0,0,0,0,0,0,0
20200430,707630,僑威永豐96購01,,,,,,0.00,0,0,0,0,0,0,0,0,0,0,0,0,0
20200430,707631,璟德永豐96購01,,,,,,0.00,0,0,0,0,0,0,0,0,0,0,0,0,0
20200430,707632,鈊象永豐96購01,,,,,,0.00,0,0,0,0,0,0,0,0,0,0,0,0,0
20200430,707633,鈊象永豐97購01,,,,,,0.00,0,0,0,0,0,0,0,0,0,0,0,0,0
20200430,707634,元太元大96購03,0.42,0.42,0.42,0.42,+0.01,2.44,143000,1,60060,0,0,0,0,0,0,0,143000,-143000,-143000
20200430,707635,宣德元大96購02,,,,,,0.00,0,0,0,0,0,0,0,0,0,0,0,0,0
20200430,707636,新普元大96購01,0.76,0.77,0.74,0.77,+0.06,8.45,200000,5,151680,0,0,0,0,0,0,122000,78000,44000,44000
20200430,707637,群聯元大97購02,,,,,,0.00,0,0,0,0,0,0,0,0,0,0,0,0,0
20200430,707638,精測元大96購01,,,,,,0.00,0,0,0,0,0,0,0,0,0,0,0,0,0
20200430,707639,鈊象元大97購01,,,,,,0.00,0,0,0,0,0,0,0,0,0,0,0,0,0
20200430,707640,波若威國票97購01,,,,,,0.00,0,0,0,0,0,0,0,0,0,0,0,0,0
20200430,707641,聯亞國票97購01,2.32,2.32,1.95,1.95,-0.28,-12.56,79000,5,180730,0,0,0,0,0,0,79000,8000,71000,71000
20200430,707642,宣德國泰97購01,0.24,0.26,0.23,0.26,-0.01,-3.7,60000,12,14990,0,0,0,0,0,0,20000,40000,-20000,-20000
20200430,707643,原相國泰98購01,,,,,,0.00,0,0,0,0,0,0,0,0,0,0,0,0,0
20200430,707644,精測國泰98購01,,,,,,0.00,0,0,0,0,0,0,0,0,0,0,0,0,0
20200430,707645,鈊象國泰98購01,,,,,,0.00,0,0,0,0,0,0,0,0,0,0,0,0,0
20200430,707646,鈊象群益99購01,,,,,,0.00,0,0,0,0,0,0,0,0,0,0,0,0,0
20200430,707647,鈺太中信96購02,,,,,,0.00,0,0,0,0,0,0,0,0,0,0,0,0,0
20200430,707648,雙鴻統一96購01,,,,,,0.00,0,0,0,0,0,0,0,0,0,0,0,0,0
20200430,707649,鈊象統一96購02,,,,,,0.00,0,0,0,0,0,0,0,0,0,0,0,0,0
20200430,707650,宇峻凱基98購01,,,,,,0.00,0,0,0,0,0,0,0,0,0,0,0,0,0
20200430,707651,精測凱基96購03,,,,,,0.00,0,0,0,0,0,0,0,0,0,0,0,0,0
20200430,707652,環球晶凱基96購03,2.22,2.31,2.22,2.31,+0.45,24.19,38000,3,85680,0,0,0,0,0,0,0,38000,-38000,-38000
20200430,707653,櫃200凱基96購03,,,,,,0.00,0,0,0,0,0,0,0,0,0,0,0,0,0
20200430,707654,雙美凱基97購01,,,,,,0.00,0,0,0,0,0,0,0,0,0,0,0,0,0
20200430,707655,穩懋凱基96購06,,,,,,0.00,0,0,0,0,0,0,0,0,0,0,0,0,0
20200430,707656,鈊象凱基96購01,,,,,,0.00,0,0,0,0,0,0,0,0,0,0,0,0,0
20200430,707657,鈊象凱基97購01,5.65,5.70,5.65,5.70,+0.15,2.7,10000,2,56550,0,0,0,0,0,0,10000,1000,9000,9000
20200430,707658,信昌電元富96購01,0.50,0.52,0.49,0.52,+0.17,48.57,140000,14,70100,0,0,0,0,0,0,0,130000,-130000,-130000
20200430,707659,精測元富96購02,,,,,,0.00,0,0,0,0,0,0,0,0,0,0,0,0,0
20200430,707660,鈊象元富96購01,,,,,,0.00,0,0,0,0,0,0,0,0,0,0,0,0,0
20200430,707661,宣德台新96購01,,,,,,0.00,0,0,0,0,0,0,0,0,0,0,0,0,0
20200430,707662,凡甲國票97購01,1.81,1.81,1.81,1.81,-0.06,-3.21,40000,1,72400,0,0,0,0,0,0,40000,0,40000,40000
20200430,707663,世界國票97購01,0.76,0.76,0.76,0.76,+0.08,11.76,39000,1,29640,0,0,0,0,0,0,0,39000,-39000,-39000
20200430,707664,杰力國票97購01,0.51,0.51,0.49,0.50,-0.02,-3.85,229000,6,114690,0,0,0,0,0,0,229000,0,229000,229000
20200430,707665,原相國票98購01,2.96,2.96,2.96,2.96,-0.06,-1.99,2000,1,5920,0,0,0,0,0,0,2000,0,2000,2000
20200430,707666,鈊象國票96購02,,,,,,0.00,0,0,0,0,0,0,0,0,0,0,0,0,0
20200430,707667,精測國泰98購02,,,,,,0.00,0,0,0,0,0,0,0,0,0,0,0,0,0
20200430,707668,合晶富邦96購01,,,,,,0.00,0,0,0,0,0,0,0,0,0,0,0,0,0
20200430,707669,安勤永豐97購01,,,,,,0.00,0,0,0,0,0,0,0,0,0,0,0,0,0
20200430,707670,閎康永豐96購01,,,,,,0.00,0,0,0,0,0,0,0,0,0,0,0,0,0
20200430,707671,精測永豐96購04,0.04,0.04,0.04,0.04,-0.01,-20.0,150000,1,6000,0,0,0,0,0,0,150000,0,150000,150000
20200430,707672,晶焱兆豐97購01,0.58,0.60,0.57,0.59,+0.02,3.51,467000,14,268730,0,0,0,0,0,0,439000,18000,421000,421000
20200430,707673,雙鴻兆豐97購02,0.31,0.31,0.29,0.31,+0.01,3.33,150000,5,45200,0,0,0,0,0,0,140000,10000,130000,130000
20200430,707674,合晶元大97購01,,,,,,0.00,0,0,0,0,0,0,0,0,0,0,0,0,0
20200430,707675,茂達元大97購01,,,,,,0.00,0,0,0,0,0,0,0,0,0,0,0,0,0
20200430,707676,原相元大97購02,,,,,,0.00,0,0,0,0,0,0,0,0,0,0,0,0,0
20200430,707677,勝麗元大96購02,,,,,,0.00,0,0,0,0,0,0,0,0,0,0,0,0,0
20200430,707678,精測元大98購01,,,,,,0.00,0,0,0,0,0,0,0,0,0,0,0,0,0
20200430,707679,璟德元大96購01,1.12,1.30,1.06,1.17,+0.05,4.46,350000,21,409670,0,0,0,0,0,0,250000,170000,80000,80000
20200430,707680,鈊象元大98購01,11.10,11.10,11.10,11.10,-0.20,-1.77,4000,1,44400,0,0,0,0,0,0,4000,4000,0,0
20200430,707681,力麒康和96購01,,,,,,0.00,0,0,0,0,0,0,0,0,0,0,0,0,0
20200430,707682,精測康和96購03,0.10,0.12,0.08,0.12,+0.01,9.09,25000,3,2400,0,0,0,0,0,0,0,10000,-10000,-10000
20200430,707683,東隆興群益96購01,,,,,,0.00,0,0,0,0,0,0,0,0,0,0,0,0,0
20200430,707684,金居群益98購02,0.74,0.89,0.74,0.89,+0.32,56.14,35000,4,27550,0,0,0,0,0,0,20000,15000,5000,5000
20200430,707685,保瑞群益98購02,,,,,,0.00,0,0,0,0,0,0,0,0,0,0,0,0,0
20200430,707686,神盾群益98購01,,,,,,0.00,0,0,0,0,0,0,0,0,0,0,0,0,0
20200430,707687,順達群益96購02,1.26,1.26,1.26,1.26,+0.03,2.44,29000,1,36540,0,0,0,0,0,0,29000,0,29000,29000
20200430,707688,緯軟統一96購01,,,,,,0.00,0,0,0,0,0,0,0,0,0,0,0,0,0
20200430,707689,穩懋統一96購06,0.79,0.80,0.74,0.74,+0.08,12.12,187000,13,144940,0,0,0,0,0,0,127000,60000,67000,67000
20200430,707690,鈊象統一96購03,,,,,,0.00,0,0,0,0,0,0,0,0,0,0,0,0,0
20200430,707691,同致元大97購02,,,,,,0.00,0,0,0,0,0,0,0,0,0,0,0,0,0
20200430,707692,迅得元大97購01,,,,,,0.00,0,0,0,0,0,0,0,0,0,0,0,0,0
20200430,707693,晶焱元大97購01,0.89,0.91,0.88,0.89,+0.05,5.95,644000,10,573840,0,0,0,0,0,0,370000,274000,96000,96000
20200430,707694,群聯元大97購03,,,,,,0.00,0,0,0,0,0,0,0,0,0,0,0,0,0
20200430,707695,優群元大97購02,3.66,3.66,3.66,3.66,-0.61,-14.29,5000,1,18300,0,0,0,0,0,0,5000,0,5000,5000
20200430,707696,聯亞元大97購01,,,,,,0.00,0,0,0,0,0,0,0,0,0,0,0,0,0
20200430,707697,穩懋元大96購03,0.61,0.61,0.61,0.61,0.00,0.0,20000,1,12200,0,0,0,0,0,0,20000,0,20000,20000
20200430,707698,鈊象元大97購02,,,,,,0.00,0,0,0,0,0,0,0,0,0,0,0,0,0
20200430,707699,原相元富96購01,,,,,,0.00,0,0,0,0,0,0,0,0,0,0,0,0,0
20200430,707700,精華元富96購01,,,,,,0.00,0,0,0,0,0,0,0,0,0,0,0,0,0
20200430,707701,環球晶元富96購01,1.39,1.72,1.38,1.72,+0.40,30.3,448000,24,690240,0,0,0,0,0,0,52000,396000,-344000,-344000
20200430,707702,鈊象台新98購01,,,,,,0.00,0,0,0,0,0,0,0,0,0,0,0,0,0
20200430,707703,M31凱基96購01,,,,,,0.00,0,0,0,0,0,0,0,0,0,0,0,0,0
20200430,707704,金可凱基97購01,,,,,,0.00,0,0,0,0,0,0,0,0,0,0,0,0,0
20200430,707705,金居凱基96購01,,,,,,0.00,0,0,0,0,0,0,0,0,0,0,0,0,0
20200430,707706,精華凱基96購02,,,,,,0.00,0,0,0,0,0,0,0,0,0,0,0,0,0
20200430,707707,環球晶凱基96購04,1.52,1.71,1.52,1.71,+0.38,28.57,3000,3,4880,0,0,0,0,0,0,3000,0,3000,3000
20200430,707708,聯亞凱基96購01,1.97,1.97,1.97,1.97,+0.17,9.44,10000,1,19700,0,0,0,0,0,0,10000,0,10000,10000
20200430,707709,鐿鈦凱基97購01,,,,,,0.00,0,0,0,0,0,0,0,0,0,0,0,0,0
20200430,707710,大田國票97購01,0.49,0.49,0.49,0.49,+0.06,13.95,67000,2,32830,0,0,0,0,0,0,0,67000,-67000,-67000
20200430,707711,六角國票98購01,0.79,0.82,0.76,0.82,+0.12,17.14,90000,4,73470,0,0,0,0,0,0,90000,0,90000,90000
20200430,707712,昂寶國票97購02,,,,,,0.00,0,0,0,0,0,0,0,0,0,0,0,0,0
20200430,707713,晶焱國票97購01,,,,,,0.00,0,0,0,0,0,0,0,0,0,0,0,0,0
20200430,707714,群聯國票97購01,,,,,,0.00,0,0,0,0,0,0,0,0,0,0,0,0,0
20200430,707715,大江國泰98購01,0.16,0.16,0.15,0.16,+0.03,23.08,45000,6,7180,0,0,0,0,0,0,0,45000,-45000,-45000
20200430,707716,晶焱國泰98購01,,,,,,0.00,0,0,0,0,0,0,0,0,0,0,0,0,0
20200430,707717,穩懋國泰97購01,,,,,,0.00,0,0,0,0,0,0,0,0,0,0,0,0,0
20200430,707718,良維永豐96購01,0.69,0.70,0.69,0.70,+0.01,1.45,55000,2,38010,0,0,0,0,0,0,55000,0,55000,55000
20200430,707719,威剛永豐96購01,0.31,0.35,0.31,0.31,+0.02,6.9,317000,21,102550,0,0,0,0,0,0,58000,259000,-201000,-201000
20200430,707720,宣德永豐97購01,,,,,,0.00,0,0,0,0,0,0,0,0,0,0,0,0,0
20200430,707721,鈊象永豐96購03,,,,,,0.00,0,0,0,0,0,0,0,0,0,0,0,0,0
20200430,707722,三貝德群益96購01,,,,,,0.00,0,0,0,0,0,0,0,0,0,0,0,0,0
20200430,707723,宜鼎群益96購02,,,,,,0.00,0,0,0,0,0,0,0,0,0,0,0,0,0
20200430,707724,長科*群益96購01,,,,,,0.00,0,0,0,0,0,0,0,0,0,0,0,0,0
20200430,707725,閎康群益97購01,0.54,0.54,0.50,0.50,-0.04,-7.41,624000,14,325160,0,0,0,0,0,0,624000,0,624000,624000
20200430,707726,晟德群益96購01,,,,,,0.00,0,0,0,0,0,0,0,0,0,0,0,0,0
20200430,707727,鈊象群益99購02,,,,,,0.00,0,0,0,0,0,0,0,0,0,0,0,0,0
20200430,707728,鈊象康和96購03,,,,,,0.00,0,0,0,0,0,0,0,0,0,0,0,0,0
20200430,707729,鈊象凱基98購01,7.85,7.85,7.00,7.00,-0.70,-9.09,16000,10,120100,0,0,0,0,0,0,5000,13000,-8000,-8000
20200430,707730,穩懋元富96購01,,,,,,0.00,0,0,0,0,0,0,0,0,0,0,0,0,0
20200430,707731,環球晶亞東97購01,,,,,,0.00,0,0,0,0,0,0,0,0,0,0,0,0,0
20200430,707732,凡甲永豐97購01,0.79,0.89,0.78,0.80,-0.07,-8.05,670000,25,546840,0,0,0,0,0,0,212000,444000,-232000,-232000
20200430,707733,大宇資永豐96購02,,,,,,0.00,0,0,0,0,0,0,0,0,0,0,0,0,0
20200430,707734,元太國票97購01,1.26,1.32,1.24,1.32,+0.10,8.2,276000,6,361350,0,0,0,0,0,0,49000,227000,-178000,-178000
20200430,707735,台燿國票97購01,,,,,,0.00,0,0,0,0,0,0,0,0,0,0,0,0,0
20200430,707736,信驊國票97購01,3.14,3.14,3.14,3.14,+0.29,10.18,10000,1,31400,0,0,0,0,0,0,10000,0,10000,10000
20200430,707737,新普國票97購01,,,,,,0.00,0,0,0,0,0,0,0,0,0,0,0,0,0
20200430,707738,聖暉國泰96購01,2.06,2.13,2.01,2.12,+0.24,12.77,17000,7,34850,0,0,0,0,0,0,12000,0,12000,12000
20200430,707739,網家國泰97購01,,,,,,0.00,0,0,0,0,0,0,0,0,0,0,0,0,0
20200430,707740,金可兆豐96購01,,,,,,0.00,0,0,0,0,0,0,0,0,0,0,0,0,0
20200430,707741,胡連康和96購01,0.45,0.45,0.42,0.42,+0.01,2.44,398000,7,173600,0,0,0,0,0,0,358000,40000,318000,318000
20200430,707742,佳邦群益96購01,,,,,,0.00,0,0,0,0,0,0,0,0,0,0,0,0,0
20200430,707743,旺矽群益97購01,,,,,,0.00,0,0,0,0,0,0,0,0,0,0,0,0,0
20200430,707744,新普群益98購01,1.58,1.64,1.57,1.64,+0.05,3.14,283000,7,453560,0,0,0,0,0,0,51000,232000,-181000,-181000
20200430,707745,網龍群益98購01,0.55,0.55,0.55,0.55,-0.11,-16.67,46000,6,25300,0,0,0,0,0,0,0,46000,-46000,-46000
20200430,707746,由田元大96購01,,,,,,0.00,0,0,0,0,0,0,0,0,0,0,0,0,0
20200430,707747,信昌電元大97購01,,,,,,0.00,0,0,0,0,0,0,0,0,0,0,0,0,0
20200430,707748,神盾元大99購01,0.45,0.46,0.43,0.43,0.00,0.0,108000,4,48630,0,0,0,0,0,0,108000,0,108000,108000
20200430,707749,精華元大97購01,,,,,,0.00,0,0,0,0,0,0,0,0,0,0,0,0,0
20200430,707750,穩懋元大97購01,,,,,,0.00,0,0,0,0,0,0,0,0,0,0,0,0,0
20200430,707751,鈺太元大97購01,0.60,0.61,0.58,0.58,-0.07,-10.77,75000,5,44600,0,0,0,0,0,0,35000,0,35000,35000
20200430,707752,世界中信98購01,0.24,0.24,0.24,0.24,+0.02,9.09,15000,2,3600,0,0,0,0,0,0,0,15000,-15000,-15000
20200430,707753,環球晶中信99購02,0.55,0.67,0.53,0.67,+0.16,31.37,2755000,150,1688830,0,0,0,0,0,0,662000,1896000,-1234000,-1234000
20200430,707754,環球晶統一96購01,3.00,3.61,2.90,3.61,+0.49,15.71,182000,13,602150,0,0,0,0,0,0,20000,162000,-142000,-142000
20200430,707755,穩懋統一96購07,,,,,,0.00,0,0,0,0,0,0,0,0,0,0,0,0,0
20200430,707756,世界凱基96購01,,,,,,0.00,0,0,0,0,0,0,0,0,0,0,0,0,0
20200430,707757,網龍凱基97購01,,,,,,0.00,0,0,0,0,0,0,0,0,0,0,0,0,0
20200430,707758,穩懋凱基96購07,,,,,,0.00,0,0,0,0,0,0,0,0,0,0,0,0,0
20200430,707759,大江元大97購01,,,,,,0.00,0,0,0,0,0,0,0,0,0,0,0,0,0
20200430,707760,世界元大96購02,,,,,,0.00,0,0,0,0,0,0,0,0,0,0,0,0,0
20200430,707761,迅得元大98購01,,,,,,0.00,0,0,0,0,0,0,0,0,0,0,0,0,0
20200430,707762,宣德元大96購03,,,,,,0.00,0,0,0,0,0,0,0,0,0,0,0,0,0
20200430,707763,群聯元大96購04,,,,,,0.00,0,0,0,0,0,0,0,0,0,0,0,0,0
20200430,707764,鈊象元大96購03,,,,,,0.00,0,0,0,0,0,0,0,0,0,0,0,0,0
20200430,707765,原相永昌99購01,3.89,3.89,3.84,3.84,-0.08,-2.04,32000,4,123030,0,0,0,0,0,0,29000,3000,26000,26000
20200430,707766,大田永豐96購01,,,,,,0.00,0,0,0,0,0,0,0,0,0,0,0,0,0
20200430,707767,中美晶永豐96購02,0.55,0.55,0.55,0.55,+0.08,17.02,10000,1,5500,0,0,0,0,0,0,0,10000,-10000,-10000
20200430,707768,世界永豐96購02,,,,,,0.00,0,0,0,0,0,0,0,0,0,0,0,0,0
20200430,707769,光頡永豐96購01,0.33,0.36,0.32,0.36,+0.13,56.52,40000,4,13400,0,0,0,0,0,0,0,40000,-40000,-40000
20200430,707770,合晶永豐97購01,0.92,1.09,0.92,1.09,+0.17,18.48,190000,8,185440,0,0,0,0,0,0,117000,74000,43000,43000
20200430,707771,精測永豐96購06,,,,,,0.00,0,0,0,0,0,0,0,0,0,0,0,0,0
20200430,707772,精測永豐96購07,,,,,,0.00,0,0,0,0,0,0,0,0,0,0,0,0,0
20200430,707773,穩懋永豐96購01,,,,,,0.00,0,0,0,0,0,0,0,0,0,0,0,0,0
20200430,707774,大宇資國票97購01,,,,,,0.00,0,0,0,0,0,0,0,0,0,0,0,0,0
20200430,707775,良維國票97購02,0.94,0.94,0.93,0.93,0.00,0.0,71000,2,66360,0,0,0,0,0,0,71000,0,71000,71000
20200430,707776,宜鼎國票97購01,4.36,4.49,4.36,4.49,+0.29,6.9,15000,3,65660,0,0,0,0,0,0,15000,0,15000,15000
20200430,707777,金居國票97購01,,,,,,0.00,0,0,0,0,0,0,0,0,0,0,0,0,0
20200430,707778,信昌電國票97購01,1.08,1.23,1.08,1.23,+0.20,19.42,241000,9,267560,0,0,0,0,0,0,187000,16000,171000,171000
20200430,707779,保瑞國票97購01,,,,,,0.00,0,0,0,0,0,0,0,0,0,0,0,0,0
20200430,707780,昇達科富邦98購01,0.31,0.31,0.29,0.29,+0.02,7.41,59000,3,17710,0,0,0,0,0,0,54000,5000,49000,49000
20200430,707781,宣德麥證96購01,,,,,,0.00,0,0,0,0,0,0,0,0,0,0,0,0,0
20200430,707782,世界台新97購01,0.02,0.02,0.02,0.02,-0.27,-93.1,10000,1,200,0,0,0,0,0,0,0,10000,-10000,-10000
20200430,707783,泰博兆豐96購02,,,,,,0.00,0,0,0,0,0,0,0,0,0,0,0,0,0
20200430,707784,聚積康和96購01,,,,,,0.00,0,0,0,0,0,0,0,0,0,0,0,0,0
20200430,707785,凡甲群益98購01,1.56,1.57,1.56,1.56,-0.07,-4.29,64000,4,100180,0,0,0,0,0,0,64000,0,64000,64000
20200430,707786,中美晶群益96購01,1.40,1.52,1.40,1.47,+0.14,10.53,99000,18,146380,0,0,0,0,0,0,10000,99000,-89000,-89000
20200430,707787,合晶群益96購01,,,,,,0.00,0,0,0,0,0,0,0,0,0,0,0,0,0
20200430,707788,晶焱群益98購01,0.66,0.71,0.66,0.71,+0.06,9.23,233000,9,158680,0,0,0,0,0,0,127000,133000,-6000,-6000
20200430,707789,精測群益96購04,,,,,,0.00,0,0,0,0,0,0,0,0,0,0,0,0,0
20200430,707790,廣明群益96購01,,,,,,0.00,0,0,0,0,0,0,0,0,0,0,0,0,0
20200430,707791,聯亞群益96購02,,,,,,0.00,0,0,0,0,0,0,0,0,0,0,0,0,0
20200430,707792,鐿鈦群益97購01,,,,,,0.00,0,0,0,0,0,0,0,0,0,0,0,0,0
20200430,707793,中美晶元大96購02,,,,,,0.00,0,0,0,0,0,0,0,0,0,0,0,0,0
20200430,707794,世界元大96購03,,,,,,0.00,0,0,0,0,0,0,0,0,0,0,0,0,0
20200430,707795,精測元大96購02,,,,,,0.00,0,0,0,0,0,0,0,0,0,0,0,0,0
20200430,707796,聯亞元大96購02,,,,,,0.00,0,0,0,0,0,0,0,0,0,0,0,0,0
20200430,707797,鈊象元大96購04,,,,,,0.00,0,0,0,0,0,0,0,0,0,0,0,0,0
20200430,707798,世界統一97購01,0.65,0.69,0.65,0.69,+0.05,7.81,248000,7,165300,0,0,0,0,0,0,23000,225000,-202000,-202000
20200430,707799,神盾統一98購01,,,,,,0.00,0,0,0,0,0,0,0,0,0,0,0,0,0
20200430,707800,穩懋統一98購02,0.57,0.57,0.57,0.57,+0.10,21.28,1000,1,570,0,0,0,0,0,0,0,1000,-1000,-1000
20200430,707801,鈊象統一97購02,,,,,,0.00,0,0,0,0,0,0,0,0,0,0,0,0,0
20200430,707802,宣德中信9A購01,0.23,0.24,0.22,0.23,-0.03,-11.54,433000,5,99530,0,0,0,0,0,0,406000,27000,379000,379000
20200430,707803,中光電凱基96購01,,,,,,0.00,0,0,0,0,0,0,0,0,0,0,0,0,0
20200430,707804,世界凱基96購02,,,,,,0.00,0,0,0,0,0,0,0,0,0,0,0,0,0
20200430,707805,旺矽凱基96購01,,,,,,0.00,0,0,0,0,0,0,0,0,0,0,0,0,0
20200430,707806,信昌電凱基97購02,,,,,,0.00,0,0,0,0,0,0,0,0,0,0,0,0,0
20200430,707807,佳邦國票97購01,0.17,0.17,0.16,0.16,+0.01,6.67,220000,5,35500,0,0,0,0,0,0,60000,160000,-100000,-100000
20200430,707808,優群國票98購01,,,,,,0.00,0,0,0,0,0,0,0,0,0,0,0,0,0
20200430,707809,中美晶國泰97購01,,,,,,0.00,0,0,0,0,0,0,0,0,0,0,0,0,0
20200430,707810,穩懋麥證96購01,0.35,0.35,0.35,0.35,+0.12,52.17,100000,1,35000,100000,0,100000,0,0,0,100000,100000,0,0
20200430,707811,世界元富96購01,,,,,,0.00,0,0,0,0,0,0,0,0,0,0,0,0,0
20200430,707812,茂達元富96購01,,,,,,0.00,0,0,0,0,0,0,0,0,0,0,0,0,0
20200430,707813,群聯元富96購02,2.40,2.44,2.31,2.44,+0.29,13.49,259000,26,624980,0,0,0,0,0,0,74000,185000,-111000,-111000
20200430,707814,穩懋富邦98購01,0.27,0.35,0.27,0.29,-0.01,-3.33,39000,20,11180,0,0,0,0,0,0,15000,0,15000,15000
20200430,707815,中美晶台新97購01,0.31,0.31,0.02,0.02,-0.16,-88.89,11000,2,510,0,0,0,0,0,0,0,10000,-10000,-10000
20200430,707816,良維台新97購01,0.05,0.05,0.05,0.05,-1.05,-95.45,10000,1,500,0,0,0,0,0,0,0,10000,-10000,-10000
20200430,707817,閎康台新96購01,0.01,0.01,0.01,0.01,-0.21,-95.45,10000,1,100,0,0,0,0,0,0,0,10000,-10000,-10000
20200430,707818,群聯台新97購02,0.06,0.06,0.06,0.06,-0.40,-86.96,10000,1,600,0,0,0,0,0,0,0,10000,-10000,-10000
20200430,707819,碩禾台新97購01,0.01,0.01,0.01,0.01,-0.19,-95.0,10000,1,100,0,0,0,0,0,0,0,10000,-10000,-10000
20200430,707820,世界康和96購01,,,,,,0.00,0,0,0,0,0,0,0,0,0,0,0,0,0
20200430,707821,凡甲群益96購01,2.03,2.21,2.03,2.03,-0.03,-1.46,281000,11,584310,0,0,0,0,0,0,15000,266000,-251000,-251000
20200430,707822,中美晶群益96購02,0.56,0.57,0.56,0.56,+0.11,24.44,150000,3,84500,0,0,0,0,0,0,0,150000,-150000,-150000
20200430,707823,宜鼎群益97購01,,,,,,0.00,0,0,0,0,0,0,0,0,0,0,0,0,0
20200430,707824,環球晶群益96購01,0.75,0.98,0.75,0.94,+0.24,34.29,213000,25,192370,0,0,0,0,0,0,102000,115000,-13000,-13000
20200430,707825,鈊象群益99購03,,,,,,0.00,0,0,0,0,0,0,0,0,0,0,0,0,0
20200430,707826,大江永豐96購02,0.12,0.12,0.12,0.12,-0.01,-7.69,70000,3,8400,0,0,0,0,0,0,0,70000,-70000,-70000
20200430,707827,世界永豐96購03,,,,,,0.00,0,0,0,0,0,0,0,0,0,0,0,0,0
20200430,707828,合晶永豐96購01,,,,,,0.00,0,0,0,0,0,0,0,0,0,0,0,0,0
20200430,707829,博智永豐96購01,,,,,,0.00,0,0,0,0,0,0,0,0,0,0,0,0,0
20200430,707830,網龍永豐96購01,,,,,,0.00,0,0,0,0,0,0,0,0,0,0,0,0,0
20200430,707831,雙美永豐97購01,0.21,0.21,0.21,0.21,+0.01,5.0,30000,1,6300,0,0,0,0,0,0,30000,0,30000,30000
20200430,707832,精測兆豐97購02,0.03,0.03,0.03,0.03,0.00,0.0,1000,1,30,0,0,0,0,0,0,1000,0,1000,1000
20200430,707833,網龍兆豐97購01,0.67,0.68,0.62,0.65,-0.06,-8.45,504000,17,329610,0,0,0,0,0,0,457000,47000,410000,410000
20200430,707834,晟德兆豐97購01,0.45,0.45,0.43,0.43,-0.01,-2.27,55000,5,23700,0,0,0,0,0,0,5000,50000,-45000,-45000
20200430,707835,原相康和96購01,1.30,1.30,1.30,1.30,-0.06,-4.41,10000,1,13000,0,0,0,0,0,0,10000,0,10000,10000
20200430,707836,力旺永豐96購01,,,,,,0.00,0,0,0,0,0,0,0,0,0,0,0,0,0
20200430,707837,良維永豐96購02,0.52,0.52,0.52,0.52,-0.01,-1.89,68000,1,35360,0,0,0,0,0,0,68000,0,68000,68000
20200430,707838,佳邦永豐96購01,,,,,,0.00,0,0,0,0,0,0,0,0,0,0,0,0,0
20200430,707839,建榮永豐97購01,,,,,,0.00,0,0,0,0,0,0,0,0,0,0,0,0,0
20200430,707840,晶焱永豐97購01,,,,,,0.00,0,0,0,0,0,0,0,0,0,0,0,0,0
20200430,707841,智崴永豐96購01,,,,,,0.00,0,0,0,0,0,0,0,0,0,0,0,0,0
20200430,707842,精測永豐96購08,,,,,,0.00,0,0,0,0,0,0,0,0,0,0,0,0,0
20200430,707843,鈊象永豐96購04,,,,,,0.00,0,0,0,0,0,0,0,0,0,0,0,0,0
20200430,707844,中美晶元大97購01,,,,,,0.00,0,0,0,0,0,0,0,0,0,0,0,0,0
20200430,707845,台半元大96購01,,,,,,0.00,0,0,0,0,0,0,0,0,0,0,0,0,0
20200430,707846,杰力元大96購03,,,,,,0.00,0,0,0,0,0,0,0,0,0,0,0,0,0
20200430,707847,宣德元大96購04,0.59,0.60,0.58,0.58,+0.04,7.41,443000,5,262730,0,0,0,0,0,0,1000,442000,-441000,-441000
20200430,707848,精測元大96購03,,,,,,0.00,0,0,0,0,0,0,0,0,0,0,0,0,0
20200430,707849,雙鴻元大99購01,0.55,0.55,0.43,0.45,-0.08,-15.09,36000,5,18150,0,0,0,0,0,0,4000,10000,-6000,-6000
20200430,707850,鈊象元大97購03,,,,,,0.00,0,0,0,0,0,0,0,0,0,0,0,0,0
20200430,707851,群聯麥證96購01,,,,,,0.00,0,0,0,0,0,0,0,0,0,0,0,0,0
20200430,707852,環球晶麥證96購01,2.42,2.61,2.41,2.61,+0.06,2.35,22000,3,54520,15000,7000,8000,0,0,0,15000,7000,8000,8000
20200430,707853,雙鴻麥證97購01,,,,,,0.00,0,0,0,0,0,0,0,0,0,0,0,0,0
20200430,707854,合晶台新96購01,,,,,,0.00,0,0,0,0,0,0,0,0,0,0,0,0,0
20200430,707855,良維台新97購02,0.05,0.05,0.05,0.05,-0.20,-80.0,10000,1,500,0,0,0,0,0,0,0,10000,-10000,-10000
20200430,707856,神盾台新97購01,0.02,0.02,0.02,0.02,-0.11,-84.62,10000,1,200,0,0,0,0,0,0,0,10000,-10000,-10000
20200430,707857,新普台新97購01,0.03,0.03,0.03,0.03,-0.75,-96.15,10000,1,300,0,0,0,0,0,0,0,10000,-10000,-10000
20200430,707858,穩懋台新97購01,,,,,,0.00,0,0,0,0,0,0,0,0,0,0,0,0,0
20200430,707859,中美晶國票97購01,,,,,,0.00,0,0,0,0,0,0,0,0,0,0,0,0,0
20200430,707860,同致國票97購02,0.72,0.83,0.72,0.82,+0.11,15.49,284000,13,217580,0,0,0,0,0,0,0,274000,-274000,-274000
20200430,707861,東隆興國票96購01,,,,,,0.00,0,0,0,0,0,0,0,0,0,0,0,0,0
20200430,707862,茂達國票97購01,0.58,0.63,0.58,0.63,+0.07,12.5,154000,4,91540,0,0,0,0,0,0,154000,0,154000,154000
20200430,707863,穩懋國票97購01,,,,,,0.00,0,0,0,0,0,0,0,0,0,0,0,0,0
20200430,707864,M31凱基98購01,,,,,,0.00,0,0,0,0,0,0,0,0,0,0,0,0,0
20200430,707865,中美晶凱基96購03,,,,,,0.00,0,0,0,0,0,0,0,0,0,0,0,0,0
20200430,707866,合晶凱基96購01,0.28,0.28,0.28,0.28,+0.06,27.27,10000,1,2800,0,0,0,0,0,0,0,10000,-10000,-10000
20200430,707867,宣德凱基96購02,,,,,,0.00,0,0,0,0,0,0,0,0,0,0,0,0,0
20200430,707868,碩禾凱基97購01,,,,,,0.00,0,0,0,0,0,0,0,0,0,0,0,0,0
20200430,707869,精測凱基96購07,,,,,,0.00,0,0,0,0,0,0,0,0,0,0,0,0,0
20200430,707870,聯亞凱基97購01,,,,,,0.00,0,0,0,0,0,0,0,0,0,0,0,0,0
20200430,707871,精測國泰97購02,0.33,0.37,0.33,0.37,+0.04,12.12,140000,6,51400,0,0,0,0,0,0,0,0,0,0
20200430,707872,精測國泰98購03,,,,,,0.00,0,0,0,0,0,0,0,0,0,0,0,0,0
20200430,707873,鈺太國泰98購01,,,,,,0.00,0,0,0,0,0,0,0,0,0,0,0,0,0
20200430,707874,世界富邦98購01,,,,,,0.00,0,0,0,0,0,0,0,0,0,0,0,0,0
20200430,707875,世界群益98購01,0.51,0.55,0.51,0.55,+0.06,12.24,260000,7,138330,0,0,0,0,0,0,90000,170000,-80000,-80000
20200430,707876,世界群益98購02,,,,,,0.00,0,0,0,0,0,0,0,0,0,0,0,0,0
20200430,707877,迅得群益97購02,,,,,,0.00,0,0,0,0,0,0,0,0,0,0,0,0,0
20200430,707878,信昌電群益96購01,0.68,0.75,0.66,0.68,+0.08,13.33,298000,8,204480,0,0,0,0,0,0,138000,160000,-22000,-22000
20200430,707879,宣德群益96購02,0.50,0.50,0.50,0.50,+0.07,16.28,20000,1,10000,0,0,0,0,0,0,0,20000,-20000,-20000
20200430,707880,建榮群益97購01,,,,,,0.00,0,0,0,0,0,0,0,0,0,0,0,0,0
20200430,707881,璟德群益97購01,1.21,1.37,1.21,1.37,+0.11,8.73,304000,15,381730,0,0,0,0,0,0,0,304000,-304000,-304000
20200430,707882,環球晶群益97購01,1.15,1.55,1.15,1.55,+0.48,44.86,123000,6,164510,0,0,0,0,0,0,24000,103000,-79000,-79000
20200430,707883,力旺元大97購01,0.72,0.83,0.72,0.83,+0.18,27.69,203000,4,152990,0,0,0,0,0,0,3000,200000,-197000,-197000
20200430,707884,中美晶元大97購02,,,,,,0.00,0,0,0,0,0,0,0,0,0,0,0,0,0
20200430,707885,台燿元大96購01,0.76,0.76,0.68,0.68,+0.21,44.68,136000,8,100160,0,0,0,0,0,0,68000,68000,0,0
20200430,707886,旺矽元大99購01,0.39,0.39,0.39,0.39,+0.06,18.18,70000,1,27300,0,0,0,0,0,0,70000,0,70000,70000
20200430,707887,晶焱元大97購02,0.20,0.20,0.20,0.20,-0.05,-20.0,10000,1,2000,0,0,0,0,0,0,10000,0,10000,10000
20200430,707888,精測元大97購02,,,,,,0.00,0,0,0,0,0,0,0,0,0,0,0,0,0
20200430,707889,璟德元大96購02,0.61,0.67,0.61,0.62,+0.01,1.64,131000,11,80950,0,0,0,0,0,0,51000,80000,-29000,-29000
20200430,707890,穩懋元大96購04,0.65,0.66,0.65,0.66,+0.11,20.0,20000,2,13100,0,0,0,0,0,0,0,20000,-20000,-20000
20200430,707891,力旺凱基96購01,0.16,0.16,0.16,0.16,+0.03,23.08,60000,1,9600,0,0,0,0,0,0,60000,0,60000,60000
20200430,707892,大江凱基96購02,0.14,0.14,0.14,0.14,-0.01,-6.67,300000,1,42000,0,0,0,0,0,0,300000,0,300000,300000
20200430,707893,保瑞凱基96購01,,,,,,0.00,0,0,0,0,0,0,0,0,0,0,0,0,0
20200430,707894,璟德凱基96購02,,,,,,0.00,0,0,0,0,0,0,0,0,0,0,0,0,0
20200430,707895,穩懋凱基96購09,0.30,0.30,0.30,0.30,+0.04,15.38,1000,1,300,0,0,0,0,0,0,0,1000,-1000,-1000
20200430,707896,中美晶統一96購01,0.69,0.69,0.69,0.69,+0.09,15.0,21000,2,14490,0,0,0,0,0,0,1000,20000,-19000,-19000
20200430,707897,昂寶統一97購01,,,,,,0.00,0,0,0,0,0,0,0,0,0,0,0,0,0
20200430,707898,台燿兆豐97購01,0.64,0.68,0.63,0.68,+0.12,21.43,274000,27,178580,0,0,0,0,0,0,244000,0,244000,244000
20200430,707899,威剛群益96購01,1.46,1.50,1.42,1.46,+0.14,10.61,87000,11,127420,0,0,0,0,0,0,2000,85000,-83000,-83000
20200430,707900,宣德群益96購03,,,,,,0.00,0,0,0,0,0,0,0,0,0,0,0,0,0
20200430,707901,精測群益96購05,,,,,,0.00,0,0,0,0,0,0,0,0,0,0,0,0,0
20200430,707902,鈊象群益98購01,,,,,,0.00,0,0,0,0,0,0,0,0,0,0,0,0,0
20200430,707903,M31永豐96購01,,,,,,0.00,0,0,0,0,0,0,0,0,0,0,0,0,0
20200430,707904,金居永豐96購01,0.07,0.07,0.07,0.07,+0.01,16.67,1000,1,70,0,0,0,0,0,0,0,1000,-1000,-1000
20200430,707905,宣德永豐96購01,,,,,,0.00,0,0,0,0,0,0,0,0,0,0,0,0,0
20200430,707906,精測永豐96購09,,,,,,0.00,0,0,0,0,0,0,0,0,0,0,0,0,0
20200430,707907,璟德永豐96購02,,,,,,0.00,0,0,0,0,0,0,0,0,0,0,0,0,0
20200430,707908,優群永豐96購02,2.16,2.16,1.93,1.93,-0.22,-10.23,43000,5,88990,0,0,0,0,0,0,23000,10000,13000,13000
20200430,707909,凡甲台新96購01,0.05,0.05,0.05,0.05,-1.26,-96.18,10000,1,500,0,0,0,0,0,0,0,10000,-10000,-10000
20200430,707910,力旺國票97購01,0.46,0.55,0.43,0.55,+0.12,27.91,954000,17,439960,0,0,0,0,0,0,424000,530000,-106000,-106000
20200430,707911,杰力國票97購02,0.67,0.67,0.64,0.65,0.00,0.0,306000,8,202460,0,0,0,0,0,0,96000,210000,-114000,-114000
20200430,707912,聚積國票97購01,,,,,,0.00,0,0,0,0,0,0,0,0,0,0,0,0,0
20200430,707913,鈊象國票97購01,19.40,19.40,16.90,16.90,-1.40,-7.65,12000,5,212400,0,0,0,0,0,0,2000,10000,-8000,-8000
20200430,707914,環球晶國泰97購01,1.87,2.28,1.86,2.28,+0.60,35.71,51000,4,99500,0,0,0,0,0,0,11000,50000,-39000,-39000
20200430,707915,中美晶富邦97購02,0.12,0.12,0.12,0.12,+0.02,20.0,61000,2,7320,0,0,0,0,0,0,0,61000,-61000,-61000
20200430,707916,聯亞富邦98購01,0.91,0.97,0.82,0.82,-0.11,-11.83,135000,19,119440,0,0,0,0,0,0,53000,62000,-9000,-9000
20200430,707917,中美晶麥證96購01,,,,,,0.00,0,0,0,0,0,0,0,0,0,0,0,0,0
20200430,707918,合晶麥證96購01,,,,,,0.00,0,0,0,0,0,0,0,0,0,0,0,0,0
20200430,707919,櫃200第一96購03,,,,,,0.00,0,0,0,0,0,0,0,0,0,0,0,0,0
20200430,707920,櫃200第一96購04,,,,,,0.00,0,0,0,0,0,0,0,0,0,0,0,0,0
20200430,707921,譜瑞兆豐96購01,2.87,2.89,2.86,2.87,+0.09,3.24,45000,5,128940,0,0,0,0,0,0,27000,18000,9000,9000
20200430,707922,雍智康和96購01,0.36,0.46,0.36,0.42,+0.06,16.67,76000,7,32510,0,0,0,0,0,0,26000,50000,-24000,-24000
20200430,707923,力旺群益97購01,,,,,,0.00,0,0,0,0,0,0,0,0,0,0,0,0,0
20200430,707924,中美晶群益97購01,0.20,0.20,0.20,0.20,+0.06,42.86,12000,2,2400,0,0,0,0,0,0,0,0,0,0
20200430,707925,信驊群益96購01,4.34,4.34,4.34,4.34,+0.34,8.5,7000,2,30380,0,0,0,0,0,0,7000,0,7000,7000
20200430,707926,雍智群益96購01,,,,,,0.00,0,0,0,0,0,0,0,0,0,0,0,0,0
20200430,707927,碩禾群益97購01,,,,,,0.00,0,0,0,0,0,0,0,0,0,0,0,0,0
20200430,707928,環球晶群益97購02,3.51,3.96,3.51,3.96,+0.52,15.12,104000,16,388540,0,0,0,0,0,0,19000,99000,-80000,-80000
20200430,707929,凡甲元大98購01,,,,,,0.00,0,0,0,0,0,0,0,0,0,0,0,0,0
20200430,707930,雍智元大97購01,,,,,,0.00,0,0,0,0,0,0,0,0,0,0,0,0,0
20200430,707931,力旺統一96購01,,,,,,0.00,0,0,0,0,0,0,0,0,0,0,0,0,0
20200430,707932,雍智統一97購01,0.84,0.84,0.81,0.81,+0.02,2.53,11000,2,9210,0,0,0,0,0,0,11000,0,11000,11000
20200430,707933,新普中信96購01,,,,,,0.00,0,0,0,0,0,0,0,0,0,0,0,0,0
20200430,707934,雍智中信96購01,0.29,0.29,0.29,0.29,+0.05,20.83,252000,3,73080,0,0,0,0,0,0,2000,250000,-248000,-248000
20200430,707935,大江國票97購03,,,,,,0.00,0,0,0,0,0,0,0,0,0,0,0,0,0
20200430,707936,世界國票97購02,,,,,,0.00,0,0,0,0,0,0,0,0,0,0,0,0,0
20200430,707937,雍智國票96購01,0.51,0.58,0.51,0.58,+0.09,18.37,3000,3,1620,0,0,0,0,0,0,3000,0,3000,3000
20200430,707938,雙鴻國票97購01,,,,,,0.00,0,0,0,0,0,0,0,0,0,0,0,0,0
20200430,707939,鈺太國票97購01,0.65,0.70,0.63,0.63,-0.03,-4.55,134000,6,87350,0,0,0,0,0,0,104000,30000,74000,74000
20200430,707940,弘塑凱基97購01,0.50,0.50,0.40,0.46,+0.16,53.33,177000,7,79300,0,0,0,0,0,0,50000,0,50000,50000
20200430,707941,同致凱基97購01,0.23,0.24,0.23,0.24,0.00,0.0,100000,2,23500,0,0,0,0,0,0,0,100000,-100000,-100000
20200430,707942,神盾凱基98購01,,,,,,0.00,0,0,0,0,0,0,0,0,0,0,0,0,0
20200430,707943,雍智凱基96購01,,,,,,0.00,0,0,0,0,0,0,0,0,0,0,0,0,0
20200430,707944,廣明凱基96購01,,,,,,0.00,0,0,0,0,0,0,0,0,0,0,0,0,0
20200430,707945,環球晶凱基96購05,,,,,,0.00,0,0,0,0,0,0,0,0,0,0,0,0,0
20200430,707946,鈊象凱基96購03,,,,,,0.00,0,0,0,0,0,0,0,0,0,0,0,0,0
20200430,707947,力旺麥證96購01,,,,,,0.00,0,0,0,0,0,0,0,0,0,0,0,0,0
20200430,707948,威剛國泰97購01,0.79,0.79,0.78,0.78,+0.14,21.88,20000,2,15700,0,0,0,0,0,0,0,20000,-20000,-20000
20200430,707949,群聯國泰98購01,0.58,0.58,0.58,0.58,+0.21,56.76,10000,1,5800,0,0,0,0,0,0,10000,10000,0,0
20200430,707950,雍智國泰98購01,1.28,1.40,1.28,1.40,+0.14,11.11,165000,11,216960,0,3000,-3000,0,0,0,83000,82000,1000,-2000
20200430,707951,精測元富99購01,0.15,0.16,0.14,0.15,+0.01,7.14,1463000,34,224520,0,0,0,0,0,0,856000,574000,282000,282000
20200430,707952,聯亞元富96購02,,,,,,0.00,0,0,0,0,0,0,0,0,0,0,0,0,0
20200430,707953,力旺台新97購01,0.20,0.20,0.20,0.20,+0.06,42.86,11000,2,2200,0,0,0,0,0,0,0,10000,-10000,-10000
20200430,707954,世界台新97購02,0.50,0.50,0.23,0.23,-0.22,-48.89,15000,2,4800,0,0,0,0,0,0,5000,10000,-5000,-5000
20200430,707955,櫃200永昌97購01,,,,,,0.00,0,0,0,0,0,0,0,0,0,0,0,0,0
20200430,707956,櫃200永昌99購01,,,,,,0.00,0,0,0,0,0,0,0,0,0,0,0,0,0
20200430,707957,櫃200永昌99購02,,,,,,0.00,0,0,0,0,0,0,0,0,0,0,0,0,0
20200430,707958,櫃200永昌99購03,,,,,,0.00,0,0,0,0,0,0,0,0,0,0,0,0,0
20200430,707959,久元永豐96購01,,,,,,0.00,0,0,0,0,0,0,0,0,0,0,0,0,0
20200430,707960,立端永豐96購01,0.40,0.46,0.40,0.45,+0.09,25.0,252000,9,108700,0,0,0,0,0,0,76000,176000,-100000,-100000
20200430,707961,良維永豐96購03,0.99,1.00,0.99,0.99,-0.04,-3.88,190000,5,188600,0,0,0,0,0,0,141000,49000,92000,92000
20200430,707962,宜鼎永豐96購01,0.93,0.99,0.93,0.99,+0.12,13.79,151000,9,141790,0,0,0,0,0,0,124000,27000,97000,97000
20200430,707963,皇田永豐96購01,,,,,,0.00,0,0,0,0,0,0,0,0,0,0,0,0,0
20200430,707964,美琪瑪永豐96購01,,,,,,0.00,0,0,0,0,0,0,0,0,0,0,0,0,0
20200430,707965,雍智永豐96購01,0.27,0.30,0.27,0.30,+0.07,30.43,260000,16,73140,0,0,0,0,0,0,100000,160000,-60000,-60000
20200430,707966,穩懋統一96購08,,,,,,0.00,0,0,0,0,0,0,0,0,0,0,0,0,0
20200430,707967,穩懋統一96購09,,,,,,0.00,0,0,0,0,0,0,0,0,0,0,0,0,0
20200430,707968,穩懋統一96購10,1.29,1.31,1.29,1.31,+0.18,15.93,25000,2,32350,0,0,0,0,0,0,25000,0,25000,25000
20200430,707969,穩懋統一97購03,0.91,0.91,0.82,0.88,+0.12,15.79,646000,18,559500,0,0,0,0,0,0,616000,72000,544000,544000
20200430,707970,鈊象統一97購03,,,,,,0.00,0,0,0,0,0,0,0,0,0,0,0,0,0
20200430,707971,中美晶中信96購01,,,,,,0.00,0,0,0,0,0,0,0,0,0,0,0,0,0
20200430,707972,同致中信98購01,,,,,,0.00,0,0,0,0,0,0,0,0,0,0,0,0,0
20200430,707973,環球晶中信9C購01,0.67,0.78,0.67,0.78,+0.14,21.88,182000,23,129160,0,0,0,0,0,0,56000,126000,-70000,-70000
20200430,707974,世界凱基96購03,0.41,0.45,0.41,0.45,+0.06,15.38,74000,3,32600,0,0,0,0,0,0,10000,64000,-54000,-54000
20200430,707975,金居凱基96購02,,,,,,0.00,0,0,0,0,0,0,0,0,0,0,0,0,0
20200430,707976,環球晶凱基96購06,,,,,,0.00,0,0,0,0,0,0,0,0,0,0,0,0,0
20200430,707977,穩懋凱基96購10,1.77,1.78,1.67,1.67,+0.17,11.33,90000,7,157840,0,0,0,0,0,0,90000,0,90000,90000
20200430,707978,大江群益97購01,0.03,0.04,0.03,0.04,-0.03,-42.86,3000,2,100,0,0,0,0,0,0,0,0,0,0
20200430,707979,原相群益98購01,,,,,,0.00,0,0,0,0,0,0,0,0,0,0,0,0,0
20200430,707980,弘塑國票97購01,,,,,,0.00,0,0,0,0,0,0,0,0,0,0,0,0,0
20200430,707981,宜鼎國票97購02,4.43,4.54,4.43,4.43,+0.27,6.49,35000,7,156280,0,0,0,0,0,0,35000,25000,10000,10000
20200430,707982,昂寶國票97購03,,,,,,0.00,0,0,0,0,0,0,0,0,0,0,0,0,0
20200430,707983,環球晶國票97購01,2.50,3.04,2.50,3.04,+0.69,29.36,87000,14,251850,0,0,0,0,0,0,31000,56000,-25000,-25000
20200430,707984,緯軟國泰97購01,,,,,,0.00,0,0,0,0,0,0,0,0,0,0,0,0,0
20200430,707985,櫃200永昌9B購01,,,,,,0.00,0,0,0,0,0,0,0,0,0,0,0,0,0
20200430,707986,櫃200永昌9C購01,,,,,,0.00,0,0,0,0,0,0,0,0,0,0,0,0,0
20200430,707987,櫃200永昌9C購02,,,,,,0.00,0,0,0,0,0,0,0,0,0,0,0,0,0
20200430,707988,櫃200永昌9C購03,4.72,4.72,4.72,4.72,+0.37,8.51,1000,1,4720,0,0,0,0,0,0,1000,0,1000,1000
20200430,707989,大宇資第一96購01,,,,,,0.00,0,0,0,0,0,0,0,0,0,0,0,0,0
20200430,707990,凡甲永豐96購01,0.58,0.58,0.52,0.52,+0.06,13.04,90000,4,49300,0,0,0,0,0,0,40000,50000,-10000,-10000
20200430,707991,弘塑永豐96購01,,,,,,0.00,0,0,0,0,0,0,0,0,0,0,0,0,0
20200430,707992,昇達科永豐96購01,,,,,,0.00,0,0,0,0,0,0,0,0,0,0,0,0,0
20200430,707993,波若威永豐97購01,,,,,,0.00,0,0,0,0,0,0,0,0,0,0,0,0,0
20200430,707994,威剛永豐96購02,,,,,,0.00,0,0,0,0,0,0,0,0,0,0,0,0,0
20200430,707995,原相永豐96購01,0.36,0.36,0.33,0.33,-0.03,-8.33,15000,2,5100,0,0,0,0,0,0,10000,5000,5000,5000
20200430,707996,神盾永豐96購01,,,,,,0.00,0,0,0,0,0,0,0,0,0,0,0,0,0
20200430,707997,網龍永豐96購02,0.32,0.34,0.30,0.30,-0.08,-21.05,79000,11,25630,0,0,0,0,0,0,3000,76000,-73000,-73000
20200430,707998,廣明永豐96購02,0.65,0.65,0.60,0.60,-0.22,-26.83,87000,5,54820,0,0,0,0,0,0,87000,0,87000,87000
20200430,707999,聯亞永豐96購01,1.59,1.59,1.32,1.32,-0.17,-11.41,200000,10,272880,0,0,0,0,0,0,187000,33000,154000,154000
20200430,708000,雙鴻永豐97購01,,,,,,0.00,0,0,0,0,0,0,0,0,0,0,0,0,0
20200430,708001,世界元大96購05,0.35,0.38,0.35,0.38,+0.07,22.58,470000,8,172290,0,0,0,0,0,0,400000,70000,330000,330000
20200430,708002,合晶元大97購02,0.54,0.54,0.52,0.53,+0.09,20.45,86000,3,46190,0,0,0,0,0,0,0,86000,-86000,-86000
20200430,708003,宜鼎元大96購01,,,,,,0.00,0,0,0,0,0,0,0,0,0,0,0,0,0
20200430,708004,雍智元大97購02,,,,,,0.00,0,0,0,0,0,0,0,0,0,0,0,0,0
20200430,708005,精測元大97購03,0.26,0.26,0.24,0.25,+0.01,4.17,871000,7,215850,0,0,0,0,0,0,870000,1000,869000,869000
20200430,708006,精華元大96購03,,,,,,0.00,0,0,0,0,0,0,0,0,0,0,0,0,0
20200430,708007,雍智元富96購01,0.04,0.04,0.03,0.03,-0.42,-93.33,50000,2,1600,0,0,0,0,0,0,0,0,0,0
20200430,708008,精測元富96購03,0.06,0.06,0.06,0.06,+0.01,20.0,100000,1,6000,0,0,0,0,0,0,0,100000,-100000,-100000
20200430,708009,精測台新96購01,,,,,,0.00,0,0,0,0,0,0,0,0,0,0,0,0,0
20200430,708010,璟德台新96購01,0.05,0.05,0.05,0.05,-0.52,-91.23,10000,1,500,0,0,0,0,0,0,0,10000,-10000,-10000
20200430,708011,良維兆豐97購01,1.43,1.47,1.43,1.47,+0.07,5.0,102000,7,147860,0,0,0,0,0,0,102000,0,102000,102000
20200430,708012,聚積兆豐97購01,,,,,,0.00,0,0,0,0,0,0,0,0,0,0,0,0,0
20200430,708013,廣明兆豐96購01,0.70,0.72,0.58,0.58,-0.12,-17.14,121000,21,80840,0,0,0,0,0,0,91000,63000,28000,28000
20200430,708014,聯亞兆豐97購01,3.19,3.19,3.19,3.19,+0.06,1.92,10000,1,31900,0,0,0,0,0,0,10000,0,10000,10000
20200430,708015,鈺太康和96購01,,,,,,0.00,0,0,0,0,0,0,0,0,0,0,0,0,0
20200430,708016,新普群益98購02,1.47,1.56,1.47,1.56,-0.03,-1.89,18000,2,26910,0,0,0,0,0,0,13000,18000,-5000,-5000
20200430,708017,精測群益96購06,,,,,,0.00,0,0,0,0,0,0,0,0,0,0,0,0,0
20200430,708018,雙鴻群益98購01,,,,,,0.00,0,0,0,0,0,0,0,0,0,0,0,0,0
20200430,708019,世界麥證96購01,,,,,,0.00,0,0,0,0,0,0,0,0,0,0,0,0,0
20200430,708020,世界元富96購02,0.10,0.10,0.10,0.10,-0.08,-44.44,60000,1,6000,0,0,0,0,0,0,60000,0,60000,60000
20200430,708021,勝麗元富96購01,,,,,,0.00,0,0,0,0,0,0,0,0,0,0,0,0,0
20200430,708022,璟德元富96購01,,,,,,0.00,0,0,0,0,0,0,0,0,0,0,0,0,0
20200430,708023,鈺太元富96購01,,,,,,0.00,0,0,0,0,0,0,0,0,0,0,0,0,0
20200430,708024,金居中信9C購01,0.23,0.30,0.23,0.30,+0.11,57.89,815000,27,234510,0,0,0,0,0,0,123000,691000,-568000,-568000
20200430,708025,勝麗中信9A購01,0.16,0.16,0.16,0.16,+0.03,23.08,7000,2,1120,0,0,0,0,0,0,7000,0,7000,7000
20200430,708026,群聯永豐96購01,0.05,0.05,0.05,0.05,+0.01,25.0,30000,1,1500,0,0,0,0,0,0,0,0,0,0
20200430,708027,精測永豐96購10,,,,,,0.00,0,0,0,0,0,0,0,0,0,0,0,0,0
20200430,708028,鈺太永豐96購01,0.13,0.13,0.13,0.13,+0.03,30.0,185000,2,24050,0,0,0,0,0,0,165000,20000,145000,145000
20200430,708029,旺矽國票97購01,0.20,0.20,0.20,0.20,+0.06,42.86,1000,1,200,0,0,0,0,0,0,0,0,0,0
20200430,708030,精華國票97購01,,,,,,0.00,0,0,0,0,0,0,0,0,0,0,0,0,0
20200430,708031,中美晶凱基96購04,1.48,1.68,1.48,1.61,+0.13,8.78,50000,11,79080,0,0,0,0,0,0,30000,28000,2000,2000
20200430,708032,六角凱基97購01,0.59,0.63,0.59,0.63,+0.20,46.51,20000,2,12200,0,0,0,0,0,0,10000,10000,0,0
20200430,708033,昂寶凱基97購01,,,,,,0.00,0,0,0,0,0,0,0,0,0,0,0,0,0
20200430,708034,勝麗凱基96購01,0.45,0.45,0.45,0.45,+0.08,21.62,20000,1,9000,0,0,0,0,0,0,0,20000,-20000,-20000
20200430,708035,博智凱基96購01,,,,,,0.00,0,0,0,0,0,0,0,0,0,0,0,0,0
20200430,708036,優群凱基98購01,,,,,,0.00,0,0,0,0,0,0,0,0,0,0,0,0,0
20200430,708037,環球晶凱基96購07,1.75,2.04,1.75,2.04,+0.44,27.5,69000,6,135060,0,0,0,0,0,0,6000,64000,-58000,-58000
20200430,708038,穩懋凱基96購11,1.25,1.25,1.17,1.17,+0.12,11.43,22000,2,27180,0,0,0,0,0,0,22000,0,22000,22000
20200430,708039,宣德國泰98購01,,,,,,0.00,0,0,0,0,0,0,0,0,0,0,0,0,0
20200430,708040,雍智國泰98購02,1.98,2.24,1.98,2.24,+0.35,18.52,205000,10,423590,0,0,0,0,0,0,62000,143000,-81000,-81000
20200430,708041,精測國泰98購04,,,,,,0.00,0,0,0,0,0,0,0,0,0,0,0,0,0
20200430,708042,精測國泰99購01,,,,,,0.00,0,0,0,0,0,0,0,0,0,0,0,0,0
20200430,708043,精測國泰9A購01,,,,,,0.00,0,0,0,0,0,0,0,0,0,0,0,0,0
20200430,708044,雙鴻富邦97購02,,,,,,0.00,0,0,0,0,0,0,0,0,0,0,0,0,0
20200430,708045,大江元大97購02,0.46,0.46,0.46,0.46,+0.05,12.2,10000,1,4600,0,0,0,0,0,0,0,10000,-10000,-10000
20200430,708046,中美晶元大96購03,,,,,,0.00,0,0,0,0,0,0,0,0,0,0,0,0,0
20200430,708047,世界元大96購06,0.40,0.43,0.39,0.43,+0.07,19.44,403000,11,164570,0,0,0,0,0,0,335000,68000,267000,267000
20200430,708048,合晶元大96購05,0.22,0.22,0.22,0.22,+0.03,15.79,1000,1,220,0,0,0,0,0,0,1000,0,1000,1000
20200430,708049,信驊元大96購01,1.85,1.85,1.85,1.85,+0.04,2.21,60000,1,111000,0,0,0,0,0,0,60000,0,60000,60000
20200430,708050,雍智元大96購01,,,,,,0.00,0,0,0,0,0,0,0,0,0,0,0,0,0
20200430,708051,精測元大96購04,,,,,,0.00,0,0,0,0,0,0,0,0,0,0,0,0,0
20200430,708052,穩懋元大96購05,,,,,,0.00,0,0,0,0,0,0,0,0,0,0,0,0,0
20200430,708053,鈺太元大97購02,,,,,,0.00,0,0,0,0,0,0,0,0,0,0,0,0,0
20200430,708054,力旺元富96購01,,,,,,0.00,0,0,0,0,0,0,0,0,0,0,0,0,0
20200430,708055,金可中信9A購01,0.07,0.10,0.06,0.10,+0.03,42.86,68000,6,6140,0,0,0,0,0,0,47000,21000,26000,26000
20200430,708056,聖暉統一99購01,0.72,0.72,0.68,0.68,+0.08,13.33,24000,2,16480,0,0,0,0,0,0,0,24000,-24000,-24000
20200430,708057,大江凱基98購01,0.15,0.18,0.15,0.18,+0.06,50.0,98000,3,15240,0,0,0,0,0,0,0,10000,-10000,-10000
20200430,708058,良維凱基98購01,,,,,,0.00,0,0,0,0,0,0,0,0,0,0,0,0,0
20200430,708059,旺矽凱基98購01,0.67,0.78,0.67,0.78,+0.08,11.43,166000,7,123930,0,0,0,0,0,0,118000,166000,-48000,-48000
20200430,708060,信驊凱基96購02,,,,,,0.00,0,0,0,0,0,0,0,0,0,0,0,0,0
20200430,708061,雍智凱基98購01,,,,,,0.00,0,0,0,0,0,0,0,0,0,0,0,0,0
20200430,708062,精測凱基99購01,0.20,0.20,0.19,0.20,+0.10,100.0,94000,5,18700,0,0,0,0,0,0,0,0,0,0
20200430,708063,緯軟凱基98購01,,,,,,0.00,0,0,0,0,0,0,0,0,0,0,0,0,0
20200430,708064,環球晶凱基96購08,0.52,0.76,0.52,0.76,+0.19,33.33,165000,4,110800,0,0,0,0,0,0,165000,0,165000,165000
20200430,708065,力旺永豐96購02,,,,,,0.00,0,0,0,0,0,0,0,0,0,0,0,0,0
20200430,708066,同致永豐96購01,,,,,,0.00,0,0,0,0,0,0,0,0,0,0,0,0,0
20200430,708067,迅得永豐97購02,,,,,,0.00,0,0,0,0,0,0,0,0,0,0,0,0,0
20200430,708068,欣銓永豐96購01,,,,,,0.00,0,0,0,0,0,0,0,0,0,0,0,0,0
20200430,708069,弘塑康和9C購01,0.45,0.52,0.44,0.49,+0.07,16.67,3976000,36,1888550,0,0,0,0,0,0,1810000,2166000,-356000,-356000
20200430,708070,大田群益96購01,0.48,0.48,0.48,0.48,+0.03,6.67,20000,1,9600,0,0,0,0,0,0,0,20000,-20000,-20000
20200430,708071,合晶群益96購02,0.95,1.06,0.95,1.06,+0.21,24.71,234000,11,238020,0,0,0,0,0,0,6000,232000,-226000,-226000
20200430,708072,信昌電群益96購02,1.67,1.82,1.64,1.82,+0.32,21.33,158000,10,262500,0,0,0,0,0,0,85000,78000,7000,7000
20200430,708073,茂達群益98購01,,,,,,0.00,0,0,0,0,0,0,0,0,0,0,0,0,0
20200430,708074,大宇資國票97購02,,,,,,0.00,0,0,0,0,0,0,0,0,0,0,0,0,0
20200430,708075,雙鴻國票97購02,0.29,0.29,0.29,0.29,0.00,0.0,1000,1,290,0,0,0,0,0,0,0,0,0,0
20200430,708076,力旺國泰98購01,,,,,,0.00,0,0,0,0,0,0,0,0,0,0,0,0,0
20200430,708077,威剛富邦98購01,0.35,0.35,0.35,0.35,+0.10,40.0,5000,1,1750,0,0,0,0,0,0,0,0,0,0
20200430,708078,勝麗富邦97購01,,,,,,0.00,0,0,0,0,0,0,0,0,0,0,0,0,0
20200430,708079,群聯富邦98購01,0.22,0.22,0.22,0.22,+0.01,4.76,1000,1,220,0,0,0,0,0,0,1000,0,1000,1000
20200430,708080,精測富邦97購01,0.01,0.01,0.01,0.01,0.00,0.0,10000,1,100,0,0,0,0,0,0,0,0,0,0
20200430,708081,信驊元大96購02,3.40,3.51,3.29,3.51,+0.33,10.38,84000,5,286000,0,0,0,0,0,0,74000,10000,64000,64000
20200430,708082,新普元大97購01,,,,,,0.00,0,0,0,0,0,0,0,0,0,0,0,0,0
20200430,708083,環球晶元大96購03,1.59,1.97,1.59,1.97,+0.45,29.61,252000,15,435140,0,0,0,0,0,0,62000,192000,-130000,-130000
20200430,708084,環球晶元大97購01,2.46,2.81,2.40,2.81,+0.49,21.12,282000,42,738460,0,0,0,0,0,0,82000,200000,-118000,-118000
20200430,708085,穩懋元大96購06,,,,,,0.00,0,0,0,0,0,0,0,0,0,0,0,0,0
20200430,708086,穩懋元大96購07,,,,,,0.00,0,0,0,0,0,0,0,0,0,0,0,0,0
20200430,708087,群聯元富96購03,3.48,3.48,3.36,3.36,+0.30,9.8,20000,2,68400,0,0,0,0,0,0,10000,10000,0,0
20200430,708088,群聯兆豐97購01,,,,,,0.00,0,0,0,0,0,0,0,0,0,0,0,0,0
20200430,708089,精測兆豐97購03,,,,,,0.00,0,0,0,0,0,0,0,0,0,0,0,0,0
20200430,708090,穩懋兆豐96購04,0.77,0.77,0.77,0.77,+0.15,24.19,7000,1,5390,0,0,0,0,0,0,7000,0,7000,7000
20200430,708091,久元康和96購01,0.60,0.60,0.59,0.59,-0.01,-1.67,81000,3,48040,0,0,0,0,0,0,35000,46000,-11000,-11000
20200430,708092,櫃200永昌98購01,,,,,,0.00,0,0,0,0,0,0,0,0,0,0,0,0,0
20200430,708093,櫃200永昌98購02,,,,,,0.00,0,0,0,0,0,0,0,0,0,0,0,0,0
20200430,708094,大學光群益98購01,1.33,1.33,1.33,1.33,-0.05,-3.62,7000,1,9310,0,0,0,0,0,0,7000,0,7000,7000
20200430,708095,VHQ中信96購01,,,,,,0.00,0,0,0,0,0,0,0,0,0,0,0,0,0
20200430,708096,合晶中信9A購01,0.23,0.27,0.23,0.27,+0.07,35.0,412000,33,100960,0,0,0,0,0,0,110000,285000,-175000,-175000
20200430,708097,宣德中信9A購02,0.10,0.12,0.10,0.12,+0.01,9.09,31000,4,3320,0,0,0,0,0,0,0,31000,-31000,-31000
20200430,708098,群聯中信9A購01,,,,,,0.00,0,0,0,0,0,0,0,0,0,0,0,0,0
20200430,708099,M31凱基97購02,,,,,,0.00,0,0,0,0,0,0,0,0,0,0,0,0,0
20200430,708100,大江凱基96購03,0.43,0.43,0.40,0.40,+0.01,2.56,104000,5,41700,0,0,0,0,0,0,4000,100000,-96000,-96000
20200430,708101,合晶凱基97購01,,,,,,0.00,0,0,0,0,0,0,0,0,0,0,0,0,0
20200430,708102,良維凱基97購01,0.36,0.36,0.36,0.36,-0.02,-5.26,61000,3,21960,0,0,0,0,0,0,61000,0,61000,61000
20200430,708103,宜鼎凱基96購02,3.23,3.23,3.23,3.23,+0.33,11.38,20000,20,64600,0,0,0,0,0,0,20000,20000,0,0
20200430,708104,晶焱凱基98購01,,,,,,0.00,0,0,0,0,0,0,0,0,0,0,0,0,0
20200430,708105,旺矽統一97購01,,,,,,0.00,0,0,0,0,0,0,0,0,0,0,0,0,0
20200430,708106,宣德統一97購02,0.21,0.21,0.21,0.21,+0.03,16.67,1000,1,210,0,0,0,0,0,0,1000,0,1000,1000
20200430,708107,大江永豐96購03,0.51,0.51,0.48,0.48,+0.03,6.67,15000,5,7540,0,0,0,0,0,0,5000,10000,-5000,-5000
20200430,708108,昂寶永豐96購02,,,,,,0.00,0,0,0,0,0,0,0,0,0,0,0,0,0
20200430,708109,昇達科永豐96購02,,,,,,0.00,0,0,0,0,0,0,0,0,0,0,0,0,0
20200430,708110,博智永豐96購02,1.60,1.66,1.60,1.65,+0.12,7.84,31000,3,50250,0,0,0,0,0,0,30000,1000,29000,29000
20200430,708111,新鉅科永豐96購01,,,,,,0.00,0,0,0,0,0,0,0,0,0,0,0,0,0
20200430,708112,晟德永豐96購01,,,,,,0.00,0,0,0,0,0,0,0,0,0,0,0,0,0
20200430,708113,世界元大96購07,0.13,0.15,0.13,0.15,+0.03,25.0,165000,7,24000,0,0,0,0,0,0,165000,0,165000,165000
20200430,708114,良維元大97購02,0.81,0.81,0.81,0.81,-0.01,-1.22,50000,1,40500,0,0,0,0,0,0,50000,0,50000,50000
20200430,708115,佳邦元大96購01,,,,,,0.00,0,0,0,0,0,0,0,0,0,0,0,0,0
20200430,708116,昂寶元大96購03,,,,,,0.00,0,0,0,0,0,0,0,0,0,0,0,0,0
20200430,708117,廣明元大97購01,,,,,,0.00,0,0,0,0,0,0,0,0,0,0,0,0,0
20200430,708118,環球晶元大96購04,,,,,,0.00,0,0,0,0,0,0,0,0,0,0,0,0,0
20200430,708119,環球晶元大97購02,,,,,,0.00,0,0,0,0,0,0,0,0,0,0,0,0,0
20200430,708120,穩懋元大96購10,0.34,0.34,0.30,0.30,+0.06,25.0,65000,2,19700,0,0,0,0,0,0,65000,60000,5000,5000
20200430,708121,M31國票97購01,0.31,0.35,0.31,0.35,+0.17,94.44,5000,2,1670,0,0,0,0,0,0,0,0,0,0
20200430,708122,六角國票98購02,1.02,1.10,0.95,1.08,+0.13,13.68,874000,35,866480,0,0,0,0,0,0,785000,104000,681000,681000
20200430,708123,原相國票97購01,2.11,2.15,2.11,2.13,-0.02,-0.93,47000,3,99410,0,0,0,0,0,0,45000,2000,43000,43000
20200430,708124,神盾國票97購02,,,,,,0.00,0,0,0,0,0,0,0,0,0,0,0,0,0
20200430,708125,碩禾國票97購01,,,,,,0.00,0,0,0,0,0,0,0,0,0,0,0,0,0
20200430,708126,環宇國票97購01,,,,,,0.00,0,0,0,0,0,0,0,0,0,0,0,0,0
20200430,708127,昂寶國泰98購01,,,,,,0.00,0,0,0,0,0,0,0,0,0,0,0,0,0
20200430,708128,環球晶國泰97購02,1.59,1.59,1.59,1.59,+0.55,52.88,10000,1,15900,0,0,0,0,0,0,10000,10000,0,0
20200430,708129,力旺元大96購01,,,,,,0.00,0,0,0,0,0,0,0,0,0,0,0,0,0
20200430,708130,台燿元大96購02,0.75,0.75,0.74,0.74,+0.23,45.1,160000,2,119900,0,0,0,0,0,0,10000,150000,-140000,-140000
20200430,708131,泰博元大96購01,,,,,,0.00,0,0,0,0,0,0,0,0,0,0,0,0,0
20200430,708132,博智元大97購01,5.60,5.75,5.55,5.65,+0.30,5.61,44000,7,249950,0,0,0,0,0,0,24000,39000,-15000,-15000
20200430,708133,網家元大96購01,,,,,,0.00,0,0,0,0,0,0,0,0,0,0,0,0,0
20200430,708134,穩懋元大96購11,,,,,,0.00,0,0,0,0,0,0,0,0,0,0,0,0,0
20200430,708135,群聯群益96購04,,,,,,0.00,0,0,0,0,0,0,0,0,0,0,0,0,0
20200430,708136,宇峻凱基98購02,0.55,0.55,0.55,0.55,-0.14,-20.29,90000,1,49500,0,0,0,0,0,0,90000,0,90000,90000
20200430,708137,旺矽凱基97購01,0.18,0.19,0.18,0.19,+0.04,26.67,109000,3,20650,0,0,0,0,0,0,9000,100000,-91000,-91000
20200430,708138,原相凱基98購01,,,,,,0.00,0,0,0,0,0,0,0,0,0,0,0,0,0
20200430,708139,精華凱基97購01,,,,,,0.00,0,0,0,0,0,0,0,0,0,0,0,0,0
20200430,708140,優群凱基98購02,,,,,,0.00,0,0,0,0,0,0,0,0,0,0,0,0,0
20200430,708141,鈊象凱基98購02,6.80,6.80,6.15,6.15,-0.55,-8.21,44000,15,282750,0,0,0,0,0,0,19000,34000,-15000,-15000
20200430,708142,宣德台新96購02,0.10,0.10,0.05,0.05,0.00,0.0,22000,4,1700,0,0,0,0,0,0,0,10000,-10000,-10000
20200430,708143,大江永豐97購01,,,,,,0.00,0,0,0,0,0,0,0,0,0,0,0,0,0
20200430,708144,杰力永豐96購01,,,,,,0.00,0,0,0,0,0,0,0,0,0,0,0,0,0
20200430,708145,直得永豐96購01,0.40,0.60,0.40,0.58,+0.19,48.72,172000,10,82400,0,0,0,0,0,0,87000,85000,2000,2000
20200430,708146,信昌電永豐96購02,1.31,1.47,1.31,1.39,+0.19,15.83,107000,14,145890,0,0,0,0,0,0,35000,77000,-42000,-42000
20200430,708147,保瑞永豐96購01,0.43,0.43,0.43,0.43,+0.02,4.88,12000,1,5160,0,0,0,0,0,0,12000,0,12000,12000
20200430,708148,胡連永豐96購01,,,,,,0.00,0,0,0,0,0,0,0,0,0,0,0,0,0
20200430,708149,精測永豐96購12,,,,,,0.00,0,0,0,0,0,0,0,0,0,0,0,0,0
20200430,708150,聚積永豐96購01,,,,,,0.00,0,0,0,0,0,0,0,0,0,0,0,0,0
20200430,708151,雙鴻永豐97購02,0.22,0.22,0.22,0.22,0.00,0.0,10000,1,2200,0,0,0,0,0,0,10000,0,10000,10000
20200430,708152,力旺中信96購01,,,,,,0.00,0,0,0,0,0,0,0,0,0,0,0,0,0
20200430,708153,建榮統一98購01,,,,,,0.00,0,0,0,0,0,0,0,0,0,0,0,0,0
20200430,708154,大江凱基98購02,0.12,0.12,0.10,0.12,0.00,0.0,16000,3,1640,0,0,0,0,0,0,0,0,0,0
20200430,708155,宇峻凱基98購03,,,,,,0.00,0,0,0,0,0,0,0,0,0,0,0,0,0
20200430,708156,昂寶凱基97購02,,,,,,0.00,0,0,0,0,0,0,0,0,0,0,0,0,0
20200430,708157,金居凱基97購01,,,,,,0.00,0,0,0,0,0,0,0,0,0,0,0,0,0
20200430,708158,鐿鈦凱基96購03,,,,,,0.00,0,0,0,0,0,0,0,0,0,0,0,0,0
20200430,708159,大江元大97購03,,,,,,0.00,0,0,0,0,0,0,0,0,0,0,0,0,0
20200430,708160,合晶元大98購01,0.36,0.36,0.36,0.36,+0.08,28.57,30000,1,10800,0,0,0,0,0,0,30000,0,30000,30000
20200430,708161,昂寶元大96購04,,,,,,0.00,0,0,0,0,0,0,0,0,0,0,0,0,0
20200430,708162,欣銓元大96購01,,,,,,0.00,0,0,0,0,0,0,0,0,0,0,0,0,0
20200430,708163,威剛元大98購01,0.28,0.28,0.26,0.26,-0.01,-3.7,228000,5,60580,0,0,0,0,0,0,0,0,0,0
20200430,708164,環球晶元大96購05,0.58,0.64,0.49,0.58,+0.14,31.82,120000,17,60770,0,0,0,0,0,0,19000,112000,-93000,-93000
20200430,708165,環球晶元大97購03,,,,,,0.00,0,0,0,0,0,0,0,0,0,0,0,0,0
20200430,708166,凡甲永豐96購02,2.16,2.21,2.09,2.09,-0.15,-6.7,42000,5,90610,0,0,0,0,0,0,32000,27000,5000,5000
20200430,708167,台燿永豐96購01,0.17,0.18,0.15,0.17,+0.05,41.67,356000,5,58530,0,0,0,0,0,0,255000,101000,154000,154000
20200430,708168,波若威永豐97購02,,,,,,0.00,0,0,0,0,0,0,0,0,0,0,0,0,0
20200430,708169,網家永豐96購01,0.29,0.29,0.29,0.29,-0.02,-6.45,20000,1,5800,0,0,0,0,0,0,20000,0,20000,20000
20200430,708170,網龍永豐96購03,,,,,,0.00,0,0,0,0,0,0,0,0,0,0,0,0,0
20200430,708171,優群永豐96購03,,,,,,0.00,0,0,0,0,0,0,0,0,0,0,0,0,0
20200430,708172,緯軟兆豐97購01,0.41,0.51,0.41,0.44,+0.07,18.92,226000,12,103390,0,0,0,0,0,0,0,226000,-226000,-226000
20200430,708173,鈺太兆豐97購01,0.19,0.19,0.19,0.19,0.00,0.0,1000,1,190,0,0,0,0,0,0,0,1000,-1000,-1000
20200430,708174,胡連康和96購02,,,,,,0.00,0,0,0,0,0,0,0,0,0,0,0,0,0
20200430,708175,精華群益96購02,,,,,,0.00,0,0,0,0,0,0,0,0,0,0,0,0,0
20200430,708176,中美晶國票97購02,,,,,,0.00,0,0,0,0,0,0,0,0,0,0,0,0,0
20200430,708177,欣銓富邦97購01,,,,,,0.00,0,0,0,0,0,0,0,0,0,0,0,0,0
20200430,708178,鈊象富邦97購01,1.83,1.83,1.74,1.74,-0.12,-6.45,2000,2,3570,0,0,0,0,0,0,0,2000,-2000,-2000
20200430,708179,神盾元富98購01,0.26,0.26,0.26,0.26,0.00,0.0,10000,1,2600,0,0,0,0,0,0,10000,0,10000,10000
20200430,708180,群聯元富96購04,0.01,0.01,0.01,0.01,0.00,0.0,500000,3,5000,0,0,0,0,0,0,500000,0,500000,500000
20200430,708181,VHQ統一96購01,,,,,,0.00,0,0,0,0,0,0,0,0,0,0,0,0,0
20200430,708182,凡甲統一96購01,2.07,2.10,2.03,2.03,-0.18,-8.14,111000,5,231250,0,0,0,0,0,0,81000,30000,51000,51000
20200430,708183,中美晶凱基96購05,1.45,1.46,1.42,1.42,+0.11,8.4,17000,9,24620,0,0,0,0,0,0,8000,17000,-9000,-9000
20200430,708184,建榮凱基96購02,,,,,,0.00,0,0,0,0,0,0,0,0,0,0,0,0,0
20200430,708185,原相凱基97購01,,,,,,0.00,0,0,0,0,0,0,0,0,0,0,0,0,0
20200430,708186,神盾凱基96購03,0.24,0.26,0.24,0.26,+0.02,8.33,40000,2,9800,0,0,0,0,0,0,40000,0,40000,40000
20200430,708187,金居兆豐97購01,1.13,1.33,1.07,1.33,+0.41,44.57,518000,38,591570,0,0,0,0,0,0,186000,294000,-108000,-108000
20200430,708188,威剛兆豐97購01,0.83,0.88,0.82,0.83,+0.01,1.22,259000,12,218950,0,0,0,0,0,0,246000,13000,233000,233000
20200430,708189,茂達群益98購02,0.84,0.92,0.84,0.91,+0.14,18.18,83000,6,73530,0,0,0,0,0,0,83000,53000,30000,30000
20200430,708190,六角元大96購02,,,,,,0.00,0,0,0,0,0,0,0,0,0,0,0,0,0
20200430,708191,同致元大96購02,0.37,0.38,0.37,0.38,+0.03,8.57,140000,2,52200,0,0,0,0,0,0,0,140000,-140000,-140000
20200430,708192,旺矽元大97購01,0.74,0.83,0.74,0.83,+0.11,15.28,227000,7,179680,0,0,0,0,0,0,150000,97000,53000,53000
20200430,708193,直得元大96購01,0.31,0.47,0.31,0.47,+0.18,62.07,24000,3,10120,0,0,0,0,0,0,24000,0,24000,24000
20200430,708194,宣德元大97購01,1.22,1.36,1.22,1.36,0.00,0.0,321000,15,415490,0,0,0,0,0,0,55000,236000,-181000,-181000
20200430,708195,精測元大96購07,,,,,,0.00,0,0,0,0,0,0,0,0,0,0,0,0,0
20200430,708196,環宇元大96購02,,,,,,0.00,0,0,0,0,0,0,0,0,0,0,0,0,0
20200430,708197,合晶亞東97購01,,,,,,0.00,0,0,0,0,0,0,0,0,0,0,0,0,0
20200430,708198,三貝德永豐96購01,,,,,,0.00,0,0,0,0,0,0,0,0,0,0,0,0,0
20200430,708199,大田永豐96購02,,,,,,0.00,0,0,0,0,0,0,0,0,0,0,0,0,0
20200430,708200,中美晶永豐96購03,0.02,0.02,0.02,0.02,-0.04,-66.67,250000,1,5000,0,0,0,0,0,0,250000,0,250000,250000
20200430,708201,金居永豐96購02,0.50,0.56,0.50,0.56,+0.26,86.67,40000,3,20720,0,0,0,0,0,0,0,40000,-40000,-40000
20200430,708202,碩禾永豐96購01,,,,,,0.00,0,0,0,0,0,0,0,0,0,0,0,0,0
20200430,708203,雙鴻永豐96購02,,,,,,0.00,0,0,0,0,0,0,0,0,0,0,0,0,0
20200430,708204,昂寶元富96購01,,,,,,0.00,0,0,0,0,0,0,0,0,0,0,0,0,0
20200430,708205,力旺台新97購02,0.12,0.12,0.12,0.12,+0.01,9.09,40000,1,4800,0,0,0,0,0,0,40000,0,40000,40000
20200430,708206,大江國票97購04,,,,,,0.00,0,0,0,0,0,0,0,0,0,0,0,0,0
20200430,708207,大學光國票98購01,2.69,2.69,2.69,2.69,0.00,0.0,5000,1,13450,0,0,0,0,0,0,5000,0,5000,5000
20200430,708208,勝麗國票97購03,0.30,0.34,0.30,0.34,+0.09,36.0,608000,7,196760,0,0,0,0,0,0,0,608000,-608000,-608000
20200430,708209,博智國票97購01,,,,,,0.00,0,0,0,0,0,0,0,0,0,0,0,0,0
20200430,708210,閎康國票97購02,1.32,1.32,1.24,1.27,-0.15,-10.56,432000,10,554350,0,0,0,0,0,0,358000,87000,271000,271000
20200430,708211,精華國票97購02,0.49,0.56,0.49,0.56,+0.14,33.33,5000,2,2660,0,0,0,0,0,0,0,5000,-5000,-5000
20200430,708212,鈺太國泰96購01,0.37,0.37,0.33,0.33,-0.02,-5.71,688000,12,234120,0,0,0,0,0,0,668000,0,668000,668000
20200430,708213,群聯富邦97購02,0.09,0.09,0.09,0.09,+0.03,50.0,10000,1,900,0,0,0,0,0,0,10000,0,10000,10000
20200430,708214,鈺太統一99購01,,,,,,0.00,0,0,0,0,0,0,0,0,0,0,0,0,0
20200430,708215,久元凱基96購01,,,,,,0.00,0,0,0,0,0,0,0,0,0,0,0,0,0
20200430,708216,勝麗凱基98購01,0.57,0.62,0.57,0.62,+0.08,14.81,74000,5,44640,0,0,0,0,0,0,0,74000,-74000,-74000
20200430,708217,碩禾凱基98購01,,,,,,0.00,0,0,0,0,0,0,0,0,0,0,0,0,0
20200430,708218,中美晶元富96購01,,,,,,0.00,0,0,0,0,0,0,0,0,0,0,0,0,0
20200430,708219,新普元富96購01,3.34,3.34,3.27,3.33,-0.09,-2.63,131000,4,430490,0,0,0,0,0,0,76000,55000,21000,21000
20200430,708220,雙鴻台新97購01,0.15,0.15,0.02,0.02,-0.12,-85.71,30000,2,3200,0,0,0,0,0,0,20000,10000,10000,10000
20200430,708221,VHQ康和96購01,0.08,0.08,0.08,0.08,+0.01,14.29,6000,1,480,0,0,0,0,0,0,0,0,0,0
20200430,708222,網家康和96購01,,,,,,0.00,0,0,0,0,0,0,0,0,0,0,0,0,0
20200430,708223,台半群益96購01,,,,,,0.00,0,0,0,0,0,0,0,0,0,0,0,0,0
20200430,708224,良維群益96購01,,,,,,0.00,0,0,0,0,0,0,0,0,0,0,0,0,0
20200430,708225,昂寶群益98購01,0.48,0.48,0.48,0.48,-0.14,-22.58,40000,4,19200,0,0,0,0,0,0,40000,0,40000,40000
20200430,708226,信昌電群益96購03,,,,,,0.00,0,0,0,0,0,0,0,0,0,0,0,0,0
20200430,708227,鈊象群益99購04,,,,,,0.00,0,0,0,0,0,0,0,0,0,0,0,0,0
20200430,708228,波若威永豐96購01,,,,,,0.00,0,0,0,0,0,0,0,0,0,0,0,0,0
20200430,708229,中美晶亞東96購01,,,,,,0.00,0,0,0,0,0,0,0,0,0,0,0,0,0
20200430,708230,群聯亞東96購01,,,,,,0.00,0,0,0,0,0,0,0,0,0,0,0,0,0
20200430,708231,六角國票98購03,0.41,0.48,0.39,0.48,+0.08,20.0,917000,20,415020,0,0,0,0,0,0,624000,291000,333000,333000
20200430,708232,宜鼎國票97購03,4.01,4.18,4.01,4.17,+0.40,10.61,98000,7,403190,0,0,0,0,0,0,35000,63000,-28000,-28000
20200430,708233,宣德國票97購01,0.84,0.93,0.83,0.93,-0.04,-4.12,155000,8,134470,0,0,0,0,0,0,121000,34000,87000,87000
20200430,708234,神盾國票98購01,0.28,0.32,0.28,0.32,+0.01,3.23,135000,8,40550,0,0,0,0,0,0,50000,81000,-31000,-31000
20200430,708235,璟德國票97購01,1.51,1.73,1.51,1.65,+0.12,7.84,494000,8,800170,0,0,0,0,0,0,349000,145000,204000,204000
20200430,708236,優群國票97購01,3.76,3.76,3.76,3.76,-0.07,-1.83,10000,1,37600,0,0,0,0,0,0,10000,0,10000,10000
20200430,708237,環宇國票97購02,,,,,,0.00,0,0,0,0,0,0,0,0,0,0,0,0,0
20200430,708238,三貝德元大97購01,,,,,,0.00,0,0,0,0,0,0,0,0,0,0,0,0,0
20200430,708239,中美晶元大96購04,0.75,0.75,0.75,0.75,+0.11,17.19,5000,1,3750,0,0,0,0,0,0,5000,0,5000,5000
20200430,708240,宇峻元大97購02,1.59,1.61,1.49,1.51,-0.08,-5.03,269000,21,419390,0,0,0,0,0,0,257000,12000,245000,245000
20200430,708241,聯亞元大97購02,2.69,2.69,2.69,2.69,-0.31,-10.33,1000,1,2690,0,0,0,0,0,0,1000,0,1000,1000
20200430,708242,穩懋元大97購02,0.67,0.67,0.65,0.65,+0.07,12.07,127000,2,83550,0,0,0,0,0,0,127000,77000,50000,50000
20200430,708243,譜瑞元大97購01,3.50,3.51,3.43,3.51,+0.08,2.33,210000,18,728300,0,0,0,0,0,0,110000,100000,10000,10000
20200430,708244,原相國泰98購02,,,,,,0.00,0,0,0,0,0,0,0,0,0,0,0,0,0
20200430,708245,勝麗國泰98購01,0.66,0.72,0.66,0.72,+0.15,26.32,23000,5,16400,0,0,0,0,0,0,1000,21000,-20000,-20000
20200430,708246,網家國泰97購02,,,,,,0.00,0,0,0,0,0,0,0,0,0,0,0,0,0
20200430,708247,原相第一96購01,,,,,,0.00,0,0,0,0,0,0,0,0,0,0,0,0,0
20200430,708248,波若威凱基98購01,,,,,,0.00,0,0,0,0,0,0,0,0,0,0,0,0,0
20200430,708249,雙鴻凱基98購01,,,,,,0.00,0,0,0,0,0,0,0,0,0,0,0,0,0
20200430,708250,穩懋凱基96購12,,,,,,0.00,0,0,0,0,0,0,0,0,0,0,0,0,0
20200430,708251,頎邦凱基97購01,0.26,0.27,0.26,0.27,+0.05,22.73,20000,2,5300,0,0,0,0,0,0,0,20000,-20000,-20000
20200430,708252,頎邦凱基97購02,0.48,0.53,0.47,0.51,+0.05,10.87,542000,28,269530,0,0,0,0,0,0,97000,445000,-348000,-348000
20200430,708253,大江元富96購02,0.60,0.60,0.60,0.60,+0.03,5.26,10000,1,6000,0,0,0,0,0,0,0,10000,-10000,-10000
20200430,708254,頎邦元富96購01,0.29,0.29,0.29,0.29,+0.03,11.54,100000,1,29000,0,0,0,0,0,0,0,100000,-100000,-100000
20200430,708255,頎邦元富96購02,0.33,0.37,0.33,0.37,+0.04,12.12,338000,10,118120,0,0,0,0,0,0,0,338000,-338000,-338000
20200430,708256,信昌電永豐96購03,,,,,,0.00,0,0,0,0,0,0,0,0,0,0,0,0,0
20200430,708257,頎邦永豐96購02,0.54,0.59,0.54,0.57,+0.06,11.76,137000,7,74990,0,0,0,0,0,0,0,137000,-137000,-137000
20200430,708258,頎邦永豐96購03,0.12,0.14,0.11,0.14,+0.03,27.27,75000,8,9160,0,0,0,0,0,0,25000,50000,-25000,-25000
20200430,708259,神盾統一96購01,0.24,0.24,0.24,0.24,+0.02,9.09,50000,1,12000,0,0,0,0,0,0,50000,0,50000,50000
20200430,708260,群聯統一98購01,2.42,2.42,2.37,2.38,+0.19,8.68,32000,7,77020,0,0,0,0,0,0,32000,6000,26000,26000
20200430,708261,頎邦統一96購01,0.09,0.09,0.09,0.09,+0.03,50.0,5000,1,450,0,0,0,0,0,0,0,0,0,0
20200430,708262,合晶國票97購02,0.98,1.05,0.98,1.05,+0.22,26.51,151000,6,150010,0,0,0,0,0,0,0,151000,-151000,-151000
20200430,708263,威剛國票97購01,,,,,,0.00,0,0,0,0,0,0,0,0,0,0,0,0,0
20200430,708264,宣德國票97購02,0.55,0.64,0.55,0.64,-0.01,-1.54,309000,8,180710,0,0,0,0,0,0,194000,115000,79000,79000
20200430,708265,聚積國票97購02,1.10,1.10,1.10,1.10,0.00,0.0,1000,1,1100,0,0,0,0,0,0,0,1000,-1000,-1000
20200430,708266,頎邦國票97購01,,,,,,0.00,0,0,0,0,0,0,0,0,0,0,0,0,0
20200430,708267,M31國泰98購01,,,,,,0.00,0,0,0,0,0,0,0,0,0,0,0,0,0
20200430,708268,聯亞國泰98購01,1.09,1.15,1.02,1.02,-0.16,-13.56,136000,14,148640,0,0,0,0,0,0,80000,76000,4000,4000
20200430,708269,頎邦國泰97購01,,,,,,0.00,0,0,0,0,0,0,0,0,0,0,0,0,0
20200430,708270,昂寶富邦98購01,,,,,,0.00,0,0,0,0,0,0,0,0,0,0,0,0,0
20200430,708271,原相富邦98購01,,,,,,0.00,0,0,0,0,0,0,0,0,0,0,0,0,0
20200430,708272,頎邦富邦98購01,0.26,0.26,0.26,0.26,+0.04,18.18,1000,1,260,0,0,0,0,0,0,0,1000,-1000,-1000
20200430,708273,力旺元大96購02,0.92,1.00,0.92,1.00,+0.17,20.48,110000,2,104560,0,0,0,0,0,0,0,110000,-110000,-110000
20200430,708274,中美晶元大96購05,1.05,1.18,1.05,1.12,+0.12,12.0,171000,15,187350,0,0,0,0,0,0,9000,170000,-161000,-161000
20200430,708275,六角元大98購01,0.47,0.50,0.47,0.50,+0.05,11.11,7000,3,3470,0,0,0,0,0,0,0,7000,-7000,-7000
20200430,708276,台半元大96購02,,,,,,0.00,0,0,0,0,0,0,0,0,0,0,0,0,0
20200430,708277,金居元大97購01,0.39,0.39,0.39,0.39,+0.12,44.44,1000,1,390,0,0,0,0,0,0,1000,0,1000,1000
20200430,708278,勝麗元大96購03,0.61,0.65,0.61,0.65,+0.11,20.37,200000,7,127160,0,0,0,0,0,0,0,200000,-200000,-200000
20200430,708279,頎邦元大96購02,,,,,,0.00,0,0,0,0,0,0,0,0,0,0,0,0,0
20200430,708280,頎邦元大96購03,,,,,,0.00,0,0,0,0,0,0,0,0,0,0,0,0,0
20200430,708281,頎邦元大97購01,0.24,0.28,0.24,0.28,-0.02,-6.67,20000,3,5050,0,0,0,0,0,0,20000,0,20000,20000
20200430,708282,兆利群益98購01,,,,,,0.00,0,0,0,0,0,0,0,0,0,0,0,0,0
20200430,708283,頎邦群益97購01,0.48,0.55,0.48,0.55,+0.11,25.0,191000,5,93900,0,0,0,0,0,0,21000,170000,-149000,-149000
20200430,708284,頎邦群益97購02,0.42,0.48,0.42,0.45,+0.05,12.5,336000,5,146230,0,0,0,0,0,0,97000,239000,-142000,-142000
20200430,708285,頎邦群益98購01,0.39,0.39,0.36,0.36,+0.02,5.88,21000,2,8160,0,0,0,0,0,0,1000,20000,-19000,-19000
20200430,708286,三貝德康和96購01,,,,,,0.00,0,0,0,0,0,0,0,0,0,0,0,0,0
20200430,708287,兆利康和9C購01,,,,,,0.00,0,0,0,0,0,0,0,0,0,0,0,0,0
20200430,708288,富喬康和96購01,0.16,0.16,0.15,0.15,-0.04,-21.05,310000,5,46800,0,0,0,0,0,0,310000,0,310000,310000
20200430,708289,杰力群益96購01,0.53,0.53,0.52,0.52,-0.02,-3.7,80000,5,42130,0,0,0,0,0,0,80000,0,80000,80000
20200430,708290,威剛群益97購01,0.15,0.15,0.15,0.15,-0.11,-42.31,20000,1,3000,0,0,0,0,0,0,20000,0,20000,20000
20200430,708291,環宇群益98購01,,,,,,0.00,0,0,0,0,0,0,0,0,0,0,0,0,0
20200430,708292,M31國票97購02,,,,,,0.00,0,0,0,0,0,0,0,0,0,0,0,0,0
20200430,708293,合晶國票98購01,1.11,1.22,1.11,1.22,+0.19,18.45,95000,10,109460,0,0,0,0,0,0,17000,90000,-73000,-73000
20200430,708294,良維國票97購03,1.33,1.35,1.29,1.33,-0.02,-1.48,631000,12,834390,0,0,0,0,0,0,431000,200000,231000,231000
20200430,708295,昂寶國票97購04,,,,,,0.00,0,0,0,0,0,0,0,0,0,0,0,0,0
20200430,708296,威剛國票97購02,0.05,0.05,0.05,0.05,0.00,0.0,10000,1,500,0,0,0,0,0,0,0,0,0,0
20200430,708297,茂達國票97購02,0.87,0.96,0.87,0.96,+0.14,17.07,41000,4,37040,0,0,0,0,0,0,16000,25000,-9000,-9000
20200430,708298,原相國票98購02,,,,,,0.00,0,0,0,0,0,0,0,0,0,0,0,0,0
20200430,708299,穩懋國票97購02,1.67,1.67,1.61,1.64,+0.18,12.33,50000,5,82100,0,0,0,0,0,0,10000,40000,-30000,-30000
20200430,708300,群聯日盛96購01,,,,,,0.00,0,0,0,0,0,0,0,0,0,0,0,0,0
20200430,708301,優群永豐97購01,3.29,3.29,3.29,3.29,-0.19,-5.46,10000,1,32900,0,0,0,0,0,0,0,10000,-10000,-10000
20200430,708302,穩懋永豐96購02,0.43,0.43,0.43,0.43,+0.07,19.44,4000,1,1720,0,0,0,0,0,0,0,4000,-4000,-4000
20200430,708303,伍豐中信9A購01,0.14,0.14,0.14,0.14,+0.01,7.69,5000,1,700,0,0,0,0,0,0,0,5000,-5000,-5000
20200430,708304,同致中信98購02,,,,,,0.00,0,0,0,0,0,0,0,0,0,0,0,0,0
20200430,708305,宜鼎中信9A購01,0.69,0.74,0.68,0.74,+0.12,19.35,1128000,42,793380,0,0,0,0,0,0,451000,638000,-187000,-187000
20200430,708306,閎康統一99購01,0.25,0.25,0.25,0.25,-0.02,-7.41,2000,1,500,0,0,0,0,0,0,2000,0,2000,2000
20200430,708307,頎邦統一96購02,,,,,,0.00,0,0,0,0,0,0,0,0,0,0,0,0,0
20200430,708308,大中凱基98購01,0.15,0.15,0.15,0.15,0.00,0.0,120000,3,18000,0,0,0,0,0,0,120000,0,120000,120000
20200430,708309,大江凱基97購01,0.34,0.34,0.34,0.34,+0.06,21.43,3000,1,1020,0,0,0,0,0,0,0,3000,-3000,-3000
20200430,708310,兆利凱基98購01,,,,,,0.00,0,0,0,0,0,0,0,0,0,0,0,0,0
20200430,708311,迅得凱基97購01,,,,,,0.00,0,0,0,0,0,0,0,0,0,0,0,0,0
20200430,708312,佳邦凱基98購01,,,,,,0.00,0,0,0,0,0,0,0,0,0,0,0,0,0
20200430,708313,金居凱基98購01,0.91,1.04,0.91,1.04,+0.24,30.0,165000,8,157770,0,0,0,0,0,0,35000,130000,-95000,-95000
20200430,708314,聚積凱基98購01,,,,,,0.00,0,0,0,0,0,0,0,0,0,0,0,0,0
20200430,708315,廣明凱基98購01,,,,,,0.00,0,0,0,0,0,0,0,0,0,0,0,0,0
20200430,708316,緯軟凱基98購02,,,,,,0.00,0,0,0,0,0,0,0,0,0,0,0,0,0
20200430,708317,環宇凱基98購01,,,,,,0.00,0,0,0,0,0,0,0,0,0,0,0,0,0
20200430,708318,聯亞凱基98購01,2.65,2.65,2.40,2.40,-0.13,-5.14,84000,10,208440,0,0,0,0,0,0,64000,20000,44000,44000
20200430,708319,穩懋凱基96購13,,,,,,0.00,0,0,0,0,0,0,0,0,0,0,0,0,0
20200430,708320,頎邦凱基96購01,0.31,0.31,0.31,0.31,+0.05,19.23,20000,1,6200,0,0,0,0,0,0,0,20000,-20000,-20000
20200430,708321,大學光元大97購01,,,,,,0.00,0,0,0,0,0,0,0,0,0,0,0,0,0
20200430,708322,群聯元大97購04,0.73,0.73,0.73,0.73,+0.18,32.73,10000,1,7300,0,0,0,0,0,0,10000,10000,0,0
20200430,708323,聯亞元大97購03,0.80,0.80,0.80,0.80,-0.04,-4.76,10000,1,8000,0,0,0,0,0,0,10000,10000,0,0
20200430,708324,新普兆豐97購01,2.01,2.07,2.01,2.07,-0.02,-0.96,107000,5,215900,0,0,0,0,0,0,90000,17000,73000,73000
20200430,708325,穩懋兆豐97購02,1.71,1.71,1.65,1.67,+0.16,10.6,126000,7,212990,0,0,0,0,0,0,93000,33000,60000,60000
20200430,708326,大江日盛96購01,,,,,,0.00,0,0,0,0,0,0,0,0,0,0,0,0,0
20200430,708327,鈊象第一96購01,,,,,,0.00,0,0,0,0,0,0,0,0,0,0,0,0,0
20200430,708328,晶焱元大97購03,0.56,0.56,0.56,0.56,+0.12,27.27,5000,1,2800,0,0,0,0,0,0,0,0,0,0
20200430,708329,頎邦康和96購01,,,,,,0.00,0,0,0,0,0,0,0,0,0,0,0,0,0
20200430,708330,M31群益98購01,,,,,,0.00,0,0,0,0,0,0,0,0,0,0,0,0,0
20200430,708331,中美晶群益96購03,0.03,0.03,0.03,0.03,-0.05,-62.5,600000,3,18000,0,0,0,0,0,0,600000,0,600000,600000
20200430,708332,六角群益98購01,0.53,0.53,0.53,0.53,+0.16,43.24,1000,1,530,0,0,0,0,0,0,0,1000,-1000,-1000
20200430,708333,宇峻群益98購01,0.65,0.65,0.64,0.64,+0.03,4.92,12000,4,7730,0,0,0,0,0,0,0,12000,-12000,-12000
20200430,708334,佳邦群益98購01,,,,,,0.00,0,0,0,0,0,0,0,0,0,0,0,0,0
20200430,708335,網龍群益96購01,,,,,,0.00,0,0,0,0,0,0,0,0,0,0,0,0,0
20200430,708336,大宇資永豐97購01,,,,,,0.00,0,0,0,0,0,0,0,0,0,0,0,0,0
20200430,708337,大學光永豐96購02,,,,,,0.00,0,0,0,0,0,0,0,0,0,0,0,0,0
20200430,708338,伍豐永豐96購01,,,,,,0.00,0,0,0,0,0,0,0,0,0,0,0,0,0
20200430,708339,旺矽永豐97購02,0.12,0.12,0.12,0.12,+0.01,9.09,20000,1,2400,0,0,0,0,0,0,20000,0,20000,20000
20200430,708340,昂寶永豐97購01,,,,,,0.00,0,0,0,0,0,0,0,0,0,0,0,0,0
20200430,708341,美琪瑪永豐96購02,,,,,,0.00,0,0,0,0,0,0,0,0,0,0,0,0,0
20200430,708342,群聯永豐96購02,,,,,,0.00,0,0,0,0,0,0,0,0,0,0,0,0,0
20200430,708343,網龍永豐96購04,,,,,,0.00,0,0,0,0,0,0,0,0,0,0,0,0,0
20200430,708344,聯亞永豐96購03,0.19,0.20,0.19,0.19,-0.01,-5.0,107000,3,20350,0,0,0,0,0,0,107000,0,107000,107000
20200430,708345,鈊象永豐96購05,3.18,3.18,2.53,2.53,-0.42,-14.24,25000,3,70500,0,0,0,0,0,0,20000,5000,15000,15000
20200430,708346,M31統一97購01,0.64,0.69,0.64,0.69,+0.06,9.52,464000,6,316330,0,0,0,0,0,0,25000,439000,-414000,-414000
20200430,708347,環球晶統一96購02,0.60,0.60,0.60,0.60,+0.08,15.38,10000,1,6000,0,0,0,0,0,0,0,0,0,0
20200430,708348,環球晶中信96購02,0.03,0.09,0.03,0.08,+0.02,33.33,138000,14,10220,0,0,0,0,0,0,0,130000,-130000,-130000
20200430,708349,鈺太中信97購01,,,,,,0.00,0,0,0,0,0,0,0,0,0,0,0,0,0
20200430,708350,中美晶台新97購02,,,,,,0.00,0,0,0,0,0,0,0,0,0,0,0,0,0
20200430,708351,穩懋台新97購02,,,,,,0.00,0,0,0,0,0,0,0,0,0,0,0,0,0
20200430,708352,杰力凱基98購01,,,,,,0.00,0,0,0,0,0,0,0,0,0,0,0,0,0
20200430,708353,中美晶富邦97購03,,,,,,0.00,0,0,0,0,0,0,0,0,0,0,0,0,0
20200430,708354,合晶國票99購01,0.84,0.94,0.84,0.94,+0.14,17.5,12000,2,10280,0,0,0,0,0,0,12000,0,12000,12000
20200430,708355,昇達科國票97購01,,,,,,0.00,0,0,0,0,0,0,0,0,0,0,0,0,0
20200430,708356,信昌電國票97購03,1.12,1.12,1.12,1.12,+0.30,36.59,10000,1,11200,0,0,0,0,0,0,0,10000,-10000,-10000
20200430,708357,神盾國票97購03,1.30,1.30,1.21,1.23,-0.01,-0.81,111000,4,137890,0,0,0,0,0,0,111000,0,111000,111000
20200430,708358,群聯國票97購02,,,,,,0.00,0,0,0,0,0,0,0,0,0,0,0,0,0
20200430,708359,中美晶國泰97購02,,,,,,0.00,0,0,0,0,0,0,0,0,0,0,0,0,0
20200430,708360,宇峻國泰97購01,0.66,0.66,0.66,0.66,-0.04,-5.71,30000,1,19800,0,0,0,0,0,0,0,0,0,0
20200430,708361,鈊象國泰98購02,4.92,4.92,4.58,4.58,-0.30,-6.15,25000,3,117050,0,0,0,0,0,0,5000,20000,-15000,-15000
20200430,708362,環球晶統一96購04,,,,,,0.00,0,0,0,0,0,0,0,0,0,0,0,0,0
20200430,708363,台燿中信98購01,0.63,0.68,0.63,0.68,+0.15,28.3,192000,27,126960,0,0,0,0,0,0,68000,115000,-47000,-47000
20200430,708364,新普中信98購01,,,,,,0.00,0,0,0,0,0,0,0,0,0,0,0,0,0
20200430,708365,凡甲凱基97購01,1.44,1.52,1.44,1.44,-0.05,-3.36,85000,8,124700,0,0,0,0,0,0,65000,20000,45000,45000
20200430,708366,中美晶凱基97購01,,,,,,0.00,0,0,0,0,0,0,0,0,0,0,0,0,0
20200430,708367,良維凱基97購02,0.71,0.71,0.71,0.71,-0.03,-4.05,24000,1,17040,0,0,0,0,0,0,24000,0,24000,24000
20200430,708368,宣德凱基97購01,,,,,,0.00,0,0,0,0,0,0,0,0,0,0,0,0,0
20200430,708369,雙美凱基98購01,,,,,,0.00,0,0,0,0,0,0,0,0,0,0,0,0,0
20200430,708370,中美晶元大96購06,0.88,0.89,0.85,0.86,+0.09,11.69,127000,11,110450,0,0,0,0,0,0,7000,127000,-120000,-120000
20200430,708371,信昌電元大96購04,,,,,,0.00,0,0,0,0,0,0,0,0,0,0,0,0,0
20200430,708372,優群元大97購03,,,,,,0.00,0,0,0,0,0,0,0,0,0,0,0,0,0
20200430,708373,中美晶元富96購02,,,,,,0.00,0,0,0,0,0,0,0,0,0,0,0,0,0
20200430,708374,久元台新96購01,0.01,0.01,0.01,0.01,-0.49,-98.0,10000,2,100,0,0,0,0,0,0,0,10000,-10000,-10000
20200430,708375,久元台新96購02,0.01,0.01,0.01,0.01,-0.46,-97.87,10000,2,100,0,0,0,0,0,0,0,10000,-10000,-10000
20200430,708376,台半台新96購01,0.01,0.01,0.01,0.01,-0.03,-75.0,10000,1,100,0,0,0,0,0,0,0,10000,-10000,-10000
20200430,708377,鈊象台新96購02,,,,,,0.00,0,0,0,0,0,0,0,0,0,0,0,0,0
20200430,708378,頎邦台新97購01,,,,,,0.00,0,0,0,0,0,0,0,0,0,0,0,0,0
20200430,708379,穩懋亞東98購01,,,,,,0.00,0,0,0,0,0,0,0,0,0,0,0,0,0
20200430,708380,台半永豐96購01,,,,,,0.00,0,0,0,0,0,0,0,0,0,0,0,0,0
20200430,708381,亞泰永豐96購01,,,,,,0.00,0,0,0,0,0,0,0,0,0,0,0,0,0
20200430,708382,宜鼎永豐96購02,0.96,0.99,0.96,0.99,+0.06,6.45,89000,4,86140,0,0,0,0,0,0,89000,0,89000,89000
20200430,708383,信昌電永豐96購04,,,,,,0.00,0,0,0,0,0,0,0,0,0,0,0,0,0
20200430,708384,雍智永豐97購01,0.28,0.28,0.28,0.28,+0.04,16.67,50000,2,14000,0,0,0,0,0,0,0,50000,-50000,-50000
20200430,708385,碩禾永豐96購02,,,,,,0.00,0,0,0,0,0,0,0,0,0,0,0,0,0
20200430,708386,雙鴻永豐97購03,0.07,0.07,0.07,0.07,0.00,0.0,236000,6,16520,0,0,0,0,0,0,0,236000,-236000,-236000
20200430,708387,瓦城康和96購01,0.17,0.22,0.17,0.20,+0.02,11.11,90000,6,16800,0,0,0,0,0,0,60000,20000,40000,40000
20200430,708388,三貝德群益96購02,,,,,,0.00,0,0,0,0,0,0,0,0,0,0,0,0,0
20200430,708389,台半群益96購02,,,,,,0.00,0,0,0,0,0,0,0,0,0,0,0,0,0
20200430,708390,美琪瑪群益96購01,,,,,,0.00,0,0,0,0,0,0,0,0,0,0,0,0,0
20200430,708391,原相群益98購02,,,,,,0.00,0,0,0,0,0,0,0,0,0,0,0,0,0
20200430,708392,大江國票97購05,,,,,,0.00,0,0,0,0,0,0,0,0,0,0,0,0,0
20200430,708393,信昌電國泰98購01,0.50,0.66,0.50,0.66,+0.23,53.49,5000,4,2870,0,0,0,0,0,0,4000,1000,3000,3000
20200430,708394,威剛國泰98購01,,,,,,0.00,0,0,0,0,0,0,0,0,0,0,0,0,0
20200430,708395,環球晶國泰97購03,1.28,1.28,1.28,1.28,+0.38,42.22,10000,1,12800,0,0,0,0,0,0,10000,10000,0,0
20200430,708396,信昌電富邦98購01,0.26,0.28,0.26,0.28,+0.03,12.0,50000,3,13040,0,0,0,0,0,0,0,0,0,0
20200430,708397,群聯富邦97購03,,,,,,0.00,0,0,0,0,0,0,0,0,0,0,0,0,0
20200430,708398,環球晶富邦99購01,0.74,0.83,0.74,0.83,+0.10,13.7,75000,7,59550,0,0,0,0,0,0,25000,40000,-15000,-15000
20200430,708399,穩懋富邦97購03,,,,,,0.00,0,0,0,0,0,0,0,0,0,0,0,0,0
20200430,708400,建榮國票98購01,0.15,0.15,0.13,0.13,+0.03,30.0,860000,10,123300,0,0,0,0,0,0,860000,860000,0,0
20200430,708401,威剛國泰98購02,,,,,,0.00,0,0,0,0,0,0,0,0,0,0,0,0,0
20200430,708402,優群國泰99購01,,,,,,0.00,0,0,0,0,0,0,0,0,0,0,0,0,0
20200430,708403,合晶元大98購02,1.57,1.81,1.56,1.80,+0.26,16.88,667000,31,1113300,0,0,0,0,0,0,73000,596000,-523000,-523000
20200430,708404,聖暉元大97購01,1.86,1.95,1.81,1.86,+0.16,9.41,569000,30,1055940,0,0,0,0,0,0,454000,115000,339000,339000
20200430,708405,頎邦元大97購02,,,,,,0.00,0,0,0,0,0,0,0,0,0,0,0,0,0
20200430,708406,昂寶元富97購01,,,,,,0.00,0,0,0,0,0,0,0,0,0,0,0,0,0
20200430,708407,環球晶元富97購01,0.97,1.21,0.97,1.21,+0.31,34.44,476000,22,536060,0,0,0,0,0,0,24000,452000,-428000,-428000
20200430,708408,雙鴻統一97購01,,,,,,0.00,0,0,0,0,0,0,0,0,0,0,0,0,0
20200430,708409,精測中信97購01,0.02,0.02,0.02,0.02,0.00,0.0,10000,1,200,0,0,0,0,0,0,0,10000,-10000,-10000
20200430,708410,頎邦中信9B購01,0.08,0.08,0.08,0.08,+0.01,14.29,20000,2,1600,0,0,0,0,0,0,0,20000,-20000,-20000
20200430,708411,宜鼎凱基99購01,0.30,0.30,0.30,0.30,+0.02,7.14,1000,1,300,0,0,0,0,0,0,0,0,0,0
20200430,708412,直得凱基98購01,0.30,0.30,0.30,0.30,+0.13,76.47,70000,1,21000,0,0,0,0,0,0,70000,0,70000,70000
20200430,708413,信昌電凱基98購01,,,,,,0.00,0,0,0,0,0,0,0,0,0,0,0,0,0
20200430,708414,群聯凱基98購01,,,,,,0.00,0,0,0,0,0,0,0,0,0,0,0,0,0
20200430,708415,VHQ永豐97購01,,,,,,0.00,0,0,0,0,0,0,0,0,0,0,0,0,0
20200430,708416,大宇資永豐99購01,0.23,0.23,0.23,0.23,-0.02,-8.0,3000,1,690,0,0,0,0,0,0,3000,0,3000,3000
20200430,708417,長科*永豐97購01,0.29,0.29,0.29,0.29,+0.02,7.41,10000,1,2900,0,0,0,0,0,0,10000,0,10000,10000
20200430,708418,廣明永豐97購01,0.05,0.05,0.03,0.04,-0.03,-42.86,182000,17,7030,0,0,0,0,0,0,0,142000,-142000,-142000
20200430,708419,環宇永豐98購01,,,,,,0.00,0,0,0,0,0,0,0,0,0,0,0,0,0
20200430,708420,宜鼎群益98購01,0.77,0.78,0.77,0.78,+0.15,23.81,25000,3,19400,0,0,0,0,0,0,25000,0,25000,25000
20200430,708421,群聯群益98購01,,,,,,0.00,0,0,0,0,0,0,0,0,0,0,0,0,0
20200430,708422,群聯群益99購01,,,,,,0.00,0,0,0,0,0,0,0,0,0,0,0,0,0
20200430,708423,世界麥證97購01,,,,,,0.00,0,0,0,0,0,0,0,0,0,0,0,0,0
20200430,708424,原相台新97購02,,,,,,0.00,0,0,0,0,0,0,0,0,0,0,0,0,0
20200430,708425,新鉅科台新98購01,0.03,0.03,0.03,0.03,0.00,0.0,10000,1,300,0,0,0,0,0,0,0,10000,-10000,-10000
20200430,708426,群聯台新97購03,0.01,0.01,0.01,0.01,-0.06,-85.71,10000,1,100,0,0,0,0,0,0,0,10000,-10000,-10000
20200430,708427,聯亞台新97購01,0.05,0.05,0.05,0.05,-0.40,-88.89,10000,1,500,0,0,0,0,0,0,0,10000,-10000,-10000
20200430,708428,鈺太台新97購01,0.32,0.32,0.04,0.04,-0.28,-87.5,31000,10,4240,0,0,0,0,0,0,10000,21000,-11000,-11000
20200430,708429,群聯統一97購01,1.54,1.56,1.50,1.56,+0.13,9.09,15000,5,22960,0,0,0,0,0,0,15000,15000,0,0
20200430,708430,兆利中信9A購01,,,,,,0.00,0,0,0,0,0,0,0,0,0,0,0,0,0
20200430,708431,原相中信99購01,1.24,1.26,1.24,1.24,-0.06,-4.62,79000,4,98260,0,0,0,0,0,0,64000,15000,49000,49000
20200430,708432,廣明中信9B購01,0.15,0.16,0.12,0.16,-0.01,-5.88,382000,22,51810,0,0,0,0,0,0,14000,20000,-6000,-6000
20200430,708433,穩懋中信99購01,0.36,0.36,0.32,0.35,+0.06,20.69,521000,27,176170,0,0,0,0,0,0,219000,302000,-83000,-83000
20200430,708434,合晶凱基98購01,0.60,0.61,0.60,0.61,+0.10,19.61,60000,2,36200,0,0,0,0,0,0,0,60000,-60000,-60000
20200430,708435,勝麗凱基97購02,0.10,0.10,0.10,0.10,+0.02,25.0,1000,1,100,0,0,0,0,0,0,0,1000,-1000,-1000
20200430,708436,博智凱基97購01,4.72,5.10,4.72,5.10,+0.59,13.08,12000,3,58020,0,1000,-1000,0,0,0,12000,0,12000,11000
20200430,708437,穩懋日盛97購01,,,,,,0.00,0,0,0,0,0,0,0,0,0,0,0,0,0
20200430,708438,中美晶亞東97購01,,,,,,0.00,0,0,0,0,0,0,0,0,0,0,0,0,0
20200430,708439,合晶亞東97購02,,,,,,0.00,0,0,0,0,0,0,0,0,0,0,0,0,0
20200430,708440,大田元富97購01,,,,,,0.00,0,0,0,0,0,0,0,0,0,0,0,0,0
20200430,708441,榮剛元富97購01,,,,,,0.00,0,0,0,0,0,0,0,0,0,0,0,0,0
20200430,708442,聯亞台新99購01,0.49,0.49,0.23,0.23,-0.36,-61.02,22000,2,8180,0,0,0,0,0,0,12000,10000,2000,2000
20200430,708443,昂寶元大9A購01,,,,,,0.00,0,0,0,0,0,0,0,0,0,0,0,0,0
20200430,708444,威剛元大99購01,0.25,0.25,0.25,0.25,+0.02,8.7,7000,1,1750,0,0,0,0,0,0,0,0,0,0
20200430,708445,神盾元大99購02,,,,,,0.00,0,0,0,0,0,0,0,0,0,0,0,0,0
20200430,708446,聯亞元大97購04,,,,,,0.00,0,0,0,0,0,0,0,0,0,0,0,0,0
20200430,708447,鈺太元大99購01,0.87,0.87,0.83,0.83,-0.05,-5.68,461000,14,391150,0,0,0,0,0,0,191000,331000,-140000,-140000
20200430,708448,大中永豐97購01,,,,,,0.00,0,0,0,0,0,0,0,0,0,0,0,0,0
20200430,708449,大江永豐97購02,,,,,,0.00,0,0,0,0,0,0,0,0,0,0,0,0,0
20200430,708450,六角永豐97購01,,,,,,0.00,0,0,0,0,0,0,0,0,0,0,0,0,0
20200430,708451,兆利永豐97購01,,,,,,0.00,0,0,0,0,0,0,0,0,0,0,0,0,0
20200430,708452,波若威永豐98購01,,,,,,0.00,0,0,0,0,0,0,0,0,0,0,0,0,0
20200430,708453,宣德永豐97購02,,,,,,0.00,0,0,0,0,0,0,0,0,0,0,0,0,0
20200430,708454,建榮永豐99購01,,,,,,0.00,0,0,0,0,0,0,0,0,0,0,0,0,0
20200430,708455,森鉅永豐97購01,,,,,,0.00,0,0,0,0,0,0,0,0,0,0,0,0,0
20200430,708456,榮剛永豐97購01,,,,,,0.00,0,0,0,0,0,0,0,0,0,0,0,0,0
20200430,708457,廣積永豐97購01,,,,,,0.00,0,0,0,0,0,0,0,0,0,0,0,0,0
20200430,708458,旺矽群益9A購01,0.58,0.66,0.58,0.66,+0.07,11.86,240000,6,146400,0,0,0,0,0,0,130000,110000,20000,20000
20200430,708459,昇達科群益98購01,,,,,,0.00,0,0,0,0,0,0,0,0,0,0,0,0,0
20200430,708460,櫃200群益97購01,,,,,,0.00,0,0,0,0,0,0,0,0,0,0,0,0,0
20200430,708461,櫃200群益97購02,,,,,,0.00,0,0,0,0,0,0,0,0,0,0,0,0,0
20200430,708462,中美晶元大97購03,1.58,1.75,1.58,1.70,+0.10,6.25,254000,25,423610,0,0,0,0,0,0,141000,129000,12000,12000
20200430,708463,宜鼎元大97購01,1.90,2.03,1.85,2.00,+0.24,13.64,504000,28,980890,0,0,0,0,0,0,418000,129000,289000,289000
20200430,708464,昂寶元大98購01,,,,,,0.00,0,0,0,0,0,0,0,0,0,0,0,0,0
20200430,708465,璟德元大97購01,1.57,1.65,1.51,1.65,+0.09,5.77,246000,16,385860,0,0,0,0,0,0,120000,126000,-6000,-6000
20200430,708466,璟德元大97購02,1.08,1.16,1.05,1.16,+0.08,7.41,94000,9,102330,0,0,0,0,0,0,59000,35000,24000,24000
20200430,708467,優群元大97購04,,,,,,0.00,0,0,0,0,0,0,0,0,0,0,0,0,0
20200430,708468,兆利康和97購01,,,,,,0.00,0,0,0,0,0,0,0,0,0,0,0,0,0
20200430,708469,璟德康和97購01,0.42,0.42,0.42,0.42,+0.03,7.69,40000,1,16800,0,0,0,0,0,0,0,40000,-40000,-40000
20200430,708470,璟德元富97購01,0.87,1.00,0.84,0.92,+0.05,5.75,426000,21,381800,0,0,0,0,0,0,316000,292000,24000,24000
20200430,708471,璟德台新97購01,0.32,0.32,0.06,0.06,-0.29,-82.86,21000,3,1520,0,0,0,0,0,0,1000,20000,-19000,-19000
20200430,708472,三貝德凱基99購01,,,,,,0.00,0,0,0,0,0,0,0,0,0,0,0,0,0
20200430,708473,大田凱基98購01,,,,,,0.00,0,0,0,0,0,0,0,0,0,0,0,0,0
20200430,708474,中美晶凱基97購02,1.37,1.39,1.34,1.34,+0.10,8.06,48000,10,65960,0,0,0,0,0,0,8000,48000,-40000,-40000
20200430,708475,宇峻凱基9A購01,0.27,0.27,0.27,0.27,-0.03,-10.0,24000,3,6480,0,0,0,0,0,0,24000,0,24000,24000
20200430,708476,網龍凱基98購01,,,,,,0.00,0,0,0,0,0,0,0,0,0,0,0,0,0
20200430,708477,鈊象凱基99購01,3.19,3.19,2.93,2.93,-0.29,-9.01,9000,3,27330,0,0,0,0,0,0,0,9000,-9000,-9000
20200430,708478,穩懋日盛97購02,,,,,,0.00,0,0,0,0,0,0,0,0,0,0,0,0,0
20200430,708479,立端永豐97購01,0.13,0.13,0.13,0.13,0.00,0.0,14000,1,1820,0,0,0,0,0,0,14000,0,14000,14000
20200430,708480,宇峻永豐97購01,0.18,0.18,0.15,0.16,-0.03,-15.79,552000,16,86480,0,0,0,0,0,0,281000,176000,105000,105000
20200430,708481,迅得永豐97購03,,,,,,0.00,0,0,0,0,0,0,0,0,0,0,0,0,0
20200430,708482,神盾永豐97購01,,,,,,0.00,0,0,0,0,0,0,0,0,0,0,0,0,0
20200430,708483,璟德永豐97購02,,,,,,0.00,0,0,0,0,0,0,0,0,0,0,0,0,0
20200430,708484,璟德國泰98購01,0.76,0.76,0.76,0.76,-0.03,-3.8,10000,1,7600,0,0,0,0,0,0,10000,0,10000,10000
20200430,708485,六角國票97購01,0.36,0.37,0.36,0.37,+0.04,12.12,210000,2,77600,0,0,0,0,0,0,210000,0,210000,210000
20200430,708486,昂寶國票98購01,,,,,,0.00,0,0,0,0,0,0,0,0,0,0,0,0,0
20200430,708487,信昌電國票98購01,0.63,0.63,0.63,0.63,+0.10,18.87,1000,1,630,0,0,0,0,0,0,1000,0,1000,1000
20200430,708488,威剛國票98購01,,,,,,0.00,0,0,0,0,0,0,0,0,0,0,0,0,0
20200430,708489,群聯國票98購01,0.23,0.23,0.22,0.22,+0.06,37.5,410000,2,90300,0,0,0,0,0,0,400000,0,400000,400000
20200430,708490,雍智國票98購01,0.48,0.56,0.48,0.55,+0.11,25.0,115000,10,62460,0,0,0,0,0,0,17000,98000,-81000,-81000
20200430,708491,雙美國票99購01,,,,,,0.00,0,0,0,0,0,0,0,0,0,0,0,0,0
20200430,708492,雙鴻國票98購02,0.55,0.57,0.54,0.55,+0.02,3.77,1115000,10,610500,0,0,0,0,0,0,640000,475000,165000,165000
20200430,708493,鈊象國票98購01,,,,,,0.00,0,0,0,0,0,0,0,0,0,0,0,0,0
20200430,708494,大江群益97購02,,,,,,0.00,0,0,0,0,0,0,0,0,0,0,0,0,0
20200430,708495,信昌電群益97購01,,,,,,0.00,0,0,0,0,0,0,0,0,0,0,0,0,0
20200430,708496,建榮群益99購01,,,,,,0.00,0,0,0,0,0,0,0,0,0,0,0,0,0
20200430,708497,原相群益99購01,1.37,1.37,1.37,1.37,-0.06,-4.2,1000,1,1370,0,0,0,0,0,0,1000,0,1000,1000
20200430,708498,勝麗群益98購01,0.75,0.75,0.75,0.75,+0.09,13.64,120000,3,90000,0,0,0,0,0,0,0,120000,-120000,-120000
20200430,708499,璟德群益98購01,,,,,,0.00,0,0,0,0,0,0,0,0,0,0,0,0,0
20200430,708500,鈊象群益99購05,9.50,9.50,8.90,8.90,-0.80,-8.25,30000,3,272100,0,0,0,0,0,0,15000,16000,-1000,-1000
20200430,708501,力致元大97購01,,,,,,0.00,0,0,0,0,0,0,0,0,0,0,0,0,0
20200430,708502,中美晶元大97購04,1.20,1.34,1.20,1.29,+0.14,12.17,228000,14,289110,0,0,0,0,0,0,76000,160000,-84000,-84000
20200430,708503,世禾元大97購01,,,,,,0.00,0,0,0,0,0,0,0,0,0,0,0,0,0
20200430,708504,尼克森元大97購01,1.00,1.00,1.00,1.00,+0.88,733.33,80000,8,80000,0,0,0,0,0,0,0,80000,-80000,-80000
20200430,708505,宇峻元大97購03,0.71,0.71,0.71,0.71,-0.02,-2.74,10000,1,7100,0,0,0,0,0,0,0,10000,-10000,-10000
20200430,708506,信昌電元大98購01,0.38,0.38,0.38,0.38,0.00,0.0,12000,2,4560,0,0,0,0,0,0,12000,0,12000,12000
20200430,708507,碩禾元大98購02,,,,,,0.00,0,0,0,0,0,0,0,0,0,0,0,0,0
20200430,708508,雙鴻元大99購02,,,,,,0.00,0,0,0,0,0,0,0,0,0,0,0,0,0
20200430,708509,尼克森統一99購01,,,,,,0.00,0,0,0,0,0,0,0,0,0,0,0,0,0
20200430,708510,尼克森統一99購02,0.13,0.13,0.13,0.13,0.00,0.0,1000,1,130,0,0,0,0,0,0,0,1000,-1000,-1000
20200430,708511,迅得統一99購01,,,,,,0.00,0,0,0,0,0,0,0,0,0,0,0,0,0
20200430,708512,頎邦統一97購01,,,,,,0.00,0,0,0,0,0,0,0,0,0,0,0,0,0
20200430,708513,M31中信98購01,,,,,,0.00,0,0,0,0,0,0,0,0,0,0,0,0,0
20200430,708514,大中中信97購01,,,,,,0.00,0,0,0,0,0,0,0,0,0,0,0,0,0
20200430,708515,宇峻中信97購01,0.11,0.11,0.10,0.10,0.00,0.0,80000,3,8500,0,0,0,0,0,0,0,0,0,0
20200430,708516,博智中信97購01,2.27,2.39,2.27,2.33,+0.19,8.88,40000,3,93800,0,0,0,0,0,0,20000,20000,0,0
20200430,708517,大中凱基98購02,,,,,,0.00,0,0,0,0,0,0,0,0,0,0,0,0,0
20200430,708518,同致凱基98購01,0.18,0.19,0.18,0.19,+0.03,18.75,70000,2,12800,0,0,0,0,0,0,0,70000,-70000,-70000
20200430,708519,合晶凱基97購02,,,,,,0.00,0,0,0,0,0,0,0,0,0,0,0,0,0
20200430,708520,朋億凱基97購01,,,,,,0.00,0,0,0,0,0,0,0,0,0,0,0,0,0
20200430,708521,南光凱基97購01,,,,,,0.00,0,0,0,0,0,0,0,0,0,0,0,0,0
20200430,708522,緯軟凱基98購03,,,,,,0.00,0,0,0,0,0,0,0,0,0,0,0,0,0
20200430,708523,大江兆豐97購01,,,,,,0.00,0,0,0,0,0,0,0,0,0,0,0,0,0
20200430,708524,中美晶兆豐98購01,0.15,0.15,0.15,0.15,+0.05,50.0,4000,1,600,0,0,0,0,0,0,0,0,0,0
20200430,708525,台燿兆豐97購02,0.79,0.80,0.71,0.80,+0.20,33.33,193000,12,148030,0,0,0,0,0,0,144000,49000,95000,95000
20200430,708526,精華兆豐98購01,0.90,1.10,0.90,1.10,+0.22,25.0,519000,27,501780,0,0,0,0,0,0,200000,419000,-219000,-219000
20200430,708527,中美晶群益97購03,,,,,,0.00,0,0,0,0,0,0,0,0,0,0,0,0,0
20200430,708528,太景*群益98購01,0.54,0.54,0.37,0.50,+0.05,11.11,126000,8,66950,0,0,0,0,0,0,0,0,0,0
20200430,708529,立端群益97購01,0.24,0.24,0.24,0.24,+0.04,20.0,10000,1,2400,0,0,0,0,0,0,10000,0,10000,10000
20200430,708530,朋億群益98購01,0.60,0.60,0.58,0.59,+0.04,7.27,25000,3,14650,0,0,0,0,0,0,25000,0,25000,25000
20200430,708531,欣銓群益98購01,,,,,,0.00,0,0,0,0,0,0,0,0,0,0,0,0,0
20200430,708532,群聯群益97購02,,,,,,0.00,0,0,0,0,0,0,0,0,0,0,0,0,0
20200430,708533,緯軟群益98購01,0.23,0.23,0.23,0.23,+0.06,35.29,50000,1,11500,0,0,0,0,0,0,50000,0,50000,50000
20200430,708534,環球晶群益97購03,0.22,0.22,0.22,0.22,+0.15,214.29,3000,1,660,0,0,0,0,0,0,0,3000,-3000,-3000
20200430,708535,譜瑞群益97購01,,,,,,0.00,0,0,0,0,0,0,0,0,0,0,0,0,0
20200430,708536,建榮國票98購02,,,,,,0.00,0,0,0,0,0,0,0,0,0,0,0,0,0
20200430,708537,力致國泰99購01,,,,,,0.00,0,0,0,0,0,0,0,0,0,0,0,0,0
20200430,708538,凡甲國泰99購01,1.58,1.60,1.51,1.51,-0.09,-5.62,259000,14,402780,0,0,0,0,0,0,82000,177000,-95000,-95000
20200430,708539,中菲行國泰98購01,,,,,,0.00,0,0,0,0,0,0,0,0,0,0,0,0,0
20200430,708540,世禾國泰98購01,0.46,0.46,0.46,0.46,+0.03,6.98,20000,1,9200,0,0,0,0,0,0,0,20000,-20000,-20000
20200430,708541,尼克森國泰99購01,0.29,0.29,0.27,0.28,+0.01,3.7,383000,8,108210,0,0,0,0,0,0,13000,370000,-357000,-357000
20200430,708542,幃翔國泰98購01,,,,,,0.00,0,0,0,0,0,0,0,0,0,0,0,0,0
20200430,708543,幃翔國泰98購02,0.40,0.42,0.38,0.38,+0.05,15.15,198000,3,79740,0,0,0,0,0,0,125000,73000,52000,52000
20200430,708544,群聯國泰99購01,,,,,,0.00,0,0,0,0,0,0,0,0,0,0,0,0,0
20200430,708545,雙鴻國泰99購01,0.77,0.77,0.77,0.77,+0.05,6.94,1000,1,770,0,0,0,0,0,0,0,1000,-1000,-1000
20200430,708546,力致永豐97購01,0.82,0.87,0.82,0.85,+0.33,63.46,174000,8,147090,0,0,0,0,0,0,0,174000,-174000,-174000
20200430,708547,世禾永豐97購01,,,,,,0.00,0,0,0,0,0,0,0,0,0,0,0,0,0
20200430,708548,尼克森永豐97購01,,,,,,0.00,0,0,0,0,0,0,0,0,0,0,0,0,0
20200430,708549,立敦永豐97購01,,,,,,0.00,0,0,0,0,0,0,0,0,0,0,0,0,0
20200430,708550,同亨永豐97購01,0.10,0.10,0.10,0.10,-0.01,-9.09,20000,1,2000,0,0,0,0,0,0,20000,0,20000,20000
20200430,708551,直得永豐97購01,,,,,,0.00,0,0,0,0,0,0,0,0,0,0,0,0,0
20200430,708552,南光永豐97購01,,,,,,0.00,0,0,0,0,0,0,0,0,0,0,0,0,0
20200430,708553,威剛永豐98購01,,,,,,0.00,0,0,0,0,0,0,0,0,0,0,0,0,0
20200430,708554,幃翔永豐97購01,0.14,0.14,0.14,0.14,+0.01,7.69,1000,1,140,0,0,0,0,0,0,1000,0,1000,1000
20200430,708555,新潤永豐97購01,0.20,0.20,0.20,0.20,+0.02,11.11,50000,1,10000,0,0,0,0,0,0,50000,0,50000,50000
20200430,708556,網龍永豐97購01,,,,,,0.00,0,0,0,0,0,0,0,0,0,0,0,0,0
20200430,708557,緯軟永豐97購01,,,,,,0.00,0,0,0,0,0,0,0,0,0,0,0,0,0
20200430,708558,環球晶永豐97購01,0.46,0.53,0.46,0.53,+0.11,26.19,345000,4,177250,0,0,0,0,0,0,315000,30000,285000,285000
20200430,708559,聯上永豐97購01,,,,,,0.00,0,0,0,0,0,0,0,0,0,0,0,0,0
20200430,708560,大中康和97購01,,,,,,0.00,0,0,0,0,0,0,0,0,0,0,0,0,0
20200430,708561,亞泰康和97購01,0.75,0.75,0.75,0.75,0.00,0.0,20000,1,15000,0,0,0,0,0,0,20000,0,20000,20000
20200430,708562,博智康和97購01,,,,,,0.00,0,0,0,0,0,0,0,0,0,0,0,0,0
20200430,708563,力致元富97購01,0.75,0.89,0.70,0.84,+0.17,25.37,1181000,32,948360,0,0,0,0,0,0,371000,735000,-364000,-364000
20200430,708564,中菲行元富97購01,,,,,,0.00,0,0,0,0,0,0,0,0,0,0,0,0,0
20200430,708565,太景*元富97購01,0.70,0.70,0.70,0.70,+0.05,7.69,6000,1,4200,0,0,0,0,0,0,0,0,0,0
20200430,708566,世禾元富97購01,,,,,,0.00,0,0,0,0,0,0,0,0,0,0,0,0,0
20200430,708567,尼克森元富97購01,,,,,,0.00,0,0,0,0,0,0,0,0,0,0,0,0,0
20200430,708568,幃翔元富97購01,,,,,,0.00,0,0,0,0,0,0,0,0,0,0,0,0,0
20200430,708569,力致統一97購01,0.83,0.99,0.83,0.99,+0.21,26.92,139000,7,126120,0,0,0,0,0,0,1000,138000,-137000,-137000
20200430,708570,力致統一97購02,1.28,1.42,1.28,1.42,+0.27,23.48,30000,3,40700,0,0,0,0,0,0,0,30000,-30000,-30000
20200430,708571,環球晶統一97購01,,,,,,0.00,0,0,0,0,0,0,0,0,0,0,0,0,0
20200430,708572,兆利凱基98購02,,,,,,0.00,0,0,0,0,0,0,0,0,0,0,0,0,0
20200430,708573,昂寶凱基98購02,,,,,,0.00,0,0,0,0,0,0,0,0,0,0,0,0,0
20200430,708574,威剛凱基99購01,,,,,,0.00,0,0,0,0,0,0,0,0,0,0,0,0,0
20200430,708575,精測凱基98購01,0.33,0.34,0.33,0.34,+0.02,6.25,88000,2,29150,0,0,0,0,0,0,77000,11000,66000,66000
20200430,708576,聯亞凱基99購01,,,,,,0.00,0,0,0,0,0,0,0,0,0,0,0,0,0
20200430,708577,頎邦凱基97購03,0.21,0.24,0.20,0.23,+0.03,15.0,297000,6,64260,0,0,0,0,0,0,0,297000,-297000,-297000
20200430,708578,中美晶麥證97購01,,,,,,0.00,0,0,0,0,0,0,0,0,0,0,0,0,0
20200430,708579,原相麥證97購01,,,,,,0.00,0,0,0,0,0,0,0,0,0,0,0,0,0
20200430,708580,神盾元富97購01,0.45,0.46,0.40,0.45,0.00,0.0,160000,6,71230,0,0,0,0,0,0,159000,1000,158000,158000
20200430,708581,神盾元富97購02,,,,,,0.00,0,0,0,0,0,0,0,0,0,0,0,0,0
20200430,708582,宇峻元大97購04,,,,,,0.00,0,0,0,0,0,0,0,0,0,0,0,0,0
20200430,708583,亞泰元大97購01,,,,,,0.00,0,0,0,0,0,0,0,0,0,0,0,0,0
20200430,708584,威剛元大98購02,,,,,,0.00,0,0,0,0,0,0,0,0,0,0,0,0,0
20200430,708585,建榮元大97購02,0.13,0.14,0.11,0.12,+0.03,33.33,119000,4,14290,0,0,0,0,0,0,59000,60000,-1000,-1000
20200430,708586,原相元大98購01,,,,,,0.00,0,0,0,0,0,0,0,0,0,0,0,0,0
20200430,708587,原相元大99購01,,,,,,0.00,0,0,0,0,0,0,0,0,0,0,0,0,0
20200430,708588,群聯元大98購01,,,,,,0.00,0,0,0,0,0,0,0,0,0,0,0,0,0
20200430,708589,聯亞元大98購01,,,,,,0.00,0,0,0,0,0,0,0,0,0,0,0,0,0
20200430,708590,雙美元大99購01,,,,,,0.00,0,0,0,0,0,0,0,0,0,0,0,0,0
20200430,708591,雙鴻元大99購03,,,,,,0.00,0,0,0,0,0,0,0,0,0,0,0,0,0
20200430,708592,穩懋元大97購03,,,,,,0.00,0,0,0,0,0,0,0,0,0,0,0,0,0
20200430,708593,穩懋元大97購04,,,,,,0.00,0,0,0,0,0,0,0,0,0,0,0,0,0
20200430,708594,鈊象元大99購01,2.93,2.93,2.93,2.93,-0.26,-8.15,100000,1,293000,0,0,0,0,0,0,100000,0,100000,100000
20200430,708595,大江兆豐97購02,,,,,,0.00,0,0,0,0,0,0,0,0,0,0,0,0,0
20200430,708596,群聯兆豐98購01,0.18,0.18,0.18,0.18,+0.03,20.0,10000,1,1800,0,0,0,0,0,0,10000,0,10000,10000
20200430,708597,迅得康和97購01,,,,,,0.00,0,0,0,0,0,0,0,0,0,0,0,0,0
20200430,708598,六角群益98購02,0.33,0.35,0.33,0.35,+0.07,25.0,4000,2,1360,0,0,0,0,0,0,2000,0,2000,2000
20200430,708599,亞泰群益97購01,0.56,0.57,0.56,0.57,+0.01,1.79,47000,2,26470,0,0,0,0,0,0,47000,0,47000,47000
20200430,708600,台燿亞東97購01,,,,,,0.00,0,0,0,0,0,0,0,0,0,0,0,0,0
20200430,708601,光頡永豐97購01,,,,,,0.00,0,0,0,0,0,0,0,0,0,0,0,0,0
20200430,708602,亞泰永豐97購01,,,,,,0.00,0,0,0,0,0,0,0,0,0,0,0,0,0
20200430,708603,力致元富97購02,0.74,0.74,0.74,0.74,+0.16,27.59,60000,1,44400,0,0,0,0,0,0,60000,0,60000,60000
20200430,708604,鈺太元富97購01,0.39,0.39,0.39,0.39,-0.03,-7.14,20000,1,7800,0,0,0,0,0,0,20000,0,20000,20000
20200430,708605,久元台新97購01,,,,,,0.00,0,0,0,0,0,0,0,0,0,0,0,0,0
20200430,708606,大中台新97購01,,,,,,0.00,0,0,0,0,0,0,0,0,0,0,0,0,0
20200430,708607,晶焱台新97購01,0.06,0.06,0.06,0.06,-0.27,-81.82,10000,1,600,0,0,0,0,0,0,0,10000,-10000,-10000
20200430,708608,光頡統一97購01,0.96,1.06,0.91,0.91,+0.10,12.35,437000,14,434320,0,0,0,0,0,0,18000,419000,-401000,-401000
20200430,708609,光頡統一99購01,,,,,,0.00,0,0,0,0,0,0,0,0,0,0,0,0,0
20200430,708610,合晶統一97購01,0.88,1.04,0.88,1.04,+0.16,18.18,552000,17,519230,0,0,0,0,0,0,142000,410000,-268000,-268000
20200430,708611,大中中信99購01,0.10,0.10,0.09,0.09,+0.01,12.5,60000,4,5800,0,0,0,0,0,0,0,50000,-50000,-50000
20200430,708612,亞泰中信97購01,,,,,,0.00,0,0,0,0,0,0,0,0,0,0,0,0,0
20200430,708613,博智中信99購01,,,,,,0.00,0,0,0,0,0,0,0,0,0,0,0,0,0
20200430,708614,緯軟中信97購01,,,,,,0.00,0,0,0,0,0,0,0,0,0,0,0,0,0
20200430,708615,台半凱基98購01,,,,,,0.00,0,0,0,0,0,0,0,0,0,0,0,0,0
20200430,708616,兆利凱基98購03,,,,,,0.00,0,0,0,0,0,0,0,0,0,0,0,0,0
20200430,708617,宇峻凱基99購01,,,,,,0.00,0,0,0,0,0,0,0,0,0,0,0,0,0
20200430,708618,新普凱基98購01,4.28,4.34,4.28,4.34,+0.19,4.58,30000,2,129000,0,0,0,0,0,0,20000,10000,10000,10000
20200430,708619,璟德凱基98購01,,,,,,0.00,0,0,0,0,0,0,0,0,0,0,0,0,0
20200430,708620,環球晶凱基97購02,1.74,2.01,1.74,2.01,+0.18,9.84,29000,3,55370,0,0,0,0,0,0,11000,19000,-8000,-8000
20200430,708621,頎邦第一97購01,,,,,,0.00,0,0,0,0,0,0,0,0,0,0,0,0,0
20200430,708622,光頡永豐97購02,0.10,0.13,0.09,0.09,+0.01,12.5,333000,16,32610,0,0,0,0,0,0,192000,141000,51000,51000
20200430,708623,建榮永豐98購01,,,,,,0.00,0,0,0,0,0,0,0,0,0,0,0,0,0
20200430,708624,雙美永豐98購01,,,,,,0.00,0,0,0,0,0,0,0,0,0,0,0,0,0
20200430,708625,雙鴻永豐98購01,0.53,0.53,0.52,0.52,+0.03,6.12,99000,2,51780,0,0,0,0,0,0,30000,69000,-39000,-39000
20200430,708626,亞泰國票97購01,,,,,,0.00,0,0,0,0,0,0,0,0,0,0,0,0,0
20200430,708627,新普國票98購01,,,,,,0.00,0,0,0,0,0,0,0,0,0,0,0,0,0
20200430,708628,廣明國票98購01,1.55,1.55,1.55,1.55,-0.08,-4.91,97000,1,150350,0,0,0,0,0,0,0,97000,-97000,-97000
20200430,708629,璟德國票98購01,2.35,2.48,2.35,2.48,+0.12,5.08,24000,2,57960,0,0,0,0,0,0,12000,12000,0,0
20200430,708630,環宇國票98購01,,,,,,0.00,0,0,0,0,0,0,0,0,0,0,0,0,0
20200430,708631,頎邦國票98購01,1.14,1.23,1.14,1.23,+0.19,18.27,70000,6,81920,0,0,0,0,0,0,0,70000,-70000,-70000
20200430,708632,M31元大98購01,,,,,,0.00,0,0,0,0,0,0,0,0,0,0,0,0,0
20200430,708633,昂寶元大98購02,,,,,,0.00,0,0,0,0,0,0,0,0,0,0,0,0,0
20200430,708634,信昌電元大98購02,0.86,0.95,0.83,0.87,+0.11,14.47,326000,17,276710,0,0,0,0,0,0,284000,42000,242000,242000
20200430,708635,建榮元大97購03,,,,,,0.00,0,0,0,0,0,0,0,0,0,0,0,0,0
20200430,708636,原相元大98購02,,,,,,0.00,0,0,0,0,0,0,0,0,0,0,0,0,0
20200430,708637,群聯元大98購02,,,,,,0.00,0,0,0,0,0,0,0,0,0,0,0,0,0
20200430,708638,精測元大97購04,,,,,,0.00,0,0,0,0,0,0,0,0,0,0,0,0,0
20200430,708639,網龍元大97購01,,,,,,0.00,0,0,0,0,0,0,0,0,0,0,0,0,0
20200430,708640,璟德元大97購03,0.60,0.60,0.60,0.60,-0.06,-9.09,30000,1,18000,0,0,0,0,0,0,30000,0,30000,30000
20200430,708641,鈊象元大98購02,,,,,,0.00,0,0,0,0,0,0,0,0,0,0,0,0,0
20200430,708642,頎邦元大97購03,,,,,,0.00,0,0,0,0,0,0,0,0,0,0,0,0,0
20200430,708643,頎邦元大97購04,0.27,0.27,0.27,0.27,+0.04,17.39,10000,1,2700,0,0,0,0,0,0,10000,0,10000,10000
20200430,708644,雙美國泰99購01,0.57,0.59,0.57,0.59,+0.06,11.32,50000,5,28800,0,0,0,0,0,0,0,50000,-50000,-50000
20200430,708645,聯亞兆豐98購01,0.53,0.54,0.42,0.44,-0.07,-13.73,390000,16,196320,0,0,0,0,0,0,317000,62000,255000,255000
20200430,708646,櫃200兆豐97購01,,,,,,0.00,0,0,0,0,0,0,0,0,0,0,0,0,0
20200430,708647,泰博群益97購01,,,,,,0.00,0,0,0,0,0,0,0,0,0,0,0,0,0
20200430,708648,VHQ中信97購01,,,,,,0.00,0,0,0,0,0,0,0,0,0,0,0,0,0
20200430,708649,鈊象中信97購01,2.63,2.63,2.63,2.63,+0.01,0.38,50000,1,131500,0,0,0,0,0,0,50000,50000,0,0
20200430,708650,迅得麥證98購01,,,,,,0.00,0,0,0,0,0,0,0,0,0,0,0,0,0
20200430,708651,大學光元富99購01,,,,,,0.00,0,0,0,0,0,0,0,0,0,0,0,0,0
20200430,708652,光頡元富97購01,,,,,,0.00,0,0,0,0,0,0,0,0,0,0,0,0,0
20200430,708653,神盾元富97購03,,,,,,0.00,0,0,0,0,0,0,0,0,0,0,0,0,0
20200430,708654,力致統一97購03,0.40,0.43,0.40,0.42,+0.07,20.0,23000,3,9650,0,0,0,0,0,0,23000,0,23000,23000
20200430,708655,波若威統一99購01,,,,,,0.00,0,0,0,0,0,0,0,0,0,0,0,0,0
20200430,708656,信昌電統一98購01,1.39,1.53,1.34,1.46,+0.18,14.06,125000,18,183590,0,0,0,0,0,0,35000,115000,-80000,-80000
20200430,708657,兆利台新97購01,0.01,0.01,0.01,0.01,-0.07,-87.5,10000,1,100,0,0,0,0,0,0,0,10000,-10000,-10000
20200430,708658,神盾台新98購01,0.15,0.15,0.15,0.15,0.00,0.0,10000,2,1500,0,0,0,0,0,0,0,10000,-10000,-10000
20200430,708659,合晶凱基97購03,1.31,1.42,1.31,1.42,+0.20,16.39,125000,13,170590,0,0,0,0,0,0,5000,125000,-120000,-120000
20200430,708660,宇峻凱基99購02,,,,,,0.00,0,0,0,0,0,0,0,0,0,0,0,0,0
20200430,708661,良維凱基97購03,0.72,0.72,0.72,0.72,+0.05,7.46,1000,1,720,0,0,0,0,0,0,1000,0,1000,1000
20200430,708662,信昌電凱基98購02,1.16,1.26,1.14,1.23,+0.15,13.89,273000,16,317980,0,0,0,0,0,0,223000,60000,163000,163000
20200430,708663,茂達凱基97購01,0.52,0.52,0.52,0.52,+0.06,13.04,5000,1,2600,0,0,0,0,0,0,5000,0,5000,5000
20200430,708664,群聯凱基98購02,,,,,,0.00,0,0,0,0,0,0,0,0,0,0,0,0,0
20200430,708665,網家凱基97購01,,,,,,0.00,0,0,0,0,0,0,0,0,0,0,0,0,0
20200430,708666,聚積凱基97購01,,,,,,0.00,0,0,0,0,0,0,0,0,0,0,0,0,0
20200430,708667,廣明凱基98購02,0.63,0.63,0.63,0.63,-0.16,-20.25,4000,1,2520,0,0,0,0,0,0,4000,0,4000,4000
20200430,708668,優群凱基98購03,2.83,2.83,2.83,2.83,-0.18,-5.98,1000,1,2830,0,0,0,0,0,0,1000,0,1000,1000
20200430,708669,聯亞凱基99購02,0.59,0.59,0.59,0.59,+0.10,20.41,1000,1,590,0,0,0,0,0,0,0,1000,-1000,-1000
20200430,708670,鈺太凱基98購01,,,,,,0.00,0,0,0,0,0,0,0,0,0,0,0,0,0
20200430,708671,頎邦凱基97購04,,,,,,0.00,0,0,0,0,0,0,0,0,0,0,0,0,0
20200430,708672,M31元大99購01,0.38,0.38,0.38,0.38,+0.01,2.7,9000,1,3420,0,0,0,0,0,0,9000,0,9000,9000
20200430,708673,凡甲元大98購02,1.79,1.84,1.77,1.79,-0.09,-4.79,129000,12,229880,0,0,0,0,0,0,129000,0,129000,129000
20200430,708674,大宇資元大98購01,,,,,,0.00,0,0,0,0,0,0,0,0,0,0,0,0,0
20200430,708675,六角元大98購02,,,,,,0.00,0,0,0,0,0,0,0,0,0,0,0,0,0
20200430,708676,昂寶元大97購02,,,,,,0.00,0,0,0,0,0,0,0,0,0,0,0,0,0
20200430,708677,晶焱元大98購01,,,,,,0.00,0,0,0,0,0,0,0,0,0,0,0,0,0
20200430,708678,鈊象元大97購04,,,,,,0.00,0,0,0,0,0,0,0,0,0,0,0,0,0
20200430,708679,光頡國票98購01,1.62,1.82,1.48,1.48,+0.17,12.98,318000,9,494970,0,0,0,0,0,0,240000,78000,162000,162000
20200430,708680,金居國票98購01,0.24,0.24,0.24,0.24,+0.08,50.0,10000,1,2400,0,0,0,0,0,0,10000,0,10000,10000
20200430,708681,建榮國票99購01,,,,,,0.00,0,0,0,0,0,0,0,0,0,0,0,0,0
20200430,708682,穩懋國票98購01,,,,,,0.00,0,0,0,0,0,0,0,0,0,0,0,0,0
20200430,708683,鈊象國票97購03,,,,,,0.00,0,0,0,0,0,0,0,0,0,0,0,0,0
20200430,708684,光頡國泰98購01,1.13,1.32,1.04,1.32,+0.40,43.48,133000,15,158610,0,0,0,0,0,0,53000,133000,-80000,-80000
20200430,708685,亞泰國泰98購01,,,,,,0.00,0,0,0,0,0,0,0,0,0,0,0,0,0
20200430,708686,世界兆豐97購01,0.63,0.69,0.63,0.69,+0.08,13.11,203000,9,132150,0,0,0,0,0,0,27000,176000,-149000,-149000
20200430,708687,同致兆豐98購01,0.24,0.29,0.24,0.29,+0.05,20.83,170000,15,45500,0,0,0,0,0,0,0,130000,-130000,-130000
20200430,708688,宜鼎兆豐98購01,2.54,2.70,2.54,2.66,+0.19,7.69,305000,28,800500,0,0,0,0,0,0,114000,201000,-87000,-87000
20200430,708689,勝麗群益98購02,0.91,1.06,0.91,1.06,+0.18,20.45,317000,8,321090,0,0,0,0,0,0,108000,209000,-101000,-101000
20200430,708690,晟德群益97購01,0.10,0.10,0.10,0.10,0.00,0.0,40000,1,4000,0,0,0,0,0,0,0,0,0,0
20200430,708691,穩懋永豐97購02,1.37,1.37,1.34,1.34,+0.11,8.94,146000,6,198160,0,0,0,0,0,0,126000,25000,101000,101000
20200430,708692,元太亞東97購01,,,,,,0.00,0,0,0,0,0,0,0,0,0,0,0,0,0
20200430,708693,台半中信99購01,0.26,0.26,0.17,0.17,+0.01,6.25,2000,2,430,0,0,0,0,0,0,0,2000,-2000,-2000
20200430,708694,M31統一98購01,,,,,,0.00,0,0,0,0,0,0,0,0,0,0,0,0,0
20200430,708695,波若威統一97購01,0.39,0.40,0.39,0.40,-0.02,-4.76,113000,9,44600,0,0,0,0,0,0,113000,0,113000,113000
20200430,708696,建榮統一9A購01,0.95,1.01,0.94,0.98,+0.24,32.43,53000,7,50500,0,0,0,0,0,0,0,53000,-53000,-53000
20200430,708697,建榮統一9A購02,,,,,,0.00,0,0,0,0,0,0,0,0,0,0,0,0,0
20200430,708698,雙鴻統一97購02,0.91,0.91,0.86,0.89,+0.02,2.3,346000,13,308500,0,0,0,0,0,0,126000,220000,-94000,-94000
20200430,708699,雙鴻統一99購01,0.58,0.60,0.58,0.59,+0.02,3.51,548000,12,321440,0,0,0,0,0,0,316000,232000,84000,84000
20200430,708700,穩懋統一99購01,0.90,0.99,0.90,0.99,+0.15,17.86,160000,16,153500,0,0,0,0,0,0,150000,150000,0,0
20200430,708701,建榮凱基97購02,,,,,,0.00,0,0,0,0,0,0,0,0,0,0,0,0,0
20200430,708702,原相凱基98購02,2.51,2.51,2.51,2.51,-0.12,-4.56,20000,1,50200,0,0,0,0,0,0,20000,0,20000,20000
20200430,708703,精測凱基97購04,,,,,,0.00,0,0,0,0,0,0,0,0,0,0,0,0,0
20200430,708704,環球晶凱基97購03,1.06,1.25,1.06,1.25,+0.36,40.45,38000,3,46750,0,0,0,0,0,0,38000,0,38000,38000
20200430,708705,穩懋凱基97購01,,,,,,0.00,0,0,0,0,0,0,0,0,0,0,0,0,0
20200430,708706,鈺太凱基98購02,1.03,1.03,1.03,1.03,+0.13,14.44,20000,3,20600,0,0,0,0,0,0,20000,0,20000,20000
20200430,708707,大江元大97購04,,,,,,0.00,0,0,0,0,0,0,0,0,0,0,0,0,0
20200430,708708,光頡元大98購01,,,,,,0.00,0,0,0,0,0,0,0,0,0,0,0,0,0
20200430,708709,新普元大97購02,2.14,2.22,2.14,2.22,+0.03,1.37,114000,5,249100,0,0,0,0,0,0,92000,22000,70000,70000
20200430,708710,新普元大97購03,,,,,,0.00,0,0,0,0,0,0,0,0,0,0,0,0,0
20200430,708711,群聯元大97購05,,,,,,0.00,0,0,0,0,0,0,0,0,0,0,0,0,0
20200430,708712,聯亞元大97購05,,,,,,0.00,0,0,0,0,0,0,0,0,0,0,0,0,0
20200430,708713,雙鴻元大99購04,0.76,0.76,0.72,0.72,+0.01,1.41,55000,6,40350,0,0,0,0,0,0,10000,0,10000,10000
20200430,708714,聯亞元富97購01,1.56,1.56,1.34,1.37,-0.15,-9.87,1302000,35,1857910,0,0,0,0,0,0,402000,900000,-498000,-498000
20200430,708715,台燿日盛97購01,,,,,,0.00,0,0,0,0,0,0,0,0,0,0,0,0,0
20200430,708716,建榮永豐97購02,,,,,,0.00,0,0,0,0,0,0,0,0,0,0,0,0,0
20200430,708717,閎康永豐97購01,1.21,1.22,1.19,1.20,-0.10,-7.69,115000,13,138230,0,0,0,0,0,0,115000,11000,104000,104000
20200430,708718,譜瑞永豐97購01,1.42,1.47,1.35,1.47,+0.08,5.76,207000,19,295280,0,0,0,0,0,0,100000,107000,-7000,-7000
20200430,708719,鈊象永豐98購01,,,,,,0.00,0,0,0,0,0,0,0,0,0,0,0,0,0
20200430,708720,力致國票97購01,0.34,0.43,0.34,0.43,+0.16,59.26,29000,5,11360,0,0,0,0,0,0,19000,0,19000,19000
20200430,708721,光頡國票98購02,0.58,0.61,0.58,0.61,+0.13,27.08,53000,4,31920,0,0,0,0,0,0,0,53000,-53000,-53000
20200430,708722,金居國票98購02,,,,,,0.00,0,0,0,0,0,0,0,0,0,0,0,0,0
20200430,708723,威剛國票98購02,,,,,,0.00,0,0,0,0,0,0,0,0,0,0,0,0,0
20200430,708724,晶焱國票98購01,,,,,,0.00,0,0,0,0,0,0,0,0,0,0,0,0,0
20200430,708725,群聯國票98購02,,,,,,0.00,0,0,0,0,0,0,0,0,0,0,0,0,0
20200430,708726,廣明國票98購02,3.31,3.31,2.97,2.97,-0.28,-8.62,68000,5,210240,0,0,0,0,0,0,68000,0,68000,68000
20200430,708727,光頡國泰99購01,,,,,,0.00,0,0,0,0,0,0,0,0,0,0,0,0,0
20200430,708728,原相國泰98購03,,,,,,0.00,0,0,0,0,0,0,0,0,0,0,0,0,0
20200430,708729,大江富邦99購01,0.09,0.10,0.09,0.10,-0.03,-23.08,65000,3,6010,0,0,0,0,0,0,49000,0,49000,49000
20200430,708730,久元群益97購01,,,,,,0.00,0,0,0,0,0,0,0,0,0,0,0,0,0
20200430,708731,聚積群益97購02,,,,,,0.00,0,0,0,0,0,0,0,0,0,0,0,0,0
20200430,708732,頎邦群益98購02,0.55,0.55,0.55,0.55,+0.13,30.95,5000,1,2750,0,0,0,0,0,0,5000,0,5000,5000
20200430,708733,M31凱基99購01,,,,,,0.00,0,0,0,0,0,0,0,0,0,0,0,0,0
20200430,708734,中美晶凱基97購04,,,,,,0.00,0,0,0,0,0,0,0,0,0,0,0,0,0
20200430,708735,昇達科凱基97購01,1.18,1.18,1.17,1.17,+0.13,12.5,21000,2,24670,0,0,0,0,0,0,21000,21000,0,0
20200430,708736,聯亞凱基97購02,,,,,,0.00,0,0,0,0,0,0,0,0,0,0,0,0,0
20200430,708737,雙美凱基99購01,,,,,,0.00,0,0,0,0,0,0,0,0,0,0,0,0,0
20200430,708738,穩懋凱基97購02,2.41,2.41,2.37,2.39,+0.32,15.46,83000,14,198370,0,0,0,0,0,0,83000,0,83000,83000
20200430,708739,穩懋凱基97購03,1.60,1.66,1.53,1.56,+0.17,12.23,139000,13,222220,0,0,0,0,0,0,109000,30000,79000,79000
20200430,708740,譜瑞凱基97購01,,,,,,0.00,0,0,0,0,0,0,0,0,0,0,0,0,0
20200430,708741,鈊象凱基98購03,,,,,,0.00,0,0,0,0,0,0,0,0,0,0,0,0,0
20200430,708742,新普麥證97購01,1.19,1.19,1.14,1.18,+0.01,0.85,102000,13,118860,89000,13000,76000,0,0,0,89000,13000,76000,76000
20200430,708743,同致元富97購01,,,,,,0.00,0,0,0,0,0,0,0,0,0,0,0,0,0
20200430,708744,金居元富97購01,,,,,,0.00,0,0,0,0,0,0,0,0,0,0,0,0,0
20200430,708745,原相元富97購01,,,,,,0.00,0,0,0,0,0,0,0,0,0,0,0,0,0
20200430,708746,穩懋元富97購01,1.21,1.21,1.08,1.10,+0.12,12.24,261000,18,293980,0,0,0,0,0,0,259000,1000,258000,258000
20200430,708747,立端亞東98購01,0.78,0.78,0.76,0.76,+0.10,15.15,20000,2,15400,0,0,0,0,0,0,0,20000,-20000,-20000
20200430,708748,合晶永豐97購03,,,,,,0.00,0,0,0,0,0,0,0,0,0,0,0,0,0
20200430,708749,旺矽永豐97購03,,,,,,0.00,0,0,0,0,0,0,0,0,0,0,0,0,0
20200430,708750,信驊永豐97購01,0.84,0.91,0.84,0.91,+0.15,19.74,15000,3,12950,0,0,0,0,0,0,10000,4000,6000,6000
20200430,708751,聯亞永豐97購01,1.51,1.51,1.30,1.30,-0.17,-11.56,707000,19,975140,0,0,0,0,0,0,301000,406000,-105000,-105000
20200430,708752,原相統一97購01,1.81,1.81,1.81,1.81,-0.02,-1.09,14000,3,25340,0,0,0,0,0,0,0,14000,-14000,-14000
20200430,708753,廣明統一9A購01,1.39,1.41,1.30,1.31,-0.08,-5.76,215000,15,291320,0,0,0,0,0,0,166000,61000,105000,105000
20200430,708754,聯亞統一98購01,1.01,1.01,0.82,0.82,-0.14,-14.58,346000,12,303160,0,0,0,0,0,0,326000,20000,306000,306000
20200430,708755,鈊象統一99購01,,,,,,0.00,0,0,0,0,0,0,0,0,0,0,0,0,0
20200430,708756,大中國票98購01,0.70,0.70,0.67,0.69,+0.04,6.15,74000,5,51320,0,0,0,0,0,0,74000,0,74000,74000
20200430,708757,大江國票97購06,,,,,,0.00,0,0,0,0,0,0,0,0,0,0,0,0,0
20200430,708758,佳邦國票98購01,1.08,1.08,1.02,1.02,+0.02,2.0,45000,3,47100,0,0,0,0,0,0,0,45000,-45000,-45000
20200430,708759,宜鼎國票97購04,,,,,,0.00,0,0,0,0,0,0,0,0,0,0,0,0,0
20200430,708760,信昌電國票98購02,1.80,1.80,1.70,1.70,+0.24,16.44,9000,3,16060,0,0,0,0,0,0,1000,9000,-8000,-8000
20200430,708761,宣德國票98購01,,,,,,0.00,0,0,0,0,0,0,0,0,0,0,0,0,0
20200430,708762,神盾國票98購02,0.52,0.52,0.47,0.51,+0.03,6.25,1270000,20,647110,0,0,0,0,0,0,121000,1149000,-1028000,-1028000
20200430,708763,群聯國票98購03,0.50,0.50,0.50,0.50,+0.39,354.55,1000,1,500,0,0,0,0,0,0,0,0,0,0
20200430,708764,緯軟國票98購01,1.10,1.13,0.99,0.99,+0.20,25.32,143000,7,154720,0,0,0,0,0,0,0,143000,-143000,-143000
20200430,708765,威剛國泰98購03,,,,,,0.00,0,0,0,0,0,0,0,0,0,0,0,0,0
20200430,708766,廣明國泰98購01,2.19,2.19,2.19,2.19,-0.24,-9.88,29000,2,63510,0,0,0,0,0,0,29000,0,29000,29000
20200430,708767,穩懋富邦99購01,0.78,0.78,0.78,0.78,+0.10,14.71,1000,1,780,0,0,0,0,0,0,1000,0,1000,1000
20200430,708768,六角元大97購01,0.22,0.25,0.22,0.25,+0.05,25.0,15000,3,3500,0,0,0,0,0,0,15000,0,15000,15000
20200430,708769,合晶元大98購03,1.75,1.98,1.74,1.98,+0.26,15.12,706000,30,1290520,0,0,0,0,0,0,149000,561000,-412000,-412000
20200430,708770,泰博元大97購01,,,,,,0.00,0,0,0,0,0,0,0,0,0,0,0,0,0
20200430,708771,精測元大97購05,,,,,,0.00,0,0,0,0,0,0,0,0,0,0,0,0,0
20200430,708772,聚積元大98購01,,,,,,0.00,0,0,0,0,0,0,0,0,0,0,0,0,0
20200430,708773,廣明元大97購02,,,,,,0.00,0,0,0,0,0,0,0,0,0,0,0,0,0
20200430,708774,璟德元大97購04,0.72,0.72,0.72,0.72,+0.03,4.35,3000,1,2160,0,0,0,0,0,0,3000,0,3000,3000
20200430,708775,穩懋元大97購07,0.92,0.92,0.83,0.83,+0.16,23.88,18000,4,15990,0,0,0,0,0,0,0,18000,-18000,-18000
20200430,708776,穩懋元大98購01,1.03,1.04,1.00,1.00,+0.22,28.21,65000,7,65700,0,0,0,0,0,0,0,65000,-65000,-65000
20200430,708777,旺矽兆豐98購01,0.39,0.39,0.39,0.39,+0.06,18.18,10000,1,3900,0,0,0,0,0,0,10000,0,10000,10000
20200430,708778,環球晶兆豐98購01,0.67,0.73,0.66,0.73,+0.17,30.36,32000,5,22370,0,0,0,0,0,0,22000,20000,2000,2000
20200430,708779,雙鴻兆豐98購01,1.10,1.10,1.06,1.06,+0.02,1.92,120000,6,131600,0,0,0,0,0,0,10000,110000,-100000,-100000
20200430,708780,穩懋兆豐97購03,,,,,,0.00,0,0,0,0,0,0,0,0,0,0,0,0,0
20200430,708781,信驊群益97購01,4.65,4.86,4.58,4.72,+0.43,10.02,320000,18,1522890,0,0,0,0,0,0,220000,100000,120000,120000
20200430,708782,建榮群益98購01,0.21,0.21,0.20,0.20,+0.06,42.86,300000,4,61000,0,0,0,0,0,0,200000,300000,-100000,-100000
20200430,708783,優群群益99購01,,,,,,0.00,0,0,0,0,0,0,0,0,0,0,0,0,0
20200430,708784,環宇群益97購02,,,,,,0.00,0,0,0,0,0,0,0,0,0,0,0,0,0
20200430,708785,信驊中信9B購01,0.81,0.85,0.81,0.84,+0.10,13.51,508000,21,423860,0,0,0,0,0,0,82000,363000,-281000,-281000
20200430,708786,中美晶凱基97購05,3.49,3.74,3.49,3.62,+0.33,10.03,49000,15,177520,0,0,0,0,0,0,16000,49000,-33000,-33000
20200430,708787,同致凱基98購02,,,,,,0.00,0,0,0,0,0,0,0,0,0,0,0,0,0
20200430,708788,泰博凱基99購01,,,,,,0.00,0,0,0,0,0,0,0,0,0,0,0,0,0
20200430,708789,群聯凱基97購01,1.45,1.45,1.42,1.42,+0.19,15.45,21000,5,30150,0,0,0,0,0,0,13000,10000,3000,3000
20200430,708790,優群凱基98購04,,,,,,0.00,0,0,0,0,0,0,0,0,0,0,0,0,0
20200430,708791,雙美凱基99購02,,,,,,0.00,0,0,0,0,0,0,0,0,0,0,0,0,0
20200430,708792,凡甲國票98購01,1.42,1.42,1.39,1.39,-0.04,-2.8,34000,5,47460,0,0,0,0,0,0,11000,21000,-10000,-10000
20200430,708793,迅得國票98購01,0.64,0.64,0.64,0.64,-0.02,-3.03,45000,1,28800,0,0,0,0,0,0,45000,0,45000,45000
20200430,708794,旺矽國票98購01,,,,,,0.00,0,0,0,0,0,0,0,0,0,0,0,0,0
20200430,708795,原相國票98購03,3.26,3.26,3.26,3.26,-0.25,-7.12,4000,1,13040,0,0,0,0,0,0,0,4000,-4000,-4000
20200430,708796,兆利群益97購01,0.62,0.62,0.59,0.59,0.00,0.0,280000,3,166850,0,0,0,0,0,0,127000,153000,-26000,-26000
20200430,708797,金居群益99購01,0.99,1.11,0.99,1.10,+0.29,35.8,298000,10,310260,0,0,0,0,0,0,19000,279000,-260000,-260000
20200430,708798,晶焱群益99購01,0.40,0.40,0.40,0.40,0.00,0.0,10000,1,4000,0,0,0,0,0,0,10000,10000,0,0
20200430,708799,閎康群益97購02,1.08,1.08,1.01,1.01,-0.19,-15.83,123000,4,125830,0,0,0,0,0,0,123000,5000,118000,118000
20200430,708800,凡甲元富99購01,1.14,1.19,1.13,1.13,-0.10,-8.13,455000,47,522040,0,0,0,0,0,0,232000,201000,31000,31000
20200430,708801,六角元富97購01,0.85,0.89,0.82,0.88,+0.08,10.0,190000,20,161680,0,0,0,0,0,0,120000,70000,50000,50000
20200430,708802,欣銓元富97購01,,,,,,0.00,0,0,0,0,0,0,0,0,0,0,0,0,0
20200430,708803,晶焱元富99購01,0.40,0.41,0.40,0.41,0.00,0.0,50000,4,20200,0,0,0,0,0,0,50000,50000,0,0
20200430,708804,廣明元富99購01,1.81,1.81,1.62,1.62,-0.17,-9.5,306000,20,532070,0,0,0,0,0,0,234000,72000,162000,162000
20200430,708805,環球晶元富98購01,0.63,0.65,0.63,0.64,+0.08,14.29,39000,5,24960,0,0,0,0,0,0,39000,20000,19000,19000
20200430,708806,環球晶元富99購01,0.69,0.73,0.69,0.70,+0.14,25.0,105000,15,75050,0,0,0,0,0,0,105000,105000,0,0
20200430,708807,雙美元富97購01,,,,,,0.00,0,0,0,0,0,0,0,0,0,0,0,0,0
20200430,708808,雙鴻元富97購01,0.94,0.94,0.92,0.92,+0.03,3.37,30000,3,28000,0,0,0,0,0,0,10000,20000,-10000,-10000
20200430,708809,穩懋元富97購02,,,,,,0.00,0,0,0,0,0,0,0,0,0,0,0,0,0
20200430,708810,鈊象元富97購01,,,,,,0.00,0,0,0,0,0,0,0,0,0,0,0,0,0
20200430,708811,雙鴻國泰98購01,,,,,,0.00,0,0,0,0,0,0,0,0,0,0,0,0,0
20200430,708812,精測台新98購01,,,,,,0.00,0,0,0,0,0,0,0,0,0,0,0,0,0
20200430,708813,宇峻元大98購01,,,,,,0.00,0,0,0,0,0,0,0,0,0,0,0,0,0
20200430,708814,建榮元大97購04,,,,,,0.00,0,0,0,0,0,0,0,0,0,0,0,0,0
20200430,708815,泰博元大97購02,6.05,6.05,5.55,5.60,0.00,0.0,15000,3,88400,0,0,0,0,0,0,15000,0,15000,15000
20200430,708816,聯亞元大97購06,1.56,1.57,1.41,1.43,-0.14,-8.92,1358000,18,1949980,0,0,0,0,0,0,70000,1288000,-1218000,-1218000
20200430,708817,譜瑞元大98購01,4.70,4.70,4.70,4.70,+0.10,2.17,1000,1,4700,0,0,0,0,0,0,1000,0,1000,1000
20200430,708818,鈊象元大98購03,2.06,2.06,2.06,2.06,-0.19,-8.44,1000,1,2060,0,0,0,0,0,0,0,1000,-1000,-1000
20200430,708819,合晶永豐97購04,0.51,0.51,0.51,0.51,+0.12,30.77,1000,1,510,0,0,0,0,0,0,1000,0,1000,1000
20200430,708820,威剛永豐99購01,,,,,,0.00,0,0,0,0,0,0,0,0,0,0,0,0,0
20200430,708821,原相永豐97購02,0.38,0.38,0.34,0.34,-0.01,-2.86,19000,3,6760,0,0,0,0,0,0,5000,1000,4000,4000
20200430,708822,泰博永豐97購01,1.65,1.65,1.49,1.55,-0.04,-2.52,112000,11,176560,0,0,0,0,0,0,62000,50000,12000,12000
20200430,708823,勝麗永豐97購01,,,,,,0.00,0,0,0,0,0,0,0,0,0,0,0,0,0
20200430,708824,廣明永豐97購03,1.70,1.70,1.70,1.70,-0.16,-8.6,30000,2,51000,0,0,0,0,0,0,30000,0,30000,30000
20200430,708825,碩禾中信9A購01,0.05,0.07,0.05,0.07,+0.02,40.0,21000,3,1070,0,0,0,0,0,0,0,21000,-21000,-21000
20200430,708826,威剛統一9A購01,,,,,,0.00,0,0,0,0,0,0,0,0,0,0,0,0,0
20200430,708827,群聯統一97購02,,,,,,0.00,0,0,0,0,0,0,0,0,0,0,0,0,0
20200430,708828,六角凱基99購01,0.31,0.34,0.31,0.34,+0.05,17.24,3000,3,970,0,0,0,0,0,0,0,3000,-3000,-3000
20200430,708829,宜鼎凱基98購01,0.59,0.66,0.59,0.66,+0.10,17.86,46000,8,28650,0,0,0,0,0,0,41000,0,41000,41000
20200430,708830,信昌電凱基97購03,1.06,1.21,1.06,1.13,+0.21,22.83,63000,7,70000,0,0,0,0,0,0,33000,33000,0,0
20200430,708831,廣明凱基99購01,2.16,2.17,2.14,2.14,-0.03,-1.38,34000,7,73140,0,0,0,0,0,0,34000,0,34000,34000
20200430,708832,群聯台新97購04,0.02,0.02,0.02,0.02,-0.22,-91.67,10000,1,200,0,0,0,0,0,0,0,10000,-10000,-10000
20200430,708833,中美晶元大97購05,1.79,1.79,1.79,1.79,+0.12,7.19,45000,3,80550,0,0,0,0,0,0,45000,0,45000,45000
20200430,708834,中美晶元大97購06,2.01,2.17,1.97,2.11,+0.19,9.9,297000,40,610050,0,0,0,0,0,0,160000,157000,3000,3000
20200430,708835,昂寶元大97購03,,,,,,0.00,0,0,0,0,0,0,0,0,0,0,0,0,0
20200430,708836,宣德元大97購02,0.55,0.55,0.55,0.55,+0.10,22.22,3000,1,1650,0,0,0,0,0,0,3000,0,3000,3000
20200430,708837,新普元大97購04,,,,,,0.00,0,0,0,0,0,0,0,0,0,0,0,0,0
20200430,708838,新普元大97購05,2.89,2.92,2.84,2.92,-0.05,-1.68,95000,5,272260,0,0,0,0,0,0,20000,75000,-55000,-55000
20200430,708839,群聯元大97購06,0.11,0.11,0.11,0.11,-0.05,-31.25,60000,1,6600,0,0,0,0,0,0,60000,0,60000,60000
20200430,708840,雍智元大99購01,0.61,0.61,0.61,0.61,+0.04,7.02,1000,1,610,0,0,0,0,0,0,1000,0,1000,1000
20200430,708841,網龍元大98購01,,,,,,0.00,0,0,0,0,0,0,0,0,0,0,0,0,0
20200430,708842,環球晶元大97購04,2.85,3.37,2.85,3.37,+0.35,11.59,116000,14,369090,0,0,0,0,0,0,24000,96000,-72000,-72000
20200430,708843,環球晶元大97購05,2.83,3.26,2.83,3.26,+0.61,23.02,161000,18,482670,0,0,0,0,0,0,64000,111000,-47000,-47000
20200430,708844,聯亞元大97購07,3.63,3.96,3.61,3.77,-0.06,-1.57,58000,7,216660,0,0,0,0,0,0,58000,0,58000,58000
20200430,708845,雙鴻元大97購03,1.09,1.09,1.09,1.09,+0.03,2.83,4000,1,4360,0,0,0,0,0,0,0,0,0,0
20200430,708846,鈊象元大98購04,1.77,1.77,1.55,1.55,-0.12,-7.19,174000,23,279540,0,0,0,0,0,0,31000,151000,-120000,-120000
20200430,708847,群聯第一97購01,,,,,,0.00,0,0,0,0,0,0,0,0,0,0,0,0,0
20200430,708848,中美晶永豐97購01,1.20,1.26,1.20,1.23,+0.11,9.82,37000,12,45550,0,0,0,0,0,0,15000,37000,-22000,-22000
20200430,708849,胡連永豐97購01,0.20,0.20,0.20,0.20,0.00,0.0,39000,1,7800,0,0,0,0,0,0,39000,0,39000,39000
20200430,708850,閎康永豐97購02,0.80,0.85,0.80,0.85,-0.08,-8.6,171000,6,142170,0,0,0,0,0,0,116000,55000,61000,61000
20200430,708851,精測永豐97購02,0.31,0.32,0.29,0.29,+0.01,3.57,110000,6,34500,0,0,0,0,0,0,10000,93000,-83000,-83000
20200430,708852,鈊象永豐97購02,1.96,1.96,1.44,1.47,-0.32,-17.88,99000,12,164240,0,0,0,0,0,0,36000,63000,-27000,-27000
20200430,708853,世界群益98購04,,,,,,0.00,0,0,0,0,0,0,0,0,0,0,0,0,0
20200430,708854,晶焱群益99購02,0.58,0.58,0.57,0.58,+0.02,3.57,85000,3,49140,0,0,0,0,0,0,85000,20000,65000,65000
20200430,708855,大江元富97購01,0.93,0.93,0.86,0.87,+0.05,6.1,26000,3,22880,0,0,0,0,0,0,0,26000,-26000,-26000
20200430,708856,台燿元富97購01,,,,,,0.00,0,0,0,0,0,0,0,0,0,0,0,0,0
20200430,708857,宜鼎元富97購01,1.25,1.33,1.24,1.32,+0.10,8.2,278000,29,364430,0,0,0,0,0,0,38000,245000,-207000,-207000
20200430,708858,昇達科元富97購01,,,,,,0.00,0,0,0,0,0,0,0,0,0,0,0,0,0
20200430,708859,信驊元富97購01,3.04,3.14,2.94,3.14,+0.44,16.3,45000,7,135800,0,0,0,0,0,0,35000,10000,25000,25000
20200430,708860,威剛元富97購02,0.17,0.17,0.17,0.17,-0.01,-5.56,15000,2,2550,0,0,0,0,0,0,0,15000,-15000,-15000
20200430,708861,新普元富97購01,1.85,1.85,1.80,1.84,-0.02,-1.08,65000,3,118920,0,0,0,0,0,0,32000,33000,-1000,-1000
20200430,708862,網家元富97購01,0.80,0.80,0.67,0.70,-0.01,-1.41,110000,4,77470,0,0,0,0,0,0,99000,10000,89000,89000
20200430,708863,聚積元富97購01,,,,,,0.00,0,0,0,0,0,0,0,0,0,0,0,0,0
20200430,708864,穩懋元富97購03,0.92,0.92,0.88,0.88,+0.10,12.82,231000,45,211520,0,0,0,0,0,0,211000,84000,127000,127000
20200430,708865,直得國票97購01,0.44,0.76,0.44,0.65,+0.21,47.73,516000,14,336850,0,0,0,0,0,0,281000,235000,46000,46000
20200430,708866,原相國泰98購04,2.94,2.94,2.84,2.86,-0.02,-0.69,30000,3,86000,0,0,0,0,0,0,30000,0,30000,30000
20200430,708867,鈊象國泰99購01,2.14,2.14,2.09,2.09,-0.15,-6.7,11000,2,23040,0,0,0,0,0,0,11000,0,11000,11000
20200430,708868,鈊象中信99購01,1.27,1.27,1.27,1.27,-0.15,-10.56,32000,3,40640,0,0,0,0,0,0,30000,0,30000,30000
20200430,708869,凡甲凱基98購01,1.02,1.06,1.00,1.00,-0.09,-8.26,234000,12,239900,0,0,0,0,0,0,65000,169000,-104000,-104000
20200430,708870,大江凱基98購03,,,,,,0.00,0,0,0,0,0,0,0,0,0,0,0,0,0
20200430,708871,信驊凱基98購01,,,,,,0.00,0,0,0,0,0,0,0,0,0,0,0,0,0
20200430,708872,新鉅科凱基97購01,,,,,,0.00,0,0,0,0,0,0,0,0,0,0,0,0,0
20200430,708873,精測凱基98購02,,,,,,0.00,0,0,0,0,0,0,0,0,0,0,0,0,0
20200430,708874,群聯統一97購03,1.59,1.59,1.48,1.56,+0.21,15.56,67000,5,100880,0,0,0,0,0,0,17000,50000,-33000,-33000
20200430,708875,譜瑞統一97購01,,,,,,0.00,0,0,0,0,0,0,0,0,0,0,0,0,0
20200430,708876,信昌電兆豐98購01,0.24,0.24,0.24,0.24,+0.05,26.32,10000,1,2400,0,0,0,0,0,0,10000,0,10000,10000
20200430,708877,胡連康和97購01,,,,,,0.00,0,0,0,0,0,0,0,0,0,0,0,0,0
20200430,708878,台燿群益97購01,1.28,1.39,1.23,1.36,+0.32,30.77,467000,10,602400,0,0,0,0,0,0,249000,172000,77000,77000
20200430,708879,博智群益97購01,,,,,,0.00,0,0,0,0,0,0,0,0,0,0,0,0,0
20200430,708880,雙鴻群益99購01,,,,,,0.00,0,0,0,0,0,0,0,0,0,0,0,0,0
20200430,708881,金居國泰99購01,0.85,0.95,0.76,0.95,+0.35,58.33,539000,52,441900,0,0,0,0,0,0,185000,344000,-159000,-159000
20200430,708882,威剛元富97購04,0.84,0.84,0.84,0.84,+0.04,5.0,20000,2,16800,0,0,0,0,0,0,0,20000,-20000,-20000
20200430,708883,原相元富97購02,0.51,0.51,0.51,0.51,-0.14,-21.54,30000,1,15300,0,0,0,0,0,0,30000,0,30000,30000
20200430,708884,聯亞元富97購03,,,,,,0.00,0,0,0,0,0,0,0,0,0,0,0,0,0
20200430,708885,穩懋元富97購04,,,,,,0.00,0,0,0,0,0,0,0,0,0,0,0,0,0
20200430,708886,鈊象元富97購02,4.98,4.98,4.44,4.44,-0.21,-4.52,48000,5,231650,0,0,0,0,0,0,39000,9000,30000,30000
20200430,708887,鈊象台新97購02,,,,,,0.00,0,0,0,0,0,0,0,0,0,0,0,0,0
20200430,708888,中美晶元大97購07,1.63,1.77,1.59,1.71,+0.09,5.56,204000,21,344470,0,0,0,0,0,0,79000,137000,-58000,-58000
20200430,708889,台燿元大97購01,1.25,1.28,1.16,1.27,+0.22,20.95,508000,27,620620,0,0,0,0,0,0,196000,302000,-106000,-106000
20200430,708890,宜鼎元大97購02,1.38,1.46,1.36,1.46,+0.17,13.18,684000,38,972880,0,0,0,0,0,0,422000,400000,22000,22000
20200430,708891,金居元大99購01,0.64,0.72,0.63,0.72,+0.19,35.85,1015000,36,681480,0,0,0,0,0,0,125000,890000,-765000,-765000
20200430,708892,胡連元大97購01,,,,,,0.00,0,0,0,0,0,0,0,0,0,0,0,0,0
20200430,708893,泰博元大97購03,4.27,4.27,4.27,4.27,+0.02,0.47,3000,1,12810,0,0,0,0,0,0,3000,0,3000,3000
20200430,708894,閎康元大97購01,0.98,1.84,0.92,0.93,-0.08,-7.92,620000,26,632170,0,0,0,0,0,0,392000,181000,211000,211000
20200430,708895,環球晶元大97購06,,,,,,0.00,0,0,0,0,0,0,0,0,0,0,0,0,0
20200430,708896,環球晶元大97購07,,,,,,0.00,0,0,0,0,0,0,0,0,0,0,0,0,0
20200430,708897,櫃200元大99購03,,,,,,0.00,0,0,0,0,0,0,0,0,0,0,0,0,0
20200430,708898,櫃200元大99購04,,,,,,0.00,0,0,0,0,0,0,0,0,0,0,0,0,0
20200430,708899,頎邦元大97購05,0.81,0.90,0.81,0.90,+0.12,15.38,32000,3,27260,0,0,0,0,0,0,12000,32000,-20000,-20000
20200430,708900,中美晶元大97購08,1.65,1.78,1.62,1.73,+0.15,9.49,203000,27,337110,0,0,0,0,0,0,128000,83000,45000,45000
20200430,708901,台燿元大97購02,1.25,1.28,1.17,1.28,+0.25,24.27,977000,36,1181510,0,0,0,0,0,0,547000,425000,122000,122000
20200430,708902,迅得元大99購01,,,,,,0.00,0,0,0,0,0,0,0,0,0,0,0,0,0
20200430,708903,宜鼎元大97購03,,,,,,0.00,0,0,0,0,0,0,0,0,0,0,0,0,0
20200430,708904,旺矽元大98購01,,,,,,0.00,0,0,0,0,0,0,0,0,0,0,0,0,0
20200430,708905,威剛元大97購01,,,,,,0.00,0,0,0,0,0,0,0,0,0,0,0,0,0
20200430,708906,泰博元大97購04,2.82,2.85,2.82,2.85,-0.15,-5.0,55000,2,155250,0,0,0,0,0,0,55000,5000,50000,50000
20200430,708907,精測元大97購06,0.68,0.70,0.64,0.64,+0.01,1.59,808000,34,542330,0,0,0,0,0,0,478000,330000,148000,148000
20200430,708908,廣明元大97購03,2.67,2.67,2.38,2.38,-0.26,-9.85,74000,10,186090,0,0,0,0,0,0,37000,37000,0,0
20200430,708909,優群元大99購01,,,,,,0.00,0,0,0,0,0,0,0,0,0,0,0,0,0
20200430,708910,環球晶元大97購08,1.96,2.25,1.96,2.25,+0.27,13.64,93000,9,202250,0,0,0,0,0,0,4000,92000,-88000,-88000
20200430,708911,環球晶元大97購09,1.32,1.65,1.31,1.65,+0.43,35.25,239000,15,356740,0,0,0,0,0,0,75000,179000,-104000,-104000
20200430,708912,世界麥證97購02,,,,,,0.00,0,0,0,0,0,0,0,0,0,0,0,0,0
20200430,708913,大江永豐97購03,0.44,0.44,0.44,0.44,+0.05,12.82,10000,1,4400,0,0,0,0,0,0,0,10000,-10000,-10000
20200430,708914,旺矽永豐97購04,,,,,,0.00,0,0,0,0,0,0,0,0,0,0,0,0,0
20200430,708915,新普永豐97購01,0.91,0.91,0.87,0.90,+0.02,2.27,78000,5,69500,0,0,0,0,0,0,1000,77000,-76000,-76000
20200430,708916,精華永豐97購01,0.05,0.05,0.05,0.05,+0.01,25.0,5000,1,250,0,0,0,0,0,0,0,5000,-5000,-5000
20200430,708917,原相兆豐98購01,0.74,0.74,0.74,0.74,+0.01,1.37,25000,3,18500,0,0,0,0,0,0,25000,10000,15000,15000
20200430,708918,群聯台新97購05,0.02,0.02,0.02,0.02,-0.21,-91.3,10000,1,200,0,0,0,0,0,0,0,10000,-10000,-10000
20200430,708919,中美晶群益97購04,,,,,,0.00,0,0,0,0,0,0,0,0,0,0,0,0,0
20200430,708920,同致群益97購01,0.65,0.67,0.65,0.67,+0.23,52.27,13000,2,8510,0,0,0,0,0,0,10000,3000,7000,7000
20200430,708921,勝麗群益97購01,0.67,0.74,0.67,0.74,+0.10,15.62,166000,5,118580,0,0,0,0,0,0,0,166000,-166000,-166000
20200430,708922,緯軟群益98購02,0.38,0.41,0.37,0.37,+0.07,23.33,226000,5,88620,0,0,0,0,0,0,16000,210000,-194000,-194000
20200430,708923,鈊象群益97購01,4.84,4.84,3.69,3.73,-0.90,-19.44,68000,11,276590,0,0,0,0,0,0,22000,56000,-34000,-34000
20200430,708924,穩懋永昌9C購01,3.99,4.26,3.99,4.17,+0.34,8.88,58000,11,241230,0,0,0,0,0,0,30000,1000,29000,29000
20200430,708925,世界統一97購02,,,,,,0.00,0,0,0,0,0,0,0,0,0,0,0,0,0
20200430,708926,胡連統一98購01,,,,,,0.00,0,0,0,0,0,0,0,0,0,0,0,0,0
20200430,708927,胡連統一99購01,,,,,,0.00,0,0,0,0,0,0,0,0,0,0,0,0,0
20200430,708928,環球晶統一97購02,1.11,1.27,1.11,1.27,+0.11,9.48,200000,6,232860,0,0,0,0,0,0,0,200000,-200000,-200000
20200430,708929,雍智中信97購01,0.33,0.38,0.33,0.37,+0.05,15.62,655000,7,231500,0,0,0,0,0,0,340000,315000,25000,25000
20200430,708930,聚積中信97購01,,,,,,0.00,0,0,0,0,0,0,0,0,0,0,0,0,0
20200430,708931,VHQ凱基97購01,,,,,,0.00,0,0,0,0,0,0,0,0,0,0,0,0,0
20200430,708932,VHQ凱基98購01,,,,,,0.00,0,0,0,0,0,0,0,0,0,0,0,0,0
20200430,708933,神盾凱基98購02,,,,,,0.00,0,0,0,0,0,0,0,0,0,0,0,0,0
20200430,708934,晶焱凱基98購02,,,,,,0.00,0,0,0,0,0,0,0,0,0,0,0,0,0
20200430,708935,環球晶凱基97購04,0.29,0.29,0.29,0.29,+0.05,20.83,50000,1,14500,0,0,0,0,0,0,50000,0,50000,50000
20200430,708936,環球晶凱基97購05,0.10,0.10,0.10,0.10,0.00,0.0,20000,1,2000,0,0,0,0,0,0,20000,0,20000,20000
20200430,708937,雙鴻富邦98購01,,,,,,0.00,0,0,0,0,0,0,0,0,0,0,0,0,0
20200430,708938,大宇資國票98購01,,,,,,0.00,0,0,0,0,0,0,0,0,0,0,0,0,0
20200430,708939,金居國票98購03,2.30,2.65,2.23,2.65,+0.78,41.71,135000,7,317410,0,0,0,0,0,0,40000,95000,-55000,-55000
20200430,708940,碩禾國票98購01,,,,,,0.00,0,0,0,0,0,0,0,0,0,0,0,0,0
20200430,708941,M31元富97購01,0.57,0.58,0.57,0.58,+0.08,16.0,29000,2,16730,0,0,0,0,0,0,0,29000,-29000,-29000
20200430,708942,金居第一97購01,0.24,0.31,0.24,0.31,+0.17,121.43,2000,2,550,0,0,0,0,0,0,0,2000,-2000,-2000
20200430,708943,M31元富97購02,0.54,0.57,0.54,0.57,+0.05,9.62,108000,2,61320,0,0,0,0,0,0,8000,100000,-92000,-92000
20200430,708944,閎康元富97購01,0.55,0.55,0.52,0.53,-0.02,-3.64,101000,6,54330,0,0,0,0,0,0,100000,1000,99000,99000
20200430,708945,大田永豐97購01,,,,,,0.00,0,0,0,0,0,0,0,0,0,0,0,0,0
20200430,708946,六角永豐97購02,0.40,0.44,0.40,0.44,+0.06,15.79,142000,5,60100,0,0,0,0,0,0,0,142000,-142000,-142000
20200430,708947,群聯永豐97購01,,,,,,0.00,0,0,0,0,0,0,0,0,0,0,0,0,0
20200430,708948,雙鴻永豐97購04,0.73,0.73,0.69,0.69,+0.01,1.47,78000,2,54220,0,0,0,0,0,0,68000,10000,58000,58000
20200430,708949,旺矽康和97購02,0.51,0.51,0.51,0.51,+0.06,13.33,101000,2,51510,0,0,0,0,0,0,42000,59000,-17000,-17000
20200430,708950,威剛康和97購02,0.46,0.46,0.45,0.45,+0.01,2.27,40000,4,18300,0,0,0,0,0,0,0,40000,-40000,-40000
20200430,708951,合晶群益99購01,2.00,2.15,2.00,2.15,+0.30,16.22,119000,11,250020,0,0,0,0,0,0,7000,119000,-112000,-112000
20200430,708952,迅得群益98購01,0.41,0.41,0.40,0.40,-0.03,-6.98,3000,3,1220,0,0,0,0,0,0,3000,0,3000,3000
20200430,708953,宜鼎群益97購02,,,,,,0.00,0,0,0,0,0,0,0,0,0,0,0,0,0
20200430,708954,胡連群益97購01,0.23,0.23,0.23,0.23,+0.03,15.0,10000,1,2300,0,0,0,0,0,0,0,10000,-10000,-10000
20200430,708955,雙美群益98購01,,,,,,0.00,0,0,0,0,0,0,0,0,0,0,0,0,0
20200430,708956,大江凱基97購02,,,,,,0.00,0,0,0,0,0,0,0,0,0,0,0,0,0
20200430,708957,世界凱基97購01,,,,,,0.00,0,0,0,0,0,0,0,0,0,0,0,0,0
20200430,708958,台燿凱基98購01,2.94,2.94,2.87,2.94,+0.43,17.13,24000,5,70460,0,0,0,0,0,0,3000,21000,-18000,-18000
20200430,708959,宣德凱基98購01,,,,,,0.00,0,0,0,0,0,0,0,0,0,0,0,0,0
20200430,708960,璟德凱基97購01,1.53,1.70,1.53,1.66,+0.10,6.41,75000,10,119610,0,0,0,0,0,0,3000,72000,-69000,-69000
20200430,708961,環球晶凱基97購06,1.83,2.02,1.83,2.02,+0.10,5.21,50000,5,97110,0,0,0,0,0,0,17000,33000,-16000,-16000
20200430,708962,鈊象凱基98購04,2.49,2.49,2.05,2.05,-0.43,-17.34,104000,7,217240,0,0,0,0,0,0,91000,13000,78000,78000
20200430,708963,譜瑞凱基97購02,,,,,,0.00,0,0,0,0,0,0,0,0,0,0,0,0,0
20200430,708964,信昌電國票98購03,,,,,,0.00,0,0,0,0,0,0,0,0,0,0,0,0,0
20200430,708965,廣明國票98購03,2.41,2.41,2.41,2.41,-0.11,-4.37,25000,1,60250,0,0,0,0,0,0,25000,0,25000,25000
20200430,708966,聯亞國票98購01,2.32,2.32,2.06,2.09,-0.14,-6.28,1138000,19,2414400,0,0,0,0,0,0,145000,988000,-843000,-843000
20200430,708967,大江元大97購05,,,,,,0.00,0,0,0,0,0,0,0,0,0,0,0,0,0
20200430,708968,中美晶元大97購09,0.25,0.25,0.25,0.25,0.00,0.0,1000,1,250,0,0,0,0,0,0,0,0,0,0
20200430,708969,宣德元大97購03,,,,,,0.00,0,0,0,0,0,0,0,0,0,0,0,0,0
20200430,708970,群聯元大97購07,,,,,,0.00,0,0,0,0,0,0,0,0,0,0,0,0,0
20200430,708971,精測元大97購07,,,,,,0.00,0,0,0,0,0,0,0,0,0,0,0,0,0
20200430,708972,網龍元大98購02,,,,,,0.00,0,0,0,0,0,0,0,0,0,0,0,0,0
20200430,708973,聚積元大97購01,,,,,,0.00,0,0,0,0,0,0,0,0,0,0,0,0,0
20200430,708974,環球晶元大97購10,1.71,1.80,1.71,1.80,+0.21,13.21,130000,6,226810,0,0,0,0,0,0,0,130000,-130000,-130000
20200430,708975,環球晶元大97購11,,,,,,0.00,0,0,0,0,0,0,0,0,0,0,0,0,0
20200430,708976,環球晶元大97購12,1.45,1.69,1.45,1.69,+0.31,22.46,124000,6,193200,0,0,0,0,0,0,24000,100000,-76000,-76000
20200430,708977,M31兆豐97購01,,,,,,0.00,0,0,0,0,0,0,0,0,0,0,0,0,0
20200430,708978,頎邦兆豐97購01,0.29,0.31,0.29,0.31,+0.07,29.17,85000,3,24950,0,0,0,0,0,0,75000,0,75000,75000
20200430,708979,VHQ統一98購01,,,,,,0.00,0,0,0,0,0,0,0,0,0,0,0,0,0
20200430,708980,威剛統一98購01,,,,,,0.00,0,0,0,0,0,0,0,0,0,0,0,0,0
20200430,708981,光頡國票98購03,0.88,0.97,0.83,0.83,+0.09,12.16,61000,9,55710,0,0,0,0,0,0,7000,54000,-47000,-47000
20200430,708982,大學光國泰99購01,1.72,1.73,1.63,1.63,-0.10,-5.78,100000,7,167930,0,0,0,0,0,0,100000,30000,70000,70000
20200430,708983,穩懋國泰98購02,1.07,1.07,1.06,1.07,+0.12,12.63,20000,8,21380,0,0,0,0,0,0,20000,20000,0,0
20200430,708984,大江凱基97購03,,,,,,0.00,0,0,0,0,0,0,0,0,0,0,0,0,0
20200430,708985,六角凱基99購02,0.40,0.44,0.40,0.44,+0.06,15.79,3000,3,1260,0,0,0,0,0,0,0,3000,-3000,-3000
20200430,708986,旺矽凱基97購02,0.68,0.78,0.68,0.77,+0.07,10.0,774000,14,574540,0,0,0,0,0,0,468000,414000,54000,54000
20200430,708987,環球晶凱基97購07,,,,,,0.00,0,0,0,0,0,0,0,0,0,0,0,0,0
20200430,708988,雙鴻凱基98購02,1.52,1.52,1.45,1.49,+0.05,3.47,161000,7,238050,0,0,0,0,0,0,147000,24000,123000,123000
20200430,708989,穩懋凱基97購05,3.05,3.05,2.93,2.93,+0.33,12.69,37000,8,110150,0,0,0,0,0,0,27000,10000,17000,17000
20200430,708990,穩懋凱基98購01,,,,,,0.00,0,0,0,0,0,0,0,0,0,0,0,0,0
20200430,708991,穩懋凱基98購02,4.80,4.80,4.80,4.80,+0.53,12.41,2000,1,9600,0,0,0,0,0,0,2000,0,2000,2000
20200430,708992,M31元大98購02,,,,,,0.00,0,0,0,0,0,0,0,0,0,0,0,0,0
20200430,708993,大學光元大98購01,1.63,1.63,1.63,1.63,-0.04,-2.4,5000,1,8150,0,0,0,0,0,0,5000,0,5000,5000
20200430,708994,中美晶元大98購01,0.35,0.35,0.35,0.35,-0.01,-2.78,10000,1,3500,0,0,0,0,0,0,10000,0,10000,10000
20200430,708995,世界元大97購01,0.70,0.75,0.70,0.75,+0.09,13.64,143000,15,104350,0,0,0,0,0,0,45000,98000,-53000,-53000
20200430,708996,保瑞元大97購01,1.90,1.90,1.90,1.90,+0.05,2.7,20000,1,38000,0,0,0,0,0,0,20000,0,20000,20000
20200430,708997,晶焱元大99購01,0.52,0.52,0.52,0.52,+0.01,1.96,80000,1,41600,0,0,0,0,0,0,80000,0,80000,80000
20200430,708998,大學光康和9B購01,,,,,,0.00,0,0,0,0,0,0,0,0,0,0,0,0,0
20200430,708999,泰博群益97購02,,,,,,0.00,0,0,0,0,0,0,0,0,0,0,0,0,0
20200430,709000,環球晶群益98購01,2.81,3.12,2.81,3.12,+0.22,7.59,83000,14,247870,0,0,0,0,0,0,21000,77000,-56000,-56000
20200430,709001,鈺太群益97購01,1.03,1.06,1.01,1.02,-0.03,-2.86,347000,12,355170,0,0,0,0,0,0,245000,135000,110000,110000
20200430,709002,環球晶日盛97購01,,,,,,0.00,0,0,0,0,0,0,0,0,0,0,0,0,0
20200430,709003,世禾永豐97購02,,,,,,0.00,0,0,0,0,0,0,0,0,0,0,0,0,0
20200430,709004,順達永豐97購01,0.67,0.67,0.65,0.65,-0.04,-5.8,61000,7,40260,0,0,0,0,0,0,55000,6000,49000,49000
20200430,709005,新揚科永豐97購01,0.18,0.19,0.17,0.18,+0.01,5.88,426000,12,74520,0,0,0,0,0,0,185000,241000,-56000,-56000
20200430,709006,穩懋永豐97購03,0.39,0.44,0.39,0.41,+0.10,32.26,700000,19,283350,0,0,0,0,0,0,494000,306000,188000,188000
20200430,709007,勝麗台新97購01,0.02,0.02,0.02,0.02,-0.19,-90.48,10000,1,200,0,0,0,0,0,0,0,10000,-10000,-10000
20200430,709008,中美晶元富99購01,,,,,,0.00,0,0,0,0,0,0,0,0,0,0,0,0,0
20200430,709009,信昌電元富97購02,1.21,1.35,1.20,1.35,+0.23,20.54,50000,5,62900,0,0,0,0,0,0,20000,30000,-10000,-10000
20200430,709010,宣德元富97購01,,,,,,0.00,0,0,0,0,0,0,0,0,0,0,0,0,0
20200430,709011,緯軟元富97購01,,,,,,0.00,0,0,0,0,0,0,0,0,0,0,0,0,0
20200430,709012,環球晶元富97購03,,,,,,0.00,0,0,0,0,0,0,0,0,0,0,0,0,0
20200430,709013,環球晶元富97購04,0.98,1.16,0.98,1.16,+0.21,22.11,108000,12,119410,0,0,0,0,0,0,11000,97000,-86000,-86000
20200430,709014,鈊象元富97購04,6.45,6.45,6.45,6.45,0.00,0.0,10000,2,64500,0,0,0,0,0,0,0,10000,-10000,-10000
20200430,709015,世禾統一99購01,0.10,0.10,0.10,0.10,-0.01,-9.09,10000,1,1000,0,0,0,0,0,0,10000,0,10000,10000
20200430,709016,世禾統一9A購01,,,,,,0.00,0,0,0,0,0,0,0,0,0,0,0,0,0
20200430,709017,金居統一98購01,2.18,2.39,2.11,2.39,+0.53,28.49,462000,19,1018880,0,0,0,0,0,0,280000,172000,108000,108000
20200430,709018,順達統一99購01,,,,,,0.00,0,0,0,0,0,0,0,0,0,0,0,0,0
20200430,709019,中美晶凱基9A購01,,,,,,0.00,0,0,0,0,0,0,0,0,0,0,0,0,0
20200430,709020,迅得凱基9A購01,,,,,,0.00,0,0,0,0,0,0,0,0,0,0,0,0,0
20200430,709021,亞泰凱基9A購01,,,,,,0.00,0,0,0,0,0,0,0,0,0,0,0,0,0
20200430,709022,保瑞凱基98購01,0.77,0.77,0.77,0.77,+0.03,4.05,5000,1,3850,0,0,0,0,0,0,0,5000,-5000,-5000
20200430,709023,新普凱基98購02,,,,,,0.00,0,0,0,0,0,0,0,0,0,0,0,0,0
20200430,709024,環球晶凱基98購01,1.70,1.90,1.70,1.90,+0.12,6.74,78000,3,146600,0,0,0,0,0,0,8000,70000,-62000,-62000
20200430,709025,環球晶凱基99購01,0.51,0.51,0.51,0.51,+0.09,21.43,1000,1,510,0,0,0,0,0,0,1000,0,1000,1000
20200430,709026,穩懋日盛98購01,,,,,,0.00,0,0,0,0,0,0,0,0,0,0,0,0,0
20200430,709027,大江國票99購01,,,,,,0.00,0,0,0,0,0,0,0,0,0,0,0,0,0
20200430,709028,凡甲富邦9A購01,1.24,1.32,1.20,1.22,-0.07,-5.43,436000,35,540060,0,0,0,0,0,0,198000,223000,-25000,-25000
20200430,709029,聯亞富邦9A購01,0.45,0.45,0.37,0.37,-0.04,-9.76,85000,16,33810,0,0,0,0,0,0,0,49000,-49000,-49000
20200430,709030,大江元大98購01,,,,,,0.00,0,0,0,0,0,0,0,0,0,0,0,0,0
20200430,709031,群聯元大99購01,,,,,,0.00,0,0,0,0,0,0,0,0,0,0,0,0,0
20200430,709032,碩禾元大99購01,,,,,,0.00,0,0,0,0,0,0,0,0,0,0,0,0,0
20200430,709033,優群元大99購02,,,,,,0.00,0,0,0,0,0,0,0,0,0,0,0,0,0
20200430,709034,環球晶元大98購01,1.64,1.80,1.64,1.80,+0.16,9.76,68000,4,120800,0,0,0,0,0,0,58000,10000,48000,48000
20200430,709035,環球晶元大98購02,,,,,,0.00,0,0,0,0,0,0,0,0,0,0,0,0,0
20200430,709036,環球晶元大98購03,0.69,0.71,0.65,0.71,+0.14,24.56,45000,4,31250,0,0,0,0,0,0,25000,20000,5000,5000
20200430,709037,聯亞元大99購01,1.59,1.59,1.34,1.34,-0.18,-11.84,1327000,29,1894450,0,0,0,0,0,0,95000,1232000,-1137000,-1137000
20200430,709038,譜瑞元大98購02,3.26,3.26,3.26,3.26,+0.08,2.52,10000,1,32600,0,0,0,0,0,0,0,10000,-10000,-10000
20200430,709039,譜瑞元富98購01,1.96,1.96,1.96,1.96,+0.10,5.38,5000,1,9800,0,0,0,0,0,0,5000,0,5000,5000
20200430,709040,勝麗台新98購01,0.23,0.23,0.02,0.02,-0.18,-90.0,36000,7,6180,0,0,0,0,0,0,26000,10000,16000,16000
20200430,709041,精測台新99購01,,,,,,0.00,0,0,0,0,0,0,0,0,0,0,0,0,0
20200430,709042,宣德兆豐98購01,0.73,0.73,0.73,0.73,-0.08,-9.88,28000,1,20440,0,0,0,0,0,0,28000,0,28000,28000
20200430,709043,威剛群益9A購01,,,,,,0.00,0,0,0,0,0,0,0,0,0,0,0,0,0
20200430,709044,統新康和98購01,1.03,1.03,1.03,1.03,-0.08,-7.21,5000,1,5150,0,0,0,0,0,0,5000,0,5000,5000
20200430,709045,神盾群益9A購01,1.68,1.68,1.68,1.68,+0.03,1.82,4000,1,6720,0,0,0,0,0,0,0,4000,-4000,-4000
20200430,709046,廣明群益98購01,1.96,1.96,1.75,1.75,-0.19,-9.79,123000,7,221550,0,0,0,0,0,0,25000,98000,-73000,-73000
20200430,709047,世禾永豐98購01,0.51,0.53,0.51,0.53,+0.04,8.16,133000,2,69830,0,0,0,0,0,0,100000,33000,67000,67000
20200430,709048,合晶永豐98購01,1.10,1.23,1.07,1.23,+0.29,30.85,213000,20,248740,0,0,0,0,0,0,56000,141000,-85000,-85000
20200430,709049,亞泰永豐99購01,1.11,1.18,1.11,1.17,+0.03,2.63,307000,6,352610,0,0,0,0,0,0,280000,27000,253000,253000
20200430,709050,金居永豐98購01,1.53,1.80,1.45,1.80,+0.66,57.89,387000,32,607340,0,0,0,0,0,0,217000,140000,77000,77000
20200430,709051,統新永豐98購01,0.86,0.91,0.78,0.79,+0.03,3.95,119000,10,103880,0,0,0,0,0,0,69000,46000,23000,23000
20200430,709052,鈊象永豐98購02,1.07,1.07,1.03,1.04,-0.20,-16.13,38000,6,39820,0,0,0,0,0,0,0,38000,-38000,-38000
20200430,709053,M31元大98購03,1.31,1.36,1.29,1.35,+0.16,13.45,335000,9,449500,0,0,0,0,0,0,5000,330000,-325000,-325000
20200430,709054,凡甲元大9A購01,2.20,2.20,2.16,2.16,+0.17,8.54,105000,2,227000,0,0,0,0,0,0,105000,0,105000,105000
20200430,709055,中美晶元大99購01,,,,,,0.00,0,0,0,0,0,0,0,0,0,0,0,0,0
20200430,709056,群聯元大98購03,,,,,,0.00,0,0,0,0,0,0,0,0,0,0,0,0,0
20200430,709057,精測元大98購02,,,,,,0.00,0,0,0,0,0,0,0,0,0,0,0,0,0
20200430,709058,緯軟元大98購01,0.68,0.84,0.68,0.81,+0.17,26.56,317000,15,234650,0,0,0,0,0,0,280000,37000,243000,243000
20200430,709059,鈊象元大99購02,3.73,3.73,3.70,3.70,-0.17,-4.39,30000,3,111300,0,0,0,0,0,0,0,30000,-30000,-30000
20200430,709060,大江國泰9A購01,,,,,,0.00,0,0,0,0,0,0,0,0,0,0,0,0,0
20200430,709061,台燿國泰99購01,2.25,2.38,2.22,2.38,+0.43,22.05,277000,21,635540,0,0,0,0,0,0,90000,176000,-86000,-86000
20200430,709062,合晶國泰99購01,2.02,2.17,2.02,2.17,+0.21,10.71,191000,10,403570,0,0,0,0,0,0,26000,165000,-139000,-139000
20200430,709063,雍智國票99購01,4.00,4.42,3.99,4.42,+0.75,20.44,77000,9,316860,0,0,0,0,0,0,12000,64000,-52000,-52000
20200430,709064,網龍國票99購01,,,,,,0.00,0,0,0,0,0,0,0,0,0,0,0,0,0
20200430,709065,雙鴻國票99購01,1.79,1.83,1.77,1.80,+0.07,4.05,121000,6,218290,0,0,0,0,0,0,61000,61000,0,0
20200430,709066,中美晶統一98購01,1.57,1.75,1.57,1.71,+0.12,7.55,171000,16,287820,0,0,0,0,0,0,14000,157000,-143000,-143000
20200430,709067,統新統一01購01,1.64,1.64,1.61,1.61,+0.05,3.21,10000,6,16180,0,0,0,0,0,0,1000,9000,-8000,-8000
20200430,709068,統新統一98購01,1.80,1.80,1.60,1.60,-0.07,-4.19,71000,6,121020,0,0,0,0,0,0,31000,40000,-9000,-9000
20200430,709069,統新統一9B購01,1.54,1.54,1.45,1.45,0.00,0.0,159000,11,235760,0,0,0,0,0,0,0,159000,-159000,-159000
20200430,709070,統新統一9C購01,,,,,,0.00,0,0,0,0,0,0,0,0,0,0,0,0,0
20200430,709071,鈊象統一9A購01,,,,,,0.00,0,0,0,0,0,0,0,0,0,0,0,0,0
20200430,709072,鈊象中信98購01,0.76,0.80,0.67,0.71,-0.10,-12.35,322000,25,233330,0,0,0,0,0,0,100000,189000,-89000,-89000
20200430,709073,大江凱基98購04,2.28,2.28,2.28,2.28,+0.30,15.15,5000,1,11400,0,0,0,0,0,0,0,5000,-5000,-5000
20200430,709074,大學光凱基9A購01,0.72,0.72,0.72,0.72,-0.08,-10.0,5000,1,3600,0,0,0,0,0,0,5000,0,5000,5000
20200430,709075,中美晶凱基98購01,1.81,1.96,1.80,1.90,+0.12,6.74,222000,25,410990,0,0,0,0,0,0,88000,144000,-56000,-56000
20200430,709076,合晶凱基98購02,1.74,1.97,1.73,1.97,+0.26,15.2,347000,39,647780,0,0,0,0,0,0,130000,317000,-187000,-187000
20200430,709077,宜鼎凱基98購02,3.59,3.76,3.56,3.73,+0.29,8.43,37000,23,136580,0,0,0,0,0,0,27000,37000,-10000,-10000
20200430,709078,昇達科凱基98購01,1.24,1.24,1.22,1.22,+0.04,3.39,101000,6,124540,0,0,0,0,0,0,101000,71000,30000,30000
20200430,709079,信昌電凱基98購03,2.50,2.70,2.50,2.60,+0.30,13.04,85000,16,216450,0,0,0,0,0,0,64000,37000,27000,27000
20200430,709080,宣德凱基98購02,1.06,1.15,1.06,1.15,-0.05,-4.17,22000,10,23800,0,0,0,0,0,0,20000,2000,18000,18000
20200430,709081,原相凱基98購03,2.28,2.28,2.28,2.28,+0.01,0.44,10000,1,22800,0,0,0,0,0,0,0,10000,-10000,-10000
20200430,709082,精測凱基98購03,,,,,,0.00,0,0,0,0,0,0,0,0,0,0,0,0,0
20200430,709083,廣明凱基98購03,,,,,,0.00,0,0,0,0,0,0,0,0,0,0,0,0,0
20200430,709084,優群凱基9A購01,,,,,,0.00,0,0,0,0,0,0,0,0,0,0,0,0,0
20200430,709085,環球晶凱基98購02,2.04,2.13,2.04,2.13,+0.42,24.56,30000,5,62450,0,0,0,0,0,0,30000,0,30000,30000
20200430,709086,環球晶凱基99購02,2.01,2.32,2.01,2.32,+0.31,15.42,139000,13,301670,0,0,0,0,0,0,30000,109000,-79000,-79000
20200430,709087,聯亞凱基98購02,1.93,1.93,1.65,1.65,+0.02,1.23,15000,7,27220,0,0,0,0,0,0,10000,5000,5000,5000
20200430,709088,鈊象凱基9A購01,,,,,,0.00,0,0,0,0,0,0,0,0,0,0,0,0,0
20200430,709089,統新元富98購01,1.08,1.08,1.04,1.04,-0.05,-4.59,70000,2,74800,0,0,0,0,0,0,70000,0,70000,70000
20200430,709090,統新元富98購02,2.30,2.36,2.04,2.04,+0.01,0.49,524000,17,1106080,0,0,0,0,0,0,440000,84000,356000,356000
20200430,709091,穩懋統一98購03,1.61,1.61,1.48,1.54,+0.29,23.2,14000,3,21100,0,0,0,0,0,0,0,14000,-14000,-14000
20200430,709092,鈊象中信99購02,1.00,1.00,1.00,1.00,-0.08,-7.41,10000,1,10000,0,0,0,0,0,0,10000,0,10000,10000
20200430,709093,VHQ元大99購01,1.19,1.19,1.18,1.19,-0.01,-0.83,61000,5,72140,0,0,0,0,0,0,34000,0,34000,34000
20200430,709094,大江元大99購01,,,,,,0.00,0,0,0,0,0,0,0,0,0,0,0,0,0
20200430,709095,六角元大99購01,0.95,1.00,0.89,1.00,+0.14,16.28,647000,28,613260,0,0,0,0,0,0,338000,309000,29000,29000
20200430,709096,同致元大99購01,0.94,0.94,0.94,0.94,-0.72,-43.37,2000,2,1880,0,0,0,0,0,0,0,0,0,0
20200430,709097,建榮元大98購01,1.26,1.26,1.12,1.16,-0.04,-3.33,133000,14,155930,0,0,0,0,0,0,20000,113000,-93000,-93000
20200430,709098,原相元大9A購01,2.08,2.08,2.08,2.08,+0.07,3.48,6000,1,12480,0,0,0,0,0,0,0,6000,-6000,-6000
20200430,709099,鈊象元大99購03,2.03,2.03,1.77,1.77,-0.12,-6.35,63000,8,124910,0,0,0,0,0,0,0,61000,-61000,-61000
20200430,709100,鈺太元大99購02,,,,,,0.00,0,0,0,0,0,0,0,0,0,0,0,0,0
20200430,709101,泰博元富98購01,,,,,,0.00,0,0,0,0,0,0,0,0,0,0,0,0,0
20200430,709102,三貝德群益98購01,1.07,1.07,1.07,1.07,+0.04,3.88,60000,3,64200,0,0,0,0,0,0,60000,0,60000,60000
20200430,709103,中美晶群益98購01,1.96,2.20,1.96,2.12,+0.14,7.07,70000,21,146580,0,0,0,0,0,0,28000,61000,-33000,-33000
20200430,709104,良維群益98購01,4.16,4.16,4.13,4.16,-0.03,-0.72,64000,5,265580,0,0,0,0,0,0,42000,22000,20000,20000
20200430,709105,宣德群益98購01,2.29,2.46,2.24,2.46,-0.04,-1.6,247000,17,573100,0,0,0,0,0,0,73000,174000,-101000,-101000
20200430,709106,統新群益98購01,4.20,4.20,4.20,4.20,-0.03,-0.71,2000,1,8400,0,0,0,0,0,0,2000,0,2000,2000
20200430,709107,晶焱群益98購02,,,,,,0.00,0,0,0,0,0,0,0,0,0,0,0,0,0
20200430,709108,金居國票99購01,1.38,1.51,1.34,1.51,+0.34,29.06,134000,10,183520,0,0,0,0,0,0,76000,58000,18000,18000
20200430,709109,統新國票98購01,6.40,6.40,5.65,5.75,-0.05,-0.86,16000,3,95200,0,0,0,0,0,0,16000,16000,0,0
20200430,709110,聯亞國票99購01,6.15,6.15,5.50,5.50,-0.15,-2.65,518000,3,2861100,0,0,0,0,0,0,19000,499000,-480000,-480000
20200430,709111,VHQ永豐98購01,1.31,1.31,1.28,1.30,0.00,0.0,230000,12,298320,0,0,0,0,0,0,230000,15000,215000,215000
20200430,709112,大宇資永豐98購01,0.34,0.36,0.34,0.36,0.00,0.0,32000,3,11280,0,0,0,0,0,0,12000,20000,-8000,-8000
20200430,709113,大學光永豐9A購01,0.82,0.82,0.79,0.79,-0.06,-7.06,401000,4,322820,0,0,0,0,0,0,201000,200000,1000,1000
20200430,709114,波若威永豐99購01,1.16,1.17,1.16,1.17,-0.03,-2.5,63000,3,73290,0,0,0,0,0,0,63000,0,63000,63000
20200430,709115,金可永豐98購01,0.21,0.34,0.21,0.31,+0.09,40.91,880000,13,214100,0,0,0,0,0,0,779000,101000,678000,678000
20200430,709116,環球晶永豐98購01,,,,,,0.00,0,0,0,0,0,0,0,0,0,0,0,0,0
20200430,709117,大江凱基98購05,1.60,1.60,1.60,1.60,+0.02,1.27,10000,1,16000,0,0,0,0,0,0,0,10000,-10000,-10000
20200430,709118,元太凱基98購01,,,,,,0.00,0,0,0,0,0,0,0,0,0,0,0,0,0
20200430,709119,台燿凱基98購02,1.73,1.74,1.65,1.74,+0.37,27.01,21000,3,35630,0,0,0,0,0,0,1000,20000,-19000,-19000
20200430,709120,同致凱基98購03,0.27,0.27,0.27,0.27,+0.02,8.0,1000,1,270,0,0,0,0,0,0,0,0,0,0
20200430,709121,合晶凱基98購03,2.12,2.39,2.12,2.38,+0.30,14.42,204000,28,463300,0,0,0,0,0,0,39000,189000,-150000,-150000
20200430,709122,宜鼎凱基98購03,,,,,,0.00,0,0,0,0,0,0,0,0,0,0,0,0,0
20200430,709123,昇達科凱基98購02,,,,,,0.00,0,0,0,0,0,0,0,0,0,0,0,0,0
20200430,709124,信昌電凱基98購04,,,,,,0.00,0,0,0,0,0,0,0,0,0,0,0,0,0
20200430,709125,原相凱基98購04,3.21,3.21,3.21,3.21,+0.03,0.94,10000,1,32100,0,0,0,0,0,0,0,10000,-10000,-10000
20200430,709126,勝麗凱基98購02,,,,,,0.00,0,0,0,0,0,0,0,0,0,0,0,0,0
20200430,709127,群聯凱基98購03,,,,,,0.00,0,0,0,0,0,0,0,0,0,0,0,0,0
20200430,709128,廣明凱基98購04,2.58,2.58,2.58,2.58,-0.16,-5.84,5000,1,12900,0,0,0,0,0,0,0,5000,-5000,-5000
20200430,709129,璟德凱基98購02,1.81,1.81,1.81,1.81,+0.20,12.42,20000,1,36200,0,0,0,0,0,0,20000,0,20000,20000
20200430,709130,優群凱基9A購02,,,,,,0.00,0,0,0,0,0,0,0,0,0,0,0,0,0
20200430,709131,穩懋凱基98購03,,,,,,0.00,0,0,0,0,0,0,0,0,0,0,0,0,0
20200430,709132,穩懋凱基98購04,2.15,2.18,2.02,2.08,+0.15,7.77,159000,20,336240,0,0,0,0,0,0,129000,30000,99000,99000
20200430,709133,頎邦凱基98購01,0.67,0.68,0.67,0.68,+0.02,3.03,8000,2,5410,0,0,0,0,0,0,8000,0,8000,8000
20200430,709134,環球晶統一98購01,,,,,,0.00,0,0,0,0,0,0,0,0,0,0,0,0,0
20200430,709135,原相凱基99購01,0.90,0.90,0.90,0.90,-0.01,-1.1,10000,1,9000,0,0,0,0,0,0,10000,0,10000,10000
20200430,709136,群聯凱基98購04,,,,,,0.00,0,0,0,0,0,0,0,0,0,0,0,0,0
20200430,709137,碩禾凱基9A購01,,,,,,0.00,0,0,0,0,0,0,0,0,0,0,0,0,0
20200430,709138,M31元大99購02,,,,,,0.00,0,0,0,0,0,0,0,0,0,0,0,0,0
20200430,709139,鈊象元大99購04,,,,,,0.00,0,0,0,0,0,0,0,0,0,0,0,0,0
20200430,709140,泰博國票99購01,8.10,8.10,7.70,7.95,-0.40,-4.79,35000,6,276450,0,0,0,0,0,0,22000,13000,9000,9000
20200430,709141,神盾國泰9A購01,1.15,1.24,1.10,1.24,+0.15,13.76,14000,3,16850,0,0,0,0,0,0,4000,10000,-6000,-6000
20200430,709142,宣德富邦9A購01,1.10,1.21,1.08,1.19,+0.15,14.42,1142000,85,1294700,0,0,0,0,0,0,202000,756000,-554000,-554000
20200430,709143,環球晶富邦9A購01,0.44,0.48,0.44,0.48,+0.10,26.32,231000,8,101880,0,0,0,0,0,0,166000,0,166000,166000
20200430,709144,信昌電亞東99購01,,,,,,0.00,0,0,0,0,0,0,0,0,0,0,0,0,0
20200430,709145,大江永豐98購01,1.78,1.78,1.63,1.63,0.00,0.0,210000,8,347920,0,0,0,0,0,0,190000,20000,170000,170000
20200430,709146,同致永豐98購01,0.26,0.26,0.26,0.26,-0.04,-13.33,40000,1,10400,0,0,0,0,0,0,40000,0,40000,40000
20200430,709147,合晶永豐98購02,,,,,,0.00,0,0,0,0,0,0,0,0,0,0,0,0,0
20200430,709148,良維永豐98購01,1.69,1.72,1.68,1.72,-0.01,-0.58,121000,6,205300,0,0,0,0,0,0,67000,54000,13000,13000
20200430,709149,東隆興永豐98購01,,,,,,0.00,0,0,0,0,0,0,0,0,0,0,0,0,0
20200430,709150,南光永豐98購01,0.36,0.36,0.35,0.35,-0.01,-2.78,155000,4,55600,0,0,0,0,0,0,20000,135000,-115000,-115000
20200430,709151,茂達永豐98購01,0.54,0.61,0.54,0.60,+0.07,13.21,125000,7,72110,0,0,0,0,0,0,122000,0,122000,122000
20200430,709152,新潤永豐98購01,,,,,,0.00,0,0,0,0,0,0,0,0,0,0,0,0,0
20200430,709153,大江兆豐98購01,1.09,1.09,0.97,0.97,0.00,0.0,40000,3,42200,0,0,0,0,0,0,10000,10000,0,0
20200430,709154,VHQ康和98購01,0.86,0.86,0.80,0.80,-0.03,-3.61,11000,2,8860,0,0,0,0,0,0,11000,0,11000,11000
20200430,709155,世界群益9A購01,0.74,0.78,0.73,0.78,+0.07,9.86,332000,10,248090,0,0,0,0,0,0,121000,211000,-90000,-90000
20200430,709156,台燿群益99購01,1.07,1.18,1.07,1.18,+0.24,25.53,581000,12,652240,0,0,0,0,0,0,580000,0,580000,580000
20200430,709157,威剛群益9A購02,,,,,,0.00,0,0,0,0,0,0,0,0,0,0,0,0,0
20200430,709158,廣明群益98購02,2.14,2.14,1.91,1.93,-0.23,-10.65,686000,22,1428370,0,0,0,0,0,0,583000,103000,480000,480000
20200430,709159,優群群益99購02,,,,,,0.00,0,0,0,0,0,0,0,0,0,0,0,0,0
20200430,709160,大江元富98購01,,,,,,0.00,0,0,0,0,0,0,0,0,0,0,0,0,0
20200430,709161,元太台新98購01,0.43,0.43,0.43,0.43,-0.86,-66.67,10000,1,4300,0,0,0,0,0,0,0,10000,-10000,-10000
20200430,709162,鈊象台新98購02,,,,,,0.00,0,0,0,0,0,0,0,0,0,0,0,0,0
20200430,709163,宇峻元大99購01,,,,,,0.00,0,0,0,0,0,0,0,0,0,0,0,0,0
20200430,709164,金居元大99購02,,,,,,0.00,0,0,0,0,0,0,0,0,0,0,0,0,0
20200430,709165,新鉅科元大98購01,0.73,0.74,0.68,0.68,0.00,0.0,158000,13,111850,0,0,0,0,0,0,150000,0,150000,150000
20200430,709166,上詮永豐98購01,0.54,0.54,0.50,0.50,-0.04,-7.41,182000,12,95520,0,0,0,0,0,0,52000,120000,-68000,-68000
20200430,709167,光頡永豐98購01,,,,,,0.00,0,0,0,0,0,0,0,0,0,0,0,0,0
20200430,709168,波若威永豐98購02,,,,,,0.00,0,0,0,0,0,0,0,0,0,0,0,0,0
20200430,709169,建榮永豐99購02,,,,,,0.00,0,0,0,0,0,0,0,0,0,0,0,0,0
20200430,709170,健信永豐98購01,,,,,,0.00,0,0,0,0,0,0,0,0,0,0,0,0,0
20200430,709171,璟德永豐98購01,1.31,1.44,1.31,1.39,+0.03,2.21,297000,12,404320,0,0,0,0,0,0,171000,126000,45000,45000
20200430,709172,統新國泰99購01,,,,,,0.00,0,0,0,0,0,0,0,0,0,0,0,0,0
20200430,709173,環球晶統一99購02,1.12,1.19,1.12,1.19,+0.04,3.48,45000,3,50610,0,0,0,0,0,0,42000,3000,39000,39000
20200430,709174,太醫中信99購01,0.88,0.88,0.81,0.82,-0.05,-5.75,161000,12,136940,0,0,0,0,0,0,111000,50000,61000,61000
20200430,709175,環球晶中信98購01,0.14,0.17,0.14,0.17,+0.04,30.77,57000,5,8900,0,0,0,0,0,0,37000,20000,17000,17000
20200430,709176,大江凱基98購06,,,,,,0.00,0,0,0,0,0,0,0,0,0,0,0,0,0
20200430,709177,宣德凱基98購03,,,,,,0.00,0,0,0,0,0,0,0,0,0,0,0,0,0
20200430,709178,精測凱基98購04,,,,,,0.00,0,0,0,0,0,0,0,0,0,0,0,0,0
20200430,709179,雙鴻兆豐99購01,0.75,0.80,0.75,0.76,+0.01,1.33,128000,9,96850,0,0,0,0,0,0,100000,23000,77000,77000
20200430,709180,統新康和98購02,,,,,,0.00,0,0,0,0,0,0,0,0,0,0,0,0,0
20200430,709181,太景*群益99購01,,,,,,0.00,0,0,0,0,0,0,0,0,0,0,0,0,0
20200430,709182,大江富邦9A購01,2.04,2.05,1.99,1.99,+0.09,4.74,78000,5,157240,0,0,0,0,0,0,52000,73000,-21000,-21000
20200430,709183,原相麥證99購01,0.76,0.76,0.74,0.75,+0.02,2.74,86000,6,64310,61000,25000,36000,0,0,0,61000,25000,36000,36000
20200430,709184,順達麥證98購01,1.92,1.93,1.87,1.87,-0.10,-5.08,84000,4,158600,84000,0,84000,0,0,0,84000,0,84000,84000
20200430,709185,璟德麥證98購01,1.02,1.13,1.02,1.13,+0.01,0.89,14000,4,14410,13000,1000,12000,0,0,0,13000,1000,12000,12000
20200430,709186,鈊象台新98購03,,,,,,0.00,0,0,0,0,0,0,0,0,0,0,0,0,0
20200430,709187,大中元富98購01,0.72,0.72,0.67,0.67,0.00,0.0,71000,3,50870,0,0,0,0,0,0,71000,0,71000,71000
20200430,709188,太景*元富98購01,0.30,0.30,0.30,0.30,+0.08,36.36,10000,1,3000,0,0,0,0,0,0,0,10000,-10000,-10000
20200430,709189,台半元富98購01,,,,,,0.00,0,0,0,0,0,0,0,0,0,0,0,0,0
20200430,709190,由田元富98購01,1.79,1.79,1.73,1.78,+0.01,0.56,93000,10,164290,0,0,0,0,0,0,10000,83000,-73000,-73000
20200430,709191,杰力元富98購01,2.17,2.17,2.13,2.13,-0.01,-0.47,51000,7,109590,0,0,0,0,0,0,45000,6000,39000,39000
20200430,709192,金居元富99購01,,,,,,0.00,0,0,0,0,0,0,0,0,0,0,0,0,0
20200430,709193,美琪瑪元富98購01,,,,,,0.00,0,0,0,0,0,0,0,0,0,0,0,0,0
20200430,709194,統新元富98購03,3.77,3.83,3.48,3.48,-0.15,-4.13,70000,10,262580,0,0,0,0,0,0,45000,25000,20000,20000
20200430,709195,碩禾元富9B購01,0.30,0.30,0.30,0.30,+0.01,3.45,2000,1,600,0,0,0,0,0,0,0,0,0,0
20200430,709196,群聯中信99購01,0.14,0.19,0.14,0.14,+0.02,16.67,390000,4,55100,0,0,0,0,0,0,360000,20000,340000,340000
20200430,709197,大學光統一99購01,0.66,0.66,0.64,0.64,-0.07,-9.86,6000,2,3860,0,0,0,0,0,0,6000,0,6000,6000
20200430,709198,原相統一99購01,,,,,,0.00,0,0,0,0,0,0,0,0,0,0,0,0,0
20200430,709199,M31凱基98購02,,,,,,0.00,0,0,0,0,0,0,0,0,0,0,0,0,0
20200430,709200,中美晶凱基98購02,0.85,0.85,0.82,0.83,+0.07,9.21,71000,9,59690,0,0,0,0,0,0,4000,71000,-67000,-67000
20200430,709201,建榮凱基9A購01,0.59,0.59,0.59,0.59,+0.12,25.53,30000,3,17700,0,0,0,0,0,0,0,30000,-30000,-30000
20200430,709202,神盾凱基99購01,,,,,,0.00,0,0,0,0,0,0,0,0,0,0,0,0,0
20200430,709203,金可兆豐99購01,0.38,0.56,0.38,0.51,+0.12,30.77,219000,19,107380,0,0,0,0,0,0,104000,115000,-11000,-11000
20200430,709204,宣德兆豐98購02,0.57,0.62,0.57,0.62,-0.01,-1.59,38000,10,22530,0,0,0,0,0,0,18000,20000,-2000,-2000
20200430,709205,環球晶兆豐98購02,,,,,,0.00,0,0,0,0,0,0,0,0,0,0,0,0,0
20200430,709206,合晶群益98購01,2.20,2.20,2.20,2.20,+0.37,20.22,5000,1,11000,0,0,0,0,0,0,5000,0,5000,5000
20200430,709207,原相群益9B購01,,,,,,0.00,0,0,0,0,0,0,0,0,0,0,0,0,0
20200430,709208,統新群益98購02,1.85,1.85,1.75,1.75,+0.03,1.74,142000,6,254250,0,0,0,0,0,0,100000,42000,58000,58000
20200430,709209,廣明群益98購03,1.24,1.26,1.11,1.12,-0.12,-9.68,321000,21,391530,0,0,0,0,0,0,279000,40000,239000,239000
20200430,709210,緯軟群益99購01,0.71,0.79,0.70,0.70,+0.10,16.67,420000,13,316200,0,0,0,0,0,0,140000,280000,-140000,-140000
20200430,709211,鈺太群益98購01,2.18,2.23,2.12,2.16,-0.05,-2.26,333000,20,727690,0,0,0,0,0,0,332000,89000,243000,243000
20200430,709212,建榮國票99購02,,,,,,0.00,0,0,0,0,0,0,0,0,0,0,0,0,0
20200430,709213,雍智國票99購02,1.36,1.46,1.36,1.46,+0.10,7.35,79000,4,110150,0,0,0,0,0,0,0,79000,-79000,-79000
20200430,709214,中美晶元大99購02,1.39,1.48,1.37,1.45,+0.11,8.21,246000,31,349330,0,0,0,0,0,0,110000,146000,-36000,-36000
20200430,709215,金居元大9A購01,5.30,5.40,5.05,5.35,+0.91,20.5,157000,23,820900,0,0,0,0,0,0,122000,35000,87000,87000
20200430,709216,威剛元大99購02,0.80,0.80,0.77,0.77,+0.02,2.67,275000,4,214000,0,0,0,0,0,0,0,275000,-275000,-275000
20200430,709217,宣德元大99購01,,,,,,0.00,0,0,0,0,0,0,0,0,0,0,0,0,0
20200430,709218,群聯元大98購04,,,,,,0.00,0,0,0,0,0,0,0,0,0,0,0,0,0
20200430,709219,碩禾元大99購02,1.00,1.00,0.98,0.98,-0.04,-3.92,100000,2,98200,0,0,0,0,0,0,100000,0,100000,100000
20200430,709220,網家元大99購01,1.48,1.55,1.41,1.52,+0.04,2.7,72000,11,106980,0,0,0,0,0,0,57000,2000,55000,55000
20200430,709221,環球晶元大98購04,1.15,1.33,1.14,1.32,+0.21,18.92,82000,6,99400,0,0,0,0,0,0,37000,45000,-8000,-8000
20200430,709222,環球晶元大99購01,1.02,1.02,1.02,1.02,+0.16,18.6,10000,1,10200,0,0,0,0,0,0,10000,0,10000,10000
20200430,709223,雙鴻元大99購05,0.90,0.90,0.90,0.90,+0.02,2.27,30000,1,27000,0,0,0,0,0,0,30000,0,30000,30000
20200430,709224,穩懋元大98購02,2.70,2.70,2.56,2.56,+0.24,10.34,62000,18,163020,0,0,0,0,0,0,43000,34000,9000,9000
20200430,709225,穩懋元大99購01,,,,,,0.00,0,0,0,0,0,0,0,0,0,0,0,0,0
20200430,709226,泰博國泰99購01,,,,,,0.00,0,0,0,0,0,0,0,0,0,0,0,0,0
20200430,709227,大江富邦9A購02,,,,,,0.00,0,0,0,0,0,0,0,0,0,0,0,0,0
20200430,709228,中美晶富邦9A購01,,,,,,0.00,0,0,0,0,0,0,0,0,0,0,0,0,0
20200430,709229,精測富邦99購01,0.06,0.10,0.06,0.10,0.00,0.0,410000,8,25160,0,0,0,0,0,0,381000,0,381000,381000
20200430,709230,環球晶富邦9B購01,0.23,0.28,0.23,0.28,+0.06,27.27,248000,4,57410,0,0,0,0,0,0,101000,0,101000,101000
20200430,709231,威剛麥證98購01,,,,,,0.00,0,0,0,0,0,0,0,0,0,0,0,0,0
20200430,709232,群聯麥證98購01,1.10,1.15,1.10,1.15,+0.13,12.75,2000,2,2250,0,2000,-2000,0,0,0,1000,2000,-1000,-1000
20200430,709233,聯亞麥證98購01,2.54,2.54,2.45,2.45,+0.05,2.08,48000,4,119600,48000,0,48000,0,0,0,48000,0,48000,48000
20200430,709234,力旺元富98購01,0.75,0.90,0.75,0.88,+0.22,33.33,535000,29,437100,0,0,0,0,0,0,138000,435000,-297000,-297000
20200430,709235,大江元富98購02,4.18,4.18,3.85,3.88,+0.09,2.37,32000,4,127400,0,0,0,0,0,0,12000,20000,-8000,-8000
20200430,709236,原相元富98購01,3.24,3.24,3.18,3.21,+0.01,0.31,22000,3,70860,0,0,0,0,0,0,22000,0,22000,22000
20200430,709237,新鉅科元富98購01,,,,,,0.00,0,0,0,0,0,0,0,0,0,0,0,0,0
20200430,709238,聚積元富98購01,1.21,1.21,1.21,1.21,+0.03,2.54,5000,1,6050,0,0,0,0,0,0,5000,0,5000,5000
20200430,709239,環球晶第一01購01,0.50,0.58,0.50,0.58,+0.15,34.88,64000,6,35230,0,0,0,0,0,0,0,14000,-14000,-14000
20200430,709240,M31永豐98購01,1.02,1.05,1.02,1.05,+0.07,7.14,52000,4,54450,0,0,0,0,0,0,5000,47000,-42000,-42000
20200430,709241,凡甲永豐98購01,3.37,3.37,3.26,3.27,-0.20,-5.76,15000,3,49940,0,0,0,0,0,0,15000,5000,10000,10000
20200430,709242,大中永豐98購01,0.82,0.82,0.81,0.81,-0.01,-1.22,99000,6,80450,0,0,0,0,0,0,99000,0,99000,99000
20200430,709243,迅得永豐98購01,,,,,,0.00,0,0,0,0,0,0,0,0,0,0,0,0,0
20200430,709244,杰力永豐98購01,0.76,0.77,0.76,0.77,-0.02,-2.53,141000,7,108020,0,0,0,0,0,0,131000,0,131000,131000
20200430,709245,統新永豐98購02,0.71,0.74,0.60,0.62,+0.02,3.33,390000,27,256320,0,0,0,0,0,0,35000,355000,-320000,-320000
20200430,709246,晶焱永豐98購01,1.31,1.33,1.29,1.33,+0.07,5.56,42000,4,54920,0,0,0,0,0,0,18000,24000,-6000,-6000
20200430,709247,網龍永豐98購01,,,,,,0.00,0,0,0,0,0,0,0,0,0,0,0,0,0
20200430,709248,優群永豐98購01,,,,,,0.00,0,0,0,0,0,0,0,0,0,0,0,0,0
20200430,709249,原相台新9A購01,,,,,,0.00,0,0,0,0,0,0,0,0,0,0,0,0,0
20200430,709250,聯亞台新9A購01,,,,,,0.00,0,0,0,0,0,0,0,0,0,0,0,0,0
20200430,709251,前鼎統一99購01,,,,,,0.00,0,0,0,0,0,0,0,0,0,0,0,0,0
20200430,709252,聯亞中信98購01,1.05,1.10,0.90,0.90,-0.16,-15.09,644000,32,670000,0,0,0,0,0,0,365000,179000,186000,186000
20200430,709253,晶焱凱基98購03,2.02,2.07,2.02,2.07,+0.12,6.15,103000,5,208860,0,0,0,0,0,0,35000,68000,-33000,-33000
20200430,709254,群聯凱基99購01,,,,,,0.00,0,0,0,0,0,0,0,0,0,0,0,0,0
20200430,709255,神盾台新98購02,0.72,0.73,0.19,0.19,-0.47,-71.21,70000,7,44900,0,0,0,0,0,0,30000,40000,-10000,-10000
20200430,709256,精測台新99購02,,,,,,0.00,0,0,0,0,0,0,0,0,0,0,0,0,0
20200430,709257,VHQ元富98購01,0.76,0.77,0.74,0.75,-0.02,-2.6,908000,47,682530,0,0,0,0,0,0,816000,92000,724000,724000
20200430,709258,前鼎元富98購01,1.30,1.30,1.19,1.24,+0.04,3.33,270000,10,340640,0,0,0,0,0,0,212000,58000,154000,154000
20200430,709259,精測元富98購02,,,,,,0.00,0,0,0,0,0,0,0,0,0,0,0,0,0
20200430,709260,中美晶國票98購01,,,,,,0.00,0,0,0,0,0,0,0,0,0,0,0,0,0
20200430,709261,保瑞國票98購01,1.46,1.52,1.45,1.45,0.00,0.0,105000,5,154120,0,0,0,0,0,0,38000,67000,-29000,-29000
20200430,709262,前鼎國票99購01,2.68,2.68,2.59,2.59,+0.10,4.02,23000,3,61280,0,0,0,0,0,0,23000,0,23000,23000
20200430,709263,原相國票99購01,1.86,1.86,1.86,1.86,+0.01,0.54,2000,1,3720,0,0,0,0,0,0,0,2000,-2000,-2000
20200430,709264,泰博國票99購02,,,,,,0.00,0,0,0,0,0,0,0,0,0,0,0,0,0
20200430,709265,統新國票99購01,1.30,1.32,1.15,1.16,-0.02,-1.69,511000,22,612830,0,0,0,0,0,0,46000,465000,-419000,-419000
20200430,709266,六角兆豐98購01,0.55,0.59,0.52,0.59,+0.08,15.69,552000,29,310730,0,0,0,0,0,0,248000,304000,-56000,-56000
20200430,709267,宇峻群益9A購01,,,,,,0.00,0,0,0,0,0,0,0,0,0,0,0,0,0
20200430,709268,博智群益98購01,,,,,,0.00,0,0,0,0,0,0,0,0,0,0,0,0,0
20200430,709269,網龍群益98購03,1.88,1.90,1.88,1.89,-0.09,-4.55,32000,4,60350,0,0,0,0,0,0,29000,3000,26000,26000
20200430,709270,太景*國泰9A購01,0.35,0.35,0.35,0.35,+0.14,66.67,11000,2,3850,0,0,0,0,0,0,0,10000,-10000,-10000
20200430,709271,前鼎國泰99購01,,,,,,0.00,0,0,0,0,0,0,0,0,0,0,0,0,0
20200430,709272,新鉅科國泰99購01,,,,,,0.00,0,0,0,0,0,0,0,0,0,0,0,0,0
20200430,709273,環宇富邦9A購01,0.44,0.45,0.44,0.45,+0.01,2.27,70000,8,31350,0,0,0,0,0,0,0,70000,-70000,-70000
20200430,709274,大江元大98購02,,,,,,0.00,0,0,0,0,0,0,0,0,0,0,0,0,0
20200430,709275,前鼎元大99購01,1.16,1.16,1.13,1.14,-0.10,-8.06,100000,11,115000,0,0,0,0,0,0,100000,0,100000,100000
20200430,709276,威剛元大9A購01,,,,,,0.00,0,0,0,0,0,0,0,0,0,0,0,0,0
20200430,709277,神盾元大9A購01,0.86,0.86,0.78,0.82,+0.03,3.8,341000,11,274460,0,0,0,0,0,0,331000,160000,171000,171000
20200430,709278,群聯元大99購02,,,,,,0.00,0,0,0,0,0,0,0,0,0,0,0,0,0
20200430,709279,緯軟元大98購02,0.79,0.79,0.72,0.72,+0.12,20.0,32000,3,24230,0,0,0,0,0,0,32000,0,32000,32000
20200430,709280,璟德元大98購01,2.85,3.00,2.75,2.89,+0.09,3.21,237000,21,681430,0,0,0,0,0,0,154000,145000,9000,9000
20200430,709281,中美晶日盛9A購01,,,,,,0.00,0,0,0,0,0,0,0,0,0,0,0,0,0
20200430,709282,伍豐永豐98購01,,,,,,0.00,0,0,0,0,0,0,0,0,0,0,0,0,0
20200430,709283,兆利永豐98購01,0.59,0.59,0.56,0.59,+0.04,7.27,124000,6,72590,0,0,0,0,0,0,39000,85000,-46000,-46000
20200430,709284,宜鼎永豐98購01,0.82,0.83,0.82,0.83,+0.07,9.21,20000,2,16430,0,0,0,0,0,0,20000,0,20000,20000
20200430,709285,前鼎永豐98購01,,,,,,0.00,0,0,0,0,0,0,0,0,0,0,0,0,0
20200430,709286,建榮永豐9A購01,,,,,,0.00,0,0,0,0,0,0,0,0,0,0,0,0,0
20200430,709287,新鉅科永豐98購01,,,,,,0.00,0,0,0,0,0,0,0,0,0,0,0,0,0
20200430,709288,聯亞永豐98購01,1.49,1.49,1.36,1.36,-0.06,-4.23,84000,10,119870,0,0,0,0,0,0,64000,20000,44000,44000
20200430,709289,雙鴻永豐99購01,1.13,1.13,1.08,1.08,+0.03,2.86,390000,22,430820,0,0,0,0,0,0,140000,278000,-138000,-138000
20200430,709290,金居凱基98購02,1.92,2.25,1.92,2.25,+0.75,50.0,15000,2,32100,0,0,0,0,0,0,5000,10000,-5000,-5000
20200430,709291,威剛凱基9A購01,0.23,0.23,0.23,0.23,-0.05,-17.86,1000,1,230,0,0,0,0,0,0,0,0,0,0
20200430,709292,環球晶凱基98購04,1.36,1.45,1.36,1.45,+0.27,22.88,101000,7,140460,0,0,0,0,0,0,0,101000,-101000,-101000
20200430,709293,環球晶康和98購01,0.74,0.81,0.74,0.81,+0.02,2.53,17000,7,13230,0,0,0,0,0,0,17000,17000,0,0
20200430,709294,大江群益98購01,3.57,3.57,3.27,3.30,+0.02,0.61,143000,8,480030,0,90000,-90000,0,0,0,143000,6000,137000,47000
20200430,709295,宇峻群益9A購02,,,,,,0.00,0,0,0,0,0,0,0,0,0,0,0,0,0
20200430,709296,神盾群益9A購02,1.19,1.19,1.19,1.19,+0.07,6.25,10000,1,11900,0,0,0,0,0,0,10000,0,10000,10000
20200430,709297,宣德國票99購01,1.46,1.59,1.42,1.59,-0.03,-1.85,457000,23,689610,0,0,0,0,0,0,119000,338000,-219000,-219000
20200430,709298,群聯國票99購01,,,,,,0.00,0,0,0,0,0,0,0,0,0,0,0,0,0
20200430,709299,VHQ國泰99購01,1.11,1.11,1.07,1.09,+0.01,0.93,828000,30,900020,0,0,0,0,0,0,828000,0,828000,828000
20200430,709300,宣德國泰9A購01,0.83,0.86,0.82,0.86,+0.04,4.88,528000,20,438960,0,0,0,0,0,0,528000,0,528000,528000
20200430,709301,大宇資永豐98購02,,,,,,0.00,0,0,0,0,0,0,0,0,0,0,0,0,0
20200430,709302,六角永豐98購01,1.06,1.11,1.04,1.11,+0.12,12.12,932000,19,984400,0,0,0,0,0,0,643000,289000,354000,354000
20200430,709303,亞泰永豐98購01,1.18,1.21,1.17,1.17,0.00,0.0,151000,3,179540,0,0,0,0,0,0,83000,68000,15000,15000
20200430,709304,信昌電永豐98購01,1.57,1.76,1.55,1.66,+0.22,15.28,95000,14,154000,0,0,0,0,0,0,22000,79000,-57000,-57000
20200430,709305,宣德永豐98購01,1.29,1.39,1.27,1.39,-0.03,-2.11,54000,12,70280,0,0,0,0,0,0,33000,21000,12000,12000
20200430,709306,原相永豐98購02,,,,,,0.00,0,0,0,0,0,0,0,0,0,0,0,0,0
20200430,709307,神盾永豐99購01,0.71,0.71,0.65,0.65,0.00,0.0,25000,3,16850,0,0,0,0,0,0,22000,3000,19000,19000
20200430,709308,雙美永豐99購01,1.01,1.02,0.99,1.00,+0.04,4.17,250000,6,252000,0,0,0,0,0,0,130000,120000,10000,10000
20200430,709309,譜瑞永豐98購01,0.86,0.86,0.86,0.86,+0.02,2.38,33000,1,28380,0,0,0,0,0,0,0,33000,-33000,-33000
20200430,709310,合晶元富98購01,1.71,1.90,1.71,1.90,+0.29,18.01,91000,12,162420,0,0,0,0,0,0,0,91000,-91000,-91000
20200430,709311,前鼎元富98購02,1.44,1.44,1.35,1.36,-0.03,-2.16,385000,23,535340,0,0,0,0,0,0,272000,113000,159000,159000
20200430,709312,大學光元大99購01,,,,,,0.00,0,0,0,0,0,0,0,0,0,0,0,0,0
20200430,709313,保瑞元大98購01,,,,,,0.00,0,0,0,0,0,0,0,0,0,0,0,0,0
20200430,709314,前鼎元大99購02,1.09,1.09,1.05,1.05,-0.02,-1.87,271000,17,288450,0,0,0,0,0,0,118000,153000,-35000,-35000
20200430,709315,胡連元大98購01,0.40,0.40,0.38,0.38,+0.01,2.7,413000,8,157480,0,0,0,0,0,0,411000,2000,409000,409000
20200430,709316,神盾元大9A購02,1.02,1.04,0.96,0.99,+0.02,2.06,273000,21,270070,0,0,0,0,0,0,170000,102000,68000,68000
20200430,709317,群聯元大98購05,0.42,0.42,0.42,0.42,+0.15,55.56,1000,1,420,0,0,0,0,0,0,0,1000,-1000,-1000
20200430,709318,環球晶元大98購09,1.22,1.22,1.22,1.22,+0.01,0.83,40000,1,48800,0,0,0,0,0,0,40000,0,40000,40000
20200430,709319,環球晶元大98購10,1.59,1.67,1.57,1.67,+0.25,17.61,98000,6,157230,0,0,0,0,0,0,3000,95000,-92000,-92000
20200430,709320,雙鴻元大9A購01,1.07,1.07,1.07,1.07,+0.05,4.9,10000,1,10700,0,0,0,0,0,0,10000,0,10000,10000
20200430,709321,譜瑞元大98購03,,,,,,0.00,0,0,0,0,0,0,0,0,0,0,0,0,0
20200430,709322,六角台新98購01,0.70,0.80,0.64,0.70,+0.06,9.38,795000,45,549230,0,0,0,0,0,0,752000,43000,709000,709000
20200430,709323,群聯麥證98購02,1.20,1.20,1.20,1.20,+0.16,15.38,50000,1,60000,50000,0,50000,0,0,0,50000,0,50000,50000
20200430,709324,同致元富98購01,0.27,0.30,0.27,0.30,+0.03,11.11,15000,2,4200,0,0,0,0,0,0,0,0,0,0
20200430,709325,神盾元富99購01,0.53,0.56,0.52,0.56,+0.01,1.82,59000,4,31320,0,0,0,0,0,0,59000,0,59000,59000
20200430,709326,群聯元富98購01,,,,,,0.00,0,0,0,0,0,0,0,0,0,0,0,0,0
20200430,709327,碩禾元富9B購02,,,,,,0.00,0,0,0,0,0,0,0,0,0,0,0,0,0
20200430,709328,三貝德凱基98購01,,,,,,0.00,0,0,0,0,0,0,0,0,0,0,0,0,0
20200430,709329,大江凱基98購07,2.14,2.14,2.14,2.14,-0.06,-2.73,40000,1,85600,0,0,0,0,0,0,40000,0,40000,40000
20200430,709330,威剛凱基9A購02,,,,,,0.00,0,0,0,0,0,0,0,0,0,0,0,0,0
20200430,709331,雍智凱基99購01,,,,,,0.00,0,0,0,0,0,0,0,0,0,0,0,0,0
20200430,709332,環球晶凱基98購05,3.05,3.43,3.05,3.38,+0.30,9.74,47000,4,147550,0,0,0,0,0,0,36000,12000,24000,24000
20200430,709333,聯亞凱基99購03,,,,,,0.00,0,0,0,0,0,0,0,0,0,0,0,0,0
20200430,709334,穩懋凱基98購06,1.98,1.98,1.98,1.98,+0.27,15.79,4000,1,7920,0,0,0,0,0,0,4000,0,4000,4000
20200430,709335,泰博永豐98購01,,,,,,0.00,0,0,0,0,0,0,0,0,0,0,0,0,0
20200430,709336,博智永豐98購01,1.68,1.79,1.68,1.71,+0.04,2.4,217000,8,374220,0,0,0,0,0,0,141000,79000,62000,62000
20200430,709337,緯軟永豐98購01,0.58,0.69,0.58,0.63,+0.11,21.15,207000,10,134100,0,0,0,0,0,0,0,207000,-207000,-207000
20200430,709338,環宇永豐98購02,,,,,,0.00,0,0,0,0,0,0,0,0,0,0,0,0,0
20200430,709339,VHQ統一99購01,0.71,0.71,0.69,0.69,+0.01,1.47,125000,7,87730,0,0,0,0,0,0,118000,7000,111000,111000
20200430,709340,大學光統一9A購01,0.97,0.97,0.89,0.89,-0.05,-5.32,15000,6,13910,0,0,0,0,0,0,0,15000,-15000,-15000
20200430,709341,廣明統一99購01,2.00,2.00,1.90,1.90,-0.32,-14.41,273000,5,523070,0,0,0,0,0,0,273000,0,273000,273000
20200430,709342,穩懋統一98購04,,,,,,0.00,0,0,0,0,0,0,0,0,0,0,0,0,0
20200430,709343,凡甲元大98購03,,,,,,0.00,0,0,0,0,0,0,0,0,0,0,0,0,0
20200430,709344,中美晶元大98購03,1.12,1.12,1.09,1.09,+0.08,7.92,17000,9,18940,0,0,0,0,0,0,9000,17000,-8000,-8000
20200430,709345,宇峻元大99購02,,,,,,0.00,0,0,0,0,0,0,0,0,0,0,0,0,0
20200430,709346,博智元大98購01,5.95,6.15,5.95,6.15,+0.35,6.03,7000,2,42050,0,0,0,0,0,0,7000,7000,0,0
20200430,709347,群聯元大98購06,,,,,,0.00,0,0,0,0,0,0,0,0,0,0,0,0,0
20200430,709348,網家元大98購01,2.12,2.25,2.05,2.12,+0.08,3.92,613000,47,1304280,20000,0,20000,0,0,0,201000,481000,-280000,-260000
20200430,709349,廣明元大98購01,1.84,1.86,1.71,1.72,-0.15,-8.02,150000,8,261370,0,0,0,0,0,0,80000,70000,10000,10000
20200430,709350,中美晶兆豐99購01,0.87,0.93,0.87,0.93,+0.08,9.41,358000,8,325130,0,0,0,0,0,0,54000,304000,-250000,-250000
20200430,709351,泰博兆豐98購01,3.01,3.01,3.01,3.01,+0.17,5.99,1000,1,3010,0,0,0,0,0,0,0,0,0,0
20200430,709352,精華兆豐99購01,0.55,0.66,0.55,0.66,+0.19,40.43,71000,9,42550,0,0,0,0,0,0,39000,20000,19000,19000
20200430,709353,頎邦兆豐98購01,0.45,0.48,0.45,0.48,+0.04,9.09,60000,2,28500,0,0,0,0,0,0,60000,0,60000,60000
20200430,709354,M31群益9A購01,1.00,1.06,1.00,1.06,+0.07,7.07,470000,21,491250,0,0,0,0,0,0,50000,470000,-420000,-420000
20200430,709355,中美晶群益98購02,,,,,,0.00,0,0,0,0,0,0,0,0,0,0,0,0,0
20200430,709356,宜鼎群益98購02,4.88,5.20,4.83,5.20,+0.56,12.07,203000,50,1015270,0,0,0,0,0,0,131000,100000,31000,31000
20200430,709357,原相群益98購03,0.57,0.57,0.57,0.57,-0.04,-6.56,206000,2,117420,0,0,0,0,0,0,206000,0,206000,206000
20200430,709358,譜瑞群益98購01,,,,,,0.00,0,0,0,0,0,0,0,0,0,0,0,0,0
20200430,709359,璟德國泰99購01,1.07,1.07,1.07,1.07,-0.04,-3.6,50000,1,53500,0,0,0,0,0,0,50000,0,50000,50000
20200430,709360,神盾富邦9A購01,,,,,,0.00,0,0,0,0,0,0,0,0,0,0,0,0,0
20200430,709361,群聯凱基98購05,3.40,3.40,3.34,3.39,+0.35,11.51,48000,20,161770,0,0,0,0,0,0,28000,38000,-10000,-10000
20200430,709362,網家凱基99購01,,,,,,0.00,0,0,0,0,0,0,0,0,0,0,0,0,0
20200430,709363,晟德凱基98購01,,,,,,0.00,0,0,0,0,0,0,0,0,0,0,0,0,0
20200430,709364,神盾統一98購02,,,,,,0.00,0,0,0,0,0,0,0,0,0,0,0,0,0
20200430,709365,VHQ元大99購02,1.18,1.19,1.16,1.16,-0.02,-1.69,250000,15,294360,0,0,0,0,0,0,250000,0,250000,250000
20200430,709366,中美晶元大98購04,1.14,1.14,1.11,1.11,+0.09,8.82,17000,9,19280,0,0,0,0,0,0,9000,17000,-8000,-8000
20200430,709367,兆利元大99購01,0.84,0.86,0.84,0.85,+0.07,8.97,100000,5,85000,0,0,0,0,0,0,100000,0,100000,100000
20200430,709368,原相元大9A購02,1.90,1.90,1.90,1.90,-0.10,-5.0,2000,1,3800,0,0,0,0,0,0,0,2000,-2000,-2000
20200430,709369,群聯元大98購07,,,,,,0.00,0,0,0,0,0,0,0,0,0,0,0,0,0
20200430,709370,碩禾元大99購03,,,,,,0.00,0,0,0,0,0,0,0,0,0,0,0,0,0
20200430,709371,廣明元大98購02,1.72,1.75,1.63,1.63,-0.27,-14.21,36000,6,61800,0,0,0,0,0,0,31000,5000,26000,26000
20200430,709372,神盾第一9C購01,0.93,0.93,0.88,0.90,0.00,0.0,1158000,15,1035910,0,0,0,0,0,0,160000,998000,-838000,-838000
20200430,709373,三貝德永豐99購01,0.24,0.24,0.24,0.24,+0.01,4.35,1000,1,240,0,0,0,0,0,0,0,1000,-1000,-1000
20200430,709374,大田永豐98購01,0.81,0.89,0.81,0.89,+0.07,8.54,90000,3,76540,0,0,0,0,0,0,50000,40000,10000,10000
20200430,709375,大江永豐98購03,2.18,2.18,2.18,2.18,+0.01,0.46,17000,1,37060,0,0,0,0,0,0,17000,0,17000,17000
20200430,709376,旺矽永豐98購01,0.43,0.50,0.43,0.50,+0.08,19.05,110000,5,48000,0,0,0,0,0,0,10000,100000,-90000,-90000
20200430,709377,勝麗永豐98購01,,,,,,0.00,0,0,0,0,0,0,0,0,0,0,0,0,0
20200430,709378,宜鼎兆豐99購01,1.06,1.14,1.06,1.14,+0.12,11.76,1017000,59,1128090,0,0,0,0,0,0,632000,405000,227000,227000
20200430,709379,神盾兆豐99購01,1.10,1.10,0.93,0.98,+0.02,2.08,528000,31,506970,0,0,0,0,0,0,489000,37000,452000,452000
20200430,709380,穩懋兆豐99購01,0.42,0.43,0.41,0.41,+0.03,7.89,19000,4,7920,0,0,0,0,0,0,8000,18000,-10000,-10000
20200430,709381,網家康和98購01,0.82,0.82,0.82,0.82,-0.04,-4.65,200000,1,164000,0,0,0,0,0,0,200000,0,200000,200000
20200430,709382,大學光群益99購01,1.85,1.85,1.85,1.85,-0.12,-6.09,1000,1,1850,1000,0,1000,0,0,0,0,1000,-1000,0
20200430,709383,六角群益98購03,1.89,2.05,1.82,2.05,+0.33,19.19,619000,20,1173440,0,0,0,0,0,0,270000,349000,-79000,-79000
20200430,709384,迅得群益9A購01,0.67,0.69,0.67,0.68,+0.01,1.49,354000,6,239520,0,0,0,0,0,0,145000,209000,-64000,-64000
20200430,709385,環宇群益99購01,0.43,0.43,0.42,0.42,-0.04,-8.7,20000,2,8500,0,0,0,0,0,0,20000,0,20000,20000
20200430,709386,鈺太群益98購02,0.61,0.61,0.61,0.61,+0.09,17.31,1000,1,610,0,0,0,0,0,0,1000,0,1000,1000
20200430,709387,大學光統一99購02,,,,,,0.00,0,0,0,0,0,0,0,0,0,0,0,0,0
20200430,709388,穩懋統一98購05,0.73,0.73,0.71,0.71,+0.06,9.23,126000,2,91460,0,0,0,0,0,0,126000,0,126000,126000
20200430,709389,原相中信9A購01,1.20,1.20,1.19,1.20,-0.02,-1.64,257000,5,307900,0,0,0,0,0,0,257000,0,257000,257000
20200430,709390,大學光凱基98購01,,,,,,0.00,0,0,0,0,0,0,0,0,0,0,0,0,0
20200430,709391,六角凱基98購01,1.20,1.27,1.16,1.27,+0.34,36.56,80000,8,96500,0,0,0,0,0,0,50000,30000,20000,20000
20200430,709392,穩懋凱基98購07,1.19,1.20,1.17,1.18,+0.12,11.32,142000,10,167460,0,0,0,0,0,0,142000,0,142000,142000
20200430,709393,宜鼎元富98購01,0.81,0.85,0.80,0.84,+0.09,12.0,389000,35,320110,0,0,0,0,0,0,229000,259000,-30000,-30000
20200430,709394,群聯元富98購02,,,,,,0.00,0,0,0,0,0,0,0,0,0,0,0,0,0
20200430,709395,譜瑞元富98購02,,,,,,0.00,0,0,0,0,0,0,0,0,0,0,0,0,0
20200430,709396,台燿元大98購01,3.00,3.07,2.83,3.07,+0.51,19.92,328000,27,968300,0,0,0,0,0,0,230000,91000,139000,139000
20200430,709397,神盾元大99購03,1.02,1.02,0.95,0.98,+0.03,3.16,158000,9,156570,0,0,0,0,0,0,136000,22000,114000,114000
20200430,709398,精測元大99購01,0.36,0.36,0.36,0.36,+0.03,9.09,1000,1,360,0,0,0,0,0,0,0,1000,-1000,-1000
20200430,709399,穩懋元大98購05,2.78,2.78,2.67,2.67,+0.25,10.33,73000,12,201870,0,0,0,0,0,0,23000,63000,-40000,-40000
20200430,709400,穩懋元大98購06,2.18,2.18,2.07,2.07,+0.18,9.52,63000,10,132600,0,0,0,0,0,0,23000,45000,-22000,-22000
20200430,709401,穩懋元大98購07,2.38,2.38,2.31,2.32,+0.22,10.48,64000,10,151690,0,0,0,0,0,0,14000,60000,-46000,-46000
20200430,709402,前鼎國票99購02,1.31,1.31,1.26,1.28,-0.21,-14.09,107000,10,136410,0,0,0,0,0,0,102000,5000,97000,97000
20200430,709403,雙美國票9B購01,0.84,0.84,0.84,0.84,-0.03,-3.45,21000,1,17640,0,0,0,0,0,0,21000,0,21000,21000
20200430,709404,雙鴻國票9A購01,,,,,,0.00,0,0,0,0,0,0,0,0,0,0,0,0,0
20200430,709405,譜瑞國票99購01,6.90,6.90,6.85,6.85,+0.20,3.01,241000,6,1651700,0,0,0,0,0,0,224000,17000,207000,207000
20200430,709406,博智國泰9A購01,,,,,,0.00,0,0,0,0,0,0,0,0,0,0,0,0,0
20200430,709407,大學光富邦9C購01,0.64,0.64,0.64,0.64,+0.02,3.23,2000,2,1280,0,0,0,0,0,0,2000,0,2000,2000
20200430,709408,VHQ永豐99購01,0.68,0.68,0.67,0.67,-0.02,-2.9,80000,4,54130,0,0,0,0,0,0,80000,0,80000,80000
20200430,709409,力致永豐99購01,1.35,1.43,1.29,1.41,+0.16,12.8,1861000,50,2592970,0,0,0,0,0,0,1772000,47000,1725000,1725000
20200430,709410,大學光永豐98購01,1.32,1.35,1.32,1.33,-0.08,-5.67,27000,3,35990,0,0,0,0,0,0,17000,10000,7000,7000
20200430,709411,台燿永豐98購01,0.52,0.53,0.48,0.53,+0.12,29.27,308000,8,154630,0,0,0,0,0,0,70000,238000,-168000,-168000
20200430,709412,立端永豐98購01,1.12,1.19,1.09,1.13,+0.04,3.67,257000,9,289380,0,0,0,0,0,0,131000,116000,15000,15000
20200430,709413,合晶永豐98購03,,,,,,0.00,0,0,0,0,0,0,0,0,0,0,0,0,0
20200430,709414,東隆興永豐98購02,0.17,0.20,0.17,0.20,+0.08,66.67,399000,9,71910,0,0,0,0,0,0,200000,199000,1000,1000
20200430,709415,群聯永豐98購01,,,,,,0.00,0,0,0,0,0,0,0,0,0,0,0,0,0
20200430,709416,緯軟永豐98購02,0.66,0.82,0.66,0.71,+0.08,12.7,241000,11,178000,0,0,0,0,0,0,45000,196000,-151000,-151000
20200430,709417,穩懋永豐98購01,1.34,1.35,1.32,1.32,+0.12,10.0,5000,5,6690,0,0,0,0,0,0,5000,4000,1000,1000
20200430,709418,頎邦永豐98購01,0.34,0.39,0.31,0.39,+0.08,25.81,114000,10,40940,0,0,0,0,0,0,62000,102000,-40000,-40000
20200430,709419,泰博兆豐98購02,2.75,2.75,2.60,2.65,-0.04,-1.49,122000,8,328800,0,0,0,0,0,0,120000,2000,118000,118000
20200430,709420,群聯兆豐99購01,0.57,0.64,0.57,0.59,-0.01,-1.67,22000,5,12820,0,0,0,0,0,0,11000,9000,2000,2000
20200430,709421,大江群益98購02,0.55,0.55,0.55,0.55,-0.01,-1.79,20000,1,11000,0,0,0,0,0,0,20000,0,20000,20000
20200430,709422,中美晶群益99購01,0.28,0.28,0.28,0.28,+0.03,12.0,100000,1,28000,0,0,0,0,0,0,100000,0,100000,100000
20200430,709423,亞泰群益98購01,,,,,,0.00,0,0,0,0,0,0,0,0,0,0,0,0,0
20200430,709424,南光群益98購01,2.40,2.41,2.40,2.41,-0.02,-0.82,62000,2,148820,0,0,0,0,0,0,60000,2000,58000,58000
20200430,709425,璟德群益98購02,1.37,1.47,1.35,1.42,+0.04,2.9,567000,11,782690,0,0,0,0,0,0,478000,89000,389000,389000
20200430,709426,智擎中信98購01,0.25,0.26,0.25,0.26,0.00,0.0,33000,3,8350,0,0,0,0,0,0,23000,10000,13000,13000
20200430,709427,力旺凱基98購01,0.80,0.96,0.80,0.96,+0.19,24.68,188000,7,164300,0,0,0,0,0,0,50000,138000,-88000,-88000
20200430,709428,三貝德凱基99購02,,,,,,0.00,0,0,0,0,0,0,0,0,0,0,0,0,0
20200430,709429,環球晶凱基99購03,,,,,,0.00,0,0,0,0,0,0,0,0,0,0,0,0,0
20200430,709430,穩懋凱基99購01,,,,,,0.00,0,0,0,0,0,0,0,0,0,0,0,0,0
20200430,709431,M31永豐99購01,0.97,1.00,0.97,1.00,+0.07,7.53,49000,3,48940,0,0,0,0,0,0,2000,47000,-45000,-45000
20200430,709432,力旺永豐98購01,0.62,0.70,0.62,0.70,+0.11,18.64,185000,10,120750,0,0,0,0,0,0,5000,180000,-175000,-175000
20200430,709433,大學光永豐98購02,1.42,1.42,1.36,1.36,-0.06,-4.23,19000,3,26380,0,0,0,0,0,0,19000,0,19000,19000
20200430,709434,宣德永豐98購02,0.86,0.93,0.84,0.93,-0.03,-3.12,89000,15,76610,0,0,0,0,0,0,46000,43000,3000,3000
20200430,709435,元太亞東99購01,,,,,,0.00,0,0,0,0,0,0,0,0,0,0,0,0,0
20200430,709436,穩懋麥證98購01,0.75,0.75,0.74,0.75,+0.09,13.64,18000,3,13470,0,18000,-18000,0,0,0,0,18000,-18000,-18000
20200430,709437,M31元富98購01,0.99,1.05,0.99,1.02,+0.10,10.87,212000,13,217730,0,0,0,0,0,0,43000,208000,-165000,-165000
20200430,709438,光頡元富98購01,0.54,0.58,0.54,0.57,+0.12,26.67,87000,6,47800,0,0,0,0,0,0,50000,37000,13000,13000
20200430,709439,優群元富98購01,,,,,,0.00,0,0,0,0,0,0,0,0,0,0,0,0,0
20200430,709440,三貝德元大99購01,,,,,,0.00,0,0,0,0,0,0,0,0,0,0,0,0,0
20200430,709441,神盾元大9A購03,0.49,0.49,0.48,0.48,-0.04,-7.69,33000,3,16070,0,0,0,0,0,0,20000,0,20000,20000
20200430,709442,神準元大98購01,0.84,0.84,0.72,0.75,-0.12,-13.79,16000,6,12250,5000,0,5000,0,0,0,5000,7000,-2000,3000
20200430,709443,統新元大99購01,2.49,2.53,2.28,2.28,-0.05,-2.15,141000,11,345940,0,0,0,0,0,0,50000,91000,-41000,-41000
20200430,709444,博智元大98購02,8.40,8.75,8.30,8.50,+0.45,5.59,62000,8,525000,0,0,0,0,0,0,17000,55000,-38000,-38000
20200430,709445,雍智元大98購01,1.49,1.68,1.49,1.62,+0.13,8.72,947000,51,1503320,0,0,0,0,0,0,365000,732000,-367000,-367000
20200430,709446,網家元大98購02,1.31,1.39,1.27,1.28,+0.02,1.59,422000,37,567180,0,0,0,0,0,0,103000,316000,-213000,-213000
20200430,709447,緯軟元大99購01,0.92,1.04,0.92,0.98,+0.14,16.67,55000,6,55550,0,0,0,0,0,0,5000,50000,-45000,-45000
20200430,709448,環球晶元大98購13,,,,,,0.00,0,0,0,0,0,0,0,0,0,0,0,0,0
20200430,709449,穩懋元大98購08,2.11,2.11,2.09,2.11,+0.24,12.83,10000,8,21000,0,0,0,0,0,0,10000,10000,0,0
20200430,709450,宇峻國票99購01,1.47,1.47,1.34,1.35,-0.16,-10.6,46000,7,65190,0,0,0,0,0,0,45000,1000,44000,44000
20200430,709451,大學光兆豐99購01,1.37,1.37,1.27,1.27,-0.08,-5.93,19000,3,25530,0,0,0,0,0,0,14000,5000,9000,9000
20200430,709452,原相兆豐99購01,,,,,,0.00,0,0,0,0,0,0,0,0,0,0,0,0,0
20200430,709453,穩懋兆豐98購02,,,,,,0.00,0,0,0,0,0,0,0,0,0,0,0,0,0
20200430,709454,網家群益98購01,0.54,0.54,0.54,0.54,-0.06,-10.0,20000,2,10800,0,0,0,0,0,0,20000,0,20000,20000
20200430,709455,網家群益98購02,2.45,2.55,2.39,2.40,-0.25,-9.43,154000,14,382120,0,0,0,0,0,0,78000,76000,2000,2000
20200430,709456,穩懋統一9A購01,0.90,0.90,0.86,0.86,+0.08,10.26,138000,6,123730,0,0,0,0,0,0,138000,0,138000,138000
20200430,709457,譜瑞中信9A購01,,,,,,0.00,0,0,0,0,0,0,0,0,0,0,0,0,0
20200430,709458,大江凱基99購01,,,,,,0.00,0,0,0,0,0,0,0,0,0,0,0,0,0
20200430,709459,中美晶凱基99購01,1.29,1.38,1.29,1.35,+0.05,3.85,124000,11,163260,0,0,0,0,0,0,104000,28000,76000,76000
20200430,709460,穩懋凱基99購02,0.49,0.49,0.45,0.45,-0.03,-6.25,40000,2,18400,0,0,0,0,0,0,30000,0,30000,30000
20200430,709461,譜瑞麥證98購01,,,,,,0.00,0,0,0,0,0,0,0,0,0,0,0,0,0
20200430,709462,環球晶元富98購02,,,,,,0.00,0,0,0,0,0,0,0,0,0,0,0,0,0
20200430,709463,環球晶元富98購03,1.05,1.10,1.04,1.10,+0.19,20.88,106000,10,114030,0,0,0,0,0,0,0,106000,-106000,-106000
20200430,709464,中美晶元大98購05,1.54,1.66,1.53,1.61,+0.13,8.78,145000,20,229130,0,0,0,0,0,0,20000,135000,-115000,-115000
20200430,709465,精測元大99購02,,,,,,0.00,0,0,0,0,0,0,0,0,0,0,0,0,0
20200430,709466,環球晶元大98購14,1.27,1.41,1.27,1.41,+0.17,13.71,51000,2,71770,0,0,0,0,0,0,1000,50000,-49000,-49000
20200430,709467,譜瑞元大98購04,3.67,3.72,3.67,3.72,+0.10,2.76,47000,4,173020,0,0,0,0,0,0,38000,9000,29000,29000
20200430,709468,穩懋日盛99購01,,,,,,0.00,0,0,0,0,0,0,0,0,0,0,0,0,0
20200430,709469,久元永豐98購01,0.53,0.53,0.53,0.53,-0.01,-1.85,20000,2,10600,0,0,0,0,0,0,0,20000,-20000,-20000
20200430,709470,原相永豐99購01,0.37,0.37,0.35,0.35,-0.01,-2.78,707000,12,249640,0,0,0,0,0,0,585000,0,585000,585000
20200430,709471,環球晶永豐98購02,0.24,0.31,0.24,0.31,+0.11,55.0,62000,5,15750,0,0,0,0,0,0,62000,0,62000,62000
20200430,709472,譜瑞永豐98購02,1.54,1.55,1.44,1.55,+0.05,3.33,102000,4,156200,0,0,0,0,0,0,10000,92000,-82000,-82000
20200430,709473,網家台新98購01,0.74,0.78,0.05,0.05,-0.65,-92.86,516000,15,391300,0,0,0,0,0,0,21000,495000,-474000,-474000
20200430,709474,台燿兆豐98購01,1.04,1.07,0.96,1.06,+0.21,24.71,245000,12,249310,0,0,0,0,0,0,193000,52000,141000,141000
20200430,709475,晟德兆豐99購01,0.52,0.56,0.52,0.54,0.00,0.0,80000,5,43000,0,0,0,0,0,0,0,40000,-40000,-40000
20200430,709476,旺矽國票99購01,1.09,1.29,1.09,1.29,+0.23,21.7,139000,7,172700,0,0,0,0,0,0,0,139000,-139000,-139000
20200430,709477,璟德國票99購01,3.12,3.12,3.12,3.12,-0.06,-1.89,9000,1,28080,0,0,0,0,0,0,9000,0,9000,9000
20200430,709478,聯亞國票99購02,2.37,2.37,2.13,2.13,-0.30,-12.35,37000,6,80690,0,0,0,0,0,0,7000,30000,-23000,-23000
20200430,709479,譜瑞國票99購02,5.40,5.40,5.35,5.35,+0.20,3.88,8000,2,43100,0,0,0,0,0,0,2000,6000,-4000,-4000
20200430,709480,宇峻康和98購01,0.48,0.48,0.47,0.47,-0.04,-7.84,60000,5,28450,0,0,0,0,0,0,0,60000,-60000,-60000
20200430,709481,凡甲群益98購02,,,,,,0.00,0,0,0,0,0,0,0,0,0,0,0,0,0
20200430,709482,大宇資群益9A購01,,,,,,0.00,0,0,0,0,0,0,0,0,0,0,0,0,0
20200430,709483,迅得群益9A購02,,,,,,0.00,0,0,0,0,0,0,0,0,0,0,0,0,0
20200430,709484,金居群益9A購01,1.78,1.98,1.73,1.98,+0.53,36.55,382000,23,697170,0,0,0,0,0,0,111000,271000,-160000,-160000
20200430,709485,晶焱群益9A購01,0.98,1.01,0.96,1.00,+0.05,5.26,198000,10,196800,0,0,0,0,0,0,62000,186000,-124000,-124000
20200430,709486,群聯群益98購02,,,,,,0.00,0,0,0,0,0,0,0,0,0,0,0,0,0
20200430,709487,環球晶群益98購02,,,,,,0.00,0,0,0,0,0,0,0,0,0,0,0,0,0
20200430,709488,大江國泰9A購02,1.11,1.11,0.97,0.97,+0.01,1.04,20000,2,20800,0,0,0,0,0,0,10000,10000,0,0
20200430,709489,譜瑞國泰9A購01,,,,,,0.00,0,0,0,0,0,0,0,0,0,0,0,0,0
20200430,709490,穩懋富邦9A購01,,,,,,0.00,0,0,0,0,0,0,0,0,0,0,0,0,0
20200430,709491,譜瑞富邦9A購01,,,,,,0.00,0,0,0,0,0,0,0,0,0,0,0,0,0
20200430,709492,同致元富9B購01,0.76,0.76,0.76,0.76,+0.12,18.75,6000,2,4560,0,0,0,0,0,0,0,6000,-6000,-6000
20200430,709493,博智元富98購01,,,,,,0.00,0,0,0,0,0,0,0,0,0,0,0,0,0
20200430,709494,威剛統一9A購02,,,,,,0.00,0,0,0,0,0,0,0,0,0,0,0,0,0
20200430,709495,譜瑞統一99購01,0.87,0.88,0.86,0.88,+0.02,2.33,76000,9,66450,0,0,0,0,0,0,59000,17000,42000,42000
20200430,709496,中美晶凱基99購02,0.25,0.25,0.15,0.15,-0.09,-37.5,101000,2,15250,0,0,0,0,0,0,100000,0,100000,100000
20200430,709497,網家凱基98購01,0.80,0.84,0.79,0.84,-0.02,-2.33,258000,13,212990,0,0,0,0,0,0,72000,186000,-114000,-114000
20200430,709498,網龍凱基98購02,0.97,0.99,0.92,0.95,-0.08,-7.77,306000,26,294290,0,0,0,0,0,0,306000,1000,305000,305000
20200430,709499,環球晶凱基98購07,,,,,,0.00,0,0,0,0,0,0,0,0,0,0,0,0,0
20200430,709500,環球晶凱基99購04,,,,,,0.00,0,0,0,0,0,0,0,0,0,0,0,0,0
20200430,709501,譜瑞凱基98購01,,,,,,0.00,0,0,0,0,0,0,0,0,0,0,0,0,0
20200430,709502,譜瑞凱基99購01,,,,,,0.00,0,0,0,0,0,0,0,0,0,0,0,0,0
20200430,709503,譜瑞凱基9A購01,,,,,,0.00,0,0,0,0,0,0,0,0,0,0,0,0,0
20200430,709504,合晶兆豐98購01,1.10,1.19,1.10,1.19,+0.17,16.67,155000,13,180390,0,0,0,0,0,0,13000,155000,-142000,-142000
20200430,709505,威剛兆豐99購01,0.49,0.49,0.48,0.49,+0.02,4.26,492000,10,240970,20000,0,20000,0,0,0,21000,460000,-439000,-419000
20200430,709506,聚積兆豐99購01,,,,,,0.00,0,0,0,0,0,0,0,0,0,0,0,0,0
20200430,709507,中美晶永豐98購02,0.10,0.11,0.10,0.11,+0.03,37.5,135000,4,13750,0,0,0,0,0,0,0,135000,-135000,-135000
20200430,709508,尼克森永豐98購01,0.83,0.84,0.83,0.84,+0.02,2.44,73000,3,61200,0,0,0,0,0,0,73000,0,73000,73000
20200430,709509,安勤永豐98購01,0.27,0.27,0.27,0.27,+0.04,17.39,5000,1,1350,0,0,0,0,0,0,5000,0,5000,5000
20200430,709510,信驊永豐98購01,2.22,2.23,2.15,2.23,+0.29,14.95,22000,4,48800,0,0,0,0,0,0,2000,17000,-15000,-15000
20200430,709511,博智永豐98購02,,,,,,0.00,0,0,0,0,0,0,0,0,0,0,0,0,0
20200430,709512,網家永豐98購01,0.19,0.19,0.19,0.19,+0.02,11.76,50000,1,9500,0,0,0,0,0,0,0,50000,-50000,-50000
20200430,709513,中美晶國票98購02,0.85,0.85,0.83,0.83,+0.10,13.7,75000,3,62550,0,0,0,0,0,0,0,75000,-75000,-75000
20200430,709514,網家國票99購01,1.32,1.47,1.32,1.32,+0.03,2.33,235000,18,322920,0,0,0,0,0,0,166000,69000,97000,97000
20200430,709515,穩懋國票99購01,2.56,2.56,2.42,2.49,+0.37,17.45,21000,5,51640,0,0,0,0,0,0,4000,17000,-13000,-13000
20200430,709516,中美晶國泰9A購01,1.14,1.22,1.14,1.19,+0.08,7.21,339000,21,396240,0,0,0,0,0,0,65000,294000,-229000,-229000
20200430,709517,太景*國泰9A購02,0.35,0.35,0.35,0.35,+0.09,34.62,60000,6,21000,0,0,0,0,0,0,0,60000,-60000,-60000
20200430,709518,宇峻國泰9A購01,0.82,0.83,0.75,0.75,-0.08,-9.64,372000,25,295600,0,0,0,0,0,0,267000,90000,177000,177000
20200430,709519,威剛國泰99購01,1.16,1.18,1.14,1.14,+0.03,2.7,95000,8,109510,0,0,0,0,0,0,3000,95000,-92000,-92000
20200430,709520,原相國泰99購01,,,,,,0.00,0,0,0,0,0,0,0,0,0,0,0,0,0
20200430,709521,博智國泰9A購02,3.65,3.81,3.65,3.67,+0.11,3.09,177000,14,660470,0,0,0,0,0,0,128000,154000,-26000,-26000
20200430,709522,環球晶國泰99購02,,,,,,0.00,0,0,0,0,0,0,0,0,0,0,0,0,0
20200430,709523,環球晶國泰9A購01,0.76,0.76,0.76,0.76,+0.17,28.81,10000,1,7600,0,0,0,0,0,0,10000,0,10000,10000
20200430,709524,鈊象國泰9A購01,2.00,2.00,1.78,1.79,-0.08,-4.28,24000,5,46310,0,0,0,0,0,0,0,24000,-24000,-24000
20200430,709525,譜瑞台新98購01,1.49,1.51,1.49,1.50,+0.02,1.35,33000,4,49500,0,0,0,0,0,0,10000,23000,-13000,-13000
20200430,709526,大學光富邦98購01,0.88,0.88,0.88,0.88,-0.03,-3.3,40000,2,35200,0,0,0,0,0,0,35000,5000,30000,30000
20200430,709527,力旺群益99購01,0.91,1.03,0.91,1.03,+0.17,19.77,289000,8,272870,0,0,0,0,0,0,68000,221000,-153000,-153000
20200430,709528,中美晶群益99購02,0.68,0.75,0.68,0.75,+0.08,11.94,253000,6,172230,0,0,0,0,0,0,230000,8000,222000,222000
20200430,709529,宜鼎群益98購03,2.12,2.25,2.12,2.25,+0.21,10.29,451000,26,990610,0,0,0,0,0,0,359000,116000,243000,243000
20200430,709530,神盾群益9A購03,,,,,,0.00,0,0,0,0,0,0,0,0,0,0,0,0,0
20200430,709531,碩禾群益98購01,0.07,0.07,0.07,0.07,0.00,0.0,20000,2,1400,0,0,0,0,0,0,0,20000,-20000,-20000
20200430,709532,精測群益98購01,0.57,0.59,0.56,0.56,+0.04,7.69,78000,4,45580,0,0,0,0,0,0,0,78000,-78000,-78000
20200430,709533,譜瑞群益98購02,2.38,2.44,2.38,2.44,+0.06,2.52,26000,3,63280,0,0,0,0,0,0,16000,10000,6000,6000
20200430,709534,M31元大9A購01,0.86,0.89,0.86,0.89,+0.08,9.88,250000,3,219500,0,0,0,0,0,0,0,250000,-250000,-250000
20200430,709535,宣德元大99購02,2.05,2.18,2.01,2.15,+0.15,7.5,396000,28,832850,0,0,0,0,0,0,123000,271000,-148000,-148000
20200430,709536,網家元大98購03,2.07,2.17,2.02,2.16,-0.02,-0.92,127000,7,267240,0,0,0,0,0,0,47000,80000,-33000,-33000
20200430,709537,環球晶元大9A購01,0.75,0.76,0.75,0.76,+0.14,22.58,2000,2,1510,0,0,0,0,0,0,2000,0,2000,2000
20200430,709538,穩懋元大98購09,2.71,2.71,2.67,2.67,+0.23,9.43,23000,11,62170,0,0,0,0,0,0,23000,13000,10000,10000
20200430,709539,鈺太元大99購03,1.69,1.72,1.62,1.72,+0.04,2.38,173000,12,285650,0,0,0,0,0,0,92000,104000,-12000,-12000
20200430,709540,雍智元富98購01,1.40,1.59,1.36,1.51,+0.21,16.15,873000,44,1298290,0,0,0,0,0,0,246000,608000,-362000,-362000
20200430,709541,環球晶中信99購03,0.16,0.18,0.16,0.18,+0.03,20.0,250000,5,42000,0,0,0,0,0,0,0,250000,-250000,-250000
20200430,709542,大江凱基9A購01,,,,,,0.00,0,0,0,0,0,0,0,0,0,0,0,0,0
20200430,709543,中美晶凱基9A購02,,,,,,0.00,0,0,0,0,0,0,0,0,0,0,0,0,0
20200430,709544,台半凱基98購02,,,,,,0.00,0,0,0,0,0,0,0,0,0,0,0,0,0
20200430,709545,安勤凱基98購01,,,,,,0.00,0,0,0,0,0,0,0,0,0,0,0,0,0
20200430,709546,環球晶凱基99購05,,,,,,0.00,0,0,0,0,0,0,0,0,0,0,0,0,0
20200430,709547,穩懋凱基98購09,1.29,1.30,1.26,1.26,+0.11,9.57,147000,10,186120,0,0,0,0,0,0,67000,80000,-13000,-13000
20200430,709548,威剛統一99購01,,,,,,0.00,0,0,0,0,0,0,0,0,0,0,0,0,0
20200430,709549,網家統一9A購01,0.45,0.48,0.44,0.44,0.00,0.0,614000,20,280980,0,0,0,0,0,0,254000,350000,-96000,-96000
20200430,709550,環球晶統一99購03,,,,,,0.00,0,0,0,0,0,0,0,0,0,0,0,0,0
20200430,709551,大江元大99購02,2.57,2.57,2.37,2.37,0.00,0.0,131000,11,328170,0,0,0,0,0,0,61000,70000,-9000,-9000
20200430,709552,神盾元大99購04,1.21,1.25,1.12,1.17,+0.02,1.74,573000,60,673740,0,0,0,0,0,0,385000,175000,210000,210000
20200430,709553,博智元大98購03,3.81,4.03,3.73,3.84,+0.20,5.49,83000,12,323310,0,0,0,0,0,0,30000,62000,-32000,-32000
20200430,709554,群聯元大99購03,0.77,0.80,0.76,0.78,+0.06,8.33,112000,7,87100,0,0,0,0,0,0,90000,0,90000,90000
20200430,709555,譜瑞元大98購06,4.05,4.05,3.99,4.03,+0.11,2.81,45000,7,180530,0,0,0,0,0,0,24000,21000,3000,3000
20200430,709556,威剛國票99購01,1.03,1.04,0.99,0.99,+0.02,2.06,69000,5,69480,0,0,0,0,0,0,52000,19000,33000,33000
20200430,709557,神盾國票99購01,1.24,1.25,1.15,1.19,+0.01,0.85,353000,8,420310,0,0,0,0,0,0,353000,0,353000,353000
20200430,709558,廣明國票99購01,2.73,2.73,2.46,2.46,-0.26,-9.56,116000,4,303820,0,0,0,0,0,0,48000,68000,-20000,-20000
20200430,709559,環球晶國票99購01,2.01,2.21,2.01,2.15,+0.26,13.76,54000,4,114320,0,0,0,0,0,0,19000,35000,-16000,-16000
20200430,709560,雙美國票99購02,,,,,,0.00,0,0,0,0,0,0,0,0,0,0,0,0,0
20200430,709561,聚積國泰99購01,0.60,0.60,0.60,0.60,+0.01,1.69,10000,1,6000,0,0,0,0,0,0,0,10000,-10000,-10000
20200430,709562,中美晶群益98購03,,,,,,0.00,0,0,0,0,0,0,0,0,0,0,0,0,0
20200430,709563,合晶群益98購02,,,,,,0.00,0,0,0,0,0,0,0,0,0,0,0,0,0
20200430,709564,旺矽群益99購01,0.57,0.64,0.57,0.64,+0.05,8.47,131000,3,80170,0,0,0,0,0,0,31000,100000,-69000,-69000
20200430,709565,宣德群益98購02,1.78,1.89,1.78,1.89,-0.02,-1.05,191000,20,351790,0,0,0,0,0,0,50000,141000,-91000,-91000
20200430,709566,鈺太群益98購03,,,,,,0.00,0,0,0,0,0,0,0,0,0,0,0,0,0
20200430,709567,穩懋台新98購02,,,,,,0.00,0,0,0,0,0,0,0,0,0,0,0,0,0
20200430,709568,原相亞東99購02,,,,,,0.00,0,0,0,0,0,0,0,0,0,0,0,0,0
20200430,709569,群聯亞東98購01,,,,,,0.00,0,0,0,0,0,0,0,0,0,0,0,0,0
20200430,709570,直得永豐98購01,0.25,0.68,0.23,0.68,+0.53,353.33,225000,8,78750,0,0,0,0,0,0,40000,120000,-80000,-80000
20200430,709571,網龍永豐98購02,0.85,0.85,0.79,0.79,-0.15,-15.96,88000,4,72950,0,0,0,0,0,0,53000,35000,18000,18000
20200430,709572,聚積永豐98購01,,,,,,0.00,0,0,0,0,0,0,0,0,0,0,0,0,0
20200430,709573,鈺太永豐98購01,0.81,0.83,0.78,0.81,-0.01,-1.22,373000,14,303330,0,0,0,0,0,0,351000,104000,247000,247000
20200430,709574,元太台新98購02,,,,,,0.00,0,0,0,0,0,0,0,0,0,0,0,0,0
20200430,709575,中美晶元大98購06,,,,,,0.00,0,0,0,0,0,0,0,0,0,0,0,0,0
20200430,709576,原相元大9A購03,,,,,,0.00,0,0,0,0,0,0,0,0,0,0,0,0,0
20200430,709577,泰博元大98購01,3.55,3.64,3.30,3.36,-0.05,-1.47,32000,5,114510,0,0,0,0,0,0,30000,2000,28000,28000
20200430,709578,聚積元大9A購01,,,,,,0.00,0,0,0,0,0,0,0,0,0,0,0,0,0
20200430,709579,環球晶元大98購15,0.77,0.90,0.77,0.90,+0.16,21.62,212000,9,180940,0,0,0,0,0,0,192000,20000,172000,172000
20200430,709580,宇峻中信98購01,0.38,0.38,0.38,0.38,-0.04,-9.52,10000,1,3800,0,0,0,0,0,0,0,10000,-10000,-10000
20200430,709581,原相統一99購02,,,,,,0.00,0,0,0,0,0,0,0,0,0,0,0,0,0
20200430,709582,雙鴻統一99購02,1.00,1.00,0.99,0.99,+0.02,2.06,1130000,6,1125650,0,0,0,0,0,0,900000,230000,670000,670000
20200430,709583,大宇資凱基99購01,0.23,0.23,0.22,0.22,-0.02,-8.33,10000,2,2210,0,0,0,0,0,0,10000,0,10000,10000
20200430,709584,威剛凱基98購01,1.07,1.08,1.04,1.04,+0.03,2.97,109000,9,115080,0,0,0,0,0,0,2000,109000,-107000,-107000
20200430,709585,博智凱基9A購01,0.95,0.95,0.94,0.94,+0.03,3.3,11000,2,10380,0,0,0,0,0,0,11000,0,11000,11000
20200430,709586,精測凱基99購02,,,,,,0.00,0,0,0,0,0,0,0,0,0,0,0,0,0
20200430,709587,譜瑞凱基98購02,0.83,0.83,0.83,0.83,+0.03,3.75,10000,1,8300,0,0,0,0,0,0,10000,0,10000,10000
20200430,709588,中美晶群益98購04,0.51,0.55,0.51,0.55,+0.05,10.0,170000,3,89200,0,0,0,0,0,0,170000,0,170000,170000
20200430,709589,元太群益99購01,1.87,1.90,1.81,1.90,+0.09,4.97,205000,19,379730,0,0,0,0,0,0,131000,74000,57000,57000
20200430,709590,網家群益98購03,,,,,,0.00,0,0,0,0,0,0,0,0,0,0,0,0,0
20200430,709591,譜瑞群益98購03,2.53,2.57,2.47,2.53,+0.05,2.02,108000,5,269850,0,0,0,0,0,0,29000,79000,-50000,-50000
20200430,709592,泰博國票99購03,3.19,3.19,3.03,3.08,-0.04,-1.28,61000,4,191570,0,0,0,0,0,0,37000,24000,13000,13000
20200430,709593,合晶國泰99購02,0.93,0.93,0.93,0.93,+0.18,24.0,1000,1,930,0,0,0,0,0,0,1000,0,1000,1000
20200430,709594,保瑞國泰9A購01,,,,,,0.00,0,0,0,0,0,0,0,0,0,0,0,0,0
20200430,709595,璟德兆豐99購01,0.46,0.55,0.46,0.50,+0.04,8.7,65000,9,32870,0,0,0,0,0,0,45000,0,45000,45000
20200430,709596,亞泰永豐99購02,,,,,,0.00,0,0,0,0,0,0,0,0,0,0,0,0,0
20200430,709597,保瑞永豐98購01,,,,,,0.00,0,0,0,0,0,0,0,0,0,0,0,0,0
20200430,709598,建榮永豐99購03,,,,,,0.00,0,0,0,0,0,0,0,0,0,0,0,0,0
20200430,709599,神盾永豐98購01,0.79,0.79,0.76,0.77,+0.02,2.67,79000,3,60810,0,0,0,0,0,0,32000,47000,-15000,-15000
20200430,709600,新鉅科永豐98購02,0.09,0.09,0.09,0.09,-0.01,-10.0,10000,1,900,0,0,0,0,0,0,0,10000,-10000,-10000
20200430,709601,雙美永豐99購02,0.68,0.68,0.68,0.68,+0.02,3.03,5000,1,3400,0,0,0,0,0,0,0,5000,-5000,-5000
20200430,709602,穩懋永豐98購03,1.85,1.85,1.81,1.83,+0.16,9.58,83000,5,151090,0,0,0,0,0,0,83000,12000,71000,71000
20200430,709603,晟德永豐98購01,0.91,0.91,0.91,0.91,0.00,0.0,1000,1,910,0,0,0,0,0,0,0,1000,-1000,-1000
20200430,709604,鈊象永豐98購03,0.73,0.73,0.65,0.67,-0.06,-8.22,46000,5,31440,0,0,0,0,0,0,14000,46000,-32000,-32000
20200430,709605,中美晶元富99購02,,,,,,0.00,0,0,0,0,0,0,0,0,0,0,0,0,0
20200430,709606,尼克森元富98購01,,,,,,0.00,0,0,0,0,0,0,0,0,0,0,0,0,0
20200430,709607,博智元富98購02,2.66,2.88,2.63,2.70,+0.15,5.88,297000,16,808670,0,0,0,0,0,0,88000,209000,-121000,-121000
20200430,709608,網龍元富98購01,1.05,1.05,1.00,1.02,-0.07,-6.42,41000,4,41920,0,0,0,0,0,0,31000,10000,21000,21000
20200430,709609,穩懋元富02購01,,,,,,0.00,0,0,0,0,0,0,0,0,0,0,0,0,0
20200430,709610,穩懋元富02購02,2.11,2.12,2.11,2.11,+0.15,7.65,119000,10,251150,0,0,0,0,0,0,119000,0,119000,119000
20200430,709611,穩懋元富02購03,2.15,2.16,2.13,2.16,+0.15,7.46,125000,14,269150,0,0,0,0,0,0,125000,0,125000,125000
20200430,709612,穩懋元富02購04,2.12,2.13,2.05,2.05,+0.03,1.49,117000,15,247420,0,0,0,0,0,0,92000,25000,67000,67000
20200430,709613,凡甲凱基98購02,,,,,,0.00,0,0,0,0,0,0,0,0,0,0,0,0,0
20200430,709614,中美晶凱基99購03,0.45,0.49,0.45,0.49,+0.05,11.36,8000,3,3710,0,0,0,0,0,0,0,8000,-8000,-8000
20200430,709615,緯軟凱基98購04,0.62,0.73,0.62,0.73,+0.17,30.36,70000,2,48900,0,0,0,0,0,0,0,70000,-70000,-70000
20200430,709616,大江兆豐99購01,1.18,1.18,1.07,1.07,+0.01,0.94,74000,8,81100,0,0,0,0,0,0,21000,54000,-33000,-33000
20200430,709617,大江群益98購03,,,,,,0.00,0,0,0,0,0,0,0,0,0,0,0,0,0
20200430,709618,安勤群益98購01,0.39,0.46,0.39,0.44,+0.04,10.0,155000,8,64500,0,0,0,0,0,0,45000,110000,-65000,-65000
20200430,709619,杰力群益98購01,1.25,1.25,1.23,1.24,-0.02,-1.59,418000,15,517900,0,0,0,0,0,0,320000,98000,222000,222000
20200430,709620,群聯群益98購03,4.04,4.04,3.94,4.00,+0.38,10.5,114000,26,456000,0,0,0,0,0,0,110000,27000,83000,83000
20200430,709621,環球晶群益98購04,2.37,2.69,2.34,2.69,+0.45,20.09,157000,28,386420,0,0,0,0,0,0,121000,80000,41000,41000
20200430,709622,M31永豐98購02,,,,,,0.00,0,0,0,0,0,0,0,0,0,0,0,0,0
20200430,709623,尼克森永豐98購02,0.89,0.90,0.87,0.90,+0.01,1.12,128000,4,112210,0,0,0,0,0,0,128000,0,128000,128000
20200430,709624,泰博永豐99購01,1.12,1.12,1.03,1.09,-0.03,-2.68,94000,12,102810,0,0,0,0,0,0,42000,51000,-9000,-9000
20200430,709625,力旺國票99購01,1.38,1.53,1.30,1.53,+0.25,19.53,199000,7,288090,0,0,0,0,0,0,60000,139000,-79000,-79000
20200430,709626,建榮國票9A購01,0.87,0.89,0.87,0.89,+0.17,23.61,142000,2,124380,0,0,0,0,0,0,142000,0,142000,142000
20200430,709627,博智國票99購01,3.41,3.57,3.41,3.46,+0.14,4.22,221000,8,772260,0,0,0,0,0,0,154000,67000,87000,87000
20200430,709628,優群國票99購01,,,,,,0.00,0,0,0,0,0,0,0,0,0,0,0,0,0
20200430,709629,環球晶國票99購02,2.80,3.18,2.80,3.18,+0.42,15.22,15000,2,43900,0,0,0,0,0,0,10000,5000,5000,5000
20200430,709630,聯亞國票99購03,8.55,8.55,7.90,7.90,-0.40,-4.82,12000,3,99800,0,0,0,0,0,0,12000,0,12000,12000
20200430,709631,大中元大98購01,0.83,0.84,0.72,0.79,+0.01,1.28,824000,34,662910,0,0,0,0,0,0,808000,70000,738000,738000
20200430,709632,合晶元大99購01,2.49,2.81,2.48,2.70,+0.25,10.2,244000,21,632530,0,0,0,0,0,0,65000,183000,-118000,-118000
20200430,709633,宜鼎元大99購01,1.08,1.13,1.07,1.12,+0.10,9.8,858000,36,941340,0,0,0,0,0,0,622000,362000,260000,260000
20200430,709634,保瑞元大98購02,1.81,1.81,1.81,1.81,+0.06,3.43,2000,1,3620,0,0,0,0,0,0,0,2000,-2000,-2000
20200430,709635,譜瑞元大98購07,2.01,2.02,1.96,2.02,+0.07,3.59,95000,10,189570,0,0,0,0,0,0,19000,76000,-57000,-57000
20200430,709636,晟德元大98購01,,,,,,0.00,0,0,0,0,0,0,0,0,0,0,0,0,0
20200430,709637,安勤元富98購01,0.96,1.05,0.96,1.04,+0.06,6.12,301000,14,300830,0,0,0,0,0,0,27000,274000,-247000,-247000
20200430,709638,威剛富邦9A購01,,,,,,0.00,0,0,0,0,0,0,0,0,0,0,0,0,0
20200430,709639,雙鴻富邦99購01,0.54,0.59,0.54,0.59,+0.06,11.32,91000,5,50840,0,0,0,0,0,0,58000,33000,25000,25000
20200430,709640,博智台新98購01,,,,,,0.00,0,0,0,0,0,0,0,0,0,0,0,0,0
20200430,709641,久元群益98購01,1.07,1.07,1.07,1.07,+0.03,2.88,17000,1,18190,0,0,0,0,0,0,17000,0,17000,17000
20200430,709642,群聯群益98購04,,,,,,0.00,0,0,0,0,0,0,0,0,0,0,0,0,0
20200430,709643,聖暉群益98購01,2.81,2.96,2.75,2.83,+0.14,5.2,350000,14,987230,0,0,0,0,0,0,220000,130000,90000,90000
20200430,709644,璟德中信98購01,2.32,2.44,2.29,2.44,+0.08,3.39,86000,10,201140,0,0,0,0,0,0,46000,30000,16000,16000
20200430,709645,合晶統一9A購01,0.63,0.70,0.63,0.70,+0.11,18.64,493000,11,323420,0,0,0,0,0,0,10000,483000,-473000,-473000
20200430,709646,神盾統一99購01,1.05,1.05,0.99,0.99,+0.02,2.06,133000,5,137930,0,0,0,0,0,0,133000,0,133000,133000
20200430,709647,環球晶統一99購04,0.69,0.71,0.69,0.71,-0.01,-1.39,263000,3,183590,0,0,0,0,0,0,0,263000,-263000,-263000
20200430,709648,穩懋統一98購06,1.27,1.27,1.26,1.27,+0.11,9.48,366000,10,461750,0,0,0,0,0,0,307000,59000,248000,248000
20200430,709649,中美晶凱基99購04,0.96,1.00,0.96,0.99,+0.09,10.0,16000,3,15670,0,0,0,0,0,0,1000,16000,-15000,-15000
20200430,709650,精測凱基98購05,0.75,0.75,0.72,0.75,+0.04,5.63,242000,13,176140,0,0,0,0,0,0,218000,24000,194000,194000
20200430,709651,聯亞凱基99購04,1.00,1.02,0.97,0.97,-0.03,-3.0,53000,12,52840,0,0,0,0,0,0,47000,22000,25000,25000
20200430,709652,大學光國票99購01,2.34,2.34,2.19,2.19,-0.14,-6.01,52000,3,118680,0,0,0,0,0,0,52000,0,52000,52000
20200430,709653,原相國票99購02,1.96,1.96,1.96,1.96,-0.10,-4.85,40000,1,78400,0,0,0,0,0,0,40000,0,40000,40000
20200430,709654,安勤國泰99購01,0.62,0.69,0.62,0.69,+0.05,7.81,45000,6,29600,0,0,0,0,0,0,0,45000,-45000,-45000
20200430,709655,大江元大98購03,2.72,2.72,2.53,2.53,+0.02,0.8,54000,7,145880,0,0,0,0,0,0,53000,2000,51000,51000
20200430,709656,中美晶元大99購03,1.46,1.56,1.45,1.52,+0.11,7.8,296000,29,447330,0,0,0,0,0,0,228000,85000,143000,143000
20200430,709657,宇峻元大99購03,1.26,1.28,1.17,1.19,-0.06,-4.8,722000,24,886240,0,0,0,0,0,0,702000,20000,682000,682000
20200430,709658,博智元大99購01,4.27,4.47,4.22,4.30,+0.20,4.88,83000,10,360420,0,0,0,0,0,0,48000,52000,-4000,-4000
20200430,709659,網家元大99購02,,,,,,0.00,0,0,0,0,0,0,0,0,0,0,0,0,0
20200430,709660,環球晶元大98購16,1.20,1.21,1.20,1.21,+0.17,16.35,100000,2,120500,0,0,0,0,0,0,0,100000,-100000,-100000
20200430,709661,環球晶元大99購02,1.30,1.32,1.30,1.32,+0.12,10.0,70000,2,92000,0,0,0,0,0,0,0,70000,-70000,-70000
20200430,709662,穩懋元大98購10,3.01,3.01,2.95,2.95,+0.25,9.26,27000,12,80410,0,0,0,0,0,0,15000,27000,-12000,-12000
20200430,709663,譜瑞元大98購08,3.66,3.71,3.66,3.71,+0.14,3.92,55000,5,201910,0,0,0,0,0,0,46000,9000,37000,37000
20200430,709664,神盾第一9C購02,1.13,1.13,1.06,1.06,-0.02,-1.85,341000,32,379150,0,0,0,0,0,0,281000,60000,221000,221000
20200430,709665,台半永豐98購01,0.19,0.19,0.18,0.18,0.00,0.0,20000,2,3700,0,0,0,0,0,0,0,20000,-20000,-20000
20200430,709666,兆利永豐98購02,0.76,0.76,0.76,0.76,+0.02,2.7,68000,1,51680,0,0,0,0,0,0,68000,0,68000,68000
20200430,709667,金居永豐98購02,0.70,0.81,0.70,0.81,+0.38,88.37,2000,2,1510,0,0,0,0,0,0,0,2000,-2000,-2000
20200430,709668,宣德永豐98購03,0.94,0.99,0.94,0.99,-0.04,-3.88,27000,7,25560,0,0,0,0,0,0,25000,2000,23000,23000
20200430,709669,博智永豐99購01,,,,,,0.00,0,0,0,0,0,0,0,0,0,0,0,0,0
20200430,709670,晶焱永豐98購03,1.14,1.20,1.14,1.20,+0.08,7.14,234000,10,271580,0,0,0,0,0,0,121000,113000,8000,8000
20200430,709671,雍智永豐99購01,1.17,1.26,1.17,1.25,+0.11,9.65,215000,18,263490,0,0,0,0,0,0,10000,205000,-195000,-195000
20200430,709672,環宇永豐98購03,,,,,,0.00,0,0,0,0,0,0,0,0,0,0,0,0,0
20200430,709673,環球晶元富98購04,,,,,,0.00,0,0,0,0,0,0,0,0,0,0,0,0,0
20200430,709674,力旺元大98購01,2.60,2.93,2.60,2.93,+0.36,14.01,157000,10,435720,0,0,0,0,0,0,3000,154000,-151000,-151000
20200430,709675,力旺元大98購02,1.15,1.15,1.15,1.15,+0.23,25.0,10000,1,11500,0,0,0,0,0,0,0,0,0,0
20200430,709676,中美晶元大98購08,1.25,1.33,1.25,1.29,+0.10,8.4,98000,12,129060,0,0,0,0,0,0,76000,30000,46000,46000
20200430,709677,聚積元大99購01,0.49,0.49,0.49,0.49,+0.01,2.08,5000,1,2450,0,0,0,0,0,0,0,5000,-5000,-5000
20200430,709678,聯亞元大98購05,1.47,1.52,1.26,1.28,-0.21,-14.09,92000,21,123670,0,0,0,0,0,0,47000,8000,39000,39000
20200430,709679,譜瑞元大98購09,2.38,2.39,2.34,2.39,+0.06,2.58,110000,7,260500,0,0,0,0,0,0,50000,60000,-10000,-10000
20200430,709680,中美晶國票99購01,1.36,1.36,1.32,1.32,+0.09,7.32,3000,3,4030,0,0,0,0,0,0,2000,1000,1000,1000
20200430,709681,宣德國票98購02,2.01,2.26,2.00,2.26,+0.09,4.15,197000,10,409570,0,0,0,0,0,0,83000,114000,-31000,-31000
20200430,709682,建榮國票9A購02,,,,,,0.00,0,0,0,0,0,0,0,0,0,0,0,0,0
20200430,709683,網家國票99購02,2.69,2.84,2.59,2.80,-0.02,-0.71,156000,11,425830,0,0,0,0,0,0,102000,54000,48000,48000
20200430,709684,雍智國泰9A購01,1.40,1.53,1.40,1.53,+0.18,13.33,550000,15,801900,0,0,0,0,0,0,0,550000,-550000,-550000
20200430,709685,安勤統一98購01,,,,,,0.00,0,0,0,0,0,0,0,0,0,0,0,0,0
20200430,709686,元太中信9A購01,1.45,1.49,1.44,1.47,+0.03,2.08,626000,61,923960,0,0,0,0,0,0,259000,360000,-101000,-101000
20200430,709687,台燿中信9A購01,0.79,0.84,0.77,0.84,+0.14,20.0,550000,22,432530,0,0,0,0,0,0,321000,224000,97000,97000
20200430,709688,合晶中信9A購02,0.31,0.31,0.31,0.31,+0.05,19.23,5000,1,1550,0,0,0,0,0,0,0,5000,-5000,-5000
20200430,709689,中美晶凱基99購05,,,,,,0.00,0,0,0,0,0,0,0,0,0,0,0,0,0
20200430,709690,六角凱基99購03,0.85,0.85,0.85,0.85,+0.11,14.86,5000,1,4250,0,0,0,0,0,0,5000,0,5000,5000
20200430,709691,智崴凱基98購01,0.30,0.31,0.27,0.27,-0.02,-6.9,139000,12,38880,0,0,0,0,0,0,0,24000,-24000,-24000
20200430,709692,昇達科永豐98購01,0.65,0.65,0.64,0.64,+0.01,1.59,50000,2,32250,0,0,0,0,0,0,50000,0,50000,50000
20200430,709693,建榮永豐99購04,,,,,,0.00,0,0,0,0,0,0,0,0,0,0,0,0,0
20200430,709694,順達永豐98購01,2.17,2.17,2.17,2.17,-0.07,-3.13,143000,4,310310,0,0,0,0,0,0,143000,0,143000,143000
20200430,709695,精測永豐98購01,0.85,0.86,0.82,0.86,+0.07,8.86,183000,9,154900,0,0,0,0,0,0,182000,0,182000,182000
20200430,709696,穩懋永豐98購04,1.29,1.29,1.26,1.29,+0.09,7.5,107000,5,136860,0,0,0,0,0,0,107000,0,107000,107000
20200430,709697,鈊象永豐99購01,0.50,0.50,0.46,0.46,-0.05,-9.8,103000,5,50300,0,0,0,0,0,0,93000,73000,20000,20000
20200430,709698,力旺中信99購01,0.84,1.01,0.79,1.01,+0.29,40.28,1532000,54,1355990,0,0,0,0,0,0,843000,679000,164000,164000
20200430,709699,凡甲元大9A購02,1.77,1.81,1.77,1.80,-0.03,-1.64,13000,3,23390,0,0,0,0,0,0,1000,12000,-11000,-11000
20200430,709700,安勤元大99購01,0.84,0.96,0.84,0.93,+0.10,12.05,546000,20,486610,0,0,0,0,0,0,36000,508000,-472000,-472000
20200430,709701,宏捷科元大99購01,2.55,2.55,2.27,2.27,-0.13,-5.42,131000,15,323580,0,0,0,0,0,0,91000,55000,36000,36000
20200430,709702,宜鼎元大9A購01,1.03,1.08,1.01,1.07,+0.10,10.31,925000,39,966200,0,0,0,0,0,0,846000,233000,613000,613000
20200430,709703,直得元大99購01,2.03,2.44,1.90,2.28,+0.33,16.92,1108000,89,2459420,0,0,0,0,0,0,475000,706000,-231000,-231000
20200430,709704,南光元大99購01,1.53,1.53,1.50,1.52,+0.04,2.7,596000,17,901120,0,0,0,0,0,0,112000,473000,-361000,-361000
20200430,709705,原相元大99購03,0.80,0.80,0.80,0.80,-0.02,-2.44,11000,2,8800,0,0,0,0,0,0,0,0,0,0
20200430,709706,新鉅科元大99購01,0.61,0.61,0.61,0.61,0.00,0.0,1000,1,610,0,0,0,0,0,0,0,1000,-1000,-1000
20200430,709707,穩懋元大99購02,2.00,2.16,2.00,2.12,+0.26,13.98,48000,10,100790,0,0,0,0,0,0,15000,36000,-21000,-21000
20200430,709708,晟德元大99購01,1.44,1.49,1.44,1.49,-0.01,-0.67,222000,5,327580,0,0,0,0,0,0,220000,2000,218000,218000
20200430,709709,大宇資國票9A購01,,,,,,0.00,0,0,0,0,0,0,0,0,0,0,0,0,0
20200430,709710,宏捷科國票9A購01,,,,,,0.00,0,0,0,0,0,0,0,0,0,0,0,0,0
20200430,709711,穩懋國泰9A購01,2.44,2.47,2.35,2.37,+0.16,7.24,378000,22,906160,0,0,0,0,0,0,331000,47000,284000,284000
20200430,709712,穩懋國泰9B購01,,,,,,0.00,0,0,0,0,0,0,0,0,0,0,0,0,0
20200430,709713,亞泰元富99購01,1.42,1.42,1.42,1.42,0.00,0.0,10000,1,14200,0,0,0,0,0,0,10000,0,10000,10000
20200430,709714,合晶統一9A購02,1.09,1.18,1.08,1.18,+0.10,9.26,987000,22,1117380,0,0,0,0,0,0,172000,824000,-652000,-652000
20200430,709715,宏捷科統一9A購01,0.81,0.81,0.75,0.75,-0.03,-3.85,59000,8,45660,0,0,0,0,0,0,32000,27000,5000,5000
20200430,709716,泰博統一9A購01,,,,,,0.00,0,0,0,0,0,0,0,0,0,0,0,0,0
20200430,709717,神盾統一9A購01,0.56,0.56,0.51,0.54,0.00,0.0,85000,7,45210,0,0,0,0,0,0,40000,45000,-5000,-5000
20200430,709718,雙鴻統一9A購01,1.07,1.07,1.01,1.02,+0.02,2.0,114000,11,119110,0,0,0,0,0,0,89000,25000,64000,64000
20200430,709719,宏捷科日盛99購01,1.44,1.44,1.41,1.41,-0.06,-4.08,60000,36,85880,0,0,0,0,0,0,60000,0,60000,60000
20200430,709720,VHQ凱基9A購01,1.51,1.51,1.45,1.45,-0.01,-0.68,105000,15,156820,0,0,0,0,0,0,103000,0,103000,103000
20200430,709721,三貝德凱基9A購01,0.41,0.41,0.41,0.41,0.00,0.0,100000,3,41000,0,0,0,0,0,0,90000,10000,80000,80000
20200430,709722,太景*凱基99購01,0.19,0.19,0.19,0.19,+0.03,18.75,10000,1,1900,0,0,0,0,0,0,0,10000,-10000,-10000
20200430,709723,宏捷科凱基99購01,,,,,,0.00,0,0,0,0,0,0,0,0,0,0,0,0,0
20200430,709724,晶焱凱基99購01,,,,,,0.00,0,0,0,0,0,0,0,0,0,0,0,0,0
20200430,709725,大學光永豐99購01,2.89,2.89,2.80,2.80,-0.14,-4.76,37000,3,104680,0,0,0,0,0,0,12000,25000,-13000,-13000
20200430,709726,宏捷科永豐99購01,2.44,2.44,2.44,2.44,-0.09,-3.56,9000,1,21960,0,0,0,0,0,0,9000,0,9000,9000
20200430,709727,信驊永豐99購01,1.83,1.96,1.81,1.96,+0.34,20.99,73000,6,137390,0,0,0,0,0,0,30000,43000,-13000,-13000
20200430,709728,威剛永豐99購02,1.53,1.53,1.53,1.53,+0.07,4.79,10000,1,15300,0,0,0,0,0,0,0,10000,-10000,-10000
20200430,709729,環球晶永豐99購01,,,,,,0.00,0,0,0,0,0,0,0,0,0,0,0,0,0
20200430,709730,宏捷科康和99購01,1.11,1.11,1.07,1.07,-0.06,-5.31,40000,2,43600,0,0,0,0,0,0,20000,20000,0,0
20200430,709731,宏捷科群益99購01,1.43,1.43,1.27,1.27,-0.05,-3.79,238000,6,323470,0,0,0,0,0,0,125000,113000,12000,12000
20200430,709732,宏捷科元富99購01,1.41,1.44,1.31,1.31,-0.05,-3.68,763000,70,1047650,0,0,0,0,0,0,455000,287000,168000,168000
20200430,709733,智擎元富99購01,1.08,1.09,1.08,1.09,-0.06,-5.22,17000,3,18430,0,0,0,0,0,0,0,17000,-17000,-17000
20200430,709734,中美晶統一9B購02,0.71,0.73,0.71,0.73,+0.01,1.39,255000,3,184150,0,0,0,0,0,0,0,255000,-255000,-255000
20200430,709735,宏捷科統一9B購01,0.97,0.97,0.90,0.90,-0.02,-2.17,68000,9,63970,0,0,0,0,0,0,30000,38000,-8000,-8000
20200430,709736,宏捷科凱基9B購01,1.56,1.56,1.53,1.53,-0.08,-4.97,12000,2,18690,0,0,0,0,0,0,12000,0,12000,12000
20200430,709737,威剛凱基9B購01,0.64,0.64,0.63,0.63,0.00,0.0,58000,3,36590,0,0,0,0,0,0,53000,5000,48000,48000
20200430,709738,建榮凱基9A購02,1.35,1.40,1.35,1.40,+0.21,17.65,4000,2,5500,0,0,0,0,0,0,0,4000,-4000,-4000
20200430,709739,神盾凱基9A購01,1.07,1.07,1.05,1.06,+0.07,7.07,60000,3,63500,0,0,0,0,0,0,60000,0,60000,60000
20200430,709740,新鉅科凱基99購01,0.44,0.44,0.43,0.43,+0.01,2.38,299000,3,129570,0,0,0,0,0,0,0,299000,-299000,-299000
20200430,709741,聚積凱基9A購01,0.70,0.70,0.70,0.70,0.00,0.0,6000,1,4200,0,0,0,0,0,0,0,6000,-6000,-6000
20200430,709742,久元元大99購01,1.20,1.20,1.16,1.18,+0.01,0.85,180000,8,211800,0,0,0,0,0,0,160000,20000,140000,140000
20200430,709743,久元元大99購02,1.13,1.13,1.10,1.13,+0.02,1.8,309000,8,348520,0,0,0,0,0,0,274000,35000,239000,239000
20200430,709744,光頡元大99購01,1.93,2.13,1.93,2.13,+0.38,21.71,267000,19,547940,0,0,0,0,0,0,111000,156000,-45000,-45000
20200430,709745,合晶元大99購02,1.05,1.15,1.05,1.14,+0.17,17.53,291000,9,316050,0,0,0,0,0,0,60000,211000,-151000,-151000
20200430,709746,宏捷科元大99購03,3.12,3.13,2.80,2.80,-0.12,-4.11,145000,22,438070,0,0,0,0,0,0,109000,51000,58000,58000
20200430,709747,迅得元大9B購01,0.72,0.72,0.68,0.70,+0.01,1.45,119000,7,83780,0,0,0,0,0,0,97000,22000,75000,75000
20200430,709748,勝麗元大99購01,1.46,1.69,1.44,1.68,+0.28,20.0,267000,19,425200,0,0,0,0,0,0,26000,241000,-215000,-215000
20200430,709749,宏捷科群益99購02,0.76,0.76,0.68,0.68,-0.03,-4.23,472000,23,336950,0,0,0,0,0,0,254000,218000,36000,36000
20200430,709750,信昌電群益99購01,2.41,2.59,2.39,2.44,+0.20,8.93,226000,24,549490,0,0,0,0,0,0,123000,51000,72000,72000
20200430,709751,安勤國票99購01,2.45,2.76,2.45,2.76,+0.17,6.56,80000,4,209440,0,0,0,0,0,0,76000,4000,72000,72000
20200430,709752,中美晶富邦9B購01,0.26,0.27,0.25,0.27,+0.01,3.85,140000,6,36300,0,0,0,0,0,0,40000,100000,-60000,-60000
20200430,709753,宏捷科富邦9B購01,0.72,0.72,0.68,0.68,-0.08,-10.53,31000,3,21120,0,0,0,0,0,0,31000,0,31000,31000
20200430,709754,穩懋富邦9B購01,1.25,1.25,1.19,1.20,+0.09,8.11,514000,65,635430,0,0,0,0,0,0,504000,17000,487000,487000
20200430,709755,力致永豐99購02,2.69,2.87,2.58,2.79,+0.32,12.96,544000,22,1512220,0,0,0,0,0,0,491000,57000,434000,434000
20200430,709756,大學光永豐99購02,2.02,2.02,2.02,2.02,-0.09,-4.27,20000,1,40400,0,0,0,0,0,0,20000,0,20000,20000
20200430,709757,宏捷科永豐99購02,2.10,2.10,1.99,1.99,-0.20,-9.13,47000,4,98590,0,0,0,0,0,0,46000,1000,45000,45000
20200430,709758,精華永豐99購01,0.19,0.25,0.19,0.25,+0.08,47.06,19000,3,4310,0,0,0,0,0,0,14000,5000,9000,9000
20200430,709759,鈺太永豐99購01,1.29,1.32,1.29,1.30,+0.01,0.78,211000,8,273520,0,0,0,0,0,0,175000,61000,114000,114000
20200430,709760,合晶凱基9A購01,1.66,1.82,1.64,1.82,+0.23,14.47,158000,20,273660,0,0,0,0,0,0,53000,109000,-56000,-56000
20200430,709761,雙鴻凱基9A購01,1.88,1.88,1.84,1.84,+0.06,3.37,61000,4,114360,0,0,0,0,0,0,28000,33000,-5000,-5000
20200430,709762,宏捷科統一9B購02,1.33,1.41,1.25,1.26,-0.04,-3.08,565000,11,717660,0,0,0,0,0,0,516000,49000,467000,467000
20200430,709763,宣德統一99購01,,,,,,0.00,0,0,0,0,0,0,0,0,0,0,0,0,0
20200430,709764,建榮統一9B購01,,,,,,0.00,0,0,0,0,0,0,0,0,0,0,0,0,0
20200430,709765,海韻電永豐99購01,1.15,1.16,1.15,1.16,-0.03,-2.52,80000,2,92500,0,0,0,0,0,0,80000,30000,50000,50000
20200430,709766,優群永豐99購01,,,,,,0.00,0,0,0,0,0,0,0,0,0,0,0,0,0
20200430,709767,穩懋永豐9A購01,2.19,2.19,2.16,2.16,+0.16,8.0,68000,6,147820,0,0,0,0,0,0,68000,5000,63000,63000
20200430,709768,海韻電元富99購01,1.47,1.51,1.44,1.48,0.00,0.0,1239000,26,1801640,0,0,0,0,0,0,1198000,0,1198000,1198000
20200430,709769,宏捷科國票99購02,3.42,3.42,3.01,3.01,-0.15,-4.75,71000,4,227320,0,0,0,0,0,0,71000,0,71000,71000
20200430,709770,威剛國票9A購01,1.25,1.25,1.25,1.25,+0.05,4.17,3000,2,3750,0,0,0,0,0,0,3000,3000,0,0
20200430,709771,宏捷科元大99購04,2.00,2.00,2.00,2.00,-0.07,-3.38,10000,1,20000,0,0,0,0,0,0,10000,0,10000,10000
20200430,709772,穩懋元大99購03,2.98,2.98,2.80,2.87,+0.22,8.3,57000,9,164860,0,0,0,0,0,0,34000,25000,9000,9000
20200430,709773,宏捷科國泰9A購01,,,,,,0.00,0,0,0,0,0,0,0,0,0,0,0,0,0
20200430,709774,海韻電國泰9B購01,1.80,1.81,1.74,1.77,+0.01,0.57,761000,24,1350260,0,0,0,0,0,0,581000,380000,201000,201000
20200430,709775,原相富邦9B購01,,,,,,0.00,0,0,0,0,0,0,0,0,0,0,0,0,0
20200430,709776,環球晶富邦9B購02,0.45,0.46,0.45,0.46,+0.03,6.98,147000,4,67020,0,0,0,0,0,0,97000,0,97000,97000
20200430,709777,神盾群益9B購01,1.04,1.04,0.99,1.00,+0.01,1.01,278000,7,277520,0,0,0,0,0,0,248000,0,248000,248000
20200430,709778,波若威永豐99購02,,,,,,0.00,0,0,0,0,0,0,0,0,0,0,0,0,0
20200430,709779,信昌電永豐99購01,0.99,1.13,0.97,1.00,+0.12,13.64,250000,34,264660,0,0,0,0,0,0,96000,156000,-60000,-60000
20200430,709780,晶焱永豐99購01,,,,,,0.00,0,0,0,0,0,0,0,0,0,0,0,0,0
20200430,709781,緯軟永豐99購01,0.77,0.83,0.72,0.74,+0.14,23.33,235000,24,175650,0,0,0,0,0,0,0,235000,-235000,-235000
20200430,709782,雙鴻永豐99購02,0.92,0.96,0.92,0.96,+0.05,5.49,55000,3,52270,0,0,0,0,0,0,12000,43000,-31000,-31000
20200430,709783,宏捷科元富9C購01,1.25,1.25,1.23,1.23,+0.03,2.5,32000,3,39690,0,0,0,0,0,0,32000,0,32000,32000
20200430,709784,閎康中信99購01,1.57,1.58,1.47,1.49,-0.01,-0.67,628000,26,945580,0,0,0,0,0,0,455000,184000,271000,271000
20200430,709785,合晶凱基9A購02,,,,,,0.00,0,0,0,0,0,0,0,0,0,0,0,0,0
20200430,709786,金居凱基99購01,2.40,2.66,2.33,2.66,+0.55,26.07,298000,26,707550,0,0,0,0,0,0,276000,20000,256000,256000
20200430,709787,金居凱基9A購01,0.89,0.92,0.89,0.92,+0.21,29.58,10000,3,8930,0,0,0,0,0,0,10000,0,10000,10000
20200430,709788,泰博凱基9A購01,,,,,,0.00,0,0,0,0,0,0,0,0,0,0,0,0,0
20200430,709789,神盾凱基99購02,1.02,1.14,1.02,1.14,+0.07,6.54,14000,3,15570,0,0,0,0,0,0,3000,11000,-8000,-8000
20200430,709790,網龍凱基9A購01,1.72,1.72,1.72,1.72,-0.12,-6.52,10000,1,17200,0,0,0,0,0,0,10000,10000,0,0
20200430,709791,雙鴻凱基99購01,3.10,3.11,3.03,3.03,+0.08,2.71,209000,18,636340,0,0,0,0,0,0,41000,196000,-155000,-155000
20200430,709792,穩懋凱基99購03,2.15,2.17,2.10,2.10,+0.15,7.69,170000,20,364000,0,0,0,0,0,0,145000,25000,120000,120000
20200430,709793,威剛統一9B購01,,,,,,0.00,0,0,0,0,0,0,0,0,0,0,0,0,0
20200430,709794,原相統一9B購01,0.74,0.75,0.73,0.74,-0.01,-1.33,293000,14,217100,0,0,0,0,0,0,173000,120000,53000,53000
20200430,709795,穩懋統一9B購01,,,,,,0.00,0,0,0,0,0,0,0,0,0,0,0,0,0
20200430,709796,三貝德國票9A購01,0.36,0.36,0.34,0.35,0.00,0.0,120000,3,41150,0,0,0,0,0,0,100000,20000,80000,80000
20200430,709797,群聯國票9A購01,0.43,0.44,0.35,0.35,0.00,0.0,26000,8,10790,0,0,0,0,0,0,0,17000,-17000,-17000
20200430,709798,優群國票9A購01,,,,,,0.00,0,0,0,0,0,0,0,0,0,0,0,0,0
20200430,709799,鈺太國泰9C購01,1.38,1.40,1.33,1.35,-0.03,-2.17,233000,26,318920,0,0,0,0,0,0,233000,0,233000,233000
20200430,709800,建榮富邦9B購01,,,,,,0.00,0,0,0,0,0,0,0,0,0,0,0,0,0
20200430,709801,凡甲兆豐99購01,2.22,2.22,2.18,2.18,-0.08,-3.54,7000,2,15460,0,0,0,0,0,0,7000,0,7000,7000
20200430,709802,中美晶兆豐9A購01,0.54,0.54,0.53,0.53,+0.04,8.16,71000,6,38030,0,0,0,0,0,0,1000,70000,-69000,-69000
20200430,709803,穩懋兆豐99購02,1.30,1.30,1.30,1.30,+0.25,23.81,7000,1,9100,0,0,0,0,0,0,0,7000,-7000,-7000
20200430,709804,譜瑞兆豐99購01,1.70,1.74,1.68,1.74,+0.10,6.1,81000,11,139360,0,0,0,0,0,0,57000,24000,33000,33000
20200430,709805,VHQ群益9B購01,0.64,0.65,0.63,0.63,0.00,0.0,399000,4,253340,0,0,0,0,0,0,299000,100000,199000,199000
20200430,709806,建榮群益9B購01,1.01,1.06,0.95,1.06,+0.27,34.18,356000,9,348810,0,0,0,0,0,0,200000,356000,-156000,-156000
20200430,709807,博智群益99購01,3.44,3.66,3.44,3.53,+0.17,5.06,47000,9,168060,0,0,0,0,0,0,34000,32000,2000,2000
20200430,709808,聚積群益99購01,0.62,0.62,0.62,0.62,0.00,0.0,11000,2,6820,0,0,0,0,0,0,7000,4000,3000,3000
20200430,709809,力致元大9A購01,2.04,2.15,1.96,2.11,+0.24,12.83,1776000,52,3721240,0,0,0,0,0,0,1242000,549000,693000,693000
20200430,709810,大宇資元大99購01,0.36,0.36,0.36,0.36,0.00,0.0,260000,2,93600,0,0,0,0,0,0,0,260000,-260000,-260000
20200430,709811,大江元大99購03,3.83,3.83,3.50,3.50,+0.02,0.57,42000,7,159030,0,0,0,0,0,0,40000,3000,37000,37000
20200430,709812,光頡元大99購02,1.86,2.07,1.85,1.85,+0.14,8.19,559000,31,1114920,0,0,0,0,0,0,215000,344000,-129000,-129000
20200430,709813,迅得元大99購02,2.03,2.03,1.87,1.98,+0.02,1.02,536000,24,1042230,0,0,0,0,0,0,200000,328000,-128000,-128000
20200430,709814,建榮元大99購01,2.24,2.24,2.24,2.24,+0.38,20.43,20000,1,44800,0,0,0,0,0,0,0,20000,-20000,-20000
20200430,709815,網龍元大9A購01,1.45,1.46,1.38,1.38,-0.11,-7.38,496000,31,701580,0,0,0,0,0,0,484000,12000,472000,472000
20200430,709816,環宇元大99購01,,,,,,0.00,0,0,0,0,0,0,0,0,0,0,0,0,0
20200430,709817,網家群益99購01,1.61,1.69,1.58,1.62,-0.09,-5.26,929000,41,1527680,0,0,0,0,0,0,383000,546000,-163000,-163000
20200430,709818,安勤永豐9A購01,0.59,0.65,0.59,0.65,+0.05,8.33,362000,8,225150,0,0,0,0,0,0,50000,312000,-262000,-262000
20200430,709819,宏捷科永豐99購03,1.35,1.35,1.28,1.28,-0.13,-9.22,130000,4,170930,0,0,0,0,0,0,129000,1000,128000,128000
20200430,709820,迅得永豐99購01,0.89,0.92,0.89,0.92,+0.01,1.1,65000,5,59300,0,0,0,0,0,0,35000,30000,5000,5000
20200430,709821,宣德永豐99購01,1.43,1.56,1.42,1.54,+0.10,6.94,184000,16,272100,0,0,0,0,0,0,79000,105000,-26000,-26000
20200430,709822,原相永豐9A購01,,,,,,0.00,0,0,0,0,0,0,0,0,0,0,0,0,0
20200430,709823,博智永豐9A購01,0.66,0.74,0.66,0.69,+0.04,6.15,643000,16,453160,0,0,0,0,0,0,142000,496000,-354000,-354000
20200430,709824,新普永豐99購01,2.32,2.36,2.30,2.36,+0.09,3.96,69000,7,160360,0,0,0,0,0,0,40000,29000,11000,11000
20200430,709825,聖暉永豐99購01,1.47,1.52,1.47,1.51,+0.08,5.59,211000,14,317380,0,0,0,0,0,0,133000,78000,55000,55000
20200430,709826,優群永豐9A購01,1.73,1.73,1.60,1.62,-0.12,-6.9,271000,29,446200,0,0,0,0,0,0,39000,211000,-172000,-172000
20200430,709827,穩懋永豐99購01,2.82,2.82,2.82,2.82,+0.23,8.88,9000,1,25380,0,0,0,0,0,0,9000,0,9000,9000
20200430,709828,信驊國票9A購01,7.55,7.75,7.55,7.60,+0.75,10.95,20000,4,152100,0,0,0,0,0,0,6000,14000,-8000,-8000
20200430,709829,聖暉國票9A購01,8.45,8.70,8.45,8.70,+0.45,5.45,29000,6,249800,0,0,0,0,0,0,8000,21000,-13000,-13000
20200430,709830,信驊國泰9B購01,2.49,2.56,2.45,2.54,+0.21,9.01,355000,32,896540,0,0,0,0,0,0,159000,176000,-17000,-17000
20200430,709831,原相富邦9C購01,0.30,0.31,0.30,0.31,0.00,0.0,17000,3,5170,0,0,0,0,0,0,10000,0,10000,10000
20200430,709832,宏捷科元富9C購02,1.84,1.84,1.72,1.72,-0.18,-9.47,201000,10,351140,0,0,0,0,0,0,49000,163000,-114000,-114000
20200430,709833,聖暉元富99購01,2.54,2.63,2.47,2.58,+0.17,7.05,954000,46,2412060,0,0,0,0,0,0,660000,294000,366000,366000
20200430,709834,建榮統一9B購02,,,,,,0.00,0,0,0,0,0,0,0,0,0,0,0,0,0
20200430,709835,台半元大99購01,1.07,1.09,1.03,1.03,-0.04,-3.74,207000,16,221580,0,0,0,0,0,0,101000,106000,-5000,-5000
20200430,709836,金居元大99購03,1.72,1.86,1.63,1.86,+0.43,30.07,1154000,74,1986220,0,0,0,0,0,0,545000,609000,-64000,-64000
20200430,709837,博智元大99購02,1.60,1.60,1.60,1.60,+0.24,17.65,1000,1,1600,0,0,0,0,0,0,0,1000,-1000,-1000
20200430,709838,網龍元大9A購02,1.29,1.31,1.24,1.24,-0.06,-4.62,564000,26,714940,0,0,0,0,0,0,520000,44000,476000,476000
20200430,709839,力旺凱基99購01,0.81,0.81,0.81,0.81,+0.09,12.5,10000,1,8100,0,0,0,0,0,0,0,10000,-10000,-10000
20200430,709840,合晶凱基9A購03,1.24,1.39,1.24,1.39,+0.18,14.88,275000,13,362900,0,0,0,0,0,0,49000,226000,-177000,-177000
20200430,709841,聯亞凱基9A購01,2.41,2.41,2.14,2.20,-0.17,-7.17,306000,34,703910,0,0,0,0,0,0,296000,0,296000,296000
20200430,709842,譜瑞凱基9A購02,,,,,,0.00,0,0,0,0,0,0,0,0,0,0,0,0,0
20200430,709843,雙鴻中信9B購01,0.64,0.64,0.60,0.60,0.00,0.0,30000,2,18400,0,0,0,0,0,0,30000,0,30000,30000
20200430,709844,宏捷科凱基9A購01,1.97,1.97,1.85,1.87,-0.03,-1.58,62000,8,117370,0,0,0,0,0,0,13000,49000,-36000,-36000
20200430,709845,金可凱基9A購01,0.62,0.72,0.62,0.70,+0.25,55.56,32000,5,22200,0,0,0,0,0,0,0,27000,-27000,-27000
20200430,709846,凡甲元大99購01,,,,,,0.00,0,0,0,0,0,0,0,0,0,0,0,0,0
20200430,709847,宇峻元大9C購01,0.67,0.67,0.64,0.64,-0.05,-7.25,428000,15,279700,0,0,0,0,0,0,387000,41000,346000,346000
20200430,709848,金可元大99購01,0.64,0.89,0.64,0.89,+0.29,48.33,200000,20,156100,0,0,0,0,0,0,20000,170000,-150000,-150000
20200430,709849,保瑞元大9A購01,1.04,1.04,1.04,1.04,+0.04,4.0,88000,2,91520,0,0,0,0,0,0,88000,0,88000,88000
20200430,709850,建榮元大99購02,,,,,,0.00,0,0,0,0,0,0,0,0,0,0,0,0,0
20200430,709851,晶焱元大9A購01,0.77,0.79,0.77,0.79,+0.04,5.33,175000,6,136110,0,0,0,0,0,0,75000,175000,-100000,-100000
20200430,709852,群聯元大99購04,,,,,,0.00,0,0,0,0,0,0,0,0,0,0,0,0,0
20200430,709853,大江國票9A購01,1.58,1.58,1.45,1.45,0.00,0.0,153000,12,234840,0,0,0,0,0,0,89000,64000,25000,25000
20200430,709854,穩懋國票99購02,3.05,3.09,2.70,2.70,+0.29,12.03,68000,5,200160,0,0,0,0,0,0,68000,0,68000,68000
20200430,709855,穩懋富邦9B購02,0.88,0.88,0.85,0.85,+0.05,6.25,379000,33,327370,0,0,0,0,0,0,267000,210000,57000,57000
20200430,709856,晶焱兆豐9A購01,0.79,0.82,0.78,0.82,+0.03,3.8,298000,13,238500,0,0,0,0,0,0,178000,120000,58000,58000
20200430,709857,環球晶兆豐99購01,,,,,,0.00,0,0,0,0,0,0,0,0,0,0,0,0,0
20200430,709858,穩懋兆豐9A購01,1.16,1.16,1.16,1.16,+0.16,16.0,20000,1,23200,0,0,0,0,0,0,0,20000,-20000,-20000
20200430,709859,安勤群益99購01,0.88,0.99,0.87,0.95,+0.06,6.74,235000,14,215430,0,0,0,0,0,0,36000,199000,-163000,-163000
20200430,709860,新鉅科群益9A購01,,,,,,0.00,0,0,0,0,0,0,0,0,0,0,0,0,0
20200430,709861,環球晶群益99購01,2.41,2.70,2.41,2.70,+0.34,14.41,111000,24,288680,0,0,0,0,0,0,21000,111000,-90000,-90000
20200430,709862,碩禾永豐99購01,,,,,,0.00,0,0,0,0,0,0,0,0,0,0,0,0,0
20200430,709863,網龍永豐9A購01,0.96,0.98,0.90,0.92,-0.09,-8.91,119000,14,112460,0,0,0,0,0,0,78000,61000,17000,17000
20200430,709864,璟德元富99購01,2.44,2.58,2.39,2.52,+0.08,3.28,410000,27,1033760,0,0,0,0,0,0,80000,330000,-250000,-250000
20200430,709865,鈺太元富99購01,2.30,2.42,2.26,2.32,-0.01,-0.43,442000,53,1026110,0,0,0,0,0,0,400000,32000,368000,368000
20200430,709866,凡甲永豐9A購01,1.40,1.43,1.39,1.39,-0.01,-0.71,65000,5,91560,0,0,0,0,0,0,65000,9000,56000,56000
20200430,709867,兆利永豐99購01,0.84,0.84,0.83,0.83,+0.01,1.22,118000,3,98220,0,0,0,0,0,0,118000,0,118000,118000
20200430,709868,欣銓永豐99購01,0.58,0.63,0.58,0.63,+0.06,10.53,329000,9,200270,0,0,0,0,0,0,135000,194000,-59000,-59000
20200430,709869,信驊永豐99購02,0.72,0.78,0.72,0.77,+0.08,11.59,142000,10,107840,0,0,0,0,0,0,49000,88000,-39000,-39000
20200430,709870,群聯永豐99購01,,,,,,0.00,0,0,0,0,0,0,0,0,0,0,0,0,0
20200430,709871,聚積永豐99購01,0.66,0.66,0.66,0.66,+0.02,3.12,17000,3,11220,0,0,0,0,0,0,0,17000,-17000,-17000
20200430,709872,環球晶永豐99購02,1.04,1.25,1.04,1.25,+0.26,26.26,881000,34,1023320,0,0,0,0,0,0,56000,836000,-780000,-780000
20200430,709873,東洋統一9B購01,1.69,1.73,1.69,1.73,+0.09,5.49,159000,7,271150,0,0,0,0,0,0,5000,154000,-149000,-149000
20200430,709874,建榮凱基9A購03,1.74,1.74,1.74,1.74,+0.27,18.37,50000,1,87000,0,0,0,0,0,0,50000,0,50000,50000
20200430,709875,大中國票9A購01,1.65,1.65,1.58,1.65,+0.07,4.43,333000,10,545930,0,0,0,0,0,0,333000,0,333000,333000
20200430,709876,台燿國票9A購01,4.91,4.91,4.91,4.91,+1.00,25.58,4000,1,19640,0,0,0,0,0,0,4000,0,4000,4000
20200430,709877,泰博國泰9A購01,2.50,2.54,2.38,2.46,+0.01,0.41,81000,9,198520,0,0,0,0,0,0,60000,26000,34000,34000
20200430,709878,大江元大99購04,1.63,1.63,1.50,1.50,-0.03,-1.96,297000,12,462120,0,0,0,0,0,0,258000,39000,219000,219000
20200430,709879,安勤元大99購02,0.65,0.74,0.63,0.72,+0.06,9.09,1436000,28,999300,0,0,0,0,0,0,731000,350000,381000,381000
20200430,709880,宏捷科元大99購06,,,,,,0.00,0,0,0,0,0,0,0,0,0,0,0,0,0
20200430,709881,聖暉元大99購01,2.17,2.25,2.14,2.21,+0.13,6.25,505000,34,1103150,0,0,0,0,0,0,283000,217000,66000,66000
20200430,709882,優群元大99購03,1.86,1.86,1.82,1.82,-0.11,-5.7,162000,19,299520,0,8000,-8000,0,0,0,55000,107000,-52000,-60000
20200430,709883,優群元大9B購01,2.17,2.17,2.04,2.05,-0.12,-5.53,65000,6,133910,0,0,0,0,0,0,8000,57000,-49000,-49000
20200430,709884,穩懋元大99購05,3.15,3.15,3.01,3.03,+0.23,8.21,45000,14,139670,0,0,0,0,0,0,37000,22000,15000,15000
20200430,709885,信驊兆豐99購01,1.25,1.25,1.24,1.24,+0.10,8.77,62000,3,77400,0,0,0,0,0,0,10000,52000,-42000,-42000
20200430,709886,中美晶群益9A購01,1.00,1.01,0.99,0.99,+0.10,11.24,46000,10,46370,0,0,0,0,0,0,10000,46000,-36000,-36000
20200430,709887,神盾群益9B購02,2.70,2.70,2.58,2.58,+0.04,1.57,115000,4,302200,0,0,0,0,0,0,49000,66000,-17000,-17000
20200430,709888,聯亞群益99購01,1.95,1.95,1.68,1.77,-0.15,-7.81,2349000,36,4226290,0,0,0,0,0,0,412000,1937000,-1525000,-1525000
20200430,709889,台燿元富9C購01,3.18,3.29,3.07,3.25,+0.41,14.44,381000,21,1203250,8000,0,8000,0,0,0,207000,174000,33000,41000
20200430,709890,原相統一9A購01,1.28,1.28,1.28,1.28,-0.06,-4.48,19000,1,24320,0,0,0,0,0,0,19000,0,19000,19000
20200430,709891,大宇資凱基9B購01,0.59,0.59,0.59,0.59,-0.01,-1.67,16000,2,9440,0,0,0,0,0,0,16000,0,16000,16000
20200430,709892,宇峻凱基9B購01,1.02,1.02,0.98,0.99,-0.06,-5.71,283000,18,283770,0,0,0,0,0,0,271000,12000,259000,259000
20200430,709893,信驊凱基9A購01,,,,,,0.00,0,0,0,0,0,0,0,0,0,0,0,0,0
20200430,709894,統新凱基9B購01,1.48,1.50,1.38,1.38,-0.01,-0.72,92000,8,133550,0,0,0,0,0,0,55000,37000,18000,18000
20200430,709895,順達凱基99購01,1.87,1.87,1.83,1.83,-0.07,-3.68,144000,7,264420,0,0,0,0,0,0,144000,0,144000,144000
20200430,709896,雙美凱基9B購01,0.98,1.00,0.97,0.98,+0.04,4.26,615000,14,601670,0,0,0,0,0,0,385000,295000,90000,90000
20200430,709897,雙鴻元大99購06,1.82,1.82,1.82,1.82,+0.10,5.81,33000,1,60060,0,0,0,0,0,0,0,33000,-33000,-33000
20200430,709898,穩懋元大99購06,3.61,3.63,3.48,3.48,+0.27,8.41,66000,17,235120,0,0,0,0,0,0,56000,24000,32000,32000
20200430,709899,穩懋元大99購07,1.62,1.63,1.53,1.56,+0.10,6.85,185000,24,292620,0,0,0,0,0,0,100000,84000,16000,16000
20200430,709900,力致永豐99購03,3.16,3.20,3.11,3.11,+0.34,12.27,610000,24,1930760,0,0,0,0,0,0,569000,10000,559000,559000
20200430,709901,光頡永豐99購01,1.12,1.24,1.08,1.08,+0.12,12.5,345000,19,408190,0,0,0,0,0,0,45000,300000,-255000,-255000
20200430,709902,新鉅科永豐99購01,0.69,0.69,0.65,0.65,-0.08,-10.96,80000,8,52700,0,0,0,0,0,0,60000,20000,40000,40000
20200430,709903,精測永豐9A購01,,,,,,0.00,0,0,0,0,0,0,0,0,0,0,0,0,0
20200430,709904,璟德永豐99購01,1.30,1.44,1.29,1.36,-0.01,-0.73,254000,22,342630,0,0,0,0,0,0,127000,127000,0,0
20200430,709905,環球晶永豐99購03,2.02,2.12,1.99,2.12,+0.18,9.28,43000,4,87890,0,0,0,0,0,0,32000,11000,21000,21000
20200430,709906,兆利國票99購01,2.63,2.63,2.55,2.55,+0.13,5.37,18000,3,47040,0,0,0,0,0,0,15000,3000,12000,12000
20200430,709907,金居國票9A購01,2.81,3.22,2.73,3.21,+0.77,31.56,116000,10,343180,0,0,0,0,0,0,54000,62000,-8000,-8000
20200430,709908,信驊國票9A購02,,,,,,0.00,0,0,0,0,0,0,0,0,0,0,0,0,0
20200430,709909,兆利國泰9A購01,,,,,,0.00,0,0,0,0,0,0,0,0,0,0,0,0,0
20200430,709910,宏捷科國泰9B購01,1.35,1.35,1.23,1.24,-0.04,-3.12,379000,35,493320,0,0,0,0,0,0,276000,116000,160000,160000
20200430,709911,精測國泰9C購01,0.85,0.85,0.85,0.85,+0.06,7.59,15000,1,12750,0,0,0,0,0,0,15000,0,15000,15000
20200430,709912,威剛富邦9C購01,0.23,0.23,0.23,0.23,+0.11,91.67,9000,2,2070,0,0,0,0,0,0,0,9000,-9000,-9000
20200430,709913,M31群益99購01,0.69,0.70,0.69,0.70,+0.06,9.38,662000,22,460550,0,0,0,0,0,0,0,662000,-662000,-662000
20200430,709914,中美晶群益9B購01,1.05,1.11,1.05,1.08,+0.07,6.93,219000,8,230720,0,0,0,0,0,0,6000,219000,-213000,-213000
20200430,709915,台燿群益99購02,1.70,1.93,1.70,1.93,+0.32,19.88,835000,33,1525150,0,0,0,0,0,0,563000,266000,297000,297000
20200430,709916,合晶群益9A購01,1.19,1.31,1.19,1.31,+0.16,13.91,479000,18,603500,0,0,0,0,0,0,45000,436000,-391000,-391000
20200430,709917,緯軟群益9A購01,1.44,1.53,1.44,1.53,+0.30,24.39,26000,3,38490,0,0,0,0,0,0,0,26000,-26000,-26000
20200430,709918,璟德群益99購01,2.50,2.59,2.49,2.59,+0.16,6.58,138000,9,348910,0,0,0,0,0,0,58000,80000,-22000,-22000
20200430,709919,環球晶群益99購02,2.47,2.76,2.47,2.76,+0.36,15.0,142000,21,368640,0,0,0,0,0,0,23000,142000,-119000,-119000
20200430,709920,原相日盛9B購01,0.61,0.61,0.61,0.61,0.00,0.0,10000,1,6100,0,0,0,0,0,0,10000,0,10000,10000
20200430,709921,雍智國泰9C購01,0.95,1.05,0.95,1.03,+0.10,10.75,1198000,51,1206210,0,0,0,0,0,0,77000,1119000,-1042000,-1042000
20200430,709922,璟德國泰9A購01,2.35,2.46,2.29,2.46,+0.15,6.49,98000,9,233000,0,0,0,0,0,0,53000,45000,8000,8000
20200430,709923,VHQ群益99購01,0.83,0.84,0.81,0.82,-0.05,-5.75,582000,10,478160,0,0,0,0,0,0,529000,53000,476000,476000
20200430,709924,中美晶群益99購03,0.64,0.68,0.64,0.66,+0.06,10.0,423000,18,279980,0,0,0,0,0,0,49000,378000,-329000,-329000
20200430,709925,精測群益99購01,1.71,1.75,1.68,1.68,+0.04,2.44,322000,15,551560,0,0,0,0,0,0,169000,177000,-8000,-8000
20200430,709926,精測富邦9A購01,0.25,0.26,0.25,0.26,+0.03,13.04,238000,12,61860,0,0,0,0,0,0,2000,181000,-179000,-179000
20200430,709927,聯亞國票9A購01,7.80,7.80,7.65,7.65,-0.05,-0.65,204000,7,1570000,0,0,0,0,0,0,204000,0,204000,204000
20200430,709928,穩懋國票99購03,,,,,,0.00,0,0,0,0,0,0,0,0,0,0,0,0,0
20200430,709929,大江永豐99購01,2.67,2.68,2.54,2.54,+0.03,1.2,71000,7,185800,0,0,0,0,0,0,32000,41000,-9000,-9000
20200430,709930,精測永豐99購01,,,,,,0.00,0,0,0,0,0,0,0,0,0,0,0,0,0
20200430,709931,建榮統一9B購03,1.13,1.16,1.09,1.09,+0.05,4.81,84000,5,95280,0,0,0,0,0,0,0,84000,-84000,-84000
20200430,709932,中美晶凱基99購07,1.44,1.55,1.44,1.51,+0.06,4.14,121000,16,177400,0,0,0,0,0,0,113000,26000,87000,87000
20200430,709933,碩禾凱基9B購01,0.48,0.48,0.47,0.47,-0.01,-2.08,20000,2,9500,0,0,0,0,0,0,0,20000,-20000,-20000
20200430,709934,精測元富99購02,1.31,1.34,1.27,1.27,+0.08,6.72,1956000,34,2522670,0,0,0,0,0,0,134000,1822000,-1688000,-1688000
20200430,709935,鈺太元富99購02,2.78,2.81,2.66,2.73,-0.01,-0.36,581000,70,1590860,0,0,0,0,0,0,552000,8000,544000,544000
20200430,709936,元太元大99購01,2.32,2.32,2.32,2.32,+0.01,0.43,2000,1,4640,0,0,0,0,0,0,0,0,0,0
20200430,709937,兆利元大9B購01,0.62,0.62,0.60,0.62,+0.04,6.9,203000,4,122810,0,0,0,0,0,0,203000,0,203000,203000
20200430,709938,宏捷科元大99購07,1.21,1.21,1.12,1.12,-0.04,-3.45,216000,18,249400,0,0,0,0,0,0,106000,90000,16000,16000
20200430,709939,良維元大99購01,3.58,3.58,3.47,3.58,+0.01,0.28,250000,18,882010,0,0,0,0,0,0,226000,24000,202000,202000
20200430,709940,信驊元大99購01,6.55,6.70,6.45,6.70,+0.50,8.06,80000,8,531000,0,0,0,0,0,0,30000,50000,-20000,-20000
20200430,709941,信驊元大99購02,3.64,3.78,3.64,3.74,+0.40,11.98,92000,5,340380,0,0,0,0,0,0,72000,20000,52000,52000
20200430,709942,威剛元大9A購02,,,,,,0.00,0,0,0,0,0,0,0,0,0,0,0,0,0
20200430,709943,泰博元大99購01,1.85,1.85,1.85,1.85,+0.06,3.35,3000,1,5550,0,0,0,0,0,0,3000,3000,0,0
20200430,709944,順達元大99購01,2.26,2.27,2.18,2.19,-0.01,-0.45,202000,19,447270,0,0,0,0,0,0,199000,33000,166000,166000
20200430,709945,群聯元大99購05,0.93,0.93,0.93,0.93,+0.13,16.25,1000,1,930,0,0,0,0,0,0,1000,0,1000,1000
20200430,709946,精華元大99購01,0.90,1.11,0.90,1.06,+0.18,20.45,1366000,63,1346650,0,0,0,0,0,0,875000,604000,271000,271000
20200430,709947,神盾永豐99購02,,,,,,0.00,0,0,0,0,0,0,0,0,0,0,0,0,0
20200430,709948,穩懋永豐99購02,2.34,2.34,2.26,2.26,+0.16,7.62,177000,10,404860,0,0,0,0,0,0,177000,59000,118000,118000
20200430,709949,中美晶日盛99購01,1.64,1.64,1.64,1.64,+0.17,11.56,12000,1,19680,0,0,0,0,0,0,0,12000,-12000,-12000
20200430,709950,大學光元大99購02,1.86,1.88,1.73,1.73,-0.07,-3.89,202000,27,366540,0,0,0,0,0,0,172000,30000,142000,142000
20200430,709951,台燿元大99購01,1.83,1.87,1.73,1.87,+0.28,17.61,630000,29,1118980,0,0,0,0,0,0,497000,123000,374000,374000
20200430,709952,良維元大99購02,3.77,3.77,3.71,3.77,+0.01,0.27,153000,12,570390,0,0,0,0,0,0,117000,36000,81000,81000
20200430,709953,建榮元大9B購01,1.16,1.16,1.10,1.15,+0.15,15.0,83000,8,94360,0,0,0,0,0,0,0,83000,-83000,-83000
20200430,709954,M31國票9A購01,2.03,2.09,2.03,2.09,+0.15,7.73,109000,7,226220,0,0,0,0,0,0,2000,107000,-105000,-105000
20200430,709955,大江國票9A購02,2.76,2.76,2.50,2.50,-0.06,-2.34,148000,9,387090,0,0,0,0,0,0,95000,87000,8000,8000
20200430,709956,群聯統一9B購01,1.01,1.01,1.01,1.01,+0.07,7.45,8000,1,8080,0,0,0,0,0,0,8000,0,8000,8000
20200430,709957,璟德兆豐99購02,1.10,1.19,1.10,1.19,+0.09,8.18,81000,5,90970,0,0,0,0,0,0,5000,76000,-71000,-71000
20200430,709958,迅得凱基99購01,2.04,2.04,2.01,2.01,-0.01,-0.5,20000,3,40710,0,0,0,0,0,0,20000,0,20000,20000
20200430,709959,保瑞凱基9B購01,1.50,1.50,1.48,1.48,+0.02,1.37,27000,3,40200,0,0,0,0,0,0,20000,7000,13000,13000
20200430,709960,原相凱基9A購01,3.03,3.06,3.03,3.03,0.00,0.0,12000,3,36480,0,0,0,0,0,0,4000,8000,-4000,-4000
20200430,709961,雍智凱基9B購01,1.17,1.24,1.17,1.24,+0.15,13.76,425000,19,511180,0,0,0,0,0,0,218000,415000,-197000,-197000
20200430,709962,精測凱基99購03,1.04,1.04,1.01,1.03,+0.06,6.19,364000,15,373230,0,0,0,0,0,0,364000,0,364000,364000
20200430,709963,廣明凱基99購02,3.13,3.13,3.12,3.12,-0.34,-9.83,6000,2,18750,0,0,0,0,0,0,6000,3000,3000,3000
20200430,709964,璟德凱基99購01,5.30,5.30,5.30,5.30,+0.30,6.0,11000,3,58300,0,0,0,0,0,0,11000,11000,0,0
20200430,709965,環球晶凱基99購07,2.01,2.22,2.01,2.21,+0.30,15.71,192000,21,401090,0,0,0,0,0,0,19000,182000,-163000,-163000
20200430,709966,金居群益9B購01,2.56,2.82,2.51,2.81,+0.53,23.25,327000,18,855430,0,0,0,0,0,0,210000,117000,93000,93000
20200430,709967,信驊群益99購01,1.92,1.97,1.92,1.97,+0.10,5.35,59000,3,114330,0,0,0,0,0,0,59000,21000,38000,38000
20200430,709968,聯亞群益99購02,4.06,4.06,3.60,3.60,-0.34,-8.63,498000,31,1918410,0,0,0,0,0,0,492000,165000,327000,327000
20200430,709969,譜瑞兆豐99購02,1.33,1.35,1.32,1.35,+0.07,5.47,214000,7,284940,0,0,0,0,0,0,192000,70000,122000,122000
20200430,709970,宏捷科元大9A購01,1.27,1.27,1.23,1.23,-0.03,-2.38,70000,2,86900,0,0,0,0,0,0,50000,20000,30000,30000
20200430,709971,邦特元大99購01,1.16,1.20,1.11,1.12,+0.04,3.7,355000,21,408890,0,0,0,0,0,0,264000,78000,186000,186000
20200430,709972,旺矽元大9B購01,1.04,1.15,1.03,1.14,+0.09,8.57,927000,36,1028920,0,0,0,0,0,0,144000,820000,-676000,-676000
20200430,709973,中美晶國票9A購01,,,,,,0.00,0,0,0,0,0,0,0,0,0,0,0,0,0
20200430,709974,旺矽國票99購02,3.42,4.00,3.42,3.87,+0.33,9.32,63000,12,239780,0,0,0,0,0,0,4000,59000,-55000,-55000
20200430,709975,宣德國票9A購01,1.69,1.85,1.68,1.85,+0.05,2.78,144000,16,248450,0,0,0,0,0,0,41000,103000,-62000,-62000
20200430,709976,鈺太國票9A購01,3.15,3.23,3.11,3.11,-0.09,-2.81,205000,17,652960,0,0,0,0,0,0,150000,55000,95000,95000
20200430,709977,M31永豐99購02,2.05,2.11,2.05,2.11,+0.14,7.11,20000,2,41600,0,0,0,0,0,0,0,20000,-20000,-20000
20200430,709978,建榮永豐9A購02,1.80,1.80,1.70,1.70,+0.15,9.68,109000,2,195300,0,0,0,0,0,0,109000,0,109000,109000
20200430,709979,晶焱永豐9A購01,,,,,,0.00,0,0,0,0,0,0,0,0,0,0,0,0,0
20200430,709980,鈊象永豐9A購01,1.92,1.92,1.86,1.86,-0.10,-5.1,51000,3,97410,0,0,0,0,0,0,43000,50000,-7000,-7000
20200430,709981,M31凱基99購02,2.31,2.34,2.31,2.34,+0.16,7.34,62000,8,144040,0,0,0,0,0,0,0,62000,-62000,-62000
20200430,709982,穩懋凱基99購05,2.80,2.83,2.73,2.73,+0.22,8.76,109000,20,304130,0,0,0,0,0,0,68000,41000,27000,27000
20200430,709983,群聯日盛9B購01,0.80,0.90,0.80,0.85,+0.16,23.19,64000,9,52740,0,0,0,0,0,0,54000,10000,44000,44000
20200430,709984,原相群益9C購01,1.89,1.89,1.89,1.89,-0.01,-0.53,4000,1,7560,0,0,0,0,0,0,0,4000,-4000,-4000
20200430,709985,大江富邦9B購02,1.34,1.34,1.27,1.27,+0.02,1.6,12000,2,15940,0,0,0,0,0,0,0,12000,-12000,-12000
20200430,709986,金可中信99購01,1.58,2.04,1.50,2.04,+0.51,33.33,313000,38,551120,0,0,0,0,0,0,72000,241000,-169000,-169000
20200430,709987,精華中信99購01,1.80,1.95,1.79,1.95,+0.24,14.04,75000,8,139900,0,0,0,0,0,0,30000,55000,-25000,-25000
20200430,709988,大江永豐99購02,3.03,3.03,3.03,3.03,+0.01,0.33,1000,1,3030,0,0,0,0,0,0,1000,1000,0,0
20200430,709989,茂達永豐99購01,1.60,1.73,1.60,1.73,+0.12,7.45,205000,9,341970,0,0,0,0,0,0,80000,125000,-45000,-45000
20200430,709990,精測永豐99購02,1.52,1.52,1.52,1.52,+0.13,9.35,2000,2,3040,0,0,0,0,0,0,0,2000,-2000,-2000
20200430,709991,環球晶凱基99購08,4.69,5.00,4.69,5.00,+0.44,9.65,118000,7,582790,0,0,0,0,0,0,2000,118000,-116000,-116000
20200430,709992,中美晶元大99購04,1.18,1.19,1.17,1.17,+0.08,7.34,55000,6,64460,0,0,0,0,0,0,2000,55000,-53000,-53000
20200430,709993,中美晶元大99購05,1.16,1.22,1.16,1.22,+0.09,7.96,131000,10,155960,0,0,0,0,0,0,1000,131000,-130000,-130000
20200430,709994,中美晶元大9B購01,0.91,0.96,0.89,0.95,+0.06,6.74,1057000,54,980330,0,0,0,0,0,0,511000,555000,-44000,-44000
20200430,709995,環球晶元大99購03,3.77,4.22,3.74,4.22,+0.65,18.21,288000,62,1141820,0,0,0,0,0,0,176000,185000,-9000,-9000
20200430,709996,環球晶元大99購04,4.24,4.67,4.24,4.67,+0.54,13.08,123000,30,551020,0,0,0,0,0,0,59000,93000,-34000,-34000
20200430,709997,聯亞元大99購02,2.78,2.92,2.64,2.70,-0.14,-4.93,113000,16,311620,0,0,0,0,0,0,74000,49000,25000,25000
20200430,709998,穩懋元大99購09,2.68,2.70,2.60,2.63,+0.19,7.79,67000,17,178330,0,0,0,0,0,0,59000,21000,38000,38000
20200430,709999,穩懋元大99購10,2.14,2.15,2.06,2.10,+0.15,7.69,433000,30,917350,0,0,0,0,0,0,427000,13000,414000,414000
20200430,710000,穩懋元大99購11,2.34,2.35,2.25,2.27,+0.16,7.58,96000,16,221370,0,0,0,0,0,0,54000,61000,-7000,-7000
20200430,710001,M31國票9A購02,,,,,,0.00,0,0,0,0,0,0,0,0,0,0,0,0,0
20200430,710002,穩懋國票9A購01,,,,,,0.00,0,0,0,0,0,0,0,0,0,0,0,0,0
20200430,710003,精測元大99購03,1.16,1.20,1.15,1.17,+0.06,5.41,427000,31,504460,0,0,0,0,0,0,225000,272000,-47000,-47000
20200430,710004,中美晶元富9B購01,1.58,1.68,1.55,1.66,+0.12,7.79,931000,35,1533130,0,0,0,0,0,0,199000,771000,-572000,-572000
20200430,710005,中美晶元富9B購02,1.71,1.80,1.71,1.80,+0.14,8.43,72000,7,128050,0,0,0,0,0,0,9000,63000,-54000,-54000
20200430,710006,神盾元富9B購01,1.96,1.96,1.83,1.91,+0.05,2.69,389000,44,737610,0,0,0,0,0,0,350000,56000,294000,294000
20200430,710007,環球晶元富9B購01,2.03,2.27,2.02,2.26,+0.31,15.9,430000,52,910890,0,0,0,0,0,0,189000,217000,-28000,-28000
20200430,710008,環球晶元富9B購02,2.70,2.93,2.69,2.93,+0.22,8.12,183000,18,513930,0,0,0,0,0,0,14000,169000,-155000,-155000
20200430,710009,穩懋元富99購01,4.67,4.75,4.59,4.59,+0.27,6.25,201000,32,944520,0,0,0,0,0,0,194000,38000,156000,156000
20200430,710010,中美晶國票9A購02,1.87,1.99,1.87,1.99,+0.10,5.29,146000,5,282180,0,0,0,0,0,0,34000,112000,-78000,-78000
20200430,710011,泰博國票9A購01,,,,,,0.00,0,0,0,0,0,0,0,0,0,0,0,0,0
20200430,710012,大宇資凱基9B購02,1.04,1.05,1.03,1.03,-0.02,-1.9,131000,11,135920,0,0,0,0,0,0,131000,0,131000,131000
20200430,710013,金可凱基99購01,1.73,2.12,1.70,2.12,+0.30,16.48,308000,30,564880,0,0,0,0,0,0,167000,65000,102000,102000
20200430,710014,信驊凱基99購01,3.95,4.06,3.95,4.06,+0.25,6.56,37000,6,147910,0,0,0,0,0,0,11000,11000,0,0
20200430,710015,統新凱基9A購01,2.10,2.10,1.86,1.86,-0.09,-4.62,29000,5,57370,0,0,0,0,0,0,15000,14000,1000,1000
20200430,710016,群聯凱基9A購01,1.93,1.94,1.89,1.94,+0.12,6.59,176000,13,337300,0,0,0,0,0,0,156000,120000,36000,36000
20200430,710017,環球晶凱基99購09,2.11,2.35,2.11,2.35,+0.32,15.76,323000,14,728700,0,0,0,0,0,0,29000,294000,-265000,-265000
20200430,710018,譜瑞凱基99購02,,,,,,0.00,0,0,0,0,0,0,0,0,0,0,0,0,0
20200430,710019,精測中信9A購01,0.86,0.89,0.85,0.86,+0.04,4.88,1838000,70,1590540,0,0,0,0,0,0,1338000,434000,904000,904000
20200430,710020,合晶永豐99購01,3.01,3.30,2.98,3.24,+0.32,10.96,227000,26,718580,0,0,0,0,0,0,24000,210000,-186000,-186000
20200430,710021,雙鴻永豐99購03,2.65,2.67,2.64,2.67,+0.12,4.71,16000,3,42490,0,0,0,0,0,0,16000,0,16000,16000
20200430,710022,譜瑞永豐99購01,2.49,2.50,2.45,2.50,+0.06,2.46,190000,8,468640,0,0,0,0,0,0,86000,104000,-18000,-18000
20200430,710023,鈊象永豐99購03,1.87,1.87,1.71,1.76,-0.09,-4.86,101000,5,182250,0,0,0,0,0,0,81000,35000,46000,46000
20200430,710024,宏捷科永豐99購04,2.51,2.51,2.51,2.51,+0.03,1.21,1000,1,2510,0,0,0,0,0,0,1000,0,1000,1000
20200430,710025,泰博永豐99購02,1.57,1.57,1.47,1.56,-0.04,-2.5,172000,12,266970,0,0,0,0,0,0,88000,84000,4000,4000
20200430,710026,群聯永豐99購02,1.95,1.99,1.92,1.98,+0.16,8.79,353000,16,694040,0,0,0,0,0,0,268000,108000,160000,160000
20200430,710027,優群永豐99購02,,,,,,0.00,0,0,0,0,0,0,0,0,0,0,0,0,0
20200430,710028,原相群益9C購02,1.94,1.94,1.90,1.90,0.00,0.0,33000,4,63020,0,0,0,0,0,0,8000,25000,-17000,-17000
20200430,710029,優群群益9A購01,3.60,3.60,3.60,3.60,-0.33,-8.4,16000,1,57600,0,0,0,0,0,0,0,16000,-16000,-16000
20200430,710030,大宇資元大9A購01,2.11,2.11,2.07,2.07,-0.02,-0.96,89000,4,186650,0,0,0,0,0,0,89000,0,89000,89000
20200430,710031,金居元大99購04,5.75,5.75,5.55,5.70,+0.76,15.38,104000,14,590100,0,0,0,0,0,0,104000,0,104000,104000
20200430,710032,精測元大99購04,1.31,1.37,1.28,1.31,+0.06,4.8,487000,30,637100,0,0,0,0,0,0,334000,215000,119000,119000
20200430,710033,聯亞元大9A購01,4.35,4.55,4.18,4.18,-0.19,-4.35,138000,16,602090,0,0,0,0,0,0,118000,52000,66000,66000
20200430,710034,穩懋元大9A購01,2.52,2.52,2.43,2.43,+0.16,7.05,70000,18,173190,0,0,0,0,0,0,68000,14000,54000,54000
20200430,710035,雙鴻元富99購01,1.67,1.67,1.64,1.67,+0.02,1.21,264000,12,439320,0,0,0,0,0,0,249000,10000,239000,239000
20200430,710036,大學光凱基9A購02,,,,,,0.00,0,0,0,0,0,0,0,0,0,0,0,0,0
20200430,710037,群聯凱基99購03,3.32,3.33,3.28,3.33,+0.22,7.07,89000,27,296020,0,0,0,0,0,0,49000,77000,-28000,-28000
20200430,710038,泰博群益9A購01,,,,,,0.00,0,0,0,0,0,0,0,0,0,0,0,0,0
20200430,710039,宏捷科富邦9B購02,1.85,1.85,1.74,1.74,-0.04,-2.25,362000,41,645110,0,0,0,0,0,0,127000,235000,-108000,-108000
20200430,710040,穩懋亞東99購01,1.76,1.76,1.76,1.76,+0.16,10.0,20000,1,35200,0,0,0,0,0,0,20000,20000,0,0
20200430,710041,原相凱基99購02,,,,,,0.00,0,0,0,0,0,0,0,0,0,0,0,0,0
20200430,710042,群聯凱基99購04,3.83,3.83,3.75,3.82,+0.26,7.3,65000,23,247630,0,0,0,0,0,0,55000,44000,11000,11000
20200430,710043,碩禾凱基9B購02,1.05,1.05,1.04,1.04,+0.01,0.97,55000,4,57500,0,0,0,0,0,0,30000,25000,5000,5000
20200430,710044,雙美凱基99購03,1.50,1.50,1.50,1.50,+0.04,2.74,40000,2,60000,0,0,0,0,0,0,40000,0,40000,40000
20200430,710045,穩懋凱基99購06,2.96,2.96,2.87,2.87,+0.22,8.3,85000,24,249470,0,0,0,0,0,0,83000,2000,81000,81000
20200430,710046,威剛元大9A購03,2.52,2.58,2.50,2.50,+0.05,2.04,218000,16,550500,0,0,0,0,0,0,75000,143000,-68000,-68000
20200430,710047,群聯元大99購06,9.70,9.70,9.70,9.70,+0.70,7.78,10000,1,97000,0,0,0,0,0,0,10000,0,10000,10000
20200430,710048,環球晶元大99購05,,,,,,0.00,0,0,0,0,0,0,0,0,0,0,0,0,0
20200430,710049,環球晶元大99購06,5.70,5.70,5.65,5.65,+0.25,4.63,3000,3,17050,0,0,0,0,0,0,3000,1000,2000,2000
20200430,710050,中美晶永豐99購01,1.23,1.34,1.23,1.31,+0.11,9.17,733000,38,957520,0,0,0,0,0,0,24000,733000,-709000,-709000
20200430,710051,宏捷科永豐99購05,4.25,4.25,4.09,4.11,-0.23,-5.3,51000,4,210450,0,0,0,0,0,0,42000,9000,33000,33000
20200430,710052,原相永豐99購03,1.71,1.72,1.71,1.72,0.00,0.0,20000,4,34370,0,0,0,0,0,0,18000,2000,16000,16000
20200430,710053,環球晶永豐99購04,1.83,2.03,1.83,2.03,+0.14,7.41,170000,15,335720,0,0,0,0,0,0,18000,155000,-137000,-137000
20200430,710054,聯亞永豐99購01,2.02,2.14,1.99,2.02,-0.06,-2.88,118000,10,242910,0,0,0,0,0,0,103000,15000,88000,88000
20200430,710055,雙鴻永豐9A購01,,,,,,0.00,0,0,0,0,0,0,0,0,0,0,0,0,0
20200430,710056,大江元大99購05,,,,,,0.00,0,0,0,0,0,0,0,0,0,0,0,0,0
20200430,710057,M31永豐99購03,2.62,2.62,2.62,2.62,+0.12,4.8,5000,1,13100,0,0,0,0,0,0,0,5000,-5000,-5000
20200430,710058,力致永豐9A購01,3.59,3.59,3.59,3.59,+0.29,8.79,32000,2,114880,0,0,0,0,0,0,32000,0,32000,32000
20200430,710059,大田永豐99購01,1.80,2.08,1.80,2.08,+0.33,18.86,292000,16,555170,0,0,0,0,0,0,13000,279000,-266000,-266000
20200430,710060,光頡永豐99購02,3.18,3.35,3.18,3.35,+0.55,19.64,18000,3,58240,0,0,0,0,0,0,15000,3000,12000,12000
20200430,710061,迅得永豐99購02,2.46,2.46,2.39,2.45,+0.05,2.08,73000,8,176350,0,0,0,0,0,0,13000,60000,-47000,-47000
20200430,710062,原相永豐99購04,,,,,,0.00,0,0,0,0,0,0,0,0,0,0,0,0,0
20200430,710063,神盾永豐99購03,2.56,2.61,2.46,2.53,+0.06,2.43,99000,12,251980,0,0,0,0,0,0,58000,37000,21000,21000
20200430,710064,聚積永豐99購02,2.29,2.29,2.29,2.29,+0.05,2.23,11000,1,25190,0,0,0,0,0,0,11000,0,11000,11000
20200430,710065,璟德永豐99購02,2.17,2.29,2.17,2.24,+0.07,3.23,120000,11,266550,0,0,0,0,0,0,77000,43000,34000,34000
20200430,710066,宏捷科群益99購03,4.02,4.02,3.77,3.77,-0.06,-1.57,63000,4,240760,0,0,0,0,0,0,63000,13000,50000,50000
20200430,710067,原相群益9C購03,,,,,,0.00,0,0,0,0,0,0,0,0,0,0,0,0,0
20200430,710068,威剛康和99購01,3.23,3.26,3.18,3.18,+0.08,2.58,6000,4,19290,0,0,0,0,0,0,6000,6000,0,0
20200430,710069,大江凱基99購02,3.24,3.24,3.24,3.24,+0.19,6.23,5000,1,16200,0,0,0,0,0,0,5000,0,5000,5000
20200430,710070,中美晶凱基99購08,1.44,1.53,1.44,1.50,+0.05,3.45,102000,13,147850,0,0,0,0,0,0,100000,16000,84000,84000
20200430,710071,原相凱基99購03,2.10,2.10,2.05,2.06,0.00,0.0,47000,7,97950,0,0,0,0,0,0,37000,10000,27000,27000
20200430,710072,環球晶凱基99購11,1.48,1.64,1.47,1.64,+0.20,13.89,928000,35,1414490,0,0,0,0,0,0,858000,70000,788000,788000
20200430,710073,穩懋兆豐9A購02,,,,,,0.00,0,0,0,0,0,0,0,0,0,0,0,0,0
20200430,710074,群聯元富99購01,3.59,3.61,3.59,3.61,+0.27,8.08,38000,4,136620,0,0,0,0,0,0,28000,15000,13000,13000
20200430,710075,大江富邦9B購03,,,,,,0.00,0,0,0,0,0,0,0,0,0,0,0,0,0
20200430,710076,穩懋富邦9B購03,2.23,2.23,2.14,2.14,+0.08,3.88,232000,51,513190,0,0,0,0,0,0,232000,6000,226000,226000
20200430,710077,中美晶元大9A購01,1.58,1.66,1.57,1.63,+0.10,6.54,292000,39,469730,0,0,0,0,0,0,155000,147000,8000,8000
20200430,710078,宇峻元大9A購01,2.47,2.50,2.37,2.37,-0.10,-4.05,125000,17,306120,0,0,0,0,0,0,88000,37000,51000,51000
20200430,710079,宣德元大9A購01,6.35,6.65,6.35,6.65,+0.15,2.31,84000,19,540350,0,0,0,0,0,0,69000,48000,21000,21000
20200430,710080,環球晶元大99購09,5.25,5.55,5.25,5.55,+0.35,6.73,19000,9,101850,0,0,0,0,0,0,19000,19000,0,0
20200430,710081,穩懋元大99購13,6.70,6.70,6.60,6.60,+0.60,10.0,10000,7,66400,0,0,0,0,0,0,10000,6000,4000,4000
20200430,710082,穩懋元大99購14,4.95,4.95,4.93,4.93,+0.43,9.56,3000,3,14810,0,0,0,0,0,0,3000,3000,0,0
20200430,710083,宏捷科凱基99購02,1.73,1.73,1.72,1.72,-0.04,-2.27,35000,2,60350,0,0,0,0,0,0,35000,0,35000,35000
20200430,710084,泰博凱基99購02,1.71,1.71,1.71,1.71,+0.02,1.18,15000,1,25650,0,0,0,0,0,0,15000,0,15000,15000
20200430,710085,群聯凱基99購05,2.62,2.64,2.59,2.64,+0.16,6.45,23000,10,60310,0,0,0,0,0,0,23000,8000,15000,15000
20200430,710086,穩懋凱基99購07,2.55,2.55,2.55,2.55,+0.21,8.97,10000,1,25500,0,0,0,0,0,0,10000,0,10000,10000
20200430,710087,大學光永豐99購03,,,,,,0.00,0,0,0,0,0,0,0,0,0,0,0,0,0
20200430,710088,威剛永豐99購03,2.46,2.46,2.46,2.46,+0.10,4.24,10000,1,24600,0,0,0,0,0,0,0,10000,-10000,-10000
20200430,710089,宣德永豐99購02,2.85,2.89,2.81,2.89,+0.17,6.25,44000,7,125470,0,0,0,0,0,0,10000,34000,-24000,-24000
20200430,710090,碩禾永豐99購02,1.24,1.26,1.24,1.25,0.00,0.0,61000,3,76200,0,0,0,0,0,0,50000,11000,39000,39000
20200430,710091,優群元富99購01,5.30,5.30,5.10,5.10,-0.25,-4.67,225000,15,1163750,0,0,0,0,0,0,91000,154000,-63000,-63000
20200430,710092,網家元大99購03,2.82,2.93,2.77,2.78,+0.05,1.83,517000,48,1460280,0,0,0,0,0,0,421000,79000,342000,342000
20200430,710093,聚積元大9C購01,,,,,,0.00,0,0,0,0,0,0,0,0,0,0,0,0,0
20200430,710094,雙美元大9C購01,,,,,,0.00,0,0,0,0,0,0,0,0,0,0,0,0,0
20200430,710095,穩懋元大99購15,6.85,6.90,6.60,6.75,+0.55,8.87,50000,13,336500,0,0,0,0,0,0,44000,34000,10000,10000
20200430,710096,鈺太元大9A購01,,,,,,0.00,0,0,0,0,0,0,0,0,0,0,0,0,0
20200430,710097,大學光群益9A購01,,,,,,0.00,0,0,0,0,0,0,0,0,0,0,0,0,0
20200430,710098,尼克森永豐99購01,1.79,1.79,1.77,1.78,0.00,0.0,148000,9,264360,0,0,0,0,0,0,87000,61000,26000,26000
20200430,710099,亞泰永豐99購03,1.93,1.93,1.93,1.93,0.00,0.0,19000,1,36670,0,0,0,0,0,0,19000,0,19000,19000
20200430,710100,旺矽永豐99購01,2.23,2.46,2.23,2.45,+0.19,8.41,182000,15,429140,0,0,0,0,0,0,70000,132000,-62000,-62000
20200430,710101,昇達科永豐99購01,1.95,1.95,1.95,1.95,+0.09,4.84,77000,2,150150,0,0,0,0,0,0,0,77000,-77000,-77000
20200430,710102,信昌電永豐99購02,2.71,2.93,2.66,2.90,+0.34,13.28,261000,16,701190,0,0,0,0,0,0,244000,15000,229000,229000
20200430,710103,威剛永豐99購04,3.55,3.59,3.50,3.51,+0.10,2.93,51000,9,180690,0,0,0,0,0,0,6000,48000,-42000,-42000
20200430,710104,新鉅科永豐99購02,1.89,1.91,1.86,1.86,-0.05,-2.62,90000,7,170240,0,0,0,0,0,0,80000,10000,70000,70000
20200430,710105,網龍永豐99購01,3.25,3.25,3.14,3.20,-0.18,-5.33,13000,3,41100,0,0,0,0,0,0,13000,1000,12000,12000
20200430,710106,廣明永豐99購01,3.24,3.24,3.24,3.24,-0.40,-10.99,10000,1,32400,0,0,0,0,0,0,10000,0,10000,10000
20200430,710107,緯軟永豐99購02,2.14,2.39,2.14,2.18,+0.22,11.22,192000,21,443250,0,0,0,0,0,0,11000,181000,-170000,-170000
20200430,710108,環宇永豐99購01,1.54,1.54,1.47,1.47,-0.10,-6.37,75000,3,112550,0,0,0,0,0,0,25000,50000,-25000,-25000
20200430,710109,晟德永豐99購01,2.37,2.37,2.37,2.37,-0.02,-0.84,27000,1,63990,0,0,0,0,0,0,27000,0,27000,27000
20200430,710110,信昌電富邦9C購01,1.97,2.12,1.97,1.97,+0.07,3.68,364000,8,728600,0,0,0,0,0,0,352000,12000,340000,340000
20200430,710111,三貝德凱基99購03,2.24,2.24,2.22,2.22,+0.01,0.45,45000,2,100400,0,0,0,0,0,0,45000,0,45000,45000
20200430,710112,大江凱基99購03,2.32,2.32,2.32,2.32,+0.03,1.31,1000,1,2320,0,0,0,0,0,0,1000,1000,0,0
20200430,710113,宣德凱基99購01,2.28,2.40,2.28,2.40,+0.14,6.19,27000,4,62760,0,0,0,0,0,0,1000,26000,-25000,-25000
20200430,710114,原相凱基99購04,,,,,,0.00,0,0,0,0,0,0,0,0,0,0,0,0,0
20200430,710115,群聯凱基99購06,,,,,,0.00,0,0,0,0,0,0,0,0,0,0,0,0,0
20200430,710116,環球晶凱基99購12,1.05,1.05,1.04,1.04,+0.02,1.96,30000,3,31300,0,0,0,0,0,0,30000,0,30000,30000
20200430,710117,聯亞凱基99購05,1.65,1.65,1.54,1.54,-0.07,-4.35,123000,16,197240,0,0,0,0,0,0,108000,15000,93000,93000
20200430,710118,雙鴻凱基99購02,,,,,,0.00,0,0,0,0,0,0,0,0,0,0,0,0,0
20200430,710119,穩懋凱基99購08,1.61,1.67,1.61,1.65,+0.14,9.27,217000,19,358110,0,0,0,0,0,0,202000,0,202000,202000
20200430,710120,鈊象凱基99購02,1.57,1.57,1.42,1.45,-0.08,-5.23,271000,9,397540,0,0,0,0,0,0,261000,10000,251000,251000
20200430,710121,三貝德永豐99購02,2.30,2.30,2.25,2.25,-0.02,-0.88,39000,4,89600,0,0,0,0,0,0,39000,0,39000,39000
20200430,710122,大江永豐99購03,2.56,2.56,2.56,2.56,+0.19,8.02,3000,1,7680,0,0,0,0,0,0,0,3000,-3000,-3000
20200430,710123,安勤永豐99購01,1.18,1.31,1.17,1.29,+0.10,8.4,928000,50,1156990,0,0,0,0,0,0,70000,858000,-788000,-788000
20200430,710124,良維永豐99購01,2.54,2.54,2.54,2.54,-0.01,-0.39,7000,2,17780,0,0,0,0,0,0,7000,0,7000,7000
20200430,710125,金居永豐99購01,2.13,2.32,2.09,2.30,+0.45,24.32,856000,32,1858690,0,0,0,0,0,0,669000,187000,482000,482000
20200430,710126,南光永豐99購01,1.30,1.30,1.29,1.29,0.00,0.0,15000,2,19400,0,0,0,0,0,0,10000,5000,5000,5000
20200430,710127,原相永豐99購05,2.02,2.02,1.98,2.00,0.00,0.0,20000,3,40040,0,0,0,0,0,0,18000,2000,16000,16000
20200430,710128,晶焱永豐99購02,1.47,1.52,1.47,1.52,+0.08,5.56,159000,7,237320,0,0,0,0,0,0,84000,75000,9000,9000
20200430,710129,群聯永豐99購03,1.62,1.62,1.60,1.62,+0.10,6.58,83000,4,134400,0,0,0,0,0,0,83000,3000,80000,80000
20200430,710130,精測永豐99購03,1.01,1.01,1.01,1.01,+0.06,6.32,1000,1,1010,0,0,0,0,0,0,1000,0,1000,1000
20200430,710131,璟德永豐99購03,1.49,1.59,1.49,1.56,+0.02,1.3,172000,12,263140,0,0,0,0,0,0,111000,61000,50000,50000
20200430,710132,鈊象永豐99購04,1.52,1.53,1.40,1.40,-0.10,-6.67,55000,7,83030,0,0,0,0,0,0,50000,5000,45000,45000
20200430,710133,宏捷科國泰9B購02,2.35,2.35,2.35,2.35,-0.13,-5.24,50000,2,117500,0,0,0,0,0,0,50000,0,50000,50000
20200430,710134,環球晶國泰9A購03,2.27,2.49,2.27,2.46,+0.26,11.82,774000,46,1843810,0,0,0,0,0,0,207000,604000,-397000,-397000
20200430,710135,穩懋國泰9A購02,2.60,2.62,2.48,2.54,+0.19,8.09,469000,39,1203180,0,0,0,0,0,0,386000,83000,303000,303000
20200430,710136,大江元大9A購01,8.35,8.45,7.95,7.95,0.00,0.0,4000,4,32750,0,0,0,0,0,0,3000,3000,0,0
20200430,710137,原相元大9B購01,6.30,6.30,6.30,6.30,-0.10,-1.56,1000,1,6300,0,0,0,0,0,0,1000,0,1000,1000
20200430,710138,群聯元大99購07,8.45,8.45,8.30,8.40,+0.55,7.01,28000,25,234950,0,0,0,0,0,0,23000,25000,-2000,-2000
20200430,710139,環球晶元大99購10,4.22,4.69,4.12,4.60,+0.58,14.43,168000,40,739770,0,0,0,0,0,0,43000,151000,-108000,-108000
20200430,710140,環球晶元大99購11,4.32,4.83,4.29,4.83,+0.38,8.54,192000,38,881300,0,0,0,0,0,0,67000,178000,-111000,-111000
20200430,710141,聯亞元大99購03,4.42,4.66,4.22,4.22,-0.36,-7.86,97000,16,430010,0,0,0,0,0,0,74000,22000,52000,52000
20200430,710142,穩懋元大99購16,6.95,6.95,6.75,6.75,+0.45,7.14,56000,14,380100,0,0,0,0,0,0,16000,55000,-39000,-39000
20200430,710143,譜瑞元大99購01,5.85,5.85,5.85,5.85,+0.15,2.63,1000,1,5850,0,0,0,0,0,0,1000,0,1000,1000
20200430,710144,鈊象元大9A購01,3.28,3.29,2.93,2.98,-0.19,-5.99,244000,52,737920,0,50000,-50000,0,0,0,93000,128000,-35000,-85000
20200430,710145,原相台新99購02,2.45,2.45,2.45,2.45,-0.01,-0.41,10000,1,24500,0,0,0,0,0,0,10000,0,10000,10000
20200430,710146,群聯台新99購01,,,,,,0.00,0,0,0,0,0,0,0,0,0,0,0,0,0
20200430,710147,精測元富99購03,2.16,2.17,2.09,2.10,+0.09,4.48,855000,44,1813390,0,0,0,0,0,0,455000,452000,3000,3000
20200430,710148,精測元富99購04,2.14,2.17,2.04,2.08,+0.12,6.12,536000,71,1132190,0,0,0,0,0,0,394000,183000,211000,211000
20200430,710149,鈊象元富99購02,4.50,4.50,4.37,4.37,+0.03,0.69,16000,3,70670,0,0,0,0,0,0,3000,3000,0,0
20200430,710150,M31凱基9A購01,2.23,2.23,2.23,2.23,+0.04,1.83,20000,1,44600,0,0,0,0,0,0,20000,0,20000,20000
20200430,710151,VHQ凱基99購01,2.56,2.56,2.52,2.52,+0.04,1.61,20000,2,50800,0,0,0,0,0,0,20000,0,20000,20000
20200430,710152,中美晶凱基9A購03,1.27,1.34,1.27,1.31,+0.05,3.97,401000,7,516540,0,0,0,0,0,0,121000,281000,-160000,-160000
20200430,710153,威剛凱基9A購03,2.22,2.25,2.22,2.25,+0.07,3.21,38000,6,84750,0,0,0,0,0,0,38000,3000,35000,35000
20200430,710154,原相凱基9A購02,,,,,,0.00,0,0,0,0,0,0,0,0,0,0,0,0,0
20200430,710155,群聯凱基9A購02,,,,,,0.00,0,0,0,0,0,0,0,0,0,0,0,0,0
20200430,710156,精測凱基9A購01,1.18,1.19,1.14,1.15,+0.04,3.6,409000,31,474930,0,0,0,0,0,0,341000,62000,279000,279000
20200430,710157,優群凱基9A購03,2.06,2.06,1.97,1.97,-0.09,-4.37,86000,3,172170,0,0,0,0,0,0,86000,0,86000,86000
20200430,710158,環球晶凱基9A購01,1.11,1.23,1.11,1.23,+0.15,13.89,331000,42,389810,0,0,0,0,0,0,104000,250000,-146000,-146000
20200430,710159,雙美凱基9A購01,,,,,,0.00,0,0,0,0,0,0,0,0,0,0,0,0,0
20200430,710160,穩懋凱基9A購01,1.50,1.51,1.50,1.50,+0.06,4.17,38000,4,57100,0,0,0,0,0,0,28000,10000,18000,18000
20200430,710161,鈊象凱基9A購02,1.23,1.23,1.09,1.11,-0.10,-8.26,226000,6,263370,0,0,0,0,0,0,209000,17000,192000,192000
20200430,710162,鈊象凱基9B購01,0.82,0.82,0.74,0.74,-0.06,-7.5,2298000,79,1756600,0,20000,-20000,0,0,0,171000,1987000,-1816000,-1836000
20200430,710163,鈺太國泰9B購01,,,,,,0.00,0,0,0,0,0,0,0,0,0,0,0,0,0
20200430,710164,大江元大9A購02,7.90,7.90,7.45,7.45,+0.10,1.36,4000,3,31100,0,0,0,0,0,0,4000,4000,0,0
20200430,710165,大學光元大9C購01,4.41,4.41,4.31,4.32,-0.14,-3.14,5000,3,21760,0,0,0,0,0,0,5000,0,5000,5000
20200430,710166,中美晶元大9A購02,3.49,3.68,2.15,3.61,+0.16,4.64,241000,46,847250,0,0,0,0,0,0,114000,149000,-35000,-35000
20200430,710167,宏捷科元大9B購01,1.55,1.55,1.47,1.48,-0.02,-1.33,19000,6,28140,0,0,0,0,0,0,15000,4000,11000,11000
20200430,710168,原相元大9A購04,5.80,5.80,5.65,5.75,+0.05,0.88,52000,4,299500,0,0,0,0,0,0,12000,40000,-28000,-28000
20200430,710169,晶焱元大99購02,3.40,3.45,3.35,3.40,+0.16,4.94,39000,9,132110,0,0,0,0,0,0,27000,12000,15000,15000
20200430,710170,聯亞元大99購04,3.63,3.83,3.35,3.35,-0.30,-8.22,512000,42,1827900,0,0,0,0,0,0,126000,386000,-260000,-260000
20200430,710171,穩懋元大99購17,3.98,3.98,3.81,3.81,+0.22,6.13,93000,20,364480,0,0,0,0,0,0,93000,31000,62000,62000
20200430,710172,穩懋元大99購18,3.40,3.40,3.26,3.26,+0.19,6.19,64000,20,215050,0,0,0,0,0,0,62000,23000,39000,39000
20200430,710173,原相台新99購03,4.05,4.05,4.05,4.05,-0.13,-3.11,10000,1,40500,0,0,0,0,0,0,0,10000,-10000,-10000
20200430,710174,群聯台新99購02,3.69,3.69,3.68,3.68,+0.21,6.05,17000,3,62610,0,0,0,0,0,0,12000,5000,7000,7000
20200430,710175,伍豐永豐99購01,1.44,1.46,1.44,1.46,+0.01,0.69,6000,2,8740,0,0,0,0,0,0,6000,0,6000,6000
20200430,710176,兆利永豐99購02,1.63,1.63,1.55,1.62,+0.06,3.85,126000,7,199610,0,0,0,0,0,0,107000,19000,88000,88000
20200430,710177,同亨永豐99購01,1.29,1.29,1.29,1.29,+0.02,1.57,73000,2,94170,0,0,0,0,0,0,73000,0,73000,73000
20200430,710178,合晶永豐99購02,1.70,1.85,1.67,1.85,+0.24,14.91,401000,30,706360,0,0,0,0,0,0,72000,333000,-261000,-261000
20200430,710179,宜鼎永豐99購01,1.73,1.78,1.70,1.78,+0.13,7.88,495000,22,856740,0,0,0,0,0,0,248000,249000,-1000,-1000
20200430,710180,信驊永豐99購04,0.78,0.80,0.78,0.80,+0.06,8.11,78000,6,61900,0,0,0,0,0,0,26000,52000,-26000,-26000
20200430,710181,聯亞永豐99購02,1.34,1.34,1.23,1.23,-0.09,-6.82,638000,17,799000,0,0,0,0,0,0,358000,280000,78000,78000
20200430,710182,M31凱基99購03,1.79,1.81,1.79,1.81,+0.10,5.85,143000,6,257970,0,0,0,0,0,0,0,143000,-143000,-143000
20200430,710183,中美晶凱基99購09,1.30,1.38,1.30,1.36,+0.08,6.25,296000,19,395240,0,0,0,0,0,0,105000,196000,-91000,-91000
20200430,710184,雍智凱基99購02,2.73,2.73,2.73,2.73,+0.22,8.76,3000,1,8190,0,0,0,0,0,0,0,3000,-3000,-3000
20200430,710185,精測凱基99購04,0.96,0.98,0.94,0.95,+0.03,3.26,650000,24,620470,0,0,0,0,0,0,635000,15000,620000,620000
20200430,710186,環球晶凱基99購13,0.90,1.01,0.90,1.01,+0.14,16.09,787000,25,772290,0,0,0,0,0,0,148000,641000,-493000,-493000
20200430,710187,聯亞凱基99購06,1.35,1.35,1.23,1.23,-0.07,-5.38,326000,36,426350,0,0,0,0,0,0,299000,15000,284000,284000
20200430,710188,穩懋凱基99購09,1.16,1.25,1.16,1.22,+0.08,7.02,77000,20,94430,0,0,0,0,0,0,72000,3000,69000,69000
20200430,710189,譜瑞凱基99購03,1.63,1.63,1.58,1.58,+0.01,0.64,66000,3,104580,0,0,0,0,0,0,60000,6000,54000,54000
20200430,710190,鈊象凱基99購03,1.00,1.00,0.90,0.91,-0.07,-7.14,816000,50,762850,0,0,0,0,0,0,548000,264000,284000,284000
20200430,710191,中美晶國票99購02,4.69,4.96,4.69,4.96,+0.33,7.13,49000,6,236210,0,0,0,0,0,0,14000,35000,-21000,-21000
20200430,710192,穩懋國票99購04,4.14,4.16,3.95,3.95,+0.25,6.76,27000,7,109740,0,0,0,0,0,0,27000,0,27000,27000
20200430,710193,三貝德康和99購01,2.14,2.14,2.13,2.13,-0.01,-0.47,30000,2,64000,0,0,0,0,0,0,20000,10000,10000,10000
20200430,710194,優群康和99購01,,,,,,0.00,0,0,0,0,0,0,0,0,0,0,0,0,0
20200430,710195,原相元富99購01,4.50,4.50,4.50,4.50,-0.06,-1.32,1000,1,4500,0,0,0,0,0,0,1000,0,1000,1000
20200430,710196,穩懋元富99購02,3.58,3.58,3.41,3.46,+0.26,8.12,123000,21,431370,0,0,0,0,0,0,89000,12000,77000,77000
20200430,710197,由田永豐99購01,1.08,1.10,1.07,1.07,-0.03,-2.73,120000,3,129700,0,0,0,0,0,0,110000,10000,100000,100000
20200430,710198,長科*永豐99購01,1.76,1.76,1.71,1.71,+0.09,5.56,76000,2,130760,0,0,0,0,0,0,76000,0,76000,76000
20200430,710199,皇田永豐99購01,1.10,1.11,1.10,1.11,+0.07,6.73,125000,8,138000,0,0,0,0,0,0,35000,90000,-55000,-55000
20200430,710200,美琪瑪永豐99購01,2.02,2.10,2.02,2.09,+0.08,3.98,210000,16,433450,0,0,0,0,0,0,72000,82000,-10000,-10000
20200430,710201,新揚科永豐99購01,1.51,1.56,1.51,1.56,-0.02,-1.27,108000,4,165530,0,0,0,0,0,0,81000,27000,54000,54000
20200430,710202,雍智永豐99購02,2.10,2.29,2.10,2.26,+0.21,10.24,223000,25,494460,0,0,0,0,0,0,35000,181000,-146000,-146000
20200430,710203,精華永豐99購02,1.00,1.15,0.99,1.15,+0.17,17.35,226000,15,237550,0,0,0,0,0,0,166000,121000,45000,45000
20200430,710204,網家永豐99購01,1.73,1.76,1.71,1.71,+0.03,1.79,140000,8,242320,0,0,0,0,0,0,110000,30000,80000,80000
20200430,710205,網龍永豐99購02,2.61,2.66,2.61,2.63,-0.07,-2.59,32000,3,84700,0,0,0,0,0,0,32000,0,32000,32000
20200430,710206,鈊象永豐99購05,,,,,,0.00,0,0,0,0,0,0,0,0,0,0,0,0,0
20200430,710207,中美晶國泰9B購01,2.16,2.27,2.14,2.24,+0.15,7.18,1488000,80,3291480,0,0,0,0,0,0,462000,1070000,-608000,-608000
20200430,710208,群聯國泰9B購01,2.28,2.29,2.22,2.27,+0.14,6.57,273000,21,615200,0,0,0,0,0,0,218000,72000,146000,146000
20200430,710209,群聯富邦9A購01,1.87,1.87,1.82,1.86,+0.12,6.9,150000,14,278100,0,0,0,0,0,0,150000,0,150000,150000
20200430,710210,環球晶富邦9B購03,0.71,0.80,0.71,0.80,+0.11,15.94,706000,20,534480,0,0,0,0,0,0,51000,631000,-580000,-580000
20200430,710211,穩懋富邦9B購04,1.12,1.18,1.12,1.16,+0.07,6.42,1873000,134,2174660,0,0,0,0,0,0,1565000,255000,1310000,1310000
20200430,710212,群聯元大99購08,5.40,5.45,5.30,5.40,+0.42,8.43,89000,11,476100,0,0,0,0,0,0,83000,11000,72000,72000
20200430,710213,鈊象元大99購06,3.57,3.61,3.19,3.22,-0.26,-7.47,104000,13,344900,0,0,0,0,0,0,36000,74000,-38000,-38000
20200430,710214,大江凱基99購04,1.88,1.88,1.83,1.83,+0.03,1.67,13000,2,23940,0,0,0,0,0,0,10000,3000,7000,7000
20200430,710215,旺矽凱基99購01,1.47,1.62,1.46,1.59,+0.10,6.71,556000,26,860610,0,0,0,0,0,0,103000,472000,-369000,-369000
20200430,710216,泰博凱基99購03,1.29,1.29,1.29,1.29,-0.01,-0.77,3000,1,3870,0,0,0,0,0,0,3000,0,3000,3000
20200430,710217,晶焱凱基99購02,1.03,1.06,1.02,1.04,+0.03,2.97,106000,12,110170,0,0,0,0,0,0,55000,51000,4000,4000
20200430,710218,群聯凱基99購07,1.30,1.32,1.28,1.31,+0.08,6.5,234000,23,305160,0,0,0,0,0,0,131000,119000,12000,12000
20200430,710219,精測凱基99購05,0.87,0.87,0.85,0.86,+0.03,3.61,260000,4,221700,0,0,0,0,0,0,250000,10000,240000,240000
20200430,710220,鈊象凱基99購04,1.21,1.21,1.08,1.10,-0.08,-6.78,406000,31,462900,0,0,0,0,0,0,197000,200000,-3000,-3000
20200430,710221,原相國票99購03,4.08,4.08,4.06,4.06,-0.02,-0.49,54000,3,219300,0,0,0,0,0,0,0,54000,-54000,-54000
20200430,710222,力麒康和99購01,1.93,1.93,1.93,1.93,+0.08,4.32,9000,1,17370,0,0,0,0,0,0,0,9000,-9000,-9000
20200430,710223,美琪瑪康和99購01,,,,,,0.00,0,0,0,0,0,0,0,0,0,0,0,0,0
20200430,710224,新鉅科康和99購01,3.03,3.03,3.02,3.02,-0.06,-1.95,65000,15,196530,0,0,0,0,0,0,65000,0,65000,65000
20200430,710225,聯亞康和99購01,2.04,2.04,1.79,1.85,-0.12,-6.09,380000,31,740990,0,0,0,0,0,0,249000,131000,118000,118000
20200430,710226,良維永豐99購02,1.69,1.69,1.69,1.69,+0.04,2.42,83000,4,140270,0,0,0,0,0,0,83000,0,83000,83000
20200430,710227,保瑞永豐99購01,1.11,1.12,1.11,1.12,+0.04,3.7,20000,2,22300,0,0,0,0,0,0,10000,10000,0,0
20200430,710228,原相永豐99購06,,,,,,0.00,0,0,0,0,0,0,0,0,0,0,0,0,0
20200430,710229,神盾永豐99購04,1.66,1.68,1.65,1.65,+0.05,3.13,113000,7,188420,0,0,0,0,0,0,113000,8000,105000,105000
20200430,710230,神盾永豐99購05,1.69,1.72,1.69,1.70,+0.07,4.29,43000,4,73380,0,0,0,0,0,0,43000,0,43000,43000
20200430,710231,優群永豐99購03,1.98,1.98,1.96,1.96,-0.11,-5.31,101000,3,199780,0,0,0,0,0,0,91000,10000,81000,81000
20200430,710232,鈺太永豐99購02,1.58,1.60,1.56,1.60,+0.02,1.27,130000,9,204850,0,0,0,0,0,0,95000,63000,32000,32000
20200430,710233,精測富邦9A購02,0.45,0.45,0.45,0.45,+0.02,4.65,16000,3,7200,0,0,0,0,0,0,16000,9000,7000,7000
20200430,710234,台燿凱基99購01,1.48,1.58,1.48,1.56,+0.15,10.64,76000,9,117860,0,0,0,0,0,0,9000,57000,-48000,-48000
20200430,710235,保瑞凱基99購01,,,,,,0.00,0,0,0,0,0,0,0,0,0,0,0,0,0
20200430,710236,原相凱基99購05,1.59,1.59,1.56,1.57,-0.01,-0.63,194000,11,305280,0,0,0,0,0,0,164000,130000,34000,34000
20200430,710237,神盾凱基99購03,1.73,1.73,1.65,1.68,+0.05,3.07,126000,19,213390,0,0,0,0,0,0,86000,40000,46000,46000
20200430,710238,精測凱基9A購02,0.70,0.70,0.68,0.68,+0.02,3.03,283000,14,195020,0,0,0,0,0,0,100000,183000,-83000,-83000
20200430,710239,鈊象凱基99購05,1.41,1.41,1.41,1.41,+0.02,1.44,112000,3,157920,0,0,0,0,0,0,112000,0,112000,112000
20200430,710240,原相元大99購05,3.86,3.86,3.86,3.86,-0.19,-4.69,31000,2,119660,0,0,0,0,0,0,1000,30000,-29000,-29000
20200430,710241,神盾元大9A購04,5.65,5.75,5.35,5.35,-0.05,-0.93,133000,12,745750,0,0,0,0,0,0,93000,58000,35000,35000
20200430,710242,環球晶元大99購13,2.30,2.48,2.30,2.48,+0.23,10.22,74000,10,176820,0,0,0,0,0,0,0,74000,-74000,-74000
20200430,710243,穩懋元大99購20,1.70,1.70,1.60,1.64,+0.12,7.89,89000,14,145250,0,0,0,0,0,0,29000,67000,-38000,-38000
20200430,710244,穩懋元大99購21,1.80,1.80,1.70,1.76,+0.14,8.64,228000,27,396990,0,10000,-10000,0,0,0,195000,40000,155000,145000
20200430,710245,中美晶群益99購04,1.82,1.94,1.81,1.90,+0.09,4.97,468000,41,881040,0,0,0,0,0,0,87000,395000,-308000,-308000
20200430,710246,鈊象群益99購06,2.08,2.08,1.86,1.87,-0.16,-7.88,250000,15,496640,0,0,0,0,0,0,110000,141000,-31000,-31000
20200430,710247,信驊元富99購01,1.23,1.30,1.22,1.30,+0.15,13.04,285000,9,364880,0,0,0,0,0,0,75000,210000,-135000,-135000
20200430,710248,原相元富99購02,,,,,,0.00,0,0,0,0,0,0,0,0,0,0,0,0,0
20200430,710249,群聯元富99購02,2.46,2.46,2.42,2.42,+0.12,5.22,25000,4,60660,0,0,0,0,0,0,4000,21000,-17000,-17000
20200430,710250,大江國票99購02,11.10,11.10,10.50,10.50,+0.20,1.94,16000,9,174700,0,0,0,0,0,0,16000,6000,10000,10000
20200430,710251,泰博國票9A購02,3.98,3.98,3.98,3.98,-0.05,-1.24,1000,1,3980,0,0,0,0,0,0,1000,0,1000,1000
20200430,710252,群聯國票99購02,2.41,2.41,2.36,2.40,+0.18,8.11,1092000,12,2614610,0,10000,-10000,0,0,0,94000,1053000,-959000,-969000
20200430,710253,網龍康和99購01,3.81,3.81,3.81,3.81,-0.02,-0.52,46000,1,175260,0,0,0,0,0,0,46000,0,46000,46000
20200430,710254,鈊象國泰9B購01,2.43,2.45,2.18,2.23,-0.16,-6.69,556000,59,1260760,0,0,0,0,0,0,175000,371000,-196000,-196000
20200430,710255,中美晶富邦9B購03,0.74,0.78,0.74,0.77,+0.05,6.94,614000,34,471110,0,0,0,0,0,0,69000,486000,-417000,-417000
20200430,710256,金居群益9B購02,3.89,4.21,3.80,4.21,+0.79,23.1,543000,30,2110930,0,0,0,0,0,0,375000,168000,207000,207000
20200430,710257,群聯群益99購02,2.88,2.88,2.80,2.87,+0.21,7.89,73000,22,209090,0,0,0,0,0,0,73000,21000,52000,52000
20200430,710258,鈊象國票9B購01,2.51,2.51,2.23,2.25,-0.14,-5.86,231000,11,534130,0,0,0,0,0,0,183000,51000,132000,132000
20200430,710259,宇峻元大9B購01,3.38,3.42,3.22,3.24,-0.17,-4.99,249000,21,824420,0,0,0,0,0,0,154000,95000,59000,59000
20200430,710260,威剛元大9B購01,4.04,4.12,4.04,4.08,+0.15,3.82,90000,11,367230,0,0,0,0,0,0,60000,36000,24000,24000
20200430,710261,神盾元大9B購01,2.68,2.72,2.55,2.61,+0.07,2.76,130000,8,340620,0,0,0,0,0,0,126000,4000,122000,122000
20200430,710262,精測元大99購05,1.45,1.51,1.43,1.45,+0.06,4.32,1013000,84,1491640,0,0,0,0,0,0,417000,637000,-220000,-220000
20200430,710263,環球晶元大99購14,3.23,3.62,3.23,3.62,+0.27,8.06,135000,25,463040,0,0,0,0,0,0,17000,135000,-118000,-118000
20200430,710264,環球晶元大99購15,2.15,2.41,2.15,2.41,+0.34,16.43,393000,33,898990,0,0,0,0,0,0,146000,250000,-104000,-104000
20200430,710265,穩懋元大99購22,2.68,2.68,2.59,2.59,+0.21,8.82,68000,15,179430,0,0,0,0,0,0,49000,34000,15000,15000
20200430,710266,譜瑞元大99購02,2.64,2.67,2.55,2.67,+0.12,4.71,588000,58,1551800,0,0,0,0,0,0,82000,506000,-424000,-424000
20200430,710267,中美晶凱基9B購01,1.38,1.47,1.38,1.45,+0.06,4.32,305000,22,434430,0,0,0,0,0,0,169000,147000,22000,22000
20200430,710268,世界凱基99購01,1.83,1.88,1.83,1.88,+0.09,5.03,62000,10,114650,0,0,0,0,0,0,34000,28000,6000,6000
20200430,710269,建榮凱基99購01,,,,,,0.00,0,0,0,0,0,0,0,0,0,0,0,0,0
20200430,710270,碩禾凱基99購01,1.22,1.22,1.20,1.21,+0.02,1.68,223000,7,268900,0,0,0,0,0,0,0,223000,-223000,-223000
20200430,710271,精測凱基99購06,0.67,0.67,0.66,0.66,+0.03,4.76,47000,7,31380,0,0,0,0,0,0,32000,15000,17000,17000
20200430,710272,環球晶凱基9B購01,1.21,1.34,1.21,1.33,+0.15,12.71,312000,15,404670,0,0,0,0,0,0,12000,302000,-290000,-290000
20200430,710273,穩懋凱基99購10,0.90,0.90,0.87,0.90,+0.08,9.76,280000,19,249000,0,0,0,0,0,0,230000,40000,190000,190000
20200430,710274,力致永豐99購04,1.93,2.04,1.89,1.96,+0.16,8.89,1257000,33,2512060,0,0,0,0,0,0,1116000,110000,1006000,1006000
20200430,710275,三貝德永豐99購03,1.22,1.23,1.20,1.23,+0.03,2.5,136000,9,164950,0,0,0,0,0,0,131000,5000,126000,126000
20200430,710276,宏捷科永豐99購06,1.38,1.38,1.36,1.36,+0.01,0.74,44000,6,60150,0,0,0,0,0,0,24000,20000,4000,4000
20200430,710277,杰力永豐99購01,1.63,1.63,1.60,1.62,0.00,0.0,151000,10,245120,0,0,0,0,0,0,128000,23000,105000,105000
20200430,710278,直得永豐99購01,1.70,2.05,1.70,2.00,+0.33,19.76,333000,29,601830,0,0,0,0,0,0,295000,33000,262000,262000
20200430,710279,威剛永豐99購05,1.63,1.63,1.59,1.59,0.00,0.0,13000,5,20850,0,0,0,0,0,0,3000,13000,-10000,-10000
20200430,710280,新鉅科永豐99購03,1.37,1.37,1.33,1.34,-0.02,-1.47,213000,8,288110,0,0,0,0,0,0,200000,13000,187000,187000
20200430,710281,碩禾永豐99購03,1.11,1.12,1.11,1.12,+0.03,2.75,13000,2,14530,0,0,0,0,0,0,0,13000,-13000,-13000
20200430,710282,精測永豐99購04,0.58,0.58,0.58,0.58,+0.05,9.43,6000,2,3480,0,0,0,0,0,0,0,6000,-6000,-6000
20200430,710283,原相群益9A購01,1.24,1.24,1.21,1.22,0.00,0.0,156000,9,189810,0,0,0,0,0,0,119000,37000,82000,82000
20200430,710284,群聯群益9A購01,3.79,3.79,3.72,3.78,+0.25,7.08,80000,24,301290,0,0,0,0,0,0,80000,22000,58000,58000
20200430,710285,大江富邦9C購01,,,,,,0.00,0,0,0,0,0,0,0,0,0,0,0,0,0
20200430,710286,神盾元富9A購01,1.94,1.96,1.86,1.91,+0.05,2.69,237000,27,455180,0,0,0,0,0,0,168000,69000,99000,99000
20200430,710287,群聯元富9A購01,2.38,2.38,2.38,2.38,+0.15,6.73,45000,2,107100,0,0,0,0,0,0,45000,0,45000,45000
20200430,710288,環球晶元富9A購01,1.42,1.58,1.42,1.58,+0.19,13.67,181000,11,268880,0,0,0,0,0,0,51000,130000,-79000,-79000
20200430,710289,環球晶元富9A購02,2.52,2.78,2.52,2.78,+0.20,7.75,253000,12,679920,0,0,0,0,0,0,46000,207000,-161000,-161000
20200430,710290,穩懋元富9A購01,1.85,1.87,1.80,1.86,+0.15,8.77,541000,33,992510,0,0,0,0,0,0,464000,115000,349000,349000
20200430,710291,鈺太元富9A購01,2.75,2.77,2.64,2.70,-0.02,-0.74,569000,47,1534920,0,0,0,0,0,0,485000,5000,480000,480000
20200430,710292,弘塑元大9B購01,2.68,3.08,2.68,2.99,+0.39,15.0,511000,38,1458390,0,0,0,0,0,0,317000,234000,83000,83000
20200430,710293,金可元大9A購01,2.44,3.08,2.37,2.82,+0.39,16.05,1393000,76,3585730,0,0,0,0,0,0,811000,572000,239000,239000
20200430,710294,博智元大9A購01,2.97,3.13,2.95,3.01,+0.15,5.24,152000,12,463300,0,0,0,0,0,0,69000,82000,-13000,-13000
20200430,710295,群聯元大9A購02,3.06,3.06,3.00,3.01,+0.17,5.99,456000,25,1372100,0,0,0,0,0,0,154000,335000,-181000,-181000
20200430,710296,雍智元大9B購01,4.43,4.84,4.43,4.84,+0.57,13.35,120000,14,555060,0,0,0,0,0,0,0,120000,-120000,-120000
20200430,710297,環球晶元大9A購02,2.66,2.95,2.66,2.88,+0.35,13.83,437000,37,1236550,0,0,0,0,0,0,123000,407000,-284000,-284000
20200430,710298,穩懋元大9A購02,2.58,2.60,2.46,2.53,+0.21,9.05,181000,31,458420,0,0,0,0,0,0,61000,128000,-67000,-67000
20200430,710299,大中永豐9A購01,1.55,1.55,1.50,1.50,+0.01,0.67,320000,11,489100,0,0,0,0,0,0,273000,47000,226000,226000
20200430,710300,尼克森永豐9A購01,1.54,1.57,1.52,1.57,+0.03,1.95,94000,5,146190,0,0,0,0,0,0,53000,41000,12000,12000
20200430,710301,弘塑永豐9A購01,1.07,1.17,1.07,1.17,+0.10,9.35,167000,10,184550,0,0,0,0,0,0,86000,131000,-45000,-45000
20200430,710302,均豪永豐9A購01,,,,,,0.00,0,0,0,0,0,0,0,0,0,0,0,0,0
20200430,710303,迅得永豐9A購01,1.99,2.03,1.97,2.00,+0.04,2.04,106000,4,212440,0,0,0,0,0,0,106000,0,106000,106000
20200430,710304,波若威永豐9A購01,1.86,1.86,1.80,1.83,0.00,0.0,59000,3,107040,0,0,0,0,0,0,57000,2000,55000,55000
20200430,710305,前鼎永豐9A購01,1.92,1.92,1.86,1.89,-0.06,-3.08,24000,4,45350,0,0,0,0,0,0,3000,21000,-18000,-18000
20200430,710306,建榮永豐9B購01,2.15,2.15,2.10,2.10,+0.04,1.94,6000,2,12850,0,0,0,0,0,0,6000,0,6000,6000
20200430,710307,泰博永豐9A購01,1.20,1.20,1.20,1.20,-0.01,-0.83,20000,1,24000,0,0,0,0,0,0,20000,0,20000,20000
20200430,710308,神盾永豐9A購01,1.94,1.94,1.88,1.88,+0.01,0.53,63000,3,119700,0,0,0,0,0,0,63000,0,63000,63000
20200430,710309,高技永豐9A購01,1.84,1.84,1.80,1.80,-0.02,-1.1,76000,4,138770,0,0,0,0,0,0,76000,0,76000,76000
20200430,710310,博智永豐9A購02,0.95,1.00,0.94,0.96,+0.05,5.49,264000,8,254770,0,0,0,0,0,0,73000,206000,-133000,-133000
20200430,710311,群聯永豐9A購01,1.08,1.09,1.06,1.09,+0.08,7.92,123000,7,131780,0,0,0,0,0,0,117000,10000,107000,107000
20200430,710312,鈊象永豐9A購02,0.88,0.88,0.78,0.78,-0.09,-10.34,235000,5,187780,0,0,0,0,0,0,235000,0,235000,235000
20200430,710313,大中凱基9A購01,1.58,1.58,1.53,1.56,+0.03,1.96,186000,22,291210,0,0,0,0,0,0,186000,36000,150000,150000
20200430,710314,弘塑凱基9A購01,1.52,1.73,1.50,1.65,+0.19,13.01,629000,60,1004180,0,0,0,0,0,0,124000,503000,-379000,-379000
20200430,710315,良維凱基9A購01,1.60,1.63,1.58,1.63,+0.04,2.52,168000,11,268410,0,0,0,0,0,0,128000,84000,44000,44000
20200430,710316,胡連凱基9A購01,1.46,1.47,1.41,1.46,+0.07,5.04,129000,11,185030,0,0,0,0,0,0,84000,45000,39000,39000
20200430,710317,群聯凱基9B購01,1.27,1.28,1.26,1.28,+0.06,4.92,172000,14,219490,0,0,0,0,0,0,147000,27000,120000,120000
20200430,710318,環球晶凱基9A購02,1.36,1.51,1.36,1.51,+0.19,14.39,31000,7,45110,0,0,0,0,0,0,8000,25000,-17000,-17000
20200430,710319,穩懋凱基9A購02,1.11,1.12,1.07,1.09,+0.07,6.86,506000,25,557290,10000,0,10000,0,0,0,431000,73000,358000,368000
20200430,710320,鈊象國票9A購02,4.58,4.58,4.01,4.01,-0.40,-9.07,86000,9,370860,0,0,0,0,0,0,76000,24000,52000,52000
20200430,710321,弘塑康和9A購01,2.13,2.50,2.13,2.45,+0.39,18.93,406000,23,910610,0,0,0,0,0,0,136000,260000,-124000,-124000
20200430,710322,昇達科康和9A購01,2.76,2.81,2.76,2.81,+0.28,11.07,5000,2,13900,0,0,0,0,0,0,0,5000,-5000,-5000
20200430,710323,緯軟康和9A購01,2.04,2.29,2.04,2.07,+0.25,13.74,523000,16,1172840,0,0,0,0,0,0,16000,507000,-491000,-491000
20200430,710324,環球晶台新9A購01,1.53,1.53,1.53,1.53,+0.15,10.87,36000,3,55080,0,0,0,0,0,0,0,36000,-36000,-36000
20200430,710325,三貝德國泰9C購01,1.40,1.40,1.39,1.39,+0.02,1.46,80000,5,111740,0,0,0,0,0,0,80000,0,80000,80000
20200430,710326,美琪瑪國泰9B購01,,,,,,0.00,0,0,0,0,0,0,0,0,0,0,0,0,0
20200430,710327,譜瑞國泰9C購01,2.07,2.09,2.03,2.09,+0.07,3.47,297000,14,616050,0,0,0,0,0,0,89000,208000,-119000,-119000
20200430,710328,精測台新9A購01,,,,,,0.00,0,0,0,0,0,0,0,0,0,0,0,0,0
20200430,710329,M31元大9A購02,3.24,3.40,3.24,3.39,+0.24,7.62,268000,17,904650,0,0,0,0,0,0,64000,233000,-169000,-169000
20200430,710330,元太元大9A購01,4.29,4.37,4.22,4.37,+0.15,3.55,67000,8,289050,0,0,0,0,0,0,11000,60000,-49000,-49000
20200430,710331,世界元大9A購01,3.71,3.84,3.68,3.84,+0.25,6.96,107000,16,403880,0,0,0,0,0,0,40000,72000,-32000,-32000
20200430,710332,良維元大9A購01,4.01,4.01,3.93,4.01,+0.01,0.25,142000,11,562300,0,0,0,0,0,0,106000,36000,70000,70000
20200430,710333,信驊元大9A購01,3.41,3.45,3.35,3.45,+0.21,6.48,69000,8,235350,0,0,0,0,0,0,69000,21000,48000,48000
20200430,710334,威剛元大9A購04,3.98,3.98,3.93,3.93,+0.02,0.51,15000,2,59450,0,0,0,0,0,0,15000,0,15000,15000
20200430,710335,精測元大9A購01,1.72,1.78,1.68,1.71,+0.06,3.64,256000,23,444260,0,0,0,0,0,0,201000,139000,62000,62000
20200430,710336,頎邦元大9A購01,2.18,2.40,2.12,2.40,+0.31,14.83,1006000,86,2230570,0,0,0,0,0,0,647000,363000,284000,284000
20200430,710337,杰力群益9C購01,2.28,2.28,2.25,2.26,0.00,0.0,66000,5,149920,0,0,0,0,0,0,66000,0,66000,66000
20200430,710338,保瑞群益9B購01,1.24,1.25,1.24,1.25,+0.05,4.17,13000,3,16130,0,0,0,0,0,0,0,13000,-13000,-13000
20200430,710339,網龍群益9C購01,,,,,,0.00,0,0,0,0,0,0,0,0,0,0,0,0,0
20200430,710340,兆利凱基9C購01,1.38,1.38,1.35,1.35,+0.02,1.5,144000,10,195840,0,0,0,0,0,0,144000,0,144000,144000
20200430,710341,威剛凱基9A購04,1.82,1.82,1.82,1.82,+0.06,3.41,2000,2,3640,0,0,0,0,0,0,2000,2000,0,0
20200430,710342,泰博凱基9A購02,,,,,,0.00,0,0,0,0,0,0,0,0,0,0,0,0,0
20200430,710343,網龍凱基9C購01,2.86,2.86,2.74,2.74,-0.30,-9.87,24000,3,67440,0,0,0,0,0,0,14000,10000,4000,4000
20200430,710344,聚積凱基9C購01,1.51,1.51,1.49,1.49,+0.02,1.36,10000,2,15000,0,0,0,0,0,0,0,10000,-10000,-10000
20200430,710345,穩懋麥證9A購01,,,,,,0.00,0,0,0,0,0,0,0,0,0,0,0,0,0
20200430,710346,弘塑元富9A購01,2.75,3.11,2.71,3.08,+0.44,16.67,264000,28,776620,0,0,0,0,0,0,24000,240000,-216000,-216000
20200430,710347,弘塑元富9A購02,2.16,2.44,2.12,2.35,+0.24,11.37,1008000,52,2291530,0,0,0,0,0,0,102000,906000,-804000,-804000
20200430,710348,神盾元富9B購02,2.61,2.63,2.51,2.51,+0.05,2.03,165000,38,427360,0,0,0,0,0,0,92000,23000,69000,69000
20200430,710349,精華元富9A購01,3.55,3.99,3.51,3.99,+0.62,18.4,173000,27,644380,0,0,0,0,0,0,60000,134000,-74000,-74000
20200430,710350,宏捷科國票9A購02,4.71,4.71,4.71,4.71,-0.14,-2.89,3000,1,14130,0,0,0,0,0,0,3000,0,3000,3000
20200430,710351,原相國票9B購01,,,,,,0.00,0,0,0,0,0,0,0,0,0,0,0,0,0
20200430,710352,神盾國票9B購01,2.07,2.07,2.07,2.07,-0.01,-0.48,10000,1,20700,0,0,0,0,0,0,10000,0,10000,10000
20200430,710353,神盾國票9C購01,2.43,2.43,2.33,2.34,+0.01,0.43,211000,7,505420,0,0,0,0,0,0,181000,30000,151000,151000
20200430,710354,博智康和9A購01,1.03,1.11,1.03,1.06,+0.07,7.07,2319000,35,2489420,0,0,0,0,0,0,959000,1360000,-401000,-401000
20200430,710355,新普康和9A購01,2.47,2.55,2.43,2.51,+0.14,5.91,202000,10,496920,0,0,0,0,0,0,192000,128000,64000,64000
20200430,710356,精測康和9A購01,0.97,0.98,0.96,0.96,+0.06,6.67,18000,9,17470,0,0,0,0,0,0,18000,0,18000,18000
20200430,710357,應華康和9A購01,3.23,3.23,2.98,2.98,-0.30,-9.15,131000,15,405150,0,0,0,0,0,0,66000,65000,1000,1000
20200430,710358,世禾永豐9A購01,1.14,1.18,1.12,1.18,+0.08,7.27,139000,4,158470,0,0,0,0,0,0,105000,34000,71000,71000
20200430,710359,光隆永豐9A購01,,,,,,0.00,0,0,0,0,0,0,0,0,0,0,0,0,0
20200430,710360,宇峻永豐9A購01,1.33,1.33,1.28,1.28,-0.06,-4.48,217000,13,287000,0,0,0,0,0,0,202000,15000,187000,187000
20200430,710361,佳邦永豐9A購01,,,,,,0.00,0,0,0,0,0,0,0,0,0,0,0,0,0
20200430,710362,振曜永豐9A購01,,,,,,0.00,0,0,0,0,0,0,0,0,0,0,0,0,0
20200430,710363,盛弘永豐9A購01,2.38,2.70,2.18,2.24,-0.09,-3.86,853000,173,2030740,0,0,0,0,0,0,30000,258000,-228000,-228000
20200430,710364,新潤永豐9A購01,,,,,,0.00,0,0,0,0,0,0,0,0,0,0,0,0,0
20200430,710365,是方國泰9B購01,1.52,1.52,1.42,1.48,+0.02,1.37,105000,17,154780,0,0,0,0,0,0,83000,2000,81000,81000
20200430,710366,原相國泰9B購01,1.81,1.81,1.78,1.80,-0.04,-2.17,61000,10,109250,0,0,0,0,0,0,54000,7000,47000,47000
20200430,710367,建榮永豐9A購03,2.39,2.39,2.39,2.39,+0.37,18.32,20000,2,47800,0,0,0,0,0,0,0,20000,-20000,-20000
20200430,710368,是方永豐9A購01,1.03,1.04,0.98,0.98,+0.01,1.03,490000,27,488760,0,0,0,0,0,0,421000,61000,360000,360000
20200430,710369,森鉅永豐9A購01,1.08,1.09,1.08,1.09,+0.01,0.93,25000,2,27050,0,0,0,0,0,0,25000,0,25000,25000
20200430,710370,磐亞永豐9A購01,0.81,0.83,0.79,0.79,0.00,0.0,590000,18,476000,0,0,0,0,0,0,45000,444000,-399000,-399000
20200430,710371,寶雅永豐9A購01,1.44,1.45,1.36,1.36,-0.08,-5.56,82000,5,115740,0,0,0,0,0,0,82000,0,82000,82000
20200430,710372,原相群益9A購02,3.50,3.50,3.50,3.50,+0.09,2.64,10000,1,35000,0,0,0,0,0,0,0,10000,-10000,-10000
20200430,710373,精華元富9A購02,2.17,2.44,2.14,2.40,+0.32,15.38,246000,26,551000,0,0,0,0,0,0,62000,205000,-143000,-143000
20200430,710374,譜瑞元富9A購01,1.62,1.65,1.58,1.64,+0.06,3.8,157000,10,254350,0,0,0,0,0,0,84000,73000,11000,11000
20200430,710375,原相元大9B購02,,,,,,0.00,0,0,0,0,0,0,0,0,0,0,0,0,0
20200430,710376,泰博元大9C購01,1.37,1.37,1.30,1.32,0.00,0.0,155000,8,209320,0,0,0,0,0,0,151000,25000,126000,126000
20200430,710377,新鉅科元大9B購01,3.41,3.41,3.25,3.25,-0.09,-2.69,40000,5,133630,0,0,0,0,0,0,33000,7000,26000,26000
20200430,710378,群聯元大9A購03,2.93,2.94,2.87,2.90,+0.16,5.84,483000,23,1393140,0,0,0,0,0,0,171000,354000,-183000,-183000
20200430,710379,精測元大9A購02,1.52,1.55,1.51,1.54,+0.06,4.05,118000,12,182030,0,0,0,0,0,0,91000,104000,-13000,-13000
20200430,710380,鈊象元大9A購02,2.00,2.01,1.78,1.79,-0.15,-7.73,936000,23,1764920,0,0,0,0,0,0,525000,513000,12000,12000
20200430,710381,鈊象元大9B購01,1.92,1.93,1.74,1.75,-0.14,-7.41,436000,26,793610,0,0,0,0,0,0,241000,211000,30000,30000
20200430,710382,凡甲凱基9A購01,2.03,2.13,2.02,2.02,-0.11,-5.16,361000,16,744480,0,0,0,0,0,0,159000,202000,-43000,-43000
20200430,710383,凡甲凱基9A購02,1.39,1.45,1.38,1.40,0.00,0.0,97000,9,137130,0,0,0,0,0,0,50000,47000,3000,3000
20200430,710384,威剛凱基9B購02,2.20,2.20,2.20,2.20,+0.01,0.46,3000,2,6600,0,0,0,0,0,0,3000,3000,0,0
20200430,710385,博智凱基9A購02,1.18,1.25,1.18,1.20,+0.06,5.26,361000,14,437700,0,0,0,0,0,0,307000,54000,253000,253000
20200430,710386,大江國票9A購03,,,,,,0.00,0,0,0,0,0,0,0,0,0,0,0,0,0
20200430,710387,穩懋國票9A購02,2.40,2.44,2.28,2.28,+0.10,4.59,115000,5,272100,0,0,0,0,0,0,65000,115000,-50000,-50000
20200430,710388,鈊象國票9B購02,3.22,3.22,2.86,2.89,-0.23,-7.37,82000,10,251230,0,0,0,0,0,0,56000,34000,22000,22000
20200430,710389,原相台新9A購02,,,,,,0.00,0,0,0,0,0,0,0,0,0,0,0,0,0
20200430,710390,M31群益9A購02,1.89,1.93,1.89,1.91,+0.12,6.7,113000,6,216250,0,0,0,0,0,0,20000,110000,-90000,-90000
20200430,710391,原相元大9B購03,2.32,2.34,2.32,2.34,-0.01,-0.43,27000,4,62760,0,0,0,0,0,0,20000,7000,13000,13000
20200430,710392,精測元大9A購03,1.14,1.15,1.12,1.15,+0.05,4.55,153000,9,175170,0,0,0,0,0,0,124000,97000,27000,27000
20200430,710393,雙鴻元大9C購01,4.32,4.32,4.24,4.24,+0.09,2.17,57000,5,243710,0,0,0,0,0,0,57000,2000,55000,55000
20200430,710394,鈊象元大9C購01,1.66,1.66,1.51,1.51,-0.11,-6.79,76000,8,120020,0,0,0,0,0,0,18000,58000,-40000,-40000
20200430,710395,神盾富邦01購01,1.00,1.01,0.94,0.98,+0.03,3.16,226000,44,224240,0,0,0,0,0,0,148000,50000,98000,98000
20200430,710396,雙鴻富邦9B購01,1.08,1.10,1.04,1.06,-0.01,-0.93,538000,17,580610,0,0,0,0,0,0,179000,376000,-197000,-197000
20200430,710397,群聯中信9C購01,0.92,0.92,0.91,0.92,+0.04,4.55,49000,3,44910,0,0,0,0,0,0,49000,0,49000,49000
20200430,710398,精測中信9A購02,0.70,0.73,0.69,0.69,+0.03,4.55,191000,8,136760,0,0,0,0,0,0,10000,181000,-171000,-171000
20200430,710399,環球晶中信9A購02,,,,,,0.00,0,0,0,0,0,0,0,0,0,0,0,0,0
20200430,710400,中美晶永豐9A購01,1.72,1.83,1.72,1.78,+0.09,5.33,179000,21,315700,0,0,0,0,0,0,31000,160000,-129000,-129000
20200430,710401,建榮永豐9A購04,1.65,1.65,1.65,1.65,+0.22,15.38,55000,1,90750,0,0,0,0,0,0,55000,0,55000,55000
20200430,710402,神盾永豐9A購02,1.74,1.74,1.64,1.64,-0.07,-4.09,28000,3,46820,0,0,0,0,0,0,28000,0,28000,28000
20200430,710403,閎康永豐9A購01,1.81,1.82,1.76,1.77,-0.17,-8.76,60000,8,106960,0,0,0,0,0,0,60000,9000,51000,51000
20200430,710404,雙鴻永豐9A購02,1.84,1.84,1.79,1.79,+0.03,1.7,107000,6,193640,0,0,0,0,0,0,1000,107000,-106000,-106000
20200430,710405,大學光凱基9A購03,2.62,2.62,2.62,2.62,-0.10,-3.68,2000,1,5240,0,0,0,0,0,0,2000,0,2000,2000
20200430,710406,中美晶凱基9A購04,1.92,2.08,1.92,2.04,+0.10,5.15,338000,29,679480,0,0,0,0,0,0,134000,216000,-82000,-82000
20200430,710407,泰博凱基9B購01,1.36,1.36,1.35,1.35,-0.02,-1.46,2000,2,2710,0,0,0,0,0,0,0,2000,-2000,-2000
20200430,710408,博智凱基9B購01,1.60,1.61,1.56,1.56,+0.04,2.63,24000,5,38130,0,0,0,0,0,0,0,23000,-23000,-23000
20200430,710409,環球晶凱基9B購02,1.94,2.06,1.94,2.06,+0.22,11.96,170000,12,338960,0,0,0,0,0,0,8000,170000,-162000,-162000
20200430,710410,雙鴻凱基9A購02,2.94,2.94,2.94,2.94,+0.06,2.08,10000,1,29400,0,0,0,0,0,0,10000,0,10000,10000
20200430,710411,穩懋凱基9B購01,1.14,1.14,1.11,1.12,+0.09,8.74,151000,7,170170,0,0,0,0,0,0,100000,36000,64000,64000
20200430,710412,宇峻國票9B購01,1.60,1.60,1.51,1.51,-0.13,-7.93,683000,18,1062670,0,0,0,0,0,0,497000,186000,311000,311000
20200430,710413,威剛中信9B購01,0.91,0.91,0.90,0.90,+0.01,1.12,105000,4,94950,0,0,0,0,0,0,80000,25000,55000,55000
20200430,710414,雙鴻中信9A購01,1.66,1.66,1.66,1.66,+0.07,4.4,1000,1,1660,0,0,0,0,0,0,1000,1000,0,0
20200430,710415,原相元大9A購05,1.45,1.45,1.41,1.43,0.00,0.0,797000,34,1133860,0,0,0,0,0,0,192000,584000,-392000,-392000
20200430,710416,神盾元大9B購02,2.14,2.18,2.05,2.10,+0.06,2.94,418000,23,874800,0,0,0,0,0,0,354000,114000,240000,240000
20200430,710417,博智元大9B購01,1.25,1.32,1.23,1.25,+0.05,4.17,344000,22,440280,0,0,0,0,0,0,65000,275000,-210000,-210000
20200430,710418,群聯元大9A購05,2.03,2.03,2.00,2.03,+0.14,7.41,206000,12,416920,0,0,0,0,0,0,206000,34000,172000,172000
20200430,710419,雙鴻元大9B購01,2.10,2.10,2.05,2.05,-0.03,-1.44,60000,7,125130,0,0,0,0,0,0,6000,54000,-48000,-48000
20200430,710420,鈊象元大9B購02,1.24,1.25,1.12,1.12,-0.08,-6.67,619000,29,724050,0,0,0,0,0,0,470000,146000,324000,324000
20200430,710421,宏捷科永豐9A購01,1.32,1.33,1.31,1.31,-0.11,-7.75,33000,3,43620,0,0,0,0,0,0,32000,1000,31000,31000
20200430,710422,昇達科永豐9A購01,1.17,1.17,1.17,1.17,+0.10,9.35,125000,2,146250,0,0,0,0,0,0,0,125000,-125000,-125000
20200430,710423,晶焱永豐9A購02,1.59,1.62,1.59,1.62,+0.07,4.52,121000,8,193480,0,0,0,0,0,0,33000,88000,-55000,-55000
20200430,710424,業強永豐9A購01,1.02,1.02,0.99,0.99,0.00,0.0,95000,2,94650,0,0,0,0,0,0,20000,75000,-55000,-55000
20200430,710425,頎邦永豐9A購01,1.01,1.12,1.01,1.12,+0.14,14.29,151000,11,157860,0,0,0,0,0,0,65000,76000,-11000,-11000
20200430,710426,宏捷科凱基9A購02,1.05,1.05,1.02,1.02,-0.04,-3.77,80000,2,83100,0,0,0,0,0,0,80000,0,80000,80000
20200430,710427,神盾凱基9B購02,2.03,2.03,1.89,1.93,+0.01,0.52,77000,16,152850,0,0,0,0,0,0,67000,0,67000,67000
20200430,710428,群聯凱基9B購02,1.85,1.86,1.85,1.86,+0.11,6.29,29000,5,53900,0,0,0,0,0,0,29000,29000,0,0
20200430,710429,群聯麥證9B購01,2.41,2.41,2.41,2.41,+0.18,8.07,9000,3,21690,2000,7000,-5000,0,0,0,2000,7000,-5000,-5000
20200430,710430,宏捷科國泰9B購03,2.16,2.16,2.01,2.03,-0.04,-1.93,468000,90,991840,0,0,0,0,0,0,386000,241000,145000,145000
20200430,710431,宇峻群益9B購01,0.73,0.73,0.70,0.70,-0.04,-5.41,124000,4,89970,0,0,0,0,0,0,79000,45000,34000,34000
20200430,710432,泰博群益9B購01,0.87,0.87,0.84,0.84,0.00,0.0,261000,7,223840,0,0,0,0,0,0,100000,161000,-61000,-61000
20200430,710433,原相富邦9C購02,0.97,0.97,0.96,0.96,-0.01,-1.03,66000,5,63720,0,0,0,0,0,0,60000,6000,54000,54000
20200430,710434,群聯富邦9B購01,0.89,0.89,0.88,0.88,+0.05,6.02,153000,11,135290,0,0,0,0,0,0,128000,25000,103000,103000
20200430,710435,旺矽元富9A購01,1.65,1.83,1.64,1.80,+0.17,10.43,759000,34,1315860,0,0,0,0,0,0,182000,577000,-395000,-395000
20200430,710436,威剛元富9A購01,3.50,3.50,3.46,3.46,+0.12,3.59,17000,2,59100,0,0,0,0,0,0,0,17000,-17000,-17000
20200430,710437,威剛元富9A購02,2.87,2.87,2.82,2.82,+0.11,4.06,20000,2,56900,0,0,0,0,0,0,0,20000,-20000,-20000
20200430,710438,泰博元富9A購01,2.24,2.24,2.24,2.24,-0.10,-4.27,10000,1,22400,0,0,0,0,0,0,0,10000,-10000,-10000
20200430,710439,泰博元富9A購02,2.12,2.12,2.06,2.06,-0.01,-0.48,20000,2,41800,0,0,0,0,0,0,10000,10000,0,0
20200430,710440,雙鴻元富9A購01,,,,,,0.00,0,0,0,0,0,0,0,0,0,0,0,0,0
20200430,710441,鈊象元富9A購01,2.58,2.58,2.56,2.56,+0.09,3.64,26000,2,66760,0,0,0,0,0,0,26000,0,26000,26000
20200430,710442,鈊象元富9A購02,2.90,2.90,2.87,2.87,+0.09,3.24,19000,2,54740,0,0,0,0,0,0,19000,0,19000,19000
20200430,710443,威剛國泰9C購01,2.16,2.18,2.12,2.12,+0.05,2.42,191000,15,409770,40000,0,40000,0,0,0,104000,91000,13000,53000
20200430,710444,雙鴻國泰9C購01,2.34,2.36,2.31,2.34,+0.08,3.54,60000,4,139940,0,0,0,0,0,0,39000,38000,1000,1000
20200430,710445,博智群益9A購01,0.97,1.00,0.96,0.99,+0.05,5.32,312000,8,305460,0,0,0,0,0,0,168000,150000,18000,18000
20200430,710446,神盾凱基9A購02,1.64,1.64,1.52,1.58,+0.03,1.94,285000,35,450450,0,0,0,0,0,0,212000,70000,142000,142000
20200430,710447,群聯凱基9A購04,1.61,1.61,1.61,1.61,+0.10,6.62,25000,2,40250,0,0,0,0,0,0,25000,25000,0,0
20200430,710448,優群凱基9A購04,1.61,1.61,1.55,1.55,-0.10,-6.06,103000,5,163230,0,0,0,0,0,0,103000,0,103000,103000
20200430,710449,環球晶凱基9C購01,1.62,1.72,1.61,1.71,+0.14,8.92,439000,22,731490,0,0,0,0,0,0,214000,225000,-11000,-11000
20200430,710450,雙鴻凱基9B購01,2.11,2.12,2.09,2.09,+0.07,3.47,110000,5,230400,0,0,0,0,0,0,10000,100000,-90000,-90000
20200430,710451,穩懋凱基9C購01,1.08,1.09,1.05,1.07,+0.07,7.0,501000,19,536560,0,0,0,0,0,0,447000,53000,394000,394000
20200430,710452,鈊象凱基9A購03,,,,,,0.00,0,0,0,0,0,0,0,0,0,0,0,0,0
20200430,710453,鈊象第一9A購01,0.74,0.74,0.74,0.74,-0.04,-5.13,13000,1,9620,0,0,0,0,0,0,0,13000,-13000,-13000
20200430,710454,精測中信9B購01,,,,,,0.00,0,0,0,0,0,0,0,0,0,0,0,0,0
20200430,710455,鈊象中信9A購01,0.84,0.84,0.84,0.84,+0.02,2.44,18000,1,15120,0,0,0,0,0,0,0,18000,-18000,-18000
20200430,710456,台半永豐9A購01,1.26,1.29,1.24,1.24,-0.02,-1.59,123000,9,156160,0,0,0,0,0,0,40000,83000,-43000,-43000
20200430,710457,台燿永豐9A購01,1.12,1.14,1.06,1.14,+0.16,16.33,475000,22,517020,0,0,0,0,0,0,319000,156000,163000,163000
20200430,710458,合晶永豐9A購01,1.09,1.19,1.09,1.19,+0.11,10.19,510000,11,580710,0,0,0,0,0,0,121000,394000,-273000,-273000
20200430,710459,宜特永豐9A購01,1.63,1.68,1.62,1.67,+0.03,1.83,159000,13,261770,0,0,0,0,0,0,81000,0,81000,81000
20200430,710460,旺矽永豐9A購01,1.18,1.28,1.18,1.28,+0.10,8.47,699000,20,859860,0,0,0,0,0,0,142000,557000,-415000,-415000
20200430,710461,信昌電永豐9A購01,1.36,1.46,1.36,1.40,+0.14,11.11,118000,10,164220,0,0,0,0,0,0,73000,50000,23000,23000
20200430,710462,威剛永豐9A購01,1.27,1.28,1.27,1.28,+0.06,4.92,11000,2,13980,0,0,0,0,0,0,1000,11000,-10000,-10000
20200430,710463,聚積永豐9A購01,1.23,1.23,1.22,1.22,+0.01,0.83,11000,3,13520,0,0,0,0,0,0,0,11000,-11000,-11000
20200430,710464,緯軟永豐9A購01,1.01,1.15,1.01,1.06,+0.12,12.77,301000,17,322920,0,0,0,0,0,0,0,301000,-301000,-301000
20200430,710465,優群永豐9A購02,1.28,1.28,1.28,1.28,-0.08,-5.88,5000,1,6400,0,0,0,0,0,0,5000,0,5000,5000
20200430,710466,環宇永豐9A購01,1.03,1.04,1.03,1.04,-0.01,-0.95,11000,2,11340,0,0,0,0,0,0,11000,0,11000,11000
20200430,710467,穩懋永豐9A購02,0.93,0.93,0.89,0.89,+0.10,12.66,160000,2,142480,0,0,0,0,0,0,158000,2000,156000,156000
20200430,710468,鈊象永豐9A購03,0.79,0.79,0.71,0.71,-0.08,-10.13,76000,4,56420,0,0,0,0,0,0,76000,0,76000,76000
20200430,710469,宏捷科元大9C購01,1.47,1.47,1.38,1.39,-0.03,-2.11,323000,17,460420,0,0,0,0,0,0,285000,38000,247000,247000
20200430,710470,信驊元大9A購02,1.70,1.76,1.69,1.74,+0.14,8.75,615000,34,1068360,0,0,0,0,0,0,217000,401000,-184000,-184000
20200430,710471,原相元大9B購04,1.64,1.64,1.60,1.61,0.00,0.0,94000,9,152350,0,0,0,0,0,0,69000,25000,44000,44000
20200430,710472,群聯元大9A購06,1.87,1.89,1.85,1.87,+0.11,6.25,277000,13,520180,0,0,0,0,0,0,122000,156000,-34000,-34000
20200430,710473,精測元大9A購04,1.93,1.99,1.89,1.92,+0.07,3.78,268000,17,521390,0,0,0,0,0,0,206000,130000,76000,76000
20200430,710474,環球晶富邦9C購01,0.81,0.91,0.81,0.91,+0.08,9.64,603000,16,512550,0,0,0,0,0,0,44000,560000,-516000,-516000
20200430,710475,聯亞富邦9B購02,1.12,1.12,0.98,1.03,-0.06,-5.5,3386000,153,3580170,0,0,0,0,0,0,2180000,934000,1246000,1246000
20200430,710476,鈊象富邦9B購01,0.66,0.66,0.57,0.59,-0.05,-7.81,687000,22,421710,0,0,0,0,0,0,343000,334000,9000,9000
20200430,710477,弘塑元大9A購01,2.34,2.64,2.34,2.62,+0.33,14.41,360000,40,889610,0,0,0,0,0,0,146000,264000,-118000,-118000
20200430,710478,神盾元大9A購05,1.94,1.98,1.81,1.90,+0.05,2.7,809000,49,1524630,0,0,0,0,0,0,645000,153000,492000,492000
20200430,710479,群聯元大9A購07,2.43,2.43,2.40,2.40,+0.14,6.19,10000,5,24180,0,0,0,0,0,0,10000,4000,6000,6000
20200430,710480,鈊象元大9B購03,2.31,2.33,2.05,2.11,-0.17,-7.46,40000,6,89890,0,0,0,0,0,0,34000,8000,26000,26000
20200430,710481,精測國泰9B購01,1.15,1.19,1.12,1.13,+0.05,4.63,1897000,77,2181120,0,0,0,0,0,0,1017000,934000,83000,83000
20200430,710482,威剛群益9A購03,2.05,2.07,1.98,1.99,+0.02,1.02,178000,10,360240,0,0,0,0,0,0,38000,148000,-110000,-110000
20200430,710483,雙鴻群益9A購01,2.71,2.73,2.64,2.65,+0.04,1.53,232000,12,625820,0,0,0,0,0,0,172000,187000,-15000,-15000
20200430,710484,鈊象群益9A購01,1.05,1.05,0.92,0.92,-0.10,-9.8,56000,8,56700,0,0,0,0,0,0,36000,20000,16000,16000
20200430,710485,譜瑞富邦9C購01,1.01,1.06,1.00,1.06,+0.07,7.07,337000,25,340870,0,0,0,0,0,0,252000,85000,167000,167000
20200430,710486,大江第一9A購01,,,,,,0.00,0,0,0,0,0,0,0,0,0,0,0,0,0
20200430,710487,環球晶第一9A購01,0.76,0.82,0.76,0.82,+0.10,13.89,179000,9,141840,0,0,0,0,0,0,3000,176000,-173000,-173000
20200430,710488,穩懋第一9A購01,0.73,0.81,0.73,0.79,+0.09,12.86,193000,22,151360,0,0,0,0,0,0,151000,23000,128000,128000
20200430,710489,力旺永豐9A購01,1.25,1.38,1.21,1.38,+0.20,16.95,356000,18,461650,0,0,0,0,0,0,165000,191000,-26000,-26000
20200430,710490,世界永豐9A購01,1.63,1.70,1.63,1.70,+0.12,7.59,132000,10,219650,0,0,0,0,0,0,43000,89000,-46000,-46000
20200430,710491,宇峻永豐9A購02,1.11,1.11,1.09,1.09,-0.05,-4.39,129000,5,142590,0,0,0,0,0,0,129000,0,129000,129000
20200430,710492,建榮永豐9B購02,1.62,1.71,1.59,1.59,+0.16,11.19,63000,3,102180,0,0,0,0,0,0,55000,8000,47000,47000
20200430,710493,原相永豐9A購02,1.13,1.13,1.13,1.13,0.00,0.0,1000,1,1130,0,0,0,0,0,0,0,1000,-1000,-1000
20200430,710494,博智國票9A購01,1.84,1.97,1.84,1.88,+0.09,5.03,183000,12,353150,0,0,0,0,0,0,3000,180000,-177000,-177000
20200430,710495,威剛統一9C購01,0.88,0.89,0.88,0.88,+0.02,2.33,415000,8,369150,0,0,0,0,0,0,30000,365000,-335000,-335000
20200430,710496,穩懋統一9C購01,1.08,1.08,1.03,1.07,+0.09,9.18,504000,15,539260,0,0,0,0,0,0,442000,62000,380000,380000
20200430,710497,網家麥證9A購01,2.57,2.65,2.57,2.65,+0.02,0.76,23000,6,60460,19000,4000,15000,0,0,0,19000,4000,15000,15000
20200430,710498,建榮凱基9C購01,2.42,2.42,2.38,2.38,+0.30,14.42,20000,2,48000,0,0,0,0,0,0,10000,10000,0,0
20200430,710499,網家國泰9B購01,2.05,2.14,2.00,2.06,+0.01,0.49,421000,39,880490,0,0,0,0,0,0,166000,244000,-78000,-78000
20200430,710500,弘塑群益9A購01,1.86,2.07,1.86,2.05,+0.27,15.17,431000,28,841460,0,0,0,0,0,0,72000,399000,-327000,-327000
20200430,710501,威剛元大9A購05,2.48,2.48,2.41,2.41,+0.02,0.84,277000,16,671560,0,0,0,0,0,0,158000,145000,13000,13000
20200430,710502,泰博元大9B購01,1.87,1.87,1.77,1.80,-0.06,-3.23,199000,16,362850,0,2000,-2000,0,0,0,199000,118000,81000,79000
20200430,710503,雙鴻元大9C購02,1.68,1.69,1.64,1.65,+0.03,1.85,375000,13,626600,0,0,0,0,0,0,158000,217000,-59000,-59000
20200430,710504,世界富邦9C購01,0.93,0.97,0.93,0.97,+0.07,7.78,752000,29,717760,0,0,0,0,0,0,152000,634000,-482000,-482000
20200430,710505,泰博富邦9B購01,0.92,0.95,0.92,0.95,+0.05,5.56,58000,9,53390,0,0,0,0,0,0,0,52000,-52000,-52000
20200430,710506,頎邦富邦9C購01,0.79,0.86,0.78,0.86,+0.10,13.16,1208000,49,967000,0,0,0,0,0,0,354000,855000,-501000,-501000
20200430,710507,宏捷科凱基9C購01,1.44,1.44,1.36,1.36,-0.07,-4.9,178000,17,253150,0,0,0,0,0,0,84000,94000,-10000,-10000
20200430,710508,南光凱基9A購01,1.66,1.66,1.66,1.66,-0.01,-0.6,6000,1,9960,0,0,0,0,0,0,0,6000,-6000,-6000
20200430,710509,建榮凱基9B購01,,,,,,0.00,0,0,0,0,0,0,0,0,0,0,0,0,0
20200430,710510,群聯凱基9B購03,,,,,,0.00,0,0,0,0,0,0,0,0,0,0,0,0,0
20200430,710511,網家凱基9A購01,2.65,2.73,2.62,2.73,-0.05,-1.8,215000,20,576320,0,0,0,0,0,0,102000,113000,-11000,-11000
20200430,710512,中美晶統一9A購01,0.88,0.94,0.87,0.93,+0.06,6.9,114000,9,101740,0,0,0,0,0,0,57000,57000,0,0
20200430,710513,雙鴻統一9C購01,1.07,1.07,1.03,1.05,+0.02,1.94,170000,11,179000,0,0,0,0,0,0,104000,62000,42000,42000
20200430,710514,穩懋統一9A購02,1.02,1.02,0.99,1.00,+0.10,11.11,178000,8,180040,0,0,0,0,0,0,128000,163000,-35000,-35000
20200430,710515,大學光永豐9A購02,2.78,2.78,2.64,2.64,-0.16,-5.71,70000,5,190340,0,0,0,0,0,0,58000,12000,46000,46000
20200430,710516,宇峻永豐9B購01,0.85,0.85,0.85,0.85,-0.02,-2.3,26000,1,22100,0,0,0,0,0,0,26000,0,26000,26000
20200430,710517,保瑞永豐9A購01,1.20,1.20,1.20,1.20,+0.02,1.69,10000,1,12000,0,0,0,0,0,0,0,10000,-10000,-10000
20200430,710518,建榮永豐9A購05,,,,,,0.00,0,0,0,0,0,0,0,0,0,0,0,0,0
20200430,710519,胡連永豐9A購01,1.10,1.11,1.08,1.08,+0.02,1.89,96000,7,104440,0,0,0,0,0,0,50000,46000,4000,4000
20200430,710520,泰博永豐9A購02,1.49,1.55,1.49,1.55,+0.01,0.65,85000,4,130700,0,0,0,0,0,0,0,85000,-85000,-85000
20200430,710521,神盾永豐9A購03,1.56,1.56,1.56,1.56,+0.07,4.7,6000,3,9360,0,0,0,0,0,0,6000,0,6000,6000
20200430,710522,博智永豐9A購03,1.15,1.21,1.14,1.16,+0.05,4.5,202000,9,234360,0,0,0,0,0,0,65000,144000,-79000,-79000
20200430,710523,網龍永豐9A購02,1.38,1.40,1.35,1.40,-0.08,-5.41,287000,11,398840,0,0,0,0,0,0,209000,78000,131000,131000
20200430,710524,大江國票9A購04,6.80,6.80,6.35,6.35,0.00,0.0,5000,3,33550,0,0,0,0,0,0,5000,2000,3000,3000
20200430,710525,弘塑國票9A購01,4.59,5.45,4.57,5.45,+0.97,21.65,209000,25,1030090,0,0,0,0,0,0,12000,197000,-185000,-185000
20200430,710526,網家國票9A購01,6.45,6.70,6.40,6.70,0.00,0.0,203000,19,1315650,0,0,0,0,0,0,95000,108000,-13000,-13000
20200430,710527,大江國泰9C購01,1.98,2.02,1.90,1.90,+0.02,1.06,298000,18,577450,0,0,0,0,0,0,226000,163000,63000,63000
20200430,710528,雍智群益9A購01,2.21,2.43,2.19,2.34,+0.25,11.96,466000,33,1073990,0,0,0,0,0,0,149000,290000,-141000,-141000
20200430,710529,威剛元大9A購06,2.51,2.59,2.51,2.52,+0.06,2.44,161000,8,406750,0,0,0,0,0,0,52000,111000,-59000,-59000
20200430,710530,泰博元大9A購01,2.42,2.42,2.28,2.30,-0.01,-0.43,164000,15,381260,0,0,0,0,0,0,102000,105000,-3000,-3000
20200430,710531,神盾元大9A購06,4.21,4.29,3.97,4.16,+0.15,3.74,90000,16,378560,0,0,0,0,0,0,88000,17000,71000,71000
20200430,710532,群聯元大9A購08,2.09,2.11,2.05,2.11,+0.13,6.57,77000,8,161230,0,0,0,0,0,0,52000,57000,-5000,-5000
20200430,710533,鈊象元大9B購04,2.99,2.99,2.65,2.65,-0.20,-7.02,17000,6,46100,0,0,0,0,0,0,7000,12000,-5000,-5000
20200430,710534,鈺太元大9B購01,2.19,2.22,2.13,2.13,-0.04,-1.84,153000,18,331890,1000,0,1000,0,0,0,127000,54000,73000,74000
20200430,710535,網家第一9A購01,1.01,1.04,0.99,0.99,-0.01,-1.0,378000,28,385800,0,0,0,0,0,0,319000,59000,260000,260000
20200430,710536,凡甲永豐9A購02,1.60,1.65,1.57,1.62,-0.04,-2.41,328000,9,523410,0,0,0,0,0,0,201000,127000,74000,74000
20200430,710537,金居永豐9A購01,1.29,1.41,1.27,1.41,+0.27,23.68,549000,32,730590,0,0,0,0,0,0,279000,270000,9000,9000
20200430,710538,原相永豐9A購04,,,,,,0.00,0,0,0,0,0,0,0,0,0,0,0,0,0
20200430,710539,華研永豐9A購01,0.82,0.88,0.82,0.88,+0.07,8.64,172000,4,147310,0,0,0,0,0,0,60000,112000,-52000,-52000
20200430,710540,群聯永豐9A購02,1.05,1.05,1.05,1.05,+0.05,5.0,74000,2,77700,0,0,0,0,0,0,74000,2000,72000,72000
20200430,710541,雍智永豐9A購01,1.26,1.35,1.26,1.35,+0.15,12.5,435000,15,562210,0,0,0,0,0,0,0,435000,-435000,-435000
20200430,710542,網家永豐9A購01,1.18,1.24,1.17,1.17,+0.01,0.86,179000,12,215240,0,0,0,0,0,0,94000,85000,9000,9000
20200430,710543,網龍永豐9A購03,1.26,1.26,1.21,1.21,-0.14,-10.37,283000,6,347510,0,0,0,0,0,0,233000,50000,183000,183000
20200430,710544,鈺太永豐9A購01,1.17,1.21,1.16,1.21,+0.11,10.0,105000,7,123730,0,0,0,0,0,0,42000,105000,-63000,-63000
20200430,710545,力旺凱基9A購01,1.51,1.65,1.46,1.64,+0.20,13.89,564000,42,882330,0,0,0,0,0,0,191000,363000,-172000,-172000
20200430,710546,宏捷科凱基9A購03,1.25,1.25,1.23,1.24,-0.01,-0.8,46000,11,57350,0,0,0,0,0,0,46000,0,46000,46000
20200430,710547,原相凱基9A購03,1.53,1.53,1.49,1.49,-0.12,-7.45,20000,2,30200,0,0,0,0,0,0,10000,10000,0,0
20200430,710548,泰博凱基9A購03,1.35,1.35,1.28,1.30,-0.01,-0.76,113000,8,149370,0,0,0,0,0,0,50000,83000,-33000,-33000
20200430,710549,精華凱基9A購01,0.86,1.00,0.86,0.99,+0.16,19.28,578000,35,538020,0,0,0,0,0,0,224000,423000,-199000,-199000
20200430,710550,網家凱基9C購01,1.22,1.26,1.20,1.20,-0.01,-0.83,481000,35,596170,0,0,0,0,0,0,175000,310000,-135000,-135000
20200430,710551,鈺太凱基9A購01,1.85,1.88,1.81,1.82,+0.16,9.64,105000,14,193480,0,0,0,0,0,0,30000,75000,-45000,-45000
20200430,710552,泰博統一9C購01,1.37,1.37,1.37,1.37,-0.04,-2.84,2000,1,2740,0,0,0,0,0,0,2000,2000,0,0
20200430,710553,穩懋統一9B購03,0.78,0.79,0.76,0.76,+0.05,7.04,213000,8,162910,0,0,0,0,0,0,172000,41000,131000,131000
20200430,710554,中美晶國票9A購04,2.00,2.13,2.00,2.10,+0.12,6.06,308000,9,645460,0,0,0,0,0,0,25000,283000,-258000,-258000
20200430,710555,宇峻國票9A購01,2.23,2.23,2.22,2.23,-0.02,-0.89,41000,5,91410,0,0,0,0,0,0,41000,0,41000,41000
20200430,710556,良維國票9A購01,3.75,3.87,3.75,3.87,+0.23,6.32,209000,6,788970,0,0,0,0,0,0,207000,209000,-2000,-2000
20200430,710557,優群國票9A購02,3.44,3.44,3.44,3.44,-0.18,-4.97,9000,1,30960,0,0,0,0,0,0,0,9000,-9000,-9000
20200430,710558,雙鴻國票9A購03,4.56,4.56,4.43,4.43,+0.11,2.55,115000,7,520430,0,0,0,0,0,0,47000,70000,-23000,-23000
20200430,710559,世界元大9A購03,2.91,3.02,2.88,3.00,+0.18,6.38,175000,16,514780,0,0,0,0,0,0,63000,137000,-74000,-74000
20200430,710560,宏捷科元大9B購02,1.14,1.14,1.14,1.14,-0.10,-8.06,25000,2,28500,0,0,0,0,0,0,20000,5000,15000,15000
20200430,710561,威剛元大9B購02,1.35,1.35,1.31,1.33,+0.03,2.31,1117000,20,1481300,0,0,0,0,0,0,587000,544000,43000,43000
20200430,710562,胡連元大9A購01,1.70,1.74,1.66,1.69,+0.07,4.32,190000,20,325200,0,0,0,0,0,0,123000,67000,56000,56000
20200430,710563,原相元大9A購08,2.05,2.05,2.05,2.05,+0.03,1.49,50000,1,102500,0,0,0,0,0,0,0,50000,-50000,-50000
20200430,710564,群聯元大9A購09,1.18,1.19,1.15,1.18,+0.08,7.27,161000,6,190360,0,0,0,0,0,0,31000,130000,-99000,-99000
20200430,710565,群聯元大9A購10,1.14,1.15,1.12,1.15,+0.09,8.49,145000,14,164220,0,0,0,0,0,0,119000,23000,96000,96000
20200430,710566,碩禾元大9B購01,1.21,1.22,1.21,1.21,+0.03,2.54,80000,3,97300,0,0,0,0,0,0,10000,70000,-60000,-60000
20200430,710567,優群元大9A購01,2.70,2.70,2.58,2.58,-0.26,-9.15,193000,4,506340,0,0,0,0,0,0,70000,123000,-53000,-53000
20200430,710568,鈊象兆豐9A購01,1.19,1.19,1.05,1.07,-0.08,-6.96,528000,29,583820,0,0,0,0,0,0,105000,423000,-318000,-318000
20200430,710569,中美晶富邦9B購04,0.78,0.83,0.78,0.82,+0.05,6.49,484000,14,389400,0,0,0,0,0,0,66000,419000,-353000,-353000
20200430,710570,宏捷科群益9A購01,1.45,1.45,1.43,1.43,-0.05,-3.38,70000,4,101380,0,0,0,0,0,0,70000,13000,57000,57000
20200430,710571,新鉅科群益9A購02,1.81,1.81,1.76,1.79,-0.02,-1.1,203000,4,362460,0,0,0,0,0,0,105000,98000,7000,7000
20200430,710572,網家群益9A購01,1.24,1.32,1.22,1.25,-0.03,-2.34,791000,38,1007800,0,0,0,0,0,0,272000,519000,-247000,-247000
20200430,710573,網龍群益9A購01,2.12,2.14,2.02,2.06,-0.16,-7.21,297000,16,618670,0,0,0,0,0,0,251000,46000,205000,205000
20200430,710574,鈊象群益9A購02,1.60,1.60,1.44,1.44,-0.10,-6.49,946000,13,1407300,0,0,0,0,0,0,437000,509000,-72000,-72000
20200430,710575,環球晶中信9B購01,0.67,0.76,0.67,0.75,+0.11,17.19,261000,7,178420,0,0,0,0,0,0,10000,251000,-241000,-241000
20200430,710576,M31永豐9A購01,1.31,1.38,1.28,1.37,+0.12,9.6,130000,8,172700,0,0,0,0,0,0,30000,100000,-70000,-70000
20200430,710577,大江永豐9A購01,1.03,1.03,0.98,0.98,0.00,0.0,58000,6,57590,0,0,0,0,0,0,3000,55000,-52000,-52000
20200430,710578,世界永豐9A購02,1.02,1.06,1.02,1.06,+0.08,8.16,49000,3,51340,0,0,0,0,0,0,15000,34000,-19000,-19000
20200430,710579,伍豐永豐9A購01,0.85,0.86,0.85,0.86,0.00,0.0,50000,2,42600,0,0,0,0,0,0,50000,0,50000,50000
20200430,710580,兆利永豐9A購01,0.99,0.99,0.97,0.97,+0.04,4.3,54000,2,52580,0,0,0,0,0,0,54000,0,54000,54000
20200430,710581,欣銓永豐9A購01,1.01,1.08,1.01,1.07,+0.06,5.94,271000,15,287310,0,0,0,0,0,0,59000,202000,-143000,-143000
20200430,710582,新鉅科永豐9A購01,0.95,0.96,0.95,0.96,-0.01,-1.03,80000,3,76300,0,0,0,0,0,0,80000,0,80000,80000
20200430,710583,精測永豐9A購02,0.49,0.49,0.49,0.49,+0.02,4.26,37000,3,18130,0,0,0,0,0,0,37000,0,37000,37000
20200430,710584,網家永豐9A購02,1.04,1.08,1.03,1.08,0.00,0.0,129000,6,137390,0,0,0,0,0,0,81000,48000,33000,33000
20200430,710585,穩懋麥證9A購02,,,,,,0.00,0,0,0,0,0,0,0,0,0,0,0,0,0
20200430,710586,原相統一9C購01,1.02,1.02,1.01,1.02,+0.01,0.99,36000,4,36620,0,0,0,0,0,0,36000,0,36000,36000
20200430,710587,宏捷科凱基9C購02,1.36,1.36,1.31,1.31,0.00,0.0,8000,2,10680,0,0,0,0,0,0,4000,4000,0,0
20200430,710588,信驊凱基9A購03,1.50,1.51,1.47,1.50,+0.12,8.7,126000,11,187950,0,0,0,0,0,0,60000,61000,-1000,-1000
20200430,710589,威剛凱基9A購05,1.46,1.46,1.43,1.44,+0.04,2.86,323000,7,465110,0,0,0,0,0,0,2000,323000,-321000,-321000
20200430,710590,鈺太凱基9B購01,1.46,1.46,1.43,1.43,+0.11,8.33,75000,8,109380,0,0,0,0,0,0,75000,0,75000,75000
20200430,710591,凡甲國票9A購01,3.77,3.85,3.73,3.76,-0.13,-3.34,161000,10,610770,0,0,0,0,0,0,83000,78000,5000,5000
20200430,710592,大江國票9A購05,1.86,1.86,1.73,1.73,+0.04,2.37,59000,3,106510,0,0,0,0,0,0,29000,41000,-12000,-12000
20200430,710593,弘塑國票9A購02,5.20,5.90,5.20,5.90,+0.75,14.56,113000,10,636250,0,0,0,0,0,0,3000,110000,-107000,-107000
20200430,710594,泰博國票9A購03,5.45,5.45,5.45,5.45,-0.10,-1.8,13000,1,70850,0,0,0,0,0,0,0,13000,-13000,-13000
20200430,710595,雍智國票9A購01,3.88,4.21,3.88,4.15,+0.26,6.68,154000,23,623890,0,0,0,0,0,0,0,154000,-154000,-154000
20200430,710596,大江元大9A購03,1.25,1.26,1.18,1.18,+0.01,0.85,149000,16,184370,0,0,0,0,0,0,134000,16000,118000,118000
20200430,710597,大學光元大9A購01,2.15,2.15,1.99,1.99,-0.14,-6.57,121000,11,252510,0,0,0,0,0,0,111000,10000,101000,101000
20200430,710598,原相元大9A購09,2.91,2.91,2.87,2.87,-0.04,-1.37,37000,4,106870,0,0,0,0,0,0,25000,12000,13000,13000
20200430,710599,泰博元大9A購02,2.36,2.36,2.26,2.31,+0.03,1.32,89000,9,206130,0,0,0,0,0,0,82000,81000,1000,1000
20200430,710600,群聯元大9A購11,2.96,2.96,2.88,2.93,+0.21,7.72,237000,29,690240,0,0,0,0,0,0,172000,82000,90000,90000
20200430,710601,精測元大9A購05,2.07,2.15,2.06,2.10,+0.11,5.53,371000,34,781300,0,0,0,0,0,0,324000,165000,159000,159000
20200430,710602,鈊象元大9A購04,2.99,3.00,2.72,2.72,-0.18,-6.21,105000,6,304730,0,0,0,0,0,0,70000,38000,32000,32000
20200430,710603,大江凱基9B購01,1.47,1.47,1.41,1.41,+0.01,0.71,22000,3,31680,0,0,0,0,0,0,10000,12000,-2000,-2000
20200430,710604,大學光凱基9A購04,1.70,1.70,1.70,1.70,-0.08,-4.49,40000,1,68000,0,0,0,0,0,0,40000,0,40000,40000
20200430,710605,原相凱基9B購01,,,,,,0.00,0,0,0,0,0,0,0,0,0,0,0,0,0
20200430,710606,太醫統一9C購01,0.72,0.72,0.68,0.68,-0.03,-4.23,296000,12,208560,0,0,0,0,0,0,171000,125000,46000,46000
20200430,710607,寶雅統一9C購01,1.02,1.02,0.96,0.96,-0.06,-5.88,337000,11,334070,0,0,0,0,0,0,277000,52000,225000,225000
20200430,710608,鈊象統一9A購02,0.87,0.87,0.79,0.80,-0.06,-6.98,397000,9,330050,0,0,0,0,0,0,230000,167000,63000,63000
20200430,710609,鈊象統一9A購03,0.87,0.87,0.79,0.79,-0.08,-9.2,24000,4,20710,0,0,0,0,0,0,21000,3000,18000,18000
20200430,710610,凡甲兆豐9A購01,1.64,1.68,1.63,1.65,-0.07,-4.07,151000,16,250680,0,0,0,0,0,0,151000,0,151000,151000
20200430,710611,泰博兆豐9A購01,1.53,1.53,1.46,1.50,0.00,0.0,485000,19,731260,0,0,0,0,0,0,215000,272000,-57000,-57000
20200430,710612,環球晶兆豐9B購01,1.41,1.56,1.40,1.56,+0.12,8.33,196000,21,293180,0,0,0,0,0,0,17000,179000,-162000,-162000
20200430,710613,聯亞兆豐9A購01,1.34,1.36,1.20,1.20,-0.14,-10.45,620000,24,812750,0,0,0,0,0,0,587000,33000,554000,554000
20200430,710614,雙鴻兆豐9B購01,1.76,1.80,1.76,1.78,+0.06,3.49,58000,5,103580,0,0,0,0,0,0,0,58000,-58000,-58000
20200430,710615,穩懋兆豐9A購03,1.06,1.07,1.00,1.03,+0.07,7.29,1239000,23,1270680,0,0,0,0,0,0,895000,1089000,-194000,-194000
20200430,710616,穩懋兆豐9B購01,2.36,2.37,2.24,2.28,+0.19,9.09,147000,12,341320,0,0,0,0,0,0,110000,37000,73000,73000
20200430,710617,大江永豐9A購02,0.94,0.94,0.89,0.89,-0.02,-2.2,200000,2,183000,0,0,0,0,0,0,100000,100000,0,0
20200430,710618,六角永豐9A購01,1.07,1.20,1.07,1.20,+0.16,15.38,500000,17,569110,0,0,0,0,0,0,0,500000,-500000,-500000
20200430,710619,太醫永豐9A購01,0.84,0.84,0.84,0.84,-0.01,-1.18,2000,1,1680,0,0,0,0,0,0,2000,0,2000,2000
20200430,710620,信昌電永豐9A購02,1.15,1.15,1.08,1.08,+0.07,6.93,99000,5,112760,0,0,0,0,0,0,99000,8000,91000,91000
20200430,710621,原相永豐9A購05,,,,,,0.00,0,0,0,0,0,0,0,0,0,0,0,0,0
20200430,710622,雍智永豐9A購02,1.13,1.22,1.10,1.22,+0.13,11.93,468000,16,548010,0,0,0,0,0,0,10000,458000,-448000,-448000
20200430,710623,碩禾永豐9A購01,0.95,0.95,0.95,0.95,+0.01,1.06,4000,1,3800,0,0,0,0,0,0,0,4000,-4000,-4000
20200430,710624,寶雅永豐9A購02,1.07,1.07,1.00,1.00,-0.10,-9.09,68000,3,68910,0,0,0,0,0,0,13000,55000,-42000,-42000
20200430,710625,大江國票9A購06,5.25,5.25,5.10,5.15,+0.15,3.0,4000,3,20600,0,0,0,0,0,0,4000,4000,0,0
20200430,710626,弘塑國票9A購03,2.53,2.87,2.47,2.86,+0.48,20.17,351000,33,907580,0,0,0,0,0,0,97000,254000,-157000,-157000
20200430,710627,宏捷科國票9A購03,1.31,1.31,1.23,1.23,-0.08,-6.11,18000,3,23060,0,0,0,0,0,0,13000,7000,6000,6000
20200430,710628,鈊象國票9A購04,6.65,6.80,6.60,6.60,-0.15,-2.22,26000,5,173250,0,0,0,0,0,0,26000,26000,0,0
20200430,710629,凡甲群益9A購01,1.40,1.44,1.39,1.39,-0.06,-4.14,67000,8,94130,0,0,0,0,0,0,48000,19000,29000,29000
20200430,710630,大江群益9A購01,1.36,1.36,1.35,1.35,-0.01,-0.74,102000,4,137800,0,0,0,0,0,0,92000,102000,-10000,-10000
20200430,710631,宇峻群益9A購03,1.06,1.06,1.00,1.02,-0.05,-4.67,1083000,29,1130960,0,0,0,0,0,0,755000,328000,427000,427000
20200430,710632,群聯群益9A購02,1.71,1.71,1.68,1.70,+0.14,8.97,192000,13,324840,0,0,0,0,0,0,162000,55000,107000,107000
20200430,710633,雙鴻群益9A購02,1.73,1.76,1.73,1.76,+0.04,2.33,95000,3,167140,0,0,0,0,0,0,61000,95000,-34000,-34000
20200430,710634,鈊象群益9A購03,1.14,1.14,1.06,1.06,-0.10,-8.62,123000,6,138840,0,0,0,0,0,0,98000,25000,73000,73000
20200430,710635,鈺太群益9A購01,1.29,1.34,1.29,1.34,+0.02,1.52,310000,13,411190,0,0,0,0,0,0,310000,23000,287000,287000
20200430,710636,寶雅凱基9A購01,1.10,1.10,1.04,1.06,-0.04,-3.64,582000,12,617940,0,0,0,0,0,0,582000,0,582000,582000
20200430,710637,原相統一9A購03,0.94,0.94,0.92,0.93,+0.01,1.09,73000,8,67960,0,0,0,0,0,0,23000,50000,-27000,-27000
20200430,710638,精測統一9B購01,0.79,0.80,0.76,0.77,+0.03,4.05,644000,24,499150,0,0,0,0,0,0,394000,250000,144000,144000
20200430,710639,穩懋統一9C購02,0.84,0.84,0.82,0.83,+0.07,9.21,357000,13,297010,0,0,0,0,0,0,109000,248000,-139000,-139000
20200430,710640,大江元大9A購04,1.31,1.31,1.23,1.23,-0.01,-0.81,147000,7,190930,0,0,0,0,0,0,69000,79000,-10000,-10000
20200430,710641,信驊元大9A購03,2.57,2.63,2.57,2.60,+0.15,6.12,56000,6,145180,0,0,0,0,0,0,46000,32000,14000,14000
20200430,710642,原相元大9A購10,1.84,1.84,1.81,1.81,+0.01,0.56,147000,11,268020,0,0,0,0,0,0,65000,82000,-17000,-17000
20200430,710643,泰博元大9B購02,2.49,2.49,2.34,2.34,-0.01,-0.43,94000,7,223460,0,0,0,0,0,0,94000,82000,12000,12000
20200430,710644,博智元大9A購02,1.59,1.68,1.57,1.60,+0.07,4.58,777000,39,1271320,0,0,0,0,0,0,85000,696000,-611000,-611000
20200430,710645,網家元大9A購01,2.60,2.71,2.55,2.60,+0.07,2.77,690000,81,1806120,50000,0,50000,0,0,0,356000,394000,-38000,12000
20200430,710646,優群元大9A購02,2.08,2.08,1.98,1.99,-0.10,-4.78,404000,10,816490,0,0,0,0,0,0,265000,139000,126000,126000
20200430,710647,威剛富邦9B購01,0.91,0.91,0.89,0.89,0.00,0.0,122000,3,108910,0,0,0,0,0,0,0,122000,-122000,-122000
20200430,710648,弘塑國泰9C購01,1.54,1.76,1.51,1.71,+0.24,16.33,1948000,67,3189960,0,0,0,0,0,0,434000,1513000,-1079000,-1079000
20200430,710649,神盾國泰9C購01,2.15,2.16,2.01,2.10,+0.05,2.44,597000,48,1263660,0,0,0,0,0,0,567000,30000,537000,537000
20200430,710650,新普國泰9C購01,1.85,1.89,1.85,1.89,+0.11,6.18,68000,5,127290,0,0,0,0,0,0,26000,42000,-16000,-16000
20200430,710651,信驊群益9A購01,2.55,2.58,2.55,2.58,+0.24,10.26,96000,3,247050,0,0,0,0,0,0,96000,21000,75000,75000
20200430,710652,原相中信03購01,0.96,0.96,0.95,0.95,-0.01,-1.04,25000,4,23970,0,0,0,0,0,0,10000,15000,-5000,-5000
20200430,710653,博智中信9A購01,0.69,0.75,0.69,0.71,+0.04,5.97,384000,8,276240,0,0,0,0,0,0,100000,284000,-184000,-184000
20200430,710654,弘塑永豐9A購02,0.98,1.14,0.98,1.14,+0.15,15.15,614000,18,639530,0,0,0,0,0,0,150000,514000,-364000,-364000
20200430,710655,佳邦永豐9A購02,,,,,,0.00,0,0,0,0,0,0,0,0,0,0,0,0,0
20200430,710656,博智永豐9A購04,0.86,0.91,0.86,0.88,+0.04,4.76,282000,10,252690,0,0,0,0,0,0,11000,282000,-271000,-271000
20200430,710657,閎康永豐9A購02,1.17,1.17,1.15,1.15,-0.03,-2.54,167000,6,194060,0,0,0,0,0,0,167000,6000,161000,161000
20200430,710658,順達永豐9A購01,1.06,1.09,1.06,1.08,-0.03,-2.7,93000,11,99850,0,0,0,0,0,0,60000,27000,33000,33000
20200430,710659,雍智永豐9A購03,1.57,1.74,1.57,1.67,+0.13,8.44,930000,72,1544670,0,0,0,0,0,0,444000,345000,99000,99000
20200430,710660,雙美永豐9A購01,1.02,1.02,1.02,1.02,-0.05,-4.67,25000,1,25500,0,0,0,0,0,0,0,25000,-25000,-25000
20200430,710661,良維兆豐9B購01,,,,,,0.00,0,0,0,0,0,0,0,0,0,0,0,0,0
20200430,710662,金居兆豐9A購01,1.76,1.91,1.72,1.91,+0.39,25.66,650000,54,1144930,0,0,0,0,0,0,533000,117000,416000,416000
20200430,710663,原相兆豐9B購01,1.28,1.28,1.25,1.25,-0.01,-0.79,70000,2,89300,0,0,0,0,0,0,70000,0,70000,70000
20200430,710664,神盾兆豐9B購01,1.42,1.42,1.34,1.34,-0.02,-1.47,153000,4,207850,0,0,0,0,0,0,153000,0,153000,153000
20200430,710665,新普兆豐9A購01,1.65,1.70,1.63,1.70,+0.05,3.03,233000,15,385340,0,0,0,0,0,0,204000,27000,177000,177000
20200430,710666,凡甲元大9A購03,2.43,2.46,2.43,2.46,+0.08,3.36,17000,2,41430,0,0,0,0,0,0,13000,4000,9000,9000
20200430,710667,泰博元大9A購03,4.06,4.06,3.86,3.86,-0.13,-3.26,34000,5,132640,0,0,0,0,0,0,27000,7000,20000,20000
20200430,710668,原相兆豐9B購02,1.17,1.17,1.17,1.17,-0.07,-5.65,70000,3,81900,0,0,0,0,0,0,10000,60000,-50000,-50000
20200430,710669,環球晶兆豐9B購02,1.20,1.36,1.20,1.36,+0.23,20.35,574000,14,719730,0,0,0,0,0,0,322000,252000,70000,70000
20200430,710670,雙美群益9B購01,,,,,,0.00,0,0,0,0,0,0,0,0,0,0,0,0,0
20200430,710671,大江富邦9C購02,0.82,0.82,0.76,0.76,0.00,0.0,238000,17,189420,0,0,0,0,0,0,78000,160000,-82000,-82000
20200430,710672,M31凱基9A購02,1.04,1.07,1.04,1.07,+0.09,9.18,268000,7,284990,0,0,0,0,0,0,0,268000,-268000,-268000
20200430,710673,大江凱基9A購02,1.14,1.14,1.09,1.09,+0.02,1.87,9000,3,10110,0,0,0,0,0,0,1000,8000,-7000,-7000
20200430,710674,原相凱基9A購06,,,,,,0.00,0,0,0,0,0,0,0,0,0,0,0,0,0
20200430,710675,群聯凱基9B購04,,,,,,0.00,0,0,0,0,0,0,0,0,0,0,0,0,0
20200430,710676,精測凱基9A購04,1.12,1.12,1.08,1.09,+0.06,5.83,439000,27,480430,0,0,0,0,0,0,346000,93000,253000,253000
20200430,710677,聯亞凱基9A購02,1.16,1.16,1.04,1.04,-0.09,-7.96,1460000,49,1596470,0,0,0,0,0,0,284000,1169000,-885000,-885000
20200430,710678,穩懋凱基9A購04,0.90,0.90,0.90,0.90,+0.07,8.43,100000,1,90000,0,0,0,0,0,0,100000,0,100000,100000
20200430,710679,譜瑞凱基9A購03,1.19,1.20,1.18,1.20,+0.04,3.45,245000,11,291760,0,0,0,0,0,0,115000,130000,-15000,-15000
20200430,710680,雙鴻第一9B購01,,,,,,0.00,0,0,0,0,0,0,0,0,0,0,0,0,0
20200430,710681,泰博中信9B購01,0.89,0.89,0.83,0.88,-0.01,-1.12,27000,6,23360,0,0,0,0,0,0,17000,10000,7000,7000
20200430,710682,精測中信9A購03,0.95,0.96,0.94,0.95,+0.04,4.4,35000,5,33300,0,0,0,0,0,0,15000,20000,-5000,-5000
20200430,710683,弘塑永豐9A購03,0.85,0.94,0.85,0.94,+0.13,16.05,337000,7,299410,0,0,0,0,0,0,4000,333000,-329000,-329000
20200430,710684,旺矽永豐9A購02,1.07,1.10,1.07,1.10,+0.09,8.91,212000,6,230570,0,0,0,0,0,0,154000,77000,77000,77000
20200430,710685,業強永豐9A購02,,,,,,0.00,0,0,0,0,0,0,0,0,0,0,0,0,0
20200430,710686,中美晶麥證9A購01,1.46,1.51,1.46,1.51,+0.10,7.09,75000,5,111200,11000,64000,-53000,0,0,0,11000,64000,-53000,-53000
20200430,710687,威剛麥證9B購01,,,,,,0.00,0,0,0,0,0,0,0,0,0,0,0,0,0
20200430,710688,博智統一9A購01,0.88,0.92,0.87,0.87,+0.03,3.57,669000,16,600210,0,0,0,0,0,0,286000,511000,-225000,-225000
20200430,710689,博智統一9A購02,1.11,1.16,1.11,1.11,+0.05,4.72,458000,13,514410,0,0,0,0,0,0,0,458000,-458000,-458000
20200430,710690,環球晶統一9C購01,0.99,1.10,0.99,1.10,+0.13,13.4,758000,34,794170,0,0,0,0,0,0,10000,738000,-728000,-728000
20200430,710691,群聯國泰9C購01,1.77,1.77,1.72,1.75,+0.11,6.71,277000,18,481190,0,0,0,0,0,0,214000,87000,127000,127000
20200430,710692,精測國泰9C購02,2.42,2.52,2.39,2.43,+0.11,4.74,1606000,72,3925470,0,0,0,0,0,0,567000,1106000,-539000,-539000
20200430,710693,優群國泰9B購01,1.68,1.69,1.68,1.69,-0.07,-3.98,9000,3,15180,0,0,0,0,0,0,0,9000,-9000,-9000
20200430,710694,晟德兆豐9B購01,1.31,1.31,1.24,1.27,-0.01,-0.78,336000,10,427330,0,0,0,0,0,0,271000,65000,206000,206000
20200430,710695,鈊象兆豐9B購01,1.30,1.30,1.17,1.17,-0.08,-6.4,775000,24,934110,0,0,0,0,0,0,335000,444000,-109000,-109000
20200430,710696,大江元大9A購05,,,,,,0.00,0,0,0,0,0,0,0,0,0,0,0,0,0
20200430,710697,信驊元大9A購05,1.88,1.90,1.88,1.90,+0.05,2.7,55000,6,104180,0,0,0,0,0,0,42000,34000,8000,8000
20200430,710698,雍智元大9A購01,2.17,2.34,2.17,2.27,+0.10,4.61,448000,37,1015130,0,0,0,0,0,0,126000,321000,-195000,-195000
20200430,710699,優群元大9A購03,2.64,2.64,2.60,2.60,-0.18,-6.47,133000,4,349990,0,95000,-95000,0,0,0,102000,38000,64000,-31000
20200430,710700,雙美元大9A購01,1.74,1.78,1.69,1.74,+0.04,2.35,1278000,25,2235340,0,0,0,0,0,0,670000,608000,62000,62000
20200430,710701,鈊象元大9A購05,2.88,2.91,2.61,2.61,-0.20,-7.12,32000,6,91730,0,0,0,0,0,0,30000,5000,25000,25000
20200430,710702,鈺太元大9A購02,1.51,1.51,1.46,1.46,-0.04,-2.67,336000,22,498060,0,0,0,0,0,0,226000,127000,99000,99000
20200430,710703,信驊群益9A購02,1.85,1.89,1.85,1.89,+0.08,4.42,135000,6,254350,0,0,0,0,0,0,41000,115000,-74000,-74000
20200430,710704,泰博群益9A購02,1.83,1.83,1.77,1.78,-0.06,-3.26,82000,6,148050,0,0,0,0,0,0,57000,25000,32000,32000
20200430,710705,精測群益9A購02,2.85,2.89,2.79,2.80,+0.11,4.09,558000,18,1581650,0,0,0,0,0,0,83000,479000,-396000,-396000
20200430,710706,精測永豐9A購03,1.54,1.57,1.52,1.55,+0.05,3.33,740000,24,1152070,0,0,0,0,0,0,255000,569000,-314000,-314000
20200430,710707,璟德永豐9A購01,1.30,1.31,1.28,1.28,+0.04,3.23,25000,4,32540,0,0,0,0,0,0,0,25000,-25000,-25000
20200430,710708,晟德永豐9A購01,1.18,1.18,1.18,1.18,-0.06,-4.84,10000,1,11800,0,0,0,0,0,0,10000,0,10000,10000
20200430,710709,頎邦永豐9A購02,0.83,0.91,0.83,0.91,+0.10,12.35,36000,3,31080,0,0,0,0,0,0,6000,36000,-30000,-30000
20200430,710710,群聯麥證9A購01,1.01,1.01,1.01,1.01,+0.05,5.21,3000,2,3030,0,3000,-3000,0,0,0,3000,3000,0,0
20200430,710711,穩懋統一9A購04,0.77,0.77,0.77,0.77,+0.09,13.24,5000,1,3850,0,0,0,0,0,0,0,5000,-5000,-5000
20200430,710712,M31凱基9A購03,1.07,1.08,1.07,1.08,+0.07,6.93,285000,8,306040,0,0,0,0,0,0,0,285000,-285000,-285000
20200430,710713,弘塑凱基9B購01,1.04,1.07,1.02,1.07,+0.04,3.88,464000,10,481770,0,0,0,0,0,0,264000,200000,64000,64000
20200430,710714,環球晶凱基9B購03,1.05,1.09,1.05,1.09,0.00,0.0,202000,2,220100,0,0,0,0,0,0,2000,202000,-200000,-200000
20200430,710715,穩懋凱基9A購05,1.47,1.47,1.45,1.46,+0.15,11.45,57000,11,83220,0,0,0,0,0,0,37000,0,37000,37000
20200430,710716,凡甲永豐9A購03,0.89,0.89,0.86,0.86,-0.06,-6.52,78000,4,67790,0,0,0,0,0,0,73000,0,73000,73000
20200430,710717,宏捷科永豐9B購01,1.12,1.12,1.07,1.07,-0.01,-0.93,23000,5,25580,0,0,0,0,0,0,22000,1000,21000,21000
20200430,710718,良維永豐9A購01,1.21,1.21,1.20,1.21,+0.02,1.68,79000,3,95390,0,0,0,0,0,0,75000,4000,71000,71000
20200430,710719,南光永豐9A購01,1.01,1.01,1.01,1.01,0.00,0.0,40000,2,40400,0,0,0,0,0,0,40000,0,40000,40000
20200430,710720,優群永豐9A購03,,,,,,0.00,0,0,0,0,0,0,0,0,0,0,0,0,0
20200430,710721,威剛統一9C購02,1.09,1.09,1.06,1.06,0.00,0.0,131000,12,141140,0,0,0,0,0,0,39000,96000,-57000,-57000
20200430,710722,宏捷科凱基9B購02,,,,,,0.00,0,0,0,0,0,0,0,0,0,0,0,0,0
20200430,710723,原相凱基9B購02,,,,,,0.00,0,0,0,0,0,0,0,0,0,0,0,0,0
20200430,710724,精測凱基9A購05,1.62,1.62,1.58,1.59,+0.06,3.92,180000,21,288640,0,0,0,0,0,0,139000,41000,98000,98000
20200430,710725,優群凱基9B購01,1.06,1.06,1.00,1.00,-0.07,-6.54,171000,10,176200,0,0,0,0,0,0,150000,21000,129000,129000
20200430,710726,頎邦凱基9A購01,1.59,1.70,1.59,1.67,+0.10,6.37,389000,21,632750,0,0,0,0,0,0,180000,211000,-31000,-31000
20200430,710727,凡甲元大9B購01,1.01,1.05,1.01,1.03,-0.03,-2.83,69000,6,72070,0,0,0,0,0,0,55000,64000,-9000,-9000
20200430,710728,弘塑元大9B購02,1.22,1.39,1.22,1.35,+0.17,14.41,383000,21,492600,0,0,0,0,0,0,135000,298000,-163000,-163000
20200430,710729,宏捷科元大9A購02,3.65,3.65,3.59,3.59,+0.10,2.87,15000,2,54210,0,0,0,0,0,0,15000,0,15000,15000
20200430,710730,威剛元大9B購03,1.09,1.09,1.07,1.08,+0.01,0.93,356000,18,386920,0,0,0,0,0,0,6000,350000,-344000,-344000
20200430,710731,網龍元大9A購03,2.79,2.81,2.69,2.69,-0.19,-6.6,173000,20,477710,0,0,0,0,0,0,136000,37000,99000,99000
20200430,710732,雙鴻元大9C購03,,,,,,0.00,0,0,0,0,0,0,0,0,0,0,0,0,0
20200430,710733,鈊象元大9A購06,2.32,2.34,2.15,2.15,-0.09,-4.02,91000,9,206240,0,0,0,0,0,0,51000,41000,10000,10000
20200430,710734,精測兆豐9B購01,0.80,0.81,0.79,0.79,+0.03,3.95,55000,9,43910,0,0,0,0,0,0,21000,30000,-9000,-9000
20200430,710735,鈺太兆豐9B購01,1.28,1.29,1.23,1.25,-0.03,-2.34,649000,27,823540,0,0,0,0,0,0,578000,69000,509000,509000
20200430,710736,宏捷科群益9A購02,1.51,1.51,1.49,1.49,+0.05,3.47,76000,5,114160,0,0,0,0,0,0,66000,23000,43000,43000
20200430,710737,璟德群益9A購01,2.09,2.20,2.09,2.20,+0.13,6.28,162000,6,356290,0,0,0,0,0,0,1000,161000,-160000,-160000
20200430,710738,宏捷科國票9A購04,4.17,4.17,3.87,3.87,-0.43,-10.0,8000,3,32980,0,0,0,0,0,0,8000,0,8000,8000
20200430,710739,南光國票9A購01,3.30,3.30,3.30,3.30,+0.01,0.3,10000,1,33000,0,0,0,0,0,0,10000,0,10000,10000
20200430,710740,優群國票9A購03,,,,,,0.00,0,0,0,0,0,0,0,0,0,0,0,0,0
20200430,710741,雙美國票9A購01,1.62,1.66,1.56,1.61,+0.07,4.55,591000,12,948730,0,0,0,0,0,0,225000,366000,-141000,-141000
20200430,710742,聯亞中信9A購01,1.04,1.11,0.97,1.01,-0.07,-6.48,623000,21,665370,0,0,0,0,0,0,459000,164000,295000,295000
20200430,710743,大學光元大9A購02,1.99,1.99,1.87,1.87,-0.12,-6.03,38000,5,73680,0,0,0,0,0,0,28000,10000,18000,18000
20200430,710744,太醫元大9A購01,1.20,1.20,1.17,1.17,-0.03,-2.5,64000,3,75240,0,0,0,0,0,0,62000,2000,60000,60000
20200430,710745,宏捷科元大9A購03,2.78,2.78,2.61,2.61,-0.04,-1.51,118000,2,309340,0,0,0,0,0,0,118000,0,118000,118000
20200430,710746,良維元大9A購02,2.22,2.22,2.19,2.19,-0.02,-0.9,122000,7,267680,0,0,0,0,0,0,122000,0,122000,122000
20200430,710747,信昌電元大9A購01,1.81,1.91,1.78,1.80,+0.11,6.51,187000,14,343750,0,0,0,0,0,0,65000,149000,-84000,-84000
20200430,710748,是方元大9A購01,1.62,1.63,1.51,1.53,-0.01,-0.65,567000,21,880710,0,0,0,0,0,0,352000,215000,137000,137000
20200430,710749,順達元大9A購01,1.76,1.76,1.72,1.72,0.00,0.0,89000,5,154450,0,0,0,0,0,0,89000,0,89000,89000
20200430,710750,群聯元大9B購01,1.31,1.33,1.31,1.32,+0.09,7.32,95000,6,125480,0,0,0,0,0,0,9000,95000,-86000,-86000
20200430,710751,璟德元大9A購01,1.72,1.77,1.67,1.74,+0.05,2.96,238000,21,414370,0,0,0,0,0,0,99000,134000,-35000,-35000
20200430,710752,鈊象元大9A購07,3.48,3.51,3.40,3.40,+0.03,0.89,7000,3,24340,0,0,0,0,0,0,7000,3000,4000,4000
20200430,710753,鈺太元大9A購03,2.02,2.04,1.95,2.04,+0.04,2.0,169000,14,337470,0,0,0,0,0,0,150000,28000,122000,122000
20200430,710754,精測富邦9B購01,0.56,0.58,0.56,0.56,+0.03,5.66,82000,11,46150,0,0,0,0,0,0,71000,11000,60000,60000
20200430,710755,良維群益9A購01,1.86,1.86,1.86,1.86,-0.04,-2.11,9000,2,16740,0,0,0,0,0,0,9000,0,9000,9000
20200430,710756,順達群益9B購01,2.51,2.51,2.47,2.47,-0.05,-1.98,67000,6,167290,0,0,0,0,0,0,62000,5000,57000,57000
20200430,710757,頎邦群益9B購01,2.04,2.17,2.04,2.17,+0.18,9.05,380000,22,810800,0,0,0,0,0,0,12000,380000,-368000,-368000
20200430,710758,凡甲國票9A購02,2.28,2.39,2.24,2.24,-0.11,-4.68,152000,11,346980,0,0,0,0,0,0,53000,99000,-46000,-46000
20200430,710759,優群國票9A購04,2.10,2.11,2.10,2.11,-0.11,-4.95,249000,3,524400,0,0,0,0,0,0,0,249000,-249000,-249000
20200430,710760,頎邦國票9A購01,3.64,4.17,3.64,4.17,+0.53,14.56,116000,16,443410,0,0,0,0,0,0,28000,88000,-60000,-60000
20200430,710761,穩懋中信9A購01,1.51,1.51,1.48,1.48,+0.13,9.63,22000,4,33060,0,0,0,0,0,0,22000,0,22000,22000
20200430,710762,穩懋中信9C購01,1.62,1.62,1.58,1.58,+0.10,6.76,58000,7,92120,0,0,0,0,0,0,10000,48000,-38000,-38000
20200430,710763,頎邦中信9A購01,0.75,0.85,0.75,0.85,+0.12,16.44,343000,17,269030,0,0,0,0,0,0,0,343000,-343000,-343000
20200430,710764,良維凱基9B購01,1.14,1.15,1.13,1.15,+0.04,3.6,172000,10,196570,0,0,0,0,0,0,122000,50000,72000,72000
20200430,710765,大學光永豐9A購03,1.19,1.19,1.19,1.19,-0.03,-2.46,1000,1,1190,0,0,0,0,0,0,1000,0,1000,1000
20200430,710766,泰博永豐9A購03,1.12,1.12,1.12,1.12,0.00,0.0,16000,1,17920,0,0,0,0,0,0,16000,0,16000,16000
20200430,710767,雙鴻永豐9B購01,,,,,,0.00,0,0,0,0,0,0,0,0,0,0,0,0,0
20200430,710768,中美晶統一9C購01,0.97,1.02,0.97,1.01,+0.04,4.12,690000,21,685660,0,0,0,0,0,0,181000,509000,-328000,-328000
20200430,710769,宏捷科統一9C購01,1.09,1.09,1.06,1.06,-0.01,-0.93,46000,8,49870,0,0,0,0,0,0,45000,1000,44000,44000
20200430,710770,中美晶兆豐9B購01,1.07,1.11,1.07,1.10,+0.07,6.8,84000,4,92080,0,0,0,0,0,0,0,84000,-84000,-84000
20200430,710771,金可兆豐9A購01,1.32,1.68,1.27,1.54,+0.18,13.24,1812000,84,2546820,0,0,0,0,0,0,561000,1187000,-626000,-626000
20200430,710772,穩懋兆豐9B購02,1.94,1.94,1.89,1.89,+0.12,6.78,136000,14,261270,0,0,0,0,0,0,113000,23000,90000,90000
20200430,710773,大學光元大9A購03,1.14,1.14,1.07,1.07,-0.07,-6.14,42000,4,46610,0,0,0,0,0,0,39000,3000,36000,36000
20200430,710774,新普元大9A購02,1.71,1.71,1.71,1.71,+0.07,4.27,10000,1,17100,0,0,0,0,0,0,0,10000,-10000,-10000
20200430,710775,雍智元大9A購02,1.42,1.56,1.42,1.51,+0.08,5.59,873000,34,1300660,0,0,0,0,0,0,155000,718000,-563000,-563000
20200430,710776,精華元大9A購01,1.85,2.11,1.81,2.06,+0.30,17.05,1200000,40,2264790,0,0,0,0,0,0,457000,756000,-299000,-299000
20200430,710777,聚積元大9A購02,,,,,,0.00,0,0,0,0,0,0,0,0,0,0,0,0,0
20200430,710778,璟德元大9A購02,2.44,2.58,2.44,2.49,0.00,0.0,186000,19,470080,0,0,0,0,0,0,0,186000,-186000,-186000
20200430,710779,頎邦元大9A購03,2.66,2.93,2.66,2.93,+0.32,12.26,300000,24,835250,0,0,0,0,0,0,68000,262000,-194000,-194000
20200430,710780,群聯群益9A購03,1.18,1.20,1.17,1.20,+0.11,10.09,76000,8,89830,0,0,0,0,0,0,22000,76000,-54000,-54000
20200430,710781,大學光凱基9A購05,0.89,0.89,0.82,0.82,-0.07,-7.87,40000,9,33820,5000,0,5000,0,0,0,4000,36000,-32000,-27000
20200430,710782,精測凱基9A購07,2.64,2.70,2.64,2.67,+0.17,6.8,20000,4,53430,0,0,0,0,0,0,19000,1000,18000,18000
20200430,710783,優群凱基9A購05,0.74,0.74,0.74,0.74,-0.03,-3.9,5000,1,3700,0,0,0,0,0,0,0,5000,-5000,-5000
20200430,710784,寶雅凱基9A購02,1.40,1.40,1.33,1.33,-0.14,-9.52,267000,10,357410,0,0,0,0,0,0,257000,10000,247000,247000
20200430,710785,鈊象凱基9B購02,3.69,3.69,3.46,3.46,-0.16,-4.42,4000,3,14430,0,0,0,0,0,0,3000,4000,-1000,-1000
20200430,710786,神盾中信9C購01,0.99,0.99,0.91,0.96,+0.03,3.23,441000,17,416300,0,0,0,0,0,0,273000,168000,105000,105000
20200430,710787,世界國票9A購01,3.93,4.12,3.93,4.12,+0.48,13.19,35000,5,141550,0,0,0,0,0,0,0,35000,-35000,-35000
20200430,710788,良維國票9A購02,5.40,5.40,5.40,5.40,+0.10,1.89,14000,1,75600,0,0,0,0,0,0,14000,0,14000,14000
20200430,710789,信驊國票9A購04,2.15,2.19,2.15,2.19,+0.20,10.05,167000,7,363670,0,0,0,0,0,0,50000,117000,-67000,-67000
20200430,710790,原相國票9C購01,,,,,,0.00,0,0,0,0,0,0,0,0,0,0,0,0,0
20200430,710791,泰博國票9A購04,,,,,,0.00,0,0,0,0,0,0,0,0,0,0,0,0,0
20200430,710792,聖暉國票9A購02,2.68,2.74,2.68,2.74,+0.10,3.79,201000,6,548530,0,0,0,0,0,0,191000,10000,181000,181000
20200430,710793,璟德國票9A購01,2.95,3.12,2.90,3.12,+0.09,2.97,162000,8,493680,0,0,0,0,0,0,59000,103000,-44000,-44000
20200430,710794,雙美國票9A購02,1.60,1.60,1.59,1.59,0.00,0.0,13000,2,20760,0,0,0,0,0,0,13000,0,13000,13000
20200430,710795,原相元大9B購05,1.25,1.25,1.25,1.25,-0.02,-1.57,20000,1,25000,0,0,0,0,0,0,0,20000,-20000,-20000
20200430,710796,優群元大9A購04,,,,,,0.00,0,0,0,0,0,0,0,0,0,0,0,0,0
20200430,710797,雙鴻元大9B購02,1.11,1.11,1.11,1.11,+0.02,1.83,10000,2,11100,0,0,0,0,0,0,5000,5000,0,0
20200430,710798,頎邦元大9A購04,2.37,2.60,2.37,2.60,+0.30,13.04,157000,14,390240,0,0,0,0,0,0,11000,157000,-146000,-146000
20200430,710799,網龍群益9A購02,2.19,2.20,2.08,2.08,-0.20,-8.77,26000,3,56400,0,0,0,0,0,0,21000,6000,15000,15000
20200430,710800,磐亞群益9A購01,,,,,,0.00,0,0,0,0,0,0,0,0,0,0,0,0,0
20200430,710801,鈺太群益9A購02,,,,,,0.00,0,0,0,0,0,0,0,0,0,0,0,0,0
20200430,710802,金居凱基9A購02,1.73,1.85,1.71,1.85,+0.36,24.16,8000,4,14390,0,0,0,0,0,0,3000,5000,-2000,-2000
20200430,710803,信驊凱基9A購04,1.12,1.12,1.12,1.12,+0.09,8.74,200000,7,224000,0,0,0,0,0,0,0,200000,-200000,-200000
20200430,710804,鈊象凱基9A購04,,,,,,0.00,0,0,0,0,0,0,0,0,0,0,0,0,0
20200430,710805,精測統一9B購02,1.05,1.05,1.05,1.05,+0.06,6.06,260000,6,273000,5000,0,5000,0,0,0,50000,210000,-160000,-155000
20200430,710806,久元永豐9A購01,1.04,1.04,1.04,1.04,+0.01,0.97,26000,1,27040,0,0,0,0,0,0,0,26000,-26000,-26000
20200430,710807,亞泰永豐9A購01,1.01,1.01,1.01,1.01,+0.03,3.06,10000,1,10100,0,0,0,0,0,0,0,10000,-10000,-10000
20200430,710808,宜特永豐9A購02,1.16,1.20,1.15,1.20,+0.08,7.14,156000,6,182650,0,0,0,0,0,0,0,156000,-156000,-156000
20200430,710809,信驊永豐9A購01,0.82,0.82,0.82,0.82,+0.06,7.89,218000,3,178760,0,0,0,0,0,0,0,218000,-218000,-218000
20200430,710810,威剛永豐9A購03,1.12,1.12,1.11,1.11,+0.02,1.83,12000,3,13420,0,0,0,0,0,0,2000,12000,-10000,-10000
20200430,710811,原相永豐9B購01,,,,,,0.00,0,0,0,0,0,0,0,0,0,0,0,0,0
20200430,710812,聖暉永豐9A購01,1.11,1.15,1.11,1.15,+0.09,8.49,105000,2,118270,0,0,0,0,0,0,0,105000,-105000,-105000
20200430,710813,網家永豐9A購03,1.07,1.07,1.07,1.07,+0.06,5.94,160000,3,171200,0,0,0,0,0,0,0,160000,-160000,-160000
20200430,710814,網龍永豐9A購04,,,,,,0.00,0,0,0,0,0,0,0,0,0,0,0,0,0
20200430,710815,雙美永豐9A購02,,,,,,0.00,0,0,0,0,0,0,0,0,0,0,0,0,0
20200430,710816,雙鴻永豐9A購03,,,,,,0.00,0,0,0,0,0,0,0,0,0,0,0,0,0
20200430,710817,群聯國票9A購03,5.75,5.80,5.60,5.80,+0.55,10.48,39000,25,223500,0,0,0,0,0,0,39000,39000,0,0
20200430,710818,雙鴻富邦9B購02,0.78,0.78,0.78,0.78,+0.08,11.43,40000,1,31200,0,0,0,0,0,0,0,40000,-40000,-40000
20200430,710819,原相元大9B購06,,,,,,0.00,0,0,0,0,0,0,0,0,0,0,0,0,0
20200430,710820,泰博元大9A購04,,,,,,0.00,0,0,0,0,0,0,0,0,0,0,0,0,0
20200430,710821,櫃200元大9A購02,,,,,,0.00,0,0,0,0,0,0,0,0,0,0,0,0,0
20200430,710822,凡甲群益9A購02,,,,,,0.00,0,0,0,0,0,0,0,0,0,0,0,0,0
20200430,710823,大江群益9A購02,2.09,2.09,2.09,2.09,+0.13,6.63,10000,1,20900,0,0,0,0,0,0,0,10000,-10000,-10000
20200430,710824,新鉅科群益9A購03,,,,,,0.00,0,0,0,0,0,0,0,0,0,0,0,0,0
20200430,710825,群聯群益9A購04,2.42,2.49,2.42,2.49,+0.14,5.96,92000,23,227900,0,0,0,0,0,0,20000,92000,-72000,-72000
20200430,710826,聚積群益9A購01,1.84,1.84,1.84,1.84,+0.05,2.79,10000,1,18400,0,0,0,0,0,0,0,10000,-10000,-10000
20200430,710827,優群群益9A購02,,,,,,0.00,0,0,0,0,0,0,0,0,0,0,0,0,0
20200430,710828,鈊象群益9A購06,3.82,3.82,3.73,3.73,+0.15,4.19,2000,2,7550,0,0,0,0,0,0,2000,2000,0,0
20200430,710829,宜鼎國票9A購01,4.06,4.10,4.06,4.06,+1.11,37.63,27000,26,109780,0,0,0,0,0,0,27000,27000,0,0
20200430,710830,網龍國票9A購01,,,,,,0.00,0,0,0,0,0,0,0,0,0,0,0,0,0
20200430,710831,宜鼎中信9B購01,,,,,,0.00,0,0,0,0,0,0,0,0,0,0,0,0,0
20200430,710832,信驊中信9A購01,0.69,0.69,0.69,0.69,+0.05,7.81,1000,1,690,0,0,0,0,0,0,0,1000,-1000,-1000
20200430,710833,群聯中信9C購02,,,,,,0.00,0,0,0,0,0,0,0,0,0,0,0,0,0
20200430,710834,中美晶凱基9A購06,2.90,3.08,2.90,3.02,+0.27,9.82,21000,11,62620,0,0,0,0,0,0,9000,21000,-12000,-12000
20200430,710835,宏捷科凱基9A購06,,,,,,0.00,0,0,0,0,0,0,0,0,0,0,0,0,0
20200430,710836,是方凱基9A購01,,,,,,0.00,0,0,0,0,0,0,0,0,0,0,0,0,0
20200430,710837,碩禾凱基9A購02,,,,,,0.00,0,0,0,0,0,0,0,0,0,0,0,0,0
20200430,710838,精測凱基9B購01,,,,,,0.00,0,0,0,0,0,0,0,0,0,0,0,0,0
20200430,710839,網家凱基9A購02,1.62,1.63,1.62,1.63,+0.19,13.19,18000,2,29220,0,0,0,0,0,0,0,18000,-18000,-18000
20200430,710840,環球晶凱基9A購05,3.76,4.10,3.76,4.10,+0.89,27.73,51000,25,200750,0,0,0,0,0,0,51000,51000,0,0
20200430,710841,穩懋凱基9A購07,,,,,,0.00,0,0,0,0,0,0,0,0,0,0,0,0,0
20200430,710842,鈊象凱基9B購03,1.19,1.19,1.09,1.09,-0.19,-14.84,40000,6,44210,0,0,0,0,0,0,3000,40000,-37000,-37000
20200430,710843,原相麥證9A購01,,,,,,0.00,0,0,0,0,0,0,0,0,0,0,0,0,0
20200430,710844,直得永豐9A購01,,,,,,0.00,0,0,0,0,0,0,0,0,0,0,0,0,0
20200430,710845,是方永豐9A購02,,,,,,0.00,0,0,0,0,0,0,0,0,0,0,0,0,0
