date,sid,name,open,high,low,close,amplitude,amplitude_ratio,capacity,transaction,turnover,foreign_dealers_buy,foreign_dealers_sell,foreign_dealers_total,investment_trust_buy,investment_trust_sell,investment_trust_total,dealer_buy,dealer_sell,dealer_total,institutional_investors_total
20200312,0050,元大台灣50,84.50,84.50,81.15,82.15,-3.15,-3.69,44910246,19425,3702402943,250250,23961000,-23710750,0,0,0,3505000,11489000,-7984000,-31694750
20200312,0051,元大中型100,32.25,32.25,30.47,30.63,-1.82,-5.61,107920,82,3333548,6000,5000,1000,0,0,0,14000,59000,-45000,-44000
20200312,0052,富邦科技,64.70,64.70,61.55,63.10,-1.60,-2.47,179511,65,11183291,5000,5000,0,0,0,0,117000,131000,-14000,-14000
20200312,0053,元大電子,38.05,38.05,36.47,36.57,-2.05,-5.31,43443,34,1604232,0,0,0,0,0,0,10000,31000,-21000,-21000
20200312,0054,元大台商50,21.71,21.71,21.04,21.04,-1.28,-5.73,4000,3,85750,0,0,0,0,0,0,0,4000,-4000,-4000
20200312,0055,元大MSCI金融,17.61,17.61,17.04,17.11,-0.74,-4.15,102982,85,1770468,1000,2000,-1000,0,0,0,25000,16000,9000,8000
20200312,0056,元大高股息,26.73,26.73,25.71,25.93,-1.04,-3.86,155640188,69580,4051650736,97030,23000,74030,0,0,0,1180000,138600000,-137420000,-137345970
20200312,0057,富邦摩台,55.15,55.15,53.20,53.45,-2.65,-4.72,33000,7,1761700,0,0,0,0,0,0,21000,32000,-11000,-11000
20200312,0061,元大寶滬深,18.00,18.20,17.79,17.92,-0.33,-1.81,732141,278,13119740,16000,0,16000,0,0,0,343000,101000,242000,258000
20200312,006203,元大MSCI台灣,38.72,38.72,37.98,38.21,-2.01,-5.0,12031,14,462624,0,2000,-2000,0,0,0,3000,9000,-6000,-8000
20200312,006204,永豐臺灣加權,53.00,53.00,52.00,52.00,-2.65,-4.85,11012,11,575721,0,0,0,0,0,0,8000,3000,5000,5000
20200312,006205,富邦上証,30.20,30.25,29.70,29.72,-0.80,-2.62,5205125,1675,155663329,1587000,0,1587000,0,0,0,3066000,1085000,1981000,3568000
20200312,006206,元大上證50,31.50,31.50,30.80,30.81,-0.79,-2.5,793926,132,24555963,467000,0,467000,0,0,0,241000,42000,199000,666000
20200312,006207,FH滬深,23.90,23.90,23.15,23.30,-0.58,-2.43,1242000,102,28938340,664000,24000,640000,0,0,0,537000,135000,402000,1042000
20200312,006208,富邦台50,48.45,48.45,46.65,47.00,-1.65,-3.39,2376511,1225,112561806,6000,6000,0,0,0,0,823000,1990000,-1167000,-1167000
20200312,00625K,富邦上証+R,6.99,6.99,6.99,6.99,-0.19,-2.65,50000,2,349500,0,0,0,0,0,0,50000,50000,0,0
20200312,00631L,元大台灣50正2,42.83,42.83,38.49,39.43,-3.99,-9.19,13307600,4136,537079164,43000,168000,-125000,0,0,0,4167000,5565000,-1398000,-1523000
20200312,00632R,元大台灣50反1,11.06,11.61,11.05,11.48,+0.50,4.55,336620824,29689,3816854284,81612000,2257000,79355000,0,0,0,106508000,104625000,1883000,81238000
20200312,00633L,富邦上証正2,42.98,43.02,41.08,41.54,-1.70,-3.93,23499398,4240,984456252,1700000,5098000,-3398000,0,0,0,5731000,8717000,-2986000,-6384000
20200312,00634R,富邦上証反1,5.87,5.99,5.85,5.94,+0.12,2.06,16504000,1447,97755770,649000,319000,330000,0,0,0,6086000,3101000,2985000,3315000
20200312,00635U,元大S&P黃金,23.38,23.49,23.22,23.24,-0.42,-1.78,4531302,1268,105593876,11000,265000,-254000,0,0,0,1141000,1321000,-180000,-434000
20200312,00636,國泰中國A50,21.00,21.00,20.50,20.59,-0.47,-2.23,2703905,950,55850176,259000,0,259000,0,0,0,1830000,85572,1744428,2003428
20200312,00636K,國泰中國A50+U,6.81,6.81,6.81,6.81,-0.25,-3.54,100,1,681,0,0,0,0,0,0,100,100,0,0
20200312,00637L,元大滬深300正2,16.46,16.52,15.75,15.93,-0.67,-4.04,142324975,14060,2286557000,4488000,23589000,-19101000,0,0,0,37982000,39138000,-1156000,-20257000
20200312,00638R,元大滬深300反1,11.83,12.06,11.80,11.98,+0.25,2.13,11530000,1758,137946060,2554000,0,2554000,0,0,0,2031000,1752000,279000,2833000
20200312,00639,富邦深100,11.63,11.75,11.45,11.46,-0.43,-3.62,2836076,409,32758916,170000,75000,95000,0,0,0,1792000,1130000,662000,757000
20200312,00640L,富邦日本正2,13.95,13.98,13.01,13.28,-1.36,-9.29,3987000,887,53492810,1000,0,1000,0,0,0,811000,2335000,-1524000,-1523000
20200312,00641R,富邦日本反1,17.06,17.56,17.01,17.44,+0.76,4.56,3813000,816,66238360,360000,0,360000,0,0,0,399000,1392000,-993000,-633000
20200312,00642U,元大S&P石油,11.30,11.41,10.93,11.00,-0.55,-4.76,80836507,15588,895040623,132000,2402000,-2270000,0,0,0,1295000,15282000,-13987000,-16257000
20200312,00643,群益深証中小,14.20,14.20,13.80,13.85,-0.45,-3.15,2586431,663,36027482,279000,77000,202000,0,0,0,1150000,999082,150918,352918
20200312,00643K,群益深証中小+R,,,,,0.00,0.00,0,0,0,0,0,0,0,0,0,0,0,0,0
20200312,00645,富邦日本,17.66,17.66,17.10,17.27,-0.83,-4.59,217360,66,3754112,0,0,0,0,0,0,89000,175000,-86000,-86000
20200312,00646,元大S&P500,25.13,25.14,24.00,24.28,-1.41,-5.49,4518185,1916,110285211,130000,253000,-123000,0,0,0,391000,2763000,-2372000,-2495000
20200312,00647L,元大S&P500正2,29.56,29.60,26.50,27.32,-3.54,-11.47,5365000,884,149256820,15000,15000,0,0,0,0,3679000,1735000,1944000,1944000
20200312,00648R,元大S&P500反1,12.80,13.30,12.74,13.18,+0.64,5.1,10097548,1597,132467572,335000,0,335000,0,0,0,4130000,3395000,735000,1070000
20200312,00650L,FH香港正2,23.86,23.86,21.94,22.50,-1.81,-7.45,1597000,290,36092700,0,0,0,0,0,0,975000,981000,-6000,-6000
20200312,00651R,FH香港反1,9.05,9.23,9.01,9.18,+0.33,3.73,1885000,340,17222000,25000,24000,1000,0,0,0,662000,396000,266000,267000
20200312,00652,富邦印度,19.81,19.81,18.58,18.58,-1.23,-6.21,222768,114,4250354,0,98000,-98000,0,0,0,77000,55105,21895,-76105
20200312,00653L,富邦印度正2,20.96,20.96,18.72,18.72,-2.66,-12.44,1577000,444,31080870,139000,29000,110000,0,0,0,547000,379000,168000,278000
20200312,00654R,富邦印度反1,15.30,16.03,15.30,16.00,+0.79,5.19,813000,179,12900770,13000,103000,-90000,0,0,0,58000,173000,-115000,-205000
20200312,00655L,國泰中國A50正2,31.27,31.27,29.76,30.08,-1.32,-4.2,8733000,2121,264802820,100000,1997000,-1897000,0,0,0,2546000,3214000,-668000,-2565000
20200312,00656R,國泰中國A50反1,10.78,10.99,10.75,10.92,+0.23,2.15,2552000,309,27787710,0,0,0,0,0,0,1559000,523000,1036000,1036000
20200312,00657,國泰日經225,23.14,23.14,22.77,22.85,-1.30,-5.38,112000,7,2554060,0,0,0,0,0,0,108000,104000,4000,4000
20200312,00657K,國泰日經225+U,7.50,7.50,7.50,7.50,-0.57,-7.06,100,1,750,0,0,0,0,0,0,100,100,0,0
20200312,00660,元大歐洲50,20.80,20.80,19.50,20.00,-1.18,-5.57,90000,48,1801270,0,0,0,0,0,0,23000,56000,-33000,-33000
20200312,00661,元大日經225,24.42,24.42,23.50,23.50,-1.40,-5.62,11000,10,263650,0,0,0,0,0,0,0,11000,-11000,-11000
20200312,00662,富邦NASDAQ,31.09,31.09,29.58,29.81,-1.62,-5.15,719842,397,21600483,104000,0,104000,0,0,0,177000,321000,-144000,-40000
20200312,00663L,國泰臺灣加權正2,38.12,38.12,34.09,34.85,-3.84,-9.93,548200,119,19645148,1000,38000,-37000,0,0,0,267000,208000,59000,22000
20200312,00664R,國泰臺灣加權反1,12.56,13.19,12.55,13.05,+0.58,4.65,10275000,1455,132880890,453000,195000,258000,0,0,0,4950000,2639000,2311000,2569000
20200312,00665L,富邦恒生國企正2,22.20,22.20,20.41,20.78,-1.54,-6.9,457000,155,9590030,4000,130000,-126000,0,0,0,180000,82000,98000,-28000
20200312,00666R,富邦恒生國企反1,14.02,14.30,14.02,14.22,+0.51,3.72,122000,16,1732940,67000,0,67000,0,0,0,49000,76000,-27000,40000
20200312,00668,國泰美國道瓊,25.67,25.67,24.43,24.66,-1.84,-6.94,1310200,652,32650036,128000,8000,120000,0,0,0,198000,524000,-326000,-206000
20200312,00668K,國泰美國道瓊+U,8.18,8.18,8.18,8.18,-0.67,-7.57,100,1,818,0,0,0,0,0,0,100,100,0,0
20200312,00669R,國泰美國道瓊反1,13.59,14.22,13.59,14.07,+0.83,6.27,18381000,2534,257729570,105000,120000,-15000,0,0,0,5826000,7319000,-1493000,-1508000
20200312,00670L,富邦NASDAQ正2,35.47,35.60,31.65,32.58,-4.06,-11.08,7123060,1631,235193621,31000,22000,9000,0,0,0,3398000,2423000,975000,984000
20200312,00671R,富邦NASDAQ反1,11.74,12.31,11.71,12.16,+0.60,5.19,8253000,1564,100077170,516000,0,516000,0,0,0,2113000,3325000,-1212000,-696000
20200312,00672L,元大S&P原油正2,4.10,4.20,3.50,3.51,-0.97,-21.65,900417079,60006,3456936351,8880000,24724000,-15844000,0,0,0,13905000,20435000,-6530000,-22374000
20200312,00673R,元大S&P原油反1,21.09,22.68,20.97,22.28,+2.00,9.86,12945550,2098,284751189,0,1160000,-1160000,0,0,0,4615000,4728000,-113000,-1273000
20200312,00674R,元大S&P黃金反1,15.20,15.35,15.14,15.34,+0.27,1.79,635000,134,9694700,0,0,0,0,0,0,120000,193000,-73000,-73000
20200312,00675L,富邦臺灣加權正2,16.52,16.52,14.89,15.22,-1.57,-9.35,1056000,442,16391140,0,0,0,0,0,0,270000,619000,-349000,-349000
20200312,00676R,富邦臺灣加權反1,6.82,7.14,6.82,7.06,+0.30,4.44,11586598,1180,81232993,4000,161000,-157000,0,0,0,4555000,3493000,1062000,905000
20200312,00677U,富邦VIX,6.95,8.00,6.94,7.65,+0.94,14.01,929322571,66679,7034095297,156191000,111824000,44367000,0,0,0,105382000,44433000,60949000,105316000
20200312,00678,群益NBI生技,21.31,21.31,20.12,20.21,-1.49,-6.87,759000,336,15487560,33000,211000,-178000,0,0,0,14000,1000,13000,-165000
20200312,00680L,元大美債20正2,32.43,33.57,32.43,33.23,-1.40,-4.04,1169000,311,38789220,0,0,0,0,0,0,751000,739000,12000,12000
20200312,00681R,元大美債20反1,13.10,13.10,12.91,13.01,+0.30,2.36,435000,79,5659320,0,0,0,0,0,0,148000,211000,-63000,-63000
20200312,00682U,元大美元指數,,,,,0.00,0.00,0,0,0,0,0,0,0,0,0,0,0,0,0
20200312,00683L,元大美元指數正2,19.02,19.12,18.93,18.99,+0.09,0.48,159000,17,3020040,0,0,0,0,0,0,134000,154000,-20000,-20000
20200312,00684R,元大美元指數反1,18.51,18.56,18.51,18.52,-0.07,-0.38,37000,9,685560,0,0,0,0,0,0,32000,0,32000,32000
20200312,00685L,群益臺灣加權正2,14.37,14.37,13.15,13.41,-1.42,-9.58,418000,69,5678670,0,0,0,0,0,0,166000,256000,-90000,-90000
20200312,00686R,群益臺灣加權反1,7.43,7.78,7.42,7.71,+0.36,4.9,843000,140,6434540,0,0,0,0,0,0,429000,334000,95000,95000
20200312,00688L,國泰20年美債正2,33.08,33.95,33.08,33.95,-1.19,-3.39,187000,35,6281650,0,0,0,0,0,0,171000,112000,59000,59000
20200312,00689R,國泰20年美債反1,13.35,13.35,13.22,13.33,+0.32,2.46,167000,30,2223860,0,0,0,0,0,0,132000,132000,0,0
20200312,00690,兆豐藍籌30,21.65,21.65,20.69,20.78,-1.00,-4.59,367041,117,7688480,3000,6000,-3000,0,0,0,179000,326000,-147000,-150000
20200312,00691R,兆豐藍籌30反1,14.85,15.42,14.85,15.42,0.00,0.00,26000,7,392380,0,0,0,0,0,0,24000,2000,22000,22000
20200312,00692,富邦公司治理,21.78,21.78,20.85,21.10,-0.78,-3.56,6756182,3229,142987356,5000,0,5000,0,0,0,1815000,4510000,-2695000,-2690000
20200312,00693U,街口S&P黃豆,14.05,14.05,13.80,13.81,-0.35,-2.47,4521420,556,62675791,0,0,0,0,0,0,3410000,1828000,1582000,1582000
20200312,00700,富邦恒生國企,18.51,18.51,18.11,18.25,-0.53,-2.82,118618,23,2170515,0,0,0,0,0,0,92000,108000,-16000,-16000
20200312,00701,國泰股利精選30,20.56,20.56,19.93,19.99,-0.69,-3.34,8328772,3517,167315528,55000,57000,-2000,0,0,0,1774000,2927000,-1153000,-1155000
20200312,00702,國泰標普低波高息,17.39,17.39,16.27,16.47,-0.98,-5.62,176180,102,2919378,0,0,0,0,0,0,25000,131000,-106000,-106000
20200312,00703,台新MSCI中國,19.76,19.76,18.98,19.15,-0.64,-3.23,254000,54,4868290,0,0,0,0,0,0,204000,139000,65000,65000
20200312,00706L,元大S&P日圓正2,18.44,18.74,18.43,18.57,+0.17,0.92,305000,81,5661050,0,0,0,0,0,0,168000,8000,160000,160000
20200312,00707R,元大S&P日圓反1,18.89,18.89,18.87,18.87,-0.15,-0.79,2000,2,37760,0,0,0,0,0,0,2000,2000,0,0
20200312,00708L,元大S&P黃金正2,26.03,26.07,25.50,25.60,-0.92,-3.47,16853130,2884,433951804,398000,0,398000,0,0,0,5813000,5805000,8000,406000
20200312,00709,富邦歐洲,17.03,17.03,15.98,16.43,-1.20,-6.81,165500,40,2692565,0,0,0,0,0,0,100000,162000,-62000,-62000
20200312,00710B,FH彭博高收益債,19.00,19.00,18.40,18.57,-0.69,-3.58,1532600,411,28674610,0,0,0,0,0,0,1103000,297000,806000,806000
20200312,00711B,FH彭博新興債,22.22,22.22,21.87,21.88,-0.68,-3.01,292000,34,6427610,0,30000,-30000,0,0,0,287000,100000,187000,157000
20200312,00712,FH富時不動產,15.54,15.54,14.96,15.31,-0.97,-5.96,1943437,613,29542849,0,803000,-803000,0,0,0,644000,535000,109000,-694000
20200312,00713,元大台灣高息低波,30.00,31.65,28.88,29.19,-0.85,-2.83,284200,206,8323390,0,88000,-88000,0,0,0,13000,58000,-45000,-133000
20200312,00714,群益道瓊美國地產,19.42,19.46,18.66,18.86,-1.23,-6.12,259005,68,4917494,103000,0,103000,0,0,0,8000,244000,-236000,-133000
20200312,00715L,街口布蘭特油正2,6.89,6.89,5.94,6.01,-1.23,-16.99,41419100,5807,259949978,3000,104000,-101000,0,0,0,40000,2881000,-2841000,-2942000
20200312,00717,富邦美國特別股,17.99,17.99,17.67,17.72,-0.49,-2.69,4784647,1594,85170157,0,0,0,0,0,0,520000,1664000,-1144000,-1144000
20200312,00728,第一金工業30,18.64,18.64,17.61,17.80,-0.86,-4.61,946204,249,16963499,0,0,0,0,0,0,525000,672000,-147000,-147000
20200312,00730,富邦臺灣優質高息,16.85,16.90,16.08,16.17,-0.76,-4.49,2087278,1127,34229690,2000,0,2000,0,0,0,510000,1689000,-1179000,-1177000
20200312,00731,FH富時高息低波,44.71,44.71,43.18,43.18,-1.55,-3.47,572100,162,24937960,0,1000,-1000,0,60000,-60000,474000,451000,23000,-38000
20200312,00732,國泰RMB短期報酬,38.75,38.75,38.75,38.75,-0.10,-0.26,100000,2,3875000,0,0,0,0,0,0,100000,100000,0,0
20200312,00733,富邦臺灣中小,19.05,19.05,18.03,18.20,-1.15,-5.94,46150,35,847557,0,0,0,0,0,0,4000,34000,-30000,-30000
20200312,00735,國泰臺韓科技,19.17,19.17,18.38,18.58,-0.84,-4.33,166000,16,3061360,48000,0,48000,0,0,0,105000,159000,-54000,-6000
20200312,00736,國泰新興市場,17.39,17.39,16.76,16.85,-0.95,-5.34,157000,36,2656590,0,0,0,0,0,0,100000,152000,-52000,-52000
20200312,00737,國泰AI+Robo,19.12,19.12,18.00,18.16,-1.29,-6.63,1139251,578,20908423,28000,217000,-189000,0,0,0,18000,453000,-435000,-624000
20200312,00738U,元大道瓊白銀,18.86,18.86,18.33,18.37,-0.60,-3.16,7574158,611,139819622,991000,10000,981000,0,0,0,4848000,1118000,3730000,4711000
20200312,00739,元大MSCI A股,21.44,21.44,20.96,21.07,-0.50,-2.32,1110000,156,23463310,2000,0,2000,0,0,0,885000,350000,535000,537000
20200312,00742,新光內需收益,19.59,19.59,19.30,19.30,-0.48,-2.43,9783,10,190190,2000,2000,0,0,0,0,1000,6000,-5000,-5000
20200312,00743,國泰中國A150,22.05,22.05,21.36,21.60,-0.45,-2.04,24813,15,533330,0,3000,-3000,0,0,0,15000,8000,7000,4000
20200312,00752,中信中國50,23.12,23.12,22.42,22.54,-0.64,-2.76,2545000,1330,57607130,2000,0,2000,0,0,0,307000,1700000,-1393000,-1391000
20200312,00753L,中信中國50正2,23.74,23.74,21.87,21.87,-1.87,-7.88,518000,172,11486210,0,0,0,0,0,0,295000,275000,20000,20000
20200312,00757,統一FANG+,23.39,23.39,22.10,22.45,-1.15,-4.87,1191000,275,26776560,138000,0,138000,0,0,0,905000,482000,423000,561000
20200312,00762,元大全球AI,22.18,22.18,21.00,21.32,-1.41,-6.2,1524100,645,32697180,10000,0,10000,0,0,0,210000,583000,-373000,-363000
20200312,00763U,街口道瓊銅,16.89,16.91,16.81,16.88,-0.53,-3.04,24000,12,404520,0,0,0,0,0,0,15000,0,15000,15000
20200312,00766L,台新MSCI中國正2,9.13,9.20,8.67,8.69,-0.72,-7.65,917000,203,8023530,0,0,0,0,0,0,367000,672000,-305000,-305000
20200312,00767,FH美國金融股,19.23,19.23,19.21,19.21,-0.22,-1.13,6000,4,115300,0,0,0,0,0,0,6000,0,6000,6000
20200312,00770,國泰北美科技,22.05,22.07,21.05,21.17,-1.31,-5.83,242000,54,5140940,71000,0,71000,0,0,0,120000,195000,-75000,-4000
20200312,00771,元大US高息特別股,18.97,18.97,18.35,18.37,-0.84,-4.37,379464,219,7048266,0,0,0,0,0,0,42000,49506,-7506,-7506
20200312,00774B,新光中國政金綠債,40.95,40.95,40.95,40.95,+0.06,0.15,2000,2,81900,0,0,0,0,0,0,2000,2000,0,0
20200312,00774C,新光中政金綠債+R,,,,,0.00,0.00,0,0,0,0,0,0,0,0,0,0,0,0,0
20200312,00775B,新光投等債15+,44.79,45.37,44.79,45.37,-1.51,-3.22,3000,3,135530,0,0,0,0,0,0,2000,3000,-1000,-1000
20200312,00776,新光ICE美國權值,19.32,19.32,18.97,18.97,-0.99,-4.96,6000,5,114870,0,0,0,0,0,0,0,6000,-6000,-6000
20200312,00783,富邦中証500,19.29,19.29,18.57,18.74,-0.55,-2.85,1083306,62,20421122,21000,18000,3000,0,0,0,1025000,840000,185000,188000
20200312,008201,BP上證50,,,,,0.00,0.00,0,0,0,0,0,0,0,0,0,0,0,0,0
20200312,00830,國泰費城半導體,14.98,14.98,14.22,14.37,-0.97,-6.32,3544416,1267,51387177,598100,66000,532100,0,0,0,435000,1749000,-1314000,-781900
20200312,00850,元大臺灣ESG永續,21.20,21.20,20.25,20.50,-0.76,-3.57,11712028,5301,241205151,12000,0,12000,0,0,0,2984000,5028000,-2044000,-2032000
20200312,00851,台新全球AI,19.85,19.85,18.69,18.87,-0.98,-4.94,124000,72,2353450,0,0,0,0,0,0,56000,52000,4000,4000
20200312,00852L,國泰美國道瓊正2,11.15,11.18,9.98,10.26,-1.54,-13.05,22585000,2750,236059990,0,425000,-425000,0,0,0,6979000,8799000,-1820000,-2245000
20200312,00861,元大全球未來通訊,19.12,19.12,18.10,18.32,-0.96,-4.98,25930371,8738,478231561,113100,103000,10100,0,0,0,1731000,12780000,-11049000,-11038900
20200312,00865B,國泰US短期公債,39.50,39.67,39.50,39.50,0.00,0.00,138000,51,5463470,0,0,0,0,0,0,127000,11000,116000,116000
20200312,00866,新光Shiller CAPE,17.01,17.01,16.29,16.42,-0.97,-5.58,66000,23,1086060,0,0,0,0,0,0,22000,56000,-34000,-34000
20200312,01001T,土銀富邦R1,16.79,16.81,16.65,16.68,-0.11,-0.66,83000,37,1388060,0,9000,-9000,0,0,0,0,0,0,-9000
20200312,01002T,土銀國泰R1,17.96,18.00,17.80,17.80,-0.16,-0.89,1065708,144,19064516,24000,13000,11000,0,0,0,0,0,0,11000
20200312,01003T,兆豐新光R1,18.67,18.80,18.65,18.68,-0.17,-0.9,43000,22,802720,18000,1000,17000,0,0,0,0,0,0,17000
20200312,01004T,土銀富邦R2,14.70,14.73,14.67,14.70,0.00,0.00,7136000,115,104958950,43000,0,43000,0,0,0,0,0,0,43000
20200312,01007T,兆豐國泰R2,17.90,17.91,17.75,17.80,-0.10,-0.56,386000,36,6874200,0,0,0,0,0,0,0,0,0,0
20200312,01009T,王道圓滿R1,9.87,9.87,9.70,9.77,-0.10,-1.01,105000,29,1023240,0,6000,-6000,0,0,0,0,0,0,-6000
20200312,01010T,京城樂富R1,10.10,10.14,9.95,10.07,-0.05,-0.49,274000,32,2755260,0,1000,-1000,0,0,0,0,0,0,-1000
20200312,020000,富邦特選蘋果N,4.96,4.96,4.72,4.72,-0.30,-5.98,556000,88,2688990,0,0,0,0,0,0,184000,335000,-151000,-151000
20200312,020002,元富新中國N,,,,,0.00,0.00,0,0,0,0,0,0,0,0,0,0,0,0,0
20200312,020004,兆豐電菁英30N,,,,,0.00,0.00,0,0,0,0,0,0,0,0,0,0,0,0,0
20200312,020005,永豐外資50N,,,,,0.00,0.00,0,0,0,0,0,0,0,0,0,0,0,0,0
20200312,020006,永昌中小300N,,,,,0.00,0.00,0,0,0,0,0,0,0,0,0,0,0,0,0
20200312,020007,凱基臺灣500N,,,,,0.00,0.00,0,0,0,0,0,0,0,0,0,0,0,0,0
20200312,020008,元大特股高息N,10.27,10.27,10.18,10.21,-0.15,-1.45,820000,60,8368160,0,0,0,0,0,0,766000,552000,214000,214000
20200312,020011,統一微波高息20N,4.58,4.58,4.58,4.58,0.00,0.00,3000,3,13740,0,0,0,0,0,0,0,3000,-3000,-3000
20200312,020012,富邦行動通訊N,4.60,4.60,4.30,4.32,-0.29,-6.29,3052000,336,13361710,0,0,0,0,0,0,754000,1830000,-1076000,-1076000
20200312,03004P,鴻海凱基93售05,,,,,0.00,0.00,0,0,0,0,0,0,0,0,0,0,0,0,0
20200312,03005P,華新科凱基93售04,0.03,0.03,0.03,0.03,0.00,0.00,1000,1,30,0,0,0,0,0,0,1000,0,1000,1000
20200312,03005X,元展05,,,,,0.00,0.00,0,0,0,0,0,0,0,0,0,0,0,0,0
20200312,03006P,華新科凱基93售05,,,,,0.00,0.00,0,0,0,0,0,0,0,0,0,0,0,0,0
20200312,03006X,元展06,24.10,24.10,23.90,24.00,-1.90,-7.34,9000,4,215500,0,0,0,0,0,0,8000,1000,7000,7000
20200312,03007X,元展07,19.30,19.30,19.20,19.20,-1.30,-6.34,3000,2,57700,0,0,0,0,0,0,3000,0,3000,3000
20200312,03009X,元展09,,,,,0.00,0.00,0,0,0,0,0,0,0,0,0,0,0,0,0
20200312,03010X,元展10,26.00,26.00,26.00,26.00,-3.40,-11.56,10000,1,260000,0,0,0,0,0,0,10000,0,10000,10000
20200312,03012X,元展12,9.05,9.10,8.85,8.95,-0.75,-7.73,11000,4,98600,0,0,0,0,0,0,8000,3000,5000,5000
20200312,03013X,元展13,,,,,0.00,0.00,0,0,0,0,0,0,0,0,0,0,0,0,0
20200312,03014X,元展14,,,,,0.00,0.00,0,0,0,0,0,0,0,0,0,0,0,0,0
20200312,03015X,元展15,33.90,34.00,33.80,33.90,0.00,0.00,800000,15,27160000,0,0,0,0,0,0,800000,0,800000,800000
20200312,03016P,臺股指中信94售01,0.09,0.40,0.09,0.32,+0.23,255.56,2977000,51,681830,0,0,0,0,0,0,1305000,101000,1204000,1204000
20200312,03016X,元展16,2.57,2.57,2.55,2.55,0.00,0.00,6000,3,15320,0,0,0,0,0,0,0,6000,-6000,-6000
20200312,03017X,元展17,4.17,4.17,4.11,4.11,0.00,0.00,100000,2,414000,0,0,0,0,0,0,0,100000,-100000,-100000
20200312,03019X,元展19,,,,,0.00,0.00,0,0,0,0,0,0,0,0,0,0,0,0,0
20200312,03020X,元展20,,,,,0.00,0.00,0,0,0,0,0,0,0,0,0,0,0,0,0
20200312,03021P,T50反1凱基94售01,0.66,0.66,0.40,0.46,-0.31,-40.26,1531000,111,710260,0,0,0,0,0,0,1530000,1451000,79000,79000
20200312,03022X,富展01,14.00,14.00,13.50,13.50,0.00,0.00,3000,2,41500,0,0,0,0,0,0,0,3000,-3000,-3000
20200312,03025P,群創凱基93售07,1.01,1.21,1.01,1.21,0.00,0.00,31000,4,34300,0,0,0,0,0,0,0,31000,-31000,-31000
20200312,03025X,元展22,28.80,28.80,28.80,28.80,0.00,0.00,9000,1,259200,0,0,0,0,0,0,9000,0,9000,9000
20200312,03026P,群創凱基93售08,0.48,0.67,0.48,0.62,0.00,0.00,103000,4,56770,0,0,0,0,0,0,103000,2000,101000,101000
20200312,03026X,元展23,,,,,0.00,0.00,0,0,0,0,0,0,0,0,0,0,0,0,0
20200312,03027P,康控凱基93售01,,,,,0.00,0.00,0,0,0,0,0,0,0,0,0,0,0,0,0
20200312,03027X,元展24,8.40,8.40,8.40,8.40,0.00,0.00,1000,1,8400,0,0,0,0,0,0,0,1000,-1000,-1000
20200312,03028X,元展25,,,,,0.00,0.00,0,0,0,0,0,0,0,0,0,0,0,0,0
20200312,03029X,元展26,14.40,14.40,14.30,14.30,0.00,0.00,23000,2,330900,0,0,0,0,0,0,23000,0,23000,23000
20200312,03033P,台積電中信95售05,0.07,0.13,0.07,0.10,+0.03,42.86,9595000,193,943600,0,0,0,0,0,0,4825000,1950000,2875000,2875000
20200312,03033X,元展30,5.55,5.55,5.40,5.40,-1.30,-19.4,11000,6,59900,0,0,0,0,0,0,0,11000,-11000,-11000
20200312,03035X,元展32,7.65,7.65,7.30,7.35,0.00,0.00,9000,3,66500,0,0,0,0,0,0,0,9000,-9000,-9000
20200312,03038P,智邦兆豐93售03,,,,,0.00,0.00,0,0,0,0,0,0,0,0,0,0,0,0,0
20200312,03038X,元展35,,,,,0.00,0.00,0,0,0,0,0,0,0,0,0,0,0,0,0
20200312,03039P,欣興兆豐93售03,0.31,0.44,0.31,0.44,0.00,0.00,22000,3,8280,0,0,0,0,0,0,15000,7000,8000,8000
20200312,03039X,元展36,3.20,3.30,3.10,3.30,0.00,0.00,12000,4,38300,0,0,0,0,0,0,4000,8000,-4000,-4000
20200312,03046X,元展43,,,,,0.00,0.00,0,0,0,0,0,0,0,0,0,0,0,0,0
20200312,03047P,台光電凱基93售02,,,,,0.00,0.00,0,0,0,0,0,0,0,0,0,0,0,0,0
20200312,03047X,元展44,,,,,0.00,0.00,0,0,0,0,0,0,0,0,0,0,0,0,0
20200312,03048P,美律凱基93售02,,,,,0.00,0.00,0,0,0,0,0,0,0,0,0,0,0,0,0
20200312,03049X,元展46,4.58,4.58,4.52,4.52,0.00,0.00,20000,2,91000,0,0,0,0,0,0,0,20000,-20000,-20000
20200312,03050X,元展47,1.53,1.53,1.45,1.45,-0.12,-7.64,42000,9,62480,0,0,0,0,0,0,0,42000,-42000,-42000
20200312,03052X,元展49,17.50,17.60,16.60,16.60,0.00,0.00,4000,4,68500,0,0,0,0,0,0,0,4000,-4000,-4000
20200312,03055X,元展52,23.40,23.40,23.40,23.40,0.00,0.00,1000,1,23400,0,0,0,0,0,0,1000,0,1000,1000
20200312,03059X,元展54,,,,,0.00,0.00,0,0,0,0,0,0,0,0,0,0,0,0,0
20200312,03060X,元展55,,,,,0.00,0.00,0,0,0,0,0,0,0,0,0,0,0,0,0
20200312,03063X,元展58,,,,,0.00,0.00,0,0,0,0,0,0,0,0,0,0,0,0,0
20200312,03064P,元油2X中信94售02,4.85,5.45,4.84,5.40,+0.65,13.68,40000,11,208740,0,0,0,0,0,0,33000,0,33000,33000
20200312,03064X,元展59,,,,,0.00,0.00,0,0,0,0,0,0,0,0,0,0,0,0,0
20200312,03071X,元展66,28.20,28.20,28.20,28.20,0.00,0.00,1000,1,28200,0,0,0,0,0,0,1000,0,1000,1000
20200312,03074X,元展69,,,,,0.00,0.00,0,0,0,0,0,0,0,0,0,0,0,0,0
20200312,03075X,元展70,,,,,0.00,0.00,0,0,0,0,0,0,0,0,0,0,0,0,0
20200312,03077X,元展72,,,,,0.00,0.00,0,0,0,0,0,0,0,0,0,0,0,0,0
20200312,03078X,元展73,,,,,0.00,0.00,0,0,0,0,0,0,0,0,0,0,0,0,0
20200312,03083P,華通凱基93售02,,,,,0.00,0.00,0,0,0,0,0,0,0,0,0,0,0,0,0
20200312,03085P,美律凱基93售03,0.67,0.94,0.67,0.94,0.00,0.00,21000,3,17020,0,0,0,0,0,0,11000,10000,1000,1000
20200312,03086P,美律凱基93售04,,,,,0.00,0.00,0,0,0,0,0,0,0,0,0,0,0,0,0
20200312,03087P,矽創凱基93售02,,,,,0.00,0.00,0,0,0,0,0,0,0,0,0,0,0,0,0
20200312,03088P,世紀鋼凱基93售04,,,,,0.00,0.00,0,0,0,0,0,0,0,0,0,0,0,0,0
20200312,03090X,元展84,9.35,9.40,9.35,9.40,0.00,0.00,3000,2,28150,0,0,0,0,0,0,2000,1000,1000,1000
20200312,03091X,元展85,,,,,0.00,0.00,0,0,0,0,0,0,0,0,0,0,0,0,0
20200312,03093X,永豐金元大61展01,,,,,0.00,0.00,0,0,0,0,0,0,0,0,0,0,0,0,0
20200312,03094X,大立光元大68展08,18.30,18.30,17.70,18.00,-4.00,-18.18,70000,14,1245000,0,0,0,0,0,0,0,70000,-70000,-70000
20200312,03098P,技嘉凱基93售01,,,,,0.00,0.00,0,0,0,0,0,0,0,0,0,0,0,0,0
20200312,03100P,緯創凱基93售01,,,,,0.00,0.00,0,0,0,0,0,0,0,0,0,0,0,0,0
20200312,03101P,泰鼎凱基93售01,,,,,0.00,0.00,0,0,0,0,0,0,0,0,0,0,0,0,0
20200312,03102P,瑞儀凱基93售03,0.52,0.52,0.52,0.52,+0.09,20.93,15000,1,7800,0,0,0,0,0,0,15000,0,15000,15000
20200312,03103P,超眾凱基93售02,0.17,0.20,0.17,0.20,0.00,0.00,150000,2,28500,0,0,0,0,0,0,150000,0,150000,150000
20200312,03108P,旺宏國泰93售02,,,,,0.00,0.00,0,0,0,0,0,0,0,0,0,0,0,0,0
20200312,03109P,聯茂國泰93售01,,,,,0.00,0.00,0,0,0,0,0,0,0,0,0,0,0,0,0
20200312,03110P,台表科國泰93售02,,,,,0.00,0.00,0,0,0,0,0,0,0,0,0,0,0,0,0
20200312,03111P,元油2X富邦97售01,2.34,2.51,2.34,2.51,+0.35,16.2,30000,2,73600,0,0,0,0,0,0,10000,20000,-10000,-10000
20200312,03127P,亞泥凱基93售01,,,,,0.00,0.00,0,0,0,0,0,0,0,0,0,0,0,0,0
20200312,03128P,華通凱基93售04,,,,,0.00,0.00,0,0,0,0,0,0,0,0,0,0,0,0,0
20200312,03129P,廣宇凱基93售01,,,,,0.00,0.00,0,0,0,0,0,0,0,0,0,0,0,0,0
20200312,03135P,健策凱基93售03,,,,,0.00,0.00,0,0,0,0,0,0,0,0,0,0,0,0,0
20200312,03136P,台表科凱基93售03,,,,,0.00,0.00,0,0,0,0,0,0,0,0,0,0,0,0,0
20200312,03147P,台積電國泰93售02,0.01,0.01,0.01,0.01,0.00,0.00,506000,5,5060,0,0,0,0,0,0,506000,0,506000,506000
20200312,03149P,超眾國泰93售04,,,,,0.00,0.00,0,0,0,0,0,0,0,0,0,0,0,0,0
20200312,03152P,台光電凱基93售05,,,,,0.00,0.00,0,0,0,0,0,0,0,0,0,0,0,0,0
20200312,03154P,瑞儀凱基93售04,,,,,0.00,0.00,0,0,0,0,0,0,0,0,0,0,0,0,0
20200312,03162P,華邦電中信96售02,1.12,1.41,1.11,1.39,+0.34,32.38,347000,13,410340,0,0,0,0,0,0,187000,160000,27000,27000
20200312,03171P,元油2X國票93售03,,,,,0.00,0.00,0,0,0,0,0,0,0,0,0,0,0,0,0
20200312,03177P,大立光統一93售01,0.69,0.91,0.69,0.91,0.00,0.00,76000,3,53260,0,0,0,0,0,0,75000,1000,74000,74000
20200312,03179P,力成統一93售01,,,,,0.00,0.00,0,0,0,0,0,0,0,0,0,0,0,0,0
20200312,03180P,華邦電國泰93售01,,,,,0.00,0.00,0,0,0,0,0,0,0,0,0,0,0,0,0
20200312,03181P,道瓊指中信96售01,0.27,0.46,0.27,0.43,+0.20,86.96,1312000,76,559840,45000,0,45000,0,0,0,470000,792000,-322000,-277000
20200312,03183P,玉晶光中信93售01,0.01,0.01,0.01,0.01,0.00,0.00,954000,24,9540,0,0,0,0,0,0,0,0,0,0
20200312,03197P,欣興富邦93售02,,,,,0.00,0.00,0,0,0,0,0,0,0,0,0,0,0,0,0
20200312,03202P,揚明光群益94售01,,,,,0.00,0.00,0,0,0,0,0,0,0,0,0,0,0,0,0
20200312,03237P,玉晶光凱基94售01,0.12,0.15,0.12,0.15,0.00,0.00,4000,4,520,0,0,0,0,0,0,4000,0,4000,4000
20200312,03242P,玉晶光國泰94售02,0.07,0.16,0.07,0.16,+0.11,220.0,432000,7,40360,0,0,0,0,0,0,421000,0,421000,421000
20200312,03243P,TPK富邦94售01,,,,,0.00,0.00,0,0,0,0,0,0,0,0,0,0,0,0,0
20200312,03252P,玉晶光群益95售02,0.35,0.47,0.35,0.47,+0.15,46.88,278000,13,118020,0,0,0,0,0,0,225000,43000,182000,182000
20200312,03253P,玉晶光群益96售01,0.23,0.32,0.23,0.32,+0.10,45.45,683000,29,189540,0,0,0,0,0,0,424000,245000,179000,179000
20200312,03267P,玉晶光國票95售01,0.10,0.17,0.09,0.13,+0.06,85.71,205000,11,23300,0,0,0,0,0,0,165000,0,165000,165000
20200312,03292P,美律中信94售01,,,,,0.00,0.00,0,0,0,0,0,0,0,0,0,0,0,0,0
20200312,03296P,康控群益94售01,,,,,0.00,0.00,0,0,0,0,0,0,0,0,0,0,0,0,0
20200312,03298P,元油2X凱基95售01,5.95,5.95,5.95,5.95,+0.65,12.26,184000,1,1094800,0,0,0,0,0,0,184000,184000,0,0
20200312,03307P,元油2X元大95售03,4.43,4.44,4.39,4.39,+0.61,16.14,704000,11,3106050,0,0,0,0,0,0,704000,570000,134000,134000
20200312,03314P,滬深2X群益96售02,0.36,0.47,0.36,0.47,+0.13,38.24,210000,8,94860,0,0,0,0,0,0,209000,1000,208000,208000
20200312,03334P,元油2X凱基95售02,,,,,0.00,0.00,0,0,0,0,0,0,0,0,0,0,0,0,0
20200312,03365P,元油2X富邦98售01,5.10,5.10,5.10,5.10,0.00,0.00,674000,3,3437400,0,0,0,0,0,0,674000,674000,0,0
20200312,03366P,元油2X元大95售05,3.68,3.69,3.68,3.69,0.00,0.00,130000,2,478700,0,0,0,0,0,0,130000,0,130000,130000
20200312,03371P,鴻海國票93售01,,,,,0.00,0.00,0,0,0,0,0,0,0,0,0,0,0,0,0
20200312,03372P,華邦電國票93售01,,,,,0.00,0.00,0,0,0,0,0,0,0,0,0,0,0,0,0
20200312,03373P,易華電國票93售02,,,,,0.00,0.00,0,0,0,0,0,0,0,0,0,0,0,0,0
20200312,03375P,元油2X群益93售02,8.45,8.45,8.35,8.35,0.00,0.00,250000,5,2095000,0,0,0,0,0,0,250000,250000,0,0
20200312,03382P,瑞昱凱基93售02,,,,,0.00,0.00,0,0,0,0,0,0,0,0,0,0,0,0,0
20200312,03383P,南電凱基93售03,,,,,0.00,0.00,0,0,0,0,0,0,0,0,0,0,0,0,0
20200312,03387P,元油2X元富94售02,4.66,4.70,4.66,4.70,0.00,0.00,4092000,9,19183490,0,0,0,0,0,0,4092000,4092000,0,0
20200312,03388P,元油2X元富98售02,3.52,3.92,3.52,3.92,0.00,0.00,21000,19,78000,0,0,0,0,0,0,16000,0,16000,16000
20200312,03395P,華新科元大93售05,,,,,0.00,0.00,0,0,0,0,0,0,0,0,0,0,0,0,0
20200312,03398P,大立光兆豐93售02,,,,,0.00,0.00,0,0,0,0,0,0,0,0,0,0,0,0,0
20200312,03399P,A50正2中信94售01,0.26,0.32,0.26,0.30,+0.07,30.43,553000,31,162360,0,0,0,0,0,0,423000,125000,298000,298000
20200312,03400P,聯發科中信93售01,,,,,0.00,0.00,0,0,0,0,0,0,0,0,0,0,0,0,0
20200312,03407P,華邦電亞東93售01,,,,,0.00,0.00,0,0,0,0,0,0,0,0,0,0,0,0,0
20200312,03408P,智邦國票93售01,,,,,0.00,0.00,0,0,0,0,0,0,0,0,0,0,0,0,0
20200312,03409P,南亞科國票93售01,0.03,0.03,0.03,0.03,0.00,0.00,20000,1,600,0,0,0,0,0,0,20000,0,20000,20000
20200312,03410P,欣興國票93售03,,,,,0.00,0.00,0,0,0,0,0,0,0,0,0,0,0,0,0
20200312,03411P,瑞儀國票93售01,,,,,0.00,0.00,0,0,0,0,0,0,0,0,0,0,0,0,0
20200312,03412P,滬深2X群益98售01,0.47,0.55,0.47,0.54,+0.09,20.0,1336000,36,699270,0,0,0,0,0,0,759000,562000,197000,197000
20200312,03413B,臺股指凱基94熊19,1.85,2.32,1.80,2.20,+0.49,28.65,2282000,102,4661900,0,0,0,0,0,0,709000,1558000,-849000,-849000
20200312,03414B,臺股指凱基99熊01,2.65,3.19,2.65,3.10,+0.55,21.57,1644000,88,4880430,2000,0,2000,0,0,0,1057000,1045000,12000,14000
20200312,03415B,臺股指元大93熊49,2.20,2.60,2.20,2.60,+0.63,31.98,12000,2,28000,0,0,0,0,0,0,4000,8000,-4000,-4000
20200312,03416B,臺股指凱基95熊05,2.48,2.94,2.48,2.89,+0.50,20.92,201000,18,553060,0,0,0,0,0,0,152000,49000,103000,103000
20200312,03416P,滬深2X國泰93售02,,,,,0.00,0.00,0,0,0,0,0,0,0,0,0,0,0,0,0
20200312,03417B,臺股指凱基95熊19,,,,,0.00,0.00,0,0,0,0,0,0,0,0,0,0,0,0,0
20200312,03417P,智邦國泰93售02,,,,,0.00,0.00,0,0,0,0,0,0,0,0,0,0,0,0,0
20200312,03418B,臺股指元大95熊20,2.57,3.09,2.57,3.00,+0.53,21.46,399000,34,1137790,0,0,0,0,0,0,114000,285000,-171000,-171000
20200312,03418P,台積電統一94售01,0.01,0.03,0.01,0.03,0.00,0.00,3000,3,60,0,0,0,0,0,0,3000,0,3000,3000
20200312,03419B,臺股指元富99熊03,4.16,4.16,4.16,4.16,0.00,0.00,1000,1,4160,0,0,0,0,0,0,0,1000,-1000,-1000
20200312,03420B,臺股指元大95熊31,3.07,3.37,3.07,3.37,+0.50,17.42,173000,13,543990,0,0,0,0,0,0,134000,39000,95000,95000
20200312,03421B,臺股指元大99熊01,3.86,4.15,3.86,4.05,+0.52,14.73,41000,15,164410,0,0,0,0,0,0,25000,16000,9000,9000
20200312,03422B,臺股指凱基96熊28,,,,,0.00,0.00,0,0,0,0,0,0,0,0,0,0,0,0,0
20200312,03423B,臺股指元大94熊29,,,,,0.00,0.00,0,0,0,0,0,0,0,0,0,0,0,0,0
20200312,03423P,華新科元大93售06,,,,,0.00,0.00,0,0,0,0,0,0,0,0,0,0,0,0,0
20200312,03424B,臺股指元大96熊26,,,,,0.00,0.00,0,0,0,0,0,0,0,0,0,0,0,0,0
20200312,03424P,大立光元大93售09,,,,,0.00,0.00,0,0,0,0,0,0,0,0,0,0,0,0,0
20200312,03425B,臺股指元大9A熊01,3.79,4.24,3.79,4.16,+0.47,12.74,350000,19,1375200,0,0,0,0,0,0,194000,156000,38000,38000
20200312,03426B,臺股指元大95熊33,,,,,0.00,0.00,0,0,0,0,0,0,0,0,0,0,0,0,0
20200312,03426P,台積電兆豐93售04,,,,,0.00,0.00,0,0,0,0,0,0,0,0,0,0,0,0,0
20200312,03427B,臺股指元大9A熊02,4.10,4.37,4.10,4.35,+0.61,16.31,107000,5,440020,0,0,0,0,0,0,106000,1000,105000,105000
20200312,03427P,滬深2X中信94售02,0.16,0.21,0.16,0.20,+0.07,53.85,559000,5,115400,0,0,0,0,0,0,559000,0,559000,559000
20200312,03428B,臺股指凱基97熊18,,,,,0.00,0.00,0,0,0,0,0,0,0,0,0,0,0,0,0
20200312,03428P,道瓊指中信94售02,0.58,0.84,0.58,0.75,+0.37,97.37,387000,24,264060,0,0,0,0,0,0,287000,90000,197000,197000
20200312,03429B,臺股指元富97熊07,4.11,4.11,4.11,4.11,+0.57,16.1,4000,1,16440,0,0,0,0,0,0,4000,0,4000,4000
20200312,03430B,臺股指元大9B熊01,3.18,3.65,3.18,3.58,+0.50,16.23,108000,30,376510,0,0,0,0,0,0,46000,62000,-16000,-16000
20200312,03431B,元油2X凱基9B熊03,4.56,4.56,4.56,4.56,0.00,0.00,19000,1,86640,0,0,0,0,0,0,19000,19000,0,0
20200312,03432B,臺股指凱基98熊13,,,,,0.00,0.00,0,0,0,0,0,0,0,0,0,0,0,0,0
20200312,03432P,鴻海凱基93售11,,,,,0.00,0.00,0,0,0,0,0,0,0,0,0,0,0,0,0
20200312,03433B,臺股指元大9C熊01,3.58,3.58,3.53,3.54,+0.51,16.83,8000,3,28330,0,0,0,0,0,0,8000,0,8000,8000
20200312,03436P,力成凱基93售03,,,,,0.00,0.00,0,0,0,0,0,0,0,0,0,0,0,0,0
20200312,03437P,欣興群益93售02,,,,,0.00,0.00,0,0,0,0,0,0,0,0,0,0,0,0,0
20200312,03438P,群創群益98售03,0.19,0.24,0.19,0.22,+0.07,46.67,813000,15,157890,0,0,0,0,0,0,8000,805000,-797000,-797000
20200312,03441P,友達國泰93售03,,,,,0.00,0.00,0,0,0,0,0,0,0,0,0,0,0,0,0
20200312,03444P,裕隆統一93售02,0.75,0.75,0.75,0.75,0.00,0.00,10000,1,7500,0,0,0,0,0,0,0,10000,-10000,-10000
20200312,03446P,南亞科統一93售02,,,,,0.00,0.00,0,0,0,0,0,0,0,0,0,0,0,0,0
20200312,03449P,臺股指統一93售05,,,,,0.00,0.00,0,0,0,0,0,0,0,0,0,0,0,0,0
20200312,03450P,元油2X元富98售05,5.05,5.05,5.05,5.05,0.00,0.00,80000,1,404000,0,0,0,0,0,0,80000,80000,0,0
20200312,03454P,元油2X元大95售06,,,,,0.00,0.00,0,0,0,0,0,0,0,0,0,0,0,0,0
20200312,03463P,正文國票93售01,,,,,0.00,0.00,0,0,0,0,0,0,0,0,0,0,0,0,0
20200312,03481P,聯茂凱基93售05,,,,,0.00,0.00,0,0,0,0,0,0,0,0,0,0,0,0,0
20200312,03492P,大立光國泰94售04,0.06,0.07,0.05,0.07,+0.05,250.0,29000,4,1850,0,0,0,0,0,0,0,25000,-25000,-25000
20200312,03497P,滬深2X元富95售02,0.83,0.86,0.83,0.86,+0.27,45.76,70000,4,58650,0,0,0,0,0,0,50000,20000,30000,30000
20200312,03498P,國巨元富94售01,,,,,0.00,0.00,0,0,0,0,0,0,0,0,0,0,0,0,0
20200312,03501P,緯穎元富94售01,,,,,0.00,0.00,0,0,0,0,0,0,0,0,0,0,0,0,0
20200312,03517P,臺股指元大93售13,,,,,0.00,0.00,0,0,0,0,0,0,0,0,0,0,0,0,0
20200312,03518P,臺股指元大93售14,,,,,0.00,0.00,0,0,0,0,0,0,0,0,0,0,0,0,0
20200312,03519P,臺股指元大93售15,0.01,0.01,0.01,0.01,0.00,0.00,80000,4,800,0,0,0,0,0,0,80000,0,80000,80000
20200312,03520P,臺股指元大93售16,0.07,0.63,0.06,0.58,0.00,0.00,652000,43,178100,0,0,0,0,0,0,621000,315000,306000,306000
20200312,03525P,和大國票93售01,,,,,0.00,0.00,0,0,0,0,0,0,0,0,0,0,0,0,0
20200312,03526P,大立光國票93售01,,,,,0.00,0.00,0,0,0,0,0,0,0,0,0,0,0,0,0
20200312,035274,華新台新97購01,,,,,0.00,0.00,0,0,0,0,0,0,0,0,0,0,0,0,0
20200312,035275,台積電台新97購01,19.80,19.80,15.70,18.20,-3.30,-15.35,115000,32,2043400,0,0,0,0,0,0,33000,80000,-47000,-47000
20200312,035276,南亞科台新97購01,,,,,0.00,0.00,0,0,0,0,0,0,0,0,0,0,0,0,0
20200312,035277,景碩台新97購01,,,,,0.00,0.00,0,0,0,0,0,0,0,0,0,0,0,0,0
20200312,03527P,大立光國票93售02,,,,,0.00,0.00,0,0,0,0,0,0,0,0,0,0,0,0,0
20200312,03528P,超眾國票93售02,,,,,0.00,0.00,0,0,0,0,0,0,0,0,0,0,0,0,0
20200312,03543P,T50正2中信95售02,0.20,0.38,0.20,0.33,+0.18,120.0,737000,14,212660,0,0,0,0,0,0,647000,88000,559000,559000
20200312,03544P,貿聯國票93售01,,,,,0.00,0.00,0,0,0,0,0,0,0,0,0,0,0,0,0
20200312,03546P,上銀兆豐93售03,,,,,0.00,0.00,0,0,0,0,0,0,0,0,0,0,0,0,0
20200312,03553P,上銀富邦94售01,0.24,0.34,0.24,0.34,0.00,0.00,105000,2,35200,0,0,0,0,0,0,5000,100000,-95000,-95000
20200312,03555P,台積電富邦95售01,0.02,0.03,0.02,0.03,+0.02,200.0,2546000,41,51270,0,0,0,0,0,0,2271000,0,2271000,2271000
20200312,03557P,大立光元大93售12,0.12,0.17,0.12,0.16,+0.12,300.0,35000,3,5350,0,0,0,0,0,0,10000,25000,-15000,-15000
20200312,03560P,中鋼中信94售02,0.63,0.93,0.63,0.93,+0.33,55.0,313000,21,226660,0,0,0,0,0,0,111000,202000,-91000,-91000
20200312,03561P,聯發科中信93售02,,,,,0.00,0.00,0,0,0,0,0,0,0,0,0,0,0,0,0
20200312,03563P,鴻海群益93售03,0.01,0.01,0.01,0.01,0.00,0.00,60000,1,600,0,0,0,0,0,0,60000,0,60000,60000
20200312,03564P,致茂群益94售01,0.63,0.72,0.63,0.72,0.00,0.00,165000,2,109800,0,0,0,0,0,0,65000,100000,-35000,-35000
20200312,03566P,群創群益96售01,0.50,0.50,0.49,0.49,0.00,0.00,2000,2,990,0,0,0,0,0,0,0,2000,-2000,-2000
20200312,03567P,百和群益94售02,1.87,1.95,1.87,1.87,0.00,0.00,20000,4,37870,0,0,0,0,0,0,10000,10000,0,0
20200312,03576P,聯發科統一94售02,0.37,0.63,0.37,0.61,+0.31,103.33,660000,20,311220,0,0,0,0,0,0,641000,19000,622000,622000
20200312,03583P,聯發科富邦94售02,0.49,0.49,0.49,0.49,+0.27,122.73,25000,1,12250,0,0,0,0,0,0,25000,0,25000,25000
20200312,03591P,中環中信94售01,1.85,1.92,1.85,1.92,+0.28,17.07,40000,3,74700,0,0,0,0,0,0,0,20000,-20000,-20000
20200312,03595P,智易群益94售01,0.54,0.65,0.54,0.65,+0.18,38.3,359000,3,227960,0,0,0,0,0,0,49000,310000,-261000,-261000
20200312,03602C,臺股指元大93牛01,,,,,0.00,0.00,0,0,0,0,0,0,0,0,0,0,0,0,0
20200312,03603P,群創凱基98售04,0.86,0.91,0.86,0.91,0.00,0.00,21000,2,18110,0,0,0,0,0,0,0,21000,-21000,-21000
20200312,03604P,群創凱基98售05,,,,,0.00,0.00,0,0,0,0,0,0,0,0,0,0,0,0,0
20200312,03607P,滬深2X富邦95售01,,,,,0.00,0.00,0,0,0,0,0,0,0,0,0,0,0,0,0
20200312,036084,台灣50台新98購01,5.35,5.40,4.42,4.87,-1.13,-18.83,40000,14,191870,0,0,0,0,0,0,0,40000,-40000,-40000
20200312,03612C,臺股指元大95牛01,1.68,1.68,1.25,1.25,-0.62,-33.16,322000,24,419500,0,0,0,0,0,0,6000,316000,-310000,-310000
20200312,03615C,臺股指元大94牛01,2.19,2.19,1.78,1.86,-0.69,-27.06,210000,11,387450,0,0,0,0,0,0,0,210000,-210000,-210000
20200312,03618C,高股息凱基95牛01,1.93,1.93,1.65,1.71,-0.26,-13.2,147000,28,258050,0,0,0,0,0,0,0,147000,-147000,-147000
20200312,03619C,臺股指元大95牛02,2.48,2.49,2.08,2.16,-0.51,-19.1,77000,16,177680,0,0,0,0,0,0,19000,58000,-39000,-39000
20200312,03623P,台積電群益93售03,,,,,0.00,0.00,0,0,0,0,0,0,0,0,0,0,0,0,0
20200312,03626P,可成兆豐93售03,,,,,0.00,0.00,0,0,0,0,0,0,0,0,0,0,0,0,0
20200312,03627P,大立光兆豐93售03,,,,,0.00,0.00,0,0,0,0,0,0,0,0,0,0,0,0,0
20200312,03628C,臺股指元大93牛02,,,,,0.00,0.00,0,0,0,0,0,0,0,0,0,0,0,0,0
20200312,03630C,臺股指元富93牛02,,,,,0.00,0.00,0,0,0,0,0,0,0,0,0,0,0,0,0
20200312,03631P,鴻海凱基93售13,,,,,0.00,0.00,0,0,0,0,0,0,0,0,0,0,0,0,0
20200312,03632C,臺股指元大95牛03,,,,,0.00,0.00,0,0,0,0,0,0,0,0,0,0,0,0,0
20200312,03633C,臺股指凱基93牛19,0.93,0.93,0.91,0.91,0.00,0.00,31000,2,28810,0,0,0,0,0,0,0,31000,-31000,-31000
20200312,03635C,滬深2X元富99牛01,2.25,2.25,2.07,2.12,-0.33,-13.47,181000,6,389900,0,0,0,0,0,0,181000,0,181000,181000
20200312,03637C,臺股指凱基94牛18,1.02,1.02,0.60,0.73,-0.47,-39.17,631000,27,462070,0,0,0,0,0,0,25000,606000,-581000,-581000
20200312,03638C,T50反1元大94牛03,1.23,1.51,1.22,1.43,+0.31,27.68,1193000,27,1552910,0,0,0,0,0,0,126000,1067000,-941000,-941000
20200312,03638P,嘉晶凱基93售03,,,,,0.00,0.00,0,0,0,0,0,0,0,0,0,0,0,0,0
20200312,03639P,祥碩凱基93售05,,,,,0.00,0.00,0,0,0,0,0,0,0,0,0,0,0,0,0
20200312,03640P,百和凱基93售05,,,,,0.00,0.00,0,0,0,0,0,0,0,0,0,0,0,0,0
20200312,03641C,臺股指凱基95牛18,0.66,0.66,0.16,0.24,-0.52,-68.42,3379000,91,1124070,0,0,0,0,0,0,261000,3068000,-2807000,-2807000
20200312,03642C,臺股指元大94牛27,0.67,0.67,0.29,0.53,0.00,0.00,82000,14,33400,0,0,0,0,0,0,6000,76000,-70000,-70000
20200312,03643C,臺股指元富99牛04,0.43,0.44,0.08,0.17,-0.48,-73.85,215000,29,48180,0,0,0,0,0,0,18000,154000,-136000,-136000
20200312,03644C,臺股指元大94牛28,0.36,0.36,0.05,0.09,-0.40,-81.63,1351000,50,174210,0,499000,-499000,0,0,0,342000,539000,-197000,-696000
20200312,03645C,臺股指凱基96牛27,0.36,0.36,0.18,0.19,-0.29,-60.42,490000,17,108600,0,0,0,0,0,0,5000,470000,-465000,-465000
20200312,03646C,臺股指元大95牛32,0.33,0.35,0.09,0.15,-0.46,-75.41,1011000,51,227300,0,0,0,0,0,0,38000,973000,-935000,-935000
20200312,03647C,T50反1元富99牛02,3.06,3.38,3.05,3.34,+0.58,21.01,463000,7,1426000,0,0,0,0,0,0,420000,43000,377000,377000
20200312,03647P,京元電元富95售02,1.14,1.40,1.14,1.38,+0.36,35.29,133000,8,162170,0,0,0,0,0,0,15000,118000,-103000,-103000
20200312,03648C,T50反1元大96牛07,2.72,2.84,2.72,2.84,+0.40,16.39,10000,2,28280,0,0,0,0,0,0,10000,0,10000,10000
20200312,03649C,T50反1凱基99牛05,,,,,0.00,0.00,0,0,0,0,0,0,0,0,0,0,0,0,0
20200312,03649P,聯發科國泰93售02,,,,,0.00,0.00,0,0,0,0,0,0,0,0,0,0,0,0,0
20200312,03650C,T50反1元大98牛05,2.93,2.93,2.93,2.93,0.00,0.00,100000,1,293000,0,0,0,0,0,0,0,100000,-100000,-100000
20200312,03650P,群創國泰93售03,,,,,0.00,0.00,0,0,0,0,0,0,0,0,0,0,0,0,0
20200312,03651C,臺股指凱基97牛17,0.22,0.30,0.22,0.30,+0.07,30.43,976000,29,215220,0,0,0,0,0,0,921000,0,921000,921000
20200312,03652C,臺股指元大03牛01,1.18,1.18,0.65,0.77,-0.51,-39.84,2652000,108,2381820,5000,0,5000,0,0,0,726000,1926000,-1200000,-1195000
20200312,03653C,臺股指元大95牛34,0.77,0.77,0.57,0.57,-0.64,-52.89,129000,7,78620,0,0,0,0,0,0,0,129000,-129000,-129000
20200312,03656C,臺股指凱基99牛12,0.43,0.43,0.31,0.31,-0.22,-41.51,292000,16,95590,0,0,0,0,0,0,225000,35000,190000,190000
20200312,03657C,T50反1元大99牛01,2.85,2.86,2.85,2.86,+0.41,16.73,200000,2,571000,0,0,0,0,0,0,100000,100000,0,0
20200312,03658C,T50反1元大9A牛02,3.19,3.22,3.10,3.19,0.00,0.00,12000,4,38100,0,0,0,0,0,0,0,12000,-12000,-12000
20200312,03660P,台積電中信93售01,,,,,0.00,0.00,0,0,0,0,0,0,0,0,0,0,0,0,0
20200312,03661C,臺股指凱基9C牛03,0.51,0.52,0.48,0.49,-0.13,-20.97,1784000,38,877690,0,0,0,0,0,0,635000,1104000,-469000,-469000
20200312,036628,統一台新99購01,3.43,3.43,2.81,2.81,-0.87,-23.64,15000,4,49650,0,0,0,0,0,0,13000,2000,11000,11000
20200312,036629,智邦台新99購01,,,,,0.00,0.00,0,0,0,0,0,0,0,0,0,0,0,0,0
20200312,03662C,FBVIX凱基03牛01,4.88,5.55,4.81,5.25,+0.87,19.86,271000,17,1392540,0,0,0,0,0,0,206000,65000,141000,141000
20200312,036630,玉山金台新99購01,,,,,0.00,0.00,0,0,0,0,0,0,0,0,0,0,0,0,0
20200312,03663C,臺股指元大04牛01,1.15,1.15,0.70,0.74,-0.52,-41.27,1956000,81,1686240,0,0,0,0,0,0,365000,1591000,-1226000,-1226000
20200312,03664C,臺股指元大05牛01,1.54,1.54,1.05,1.25,-0.47,-27.33,557000,20,700650,0,0,0,0,0,0,360000,197000,163000,163000
20200312,03667P,鴻海凱基93售14,,,,,0.00,0.00,0,0,0,0,0,0,0,0,0,0,0,0,0
20200312,03671P,大立光凱基95售02,,,,,0.00,0.00,0,0,0,0,0,0,0,0,0,0,0,0,0
20200312,03676P,大立光國泰93售03,,,,,0.00,0.00,0,0,0,0,0,0,0,0,0,0,0,0,0
20200312,03686P,大立光統一98售02,0.49,0.71,0.49,0.70,+0.28,66.67,1594000,71,970380,0,0,0,0,0,0,1316000,32000,1284000,1284000
20200312,03708P,鴻海亞東93售01,,,,,0.00,0.00,0,0,0,0,0,0,0,0,0,0,0,0,0
20200312,03712P,京元電統一93售02,,,,,0.00,0.00,0,0,0,0,0,0,0,0,0,0,0,0,0
20200312,03720P,元油2X富邦95售01,8.25,8.35,8.25,8.25,0.00,0.00,1135000,16,9375500,0,0,0,0,0,0,1135000,1135000,0,0
20200312,03737P,臺股指中信95售01,,,,,0.00,0.00,0,0,0,0,0,0,0,0,0,0,0,0,0
20200312,03740P,奇鋐群益94售01,,,,,0.00,0.00,0,0,0,0,0,0,0,0,0,0,0,0,0
20200312,03751P,旺宏富邦95售01,0.19,0.28,0.19,0.27,+0.12,80.0,685000,11,176950,0,0,0,0,0,0,675000,5000,670000,670000
20200312,037536,道瓊反元富93購01,0.27,0.51,0.27,0.47,+0.33,235.71,335000,25,142270,0,0,0,0,0,0,333000,0,333000,333000
20200312,03763P,聯發科元富96售01,0.57,0.86,0.57,0.85,+0.35,70.0,937000,49,699460,0,0,0,0,0,0,484000,453000,31000,31000
20200312,03765P,大立光元富96售01,0.42,0.62,0.42,0.62,+0.29,87.88,2684000,20,1580450,0,0,0,0,0,0,2619000,60000,2559000,2559000
20200312,03777P,華通中信95售01,0.05,0.12,0.05,0.11,+0.06,120.0,2014000,29,186190,0,0,0,0,0,0,1574000,440000,1134000,1134000
20200312,037839,T50反1群益93購01,,,,,0.00,0.00,0,0,0,0,0,0,0,0,0,0,0,0,0
20200312,03786P,鴻海群益94售02,0.01,0.01,0.01,0.01,0.00,0.00,310000,2,3100,0,0,0,0,0,0,310000,0,310000,310000
20200312,03787P,台積電群益94售02,,,,,0.00,0.00,0,0,0,0,0,0,0,0,0,0,0,0,0
20200312,03788P,聯發科群益94售02,,,,,0.00,0.00,0,0,0,0,0,0,0,0,0,0,0,0,0
20200312,03799P,京元電元大94售01,,,,,0.00,0.00,0,0,0,0,0,0,0,0,0,0,0,0,0
20200312,03808P,旺宏國泰94售02,0.04,0.05,0.04,0.05,0.00,0.00,41000,2,2040,0,0,0,0,0,0,41000,0,41000,41000
20200312,038095,T50反1群益93購02,0.01,0.01,0.01,0.01,0.00,0.00,40000,12,400,0,0,0,0,0,0,0,0,0,0
20200312,03810P,大立光富邦98售01,0.58,0.80,0.58,0.79,+0.27,51.92,268000,5,196940,0,0,0,0,0,0,188000,80000,108000,108000
20200312,03821P,上海銀統一95售01,0.80,1.00,0.80,1.00,+0.25,33.33,302000,12,254620,0,0,0,0,0,0,88000,208000,-120000,-120000
20200312,03824P,燿華元大94售01,,,,,0.00,0.00,0,0,0,0,0,0,0,0,0,0,0,0,0
20200312,03826P,瀚宇博元大95售01,1.09,1.33,1.09,1.27,+0.27,27.0,149000,7,169230,0,0,0,0,0,0,13000,149000,-136000,-136000
20200312,03827P,矽創國票94售01,0.48,0.65,0.46,0.64,+0.20,45.45,122000,11,61530,0,0,0,0,0,0,41000,80000,-39000,-39000
20200312,03828P,致茂中信95售01,0.95,1.24,0.95,1.24,+0.42,51.22,480000,12,526980,0,0,0,0,0,0,13000,467000,-454000,-454000
20200312,03829P,元大金中信95售01,,,,,0.00,0.00,0,0,0,0,0,0,0,0,0,0,0,0,0
20200312,03830P,緯創中信95售01,,,,,0.00,0.00,0,0,0,0,0,0,0,0,0,0,0,0,0
20200312,03831P,臺股指中信95售02,0.44,0.79,0.44,0.71,+0.33,86.84,919000,33,559740,0,0,0,0,0,0,421000,496000,-75000,-75000
20200312,03832P,臺股指中信95售03,0.49,0.81,0.46,0.81,+0.43,113.16,1224000,27,902490,0,0,0,0,0,0,1056000,840000,216000,216000
20200312,03840P,台積電統一99售02,0.40,0.55,0.40,0.48,+0.10,26.32,6745000,194,3102730,15000,0,15000,0,0,0,1387000,4742000,-3355000,-3340000
20200312,038455,群臺反群益94購01,,,,,0.00,0.00,0,0,0,0,0,0,0,0,0,0,0,0,0
20200312,038489,T50反1台新9A購01,0.21,0.40,0.21,0.38,+0.17,80.95,730000,37,215070,0,0,0,0,0,0,101000,0,101000,101000
20200312,03857P,聯發科元富99售02,0.55,0.73,0.55,0.73,+0.23,46.0,761000,29,488950,0,0,0,0,0,0,372000,366000,6000,6000
20200312,03860P,群創元富97售01,0.81,0.99,0.81,0.99,+0.28,39.44,452000,13,395800,0,0,0,0,0,0,90000,362000,-272000,-272000
20200312,03861P,群創元富99售01,0.66,0.71,0.66,0.71,0.00,0.00,123000,3,86430,0,0,0,0,0,0,10000,113000,-103000,-103000
20200312,03874P,臺股指群益95售01,0.98,1.75,0.98,1.75,0.00,0.00,12000,5,18070,0,0,0,0,0,0,12000,0,12000,12000
20200312,03875P,滬深2X國票05售01,0.74,0.74,0.74,0.74,+0.06,8.82,1000,1,740,0,0,0,0,0,0,1000,0,1000,1000
20200312,03877P,台光電國票94售01,,,,,0.00,0.00,0,0,0,0,0,0,0,0,0,0,0,0,0
20200312,03885P,華新科統一96售01,0.34,0.47,0.34,0.47,+0.16,51.61,187000,9,75260,0,0,0,0,0,0,44000,143000,-99000,-99000
20200312,03889P,國巨國泰94售04,0.03,0.03,0.02,0.02,0.00,0.00,390000,3,10800,0,0,0,0,0,0,0,0,0,0
20200312,03890P,聯詠國泰94售02,,,,,0.00,0.00,0,0,0,0,0,0,0,0,0,0,0,0,0
20200312,03891P,晶技國泰94售02,,,,,0.00,0.00,0,0,0,0,0,0,0,0,0,0,0,0,0
20200312,03892P,元油2X中信95售01,4.32,4.32,4.32,4.32,0.00,0.00,90000,1,388800,0,0,0,0,0,0,90000,90000,0,0
20200312,03894P,鴻海凱基94售05,,,,,0.00,0.00,0,0,0,0,0,0,0,0,0,0,0,0,0
20200312,03896P,長榮航凱基95售01,2.79,2.79,2.23,2.53,+0.37,17.13,257000,26,615330,0,0,0,0,0,0,158000,76000,82000,82000
20200312,03899P,滬深2X群益95售03,1.10,1.12,1.10,1.12,0.00,0.00,30000,3,33400,0,0,0,0,0,0,30000,0,30000,30000
20200312,03902P,義隆國票94售01,,,,,0.00,0.00,0,0,0,0,0,0,0,0,0,0,0,0,0
20200312,03907P,易華電國泰94售03,,,,,0.00,0.00,0,0,0,0,0,0,0,0,0,0,0,0,0
20200312,03917P,鴻海凱基94售07,0.11,0.14,0.11,0.12,0.00,0.00,320000,4,39200,0,0,0,0,0,0,320000,0,320000,320000
20200312,039212,台達電台新9A購01,0.60,0.60,0.41,0.41,-0.28,-40.58,41000,6,20070,0,0,0,0,0,0,0,41000,-41000,-41000
20200312,03921P,亞光凱基94售01,0.88,0.88,0.88,0.88,0.00,0.00,10000,1,8800,0,0,0,0,0,0,0,10000,-10000,-10000
20200312,03927P,旺宏台新94售01,,,,,0.00,0.00,0,0,0,0,0,0,0,0,0,0,0,0,0
20200312,03935P,可成富邦95售01,0.66,0.69,0.66,0.69,+0.13,23.21,11000,2,7560,0,0,0,0,0,0,1000,10000,-9000,-9000
20200312,03939P,康控元大95售02,0.80,0.80,0.80,0.80,0.00,0.00,100000,1,80000,0,0,0,0,0,0,100000,0,100000,100000
20200312,03945P,欣興群益94售01,1.41,1.41,1.41,1.41,+0.35,33.02,10000,1,14100,0,0,0,0,0,0,10000,0,10000,10000
20200312,03947P,新光金國泰94售01,,,,,0.00,0.00,0,0,0,0,0,0,0,0,0,0,0,0,0
20200312,03951P,新光金凱基95售01,0.73,0.75,0.73,0.75,+0.14,22.95,40000,2,29600,0,0,0,0,0,0,20000,20000,0,0
20200312,03953P,易華電凱基94售01,2.88,2.88,2.88,2.88,0.00,0.00,10000,1,28800,0,0,0,0,0,0,0,10000,-10000,-10000
20200312,039550,滬深反凱基94購01,0.08,0.10,0.08,0.10,+0.02,25.0,173000,6,15080,0,0,0,0,0,0,0,0,0,0
20200312,03957P,創意統一94售02,,,,,0.00,0.00,0,0,0,0,0,0,0,0,0,0,0,0,0
20200312,03959P,義隆元富96售01,1.16,1.29,1.13,1.19,+0.13,12.26,194000,9,239820,0,0,0,0,0,0,165000,29000,136000,136000
20200312,03960P,新日興元富96售02,1.11,1.41,1.11,1.34,+0.29,27.62,380000,26,460740,0,0,0,0,0,0,60000,320000,-260000,-260000
20200312,03965P,上銀國票94售01,,,,,0.00,0.00,0,0,0,0,0,0,0,0,0,0,0,0,0
20200312,03969P,華新科國票94售01,0.05,0.05,0.05,0.05,0.00,0.00,120000,1,6000,0,0,0,0,0,0,120000,0,120000,120000
20200312,03971P,智邦亞東93售01,,,,,0.00,0.00,0,0,0,0,0,0,0,0,0,0,0,0,0
20200312,03972P,可成元大93售07,,,,,0.00,0.00,0,0,0,0,0,0,0,0,0,0,0,0,0
20200312,03973P,高鐵元大93售01,,,,,0.00,0.00,0,0,0,0,0,0,0,0,0,0,0,0,0
20200312,03974P,大立光元大93售25,,,,,0.00,0.00,0,0,0,0,0,0,0,0,0,0,0,0,0
20200312,03975P,大立光元大94售02,0.19,0.19,0.19,0.19,0.00,0.00,10000,1,1900,0,0,0,0,0,0,10000,0,10000,10000
20200312,03976P,智原元大93售02,,,,,0.00,0.00,0,0,0,0,0,0,0,0,0,0,0,0,0
20200312,03977P,上海銀元大93售01,2.65,2.65,2.65,2.65,0.00,0.00,12000,1,31800,0,0,0,0,0,0,12000,0,12000,12000
20200312,03978P,瑞儀元大93售01,,,,,0.00,0.00,0,0,0,0,0,0,0,0,0,0,0,0,0
20200312,03979P,台積電凱基93售16,0.01,0.01,0.01,0.01,0.00,0.00,20000,20,200,0,0,0,0,0,0,0,0,0,0
20200312,03980P,群創凱基95售02,,,,,0.00,0.00,0,0,0,0,0,0,0,0,0,0,0,0,0
20200312,03981P,嘉澤凱基93售02,,,,,0.00,0.00,0,0,0,0,0,0,0,0,0,0,0,0,0
20200312,03982P,智易國票94售02,,,,,0.00,0.00,0,0,0,0,0,0,0,0,0,0,0,0,0
20200312,03983P,健策國票93售01,,,,,0.00,0.00,0,0,0,0,0,0,0,0,0,0,0,0,0
20200312,03984P,上銀群益93售05,0.12,0.21,0.12,0.21,+0.17,425.0,35000,2,6000,0,0,0,0,0,0,35000,0,35000,35000
20200312,03985P,聯發科群益93售09,,,,,0.00,0.00,0,0,0,0,0,0,0,0,0,0,0,0,0
20200312,03986P,大立光群益93售10,,,,,0.00,0.00,0,0,0,0,0,0,0,0,0,0,0,0,0
20200312,03987P,亞光群益93售02,,,,,0.00,0.00,0,0,0,0,0,0,0,0,0,0,0,0,0
20200312,03988P,上海銀群益93售01,,,,,0.00,0.00,0,0,0,0,0,0,0,0,0,0,0,0,0
20200312,03989P,同欣電群益93售02,,,,,0.00,0.00,0,0,0,0,0,0,0,0,0,0,0,0,0
20200312,03990P,嘉澤永豐93售01,,,,,0.00,0.00,0,0,0,0,0,0,0,0,0,0,0,0,0
20200312,03991P,台積電統一93售03,0.50,0.50,0.50,0.50,0.00,0.00,1000,1,500,0,0,0,0,0,0,0,0,0,0
20200312,03992P,臺股指統一93售06,0.22,0.47,0.22,0.47,+0.26,123.81,6000,2,1570,0,0,0,0,0,0,6000,0,6000,6000
20200312,03993P,滬深2X中信94售03,1.06,1.26,1.05,1.20,+0.21,21.21,282000,25,328610,0,0,0,0,0,0,139000,143000,-4000,-4000
20200312,03994P,台積電中信93售03,,,,,0.00,0.00,0,0,0,0,0,0,0,0,0,0,0,0,0
20200312,03995P,滬深2X國泰95售01,,,,,0.00,0.00,0,0,0,0,0,0,0,0,0,0,0,0,0
20200312,03996P,旺宏國泰95售01,0.47,0.66,0.47,0.62,+0.18,40.91,627000,9,357930,0,0,0,0,0,0,246000,381000,-135000,-135000
20200312,03997P,台郡群益93售03,,,,,0.00,0.00,0,0,0,0,0,0,0,0,0,0,0,0,0
20200312,03998P,GIS群益93售01,,,,,0.00,0.00,0,0,0,0,0,0,0,0,0,0,0,0,0
20200312,03999P,鴻海凱基94售11,0.21,0.32,0.20,0.30,+0.18,150.0,650000,10,183850,0,0,0,0,0,0,480000,170000,310000,310000
20200312,04000P,台積電凱基93售18,,,,,0.00,0.00,0,0,0,0,0,0,0,0,0,0,0,0,0
20200312,04001P,聯發科凱基93售15,,,,,0.00,0.00,0,0,0,0,0,0,0,0,0,0,0,0,0
20200312,04002P,大立光凱基93售23,,,,,0.00,0.00,0,0,0,0,0,0,0,0,0,0,0,0,0
20200312,04003P,麗豐凱基94售03,1.49,1.69,1.46,1.59,+0.37,30.33,105000,14,166210,0,0,0,0,0,0,17000,88000,-71000,-71000
20200312,04004P,智伸科凱基93售06,,,,,0.00,0.00,0,0,0,0,0,0,0,0,0,0,0,0,0
20200312,04005P,樺漢凱基93售02,,,,,0.00,0.00,0,0,0,0,0,0,0,0,0,0,0,0,0
20200312,04006P,滬深2X國票9B售01,1.13,1.13,1.13,1.13,+0.16,16.49,10000,1,11300,0,0,0,0,0,0,10000,0,10000,10000
20200312,04007P,國巨國票93售03,,,,,0.00,0.00,0,0,0,0,0,0,0,0,0,0,0,0,0
20200312,04008P,京元電國票93售01,,,,,0.00,0.00,0,0,0,0,0,0,0,0,0,0,0,0,0
20200312,04009P,可成國票93售03,,,,,0.00,0.00,0,0,0,0,0,0,0,0,0,0,0,0,0
20200312,04010P,上銀元大93售07,,,,,0.00,0.00,0,0,0,0,0,0,0,0,0,0,0,0,0
20200312,04011P,台積電元大93售22,,,,,0.00,0.00,0,0,0,0,0,0,0,0,0,0,0,0,0
20200312,04012P,台積電元大93售23,,,,,0.00,0.00,0,0,0,0,0,0,0,0,0,0,0,0,0
20200312,04013P,漢唐元大93售05,,,,,0.00,0.00,0,0,0,0,0,0,0,0,0,0,0,0,0
20200312,04014P,聯發科元大93售18,,,,,0.00,0.00,0,0,0,0,0,0,0,0,0,0,0,0,0
20200312,04015P,可成元大93售10,,,,,0.00,0.00,0,0,0,0,0,0,0,0,0,0,0,0,0
20200312,040160,SP黃豆元富95購01,0.07,0.08,0.07,0.08,-0.05,-38.46,70000,2,5100,0,0,0,0,0,0,50000,20000,30000,30000
20200312,04016P,台積電兆豐93售06,,,,,0.00,0.00,0,0,0,0,0,0,0,0,0,0,0,0,0
20200312,04017P,臺股指麥證93售02,,,,,0.00,0.00,0,0,0,0,0,0,0,0,0,0,0,0,0
20200312,04018P,亞光永豐93售01,0.37,0.46,0.37,0.46,0.00,0.00,20000,3,7840,0,0,0,0,0,0,20000,0,20000,20000
20200312,04019P,聯茂永豐93售01,,,,,0.00,0.00,0,0,0,0,0,0,0,0,0,0,0,0,0
20200312,04020P,南茂永豐93售02,,,,,0.00,0.00,0,0,0,0,0,0,0,0,0,0,0,0,0
20200312,040215,上証反凱基95購01,0.13,0.13,0.10,0.10,0.00,0.00,307000,6,39610,0,0,0,0,0,0,9000,197000,-188000,-188000
20200312,04021P,寶滬深元富93售01,0.07,0.08,0.07,0.08,+0.04,100.0,2000,2,150,0,0,0,0,0,0,2000,0,2000,2000
20200312,04022P,群創元富96售04,0.82,0.95,0.81,0.95,+0.27,39.71,242000,10,208650,0,0,0,0,0,0,59000,183000,-124000,-124000
20200312,04023P,臺股指元富99售02,0.55,0.94,0.55,0.92,+0.42,84.0,2848000,153,1979410,0,0,0,0,0,0,1608000,732000,876000,876000
20200312,04024P,志超康和93售01,,,,,0.00,0.00,0,0,0,0,0,0,0,0,0,0,0,0,0
20200312,04025P,宏達電國泰94售01,0.61,0.84,0.61,0.84,+0.24,40.0,175000,5,139820,0,0,0,0,0,0,175000,0,175000,175000
20200312,04026P,燿華國票93售01,,,,,0.00,0.00,0,0,0,0,0,0,0,0,0,0,0,0,0
20200312,04027P,亞德客凱基93售05,,,,,0.00,0.00,0,0,0,0,0,0,0,0,0,0,0,0,0
20200312,04028P,燿華凱基94售02,1.29,1.75,1.29,1.75,+0.60,52.17,73000,6,117970,0,0,0,0,0,0,53000,60000,-7000,-7000
20200312,04029P,聯發科凱基93售16,,,,,0.00,0.00,0,0,0,0,0,0,0,0,0,0,0,0,0
20200312,04030P,聯發科凱基93售19,,,,,0.00,0.00,0,0,0,0,0,0,0,0,0,0,0,0,0
20200312,04031P,聯發科凱基93售20,,,,,0.00,0.00,0,0,0,0,0,0,0,0,0,0,0,0,0
20200312,04032P,聯茂凱基94售02,0.68,0.97,0.68,0.97,+0.40,70.18,138000,5,100940,0,0,0,0,0,0,10000,128000,-118000,-118000
20200312,04033P,啟碁凱基93售04,,,,,0.00,0.00,0,0,0,0,0,0,0,0,0,0,0,0,0
20200312,04034P,技嘉群益93售03,,,,,0.00,0.00,0,0,0,0,0,0,0,0,0,0,0,0,0
20200312,04035P,全新群益93售03,,,,,0.00,0.00,0,0,0,0,0,0,0,0,0,0,0,0,0
20200312,04036P,臻鼎群益93售03,0.62,0.62,0.62,0.62,0.00,0.00,20000,1,12400,0,0,0,0,0,0,20000,0,20000,20000
20200312,04037P,中磊群益93售02,,,,,0.00,0.00,0,0,0,0,0,0,0,0,0,0,0,0,0
20200312,040380,SP黃豆元富95購02,,,,,0.00,0.00,0,0,0,0,0,0,0,0,0,0,0,0,0
20200312,040381,元金2X元富95購01,,,,,0.00,0.00,0,0,0,0,0,0,0,0,0,0,0,0,0
20200312,04038P,聯茂群益93售03,,,,,0.00,0.00,0,0,0,0,0,0,0,0,0,0,0,0,0
20200312,04039P,台積電統一93售04,,,,,0.00,0.00,0,0,0,0,0,0,0,0,0,0,0,0,0
20200312,04040P,大立光統一93售09,,,,,0.00,0.00,0,0,0,0,0,0,0,0,0,0,0,0,0
20200312,04041P,大立光統一94售03,0.53,0.62,0.53,0.62,+0.35,129.63,855000,7,473580,0,0,0,0,0,0,589000,266000,323000,323000
20200312,04042P,臺股指統一93售07,,,,,0.00,0.00,0,0,0,0,0,0,0,0,0,0,0,0,0
20200312,04043P,復盛元富93售02,,,,,0.00,0.00,0,0,0,0,0,0,0,0,0,0,0,0,0
20200312,04044P,鴻海元大93售18,,,,,0.00,0.00,0,0,0,0,0,0,0,0,0,0,0,0,0
20200312,04045P,鴻海元大93售19,0.01,0.01,0.01,0.01,0.00,0.00,10000,10,100,0,0,0,0,0,0,0,0,0,0
20200312,04046P,台積電元大93售24,,,,,0.00,0.00,0,0,0,0,0,0,0,0,0,0,0,0,0
20200312,04047P,華邦電元大94售03,2.41,3.09,2.41,3.09,+0.99,47.14,13000,3,32210,0,0,0,0,0,0,13000,0,13000,13000
20200312,04048P,大立光元大93售26,,,,,0.00,0.00,0,0,0,0,0,0,0,0,0,0,0,0,0
20200312,04049P,大立光元大95售02,0.65,0.86,0.65,0.86,+0.31,56.36,1869000,50,1461700,0,0,0,0,0,0,1529000,276000,1253000,1253000
20200312,04050P,創意元大93售05,,,,,0.00,0.00,0,0,0,0,0,0,0,0,0,0,0,0,0
20200312,04051P,友達中信94售02,0.85,0.85,0.26,0.40,+0.22,122.22,1312000,13,373100,0,0,0,0,0,0,1303000,8000,1295000,1295000
20200312,04052P,上銀國泰94售01,0.54,0.71,0.54,0.70,0.00,0.00,195000,11,129450,0,0,0,0,0,0,195000,150000,45000,45000
20200312,04053P,聯茂國泰94售01,,,,,0.00,0.00,0,0,0,0,0,0,0,0,0,0,0,0,0
20200312,04054P,滬深2X富邦96售02,,,,,0.00,0.00,0,0,0,0,0,0,0,0,0,0,0,0,0
20200312,04055P,奇力新群益93售04,,,,,0.00,0.00,0,0,0,0,0,0,0,0,0,0,0,0,0
20200312,04056P,臺股指群益93售10,,,,,0.00,0.00,0,0,0,0,0,0,0,0,0,0,0,0,0
20200312,040578,SP黃豆元富95購03,,,,,0.00,0.00,0,0,0,0,0,0,0,0,0,0,0,0,0
20200312,04057P,臺股指群益93售11,,,,,0.00,0.00,0,0,0,0,0,0,0,0,0,0,0,0,0
20200312,04058P,臺股指群益93售12,1.03,1.10,1.03,1.10,+0.61,124.49,14000,3,15140,0,0,0,0,0,0,14000,0,14000,14000
20200312,04059P,臺股指群益93售13,,,,,0.00,0.00,0,0,0,0,0,0,0,0,0,0,0,0,0
20200312,04060P,臺股指群益93售14,,,,,0.00,0.00,0,0,0,0,0,0,0,0,0,0,0,0,0
20200312,04061P,臺股指群益93售15,,,,,0.00,0.00,0,0,0,0,0,0,0,0,0,0,0,0,0
20200312,04062P,可成兆豐93售04,0.50,0.60,0.50,0.59,0.00,0.00,30000,3,16900,0,0,0,0,0,0,30000,20000,10000,10000
20200312,04063P,臺股指兆豐93售02,0.90,0.90,0.90,0.90,0.00,0.00,10000,1,9000,0,0,0,0,0,0,10000,10000,0,0
20200312,04064P,臺股指兆豐93售03,0.44,0.44,0.44,0.44,0.00,0.00,10000,1,4400,0,0,0,0,0,0,0,10000,-10000,-10000
20200312,04065P,台積電凱基93售20,,,,,0.00,0.00,0,0,0,0,0,0,0,0,0,0,0,0,0
20200312,04066P,京元電凱基93售02,,,,,0.00,0.00,0,0,0,0,0,0,0,0,0,0,0,0,0
20200312,04067P,聯發科凱基93售24,,,,,0.00,0.00,0,0,0,0,0,0,0,0,0,0,0,0,0
20200312,04068P,大立光凱基93售27,,,,,0.00,0.00,0,0,0,0,0,0,0,0,0,0,0,0,0
20200312,04069P,聯詠凱基93售05,,,,,0.00,0.00,0,0,0,0,0,0,0,0,0,0,0,0,0
20200312,04070P,臺股指凱基93售06,0.10,0.21,0.10,0.18,0.00,0.00,150000,15,25300,0,0,0,0,0,0,120000,140000,-20000,-20000
20200312,04071P,臺股指凱基93售07,0.27,0.69,0.27,0.47,0.00,0.00,138000,14,76060,0,0,0,0,0,0,138000,138000,0,0
20200312,04072P,臺股指凱基93售08,0.25,1.06,0.25,0.73,0.00,0.00,148000,16,111210,0,0,0,0,0,0,8000,147000,-139000,-139000
20200312,04073P,臺股指凱基93售09,1.41,1.41,1.41,1.41,0.00,0.00,10000,1,14100,0,0,0,0,0,0,10000,10000,0,0
20200312,040744,滬深2X國票94購01,,,,,0.00,0.00,0,0,0,0,0,0,0,0,0,0,0,0,0
20200312,04074P,臺股指凱基93售10,,,,,0.00,0.00,0,0,0,0,0,0,0,0,0,0,0,0,0
20200312,04075P,臺股指凱基93售11,,,,,0.00,0.00,0,0,0,0,0,0,0,0,0,0,0,0,0
20200312,040760,T50反1凱基95購01,1.19,1.56,1.19,1.56,+0.53,51.46,801000,15,1133320,0,0,0,0,0,0,801000,0,801000,801000
20200312,040761,T50反1凱基95購02,0.04,0.15,0.04,0.15,0.00,0.00,1718000,60,228400,0,0,0,0,0,0,1497000,498000,999000,999000
20200312,04076P,臺股指凱基93售12,1.12,2.98,1.12,2.98,+2.00,204.08,130000,8,299520,0,0,0,0,0,0,130000,0,130000,130000
20200312,04077P,臺股指凱基93售13,,,,,0.00,0.00,0,0,0,0,0,0,0,0,0,0,0,0,0
20200312,04078P,臺股指凱基93售14,0.44,1.06,0.44,0.75,0.00,0.00,137000,14,112880,0,0,0,0,0,0,7000,137000,-130000,-130000
20200312,04079P,燿華元大93售04,,,,,0.00,0.00,0,0,0,0,0,0,0,0,0,0,0,0,0
20200312,04080P,可成元大93售11,0.03,0.04,0.03,0.04,0.00,0.00,150000,6,5000,0,0,0,0,0,0,100000,50000,50000,50000
20200312,04081P,聯詠元大93售11,,,,,0.00,0.00,0,0,0,0,0,0,0,0,0,0,0,0,0
20200312,04082P,智邦統一93售03,,,,,0.00,0.00,0,0,0,0,0,0,0,0,0,0,0,0,0
20200312,04083P,欣興統一94售01,1.10,1.49,1.10,1.49,0.00,0.00,60000,8,83660,0,0,0,0,0,0,13000,47000,-34000,-34000
20200312,04084P,台表科統一93售01,,,,,0.00,0.00,0,0,0,0,0,0,0,0,0,0,0,0,0
20200312,04085P,欣興元富93售01,,,,,0.00,0.00,0,0,0,0,0,0,0,0,0,0,0,0,0
20200312,04086P,臺股指元富93售04,1.08,1.35,1.08,1.35,+0.73,117.74,30000,4,36050,0,0,0,0,0,0,30000,0,30000,30000
20200312,04087P,臺股指元富93售05,,,,,0.00,0.00,0,0,0,0,0,0,0,0,0,0,0,0,0
20200312,04088P,臺股指元富93售06,,,,,0.00,0.00,0,0,0,0,0,0,0,0,0,0,0,0,0
20200312,04089P,臺股指元富93售07,,,,,0.00,0.00,0,0,0,0,0,0,0,0,0,0,0,0,0
20200312,04090P,臺股指元富93售08,,,,,0.00,0.00,0,0,0,0,0,0,0,0,0,0,0,0,0
20200312,04091P,臺股指元富93售09,,,,,0.00,0.00,0,0,0,0,0,0,0,0,0,0,0,0,0
20200312,04092P,臺股指元富93售10,,,,,0.00,0.00,0,0,0,0,0,0,0,0,0,0,0,0,0
20200312,04093P,上銀國票94售02,,,,,0.00,0.00,0,0,0,0,0,0,0,0,0,0,0,0,0
20200312,04094P,臺股指國票93售01,,,,,0.00,0.00,0,0,0,0,0,0,0,0,0,0,0,0,0
20200312,04095P,臺股指國票93售02,,,,,0.00,0.00,0,0,0,0,0,0,0,0,0,0,0,0,0
20200312,04096P,臺股指國票93售03,,,,,0.00,0.00,0,0,0,0,0,0,0,0,0,0,0,0,0
20200312,04097P,臺股指國票93售04,,,,,0.00,0.00,0,0,0,0,0,0,0,0,0,0,0,0,0
20200312,04098P,臺股指國票93售05,,,,,0.00,0.00,0,0,0,0,0,0,0,0,0,0,0,0,0
20200312,04099P,臺股指國票93售06,,,,,0.00,0.00,0,0,0,0,0,0,0,0,0,0,0,0,0
20200312,04100P,臺股指國票93售07,,,,,0.00,0.00,0,0,0,0,0,0,0,0,0,0,0,0,0
20200312,04101P,臺股指國票93售08,3.85,3.85,3.85,3.85,0.00,0.00,5000,1,19250,0,0,0,0,0,0,5000,0,5000,5000
20200312,04102P,臺股指國票93售09,,,,,0.00,0.00,0,0,0,0,0,0,0,0,0,0,0,0,0
20200312,04103P,臺股指國票93售10,,,,,0.00,0.00,0,0,0,0,0,0,0,0,0,0,0,0,0
20200312,04104P,臺股指國票93售11,3.50,5.00,3.50,5.00,0.00,0.00,15000,5,61770,0,0,0,0,0,0,15000,0,15000,15000
20200312,04105P,東陽康和93售03,,,,,0.00,0.00,0,0,0,0,0,0,0,0,0,0,0,0,0
20200312,04106P,滬深2X永豐93售02,,,,,0.00,0.00,0,0,0,0,0,0,0,0,0,0,0,0,0
20200312,04107P,元黃金中信94售01,0.05,0.05,0.05,0.05,+0.01,25.0,20000,2,1000,0,0,0,0,0,0,0,20000,-20000,-20000
20200312,04108P,臺股指永昌93售03,0.20,0.50,0.20,0.50,0.00,0.00,443000,4,161500,0,0,0,0,0,0,244000,0,244000,244000
20200312,04109P,臺股指永昌93售04,,,,,0.00,0.00,0,0,0,0,0,0,0,0,0,0,0,0,0
20200312,04110P,臺股指富邦93售03,,,,,0.00,0.00,0,0,0,0,0,0,0,0,0,0,0,0,0
20200312,04111P,臺股指富邦93售04,0.26,0.31,0.26,0.31,0.00,0.00,3000,2,830,0,0,0,0,0,0,3000,0,3000,3000
20200312,04112P,臺股指富邦93售05,,,,,0.00,0.00,0,0,0,0,0,0,0,0,0,0,0,0,0
20200312,04113P,臺股指富邦93售06,,,,,0.00,0.00,0,0,0,0,0,0,0,0,0,0,0,0,0
20200312,04114P,電子類富邦93售02,,,,,0.00,0.00,0,0,0,0,0,0,0,0,0,0,0,0,0
20200312,04115P,欣興群益93售06,,,,,0.00,0.00,0,0,0,0,0,0,0,0,0,0,0,0,0
20200312,04116P,京元電元大94售02,0.56,0.58,0.56,0.58,+0.14,31.82,47000,2,27120,0,0,0,0,0,0,0,47000,-47000,-47000
20200312,04117P,聯發科元大93售21,,,,,0.00,0.00,0,0,0,0,0,0,0,0,0,0,0,0,0
20200312,04118P,上銀凱基93售06,,,,,0.00,0.00,0,0,0,0,0,0,0,0,0,0,0,0,0
20200312,04119P,旺宏凱基93售06,,,,,0.00,0.00,0,0,0,0,0,0,0,0,0,0,0,0,0
20200312,04120P,智邦凱基93售09,,,,,0.00,0.00,0,0,0,0,0,0,0,0,0,0,0,0,0
20200312,041210,群創元富93購01,,,,,0.00,0.00,0,0,0,0,0,0,0,0,0,0,0,0,0
20200312,04121P,宏碁凱基93售02,0.71,1.16,0.71,1.16,0.00,0.00,53000,6,49790,0,0,0,0,0,0,0,53000,-53000,-53000
20200312,04122P,瑞昱凱基93售09,0.07,0.07,0.07,0.07,0.00,0.00,10000,1,700,0,0,0,0,0,0,10000,0,10000,10000
20200312,04123P,可成凱基93售11,,,,,0.00,0.00,0,0,0,0,0,0,0,0,0,0,0,0,0
20200312,04124P,可成凱基93售12,,,,,0.00,0.00,0,0,0,0,0,0,0,0,0,0,0,0,0
20200312,04125P,健策凱基93售05,,,,,0.00,0.00,0,0,0,0,0,0,0,0,0,0,0,0,0
20200312,04126P,滬深2X國票95售02,,,,,0.00,0.00,0,0,0,0,0,0,0,0,0,0,0,0,0
20200312,04127P,聯茂國票93售02,,,,,0.00,0.00,0,0,0,0,0,0,0,0,0,0,0,0,0
20200312,04128P,台積電統一93售05,,,,,0.00,0.00,0,0,0,0,0,0,0,0,0,0,0,0,0
20200312,04129P,亞德客永豐93售04,,,,,0.00,0.00,0,0,0,0,0,0,0,0,0,0,0,0,0
20200312,04130P,台積電永豐93售03,,,,,0.00,0.00,0,0,0,0,0,0,0,0,0,0,0,0,0
20200312,04131P,裕隆群益93售01,0.17,0.17,0.17,0.17,0.00,0.00,50000,1,8500,0,0,0,0,0,0,50000,0,50000,50000
20200312,04132P,瑞昱群益93售04,0.58,0.58,0.58,0.58,0.00,0.00,10000,1,5800,0,0,0,0,0,0,10000,0,10000,10000
20200312,04133P,友達群益93售01,,,,,0.00,0.00,0,0,0,0,0,0,0,0,0,0,0,0,0
20200312,04134P,華新科群益93售02,,,,,0.00,0.00,0,0,0,0,0,0,0,0,0,0,0,0,0
20200312,04135P,亞德客元大93售04,,,,,0.00,0.00,0,0,0,0,0,0,0,0,0,0,0,0,0
20200312,04136P,智邦元大93售09,,,,,0.00,0.00,0,0,0,0,0,0,0,0,0,0,0,0,0
20200312,04137P,元油反國票97售01,,,,,0.00,0.00,0,0,0,0,0,0,0,0,0,0,0,0,0
20200312,04138P,智邦國票93售02,,,,,0.00,0.00,0,0,0,0,0,0,0,0,0,0,0,0,0
20200312,04139P,大立光國票93售03,,,,,0.00,0.00,0,0,0,0,0,0,0,0,0,0,0,0,0
20200312,04140P,聯茂國票93售03,,,,,0.00,0.00,0,0,0,0,0,0,0,0,0,0,0,0,0
20200312,04141P,啟碁國票93售01,1.32,1.62,1.32,1.62,0.00,0.00,58000,2,84360,0,0,0,0,0,0,0,58000,-58000,-58000
20200312,041427,滬深2X國票93購01,0.01,0.01,0.01,0.01,0.00,0.00,1200000,7,12000,0,0,0,0,0,0,1100000,0,1100000,1100000
20200312,04142P,元油反凱基99售01,0.13,0.16,0.12,0.16,+0.03,23.08,184000,21,26660,0,0,0,0,0,0,0,172000,-172000,-172000
20200312,04143P,鴻海凱基93售31,,,,,0.00,0.00,0,0,0,0,0,0,0,0,0,0,0,0,0
20200312,04144P,瑞昱凱基93售10,,,,,0.00,0.00,0,0,0,0,0,0,0,0,0,0,0,0,0
20200312,041453,國巨元富93購03,,,,,0.00,0.00,0,0,0,0,0,0,0,0,0,0,0,0,0
20200312,041454,國巨元富93購04,,,,,0.00,0.00,0,0,0,0,0,0,0,0,0,0,0,0,0
20200312,041455,國巨元富93購05,,,,,0.00,0.00,0,0,0,0,0,0,0,0,0,0,0,0,0
20200312,04145P,聯發科凱基93售28,,,,,0.00,0.00,0,0,0,0,0,0,0,0,0,0,0,0,0
20200312,04146P,可成凱基93售14,1.50,1.80,1.50,1.80,+1.09,153.52,40000,4,66200,0,0,0,0,0,0,0,40000,-40000,-40000
20200312,04147P,大立光凱基93售30,,,,,0.00,0.00,0,0,0,0,0,0,0,0,0,0,0,0,0
20200312,04148P,GIS凱基93售05,1.38,1.70,1.38,1.70,+0.48,39.34,20000,2,30800,0,0,0,0,0,0,10000,10000,0,0
20200312,04149P,景碩台新93售02,,,,,0.00,0.00,0,0,0,0,0,0,0,0,0,0,0,0,0
20200312,04150P,燿華康和93售01,1.15,1.52,1.15,1.52,+0.68,80.95,200000,2,267000,0,0,0,0,0,0,200000,0,200000,200000
20200312,04151P,日電貿康和93售01,,,,,0.00,0.00,0,0,0,0,0,0,0,0,0,0,0,0,0
20200312,041527,T50反1中信96購01,1.31,1.71,1.31,1.65,+0.43,35.25,433000,30,637890,0,0,0,0,0,0,309000,104000,205000,205000
20200312,041528,國泰金中信93購01,,,,,0.00,0.00,0,0,0,0,0,0,0,0,0,0,0,0,0
20200312,04152P,喬山永豐93售02,1.18,1.18,1.18,1.18,0.00,0.00,10000,1,11800,0,0,0,0,0,0,0,10000,-10000,-10000
20200312,041534,T50反1凱基96購01,0.35,0.46,0.26,0.42,0.00,0.00,207000,16,83410,0,0,0,0,0,0,131000,15000,116000,116000
20200312,04153P,旺宏永豐93售03,,,,,0.00,0.00,0,0,0,0,0,0,0,0,0,0,0,0,0
20200312,04154P,南亞科永豐93售02,,,,,0.00,0.00,0,0,0,0,0,0,0,0,0,0,0,0,0
20200312,04155P,全新永豐93售01,,,,,0.00,0.00,0,0,0,0,0,0,0,0,0,0,0,0,0
20200312,04156P,大立光永豐93售02,,,,,0.00,0.00,0,0,0,0,0,0,0,0,0,0,0,0,0
20200312,04157P,鎧勝永豐93售02,1.14,1.48,1.14,1.48,0.00,0.00,40000,4,51600,0,0,0,0,0,0,0,40000,-40000,-40000
20200312,04158P,南電永豐93售04,,,,,0.00,0.00,0,0,0,0,0,0,0,0,0,0,0,0,0
20200312,041596,S&P反1中信94購01,0.02,0.02,0.01,0.01,0.00,0.00,747000,53,12460,0,0,0,0,0,0,248000,499000,-251000,-251000
20200312,04159P,滬深2X中信95售08,0.66,0.72,0.66,0.69,+0.12,21.05,150000,6,102600,0,0,0,0,0,0,120000,30000,90000,90000
20200312,04160P,儒鴻中信93售01,0.75,1.17,0.75,1.17,+0.71,154.35,60000,2,57600,0,0,0,0,0,0,30000,30000,0,0
20200312,04161P,全新國泰94售01,1.45,1.45,1.45,1.45,+0.24,19.83,15000,1,21750,0,0,0,0,0,0,15000,0,15000,15000
20200312,04162P,南亞科統一94售02,,,,,0.00,0.00,0,0,0,0,0,0,0,0,0,0,0,0,0
20200312,04163P,可成統一93售03,0.52,0.72,0.52,0.72,+0.39,118.18,283000,3,182160,0,0,0,0,0,0,108000,175000,-67000,-67000
20200312,04164P,滬深2X元富93售03,1.01,1.01,1.01,1.01,+0.46,83.64,1000,1,1010,0,0,0,0,0,0,1000,0,1000,1000
20200312,04165P,南亞科元富95售03,1.77,2.27,1.77,2.25,+0.72,47.06,81000,9,158270,0,0,0,0,0,0,41000,40000,1000,1000
20200312,04166P,美利達元富93售03,,,,,0.00,0.00,0,0,0,0,0,0,0,0,0,0,0,0,0
20200312,04167P,滬深反凱基99售01,0.66,0.66,0.65,0.65,0.00,0.00,270000,3,175700,0,0,0,0,0,0,0,270000,-270000,-270000
20200312,04168P,元金2X凱基99售01,0.25,0.27,0.25,0.27,+0.04,17.39,36000,4,9400,0,0,0,0,0,0,36000,0,36000,36000
20200312,04169P,鴻海凱基93售34,0.10,0.10,0.10,0.10,0.00,0.00,30000,3,3000,0,0,0,0,0,0,0,30000,-30000,-30000
20200312,04170P,台積電凱基93售24,,,,,0.00,0.00,0,0,0,0,0,0,0,0,0,0,0,0,0
20200312,04171P,旺宏凱基93售07,0.15,0.15,0.15,0.15,0.00,0.00,40000,4,6000,0,0,0,0,0,0,0,40000,-40000,-40000
20200312,04172P,大立光凱基93售34,,,,,0.00,0.00,0,0,0,0,0,0,0,0,0,0,0,0,0
20200312,04173P,上海銀凱基93售02,,,,,0.00,0.00,0,0,0,0,0,0,0,0,0,0,0,0,0
20200312,04174P,上銀群益93售06,,,,,0.00,0.00,0,0,0,0,0,0,0,0,0,0,0,0,0
20200312,04175P,台積電群益94售05,,,,,0.00,0.00,0,0,0,0,0,0,0,0,0,0,0,0,0
20200312,04176P,台達電元大94售01,1.80,1.90,1.80,1.80,+0.27,17.65,158000,7,284700,0,0,0,0,0,0,4000,154000,-150000,-150000
20200312,04177P,富邦金元大94售01,1.81,2.16,1.81,2.07,+0.52,33.55,27000,5,54730,0,0,0,0,0,0,6000,21000,-15000,-15000
20200312,04178P,聯茂元大93售07,,,,,0.00,0.00,0,0,0,0,0,0,0,0,0,0,0,0,0
20200312,04179P,滬深2X國票93售03,,,,,0.00,0.00,0,0,0,0,0,0,0,0,0,0,0,0,0
20200312,04180P,華新科國票93售01,,,,,0.00,0.00,0,0,0,0,0,0,0,0,0,0,0,0,0
20200312,04181P,嘉晶國票93售04,,,,,0.00,0.00,0,0,0,0,0,0,0,0,0,0,0,0,0
20200312,041824,元油2X國票96購01,,,,,0.00,0.00,0,0,0,0,0,0,0,0,0,0,0,0,0
20200312,04182P,祥碩國票93售01,,,,,0.00,0.00,0,0,0,0,0,0,0,0,0,0,0,0,0
20200312,041832,T50反1統一94購01,0.01,0.05,0.01,0.05,+0.04,400.0,722000,14,14270,0,0,0,0,0,0,0,0,0,0
20200312,04183P,大成鋼統一93售03,,,,,0.00,0.00,0,0,0,0,0,0,0,0,0,0,0,0,0
20200312,04184P,台積電統一93售06,,,,,0.00,0.00,0,0,0,0,0,0,0,0,0,0,0,0,0
20200312,04185P,欣興統一93售05,,,,,0.00,0.00,0,0,0,0,0,0,0,0,0,0,0,0,0
20200312,04186P,創意元富93售04,,,,,0.00,0.00,0,0,0,0,0,0,0,0,0,0,0,0,0
20200312,041870,A50正2凱基96購01,0.45,0.48,0.45,0.45,-0.21,-31.82,60000,3,27600,0,0,0,0,0,0,0,60000,-60000,-60000
20200312,04187P,麗豐元富93售02,,,,,0.00,0.00,0,0,0,0,0,0,0,0,0,0,0,0,0
20200312,04188P,康控元富93售03,1.89,1.94,1.89,1.94,0.00,0.00,30000,3,57200,0,0,0,0,0,0,0,30000,-30000,-30000
20200312,04189P,台積電兆豐94售02,0.09,0.16,0.09,0.12,0.00,0.00,60000,4,6900,0,0,0,0,0,0,50000,10000,40000,40000
20200312,041900,元油2X富邦96購01,0.07,0.08,0.05,0.05,-0.03,-37.5,846000,30,54680,0,0,0,0,0,0,0,0,0,0
20200312,04190P,大立光兆豐94售03,0.42,0.42,0.42,0.42,0.00,0.00,10000,1,4200,0,0,0,0,0,0,10000,0,10000,10000
20200312,04191P,儒鴻永豐93售02,,,,,0.00,0.00,0,0,0,0,0,0,0,0,0,0,0,0,0
20200312,04192P,漢唐永豐93售03,,,,,0.00,0.00,0,0,0,0,0,0,0,0,0,0,0,0,0
20200312,04193P,智原永豐93售01,1.17,1.45,1.17,1.45,+0.61,72.62,30000,3,39100,0,0,0,0,0,0,10000,20000,-10000,-10000
20200312,04194P,欣興永豐93售05,,,,,0.00,0.00,0,0,0,0,0,0,0,0,0,0,0,0,0
20200312,04195P,上海銀永豐93售01,,,,,0.00,0.00,0,0,0,0,0,0,0,0,0,0,0,0,0
20200312,04196P,東陽中信93售02,,,,,0.00,0.00,0,0,0,0,0,0,0,0,0,0,0,0,0
20200312,041973,台灣50中信94購01,0.02,0.08,0.02,0.08,-0.02,-20.0,636000,25,20140,0,0,0,0,0,0,0,0,0,0
20200312,04197P,台積電亞東94售01,0.05,0.05,0.05,0.05,0.00,0.00,110000,1,5500,0,0,0,0,0,0,110000,0,110000,110000
20200312,04198P,滬深2X群益95售04,0.91,0.91,0.78,0.83,+0.17,25.76,43000,4,36040,0,0,0,0,0,0,33000,10000,23000,23000
20200312,041990,A50正2國票97購01,0.29,0.29,0.29,0.29,0.00,0.00,400000,1,116000,0,0,0,0,0,0,0,400000,-400000,-400000
20200312,041991,元油2X國票98購01,0.04,0.06,0.04,0.06,+0.01,20.0,150000,17,6500,0,0,0,0,0,0,0,0,0,0
20200312,04199P,國巨群益93售05,,,,,0.00,0.00,0,0,0,0,0,0,0,0,0,0,0,0,0
20200312,04200P,奇力新群益93售07,,,,,0.00,0.00,0,0,0,0,0,0,0,0,0,0,0,0,0
20200312,04201P,智原群益93售01,,,,,0.00,0.00,0,0,0,0,0,0,0,0,0,0,0,0,0
20200312,04202P,華新科元大93售10,,,,,0.00,0.00,0,0,0,0,0,0,0,0,0,0,0,0,0
20200312,04203P,超眾元大93售04,0.61,0.90,0.61,0.90,0.00,0.00,220000,3,192900,0,0,0,0,0,0,200000,20000,180000,180000
20200312,04204P,臺股指元大93售44,,,,,0.00,0.00,0,0,0,0,0,0,0,0,0,0,0,0,0
20200312,04205P,臺股指元大93售45,0.45,0.45,0.45,0.45,0.00,0.00,2000,1,900,0,0,0,0,0,0,2000,0,2000,2000
20200312,04206P,臺股指元大93售46,1.20,1.26,1.20,1.26,+1.06,530.0,55000,2,66300,0,0,0,0,0,0,55000,0,55000,55000
20200312,04207P,臺股指元大93售47,1.77,2.89,1.77,2.80,0.00,0.00,1010000,5,2047000,0,0,0,0,0,0,1010000,0,1010000,1010000
20200312,042088,台灣50中信93購04,1.58,1.58,1.28,1.28,-1.78,-58.17,20000,2,28600,0,0,0,0,0,0,10000,10000,0,0
20200312,042089,台灣50中信94購03,,,,,0.00,0.00,0,0,0,0,0,0,0,0,0,0,0,0,0
20200312,04208P,臺股指元大93售48,0.96,2.27,0.96,2.27,0.00,0.00,470000,5,984400,0,0,0,0,0,0,470000,0,470000,470000
20200312,042093,台灣50群益94購02,0.18,0.18,0.17,0.17,-0.01,-5.56,17000,3,3040,0,0,0,0,0,0,0,0,0,0
20200312,04209P,臺股指日盛93售01,,,,,0.00,0.00,0,0,0,0,0,0,0,0,0,0,0,0,0
20200312,04210P,鴻海凱基93售36,0.10,0.14,0.10,0.14,0.00,0.00,20000,2,2400,0,0,0,0,0,0,10000,20000,-10000,-10000
20200312,042116,元油2X國票97購01,0.05,0.05,0.05,0.05,0.00,0.00,1000,1,50,0,0,0,0,0,0,0,0,0,0
20200312,04211P,台積電凱基93售25,,,,,0.00,0.00,0,0,0,0,0,0,0,0,0,0,0,0,0
20200312,04212P,微星凱基93售03,,,,,0.00,0.00,0,0,0,0,0,0,0,0,0,0,0,0,0
20200312,042131,國巨富邦93購01,,,,,0.00,0.00,0,0,0,0,0,0,0,0,0,0,0,0,0
20200312,042135,台灣50元大93購05,,,,,0.00,0.00,0,0,0,0,0,0,0,0,0,0,0,0,0
20200312,042136,台灣50元大93購08,,,,,0.00,0.00,0,0,0,0,0,0,0,0,0,0,0,0,0
20200312,042137,元油2X元大93購01,,,,,0.00,0.00,0,0,0,0,0,0,0,0,0,0,0,0,0
20200312,04213P,台光電凱基93售11,1.08,1.22,1.08,1.22,0.00,0.00,40000,4,45700,0,0,0,0,0,0,0,40000,-40000,-40000
20200312,04214P,美利達凱基93售04,,,,,0.00,0.00,0,0,0,0,0,0,0,0,0,0,0,0,0
20200312,04215P,鴻海國票93售02,0.01,0.02,0.01,0.02,+0.01,100.0,120000,2,1400,0,0,0,0,0,0,100000,0,100000,100000
20200312,042168,台灣50凱基96購01,2.30,2.30,1.30,1.45,-1.39,-48.94,455000,53,725410,0,0,0,0,0,0,43000,425000,-382000,-382000
20200312,04216P,燿華國票93售02,,,,,0.00,0.00,0,0,0,0,0,0,0,0,0,0,0,0,0
20200312,042173,台灣50永豐93購01,,,,,0.00,0.00,0,0,0,0,0,0,0,0,0,0,0,0,0
20200312,04217P,漢唐國票93售01,,,,,0.00,0.00,0,0,0,0,0,0,0,0,0,0,0,0,0
20200312,04218P,正文國票93售03,,,,,0.00,0.00,0,0,0,0,0,0,0,0,0,0,0,0,0
20200312,042191,元油2X富邦93購01,,,,,0.00,0.00,0,0,0,0,0,0,0,0,0,0,0,0,0
20200312,042194,揚明光富邦93購01,0.01,0.01,0.01,0.01,0.00,0.00,1000,1,10,0,0,0,0,0,0,1000,0,1000,1000
20200312,042195,元石油元大93購01,,,,,0.00,0.00,0,0,0,0,0,0,0,0,0,0,0,0,0
20200312,042196,元油2X元大93購02,,,,,0.00,0.00,0,0,0,0,0,0,0,0,0,0,0,0,0
20200312,04219P,鴻海兆豐93售02,0.04,0.11,0.04,0.11,0.00,0.00,210000,4,9600,0,0,0,0,0,0,160000,0,160000,160000
20200312,04220P,聯發科兆豐93售04,,,,,0.00,0.00,0,0,0,0,0,0,0,0,0,0,0,0,0
20200312,04221P,大立光兆豐93售05,0.30,0.30,0.30,0.30,0.00,0.00,10000,1,3000,0,0,0,0,0,0,10000,0,10000,10000
20200312,042227,元油2X永豐93購01,,,,,0.00,0.00,0,0,0,0,0,0,0,0,0,0,0,0,0
20200312,04222P,台積電統一93售08,0.01,0.01,0.01,0.01,0.00,0.00,10000,1,100,0,0,0,0,0,0,10000,0,10000,10000
20200312,042237,鴻海永昌93購01,1.82,1.82,1.82,1.82,0.00,0.00,10000,1,18200,0,0,0,0,0,0,0,10000,-10000,-10000
20200312,042238,台積電永昌93購01,,,,,0.00,0.00,0,0,0,0,0,0,0,0,0,0,0,0,0
20200312,042239,大立光永昌93購01,,,,,0.00,0.00,0,0,0,0,0,0,0,0,0,0,0,0,0
20200312,04223P,友達統一93售05,,,,,0.00,0.00,0,0,0,0,0,0,0,0,0,0,0,0,0
20200312,04224P,群創統一93售05,0.58,0.60,0.58,0.60,0.00,0.00,78000,2,46000,0,0,0,0,0,0,0,78000,-78000,-78000
20200312,04225P,台積電元富94售02,0.07,0.08,0.07,0.08,0.00,0.00,11000,2,780,0,0,0,0,0,0,11000,0,11000,11000
20200312,04226P,宏達電元富93售01,0.43,0.58,0.43,0.58,+0.27,87.1,200000,4,103000,0,0,0,0,0,0,0,200000,-200000,-200000
20200312,04227P,滬深2X永豐94售04,0.38,0.38,0.38,0.38,0.00,0.00,12000,1,4560,0,0,0,0,0,0,12000,0,12000,12000
20200312,042280,元石油富邦96購01,0.02,0.03,0.01,0.02,0.00,0.00,684000,13,13180,0,0,0,0,0,0,0,0,0,0
20200312,042281,元油2X富邦96購02,0.10,0.10,0.10,0.10,0.00,0.00,1000,1,100,0,0,0,0,0,0,0,1000,-1000,-1000
20200312,042287,台灣50元大93購10,0.69,0.69,0.69,0.69,-1.97,-74.06,20000,1,13800,0,0,0,0,0,0,20000,0,20000,20000
20200312,042288,元油2X元大93購03,,,,,0.00,0.00,0,0,0,0,0,0,0,0,0,0,0,0,0
20200312,04228P,貿聯永豐93售03,1.04,1.04,1.04,1.04,+0.32,44.44,13000,1,13520,0,0,0,0,0,0,0,13000,-13000,-13000
20200312,04229P,臺股指中信95售05,0.08,0.08,0.07,0.07,0.00,0.00,121000,4,9580,0,0,0,0,0,0,111000,0,111000,111000
20200312,04230P,臺股指中信95售06,0.80,1.09,0.79,1.02,+0.35,52.24,250000,15,242840,0,0,0,0,0,0,245000,5000,240000,240000
20200312,042315,T50反1台新96購01,0.11,0.26,0.11,0.23,+0.09,64.29,4101000,132,906590,0,0,0,0,0,0,3260000,2638000,622000,622000
20200312,042317,台灣50永豐96購01,1.29,1.29,0.54,0.61,-0.68,-52.71,640000,88,414430,0,0,0,0,0,0,9000,606000,-597000,-597000
20200312,04231P,聯發科亞東93售03,,,,,0.00,0.00,0,0,0,0,0,0,0,0,0,0,0,0,0
20200312,042326,元油2X國票94購01,0.01,0.01,0.01,0.01,0.00,0.00,30000,1,300,0,0,0,0,0,0,30000,0,30000,30000
20200312,04232P,可成亞東93售02,,,,,0.00,0.00,0,0,0,0,0,0,0,0,0,0,0,0,0
20200312,04233P,儒鴻兆豐93售01,,,,,0.00,0.00,0,0,0,0,0,0,0,0,0,0,0,0,0
20200312,04234P,華通群益94售02,0.42,0.67,0.42,0.67,0.00,0.00,13000,2,5960,0,0,0,0,0,0,2000,11000,-9000,-9000
20200312,04235P,鴻海群益93售08,0.42,0.73,0.42,0.73,0.00,0.00,52000,6,26940,0,0,0,0,0,0,52000,0,52000,52000
20200312,04236P,華新科群益93售03,,,,,0.00,0.00,0,0,0,0,0,0,0,0,0,0,0,0,0
20200312,042379,T50反1群益93購03,0.01,0.01,0.01,0.01,0.00,0.00,170000,1,1700,0,0,0,0,0,0,0,0,0,0
20200312,04237P,超眾群益93售02,,,,,0.00,0.00,0,0,0,0,0,0,0,0,0,0,0,0,0
20200312,042387,台積電永昌93購02,0.34,0.34,0.20,0.20,-1.28,-86.49,202000,21,41900,0,0,0,0,0,0,12000,190000,-178000,-178000
20200312,042388,大立光永昌93購02,,,,,0.00,0.00,0,0,0,0,0,0,0,0,0,0,0,0,0
20200312,04238P,滬深2X日盛93售01,,,,,0.00,0.00,0,0,0,0,0,0,0,0,0,0,0,0,0
20200312,04239P,上銀凱基93售08,,,,,0.00,0.00,0,0,0,0,0,0,0,0,0,0,0,0,0
20200312,04240P,台積電凱基93售27,,,,,0.00,0.00,0,0,0,0,0,0,0,0,0,0,0,0,0
20200312,04241P,欣興國泰95售02,1.68,1.87,1.68,1.87,+0.57,43.85,40000,5,69000,0,0,0,0,0,0,30000,10000,20000,20000
20200312,04242P,台積電永昌93售08,,,,,0.00,0.00,0,0,0,0,0,0,0,0,0,0,0,0,0
20200312,042433,元油2X永豐96購01,,,,,0.00,0.00,0,0,0,0,0,0,0,0,0,0,0,0,0
20200312,04243P,大立光永昌93售08,,,,,0.00,0.00,0,0,0,0,0,0,0,0,0,0,0,0,0
20200312,04244P,可成元大93售12,,,,,0.00,0.00,0,0,0,0,0,0,0,0,0,0,0,0,0
20200312,04245P,上海銀元大93售03,3.37,3.61,3.37,3.61,0.00,0.00,40000,4,140400,0,0,0,0,0,0,0,40000,-40000,-40000
20200312,04246P,義隆永豐93售03,,,,,0.00,0.00,0,0,0,0,0,0,0,0,0,0,0,0,0
20200312,042470,元油2X元大93購04,,,,,0.00,0.00,0,0,0,0,0,0,0,0,0,0,0,0,0
20200312,04247P,宏達電永豐93售02,0.55,0.81,0.55,0.81,+0.27,50.0,50000,5,33900,0,0,0,0,0,0,20000,30000,-10000,-10000
20200312,04248P,臺股指永豐93售03,0.50,0.53,0.45,0.45,0.00,0.00,90000,3,42300,0,0,0,0,0,0,90000,10000,80000,80000
20200312,04249P,大立光統一94售04,0.86,0.92,0.86,0.92,0.00,0.00,341000,7,308140,0,0,0,0,0,0,0,341000,-341000,-341000
20200312,042501,台灣50凱基96購06,3.00,3.00,2.09,2.30,-1.21,-34.47,82000,22,202600,0,0,0,0,0,0,4000,78000,-74000,-74000
20200312,042502,上銀凱基93購01,0.19,0.19,0.19,0.19,-0.12,-38.71,30000,1,5700,0,0,0,0,0,0,30000,0,30000,30000
20200312,04250P,嘉晶統一95售02,0.77,0.90,0.72,0.83,+0.08,10.67,1359000,74,1089030,0,0,0,0,0,0,424000,1001000,-577000,-577000
20200312,042516,健策凱基93購01,,,,,0.00,0.00,0,0,0,0,0,0,0,0,0,0,0,0,0
20200312,04251P,欣興統一93售06,,,,,0.00,0.00,0,0,0,0,0,0,0,0,0,0,0,0,0
20200312,042527,台灣50永豐94購01,0.31,0.32,0.24,0.26,0.00,0.00,362000,39,93320,0,0,0,0,0,0,210000,362000,-152000,-152000
20200312,04252P,台達電元富93售02,0.77,0.84,0.77,0.84,+0.18,27.27,30000,3,24500,0,0,0,0,0,0,0,30000,-30000,-30000
20200312,04253P,聯發科元富93售01,0.34,0.34,0.34,0.34,+0.08,30.77,20000,1,6800,0,0,0,0,0,0,20000,0,20000,20000
20200312,042542,台灣50元大93購14,,,,,0.00,0.00,0,0,0,0,0,0,0,0,0,0,0,0,0
20200312,04254P,亞德客國票93售03,,,,,0.00,0.00,0,0,0,0,0,0,0,0,0,0,0,0,0
20200312,042556,台灣50中信96購04,1.31,1.35,1.10,1.29,-0.52,-28.73,407000,49,483950,0,0,0,0,0,0,37000,370000,-333000,-333000
20200312,042558,瑞昱中信94購01,,,,,0.00,0.00,0,0,0,0,0,0,0,0,0,0,0,0,0
20200312,04255P,台積電國票94售03,0.02,0.03,0.02,0.02,0.00,0.00,681000,7,14620,0,0,0,0,0,0,681000,0,681000,681000
20200312,04256P,美律國票93售03,,,,,0.00,0.00,0,0,0,0,0,0,0,0,0,0,0,0,0
20200312,04257P,景碩國票93售01,0.10,0.10,0.10,0.10,0.00,0.00,3000,1,300,0,0,0,0,0,0,3000,0,3000,3000
20200312,04258P,健策國票94售01,,,,,0.00,0.00,0,0,0,0,0,0,0,0,0,0,0,0,0
20200312,04259P,滬深2X群益93售03,3.46,3.46,3.46,3.46,+0.51,17.29,25000,2,86500,0,0,0,0,0,0,25000,0,25000,25000
20200312,04260P,亞德客群益93售01,,,,,0.00,0.00,0,0,0,0,0,0,0,0,0,0,0,0,0
20200312,04261P,大立光群益93售12,0.63,0.63,0.63,0.63,0.00,0.00,4000,1,2520,0,0,0,0,0,0,4000,0,4000,4000
20200312,04262P,景碩群益93售03,,,,,0.00,0.00,0,0,0,0,0,0,0,0,0,0,0,0,0
20200312,04263P,南電群益93售03,0.13,0.13,0.13,0.13,0.00,0.00,6000,1,780,0,0,0,0,0,0,6000,0,6000,6000
20200312,04264P,宏碁統一93售01,,,,,0.00,0.00,0,0,0,0,0,0,0,0,0,0,0,0,0
20200312,04265P,滬深2X元富93售04,1.95,1.95,1.95,1.95,+0.53,37.32,10000,1,19500,0,0,0,0,0,0,10000,10000,0,0
20200312,04266P,華新科元富93售02,,,,,0.00,0.00,0,0,0,0,0,0,0,0,0,0,0,0,0
20200312,042676,臺指反元大93購01,0.02,0.08,0.02,0.08,+0.07,700.0,195000,3,9900,0,0,0,0,0,0,195000,0,195000,195000
20200312,04267P,康控元富93售04,1.95,2.29,1.95,2.29,+0.65,39.63,60000,6,127600,0,0,0,0,0,0,10000,50000,-40000,-40000
20200312,04268P,南電元富93售03,,,,,0.00,0.00,0,0,0,0,0,0,0,0,0,0,0,0,0
20200312,042692,台灣50凱基96購09,4.51,4.51,3.30,3.62,-2.13,-37.04,55000,12,206520,0,0,0,0,0,0,2000,53000,-51000,-51000
20200312,04269P,華通國票93售03,,,,,0.00,0.00,0,0,0,0,0,0,0,0,0,0,0,0,0
20200312,042705,台積電亞東93購01,,,,,0.00,0.00,0,0,0,0,0,0,0,0,0,0,0,0,0
20200312,04270P,台光電國票93售03,,,,,0.00,0.00,0,0,0,0,0,0,0,0,0,0,0,0,0
20200312,042711,台灣50國票93購01,,,,,0.00,0.00,0,0,0,0,0,0,0,0,0,0,0,0,0
20200312,042712,元石油國票95購01,,,,,0.00,0.00,0,0,0,0,0,0,0,0,0,0,0,0,0
20200312,042719,臺指反群益93購01,0.03,0.07,0.03,0.06,0.00,0.00,255000,10,13350,0,0,0,0,0,0,252000,0,252000,252000
20200312,04271P,南亞科國票93售03,,,,,0.00,0.00,0,0,0,0,0,0,0,0,0,0,0,0,0
20200312,042724,群創群益93購01,,,,,0.00,0.00,0,0,0,0,0,0,0,0,0,0,0,0,0
20200312,04272P,元上證凱基94售01,0.13,0.17,0.13,0.17,+0.07,70.0,208000,7,34300,0,0,0,0,0,0,168000,40000,128000,128000
20200312,04273P,上証反凱基99售01,,,,,0.00,0.00,0,0,0,0,0,0,0,0,0,0,0,0,0
20200312,04274P,滬深2X凱基94售01,0.68,0.69,0.68,0.69,0.00,0.00,47000,3,31980,0,0,0,0,0,0,45000,2000,43000,43000
20200312,042752,台灣50元大96購03,2.96,2.96,1.37,1.57,-1.39,-46.96,1282000,182,2215710,0,0,0,0,0,0,135000,915000,-780000,-780000
20200312,042754,元黃金元大93購01,,,,,0.00,0.00,0,0,0,0,0,0,0,0,0,0,0,0,0
20200312,04275P,南亞科凱基93售08,2.91,4.35,2.91,4.35,+2.40,123.08,20000,2,72600,0,0,0,0,0,0,0,20000,-20000,-20000
20200312,04276P,聯發科凱基93售33,1.40,1.94,1.40,1.74,+0.65,59.63,50000,6,82100,0,0,0,0,0,0,10000,40000,-30000,-30000
20200312,04277P,奇力新凱基93售05,,,,,0.00,0.00,0,0,0,0,0,0,0,0,0,0,0,0,0
20200312,04278P,大立光凱基93售38,,,,,0.00,0.00,0,0,0,0,0,0,0,0,0,0,0,0,0
20200312,042792,T50反1台新9C購01,0.84,1.08,0.83,1.03,+0.26,33.77,1486000,37,1480020,0,0,0,0,0,0,1052000,394000,658000,658000
20200312,042793,台積電台新9C購01,12.50,12.90,11.00,12.30,-2.30,-15.75,41000,16,493000,0,0,0,0,0,0,5000,34000,-29000,-29000
20200312,042796,永冠元大93購01,,,,,0.00,0.00,0,0,0,0,0,0,0,0,0,0,0,0,0
20200312,04279P,超眾凱基93售07,,,,,0.00,0.00,0,0,0,0,0,0,0,0,0,0,0,0,0
20200312,042801,達邁元大93購01,,,,,0.00,0.00,0,0,0,0,0,0,0,0,0,0,0,0,0
20200312,042803,天鈺元大93購01,,,,,0.00,0.00,0,0,0,0,0,0,0,0,0,0,0,0,0
20200312,04280P,宏達電台新93售01,,,,,0.00,0.00,0,0,0,0,0,0,0,0,0,0,0,0,0
20200312,04281P,旺宏永豐93售05,,,,,0.00,0.00,0,0,0,0,0,0,0,0,0,0,0,0,0
20200312,04282P,微星永豐93售02,,,,,0.00,0.00,0,0,0,0,0,0,0,0,0,0,0,0,0
20200312,04283P,麗豐永豐93售03,,,,,0.00,0.00,0,0,0,0,0,0,0,0,0,0,0,0,0
20200312,04284P,瀚宇博永豐93售01,,,,,0.00,0.00,0,0,0,0,0,0,0,0,0,0,0,0,0
20200312,04285P,超眾永豐93售04,,,,,0.00,0.00,0,0,0,0,0,0,0,0,0,0,0,0,0
20200312,04286P,滬深2X中信96售01,0.56,0.58,0.56,0.58,0.00,0.00,331000,5,186720,0,0,0,0,0,0,31000,300000,-269000,-269000
20200312,04287P,A50正2中信96售01,0.53,0.59,0.52,0.56,+0.11,24.44,253000,10,135410,0,0,0,0,0,0,223000,30000,193000,193000
20200312,04288P,台積電中信95售06,0.17,0.21,0.17,0.18,+0.05,38.46,549000,9,104900,0,0,0,0,0,0,519000,30000,489000,489000
20200312,04289P,臺股指中信95售07,0.64,1.00,0.64,0.99,+0.41,70.69,626000,60,522220,0,0,0,0,0,0,444000,135000,309000,309000
20200312,042901,中纖元大94購01,,,,,0.00,0.00,0,0,0,0,0,0,0,0,0,0,0,0,0
20200312,042902,光寶科元大94購01,,,,,0.00,0.00,0,0,0,0,0,0,0,0,0,0,0,0,0
20200312,042903,金寶元大94購01,,,,,0.00,0.00,0,0,0,0,0,0,0,0,0,0,0,0,0
20200312,042904,金寶元大94購02,0.66,0.66,0.56,0.56,-0.43,-43.43,124000,3,76280,0,0,0,0,0,0,10000,114000,-104000,-104000
20200312,042909,順德元大94購01,,,,,0.00,0.00,0,0,0,0,0,0,0,0,0,0,0,0,0
20200312,04290P,滬深2X富邦96售03,,,,,0.00,0.00,0,0,0,0,0,0,0,0,0,0,0,0,0
20200312,042912,凌陽元大94購01,,,,,0.00,0.00,0,0,0,0,0,0,0,0,0,0,0,0,0
20200312,042916,佐登元大94購01,,,,,0.00,0.00,0,0,0,0,0,0,0,0,0,0,0,0,0
20200312,042918,矽格元大94購01,,,,,0.00,0.00,0,0,0,0,0,0,0,0,0,0,0,0,0
20200312,04291P,鴻海富邦93售04,,,,,0.00,0.00,0,0,0,0,0,0,0,0,0,0,0,0,0
20200312,042927,道瓊反中信94購01,1.05,1.09,0.99,0.99,+0.35,54.69,35000,4,35030,0,0,0,0,0,0,33000,2000,31000,31000
20200312,042928,台積電中信95購01,2.53,2.67,2.24,2.67,-0.68,-20.3,15000,3,38190,0,0,0,0,0,0,4000,11000,-7000,-7000
20200312,042929,台積電中信95購02,2.16,2.16,1.57,2.02,-0.50,-19.84,166000,43,320040,0,0,0,0,0,0,27000,136000,-109000,-109000
20200312,04292P,台積電富邦93售04,,,,,0.00,0.00,0,0,0,0,0,0,0,0,0,0,0,0,0
20200312,042930,大立光中信94購01,,,,,0.00,0.00,0,0,0,0,0,0,0,0,0,0,0,0,0
20200312,042931,啟碁中信95購01,,,,,0.00,0.00,0,0,0,0,0,0,0,0,0,0,0,0,0
20200312,04293P,滬深2X元大96售02,1.53,1.77,1.52,1.63,+0.18,12.41,343000,19,569560,0,0,0,0,0,0,102000,241000,-139000,-139000
20200312,042942,永冠國票94購01,,,,,0.00,0.00,0,0,0,0,0,0,0,0,0,0,0,0,0
20200312,04294P,台積電元大95售01,0.28,0.41,0.27,0.31,+0.06,24.0,1117000,60,362580,0,0,0,0,0,0,931000,159000,772000,772000
20200312,042953,鴻海台新01購01,2.73,2.77,2.12,2.15,-0.96,-30.87,597000,37,1398990,0,0,0,0,0,0,490000,105000,385000,385000
20200312,04295P,智邦元大93售10,,,,,0.00,0.00,0,0,0,0,0,0,0,0,0,0,0,0,0
20200312,04296P,技嘉元大93售01,,,,,0.00,0.00,0,0,0,0,0,0,0,0,0,0,0,0,0
20200312,04297P,微星元大93售03,0.90,0.90,0.90,0.90,0.00,0.00,3000,1,2700,0,0,0,0,0,0,0,3000,-3000,-3000
20200312,04298P,祥碩元大93售02,,,,,0.00,0.00,0,0,0,0,0,0,0,0,0,0,0,0,0
20200312,042993,葡萄王元大94購01,0.46,0.46,0.24,0.26,-0.15,-36.59,544000,26,178960,0,0,0,0,0,0,207000,336000,-129000,-129000
20200312,042994,葡萄王元大94購02,1.50,1.50,0.73,0.85,-0.27,-24.11,827000,54,835350,0,0,0,0,0,0,454000,363000,91000,91000
20200312,042997,新光鋼元大94購01,,,,,0.00,0.00,0,0,0,0,0,0,0,0,0,0,0,0,0
20200312,04299P,卜蜂中信93售02,,,,,0.00,0.00,0,0,0,0,0,0,0,0,0,0,0,0,0
20200312,04300P,華通中信93售02,,,,,0.00,0.00,0,0,0,0,0,0,0,0,0,0,0,0,0
20200312,043019,華晶科元大94購01,,,,,0.00,0.00,0,0,0,0,0,0,0,0,0,0,0,0,0
20200312,04301P,微星中信93售01,,,,,0.00,0.00,0,0,0,0,0,0,0,0,0,0,0,0,0
20200312,043023,康普元大94購01,,,,,0.00,0.00,0,0,0,0,0,0,0,0,0,0,0,0,0
20200312,04302P,和碩中信93售01,0.02,0.02,0.02,0.02,0.00,0.00,220000,3,4400,0,0,0,0,0,0,220000,0,220000,220000
20200312,04303P,義隆群益93售02,,,,,0.00,0.00,0,0,0,0,0,0,0,0,0,0,0,0,0
20200312,043040,永冠元富94購01,,,,,0.00,0.00,0,0,0,0,0,0,0,0,0,0,0,0,0
20200312,04304P,上海銀亞東93售01,,,,,0.00,0.00,0,0,0,0,0,0,0,0,0,0,0,0,0
20200312,04305P,A50反1凱基93售02,,,,,0.00,0.00,0,0,0,0,0,0,0,0,0,0,0,0,0
20200312,04306P,上銀凱基93售10,,,,,0.00,0.00,0,0,0,0,0,0,0,0,0,0,0,0,0
20200312,04307P,國巨凱基93售09,,,,,0.00,0.00,0,0,0,0,0,0,0,0,0,0,0,0,0
20200312,04308P,京元電凱基93售06,2.17,2.69,2.17,2.48,+0.76,44.19,34000,4,83320,0,0,0,0,0,0,18000,16000,2000,2000
20200312,04309P,滬深2X統一93售05,,,,,0.00,0.00,0,0,0,0,0,0,0,0,0,0,0,0,0
20200312,04310P,京元電統一93售03,,,,,0.00,0.00,0,0,0,0,0,0,0,0,0,0,0,0,0
20200312,04311P,奇力新統一95售01,0.72,0.72,0.72,0.72,0.00,0.00,10000,1,7200,0,0,0,0,0,0,10000,0,10000,10000
20200312,04312P,聯茂統一93售02,1.24,1.31,1.24,1.31,+0.56,74.67,16000,2,20260,0,0,0,0,0,0,6000,10000,-4000,-4000
20200312,04313P,國巨元富95售03,0.13,0.19,0.13,0.19,0.00,0.00,199000,7,32180,0,0,0,0,0,0,198000,1000,197000,197000
20200312,04314P,聯茂元富93售01,,,,,0.00,0.00,0,0,0,0,0,0,0,0,0,0,0,0,0
20200312,043156,大立光統一94購01,,,,,0.00,0.00,0,0,0,0,0,0,0,0,0,0,0,0,0
20200312,04315P,台光電國票93售04,0.62,0.62,0.62,0.62,+0.15,31.91,10000,1,6200,0,0,0,0,0,0,10000,0,10000,10000
20200312,04316P,華新科國票94售05,0.07,0.07,0.07,0.07,0.00,0.00,50000,1,3500,0,0,0,0,0,0,50000,0,50000,50000
20200312,04317P,樺漢國票93售03,,,,,0.00,0.00,0,0,0,0,0,0,0,0,0,0,0,0,0
20200312,04318P,大成鋼永豐93售02,,,,,0.00,0.00,0,0,0,0,0,0,0,0,0,0,0,0,0
20200312,04319P,健策永豐93售03,,,,,0.00,0.00,0,0,0,0,0,0,0,0,0,0,0,0,0
20200312,043202,緯穎元大94購01,,,,,0.00,0.00,0,0,0,0,0,0,0,0,0,0,0,0,0
20200312,04320P,亞德客元大93售07,,,,,0.00,0.00,0,0,0,0,0,0,0,0,0,0,0,0,0
20200312,04321P,國巨元大93售12,,,,,0.00,0.00,0,0,0,0,0,0,0,0,0,0,0,0,0
20200312,04322P,可成元大94售01,2.72,2.72,2.72,2.72,+0.91,50.28,4000,1,10880,0,0,0,0,0,0,4000,4000,0,0
20200312,043231,鴻海中信95購01,0.02,0.02,0.01,0.02,-0.02,-50.0,407000,42,8130,0,0,0,0,0,0,7000,400000,-393000,-393000
20200312,04323P,強茂元大93售02,,,,,0.00,0.00,0,0,0,0,0,0,0,0,0,0,0,0,0
20200312,04324P,新光金元大94售01,,,,,0.00,0.00,0,0,0,0,0,0,0,0,0,0,0,0,0
20200312,04325P,創意元大93售06,1.85,1.85,1.85,1.85,0.00,0.00,15000,1,27750,0,0,0,0,0,0,15000,0,15000,15000
20200312,04326P,泰鼎元大93售06,,,,,0.00,0.00,0,0,0,0,0,0,0,0,0,0,0,0,0
20200312,043272,羅麗芬國泰94購01,,,,,0.00,0.00,0,0,0,0,0,0,0,0,0,0,0,0,0
20200312,04327P,台積電國泰95售01,0.58,1.00,0.58,0.73,+0.38,108.57,778000,22,533870,0,0,0,0,0,0,674000,84000,590000,590000
20200312,04328P,台達電中信93售02,,,,,0.00,0.00,0,0,0,0,0,0,0,0,0,0,0,0,0
20200312,043290,揚明光元大94購01,,,,,0.00,0.00,0,0,0,0,0,0,0,0,0,0,0,0,0
20200312,04329P,TPK群益93售04,3.42,3.85,3.42,3.85,0.00,0.00,40000,4,145900,0,0,0,0,0,0,0,40000,-40000,-40000
20200312,04330P,台達電亞東93售02,1.00,1.00,1.00,1.00,0.00,0.00,100000,3,100000,0,0,0,0,0,0,0,100000,-100000,-100000
20200312,04331P,健策國票93售02,,,,,0.00,0.00,0,0,0,0,0,0,0,0,0,0,0,0,0
20200312,04332P,A50正2日盛93售01,,,,,0.00,0.00,0,0,0,0,0,0,0,0,0,0,0,0,0
20200312,04333P,儒鴻凱基93售06,3.73,5.05,3.73,5.05,+2.35,87.04,23000,5,93300,0,0,0,0,0,0,3000,20000,-17000,-17000
20200312,04334P,中石化康和93售01,,,,,0.00,0.00,0,0,0,0,0,0,0,0,0,0,0,0,0
20200312,04335P,大成鋼元大93售01,1.35,1.35,1.35,1.35,0.00,0.00,10000,1,13500,0,0,0,0,0,0,10000,0,10000,10000
20200312,04336P,台達電元大93售04,0.27,0.27,0.27,0.27,0.00,0.00,3000,1,810,0,0,0,0,0,0,3000,0,3000,3000
20200312,04337P,台積電元大93售25,0.10,0.20,0.10,0.14,+0.07,100.0,202000,8,27980,0,0,0,0,0,0,200000,2000,198000,198000
20200312,04338P,亞光元大93售04,0.88,0.88,0.88,0.88,0.00,0.00,10000,1,8800,0,0,0,0,0,0,10000,0,10000,10000
20200312,043391,康控元大94購01,0.01,0.01,0.01,0.01,-0.02,-66.67,40000,4,400,0,0,0,0,0,0,0,40000,-40000,-40000
20200312,043394,易華電元大94購01,,,,,0.00,0.00,0,0,0,0,0,0,0,0,0,0,0,0,0
20200312,04339P,欣興元大93售08,,,,,0.00,0.00,0,0,0,0,0,0,0,0,0,0,0,0,0
20200312,04340P,易華電元大94售02,,,,,0.00,0.00,0,0,0,0,0,0,0,0,0,0,0,0,0
20200312,04341P,美律永豐93售03,,,,,0.00,0.00,0,0,0,0,0,0,0,0,0,0,0,0,0
20200312,04342P,揚明光永豐93售03,,,,,0.00,0.00,0,0,0,0,0,0,0,0,0,0,0,0,0
20200312,04343P,啟碁永豐93售02,1.03,1.26,1.03,1.26,0.00,0.00,40000,4,45000,0,0,0,0,0,0,0,40000,-40000,-40000
20200312,043442,大立光台新01購01,2.80,2.80,2.21,2.24,-0.99,-30.65,260000,31,611510,0,0,0,0,0,0,2000,258000,-256000,-256000
20200312,04344P,台達電國泰94售01,0.88,1.08,0.83,1.08,+0.43,66.15,24000,5,23910,0,0,0,0,0,0,13000,24000,-11000,-11000
20200312,04345P,景碩國泰94售02,0.44,0.55,0.44,0.55,0.00,0.00,266000,5,120100,0,0,0,0,0,0,4000,262000,-258000,-258000
20200312,04346P,大立光兆豐95售02,0.36,0.52,0.36,0.45,+0.22,95.65,70000,3,32700,0,0,0,0,0,0,40000,30000,10000,10000
20200312,04347P,全新群益94售01,0.57,0.57,0.57,0.57,+0.18,46.15,3000,1,1710,0,0,0,0,0,0,3000,0,3000,3000
20200312,04348P,燿華國票94售01,,,,,0.00,0.00,0,0,0,0,0,0,0,0,0,0,0,0,0
20200312,04349P,美律國票94售02,,,,,0.00,0.00,0,0,0,0,0,0,0,0,0,0,0,0,0
20200312,04350P,欣興國票94售01,1.34,2.06,1.34,2.06,+1.13,121.51,113000,7,190450,0,0,0,0,0,0,73000,40000,33000,33000
20200312,043513,台灣50元大96購05,1.01,1.01,0.80,0.80,-0.34,-29.82,67000,9,60450,0,0,0,0,0,0,2000,62000,-60000,-60000
20200312,04351P,鴻海永豐94售01,,,,,0.00,0.00,0,0,0,0,0,0,0,0,0,0,0,0,0
20200312,04352P,國巨永豐94售01,,,,,0.00,0.00,0,0,0,0,0,0,0,0,0,0,0,0,0
20200312,043538,元石油國票97購01,0.02,0.03,0.01,0.03,+0.01,50.0,1004000,10,20080,0,0,0,0,0,0,0,802000,-802000,-802000
20200312,04353P,全新永豐94售01,,,,,0.00,0.00,0,0,0,0,0,0,0,0,0,0,0,0,0
20200312,04354P,華新科永豐94售01,0.03,0.03,0.03,0.03,0.00,0.00,120000,1,3600,0,0,0,0,0,0,120000,0,120000,120000
20200312,04355P,大立光永豐94售02,,,,,0.00,0.00,0,0,0,0,0,0,0,0,0,0,0,0,0
20200312,04356P,嘉晶永豐94售01,,,,,0.00,0.00,0,0,0,0,0,0,0,0,0,0,0,0,0
20200312,04357P,智易永豐94售01,,,,,0.00,0.00,0,0,0,0,0,0,0,0,0,0,0,0,0
20200312,043580,大立光元富94購01,,,,,0.00,0.00,0,0,0,0,0,0,0,0,0,0,0,0,0
20200312,043585,道瓊反元大94購01,0.20,0.24,0.20,0.24,+0.15,166.67,740000,18,166780,0,0,0,0,0,0,359000,380000,-21000,-21000
20200312,04358P,TPK永豐94售01,1.39,1.57,1.39,1.57,0.00,0.00,20000,2,29600,0,0,0,0,0,0,0,20000,-20000,-20000
20200312,04359P,中磊永豐94售01,,,,,0.00,0.00,0,0,0,0,0,0,0,0,0,0,0,0,0
20200312,04360P,易華電永豐94售01,0.46,0.50,0.46,0.50,0.00,0.00,50000,5,24000,0,0,0,0,0,0,40000,10000,30000,30000
20200312,04361P,台積電統一94售05,,,,,0.00,0.00,0,0,0,0,0,0,0,0,0,0,0,0,0
20200312,04362P,聯詠統一94售01,,,,,0.00,0.00,0,0,0,0,0,0,0,0,0,0,0,0,0
20200312,04363P,儒鴻元富94售01,2.61,3.32,2.61,3.32,+1.65,98.8,46000,3,132830,0,0,0,0,0,0,6000,40000,-34000,-34000
20200312,043641,深中小國票94購01,0.49,0.49,0.47,0.47,-0.39,-45.35,20000,2,9600,0,0,0,0,0,0,0,20000,-20000,-20000
20200312,043642,元金2X國票97購01,1.69,1.69,1.55,1.55,0.00,0.00,11000,4,17640,0,0,0,0,0,0,5000,6000,-1000,-1000
20200312,04364P,台積電元富94售03,,,,,0.00,0.00,0,0,0,0,0,0,0,0,0,0,0,0,0
20200312,043656,上証反元大94購01,0.08,0.08,0.07,0.07,+0.02,40.0,7000,3,530,0,0,0,0,0,0,4000,3000,1000,1000
20200312,04365P,台積電元富95售02,,,,,0.00,0.00,0,0,0,0,0,0,0,0,0,0,0,0,0
20200312,04366P,全新元富95售01,1.45,1.53,1.41,1.53,+0.27,21.43,88000,4,127780,0,0,0,0,0,0,18000,70000,-52000,-52000
20200312,04367P,滬深2X凱基95售04,,,,,0.00,0.00,0,0,0,0,0,0,0,0,0,0,0,0,0
20200312,04368P,台積電凱基94售02,,,,,0.00,0.00,0,0,0,0,0,0,0,0,0,0,0,0,0
20200312,043693,為升兆豐93購01,,,,,0.00,0.00,0,0,0,0,0,0,0,0,0,0,0,0,0
20200312,043696,瑞儀兆豐93購01,,,,,0.00,0.00,0,0,0,0,0,0,0,0,0,0,0,0,0
20200312,04369P,台光電凱基94售04,,,,,0.00,0.00,0,0,0,0,0,0,0,0,0,0,0,0,0
20200312,04370P,聯茂凱基94售05,,,,,0.00,0.00,0,0,0,0,0,0,0,0,0,0,0,0,0
20200312,043715,易華電群益93購01,,,,,0.00,0.00,0,0,0,0,0,0,0,0,0,0,0,0,0
20200312,043719,國巨統一93購02,,,,,0.00,0.00,0,0,0,0,0,0,0,0,0,0,0,0,0
20200312,04371P,臺股指凱基94售01,1.23,1.35,1.23,1.34,0.00,0.00,520000,28,684500,0,0,0,0,0,0,520000,520000,0,0
20200312,043726,T50反1國泰93購01,0.10,0.51,0.10,0.51,+0.44,628.57,66000,13,17700,0,0,0,0,0,0,66000,0,66000,66000
20200312,043728,美律國泰93購01,,,,,0.00,0.00,0,0,0,0,0,0,0,0,0,0,0,0,0
20200312,04372P,臺股指凱基94售02,0.91,1.37,0.91,1.37,0.00,0.00,80000,8,104800,0,0,0,0,0,0,80000,70000,10000,10000
20200312,043730,旭富國泰93購01,,,,,0.00,0.00,0,0,0,0,0,0,0,0,0,0,0,0,0
20200312,043735,元金2X元大94購01,,,,,0.00,0.00,0,0,0,0,0,0,0,0,0,0,0,0,0
20200312,04373P,滬深2X元大97售01,1.10,1.30,1.10,1.23,+0.10,8.85,584000,18,702050,0,0,0,0,0,0,461000,123000,338000,338000
20200312,043740,國巨元大93購02,,,,,0.00,0.00,0,0,0,0,0,0,0,0,0,0,0,0,0
20200312,043748,漢唐元大93購01,,,,,0.00,0.00,0,0,0,0,0,0,0,0,0,0,0,0,0
20200312,04374P,深中小元大94售03,,,,,0.00,0.00,0,0,0,0,0,0,0,0,0,0,0,0,0
20200312,043750,美律元大93購01,,,,,0.00,0.00,0,0,0,0,0,0,0,0,0,0,0,0,0
20200312,043757,欣興元大93購01,0.02,0.02,0.02,0.02,0.00,0.00,5000,1,100,0,0,0,0,0,0,5000,0,5000,5000
20200312,04375P,卜蜂元大94售01,,,,,0.00,0.00,0,0,0,0,0,0,0,0,0,0,0,0,0
20200312,043765,GIS元大93購04,,,,,0.00,0.00,0,0,0,0,0,0,0,0,0,0,0,0,0
20200312,04376P,漢唐元大94售04,0.67,0.74,0.67,0.74,+0.28,60.87,460000,3,329900,0,0,0,0,0,0,150000,310000,-160000,-160000
20200312,043773,智邦兆豐93購01,,,,,0.00,0.00,0,0,0,0,0,0,0,0,0,0,0,0,0
20200312,04377P,大立光元大94售04,,,,,0.00,0.00,0,0,0,0,0,0,0,0,0,0,0,0,0
20200312,043784,鴻海凱基94購01,0.54,0.55,0.40,0.40,-0.29,-42.03,583000,11,286600,0,0,0,0,0,0,10000,573000,-563000,-563000
20200312,04378P,大立光元大94售05,,,,,0.00,0.00,0,0,0,0,0,0,0,0,0,0,0,0,0
20200312,04379P,大立光元大94售06,1.38,1.43,1.37,1.43,0.00,0.00,87000,3,123260,0,0,0,0,0,0,20000,67000,-47000,-47000
20200312,04380P,欣興元大94售02,1.01,1.33,1.01,1.33,+0.66,98.51,23000,3,26040,0,0,0,0,0,0,10000,13000,-3000,-3000
20200312,04381P,世紀鋼元大94售01,,,,,0.00,0.00,0,0,0,0,0,0,0,0,0,0,0,0,0
20200312,043823,羅麗芬群益94購01,,,,,0.00,0.00,0,0,0,0,0,0,0,0,0,0,0,0,0
20200312,04382P,美律國泰95售01,1.84,1.84,1.82,1.82,0.00,0.00,110000,2,202200,0,0,0,0,0,0,0,110000,-110000,-110000
20200312,043832,SP黃豆國票95購01,,,,,0.00,0.00,0,0,0,0,0,0,0,0,0,0,0,0,0
20200312,04383P,泰鼎國泰95售01,0.21,0.30,0.20,0.26,+0.04,18.18,625000,25,162450,0,0,0,0,0,0,605000,20000,585000,585000
20200312,04384P,上証2X中信96售01,0.85,0.99,0.85,0.94,+0.15,18.99,300000,11,273700,0,0,0,0,0,0,175000,125000,50000,50000
20200312,043850,台表科國泰93購01,,,,,0.00,0.00,0,0,0,0,0,0,0,0,0,0,0,0,0
20200312,043851,國泰金永昌93購01,,,,,0.00,0.00,0,0,0,0,0,0,0,0,0,0,0,0,0
20200312,043853,力山富邦93購01,,,,,0.00,0.00,0,0,0,0,0,0,0,0,0,0,0,0,0
20200312,043854,華新科富邦93購01,0.01,0.01,0.01,0.01,0.00,0.00,2000,1,20,0,0,0,0,0,0,2000,0,2000,2000
20200312,043855,創意富邦93購01,,,,,0.00,0.00,0,0,0,0,0,0,0,0,0,0,0,0,0
20200312,04385P,可成日盛94售01,1.07,1.26,1.07,1.26,+0.63,100.0,40000,4,45900,0,0,0,0,0,0,0,40000,-40000,-40000
20200312,04386P,大立光日盛94售01,,,,,0.00,0.00,0,0,0,0,0,0,0,0,0,0,0,0,0
20200312,04387P,玉晶光日盛94售01,,,,,0.00,0.00,0,0,0,0,0,0,0,0,0,0,0,0,0
20200312,043889,台表科元大93購01,,,,,0.00,0.00,0,0,0,0,0,0,0,0,0,0,0,0,0
20200312,04388P,滬深2X凱基95售05,0.89,0.93,0.89,0.93,0.00,0.00,40000,2,36800,0,0,0,0,0,0,30000,10000,20000,20000
20200312,043891,羅麗芬元大94購01,,,,,0.00,0.00,0,0,0,0,0,0,0,0,0,0,0,0,0
20200312,04389P,台積電凱基94售04,,,,,0.00,0.00,0,0,0,0,0,0,0,0,0,0,0,0,0
20200312,043907,鴻海凱基93購01,,,,,0.00,0.00,0,0,0,0,0,0,0,0,0,0,0,0,0
20200312,043908,鴻海凱基93購02,,,,,0.00,0.00,0,0,0,0,0,0,0,0,0,0,0,0,0
20200312,043909,台光電凱基93購01,0.24,0.24,0.19,0.19,0.00,0.00,15000,3,3080,0,0,0,0,0,0,4000,15000,-11000,-11000
20200312,04390P,台積電凱基94售05,,,,,0.00,0.00,0,0,0,0,0,0,0,0,0,0,0,0,0
20200312,043912,華新科凱基93購01,,,,,0.00,0.00,0,0,0,0,0,0,0,0,0,0,0,0,0
20200312,043916,群創凱基93購01,,,,,0.00,0.00,0,0,0,0,0,0,0,0,0,0,0,0,0
20200312,04391P,玉晶光凱基95售03,0.29,0.33,0.29,0.31,0.00,0.00,211000,5,65530,0,0,0,0,0,0,211000,0,211000,211000
20200312,043920,瑞儀凱基93購01,,,,,0.00,0.00,0,0,0,0,0,0,0,0,0,0,0,0,0
20200312,043921,台表科凱基93購01,,,,,0.00,0.00,0,0,0,0,0,0,0,0,0,0,0,0,0
20200312,043924,世紀鋼凱基93購01,,,,,0.00,0.00,0,0,0,0,0,0,0,0,0,0,0,0,0
20200312,04392P,牧德凱基94售05,,,,,0.00,0.00,0,0,0,0,0,0,0,0,0,0,0,0,0
20200312,043938,華邦電兆豐93購01,,,,,0.00,0.00,0,0,0,0,0,0,0,0,0,0,0,0,0
20200312,04393P,牧德凱基94售06,,,,,0.00,0.00,0,0,0,0,0,0,0,0,0,0,0,0,0
20200312,043944,欣興兆豐93購02,,,,,0.00,0.00,0,0,0,0,0,0,0,0,0,0,0,0,0
20200312,04394P,臻鼎凱基94售01,0.62,1.18,0.62,1.14,+0.59,107.27,41000,11,44000,0,0,0,0,0,0,31000,10000,21000,21000
20200312,043958,臻鼎元富94購01,,,,,0.00,0.00,0,0,0,0,0,0,0,0,0,0,0,0,0
20200312,04395P,台積電群益94售06,0.15,0.15,0.15,0.15,0.00,0.00,10000,1,1500,0,0,0,0,0,0,10000,0,10000,10000
20200312,043961,道瓊反國泰94購01,0.51,0.68,0.51,0.57,+0.17,42.5,351000,12,213870,0,0,0,0,0,0,351000,0,351000,351000
20200312,04396P,玉晶光群益94售02,0.40,0.40,0.38,0.38,0.00,0.00,200000,2,78000,0,0,0,0,0,0,200000,0,200000,200000
20200312,043970,為升富邦94購01,,,,,0.00,0.00,0,0,0,0,0,0,0,0,0,0,0,0,0
20200312,043972,大立光富邦93購02,,,,,0.00,0.00,0,0,0,0,0,0,0,0,0,0,0,0,0
20200312,043973,元金2X元大94購02,,,,,0.00,0.00,0,0,0,0,0,0,0,0,0,0,0,0,0
20200312,04397P,玉晶光群益95售03,,,,,0.00,0.00,0,0,0,0,0,0,0,0,0,0,0,0,0
20200312,04398P,致伸群益94售02,,,,,0.00,0.00,0,0,0,0,0,0,0,0,0,0,0,0,0
20200312,043990,智易元大93購01,,,,,0.00,0.00,0,0,0,0,0,0,0,0,0,0,0,0,0
20200312,043992,康控元大93購02,,,,,0.00,0.00,0,0,0,0,0,0,0,0,0,0,0,0,0
20200312,04399P,樺漢群益94售01,,,,,0.00,0.00,0,0,0,0,0,0,0,0,0,0,0,0,0
20200312,044003,聯發科兆豐93購01,,,,,0.00,0.00,0,0,0,0,0,0,0,0,0,0,0,0,0
20200312,04400P,台積電兆豐95售02,0.28,0.28,0.28,0.28,0.00,0.00,20000,1,5600,0,0,0,0,0,0,0,20000,-20000,-20000
20200312,044010,華通凱基93購01,,,,,0.00,0.00,0,0,0,0,0,0,0,0,0,0,0,0,0
20200312,044011,鴻海凱基93購03,0.54,0.54,0.54,0.54,-0.47,-46.53,10000,1,5400,0,0,0,0,0,0,0,10000,-10000,-10000
20200312,044013,友達凱基93購01,,,,,0.00,0.00,0,0,0,0,0,0,0,0,0,0,0,0,0
20200312,044016,義隆凱基93購01,0.20,0.20,0.20,0.20,-0.70,-77.78,8000,1,1600,0,0,0,0,0,0,8000,0,8000,8000
20200312,04401P,玉晶光兆豐94售01,0.06,0.06,0.06,0.06,0.00,0.00,60000,1,3600,0,0,0,0,0,0,60000,0,60000,60000
20200312,044022,健策凱基93購02,,,,,0.00,0.00,0,0,0,0,0,0,0,0,0,0,0,0,0
20200312,044024,祥碩凱基93購01,,,,,0.00,0.00,0,0,0,0,0,0,0,0,0,0,0,0,0
20200312,044025,台表科凱基93購02,,,,,0.00,0.00,0,0,0,0,0,0,0,0,0,0,0,0,0
20200312,04402P,TPK兆豐95售01,0.87,1.08,0.87,1.08,+0.28,35.0,513000,15,479780,0,0,0,0,0,0,0,513000,-513000,-513000
20200312,044038,群創群益93購02,,,,,0.00,0.00,0,0,0,0,0,0,0,0,0,0,0,0,0
20200312,044039,康控群益93購01,,,,,0.00,0.00,0,0,0,0,0,0,0,0,0,0,0,0,0
20200312,04403P,景碩國票95售01,0.30,0.30,0.30,0.30,0.00,0.00,1000,1,300,0,0,0,0,0,0,1000,0,1000,1000
20200312,044049,元金2X元大94購03,1.63,1.63,1.42,1.42,-0.47,-24.87,6000,4,9360,0,0,0,0,0,0,0,6000,-6000,-6000
20200312,04404P,玉晶光國票94售01,,,,,0.00,0.00,0,0,0,0,0,0,0,0,0,0,0,0,0
20200312,04405P,牧德國票95售01,,,,,0.00,0.00,0,0,0,0,0,0,0,0,0,0,0,0,0
20200312,04406P,貿聯國票94售02,,,,,0.00,0.00,0,0,0,0,0,0,0,0,0,0,0,0,0
20200312,044076,台灣50國票93購02,,,,,0.00,0.00,0,0,0,0,0,0,0,0,0,0,0,0,0
20200312,04407P,滬深2X統一94售02,,,,,0.00,0.00,0,0,0,0,0,0,0,0,0,0,0,0,0
20200312,044088,國巨元富95購01,3.23,3.23,3.23,3.23,0.00,0.00,1000,1,3230,0,0,0,0,0,0,1000,0,1000,1000
20200312,04408P,台積電統一94售06,0.15,0.26,0.15,0.26,+0.16,160.0,115000,2,28250,0,0,0,0,0,0,115000,0,115000,115000
20200312,04409P,台積電統一95售01,,,,,0.00,0.00,0,0,0,0,0,0,0,0,0,0,0,0,0
20200312,044104,鴻海中信95購03,0.02,0.02,0.01,0.02,-0.01,-33.33,521000,46,10410,0,0,0,0,0,0,0,420000,-420000,-420000
20200312,044105,聯詠中信95購01,0.45,0.45,0.41,0.43,-0.21,-32.81,152000,4,66440,0,0,0,0,0,0,112000,40000,72000,72000
20200312,04410P,大立光統一94售05,1.64,2.12,1.64,2.12,0.00,0.00,7000,7,13380,0,0,0,0,0,0,7000,0,7000,7000
20200312,044118,健策兆豐93購02,,,,,0.00,0.00,0,0,0,0,0,0,0,0,0,0,0,0,0
20200312,04411P,智易統一96售01,1.29,1.45,1.29,1.45,0.00,0.00,30000,3,41200,0,0,0,0,0,0,0,30000,-30000,-30000
20200312,044124,燿華凱基93購01,,,,,0.00,0.00,0,0,0,0,0,0,0,0,0,0,0,0,0
20200312,044125,美律凱基93購01,,,,,0.00,0.00,0,0,0,0,0,0,0,0,0,0,0,0,0
20200312,044126,奇力新凱基93購01,,,,,0.00,0.00,0,0,0,0,0,0,0,0,0,0,0,0,0
20200312,044129,群創凱基93購02,0.02,0.02,0.02,0.02,-0.12,-85.71,21000,1,420,0,0,0,0,0,0,21000,0,21000,21000
20200312,04412P,欣興元富94售01,3.02,3.02,3.02,3.02,0.00,0.00,1000,1,3020,0,0,0,0,0,0,1000,0,1000,1000
20200312,044134,訊芯凱基93購01,,,,,0.00,0.00,0,0,0,0,0,0,0,0,0,0,0,0,0
20200312,044136,百和凱基93購01,,,,,0.00,0.00,0,0,0,0,0,0,0,0,0,0,0,0,0
20200312,04413P,玉晶光元富94售01,,,,,0.00,0.00,0,0,0,0,0,0,0,0,0,0,0,0,0
20200312,04414P,牧德元富94售04,0.38,0.68,0.38,0.68,+0.38,126.67,79000,8,44520,0,0,0,0,0,0,79000,0,79000,79000
20200312,04415P,牧德元富94售05,,,,,0.00,0.00,0,0,0,0,0,0,0,0,0,0,0,0,0
20200312,044167,大立光元大93購03,,,,,0.00,0.00,0,0,0,0,0,0,0,0,0,0,0,0,0
20200312,04416P,牧德元富94售06,,,,,0.00,0.00,0,0,0,0,0,0,0,0,0,0,0,0,0
20200312,04417P,光罩國泰95售02,0.96,1.13,0.96,1.13,+0.22,24.18,519000,19,549380,0,0,0,0,0,0,183000,321000,-138000,-138000
20200312,044183,S&P反1國泰93購01,,,,,0.00,0.00,0,0,0,0,0,0,0,0,0,0,0,0,0
20200312,044184,南亞科國泰93購01,,,,,0.00,0.00,0,0,0,0,0,0,0,0,0,0,0,0,0
20200312,044187,泰鼎國泰93購01,,,,,0.00,0.00,0,0,0,0,0,0,0,0,0,0,0,0,0
20200312,044188,超眾國泰93購01,,,,,0.00,0.00,0,0,0,0,0,0,0,0,0,0,0,0,0
20200312,04418P,燿華永豐94售01,,,,,0.00,0.00,0,0,0,0,0,0,0,0,0,0,0,0,0
20200312,044190,聯詠富邦93購01,,,,,0.00,0.00,0,0,0,0,0,0,0,0,0,0,0,0,0
20200312,04419P,奇力新永豐94售01,0.18,0.21,0.18,0.21,+0.06,40.0,20000,2,3900,0,0,0,0,0,0,20000,0,20000,20000
20200312,044200,群創國票93購01,,,,,0.00,0.00,0,0,0,0,0,0,0,0,0,0,0,0,0
20200312,044201,群創國票95購01,,,,,0.00,0.00,0,0,0,0,0,0,0,0,0,0,0,0,0
20200312,04420P,奇鋐永豐94售01,1.37,1.61,1.37,1.61,+0.51,46.36,50000,4,71900,0,0,0,0,0,0,20000,30000,-10000,-10000
20200312,044212,鴻海凱基93購04,,,,,0.00,0.00,0,0,0,0,0,0,0,0,0,0,0,0,0
20200312,044216,華新科凱基93購02,,,,,0.00,0.00,0,0,0,0,0,0,0,0,0,0,0,0,0
20200312,044217,華新科凱基93購03,0.62,0.62,0.27,0.27,-0.43,-61.43,16000,2,7820,0,0,0,0,0,0,10000,6000,4000,4000
20200312,04421P,玉晶光永豐94售02,0.60,0.66,0.60,0.66,0.00,0.00,40000,4,25600,0,0,0,0,0,0,6000,34000,-28000,-28000
20200312,044221,群創凱基93購03,,,,,0.00,0.00,0,0,0,0,0,0,0,0,0,0,0,0,0
20200312,044224,超眾凱基93購01,,,,,0.00,0.00,0,0,0,0,0,0,0,0,0,0,0,0,0
20200312,044225,世紀鋼凱基93購02,,,,,0.00,0.00,0,0,0,0,0,0,0,0,0,0,0,0,0
20200312,04422P,玉晶光永豐94售03,0.75,1.08,0.75,1.00,+0.32,47.06,859000,25,745370,0,0,0,0,0,0,785000,74000,711000,711000
20200312,04423P,牧德永豐94售01,,,,,0.00,0.00,0,0,0,0,0,0,0,0,0,0,0,0,0
20200312,044242,宏達電統一93購01,,,,,0.00,0.00,0,0,0,0,0,0,0,0,0,0,0,0,0
20200312,044247,道瓊反元富97購01,0.80,1.04,0.80,1.00,+0.30,42.86,88000,14,84330,0,0,0,0,0,0,23000,59000,-36000,-36000
20200312,044249,T50反1中信94購01,0.37,0.56,0.37,0.56,+0.29,107.41,196000,17,91520,0,0,0,0,0,0,196000,166000,30000,30000
20200312,04424P,台郡永豐94售01,0.02,0.02,0.02,0.02,0.00,0.00,57000,1,1140,0,0,0,0,0,0,57000,0,57000,57000
20200312,044254,深中小元大94購01,,,,,0.00,0.00,0,0,0,0,0,0,0,0,0,0,0,0,0
20200312,044255,群創元大93購01,,,,,0.00,0.00,0,0,0,0,0,0,0,0,0,0,0,0,0
20200312,04425P,中環康和94售01,,,,,0.00,0.00,0,0,0,0,0,0,0,0,0,0,0,0,0
20200312,044264,大立光富邦93購03,,,,,0.00,0.00,0,0,0,0,0,0,0,0,0,0,0,0,0
20200312,044265,滬深2X中信95購05,0.02,0.02,0.02,0.02,-0.03,-60.0,50000,5,1000,0,0,0,0,0,0,0,50000,-50000,-50000
20200312,044269,群創中信95購01,0.03,0.03,0.02,0.02,-0.02,-50.0,3509000,260,78330,0,0,0,0,0,0,0,2370000,-2370000,-2370000
20200312,04426P,佳世達康和94售02,0.70,0.85,0.70,0.85,+0.28,49.12,104000,2,75800,0,0,0,0,0,0,84000,20000,64000,64000
20200312,044270,群創中信95購02,0.07,0.07,0.04,0.04,-0.07,-63.64,345000,34,17550,0,0,0,0,0,0,20000,325000,-305000,-305000
20200312,04427P,滬深2X元大97售02,1.11,1.29,1.11,1.24,+0.24,24.0,71000,13,85540,0,0,0,0,0,0,27000,44000,-17000,-17000
20200312,044280,T50反1凱基94購02,0.35,0.65,0.35,0.65,+0.32,96.97,1156000,38,542830,0,0,0,0,0,0,1156000,10000,1146000,1146000
20200312,044282,上銀凱基93購03,0.38,0.38,0.23,0.23,-0.47,-67.14,51000,4,15130,0,0,0,0,0,0,21000,51000,-30000,-30000
20200312,044285,鴻海凱基93購06,,,,,0.00,0.00,0,0,0,0,0,0,0,0,0,0,0,0,0
20200312,044289,群創凱基93購04,,,,,0.00,0.00,0,0,0,0,0,0,0,0,0,0,0,0,0
20200312,04428P,台光電元大94售02,1.16,1.44,1.16,1.44,0.00,0.00,52000,3,60750,0,0,0,0,0,0,2000,50000,-48000,-48000
20200312,044290,群創凱基93購05,,,,,0.00,0.00,0,0,0,0,0,0,0,0,0,0,0,0,0
20200312,044291,群創凱基93購06,,,,,0.00,0.00,0,0,0,0,0,0,0,0,0,0,0,0,0
20200312,044296,嘉聯益凱基93購01,,,,,0.00,0.00,0,0,0,0,0,0,0,0,0,0,0,0,0
20200312,044298,南電凱基93購01,,,,,0.00,0.00,0,0,0,0,0,0,0,0,0,0,0,0,0
20200312,044299,南電凱基93購02,,,,,0.00,0.00,0,0,0,0,0,0,0,0,0,0,0,0,0
20200312,04429P,和鑫元大94售01,,,,,0.00,0.00,0,0,0,0,0,0,0,0,0,0,0,0,0
20200312,044302,智邦兆豐93購02,0.96,1.10,0.96,1.10,0.00,0.00,25000,3,26100,0,0,0,0,0,0,5000,20000,-15000,-15000
20200312,044304,臻鼎兆豐93購01,,,,,0.00,0.00,0,0,0,0,0,0,0,0,0,0,0,0,0
20200312,044305,瀚宇博兆豐93購01,,,,,0.00,0.00,0,0,0,0,0,0,0,0,0,0,0,0,0
20200312,044306,瑞儀兆豐93購02,,,,,0.00,0.00,0,0,0,0,0,0,0,0,0,0,0,0,0
20200312,044307,GIS兆豐93購01,,,,,0.00,0.00,0,0,0,0,0,0,0,0,0,0,0,0,0
20200312,04430P,晶相光元大94售04,,,,,0.00,0.00,0,0,0,0,0,0,0,0,0,0,0,0,0
20200312,044310,元黃金台新93購01,,,,,0.00,0.00,0,0,0,0,0,0,0,0,0,0,0,0,0
20200312,04431P,牧德元大94售03,,,,,0.00,0.00,0,0,0,0,0,0,0,0,0,0,0,0,0
20200312,04432P,昇陽半元大94售04,,,,,0.00,0.00,0,0,0,0,0,0,0,0,0,0,0,0,0
20200312,044330,T50反1統一93購01,0.10,0.23,0.10,0.23,0.00,0.00,276000,3,34880,0,0,0,0,0,0,276000,0,276000,276000
20200312,04433P,上証2X國票95售01,0.80,0.82,0.72,0.76,0.00,0.00,150000,12,111690,0,0,0,0,0,0,130000,0,130000,130000
20200312,044340,TPK統一93購01,,,,,0.00,0.00,0,0,0,0,0,0,0,0,0,0,0,0,0
20200312,044346,力山富邦95購01,,,,,0.00,0.00,0,0,0,0,0,0,0,0,0,0,0,0,0
20200312,044347,上証2X元大94購01,,,,,0.00,0.00,0,0,0,0,0,0,0,0,0,0,0,0,0
20200312,04434P,玉晶光國票96售02,1.07,1.42,1.07,1.38,+0.38,38.0,1917000,78,2315600,0,0,0,0,0,0,1523000,346000,1177000,1177000
20200312,044353,宏達電元大93購04,,,,,0.00,0.00,0,0,0,0,0,0,0,0,0,0,0,0,0
20200312,044354,奇鋐元大93購02,,,,,0.00,0.00,0,0,0,0,0,0,0,0,0,0,0,0,0
20200312,04435P,台積電中信95售07,0.27,0.39,0.27,0.30,+0.08,36.36,414000,11,147080,0,0,0,0,0,0,393000,21000,372000,372000
20200312,044362,元油2X中信94購01,0.01,0.01,0.01,0.01,0.00,0.00,39000,30,390,0,0,0,0,0,0,0,0,0,0
20200312,044364,超眾中信94購01,0.02,0.02,0.02,0.02,0.00,0.00,350000,1,7000,0,0,0,0,0,0,350000,0,350000,350000
20200312,04436P,聯發科中信96售02,,,,,0.00,0.00,0,0,0,0,0,0,0,0,0,0,0,0,0
20200312,044374,燿華兆豐93購01,0.31,0.31,0.12,0.12,-0.43,-78.18,33000,6,8210,0,0,0,0,0,0,20000,13000,7000,7000
20200312,044377,南茂兆豐93購01,0.72,0.72,0.72,0.72,0.00,0.00,10000,1,7200,0,0,0,0,0,0,0,10000,-10000,-10000
20200312,04437P,滬深2X群益98售03,0.86,1.04,0.86,0.92,+0.16,21.05,36000,5,33920,0,0,0,0,0,0,25000,11000,14000,14000
20200312,044382,嘉聯益群益94購01,0.23,0.23,0.14,0.14,-0.13,-48.15,24000,4,4620,0,0,0,0,0,0,4000,20000,-16000,-16000
20200312,04438P,微星群益94售01,,,,,0.00,0.00,0,0,0,0,0,0,0,0,0,0,0,0,0
20200312,044396,燿華凱基93購02,,,,,0.00,0.00,0,0,0,0,0,0,0,0,0,0,0,0,0
20200312,04439P,聯發科群益94售04,,,,,0.00,0.00,0,0,0,0,0,0,0,0,0,0,0,0,0
20200312,044401,亞光凱基93購01,,,,,0.00,0.00,0,0,0,0,0,0,0,0,0,0,0,0,0
20200312,044402,景碩凱基93購01,0.17,0.18,0.17,0.17,-0.19,-52.78,100000,3,17100,0,0,0,0,0,0,90000,10000,80000,80000
20200312,044405,材料凱基93購01,,,,,0.00,0.00,0,0,0,0,0,0,0,0,0,0,0,0,0
20200312,044407,聯茂凱基93購01,,,,,0.00,0.00,0,0,0,0,0,0,0,0,0,0,0,0,0
20200312,044408,聯茂凱基93購02,,,,,0.00,0.00,0,0,0,0,0,0,0,0,0,0,0,0,0
20200312,04440P,訊芯群益94售01,,,,,0.00,0.00,0,0,0,0,0,0,0,0,0,0,0,0,0
20200312,044411,A50正2統一93購01,,,,,0.00,0.00,0,0,0,0,0,0,0,0,0,0,0,0,0
20200312,04441P,台積電台新95售01,,,,,0.00,0.00,0,0,0,0,0,0,0,0,0,0,0,0,0
20200312,044426,欣興國泰93購02,,,,,0.00,0.00,0,0,0,0,0,0,0,0,0,0,0,0,0
20200312,044427,群創國泰93購01,,,,,0.00,0.00,0,0,0,0,0,0,0,0,0,0,0,0,0
20200312,044429,元金2X元大94購04,0.29,0.29,0.25,0.25,-0.11,-30.56,2391000,24,641020,0,0,0,0,0,0,2042000,345000,1697000,1697000
20200312,04442P,矽格康和94售02,,,,,0.00,0.00,0,0,0,0,0,0,0,0,0,0,0,0,0
20200312,044439,南電元大93購01,0.33,0.33,0.33,0.33,-0.33,-50.0,70000,1,23100,0,0,0,0,0,0,70000,0,70000,70000
20200312,04443P,台積電永豐94售01,,,,,0.00,0.00,0,0,0,0,0,0,0,0,0,0,0,0,0
20200312,04444P,玉晶光永豐94售06,,,,,0.00,0.00,0,0,0,0,0,0,0,0,0,0,0,0,0
20200312,044457,滬深2X國票97購01,0.08,0.08,0.05,0.06,-0.03,-33.33,2466000,21,159210,0,0,0,0,0,0,10000,2322000,-2312000,-2312000
20200312,04445P,台積電日盛94售01,,,,,0.00,0.00,0,0,0,0,0,0,0,0,0,0,0,0,0
20200312,044461,滬深2X兆豐93購01,,,,,0.00,0.00,0,0,0,0,0,0,0,0,0,0,0,0,0
20200312,044462,漢唐兆豐93購01,,,,,0.00,0.00,0,0,0,0,0,0,0,0,0,0,0,0,0
20200312,044463,全新兆豐93購01,,,,,0.00,0.00,0,0,0,0,0,0,0,0,0,0,0,0,0
20200312,044464,滬深2X群益95購01,0.02,0.02,0.02,0.02,-0.01,-33.33,140000,5,2800,0,0,0,0,0,0,0,0,0,0
20200312,044465,元油2X群益97購01,,,,,0.00,0.00,0,0,0,0,0,0,0,0,0,0,0,0,0
20200312,044466,和大群益93購01,,,,,0.00,0.00,0,0,0,0,0,0,0,0,0,0,0,0,0
20200312,044468,台積電群益93購01,,,,,0.00,0.00,0,0,0,0,0,0,0,0,0,0,0,0,0
20200312,04446P,元油2X凱基94售03,5.30,5.90,5.30,5.50,0.00,0.00,3661000,38,19847900,0,0,0,0,0,0,3660000,3362000,298000,298000
20200312,044475,國巨元富95購02,,,,,0.00,0.00,0,0,0,0,0,0,0,0,0,0,0,0,0
20200312,044478,友達統一93購01,,,,,0.00,0.00,0,0,0,0,0,0,0,0,0,0,0,0,0
20200312,04447P,上銀凱基94售02,0.43,0.47,0.43,0.47,0.00,0.00,70000,2,30500,0,0,0,0,0,0,70000,10000,60000,60000
20200312,044487,元油2X元大94購01,,,,,0.00,0.00,0,0,0,0,0,0,0,0,0,0,0,0,0
20200312,04448P,台積電凱基94售07,,,,,0.00,0.00,0,0,0,0,0,0,0,0,0,0,0,0,0
20200312,044496,群創元大93購02,,,,,0.00,0.00,0,0,0,0,0,0,0,0,0,0,0,0,0
20200312,04449P,智邦凱基94售01,,,,,0.00,0.00,0,0,0,0,0,0,0,0,0,0,0,0,0
20200312,044507,燿華凱基93購03,0.12,0.12,0.11,0.11,-0.10,-47.62,55000,4,6550,0,0,0,0,0,0,40000,15000,25000,25000
20200312,044509,台光電凱基93購03,,,,,0.00,0.00,0,0,0,0,0,0,0,0,0,0,0,0,0
20200312,04450P,京元電凱基94售01,2.29,2.37,2.13,2.24,+0.92,69.7,27000,5,60240,0,0,0,0,0,0,18000,9000,9000,9000
20200312,044510,台光電凱基93購04,,,,,0.00,0.00,0,0,0,0,0,0,0,0,0,0,0,0,0
20200312,044512,奇力新凱基93購02,0.60,0.60,0.60,0.60,-0.30,-33.33,10000,1,6000,0,0,0,0,0,0,10000,0,10000,10000
20200312,044513,義隆凱基93購02,,,,,0.00,0.00,0,0,0,0,0,0,0,0,0,0,0,0,0
20200312,044514,亞光凱基93購02,,,,,0.00,0.00,0,0,0,0,0,0,0,0,0,0,0,0,0
20200312,044516,景碩凱基93購02,,,,,0.00,0.00,0,0,0,0,0,0,0,0,0,0,0,0,0
20200312,04451P,可成凱基94售04,3.07,3.73,3.07,3.73,+1.40,60.09,40000,4,139200,0,0,0,0,0,0,10000,30000,-20000,-20000
20200312,044522,TPK凱基93購01,,,,,0.00,0.00,0,0,0,0,0,0,0,0,0,0,0,0,0
20200312,044524,瑞儀凱基93購02,,,,,0.00,0.00,0,0,0,0,0,0,0,0,0,0,0,0,0
20200312,044526,訊芯凱基93購02,,,,,0.00,0.00,0,0,0,0,0,0,0,0,0,0,0,0,0
20200312,044527,易華電凱基93購01,,,,,0.00,0.00,0,0,0,0,0,0,0,0,0,0,0,0,0
20200312,04452P,超眾國泰95售01,1.29,1.64,1.29,1.50,+0.25,20.0,120000,8,172340,0,0,0,0,0,0,89000,71000,18000,18000
20200312,044530,台積電富邦94購01,0.97,0.97,0.60,0.71,0.00,0.00,105000,21,81060,0,0,0,0,0,0,10000,92000,-82000,-82000
20200312,044531,欣興富邦93購01,,,,,0.00,0.00,0,0,0,0,0,0,0,0,0,0,0,0,0
20200312,044532,康控富邦93購01,,,,,0.00,0.00,0,0,0,0,0,0,0,0,0,0,0,0,0
20200312,044533,S&P反1中信94購02,0.85,1.51,0.85,1.51,+0.66,77.65,86000,8,107870,0,0,0,0,0,0,74000,10000,64000,64000
20200312,044535,華新科麥證93購01,1.19,1.19,1.19,1.19,0.00,0.00,2000,1,2380,2000,0,2000,0,0,0,2000,0,2000,2000
20200312,04453P,聯發科富邦94售04,2.04,2.68,2.04,2.31,+0.66,40.0,30000,4,68900,0,0,0,0,0,0,20000,10000,10000,10000
20200312,04454P,大立光富邦98售02,0.78,1.08,0.78,1.07,+0.33,44.59,800000,18,791800,0,0,0,0,0,0,367000,433000,-66000,-66000
20200312,04455P,台積電統一94售07,0.17,0.18,0.15,0.18,0.00,0.00,141000,5,23180,0,0,0,0,0,0,0,111000,-111000,-111000
20200312,044567,華通凱基93購03,1.88,1.88,0.87,0.88,-1.19,-57.49,208000,28,306130,0,0,0,0,0,0,109000,99000,10000,10000
20200312,04456P,日月光統一94售01,1.81,2.02,1.81,2.02,0.00,0.00,25000,2,48400,0,0,0,0,0,0,15000,10000,5000,5000
20200312,044574,潤泰全凱基93購01,,,,,0.00,0.00,0,0,0,0,0,0,0,0,0,0,0,0,0
20200312,044578,緯創凱基93購02,,,,,0.00,0.00,0,0,0,0,0,0,0,0,0,0,0,0,0
20200312,04457P,同欣電統一94售01,0.56,0.82,0.55,0.82,+0.35,74.47,504000,13,322220,0,0,0,0,0,0,250000,254000,-4000,-4000
20200312,044583,易華電凱基93購02,,,,,0.00,0.00,0,0,0,0,0,0,0,0,0,0,0,0,0
20200312,044584,世紀鋼凱基93購05,,,,,0.00,0.00,0,0,0,0,0,0,0,0,0,0,0,0,0
20200312,044588,元金2X統一93購01,,,,,0.00,0.00,0,0,0,0,0,0,0,0,0,0,0,0,0
20200312,044589,國巨統一93購03,,,,,0.00,0.00,0,0,0,0,0,0,0,0,0,0,0,0,0
20200312,04458P,世紀鋼統一96售01,0.72,0.78,0.72,0.78,+0.11,16.42,41000,6,30180,0,0,0,0,0,0,33000,8000,25000,25000
20200312,044592,元油2X國票93購02,,,,,0.00,0.00,0,0,0,0,0,0,0,0,0,0,0,0,0
20200312,04459P,元油2X元富94售08,7.65,7.65,7.55,7.65,0.00,0.00,1438000,10,10976200,0,0,0,0,0,0,1438000,1438000,0,0
20200312,044600,上銀國泰93購01,,,,,0.00,0.00,0,0,0,0,0,0,0,0,0,0,0,0,0
20200312,044601,旺宏國泰93購03,,,,,0.00,0.00,0,0,0,0,0,0,0,0,0,0,0,0,0
20200312,044602,大立光國泰93購01,,,,,0.00,0.00,0,0,0,0,0,0,0,0,0,0,0,0,0
20200312,044604,嘉聯益國泰93購01,,,,,0.00,0.00,0,0,0,0,0,0,0,0,0,0,0,0,0
20200312,044605,超眾國泰93購02,,,,,0.00,0.00,0,0,0,0,0,0,0,0,0,0,0,0,0
20200312,044608,奇力新富邦93購01,,,,,0.00,0.00,0,0,0,0,0,0,0,0,0,0,0,0,0
20200312,04460P,元油2X元富96售04,,,,,0.00,0.00,0,0,0,0,0,0,0,0,0,0,0,0,0
20200312,044610,A50正2兆豐93購01,,,,,0.00,0.00,0,0,0,0,0,0,0,0,0,0,0,0,0
20200312,044612,創意兆豐93購01,,,,,0.00,0.00,0,0,0,0,0,0,0,0,0,0,0,0,0
20200312,044613,智易兆豐94購01,,,,,0.00,0.00,0,0,0,0,0,0,0,0,0,0,0,0,0
20200312,044615,聯茂兆豐93購01,,,,,0.00,0.00,0,0,0,0,0,0,0,0,0,0,0,0,0
20200312,04461P,燿華元富94售01,,,,,0.00,0.00,0,0,0,0,0,0,0,0,0,0,0,0,0
20200312,04462P,全新元富96售01,1.40,1.55,1.40,1.55,+0.27,21.09,349000,6,511500,0,0,0,0,0,0,28000,321000,-293000,-293000
20200312,044636,創意統一94購01,,,,,0.00,0.00,0,0,0,0,0,0,0,0,0,0,0,0,0
20200312,044637,滬深2X元富94購01,0.08,0.08,0.08,0.08,-0.10,-55.56,100000,1,8000,0,0,0,0,0,0,0,100000,-100000,-100000
20200312,044639,京元電元富94購01,0.32,0.32,0.17,0.19,-0.24,-55.81,830000,21,200800,0,0,0,0,0,0,60000,770000,-710000,-710000
20200312,04463P,可成元富94售03,2.68,2.68,2.68,2.68,+1.10,69.62,30000,1,80400,0,0,0,0,0,0,30000,0,30000,30000
20200312,044643,滬深2X群益96購01,0.10,0.10,0.09,0.10,-0.05,-33.33,34000,3,3350,0,0,0,0,0,0,0,34000,-34000,-34000
20200312,044645,元金2X群益93購01,,,,,0.00,0.00,0,0,0,0,0,0,0,0,0,0,0,0,0
20200312,04464P,可成元富94售04,2.70,2.73,2.70,2.73,0.00,0.00,500000,2,1350030,0,0,0,0,0,0,500000,0,500000,500000
20200312,04465P,大立光元富94售03,0.51,0.58,0.51,0.58,0.00,0.00,257000,2,148570,0,0,0,0,0,0,257000,0,257000,257000
20200312,04466P,大立光元富94售04,1.60,1.60,1.60,1.60,+0.73,83.91,69000,1,110400,0,0,0,0,0,0,69000,0,69000,69000
20200312,044673,上銀凱基93購04,0.17,0.17,0.17,0.17,-0.14,-45.16,30000,1,5100,0,0,0,0,0,0,30000,0,30000,30000
20200312,044675,廣宇凱基93購02,,,,,0.00,0.00,0,0,0,0,0,0,0,0,0,0,0,0,0
20200312,04467P,元油2X元大94售03,5.90,6.10,5.90,6.05,0.00,0.00,2009000,22,12152450,0,0,0,0,0,0,2009000,1979000,30000,30000
20200312,044680,華新科凱基93購06,,,,,0.00,0.00,0,0,0,0,0,0,0,0,0,0,0,0,0
20200312,044682,和鑫凱基93購01,,,,,0.00,0.00,0,0,0,0,0,0,0,0,0,0,0,0,0
20200312,044683,聯鈞凱基93購01,0.49,0.57,0.49,0.57,-0.07,-10.94,30000,3,15500,0,0,0,0,0,0,30000,0,30000,30000
20200312,044687,南寶凱基93購01,,,,,0.00,0.00,0,0,0,0,0,0,0,0,0,0,0,0,0
20200312,044688,傳奇凱基93購01,,,,,0.00,0.00,0,0,0,0,0,0,0,0,0,0,0,0,0
20200312,044689,超眾凱基93購03,,,,,0.00,0.00,0,0,0,0,0,0,0,0,0,0,0,0,0
20200312,04468P,元油2X元大94售04,4.04,4.04,4.04,4.04,0.00,0.00,140000,2,565600,0,0,0,0,0,0,140000,0,140000,140000
20200312,044693,滬深2X元大94購01,0.13,0.13,0.10,0.12,-0.11,-47.83,273000,19,32200,0,0,0,0,0,0,153000,120000,33000,33000
20200312,044694,道瓊反元大94購02,0.40,0.46,0.39,0.41,+0.23,127.78,990000,13,425000,0,0,0,0,0,0,319000,671000,-352000,-352000
20200312,044697,美律元大93購02,,,,,0.00,0.00,0,0,0,0,0,0,0,0,0,0,0,0,0
20200312,04469P,元油2X元大94售05,3.78,3.79,3.78,3.79,+0.52,15.9,199000,2,753210,0,0,0,0,0,0,199000,0,199000,199000
20200312,044705,群創元大93購03,,,,,0.00,0.00,0,0,0,0,0,0,0,0,0,0,0,0,0
20200312,04470P,為升元大94售01,4.60,4.60,4.60,4.60,0.00,0.00,10000,1,46000,0,0,0,0,0,0,0,10000,-10000,-10000
20200312,044717,旺宏統一94購01,0.27,0.27,0.13,0.15,-0.18,-54.55,1960000,43,414140,0,0,0,0,0,0,1060000,880000,180000,180000
20200312,044718,宏達電統一93購02,,,,,0.00,0.00,0,0,0,0,0,0,0,0,0,0,0,0,0
20200312,044719,欣興亞東93購01,,,,,0.00,0.00,0,0,0,0,0,0,0,0,0,0,0,0,0
20200312,04471P,華通元大95售03,0.44,0.69,0.44,0.68,+0.32,88.89,705000,15,390210,0,0,0,0,0,0,112000,590000,-478000,-478000
20200312,04472P,中環元大94售01,,,,,0.00,0.00,0,0,0,0,0,0,0,0,0,0,0,0,0
20200312,044734,台積電國泰93購01,,,,,0.00,0.00,0,0,0,0,0,0,0,0,0,0,0,0,0
20200312,044735,光磊國泰93購01,,,,,0.00,0.00,0,0,0,0,0,0,0,0,0,0,0,0,0
20200312,04473P,國巨元大94售03,,,,,0.00,0.00,0,0,0,0,0,0,0,0,0,0,0,0,0
20200312,044746,智易群益93購01,,,,,0.00,0.00,0,0,0,0,0,0,0,0,0,0,0,0,0
20200312,044747,健策群益93購01,,,,,0.00,0.00,0,0,0,0,0,0,0,0,0,0,0,0,0
20200312,04474P,聯發科元大94售03,0.56,0.56,0.56,0.56,0.00,0.00,1000,1,560,0,0,0,0,0,0,0,1000,-1000,-1000
20200312,044750,鴻海凱基93購07,,,,,0.00,0.00,0,0,0,0,0,0,0,0,0,0,0,0,0
20200312,044751,鴻海凱基93購08,,,,,0.00,0.00,0,0,0,0,0,0,0,0,0,0,0,0,0
20200312,044757,益航凱基93購01,,,,,0.00,0.00,0,0,0,0,0,0,0,0,0,0,0,0,0
20200312,04475P,欣興元大94售03,1.66,1.89,1.66,1.89,0.00,0.00,37000,5,63800,0,0,0,0,0,0,37000,0,37000,37000
20200312,044762,元翎凱基93購01,,,,,0.00,0.00,0,0,0,0,0,0,0,0,0,0,0,0,0
20200312,044763,瀚宇博凱基93購01,0.68,0.68,0.65,0.65,-0.42,-39.25,35000,2,22900,0,0,0,0,0,0,35000,0,35000,35000
20200312,044764,聯茂凱基93購03,0.40,0.40,0.40,0.40,-0.13,-24.53,10000,1,4000,0,0,0,0,0,0,10000,0,10000,10000
20200312,044767,世紀鋼凱基93購06,,,,,0.00,0.00,0,0,0,0,0,0,0,0,0,0,0,0,0
20200312,044768,深中小元大94購02,,,,,0.00,0.00,0,0,0,0,0,0,0,0,0,0,0,0,0
20200312,04476P,玉晶光元大94售05,0.16,0.17,0.16,0.17,0.00,0.00,369000,3,60870,0,0,0,0,0,0,369000,0,369000,369000
20200312,044779,GIS元大93購05,0.02,0.02,0.02,0.02,0.00,0.00,10000,1,200,0,0,0,0,0,0,0,10000,-10000,-10000
20200312,04477P,南電元大94售04,0.35,0.41,0.35,0.39,+0.04,11.43,9000,5,3280,0,0,0,0,0,0,9000,0,9000,9000
20200312,044784,華邦電中信96購01,0.07,0.07,0.05,0.05,0.00,0.00,237000,25,13250,0,0,0,0,0,0,0,237000,-237000,-237000
20200312,044785,台達電亞東93購01,,,,,0.00,0.00,0,0,0,0,0,0,0,0,0,0,0,0,0
20200312,04478P,元油2X中信95售03,4.00,4.00,4.00,4.00,+0.40,11.11,20000,2,80000,0,0,0,0,0,0,0,20000,-20000,-20000
20200312,044790,智易群益93購02,,,,,0.00,0.00,0,0,0,0,0,0,0,0,0,0,0,0,0
20200312,04479P,同欣電中信96售02,0.40,0.46,0.40,0.46,+0.13,39.39,366000,3,163840,0,0,0,0,0,0,200000,366000,-166000,-166000
20200312,044805,旭富凱基93購01,0.57,0.57,0.27,0.27,-0.59,-68.6,175000,17,83130,0,0,0,0,0,0,85000,90000,-5000,-5000
20200312,044809,道瓊反國票93購01,0.68,0.96,0.64,0.86,+0.46,115.0,153000,15,112780,0,0,0,0,0,0,153000,0,153000,153000
20200312,04480P,微星兆豐94售01,0.31,0.31,0.31,0.31,0.00,0.00,10000,1,3100,0,0,0,0,0,0,10000,0,10000,10000
20200312,044813,為升兆豐93購02,,,,,0.00,0.00,0,0,0,0,0,0,0,0,0,0,0,0,0
20200312,044814,華邦電兆豐93購02,,,,,0.00,0.00,0,0,0,0,0,0,0,0,0,0,0,0,0
20200312,044817,可成兆豐93購01,0.05,0.05,0.02,0.02,-0.08,-80.0,100000,10,3500,0,0,0,0,0,0,0,100000,-100000,-100000
20200312,044819,新日興兆豐93購02,,,,,0.00,0.00,0,0,0,0,0,0,0,0,0,0,0,0,0
20200312,04481P,聯發科日盛94售01,,,,,0.00,0.00,0,0,0,0,0,0,0,0,0,0,0,0,0
20200312,044820,臻鼎兆豐93購02,,,,,0.00,0.00,0,0,0,0,0,0,0,0,0,0,0,0,0
20200312,044821,瑞儀兆豐93購03,,,,,0.00,0.00,0,0,0,0,0,0,0,0,0,0,0,0,0
20200312,04482P,臺股指日盛94售01,0.35,1.20,0.35,1.20,0.00,0.00,100000,4,103000,0,0,0,0,0,0,100000,0,100000,100000
20200312,044836,宏達電元大93購05,,,,,0.00,0.00,0,0,0,0,0,0,0,0,0,0,0,0,0
20200312,04483P,元油2X凱基97售04,6.85,7.75,6.85,7.45,+0.55,7.97,171000,6,1238500,0,0,0,0,0,0,161000,49000,112000,112000
20200312,044844,國巨統一93購04,,,,,0.00,0.00,0,0,0,0,0,0,0,0,0,0,0,0,0
20200312,044846,旺宏統一93購01,,,,,0.00,0.00,0,0,0,0,0,0,0,0,0,0,0,0,0
20200312,044848,華邦電統一94購01,,,,,0.00,0.00,0,0,0,0,0,0,0,0,0,0,0,0,0
20200312,04484P,台積電凱基94售09,0.21,0.40,0.21,0.23,0.00,0.00,190000,12,55700,0,0,0,0,0,0,140000,50000,90000,90000
20200312,044850,南亞科統一94購01,,,,,0.00,0.00,0,0,0,0,0,0,0,0,0,0,0,0,0
20200312,044852,華邦電國泰93購02,,,,,0.00,0.00,0,0,0,0,0,0,0,0,0,0,0,0,0
20200312,044853,亞光國泰93購01,,,,,0.00,0.00,0,0,0,0,0,0,0,0,0,0,0,0,0
20200312,04485P,台積電凱基94售10,,,,,0.00,0.00,0,0,0,0,0,0,0,0,0,0,0,0,0
20200312,044860,元油2X中信93購01,,,,,0.00,0.00,0,0,0,0,0,0,0,0,0,0,0,0,0
20200312,044864,道瓊反國票96購01,0.31,0.59,0.31,0.54,+0.26,92.86,7678000,131,3657230,0,0,0,0,0,0,3494000,3597000,-103000,-103000
20200312,04486P,台光電凱基94售05,,,,,0.00,0.00,0,0,0,0,0,0,0,0,0,0,0,0,0
20200312,044871,國巨統一93購05,9.10,9.10,9.10,9.10,-2.30,-20.18,10000,1,91000,0,0,0,0,0,0,0,10000,-10000,-10000
20200312,044872,旺宏統一93購02,0.40,0.40,0.30,0.30,-0.40,-57.14,200000,2,70000,0,0,0,0,0,0,100000,100000,0,0
20200312,044875,玉晶光統一93購01,,,,,0.00,0.00,0,0,0,0,0,0,0,0,0,0,0,0,0
20200312,044879,上証2X群益93購01,,,,,0.00,0.00,0,0,0,0,0,0,0,0,0,0,0,0,0
20200312,04487P,南亞科凱基94售01,,,,,0.00,0.00,0,0,0,0,0,0,0,0,0,0,0,0,0
20200312,044883,玉晶光群益93購01,,,,,0.00,0.00,0,0,0,0,0,0,0,0,0,0,0,0,0
20200312,04488P,聯發科凱基94售05,,,,,0.00,0.00,0,0,0,0,0,0,0,0,0,0,0,0,0
20200312,04489P,大立光凱基94售03,1.10,1.18,1.10,1.18,+0.64,118.52,30000,3,34400,0,0,0,0,0,0,20000,30000,-10000,-10000
20200312,044909,玉晶光凱基93購02,0.83,0.83,0.42,0.42,-0.81,-65.85,43000,6,30860,0,0,0,0,0,0,1000,42000,-41000,-41000
20200312,04490P,聯發科台新94售02,,,,,0.00,0.00,0,0,0,0,0,0,0,0,0,0,0,0,0
20200312,04491P,光磊康和94售01,0.75,1.03,0.75,1.03,+0.36,53.73,335000,2,275610,0,0,0,0,0,0,248000,87000,161000,161000
20200312,044926,聯詠國泰93購01,,,,,0.00,0.00,0,0,0,0,0,0,0,0,0,0,0,0,0
20200312,044927,聯詠國泰94購01,0.82,0.82,0.76,0.76,-0.41,-35.04,46000,2,35020,0,0,0,0,0,0,1000,45000,-44000,-44000
20200312,044928,玉晶光國泰93購01,0.58,0.58,0.58,0.58,0.00,0.00,15000,1,8700,0,0,0,0,0,0,15000,0,15000,15000
20200312,04492P,元油2X永豐94售03,,,,,0.00,0.00,0,0,0,0,0,0,0,0,0,0,0,0,0
20200312,044930,元黃金富邦93購01,0.32,0.32,0.32,0.32,0.00,0.00,5000,1,1600,0,0,0,0,0,0,0,5000,-5000,-5000
20200312,04493P,漢唐永豐94售01,0.21,0.25,0.21,0.25,0.00,0.00,17000,3,4120,0,0,0,0,0,0,17000,0,17000,17000
20200312,044942,國巨群益94購01,,,,,0.00,0.00,0,0,0,0,0,0,0,0,0,0,0,0,0
20200312,04494P,台積電國票94售04,,,,,0.00,0.00,0,0,0,0,0,0,0,0,0,0,0,0,0
20200312,044950,玉晶光群益94購01,,,,,0.00,0.00,0,0,0,0,0,0,0,0,0,0,0,0,0
20200312,04495P,台積電國票95售01,0.93,0.93,0.72,0.75,0.00,0.00,250000,3,188100,0,0,0,0,0,0,0,250000,-250000,-250000
20200312,044961,聯電中信94購01,,,,,0.00,0.00,0,0,0,0,0,0,0,0,0,0,0,0,0
20200312,044963,台積電中信96購01,1.36,1.36,0.96,1.17,-0.36,-23.53,594000,65,667710,0,0,0,0,0,0,213000,368000,-155000,-155000
20200312,044964,旺宏中信94購01,0.02,0.02,0.01,0.01,-0.04,-80.0,459000,6,4790,0,0,0,0,0,0,200000,20000,180000,180000
20200312,044965,大立光中信95購01,0.10,0.10,0.06,0.06,-0.10,-62.5,340000,27,23600,0,0,0,0,0,0,80000,260000,-180000,-180000
20200312,044966,台表科中信94購01,0.07,0.07,0.05,0.05,-0.14,-73.68,362000,6,24340,0,0,0,0,0,0,312000,50000,262000,262000
20200312,04496P,國巨國泰96售02,0.15,0.30,0.15,0.24,+0.10,71.43,2404000,40,431250,0,0,0,0,0,0,543000,1280000,-737000,-737000
20200312,044972,元金2X國票96購01,,,,,0.00,0.00,0,0,0,0,0,0,0,0,0,0,0,0,0
20200312,044974,鴻海國票94購01,0.01,0.01,0.01,0.01,0.00,0.00,2881000,12,28810,0,0,0,0,0,0,2881000,0,2881000,2881000
20200312,04497P,元油2X富邦97售03,7.50,7.50,7.30,7.35,0.00,0.00,1264000,22,9265850,0,0,0,0,0,0,1264000,1230000,34000,34000
20200312,044987,宏達電統一94購01,0.03,0.03,0.02,0.02,0.00,0.00,60000,2,1500,0,0,0,0,0,0,0,60000,-60000,-60000
20200312,044988,玉晶光統一95購01,0.95,0.96,0.71,0.76,-0.48,-38.71,145000,13,107420,0,0,0,0,0,0,3000,142000,-139000,-139000
20200312,04498P,台積電富邦94售04,,,,,0.00,0.00,0,0,0,0,0,0,0,0,0,0,0,0,0
20200312,044992,力山國泰94購01,,,,,0.00,0.00,0,0,0,0,0,0,0,0,0,0,0,0,0
20200312,044995,大立光國泰94購01,,,,,0.00,0.00,0,0,0,0,0,0,0,0,0,0,0,0,0
20200312,044996,嘉晶國泰95購01,0.84,0.91,0.79,0.88,+0.06,7.32,272000,6,236380,0,0,0,0,0,0,210000,52000,158000,158000
20200312,044998,玉晶光國泰94購01,,,,,0.00,0.00,0,0,0,0,0,0,0,0,0,0,0,0,0
20200312,04499P,滬深2X統一94售03,0.70,0.96,0.70,0.95,+0.33,53.23,123000,68,101330,0,0,0,0,0,0,122000,0,122000,122000
20200312,045001,旺宏富邦94購01,0.15,0.15,0.14,0.14,0.00,0.00,7000,2,1030,0,0,0,0,0,0,5000,2000,3000,3000
20200312,04500P,燿華統一94售01,,,,,0.00,0.00,0,0,0,0,0,0,0,0,0,0,0,0,0
20200312,045015,玉晶光元大94購01,0.37,0.37,0.37,0.37,0.00,0.00,50000,1,18500,0,0,0,0,0,0,50000,0,50000,50000
20200312,045016,創意元大94購01,,,,,0.00,0.00,0,0,0,0,0,0,0,0,0,0,0,0,0
20200312,04501P,元油2X元富98售07,5.65,5.65,5.65,5.65,+1.33,30.79,75000,2,423750,0,0,0,0,0,0,75000,75000,0,0
20200312,045021,臺股指中信94購02,,,,,0.00,0.00,0,0,0,0,0,0,0,0,0,0,0,0,0
20200312,04502P,元油2X元富98售08,7.00,7.00,6.80,6.90,0.00,0.00,120000,3,832000,0,0,0,0,0,0,120000,120000,0,0
20200312,04503P,元油2X元富98售09,8.30,8.30,8.20,8.25,+0.85,11.49,914000,15,7519800,0,0,0,0,0,0,914000,914000,0,0
20200312,04504P,台積電元富94售04,,,,,0.00,0.00,0,0,0,0,0,0,0,0,0,0,0,0,0
20200312,045053,聯發科元富98購01,0.42,0.42,0.27,0.27,-0.24,-47.06,2368000,89,745220,0,0,0,0,0,0,386000,1961000,-1575000,-1575000
20200312,045054,聯發科元富98購02,0.69,0.69,0.45,0.46,-0.35,-43.21,1055000,48,601920,0,0,0,0,0,0,94000,945000,-851000,-851000
20200312,045055,聯發科元富98購03,1.43,1.46,1.06,1.06,-0.57,-34.97,873000,43,1094980,0,0,0,0,0,0,458000,413000,45000,45000
20200312,045058,華邦電國泰94購01,,,,,0.00,0.00,0,0,0,0,0,0,0,0,0,0,0,0,0
20200312,04505P,佳世達元富96售03,1.37,1.47,1.37,1.43,+0.20,16.26,160000,7,227600,0,0,0,0,0,0,120000,40000,80000,80000
20200312,04506P,旺宏元大94售06,0.45,0.73,0.45,0.67,0.00,0.00,140000,9,91930,0,0,0,0,0,0,70000,70000,0,0
20200312,045071,奇力新元大94購01,0.70,0.70,0.46,0.46,-0.39,-45.88,130000,3,86200,0,0,0,0,0,0,130000,0,130000,130000
20200312,04507P,台光電元大94售03,0.44,0.44,0.44,0.44,0.00,0.00,10000,1,4400,0,0,0,0,0,0,10000,0,10000,10000
20200312,045086,玉晶光元大94購02,0.22,0.22,0.22,0.22,-0.29,-56.86,57000,1,12540,0,0,0,0,0,0,57000,0,57000,57000
20200312,045087,玉晶光元大95購01,0.68,0.71,0.65,0.65,-0.52,-44.44,60000,6,40600,0,0,0,0,0,0,0,60000,-60000,-60000
20200312,045088,康控元大94購02,,,,,0.00,0.00,0,0,0,0,0,0,0,0,0,0,0,0,0
20200312,045089,中磊元大94購01,,,,,0.00,0.00,0,0,0,0,0,0,0,0,0,0,0,0,0
20200312,04508P,臺股指元大94售03,0.80,0.80,0.80,0.80,0.00,0.00,95000,1,76000,0,0,0,0,0,0,95000,0,95000,95000
20200312,045095,緯穎元大94購02,,,,,0.00,0.00,0,0,0,0,0,0,0,0,0,0,0,0,0
20200312,04509P,臺股指元大94售04,,,,,0.00,0.00,0,0,0,0,0,0,0,0,0,0,0,0,0
20200312,045101,玉晶光中信94購01,0.02,0.02,0.02,0.02,0.00,0.00,45000,2,900,0,0,0,0,0,0,45000,0,45000,45000
20200312,045103,上海銀亞東94購01,,,,,0.00,0.00,0,0,0,0,0,0,0,0,0,0,0,0,0
20200312,045106,玉晶光群益95購01,,,,,0.00,0.00,0,0,0,0,0,0,0,0,0,0,0,0,0
20200312,04510P,臺股指元大94售05,,,,,0.00,0.00,0,0,0,0,0,0,0,0,0,0,0,0,0
20200312,045115,玉晶光永豐94購01,0.31,0.31,0.31,0.31,0.00,0.00,1000,1,310,0,0,0,0,0,0,1000,0,1000,1000
20200312,04511P,臺股指元大94售06,1.75,2.56,1.75,2.56,+1.56,156.0,26000,4,57680,0,0,0,0,0,0,26000,0,26000,26000
20200312,04512P,臺股指元大94售07,,,,,0.00,0.00,0,0,0,0,0,0,0,0,0,0,0,0,0
20200312,04513P,元石油中信94售01,,,,,0.00,0.00,0,0,0,0,0,0,0,0,0,0,0,0,0
20200312,04514P,元石油中信97售01,3.10,3.63,3.10,3.63,+0.92,33.95,8000,7,27430,0,0,0,0,0,0,0,0,0,0
20200312,04515P,元油2X群益97售02,,,,,0.00,0.00,0,0,0,0,0,0,0,0,0,0,0,0,0
20200312,045161,玉晶光國泰94購03,0.58,0.58,0.36,0.36,-0.51,-58.62,40000,2,21000,0,0,0,0,0,0,40000,0,40000,40000
20200312,045162,玉晶光國泰94購04,,,,,0.00,0.00,0,0,0,0,0,0,0,0,0,0,0,0,0
20200312,04516P,台積電群益94售07,0.45,0.62,0.45,0.62,0.00,0.00,3000,2,1520,0,0,0,0,0,0,3000,0,3000,3000
20200312,045172,欣興兆豐94購01,0.40,0.40,0.22,0.22,0.00,0.00,24000,3,7880,0,0,0,0,0,0,0,24000,-24000,-24000
20200312,045173,A50正2國票95購01,,,,,0.00,0.00,0,0,0,0,0,0,0,0,0,0,0,0,0
20200312,04517P,宏達電群益95售01,1.32,1.75,1.32,1.75,+0.58,49.57,313000,15,439780,0,0,0,0,0,0,52000,261000,-209000,-209000
20200312,045185,致伸統一94購01,,,,,0.00,0.00,0,0,0,0,0,0,0,0,0,0,0,0,0
20200312,045189,大立光元富98購01,0.77,0.77,0.57,0.58,-0.48,-45.28,4286000,106,2840250,0,0,0,0,0,0,535000,3751000,-3216000,-3216000
20200312,04518P,高鐵群益95售01,1.67,1.82,1.66,1.82,+0.45,32.85,89000,7,150120,0,0,0,0,0,0,10000,69000,-59000,-59000
20200312,04519P,國泰金群益94售01,,,,,0.00,0.00,0,0,0,0,0,0,0,0,0,0,0,0,0
20200312,045208,力成國泰94購01,1.85,1.94,1.71,1.94,-0.91,-31.93,130000,9,236700,0,0,0,0,0,0,60000,70000,-10000,-10000
20200312,045209,T50反1富邦94購01,,,,,0.00,0.00,0,0,0,0,0,0,0,0,0,0,0,0,0
20200312,04520P,欣興群益94售02,1.63,2.24,1.63,2.24,+1.15,105.5,65000,3,134700,0,0,0,0,0,0,45000,20000,25000,25000
20200312,045213,A50正2元大95購01,0.25,0.25,0.18,0.21,-0.08,-27.59,647000,12,140570,0,0,0,0,0,0,322000,325000,-3000,-3000
20200312,04521P,元油2X日盛94售02,6.70,6.75,6.70,6.70,0.00,0.00,1153000,12,7730100,0,0,0,0,0,0,1153000,1113000,40000,40000
20200312,045220,漢唐元大94購01,,,,,0.00,0.00,0,0,0,0,0,0,0,0,0,0,0,0,0
20200312,04522P,卜蜂凱基94售02,,,,,0.00,0.00,0,0,0,0,0,0,0,0,0,0,0,0,0
20200312,045231,南電元大94購01,,,,,0.00,0.00,0,0,0,0,0,0,0,0,0,0,0,0,0
20200312,04523P,亞德客凱基94售02,,,,,0.00,0.00,0,0,0,0,0,0,0,0,0,0,0,0,0
20200312,04524P,台積電凱基94售13,,,,,0.00,0.00,0,0,0,0,0,0,0,0,0,0,0,0,0
20200312,045250,華通凱基94購01,6.75,6.75,6.75,6.75,-1.65,-19.64,6000,1,40500,0,0,0,0,0,0,6000,0,6000,6000
20200312,04525P,台積電凱基94售14,,,,,0.00,0.00,0,0,0,0,0,0,0,0,0,0,0,0,0
20200312,045265,和鑫凱基94購01,,,,,0.00,0.00,0,0,0,0,0,0,0,0,0,0,0,0,0
20200312,04526P,美律凱基94售03,0.73,0.80,0.73,0.80,0.00,0.00,11000,2,8100,0,0,0,0,0,0,0,11000,-11000,-11000
20200312,045272,元油2X統一94購01,,,,,0.00,0.00,0,0,0,0,0,0,0,0,0,0,0,0,0
20200312,04527P,大立光凱基94售04,,,,,0.00,0.00,0,0,0,0,0,0,0,0,0,0,0,0,0
20200312,045280,儒鴻富邦94購01,,,,,0.00,0.00,0,0,0,0,0,0,0,0,0,0,0,0,0
20200312,045287,元油2X元大95購01,0.01,0.01,0.01,0.01,0.00,0.00,23000,5,230,0,0,0,0,0,0,0,0,0,0
20200312,045288,元油2X元大95購02,,,,,0.00,0.00,0,0,0,0,0,0,0,0,0,0,0,0,0
20200312,04528P,智原凱基94售01,,,,,0.00,0.00,0,0,0,0,0,0,0,0,0,0,0,0,0
20200312,045293,鴻海元大94購01,0.42,0.42,0.22,0.22,-0.44,-66.67,816000,9,201120,0,0,0,0,0,0,660000,156000,504000,504000
20200312,045298,旺宏元大94購01,1.03,1.03,0.71,0.71,-0.66,-48.18,108000,2,95240,0,0,0,0,0,0,50000,58000,-8000,-8000
20200312,04529P,正文凱基94售04,0.85,0.85,0.85,0.85,+0.15,21.43,10000,1,8500,0,0,0,0,0,0,0,10000,-10000,-10000
20200312,04530P,上海銀凱基94售03,,,,,0.00,0.00,0,0,0,0,0,0,0,0,0,0,0,0,0
20200312,045311,GIS元大94購01,,,,,0.00,0.00,0,0,0,0,0,0,0,0,0,0,0,0,0
20200312,04531P,台郡凱基94售02,,,,,0.00,0.00,0,0,0,0,0,0,0,0,0,0,0,0,0
20200312,045325,元油2X永豐94購01,,,,,0.00,0.00,0,0,0,0,0,0,0,0,0,0,0,0,0
20200312,04532P,臺股指凱基94售04,1.46,1.70,1.46,1.70,+1.09,178.69,40000,4,61000,0,0,0,0,0,0,40000,40000,0,0
20200312,045331,旺宏群益94購01,0.64,0.64,0.44,0.44,-0.32,-42.11,27000,5,16450,0,0,0,0,0,0,22000,5000,17000,17000
20200312,045337,滬深2X凱基95購01,,,,,0.00,0.00,0,0,0,0,0,0,0,0,0,0,0,0,0
20200312,04533P,臺股指凱基94售05,0.91,1.41,0.91,1.30,+1.00,333.33,1240000,116,1656800,0,0,0,0,0,0,1240000,1240000,0,0
20200312,04534P,臻鼎元富94售03,0.29,0.61,0.29,0.59,+0.33,126.92,679000,7,392390,0,0,0,0,0,0,679000,0,679000,679000
20200312,04535P,華新統一94售01,2.67,2.70,2.67,2.70,0.00,0.00,20000,2,53700,0,0,0,0,0,0,0,20000,-20000,-20000
20200312,04536P,長榮航統一94售01,2.10,2.10,2.10,2.10,+0.24,12.9,3000,1,6300,0,0,0,0,0,0,3000,0,3000,3000
20200312,045371,元石油元大95購01,,,,,0.00,0.00,0,0,0,0,0,0,0,0,0,0,0,0,0
20200312,04537P,新光金統一94售01,0.62,0.65,0.62,0.65,0.00,0.00,100000,2,63500,0,0,0,0,0,0,0,100000,-100000,-100000
20200312,04538P,TPK台新94售01,,,,,0.00,0.00,0,0,0,0,0,0,0,0,0,0,0,0,0
20200312,045396,群創國泰94購01,0.30,0.30,0.30,0.30,0.00,0.00,50000,4,15000,0,0,0,0,0,0,0,50000,-50000,-50000
20200312,04539P,力山永豐94售02,,,,,0.00,0.00,0,0,0,0,0,0,0,0,0,0,0,0,0
20200312,04540P,聯詠永豐94售02,,,,,0.00,0.00,0,0,0,0,0,0,0,0,0,0,0,0,0
20200312,045410,華邦電群益94購01,,,,,0.00,0.00,0,0,0,0,0,0,0,0,0,0,0,0,0
20200312,045414,康控群益94購02,,,,,0.00,0.00,0,0,0,0,0,0,0,0,0,0,0,0,0
20200312,04541P,智易永豐94售03,1.45,1.45,1.45,1.45,0.00,0.00,10000,1,14500,0,0,0,0,0,0,0,10000,-10000,-10000
20200312,045428,彩晶凱基94購01,0.41,0.41,0.26,0.26,-0.34,-56.67,15000,3,4320,0,0,0,0,0,0,0,15000,-15000,-15000
20200312,04542P,致伸永豐94售01,,,,,0.00,0.00,0,0,0,0,0,0,0,0,0,0,0,0,0
20200312,045435,鴻海統一94購01,1.03,1.03,0.64,0.64,-0.76,-54.29,101000,5,82710,0,0,0,0,0,0,56000,45000,11000,11000
20200312,045437,大立光統一94購02,0.68,0.68,0.66,0.66,-1.06,-61.63,30000,3,20200,0,0,0,0,0,0,0,30000,-30000,-30000
20200312,045438,台郡統一94購01,1.20,1.20,1.20,1.20,0.00,0.00,10000,1,12000,0,0,0,0,0,0,10000,0,10000,10000
20200312,04543P,鴻海富邦95售03,0.42,0.42,0.42,0.42,0.00,0.00,10000,1,4200,0,0,0,0,0,0,10000,0,10000,10000
20200312,045443,群創元富98購01,0.72,0.72,0.72,0.72,-0.40,-35.71,2000,1,1440,0,0,0,0,0,0,2000,0,2000,2000
20200312,045444,群創元富98購02,0.90,0.90,0.82,0.82,-0.39,-32.23,191000,20,164440,0,0,0,0,0,0,0,191000,-191000,-191000
20200312,045446,鴻海國泰94購01,0.36,0.36,0.24,0.24,-0.35,-59.32,130000,9,33150,0,0,0,0,0,0,0,130000,-130000,-130000
20200312,045447,鴻海國泰94購02,,,,,0.00,0.00,0,0,0,0,0,0,0,0,0,0,0,0,0
20200312,045449,嘉聯益國泰94購01,0.58,0.58,0.58,0.58,-0.41,-41.41,15000,1,8700,0,0,0,0,0,0,0,15000,-15000,-15000
20200312,04544P,欣興富邦96售02,,,,,0.00,0.00,0,0,0,0,0,0,0,0,0,0,0,0,0
20200312,04545P,國巨元大94售05,0.01,0.01,0.01,0.01,0.00,0.00,10000,1,100,0,0,0,0,0,0,0,0,0,0
20200312,045468,健策元大94購01,,,,,0.00,0.00,0,0,0,0,0,0,0,0,0,0,0,0,0
20200312,04546P,台積電元大94售09,,,,,0.00,0.00,0,0,0,0,0,0,0,0,0,0,0,0,0
20200312,045470,康控元大94購03,,,,,0.00,0.00,0,0,0,0,0,0,0,0,0,0,0,0,0
20200312,045479,T50反1中信95購01,0.26,0.43,0.26,0.43,+0.23,115.0,411000,26,142850,0,0,0,0,0,0,200000,146000,54000,54000
20200312,04547P,高鐵元大94售01,1.93,2.32,1.93,2.32,+0.54,30.34,58000,8,128670,0,0,0,0,0,0,12000,40000,-28000,-28000
20200312,045480,滬深2X中信94購01,,,,,0.00,0.00,0,0,0,0,0,0,0,0,0,0,0,0,0
20200312,045484,聯電亞東94購01,,,,,0.00,0.00,0,0,0,0,0,0,0,0,0,0,0,0,0
20200312,04548P,大立光元大94售14,2.13,2.18,2.13,2.18,0.00,0.00,96000,2,206780,0,0,0,0,0,0,0,96000,-96000,-96000
20200312,04549P,茂林元大94售02,0.18,0.32,0.18,0.32,+0.17,113.33,1050000,15,249360,0,0,0,0,0,0,190000,860000,-670000,-670000
20200312,045504,群創凱基94購01,0.48,0.48,0.37,0.37,-0.35,-48.61,142000,4,55280,0,0,0,0,0,0,65000,77000,-12000,-12000
20200312,04550P,超眾元大94售01,1.40,1.40,1.40,1.40,0.00,0.00,89000,1,124600,0,0,0,0,0,0,0,89000,-89000,-89000
20200312,045516,聯茂統一94購01,0.26,0.26,0.15,0.15,-0.28,-65.12,30000,3,6200,0,0,0,0,0,0,0,30000,-30000,-30000
20200312,045517,元油2X元富98購01,0.04,0.05,0.03,0.04,-0.01,-20.0,850000,14,32600,0,0,0,0,0,0,0,0,0,0
20200312,04551P,台表科元大94售02,0.31,0.35,0.31,0.35,0.00,0.00,15000,3,4900,0,0,0,0,0,0,15000,0,15000,15000
20200312,045522,滬深2X永豐94購01,,,,,0.00,0.00,0,0,0,0,0,0,0,0,0,0,0,0,0
20200312,04552P,南電元大94售06,0.76,0.76,0.76,0.76,0.00,0.00,100000,1,76000,0,0,0,0,0,0,100000,0,100000,100000
20200312,045534,深中小群益94購01,,,,,0.00,0.00,0,0,0,0,0,0,0,0,0,0,0,0,0
20200312,045535,A50正2群益94購01,0.09,0.09,0.09,0.09,0.00,0.00,50000,1,4500,0,0,0,0,0,0,0,50000,-50000,-50000
20200312,045537,華新群益94購01,0.06,0.06,0.06,0.06,-0.12,-66.67,9000,1,540,0,0,0,0,0,0,9000,9000,0,0
20200312,04553P,S&P正2中信95售01,1.10,1.59,1.10,1.46,+0.63,75.9,575000,28,742600,0,0,0,0,0,0,434000,141000,293000,293000
20200312,045543,百和群益94購01,,,,,0.00,0.00,0,0,0,0,0,0,0,0,0,0,0,0,0
20200312,045547,滬深2X國票95購01,,,,,0.00,0.00,0,0,0,0,0,0,0,0,0,0,0,0,0
20200312,04554P,可成中信94售01,1.47,1.70,1.45,1.70,+0.50,41.67,120000,12,190200,0,0,0,0,0,0,0,120000,-120000,-120000
20200312,04555P,元油2X群益95售01,7.90,7.90,7.85,7.85,+1.15,17.16,570000,6,4479500,0,0,0,0,0,0,570000,570000,0,0
20200312,045568,上証2X元大95購01,,,,,0.00,0.00,0,0,0,0,0,0,0,0,0,0,0,0,0
20200312,04556P,大成鋼群益94售02,1.02,1.02,1.02,1.02,0.00,0.00,11000,1,11220,0,0,0,0,0,0,0,11000,-11000,-11000
20200312,045571,元油2X元大95購04,,,,,0.00,0.00,0,0,0,0,0,0,0,0,0,0,0,0,0
20200312,045572,元油2X元大98購01,0.02,0.04,0.01,0.01,-0.02,-66.67,2009000,13,48140,0,0,0,0,0,0,0,279000,-279000,-279000
20200312,04557P,茂林群益94售03,0.24,0.44,0.24,0.44,+0.22,100.0,10000,8,3830,0,0,0,0,0,0,10000,0,10000,10000
20200312,04558P,瑞昱日盛94售01,0.45,0.48,0.45,0.48,0.00,0.00,20000,2,9300,0,0,0,0,0,0,10000,10000,0,0
20200312,045598,上証2X中信94購02,,,,,0.00,0.00,0,0,0,0,0,0,0,0,0,0,0,0,0
20200312,04559P,華通凱基94售03,0.51,0.86,0.50,0.86,+0.45,109.76,196000,5,150920,0,0,0,0,0,0,145000,51000,94000,94000
20200312,045600,道瓊指國票95購01,0.02,0.02,0.01,0.02,0.00,0.00,893000,10,17080,0,0,0,0,0,0,78000,0,78000,78000
20200312,045608,鴻海群益93購02,,,,,0.00,0.00,0,0,0,0,0,0,0,0,0,0,0,0,0
20200312,045609,國巨群益93購02,,,,,0.00,0.00,0,0,0,0,0,0,0,0,0,0,0,0,0
20200312,04560P,台積電凱基94售16,,,,,0.00,0.00,0,0,0,0,0,0,0,0,0,0,0,0,0
20200312,045610,大立光群益93購04,,,,,0.00,0.00,0,0,0,0,0,0,0,0,0,0,0,0,0
20200312,045618,元油2X永豐98購01,0.04,0.04,0.04,0.04,-0.01,-20.0,45000,2,1800,0,0,0,0,0,0,0,0,0,0
20200312,04561P,台積電凱基94售17,,,,,0.00,0.00,0,0,0,0,0,0,0,0,0,0,0,0,0
20200312,045626,上銀凱基93購05,,,,,0.00,0.00,0,0,0,0,0,0,0,0,0,0,0,0,0
20200312,045627,聯電凱基93購03,,,,,0.00,0.00,0,0,0,0,0,0,0,0,0,0,0,0,0
20200312,04562P,南亞科凱基94售02,,,,,0.00,0.00,0,0,0,0,0,0,0,0,0,0,0,0,0
20200312,045630,技嘉凱基93購02,0.35,0.35,0.33,0.33,-0.29,-46.77,3000,3,1010,0,0,0,0,0,0,3000,0,3000,3000
20200312,045631,台光電凱基93購06,,,,,0.00,0.00,0,0,0,0,0,0,0,0,0,0,0,0,0
20200312,045632,正崴凱基93購01,,,,,0.00,0.00,0,0,0,0,0,0,0,0,0,0,0,0,0
20200312,045634,友達凱基93購02,,,,,0.00,0.00,0,0,0,0,0,0,0,0,0,0,0,0,0
20200312,045635,建準凱基93購02,,,,,0.00,0.00,0,0,0,0,0,0,0,0,0,0,0,0,0
20200312,045638,強茂凱基93購02,,,,,0.00,0.00,0,0,0,0,0,0,0,0,0,0,0,0,0
20200312,045639,冠德凱基93購01,,,,,0.00,0.00,0,0,0,0,0,0,0,0,0,0,0,0,0
20200312,04563P,可成凱基94售05,0.93,1.18,0.93,1.18,0.00,0.00,102000,3,97260,0,0,0,0,0,0,0,102000,-102000,-102000
20200312,045640,嘉晶凱基93購01,,,,,0.00,0.00,0,0,0,0,0,0,0,0,0,0,0,0,0
20200312,045643,臻鼎凱基93購01,,,,,0.00,0.00,0,0,0,0,0,0,0,0,0,0,0,0,0
20200312,045645,祥碩凱基93購03,,,,,0.00,0.00,0,0,0,0,0,0,0,0,0,0,0,0,0
20200312,045646,瑞儀凱基93購05,,,,,0.00,0.00,0,0,0,0,0,0,0,0,0,0,0,0,0
20200312,045648,聯茂凱基93購04,,,,,0.00,0.00,0,0,0,0,0,0,0,0,0,0,0,0,0
20200312,045649,超眾凱基93購04,,,,,0.00,0.00,0,0,0,0,0,0,0,0,0,0,0,0,0
20200312,04564P,大立光凱基94售06,,,,,0.00,0.00,0,0,0,0,0,0,0,0,0,0,0,0,0
20200312,045650,超眾凱基93購05,,,,,0.00,0.00,0,0,0,0,0,0,0,0,0,0,0,0,0
20200312,045651,力成凱基93購01,,,,,0.00,0.00,0,0,0,0,0,0,0,0,0,0,0,0,0
20200312,045653,南茂凱基93購02,,,,,0.00,0.00,0,0,0,0,0,0,0,0,0,0,0,0,0
20200312,045654,志超凱基93購01,,,,,0.00,0.00,0,0,0,0,0,0,0,0,0,0,0,0,0
20200312,045656,滬深2X永昌93購03,,,,,0.00,0.00,0,0,0,0,0,0,0,0,0,0,0,0,0
20200312,045657,T50反1國泰94購01,0.15,1.10,0.15,0.69,0.00,0.00,893000,56,173440,0,0,0,0,0,0,506000,538000,-32000,-32000
20200312,045658,儒鴻國泰93購01,,,,,0.00,0.00,0,0,0,0,0,0,0,0,0,0,0,0,0
20200312,045659,華新科國泰94購01,,,,,0.00,0.00,0,0,0,0,0,0,0,0,0,0,0,0,0
20200312,04565P,聯詠凱基94售01,0.64,0.73,0.64,0.71,0.00,0.00,146000,11,104380,0,0,0,0,0,0,6000,140000,-134000,-134000
20200312,045660,欣興富邦93購03,,,,,0.00,0.00,0,0,0,0,0,0,0,0,0,0,0,0,0
20200312,045661,T50反1統一93購02,0.03,0.03,0.03,0.03,0.00,0.00,200000,1,6000,0,0,0,0,0,0,200000,0,200000,200000
20200312,045662,華邦電統一94購02,,,,,0.00,0.00,0,0,0,0,0,0,0,0,0,0,0,0,0
20200312,045663,元油2X元富94購01,0.01,0.01,0.01,0.01,0.00,0.00,139000,3,1390,0,0,0,0,0,0,139000,0,139000,139000
20200312,045664,元油2X元富96購01,,,,,0.00,0.00,0,0,0,0,0,0,0,0,0,0,0,0,0
20200312,045667,台積電元富93購01,2.24,2.24,2.24,2.24,0.00,0.00,6000,1,13440,0,0,0,0,0,0,6000,0,6000,6000
20200312,045669,華通元大93購02,,,,,0.00,0.00,0,0,0,0,0,0,0,0,0,0,0,0,0
20200312,04566P,GIS凱基94售04,0.88,0.98,0.88,0.98,0.00,0.00,110000,3,106800,0,0,0,0,0,0,0,110000,-110000,-110000
20200312,045675,友達元大93購01,,,,,0.00,0.00,0,0,0,0,0,0,0,0,0,0,0,0,0
20200312,045678,華新科元大95購01,1.43,1.43,1.41,1.41,-0.65,-31.55,60000,6,84800,0,0,0,0,0,0,0,60000,-60000,-60000
20200312,045679,欣興元大94購01,,,,,0.00,0.00,0,0,0,0,0,0,0,0,0,0,0,0,0
20200312,04567P,臺股指凱基95售01,0.40,0.70,0.40,0.61,0.00,0.00,77000,7,42920,0,0,0,0,0,0,30000,47000,-17000,-17000
20200312,045683,泰鼎元大93購03,,,,,0.00,0.00,0,0,0,0,0,0,0,0,0,0,0,0,0
20200312,045685,康控元大95購01,0.25,0.25,0.22,0.22,-0.22,-50.0,689000,6,159580,0,0,0,0,0,0,689000,0,689000,689000
20200312,04568P,瑞昱兆豐94售02,0.50,0.64,0.50,0.64,0.00,0.00,1210000,13,690200,0,0,0,0,0,0,1210000,0,1210000,1210000
20200312,045694,智邦兆豐93購05,,,,,0.00,0.00,0,0,0,0,0,0,0,0,0,0,0,0,0
20200312,045695,英業達兆豐93購01,,,,,0.00,0.00,0,0,0,0,0,0,0,0,0,0,0,0,0
20200312,045698,致伸兆豐93購01,,,,,0.00,0.00,0,0,0,0,0,0,0,0,0,0,0,0,0
20200312,04569P,聯詠兆豐94售01,,,,,0.00,0.00,0,0,0,0,0,0,0,0,0,0,0,0,0
20200312,045700,道瓊指中信94購01,0.15,0.15,0.07,0.10,-0.05,-33.33,272000,21,25700,0,0,0,0,0,0,0,0,0,0
20200312,045708,元油2X凱基93購02,,,,,0.00,0.00,0,0,0,0,0,0,0,0,0,0,0,0,0
20200312,04570P,台積電國票94售05,,,,,0.00,0.00,0,0,0,0,0,0,0,0,0,0,0,0,0
20200312,045713,台達電凱基93購02,,,,,0.00,0.00,0,0,0,0,0,0,0,0,0,0,0,0,0
20200312,04571P,華新科國泰95售03,0.61,0.88,0.61,0.87,+0.31,55.36,821000,17,581780,0,0,0,0,0,0,585000,266000,319000,319000
20200312,045720,台光電凱基93購07,,,,,0.00,0.00,0,0,0,0,0,0,0,0,0,0,0,0,0
20200312,045727,宏碁亞東93購01,,,,,0.00,0.00,0,0,0,0,0,0,0,0,0,0,0,0,0
20200312,045728,大立光亞東93購01,,,,,0.00,0.00,0,0,0,0,0,0,0,0,0,0,0,0,0
20200312,045729,日月光亞東93購01,,,,,0.00,0.00,0,0,0,0,0,0,0,0,0,0,0,0,0
20200312,04572P,T50反1統一94售06,,,,,0.00,0.00,0,0,0,0,0,0,0,0,0,0,0,0,0
20200312,045732,儒鴻國票93購01,,,,,0.00,0.00,0,0,0,0,0,0,0,0,0,0,0,0,0
20200312,045733,瑞昱國票93購01,,,,,0.00,0.00,0,0,0,0,0,0,0,0,0,0,0,0,0
20200312,045734,全新國票93購01,,,,,0.00,0.00,0,0,0,0,0,0,0,0,0,0,0,0,0
20200312,045736,台積電群益94購01,4.73,4.73,2.88,4.10,-2.95,-41.84,45000,6,194160,0,0,0,0,0,0,10000,35000,-25000,-25000
20200312,045737,友達群益94購01,,,,,0.00,0.00,0,0,0,0,0,0,0,0,0,0,0,0,0
20200312,04573P,聯電統一94售02,,,,,0.00,0.00,0,0,0,0,0,0,0,0,0,0,0,0,0
20200312,045743,台郡群益93購01,,,,,0.00,0.00,0,0,0,0,0,0,0,0,0,0,0,0,0
20200312,045749,智邦富邦93購01,,,,,0.00,0.00,0,0,0,0,0,0,0,0,0,0,0,0,0
20200312,04574P,台達電統一94售05,0.69,0.94,0.69,0.94,+0.39,70.91,18000,13,15060,0,0,0,0,0,0,18000,0,18000,18000
20200312,045750,鈺齊富邦94購01,,,,,0.00,0.00,0,0,0,0,0,0,0,0,0,0,0,0,0
20200312,045751,智邦國泰93購01,,,,,0.00,0.00,0,0,0,0,0,0,0,0,0,0,0,0,0
20200312,045752,全新國泰93購01,,,,,0.00,0.00,0,0,0,0,0,0,0,0,0,0,0,0,0
20200312,045753,大立光國泰94購02,0.64,0.64,0.43,0.45,-0.78,-63.41,488000,43,239520,0,0,0,0,0,0,275000,488000,-213000,-213000
20200312,045754,大立光國泰94購03,0.91,0.92,0.66,0.66,0.00,0.00,78000,8,63080,0,0,0,0,0,0,0,78000,-78000,-78000
20200312,045755,嘉澤國泰93購01,,,,,0.00,0.00,0,0,0,0,0,0,0,0,0,0,0,0,0
20200312,045756,智伸科國泰93購01,,,,,0.00,0.00,0,0,0,0,0,0,0,0,0,0,0,0,0
20200312,045757,台表科國泰93購03,,,,,0.00,0.00,0,0,0,0,0,0,0,0,0,0,0,0,0
20200312,045758,易華電國泰94購01,,,,,0.00,0.00,0,0,0,0,0,0,0,0,0,0,0,0,0
20200312,045759,T50反1統一94購02,0.51,0.51,0.51,0.51,0.00,0.00,15000,1,7650,0,0,0,0,0,0,15000,0,15000,15000
20200312,04575P,新日興統一94售02,0.57,0.72,0.57,0.72,+0.19,35.85,165000,6,105460,0,0,0,0,0,0,98000,67000,31000,31000
20200312,045760,鴻海統一93購02,,,,,0.00,0.00,0,0,0,0,0,0,0,0,0,0,0,0,0
20200312,045763,南亞科統一93購01,,,,,0.00,0.00,0,0,0,0,0,0,0,0,0,0,0,0,0
20200312,045764,智易統一94購01,,,,,0.00,0.00,0,0,0,0,0,0,0,0,0,0,0,0,0
20200312,045767,大立光元富95購01,2.15,2.15,1.73,1.82,0.00,0.00,83000,10,167620,0,0,0,0,0,0,1000,82000,-81000,-81000
20200312,045768,大立光元富95購02,1.78,1.78,1.19,1.19,-2.12,-64.05,817000,17,1163120,0,0,0,0,0,0,116000,702000,-586000,-586000
20200312,04576P,上海銀統一94售04,,,,,0.00,0.00,0,0,0,0,0,0,0,0,0,0,0,0,0
20200312,045770,華通元大93購03,,,,,0.00,0.00,0,0,0,0,0,0,0,0,0,0,0,0,0
20200312,045771,國巨元大93購08,,,,,0.00,0.00,0,0,0,0,0,0,0,0,0,0,0,0,0
20200312,045772,台光電元大93購01,,,,,0.00,0.00,0,0,0,0,0,0,0,0,0,0,0,0,0
20200312,045778,大立光元大93購10,,,,,0.00,0.00,0,0,0,0,0,0,0,0,0,0,0,0,0
20200312,045779,大立光元大93購11,,,,,0.00,0.00,0,0,0,0,0,0,0,0,0,0,0,0,0
20200312,04577P,康友元富94售02,0.38,0.49,0.38,0.49,0.00,0.00,20000,2,8700,0,0,0,0,0,0,0,20000,-20000,-20000
20200312,045780,奇鋐元大94購01,,,,,0.00,0.00,0,0,0,0,0,0,0,0,0,0,0,0,0
20200312,045782,欣興元大93購04,,,,,0.00,0.00,0,0,0,0,0,0,0,0,0,0,0,0,0
20200312,045785,揚明光元大93購04,,,,,0.00,0.00,0,0,0,0,0,0,0,0,0,0,0,0,0
20200312,045787,TPK元大93購04,,,,,0.00,0.00,0,0,0,0,0,0,0,0,0,0,0,0,0
20200312,045788,南寶元大93購01,,,,,0.00,0.00,0,0,0,0,0,0,0,0,0,0,0,0,0
20200312,04578P,微星富邦96售01,0.56,0.61,0.56,0.59,+0.06,11.32,27000,4,16070,0,0,0,0,0,0,17000,10000,7000,7000
20200312,045791,台表科元大93購04,,,,,0.00,0.00,0,0,0,0,0,0,0,0,0,0,0,0,0
20200312,045793,台積電兆豐93購03,,,,,0.00,0.00,0,0,0,0,0,0,0,0,0,0,0,0,0
20200312,045794,奇力新兆豐93購01,,,,,0.00,0.00,0,0,0,0,0,0,0,0,0,0,0,0,0
20200312,045795,瀚宇博兆豐94購01,,,,,0.00,0.00,0,0,0,0,0,0,0,0,0,0,0,0,0
20200312,045796,廣達中信93購01,,,,,0.00,0.00,0,0,0,0,0,0,0,0,0,0,0,0,0
20200312,045797,健策中信93購01,,,,,0.00,0.00,0,0,0,0,0,0,0,0,0,0,0,0,0
20200312,045798,華邦電亞東93購02,,,,,0.00,0.00,0,0,0,0,0,0,0,0,0,0,0,0,0
20200312,045799,微星亞東93購01,,,,,0.00,0.00,0,0,0,0,0,0,0,0,0,0,0,0,0
20200312,04579P,聯茂台新94售01,,,,,0.00,0.00,0,0,0,0,0,0,0,0,0,0,0,0,0
20200312,045800,漢唐亞東93購01,,,,,0.00,0.00,0,0,0,0,0,0,0,0,0,0,0,0,0
20200312,045803,旺宏國票93購01,,,,,0.00,0.00,0,0,0,0,0,0,0,0,0,0,0,0,0
20200312,045807,上緯控國票93購01,,,,,0.00,0.00,0,0,0,0,0,0,0,0,0,0,0,0,0
20200312,04580P,楠梓電康和94售02,,,,,0.00,0.00,0,0,0,0,0,0,0,0,0,0,0,0,0
20200312,045814,可成麥證93購01,,,,,0.00,0.00,0,0,0,0,0,0,0,0,0,0,0,0,0
20200312,045817,滬深2X凱基95購02,,,,,0.00,0.00,0,0,0,0,0,0,0,0,0,0,0,0,0
20200312,045818,鴻海凱基93購10,0.08,0.08,0.08,0.08,-0.34,-80.95,6000,1,480,0,0,0,0,0,0,6000,0,6000,6000
20200312,04581P,楠梓電康和94售03,1.06,1.06,1.06,1.06,+0.01,0.95,86000,1,91160,0,0,0,0,0,0,86000,0,86000,86000
20200312,045822,TPK凱基93購03,,,,,0.00,0.00,0,0,0,0,0,0,0,0,0,0,0,0,0
20200312,045824,嘉聯益凱基93購02,,,,,0.00,0.00,0,0,0,0,0,0,0,0,0,0,0,0,0
20200312,045825,力成凱基93購02,2.45,2.45,1.96,1.96,-2.84,-59.17,80000,4,162100,0,0,0,0,0,0,50000,30000,20000,20000
20200312,045829,滬深2X群益95購02,,,,,0.00,0.00,0,0,0,0,0,0,0,0,0,0,0,0,0
20200312,04582P,燿華康和94售01,,,,,0.00,0.00,0,0,0,0,0,0,0,0,0,0,0,0,0
20200312,045836,群創群益98購01,0.83,0.88,0.79,0.79,0.00,0.00,53000,5,43630,0,0,0,0,0,0,0,53000,-53000,-53000
20200312,045837,群創群益98購02,0.66,0.66,0.50,0.53,-0.39,-42.39,74000,8,40750,0,0,0,0,0,0,13000,74000,-61000,-61000
20200312,045838,揚明光群益93購01,,,,,0.00,0.00,0,0,0,0,0,0,0,0,0,0,0,0,0
20200312,04583P,滬深2X永豐94售06,,,,,0.00,0.00,0,0,0,0,0,0,0,0,0,0,0,0,0
20200312,045842,T50反1台新98購01,0.29,0.46,0.26,0.45,+0.22,95.65,2304000,42,723310,0,0,0,0,0,0,1855000,2003000,-148000,-148000
20200312,04584P,楠梓電永豐94售01,0.96,1.34,0.96,1.34,+0.39,41.05,67000,8,79530,0,0,0,0,0,0,47000,20000,27000,27000
20200312,045854,貿聯富邦93購01,,,,,0.00,0.00,0,0,0,0,0,0,0,0,0,0,0,0,0
20200312,045855,緯穎富邦93購01,,,,,0.00,0.00,0,0,0,0,0,0,0,0,0,0,0,0,0
20200312,045856,南亞科國泰94購01,0.15,0.15,0.15,0.15,-0.36,-70.59,10000,1,1500,0,0,0,0,0,0,0,10000,-10000,-10000
20200312,045857,友達國泰93購02,,,,,0.00,0.00,0,0,0,0,0,0,0,0,0,0,0,0,0
20200312,045858,元油2X統一94購02,,,,,0.00,0.00,0,0,0,0,0,0,0,0,0,0,0,0,0
20200312,04585P,楠梓電永豐94售02,2.23,2.50,2.23,2.50,0.00,0.00,23000,2,54800,0,0,0,0,0,0,0,23000,-23000,-23000
20200312,045860,鴻海統一93購03,,,,,0.00,0.00,0,0,0,0,0,0,0,0,0,0,0,0,0
20200312,045861,智邦統一93購02,,,,,0.00,0.00,0,0,0,0,0,0,0,0,0,0,0,0,0
20200312,045862,大立光統一93購02,,,,,0.00,0.00,0,0,0,0,0,0,0,0,0,0,0,0,0
20200312,045864,致伸統一93購01,,,,,0.00,0.00,0,0,0,0,0,0,0,0,0,0,0,0,0
20200312,045865,緯穎統一93購02,,,,,0.00,0.00,0,0,0,0,0,0,0,0,0,0,0,0,0
20200312,045866,南茂統一94購01,0.53,0.53,0.40,0.40,-0.34,-45.95,102000,7,46360,0,0,0,0,0,0,102000,0,102000,102000
20200312,045867,臺股指統一93購03,,,,,0.00,0.00,0,0,0,0,0,0,0,0,0,0,0,0,0
20200312,045868,臺股指統一93購04,1.64,1.64,1.64,1.64,-1.53,-48.26,10000,1,16400,0,0,0,0,0,0,10000,10000,0,0
20200312,045869,滬深2X元富95購01,,,,,0.00,0.00,0,0,0,0,0,0,0,0,0,0,0,0,0
20200312,04586P,光罩永豐94售02,,,,,0.00,0.00,0,0,0,0,0,0,0,0,0,0,0,0,0
20200312,045870,元油2X元富96購02,,,,,0.00,0.00,0,0,0,0,0,0,0,0,0,0,0,0,0
20200312,045871,元油2X元富96購03,0.01,0.01,0.01,0.01,0.00,0.00,4000,1,40,0,0,0,0,0,0,4000,0,4000,4000
20200312,045872,元油2X元富98購03,0.04,0.05,0.03,0.04,-0.01,-20.0,5907000,102,215670,0,0,0,0,0,0,0,0,0,0
20200312,045873,元油2X元富98購04,0.04,0.05,0.03,0.05,0.00,0.00,2331000,39,89250,0,0,0,0,0,0,0,0,0,0
20200312,045877,友達元富95購01,0.91,0.91,0.82,0.82,-0.41,-33.33,45000,2,40050,0,0,0,0,0,0,35000,10000,25000,25000
20200312,04587P,聯發科永豐94售02,0.56,0.56,0.56,0.56,0.00,0.00,50000,1,28000,0,0,0,0,0,0,50000,50000,0,0
20200312,045882,滬深2X元大95購01,,,,,0.00,0.00,0,0,0,0,0,0,0,0,0,0,0,0,0
20200312,045883,元油2X元大95購07,0.04,0.04,0.04,0.04,0.00,0.00,100000,1,4000,0,0,0,0,0,0,0,100000,-100000,-100000
20200312,04588P,茂林永豐94售04,,,,,0.00,0.00,0,0,0,0,0,0,0,0,0,0,0,0,0
20200312,045892,和鑫元大93購03,,,,,0.00,0.00,0,0,0,0,0,0,0,0,0,0,0,0,0
20200312,045897,泰鼎元大93購04,,,,,0.00,0.00,0,0,0,0,0,0,0,0,0,0,0,0,0
20200312,045898,康控元大93購04,,,,,0.00,0.00,0,0,0,0,0,0,0,0,0,0,0,0,0
20200312,04589P,祥碩永豐94售01,,,,,0.00,0.00,0,0,0,0,0,0,0,0,0,0,0,0,0
20200312,045906,鴻海中信94購01,0.97,0.97,0.68,0.73,-0.49,-40.16,59000,7,53620,0,0,0,0,0,0,22000,39000,-17000,-17000
20200312,045907,鴻海中信94購02,0.90,0.92,0.53,0.53,-0.64,-54.7,1730000,56,1213910,0,0,0,0,0,0,756000,977000,-221000,-221000
20200312,04590P,元石油元大97售01,4.24,4.24,4.20,4.20,+0.50,13.51,45000,5,190080,0,0,0,0,0,0,0,0,0,0
20200312,045914,超眾國票93購01,,,,,0.00,0.00,0,0,0,0,0,0,0,0,0,0,0,0,0
20200312,04591P,上銀元大94售01,0.39,0.56,0.39,0.51,0.00,0.00,1029000,4,494540,0,0,0,0,0,0,0,1029000,-1029000,-1029000
20200312,04592P,台積電元大94售10,0.51,0.85,0.51,0.57,+0.28,96.55,478000,20,272460,0,0,0,0,0,0,444000,379000,65000,65000
20200312,045931,緯穎永豐93購01,3.00,3.15,2.91,2.91,0.00,0.00,120000,12,364200,0,0,0,0,0,0,0,120000,-120000,-120000
20200312,045934,燿華群益93購01,,,,,0.00,0.00,0,0,0,0,0,0,0,0,0,0,0,0,0
20200312,045936,富邦金群益94購01,,,,,0.00,0.00,0,0,0,0,0,0,0,0,0,0,0,0,0
20200312,045937,臻鼎群益93購02,,,,,0.00,0.00,0,0,0,0,0,0,0,0,0,0,0,0,0
20200312,04593P,台積電元大94售11,0.31,0.35,0.31,0.35,+0.13,59.09,4000,2,1280,0,0,0,0,0,0,4000,0,4000,4000
20200312,045947,欣興兆豐93購04,,,,,0.00,0.00,0,0,0,0,0,0,0,0,0,0,0,0,0
20200312,04594P,緯穎元大94售04,,,,,0.00,0.00,0,0,0,0,0,0,0,0,0,0,0,0,0
20200312,045955,宏碁凱基93購01,,,,,0.00,0.00,0,0,0,0,0,0,0,0,0,0,0,0,0
20200312,045956,英業達凱基93購01,,,,,0.00,0.00,0,0,0,0,0,0,0,0,0,0,0,0,0
20200312,045957,技嘉凱基93購03,0.12,0.12,0.12,0.12,0.00,0.00,15000,1,1800,0,0,0,0,0,0,15000,0,15000,15000
20200312,045958,技嘉凱基93購04,,,,,0.00,0.00,0,0,0,0,0,0,0,0,0,0,0,0,0
20200312,04595P,臺股指元大94售13,1.91,2.55,1.91,2.55,0.00,0.00,70000,3,144400,0,0,0,0,0,0,50000,20000,30000,30000
20200312,045963,新光金凱基93購01,,,,,0.00,0.00,0,0,0,0,0,0,0,0,0,0,0,0,0
20200312,04596P,臺股指元大94售14,2.59,3.74,2.59,3.08,+1.16,60.42,91000,5,296090,0,0,0,0,0,0,0,91000,-91000,-91000
20200312,045974,傳奇凱基93購02,,,,,0.00,0.00,0,0,0,0,0,0,0,0,0,0,0,0,0
20200312,045975,祥碩凱基93購04,2.90,2.90,2.61,2.68,0.00,0.00,30000,3,81900,0,0,0,0,0,0,0,30000,-30000,-30000
20200312,045979,巨大凱基93購01,,,,,0.00,0.00,0,0,0,0,0,0,0,0,0,0,0,0,0
20200312,04597P,為升凱基94售02,4.61,5.30,4.61,5.30,+1.35,34.18,20000,2,99100,0,0,0,0,0,0,10000,10000,0,0
20200312,045980,百和凱基93購03,,,,,0.00,0.00,0,0,0,0,0,0,0,0,0,0,0,0,0
20200312,045984,亞光麥證93購02,,,,,0.00,0.00,0,0,0,0,0,0,0,0,0,0,0,0,0
20200312,045985,台達電永昌93購01,,,,,0.00,0.00,0,0,0,0,0,0,0,0,0,0,0,0,0
20200312,045986,南亞科永昌93購01,0.01,0.01,0.01,0.01,0.00,0.00,2000,1,20,0,0,0,0,0,0,2000,2000,0,0
20200312,045989,緯穎國泰93購03,,,,,0.00,0.00,0,0,0,0,0,0,0,0,0,0,0,0,0
20200312,04598P,光罩凱基94售03,1.32,1.54,1.32,1.36,+0.44,47.83,67000,7,98680,0,0,0,0,0,0,61000,21000,40000,40000
20200312,045990,元石油富邦93購02,,,,,0.00,0.00,0,0,0,0,0,0,0,0,0,0,0,0,0
20200312,045991,為升富邦95購01,,,,,0.00,0.00,0,0,0,0,0,0,0,0,0,0,0,0,0
20200312,045992,鴻海富邦94購01,0.96,0.96,0.72,0.72,0.00,0.00,63000,2,45840,0,0,0,0,0,0,61000,2000,59000,59000
20200312,045993,美律富邦93購01,,,,,0.00,0.00,0,0,0,0,0,0,0,0,0,0,0,0,0
20200312,045994,康控富邦94購01,0.15,0.15,0.15,0.15,-0.08,-34.78,340000,1,51000,0,0,0,0,0,0,340000,0,340000,340000
20200312,045995,台表科富邦93購01,,,,,0.00,0.00,0,0,0,0,0,0,0,0,0,0,0,0,0
20200312,045996,南電富邦94購01,,,,,0.00,0.00,0,0,0,0,0,0,0,0,0,0,0,0,0
20200312,04599P,南亞科凱基94售03,1.49,1.82,1.49,1.71,+0.57,50.0,42000,4,73070,0,0,0,0,0,0,32000,40000,-8000,-8000
20200312,046001,友達統一93購03,,,,,0.00,0.00,0,0,0,0,0,0,0,0,0,0,0,0,0
20200312,046002,美律統一93購01,,,,,0.00,0.00,0,0,0,0,0,0,0,0,0,0,0,0,0
20200312,046004,群創統一93購02,,,,,0.00,0.00,0,0,0,0,0,0,0,0,0,0,0,0,0
20200312,04600P,可成凱基94售07,3.58,4.07,3.58,4.07,+1.41,53.01,30000,3,116700,0,0,0,0,0,0,0,30000,-30000,-30000
20200312,046011,欣興元富95購01,0.18,0.20,0.18,0.20,-0.20,-50.0,14000,2,2660,0,0,0,0,0,0,0,14000,-14000,-14000
20200312,04601P,大立光凱基94售07,0.86,1.05,0.86,1.05,+0.50,90.91,109000,3,99950,0,0,0,0,0,0,9000,100000,-91000,-91000
20200312,046020,滬深2X元大95購02,0.25,0.25,0.25,0.25,0.00,0.00,140000,1,35000,0,0,0,0,0,0,140000,0,140000,140000
20200312,04602P,聯詠凱基94售02,0.58,0.70,0.58,0.70,0.00,0.00,30000,3,19500,0,0,0,0,0,0,0,30000,-30000,-30000
20200312,04603P,訊芯凱基94售03,1.37,1.59,1.37,1.55,+0.36,30.25,67000,9,98690,0,0,0,0,0,0,46000,36000,10000,10000
20200312,046046,世紀鋼元大93購03,,,,,0.00,0.00,0,0,0,0,0,0,0,0,0,0,0,0,0
20200312,046047,臺股指元大93購17,,,,,0.00,0.00,0,0,0,0,0,0,0,0,0,0,0,0,0
20200312,046048,臺股指元大93購18,0.53,0.53,0.53,0.53,0.00,0.00,10000,1,5300,0,0,0,0,0,0,0,10000,-10000,-10000
20200312,046049,臺股指元大93購19,,,,,0.00,0.00,0,0,0,0,0,0,0,0,0,0,0,0,0
20200312,04604P,華新科國票95售01,0.11,0.11,0.11,0.11,0.00,0.00,2000,1,220,0,0,0,0,0,0,2000,0,2000,2000
20200312,046050,臺股指元大93購20,,,,,0.00,0.00,0,0,0,0,0,0,0,0,0,0,0,0,0
20200312,046051,華通亞東93購01,,,,,0.00,0.00,0,0,0,0,0,0,0,0,0,0,0,0,0
20200312,046052,國巨中信93購01,,,,,0.00,0.00,0,0,0,0,0,0,0,0,0,0,0,0,0
20200312,046053,滬深2X群益94購01,0.22,0.22,0.20,0.20,0.00,0.00,20000,2,4200,0,0,0,0,0,0,0,20000,-20000,-20000
20200312,046054,冠德群益93購01,,,,,0.00,0.00,0,0,0,0,0,0,0,0,0,0,0,0,0
20200312,04605P,台積電兆豐94售03,0.38,0.54,0.38,0.44,+0.14,46.67,126000,14,61400,0,0,0,0,0,0,46000,80000,-34000,-34000
20200312,046061,中石化凱基98購01,,,,,0.00,0.00,0,0,0,0,0,0,0,0,0,0,0,0,0
20200312,046064,中工凱基94購01,0.39,0.40,0.39,0.40,-0.23,-36.51,50000,2,19590,0,0,0,0,0,0,50000,50000,0,0
20200312,046065,益航凱基93購02,,,,,0.00,0.00,0,0,0,0,0,0,0,0,0,0,0,0,0
20200312,046066,長榮航凱基94購01,0.22,0.22,0.22,0.22,-0.15,-40.54,10000,1,2200,0,0,0,0,0,0,10000,0,10000,10000
20200312,04606P,高股息中信96售01,0.96,0.96,0.96,0.96,0.00,0.00,4000,1,3840,0,0,0,0,0,0,0,4000,-4000,-4000
20200312,04607P,A50中信94售01,0.38,0.43,0.38,0.43,+0.13,43.33,121000,3,51230,0,0,0,0,0,0,121000,0,121000,121000
20200312,046087,亞德客兆豐93購01,,,,,0.00,0.00,0,0,0,0,0,0,0,0,0,0,0,0,0
20200312,04608P,晶相光永豐94售02,0.29,0.29,0.29,0.29,0.00,0.00,30000,1,8700,0,0,0,0,0,0,30000,0,30000,30000
20200312,04609P,健策永豐94售01,,,,,0.00,0.00,0,0,0,0,0,0,0,0,0,0,0,0,0
20200312,046108,A50正2元大95購02,0.25,0.28,0.24,0.28,-0.10,-26.32,150000,5,37800,0,0,0,0,0,0,0,150000,-150000,-150000
20200312,04610P,世紀鋼永豐94售03,0.50,0.55,0.49,0.49,+0.08,19.51,132000,12,69680,0,0,0,0,0,0,0,132000,-132000,-132000
20200312,046113,旺宏元大93購04,0.67,0.70,0.59,0.59,0.00,0.00,35000,7,23150,0,0,0,0,0,0,0,35000,-35000,-35000
20200312,04611P,元油2X群益98售02,6.40,6.85,6.40,6.85,+0.85,14.17,40000,5,264000,0,0,0,0,0,0,27000,10000,17000,17000
20200312,04612P,上銀群益94售01,0.53,0.53,0.53,0.53,0.00,0.00,6000,1,3180,0,0,0,0,0,0,6000,0,6000,6000
20200312,046134,致新國泰93購02,,,,,0.00,0.00,0,0,0,0,0,0,0,0,0,0,0,0,0
20200312,04613P,台積電群益94售10,,,,,0.00,0.00,0,0,0,0,0,0,0,0,0,0,0,0,0
20200312,046142,康舒統一93購01,,,,,0.00,0.00,0,0,0,0,0,0,0,0,0,0,0,0,0
20200312,046145,矽力元富95購01,,,,,0.00,0.00,0,0,0,0,0,0,0,0,0,0,0,0,0
20200312,046147,道瓊指中信96購02,0.08,0.10,0.06,0.08,-0.03,-27.27,2411000,62,188950,0,0,0,0,0,0,0,0,0,0
20200312,046148,友達中信94購01,0.68,0.68,0.68,0.68,-0.20,-22.73,10000,1,6800,0,0,0,0,0,0,10000,0,10000,10000
20200312,046149,宏達電國票93購01,,,,,0.00,0.00,0,0,0,0,0,0,0,0,0,0,0,0,0
20200312,04614P,光罩群益94售02,0.40,0.59,0.40,0.59,+0.29,96.67,225000,16,119450,0,0,0,0,0,0,95000,130000,-35000,-35000
20200312,046154,道瓊指群益94購01,0.01,0.01,0.01,0.01,0.00,0.00,100000,1,1000,0,0,0,0,0,0,0,0,0,0
20200312,046155,道瓊反群益94購01,0.68,0.69,0.60,0.60,+0.29,93.55,31000,5,21000,0,0,0,0,0,0,31000,0,31000,31000
20200312,046159,群創群益98購04,0.47,0.47,0.46,0.46,-0.24,-34.29,24000,3,11170,0,0,0,0,0,0,11000,13000,-2000,-2000
20200312,04615P,華新科群益94售03,0.47,0.74,0.47,0.74,+0.48,184.62,124000,3,64560,0,0,0,0,0,0,24000,100000,-76000,-76000
20200312,046161,易華電群益93購02,,,,,0.00,0.00,0,0,0,0,0,0,0,0,0,0,0,0,0
20200312,046164,健策兆豐93購03,0.87,0.87,0.54,0.54,0.00,0.00,60000,6,41300,0,0,0,0,0,0,0,60000,-60000,-60000
20200312,046165,中磊兆豐93購01,,,,,0.00,0.00,0,0,0,0,0,0,0,0,0,0,0,0,0
20200312,046166,嘉聯益兆豐93購01,,,,,0.00,0.00,0,0,0,0,0,0,0,0,0,0,0,0,0
20200312,04616P,臺股指群益95售02,,,,,0.00,0.00,0,0,0,0,0,0,0,0,0,0,0,0,0
20200312,04617P,臺股指群益95售03,3.24,3.42,3.24,3.42,0.00,0.00,31000,4,101820,0,0,0,0,0,0,0,31000,-31000,-31000
20200312,046180,裕隆凱基93購01,,,,,0.00,0.00,0,0,0,0,0,0,0,0,0,0,0,0,0
20200312,046182,燿華凱基93購04,,,,,0.00,0.00,0,0,0,0,0,0,0,0,0,0,0,0,0
20200312,046184,台光電凱基93購08,,,,,0.00,0.00,0,0,0,0,0,0,0,0,0,0,0,0,0
20200312,046185,正崴凱基93購02,0.24,0.24,0.24,0.24,-0.23,-48.94,40000,1,9600,0,0,0,0,0,0,40000,0,40000,40000
20200312,046187,友達凱基93購03,1.40,1.41,1.14,1.14,-0.87,-43.28,70000,7,90900,0,0,0,0,0,0,0,70000,-70000,-70000
20200312,04618P,電子類群益94售02,0.27,0.77,0.27,0.56,+0.42,300.0,345000,18,155220,0,0,0,0,0,0,268000,77000,191000,191000
20200312,046191,新光金凱基98購01,0.63,0.63,0.57,0.57,-0.17,-22.97,203000,3,121770,0,0,0,0,0,0,0,203000,-203000,-203000
20200312,04619P,華新統一94售02,2.07,2.39,2.07,2.36,+0.70,42.17,20000,8,43400,0,0,0,0,0,0,10000,10000,0,0
20200312,046200,上海銀凱基93購01,,,,,0.00,0.00,0,0,0,0,0,0,0,0,0,0,0,0,0
20200312,046202,台表科凱基93購04,1.39,1.39,0.83,0.83,-0.84,-50.3,50000,3,63900,0,0,0,0,0,0,40000,10000,30000,30000
20200312,046203,GIS凱基93購02,,,,,0.00,0.00,0,0,0,0,0,0,0,0,0,0,0,0,0
20200312,046204,致新凱基93購01,,,,,0.00,0.00,0,0,0,0,0,0,0,0,0,0,0,0,0
20200312,046205,明基材凱基93購01,,,,,0.00,0.00,0,0,0,0,0,0,0,0,0,0,0,0,0
20200312,046206,為升國泰93購01,,,,,0.00,0.00,0,0,0,0,0,0,0,0,0,0,0,0,0
20200312,046207,群創國泰94購02,0.63,0.63,0.63,0.63,-0.18,-22.22,50000,1,31500,0,0,0,0,0,0,50000,0,50000,50000
20200312,046208,滬深2X元富95購03,0.39,0.39,0.32,0.32,-0.10,-23.81,1074000,6,409310,0,0,0,0,0,0,934000,140000,794000,794000
20200312,04620P,聯電統一94售04,0.44,0.62,0.44,0.59,+0.26,78.79,40000,5,21200,0,0,0,0,0,0,10000,30000,-20000,-20000
20200312,046216,滬深2X富邦93購02,,,,,0.00,0.00,0,0,0,0,0,0,0,0,0,0,0,0,0
20200312,046217,康友富邦94購01,,,,,0.00,0.00,0,0,0,0,0,0,0,0,0,0,0,0,0
20200312,046218,T50反1元大93購02,0.04,0.04,0.04,0.04,0.00,0.00,10000,1,400,0,0,0,0,0,0,10000,0,10000,10000
20200312,046219,T50反1元大93購03,,,,,0.00,0.00,0,0,0,0,0,0,0,0,0,0,0,0,0
20200312,04621P,楠梓電統一94售02,1.98,2.15,1.98,2.15,0.00,0.00,25000,3,51790,0,0,0,0,0,0,0,25000,-25000,-25000
20200312,046220,滬深2X元大95購03,0.11,0.11,0.11,0.11,-0.09,-45.0,20000,2,2200,0,0,0,0,0,0,0,20000,-20000,-20000
20200312,04622P,臺股指統一94售01,0.72,0.79,0.72,0.79,0.00,0.00,490000,49,368900,0,0,0,0,0,0,490000,490000,0,0
20200312,046232,智易元大93購05,,,,,0.00,0.00,0,0,0,0,0,0,0,0,0,0,0,0,0
20200312,046236,緯穎元大93購05,,,,,0.00,0.00,0,0,0,0,0,0,0,0,0,0,0,0,0
20200312,04623P,台積電元大94售13,,,,,0.00,0.00,0,0,0,0,0,0,0,0,0,0,0,0,0
20200312,046240,中鋼中信94購01,0.17,0.17,0.17,0.17,-0.18,-51.43,20000,1,3400,0,0,0,0,0,0,0,20000,-20000,-20000
20200312,046241,聯發科中信94購02,,,,,0.00,0.00,0,0,0,0,0,0,0,0,0,0,0,0,0
20200312,046242,大立光中信93購02,0.64,0.64,0.61,0.62,-1.24,-66.67,40000,4,24900,0,0,0,0,0,0,30000,10000,20000,20000
20200312,046244,大成鋼亞東93購01,,,,,0.00,0.00,0,0,0,0,0,0,0,0,0,0,0,0,0
20200312,046245,奇力新亞東93購01,,,,,0.00,0.00,0,0,0,0,0,0,0,0,0,0,0,0,0
20200312,046246,嘉聯益亞東93購01,,,,,0.00,0.00,0,0,0,0,0,0,0,0,0,0,0,0,0
20200312,046247,南電亞東93購02,,,,,0.00,0.00,0,0,0,0,0,0,0,0,0,0,0,0,0
20200312,046248,技嘉群益93購02,,,,,0.00,0.00,0,0,0,0,0,0,0,0,0,0,0,0,0
20200312,04624P,台積電元大94售14,1.01,1.09,0.84,0.84,+0.39,86.67,40000,3,39500,0,0,0,0,0,0,20000,20000,0,0
20200312,046257,A50正2國票94購01,,,,,0.00,0.00,0,0,0,0,0,0,0,0,0,0,0,0,0
20200312,04625P,燿華元大94售03,,,,,0.00,0.00,0,0,0,0,0,0,0,0,0,0,0,0,0
20200312,046261,中環凱基93購01,,,,,0.00,0.00,0,0,0,0,0,0,0,0,0,0,0,0,0
20200312,046264,美律凱基93購05,,,,,0.00,0.00,0,0,0,0,0,0,0,0,0,0,0,0,0
20200312,046268,嘉晶凱基93購02,0.34,0.48,0.30,0.31,-0.11,-26.19,160000,11,58000,0,0,0,0,0,0,60000,100000,-40000,-40000
20200312,04626P,聯發科元大94售07,1.73,2.05,1.73,2.05,+0.55,36.67,39000,4,75550,0,0,0,0,0,0,39000,0,39000,39000
20200312,046275,台表科凱基94購01,0.95,0.95,0.84,0.87,-0.39,-30.95,30000,14,27170,0,0,0,0,0,0,30000,0,30000,30000
20200312,04627P,聯發科元大94售08,1.00,1.35,1.00,1.35,0.00,0.00,131000,3,166310,0,0,0,0,0,0,100000,131000,-31000,-31000
20200312,046285,國巨兆豐93購01,,,,,0.00,0.00,0,0,0,0,0,0,0,0,0,0,0,0,0
20200312,046286,高鐵兆豐93購01,,,,,0.00,0.00,0,0,0,0,0,0,0,0,0,0,0,0,0
20200312,04628P,欣興元大95售01,2.91,3.57,2.91,3.57,+1.26,54.55,15000,2,46950,0,0,0,0,0,0,15000,0,15000,15000
20200312,046290,儒鴻統一93購01,,,,,0.00,0.00,0,0,0,0,0,0,0,0,0,0,0,0,0
20200312,046291,友達統一94購01,0.42,0.42,0.21,0.22,-0.33,-60.0,164000,14,45850,0,0,0,0,0,0,70000,94000,-24000,-24000
20200312,046293,聯發科統一94購01,0.10,0.11,0.06,0.07,-0.10,-58.82,295000,29,25200,0,0,0,0,0,0,0,275000,-275000,-275000
20200312,046298,聯發科富邦94購01,0.17,0.17,0.07,0.09,-0.14,-60.87,214000,15,20860,0,0,0,0,0,0,22000,195000,-173000,-173000
20200312,046299,大立光富邦93購04,0.76,0.76,0.76,0.76,-0.74,-49.33,1000,1,760,0,0,0,0,0,0,1000,0,1000,1000
20200312,04629P,康控元大94售05,1.17,1.17,1.17,1.17,+0.26,28.57,82000,1,95940,0,0,0,0,0,0,82000,0,82000,82000
20200312,046300,嘉聯益富邦94購01,,,,,0.00,0.00,0,0,0,0,0,0,0,0,0,0,0,0,0
20200312,04630P,嘉聯益元大95售02,0.95,1.10,0.95,1.10,0.00,0.00,154000,4,160300,0,0,0,0,0,0,110000,44000,66000,66000
20200312,04631P,臺股指中信95售08,1.01,1.52,1.01,1.33,+0.61,84.72,18000,5,22420,0,0,0,0,0,0,6000,12000,-6000,-6000
20200312,04632P,台積電群益94售11,,,,,0.00,0.00,0,0,0,0,0,0,0,0,0,0,0,0,0
20200312,04633P,旺宏群益96售04,1.19,1.51,1.14,1.51,+0.52,52.53,196000,21,268790,0,0,0,0,0,0,157000,39000,118000,118000
20200312,046340,滬深2X國票96購01,,,,,0.00,0.00,0,0,0,0,0,0,0,0,0,0,0,0,0
20200312,046341,A50正2國票93購01,,,,,0.00,0.00,0,0,0,0,0,0,0,0,0,0,0,0,0
20200312,046343,和鑫國票93購02,,,,,0.00,0.00,0,0,0,0,0,0,0,0,0,0,0,0,0
20200312,046344,超眾國票94購01,,,,,0.00,0.00,0,0,0,0,0,0,0,0,0,0,0,0,0
20200312,046345,世紀鋼國票93購01,,,,,0.00,0.00,0,0,0,0,0,0,0,0,0,0,0,0,0
20200312,046347,奇力新兆豐93購02,,,,,0.00,0.00,0,0,0,0,0,0,0,0,0,0,0,0,0
20200312,046348,嘉澤兆豐93購01,,,,,0.00,0.00,0,0,0,0,0,0,0,0,0,0,0,0,0
20200312,046349,康控兆豐93購02,,,,,0.00,0.00,0,0,0,0,0,0,0,0,0,0,0,0,0
20200312,04634P,臺股指群益94售09,,,,,0.00,0.00,0,0,0,0,0,0,0,0,0,0,0,0,0
20200312,046356,智伸科群益93購01,,,,,0.00,0.00,0,0,0,0,0,0,0,0,0,0,0,0,0
20200312,04635P,臺股指群益94售10,,,,,0.00,0.00,0,0,0,0,0,0,0,0,0,0,0,0,0
20200312,04636P,臺股指群益94售11,2.57,2.57,2.57,2.57,0.00,0.00,10000,1,25700,0,0,0,0,0,0,0,10000,-10000,-10000
20200312,046370,全新麥證93購01,,,,,0.00,0.00,0,0,0,0,0,0,0,0,0,0,0,0,0
20200312,046375,友達凱基98購01,0.88,0.90,0.76,0.76,-0.35,-31.53,65000,7,52670,0,0,0,0,0,0,23000,42000,-19000,-19000
20200312,046379,奇力新凱基93購03,1.18,1.18,1.01,1.01,-0.72,-41.62,50000,7,52810,0,0,0,0,0,0,50000,0,50000,50000
20200312,04637P,臺股指群益94售12,,,,,0.00,0.00,0,0,0,0,0,0,0,0,0,0,0,0,0
20200312,046380,神基凱基93購01,,,,,0.00,0.00,0,0,0,0,0,0,0,0,0,0,0,0,0
20200312,046381,緯創凱基93購03,,,,,0.00,0.00,0,0,0,0,0,0,0,0,0,0,0,0,0
20200312,046382,明泰凱基93購01,,,,,0.00,0.00,0,0,0,0,0,0,0,0,0,0,0,0,0
20200312,046383,群創凱基98購01,0.52,0.52,0.52,0.52,-0.16,-23.53,68000,2,35360,0,0,0,0,0,0,68000,0,68000,68000
20200312,046384,群創凱基98購02,0.55,0.55,0.47,0.47,-0.29,-38.16,128000,2,65600,0,0,0,0,0,0,60000,68000,-8000,-8000
20200312,046385,群創凱基98購03,0.70,0.70,0.55,0.55,-0.29,-34.52,265000,7,160900,0,0,0,0,0,0,155000,110000,45000,45000
20200312,046389,百和凱基93購04,,,,,0.00,0.00,0,0,0,0,0,0,0,0,0,0,0,0,0
20200312,04638P,臺股指群益94售13,2.34,3.80,2.34,3.80,+1.72,82.69,54000,6,162830,0,0,0,0,0,0,53000,0,53000,53000
20200312,046390,旺宏統一94購02,,,,,0.00,0.00,0,0,0,0,0,0,0,0,0,0,0,0,0
20200312,046391,上海銀統一94購01,1.20,1.20,1.20,1.20,-0.22,-15.49,1000,1,1200,0,0,0,0,0,0,0,1000,-1000,-1000
20200312,046395,友達國泰93購04,,,,,0.00,0.00,0,0,0,0,0,0,0,0,0,0,0,0,0
20200312,046396,矽創國泰93購01,,,,,0.00,0.00,0,0,0,0,0,0,0,0,0,0,0,0,0
20200312,046397,力山富邦94購01,,,,,0.00,0.00,0,0,0,0,0,0,0,0,0,0,0,0,0
20200312,046398,群創富邦93購01,,,,,0.00,0.00,0,0,0,0,0,0,0,0,0,0,0,0,0
20200312,04639P,臺股指群益94售14,12.50,15.50,12.50,15.50,0.00,0.00,30000,3,430000,0,0,0,0,0,0,30000,0,30000,30000
20200312,046404,友達元大93購02,,,,,0.00,0.00,0,0,0,0,0,0,0,0,0,0,0,0,0
20200312,046407,華新科元大93購07,,,,,0.00,0.00,0,0,0,0,0,0,0,0,0,0,0,0,0
20200312,04640P,上銀凱基94售05,,,,,0.00,0.00,0,0,0,0,0,0,0,0,0,0,0,0,0
20200312,04641P,台積電凱基94售19,,,,,0.00,0.00,0,0,0,0,0,0,0,0,0,0,0,0,0
20200312,04642P,台積電凱基94售20,0.10,0.10,0.10,0.10,0.00,0.00,10000,1,1000,0,0,0,0,0,0,0,10000,-10000,-10000
20200312,046432,宏達電中信94購01,0.48,0.48,0.45,0.45,-0.10,-18.18,55000,6,25650,0,0,0,0,0,0,55000,0,55000,55000
20200312,046434,國巨群益93購03,,,,,0.00,0.00,0,0,0,0,0,0,0,0,0,0,0,0,0
20200312,046437,大立光群益93購05,,,,,0.00,0.00,0,0,0,0,0,0,0,0,0,0,0,0,0
20200312,046438,群創群益95購01,0.22,0.22,0.21,0.21,-0.30,-58.82,20000,2,4300,0,0,0,0,0,0,0,20000,-20000,-20000
20200312,04643P,京元電凱基94售02,,,,,0.00,0.00,0,0,0,0,0,0,0,0,0,0,0,0,0
20200312,046440,義隆亞東93購01,,,,,0.00,0.00,0,0,0,0,0,0,0,0,0,0,0,0,0
20200312,046442,聯茂兆豐93購03,,,,,0.00,0.00,0,0,0,0,0,0,0,0,0,0,0,0,0
20200312,046443,超眾兆豐93購01,,,,,0.00,0.00,0,0,0,0,0,0,0,0,0,0,0,0,0
20200312,04644P,全新凱基94售01,,,,,0.00,0.00,0,0,0,0,0,0,0,0,0,0,0,0,0
20200312,046450,鴻海凱基93購12,0.32,0.35,0.32,0.35,-0.32,-47.76,41000,3,13950,0,0,0,0,0,0,21000,20000,1000,1000
20200312,046451,中環凱基93購02,,,,,0.00,0.00,0,0,0,0,0,0,0,0,0,0,0,0,0
20200312,04645P,禾伸堂凱基94售03,0.67,0.67,0.65,0.65,0.00,0.00,16000,3,10460,0,0,0,0,0,0,0,16000,-16000,-16000
20200312,046460,聯鈞凱基93購02,0.68,0.68,0.68,0.68,-1.20,-63.83,10000,1,6800,0,0,0,0,0,0,0,10000,-10000,-10000
20200312,046465,GIS凱基95購01,,,,,0.00,0.00,0,0,0,0,0,0,0,0,0,0,0,0,0
20200312,04646P,TPK凱基94售03,1.92,2.31,1.92,2.31,+0.57,32.76,57000,8,123900,0,0,0,0,0,0,2000,55000,-53000,-53000
20200312,046476,鴻海統一96購01,0.90,0.91,0.61,0.62,-0.48,-43.64,263000,33,195260,0,0,0,0,0,0,101000,172000,-71000,-71000
20200312,046477,台積電統一94購02,3.12,3.12,3.12,3.12,0.00,0.00,1000,1,3120,0,0,0,0,0,0,1000,0,1000,1000
20200312,046479,群創元富94購01,0.26,0.26,0.26,0.26,-0.09,-25.71,15000,2,3900,0,0,0,0,0,0,0,15000,-15000,-15000
20200312,04647P,上海銀凱基94售04,2.27,2.27,2.27,2.27,+0.53,30.46,20000,2,45400,0,0,0,0,0,0,0,20000,-20000,-20000
20200312,046480,群創元富96購01,0.20,0.20,0.16,0.16,-0.19,-54.29,180000,3,30800,0,0,0,0,0,0,140000,40000,100000,100000
20200312,046483,華通國泰93購01,,,,,0.00,0.00,0,0,0,0,0,0,0,0,0,0,0,0,0
20200312,046484,華泰國泰93購01,,,,,0.00,0.00,0,0,0,0,0,0,0,0,0,0,0,0,0
20200312,046485,群創國泰93購02,,,,,0.00,0.00,0,0,0,0,0,0,0,0,0,0,0,0,0
20200312,046486,樺漢國泰94購01,,,,,0.00,0.00,0,0,0,0,0,0,0,0,0,0,0,0,0
20200312,04648P,臺股指凱基94售07,,,,,0.00,0.00,0,0,0,0,0,0,0,0,0,0,0,0,0
20200312,046491,滬深2X富邦95購02,0.49,0.49,0.42,0.42,-0.17,-28.81,31000,4,13730,0,0,0,0,0,0,11000,21000,-10000,-10000
20200312,046492,旺宏富邦94購02,0.88,0.88,0.80,0.80,0.00,0.00,15000,2,12400,0,0,0,0,0,0,0,15000,-15000,-15000
20200312,046493,緯創富邦93購01,,,,,0.00,0.00,0,0,0,0,0,0,0,0,0,0,0,0,0
20200312,04649P,臺股指凱基94售08,1.45,1.54,1.43,1.54,+0.25,19.38,365000,7,556100,0,0,0,0,0,0,365000,365000,0,0
20200312,04650P,臺股指凱基94售09,,,,,0.00,0.00,0,0,0,0,0,0,0,0,0,0,0,0,0
20200312,04651P,臺股指凱基94售10,,,,,0.00,0.00,0,0,0,0,0,0,0,0,0,0,0,0,0
20200312,046528,聯詠中信94購01,0.74,0.74,0.65,0.65,-0.34,-34.34,68000,3,47540,0,0,0,0,0,0,38000,30000,8000,8000
20200312,04652P,臺股指凱基94售11,,,,,0.00,0.00,0,0,0,0,0,0,0,0,0,0,0,0,0
20200312,046532,元石油群益93購01,,,,,0.00,0.00,0,0,0,0,0,0,0,0,0,0,0,0,0
20200312,046537,聯發科群益93購02,,,,,0.00,0.00,0,0,0,0,0,0,0,0,0,0,0,0,0
20200312,046538,大立光群益93購06,,,,,0.00,0.00,0,0,0,0,0,0,0,0,0,0,0,0,0
20200312,04653P,臺股指凱基94售12,,,,,0.00,0.00,0,0,0,0,0,0,0,0,0,0,0,0,0
20200312,046541,超眾群益93購01,,,,,0.00,0.00,0,0,0,0,0,0,0,0,0,0,0,0,0
20200312,04654P,臺股指凱基94售13,,,,,0.00,0.00,0,0,0,0,0,0,0,0,0,0,0,0,0
20200312,046557,亞泥凱基93購02,,,,,0.00,0.00,0,0,0,0,0,0,0,0,0,0,0,0,0
20200312,04655P,臺股指凱基94售14,2.30,3.50,2.30,2.85,0.00,0.00,63000,5,193900,0,0,0,0,0,0,63000,20000,43000,43000
20200312,046562,大立光凱基95購01,0.77,0.77,0.67,0.67,0.00,0.00,505000,3,388260,0,0,0,0,0,0,0,505000,-505000,-505000
20200312,046568,臻鼎元富95購01,0.14,0.14,0.11,0.14,-0.10,-41.67,127000,8,16380,0,0,0,0,0,0,37000,30000,7000,7000
20200312,04656P,台郡台新94售02,,,,,0.00,0.00,0,0,0,0,0,0,0,0,0,0,0,0,0
20200312,046570,旺宏國泰94購01,1.87,1.87,1.76,1.76,-0.81,-31.52,60000,2,108900,0,0,0,0,0,0,0,60000,-60000,-60000
20200312,046571,瑞昱國泰93購01,,,,,0.00,0.00,0,0,0,0,0,0,0,0,0,0,0,0,0
20200312,046572,貿聯國泰94購01,,,,,0.00,0.00,0,0,0,0,0,0,0,0,0,0,0,0,0
20200312,046573,上緯控國泰94購01,0.15,0.15,0.15,0.15,-0.16,-51.61,10000,1,1500,0,0,0,0,0,0,10000,0,10000,10000
20200312,046574,泰鼎國泰94購01,0.44,0.45,0.30,0.40,-0.10,-20.0,210000,9,75200,0,0,0,0,0,0,0,60000,-60000,-60000
20200312,046575,GIS國泰93購01,,,,,0.00,0.00,0,0,0,0,0,0,0,0,0,0,0,0,0
20200312,046576,S&P反1富邦93購01,,,,,0.00,0.00,0,0,0,0,0,0,0,0,0,0,0,0,0
20200312,04657P,國巨永豐94售03,,,,,0.00,0.00,0,0,0,0,0,0,0,0,0,0,0,0,0
20200312,046588,大立光元大93購13,,,,,0.00,0.00,0,0,0,0,0,0,0,0,0,0,0,0,0
20200312,04658P,臺股指永昌94售02,,,,,0.00,0.00,0,0,0,0,0,0,0,0,0,0,0,0,0
20200312,046597,可成亞東93購01,,,,,0.00,0.00,0,0,0,0,0,0,0,0,0,0,0,0,0
20200312,046598,T50反1群益93購04,0.16,0.16,0.16,0.16,0.00,0.00,100000,10,16000,0,0,0,0,0,0,100000,100000,0,0
20200312,046599,S&P反1群益93購01,0.34,0.34,0.34,0.34,0.00,0.00,1000,1,340,0,0,0,0,0,0,1000,0,1000,1000
20200312,04659P,臺股指永昌94售03,,,,,0.00,0.00,0,0,0,0,0,0,0,0,0,0,0,0,0
20200312,046600,鴻海群益94購01,1.46,1.48,1.02,1.09,-0.80,-42.33,65000,23,87960,0,0,0,0,0,0,50000,37000,13000,13000
20200312,046602,新日興群益94購01,0.31,0.31,0.29,0.29,-0.15,-34.09,78000,2,23980,0,0,0,0,0,0,78000,0,78000,78000
20200312,046604,康控群益93購02,,,,,0.00,0.00,0,0,0,0,0,0,0,0,0,0,0,0,0
20200312,046606,世紀鋼群益93購01,,,,,0.00,0.00,0,0,0,0,0,0,0,0,0,0,0,0,0
20200312,046608,超眾兆豐93購02,,,,,0.00,0.00,0,0,0,0,0,0,0,0,0,0,0,0,0
20200312,04660P,臺股指富邦94售03,0.67,0.67,0.67,0.67,+0.37,123.33,1000,1,670,0,0,0,0,0,0,1000,0,1000,1000
20200312,04661P,臺股指富邦94售04,,,,,0.00,0.00,0,0,0,0,0,0,0,0,0,0,0,0,0
20200312,046624,彩晶凱基94購02,0.32,0.32,0.25,0.25,-0.29,-53.7,75000,4,20600,0,0,0,0,0,0,15000,60000,-45000,-45000
20200312,046626,台光電統一94購01,,,,,0.00,0.00,0,0,0,0,0,0,0,0,0,0,0,0,0
20200312,046627,高鐵統一95購01,,,,,0.00,0.00,0,0,0,0,0,0,0,0,0,0,0,0,0
20200312,046628,大立光統一98購01,2.23,2.23,1.80,1.98,-0.77,-28.0,333000,18,681780,0,0,0,0,0,0,235000,98000,137000,137000
20200312,046629,群創統一98購01,0.59,0.59,0.49,0.49,-0.25,-33.78,103000,4,52530,0,0,0,0,0,0,83000,20000,63000,63000
20200312,04662P,臺股指國票94售01,1.65,1.65,1.29,1.37,0.00,0.00,88000,7,128120,0,0,0,0,0,0,82000,36000,46000,46000
20200312,046630,京元電元富95購03,0.47,0.47,0.47,0.47,-0.17,-26.56,10000,1,4700,0,0,0,0,0,0,0,10000,-10000,-10000
20200312,04663P,臺股指國票94售02,4.00,4.11,3.80,4.09,0.00,0.00,40000,4,160000,0,0,0,0,0,0,40000,40000,0,0
20200312,046644,台達電國泰93購01,,,,,0.00,0.00,0,0,0,0,0,0,0,0,0,0,0,0,0
20200312,046645,技嘉國泰94購01,0.15,0.18,0.15,0.18,-0.14,-43.75,520000,2,86400,0,0,0,0,0,0,520000,0,520000,520000
20200312,046646,冠德國泰94購01,,,,,0.00,0.00,0,0,0,0,0,0,0,0,0,0,0,0,0
20200312,046647,高鐵國泰93購01,,,,,0.00,0.00,0,0,0,0,0,0,0,0,0,0,0,0,0
20200312,046648,和鑫國泰94購01,,,,,0.00,0.00,0,0,0,0,0,0,0,0,0,0,0,0,0
20200312,046649,致伸國泰94購01,,,,,0.00,0.00,0,0,0,0,0,0,0,0,0,0,0,0,0
20200312,04664P,臺股指國票94售03,3.53,4.40,3.53,4.40,+2.56,139.13,41000,5,166500,0,0,0,0,0,0,41000,40000,1000,1000
20200312,046650,台表科國泰94購01,0.81,0.82,0.73,0.75,-0.33,-30.56,81000,25,63760,0,0,0,0,0,0,72000,0,72000,72000
20200312,046651,TPK富邦94購02,,,,,0.00,0.00,0,0,0,0,0,0,0,0,0,0,0,0,0
20200312,04665P,臺股指國票94售04,2.92,5.05,2.89,5.05,+2.48,96.5,60000,6,257000,0,0,0,0,0,0,60000,40000,20000,20000
20200312,046662,大立光元大93購14,1.75,1.75,1.75,1.75,0.00,0.00,1000,1,1750,0,0,0,0,0,0,1000,0,1000,1000
20200312,04666P,臺股指國票94售05,,,,,0.00,0.00,0,0,0,0,0,0,0,0,0,0,0,0,0
20200312,04667P,臺股指國票94售06,4.05,4.05,4.05,4.05,+0.64,18.77,5000,1,20250,0,0,0,0,0,0,5000,0,5000,5000
20200312,046680,上証反群益95購01,,,,,0.00,0.00,0,0,0,0,0,0,0,0,0,0,0,0,0
20200312,046685,世紀鋼群益93購02,0.89,0.89,0.89,0.89,0.00,0.00,6000,1,5340,0,0,0,0,0,0,6000,0,6000,6000
20200312,046686,上銀國票93購01,,,,,0.00,0.00,0,0,0,0,0,0,0,0,0,0,0,0,0
20200312,046687,TPK國票93購01,,,,,0.00,0.00,0,0,0,0,0,0,0,0,0,0,0,0,0
20200312,046688,超眾國票93購03,,,,,0.00,0.00,0,0,0,0,0,0,0,0,0,0,0,0,0
20200312,04668P,臺股指國票94售07,3.18,4.98,3.18,4.95,+2.62,112.45,126000,13,522380,0,0,0,0,0,0,126000,40000,86000,86000
20200312,046697,麗豐凱基94購01,,,,,0.00,0.00,0,0,0,0,0,0,0,0,0,0,0,0,0
20200312,04669P,臺股指國票94售08,3.22,3.60,3.22,3.60,+0.67,22.87,11000,3,35950,0,0,0,0,0,0,11000,0,11000,11000
20200312,046703,瑞昱元富95購01,0.83,0.83,0.55,0.57,-0.67,-54.03,855000,20,541920,0,0,0,0,0,0,15000,840000,-825000,-825000
20200312,046707,友達康和93購01,,,,,0.00,0.00,0,0,0,0,0,0,0,0,0,0,0,0,0
20200312,04670P,臺股指國票94售09,4.40,6.35,4.40,6.35,+2.75,76.39,28000,4,128050,0,0,0,0,0,0,28000,0,28000,28000
20200312,046713,鴻海國泰93購02,,,,,0.00,0.00,0,0,0,0,0,0,0,0,0,0,0,0,0
20200312,046714,國巨國泰93購02,,,,,0.00,0.00,0,0,0,0,0,0,0,0,0,0,0,0,0
20200312,046715,美律國泰94購01,0.35,0.35,0.16,0.16,0.00,0.00,87000,2,30260,0,0,0,0,0,0,1000,86000,-85000,-85000
20200312,046716,欣興國泰93購03,,,,,0.00,0.00,0,0,0,0,0,0,0,0,0,0,0,0,0
20200312,046717,世紀鋼國泰94購01,1.18,1.18,1.11,1.11,-0.20,-15.27,12000,2,13670,0,0,0,0,0,0,5000,7000,-2000,-2000
20200312,046719,元石油元大95購02,,,,,0.00,0.00,0,0,0,0,0,0,0,0,0,0,0,0,0
20200312,04671P,華通統一94售01,,,,,0.00,0.00,0,0,0,0,0,0,0,0,0,0,0,0,0
20200312,046720,元油2X元大95購08,,,,,0.00,0.00,0,0,0,0,0,0,0,0,0,0,0,0,0
20200312,046727,新光金元大93購03,,,,,0.00,0.00,0,0,0,0,0,0,0,0,0,0,0,0,0
20200312,04672P,台積電統一94售09,0.60,0.90,0.60,0.75,+0.30,66.67,441000,10,315710,0,0,0,0,0,0,211000,280000,-69000,-69000
20200312,046733,鴻海亞東94購01,,,,,0.00,0.00,0,0,0,0,0,0,0,0,0,0,0,0,0
20200312,04673P,友達統一94售04,0.45,0.45,0.45,0.45,0.00,0.00,107000,1,48150,0,0,0,0,0,0,0,107000,-107000,-107000
20200312,046740,大立光群益95購01,1.24,1.28,0.77,0.83,-1.67,-66.8,190000,20,201650,0,0,0,0,0,0,25000,165000,-140000,-140000
20200312,046741,GIS群益94購01,,,,,0.00,0.00,0,0,0,0,0,0,0,0,0,0,0,0,0
20200312,046744,元油2X凱基94購01,,,,,0.00,0.00,0,0,0,0,0,0,0,0,0,0,0,0,0
20200312,04674P,全新統一95售01,1.58,1.79,1.58,1.79,+0.33,22.6,130000,4,221600,0,0,0,0,0,0,16000,114000,-98000,-98000
20200312,04675P,華新科統一94售05,,,,,0.00,0.00,0,0,0,0,0,0,0,0,0,0,0,0,0
20200312,04676P,彩晶統一94售03,0.77,0.77,0.77,0.77,+0.35,83.33,60000,1,46200,0,0,0,0,0,0,60000,0,60000,60000
20200312,046770,聯發科國泰94購01,,,,,0.00,0.00,0,0,0,0,0,0,0,0,0,0,0,0,0
20200312,046771,聯發科國泰94購02,,,,,0.00,0.00,0,0,0,0,0,0,0,0,0,0,0,0,0
20200312,046773,GIS富邦94購01,0.01,0.01,0.01,0.01,0.00,0.00,122000,1,1220,0,0,0,0,0,0,122000,0,122000,122000
20200312,04677P,臺股指統一94售02,,,,,0.00,0.00,0,0,0,0,0,0,0,0,0,0,0,0,0
20200312,04678P,臺股指統一94售03,,,,,0.00,0.00,0,0,0,0,0,0,0,0,0,0,0,0,0
20200312,046791,台郡統一96購01,1.37,1.37,1.07,1.07,-0.65,-37.79,111000,8,138600,0,0,0,0,0,0,21000,90000,-69000,-69000
20200312,046792,京元電元富96購01,0.43,0.43,0.43,0.43,-0.10,-18.87,12000,3,5160,0,0,0,0,0,0,12000,0,12000,12000
20200312,046793,聯發科元富99購01,0.42,0.42,0.27,0.29,-0.25,-46.3,894000,14,311350,0,0,0,0,0,0,35000,859000,-824000,-824000
20200312,046797,T50反1元大96購01,0.31,0.50,0.31,0.46,+0.26,130.0,571000,20,235910,0,0,0,0,0,0,211000,180000,31000,31000
20200312,046798,元油2X元大96購01,0.04,0.04,0.04,0.04,0.00,0.00,499000,3,19960,0,0,0,0,0,0,0,499000,-499000,-499000
20200312,04679P,臺股指統一94售04,1.07,1.07,1.07,1.07,0.00,0.00,10000,1,10700,0,0,0,0,0,0,10000,10000,0,0
20200312,046804,群創元大94購01,0.05,0.05,0.05,0.05,-0.06,-54.55,20000,2,1000,0,0,0,0,0,0,0,20000,-20000,-20000
20200312,04680P,臺股指統一94售05,,,,,0.00,0.00,0,0,0,0,0,0,0,0,0,0,0,0,0
20200312,046813,聯電凱基96購01,1.69,1.69,1.44,1.65,-0.40,-19.51,41000,5,62560,0,0,0,0,0,0,25000,16000,9000,9000
20200312,04681P,臺股指統一94售06,,,,,0.00,0.00,0,0,0,0,0,0,0,0,0,0,0,0,0
20200312,046826,統一群益94購01,,,,,0.00,0.00,0,0,0,0,0,0,0,0,0,0,0,0,0
20200312,046828,聯發科群益94購01,,,,,0.00,0.00,0,0,0,0,0,0,0,0,0,0,0,0,0
20200312,04682P,臺股指統一96售01,0.50,0.92,0.50,0.87,+0.47,117.5,200000,10,173770,0,0,0,0,0,0,200000,0,200000,200000
20200312,046831,大立光群益94購01,0.10,0.10,0.10,0.10,-0.55,-84.62,10000,1,1000,0,0,0,0,0,0,10000,0,10000,10000
20200312,04683P,南亞科元大94售04,,,,,0.00,0.00,0,0,0,0,0,0,0,0,0,0,0,0,0
20200312,04684P,欣興元大94售07,,,,,0.00,0.00,0,0,0,0,0,0,0,0,0,0,0,0,0
20200312,046855,嘉晶元大94購01,0.31,0.34,0.18,0.18,-0.13,-41.94,342000,7,70890,0,0,0,0,0,0,135000,207000,-72000,-72000
20200312,046858,群創元大94購02,,,,,0.00,0.00,0,0,0,0,0,0,0,0,0,0,0,0,0
20200312,04685P,訊芯元大94售02,2.12,2.12,2.12,2.12,+0.62,41.33,50000,2,106000,0,0,0,0,0,0,0,50000,-50000,-50000
20200312,046862,台郡元大94購01,0.61,0.61,0.58,0.58,-1.23,-67.96,47000,2,27440,0,0,0,0,0,0,6000,41000,-35000,-35000
20200312,046864,和大統一97購01,0.15,0.17,0.11,0.17,-0.07,-29.17,227000,8,30560,0,0,0,0,0,0,200000,25000,175000,175000
20200312,046865,鴻海統一95購01,1.10,1.10,0.86,0.87,-0.58,-40.0,32000,4,30020,0,0,0,0,0,0,22000,12000,10000,10000
20200312,046866,台積電統一94購03,2.07,2.07,1.95,1.95,0.00,0.00,7000,4,13890,0,0,0,0,0,0,0,7000,-7000,-7000
20200312,046869,聯發科統一95購01,0.10,0.10,0.05,0.05,-0.10,-66.67,70000,6,4800,0,0,0,0,0,0,20000,50000,-30000,-30000
20200312,04686P,台積電凱基94售23,,,,,0.00,0.00,0,0,0,0,0,0,0,0,0,0,0,0,0
20200312,046870,大立光統一95購01,0.60,0.60,0.47,0.47,-0.48,-50.53,101000,6,56300,0,0,0,0,0,0,73000,32000,41000,41000
20200312,046876,國巨國泰94購01,,,,,0.00,0.00,0,0,0,0,0,0,0,0,0,0,0,0,0
20200312,046877,燿華國泰94購01,,,,,0.00,0.00,0,0,0,0,0,0,0,0,0,0,0,0,0
20200312,046878,康友國泰94購01,0.92,0.92,0.92,0.92,-0.07,-7.07,45000,2,41400,0,0,0,0,0,0,45000,0,45000,45000
20200312,04687P,全新凱基94售02,1.55,1.59,1.54,1.59,+0.18,12.77,25000,3,38660,0,0,0,0,0,0,23000,2000,21000,21000
20200312,046881,智原富邦99購01,0.29,0.29,0.29,0.29,0.00,0.00,6000,1,1740,0,0,0,0,0,0,6000,0,6000,6000
20200312,046882,智易富邦97購01,0.04,0.04,0.04,0.04,-0.04,-50.0,1000,1,40,0,0,0,0,0,0,1000,0,1000,1000
20200312,046884,元油反群益95購01,4.53,5.45,4.53,5.10,+2.00,64.52,78000,10,388620,0,0,0,0,0,0,28000,50000,-22000,-22000
20200312,04688P,大立光凱基94售09,,,,,0.00,0.00,0,0,0,0,0,0,0,0,0,0,0,0,0
20200312,046893,華新科群益94購01,1.69,1.69,0.92,0.92,-1.07,-53.77,20000,2,26100,0,0,0,0,0,0,10000,10000,0,0
20200312,046896,臻鼎群益94購01,,,,,0.00,0.00,0,0,0,0,0,0,0,0,0,0,0,0,0
20200312,04689P,台積電中信94售03,,,,,0.00,0.00,0,0,0,0,0,0,0,0,0,0,0,0,0
20200312,046903,友達凱基99購01,,,,,0.00,0.00,0,0,0,0,0,0,0,0,0,0,0,0,0
20200312,046905,新光金凱基99購01,0.82,0.83,0.74,0.77,-0.20,-20.62,175000,9,140350,0,0,0,0,0,0,105000,70000,35000,35000
20200312,046906,新光金凱基99購02,,,,,0.00,0.00,0,0,0,0,0,0,0,0,0,0,0,0,0
20200312,04690P,國巨群益94售06,0.15,0.25,0.15,0.25,+0.16,177.78,370000,9,78520,0,0,0,0,0,0,368000,0,368000,368000
20200312,046914,友達台新96購01,0.58,0.58,0.58,0.58,0.00,0.00,10000,1,5800,0,0,0,0,0,0,0,10000,-10000,-10000
20200312,04691P,智邦群益94售02,1.20,1.20,1.10,1.11,+0.29,35.37,18000,8,20920,0,0,0,0,0,0,8000,10000,-2000,-2000
20200312,046922,國巨國泰94購02,,,,,0.00,0.00,0,0,0,0,0,0,0,0,0,0,0,0,0
20200312,046923,友達國泰94購01,,,,,0.00,0.00,0,0,0,0,0,0,0,0,0,0,0,0,0
20200312,046924,華新科國泰94購02,,,,,0.00,0.00,0,0,0,0,0,0,0,0,0,0,0,0,0
20200312,046925,華新科國泰94購03,,,,,0.00,0.00,0,0,0,0,0,0,0,0,0,0,0,0,0
20200312,046926,易華電國泰94購02,,,,,0.00,0.00,0,0,0,0,0,0,0,0,0,0,0,0,0
20200312,046927,上銀富邦95購01,,,,,0.00,0.00,0,0,0,0,0,0,0,0,0,0,0,0,0
20200312,046928,奇鋐富邦97購01,,,,,0.00,0.00,0,0,0,0,0,0,0,0,0,0,0,0,0
20200312,04692P,大立光群益94售06,1.26,1.67,1.26,1.67,+0.90,116.88,269000,10,358880,0,0,0,0,0,0,47000,222000,-175000,-175000
20200312,046934,智邦元富96購01,0.36,0.36,0.25,0.28,-0.14,-33.33,300000,5,93640,0,0,0,0,0,0,240000,60000,180000,180000
20200312,046937,聯電元大99購01,1.73,1.73,1.45,1.50,-0.50,-25.0,107000,13,166430,0,0,0,0,0,0,45000,74000,-29000,-29000
20200312,046939,燿華元大96購01,0.47,0.47,0.47,0.47,-0.31,-39.74,30000,1,14100,0,0,0,0,0,0,30000,0,30000,30000
20200312,04693P,超眾群益95售01,1.11,1.39,1.11,1.39,+0.32,29.91,319000,12,381670,0,0,0,0,0,0,115000,204000,-89000,-89000
20200312,046942,友達元大99購01,1.14,1.15,1.07,1.07,-0.28,-20.74,385000,5,431910,0,0,0,0,0,0,217000,385000,-168000,-168000
20200312,046944,奇力新元大96購01,2.74,2.74,2.21,2.21,-0.84,-27.54,69000,4,170640,0,0,0,0,0,0,59000,69000,-10000,-10000
20200312,046946,益航元大94購01,,,,,0.00,0.00,0,0,0,0,0,0,0,0,0,0,0,0,0
20200312,046949,群創元大99購01,0.55,0.55,0.44,0.49,-0.23,-31.94,133000,5,68940,0,0,0,0,0,0,3000,133000,-130000,-130000
20200312,04694P,TPK台新94售02,,,,,0.00,0.00,0,0,0,0,0,0,0,0,0,0,0,0,0
20200312,046953,嘉聯益國票94購01,,,,,0.00,0.00,0,0,0,0,0,0,0,0,0,0,0,0,0
20200312,04695P,正崴康和94售01,,,,,0.00,0.00,0,0,0,0,0,0,0,0,0,0,0,0,0
20200312,046960,台新金中信95購01,,,,,0.00,0.00,0,0,0,0,0,0,0,0,0,0,0,0,0
20200312,046961,大立光中信95購02,1.51,1.51,1.07,1.07,-1.14,-51.58,214000,32,275780,0,0,0,0,0,0,30000,184000,-154000,-154000
20200312,046962,群創中信95購03,,,,,0.00,0.00,0,0,0,0,0,0,0,0,0,0,0,0,0
20200312,046968,台積電群益94購03,,,,,0.00,0.00,0,0,0,0,0,0,0,0,0,0,0,0,0
20200312,04696P,亞德客國泰95售02,0.83,1.19,0.83,1.19,+0.42,54.55,511000,11,538740,0,0,0,0,0,0,511000,185000,326000,326000
20200312,04697P,臺股指元富94售03,,,,,0.00,0.00,0,0,0,0,0,0,0,0,0,0,0,0,0
20200312,046980,智邦兆豐94購01,,,,,0.00,0.00,0,0,0,0,0,0,0,0,0,0,0,0,0
20200312,046981,智伸科兆豐94購01,,,,,0.00,0.00,0,0,0,0,0,0,0,0,0,0,0,0,0
20200312,046982,瀚宇博兆豐94購02,,,,,0.00,0.00,0,0,0,0,0,0,0,0,0,0,0,0,0
20200312,046983,南茂兆豐94購01,0.04,0.04,0.04,0.04,-0.12,-75.0,100000,1,4000,0,0,0,0,0,0,100000,0,100000,100000
20200312,04698P,臺股指元富94售04,,,,,0.00,0.00,0,0,0,0,0,0,0,0,0,0,0,0,0
20200312,046996,國巨國泰94購03,,,,,0.00,0.00,0,0,0,0,0,0,0,0,0,0,0,0,0
20200312,046997,國巨國泰95購01,,,,,0.00,0.00,0,0,0,0,0,0,0,0,0,0,0,0,0
20200312,046998,同欣電國泰94購01,,,,,0.00,0.00,0,0,0,0,0,0,0,0,0,0,0,0,0
20200312,046999,康控富邦99購01,0.17,0.18,0.15,0.16,-0.07,-30.43,973000,13,164870,0,0,0,0,0,0,828000,135000,693000,693000
20200312,04699P,臺股指元富94售05,,,,,0.00,0.00,0,0,0,0,0,0,0,0,0,0,0,0,0
20200312,047004,台積電統一99購01,2.30,2.30,1.82,2.15,-0.27,-11.16,564000,97,1166610,0,0,0,0,0,0,107000,347000,-240000,-240000
20200312,04700P,臺股指元富94售06,,,,,0.00,0.00,0,0,0,0,0,0,0,0,0,0,0,0,0
20200312,047013,超眾元富96購01,0.07,0.07,0.07,0.07,-0.06,-46.15,529000,2,37030,0,0,0,0,0,0,0,529000,-529000,-529000
20200312,047014,元油反元大99購01,5.05,5.90,5.05,5.80,+1.80,45.0,51000,8,288300,0,0,0,0,0,0,20000,31000,-11000,-11000
20200312,04701P,臺股指元富94售07,0.49,1.39,0.49,0.97,0.00,0.00,113000,8,114990,0,0,0,0,0,0,113000,0,113000,113000
20200312,047024,奇力新元大95購01,2.86,2.86,2.15,2.25,-1.41,-38.52,80000,4,181100,0,0,0,0,0,0,30000,70000,-40000,-40000
20200312,047027,新光金元大95購01,0.28,0.28,0.28,0.28,0.00,0.00,20000,1,5600,0,0,0,0,0,0,20000,0,20000,20000
20200312,04702P,臺股指元富94售08,2.00,2.50,2.00,2.50,0.00,0.00,18000,4,43500,0,18000,-18000,0,0,0,18000,0,18000,0
20200312,047033,日月光中信95購01,,,,,0.00,0.00,0,0,0,0,0,0,0,0,0,0,0,0,0
20200312,047035,華邦電群益94購02,,,,,0.00,0.00,0,0,0,0,0,0,0,0,0,0,0,0,0
20200312,04703P,樺漢統一95售01,1.02,1.26,1.01,1.26,+0.34,36.96,211000,14,234490,0,0,0,0,0,0,52000,159000,-107000,-107000
20200312,047046,台積電國票94購01,0.03,0.05,0.02,0.05,-0.13,-72.22,108000,4,4040,0,0,0,0,0,0,8000,60000,-52000,-52000
20200312,047047,旺宏國票95購01,0.30,0.30,0.14,0.14,-0.31,-68.89,569000,20,121580,0,0,0,0,0,0,104000,457000,-353000,-353000
20200312,047049,聯發科國票94購01,,,,,0.00,0.00,0,0,0,0,0,0,0,0,0,0,0,0,0
20200312,04704P,臺股指統一95售01,0.70,1.20,0.70,1.20,+1.05,700.0,39000,4,36200,0,0,0,0,0,0,39000,0,39000,39000
20200312,047051,可成國票94購01,0.30,0.30,0.09,0.10,-0.54,-84.38,97000,4,19960,0,0,0,0,0,0,53000,44000,9000,9000
20200312,047058,聯茂國票94購01,,,,,0.00,0.00,0,0,0,0,0,0,0,0,0,0,0,0,0
20200312,04705P,臺股指統一95售02,,,,,0.00,0.00,0,0,0,0,0,0,0,0,0,0,0,0,0
20200312,047063,漢唐凱基95購01,1.19,1.19,1.19,1.19,-0.19,-13.77,20000,1,23800,0,0,0,0,0,0,20000,0,20000,20000
20200312,04706P,力山元大95售01,,,,,0.00,0.00,0,0,0,0,0,0,0,0,0,0,0,0,0
20200312,047072,義隆兆豐94購01,,,,,0.00,0.00,0,0,0,0,0,0,0,0,0,0,0,0,0
20200312,047073,大立光兆豐94購01,0.58,0.58,0.58,0.58,-0.69,-54.33,1000,1,580,0,0,0,0,0,0,1000,0,1000,1000
20200312,047074,大立光兆豐94購02,,,,,0.00,0.00,0,0,0,0,0,0,0,0,0,0,0,0,0
20200312,047076,TPK兆豐94購01,,,,,0.00,0.00,0,0,0,0,0,0,0,0,0,0,0,0,0
20200312,047079,GIS兆豐94購01,,,,,0.00,0.00,0,0,0,0,0,0,0,0,0,0,0,0,0
20200312,04707P,喬山元大94售01,1.24,1.24,1.24,1.24,+0.29,30.53,24000,1,29760,0,0,0,0,0,0,24000,0,24000,24000
20200312,04708P,國巨元大94售11,,,,,0.00,0.00,0,0,0,0,0,0,0,0,0,0,0,0,0
20200312,047096,元油反國泰96購01,,,,,0.00,0.00,0,0,0,0,0,0,0,0,0,0,0,0,0
20200312,047097,旺宏國泰94購03,,,,,0.00,0.00,0,0,0,0,0,0,0,0,0,0,0,0,0
20200312,047098,大毅國泰94購01,,,,,0.00,0.00,0,0,0,0,0,0,0,0,0,0,0,0,0
20200312,047099,華通富邦94購01,,,,,0.00,0.00,0,0,0,0,0,0,0,0,0,0,0,0,0
20200312,04709P,台積電元大94售15,1.05,1.36,1.05,1.31,0.00,0.00,319000,9,350390,0,0,0,0,0,0,300000,319000,-19000,-19000
20200312,047102,潤泰全富邦95購01,0.15,0.15,0.15,0.15,-0.05,-25.0,299000,2,44850,0,0,0,0,0,0,0,299000,-299000,-299000
20200312,047105,和大元大94購01,,,,,0.00,0.00,0,0,0,0,0,0,0,0,0,0,0,0,0
20200312,047109,華邦電元大94購01,,,,,0.00,0.00,0,0,0,0,0,0,0,0,0,0,0,0,0
20200312,04710P,台積電元大94售16,0.44,0.58,0.44,0.58,+0.29,100.0,13000,3,7280,0,0,0,0,0,0,11000,2000,9000,9000
20200312,047114,全新元大94購01,0.27,0.27,0.27,0.27,0.00,0.00,110000,3,29700,0,0,0,0,0,0,110000,0,110000,110000
20200312,04711P,台光電元大94售05,0.61,0.72,0.61,0.72,0.00,0.00,221000,2,143610,0,0,0,0,0,0,80000,141000,-61000,-61000
20200312,047123,中石化中信95購01,0.12,0.12,0.06,0.07,-0.08,-53.33,310000,31,22200,0,0,0,0,0,0,0,310000,-310000,-310000
20200312,047127,臻鼎中信95購01,0.70,0.70,0.38,0.38,-0.41,-51.9,131000,12,70660,0,0,0,0,0,0,78000,53000,25000,25000
20200312,04712P,國泰金元大94售01,,,,,0.00,0.00,0,0,0,0,0,0,0,0,0,0,0,0,0
20200312,047131,鴻海凱基94購03,,,,,0.00,0.00,0,0,0,0,0,0,0,0,0,0,0,0,0
20200312,047136,潤泰全凱基94購01,,,,,0.00,0.00,0,0,0,0,0,0,0,0,0,0,0,0,0
20200312,047137,健策凱基94購01,1.39,1.39,1.30,1.30,-0.55,-29.73,28000,3,38200,0,0,0,0,0,0,10000,18000,-8000,-8000
20200312,04713P,創意元大95售01,,,,,0.00,0.00,0,0,0,0,0,0,0,0,0,0,0,0,0
20200312,047140,滬深2X兆豐94購01,,,,,0.00,0.00,0,0,0,0,0,0,0,0,0,0,0,0,0
20200312,047141,宏達電兆豐94購01,0.05,0.05,0.05,0.05,-0.15,-75.0,90000,1,4500,0,0,0,0,0,0,90000,0,90000,90000
20200312,047144,華通群益94購01,0.39,0.42,0.39,0.42,-0.56,-57.14,22000,10,8620,0,0,0,0,0,0,22000,0,22000,22000
20200312,047145,鴻海群益95購01,1.13,1.14,0.72,0.75,-0.85,-53.12,195000,22,185100,0,0,0,0,0,0,81000,115000,-34000,-34000
20200312,04714P,上海銀元大94售01,1.37,1.70,1.37,1.70,+0.45,36.0,129000,4,212030,0,0,0,0,0,0,19000,110000,-91000,-91000
20200312,047151,台積電國票94購02,0.77,0.77,0.38,0.60,-0.86,-58.9,154000,13,96150,0,0,0,0,0,0,85000,69000,16000,16000
20200312,047154,新光金國票95購01,,,,,0.00,0.00,0,0,0,0,0,0,0,0,0,0,0,0,0
20200312,047156,群創國票94購01,,,,,0.00,0.00,0,0,0,0,0,0,0,0,0,0,0,0,0
20200312,047159,中磊國票94購01,,,,,0.00,0.00,0,0,0,0,0,0,0,0,0,0,0,0,0
20200312,04715P,聯茂元大94售06,1.30,1.47,1.30,1.47,0.00,0.00,300000,4,410780,0,0,0,0,0,0,0,300000,-300000,-300000
20200312,047160,台郡國票94購01,0.41,0.41,0.19,0.19,-0.73,-79.35,8000,5,2550,0,0,0,0,0,0,6000,2000,4000,4000
20200312,047161,世紀鋼國票94購01,,,,,0.00,0.00,0,0,0,0,0,0,0,0,0,0,0,0,0
20200312,047169,滬深2X永豐95購01,,,,,0.00,0.00,0,0,0,0,0,0,0,0,0,0,0,0,0
20200312,04716P,中石化凱基94售01,1.67,1.97,1.67,1.97,+0.37,23.12,65000,4,114900,0,0,0,0,0,0,35000,30000,5000,5000
20200312,04717P,和大凱基94售02,0.77,0.98,0.77,0.98,+0.43,78.18,36000,4,31680,0,0,0,0,0,0,6000,30000,-24000,-24000
20200312,047184,漢唐元大94購02,1.37,1.37,1.37,1.37,-0.71,-34.13,16000,2,21920,0,0,0,0,0,0,16000,0,16000,16000
20200312,047185,益航元大94購02,,,,,0.00,0.00,0,0,0,0,0,0,0,0,0,0,0,0,0
20200312,047187,亞光元大94購01,,,,,0.00,0.00,0,0,0,0,0,0,0,0,0,0,0,0,0
20200312,04718P,亞德客凱基94售03,,,,,0.00,0.00,0,0,0,0,0,0,0,0,0,0,0,0,0
20200312,047193,南電元大94購02,,,,,0.00,0.00,0,0,0,0,0,0,0,0,0,0,0,0,0
20200312,047194,世紀鋼元大96購01,2.64,2.64,2.25,2.50,-0.28,-10.07,411000,27,1006160,0,0,0,0,0,0,2000,409000,-407000,-407000
20200312,047196,上銀統一97購01,0.75,0.75,0.52,0.52,-0.60,-53.57,89000,7,51720,0,0,0,0,0,0,16000,58000,-42000,-42000
20200312,047197,美律統一94購01,,,,,0.00,0.00,0,0,0,0,0,0,0,0,0,0,0,0,0
20200312,04719P,台達電凱基94售09,,,,,0.00,0.00,0,0,0,0,0,0,0,0,0,0,0,0,0
20200312,047202,欣興元富96購01,0.30,0.30,0.20,0.20,-0.20,-50.0,450000,15,100500,0,0,0,0,0,0,60000,380000,-320000,-320000
20200312,047206,元金2X國泰94購01,1.07,1.07,0.99,0.99,-0.38,-27.74,15000,2,15250,0,0,0,0,0,0,0,0,0,0
20200312,047207,晶技國泰94購01,3.43,3.43,3.23,3.25,+0.14,4.5,15000,4,50150,0,0,0,0,0,0,15000,0,15000,15000
20200312,047208,智易國泰94購01,,,,,0.00,0.00,0,0,0,0,0,0,0,0,0,0,0,0,0
20200312,047209,滬深2X富邦96購01,,,,,0.00,0.00,0,0,0,0,0,0,0,0,0,0,0,0,0
20200312,04720P,台積電凱基94售25,,,,,0.00,0.00,0,0,0,0,0,0,0,0,0,0,0,0,0
20200312,047210,漢唐富邦95購01,,,,,0.00,0.00,0,0,0,0,0,0,0,0,0,0,0,0,0
20200312,047211,華新科富邦99購01,1.59,1.64,1.59,1.64,-0.81,-33.06,17000,3,27180,0,0,0,0,0,0,0,17000,-17000,-17000
20200312,047212,宏達電富邦97購01,0.49,0.49,0.32,0.32,-0.18,-36.0,365000,20,148700,0,0,0,0,0,0,0,365000,-365000,-365000
20200312,047213,新日興富邦97購01,0.86,0.86,0.61,0.61,-0.30,-32.97,114000,13,82640,0,0,0,0,0,0,71000,53000,18000,18000
20200312,047214,啟碁富邦97購01,0.10,0.10,0.10,0.10,0.00,0.00,107000,2,10700,0,0,0,0,0,0,107000,0,107000,107000
20200312,047219,美律麥證94購01,0.15,0.15,0.12,0.12,-0.18,-60.0,40000,2,5400,0,40000,-40000,0,0,0,0,40000,-40000,-40000
20200312,04721P,正崴凱基94售02,1.17,1.17,1.17,1.17,0.00,0.00,74000,2,86580,0,0,0,0,0,0,0,74000,-74000,-74000
20200312,047222,鴻海凱基94購04,,,,,0.00,0.00,0,0,0,0,0,0,0,0,0,0,0,0,0
20200312,047224,台光電凱基94購01,,,,,0.00,0.00,0,0,0,0,0,0,0,0,0,0,0,0,0
20200312,047226,義隆凱基94購01,,,,,0.00,0.00,0,0,0,0,0,0,0,0,0,0,0,0,0
20200312,047227,華新科凱基94購01,0.31,0.31,0.31,0.31,-0.79,-71.82,10000,1,3100,0,0,0,0,0,0,0,10000,-10000,-10000
20200312,04722P,南亞科凱基94售05,0.18,0.18,0.18,0.18,0.00,0.00,10000,1,1800,0,0,0,0,0,0,0,10000,-10000,-10000
20200312,047231,大立光凱基95購03,0.08,0.10,0.08,0.10,-0.12,-54.55,874000,9,71320,0,0,0,0,0,0,804000,70000,734000,734000
20200312,047238,傳奇凱基94購01,,,,,0.00,0.00,0,0,0,0,0,0,0,0,0,0,0,0,0
20200312,047239,瀚宇博凱基94購01,,,,,0.00,0.00,0,0,0,0,0,0,0,0,0,0,0,0,0
20200312,04723P,美律凱基94售06,1.54,1.95,1.54,1.95,0.00,0.00,26000,4,45150,0,0,0,0,0,0,5000,21000,-16000,-16000
20200312,047245,聯發科群益94購03,0.09,0.09,0.05,0.05,-0.25,-83.33,6000,2,460,0,0,0,0,0,0,2000,6000,-4000,-4000
20200312,047248,奇鋐群益95購01,0.10,0.11,0.08,0.08,-0.04,-33.33,524000,17,50220,0,0,0,0,0,0,20000,404000,-384000,-384000
20200312,04724P,可成凱基94售08,2.68,2.68,2.68,2.68,0.00,0.00,10000,1,26800,0,0,0,0,0,0,0,10000,-10000,-10000
20200312,047250,日月光群益94購01,0.22,0.22,0.22,0.22,-0.10,-31.25,30000,2,6600,0,0,0,0,0,0,21000,0,21000,21000
20200312,04725P,華新科凱基94售07,,,,,0.00,0.00,0,0,0,0,0,0,0,0,0,0,0,0,0
20200312,047263,揚明光國票94購01,,,,,0.00,0.00,0,0,0,0,0,0,0,0,0,0,0,0,0
20200312,047266,嘉聯益國票94購02,,,,,0.00,0.00,0,0,0,0,0,0,0,0,0,0,0,0,0
20200312,04726P,TPK凱基94售04,2.56,2.82,2.56,2.82,0.00,0.00,50000,5,134300,0,0,0,0,0,0,0,50000,-50000,-50000
20200312,047270,元油2X永豐94購02,,,,,0.00,0.00,0,0,0,0,0,0,0,0,0,0,0,0,0
20200312,04727P,臺股指凱基96售03,0.45,0.74,0.45,0.70,+0.34,94.44,11000,5,6960,0,0,0,0,0,0,4000,7000,-3000,-3000
20200312,047285,鴻海統一95購02,0.01,0.02,0.01,0.01,-0.01,-50.0,325000,10,3650,0,0,0,0,0,0,0,0,0,0
20200312,047287,貿聯統一95購01,,,,,0.00,0.00,0,0,0,0,0,0,0,0,0,0,0,0,0
20200312,047289,啟碁統一97購01,,,,,0.00,0.00,0,0,0,0,0,0,0,0,0,0,0,0,0
20200312,04728P,美律亞東94售02,3.43,4.01,3.43,4.01,0.00,0.00,135000,3,521050,0,0,0,0,0,0,0,135000,-135000,-135000
20200312,047292,台光電元富96購01,,,,,0.00,0.00,0,0,0,0,0,0,0,0,0,0,0,0,0
20200312,047295,欣興元富96購02,0.13,0.13,0.09,0.09,-0.22,-70.97,130000,6,15300,0,0,0,0,0,0,0,130000,-130000,-130000
20200312,047296,日月光元富96購01,0.10,0.10,0.08,0.08,0.00,0.00,50000,3,4600,0,0,0,0,0,0,0,50000,-50000,-50000
20200312,047298,聯茂元富96購01,0.40,0.40,0.30,0.30,-0.21,-41.18,43000,2,13900,0,0,0,0,0,0,10000,33000,-23000,-23000
20200312,04729P,臺股指中信96售01,0.05,0.12,0.05,0.09,+0.06,200.0,2440000,14,167300,0,0,0,0,0,0,2110000,20000,2090000,2090000
20200312,047301,啟碁國泰94購01,0.02,0.02,0.02,0.02,0.00,0.00,131000,1,2620,0,0,0,0,0,0,131000,0,131000,131000
20200312,047302,為升富邦97購01,,,,,0.00,0.00,0,0,0,0,0,0,0,0,0,0,0,0,0
20200312,047303,寶滬深元大96購01,0.62,0.66,0.62,0.65,-0.21,-24.42,47000,5,29970,0,0,0,0,0,0,25000,22000,3000,3000
20200312,047304,元油2X元大96購02,,,,,0.00,0.00,0,0,0,0,0,0,0,0,0,0,0,0,0
20200312,04730P,臺股指中信96售02,0.58,0.92,0.58,0.92,+0.47,104.44,287000,15,226290,0,0,0,0,0,0,142000,145000,-3000,-3000
20200312,047316,大立光元大94購01,0.42,0.42,0.25,0.25,-1.02,-80.31,310000,6,89900,0,0,0,0,0,0,10000,300000,-290000,-290000
20200312,04731P,臺股指中信96售03,1.16,1.48,1.16,1.39,+0.43,44.79,50000,9,66050,0,0,0,0,0,0,38000,12000,26000,26000
20200312,04732P,聯茂群益94售01,1.16,1.26,1.14,1.25,+0.41,48.81,120000,4,148500,0,0,0,0,0,0,20000,100000,-80000,-80000
20200312,04733P,康控兆豐95售01,0.87,1.04,0.87,1.04,+0.21,25.3,705000,18,659940,0,0,0,0,0,0,296000,409000,-113000,-113000
20200312,047342,T50反1中信99購01,0.75,1.06,0.75,1.00,+0.35,53.85,97000,12,96850,0,0,0,0,0,0,31000,66000,-35000,-35000
20200312,047343,台達電中信95購01,0.15,0.15,0.10,0.10,-0.10,-50.0,20000,2,2500,0,0,0,0,0,0,0,20000,-20000,-20000
20200312,047345,鴻海凱基94購06,,,,,0.00,0.00,0,0,0,0,0,0,0,0,0,0,0,0,0
20200312,047348,台光電凱基94購02,,,,,0.00,0.00,0,0,0,0,0,0,0,0,0,0,0,0,0
20200312,04734P,上海銀兆豐94售02,0.84,0.89,0.84,0.89,0.00,0.00,50000,5,43500,0,0,0,0,0,0,0,50000,-50000,-50000
20200312,047350,華新科凱基94購02,,,,,0.00,0.00,0,0,0,0,0,0,0,0,0,0,0,0,0
20200312,047352,和鑫凱基94購02,,,,,0.00,0.00,0,0,0,0,0,0,0,0,0,0,0,0,0
20200312,047354,訊芯凱基94購01,,,,,0.00,0.00,0,0,0,0,0,0,0,0,0,0,0,0,0
20200312,047355,世紀鋼凱基94購01,0.90,0.90,0.69,0.81,-0.20,-19.8,165000,8,138600,0,0,0,0,0,0,115000,50000,65000,65000
20200312,047356,貿聯兆豐94購01,0.16,0.17,0.09,0.09,-0.16,-64.0,190000,15,28490,0,0,0,0,0,0,150000,40000,110000,110000
20200312,04735P,聯茂兆豐94售01,0.14,0.14,0.14,0.14,+0.04,40.0,30000,1,4200,0,0,0,0,0,0,30000,0,30000,30000
20200312,047360,鴻海群益95購02,,,,,0.00,0.00,0,0,0,0,0,0,0,0,0,0,0,0,0
20200312,047369,漢唐國票94購01,,,,,0.00,0.00,0,0,0,0,0,0,0,0,0,0,0,0,0
20200312,04736P,台積電永豐94售03,,,,,0.00,0.00,0,0,0,0,0,0,0,0,0,0,0,0,0
20200312,047372,創意國票94購01,,,,,0.00,0.00,0,0,0,0,0,0,0,0,0,0,0,0,0
20200312,047373,TPK國票94購01,,,,,0.00,0.00,0,0,0,0,0,0,0,0,0,0,0,0,0
20200312,047376,南電國票94購01,,,,,0.00,0.00,0,0,0,0,0,0,0,0,0,0,0,0,0
20200312,047379,元油2X元大96購03,,,,,0.00,0.00,0,0,0,0,0,0,0,0,0,0,0,0,0
20200312,04737P,正崴永豐94售02,,,,,0.00,0.00,0,0,0,0,0,0,0,0,0,0,0,0,0
20200312,047383,鴻海元大95購01,1.57,1.57,1.08,1.10,-0.92,-45.54,106000,17,131620,0,0,0,0,0,0,24000,92000,-68000,-68000
20200312,047385,華邦電元大94購02,,,,,0.00,0.00,0,0,0,0,0,0,0,0,0,0,0,0,0
20200312,047388,京元電元大95購01,,,,,0.00,0.00,0,0,0,0,0,0,0,0,0,0,0,0,0
20200312,047389,義隆元大94購01,0.14,0.14,0.14,0.14,-0.12,-46.15,6000,1,840,0,0,0,0,0,0,6000,0,6000,6000
20200312,04738P,揚明光永豐94售03,1.37,1.69,1.37,1.69,+0.53,45.69,39000,5,62280,0,0,0,0,0,0,9000,30000,-21000,-21000
20200312,047395,聯茂元大94購01,0.80,0.80,0.37,0.37,-0.65,-63.73,88000,3,66100,0,0,0,0,0,0,0,88000,-88000,-88000
20200312,04739P,泰鼎永豐94售02,0.04,0.04,0.04,0.04,0.00,0.00,50000,5,2000,0,0,0,0,0,0,0,50000,-50000,-50000
20200312,047402,T50反1統一94購03,,,,,0.00,0.00,0,0,0,0,0,0,0,0,0,0,0,0,0
20200312,047404,香港2X統一94購01,,,,,0.00,0.00,0,0,0,0,0,0,0,0,0,0,0,0,0
20200312,047405,香港2X統一96購01,,,,,0.00,0.00,0,0,0,0,0,0,0,0,0,0,0,0,0
20200312,047406,香港反統一94購01,0.87,0.92,0.81,0.92,+0.23,33.33,75000,8,62970,0,0,0,0,0,0,70000,0,70000,70000
20200312,047408,嘉晶統一95購01,0.38,0.42,0.25,0.28,-0.12,-30.0,730000,37,252170,0,0,0,0,0,0,287000,423000,-136000,-136000
20200312,04740P,台積電富邦95售02,0.58,0.62,0.58,0.61,+0.11,22.0,524000,4,323880,0,0,0,0,0,0,20000,504000,-484000,-484000
20200312,047410,上銀元富96購01,0.79,0.79,0.53,0.53,-0.67,-55.83,56000,11,37760,0,0,0,0,0,0,6000,50000,-44000,-44000
20200312,047416,台泥富邦94購01,,,,,0.00,0.00,0,0,0,0,0,0,0,0,0,0,0,0,0
20200312,047417,台塑富邦97購01,0.29,0.29,0.21,0.21,-0.13,-38.24,5000,2,1370,0,0,0,0,0,0,5000,0,5000,5000
20200312,047418,智邦富邦97購01,0.66,0.66,0.46,0.54,-0.12,-18.18,622000,50,360480,0,0,0,0,0,0,531000,71000,460000,460000
20200312,047419,聯發科富邦95購01,0.07,0.07,0.07,0.07,-0.06,-46.15,90000,2,6300,0,0,0,0,0,0,40000,50000,-10000,-10000
20200312,04741P,台積電統一94售10,,,,,0.00,0.00,0,0,0,0,0,0,0,0,0,0,0,0,0
20200312,047420,全新富邦97購01,,,,,0.00,0.00,0,0,0,0,0,0,0,0,0,0,0,0,0
20200312,047421,聯茂富邦97購01,0.48,0.48,0.31,0.31,-0.22,-41.51,484000,24,180420,0,0,0,0,0,0,178000,291000,-113000,-113000
20200312,047422,滬深2X兆豐94購02,,,,,0.00,0.00,0,0,0,0,0,0,0,0,0,0,0,0,0
20200312,04742P,瑞昱統一94售01,1.18,1.42,1.18,1.42,+0.57,67.06,120000,5,159120,0,0,0,0,0,0,17000,103000,-86000,-86000
20200312,047435,台積電元大94購01,3.48,3.48,2.50,3.20,-0.93,-22.52,40000,3,120300,0,0,0,0,0,0,25000,15000,10000,10000
20200312,047436,台積電元大94購02,,,,,0.00,0.00,0,0,0,0,0,0,0,0,0,0,0,0,0
20200312,047437,旺宏元大94購02,0.41,0.41,0.31,0.31,-0.29,-48.33,159000,3,63830,0,0,0,0,0,0,91000,68000,23000,23000
20200312,047439,漢唐元大95購01,1.16,1.16,1.16,1.16,-0.18,-13.43,10000,1,11600,0,0,0,0,0,0,10000,0,10000,10000
20200312,04743P,台積電元富94售07,0.40,0.40,0.34,0.34,0.00,0.00,30000,3,10900,0,0,0,0,0,0,0,30000,-30000,-30000
20200312,047443,智原元大94購01,,,,,0.00,0.00,0,0,0,0,0,0,0,0,0,0,0,0,0
20200312,047446,TPK元大94購01,,,,,0.00,0.00,0,0,0,0,0,0,0,0,0,0,0,0,0
20200312,047447,台郡元大94購02,,,,,0.00,0.00,0,0,0,0,0,0,0,0,0,0,0,0,0
20200312,04744P,臻鼎元富94售04,1.10,1.22,1.10,1.22,+0.73,148.98,355000,10,429000,0,0,0,0,0,0,35000,320000,-285000,-285000
20200312,047454,滬深2X群益96購03,0.03,0.03,0.03,0.03,-0.01,-25.0,100000,1,3000,0,0,0,0,0,0,0,0,0,0
20200312,047457,旺宏群益95購01,0.60,0.62,0.33,0.42,-0.29,-40.85,319000,13,151500,0,0,0,0,0,0,67000,252000,-185000,-185000
20200312,04745P,祥碩元大94售04,0.08,0.11,0.08,0.11,0.00,0.00,130000,3,11000,0,0,0,0,0,0,30000,100000,-70000,-70000
20200312,047460,富邦金群益95購01,,,,,0.00,0.00,0,0,0,0,0,0,0,0,0,0,0,0,0
20200312,047465,滬深2X國泰94購01,,,,,0.00,0.00,0,0,0,0,0,0,0,0,0,0,0,0,0
20200312,047466,新光金國泰95購01,0.11,0.11,0.11,0.11,-0.06,-35.29,10000,1,1100,0,0,0,0,0,0,0,10000,-10000,-10000
20200312,047467,滬深2X中信95購06,,,,,0.00,0.00,0,0,0,0,0,0,0,0,0,0,0,0,0
20200312,047468,為升中信95購01,,,,,0.00,0.00,0,0,0,0,0,0,0,0,0,0,0,0,0
20200312,04746P,臺股指元大94售17,3.70,3.70,3.70,3.70,0.00,0.00,10000,1,37000,0,0,0,0,0,0,0,10000,-10000,-10000
20200312,047470,聯發科中信94購03,,,,,0.00,0.00,0,0,0,0,0,0,0,0,0,0,0,0,0
20200312,047476,鴻海凱基94購08,0.88,0.88,0.88,0.88,-0.94,-51.65,10000,1,8800,0,0,0,0,0,0,10000,0,10000,10000
20200312,047479,美律凱基94購01,,,,,0.00,0.00,0,0,0,0,0,0,0,0,0,0,0,0,0
20200312,04747P,臺股指元大94售22,2.37,3.60,2.37,3.36,+1.38,69.7,61000,12,203570,0,0,0,0,0,0,55000,0,55000,55000
20200312,047482,新光金凱基99購03,0.37,0.37,0.37,0.37,0.00,0.00,230000,2,85100,0,0,0,0,0,0,230000,0,230000,230000
20200312,047483,新光金凱基99購04,0.32,0.32,0.29,0.30,-0.07,-18.92,1120000,7,341600,0,0,0,0,0,0,550000,570000,-20000,-20000
20200312,047485,景碩凱基94購01,,,,,0.00,0.00,0,0,0,0,0,0,0,0,0,0,0,0,0
20200312,047486,上海銀凱基94購01,,,,,0.00,0.00,0,0,0,0,0,0,0,0,0,0,0,0,0
20200312,047487,南電凱基94購01,0.45,0.45,0.45,0.45,-0.37,-45.12,5000,1,2250,0,0,0,0,0,0,5000,0,5000,5000
20200312,04748P,臺股指元大94售23,2.39,4.08,2.39,4.08,+2.30,129.21,240000,6,609900,0,0,0,0,0,0,240000,0,240000,240000
20200312,047491,旺宏統一94購03,0.48,0.48,0.21,0.22,-0.75,-77.32,43000,4,11360,0,0,0,0,0,0,0,43000,-43000,-43000
20200312,047493,旺宏元富96購01,0.30,0.32,0.30,0.32,0.00,0.00,100000,2,31000,0,0,0,0,0,0,0,100000,-100000,-100000
20200312,047494,華邦電元富96購01,0.15,0.15,0.14,0.14,-0.18,-56.25,50000,3,7200,0,0,0,0,0,0,20000,30000,-10000,-10000
20200312,047495,新日興元富96購01,0.61,0.61,0.42,0.42,-0.36,-46.15,237000,5,131120,0,0,0,0,0,0,217000,20000,197000,197000
20200312,04749P,臺股指元大94售25,1.55,3.00,1.55,3.00,0.00,0.00,80000,9,174700,0,0,0,0,0,0,80000,0,80000,80000
20200312,047504,滬深2X國票9A購01,0.17,0.17,0.12,0.14,-0.04,-22.22,1365000,16,201590,0,0,0,0,0,0,35000,1330000,-1295000,-1295000
20200312,047505,元金2X國票9B購01,0.83,0.83,0.72,0.73,-0.22,-23.16,3360000,54,2510080,0,0,0,0,0,0,248000,3111000,-2863000,-2863000
20200312,047508,旺宏國票94購01,0.98,0.98,0.97,0.97,0.00,0.00,2000,2,1950,0,0,0,0,0,0,0,2000,-2000,-2000
20200312,04750P,臺股指元大94售26,2.29,2.51,2.29,2.51,+0.41,19.52,6000,3,14430,0,0,0,0,0,0,6000,0,6000,6000
20200312,047510,奇力新國票94購01,,,,,0.00,0.00,0,0,0,0,0,0,0,0,0,0,0,0,0
20200312,047512,宏達電國票94購01,0.01,0.01,0.01,0.01,0.00,0.00,1497000,3,14970,0,0,0,0,0,0,998000,0,998000,998000
20200312,047514,亞光國票94購01,,,,,0.00,0.00,0,0,0,0,0,0,0,0,0,0,0,0,0
20200312,047515,智易國票94購01,,,,,0.00,0.00,0,0,0,0,0,0,0,0,0,0,0,0,0
20200312,047516,深中小第一93購01,,,,,0.00,0.00,0,0,0,0,0,0,0,0,0,0,0,0,0
20200312,047517,元油反元大96購01,,,,,0.00,0.00,0,0,0,0,0,0,0,0,0,0,0,0,0
20200312,047518,儒鴻元大93購07,,,,,0.00,0.00,0,0,0,0,0,0,0,0,0,0,0,0,0
20200312,047519,台達電元大93購02,,,,,0.00,0.00,0,0,0,0,0,0,0,0,0,0,0,0,0
20200312,04751P,智邦兆豐95售02,1.09,1.22,1.08,1.17,+0.17,17.0,581000,33,671800,0,0,0,0,0,0,220000,340000,-120000,-120000
20200312,047520,鴻海元大93購17,,,,,0.00,0.00,0,0,0,0,0,0,0,0,0,0,0,0,0
20200312,047521,台積電元大94購03,1.90,1.90,1.63,1.63,-1.07,-39.63,55000,4,92350,0,0,0,0,0,0,0,55000,-55000,-55000
20200312,047522,微星元大93購02,,,,,0.00,0.00,0,0,0,0,0,0,0,0,0,0,0,0,0
20200312,047523,瑞昱元大93購09,,,,,0.00,0.00,0,0,0,0,0,0,0,0,0,0,0,0,0
20200312,047524,瑞昱元大93購10,,,,,0.00,0.00,0,0,0,0,0,0,0,0,0,0,0,0,0
20200312,047525,漢唐元大93購04,,,,,0.00,0.00,0,0,0,0,0,0,0,0,0,0,0,0,0
20200312,047526,可成元大93購08,,,,,0.00,0.00,0,0,0,0,0,0,0,0,0,0,0,0,0
20200312,047527,高鐵元大93購02,,,,,0.00,0.00,0,0,0,0,0,0,0,0,0,0,0,0,0
20200312,047528,高鐵元大93購03,,,,,0.00,0.00,0,0,0,0,0,0,0,0,0,0,0,0,0
20200312,047529,嘉晶元大94購02,0.56,0.64,0.45,0.45,-0.20,-30.77,495000,7,278150,0,0,0,0,0,0,195000,300000,-105000,-105000
20200312,04752P,大立光群益94售07,,,,,0.00,0.00,0,0,0,0,0,0,0,0,0,0,0,0,0
20200312,047530,智伸科元大93購04,,,,,0.00,0.00,0,0,0,0,0,0,0,0,0,0,0,0,0
20200312,047531,新唐元大93購02,,,,,0.00,0.00,0,0,0,0,0,0,0,0,0,0,0,0,0
20200312,047532,上海銀元大93購02,,,,,0.00,0.00,0,0,0,0,0,0,0,0,0,0,0,0,0
20200312,047533,瑞儀元大93購02,,,,,0.00,0.00,0,0,0,0,0,0,0,0,0,0,0,0,0
20200312,047534,聯茂元大93購05,,,,,0.00,0.00,0,0,0,0,0,0,0,0,0,0,0,0,0
20200312,047535,台光電日盛93購01,0.01,0.01,0.01,0.01,0.00,0.00,290000,4,2900,0,0,0,0,0,0,289000,0,289000,289000
20200312,047536,正崴日盛93購01,,,,,0.00,0.00,0,0,0,0,0,0,0,0,0,0,0,0,0
20200312,047537,聯發科日盛93購01,,,,,0.00,0.00,0,0,0,0,0,0,0,0,0,0,0,0,0
20200312,047538,訊芯日盛93購01,,,,,0.00,0.00,0,0,0,0,0,0,0,0,0,0,0,0,0
20200312,047539,鴻海麥證93購01,,,,,0.00,0.00,0,0,0,0,0,0,0,0,0,0,0,0,0
20200312,04753P,台積電統一94售11,0.37,0.60,0.37,0.60,+0.35,140.0,32000,2,12300,0,0,0,0,0,0,30000,2000,28000,28000
20200312,047540,技嘉麥證93購01,,,,,0.00,0.00,0,0,0,0,0,0,0,0,0,0,0,0,0
20200312,047541,深中小凱基94購01,1.08,1.08,1.07,1.07,-0.50,-31.85,11000,2,11780,0,0,0,0,0,0,0,11000,-11000,-11000
20200312,047542,華通凱基94購02,0.13,0.13,0.13,0.13,-0.06,-31.58,174000,3,22620,0,0,0,0,0,0,174000,0,174000,174000
20200312,047543,鴻海凱基94購09,0.37,0.37,0.33,0.35,-0.56,-61.54,380000,3,131400,0,0,0,0,0,0,0,380000,-380000,-380000
20200312,047544,台積電凱基93購17,,,,,0.00,0.00,0,0,0,0,0,0,0,0,0,0,0,0,0
20200312,047545,智邦凱基93購05,,,,,0.00,0.00,0,0,0,0,0,0,0,0,0,0,0,0,0
20200312,047546,瑞昱凱基93購06,,,,,0.00,0.00,0,0,0,0,0,0,0,0,0,0,0,0,0
20200312,047547,友達凱基99購02,0.70,0.70,0.56,0.56,-0.39,-41.05,153000,16,100680,0,0,0,0,0,0,0,153000,-153000,-153000
20200312,047548,友達凱基99購03,0.52,0.52,0.40,0.40,-0.24,-37.5,130000,13,64300,0,0,0,0,0,0,0,130000,-130000,-130000
20200312,047549,聯發科凱基93購12,,,,,0.00,0.00,0,0,0,0,0,0,0,0,0,0,0,0,0
20200312,04754P,宏達電元富94售02,1.34,1.79,1.34,1.79,+0.49,37.69,157000,12,242520,0,0,0,0,0,0,29000,128000,-99000,-99000
20200312,047550,聯發科凱基93購13,,,,,0.00,0.00,0,0,0,0,0,0,0,0,0,0,0,0,0
20200312,047551,聯發科凱基93購14,,,,,0.00,0.00,0,0,0,0,0,0,0,0,0,0,0,0,0
20200312,047552,潤泰全凱基94購02,,,,,0.00,0.00,0,0,0,0,0,0,0,0,0,0,0,0,0
20200312,047553,大立光凱基93購21,0.86,0.86,0.36,0.36,-1.32,-78.57,46000,8,25980,0,0,0,0,0,0,12000,34000,-22000,-22000
20200312,047554,聯詠凱基93購04,,,,,0.00,0.00,0,0,0,0,0,0,0,0,0,0,0,0,0
20200312,047555,欣興凱基93購01,,,,,0.00,0.00,0,0,0,0,0,0,0,0,0,0,0,0,0
20200312,047556,群創凱基95購01,0.24,0.24,0.24,0.24,-0.24,-50.0,200000,2,48000,0,0,0,0,0,0,101000,99000,2000,2000
20200312,047557,麗豐凱基94購02,,,,,0.00,0.00,0,0,0,0,0,0,0,0,0,0,0,0,0
20200312,047558,臻鼎凱基93購06,,,,,0.00,0.00,0,0,0,0,0,0,0,0,0,0,0,0,0
20200312,047559,彩晶凱基94購03,,,,,0.00,0.00,0,0,0,0,0,0,0,0,0,0,0,0,0
20200312,04755P,大立光元富94售07,,,,,0.00,0.00,0,0,0,0,0,0,0,0,0,0,0,0,0
20200312,047560,超眾凱基94購01,,,,,0.00,0.00,0,0,0,0,0,0,0,0,0,0,0,0,0
20200312,047561,啟碁凱基93購03,,,,,0.00,0.00,0,0,0,0,0,0,0,0,0,0,0,0,0
20200312,047562,志超凱基94購01,,,,,0.00,0.00,0,0,0,0,0,0,0,0,0,0,0,0,0
20200312,047563,柏文凱基93購02,,,,,0.00,0.00,0,0,0,0,0,0,0,0,0,0,0,0,0
20200312,047564,滬深2X國票99購01,,,,,0.00,0.00,0,0,0,0,0,0,0,0,0,0,0,0,0
20200312,047565,美律國票93購02,,,,,0.00,0.00,0,0,0,0,0,0,0,0,0,0,0,0,0
20200312,047566,華新科國票94購02,2.79,2.79,2.79,2.79,0.00,0.00,50000,1,139500,0,0,0,0,0,0,0,50000,-50000,-50000
20200312,047567,欣興國票93購05,,,,,0.00,0.00,0,0,0,0,0,0,0,0,0,0,0,0,0
20200312,047568,創意國票93購03,,,,,0.00,0.00,0,0,0,0,0,0,0,0,0,0,0,0,0
20200312,047569,世紀鋼國票94購02,0.83,0.83,0.70,0.70,-0.27,-27.84,50000,2,38900,0,0,0,0,0,0,30000,20000,10000,10000
20200312,04756P,大立光元富94售08,2.38,3.14,2.38,3.14,+1.65,110.74,63000,9,166660,0,0,0,0,0,0,42000,21000,21000,21000
20200312,047570,元上證群益93購02,,,,,0.00,0.00,0,0,0,0,0,0,0,0,0,0,0,0,0
20200312,047571,滬深2X群益99購01,0.16,0.16,0.11,0.13,-0.05,-27.78,1558000,28,216860,0,0,0,0,0,0,175000,1383000,-1208000,-1208000
20200312,047572,深中小群益95購01,0.74,0.74,0.67,0.67,-0.30,-30.93,30000,3,21200,0,0,0,0,0,0,0,30000,-30000,-30000
20200312,047573,儒鴻群益93購04,,,,,0.00,0.00,0,0,0,0,0,0,0,0,0,0,0,0,0
20200312,047574,和大群益93購03,,,,,0.00,0.00,0,0,0,0,0,0,0,0,0,0,0,0,0
20200312,047575,台積電群益93購08,,,,,0.00,0.00,0,0,0,0,0,0,0,0,0,0,0,0,0
20200312,047576,技嘉群益94購01,0.28,0.28,0.22,0.22,-0.20,-47.62,39000,4,10450,0,0,0,0,0,0,39000,0,39000,39000
20200312,047577,宏達電群益93購03,,,,,0.00,0.00,0,0,0,0,0,0,0,0,0,0,0,0,0
20200312,047578,新光金群益93購01,,,,,0.00,0.00,0,0,0,0,0,0,0,0,0,0,0,0,0
20200312,047579,大立光群益94購02,1.84,1.84,1.35,1.36,0.00,0.00,13000,4,18150,0,0,0,0,0,0,0,13000,-13000,-13000
20200312,04757P,元油2X凱基94售04,5.95,6.15,5.95,6.15,0.00,0.00,1800000,18,10920000,0,0,0,0,0,0,1800000,1500000,300000,300000
20200312,047580,TPK群益94購01,,,,,0.00,0.00,0,0,0,0,0,0,0,0,0,0,0,0,0
20200312,047581,康控台新93購01,,,,,0.00,0.00,0,0,0,0,0,0,0,0,0,0,0,0,0
20200312,047582,滬深2X永豐95購02,,,,,0.00,0.00,0,0,0,0,0,0,0,0,0,0,0,0,0
20200312,047583,深中小永豐94購01,,,,,0.00,0.00,0,0,0,0,0,0,0,0,0,0,0,0,0
20200312,047584,元金2X永豐95購01,0.64,0.64,0.44,0.49,-0.22,-30.99,1165000,24,548090,0,0,0,0,0,0,891000,233000,658000,658000
20200312,047585,微星永豐93購01,,,,,0.00,0.00,0,0,0,0,0,0,0,0,0,0,0,0,0
20200312,047586,聯發科永豐94購01,,,,,0.00,0.00,0,0,0,0,0,0,0,0,0,0,0,0,0
20200312,047587,義隆永豐93購02,,,,,0.00,0.00,0,0,0,0,0,0,0,0,0,0,0,0,0
20200312,047588,大立光永豐94購01,,,,,0.00,0.00,0,0,0,0,0,0,0,0,0,0,0,0,0
20200312,047589,奇鋐永豐93購01,,,,,0.00,0.00,0,0,0,0,0,0,0,0,0,0,0,0,0
20200312,04758P,國巨凱基94售03,,,,,0.00,0.00,0,0,0,0,0,0,0,0,0,0,0,0,0
20200312,047590,健策永豐93購01,,,,,0.00,0.00,0,0,0,0,0,0,0,0,0,0,0,0,0
20200312,047591,訊芯永豐93購02,,,,,0.00,0.00,0,0,0,0,0,0,0,0,0,0,0,0,0
20200312,047592,長華永豐93購01,,,,,0.00,0.00,0,0,0,0,0,0,0,0,0,0,0,0,0
20200312,047593,百和永豐93購02,,,,,0.00,0.00,0,0,0,0,0,0,0,0,0,0,0,0,0
20200312,047594,滬深2X元富93購02,,,,,0.00,0.00,0,0,0,0,0,0,0,0,0,0,0,0,0
20200312,047595,元石油元富97購01,,,,,0.00,0.00,0,0,0,0,0,0,0,0,0,0,0,0,0
20200312,047596,元油反元富97購01,,,,,0.00,0.00,0,0,0,0,0,0,0,0,0,0,0,0,0
20200312,047597,滬深2X統一93購03,,,,,0.00,0.00,0,0,0,0,0,0,0,0,0,0,0,0,0
20200312,047598,深中小統一94購01,,,,,0.00,0.00,0,0,0,0,0,0,0,0,0,0,0,0,0
20200312,047599,大立光統一93購08,,,,,0.00,0.00,0,0,0,0,0,0,0,0,0,0,0,0,0
20200312,04759P,台積電凱基94售27,0.30,0.30,0.30,0.30,+0.08,36.36,3000,1,900,0,0,0,0,0,0,3000,0,3000,3000
20200312,047600,富邦金中信93購01,,,,,0.00,0.00,0,0,0,0,0,0,0,0,0,0,0,0,0
20200312,047601,上海銀中信93購01,,,,,0.00,0.00,0,0,0,0,0,0,0,0,0,0,0,0,0
20200312,047602,GIS中信93購02,,,,,0.00,0.00,0,0,0,0,0,0,0,0,0,0,0,0,0
20200312,047603,瑞昱國泰94購01,0.66,0.66,0.49,0.60,0.00,0.00,54000,5,30600,0,0,0,0,0,0,5000,49000,-44000,-44000
20200312,047604,智原國泰95購01,0.03,0.03,0.03,0.03,0.00,0.00,10000,2,300,0,0,0,0,0,0,0,10000,-10000,-10000
20200312,047605,滬深2X富邦93購03,,,,,0.00,0.00,0,0,0,0,0,0,0,0,0,0,0,0,0
20200312,047606,元油反富邦94購01,,,,,0.00,0.00,0,0,0,0,0,0,0,0,0,0,0,0,0
20200312,047607,上海銀富邦93購01,,,,,0.00,0.00,0,0,0,0,0,0,0,0,0,0,0,0,0
20200312,047608,聯發科第一95購01,0.12,0.12,0.12,0.12,0.00,0.00,10000,1,1200,0,0,0,0,0,0,0,10000,-10000,-10000
20200312,047609,奇力新第一93購01,0.24,0.24,0.24,0.24,-0.97,-80.17,10000,1,2400,0,0,0,0,0,0,10000,0,10000,10000
20200312,04760P,旺宏凱基94售02,,,,,0.00,0.00,0,0,0,0,0,0,0,0,0,0,0,0,0
20200312,047610,致伸第一93購01,,,,,0.00,0.00,0,0,0,0,0,0,0,0,0,0,0,0,0
20200312,047611,滬深2X群益93購02,,,,,0.00,0.00,0,0,0,0,0,0,0,0,0,0,0,0,0
20200312,047612,瑞昱群益93購03,0.04,0.04,0.04,0.04,0.00,0.00,30000,1,1200,0,0,0,0,0,0,30000,0,30000,30000
20200312,047613,健策群益93購02,,,,,0.00,0.00,0,0,0,0,0,0,0,0,0,0,0,0,0
20200312,047614,台郡群益93購02,,,,,0.00,0.00,0,0,0,0,0,0,0,0,0,0,0,0,0
20200312,047615,為升凱基93購05,,,,,0.00,0.00,0,0,0,0,0,0,0,0,0,0,0,0,0
20200312,047616,鴻海凱基94購10,,,,,0.00,0.00,0,0,0,0,0,0,0,0,0,0,0,0,0
20200312,047617,瑞昱凱基93購07,,,,,0.00,0.00,0,0,0,0,0,0,0,0,0,0,0,0,0
20200312,047618,義隆凱基94購02,0.38,0.38,0.30,0.30,-0.36,-54.55,20000,2,6800,0,0,0,0,0,0,10000,10000,0,0
20200312,047619,大立光凱基93購22,0.65,0.65,0.65,0.65,0.00,0.00,20000,2,13000,0,0,0,0,0,0,0,20000,-20000,-20000
20200312,04761P,可成凱基94售09,1.98,1.98,1.98,1.98,0.00,0.00,90000,2,178200,0,0,0,0,0,0,0,90000,-90000,-90000
20200312,047620,貿聯凱基93購01,,,,,0.00,0.00,0,0,0,0,0,0,0,0,0,0,0,0,0
20200312,047621,TPK凱基94購01,,,,,0.00,0.00,0,0,0,0,0,0,0,0,0,0,0,0,0
20200312,047622,中磊凱基93購02,,,,,0.00,0.00,0,0,0,0,0,0,0,0,0,0,0,0,0
20200312,047623,世紀鋼凱基94購02,0.63,0.63,0.55,0.56,-0.10,-15.15,400000,12,229720,0,0,0,0,0,0,298000,102000,196000,196000
20200312,047624,台達電國票93購01,,,,,0.00,0.00,0,0,0,0,0,0,0,0,0,0,0,0,0
20200312,047625,友達國票94購01,,,,,0.00,0.00,0,0,0,0,0,0,0,0,0,0,0,0,0
20200312,047626,全新國票94購01,0.12,0.12,0.12,0.12,0.00,0.00,5000,1,600,0,0,0,0,0,0,5000,0,5000,5000
20200312,047627,華新科國票94購03,1.24,1.47,1.24,1.47,-2.75,-65.17,8000,2,10150,0,0,0,0,0,0,1000,7000,-6000,-6000
20200312,047628,新光金國票95購02,0.06,0.06,0.06,0.06,-0.05,-45.45,20000,1,1200,0,0,0,0,0,0,0,20000,-20000,-20000
20200312,047629,深中小元大96購01,0.74,0.74,0.69,0.71,-0.24,-25.26,590000,44,418200,0,0,0,0,0,0,200000,390000,-190000,-190000
20200312,04762P,聯詠凱基94售03,0.31,0.31,0.31,0.31,0.00,0.00,10000,1,3100,0,0,0,0,0,0,10000,0,10000,10000
20200312,047630,元油反元大96購02,3.50,4.70,3.50,4.61,+1.56,51.15,70000,13,309260,0,0,0,0,0,0,38000,32000,6000,6000
20200312,047631,味全元大93購01,,,,,0.00,0.00,0,0,0,0,0,0,0,0,0,0,0,0,0
20200312,047632,儒鴻元大93購08,,,,,0.00,0.00,0,0,0,0,0,0,0,0,0,0,0,0,0
20200312,047633,力山元大94購01,,,,,0.00,0.00,0,0,0,0,0,0,0,0,0,0,0,0,0
20200312,047634,亞德客元大93購01,,,,,0.00,0.00,0,0,0,0,0,0,0,0,0,0,0,0,0
20200312,047635,華新元大93購01,,,,,0.00,0.00,0,0,0,0,0,0,0,0,0,0,0,0,0
20200312,047636,台達電元大93購03,,,,,0.00,0.00,0,0,0,0,0,0,0,0,0,0,0,0,0
20200312,047637,旺宏元大94購03,,,,,0.00,0.00,0,0,0,0,0,0,0,0,0,0,0,0,0
20200312,047638,瑞昱元大93購11,,,,,0.00,0.00,0,0,0,0,0,0,0,0,0,0,0,0,0
20200312,047639,聯發科元大93購16,,,,,0.00,0.00,0,0,0,0,0,0,0,0,0,0,0,0,0
20200312,04763P,臺股指凱基96售05,0.55,0.89,0.52,0.80,+0.37,86.05,1234000,53,771830,0,0,0,0,0,0,1171000,5000,1166000,1166000
20200312,047640,聯發科元大93購17,,,,,0.00,0.00,0,0,0,0,0,0,0,0,0,0,0,0,0
20200312,047641,可成元大93購09,,,,,0.00,0.00,0,0,0,0,0,0,0,0,0,0,0,0,0
20200312,047642,宏達電元大93購08,,,,,0.00,0.00,0,0,0,0,0,0,0,0,0,0,0,0,0
20200312,047643,新光金元大95購02,,,,,0.00,0.00,0,0,0,0,0,0,0,0,0,0,0,0,0
20200312,047644,揚明光元大94購02,,,,,0.00,0.00,0,0,0,0,0,0,0,0,0,0,0,0,0
20200312,047645,健策元大93購03,,,,,0.00,0.00,0,0,0,0,0,0,0,0,0,0,0,0,0
20200312,047646,貿聯元大94購01,,,,,0.00,0.00,0,0,0,0,0,0,0,0,0,0,0,0,0
20200312,047647,麗豐元大93購03,,,,,0.00,0.00,0,0,0,0,0,0,0,0,0,0,0,0,0
20200312,047648,智伸科元大93購05,,,,,0.00,0.00,0,0,0,0,0,0,0,0,0,0,0,0,0
20200312,047649,啟碁元大93購07,,,,,0.00,0.00,0,0,0,0,0,0,0,0,0,0,0,0,0
20200312,04764P,台光電台新94售01,0.47,0.60,0.47,0.56,0.00,0.00,430000,7,229800,0,0,0,0,0,0,30000,400000,-370000,-370000
20200312,047650,矽力元大93購01,,,,,0.00,0.00,0,0,0,0,0,0,0,0,0,0,0,0,0
20200312,047651,復盛元大93購01,,,,,0.00,0.00,0,0,0,0,0,0,0,0,0,0,0,0,0
20200312,047652,滬深2X兆豐94購03,,,,,0.00,0.00,0,0,0,0,0,0,0,0,0,0,0,0,0
20200312,047653,上銀兆豐94購01,,,,,0.00,0.00,0,0,0,0,0,0,0,0,0,0,0,0,0
20200312,047654,鴻海兆豐93購01,,,,,0.00,0.00,0,0,0,0,0,0,0,0,0,0,0,0,0
20200312,047655,聯發科兆豐93購02,,,,,0.00,0.00,0,0,0,0,0,0,0,0,0,0,0,0,0
20200312,047656,聯詠兆豐93購02,0.52,0.54,0.52,0.54,-0.35,-39.33,31000,2,16500,0,0,0,0,0,0,12000,0,12000,12000
20200312,047657,智易兆豐94購02,,,,,0.00,0.00,0,0,0,0,0,0,0,0,0,0,0,0,0
20200312,047658,全新麥證93購02,,,,,0.00,0.00,0,0,0,0,0,0,0,0,0,0,0,0,0
20200312,047659,大立光麥證93購01,,,,,0.00,0.00,0,0,0,0,0,0,0,0,0,0,0,0,0
20200312,04765P,宏達電永豐94售02,0.50,0.50,0.50,0.50,0.00,0.00,20000,2,10000,0,0,0,0,0,0,0,20000,-20000,-20000
20200312,047660,南茂麥證93購02,,,,,0.00,0.00,0,0,0,0,0,0,0,0,0,0,0,0,0
20200312,047661,滬深2X永豐96購01,,,,,0.00,0.00,0,0,0,0,0,0,0,0,0,0,0,0,0
20200312,047662,東陽永豐93購01,,,,,0.00,0.00,0,0,0,0,0,0,0,0,0,0,0,0,0
20200312,047663,亞德客永豐93購03,,,,,0.00,0.00,0,0,0,0,0,0,0,0,0,0,0,0,0
20200312,047664,智邦永豐93購02,,,,,0.00,0.00,0,0,0,0,0,0,0,0,0,0,0,0,0
20200312,047665,智易永豐93購02,,,,,0.00,0.00,0,0,0,0,0,0,0,0,0,0,0,0,0
20200312,047666,利勤永豐93購02,,,,,0.00,0.00,0,0,0,0,0,0,0,0,0,0,0,0,0
20200312,047667,新唐永豐93購02,,,,,0.00,0.00,0,0,0,0,0,0,0,0,0,0,0,0,0
20200312,047668,聯茂永豐93購02,,,,,0.00,0.00,0,0,0,0,0,0,0,0,0,0,0,0,0
20200312,047669,台表科永豐93購02,,,,,0.00,0.00,0,0,0,0,0,0,0,0,0,0,0,0,0
20200312,04766P,緯穎永豐94售02,,,,,0.00,0.00,0,0,0,0,0,0,0,0,0,0,0,0,0
20200312,047670,矽力永豐93購01,1.15,1.15,1.15,1.15,-0.78,-40.41,10000,1,11500,0,0,0,0,0,0,10000,0,10000,10000
20200312,047671,T50反1統一93購04,,,,,0.00,0.00,0,0,0,0,0,0,0,0,0,0,0,0,0
20200312,047672,欣興統一93購03,,,,,0.00,0.00,0,0,0,0,0,0,0,0,0,0,0,0,0
20200312,047673,瑞昱元富96購01,0.26,0.26,0.26,0.26,-0.27,-50.94,40000,1,10400,0,0,0,0,0,0,40000,0,40000,40000
20200312,047674,群創元富96購02,0.54,0.54,0.54,0.54,0.00,0.00,40000,4,21600,0,0,0,0,0,0,0,40000,-40000,-40000
20200312,047675,群創元富96購03,,,,,0.00,0.00,0,0,0,0,0,0,0,0,0,0,0,0,0
20200312,047676,臺股指元富99購01,0.18,0.18,0.18,0.18,0.00,0.00,1000,1,180,0,0,0,0,0,0,0,1000,-1000,-1000
20200312,047677,亞德客台新93購01,,,,,0.00,0.00,0,0,0,0,0,0,0,0,0,0,0,0,0
20200312,047678,景碩台新93購01,,,,,0.00,0.00,0,0,0,0,0,0,0,0,0,0,0,0,0
20200312,047679,中磊台新93購01,,,,,0.00,0.00,0,0,0,0,0,0,0,0,0,0,0,0,0
20200312,04767P,台積電國泰95售04,1.38,1.80,1.38,1.80,+0.66,57.89,12000,6,18880,0,0,0,0,0,0,12000,0,12000,12000
20200312,047680,上証反中信96購01,0.42,0.42,0.42,0.42,0.00,0.00,200000,1,84000,0,0,0,0,0,0,0,200000,-200000,-200000
20200312,047681,滬深反中信95購01,0.51,0.59,0.51,0.55,+0.12,27.91,797000,28,444540,0,0,0,0,0,0,392000,395000,-3000,-3000
20200312,047682,滬深2X國泰94購02,,,,,0.00,0.00,0,0,0,0,0,0,0,0,0,0,0,0,0
20200312,047683,亞德客國泰95購01,,,,,0.00,0.00,0,0,0,0,0,0,0,0,0,0,0,0,0
20200312,047684,景碩國泰94購01,,,,,0.00,0.00,0,0,0,0,0,0,0,0,0,0,0,0,0
20200312,047685,嘉聯益國泰95購01,,,,,0.00,0.00,0,0,0,0,0,0,0,0,0,0,0,0,0
20200312,047686,元油反富邦94購02,,,,,0.00,0.00,0,0,0,0,0,0,0,0,0,0,0,0,0
20200312,047687,元金2X富邦96購01,2.09,2.09,2.08,2.08,-0.37,-15.1,25000,2,52200,0,0,0,0,0,0,0,25000,-25000,-25000
20200312,047688,亞德客富邦95購01,,,,,0.00,0.00,0,0,0,0,0,0,0,0,0,0,0,0,0
20200312,047689,瑞昱富邦97購01,0.51,0.51,0.38,0.42,-0.28,-40.0,123000,4,48090,0,0,0,0,0,0,0,123000,-123000,-123000
20200312,04768P,大立光國泰96售03,1.76,1.95,1.74,1.95,+0.58,42.34,562000,16,1034580,0,0,0,0,0,0,376000,189000,187000,187000
20200312,047690,美律富邦97購01,,,,,0.00,0.00,0,0,0,0,0,0,0,0,0,0,0,0,0
20200312,047691,群創第一93購01,,,,,0.00,0.00,0,0,0,0,0,0,0,0,0,0,0,0,0
20200312,047692,T50反1國票94購01,0.56,1.00,0.56,0.78,0.00,0.00,168000,18,129370,0,0,0,0,0,0,168000,70000,98000,98000
20200312,047693,T50反1國票95購01,0.45,0.45,0.45,0.45,0.00,0.00,1000,1,450,0,0,0,0,0,0,1000,0,1000,1000
20200312,047694,SP黃豆國票9B購01,0.30,0.30,0.30,0.30,-0.05,-14.29,2000,2,600,0,0,0,0,0,0,2000,0,2000,2000
20200312,047695,聯發科國票93購06,,,,,0.00,0.00,0,0,0,0,0,0,0,0,0,0,0,0,0
20200312,047696,聯發科國票94購02,,,,,0.00,0.00,0,0,0,0,0,0,0,0,0,0,0,0,0
20200312,047697,台郡國票94購02,2.31,2.31,1.61,1.61,-1.73,-51.8,77000,4,140070,0,0,0,0,0,0,27000,50000,-23000,-23000
20200312,047698,瑞儀日盛93購01,,,,,0.00,0.00,0,0,0,0,0,0,0,0,0,0,0,0,0
20200312,047699,亞德客凱基93購04,,,,,0.00,0.00,0,0,0,0,0,0,0,0,0,0,0,0,0
20200312,04769P,高股息元大94售01,0.57,0.62,0.57,0.62,0.00,0.00,4000,2,2430,0,0,0,0,0,0,1000,3000,-2000,-2000
20200312,047700,華新凱基94購01,,,,,0.00,0.00,0,0,0,0,0,0,0,0,0,0,0,0,0
20200312,047701,鴻海凱基94購12,1.32,1.32,1.28,1.28,-1.00,-43.86,2000,2,2600,0,0,0,0,0,0,2000,2000,0,0
20200312,047702,鴻海凱基94購13,,,,,0.00,0.00,0,0,0,0,0,0,0,0,0,0,0,0,0
20200312,047703,台積電凱基93購19,,,,,0.00,0.00,0,0,0,0,0,0,0,0,0,0,0,0,0
20200312,047704,智邦凱基93購06,,,,,0.00,0.00,0,0,0,0,0,0,0,0,0,0,0,0,0
20200312,047705,燿華凱基94購01,,,,,0.00,0.00,0,0,0,0,0,0,0,0,0,0,0,0,0
20200312,047706,燿華凱基95購01,,,,,0.00,0.00,0,0,0,0,0,0,0,0,0,0,0,0,0
20200312,047707,南亞科凱基93購03,,,,,0.00,0.00,0,0,0,0,0,0,0,0,0,0,0,0,0
20200312,047708,聯發科凱基93購17,,,,,0.00,0.00,0,0,0,0,0,0,0,0,0,0,0,0,0
20200312,047709,聯發科凱基93購18,,,,,0.00,0.00,0,0,0,0,0,0,0,0,0,0,0,0,0
20200312,04770P,鴻海元大94售09,0.07,0.10,0.07,0.10,0.00,0.00,400000,2,34000,0,0,0,0,0,0,400000,0,400000,400000
20200312,047710,聯發科凱基93購21,,,,,0.00,0.00,0,0,0,0,0,0,0,0,0,0,0,0,0
20200312,047711,華新科凱基94購03,0.85,0.85,0.64,0.78,-1.02,-56.67,35000,4,26950,0,0,0,0,0,0,10000,35000,-25000,-25000
20200312,047712,宏達電凱基93購01,,,,,0.00,0.00,0,0,0,0,0,0,0,0,0,0,0,0,0
20200312,047713,大立光凱基93購24,,,,,0.00,0.00,0,0,0,0,0,0,0,0,0,0,0,0,0
20200312,047714,禾伸堂凱基93購03,,,,,0.00,0.00,0,0,0,0,0,0,0,0,0,0,0,0,0
20200312,047715,欣興凱基93購02,,,,,0.00,0.00,0,0,0,0,0,0,0,0,0,0,0,0,0
20200312,047716,晶技凱基93購03,,,,,0.00,0.00,0,0,0,0,0,0,0,0,0,0,0,0,0
20200312,047717,致伸凱基93購04,,,,,0.00,0.00,0,0,0,0,0,0,0,0,0,0,0,0,0
20200312,047718,達興凱基94購01,,,,,0.00,0.00,0,0,0,0,0,0,0,0,0,0,0,0,0
20200312,047719,聯茂凱基94購01,0.05,0.05,0.05,0.05,-0.05,-50.0,30000,1,1500,0,0,0,0,0,0,0,0,0,0
20200312,04771P,友達元大96售02,0.49,0.67,0.49,0.67,+0.21,45.65,148000,6,86480,0,0,0,0,0,0,55000,93000,-38000,-38000
20200312,047720,聯茂凱基94購03,,,,,0.00,0.00,0,0,0,0,0,0,0,0,0,0,0,0,0
20200312,047721,GIS凱基93購04,,,,,0.00,0.00,0,0,0,0,0,0,0,0,0,0,0,0,0
20200312,047722,南電凱基94購02,1.04,1.04,1.04,1.04,0.00,0.00,25000,1,26000,0,0,0,0,0,0,0,25000,-25000,-25000
20200312,047723,廣宇群益94購01,,,,,0.00,0.00,0,0,0,0,0,0,0,0,0,0,0,0,0
20200312,047724,智邦群益93購03,,,,,0.00,0.00,0,0,0,0,0,0,0,0,0,0,0,0,0
20200312,047725,廣達群益93購01,,,,,0.00,0.00,0,0,0,0,0,0,0,0,0,0,0,0,0
20200312,047726,友達群益94購02,0.07,0.07,0.07,0.07,-0.16,-69.57,50000,4,3500,0,0,0,0,0,0,20000,30000,-10000,-10000
20200312,047727,拓凱群益94購01,,,,,0.00,0.00,0,0,0,0,0,0,0,0,0,0,0,0,0
20200312,047728,嘉聯益群益93購01,,,,,0.00,0.00,0,0,0,0,0,0,0,0,0,0,0,0,0
20200312,047729,聯茂群益93購02,,,,,0.00,0.00,0,0,0,0,0,0,0,0,0,0,0,0,0
20200312,04772P,欣興元大94售08,,,,,0.00,0.00,0,0,0,0,0,0,0,0,0,0,0,0,0
20200312,047730,矽力群益93購02,3.75,3.75,3.10,3.10,-1.32,-29.86,30000,2,106000,0,0,0,0,0,0,20000,10000,10000,10000
20200312,047731,志超群益93購01,,,,,0.00,0.00,0,0,0,0,0,0,0,0,0,0,0,0,0
20200312,047732,美利達群益93購01,,,,,0.00,0.00,0,0,0,0,0,0,0,0,0,0,0,0,0
20200312,047733,友達兆豐95購01,,,,,0.00,0.00,0,0,0,0,0,0,0,0,0,0,0,0,0
20200312,047734,欣興兆豐94購02,0.02,0.03,0.02,0.02,-0.04,-66.67,290000,20,5900,0,0,0,0,0,0,0,290000,-290000,-290000
20200312,047735,華邦電台新94購01,,,,,0.00,0.00,0,0,0,0,0,0,0,0,0,0,0,0,0
20200312,047736,聯發科台新94購01,0.13,0.30,0.10,0.10,-0.21,-67.74,150000,15,22300,0,0,0,0,0,0,0,150000,-150000,-150000
20200312,047737,義隆麥證94購01,,,,,0.00,0.00,0,0,0,0,0,0,0,0,0,0,0,0,0
20200312,047738,美律永豐93購02,,,,,0.00,0.00,0,0,0,0,0,0,0,0,0,0,0,0,0
20200312,047739,致伸永豐93購01,,,,,0.00,0.00,0,0,0,0,0,0,0,0,0,0,0,0,0
20200312,04773P,金融類元大94售01,1.48,1.48,1.48,1.48,+0.50,51.02,1000,1,1480,0,0,0,0,0,0,1000,0,1000,1000
20200312,047740,樺漢永豐93購01,,,,,0.00,0.00,0,0,0,0,0,0,0,0,0,0,0,0,0
20200312,047741,鴻海統一93購06,,,,,0.00,0.00,0,0,0,0,0,0,0,0,0,0,0,0,0
20200312,047742,友達統一93購04,0.07,0.07,0.07,0.07,0.00,0.00,10000,1,700,0,0,0,0,0,0,10000,0,10000,10000
20200312,047743,亞德客元富93購01,,,,,0.00,0.00,0,0,0,0,0,0,0,0,0,0,0,0,0
20200312,047744,大成鋼元富93購01,,,,,0.00,0.00,0,0,0,0,0,0,0,0,0,0,0,0,0
20200312,047745,廣宇元富93購01,,,,,0.00,0.00,0,0,0,0,0,0,0,0,0,0,0,0,0
20200312,047746,宏碁元富93購01,,,,,0.00,0.00,0,0,0,0,0,0,0,0,0,0,0,0,0
20200312,047747,致茂元富93購01,,,,,0.00,0.00,0,0,0,0,0,0,0,0,0,0,0,0,0
20200312,047748,漢唐元富93購02,,,,,0.00,0.00,0,0,0,0,0,0,0,0,0,0,0,0,0
20200312,047749,富邦金元富93購01,,,,,0.00,0.00,0,0,0,0,0,0,0,0,0,0,0,0,0
20200312,04774P,金融類元大94售02,1.70,1.70,1.70,1.70,+0.64,60.38,1000,1,1700,0,0,0,0,0,0,1000,0,1000,1000
20200312,047750,開發金元富93購01,,,,,0.00,0.00,0,0,0,0,0,0,0,0,0,0,0,0,0
20200312,047751,玉山金元富93購01,,,,,0.00,0.00,0,0,0,0,0,0,0,0,0,0,0,0,0
20200312,047752,健鼎元富93購01,,,,,0.00,0.00,0,0,0,0,0,0,0,0,0,0,0,0,0
20200312,047753,景碩元富93購01,,,,,0.00,0.00,0,0,0,0,0,0,0,0,0,0,0,0,0
20200312,047754,嘉澤元富93購02,,,,,0.00,0.00,0,0,0,0,0,0,0,0,0,0,0,0,0
20200312,047755,麗豐元富93購01,,,,,0.00,0.00,0,0,0,0,0,0,0,0,0,0,0,0,0
20200312,047756,利勤元富93購01,,,,,0.00,0.00,0,0,0,0,0,0,0,0,0,0,0,0,0
20200312,047757,達運元富93購01,,,,,0.00,0.00,0,0,0,0,0,0,0,0,0,0,0,0,0
20200312,047758,康舒元富93購01,,,,,0.00,0.00,0,0,0,0,0,0,0,0,0,0,0,0,0
20200312,047759,復盛元富93購01,,,,,0.00,0.00,0,0,0,0,0,0,0,0,0,0,0,0,0
20200312,04775P,台積電凱基94售29,,,,,0.00,0.00,0,0,0,0,0,0,0,0,0,0,0,0,0
20200312,047760,元油反元大96購03,7.50,7.50,7.50,7.50,0.00,0.00,1000,1,7500,0,0,0,0,0,0,1000,0,1000,1000
20200312,047761,亞德客元大93購02,,,,,0.00,0.00,0,0,0,0,0,0,0,0,0,0,0,0,0
20200312,047762,華新元大93購02,,,,,0.00,0.00,0,0,0,0,0,0,0,0,0,0,0,0,0
20200312,047763,旺宏元大94購04,0.24,0.24,0.14,0.15,-0.25,-62.5,199000,8,29180,0,0,0,0,0,0,169000,30000,139000,139000
20200312,047764,燿華元大93購03,,,,,0.00,0.00,0,0,0,0,0,0,0,0,0,0,0,0,0
20200312,047765,瑞昱元大93購12,,,,,0.00,0.00,0,0,0,0,0,0,0,0,0,0,0,0,0
20200312,047766,聯發科元大93購19,,,,,0.00,0.00,0,0,0,0,0,0,0,0,0,0,0,0,0
20200312,047767,聯發科元大93購20,,,,,0.00,0.00,0,0,0,0,0,0,0,0,0,0,0,0,0
20200312,047768,大立光元大95購01,1.30,1.30,1.30,1.30,-1.37,-51.31,1000,1,1300,0,0,0,0,0,0,1000,1000,0,0
20200312,047769,大立光元大96購01,0.89,0.98,0.88,0.88,-0.69,-43.95,81000,7,73050,0,0,0,0,0,0,1000,81000,-80000,-80000
20200312,04776P,聯發科凱基94售06,,,,,0.00,0.00,0,0,0,0,0,0,0,0,0,0,0,0,0
20200312,047770,聯詠元大93購10,,,,,0.00,0.00,0,0,0,0,0,0,0,0,0,0,0,0,0
20200312,047771,緯創元大93購01,,,,,0.00,0.00,0,0,0,0,0,0,0,0,0,0,0,0,0
20200312,047772,泰鼎元大93購05,0.37,0.37,0.37,0.37,-1.12,-75.17,1000,1,370,0,0,0,0,0,0,1000,0,1000,1000
20200312,047773,超眾元大96購01,,,,,0.00,0.00,0,0,0,0,0,0,0,0,0,0,0,0,0
20200312,047774,台表科元大95購01,1.05,1.05,0.68,0.68,-0.38,-35.85,280000,17,234160,0,0,0,0,0,0,160000,120000,40000,40000
20200312,047775,緯穎元大95購01,,,,,0.00,0.00,0,0,0,0,0,0,0,0,0,0,0,0,0
20200312,047776,志超元大93購01,,,,,0.00,0.00,0,0,0,0,0,0,0,0,0,0,0,0,0
20200312,047777,寶成元大93購01,,,,,0.00,0.00,0,0,0,0,0,0,0,0,0,0,0,0,0
20200312,047778,美利達元大93購01,,,,,0.00,0.00,0,0,0,0,0,0,0,0,0,0,0,0,0
20200312,047779,台化中信93購01,,,,,0.00,0.00,0,0,0,0,0,0,0,0,0,0,0,0,0
20200312,04777P,聯發科凱基94售10,,,,,0.00,0.00,0,0,0,0,0,0,0,0,0,0,0,0,0
20200312,047780,友達中信96購01,0.43,0.43,0.25,0.25,-0.25,-50.0,60000,6,22000,0,0,0,0,0,0,10000,50000,-40000,-40000
20200312,047781,上銀國泰94購02,0.56,0.61,0.56,0.58,-0.80,-57.97,45000,3,26250,0,0,0,0,0,0,15000,30000,-15000,-15000
20200312,047782,燿華國泰95購01,,,,,0.00,0.00,0,0,0,0,0,0,0,0,0,0,0,0,0
20200312,047783,聯茂國泰94購02,0.30,0.30,0.15,0.15,0.00,0.00,11000,2,3150,0,0,0,0,0,0,10000,1000,9000,9000
20200312,047784,元油反富邦94購03,2.53,3.58,2.53,3.32,+1.54,86.52,179000,22,549890,0,0,0,0,0,0,93000,86000,7000,7000
20200312,047785,嘉聯益第一93購01,,,,,0.00,0.00,0,0,0,0,0,0,0,0,0,0,0,0,0
20200312,047786,燿華群益93購03,,,,,0.00,0.00,0,0,0,0,0,0,0,0,0,0,0,0,0
20200312,047787,正崴群益93購01,,,,,0.00,0.00,0,0,0,0,0,0,0,0,0,0,0,0,0
20200312,047788,欣興群益93購05,,,,,0.00,0.00,0,0,0,0,0,0,0,0,0,0,0,0,0
20200312,047789,景碩群益93購01,,,,,0.00,0.00,0,0,0,0,0,0,0,0,0,0,0,0,0
20200312,04778P,可成凱基94售10,,,,,0.00,0.00,0,0,0,0,0,0,0,0,0,0,0,0,0
20200312,047790,致伸群益93購04,,,,,0.00,0.00,0,0,0,0,0,0,0,0,0,0,0,0,0
20200312,047791,聯茂群益93購04,,,,,0.00,0.00,0,0,0,0,0,0,0,0,0,0,0,0,0
20200312,047792,美利達群益93購02,,,,,0.00,0.00,0,0,0,0,0,0,0,0,0,0,0,0,0
20200312,047793,臺股指群益93購04,,,,,0.00,0.00,0,0,0,0,0,0,0,0,0,0,0,0,0
20200312,047794,臺股指群益93購05,,,,,0.00,0.00,0,0,0,0,0,0,0,0,0,0,0,0,0
20200312,047795,臺股指群益93購06,,,,,0.00,0.00,0,0,0,0,0,0,0,0,0,0,0,0,0
20200312,047796,臺股指群益93購07,,,,,0.00,0.00,0,0,0,0,0,0,0,0,0,0,0,0,0
20200312,047797,臺股指群益93購08,,,,,0.00,0.00,0,0,0,0,0,0,0,0,0,0,0,0,0
20200312,047798,臺股指群益93購09,,,,,0.00,0.00,0,0,0,0,0,0,0,0,0,0,0,0,0
20200312,047799,技嘉兆豐93購01,,,,,0.00,0.00,0,0,0,0,0,0,0,0,0,0,0,0,0
20200312,04779P,大立光凱基94售10,,,,,0.00,0.00,0,0,0,0,0,0,0,0,0,0,0,0,0
20200312,047800,大立光兆豐93購04,,,,,0.00,0.00,0,0,0,0,0,0,0,0,0,0,0,0,0
20200312,047801,臺股指兆豐93購01,0.01,0.01,0.01,0.01,-1.19,-99.17,10000,1,100,0,0,0,0,0,0,0,10000,-10000,-10000
20200312,047802,滬深2X凱基95購03,,,,,0.00,0.00,0,0,0,0,0,0,0,0,0,0,0,0,0
20200312,047803,卜蜂凱基93購03,,,,,0.00,0.00,0,0,0,0,0,0,0,0,0,0,0,0,0
20200312,047804,鴻海凱基93購26,,,,,0.00,0.00,0,0,0,0,0,0,0,0,0,0,0,0,0
20200312,047805,台積電凱基93購21,,,,,0.00,0.00,0,0,0,0,0,0,0,0,0,0,0,0,0
20200312,047806,旺宏凱基93購05,,,,,0.00,0.00,0,0,0,0,0,0,0,0,0,0,0,0,0
20200312,047807,華邦電凱基93購06,,,,,0.00,0.00,0,0,0,0,0,0,0,0,0,0,0,0,0
20200312,047808,智邦凱基93購07,,,,,0.00,0.00,0,0,0,0,0,0,0,0,0,0,0,0,0
20200312,047809,瑞昱凱基93購08,0.18,0.18,0.18,0.18,-0.34,-65.38,10000,1,1800,0,0,0,0,0,0,10000,0,10000,10000
20200312,04780P,大立光凱基94售11,0.31,0.32,0.31,0.32,0.00,0.00,30000,2,9500,0,0,0,0,0,0,0,30000,-30000,-30000
20200312,047810,聯發科凱基93購22,,,,,0.00,0.00,0,0,0,0,0,0,0,0,0,0,0,0,0
20200312,047811,聯發科凱基93購23,,,,,0.00,0.00,0,0,0,0,0,0,0,0,0,0,0,0,0
20200312,047812,可成凱基93購09,,,,,0.00,0.00,0,0,0,0,0,0,0,0,0,0,0,0,0
20200312,047813,華新科凱基93購07,0.76,0.86,0.76,0.86,0.00,0.00,11000,2,9360,0,0,0,0,0,0,0,11000,-11000,-11000
20200312,047814,宏達電凱基93購02,,,,,0.00,0.00,0,0,0,0,0,0,0,0,0,0,0,0,0
20200312,047815,大立光凱基93購25,,,,,0.00,0.00,0,0,0,0,0,0,0,0,0,0,0,0,0
20200312,047816,大立光凱基93購26,,,,,0.00,0.00,0,0,0,0,0,0,0,0,0,0,0,0,0
20200312,047817,聯茂凱基93購08,,,,,0.00,0.00,0,0,0,0,0,0,0,0,0,0,0,0,0
20200312,047818,台郡凱基93購04,,,,,0.00,0.00,0,0,0,0,0,0,0,0,0,0,0,0,0
20200312,047819,南茂凱基93購04,,,,,0.00,0.00,0,0,0,0,0,0,0,0,0,0,0,0,0
20200312,04781P,欣興凱基94售06,2.94,3.49,2.94,3.49,+1.38,65.4,59000,7,196560,0,0,0,0,0,0,0,59000,-59000,-59000
20200312,047820,世紀鋼凱基93購09,,,,,0.00,0.00,0,0,0,0,0,0,0,0,0,0,0,0,0
20200312,047821,臺股指凱基93購15,,,,,0.00,0.00,0,0,0,0,0,0,0,0,0,0,0,0,0
20200312,047822,臺股指凱基93購16,,,,,0.00,0.00,0,0,0,0,0,0,0,0,0,0,0,0,0
20200312,047823,臺股指凱基93購17,,,,,0.00,0.00,0,0,0,0,0,0,0,0,0,0,0,0,0
20200312,047824,臺股指凱基93購18,,,,,0.00,0.00,0,0,0,0,0,0,0,0,0,0,0,0,0
20200312,047825,道瓊反元大96購01,1.20,1.60,1.20,1.45,+0.48,49.48,1018000,13,1536470,0,0,0,0,0,0,461000,657000,-196000,-196000
20200312,047826,台泥元大93購01,0.35,0.35,0.35,0.35,-0.33,-48.53,100000,1,35000,0,0,0,0,0,0,0,100000,-100000,-100000
20200312,047827,東陽元大93購01,,,,,0.00,0.00,0,0,0,0,0,0,0,0,0,0,0,0,0
20200312,047828,華新元大93購03,,,,,0.00,0.00,0,0,0,0,0,0,0,0,0,0,0,0,0
20200312,047829,旺宏元大93購06,0.53,0.53,0.53,0.53,-0.37,-41.11,50000,1,26500,0,0,0,0,0,0,50000,0,50000,50000
20200312,04782P,智伸科統一96售01,1.55,1.77,1.55,1.74,+0.27,18.37,87000,11,143500,0,0,0,0,0,0,3000,84000,-81000,-81000
20200312,047830,智邦元大93購08,,,,,0.00,0.00,0,0,0,0,0,0,0,0,0,0,0,0,0
20200312,047831,台光電元大93購07,,,,,0.00,0.00,0,0,0,0,0,0,0,0,0,0,0,0,0
20200312,047832,漢唐元大94購03,0.88,0.88,0.88,0.88,0.00,0.00,99000,1,87120,0,0,0,0,0,0,0,99000,-99000,-99000
20200312,047833,全新元大94購02,,,,,0.00,0.00,0,0,0,0,0,0,0,0,0,0,0,0,0
20200312,047834,義隆元大93購02,,,,,0.00,0.00,0,0,0,0,0,0,0,0,0,0,0,0,0
20200312,047835,華新科元大93購09,,,,,0.00,0.00,0,0,0,0,0,0,0,0,0,0,0,0,0
20200312,047836,國泰金元大93購01,,,,,0.00,0.00,0,0,0,0,0,0,0,0,0,0,0,0,0
20200312,047837,嘉晶元大93購01,0.02,0.02,0.02,0.02,-0.02,-50.0,10000,1,200,0,0,0,0,0,0,10000,0,10000,10000
20200312,047838,亞光元大93購03,,,,,0.00,0.00,0,0,0,0,0,0,0,0,0,0,0,0,0
20200312,047839,景碩元大93購03,,,,,0.00,0.00,0,0,0,0,0,0,0,0,0,0,0,0,0
20200312,04783P,貿聯元富94售01,0.90,1.16,0.88,1.13,+0.34,43.04,111000,10,107730,0,0,0,0,0,0,31000,80000,-49000,-49000
20200312,047840,新日興元大93購03,,,,,0.00,0.00,0,0,0,0,0,0,0,0,0,0,0,0,0
20200312,047841,致伸元大94購01,,,,,0.00,0.00,0,0,0,0,0,0,0,0,0,0,0,0,0
20200312,047842,聯茂元大93購06,,,,,0.00,0.00,0,0,0,0,0,0,0,0,0,0,0,0,0
20200312,047843,超眾元大93購02,,,,,0.00,0.00,0,0,0,0,0,0,0,0,0,0,0,0,0
20200312,047844,台虹元大93購02,0.04,0.04,0.04,0.04,-0.22,-84.62,10000,1,400,0,0,0,0,0,0,0,10000,-10000,-10000
20200312,047845,美利達元大93購02,,,,,0.00,0.00,0,0,0,0,0,0,0,0,0,0,0,0,0
20200312,047846,滬深2X統一93購04,,,,,0.00,0.00,0,0,0,0,0,0,0,0,0,0,0,0,0
20200312,047847,鴻海統一93購07,,,,,0.00,0.00,0,0,0,0,0,0,0,0,0,0,0,0,0
20200312,047848,可成統一93購01,,,,,0.00,0.00,0,0,0,0,0,0,0,0,0,0,0,0,0
20200312,047849,中工統一93購01,,,,,0.00,0.00,0,0,0,0,0,0,0,0,0,0,0,0,0
20200312,04784P,超眾元富94售01,1.23,1.62,1.22,1.52,+0.46,43.4,977000,30,1299980,0,0,0,0,0,0,635000,292000,343000,343000
20200312,047850,彩晶統一94購01,,,,,0.00,0.00,0,0,0,0,0,0,0,0,0,0,0,0,0
20200312,047851,智易元富93購02,,,,,0.00,0.00,0,0,0,0,0,0,0,0,0,0,0,0,0
20200312,047852,矽創元富93購01,,,,,0.00,0.00,0,0,0,0,0,0,0,0,0,0,0,0,0
20200312,047853,臺股指元富93購03,,,,,0.00,0.00,0,0,0,0,0,0,0,0,0,0,0,0,0
20200312,047854,滬深2X國票96購02,,,,,0.00,0.00,0,0,0,0,0,0,0,0,0,0,0,0,0
20200312,047855,美律國票94購01,,,,,0.00,0.00,0,0,0,0,0,0,0,0,0,0,0,0,0
20200312,047856,GIS國票94購01,,,,,0.00,0.00,0,0,0,0,0,0,0,0,0,0,0,0,0
20200312,047857,臺股指國票93購12,,,,,0.00,0.00,0,0,0,0,0,0,0,0,0,0,0,0,0
20200312,047858,臺股指國票93購13,0.80,0.80,0.28,0.28,0.00,0.00,5000,5,2490,0,0,0,0,0,0,0,5000,-5000,-5000
20200312,047859,臺股指國票93購14,0.24,0.24,0.11,0.12,-0.59,-83.1,58000,9,8280,0,0,0,0,0,0,0,58000,-58000,-58000
20200312,04785P,鴻海永豐94售03,0.59,0.80,0.56,0.76,+0.28,58.33,104000,8,70270,0,0,0,0,0,0,104000,4000,100000,100000
20200312,047860,臺股指國票93購15,,,,,0.00,0.00,0,0,0,0,0,0,0,0,0,0,0,0,0
20200312,047861,臺股指國票93購16,,,,,0.00,0.00,0,0,0,0,0,0,0,0,0,0,0,0,0
20200312,047862,超眾台新93購01,,,,,0.00,0.00,0,0,0,0,0,0,0,0,0,0,0,0,0
20200312,047863,東陽康和93購02,,,,,0.00,0.00,0,0,0,0,0,0,0,0,0,0,0,0,0
20200312,047864,信邦康和93購01,,,,,0.00,0.00,0,0,0,0,0,0,0,0,0,0,0,0,0
20200312,047865,健鼎康和93購01,,,,,0.00,0.00,0,0,0,0,0,0,0,0,0,0,0,0,0
20200312,047866,得力永豐93購01,,,,,0.00,0.00,0,0,0,0,0,0,0,0,0,0,0,0,0
20200312,047867,旺宏永豐93購02,,,,,0.00,0.00,0,0,0,0,0,0,0,0,0,0,0,0,0
20200312,047868,欣興永豐93購04,,,,,0.00,0.00,0,0,0,0,0,0,0,0,0,0,0,0,0
20200312,047869,景碩永豐93購01,,,,,0.00,0.00,0,0,0,0,0,0,0,0,0,0,0,0,0
20200312,04786P,鴻海永昌96售01,0.27,0.40,0.27,0.38,+0.16,72.73,553000,23,190490,0,0,0,0,0,0,360000,191000,169000,169000
20200312,047870,嘉澤永豐93購02,,,,,0.00,0.00,0,0,0,0,0,0,0,0,0,0,0,0,0
20200312,047871,健策永豐93購02,,,,,0.00,0.00,0,0,0,0,0,0,0,0,0,0,0,0,0
20200312,047872,貿聯永豐93購02,,,,,0.00,0.00,0,0,0,0,0,0,0,0,0,0,0,0,0
20200312,047873,上緯控永豐93購02,,,,,0.00,0.00,0,0,0,0,0,0,0,0,0,0,0,0,0
20200312,047874,易華電永豐93購03,,,,,0.00,0.00,0,0,0,0,0,0,0,0,0,0,0,0,0
20200312,047875,南電永豐93購02,,,,,0.00,0.00,0,0,0,0,0,0,0,0,0,0,0,0,0
20200312,047876,美利達永豐93購01,,,,,0.00,0.00,0,0,0,0,0,0,0,0,0,0,0,0,0
20200312,047877,滬深2X中信95購07,,,,,0.00,0.00,0,0,0,0,0,0,0,0,0,0,0,0,0
20200312,047879,台積電中信93購04,,,,,0.00,0.00,0,0,0,0,0,0,0,0,0,0,0,0,0
20200312,04787P,台積電永昌96售04,1.25,1.58,1.22,1.48,+0.38,34.55,4382000,64,5976510,0,0,0,0,0,0,3540000,2897000,643000,643000
20200312,047880,聯發科國泰94購03,0.06,0.06,0.05,0.05,-0.21,-80.77,90000,5,5000,0,0,0,0,0,0,40000,50000,-10000,-10000
20200312,047881,和鑫國泰95購01,,,,,0.00,0.00,0,0,0,0,0,0,0,0,0,0,0,0,0
20200312,047882,超眾國泰94購01,,,,,0.00,0.00,0,0,0,0,0,0,0,0,0,0,0,0,0
20200312,047883,臺股指永昌93購01,,,,,0.00,0.00,0,0,0,0,0,0,0,0,0,0,0,0,0
20200312,047884,臺股指永昌93購02,,,,,0.00,0.00,0,0,0,0,0,0,0,0,0,0,0,0,0
20200312,047885,元金2X富邦99購01,1.19,1.21,1.06,1.08,-0.32,-22.86,1334000,45,1497990,0,0,0,0,0,0,672000,657000,15000,15000
20200312,047886,京元電富邦95購01,0.23,0.23,0.15,0.15,-0.17,-53.12,20000,4,3650,0,0,0,0,0,0,0,20000,-20000,-20000
20200312,047887,智原富邦97購01,,,,,0.00,0.00,0,0,0,0,0,0,0,0,0,0,0,0,0
20200312,047888,臺股指富邦93購01,,,,,0.00,0.00,0,0,0,0,0,0,0,0,0,0,0,0,0
20200312,047889,臺股指富邦93購02,0.21,0.21,0.21,0.21,-0.29,-58.0,2000,1,420,0,0,0,0,0,0,2000,0,2000,2000
20200312,04788P,台積電永昌96售05,0.19,0.23,0.19,0.20,0.00,0.00,516000,54,114280,0,0,0,0,0,0,0,497000,-497000,-497000
20200312,047890,電子類富邦93購01,,,,,0.00,0.00,0,0,0,0,0,0,0,0,0,0,0,0,0
20200312,047891,滬深2X第一93購01,,,,,0.00,0.00,0,0,0,0,0,0,0,0,0,0,0,0,0
20200312,047892,康控兆豐94購01,,,,,0.00,0.00,0,0,0,0,0,0,0,0,0,0,0,0,0
20200312,047893,嘉聯益兆豐94購01,,,,,0.00,0.00,0,0,0,0,0,0,0,0,0,0,0,0,0
20200312,047894,大成鋼群益93購01,,,,,0.00,0.00,0,0,0,0,0,0,0,0,0,0,0,0,0
20200312,047895,台積電群益94購04,1.24,1.24,0.63,0.91,-1.00,-52.36,309000,31,239710,0,0,0,0,0,0,101000,198000,-97000,-97000
20200312,047896,京元電群益93購01,,,,,0.00,0.00,0,0,0,0,0,0,0,0,0,0,0,0,0
20200312,047897,可成群益94購01,0.22,0.22,0.10,0.10,-0.39,-79.59,177000,18,26040,0,0,0,0,0,0,20000,157000,-137000,-137000
20200312,047898,嘉澤群益93購02,,,,,0.00,0.00,0,0,0,0,0,0,0,0,0,0,0,0,0
20200312,047899,貿聯群益93購03,,,,,0.00,0.00,0,0,0,0,0,0,0,0,0,0,0,0,0
20200312,04789P,台積電富邦95售03,,,,,0.00,0.00,0,0,0,0,0,0,0,0,0,0,0,0,0
20200312,047900,TPK群益93購03,,,,,0.00,0.00,0,0,0,0,0,0,0,0,0,0,0,0,0
20200312,047901,復盛群益93購01,,,,,0.00,0.00,0,0,0,0,0,0,0,0,0,0,0,0,0
20200312,047902,美利達群益93購03,,,,,0.00,0.00,0,0,0,0,0,0,0,0,0,0,0,0,0
20200312,047903,滬深2X元大96購01,,,,,0.00,0.00,0,0,0,0,0,0,0,0,0,0,0,0,0
20200312,047904,臺指反元大96購01,0.71,0.71,0.71,0.71,0.00,0.00,10000,1,7100,0,0,0,0,0,0,10000,0,10000,10000
20200312,047905,元油反元大96購04,5.25,6.30,5.25,6.05,0.00,0.00,65000,5,365500,0,0,0,0,0,0,0,65000,-65000,-65000
20200312,047906,中石化元大94購01,,,,,0.00,0.00,0,0,0,0,0,0,0,0,0,0,0,0,0
20200312,047907,燿華元大93購05,,,,,0.00,0.00,0,0,0,0,0,0,0,0,0,0,0,0,0
20200312,047908,南亞科元大93購02,,,,,0.00,0.00,0,0,0,0,0,0,0,0,0,0,0,0,0
20200312,047909,超眾元大93購03,,,,,0.00,0.00,0,0,0,0,0,0,0,0,0,0,0,0,0
20200312,04790P,台積電元大94售19,,,,,0.00,0.00,0,0,0,0,0,0,0,0,0,0,0,0,0
20200312,047910,全新麥證94購01,,,,,0.00,0.00,0,0,0,0,0,0,0,0,0,0,0,0,0
20200312,047911,晶技麥證94購01,2.13,2.15,1.72,1.72,-0.54,-23.89,67000,15,134910,61000,0,61000,0,0,0,61000,0,61000,61000
20200312,047912,台郡麥證94購01,0.41,0.41,0.29,0.29,-0.36,-55.38,952000,19,313790,792000,60000,732000,0,0,0,792000,60000,732000,732000
20200312,047913,美利達麥證93購01,,,,,0.00,0.00,0,0,0,0,0,0,0,0,0,0,0,0,0
20200312,047914,華新凱基93購03,,,,,0.00,0.00,0,0,0,0,0,0,0,0,0,0,0,0,0
20200312,047915,鴻海凱基93購27,0.23,0.24,0.21,0.24,0.00,0.00,500000,50,110800,0,0,0,0,0,0,500000,500000,0,0
20200312,047916,台積電凱基93購22,,,,,0.00,0.00,0,0,0,0,0,0,0,0,0,0,0,0,0
20200312,047917,台積電凱基94購01,0.13,0.13,0.13,0.13,-0.17,-56.67,10000,1,1300,0,0,0,0,0,0,0,0,0,0
20200312,047918,智邦凱基93購08,,,,,0.00,0.00,0,0,0,0,0,0,0,0,0,0,0,0,0
20200312,047919,技嘉凱基93購06,,,,,0.00,0.00,0,0,0,0,0,0,0,0,0,0,0,0,0
20200312,04791P,台積電元大94售20,,,,,0.00,0.00,0,0,0,0,0,0,0,0,0,0,0,0,0
20200312,047920,南亞科凱基93購04,,,,,0.00,0.00,0,0,0,0,0,0,0,0,0,0,0,0,0
20200312,047921,南亞科凱基93購05,,,,,0.00,0.00,0,0,0,0,0,0,0,0,0,0,0,0,0
20200312,047922,聯發科凱基94購01,,,,,0.00,0.00,0,0,0,0,0,0,0,0,0,0,0,0,0
20200312,047923,聯發科凱基94購02,,,,,0.00,0.00,0,0,0,0,0,0,0,0,0,0,0,0,0
20200312,047924,可成凱基93購10,,,,,0.00,0.00,0,0,0,0,0,0,0,0,0,0,0,0,0
20200312,047925,可成凱基94購01,0.10,0.10,0.10,0.10,-0.53,-84.13,4000,1,400,0,0,0,0,0,0,0,4000,-4000,-4000
20200312,047926,可成凱基94購02,,,,,0.00,0.00,0,0,0,0,0,0,0,0,0,0,0,0,0
20200312,047927,宏達電凱基93購03,,,,,0.00,0.00,0,0,0,0,0,0,0,0,0,0,0,0,0
20200312,047928,禾伸堂凱基93購04,,,,,0.00,0.00,0,0,0,0,0,0,0,0,0,0,0,0,0
20200312,047929,景碩凱基93購03,,,,,0.00,0.00,0,0,0,0,0,0,0,0,0,0,0,0,0
20200312,04792P,智邦元大94售06,1.80,1.99,1.80,1.99,0.00,0.00,140000,6,263610,0,0,0,0,0,0,25000,115000,-90000,-90000
20200312,047930,嘉澤凱基93購03,0.53,0.53,0.53,0.53,-1.18,-69.01,10000,1,5300,0,0,0,0,0,0,0,10000,-10000,-10000
20200312,047931,日月光凱基93購01,,,,,0.00,0.00,0,0,0,0,0,0,0,0,0,0,0,0,0
20200312,047932,麗豐凱基93購01,,,,,0.00,0.00,0,0,0,0,0,0,0,0,0,0,0,0,0
20200312,047933,瑞儀凱基93購06,,,,,0.00,0.00,0,0,0,0,0,0,0,0,0,0,0,0,0
20200312,047934,GIS凱基94購01,,,,,0.00,0.00,0,0,0,0,0,0,0,0,0,0,0,0,0
20200312,047935,美利達凱基93購01,,,,,0.00,0.00,0,0,0,0,0,0,0,0,0,0,0,0,0
20200312,047936,美利達凱基93購02,,,,,0.00,0.00,0,0,0,0,0,0,0,0,0,0,0,0,0
20200312,047937,元金2X國票97購02,1.54,1.54,1.45,1.45,-0.20,-12.12,41000,6,60210,0,0,0,0,0,0,0,41000,-41000,-41000
20200312,047938,台化國票93購01,,,,,0.00,0.00,0,0,0,0,0,0,0,0,0,0,0,0,0
20200312,047939,亞德客國票93購02,,,,,0.00,0.00,0,0,0,0,0,0,0,0,0,0,0,0,0
20200312,04793P,台光電元大94售07,1.18,1.35,1.18,1.35,+0.44,48.35,149000,2,192650,0,0,0,0,0,0,0,149000,-149000,-149000
20200312,047940,台光電國票93購01,,,,,0.00,0.00,0,0,0,0,0,0,0,0,0,0,0,0,0
20200312,047941,義隆國票94購02,,,,,0.00,0.00,0,0,0,0,0,0,0,0,0,0,0,0,0
20200312,047942,華新科國票94購04,,,,,0.00,0.00,0,0,0,0,0,0,0,0,0,0,0,0,0
20200312,047943,欣興國票93購06,,,,,0.00,0.00,0,0,0,0,0,0,0,0,0,0,0,0,0
20200312,047944,中石化元富96購01,0.01,0.01,0.01,0.01,0.00,0.00,10000,1,100,0,0,0,0,0,0,0,0,0,0
20200312,047945,滬深2X統一94購01,,,,,0.00,0.00,0,0,0,0,0,0,0,0,0,0,0,0,0
20200312,047946,南亞科統一93購04,,,,,0.00,0.00,0,0,0,0,0,0,0,0,0,0,0,0,0
20200312,047947,欣興統一93購04,,,,,0.00,0.00,0,0,0,0,0,0,0,0,0,0,0,0,0
20200312,047948,瑞儀統一93購01,,,,,0.00,0.00,0,0,0,0,0,0,0,0,0,0,0,0,0
20200312,047949,燿華台新93購01,,,,,0.00,0.00,0,0,0,0,0,0,0,0,0,0,0,0,0
20200312,04794P,友達元大96售03,,,,,0.00,0.00,0,0,0,0,0,0,0,0,0,0,0,0,0
20200312,047950,滬深2X永豐94購02,,,,,0.00,0.00,0,0,0,0,0,0,0,0,0,0,0,0,0
20200312,047951,元油反永豐94購01,,,,,0.00,0.00,0,0,0,0,0,0,0,0,0,0,0,0,0
20200312,047952,華通永豐93購03,,,,,0.00,0.00,0,0,0,0,0,0,0,0,0,0,0,0,0
20200312,047953,台積電永豐93購04,,,,,0.00,0.00,0,0,0,0,0,0,0,0,0,0,0,0,0
20200312,047954,漢唐永豐93購02,,,,,0.00,0.00,0,0,0,0,0,0,0,0,0,0,0,0,0
20200312,047955,南亞科永豐93購01,,,,,0.00,0.00,0,0,0,0,0,0,0,0,0,0,0,0,0
20200312,047956,麗豐永豐93購02,,,,,0.00,0.00,0,0,0,0,0,0,0,0,0,0,0,0,0
20200312,047957,鎧勝永豐93購01,,,,,0.00,0.00,0,0,0,0,0,0,0,0,0,0,0,0,0
20200312,047958,矽創永豐93購02,,,,,0.00,0.00,0,0,0,0,0,0,0,0,0,0,0,0,0
20200312,047959,南電永豐93購03,,,,,0.00,0.00,0,0,0,0,0,0,0,0,0,0,0,0,0
20200312,04795P,聯發科元大94售09,,,,,0.00,0.00,0,0,0,0,0,0,0,0,0,0,0,0,0
20200312,047960,鈺齊永豐93購01,,,,,0.00,0.00,0,0,0,0,0,0,0,0,0,0,0,0,0
20200312,047961,百和永豐93購03,,,,,0.00,0.00,0,0,0,0,0,0,0,0,0,0,0,0,0
20200312,047962,T50反1中信96購02,0.83,1.19,0.83,1.16,+0.38,48.72,267000,14,275660,0,0,0,0,0,0,150000,117000,33000,33000
20200312,047963,滬深2X中信94購04,,,,,0.00,0.00,0,0,0,0,0,0,0,0,0,0,0,0,0
20200312,047964,元油反中信95購01,,,,,0.00,0.00,0,0,0,0,0,0,0,0,0,0,0,0,0
20200312,047965,景碩中信93購01,,,,,0.00,0.00,0,0,0,0,0,0,0,0,0,0,0,0,0
20200312,047966,華通國泰94購01,0.82,0.82,0.33,0.33,-0.85,-72.03,45000,18,26680,0,0,0,0,0,0,28000,17000,11000,11000
20200312,047967,南亞科國泰95購01,0.11,0.11,0.09,0.09,-0.12,-57.14,23000,3,2170,0,0,0,0,0,0,13000,10000,3000,3000
20200312,047968,南電國泰94購01,,,,,0.00,0.00,0,0,0,0,0,0,0,0,0,0,0,0,0
20200312,047969,台達電富邦97購01,0.29,0.29,0.21,0.21,-0.10,-32.26,210000,8,52600,0,0,0,0,0,0,100000,90000,10000,10000
20200312,04796P,聯發科元大94售10,0.71,0.72,0.71,0.71,0.00,0.00,31000,4,22110,0,0,0,0,0,0,1000,30000,-29000,-29000
20200312,047970,鴻海富邦95購01,,,,,0.00,0.00,0,0,0,0,0,0,0,0,0,0,0,0,0
20200312,047971,南亞科富邦95購01,,,,,0.00,0.00,0,0,0,0,0,0,0,0,0,0,0,0,0
20200312,047972,康控富邦95購01,0.02,0.02,0.01,0.01,-0.03,-75.0,318000,2,5860,0,0,0,0,0,0,268000,0,268000,268000
20200312,047973,華通兆豐94購01,0.52,0.52,0.25,0.25,-0.39,-60.94,202000,36,95060,0,0,0,0,0,0,157000,45000,112000,112000
20200312,047974,新光金兆豐93購01,,,,,0.00,0.00,0,0,0,0,0,0,0,0,0,0,0,0,0
20200312,047975,緯創兆豐93購01,,,,,0.00,0.00,0,0,0,0,0,0,0,0,0,0,0,0,0
20200312,047976,台光電亞東93購01,,,,,0.00,0.00,0,0,0,0,0,0,0,0,0,0,0,0,0
20200312,047977,南電亞東93購03,,,,,0.00,0.00,0,0,0,0,0,0,0,0,0,0,0,0,0
20200312,047978,元油反群益97購01,,,,,0.00,0.00,0,0,0,0,0,0,0,0,0,0,0,0,0
20200312,047979,中石化群益95購01,,,,,0.00,0.00,0,0,0,0,0,0,0,0,0,0,0,0,0
20200312,04797P,華新科元大94售04,1.09,1.11,1.07,1.11,+0.46,70.77,110000,3,121720,0,0,0,0,0,0,10000,100000,-90000,-90000
20200312,047980,東陽群益93購02,,,,,0.00,0.00,0,0,0,0,0,0,0,0,0,0,0,0,0
20200312,047981,南亞科群益93購02,,,,,0.00,0.00,0,0,0,0,0,0,0,0,0,0,0,0,0
20200312,047982,奇力新群益93購05,,,,,0.00,0.00,0,0,0,0,0,0,0,0,0,0,0,0,0
20200312,047983,宏達電群益93購04,,,,,0.00,0.00,0,0,0,0,0,0,0,0,0,0,0,0,0
20200312,047984,禾伸堂群益93購01,,,,,0.00,0.00,0,0,0,0,0,0,0,0,0,0,0,0,0
20200312,047985,欣興群益93購07,,,,,0.00,0.00,0,0,0,0,0,0,0,0,0,0,0,0,0
20200312,047986,明泰群益93購01,,,,,0.00,0.00,0,0,0,0,0,0,0,0,0,0,0,0,0
20200312,047987,力成群益93購01,1.41,1.41,1.13,1.13,-2.31,-67.15,60000,2,70600,0,0,0,0,0,0,50000,10000,40000,40000
20200312,047988,志超群益93購02,,,,,0.00,0.00,0,0,0,0,0,0,0,0,0,0,0,0,0
20200312,047989,深中小元大96購02,0.59,0.65,0.59,0.62,-0.24,-27.91,770000,52,479800,0,0,0,0,0,0,300000,470000,-170000,-170000
20200312,04798P,牧德元大95售02,0.36,0.36,0.36,0.36,0.00,0.00,499000,1,179640,0,0,0,0,0,0,0,499000,-499000,-499000
20200312,047990,臺指反元大96購02,,,,,0.00,0.00,0,0,0,0,0,0,0,0,0,0,0,0,0
20200312,047991,元油反元大96購05,,,,,0.00,0.00,0,0,0,0,0,0,0,0,0,0,0,0,0
20200312,047992,東陽元大96購01,,,,,0.00,0.00,0,0,0,0,0,0,0,0,0,0,0,0,0
20200312,047993,鑽全元大96購01,0.52,0.52,0.46,0.46,-0.13,-22.03,28000,3,13580,0,0,0,0,0,0,10000,18000,-8000,-8000
20200312,047994,亞德客元大93購03,1.71,1.71,0.59,0.59,-1.59,-72.94,50000,3,51400,0,0,0,0,0,0,50000,0,50000,50000
20200312,047995,台達電元大96購01,0.54,0.54,0.54,0.54,-0.12,-18.18,98000,2,52920,0,0,0,0,0,0,30000,68000,-38000,-38000
20200312,047996,華邦電元大93購04,,,,,0.00,0.00,0,0,0,0,0,0,0,0,0,0,0,0,0
20200312,047997,南亞科元大93購03,,,,,0.00,0.00,0,0,0,0,0,0,0,0,0,0,0,0,0
20200312,047998,美律元大93購06,,,,,0.00,0.00,0,0,0,0,0,0,0,0,0,0,0,0,0
20200312,047999,聯發科元大93購22,,,,,0.00,0.00,0,0,0,0,0,0,0,0,0,0,0,0,0
20200312,04799P,健策元大94售03,,,,,0.00,0.00,0,0,0,0,0,0,0,0,0,0,0,0,0
20200312,048000,義隆元大93購03,0.20,0.20,0.20,0.20,-0.32,-61.54,30000,1,6000,0,0,0,0,0,0,30000,0,30000,30000
20200312,048001,中工元大96購01,0.56,0.56,0.41,0.41,-0.19,-31.67,387000,16,172360,0,0,0,0,0,0,347000,345000,2000,2000
20200312,048002,景碩元大93購04,,,,,0.00,0.00,0,0,0,0,0,0,0,0,0,0,0,0,0
20200312,048003,旭富元大93購01,1.99,1.99,1.99,1.99,-1.39,-41.12,10000,1,19900,0,0,0,0,0,0,0,10000,-10000,-10000
20200312,048004,康控元大93購05,,,,,0.00,0.00,0,0,0,0,0,0,0,0,0,0,0,0,0
20200312,048005,鎧勝元大93購02,,,,,0.00,0.00,0,0,0,0,0,0,0,0,0,0,0,0,0
20200312,048006,瑞儀元大93購03,,,,,0.00,0.00,0,0,0,0,0,0,0,0,0,0,0,0,0
20200312,048007,明基材元大96購01,0.40,0.40,0.40,0.40,-0.14,-25.93,70000,1,28000,0,0,0,0,0,0,0,70000,-70000,-70000
20200312,048008,聯發科富邦95購02,,,,,0.00,0.00,0,0,0,0,0,0,0,0,0,0,0,0,0
20200312,048009,中壽富邦94購01,,,,,0.00,0.00,0,0,0,0,0,0,0,0,0,0,0,0,0
20200312,04800P,聯茂元大94售08,1.68,1.76,1.68,1.76,0.00,0.00,66000,2,114160,0,0,0,0,0,0,0,66000,-66000,-66000
20200312,048010,嘉聯益富邦97購01,0.44,0.44,0.33,0.34,-0.16,-32.0,300000,15,117350,0,0,0,0,0,0,170000,110000,60000,60000
20200312,048011,滬深2X國票93購02,,,,,0.00,0.00,0,0,0,0,0,0,0,0,0,0,0,0,0
20200312,048012,嘉晶國票94購01,0.69,0.82,0.55,0.61,-0.30,-32.97,129000,13,86730,0,0,0,0,0,0,11000,118000,-107000,-107000
20200312,048013,智易國票93購01,,,,,0.00,0.00,0,0,0,0,0,0,0,0,0,0,0,0,0
20200312,048014,貿聯國票93購03,,,,,0.00,0.00,0,0,0,0,0,0,0,0,0,0,0,0,0
20200312,048015,致伸國票93購03,,,,,0.00,0.00,0,0,0,0,0,0,0,0,0,0,0,0,0
20200312,048016,啟碁國票94購01,,,,,0.00,0.00,0,0,0,0,0,0,0,0,0,0,0,0,0
20200312,048017,美利達國票93購01,,,,,0.00,0.00,0,0,0,0,0,0,0,0,0,0,0,0,0
20200312,048018,南亞科麥證93購01,,,,,0.00,0.00,0,0,0,0,0,0,0,0,0,0,0,0,0
20200312,048019,GIS麥證94購01,,,,,0.00,0.00,0,0,0,0,0,0,0,0,0,0,0,0,0
20200312,04801P,矽力元大94售02,0.21,0.21,0.20,0.20,+0.04,25.0,147000,4,29800,0,0,0,0,0,0,117000,30000,87000,87000
20200312,048020,滬深2X凱基96購02,,,,,0.00,0.00,0,0,0,0,0,0,0,0,0,0,0,0,0
20200312,048021,滬深反凱基93購02,,,,,0.00,0.00,0,0,0,0,0,0,0,0,0,0,0,0,0
20200312,048022,儒鴻凱基93購04,,,,,0.00,0.00,0,0,0,0,0,0,0,0,0,0,0,0,0
20200312,048023,鴻海凱基93購28,0.72,0.78,0.72,0.74,0.00,0.00,500000,50,369800,0,0,0,0,0,0,490000,500000,-10000,-10000
20200312,048024,鴻海凱基93購29,,,,,0.00,0.00,0,0,0,0,0,0,0,0,0,0,0,0,0
20200312,048025,鴻海凱基93購30,,,,,0.00,0.00,0,0,0,0,0,0,0,0,0,0,0,0,0
20200312,048026,瑞昱凱基94購01,0.12,0.12,0.12,0.12,-0.23,-65.71,68000,1,8160,0,0,0,0,0,0,68000,0,68000,68000
20200312,048027,京元電凱基93購03,,,,,0.00,0.00,0,0,0,0,0,0,0,0,0,0,0,0,0
20200312,048028,聯發科凱基93購25,,,,,0.00,0.00,0,0,0,0,0,0,0,0,0,0,0,0,0
20200312,048029,聯發科凱基93購26,,,,,0.00,0.00,0,0,0,0,0,0,0,0,0,0,0,0,0
20200312,04802P,國巨凱基94售07,0.24,0.40,0.24,0.40,0.00,0.00,469000,4,128420,0,0,0,0,0,0,469000,0,469000,469000
20200312,048030,聯發科凱基93購27,,,,,0.00,0.00,0,0,0,0,0,0,0,0,0,0,0,0,0
20200312,048031,全新凱基93購02,,,,,0.00,0.00,0,0,0,0,0,0,0,0,0,0,0,0,0
20200312,048032,可成凱基93購13,,,,,0.00,0.00,0,0,0,0,0,0,0,0,0,0,0,0,0
20200312,048033,大立光凱基93購28,,,,,0.00,0.00,0,0,0,0,0,0,0,0,0,0,0,0,0
20200312,048034,大立光凱基93購29,,,,,0.00,0.00,0,0,0,0,0,0,0,0,0,0,0,0,0
20200312,048035,聯詠凱基93購06,,,,,0.00,0.00,0,0,0,0,0,0,0,0,0,0,0,0,0
20200312,048036,隆達凱基93購01,,,,,0.00,0.00,0,0,0,0,0,0,0,0,0,0,0,0,0
20200312,048037,台表科凱基93購05,0.34,0.34,0.34,0.34,-0.26,-43.33,2000,1,680,0,0,0,0,0,0,2000,0,2000,2000
20200312,048038,樺漢凱基93購03,,,,,0.00,0.00,0,0,0,0,0,0,0,0,0,0,0,0,0
20200312,048039,矽創凱基93購03,,,,,0.00,0.00,0,0,0,0,0,0,0,0,0,0,0,0,0
20200312,04803P,台積電凱基94售30,,,,,0.00,0.00,0,0,0,0,0,0,0,0,0,0,0,0,0
20200312,048040,百和凱基93購07,,,,,0.00,0.00,0,0,0,0,0,0,0,0,0,0,0,0,0
20200312,048041,元油反台新94購01,,,,,0.00,0.00,0,0,0,0,0,0,0,0,0,0,0,0,0
20200312,048042,廣越康和93購02,,,,,0.00,0.00,0,0,0,0,0,0,0,0,0,0,0,0,0
20200312,048043,滬深2X永豐94購03,,,,,0.00,0.00,0,0,0,0,0,0,0,0,0,0,0,0,0
20200312,048044,儒鴻永豐93購01,,,,,0.00,0.00,0,0,0,0,0,0,0,0,0,0,0,0,0
20200312,048045,上銀永豐93購02,,,,,0.00,0.00,0,0,0,0,0,0,0,0,0,0,0,0,0
20200312,048046,正崴永豐93購01,,,,,0.00,0.00,0,0,0,0,0,0,0,0,0,0,0,0,0
20200312,048047,全新永豐93購02,,,,,0.00,0.00,0,0,0,0,0,0,0,0,0,0,0,0,0
20200312,048048,大立光永豐93購03,,,,,0.00,0.00,0,0,0,0,0,0,0,0,0,0,0,0,0
20200312,048049,滬深反中信96購01,0.34,0.38,0.33,0.35,+0.07,25.0,500000,12,177160,0,0,0,0,0,0,369000,131000,238000,238000
20200312,04804P,聯發科凱基94售12,,,,,0.00,0.00,0,0,0,0,0,0,0,0,0,0,0,0,0
20200312,048050,元油反中信93購01,,,,,0.00,0.00,0,0,0,0,0,0,0,0,0,0,0,0,0
20200312,048051,大立光中信94購03,1.15,1.15,0.87,0.87,-0.71,-44.94,43000,7,45380,0,0,0,0,0,0,21000,22000,-1000,-1000
20200312,048052,力成中信93購01,,,,,0.00,0.00,0,0,0,0,0,0,0,0,0,0,0,0,0
20200312,048053,美利達中信93購01,,,,,0.00,0.00,0,0,0,0,0,0,0,0,0,0,0,0,0
20200312,048054,鴻海國泰95購01,0.85,0.85,0.85,0.85,-0.45,-34.62,105000,2,89250,0,0,0,0,0,0,105000,0,105000,105000
20200312,048055,燿華國泰95購02,,,,,0.00,0.00,0,0,0,0,0,0,0,0,0,0,0,0,0
20200312,048056,全新國泰94購02,,,,,0.00,0.00,0,0,0,0,0,0,0,0,0,0,0,0,0
20200312,048057,宏達電國泰94購02,,,,,0.00,0.00,0,0,0,0,0,0,0,0,0,0,0,0,0
20200312,048058,大立光國泰95購01,0.99,0.99,0.81,0.85,-0.81,-48.8,213000,6,194770,0,0,0,0,0,0,4000,213000,-209000,-209000
20200312,048059,欣興國泰95購01,0.17,0.17,0.09,0.12,-0.12,-50.0,653000,23,83100,0,0,0,0,0,0,52000,601000,-549000,-549000
20200312,04805P,創意元富94售01,1.26,1.55,1.26,1.55,+0.41,35.96,190000,14,271300,0,0,0,0,0,0,80000,110000,-30000,-30000
20200312,048060,台達電統一93購01,,,,,0.00,0.00,0,0,0,0,0,0,0,0,0,0,0,0,0
20200312,048061,鴻海統一95購03,0.18,0.18,0.09,0.12,-0.14,-53.85,645000,41,81800,0,0,0,0,0,0,190000,455000,-265000,-265000
20200312,048062,南亞科統一93購05,,,,,0.00,0.00,0,0,0,0,0,0,0,0,0,0,0,0,0
20200312,048063,聯發科統一93購03,,,,,0.00,0.00,0,0,0,0,0,0,0,0,0,0,0,0,0
20200312,048064,可成統一93購02,,,,,0.00,0.00,0,0,0,0,0,0,0,0,0,0,0,0,0
20200312,048065,群創統一93購04,,,,,0.00,0.00,0,0,0,0,0,0,0,0,0,0,0,0,0
20200312,048066,樺漢統一93購01,,,,,0.00,0.00,0,0,0,0,0,0,0,0,0,0,0,0,0
20200312,048067,台光電元富93購01,,,,,0.00,0.00,0,0,0,0,0,0,0,0,0,0,0,0,0
20200312,048068,南亞科元富95購01,0.28,0.28,0.28,0.28,-0.13,-31.71,20000,1,5600,0,0,0,0,0,0,20000,0,20000,20000
20200312,048069,南亞科元富95購02,,,,,0.00,0.00,0,0,0,0,0,0,0,0,0,0,0,0,0
20200312,04806P,臻鼎元富94售06,2.54,2.99,2.54,2.82,+1.03,57.54,43000,5,119470,0,0,0,0,0,0,10000,33000,-23000,-23000
20200312,048070,聯發科元富99購03,0.32,0.32,0.21,0.24,-0.14,-36.84,61000,11,15300,0,0,0,0,0,0,18000,43000,-25000,-25000
20200312,048071,創意元富93購03,,,,,0.00,0.00,0,0,0,0,0,0,0,0,0,0,0,0,0
20200312,048072,GIS元富93購05,,,,,0.00,0.00,0,0,0,0,0,0,0,0,0,0,0,0,0
20200312,048073,南電元富93購02,,,,,0.00,0.00,0,0,0,0,0,0,0,0,0,0,0,0,0
20200312,048074,美利達元富93購01,,,,,0.00,0.00,0,0,0,0,0,0,0,0,0,0,0,0,0
20200312,048075,美利達元富93購02,,,,,0.00,0.00,0,0,0,0,0,0,0,0,0,0,0,0,0
20200312,048076,亞光第一94購01,0.20,0.20,0.18,0.18,0.00,0.00,168000,2,33400,0,0,0,0,0,0,158000,10000,148000,148000
20200312,048077,中磊亞東93購02,,,,,0.00,0.00,0,0,0,0,0,0,0,0,0,0,0,0,0
20200312,048078,嘉聯益亞東93購02,,,,,0.00,0.00,0,0,0,0,0,0,0,0,0,0,0,0,0
20200312,048079,燿華日盛93購01,,,,,0.00,0.00,0,0,0,0,0,0,0,0,0,0,0,0,0
20200312,04807P,聯茂元富94售01,1.17,1.58,1.15,1.58,+0.63,66.32,187000,25,241890,0,0,0,0,0,0,42000,140000,-98000,-98000
20200312,048080,元石油凱基96購01,,,,,0.00,0.00,0,0,0,0,0,0,0,0,0,0,0,0,0
20200312,048081,元油反凱基96購01,,,,,0.00,0.00,0,0,0,0,0,0,0,0,0,0,0,0,0
20200312,048082,台苯凱基93購01,,,,,0.00,0.00,0,0,0,0,0,0,0,0,0,0,0,0,0
20200312,048083,台達電凱基93購04,,,,,0.00,0.00,0,0,0,0,0,0,0,0,0,0,0,0,0
20200312,048084,華通凱基93購05,,,,,0.00,0.00,0,0,0,0,0,0,0,0,0,0,0,0,0
20200312,048085,鴻海凱基93購32,,,,,0.00,0.00,0,0,0,0,0,0,0,0,0,0,0,0,0
20200312,048086,鴻海凱基93購33,,,,,0.00,0.00,0,0,0,0,0,0,0,0,0,0,0,0,0
20200312,048087,國巨凱基93購07,,,,,0.00,0.00,0,0,0,0,0,0,0,0,0,0,0,0,0
20200312,048088,台積電凱基93購23,0.45,0.45,0.31,0.31,-0.67,-68.37,30000,4,11060,0,0,0,0,0,0,0,20000,-20000,-20000
20200312,048089,智邦凱基93購10,,,,,0.00,0.00,0,0,0,0,0,0,0,0,0,0,0,0,0
20200312,04808P,訊芯永豐94售02,1.24,1.42,1.21,1.42,+0.32,29.09,234000,11,290120,0,0,0,0,0,0,183000,51000,132000,132000
20200312,048090,正崴凱基93購03,,,,,0.00,0.00,0,0,0,0,0,0,0,0,0,0,0,0,0
20200312,048091,漢唐凱基93購03,0.31,0.31,0.31,0.31,0.00,0.00,10000,1,3100,0,0,0,0,0,0,0,10000,-10000,-10000
20200312,048092,聯發科凱基93購29,,,,,0.00,0.00,0,0,0,0,0,0,0,0,0,0,0,0,0
20200312,048093,聯發科凱基93購30,,,,,0.00,0.00,0,0,0,0,0,0,0,0,0,0,0,0,0
20200312,048094,大立光凱基93購31,0.08,0.08,0.08,0.08,-0.43,-84.31,10000,1,800,0,0,0,0,0,0,10000,0,10000,10000
20200312,048095,大立光凱基93購32,,,,,0.00,0.00,0,0,0,0,0,0,0,0,0,0,0,0,0
20200312,048096,大立光凱基93購33,,,,,0.00,0.00,0,0,0,0,0,0,0,0,0,0,0,0,0
20200312,048097,聯詠凱基93購07,0.69,0.69,0.52,0.52,-0.59,-53.15,50000,3,31500,0,0,0,0,0,0,30000,20000,10000,10000
20200312,048098,嘉澤凱基93購04,,,,,0.00,0.00,0,0,0,0,0,0,0,0,0,0,0,0,0
20200312,048099,健策凱基93購06,0.55,0.55,0.35,0.39,-0.43,-52.44,70000,7,32000,0,0,0,0,0,0,10000,60000,-50000,-50000
20200312,04809P,台光電群益94售04,0.67,0.79,0.67,0.79,0.00,0.00,144000,6,103010,0,0,0,0,0,0,0,144000,-144000,-144000
20200312,048100,貿聯凱基93購02,,,,,0.00,0.00,0,0,0,0,0,0,0,0,0,0,0,0,0
20200312,048101,致伸凱基93購05,,,,,0.00,0.00,0,0,0,0,0,0,0,0,0,0,0,0,0
20200312,048102,矽力凱基94購01,2.63,2.63,2.15,2.34,-0.76,-24.52,62000,20,145530,0,0,0,0,0,0,58000,1000,57000,57000
20200312,048103,GIS凱基93購06,,,,,0.00,0.00,0,0,0,0,0,0,0,0,0,0,0,0,0
20200312,048104,易華電凱基93購03,,,,,0.00,0.00,0,0,0,0,0,0,0,0,0,0,0,0,0
20200312,048105,滬深2X群益99購02,0.33,0.33,0.33,0.33,-0.18,-35.29,30000,1,9900,0,0,0,0,0,0,0,30000,-30000,-30000
20200312,048106,臺指反群益93購02,,,,,0.00,0.00,0,0,0,0,0,0,0,0,0,0,0,0,0
20200312,048107,華通群益93購02,,,,,0.00,0.00,0,0,0,0,0,0,0,0,0,0,0,0,0
20200312,048108,鴻海群益93購07,0.84,0.84,0.37,0.37,0.00,0.00,2000,2,1210,0,0,0,0,0,0,0,2000,-2000,-2000
20200312,048109,旺宏群益94購02,0.43,0.43,0.43,0.43,-0.34,-44.16,11000,1,4730,0,0,0,0,0,0,11000,0,11000,11000
20200312,04810P,亞德客元大94售01,,,,,0.00,0.00,0,0,0,0,0,0,0,0,0,0,0,0,0
20200312,048110,京元電群益94購01,,,,,0.00,0.00,0,0,0,0,0,0,0,0,0,0,0,0,0
20200312,048111,奇力新群益93購06,,,,,0.00,0.00,0,0,0,0,0,0,0,0,0,0,0,0,0
20200312,048112,宏達電群益93購05,,,,,0.00,0.00,0,0,0,0,0,0,0,0,0,0,0,0,0
20200312,048113,欣興群益93購08,,,,,0.00,0.00,0,0,0,0,0,0,0,0,0,0,0,0,0
20200312,048114,景碩群益93購02,,,,,0.00,0.00,0,0,0,0,0,0,0,0,0,0,0,0,0
20200312,048115,樺漢群益93購01,,,,,0.00,0.00,0,0,0,0,0,0,0,0,0,0,0,0,0
20200312,048116,矽創群益93購02,,,,,0.00,0.00,0,0,0,0,0,0,0,0,0,0,0,0,0
20200312,048117,南電群益93購02,,,,,0.00,0.00,0,0,0,0,0,0,0,0,0,0,0,0,0
20200312,048118,百和群益94購03,,,,,0.00,0.00,0,0,0,0,0,0,0,0,0,0,0,0,0
20200312,048119,臺指反元大96購03,0.68,0.68,0.68,0.68,+0.15,28.3,30000,1,20400,0,0,0,0,0,0,30000,0,30000,30000
20200312,04811P,上銀元大94售02,1.31,1.37,1.30,1.30,0.00,0.00,168000,4,222780,0,0,0,0,0,0,0,168000,-168000,-168000
20200312,048120,台泥元大93購02,0.89,0.95,0.89,0.95,0.00,0.00,398000,4,366100,0,0,0,0,0,0,0,398000,-398000,-398000
20200312,048121,亞德客元大93購05,,,,,0.00,0.00,0,0,0,0,0,0,0,0,0,0,0,0,0
20200312,048122,台達電元大96購02,0.34,0.34,0.20,0.20,-0.21,-51.22,188000,5,52360,0,0,0,0,0,0,50000,138000,-88000,-88000
20200312,048123,大立光元大93購27,,,,,0.00,0.00,0,0,0,0,0,0,0,0,0,0,0,0,0
20200312,048124,大立光元大95購03,0.39,0.39,0.28,0.29,-0.62,-68.13,12000,3,3570,0,0,0,0,0,0,10000,2000,8000,8000
20200312,048125,和鑫元大96購01,,,,,0.00,0.00,0,0,0,0,0,0,0,0,0,0,0,0,0
20200312,048126,TPK元大94購02,,,,,0.00,0.00,0,0,0,0,0,0,0,0,0,0,0,0,0
20200312,048127,麗豐元大94購01,,,,,0.00,0.00,0,0,0,0,0,0,0,0,0,0,0,0,0
20200312,048128,超眾元大95購01,0.33,0.33,0.33,0.33,-0.11,-25.0,82000,1,27060,0,0,0,0,0,0,82000,0,82000,82000
20200312,048129,力成元大93購02,0.36,0.36,0.27,0.27,-1.21,-81.76,200000,3,61500,0,0,0,0,0,0,100000,100000,0,0
20200312,04812P,國巨元大95售03,0.04,0.05,0.04,0.05,0.00,0.00,13000,3,550,0,0,0,0,0,0,8000,3000,5000,5000
20200312,048130,美利達元大96購01,0.60,0.61,0.46,0.46,-0.28,-37.84,57000,4,31190,0,0,0,0,0,0,34000,23000,11000,11000
20200312,048131,全新國票94購02,0.01,0.01,0.01,0.01,0.00,0.00,50000,1,500,0,0,0,0,0,0,0,0,0,0
20200312,048132,冠德國票94購01,,,,,0.00,0.00,0,0,0,0,0,0,0,0,0,0,0,0,0
20200312,048133,臻鼎國票94購01,0.05,0.05,0.01,0.01,-0.10,-90.91,62000,4,2000,0,0,0,0,0,0,42000,20000,22000,22000
20200312,048134,祥碩國票93購02,,,,,0.00,0.00,0,0,0,0,0,0,0,0,0,0,0,0,0
20200312,048135,瀚宇博國票94購01,,,,,0.00,0.00,0,0,0,0,0,0,0,0,0,0,0,0,0
20200312,048136,聯茂國票93購04,,,,,0.00,0.00,0,0,0,0,0,0,0,0,0,0,0,0,0
20200312,048137,力成國票93購01,,,,,0.00,0.00,0,0,0,0,0,0,0,0,0,0,0,0,0
20200312,048138,羅麗芬國票94購01,,,,,0.00,0.00,0,0,0,0,0,0,0,0,0,0,0,0,0
20200312,048139,南電國票94購02,,,,,0.00,0.00,0,0,0,0,0,0,0,0,0,0,0,0,0
20200312,04813P,智邦元大94售07,1.39,1.56,1.39,1.56,0.00,0.00,132000,4,194700,0,0,0,0,0,0,0,132000,-132000,-132000
20200312,048140,T50反1統一93購05,,,,,0.00,0.00,0,0,0,0,0,0,0,0,0,0,0,0,0
20200312,048141,大成鋼統一93購02,,,,,0.00,0.00,0,0,0,0,0,0,0,0,0,0,0,0,0
20200312,048142,聯電統一93購01,0.30,0.30,0.30,0.30,-0.13,-30.23,45000,1,13500,0,0,0,0,0,0,45000,0,45000,45000
20200312,048143,聯發科統一94購03,,,,,0.00,0.00,0,0,0,0,0,0,0,0,0,0,0,0,0
20200312,048144,華固統一93購01,,,,,0.00,0.00,0,0,0,0,0,0,0,0,0,0,0,0,0
20200312,048145,大立光統一93購10,0.12,0.12,0.09,0.10,-0.52,-83.87,80000,4,8200,0,0,0,0,0,0,80000,0,80000,80000
20200312,048146,大立光統一93購11,,,,,0.00,0.00,0,0,0,0,0,0,0,0,0,0,0,0,0
20200312,048147,元油反元富95購01,,,,,0.00,0.00,0,0,0,0,0,0,0,0,0,0,0,0,0
20200312,048148,欣興元富93購02,,,,,0.00,0.00,0,0,0,0,0,0,0,0,0,0,0,0,0
20200312,048149,泰鼎元富95購01,,,,,0.00,0.00,0,0,0,0,0,0,0,0,0,0,0,0,0
20200312,04814P,健策元大96售01,0.27,0.28,0.26,0.28,0.00,0.00,35000,6,9550,0,0,0,0,0,0,20000,15000,5000,5000
20200312,048150,矽力元富93購01,3.85,3.85,3.38,3.38,-1.82,-35.0,13000,2,48640,0,0,0,0,0,0,10000,3000,7000,7000
20200312,048151,世紀鋼元富93購01,,,,,0.00,0.00,0,0,0,0,0,0,0,0,0,0,0,0,0
20200312,048152,力山兆豐94購01,,,,,0.00,0.00,0,0,0,0,0,0,0,0,0,0,0,0,0
20200312,048153,台積電兆豐94購01,0.60,0.60,0.28,0.49,-0.41,-45.56,838000,28,372090,0,0,0,0,0,0,230000,587000,-357000,-357000
20200312,048154,旺宏兆豐94購01,0.25,0.25,0.12,0.17,-0.15,-46.88,700000,44,125380,0,0,0,0,0,0,30000,580000,-550000,-550000
20200312,048155,瑞昱兆豐93購01,,,,,0.00,0.00,0,0,0,0,0,0,0,0,0,0,0,0,0
20200312,048156,正崴兆豐93購01,,,,,0.00,0.00,0,0,0,0,0,0,0,0,0,0,0,0,0
20200312,048157,美律兆豐93購01,,,,,0.00,0.00,0,0,0,0,0,0,0,0,0,0,0,0,0
20200312,048158,大立光兆豐95購01,0.17,0.17,0.16,0.16,0.00,0.00,418000,3,70860,0,0,0,0,0,0,0,418000,-418000,-418000
20200312,048159,聯詠兆豐93購03,,,,,0.00,0.00,0,0,0,0,0,0,0,0,0,0,0,0,0
20200312,04815P,致伸元大94售04,,,,,0.00,0.00,0,0,0,0,0,0,0,0,0,0,0,0,0
20200312,048160,GIS兆豐95購01,,,,,0.00,0.00,0,0,0,0,0,0,0,0,0,0,0,0,0
20200312,048161,旺宏麥證94購01,0.39,0.39,0.23,0.23,-0.44,-65.67,220000,4,52290,220000,0,220000,0,0,0,220000,0,220000,220000
20200312,048162,矽力麥證93購01,3.00,3.00,2.45,2.45,-1.87,-43.29,20000,3,56250,16000,4000,12000,0,0,0,16000,4000,12000,12000
20200312,048163,南亞科台新93購01,,,,,0.00,0.00,0,0,0,0,0,0,0,0,0,0,0,0,0
20200312,048164,台光電康和93購01,,,,,0.00,0.00,0,0,0,0,0,0,0,0,0,0,0,0,0
20200312,048165,嘉澤康和93購01,,,,,0.00,0.00,0,0,0,0,0,0,0,0,0,0,0,0,0
20200312,048166,滬深2X永豐96購02,,,,,0.00,0.00,0,0,0,0,0,0,0,0,0,0,0,0,0
20200312,048167,旺宏永豐93購04,,,,,0.00,0.00,0,0,0,0,0,0,0,0,0,0,0,0,0
20200312,048168,致茂永豐93購02,,,,,0.00,0.00,0,0,0,0,0,0,0,0,0,0,0,0,0
20200312,048169,瑞昱永豐93購02,,,,,0.00,0.00,0,0,0,0,0,0,0,0,0,0,0,0,0
20200312,04816P,台積電兆豐94售06,,,,,0.00,0.00,0,0,0,0,0,0,0,0,0,0,0,0,0
20200312,048170,智原永豐93購02,,,,,0.00,0.00,0,0,0,0,0,0,0,0,0,0,0,0,0
20200312,048171,創意永豐93購03,,,,,0.00,0.00,0,0,0,0,0,0,0,0,0,0,0,0,0
20200312,048172,祥碩永豐93購02,4.65,4.65,4.65,4.65,0.00,0.00,10000,1,46500,0,0,0,0,0,0,0,10000,-10000,-10000
20200312,048173,上海銀永豐93購02,,,,,0.00,0.00,0,0,0,0,0,0,0,0,0,0,0,0,0
20200312,048174,東陽中信93購01,,,,,0.00,0.00,0,0,0,0,0,0,0,0,0,0,0,0,0
20200312,048175,矽力國泰95購01,,,,,0.00,0.00,0,0,0,0,0,0,0,0,0,0,0,0,0
20200312,048176,美利達國泰94購01,,,,,0.00,0.00,0,0,0,0,0,0,0,0,0,0,0,0,0
20200312,048177,臺指反富邦99購01,0.62,0.82,0.58,0.82,+0.29,54.72,80000,9,56390,0,0,0,0,0,0,20000,60000,-40000,-40000
20200312,048178,上銀富邦95購02,0.31,0.31,0.15,0.16,-0.25,-60.98,1254000,43,230110,0,0,0,0,0,0,91000,1143000,-1052000,-1052000
20200312,048179,臻鼎富邦97購01,0.29,0.30,0.27,0.29,-0.21,-42.0,85000,9,23950,0,0,0,0,0,0,7000,60000,-53000,-53000
20200312,04817P,創意國票95售02,3.19,4.26,3.19,4.08,+1.45,55.13,60000,5,229000,0,0,0,0,0,0,40000,20000,20000,20000
20200312,048180,聯茂亞東93購02,,,,,0.00,0.00,0,0,0,0,0,0,0,0,0,0,0,0,0
20200312,048181,A50正2群益95購01,0.15,0.15,0.15,0.15,-0.13,-46.43,10000,1,1500,0,0,0,0,0,0,0,10000,-10000,-10000
20200312,048182,祥碩群益93購02,,,,,0.00,0.00,0,0,0,0,0,0,0,0,0,0,0,0,0
20200312,048183,上海銀群益94購01,,,,,0.00,0.00,0,0,0,0,0,0,0,0,0,0,0,0,0
20200312,048184,達運群益93購01,,,,,0.00,0.00,0,0,0,0,0,0,0,0,0,0,0,0,0
20200312,048185,台郡群益93購04,,,,,0.00,0.00,0,0,0,0,0,0,0,0,0,0,0,0,0
20200312,048186,元黃金元大96購01,1.03,1.03,1.00,1.00,-0.16,-13.79,42000,3,42620,0,0,0,0,0,0,20000,22000,-2000,-2000
20200312,048187,臺指反元大96購04,,,,,0.00,0.00,0,0,0,0,0,0,0,0,0,0,0,0,0
20200312,048188,臺指反元大96購05,,,,,0.00,0.00,0,0,0,0,0,0,0,0,0,0,0,0,0
20200312,048189,臺指反元大96購06,1.02,1.03,0.94,0.94,0.00,0.00,10000,4,9820,0,0,0,0,0,0,10000,0,10000,10000
20200312,04818P,華新科永豐94售03,0.21,0.37,0.21,0.35,0.00,0.00,50000,11,14440,0,0,0,0,0,0,0,50000,-50000,-50000
20200312,048190,道瓊反元大96購02,1.43,1.83,1.42,1.74,+0.55,46.22,83000,9,138370,0,0,0,0,0,0,2000,81000,-79000,-79000
20200312,048191,亞德客元大93購06,,,,,0.00,0.00,0,0,0,0,0,0,0,0,0,0,0,0,0
20200312,048192,華通元大96購01,1.90,1.91,1.15,1.15,-0.86,-42.79,405000,37,609540,0,0,0,0,0,0,232000,304000,-72000,-72000
20200312,048193,旺宏元大94購05,1.06,1.06,1.04,1.04,-0.58,-35.8,104000,2,108240,0,0,0,0,0,0,4000,100000,-96000,-96000
20200312,048194,華邦電元大94購04,,,,,0.00,0.00,0,0,0,0,0,0,0,0,0,0,0,0,0
20200312,048195,聯發科元大93購23,,,,,0.00,0.00,0,0,0,0,0,0,0,0,0,0,0,0,0
20200312,048196,聯發科元大93購24,,,,,0.00,0.00,0,0,0,0,0,0,0,0,0,0,0,0,0
20200312,048197,義隆元大93購04,,,,,0.00,0.00,0,0,0,0,0,0,0,0,0,0,0,0,0
20200312,048198,大立光元大93購28,,,,,0.00,0.00,0,0,0,0,0,0,0,0,0,0,0,0,0
20200312,048199,大立光元大94購03,0.25,0.25,0.19,0.19,-0.62,-76.54,10000,2,2200,0,0,0,0,0,0,0,10000,-10000,-10000
20200312,04819P,嘉澤永豐94售01,0.43,0.48,0.43,0.48,0.00,0.00,20000,2,9100,0,0,0,0,0,0,0,20000,-20000,-20000
20200312,048200,欣興元大93購07,0.01,0.01,0.01,0.01,0.00,0.00,7000,7,70,0,0,0,0,0,0,0,7000,-7000,-7000
20200312,048201,智易元大93購06,,,,,0.00,0.00,0,0,0,0,0,0,0,0,0,0,0,0,0
20200312,048202,瑞儀元大93購04,,,,,0.00,0.00,0,0,0,0,0,0,0,0,0,0,0,0,0
20200312,048203,矽力元大93購02,3.65,3.65,2.63,2.94,-1.75,-37.31,95000,8,298650,0,0,0,0,0,0,55000,40000,15000,15000
20200312,048204,訊芯元大93購06,,,,,0.00,0.00,0,0,0,0,0,0,0,0,0,0,0,0,0
20200312,048205,臺股指元大93購39,,,,,0.00,0.00,0,0,0,0,0,0,0,0,0,0,0,0,0
20200312,048206,臺股指元大93購40,,,,,0.00,0.00,0,0,0,0,0,0,0,0,0,0,0,0,0
20200312,048207,臺股指元大93購41,,,,,0.00,0.00,0,0,0,0,0,0,0,0,0,0,0,0,0
20200312,048208,臺股指元大93購42,,,,,0.00,0.00,0,0,0,0,0,0,0,0,0,0,0,0,0
20200312,048209,臺股指元大93購43,,,,,0.00,0.00,0,0,0,0,0,0,0,0,0,0,0,0,0
20200312,04820P,聯茂永豐94售02,0.57,0.73,0.56,0.73,0.00,0.00,240000,12,154500,0,0,0,0,0,0,0,240000,-240000,-240000
20200312,048210,鴻海日盛93購01,,,,,0.00,0.00,0,0,0,0,0,0,0,0,0,0,0,0,0
20200312,048211,大立光日盛93購01,,,,,0.00,0.00,0,0,0,0,0,0,0,0,0,0,0,0,0
20200312,048212,美利達日盛93購01,,,,,0.00,0.00,0,0,0,0,0,0,0,0,0,0,0,0,0
20200312,048213,群創麥證93購02,,,,,0.00,0.00,0,0,0,0,0,0,0,0,0,0,0,0,0
20200312,048214,滬深2X凱基96購03,,,,,0.00,0.00,0,0,0,0,0,0,0,0,0,0,0,0,0
20200312,048215,A50正2凱基95購01,,,,,0.00,0.00,0,0,0,0,0,0,0,0,0,0,0,0,0
20200312,048216,元油反凱基93購01,,,,,0.00,0.00,0,0,0,0,0,0,0,0,0,0,0,0,0
20200312,048217,亞德客凱基93購06,0.79,0.79,0.79,0.79,-0.61,-43.57,10000,1,7900,0,0,0,0,0,0,10000,0,10000,10000
20200312,048218,上銀凱基93購07,,,,,0.00,0.00,0,0,0,0,0,0,0,0,0,0,0,0,0
20200312,048219,為升凱基93購06,,,,,0.00,0.00,0,0,0,0,0,0,0,0,0,0,0,0,0
20200312,04821P,臺股指永豐94售01,,,,,0.00,0.00,0,0,0,0,0,0,0,0,0,0,0,0,0
20200312,048220,鴻海凱基93購35,2.07,2.13,1.47,1.47,0.00,0.00,50000,8,97140,0,0,0,0,0,0,0,50000,-50000,-50000
20200312,048221,鴻海凱基95購01,2.26,2.26,1.78,1.78,-0.97,-35.27,14000,9,27000,0,0,0,0,0,0,3000,13000,-10000,-10000
20200312,048222,台積電凱基93購26,2.76,2.76,2.76,2.76,-1.66,-37.56,10000,1,27600,0,0,0,0,0,0,0,10000,-10000,-10000
20200312,048223,微星凱基93購02,,,,,0.00,0.00,0,0,0,0,0,0,0,0,0,0,0,0,0
20200312,048224,聯發科凱基93購31,,,,,0.00,0.00,0,0,0,0,0,0,0,0,0,0,0,0,0
20200312,048225,全新凱基93購03,,,,,0.00,0.00,0,0,0,0,0,0,0,0,0,0,0,0,0
20200312,048226,大立光凱基93購35,,,,,0.00,0.00,0,0,0,0,0,0,0,0,0,0,0,0,0
20200312,048227,亞光凱基93購05,,,,,0.00,0.00,0,0,0,0,0,0,0,0,0,0,0,0,0
20200312,048228,和鑫凱基93購02,,,,,0.00,0.00,0,0,0,0,0,0,0,0,0,0,0,0,0
20200312,048229,華晶科凱基93購02,,,,,0.00,0.00,0,0,0,0,0,0,0,0,0,0,0,0,0
20200312,04822P,台積電元富94售08,,,,,0.00,0.00,0,0,0,0,0,0,0,0,0,0,0,0,0
20200312,048230,瀚宇博凱基93購03,,,,,0.00,0.00,0,0,0,0,0,0,0,0,0,0,0,0,0
20200312,048231,台表科凱基93購06,0.02,0.02,0.02,0.02,0.00,0.00,8000,1,160,0,0,0,0,0,0,8000,0,8000,8000
20200312,048232,GIS凱基93購07,,,,,0.00,0.00,0,0,0,0,0,0,0,0,0,0,0,0,0
20200312,048233,南電凱基93購05,,,,,0.00,0.00,0,0,0,0,0,0,0,0,0,0,0,0,0
20200312,048234,美利達凱基93購03,,,,,0.00,0.00,0,0,0,0,0,0,0,0,0,0,0,0,0
20200312,048235,滬深2X國票93購04,,,,,0.00,0.00,0,0,0,0,0,0,0,0,0,0,0,0,0
20200312,048236,A50正2國票97購02,,,,,0.00,0.00,0,0,0,0,0,0,0,0,0,0,0,0,0
20200312,048237,致茂國票94購01,,,,,0.00,0.00,0,0,0,0,0,0,0,0,0,0,0,0,0
20200312,048238,奇鋐國票94購01,,,,,0.00,0.00,0,0,0,0,0,0,0,0,0,0,0,0,0
20200312,048239,嘉澤國票93購01,,,,,0.00,0.00,0,0,0,0,0,0,0,0,0,0,0,0,0
20200312,04823P,台積電元富94售09,0.63,0.75,0.63,0.75,0.00,0.00,30000,3,20850,0,0,0,0,0,0,0,30000,-30000,-30000
20200312,048240,嘉聯益國票94購03,0.09,0.09,0.06,0.06,-0.07,-53.85,215000,7,13850,0,0,0,0,0,0,135000,80000,55000,55000
20200312,048241,樺漢國票93購01,,,,,0.00,0.00,0,0,0,0,0,0,0,0,0,0,0,0,0
20200312,048242,統一兆豐93購01,,,,,0.00,0.00,0,0,0,0,0,0,0,0,0,0,0,0,0
20200312,048243,儒鴻兆豐94購01,,,,,0.00,0.00,0,0,0,0,0,0,0,0,0,0,0,0,0
20200312,048244,廣宇兆豐93購01,,,,,0.00,0.00,0,0,0,0,0,0,0,0,0,0,0,0,0
20200312,048245,台積電兆豐93購07,,,,,0.00,0.00,0,0,0,0,0,0,0,0,0,0,0,0,0
20200312,048246,京元電兆豐93購02,0.02,0.02,0.02,0.02,0.00,0.00,50000,3,1000,0,0,0,0,0,0,0,50000,-50000,-50000
20200312,048247,聯發科兆豐93購03,0.06,0.06,0.02,0.02,-0.10,-83.33,223000,22,6660,0,0,0,0,0,0,0,223000,-223000,-223000
20200312,048248,聯發科兆豐95購01,0.08,0.08,0.04,0.04,-0.08,-66.67,494000,25,24330,0,0,0,0,0,0,256000,206000,50000,50000
20200312,048249,嘉澤兆豐94購01,0.20,0.20,0.20,0.20,-0.22,-52.38,30000,1,6000,0,0,0,0,0,0,30000,0,30000,30000
20200312,04824P,亞泥中信94售02,0.50,0.51,0.50,0.51,+0.08,18.6,2000,2,1010,0,0,0,0,0,0,2000,0,2000,2000
20200312,048250,矽創兆豐93購02,,,,,0.00,0.00,0,0,0,0,0,0,0,0,0,0,0,0,0
20200312,048251,T50反1統一93購06,,,,,0.00,0.00,0,0,0,0,0,0,0,0,0,0,0,0,0
20200312,048252,T50反1統一93購07,,,,,0.00,0.00,0,0,0,0,0,0,0,0,0,0,0,0,0
20200312,048253,T50反1統一93購08,,,,,0.00,0.00,0,0,0,0,0,0,0,0,0,0,0,0,0
20200312,048254,深中小統一93購01,,,,,0.00,0.00,0,0,0,0,0,0,0,0,0,0,0,0,0
20200312,048255,臺指反統一94購01,,,,,0.00,0.00,0,0,0,0,0,0,0,0,0,0,0,0,0
20200312,048256,鴻海統一93購08,0.49,0.49,0.45,0.49,-0.50,-50.51,51000,4,23990,0,0,0,0,0,0,50000,1000,49000,49000
20200312,048257,台積電統一93購07,,,,,0.00,0.00,0,0,0,0,0,0,0,0,0,0,0,0,0
20200312,048258,國泰金統一93購01,,,,,0.00,0.00,0,0,0,0,0,0,0,0,0,0,0,0,0
20200312,048259,新日興統一93購01,0.38,0.38,0.33,0.33,-0.14,-29.79,108000,6,39240,0,0,0,0,0,0,108000,0,108000,108000
20200312,04825P,元大金中信94售01,0.57,0.71,0.56,0.56,+0.17,43.59,62000,6,37270,0,0,0,0,0,0,17000,35000,-18000,-18000
20200312,048260,鴻海元富93購06,,,,,0.00,0.00,0,0,0,0,0,0,0,0,0,0,0,0,0
20200312,048261,鴻海元富95購01,0.12,0.14,0.07,0.08,-0.13,-61.9,622000,17,60780,0,0,0,0,0,0,245000,377000,-132000,-132000
20200312,048262,台積電元富94購01,,,,,0.00,0.00,0,0,0,0,0,0,0,0,0,0,0,0,0
20200312,048263,台積電元富95購01,2.15,2.15,2.15,2.15,-0.63,-22.66,1000,1,2150,0,0,0,0,0,0,0,1000,-1000,-1000
20200312,048264,華新科元富93購01,,,,,0.00,0.00,0,0,0,0,0,0,0,0,0,0,0,0,0
20200312,048265,創意元富93購05,,,,,0.00,0.00,0,0,0,0,0,0,0,0,0,0,0,0,0
20200312,048266,臺指反中信95購01,0.97,0.97,0.97,0.97,+0.27,38.57,100000,1,97000,0,0,0,0,0,0,100000,0,100000,100000
20200312,048267,元金反中信93購01,,,,,0.00,0.00,0,0,0,0,0,0,0,0,0,0,0,0,0
20200312,048268,長榮航中信95購01,0.08,0.08,0.07,0.07,-0.03,-30.0,30000,3,2200,0,0,0,0,0,0,0,30000,-30000,-30000
20200312,048269,瀚宇博國泰95購01,0.30,0.30,0.30,0.30,-0.20,-40.0,10000,1,3000,0,0,0,0,0,0,0,10000,-10000,-10000
20200312,04826P,華新科麥證95售01,0.65,0.80,0.65,0.80,+0.23,40.35,164000,8,114800,20000,144000,-124000,0,0,0,75000,144000,-69000,-69000
20200312,048270,T50反1富邦99購01,0.82,1.08,0.82,1.08,+0.37,52.11,26000,5,24800,0,0,0,0,0,0,21000,5000,16000,16000
20200312,048271,可成富邦95購02,0.04,0.04,0.04,0.04,-0.08,-66.67,1200000,5,48000,0,0,0,0,0,0,1100000,0,1100000,1100000
20200312,048272,新光金富邦98購01,,,,,0.00,0.00,0,0,0,0,0,0,0,0,0,0,0,0,0
20200312,048273,南電富邦97購01,1.09,1.09,0.81,0.81,-0.29,-26.36,81000,9,79270,0,0,0,0,0,0,56000,64000,-8000,-8000
20200312,048274,矽力台新93購01,2.10,2.10,1.99,1.99,-0.67,-25.19,20000,2,40900,0,0,0,0,0,0,20000,0,20000,20000
20200312,048275,A50正2永豐93購01,,,,,0.00,0.00,0,0,0,0,0,0,0,0,0,0,0,0,0
20200312,048276,旺宏永豐94購01,0.07,0.07,0.07,0.07,-0.02,-22.22,251000,1,17570,0,0,0,0,0,0,0,251000,-251000,-251000
20200312,048277,建準永豐93購02,,,,,0.00,0.00,0,0,0,0,0,0,0,0,0,0,0,0,0
20200312,048278,聯發科永豐93購03,,,,,0.00,0.00,0,0,0,0,0,0,0,0,0,0,0,0,0
20200312,048279,聯鈞永豐93購01,0.20,0.20,0.05,0.05,-0.25,-83.33,21000,3,4050,0,0,0,0,0,0,21000,0,21000,21000
20200312,04827P,國巨凱基94售09,0.12,0.12,0.12,0.12,0.00,0.00,10000,1,1200,0,0,0,0,0,0,10000,0,10000,10000
20200312,048280,康普永豐93購01,,,,,0.00,0.00,0,0,0,0,0,0,0,0,0,0,0,0,0
20200312,048281,矽力永豐93購02,0.32,0.32,0.22,0.26,-0.30,-53.57,42000,4,10760,0,0,0,0,0,0,30000,12000,18000,18000
20200312,048282,世紀鋼永豐94購01,,,,,0.00,0.00,0,0,0,0,0,0,0,0,0,0,0,0,0
20200312,048283,亞德客中信94購01,0.74,0.74,0.48,0.48,-0.49,-50.52,44000,4,26640,0,0,0,0,0,0,20000,24000,-4000,-4000
20200312,048284,臺股指中信95購04,,,,,0.00,0.00,0,0,0,0,0,0,0,0,0,0,0,0,0
20200312,048285,華新科亞東93購01,,,,,0.00,0.00,0,0,0,0,0,0,0,0,0,0,0,0,0
20200312,048286,滬深2X兆豐94購04,0.60,0.60,0.44,0.48,-0.19,-28.36,227000,33,115540,0,0,0,0,0,0,133000,94000,39000,39000
20200312,048287,嘉晶兆豐94購01,0.39,0.39,0.30,0.30,-0.10,-25.0,562000,16,203010,0,0,0,0,0,0,352000,210000,142000,142000
20200312,048288,T50反1群益93購05,0.25,0.55,0.25,0.55,+0.39,243.75,483000,13,189250,0,0,0,0,0,0,483000,0,483000,483000
20200312,048289,臺指反群益95購01,0.42,0.57,0.42,0.54,+0.27,100.0,561000,25,272670,0,0,0,0,0,0,361000,300000,61000,61000
20200312,04828P,聯發科凱基94售15,0.80,1.50,0.80,1.33,+0.64,92.75,679000,13,883580,0,0,0,0,0,0,588000,125000,463000,463000
20200312,048290,國巨群益93購06,,,,,0.00,0.00,0,0,0,0,0,0,0,0,0,0,0,0,0
20200312,048291,台積電群益93購09,,,,,0.00,0.00,0,0,0,0,0,0,0,0,0,0,0,0,0
20200312,048292,微星群益93購01,,,,,0.00,0.00,0,0,0,0,0,0,0,0,0,0,0,0,0
20200312,048293,聯詠群益93購04,,,,,0.00,0.00,0,0,0,0,0,0,0,0,0,0,0,0,0
20200312,048294,智原群益93購02,,,,,0.00,0.00,0,0,0,0,0,0,0,0,0,0,0,0,0
20200312,048295,泰鼎群益93購01,,,,,0.00,0.00,0,0,0,0,0,0,0,0,0,0,0,0,0
20200312,048296,康控群益93購03,,,,,0.00,0.00,0,0,0,0,0,0,0,0,0,0,0,0,0
20200312,048297,GIS群益93購02,,,,,0.00,0.00,0,0,0,0,0,0,0,0,0,0,0,0,0
20200312,048298,華通麥證94購01,0.71,0.72,0.41,0.41,-0.67,-62.04,135000,14,78880,65000,70000,-5000,0,0,0,65000,70000,-5000,-5000
20200312,048299,聯詠麥證93購02,0.33,0.33,0.33,0.33,0.00,0.00,10000,1,3300,10000,0,10000,0,0,0,10000,0,10000,10000
20200312,04829P,大立光凱基94售14,0.32,0.32,0.32,0.32,+0.22,220.0,100000,1,32000,0,0,0,0,0,0,100000,0,100000,100000
20200312,048300,FB上証凱基93購01,,,,,0.00,0.00,0,0,0,0,0,0,0,0,0,0,0,0,0
20200312,048301,元上證凱基93購01,,,,,0.00,0.00,0,0,0,0,0,0,0,0,0,0,0,0,0
20200312,048302,上証反凱基93購01,0.47,0.47,0.47,0.47,+0.14,42.42,110000,11,51700,0,0,0,0,0,0,0,110000,-110000,-110000
20200312,048303,A50凱基96購01,,,,,0.00,0.00,0,0,0,0,0,0,0,0,0,0,0,0,0
20200312,048304,滬深2X凱基93購04,,,,,0.00,0.00,0,0,0,0,0,0,0,0,0,0,0,0,0
20200312,048305,深100凱基96購01,0.56,0.58,0.56,0.58,-0.17,-22.67,68000,2,38140,0,0,0,0,0,0,65000,3000,62000,62000
20200312,048306,A50反1凱基93購01,,,,,0.00,0.00,0,0,0,0,0,0,0,0,0,0,0,0,0
20200312,048307,道瓊指凱基93購01,,,,,0.00,0.00,0,0,0,0,0,0,0,0,0,0,0,0,0
20200312,048308,儒鴻凱基93購05,,,,,0.00,0.00,0,0,0,0,0,0,0,0,0,0,0,0,0
20200312,048309,寶齡凱基93購01,,,,,0.00,0.00,0,0,0,0,0,0,0,0,0,0,0,0,0
20200312,04830P,大立光凱基94售15,0.13,0.24,0.13,0.24,0.00,0.00,275000,15,48100,0,0,0,0,0,0,0,275000,-275000,-275000
20200312,048310,台達電凱基93購05,,,,,0.00,0.00,0,0,0,0,0,0,0,0,0,0,0,0,0
20200312,048311,台積電凱基93購28,3.15,3.20,3.03,3.03,-2.67,-46.84,29000,3,90770,0,0,0,0,0,0,0,29000,-29000,-29000
20200312,048312,致茂凱基93購02,,,,,0.00,0.00,0,0,0,0,0,0,0,0,0,0,0,0,0
20200312,048313,南亞科凱基93購06,,,,,0.00,0.00,0,0,0,0,0,0,0,0,0,0,0,0,0
20200312,048314,京元電凱基93購04,,,,,0.00,0.00,0,0,0,0,0,0,0,0,0,0,0,0,0
20200312,048315,聯發科凱基93購32,0.13,0.13,0.11,0.11,-0.11,-50.0,30000,2,3700,0,0,0,0,0,0,20000,10000,10000,10000
20200312,048316,可成凱基93購15,,,,,0.00,0.00,0,0,0,0,0,0,0,0,0,0,0,0,0
20200312,048317,大立光凱基93購36,,,,,0.00,0.00,0,0,0,0,0,0,0,0,0,0,0,0,0
20200312,048318,大立光凱基93購37,,,,,0.00,0.00,0,0,0,0,0,0,0,0,0,0,0,0,0
20200312,048319,嘉晶凱基93購04,,,,,0.00,0.00,0,0,0,0,0,0,0,0,0,0,0,0,0
20200312,04831P,聯詠富邦96售01,0.61,0.69,0.61,0.64,+0.06,10.34,1135000,15,756700,0,0,0,0,0,0,105000,1030000,-925000,-925000
20200312,048320,聯詠凱基93購08,0.18,0.18,0.18,0.18,-0.23,-56.1,40000,1,7200,0,0,0,0,0,0,40000,0,40000,40000
20200312,048321,欣興凱基93購03,,,,,0.00,0.00,0,0,0,0,0,0,0,0,0,0,0,0,0
20200312,048322,康控凱基93購02,,,,,0.00,0.00,0,0,0,0,0,0,0,0,0,0,0,0,0
20200312,048323,聯茂凱基93購09,,,,,0.00,0.00,0,0,0,0,0,0,0,0,0,0,0,0,0
20200312,048324,訊芯凱基93購03,,,,,0.00,0.00,0,0,0,0,0,0,0,0,0,0,0,0,0
20200312,048325,美利達凱基93購05,,,,,0.00,0.00,0,0,0,0,0,0,0,0,0,0,0,0,0
20200312,048326,滬深2X國泰94購03,,,,,0.00,0.00,0,0,0,0,0,0,0,0,0,0,0,0,0
20200312,048327,緯穎國泰94購01,,,,,0.00,0.00,0,0,0,0,0,0,0,0,0,0,0,0,0
20200312,048328,滬深2X永昌94購01,0.62,0.70,0.62,0.64,-0.28,-30.43,70000,4,44600,0,0,0,0,0,0,50000,20000,30000,30000
20200312,048329,台積電永昌93購07,,,,,0.00,0.00,0,0,0,0,0,0,0,0,0,0,0,0,0
20200312,04832P,為升元大94售09,,,,,0.00,0.00,0,0,0,0,0,0,0,0,0,0,0,0,0
20200312,048330,大立光永昌93購07,,,,,0.00,0.00,0,0,0,0,0,0,0,0,0,0,0,0,0
20200312,048331,臺指反富邦97購01,0.45,0.45,0.42,0.42,+0.13,44.83,70000,3,30030,0,0,0,0,0,0,69000,0,69000,69000
20200312,048332,台積電富邦94購02,,,,,0.00,0.00,0,0,0,0,0,0,0,0,0,0,0,0,0
20200312,048333,大立光富邦95購01,0.28,0.28,0.28,0.28,0.00,0.00,5000,1,1400,0,0,0,0,0,0,0,5000,-5000,-5000
20200312,048334,A50正2元大96購01,0.27,0.27,0.23,0.25,-0.09,-26.47,90000,4,22300,0,0,0,0,0,0,0,90000,-90000,-90000
20200312,048335,和大元大93購03,,,,,0.00,0.00,0,0,0,0,0,0,0,0,0,0,0,0,0
20200312,048336,光磊元大93購02,,,,,0.00,0.00,0,0,0,0,0,0,0,0,0,0,0,0,0
20200312,048337,致茂元大93購04,,,,,0.00,0.00,0,0,0,0,0,0,0,0,0,0,0,0,0
20200312,048338,正崴元大93購01,,,,,0.00,0.00,0,0,0,0,0,0,0,0,0,0,0,0,0
20200312,048339,友達元大95購01,0.35,0.35,0.35,0.35,0.00,0.00,10000,1,3500,0,0,0,0,0,0,0,10000,-10000,-10000
20200312,04833P,鴻海元大94售16,1.35,1.90,1.35,1.90,+0.75,65.22,1178000,24,1791440,0,0,0,0,0,0,64000,1117000,-1053000,-1053000
20200312,048340,聯發科元大93購25,,,,,0.00,0.00,0,0,0,0,0,0,0,0,0,0,0,0,0
20200312,048341,全新元大94購03,,,,,0.00,0.00,0,0,0,0,0,0,0,0,0,0,0,0,0
20200312,048342,強茂元大93購01,,,,,0.00,0.00,0,0,0,0,0,0,0,0,0,0,0,0,0
20200312,048343,大立光元大93購29,,,,,0.00,0.00,0,0,0,0,0,0,0,0,0,0,0,0,0
20200312,048344,大立光元大93購30,,,,,0.00,0.00,0,0,0,0,0,0,0,0,0,0,0,0,0
20200312,048345,緯創元大94購01,0.42,0.42,0.42,0.42,-0.42,-50.0,68000,1,28560,0,0,0,0,0,0,0,68000,-68000,-68000
20200312,048346,智易元大95購01,0.17,0.18,0.10,0.10,-0.10,-50.0,658000,21,96940,0,0,0,0,0,0,57000,571000,-514000,-514000
20200312,048347,康普元大93購02,,,,,0.00,0.00,0,0,0,0,0,0,0,0,0,0,0,0,0
20200312,048348,矽力元大93購03,2.44,2.44,2.00,2.00,-1.10,-35.48,14000,3,31080,0,0,0,0,0,0,7000,7000,0,0
20200312,048349,美利達元大96購02,0.85,0.86,0.58,0.58,-0.46,-44.23,212000,9,150000,0,0,0,0,0,0,113000,99000,14000,14000
20200312,04834P,鴻海元大94售17,0.58,0.91,0.58,0.91,+0.47,106.82,629000,13,511080,0,0,0,0,0,0,159000,470000,-311000,-311000
20200312,048350,世紀鋼元大95購01,1.51,1.53,1.28,1.37,-0.26,-15.95,851000,25,1180580,0,0,0,0,0,0,356000,500000,-144000,-144000
20200312,048351,旺宏台新94購02,,,,,0.00,0.00,0,0,0,0,0,0,0,0,0,0,0,0,0
20200312,048352,嘉澤台新93購01,,,,,0.00,0.00,0,0,0,0,0,0,0,0,0,0,0,0,0
20200312,048353,嘉聯益台新93購02,,,,,0.00,0.00,0,0,0,0,0,0,0,0,0,0,0,0,0
20200312,048354,滬深2X永豐93購03,,,,,0.00,0.00,0,0,0,0,0,0,0,0,0,0,0,0,0
20200312,048355,國巨永豐93購04,1.89,1.89,1.89,1.89,0.00,0.00,10000,1,18900,0,0,0,0,0,0,0,10000,-10000,-10000
20200312,048356,華泰永豐93購01,,,,,0.00,0.00,0,0,0,0,0,0,0,0,0,0,0,0,0
20200312,048357,漢唐永豐93購04,,,,,0.00,0.00,0,0,0,0,0,0,0,0,0,0,0,0,0
20200312,048358,嘉晶永豐93購03,0.03,0.10,0.01,0.01,0.00,0.00,263000,28,21250,0,0,0,0,0,0,0,263000,-263000,-263000
20200312,048359,奇鋐永豐93購02,,,,,0.00,0.00,0,0,0,0,0,0,0,0,0,0,0,0,0
20200312,04835P,鴻海元大94售18,0.94,1.45,0.94,1.45,0.00,0.00,207000,5,296580,0,0,0,0,0,0,7000,200000,-193000,-193000
20200312,048360,華晶科永豐93購02,,,,,0.00,0.00,0,0,0,0,0,0,0,0,0,0,0,0,0
20200312,048361,揚明光永豐93購02,,,,,0.00,0.00,0,0,0,0,0,0,0,0,0,0,0,0,0
20200312,048362,康控永豐93購01,,,,,0.00,0.00,0,0,0,0,0,0,0,0,0,0,0,0,0
20200312,048363,中磊永豐93購02,,,,,0.00,0.00,0,0,0,0,0,0,0,0,0,0,0,0,0
20200312,048364,臺股指永豐93購04,0.01,0.01,0.01,0.01,0.00,0.00,176000,1,1760,0,0,0,0,0,0,0,0,0,0
20200312,048365,T50反1統一93購09,,,,,0.00,0.00,0,0,0,0,0,0,0,0,0,0,0,0,0
20200312,048366,深中小統一93購02,,,,,0.00,0.00,0,0,0,0,0,0,0,0,0,0,0,0,0
20200312,048367,華邦電統一93購01,,,,,0.00,0.00,0,0,0,0,0,0,0,0,0,0,0,0,0
20200312,048368,燿華統一93購01,,,,,0.00,0.00,0,0,0,0,0,0,0,0,0,0,0,0,0
20200312,048369,友達統一93購06,,,,,0.00,0.00,0,0,0,0,0,0,0,0,0,0,0,0,0
20200312,04836P,台積電元大94售22,,,,,0.00,0.00,0,0,0,0,0,0,0,0,0,0,0,0,0
20200312,048370,可成統一93購04,,,,,0.00,0.00,0,0,0,0,0,0,0,0,0,0,0,0,0
20200312,048371,華固統一93購02,1.32,1.32,1.32,1.32,-0.09,-6.38,10000,1,13200,0,0,0,0,0,0,10000,0,10000,10000
20200312,048372,美利達統一93購01,,,,,0.00,0.00,0,0,0,0,0,0,0,0,0,0,0,0,0
20200312,048373,A50正2元富95購01,0.86,0.86,0.77,0.85,-0.37,-30.33,68000,5,55100,0,0,0,0,0,0,8000,68000,-60000,-60000
20200312,048374,味全元富94購01,,,,,0.00,0.00,0,0,0,0,0,0,0,0,0,0,0,0,0
20200312,048375,儒鴻元富93購02,,,,,0.00,0.00,0,0,0,0,0,0,0,0,0,0,0,0,0
20200312,048376,台達電元富93購01,,,,,0.00,0.00,0,0,0,0,0,0,0,0,0,0,0,0,0
20200312,048377,燿華元富93購01,,,,,0.00,0.00,0,0,0,0,0,0,0,0,0,0,0,0,0
20200312,048378,貿聯元富93購01,,,,,0.00,0.00,0,0,0,0,0,0,0,0,0,0,0,0,0
20200312,048379,台郡元富96購01,0.88,0.88,0.81,0.86,-0.56,-39.44,17000,6,14870,0,0,0,0,0,0,17000,0,17000,17000
20200312,04837P,華新科元大94售05,0.73,1.06,0.73,1.06,+0.37,53.62,41000,32,32760,0,0,0,0,0,0,40000,1000,39000,39000
20200312,048380,T50反1國票94購02,0.66,0.66,0.66,0.66,+0.35,112.9,125000,1,82500,0,0,0,0,0,0,125000,0,125000,125000
20200312,048381,T50反1國票94購03,1.00,1.26,1.00,1.26,+0.67,113.56,38000,5,44430,0,0,0,0,0,0,38000,0,38000,38000
20200312,048382,T50反1國票96購01,0.37,0.37,0.36,0.37,0.00,0.00,310000,5,114600,0,0,0,0,0,0,310000,0,310000,310000
20200312,048383,元金2X國票99購01,1.17,1.17,1.17,1.17,-0.23,-16.43,15000,1,17550,0,0,0,0,0,0,0,15000,-15000,-15000
20200312,048384,遠東新國票94購01,,,,,0.00,0.00,0,0,0,0,0,0,0,0,0,0,0,0,0
20200312,048385,亞德客國票94購01,2.04,2.04,2.04,2.04,0.00,0.00,2000,1,4080,0,0,0,0,0,0,0,2000,-2000,-2000
20200312,048386,華新國票94購01,,,,,0.00,0.00,0,0,0,0,0,0,0,0,0,0,0,0,0
20200312,048387,台達電國票94購01,,,,,0.00,0.00,0,0,0,0,0,0,0,0,0,0,0,0,0
20200312,048388,華通國票94購01,,,,,0.00,0.00,0,0,0,0,0,0,0,0,0,0,0,0,0
20200312,048389,國巨國票94購01,,,,,0.00,0.00,0,0,0,0,0,0,0,0,0,0,0,0,0
20200312,04838P,宏達電元大95售02,1.94,1.97,1.94,1.97,0.00,0.00,78000,3,153300,0,0,0,0,0,0,0,78000,-78000,-78000
20200312,048390,國巨國票94購02,,,,,0.00,0.00,0,0,0,0,0,0,0,0,0,0,0,0,0
20200312,048391,友訊國票94購01,0.39,0.39,0.19,0.20,-0.20,-50.0,952000,23,302820,0,0,0,0,0,0,936000,16000,920000,920000
20200312,048392,宏碁國票94購01,,,,,0.00,0.00,0,0,0,0,0,0,0,0,0,0,0,0,0
20200312,048393,台光電國票93購02,,,,,0.00,0.00,0,0,0,0,0,0,0,0,0,0,0,0,0
20200312,048394,正崴國票94購01,,,,,0.00,0.00,0,0,0,0,0,0,0,0,0,0,0,0,0
20200312,048395,南亞科國票93購02,0.01,0.01,0.01,0.01,0.00,0.00,105000,1,1050,0,0,0,0,0,0,105000,0,105000,105000
20200312,048396,奇力新國票94購02,3.95,3.95,3.83,3.83,-0.66,-14.7,68000,3,263800,0,0,0,0,0,0,68000,0,68000,68000
20200312,048397,TPK國票94購02,,,,,0.00,0.00,0,0,0,0,0,0,0,0,0,0,0,0,0
20200312,048398,康普國票94購01,,,,,0.00,0.00,0,0,0,0,0,0,0,0,0,0,0,0,0
20200312,048399,祥碩國票94購01,11.20,11.20,10.40,10.40,0.00,0.00,12000,2,126400,0,0,0,0,0,0,0,12000,-12000,-12000
20200312,04839P,大立光元大94售17,1.22,1.27,1.22,1.27,+0.45,54.88,296000,13,371620,0,0,0,0,0,0,0,296000,-296000,-296000
20200312,048400,矽創國票93購01,,,,,0.00,0.00,0,0,0,0,0,0,0,0,0,0,0,0,0
20200312,048401,南電國票93購03,,,,,0.00,0.00,0,0,0,0,0,0,0,0,0,0,0,0,0
20200312,048402,聯茂兆豐95購01,0.06,0.06,0.06,0.06,0.00,0.00,10000,1,600,0,0,0,0,0,0,0,10000,-10000,-10000
20200312,048403,聯發科群益93購10,,,,,0.00,0.00,0,0,0,0,0,0,0,0,0,0,0,0,0
20200312,048404,大立光群益93購11,,,,,0.00,0.00,0,0,0,0,0,0,0,0,0,0,0,0,0
20200312,048405,嘉晶群益93購03,,,,,0.00,0.00,0,0,0,0,0,0,0,0,0,0,0,0,0
20200312,048406,欣興群益93購09,,,,,0.00,0.00,0,0,0,0,0,0,0,0,0,0,0,0,0
20200312,048407,貿聯群益93購04,,,,,0.00,0.00,0,0,0,0,0,0,0,0,0,0,0,0,0
20200312,048408,正文群益93購01,,,,,0.00,0.00,0,0,0,0,0,0,0,0,0,0,0,0,0
20200312,048409,致伸群益93購05,,,,,0.00,0.00,0,0,0,0,0,0,0,0,0,0,0,0,0
20200312,04840P,大立光元大94售18,0.94,0.94,0.94,0.94,0.00,0.00,100000,1,94000,0,0,0,0,0,0,0,100000,-100000,-100000
20200312,048410,和碩群益93購01,,,,,0.00,0.00,0,0,0,0,0,0,0,0,0,0,0,0,0
20200312,048411,嘉聯益群益93購02,,,,,0.00,0.00,0,0,0,0,0,0,0,0,0,0,0,0,0
20200312,048412,台勝科亞東93購01,,,,,0.00,0.00,0,0,0,0,0,0,0,0,0,0,0,0,0
20200312,048413,國巨第一93購01,,,,,0.00,0.00,0,0,0,0,0,0,0,0,0,0,0,0,0
20200312,048414,滬深2X統一98購01,,,,,0.00,0.00,0,0,0,0,0,0,0,0,0,0,0,0,0
20200312,048415,深中小統一93購03,,,,,0.00,0.00,0,0,0,0,0,0,0,0,0,0,0,0,0
20200312,048416,台達電統一93購02,,,,,0.00,0.00,0,0,0,0,0,0,0,0,0,0,0,0,0
20200312,048417,國巨統一94購01,9.20,9.25,7.15,7.40,-2.30,-23.71,36000,6,316800,0,0,0,0,0,0,2000,34000,-32000,-32000
20200312,048418,瑞昱統一93購04,,,,,0.00,0.00,0,0,0,0,0,0,0,0,0,0,0,0,0
20200312,048419,智易統一93購01,,,,,0.00,0.00,0,0,0,0,0,0,0,0,0,0,0,0,0
20200312,04841P,群創元大94售04,,,,,0.00,0.00,0,0,0,0,0,0,0,0,0,0,0,0,0
20200312,048420,祥碩統一93購01,,,,,0.00,0.00,0,0,0,0,0,0,0,0,0,0,0,0,0
20200312,048421,聯茂統一93購01,,,,,0.00,0.00,0,0,0,0,0,0,0,0,0,0,0,0,0
20200312,048422,瑞昱元富96購02,0.27,0.27,0.23,0.23,-0.23,-50.0,70000,3,17100,0,0,0,0,0,0,70000,0,70000,70000
20200312,048423,聯發科元富93購02,,,,,0.00,0.00,0,0,0,0,0,0,0,0,0,0,0,0,0
20200312,048424,揚明光元富95購01,,,,,0.00,0.00,0,0,0,0,0,0,0,0,0,0,0,0,0
20200312,048425,聯茂元富96購02,0.22,0.22,0.15,0.15,-0.18,-54.55,35000,3,6000,0,0,0,0,0,0,0,35000,-35000,-35000
20200312,048426,超眾元富93購01,,,,,0.00,0.00,0,0,0,0,0,0,0,0,0,0,0,0,0
20200312,048427,百和元富95購01,1.03,1.03,0.59,0.59,-0.59,-50.0,137000,18,117990,0,0,0,0,0,0,117000,30000,87000,87000
20200312,048428,滬深2X國票93購05,,,,,0.00,0.00,0,0,0,0,0,0,0,0,0,0,0,0,0
20200312,048429,旺宏國票94購02,0.02,0.02,0.02,0.02,-0.07,-77.78,50000,1,1000,0,0,0,0,0,0,0,50000,-50000,-50000
20200312,04842P,群創元大96售02,0.53,0.59,0.53,0.59,+0.14,31.11,211000,5,116850,0,0,0,0,0,0,72000,139000,-67000,-67000
20200312,048430,瑞昱國票93購02,,,,,0.00,0.00,0,0,0,0,0,0,0,0,0,0,0,0,0
20200312,048431,瑞昱國票94購01,,,,,0.00,0.00,0,0,0,0,0,0,0,0,0,0,0,0,0
20200312,048432,全新國票95購01,,,,,0.00,0.00,0,0,0,0,0,0,0,0,0,0,0,0,0
20200312,048433,聯詠國票94購01,0.91,0.91,0.76,0.76,-0.49,-39.2,30000,3,24700,0,0,0,0,0,0,10000,20000,-10000,-10000
20200312,048434,樺漢國票93購02,,,,,0.00,0.00,0,0,0,0,0,0,0,0,0,0,0,0,0
20200312,048435,致新國票93購01,0.02,0.02,0.02,0.02,0.00,0.00,50000,1,1000,0,0,0,0,0,0,0,50000,-50000,-50000
20200312,048436,聯茂日盛93購01,,,,,0.00,0.00,0,0,0,0,0,0,0,0,0,0,0,0,0
20200312,048437,義隆麥證93購01,,,,,0.00,0.00,0,0,0,0,0,0,0,0,0,0,0,0,0
20200312,048438,台表科麥證94購01,,,,,0.00,0.00,0,0,0,0,0,0,0,0,0,0,0,0,0
20200312,048439,上銀凱基93購09,,,,,0.00,0.00,0,0,0,0,0,0,0,0,0,0,0,0,0
20200312,04843P,致新元大94售02,1.45,1.45,1.45,1.45,0.00,0.00,100000,1,145000,0,0,0,0,0,0,0,100000,-100000,-100000
20200312,048440,國巨凱基93購08,,,,,0.00,0.00,0,0,0,0,0,0,0,0,0,0,0,0,0
20200312,048441,台積電凱基93購29,1.19,1.19,0.78,0.78,-0.94,-54.65,50000,5,50900,0,0,0,0,0,0,50000,20000,30000,30000
20200312,048442,友訊凱基94購01,0.22,0.22,0.19,0.21,-0.03,-12.5,110000,32,22160,0,0,0,0,0,0,110000,0,110000,110000
20200312,048443,旺宏凱基93購08,,,,,0.00,0.00,0,0,0,0,0,0,0,0,0,0,0,0,0
20200312,048444,燿華凱基93購05,,,,,0.00,0.00,0,0,0,0,0,0,0,0,0,0,0,0,0
20200312,048445,瑞昱凱基93購11,,,,,0.00,0.00,0,0,0,0,0,0,0,0,0,0,0,0,0
20200312,048446,南亞科凱基93購07,,,,,0.00,0.00,0,0,0,0,0,0,0,0,0,0,0,0,0
20200312,048447,美律凱基93購06,,,,,0.00,0.00,0,0,0,0,0,0,0,0,0,0,0,0,0
20200312,048448,京元電凱基93購05,,,,,0.00,0.00,0,0,0,0,0,0,0,0,0,0,0,0,0
20200312,048449,強茂凱基93購03,,,,,0.00,0.00,0,0,0,0,0,0,0,0,0,0,0,0,0
20200312,04844P,京元電亞東94售01,,,,,0.00,0.00,0,0,0,0,0,0,0,0,0,0,0,0,0
20200312,048450,聯詠凱基93購09,0.53,0.53,0.45,0.45,-0.51,-53.12,53000,2,27290,0,0,0,0,0,0,43000,10000,33000,33000
20200312,048451,智原凱基93購02,,,,,0.00,0.00,0,0,0,0,0,0,0,0,0,0,0,0,0
20200312,048452,緯創凱基93購04,,,,,0.00,0.00,0,0,0,0,0,0,0,0,0,0,0,0,0
20200312,048453,嘉澤凱基93購05,,,,,0.00,0.00,0,0,0,0,0,0,0,0,0,0,0,0,0
20200312,048454,合勤控凱基94購01,,,,,0.00,0.00,0,0,0,0,0,0,0,0,0,0,0,0,0
20200312,048455,上緯控凱基94購01,,,,,0.00,0.00,0,0,0,0,0,0,0,0,0,0,0,0,0
20200312,048456,利勤凱基95購01,,,,,0.00,0.00,0,0,0,0,0,0,0,0,0,0,0,0,0
20200312,048457,康普凱基93購01,,,,,0.00,0.00,0,0,0,0,0,0,0,0,0,0,0,0,0
20200312,048458,中磊凱基93購03,,,,,0.00,0.00,0,0,0,0,0,0,0,0,0,0,0,0,0
20200312,048459,嘉聯益凱基93購04,,,,,0.00,0.00,0,0,0,0,0,0,0,0,0,0,0,0,0
20200312,04845P,台積電凱基94售33,,,,,0.00,0.00,0,0,0,0,0,0,0,0,0,0,0,0,0
20200312,048460,盛群凱基94購01,0.46,0.46,0.33,0.35,-0.20,-36.36,823000,26,313920,0,0,0,0,0,0,327000,496000,-169000,-169000
20200312,048461,緯穎凱基93購01,,,,,0.00,0.00,0,0,0,0,0,0,0,0,0,0,0,0,0
20200312,048462,南電凱基93購06,,,,,0.00,0.00,0,0,0,0,0,0,0,0,0,0,0,0,0
20200312,048463,美利達凱基93購06,,,,,0.00,0.00,0,0,0,0,0,0,0,0,0,0,0,0,0
20200312,048464,康控台新94購01,,,,,0.00,0.00,0,0,0,0,0,0,0,0,0,0,0,0,0
20200312,048465,南電台新93購01,,,,,0.00,0.00,0,0,0,0,0,0,0,0,0,0,0,0,0
20200312,048466,卜蜂康和93購01,,,,,0.00,0.00,0,0,0,0,0,0,0,0,0,0,0,0,0
20200312,048467,南電康和93購01,,,,,0.00,0.00,0,0,0,0,0,0,0,0,0,0,0,0,0
20200312,048468,光磊永豐93購01,,,,,0.00,0.00,0,0,0,0,0,0,0,0,0,0,0,0,0
20200312,048469,微星永豐93購03,,,,,0.00,0.00,0,0,0,0,0,0,0,0,0,0,0,0,0
20200312,04846P,旺宏凱基94售07,0.19,0.25,0.19,0.25,+0.15,150.0,140000,2,31400,0,0,0,0,0,0,0,140000,-140000,-140000
20200312,048470,神基永豐93購01,,,,,0.00,0.00,0,0,0,0,0,0,0,0,0,0,0,0,0
20200312,048471,旭富永豐93購01,0.25,0.26,0.10,0.10,-0.36,-78.26,239000,25,36830,0,0,0,0,0,0,73000,166000,-93000,-93000
20200312,048472,傳奇永豐93購01,,,,,0.00,0.00,0,0,0,0,0,0,0,0,0,0,0,0,0
20200312,048473,瀚宇博永豐93購02,,,,,0.00,0.00,0,0,0,0,0,0,0,0,0,0,0,0,0
20200312,048474,嘉聯益永豐93購03,,,,,0.00,0.00,0,0,0,0,0,0,0,0,0,0,0,0,0
20200312,048475,台郡永豐93購02,0.07,0.07,0.04,0.05,-0.25,-83.33,16000,9,950,0,0,0,0,0,0,16000,0,16000,16000
20200312,048476,同欣電永豐93購01,,,,,0.00,0.00,0,0,0,0,0,0,0,0,0,0,0,0,0
20200312,048477,易華電永豐93購04,,,,,0.00,0.00,0,0,0,0,0,0,0,0,0,0,0,0,0
20200312,048478,羅麗芬永豐94購01,,,,,0.00,0.00,0,0,0,0,0,0,0,0,0,0,0,0,0
20200312,048479,寶成永豐93購01,,,,,0.00,0.00,0,0,0,0,0,0,0,0,0,0,0,0,0
20200312,04847P,聯發科凱基94售17,,,,,0.00,0.00,0,0,0,0,0,0,0,0,0,0,0,0,0
20200312,048480,FB上証中信94購01,0.06,0.06,0.06,0.06,-0.04,-40.0,10000,1,600,0,0,0,0,0,0,0,10000,-10000,-10000
20200312,048481,瑞儀中信93購01,,,,,0.00,0.00,0,0,0,0,0,0,0,0,0,0,0,0,0
20200312,048482,柏文中信94購01,,,,,0.00,0.00,0,0,0,0,0,0,0,0,0,0,0,0,0
20200312,048483,可成國泰95購01,0.43,0.43,0.21,0.22,-0.37,-62.71,198000,10,69600,0,0,0,0,0,0,190000,60000,130000,130000
20200312,048484,大立光國泰95購02,0.57,0.57,0.40,0.40,-0.64,-61.54,187000,7,95210,0,0,0,0,0,0,87000,104000,-17000,-17000
20200312,048485,泰鼎國泰94購02,,,,,0.00,0.00,0,0,0,0,0,0,0,0,0,0,0,0,0
20200312,048486,傳奇國泰95購01,,,,,0.00,0.00,0,0,0,0,0,0,0,0,0,0,0,0,0
20200312,048487,華邦電富邦93購02,,,,,0.00,0.00,0,0,0,0,0,0,0,0,0,0,0,0,0
20200312,048488,大立光富邦93購05,0.97,0.97,0.70,0.70,-1.50,-68.18,17000,3,15400,0,0,0,0,0,0,0,17000,-17000,-17000
20200312,048489,明泰富邦93購01,,,,,0.00,0.00,0,0,0,0,0,0,0,0,0,0,0,0,0
20200312,04848P,康控凱基94售02,1.72,1.81,1.71,1.81,0.00,0.00,50000,5,87600,0,0,0,0,0,0,0,50000,-50000,-50000
20200312,048490,寶成富邦93購01,,,,,0.00,0.00,0,0,0,0,0,0,0,0,0,0,0,0,0
20200312,048491,A50元大93購01,0.07,0.07,0.07,0.07,0.00,0.00,10000,1,700,0,0,0,0,0,0,10000,0,10000,10000
20200312,048492,國巨元大93購11,,,,,0.00,0.00,0,0,0,0,0,0,0,0,0,0,0,0,0
20200312,048493,微星元大93購04,,,,,0.00,0.00,0,0,0,0,0,0,0,0,0,0,0,0,0
20200312,048494,瑞昱元大93購13,,,,,0.00,0.00,0,0,0,0,0,0,0,0,0,0,0,0,0
20200312,048495,南亞科元大93購04,,,,,0.00,0.00,0,0,0,0,0,0,0,0,0,0,0,0,0
20200312,048496,南亞科元大93購05,,,,,0.00,0.00,0,0,0,0,0,0,0,0,0,0,0,0,0
20200312,048497,京元電元大93購02,,,,,0.00,0.00,0,0,0,0,0,0,0,0,0,0,0,0,0
20200312,048498,嘉澤元大94購01,,,,,0.00,0.00,0,0,0,0,0,0,0,0,0,0,0,0,0
20200312,048499,達運元大96購01,0.09,0.11,0.09,0.11,-0.05,-31.25,53000,5,5290,0,0,0,0,0,0,20000,33000,-13000,-13000
20200312,04849P,GIS中信94售01,1.47,1.47,1.47,1.47,+0.09,6.52,10000,1,14700,0,0,0,0,0,0,10000,0,10000,10000
20200312,048500,樺漢元大93購03,,,,,0.00,0.00,0,0,0,0,0,0,0,0,0,0,0,0,0
20200312,048501,GIS元大94購02,,,,,0.00,0.00,0,0,0,0,0,0,0,0,0,0,0,0,0
20200312,048502,百和元大93購01,,,,,0.00,0.00,0,0,0,0,0,0,0,0,0,0,0,0,0
20200312,048503,百和元大93購02,,,,,0.00,0.00,0,0,0,0,0,0,0,0,0,0,0,0,0
20200312,048504,A50正2中信95購01,,,,,0.00,0.00,0,0,0,0,0,0,0,0,0,0,0,0,0
20200312,048505,滬深2X群益99購03,0.52,0.52,0.52,0.52,-0.10,-16.13,70000,2,36400,0,0,0,0,0,0,70000,0,70000,70000
20200312,048506,華通群益94購03,0.47,0.50,0.23,0.23,-0.75,-76.53,201000,16,92220,0,0,0,0,0,0,94000,99000,-5000,-5000
20200312,048507,聯茂群益93購05,,,,,0.00,0.00,0,0,0,0,0,0,0,0,0,0,0,0,0
20200312,048508,元上證凱基94購02,,,,,0.00,0.00,0,0,0,0,0,0,0,0,0,0,0,0,0
20200312,048509,上証反凱基99購02,0.32,0.33,0.32,0.32,+0.04,14.29,118000,12,38110,0,0,0,0,0,0,52000,20000,32000,32000
20200312,04850P,全新永豐94售03,1.33,1.44,1.33,1.44,0.00,0.00,20000,2,27700,0,0,0,0,0,0,0,20000,-20000,-20000
20200312,048510,滬深2X凱基93購05,,,,,0.00,0.00,0,0,0,0,0,0,0,0,0,0,0,0,0
20200312,048511,美律凱基93購07,,,,,0.00,0.00,0,0,0,0,0,0,0,0,0,0,0,0,0
20200312,048512,全新凱基93購04,,,,,0.00,0.00,0,0,0,0,0,0,0,0,0,0,0,0,0
20200312,048513,欣興凱基93購04,,,,,0.00,0.00,0,0,0,0,0,0,0,0,0,0,0,0,0
20200312,048514,嘉澤凱基93購06,,,,,0.00,0.00,0,0,0,0,0,0,0,0,0,0,0,0,0
20200312,048515,貿聯凱基93購03,,,,,0.00,0.00,0,0,0,0,0,0,0,0,0,0,0,0,0
20200312,048516,麗豐凱基93購02,,,,,0.00,0.00,0,0,0,0,0,0,0,0,0,0,0,0,0
20200312,048517,致伸凱基93購06,,,,,0.00,0.00,0,0,0,0,0,0,0,0,0,0,0,0,0
20200312,048518,聯茂凱基93購10,,,,,0.00,0.00,0,0,0,0,0,0,0,0,0,0,0,0,0
20200312,048519,緯穎凱基93購02,6.35,7.00,6.35,7.00,0.00,0.00,20000,3,133500,0,0,0,0,0,0,10000,20000,-10000,-10000
20200312,04851P,創意永豐94售02,1.84,1.84,1.84,1.84,0.00,0.00,10000,1,18400,0,0,0,0,0,0,0,10000,-10000,-10000
20200312,048520,柏文凱基93購03,,,,,0.00,0.00,0,0,0,0,0,0,0,0,0,0,0,0,0
20200312,048521,華通統一93購05,0.43,0.43,0.39,0.39,-0.40,-50.63,40000,2,16400,0,0,0,0,0,0,40000,0,40000,40000
20200312,048522,A50正2元富95購02,,,,,0.00,0.00,0,0,0,0,0,0,0,0,0,0,0,0,0
20200312,048523,TPK元富94購01,,,,,0.00,0.00,0,0,0,0,0,0,0,0,0,0,0,0,0
20200312,048524,GIS元富94購01,,,,,0.00,0.00,0,0,0,0,0,0,0,0,0,0,0,0,0
20200312,048525,華通國票94購02,0.25,0.26,0.09,0.09,-0.37,-80.43,98000,12,18550,0,0,0,0,0,0,91000,0,91000,91000
20200312,048526,鴻海國票93購03,,,,,0.00,0.00,0,0,0,0,0,0,0,0,0,0,0,0,0
20200312,048527,鴻海國票94購02,0.05,0.05,0.02,0.05,-0.08,-61.54,133000,6,4820,0,0,0,0,0,0,102000,30000,72000,72000
20200312,048528,華泰國票94購01,,,,,0.00,0.00,0,0,0,0,0,0,0,0,0,0,0,0,0
20200312,048529,京元電國票94購01,,,,,0.00,0.00,0,0,0,0,0,0,0,0,0,0,0,0,0
20200312,04852P,臻鼎永豐94售02,0.98,1.10,0.98,1.10,+0.54,96.43,15000,3,15900,0,0,0,0,0,0,5000,10000,-5000,-5000
20200312,048530,大立光國票93購04,,,,,0.00,0.00,0,0,0,0,0,0,0,0,0,0,0,0,0
20200312,048531,大立光國票93購05,,,,,0.00,0.00,0,0,0,0,0,0,0,0,0,0,0,0,0
20200312,048532,大立光國票93購06,0.67,0.67,0.32,0.32,0.00,0.00,130000,7,57800,0,0,0,0,0,0,0,130000,-130000,-130000
20200312,048533,景碩國票94購01,1.07,1.07,1.07,1.07,-0.50,-31.85,10000,1,10700,0,0,0,0,0,0,10000,0,10000,10000
20200312,048534,貿聯國票94購01,0.29,0.31,0.28,0.31,-0.12,-27.91,28000,9,8380,0,0,0,0,0,0,28000,0,28000,28000
20200312,048535,超眾國票94購02,,,,,0.00,0.00,0,0,0,0,0,0,0,0,0,0,0,0,0
20200312,048536,南電國票93購04,,,,,0.00,0.00,0,0,0,0,0,0,0,0,0,0,0,0,0
20200312,048537,柏文國票94購01,,,,,0.00,0.00,0,0,0,0,0,0,0,0,0,0,0,0,0
20200312,048538,美利達國票94購01,,,,,0.00,0.00,0,0,0,0,0,0,0,0,0,0,0,0,0
20200312,048539,巨大國票94購01,,,,,0.00,0.00,0,0,0,0,0,0,0,0,0,0,0,0,0
20200312,04853P,易華電永豐94售03,,,,,0.00,0.00,0,0,0,0,0,0,0,0,0,0,0,0,0
20200312,048540,百和國票93購01,,,,,0.00,0.00,0,0,0,0,0,0,0,0,0,0,0,0,0
20200312,048541,緯穎台新93購01,,,,,0.00,0.00,0,0,0,0,0,0,0,0,0,0,0,0,0
20200312,048542,美利達台新93購01,,,,,0.00,0.00,0,0,0,0,0,0,0,0,0,0,0,0,0
20200312,048543,統一永豐93購01,,,,,0.00,0.00,0,0,0,0,0,0,0,0,0,0,0,0,0
20200312,048544,欣興永豐94購01,,,,,0.00,0.00,0,0,0,0,0,0,0,0,0,0,0,0,0
20200312,048545,嘉澤永豐93購03,,,,,0.00,0.00,0,0,0,0,0,0,0,0,0,0,0,0,0
20200312,048546,廣越永豐93購01,,,,,0.00,0.00,0,0,0,0,0,0,0,0,0,0,0,0,0
20200312,048547,訊芯永豐93購03,,,,,0.00,0.00,0,0,0,0,0,0,0,0,0,0,0,0,0
20200312,048548,緯穎永豐93購02,,,,,0.00,0.00,0,0,0,0,0,0,0,0,0,0,0,0,0
20200312,048549,滬深2X元大96購03,0.20,0.20,0.18,0.18,0.00,0.00,150000,3,28400,0,0,0,0,0,0,0,150000,-150000,-150000
20200312,04854P,鴻海國泰96售04,1.33,1.73,1.33,1.72,+0.57,49.57,364000,15,563690,0,0,0,0,0,0,364000,5000,359000,359000
20200312,048550,中鴻元大96購01,0.29,0.29,0.18,0.18,0.00,0.00,30000,2,7600,0,0,0,0,0,0,20000,10000,10000,10000
20200312,048551,鴻海元大94購02,2.28,2.28,1.93,1.93,0.00,0.00,15000,4,30220,0,0,0,0,0,0,4000,15000,-11000,-11000
20200312,048552,鴻海元大94購03,2.04,2.04,1.48,1.57,-0.98,-38.43,21000,7,35310,0,0,0,0,0,0,16000,15000,1000,1000
20200312,048553,光磊元大93購03,,,,,0.00,0.00,0,0,0,0,0,0,0,0,0,0,0,0,0
20200312,048554,燿華元大93購06,,,,,0.00,0.00,0,0,0,0,0,0,0,0,0,0,0,0,0
20200312,048555,技嘉元大93購02,,,,,0.00,0.00,0,0,0,0,0,0,0,0,0,0,0,0,0
20200312,048556,技嘉元大93購03,,,,,0.00,0.00,0,0,0,0,0,0,0,0,0,0,0,0,0
20200312,048557,瑞昱元大94購01,0.79,0.79,0.54,0.55,-0.62,-52.99,193000,7,125420,0,0,0,0,0,0,96000,183000,-87000,-87000
20200312,048558,漢唐元大93購06,,,,,0.00,0.00,0,0,0,0,0,0,0,0,0,0,0,0,0
20200312,048559,京元電元大93購03,,,,,0.00,0.00,0,0,0,0,0,0,0,0,0,0,0,0,0
20200312,04855P,上証2X元富94售02,1.45,1.90,1.45,1.75,+0.50,40.0,10000,10,16860,0,0,0,0,0,0,10000,0,10000,10000
20200312,048560,聯發科元大94購01,0.02,0.02,0.02,0.02,-0.06,-75.0,542000,55,10840,0,0,0,0,0,0,0,542000,-542000,-542000
20200312,048561,可成元大93購13,,,,,0.00,0.00,0,0,0,0,0,0,0,0,0,0,0,0,0
20200312,048562,宏達電元大95購01,0.47,0.47,0.39,0.39,-0.13,-25.0,330000,4,141000,0,0,0,0,0,0,0,330000,-330000,-330000
20200312,048563,明泰元大94購01,,,,,0.00,0.00,0,0,0,0,0,0,0,0,0,0,0,0,0
20200312,048564,智易元大94購01,,,,,0.00,0.00,0,0,0,0,0,0,0,0,0,0,0,0,0
20200312,048565,康控元大94購04,,,,,0.00,0.00,0,0,0,0,0,0,0,0,0,0,0,0,0
20200312,048566,上海銀元大93購04,,,,,0.00,0.00,0,0,0,0,0,0,0,0,0,0,0,0,0
20200312,048567,台郡元大93購03,2.52,2.52,1.39,1.39,-2.08,-59.94,170000,5,271700,0,0,0,0,0,0,20000,150000,-130000,-130000
20200312,048568,緯穎元大93購06,,,,,0.00,0.00,0,0,0,0,0,0,0,0,0,0,0,0,0
20200312,048569,台虹元大93購03,1.28,1.28,1.28,1.28,0.00,0.00,10000,1,12800,0,0,0,0,0,0,0,10000,-10000,-10000
20200312,04856P,光磊元富94售01,1.73,1.95,1.73,1.95,+0.38,24.2,139000,9,259270,0,0,0,0,0,0,30000,109000,-79000,-79000
20200312,048570,鈺齊元大93購01,,,,,0.00,0.00,0,0,0,0,0,0,0,0,0,0,0,0,0
20200312,048571,美利達元大96購03,0.57,0.57,0.43,0.43,-0.19,-30.65,111000,6,55650,0,0,0,0,0,0,86000,25000,61000,61000
20200312,048572,美利達元大96購04,1.01,1.02,0.81,0.81,-0.26,-24.3,320000,9,282050,0,0,0,0,0,0,225000,95000,130000,130000
20200312,048573,世紀鋼元大93購05,0.80,0.80,0.59,0.61,-0.31,-33.7,314000,12,235180,0,0,0,0,0,0,147000,167000,-20000,-20000
20200312,048574,台積電國泰95購02,,,,,0.00,0.00,0,0,0,0,0,0,0,0,0,0,0,0,0
20200312,048575,旺宏國泰94購04,1.91,1.91,1.13,1.25,-0.98,-43.95,268000,13,373450,0,0,0,0,0,0,113000,238000,-125000,-125000
20200312,048576,義隆國泰95購01,0.77,0.77,0.70,0.70,-0.25,-26.32,40000,3,29500,0,0,0,0,0,0,30000,10000,20000,20000
20200312,048577,GIS國泰94購01,,,,,0.00,0.00,0,0,0,0,0,0,0,0,0,0,0,0,0
20200312,048578,滬深2X富邦93購04,,,,,0.00,0.00,0,0,0,0,0,0,0,0,0,0,0,0,0
20200312,048579,華新富邦93購01,,,,,0.00,0.00,0,0,0,0,0,0,0,0,0,0,0,0,0
20200312,04857P,美律元富94售01,1.14,1.62,1.14,1.58,+0.63,66.32,162000,18,229250,0,0,0,0,0,0,62000,150000,-88000,-88000
20200312,048580,台達電富邦93購01,0.52,0.52,0.52,0.52,-0.33,-38.82,20000,1,10400,0,0,0,0,0,0,20000,0,20000,20000
20200312,048581,南亞科富邦93購02,,,,,0.00,0.00,0,0,0,0,0,0,0,0,0,0,0,0,0
20200312,048582,國泰金富邦93購01,,,,,0.00,0.00,0,0,0,0,0,0,0,0,0,0,0,0,0
20200312,048583,智原富邦98購01,,,,,0.00,0.00,0,0,0,0,0,0,0,0,0,0,0,0,0
20200312,048584,欣興富邦95購01,0.10,0.10,0.10,0.10,-0.06,-37.5,10000,1,1000,0,0,0,0,0,0,0,10000,-10000,-10000
20200312,048585,瑞儀富邦93購01,,,,,0.00,0.00,0,0,0,0,0,0,0,0,0,0,0,0,0
20200312,048586,美利達富邦93購01,,,,,0.00,0.00,0,0,0,0,0,0,0,0,0,0,0,0,0
20200312,048587,康控中信93購01,,,,,0.00,0.00,0,0,0,0,0,0,0,0,0,0,0,0,0
20200312,048588,世紀鋼中信94購01,0.41,0.45,0.35,0.37,-0.10,-21.28,60000,5,24100,0,0,0,0,0,0,30000,30000,0,0
20200312,048589,國巨兆豐96購01,2.71,2.71,2.51,2.51,0.00,0.00,62000,7,156820,0,0,0,0,0,0,0,62000,-62000,-62000
20200312,04858P,健策元富94售01,0.12,0.17,0.12,0.17,0.00,0.00,11000,2,1370,0,0,0,0,0,0,11000,0,11000,11000
20200312,048590,貿聯兆豐94購02,0.10,0.10,0.09,0.09,-0.09,-50.0,15000,2,1450,0,0,0,0,0,0,0,15000,-15000,-15000
20200312,048591,台郡兆豐94購01,0.52,0.56,0.48,0.48,-0.51,-51.52,156000,4,84120,0,0,0,0,0,0,156000,0,156000,156000
20200312,048592,漢唐群益93購04,,,,,0.00,0.00,0,0,0,0,0,0,0,0,0,0,0,0,0
20200312,048593,華新科群益93購04,,,,,0.00,0.00,0,0,0,0,0,0,0,0,0,0,0,0,0
20200312,048594,泰鼎群益93購02,,,,,0.00,0.00,0,0,0,0,0,0,0,0,0,0,0,0,0
20200312,048595,儒鴻國票96購01,0.04,0.04,0.03,0.03,-0.05,-62.5,631000,18,20530,0,0,0,0,0,0,0,560000,-560000,-560000
20200312,048596,力山國票94購01,,,,,0.00,0.00,0,0,0,0,0,0,0,0,0,0,0,0,0
20200312,048597,台達電國票93購02,,,,,0.00,0.00,0,0,0,0,0,0,0,0,0,0,0,0,0
20200312,048598,瑞昱國票93購03,,,,,0.00,0.00,0,0,0,0,0,0,0,0,0,0,0,0,0
20200312,048599,和鑫國票96購01,,,,,0.00,0.00,0,0,0,0,0,0,0,0,0,0,0,0,0
20200312,04859P,台達電群益94售04,0.66,0.73,0.66,0.73,0.00,0.00,33000,3,23100,0,0,0,0,0,0,0,33000,-33000,-33000
20200312,048600,嘉澤國票94購01,,,,,0.00,0.00,0,0,0,0,0,0,0,0,0,0,0,0,0
20200312,048601,智易國票94購03,,,,,0.00,0.00,0,0,0,0,0,0,0,0,0,0,0,0,0
20200312,048602,上緯控國票96購01,,,,,0.00,0.00,0,0,0,0,0,0,0,0,0,0,0,0,0
20200312,048603,中磊國票94購02,0.44,0.44,0.44,0.44,-0.13,-22.81,74000,1,32560,0,0,0,0,0,0,74000,0,74000,74000
20200312,048604,美利達國票94購02,,,,,0.00,0.00,0,0,0,0,0,0,0,0,0,0,0,0,0
20200312,048605,百和國票93購02,0.01,0.01,0.01,0.01,0.00,0.00,5000,1,50,0,0,0,0,0,0,5000,0,5000,5000
20200312,048606,聯發科日盛93購02,,,,,0.00,0.00,0,0,0,0,0,0,0,0,0,0,0,0,0
20200312,048607,上銀凱基93購11,,,,,0.00,0.00,0,0,0,0,0,0,0,0,0,0,0,0,0
20200312,048608,燿華凱基93購06,,,,,0.00,0.00,0,0,0,0,0,0,0,0,0,0,0,0,0
20200312,048609,京元電凱基93購07,,,,,0.00,0.00,0,0,0,0,0,0,0,0,0,0,0,0,0
20200312,04860P,鴻海群益94售07,2.25,2.91,2.21,2.68,+0.86,47.25,122000,7,305700,0,0,0,0,0,0,40000,92000,-52000,-52000
20200312,048610,華新科凱基94購04,1.36,1.36,1.36,1.36,-0.43,-24.02,10000,1,13600,0,0,0,0,0,0,0,10000,-10000,-10000
20200312,048611,宏達電凱基93購04,,,,,0.00,0.00,0,0,0,0,0,0,0,0,0,0,0,0,0
20200312,048612,嘉晶凱基93購05,,,,,0.00,0.00,0,0,0,0,0,0,0,0,0,0,0,0,0
20200312,048613,智原凱基93購03,,,,,0.00,0.00,0,0,0,0,0,0,0,0,0,0,0,0,0
20200312,048614,欣興凱基93購05,,,,,0.00,0.00,0,0,0,0,0,0,0,0,0,0,0,0,0
20200312,048615,貿聯凱基93購04,,,,,0.00,0.00,0,0,0,0,0,0,0,0,0,0,0,0,0
20200312,048616,智伸科凱基93購07,,,,,0.00,0.00,0,0,0,0,0,0,0,0,0,0,0,0,0
20200312,048617,瀚宇博凱基93購04,,,,,0.00,0.00,0,0,0,0,0,0,0,0,0,0,0,0,0
20200312,048618,超眾凱基93購08,,,,,0.00,0.00,0,0,0,0,0,0,0,0,0,0,0,0,0
20200312,048619,台表科凱基93購07,0.47,0.49,0.41,0.42,-0.35,-45.45,20000,10,8820,0,0,0,0,0,0,20000,0,20000,20000
20200312,04861P,中磊群益94售02,1.33,1.48,1.33,1.48,0.00,0.00,66000,3,96030,0,0,0,0,0,0,0,66000,-66000,-66000
20200312,048620,易華電凱基94購02,,,,,0.00,0.00,0,0,0,0,0,0,0,0,0,0,0,0,0
20200312,048621,緯穎凱基93購03,,,,,0.00,0.00,0,0,0,0,0,0,0,0,0,0,0,0,0
20200312,048622,南電凱基93購07,,,,,0.00,0.00,0,0,0,0,0,0,0,0,0,0,0,0,0
20200312,048623,世紀鋼凱基94購03,,,,,0.00,0.00,0,0,0,0,0,0,0,0,0,0,0,0,0
20200312,048624,美律台新93購01,,,,,0.00,0.00,0,0,0,0,0,0,0,0,0,0,0,0,0
20200312,048625,GIS台新93購01,,,,,0.00,0.00,0,0,0,0,0,0,0,0,0,0,0,0,0
20200312,048626,矽創台新93購01,,,,,0.00,0.00,0,0,0,0,0,0,0,0,0,0,0,0,0
20200312,048627,T50反1元大96購02,0.56,0.86,0.55,0.83,+0.36,76.6,1316000,33,879640,0,0,0,0,0,0,615000,519000,96000,96000
20200312,048628,T50反1元大96購03,0.46,0.75,0.46,0.70,+0.30,75.0,3725000,46,2453760,171000,0,171000,0,0,0,3317000,0,3317000,3488000
20200312,048629,滬深2X元大96購04,0.31,0.31,0.30,0.30,0.00,0.00,60000,2,18500,0,0,0,0,0,0,10000,50000,-40000,-40000
20200312,04862P,台積電元大94售26,1.03,1.04,1.03,1.03,0.00,0.00,110000,3,113400,0,0,0,0,0,0,110000,110000,0,0
20200312,048630,南亞元大93購01,,,,,0.00,0.00,0,0,0,0,0,0,0,0,0,0,0,0,0
20200312,048631,遠東新元大93購01,,,,,0.00,0.00,0,0,0,0,0,0,0,0,0,0,0,0,0
20200312,048632,大成鋼元大93購02,,,,,0.00,0.00,0,0,0,0,0,0,0,0,0,0,0,0,0
20200312,048633,台達電元大94購02,1.11,1.11,1.11,1.11,-0.21,-15.91,99000,1,109890,0,0,0,0,0,0,99000,0,99000,99000
20200312,048634,華通元大94購01,1.05,1.06,0.40,0.40,-0.73,-64.6,627000,24,420000,0,0,0,0,0,0,192000,537000,-345000,-345000
20200312,048635,鴻海元大94購04,1.57,1.57,1.08,1.11,-0.91,-45.05,14000,4,20080,0,0,0,0,0,0,14000,4000,10000,10000
20200312,048636,鴻海元大94購05,1.15,1.16,1.13,1.16,-0.90,-43.69,5000,4,5730,0,0,0,0,0,0,5000,5000,0,0
20200312,048637,鴻海元大96購01,2.34,2.34,1.89,1.91,-0.78,-29.0,19000,9,38250,0,0,0,0,0,0,19000,9000,10000,10000
20200312,048638,台光電元大94購01,0.49,0.49,0.34,0.34,-0.30,-46.88,77000,3,27530,0,0,0,0,0,0,9000,77000,-68000,-68000
20200312,048639,漢唐元大93購07,0.10,0.10,0.10,0.10,0.00,0.00,5000,1,500,0,0,0,0,0,0,0,5000,-5000,-5000
20200312,04863P,技嘉元大94售02,0.92,1.08,0.92,1.08,+0.31,40.26,35000,2,37000,0,0,0,0,0,0,30000,5000,25000,25000
20200312,048640,南亞科元大93購06,,,,,0.00,0.00,0,0,0,0,0,0,0,0,0,0,0,0,0
20200312,048641,美律元大94購01,,,,,0.00,0.00,0,0,0,0,0,0,0,0,0,0,0,0,0
20200312,048642,聯發科元大94購02,0.33,0.33,0.16,0.18,-0.33,-64.71,228000,12,56680,0,0,0,0,0,0,96000,132000,-36000,-36000
20200312,048643,強茂元大94購01,,,,,0.00,0.00,0,0,0,0,0,0,0,0,0,0,0,0,0
20200312,048644,華固元大93購01,1.74,1.74,1.65,1.71,+0.10,6.21,40000,5,67420,0,0,0,0,0,0,37000,27000,10000,10000
20200312,048645,創意元大94購02,,,,,0.00,0.00,0,0,0,0,0,0,0,0,0,0,0,0,0
20200312,048646,上緯控元大93購01,,,,,0.00,0.00,0,0,0,0,0,0,0,0,0,0,0,0,0
20200312,048647,正文元大93購01,,,,,0.00,0.00,0,0,0,0,0,0,0,0,0,0,0,0,0
20200312,048648,祥碩元大93購03,,,,,0.00,0.00,0,0,0,0,0,0,0,0,0,0,0,0,0
20200312,048649,瀚宇博元大93購05,,,,,0.00,0.00,0,0,0,0,0,0,0,0,0,0,0,0,0
20200312,04864P,欣興元大94售10,3.42,3.83,3.42,3.83,+0.79,25.99,23000,3,82440,0,0,0,0,0,0,23000,0,23000,23000
20200312,048650,台表科元大93購05,0.71,0.71,0.71,0.71,-0.41,-36.61,21000,2,14910,0,0,0,0,0,0,21000,0,21000,21000
20200312,048651,美利達元大96購05,0.39,0.40,0.39,0.40,-0.09,-18.37,93000,3,37060,0,0,0,0,0,0,93000,0,93000,93000
20200312,048652,巨大元大96購01,0.53,0.53,0.39,0.39,-0.19,-32.76,208000,8,92040,0,0,0,0,0,0,108000,100000,8000,8000
20200312,048653,巨大元大96購02,0.61,0.61,0.40,0.40,-0.22,-35.48,142000,5,64750,0,0,0,0,0,0,63000,79000,-16000,-16000
20200312,048654,滬深2X元富93購05,,,,,0.00,0.00,0,0,0,0,0,0,0,0,0,0,0,0,0
20200312,048655,A50正2元富96購01,0.47,0.47,0.35,0.35,-0.24,-40.68,10000,4,4090,0,0,0,0,0,0,0,10000,-10000,-10000
20200312,048656,大立光元富93購05,,,,,0.00,0.00,0,0,0,0,0,0,0,0,0,0,0,0,0
20200312,048657,大成鋼統一93購04,,,,,0.00,0.00,0,0,0,0,0,0,0,0,0,0,0,0,0
20200312,048658,鴻海統一93購09,,,,,0.00,0.00,0,0,0,0,0,0,0,0,0,0,0,0,0
20200312,048659,國巨統一94購02,,,,,0.00,0.00,0,0,0,0,0,0,0,0,0,0,0,0,0
20200312,04865P,台積電亞東95售01,,,,,0.00,0.00,0,0,0,0,0,0,0,0,0,0,0,0,0
20200312,048660,台積電統一93購09,1.05,1.61,1.05,1.48,0.00,0.00,350000,35,441300,0,0,0,0,0,0,350000,350000,0,0
20200312,048661,瑞昱統一93購05,,,,,0.00,0.00,0,0,0,0,0,0,0,0,0,0,0,0,0
20200312,048662,京元電統一93購04,,,,,0.00,0.00,0,0,0,0,0,0,0,0,0,0,0,0,0
20200312,048663,聯發科統一96購01,0.07,0.07,0.07,0.07,-0.12,-63.16,120000,1,8400,0,0,0,0,0,0,120000,0,120000,120000
20200312,048664,華新科統一94購01,0.37,0.37,0.37,0.37,0.00,0.00,3000,1,1110,0,0,0,0,0,0,3000,0,3000,3000
20200312,048665,欣興統一93購07,,,,,0.00,0.00,0,0,0,0,0,0,0,0,0,0,0,0,0
20200312,048666,康控統一93購01,,,,,0.00,0.00,0,0,0,0,0,0,0,0,0,0,0,0,0
20200312,048667,旺宏永豐94購02,,,,,0.00,0.00,0,0,0,0,0,0,0,0,0,0,0,0,0
20200312,048668,奇力新永豐93購04,0.05,0.05,0.05,0.05,-0.30,-85.71,20000,1,1000,0,0,0,0,0,0,20000,0,20000,20000
20200312,048669,強茂永豐93購01,,,,,0.00,0.00,0,0,0,0,0,0,0,0,0,0,0,0,0
20200312,04866P,台積電統一95售02,0.90,0.90,0.90,0.90,0.00,0.00,186000,3,167400,0,0,0,0,0,0,0,186000,-186000,-186000
20200312,048670,華新科永豐93購03,,,,,0.00,0.00,0,0,0,0,0,0,0,0,0,0,0,0,0
20200312,048671,大立光永豐93購04,,,,,0.00,0.00,0,0,0,0,0,0,0,0,0,0,0,0,0
20200312,048672,日電貿永豐93購02,,,,,0.00,0.00,0,0,0,0,0,0,0,0,0,0,0,0,0
20200312,048673,智伸科永豐93購02,,,,,0.00,0.00,0,0,0,0,0,0,0,0,0,0,0,0,0
20200312,048674,易華電永豐93購05,,,,,0.00,0.00,0,0,0,0,0,0,0,0,0,0,0,0,0
20200312,048675,台達電國泰94購02,0.61,0.61,0.46,0.46,-0.25,-35.21,69000,3,34890,0,0,0,0,0,0,20000,48000,-28000,-28000
20200312,048676,和鑫國泰94購02,,,,,0.00,0.00,0,0,0,0,0,0,0,0,0,0,0,0,0
20200312,048677,智伸科國泰94購01,,,,,0.00,0.00,0,0,0,0,0,0,0,0,0,0,0,0,0
20200312,048678,統一富邦93購01,0.26,0.26,0.26,0.26,0.00,0.00,1000,1,260,0,0,0,0,0,0,1000,0,1000,1000
20200312,048679,大成鋼富邦93購01,,,,,0.00,0.00,0,0,0,0,0,0,0,0,0,0,0,0,0
20200312,04867P,美律統一94售03,1.02,1.32,1.02,1.32,+0.48,57.14,258000,12,290680,0,0,0,0,0,0,70000,228000,-158000,-158000
20200312,048680,智邦富邦93購02,,,,,0.00,0.00,0,0,0,0,0,0,0,0,0,0,0,0,0
20200312,048681,漢唐富邦96購01,,,,,0.00,0.00,0,0,0,0,0,0,0,0,0,0,0,0,0
20200312,048682,奇力新富邦96購01,3.42,3.43,2.39,2.42,-1.57,-39.35,78000,12,225520,0,0,0,0,0,0,48000,30000,18000,18000
20200312,048683,日月光富邦93購01,,,,,0.00,0.00,0,0,0,0,0,0,0,0,0,0,0,0,0
20200312,048684,上海銀富邦93購02,,,,,0.00,0.00,0,0,0,0,0,0,0,0,0,0,0,0,0
20200312,048685,T50反1第一94購01,0.29,0.47,0.29,0.35,0.00,0.00,72000,9,28650,0,0,0,0,0,0,72000,70000,2000,2000
20200312,048686,滬深2X中信95購09,,,,,0.00,0.00,0,0,0,0,0,0,0,0,0,0,0,0,0
20200312,048687,旺宏群益96購01,,,,,0.00,0.00,0,0,0,0,0,0,0,0,0,0,0,0,0
20200312,048688,瑞昱群益94購01,,,,,0.00,0.00,0,0,0,0,0,0,0,0,0,0,0,0,0
20200312,048689,台光電群益94購01,,,,,0.00,0.00,0,0,0,0,0,0,0,0,0,0,0,0,0
20200312,04868P,可成統一94售03,3.33,3.33,3.33,3.33,0.00,0.00,10000,2,33300,0,0,0,0,0,0,0,10000,-10000,-10000
20200312,048690,美律群益94購01,,,,,0.00,0.00,0,0,0,0,0,0,0,0,0,0,0,0,0
20200312,048691,智伸科群益94購01,,,,,0.00,0.00,0,0,0,0,0,0,0,0,0,0,0,0,0
20200312,048692,致伸群益94購01,,,,,0.00,0.00,0,0,0,0,0,0,0,0,0,0,0,0,0
20200312,048693,GIS群益94購02,,,,,0.00,0.00,0,0,0,0,0,0,0,0,0,0,0,0,0
20200312,048694,緯穎群益94購01,,,,,0.00,0.00,0,0,0,0,0,0,0,0,0,0,0,0,0
20200312,048695,滬深2X國票95購03,,,,,0.00,0.00,0,0,0,0,0,0,0,0,0,0,0,0,0
20200312,048696,台達電國票96購01,1.29,1.38,1.29,1.38,-0.23,-14.29,71000,3,95410,0,0,0,0,0,0,61000,10000,51000,51000
20200312,048697,華新科國票94購06,0.35,0.35,0.32,0.32,-0.46,-58.97,100000,4,32600,0,0,0,0,0,0,0,0,0,0
20200312,048698,宏達電國票95購01,0.12,0.12,0.06,0.07,-0.10,-58.82,90000,4,8800,0,0,0,0,0,0,0,90000,-90000,-90000
20200312,048699,嘉晶國票95購01,1.37,1.60,1.08,1.08,-0.49,-31.21,324000,9,443000,0,0,0,0,0,0,265000,59000,206000,206000
20200312,04869P,鴻海元富95售02,1.41,1.65,1.41,1.65,+0.52,46.02,119000,6,192380,0,0,0,0,0,0,111000,108000,3000,3000
20200312,048700,和鑫國票95購01,,,,,0.00,0.00,0,0,0,0,0,0,0,0,0,0,0,0,0
20200312,048701,健策國票95購01,5.00,5.00,5.00,5.00,0.00,0.00,9000,1,45000,0,0,0,0,0,0,0,9000,-9000,-9000
20200312,048702,正文國票95購01,,,,,0.00,0.00,0,0,0,0,0,0,0,0,0,0,0,0,0
20200312,048703,康控國票95購01,,,,,0.00,0.00,0,0,0,0,0,0,0,0,0,0,0,0,0
20200312,048704,台表科國票95購01,1.39,1.39,0.60,0.60,-0.81,-57.45,142000,11,115840,0,0,0,0,0,0,92000,50000,42000,42000
20200312,048705,GIS國票95購01,0.11,0.11,0.07,0.07,-0.14,-66.67,170000,4,16700,0,0,0,0,0,0,0,170000,-170000,-170000
20200312,048706,緯穎國票94購01,,,,,0.00,0.00,0,0,0,0,0,0,0,0,0,0,0,0,0
20200312,048707,南電國票95購01,0.39,0.39,0.39,0.39,-0.28,-41.79,110000,1,42900,0,0,0,0,0,0,110000,0,110000,110000
20200312,048708,智邦亞東94購01,,,,,0.00,0.00,0,0,0,0,0,0,0,0,0,0,0,0,0
20200312,048709,瑞昱亞東94購01,,,,,0.00,0.00,0,0,0,0,0,0,0,0,0,0,0,0,0
20200312,04870P,大立光元富94售11,1.53,1.53,1.53,1.53,+0.69,82.14,45000,1,68850,0,0,0,0,0,0,45000,0,45000,45000
20200312,048710,奇力新台新94購01,1.89,1.89,1.66,1.66,-0.90,-35.16,10000,6,18440,0,0,0,0,0,0,10000,0,10000,10000
20200312,048711,台郡台新94購01,0.85,0.85,0.66,0.66,-1.27,-65.8,10000,7,7550,0,0,0,0,0,0,10000,0,10000,10000
20200312,048712,樺漢台新94購01,,,,,0.00,0.00,0,0,0,0,0,0,0,0,0,0,0,0,0
20200312,048713,美利達康和94購01,0.41,0.41,0.41,0.41,-0.15,-26.79,71000,1,29110,0,0,0,0,0,0,71000,0,71000,71000
20200312,048714,巨大康和94購01,,,,,0.00,0.00,0,0,0,0,0,0,0,0,0,0,0,0,0
20200312,048715,A50正2永豐94購01,,,,,0.00,0.00,0,0,0,0,0,0,0,0,0,0,0,0,0
20200312,048716,力山永豐94購01,,,,,0.00,0.00,0,0,0,0,0,0,0,0,0,0,0,0,0
20200312,048717,鴻海永豐94購02,,,,,0.00,0.00,0,0,0,0,0,0,0,0,0,0,0,0,0
20200312,048718,台光電永豐94購01,,,,,0.00,0.00,0,0,0,0,0,0,0,0,0,0,0,0,0
20200312,048719,亞光永豐94購01,,,,,0.00,0.00,0,0,0,0,0,0,0,0,0,0,0,0,0
20200312,04871P,力成元富94售02,0.77,0.98,0.77,0.98,+0.34,53.13,50000,2,44800,0,0,0,0,0,0,50000,0,50000,50000
20200312,048720,智易永豐94購02,,,,,0.00,0.00,0,0,0,0,0,0,0,0,0,0,0,0,0
20200312,048721,正文永豐94購01,,,,,0.00,0.00,0,0,0,0,0,0,0,0,0,0,0,0,0
20200312,048722,台表科永豐94購01,0.50,0.50,0.42,0.45,-0.36,-44.44,43000,14,20360,0,0,0,0,0,0,33000,10000,23000,23000
20200312,048723,世紀鋼永豐94購02,0.21,0.22,0.21,0.22,0.00,0.00,70000,3,15200,0,0,0,0,0,0,10000,60000,-50000,-50000
20200312,048724,台達電日盛94購01,0.06,0.06,0.06,0.06,-0.07,-53.85,10000,1,600,0,0,0,0,0,0,10000,0,10000,10000
20200312,048725,京元電日盛94購01,,,,,0.00,0.00,0,0,0,0,0,0,0,0,0,0,0,0,0
20200312,048726,儒鴻麥證95購01,0.02,0.02,0.01,0.02,-0.04,-66.67,315000,6,5500,80000,0,80000,0,0,0,80000,0,80000,80000
20200312,048727,大成鋼麥證94購01,,,,,0.00,0.00,0,0,0,0,0,0,0,0,0,0,0,0,0
20200312,048728,台達電麥證94購01,0.31,0.31,0.23,0.23,-0.16,-41.03,372000,7,96700,372000,0,372000,0,0,0,372000,0,372000,372000
20200312,048729,鴻海麥證94購01,0.49,0.49,0.28,0.28,-0.39,-58.21,41000,5,18880,31000,10000,21000,0,0,0,31000,11000,20000,20000
20200312,04872P,高股息中信94售01,1.49,1.49,1.49,1.49,0.00,0.00,1000,1,1490,0,0,0,0,0,0,1000,0,1000,1000
20200312,048730,智原麥證94購01,,,,,0.00,0.00,0,0,0,0,0,0,0,0,0,0,0,0,0
20200312,048731,創意麥證94購01,,,,,0.00,0.00,0,0,0,0,0,0,0,0,0,0,0,0,0
20200312,048732,台勝科麥證95購01,2.20,2.25,1.84,2.25,+0.24,11.94,65000,13,137570,11000,57000,-46000,0,0,0,8000,57000,-49000,-46000
20200312,048733,台勝科麥證95購02,2.82,3.21,2.21,3.10,+0.27,9.54,171000,20,463340,96000,70000,26000,0,0,0,96000,70000,26000,26000
20200312,048734,美利達麥證94購01,,,,,0.00,0.00,0,0,0,0,0,0,0,0,0,0,0,0,0
20200312,048735,美利達麥證95購01,,,,,0.00,0.00,0,0,0,0,0,0,0,0,0,0,0,0,0
20200312,048736,台達電統一94購01,0.12,0.12,0.12,0.12,0.00,0.00,37000,1,4440,0,0,0,0,0,0,37000,0,37000,37000
20200312,048737,國巨統一94購03,,,,,0.00,0.00,0,0,0,0,0,0,0,0,0,0,0,0,0
20200312,048738,台積電統一94購04,,,,,0.00,0.00,0,0,0,0,0,0,0,0,0,0,0,0,0
20200312,048739,華新科統一94購02,,,,,0.00,0.00,0,0,0,0,0,0,0,0,0,0,0,0,0
20200312,048740,富邦金統一94購01,,,,,0.00,0.00,0,0,0,0,0,0,0,0,0,0,0,0,0
20200312,048741,欣興統一94購02,,,,,0.00,0.00,0,0,0,0,0,0,0,0,0,0,0,0,0
20200312,048742,瀚宇博統一94購01,0.15,0.15,0.15,0.15,-0.17,-53.12,10000,1,1500,0,0,0,0,0,0,10000,0,10000,10000
20200312,048743,美利達統一94購01,,,,,0.00,0.00,0,0,0,0,0,0,0,0,0,0,0,0,0
20200312,048744,儒鴻元富97購01,0.04,0.07,0.03,0.04,-0.05,-55.56,396000,17,15870,0,0,0,0,0,0,10000,355000,-345000,-345000
20200312,048745,儒鴻元富97購02,0.09,0.09,0.04,0.07,-0.06,-46.15,1822000,41,114500,0,0,0,0,0,0,572000,1185000,-613000,-613000
20200312,048746,台達電元富94購01,0.15,0.15,0.15,0.15,-0.09,-37.5,5000,1,750,0,0,0,0,0,0,5000,0,5000,5000
20200312,048747,華通元富97購01,1.21,1.21,0.68,0.73,-0.74,-50.34,58000,7,47760,0,0,0,0,0,0,20000,38000,-18000,-18000
20200312,048748,國巨元富96購01,,,,,0.00,0.00,0,0,0,0,0,0,0,0,0,0,0,0,0
20200312,048749,京元電元富94購02,,,,,0.00,0.00,0,0,0,0,0,0,0,0,0,0,0,0,0
20200312,04874P,高股息中信97售01,0.52,0.56,0.52,0.56,+0.18,47.37,75000,3,41700,0,0,0,0,0,0,75000,0,75000,75000
20200312,048750,智原元富94購01,,,,,0.00,0.00,0,0,0,0,0,0,0,0,0,0,0,0,0
20200312,048751,京鼎元富96購01,1.67,1.67,1.67,1.67,0.00,0.00,5000,1,8350,0,0,0,0,0,0,0,5000,-5000,-5000
20200312,048752,廣越元富95購01,,,,,0.00,0.00,0,0,0,0,0,0,0,0,0,0,0,0,0
20200312,048753,智伸科元富94購01,,,,,0.00,0.00,0,0,0,0,0,0,0,0,0,0,0,0,0
20200312,048754,瀚宇博元富97購01,,,,,0.00,0.00,0,0,0,0,0,0,0,0,0,0,0,0,0
20200312,048755,志超元富96購01,0.48,0.48,0.34,0.34,-0.23,-40.35,35000,4,14750,0,0,0,0,0,0,10000,25000,-15000,-15000
20200312,048756,志超元富96購02,0.08,0.08,0.08,0.08,-0.06,-42.86,120000,12,9600,0,0,0,0,0,0,0,120000,-120000,-120000
20200312,048757,美利達元富96購01,0.40,0.40,0.40,0.40,-0.27,-40.3,4000,1,1600,0,0,0,0,0,0,0,4000,-4000,-4000
20200312,048758,美利達元富96購02,,,,,0.00,0.00,0,0,0,0,0,0,0,0,0,0,0,0,0
20200312,048759,巨大元富96購01,,,,,0.00,0.00,0,0,0,0,0,0,0,0,0,0,0,0,0
20200312,04875P,台積電中信94售04,0.28,0.44,0.28,0.33,+0.13,65.0,535000,25,176710,0,0,0,0,0,0,505000,30000,475000,475000
20200312,048760,S&P反1凱基94購01,0.48,0.51,0.48,0.51,+0.35,218.75,60000,6,29100,0,0,0,0,0,0,60000,50000,10000,10000
20200312,048761,力山凱基94購01,,,,,0.00,0.00,0,0,0,0,0,0,0,0,0,0,0,0,0
20200312,048762,寶齡凱基94購01,0.12,0.12,0.12,0.12,-0.15,-55.56,18000,2,2160,0,0,0,0,0,0,13000,5000,8000,8000
20200312,048763,台積電凱基94購03,,,,,0.00,0.00,0,0,0,0,0,0,0,0,0,0,0,0,0
20200312,048764,台光電凱基94購03,,,,,0.00,0.00,0,0,0,0,0,0,0,0,0,0,0,0,0
20200312,048765,奇力新凱基94購01,0.90,0.90,0.89,0.89,-0.36,-28.8,61000,2,54300,0,0,0,0,0,0,61000,0,61000,61000
20200312,048766,禾伸堂凱基94購01,1.34,1.44,1.30,1.33,-0.19,-12.5,60000,6,80600,0,0,0,0,0,0,10000,50000,-40000,-40000
20200312,048767,欣興凱基94購01,,,,,0.00,0.00,0,0,0,0,0,0,0,0,0,0,0,0,0
20200312,048768,景碩凱基94購02,0.15,0.15,0.15,0.15,-0.74,-83.15,10000,1,1500,0,0,0,0,0,0,0,10000,-10000,-10000
20200312,048769,聯鈞凱基94購01,2.16,2.16,1.49,1.49,-0.93,-38.43,30000,3,57100,0,0,0,0,0,0,10000,20000,-10000,-10000
20200312,04876P,台光電中信94售02,0.53,0.57,0.53,0.55,+0.18,48.65,580000,19,320900,0,0,0,0,0,0,10000,570000,-560000,-560000
20200312,048770,揚明光凱基94購01,,,,,0.00,0.00,0,0,0,0,0,0,0,0,0,0,0,0,0
20200312,048771,嘉澤凱基94購01,,,,,0.00,0.00,0,0,0,0,0,0,0,0,0,0,0,0,0
20200312,048772,智易凱基94購01,,,,,0.00,0.00,0,0,0,0,0,0,0,0,0,0,0,0,0
20200312,048773,貿聯凱基94購01,0.05,0.05,0.05,0.05,-0.09,-64.29,110000,1,5500,0,0,0,0,0,0,110000,0,110000,110000
20200312,048774,麗豐凱基94購04,,,,,0.00,0.00,0,0,0,0,0,0,0,0,0,0,0,0,0
20200312,048775,智伸科凱基94購01,,,,,0.00,0.00,0,0,0,0,0,0,0,0,0,0,0,0,0
20200312,048776,正文凱基94購01,,,,,0.00,0.00,0,0,0,0,0,0,0,0,0,0,0,0,0
20200312,048777,瀚宇博凱基94購02,,,,,0.00,0.00,0,0,0,0,0,0,0,0,0,0,0,0,0
20200312,048778,聯茂凱基94購04,,,,,0.00,0.00,0,0,0,0,0,0,0,0,0,0,0,0,0
20200312,048779,美利達凱基94購01,,,,,0.00,0.00,0,0,0,0,0,0,0,0,0,0,0,0,0
20200312,04877P,聯發科麥證94售04,0.70,1.01,0.70,0.92,+0.31,50.82,233000,15,195730,95000,138000,-43000,0,0,0,130000,138000,-8000,-8000
20200312,048780,臺股指凱基94購03,,,,,0.00,0.00,0,0,0,0,0,0,0,0,0,0,0,0,0
20200312,048781,臺股指凱基96購01,,,,,0.00,0.00,0,0,0,0,0,0,0,0,0,0,0,0,0
20200312,048782,亞泥元大94購01,0.18,0.18,0.18,0.18,-0.16,-47.06,68000,1,12240,0,0,0,0,0,0,68000,0,68000,68000
20200312,048783,國巨元大94購01,,,,,0.00,0.00,0,0,0,0,0,0,0,0,0,0,0,0,0
20200312,048784,台積電元大94購04,0.61,0.70,0.54,0.67,0.00,0.00,159000,5,107210,0,0,0,0,0,0,159000,150000,9000,9000
20200312,048785,台積電元大96購01,2.97,3.55,2.78,3.55,-0.57,-13.83,70000,5,211000,0,0,0,0,0,0,30000,70000,-40000,-40000
20200312,048786,瑞昱元大94購02,0.31,0.31,0.31,0.31,-0.23,-42.59,10000,1,3100,0,0,0,0,0,0,10000,0,10000,10000
20200312,048787,義隆元大94購02,0.19,0.19,0.19,0.19,-0.31,-62.0,40000,1,7600,0,0,0,0,0,0,40000,0,40000,40000
20200312,048788,華新科元大95購02,1.91,1.91,1.31,1.31,-1.42,-52.01,51000,2,67410,0,0,0,0,0,0,1000,50000,-49000,-49000
20200312,048789,大立光元大95購04,0.42,0.42,0.42,0.42,0.00,0.00,68000,1,28560,0,0,0,0,0,0,0,68000,-68000,-68000
20200312,04878P,國巨康和94售02,0.30,0.30,0.30,0.30,0.00,0.00,80000,1,24000,0,0,0,0,0,0,80000,0,80000,80000
20200312,048790,大立光元大95購05,,,,,0.00,0.00,0,0,0,0,0,0,0,0,0,0,0,0,0
20200312,048791,智原元大94購02,,,,,0.00,0.00,0,0,0,0,0,0,0,0,0,0,0,0,0
20200312,048792,瑞儀元大94購01,0.02,0.02,0.02,0.02,-0.06,-75.0,50000,5,1000,0,0,0,0,0,0,0,50000,-50000,-50000
20200312,048793,超眾元大95購02,0.30,0.30,0.30,0.30,-0.25,-45.45,91000,1,27300,0,0,0,0,0,0,91000,0,91000,91000
20200312,048794,易華電元大97購01,,,,,0.00,0.00,0,0,0,0,0,0,0,0,0,0,0,0,0
20200312,048795,復盛元大94購01,0.47,0.47,0.40,0.40,-0.38,-48.72,200000,2,86300,0,0,0,0,0,0,110000,90000,20000,20000
20200312,048796,國巨國泰95購02,,,,,0.00,0.00,0,0,0,0,0,0,0,0,0,0,0,0,0
20200312,048797,美律國泰95購02,0.52,0.52,0.32,0.32,-0.32,-50.0,138000,2,63760,0,0,0,0,0,0,40000,98000,-58000,-58000
20200312,048798,華新科國泰95購01,,,,,0.00,0.00,0,0,0,0,0,0,0,0,0,0,0,0,0
20200312,048799,台積電富邦94購03,,,,,0.00,0.00,0,0,0,0,0,0,0,0,0,0,0,0,0
20200312,04879P,康控永豐94售02,,,,,0.00,0.00,0,0,0,0,0,0,0,0,0,0,0,0,0
20200312,048800,瑞昱富邦94購01,,,,,0.00,0.00,0,0,0,0,0,0,0,0,0,0,0,0,0
20200312,048801,漢唐富邦96購02,,,,,0.00,0.00,0,0,0,0,0,0,0,0,0,0,0,0,0
20200312,048802,聯發科富邦94購03,,,,,0.00,0.00,0,0,0,0,0,0,0,0,0,0,0,0,0
20200312,048803,大立光富邦96購01,,,,,0.00,0.00,0,0,0,0,0,0,0,0,0,0,0,0,0
20200312,048804,和碩富邦94購01,2.45,2.49,2.27,2.49,-0.92,-26.98,10000,10,24110,0,0,0,0,0,0,10000,0,10000,10000
20200312,048805,瀚宇博富邦95購01,,,,,0.00,0.00,0,0,0,0,0,0,0,0,0,0,0,0,0
20200312,048806,光磊中信94購01,,,,,0.00,0.00,0,0,0,0,0,0,0,0,0,0,0,0,0
20200312,048807,崇越中信94購01,,,,,0.00,0.00,0,0,0,0,0,0,0,0,0,0,0,0,0
20200312,048808,美律亞東94購01,,,,,0.00,0.00,0,0,0,0,0,0,0,0,0,0,0,0,0
20200312,048809,創意亞東94購01,,,,,0.00,0.00,0,0,0,0,0,0,0,0,0,0,0,0,0
20200312,04880P,GIS永豐94售02,,,,,0.00,0.00,0,0,0,0,0,0,0,0,0,0,0,0,0
20200312,048810,玉晶光第一94購01,,,,,0.00,0.00,0,0,0,0,0,0,0,0,0,0,0,0,0
20200312,048811,鴻海日盛94購01,0.27,0.27,0.24,0.24,-0.28,-53.85,50000,4,13200,0,0,0,0,0,0,0,50000,-50000,-50000
20200312,048812,上証2X凱基96購01,,,,,0.00,0.00,0,0,0,0,0,0,0,0,0,0,0,0,0
20200312,048813,元黃金凱基94購01,0.35,0.35,0.30,0.30,-0.13,-30.23,255000,13,85240,0,0,0,0,0,0,151000,104000,47000,47000
20200312,048814,上銀凱基94購01,0.39,0.39,0.19,0.19,-0.42,-68.85,185000,26,48920,0,0,0,0,0,0,48000,137000,-89000,-89000
20200312,048815,川湖凱基94購01,,,,,0.00,0.00,0,0,0,0,0,0,0,0,0,0,0,0,0
20200312,048816,光寶科凱基94購01,,,,,0.00,0.00,0,0,0,0,0,0,0,0,0,0,0,0,0
20200312,048817,光寶科凱基94購02,,,,,0.00,0.00,0,0,0,0,0,0,0,0,0,0,0,0,0
20200312,048818,台達電凱基94購01,0.31,0.31,0.30,0.30,-0.10,-25.0,82000,5,24800,0,0,0,0,0,0,72000,10000,62000,62000
20200312,048819,國巨凱基94購01,,,,,0.00,0.00,0,0,0,0,0,0,0,0,0,0,0,0,0
20200312,04881P,高股息凱基96售01,0.88,1.27,0.88,1.19,+0.42,54.55,102000,29,114770,0,0,0,0,0,0,76000,26000,50000,50000
20200312,048820,台積電凱基94購06,,,,,0.00,0.00,0,0,0,0,0,0,0,0,0,0,0,0,0
20200312,048821,光磊凱基95購01,,,,,0.00,0.00,0,0,0,0,0,0,0,0,0,0,0,0,0
20200312,048822,燿華凱基94購03,,,,,0.00,0.00,0,0,0,0,0,0,0,0,0,0,0,0,0
20200312,048823,漢唐凱基94購01,,,,,0.00,0.00,0,0,0,0,0,0,0,0,0,0,0,0,0
20200312,048824,聯發科凱基94購03,,,,,0.00,0.00,0,0,0,0,0,0,0,0,0,0,0,0,0
20200312,048825,華新科凱基94購05,0.45,0.45,0.45,0.45,-0.18,-28.57,10000,1,4500,0,0,0,0,0,0,10000,0,10000,10000
20200312,048826,宏達電凱基94購01,,,,,0.00,0.00,0,0,0,0,0,0,0,0,0,0,0,0,0
20200312,048827,大立光凱基94購01,,,,,0.00,0.00,0,0,0,0,0,0,0,0,0,0,0,0,0
20200312,048828,禾伸堂凱基94購02,,,,,0.00,0.00,0,0,0,0,0,0,0,0,0,0,0,0,0
20200312,048829,欣興凱基94購02,,,,,0.00,0.00,0,0,0,0,0,0,0,0,0,0,0,0,0
20200312,04882P,鴻海凱基94售19,1.94,2.41,1.94,2.41,+1.00,70.92,5000,3,10530,0,0,0,0,0,0,5000,5000,0,0
20200312,048830,和鑫凱基94購03,,,,,0.00,0.00,0,0,0,0,0,0,0,0,0,0,0,0,0
20200312,048831,玉晶光凱基95購01,2.12,2.12,1.49,1.49,-1.24,-45.42,142000,16,242930,0,0,0,0,0,0,7000,142000,-135000,-135000
20200312,048832,玉晶光凱基95購02,1.66,1.66,1.18,1.29,-0.99,-43.42,17000,7,22300,0,0,0,0,0,0,7000,17000,-10000,-10000
20200312,048833,揚明光凱基94購02,,,,,0.00,0.00,0,0,0,0,0,0,0,0,0,0,0,0,0
20200312,048834,牧德凱基94購01,,,,,0.00,0.00,0,0,0,0,0,0,0,0,0,0,0,0,0
20200312,048835,牧德凱基94購02,0.98,0.98,0.98,0.98,-0.93,-48.69,2000,1,1960,0,0,0,0,0,0,2000,2000,0,0
20200312,048836,牧德凱基94購03,,,,,0.00,0.00,0,0,0,0,0,0,0,0,0,0,0,0,0
20200312,048837,牧德凱基94購04,,,,,0.00,0.00,0,0,0,0,0,0,0,0,0,0,0,0,0
20200312,048838,牧德凱基94購07,,,,,0.00,0.00,0,0,0,0,0,0,0,0,0,0,0,0,0
20200312,048839,牧德凱基95購01,0.70,0.70,0.70,0.70,-0.53,-43.09,5000,1,3500,0,0,0,0,0,0,5000,0,5000,5000
20200312,04883P,台積電凱基94售35,,,,,0.00,0.00,0,0,0,0,0,0,0,0,0,0,0,0,0
20200312,048840,上海銀凱基94購02,,,,,0.00,0.00,0,0,0,0,0,0,0,0,0,0,0,0,0
20200312,048841,聯茂凱基94購06,0.31,0.31,0.31,0.31,-0.12,-27.91,10000,1,3100,0,0,0,0,0,0,10000,0,10000,10000
20200312,048842,矽格凱基94購01,0.55,0.55,0.33,0.35,-0.45,-56.25,80000,6,38500,0,0,0,0,0,0,50000,30000,20000,20000
20200312,048843,台郡凱基94購01,0.87,0.87,0.47,0.47,-1.26,-72.83,40000,13,26320,0,0,0,0,0,0,20000,20000,0,0
20200312,048844,訊芯凱基94購02,0.27,0.27,0.27,0.27,-0.13,-32.5,10000,1,2700,0,0,0,0,0,0,10000,0,10000,10000
20200312,048845,GIS凱基94購02,,,,,0.00,0.00,0,0,0,0,0,0,0,0,0,0,0,0,0
20200312,048846,緯穎凱基94購01,,,,,0.00,0.00,0,0,0,0,0,0,0,0,0,0,0,0,0
20200312,048847,A50群益98購01,0.50,0.50,0.50,0.50,-0.21,-29.58,2000,1,1000,0,0,0,0,0,0,2000,0,2000,2000
20200312,048848,滬深2X群益98購02,1.00,1.00,0.82,0.86,-0.24,-21.82,516000,17,480870,0,0,0,0,0,0,286000,230000,56000,56000
20200312,048849,光寶科群益94購01,0.01,0.01,0.01,0.01,0.00,0.00,10000,1,100,0,0,0,0,0,0,10000,0,10000,10000
20200312,04884P,聯發科凱基94售20,0.21,0.22,0.21,0.22,0.00,0.00,120000,3,26200,0,0,0,0,0,0,0,120000,-120000,-120000
20200312,048850,聯電群益96購01,0.64,0.64,0.49,0.49,-0.29,-37.18,50000,4,28100,0,0,0,0,0,0,20000,30000,-10000,-10000
20200312,048851,台達電群益94購01,,,,,0.00,0.00,0,0,0,0,0,0,0,0,0,0,0,0,0
20200312,048852,旺宏群益96購02,1.61,1.61,1.14,1.14,-0.88,-43.56,128000,10,163900,0,0,0,0,0,0,7000,127000,-120000,-120000
20200312,048853,凌陽群益94購01,,,,,0.00,0.00,0,0,0,0,0,0,0,0,0,0,0,0,0
20200312,048854,凌陽群益94購02,,,,,0.00,0.00,0,0,0,0,0,0,0,0,0,0,0,0,0
20200312,048855,華新科群益94購02,,,,,0.00,0.00,0,0,0,0,0,0,0,0,0,0,0,0,0
20200312,048856,高鐵群益94購01,,,,,0.00,0.00,0,0,0,0,0,0,0,0,0,0,0,0,0
20200312,048857,晶豪科群益94購01,0.40,0.40,0.22,0.22,-0.28,-56.0,130000,11,32000,0,0,0,0,0,0,110000,20000,90000,90000
20200312,048858,大立光群益94購03,,,,,0.00,0.00,0,0,0,0,0,0,0,0,0,0,0,0,0
20200312,048859,玉晶光群益96購02,0.91,0.91,0.85,0.85,-0.47,-35.61,15000,2,13050,0,0,0,0,0,0,0,15000,-15000,-15000
20200312,04885P,大立光凱基94售19,,,,,0.00,0.00,0,0,0,0,0,0,0,0,0,0,0,0,0
20200312,048860,玉晶光群益96購03,1.38,1.38,1.02,1.02,-0.84,-45.16,61000,8,75610,0,0,0,0,0,0,24000,39000,-15000,-15000
20200312,048861,牧德群益94購01,,,,,0.00,0.00,0,0,0,0,0,0,0,0,0,0,0,0,0
20200312,048862,中磊群益94購01,,,,,0.00,0.00,0,0,0,0,0,0,0,0,0,0,0,0,0
20200312,048863,超眾群益94購01,,,,,0.00,0.00,0,0,0,0,0,0,0,0,0,0,0,0,0
20200312,048864,昇陽半群益94購01,,,,,0.00,0.00,0,0,0,0,0,0,0,0,0,0,0,0,0
20200312,048865,世紀鋼群益94購01,0.27,0.27,0.27,0.27,-0.15,-35.71,40000,1,10800,0,0,0,0,0,0,40000,0,40000,40000
20200312,048866,滬深2X兆豐95購01,0.26,0.26,0.21,0.21,0.00,0.00,30000,2,6800,0,0,0,0,0,0,0,30000,-30000,-30000
20200312,048867,台積電兆豐95購01,,,,,0.00,0.00,0,0,0,0,0,0,0,0,0,0,0,0,0
20200312,048868,劍麟國票94購01,,,,,0.00,0.00,0,0,0,0,0,0,0,0,0,0,0,0,0
20200312,048869,光罩國票94購01,,,,,0.00,0.00,0,0,0,0,0,0,0,0,0,0,0,0,0
20200312,04886P,臺股指凱基94售20,2.22,2.40,2.22,2.40,0.00,0.00,55000,2,123000,0,0,0,0,0,0,55000,0,55000,55000
20200312,048870,義隆國票96購01,,,,,0.00,0.00,0,0,0,0,0,0,0,0,0,0,0,0,0
20200312,048871,晶豪科國票94購01,0.56,0.58,0.18,0.18,-0.70,-79.55,808000,36,390590,0,0,0,0,0,0,86000,722000,-636000,-636000
20200312,048872,玉晶光國票94購02,0.44,0.44,0.17,0.18,-0.47,-72.31,222000,14,70570,0,0,0,0,0,0,172000,50000,122000,122000
20200312,048873,玉晶光國票95購02,1.57,1.57,1.02,1.02,-0.83,-44.86,48000,14,67220,0,0,0,0,0,0,6000,45000,-39000,-39000
20200312,048874,玉晶光國票96購01,1.37,1.37,0.93,0.93,-0.87,-48.33,11000,2,10670,0,0,0,0,0,0,1000,11000,-10000,-10000
20200312,048875,晶相光國票94購01,0.22,0.22,0.14,0.14,-0.30,-68.18,273000,2,50220,0,0,0,0,0,0,123000,150000,-27000,-27000
20200312,048876,牧德國票95購02,,,,,0.00,0.00,0,0,0,0,0,0,0,0,0,0,0,0,0
20200312,048877,茂林國票94購01,4.87,4.87,4.87,4.87,0.00,0.00,10000,1,48700,0,0,0,0,0,0,0,10000,-10000,-10000
20200312,048878,康控國票95購02,0.18,0.18,0.12,0.12,-0.20,-62.5,60000,2,7800,0,0,0,0,0,0,10000,50000,-40000,-40000
20200312,048879,瀚宇博國票95購01,,,,,0.00,0.00,0,0,0,0,0,0,0,0,0,0,0,0,0
20200312,04887P,臺股指凱基94售21,2.01,2.13,1.93,1.93,0.00,0.00,30000,3,60700,0,0,0,0,0,0,30000,30000,0,0
20200312,048880,昇陽半國票94購01,,,,,0.00,0.00,0,0,0,0,0,0,0,0,0,0,0,0,0
20200312,048881,美律統一94購02,,,,,0.00,0.00,0,0,0,0,0,0,0,0,0,0,0,0,0
20200312,048882,智原統一96購01,0.07,0.07,0.07,0.07,0.00,0.00,8000,1,560,0,0,0,0,0,0,0,8000,-8000,-8000
20200312,048883,玉晶光統一94購01,,,,,0.00,0.00,0,0,0,0,0,0,0,0,0,0,0,0,0
20200312,048884,川湖元富94購01,,,,,0.00,0.00,0,0,0,0,0,0,0,0,0,0,0,0,0
20200312,048885,中環元富94購01,,,,,0.00,0.00,0,0,0,0,0,0,0,0,0,0,0,0,0
20200312,048886,慧洋元富94購01,,,,,0.00,0.00,0,0,0,0,0,0,0,0,0,0,0,0,0
20200312,048887,牧德元富94購01,,,,,0.00,0.00,0,0,0,0,0,0,0,0,0,0,0,0,0
20200312,048888,牧德元富94購02,,,,,0.00,0.00,0,0,0,0,0,0,0,0,0,0,0,0,0
20200312,048889,牧德元富94購03,,,,,0.00,0.00,0,0,0,0,0,0,0,0,0,0,0,0,0
20200312,04888P,臺股指凱基95售03,1.33,1.86,1.33,1.86,+0.77,70.64,106000,11,178860,0,0,0,0,0,0,71000,35000,36000,36000
20200312,048890,傳奇元富97購01,0.01,0.01,0.01,0.01,0.00,0.00,220000,1,2200,0,0,0,0,0,0,220000,0,220000,220000
20200312,048891,傳奇元富97購02,,,,,0.00,0.00,0,0,0,0,0,0,0,0,0,0,0,0,0
20200312,048892,台郡元富97購01,1.65,1.74,1.32,1.45,-0.91,-38.56,119000,13,184880,0,0,0,0,0,0,39000,81000,-42000,-42000
20200312,048893,南電元富94購01,0.72,0.72,0.72,0.72,-0.04,-5.26,30000,1,21600,0,0,0,0,0,0,30000,0,30000,30000
20200312,048894,光罩國泰94購01,,,,,0.00,0.00,0,0,0,0,0,0,0,0,0,0,0,0,0
20200312,048895,光罩國泰95購01,0.36,0.36,0.24,0.27,-0.20,-42.55,121000,8,39140,0,0,0,0,0,0,101000,39000,62000,62000
20200312,048896,凌陽國泰95購01,,,,,0.00,0.00,0,0,0,0,0,0,0,0,0,0,0,0,0
20200312,048897,日電貿國泰95購01,,,,,0.00,0.00,0,0,0,0,0,0,0,0,0,0,0,0,0
20200312,048898,晶相光國泰96購01,0.88,0.88,0.60,0.64,-0.29,-31.18,114000,12,89740,0,0,0,0,0,0,84000,30000,54000,54000
20200312,048899,茂林國泰95購01,2.03,2.03,2.03,2.03,0.00,0.00,2000,1,4060,0,0,0,0,0,0,0,2000,-2000,-2000
20200312,04889P,華通元大94售03,0.79,1.12,0.79,1.06,+0.33,45.21,136000,9,142990,0,0,0,0,0,0,35000,101000,-66000,-66000
20200312,048900,精成科國泰95購01,0.22,0.22,0.13,0.13,-0.20,-60.61,319000,22,54850,0,0,0,0,0,0,147000,172000,-25000,-25000
20200312,048901,矽格國泰95購01,,,,,0.00,0.00,0,0,0,0,0,0,0,0,0,0,0,0,0
20200312,048902,昇陽半國泰96購01,0.35,0.35,0.23,0.23,-0.26,-53.06,108000,9,33560,0,0,0,0,0,0,76000,32000,44000,44000
20200312,048903,華通富邦95購01,,,,,0.00,0.00,0,0,0,0,0,0,0,0,0,0,0,0,0
20200312,048904,鴻海富邦94購02,,,,,0.00,0.00,0,0,0,0,0,0,0,0,0,0,0,0,0
20200312,048905,旺宏富邦96購01,0.51,0.51,0.33,0.33,-0.47,-58.75,60000,6,27900,0,0,0,0,0,0,60000,0,60000,60000
20200312,048906,強茂富邦95購01,0.03,0.03,0.02,0.02,0.00,0.00,120000,3,2700,0,0,0,0,0,0,120000,0,120000,120000
20200312,048907,高鐵富邦94購01,,,,,0.00,0.00,0,0,0,0,0,0,0,0,0,0,0,0,0
20200312,048908,慧洋富邦95購01,0.17,0.17,0.15,0.15,-0.08,-34.78,22000,4,3520,0,0,0,0,0,0,0,22000,-22000,-22000
20200312,048909,聯詠富邦94購01,1.73,1.73,1.73,1.73,-0.60,-25.75,3000,1,5190,0,0,0,0,0,0,0,3000,-3000,-3000
20200312,04890P,台積電元大95售05,0.13,0.23,0.13,0.20,+0.10,100.0,95000,8,13990,0,0,0,0,0,0,85000,10000,75000,75000
20200312,048910,和鑫富邦98購01,,,,,0.00,0.00,0,0,0,0,0,0,0,0,0,0,0,0,0
20200312,048911,玉晶光富邦96購01,0.48,0.52,0.48,0.52,0.00,0.00,88000,2,42640,0,0,0,0,0,0,78000,10000,68000,68000
20200312,048912,牧德富邦94購01,,,,,0.00,0.00,0,0,0,0,0,0,0,0,0,0,0,0,0
20200312,048913,傳奇富邦94購01,,,,,0.00,0.00,0,0,0,0,0,0,0,0,0,0,0,0,0
20200312,048914,川湖台新94購01,,,,,0.00,0.00,0,0,0,0,0,0,0,0,0,0,0,0,0
20200312,048915,國巨台新94購01,2.89,2.89,2.89,2.89,0.00,0.00,10000,1,28900,0,0,0,0,0,0,0,10000,-10000,-10000
20200312,048916,華新科台新94購01,,,,,0.00,0.00,0,0,0,0,0,0,0,0,0,0,0,0,0
20200312,048917,和鑫台新94購01,,,,,0.00,0.00,0,0,0,0,0,0,0,0,0,0,0,0,0
20200312,048918,上証2X永豐94購01,,,,,0.00,0.00,0,0,0,0,0,0,0,0,0,0,0,0,0
20200312,048919,堤維西永豐94購01,,,,,0.00,0.00,0,0,0,0,0,0,0,0,0,0,0,0,0
20200312,04891P,友達元大94售01,0.42,0.59,0.42,0.59,0.00,0.00,704000,8,343780,0,0,0,0,0,0,1000,703000,-702000,-702000
20200312,048920,川湖永豐94購01,,,,,0.00,0.00,0,0,0,0,0,0,0,0,0,0,0,0,0
20200312,048921,劍麟永豐94購01,,,,,0.00,0.00,0,0,0,0,0,0,0,0,0,0,0,0,0
20200312,048922,光寶科永豐94購01,,,,,0.00,0.00,0,0,0,0,0,0,0,0,0,0,0,0,0
20200312,048923,國巨永豐94購02,1.31,1.37,0.50,0.50,-0.97,-65.99,148000,8,148970,0,0,0,0,0,0,120000,28000,92000,92000
20200312,048924,光罩永豐94購01,,,,,0.00,0.00,0,0,0,0,0,0,0,0,0,0,0,0,0
20200312,048925,佳世達永豐94購01,,,,,0.00,0.00,0,0,0,0,0,0,0,0,0,0,0,0,0
20200312,048926,燿華永豐95購01,,,,,0.00,0.00,0,0,0,0,0,0,0,0,0,0,0,0,0
20200312,048927,兆赫永豐94購01,,,,,0.00,0.00,0,0,0,0,0,0,0,0,0,0,0,0,0
20200312,048928,華新科永豐94購02,,,,,0.00,0.00,0,0,0,0,0,0,0,0,0,0,0,0,0
20200312,048929,裕民永豐94購01,,,,,0.00,0.00,0,0,0,0,0,0,0,0,0,0,0,0,0
20200312,04892P,聯發科元大94售14,1.26,1.97,1.26,1.97,+0.93,89.42,465000,10,708420,0,0,0,0,0,0,115000,450000,-335000,-335000
20200312,048930,慧洋永豐94購01,,,,,0.00,0.00,0,0,0,0,0,0,0,0,0,0,0,0,0
20200312,048931,晶華永豐94購01,,,,,0.00,0.00,0,0,0,0,0,0,0,0,0,0,0,0,0
20200312,048932,美食永豐94購01,,,,,0.00,0.00,0,0,0,0,0,0,0,0,0,0,0,0,0
20200312,048933,晶豪科永豐94購01,,,,,0.00,0.00,0,0,0,0,0,0,0,0,0,0,0,0,0
20200312,048934,日電貿永豐94購01,,,,,0.00,0.00,0,0,0,0,0,0,0,0,0,0,0,0,0
20200312,048935,玉晶光永豐94購04,0.08,0.08,0.06,0.06,0.00,0.00,807000,11,54640,0,0,0,0,0,0,457000,350000,107000,107000
20200312,048936,玉晶光永豐94購05,,,,,0.00,0.00,0,0,0,0,0,0,0,0,0,0,0,0,0
20200312,048937,玉晶光永豐95購01,0.57,0.57,0.39,0.39,-0.30,-43.48,54000,4,28270,0,0,0,0,0,0,41000,13000,28000,28000
20200312,048938,玉晶光永豐95購02,,,,,0.00,0.00,0,0,0,0,0,0,0,0,0,0,0,0,0
20200312,048939,華擎永豐94購01,0.67,0.71,0.67,0.71,-0.47,-39.83,60000,2,41800,0,0,0,0,0,0,60000,0,60000,60000
20200312,04893P,創意元大94售03,1.24,1.24,1.24,1.24,+0.19,18.1,22000,1,27280,0,0,0,0,0,0,22000,0,22000,22000
20200312,048940,晶相光永豐94購01,0.04,0.04,0.04,0.04,0.00,0.00,50000,1,2000,0,0,0,0,0,0,50000,0,50000,50000
20200312,048941,牧德永豐94購02,0.15,0.15,0.15,0.15,0.00,0.00,70000,7,10500,0,0,0,0,0,0,0,70000,-70000,-70000
20200312,048942,上緯控永豐94購01,,,,,0.00,0.00,0,0,0,0,0,0,0,0,0,0,0,0,0
20200312,048943,智伸科永豐94購01,,,,,0.00,0.00,0,0,0,0,0,0,0,0,0,0,0,0,0
20200312,048944,茂林永豐94購01,0.60,0.60,0.60,0.60,-0.87,-59.18,20000,1,12000,0,0,0,0,0,0,20000,0,20000,20000
20200312,048945,訊連永豐94購01,0.41,0.42,0.31,0.38,-0.18,-32.14,64000,5,23230,0,0,0,0,0,0,25000,39000,-14000,-14000
20200312,048946,崇越永豐94購01,,,,,0.00,0.00,0,0,0,0,0,0,0,0,0,0,0,0,0
20200312,048947,凌華永豐94購01,0.13,0.13,0.13,0.13,0.00,0.00,15000,1,1950,0,0,0,0,0,0,15000,0,15000,15000
20200312,048948,巨路永豐94購01,,,,,0.00,0.00,0,0,0,0,0,0,0,0,0,0,0,0,0
20200312,048949,昇陽半永豐94購01,,,,,0.00,0.00,0,0,0,0,0,0,0,0,0,0,0,0,0
20200312,04894P,世紀鋼元大94售02,0.28,0.32,0.28,0.32,+0.06,23.08,160000,8,49390,0,0,0,0,0,0,105000,5000,100000,100000
20200312,048950,達方永豐94購01,,,,,0.00,0.00,0,0,0,0,0,0,0,0,0,0,0,0,0
20200312,048951,宏全永豐94購01,,,,,0.00,0.00,0,0,0,0,0,0,0,0,0,0,0,0,0
20200312,048952,川湖康和94購01,0.48,0.48,0.48,0.48,-0.14,-22.58,65000,1,31200,0,0,0,0,0,0,65000,0,65000,65000
20200312,048953,佳世達康和94購01,,,,,0.00,0.00,0,0,0,0,0,0,0,0,0,0,0,0,0
20200312,048954,裕民康和94購01,,,,,0.00,0.00,0,0,0,0,0,0,0,0,0,0,0,0,0
20200312,048955,慧洋康和94購01,,,,,0.00,0.00,0,0,0,0,0,0,0,0,0,0,0,0,0
20200312,048956,美食康和94購01,,,,,0.00,0.00,0,0,0,0,0,0,0,0,0,0,0,0,0
20200312,048957,玉晶光康和94購01,0.61,0.61,0.60,0.60,-0.33,-35.48,194000,2,117400,0,0,0,0,0,0,194000,0,194000,194000
20200312,048958,傳奇康和95購01,,,,,0.00,0.00,0,0,0,0,0,0,0,0,0,0,0,0,0
20200312,048959,凌華康和94購01,,,,,0.00,0.00,0,0,0,0,0,0,0,0,0,0,0,0,0
20200312,048960,矽格康和94購01,,,,,0.00,0.00,0,0,0,0,0,0,0,0,0,0,0,0,0
20200312,048961,矽創康和94購01,,,,,0.00,0.00,0,0,0,0,0,0,0,0,0,0,0,0,0
20200312,048962,宏全康和94購01,,,,,0.00,0.00,0,0,0,0,0,0,0,0,0,0,0,0,0
20200312,048963,川湖元大94購01,0.59,0.59,0.42,0.42,-0.37,-46.84,6000,2,3030,0,0,0,0,0,0,3000,3000,0,0
20200312,048964,劍麟元大94購01,,,,,0.00,0.00,0,0,0,0,0,0,0,0,0,0,0,0,0
20200312,048965,佳世達元大94購01,,,,,0.00,0.00,0,0,0,0,0,0,0,0,0,0,0,0,0
20200312,048966,佳世達元大95購01,,,,,0.00,0.00,0,0,0,0,0,0,0,0,0,0,0,0,0
20200312,048967,凌陽元大95購01,,,,,0.00,0.00,0,0,0,0,0,0,0,0,0,0,0,0,0
20200312,048968,可成元大94購02,,,,,0.00,0.00,0,0,0,0,0,0,0,0,0,0,0,0,0
20200312,048969,兆赫元大94購01,,,,,0.00,0.00,0,0,0,0,0,0,0,0,0,0,0,0,0
20200312,04896P,上証2X中信95售01,1.31,1.54,1.31,1.44,+0.22,18.03,28000,4,39460,0,0,0,0,0,0,15000,13000,2000,2000
20200312,048970,裕民元大94購01,,,,,0.00,0.00,0,0,0,0,0,0,0,0,0,0,0,0,0
20200312,048971,美食元大94購01,,,,,0.00,0.00,0,0,0,0,0,0,0,0,0,0,0,0,0
20200312,048972,晶豪科元大94購01,2.29,2.29,1.02,1.02,-1.38,-57.5,119000,9,188970,0,0,0,0,0,0,83000,36000,47000,47000
20200312,048973,禾伸堂元大94購01,,,,,0.00,0.00,0,0,0,0,0,0,0,0,0,0,0,0,0
20200312,048974,日電貿元大94購01,,,,,0.00,0.00,0,0,0,0,0,0,0,0,0,0,0,0,0
20200312,048975,玉晶光元大94購03,1.50,1.50,1.05,1.12,-1.29,-53.53,92000,11,125190,0,0,0,0,0,0,22000,92000,-70000,-70000
20200312,048976,華擎元大94購01,,,,,0.00,0.00,0,0,0,0,0,0,0,0,0,0,0,0,0
20200312,048977,晶相光元大94購01,0.14,0.14,0.14,0.14,-0.58,-80.56,10000,1,1400,0,0,0,0,0,0,10000,0,10000,10000
20200312,048978,晶相光元大94購02,,,,,0.00,0.00,0,0,0,0,0,0,0,0,0,0,0,0,0
20200312,048979,晶相光元大94購03,0.54,0.54,0.54,0.54,-0.96,-64.0,10000,1,5400,0,0,0,0,0,0,0,10000,-10000,-10000
20200312,04897P,喬山中信94售01,0.94,1.23,0.91,1.22,+0.36,41.86,276000,22,283990,0,0,0,0,0,0,216000,160000,56000,56000
20200312,048980,嘉澤元大94購02,,,,,0.00,0.00,0,0,0,0,0,0,0,0,0,0,0,0,0
20200312,048981,牧德元大94購01,0.46,0.46,0.46,0.46,0.00,0.00,21000,1,9660,0,0,0,0,0,0,0,21000,-21000,-21000
20200312,048982,牧德元大94購02,,,,,0.00,0.00,0,0,0,0,0,0,0,0,0,0,0,0,0
20200312,048983,牧德元大95購01,1.50,1.50,1.50,1.50,-1.20,-44.44,2000,1,3000,0,0,0,0,0,0,0,2000,-2000,-2000
20200312,048984,上緯控元大94購01,,,,,0.00,0.00,0,0,0,0,0,0,0,0,0,0,0,0,0
20200312,048985,茂林元大94購01,3.95,3.95,2.69,2.69,-2.16,-44.54,33000,6,118870,0,0,0,0,0,0,10000,23000,-13000,-13000
20200312,048986,訊連元大94購01,3.59,3.59,3.43,3.43,-1.16,-25.27,32000,3,113280,0,0,0,0,0,0,22000,10000,12000,12000
20200312,048987,崇越元大94購01,1.76,1.76,1.76,1.76,-0.33,-15.79,5000,1,8800,0,0,0,0,0,0,5000,0,5000,5000
20200312,048988,聯茂元大94購02,,,,,0.00,0.00,0,0,0,0,0,0,0,0,0,0,0,0,0
20200312,048989,矽格元大94購02,1.11,1.11,0.80,0.80,-0.79,-49.69,300000,3,286000,0,0,0,0,0,0,100000,300000,-200000,-200000
20200312,04898P,瑞儀中信95售01,1.37,1.66,1.37,1.66,+0.35,26.72,401000,18,616190,0,0,0,0,0,0,118000,283000,-165000,-165000
20200312,048990,台表科元大94購01,1.58,1.58,0.66,0.66,-1.32,-66.67,16000,2,16080,0,0,0,0,0,0,16000,0,16000,16000
20200312,048991,昇陽半元大94購01,,,,,0.00,0.00,0,0,0,0,0,0,0,0,0,0,0,0,0
20200312,048992,昇陽半元大94購02,0.08,0.08,0.08,0.08,-0.17,-68.0,20000,1,1600,0,0,0,0,0,0,20000,0,20000,20000
20200312,048993,昇陽半元大94購03,,,,,0.00,0.00,0,0,0,0,0,0,0,0,0,0,0,0,0
20200312,048994,南電元大94購03,,,,,0.00,0.00,0,0,0,0,0,0,0,0,0,0,0,0,0
20200312,048995,宏全元大94購01,1.06,1.06,1.06,1.06,-0.92,-46.46,50000,2,53000,0,0,0,0,0,0,50000,0,50000,50000
20200312,048996,中環第一94購01,,,,,0.00,0.00,0,0,0,0,0,0,0,0,0,0,0,0,0
20200312,048997,智原國票95購01,,,,,0.00,0.00,0,0,0,0,0,0,0,0,0,0,0,0,0
20200312,048998,玉晶光國票95購03,0.82,0.82,0.51,0.57,-0.66,-53.66,326000,7,181700,0,0,0,0,0,0,205000,121000,84000,84000
20200312,048999,康普國票95購01,,,,,0.00,0.00,0,0,0,0,0,0,0,0,0,0,0,0,0
20200312,04899P,力成中信94售02,0.47,0.47,0.47,0.47,0.00,0.00,128000,1,60160,0,0,0,0,0,0,0,128000,-128000,-128000
20200312,049000,元油2X中信95購02,,,,,0.00,0.00,0,0,0,0,0,0,0,0,0,0,0,0,0
20200312,049001,川湖中信94購01,,,,,0.00,0.00,0,0,0,0,0,0,0,0,0,0,0,0,0
20200312,049002,光寶科中信94購01,,,,,0.00,0.00,0,0,0,0,0,0,0,0,0,0,0,0,0
20200312,049003,智邦中信95購01,0.07,0.07,0.07,0.07,0.00,0.00,80000,1,5600,0,0,0,0,0,0,80000,0,80000,80000
20200312,049004,聯發科中信96購01,0.45,0.45,0.24,0.24,-0.24,-50.0,475000,20,145200,0,0,0,0,0,0,73000,406000,-333000,-333000
20200312,049005,可成中信95購01,,,,,0.00,0.00,0,0,0,0,0,0,0,0,0,0,0,0,0
20200312,049006,和鑫中信94購01,,,,,0.00,0.00,0,0,0,0,0,0,0,0,0,0,0,0,0
20200312,049007,玉晶光中信96購01,0.53,0.54,0.37,0.37,-0.24,-39.34,1819000,44,868500,0,0,0,0,0,0,263000,1556000,-1293000,-1293000
20200312,049008,傳奇中信95購01,,,,,0.00,0.00,0,0,0,0,0,0,0,0,0,0,0,0,0
20200312,049009,南亞科麥證94購01,,,,,0.00,0.00,0,0,0,0,0,0,0,0,0,0,0,0,0
20200312,04900P,矽格中信94售02,0.53,0.60,0.53,0.60,0.00,0.00,260000,4,146330,0,0,0,0,0,0,0,260000,-260000,-260000
20200312,049010,台表科麥證95購01,0.49,0.49,0.49,0.49,0.00,0.00,2000,1,980,0,2000,-2000,0,0,0,0,2000,-2000,-2000
20200312,049011,元油2X群益94購01,,,,,0.00,0.00,0,0,0,0,0,0,0,0,0,0,0,0,0
20200312,049012,大成鋼群益94購01,,,,,0.00,0.00,0,0,0,0,0,0,0,0,0,0,0,0,0
20200312,049013,川湖群益94購01,,,,,0.00,0.00,0,0,0,0,0,0,0,0,0,0,0,0,0
20200312,049014,台達電群益94購02,0.11,0.11,0.11,0.11,-0.09,-45.0,10000,1,1100,0,0,0,0,0,0,10000,0,10000,10000
20200312,049015,鴻海群益94購03,,,,,0.00,0.00,0,0,0,0,0,0,0,0,0,0,0,0,0
20200312,049016,國巨群益94購02,5.85,5.85,2.03,2.03,-4.62,-69.47,65000,10,289500,3000,3000,0,0,0,0,38000,27000,11000,11000
20200312,049017,旺宏群益96購03,0.97,0.97,0.62,0.64,-0.48,-42.86,174000,17,121840,0,0,0,0,0,0,10000,174000,-164000,-164000
20200312,049018,光罩群益94購01,,,,,0.00,0.00,0,0,0,0,0,0,0,0,0,0,0,0,0
20200312,049019,美律群益94購02,,,,,0.00,0.00,0,0,0,0,0,0,0,0,0,0,0,0,0
20200312,04901P,臺股指麥證94售02,4.63,6.35,4.63,6.35,+2.46,63.24,93000,11,554080,36000,57000,-21000,0,0,0,36000,57000,-21000,-21000
20200312,049020,可成群益94購02,,,,,0.00,0.00,0,0,0,0,0,0,0,0,0,0,0,0,0
20200312,049021,慧洋群益94購01,,,,,0.00,0.00,0,0,0,0,0,0,0,0,0,0,0,0,0
20200312,049022,聯詠群益94購01,,,,,0.00,0.00,0,0,0,0,0,0,0,0,0,0,0,0,0
20200312,049023,玉晶光群益96購04,0.30,0.31,0.20,0.20,-0.18,-47.37,1256000,48,301100,0,0,0,0,0,0,496000,758000,-262000,-262000
20200312,049024,玉晶光群益97購01,1.64,1.64,1.07,1.07,-1.08,-50.23,224000,9,344000,0,0,0,0,0,0,123000,105000,18000,18000
20200312,049025,華擎群益94購01,,,,,0.00,0.00,0,0,0,0,0,0,0,0,0,0,0,0,0
20200312,049026,晶相光群益94購01,0.14,0.14,0.14,0.14,-0.21,-60.0,6000,1,840,0,0,0,0,0,0,6000,0,6000,6000
20200312,049027,智易群益94購02,,,,,0.00,0.00,0,0,0,0,0,0,0,0,0,0,0,0,0
20200312,049028,麗豐群益94購01,,,,,0.00,0.00,0,0,0,0,0,0,0,0,0,0,0,0,0
20200312,049029,茂林群益94購01,1.98,1.98,1.98,1.98,-2.12,-51.71,20000,1,39600,0,0,0,0,0,0,20000,0,20000,20000
20200312,04902P,國巨台新94售04,0.23,0.23,0.23,0.23,0.00,0.00,5000,1,1150,0,0,0,0,0,0,5000,0,5000,5000
20200312,049030,凌華群益94購01,0.60,0.63,0.60,0.63,0.00,0.00,8000,2,4890,0,0,0,0,0,0,8000,0,8000,8000
20200312,049031,矽格群益94購01,0.25,0.25,0.25,0.25,0.00,0.00,7000,1,1750,0,0,0,0,0,0,7000,0,7000,7000
20200312,049032,百和群益94購04,,,,,0.00,0.00,0,0,0,0,0,0,0,0,0,0,0,0,0
20200312,049033,大成鋼兆豐94購01,,,,,0.00,0.00,0,0,0,0,0,0,0,0,0,0,0,0,0
20200312,049034,台達電兆豐94購01,0.18,0.18,0.18,0.18,-0.12,-40.0,5000,1,900,0,0,0,0,0,0,5000,0,5000,5000
20200312,049035,中環兆豐94購01,,,,,0.00,0.00,0,0,0,0,0,0,0,0,0,0,0,0,0
20200312,049036,燿華兆豐95購01,0.02,0.03,0.02,0.03,0.00,0.00,153000,14,3560,0,0,0,0,0,0,0,153000,-153000,-153000
20200312,049037,可成兆豐94購01,,,,,0.00,0.00,0,0,0,0,0,0,0,0,0,0,0,0,0
20200312,049038,高鐵兆豐94購01,,,,,0.00,0.00,0,0,0,0,0,0,0,0,0,0,0,0,0
20200312,049039,富邦金兆豐94購01,,,,,0.00,0.00,0,0,0,0,0,0,0,0,0,0,0,0,0
20200312,04903P,全新永豐94售05,1.22,1.34,1.22,1.34,0.00,0.00,30000,3,37800,0,0,0,0,0,0,0,30000,-30000,-30000
20200312,049040,亞光兆豐95購01,,,,,0.00,0.00,0,0,0,0,0,0,0,0,0,0,0,0,0
20200312,049041,和鑫兆豐94購01,,,,,0.00,0.00,0,0,0,0,0,0,0,0,0,0,0,0,0
20200312,049042,玉晶光兆豐95購01,0.40,0.40,0.24,0.24,-0.30,-55.56,1200000,30,410400,0,0,0,0,0,0,1039000,158000,881000,881000
20200312,049043,新唐兆豐94購01,,,,,0.00,0.00,0,0,0,0,0,0,0,0,0,0,0,0,0
20200312,049044,和碩兆豐94購01,0.73,0.73,0.58,0.58,-0.45,-43.69,40000,10,25500,0,0,0,0,0,0,10000,30000,-20000,-20000
20200312,049045,上海銀兆豐94購01,,,,,0.00,0.00,0,0,0,0,0,0,0,0,0,0,0,0,0
20200312,049046,同欣電兆豐94購01,0.06,0.06,0.06,0.06,0.00,0.00,150000,2,9000,0,0,0,0,0,0,150000,0,150000,150000
20200312,049047,台達電台新94購01,,,,,0.00,0.00,0,0,0,0,0,0,0,0,0,0,0,0,0
20200312,049048,玉晶光台新94購01,,,,,0.00,0.00,0,0,0,0,0,0,0,0,0,0,0,0,0
20200312,049049,玉晶光康和94購02,0.17,0.17,0.17,0.17,0.00,0.00,30000,1,5100,0,0,0,0,0,0,30000,0,30000,30000
20200312,04904P,奇力新永豐94售05,0.32,0.32,0.32,0.32,0.00,0.00,12000,1,3840,0,0,0,0,0,0,12000,0,12000,12000
20200312,049050,崇越康和94購01,,,,,0.00,0.00,0,0,0,0,0,0,0,0,0,0,0,0,0
20200312,049051,滬深2X永豐94購05,,,,,0.00,0.00,0,0,0,0,0,0,0,0,0,0,0,0,0
20200312,049052,台積電永豐94購02,0.22,0.22,0.15,0.15,0.00,0.00,33000,5,5710,0,0,0,0,0,0,15000,18000,-3000,-3000
20200312,049053,可成永豐94購01,,,,,0.00,0.00,0,0,0,0,0,0,0,0,0,0,0,0,0
20200312,049054,禾伸堂永豐94購01,0.02,0.02,0.02,0.02,0.00,0.00,8000,1,160,0,0,0,0,0,0,8000,0,8000,8000
20200312,049055,聯詠永豐94購01,0.01,0.01,0.01,0.01,0.00,0.00,300000,1,3000,0,0,0,0,0,0,300000,0,300000,300000
20200312,049056,玉晶光永豐95購03,0.20,0.20,0.13,0.13,0.00,0.00,75000,6,12950,0,0,0,0,0,0,55000,20000,35000,35000
20200312,049057,元翎永豐94購01,,,,,0.00,0.00,0,0,0,0,0,0,0,0,0,0,0,0,0
20200312,049058,茂林永豐94購02,,,,,0.00,0.00,0,0,0,0,0,0,0,0,0,0,0,0,0
20200312,049059,超眾永豐94購01,,,,,0.00,0.00,0,0,0,0,0,0,0,0,0,0,0,0,0
20200312,04905P,國巨國票94售04,,,,,0.00,0.00,0,0,0,0,0,0,0,0,0,0,0,0,0
20200312,049060,易華電永豐94購02,,,,,0.00,0.00,0,0,0,0,0,0,0,0,0,0,0,0,0
20200312,049061,元油2X日盛94購01,,,,,0.00,0.00,0,0,0,0,0,0,0,0,0,0,0,0,0
20200312,049062,華新科日盛94購01,,,,,0.00,0.00,0,0,0,0,0,0,0,0,0,0,0,0,0
20200312,049063,緯穎日盛94購01,,,,,0.00,0.00,0,0,0,0,0,0,0,0,0,0,0,0,0
20200312,049064,T50反1凱基96購03,,,,,0.00,0.00,0,0,0,0,0,0,0,0,0,0,0,0,0
20200312,049065,T50反1凱基96購04,0.70,0.71,0.70,0.71,+0.09,14.52,1000000,4,702000,0,0,0,0,0,0,1000000,0,1000000,1000000
20200312,049066,元石油凱基97購01,,,,,0.00,0.00,0,0,0,0,0,0,0,0,0,0,0,0,0
20200312,049067,元油2X凱基94購02,,,,,0.00,0.00,0,0,0,0,0,0,0,0,0,0,0,0,0
20200312,049068,元油2X凱基95購03,,,,,0.00,0.00,0,0,0,0,0,0,0,0,0,0,0,0,0
20200312,049069,元油2X凱基95購04,,,,,0.00,0.00,0,0,0,0,0,0,0,0,0,0,0,0,0
20200312,04906P,欣興國票95售01,3.70,3.70,3.70,3.70,+0.75,25.42,10000,1,37000,0,0,0,0,0,0,10000,0,10000,10000
20200312,049070,力山凱基94購02,,,,,0.00,0.00,0,0,0,0,0,0,0,0,0,0,0,0,0
20200312,049071,台達電凱基94購02,,,,,0.00,0.00,0,0,0,0,0,0,0,0,0,0,0,0,0
20200312,049072,台積電凱基94購08,,,,,0.00,0.00,0,0,0,0,0,0,0,0,0,0,0,0,0
20200312,049073,光罩凱基94購01,,,,,0.00,0.00,0,0,0,0,0,0,0,0,0,0,0,0,0
20200312,049074,光罩凱基94購02,0.06,0.06,0.06,0.06,-0.20,-76.92,10000,1,600,0,0,0,0,0,0,10000,0,10000,10000
20200312,049075,光磊凱基94購01,,,,,0.00,0.00,0,0,0,0,0,0,0,0,0,0,0,0,0
20200312,049076,佳世達凱基94購01,,,,,0.00,0.00,0,0,0,0,0,0,0,0,0,0,0,0,0
20200312,049077,佳世達凱基94購02,,,,,0.00,0.00,0,0,0,0,0,0,0,0,0,0,0,0,0
20200312,049078,瑞昱凱基94購02,,,,,0.00,0.00,0,0,0,0,0,0,0,0,0,0,0,0,0
20200312,049079,聯發科凱基94購04,,,,,0.00,0.00,0,0,0,0,0,0,0,0,0,0,0,0,0
20200312,04907P,超眾國票95售01,1.47,1.82,1.47,1.82,+0.53,41.09,134000,15,216580,0,0,0,0,0,0,20000,114000,-94000,-94000
20200312,049080,可成凱基94購03,,,,,0.00,0.00,0,0,0,0,0,0,0,0,0,0,0,0,0
20200312,049081,兆赫凱基94購01,,,,,0.00,0.00,0,0,0,0,0,0,0,0,0,0,0,0,0
20200312,049082,晶豪科凱基94購01,0.30,0.30,0.10,0.10,-0.39,-79.59,291000,30,69380,0,0,0,0,0,0,261000,30000,231000,231000
20200312,049083,大立光凱基94購02,,,,,0.00,0.00,0,0,0,0,0,0,0,0,0,0,0,0,0
20200312,049084,欣興凱基94購03,,,,,0.00,0.00,0,0,0,0,0,0,0,0,0,0,0,0,0
20200312,049085,揚明光凱基94購03,,,,,0.00,0.00,0,0,0,0,0,0,0,0,0,0,0,0,0
20200312,049086,晶相光凱基94購01,0.38,0.38,0.20,0.21,-0.54,-72.0,45000,5,14450,0,0,0,0,0,0,10000,35000,-25000,-25000
20200312,049087,晶相光凱基94購02,0.26,0.26,0.26,0.26,-0.30,-53.57,20000,1,5200,0,0,0,0,0,0,20000,0,20000,20000
20200312,049088,上緯控凱基94購02,,,,,0.00,0.00,0,0,0,0,0,0,0,0,0,0,0,0,0
20200312,049089,正文凱基94購02,,,,,0.00,0.00,0,0,0,0,0,0,0,0,0,0,0,0,0
20200312,04908P,南電國票95售03,1.18,1.46,1.17,1.46,+0.31,26.96,349000,23,462980,0,0,0,0,0,0,294000,55000,239000,239000
20200312,049090,茂林凱基94購01,2.14,2.14,1.91,2.02,-1.85,-47.8,40000,4,80400,0,0,0,0,0,0,10000,30000,-20000,-20000
20200312,049091,訊連凱基94購01,1.38,1.39,1.06,1.27,-1.08,-45.96,40000,4,51000,0,0,0,0,0,0,10000,30000,-20000,-20000
20200312,049092,聯茂凱基94購07,,,,,0.00,0.00,0,0,0,0,0,0,0,0,0,0,0,0,0
20200312,049093,昇陽半凱基94購01,,,,,0.00,0.00,0,0,0,0,0,0,0,0,0,0,0,0,0
20200312,049094,昇陽半凱基94購02,,,,,0.00,0.00,0,0,0,0,0,0,0,0,0,0,0,0,0
20200312,049095,昇陽半凱基94購03,,,,,0.00,0.00,0,0,0,0,0,0,0,0,0,0,0,0,0
20200312,049096,南茂凱基94購01,,,,,0.00,0.00,0,0,0,0,0,0,0,0,0,0,0,0,0
20200312,049097,國巨國泰95購03,,,,,0.00,0.00,0,0,0,0,0,0,0,0,0,0,0,0,0
20200312,049098,國巨國泰96購01,,,,,0.00,0.00,0,0,0,0,0,0,0,0,0,0,0,0,0
20200312,049099,華新科國泰95購02,1.34,1.34,0.72,0.84,-0.79,-48.47,310000,5,358700,0,0,0,0,0,0,0,310000,-310000,-310000
20200312,04909P,鴻海統一94售10,0.85,1.30,0.85,1.20,+0.58,93.55,141000,10,171300,0,0,0,0,0,0,141000,98000,43000,43000
20200312,049100,華新科國泰96購01,1.38,1.38,0.81,0.90,-0.52,-36.62,492000,21,566350,0,0,0,0,0,0,222000,270000,-48000,-48000
20200312,049101,聯詠國泰95購01,0.72,0.72,0.72,0.72,-0.37,-33.94,50000,1,36000,0,0,0,0,0,0,0,50000,-50000,-50000
20200312,049102,智伸科國泰96購01,,,,,0.00,0.00,0,0,0,0,0,0,0,0,0,0,0,0,0
20200312,049103,易華電國泰96購01,,,,,0.00,0.00,0,0,0,0,0,0,0,0,0,0,0,0,0
20200312,049104,元油2X富邦97購02,0.09,0.09,0.09,0.09,-0.01,-10.0,33000,2,2970,0,0,0,0,0,0,0,0,0,0
20200312,049105,亞泥富邦94購01,,,,,0.00,0.00,0,0,0,0,0,0,0,0,0,0,0,0,0
20200312,049106,大立光富邦94購01,,,,,0.00,0.00,0,0,0,0,0,0,0,0,0,0,0,0,0
20200312,049107,緯創富邦94購01,,,,,0.00,0.00,0,0,0,0,0,0,0,0,0,0,0,0,0
20200312,049108,玉晶光富邦96購02,0.27,0.29,0.25,0.25,-0.16,-39.02,205000,8,54070,0,0,0,0,0,0,165000,40000,125000,125000
20200312,049109,嘉澤富邦95購01,,,,,0.00,0.00,0,0,0,0,0,0,0,0,0,0,0,0,0
20200312,04910P,台積電統一94售12,0.63,0.71,0.63,0.70,+0.21,42.86,36000,7,23120,0,0,0,0,0,0,32000,30000,2000,2000
20200312,049110,臻鼎富邦94購01,,,,,0.00,0.00,0,0,0,0,0,0,0,0,0,0,0,0,0
20200312,049111,元油2X統一94購03,,,,,0.00,0.00,0,0,0,0,0,0,0,0,0,0,0,0,0
20200312,049112,可成統一94購01,,,,,0.00,0.00,0,0,0,0,0,0,0,0,0,0,0,0,0
20200312,049113,大立光統一94購06,,,,,0.00,0.00,0,0,0,0,0,0,0,0,0,0,0,0,0
20200312,049114,玉晶光統一94購02,,,,,0.00,0.00,0,0,0,0,0,0,0,0,0,0,0,0,0
20200312,049115,創意統一94購03,,,,,0.00,0.00,0,0,0,0,0,0,0,0,0,0,0,0,0
20200312,049116,瑞儀統一94購01,,,,,0.00,0.00,0,0,0,0,0,0,0,0,0,0,0,0,0
20200312,049117,矽格統一96購01,1.03,1.03,0.82,0.85,-0.39,-31.45,68000,5,63300,0,0,0,0,0,0,68000,0,68000,68000
20200312,049118,元油2X元富94購03,0.01,0.01,0.01,0.01,-0.01,-50.0,92000,1,920,0,0,0,0,0,0,0,0,0,0
20200312,049119,元油2X元富94購04,,,,,0.00,0.00,0,0,0,0,0,0,0,0,0,0,0,0,0
20200312,04911P,美律元富94售02,1.06,1.28,1.02,1.28,+0.33,34.74,50000,4,54700,0,0,0,0,0,0,20000,30000,-10000,-10000
20200312,049120,元油2X元富94購05,,,,,0.00,0.00,0,0,0,0,0,0,0,0,0,0,0,0,0
20200312,049121,元油2X元富94購06,,,,,0.00,0.00,0,0,0,0,0,0,0,0,0,0,0,0,0
20200312,049122,元油2X元富94購07,,,,,0.00,0.00,0,0,0,0,0,0,0,0,0,0,0,0,0
20200312,049123,可成元富94購01,,,,,0.00,0.00,0,0,0,0,0,0,0,0,0,0,0,0,0
20200312,049124,可成元富94購02,,,,,0.00,0.00,0,0,0,0,0,0,0,0,0,0,0,0,0
20200312,049125,禾伸堂元富94購01,,,,,0.00,0.00,0,0,0,0,0,0,0,0,0,0,0,0,0
20200312,049126,玉晶光元富94購02,,,,,0.00,0.00,0,0,0,0,0,0,0,0,0,0,0,0,0
20200312,049127,上海銀元富94購01,,,,,0.00,0.00,0,0,0,0,0,0,0,0,0,0,0,0,0
20200312,049128,滬深2X元大97購03,0.29,0.30,0.25,0.30,-0.07,-18.92,36000,7,9710,0,0,0,0,0,0,20000,16000,4000,4000
20200312,049129,S&P反1元大97購01,0.59,0.71,0.58,0.68,+0.14,25.93,530000,12,321810,0,0,0,0,0,0,480000,20000,460000,460000
20200312,04912P,可成元富94售06,3.10,3.89,3.02,3.86,+1.30,50.78,104000,12,342670,0,0,0,0,0,0,21000,94000,-73000,-73000
20200312,049130,臺指反元大98購01,0.63,0.77,0.63,0.73,+0.24,48.98,455000,8,334890,0,0,0,0,0,0,455000,0,455000,455000
20200312,049131,元油2X元大94購02,,,,,0.00,0.00,0,0,0,0,0,0,0,0,0,0,0,0,0
20200312,049132,大成鋼元大94購01,0.08,0.08,0.07,0.07,0.00,0.00,70000,2,5100,0,0,0,0,0,0,70000,0,70000,70000
20200312,049133,為升元大94購02,,,,,0.00,0.00,0,0,0,0,0,0,0,0,0,0,0,0,0
20200312,049134,為升元大95購01,0.02,0.02,0.02,0.02,-0.04,-66.67,100000,10,2000,0,0,0,0,0,0,0,100000,-100000,-100000
20200312,049135,台達電元大94購03,0.09,0.09,0.09,0.09,-0.15,-62.5,10000,1,900,0,0,0,0,0,0,10000,0,10000,10000
20200312,049136,華通元大95購01,0.64,0.64,0.30,0.33,-0.39,-54.17,310000,23,139660,0,0,0,0,0,0,101000,249000,-148000,-148000
20200312,049137,華通元大95購02,0.96,0.96,0.51,0.51,-0.77,-60.16,314000,23,229740,0,0,0,0,0,0,254000,162000,92000,92000
20200312,049138,台積電元大94購05,0.31,0.31,0.12,0.25,-0.49,-66.22,257000,10,55200,0,0,0,0,0,0,117000,189000,-72000,-72000
20200312,049139,台積電元大94購06,0.59,0.59,0.42,0.50,-0.83,-62.41,204000,5,107010,0,0,0,0,0,0,199000,204000,-5000,-5000
20200312,04913P,聯詠元富94售02,1.25,1.44,1.25,1.31,+0.17,14.91,333000,10,449040,0,0,0,0,0,0,216000,117000,99000,99000
20200312,049140,台積電元大94購07,,,,,0.00,0.00,0,0,0,0,0,0,0,0,0,0,0,0,0
20200312,049141,旺宏元大95購01,0.96,0.96,0.64,0.64,-0.46,-41.82,253000,18,199110,0,0,0,0,0,0,111000,142000,-31000,-31000
20200312,049142,智邦元大94購01,0.31,0.31,0.31,0.31,-0.10,-24.39,10000,1,3100,0,0,0,0,0,0,10000,0,10000,10000
20200312,049143,智邦元大94購02,0.65,0.65,0.42,0.42,-0.35,-45.45,97000,2,46030,0,0,0,0,0,0,23000,74000,-51000,-51000
20200312,049144,瑞昱元大94購03,,,,,0.00,0.00,0,0,0,0,0,0,0,0,0,0,0,0,0
20200312,049145,南亞科元大94購01,,,,,0.00,0.00,0,0,0,0,0,0,0,0,0,0,0,0,0
20200312,049146,南亞科元大94購02,,,,,0.00,0.00,0,0,0,0,0,0,0,0,0,0,0,0,0
20200312,049147,美律元大94購02,,,,,0.00,0.00,0,0,0,0,0,0,0,0,0,0,0,0,0
20200312,049148,全新元大95購01,,,,,0.00,0.00,0,0,0,0,0,0,0,0,0,0,0,0,0
20200312,049149,華新科元大95購03,0.60,0.60,0.45,0.45,-0.52,-53.61,31000,7,14460,0,0,0,0,0,0,12000,19000,-7000,-7000
20200312,04914P,國巨國泰95售06,0.56,0.82,0.56,0.74,+0.28,60.87,516000,9,371640,0,0,0,0,0,0,511000,5000,506000,506000
20200312,049150,新光金元大96購01,0.39,0.39,0.33,0.34,-0.14,-29.17,65000,4,24250,0,0,0,0,0,0,53000,12000,41000,41000
20200312,049151,大立光元大94購07,,,,,0.00,0.00,0,0,0,0,0,0,0,0,0,0,0,0,0
20200312,049152,大立光元大95購06,0.12,0.14,0.11,0.12,-0.20,-62.5,260000,9,32350,0,0,0,0,0,0,25000,235000,-210000,-210000
20200312,049153,大立光元大96購02,0.24,0.25,0.18,0.18,-0.17,-48.57,994000,55,210960,0,0,0,0,0,0,319000,615000,-296000,-296000
20200312,049154,玉晶光元大95購02,0.45,0.45,0.37,0.37,-0.55,-59.78,17000,2,7090,0,0,0,0,0,0,17000,0,17000,17000
20200312,049155,同欣電元大94購01,,,,,0.00,0.00,0,0,0,0,0,0,0,0,0,0,0,0,0
20200312,049156,緯穎元大96購01,,,,,0.00,0.00,0,0,0,0,0,0,0,0,0,0,0,0,0
20200312,049157,矽創元大95購01,0.42,0.42,0.22,0.22,-0.24,-52.17,107000,2,40940,0,0,0,0,0,0,107000,0,107000,107000
20200312,049158,元油2X中信94購03,,,,,0.00,0.00,0,0,0,0,0,0,0,0,0,0,0,0,0
20200312,049159,同欣電中信96購01,0.44,0.44,0.32,0.32,-0.16,-33.33,130000,5,45940,0,0,0,0,0,0,92000,38000,54000,54000
20200312,04915P,鴻海永昌96售02,1.93,2.26,1.93,2.26,+0.63,38.65,683000,14,1525150,0,0,0,0,0,0,27000,671000,-644000,-644000
20200312,049160,鴻海第一95購01,,,,,0.00,0.00,0,0,0,0,0,0,0,0,0,0,0,0,0
20200312,049161,聯發科亞東94購01,,,,,0.00,0.00,0,0,0,0,0,0,0,0,0,0,0,0,0
20200312,049162,聯詠亞東94購01,,,,,0.00,0.00,0,0,0,0,0,0,0,0,0,0,0,0,0
20200312,049163,欣興亞東94購01,,,,,0.00,0.00,0,0,0,0,0,0,0,0,0,0,0,0,0
20200312,049164,滬深2X日盛94購01,,,,,0.00,0.00,0,0,0,0,0,0,0,0,0,0,0,0,0
20200312,049165,元油2X凱基97購01,,,,,0.00,0.00,0,0,0,0,0,0,0,0,0,0,0,0,0
20200312,049166,元油2X凱基97購02,0.14,0.14,0.10,0.10,0.00,0.00,31000,4,3140,0,0,0,0,0,0,0,30000,-30000,-30000
20200312,049167,元油2X凱基97購03,,,,,0.00,0.00,0,0,0,0,0,0,0,0,0,0,0,0,0
20200312,049168,卜蜂凱基94購01,,,,,0.00,0.00,0,0,0,0,0,0,0,0,0,0,0,0,0
20200312,049169,統一凱基94購01,,,,,0.00,0.00,0,0,0,0,0,0,0,0,0,0,0,0,0
20200312,04916P,大立光永昌96售02,2.92,3.46,2.90,3.46,+1.44,71.29,1657000,14,4980050,0,0,0,0,0,0,1509000,148000,1361000,1361000
20200312,049170,亞德客凱基94購01,1.20,1.20,0.72,0.72,-1.27,-63.82,20000,2,19200,0,0,0,0,0,0,10000,10000,0,0
20200312,049171,台達電凱基94購03,,,,,0.00,0.00,0,0,0,0,0,0,0,0,0,0,0,0,0
20200312,049172,鴻海凱基94購14,1.29,1.29,0.70,0.79,-1.23,-60.89,90000,9,92100,0,0,0,0,0,0,0,90000,-90000,-90000
20200312,049173,鴻海凱基94購15,0.25,0.25,0.25,0.25,-0.28,-52.83,10000,1,2500,0,0,0,0,0,0,10000,0,10000,10000
20200312,049174,台積電凱基94購11,1.86,1.93,1.86,1.93,-1.54,-44.38,30000,3,56900,0,0,0,0,0,0,0,30000,-30000,-30000
20200312,049175,台積電凱基94購12,0.19,0.19,0.19,0.19,-0.57,-75.0,1000,1,190,0,0,0,0,0,0,1000,0,1000,1000
20200312,049176,漢唐凱基94購02,0.24,0.24,0.24,0.24,-0.23,-48.94,10000,1,2400,0,0,0,0,0,0,10000,0,10000,10000
20200312,049177,美律凱基94購02,,,,,0.00,0.00,0,0,0,0,0,0,0,0,0,0,0,0,0
20200312,049178,宏達電凱基94購02,,,,,0.00,0.00,0,0,0,0,0,0,0,0,0,0,0,0,0
20200312,049179,高鐵凱基94購01,,,,,0.00,0.00,0,0,0,0,0,0,0,0,0,0,0,0,0
20200312,04917P,台積電凱基94售37,,,,,0.00,0.00,0,0,0,0,0,0,0,0,0,0,0,0,0
20200312,049180,TPK凱基94購02,,,,,0.00,0.00,0,0,0,0,0,0,0,0,0,0,0,0,0
20200312,049181,正文凱基94購03,,,,,0.00,0.00,0,0,0,0,0,0,0,0,0,0,0,0,0
20200312,049182,新唐凱基94購01,,,,,0.00,0.00,0,0,0,0,0,0,0,0,0,0,0,0,0
20200312,049183,鎧勝凱基94購01,,,,,0.00,0.00,0,0,0,0,0,0,0,0,0,0,0,0,0
20200312,049184,啟碁凱基94購01,,,,,0.00,0.00,0,0,0,0,0,0,0,0,0,0,0,0,0
20200312,049185,南電凱基94購03,,,,,0.00,0.00,0,0,0,0,0,0,0,0,0,0,0,0,0
20200312,049186,寶成凱基94購01,,,,,0.00,0.00,0,0,0,0,0,0,0,0,0,0,0,0,0
20200312,049187,義隆台新94購01,,,,,0.00,0.00,0,0,0,0,0,0,0,0,0,0,0,0,0
20200312,049188,可成台新94購01,,,,,0.00,0.00,0,0,0,0,0,0,0,0,0,0,0,0,0
20200312,049189,訊芯康和94購01,,,,,0.00,0.00,0,0,0,0,0,0,0,0,0,0,0,0,0
20200312,04918P,華新科凱基94售12,,,,,0.00,0.00,0,0,0,0,0,0,0,0,0,0,0,0,0
20200312,049190,元油2X永豐94購04,,,,,0.00,0.00,0,0,0,0,0,0,0,0,0,0,0,0,0
20200312,049191,元油2X永豐95購01,,,,,0.00,0.00,0,0,0,0,0,0,0,0,0,0,0,0,0
20200312,049192,元油2X永豐96購02,,,,,0.00,0.00,0,0,0,0,0,0,0,0,0,0,0,0,0
20200312,049193,元油2X永豐97購01,,,,,0.00,0.00,0,0,0,0,0,0,0,0,0,0,0,0,0
20200312,049194,卜蜂永豐94購01,,,,,0.00,0.00,0,0,0,0,0,0,0,0,0,0,0,0,0
20200312,049195,全新永豐94購02,,,,,0.00,0.00,0,0,0,0,0,0,0,0,0,0,0,0,0
20200312,049196,奇力新永豐94購02,,,,,0.00,0.00,0,0,0,0,0,0,0,0,0,0,0,0,0
20200312,049197,信邦永豐94購01,,,,,0.00,0.00,0,0,0,0,0,0,0,0,0,0,0,0,0
20200312,049198,聯鈞永豐94購01,2.15,2.15,2.15,2.15,-1.05,-32.81,2000,1,4300,0,0,0,0,0,0,2000,0,2000,2000
20200312,049199,茂林永豐95購01,,,,,0.00,0.00,0,0,0,0,0,0,0,0,0,0,0,0,0
20200312,04919P,聯詠凱基94售05,0.95,1.11,0.95,1.11,0.00,0.00,219000,8,217450,0,0,0,0,0,0,0,219000,-219000,-219000
20200312,049200,元黃金群益98購01,,,,,0.00,0.00,0,0,0,0,0,0,0,0,0,0,0,0,0
20200312,049201,劍麟群益94購01,,,,,0.00,0.00,0,0,0,0,0,0,0,0,0,0,0,0,0
20200312,049202,國巨群益94購03,3.43,3.43,3.22,3.22,0.00,0.00,10000,2,33250,0,0,0,0,0,0,0,10000,-10000,-10000
20200312,049203,智邦群益94購01,,,,,0.00,0.00,0,0,0,0,0,0,0,0,0,0,0,0,0
20200312,049204,京元電群益94購02,,,,,0.00,0.00,0,0,0,0,0,0,0,0,0,0,0,0,0
20200312,049205,聯發科群益94購05,,,,,0.00,0.00,0,0,0,0,0,0,0,0,0,0,0,0,0
20200312,049206,大立光群益94購04,,,,,0.00,0.00,0,0,0,0,0,0,0,0,0,0,0,0,0
20200312,049207,茂林群益94購02,2.04,2.04,1.97,1.97,-1.09,-35.62,60000,2,119600,0,0,0,0,0,0,60000,0,60000,60000
20200312,049208,台郡群益94購01,,,,,0.00,0.00,0,0,0,0,0,0,0,0,0,0,0,0,0
20200312,049209,GIS群益94購03,,,,,0.00,0.00,0,0,0,0,0,0,0,0,0,0,0,0,0
20200312,04920P,智易凱基94售05,2.55,2.99,2.55,2.99,0.00,0.00,30000,3,85300,0,0,0,0,0,0,0,30000,-30000,-30000
20200312,049210,昇陽半群益94購02,,,,,0.00,0.00,0,0,0,0,0,0,0,0,0,0,0,0,0
20200312,049211,昇陽半群益94購03,,,,,0.00,0.00,0,0,0,0,0,0,0,0,0,0,0,0,0
20200312,049212,T50反1國票94購04,1.14,1.50,1.14,1.47,+0.50,51.55,389000,17,484540,0,0,0,0,0,0,388000,0,388000,388000
20200312,049213,滬深2X國票94購02,0.18,0.18,0.18,0.18,-0.13,-41.94,2000,2,360,0,0,0,0,0,0,2000,0,2000,2000
20200312,049214,台達電國票95購01,,,,,0.00,0.00,0,0,0,0,0,0,0,0,0,0,0,0,0
20200312,049215,國巨國票94購03,3.36,3.36,3.30,3.30,-6.40,-65.98,11000,2,36900,0,0,0,0,0,0,0,11000,-11000,-11000
20200312,049216,華邦電國票95購01,,,,,0.00,0.00,0,0,0,0,0,0,0,0,0,0,0,0,0
20200312,049217,智邦國票95購01,0.15,0.15,0.15,0.15,-0.23,-60.53,38000,1,5700,0,0,0,0,0,0,38000,0,38000,38000
20200312,049218,燿華國票94購02,,,,,0.00,0.00,0,0,0,0,0,0,0,0,0,0,0,0,0
20200312,049219,聯發科國票95購01,0.01,0.05,0.01,0.05,0.00,0.00,281000,6,2890,0,0,0,0,0,0,0,2000,-2000,-2000
20200312,04921P,TPK凱基94售05,2.57,2.57,2.57,2.57,0.00,0.00,10000,1,25700,0,0,0,0,0,0,0,10000,-10000,-10000
20200312,049220,聯發科國票95購02,0.07,0.07,0.07,0.07,-0.18,-72.0,10000,1,700,0,0,0,0,0,0,0,10000,-10000,-10000
20200312,049221,健策國票95購02,,,,,0.00,0.00,0,0,0,0,0,0,0,0,0,0,0,0,0
20200312,049222,和碩國票94購01,0.41,0.43,0.27,0.27,-0.40,-59.7,90000,6,28300,0,0,0,0,0,0,40000,50000,-10000,-10000
20200312,049223,鎧勝國票95購01,,,,,0.00,0.00,0,0,0,0,0,0,0,0,0,0,0,0,0
20200312,049224,致新國票95購01,,,,,0.00,0.00,0,0,0,0,0,0,0,0,0,0,0,0,0
20200312,049225,達方國票94購01,,,,,0.00,0.00,0,0,0,0,0,0,0,0,0,0,0,0,0
20200312,049226,元石油富邦95購01,,,,,0.00,0.00,0,0,0,0,0,0,0,0,0,0,0,0,0
20200312,049227,元油2X富邦96購03,,,,,0.00,0.00,0,0,0,0,0,0,0,0,0,0,0,0,0
20200312,049228,台塑富邦94購01,,,,,0.00,0.00,0,0,0,0,0,0,0,0,0,0,0,0,0
20200312,049229,台化富邦94購01,,,,,0.00,0.00,0,0,0,0,0,0,0,0,0,0,0,0,0
20200312,04922P,日月光凱基94售02,1.96,2.43,1.96,2.41,+0.60,33.15,77000,5,172600,0,0,0,0,0,0,23000,54000,-31000,-31000
20200312,049230,台達電富邦96購01,,,,,0.00,0.00,0,0,0,0,0,0,0,0,0,0,0,0,0
20200312,049231,鴻海富邦95購02,1.17,1.17,1.17,1.17,0.00,0.00,3000,1,3510,0,0,0,0,0,0,0,3000,-3000,-3000
20200312,049232,元油2X統一94購04,,,,,0.00,0.00,0,0,0,0,0,0,0,0,0,0,0,0,0
20200312,049233,聯發科統一94購04,0.54,0.54,0.29,0.29,-0.55,-65.48,55000,4,25150,0,0,0,0,0,0,10000,45000,-35000,-35000
20200312,049234,可成統一94購02,,,,,0.00,0.00,0,0,0,0,0,0,0,0,0,0,0,0,0
20200312,049235,元油2X元富96購05,0.08,0.08,0.05,0.07,-0.04,-36.36,10210000,209,617260,0,0,0,0,0,0,0,7695000,-7695000,-7695000
20200312,049236,元油2X元富96購06,0.02,0.02,0.01,0.01,-0.02,-66.67,405000,10,4260,0,0,0,0,0,0,20000,0,20000,20000
20200312,049237,元油2X元富96購07,,,,,0.00,0.00,0,0,0,0,0,0,0,0,0,0,0,0,0
20200312,049238,元油2X元富96購08,,,,,0.00,0.00,0,0,0,0,0,0,0,0,0,0,0,0,0
20200312,049239,卜蜂元富94購01,,,,,0.00,0.00,0,0,0,0,0,0,0,0,0,0,0,0,0
20200312,04923P,GIS凱基94售06,0.89,1.24,0.89,1.24,+0.48,63.16,349000,7,350060,0,0,0,0,0,0,79000,270000,-191000,-191000
20200312,049240,華通元富94購01,,,,,0.00,0.00,0,0,0,0,0,0,0,0,0,0,0,0,0
20200312,049241,智邦元富94購01,,,,,0.00,0.00,0,0,0,0,0,0,0,0,0,0,0,0,0
20200312,049242,佳世達元富96購01,0.14,0.14,0.12,0.12,0.00,0.00,25000,3,3300,0,0,0,0,0,0,0,25000,-25000,-25000
20200312,049243,佳世達元富96購02,0.06,0.06,0.06,0.06,0.00,0.00,10000,1,600,0,0,0,0,0,0,0,10000,-10000,-10000
20200312,049244,亞光元富94購01,,,,,0.00,0.00,0,0,0,0,0,0,0,0,0,0,0,0,0
20200312,049245,和鑫元富95購01,0.04,0.04,0.04,0.04,0.00,0.00,100000,1,4000,0,0,0,0,0,0,0,100000,-100000,-100000
20200312,049246,大成鋼元大94購02,0.21,0.21,0.21,0.21,0.00,0.00,1000,1,210,0,0,0,0,0,0,0,1000,-1000,-1000
20200312,049247,光寶科元大94購02,0.40,0.40,0.40,0.40,+0.03,8.11,3000,1,1200,0,0,0,0,0,0,0,3000,-3000,-3000
20200312,049248,台達電元大94購04,,,,,0.00,0.00,0,0,0,0,0,0,0,0,0,0,0,0,0
20200312,049249,台達電元大94購05,0.57,0.57,0.57,0.57,-0.26,-31.33,20000,1,11400,0,0,0,0,0,0,20000,0,20000,20000
20200312,04924P,元油2X元大94售12,6.55,6.90,6.55,6.80,+1.10,19.3,427000,9,2931750,0,0,0,0,0,0,427000,208000,219000,219000
20200312,049250,華通元大95購04,0.53,0.54,0.24,0.24,-0.73,-75.26,68000,14,31330,0,0,0,0,0,0,60000,48000,12000,12000
20200312,049251,國巨元大95購02,,,,,0.00,0.00,0,0,0,0,0,0,0,0,0,0,0,0,0
20200312,049252,國巨元大96購01,5.45,5.45,5.15,5.15,0.00,0.00,10000,3,52600,0,0,0,0,0,0,4000,6000,-2000,-2000
20200312,049253,台積電元大94購08,2.13,2.13,1.23,1.67,0.00,0.00,40000,9,63340,0,0,0,0,0,0,1000,39000,-38000,-38000
20200312,049254,台積電元大96購02,2.67,2.70,2.07,2.46,-0.86,-25.9,398000,54,981480,0,0,0,0,0,0,167000,398000,-231000,-231000
20200312,049255,旺宏元大97購02,1.36,1.38,0.94,0.94,-0.87,-48.07,233000,11,274000,0,0,0,0,0,0,95000,138000,-43000,-43000
20200312,049256,瑞昱元大94購04,,,,,0.00,0.00,0,0,0,0,0,0,0,0,0,0,0,0,0
20200312,049257,南亞科元大94購03,0.14,0.14,0.08,0.09,-0.17,-65.38,534000,18,47130,0,0,0,0,0,0,534000,0,534000,534000
20200312,049258,美律元大94購03,,,,,0.00,0.00,0,0,0,0,0,0,0,0,0,0,0,0,0
20200312,049259,聯發科元大94購04,,,,,0.00,0.00,0,0,0,0,0,0,0,0,0,0,0,0,0
20200312,04925P,和碩元大94售03,1.00,1.26,0.98,1.26,+0.46,57.5,508000,11,533230,0,0,0,0,0,0,219000,289000,-70000,-70000
20200312,049260,華新科元大96購01,1.38,1.38,0.83,0.83,-0.61,-42.36,247000,18,279650,0,0,0,0,0,0,64000,136000,-72000,-72000
20200312,049261,大立光元大94購08,0.02,0.02,0.02,0.02,0.00,0.00,80000,2,1600,0,0,0,0,0,0,80000,0,80000,80000
20200312,049262,大立光元大94購09,,,,,0.00,0.00,0,0,0,0,0,0,0,0,0,0,0,0,0
20200312,049263,大立光元大94購10,,,,,0.00,0.00,0,0,0,0,0,0,0,0,0,0,0,0,0
20200312,049264,奇鋐元大95購01,0.16,0.16,0.14,0.14,-0.15,-51.72,37000,3,5280,0,0,0,0,0,0,0,37000,-37000,-37000
20200312,049265,揚明光元大94購03,,,,,0.00,0.00,0,0,0,0,0,0,0,0,0,0,0,0,0
20200312,049266,和碩元大94購01,0.40,0.48,0.39,0.39,-0.90,-69.77,408000,5,178940,0,0,0,0,0,0,10000,398000,-388000,-388000
20200312,049267,瀚宇博元大95購02,0.83,0.83,0.58,0.58,-0.44,-43.14,106000,8,81900,0,0,0,0,0,0,104000,6000,98000,98000
20200312,049268,聯茂元大94購03,0.41,0.41,0.41,0.41,-0.26,-38.81,100000,1,41000,0,0,0,0,0,0,0,100000,-100000,-100000
20200312,049269,超眾元大96購02,0.31,0.31,0.31,0.31,0.00,0.00,68000,1,21080,0,0,0,0,0,0,0,68000,-68000,-68000
20200312,04926P,聯發科凱基95售03,1.32,1.92,1.32,1.92,+1.06,123.26,530000,8,761600,0,0,0,0,0,0,490000,50000,440000,440000
20200312,049270,台表科元大95購02,1.66,1.66,1.08,1.08,-0.84,-43.75,218000,12,282440,0,0,0,0,0,0,166000,52000,114000,114000
20200312,049271,百和元大94購01,,,,,0.00,0.00,0,0,0,0,0,0,0,0,0,0,0,0,0
20200312,049272,世紀鋼元大96購02,1.07,1.07,0.89,0.97,-0.11,-10.19,435000,25,428720,0,0,0,0,0,0,320000,115000,205000,205000
20200312,049273,臺股指元大94購08,1.32,1.34,0.76,0.82,-0.66,-44.59,75000,22,71890,0,0,0,0,0,0,17000,58000,-41000,-41000
20200312,049274,臺股指元大94購09,1.01,1.01,1.01,1.01,-0.98,-49.25,1000,1,1010,0,0,0,0,0,0,0,1000,-1000,-1000
20200312,049275,臺股指元大94購10,,,,,0.00,0.00,0,0,0,0,0,0,0,0,0,0,0,0,0
20200312,049276,臺股指元大94購11,1.03,1.03,1.03,1.03,0.00,0.00,1000,1,1030,0,0,0,0,0,0,1000,0,1000,1000
20200312,049277,臺股指元大94購12,,,,,0.00,0.00,0,0,0,0,0,0,0,0,0,0,0,0,0
20200312,049278,南亞科亞東94購01,,,,,0.00,0.00,0,0,0,0,0,0,0,0,0,0,0,0,0
20200312,049279,元油2X國票94購02,0.01,0.01,0.01,0.01,0.00,0.00,200000,1,2000,0,0,0,0,0,0,200000,0,200000,200000
20200312,04927P,大立光凱基95售06,1.65,2.34,1.65,2.24,+0.79,54.48,86000,7,154870,0,0,0,0,0,0,31000,7000,24000,24000
20200312,049280,創意國票95購01,,,,,0.00,0.00,0,0,0,0,0,0,0,0,0,0,0,0,0
20200312,049281,嘉聯益國票95購01,0.01,0.01,0.01,0.01,0.00,0.00,10000,1,100,0,0,0,0,0,0,0,0,0,0
20200312,049282,易華電國票95購01,,,,,0.00,0.00,0,0,0,0,0,0,0,0,0,0,0,0,0
20200312,049283,滬深2X中信95購10,0.40,0.40,0.40,0.40,-0.19,-32.2,10000,1,4000,0,0,0,0,0,0,0,10000,-10000,-10000
20200312,049284,瑞昱中信94購02,,,,,0.00,0.00,0,0,0,0,0,0,0,0,0,0,0,0,0
20200312,049285,宏碁兆豐94購01,,,,,0.00,0.00,0,0,0,0,0,0,0,0,0,0,0,0,0
20200312,049286,美律兆豐94購01,,,,,0.00,0.00,0,0,0,0,0,0,0,0,0,0,0,0,0
20200312,049287,可成兆豐95購01,0.06,0.06,0.05,0.05,-0.10,-66.67,20000,2,1100,0,0,0,0,0,0,0,20000,-20000,-20000
20200312,049288,聯茂兆豐95購02,0.16,0.16,0.12,0.12,-0.18,-60.0,56000,6,7300,0,0,0,0,0,0,12000,44000,-32000,-32000
20200312,049289,樺漢兆豐94購01,,,,,0.00,0.00,0,0,0,0,0,0,0,0,0,0,0,0,0
20200312,04928P,大立光凱基95售07,0.90,0.98,0.90,0.98,0.00,0.00,15000,2,13900,0,0,0,0,0,0,0,15000,-15000,-15000
20200312,049290,元油2X群益94購02,,,,,0.00,0.00,0,0,0,0,0,0,0,0,0,0,0,0,0
20200312,049291,華通群益94購04,0.59,0.62,0.58,0.62,-0.36,-36.73,22000,13,12990,0,0,0,0,0,0,22000,0,22000,22000
20200312,049292,鴻海群益94購04,2.09,2.09,1.73,1.73,0.00,0.00,40000,6,75750,0,0,0,0,0,0,0,40000,-40000,-40000
20200312,049293,友訊群益95購01,0.47,0.49,0.31,0.31,-0.19,-38.0,833000,20,334170,0,0,0,0,0,0,535000,297000,238000,238000
20200312,049294,南亞科群益94購01,,,,,0.00,0.00,0,0,0,0,0,0,0,0,0,0,0,0,0
20200312,049295,全新群益94購02,,,,,0.00,0.00,0,0,0,0,0,0,0,0,0,0,0,0,0
20200312,049296,義隆群益96購01,,,,,0.00,0.00,0,0,0,0,0,0,0,0,0,0,0,0,0
20200312,049297,日電貿群益95購01,0.74,0.74,0.52,0.52,-0.64,-55.17,10000,2,6300,0,0,0,0,0,0,0,10000,-10000,-10000
20200312,049298,矽格群益95購01,1.66,1.66,1.27,1.27,-0.56,-30.6,198000,8,295960,0,0,0,0,0,0,178000,86000,92000,92000
20200312,049299,矽創群益94購01,0.05,0.05,0.05,0.05,0.00,0.00,60000,2,3000,0,0,0,0,0,0,60000,0,60000,60000
20200312,04929P,同欣電凱基95售01,0.93,1.08,0.93,1.07,+0.19,21.59,98000,9,98890,0,0,0,0,0,0,47000,31000,16000,16000
20200312,049300,南電群益94購01,,,,,0.00,0.00,0,0,0,0,0,0,0,0,0,0,0,0,0
20200312,049301,致新群益95購01,0.05,0.05,0.05,0.05,0.00,0.00,499000,2,24950,0,0,0,0,0,0,0,499000,-499000,-499000
20200312,049302,聯茂日盛94購01,,,,,0.00,0.00,0,0,0,0,0,0,0,0,0,0,0,0,0
20200312,049303,S&P反1凱基94購02,,,,,0.00,0.00,0,0,0,0,0,0,0,0,0,0,0,0,0
20200312,049304,元油2X凱基95購05,,,,,0.00,0.00,0,0,0,0,0,0,0,0,0,0,0,0,0
20200312,049305,元油2X凱基95購06,,,,,0.00,0.00,0,0,0,0,0,0,0,0,0,0,0,0,0
20200312,049306,元油2X凱基96購01,,,,,0.00,0.00,0,0,0,0,0,0,0,0,0,0,0,0,0
20200312,049307,上銀凱基94購03,,,,,0.00,0.00,0,0,0,0,0,0,0,0,0,0,0,0,0
20200312,049308,台達電凱基94購04,0.29,0.29,0.29,0.29,-0.09,-23.68,10000,1,2900,0,0,0,0,0,0,10000,0,10000,10000
20200312,049309,台達電凱基94購05,,,,,0.00,0.00,0,0,0,0,0,0,0,0,0,0,0,0,0
20200312,04930P,國巨統一94售08,0.21,0.65,0.21,0.65,+0.44,209.52,1576000,43,442530,0,0,0,0,0,0,1516000,26000,1490000,1490000
20200312,049310,台積電凱基94購15,0.65,0.65,0.25,0.46,-0.55,-54.46,384000,38,173080,0,0,0,0,0,0,80000,304000,-224000,-224000
20200312,049311,漢唐凱基94購03,,,,,0.00,0.00,0,0,0,0,0,0,0,0,0,0,0,0,0
20200312,049312,亞光凱基94購02,,,,,0.00,0.00,0,0,0,0,0,0,0,0,0,0,0,0,0
20200312,049313,晶技凱基94購01,3.63,3.63,2.75,2.75,-0.93,-25.27,198000,29,680070,0,0,0,0,0,0,178000,23000,155000,155000
20200312,049314,京鼎凱基94購01,1.67,1.67,1.19,1.39,-1.17,-45.7,67000,6,99530,0,0,0,0,0,0,20000,47000,-27000,-27000
20200312,049315,上緯控凱基94購03,,,,,0.00,0.00,0,0,0,0,0,0,0,0,0,0,0,0,0
20200312,049316,茂林凱基94購02,1.03,1.03,0.50,0.52,-0.64,-55.17,65000,7,53500,0,0,0,0,0,0,15000,50000,-35000,-35000
20200312,049317,啟碁凱基94購02,,,,,0.00,0.00,0,0,0,0,0,0,0,0,0,0,0,0,0
20200312,049318,樺漢凱基94購01,,,,,0.00,0.00,0,0,0,0,0,0,0,0,0,0,0,0,0
20200312,049319,GIS凱基94購03,0.10,0.10,0.10,0.10,-0.09,-47.37,10000,1,1000,0,0,0,0,0,0,0,10000,-10000,-10000
20200312,04931P,臻鼎元富94售09,2.80,2.82,2.80,2.82,+0.79,38.92,20000,2,56200,0,0,0,0,0,0,10000,10000,0,0
20200312,049320,羅麗芬凱基94購01,0.01,0.01,0.01,0.01,0.00,0.00,36000,1,360,0,0,0,0,0,0,36000,0,36000,36000
20200312,049321,緯穎凱基94購02,8.00,8.00,8.00,8.00,0.00,0.00,10000,1,80000,0,0,0,0,0,0,0,10000,-10000,-10000
20200312,049322,志超凱基94購02,,,,,0.00,0.00,0,0,0,0,0,0,0,0,0,0,0,0,0
20200312,049323,百和凱基94購01,,,,,0.00,0.00,0,0,0,0,0,0,0,0,0,0,0,0,0
20200312,049324,臺股指凱基94購06,,,,,0.00,0.00,0,0,0,0,0,0,0,0,0,0,0,0,0
20200312,049325,智邦元富94購02,0.08,0.08,0.08,0.08,-0.10,-55.56,67000,2,5360,0,0,0,0,0,0,67000,7000,60000,60000
20200312,049326,聯發科元富94購01,,,,,0.00,0.00,0,0,0,0,0,0,0,0,0,0,0,0,0
20200312,049327,台郡元富94購01,,,,,0.00,0.00,0,0,0,0,0,0,0,0,0,0,0,0,0
20200312,049328,元上證統一94購01,,,,,0.00,0.00,0,0,0,0,0,0,0,0,0,0,0,0,0
20200312,049329,元上證統一94購02,,,,,0.00,0.00,0,0,0,0,0,0,0,0,0,0,0,0,0
20200312,04932P,香港2X中信96售01,1.29,1.54,1.29,1.48,+0.28,23.33,302000,16,436310,0,0,0,0,0,0,210000,92000,118000,118000
20200312,049330,元上證統一94購03,,,,,0.00,0.00,0,0,0,0,0,0,0,0,0,0,0,0,0
20200312,049331,元石油統一94購01,,,,,0.00,0.00,0,0,0,0,0,0,0,0,0,0,0,0,0
20200312,049332,深中小統一94購02,,,,,0.00,0.00,0,0,0,0,0,0,0,0,0,0,0,0,0
20200312,049333,深中小統一94購03,,,,,0.00,0.00,0,0,0,0,0,0,0,0,0,0,0,0,0
20200312,049334,上銀統一94購01,,,,,0.00,0.00,0,0,0,0,0,0,0,0,0,0,0,0,0
20200312,049335,聯電統一97購01,1.35,1.45,1.35,1.41,-0.43,-23.37,70000,7,98400,0,0,0,0,0,0,10000,60000,-50000,-50000
20200312,049336,台達電統一94購02,0.75,0.75,0.75,0.75,-0.29,-27.88,10000,1,7500,0,0,0,0,0,0,10000,0,10000,10000
20200312,049337,台達電統一94購03,0.57,0.57,0.49,0.49,-0.20,-28.99,30000,2,16300,0,0,0,0,0,0,20000,10000,10000,10000
20200312,049338,台達電統一94購04,0.46,0.46,0.37,0.37,-0.32,-46.38,85000,5,36450,0,0,0,0,0,0,60000,25000,35000,35000
20200312,049339,鴻海統一94購02,,,,,0.00,0.00,0,0,0,0,0,0,0,0,0,0,0,0,0
20200312,04933P,中石化中信96售01,1.39,1.53,1.39,1.53,+0.19,14.18,178000,8,253230,0,0,0,0,0,0,62000,116000,-54000,-54000
20200312,049340,鴻海統一94購03,1.52,1.52,1.01,1.01,-1.17,-53.67,100000,2,126500,0,0,0,0,0,0,50000,50000,0,0
20200312,049341,旺宏統一95購01,0.36,0.36,0.25,0.25,-0.22,-46.81,110000,5,31700,0,0,0,0,0,0,70000,40000,30000,30000
20200312,049342,聯發科統一94購05,,,,,0.00,0.00,0,0,0,0,0,0,0,0,0,0,0,0,0
20200312,049343,華新科統一94購03,,,,,0.00,0.00,0,0,0,0,0,0,0,0,0,0,0,0,0
20200312,049344,華固統一94購01,1.73,1.88,1.69,1.88,+0.24,14.63,69000,7,119970,0,0,0,0,0,0,49000,20000,29000,29000
20200312,049345,富邦金統一94購02,0.50,0.50,0.38,0.38,-0.20,-34.48,100000,3,45200,0,0,0,0,0,0,50000,50000,0,0
20200312,049346,新光金統一95購01,0.39,0.40,0.37,0.37,-0.20,-35.09,41000,5,15690,0,0,0,0,0,0,0,41000,-41000,-41000
20200312,049347,群創統一95購01,,,,,0.00,0.00,0,0,0,0,0,0,0,0,0,0,0,0,0
20200312,049348,瑞昱台新94購01,,,,,0.00,0.00,0,0,0,0,0,0,0,0,0,0,0,0,0
20200312,049349,國巨康和94購01,,,,,0.00,0.00,0,0,0,0,0,0,0,0,0,0,0,0,0
20200312,04934P,鴻海中信94售05,0.73,0.73,0.73,0.73,+0.22,43.14,30000,1,21900,0,0,0,0,0,0,30000,0,30000,30000
20200312,049350,麗豐康和94購01,,,,,0.00,0.00,0,0,0,0,0,0,0,0,0,0,0,0,0
20200312,049351,揚明光永豐94購01,,,,,0.00,0.00,0,0,0,0,0,0,0,0,0,0,0,0,0
20200312,049352,泰鼎永豐95購01,,,,,0.00,0.00,0,0,0,0,0,0,0,0,0,0,0,0,0
20200312,049353,茂林永豐94購03,,,,,0.00,0.00,0,0,0,0,0,0,0,0,0,0,0,0,0
20200312,049354,致新永豐94購01,,,,,0.00,0.00,0,0,0,0,0,0,0,0,0,0,0,0,0
20200312,049355,元油2X富邦96購04,,,,,0.00,0.00,0,0,0,0,0,0,0,0,0,0,0,0,0
20200312,049356,台積電富邦94購05,,,,,0.00,0.00,0,0,0,0,0,0,0,0,0,0,0,0,0
20200312,049357,微星富邦94購01,,,,,0.00,0.00,0,0,0,0,0,0,0,0,0,0,0,0,0
20200312,049358,可成富邦94購01,,,,,0.00,0.00,0,0,0,0,0,0,0,0,0,0,0,0,0
20200312,049359,台達電元大94購06,0.73,0.73,0.73,0.73,-0.32,-30.48,10000,1,7300,0,0,0,0,0,0,10000,0,10000,10000
20200312,04935P,鴻海中信96售01,0.58,0.78,0.58,0.74,+0.22,42.31,514000,26,357790,0,0,0,0,0,0,467000,47000,420000,420000
20200312,049360,台達電元大94購07,1.11,1.11,0.89,0.97,-0.51,-34.46,300000,3,297000,0,0,0,0,0,0,100000,200000,-100000,-100000
20200312,049361,華通元大94購02,0.41,0.41,0.16,0.16,-0.32,-66.67,158000,5,34940,0,0,0,0,0,0,158000,8000,150000,150000
20200312,049362,國巨元大94購04,,,,,0.00,0.00,0,0,0,0,0,0,0,0,0,0,0,0,0
20200312,049363,旺宏元大94購07,0.15,0.15,0.07,0.07,0.00,0.00,183000,5,20190,0,0,0,0,0,0,103000,80000,23000,23000
20200312,049364,燿華元大94購02,,,,,0.00,0.00,0,0,0,0,0,0,0,0,0,0,0,0,0
20200312,049365,美律元大94購04,,,,,0.00,0.00,0,0,0,0,0,0,0,0,0,0,0,0,0
20200312,049366,聯發科元大94購05,,,,,0.00,0.00,0,0,0,0,0,0,0,0,0,0,0,0,0
20200312,049367,全新元大96購01,0.09,0.09,0.09,0.09,-0.06,-40.0,1514000,12,136260,0,0,0,0,0,0,1514000,0,1514000,1514000
20200312,049368,奇力新元大94購02,,,,,0.00,0.00,0,0,0,0,0,0,0,0,0,0,0,0,0
20200312,049369,義隆元大95購01,0.19,0.19,0.19,0.19,-0.04,-17.39,20000,1,3800,0,0,0,0,0,0,0,20000,-20000,-20000
20200312,04936P,大立光中信95售03,0.72,0.76,0.71,0.76,+0.36,90.0,319000,3,241540,0,0,0,0,0,0,299000,20000,279000,279000
20200312,049370,可成元大94購03,,,,,0.00,0.00,0,0,0,0,0,0,0,0,0,0,0,0,0
20200312,049371,可成元大94購04,,,,,0.00,0.00,0,0,0,0,0,0,0,0,0,0,0,0,0
20200312,049372,華新科元大95購04,0.25,0.26,0.10,0.17,-0.23,-57.5,255000,19,51320,0,0,0,0,0,0,100000,103000,-3000,-3000
20200312,049373,大立光元大94購11,,,,,0.00,0.00,0,0,0,0,0,0,0,0,0,0,0,0,0
20200312,049374,大立光元大94購12,0.06,0.06,0.06,0.06,-0.44,-88.0,30000,2,1800,0,0,0,0,0,0,30000,0,30000,30000
20200312,049375,大立光元大94購13,,,,,0.00,0.00,0,0,0,0,0,0,0,0,0,0,0,0,0
20200312,049376,奇鋐元大94購02,,,,,0.00,0.00,0,0,0,0,0,0,0,0,0,0,0,0,0
20200312,049377,聯詠元大94購01,0.82,0.82,0.82,0.82,-0.45,-35.43,10000,1,8200,0,0,0,0,0,0,10000,0,10000,10000
20200312,049378,聯詠元大94購02,0.90,0.95,0.90,0.95,-0.62,-39.49,25000,2,23400,0,0,0,0,0,0,25000,0,25000,25000
20200312,049379,智原元大95購01,,,,,0.00,0.00,0,0,0,0,0,0,0,0,0,0,0,0,0
20200312,049380,欣興元大94購04,,,,,0.00,0.00,0,0,0,0,0,0,0,0,0,0,0,0,0
20200312,049381,欣興元大94購05,,,,,0.00,0.00,0,0,0,0,0,0,0,0,0,0,0,0,0
20200312,049382,牧德元大94購04,1.00,1.00,0.80,0.80,0.00,0.00,6000,2,5400,0,0,0,0,0,0,0,6000,-6000,-6000
20200312,049383,健策元大95購01,,,,,0.00,0.00,0,0,0,0,0,0,0,0,0,0,0,0,0
20200312,049384,致伸元大94購02,,,,,0.00,0.00,0,0,0,0,0,0,0,0,0,0,0,0,0
20200312,049385,茂林元大94購03,2.23,2.23,1.22,1.33,-0.99,-42.67,174000,8,242650,0,0,0,0,0,0,97000,77000,20000,20000
20200312,049386,嘉聯益元大95購01,0.07,0.07,0.07,0.07,-0.08,-53.33,20000,2,1400,0,0,0,0,0,0,20000,0,20000,20000
20200312,049387,緯穎元大94購03,6.05,6.05,4.42,4.42,0.00,0.00,90000,5,450200,0,0,0,0,0,0,0,90000,-90000,-90000
20200312,049388,南電元大94購05,0.26,0.26,0.26,0.26,-0.28,-51.85,14000,3,3640,0,0,0,0,0,0,14000,0,14000,14000
20200312,049389,元石油中信97購02,0.06,0.06,0.04,0.05,-0.04,-44.44,1273000,25,66550,0,0,0,0,0,0,0,0,0,0
20200312,04938P,亞德客國票95售01,0.96,1.33,0.96,1.33,+0.45,51.14,82000,7,87020,0,0,0,0,0,0,82000,0,82000,82000
20200312,049390,元油2X中信96購01,,,,,0.00,0.00,0,0,0,0,0,0,0,0,0,0,0,0,0
20200312,049391,廣宇中信94購01,,,,,0.00,0.00,0,0,0,0,0,0,0,0,0,0,0,0,0
20200312,049392,臺股指麥證94購01,,,,,0.00,0.00,0,0,0,0,0,0,0,0,0,0,0,0,0
20200312,049393,世紀鋼第一94購01,,,,,0.00,0.00,0,0,0,0,0,0,0,0,0,0,0,0,0
20200312,049394,T50反1群益94購01,0.24,0.50,0.24,0.47,0.00,0.00,620000,34,236000,0,0,0,0,0,0,620000,270000,350000,350000
20200312,049395,元油2X群益94購03,,,,,0.00,0.00,0,0,0,0,0,0,0,0,0,0,0,0,0
20200312,049396,元油2X群益97購03,,,,,0.00,0.00,0,0,0,0,0,0,0,0,0,0,0,0,0
20200312,049397,台達電群益94購03,,,,,0.00,0.00,0,0,0,0,0,0,0,0,0,0,0,0,0
20200312,049398,微星群益94購02,0.52,0.52,0.52,0.52,-0.23,-30.67,10000,1,5200,0,0,0,0,0,0,0,10000,-10000,-10000
20200312,049399,台光電群益94購02,,,,,0.00,0.00,0,0,0,0,0,0,0,0,0,0,0,0,0
20200312,04939P,國巨國票95售03,0.65,1.13,0.65,1.11,+0.45,68.18,344000,28,311100,0,0,0,0,0,0,259000,85000,174000,174000
20200312,049400,可成群益94購03,,,,,0.00,0.00,0,0,0,0,0,0,0,0,0,0,0,0,0
20200312,049401,可成群益94購04,,,,,0.00,0.00,0,0,0,0,0,0,0,0,0,0,0,0,0
20200312,049402,奇鋐群益95購02,,,,,0.00,0.00,0,0,0,0,0,0,0,0,0,0,0,0,0
20200312,049403,欣興群益94購03,,,,,0.00,0.00,0,0,0,0,0,0,0,0,0,0,0,0,0
20200312,049404,訊芯群益94購02,,,,,0.00,0.00,0,0,0,0,0,0,0,0,0,0,0,0,0
20200312,049405,羅麗芬群益94購02,,,,,0.00,0.00,0,0,0,0,0,0,0,0,0,0,0,0,0
20200312,049406,T50反1日盛97購01,0.42,0.72,0.42,0.69,+0.32,86.49,557000,43,364440,0,0,0,0,0,0,445000,300000,145000,145000
20200312,049407,台積電日盛94購02,0.29,0.29,0.13,0.24,-0.32,-57.14,459000,34,85660,0,0,0,0,0,0,20000,379000,-359000,-359000
20200312,049408,旺宏日盛94購01,,,,,0.00,0.00,0,0,0,0,0,0,0,0,0,0,0,0,0
20200312,049409,滬深2X凱基96購04,,,,,0.00,0.00,0,0,0,0,0,0,0,0,0,0,0,0,0
20200312,04940P,台積電國票95售02,0.90,1.06,0.90,0.98,+0.22,28.95,378000,6,367800,0,0,0,0,0,0,300000,78000,222000,222000
20200312,049410,統一凱基94購02,,,,,0.00,0.00,0,0,0,0,0,0,0,0,0,0,0,0,0
20200312,049411,大成鋼凱基94購01,,,,,0.00,0.00,0,0,0,0,0,0,0,0,0,0,0,0,0
20200312,049412,為升凱基94購01,,,,,0.00,0.00,0,0,0,0,0,0,0,0,0,0,0,0,0
20200312,049413,台達電凱基94購06,,,,,0.00,0.00,0,0,0,0,0,0,0,0,0,0,0,0,0
20200312,049414,台積電凱基94購18,,,,,0.00,0.00,0,0,0,0,0,0,0,0,0,0,0,0,0
20200312,049415,智邦凱基94購02,,,,,0.00,0.00,0,0,0,0,0,0,0,0,0,0,0,0,0
20200312,049416,美律凱基94購04,,,,,0.00,0.00,0,0,0,0,0,0,0,0,0,0,0,0,0
20200312,049417,奇力新凱基94購02,0.35,0.35,0.17,0.17,-0.31,-64.58,174000,21,47090,0,0,0,0,0,0,124000,50000,74000,74000
20200312,049418,大立光凱基94購05,,,,,0.00,0.00,0,0,0,0,0,0,0,0,0,0,0,0,0
20200312,049419,欣興凱基94購04,,,,,0.00,0.00,0,0,0,0,0,0,0,0,0,0,0,0,0
20200312,04941P,台達電台新94售02,0.64,0.71,0.64,0.71,0.00,0.00,11000,3,7360,0,0,0,0,0,0,5000,6000,-1000,-1000
20200312,049420,日電貿凱基94購01,,,,,0.00,0.00,0,0,0,0,0,0,0,0,0,0,0,0,0
20200312,049421,鎧勝凱基94購02,,,,,0.00,0.00,0,0,0,0,0,0,0,0,0,0,0,0,0
20200312,049422,矽創凱基94購01,,,,,0.00,0.00,0,0,0,0,0,0,0,0,0,0,0,0,0
20200312,049423,臺股指凱基95購02,,,,,0.00,0.00,0,0,0,0,0,0,0,0,0,0,0,0,0
20200312,049424,中石化兆豐94購01,,,,,0.00,0.00,0,0,0,0,0,0,0,0,0,0,0,0,0
20200312,049425,喬山兆豐95購01,0.04,0.04,0.02,0.02,-0.04,-66.67,350000,11,9900,0,0,0,0,0,0,270000,30000,240000,240000
20200312,049426,為升兆豐95購01,,,,,0.00,0.00,0,0,0,0,0,0,0,0,0,0,0,0,0
20200312,049427,瑞昱兆豐94購01,,,,,0.00,0.00,0,0,0,0,0,0,0,0,0,0,0,0,0
20200312,049428,力山國票94購02,,,,,0.00,0.00,0,0,0,0,0,0,0,0,0,0,0,0,0
20200312,049429,國巨國票95購01,,,,,0.00,0.00,0,0,0,0,0,0,0,0,0,0,0,0,0
20200312,04942P,台積電台新94售01,,,,,0.00,0.00,0,0,0,0,0,0,0,0,0,0,0,0,0
20200312,049430,國巨國票95購02,5.45,5.45,3.03,3.03,-5.27,-63.49,39000,8,164220,0,0,0,0,0,0,10000,29000,-19000,-19000
20200312,049431,光罩國票96購01,0.15,0.17,0.14,0.14,-0.12,-46.15,339000,5,51860,0,0,0,0,0,0,319000,20000,299000,299000
20200312,049432,聯詠國票95購01,0.21,0.21,0.19,0.19,-0.21,-52.5,47000,7,9730,0,0,0,0,0,0,47000,0,47000,47000
20200312,049433,健策國票95購03,1.94,1.94,1.78,1.78,0.00,0.00,77000,4,147600,0,0,0,0,0,0,0,77000,-77000,-77000
20200312,049434,茂林國票95購01,2.01,2.01,0.93,0.94,-1.72,-64.66,165000,16,218610,0,0,0,0,0,0,22000,143000,-121000,-121000
20200312,049435,S&P反1國泰96購01,0.59,0.59,0.59,0.59,0.00,0.00,21000,1,12390,0,0,0,0,0,0,21000,0,21000,21000
20200312,049436,義隆國泰96購02,0.67,0.67,0.51,0.58,-0.16,-21.62,67000,11,43490,0,0,0,0,0,0,65000,2000,63000,63000
20200312,049437,可成國泰96購01,0.12,0.12,0.11,0.11,-0.14,-56.0,68000,3,7980,0,0,0,0,0,0,0,68000,-68000,-68000
20200312,049438,嘉晶國泰96購01,0.93,1.03,0.77,0.80,-0.20,-20.0,1238000,53,1106180,0,2000,-2000,0,0,0,348000,890000,-542000,-544000
20200312,049439,牧德國泰96購01,1.70,1.70,1.37,1.37,-0.94,-40.69,56000,4,80250,0,0,0,0,0,0,26000,56000,-30000,-30000
20200312,04943P,臻鼎康和94售01,,,,,0.00,0.00,0,0,0,0,0,0,0,0,0,0,0,0,0
20200312,049440,T50反1統一94購04,0.90,1.02,0.89,1.02,+0.25,32.47,37000,5,33390,0,0,0,0,0,0,37000,0,37000,37000
20200312,049441,T50反1統一94購05,0.82,0.84,0.82,0.84,+0.28,50.0,177000,2,145680,0,0,0,0,0,0,177000,0,177000,177000
20200312,049442,滬深2X統一99購01,,,,,0.00,0.00,0,0,0,0,0,0,0,0,0,0,0,0,0
20200312,049443,元石油統一94購02,,,,,0.00,0.00,0,0,0,0,0,0,0,0,0,0,0,0,0
20200312,049444,元石油統一94購03,,,,,0.00,0.00,0,0,0,0,0,0,0,0,0,0,0,0,0
20200312,049445,遠東新統一94購01,,,,,0.00,0.00,0,0,0,0,0,0,0,0,0,0,0,0,0
20200312,049446,為升統一94購01,,,,,0.00,0.00,0,0,0,0,0,0,0,0,0,0,0,0,0
20200312,049447,聯電統一94購01,1.05,1.05,1.05,1.05,0.00,0.00,3000,1,3150,0,0,0,0,0,0,0,3000,-3000,-3000
20200312,049448,光磊統一94購01,,,,,0.00,0.00,0,0,0,0,0,0,0,0,0,0,0,0,0
20200312,049449,宏碁統一94購01,,,,,0.00,0.00,0,0,0,0,0,0,0,0,0,0,0,0,0
20200312,04944P,元油2X永豐94售06,9.35,9.35,9.35,9.35,+1.10,13.33,211000,1,1972850,0,0,0,0,0,0,211000,211000,0,0
20200312,049450,友達統一94購02,,,,,0.00,0.00,0,0,0,0,0,0,0,0,0,0,0,0,0
20200312,049451,富邦金統一94購03,,,,,0.00,0.00,0,0,0,0,0,0,0,0,0,0,0,0,0
20200312,049452,新光金統一94購02,,,,,0.00,0.00,0,0,0,0,0,0,0,0,0,0,0,0,0
20200312,049453,新日興統一94購01,1.15,1.15,0.75,0.75,-0.55,-42.31,35000,4,32250,0,0,0,0,0,0,10000,25000,-15000,-15000
20200312,049454,群創統一94購01,,,,,0.00,0.00,0,0,0,0,0,0,0,0,0,0,0,0,0
20200312,049455,上海銀統一94購02,,,,,0.00,0.00,0,0,0,0,0,0,0,0,0,0,0,0,0
20200312,049456,上海銀統一94購03,,,,,0.00,0.00,0,0,0,0,0,0,0,0,0,0,0,0,0
20200312,049457,彩晶統一94購02,,,,,0.00,0.00,0,0,0,0,0,0,0,0,0,0,0,0,0
20200312,049458,SP黃豆元富96購01,,,,,0.00,0.00,0,0,0,0,0,0,0,0,0,0,0,0,0
20200312,049459,全新元富95購02,,,,,0.00,0.00,0,0,0,0,0,0,0,0,0,0,0,0,0
20200312,04945P,鴻海永豐94售06,0.16,0.26,0.16,0.26,+0.12,85.71,90000,2,22400,0,0,0,0,0,0,10000,80000,-70000,-70000
20200312,049460,宏達電元富94購01,,,,,0.00,0.00,0,0,0,0,0,0,0,0,0,0,0,0,0
20200312,049461,嘉聯益元富94購01,,,,,0.00,0.00,0,0,0,0,0,0,0,0,0,0,0,0,0
20200312,049462,康友元富94購01,,,,,0.00,0.00,0,0,0,0,0,0,0,0,0,0,0,0,0
20200312,049463,華新科富邦97購01,0.70,0.70,0.51,0.51,-0.33,-39.29,554000,48,331310,0,0,0,0,0,0,85000,469000,-384000,-384000
20200312,049464,燿華台新95購01,,,,,0.00,0.00,0,0,0,0,0,0,0,0,0,0,0,0,0
20200312,049465,美律台新94購01,,,,,0.00,0.00,0,0,0,0,0,0,0,0,0,0,0,0,0
20200312,049466,創意台新94購01,,,,,0.00,0.00,0,0,0,0,0,0,0,0,0,0,0,0,0
20200312,049467,致伸台新94購01,,,,,0.00,0.00,0,0,0,0,0,0,0,0,0,0,0,0,0
20200312,049468,楠梓電康和94購01,,,,,0.00,0.00,0,0,0,0,0,0,0,0,0,0,0,0,0
20200312,049469,元金2X永豐94購01,,,,,0.00,0.00,0,0,0,0,0,0,0,0,0,0,0,0,0
20200312,04946P,華通元大94售04,0.70,0.94,0.70,0.91,+0.26,40.0,390000,6,312700,0,0,0,0,0,0,390000,0,390000,390000
20200312,049470,楠梓電永豐94購03,,,,,0.00,0.00,0,0,0,0,0,0,0,0,0,0,0,0,0
20200312,049471,楠梓電永豐94購04,,,,,0.00,0.00,0,0,0,0,0,0,0,0,0,0,0,0,0
20200312,049472,楠梓電永豐95購01,0.01,0.01,0.01,0.01,-0.01,-50.0,80000,8,800,0,0,0,0,0,0,0,80000,-80000,-80000
20200312,049473,光罩永豐94購03,0.02,0.09,0.02,0.09,0.00,0.00,298000,4,25650,0,0,0,0,0,0,0,21000,-21000,-21000
20200312,049474,台光電永豐94購02,,,,,0.00,0.00,0,0,0,0,0,0,0,0,0,0,0,0,0
20200312,049475,高鐵永豐94購01,,,,,0.00,0.00,0,0,0,0,0,0,0,0,0,0,0,0,0
20200312,049476,美食永豐94購02,,,,,0.00,0.00,0,0,0,0,0,0,0,0,0,0,0,0,0
20200312,049477,泰鼎永豐94購01,,,,,0.00,0.00,0,0,0,0,0,0,0,0,0,0,0,0,0
20200312,049478,祥碩永豐94購02,,,,,0.00,0.00,0,0,0,0,0,0,0,0,0,0,0,0,0
20200312,049479,矽格永豐94購01,,,,,0.00,0.00,0,0,0,0,0,0,0,0,0,0,0,0,0
20200312,04947P,聯詠元大94售05,1.48,1.76,1.48,1.71,0.00,0.00,394000,11,645990,0,0,0,0,0,0,0,394000,-394000,-394000
20200312,049480,同欣電永豐94購01,,,,,0.00,0.00,0,0,0,0,0,0,0,0,0,0,0,0,0
20200312,049481,為升元大94購03,,,,,0.00,0.00,0,0,0,0,0,0,0,0,0,0,0,0,0
20200312,049482,國巨元大94購06,,,,,0.00,0.00,0,0,0,0,0,0,0,0,0,0,0,0,0
20200312,049483,台積電元大94購12,,,,,0.00,0.00,0,0,0,0,0,0,0,0,0,0,0,0,0
20200312,049484,台積電元大95購02,2.46,2.46,2.02,2.18,-0.64,-22.7,219000,56,493620,0,0,0,0,0,0,185000,204000,-19000,-19000
20200312,049485,台積電元大96購03,3.00,3.00,2.16,2.60,-0.72,-21.69,416000,90,1119740,0,0,0,0,0,0,271000,377000,-106000,-106000
20200312,049486,旺宏元大94購08,0.26,0.26,0.14,0.14,-0.41,-74.55,62000,4,9680,0,0,0,0,0,0,56000,6000,50000,50000
20200312,049487,智邦元大94購03,0.41,0.41,0.28,0.30,-0.18,-37.5,466000,8,143340,0,0,0,0,0,0,68000,398000,-330000,-330000
20200312,049488,智邦元大95購01,0.38,0.38,0.38,0.38,-0.09,-19.15,20000,1,7600,0,0,0,0,0,0,20000,0,20000,20000
20200312,049489,美律元大94購05,,,,,0.00,0.00,0,0,0,0,0,0,0,0,0,0,0,0,0
20200312,04948P,瑞儀元大94售03,3.11,3.11,3.11,3.11,0.00,0.00,7000,1,21770,0,0,0,0,0,0,7000,0,7000,7000
20200312,049490,京元電元大95購02,0.81,0.81,0.49,0.61,-0.31,-33.7,114000,10,79950,0,0,0,0,0,0,88000,28000,60000,60000
20200312,049491,聯發科元大95購01,0.37,0.37,0.17,0.17,-0.29,-63.04,2853000,72,801960,0,0,0,0,0,0,939000,1893000,-954000,-954000
20200312,049492,聯發科元大95購02,0.42,0.42,0.22,0.22,-0.46,-67.65,134000,8,47280,0,0,0,0,0,0,14000,118000,-104000,-104000
20200312,049493,可成元大94購05,,,,,0.00,0.00,0,0,0,0,0,0,0,0,0,0,0,0,0
20200312,049494,華新科元大95購05,0.99,0.99,0.99,0.99,-0.15,-13.16,72000,1,71280,0,0,0,0,0,0,0,72000,-72000,-72000
20200312,049495,欣興元大94購06,,,,,0.00,0.00,0,0,0,0,0,0,0,0,0,0,0,0,0
20200312,049496,和鑫元大95購01,,,,,0.00,0.00,0,0,0,0,0,0,0,0,0,0,0,0,0
20200312,049497,茂林元大94購04,0.88,0.88,0.83,0.83,-1.28,-60.66,30000,2,25900,0,0,0,0,0,0,0,30000,-30000,-30000
20200312,049498,茂林元大95購01,1.72,1.72,1.19,1.19,-1.61,-57.5,84000,2,126460,0,0,0,0,0,0,0,84000,-84000,-84000
20200312,049499,康控元大96購01,0.13,0.13,0.13,0.13,-0.17,-56.67,68000,1,8840,0,0,0,0,0,0,68000,0,68000,68000
20200312,04949P,致新元大94售04,0.82,0.99,0.82,0.97,+0.22,29.33,451000,9,410870,0,0,0,0,0,0,31000,420000,-389000,-389000
20200312,049500,聯茂元大94購04,,,,,0.00,0.00,0,0,0,0,0,0,0,0,0,0,0,0,0
20200312,049501,台郡元大95購01,1.34,1.34,1.06,1.12,-1.00,-47.17,67000,6,76880,0,0,0,0,0,0,2000,67000,-65000,-65000
20200312,049502,訊芯元大94購01,,,,,0.00,0.00,0,0,0,0,0,0,0,0,0,0,0,0,0
20200312,049503,矽創元大94購01,0.02,0.02,0.02,0.02,0.00,0.00,50000,1,1000,0,0,0,0,0,0,50000,0,50000,50000
20200312,049504,臺股指元大94購15,0.44,0.44,0.18,0.22,-0.48,-68.57,264000,19,63890,0,0,0,0,0,0,46000,218000,-172000,-172000
20200312,049505,臺股指元大94購16,1.05,1.05,0.39,0.47,-1.08,-69.68,343000,21,194590,0,0,0,0,0,0,51000,292000,-241000,-241000
20200312,049506,可成日盛94購02,,,,,0.00,0.00,0,0,0,0,0,0,0,0,0,0,0,0,0
20200312,049507,和大凱基94購01,,,,,0.00,0.00,0,0,0,0,0,0,0,0,0,0,0,0,0
20200312,049508,上銀凱基94購04,0.88,0.88,0.88,0.88,-0.31,-26.05,10000,1,8800,0,0,0,0,0,0,10000,0,10000,10000
20200312,049509,台達電凱基94購07,,,,,0.00,0.00,0,0,0,0,0,0,0,0,0,0,0,0,0
20200312,04950P,上証2X中信96售02,0.35,0.40,0.35,0.37,+0.05,15.62,795000,15,295900,0,0,0,0,0,0,310000,485000,-175000,-175000
20200312,049510,楠梓電凱基94購01,,,,,0.00,0.00,0,0,0,0,0,0,0,0,0,0,0,0,0
20200312,049511,奇力新凱基94購03,0.81,0.81,0.48,0.48,-0.42,-46.67,13000,2,9540,0,0,0,0,0,0,13000,3000,10000,10000
20200312,049512,可成凱基94購06,,,,,0.00,0.00,0,0,0,0,0,0,0,0,0,0,0,0,0
20200312,049513,宏達電凱基94購03,0.10,0.10,0.10,0.10,0.00,0.00,1000,1,100,0,0,0,0,0,0,0,1000,-1000,-1000
20200312,049514,奇鋐凱基94購01,,,,,0.00,0.00,0,0,0,0,0,0,0,0,0,0,0,0,0
20200312,049515,同欣電凱基94購01,,,,,0.00,0.00,0,0,0,0,0,0,0,0,0,0,0,0,0
20200312,049516,光罩國票94購02,,,,,0.00,0.00,0,0,0,0,0,0,0,0,0,0,0,0,0
20200312,049517,台光電國票94購02,0.36,0.36,0.16,0.19,-0.30,-61.22,230000,8,50500,0,0,0,0,0,0,30000,200000,-170000,-170000
20200312,049518,宏達電國票95購02,0.05,0.05,0.03,0.03,-0.05,-62.5,349000,4,10870,0,0,0,0,0,0,0,349000,-349000,-349000
20200312,049519,新光金國票95購03,,,,,0.00,0.00,0,0,0,0,0,0,0,0,0,0,0,0,0
20200312,04951P,緯創中信94售01,0.60,0.81,0.60,0.80,+0.28,53.85,110000,5,76200,0,0,0,0,0,0,40000,70000,-30000,-30000
20200312,049520,TPK國票95購01,,,,,0.00,0.00,0,0,0,0,0,0,0,0,0,0,0,0,0
20200312,049521,致伸國票95購01,,,,,0.00,0.00,0,0,0,0,0,0,0,0,0,0,0,0,0
20200312,049522,華通兆豐94購02,0.16,0.16,0.15,0.16,-0.19,-54.29,29000,17,4500,0,0,0,0,0,0,29000,0,29000,29000
20200312,049523,微星兆豐94購02,,,,,0.00,0.00,0,0,0,0,0,0,0,0,0,0,0,0,0
20200312,049524,可成兆豐95購02,0.02,0.02,0.01,0.01,-0.01,-50.0,353000,28,6960,0,0,0,0,0,0,0,353000,-353000,-353000
20200312,049525,華新科兆豐94購01,0.24,0.24,0.23,0.23,-0.61,-72.62,100000,2,23500,0,0,0,0,0,0,0,100000,-100000,-100000
20200312,049526,緯穎兆豐95購01,,,,,0.00,0.00,0,0,0,0,0,0,0,0,0,0,0,0,0
20200312,049527,國巨中信95購01,2.11,2.14,1.20,1.20,-0.91,-43.13,276000,34,422970,0,0,0,0,0,0,97000,179000,-82000,-82000
20200312,049528,台積電中信94購01,0.40,0.42,0.26,0.34,-0.40,-54.05,177000,9,64390,0,0,0,0,0,0,30000,147000,-117000,-117000
20200312,049529,華新科中信95購01,0.45,0.45,0.20,0.24,-0.26,-52.0,352000,8,108270,0,0,0,0,0,0,62000,290000,-228000,-228000
20200312,04952P,台光電亞東94售01,,,,,0.00,0.00,0,0,0,0,0,0,0,0,0,0,0,0,0
20200312,049530,上銀台新94購01,,,,,0.00,0.00,0,0,0,0,0,0,0,0,0,0,0,0,0
20200312,049531,聯詠台新94購01,,,,,0.00,0.00,0,0,0,0,0,0,0,0,0,0,0,0,0
20200312,049532,同欣電台新94購01,0.05,0.05,0.05,0.05,0.00,0.00,30000,1,1500,0,0,0,0,0,0,30000,0,30000,30000
20200312,049533,美食永豐94購03,,,,,0.00,0.00,0,0,0,0,0,0,0,0,0,0,0,0,0
20200312,049534,華擎永豐94購02,,,,,0.00,0.00,0,0,0,0,0,0,0,0,0,0,0,0,0
20200312,049535,臻鼎永豐94購01,,,,,0.00,0.00,0,0,0,0,0,0,0,0,0,0,0,0,0
20200312,049536,T50反1群益94購02,0.31,0.47,0.31,0.47,0.00,0.00,60000,5,22900,0,0,0,0,0,0,50000,30000,20000,20000
20200312,049537,元石油群益97購01,0.05,0.05,0.04,0.05,-0.03,-37.5,268000,9,10780,0,0,0,0,0,0,0,0,0,0
20200312,049538,元油2X群益98購01,0.06,0.06,0.06,0.06,0.00,0.00,51000,5,3060,0,0,0,0,0,0,0,0,0,0
20200312,049539,元油2X群益9A購01,0.16,0.16,0.13,0.13,-0.03,-18.75,320000,12,41900,0,0,0,0,0,0,0,0,0,0
20200312,04953P,台積電群益94售13,1.37,2.04,1.35,2.04,+0.85,71.43,104000,7,151030,0,0,0,0,0,0,94000,60000,34000,34000
20200312,049540,楠梓電群益94購01,,,,,0.00,0.00,0,0,0,0,0,0,0,0,0,0,0,0,0
20200312,049541,楠梓電群益94購02,,,,,0.00,0.00,0,0,0,0,0,0,0,0,0,0,0,0,0
20200312,049542,鴻海群益94購05,,,,,0.00,0.00,0,0,0,0,0,0,0,0,0,0,0,0,0
20200312,049543,國巨群益94購04,,,,,0.00,0.00,0,0,0,0,0,0,0,0,0,0,0,0,0
20200312,049544,台積電群益94購08,1.65,1.65,1.06,1.34,-0.92,-40.71,45000,6,62200,0,0,0,0,0,0,10000,35000,-25000,-25000
20200312,049545,台積電群益94購09,,,,,0.00,0.00,0,0,0,0,0,0,0,0,0,0,0,0,0
20200312,049546,正崴群益94購01,,,,,0.00,0.00,0,0,0,0,0,0,0,0,0,0,0,0,0
20200312,049547,新光金群益94購01,0.12,0.12,0.12,0.12,-0.10,-45.45,120000,12,14400,0,0,0,0,0,0,10000,110000,-100000,-100000
20200312,049548,群創群益94購01,,,,,0.00,0.00,0,0,0,0,0,0,0,0,0,0,0,0,0
20200312,049549,瀚宇博群益94購01,,,,,0.00,0.00,0,0,0,0,0,0,0,0,0,0,0,0,0
20200312,04954P,健策國票96售01,0.59,0.67,0.59,0.66,0.00,0.00,2146000,13,1404270,0,0,0,0,0,0,0,2146000,-2146000,-2146000
20200312,049550,柏文群益94購01,,,,,0.00,0.00,0,0,0,0,0,0,0,0,0,0,0,0,0
20200312,049551,電子類群益94購01,0.66,0.66,0.37,0.37,-1.12,-75.17,98000,2,62360,0,0,0,0,0,0,90000,8000,82000,82000
20200312,049552,鴻海國泰96購01,1.57,1.57,1.21,1.25,-0.55,-30.56,444000,17,633220,0,0,0,0,0,0,292000,152000,140000,140000
20200312,049553,鴻海國泰96購02,1.65,1.70,1.34,1.35,-0.64,-32.16,310000,16,478060,0,0,0,0,0,0,107000,210000,-103000,-103000
20200312,049554,禾伸堂富邦96購01,0.37,0.46,0.34,0.46,-0.02,-4.17,195000,4,79100,0,0,0,0,0,0,90000,105000,-15000,-15000
20200312,049555,台表科富邦94購01,,,,,0.00,0.00,0,0,0,0,0,0,0,0,0,0,0,0,0
20200312,049556,智易元富94購01,,,,,0.00,0.00,0,0,0,0,0,0,0,0,0,0,0,0,0
20200312,049557,南電元富94購02,,,,,0.00,0.00,0,0,0,0,0,0,0,0,0,0,0,0,0
20200312,049558,深中小統一94購04,,,,,0.00,0.00,0,0,0,0,0,0,0,0,0,0,0,0,0
20200312,049559,香港反統一94購02,0.51,0.60,0.51,0.55,+0.21,61.76,67000,8,36450,0,0,0,0,0,0,0,67000,-67000,-67000
20200312,04955P,大立光日盛94售02,0.76,0.76,0.76,0.76,0.00,0.00,5000,1,3800,0,0,0,0,0,0,0,5000,-5000,-5000
20200312,049560,香港反統一95購01,0.52,0.52,0.52,0.52,0.00,0.00,2000,1,1040,0,0,0,0,0,0,2000,0,2000,2000
20200312,049561,道瓊銀統一96購01,,,,,0.00,0.00,0,0,0,0,0,0,0,0,0,0,0,0,0
20200312,049562,和大統一94購01,0.22,0.22,0.22,0.22,-0.41,-65.08,40000,1,8800,0,0,0,0,0,0,40000,0,40000,40000
20200312,049563,華新統一95購01,0.56,0.56,0.37,0.37,-0.28,-43.08,203000,11,85560,0,0,0,0,0,0,60000,143000,-83000,-83000
20200312,049564,聯電統一94購03,1.49,1.49,1.49,1.49,0.00,0.00,4000,1,5960,0,0,0,0,0,0,4000,0,4000,4000
20200312,049565,楠梓電統一94購01,,,,,0.00,0.00,0,0,0,0,0,0,0,0,0,0,0,0,0
20200312,049566,鴻海統一94購04,0.40,0.43,0.39,0.40,0.00,0.00,70000,7,28300,0,0,0,0,0,0,70000,70000,0,0
20200312,049567,鴻海統一94購05,,,,,0.00,0.00,0,0,0,0,0,0,0,0,0,0,0,0,0
20200312,049568,台積電統一94購08,,,,,0.00,0.00,0,0,0,0,0,0,0,0,0,0,0,0,0
20200312,049569,光磊統一94購02,0.23,0.23,0.13,0.14,-0.27,-65.85,30000,3,5000,0,0,0,0,0,0,0,30000,-30000,-30000
20200312,04956P,臺股指日盛94售02,10.30,10.30,10.30,10.30,0.00,0.00,19000,1,195700,0,0,0,0,0,0,19000,0,19000,19000
20200312,049570,華新科統一94購04,0.13,0.13,0.08,0.08,-0.22,-73.33,57000,2,7060,0,0,0,0,0,0,50000,7000,43000,43000
20200312,049571,華固統一94購02,2.42,2.48,2.42,2.48,+0.05,2.06,80000,6,194400,0,0,0,0,0,0,40000,40000,0,0
20200312,049572,華固統一94購03,,,,,0.00,0.00,0,0,0,0,0,0,0,0,0,0,0,0,0
20200312,049573,長榮航統一95購01,0.41,0.41,0.39,0.39,-0.10,-20.41,40000,3,15800,0,0,0,0,0,0,30000,10000,20000,20000
20200312,049574,新日興統一94購03,,,,,0.00,0.00,0,0,0,0,0,0,0,0,0,0,0,0,0
20200312,049575,美食康和94購02,,,,,0.00,0.00,0,0,0,0,0,0,0,0,0,0,0,0,0
20200312,049576,元油2X元大94購06,0.01,0.01,0.01,0.01,0.00,0.00,10000,10,100,0,0,0,0,0,0,0,0,0,0
20200312,049577,台達電元大94購08,0.58,0.58,0.58,0.58,-0.42,-42.0,20000,1,11600,0,0,0,0,0,0,20000,0,20000,20000
20200312,049578,台達電元大94購09,,,,,0.00,0.00,0,0,0,0,0,0,0,0,0,0,0,0,0
20200312,049579,鴻海元大94購06,,,,,0.00,0.00,0,0,0,0,0,0,0,0,0,0,0,0,0
20200312,04957P,上証2X凱基96售02,1.43,1.68,1.43,1.56,+0.22,16.42,27000,5,41890,0,0,0,0,0,0,21000,6000,15000,15000
20200312,049580,國巨元大94購07,,,,,0.00,0.00,0,0,0,0,0,0,0,0,0,0,0,0,0
20200312,049581,國巨元大94購08,,,,,0.00,0.00,0,0,0,0,0,0,0,0,0,0,0,0,0
20200312,049582,台積電元大95購03,1.60,1.63,1.20,1.36,-0.57,-29.53,381000,52,576600,0,0,0,0,0,0,127000,356000,-229000,-229000
20200312,049583,台積電元大95購04,0.75,0.77,0.40,0.61,-0.36,-37.11,855000,46,523150,0,0,0,0,0,0,190000,711000,-521000,-521000
20200312,049584,台積電元大96購04,1.22,1.22,1.00,1.06,-0.35,-24.82,594000,74,660100,0,0,0,0,0,0,256000,338000,-82000,-82000
20200312,049585,旺宏元大95購02,0.40,0.40,0.30,0.32,-0.36,-52.94,495000,10,168100,0,0,0,0,0,0,125000,370000,-245000,-245000
20200312,049586,正崴元大94購01,,,,,0.00,0.00,0,0,0,0,0,0,0,0,0,0,0,0,0
20200312,049587,美律元大95購01,0.20,0.20,0.17,0.17,-0.22,-56.41,260000,3,49000,0,0,0,0,0,0,0,260000,-260000,-260000
20200312,049588,聯發科元大94購06,0.11,0.13,0.11,0.12,-0.25,-67.57,325000,3,36350,0,0,0,0,0,0,270000,55000,215000,215000
20200312,049589,奇力新元大95購02,0.99,0.99,0.63,0.69,-0.42,-37.84,401000,15,291650,0,0,0,0,0,0,401000,351000,50000,50000
20200312,04958P,和大凱基94售04,1.83,1.83,1.75,1.77,+0.34,23.78,24000,12,42920,0,0,0,0,0,0,13000,11000,2000,2000
20200312,049590,華新科元大94購01,0.57,0.57,0.18,0.21,-0.52,-71.23,634000,11,225870,0,0,0,0,0,0,130000,504000,-374000,-374000
20200312,049591,開發金元大98購01,0.37,0.37,0.34,0.36,-0.12,-25.0,92000,4,33320,0,0,0,0,0,0,82000,10000,72000,72000
20200312,049592,欣興元大96購01,0.07,0.07,0.07,0.07,-0.10,-58.82,10000,1,700,0,0,0,0,0,0,0,10000,-10000,-10000
20200312,049593,群創元大9A購01,0.65,0.65,0.45,0.45,-0.26,-36.62,115000,5,56030,0,0,0,0,0,0,35000,83000,-48000,-48000
20200312,049594,揚明光元大95購01,,,,,0.00,0.00,0,0,0,0,0,0,0,0,0,0,0,0,0
20200312,049595,麗豐元大95購01,,,,,0.00,0.00,0,0,0,0,0,0,0,0,0,0,0,0,0
20200312,049596,智伸科元大95購01,,,,,0.00,0.00,0,0,0,0,0,0,0,0,0,0,0,0,0
20200312,049597,泰鼎元大96購01,,,,,0.00,0.00,0,0,0,0,0,0,0,0,0,0,0,0,0
20200312,049598,超眾元大95購03,0.12,0.12,0.11,0.11,-0.13,-54.17,80000,4,9400,0,0,0,0,0,0,0,80000,-80000,-80000
20200312,049599,樺漢元大95購01,1.00,1.00,0.66,0.68,-0.47,-40.87,337000,9,262550,0,0,0,0,0,0,134000,245000,-111000,-111000
20200312,04959P,可成凱基94售14,2.63,2.77,2.63,2.77,0.00,0.00,13000,2,34610,0,0,0,0,0,0,3000,10000,-7000,-7000
20200312,049600,緯穎元大95購02,2.64,2.64,2.64,2.64,0.00,0.00,20000,2,52800,0,0,0,0,0,0,0,20000,-20000,-20000
20200312,049601,矽創元大95購02,0.19,0.19,0.10,0.12,-0.14,-53.85,244000,7,36870,0,0,0,0,0,0,224000,20000,204000,204000
20200312,049602,南電元大95購01,0.56,0.56,0.43,0.44,-0.32,-42.11,203000,3,89420,0,0,0,0,0,0,203000,0,203000,203000
20200312,049603,富邦金亞東94購01,0.04,0.04,0.03,0.03,0.00,0.00,80000,2,3100,0,0,0,0,0,0,0,80000,-80000,-80000
20200312,049604,創意亞東94購02,,,,,0.00,0.00,0,0,0,0,0,0,0,0,0,0,0,0,0
20200312,049605,旺宏第一94購01,,,,,0.00,0.00,0,0,0,0,0,0,0,0,0,0,0,0,0
20200312,049606,可成第一94購01,,,,,0.00,0.00,0,0,0,0,0,0,0,0,0,0,0,0,0
20200312,049607,台積電兆豐94購04,0.22,0.22,0.11,0.22,-0.20,-47.62,247000,8,41180,0,0,0,0,0,0,15000,232000,-217000,-217000
20200312,049608,旺宏兆豐94購02,0.24,0.24,0.24,0.24,-0.36,-60.0,40000,4,9600,0,0,0,0,0,0,0,40000,-40000,-40000
20200312,049609,全新兆豐95購01,0.03,0.03,0.03,0.03,0.00,0.00,121000,2,3630,0,0,0,0,0,0,121000,0,121000,121000
20200312,04960P,大立光凱基96售04,,,,,0.00,0.00,0,0,0,0,0,0,0,0,0,0,0,0,0
20200312,049610,奇力新兆豐95購01,1.11,1.11,0.96,0.96,-0.43,-30.94,30000,2,31800,0,0,0,0,0,0,30000,10000,20000,20000
20200312,049611,緯穎兆豐95購02,,,,,0.00,0.00,0,0,0,0,0,0,0,0,0,0,0,0,0
20200312,049612,香港反中信96購01,0.71,0.79,0.71,0.79,+0.25,46.3,280000,13,211300,0,0,0,0,0,0,120000,250000,-130000,-130000
20200312,049613,華通中信94購01,0.91,0.91,0.49,0.49,-0.47,-48.96,148000,31,119450,0,0,0,0,0,0,108000,40000,68000,68000
20200312,049614,聯茂中信94購01,,,,,0.00,0.00,0,0,0,0,0,0,0,0,0,0,0,0,0
20200312,049615,香港2X群益98購01,0.23,0.23,0.19,0.20,-0.10,-33.33,297000,6,60800,0,0,0,0,0,0,0,297000,-297000,-297000
20200312,049616,卜蜂群益94購01,0.18,0.18,0.18,0.18,0.00,0.00,1000,1,180,0,0,0,0,0,0,1000,0,1000,1000
20200312,049617,光罩群益94購03,0.13,0.13,0.06,0.06,-0.16,-72.73,257000,13,23110,0,0,0,0,0,0,170000,87000,83000,83000
20200312,049618,美律群益94購03,0.11,0.11,0.11,0.11,-0.25,-69.44,2000,1,220,0,0,0,0,0,0,2000,0,2000,2000
20200312,049619,宏達電群益95購02,0.07,0.07,0.06,0.06,-0.07,-53.85,360000,4,21900,0,0,0,0,0,0,300000,60000,240000,240000
20200312,04961P,貿聯凱基94售03,1.39,1.60,1.39,1.60,+0.31,24.03,40000,4,60100,0,0,0,0,0,0,10000,30000,-20000,-20000
20200312,049620,美食群益94購01,,,,,0.00,0.00,0,0,0,0,0,0,0,0,0,0,0,0,0
20200312,049621,美食群益94購02,,,,,0.00,0.00,0,0,0,0,0,0,0,0,0,0,0,0,0
20200312,049622,聯詠群益94購02,0.59,0.59,0.43,0.49,-0.44,-47.31,145000,5,76250,0,0,0,0,0,0,30000,115000,-85000,-85000
20200312,049623,創意群益94購01,,,,,0.00,0.00,0,0,0,0,0,0,0,0,0,0,0,0,0
20200312,049624,嘉澤群益94購01,,,,,0.00,0.00,0,0,0,0,0,0,0,0,0,0,0,0,0
20200312,049625,智易群益95購01,0.25,0.25,0.14,0.14,-0.23,-62.16,446000,4,73000,0,0,0,0,0,0,248000,198000,50000,50000
20200312,049626,健策群益94購01,1.16,1.16,1.16,1.16,0.00,0.00,11000,1,12760,0,0,0,0,0,0,0,11000,-11000,-11000
20200312,049627,嘉聯益群益94購02,0.01,0.01,0.01,0.01,0.00,0.00,40000,2,400,0,0,0,0,0,0,40000,0,40000,40000
20200312,049628,臺股指群益94購01,,,,,0.00,0.00,0,0,0,0,0,0,0,0,0,0,0,0,0
20200312,049629,臺股指群益94購02,,,,,0.00,0.00,0,0,0,0,0,0,0,0,0,0,0,0,0
20200312,04962P,易華電凱基96售01,1.03,1.18,1.03,1.18,0.00,0.00,24000,4,26570,0,0,0,0,0,0,3000,21000,-18000,-18000
20200312,049630,臺股指群益94購03,2.27,2.27,2.27,2.27,-1.56,-40.73,1000,1,2270,0,0,0,0,0,0,1000,0,1000,1000
20200312,049631,臺股指群益94購04,1.23,1.23,1.08,1.10,0.00,0.00,96000,7,109130,0,0,0,0,0,0,0,96000,-96000,-96000
20200312,049632,臺股指群益94購05,1.20,1.20,1.20,1.20,0.00,0.00,1000,1,1200,0,0,0,0,0,0,0,1000,-1000,-1000
20200312,049633,臺股指群益94購06,,,,,0.00,0.00,0,0,0,0,0,0,0,0,0,0,0,0,0
20200312,049634,臺股指群益94購07,0.34,0.34,0.34,0.34,-1.00,-74.63,4000,1,1360,0,0,0,0,0,0,0,0,0,0
20200312,049635,臺股指群益94購08,0.04,0.04,0.04,0.04,-0.03,-42.86,9000,1,360,0,0,0,0,0,0,9000,0,9000,9000
20200312,049636,上証反凱基9A購01,0.49,0.54,0.49,0.52,+0.05,10.64,67000,8,35180,0,0,0,0,0,0,0,67000,-67000,-67000
20200312,049637,元石油凱基94購01,,,,,0.00,0.00,0,0,0,0,0,0,0,0,0,0,0,0,0
20200312,049638,A50反1凱基94購01,0.08,0.10,0.08,0.09,0.00,0.00,122000,4,11060,0,0,0,0,0,0,2000,10000,-8000,-8000
20200312,049639,力山凱基94購03,,,,,0.00,0.00,0,0,0,0,0,0,0,0,0,0,0,0,0
20200312,04963P,鴻海元大94售25,2.15,2.86,2.15,2.83,+0.93,48.95,731000,35,1827960,0,0,0,0,0,0,513000,241000,272000,272000
20200312,049640,大成鋼凱基94購02,,,,,0.00,0.00,0,0,0,0,0,0,0,0,0,0,0,0,0
20200312,049641,台達電凱基94購08,,,,,0.00,0.00,0,0,0,0,0,0,0,0,0,0,0,0,0
20200312,049642,鴻海凱基94購16,,,,,0.00,0.00,0,0,0,0,0,0,0,0,0,0,0,0,0
20200312,049643,華泰凱基94購01,,,,,0.00,0.00,0,0,0,0,0,0,0,0,0,0,0,0,0
20200312,049644,台積電凱基94購21,0.01,0.01,0.01,0.01,0.00,0.00,40000,1,400,0,0,0,0,0,0,40000,0,40000,40000
20200312,049645,台積電凱基94購22,,,,,0.00,0.00,0,0,0,0,0,0,0,0,0,0,0,0,0
20200312,049646,旺宏凱基94購01,0.22,0.22,0.10,0.10,-0.29,-74.36,190000,15,27560,0,0,0,0,0,0,144000,36000,108000,108000
20200312,049647,美食凱基94購01,,,,,0.00,0.00,0,0,0,0,0,0,0,0,0,0,0,0,0
20200312,049648,大立光凱基94購08,,,,,0.00,0.00,0,0,0,0,0,0,0,0,0,0,0,0,0
20200312,049649,信邦凱基94購01,,,,,0.00,0.00,0,0,0,0,0,0,0,0,0,0,0,0,0
20200312,04964P,鴻海元大94售26,2.08,2.64,2.08,2.64,+0.91,52.6,272000,7,671100,0,0,0,0,0,0,103000,172000,-69000,-69000
20200312,049650,啟碁凱基94購03,,,,,0.00,0.00,0,0,0,0,0,0,0,0,0,0,0,0,0
20200312,049651,訊芯凱基94購04,,,,,0.00,0.00,0,0,0,0,0,0,0,0,0,0,0,0,0
20200312,049652,GIS凱基94購05,,,,,0.00,0.00,0,0,0,0,0,0,0,0,0,0,0,0,0
20200312,049653,緯穎凱基94購03,3.69,3.69,2.73,2.73,-3.37,-55.25,88000,3,257950,0,0,0,0,0,0,69000,23000,46000,46000
20200312,049654,臺股指凱基94購15,,,,,0.00,0.00,0,0,0,0,0,0,0,0,0,0,0,0,0
20200312,049655,臺股指凱基94購16,,,,,0.00,0.00,0,0,0,0,0,0,0,0,0,0,0,0,0
20200312,049656,臺股指凱基94購17,0.81,0.81,0.60,0.60,-0.73,-54.89,295000,30,199150,0,0,0,0,0,0,200000,295000,-95000,-95000
20200312,049657,滬深2X台新94購01,,,,,0.00,0.00,0,0,0,0,0,0,0,0,0,0,0,0,0
20200312,049658,國巨台新95購01,1.86,1.86,1.55,1.55,-1.41,-47.64,62000,2,97340,0,0,0,0,0,0,4000,58000,-54000,-54000
20200312,049659,旺宏台新95購01,1.24,1.24,1.03,1.03,0.00,0.00,2000,2,2270,0,0,0,0,0,0,0,2000,-2000,-2000
20200312,04965P,日月光元大94售02,3.45,4.17,3.45,4.17,+1.27,43.79,85000,5,324130,0,0,0,0,0,0,10000,85000,-75000,-75000
20200312,049660,奇鋐台新94購01,,,,,0.00,0.00,0,0,0,0,0,0,0,0,0,0,0,0,0
20200312,049661,喬山永豐94購01,,,,,0.00,0.00,0,0,0,0,0,0,0,0,0,0,0,0,0
20200312,049662,燿華永豐95購02,,,,,0.00,0.00,0,0,0,0,0,0,0,0,0,0,0,0,0
20200312,049663,正崴永豐94購01,,,,,0.00,0.00,0,0,0,0,0,0,0,0,0,0,0,0,0
20200312,049664,聯發科永豐94購03,,,,,0.00,0.00,0,0,0,0,0,0,0,0,0,0,0,0,0
20200312,049665,TPK永昌95購01,,,,,0.00,0.00,0,0,0,0,0,0,0,0,0,0,0,0,0
20200312,049666,臺股指永昌94購01,,,,,0.00,0.00,0,0,0,0,0,0,0,0,0,0,0,0,0
20200312,049667,大立光國泰96購01,0.50,0.50,0.37,0.37,-0.41,-52.56,192000,14,82510,0,0,0,0,0,0,101000,91000,10000,10000
20200312,049668,大立光國泰96購02,0.66,0.66,0.43,0.44,-0.65,-59.63,1207000,23,619140,0,0,0,0,0,0,317000,990000,-673000,-673000
20200312,049669,訊芯國泰95購01,,,,,0.00,0.00,0,0,0,0,0,0,0,0,0,0,0,0,0
20200312,04966P,台表科元大94售04,0.62,0.85,0.62,0.85,+0.21,32.81,156000,3,111150,0,0,0,0,0,0,66000,90000,-24000,-24000
20200312,049670,鈺齊國泰96購01,1.03,1.03,1.03,1.03,0.00,0.00,91000,1,93730,0,0,0,0,0,0,91000,0,91000,91000
20200312,049671,上証2X富邦95購01,,,,,0.00,0.00,0,0,0,0,0,0,0,0,0,0,0,0,0
20200312,049672,臺股指富邦94購01,0.22,0.22,0.22,0.22,0.00,0.00,4000,1,880,0,0,0,0,0,0,4000,0,4000,4000
20200312,049673,臺股指富邦94購02,,,,,0.00,0.00,0,0,0,0,0,0,0,0,0,0,0,0,0
20200312,049674,國巨元富94購02,,,,,0.00,0.00,0,0,0,0,0,0,0,0,0,0,0,0,0
20200312,049675,台光電國票95購01,0.42,0.42,0.42,0.42,-0.19,-31.15,30000,1,12600,0,0,0,0,0,0,30000,0,30000,30000
20200312,049676,美食國票94購01,,,,,0.00,0.00,0,0,0,0,0,0,0,0,0,0,0,0,0
20200312,049677,臺股指國票94購10,2.47,2.47,1.53,1.53,-1.29,-45.74,60000,7,113200,0,0,0,0,0,0,20000,40000,-20000,-20000
20200312,049678,臺股指國票94購11,,,,,0.00,0.00,0,0,0,0,0,0,0,0,0,0,0,0,0
20200312,049679,臺股指國票94購12,,,,,0.00,0.00,0,0,0,0,0,0,0,0,0,0,0,0,0
20200312,04967P,台表科永豐94售04,0.62,0.82,0.62,0.80,+0.23,40.35,83000,7,65660,0,0,0,0,0,0,33000,50000,-17000,-17000
20200312,049680,臺股指國票94購13,,,,,0.00,0.00,0,0,0,0,0,0,0,0,0,0,0,0,0
20200312,049681,旺宏統一94購04,0.34,0.34,0.13,0.13,-0.38,-74.51,22000,3,4610,0,0,0,0,0,0,0,22000,-22000,-22000
20200312,049682,友達統一94購03,,,,,0.00,0.00,0,0,0,0,0,0,0,0,0,0,0,0,0
20200312,049683,美食統一94購01,,,,,0.00,0.00,0,0,0,0,0,0,0,0,0,0,0,0,0
20200312,049684,彩晶統一95購01,,,,,0.00,0.00,0,0,0,0,0,0,0,0,0,0,0,0,0
20200312,049685,T50反1元大94購01,0.42,0.67,0.42,0.67,+0.30,81.08,362000,14,208310,0,0,0,0,0,0,345000,25000,320000,320000
20200312,049686,T50反1元大94購02,,,,,0.00,0.00,0,0,0,0,0,0,0,0,0,0,0,0,0
20200312,049687,國巨元大94購09,,,,,0.00,0.00,0,0,0,0,0,0,0,0,0,0,0,0,0
20200312,049688,台光電元大94購04,0.61,0.61,0.33,0.33,-0.36,-52.17,85000,6,47860,0,0,0,0,0,0,10000,75000,-65000,-65000
20200312,049689,正崴元大94購02,,,,,0.00,0.00,0,0,0,0,0,0,0,0,0,0,0,0,0
20200312,04968P,台積電富邦94售06,,,,,0.00,0.00,0,0,0,0,0,0,0,0,0,0,0,0,0
20200312,049690,義隆元大95購02,0.20,0.20,0.20,0.20,-0.11,-35.48,60000,2,12000,0,0,0,0,0,0,30000,30000,0,0
20200312,049691,可成元大94購06,,,,,0.00,0.00,0,0,0,0,0,0,0,0,0,0,0,0,0
20200312,049692,可成元大94購07,,,,,0.00,0.00,0,0,0,0,0,0,0,0,0,0,0,0,0
20200312,049693,可成元大94購08,,,,,0.00,0.00,0,0,0,0,0,0,0,0,0,0,0,0,0
20200312,049694,華新科元大95購06,1.06,1.06,0.62,0.62,-0.45,-42.06,541000,22,421000,0,0,0,0,0,0,324000,517000,-193000,-193000
20200312,049695,新光金元大9A購01,0.47,0.47,0.46,0.46,-0.07,-13.21,102000,2,47330,0,0,0,0,0,0,102000,0,102000,102000
20200312,049696,欣興元大95購02,,,,,0.00,0.00,0,0,0,0,0,0,0,0,0,0,0,0,0
20200312,049697,群創元大98購01,,,,,0.00,0.00,0,0,0,0,0,0,0,0,0,0,0,0,0
20200312,049698,TPK元大95購01,,,,,0.00,0.00,0,0,0,0,0,0,0,0,0,0,0,0,0
20200312,049699,祥碩元大94購01,,,,,0.00,0.00,0,0,0,0,0,0,0,0,0,0,0,0,0
20200312,04969P,道瓊銀統一94售02,,,,,0.00,0.00,0,0,0,0,0,0,0,0,0,0,0,0,0
20200312,049700,瀚宇博元大97購01,1.64,1.64,1.23,1.29,-0.46,-26.29,43000,6,60270,0,0,0,0,0,0,19000,29000,-10000,-10000
20200312,049701,聯茂元大94購05,0.10,0.10,0.10,0.10,-0.28,-73.68,7000,1,700,0,0,0,0,0,0,0,7000,-7000,-7000
20200312,049702,台表科元大95購03,,,,,0.00,0.00,0,0,0,0,0,0,0,0,0,0,0,0,0
20200312,049703,訊芯元大95購01,,,,,0.00,0.00,0,0,0,0,0,0,0,0,0,0,0,0,0
20200312,049704,羅麗芬元大95購01,0.03,0.03,0.03,0.03,-0.03,-50.0,270000,3,8100,0,0,0,0,0,0,270000,0,270000,270000
20200312,049705,緯穎元大94購05,4.50,4.50,4.50,4.50,0.00,0.00,30000,1,135000,0,0,0,0,0,0,0,30000,-30000,-30000
20200312,049706,世紀鋼元大95購02,0.76,0.76,0.64,0.64,-0.17,-20.99,613000,24,415190,0,0,0,0,0,0,413000,200000,213000,213000
20200312,049707,華通麥證94購02,,,,,0.00,0.00,0,0,0,0,0,0,0,0,0,0,0,0,0
20200312,049708,滬深2X凱基94購02,0.17,0.18,0.15,0.18,-0.11,-37.93,203000,3,32580,0,0,0,0,0,0,0,203000,-203000,-203000
20200312,049709,力山凱基94購04,,,,,0.00,0.00,0,0,0,0,0,0,0,0,0,0,0,0,0
20200312,04970P,中環元富94售02,,,,,0.00,0.00,0,0,0,0,0,0,0,0,0,0,0,0,0
20200312,049710,大成鋼凱基94購03,,,,,0.00,0.00,0,0,0,0,0,0,0,0,0,0,0,0,0
20200312,049711,劍麟凱基94購01,,,,,0.00,0.00,0,0,0,0,0,0,0,0,0,0,0,0,0
20200312,049712,為升凱基94購03,,,,,0.00,0.00,0,0,0,0,0,0,0,0,0,0,0,0,0
20200312,049713,鴻海凱基94購17,1.20,1.20,0.93,0.93,-1.02,-52.31,490000,11,511600,0,0,0,0,0,0,450000,480000,-30000,-30000
20200312,049714,國巨凱基94購02,1.84,1.84,0.98,0.98,-0.97,-49.74,17000,3,29160,0,0,0,0,0,0,10000,7000,3000,3000
20200312,049715,華泰凱基94購02,,,,,0.00,0.00,0,0,0,0,0,0,0,0,0,0,0,0,0
20200312,049716,台積電凱基94購24,0.31,0.31,0.21,0.21,-0.47,-69.12,211000,2,45410,0,0,0,0,0,0,11000,200000,-189000,-189000
20200312,049717,微星凱基94購01,,,,,0.00,0.00,0,0,0,0,0,0,0,0,0,0,0,0,0
20200312,049718,南亞科凱基94購04,,,,,0.00,0.00,0,0,0,0,0,0,0,0,0,0,0,0,0
20200312,049719,義隆凱基94購03,,,,,0.00,0.00,0,0,0,0,0,0,0,0,0,0,0,0,0
20200312,04971P,矽力元富94售02,0.33,0.37,0.31,0.35,+0.11,45.83,108000,7,35480,0,0,0,0,0,0,10000,98000,-88000,-88000
20200312,049720,欣興凱基94購05,0.10,0.10,0.10,0.10,-0.01,-9.09,4000,1,400,0,0,0,0,0,0,0,4000,-4000,-4000
20200312,049721,晶技凱基94購02,2.21,2.22,0.99,0.99,-1.14,-53.52,384000,55,597370,0,0,0,0,0,0,143000,248000,-105000,-105000
20200312,049722,易華電凱基94購03,,,,,0.00,0.00,0,0,0,0,0,0,0,0,0,0,0,0,0
20200312,049723,緯穎凱基94購04,,,,,0.00,0.00,0,0,0,0,0,0,0,0,0,0,0,0,0
20200312,049724,南電第一94購01,,,,,0.00,0.00,0,0,0,0,0,0,0,0,0,0,0,0,0
20200312,049725,台郡國票94購03,0.41,0.41,0.27,0.31,-0.77,-71.3,12000,7,4220,0,0,0,0,0,0,12000,0,12000,12000
20200312,049726,道瓊反中信96購01,1.49,1.94,1.49,1.84,+0.62,50.82,109000,13,174890,0,0,0,0,0,0,43000,66000,-23000,-23000
20200312,049727,台積電中信94購02,0.14,0.24,0.14,0.24,-0.33,-57.89,47000,4,9380,0,0,0,0,0,0,0,47000,-47000,-47000
20200312,049728,正崴中信94購01,,,,,0.00,0.00,0,0,0,0,0,0,0,0,0,0,0,0,0
20200312,049729,日月光中信94購01,,,,,0.00,0.00,0,0,0,0,0,0,0,0,0,0,0,0,0
20200312,04972P,緯穎元富94售03,,,,,0.00,0.00,0,0,0,0,0,0,0,0,0,0,0,0,0
20200312,049730,滬深2X群益94購02,,,,,0.00,0.00,0,0,0,0,0,0,0,0,0,0,0,0,0
20200312,049731,A50正2群益94購02,,,,,0.00,0.00,0,0,0,0,0,0,0,0,0,0,0,0,0
20200312,049732,國巨群益94購05,2.40,2.40,1.87,1.87,-0.49,-20.76,34000,3,79480,0,0,0,0,0,0,34000,0,34000,34000
20200312,049733,旺宏群益94購03,,,,,0.00,0.00,0,0,0,0,0,0,0,0,0,0,0,0,0
20200312,049734,瑞昱群益94購02,,,,,0.00,0.00,0,0,0,0,0,0,0,0,0,0,0,0,0
20200312,049735,台光電群益94購03,0.34,0.34,0.21,0.21,-0.28,-57.14,420000,7,107820,0,0,0,0,0,0,21000,399000,-378000,-378000
20200312,049736,宏達電群益95購03,0.03,0.03,0.03,0.03,-0.03,-50.0,160000,4,4800,0,0,0,0,0,0,0,160000,-160000,-160000
20200312,049737,美食群益94購03,,,,,0.00,0.00,0,0,0,0,0,0,0,0,0,0,0,0,0
20200312,049738,神基群益94購01,0.30,0.39,0.30,0.39,-0.08,-17.02,118000,7,39730,0,0,0,0,0,0,67000,51000,16000,16000
20200312,049739,大立光群益94購05,,,,,0.00,0.00,0,0,0,0,0,0,0,0,0,0,0,0,0
20200312,04973P,台積電凱基94售41,,,,,0.00,0.00,0,0,0,0,0,0,0,0,0,0,0,0,0
20200312,049740,禾伸堂群益94購01,,,,,0.00,0.00,0,0,0,0,0,0,0,0,0,0,0,0,0
20200312,049741,創意群益94購02,,,,,0.00,0.00,0,0,0,0,0,0,0,0,0,0,0,0,0
20200312,049742,日月光群益94購02,,,,,0.00,0.00,0,0,0,0,0,0,0,0,0,0,0,0,0
20200312,049743,全新台新94購01,,,,,0.00,0.00,0,0,0,0,0,0,0,0,0,0,0,0,0
20200312,049744,亞德客永豐94購01,0.11,0.11,0.11,0.11,0.00,0.00,2000,1,220,0,0,0,0,0,0,0,2000,-2000,-2000
20200312,049745,國巨永豐94購04,0.29,0.31,0.11,0.16,-0.23,-58.97,3446000,73,586680,0,0,0,0,0,0,1301000,1970000,-669000,-669000
20200312,049746,全新永豐95購01,,,,,0.00,0.00,0,0,0,0,0,0,0,0,0,0,0,0,0
20200312,049747,嘉晶永豐94購02,,,,,0.00,0.00,0,0,0,0,0,0,0,0,0,0,0,0,0
20200312,049748,智原永豐94購01,,,,,0.00,0.00,0,0,0,0,0,0,0,0,0,0,0,0,0
20200312,049749,創意永豐94購01,,,,,0.00,0.00,0,0,0,0,0,0,0,0,0,0,0,0,0
20200312,04974P,聯發科凱基96售02,2.40,2.54,2.40,2.54,0.00,0.00,60000,2,150720,0,0,0,0,0,0,0,60000,-60000,-60000
20200312,049750,揚明光永豐94購02,,,,,0.00,0.00,0,0,0,0,0,0,0,0,0,0,0,0,0
20200312,049751,牧德永豐95購01,0.92,0.92,0.74,0.74,0.00,0.00,40000,4,33400,0,0,0,0,0,0,10000,30000,-20000,-20000
20200312,049752,上緯控永豐94購02,,,,,0.00,0.00,0,0,0,0,0,0,0,0,0,0,0,0,0
20200312,049753,傳奇永豐94購01,,,,,0.00,0.00,0,0,0,0,0,0,0,0,0,0,0,0,0
20200312,049754,豐祥永豐94購01,,,,,0.00,0.00,0,0,0,0,0,0,0,0,0,0,0,0,0
20200312,049755,中磊永豐94購02,,,,,0.00,0.00,0,0,0,0,0,0,0,0,0,0,0,0,0
20200312,049756,瀚宇博永豐94購01,,,,,0.00,0.00,0,0,0,0,0,0,0,0,0,0,0,0,0
20200312,049757,聯茂永豐94購01,,,,,0.00,0.00,0,0,0,0,0,0,0,0,0,0,0,0,0
20200312,049758,GIS永豐94購01,,,,,0.00,0.00,0,0,0,0,0,0,0,0,0,0,0,0,0
20200312,049759,元黃金富邦9A購01,3.14,3.15,2.98,2.98,-0.23,-7.17,45000,11,140530,0,0,0,0,0,0,0,45000,-45000,-45000
20200312,04975P,華新科凱基96售02,0.78,1.13,0.78,1.13,+0.39,52.7,303000,9,264590,0,0,0,0,0,0,268000,165000,103000,103000
20200312,049760,滬深2X國泰95購02,,,,,0.00,0.00,0,0,0,0,0,0,0,0,0,0,0,0,0
20200312,049761,亞德客國泰95購03,1.81,1.81,1.81,1.81,-1.51,-45.48,5000,1,9050,0,0,0,0,0,0,0,5000,-5000,-5000
20200312,049762,華邦電國泰95購01,0.36,0.36,0.17,0.17,-0.28,-62.22,334000,13,84510,0,0,0,0,0,0,165000,169000,-4000,-4000
20200312,049763,美食國泰96購01,,,,,0.00,0.00,0,0,0,0,0,0,0,0,0,0,0,0,0
20200312,049764,TPK國泰95購01,,,,,0.00,0.00,0,0,0,0,0,0,0,0,0,0,0,0,0
20200312,049765,上証2X元富94購01,,,,,0.00,0.00,0,0,0,0,0,0,0,0,0,0,0,0,0
20200312,049766,滬深2X元富94購02,0.46,0.46,0.29,0.33,-0.20,-37.74,234000,27,83020,0,0,0,0,0,0,7000,227000,-220000,-220000
20200312,049767,奇力新元富94購01,,,,,0.00,0.00,0,0,0,0,0,0,0,0,0,0,0,0,0
20200312,049768,奇鋐元富94購01,,,,,0.00,0.00,0,0,0,0,0,0,0,0,0,0,0,0,0
20200312,049769,和鑫元富96購01,0.08,0.08,0.08,0.08,0.00,0.00,16000,2,1280,0,0,0,0,0,0,0,16000,-16000,-16000
20200312,04976P,中磊凱基94售01,1.25,1.32,1.25,1.32,0.00,0.00,68000,5,86840,0,0,0,0,0,0,0,68000,-68000,-68000
20200312,049770,康控元富95購01,,,,,0.00,0.00,0,0,0,0,0,0,0,0,0,0,0,0,0
20200312,049771,GIS元富94購02,,,,,0.00,0.00,0,0,0,0,0,0,0,0,0,0,0,0,0
20200312,049772,臺股指元富94購01,,,,,0.00,0.00,0,0,0,0,0,0,0,0,0,0,0,0,0
20200312,049773,臺股指元富94購02,,,,,0.00,0.00,0,0,0,0,0,0,0,0,0,0,0,0,0
20200312,049774,元油2X統一94購05,,,,,0.00,0.00,0,0,0,0,0,0,0,0,0,0,0,0,0
20200312,049775,旺宏統一95購02,0.59,0.59,0.40,0.40,-0.54,-57.45,118000,3,62320,0,0,0,0,0,0,0,118000,-118000,-118000
20200312,049776,全新統一95購02,,,,,0.00,0.00,0,0,0,0,0,0,0,0,0,0,0,0,0
20200312,049777,華新科統一94購06,,,,,0.00,0.00,0,0,0,0,0,0,0,0,0,0,0,0,0
20200312,049778,宏達電統一94購02,0.10,0.11,0.08,0.10,-0.05,-33.33,55000,4,5150,0,0,0,0,0,0,40000,15000,25000,25000
20200312,049779,創意統一95購01,,,,,0.00,0.00,0,0,0,0,0,0,0,0,0,0,0,0,0
20200312,04977P,力成凱基96售01,0.63,0.83,0.63,0.83,+0.26,45.61,328000,10,227090,0,0,0,0,0,0,208000,120000,88000,88000
20200312,049780,智易統一94購02,,,,,0.00,0.00,0,0,0,0,0,0,0,0,0,0,0,0,0
20200312,049781,台表科統一94購01,,,,,0.00,0.00,0,0,0,0,0,0,0,0,0,0,0,0,0
20200312,049782,世紀鋼統一94購01,0.61,0.61,0.55,0.55,-0.12,-17.91,44000,3,26200,0,0,0,0,0,0,44000,0,44000,44000
20200312,049783,元油2X兆豐95購01,,,,,0.00,0.00,0,0,0,0,0,0,0,0,0,0,0,0,0
20200312,049784,台積電兆豐94購05,,,,,0.00,0.00,0,0,0,0,0,0,0,0,0,0,0,0,0
20200312,049785,華新科兆豐95購01,0.17,0.17,0.07,0.08,-0.12,-60.0,583000,14,70610,0,0,0,0,0,0,220000,313000,-93000,-93000
20200312,049786,奇鋐兆豐94購01,,,,,0.00,0.00,0,0,0,0,0,0,0,0,0,0,0,0,0
20200312,049787,麗豐兆豐94購01,,,,,0.00,0.00,0,0,0,0,0,0,0,0,0,0,0,0,0
20200312,049788,智伸科兆豐95購01,,,,,0.00,0.00,0,0,0,0,0,0,0,0,0,0,0,0,0
20200312,049789,世紀鋼兆豐94購01,0.66,0.66,0.46,0.46,-0.27,-36.99,330000,8,173160,0,0,0,0,0,0,330000,0,330000,330000
20200312,04978P,台表科凱基94售02,1.02,1.11,1.02,1.08,+0.12,12.5,135000,8,144170,0,0,0,0,0,0,135000,0,135000,135000
20200312,049790,滬深2X元大97購04,0.14,0.14,0.14,0.14,0.00,0.00,60000,1,8400,0,0,0,0,0,0,60000,0,60000,60000
20200312,049791,元油2X元大94購07,,,,,0.00,0.00,0,0,0,0,0,0,0,0,0,0,0,0,0
20200312,049792,元油2X元大94購08,,,,,0.00,0.00,0,0,0,0,0,0,0,0,0,0,0,0,0
20200312,049793,為升元大94購04,,,,,0.00,0.00,0,0,0,0,0,0,0,0,0,0,0,0,0
20200312,049794,台達電元大94購10,0.40,0.40,0.40,0.40,-0.16,-28.57,30000,1,12000,0,0,0,0,0,0,30000,0,30000,30000
20200312,049795,華通元大96購02,0.31,0.31,0.19,0.19,-0.19,-50.0,116000,6,23810,0,0,0,0,0,0,61000,56000,5000,5000
20200312,049796,國巨元大94購10,2.00,2.17,2.00,2.17,-1.78,-45.06,60000,2,125100,0,0,0,0,0,0,60000,60000,0,0
20200312,049797,台積電元大94購17,0.61,0.61,0.37,0.57,-0.65,-53.28,475000,15,247400,0,0,0,0,0,0,200000,475000,-275000,-275000
20200312,049798,台積電元大94購18,0.32,0.32,0.17,0.24,-0.19,-44.19,783000,27,209300,0,0,0,0,0,0,202000,581000,-379000,-379000
20200312,049799,旺宏元大96購01,0.58,0.58,0.51,0.51,-0.42,-45.16,370000,5,202400,0,0,0,0,0,0,0,370000,-370000,-370000
20200312,04979P,臺股指凱基96售07,1.36,2.46,1.36,2.25,+1.03,84.43,1051000,35,1925720,0,0,0,0,0,0,925000,126000,799000,799000
20200312,049800,瑞昱元大94購05,0.55,0.55,0.22,0.30,-0.56,-65.12,150000,5,53520,0,0,0,0,0,0,60000,90000,-30000,-30000
20200312,049801,可成元大94購09,,,,,0.00,0.00,0,0,0,0,0,0,0,0,0,0,0,0,0
20200312,049802,可成元大94購10,,,,,0.00,0.00,0,0,0,0,0,0,0,0,0,0,0,0,0
20200312,049803,華新科元大95購07,0.80,0.80,0.48,0.48,-0.34,-41.46,667000,30,376050,0,0,0,0,0,0,435000,604000,-169000,-169000
20200312,049804,華固元大94購01,0.52,0.61,0.50,0.61,+0.03,5.17,944000,19,513260,0,0,0,0,0,0,458000,700000,-242000,-242000
20200312,049805,美食元大94購02,,,,,0.00,0.00,0,0,0,0,0,0,0,0,0,0,0,0,0
20200312,049806,臺企銀元大94購01,,,,,0.00,0.00,0,0,0,0,0,0,0,0,0,0,0,0,0
20200312,049807,新光金元大96購02,,,,,0.00,0.00,0,0,0,0,0,0,0,0,0,0,0,0,0
20200312,049808,聯詠元大94購03,1.31,1.31,1.31,1.31,-0.67,-33.84,3000,1,3930,0,0,0,0,0,0,3000,0,3000,3000
20200312,049809,聯詠元大94購04,1.25,1.25,1.19,1.19,-0.77,-39.29,101000,2,120250,0,0,0,0,0,0,1000,100000,-99000,-99000
20200312,04980P,臺股指凱基96售08,1.25,2.06,1.18,1.82,+0.73,66.97,5832000,312,8560090,0,0,0,0,0,0,3614000,1546000,2068000,2068000
20200312,049810,欣興元大95購03,,,,,0.00,0.00,0,0,0,0,0,0,0,0,0,0,0,0,0
20200312,049811,聯鈞元大94購01,,,,,0.00,0.00,0,0,0,0,0,0,0,0,0,0,0,0,0
20200312,049812,致伸元大94購03,,,,,0.00,0.00,0,0,0,0,0,0,0,0,0,0,0,0,0
20200312,049813,康控元大96購02,,,,,0.00,0.00,0,0,0,0,0,0,0,0,0,0,0,0,0
20200312,049814,超眾元大95購04,,,,,0.00,0.00,0,0,0,0,0,0,0,0,0,0,0,0,0
20200312,049815,緯穎元大94購06,,,,,0.00,0.00,0,0,0,0,0,0,0,0,0,0,0,0,0
20200312,049816,緯穎元大94購07,,,,,0.00,0.00,0,0,0,0,0,0,0,0,0,0,0,0,0
20200312,049817,南電元大94購07,0.15,0.15,0.15,0.15,-0.46,-75.41,7000,1,1050,0,0,0,0,0,0,0,7000,-7000,-7000
20200312,049818,柏文元大94購01,,,,,0.00,0.00,0,0,0,0,0,0,0,0,0,0,0,0,0
20200312,049819,百和元大94購02,,,,,0.00,0.00,0,0,0,0,0,0,0,0,0,0,0,0,0
20200312,04981P,華新科亞東94售01,,,,,0.00,0.00,0,0,0,0,0,0,0,0,0,0,0,0,0
20200312,049820,世紀鋼元大96購03,0.91,0.95,0.81,0.89,-0.15,-14.42,299000,10,272760,0,0,0,0,0,0,253000,40000,213000,213000
20200312,049821,中石化凱基94購02,,,,,0.00,0.00,0,0,0,0,0,0,0,0,0,0,0,0,0
20200312,049822,大成鋼凱基94購04,,,,,0.00,0.00,0,0,0,0,0,0,0,0,0,0,0,0,0
20200312,049823,為升凱基94購04,,,,,0.00,0.00,0,0,0,0,0,0,0,0,0,0,0,0,0
20200312,049824,鴻海凱基94購18,,,,,0.00,0.00,0,0,0,0,0,0,0,0,0,0,0,0,0
20200312,049825,台積電凱基94購26,,,,,0.00,0.00,0,0,0,0,0,0,0,0,0,0,0,0,0
20200312,049826,光磊凱基94購02,,,,,0.00,0.00,0,0,0,0,0,0,0,0,0,0,0,0,0
20200312,049827,正崴凱基94購01,,,,,0.00,0.00,0,0,0,0,0,0,0,0,0,0,0,0,0
20200312,049828,華新科凱基94購06,0.17,0.17,0.17,0.17,-0.08,-32.0,20000,2,3400,0,0,0,0,0,0,20000,0,20000,20000
20200312,049829,裕民凱基94購01,,,,,0.00,0.00,0,0,0,0,0,0,0,0,0,0,0,0,0
20200312,04982P,臺股指中信94售03,1.18,1.92,1.18,1.60,+0.59,58.42,164000,15,277820,0,0,0,0,0,0,157000,7000,150000,150000
20200312,049830,智易凱基94購02,,,,,0.00,0.00,0,0,0,0,0,0,0,0,0,0,0,0,0
20200312,049831,日月光凱基94購01,,,,,0.00,0.00,0,0,0,0,0,0,0,0,0,0,0,0,0
20200312,049832,麗豐凱基94購05,,,,,0.00,0.00,0,0,0,0,0,0,0,0,0,0,0,0,0
20200312,049833,正文凱基94購05,0.17,0.17,0.11,0.11,-0.10,-47.62,255000,4,31350,0,0,0,0,0,0,55000,200000,-145000,-145000
20200312,049834,康控凱基94購01,,,,,0.00,0.00,0,0,0,0,0,0,0,0,0,0,0,0,0
20200312,049835,緯穎凱基94購05,3.17,3.17,3.17,3.17,0.00,0.00,5000,1,15850,0,0,0,0,0,0,5000,5000,0,0
20200312,049836,矽創凱基94購02,,,,,0.00,0.00,0,0,0,0,0,0,0,0,0,0,0,0,0
20200312,049837,臺股指凱基96購02,0.03,0.03,0.03,0.03,-0.07,-70.0,200000,20,6000,0,0,0,0,0,0,0,200000,-200000,-200000
20200312,049838,友達亞東94購01,,,,,0.00,0.00,0,0,0,0,0,0,0,0,0,0,0,0,0
20200312,049839,聯發科亞東94購02,,,,,0.00,0.00,0,0,0,0,0,0,0,0,0,0,0,0,0
20200312,04983P,臺股指康和94售03,1.56,1.98,1.56,1.98,+0.87,78.38,60000,2,97800,0,0,0,0,0,0,60000,10000,50000,50000
20200312,049840,亞光亞東94購01,0.11,0.11,0.11,0.11,0.00,0.00,100000,1,11000,0,0,0,0,0,0,100000,0,100000,100000
20200312,049841,國巨第一94購01,,,,,0.00,0.00,0,0,0,0,0,0,0,0,0,0,0,0,0
20200312,049842,道瓊反中信98購01,2.18,2.18,2.11,2.11,+0.58,37.91,101000,4,217580,0,0,0,0,0,0,101000,0,101000,101000
20200312,049843,康友中信95購01,0.79,0.79,0.51,0.57,-0.27,-32.14,421000,56,305490,0,0,0,0,0,0,313000,124000,189000,189000
20200312,049844,國巨麥證94購01,,,,,0.00,0.00,0,0,0,0,0,0,0,0,0,0,0,0,0
20200312,049845,台積電麥證94購01,0.40,0.40,0.40,0.40,-0.53,-56.99,10000,1,4000,10000,0,10000,0,0,0,10000,0,10000,10000
20200312,049846,台泥群益94購01,0.73,0.73,0.52,0.67,-0.13,-16.25,71000,6,46020,0,0,0,0,0,0,30000,51000,-21000,-21000
20200312,049847,旺宏群益94購04,0.47,0.48,0.47,0.48,-0.66,-57.89,20000,2,9500,0,0,0,0,0,0,0,20000,-20000,-20000
20200312,049848,聯發科群益94購06,0.01,0.01,0.01,0.01,-0.05,-83.33,20000,1,200,0,0,0,0,0,0,20000,0,20000,20000
20200312,049849,欣興群益94購04,,,,,0.00,0.00,0,0,0,0,0,0,0,0,0,0,0,0,0
20200312,04984P,臺股指康和94售04,1.88,2.29,1.81,2.11,0.00,0.00,4007000,401,8224220,0,0,0,0,0,0,4007000,4007000,0,0
20200312,049850,上緯控群益94購01,,,,,0.00,0.00,0,0,0,0,0,0,0,0,0,0,0,0,0
20200312,049851,致伸群益94購03,,,,,0.00,0.00,0,0,0,0,0,0,0,0,0,0,0,0,0
20200312,049852,康控群益94購03,,,,,0.00,0.00,0,0,0,0,0,0,0,0,0,0,0,0,0
20200312,049853,上海銀群益94購02,,,,,0.00,0.00,0,0,0,0,0,0,0,0,0,0,0,0,0
20200312,049854,超眾群益94購02,,,,,0.00,0.00,0,0,0,0,0,0,0,0,0,0,0,0,0
20200312,049855,台表科群益94購01,1.51,1.51,0.70,0.70,-1.03,-59.54,83000,12,91600,0,0,0,0,0,0,73000,10000,63000,63000
20200312,049856,緯穎群益94購02,4.41,4.41,4.41,4.41,0.00,0.00,2000,1,8820,0,0,0,0,0,0,0,2000,-2000,-2000
20200312,049857,緯穎群益94購03,7.30,7.30,4.42,4.42,-4.63,-51.16,37000,4,219400,0,0,0,0,0,0,13000,24000,-11000,-11000
20200312,049858,百和群益94購05,,,,,0.00,0.00,0,0,0,0,0,0,0,0,0,0,0,0,0
20200312,049859,味全兆豐95購01,,,,,0.00,0.00,0,0,0,0,0,0,0,0,0,0,0,0,0
20200312,04985P,景碩永豐94售02,0.45,0.45,0.45,0.45,0.00,0.00,10000,1,4500,0,0,0,0,0,0,0,10000,-10000,-10000
20200312,049860,亞德客兆豐94購01,,,,,0.00,0.00,0,0,0,0,0,0,0,0,0,0,0,0,0
20200312,049861,正崴兆豐94購01,,,,,0.00,0.00,0,0,0,0,0,0,0,0,0,0,0,0,0
20200312,049862,南亞科兆豐94購01,,,,,0.00,0.00,0,0,0,0,0,0,0,0,0,0,0,0,0
20200312,049863,京元電兆豐94購01,,,,,0.00,0.00,0,0,0,0,0,0,0,0,0,0,0,0,0
20200312,049864,聯發科兆豐94購01,0.36,0.36,0.18,0.18,-0.28,-60.87,356000,15,87010,0,0,0,0,0,0,246000,106000,140000,140000
20200312,049865,和鑫兆豐95購01,,,,,0.00,0.00,0,0,0,0,0,0,0,0,0,0,0,0,0
20200312,049866,景碩兆豐94購01,,,,,0.00,0.00,0,0,0,0,0,0,0,0,0,0,0,0,0
20200312,049867,日月光兆豐94購01,,,,,0.00,0.00,0,0,0,0,0,0,0,0,0,0,0,0,0
20200312,049868,傳奇兆豐94購01,,,,,0.00,0.00,0,0,0,0,0,0,0,0,0,0,0,0,0
20200312,049869,訊芯兆豐94購01,,,,,0.00,0.00,0,0,0,0,0,0,0,0,0,0,0,0,0
20200312,04986P,茂林永豐94售05,0.25,0.25,0.25,0.25,0.00,0.00,2000,1,500,0,0,0,0,0,0,2000,0,2000,2000
20200312,049870,南電兆豐94購01,0.20,0.20,0.18,0.19,-0.19,-50.0,81000,4,15550,0,0,0,0,0,0,36000,45000,-9000,-9000
20200312,049871,T50反1台新9A購02,0.63,0.94,0.63,0.85,+0.26,44.07,1551000,42,1137510,0,0,0,0,0,0,755000,645000,110000,110000
20200312,049872,聯發科台新94購03,0.18,0.22,0.18,0.22,-0.62,-73.81,126000,15,27480,0,0,0,0,0,0,5000,125000,-120000,-120000
20200312,049873,華新科台新94購02,0.65,0.65,0.33,0.33,-0.82,-71.3,34000,13,18720,0,0,0,0,0,0,0,34000,-34000,-34000
20200312,049874,全新康和94購01,,,,,0.00,0.00,0,0,0,0,0,0,0,0,0,0,0,0,0
20200312,049875,台積電永豐94購04,0.15,0.18,0.06,0.12,-0.12,-50.0,707000,36,74330,0,0,0,0,0,0,289000,236000,53000,53000
20200312,049876,智邦永豐94購01,,,,,0.00,0.00,0,0,0,0,0,0,0,0,0,0,0,0,0
20200312,049877,南亞科永豐94購01,,,,,0.00,0.00,0,0,0,0,0,0,0,0,0,0,0,0,0
20200312,049878,宏達電永豐94購01,,,,,0.00,0.00,0,0,0,0,0,0,0,0,0,0,0,0,0
20200312,049879,奇鋐永豐94購02,,,,,0.00,0.00,0,0,0,0,0,0,0,0,0,0,0,0,0
20200312,04987P,昇陽半永豐94售04,1.39,1.39,1.39,1.39,+0.22,18.8,10000,1,13900,0,0,0,0,0,0,10000,0,10000,10000
20200312,049880,健策永豐94購02,0.56,0.57,0.56,0.57,-0.19,-25.0,60000,3,34100,0,0,0,0,0,0,40000,20000,20000,20000
20200312,049881,TPK永豐94購02,,,,,0.00,0.00,0,0,0,0,0,0,0,0,0,0,0,0,0
20200312,049882,康控永豐94購01,,,,,0.00,0.00,0,0,0,0,0,0,0,0,0,0,0,0,0
20200312,049883,台表科永豐94購02,0.45,0.45,0.38,0.38,-0.30,-44.12,30000,7,12520,0,0,0,0,0,0,20000,10000,10000,10000
20200312,049884,訊芯永豐94購01,,,,,0.00,0.00,0,0,0,0,0,0,0,0,0,0,0,0,0
20200312,049885,緯穎永豐94購01,1.65,1.65,1.26,1.26,-0.53,-29.61,30000,2,45600,0,0,0,0,0,0,20000,10000,10000,10000
20200312,049886,華通永昌95購01,,,,,0.00,0.00,0,0,0,0,0,0,0,0,0,0,0,0,0
20200312,049887,嘉聯益永昌95購01,,,,,0.00,0.00,0,0,0,0,0,0,0,0,0,0,0,0,0
20200312,049888,智邦國泰96購01,0.88,0.88,0.55,0.62,-0.28,-31.11,261000,38,199450,0,0,0,0,0,0,181000,92000,89000,89000
20200312,049889,欣興國泰96購01,0.15,0.15,0.10,0.12,0.00,0.00,80000,4,9700,0,0,0,0,0,0,70000,10000,60000,60000
20200312,04988P,楠梓電元大94售01,2.16,2.51,2.13,2.41,+0.76,46.06,70000,10,157050,0,0,0,0,0,0,70000,0,70000,70000
20200312,049890,嘉澤國泰95購01,1.03,1.03,0.83,0.83,-0.52,-38.52,40000,3,38200,0,0,0,0,0,0,30000,10000,20000,20000
20200312,049891,T50反1富邦94購02,0.80,1.00,0.70,0.96,0.00,0.00,718000,8,555830,0,0,0,0,0,0,713000,3000,710000,710000
20200312,049892,國巨富邦96購01,1.33,1.33,0.95,0.96,-0.56,-36.84,174000,25,181620,0,0,0,0,0,0,45000,119000,-74000,-74000
20200312,049893,日月光富邦98購01,0.30,0.30,0.20,0.20,-0.14,-41.18,75000,8,19200,0,0,0,0,0,0,20000,55000,-35000,-35000
20200312,049894,嘉聯益富邦98購01,0.33,0.33,0.23,0.25,-0.10,-28.57,185000,7,47890,0,0,0,0,0,0,100000,85000,15000,15000
20200312,049895,國巨統一94購04,1.02,1.02,1.02,1.02,-1.07,-51.2,10000,1,10200,0,0,0,0,0,0,10000,0,10000,10000
20200312,049896,聯發科統一94購06,0.33,0.33,0.17,0.17,-0.52,-75.36,54000,2,16860,0,0,0,0,0,0,0,54000,-54000,-54000
20200312,049897,華新科統一94購07,0.46,0.46,0.24,0.24,-0.51,-68.0,121000,10,52700,0,0,0,0,0,0,62000,59000,3000,3000
20200312,049898,緯穎統一95購01,,,,,0.00,0.00,0,0,0,0,0,0,0,0,0,0,0,0,0
20200312,049899,台積電元富94購05,0.42,0.48,0.30,0.48,-0.36,-42.86,48000,8,20170,0,0,0,0,0,0,31000,14000,17000,17000
20200312,04989P,國巨元大94售15,0.21,0.22,0.21,0.22,0.00,0.00,400000,3,86000,0,0,0,0,0,0,400000,200000,200000,200000
20200312,049900,台積電元富94購06,0.30,0.30,0.13,0.23,-0.20,-46.51,600000,25,133600,0,0,0,0,0,0,72000,528000,-456000,-456000
20200312,049901,瑞昱元富94購01,,,,,0.00,0.00,0,0,0,0,0,0,0,0,0,0,0,0,0
20200312,049902,大立光元富94購05,0.12,0.12,0.07,0.07,-0.27,-79.41,232000,4,21600,0,0,0,0,0,0,104000,128000,-24000,-24000
20200312,049903,大立光元富94購06,0.07,0.07,0.05,0.05,-0.33,-86.84,500000,3,25020,0,0,0,0,0,0,1000,499000,-498000,-498000
20200312,049904,矽力元富94購01,2.94,2.94,2.20,2.20,-1.14,-34.13,52000,16,134700,0,0,0,0,0,0,52000,0,52000,52000
20200312,049905,為升元大94購05,,,,,0.00,0.00,0,0,0,0,0,0,0,0,0,0,0,0,0
20200312,049906,光寶科元大94購03,0.31,0.31,0.27,0.27,-0.15,-35.71,148000,3,45480,0,0,0,0,0,0,148000,0,148000,148000
20200312,049907,鴻海元大94購07,1.51,1.51,1.23,1.23,0.00,0.00,7000,3,10290,0,0,0,0,0,0,7000,7000,0,0
20200312,049908,鴻海元大94購08,1.76,1.76,1.76,1.76,-0.83,-32.05,10000,1,17600,0,0,0,0,0,0,10000,0,10000,10000
20200312,049909,國巨元大95購01,1.53,1.53,0.99,1.00,-0.58,-36.71,177000,10,237240,0,0,0,0,0,0,51000,151000,-100000,-100000
20200312,04990P,臻鼎元大94售04,,,,,0.00,0.00,0,0,0,0,0,0,0,0,0,0,0,0,0
20200312,049910,智邦元大94購04,,,,,0.00,0.00,0,0,0,0,0,0,0,0,0,0,0,0,0
20200312,049911,智邦元大94購05,,,,,0.00,0.00,0,0,0,0,0,0,0,0,0,0,0,0,0
20200312,049912,燿華元大94購04,,,,,0.00,0.00,0,0,0,0,0,0,0,0,0,0,0,0,0
20200312,049913,微星元大94購01,0.72,0.72,0.72,0.72,-0.11,-13.25,30000,1,21600,0,0,0,0,0,0,30000,0,30000,30000
20200312,049914,瑞昱元大94購06,0.17,0.17,0.09,0.11,-0.33,-75.0,135000,4,18590,0,0,0,0,0,0,69000,66000,3000,3000
20200312,049915,瑞昱元大94購07,0.26,0.26,0.26,0.26,-0.24,-48.0,10000,1,2600,0,0,0,0,0,0,10000,0,10000,10000
20200312,049916,台光電元大94購06,0.78,0.78,0.39,0.39,-0.53,-57.61,102000,2,78390,0,0,0,0,0,0,0,102000,-102000,-102000
20200312,049917,華新科元大94購02,0.24,0.24,0.24,0.24,-0.71,-74.74,6000,1,1440,0,0,0,0,0,0,0,6000,-6000,-6000
20200312,049918,宏達電元大94購01,,,,,0.00,0.00,0,0,0,0,0,0,0,0,0,0,0,0,0
20200312,049919,美食元大94購03,,,,,0.00,0.00,0,0,0,0,0,0,0,0,0,0,0,0,0
20200312,04991P,台表科元大94售05,0.70,0.85,0.70,0.85,+0.13,18.06,89000,4,69170,0,0,0,0,0,0,32000,57000,-25000,-25000
20200312,049920,大立光元大94購15,,,,,0.00,0.00,0,0,0,0,0,0,0,0,0,0,0,0,0
20200312,049921,大立光元大94購16,0.23,0.23,0.23,0.23,-0.76,-76.77,31000,1,7130,0,0,0,0,0,0,0,31000,-31000,-31000
20200312,049922,禾伸堂元大95購01,0.25,0.25,0.21,0.25,0.00,0.00,218000,4,53030,0,0,0,0,0,0,218000,100000,118000,118000
20200312,049923,智原元大95購02,0.05,0.05,0.05,0.05,0.00,0.00,260000,26,13000,0,0,0,0,0,0,0,260000,-260000,-260000
20200312,049924,欣興元大95購04,0.06,0.06,0.06,0.06,-0.08,-57.14,40000,1,2400,0,0,0,0,0,0,0,40000,-40000,-40000
20200312,049925,創意元大95購02,,,,,0.00,0.00,0,0,0,0,0,0,0,0,0,0,0,0,0
20200312,049926,智易元大95購02,0.08,0.08,0.05,0.05,0.00,0.00,105000,11,5400,0,0,0,0,0,0,5000,100000,-95000,-95000
20200312,049927,健策元大94購02,3.51,3.51,3.36,3.46,-1.94,-35.93,50000,5,172000,0,0,0,0,0,0,10000,40000,-30000,-30000
20200312,049928,祥碩元大94購02,,,,,0.00,0.00,0,0,0,0,0,0,0,0,0,0,0,0,0
20200312,049929,祥碩元大94購03,,,,,0.00,0.00,0,0,0,0,0,0,0,0,0,0,0,0,0
20200312,04992P,元油2X富邦97售04,6.85,6.85,6.85,6.85,0.00,0.00,300000,6,2055000,0,0,0,0,0,0,300000,300000,0,0
20200312,049930,上海銀元大94購02,0.20,0.20,0.20,0.20,-0.11,-35.48,23000,1,4600,0,0,0,0,0,0,23000,23000,0,0
20200312,049931,矽力元大94購01,3.66,3.66,2.95,2.95,-1.88,-38.92,42000,3,135880,0,0,0,0,0,0,18000,24000,-6000,-6000
20200312,049932,GIS元大94購03,,,,,0.00,0.00,0,0,0,0,0,0,0,0,0,0,0,0,0
20200312,049933,GIS元大95購01,0.07,0.07,0.06,0.06,0.00,0.00,70000,2,4700,0,0,0,0,0,0,0,70000,-70000,-70000
20200312,049934,緯穎元大94購08,,,,,0.00,0.00,0,0,0,0,0,0,0,0,0,0,0,0,0
20200312,049935,南電元大94購08,,,,,0.00,0.00,0,0,0,0,0,0,0,0,0,0,0,0,0
20200312,049936,柏文元大94購02,0.05,0.05,0.05,0.05,0.00,0.00,159000,2,7950,0,0,0,0,0,0,159000,0,159000,159000
20200312,049937,臺股指元大94購18,0.72,0.73,0.72,0.73,0.00,0.00,320000,32,230600,0,0,0,0,0,0,0,320000,-320000,-320000
20200312,049938,臺股指元大94購19,,,,,0.00,0.00,0,0,0,0,0,0,0,0,0,0,0,0,0
20200312,049939,臺股指元大94購20,0.76,0.76,0.76,0.76,0.00,0.00,6000,1,4560,0,0,0,0,0,0,0,6000,-6000,-6000
20200312,04993P,上銀兆豐96售01,0.76,0.94,0.76,0.90,+0.21,30.43,533000,19,444190,0,0,0,0,0,0,137000,396000,-259000,-259000
20200312,049940,臺股指元大94購21,,,,,0.00,0.00,0,0,0,0,0,0,0,0,0,0,0,0,0
20200312,049941,臺股指元大94購24,,,,,0.00,0.00,0,0,0,0,0,0,0,0,0,0,0,0,0
20200312,049942,奇力新亞東94購01,,,,,0.00,0.00,0,0,0,0,0,0,0,0,0,0,0,0,0
20200312,049943,聯詠第一94購01,,,,,0.00,0.00,0,0,0,0,0,0,0,0,0,0,0,0,0
20200312,049944,日月光第一94購01,,,,,0.00,0.00,0,0,0,0,0,0,0,0,0,0,0,0,0
20200312,049945,樺漢第一94購01,0.13,0.13,0.11,0.11,0.00,0.00,15000,2,1750,0,0,0,0,0,0,15000,0,15000,15000
20200312,049946,智邦兆豐95購01,0.18,0.18,0.18,0.18,-0.11,-37.93,20000,1,3600,0,0,0,0,0,0,20000,0,20000,20000
20200312,049947,S&P反1中信97購01,1.12,1.43,1.12,1.43,+0.47,48.96,77000,5,99160,0,0,0,0,0,0,32000,47000,-15000,-15000
20200312,049948,聯發科麥證94購01,,,,,0.00,0.00,0,0,0,0,0,0,0,0,0,0,0,0,0
20200312,049949,燿華群益96購01,0.04,0.04,0.04,0.04,-0.07,-63.64,100000,3,4000,0,0,0,0,0,0,0,100000,-100000,-100000
20200312,04994P,大成鋼凱基95售01,1.88,1.95,1.81,1.82,+0.12,7.06,217000,8,399650,0,0,0,0,0,0,1000,216000,-215000,-215000
20200312,049950,南亞科群益94購02,,,,,0.00,0.00,0,0,0,0,0,0,0,0,0,0,0,0,0
20200312,049951,全新群益94購03,,,,,0.00,0.00,0,0,0,0,0,0,0,0,0,0,0,0,0
20200312,049952,強茂群益94購01,,,,,0.00,0.00,0,0,0,0,0,0,0,0,0,0,0,0,0
20200312,049953,華新科群益94購04,2.04,2.04,1.26,1.34,0.00,0.00,60000,6,99100,0,0,0,0,0,0,0,60000,-60000,-60000
20200312,049954,健策群益95購01,1.69,1.74,1.59,1.59,-0.74,-31.76,108000,3,185920,0,0,0,0,0,0,0,108000,-108000,-108000
20200312,049955,崇越群益95購01,1.76,1.76,1.74,1.74,-0.57,-24.68,15000,2,26320,0,0,0,0,0,0,15000,0,15000,15000
20200312,049956,國巨統一94購05,2.35,2.35,2.12,2.12,-0.36,-14.52,45000,3,104600,0,0,0,0,0,0,45000,0,45000,45000
20200312,049957,智邦統一94購01,,,,,0.00,0.00,0,0,0,0,0,0,0,0,0,0,0,0,0
20200312,049958,華新科統一94購08,,,,,0.00,0.00,0,0,0,0,0,0,0,0,0,0,0,0,0
20200312,049959,創意統一95購02,,,,,0.00,0.00,0,0,0,0,0,0,0,0,0,0,0,0,0
20200312,04995P,台達電凱基96售03,1.35,1.62,1.30,1.62,+0.44,37.29,311000,32,457430,0,0,0,0,0,0,276000,285000,-9000,-9000
20200312,049960,嘉聯益統一94購01,,,,,0.00,0.00,0,0,0,0,0,0,0,0,0,0,0,0,0
20200312,049961,GIS統一94購01,,,,,0.00,0.00,0,0,0,0,0,0,0,0,0,0,0,0,0
20200312,049962,台光電元富94購01,,,,,0.00,0.00,0,0,0,0,0,0,0,0,0,0,0,0,0
20200312,049963,聯發科元富94購02,,,,,0.00,0.00,0,0,0,0,0,0,0,0,0,0,0,0,0
20200312,049964,強茂元富94購01,,,,,0.00,0.00,0,0,0,0,0,0,0,0,0,0,0,0,0
20200312,049965,矽創元富94購01,,,,,0.00,0.00,0,0,0,0,0,0,0,0,0,0,0,0,0
20200312,049966,旺宏國票95購02,,,,,0.00,0.00,0,0,0,0,0,0,0,0,0,0,0,0,0
20200312,049967,華新科國票94購07,0.10,0.35,0.10,0.35,+0.12,52.17,71000,7,7480,0,0,0,0,0,0,0,0,0,0
20200312,049968,麗豐國票95購01,,,,,0.00,0.00,0,0,0,0,0,0,0,0,0,0,0,0,0
20200312,049969,泰鼎國票95購01,,,,,0.00,0.00,0,0,0,0,0,0,0,0,0,0,0,0,0
20200312,04996P,台積電凱基95售02,0.45,0.69,0.45,0.50,+0.10,25.0,97000,25,58580,0,0,0,0,0,0,77000,90000,-13000,-13000
20200312,049970,康控國票95購03,,,,,0.00,0.00,0,0,0,0,0,0,0,0,0,0,0,0,0
20200312,049971,台郡國票95購01,2.59,2.59,1.76,1.76,-1.99,-53.07,30000,3,61700,0,0,0,0,0,0,10000,20000,-10000,-10000
20200312,049972,南電國票95購02,0.30,0.30,0.20,0.22,-0.30,-57.69,72000,5,17240,0,0,0,0,0,0,20000,52000,-32000,-32000
20200312,049973,T50反1日盛9A購01,0.80,1.10,0.80,1.10,+0.36,48.65,346000,13,293500,0,0,0,0,0,0,345000,20000,325000,325000
20200312,049974,聯發科日盛94購02,0.09,0.09,0.09,0.09,-0.19,-67.86,10000,1,900,0,0,0,0,0,0,0,10000,-10000,-10000
20200312,049975,力山凱基94購05,,,,,0.00,0.00,0,0,0,0,0,0,0,0,0,0,0,0,0
20200312,049976,台積電凱基94購28,,,,,0.00,0.00,0,0,0,0,0,0,0,0,0,0,0,0,0
20200312,049977,瑞昱凱基94購03,,,,,0.00,0.00,0,0,0,0,0,0,0,0,0,0,0,0,0
20200312,049978,瑞昱凱基94購04,,,,,0.00,0.00,0,0,0,0,0,0,0,0,0,0,0,0,0
20200312,049979,美律凱基94購07,0.01,0.01,0.01,0.01,0.00,0.00,230000,1,2300,0,0,0,0,0,0,230000,0,230000,230000
20200312,04997P,燿華台新95售02,3.38,3.67,3.31,3.67,+0.84,29.68,144000,14,488200,0,0,0,0,0,0,89000,55000,34000,34000
20200312,049980,奇力新凱基94購04,0.59,0.59,0.51,0.51,-0.29,-36.25,6000,5,3260,0,0,0,0,0,0,6000,0,6000,6000
20200312,049981,臺企銀凱基94購01,,,,,0.00,0.00,0,0,0,0,0,0,0,0,0,0,0,0,0
20200312,049982,嘉晶凱基94購01,1.35,1.60,1.01,1.01,-0.39,-27.86,207000,9,279860,0,0,0,0,0,0,165000,43000,122000,122000
20200312,049983,智原凱基94購02,,,,,0.00,0.00,0,0,0,0,0,0,0,0,0,0,0,0,0
20200312,049984,揚明光凱基94購04,,,,,0.00,0.00,0,0,0,0,0,0,0,0,0,0,0,0,0
20200312,049985,華擎凱基94購01,0.84,0.93,0.84,0.84,-0.88,-51.16,21000,3,18000,0,0,0,0,0,0,11000,10000,1000,1000
20200312,049986,嘉澤凱基94購02,0.58,0.58,0.31,0.31,-0.48,-60.76,457000,7,162850,0,0,0,0,0,0,57000,400000,-343000,-343000
20200312,049987,智易凱基94購03,,,,,0.00,0.00,0,0,0,0,0,0,0,0,0,0,0,0,0
20200312,049988,貿聯凱基94購02,,,,,0.00,0.00,0,0,0,0,0,0,0,0,0,0,0,0,0
20200312,049989,臻鼎凱基94購02,,,,,0.00,0.00,0,0,0,0,0,0,0,0,0,0,0,0,0
20200312,04998P,京元電永豐95售01,0.75,0.78,0.74,0.78,0.00,0.00,17000,3,12760,0,0,0,0,0,0,5000,12000,-7000,-7000
20200312,049990,志超凱基94購03,,,,,0.00,0.00,0,0,0,0,0,0,0,0,0,0,0,0,0
20200312,049991,臺股指凱基96購04,,,,,0.00,0.00,0,0,0,0,0,0,0,0,0,0,0,0,0
20200312,049992,國巨台新94購02,,,,,0.00,0.00,0,0,0,0,0,0,0,0,0,0,0,0,0
20200312,049993,奇力新台新94購02,0.66,0.66,0.66,0.66,-0.70,-51.47,10000,1,6600,0,0,0,0,0,0,10000,0,10000,10000
20200312,049994,聯茂台新94購02,,,,,0.00,0.00,0,0,0,0,0,0,0,0,0,0,0,0,0
20200312,049995,GIS台新94購01,,,,,0.00,0.00,0,0,0,0,0,0,0,0,0,0,0,0,0
20200312,049996,元油2X永豐94購05,,,,,0.00,0.00,0,0,0,0,0,0,0,0,0,0,0,0,0
20200312,049997,聯發科永豐94購04,0.02,0.02,0.02,0.02,-0.05,-71.43,150000,1,3000,0,0,0,0,0,0,150000,0,150000,150000
20200312,049998,奇力新永豐94購03,,,,,0.00,0.00,0,0,0,0,0,0,0,0,0,0,0,0,0
20200312,049999,義隆永豐94購01,,,,,0.00,0.00,0,0,0,0,0,0,0,0,0,0,0,0,0
20200312,04999P,南電永豐95售01,0.67,0.81,0.62,0.81,+0.18,28.57,101000,6,67550,0,0,0,0,0,0,84000,17000,67000,67000
20200312,050000,盟立永豐94購01,,,,,0.00,0.00,0,0,0,0,0,0,0,0,0,0,0,0,0
20200312,050001,奇鋐永豐94購03,,,,,0.00,0.00,0,0,0,0,0,0,0,0,0,0,0,0,0
20200312,050002,智原永豐94購02,,,,,0.00,0.00,0,0,0,0,0,0,0,0,0,0,0,0,0
20200312,050003,景碩永豐94購01,0.12,0.12,0.09,0.10,-0.22,-68.75,298000,9,33380,0,0,0,0,0,0,230000,68000,162000,162000
20200312,050004,明泰永豐94購01,0.01,0.01,0.01,0.01,0.00,0.00,998000,2,9980,0,0,0,0,0,0,998000,0,998000,998000
20200312,050005,京鼎永豐94購01,0.26,0.26,0.20,0.20,-0.14,-41.18,82000,4,19820,0,0,0,0,0,0,62000,20000,42000,42000
20200312,050006,華擎永豐94購03,0.30,0.41,0.27,0.29,-0.18,-38.3,62000,7,19310,0,0,0,0,0,0,16000,45000,-29000,-29000
20200312,050007,貿聯永豐94購01,0.02,0.02,0.02,0.02,0.00,0.00,41000,6,820,0,0,0,0,0,0,0,41000,-41000,-41000
20200312,050008,超眾永豐94購02,,,,,0.00,0.00,0,0,0,0,0,0,0,0,0,0,0,0,0
20200312,050009,昇陽半永豐94購02,,,,,0.00,0.00,0,0,0,0,0,0,0,0,0,0,0,0,0
20200312,05000P,臺股指永豐95售01,,,,,0.00,0.00,0,0,0,0,0,0,0,0,0,0,0,0,0
20200312,050010,鈺齊永豐94購01,,,,,0.00,0.00,0,0,0,0,0,0,0,0,0,0,0,0,0
20200312,050011,S&P反1國泰95購01,0.74,0.74,0.74,0.74,0.00,0.00,200000,1,148000,0,0,0,0,0,0,200000,0,200000,200000
20200312,050012,台積電國泰95購03,4.13,4.16,3.04,3.07,-1.81,-37.09,66000,8,264630,0,0,0,0,0,0,20000,46000,-26000,-26000
20200312,050013,淘帝國泰95購01,,,,,0.00,0.00,0,0,0,0,0,0,0,0,0,0,0,0,0
20200312,050014,國巨富邦98購01,1.81,1.81,1.50,1.50,0.00,0.00,33000,6,55680,0,0,0,0,0,0,10000,23000,-13000,-13000
20200312,050015,友達富邦95購01,,,,,0.00,0.00,0,0,0,0,0,0,0,0,0,0,0,0,0
20200312,050016,緯穎富邦95購01,,,,,0.00,0.00,0,0,0,0,0,0,0,0,0,0,0,0,0
20200312,050017,百和富邦94購01,,,,,0.00,0.00,0,0,0,0,0,0,0,0,0,0,0,0,0
20200312,050018,高股息元大94購02,0.12,0.12,0.12,0.12,-0.04,-25.0,10000,1,1200,0,0,0,0,0,0,0,10000,-10000,-10000
20200312,050019,T50反1元大94購04,0.53,0.89,0.53,0.89,+0.50,128.21,231000,12,143890,0,0,0,0,0,0,120000,111000,9000,9000
20200312,05001P,華通統一95售01,2.18,2.39,2.18,2.39,+0.47,24.48,205000,6,458010,0,0,0,0,0,0,0,205000,-205000,-205000
20200312,050020,為升元大94購06,,,,,0.00,0.00,0,0,0,0,0,0,0,0,0,0,0,0,0
20200312,050021,鴻海元大94購10,1.03,1.03,1.03,1.03,0.00,0.00,50000,1,51500,0,0,0,0,0,0,0,50000,-50000,-50000
20200312,050022,鴻海元大94購11,1.46,1.49,1.46,1.49,-1.50,-50.17,11000,4,16300,0,0,0,0,0,0,9000,11000,-2000,-2000
20200312,050023,國巨元大94購12,2.07,2.07,1.77,1.79,-3.03,-62.86,27000,3,48510,0,0,0,0,0,0,27000,21000,6000,6000
20200312,050024,旺宏元大94購09,,,,,0.00,0.00,0,0,0,0,0,0,0,0,0,0,0,0,0
20200312,050025,燿華元大94購05,,,,,0.00,0.00,0,0,0,0,0,0,0,0,0,0,0,0,0
20200312,050026,友達元大96購01,,,,,0.00,0.00,0,0,0,0,0,0,0,0,0,0,0,0,0
20200312,050027,義隆元大94購03,,,,,0.00,0.00,0,0,0,0,0,0,0,0,0,0,0,0,0
20200312,050028,華新科元大94購03,1.91,1.91,1.17,1.17,-0.87,-42.65,50000,2,65900,0,0,0,0,0,0,50000,0,50000,50000
20200312,050029,美食元大94購04,,,,,0.00,0.00,0,0,0,0,0,0,0,0,0,0,0,0,0
20200312,05002P,台積電統一95售03,1.11,1.70,1.11,1.35,0.00,0.00,21000,7,28020,0,0,0,0,0,0,21000,4000,17000,17000
20200312,050030,嘉晶元大94購03,1.18,1.40,0.77,0.95,-0.40,-29.63,368000,18,387140,0,0,0,0,0,0,185000,253000,-68000,-68000
20200312,050031,嘉澤元大95購01,0.54,0.54,0.38,0.40,-0.21,-34.43,279000,11,136170,0,0,0,0,0,0,119000,160000,-41000,-41000
20200312,050032,TPK元大94購03,,,,,0.00,0.00,0,0,0,0,0,0,0,0,0,0,0,0,0
20200312,050033,日月光元大94購01,,,,,0.00,0.00,0,0,0,0,0,0,0,0,0,0,0,0,0
20200312,050034,智伸科元大94購01,,,,,0.00,0.00,0,0,0,0,0,0,0,0,0,0,0,0,0
20200312,050035,聯茂元大94購07,1.63,1.63,0.91,0.91,-1.11,-54.95,242000,5,310940,0,0,0,0,0,0,5000,237000,-232000,-232000
20200312,050036,矽格元大94購03,1.24,1.24,0.87,0.87,-0.73,-45.62,165000,6,197130,0,0,0,0,0,0,71000,108000,-37000,-37000
20200312,050037,金融類元大94購03,,,,,0.00,0.00,0,0,0,0,0,0,0,0,0,0,0,0,0
20200312,050038,金融類元大94購04,0.17,0.26,0.17,0.26,-0.40,-60.61,11000,2,2140,0,0,0,0,0,0,0,11000,-11000,-11000
20200312,050039,鴻海中信94購03,1.44,1.44,0.94,0.94,-0.65,-40.88,125000,17,164280,0,0,0,0,0,0,27000,106000,-79000,-79000
20200312,050040,鴻海中信94購04,0.39,0.39,0.39,0.39,-0.22,-36.07,10000,1,3900,0,0,0,0,0,0,10000,0,10000,10000
20200312,050041,中石化亞東94購01,,,,,0.00,0.00,0,0,0,0,0,0,0,0,0,0,0,0,0
20200312,050042,台表科亞東94購01,,,,,0.00,0.00,0,0,0,0,0,0,0,0,0,0,0,0,0
20200312,050043,GIS亞東94購01,,,,,0.00,0.00,0,0,0,0,0,0,0,0,0,0,0,0,0
20200312,050044,聯詠兆豐94購02,,,,,0.00,0.00,0,0,0,0,0,0,0,0,0,0,0,0,0
20200312,050045,祥碩兆豐94購01,,,,,0.00,0.00,0,0,0,0,0,0,0,0,0,0,0,0,0
20200312,050046,矽力兆豐94購01,,,,,0.00,0.00,0,0,0,0,0,0,0,0,0,0,0,0,0
20200312,050047,奇鋐國票95購01,,,,,0.00,0.00,0,0,0,0,0,0,0,0,0,0,0,0,0
20200312,050048,百和國票94購01,,,,,0.00,0.00,0,0,0,0,0,0,0,0,0,0,0,0,0
20200312,050049,華通群益96購01,0.78,0.82,0.47,0.47,-0.55,-53.92,508000,38,387770,0,0,0,0,0,0,348000,200000,148000,148000
20200312,05004P,健策統一95售01,0.34,0.44,0.34,0.44,+0.20,83.33,457000,10,192360,0,0,0,0,0,0,83000,374000,-291000,-291000
20200312,050050,國泰金群益94購02,0.02,0.03,0.02,0.03,-0.02,-40.0,54000,16,1510,0,0,0,0,0,0,11000,43000,-32000,-32000
20200312,050051,智原群益94購01,,,,,0.00,0.00,0,0,0,0,0,0,0,0,0,0,0,0,0
20200312,050052,致伸群益94購04,,,,,0.00,0.00,0,0,0,0,0,0,0,0,0,0,0,0,0
20200312,050053,訊芯群益94購03,,,,,0.00,0.00,0,0,0,0,0,0,0,0,0,0,0,0,0
20200312,050054,緯穎群益94購04,,,,,0.00,0.00,0,0,0,0,0,0,0,0,0,0,0,0,0
20200312,050055,道瓊反凱基95購01,0.88,1.15,0.88,1.15,0.00,0.00,356000,5,382700,0,0,0,0,0,0,310000,43000,267000,267000
20200312,050056,國巨凱基94購04,,,,,0.00,0.00,0,0,0,0,0,0,0,0,0,0,0,0,0
20200312,050057,國巨凱基94購05,,,,,0.00,0.00,0,0,0,0,0,0,0,0,0,0,0,0,0
20200312,050058,國巨凱基94購06,1.59,1.59,0.64,0.64,-0.95,-59.75,68000,9,63180,0,0,0,0,0,0,38000,50000,-12000,-12000
20200312,050059,旺宏凱基94購03,0.45,0.45,0.36,0.39,0.00,0.00,60000,4,24900,0,0,0,0,0,0,30000,30000,0,0
20200312,05005P,台表科統一95售01,0.90,1.18,0.90,1.10,+0.31,39.24,30000,6,32720,0,0,0,0,0,0,28000,2000,26000,26000
20200312,050060,光磊凱基94購03,,,,,0.00,0.00,0,0,0,0,0,0,0,0,0,0,0,0,0
20200312,050061,聯發科凱基94購07,0.60,0.60,0.35,0.35,-0.66,-65.35,40000,4,19000,0,0,0,0,0,0,0,40000,-40000,-40000
20200312,050062,聯發科凱基94購08,0.14,0.14,0.11,0.11,-0.31,-73.81,75000,2,10290,0,0,0,0,0,0,68000,7000,61000,61000
20200312,050063,聯發科凱基94購09,,,,,0.00,0.00,0,0,0,0,0,0,0,0,0,0,0,0,0
20200312,050064,華新科凱基94購08,0.23,0.23,0.10,0.10,-0.25,-71.43,270000,28,38800,0,0,0,0,0,0,20000,250000,-230000,-230000
20200312,050065,冠德凱基94購01,,,,,0.00,0.00,0,0,0,0,0,0,0,0,0,0,0,0,0
20200312,050066,華固凱基94購01,,,,,0.00,0.00,0,0,0,0,0,0,0,0,0,0,0,0,0
20200312,050067,美食凱基94購02,,,,,0.00,0.00,0,0,0,0,0,0,0,0,0,0,0,0,0
20200312,050068,美食凱基94購03,,,,,0.00,0.00,0,0,0,0,0,0,0,0,0,0,0,0,0
20200312,050069,禾伸堂凱基94購04,0.63,0.64,0.61,0.61,+0.05,8.93,40000,4,25000,0,0,0,0,0,0,0,40000,-40000,-40000
20200312,05006P,華通元富95售01,1.34,2.02,1.34,2.02,+0.85,72.65,104000,7,153600,0,0,0,0,0,0,30000,74000,-44000,-44000
20200312,050070,欣興凱基94購07,,,,,0.00,0.00,0,0,0,0,0,0,0,0,0,0,0,0,0
20200312,050071,明泰凱基94購01,,,,,0.00,0.00,0,0,0,0,0,0,0,0,0,0,0,0,0
20200312,050072,京鼎凱基94購02,0.65,0.65,0.40,0.40,-0.41,-50.62,135000,8,65840,0,0,0,0,0,0,125000,10000,115000,115000
20200312,050073,傳奇凱基94購02,,,,,0.00,0.00,0,0,0,0,0,0,0,0,0,0,0,0,0
20200312,050074,訊芯凱基94購05,,,,,0.00,0.00,0,0,0,0,0,0,0,0,0,0,0,0,0
20200312,050075,南電凱基94購04,0.10,0.11,0.10,0.11,-0.22,-66.67,263000,2,26500,0,0,0,0,0,0,263000,0,263000,263000
20200312,050076,百和凱基94購02,,,,,0.00,0.00,0,0,0,0,0,0,0,0,0,0,0,0,0
20200312,050077,臺股指凱基99購02,0.28,0.48,0.12,0.48,+0.17,54.84,998000,60,195870,0,0,0,0,0,0,0,811000,-811000,-811000
20200312,050078,臺指反統一97購01,,,,,0.00,0.00,0,0,0,0,0,0,0,0,0,0,0,0,0
20200312,050079,元油2X統一94購06,,,,,0.00,0.00,0,0,0,0,0,0,0,0,0,0,0,0,0
20200312,05007P,旺宏元富95售01,0.66,0.66,0.66,0.66,0.00,0.00,20000,1,13200,0,0,0,0,0,0,20000,0,20000,20000
20200312,050080,國巨統一94購06,2.52,2.52,2.34,2.34,-1.52,-39.38,24000,2,59400,0,0,0,0,0,0,18000,6000,12000,12000
20200312,050081,聯發科統一94購07,0.64,0.67,0.36,0.40,-0.42,-51.22,799000,32,452820,0,0,0,0,0,0,632000,655000,-23000,-23000
20200312,050082,聯發科統一94購08,0.36,0.36,0.20,0.20,-0.59,-74.68,34000,2,11600,0,0,0,0,0,0,0,30000,-30000,-30000
20200312,050083,旺宏元富94購01,0.39,0.44,0.39,0.44,-0.08,-15.38,95000,2,39300,0,0,0,0,0,0,95000,0,95000,95000
20200312,050084,宏達電元富94購03,,,,,0.00,0.00,0,0,0,0,0,0,0,0,0,0,0,0,0
20200312,050085,國泰金元富94購01,0.08,0.08,0.08,0.08,0.00,0.00,20000,1,1600,0,0,0,0,0,0,0,20000,-20000,-20000
20200312,050086,國巨台新94購03,,,,,0.00,0.00,0,0,0,0,0,0,0,0,0,0,0,0,0
20200312,050087,美食台新94購01,,,,,0.00,0.00,0,0,0,0,0,0,0,0,0,0,0,0,0
20200312,050088,禾伸堂台新94購01,,,,,0.00,0.00,0,0,0,0,0,0,0,0,0,0,0,0,0
20200312,050089,臻鼎台新94購01,,,,,0.00,0.00,0,0,0,0,0,0,0,0,0,0,0,0,0
20200312,05008P,大立光元富95售05,2.18,2.61,2.18,2.61,+1.14,77.55,283000,5,678940,0,0,0,0,0,0,83000,200000,-117000,-117000
20200312,050090,鈺齊康和94購01,0.40,0.40,0.36,0.38,-0.15,-28.3,30000,13,11440,0,0,0,0,0,0,30000,0,30000,30000
20200312,050091,喬山永豐94購02,0.12,0.12,0.12,0.12,0.00,0.00,5000,1,600,0,0,0,0,0,0,0,5000,-5000,-5000
20200312,050092,鴻海永豐94購04,0.13,0.16,0.13,0.15,-0.24,-61.54,101000,3,13780,0,0,0,0,0,0,76000,25000,51000,51000
20200312,050093,國巨永豐94購05,0.81,0.81,0.35,0.35,-0.60,-63.16,122000,12,63560,0,0,0,0,0,0,32000,90000,-58000,-58000
20200312,050094,T50反1國泰95購01,,,,,0.00,0.00,0,0,0,0,0,0,0,0,0,0,0,0,0
20200312,050095,國巨國泰95購04,,,,,0.00,0.00,0,0,0,0,0,0,0,0,0,0,0,0,0
20200312,050096,國巨國泰95購05,,,,,0.00,0.00,0,0,0,0,0,0,0,0,0,0,0,0,0
20200312,050097,可成國泰96購02,0.31,0.31,0.15,0.17,-0.27,-61.36,199000,7,51990,0,0,0,0,0,0,124000,75000,49000,49000
20200312,050098,嘉聯益國泰95購02,,,,,0.00,0.00,0,0,0,0,0,0,0,0,0,0,0,0,0
20200312,050099,台積電永昌96購01,1.91,1.91,1.39,1.72,-0.49,-22.17,3245000,78,5306600,0,0,0,0,0,0,1391000,2584000,-1193000,-1193000
20200312,05009P,大立光元富95售06,3.50,4.13,3.50,4.13,0.00,0.00,120000,7,482700,0,0,0,0,0,0,120000,0,120000,120000
20200312,050100,台積電永昌96購02,1.25,1.25,0.83,1.05,-0.43,-29.05,5045000,92,5558440,0,0,0,0,0,0,2313000,3581000,-1268000,-1268000
20200312,050101,台積電永昌96購03,0.43,0.43,0.15,0.24,-0.19,-44.19,3489000,64,861330,0,0,0,0,0,0,2219000,1365000,854000,854000
20200312,050102,鴻海富邦95購04,0.54,0.54,0.38,0.38,-0.26,-40.62,82000,11,37160,0,0,0,0,0,0,2000,82000,-80000,-80000
20200312,050103,群創富邦94購01,,,,,0.00,0.00,0,0,0,0,0,0,0,0,0,0,0,0,0
20200312,050104,元石油元大97購02,0.07,0.07,0.07,0.07,+0.01,16.67,10000,1,700,0,0,0,0,0,0,0,10000,-10000,-10000
20200312,050105,力山元大95購02,,,,,0.00,0.00,0,0,0,0,0,0,0,0,0,0,0,0,0
20200312,050106,台達電元大94購11,1.24,1.24,1.24,1.24,-0.31,-20.0,110000,2,136400,0,0,0,0,0,0,110000,0,110000,110000
20200312,050107,鴻海元大94購12,,,,,0.00,0.00,0,0,0,0,0,0,0,0,0,0,0,0,0
20200312,050108,鴻海元大94購13,1.38,1.38,0.83,0.83,-1.27,-60.48,4000,2,4420,0,0,0,0,0,0,0,4000,-4000,-4000
20200312,050109,國巨元大94購13,,,,,0.00,0.00,0,0,0,0,0,0,0,0,0,0,0,0,0
20200312,05010P,台郡元富95售01,0.33,0.37,0.32,0.37,+0.16,76.19,185000,6,63500,0,0,0,0,0,0,185000,0,185000,185000
20200312,050110,京元電元大94購03,,,,,0.00,0.00,0,0,0,0,0,0,0,0,0,0,0,0,0
20200312,050111,全新元大95購02,,,,,0.00,0.00,0,0,0,0,0,0,0,0,0,0,0,0,0
20200312,050112,高鐵元大94購02,,,,,0.00,0.00,0,0,0,0,0,0,0,0,0,0,0,0,0
20200312,050113,欣興元大95購05,,,,,0.00,0.00,0,0,0,0,0,0,0,0,0,0,0,0,0
20200312,050114,群創元大95購01,0.32,0.32,0.31,0.32,-0.27,-45.76,110000,5,34900,0,0,0,0,0,0,80000,30000,50000,50000
20200312,050115,群創元大96購01,0.33,0.33,0.33,0.33,-0.26,-44.07,300000,1,99000,0,0,0,0,0,0,0,300000,-300000,-300000
20200312,050116,嘉澤元大94購03,0.52,0.52,0.47,0.47,-0.35,-42.68,107000,3,50790,0,0,0,0,0,0,107000,0,107000,107000
20200312,050117,麗豐元大96購02,0.16,0.16,0.14,0.15,-0.08,-34.78,236000,4,36100,0,0,0,0,0,0,120000,116000,4000,4000
20200312,050118,臻鼎元大94購01,,,,,0.00,0.00,0,0,0,0,0,0,0,0,0,0,0,0,0
20200312,050119,瀚宇博元大95購03,,,,,0.00,0.00,0,0,0,0,0,0,0,0,0,0,0,0,0
20200312,05011P,南電國泰96售01,1.06,1.37,1.06,1.36,+0.30,28.3,1424000,49,1741830,0,0,0,0,0,0,456000,917000,-461000,-461000
20200312,050120,GIS元大95購02,,,,,0.00,0.00,0,0,0,0,0,0,0,0,0,0,0,0,0
20200312,050121,南電元大95購02,1.82,1.82,1.21,1.21,-0.69,-36.32,57000,7,72110,0,0,0,0,0,0,33000,57000,-24000,-24000
20200312,050122,臺指反凱基96購01,0.47,0.73,0.47,0.70,+0.40,133.33,562000,16,344880,0,0,0,0,0,0,300000,412000,-112000,-112000
20200312,050123,群臺反凱基96購01,0.61,0.83,0.61,0.81,+0.30,58.82,281000,9,209090,0,0,0,0,0,0,121000,140000,-19000,-19000
20200312,050124,元金2X凱基95購01,1.74,1.74,1.59,1.59,-0.54,-25.35,245000,6,390860,0,0,0,0,0,0,229000,15000,214000,214000
20200312,050125,中環凱基94購01,,,,,0.00,0.00,0,0,0,0,0,0,0,0,0,0,0,0,0
20200312,050126,國巨凱基94購08,1.45,1.54,1.45,1.54,0.00,0.00,20000,2,29900,0,0,0,0,0,0,20000,20000,0,0
20200312,050127,台積電凱基94購31,,,,,0.00,0.00,0,0,0,0,0,0,0,0,0,0,0,0,0
20200312,050128,旺宏凱基94購04,0.25,0.27,0.25,0.25,-0.33,-56.9,40000,4,10300,0,0,0,0,0,0,0,40000,-40000,-40000
20200312,050129,聯發科凱基94購11,,,,,0.00,0.00,0,0,0,0,0,0,0,0,0,0,0,0,0
20200312,05012P,台積電元大95售07,0.83,0.96,0.83,0.96,0.00,0.00,70000,4,60300,0,0,0,0,0,0,50000,70000,-20000,-20000
20200312,050130,華新科凱基94購09,0.22,0.22,0.12,0.12,-0.14,-53.85,110000,12,18200,0,0,0,0,0,0,10000,100000,-90000,-90000
20200312,050131,新光金凱基94購01,,,,,0.00,0.00,0,0,0,0,0,0,0,0,0,0,0,0,0
20200312,050132,日電貿凱基94購02,0.21,0.21,0.21,0.21,-0.33,-61.11,30000,1,6300,0,0,0,0,0,0,30000,0,30000,30000
20200312,050133,鈺齊凱基94購01,0.07,0.07,0.06,0.06,-0.07,-53.85,6000,5,390,0,0,0,0,0,0,6000,0,6000,6000
20200312,050134,世紀鋼凱基94購04,,,,,0.00,0.00,0,0,0,0,0,0,0,0,0,0,0,0,0
20200312,050135,禾伸堂兆豐95購01,0.40,0.40,0.40,0.40,-0.07,-14.89,10000,1,4000,0,0,0,0,0,0,0,10000,-10000,-10000
20200312,050136,柏文兆豐94購01,,,,,0.00,0.00,0,0,0,0,0,0,0,0,0,0,0,0,0
20200312,050137,臺指反國票96購01,1.05,1.20,1.05,1.20,+0.48,66.67,15000,3,17000,0,0,0,0,0,0,15000,0,15000,15000
20200312,050138,台表科國票95購02,,,,,0.00,0.00,0,0,0,0,0,0,0,0,0,0,0,0,0
20200312,050139,華通亞東94購01,,,,,0.00,0.00,0,0,0,0,0,0,0,0,0,0,0,0,0
20200312,05013P,台積電元大96售05,0.93,1.20,0.92,1.06,+0.23,27.71,406000,34,417860,0,0,0,0,0,0,224000,282000,-58000,-58000
20200312,050140,台郡第一94購01,0.71,0.74,0.71,0.71,0.00,0.00,50000,5,35800,0,0,0,0,0,0,0,50000,-50000,-50000
20200312,050141,國巨統一94購07,2.12,2.12,2.12,2.12,-0.17,-7.42,20000,1,42400,0,0,0,0,0,0,20000,0,20000,20000
20200312,050142,聯發科元富9A購01,0.67,0.67,0.46,0.46,-0.27,-36.99,703000,47,393860,0,0,0,0,0,0,64000,639000,-575000,-575000
20200312,050143,臻鼎元富94購05,0.01,0.01,0.01,0.01,0.00,0.00,380000,1,3800,0,0,0,0,0,0,380000,0,380000,380000
20200312,050144,宏達電台新95購01,0.43,0.43,0.29,0.29,-0.17,-36.96,20000,4,6950,0,0,0,0,0,0,0,20000,-20000,-20000
20200312,050145,矽創台新94購01,,,,,0.00,0.00,0,0,0,0,0,0,0,0,0,0,0,0,0
20200312,050146,訊芯康和94購02,,,,,0.00,0.00,0,0,0,0,0,0,0,0,0,0,0,0,0
20200312,050147,為升永豐94購01,,,,,0.00,0.00,0,0,0,0,0,0,0,0,0,0,0,0,0
20200312,050148,啟碁永豐94購01,,,,,0.00,0.00,0,0,0,0,0,0,0,0,0,0,0,0,0
20200312,050149,東元群益94購01,,,,,0.00,0.00,0,0,0,0,0,0,0,0,0,0,0,0,0
20200312,05014P,臺股指元大95售05,3.40,4.39,3.40,4.39,+1.61,57.91,14000,4,54880,0,0,0,0,0,0,14000,0,14000,14000
20200312,050150,國巨群益95購01,1.87,1.88,1.08,1.08,-1.03,-48.82,91000,10,127000,0,0,0,0,0,0,40000,51000,-11000,-11000
20200312,050151,台積電群益94購12,0.67,0.67,0.50,0.52,-0.43,-45.26,162000,11,89570,0,0,0,0,0,0,39000,123000,-84000,-84000
20200312,050152,聯發科群益94購07,,,,,0.00,0.00,0,0,0,0,0,0,0,0,0,0,0,0,0
20200312,050153,義隆群益94購01,,,,,0.00,0.00,0,0,0,0,0,0,0,0,0,0,0,0,0
20200312,050154,可成群益94購05,,,,,0.00,0.00,0,0,0,0,0,0,0,0,0,0,0,0,0
20200312,050155,華新科群益95購01,1.02,1.02,0.63,0.72,-0.87,-54.72,171000,14,126400,0,0,0,0,0,0,116000,75000,41000,41000
20200312,050156,潤泰全群益94購01,,,,,0.00,0.00,0,0,0,0,0,0,0,0,0,0,0,0,0
20200312,050157,臻鼎群益94購02,,,,,0.00,0.00,0,0,0,0,0,0,0,0,0,0,0,0,0
20200312,050158,上海銀群益96購01,0.05,0.05,0.05,0.05,-0.04,-44.44,50000,1,2500,0,0,0,0,0,0,0,50000,-50000,-50000
20200312,050159,超眾群益94購03,,,,,0.00,0.00,0,0,0,0,0,0,0,0,0,0,0,0,0
20200312,05015P,臺股指元大95售06,1.69,3.00,1.69,3.00,+1.55,106.9,19000,6,43730,0,0,0,0,0,0,19000,0,19000,19000
20200312,050160,中石化國泰95購01,,,,,0.00,0.00,0,0,0,0,0,0,0,0,0,0,0,0,0
20200312,050161,鴻海國泰96購03,0.93,0.93,0.93,0.93,0.00,0.00,98000,1,91140,0,0,0,0,0,0,0,98000,-98000,-98000
20200312,050162,中環國泰95購01,,,,,0.00,0.00,0,0,0,0,0,0,0,0,0,0,0,0,0
20200312,050163,群創國泰95購01,0.52,0.52,0.40,0.45,-0.35,-43.75,172000,5,81300,0,0,0,0,0,0,0,172000,-172000,-172000
20200312,050164,揚明光國泰95購01,0.19,0.19,0.19,0.19,-0.12,-38.71,100000,1,19000,0,0,0,0,0,0,100000,0,100000,100000
20200312,050165,泰鼎國泰95購02,,,,,0.00,0.00,0,0,0,0,0,0,0,0,0,0,0,0,0
20200312,050166,彩晶國泰95購01,0.61,0.61,0.49,0.49,-0.29,-37.18,100000,3,56800,0,0,0,0,0,0,100000,0,100000,100000
20200312,050167,T50反1富邦96購01,0.87,0.87,0.87,0.87,+0.31,55.36,100000,1,87000,0,0,0,0,0,0,100000,0,100000,100000
20200312,050168,緯創富邦95購01,,,,,0.00,0.00,0,0,0,0,0,0,0,0,0,0,0,0,0
20200312,050169,臺指反元大97購01,,,,,0.00,0.00,0,0,0,0,0,0,0,0,0,0,0,0,0
20200312,05016P,臺股指元大95售07,3.95,3.95,3.95,3.95,+1.80,83.72,100000,1,395000,0,0,0,0,0,0,100000,0,100000,100000
20200312,050170,臺指反元大97購02,,,,,0.00,0.00,0,0,0,0,0,0,0,0,0,0,0,0,0
20200312,050171,臺指反元大97購03,,,,,0.00,0.00,0,0,0,0,0,0,0,0,0,0,0,0,0
20200312,050172,臺指反元大98購02,1.35,1.71,1.35,1.62,+0.50,44.64,378000,19,534050,0,0,0,0,0,0,308000,70000,238000,238000
20200312,050173,旺宏元大96購02,0.60,0.60,0.35,0.38,-0.35,-47.95,346000,14,140430,0,0,0,0,0,0,25000,316000,-291000,-291000
20200312,050174,技嘉元大94購01,1.07,1.07,0.90,0.90,-0.27,-23.08,146000,4,143000,0,0,0,0,0,0,30000,116000,-86000,-86000
20200312,050175,台光電元大94購08,0.45,0.45,0.45,0.45,-0.07,-13.46,90000,1,40500,0,0,0,0,0,0,0,90000,-90000,-90000
20200312,050176,正崴元大94購03,,,,,0.00,0.00,0,0,0,0,0,0,0,0,0,0,0,0,0
20200312,050177,聯發科元大94購11,0.27,0.27,0.14,0.14,-0.41,-74.55,48000,3,11920,0,0,0,0,0,0,0,48000,-48000,-48000
20200312,050178,聯發科元大94購12,,,,,0.00,0.00,0,0,0,0,0,0,0,0,0,0,0,0,0
20200312,050179,全新元大96購02,0.22,0.22,0.18,0.18,-0.14,-43.75,1030000,7,224200,0,0,0,0,0,0,970000,60000,910000,910000
20200312,05017P,臺股指元大95售08,2.83,4.03,2.83,3.80,+1.82,91.92,140000,6,484900,0,0,0,0,0,0,140000,0,140000,140000
20200312,050180,華新科元大95購08,0.99,0.99,0.75,0.84,-0.49,-36.84,245000,5,201070,0,0,0,0,0,0,23000,245000,-222000,-222000
20200312,050181,富邦金元大94購02,,,,,0.00,0.00,0,0,0,0,0,0,0,0,0,0,0,0,0
20200312,050182,淘帝元大94購01,,,,,0.00,0.00,0,0,0,0,0,0,0,0,0,0,0,0,0
20200312,050183,奇鋐元大96購01,0.21,0.21,0.17,0.17,-0.12,-41.38,58000,5,10810,0,0,0,0,0,0,48000,10000,38000,38000
20200312,050184,信邦元大94購01,,,,,0.00,0.00,0,0,0,0,0,0,0,0,0,0,0,0,0
20200312,050185,和鑫元大95購02,,,,,0.00,0.00,0,0,0,0,0,0,0,0,0,0,0,0,0
20200312,050186,京鼎元大94購01,1.20,1.20,1.02,1.02,-0.54,-34.62,202000,3,214580,0,0,0,0,0,0,3000,199000,-196000,-196000
20200312,050187,群創元大94購03,,,,,0.00,0.00,0,0,0,0,0,0,0,0,0,0,0,0,0
20200312,050188,貿聯元大96購01,0.50,0.50,0.39,0.39,-0.21,-35.0,151000,3,62090,0,0,0,0,0,0,40000,111000,-71000,-71000
20200312,050189,旭富元大94購01,3.13,3.13,2.52,2.52,0.00,0.00,30000,3,86700,0,0,0,0,0,0,0,30000,-30000,-30000
20200312,05018P,臺股指元大95售09,2.90,3.05,2.90,3.05,0.00,0.00,10000,2,29750,0,0,0,0,0,0,10000,0,10000,10000
20200312,050190,麗豐元大95購02,0.11,0.11,0.11,0.11,0.00,0.00,90000,1,9900,0,0,0,0,0,0,90000,0,90000,90000
20200312,050191,和碩元大94購02,1.08,1.08,0.84,0.89,-0.75,-45.73,412000,5,376340,0,0,0,0,0,0,14000,398000,-384000,-384000
20200312,050192,康控元大97購01,0.18,0.18,0.08,0.14,-0.07,-33.33,300000,10,47800,0,0,0,0,0,0,0,290000,-290000,-290000
20200312,050193,臻鼎元大94購02,0.16,0.16,0.16,0.16,-0.17,-51.52,20000,1,3200,0,0,0,0,0,0,20000,0,20000,20000
20200312,050194,臻鼎元大94購03,0.09,0.09,0.03,0.03,-0.27,-90.0,3081000,163,156040,0,0,0,0,0,0,57000,3013000,-2956000,-2956000
20200312,050195,上海銀元大94購03,,,,,0.00,0.00,0,0,0,0,0,0,0,0,0,0,0,0,0
20200312,050196,嘉聯益元大97購01,0.22,0.22,0.17,0.17,-0.10,-37.04,98000,6,20360,0,0,0,0,0,0,93000,5000,88000,88000
20200312,050197,矽格元大94購04,0.91,0.91,0.60,0.60,-0.51,-45.95,204000,6,163560,0,0,0,0,0,0,115000,145000,-30000,-30000
20200312,050198,緯穎元大94購09,,,,,0.00,0.00,0,0,0,0,0,0,0,0,0,0,0,0,0
20200312,050199,南電元大94購09,0.70,0.78,0.63,0.63,-0.52,-45.22,116000,7,81870,0,0,0,0,0,0,82000,34000,48000,48000
20200312,05019P,喬山中信95售01,0.98,1.27,0.96,1.27,+0.34,36.56,603000,32,650260,0,0,0,0,0,0,535000,153000,382000,382000
20200312,050200,致新元大94購01,,,,,0.00,0.00,0,0,0,0,0,0,0,0,0,0,0,0,0
20200312,050201,光磊群益94購01,,,,,0.00,0.00,0,0,0,0,0,0,0,0,0,0,0,0,0
20200312,050202,建準群益95購01,1.20,1.20,0.96,0.96,-0.44,-31.43,115000,16,123460,0,0,0,0,0,0,55000,60000,-5000,-5000
20200312,050203,美律群益94購04,,,,,0.00,0.00,0,0,0,0,0,0,0,0,0,0,0,0,0
20200312,050204,華新科群益94購05,0.64,0.64,0.24,0.24,-0.54,-69.23,130000,6,38900,0,0,0,0,0,0,100000,30000,70000,70000
20200312,050205,牧德群益94購02,0.32,0.32,0.27,0.27,-0.27,-50.0,150000,3,43000,0,0,0,0,0,0,0,150000,-150000,-150000
20200312,050206,寶成群益94購01,,,,,0.00,0.00,0,0,0,0,0,0,0,0,0,0,0,0,0
20200312,050207,百和群益95購01,,,,,0.00,0.00,0,0,0,0,0,0,0,0,0,0,0,0,0
20200312,050208,燿華兆豐95購02,,,,,0.00,0.00,0,0,0,0,0,0,0,0,0,0,0,0,0
20200312,050209,華通國票95購01,,,,,0.00,0.00,0,0,0,0,0,0,0,0,0,0,0,0,0
20200312,05020P,廣達中信95售01,0.38,0.45,0.38,0.41,+0.06,17.14,236000,11,96470,0,0,0,0,0,0,49000,187000,-138000,-138000
20200312,050210,華新科國票94購08,,,,,0.00,0.00,0,0,0,0,0,0,0,0,0,0,0,0,0
20200312,050211,貿聯國票95購01,0.41,0.43,0.40,0.43,-0.22,-33.85,60000,9,24690,0,0,0,0,0,0,60000,0,60000,60000
20200312,050212,瀚宇博國票95購02,,,,,0.00,0.00,0,0,0,0,0,0,0,0,0,0,0,0,0
20200312,050213,華新科台新94購03,0.46,0.46,0.46,0.46,-0.99,-68.28,94000,1,43240,0,0,0,0,0,0,0,94000,-94000,-94000
20200312,050214,嘉晶台新94購01,0.38,0.39,0.33,0.33,-0.17,-34.0,99000,7,37270,0,0,0,0,0,0,99000,0,99000,99000
20200312,050215,TPK台新96購01,,,,,0.00,0.00,0,0,0,0,0,0,0,0,0,0,0,0,0
20200312,050216,奇力新永豐94購04,1.20,1.20,1.03,1.03,-0.57,-35.62,60000,10,67110,0,0,0,0,0,0,60000,0,60000,60000
20200312,050217,健策永豐94購03,0.98,0.98,0.92,0.92,-0.71,-43.56,48000,5,45660,0,0,0,0,0,0,0,48000,-48000,-48000
20200312,050218,世紀鋼統一94購02,2.04,2.04,2.04,2.04,-0.21,-9.33,20000,1,40800,0,0,0,0,0,0,20000,0,20000,20000
20200312,050219,台積電元富95購03,0.77,0.85,0.77,0.85,0.00,0.00,8000,2,6400,0,0,0,0,0,0,0,8000,-8000,-8000
20200312,05021P,瑞昱凱基95售01,,,,,0.00,0.00,0,0,0,0,0,0,0,0,0,0,0,0,0
20200312,050220,台積電元富96購01,0.40,0.41,0.27,0.40,-0.08,-16.67,134000,12,52960,0,0,0,0,0,0,11000,58000,-47000,-47000
20200312,050221,TPK元富94購02,,,,,0.00,0.00,0,0,0,0,0,0,0,0,0,0,0,0,0
20200312,050222,瑞儀元富94購01,,,,,0.00,0.00,0,0,0,0,0,0,0,0,0,0,0,0,0
20200312,050223,聯茂元富94購02,0.10,0.10,0.06,0.06,-0.17,-73.91,621000,12,51300,0,0,0,0,0,0,0,621000,-621000,-621000
20200312,050224,台泥中信94購01,,,,,0.00,0.00,0,0,0,0,0,0,0,0,0,0,0,0,0
20200312,050225,亞泥中信94購01,,,,,0.00,0.00,0,0,0,0,0,0,0,0,0,0,0,0,0
20200312,050226,華新科中信94購01,0.08,0.08,0.08,0.08,0.00,0.00,20000,1,1600,0,0,0,0,0,0,20000,0,20000,20000
20200312,050227,大立光中信96購01,0.55,0.55,0.30,0.32,-0.42,-56.76,108000,6,37390,0,25000,-25000,0,0,0,25000,83000,-58000,-83000
20200312,050228,中磊中信96購01,0.54,0.54,0.54,0.54,-0.08,-12.9,30000,1,16200,0,0,0,0,0,0,30000,0,30000,30000
20200312,050229,鴻海麥證94購02,0.60,0.60,0.37,0.37,-0.43,-53.75,53000,16,27560,20000,33000,-13000,0,0,0,20000,33000,-13000,-13000
20200312,05022P,智易凱基95售01,1.46,1.85,1.46,1.85,+0.63,51.64,39000,3,64740,0,0,0,0,0,0,19000,20000,-1000,-1000
20200312,050230,聯發科麥證94購02,0.66,0.66,0.33,0.33,-0.45,-57.69,259000,7,109570,19000,240000,-221000,0,0,0,19000,249000,-230000,-230000
20200312,050231,聯發科麥證94購03,0.43,0.43,0.18,0.18,-0.35,-66.04,75000,8,29200,45000,30000,15000,0,0,0,45000,35000,10000,10000
20200312,050232,奇鋐麥證95購01,0.12,0.12,0.09,0.09,-0.05,-35.71,200000,3,21000,0,200000,-200000,0,0,0,0,200000,-200000,-200000
20200312,050233,香港2X凱基96購01,0.16,0.16,0.10,0.11,-0.10,-47.62,236000,15,27890,0,0,0,0,0,0,0,236000,-236000,-236000
20200312,050234,國巨凱基94購10,1.03,1.04,0.59,0.59,-0.66,-52.8,37000,5,37000,0,0,0,0,0,0,35000,2000,33000,33000
20200312,050235,國巨凱基94購11,,,,,0.00,0.00,0,0,0,0,0,0,0,0,0,0,0,0,0
20200312,050236,旺宏凱基94購06,,,,,0.00,0.00,0,0,0,0,0,0,0,0,0,0,0,0,0
20200312,050237,智邦凱基94購03,,,,,0.00,0.00,0,0,0,0,0,0,0,0,0,0,0,0,0
20200312,050238,瑞昱凱基94購05,,,,,0.00,0.00,0,0,0,0,0,0,0,0,0,0,0,0,0
20200312,050239,廣達凱基94購01,0.52,0.52,0.52,0.52,0.00,0.00,68000,1,35360,0,0,0,0,0,0,0,68000,-68000,-68000
20200312,05023P,和碩凱基95售01,0.71,0.80,0.71,0.80,+0.20,33.33,159000,8,116570,0,0,0,0,0,0,39000,120000,-81000,-81000
20200312,050240,聯發科凱基94購13,0.19,0.19,0.15,0.15,-0.13,-46.43,130000,4,22000,0,0,0,0,0,0,130000,0,130000,130000
20200312,050241,聯發科凱基94購14,,,,,0.00,0.00,0,0,0,0,0,0,0,0,0,0,0,0,0
20200312,050242,義隆凱基94購04,,,,,0.00,0.00,0,0,0,0,0,0,0,0,0,0,0,0,0
20200312,050243,華新科凱基94購10,0.19,0.19,0.19,0.19,-0.27,-58.7,20000,1,3800,0,0,0,0,0,0,20000,0,20000,20000
20200312,050244,富邦金凱基94購01,,,,,0.00,0.00,0,0,0,0,0,0,0,0,0,0,0,0,0
20200312,050245,大立光凱基94購12,0.79,0.79,0.57,0.60,0.00,0.00,23000,5,14940,0,0,0,0,0,0,0,23000,-23000,-23000
20200312,050246,大立光凱基94購13,,,,,0.00,0.00,0,0,0,0,0,0,0,0,0,0,0,0,0
20200312,050247,智易凱基94購04,,,,,0.00,0.00,0,0,0,0,0,0,0,0,0,0,0,0,0
20200312,050248,臻鼎凱基94購03,,,,,0.00,0.00,0,0,0,0,0,0,0,0,0,0,0,0,0
20200312,050249,瑞儀凱基94購01,,,,,0.00,0.00,0,0,0,0,0,0,0,0,0,0,0,0,0
20200312,05024P,華通國票96售01,1.42,1.78,1.42,1.78,+0.59,49.58,45000,5,67900,0,0,0,0,0,0,5000,40000,-35000,-35000
20200312,050250,台郡凱基94購03,3.09,3.09,2.35,2.35,-1.99,-45.85,115000,5,325450,0,0,0,0,0,0,15000,100000,-85000,-85000
20200312,050251,樺漢凱基94購02,0.48,0.48,0.48,0.48,-0.76,-61.29,11000,1,5280,0,0,0,0,0,0,11000,11000,0,0
20200312,050252,聯發科國泰95購01,1.54,1.54,0.84,0.86,-0.89,-50.86,244000,19,296890,0,0,0,0,0,0,101000,128000,-27000,-27000
20200312,050253,百和國泰96購01,0.34,0.34,0.24,0.24,-0.23,-48.94,20000,2,5800,0,0,0,0,0,0,0,20000,-20000,-20000
20200312,050254,大立光富邦96購02,0.78,0.79,0.48,0.49,-0.45,-47.87,747000,12,372110,0,0,0,0,0,0,7000,740000,-733000,-733000
20200312,050255,GIS富邦95購01,0.04,0.04,0.03,0.03,-0.03,-50.0,70000,2,2500,0,0,0,0,0,0,70000,0,70000,70000
20200312,050256,臺指反元大98購03,0.95,1.19,0.95,1.19,+0.31,35.23,585000,19,607470,0,0,0,0,0,0,112000,463000,-351000,-351000
20200312,050257,為升元大94購07,,,,,0.00,0.00,0,0,0,0,0,0,0,0,0,0,0,0,0
20200312,050258,為升元大94購08,,,,,0.00,0.00,0,0,0,0,0,0,0,0,0,0,0,0,0
20200312,050259,鴻海元大94購14,1.12,1.12,1.12,1.12,-0.55,-32.93,10000,1,11200,0,0,0,0,0,0,10000,0,10000,10000
20200312,05025P,聯發科群益95售02,5.25,6.25,5.25,6.25,+1.88,43.02,22000,6,124600,0,0,0,0,0,0,22000,8000,14000,14000
20200312,050260,鴻海元大94購15,0.53,0.53,0.39,0.39,-0.37,-48.68,182000,8,83630,0,0,0,0,0,0,33000,149000,-116000,-116000
20200312,050261,國巨元大95購04,1.17,1.17,0.69,0.70,-0.52,-42.62,404000,26,366360,0,0,0,0,0,0,87000,333000,-246000,-246000
20200312,050262,台積電元大94購21,1.89,1.89,1.28,1.74,-1.04,-37.41,30000,5,50450,0,0,0,0,0,0,19000,30000,-11000,-11000
20200312,050263,旺宏元大94購10,0.90,0.90,0.49,0.49,-0.97,-66.44,130000,3,103900,0,0,0,0,0,0,20000,110000,-90000,-90000
20200312,050264,聯發科元大94購13,0.54,0.54,0.24,0.29,-0.66,-69.47,440000,9,185100,0,0,0,0,0,0,280000,160000,120000,120000
20200312,050265,美食元大94購05,,,,,0.00,0.00,0,0,0,0,0,0,0,0,0,0,0,0,0
20200312,050266,兆豐金元大94購01,,,,,0.00,0.00,0,0,0,0,0,0,0,0,0,0,0,0,0
20200312,050267,奇鋐元大94購03,,,,,0.00,0.00,0,0,0,0,0,0,0,0,0,0,0,0,0
20200312,050268,智原元大95購03,,,,,0.00,0.00,0,0,0,0,0,0,0,0,0,0,0,0,0
20200312,050269,欣興元大94購09,0.05,0.05,0.05,0.05,0.00,0.00,105000,2,5250,0,0,0,0,0,0,105000,0,105000,105000
20200312,05026P,貿聯群益95售01,1.87,1.89,1.85,1.85,+0.07,3.93,60000,3,112800,0,0,0,0,0,0,60000,0,60000,60000
20200312,050270,景碩元大94購01,,,,,0.00,0.00,0,0,0,0,0,0,0,0,0,0,0,0,0
20200312,050271,上緯控元大96購01,,,,,0.00,0.00,0,0,0,0,0,0,0,0,0,0,0,0,0
20200312,050272,訊芯元大94購03,,,,,0.00,0.00,0,0,0,0,0,0,0,0,0,0,0,0,0
20200312,050273,GIS元大94購04,,,,,0.00,0.00,0,0,0,0,0,0,0,0,0,0,0,0,0
20200312,050274,GIS元大94購05,,,,,0.00,0.00,0,0,0,0,0,0,0,0,0,0,0,0,0
20200312,050275,緯穎元大94購10,,,,,0.00,0.00,0,0,0,0,0,0,0,0,0,0,0,0,0
20200312,050276,百和元大94購03,,,,,0.00,0.00,0,0,0,0,0,0,0,0,0,0,0,0,0
20200312,050277,上銀亞東94購01,,,,,0.00,0.00,0,0,0,0,0,0,0,0,0,0,0,0,0
20200312,050278,上証2X第一94購01,,,,,0.00,0.00,0,0,0,0,0,0,0,0,0,0,0,0,0
20200312,050279,彩晶第一94購01,0.32,0.32,0.32,0.32,-0.26,-44.83,2000,1,640,0,0,0,0,0,0,2000,0,2000,2000
20200312,05027P,南電群益95售01,0.98,1.28,0.92,1.28,+0.38,42.22,306000,12,307150,0,0,0,0,0,0,113000,193000,-80000,-80000
20200312,050280,國巨日盛94購01,1.38,1.38,1.22,1.22,-0.22,-15.28,70000,4,94000,0,0,0,0,0,0,60000,10000,50000,50000
20200312,050281,台積電日盛94購03,0.20,0.20,0.10,0.17,-0.13,-43.33,70000,10,10450,0,0,0,0,0,0,27000,43000,-16000,-16000
20200312,050282,T50反1凱基97購01,,,,,0.00,0.00,0,0,0,0,0,0,0,0,0,0,0,0,0
20200312,050283,T50反1凱基9A購01,1.04,1.04,1.04,1.04,0.00,0.00,2000,1,2080,0,0,0,0,0,0,0,2000,-2000,-2000
20200312,050284,台泥凱基94購01,,,,,0.00,0.00,0,0,0,0,0,0,0,0,0,0,0,0,0
20200312,050285,力山凱基94購06,,,,,0.00,0.00,0,0,0,0,0,0,0,0,0,0,0,0,0
20200312,050286,為升凱基94購05,,,,,0.00,0.00,0,0,0,0,0,0,0,0,0,0,0,0,0
20200312,050287,台達電凱基94購10,,,,,0.00,0.00,0,0,0,0,0,0,0,0,0,0,0,0,0
20200312,050288,台積電凱基94購32,0.23,0.23,0.14,0.16,-0.40,-71.43,181000,19,31300,0,0,0,0,0,0,23000,158000,-135000,-135000
20200312,050289,光磊凱基94購04,,,,,0.00,0.00,0,0,0,0,0,0,0,0,0,0,0,0,0
20200312,05028P,康控永豐95售02,1.80,2.17,1.80,2.17,+0.50,29.94,273000,10,506420,0,0,0,0,0,0,196000,77000,119000,119000
20200312,050290,南亞科凱基94購06,,,,,0.00,0.00,0,0,0,0,0,0,0,0,0,0,0,0,0
20200312,050291,聯發科凱基94購16,0.13,0.13,0.13,0.13,-0.37,-74.0,8000,1,1040,0,0,0,0,0,0,0,8000,-8000,-8000
20200312,050292,可成凱基94購11,,,,,0.00,0.00,0,0,0,0,0,0,0,0,0,0,0,0,0
20200312,050293,強茂凱基94購01,,,,,0.00,0.00,0,0,0,0,0,0,0,0,0,0,0,0,0
20200312,050294,宏達電凱基94購04,,,,,0.00,0.00,0,0,0,0,0,0,0,0,0,0,0,0,0
20200312,050295,大立光凱基94購16,,,,,0.00,0.00,0,0,0,0,0,0,0,0,0,0,0,0,0
20200312,050296,亞光凱基94購03,0.10,0.10,0.10,0.10,-0.17,-62.96,30000,3,3000,0,0,0,0,0,0,0,30000,-30000,-30000
20200312,050297,欣興凱基94購08,,,,,0.00,0.00,0,0,0,0,0,0,0,0,0,0,0,0,0
20200312,050298,智伸科凱基94購02,,,,,0.00,0.00,0,0,0,0,0,0,0,0,0,0,0,0,0
20200312,050299,康普凱基94購01,,,,,0.00,0.00,0,0,0,0,0,0,0,0,0,0,0,0,0
20200312,05029P,鴻海元富95售04,1.32,1.62,1.32,1.55,+0.51,49.04,131000,17,187350,0,0,0,0,0,0,53000,78000,-25000,-25000
20200312,050300,康控凱基94購03,,,,,0.00,0.00,0,0,0,0,0,0,0,0,0,0,0,0,0
20200312,050301,矽創凱基94購03,,,,,0.00,0.00,0,0,0,0,0,0,0,0,0,0,0,0,0
20200312,050302,百和凱基94購03,,,,,0.00,0.00,0,0,0,0,0,0,0,0,0,0,0,0,0
20200312,050303,S&P反1中信96購01,1.60,1.60,1.60,1.60,0.00,0.00,30000,1,48000,0,0,0,0,0,0,0,30000,-30000,-30000
20200312,050304,台光電中信94購01,0.08,0.08,0.07,0.07,-0.05,-41.67,350000,35,26500,0,0,0,0,0,0,0,339000,-339000,-339000
20200312,050305,正崴中信95購01,,,,,0.00,0.00,0,0,0,0,0,0,0,0,0,0,0,0,0
20200312,050306,聯發科中信97購01,0.37,0.37,0.25,0.27,-0.24,-47.06,229000,7,70860,0,0,0,0,0,0,120000,109000,11000,11000
20200312,050307,欣興中信95購01,,,,,0.00,0.00,0,0,0,0,0,0,0,0,0,0,0,0,0
20200312,050308,矽創中信97購01,0.11,0.11,0.07,0.07,-0.09,-56.25,81000,2,8870,0,0,0,0,0,0,1000,80000,-79000,-79000
20200312,050309,亞泥兆豐94購01,,,,,0.00,0.00,0,0,0,0,0,0,0,0,0,0,0,0,0
20200312,05030P,台積電元富95售04,0.57,0.98,0.57,0.70,+0.21,42.86,246000,30,178680,0,0,0,0,0,0,94000,236000,-142000,-142000
20200312,050310,卜蜂兆豐94購01,,,,,0.00,0.00,0,0,0,0,0,0,0,0,0,0,0,0,0
20200312,050311,上銀兆豐95購01,0.84,0.84,0.84,0.84,0.00,0.00,4000,1,3360,0,0,0,0,0,0,0,4000,-4000,-4000
20200312,050312,大立光兆豐94購04,,,,,0.00,0.00,0,0,0,0,0,0,0,0,0,0,0,0,0
20200312,050313,大立光兆豐94購05,0.21,0.21,0.14,0.14,-0.28,-66.67,335000,12,53100,0,0,0,0,0,0,0,335000,-335000,-335000
20200312,050314,晶技兆豐94購01,,,,,0.00,0.00,0,0,0,0,0,0,0,0,0,0,0,0,0
20200312,050315,和碩兆豐95購01,0.55,0.55,0.41,0.43,-0.16,-27.12,61000,11,27100,0,0,0,0,0,0,3000,58000,-55000,-55000
20200312,050316,上証2X國票98購01,,,,,0.00,0.00,0,0,0,0,0,0,0,0,0,0,0,0,0
20200312,050317,和鑫國票95購02,,,,,0.00,0.00,0,0,0,0,0,0,0,0,0,0,0,0,0
20200312,050318,景碩國票94購02,,,,,0.00,0.00,0,0,0,0,0,0,0,0,0,0,0,0,0
20200312,050319,康控國票95購04,,,,,0.00,0.00,0,0,0,0,0,0,0,0,0,0,0,0,0
20200312,05031P,台光電元富95售01,0.41,0.51,0.41,0.51,+0.21,70.0,504000,12,231240,0,0,0,0,0,0,235000,459000,-224000,-224000
20200312,050320,台表科國票94購01,1.53,1.53,0.69,0.74,-1.01,-57.71,129000,13,124320,0,0,0,0,0,0,79000,50000,29000,29000
20200312,050321,GIS國票95購02,,,,,0.00,0.00,0,0,0,0,0,0,0,0,0,0,0,0,0
20200312,050322,世紀鋼國票95購01,1.50,1.55,1.45,1.55,-0.08,-4.91,272000,5,408050,0,0,0,0,0,0,142000,62000,80000,80000
20200312,050323,嘉聯益台新94購01,,,,,0.00,0.00,0,0,0,0,0,0,0,0,0,0,0,0,0
20200312,050324,訊芯台新94購01,,,,,0.00,0.00,0,0,0,0,0,0,0,0,0,0,0,0,0
20200312,050325,台積電永豐94購05,0.39,0.39,0.39,0.39,0.00,0.00,5000,1,1950,0,0,0,0,0,0,0,5000,-5000,-5000
20200312,050326,正崴永豐94購03,,,,,0.00,0.00,0,0,0,0,0,0,0,0,0,0,0,0,0
20200312,050327,泰鼎永豐94購03,0.58,0.61,0.58,0.61,-0.51,-45.54,87000,3,52340,0,0,0,0,0,0,87000,0,87000,87000
20200312,050328,臻鼎永豐94購03,,,,,0.00,0.00,0,0,0,0,0,0,0,0,0,0,0,0,0
20200312,050329,超眾永豐94購03,,,,,0.00,0.00,0,0,0,0,0,0,0,0,0,0,0,0,0
20200312,05032P,台積電國泰96售05,2.64,3.80,2.64,3.01,+1.09,56.77,71000,37,218020,0,0,0,0,0,0,71000,68000,3000,3000
20200312,050330,南電永豐94購01,,,,,0.00,0.00,0,0,0,0,0,0,0,0,0,0,0,0,0
20200312,050331,鈺齊永豐94購02,,,,,0.00,0.00,0,0,0,0,0,0,0,0,0,0,0,0,0
20200312,050332,鴻海國泰96購05,0.91,0.91,0.70,0.70,-0.56,-44.44,212000,5,183820,0,0,0,0,0,0,8000,206000,-198000,-198000
20200312,050333,鴻海國泰96購06,0.95,0.95,0.67,0.67,-0.61,-47.66,151000,6,130790,0,0,0,0,0,0,47000,144000,-97000,-97000
20200312,050334,鴻海國泰96購07,0.99,0.99,0.73,0.73,-0.50,-40.65,72000,6,67660,0,0,0,0,0,0,50000,22000,28000,28000
20200312,050335,正崴國泰96購01,0.13,0.13,0.13,0.13,0.00,0.00,5000,1,650,0,0,0,0,0,0,5000,0,5000,5000
20200312,050336,緯穎國泰94購02,,,,,0.00,0.00,0,0,0,0,0,0,0,0,0,0,0,0,0
20200312,050337,南電國泰95購01,0.65,0.65,0.65,0.65,-0.78,-54.55,26000,1,16900,0,0,0,0,0,0,26000,0,26000,26000
20200312,050338,TPK富邦96購01,,,,,0.00,0.00,0,0,0,0,0,0,0,0,0,0,0,0,0
20200312,050339,鴻海統一94購06,,,,,0.00,0.00,0,0,0,0,0,0,0,0,0,0,0,0,0
20200312,05033P,T50反1元大98售01,,,,,0.00,0.00,0,0,0,0,0,0,0,0,0,0,0,0,0
20200312,050340,鴻海統一94購07,,,,,0.00,0.00,0,0,0,0,0,0,0,0,0,0,0,0,0
20200312,050341,光寶科元富94購01,,,,,0.00,0.00,0,0,0,0,0,0,0,0,0,0,0,0,0
20200312,050342,華通元富94購02,,,,,0.00,0.00,0,0,0,0,0,0,0,0,0,0,0,0,0
20200312,050343,鴻海元富94購01,0.37,0.37,0.37,0.37,0.00,0.00,60000,1,22200,0,0,0,0,0,0,60000,0,60000,60000
20200312,050344,鴻海元富96購01,0.69,0.74,0.53,0.56,-0.38,-40.43,163000,12,93850,0,0,0,0,0,0,21000,142000,-121000,-121000
20200312,050345,創意元富94購02,,,,,0.00,0.00,0,0,0,0,0,0,0,0,0,0,0,0,0
20200312,050346,康友元富94購03,2.53,2.53,2.53,2.53,-0.67,-20.94,10000,1,25300,0,0,0,0,0,0,10000,0,10000,10000
20200312,050347,上証2X群益98購01,,,,,0.00,0.00,0,0,0,0,0,0,0,0,0,0,0,0,0
20200312,050348,鴻海群益94購06,0.34,0.39,0.34,0.39,-0.52,-57.14,3000,3,1090,0,0,0,0,0,0,3000,1000,2000,2000
20200312,050349,中環群益94購01,,,,,0.00,0.00,0,0,0,0,0,0,0,0,0,0,0,0,0
20200312,05034P,台積電元大95售08,1.40,1.86,1.40,1.57,+0.35,28.69,842000,38,1328480,0,0,0,0,0,0,816000,726000,90000,90000
20200312,050350,全新群益94購04,0.03,0.03,0.03,0.03,-0.01,-25.0,11000,1,330,0,0,0,0,0,0,0,11000,-11000,-11000
20200312,050351,華新科群益95購02,1.60,1.60,0.82,1.07,-1.53,-58.85,104000,11,117640,0,0,0,0,0,0,14000,90000,-76000,-76000
20200312,050352,欣興群益95購01,,,,,0.00,0.00,0,0,0,0,0,0,0,0,0,0,0,0,0
20200312,050353,華擎群益95購01,1.29,1.29,1.29,1.29,-1.11,-46.25,29000,1,37410,0,0,0,0,0,0,29000,0,29000,29000
20200312,050354,瀚宇博群益94購02,,,,,0.00,0.00,0,0,0,0,0,0,0,0,0,0,0,0,0
20200312,050355,瑞儀群益94購01,,,,,0.00,0.00,0,0,0,0,0,0,0,0,0,0,0,0,0
20200312,050356,緯穎群益94購05,4.96,4.96,3.00,3.00,-4.00,-57.14,29000,5,127200,0,0,0,0,0,0,10000,19000,-9000,-9000
20200312,050357,南電群益94購02,0.15,0.15,0.15,0.15,-0.05,-25.0,10000,1,1500,0,0,0,0,0,0,10000,0,10000,10000
20200312,050358,致新群益94購01,,,,,0.00,0.00,0,0,0,0,0,0,0,0,0,0,0,0,0
20200312,050359,T50反1元大94購05,0.56,0.56,0.56,0.56,0.00,0.00,2000,1,1120,0,0,0,0,0,0,2000,0,2000,2000
20200312,05035P,聯發科元大95售06,2.38,3.18,2.38,3.02,+0.83,37.9,269000,21,750590,0,0,0,0,0,0,267000,209000,58000,58000
20200312,050360,T50反1元大94購06,0.61,1.00,0.61,1.00,+0.50,100.0,8000,7,6230,0,0,0,0,0,0,8000,0,8000,8000
20200312,050361,T50反1元大94購07,1.06,1.06,1.06,1.06,0.00,0.00,50000,1,53000,0,0,0,0,0,0,50000,0,50000,50000
20200312,050362,深中小元大94購04,,,,,0.00,0.00,0,0,0,0,0,0,0,0,0,0,0,0,0
20200312,050363,臺指反元大98購04,1.20,1.64,1.19,1.44,+0.38,35.85,529000,51,714330,0,0,0,0,0,0,363000,50000,313000,313000
20200312,050364,卜蜂元大94購02,0.08,0.08,0.08,0.08,-0.06,-42.86,100000,1,8000,0,0,0,0,0,0,0,100000,-100000,-100000
20200312,050365,中石化元大94購02,,,,,0.00,0.00,0,0,0,0,0,0,0,0,0,0,0,0,0
20200312,050366,鴻海元大94購19,1.17,1.17,0.90,0.90,-0.73,-44.79,17000,3,18060,0,0,0,0,0,0,17000,0,17000,17000
20200312,050367,鴻海元大94購20,0.41,0.41,0.41,0.41,-0.39,-48.75,15000,1,6150,0,0,0,0,0,0,15000,0,15000,15000
20200312,050368,國巨元大94購14,1.32,1.32,0.78,0.78,-0.54,-40.91,187000,5,204540,0,0,0,0,0,0,18000,187000,-169000,-169000
20200312,050369,台積電元大94購23,2.11,2.11,1.72,1.72,-0.70,-28.93,78000,18,153450,0,0,0,0,0,0,43000,78000,-35000,-35000
20200312,05036P,義隆元大95售03,1.28,1.50,1.28,1.42,+0.24,20.34,354000,13,506990,0,0,0,0,0,0,189000,165000,24000,24000
20200312,050370,台積電元大94購24,1.00,1.18,1.00,1.18,-0.46,-28.05,60000,3,65400,0,0,0,0,0,0,30000,5000,25000,25000
20200312,050371,台積電元大94購25,1.38,1.38,1.32,1.32,0.00,0.00,20000,2,26460,0,0,0,0,0,0,20000,0,20000,20000
20200312,050372,全新元大96購03,,,,,0.00,0.00,0,0,0,0,0,0,0,0,0,0,0,0,0
20200312,050373,奇鋐元大94購04,,,,,0.00,0.00,0,0,0,0,0,0,0,0,0,0,0,0,0
20200312,050374,上緯控元大95購01,0.14,0.14,0.14,0.14,-0.11,-44.0,10000,1,1400,0,0,0,0,0,0,10000,0,10000,10000
20200312,050375,矽創元大94購02,,,,,0.00,0.00,0,0,0,0,0,0,0,0,0,0,0,0,0
20200312,050376,百和元大95購01,,,,,0.00,0.00,0,0,0,0,0,0,0,0,0,0,0,0,0
20200312,050377,華通第一94購01,0.15,0.15,0.13,0.14,-0.12,-46.15,37000,25,5160,0,0,0,0,0,0,37000,0,37000,37000
20200312,050378,上証2X群益98購02,0.42,0.42,0.32,0.35,-0.14,-28.57,1920000,44,709310,0,0,0,0,0,0,519000,1401000,-882000,-882000
20200312,050379,易華電群益96購01,,,,,0.00,0.00,0,0,0,0,0,0,0,0,0,0,0,0,0
20200312,05037P,華新科元大95售09,0.38,0.68,0.38,0.68,+0.34,100.0,268000,12,118560,0,0,0,0,0,0,140000,128000,12000,12000
20200312,050380,台積電亞東94購02,,,,,0.00,0.00,0,0,0,0,0,0,0,0,0,0,0,0,0
20200312,050381,鴻海兆豐94購01,,,,,0.00,0.00,0,0,0,0,0,0,0,0,0,0,0,0,0
20200312,050382,TPK兆豐95購02,,,,,0.00,0.00,0,0,0,0,0,0,0,0,0,0,0,0,0
20200312,050383,超眾兆豐95購01,0.55,0.55,0.55,0.55,-0.35,-38.89,43000,1,23650,0,0,0,0,0,0,0,43000,-43000,-43000
20200312,050384,嘉澤國票94購02,,,,,0.00,0.00,0,0,0,0,0,0,0,0,0,0,0,0,0
20200312,050385,貿聯國票95購02,0.53,0.54,0.52,0.54,-0.18,-25.0,18000,7,9580,0,0,0,0,0,0,18000,0,18000,18000
20200312,050386,智伸科國票94購01,,,,,0.00,0.00,0,0,0,0,0,0,0,0,0,0,0,0,0
20200312,050387,鴻海統一94購08,,,,,0.00,0.00,0,0,0,0,0,0,0,0,0,0,0,0,0
20200312,050388,鴻海統一94購09,,,,,0.00,0.00,0,0,0,0,0,0,0,0,0,0,0,0,0
20200312,050389,鴻海統一95購04,,,,,0.00,0.00,0,0,0,0,0,0,0,0,0,0,0,0,0
20200312,05038P,牧德元大95售03,0.45,0.49,0.45,0.49,0.00,0.00,966000,2,453380,0,0,0,0,0,0,0,966000,-966000,-966000
20200312,050390,聯發科統一94購09,0.12,0.12,0.06,0.06,-0.25,-80.65,150000,6,12290,0,0,0,0,0,0,20000,130000,-110000,-110000
20200312,050391,大立光統一94購07,,,,,0.00,0.00,0,0,0,0,0,0,0,0,0,0,0,0,0
20200312,050392,群創統一96購01,,,,,0.00,0.00,0,0,0,0,0,0,0,0,0,0,0,0,0
20200312,050393,樺漢統一94購01,0.20,0.20,0.09,0.09,-0.26,-74.29,64000,3,10080,0,0,0,0,0,0,56000,8000,48000,48000
20200312,050394,大立光元富94購09,0.05,0.05,0.05,0.05,0.00,0.00,200000,1,10000,0,0,0,0,0,0,0,200000,-200000,-200000
20200312,050395,大立光元富94購10,0.24,0.24,0.17,0.17,-0.52,-75.36,132000,4,31000,0,0,0,0,0,0,98000,34000,64000,64000
20200312,050396,欣興元富94購02,,,,,0.00,0.00,0,0,0,0,0,0,0,0,0,0,0,0,0
20200312,050397,力成元富94購01,0.34,0.34,0.27,0.27,-0.16,-37.21,110000,4,36000,0,0,0,0,0,0,90000,20000,70000,70000
20200312,050398,上証2X中信97購01,0.13,0.13,0.13,0.13,-0.04,-23.53,150000,3,19500,0,0,0,0,0,0,0,150000,-150000,-150000
20200312,050399,潤泰全中信95購01,0.12,0.12,0.12,0.12,-0.04,-25.0,200000,1,24000,0,0,0,0,0,0,0,200000,-200000,-200000
20200312,05039P,鴻海凱基95售10,0.83,1.00,0.78,1.00,+0.31,44.93,261000,14,238730,0,0,0,0,0,0,46000,218000,-172000,-172000
20200312,050400,臻鼎中信97購01,0.04,0.04,0.02,0.02,-0.03,-60.0,1084000,114,30280,0,0,0,0,0,0,0,1084000,-1084000,-1084000
20200312,050401,鎧勝中信94購01,,,,,0.00,0.00,0,0,0,0,0,0,0,0,0,0,0,0,0
20200312,050402,緯穎中信96購01,1.43,1.45,0.96,1.03,-0.67,-39.41,363000,27,415430,0,0,0,0,0,0,161000,202000,-41000,-41000
20200312,050403,台積電麥證94購02,0.85,0.85,0.85,0.85,0.00,0.00,2000,1,1700,0,2000,-2000,0,0,0,0,2000,-2000,-2000
20200312,050404,元大金麥證94購01,,,,,0.00,0.00,0,0,0,0,0,0,0,0,0,0,0,0,0
20200312,050405,新光金麥證94購01,,,,,0.00,0.00,0,0,0,0,0,0,0,0,0,0,0,0,0
20200312,050406,台積電台新95購02,1.06,1.14,1.02,1.06,-0.76,-41.76,242000,10,255470,0,0,0,0,0,0,0,242000,-242000,-242000
20200312,050407,聯詠台新94購02,,,,,0.00,0.00,0,0,0,0,0,0,0,0,0,0,0,0,0
20200312,050408,臻鼎台新94購02,,,,,0.00,0.00,0,0,0,0,0,0,0,0,0,0,0,0,0
20200312,050409,華通永豐94購01,,,,,0.00,0.00,0,0,0,0,0,0,0,0,0,0,0,0,0
20200312,05040P,聯發科凱基95售05,1.42,1.64,1.42,1.64,0.00,0.00,102000,2,145280,0,0,0,0,0,0,2000,100000,-98000,-98000
20200312,050410,燿華永豐95購03,,,,,0.00,0.00,0,0,0,0,0,0,0,0,0,0,0,0,0
20200312,050411,聯發科永豐94購05,,,,,0.00,0.00,0,0,0,0,0,0,0,0,0,0,0,0,0
20200312,050412,全新永豐94購04,,,,,0.00,0.00,0,0,0,0,0,0,0,0,0,0,0,0,0
20200312,050413,麗豐永豐94購01,,,,,0.00,0.00,0,0,0,0,0,0,0,0,0,0,0,0,0
20200312,050414,泰鼎永豐94購04,,,,,0.00,0.00,0,0,0,0,0,0,0,0,0,0,0,0,0
20200312,050415,力成永豐94購01,0.10,0.10,0.09,0.10,-0.13,-56.52,37000,19,3630,0,0,0,0,0,0,37000,0,37000,37000
20200312,050416,高股息凱基96購02,0.14,0.14,0.08,0.09,-0.09,-50.0,1367000,85,142020,0,0,0,0,0,0,40000,1108000,-1068000,-1068000
20200312,050417,喬山凱基94購01,,,,,0.00,0.00,0,0,0,0,0,0,0,0,0,0,0,0,0
20200312,050418,為升凱基94購06,,,,,0.00,0.00,0,0,0,0,0,0,0,0,0,0,0,0,0
20200312,050419,鴻海凱基95購02,0.59,0.59,0.39,0.42,-0.34,-44.74,35000,8,17160,0,0,0,0,0,0,5000,30000,-25000,-25000
20200312,05041P,大立光凱基95售09,0.86,1.15,0.86,1.15,+0.42,57.53,394000,14,422660,0,0,0,0,0,0,359000,33000,326000,326000
20200312,050420,鴻海凱基95購03,,,,,0.00,0.00,0,0,0,0,0,0,0,0,0,0,0,0,0
20200312,050421,鴻海凱基95購04,0.08,0.08,0.08,0.08,-0.04,-33.33,400000,2,32000,0,0,0,0,0,0,0,0,0,0
20200312,050422,鴻海凱基96購01,0.10,0.10,0.10,0.10,0.00,0.00,10000,1,1000,0,0,0,0,0,0,0,10000,-10000,-10000
20200312,050423,鴻海凱基96購02,0.12,0.12,0.10,0.10,0.00,0.00,210000,2,25000,0,0,0,0,0,0,0,210000,-210000,-210000
20200312,050424,鴻海凱基96購03,,,,,0.00,0.00,0,0,0,0,0,0,0,0,0,0,0,0,0
20200312,050425,國巨凱基94購12,1.75,1.75,1.50,1.55,-0.50,-24.39,26000,5,42120,0,0,0,0,0,0,16000,16000,0,0
20200312,050426,國巨凱基94購14,1.41,1.41,1.39,1.39,-1.87,-57.36,17000,2,23830,0,0,0,0,0,0,17000,17000,0,0
20200312,050427,台積電凱基94購34,1.65,1.65,1.19,1.21,-1.36,-52.92,500000,5,609000,0,0,0,0,0,0,0,500000,-500000,-500000
20200312,050428,光磊凱基94購05,,,,,0.00,0.00,0,0,0,0,0,0,0,0,0,0,0,0,0
20200312,050429,漢唐凱基94購04,,,,,0.00,0.00,0,0,0,0,0,0,0,0,0,0,0,0,0
20200312,05042P,GIS凱基95售03,,,,,0.00,0.00,0,0,0,0,0,0,0,0,0,0,0,0,0
20200312,050430,京元電凱基94購03,,,,,0.00,0.00,0,0,0,0,0,0,0,0,0,0,0,0,0
20200312,050431,聯發科凱基94購18,0.26,0.26,0.26,0.26,-0.42,-61.76,10000,1,2600,0,0,0,0,0,0,10000,10000,0,0
20200312,050432,聯發科凱基94購19,,,,,0.00,0.00,0,0,0,0,0,0,0,0,0,0,0,0,0
20200312,050433,華新科凱基94購11,,,,,0.00,0.00,0,0,0,0,0,0,0,0,0,0,0,0,0
20200312,050434,富邦金凱基94購02,,,,,0.00,0.00,0,0,0,0,0,0,0,0,0,0,0,0,0
20200312,050435,大立光凱基94購17,0.24,0.24,0.18,0.18,-0.53,-74.65,92000,4,21010,0,0,0,0,0,0,85000,7000,78000,78000
20200312,050436,大立光凱基94購18,,,,,0.00,0.00,0,0,0,0,0,0,0,0,0,0,0,0,0
20200312,050437,聯詠凱基94購04,0.48,0.48,0.44,0.44,-0.37,-45.68,240000,2,110400,0,0,0,0,0,0,120000,120000,0,0
20200312,050438,欣興凱基94購09,,,,,0.00,0.00,0,0,0,0,0,0,0,0,0,0,0,0,0
20200312,050439,新日興凱基94購01,0.49,0.49,0.48,0.48,-0.19,-28.36,176000,3,84980,0,0,0,0,0,0,176000,0,176000,176000
20200312,05043P,佳世達元富95售01,2.92,2.92,2.92,2.92,0.00,0.00,10000,1,29200,0,0,0,0,0,0,0,10000,-10000,-10000
20200312,050440,揚明光凱基94購05,,,,,0.00,0.00,0,0,0,0,0,0,0,0,0,0,0,0,0
20200312,050441,和碩凱基94購01,0.66,0.72,0.66,0.72,-0.37,-33.94,69000,6,45720,0,0,0,0,0,0,69000,0,69000,69000
20200312,050442,復盛凱基94購01,0.23,0.23,0.17,0.17,-0.15,-46.88,162000,4,28740,0,0,0,0,0,0,162000,0,162000,162000
20200312,050443,復盛凱基94購02,,,,,0.00,0.00,0,0,0,0,0,0,0,0,0,0,0,0,0
20200312,050444,卜蜂元大94購03,0.61,0.61,0.49,0.49,-0.24,-32.88,28000,4,15800,0,0,0,0,0,0,14000,14000,0,0
20200312,050445,鴻海元大94購21,0.08,0.08,0.08,0.08,-0.08,-50.0,510000,5,40800,0,0,0,0,0,0,0,360000,-360000,-360000
20200312,050446,鴻海元大94購22,,,,,0.00,0.00,0,0,0,0,0,0,0,0,0,0,0,0,0
20200312,050447,廣達元大94購01,1.02,1.02,0.86,0.86,0.00,0.00,201000,3,188860,0,0,0,0,0,0,1000,200000,-199000,-199000
20200312,050448,義隆元大94購04,,,,,0.00,0.00,0,0,0,0,0,0,0,0,0,0,0,0,0
20200312,050449,宏達電元大95購03,,,,,0.00,0.00,0,0,0,0,0,0,0,0,0,0,0,0,0
20200312,05044P,亞德客永豐95售01,,,,,0.00,0.00,0,0,0,0,0,0,0,0,0,0,0,0,0
20200312,050450,富邦金元大94購03,,,,,0.00,0.00,0,0,0,0,0,0,0,0,0,0,0,0,0
20200312,050451,嘉晶元大95購01,1.10,1.16,0.83,0.88,-0.28,-24.14,253000,27,254180,0,0,0,0,0,0,132000,143000,-11000,-11000
20200312,050452,智原元大95購04,,,,,0.00,0.00,0,0,0,0,0,0,0,0,0,0,0,0,0
20200312,050453,創意元大95購03,,,,,0.00,0.00,0,0,0,0,0,0,0,0,0,0,0,0,0
20200312,050454,嘉澤元大94購04,0.40,0.40,0.27,0.27,-0.30,-52.63,182000,9,66230,0,0,0,0,0,0,155000,27000,128000,128000
20200312,050455,貿聯元大94購02,0.31,0.31,0.31,0.31,-0.08,-20.51,30000,1,9300,0,0,0,0,0,0,30000,0,30000,30000
20200312,050456,聯茂元大94購09,0.55,0.55,0.55,0.55,-0.23,-29.49,68000,1,37400,0,0,0,0,0,0,0,68000,-68000,-68000
20200312,050457,力成元大94購01,0.88,0.88,0.62,0.62,-0.90,-59.21,196000,4,134440,0,0,0,0,0,0,98000,98000,0,0
20200312,050458,台郡元大94購03,2.68,2.68,2.04,2.04,-2.07,-50.36,93000,4,223620,0,0,0,0,0,0,3000,93000,-90000,-90000
20200312,050459,台表科元大94購03,1.53,1.55,0.94,0.94,-1.00,-51.55,64000,8,88080,0,0,0,0,0,0,64000,4000,60000,60000
20200312,05045P,台積電永豐95售01,0.32,0.39,0.29,0.34,0.00,0.00,500000,32,169320,0,0,0,0,0,0,0,500000,-500000,-500000
20200312,050460,GIS元大95購03,,,,,0.00,0.00,0,0,0,0,0,0,0,0,0,0,0,0,0
20200312,050461,GIS元大95購04,0.07,0.07,0.07,0.07,0.00,0.00,20000,1,1400,0,0,0,0,0,0,0,20000,-20000,-20000
20200312,050462,寶成元大94購01,,,,,0.00,0.00,0,0,0,0,0,0,0,0,0,0,0,0,0
20200312,050463,百和元大94購04,0.44,0.44,0.33,0.33,-0.30,-47.62,61000,4,25000,0,0,0,0,0,0,61000,14000,47000,47000
20200312,050464,華通國泰95購01,0.91,0.91,0.49,0.49,-0.50,-50.51,180000,18,119980,0,0,0,0,0,0,82000,98000,-16000,-16000
20200312,050465,神基中信94購01,,,,,0.00,0.00,0,0,0,0,0,0,0,0,0,0,0,0,0
20200312,050466,瑞儀中信94購01,,,,,0.00,0.00,0,0,0,0,0,0,0,0,0,0,0,0,0
20200312,050467,力成中信94購01,0.07,0.07,0.03,0.05,-0.06,-54.55,145000,53,7650,0,0,0,0,0,0,125000,20000,105000,105000
20200312,050468,矽格中信94購01,,,,,0.00,0.00,0,0,0,0,0,0,0,0,0,0,0,0,0
20200312,050469,聯電台新94購01,,,,,0.00,0.00,0,0,0,0,0,0,0,0,0,0,0,0,0
20200312,05046P,台光電永豐95售02,0.83,0.92,0.83,0.92,+0.21,29.58,90000,8,79100,0,0,0,0,0,0,0,60000,-60000,-60000
20200312,050470,智邦台新94購01,,,,,0.00,0.00,0,0,0,0,0,0,0,0,0,0,0,0,0
20200312,050471,國泰金台新94購01,,,,,0.00,0.00,0,0,0,0,0,0,0,0,0,0,0,0,0
20200312,050472,和大永豐94購01,,,,,0.00,0.00,0,0,0,0,0,0,0,0,0,0,0,0,0
20200312,050473,劍麟永豐94購02,,,,,0.00,0.00,0,0,0,0,0,0,0,0,0,0,0,0,0
20200312,050474,鴻海永豐94購05,,,,,0.00,0.00,0,0,0,0,0,0,0,0,0,0,0,0,0
20200312,050475,揚明光永豐95購01,,,,,0.00,0.00,0,0,0,0,0,0,0,0,0,0,0,0,0
20200312,050476,瑞儀永豐94購01,,,,,0.00,0.00,0,0,0,0,0,0,0,0,0,0,0,0,0
20200312,050477,矽力永豐94購01,0.77,0.77,0.58,0.66,-0.43,-39.45,189000,34,123170,0,0,0,0,0,0,102000,56000,46000,46000
20200312,050478,致新永豐94購02,,,,,0.00,0.00,0,0,0,0,0,0,0,0,0,0,0,0,0
20200312,050479,上証2X國票95購02,0.02,0.02,0.02,0.02,-0.05,-71.43,10000,1,200,0,0,0,0,0,0,10000,0,10000,10000
20200312,05047P,強茂永豐95售02,1.44,1.61,1.44,1.61,0.00,0.00,20000,2,30500,0,0,0,0,0,0,0,20000,-20000,-20000
20200312,050480,健策國票95購04,2.17,2.17,2.14,2.14,0.00,0.00,11000,2,23840,0,0,0,0,0,0,0,11000,-11000,-11000
20200312,050481,泰鼎國票96購01,1.47,1.47,1.47,1.47,-0.72,-32.88,100000,1,147000,0,0,0,0,0,0,100000,0,100000,100000
20200312,050482,台郡國票94購04,,,,,0.00,0.00,0,0,0,0,0,0,0,0,0,0,0,0,0
20200312,050483,樺漢國票94購01,0.86,0.86,0.79,0.79,-0.49,-38.28,30000,2,25100,0,0,0,0,0,0,20000,10000,10000,10000
20200312,050484,世紀鋼國票95購02,1.26,1.30,1.18,1.30,-0.22,-14.47,80000,9,100100,0,0,0,0,0,0,0,80000,-80000,-80000
20200312,050485,國巨統一96購01,2.82,2.82,2.32,2.32,0.00,0.00,468000,8,1128530,0,0,0,0,0,0,388000,19000,369000,369000
20200312,050486,可成元富94購05,,,,,0.00,0.00,0,0,0,0,0,0,0,0,0,0,0,0,0
20200312,050487,美食元富94購01,,,,,0.00,0.00,0,0,0,0,0,0,0,0,0,0,0,0,0
20200312,050488,美食元富94購02,,,,,0.00,0.00,0,0,0,0,0,0,0,0,0,0,0,0,0
20200312,050489,聯詠元富94購01,0.66,0.66,0.66,0.66,-0.27,-29.03,50000,1,33000,0,0,0,0,0,0,50000,0,50000,50000
20200312,05048P,同欣電永豐95售01,0.50,0.54,0.50,0.54,0.00,0.00,24000,2,12480,0,0,0,0,0,0,0,24000,-24000,-24000
20200312,050490,上証2X國泰95購01,,,,,0.00,0.00,0,0,0,0,0,0,0,0,0,0,0,0,0
20200312,050491,旺宏國泰96購01,1.05,1.05,0.73,0.80,-0.32,-28.57,109000,11,93100,0,0,0,0,0,0,26000,97000,-71000,-71000
20200312,050492,漢唐國泰96購01,,,,,0.00,0.00,0,0,0,0,0,0,0,0,0,0,0,0,0
20200312,050493,聯發科永昌96購01,0.41,0.41,0.30,0.33,-0.32,-49.23,285000,14,92850,0,0,0,0,0,0,20000,265000,-245000,-245000
20200312,050494,可成永昌96購01,,,,,0.00,0.00,0,0,0,0,0,0,0,0,0,0,0,0,0
20200312,050495,大立光永昌96購01,1.55,1.55,1.20,1.20,-1.28,-51.61,275000,8,389510,0,0,0,0,0,0,267000,220000,47000,47000
20200312,050496,鴻海富邦96購01,0.20,0.21,0.20,0.21,-0.09,-30.0,10000,2,2050,0,0,0,0,0,0,0,0,0,0
20200312,050497,臺指反凱基96購02,0.41,0.65,0.41,0.55,+0.23,71.87,75000,5,39550,0,0,0,0,0,0,75000,0,75000,75000
20200312,050498,為升凱基94購07,,,,,0.00,0.00,0,0,0,0,0,0,0,0,0,0,0,0,0
20200312,050499,台達電凱基94購11,,,,,0.00,0.00,0,0,0,0,0,0,0,0,0,0,0,0,0
20200312,05049P,矽創永豐95售01,1.21,1.30,1.17,1.30,0.00,0.00,60000,6,74900,0,0,0,0,0,0,0,60000,-60000,-60000
20200312,050500,台積電凱基94購36,0.31,0.31,0.30,0.30,-0.22,-42.31,366000,5,112490,0,0,0,0,0,0,274000,92000,182000,182000
20200312,050501,佳世達凱基94購03,,,,,0.00,0.00,0,0,0,0,0,0,0,0,0,0,0,0,0
20200312,050502,聯發科凱基94購21,,,,,0.00,0.00,0,0,0,0,0,0,0,0,0,0,0,0,0
20200312,050503,聯發科凱基94購22,,,,,0.00,0.00,0,0,0,0,0,0,0,0,0,0,0,0,0
20200312,050504,全新凱基94購03,,,,,0.00,0.00,0,0,0,0,0,0,0,0,0,0,0,0,0
20200312,050505,可成凱基94購12,,,,,0.00,0.00,0,0,0,0,0,0,0,0,0,0,0,0,0
20200312,050506,奇鋐凱基94購02,,,,,0.00,0.00,0,0,0,0,0,0,0,0,0,0,0,0,0
20200312,050507,聯詠凱基94購06,,,,,0.00,0.00,0,0,0,0,0,0,0,0,0,0,0,0,0
20200312,050508,上証2X元大97購01,0.31,0.31,0.31,0.31,-0.15,-32.61,160000,2,49600,0,0,0,0,0,0,0,160000,-160000,-160000
20200312,050509,元油2X元大94購09,,,,,0.00,0.00,0,0,0,0,0,0,0,0,0,0,0,0,0
20200312,05050P,華通群益96售02,2.28,2.59,2.25,2.59,+0.70,37.04,79000,7,185030,0,0,0,0,0,0,71000,8000,63000,63000
20200312,050510,元油2X元大94購10,,,,,0.00,0.00,0,0,0,0,0,0,0,0,0,0,0,0,0
20200312,050511,元油2X元大94購11,,,,,0.00,0.00,0,0,0,0,0,0,0,0,0,0,0,0,0
20200312,050512,台泥元大94購01,1.07,1.07,0.90,0.90,-0.35,-28.0,12000,2,12500,0,0,0,0,0,0,12000,2000,10000,10000
20200312,050513,亞泥元大94購02,0.40,0.43,0.38,0.42,-0.23,-35.38,621000,8,254300,0,0,0,0,0,0,151000,540000,-389000,-389000
20200312,050514,聯電元大94購01,0.49,0.49,0.49,0.49,-0.47,-48.96,40000,2,19600,0,0,0,0,0,0,0,40000,-40000,-40000
20200312,050515,聯電元大96購01,0.72,0.72,0.72,0.72,-0.30,-29.41,10000,1,7200,0,0,0,0,0,0,0,10000,-10000,-10000
20200312,050516,華通元大95購05,0.31,0.31,0.28,0.28,0.00,0.00,84000,3,24000,0,0,0,0,0,0,44000,40000,4000,4000
20200312,050517,台積電元大94購27,,,,,0.00,0.00,0,0,0,0,0,0,0,0,0,0,0,0,0
20200312,050518,台積電元大94購28,0.45,0.45,0.40,0.40,-0.40,-50.0,312000,2,129650,0,0,0,0,0,0,312000,0,312000,312000
20200312,050519,旺宏元大95購03,0.86,0.87,0.57,0.57,-0.40,-41.24,332000,17,232020,0,0,0,0,0,0,142000,193000,-51000,-51000
20200312,05051P,鴻海群益95售05,3.52,3.60,3.52,3.60,+0.60,20.0,49000,3,175410,0,0,0,0,0,0,20000,29000,-9000,-9000
20200312,050520,凌陽元大94購02,,,,,0.00,0.00,0,0,0,0,0,0,0,0,0,0,0,0,0
20200312,050521,聯發科元大94購15,0.18,0.20,0.11,0.11,-0.17,-60.71,490000,5,91100,0,0,0,0,0,0,300000,190000,110000,110000
20200312,050522,聯發科元大95購03,1.31,1.31,0.70,0.81,-0.54,-40.0,736000,26,656930,0,0,0,0,0,0,362000,716000,-354000,-354000
20200312,050523,義隆元大94購05,,,,,0.00,0.00,0,0,0,0,0,0,0,0,0,0,0,0,0
20200312,050524,宏達電元大95購04,,,,,0.00,0.00,0,0,0,0,0,0,0,0,0,0,0,0,0
20200312,050525,嘉晶元大95購02,0.60,0.66,0.43,0.46,-0.13,-22.03,268000,10,145020,0,0,0,0,0,0,85000,183000,-98000,-98000
20200312,050526,貿聯元大95購01,0.19,0.19,0.19,0.19,-0.11,-36.67,80000,2,15200,0,0,0,0,0,0,80000,0,80000,80000
20200312,050527,嘉聯益元大96購01,,,,,0.00,0.00,0,0,0,0,0,0,0,0,0,0,0,0,0
20200312,050528,瑞儀元大94購02,,,,,0.00,0.00,0,0,0,0,0,0,0,0,0,0,0,0,0
20200312,050529,矽格元大94購05,0.40,0.40,0.36,0.36,-0.15,-29.41,78000,2,28480,0,0,0,0,0,0,10000,68000,-58000,-58000
20200312,05052P,友達群益97售01,0.47,0.47,0.47,0.47,0.00,0.00,5000,1,2350,0,0,0,0,0,0,5000,0,5000,5000
20200312,050530,台表科元大95購04,0.73,0.73,0.66,0.68,-0.20,-22.73,100000,10,69500,0,0,0,0,0,0,100000,0,100000,100000
20200312,050531,訊芯元大95購02,0.04,0.04,0.04,0.04,-0.06,-60.0,90000,9,3600,0,0,0,0,0,0,0,90000,-90000,-90000
20200312,050532,矽創元大94購03,,,,,0.00,0.00,0,0,0,0,0,0,0,0,0,0,0,0,0
20200312,050533,致新元大94購03,0.12,0.12,0.10,0.10,-0.14,-58.33,12000,2,1240,0,0,0,0,0,0,12000,0,12000,12000
20200312,050534,臻鼎兆豐94購01,,,,,0.00,0.00,0,0,0,0,0,0,0,0,0,0,0,0,0
20200312,050535,台表科群益94購02,0.13,0.13,0.11,0.11,0.00,0.00,20000,2,2400,0,0,0,0,0,0,0,20000,-20000,-20000
20200312,050536,亞泥凱基95購01,,,,,0.00,0.00,0,0,0,0,0,0,0,0,0,0,0,0,0
20200312,050537,鴻海凱基95購05,0.74,0.74,0.53,0.57,-0.48,-45.71,11000,9,6930,0,0,0,0,0,0,7000,11000,-4000,-4000
20200312,050538,鴻海凱基95購06,,,,,0.00,0.00,0,0,0,0,0,0,0,0,0,0,0,0,0
20200312,050539,鴻海凱基95購07,,,,,0.00,0.00,0,0,0,0,0,0,0,0,0,0,0,0,0
20200312,05053P,新日興群益95售01,0.37,0.37,0.37,0.37,+0.03,8.82,50000,1,18500,0,0,0,0,0,0,50000,0,50000,50000
20200312,050540,台積電凱基94購38,0.58,0.58,0.49,0.55,-0.31,-36.05,514000,6,259250,0,0,0,0,0,0,79000,435000,-356000,-356000
20200312,050541,智邦凱基94購04,,,,,0.00,0.00,0,0,0,0,0,0,0,0,0,0,0,0,0
20200312,050542,宏碁凱基95購01,,,,,0.00,0.00,0,0,0,0,0,0,0,0,0,0,0,0,0
20200312,050543,聯發科凱基95購01,0.42,0.43,0.23,0.24,-0.31,-56.36,183000,18,59050,0,0,0,0,0,0,40000,143000,-103000,-103000
20200312,050544,聯發科凱基95購02,0.15,0.15,0.13,0.13,-0.29,-69.05,120000,3,17600,0,0,0,0,0,0,0,120000,-120000,-120000
20200312,050545,奇力新凱基95購01,,,,,0.00,0.00,0,0,0,0,0,0,0,0,0,0,0,0,0
20200312,050546,可成凱基94購13,,,,,0.00,0.00,0,0,0,0,0,0,0,0,0,0,0,0,0
20200312,050547,華新科凱基95購01,1.00,1.00,1.00,1.00,-0.34,-25.37,13000,1,13000,0,0,0,0,0,0,13000,13000,0,0
20200312,050548,華固凱基95購01,0.87,0.95,0.87,0.93,+0.08,9.41,353000,11,315240,0,0,0,0,0,0,248000,105000,143000,143000
20200312,050549,慧洋凱基95購01,,,,,0.00,0.00,0,0,0,0,0,0,0,0,0,0,0,0,0
20200312,05054P,臻鼎群益95售02,4.28,4.88,4.28,4.88,+2.15,78.75,30000,3,137400,0,0,0,0,0,0,0,30000,-30000,-30000
20200312,050550,大立光凱基95購04,,,,,0.00,0.00,0,0,0,0,0,0,0,0,0,0,0,0,0
20200312,050551,大立光凱基95購05,0.48,0.48,0.48,0.48,0.00,0.00,35000,1,16800,0,0,0,0,0,0,0,35000,-35000,-35000
20200312,050552,禾伸堂凱基94購05,0.29,0.36,0.29,0.31,+0.05,19.23,115000,4,35050,0,0,0,0,0,0,0,115000,-115000,-115000
20200312,050553,緯穎凱基94購06,3.77,3.77,2.23,2.50,-1.76,-41.31,262000,11,818850,0,0,0,0,0,0,123000,139000,-16000,-16000
20200312,050554,百和凱基95購01,0.21,0.21,0.19,0.19,0.00,0.00,152000,4,29650,0,0,0,0,0,0,152000,152000,0,0
20200312,050555,道瓊銀統一94購01,,,,,0.00,0.00,0,0,0,0,0,0,0,0,0,0,0,0,0
20200312,050556,道瓊銀統一95購01,,,,,0.00,0.00,0,0,0,0,0,0,0,0,0,0,0,0,0
20200312,050557,台積電統一94購13,,,,,0.00,0.00,0,0,0,0,0,0,0,0,0,0,0,0,0
20200312,050558,台積電統一94購14,0.23,0.26,0.14,0.26,-0.15,-36.59,184000,7,35560,0,0,0,0,0,0,144000,30000,114000,114000
20200312,050559,聯發科統一94購10,0.03,0.03,0.02,0.02,-0.03,-60.0,179000,6,4380,0,0,0,0,0,0,0,94000,-94000,-94000
20200312,05055P,台表科群益95售01,1.31,1.31,1.31,1.31,+0.11,9.17,20000,1,26200,0,0,0,0,0,0,20000,0,20000,20000
20200312,050560,聯詠統一94購02,,,,,0.00,0.00,0,0,0,0,0,0,0,0,0,0,0,0,0
20200312,050561,上証2X元富97購01,,,,,0.00,0.00,0,0,0,0,0,0,0,0,0,0,0,0,0
20200312,050562,瑞昱元富94購02,0.07,0.07,0.07,0.07,0.00,0.00,88000,1,6160,0,0,0,0,0,0,88000,0,88000,88000
20200312,050563,臻鼎元富94購07,,,,,0.00,0.00,0,0,0,0,0,0,0,0,0,0,0,0,0
20200312,050564,臻鼎元富94購08,,,,,0.00,0.00,0,0,0,0,0,0,0,0,0,0,0,0,0
20200312,050565,矽格元富94購01,0.23,0.23,0.23,0.23,-0.12,-34.29,100000,2,23000,0,0,0,0,0,0,100000,0,100000,100000
20200312,050566,高股息中信97購02,0.23,0.23,0.12,0.14,-0.17,-54.84,745000,22,115980,0,0,0,0,0,0,0,745000,-745000,-745000
20200312,050567,道瓊銀中信96購01,,,,,0.00,0.00,0,0,0,0,0,0,0,0,0,0,0,0,0
20200312,050568,為升中信97購01,,,,,0.00,0.00,0,0,0,0,0,0,0,0,0,0,0,0,0
20200312,050569,英業達中信94購01,,,,,0.00,0.00,0,0,0,0,0,0,0,0,0,0,0,0,0
20200312,05056P,訊芯群益95售01,2.28,2.28,2.28,2.28,+0.37,19.37,40000,2,91200,0,0,0,0,0,0,40000,0,40000,40000
20200312,050570,聯發科中信97購02,,,,,0.00,0.00,0,0,0,0,0,0,0,0,0,0,0,0,0
20200312,050571,美食中信95購01,,,,,0.00,0.00,0,0,0,0,0,0,0,0,0,0,0,0,0
20200312,050572,大立光中信97購01,0.27,0.27,0.20,0.22,-0.32,-59.26,20000,5,4440,0,0,0,0,0,0,0,20000,-20000,-20000
20200312,050573,光寶科國票94購01,,,,,0.00,0.00,0,0,0,0,0,0,0,0,0,0,0,0,0
20200312,050574,微星國票94購01,,,,,0.00,0.00,0,0,0,0,0,0,0,0,0,0,0,0,0
20200312,050575,南亞科國票94購01,0.54,0.54,0.43,0.43,-0.94,-68.61,20000,2,9700,0,0,0,0,0,0,0,20000,-20000,-20000
20200312,050576,南亞科國票95購01,,,,,0.00,0.00,0,0,0,0,0,0,0,0,0,0,0,0,0
20200312,050577,美律國票94購03,,,,,0.00,0.00,0,0,0,0,0,0,0,0,0,0,0,0,0
20200312,050578,聯發科國票95購03,0.15,0.15,0.10,0.10,-0.13,-56.52,170000,9,21540,0,0,0,0,0,0,0,170000,-170000,-170000
20200312,050579,聯發科國票95購04,0.64,0.64,0.36,0.37,-0.53,-58.89,354000,18,158590,0,0,0,0,0,0,63000,291000,-228000,-228000
20200312,05057P,鴻海國票96售01,1.94,2.26,1.94,2.21,+0.53,31.55,65000,5,137500,0,0,0,0,0,0,35000,45000,-10000,-10000
20200312,050580,強茂國票95購01,0.07,0.07,0.07,0.07,0.00,0.00,30000,1,2100,0,0,0,0,0,0,30000,0,30000,30000
20200312,050581,美食國票94購02,,,,,0.00,0.00,0,0,0,0,0,0,0,0,0,0,0,0,0
20200312,050582,傳奇國票94購01,,,,,0.00,0.00,0,0,0,0,0,0,0,0,0,0,0,0,0
20200312,050583,瑞儀國票94購01,,,,,0.00,0.00,0,0,0,0,0,0,0,0,0,0,0,0,0
20200312,050584,瑞儀國票95購01,,,,,0.00,0.00,0,0,0,0,0,0,0,0,0,0,0,0,0
20200312,050585,矽格國票94購01,,,,,0.00,0.00,0,0,0,0,0,0,0,0,0,0,0,0,0
20200312,050586,康友國票94購01,2.36,2.37,1.71,1.71,-0.97,-36.19,70000,4,146500,0,0,0,0,0,0,40000,30000,10000,10000
20200312,050587,緯穎國票94購02,,,,,0.00,0.00,0,0,0,0,0,0,0,0,0,0,0,0,0
20200312,050588,矽創國票95購01,,,,,0.00,0.00,0,0,0,0,0,0,0,0,0,0,0,0,0
20200312,050589,昇陽半國票94購02,,,,,0.00,0.00,0,0,0,0,0,0,0,0,0,0,0,0,0
20200312,05058P,燿華國票97售01,1.68,1.88,1.68,1.88,0.00,0.00,35000,4,61500,0,0,0,0,0,0,5000,30000,-25000,-25000
20200312,050590,晶技永豐95購01,2.19,2.19,1.26,1.26,-0.89,-41.4,404000,32,758260,0,0,0,0,0,0,309000,24000,285000,285000
20200312,050591,智易永豐94購04,,,,,0.00,0.00,0,0,0,0,0,0,0,0,0,0,0,0,0
20200312,050592,矽格永豐94購02,,,,,0.00,0.00,0,0,0,0,0,0,0,0,0,0,0,0,0
20200312,050593,台表科永豐94購03,,,,,0.00,0.00,0,0,0,0,0,0,0,0,0,0,0,0,0
20200312,050594,康友永豐94購01,1.56,1.56,1.20,1.20,-0.74,-38.14,21000,2,29160,0,0,0,0,0,0,11000,10000,1000,1000
20200312,050595,緯穎永豐94購03,1.42,1.42,1.13,1.13,-0.96,-45.93,20000,2,25500,0,0,0,0,0,0,10000,10000,0,0
20200312,050596,昇陽半永豐94購03,,,,,0.00,0.00,0,0,0,0,0,0,0,0,0,0,0,0,0
20200312,050597,聯電麥證94購01,0.59,0.74,0.59,0.74,-0.44,-37.29,259000,8,185260,209000,50000,159000,0,0,0,209000,50000,159000,159000
20200312,050598,友達麥證94購01,0.42,0.42,0.42,0.42,-0.15,-26.32,10000,1,4200,10000,0,10000,0,0,0,10000,0,10000,10000
20200312,050599,美食麥證94購01,,,,,0.00,0.00,0,0,0,0,0,0,0,0,0,0,0,0,0
20200312,05059P,大立光國票96售02,1.54,1.67,1.54,1.67,+0.52,45.22,12000,3,18620,0,0,0,0,0,0,10000,2000,8000,8000
20200312,050600,瑞儀國泰95購01,,,,,0.00,0.00,0,0,0,0,0,0,0,0,0,0,0,0,0
20200312,050601,台表科國泰96購01,0.71,0.72,0.41,0.42,-0.30,-41.67,216000,31,132760,0,0,0,0,0,0,131000,85000,46000,46000
20200312,050602,訊芯國泰96購01,,,,,0.00,0.00,0,0,0,0,0,0,0,0,0,0,0,0,0
20200312,050603,致新國泰96購01,0.34,0.34,0.26,0.28,-0.15,-34.88,50000,6,14900,0,0,0,0,0,0,35000,15000,20000,20000
20200312,050604,上証2X永昌94購01,,,,,0.00,0.00,0,0,0,0,0,0,0,0,0,0,0,0,0
20200312,050605,上証2X元大97購02,,,,,0.00,0.00,0,0,0,0,0,0,0,0,0,0,0,0,0
20200312,050606,劍麟元大94購02,,,,,0.00,0.00,0,0,0,0,0,0,0,0,0,0,0,0,0
20200312,050607,為升元大94購10,,,,,0.00,0.00,0,0,0,0,0,0,0,0,0,0,0,0,0
20200312,050608,台達電元大94購12,0.34,0.34,0.34,0.34,-0.17,-33.33,136000,2,46240,0,0,0,0,0,0,68000,68000,0,0
20200312,050609,鴻海元大94購23,1.01,1.01,0.71,0.71,-0.77,-52.03,70000,3,50300,0,0,0,0,0,0,2000,70000,-68000,-68000
20200312,05060P,台達電富邦97售02,0.75,0.94,0.75,0.89,+0.19,27.14,69000,15,55500,0,0,0,0,0,0,18000,51000,-33000,-33000
20200312,050610,鴻海元大94購24,0.42,0.42,0.33,0.33,-0.51,-60.71,88000,3,35160,0,0,0,0,0,0,0,88000,-88000,-88000
20200312,050611,鴻海元大95購02,,,,,0.00,0.00,0,0,0,0,0,0,0,0,0,0,0,0,0
20200312,050612,台積電元大95購06,,,,,0.00,0.00,0,0,0,0,0,0,0,0,0,0,0,0,0
20200312,050613,台光電元大94購09,0.37,0.37,0.23,0.23,-0.18,-43.9,359000,3,121470,0,0,0,0,0,0,10000,349000,-339000,-339000
20200312,050614,聯發科元大95購04,0.25,0.26,0.21,0.21,0.00,0.00,155000,4,35650,0,0,0,0,0,0,55000,105000,-50000,-50000
20200312,050615,奇力新元大95購03,2.36,2.36,1.64,1.74,-1.13,-39.37,17000,4,33800,0,0,0,0,0,0,16000,1000,15000,15000
20200312,050616,潤泰全元大94購01,0.29,0.29,0.29,0.29,-0.08,-21.62,299000,3,86710,0,0,0,0,0,0,0,299000,-299000,-299000
20200312,050617,神基元大94購01,0.52,0.57,0.48,0.57,-0.08,-12.31,356000,11,191860,0,0,0,0,0,0,163000,193000,-30000,-30000
20200312,050618,緯創元大95購01,0.51,0.51,0.26,0.26,-0.29,-52.73,28000,3,10780,0,0,0,0,0,0,8000,28000,-20000,-20000
20200312,050619,TPK元大95購02,,,,,0.00,0.00,0,0,0,0,0,0,0,0,0,0,0,0,0
20200312,05061P,鴻海富邦96售03,1.15,1.35,1.15,1.35,0.00,0.00,19000,3,23700,0,0,0,0,0,0,19000,0,19000,19000
20200312,050620,和碩元大94購04,0.49,0.49,0.33,0.33,-0.46,-58.23,113000,6,43490,0,0,0,0,0,0,25000,98000,-73000,-73000
20200312,050621,易華電元大95購01,,,,,0.00,0.00,0,0,0,0,0,0,0,0,0,0,0,0,0
20200312,050622,昇陽半元大94購05,,,,,0.00,0.00,0,0,0,0,0,0,0,0,0,0,0,0,0
20200312,050623,致新元大94購05,,,,,0.00,0.00,0,0,0,0,0,0,0,0,0,0,0,0,0
20200312,050624,鈺齊元大94購01,0.31,0.31,0.31,0.31,-0.11,-26.19,10000,1,3100,0,0,0,0,0,0,0,10000,-10000,-10000
20200312,050625,康控第一94購01,,,,,0.00,0.00,0,0,0,0,0,0,0,0,0,0,0,0,0
20200312,050626,A50正2中信96購02,,,,,0.00,0.00,0,0,0,0,0,0,0,0,0,0,0,0,0
20200312,050627,華通中信94購02,0.56,0.56,0.44,0.44,-0.34,-43.59,32000,10,15930,0,0,0,0,0,0,32000,10000,22000,22000
20200312,050628,美律中信94購02,,,,,0.00,0.00,0,0,0,0,0,0,0,0,0,0,0,0,0
20200312,050629,廣宇亞東96購01,,,,,0.00,0.00,0,0,0,0,0,0,0,0,0,0,0,0,0
20200312,05062P,大立光富邦98售03,0.82,1.03,0.81,1.03,+0.25,32.05,259000,15,238250,0,0,0,0,0,0,208000,29000,179000,179000
20200312,050630,大立光亞東96購01,0.88,0.88,0.72,0.72,0.00,0.00,177000,3,128790,0,0,0,0,0,0,174000,177000,-3000,-3000
20200312,050631,矽創亞東94購01,,,,,0.00,0.00,0,0,0,0,0,0,0,0,0,0,0,0,0
20200312,050632,國巨群益94購07,2.34,2.34,0.89,0.89,-1.60,-64.26,190000,12,355190,0,0,0,0,0,0,139000,49000,90000,90000
20200312,050633,義隆群益96購02,0.29,0.29,0.26,0.26,-0.14,-35.0,31000,3,8580,0,0,0,0,0,0,11000,20000,-9000,-9000
20200312,050634,華新科群益96購01,2.08,2.08,1.36,1.36,-0.96,-41.38,44000,5,79490,0,0,0,0,0,0,34000,30000,4000,4000
20200312,050635,昇陽半群益94購04,,,,,0.00,0.00,0,0,0,0,0,0,0,0,0,0,0,0,0
20200312,050636,上証2X國票94購01,,,,,0.00,0.00,0,0,0,0,0,0,0,0,0,0,0,0,0
20200312,050637,欣興國票94購02,,,,,0.00,0.00,0,0,0,0,0,0,0,0,0,0,0,0,0
20200312,050638,創意國票94購02,,,,,0.00,0.00,0,0,0,0,0,0,0,0,0,0,0,0,0
20200312,050639,GIS國票96購01,,,,,0.00,0.00,0,0,0,0,0,0,0,0,0,0,0,0,0
20200312,05063P,聯電元大96售03,0.80,0.99,0.80,0.87,+0.18,26.09,535000,14,466070,0,0,0,0,0,0,175000,535000,-360000,-360000
20200312,050640,致新國票94購01,,,,,0.00,0.00,0,0,0,0,0,0,0,0,0,0,0,0,0
20200312,050641,上証反凱基96購01,0.43,0.43,0.43,0.43,0.00,0.00,56000,3,24080,0,0,0,0,0,0,1000,0,1000,1000
20200312,050642,和大凱基94購03,,,,,0.00,0.00,0,0,0,0,0,0,0,0,0,0,0,0,0
20200312,050643,為升凱基94購08,,,,,0.00,0.00,0,0,0,0,0,0,0,0,0,0,0,0,0
20200312,050644,國巨凱基96購01,3.04,3.04,2.34,2.68,-0.62,-18.79,38000,5,105670,0,0,0,0,0,0,28000,38000,-10000,-10000
20200312,050645,台積電凱基94購39,0.68,0.68,0.68,0.68,-0.41,-37.61,10000,1,6800,0,0,0,0,0,0,10000,0,10000,10000
20200312,050646,美律凱基96購01,,,,,0.00,0.00,0,0,0,0,0,0,0,0,0,0,0,0,0
20200312,050647,聯發科凱基96購01,0.30,0.30,0.15,0.15,-0.25,-62.5,404000,20,76620,0,0,0,0,0,0,114000,290000,-176000,-176000
20200312,050648,全新凱基96購01,,,,,0.00,0.00,0,0,0,0,0,0,0,0,0,0,0,0,0
20200312,050649,華新科凱基96購01,1.33,1.33,0.92,0.92,-0.63,-40.65,73000,6,91090,0,0,0,0,0,0,63000,16000,47000,47000
20200312,05064P,台積電元大95售10,0.50,0.50,0.50,0.50,0.00,0.00,10000,1,5000,0,0,0,0,0,0,0,10000,-10000,-10000
20200312,050650,大立光凱基96購01,1.04,1.04,0.72,0.72,0.00,0.00,11000,11,9930,0,0,0,0,0,0,0,11000,-11000,-11000
20200312,050651,大立光凱基96購02,,,,,0.00,0.00,0,0,0,0,0,0,0,0,0,0,0,0,0
20200312,050652,大立光凱基96購03,,,,,0.00,0.00,0,0,0,0,0,0,0,0,0,0,0,0,0
20200312,050653,聯鈞凱基96購01,2.54,2.56,1.66,1.84,-1.30,-41.4,82000,13,175720,0,0,0,0,0,0,10000,72000,-62000,-62000
20200312,050654,鎧勝凱基96購01,0.02,0.02,0.02,0.02,-0.02,-50.0,40000,1,800,0,0,0,0,0,0,40000,0,40000,40000
20200312,050655,中磊凱基96購01,,,,,0.00,0.00,0,0,0,0,0,0,0,0,0,0,0,0,0
20200312,050656,瑞儀凱基96購01,,,,,0.00,0.00,0,0,0,0,0,0,0,0,0,0,0,0,0
20200312,050657,宏達電麥證94購01,0.22,0.22,0.21,0.21,-0.07,-25.0,100000,2,21500,0,100000,-100000,0,0,0,0,100000,-100000,-100000
20200312,050658,台郡麥證96購01,,,,,0.00,0.00,0,0,0,0,0,0,0,0,0,0,0,0,0
20200312,050659,宏達電元大96購01,0.14,0.14,0.06,0.06,-0.08,-57.14,479000,6,35030,0,0,0,0,0,0,0,479000,-479000,-479000
20200312,05065P,燿華元大96售03,1.92,2.02,1.92,2.02,0.00,0.00,20000,2,39400,0,0,0,0,0,0,20000,0,20000,20000
20200312,050660,欣興元大96購02,0.07,0.07,0.04,0.05,0.00,0.00,225000,6,14200,0,0,0,0,0,0,5000,216000,-211000,-211000
20200312,050661,景碩元大94購02,,,,,0.00,0.00,0,0,0,0,0,0,0,0,0,0,0,0,0
20200312,050662,智易元大96購01,,,,,0.00,0.00,0,0,0,0,0,0,0,0,0,0,0,0,0
20200312,050663,麗豐元大96購03,,,,,0.00,0.00,0,0,0,0,0,0,0,0,0,0,0,0,0
20200312,050664,全新台新94購02,,,,,0.00,0.00,0,0,0,0,0,0,0,0,0,0,0,0,0
20200312,050665,南電台新94購01,0.26,0.26,0.14,0.14,-0.17,-54.84,650000,14,119200,0,0,0,0,0,0,550000,100000,450000,450000
20200312,050666,道瓊銀永豐94購01,0.09,0.09,0.09,0.09,0.00,0.00,5000,2,450,0,0,0,0,0,0,0,5000,-5000,-5000
20200312,050667,國巨永豐94購06,,,,,0.00,0.00,0,0,0,0,0,0,0,0,0,0,0,0,0
20200312,050668,京元電永豐94購01,,,,,0.00,0.00,0,0,0,0,0,0,0,0,0,0,0,0,0
20200312,050669,嘉晶永豐96購01,0.23,0.25,0.23,0.25,-0.02,-7.41,9000,3,2130,0,0,0,0,0,0,0,9000,-9000,-9000
20200312,05066P,康控元大95售03,3.65,3.65,3.65,3.65,+0.62,20.46,10000,1,36500,0,0,0,0,0,0,10000,0,10000,10000
20200312,050670,牧德永豐94購03,0.78,0.78,0.78,0.78,-0.33,-29.73,6000,1,4680,0,0,0,0,0,0,6000,0,6000,6000
20200312,050671,超眾永豐94購04,0.37,0.37,0.37,0.37,-0.18,-32.73,10000,1,3700,0,0,0,0,0,0,10000,0,10000,10000
20200312,050672,上証2X富邦97購01,,,,,0.00,0.00,0,0,0,0,0,0,0,0,0,0,0,0,0
20200312,050673,旺宏富邦96購02,0.68,0.69,0.50,0.53,-0.22,-29.33,604000,26,369180,0,0,0,0,0,0,438000,184000,254000,254000
20200312,050674,瑞昱富邦94購02,,,,,0.00,0.00,0,0,0,0,0,0,0,0,0,0,0,0,0
20200312,050675,奇鋐富邦96購01,,,,,0.00,0.00,0,0,0,0,0,0,0,0,0,0,0,0,0
20200312,050676,道瓊銀統一96購02,,,,,0.00,0.00,0,0,0,0,0,0,0,0,0,0,0,0,0
20200312,050677,光寶科統一94購01,,,,,0.00,0.00,0,0,0,0,0,0,0,0,0,0,0,0,0
20200312,050678,美律統一94購04,0.12,0.12,0.12,0.12,0.00,0.00,50000,2,6000,0,0,0,0,0,0,0,50000,-50000,-50000
20200312,050679,上証2X元富97購02,0.25,0.27,0.25,0.27,-0.12,-30.77,998000,4,259480,0,0,0,0,0,0,499000,499000,0,0
20200312,05067P,欣興兆豐96售02,,,,,0.00,0.00,0,0,0,0,0,0,0,0,0,0,0,0,0
20200312,050680,上銀元富94購01,0.81,0.81,0.41,0.41,-0.67,-62.04,55000,9,30580,0,0,0,0,0,0,45000,40000,5000,5000
20200312,050681,南亞科元富94購01,0.62,0.62,0.42,0.46,-0.63,-57.8,23000,4,12070,0,0,0,0,0,0,0,23000,-23000,-23000
20200312,050682,南亞科元富94購02,0.27,0.27,0.27,0.27,-0.59,-68.6,20000,2,5400,0,0,0,0,0,0,0,20000,-20000,-20000
20200312,050683,智原元富94購02,,,,,0.00,0.00,0,0,0,0,0,0,0,0,0,0,0,0,0
20200312,050684,台郡元富94購02,1.88,1.88,1.88,1.88,-1.07,-36.27,10000,1,18800,0,0,0,0,0,0,10000,0,10000,10000
20200312,050685,緯穎元富94購02,1.92,1.92,0.94,1.19,-1.03,-46.4,214000,22,319230,0,0,0,0,0,0,50000,164000,-114000,-114000
20200312,050686,欣興兆豐96購01,0.18,0.18,0.12,0.12,-0.13,-52.0,442000,13,59890,0,0,0,0,0,0,220000,222000,-2000,-2000
20200312,050687,上銀日盛94購01,0.23,0.23,0.10,0.10,-0.21,-67.74,296000,26,53360,0,0,0,0,0,0,156000,140000,16000,16000
20200312,050688,大立光日盛94購03,0.08,0.08,0.05,0.05,-0.16,-76.19,2063000,61,120430,0,0,0,0,0,0,699000,1364000,-665000,-665000
20200312,050689,力山凱基94購07,,,,,0.00,0.00,0,0,0,0,0,0,0,0,0,0,0,0,0
20200312,05068P,鴻海統一95售06,4.80,4.99,4.80,4.99,0.00,0.00,11000,2,54700,0,0,0,0,0,0,11000,10000,1000,1000
20200312,050690,台達電凱基96購01,0.90,0.90,0.88,0.88,-0.17,-16.19,42000,2,37600,0,0,0,0,0,0,42000,0,42000,42000
20200312,050691,楠梓電凱基96購01,,,,,0.00,0.00,0,0,0,0,0,0,0,0,0,0,0,0,0
20200312,050692,鴻海凱基96購04,0.36,0.36,0.29,0.29,0.00,0.00,17000,4,5330,0,0,0,0,0,0,0,17000,-17000,-17000
20200312,050693,鴻海凱基96購05,0.11,0.12,0.10,0.11,0.00,0.00,90000,10,9750,0,0,0,0,0,0,0,90000,-90000,-90000
20200312,050694,國巨凱基96購03,,,,,0.00,0.00,0,0,0,0,0,0,0,0,0,0,0,0,0
20200312,050695,台積電凱基94購40,0.35,0.35,0.17,0.28,-0.27,-49.09,830000,9,207460,0,0,0,0,0,0,68000,762000,-694000,-694000
20200312,050696,台光電凱基96購01,,,,,0.00,0.00,0,0,0,0,0,0,0,0,0,0,0,0,0
20200312,050697,冠德凱基96購01,,,,,0.00,0.00,0,0,0,0,0,0,0,0,0,0,0,0,0
20200312,050698,明泰凱基96購01,,,,,0.00,0.00,0,0,0,0,0,0,0,0,0,0,0,0,0
20200312,050699,京鼎凱基96購01,0.45,0.46,0.43,0.45,-0.24,-34.78,10000,10,4460,0,0,0,0,0,0,10000,0,10000,10000
20200312,05069P,鴻海統一96售03,,,,,0.00,0.00,0,0,0,0,0,0,0,0,0,0,0,0,0
20200312,050700,健策凱基96購01,0.55,0.55,0.40,0.40,-0.54,-57.45,28000,4,13250,0,0,0,0,0,0,8000,20000,-12000,-12000
20200312,050701,上緯控凱基94購04,,,,,0.00,0.00,0,0,0,0,0,0,0,0,0,0,0,0,0
20200312,050702,崇越凱基94購01,0.66,0.66,0.66,0.66,-0.52,-44.07,30000,1,19800,0,0,0,0,0,0,0,30000,-30000,-30000
20200312,050703,矽格凱基94購02,,,,,0.00,0.00,0,0,0,0,0,0,0,0,0,0,0,0,0
20200312,050704,復盛凱基94購03,0.58,0.58,0.52,0.52,-0.14,-21.21,15000,2,8340,0,0,0,0,0,0,9000,6000,3000,3000
20200312,050705,南電凱基96購01,0.33,0.33,0.18,0.18,-0.31,-63.27,1118000,10,224010,0,0,0,0,0,0,1111000,7000,1104000,1104000
20200312,050706,柏文凱基94購01,,,,,0.00,0.00,0,0,0,0,0,0,0,0,0,0,0,0,0
20200312,050707,寶成凱基94購02,,,,,0.00,0.00,0,0,0,0,0,0,0,0,0,0,0,0,0
20200312,050708,臺股指凱基96購06,0.07,0.08,0.05,0.06,-0.03,-33.33,446000,10,23060,0,0,0,0,0,0,0,0,0,0
20200312,050709,嘉聯益第一96購01,,,,,0.00,0.00,0,0,0,0,0,0,0,0,0,0,0,0,0
20200312,05070P,鴻海統一96售04,2.10,2.10,2.10,2.10,0.00,0.00,2000,1,4200,0,0,0,0,0,0,2000,2000,0,0
20200312,050710,元黃金中信96購01,1.28,1.29,1.27,1.27,0.00,0.00,45000,5,57450,0,0,0,0,0,0,0,45000,-45000,-45000
20200312,050711,TPK中信94購01,,,,,0.00,0.00,0,0,0,0,0,0,0,0,0,0,0,0,0
20200312,050712,和碩中信94購01,,,,,0.00,0.00,0,0,0,0,0,0,0,0,0,0,0,0,0
20200312,050713,矽格麥證94購01,0.24,0.24,0.23,0.23,-0.10,-30.3,30000,2,7000,30000,0,30000,0,0,0,30000,0,30000,30000
20200312,050714,深中小群益98購01,0.89,0.89,0.78,0.78,-0.19,-19.59,681000,21,547620,0,0,0,0,0,0,401000,280000,121000,121000
20200312,050715,台積電群益96購01,0.09,0.11,0.05,0.10,-0.04,-28.57,3559000,95,287310,0,0,0,0,0,0,628000,2039000,-1411000,-1411000
20200312,050716,可成群益96購01,0.04,0.04,0.04,0.04,-0.09,-69.23,8000,1,320,0,0,0,0,0,0,0,8000,-8000,-8000
20200312,050717,京鼎群益96購01,0.69,0.71,0.49,0.50,-0.35,-41.18,366000,19,238020,0,0,0,0,0,0,266000,100000,166000,166000
20200312,050718,茂林群益94購04,0.81,0.81,0.81,0.81,-1.42,-63.68,20000,1,16200,0,0,0,0,0,0,20000,0,20000,20000
20200312,050719,世紀鋼群益96購01,1.70,1.70,1.56,1.62,-0.18,-10.0,144000,15,240110,0,0,0,0,0,0,47000,97000,-50000,-50000
20200312,05071P,鴻海統一96售05,2.68,3.04,2.68,2.99,0.00,0.00,60000,4,177000,0,0,0,0,0,0,60000,0,60000,60000
20200312,050720,上証2X國票94購02,,,,,0.00,0.00,0,0,0,0,0,0,0,0,0,0,0,0,0
20200312,050721,台泥國票94購01,,,,,0.00,0.00,0,0,0,0,0,0,0,0,0,0,0,0,0
20200312,050722,聯電國票96購01,0.60,0.60,0.38,0.50,-0.27,-35.06,132000,17,60510,0,0,0,0,0,0,20000,112000,-92000,-92000
20200312,050723,楠梓電國票94購01,0.08,0.08,0.05,0.05,0.00,0.00,400000,2,26000,0,0,0,0,0,0,0,400000,-400000,-400000
20200312,050724,國巨國票96購01,2.44,2.44,1.36,1.36,-1.60,-54.05,69000,12,125760,0,0,0,0,0,0,3000,66000,-63000,-63000
20200312,050725,光磊國票96購01,,,,,0.00,0.00,0,0,0,0,0,0,0,0,0,0,0,0,0
20200312,050726,可成國票96購01,0.03,0.03,0.03,0.03,0.00,0.00,20000,1,600,0,0,0,0,0,0,20000,0,20000,20000
20200312,050727,華新科國票94購09,0.87,0.87,0.87,0.87,0.00,0.00,10000,1,8700,0,0,0,0,0,0,0,10000,-10000,-10000
20200312,050728,新日興國票94購01,0.48,0.48,0.44,0.48,-0.66,-57.89,56000,7,25590,0,0,0,0,0,0,3000,53000,-50000,-50000
20200312,050729,聯鈞國票94購01,,,,,0.00,0.00,0,0,0,0,0,0,0,0,0,0,0,0,0
20200312,05072P,聯電元富95售02,0.36,0.50,0.36,0.50,+0.22,78.57,20000,3,8600,0,0,0,0,0,0,10000,10000,0,0
20200312,050730,復盛國票94購01,0.49,0.49,0.42,0.42,0.00,0.00,30000,3,13600,0,0,0,0,0,0,0,30000,-30000,-30000
20200312,050731,昇陽半國票96購01,,,,,0.00,0.00,0,0,0,0,0,0,0,0,0,0,0,0,0
20200312,050732,台虹國票94購01,1.45,1.45,1.16,1.16,-0.72,-38.3,30000,4,39550,0,0,0,0,0,0,5000,25000,-20000,-20000
20200312,050733,寶成國票94購01,,,,,0.00,0.00,0,0,0,0,0,0,0,0,0,0,0,0,0
20200312,050734,台積電台新94購02,,,,,0.00,0.00,0,0,0,0,0,0,0,0,0,0,0,0,0
20200312,050735,亞光台新94購01,,,,,0.00,0.00,0,0,0,0,0,0,0,0,0,0,0,0,0
20200312,050736,台積電康和94購01,0.33,0.33,0.24,0.24,-0.19,-44.19,616000,7,168980,0,0,0,0,0,0,148000,468000,-320000,-320000
20200312,050737,聯詠康和94購01,,,,,0.00,0.00,0,0,0,0,0,0,0,0,0,0,0,0,0
20200312,050738,臺股指康和94購01,0.15,0.15,0.10,0.11,-0.11,-50.0,1215000,19,142600,0,0,0,0,0,0,0,1215000,-1215000,-1215000
20200312,050739,臺股指康和94購02,,,,,0.00,0.00,0,0,0,0,0,0,0,0,0,0,0,0,0
20200312,05073P,臺股指中信95售09,,,,,0.00,0.00,0,0,0,0,0,0,0,0,0,0,0,0,0
20200312,050740,旺宏永豐94購03,,,,,0.00,0.00,0,0,0,0,0,0,0,0,0,0,0,0,0
20200312,050741,奇鋐永豐94購04,,,,,0.00,0.00,0,0,0,0,0,0,0,0,0,0,0,0,0
20200312,050742,新日興永豐94購01,,,,,0.00,0.00,0,0,0,0,0,0,0,0,0,0,0,0,0
20200312,050743,京鼎永豐94購02,0.06,0.06,0.05,0.06,-0.06,-50.0,26000,3,1550,0,0,0,0,0,0,6000,20000,-14000,-14000
20200312,050744,健策永豐94購04,0.35,0.35,0.25,0.25,-0.20,-44.44,144000,6,42090,0,0,0,0,0,0,30000,114000,-84000,-84000
20200312,050745,茂林永豐94購06,,,,,0.00,0.00,0,0,0,0,0,0,0,0,0,0,0,0,0
20200312,050746,矽創永豐94購01,,,,,0.00,0.00,0,0,0,0,0,0,0,0,0,0,0,0,0
20200312,050747,道瓊銀統一94購03,0.56,0.56,0.56,0.56,-0.12,-17.65,1000,1,560,0,0,0,0,0,0,1000,0,1000,1000
20200312,050748,道瓊銀統一94購04,0.25,0.25,0.25,0.25,0.00,0.00,25000,1,6250,0,0,0,0,0,0,25000,0,25000,25000
20200312,050749,道瓊銀統一96購03,,,,,0.00,0.00,0,0,0,0,0,0,0,0,0,0,0,0,0
20200312,05074P,鴻海麥證95售01,1.96,2.27,1.96,2.27,0.00,0.00,60000,6,125800,0,60000,-60000,0,0,0,0,60000,-60000,-60000
20200312,050750,上銀統一94購02,0.63,0.63,0.40,0.40,-0.46,-53.49,337000,10,179020,0,0,0,0,0,0,337000,0,337000,337000
20200312,050751,聯電統一94購05,,,,,0.00,0.00,0,0,0,0,0,0,0,0,0,0,0,0,0
20200312,050752,美律統一94購05,,,,,0.00,0.00,0,0,0,0,0,0,0,0,0,0,0,0,0
20200312,050753,百和統一94購01,,,,,0.00,0.00,0,0,0,0,0,0,0,0,0,0,0,0,0
20200312,050754,元金2X元富9B購01,0.81,0.82,0.77,0.80,-0.17,-17.53,499000,15,394470,0,0,0,0,0,0,246000,253000,-7000,-7000
20200312,050755,和大元富94購01,0.03,0.03,0.03,0.03,-0.02,-40.0,1000,1,30,0,0,0,0,0,0,0,0,0,0
20200312,050756,京元電元富94購03,,,,,0.00,0.00,0,0,0,0,0,0,0,0,0,0,0,0,0
20200312,050757,聯發科元富94購03,0.05,0.05,0.05,0.05,-0.11,-68.75,100000,1,5000,0,0,0,0,0,0,0,100000,-100000,-100000
20200312,050758,聯發科元富9B購01,0.29,0.29,0.21,0.23,-0.13,-36.11,60000,9,14040,0,0,0,0,0,0,10000,50000,-40000,-40000
20200312,050759,貿聯元富94購02,0.23,0.23,0.17,0.17,-0.15,-46.88,40000,17,8290,0,0,0,0,0,0,32000,8000,24000,24000
20200312,05075P,台積電麥證95售01,0.73,0.97,0.73,0.94,+0.40,74.07,30000,4,25350,10000,20000,-10000,0,0,0,10000,20000,-10000,-10000
20200312,050760,矽力元富94購03,2.69,2.69,1.92,2.34,-1.53,-39.53,115000,32,264270,0,0,0,0,0,0,89000,14000,75000,75000
20200312,050761,華通元大94購05,0.08,0.08,0.05,0.05,-0.26,-83.87,68000,2,3610,0,0,0,0,0,0,61000,0,61000,61000
20200312,050762,楠梓電元大94購02,,,,,0.00,0.00,0,0,0,0,0,0,0,0,0,0,0,0,0
20200312,050763,楠梓電元大94購03,,,,,0.00,0.00,0,0,0,0,0,0,0,0,0,0,0,0,0
20200312,050764,鴻海元大94購27,,,,,0.00,0.00,0,0,0,0,0,0,0,0,0,0,0,0,0
20200312,050765,鴻海元大96購02,0.36,0.36,0.22,0.26,-0.20,-43.48,992000,24,280590,0,0,0,0,0,0,156000,836000,-680000,-680000
20200312,050766,燿華元大96購02,0.10,0.10,0.10,0.10,-0.09,-47.37,10000,1,1000,0,0,0,0,0,0,0,10000,-10000,-10000
20200312,050767,京元電元大96購01,0.12,0.12,0.11,0.11,-0.15,-57.69,111000,3,13220,0,0,0,0,0,0,0,111000,-111000,-111000
20200312,050768,聯發科元大94購16,0.06,0.06,0.03,0.03,-0.05,-62.5,15000,3,700,0,0,0,0,0,0,0,15000,-15000,-15000
20200312,050769,聯發科元大94購17,0.08,0.08,0.06,0.06,-0.27,-81.82,76000,2,4720,0,0,0,0,0,0,68000,8000,60000,60000
20200312,05076P,深中小群益99售02,0.30,0.43,0.30,0.43,+0.07,19.44,201000,17,66430,0,0,0,0,0,0,80000,91000,-11000,-11000
20200312,050770,全新元大94購04,,,,,0.00,0.00,0,0,0,0,0,0,0,0,0,0,0,0,0
20200312,050771,華新科元大94購06,1.15,1.15,0.61,0.63,-0.58,-47.93,198000,8,146560,0,0,0,0,0,0,88000,148000,-60000,-60000
20200312,050772,美食元大94購06,,,,,0.00,0.00,0,0,0,0,0,0,0,0,0,0,0,0,0
20200312,050773,京鼎元大94購02,0.54,0.54,0.44,0.44,-0.26,-37.14,278000,14,139320,0,0,0,0,0,0,95000,183000,-88000,-88000
20200312,050774,健策元大96購02,1.20,1.20,0.74,0.74,-0.49,-39.84,339000,10,317790,0,0,0,0,0,0,19000,310000,-291000,-291000
20200312,050775,TPK元大96購01,,,,,0.00,0.00,0,0,0,0,0,0,0,0,0,0,0,0,0
20200312,050776,康控元大96購03,,,,,0.00,0.00,0,0,0,0,0,0,0,0,0,0,0,0,0
20200312,050777,臻鼎元大94購05,,,,,0.00,0.00,0,0,0,0,0,0,0,0,0,0,0,0,0
20200312,050778,瑞儀元大96購01,,,,,0.00,0.00,0,0,0,0,0,0,0,0,0,0,0,0,0
20200312,050779,超眾元大96購03,0.57,0.57,0.50,0.50,-0.31,-38.27,221000,6,120630,0,0,0,0,0,0,113000,137000,-24000,-24000
20200312,05077P,智易群益95售02,1.39,1.44,1.39,1.44,+0.19,15.2,142000,4,201930,0,0,0,0,0,0,11000,131000,-120000,-120000
20200312,050780,台表科元大96購01,0.44,0.44,0.26,0.26,-0.26,-50.0,347000,16,138000,0,0,0,0,0,0,197000,150000,47000,47000
20200312,050781,昇陽半元大94購06,,,,,0.00,0.00,0,0,0,0,0,0,0,0,0,0,0,0,0
20200312,050782,台積電國泰96購03,3.50,3.50,2.25,3.09,-1.13,-26.78,135000,20,376800,0,0,0,0,0,0,40000,95000,-55000,-55000
20200312,050783,旺宏國泰96購02,1.08,1.10,0.80,0.80,-0.47,-37.01,850000,12,706800,0,0,0,0,0,0,20000,830000,-810000,-810000
20200312,050784,美律國泰96購01,0.56,0.56,0.31,0.34,-0.34,-50.0,127000,13,50080,0,0,0,0,0,0,20000,107000,-87000,-87000
20200312,050785,全新國泰96購01,,,,,0.00,0.00,0,0,0,0,0,0,0,0,0,0,0,0,0
20200312,050786,健策國泰96購01,2.41,2.41,1.73,1.73,-1.39,-44.55,491000,11,1023780,0,0,0,0,0,0,36000,455000,-419000,-419000
20200312,050787,致伸國泰96購01,,,,,0.00,0.00,0,0,0,0,0,0,0,0,0,0,0,0,0
20200312,050788,台郡國泰96購01,2.19,2.19,1.79,1.79,-1.28,-41.69,90000,3,180000,0,0,0,0,0,0,0,90000,-90000,-90000
20200312,050789,矽創國泰96購01,0.34,0.34,0.34,0.34,-0.29,-46.03,98000,1,33320,0,0,0,0,0,0,0,98000,-98000,-98000
20200312,05078P,義隆永豐95售01,0.98,1.14,0.98,1.14,+0.37,48.05,58000,4,61730,0,0,0,0,0,0,22000,36000,-14000,-14000
20200312,050790,昇陽半國泰96購02,,,,,0.00,0.00,0,0,0,0,0,0,0,0,0,0,0,0,0
20200312,050791,聯發科富邦96購01,0.18,0.18,0.10,0.10,-0.13,-56.52,55000,5,7410,0,0,0,0,0,0,40000,15000,25000,25000
20200312,050792,可成富邦96購01,,,,,0.00,0.00,0,0,0,0,0,0,0,0,0,0,0,0,0
20200312,050793,大立光富邦96購03,0.30,0.30,0.30,0.30,-0.32,-51.61,10000,1,3000,0,0,0,0,0,0,0,10000,-10000,-10000
20200312,050794,大立光富邦96購04,,,,,0.00,0.00,0,0,0,0,0,0,0,0,0,0,0,0,0
20200312,050795,超眾富邦94購01,,,,,0.00,0.00,0,0,0,0,0,0,0,0,0,0,0,0,0
20200312,050796,燿華中信95購01,,,,,0.00,0.00,0,0,0,0,0,0,0,0,0,0,0,0,0
20200312,050797,聯發科中信99購01,0.28,0.28,0.19,0.19,-0.12,-38.71,1397000,19,315720,0,0,0,0,0,0,248000,1149000,-901000,-901000
20200312,050798,TPK中信96購01,,,,,0.00,0.00,0,0,0,0,0,0,0,0,0,0,0,0,0
20200312,050799,嘉聯益中信98購01,0.09,0.09,0.07,0.07,0.00,0.00,52000,7,4650,0,0,0,0,0,0,0,52000,-52000,-52000
20200312,05079P,可成永豐95售01,1.46,1.78,1.46,1.78,+0.56,45.9,54000,6,86360,0,0,0,0,0,0,10000,44000,-34000,-34000
20200312,050800,百和中信95購01,,,,,0.00,0.00,0,0,0,0,0,0,0,0,0,0,0,0,0
20200312,050801,元金2X群益98購01,,,,,0.00,0.00,0,0,0,0,0,0,0,0,0,0,0,0,0
20200312,050802,康控群益95購01,,,,,0.00,0.00,0,0,0,0,0,0,0,0,0,0,0,0,0
20200312,050803,康控兆豐96購01,,,,,0.00,0.00,0,0,0,0,0,0,0,0,0,0,0,0,0
20200312,050804,和大日盛95購01,0.03,0.03,0.03,0.03,0.00,0.00,4000,1,120,0,0,0,0,0,0,4000,0,4000,4000
20200312,050805,光寶科日盛95購01,0.03,0.03,0.03,0.03,-0.02,-40.0,100000,1,3000,0,0,0,0,0,0,0,100000,-100000,-100000
20200312,050806,華新科日盛95購01,0.21,0.21,0.21,0.21,-0.35,-62.5,4000,1,840,0,0,0,0,0,0,0,4000,-4000,-4000
20200312,050807,群臺反凱基95購01,0.90,1.15,0.90,1.13,+0.38,50.67,486000,10,528110,0,0,0,0,0,0,253000,233000,20000,20000
20200312,050808,台達電凱基96購02,0.45,0.45,0.45,0.45,-0.16,-26.23,10000,1,4500,0,0,0,0,0,0,10000,0,10000,10000
20200312,050809,鴻海凱基95購08,0.49,0.49,0.32,0.32,-0.35,-52.24,108000,3,44960,0,0,0,0,0,0,68000,40000,28000,28000
20200312,05080P,亞光永豐95售02,1.44,1.72,1.44,1.72,0.00,0.00,40000,4,63400,0,0,0,0,0,0,10000,40000,-30000,-30000
20200312,050810,鴻海凱基95購09,,,,,0.00,0.00,0,0,0,0,0,0,0,0,0,0,0,0,0
20200312,050811,國巨凱基95購02,2.60,2.60,2.16,2.16,-1.57,-42.09,25000,4,58920,0,0,0,0,0,0,15000,15000,0,0
20200312,050812,台積電凱基95購01,0.12,0.12,0.12,0.12,-0.06,-33.33,50000,1,6000,0,0,0,0,0,0,50000,0,50000,50000
20200312,050813,旺宏凱基96購01,1.33,1.40,0.95,0.98,-0.80,-44.94,120000,8,156300,0,0,0,0,0,0,90000,30000,60000,60000
20200312,050814,微星凱基95購01,,,,,0.00,0.00,0,0,0,0,0,0,0,0,0,0,0,0,0
20200312,050815,南亞科凱基95購01,0.27,0.27,0.12,0.12,-0.34,-73.91,752000,27,140980,0,0,0,0,0,0,736000,16000,720000,720000
20200312,050816,京元電凱基95購01,,,,,0.00,0.00,0,0,0,0,0,0,0,0,0,0,0,0,0
20200312,050817,可成凱基95購01,,,,,0.00,0.00,0,0,0,0,0,0,0,0,0,0,0,0,0
20200312,050818,華新科凱基95購02,1.25,1.25,1.25,1.25,-0.39,-23.78,6000,1,7500,0,0,0,0,0,0,6000,6000,0,0
20200312,050819,宏達電凱基95購01,,,,,0.00,0.00,0,0,0,0,0,0,0,0,0,0,0,0,0
20200312,05081P,京鼎永豐95售01,0.81,1.01,0.78,1.01,+0.33,48.53,216000,11,174960,0,0,0,0,0,0,171000,45000,126000,126000
20200312,050820,美食凱基95購01,,,,,0.00,0.00,0,0,0,0,0,0,0,0,0,0,0,0,0
20200312,050821,國泰金凱基95購01,,,,,0.00,0.00,0,0,0,0,0,0,0,0,0,0,0,0,0
20200312,050822,亞光凱基95購01,,,,,0.00,0.00,0,0,0,0,0,0,0,0,0,0,0,0,0
20200312,050823,信邦凱基95購01,0.54,0.55,0.50,0.50,0.00,0.00,45000,6,23380,0,0,0,0,0,0,45000,0,45000,45000
20200312,050824,欣興凱基95購01,,,,,0.00,0.00,0,0,0,0,0,0,0,0,0,0,0,0,0
20200312,050825,嘉澤凱基95購01,0.32,0.32,0.16,0.16,-0.47,-74.6,76000,2,23040,0,0,0,0,0,0,68000,8000,60000,60000
20200312,050826,康普凱基95購01,,,,,0.00,0.00,0,0,0,0,0,0,0,0,0,0,0,0,0
20200312,050827,致伸凱基95購01,,,,,0.00,0.00,0,0,0,0,0,0,0,0,0,0,0,0,0
20200312,050828,康控凱基95購01,,,,,0.00,0.00,0,0,0,0,0,0,0,0,0,0,0,0,0
20200312,050829,臻鼎凱基96購01,,,,,0.00,0.00,0,0,0,0,0,0,0,0,0,0,0,0,0
20200312,05082P,健策永豐95售02,0.60,0.62,0.60,0.61,0.00,0.00,40000,4,24400,0,0,0,0,0,0,0,40000,-40000,-40000
20200312,050830,嘉聯益凱基95購01,,,,,0.00,0.00,0,0,0,0,0,0,0,0,0,0,0,0,0
20200312,050831,超眾凱基95購01,0.48,0.48,0.43,0.43,-0.39,-47.56,56000,2,25830,0,0,0,0,0,0,35000,56000,-21000,-21000
20200312,050832,力成凱基95購01,0.27,0.27,0.21,0.22,-0.25,-53.19,172000,22,39960,0,0,0,0,0,0,172000,0,172000,172000
20200312,050833,台郡凱基95購01,,,,,0.00,0.00,0,0,0,0,0,0,0,0,0,0,0,0,0
20200312,050834,啟碁凱基95購01,0.06,0.06,0.06,0.06,0.00,0.00,180000,1,10800,0,0,0,0,0,0,180000,0,180000,180000
20200312,050835,GIS凱基96購01,,,,,0.00,0.00,0,0,0,0,0,0,0,0,0,0,0,0,0
20200312,050836,緯穎凱基95購01,1.66,1.66,1.10,1.10,-1.01,-47.87,67000,3,82770,0,0,0,0,0,0,67000,50000,17000,17000
20200312,050837,力山國票95購01,,,,,0.00,0.00,0,0,0,0,0,0,0,0,0,0,0,0,0
20200312,050838,為升國票96購01,,,,,0.00,0.00,0,0,0,0,0,0,0,0,0,0,0,0,0
20200312,050839,楠梓電國票96購01,,,,,0.00,0.00,0,0,0,0,0,0,0,0,0,0,0,0,0
20200312,05083P,麗豐永豐95售02,1.24,1.49,1.24,1.39,+0.18,14.88,98000,12,127010,0,0,0,0,0,0,41000,57000,-16000,-16000
20200312,050840,中環國票96購01,,,,,0.00,0.00,0,0,0,0,0,0,0,0,0,0,0,0,0
20200312,050841,國巨國票96購02,1.34,1.42,0.69,0.81,-1.43,-63.84,270000,7,208010,0,0,0,0,0,0,269000,260000,9000,9000
20200312,050842,旺宏國票97購01,2.47,2.47,1.72,1.79,-1.11,-38.28,103000,11,210910,0,0,0,0,0,0,38000,65000,-27000,-27000
20200312,050843,富邦金國票96購01,,,,,0.00,0.00,0,0,0,0,0,0,0,0,0,0,0,0,0
20200312,050844,大立光國票96購01,0.18,0.18,0.12,0.12,-0.59,-83.1,436000,8,64330,0,0,0,0,0,0,0,436000,-436000,-436000
20200312,050845,奇鋐國票95購02,,,,,0.00,0.00,0,0,0,0,0,0,0,0,0,0,0,0,0
20200312,050846,緯創國票96購01,,,,,0.00,0.00,0,0,0,0,0,0,0,0,0,0,0,0,0
20200312,050847,創意國票96購01,,,,,0.00,0.00,0,0,0,0,0,0,0,0,0,0,0,0,0
20200312,050848,日月光國票95購01,0.02,0.02,0.02,0.02,-0.03,-60.0,150000,2,3000,0,0,0,0,0,0,0,150000,-150000,-150000
20200312,050849,智伸科國票95購01,,,,,0.00,0.00,0,0,0,0,0,0,0,0,0,0,0,0,0
20200312,05084P,嘉聯益永豐95售02,1.73,1.83,1.73,1.83,+0.50,37.59,30000,3,53400,0,0,0,0,0,0,0,30000,-30000,-30000
20200312,050850,訊連國票96購01,2.92,2.92,2.92,2.92,0.00,0.00,46000,1,134320,0,0,0,0,0,0,0,46000,-46000,-46000
20200312,050851,羅麗芬國票96購01,,,,,0.00,0.00,0,0,0,0,0,0,0,0,0,0,0,0,0
20200312,050852,矽創國票95購02,,,,,0.00,0.00,0,0,0,0,0,0,0,0,0,0,0,0,0
20200312,050853,南電國票96購01,0.25,0.26,0.11,0.11,-0.19,-63.33,3040000,55,521980,0,0,0,0,0,0,1661000,1176000,485000,485000
20200312,050854,世紀鋼國票97購01,1.51,1.51,1.20,1.24,-0.43,-25.75,221000,6,286430,0,0,0,0,0,0,69000,152000,-83000,-83000
20200312,050855,華通台新95購01,,,,,0.00,0.00,0,0,0,0,0,0,0,0,0,0,0,0,0
20200312,050856,智邦台新95購01,,,,,0.00,0.00,0,0,0,0,0,0,0,0,0,0,0,0,0
20200312,050857,義隆台新95購01,,,,,0.00,0.00,0,0,0,0,0,0,0,0,0,0,0,0,0
20200312,050858,欣興台新95購01,,,,,0.00,0.00,0,0,0,0,0,0,0,0,0,0,0,0,0
20200312,050859,訊芯康和95購01,,,,,0.00,0.00,0,0,0,0,0,0,0,0,0,0,0,0,0
20200312,05085P,鴻海日盛95售01,1.48,1.51,1.37,1.51,+0.63,71.59,190000,7,278260,0,0,0,0,0,0,188000,102000,86000,86000
20200312,050860,喬山永豐95購01,,,,,0.00,0.00,0,0,0,0,0,0,0,0,0,0,0,0,0
20200312,050861,鴻海永豐95購01,,,,,0.00,0.00,0,0,0,0,0,0,0,0,0,0,0,0,0
20200312,050862,燿華永豐95購04,,,,,0.00,0.00,0,0,0,0,0,0,0,0,0,0,0,0,0
20200312,050863,聯發科永豐95購01,,,,,0.00,0.00,0,0,0,0,0,0,0,0,0,0,0,0,0
20200312,050864,亞光永豐95購01,,,,,0.00,0.00,0,0,0,0,0,0,0,0,0,0,0,0,0
20200312,050865,欣興永豐95購01,0.04,0.04,0.04,0.04,-0.13,-76.47,40000,2,1600,0,0,0,0,0,0,0,40000,-40000,-40000
20200312,050866,景碩永豐95購01,0.08,0.08,0.08,0.08,-0.08,-50.0,10000,1,800,0,0,0,0,0,0,0,10000,-10000,-10000
20200312,050867,聯鈞永豐95購01,1.02,1.02,0.65,0.70,-0.58,-45.31,115000,14,93200,0,0,0,0,0,0,40000,75000,-35000,-35000
20200312,050868,智易永豐95購01,,,,,0.00,0.00,0,0,0,0,0,0,0,0,0,0,0,0,0
20200312,050869,健策永豐95購01,0.29,0.29,0.17,0.17,-0.21,-55.26,84000,2,20760,0,0,0,0,0,0,54000,30000,24000,24000
20200312,05086P,鴻海凱基95售13,1.04,1.29,1.04,1.29,+0.38,41.76,612000,13,702400,0,0,0,0,0,0,185000,477000,-292000,-292000
20200312,050870,旭富永豐95購01,0.29,0.30,0.16,0.16,-0.18,-52.94,226000,25,47350,0,0,0,0,0,0,77000,77000,0,0
20200312,050871,麗豐永豐95購01,,,,,0.00,0.00,0,0,0,0,0,0,0,0,0,0,0,0,0
20200312,050872,致伸永豐95購01,,,,,0.00,0.00,0,0,0,0,0,0,0,0,0,0,0,0,0
20200312,050873,新唐永豐95購01,,,,,0.00,0.00,0,0,0,0,0,0,0,0,0,0,0,0,0
20200312,050874,康控永豐95購01,,,,,0.00,0.00,0,0,0,0,0,0,0,0,0,0,0,0,0
20200312,050875,訊芯永豐95購01,0.01,0.01,0.01,0.01,0.00,0.00,300000,30,3000,0,0,0,0,0,0,0,300000,-300000,-300000
20200312,050876,復盛永豐95購01,,,,,0.00,0.00,0,0,0,0,0,0,0,0,0,0,0,0,0
20200312,050877,美律統一95購01,0.08,0.08,0.07,0.07,0.00,0.00,50000,2,3780,0,0,0,0,0,0,50000,0,50000,50000
20200312,050878,嘉聯益統一95購01,,,,,0.00,0.00,0,0,0,0,0,0,0,0,0,0,0,0,0
20200312,050879,樺漢統一95購02,0.45,0.45,0.44,0.44,-0.14,-24.14,45000,2,20080,0,0,0,0,0,0,45000,0,45000,45000
20200312,05087P,GIS國泰96售01,2.65,3.08,2.65,3.08,+0.52,20.31,91000,9,259070,0,0,0,0,0,0,61000,30000,31000,31000
20200312,050880,大立光元富95購03,1.20,1.20,0.79,0.90,-1.38,-60.53,228000,12,249510,0,0,0,0,0,0,108000,121000,-13000,-13000
20200312,050881,大立光元富95購04,0.49,0.49,0.24,0.27,-1.26,-82.35,68000,10,21690,0,0,0,0,0,0,15000,53000,-38000,-38000
20200312,050882,華泰國泰96購01,,,,,0.00,0.00,0,0,0,0,0,0,0,0,0,0,0,0,0
20200312,050883,嘉聯益國泰96購01,0.23,0.23,0.19,0.19,0.00,0.00,40000,2,8400,0,0,0,0,0,0,0,40000,-40000,-40000
20200312,050884,聯茂國泰96購01,0.74,0.74,0.74,0.74,0.00,0.00,98000,1,72520,0,0,0,0,0,0,0,98000,-98000,-98000
20200312,050885,T50反1富邦95購01,1.10,1.11,1.10,1.11,0.00,0.00,9000,2,9930,0,0,0,0,0,0,9000,0,9000,9000
20200312,050886,台積電富邦95購04,,,,,0.00,0.00,0,0,0,0,0,0,0,0,0,0,0,0,0
20200312,050887,台積電富邦95購05,0.23,0.27,0.18,0.25,0.00,0.00,1455000,150,330870,0,0,0,0,0,0,1452000,1453000,-1000,-1000
20200312,050888,群創富邦95購01,0.22,0.22,0.22,0.22,0.00,0.00,7000,1,1540,0,0,0,0,0,0,0,7000,-7000,-7000
20200312,050889,健策富邦95購01,,,,,0.00,0.00,0,0,0,0,0,0,0,0,0,0,0,0,0
20200312,05088P,大立光富邦99售01,0.84,1.15,0.84,1.15,0.00,0.00,18000,5,16420,0,0,0,0,0,0,8000,10000,-2000,-2000
20200312,050890,南電富邦99購01,0.56,0.56,0.40,0.40,-0.16,-28.57,317000,18,151840,0,0,0,0,0,0,286000,85000,201000,201000
20200312,050891,喬山元大95購01,,,,,0.00,0.00,0,0,0,0,0,0,0,0,0,0,0,0,0
20200312,050892,聯電元大96購02,0.84,0.84,0.60,0.60,-0.38,-38.78,100000,4,70600,0,0,0,0,0,0,50000,50000,0,0
20200312,050893,鴻海元大96購03,0.55,0.55,0.38,0.38,-0.28,-42.42,374000,13,162160,0,0,0,0,0,0,294000,354000,-60000,-60000
20200312,050894,旺宏元大96購03,0.97,1.04,0.73,0.73,-0.37,-33.64,194000,5,185670,0,0,0,0,0,0,91000,93000,-2000,-2000
20200312,050895,聯發科元大97購01,0.40,0.40,0.25,0.29,0.00,0.00,424000,12,121330,0,0,0,0,0,0,5000,419000,-414000,-414000
20200312,050896,華新科元大96購02,3.15,3.15,2.41,2.49,-0.72,-22.43,66000,6,170090,0,0,0,0,0,0,56000,16000,40000,40000
20200312,050897,嘉晶元大95購03,0.49,0.59,0.39,0.43,-0.38,-46.91,344000,8,158960,0,0,0,0,0,0,76000,268000,-192000,-192000
20200312,050898,智原元大96購01,,,,,0.00,0.00,0,0,0,0,0,0,0,0,0,0,0,0,0
20200312,050899,旭富元大95購01,1.24,1.24,0.77,0.77,-0.61,-44.2,244000,15,263510,0,0,0,0,0,0,128000,121000,7000,7000
20200312,05089P,亞德客元大95售01,1.07,1.42,1.07,1.42,+0.46,47.92,174000,5,202430,0,0,0,0,0,0,169000,45000,124000,124000
20200312,050900,台郡元大95購02,,,,,0.00,0.00,0,0,0,0,0,0,0,0,0,0,0,0,0
20200312,050901,樺漢元大95購02,0.41,0.41,0.20,0.20,-0.37,-64.91,168000,2,47880,0,0,0,0,0,0,68000,100000,-32000,-32000
20200312,050902,南電元大96購01,0.97,0.97,0.67,0.67,-0.39,-36.79,26000,3,20120,0,0,0,0,0,0,26000,0,26000,26000
20200312,050903,臺股指元大95購10,,,,,0.00,0.00,0,0,0,0,0,0,0,0,0,0,0,0,0
20200312,050904,臺股指元大95購11,0.65,0.65,0.60,0.60,-0.72,-54.55,6000,2,3650,0,0,0,0,0,0,0,6000,-6000,-6000
20200312,050905,臺股指元大95購12,,,,,0.00,0.00,0,0,0,0,0,0,0,0,0,0,0,0,0
20200312,050906,臺股指元大95購13,,,,,0.00,0.00,0,0,0,0,0,0,0,0,0,0,0,0,0
20200312,050907,臺股指元大95購14,,,,,0.00,0.00,0,0,0,0,0,0,0,0,0,0,0,0,0
20200312,050908,TPK亞東95購01,,,,,0.00,0.00,0,0,0,0,0,0,0,0,0,0,0,0,0
20200312,050909,華夏中信95購01,,,,,0.00,0.00,0,0,0,0,0,0,0,0,0,0,0,0,0
20200312,05090P,國巨元大95售05,0.23,0.39,0.23,0.34,+0.09,36.0,672000,10,220190,0,0,0,0,0,0,622000,162000,460000,460000
20200312,050910,楠梓電中信95購01,,,,,0.00,0.00,0,0,0,0,0,0,0,0,0,0,0,0,0
20200312,050911,光磊中信98購01,0.13,0.13,0.10,0.10,-0.07,-41.18,610000,4,78100,0,0,0,0,0,0,550000,60000,490000,490000
20200312,050912,正崴中信95購02,0.02,0.02,0.02,0.02,0.00,0.00,2000,1,40,0,0,0,0,0,0,2000,0,2000,2000
20200312,050913,全新中信97購01,,,,,0.00,0.00,0,0,0,0,0,0,0,0,0,0,0,0,0
20200312,050914,健鼎中信95購01,0.04,0.05,0.04,0.05,-0.03,-37.5,150000,4,7400,0,0,0,0,0,0,0,150000,-150000,-150000
20200312,050915,健策中信98購01,0.58,0.58,0.56,0.56,-0.13,-18.84,216000,4,124490,0,0,0,0,0,0,149000,67000,82000,82000
20200312,050916,聯茂中信95購01,,,,,0.00,0.00,0,0,0,0,0,0,0,0,0,0,0,0,0
20200312,050917,瀚宇博兆豐96購01,0.11,0.11,0.11,0.11,0.00,0.00,3000,1,330,0,0,0,0,0,0,0,3000,-3000,-3000
20200312,050918,南亞科日盛95購01,0.12,0.12,0.12,0.12,0.00,0.00,5000,1,600,0,0,0,0,0,0,5000,0,5000,5000
20200312,050919,台積電凱基95購03,0.45,0.45,0.27,0.43,-0.33,-43.42,1239000,13,445020,0,0,0,0,0,0,110000,1129000,-1019000,-1019000
20200312,05091P,台積電元大95售11,1.74,2.24,1.74,1.88,+0.30,18.99,1893000,77,3743830,0,0,0,0,0,0,1321000,1620000,-299000,-299000
20200312,050920,旺宏凱基95購01,0.86,0.86,0.61,0.65,-0.53,-44.92,80000,4,51700,0,0,0,0,0,0,60000,70000,-10000,-10000
20200312,050921,旺宏凱基95購02,0.58,0.58,0.57,0.57,-0.77,-57.46,20000,2,11500,0,0,0,0,0,0,0,20000,-20000,-20000
20200312,050922,南亞科凱基95購02,,,,,0.00,0.00,0,0,0,0,0,0,0,0,0,0,0,0,0
20200312,050923,南亞科凱基95購03,,,,,0.00,0.00,0,0,0,0,0,0,0,0,0,0,0,0,0
20200312,050924,京元電凱基95購02,,,,,0.00,0.00,0,0,0,0,0,0,0,0,0,0,0,0,0
20200312,050925,可成凱基95購02,,,,,0.00,0.00,0,0,0,0,0,0,0,0,0,0,0,0,0
20200312,050926,禾伸堂凱基95購01,,,,,0.00,0.00,0,0,0,0,0,0,0,0,0,0,0,0,0
20200312,050927,聯詠凱基95購01,,,,,0.00,0.00,0,0,0,0,0,0,0,0,0,0,0,0,0
20200312,050928,日月光凱基95購01,,,,,0.00,0.00,0,0,0,0,0,0,0,0,0,0,0,0,0
20200312,050929,中磊凱基95購01,,,,,0.00,0.00,0,0,0,0,0,0,0,0,0,0,0,0,0
20200312,05092P,全新元大95售03,,,,,0.00,0.00,0,0,0,0,0,0,0,0,0,0,0,0,0
20200312,050930,矽格凱基95購01,,,,,0.00,0.00,0,0,0,0,0,0,0,0,0,0,0,0,0
20200312,050931,上証2X國票95購03,,,,,0.00,0.00,0,0,0,0,0,0,0,0,0,0,0,0,0
20200312,050932,台塑國票96購01,,,,,0.00,0.00,0,0,0,0,0,0,0,0,0,0,0,0,0
20200312,050933,南亞國票95購01,,,,,0.00,0.00,0,0,0,0,0,0,0,0,0,0,0,0,0
20200312,050934,喬山國票96購01,0.09,0.09,0.07,0.07,-0.09,-56.25,1210000,10,100700,0,0,0,0,0,0,0,1210000,-1210000,-1210000
20200312,050935,劍麟國票96購01,,,,,0.00,0.00,0,0,0,0,0,0,0,0,0,0,0,0,0
20200312,050936,國巨國票95購04,0.35,0.35,0.35,0.35,-0.73,-67.59,10000,1,3500,0,0,0,0,0,0,0,10000,-10000,-10000
20200312,050937,可成國票96購02,0.01,0.01,0.01,0.01,0.00,0.00,1000,1,10,0,0,0,0,0,0,1000,0,1000,1000
20200312,050938,智原國票96購01,,,,,0.00,0.00,0,0,0,0,0,0,0,0,0,0,0,0,0
20200312,050939,健鼎國票96購01,0.22,0.22,0.15,0.17,-0.17,-50.0,40000,4,7400,0,0,0,0,0,0,20000,20000,0,0
20200312,05093P,可成元大95售03,,,,,0.00,0.00,0,0,0,0,0,0,0,0,0,0,0,0,0
20200312,050940,嘉澤國票95購01,,,,,0.00,0.00,0,0,0,0,0,0,0,0,0,0,0,0,0
20200312,050941,T50反1群益95購01,,,,,0.00,0.00,0,0,0,0,0,0,0,0,0,0,0,0,0
20200312,050942,S&P正2群益95購01,0.27,0.28,0.16,0.27,-0.07,-20.59,264000,24,52720,0,0,0,0,0,0,47000,55000,-8000,-8000
20200312,050943,楠梓電群益96購01,,,,,0.00,0.00,0,0,0,0,0,0,0,0,0,0,0,0,0
20200312,050944,智邦群益95購01,,,,,0.00,0.00,0,0,0,0,0,0,0,0,0,0,0,0,0
20200312,050945,致茂群益95購01,,,,,0.00,0.00,0,0,0,0,0,0,0,0,0,0,0,0,0
20200312,050946,瑞昱群益95購01,0.36,0.36,0.19,0.19,-0.42,-68.85,24000,3,6490,0,0,0,0,0,0,14000,10000,4000,4000
20200312,050947,聯發科群益95購01,,,,,0.00,0.00,0,0,0,0,0,0,0,0,0,0,0,0,0
20200312,050948,華固群益95購01,1.96,2.01,1.93,1.94,+0.04,2.11,121000,13,236160,0,0,0,0,0,0,65000,56000,9000,9000
20200312,050949,亞光群益96購01,,,,,0.00,0.00,0,0,0,0,0,0,0,0,0,0,0,0,0
20200312,05094P,大立光元大95售07,1.91,1.95,1.91,1.94,+0.70,56.45,96000,4,185160,0,0,0,0,0,0,96000,0,96000,96000
20200312,050950,健鼎群益96購01,0.24,0.24,0.24,0.24,-0.10,-29.41,10000,1,2400,0,0,0,0,0,0,10000,0,10000,10000
20200312,050951,緯創群益96購01,0.07,0.07,0.07,0.07,-0.11,-61.11,85000,1,5950,0,0,0,0,0,0,85000,0,85000,85000
20200312,050952,健策群益96購01,1.74,1.80,1.64,1.64,-1.31,-44.41,81000,3,143440,0,0,0,0,0,0,0,81000,-81000,-81000
20200312,050953,臻鼎群益95購01,,,,,0.00,0.00,0,0,0,0,0,0,0,0,0,0,0,0,0
20200312,050954,樺漢群益95購01,0.09,0.09,0.09,0.09,-0.04,-30.77,100000,2,9000,0,0,0,0,0,0,0,100000,-100000,-100000
20200312,050955,達方群益97購01,,,,,0.00,0.00,0,0,0,0,0,0,0,0,0,0,0,0,0
20200312,050956,鈺齊群益95購01,0.23,0.23,0.23,0.23,-0.07,-23.33,88000,1,20240,0,0,0,0,0,0,88000,0,88000,88000
20200312,050957,T50反1台新05購01,0.89,1.15,0.89,1.15,+0.38,49.35,1941000,89,2022190,0,0,0,0,0,0,1939000,1883000,56000,56000
20200312,050958,日月光台新95購01,,,,,0.00,0.00,0,0,0,0,0,0,0,0,0,0,0,0,0
20200312,050959,元金2X永豐95購02,,,,,0.00,0.00,0,0,0,0,0,0,0,0,0,0,0,0,0
20200312,05095P,景碩元大95售01,0.71,0.71,0.71,0.71,0.00,0.00,400000,3,284000,0,0,0,0,0,0,0,400000,-400000,-400000
20200312,050960,台光電永豐95購01,,,,,0.00,0.00,0,0,0,0,0,0,0,0,0,0,0,0,0
20200312,050961,美律永豐95購01,,,,,0.00,0.00,0,0,0,0,0,0,0,0,0,0,0,0,0
20200312,050962,聯發科永豐95購02,,,,,0.00,0.00,0,0,0,0,0,0,0,0,0,0,0,0,0
20200312,050963,強茂永豐95購01,,,,,0.00,0.00,0,0,0,0,0,0,0,0,0,0,0,0,0
20200312,050964,晶技永豐95購02,2.70,2.76,2.34,2.34,-1.35,-36.59,35000,6,87440,0,0,0,0,0,0,12000,23000,-11000,-11000
20200312,050965,揚明光永豐96購01,0.32,0.32,0.27,0.27,-0.13,-32.5,24000,2,6980,0,0,0,0,0,0,14000,10000,4000,4000
20200312,050966,日月光永豐95購01,,,,,0.00,0.00,0,0,0,0,0,0,0,0,0,0,0,0,0
20200312,050967,嘉聯益永豐95購01,,,,,0.00,0.00,0,0,0,0,0,0,0,0,0,0,0,0,0
20200312,050968,超眾永豐95購01,,,,,0.00,0.00,0,0,0,0,0,0,0,0,0,0,0,0,0
20200312,050969,台郡永豐95購01,,,,,0.00,0.00,0,0,0,0,0,0,0,0,0,0,0,0,0
20200312,05096P,台積電日盛95售01,0.24,0.47,0.24,0.33,0.00,0.00,1291000,67,516230,0,0,0,0,0,0,1270000,1281000,-11000,-11000
20200312,050970,康舒永豐95購01,,,,,0.00,0.00,0,0,0,0,0,0,0,0,0,0,0,0,0
20200312,050971,緯穎永豐95購01,0.69,0.69,0.30,0.34,-0.55,-61.8,108000,5,51080,0,0,0,0,0,0,10000,98000,-88000,-88000
20200312,050972,台虹永豐95購01,0.34,0.34,0.34,0.34,-0.31,-47.69,16000,1,5440,0,0,0,0,0,0,16000,0,16000,16000
20200312,050973,S&P反1統一95購01,,,,,0.00,0.00,0,0,0,0,0,0,0,0,0,0,0,0,0
20200312,050974,大成鋼統一95購01,0.91,0.91,0.81,0.85,-0.26,-23.42,512000,11,432280,0,0,0,0,0,0,404000,108000,296000,296000
20200312,050975,楠梓電統一95購01,0.16,0.16,0.14,0.15,-0.17,-53.12,138000,23,21330,0,0,0,0,0,0,138000,0,138000,138000
20200312,050976,台光電統一95購01,0.21,0.21,0.21,0.21,-0.24,-53.33,20000,1,4200,0,0,0,0,0,0,0,20000,-20000,-20000
20200312,050977,聯發科統一95購02,,,,,0.00,0.00,0,0,0,0,0,0,0,0,0,0,0,0,0
20200312,050978,鴻海元富95購03,0.10,0.10,0.10,0.10,-0.24,-70.59,120000,1,12000,0,0,0,0,0,0,120000,0,120000,120000
20200312,050979,鴻海元富96購02,0.40,0.41,0.26,0.30,-0.28,-48.28,26000,8,10080,0,0,0,0,0,0,11000,15000,-4000,-4000
20200312,05097P,聯發科日盛95售01,1.21,1.78,1.21,1.78,0.00,0.00,601000,6,1029100,0,0,0,0,0,0,0,601000,-601000,-601000
20200312,050980,欣興元富95購02,,,,,0.00,0.00,0,0,0,0,0,0,0,0,0,0,0,0,0
20200312,050981,GIS元富95購01,,,,,0.00,0.00,0,0,0,0,0,0,0,0,0,0,0,0,0
20200312,050982,台積電國泰96購04,3.55,3.59,2.36,2.96,-1.16,-28.16,177000,28,531370,0,0,0,0,0,0,34000,141000,-107000,-107000
20200312,050983,新光金國泰97購01,0.33,0.33,0.33,0.33,-0.14,-29.79,26000,3,8580,0,0,0,0,0,0,0,20000,-20000,-20000
20200312,050984,大立光國泰97購01,1.28,1.28,1.10,1.12,-0.70,-38.46,311000,21,369790,0,0,0,0,0,0,48000,258000,-210000,-210000
20200312,050985,易華電國泰96購02,,,,,0.00,0.00,0,0,0,0,0,0,0,0,0,0,0,0,0
20200312,050986,上証2X永昌97購01,0.39,0.40,0.35,0.35,-0.20,-36.36,1008000,13,392240,0,0,0,0,0,0,499000,509000,-10000,-10000
20200312,050987,台泥富邦95購01,,,,,0.00,0.00,0,0,0,0,0,0,0,0,0,0,0,0,0
20200312,050988,廣達富邦95購01,0.52,0.52,0.52,0.52,-0.18,-25.71,10000,1,5200,0,0,0,0,0,0,10000,0,10000,10000
20200312,050989,台表科富邦95購01,,,,,0.00,0.00,0,0,0,0,0,0,0,0,0,0,0,0,0
20200312,05098P,鴻海凱基95售15,1.78,2.15,1.78,2.04,+0.47,29.94,89000,6,169540,0,0,0,0,0,0,51000,89000,-38000,-38000
20200312,050990,T50反1元大95購01,0.79,1.02,0.79,1.02,+0.36,54.55,4000,4,3610,0,0,0,0,0,0,4000,0,4000,4000
20200312,050991,元油2X元大96購04,0.03,0.04,0.02,0.02,-0.01,-33.33,300000,4,7500,0,0,0,0,0,0,0,50000,-50000,-50000
20200312,050992,台積電元大97購01,0.91,1.10,0.83,1.10,-0.13,-10.57,100000,15,88050,0,0,0,0,0,0,14000,10000,4000,4000
20200312,050993,聯發科元大95購05,0.02,0.02,0.02,0.02,0.00,0.00,20000,1,400,0,0,0,0,0,0,20000,0,20000,20000
20200312,050994,欣興元大96購03,0.06,0.06,0.06,0.06,0.00,0.00,910000,4,54600,0,0,0,0,0,0,0,910000,-910000,-910000
20200312,050995,貿聯元大95購02,0.51,0.51,0.32,0.32,-0.36,-52.94,79000,3,27270,0,0,0,0,0,0,11000,68000,-57000,-57000
20200312,050996,隆達元大95購01,,,,,0.00,0.00,0,0,0,0,0,0,0,0,0,0,0,0,0
20200312,050997,麗豐元大95購03,,,,,0.00,0.00,0,0,0,0,0,0,0,0,0,0,0,0,0
20200312,050998,訊連元大95購01,1.32,1.32,1.12,1.12,-0.41,-26.8,65000,3,83800,0,0,0,0,0,0,41000,24000,17000,17000
20200312,050999,瀚宇博元大95購04,,,,,0.00,0.00,0,0,0,0,0,0,0,0,0,0,0,0,0
20200312,05099P,台積電凱基95售06,1.54,1.76,1.54,1.76,+0.53,43.09,130000,9,214300,0,0,0,0,0,0,110000,110000,0,0
20200312,051000,台郡元大96購01,0.48,0.48,0.30,0.31,-0.30,-49.18,968000,28,342090,0,0,0,0,0,0,361000,522000,-161000,-161000
20200312,051001,緯穎元大96購02,1.70,1.70,1.40,1.40,-0.84,-37.5,185000,7,283750,0,0,0,0,0,0,10000,175000,-165000,-165000
20200312,051002,華邦電亞東96購01,,,,,0.00,0.00,0,0,0,0,0,0,0,0,0,0,0,0,0
20200312,051003,中環中信97購01,0.01,0.01,0.01,0.01,-0.01,-50.0,620000,8,6200,0,0,0,0,0,0,0,0,0,0
20200312,051004,台新金中信95購02,,,,,0.00,0.00,0,0,0,0,0,0,0,0,0,0,0,0,0
20200312,051005,緯創中信95購02,,,,,0.00,0.00,0,0,0,0,0,0,0,0,0,0,0,0,0
20200312,051006,中磊中信95購01,,,,,0.00,0.00,0,0,0,0,0,0,0,0,0,0,0,0,0
20200312,051007,台光電麥證95購01,0.29,0.29,0.20,0.20,-0.15,-42.86,53000,5,13240,33000,20000,13000,0,0,0,33000,20000,13000,13000
20200312,051008,大立光麥證95購01,0.45,0.45,0.31,0.36,-0.44,-55.0,23000,6,7840,2000,21000,-19000,0,0,0,6000,21000,-15000,-15000
20200312,051009,緯創麥證95購01,,,,,0.00,0.00,0,0,0,0,0,0,0,0,0,0,0,0,0
20200312,05100P,智邦凱基95售02,0.72,1.02,0.71,0.96,+0.20,26.32,90000,8,73850,0,0,0,0,0,0,55000,35000,20000,20000
20200312,051010,美律日盛95購01,,,,,0.00,0.00,0,0,0,0,0,0,0,0,0,0,0,0,0
20200312,051011,國巨凱基95購03,1.27,1.27,1.08,1.08,-1.39,-56.28,57000,2,62890,0,0,0,0,0,0,57000,7000,50000,50000
20200312,051012,台積電凱基95購04,0.13,0.13,0.10,0.12,-0.07,-36.84,129000,9,14780,0,0,0,0,0,0,68000,61000,7000,7000
20200312,051013,旺宏凱基95購03,0.50,0.55,0.34,0.37,-0.36,-49.32,225000,8,106800,0,0,0,0,0,0,115000,110000,5000,5000
20200312,051014,智邦凱基95購01,,,,,0.00,0.00,0,0,0,0,0,0,0,0,0,0,0,0,0
20200312,051015,南亞科凱基95購04,0.27,0.27,0.27,0.27,-0.91,-77.12,5000,1,1350,0,0,0,0,0,0,0,5000,-5000,-5000
20200312,051016,京元電凱基95購03,,,,,0.00,0.00,0,0,0,0,0,0,0,0,0,0,0,0,0
20200312,051017,聯發科凱基95購04,,,,,0.00,0.00,0,0,0,0,0,0,0,0,0,0,0,0,0
20200312,051018,可成凱基95購03,,,,,0.00,0.00,0,0,0,0,0,0,0,0,0,0,0,0,0
20200312,051019,大立光凱基95購08,,,,,0.00,0.00,0,0,0,0,0,0,0,0,0,0,0,0,0
20200312,05101P,大立光凱基95售11,,,,,0.00,0.00,0,0,0,0,0,0,0,0,0,0,0,0,0
20200312,051020,健策凱基96購02,0.97,0.97,0.62,0.64,-0.56,-46.67,129000,19,106360,0,0,0,0,0,0,8000,121000,-113000,-113000
20200312,051021,啟碁凱基95購02,,,,,0.00,0.00,0,0,0,0,0,0,0,0,0,0,0,0,0
20200312,051022,GIS凱基95購02,,,,,0.00,0.00,0,0,0,0,0,0,0,0,0,0,0,0,0
20200312,051023,S&P反1統一95購02,1.39,1.57,1.39,1.57,+0.68,76.4,55000,2,85450,0,0,0,0,0,0,55000,0,55000,55000
20200312,051024,南亞科統一95購01,0.81,0.82,0.48,0.48,-0.86,-64.18,102000,5,66300,0,0,0,0,0,0,49000,53000,-4000,-4000
20200312,051025,晶華統一95購01,0.35,0.36,0.29,0.29,-0.17,-36.96,63000,4,20870,0,0,0,0,0,0,43000,20000,23000,23000
20200312,051026,健策統一96購01,,,,,0.00,0.00,0,0,0,0,0,0,0,0,0,0,0,0,0
20200312,051027,楠梓電元富95購01,0.13,0.13,0.07,0.08,-0.15,-65.22,80000,17,7320,0,0,0,0,0,0,10000,70000,-60000,-60000
20200312,051028,台光電元富95購02,0.65,0.65,0.55,0.55,-0.27,-32.93,60000,3,38480,0,0,0,0,0,0,60000,4000,56000,56000
20200312,051029,緯創元富95購01,,,,,0.00,0.00,0,0,0,0,0,0,0,0,0,0,0,0,0
20200312,05102P,臺股指凱基96售09,2.07,2.82,2.01,2.63,+0.88,50.29,128000,7,282160,0,0,0,0,0,0,100000,28000,72000,72000
20200312,051030,康友元富95購01,1.63,1.65,1.20,1.20,-0.73,-37.82,29000,3,44300,0,0,0,0,0,0,29000,0,29000,29000
20200312,051031,康友元富95購02,0.87,0.89,0.62,0.62,-0.38,-38.0,113000,6,91010,0,0,0,0,0,0,93000,33000,60000,60000
20200312,051032,南電元富95購01,,,,,0.00,0.00,0,0,0,0,0,0,0,0,0,0,0,0,0
20200312,051033,台積電兆豐95購03,,,,,0.00,0.00,0,0,0,0,0,0,0,0,0,0,0,0,0
20200312,051034,正崴兆豐95購01,,,,,0.00,0.00,0,0,0,0,0,0,0,0,0,0,0,0,0
20200312,051035,百和兆豐95購01,,,,,0.00,0.00,0,0,0,0,0,0,0,0,0,0,0,0,0
20200312,051036,喬山台新95購01,,,,,0.00,0.00,0,0,0,0,0,0,0,0,0,0,0,0,0
20200312,051037,大立光台新95購01,,,,,0.00,0.00,0,0,0,0,0,0,0,0,0,0,0,0,0
20200312,051038,健策台新95購01,0.67,0.71,0.67,0.71,0.00,0.00,94000,2,64740,0,0,0,0,0,0,0,94000,-94000,-94000
20200312,051039,台表科康和95購01,,,,,0.00,0.00,0,0,0,0,0,0,0,0,0,0,0,0,0
20200312,05103P,臺股指凱基96售10,2.36,3.25,2.26,3.10,+1.21,64.02,203000,16,562600,0,0,0,0,0,0,137000,66000,71000,71000
20200312,051040,漢唐永豐95購01,0.25,0.25,0.25,0.25,-0.13,-34.21,37000,1,9250,0,0,0,0,0,0,37000,0,37000,37000
20200312,051041,大立光永豐95購01,,,,,0.00,0.00,0,0,0,0,0,0,0,0,0,0,0,0,0
20200312,051042,中磊永豐95購01,0.37,0.37,0.35,0.35,-0.10,-22.22,78000,2,27500,0,0,0,0,0,0,68000,10000,58000,58000
20200312,051043,瀚宇博永豐95購01,,,,,0.00,0.00,0,0,0,0,0,0,0,0,0,0,0,0,0
20200312,051044,GIS永豐95購01,,,,,0.00,0.00,0,0,0,0,0,0,0,0,0,0,0,0,0
20200312,051045,南茂永豐95購01,0.07,0.07,0.07,0.07,-0.10,-58.82,2000,1,140,0,0,0,0,0,0,2000,0,2000,2000
20200312,051046,寶成永豐95購01,,,,,0.00,0.00,0,0,0,0,0,0,0,0,0,0,0,0,0
20200312,051047,深中小群益99購01,1.91,1.91,1.73,1.73,-0.44,-20.28,107000,8,194150,0,0,0,0,0,0,45000,62000,-17000,-17000
20200312,051048,臺指反群益96購01,0.71,1.04,0.71,0.99,+0.50,102.04,417000,7,349910,0,0,0,0,0,0,387000,80000,307000,307000
20200312,051049,亞德客群益95購01,,,,,0.00,0.00,0,0,0,0,0,0,0,0,0,0,0,0,0
20200312,05104P,智邦台新95售02,0.82,0.82,0.82,0.82,0.00,0.00,59000,1,48380,0,0,0,0,0,0,0,59000,-59000,-59000
20200312,051050,鴻海群益95購03,0.18,0.18,0.09,0.11,-0.23,-67.65,118000,12,19320,0,0,0,0,0,0,0,118000,-118000,-118000
20200312,051051,鴻海群益95購04,,,,,0.00,0.00,0,0,0,0,0,0,0,0,0,0,0,0,0
20200312,051052,台積電群益95購01,0.55,0.55,0.30,0.54,-0.22,-28.95,428000,18,192030,0,0,0,0,0,0,305000,129000,176000,176000
20200312,051053,台光電群益95購01,0.57,0.57,0.38,0.43,-0.24,-35.82,153000,15,77940,0,0,0,0,0,0,60000,93000,-33000,-33000
20200312,051054,正崴群益95購01,,,,,0.00,0.00,0,0,0,0,0,0,0,0,0,0,0,0,0
20200312,051055,友達群益98購01,,,,,0.00,0.00,0,0,0,0,0,0,0,0,0,0,0,0,0
20200312,051056,華新科群益95購03,0.12,0.12,0.12,0.12,0.00,0.00,20000,2,2400,0,0,0,0,0,0,0,20000,-20000,-20000
20200312,051057,信邦群益95購01,1.36,1.36,1.36,1.36,-0.53,-28.04,10000,1,13600,0,0,0,0,0,0,10000,0,10000,10000
20200312,051058,景碩群益96購01,0.54,0.54,0.54,0.54,0.00,0.00,20000,2,10800,0,0,0,0,0,0,0,20000,-20000,-20000
20200312,051059,康普群益95購01,,,,,0.00,0.00,0,0,0,0,0,0,0,0,0,0,0,0,0
20200312,05105P,大立光台新95售02,0.88,0.97,0.87,0.97,+0.38,64.41,130000,10,120450,0,0,0,0,0,0,81000,49000,32000,32000
20200312,051060,鎧勝群益95購01,,,,,0.00,0.00,0,0,0,0,0,0,0,0,0,0,0,0,0
20200312,051061,中磊群益95購01,0.28,0.28,0.28,0.28,-0.07,-20.0,98000,1,27440,0,0,0,0,0,0,98000,0,98000,98000
20200312,051062,超眾群益95購02,0.26,0.29,0.26,0.26,0.00,0.00,180000,18,48900,0,0,0,0,0,0,0,180000,-180000,-180000
20200312,051063,台郡群益95購01,0.23,0.23,0.16,0.16,-0.27,-62.79,41000,14,7500,0,0,0,0,0,0,31000,10000,21000,21000
20200312,051064,鴻海國票95購01,0.15,0.16,0.08,0.08,-0.22,-73.33,510000,12,57100,0,0,0,0,0,0,280000,230000,50000,50000
20200312,051065,台積電國票96購01,0.48,0.48,0.48,0.48,-0.10,-17.24,1000,1,480,0,0,0,0,0,0,0,0,0,0
20200312,051066,台積電國票96購02,0.12,0.12,0.07,0.09,-0.13,-59.09,767000,16,72280,0,0,0,0,0,0,0,767000,-767000,-767000
20200312,051067,台積電國票96購03,1.78,1.78,1.36,1.56,-0.66,-29.73,154000,16,258320,0,0,0,0,0,0,61000,93000,-32000,-32000
20200312,051068,台積電國票97購01,,,,,0.00,0.00,0,0,0,0,0,0,0,0,0,0,0,0,0
20200312,051069,智邦國票96購01,0.37,0.39,0.29,0.30,-0.21,-41.18,202000,12,66540,0,0,0,0,0,0,120000,82000,38000,38000
20200312,05106P,鴻海永豐95售02,,,,,0.00,0.00,0,0,0,0,0,0,0,0,0,0,0,0,0
20200312,051070,正崴國票96購01,0.06,0.06,0.05,0.05,-0.08,-61.54,70000,3,3800,0,0,0,0,0,0,0,70000,-70000,-70000
20200312,051071,聯發科國票96購01,,,,,0.00,0.00,0,0,0,0,0,0,0,0,0,0,0,0,0
20200312,051072,強茂國票95購02,,,,,0.00,0.00,0,0,0,0,0,0,0,0,0,0,0,0,0
20200312,051073,同欣電國票96購01,0.34,0.34,0.26,0.26,-0.31,-54.39,60000,5,18300,0,0,0,0,0,0,50000,10000,40000,40000
20200312,051074,矽力國票96購01,3.19,3.50,3.19,3.50,-0.95,-21.35,16000,2,55690,0,0,0,0,0,0,0,16000,-16000,-16000
20200312,051075,智邦國泰97購01,1.02,1.02,0.71,0.75,-0.33,-30.56,219000,18,196180,0,0,0,0,0,0,119000,103000,16000,16000
20200312,051076,緯創國泰96購01,0.23,0.23,0.23,0.23,-0.13,-36.11,114000,2,26220,0,0,0,0,0,0,114000,16000,98000,98000
20200312,051077,台郡國泰96購02,1.01,1.01,0.72,0.72,-0.47,-39.5,437000,17,354840,0,0,0,0,0,0,212000,225000,-13000,-13000
20200312,051078,力山富邦97購01,0.10,0.10,0.08,0.08,-0.04,-33.33,25000,3,2300,0,0,0,0,0,0,0,15000,-15000,-15000
20200312,051079,鴻海富邦96購02,,,,,0.00,0.00,0,0,0,0,0,0,0,0,0,0,0,0,0
20200312,05107P,鴻海兆豐96售02,1.85,2.23,1.81,2.23,+0.62,38.51,167000,6,347430,0,0,0,0,0,0,136000,156000,-20000,-20000
20200312,051080,全新富邦96購01,,,,,0.00,0.00,0,0,0,0,0,0,0,0,0,0,0,0,0
20200312,051081,聯茂富邦96購01,,,,,0.00,0.00,0,0,0,0,0,0,0,0,0,0,0,0,0
20200312,051082,上証2X元大98購01,0.52,0.55,0.52,0.55,-0.16,-22.54,55000,2,28750,0,0,0,0,0,0,5000,50000,-45000,-45000
20200312,051083,A50正2元大98購01,0.63,0.69,0.62,0.69,-0.11,-13.75,242000,6,152720,0,0,0,0,0,0,0,242000,-242000,-242000
20200312,051084,華通元大95購06,,,,,0.00,0.00,0,0,0,0,0,0,0,0,0,0,0,0,0
20200312,051085,鴻海元大95購03,0.07,0.07,0.03,0.04,-0.08,-66.67,180000,7,9200,0,0,0,0,0,0,80000,100000,-20000,-20000
20200312,051086,鴻海元大96購04,0.24,0.24,0.14,0.14,-0.16,-53.33,321000,14,55290,0,0,0,0,0,0,0,321000,-321000,-321000
20200312,051087,國巨元大97購01,2.70,2.70,1.94,1.94,0.00,0.00,85000,4,175600,0,0,0,0,0,0,75000,85000,-10000,-10000
20200312,051088,台積電元大95購09,0.28,0.28,0.28,0.28,-0.51,-64.56,20000,2,5600,0,0,0,0,0,0,0,20000,-20000,-20000
20200312,051089,旺宏元大96購04,0.82,0.82,0.55,0.60,-0.47,-43.93,306000,7,192020,0,0,0,0,0,0,25000,271000,-246000,-246000
20200312,05108P,欣興中信95售02,0.96,1.16,0.96,1.16,+0.49,73.13,89000,4,91400,0,0,0,0,0,0,21000,68000,-47000,-47000
20200312,051090,光磊元大96購01,,,,,0.00,0.00,0,0,0,0,0,0,0,0,0,0,0,0,0
20200312,051091,聯發科元大95購07,,,,,0.00,0.00,0,0,0,0,0,0,0,0,0,0,0,0,0
20200312,051092,禾伸堂元大95購02,0.65,0.65,0.55,0.55,0.00,0.00,227000,8,137580,0,0,0,0,0,0,100000,227000,-127000,-127000
20200312,051093,聯詠元大95購01,0.19,0.19,0.16,0.16,-0.14,-46.67,210000,2,33900,0,0,0,0,0,0,10000,200000,-190000,-190000
20200312,051094,健策元大96購03,2.03,2.03,1.55,1.55,-1.64,-51.41,80000,3,152200,0,0,0,0,0,0,20000,60000,-40000,-40000
20200312,051095,貿聯元大95購03,0.41,0.41,0.30,0.30,-0.24,-44.44,203000,6,70310,0,0,0,0,0,0,66000,137000,-71000,-71000
20200312,051096,日月光元大95購01,,,,,0.00,0.00,0,0,0,0,0,0,0,0,0,0,0,0,0
20200312,051097,嘉聯益元大96購02,0.23,0.23,0.17,0.17,-0.12,-41.38,812000,6,178040,0,0,0,0,0,0,412000,400000,12000,12000
20200312,051098,矽格元大95購01,0.50,0.50,0.48,0.48,-0.11,-18.64,211000,3,104060,0,0,0,0,0,0,139000,72000,67000,67000
20200312,051099,台郡元大95購03,0.22,0.22,0.12,0.16,-0.18,-52.94,715000,11,119140,0,0,0,0,0,0,489000,272000,217000,217000
20200312,05109P,臺股指麥證95售01,,,,,0.00,0.00,0,0,0,0,0,0,0,0,0,0,0,0,0
20200312,051100,同欣電元大95購01,0.83,0.83,0.69,0.69,-0.62,-47.33,23000,2,18250,0,0,0,0,0,0,17000,6000,11000,11000
20200312,051101,台表科元大96購02,0.26,0.26,0.19,0.19,-0.21,-52.5,864000,7,170010,0,0,0,0,0,0,45000,819000,-774000,-774000
20200312,051102,訊芯元大96購01,,,,,0.00,0.00,0,0,0,0,0,0,0,0,0,0,0,0,0
20200312,051103,緯穎元大96購03,1.72,1.72,1.45,1.45,0.00,0.00,113000,6,170490,0,0,0,0,0,0,10000,113000,-103000,-103000
20200312,051104,鈺齊元大96購01,0.42,0.42,0.40,0.40,-0.11,-21.57,105000,3,42600,0,0,0,0,0,0,30000,75000,-45000,-45000
20200312,051105,台光電國票96購01,,,,,0.00,0.00,0,0,0,0,0,0,0,0,0,0,0,0,0
20200312,051106,華通統一95購02,,,,,0.00,0.00,0,0,0,0,0,0,0,0,0,0,0,0,0
20200312,051107,鴻海統一95購05,0.01,0.01,0.01,0.01,0.00,0.00,294000,3,2940,0,0,0,0,0,0,108000,0,108000,108000
20200312,051108,鴻海統一96購02,,,,,0.00,0.00,0,0,0,0,0,0,0,0,0,0,0,0,0
20200312,051109,美律統一95購02,0.10,0.16,0.10,0.16,-0.03,-15.79,45000,6,5550,0,0,0,0,0,0,0,45000,-45000,-45000
20200312,05110P,上銀統一95售01,2.73,2.80,2.73,2.80,+1.14,68.67,30000,3,83300,0,0,0,0,0,0,10000,20000,-10000,-10000
20200312,051110,可成統一95購01,,,,,0.00,0.00,0,0,0,0,0,0,0,0,0,0,0,0,0
20200312,051111,可成統一95購02,,,,,0.00,0.00,0,0,0,0,0,0,0,0,0,0,0,0,0
20200312,051112,台郡統一95購01,0.35,0.35,0.30,0.30,-0.56,-65.12,13000,8,4340,0,0,0,0,0,0,10000,3000,7000,7000
20200312,051113,聯電元富95購01,0.28,0.28,0.14,0.20,-0.15,-42.86,363000,9,76400,0,0,0,0,0,0,41000,322000,-281000,-281000
20200312,051114,鈺齊中信95購01,0.06,0.08,0.04,0.04,-0.09,-69.23,220000,11,13940,0,0,0,0,0,0,54000,160000,-106000,-106000
20200312,051115,華通麥證96購01,0.32,0.32,0.22,0.23,-0.18,-43.9,200000,4,46600,80000,120000,-40000,0,0,0,80000,120000,-40000,-40000
20200312,051116,可成麥證95購01,,,,,0.00,0.00,0,0,0,0,0,0,0,0,0,0,0,0,0
20200312,051117,臺指反群益95購02,1.09,1.09,1.09,1.09,0.00,0.00,50000,1,54500,0,0,0,0,0,0,50000,0,50000,50000
20200312,051118,台塑群益95購01,0.03,0.03,0.02,0.02,-0.06,-75.0,27000,2,700,0,0,0,0,0,0,11000,16000,-5000,-5000
20200312,051119,光寶科群益95購01,0.40,0.40,0.40,0.40,-0.16,-28.57,11000,1,4400,0,0,0,0,0,0,11000,0,11000,11000
20200312,05111P,台積電統一95售04,1.11,1.54,1.10,1.25,+0.28,28.87,891000,43,1050640,0,0,0,0,0,0,412000,505000,-93000,-93000
20200312,051120,南亞科群益95購01,,,,,0.00,0.00,0,0,0,0,0,0,0,0,0,0,0,0,0
20200312,051121,裕民群益97購01,0.58,0.58,0.58,0.58,-0.10,-14.71,10000,1,5800,0,0,0,0,0,0,0,10000,-10000,-10000
20200312,051122,美食群益95購01,,,,,0.00,0.00,0,0,0,0,0,0,0,0,0,0,0,0,0
20200312,051123,和鑫群益95購01,,,,,0.00,0.00,0,0,0,0,0,0,0,0,0,0,0,0,0
20200312,051124,創意群益95購01,,,,,0.00,0.00,0,0,0,0,0,0,0,0,0,0,0,0,0
20200312,051125,TPK群益95購01,,,,,0.00,0.00,0,0,0,0,0,0,0,0,0,0,0,0,0
20200312,051126,訊連群益95購01,0.38,0.42,0.35,0.35,-0.22,-38.6,86000,3,32780,0,0,0,0,0,0,66000,20000,46000,46000
20200312,051127,同欣電群益95購01,0.15,0.15,0.08,0.09,-0.11,-55.0,447000,11,44400,0,0,0,0,0,0,357000,90000,267000,267000
20200312,051128,台表科群益95購02,0.15,0.15,0.10,0.10,-0.12,-54.55,50000,3,5250,0,0,0,0,0,0,5000,45000,-40000,-40000
20200312,051129,GIS群益95購01,,,,,0.00,0.00,0,0,0,0,0,0,0,0,0,0,0,0,0
20200312,05112P,燿華統一95售01,,,,,0.00,0.00,0,0,0,0,0,0,0,0,0,0,0,0,0
20200312,051130,百和群益96購01,,,,,0.00,0.00,0,0,0,0,0,0,0,0,0,0,0,0,0
20200312,051131,玉山金台新95購01,0.30,0.30,0.20,0.22,0.00,0.00,240000,8,60300,0,0,0,0,0,0,130000,110000,20000,20000
20200312,051132,喬山永豐95購02,,,,,0.00,0.00,0,0,0,0,0,0,0,0,0,0,0,0,0
20200312,051133,台積電永豐95購02,0.15,0.15,0.08,0.11,-0.07,-38.89,9266000,442,973900,0,0,0,0,0,0,231000,3243000,-3012000,-3012000
20200312,051134,燿華永豐95購05,,,,,0.00,0.00,0,0,0,0,0,0,0,0,0,0,0,0,0
20200312,051135,建準永豐95購01,,,,,0.00,0.00,0,0,0,0,0,0,0,0,0,0,0,0,0
20200312,051136,可成永豐95購02,,,,,0.00,0.00,0,0,0,0,0,0,0,0,0,0,0,0,0
20200312,051137,聯詠永豐95購01,0.02,0.03,0.01,0.03,0.00,0.00,40000,4,800,0,0,0,0,0,0,0,30000,-30000,-30000
20200312,051138,訊連永豐95購01,,,,,0.00,0.00,0,0,0,0,0,0,0,0,0,0,0,0,0
20200312,051139,康友永豐95購01,0.18,0.18,0.18,0.18,-0.22,-55.0,10000,1,1800,0,0,0,0,0,0,0,10000,-10000,-10000
20200312,05113P,臺股指元富95售01,,,,,0.00,0.00,0,0,0,0,0,0,0,0,0,0,0,0,0
20200312,051140,矽創永豐95購02,,,,,0.00,0.00,0,0,0,0,0,0,0,0,0,0,0,0,0
20200312,051141,鈺齊永豐95購01,0.02,0.02,0.02,0.02,0.00,0.00,100000,1,2000,0,0,0,0,0,0,100000,0,100000,100000
20200312,051142,臺股指永豐95購02,,,,,0.00,0.00,0,0,0,0,0,0,0,0,0,0,0,0,0
20200312,051143,鴻海凱基95購11,,,,,0.00,0.00,0,0,0,0,0,0,0,0,0,0,0,0,0
20200312,051144,鴻海凱基95購12,,,,,0.00,0.00,0,0,0,0,0,0,0,0,0,0,0,0,0
20200312,051145,台積電凱基95購05,,,,,0.00,0.00,0,0,0,0,0,0,0,0,0,0,0,0,0
20200312,051146,旺宏凱基95購04,0.24,0.28,0.24,0.26,0.00,0.00,53000,5,13820,0,0,0,0,0,0,0,53000,-53000,-53000
20200312,051147,南亞科凱基95購05,0.90,0.90,0.90,0.90,0.00,0.00,10000,1,9000,0,0,0,0,0,0,0,10000,-10000,-10000
20200312,051148,聯發科凱基95購06,,,,,0.00,0.00,0,0,0,0,0,0,0,0,0,0,0,0,0
20200312,051149,可成凱基95購04,,,,,0.00,0.00,0,0,0,0,0,0,0,0,0,0,0,0,0
20200312,05114P,臺股指元富95售02,,,,,0.00,0.00,0,0,0,0,0,0,0,0,0,0,0,0,0
20200312,051150,宏達電凱基95購02,0.31,0.31,0.31,0.31,-0.15,-32.61,20000,1,6200,0,0,0,0,0,0,0,20000,-20000,-20000
20200312,051151,中磊凱基95購02,,,,,0.00,0.00,0,0,0,0,0,0,0,0,0,0,0,0,0
20200312,051152,鴻海國泰97購01,0.46,0.46,0.39,0.39,-0.20,-33.9,675000,21,292950,0,0,0,0,0,0,20000,655000,-635000,-635000
20200312,051153,鴻海國泰97購02,0.28,0.28,0.22,0.22,-0.18,-45.0,310000,7,74800,0,0,0,0,0,0,10000,300000,-290000,-290000
20200312,051154,國巨國泰96購03,,,,,0.00,0.00,0,0,0,0,0,0,0,0,0,0,0,0,0
20200312,051155,聯發科國泰96購01,0.29,0.29,0.18,0.21,-0.33,-61.11,40000,3,9700,0,0,0,0,0,0,30000,10000,20000,20000
20200312,051156,鴻海富邦97購01,0.14,0.15,0.14,0.14,0.00,0.00,76000,6,10690,0,0,0,0,0,0,0,0,0,0
20200312,051157,華新科富邦98購01,0.63,0.63,0.38,0.42,-0.24,-36.36,175000,14,87060,0,0,0,0,0,0,100000,75000,25000,25000
20200312,051158,嘉晶富邦96購01,0.20,0.22,0.15,0.18,-0.04,-18.18,876000,18,160440,0,0,0,0,0,0,405000,471000,-66000,-66000
20200312,051159,力山元大96購01,,,,,0.00,0.00,0,0,0,0,0,0,0,0,0,0,0,0,0
20200312,05115P,T50反1群益95售02,,,,,0.00,0.00,0,0,0,0,0,0,0,0,0,0,0,0,0
20200312,051160,亞德客元大95購02,0.79,0.79,0.79,0.79,-0.99,-55.62,1000,1,790,0,0,0,0,0,0,1000,1000,0,0
20200312,051161,喬山元大95購02,,,,,0.00,0.00,0,0,0,0,0,0,0,0,0,0,0,0,0
20200312,051162,楠梓電元大95購01,,,,,0.00,0.00,0,0,0,0,0,0,0,0,0,0,0,0,0
20200312,051163,鴻海元大95購04,0.11,0.11,0.06,0.06,0.00,0.00,80000,4,6400,0,0,0,0,0,0,0,80000,-80000,-80000
20200312,051164,鴻海元大95購05,,,,,0.00,0.00,0,0,0,0,0,0,0,0,0,0,0,0,0
20200312,051165,可成元大95購01,,,,,0.00,0.00,0,0,0,0,0,0,0,0,0,0,0,0,0
20200312,051166,可成元大95購02,,,,,0.00,0.00,0,0,0,0,0,0,0,0,0,0,0,0,0
20200312,051167,京鼎元大95購01,0.41,0.41,0.38,0.38,-0.13,-25.49,136000,5,53520,0,0,0,0,0,0,68000,68000,0,0
20200312,051168,訊連元大95購02,0.41,0.42,0.41,0.42,-0.32,-43.24,50000,2,20600,0,0,0,0,0,0,0,40000,-40000,-40000
20200312,051169,瀚宇博元大95購05,,,,,0.00,0.00,0,0,0,0,0,0,0,0,0,0,0,0,0
20200312,05116P,台積電群益95售03,0.60,0.69,0.60,0.69,+0.20,40.82,52000,5,33190,0,0,0,0,0,0,52000,0,52000,52000
20200312,051170,南電元大95購03,,,,,0.00,0.00,0,0,0,0,0,0,0,0,0,0,0,0,0
20200312,051171,T50反1第一95購01,,,,,0.00,0.00,0,0,0,0,0,0,0,0,0,0,0,0,0
20200312,051172,鴻海第一96購01,,,,,0.00,0.00,0,0,0,0,0,0,0,0,0,0,0,0,0
20200312,051173,元油2X凱基98購01,0.06,0.07,0.05,0.05,-0.03,-37.5,455000,9,25730,0,0,0,0,0,0,0,0,0,0
20200312,051174,鴻海凱基95購14,0.01,0.01,0.01,0.01,0.00,0.00,10000,10,100,0,0,0,0,0,0,0,0,0,0
20200312,051175,國巨凱基95購04,1.21,1.21,0.51,0.60,-0.85,-58.62,725000,76,503200,0,0,0,0,0,0,14000,711000,-697000,-697000
20200312,051176,聯發科凱基95購07,,,,,0.00,0.00,0,0,0,0,0,0,0,0,0,0,0,0,0
20200312,051177,可成凱基95購05,,,,,0.00,0.00,0,0,0,0,0,0,0,0,0,0,0,0,0
20200312,051178,大立光凱基95購10,0.01,0.10,0.01,0.10,0.00,0.00,15000,2,600,0,0,0,0,0,0,10000,5000,5000,5000
20200312,051179,臺股指凱基95購04,0.10,0.10,0.07,0.07,-0.25,-78.12,39000,4,3030,0,0,0,0,0,0,0,39000,-39000,-39000
20200312,05117P,瑞昱群益95售02,,,,,0.00,0.00,0,0,0,0,0,0,0,0,0,0,0,0,0
20200312,051180,喬山永豐95購03,,,,,0.00,0.00,0,0,0,0,0,0,0,0,0,0,0,0,0
20200312,051181,鴻海永豐95購03,,,,,0.00,0.00,0,0,0,0,0,0,0,0,0,0,0,0,0
20200312,051182,旺宏永豐95購01,0.13,0.13,0.13,0.13,0.00,0.00,15000,1,1950,0,0,0,0,0,0,15000,0,15000,15000
20200312,051183,建準永豐95購02,,,,,0.00,0.00,0,0,0,0,0,0,0,0,0,0,0,0,0
20200312,051184,聯發科永豐95購03,,,,,0.00,0.00,0,0,0,0,0,0,0,0,0,0,0,0,0
20200312,051185,強茂永豐95購03,0.27,0.27,0.27,0.27,-0.14,-34.15,25000,1,6750,0,0,0,0,0,0,25000,0,25000,25000
20200312,051186,創意永豐95購01,,,,,0.00,0.00,0,0,0,0,0,0,0,0,0,0,0,0,0
20200312,051187,晶相光永豐95購01,0.18,0.18,0.14,0.14,-0.09,-39.13,160000,5,27250,0,0,0,0,0,0,160000,0,160000,160000
20200312,051188,鴻海兆豐95購01,,,,,0.00,0.00,0,0,0,0,0,0,0,0,0,0,0,0,0
20200312,051189,鴻海兆豐96購01,,,,,0.00,0.00,0,0,0,0,0,0,0,0,0,0,0,0,0
20200312,05118P,超眾元大96售04,0.80,0.83,0.78,0.82,+0.21,34.43,175000,7,141750,0,0,0,0,0,0,40000,125000,-85000,-85000
20200312,051190,可成兆豐95購03,,,,,0.00,0.00,0,0,0,0,0,0,0,0,0,0,0,0,0
20200312,051191,可成兆豐96購01,0.01,0.01,0.01,0.01,-0.01,-50.0,10000,1,100,0,0,0,0,0,0,0,10000,-10000,-10000
20200312,051192,緯創兆豐96購01,,,,,0.00,0.00,0,0,0,0,0,0,0,0,0,0,0,0,0
20200312,051193,新日興兆豐96購01,0.70,0.70,0.48,0.48,-0.32,-40.0,76000,11,43600,0,0,0,0,0,0,26000,45000,-19000,-19000
20200312,051194,大立光中信96購02,,,,,0.00,0.00,0,0,0,0,0,0,0,0,0,0,0,0,0
20200312,051195,台郡中信95購01,0.10,0.10,0.06,0.07,-0.12,-63.16,125000,35,9710,0,0,0,0,0,0,125000,0,125000,125000
20200312,051196,喬山麥證95購01,,,,,0.00,0.00,0,0,0,0,0,0,0,0,0,0,0,0,0
20200312,051197,光寶科麥證95購01,,,,,0.00,0.00,0,0,0,0,0,0,0,0,0,0,0,0,0
20200312,051198,鴻海麥證95購02,,,,,0.00,0.00,0,0,0,0,0,0,0,0,0,0,0,0,0
20200312,051199,鴻海麥證95購03,,,,,0.00,0.00,0,0,0,0,0,0,0,0,0,0,0,0,0
20200312,05119P,聯發科國泰96售02,2.66,3.07,2.66,3.07,+0.61,24.8,41000,3,115920,0,0,0,0,0,0,41000,36000,5000,5000
20200312,051200,國巨麥證95購01,,,,,0.00,0.00,0,0,0,0,0,0,0,0,0,0,0,0,0
20200312,051201,台積電麥證95購02,0.36,0.40,0.34,0.38,-0.31,-44.93,2400000,8,882000,0,2400000,-2400000,0,0,0,0,2400000,-2400000,-2400000
20200312,051202,智邦麥證95購01,0.48,0.48,0.39,0.39,-0.23,-37.1,16000,8,7180,16000,0,16000,0,0,0,16000,0,16000,16000
20200312,051203,微星麥證95購01,,,,,0.00,0.00,0,0,0,0,0,0,0,0,0,0,0,0,0
20200312,051204,正崴麥證95購01,,,,,0.00,0.00,0,0,0,0,0,0,0,0,0,0,0,0,0
20200312,051205,華新科麥證95購02,0.69,0.72,0.69,0.72,-0.49,-40.5,207000,4,148740,197000,10000,187000,0,0,0,197000,10000,187000,187000
20200312,051206,大立光麥證95購02,0.42,0.42,0.36,0.36,-0.47,-56.63,30000,3,12000,10000,20000,-10000,0,0,0,10000,20000,-10000,-10000
20200312,051207,聯茂麥證95購01,0.45,0.45,0.44,0.44,-0.06,-12.0,20000,2,8900,10000,10000,0,0,0,0,10000,10000,0,0
20200312,051208,GIS麥證95購01,,,,,0.00,0.00,0,0,0,0,0,0,0,0,0,0,0,0,0
20200312,051209,百和麥證95購01,,,,,0.00,0.00,0,0,0,0,0,0,0,0,0,0,0,0,0
20200312,05120P,聯發科國泰97售01,2.58,2.72,2.58,2.72,0.00,0.00,104000,3,278880,0,0,0,0,0,0,0,104000,-104000,-104000
20200312,051210,S&P反1統一97購01,,,,,0.00,0.00,0,0,0,0,0,0,0,0,0,0,0,0,0
20200312,051211,道瓊反統一95購01,,,,,0.00,0.00,0,0,0,0,0,0,0,0,0,0,0,0,0
20200312,051212,國巨統一95購01,1.96,1.96,1.23,1.23,-1.98,-61.68,111000,4,172570,0,0,0,0,0,0,70000,41000,29000,29000
20200312,051213,華新科統一95購01,,,,,0.00,0.00,0,0,0,0,0,0,0,0,0,0,0,0,0
20200312,051214,大立光統一95購02,0.26,0.26,0.17,0.17,-0.53,-75.71,53000,3,12240,0,0,0,0,0,0,35000,18000,17000,17000
20200312,051215,大立光統一95購03,0.01,0.01,0.01,0.01,-0.03,-75.0,1000,1,10,0,0,0,0,0,0,0,0,0,0
20200312,051216,為升元富95購01,,,,,0.00,0.00,0,0,0,0,0,0,0,0,0,0,0,0,0
20200312,051217,聯發科元富95購01,,,,,0.00,0.00,0,0,0,0,0,0,0,0,0,0,0,0,0
20200312,051218,聯發科元富9B購02,0.26,0.26,0.17,0.17,-0.12,-41.38,128000,10,28440,0,0,0,0,0,0,0,128000,-128000,-128000
20200312,051219,大立光元富95購07,,,,,0.00,0.00,0,0,0,0,0,0,0,0,0,0,0,0,0
20200312,05121P,創意國泰96售01,3.00,3.49,3.00,3.49,+0.70,25.09,3000,2,9490,0,0,0,0,0,0,0,3000,-3000,-3000
20200312,051220,大立光元富95購08,,,,,0.00,0.00,0,0,0,0,0,0,0,0,0,0,0,0,0
20200312,051221,嘉聯益元富95購01,,,,,0.00,0.00,0,0,0,0,0,0,0,0,0,0,0,0,0
20200312,051222,世紀鋼元富95購01,1.03,1.03,0.80,0.92,-0.21,-18.58,974000,43,898810,0,0,0,0,0,0,601000,353000,248000,248000
20200312,051223,台化群益95購01,,,,,0.00,0.00,0,0,0,0,0,0,0,0,0,0,0,0,0
20200312,051224,華通群益96購03,0.32,0.33,0.15,0.17,-0.41,-70.69,100000,17,27240,0,0,0,0,0,0,68000,32000,36000,36000
20200312,051225,台積電群益95購02,0.18,0.18,0.16,0.16,-0.21,-56.76,64000,9,11020,0,0,0,0,0,0,4000,10000,-6000,-6000
20200312,051226,英業達群益95購01,0.39,0.39,0.39,0.39,-0.06,-13.33,11000,1,4290,0,0,0,0,0,0,11000,0,11000,11000
20200312,051227,技嘉群益97購01,0.52,0.56,0.41,0.46,-0.20,-30.3,270000,8,137080,0,0,0,0,0,0,160000,110000,50000,50000
20200312,051228,聯發科群益95購03,,,,,0.00,0.00,0,0,0,0,0,0,0,0,0,0,0,0,0
20200312,051229,亞光群益95購01,,,,,0.00,0.00,0,0,0,0,0,0,0,0,0,0,0,0,0
20200312,05122P,鴻海永昌96售06,4.92,4.92,4.86,4.86,+0.39,8.72,26000,2,127020,0,0,0,0,0,0,26000,26000,0,0
20200312,051230,聯詠群益95購01,0.11,0.11,0.10,0.10,0.00,0.00,42000,2,4500,0,0,0,0,0,0,12000,30000,-18000,-18000
20200312,051231,健策群益97購01,0.44,0.46,0.34,0.34,-0.27,-44.26,467000,12,185870,0,0,0,0,0,0,7000,460000,-453000,-453000
20200312,051232,貿聯群益95購02,0.47,0.47,0.40,0.40,-0.25,-38.46,156000,8,63540,0,0,0,0,0,0,156000,0,156000,156000
20200312,051233,力成群益97購01,2.48,2.48,1.83,1.87,-1.07,-36.39,66000,8,143470,0,0,0,0,0,0,36000,30000,6000,6000
20200312,051234,南電群益95購02,0.38,0.38,0.38,0.38,-0.06,-13.64,5000,1,1900,0,0,0,0,0,0,5000,5000,0,0
20200312,051235,鴻海元大95購06,,,,,0.00,0.00,0,0,0,0,0,0,0,0,0,0,0,0,0
20200312,051236,鴻海元大96購05,,,,,0.00,0.00,0,0,0,0,0,0,0,0,0,0,0,0,0
20200312,051237,鴻海元大97購01,,,,,0.00,0.00,0,0,0,0,0,0,0,0,0,0,0,0,0
20200312,051238,中環元大96購01,0.06,0.06,0.06,0.06,0.00,0.00,20000,1,1200,0,0,0,0,0,0,0,20000,-20000,-20000
20200312,051239,國巨元大96購02,3.03,3.22,2.97,2.98,0.00,0.00,200000,18,598920,0,0,0,0,0,0,33000,200000,-167000,-167000
20200312,05123P,鴻海永昌96售07,3.93,4.79,3.89,4.74,+1.40,41.92,321000,11,1322120,0,0,0,0,0,0,276000,145000,131000,131000
20200312,051240,台積電元大95購12,0.31,0.31,0.18,0.18,-0.24,-57.14,165000,11,38020,0,0,0,0,0,0,0,50000,-50000,-50000
20200312,051241,台積電元大95購13,0.05,0.05,0.05,0.05,0.00,0.00,140000,14,7000,0,0,0,0,0,0,0,140000,-140000,-140000
20200312,051242,台積電元大96購06,,,,,0.00,0.00,0,0,0,0,0,0,0,0,0,0,0,0,0
20200312,051243,微星元大95購01,0.60,0.60,0.60,0.60,-0.25,-29.41,88000,2,52800,0,0,0,0,0,0,20000,68000,-48000,-48000
20200312,051244,正崴元大95購01,,,,,0.00,0.00,0,0,0,0,0,0,0,0,0,0,0,0,0
20200312,051245,南亞科元大95購01,1.30,1.30,0.80,0.80,0.00,0.00,99000,6,110870,0,0,0,0,0,0,9000,99000,-90000,-90000
20200312,051246,美律元大96購01,0.13,0.13,0.08,0.08,0.00,0.00,20000,2,2100,0,0,0,0,0,0,0,20000,-20000,-20000
20200312,051247,可成元大95購04,,,,,0.00,0.00,0,0,0,0,0,0,0,0,0,0,0,0,0
20200312,051248,華固元大95購01,0.82,0.88,0.81,0.88,+0.10,12.82,394000,17,327900,0,0,0,0,0,0,203000,191000,12000,12000
20200312,051249,潤泰全元大95購01,0.46,0.46,0.44,0.44,-0.17,-27.87,253000,3,116320,0,0,0,0,0,0,250000,3000,247000,247000
20200312,05124P,華新科富邦97售02,0.51,0.67,0.51,0.67,+0.19,39.58,119000,8,65530,0,0,0,0,0,0,109000,10000,99000,99000
20200312,051250,大立光元大98購01,0.63,0.63,0.59,0.59,-0.60,-50.42,40000,4,23970,0,0,0,0,0,0,3000,37000,-34000,-34000
20200312,051251,信邦元大95購01,0.92,0.94,0.85,0.94,-0.46,-32.86,24000,5,21790,0,0,0,0,0,0,24000,0,24000,24000
20200312,051252,健鼎元大95購01,0.39,0.39,0.31,0.31,-0.14,-31.11,463000,5,156340,0,0,0,0,0,0,153000,310000,-157000,-157000
20200312,051253,緯創元大95購02,,,,,0.00,0.00,0,0,0,0,0,0,0,0,0,0,0,0,0
20200312,051254,健策元大96購04,1.38,1.38,1.03,1.03,-0.58,-36.02,167000,6,206290,0,0,0,0,0,0,116000,51000,65000,65000
20200312,051255,康控元大96購04,,,,,0.00,0.00,0,0,0,0,0,0,0,0,0,0,0,0,0
20200312,051256,中磊元大95購01,,,,,0.00,0.00,0,0,0,0,0,0,0,0,0,0,0,0,0
20200312,051257,光寶科國泰96購01,0.41,0.41,0.38,0.38,-0.17,-30.91,115000,2,46250,0,0,0,0,0,0,85000,30000,55000,55000
20200312,051258,鈺齊國泰97購01,,,,,0.00,0.00,0,0,0,0,0,0,0,0,0,0,0,0,0
20200312,051259,鴻海永昌96購03,0.25,0.26,0.15,0.16,-0.17,-51.52,3820000,93,722670,0,0,0,0,0,0,1112000,2770000,-1658000,-1658000
20200312,05125P,鴻海群益95售06,5.30,5.30,5.30,5.30,+0.80,17.78,20000,1,106000,0,0,0,0,0,0,20000,0,20000,20000
20200312,051260,鴻海永昌96購04,0.11,0.11,0.11,0.11,0.00,0.00,1000,1,110,0,0,0,0,0,0,0,1000,-1000,-1000
20200312,051261,鴻海永昌96購05,,,,,0.00,0.00,0,0,0,0,0,0,0,0,0,0,0,0,0
20200312,051262,A50富邦96購01,,,,,0.00,0.00,0,0,0,0,0,0,0,0,0,0,0,0,0
20200312,051263,深中小富邦96購01,,,,,0.00,0.00,0,0,0,0,0,0,0,0,0,0,0,0,0
20200312,051264,道瓊反富邦97購01,1.85,1.85,1.85,1.85,0.00,0.00,6000,1,11100,0,0,0,0,0,0,6000,0,6000,6000
20200312,051265,鴻海富邦96購04,,,,,0.00,0.00,0,0,0,0,0,0,0,0,0,0,0,0,0
20200312,051266,國巨富邦99購01,1.65,1.66,1.11,1.11,-0.64,-36.57,491000,46,612460,0,0,0,0,0,0,211000,219000,-8000,-8000
20200312,051267,美律富邦96購01,0.09,0.09,0.09,0.09,-0.06,-40.0,73000,5,6570,0,0,0,0,0,0,20000,53000,-33000,-33000
20200312,051268,創意富邦97購01,0.21,0.21,0.18,0.18,-0.14,-43.75,45000,3,8400,0,0,0,0,0,0,45000,0,45000,45000
20200312,051269,康友富邦97購01,0.65,0.65,0.65,0.65,-0.19,-22.62,10000,1,6500,0,0,0,0,0,0,0,10000,-10000,-10000
20200312,05126P,牧德群益95售01,0.46,0.46,0.46,0.46,0.00,0.00,100000,1,46000,0,0,0,0,0,0,100000,0,100000,100000
20200312,051270,百和富邦95購01,,,,,0.00,0.00,0,0,0,0,0,0,0,0,0,0,0,0,0
20200312,051271,華新科群益95購04,,,,,0.00,0.00,0,0,0,0,0,0,0,0,0,0,0,0,0
20200312,051272,嘉晶群益95購01,0.64,0.83,0.45,0.51,-0.22,-30.14,579000,38,390430,0,0,0,0,0,0,177000,402000,-225000,-225000
20200312,051273,可成亞東95購01,,,,,0.00,0.00,0,0,0,0,0,0,0,0,0,0,0,0,0
20200312,051274,華新科亞東96購01,,,,,0.00,0.00,0,0,0,0,0,0,0,0,0,0,0,0,0
20200312,051275,群創亞東95購01,,,,,0.00,0.00,0,0,0,0,0,0,0,0,0,0,0,0,0
20200312,051276,SGBR2X中信97購01,0.03,0.06,0.03,0.06,0.00,0.00,151000,2,4560,0,0,0,0,0,0,0,0,0,0
20200312,051277,聯發科中信9A購01,0.09,0.09,0.05,0.07,-0.03,-30.0,2187000,158,151070,0,0,0,0,0,0,0,1407000,-1407000,-1407000
20200312,051278,臻鼎中信97購02,,,,,0.00,0.00,0,0,0,0,0,0,0,0,0,0,0,0,0
20200312,051279,喬山兆豐96購01,,,,,0.00,0.00,0,0,0,0,0,0,0,0,0,0,0,0,0
20200312,05127P,鴻海亞東96售01,,,,,0.00,0.00,0,0,0,0,0,0,0,0,0,0,0,0,0
20200312,051280,台積電兆豐95購04,0.05,0.05,0.03,0.04,-0.03,-42.86,163000,11,7530,0,0,0,0,0,0,0,41000,-41000,-41000
20200312,051281,健策兆豐96購01,0.75,0.75,0.64,0.64,-0.26,-28.89,77000,6,53690,0,0,0,0,0,0,34000,43000,-9000,-9000
20200312,051282,GIS兆豐95購02,,,,,0.00,0.00,0,0,0,0,0,0,0,0,0,0,0,0,0
20200312,051283,亞德客統一95購01,0.98,0.98,0.75,0.75,-0.61,-44.85,43000,2,41450,0,0,0,0,0,0,40000,3000,37000,37000
20200312,051284,上銀統一95購02,0.51,0.51,0.28,0.28,-0.44,-61.11,327000,16,129350,0,0,0,0,0,0,131000,196000,-65000,-65000
20200312,051285,鴻海統一95購07,,,,,0.00,0.00,0,0,0,0,0,0,0,0,0,0,0,0,0
20200312,051286,國巨統一97購01,4.04,4.04,2.78,2.83,-1.58,-35.83,76000,8,233130,0,0,0,0,0,0,16000,60000,-44000,-44000
20200312,051287,台積電統一95購05,,,,,0.00,0.00,0,0,0,0,0,0,0,0,0,0,0,0,0
20200312,051288,可成統一95購03,,,,,0.00,0.00,0,0,0,0,0,0,0,0,0,0,0,0,0
20200312,051289,大立光統一96購01,0.15,0.15,0.15,0.15,-0.14,-48.28,108000,4,16200,0,0,0,0,0,0,0,108000,-108000,-108000
20200312,05128P,聯發科中信97售03,1.82,2.15,1.82,2.15,+0.54,33.54,135000,13,270170,0,0,0,0,0,0,75000,95000,-20000,-20000
20200312,051290,大立光統一96購02,0.31,0.31,0.29,0.29,0.00,0.00,193000,4,56170,0,0,0,0,0,0,173000,193000,-20000,-20000
20200312,051291,聯詠統一95購01,,,,,0.00,0.00,0,0,0,0,0,0,0,0,0,0,0,0,0
20200312,051292,牧德統一97購01,,,,,0.00,0.00,0,0,0,0,0,0,0,0,0,0,0,0,0
20200312,051293,鴻海元富95購05,0.04,0.04,0.04,0.04,-0.03,-42.86,50000,5,2000,0,0,0,0,0,0,0,50000,-50000,-50000
20200312,051294,鴻海元富95購06,,,,,0.00,0.00,0,0,0,0,0,0,0,0,0,0,0,0,0
20200312,051295,國巨元富95購04,,,,,0.00,0.00,0,0,0,0,0,0,0,0,0,0,0,0,0
20200312,051296,鴻海凱基97購01,,,,,0.00,0.00,0,0,0,0,0,0,0,0,0,0,0,0,0
20200312,051297,台積電凱基95購07,,,,,0.00,0.00,0,0,0,0,0,0,0,0,0,0,0,0,0
20200312,051298,智邦凱基95購03,,,,,0.00,0.00,0,0,0,0,0,0,0,0,0,0,0,0,0
20200312,051299,致茂凱基95購01,0.34,0.34,0.23,0.23,-0.22,-48.89,451000,26,137420,0,0,0,0,0,0,383000,67000,316000,316000
20200312,05129P,鴻海兆豐95售02,1.96,2.32,1.96,2.32,+0.62,36.47,125000,4,281700,0,0,0,0,0,0,105000,125000,-20000,-20000
20200312,051300,台光電凱基96購02,0.26,0.26,0.15,0.15,-0.20,-57.14,75000,2,14000,0,0,0,0,0,0,0,75000,-75000,-75000
20200312,051301,聯發科凱基95購08,,,,,0.00,0.00,0,0,0,0,0,0,0,0,0,0,0,0,0
20200312,051302,可成凱基95購06,,,,,0.00,0.00,0,0,0,0,0,0,0,0,0,0,0,0,0
20200312,051303,奇鋐凱基95購01,,,,,0.00,0.00,0,0,0,0,0,0,0,0,0,0,0,0,0
20200312,051304,緯創凱基96購01,,,,,0.00,0.00,0,0,0,0,0,0,0,0,0,0,0,0,0
20200312,051305,訊連凱基96購01,0.47,0.48,0.34,0.37,-0.21,-36.21,507000,23,218900,0,0,0,0,0,0,383000,113000,270000,270000
20200312,051306,嘉聯益凱基96購01,,,,,0.00,0.00,0,0,0,0,0,0,0,0,0,0,0,0,0
20200312,051307,康舒凱基95購01,,,,,0.00,0.00,0,0,0,0,0,0,0,0,0,0,0,0,0
20200312,051308,GIS凱基95購04,,,,,0.00,0.00,0,0,0,0,0,0,0,0,0,0,0,0,0
20200312,051309,卜蜂麥證95購01,0.11,0.11,0.09,0.09,-0.09,-50.0,50000,3,5200,40000,10000,30000,0,0,0,40000,10000,30000,30000
20200312,05130P,聯發科統一95售03,2.76,2.83,2.76,2.83,0.00,0.00,56000,2,156520,0,0,0,0,0,0,0,56000,-56000,-56000
20200312,051310,台達電麥證95購01,,,,,0.00,0.00,0,0,0,0,0,0,0,0,0,0,0,0,0
20200312,051311,瑞昱麥證95購01,0.18,0.18,0.08,0.10,-0.20,-66.67,306000,11,33480,250000,56000,194000,0,0,0,250000,56000,194000,194000
20200312,051312,國泰金麥證95購01,,,,,0.00,0.00,0,0,0,0,0,0,0,0,0,0,0,0,0
20200312,051313,緯創麥證95購02,,,,,0.00,0.00,0,0,0,0,0,0,0,0,0,0,0,0,0
20200312,051314,嘉聯益麥證96購01,,,,,0.00,0.00,0,0,0,0,0,0,0,0,0,0,0,0,0
20200312,051315,同欣電麥證95購01,0.44,0.44,0.27,0.32,-0.24,-42.86,218000,14,71660,143000,75000,68000,0,0,0,143000,75000,68000,68000
20200312,051316,T50反1國票95購02,,,,,0.00,0.00,0,0,0,0,0,0,0,0,0,0,0,0,0
20200312,051317,亞德客國票96購01,0.86,0.86,0.51,0.51,-0.59,-53.64,75000,4,52750,0,0,0,0,0,0,65000,10000,55000,55000
20200312,051318,上銀國票96購01,1.09,1.11,0.70,0.78,-0.73,-48.34,131000,12,126790,0,0,0,0,0,0,76000,55000,21000,21000
20200312,051319,光磊國票96購02,0.65,0.65,0.60,0.60,-0.21,-25.93,20000,2,12500,0,0,0,0,0,0,10000,10000,0,0
20200312,05131P,聯詠統一97售01,2.67,2.84,2.67,2.80,+0.24,9.38,124000,5,343360,0,0,0,0,0,0,16000,108000,-92000,-92000
20200312,051320,燿華國票96購01,,,,,0.00,0.00,0,0,0,0,0,0,0,0,0,0,0,0,0
20200312,051321,建準國票96購01,,,,,0.00,0.00,0,0,0,0,0,0,0,0,0,0,0,0,0
20200312,051322,國泰金國票96購01,,,,,0.00,0.00,0,0,0,0,0,0,0,0,0,0,0,0,0
20200312,051323,康控國票96購01,,,,,0.00,0.00,0,0,0,0,0,0,0,0,0,0,0,0,0
20200312,051324,康友國票96購01,1.42,1.43,1.04,1.08,-0.58,-34.94,94000,9,106910,0,0,0,0,0,0,54000,94000,-40000,-40000
20200312,051325,台光電台新96購01,,,,,0.00,0.00,0,0,0,0,0,0,0,0,0,0,0,0,0
20200312,051326,聯發科台新95購01,0.06,0.06,0.06,0.06,0.00,0.00,20000,1,1200,0,0,0,0,0,0,0,20000,-20000,-20000
20200312,051327,元油2X永豐95購02,0.10,0.10,0.10,0.10,0.00,0.00,7000,1,700,0,0,0,0,0,0,0,7000,-7000,-7000
20200312,051328,力山永豐95購01,,,,,0.00,0.00,0,0,0,0,0,0,0,0,0,0,0,0,0
20200312,051329,智邦永豐95購01,,,,,0.00,0.00,0,0,0,0,0,0,0,0,0,0,0,0,0
20200312,05132P,鴻海元富95售07,2.11,2.18,2.11,2.18,0.00,0.00,20000,2,42900,0,0,0,0,0,0,0,20000,-20000,-20000
20200312,051330,宏碁永豐95購01,,,,,0.00,0.00,0,0,0,0,0,0,0,0,0,0,0,0,0
20200312,051331,全新永豐96購01,,,,,0.00,0.00,0,0,0,0,0,0,0,0,0,0,0,0,0
20200312,051332,奇力新永豐95購01,0.23,0.23,0.23,0.23,-0.31,-57.41,10000,1,2300,0,0,0,0,0,0,0,10000,-10000,-10000
20200312,051333,義隆永豐95購02,,,,,0.00,0.00,0,0,0,0,0,0,0,0,0,0,0,0,0
20200312,051334,宏達電永豐95購01,0.54,0.54,0.35,0.35,-0.21,-37.5,40000,4,17900,0,0,0,0,0,0,0,40000,-40000,-40000
20200312,051335,華固永豐95購01,,,,,0.00,0.00,0,0,0,0,0,0,0,0,0,0,0,0,0
20200312,051336,智原永豐95購01,,,,,0.00,0.00,0,0,0,0,0,0,0,0,0,0,0,0,0
20200312,051337,欣興永豐95購02,,,,,0.00,0.00,0,0,0,0,0,0,0,0,0,0,0,0,0
20200312,051338,揚明光永豐95購02,0.35,0.35,0.29,0.29,0.00,0.00,30000,2,9900,0,0,0,0,0,0,30000,0,30000,30000
20200312,051339,智易永豐95購02,0.18,0.18,0.18,0.18,0.00,0.00,10000,1,1800,0,0,0,0,0,0,0,10000,-10000,-10000
20200312,05133P,臺股指日盛95售01,,,,,0.00,0.00,0,0,0,0,0,0,0,0,0,0,0,0,0
20200312,051340,健策永豐95購03,0.12,0.12,0.12,0.12,-0.10,-45.45,10000,1,1200,0,0,0,0,0,0,0,10000,-10000,-10000
20200312,051341,訊連永豐95購02,0.08,0.08,0.08,0.08,0.00,0.00,230000,3,18400,0,0,0,0,0,0,210000,20000,190000,190000
20200312,051342,光寶科元大95購01,,,,,0.00,0.00,0,0,0,0,0,0,0,0,0,0,0,0,0
20200312,051343,鴻海元大95購07,0.08,0.08,0.08,0.08,-0.02,-20.0,10000,1,800,0,0,0,0,0,0,0,10000,-10000,-10000
20200312,051344,鴻海元大95購08,0.03,0.03,0.03,0.03,0.00,0.00,150000,1,4500,0,0,0,0,0,0,150000,0,150000,150000
20200312,051345,鴻海元大95購09,0.03,0.03,0.03,0.03,0.00,0.00,6000,1,180,0,0,0,0,0,0,0,6000,-6000,-6000
20200312,051346,仁寶元大95購01,0.30,0.30,0.25,0.25,-0.09,-26.47,68000,7,18400,0,0,0,0,0,0,68000,0,68000,68000
20200312,051347,國巨元大95購06,2.29,2.29,1.41,1.41,-1.00,-41.49,375000,9,618900,0,0,0,0,0,0,70000,365000,-295000,-295000
20200312,051348,國巨元大95購07,2.45,2.45,2.13,2.13,-0.85,-28.52,13000,2,30890,0,0,0,0,0,0,3000,13000,-10000,-10000
20200312,051349,國巨元大95購08,3.46,3.46,3.46,3.46,-0.73,-17.42,10000,1,34600,0,0,0,0,0,0,10000,0,10000,10000
20200312,05134P,鴻海凱基96售06,3.22,3.88,3.18,3.88,+1.16,42.65,229000,14,789360,0,0,0,0,0,0,213000,229000,-16000,-16000
20200312,051350,台積電元大95購14,0.36,0.36,0.29,0.30,0.00,0.00,114000,13,40780,0,0,0,0,0,0,4000,110000,-106000,-106000
20200312,051351,台積電元大95購15,,,,,0.00,0.00,0,0,0,0,0,0,0,0,0,0,0,0,0
20200312,051352,南亞科元大95購02,0.83,0.83,0.53,0.53,-1.02,-65.81,78000,2,61740,0,0,0,0,0,0,10000,68000,-58000,-58000
20200312,051353,聯發科元大95購08,,,,,0.00,0.00,0,0,0,0,0,0,0,0,0,0,0,0,0
20200312,051354,聯發科元大95購09,0.09,0.09,0.04,0.04,-0.12,-75.0,690000,8,44900,0,0,0,0,0,0,270000,420000,-150000,-150000
20200312,051355,聯發科元大96購01,0.13,0.13,0.09,0.10,-0.09,-47.37,435000,8,48400,0,0,0,0,0,0,215000,220000,-5000,-5000
20200312,051356,全新元大96購04,0.03,0.03,0.03,0.03,0.00,0.00,1000000,7,30000,0,0,0,0,0,0,1000000,0,1000000,1000000
20200312,051357,可成元大95購05,0.04,0.04,0.04,0.04,-0.03,-42.86,200000,2,8000,0,0,0,0,0,0,0,200000,-200000,-200000
20200312,051358,台新金元大95購01,0.32,0.32,0.26,0.26,-0.14,-35.0,283000,5,79640,0,0,0,0,0,0,133000,150000,-17000,-17000
20200312,051359,中信金元大95購01,0.39,0.39,0.25,0.28,-0.20,-41.67,1268000,29,367680,0,0,0,0,0,0,525000,743000,-218000,-218000
20200312,05135P,鴻海凱基96售07,2.93,3.53,2.93,3.53,+0.99,38.98,98000,4,341980,0,0,0,0,0,0,98000,98000,0,0
20200312,051360,緯創元大95購03,0.08,0.08,0.08,0.08,-0.11,-57.89,100000,1,8000,0,0,0,0,0,0,100000,0,100000,100000
20200312,051361,泰鼎元大95購01,3.62,3.62,3.62,3.62,-2.33,-39.16,30000,1,108600,0,0,0,0,0,0,0,30000,-30000,-30000
20200312,051362,台郡元大95購04,0.20,0.20,0.20,0.20,-0.39,-66.1,105000,1,21000,0,0,0,0,0,0,0,105000,-105000,-105000
20200312,051363,矽創元大95購03,0.17,0.17,0.17,0.17,-0.18,-51.43,10000,1,1700,0,0,0,0,0,0,0,10000,-10000,-10000
20200312,051364,鴻海國泰97購03,0.09,0.09,0.09,0.09,-0.04,-30.77,10000,1,900,0,0,0,0,0,0,0,10000,-10000,-10000
20200312,051365,瀚宇博國泰97購01,0.42,0.42,0.33,0.34,-0.22,-39.29,128000,4,45670,0,0,0,0,0,0,41000,87000,-46000,-46000
20200312,051366,康友國泰97購01,1.56,1.61,1.21,1.29,-0.40,-23.67,500000,33,731850,0,0,0,0,0,0,465000,117000,348000,348000
20200312,051367,可成富邦97購01,0.03,0.09,0.03,0.07,0.00,0.00,227000,5,10290,0,0,0,0,0,0,0,0,0,0
20200312,051368,國泰金富邦97購01,,,,,0.00,0.00,0,0,0,0,0,0,0,0,0,0,0,0,0
20200312,051369,新光金富邦9A購01,,,,,0.00,0.00,0,0,0,0,0,0,0,0,0,0,0,0,0
20200312,05136P,台積電凱基95售08,1.65,1.65,1.65,1.65,+0.35,26.92,10000,1,16500,0,0,0,0,0,0,10000,10000,0,0
20200312,051370,聯詠富邦97購01,0.12,0.13,0.11,0.13,-0.07,-35.0,87000,5,10450,0,0,0,0,0,0,77000,7000,70000,70000
20200312,051371,超眾富邦95購01,,,,,0.00,0.00,0,0,0,0,0,0,0,0,0,0,0,0,0
20200312,051372,樺漢富邦96購01,0.25,0.25,0.18,0.18,-0.18,-50.0,16000,3,3880,0,0,0,0,0,0,15000,1000,14000,14000
20200312,051373,華新亞東95購01,,,,,0.00,0.00,0,0,0,0,0,0,0,0,0,0,0,0,0
20200312,051374,國泰金亞東95購01,,,,,0.00,0.00,0,0,0,0,0,0,0,0,0,0,0,0,0
20200312,051375,道瓊反群益9A購01,,,,,0.00,0.00,0,0,0,0,0,0,0,0,0,0,0,0,0
20200312,051376,力山群益95購01,,,,,0.00,0.00,0,0,0,0,0,0,0,0,0,0,0,0,0
20200312,051377,鴻海群益95購07,,,,,0.00,0.00,0,0,0,0,0,0,0,0,0,0,0,0,0
20200312,051378,奇力新群益95購01,1.15,1.15,0.55,0.55,-0.73,-57.03,351000,8,277000,0,0,0,0,0,0,171000,180000,-9000,-9000
20200312,051379,新光金群益95購01,0.03,0.03,0.03,0.03,-0.02,-40.0,100000,1,3000,0,0,0,0,0,0,0,100000,-100000,-100000
20200312,05137P,華新科凱基96售03,,,,,0.00,0.00,0,0,0,0,0,0,0,0,0,0,0,0,0
20200312,051380,禾伸堂群益95購01,0.56,0.56,0.34,0.49,-0.01,-2.0,92000,9,46430,0,0,0,0,0,0,15000,77000,-62000,-62000
20200312,051381,玉晶光群益98購01,1.96,1.96,1.67,1.79,-0.57,-24.15,398000,15,761060,0,0,0,0,0,0,213000,188000,25000,25000
20200312,051382,玉晶光群益98購02,2.96,2.96,2.08,2.14,-1.09,-33.75,283000,10,751970,0,0,0,0,0,0,125000,162000,-37000,-37000
20200312,051383,京鼎群益96購02,0.61,0.62,0.61,0.62,-0.16,-20.51,138000,5,85470,0,0,0,0,0,0,138000,0,138000,138000
20200312,051384,康友群益95購01,1.01,1.01,0.74,0.75,-0.37,-33.04,129000,20,120850,0,0,0,0,0,0,89000,69000,20000,20000
20200312,051385,矽創群益95購01,,,,,0.00,0.00,0,0,0,0,0,0,0,0,0,0,0,0,0
20200312,051386,富邦金麥證96購01,,,,,0.00,0.00,0,0,0,0,0,0,0,0,0,0,0,0,0
20200312,051387,新光金麥證96購01,,,,,0.00,0.00,0,0,0,0,0,0,0,0,0,0,0,0,0
20200312,051388,大立光麥證95購03,0.48,0.48,0.38,0.38,0.00,0.00,20000,2,8600,0,20000,-20000,0,0,0,0,20000,-20000,-20000
20200312,051389,台達電兆豐95購01,,,,,0.00,0.00,0,0,0,0,0,0,0,0,0,0,0,0,0
20200312,05138P,嘉聯益凱基96售02,1.67,1.87,1.67,1.87,+0.29,18.35,54000,3,92180,0,0,0,0,0,0,44000,10000,34000,34000
20200312,051390,京元電兆豐95購01,0.32,0.32,0.29,0.29,-0.16,-35.56,51000,2,15150,0,0,0,0,0,0,51000,0,51000,51000
20200312,051391,聯發科兆豐95購02,,,,,0.00,0.00,0,0,0,0,0,0,0,0,0,0,0,0,0
20200312,051392,玉山金兆豐95購01,,,,,0.00,0.00,0,0,0,0,0,0,0,0,0,0,0,0,0
20200312,051393,新光金兆豐96購01,,,,,0.00,0.00,0,0,0,0,0,0,0,0,0,0,0,0,0
20200312,051394,奇鋐兆豐95購01,,,,,0.00,0.00,0,0,0,0,0,0,0,0,0,0,0,0,0
20200312,051395,聯詠兆豐95購01,0.09,0.09,0.09,0.09,0.00,0.00,19000,1,1710,0,0,0,0,0,0,19000,0,19000,19000
20200312,051396,健鼎兆豐95購01,0.10,0.11,0.10,0.11,-0.07,-38.89,60000,4,6200,0,0,0,0,0,0,0,60000,-60000,-60000
20200312,051397,聯茂兆豐95購03,,,,,0.00,0.00,0,0,0,0,0,0,0,0,0,0,0,0,0
20200312,051398,智原台新95購01,,,,,0.00,0.00,0,0,0,0,0,0,0,0,0,0,0,0,0
20200312,051399,玉晶光台新96購01,1.00,1.00,0.80,0.81,0.00,0.00,74000,6,61220,0,0,0,0,0,0,0,74000,-74000,-74000
20200312,05139P,臺股指凱基95售06,,,,,0.00,0.00,0,0,0,0,0,0,0,0,0,0,0,0,0
20200312,051400,國巨永豐95購01,1.09,1.12,0.56,0.56,-0.73,-56.59,182000,19,150290,0,0,0,0,0,0,36000,132000,-96000,-96000
20200312,051401,華新科永豐95購01,0.25,0.25,0.15,0.19,0.00,0.00,355000,14,69650,0,0,0,0,0,0,212000,143000,69000,69000
20200312,051402,玉晶光永豐95購04,0.59,0.59,0.59,0.59,-0.47,-44.34,20000,1,11800,0,0,0,0,0,0,20000,0,20000,20000
20200312,051403,玉晶光永豐95購05,1.73,1.73,1.13,1.18,-0.86,-42.16,57000,13,87610,0,0,0,0,0,0,8000,57000,-49000,-49000
20200312,051404,牧德永豐96購01,,,,,0.00,0.00,0,0,0,0,0,0,0,0,0,0,0,0,0
20200312,051405,世芯永豐95購01,0.42,0.44,0.22,0.22,-0.26,-54.17,2446000,68,784810,0,0,0,0,0,0,310000,2070000,-1760000,-1760000
20200312,051406,泰鼎永豐96購01,0.98,0.98,0.82,0.88,-0.33,-27.27,5000,4,4560,0,0,0,0,0,0,3000,2000,1000,1000
20200312,051407,南茂永豐95購02,,,,,0.00,0.00,0,0,0,0,0,0,0,0,0,0,0,0,0
20200312,051408,台積電國票95購03,,,,,0.00,0.00,0,0,0,0,0,0,0,0,0,0,0,0,0
20200312,051409,美律國票96購01,0.52,0.52,0.25,0.30,-0.38,-55.88,85000,7,35400,0,0,0,0,0,0,0,85000,-85000,-85000
20200312,05140P,台表科國票96售01,1.13,1.69,1.12,1.67,+0.61,57.55,374000,24,503470,0,0,0,0,0,0,145000,229000,-84000,-84000
20200312,051410,京元電國票96購01,0.08,0.08,0.05,0.05,-0.07,-58.33,1981000,19,111650,0,0,0,0,0,0,50000,1931000,-1881000,-1881000
20200312,051411,聯發科國票95購05,,,,,0.00,0.00,0,0,0,0,0,0,0,0,0,0,0,0,0
20200312,051412,奇力新國票96購01,2.27,2.27,1.32,1.41,-1.09,-43.6,27000,6,46970,0,0,0,0,0,0,16000,11000,5000,5000
20200312,051413,富邦金國票96購02,0.05,0.05,0.05,0.05,-0.04,-44.44,70000,1,3500,0,0,0,0,0,0,70000,0,70000,70000
20200312,051414,新光金國票95購04,,,,,0.00,0.00,0,0,0,0,0,0,0,0,0,0,0,0,0
20200312,051415,晶技國票96購01,4.39,4.39,2.27,2.33,-2.08,-47.17,228000,20,807430,0,0,0,0,0,0,112000,120000,-8000,-8000
20200312,051416,創意國票96購02,,,,,0.00,0.00,0,0,0,0,0,0,0,0,0,0,0,0,0
20200312,051417,揚明光國票96購01,,,,,0.00,0.00,0,0,0,0,0,0,0,0,0,0,0,0,0
20200312,051418,智易國票97購01,,,,,0.00,0.00,0,0,0,0,0,0,0,0,0,0,0,0,0
20200312,051419,麗豐國票96購01,,,,,0.00,0.00,0,0,0,0,0,0,0,0,0,0,0,0,0
20200312,05141P,華通台新96售01,2.47,2.66,2.47,2.66,+0.54,25.47,89000,4,225160,0,0,0,0,0,0,0,89000,-89000,-89000
20200312,051420,康控國票95購05,,,,,0.00,0.00,0,0,0,0,0,0,0,0,0,0,0,0,0
20200312,051421,彩晶國票95購01,,,,,0.00,0.00,0,0,0,0,0,0,0,0,0,0,0,0,0
20200312,051422,超眾國票96購01,0.91,0.91,0.77,0.77,-0.37,-32.46,40000,3,33400,0,0,0,0,0,0,30000,10000,20000,20000
20200312,051423,GIS國票97購01,0.33,0.33,0.33,0.33,-0.15,-31.25,10000,1,3300,0,0,0,0,0,0,10000,0,10000,10000
20200312,051424,緯穎國票97購01,7.20,7.20,6.35,6.35,-5.05,-44.3,2000,2,13550,0,0,0,0,0,0,0,2000,-2000,-2000
20200312,051425,昇陽半國票97購01,,,,,0.00,0.00,0,0,0,0,0,0,0,0,0,0,0,0,0
20200312,051426,道瓊反統一95購02,,,,,0.00,0.00,0,0,0,0,0,0,0,0,0,0,0,0,0
20200312,051427,聯發科統一95購04,,,,,0.00,0.00,0,0,0,0,0,0,0,0,0,0,0,0,0
20200312,051428,玉晶光統一96購01,1.52,1.52,1.40,1.40,-0.68,-32.69,13000,3,18550,0,0,0,0,0,0,10000,3000,7000,7000
20200312,051429,智邦元富95購01,0.79,0.79,0.52,0.56,-0.35,-38.46,721000,34,435210,0,0,0,0,0,0,541000,180000,361000,361000
20200312,05142P,華新科台新95售01,0.59,0.59,0.59,0.59,0.00,0.00,10000,1,5900,0,0,0,0,0,0,0,10000,-10000,-10000
20200312,051430,瑞昱元富95購02,0.53,0.53,0.32,0.37,-0.41,-52.56,219000,5,92280,0,0,0,0,0,0,101000,118000,-17000,-17000
20200312,051431,群創元富99購02,0.26,0.26,0.25,0.25,-0.33,-56.9,560000,2,143000,0,0,0,0,0,0,560000,0,560000,560000
20200312,051432,群創元富99購03,0.63,0.63,0.46,0.52,-0.26,-33.33,894000,58,460450,0,0,0,0,0,0,443000,451000,-8000,-8000
20200312,051433,中磊元富95購01,0.69,0.69,0.66,0.66,-0.18,-21.43,30000,3,20200,0,0,0,0,0,0,10000,20000,-10000,-10000
20200312,051434,中磊元富95購02,1.66,1.66,1.23,1.23,-0.56,-31.28,70000,5,100600,0,0,0,0,0,0,50000,20000,30000,30000
20200312,051435,聯茂元富95購01,0.98,0.98,0.68,0.68,-0.52,-43.33,50000,5,43600,0,0,0,0,0,0,30000,20000,10000,10000
20200312,051436,訊芯元富95購01,,,,,0.00,0.00,0,0,0,0,0,0,0,0,0,0,0,0,0
20200312,051437,百和元富95購02,,,,,0.00,0.00,0,0,0,0,0,0,0,0,0,0,0,0,0
20200312,051438,喬山元大95購03,,,,,0.00,0.00,0,0,0,0,0,0,0,0,0,0,0,0,0
20200312,051439,川湖元大95購01,0.39,0.39,0.30,0.30,-0.18,-37.5,37000,3,12720,0,0,0,0,0,0,9000,28000,-19000,-19000
20200312,05143P,臻鼎台新95售01,,,,,0.00,0.00,0,0,0,0,0,0,0,0,0,0,0,0,0
20200312,051440,鴻海元大95購12,,,,,0.00,0.00,0,0,0,0,0,0,0,0,0,0,0,0,0
20200312,051441,鴻海元大95購13,,,,,0.00,0.00,0,0,0,0,0,0,0,0,0,0,0,0,0
20200312,051442,正崴元大95購02,,,,,0.00,0.00,0,0,0,0,0,0,0,0,0,0,0,0,0
20200312,051443,聯發科元大95購10,,,,,0.00,0.00,0,0,0,0,0,0,0,0,0,0,0,0,0
20200312,051444,聯發科元大95購11,,,,,0.00,0.00,0,0,0,0,0,0,0,0,0,0,0,0,0
20200312,051445,可成元大95購06,0.01,0.01,0.01,0.01,0.00,0.00,50000,1,500,0,0,0,0,0,0,50000,0,50000,50000
20200312,051446,中壽元大96購01,0.13,0.13,0.07,0.07,-0.16,-69.57,3619000,16,257880,0,0,0,0,0,0,114000,3579000,-3465000,-3465000
20200312,051447,新光金元大97購01,,,,,0.00,0.00,0,0,0,0,0,0,0,0,0,0,0,0,0
20200312,051448,聯詠元大95購02,0.49,0.49,0.40,0.42,-0.32,-43.24,81000,3,33220,0,0,0,0,0,0,8000,73000,-65000,-65000
20200312,051449,玉晶光元大96購01,1.35,1.35,1.04,1.07,-0.65,-37.79,136000,9,176220,0,0,0,0,0,0,13000,126000,-113000,-113000
20200312,05144P,美律永豐95售02,0.87,1.13,0.87,1.13,+0.27,31.4,140000,10,138280,0,0,0,0,0,0,60000,80000,-20000,-20000
20200312,051450,世芯元大95購02,1.76,1.87,1.12,1.17,-0.67,-36.41,121000,12,183400,0,0,0,0,0,0,78000,43000,35000,35000
20200312,051451,世芯元大95購03,1.54,1.60,1.04,1.04,-0.57,-35.4,175000,23,223130,0,0,0,0,0,0,103000,84000,19000,19000
20200312,051452,貿聯元大95購04,0.75,0.75,0.45,0.46,-0.39,-45.88,116000,9,64440,0,0,0,0,0,0,56000,60000,-4000,-4000
20200312,051453,智伸科元大95購02,0.06,0.06,0.06,0.06,0.00,0.00,30000,1,1800,0,0,0,0,0,0,0,30000,-30000,-30000
20200312,051454,致伸元大95購01,,,,,0.00,0.00,0,0,0,0,0,0,0,0,0,0,0,0,0
20200312,051455,樺漢元大96購01,,,,,0.00,0.00,0,0,0,0,0,0,0,0,0,0,0,0,0
20200312,051456,鈺齊元大95購01,0.19,0.19,0.12,0.12,-0.13,-52.0,510000,4,80400,0,0,0,0,0,0,310000,200000,110000,110000
20200312,051457,寶成元大95購01,,,,,0.00,0.00,0,0,0,0,0,0,0,0,0,0,0,0,0
20200312,051458,臺股指元大95購18,,,,,0.00,0.00,0,0,0,0,0,0,0,0,0,0,0,0,0
20200312,051459,臺股指元大95購19,0.10,0.10,0.10,0.10,0.00,0.00,1000,1,100,0,0,0,0,0,0,0,1000,-1000,-1000
20200312,05145P,道瓊反元大98售01,0.19,0.22,0.19,0.22,-0.14,-38.89,24000,2,4950,0,0,0,0,0,0,11000,0,11000,11000
20200312,051460,S&P反1國泰97購01,,,,,0.00,0.00,0,0,0,0,0,0,0,0,0,0,0,0,0
20200312,051461,聯詠國泰96購01,0.63,0.63,0.51,0.59,-0.29,-32.95,339000,6,201010,0,0,0,0,0,0,241000,98000,143000,143000
20200312,051462,世芯國泰97購01,1.93,2.13,1.39,1.48,-0.55,-27.09,718000,51,1278900,10000,0,10000,0,0,0,254000,544000,-290000,-280000
20200312,051463,世芯國泰97購02,2.94,3.26,2.09,2.25,-1.10,-32.84,299000,32,837470,0,0,0,0,0,0,59000,252000,-193000,-193000
20200312,051464,彩晶國泰96購01,0.54,0.54,0.51,0.51,-0.32,-38.55,280000,5,148000,0,0,0,0,0,0,0,280000,-280000,-280000
20200312,051465,鴻海富邦97購02,,,,,0.00,0.00,0,0,0,0,0,0,0,0,0,0,0,0,0
20200312,051466,玉晶光富邦97購01,0.52,0.53,0.41,0.41,0.00,0.00,299000,10,139000,0,0,0,0,0,0,138000,161000,-23000,-23000
20200312,051467,GIS富邦96購01,0.04,0.04,0.04,0.04,0.00,0.00,180000,2,7200,0,0,0,0,0,0,180000,0,180000,180000
20200312,051468,智邦日盛95購01,,,,,0.00,0.00,0,0,0,0,0,0,0,0,0,0,0,0,0
20200312,051469,友達日盛9B購01,,,,,0.00,0.00,0,0,0,0,0,0,0,0,0,0,0,0,0
20200312,05146P,鴻海元大95售10,,,,,0.00,0.00,0,0,0,0,0,0,0,0,0,0,0,0,0
20200312,051470,玉晶光日盛95購01,,,,,0.00,0.00,0,0,0,0,0,0,0,0,0,0,0,0,0
20200312,051471,國巨凱基97購01,1.82,1.82,1.25,1.25,-0.59,-32.07,52000,8,81720,0,0,0,0,0,0,37000,27000,10000,10000
20200312,051472,台積電凱基95購09,0.35,0.37,0.34,0.34,0.00,0.00,56000,3,19400,0,0,0,0,0,0,21000,5000,16000,16000
20200312,051473,台積電凱基95購10,,,,,0.00,0.00,0,0,0,0,0,0,0,0,0,0,0,0,0
20200312,051474,智邦凱基95購04,0.25,0.25,0.25,0.25,-0.03,-10.71,2000,2,500,0,0,0,0,0,0,2000,0,2000,2000
20200312,051475,宏碁凱基95購02,,,,,0.00,0.00,0,0,0,0,0,0,0,0,0,0,0,0,0
20200312,051476,聯發科凱基95購09,,,,,0.00,0.00,0,0,0,0,0,0,0,0,0,0,0,0,0
20200312,051477,可成凱基95購07,,,,,0.00,0.00,0,0,0,0,0,0,0,0,0,0,0,0,0
20200312,051478,宏達電凱基95購03,,,,,0.00,0.00,0,0,0,0,0,0,0,0,0,0,0,0,0
20200312,051479,兆豐金凱基95購01,0.40,0.41,0.32,0.35,-0.23,-39.66,159000,14,57360,0,0,0,0,0,0,49000,110000,-61000,-61000
20200312,05147P,鴻海元大95售11,,,,,0.00,0.00,0,0,0,0,0,0,0,0,0,0,0,0,0
20200312,051480,大立光凱基97購01,0.13,0.13,0.10,0.10,-0.16,-61.54,30000,3,3300,0,0,0,0,0,0,0,30000,-30000,-30000
20200312,051481,聯詠凱基95購02,0.02,0.03,0.02,0.03,-0.04,-57.14,27000,2,640,0,0,0,0,0,0,27000,0,27000,27000
20200312,051482,玉晶光凱基96購01,0.76,0.76,0.74,0.74,-0.70,-48.61,12000,3,9100,0,0,0,0,0,0,10000,2000,8000,8000
20200312,051483,玉晶光凱基96購02,1.03,1.03,0.70,0.70,-0.46,-39.66,82000,9,62870,0,0,0,0,0,0,9000,73000,-64000,-64000
20200312,051484,玉晶光凱基97購01,0.76,0.84,0.76,0.84,-0.53,-38.69,15000,2,11800,0,0,0,0,0,0,15000,0,15000,15000
20200312,051485,玉晶光凱基97購02,1.39,1.39,1.11,1.17,-0.76,-39.38,176000,10,204750,0,0,0,0,0,0,56000,126000,-70000,-70000
20200312,051486,玉晶光凱基97購03,0.98,0.98,0.73,0.73,-0.59,-44.7,93000,8,73480,0,0,0,0,0,0,26000,67000,-41000,-41000
20200312,051487,健策凱基96購03,0.28,0.28,0.16,0.16,-0.24,-60.0,291000,5,52600,0,0,0,0,0,0,81000,210000,-129000,-129000
20200312,051488,健策凱基96購04,0.20,0.20,0.10,0.12,-0.14,-53.85,905000,28,124550,0,0,0,0,0,0,144000,734000,-590000,-590000
20200312,051489,世芯凱基95購01,1.41,1.46,0.85,0.98,-0.63,-39.13,109000,13,129870,0,0,0,0,0,0,62000,75000,-13000,-13000
20200312,05148P,臻鼎元大95售01,3.62,4.35,3.62,4.35,0.00,0.00,40000,2,170350,0,0,0,0,0,0,0,40000,-40000,-40000
20200312,051490,世芯凱基96購01,1.33,1.39,0.86,1.00,-0.44,-30.56,404000,31,466260,0,0,0,0,0,0,246000,184000,62000,62000
20200312,051491,貿聯凱基95購01,,,,,0.00,0.00,0,0,0,0,0,0,0,0,0,0,0,0,0
20200312,051492,臻鼎凱基95購01,0.05,0.05,0.05,0.05,0.00,0.00,150000,1,7500,0,0,0,0,0,0,150000,0,150000,150000
20200312,051493,台郡凱基95購02,0.17,0.17,0.12,0.12,-0.27,-69.23,80000,2,10100,0,0,0,0,0,0,80000,0,80000,80000
20200312,051494,中環兆豐95購01,0.01,0.01,0.01,0.01,0.00,0.00,10000,1,100,0,0,0,0,0,0,0,10000,-10000,-10000
20200312,051495,玉晶光第一95購02,0.51,0.51,0.44,0.44,-0.32,-42.11,40000,5,18360,0,0,0,0,0,0,0,40000,-40000,-40000
20200312,051496,義隆亞東95購01,,,,,0.00,0.00,0,0,0,0,0,0,0,0,0,0,0,0,0
20200312,051497,中磊亞東96購01,,,,,0.00,0.00,0,0,0,0,0,0,0,0,0,0,0,0,0
20200312,051498,智易群益96購01,,,,,0.00,0.00,0,0,0,0,0,0,0,0,0,0,0,0,0
20200312,051499,康控群益95購02,,,,,0.00,0.00,0,0,0,0,0,0,0,0,0,0,0,0,0
20200312,05149P,緯穎國泰96售01,0.37,0.40,0.37,0.37,0.00,0.00,15000,3,5700,0,0,0,0,0,0,10000,5000,5000,5000
20200312,051500,聯茂群益95購01,0.68,0.68,0.49,0.58,-0.44,-43.14,186000,8,103720,0,0,0,0,0,0,0,186000,-186000,-186000
20200312,051501,康友群益95購02,0.74,0.76,0.48,0.54,-0.46,-46.0,207000,19,125050,0,0,0,0,0,0,122000,144000,-22000,-22000
20200312,051502,南茂群益95購01,,,,,0.00,0.00,0,0,0,0,0,0,0,0,0,0,0,0,0
20200312,051503,玉晶光統一97購01,,,,,0.00,0.00,0,0,0,0,0,0,0,0,0,0,0,0,0
20200312,051504,TPK統一95購01,,,,,0.00,0.00,0,0,0,0,0,0,0,0,0,0,0,0,0
20200312,051505,台積電元富95購05,0.37,0.37,0.22,0.30,-0.15,-33.33,204000,20,53340,0,0,0,0,0,0,100000,130000,-30000,-30000
20200312,051506,台積電元富95購06,0.19,0.19,0.07,0.11,-0.17,-60.71,520000,8,54780,0,0,0,0,0,0,441000,0,441000,441000
20200312,051507,彩晶元富95購01,0.16,0.16,0.11,0.11,-0.16,-59.26,150000,6,21000,0,0,0,0,0,0,0,150000,-150000,-150000
20200312,051508,元黃金中信97購01,1.92,1.92,1.92,1.92,0.00,0.00,10000,1,19200,0,0,0,0,0,0,0,10000,-10000,-10000
20200312,051509,鴻海中信97購01,,,,,0.00,0.00,0,0,0,0,0,0,0,0,0,0,0,0,0
20200312,05150P,玉晶光第一95售01,,,,,0.00,0.00,0,0,0,0,0,0,0,0,0,0,0,0,0
20200312,051510,新光金中信97購01,,,,,0.00,0.00,0,0,0,0,0,0,0,0,0,0,0,0,0
20200312,051511,鈺齊中信97購01,0.08,0.08,0.05,0.05,-0.08,-61.54,61000,19,4850,0,0,0,0,0,0,61000,0,61000,61000
20200312,051512,超眾麥證95購01,0.54,0.54,0.43,0.43,-0.35,-44.87,47000,3,24370,36000,11000,25000,0,0,0,36000,11000,25000,25000
20200312,051513,台積電凱基95購13,0.09,0.09,0.09,0.09,-0.14,-60.87,30000,2,2700,0,0,0,0,0,0,10000,0,10000,10000
20200312,051514,智邦凱基95購05,0.11,0.11,0.11,0.11,-0.02,-15.38,200000,1,22000,0,0,0,0,0,0,0,200000,-200000,-200000
20200312,051515,聯發科凱基95購10,,,,,0.00,0.00,0,0,0,0,0,0,0,0,0,0,0,0,0
20200312,051516,全新凱基96購02,,,,,0.00,0.00,0,0,0,0,0,0,0,0,0,0,0,0,0
20200312,051517,可成凱基95購08,,,,,0.00,0.00,0,0,0,0,0,0,0,0,0,0,0,0,0
20200312,051518,富邦金凱基95購01,0.10,0.10,0.07,0.07,0.00,0.00,110000,11,10700,0,0,0,0,0,0,10000,100000,-90000,-90000
20200312,051519,國泰金凱基95購02,0.23,0.23,0.15,0.15,-0.16,-51.61,107000,7,20460,10000,0,10000,0,0,0,77000,39000,38000,48000
20200312,05151P,台光電群益95售02,1.03,1.23,1.03,1.23,+0.31,33.7,75000,7,85140,0,0,0,0,0,0,10000,65000,-55000,-55000
20200312,051520,新光金凱基97購01,,,,,0.00,0.00,0,0,0,0,0,0,0,0,0,0,0,0,0
20200312,051521,大立光凱基96購07,,,,,0.00,0.00,0,0,0,0,0,0,0,0,0,0,0,0,0
20200312,051522,玉晶光凱基95購05,0.44,0.44,0.25,0.25,-0.33,-56.9,140000,11,50730,0,0,0,0,0,0,73000,67000,6000,6000
20200312,051523,牧德凱基95購02,0.88,0.88,0.64,0.64,-0.64,-50.0,12000,3,8140,0,0,0,0,0,0,2000,10000,-8000,-8000
20200312,051524,貿聯凱基95購02,0.28,0.29,0.20,0.20,-0.17,-45.95,130000,22,29640,0,0,0,0,0,0,30000,100000,-70000,-70000
20200312,051525,日月光凱基95購02,,,,,0.00,0.00,0,0,0,0,0,0,0,0,0,0,0,0,0
20200312,051526,超眾凱基95購02,0.49,0.49,0.45,0.45,-0.46,-50.55,12000,2,5800,0,0,0,0,0,0,12000,10000,2000,2000
20200312,051527,台郡凱基95購03,,,,,0.00,0.00,0,0,0,0,0,0,0,0,0,0,0,0,0
20200312,051528,亞泥國票96購01,0.30,0.35,0.30,0.31,-0.14,-31.11,116000,5,36480,0,0,0,0,0,0,78000,38000,40000,40000
20200312,051529,東元國票96購01,0.45,0.46,0.40,0.42,-0.17,-28.81,282000,7,122030,0,0,0,0,0,0,74000,208000,-134000,-134000
20200312,05152P,玉晶光群益96售05,1.33,1.36,1.33,1.36,+0.37,37.37,6000,2,8010,0,0,0,0,0,0,6000,0,6000,6000
20200312,051530,鴻海國票97購01,,,,,0.00,0.00,0,0,0,0,0,0,0,0,0,0,0,0,0
20200312,051531,國巨國票96購04,,,,,0.00,0.00,0,0,0,0,0,0,0,0,0,0,0,0,0
20200312,051532,潤泰全國票96購01,0.38,0.38,0.32,0.32,-0.13,-28.89,309000,3,116820,0,0,0,0,0,0,0,309000,-309000,-309000
20200312,051533,健鼎國票96購02,,,,,0.00,0.00,0,0,0,0,0,0,0,0,0,0,0,0,0
20200312,051534,景碩國票97購01,1.16,1.16,1.09,1.09,-0.41,-27.33,20000,2,22850,0,0,0,0,0,0,20000,0,20000,20000
20200312,051535,新日興國票96購01,0.39,0.39,0.18,0.21,-0.32,-60.38,186000,13,53160,0,0,0,0,0,0,105000,81000,24000,24000
20200312,051536,玉晶光國票97購01,2.16,2.18,1.47,1.52,-1.02,-40.16,125000,13,239670,0,0,0,0,0,0,31000,97000,-66000,-66000
20200312,051537,牧德國票96購01,3.06,3.06,2.51,2.51,-1.24,-33.07,65000,4,176300,0,0,0,0,0,0,5000,60000,-55000,-55000
20200312,051538,和碩國票96購01,,,,,0.00,0.00,0,0,0,0,0,0,0,0,0,0,0,0,0
20200312,051539,瀚宇博國票97購01,0.26,0.26,0.18,0.18,-0.17,-48.57,38000,2,8440,0,0,0,0,0,0,18000,20000,-2000,-2000
20200312,05153P,台表科群益96售01,1.04,1.25,1.02,1.25,+0.23,22.55,301000,32,327920,0,0,0,0,0,0,71000,230000,-159000,-159000
20200312,051540,力成國票95購01,,,,,0.00,0.00,0,0,0,0,0,0,0,0,0,0,0,0,0
20200312,051541,GIS國票96購02,0.06,0.06,0.06,0.06,0.00,0.00,50000,1,3000,0,0,0,0,0,0,50000,0,50000,50000
20200312,051542,南茂國票96購01,,,,,0.00,0.00,0,0,0,0,0,0,0,0,0,0,0,0,0
20200312,051543,鈺齊國票96購01,0.07,0.07,0.05,0.05,-0.07,-58.33,231000,4,13550,0,0,0,0,0,0,31000,190000,-159000,-159000
20200312,051544,T50反1康和98購01,1.20,1.37,1.19,1.37,0.00,0.00,246000,19,313980,0,0,0,0,0,0,0,246000,-246000,-246000
20200312,051545,裕隆康和95購01,,,,,0.00,0.00,0,0,0,0,0,0,0,0,0,0,0,0,0
20200312,051546,慧洋康和95購01,,,,,0.00,0.00,0,0,0,0,0,0,0,0,0,0,0,0,0
20200312,051547,健鼎康和95購01,,,,,0.00,0.00,0,0,0,0,0,0,0,0,0,0,0,0,0
20200312,051548,鈺齊康和95購01,,,,,0.00,0.00,0,0,0,0,0,0,0,0,0,0,0,0,0
20200312,051549,健鼎永豐95購01,,,,,0.00,0.00,0,0,0,0,0,0,0,0,0,0,0,0,0
20200312,05154P,台積電兆豐95售05,0.95,1.10,0.95,1.01,+0.34,50.75,499000,15,510880,0,0,0,0,0,0,59000,440000,-381000,-381000
20200312,051550,日電貿永豐95購01,,,,,0.00,0.00,0,0,0,0,0,0,0,0,0,0,0,0,0
20200312,051551,新日興永豐95購01,0.09,0.09,0.09,0.09,0.00,0.00,100000,1,9000,0,0,0,0,0,0,100000,0,100000,100000
20200312,051552,牧德永豐95購03,1.71,1.71,1.71,1.71,-0.70,-29.05,1000,1,1710,0,0,0,0,0,0,1000,0,1000,1000
20200312,051553,牧德永豐96購02,1.32,1.32,1.32,1.32,-0.50,-27.47,9000,1,11880,0,0,0,0,0,0,9000,0,9000,9000
20200312,051554,鎧勝永豐95購01,,,,,0.00,0.00,0,0,0,0,0,0,0,0,0,0,0,0,0
20200312,051555,聯茂永豐95購01,,,,,0.00,0.00,0,0,0,0,0,0,0,0,0,0,0,0,0
20200312,051556,台表科永豐96購01,,,,,0.00,0.00,0,0,0,0,0,0,0,0,0,0,0,0,0
20200312,051557,昇陽半永豐96購01,,,,,0.00,0.00,0,0,0,0,0,0,0,0,0,0,0,0,0
20200312,051558,元金2X國泰97購01,3.84,3.84,3.84,3.84,0.00,0.00,50000,1,192000,0,0,0,0,0,0,50000,0,50000,50000
20200312,051559,宏達電國泰96購01,0.67,0.67,0.45,0.45,-0.39,-46.43,155000,3,74150,0,0,0,0,0,0,105000,50000,55000,55000
20200312,05155P,聯發科兆豐95售03,1.72,1.83,1.72,1.83,0.00,0.00,20000,2,35500,0,0,0,0,0,0,0,20000,-20000,-20000
20200312,051560,玉晶光國泰97購03,1.83,1.83,1.28,1.28,-0.69,-35.03,86000,21,130820,0,0,0,0,0,0,51000,73000,-22000,-22000
20200312,051561,玉晶光國泰97購04,1.44,1.45,1.26,1.30,-0.54,-29.35,19000,6,24530,0,0,0,0,0,0,19000,19000,0,0
20200312,051562,玉晶光國泰97購05,1.50,1.50,1.05,1.06,-0.72,-40.45,350000,19,400040,0,0,0,0,0,0,33000,320000,-287000,-287000
20200312,051563,泰鼎國泰96購01,,,,,0.00,0.00,0,0,0,0,0,0,0,0,0,0,0,0,0
20200312,051564,和碩國泰96購01,0.42,0.42,0.38,0.38,-0.26,-40.62,115000,14,45790,0,0,0,0,0,0,115000,10000,105000,105000
20200312,051565,玉晶光永昌96購01,,,,,0.00,0.00,0,0,0,0,0,0,0,0,0,0,0,0,0
20200312,051566,鴻海富邦95購05,,,,,0.00,0.00,0,0,0,0,0,0,0,0,0,0,0,0,0
20200312,051567,台積電富邦95購06,0.60,0.60,0.14,0.20,-0.20,-50.0,210000,20,60840,0,0,0,0,0,0,68000,123000,-55000,-55000
20200312,051568,智邦富邦95購01,0.23,0.23,0.14,0.14,-0.12,-46.15,6000,2,930,0,0,0,0,0,0,1000,5000,-4000,-4000
20200312,051569,緯創富邦95購02,,,,,0.00,0.00,0,0,0,0,0,0,0,0,0,0,0,0,0
20200312,05156P,群創兆豐95售01,0.65,0.65,0.65,0.65,0.00,0.00,60000,1,39000,0,0,0,0,0,0,60000,0,60000,60000
20200312,051570,和碩富邦97購01,0.25,0.25,0.20,0.23,-0.08,-25.81,263000,6,57040,0,0,0,0,0,0,253000,10000,243000,243000
20200312,051571,南茂富邦95購01,,,,,0.00,0.00,0,0,0,0,0,0,0,0,0,0,0,0,0
20200312,051572,上銀元大95購01,1.38,1.38,1.03,1.03,-0.80,-43.72,86000,3,99930,0,0,0,0,0,0,36000,51000,-15000,-15000
20200312,051573,鴻海元大95購15,0.01,0.01,0.01,0.01,-0.01,-50.0,150000,3,1500,0,0,0,0,0,0,0,0,0,0
20200312,051574,鴻海元大96購06,,,,,0.00,0.00,0,0,0,0,0,0,0,0,0,0,0,0,0
20200312,051575,國巨元大96購03,2.07,2.07,1.30,1.30,-0.87,-40.09,110000,8,195830,0,0,0,0,0,0,55000,110000,-55000,-55000
20200312,051576,台積電元大97購02,1.22,1.23,0.89,1.08,-0.46,-29.87,114000,20,124840,0,0,0,0,0,0,22000,91000,-69000,-69000
20200312,051577,台積電元大97購03,1.62,1.62,1.24,1.38,-0.65,-32.02,69000,11,102270,0,0,0,0,0,0,2000,69000,-67000,-67000
20200312,051578,智邦元大96購01,0.92,0.92,0.67,0.67,-0.28,-29.47,148000,7,117120,0,0,0,0,0,0,119000,88000,31000,31000
20200312,051579,宏碁元大95購01,0.05,0.31,0.05,0.31,+0.21,210.0,30000,3,6600,0,0,0,0,0,0,0,20000,-20000,-20000
20200312,05157P,全新台新96售01,2.41,2.54,2.41,2.54,+0.31,13.9,20000,2,49500,0,0,0,0,0,0,20000,0,20000,20000
20200312,051580,宏碁元大95購02,,,,,0.00,0.00,0,0,0,0,0,0,0,0,0,0,0,0,0
20200312,051581,聯發科元大95購12,,,,,0.00,0.00,0,0,0,0,0,0,0,0,0,0,0,0,0
20200312,051582,聯發科元大97購02,0.68,0.68,0.47,0.47,-0.46,-49.46,253000,6,136400,0,0,0,0,0,0,95000,158000,-63000,-63000
20200312,051583,可成元大95購07,,,,,0.00,0.00,0,0,0,0,0,0,0,0,0,0,0,0,0
20200312,051584,可成元大95購08,0.07,0.07,0.07,0.07,-0.07,-50.0,10000,1,700,0,0,0,0,0,0,10000,0,10000,10000
20200312,051585,美食元大95購01,0.04,0.04,0.04,0.04,-0.04,-50.0,10000,1,400,0,0,0,0,0,0,0,10000,-10000,-10000
20200312,051586,國泰金元大96購01,,,,,0.00,0.00,0,0,0,0,0,0,0,0,0,0,0,0,0
20200312,051587,大立光元大95購08,0.08,0.08,0.04,0.05,0.00,0.00,230000,19,12600,0,0,0,0,0,0,0,230000,-230000,-230000
20200312,051588,聯詠元大95購03,0.33,0.33,0.33,0.33,-0.17,-34.0,22000,1,7260,0,0,0,0,0,0,22000,0,22000,22000
20200312,051589,健鼎元大95購02,,,,,0.00,0.00,0,0,0,0,0,0,0,0,0,0,0,0,0
20200312,05158P,華通永豐95售01,1.25,1.33,1.25,1.33,+0.44,49.44,30000,3,38300,0,0,0,0,0,0,0,30000,-30000,-30000
20200312,051590,玉晶光元大96購02,1.80,1.80,1.25,1.44,-0.81,-36.0,568000,43,853990,0,0,0,0,0,0,88000,466000,-378000,-378000
20200312,051591,玉晶光元大97購01,1.09,1.09,0.83,0.83,-0.46,-35.66,200000,8,179930,0,0,0,0,0,0,130000,170000,-40000,-40000
20200312,051592,健策元大96購05,0.57,0.57,0.42,0.42,-0.24,-36.36,32000,5,15770,0,0,0,0,0,0,10000,22000,-12000,-12000
20200312,051593,和碩元大95購01,0.13,0.13,0.11,0.11,-0.20,-64.52,86000,3,9740,0,0,0,0,0,0,68000,18000,50000,50000
20200312,051594,和碩元大96購01,0.46,0.46,0.37,0.37,-0.30,-44.78,108000,4,43410,0,0,0,0,0,0,40000,78000,-38000,-38000
20200312,051595,康控元大95購04,,,,,0.00,0.00,0,0,0,0,0,0,0,0,0,0,0,0,0
20200312,051596,超眾元大95購05,0.70,0.70,0.63,0.68,-0.38,-35.85,157000,5,102950,0,0,0,0,0,0,61000,157000,-96000,-96000
20200312,051597,T50反1中信99購02,2.24,2.62,2.24,2.53,+0.56,28.43,77000,12,186830,0,0,0,0,0,0,32000,45000,-13000,-13000
20200312,051598,瑞昱兆豐95購01,0.32,0.32,0.23,0.23,-0.27,-54.0,156000,6,47530,0,0,0,0,0,0,105000,51000,54000,54000
20200312,051599,健鼎兆豐95購02,,,,,0.00,0.00,0,0,0,0,0,0,0,0,0,0,0,0,0
20200312,05159P,聯發科永豐95售04,1.33,1.85,1.33,1.85,0.00,0.00,156000,6,252080,0,0,0,0,0,0,90000,156000,-66000,-66000
20200312,051600,新日興兆豐96購02,,,,,0.00,0.00,0,0,0,0,0,0,0,0,0,0,0,0,0
20200312,051601,群創兆豐95購02,0.40,0.40,0.32,0.32,0.00,0.00,203000,7,71660,0,0,0,0,0,0,0,203000,-203000,-203000
20200312,051602,南茂兆豐96購01,0.25,0.25,0.22,0.22,-0.19,-46.34,289000,8,72100,0,0,0,0,0,0,284000,5000,279000,279000
20200312,051603,深中小群益99購03,1.55,1.55,1.49,1.51,-0.25,-14.2,72000,8,109020,0,0,0,0,0,0,10000,62000,-52000,-52000
20200312,051604,喬山群益95購01,,,,,0.00,0.00,0,0,0,0,0,0,0,0,0,0,0,0,0
20200312,051605,奇力新群益95購02,,,,,0.00,0.00,0,0,0,0,0,0,0,0,0,0,0,0,0
20200312,051606,華新科群益95購05,,,,,0.00,0.00,0,0,0,0,0,0,0,0,0,0,0,0,0
20200312,051607,緯創群益96購02,,,,,0.00,0.00,0,0,0,0,0,0,0,0,0,0,0,0,0
20200312,051608,新日興群益96購01,1.37,1.37,1.04,1.04,-0.65,-38.46,255000,8,312880,0,0,0,0,0,0,226000,29000,197000,197000
20200312,051609,貿聯群益95購03,,,,,0.00,0.00,0,0,0,0,0,0,0,0,0,0,0,0,0
20200312,05160P,國巨國票96售03,0.82,1.22,0.81,1.22,+0.54,79.41,671000,44,656520,0,0,0,0,0,0,540000,131000,409000,409000
20200312,051610,GIS群益95購02,,,,,0.00,0.00,0,0,0,0,0,0,0,0,0,0,0,0,0
20200312,051611,鈺齊群益95購02,,,,,0.00,0.00,0,0,0,0,0,0,0,0,0,0,0,0,0
20200312,051612,緯創日盛95購01,,,,,0.00,0.00,0,0,0,0,0,0,0,0,0,0,0,0,0
20200312,051613,S&P反1凱基96購01,0.88,1.21,0.86,1.07,+0.31,40.79,1043000,15,987940,0,0,0,0,0,0,917000,376000,541000,541000
20200312,051614,元金2X凱基97購01,1.28,1.28,0.89,0.93,-0.35,-27.34,1441000,37,1316650,0,0,0,0,0,0,868000,505000,363000,363000
20200312,051615,華通凱基96購01,,,,,0.00,0.00,0,0,0,0,0,0,0,0,0,0,0,0,0
20200312,051616,鴻海凱基96購08,,,,,0.00,0.00,0,0,0,0,0,0,0,0,0,0,0,0,0
20200312,051617,台積電凱基95購14,,,,,0.00,0.00,0,0,0,0,0,0,0,0,0,0,0,0,0
20200312,051618,智邦凱基95購06,0.67,0.67,0.41,0.44,-0.23,-34.33,78000,19,42420,0,0,0,0,0,0,37000,42000,-5000,-5000
20200312,051619,智邦凱基95購07,0.25,0.25,0.22,0.22,-0.03,-12.0,12000,8,2820,0,0,0,0,0,0,12000,0,12000,12000
20200312,05161P,華新科國票96售01,1.02,1.24,1.02,1.24,+0.55,79.71,91000,4,95920,0,0,0,0,0,0,61000,30000,31000,31000
20200312,051620,可成凱基95購10,,,,,0.00,0.00,0,0,0,0,0,0,0,0,0,0,0,0,0
20200312,051621,欣興凱基95購02,,,,,0.00,0.00,0,0,0,0,0,0,0,0,0,0,0,0,0
20200312,051622,和碩凱基96購01,0.08,0.09,0.08,0.09,0.00,0.00,105000,2,8900,0,0,0,0,0,0,105000,0,105000,105000
20200312,051623,和碩凱基96購02,0.37,0.40,0.31,0.31,-0.15,-32.61,177000,16,66450,0,0,0,0,0,0,157000,30000,127000,127000
20200312,051624,智邦麥證95購02,0.88,0.88,0.68,0.76,-0.43,-36.13,89000,6,69450,89000,0,89000,0,0,0,89000,59000,30000,30000
20200312,051625,聯發科麥證95購01,,,,,0.00,0.00,0,0,0,0,0,0,0,0,0,0,0,0,0
20200312,051626,可成麥證95購02,,,,,0.00,0.00,0,0,0,0,0,0,0,0,0,0,0,0,0
20200312,051627,華新科麥證95購03,,,,,0.00,0.00,0,0,0,0,0,0,0,0,0,0,0,0,0
20200312,051628,瀚宇博麥證95購01,,,,,0.00,0.00,0,0,0,0,0,0,0,0,0,0,0,0,0
20200312,051629,上証2X國票95購04,,,,,0.00,0.00,0,0,0,0,0,0,0,0,0,0,0,0,0
20200312,05162P,玉晶光國票96售03,1.11,1.66,1.11,1.65,+0.66,66.67,2941000,38,4098000,0,0,0,0,0,0,1782000,1124000,658000,658000
20200312,051630,力山國票96購01,,,,,0.00,0.00,0,0,0,0,0,0,0,0,0,0,0,0,0
20200312,051631,國巨國票96購06,4.00,4.00,4.00,4.00,-1.85,-31.62,2000,1,8000,0,0,0,0,0,0,0,2000,-2000,-2000
20200312,051632,全新國票96購01,,,,,0.00,0.00,0,0,0,0,0,0,0,0,0,0,0,0,0
20200312,051633,可成國票96購03,0.21,0.21,0.09,0.11,-0.23,-67.65,335000,7,44490,0,0,0,0,0,0,108000,227000,-119000,-119000
20200312,051634,大立光國票96購03,0.07,0.08,0.06,0.06,-0.13,-68.42,965000,11,67900,0,0,0,0,0,0,0,965000,-965000,-965000
20200312,051635,大立光國票96購04,,,,,0.00,0.00,0,0,0,0,0,0,0,0,0,0,0,0,0
20200312,051636,嘉晶國票95購02,1.37,1.37,1.12,1.12,-0.33,-22.76,243000,15,298240,0,0,0,0,0,0,60000,183000,-123000,-123000
20200312,051637,嘉聯益國票96購01,,,,,0.00,0.00,0,0,0,0,0,0,0,0,0,0,0,0,0
20200312,051638,聯茂國票96購01,1.12,1.17,1.10,1.12,-0.55,-32.93,41000,5,46230,0,0,0,0,0,0,19000,28000,-9000,-9000
20200312,051639,康友國票96購02,1.59,1.59,1.29,1.29,-0.47,-26.7,122000,9,172950,0,0,0,0,0,0,113000,9000,104000,104000
20200312,05163P,聯發科統一96售02,2.01,2.24,2.01,2.23,+0.78,53.79,101000,13,218900,0,0,0,0,0,0,65000,71000,-6000,-6000
20200312,051640,GIS國票96購03,0.17,0.17,0.17,0.17,-0.24,-58.54,204000,1,34680,0,0,0,0,0,0,204000,0,204000,204000
20200312,051641,矽創國票96購01,,,,,0.00,0.00,0,0,0,0,0,0,0,0,0,0,0,0,0
20200312,051642,鈺齊台新95購01,,,,,0.00,0.00,0,0,0,0,0,0,0,0,0,0,0,0,0
20200312,051643,瑞昱康和95購01,,,,,0.00,0.00,0,0,0,0,0,0,0,0,0,0,0,0,0
20200312,051644,聯茂康和95購01,,,,,0.00,0.00,0,0,0,0,0,0,0,0,0,0,0,0,0
20200312,051645,光寶科永豐95購01,0.22,0.22,0.21,0.21,-0.11,-34.38,40000,2,8600,0,0,0,0,0,0,40000,0,40000,40000
20200312,051646,華通永豐96購01,,,,,0.00,0.00,0,0,0,0,0,0,0,0,0,0,0,0,0
20200312,051647,華新科永豐95購02,0.52,0.52,0.52,0.52,-0.51,-49.51,2000,1,1040,0,0,0,0,0,0,0,2000,-2000,-2000
20200312,051648,TPK永豐95購01,,,,,0.00,0.00,0,0,0,0,0,0,0,0,0,0,0,0,0
20200312,051649,中磊永豐95購02,,,,,0.00,0.00,0,0,0,0,0,0,0,0,0,0,0,0,0
20200312,05164P,南亞科元富95售04,0.08,0.15,0.08,0.15,0.00,0.00,250000,6,31400,0,0,0,0,0,0,250000,0,250000,250000
20200312,051650,矽力永豐95購01,0.61,0.61,0.46,0.51,-0.24,-32.0,81000,24,41930,0,0,0,0,0,0,80000,0,80000,80000
20200312,051651,易華電永豐95購01,,,,,0.00,0.00,0,0,0,0,0,0,0,0,0,0,0,0,0
20200312,051652,昇陽半永豐96購02,,,,,0.00,0.00,0,0,0,0,0,0,0,0,0,0,0,0,0
20200312,051653,南電永豐95購02,0.20,0.21,0.20,0.21,-0.22,-51.16,50000,5,10400,0,0,0,0,0,0,0,50000,-50000,-50000
20200312,051654,致新永豐95購01,,,,,0.00,0.00,0,0,0,0,0,0,0,0,0,0,0,0,0
20200312,051655,欣興元富95購04,,,,,0.00,0.00,0,0,0,0,0,0,0,0,0,0,0,0,0
20200312,051656,嘉聯益元富95購02,,,,,0.00,0.00,0,0,0,0,0,0,0,0,0,0,0,0,0
20200312,051657,台郡元富98購01,0.44,0.44,0.34,0.34,-0.26,-43.33,223000,16,84350,0,0,0,0,0,0,104000,119000,-15000,-15000
20200312,051658,深中小國泰97購01,,,,,0.00,0.00,0,0,0,0,0,0,0,0,0,0,0,0,0
20200312,051659,力山國泰97購01,0.09,0.09,0.09,0.09,-0.03,-25.0,380000,1,34200,0,0,0,0,0,0,380000,0,380000,380000
20200312,05165P,欣興元富95售03,4.84,4.84,4.84,4.84,+0.70,16.91,8000,1,38720,0,0,0,0,0,0,8000,0,8000,8000
20200312,051660,緯穎國泰96購02,,,,,0.00,0.00,0,0,0,0,0,0,0,0,0,0,0,0,0
20200312,051661,華新科永昌96購01,,,,,0.00,0.00,0,0,0,0,0,0,0,0,0,0,0,0,0
20200312,051662,大立光永昌96購03,0.62,0.62,0.48,0.48,-0.74,-60.66,390000,8,231200,0,0,0,0,0,0,390000,0,390000,390000
20200312,051663,鴻海元大95購18,,,,,0.00,0.00,0,0,0,0,0,0,0,0,0,0,0,0,0
20200312,051664,鴻海元大96購07,0.17,0.19,0.12,0.12,0.00,0.00,88000,8,13080,0,0,0,0,0,0,30000,58000,-28000,-28000
20200312,051665,台積電元大96購07,0.81,0.81,0.72,0.74,-0.23,-23.71,23000,12,17660,0,0,0,0,0,0,0,23000,-23000,-23000
20200312,051666,旺宏元大96購05,1.26,1.26,1.08,1.08,-0.59,-35.33,6000,2,6660,0,0,0,0,0,0,1000,6000,-5000,-5000
20200312,051667,光磊元大96購02,,,,,0.00,0.00,0,0,0,0,0,0,0,0,0,0,0,0,0
20200312,051668,智邦元大95購02,0.63,0.63,0.44,0.45,-0.25,-35.71,94000,4,48760,0,0,0,0,0,0,10000,84000,-74000,-74000
20200312,051669,建準元大95購01,,,,,0.00,0.00,0,0,0,0,0,0,0,0,0,0,0,0,0
20200312,05166P,中磊元富95售03,0.44,0.53,0.44,0.53,0.00,0.00,50000,5,24500,0,0,0,0,0,0,0,50000,-50000,-50000
20200312,051670,欣興元大95購06,0.16,0.16,0.10,0.10,-0.22,-68.75,290000,6,31400,0,0,0,0,0,0,0,290000,-290000,-290000
20200312,051671,和鑫元大96購02,0.11,0.11,0.11,0.11,0.00,0.00,50000,1,5500,0,0,0,0,0,0,0,50000,-50000,-50000
20200312,051672,玉晶光元大96購03,1.93,1.94,1.56,1.57,-0.71,-31.14,118000,15,222430,0,0,0,0,0,0,8000,118000,-110000,-110000
20200312,051673,玉晶光元大96購04,1.04,1.05,0.78,0.78,-0.46,-37.1,472000,17,415650,0,0,0,0,0,0,58000,411000,-353000,-353000
20200312,051674,臻鼎元大95購02,,,,,0.00,0.00,0,0,0,0,0,0,0,0,0,0,0,0,0
20200312,051675,瑞儀元大96購02,,,,,0.00,0.00,0,0,0,0,0,0,0,0,0,0,0,0,0
20200312,051676,康舒元大95購01,0.62,0.62,0.61,0.61,-0.38,-38.38,200000,2,123000,0,0,0,0,0,0,0,200000,-200000,-200000
20200312,051677,達方元大95購01,0.42,0.42,0.38,0.38,-0.32,-45.71,200000,5,82100,0,0,0,0,0,0,0,200000,-200000,-200000
20200312,051678,鈺齊元大95購02,,,,,0.00,0.00,0,0,0,0,0,0,0,0,0,0,0,0,0
20200312,051679,百和元大95購02,0.17,0.17,0.17,0.17,0.00,0.00,70000,1,11900,0,0,0,0,0,0,70000,0,70000,70000
20200312,05167P,百和元富95售03,0.72,0.98,0.72,0.98,0.00,0.00,240000,12,197200,0,0,0,0,0,0,0,240000,-240000,-240000
20200312,051680,國泰金第一95購01,,,,,0.00,0.00,0,0,0,0,0,0,0,0,0,0,0,0,0
20200312,051681,日月光兆豐95購01,,,,,0.00,0.00,0,0,0,0,0,0,0,0,0,0,0,0,0
20200312,051682,元黃金凱基97購01,1.62,1.62,1.55,1.55,-0.25,-13.89,17000,3,27100,0,0,0,0,0,0,0,17000,-17000,-17000
20200312,051683,A50正2凱基97購01,0.10,0.10,0.10,0.10,-0.03,-23.08,1000,1,100,0,0,0,0,0,0,0,1000,-1000,-1000
20200312,051684,瑞昱凱基95購02,0.46,0.46,0.31,0.32,-0.56,-63.64,100000,5,41400,0,0,0,0,0,0,70000,30000,40000,40000
20200312,051685,台光電凱基95購01,0.15,0.15,0.15,0.15,-0.17,-53.12,100000,1,15000,0,0,0,0,0,0,0,100000,-100000,-100000
20200312,051686,宏達電凱基95購04,0.18,0.18,0.18,0.18,-0.22,-55.0,40000,1,7200,0,0,0,0,0,0,0,40000,-40000,-40000
20200312,051687,大立光凱基95購12,0.10,0.10,0.10,0.10,-0.05,-33.33,10000,1,1000,0,0,0,0,0,0,0,10000,-10000,-10000
20200312,051688,大立光凱基97購02,0.58,0.58,0.46,0.49,-0.31,-38.75,538000,17,268840,0,0,0,0,0,0,4000,538000,-534000,-534000
20200312,051689,智易凱基95購02,,,,,0.00,0.00,0,0,0,0,0,0,0,0,0,0,0,0,0
20200312,05168P,鴻海元大95售14,3.90,3.90,3.90,3.90,0.00,0.00,20000,2,78000,0,0,0,0,0,0,0,20000,-20000,-20000
20200312,051690,超眾凱基95購03,,,,,0.00,0.00,0,0,0,0,0,0,0,0,0,0,0,0,0
20200312,051691,台表科凱基95購01,0.35,0.35,0.19,0.19,-0.32,-62.75,189000,25,60980,0,0,0,0,0,0,179000,10000,169000,169000
20200312,051692,深中小統一95購01,,,,,0.00,0.00,0,0,0,0,0,0,0,0,0,0,0,0,0
20200312,051693,華新科統一95購02,2.15,2.15,1.70,1.90,-1.32,-40.99,70000,7,135200,0,0,0,0,0,0,20000,50000,-30000,-30000
20200312,051694,A50正2中信96購03,0.39,0.39,0.35,0.35,-0.10,-22.22,297000,5,108700,0,0,0,0,0,0,261000,36000,225000,225000
20200312,051695,元金2X中信98購01,,,,,0.00,0.00,0,0,0,0,0,0,0,0,0,0,0,0,0
20200312,051696,新日興中信96購01,0.27,0.27,0.17,0.17,-0.16,-48.48,154000,9,38380,0,0,0,0,0,0,139000,15000,124000,124000
20200312,051697,康友中信95購02,0.22,0.22,0.16,0.16,-0.10,-38.46,202000,7,36920,0,0,0,0,0,0,60000,142000,-82000,-82000
20200312,051698,旺宏麥證95購01,,,,,0.00,0.00,0,0,0,0,0,0,0,0,0,0,0,0,0
20200312,051699,世紀鋼麥證95購01,0.67,0.67,0.58,0.63,-0.10,-13.7,298000,10,181420,210000,88000,122000,0,0,0,210000,88000,122000,122000
20200312,05169P,玉晶光元大95售03,1.21,1.61,1.21,1.59,+0.50,45.87,49000,12,67300,0,0,0,0,0,0,49000,0,49000,49000
20200312,051700,深中小群益99購04,1.11,1.11,0.98,1.02,-0.18,-15.0,664000,15,706140,0,0,0,0,0,0,564000,100000,464000,464000
20200312,051701,華通群益97購01,0.43,0.43,0.23,0.23,-0.31,-57.41,53000,14,18300,0,0,0,0,0,0,28000,25000,3000,3000
20200312,051702,鴻海群益95購08,0.05,0.05,0.05,0.05,-0.07,-58.33,45000,1,2250,0,0,0,0,0,0,45000,0,45000,45000
20200312,051703,台積電群益95購04,0.22,0.22,0.20,0.20,-0.18,-47.37,114000,9,24060,0,0,0,0,0,0,3000,10000,-7000,-7000
20200312,051704,智邦群益95購02,0.50,0.50,0.36,0.36,-0.14,-28.0,94000,24,38130,0,0,0,0,0,0,44000,50000,-6000,-6000
20200312,051705,富邦金群益97購01,0.15,0.16,0.14,0.14,-0.11,-44.0,78000,3,11580,0,0,0,0,0,0,50000,28000,22000,22000
20200312,051706,國泰金群益95購01,,,,,0.00,0.00,0,0,0,0,0,0,0,0,0,0,0,0,0
20200312,051707,欣興群益95購02,,,,,0.00,0.00,0,0,0,0,0,0,0,0,0,0,0,0,0
20200312,051708,創意群益95購02,,,,,0.00,0.00,0,0,0,0,0,0,0,0,0,0,0,0,0
20200312,051709,TPK群益95購02,,,,,0.00,0.00,0,0,0,0,0,0,0,0,0,0,0,0,0
20200312,05170P,世芯元大95售01,0.73,0.99,0.69,0.99,+0.31,45.59,1982000,75,1655790,0,0,0,0,0,0,1604000,218000,1386000,1386000
20200312,051710,和碩群益95購01,,,,,0.00,0.00,0,0,0,0,0,0,0,0,0,0,0,0,0
20200312,051711,臻鼎群益95購03,,,,,0.00,0.00,0,0,0,0,0,0,0,0,0,0,0,0,0
20200312,051712,嘉聯益群益95購01,,,,,0.00,0.00,0,0,0,0,0,0,0,0,0,0,0,0,0
20200312,051713,大立光台新95購03,0.52,0.52,0.52,0.52,0.00,0.00,100000,1,52000,0,0,0,0,0,0,0,100000,-100000,-100000
20200312,051714,健鼎台新95購01,,,,,0.00,0.00,0,0,0,0,0,0,0,0,0,0,0,0,0
20200312,051715,和碩台新95購01,,,,,0.00,0.00,0,0,0,0,0,0,0,0,0,0,0,0,0
20200312,051716,康控康和95購01,,,,,0.00,0.00,0,0,0,0,0,0,0,0,0,0,0,0,0
20200312,051717,祥碩康和95購01,,,,,0.00,0.00,0,0,0,0,0,0,0,0,0,0,0,0,0
20200312,051718,上証2X永豐95購01,0.24,0.26,0.21,0.22,-0.13,-37.14,155000,10,36110,0,0,0,0,0,0,60000,95000,-35000,-35000
20200312,051719,鴻海永豐95購04,,,,,0.00,0.00,0,0,0,0,0,0,0,0,0,0,0,0,0
20200312,05171P,臺股指元大95售15,3.27,4.47,3.27,4.47,+1.70,61.37,158000,18,608390,0,0,0,0,0,0,116000,41000,75000,75000
20200312,051720,燿華永豐95購06,,,,,0.00,0.00,0,0,0,0,0,0,0,0,0,0,0,0,0
20200312,051721,玉晶光永豐96購02,1.62,1.62,1.25,1.29,0.00,0.00,21000,7,32210,0,0,0,0,0,0,21000,6000,15000,15000
20200312,051722,玉晶光永豐97購01,1.67,1.67,1.24,1.29,-0.67,-34.18,35000,8,56210,0,0,0,0,0,0,5000,35000,-30000,-30000
20200312,051723,嘉澤永豐95購01,0.08,0.08,0.08,0.08,0.00,0.00,10000,1,800,0,0,0,0,0,0,0,10000,-10000,-10000
20200312,051724,康控永豐95購03,,,,,0.00,0.00,0,0,0,0,0,0,0,0,0,0,0,0,0
20200312,051725,緯穎永豐95購02,2.03,2.03,1.71,1.71,-0.82,-32.41,20000,2,37400,0,0,0,0,0,0,10000,10000,0,0
20200312,051726,南茂永豐95購03,,,,,0.00,0.00,0,0,0,0,0,0,0,0,0,0,0,0,0
20200312,051727,S&P反1國票97購01,1.20,1.30,1.20,1.30,+0.30,30.0,1000000,4,1255000,0,0,0,0,0,0,970000,0,970000,970000
20200312,051728,道瓊反國票97購01,1.52,1.77,1.52,1.77,+0.62,53.91,6000,3,10010,0,0,0,0,0,0,6000,0,6000,6000
20200312,051729,華新國票96購01,0.43,0.43,0.43,0.43,-0.10,-18.87,20000,1,8600,0,0,0,0,0,0,20000,0,20000,20000
20200312,05172P,臺股指元大95售16,,,,,0.00,0.00,0,0,0,0,0,0,0,0,0,0,0,0,0
20200312,051730,為升國票96購02,0.15,0.15,0.09,0.09,-0.23,-71.88,479000,8,56600,0,0,0,0,0,0,4000,475000,-471000,-471000
20200312,051731,聯電國票96購02,1.19,1.19,0.89,0.96,-0.50,-34.25,74000,7,73100,0,0,0,0,0,0,10000,64000,-54000,-54000
20200312,051732,華通國票97購01,0.01,0.10,0.01,0.10,+0.05,100.0,577000,8,5860,0,0,0,0,0,0,0,0,0,0
20200312,051733,中環國票96購02,0.08,0.08,0.08,0.08,-0.01,-11.11,12000,1,960,0,0,0,0,0,0,0,0,0,0
20200312,051734,台積電國票95購04,,,,,0.00,0.00,0,0,0,0,0,0,0,0,0,0,0,0,0
20200312,051735,台積電國票96購06,1.17,1.17,0.76,1.09,-0.41,-27.33,58000,8,60370,0,0,0,0,0,0,41000,17000,24000,24000
20200312,051736,旺宏國票96購01,3.49,3.49,2.64,2.64,-1.45,-35.45,31000,4,97130,0,0,0,0,0,0,1000,30000,-29000,-29000
20200312,051737,瑞昱國票96購01,1.03,1.03,0.67,0.67,-0.83,-55.33,76000,5,66580,0,0,0,0,0,0,36000,40000,-4000,-4000
20200312,051738,全新國票96購02,,,,,0.00,0.00,0,0,0,0,0,0,0,0,0,0,0,0,0
20200312,051739,奇力新國票97購01,2.82,2.82,1.87,1.98,-0.99,-33.33,39000,4,85030,0,0,0,0,0,0,10000,29000,-19000,-19000
20200312,05173P,臺股指元大95售17,4.35,5.15,4.35,5.15,+1.79,53.27,3000,3,14000,0,0,0,0,0,0,3000,0,3000,3000
20200312,051740,可成國票96購04,,,,,0.00,0.00,0,0,0,0,0,0,0,0,0,0,0,0,0
20200312,051741,可成國票97購01,,,,,0.00,0.00,0,0,0,0,0,0,0,0,0,0,0,0,0
20200312,051742,欣興國票96購01,0.04,0.04,0.04,0.04,-0.04,-50.0,379000,3,15160,0,0,0,0,0,0,0,379000,-379000,-379000
20200312,051743,揚明光國票96購02,0.55,0.55,0.55,0.55,0.00,0.00,10000,1,5500,0,0,0,0,0,0,0,10000,-10000,-10000
20200312,051744,嘉聯益國票97購01,,,,,0.00,0.00,0,0,0,0,0,0,0,0,0,0,0,0,0
20200312,051745,玉晶光國泰97購06,1.68,1.68,1.29,1.34,-0.72,-34.95,37000,7,59940,0,0,0,0,0,0,37000,37000,0,0
20200312,051746,玉晶光國泰97購07,1.78,1.79,1.57,1.62,0.00,0.00,8000,6,13110,0,0,0,0,0,0,8000,8000,0,0
20200312,051747,貿聯國泰96購01,0.44,0.45,0.36,0.38,-0.12,-24.0,759000,34,296080,0,0,0,0,0,0,750000,0,750000,750000
20200312,051748,超眾國泰96購01,0.92,0.92,0.71,0.74,-0.28,-27.45,310000,5,230900,0,0,0,0,0,0,290000,270000,20000,20000
20200312,051749,矽力國泰97購01,1.54,1.54,1.24,1.38,-0.32,-18.82,999000,53,1355540,0,0,0,0,0,0,455000,480000,-25000,-25000
20200312,05174P,元金2X富邦9B售01,0.41,0.49,0.41,0.46,+0.09,24.32,490000,16,225170,0,0,0,0,0,0,358000,108000,250000,250000
20200312,051750,華通富邦96購01,,,,,0.00,0.00,0,0,0,0,0,0,0,0,0,0,0,0,0
20200312,051751,聯茂富邦95購01,0.19,0.19,0.18,0.18,-0.22,-55.0,140000,2,26200,0,0,0,0,0,0,0,140000,-140000,-140000
20200312,051752,緯穎富邦96購01,0.73,0.73,0.73,0.73,-0.42,-36.52,2000,2,1460,0,0,0,0,0,0,0,2000,-2000,-2000
20200312,051753,華通元大96購03,0.06,0.06,0.06,0.06,-0.09,-60.0,20000,2,1200,0,0,0,0,0,0,0,20000,-20000,-20000
20200312,051754,廣宇元大95購01,,,,,0.00,0.00,0,0,0,0,0,0,0,0,0,0,0,0,0
20200312,051755,台積電元大96購08,1.05,1.05,0.74,0.90,-0.31,-25.62,474000,23,425580,0,0,0,0,0,0,244000,409000,-165000,-165000
20200312,051756,台積電元大97購04,1.26,1.26,1.25,1.25,-0.41,-24.7,3000,2,3760,0,0,0,0,0,0,1000,3000,-2000,-2000
20200312,051757,佳世達元大95購02,,,,,0.00,0.00,0,0,0,0,0,0,0,0,0,0,0,0,0
20200312,051758,瑞昱元大95購01,0.56,0.56,0.31,0.31,-0.58,-65.17,128000,3,50680,0,0,0,0,0,0,60000,68000,-8000,-8000
20200312,051759,全新元大95購04,0.03,0.03,0.03,0.03,0.00,0.00,2028000,14,60840,0,0,0,0,0,0,2028000,0,2028000,2028000
20200312,05175P,TPK富邦99售01,2.05,2.05,2.05,2.05,0.00,0.00,20000,2,41000,0,0,0,0,0,0,0,20000,-20000,-20000
20200312,051760,奇力新元大95購04,1.51,1.51,1.28,1.28,-0.75,-36.95,65000,4,88010,0,0,0,0,0,0,65000,61000,4000,4000
20200312,051761,富邦金元大96購01,0.14,0.14,0.12,0.12,-0.11,-47.83,230000,6,30300,0,0,0,0,0,0,100000,130000,-30000,-30000
20200312,051762,國泰金元大95購01,,,,,0.00,0.00,0,0,0,0,0,0,0,0,0,0,0,0,0
20200312,051763,新光金元大98購01,,,,,0.00,0.00,0,0,0,0,0,0,0,0,0,0,0,0,0
20200312,051764,欣興元大95購07,,,,,0.00,0.00,0,0,0,0,0,0,0,0,0,0,0,0,0
20200312,051765,健鼎元大95購03,,,,,0.00,0.00,0,0,0,0,0,0,0,0,0,0,0,0,0
20200312,051766,泰鼎元大95購02,,,,,0.00,0.00,0,0,0,0,0,0,0,0,0,0,0,0,0
20200312,051767,臻鼎元大95購03,,,,,0.00,0.00,0,0,0,0,0,0,0,0,0,0,0,0,0
20200312,051768,臻鼎元大95購04,,,,,0.00,0.00,0,0,0,0,0,0,0,0,0,0,0,0,0
20200312,051769,矽力元大95購01,2.26,2.26,1.85,1.90,-0.68,-26.36,78000,8,152000,0,0,0,0,0,0,19000,59000,-40000,-40000
20200312,05176P,台積電凱基95售11,0.87,1.15,0.87,0.92,+0.23,33.33,767000,27,736290,0,0,0,0,0,0,116000,664000,-548000,-548000
20200312,051770,南茂元大95購02,,,,,0.00,0.00,0,0,0,0,0,0,0,0,0,0,0,0,0
20200312,051771,上銀中信95購01,0.41,0.41,0.21,0.21,-0.41,-66.13,284000,9,96650,0,0,0,0,0,0,60000,224000,-164000,-164000
20200312,051772,玉山金中信95購01,0.38,0.38,0.25,0.28,-0.13,-31.71,311000,10,96820,0,0,0,0,0,0,99000,212000,-113000,-113000
20200312,051773,元大金中信95購02,,,,,0.00,0.00,0,0,0,0,0,0,0,0,0,0,0,0,0
20200312,051774,聯茂中信96購01,0.99,0.99,0.65,0.65,-0.42,-39.25,492000,15,390070,0,0,0,0,0,0,363000,129000,234000,234000
20200312,051775,旺宏亞東95購01,0.40,0.40,0.40,0.40,-0.23,-36.51,10000,1,4000,0,0,0,0,0,0,0,10000,-10000,-10000
20200312,051776,上証2X群益99購01,0.77,0.77,0.62,0.70,-0.20,-22.22,272000,9,189940,0,0,0,0,0,0,152000,120000,32000,32000
20200312,051777,聯發科群益95購04,0.18,0.18,0.18,0.18,-0.11,-37.93,110000,1,19800,0,0,0,0,0,0,110000,0,110000,110000
20200312,051778,全新群益95購01,,,,,0.00,0.00,0,0,0,0,0,0,0,0,0,0,0,0,0
20200312,051779,大立光群益95購02,0.11,0.11,0.05,0.05,-0.33,-86.84,300000,10,22800,0,0,0,0,0,0,30000,260000,-230000,-230000
20200312,05177P,台積電凱基95售12,0.47,0.47,0.47,0.47,+0.13,38.24,1000,1,470,0,0,0,0,0,0,0,1000,-1000,-1000
20200312,051780,矽力群益95購01,1.61,1.61,1.22,1.39,-0.63,-31.19,147000,22,211450,0,0,0,0,0,0,65000,82000,-17000,-17000
20200312,051781,緯穎群益96購01,3.20,3.28,3.20,3.28,-1.87,-36.31,15000,2,48400,0,0,0,0,0,0,10000,5000,5000,5000
20200312,051782,昇陽半群益95購01,,,,,0.00,0.00,0,0,0,0,0,0,0,0,0,0,0,0,0
20200312,051783,鴻海兆豐95購03,,,,,0.00,0.00,0,0,0,0,0,0,0,0,0,0,0,0,0
20200312,051784,國巨兆豐95購01,1.62,1.62,0.98,1.09,-0.59,-35.12,189000,14,231320,0,0,0,0,0,0,87000,102000,-15000,-15000
20200312,051785,臻鼎兆豐96購01,,,,,0.00,0.00,0,0,0,0,0,0,0,0,0,0,0,0,0
20200312,051786,A50正2國票95購02,0.21,0.21,0.15,0.18,-0.05,-21.74,89000,14,15500,0,0,0,0,0,0,5000,84000,-79000,-79000
20200312,051787,燿華國票96購02,,,,,0.00,0.00,0,0,0,0,0,0,0,0,0,0,0,0,0
20200312,051788,奇力新國票97購02,1.03,1.03,0.63,0.63,-0.65,-50.78,95000,7,83810,0,0,0,0,0,0,95000,0,95000,95000
20200312,051789,嘉澤國票96購01,,,,,0.00,0.00,0,0,0,0,0,0,0,0,0,0,0,0,0
20200312,05178P,大立光凱基96售05,2.00,2.57,2.00,2.57,+1.03,66.88,9000,4,21750,0,0,0,0,0,0,8000,0,8000,8000
20200312,051790,貿聯國票95購03,,,,,0.00,0.00,0,0,0,0,0,0,0,0,0,0,0,0,0
20200312,051791,智伸科國票96購01,0.27,0.27,0.26,0.26,-0.10,-27.78,140000,2,37420,0,0,0,0,0,0,140000,0,140000,140000
20200312,051792,泰鼎國票96購02,,,,,0.00,0.00,0,0,0,0,0,0,0,0,0,0,0,0,0
20200312,051793,臻鼎國票95購02,,,,,0.00,0.00,0,0,0,0,0,0,0,0,0,0,0,0,0
20200312,051794,臻鼎國票96購02,0.01,0.01,0.01,0.01,-0.07,-87.5,30000,1,300,0,0,0,0,0,0,0,0,0,0
20200312,051795,T50反1台新05購02,1.01,1.33,1.01,1.33,+0.45,51.14,648000,12,808540,0,0,0,0,0,0,648000,642000,6000,6000
20200312,051796,和碩康和95購01,,,,,0.00,0.00,0,0,0,0,0,0,0,0,0,0,0,0,0
20200312,051797,卜蜂永豐95購01,0.08,0.08,0.08,0.08,0.00,0.00,10000,1,800,0,0,0,0,0,0,0,10000,-10000,-10000
20200312,051798,國巨永豐95購03,1.61,1.61,0.87,0.87,-0.73,-45.62,102000,7,122700,0,0,0,0,0,0,35000,67000,-32000,-32000
20200312,051799,台積電永豐96購01,0.68,0.70,0.59,0.69,-0.27,-28.13,49000,5,33440,0,0,0,0,0,0,26000,23000,3000,3000
20200312,05179P,大立光凱基96售06,2.39,2.45,2.39,2.45,0.00,0.00,200000,3,484000,0,0,0,0,0,0,200000,200000,0,0
20200312,051800,旺宏永豐95購02,,,,,0.00,0.00,0,0,0,0,0,0,0,0,0,0,0,0,0
20200312,051801,牧德永豐95購04,1.11,1.12,0.76,0.76,0.00,0.00,19000,3,19020,0,0,0,0,0,0,0,19000,-19000,-19000
20200312,051802,同欣電永豐95購02,0.17,0.17,0.15,0.15,-0.17,-53.12,33000,2,5010,0,0,0,0,0,0,33000,0,33000,33000
20200312,051803,矽創永豐95購03,,,,,0.00,0.00,0,0,0,0,0,0,0,0,0,0,0,0,0
20200312,051804,新光金日盛95購01,0.08,0.10,0.08,0.09,-0.06,-40.0,160000,8,14000,0,0,0,0,0,0,0,160000,-160000,-160000
20200312,051805,元黃金凱基97購02,1.70,1.70,1.58,1.58,-0.24,-13.19,73000,10,119650,0,0,0,0,0,0,30000,43000,-13000,-13000
20200312,051806,華通凱基96購02,,,,,0.00,0.00,0,0,0,0,0,0,0,0,0,0,0,0,0
20200312,051807,瑞昱凱基95購03,,,,,0.00,0.00,0,0,0,0,0,0,0,0,0,0,0,0,0
20200312,051808,美律凱基96購02,,,,,0.00,0.00,0,0,0,0,0,0,0,0,0,0,0,0,0
20200312,051809,義隆凱基96購01,,,,,0.00,0.00,0,0,0,0,0,0,0,0,0,0,0,0,0
20200312,05180P,玉晶光凱基95售04,0.34,0.47,0.34,0.46,+0.14,43.75,2974000,41,1190180,0,0,0,0,0,0,2280000,691000,1589000,1589000
20200312,051810,欣興凱基95購03,,,,,0.00,0.00,0,0,0,0,0,0,0,0,0,0,0,0,0
20200312,051811,致伸凱基95購03,,,,,0.00,0.00,0,0,0,0,0,0,0,0,0,0,0,0,0
20200312,051812,臻鼎凱基95購03,,,,,0.00,0.00,0,0,0,0,0,0,0,0,0,0,0,0,0
20200312,051813,GIS凱基96購02,,,,,0.00,0.00,0,0,0,0,0,0,0,0,0,0,0,0,0
20200312,051814,鈺齊凱基95購01,,,,,0.00,0.00,0,0,0,0,0,0,0,0,0,0,0,0,0
20200312,051815,百和凱基96購01,,,,,0.00,0.00,0,0,0,0,0,0,0,0,0,0,0,0,0
20200312,051816,臺股指凱基95購07,0.32,0.34,0.30,0.30,-0.39,-56.52,5000,5,1600,0,0,0,0,0,0,0,5000,-5000,-5000
20200312,051817,元金2X統一95購01,3.37,3.37,3.15,3.15,-0.66,-17.32,41000,5,132350,0,0,0,0,0,0,0,41000,-41000,-41000
20200312,051818,國巨統一95購02,3.74,3.74,2.55,2.55,-1.20,-32.0,54000,4,175760,0,0,0,0,0,0,24000,30000,-6000,-6000
20200312,051819,燿華統一96購01,,,,,0.00,0.00,0,0,0,0,0,0,0,0,0,0,0,0,0
20200312,05181P,健策凱基95售01,0.45,0.62,0.44,0.62,0.00,0.00,2010000,25,958640,0,0,0,0,0,0,0,2010000,-2010000,-2010000
20200312,051820,道瓊反元富95購01,,,,,0.00,0.00,0,0,0,0,0,0,0,0,0,0,0,0,0
20200312,051821,京元電元富95購04,,,,,0.00,0.00,0,0,0,0,0,0,0,0,0,0,0,0,0
20200312,051822,和碩元富95購01,0.07,0.07,0.07,0.07,-0.04,-36.36,440000,1,30800,0,0,0,0,0,0,440000,0,440000,440000
20200312,051823,矽力元富95購02,1.22,1.22,1.01,1.01,-0.34,-25.19,113000,30,125060,0,0,0,0,0,0,100000,12000,88000,88000
20200312,051824,華通元大95購07,,,,,0.00,0.00,0,0,0,0,0,0,0,0,0,0,0,0,0
20200312,051825,中環元大95購01,0.15,0.15,0.07,0.07,-0.10,-58.82,663000,8,81120,0,0,0,0,0,0,224000,429000,-205000,-205000
20200312,051826,智邦元大95購03,0.37,0.37,0.22,0.22,-0.17,-43.59,130000,7,42300,0,0,0,0,0,0,20000,110000,-90000,-90000
20200312,051827,智邦元大95購04,0.53,0.53,0.36,0.37,-0.20,-35.09,140000,9,60000,0,0,0,0,0,0,21000,130000,-109000,-109000
20200312,051828,微星元大95購03,1.91,1.91,1.50,1.50,-0.57,-27.54,70000,6,126260,0,0,0,0,0,0,70000,6000,64000,64000
20200312,051829,玉晶光元大98購02,1.51,1.52,1.19,1.20,-0.46,-27.71,482000,44,654290,0,0,0,0,0,0,324000,238000,86000,86000
20200312,05182P,嘉晶統一95售03,0.49,0.59,0.46,0.52,+0.03,6.12,208000,14,102080,0,0,0,0,0,0,112000,96000,16000,16000
20200312,051830,健策元大97購01,0.95,0.95,0.66,0.66,-0.56,-45.9,199000,13,166330,0,0,0,0,0,0,83000,116000,-33000,-33000
20200312,051831,緯穎元大96購04,,,,,0.00,0.00,0,0,0,0,0,0,0,0,0,0,0,0,0
20200312,051832,復盛元大95購01,1.13,1.13,0.86,0.86,-0.53,-38.13,97000,5,91640,0,0,0,0,0,0,66000,31000,35000,35000
20200312,051833,昇陽半元大96購01,0.29,0.29,0.20,0.20,-0.16,-44.44,57000,4,14080,0,0,0,0,0,0,27000,30000,-3000,-3000
20200312,051834,南電元大96購02,0.52,0.52,0.31,0.31,-0.25,-44.64,193000,4,63820,0,0,0,0,0,0,193000,1000,192000,192000
20200312,051835,百和元大95購03,,,,,0.00,0.00,0,0,0,0,0,0,0,0,0,0,0,0,0
20200312,051836,華通國泰95購02,,,,,0.00,0.00,0,0,0,0,0,0,0,0,0,0,0,0,0
20200312,051837,國巨國泰96購04,,,,,0.00,0.00,0,0,0,0,0,0,0,0,0,0,0,0,0
20200312,051838,國巨國泰97購01,,,,,0.00,0.00,0,0,0,0,0,0,0,0,0,0,0,0,0
20200312,051839,和鑫國泰96購01,0.22,0.22,0.22,0.22,-0.10,-31.25,30000,1,6600,0,0,0,0,0,0,30000,0,30000,30000
20200312,05183P,台積電元富95售07,1.63,1.66,1.45,1.45,0.00,0.00,62000,19,94940,0,0,0,0,0,0,50000,62000,-12000,-12000
20200312,051840,康友國泰97購02,1.23,1.23,0.91,0.97,-0.32,-24.81,675000,85,708060,0,0,0,0,0,0,531000,390000,141000,141000
20200312,051841,南茂國泰96購01,0.44,0.44,0.31,0.34,-0.29,-46.03,455000,7,164950,0,0,0,0,0,0,430000,25000,405000,405000
20200312,051842,大成鋼富邦97購01,0.54,0.54,0.50,0.52,-0.03,-5.45,391000,13,201720,0,0,0,0,0,0,376000,15000,361000,361000
20200312,051843,聯發科富邦99購01,0.35,0.35,0.20,0.20,-0.21,-51.22,1229000,49,300490,0,0,0,0,0,0,584000,635000,-51000,-51000
20200312,051844,宏達電富邦96購01,0.25,0.26,0.18,0.18,-0.12,-40.0,593000,11,128150,0,0,0,0,0,0,305000,288000,17000,17000
20200312,051845,世紀鋼富邦96購01,0.56,0.56,0.45,0.56,-0.04,-6.67,601000,24,310970,10000,0,10000,0,0,0,468000,133000,335000,345000
20200312,051846,S&P反1中信96購02,1.95,2.20,1.95,2.20,+0.44,25.0,49000,5,101440,0,0,0,0,0,0,39000,20000,19000,19000
20200312,051847,香港反中信99購01,0.88,0.91,0.87,0.89,+0.16,21.92,195000,10,172280,0,0,0,0,0,0,60000,135000,-75000,-75000
20200312,051848,元金2X中信98購02,1.45,1.45,1.33,1.35,-0.21,-13.46,388000,17,521030,0,0,0,0,0,0,109000,279000,-170000,-170000
20200312,051849,旺宏中信98購01,0.70,0.70,0.52,0.58,-0.22,-27.5,394000,16,255780,0,0,0,0,0,0,180000,214000,-34000,-34000
20200312,05184P,緯穎元富95售01,,,,,0.00,0.00,0,0,0,0,0,0,0,0,0,0,0,0,0
20200312,051850,臻鼎中信96購01,0.16,0.16,0.07,0.08,-0.10,-55.56,280000,13,27100,0,0,0,0,0,0,200000,80000,120000,120000
20200312,051851,TPK群益95購03,,,,,0.00,0.00,0,0,0,0,0,0,0,0,0,0,0,0,0
20200312,051852,啟碁群益95購01,,,,,0.00,0.00,0,0,0,0,0,0,0,0,0,0,0,0,0
20200312,051853,京元電亞東95購01,,,,,0.00,0.00,0,0,0,0,0,0,0,0,0,0,0,0,0
20200312,051854,鴻海麥證95購04,,,,,0.00,0.00,0,0,0,0,0,0,0,0,0,0,0,0,0
20200312,051855,道瓊反凱基97購01,1.15,1.57,1.15,1.46,+0.51,53.68,1416000,37,2030590,0,0,0,0,0,0,902000,1234000,-332000,-332000
20200312,051856,亞德客凱基95購01,0.46,0.46,0.26,0.26,-0.41,-61.19,29000,4,8840,0,0,0,0,0,0,3000,29000,-26000,-26000
20200312,051857,喬山凱基95購01,,,,,0.00,0.00,0,0,0,0,0,0,0,0,0,0,0,0,0
20200312,051858,上銀凱基95購01,0.12,0.12,0.08,0.08,-0.12,-60.0,58000,4,5040,0,0,0,0,0,0,48000,0,48000,48000
20200312,051859,劍麟凱基96購01,,,,,0.00,0.00,0,0,0,0,0,0,0,0,0,0,0,0,0
20200312,05185P,鴻海中信95售04,1.40,1.67,1.38,1.67,+0.47,39.17,126000,12,187440,0,0,0,0,0,0,56000,105000,-49000,-49000
20200312,051860,為升凱基95購01,0.02,0.02,0.02,0.02,0.00,0.00,5000,1,100,0,0,0,0,0,0,5000,0,5000,5000
20200312,051861,鴻海凱基98購01,0.14,0.14,0.09,0.10,-0.07,-41.18,172000,23,18810,0,0,0,0,0,0,10000,120000,-110000,-110000
20200312,051862,旺宏凱基95購05,0.50,0.50,0.30,0.30,-0.50,-62.5,95000,6,38900,0,0,0,0,0,0,10000,85000,-75000,-75000
20200312,051863,技嘉凱基95購01,0.10,0.10,0.06,0.06,-0.06,-50.0,250000,11,19000,0,0,0,0,0,0,150000,100000,50000,50000
20200312,051864,聯發科凱基96購03,0.14,0.14,0.14,0.14,-0.14,-50.0,2000,1,280,0,0,0,0,0,0,2000,0,2000,2000
20200312,051865,聯發科凱基96購04,,,,,0.00,0.00,0,0,0,0,0,0,0,0,0,0,0,0,0
20200312,051866,聯發科凱基96購05,,,,,0.00,0.00,0,0,0,0,0,0,0,0,0,0,0,0,0
20200312,051867,潤泰全凱基95購01,,,,,0.00,0.00,0,0,0,0,0,0,0,0,0,0,0,0,0
20200312,051868,貿聯凱基96購01,0.19,0.19,0.14,0.14,-0.10,-41.67,20000,2,3300,0,0,0,0,0,0,0,20000,-20000,-20000
20200312,051869,康控凱基96購01,,,,,0.00,0.00,0,0,0,0,0,0,0,0,0,0,0,0,0
20200312,05186P,鈺齊中信95售02,0.73,0.88,0.71,0.88,+0.20,29.41,348000,10,267290,0,0,0,0,0,0,106000,242000,-136000,-136000
20200312,051870,台郡凱基95購04,0.06,0.06,0.04,0.05,-0.10,-66.67,50000,28,2650,0,0,0,0,0,0,50000,0,50000,50000
20200312,051871,同欣電凱基95購02,,,,,0.00,0.00,0,0,0,0,0,0,0,0,0,0,0,0,0
20200312,051872,矽力凱基96購01,0.83,0.98,0.83,0.88,-0.26,-22.81,39000,18,36190,0,0,0,0,0,0,39000,0,39000,39000
20200312,051873,緯穎凱基95購02,1.77,1.77,1.65,1.65,-0.97,-37.02,100000,2,171000,0,0,0,0,0,0,100000,0,100000,100000
20200312,051874,志超凱基95購01,,,,,0.00,0.00,0,0,0,0,0,0,0,0,0,0,0,0,0
20200312,051875,聯發科兆豐95購04,0.11,0.11,0.10,0.10,-0.11,-52.38,40000,3,4200,0,0,0,0,0,0,0,40000,-40000,-40000
20200312,051876,宏達電國票96購01,1.55,1.55,1.06,1.06,-0.61,-36.53,48000,8,66980,0,0,0,0,0,0,20000,28000,-8000,-8000
20200312,051877,嘉聯益國票97購02,,,,,0.00,0.00,0,0,0,0,0,0,0,0,0,0,0,0,0
20200312,051878,鴻海台新96購01,,,,,0.00,0.00,0,0,0,0,0,0,0,0,0,0,0,0,0
20200312,051879,健策台新96購01,0.71,0.71,0.47,0.47,-0.55,-53.92,291000,8,155710,0,0,0,0,0,0,10000,281000,-271000,-271000
20200312,05187P,力山凱基95售01,1.84,1.84,1.84,1.84,+0.14,8.24,25000,1,46000,0,0,0,0,0,0,25000,0,25000,25000
20200312,051880,健策康和95購01,,,,,0.00,0.00,0,0,0,0,0,0,0,0,0,0,0,0,0
20200312,051881,上証2X永豐95購02,,,,,0.00,0.00,0,0,0,0,0,0,0,0,0,0,0,0,0
20200312,051882,潤泰全永豐95購01,,,,,0.00,0.00,0,0,0,0,0,0,0,0,0,0,0,0,0
20200312,051883,智原永豐95購03,,,,,0.00,0.00,0,0,0,0,0,0,0,0,0,0,0,0,0
20200312,051884,樺漢永豐95購01,,,,,0.00,0.00,0,0,0,0,0,0,0,0,0,0,0,0,0
20200312,051885,易華電永豐95購02,,,,,0.00,0.00,0,0,0,0,0,0,0,0,0,0,0,0,0
20200312,051886,道瓊反統一95購03,,,,,0.00,0.00,0,0,0,0,0,0,0,0,0,0,0,0,0
20200312,051887,上証2X元富98購01,0.26,0.26,0.26,0.26,0.00,0.00,6000,1,1560,0,0,0,0,0,0,0,6000,-6000,-6000
20200312,051888,國巨元富95購05,0.70,0.70,0.44,0.47,-0.29,-38.16,414000,27,219450,0,0,0,0,0,0,180000,108000,72000,72000
20200312,051889,智邦元富95購02,0.53,0.53,0.32,0.38,-0.18,-32.14,569000,38,242780,0,0,0,0,0,0,310000,289000,21000,21000
20200312,05188P,可成凱基95售09,1.68,1.68,1.68,1.68,0.00,0.00,10000,1,16800,0,0,0,0,0,0,0,10000,-10000,-10000
20200312,051890,智邦元富95購03,0.33,0.33,0.31,0.31,-0.09,-22.5,150000,30,48420,0,0,0,0,0,0,150000,0,150000,150000
20200312,051891,智邦元富95購04,,,,,0.00,0.00,0,0,0,0,0,0,0,0,0,0,0,0,0
20200312,051892,台光電元富95購03,,,,,0.00,0.00,0,0,0,0,0,0,0,0,0,0,0,0,0
20200312,051893,瀚宇博元富95購01,,,,,0.00,0.00,0,0,0,0,0,0,0,0,0,0,0,0,0
20200312,051894,嘉聯益元富95購03,,,,,0.00,0.00,0,0,0,0,0,0,0,0,0,0,0,0,0
20200312,051895,聯茂元富95購02,,,,,0.00,0.00,0,0,0,0,0,0,0,0,0,0,0,0,0
20200312,051896,柏文元富95購01,0.07,0.07,0.07,0.07,0.00,0.00,70000,1,4900,0,0,0,0,0,0,70000,0,70000,70000
20200312,051897,台光電國泰97購01,1.18,1.18,0.82,0.96,-0.35,-26.72,118000,11,116580,0,0,0,0,0,0,20000,98000,-78000,-78000
20200312,051898,富邦金國泰97購01,0.58,0.58,0.41,0.41,-0.26,-38.81,110000,6,48800,0,0,0,0,0,0,60000,50000,10000,10000
20200312,051899,欣興國泰97購01,0.23,0.23,0.18,0.18,-0.18,-50.0,19000,8,3910,0,0,0,0,0,0,0,19000,-19000,-19000
20200312,05189P,新光金凱基97售02,0.98,1.00,0.98,1.00,0.00,0.00,105000,2,104900,0,0,0,0,0,0,5000,100000,-95000,-95000
20200312,051900,臻鼎富邦95購01,,,,,0.00,0.00,0,0,0,0,0,0,0,0,0,0,0,0,0
20200312,051901,嘉聯益富邦96購01,,,,,0.00,0.00,0,0,0,0,0,0,0,0,0,0,0,0,0
20200312,051902,T50反1元大97購01,1.10,1.46,1.10,1.37,+0.52,61.18,109000,11,141840,0,0,0,0,0,0,70000,39000,31000,31000
20200312,051903,T50反1元大97購02,,,,,0.00,0.00,0,0,0,0,0,0,0,0,0,0,0,0,0
20200312,051904,深100元大95購01,0.70,0.70,0.59,0.64,-0.18,-21.95,50000,5,32300,0,0,0,0,0,0,0,50000,-50000,-50000
20200312,051905,道瓊銀元大95購01,0.52,0.52,0.50,0.50,-0.20,-28.57,41000,2,20520,0,0,0,0,0,0,1000,40000,-39000,-39000
20200312,051906,國巨元大95購09,2.58,2.58,1.91,1.91,-0.97,-33.68,90000,3,223700,0,0,0,0,0,0,80000,80000,0,0
20200312,051907,台積電元大97購05,1.01,1.01,0.75,0.86,-0.25,-22.52,168000,38,152310,0,0,0,0,0,0,14000,120000,-106000,-106000
20200312,051908,國泰金元大96購02,0.20,0.21,0.20,0.21,-0.08,-27.59,100000,2,20500,0,0,0,0,0,0,0,100000,-100000,-100000
20200312,051909,潤泰全元大95購02,,,,,0.00,0.00,0,0,0,0,0,0,0,0,0,0,0,0,0
20200312,05190P,鴻海國票96售02,,,,,0.00,0.00,0,0,0,0,0,0,0,0,0,0,0,0,0
20200312,051910,大立光元大97購01,0.39,0.39,0.28,0.28,-0.34,-54.84,92000,5,32220,0,0,0,0,0,0,0,92000,-92000,-92000
20200312,051911,大立光元大98購02,0.80,0.80,0.62,0.62,-0.45,-42.06,1182000,58,823960,0,0,0,0,0,0,146000,1067000,-921000,-921000
20200312,051912,健鼎元大96購01,,,,,0.00,0.00,0,0,0,0,0,0,0,0,0,0,0,0,0
20200312,051913,緯創元大96購01,,,,,0.00,0.00,0,0,0,0,0,0,0,0,0,0,0,0,0
20200312,051914,健策元大96購06,1.92,1.92,1.37,1.37,-1.59,-53.72,59000,6,110050,0,0,0,0,0,0,0,59000,-59000,-59000
20200312,051915,日月光元大96購01,0.20,0.20,0.20,0.20,-0.20,-50.0,25000,1,5000,0,0,0,0,0,0,0,0,0,0
20200312,051916,和碩元大95購02,0.18,0.18,0.13,0.13,-0.10,-43.48,2296000,9,356390,0,0,0,0,0,0,2289000,0,2289000,2289000
20200312,051917,瑞儀元大95購01,,,,,0.00,0.00,0,0,0,0,0,0,0,0,0,0,0,0,0
20200312,051918,聯茂元大95購01,1.38,1.38,0.84,0.84,-0.63,-42.86,77000,11,86940,0,0,0,0,0,0,67000,32000,35000,35000
20200312,051919,台郡元大96購02,1.02,1.02,0.90,0.97,-0.64,-39.75,32000,7,31760,0,0,0,0,0,0,14000,22000,-8000,-8000
20200312,05191P,鴻海台新95售01,,,,,0.00,0.00,0,0,0,0,0,0,0,0,0,0,0,0,0
20200312,051920,南茂元大95購03,0.06,0.06,0.05,0.05,-0.05,-50.0,3077000,45,182620,0,0,0,0,0,0,2797000,220000,2577000,2577000
20200312,051921,南茂元大95購04,,,,,0.00,0.00,0,0,0,0,0,0,0,0,0,0,0,0,0
20200312,051922,鴻海亞東96購02,,,,,0.00,0.00,0,0,0,0,0,0,0,0,0,0,0,0,0
20200312,051923,聯發科日盛95購02,0.01,0.01,0.01,0.01,-0.02,-66.67,1607000,12,16070,0,0,0,0,0,0,714000,0,714000,714000
20200312,051924,聯茂日盛95購01,0.47,0.47,0.29,0.29,-0.31,-51.67,764000,19,276720,0,0,0,0,0,0,729000,35000,694000,694000
20200312,051925,瀚宇博第一95購01,,,,,0.00,0.00,0,0,0,0,0,0,0,0,0,0,0,0,0
20200312,051926,聯電中信97購01,0.35,0.35,0.31,0.31,-0.23,-42.59,112000,2,38720,0,0,0,0,0,0,112000,0,112000,112000
20200312,051927,國巨中信96購01,1.28,1.28,0.73,0.73,-0.62,-45.93,189000,20,202750,0,0,0,0,0,0,64000,125000,-61000,-61000
20200312,051928,大立光中信96購03,0.18,0.18,0.12,0.13,-0.22,-62.86,985000,16,136550,0,0,0,0,0,0,0,985000,-985000,-985000
20200312,051929,GIS中信96購01,,,,,0.00,0.00,0,0,0,0,0,0,0,0,0,0,0,0,0
20200312,05192P,玉晶光台新96售02,1.06,1.33,1.06,1.30,+0.43,49.43,118000,9,131680,0,0,0,0,0,0,53000,64000,-11000,-11000
20200312,051930,國泰金兆豐97購01,,,,,0.00,0.00,0,0,0,0,0,0,0,0,0,0,0,0,0
20200312,051931,美律國票96購02,0.97,0.97,0.56,0.60,-0.55,-47.83,474000,23,349960,0,0,0,0,0,0,66000,378000,-312000,-312000
20200312,051932,康控國票96購02,0.10,0.11,0.09,0.09,-0.14,-60.87,630000,8,63700,0,0,0,0,0,0,370000,260000,110000,110000
20200312,051933,嘉聯益國票97購03,,,,,0.00,0.00,0,0,0,0,0,0,0,0,0,0,0,0,0
20200312,051934,緯穎國票96購01,6.95,6.95,6.95,6.95,-2.15,-23.63,3000,1,20850,0,0,0,0,0,0,0,3000,-3000,-3000
20200312,051935,味全群益95購01,0.27,0.27,0.22,0.22,-0.17,-43.59,120000,3,31400,0,0,0,0,0,0,100000,20000,80000,80000
20200312,051936,力山群益95購02,,,,,0.00,0.00,0,0,0,0,0,0,0,0,0,0,0,0,0
20200312,051937,廣達群益95購01,0.60,0.60,0.59,0.59,-0.21,-26.25,139000,2,82730,0,0,0,0,0,0,67000,72000,-5000,-5000
20200312,051938,旭富群益95購01,2.52,2.52,1.61,1.62,-1.18,-42.14,175000,23,361400,0,0,0,0,0,0,121000,54000,67000,67000
20200312,051939,同欣電群益97購01,1.50,1.50,1.11,1.11,-0.59,-34.71,193000,5,253280,0,0,0,0,0,0,95000,98000,-3000,-3000
20200312,05193P,台郡台新95售01,0.60,0.60,0.60,0.60,0.00,0.00,40000,1,24000,0,0,0,0,0,0,0,40000,-40000,-40000
20200312,051940,康舒群益95購01,0.56,0.56,0.45,0.45,-0.26,-36.62,21000,2,10660,0,0,0,0,0,0,11000,10000,1000,1000
20200312,051941,樺漢群益95購02,,,,,0.00,0.00,0,0,0,0,0,0,0,0,0,0,0,0,0
20200312,051942,寶成群益95購01,,,,,0.00,0.00,0,0,0,0,0,0,0,0,0,0,0,0,0
20200312,051943,台積電麥證95購03,,,,,0.00,0.00,0,0,0,0,0,0,0,0,0,0,0,0,0
20200312,051944,智邦統一95購02,0.86,0.86,0.75,0.75,-0.26,-25.74,219000,20,171950,0,0,0,0,0,0,219000,0,219000,219000
20200312,051945,智邦統一95購03,0.78,0.78,0.55,0.55,-0.33,-37.5,90000,28,67050,0,0,0,0,0,0,90000,4000,86000,86000
20200312,051946,健策統一98購01,0.30,0.30,0.21,0.21,-0.18,-46.15,292000,10,83620,0,0,0,0,0,0,260000,32000,228000,228000
20200312,051947,矽力統一95購01,0.47,0.47,0.39,0.46,-0.22,-32.35,294000,22,129560,0,0,0,0,0,0,277000,0,277000,277000
20200312,051948,滬深2X元富9B購01,0.51,0.56,0.51,0.52,-0.21,-28.77,541000,7,292310,0,0,0,0,0,0,20000,501000,-481000,-481000
20200312,051949,鴻海元富95購08,,,,,0.00,0.00,0,0,0,0,0,0,0,0,0,0,0,0,0
20200312,05194P,玉晶光康和95售01,0.47,0.50,0.47,0.50,+0.11,28.21,45000,3,21600,0,0,0,0,0,0,45000,0,45000,45000
20200312,051950,旺宏元富95購02,2.03,2.03,1.56,1.57,-0.88,-35.92,126000,4,205320,0,0,0,0,0,0,106000,20000,86000,86000
20200312,051951,聯發科元富95購02,0.13,0.13,0.07,0.07,-0.11,-61.11,1010000,16,98200,0,0,0,0,0,0,540000,470000,70000,70000
20200312,051952,聯發科元富95購03,,,,,0.00,0.00,0,0,0,0,0,0,0,0,0,0,0,0,0
20200312,051953,矽力元富95購03,0.63,0.67,0.58,0.67,-0.14,-17.28,160000,22,97330,0,0,0,0,0,0,100000,60000,40000,40000
20200312,051954,矽力元富95購04,0.77,0.77,0.64,0.66,-0.42,-38.89,124000,35,86110,0,0,0,0,0,0,114000,10000,104000,104000
20200312,051955,寶成元富95購01,,,,,0.00,0.00,0,0,0,0,0,0,0,0,0,0,0,0,0
20200312,051956,滬深2X台新96購01,,,,,0.00,0.00,0,0,0,0,0,0,0,0,0,0,0,0,0
20200312,051957,旺宏台新95購02,1.57,1.66,1.08,1.12,-0.84,-42.86,485000,21,605120,0,0,0,0,0,0,244000,241000,3000,3000
20200312,051958,貿聯台新95購01,,,,,0.00,0.00,0,0,0,0,0,0,0,0,0,0,0,0,0
20200312,051959,台郡台新95購03,0.23,0.23,0.17,0.17,-0.22,-56.41,259000,27,50650,0,0,0,0,0,0,235000,24000,211000,211000
20200312,05195P,南茂康和95售01,,,,,0.00,0.00,0,0,0,0,0,0,0,0,0,0,0,0,0
20200312,051960,美食永豐95購01,,,,,0.00,0.00,0,0,0,0,0,0,0,0,0,0,0,0,0
20200312,051961,泰碩永豐95購01,0.27,0.27,0.20,0.24,-0.09,-27.27,431000,21,105670,0,0,0,0,0,0,199000,232000,-33000,-33000
20200312,051962,晶相光永豐95購02,0.76,0.76,0.62,0.62,-0.12,-16.22,75000,3,53300,0,0,0,0,0,0,70000,5000,65000,65000
20200312,051963,利勤永豐95購01,,,,,0.00,0.00,0,0,0,0,0,0,0,0,0,0,0,0,0
20200312,051965,傳奇永豐95購01,0.04,0.05,0.02,0.02,0.00,0.00,291000,30,7020,0,0,0,0,0,0,0,291000,-291000,-291000
20200312,051966,台表科永豐95購01,,,,,0.00,0.00,0,0,0,0,0,0,0,0,0,0,0,0,0
20200312,051967,康友永豐95購02,0.18,0.18,0.14,0.14,-0.17,-54.84,100000,2,16000,0,0,0,0,0,0,100000,0,100000,100000
20200312,051968,勤誠永豐95購01,0.21,0.21,0.21,0.21,0.00,0.00,15000,1,3150,0,0,0,0,0,0,15000,0,15000,15000
20200312,051969,世紀鋼永豐95購01,1.68,1.68,1.68,1.68,-0.28,-14.29,20000,1,33600,0,0,0,0,0,0,20000,0,20000,20000
20200312,05196P,台積電永豐95售03,0.85,1.18,0.85,0.97,+0.33,51.56,318000,18,284320,0,0,0,0,0,0,50000,268000,-218000,-218000
20200312,051970,元黃金凱基98購01,0.84,0.85,0.77,0.77,-0.15,-16.3,134000,10,105600,0,0,0,0,0,0,24000,110000,-86000,-86000
20200312,051971,元金2X凱基97購02,0.91,0.92,0.77,0.80,-0.28,-25.93,1565000,65,1271230,0,0,0,0,0,0,624000,791000,-167000,-167000
20200312,051972,廣達凱基95購02,,,,,0.00,0.00,0,0,0,0,0,0,0,0,0,0,0,0,0
20200312,051973,華新科凱基96購04,1.25,1.25,0.77,0.88,-0.60,-40.54,38000,6,39500,0,0,0,0,0,0,23000,25000,-2000,-2000
20200312,051974,華新科凱基96購05,0.54,0.54,0.52,0.52,-0.55,-51.4,50000,5,26200,0,0,0,0,0,0,0,50000,-50000,-50000
20200312,051975,美食凱基95購02,0.02,0.02,0.02,0.02,-0.01,-33.33,15000,1,300,0,0,0,0,0,0,0,0,0,0
20200312,051976,淘帝凱基95購01,,,,,0.00,0.00,0,0,0,0,0,0,0,0,0,0,0,0,0
20200312,051977,泰碩凱基95購01,0.16,0.16,0.10,0.13,-0.03,-18.75,391000,8,43960,0,0,0,0,0,0,341000,50000,291000,291000
20200312,051978,泰碩凱基96購01,0.17,0.19,0.17,0.17,-0.05,-22.73,99000,11,17080,0,0,0,0,0,0,3000,96000,-93000,-93000
20200312,051979,群創凱基97購01,0.51,0.51,0.51,0.51,-0.25,-32.89,2000,1,1020,0,0,0,0,0,0,0,2000,-2000,-2000
20200312,05197P,智原永豐95售02,,,,,0.00,0.00,0,0,0,0,0,0,0,0,0,0,0,0,0
20200312,051980,樺漢凱基96購01,0.13,0.13,0.10,0.10,0.00,0.00,20000,2,2300,0,0,0,0,0,0,0,20000,-20000,-20000
20200312,051981,南茂凱基96購01,,,,,0.00,0.00,0,0,0,0,0,0,0,0,0,0,0,0,0
20200312,051982,深中小元大95購01,,,,,0.00,0.00,0,0,0,0,0,0,0,0,0,0,0,0,0
20200312,051983,道瓊反元大95購01,1.85,2.30,1.85,2.12,+0.64,43.24,341000,9,732660,0,0,0,0,0,0,321000,100000,221000,221000
20200312,051984,台塑元大95購01,0.33,0.33,0.33,0.33,-0.21,-38.89,4000,1,1320,0,0,0,0,0,0,4000,4000,0,0
20200312,051985,智邦元大95購05,0.51,0.51,0.40,0.42,-0.21,-33.33,86000,4,36220,0,0,0,0,0,0,18000,76000,-58000,-58000
20200312,051986,燿華元大96購04,,,,,0.00,0.00,0,0,0,0,0,0,0,0,0,0,0,0,0
20200312,051987,廣達元大95購01,0.75,0.77,0.58,0.70,-0.25,-26.32,199000,5,136530,0,0,0,0,0,0,53000,176000,-123000,-123000
20200312,051988,台光電元大95購01,0.63,0.63,0.39,0.39,-0.30,-43.48,161000,9,92510,0,0,0,0,0,0,31000,156000,-125000,-125000
20200312,051989,華固元大95購02,0.64,0.72,0.63,0.72,+0.07,10.77,605000,8,388630,0,0,0,0,0,0,562000,43000,519000,519000
20200312,05198P,牧德永豐95售02,0.24,0.24,0.24,0.24,+0.05,26.32,346000,3,83040,0,0,0,0,0,0,346000,0,346000,346000
20200312,051990,泰碩元大95購01,,,,,0.00,0.00,0,0,0,0,0,0,0,0,0,0,0,0,0
20200312,051991,泰碩元大95購02,0.72,0.73,0.60,0.67,-0.23,-25.56,314000,15,203390,0,0,0,0,0,0,14000,300000,-286000,-286000
20200312,051993,和碩元大95購03,,,,,0.00,0.00,0,0,0,0,0,0,0,0,0,0,0,0,0
20200312,051994,瀚宇博元大96購01,0.38,0.38,0.38,0.38,-0.21,-35.59,5000,1,1900,0,0,0,0,0,0,5000,0,5000,5000
20200312,051995,矽力元大95購03,1.00,1.00,0.84,0.94,-0.55,-36.91,123000,17,111850,0,0,0,0,0,0,43000,78000,-35000,-35000
20200312,051996,康友元大95購01,0.50,0.50,0.32,0.32,-0.23,-41.82,14000,2,5200,0,0,0,0,0,0,14000,0,14000,14000
20200312,051997,康友元大95購02,0.43,0.43,0.31,0.31,-0.17,-35.42,311000,8,108580,0,0,0,0,0,0,201000,110000,91000,91000
20200312,051998,昇陽半元大96購02,,,,,0.00,0.00,0,0,0,0,0,0,0,0,0,0,0,0,0
20200312,051999,勤誠元大95購01,1.31,1.31,0.96,1.03,-0.41,-28.47,422000,16,483890,0,0,0,0,0,0,235000,187000,48000,48000
20200312,05199P,訊芯永豐95售02,1.33,1.37,1.31,1.37,+0.13,10.48,176000,6,234250,0,0,0,0,0,0,164000,12000,152000,152000
20200312,052000,鈺齊元大95購03,,,,,0.00,0.00,0,0,0,0,0,0,0,0,0,0,0,0,0
20200312,052001,寶成元大95購02,,,,,0.00,0.00,0,0,0,0,0,0,0,0,0,0,0,0,0
20200312,052002,滬深2X國泰96購01,,,,,0.00,0.00,0,0,0,0,0,0,0,0,0,0,0,0,0
20200312,052003,泰碩國泰97購02,1.19,1.20,0.91,1.04,-0.20,-16.13,1595000,50,1658550,0,0,0,0,0,0,1408000,379000,1029000,1029000
20200312,052004,泰碩國泰97購03,0.91,0.95,0.74,0.83,-0.17,-17.0,377000,12,336880,0,0,0,0,0,0,250000,131000,119000,119000
20200312,052005,矽力國泰97購02,2.14,2.14,1.71,1.93,-0.44,-18.57,353000,53,681330,0,0,0,0,0,0,211000,69000,142000,142000
20200312,052006,康友富邦98購01,0.46,0.49,0.44,0.48,-0.12,-20.0,400000,13,184130,0,0,0,0,0,0,324000,76000,248000,248000
20200312,052007,滬深2X第一95購01,,,,,0.00,0.00,0,0,0,0,0,0,0,0,0,0,0,0,0
20200312,052008,創意第一95購01,,,,,0.00,0.00,0,0,0,0,0,0,0,0,0,0,0,0,0
20200312,052009,群創第一95購01,,,,,0.00,0.00,0,0,0,0,0,0,0,0,0,0,0,0,0
20200312,05200P,臺股指永豐95售03,3.78,3.80,3.78,3.80,0.00,0.00,10000,2,37900,0,0,0,0,0,0,10000,0,10000,10000
20200312,052010,兆豐金中信95購01,1.17,1.17,0.98,0.98,-0.33,-25.19,202000,18,210350,0,0,0,0,0,0,34000,168000,-134000,-134000
20200312,052011,欣興中信96購01,0.05,0.05,0.03,0.03,-0.04,-57.14,600000,37,23000,0,0,0,0,0,0,0,440000,-440000,-440000
20200312,052012,聯發科台新95購02,,,,,0.00,0.00,0,0,0,0,0,0,0,0,0,0,0,0,0
20200312,052013,台積電永豐95購04,0.02,0.05,0.02,0.05,0.00,0.00,138000,12,3790,0,0,0,0,0,0,0,101000,-101000,-101000
20200312,052014,光罩永豐95購01,,,,,0.00,0.00,0,0,0,0,0,0,0,0,0,0,0,0,0
20200312,052015,漢唐永豐95購02,,,,,0.00,0.00,0,0,0,0,0,0,0,0,0,0,0,0,0
20200312,052016,神基永豐95購01,0.93,1.03,0.93,1.03,-0.09,-8.04,26000,4,25890,0,0,0,0,0,0,14000,12000,2000,2000
20200312,052017,奇鋐永豐95購01,0.24,0.24,0.18,0.18,-0.24,-57.14,20000,3,4300,0,0,0,0,0,0,10000,10000,0,0
20200312,052018,京鼎永豐95購02,,,,,0.00,0.00,0,0,0,0,0,0,0,0,0,0,0,0,0
20200312,052019,創意永豐95購02,,,,,0.00,0.00,0,0,0,0,0,0,0,0,0,0,0,0,0
20200312,05201P,玉晶光國泰97售02,0.81,0.95,0.80,0.94,+0.19,25.33,756000,20,637850,0,0,0,0,0,0,478000,278000,200000,200000
20200312,052020,聯茂永豐95購02,0.90,0.90,0.62,0.62,-0.37,-37.37,60000,5,44890,0,0,0,0,0,0,3000,57000,-54000,-54000
20200312,052021,易華電永豐95購03,,,,,0.00,0.00,0,0,0,0,0,0,0,0,0,0,0,0,0
20200312,052022,南電永豐95購03,0.13,0.13,0.11,0.11,-0.15,-57.69,2164000,10,269680,0,0,0,0,0,0,1964000,120000,1844000,1844000
20200312,052023,鈺齊永豐95購02,,,,,0.00,0.00,0,0,0,0,0,0,0,0,0,0,0,0,0
20200312,052024,臺股指永豐95購04,,,,,0.00,0.00,0,0,0,0,0,0,0,0,0,0,0,0,0
20200312,052025,國巨群益96購01,4.03,4.03,4.03,4.03,+0.05,1.26,20000,2,80600,0,0,0,0,0,0,20000,0,20000,20000
20200312,052026,漢唐群益95購01,1.23,1.23,1.00,1.00,-0.39,-28.06,80000,8,86700,0,0,0,0,0,0,30000,60000,-30000,-30000
20200312,052027,智原群益95購01,,,,,0.00,0.00,0,0,0,0,0,0,0,0,0,0,0,0,0
20200312,052028,健策群益95購02,0.57,0.57,0.57,0.57,-0.21,-26.92,73000,1,41610,0,0,0,0,0,0,73000,0,73000,73000
20200312,052029,矽力群益95購02,1.18,1.18,1.00,1.06,-0.38,-26.39,58000,19,64010,0,0,0,0,0,0,53000,23000,30000,30000
20200312,05202P,鴻海元大95售16,4.26,4.26,4.26,4.26,0.00,0.00,10000,1,42600,0,0,0,0,0,0,0,10000,-10000,-10000
20200312,052030,GIS群益95購04,,,,,0.00,0.00,0,0,0,0,0,0,0,0,0,0,0,0,0
20200312,052031,臺股指群益95購04,,,,,0.00,0.00,0,0,0,0,0,0,0,0,0,0,0,0,0
20200312,052032,臺股指群益95購05,0.29,0.29,0.10,0.12,-0.37,-75.51,539000,14,68590,0,0,0,0,0,0,465000,0,465000,465000
20200312,052033,臺股指群益95購06,,,,,0.00,0.00,0,0,0,0,0,0,0,0,0,0,0,0,0
20200312,052034,臺股指群益95購07,0.03,0.03,0.03,0.03,0.00,0.00,12000,1,360,0,0,0,0,0,0,12000,0,12000,12000
20200312,052035,臺股指群益95購08,0.05,0.05,0.05,0.05,-0.19,-79.17,9000,1,450,0,0,0,0,0,0,0,0,0,0
20200312,052036,臺股指群益95購09,,,,,0.00,0.00,0,0,0,0,0,0,0,0,0,0,0,0,0
20200312,052037,全新國泰96購02,,,,,0.00,0.00,0,0,0,0,0,0,0,0,0,0,0,0,0
20200312,052038,國巨永昌96購01,3.66,4.20,3.41,3.41,-2.49,-42.2,10000,6,37010,0,0,0,0,0,0,2000,8000,-6000,-6000
20200312,052039,聯詠永昌96購01,,,,,0.00,0.00,0,0,0,0,0,0,0,0,0,0,0,0,0
20200312,05203P,華新科元大95售10,0.75,0.75,0.75,0.75,+0.27,56.25,229000,1,171750,0,0,0,0,0,0,229000,0,229000,229000
20200312,052040,臺股指永昌95購01,,,,,0.00,0.00,0,0,0,0,0,0,0,0,0,0,0,0,0
20200312,052041,鴻海日盛95購02,0.01,0.01,0.01,0.01,0.00,0.00,785000,11,7850,0,0,0,0,0,0,0,0,0,0
20200312,052042,台積電日盛95購02,0.73,0.73,0.48,0.60,-0.29,-32.58,2193000,66,1291850,0,0,0,0,0,0,615000,1603000,-988000,-988000
20200312,052043,瑞昱日盛95購01,0.08,0.08,0.08,0.08,-0.19,-70.37,20000,1,1600,0,0,0,0,0,0,20000,0,20000,20000
20200312,052044,華通凱基97購01,0.06,0.06,0.06,0.06,0.00,0.00,42000,3,2520,0,0,0,0,0,0,0,0,0,0
20200312,052045,瑞昱凱基96購01,,,,,0.00,0.00,0,0,0,0,0,0,0,0,0,0,0,0,0
20200312,052046,漢唐凱基96購01,,,,,0.00,0.00,0,0,0,0,0,0,0,0,0,0,0,0,0
20200312,052047,建準凱基96購01,,,,,0.00,0.00,0,0,0,0,0,0,0,0,0,0,0,0,0
20200312,052048,景碩凱基95購01,0.12,0.12,0.12,0.12,-0.10,-45.45,40000,1,4800,0,0,0,0,0,0,40000,0,40000,40000
20200312,052049,緯創凱基97購01,,,,,0.00,0.00,0,0,0,0,0,0,0,0,0,0,0,0,0
20200312,05204P,TPK元大95售03,1.16,1.25,1.16,1.25,+0.19,17.92,125000,3,154200,0,0,0,0,0,0,0,125000,-125000,-125000
20200312,052050,明泰凱基95購01,,,,,0.00,0.00,0,0,0,0,0,0,0,0,0,0,0,0,0
20200312,052051,京鼎凱基95購01,,,,,0.00,0.00,0,0,0,0,0,0,0,0,0,0,0,0,0
20200312,052052,嘉澤凱基95購02,,,,,0.00,0.00,0,0,0,0,0,0,0,0,0,0,0,0,0
20200312,052053,泰鼎凱基96購01,1.02,1.12,1.02,1.12,-0.29,-20.57,23000,3,24060,0,0,0,0,0,0,13000,10000,3000,3000
20200312,052054,台表科凱基96購01,,,,,0.00,0.00,0,0,0,0,0,0,0,0,0,0,0,0,0
20200312,052055,緯穎凱基95購03,2.43,2.43,2.08,2.08,-0.57,-21.51,20000,2,45800,0,0,0,0,0,0,20000,20000,0,0
20200312,052056,緯穎凱基95購04,2.79,2.79,2.79,2.79,-3.31,-54.26,1000,1,2790,0,0,0,0,0,0,0,1000,-1000,-1000
20200312,052057,臺股指凱基95購15,0.56,0.56,0.26,0.27,-0.59,-68.6,643000,29,184640,0,0,0,0,0,0,1000,517000,-516000,-516000
20200312,052058,臺股指凱基95購16,0.67,0.67,0.41,0.43,0.00,0.00,95000,12,42180,0,0,0,0,0,0,10000,85000,-75000,-75000
20200312,052059,臺股指凱基95購17,,,,,0.00,0.00,0,0,0,0,0,0,0,0,0,0,0,0,0
20200312,05205P,緯穎元大95售03,0.18,0.18,0.18,0.18,+0.04,28.57,220000,1,39600,0,0,0,0,0,0,220000,0,220000,220000
20200312,052060,旺宏國票96購02,1.42,1.44,0.94,1.03,-0.74,-41.81,276000,26,292240,0,0,0,0,0,0,42000,234000,-192000,-192000
20200312,052061,樺漢國票96購01,0.35,0.35,0.23,0.23,-0.27,-54.0,220000,4,56800,0,0,0,0,0,0,10000,210000,-200000,-200000
20200312,052062,臺股指國票95購09,0.60,0.61,0.60,0.61,-0.29,-32.22,15000,2,9100,0,0,0,0,0,0,0,15000,-15000,-15000
20200312,052063,臺股指國票95購10,,,,,0.00,0.00,0,0,0,0,0,0,0,0,0,0,0,0,0
20200312,052064,臺股指國票95購11,,,,,0.00,0.00,0,0,0,0,0,0,0,0,0,0,0,0,0
20200312,052065,臺股指國票95購12,,,,,0.00,0.00,0,0,0,0,0,0,0,0,0,0,0,0,0
20200312,052066,華邦電兆豐96購01,0.47,0.47,0.26,0.26,-0.28,-51.85,1297000,45,417870,0,0,0,0,0,0,450000,847000,-397000,-397000
20200312,052067,中磊兆豐96購01,0.55,0.57,0.50,0.50,-0.15,-23.08,107000,5,60160,0,0,0,0,0,0,100000,7000,93000,93000
20200312,052068,瑞儀兆豐96購01,,,,,0.00,0.00,0,0,0,0,0,0,0,0,0,0,0,0,0
20200312,052069,聯茂兆豐96購01,0.63,0.63,0.44,0.44,-0.37,-45.68,422000,8,242360,0,0,0,0,0,0,308000,114000,194000,194000
20200312,05206P,南茂元大95售01,2.92,3.05,2.81,3.05,+0.41,15.53,313000,17,914060,0,0,0,0,0,0,240000,73000,167000,167000
20200312,052070,GIS兆豐95購03,0.14,0.14,0.14,0.14,0.00,0.00,58000,1,8120,0,0,0,0,0,0,58000,0,58000,58000
20200312,052071,臺股指兆豐95購01,,,,,0.00,0.00,0,0,0,0,0,0,0,0,0,0,0,0,0
20200312,052072,健策統一95購02,0.60,0.60,0.30,0.30,-0.46,-60.53,149000,14,48520,0,0,0,0,0,0,108000,15000,93000,93000
20200312,052073,矽力統一95購03,,,,,0.00,0.00,0,0,0,0,0,0,0,0,0,0,0,0,0
20200312,052074,鴻海元富95購10,,,,,0.00,0.00,0,0,0,0,0,0,0,0,0,0,0,0,0
20200312,052075,旺宏元富95購03,0.52,0.60,0.52,0.60,-0.42,-41.18,46000,2,25200,0,0,0,0,0,0,30000,16000,14000,14000
20200312,052076,可成元富98購01,0.72,0.75,0.54,0.54,-0.42,-43.75,72000,4,51080,0,0,0,0,0,0,40000,32000,8000,8000
20200312,052077,可成元富98購02,,,,,0.00,0.00,0,0,0,0,0,0,0,0,0,0,0,0,0
20200312,052078,大立光元富95購10,0.88,0.88,0.64,0.68,-0.92,-57.5,250000,8,207540,0,0,0,0,0,0,199000,55000,144000,144000
20200312,052079,康友元富98購01,1.61,1.65,1.35,1.36,-0.35,-20.47,120000,12,183640,0,0,0,0,0,0,96000,24000,72000,72000
20200312,05207P,高股息中信97售03,1.47,1.47,1.47,1.47,0.00,0.00,1000,1,1470,0,0,0,0,0,0,1000,0,1000,1000
20200312,052080,康友元富98購02,1.45,1.45,1.20,1.20,-0.41,-25.47,78000,8,107890,0,0,0,0,0,0,26000,42000,-16000,-16000
20200312,052081,臺股指元富95購03,,,,,0.00,0.00,0,0,0,0,0,0,0,0,0,0,0,0,0
20200312,052082,臺股指元富95購04,,,,,0.00,0.00,0,0,0,0,0,0,0,0,0,0,0,0,0
20200312,052083,S&P反1元大97購02,0.81,1.11,0.81,1.04,+0.34,48.57,1427000,15,1265120,0,0,0,0,0,0,1008000,419000,589000,589000
20200312,052084,台泥元大95購01,0.98,0.98,0.72,0.89,-0.21,-19.09,795000,13,679340,0,0,0,0,0,0,34000,768000,-734000,-734000
20200312,052085,聯電元大95購01,0.38,0.38,0.25,0.25,-0.24,-48.98,27000,6,9180,0,0,0,0,0,0,27000,0,27000,27000
20200312,052086,鴻海元大96購08,0.14,0.14,0.14,0.14,0.00,0.00,110000,1,15400,0,0,0,0,0,0,110000,0,110000,110000
20200312,052087,鴻海元大96購09,0.09,0.09,0.09,0.09,0.00,0.00,101000,2,9090,0,0,0,0,0,0,0,101000,-101000,-101000
20200312,052088,漢唐元大95購02,0.46,0.46,0.46,0.46,0.00,0.00,68000,1,31280,0,0,0,0,0,0,0,68000,-68000,-68000
20200312,052089,聯發科元大96購02,,,,,0.00,0.00,0,0,0,0,0,0,0,0,0,0,0,0,0
20200312,05208P,TPK中信95售01,1.42,1.59,1.42,1.59,0.00,0.00,23000,3,33870,0,0,0,0,0,0,3000,20000,-17000,-17000
20200312,052090,聯發科元大97購03,0.15,0.15,0.12,0.13,-0.14,-51.85,45000,5,6300,0,0,0,0,0,0,20000,25000,-5000,-5000
20200312,052091,緯創元大95購04,0.07,0.07,0.07,0.07,-0.14,-66.67,100000,1,7000,0,0,0,0,0,0,0,100000,-100000,-100000
20200312,052092,貿聯元大96購02,0.31,0.31,0.26,0.26,-0.12,-31.58,80000,3,23300,0,0,0,0,0,0,0,80000,-80000,-80000
20200312,052093,麗豐元大96購04,,,,,0.00,0.00,0,0,0,0,0,0,0,0,0,0,0,0,0
20200312,052094,瀚宇博元大96購02,0.39,0.39,0.35,0.36,-0.10,-21.74,200000,11,72900,0,0,0,0,0,0,200000,0,200000,200000
20200312,052095,彩晶元大97購01,0.74,0.74,0.74,0.74,-0.19,-20.43,13000,1,9620,0,0,0,0,0,0,13000,0,13000,13000
20200312,052096,力成元大95購01,0.99,0.99,0.89,0.98,-0.80,-44.94,139000,4,131780,0,0,0,0,0,0,71000,71000,0,0
20200312,052097,GIS元大95購05,0.19,0.19,0.19,0.19,-0.25,-56.82,10000,1,1900,0,0,0,0,0,0,10000,0,10000,10000
20200312,052098,臺股指富邦95購01,,,,,0.00,0.00,0,0,0,0,0,0,0,0,0,0,0,0,0
20200312,052099,臺股指富邦95購02,0.04,0.04,0.04,0.04,0.00,0.00,100000,1,4000,0,0,0,0,0,0,0,0,0,0
20200312,05209P,鴻海凱基96售09,0.80,1.29,0.80,1.29,+0.51,65.38,160000,8,188950,0,0,0,0,0,0,145000,100000,45000,45000
20200312,052100,滬深2X永昌96購01,,,,,0.00,0.00,0,0,0,0,0,0,0,0,0,0,0,0,0
20200312,052101,滬深2X兆豐96購01,0.43,0.43,0.41,0.42,0.00,0.00,361000,5,151220,0,0,0,0,0,0,301000,60000,241000,241000
20200312,052102,台泥兆豐96購01,0.58,0.58,0.50,0.53,-0.07,-11.67,63000,3,33800,0,0,0,0,0,0,13000,50000,-37000,-37000
20200312,052103,台積電兆豐95購06,0.11,0.18,0.10,0.18,-0.03,-14.29,911000,29,121690,0,0,0,0,0,0,851000,861000,-10000,-10000
20200312,052104,英業達兆豐96購01,0.56,0.56,0.54,0.54,-0.18,-25.0,130000,2,72500,0,0,0,0,0,0,15000,115000,-100000,-100000
20200312,052105,南亞科兆豐95購01,0.42,0.42,0.42,0.42,-0.54,-56.25,50000,1,21000,0,0,0,0,0,0,0,50000,-50000,-50000
20200312,052106,明泰兆豐95購01,0.24,0.24,0.24,0.24,-0.12,-33.33,10000,1,2400,0,0,0,0,0,0,10000,0,10000,10000
20200312,052107,台積電統一95購06,0.54,0.56,0.37,0.56,-0.09,-13.85,1322000,16,676720,0,0,0,0,0,0,243000,1079000,-836000,-836000
20200312,052108,鴻海元富95購11,,,,,0.00,0.00,0,0,0,0,0,0,0,0,0,0,0,0,0
20200312,052109,可成元富95購01,,,,,0.00,0.00,0,0,0,0,0,0,0,0,0,0,0,0,0
20200312,05210P,台積電凱基95售15,,,,,0.00,0.00,0,0,0,0,0,0,0,0,0,0,0,0,0
20200312,052110,可成元富95購02,,,,,0.00,0.00,0,0,0,0,0,0,0,0,0,0,0,0,0
20200312,052111,智原元富95購01,,,,,0.00,0.00,0,0,0,0,0,0,0,0,0,0,0,0,0
20200312,052112,滬深2X中信99購01,,,,,0.00,0.00,0,0,0,0,0,0,0,0,0,0,0,0,0
20200312,052113,漢唐中信98購01,0.36,0.36,0.31,0.31,-0.09,-22.5,130000,5,41730,0,0,0,0,0,0,130000,0,130000,130000
20200312,052114,華固中信95購01,0.06,0.07,0.05,0.07,-0.07,-50.0,2405000,24,136690,0,0,0,0,0,0,2135000,230000,1905000,1905000
20200312,052115,T50反1國票95購03,1.58,1.83,1.58,1.83,+0.45,32.61,97000,6,166830,0,0,0,0,0,0,50000,20000,30000,30000
20200312,052116,T50反1國票97購01,1.22,1.22,1.15,1.17,+0.42,56.0,832000,9,966530,0,0,0,0,0,0,832000,0,832000,832000
20200312,052117,鴻海國票96購03,,,,,0.00,0.00,0,0,0,0,0,0,0,0,0,0,0,0,0
20200312,052118,鴻海國票96購04,,,,,0.00,0.00,0,0,0,0,0,0,0,0,0,0,0,0,0
20200312,052119,漢唐國票96購01,0.81,0.81,0.71,0.73,-0.26,-26.26,55000,5,39950,0,0,0,0,0,0,25000,35000,-10000,-10000
20200312,05211P,國巨國票96售05,0.12,0.21,0.12,0.18,+0.06,50.0,955000,8,173100,0,0,0,0,0,0,650000,305000,345000,345000
20200312,052120,友達國票96購01,0.75,0.75,0.75,0.75,-0.27,-26.47,24000,1,18000,0,0,0,0,0,0,24000,0,24000,24000
20200312,052121,全新國票96購03,,,,,0.00,0.00,0,0,0,0,0,0,0,0,0,0,0,0,0
20200312,052122,新光金國票96購01,,,,,0.00,0.00,0,0,0,0,0,0,0,0,0,0,0,0,0
20200312,052123,泰碩國票95購01,0.34,0.34,0.19,0.25,-0.15,-37.5,304000,14,74200,0,0,0,0,0,0,70000,234000,-164000,-164000
20200312,052124,京鼎國票95購01,0.33,0.33,0.25,0.25,-0.20,-44.44,104000,2,31920,0,0,0,0,0,0,104000,0,104000,104000
20200312,052125,群創國票95購02,0.45,0.45,0.41,0.42,-0.25,-37.31,310000,7,135500,0,0,0,0,0,0,0,310000,-310000,-310000
20200312,052126,群創國票97購01,0.29,0.29,0.29,0.29,-0.30,-50.85,50000,1,14500,0,0,0,0,0,0,0,50000,-50000,-50000
20200312,052127,日月光國票96購01,0.03,0.03,0.03,0.03,0.00,0.00,199000,2,5970,0,0,0,0,0,0,0,199000,-199000,-199000
20200312,052128,聯發科日盛95購03,,,,,0.00,0.00,0,0,0,0,0,0,0,0,0,0,0,0,0
20200312,052129,鴻海凱基97購02,,,,,0.00,0.00,0,0,0,0,0,0,0,0,0,0,0,0,0
20200312,05212P,台積電國票96售04,2.28,2.67,2.28,2.67,+0.58,27.75,66000,9,155330,0,0,0,0,0,0,56000,20000,36000,36000
20200312,052130,國巨凱基9B購01,1.91,1.95,1.41,1.41,-0.66,-31.88,919000,95,1534320,0,0,0,0,0,0,556000,357000,199000,199000
20200312,052131,台積電凱基96購01,0.10,0.10,0.06,0.06,-0.04,-40.0,200000,20,14800,0,0,0,0,0,0,0,25000,-25000,-25000
20200312,052132,旺宏凱基9B購01,1.16,1.16,0.88,0.90,-0.42,-31.82,66000,14,62690,0,0,0,0,0,0,32000,34000,-2000,-2000
20200312,052133,華邦電凱基9B購01,0.53,0.53,0.37,0.37,-0.26,-41.27,150000,6,65430,0,0,0,0,0,0,50000,100000,-50000,-50000
20200312,052134,智邦凱基95購09,0.90,0.94,0.60,0.62,-0.32,-34.04,146000,11,122510,0,0,0,0,0,0,75000,61000,14000,14000
20200312,052135,聯發科凱基9B購01,0.45,0.45,0.31,0.31,-0.21,-40.38,943000,101,366940,0,0,0,0,0,0,39000,888000,-849000,-849000
20200312,052136,瑞儀凱基95購01,,,,,0.00,0.00,0,0,0,0,0,0,0,0,0,0,0,0,0
20200312,052137,台表科凱基96購02,0.10,0.10,0.10,0.10,-0.15,-60.0,10000,1,1000,0,0,0,0,0,0,10000,0,10000,10000
20200312,052138,易華電凱基97購01,,,,,0.00,0.00,0,0,0,0,0,0,0,0,0,0,0,0,0
20200312,052139,矽創凱基95購01,,,,,0.00,0.00,0,0,0,0,0,0,0,0,0,0,0,0,0
20200312,05213P,台積電國票96售05,1.45,1.45,1.45,1.45,+0.51,54.26,28000,2,40600,0,0,0,0,0,0,28000,0,28000,28000
20200312,052140,鈺齊凱基95購02,,,,,0.00,0.00,0,0,0,0,0,0,0,0,0,0,0,0,0
20200312,052141,百和凱基95購02,,,,,0.00,0.00,0,0,0,0,0,0,0,0,0,0,0,0,0
20200312,052142,滬深2X群益99購04,,,,,0.00,0.00,0,0,0,0,0,0,0,0,0,0,0,0,0
20200312,052143,鴻海群益95購09,,,,,0.00,0.00,0,0,0,0,0,0,0,0,0,0,0,0,0
20200312,052144,鴻海群益95購10,,,,,0.00,0.00,0,0,0,0,0,0,0,0,0,0,0,0,0
20200312,052145,京元電群益95購02,0.08,0.08,0.08,0.08,-0.11,-57.89,20000,2,1600,0,0,0,0,0,0,0,20000,-20000,-20000
20200312,052146,泰碩群益95購01,0.68,0.68,0.59,0.59,-0.21,-26.25,112000,4,71420,0,0,0,0,0,0,112000,0,112000,112000
20200312,052147,上緯控群益95購01,,,,,0.00,0.00,0,0,0,0,0,0,0,0,0,0,0,0,0
20200312,052148,康友群益95購03,0.61,0.61,0.56,0.56,-0.36,-39.13,78000,2,44230,0,0,0,0,0,0,11000,67000,-56000,-56000
20200312,052149,電子類群益95購01,,,,,0.00,0.00,0,0,0,0,0,0,0,0,0,0,0,0,0
20200312,05214P,台積電國票97售02,0.25,0.40,0.23,0.40,+0.23,135.29,11000,3,2800,0,0,0,0,0,0,10000,1000,9000,9000
20200312,052150,台積電富邦95購07,0.10,0.10,0.05,0.08,-0.04,-33.33,4918000,136,339610,0,0,0,0,0,0,0,20000,-20000,-20000
20200312,052151,義隆富邦96購01,,,,,0.00,0.00,0,0,0,0,0,0,0,0,0,0,0,0,0
20200312,052152,創意富邦98購01,0.14,0.14,0.14,0.14,-0.12,-46.15,200000,2,28000,0,0,0,0,0,0,0,200000,-200000,-200000
20200312,052153,GIS富邦96購02,0.11,0.11,0.10,0.10,0.00,0.00,30000,2,3150,0,0,0,0,0,0,0,30000,-30000,-30000
20200312,052154,緯創台新95購01,,,,,0.00,0.00,0,0,0,0,0,0,0,0,0,0,0,0,0
20200312,052155,百和台新95購01,,,,,0.00,0.00,0,0,0,0,0,0,0,0,0,0,0,0,0
20200312,052156,滬深2X永豐95購03,,,,,0.00,0.00,0,0,0,0,0,0,0,0,0,0,0,0,0
20200312,052157,東元永豐95購01,,,,,0.00,0.00,0,0,0,0,0,0,0,0,0,0,0,0,0
20200312,052158,華泰永豐95購01,,,,,0.00,0.00,0,0,0,0,0,0,0,0,0,0,0,0,0
20200312,052159,瑞昱永豐95購01,0.44,0.44,0.35,0.35,0.00,0.00,48000,2,17700,0,0,0,0,0,0,0,48000,-48000,-48000
20200312,05215P,台積電台新95售03,0.57,0.86,0.57,0.68,+0.22,47.83,112000,9,76230,0,0,0,0,0,0,1000,111000,-110000,-110000
20200312,052160,美律永豐95購03,,,,,0.00,0.00,0,0,0,0,0,0,0,0,0,0,0,0,0
20200312,052161,義隆永豐95購03,,,,,0.00,0.00,0,0,0,0,0,0,0,0,0,0,0,0,0
20200312,052162,智伸科永豐95購01,,,,,0.00,0.00,0,0,0,0,0,0,0,0,0,0,0,0,0
20200312,052163,康舒永豐95購02,0.30,0.30,0.30,0.30,-0.17,-36.17,120000,2,36000,0,0,0,0,0,0,120000,0,120000,120000
20200312,052164,啟碁永豐95購01,,,,,0.00,0.00,0,0,0,0,0,0,0,0,0,0,0,0,0
20200312,052165,訊芯永豐95購03,,,,,0.00,0.00,0,0,0,0,0,0,0,0,0,0,0,0,0
20200312,052166,元油反元大95購01,6.05,6.05,6.05,6.05,0.00,0.00,23000,1,139150,0,0,0,0,0,0,0,23000,-23000,-23000
20200312,052167,亞泥元大96購01,0.89,0.95,0.78,0.79,-0.15,-15.96,207000,12,169380,0,0,0,0,0,0,85000,112000,-27000,-27000
20200312,052168,鴻海元大96購10,,,,,0.00,0.00,0,0,0,0,0,0,0,0,0,0,0,0,0
20200312,052169,鴻海元大97購02,,,,,0.00,0.00,0,0,0,0,0,0,0,0,0,0,0,0,0
20200312,05216P,國巨永豐95售02,,,,,0.00,0.00,0,0,0,0,0,0,0,0,0,0,0,0,0
20200312,052170,台積電元大95購20,0.44,0.44,0.22,0.22,-0.38,-63.33,265000,6,77980,0,0,0,0,0,0,225000,30000,195000,195000
20200312,052171,台積電元大95購21,0.69,0.69,0.40,0.55,-0.33,-37.5,215000,9,119760,0,0,0,0,0,0,165000,89000,76000,76000
20200312,052172,致茂元大95購01,0.71,0.71,0.47,0.47,-0.47,-50.0,355000,6,197940,0,0,0,0,0,0,105000,250000,-145000,-145000
20200312,052173,廣達元大95購02,0.37,0.37,0.29,0.32,-0.20,-38.46,263000,6,85130,0,0,0,0,0,0,65000,198000,-133000,-133000
20200312,052174,聯發科元大95購13,,,,,0.00,0.00,0,0,0,0,0,0,0,0,0,0,0,0,0
20200312,052175,可成元大95購10,,,,,0.00,0.00,0,0,0,0,0,0,0,0,0,0,0,0,0
20200312,052176,景碩元大96購01,0.26,0.26,0.17,0.17,-0.16,-48.48,370000,2,94400,0,0,0,0,0,0,350000,20000,330000,330000
20200312,052177,京鼎元大95購02,0.25,0.26,0.17,0.17,-0.25,-59.52,305000,8,65850,0,0,0,0,0,0,105000,200000,-95000,-95000
20200312,052178,台郡元大96購03,,,,,0.00,0.00,0,0,0,0,0,0,0,0,0,0,0,0,0
20200312,052179,康友元大95購03,0.60,0.60,0.44,0.44,-0.22,-33.33,268000,10,142050,0,0,0,0,0,0,174000,94000,80000,80000
20200312,05217P,鴻海統一95售08,4.13,4.13,4.13,4.13,0.00,0.00,38000,2,156940,0,0,0,0,0,0,20000,38000,-18000,-18000
20200312,052180,緯穎元大96購05,2.85,2.85,2.02,2.02,-0.93,-31.53,33000,7,87790,0,0,0,0,0,0,21000,12000,9000,9000
20200312,052181,南茂元大95購05,0.13,0.13,0.13,0.13,-0.07,-35.0,20000,2,2600,0,0,0,0,0,0,10000,10000,0,0
20200312,052182,鴻海群益96購01,,,,,0.00,0.00,0,0,0,0,0,0,0,0,0,0,0,0,0
20200312,052183,華邦電群益95購01,,,,,0.00,0.00,0,0,0,0,0,0,0,0,0,0,0,0,0
20200312,052184,台光電群益95購03,1.11,1.11,0.74,0.74,-0.51,-40.8,216000,13,186980,0,0,0,0,0,0,51000,171000,-120000,-120000
20200312,052185,奇力新群益95購03,0.84,0.84,0.50,0.50,-0.47,-48.45,126000,18,89950,0,0,0,0,0,0,126000,0,126000,126000
20200312,052186,宏達電群益95購04,,,,,0.00,0.00,0,0,0,0,0,0,0,0,0,0,0,0,0
20200312,052187,奇鋐群益95購03,,,,,0.00,0.00,0,0,0,0,0,0,0,0,0,0,0,0,0
20200312,052188,欣興群益95購03,,,,,0.00,0.00,0,0,0,0,0,0,0,0,0,0,0,0,0
20200312,052189,玉晶光群益96購06,1.50,1.50,1.50,1.50,0.00,0.00,1000,1,1500,0,0,0,0,0,0,1000,1000,0,0
20200312,05218P,大立光永昌96售04,4.38,4.95,4.38,4.95,+1.38,38.66,189000,11,874330,0,0,0,0,0,0,149000,40000,109000,109000
20200312,052190,創意群益95購03,,,,,0.00,0.00,0,0,0,0,0,0,0,0,0,0,0,0,0
20200312,052191,超眾群益96購01,1.84,1.84,1.65,1.65,-1.48,-47.28,19000,2,33060,0,0,0,0,0,0,0,19000,-19000,-19000
20200312,052192,SP黃豆元富95購04,0.20,0.20,0.20,0.20,-0.07,-25.93,16000,2,3200,0,0,0,0,0,0,6000,10000,-4000,-4000
20200312,052193,國巨元富95購06,1.77,1.77,1.20,1.20,-0.91,-43.13,70000,10,93150,0,0,0,0,0,0,0,70000,-70000,-70000
20200312,052194,旺宏元富95購04,,,,,0.00,0.00,0,0,0,0,0,0,0,0,0,0,0,0,0
20200312,052195,健策元富95購01,1.07,1.10,0.98,0.98,-0.37,-27.41,60000,4,63900,0,0,0,0,0,0,30000,30000,0,0
20200312,052196,TPK元富95購01,,,,,0.00,0.00,0,0,0,0,0,0,0,0,0,0,0,0,0
20200312,052197,台郡元富95購03,0.08,0.08,0.07,0.07,-0.07,-50.0,65000,18,4860,0,0,0,0,0,0,65000,0,65000,65000
20200312,052198,鴻海統一95購10,,,,,0.00,0.00,0,0,0,0,0,0,0,0,0,0,0,0,0
20200312,052199,鴻海統一95購11,,,,,0.00,0.00,0,0,0,0,0,0,0,0,0,0,0,0,0
20200312,05219P,鴻海元大95售17,6.10,7.25,6.10,7.20,+2.10,41.18,584000,24,4049050,0,0,0,0,0,0,455000,583000,-128000,-128000
20200312,052200,台光電統一95購02,1.56,1.56,1.24,1.24,-0.58,-31.87,110000,9,152400,0,0,0,0,0,0,50000,60000,-10000,-10000
20200312,052201,超眾統一96購01,1.81,1.87,1.47,1.47,-0.88,-37.45,86000,5,150380,0,0,0,0,0,0,48000,58000,-10000,-10000
20200312,052202,矽力統一96購01,1.40,1.40,1.40,1.40,0.00,0.00,3000,2,4200,0,0,0,0,0,0,2000,1000,1000,1000
20200312,052203,T50反1中信99購03,1.25,1.55,1.25,1.52,+0.39,34.51,135000,6,179550,0,0,0,0,0,0,0,135000,-135000,-135000
20200312,052204,台泥中信96購01,,,,,0.00,0.00,0,0,0,0,0,0,0,0,0,0,0,0,0
20200312,052205,台積電中信95購09,0.17,0.18,0.13,0.15,-0.16,-51.61,175000,8,28690,0,0,0,0,0,0,100000,75000,25000,25000
20200312,052206,燿華中信95購02,0.10,0.10,0.06,0.06,0.00,0.00,104000,6,7340,0,0,0,0,0,0,54000,50000,4000,4000
20200312,052207,台郡中信95購02,0.32,0.32,0.19,0.19,-0.19,-50.0,189000,31,47180,0,0,0,0,0,0,169000,20000,149000,149000
20200312,052208,力成麥證95購01,0.32,0.32,0.32,0.32,-0.16,-33.33,10000,1,3200,10000,0,10000,0,0,0,10000,0,10000,10000
20200312,052209,深中小元大95購02,0.87,0.88,0.81,0.81,-0.37,-31.36,509000,35,428110,0,0,0,0,0,0,200000,309000,-109000,-109000
20200312,05220P,台積電元大95售16,1.34,1.57,1.34,1.54,+0.35,29.41,729000,30,1061560,0,0,0,0,0,0,709000,724000,-15000,-15000
20200312,052210,華夏元大95購01,0.31,0.31,0.31,0.31,-0.19,-38.0,40000,1,12400,0,0,0,0,0,0,40000,0,40000,40000
20200312,052211,台積電元大95購22,0.32,0.33,0.15,0.30,0.00,0.00,110000,11,34100,0,0,0,0,0,0,10000,100000,-90000,-90000
20200312,052212,可成元大95購11,,,,,0.00,0.00,0,0,0,0,0,0,0,0,0,0,0,0,0
20200312,052213,富邦金元大95購01,0.36,0.36,0.29,0.29,-0.18,-38.3,55000,3,18300,0,0,0,0,0,0,40000,15000,25000,25000
20200312,052214,智伸科元大96購01,,,,,0.00,0.00,0,0,0,0,0,0,0,0,0,0,0,0,0
20200312,052215,樺漢元大96購02,0.33,0.33,0.26,0.28,-0.24,-46.15,20000,3,5750,0,0,0,0,0,0,0,20000,-20000,-20000
20200312,052216,康友元大96購01,1.22,1.22,0.98,0.98,-0.29,-22.83,278000,24,305820,0,0,0,0,0,0,228000,78000,150000,150000
20200312,052217,台光電日盛95購01,0.38,0.38,0.24,0.24,-0.26,-52.0,82000,10,23530,0,0,0,0,0,0,12000,70000,-58000,-58000
20200312,052218,大立光日盛95購01,0.18,0.22,0.18,0.22,-0.49,-69.01,825000,5,165160,0,0,0,0,0,0,798000,825000,-27000,-27000
20200312,052219,大立光日盛95購02,,,,,0.00,0.00,0,0,0,0,0,0,0,0,0,0,0,0,0
20200312,05221P,玉晶光元大95售04,0.20,0.30,0.20,0.30,+0.09,42.86,362000,13,90400,0,0,0,0,0,0,246000,115000,131000,131000
20200312,052220,T50反1凱基98購01,,,,,0.00,0.00,0,0,0,0,0,0,0,0,0,0,0,0,0
20200312,052221,東元凱基95購01,,,,,0.00,0.00,0,0,0,0,0,0,0,0,0,0,0,0,0
20200312,052222,力山凱基95購02,,,,,0.00,0.00,0,0,0,0,0,0,0,0,0,0,0,0,0
20200312,052223,聯電凱基96購02,,,,,0.00,0.00,0,0,0,0,0,0,0,0,0,0,0,0,0
20200312,052224,楠梓電凱基97購01,0.47,0.47,0.34,0.34,-0.18,-34.62,282000,22,118690,0,0,0,0,0,0,199000,80000,119000,119000
20200312,052225,台積電凱基96購03,0.10,0.10,0.07,0.10,-0.03,-23.08,500000,29,43220,0,0,0,0,0,0,0,0,0,0
20200312,052226,旺宏凱基95購06,,,,,0.00,0.00,0,0,0,0,0,0,0,0,0,0,0,0,0
20200312,052227,瑞昱凱基95購05,0.24,0.24,0.24,0.24,-0.32,-57.14,410000,4,98400,0,0,0,0,0,0,10000,400000,-390000,-390000
20200312,052228,聯發科凱基96購06,0.10,0.10,0.06,0.06,-0.08,-57.14,310000,3,23000,0,0,0,0,0,0,0,110000,-110000,-110000
20200312,052229,奇力新凱基96購01,,,,,0.00,0.00,0,0,0,0,0,0,0,0,0,0,0,0,0
20200312,05222P,致伸凱基95售02,3.98,3.98,3.98,3.98,+0.82,25.95,1000,1,3980,0,0,0,0,0,0,1000,0,1000,1000
20200312,052230,大立光凱基96購09,,,,,0.00,0.00,0,0,0,0,0,0,0,0,0,0,0,0,0
20200312,052231,景碩凱基96購01,0.30,0.31,0.22,0.22,-0.28,-56.0,303000,3,93160,0,0,0,0,0,0,300000,3000,297000,297000
20200312,052232,貿聯凱基96購02,,,,,0.00,0.00,0,0,0,0,0,0,0,0,0,0,0,0,0
20200312,052233,台郡凱基96購01,0.07,0.07,0.05,0.05,-0.05,-50.0,242000,6,14130,0,0,0,0,0,0,212000,0,212000,212000
20200312,052234,GIS凱基97購01,,,,,0.00,0.00,0,0,0,0,0,0,0,0,0,0,0,0,0
20200312,052235,聯發科國票96購02,,,,,0.00,0.00,0,0,0,0,0,0,0,0,0,0,0,0,0
20200312,052236,聯發科國票96購03,,,,,0.00,0.00,0,0,0,0,0,0,0,0,0,0,0,0,0
20200312,052237,嘉澤國票96購02,0.88,0.88,0.88,0.88,0.00,0.00,10000,1,8800,0,0,0,0,0,0,0,10000,-10000,-10000
20200312,052238,智易國票96購01,,,,,0.00,0.00,0,0,0,0,0,0,0,0,0,0,0,0,0
20200312,052239,泰鼎國票97購01,1.42,1.42,1.34,1.34,-0.97,-41.99,700000,4,962000,0,0,0,0,0,0,300000,400000,-100000,-100000
20200312,05223P,臻鼎凱基95售02,3.20,3.34,3.20,3.34,+1.02,43.97,11000,2,36600,0,0,0,0,0,0,1000,10000,-9000,-9000
20200312,052240,臻鼎國票96購03,,,,,0.00,0.00,0,0,0,0,0,0,0,0,0,0,0,0,0
20200312,052241,台郡國票96購01,0.84,0.84,0.66,0.72,-0.51,-41.46,12000,7,9240,0,0,0,0,0,0,12000,0,12000,12000
20200312,052242,台達電台新96購01,0.47,0.52,0.40,0.42,-0.18,-30.0,218000,7,93300,0,0,0,0,0,0,90000,128000,-38000,-38000
20200312,052243,致茂康和95購01,0.28,0.29,0.21,0.21,-0.22,-51.16,465000,22,123500,0,0,0,0,0,0,465000,0,465000,465000
20200312,052244,廣達康和95購01,,,,,0.00,0.00,0,0,0,0,0,0,0,0,0,0,0,0,0
20200312,052245,緯創康和95購01,,,,,0.00,0.00,0,0,0,0,0,0,0,0,0,0,0,0,0
20200312,052246,超眾康和95購01,,,,,0.00,0.00,0,0,0,0,0,0,0,0,0,0,0,0,0
20200312,052247,深中小永豐95購01,,,,,0.00,0.00,0,0,0,0,0,0,0,0,0,0,0,0,0
20200312,052248,元油反永豐95購01,,,,,0.00,0.00,0,0,0,0,0,0,0,0,0,0,0,0,0
20200312,052249,大成鋼永豐95購01,0.62,0.65,0.59,0.59,-0.15,-20.27,117000,4,73220,0,0,0,0,0,0,93000,24000,69000,69000
20200312,05224P,華通統一95售03,2.97,3.56,2.97,3.56,0.00,0.00,32000,3,101600,0,0,0,0,0,0,0,32000,-32000,-32000
20200312,052250,光磊永豐95購01,0.16,0.16,0.16,0.16,0.00,0.00,12000,1,1920,0,0,0,0,0,0,12000,0,12000,12000
20200312,052251,台光電永豐95購03,,,,,0.00,0.00,0,0,0,0,0,0,0,0,0,0,0,0,0
20200312,052252,大立光永豐95購03,0.70,0.70,0.55,0.56,-0.82,-59.42,6000,3,3620,0,0,0,0,0,0,0,6000,-6000,-6000
20200312,052253,康控永豐95購04,,,,,0.00,0.00,0,0,0,0,0,0,0,0,0,0,0,0,0
20200312,052254,康友永豐95購03,0.84,0.84,0.63,0.65,-0.40,-38.1,82000,7,66620,0,0,0,0,0,0,82000,15000,67000,67000
20200312,052255,T50反1國泰96購01,,,,,0.00,0.00,0,0,0,0,0,0,0,0,0,0,0,0,0
20200312,052256,台泥國泰96購01,,,,,0.00,0.00,0,0,0,0,0,0,0,0,0,0,0,0,0
20200312,052257,燿華國泰96購01,,,,,0.00,0.00,0,0,0,0,0,0,0,0,0,0,0,0,0
20200312,052258,滬深2X富邦96購04,0.14,0.14,0.14,0.14,0.00,0.00,20000,1,2800,0,0,0,0,0,0,0,20000,-20000,-20000
20200312,052259,深100富邦95購01,0.46,0.46,0.46,0.46,0.00,0.00,10000,1,4600,0,0,0,0,0,0,0,10000,-10000,-10000
20200312,05225P,鴻海統一95售09,2.31,2.40,2.31,2.40,0.00,0.00,22000,2,51810,0,0,0,0,0,0,0,22000,-22000,-22000
20200312,052260,為升富邦97購02,0.14,0.14,0.14,0.14,-0.10,-41.67,10000,1,1400,0,0,0,0,0,0,0,0,0,0
20200312,052261,台泥第一95購01,,,,,0.00,0.00,0,0,0,0,0,0,0,0,0,0,0,0,0
20200312,052262,華新亞東95購02,,,,,0.00,0.00,0,0,0,0,0,0,0,0,0,0,0,0,0
20200312,052263,聯電亞東95購01,,,,,0.00,0.00,0,0,0,0,0,0,0,0,0,0,0,0,0
20200312,052264,台達電亞東96購01,0.42,0.42,0.42,0.42,-0.25,-37.31,76000,1,31920,0,0,0,0,0,0,76000,0,76000,76000
20200312,052265,聯發科亞東95購01,,,,,0.00,0.00,0,0,0,0,0,0,0,0,0,0,0,0,0
20200312,052266,義隆亞東95購02,,,,,0.00,0.00,0,0,0,0,0,0,0,0,0,0,0,0,0
20200312,052267,可成亞東95購02,,,,,0.00,0.00,0,0,0,0,0,0,0,0,0,0,0,0,0
20200312,052268,新光金亞東96購01,,,,,0.00,0.00,0,0,0,0,0,0,0,0,0,0,0,0,0
20200312,052269,T50反1日盛9B購01,1.00,1.26,0.94,1.26,+0.40,46.51,103000,8,110400,0,0,0,0,0,0,85000,17000,68000,68000
20200312,05226P,智邦統一95售01,1.41,1.47,1.41,1.47,0.00,0.00,56000,2,80640,0,0,0,0,0,0,0,56000,-56000,-56000
20200312,052270,力成日盛95購01,0.43,0.43,0.32,0.32,-0.28,-46.67,3000,2,1070,0,0,0,0,0,0,1000,2000,-1000,-1000
20200312,052271,力成日盛95購02,0.24,0.24,0.21,0.22,-0.21,-48.84,105000,51,24010,0,0,0,0,0,0,105000,0,105000,105000
20200312,052272,T50反1群益95購03,0.87,1.19,0.87,1.08,+0.45,71.43,204000,11,220630,0,0,0,0,0,0,110000,94000,16000,16000
20200312,052273,新光金群益95購02,0.08,0.08,0.08,0.08,0.00,0.00,77000,1,6160,0,0,0,0,0,0,0,77000,-77000,-77000
20200312,052274,大立光群益95購03,1.07,1.07,1.07,1.07,-0.92,-46.23,70000,2,74900,0,0,0,0,0,0,10000,60000,-50000,-50000
20200312,052275,日月光群益95購01,,,,,0.00,0.00,0,0,0,0,0,0,0,0,0,0,0,0,0
20200312,052276,力成群益96購01,1.99,1.99,1.46,1.46,-1.06,-42.06,66000,7,121480,0,0,0,0,0,0,45000,21000,24000,24000
20200312,052277,台達電凱基97購01,0.31,0.31,0.29,0.29,-0.10,-25.64,20000,2,6000,0,0,0,0,0,0,20000,0,20000,20000
20200312,052278,國巨凱基95購06,2.83,2.83,1.86,1.86,-1.39,-42.77,11000,2,21430,0,0,0,0,0,0,11000,0,11000,11000
20200312,052279,旺宏凱基95購07,,,,,0.00,0.00,0,0,0,0,0,0,0,0,0,0,0,0,0
20200312,05227P,大立光統一95售04,1.87,2.10,1.87,2.10,+0.77,57.89,155000,6,296270,0,0,0,0,0,0,111000,44000,67000,67000
20200312,052280,聯發科凱基95購11,0.18,0.18,0.15,0.15,-0.16,-51.61,80000,2,13500,0,0,0,0,0,0,80000,0,80000,80000
20200312,052281,全新凱基97購01,0.18,0.18,0.15,0.16,0.00,0.00,130000,5,20200,0,0,0,0,0,0,120000,10000,110000,110000
20200312,052282,宏達電凱基95購05,0.84,0.84,0.56,0.56,-0.34,-37.78,161000,2,133840,0,0,0,0,0,0,0,161000,-161000,-161000
20200312,052283,TPK凱基97購01,,,,,0.00,0.00,0,0,0,0,0,0,0,0,0,0,0,0,0
20200312,052284,日月光凱基96購01,0.02,0.02,0.02,0.02,0.00,0.00,1000,1,20,0,0,0,0,0,0,1000,0,1000,1000
20200312,052285,康控凱基95購02,,,,,0.00,0.00,0,0,0,0,0,0,0,0,0,0,0,0,0
20200312,052286,力成凱基95購02,0.08,0.08,0.06,0.07,-0.09,-56.25,142000,18,9880,0,0,0,0,0,0,127000,0,127000,127000
20200312,052287,臺股指中信95購12,0.03,0.03,0.02,0.03,-0.04,-57.14,1800000,21,51450,0,0,0,0,0,0,0,0,0,0
20200312,052288,敦南統一95購01,,,,,0.00,0.00,0,0,0,0,0,0,0,0,0,0,0,0,0
20200312,052289,為升元富95購02,,,,,0.00,0.00,0,0,0,0,0,0,0,0,0,0,0,0,0
20200312,05228P,大立光元富95售09,2.99,2.99,2.99,2.99,+1.19,66.11,1000,1,2990,0,0,0,0,0,0,1000,0,1000,1000
20200312,052290,鴻海元富97購01,0.13,0.13,0.10,0.10,-0.08,-44.44,47000,3,5710,0,0,0,0,0,0,0,47000,-47000,-47000
20200312,052291,鴻海元富97購02,,,,,0.00,0.00,0,0,0,0,0,0,0,0,0,0,0,0,0
20200312,052292,緯穎元富95購02,2.07,2.07,1.43,1.61,-0.88,-35.34,79000,13,135090,0,0,0,0,0,0,6000,73000,-67000,-67000
20200312,052293,泰碩國票95購03,1.01,1.01,0.66,0.87,-0.23,-20.91,720000,17,535670,0,0,0,0,0,0,400000,320000,80000,80000
20200312,052294,創意國票96購03,0.16,0.16,0.16,0.16,-0.18,-52.94,20000,1,3200,0,0,0,0,0,0,20000,0,20000,20000
20200312,052295,揚明光國票96購03,0.59,0.59,0.59,0.59,0.00,0.00,30000,1,17700,0,0,0,0,0,0,0,30000,-30000,-30000
20200312,052296,TPK國票96購01,0.10,0.10,0.06,0.07,-0.06,-46.15,3976000,17,310870,0,0,0,0,0,0,0,3976000,-3976000,-3976000
20200312,052297,旭富國票96購01,2.45,2.47,2.00,2.00,-0.86,-30.07,331000,5,810650,0,0,0,0,0,0,300000,31000,269000,269000
20200312,052298,易華電國票96購01,,,,,0.00,0.00,0,0,0,0,0,0,0,0,0,0,0,0,0
20200312,052299,T50反1台新05購03,1.09,1.24,1.09,1.24,+0.33,36.26,49000,5,56740,0,0,0,0,0,0,5000,44000,-39000,-39000
20200312,05229P,台積電群益95售05,2.19,2.92,2.17,2.63,+0.85,47.75,132000,5,298960,0,0,0,0,0,0,100000,30000,70000,70000
20200312,052300,力成台新95購01,0.83,0.83,0.52,0.52,-0.65,-55.56,60000,5,39000,0,0,0,0,0,0,40000,20000,20000,20000
20200312,052301,華通康和95購01,,,,,0.00,0.00,0,0,0,0,0,0,0,0,0,0,0,0,0
20200312,052302,鴻海永豐95購06,,,,,0.00,0.00,0,0,0,0,0,0,0,0,0,0,0,0,0
20200312,052303,聯發科永豐95購05,0.01,0.01,0.01,0.01,0.00,0.00,330000,36,3300,0,0,0,0,0,0,0,330000,-330000,-330000
20200312,052304,可成永豐95購03,,,,,0.00,0.00,0,0,0,0,0,0,0,0,0,0,0,0,0
20200312,052305,GIS永豐95購03,0.22,0.22,0.21,0.21,-0.12,-36.36,165000,2,34800,0,0,0,0,0,0,165000,0,165000,165000
20200312,052306,鴻海國泰97購05,,,,,0.00,0.00,0,0,0,0,0,0,0,0,0,0,0,0,0
20200312,052307,潤泰全國泰96購01,0.68,0.70,0.58,0.58,-0.22,-27.5,243000,9,158420,0,0,0,0,0,0,120000,173000,-53000,-53000
20200312,052308,大立光國泰97購02,0.69,0.69,0.54,0.55,-0.44,-44.44,553000,12,354530,0,0,0,0,0,0,420000,421000,-1000,-1000
20200312,052309,健策國泰97購01,1.08,1.08,0.76,0.76,-0.46,-37.7,311000,18,295220,0,0,0,0,0,0,130000,271000,-141000,-141000
20200312,05230P,京元電群益95售01,3.56,4.30,3.56,4.30,+1.35,45.76,9000,2,36480,0,0,0,0,0,0,6000,3000,3000,3000
20200312,052310,聯電富邦95購01,,,,,0.00,0.00,0,0,0,0,0,0,0,0,0,0,0,0,0
20200312,052311,台積電富邦95購09,,,,,0.00,0.00,0,0,0,0,0,0,0,0,0,0,0,0,0
20200312,052312,美律富邦96購02,0.16,0.16,0.13,0.13,-0.14,-51.85,40000,2,5800,0,0,0,0,0,0,0,40000,-40000,-40000
20200312,052313,聯電元大98購01,0.80,0.80,0.57,0.66,-0.27,-29.03,124000,6,93140,0,0,0,0,0,0,2000,122000,-120000,-120000
20200312,052314,鴻海元大96購11,0.22,0.22,0.10,0.20,-0.02,-9.09,186000,12,30630,0,0,0,0,0,0,4000,10000,-6000,-6000
20200312,052315,廣宇元大95購02,,,,,0.00,0.00,0,0,0,0,0,0,0,0,0,0,0,0,0
20200312,052316,台積電元大96購10,0.52,0.52,0.39,0.39,-0.35,-47.3,27000,5,12700,0,0,0,0,0,0,0,26000,-26000,-26000
20200312,052317,台積電元大96購11,0.52,0.52,0.47,0.52,-0.10,-16.13,94000,12,47680,0,0,0,0,0,0,36000,46000,-10000,-10000
20200312,052318,友達元大98購01,0.89,0.89,0.89,0.89,0.00,0.00,14000,1,12460,0,0,0,0,0,0,14000,0,14000,14000
20200312,052319,可成元大95購12,0.18,0.18,0.11,0.12,-0.17,-58.62,318000,10,43940,0,0,0,0,0,0,114000,248000,-134000,-134000
20200312,05231P,GIS群益95售03,2.72,3.30,2.72,3.30,+0.72,27.91,161000,12,463190,0,0,0,0,0,0,112000,52000,60000,60000
20200312,052320,緯創元大95購05,0.19,0.19,0.09,0.09,-0.15,-62.5,401000,6,56990,0,0,0,0,0,0,301000,101000,200000,200000
20200312,052321,華擎元大95購01,2.75,3.01,2.75,3.01,-0.45,-13.01,10000,2,28800,0,0,0,0,0,0,5000,5000,0,0
20200312,052322,力成元大96購01,0.61,0.61,0.47,0.48,-0.26,-35.14,320000,8,163030,0,0,0,0,0,0,11000,320000,-309000,-309000
20200312,052323,矽力元大95購04,1.74,1.74,1.55,1.55,-0.76,-32.9,18000,2,31130,0,0,0,0,0,0,17000,1000,16000,16000
20200312,052324,康友元大96購02,1.30,1.30,1.00,1.02,-0.32,-23.88,183000,20,209230,0,0,0,0,0,0,63000,126000,-63000,-63000
20200312,052325,高股息中信99購01,1.74,1.74,1.36,1.46,-0.42,-22.34,266000,25,390640,0,0,0,0,0,0,72000,194000,-122000,-122000
20200312,052326,滬深反中信99購01,0.85,0.92,0.85,0.90,+0.10,12.5,498000,13,438180,0,0,0,0,0,0,95000,403000,-308000,-308000
20200312,052327,聯詠中信95購03,,,,,0.00,0.00,0,0,0,0,0,0,0,0,0,0,0,0,0
20200312,052328,台表科中信99購01,0.18,0.18,0.16,0.16,-0.10,-38.46,276000,3,47160,0,0,0,0,0,0,26000,250000,-224000,-224000
20200312,052329,台積電亞東96購01,0.80,0.80,0.72,0.72,-0.43,-37.39,3000,3,2310,0,0,0,0,0,0,0,3000,-3000,-3000
20200312,05232P,緯穎群益95售01,,,,,0.00,0.00,0,0,0,0,0,0,0,0,0,0,0,0,0
20200312,052330,燿華亞東95購01,,,,,0.00,0.00,0,0,0,0,0,0,0,0,0,0,0,0,0
20200312,052331,漢唐亞東97購01,,,,,0.00,0.00,0,0,0,0,0,0,0,0,0,0,0,0,0
20200312,052332,美律亞東96購01,,,,,0.00,0.00,0,0,0,0,0,0,0,0,0,0,0,0,0
20200312,052333,嘉聯益兆豐96購01,,,,,0.00,0.00,0,0,0,0,0,0,0,0,0,0,0,0,0
20200312,052334,大成鋼日盛95購01,,,,,0.00,0.00,0,0,0,0,0,0,0,0,0,0,0,0,0
20200312,052335,新光金日盛95購02,,,,,0.00,0.00,0,0,0,0,0,0,0,0,0,0,0,0,0
20200312,052336,矽力日盛95購01,1.32,1.32,1.32,1.32,-0.55,-29.41,10000,1,13200,0,0,0,0,0,0,10000,0,10000,10000
20200312,052337,臺股指日盛95購02,,,,,0.00,0.00,0,0,0,0,0,0,0,0,0,0,0,0,0
20200312,052338,道瓊反凱基97購02,1.62,2.00,1.62,2.00,+0.70,53.85,70000,3,122650,0,0,0,0,0,0,20000,50000,-30000,-30000
20200312,052339,光寶科凱基95購01,,,,,0.00,0.00,0,0,0,0,0,0,0,0,0,0,0,0,0
20200312,05233P,台郡台新95售02,,,,,0.00,0.00,0,0,0,0,0,0,0,0,0,0,0,0,0
20200312,052340,燿華凱基96購01,,,,,0.00,0.00,0,0,0,0,0,0,0,0,0,0,0,0,0
20200312,052341,泰鼎凱基96購02,1.75,1.75,1.33,1.33,-0.49,-26.92,56000,8,82760,0,0,0,0,0,0,41000,43000,-2000,-2000
20200312,052342,茂林凱基96購01,0.55,0.55,0.32,0.32,-0.29,-47.54,115000,10,55110,0,0,0,0,0,0,57000,58000,-1000,-1000
20200312,052343,同欣電凱基95購03,0.35,0.35,0.22,0.23,-0.24,-51.06,216000,4,48840,0,0,0,0,0,0,204000,12000,192000,192000
20200312,052344,台表科凱基98購01,,,,,0.00,0.00,0,0,0,0,0,0,0,0,0,0,0,0,0
20200312,052345,矽力凱基95購01,1.78,1.78,1.53,1.53,-0.80,-34.33,90000,14,146800,0,0,0,0,0,0,75000,15000,60000,60000
20200312,052346,訊芯凱基95購01,,,,,0.00,0.00,0,0,0,0,0,0,0,0,0,0,0,0,0
20200312,052347,GIS凱基95購05,,,,,0.00,0.00,0,0,0,0,0,0,0,0,0,0,0,0,0
20200312,052348,台光電富邦95購01,0.37,0.37,0.31,0.31,-0.14,-31.11,100000,9,34000,0,0,0,0,0,0,80000,20000,60000,60000
20200312,052349,鴻海統一95購15,,,,,0.00,0.00,0,0,0,0,0,0,0,0,0,0,0,0,0
20200312,05234P,美食康和95售01,1.51,1.58,1.47,1.51,+0.15,11.03,593000,15,885970,0,0,0,0,0,0,556000,3000,553000,553000
20200312,052350,鴻海統一96購06,0.01,0.01,0.01,0.01,0.00,0.00,15000,1,150,0,0,0,0,0,0,0,0,0,0
20200312,052351,中環元富95購01,,,,,0.00,0.00,0,0,0,0,0,0,0,0,0,0,0,0,0
20200312,052352,力成元富95購01,0.31,0.31,0.31,0.31,-0.23,-42.59,40000,1,12400,0,0,0,0,0,0,40000,0,40000,40000
20200312,052353,高鐵群益97購01,,,,,0.00,0.00,0,0,0,0,0,0,0,0,0,0,0,0,0
20200312,052354,健策群益96購02,0.78,0.78,0.53,0.53,-0.44,-45.36,118000,4,78760,0,0,0,0,0,0,44000,74000,-30000,-30000
20200312,052355,為升永豐95購02,0.08,0.08,0.05,0.06,0.00,0.00,270000,19,19100,0,0,0,0,0,0,20000,250000,-230000,-230000
20200312,052356,聯詠永豐95購03,,,,,0.00,0.00,0,0,0,0,0,0,0,0,0,0,0,0,0
20200312,052357,揚明光永豐95購03,,,,,0.00,0.00,0,0,0,0,0,0,0,0,0,0,0,0,0
20200312,052358,台表科永豐95購02,,,,,0.00,0.00,0,0,0,0,0,0,0,0,0,0,0,0,0
20200312,052359,百和永豐95購01,,,,,0.00,0.00,0,0,0,0,0,0,0,0,0,0,0,0,0
20200312,05235P,健鼎康和95售02,1.09,1.16,1.09,1.11,+0.13,13.27,258000,7,289250,0,0,0,0,0,0,245000,13000,232000,232000
20200312,052360,FB上証國票96購01,0.48,0.51,0.45,0.45,-0.23,-33.82,271000,6,133240,0,0,0,0,0,0,0,271000,-271000,-271000
20200312,052361,大成鋼國票96購01,0.45,0.48,0.45,0.47,0.00,0.00,55000,4,25750,0,0,0,0,0,0,5000,55000,-50000,-50000
20200312,052362,瑞昱國票96購02,0.54,0.54,0.54,0.54,-0.34,-38.64,10000,1,5400,0,0,0,0,0,0,10000,0,10000,10000
20200312,052363,廣達國票96購01,0.16,0.16,0.14,0.14,-0.10,-41.67,30000,3,4500,0,0,0,0,0,0,0,30000,-30000,-30000
20200312,052364,全新國票95購02,0.10,0.10,0.10,0.10,0.00,0.00,10000,1,1000,0,0,0,0,0,0,0,10000,-10000,-10000
20200312,052365,聯詠國票95購02,,,,,0.00,0.00,0,0,0,0,0,0,0,0,0,0,0,0,0
20200312,052366,聯詠國票96購01,,,,,0.00,0.00,0,0,0,0,0,0,0,0,0,0,0,0,0
20200312,052367,聯茂國票96購02,1.42,1.50,1.18,1.18,-0.92,-43.81,76000,7,104760,0,0,0,0,0,0,32000,44000,-12000,-12000
20200312,052368,力成國票96購01,0.39,0.39,0.25,0.25,-0.55,-68.75,263000,23,79220,0,0,0,0,0,0,60000,203000,-143000,-143000
20200312,052369,矽力國票96購02,3.22,3.22,2.61,3.06,-0.87,-22.14,39000,11,119290,0,0,0,0,0,0,37000,2000,35000,35000
20200312,05236P,緯穎康和95售01,,,,,0.00,0.00,0,0,0,0,0,0,0,0,0,0,0,0,0
20200312,052370,滬深2X元大95購04,0.48,0.48,0.37,0.37,-0.22,-37.29,110000,3,45500,0,0,0,0,0,0,50000,60000,-10000,-10000
20200312,052371,元金2X元大95購01,0.80,0.80,0.74,0.74,-0.22,-22.92,545000,5,427300,0,0,0,0,0,0,400000,145000,255000,255000
20200312,052372,台泥元大95購02,0.38,0.38,0.38,0.38,-0.10,-20.83,68000,1,25840,0,0,0,0,0,0,0,68000,-68000,-68000
20200312,052373,鴻海元大95購22,0.14,0.14,0.14,0.14,-0.15,-51.72,70000,1,9800,0,0,0,0,0,0,70000,0,70000,70000
20200312,052374,瑞昱元大95購02,0.95,0.95,0.57,0.57,-0.75,-56.82,71000,5,53310,0,0,0,0,0,0,71000,71000,0,0
20200312,052375,奇力新元大96購02,0.84,0.84,0.52,0.57,-0.44,-43.56,35000,6,24030,0,0,0,0,0,0,22000,13000,9000,9000
20200312,052376,聯詠元大95購04,,,,,0.00,0.00,0,0,0,0,0,0,0,0,0,0,0,0,0
20200312,052377,景碩元大96購02,0.73,0.73,0.48,0.48,-0.56,-53.85,203000,5,131950,0,0,0,0,0,0,100000,103000,-3000,-3000
20200312,052378,矽力元大96購01,3.30,3.37,3.23,3.27,-0.83,-20.24,27000,5,88640,0,0,0,0,0,0,5000,22000,-17000,-17000
20200312,052379,鈺齊元大95購04,,,,,0.00,0.00,0,0,0,0,0,0,0,0,0,0,0,0,0
20200312,05237P,為升永豐95售01,1.88,2.20,1.86,2.14,+0.54,33.75,394000,16,775310,0,0,0,0,0,0,361000,33000,328000,328000
20200312,052380,臺股指元大95購21,0.76,0.76,0.40,0.40,-0.72,-64.29,60000,6,39300,0,0,0,0,0,0,0,60000,-60000,-60000
20200312,052381,臺股指元大95購22,,,,,0.00,0.00,0,0,0,0,0,0,0,0,0,0,0,0,0
20200312,052382,臺股指元大95購23,0.45,0.45,0.38,0.38,0.00,0.00,20000,3,8550,0,0,0,0,0,0,0,20000,-20000,-20000
20200312,052383,臺股指元大95購29,0.20,0.20,0.20,0.20,-0.47,-70.15,181000,1,36200,0,0,0,0,0,0,181000,0,181000,181000
20200312,052384,臺股指元大95購30,0.45,0.45,0.45,0.45,0.00,0.00,3000,1,1350,0,0,0,0,0,0,3000,0,3000,3000
20200312,052385,滬深2X群益99購05,1.22,1.24,1.08,1.08,-0.37,-25.52,78000,13,89880,0,0,0,0,0,0,34000,70000,-36000,-36000
20200312,052386,鴻海群益96購02,0.58,0.61,0.44,0.44,-0.40,-47.62,140000,5,78500,0,0,0,0,0,0,50000,90000,-40000,-40000
20200312,052387,台積電群益95購08,1.63,1.66,1.09,1.54,-0.44,-22.22,470000,31,678750,0,0,0,0,0,0,257000,302000,-45000,-45000
20200312,052388,旺宏群益96購05,1.65,1.65,1.16,1.20,-0.82,-40.59,206000,11,269370,0,0,0,0,0,0,55000,114000,-59000,-59000
20200312,052389,聯發科群益95購05,0.05,0.05,0.03,0.03,-0.05,-62.5,250000,2,11500,0,0,0,0,0,0,0,250000,-250000,-250000
20200312,05238P,禾伸堂永豐95售01,1.19,1.37,1.13,1.19,0.00,0.00,253000,28,311570,0,0,0,0,0,0,40000,243000,-203000,-203000
20200312,052390,聯詠群益95購03,,,,,0.00,0.00,0,0,0,0,0,0,0,0,0,0,0,0,0
20200312,052391,瑞儀群益95購01,,,,,0.00,0.00,0,0,0,0,0,0,0,0,0,0,0,0,0
20200312,052392,台表科群益96購02,0.22,0.22,0.13,0.13,-0.14,-51.85,210000,3,36300,0,0,0,0,0,0,100000,110000,-10000,-10000
20200312,052393,康友群益95購05,1.18,1.18,0.92,0.93,-0.34,-26.77,138000,21,152410,0,0,0,0,0,0,88000,108000,-20000,-20000
20200312,052394,滬深2X日盛95購01,0.38,0.38,0.28,0.28,-0.21,-42.86,300000,3,101000,0,0,0,0,0,0,0,300000,-300000,-300000
20200312,052395,上証2X凱基97購01,,,,,0.00,0.00,0,0,0,0,0,0,0,0,0,0,0,0,0
20200312,052396,台積電凱基97購01,1.01,1.01,0.65,0.89,-0.32,-26.45,87000,16,74630,0,0,0,0,0,0,0,87000,-87000,-87000
20200312,052397,燿華凱基96購02,0.01,0.01,0.01,0.01,0.00,0.00,10000,1,100,0,0,0,0,0,0,0,0,0,0
20200312,052398,瑞昱凱基95購06,0.10,0.10,0.10,0.10,-0.04,-28.57,20000,2,2000,0,0,0,0,0,0,0,20000,-20000,-20000
20200312,052399,台光電凱基95購03,0.42,0.42,0.30,0.30,-0.22,-42.31,50000,2,16200,0,0,0,0,0,0,50000,0,50000,50000
20200312,05239P,欣興永豐95售03,2.29,3.03,2.29,2.97,+1.10,58.82,100000,9,261100,0,0,0,0,0,0,30000,70000,-40000,-40000
20200312,052400,聯詠凱基97購01,0.12,0.14,0.11,0.14,-0.07,-33.33,5614000,24,680030,0,0,0,0,0,0,1373000,4241000,-2868000,-2868000
20200312,052401,智原凱基95購01,,,,,0.00,0.00,0,0,0,0,0,0,0,0,0,0,0,0,0
20200312,052402,健策凱基97購01,0.48,0.48,0.35,0.35,-0.23,-39.66,375000,10,153100,0,0,0,0,0,0,35000,340000,-305000,-305000
20200312,052403,麗豐凱基96購01,,,,,0.00,0.00,0,0,0,0,0,0,0,0,0,0,0,0,0
20200312,052404,臻鼎凱基95購05,,,,,0.00,0.00,0,0,0,0,0,0,0,0,0,0,0,0,0
20200312,052405,聯茂凱基95購01,0.40,0.40,0.22,0.22,-0.38,-63.33,124000,3,33280,0,0,0,0,0,0,20000,104000,-84000,-84000
20200312,052406,力成凱基95購03,0.35,0.35,0.27,0.27,-0.34,-55.74,173000,11,53410,0,0,0,0,0,0,173000,0,173000,173000
20200312,052407,樺漢凱基95購01,,,,,0.00,0.00,0,0,0,0,0,0,0,0,0,0,0,0,0
20200312,052408,羅麗芬凱基95購01,,,,,0.00,0.00,0,0,0,0,0,0,0,0,0,0,0,0,0
20200312,052409,國巨亞東95購01,,,,,0.00,0.00,0,0,0,0,0,0,0,0,0,0,0,0,0
20200312,05240P,玉晶光永豐96售01,0.80,0.80,0.80,0.80,0.00,0.00,50000,1,40000,0,0,0,0,0,0,50000,0,50000,50000
20200312,052410,智邦亞東96購01,,,,,0.00,0.00,0,0,0,0,0,0,0,0,0,0,0,0,0
20200312,052411,嘉聯益亞東95購02,,,,,0.00,0.00,0,0,0,0,0,0,0,0,0,0,0,0,0
20200312,052412,上証2X中信98購01,0.49,0.49,0.49,0.49,0.00,0.00,50000,1,24500,0,0,0,0,0,0,0,50000,-50000,-50000
20200312,052413,上証反中信97購01,1.06,1.09,1.02,1.02,+0.14,15.91,240000,11,254600,0,0,0,0,0,0,40000,200000,-160000,-160000
20200312,052414,聯電麥證95購01,,,,,0.00,0.00,0,0,0,0,0,0,0,0,0,0,0,0,0
20200312,052415,台表科麥證95購02,,,,,0.00,0.00,0,0,0,0,0,0,0,0,0,0,0,0,0
20200312,052416,滬深2X兆豐96購02,,,,,0.00,0.00,0,0,0,0,0,0,0,0,0,0,0,0,0
20200312,052417,聯發科兆豐9B購01,0.65,0.65,0.43,0.44,-0.27,-38.03,370000,19,182800,0,0,0,0,0,0,0,370000,-370000,-370000
20200312,052418,玉晶光兆豐96購01,,,,,0.00,0.00,0,0,0,0,0,0,0,0,0,0,0,0,0
20200312,052419,上証2X國票96購02,0.21,0.21,0.21,0.21,0.00,0.00,400000,1,84000,0,0,0,0,0,0,0,400000,-400000,-400000
20200312,05241P,鴻海國泰97售04,2.51,2.98,2.51,2.77,+0.51,22.57,101000,12,264650,0,0,0,0,0,0,30000,81000,-51000,-51000
20200312,052420,道瓊反國票9B購01,1.49,1.89,1.49,1.80,+0.56,45.16,414000,38,705430,0,0,0,0,0,0,130000,231000,-101000,-101000
20200312,052421,元油反國票9B購01,3.95,4.50,3.95,4.50,+1.77,64.84,26000,5,107450,0,0,0,0,0,0,25000,1000,24000,24000
20200312,052422,聯電國票96購03,0.62,0.62,0.41,0.42,-0.35,-45.45,80000,7,42300,0,0,0,0,0,0,20000,60000,-40000,-40000
20200312,052423,宏達電國票96購02,1.72,1.72,1.72,1.72,-0.12,-6.52,30000,3,51600,0,0,0,0,0,0,20000,10000,10000,10000
20200312,052424,泰碩國票97購01,1.36,1.36,1.25,1.25,-0.20,-13.79,116000,2,152370,0,0,0,0,0,0,116000,0,116000,116000
20200312,052425,華通台新95購02,,,,,0.00,0.00,0,0,0,0,0,0,0,0,0,0,0,0,0
20200312,052426,國巨台新96購01,1.97,2.01,1.36,1.36,-0.79,-36.74,61000,6,104040,0,0,0,0,0,0,31000,30000,1000,1000
20200312,052427,上証2X永豐96購01,0.11,0.11,0.11,0.11,0.00,0.00,30000,1,3300,0,0,0,0,0,0,0,30000,-30000,-30000
20200312,052428,嘉晶永豐95購01,1.19,1.27,1.02,1.02,-0.35,-25.55,168000,14,191800,0,0,0,0,0,0,72000,97000,-25000,-25000
20200312,052429,禾伸堂永豐95購02,0.37,0.37,0.37,0.37,0.00,0.00,64000,1,23680,0,0,0,0,0,0,64000,0,64000,64000
20200312,05242P,群創國泰97售01,0.50,0.58,0.50,0.58,0.00,0.00,227000,8,120400,0,0,0,0,0,0,82000,145000,-63000,-63000
20200312,052430,泰碩永豐95購02,,,,,0.00,0.00,0,0,0,0,0,0,0,0,0,0,0,0,0
20200312,052431,茂林永豐95購03,0.34,0.34,0.21,0.21,-0.30,-58.82,86000,4,25750,0,0,0,0,0,0,10000,76000,-66000,-66000
20200312,052432,康友永豐95購04,0.72,0.72,0.60,0.60,-0.31,-34.07,100000,2,70800,0,0,0,0,0,0,90000,10000,80000,80000
20200312,052433,滬深2X國泰96購02,,,,,0.00,0.00,0,0,0,0,0,0,0,0,0,0,0,0,0
20200312,052434,茂林國泰97購01,0.90,0.91,0.59,0.59,-0.36,-37.89,481000,18,369060,0,0,0,0,0,0,378000,153000,225000,225000
20200312,052435,滬深2X富邦96購05,,,,,0.00,0.00,0,0,0,0,0,0,0,0,0,0,0,0,0
20200312,052436,正崴富邦95購01,,,,,0.00,0.00,0,0,0,0,0,0,0,0,0,0,0,0,0
20200312,052437,聯發科富邦99購02,0.30,0.30,0.23,0.24,-0.28,-53.85,79000,5,19060,0,0,0,0,0,0,0,79000,-79000,-79000
20200312,052438,瑞儀富邦95購01,,,,,0.00,0.00,0,0,0,0,0,0,0,0,0,0,0,0,0
20200312,052439,寶成富邦97購01,0.16,0.16,0.13,0.13,-0.07,-35.0,15000,2,2250,0,0,0,0,0,0,0,15000,-15000,-15000
20200312,05243P,鴻海元大95售19,6.20,6.20,6.20,6.20,+1.60,34.78,53000,3,328600,0,0,0,0,0,0,0,53000,-53000,-53000
20200312,052440,上証2X元大95購02,,,,,0.00,0.00,0,0,0,0,0,0,0,0,0,0,0,0,0
20200312,052441,亞泥元大95購01,0.42,0.47,0.39,0.41,-0.15,-26.79,663000,16,277690,0,0,0,0,0,0,563000,100000,463000,463000
20200312,052442,中環元大95購02,,,,,0.00,0.00,0,0,0,0,0,0,0,0,0,0,0,0,0
20200312,052443,台積電元大95購23,0.92,0.92,0.62,0.80,-0.28,-25.93,1134000,45,899830,0,0,0,0,0,0,222000,915000,-693000,-693000
20200312,052444,友訊元大95購01,0.41,0.41,0.24,0.24,-0.22,-47.83,156000,9,53880,0,0,0,0,0,0,78000,78000,0,0
20200312,052445,南亞科元大95購05,0.91,0.94,0.61,0.61,-0.89,-59.33,580000,17,434500,0,0,0,0,0,0,20000,560000,-540000,-540000
20200312,052446,聯發科元大96購03,0.14,0.15,0.14,0.14,-0.16,-53.33,98000,4,13750,0,0,0,0,0,0,73000,25000,48000,48000
20200312,052447,聯發科元大96購04,0.35,0.35,0.35,0.35,0.00,0.00,68000,1,23800,0,0,0,0,0,0,0,68000,-68000,-68000
20200312,052448,新光金元大96購03,,,,,0.00,0.00,0,0,0,0,0,0,0,0,0,0,0,0,0
20200312,052449,創意元大95購04,,,,,0.00,0.00,0,0,0,0,0,0,0,0,0,0,0,0,0
20200312,05244P,台積電元大95售17,2.57,2.57,2.21,2.21,+0.75,51.37,203000,14,496030,0,0,0,0,0,0,100000,203000,-103000,-103000
20200312,052450,嘉澤元大95購03,,,,,0.00,0.00,0,0,0,0,0,0,0,0,0,0,0,0,0
20200312,052451,旭富元大95購02,1.44,1.44,0.88,0.88,-0.63,-41.72,629000,51,666730,0,0,0,0,0,0,506000,123000,383000,383000
20200312,052452,茂林元大95購03,1.04,1.04,0.74,0.74,-0.36,-32.73,128000,7,114560,0,0,0,0,0,0,59000,113000,-54000,-54000
20200312,052453,崇越元大95購01,0.72,0.72,0.55,0.59,-0.23,-28.05,150000,5,87900,0,0,0,0,0,0,110000,40000,70000,70000
20200312,052454,力成元大95購02,1.28,1.28,0.84,0.84,-0.66,-44.0,318000,10,304550,0,0,0,0,0,0,100000,210000,-110000,-110000
20200312,052455,樺漢元大96購03,0.24,0.24,0.24,0.24,-0.16,-40.0,68000,1,16320,0,0,0,0,0,0,68000,0,68000,68000
20200312,052456,滬深2X元富9B購03,0.54,0.54,0.41,0.44,-0.13,-22.81,1286000,31,601360,0,0,0,0,0,0,289000,996000,-707000,-707000
20200312,052457,日月光元富95購01,0.37,0.37,0.34,0.34,-0.19,-35.85,50000,2,17300,0,0,0,0,0,0,50000,0,50000,50000
20200312,052458,T50反1統一97購01,,,,,0.00,0.00,0,0,0,0,0,0,0,0,0,0,0,0,0
20200312,052459,道瓊反統一95購04,1.85,1.95,1.85,1.95,0.00,0.00,50000,2,94500,0,0,0,0,0,0,0,50000,-50000,-50000
20200312,05245P,台積電元大95售18,1.61,2.19,1.61,1.73,+0.33,23.57,1634000,60,3048480,0,0,0,0,0,0,1030000,1591000,-561000,-561000
20200312,052460,元油反統一95購01,,,,,0.00,0.00,0,0,0,0,0,0,0,0,0,0,0,0,0
20200312,052461,和大統一95購01,0.33,0.33,0.32,0.32,-0.37,-53.62,59000,2,19120,0,0,0,0,0,0,59000,0,59000,59000
20200312,052462,上銀統一95購03,1.21,1.21,0.81,0.81,-0.77,-48.73,510000,14,541260,0,0,0,0,0,0,460000,50000,410000,410000
20200312,052463,聯電統一96購01,0.49,0.49,0.40,0.40,-0.30,-42.86,136000,5,59400,0,0,0,0,0,0,60000,76000,-16000,-16000
20200312,052464,大立光統一95購05,0.61,0.61,0.39,0.47,-0.84,-64.12,1566000,8,678180,0,0,0,0,0,0,1503000,1557000,-54000,-54000
20200312,052465,聯詠統一95購02,,,,,0.00,0.00,0,0,0,0,0,0,0,0,0,0,0,0,0
20200312,052466,聯詠統一95購03,,,,,0.00,0.00,0,0,0,0,0,0,0,0,0,0,0,0,0
20200312,052467,嘉聯益統一96購01,0.33,0.33,0.33,0.33,-0.25,-43.1,55000,1,18150,0,0,0,0,0,0,0,55000,-55000,-55000
20200312,052468,超眾統一96購02,,,,,0.00,0.00,0,0,0,0,0,0,0,0,0,0,0,0,0
20200312,052469,宏碁亞東95購01,,,,,0.00,0.00,0,0,0,0,0,0,0,0,0,0,0,0,0
20200312,05246P,南電元大95售04,1.42,1.78,1.42,1.78,+0.48,36.92,187000,11,290770,0,0,0,0,0,0,120000,66000,54000,54000
20200312,052470,華新科亞東97購01,,,,,0.00,0.00,0,0,0,0,0,0,0,0,0,0,0,0,0
20200312,052471,華固亞東95購01,,,,,0.00,0.00,0,0,0,0,0,0,0,0,0,0,0,0,0
20200312,052472,和碩亞東95購01,,,,,0.00,0.00,0,0,0,0,0,0,0,0,0,0,0,0,0
20200312,052473,臻鼎亞東95購01,,,,,0.00,0.00,0,0,0,0,0,0,0,0,0,0,0,0,0
20200312,052474,T50反1群益95購04,1.49,1.49,1.49,1.49,0.00,0.00,11000,1,16390,0,0,0,0,0,0,11000,0,11000,11000
20200312,052475,滬深2X群益99購06,,,,,0.00,0.00,0,0,0,0,0,0,0,0,0,0,0,0,0
20200312,052476,台光電群益98購01,0.57,0.57,0.45,0.47,-0.19,-28.79,583000,13,294800,0,0,0,0,0,0,323000,250000,73000,73000
20200312,052477,美律群益98購01,0.32,0.32,0.23,0.23,-0.21,-47.73,235000,2,57200,0,0,0,0,0,0,35000,200000,-165000,-165000
20200312,052478,大立光群益95購05,0.99,1.01,0.69,0.69,-0.95,-57.93,182000,12,169440,0,0,0,0,0,0,40000,142000,-102000,-102000
20200312,052479,TPK群益95購04,,,,,0.00,0.00,0,0,0,0,0,0,0,0,0,0,0,0,0
20200312,05247P,上銀群益95售01,0.88,1.02,0.88,1.02,0.00,0.00,201000,3,190630,0,0,0,0,0,0,0,201000,-201000,-201000
20200312,052480,麗豐群益95購01,,,,,0.00,0.00,0,0,0,0,0,0,0,0,0,0,0,0,0
20200312,052481,利勤群益95購01,0.07,0.07,0.05,0.05,0.00,0.00,320000,5,19200,0,0,0,0,0,0,0,320000,-320000,-320000
20200312,052482,茂林群益95購01,0.85,0.85,0.51,0.55,-0.36,-39.56,122000,11,81600,0,0,0,0,0,0,40000,62000,-22000,-22000
20200312,052483,超眾群益95購03,0.41,0.42,0.41,0.42,-0.46,-52.27,64000,3,26740,0,0,0,0,0,0,60000,64000,-4000,-4000
20200312,052484,矽創群益95購02,,,,,0.00,0.00,0,0,0,0,0,0,0,0,0,0,0,0,0
20200312,052485,深中小國票96購01,2.02,2.02,1.94,1.94,-0.46,-19.17,40000,4,78400,0,0,0,0,0,0,10000,30000,-20000,-20000
20200312,052486,元油反國票96購01,,,,,0.00,0.00,0,0,0,0,0,0,0,0,0,0,0,0,0
20200312,052487,國巨國票96購07,,,,,0.00,0.00,0,0,0,0,0,0,0,0,0,0,0,0,0
20200312,052488,旺宏國票96購03,1.83,1.83,1.83,1.83,-0.50,-21.46,2000,1,3660,0,0,0,0,0,0,2000,0,2000,2000
20200312,052489,義隆國票96購02,0.70,0.70,0.62,0.62,-0.35,-36.08,616000,4,429920,0,0,0,0,0,0,616000,0,616000,616000
20200312,05248P,矽創群益96售01,1.76,2.09,1.73,2.09,+0.45,27.44,99000,10,191500,0,0,0,0,0,0,40000,59000,-19000,-19000
20200312,052490,禾伸堂國票95購01,,,,,0.00,0.00,0,0,0,0,0,0,0,0,0,0,0,0,0
20200312,052491,泰碩國票99購01,1.14,1.14,0.91,1.05,-0.23,-17.97,25000,6,25790,0,0,0,0,0,0,2000,23000,-21000,-21000
20200312,052492,易華電國票96購02,,,,,0.00,0.00,0,0,0,0,0,0,0,0,0,0,0,0,0
20200312,052493,上証2X中信97購02,,,,,0.00,0.00,0,0,0,0,0,0,0,0,0,0,0,0,0
20200312,052494,百和中信95購02,,,,,0.00,0.00,0,0,0,0,0,0,0,0,0,0,0,0,0
20200312,052495,滬深2X台新95購01,,,,,0.00,0.00,0,0,0,0,0,0,0,0,0,0,0,0,0
20200312,052496,華通台新96購02,,,,,0.00,0.00,0,0,0,0,0,0,0,0,0,0,0,0,0
20200312,052497,楠梓電永豐96購01,,,,,0.00,0.00,0,0,0,0,0,0,0,0,0,0,0,0,0
20200312,052498,台積電永豐95購06,0.34,0.34,0.21,0.28,-0.17,-37.78,145000,15,39930,0,0,0,0,0,0,51000,86000,-35000,-35000
20200312,052499,合勤控永豐95購01,,,,,0.00,0.00,0,0,0,0,0,0,0,0,0,0,0,0,0
20200312,05249P,臻鼎國票95售01,,,,,0.00,0.00,0,0,0,0,0,0,0,0,0,0,0,0,0
20200312,052500,元翎永豐95購01,,,,,0.00,0.00,0,0,0,0,0,0,0,0,0,0,0,0,0
20200312,052501,茂林永豐95購04,0.22,0.22,0.22,0.22,-0.10,-31.25,10000,1,2200,0,0,0,0,0,0,10000,0,10000,10000
20200312,052502,瀚宇博永豐95購02,,,,,0.00,0.00,0,0,0,0,0,0,0,0,0,0,0,0,0
20200312,052503,大成鋼日盛95購02,,,,,0.00,0.00,0,0,0,0,0,0,0,0,0,0,0,0,0
20200312,052504,鴻海日盛95購03,,,,,0.00,0.00,0,0,0,0,0,0,0,0,0,0,0,0,0
20200312,052505,友達日盛9B購02,0.50,0.50,0.50,0.50,-0.29,-36.71,20000,2,10000,0,0,0,0,0,0,0,20000,-20000,-20000
20200312,052506,日月光日盛95購01,,,,,0.00,0.00,0,0,0,0,0,0,0,0,0,0,0,0,0
20200312,052507,日月光日盛95購02,,,,,0.00,0.00,0,0,0,0,0,0,0,0,0,0,0,0,0
20200312,052508,矽力日盛95購02,1.57,1.57,1.34,1.38,-0.88,-38.94,326000,34,463280,0,0,0,0,0,0,296000,30000,266000,266000
20200312,052509,鴻海凱基96購10,,,,,0.00,0.00,0,0,0,0,0,0,0,0,0,0,0,0,0
20200312,05250P,臻鼎國票96售01,3.73,5.20,3.73,5.20,+1.86,55.69,34000,4,150180,0,0,0,0,0,0,0,34000,-34000,-34000
20200312,052510,聯發科凱基95購13,,,,,0.00,0.00,0,0,0,0,0,0,0,0,0,0,0,0,0
20200312,052511,聯發科凱基95購14,,,,,0.00,0.00,0,0,0,0,0,0,0,0,0,0,0,0,0
20200312,052512,全新凱基96購03,0.12,0.12,0.12,0.12,0.00,0.00,1250000,5,150000,0,0,0,0,0,0,1250000,0,1250000,1250000
20200312,052513,大立光凱基95購13,,,,,0.00,0.00,0,0,0,0,0,0,0,0,0,0,0,0,0
20200312,052514,嘉澤凱基96購01,,,,,0.00,0.00,0,0,0,0,0,0,0,0,0,0,0,0,0
20200312,052515,矽力凱基95購02,1.55,1.86,1.55,1.67,-0.24,-12.57,16000,6,27910,0,0,0,0,0,0,16000,0,16000,16000
20200312,052516,臺股指凱基95購20,0.56,0.56,0.36,0.36,-0.57,-61.29,82000,8,35120,0,0,0,0,0,0,2000,60000,-58000,-58000
20200312,052517,滬深2X元大95購05,0.30,0.30,0.30,0.30,-0.18,-37.5,1000,1,300,0,0,0,0,0,0,1000,1000,0,0
20200312,052518,道瓊反元大95購02,0.65,0.81,0.65,0.77,+0.29,60.42,902000,15,698880,0,0,0,0,0,0,574000,328000,246000,246000
20200312,052519,旺宏元大95購05,1.83,1.88,1.20,1.27,-0.82,-39.23,325000,44,492210,0,0,0,0,0,0,216000,249000,-33000,-33000
20200312,05251P,喬山台新95售02,1.35,1.52,1.35,1.52,+0.20,15.15,222000,20,321320,0,0,0,0,0,0,222000,0,222000,222000
20200312,052520,南亞科元大95購06,1.76,1.76,1.16,1.24,0.00,0.00,206000,16,287890,0,0,0,0,0,0,42000,206000,-164000,-164000
20200312,052521,友達元大9B購01,1.15,1.15,0.99,0.99,-0.44,-30.77,168000,6,178770,0,0,0,0,0,0,108000,168000,-60000,-60000
20200312,052522,聯發科元大96購05,,,,,0.00,0.00,0,0,0,0,0,0,0,0,0,0,0,0,0
20200312,052523,奇力新元大97購01,1.00,1.00,0.68,0.69,-0.40,-36.7,392000,32,331910,0,0,0,0,0,0,216000,166000,50000,50000
20200312,052524,新光金元大9B購01,,,,,0.00,0.00,0,0,0,0,0,0,0,0,0,0,0,0,0
20200312,052525,聯詠元大95購06,,,,,0.00,0.00,0,0,0,0,0,0,0,0,0,0,0,0,0
20200312,052526,智伸科元大96購02,0.26,0.26,0.26,0.26,-0.04,-13.33,20000,1,5200,0,0,0,0,0,0,20000,0,20000,20000
20200312,052527,泰鼎元大96購02,1.29,1.29,1.29,1.29,-0.66,-33.85,100000,1,129000,0,0,0,0,0,0,0,100000,-100000,-100000
20200312,052528,茂林元大95購05,0.60,0.61,0.37,0.37,-0.27,-42.19,262000,16,127370,0,0,0,0,0,0,152000,118000,34000,34000
20200312,052529,力成元大95購03,0.76,0.76,0.76,0.76,-0.64,-45.71,5000,1,3800,0,0,0,0,0,0,0,5000,-5000,-5000
20200312,05252P,華通凱基95售01,1.22,1.65,1.22,1.65,+0.54,48.65,144000,15,205380,0,0,0,0,0,0,98000,47000,51000,51000
20200312,052530,台郡元大96購04,0.94,0.94,0.62,0.64,-0.43,-40.19,204000,12,144180,0,0,0,0,0,0,99000,114000,-15000,-15000
20200312,052531,台積電國泰96購06,0.82,0.82,0.69,0.69,-0.30,-30.3,752000,8,574970,0,0,0,0,0,0,692000,261000,431000,431000
20200312,052532,台積電國泰96購07,0.99,0.99,0.63,0.89,-0.30,-25.21,1013000,28,841420,0,0,0,0,0,0,645000,870000,-225000,-225000
20200312,052533,聯發科國泰96購03,,,,,0.00,0.00,0,0,0,0,0,0,0,0,0,0,0,0,0
20200312,052534,貿聯國泰96購02,0.44,0.44,0.38,0.41,-0.14,-25.45,195000,36,79940,0,0,0,0,0,0,195000,0,195000,195000
20200312,052535,日月光國泰96購01,0.24,0.24,0.11,0.12,-0.28,-70.0,358000,11,48470,0,0,0,0,0,0,20000,338000,-318000,-318000
20200312,052536,聯茂國泰97購01,1.89,1.89,1.26,1.26,-0.75,-37.31,70000,8,107450,0,0,0,0,0,0,15000,55000,-40000,-40000
20200312,052537,力成富邦95購01,,,,,0.00,0.00,0,0,0,0,0,0,0,0,0,0,0,0,0
20200312,052538,和大統一95購02,0.30,0.30,0.24,0.24,-0.27,-52.94,810000,3,232350,0,0,0,0,0,0,810000,0,810000,810000
20200312,052539,華邦電統一95購01,,,,,0.00,0.00,0,0,0,0,0,0,0,0,0,0,0,0,0
20200312,05253P,智邦凱基95售08,0.15,0.19,0.15,0.19,+0.07,58.33,330000,4,57500,0,0,0,0,0,0,200000,130000,70000,70000
20200312,052540,華新科統一95購03,,,,,0.00,0.00,0,0,0,0,0,0,0,0,0,0,0,0,0
20200312,052541,大立光統一95購06,0.88,0.89,0.69,0.69,-0.91,-56.88,139000,6,107010,0,0,0,0,0,0,29000,110000,-81000,-81000
20200312,052542,友達元富98購01,0.74,0.74,0.65,0.65,-0.37,-36.27,6000,2,4080,0,0,0,0,0,0,2000,4000,-2000,-2000
20200312,052543,聯詠元富95購01,,,,,0.00,0.00,0,0,0,0,0,0,0,0,0,0,0,0,0
20200312,052544,牧德元富95購01,,,,,0.00,0.00,0,0,0,0,0,0,0,0,0,0,0,0,0
20200312,052545,康控元富95購02,,,,,0.00,0.00,0,0,0,0,0,0,0,0,0,0,0,0,0
20200312,052546,友達中信98購01,0.80,0.80,0.58,0.58,-0.40,-40.82,714000,11,469260,0,0,0,0,0,0,408000,306000,102000,102000
20200312,052547,光磊兆豐96購01,,,,,0.00,0.00,0,0,0,0,0,0,0,0,0,0,0,0,0
20200312,052548,旺宏亞東96購01,0.19,0.19,0.19,0.19,0.00,0.00,15000,1,2850,0,0,0,0,0,0,0,15000,-15000,-15000
20200312,052549,喬山國票97購01,0.02,0.02,0.02,0.02,0.00,0.00,1000,1,20,0,0,0,0,0,0,1000,0,1000,1000
20200312,05254P,瑞昱凱基95售04,0.21,0.21,0.21,0.21,0.00,0.00,110000,1,23100,0,0,0,0,0,0,110000,0,110000,110000
20200312,052550,鴻海國票97購02,,,,,0.00,0.00,0,0,0,0,0,0,0,0,0,0,0,0,0
20200312,052551,台積電國票97購03,0.41,0.41,0.41,0.41,0.00,0.00,30000,1,12300,0,0,0,0,0,0,30000,0,30000,30000
20200312,052552,智邦國票97購01,1.46,1.46,1.46,1.46,-0.68,-31.78,5000,1,7300,0,0,0,0,0,0,0,5000,-5000,-5000
20200312,052553,技嘉國票96購01,0.59,0.59,0.40,0.52,-0.20,-27.78,112000,3,64040,0,0,0,0,0,0,10000,102000,-92000,-92000
20200312,052554,正崴國票97購01,,,,,0.00,0.00,0,0,0,0,0,0,0,0,0,0,0,0,0
20200312,052555,漢唐國票97購01,,,,,0.00,0.00,0,0,0,0,0,0,0,0,0,0,0,0,0
20200312,052556,聯發科國票97購01,,,,,0.00,0.00,0,0,0,0,0,0,0,0,0,0,0,0,0
20200312,052557,群創國票97購02,0.33,0.33,0.33,0.33,-0.33,-50.0,30000,1,9900,0,0,0,0,0,0,0,30000,-30000,-30000
20200312,052558,新唐國票97購01,,,,,0.00,0.00,0,0,0,0,0,0,0,0,0,0,0,0,0
20200312,052559,茂林國票97購01,0.71,0.71,0.44,0.45,-0.34,-43.04,183000,8,108350,0,0,0,0,0,0,122000,61000,61000,61000
20200312,05255P,義隆凱基95售01,0.71,0.71,0.71,0.71,0.00,0.00,32000,1,22720,0,0,0,0,0,0,0,32000,-32000,-32000
20200312,052560,康舒國票97購01,0.33,0.33,0.33,0.33,-0.30,-47.62,42000,1,13860,0,0,0,0,0,0,42000,0,42000,42000
20200312,052561,矽創國票97購01,0.66,0.66,0.43,0.46,-0.25,-35.21,100000,7,57590,0,0,0,0,0,0,52000,48000,4000,4000
20200312,052562,南亞科日盛96購01,,,,,0.00,0.00,0,0,0,0,0,0,0,0,0,0,0,0,0
20200312,052563,京元電日盛96購01,0.10,0.10,0.06,0.09,0.00,0.00,430000,5,27400,0,0,0,0,0,0,0,430000,-430000,-430000
20200312,052564,美食日盛96購01,,,,,0.00,0.00,0,0,0,0,0,0,0,0,0,0,0,0,0
20200312,052565,上銀凱基96購01,1.01,1.01,0.61,0.61,-0.71,-53.79,175000,16,155600,0,0,0,0,0,0,69000,119000,-50000,-50000
20200312,052566,國巨凱基96購04,1.74,1.74,1.15,1.15,-1.14,-49.78,45000,5,64270,0,0,0,0,0,0,35000,35000,0,0
20200312,052567,台積電凱基96購05,0.30,0.30,0.25,0.26,-0.22,-45.83,95000,5,24600,0,0,0,0,0,0,85000,10000,75000,75000
20200312,052568,漢唐凱基96購02,0.57,0.58,0.48,0.48,-0.19,-28.36,30000,3,16300,0,0,0,0,0,0,20000,10000,10000,10000
20200312,052569,聯發科凱基96購08,,,,,0.00,0.00,0,0,0,0,0,0,0,0,0,0,0,0,0
20200312,05256P,義隆凱基95售02,0.15,0.15,0.15,0.15,0.00,0.00,300000,1,45000,0,0,0,0,0,0,0,300000,-300000,-300000
20200312,052570,華新科凱基96購06,,,,,0.00,0.00,0,0,0,0,0,0,0,0,0,0,0,0,0
20200312,052571,新光金凱基98購02,,,,,0.00,0.00,0,0,0,0,0,0,0,0,0,0,0,0,0
20200312,052572,群創凱基99購01,0.52,0.52,0.51,0.51,-0.15,-22.73,68000,2,34780,0,0,0,0,0,0,68000,0,68000,68000
20200312,052573,智伸科凱基97購01,,,,,0.00,0.00,0,0,0,0,0,0,0,0,0,0,0,0,0
20200312,052574,茂林凱基96購02,0.35,0.35,0.19,0.19,-0.17,-47.22,293000,10,64460,0,0,0,0,0,0,243000,250000,-7000,-7000
20200312,052575,茂林凱基96購04,0.50,0.50,0.46,0.46,-0.09,-16.36,20000,2,9600,0,0,0,0,0,0,10000,10000,0,0
20200312,052576,聯茂凱基96購01,0.54,0.58,0.41,0.41,-0.43,-51.19,314000,9,146820,0,0,0,0,0,0,99000,215000,-116000,-116000
20200312,052577,台積電統一96購01,0.68,0.68,0.47,0.57,-0.29,-33.72,275000,8,156630,0,0,0,0,0,0,142000,113000,29000,29000
20200312,052578,大立光統一97購01,0.72,0.72,0.72,0.72,-0.70,-49.3,1000,1,720,0,0,0,0,0,0,1000,1000,0,0
20200312,052579,亞泥元富96購01,2.02,2.02,1.83,1.93,-0.27,-12.27,227000,17,437510,0,0,0,0,0,0,120000,107000,13000,13000
20200312,05257P,欣興凱基95售04,2.10,2.36,2.10,2.36,+0.54,29.67,69000,7,151830,0,0,0,0,0,0,47000,43000,4000,4000
20200312,052580,高鐵元富96購01,2.17,2.17,1.98,1.98,-0.50,-20.16,79000,4,166860,0,0,0,0,0,0,59000,20000,39000,39000
20200312,052581,訊芯元富98購01,0.57,0.57,0.49,0.49,-0.22,-30.99,43000,3,22670,0,0,0,0,0,0,23000,20000,3000,3000
20200312,052582,喬山台新96購01,,,,,0.00,0.00,0,0,0,0,0,0,0,0,0,0,0,0,0
20200312,052583,友達台新96購02,,,,,0.00,0.00,0,0,0,0,0,0,0,0,0,0,0,0,0
20200312,052584,喬山永豐96購01,,,,,0.00,0.00,0,0,0,0,0,0,0,0,0,0,0,0,0
20200312,052585,友達永豐97購01,,,,,0.00,0.00,0,0,0,0,0,0,0,0,0,0,0,0,0
20200312,052586,晶豪科永豐96購01,0.85,0.85,0.52,0.54,-0.40,-42.55,166000,23,102690,0,0,0,0,0,0,131000,24000,107000,107000
20200312,052587,景碩永豐97購01,0.15,0.15,0.15,0.15,0.00,0.00,200000,4,30000,0,0,0,0,0,0,0,200000,-200000,-200000
20200312,052588,玉晶光永豐98購01,1.36,1.36,1.07,1.07,0.00,0.00,24000,5,28730,0,0,0,0,0,0,12000,24000,-12000,-12000
20200312,052589,群創永豐97購01,,,,,0.00,0.00,0,0,0,0,0,0,0,0,0,0,0,0,0
20200312,05258P,臺股指凱基96售11,2.03,3.04,2.00,2.84,0.00,0.00,926000,43,2411960,0,0,0,0,0,0,856000,869000,-13000,-13000
20200312,052590,祥碩永豐96購01,2.38,2.38,1.72,1.98,-0.71,-26.39,169000,13,329950,0,0,0,0,0,0,86000,168000,-82000,-82000
20200312,052591,康友永豐97購01,0.37,0.37,0.29,0.32,-0.14,-30.43,1266000,39,406700,0,0,0,0,0,0,0,1266000,-1266000,-1266000
20200312,052592,華通群益98購01,0.09,0.09,0.09,0.09,0.00,0.00,10000,1,900,0,0,0,0,0,0,0,10000,-10000,-10000
20200312,052593,台積電群益96購02,0.10,0.10,0.07,0.10,-0.06,-37.5,817000,22,58390,0,0,0,0,0,0,0,802000,-802000,-802000
20200312,052594,友訊群益98購01,0.63,0.63,0.44,0.44,-0.19,-30.16,314000,12,169080,0,0,0,0,0,0,22000,292000,-270000,-270000
20200312,052595,奇力新群益96購01,0.23,0.23,0.11,0.12,-0.14,-53.85,132000,17,19940,0,0,0,0,0,0,56000,76000,-20000,-20000
20200312,052596,群創群益98購05,0.20,0.20,0.19,0.19,-0.21,-52.5,7000,2,1350,0,0,0,0,0,0,0,7000,-7000,-7000
20200312,052597,茂林群益96購01,0.49,0.49,0.44,0.44,-0.48,-52.17,407000,4,193080,0,0,0,0,0,0,207000,200000,7000,7000
20200312,052598,滬深2X元大96購05,0.67,0.67,0.53,0.55,-0.25,-31.25,269000,13,160010,0,0,0,0,0,0,7000,262000,-255000,-255000
20200312,052599,S&P反1元大96購01,,,,,0.00,0.00,0,0,0,0,0,0,0,0,0,0,0,0,0
20200312,05259P,臺股指凱基96售12,2.05,3.49,2.05,3.42,+1.48,76.29,94000,28,281510,0,0,0,0,0,0,41000,73000,-32000,-32000
20200312,052600,力山元大97購01,0.04,0.04,0.04,0.04,0.00,0.00,2000,1,80,0,0,0,0,0,0,0,2000,-2000,-2000
20200312,052601,大成鋼元大96購01,1.32,1.32,1.17,1.26,-0.13,-9.35,698000,21,870440,0,0,0,0,0,0,485000,467000,18000,18000
20200312,052602,聯電元大97購01,,,,,0.00,0.00,0,0,0,0,0,0,0,0,0,0,0,0,0
20200312,052603,鴻海元大96購15,,,,,0.00,0.00,0,0,0,0,0,0,0,0,0,0,0,0,0
20200312,052604,建準元大97購01,0.47,0.47,0.47,0.47,-0.19,-28.79,12000,2,5640,0,0,0,0,0,0,10000,2000,8000,8000
20200312,052605,聯發科元大96購06,0.03,0.03,0.02,0.02,-0.09,-81.82,504000,51,10130,0,0,0,0,0,0,5000,499000,-494000,-494000
20200312,052606,聯發科元大97購04,0.31,0.31,0.23,0.23,-0.23,-50.0,395000,7,107200,0,0,0,0,0,0,70000,325000,-255000,-255000
20200312,052607,大立光元大96購03,0.50,0.50,0.50,0.50,-0.73,-59.35,55000,2,27500,0,0,0,0,0,0,45000,10000,35000,35000
20200312,052608,欣興元大97購01,0.05,0.10,0.05,0.10,0.00,0.00,360000,2,35500,0,0,0,0,0,0,350000,0,350000,350000
20200312,052609,智易元大97購01,,,,,0.00,0.00,0,0,0,0,0,0,0,0,0,0,0,0,0
20200312,05260P,和碩元富95售02,1.41,1.58,1.36,1.56,+0.25,19.08,282000,18,403640,0,0,0,0,0,0,84000,198000,-114000,-114000
20200312,052610,貿聯元大97購01,0.26,0.26,0.20,0.20,-0.11,-35.48,280000,5,65400,0,0,0,0,0,0,0,280000,-280000,-280000
20200312,052611,力成元大96購02,0.98,0.98,0.76,0.76,-0.36,-32.14,78000,10,72370,0,0,0,0,0,0,78000,1000,77000,77000
20200312,052612,康舒元大97購01,0.64,0.64,0.59,0.59,-0.32,-35.16,92000,5,57580,0,0,0,0,0,0,92000,0,92000,92000
20200312,052613,易華電元大96購01,,,,,0.00,0.00,0,0,0,0,0,0,0,0,0,0,0,0,0
20200312,052614,聯電國泰97購01,0.68,0.68,0.44,0.54,-0.28,-34.15,330000,16,177480,0,0,0,0,0,0,232000,232000,0,0
20200312,052615,鴻海國泰98購01,0.21,0.21,0.15,0.17,0.00,0.00,194000,9,32740,0,0,0,0,0,0,4000,190000,-186000,-186000
20200312,052616,鴻海國泰98購02,0.23,0.23,0.17,0.17,-0.23,-57.5,222000,4,50020,0,0,0,0,0,0,212000,10000,202000,202000
20200312,052617,景碩國泰98購01,1.30,1.30,1.30,1.30,-0.36,-21.69,10000,1,13000,0,0,0,0,0,0,10000,0,10000,10000
20200312,052618,群創國泰98購01,0.29,0.29,0.28,0.28,0.00,0.00,10000,2,2820,0,0,0,0,0,0,0,10000,-10000,-10000
20200312,052619,茂林國泰99購01,0.73,0.73,0.47,0.48,-0.27,-36.0,1513000,16,790490,0,0,0,0,0,0,213000,1323000,-1110000,-1110000
20200312,05261P,鴻海元大95售20,2.17,3.01,2.14,3.01,+1.16,62.7,1146000,53,3158140,0,0,0,0,0,0,836000,763000,73000,73000
20200312,052620,上証2X富邦97購02,,,,,0.00,0.00,0,0,0,0,0,0,0,0,0,0,0,0,0
20200312,052621,台郡富邦97購01,0.28,0.28,0.23,0.23,-0.10,-30.3,38000,8,10070,0,0,0,0,0,0,34000,2000,32000,32000
20200312,052622,貿聯兆豐97購01,,,,,0.00,0.00,0,0,0,0,0,0,0,0,0,0,0,0,0
20200312,052623,台郡兆豐96購01,,,,,0.00,0.00,0,0,0,0,0,0,0,0,0,0,0,0,0
20200312,052624,微星亞東97購01,,,,,0.00,0.00,0,0,0,0,0,0,0,0,0,0,0,0,0
20200312,052625,南電亞東97購01,1.38,1.38,1.04,1.04,0.00,0.00,13000,2,14540,0,0,0,0,0,0,10000,13000,-3000,-3000
20200312,052626,上証2X中信9A購01,0.41,0.41,0.41,0.41,-0.11,-21.15,30000,1,12300,0,0,0,0,0,0,0,30000,-30000,-30000
20200312,052627,中壽中信98購01,0.08,0.09,0.05,0.05,-0.10,-66.67,2003000,204,114120,0,0,0,0,0,0,0,1997000,-1997000,-1997000
20200312,052628,樺漢中信96購01,,,,,0.00,0.00,0,0,0,0,0,0,0,0,0,0,0,0,0
20200312,052629,訊芯中信99購01,0.12,0.12,0.10,0.10,-0.05,-33.33,110000,4,11200,0,0,0,0,0,0,10000,100000,-90000,-90000
20200312,05262P,台積電元大95售19,0.57,0.75,0.57,0.75,+0.24,47.06,1042000,79,742390,0,0,0,0,0,0,1002000,40000,962000,962000
20200312,052630,滬深2X日盛96購01,,,,,0.00,0.00,0,0,0,0,0,0,0,0,0,0,0,0,0
20200312,052631,T50反1凱基98購02,1.05,1.05,1.05,1.05,0.00,0.00,14000,1,14700,0,0,0,0,0,0,14000,0,14000,14000
20200312,052632,喬山凱基96購01,,,,,0.00,0.00,0,0,0,0,0,0,0,0,0,0,0,0,0
20200312,052633,國巨凱基96購05,1.44,1.44,1.34,1.34,-0.80,-37.38,23000,3,32750,0,0,0,0,0,0,23000,16000,7000,7000
20200312,052634,華邦電凱基96購01,0.11,0.11,0.11,0.11,-0.11,-50.0,25000,1,2750,0,0,0,0,0,0,0,25000,-25000,-25000
20200312,052635,奇力新凱基98購01,0.42,0.42,0.26,0.26,-0.26,-50.0,445000,28,158360,0,0,0,0,0,0,414000,20000,394000,394000
20200312,052636,大立光凱基96購10,0.10,0.10,0.06,0.06,-0.19,-76.0,140000,2,12000,0,0,0,0,0,0,0,90000,-90000,-90000
20200312,052637,欣興凱基97購01,0.11,0.11,0.10,0.10,-0.07,-41.18,255000,7,26500,0,0,0,0,0,0,50000,205000,-155000,-155000
20200312,052638,緯創凱基96購02,,,,,0.00,0.00,0,0,0,0,0,0,0,0,0,0,0,0,0
20200312,052639,康控凱基96購02,0.06,0.06,0.06,0.06,0.00,0.00,99000,1,5940,0,0,0,0,0,0,99000,0,99000,99000
20200312,05263P,台積電元大96售09,1.20,1.55,1.19,1.37,+0.26,23.42,1369000,82,1802810,0,0,0,0,0,0,962000,927000,35000,35000
20200312,052640,台表科凱基97購01,0.10,0.10,0.10,0.10,-0.10,-50.0,165000,1,16500,0,0,0,0,0,0,165000,0,165000,165000
20200312,052641,聯詠台新96購01,0.19,0.19,0.19,0.19,0.00,0.00,50000,1,9500,0,0,0,0,0,0,50000,0,50000,50000
20200312,052642,滬深2X永豐96購03,0.65,0.65,0.49,0.49,-0.56,-53.33,10000,3,5660,0,0,0,0,0,0,0,10000,-10000,-10000
20200312,052643,華通永豐96購02,,,,,0.00,0.00,0,0,0,0,0,0,0,0,0,0,0,0,0
20200312,052644,聯發科永豐96購01,0.20,0.20,0.11,0.11,-0.14,-56.0,646000,6,90570,0,0,0,0,0,0,516000,130000,386000,386000
20200312,052645,美食永豐96購01,,,,,0.00,0.00,0,0,0,0,0,0,0,0,0,0,0,0,0
20200312,052646,淘帝永豐96購01,0.07,0.07,0.07,0.07,-0.03,-30.0,30000,1,2100,0,0,0,0,0,0,30000,0,30000,30000
20200312,052647,晶技永豐97購01,2.05,2.09,1.22,1.22,-0.71,-36.79,305000,28,552580,0,0,0,0,0,0,237000,2000,235000,235000
20200312,052648,茂林永豐96購01,0.15,0.15,0.14,0.14,-0.01,-6.67,41000,3,5950,0,0,0,0,0,0,0,41000,-41000,-41000
20200312,052649,康控永豐96購01,,,,,0.00,0.00,0,0,0,0,0,0,0,0,0,0,0,0,0
20200312,05264P,微星元大95售02,1.54,1.54,1.48,1.54,+0.28,22.22,449000,6,678300,0,0,0,0,0,0,0,449000,-449000,-449000
20200312,052650,台郡永豐96購01,0.23,0.23,0.23,0.23,-0.07,-23.33,30000,1,6900,0,0,0,0,0,0,0,30000,-30000,-30000
20200312,052651,台表科永豐96購02,,,,,0.00,0.00,0,0,0,0,0,0,0,0,0,0,0,0,0
20200312,052652,台虹永豐96購01,0.50,0.50,0.41,0.42,-0.28,-40.0,21000,3,9030,0,0,0,0,0,0,6000,15000,-9000,-9000
20200312,052653,臺股指永豐97購01,0.13,0.13,0.11,0.11,-0.07,-38.89,118000,13,13080,0,0,0,0,0,0,0,115000,-115000,-115000
20200312,052654,友達統一97購01,,,,,0.00,0.00,0,0,0,0,0,0,0,0,0,0,0,0,0
20200312,052655,群創統一97購01,0.21,0.21,0.14,0.14,-0.15,-51.72,718000,12,116220,0,0,0,0,0,0,198000,520000,-322000,-322000
20200312,052656,力山元富96購01,,,,,0.00,0.00,0,0,0,0,0,0,0,0,0,0,0,0,0
20200312,052657,友達元富96購01,,,,,0.00,0.00,0,0,0,0,0,0,0,0,0,0,0,0,0
20200312,052658,友達元富9C購01,0.80,0.80,0.69,0.69,-0.27,-28.13,406000,8,308080,0,0,0,0,0,0,0,406000,-406000,-406000
20200312,052659,上証2X國票99購01,,,,,0.00,0.00,0,0,0,0,0,0,0,0,0,0,0,0,0
20200312,05265P,正崴元大95售03,2.27,2.56,2.27,2.56,0.00,0.00,35000,2,80900,0,0,0,0,0,0,5000,30000,-25000,-25000
20200312,052660,京元電國票97購01,0.60,0.60,0.43,0.45,-0.36,-44.44,50000,3,23150,0,0,0,0,0,0,5000,45000,-40000,-40000
20200312,052661,奇力新國票97購03,0.51,0.51,0.29,0.29,-0.34,-53.97,96000,17,40770,0,0,0,0,0,0,96000,0,96000,96000
20200312,052662,華新科國票97購01,2.85,2.85,1.91,1.91,-2.49,-56.59,28000,7,56330,0,0,0,0,0,0,0,28000,-28000,-28000
20200312,052663,奇鋐國票97購01,0.46,0.48,0.36,0.36,-0.24,-40.0,548000,19,227980,0,0,0,0,0,0,100000,448000,-348000,-348000
20200312,052664,麗豐國票96購02,,,,,0.00,0.00,0,0,0,0,0,0,0,0,0,0,0,0,0
20200312,052665,緯穎國票96購03,2.03,2.03,1.93,1.93,0.00,0.00,50000,5,98600,0,0,0,0,0,0,0,50000,-50000,-50000
20200312,052666,瑞昱群益96購01,0.07,0.07,0.07,0.07,0.00,0.00,10000,2,700,0,0,0,0,0,0,0,10000,-10000,-10000
20200312,052667,漢唐群益96購01,0.53,0.53,0.51,0.51,-0.38,-42.7,21000,2,10930,0,0,0,0,0,0,0,21000,-21000,-21000
20200312,052668,聯發科群益97購01,0.19,0.19,0.18,0.18,-0.37,-67.27,210000,2,39800,0,0,0,0,0,0,200000,10000,190000,190000
20200312,052669,群創群益98購06,0.13,0.13,0.10,0.10,-0.09,-47.37,340000,26,35900,0,0,0,0,0,0,0,250000,-250000,-250000
20200312,05266P,華新科元大95售11,0.32,0.49,0.32,0.49,+0.25,104.17,125000,4,47050,0,0,0,0,0,0,125000,0,125000,125000
20200312,052670,茂林群益96購02,0.28,0.28,0.23,0.23,-0.07,-23.33,29000,4,7170,0,0,0,0,0,0,29000,0,29000,29000
20200312,052671,祥碩群益96購01,4.92,4.92,4.92,4.92,-1.38,-21.9,2000,1,9840,0,0,0,0,0,0,0,2000,-2000,-2000
20200312,052672,世紀鋼群益96購02,1.15,1.23,1.02,1.13,-0.24,-17.52,442000,17,493380,0,0,0,0,0,0,310000,132000,178000,178000
20200312,052673,T50反1國泰97購01,1.50,1.50,1.50,1.50,0.00,0.00,690000,2,1035000,0,0,0,0,0,0,690000,0,690000,690000
20200312,052674,智邦國泰98購01,1.65,1.65,1.19,1.30,-0.36,-21.69,530000,36,742430,0,0,0,0,0,0,180000,328000,-148000,-148000
20200312,052675,新光金國泰98購01,0.23,0.23,0.23,0.23,0.00,0.00,3000,1,690,0,0,0,0,0,0,3000,0,3000,3000
20200312,052676,聯發科永昌98購01,0.82,0.82,0.60,0.63,-0.31,-32.98,232000,6,146830,0,0,0,0,0,0,222000,189000,33000,33000
20200312,052677,景碩富邦97購01,0.08,0.08,0.08,0.08,-0.05,-38.46,5000,2,400,0,0,0,0,0,0,0,0,0,0
20200312,052678,群創富邦96購01,0.12,0.12,0.08,0.08,0.00,0.00,850000,12,77000,0,0,0,0,0,0,10000,600000,-590000,-590000
20200312,052679,致伸富邦98購01,0.10,0.10,0.08,0.08,-0.04,-33.33,130000,7,11800,0,0,0,0,0,0,0,50000,-50000,-50000
20200312,05267P,欣興元大95售08,1.96,1.96,1.96,1.96,+0.34,20.99,2000,1,3920,0,0,0,0,0,0,2000,0,2000,2000
20200312,052680,T50反1元大96購04,,,,,0.00,0.00,0,0,0,0,0,0,0,0,0,0,0,0,0
20200312,052681,T50反1元大98購02,1.06,1.33,1.06,1.33,+0.45,51.14,74000,3,88790,0,0,0,0,0,0,38000,36000,2000,2000
20200312,052682,上銀元大97購01,2.03,2.03,1.43,1.50,-0.80,-34.78,134000,13,231040,0,0,0,0,0,0,110000,84000,26000,26000
20200312,052683,鴻海元大97購03,0.14,0.14,0.14,0.14,-0.11,-44.0,100000,2,14000,0,0,0,0,0,0,50000,50000,0,0
20200312,052684,旺宏元大98購01,0.64,0.66,0.45,0.50,-0.22,-30.56,278000,8,151480,0,0,0,0,0,0,141000,144000,-3000,-3000
20200312,052685,技嘉元大96購01,1.11,1.11,0.84,0.93,-0.24,-20.51,268000,15,266480,0,0,0,0,0,0,261000,73000,188000,188000
20200312,052686,華新科元大96購03,1.50,1.50,1.16,1.30,-0.54,-29.35,115000,3,145500,0,0,0,0,0,0,65000,115000,-50000,-50000
20200312,052687,國泰金元大96購03,0.33,0.33,0.30,0.30,-0.13,-30.23,374000,8,112480,0,0,0,0,0,0,354000,39000,315000,315000
20200312,052688,新日興元大96購01,1.12,1.12,0.65,0.65,-0.57,-46.72,762000,21,624890,0,0,0,0,0,0,110000,652000,-542000,-542000
20200312,052689,玉晶光元大98購03,1.16,1.19,1.16,1.16,-0.55,-32.16,23000,5,26710,0,0,0,0,0,0,3000,23000,-20000,-20000
20200312,05268P,玉晶光元大98售01,0.87,1.03,0.87,1.03,+0.19,22.62,2928000,74,2821470,0,0,0,0,0,0,1379000,1496000,-117000,-117000
20200312,052690,台表科元大97購01,0.31,0.31,0.18,0.18,-0.21,-53.85,504000,15,144960,0,0,0,0,0,0,439000,65000,374000,374000
20200312,052691,GIS元大96購01,0.38,0.38,0.20,0.20,-0.21,-51.22,147000,7,40760,0,0,0,0,0,0,10000,137000,-127000,-127000
20200312,052692,滬深2X中信99購02,,,,,0.00,0.00,0,0,0,0,0,0,0,0,0,0,0,0,0
20200312,052693,微星中信96購01,0.89,0.89,0.76,0.76,-0.22,-22.45,110000,5,94000,0,0,0,0,0,0,95000,15000,80000,80000
20200312,052694,開發金中信98購01,,,,,0.00,0.00,0,0,0,0,0,0,0,0,0,0,0,0,0
20200312,052695,台表科中信98購01,0.04,0.04,0.04,0.04,-0.04,-50.0,130000,14,5200,0,0,0,0,0,0,0,130000,-130000,-130000
20200312,052696,玉晶光麥證97購01,3.30,3.30,2.56,2.64,-1.27,-32.48,36000,8,112000,0,36000,-36000,0,0,0,5000,36000,-31000,-31000
20200312,052697,滬深2X國票98購01,,,,,0.00,0.00,0,0,0,0,0,0,0,0,0,0,0,0,0
20200312,052698,深中小國票99購01,1.72,1.72,1.53,1.53,-0.47,-23.5,432000,43,673240,0,0,0,0,0,0,12000,420000,-408000,-408000
20200312,052699,友達國票97購01,0.45,0.45,0.45,0.45,-0.20,-30.77,10000,1,4500,0,0,0,0,0,0,10000,0,10000,10000
20200312,05269P,臻鼎元大95售05,,,,,0.00,0.00,0,0,0,0,0,0,0,0,0,0,0,0,0
20200312,052700,奇鋐國票97購02,0.52,0.53,0.44,0.44,-0.26,-37.14,30000,3,14900,0,0,0,0,0,0,10000,20000,-10000,-10000
20200312,052701,群創國票96購01,0.22,0.22,0.14,0.16,0.00,0.00,416000,8,70540,0,0,0,0,0,0,226000,190000,36000,36000
20200312,052702,群創國票97購03,0.15,0.15,0.12,0.12,-0.16,-57.14,45000,5,6250,0,0,0,0,0,0,10000,35000,-25000,-25000
20200312,052703,貿聯國票97購01,0.31,0.32,0.31,0.32,-0.15,-31.91,60000,5,18870,0,0,0,0,0,0,60000,0,60000,60000
20200312,052704,TPK國票97購01,,,,,0.00,0.00,0,0,0,0,0,0,0,0,0,0,0,0,0
20200312,052705,超眾國票97購01,1.13,1.13,0.94,0.94,-0.53,-36.05,53000,6,54720,0,0,0,0,0,0,10000,43000,-33000,-33000
20200312,052706,台虹國票97購01,1.78,1.78,1.42,1.45,-0.99,-40.57,92000,10,147100,0,0,0,0,0,0,42000,50000,-8000,-8000
20200312,052707,景碩台新96購01,0.28,0.28,0.14,0.16,-0.26,-61.9,89000,11,13830,0,0,0,0,0,0,4000,85000,-81000,-81000
20200312,052708,楠梓電永豐97購01,,,,,0.00,0.00,0,0,0,0,0,0,0,0,0,0,0,0,0
20200312,052709,光寶科日盛96購01,,,,,0.00,0.00,0,0,0,0,0,0,0,0,0,0,0,0,0
20200312,05270P,台表科元大95售05,0.71,0.98,0.70,0.97,+0.24,32.88,306000,11,244450,0,0,0,0,0,0,76000,230000,-154000,-154000
20200312,052710,玉晶光日盛96購01,,,,,0.00,0.00,0,0,0,0,0,0,0,0,0,0,0,0,0
20200312,052711,滬深2X凱基97購01,,,,,0.00,0.00,0,0,0,0,0,0,0,0,0,0,0,0,0
20200312,052712,旺宏凱基96購02,0.45,0.45,0.41,0.41,-0.20,-32.79,81000,2,36410,0,0,0,0,0,0,81000,1000,80000,80000
20200312,052713,智邦凱基96購01,0.67,0.67,0.35,0.46,-0.29,-38.67,149000,22,74730,0,0,0,0,0,0,45000,105000,-60000,-60000
20200312,052714,義隆凱基96購02,,,,,0.00,0.00,0,0,0,0,0,0,0,0,0,0,0,0,0
20200312,052715,可成凱基96購01,,,,,0.00,0.00,0,0,0,0,0,0,0,0,0,0,0,0,0
20200312,052716,欣興凱基96購01,,,,,0.00,0.00,0,0,0,0,0,0,0,0,0,0,0,0,0
20200312,052717,正文凱基96購01,,,,,0.00,0.00,0,0,0,0,0,0,0,0,0,0,0,0,0
20200312,052718,新唐凱基96購01,,,,,0.00,0.00,0,0,0,0,0,0,0,0,0,0,0,0,0
20200312,052719,致新凱基96購01,0.31,0.31,0.24,0.24,-0.13,-35.14,44000,2,12240,0,0,0,0,0,0,24000,20000,4000,4000
20200312,05271P,國巨富邦97售01,0.45,0.47,0.45,0.47,0.00,0.00,20000,2,9200,0,0,0,0,0,0,0,10000,-10000,-10000
20200312,052720,鴻海統一96購07,,,,,0.00,0.00,0,0,0,0,0,0,0,0,0,0,0,0,0
20200312,052721,友達統一96購01,0.40,0.40,0.31,0.31,-0.19,-38.0,128000,3,42280,0,0,0,0,0,0,128000,0,128000,128000
20200312,052722,群創統一97購02,,,,,0.00,0.00,0,0,0,0,0,0,0,0,0,0,0,0,0
20200312,052723,新唐統一97購01,,,,,0.00,0.00,0,0,0,0,0,0,0,0,0,0,0,0,0
20200312,052724,力成統一97購01,1.27,1.30,1.14,1.14,-0.49,-30.06,108000,10,132740,0,0,0,0,0,0,30000,78000,-48000,-48000
20200312,052725,為升元富96購01,,,,,0.00,0.00,0,0,0,0,0,0,0,0,0,0,0,0,0
20200312,052726,鴻海元富96購03,0.07,0.08,0.05,0.08,-0.04,-33.33,621000,16,38080,0,0,0,0,0,0,30000,590000,-560000,-560000
20200312,052727,仁寶元富96購01,0.60,0.60,0.49,0.51,-0.18,-26.09,100000,9,52800,0,0,0,0,0,0,30000,70000,-40000,-40000
20200312,052728,上証2X國泰97購01,,,,,0.00,0.00,0,0,0,0,0,0,0,0,0,0,0,0,0
20200312,052729,國巨國泰97購03,1.90,1.90,1.60,1.60,-1.33,-45.39,4000,2,7000,0,0,0,0,0,0,0,4000,-4000,-4000
20200312,05272P,臻鼎中信97售03,0.65,0.92,0.65,0.92,+0.31,50.82,237000,15,190840,0,0,0,0,0,0,183000,54000,129000,129000
20200312,052730,華新科國泰98購01,,,,,0.00,0.00,0,0,0,0,0,0,0,0,0,0,0,0,0
20200312,052731,宏達電國泰98購01,1.11,1.11,0.76,0.77,-0.34,-30.63,284000,18,242590,0,0,0,0,0,0,51000,233000,-182000,-182000
20200312,052732,新唐國泰97購01,,,,,0.00,0.00,0,0,0,0,0,0,0,0,0,0,0,0,0
20200312,052733,台郡國泰97購01,1.19,1.19,0.76,0.80,-0.63,-44.06,1049000,31,923590,0,0,0,0,0,0,417000,717000,-300000,-300000
20200312,052734,台表科國泰98購02,,,,,0.00,0.00,0,0,0,0,0,0,0,0,0,0,0,0,0
20200312,052735,燿華富邦98購01,,,,,0.00,0.00,0,0,0,0,0,0,0,0,0,0,0,0,0
20200312,052736,T50反1元大96購05,1.19,1.45,1.19,1.38,0.00,0.00,1981000,12,2820490,0,0,0,0,0,0,13000,1968000,-1955000,-1955000
20200312,052737,滬深2X元大96購06,,,,,0.00,0.00,0,0,0,0,0,0,0,0,0,0,0,0,0
20200312,052738,聯電元大98購02,0.66,0.66,0.49,0.58,-0.16,-21.62,526000,20,289020,20000,0,20000,0,0,0,155000,371000,-216000,-196000
20200312,052739,國巨元大96購04,1.86,1.86,1.25,1.25,-0.66,-34.55,20000,8,31820,0,0,0,0,0,0,0,20000,-20000,-20000
20200312,05273P,國巨群益95售02,0.84,0.84,0.84,0.84,0.00,0.00,50000,1,42000,0,0,0,0,0,0,50000,0,50000,50000
20200312,052740,聯發科元大96購07,0.18,0.18,0.08,0.09,-0.14,-60.87,612000,10,75780,0,0,0,0,0,0,50000,562000,-512000,-512000
20200312,052741,聯發科元大96購08,0.20,0.20,0.10,0.11,-0.24,-68.57,330000,17,47000,0,0,0,0,0,0,165000,165000,0,0
20200312,052742,可成元大96購01,0.54,0.54,0.30,0.32,-0.43,-57.33,350000,20,129010,0,0,0,0,0,0,180000,292000,-112000,-112000
20200312,052743,華新科元大97購01,2.03,2.03,1.45,1.45,-0.61,-29.61,110000,3,194300,0,0,0,0,0,0,100000,60000,40000,40000
20200312,052744,聯詠元大97購01,0.34,0.35,0.25,0.25,-0.22,-46.81,74000,6,21850,0,0,0,0,0,0,69000,5000,64000,64000
20200312,052745,欣興元大96購04,0.20,0.20,0.15,0.15,0.00,0.00,48000,5,7600,0,0,0,0,0,0,0,48000,-48000,-48000
20200312,052746,泰碩元大97購01,0.56,0.59,0.54,0.54,-0.23,-29.87,39000,5,22160,0,0,0,0,0,0,0,39000,-39000,-39000
20200312,052747,京鼎元大97購01,0.59,0.59,0.42,0.42,-0.29,-40.85,527000,20,275970,0,0,0,0,0,0,190000,337000,-147000,-147000
20200312,052748,群創元大9A購02,0.24,0.24,0.20,0.21,0.00,0.00,30000,4,6500,0,0,0,0,0,0,0,30000,-30000,-30000
20200312,052749,日月光元大96購02,0.35,0.35,0.17,0.17,-0.26,-60.47,187000,6,43240,0,0,0,0,0,0,167000,10000,157000,157000
20200312,05274P,嘉聯益亞東95售01,1.32,1.32,1.32,1.32,0.00,0.00,50000,1,66000,0,0,0,0,0,0,0,50000,-50000,-50000
20200312,052750,臺股指元大96購04,0.38,0.38,0.13,0.20,-0.26,-56.52,4417000,105,989550,0,0,0,0,0,0,585000,3297000,-2712000,-2712000
20200312,052751,臺股指元大96購05,0.16,0.16,0.05,0.16,-0.08,-33.33,731000,15,100610,0,0,0,0,0,0,310000,391000,-81000,-81000
20200312,052752,臺股指元大96購06,0.03,0.03,0.03,0.03,-0.10,-76.92,900000,2,27000,0,0,0,0,0,0,900000,0,900000,900000
20200312,052753,電子類元大96購02,0.65,0.65,0.34,0.36,-0.39,-52.0,123000,15,48630,0,0,0,0,0,0,0,123000,-123000,-123000
20200312,052754,上証2X群益9A購01,1.13,1.13,1.13,1.13,0.00,0.00,20000,1,22600,0,0,0,0,0,0,0,20000,-20000,-20000
20200312,052755,滬深2X群益9A購01,,,,,0.00,0.00,0,0,0,0,0,0,0,0,0,0,0,0,0
20200312,052756,國巨群益96購02,,,,,0.00,0.00,0,0,0,0,0,0,0,0,0,0,0,0,0
20200312,052757,華邦電群益96購01,,,,,0.00,0.00,0,0,0,0,0,0,0,0,0,0,0,0,0
20200312,052758,友達群益99購01,0.40,0.40,0.40,0.40,0.00,0.00,2000,1,800,0,0,0,0,0,0,2000,0,2000,2000
20200312,052759,京元電群益96購01,0.51,0.51,0.30,0.31,-0.41,-56.94,110000,11,40970,0,0,0,0,0,0,39000,71000,-32000,-32000
20200312,05275P,國巨凱基95售05,0.37,0.59,0.36,0.55,+0.20,57.14,862000,24,372060,0,0,0,0,0,0,606000,251000,355000,355000
20200312,052760,盟立群益96購01,0.24,0.24,0.17,0.17,-0.14,-45.16,85000,4,15100,0,0,0,0,0,0,55000,30000,25000,25000
20200312,052761,可成群益96購02,0.36,0.36,0.16,0.16,-0.49,-75.38,106000,2,36560,0,0,0,0,0,0,98000,8000,90000,90000
20200312,052762,欣興群益96購01,0.05,0.05,0.05,0.05,-0.05,-50.0,100000,1,5000,0,0,0,0,0,0,0,100000,-100000,-100000
20200312,052763,晶技群益97購01,3.05,3.18,2.10,2.10,-1.11,-34.58,158000,23,474230,0,0,0,0,0,0,115000,50000,65000,65000
20200312,052764,景碩群益98購01,0.55,0.55,0.39,0.39,-0.35,-47.3,33000,2,16070,0,0,0,0,0,0,13000,20000,-7000,-7000
20200312,052765,新日興群益97購01,1.06,1.06,0.80,0.80,-0.39,-32.77,168000,5,146800,0,0,0,0,0,0,50000,108000,-58000,-58000
20200312,052766,玉晶光群益9A購01,5.05,5.05,3.70,3.70,-1.80,-32.73,135000,13,621160,0,0,0,0,0,0,35000,105000,-70000,-70000
20200312,052767,智伸科群益98購01,,,,,0.00,0.00,0,0,0,0,0,0,0,0,0,0,0,0,0
20200312,052768,泰鼎群益96購01,1.63,1.63,0.99,0.99,-1.07,-51.94,107000,13,138530,0,0,0,0,0,0,21000,91000,-70000,-70000
20200312,052769,達興群益96購01,1.19,1.19,1.19,1.19,-0.61,-33.89,10000,1,11900,0,0,0,0,0,0,0,10000,-10000,-10000
20200312,05276P,GIS永豐95售02,1.15,1.48,1.15,1.48,+0.40,37.04,138000,7,169290,0,0,0,0,0,0,85000,53000,32000,32000
20200312,052770,聯茂群益96購02,1.41,1.41,1.02,1.02,-0.63,-38.18,73000,8,86990,0,0,0,0,0,0,32000,52000,-20000,-20000
20200312,052771,GIS群益96購01,0.46,0.46,0.28,0.29,-0.24,-45.28,31000,3,10760,0,0,0,0,0,0,11000,20000,-9000,-9000
20200312,052772,台虹群益96購01,1.58,1.58,1.24,1.24,-0.97,-43.89,57000,3,72460,0,0,0,0,0,0,56000,1000,55000,55000
20200312,052773,大成鋼亞東97購01,,,,,0.00,0.00,0,0,0,0,0,0,0,0,0,0,0,0,0
20200312,052774,京元電亞東96購01,,,,,0.00,0.00,0,0,0,0,0,0,0,0,0,0,0,0,0
20200312,052775,滬深2X國票99購02,,,,,0.00,0.00,0,0,0,0,0,0,0,0,0,0,0,0,0
20200312,052776,力山國票97購01,0.06,0.06,0.06,0.06,-0.07,-53.85,20000,1,1200,0,0,0,0,0,0,0,20000,-20000,-20000
20200312,052777,燿華國票98購01,0.43,0.43,0.43,0.43,-0.26,-37.68,1000,1,430,0,0,0,0,0,0,1000,0,1000,1000
20200312,052778,智原國票97購01,0.27,0.27,0.16,0.16,0.00,0.00,165000,5,30500,0,0,0,0,0,0,0,165000,-165000,-165000
20200312,052779,欣興國票97購01,0.22,0.22,0.17,0.18,-0.33,-64.71,258000,3,53760,0,0,0,0,0,0,0,258000,-258000,-258000
20200312,05277P,深中小統一95售02,,,,,0.00,0.00,0,0,0,0,0,0,0,0,0,0,0,0,0
20200312,052780,玉晶光國票96購04,3.36,3.36,2.48,2.48,-1.89,-43.25,147000,5,452940,0,0,0,0,0,0,93000,57000,36000,36000
20200312,052781,瀚宇博國票97購03,,,,,0.00,0.00,0,0,0,0,0,0,0,0,0,0,0,0,0
20200312,052782,超眾國票96購02,1.50,1.50,1.20,1.20,-0.83,-40.89,39000,5,53480,0,0,0,0,0,0,10000,29000,-19000,-19000
20200312,052783,台郡國票97購01,0.60,0.60,0.38,0.44,-0.52,-54.17,293000,16,125560,0,0,0,0,0,0,12000,281000,-269000,-269000
20200312,052784,緯穎國票97購02,6.05,6.05,4.84,4.84,-3.36,-40.98,484000,8,2527940,0,0,0,0,0,0,0,484000,-484000,-484000
20200312,052785,滬深2X中信99購03,1.10,1.10,0.98,0.98,-0.21,-17.65,680000,10,703000,0,0,0,0,0,0,180000,500000,-320000,-320000
20200312,052786,S&P500中信96購01,0.09,0.09,0.04,0.07,-0.06,-46.15,623000,60,37310,0,0,0,0,0,0,0,495000,-495000,-495000
20200312,052787,國巨中信96購02,1.00,1.00,0.52,0.52,-0.46,-46.94,859000,38,562460,0,0,0,0,0,0,775000,710000,65000,65000
20200312,052788,開發金中信98購02,,,,,0.00,0.00,0,0,0,0,0,0,0,0,0,0,0,0,0
20200312,052789,台積電麥證96購01,1.76,1.76,1.46,1.46,-1.00,-40.65,657000,20,1099300,0,657000,-657000,0,0,0,0,657000,-657000,-657000
20200312,05278P,台郡元富95售02,0.94,1.12,0.94,1.03,+0.29,39.19,534000,12,561460,0,0,0,0,0,0,16000,518000,-502000,-502000
20200312,052790,智邦兆豐97購01,1.35,1.35,1.06,1.15,-0.32,-21.77,81000,9,103450,0,0,0,0,0,0,56000,27000,29000,29000
20200312,052791,友達兆豐97購01,,,,,0.00,0.00,0,0,0,0,0,0,0,0,0,0,0,0,0
20200312,052792,大立光兆豐96購01,0.43,0.44,0.30,0.30,-0.49,-62.03,40000,3,16780,0,0,0,0,0,0,35000,5000,30000,30000
20200312,052793,健鼎兆豐96購01,0.09,0.09,0.09,0.09,0.00,0.00,40000,2,3600,0,0,0,0,0,0,0,40000,-40000,-40000
20200312,052794,群創兆豐97購01,0.17,0.17,0.17,0.17,0.00,0.00,250000,1,42500,0,0,0,0,0,0,250000,0,250000,250000
20200312,052795,健策兆豐97購01,0.75,0.75,0.70,0.70,-0.46,-39.66,38000,2,27850,0,0,0,0,0,0,0,38000,-38000,-38000
20200312,052796,和碩兆豐96購01,,,,,0.00,0.00,0,0,0,0,0,0,0,0,0,0,0,0,0
20200312,052797,樺漢兆豐96購01,0.28,0.28,0.26,0.26,-0.12,-31.58,38000,2,10100,0,0,0,0,0,0,38000,0,38000,38000
20200312,052798,滬深2X元大96購07,0.75,0.75,0.60,0.70,-0.18,-20.45,210000,10,140050,0,0,0,0,0,0,10000,200000,-190000,-190000
20200312,052799,上銀元大96購01,2.36,2.36,1.59,1.59,-1.26,-44.21,51000,6,109270,0,0,0,0,0,0,37000,16000,21000,21000
20200312,05279P,上銀元大95售02,0.61,1.00,0.61,0.90,0.00,0.00,185000,21,132200,0,0,0,0,0,0,0,185000,-185000,-185000
20200312,052800,國巨元大96購05,,,,,0.00,0.00,0,0,0,0,0,0,0,0,0,0,0,0,0
20200312,052801,友達元大9A購01,0.75,0.79,0.72,0.72,-0.35,-32.71,138000,3,106320,0,0,0,0,0,0,128000,88000,40000,40000
20200312,052802,華新科元大97購02,1.83,1.83,1.83,1.83,-0.23,-11.17,25000,1,45750,0,0,0,0,0,0,0,25000,-25000,-25000
20200312,052803,冠德元大96購01,0.07,0.07,0.07,0.07,-0.05,-41.67,30000,2,2100,0,0,0,0,0,0,0,30000,-30000,-30000
20200312,052804,淘帝元大96購01,0.21,0.21,0.16,0.16,-0.08,-33.33,199000,2,36840,0,0,0,0,0,0,0,199000,-199000,-199000
20200312,052805,晶技元大97購01,1.88,1.88,1.10,1.12,-0.72,-39.13,1106000,96,1647380,6000,0,6000,0,0,0,706000,419000,287000,293000
20200312,052806,玉晶光元大98購04,3.65,3.65,2.62,2.71,-1.14,-29.61,94000,13,279320,0,0,0,0,0,0,54000,79000,-25000,-25000
20200312,052807,貿聯元大98購01,0.47,0.47,0.35,0.39,-0.18,-31.58,252000,3,97000,0,0,0,0,0,0,40000,212000,-172000,-172000
20200312,052808,矽力元大96購02,2.02,2.17,2.02,2.13,-0.63,-22.83,52000,3,107310,0,0,0,0,0,0,17000,35000,-18000,-18000
20200312,052809,訊芯元大97購01,0.55,0.55,0.41,0.41,-0.20,-32.79,342000,18,166430,0,0,0,0,0,0,262000,101000,161000,161000
20200312,05280P,華通元大95售08,2.83,3.12,2.83,3.12,+0.88,39.29,22000,2,62840,0,0,0,0,0,0,22000,0,22000,22000
20200312,052810,易華電元大96購02,0.13,0.13,0.13,0.13,0.00,0.00,15000,1,1950,0,0,0,0,0,0,0,15000,-15000,-15000
20200312,052811,玉晶光台新96購03,1.52,1.54,1.29,1.34,-1.01,-42.98,5000,4,7030,0,0,0,0,0,0,5000,5000,0,0
20200312,052812,致伸康和96購01,,,,,0.00,0.00,0,0,0,0,0,0,0,0,0,0,0,0,0
20200312,052813,T50正2永豐96購01,0.30,0.30,0.13,0.16,-0.20,-55.56,1601000,144,287820,0,0,0,0,0,0,34000,1527000,-1493000,-1493000
20200312,052814,上証2X永豐96購02,0.82,0.86,0.64,0.66,-0.35,-34.65,955000,73,704740,0,0,0,0,0,0,173000,679000,-506000,-506000
20200312,052815,滬深2X永豐97購01,,,,,0.00,0.00,0,0,0,0,0,0,0,0,0,0,0,0,0
20200312,052816,上銀永豐96購01,0.88,0.88,0.87,0.87,-0.39,-30.95,60000,3,52300,0,0,0,0,0,0,60000,8000,52000,52000
20200312,052817,楠梓電永豐96購02,0.46,0.46,0.36,0.36,-0.32,-47.06,52000,16,22690,0,0,0,0,0,0,42000,10000,32000,32000
20200312,052818,智邦永豐96購01,0.60,0.60,0.60,0.60,-0.06,-9.09,68000,1,40800,0,0,0,0,0,0,68000,0,68000,68000
20200312,052819,義隆永豐96購01,0.70,0.70,0.63,0.63,-0.34,-35.05,83000,2,57050,0,0,0,0,0,0,83000,0,83000,83000
20200312,05281P,南亞科元大95售03,1.23,1.23,1.23,1.23,+0.32,35.16,25000,1,30750,0,0,0,0,0,0,25000,0,25000,25000
20200312,052820,宏達電永豐96購01,,,,,0.00,0.00,0,0,0,0,0,0,0,0,0,0,0,0,0
20200312,052821,晶技永豐96購01,1.08,1.08,0.48,0.48,-0.59,-55.14,348000,34,299570,0,0,0,0,0,0,205000,23000,182000,182000
20200312,052822,泰碩永豐97購01,0.63,0.63,0.46,0.58,-0.19,-24.68,91000,6,45930,0,0,0,0,0,0,0,91000,-91000,-91000
20200312,052823,創意永豐96購02,0.29,0.29,0.29,0.29,-0.06,-17.14,1000,1,290,0,0,0,0,0,0,1000,0,1000,1000
20200312,052824,揚明光永豐96購02,,,,,0.00,0.00,0,0,0,0,0,0,0,0,0,0,0,0,0
20200312,052825,TPK永豐96購01,,,,,0.00,0.00,0,0,0,0,0,0,0,0,0,0,0,0,0
20200312,052826,嘉聯益永豐96購01,,,,,0.00,0.00,0,0,0,0,0,0,0,0,0,0,0,0,0
20200312,052827,昇陽半永豐97購01,0.42,0.42,0.37,0.37,-0.21,-36.21,15000,2,6050,0,0,0,0,0,0,0,15000,-15000,-15000
20200312,052828,滬深2X群益9A購02,0.33,0.33,0.30,0.30,-0.10,-25.0,130000,6,41100,0,0,0,0,0,0,0,130000,-130000,-130000
20200312,052829,上銀群益96購01,1.52,1.52,0.95,0.95,-1.30,-57.78,113000,11,160880,0,0,0,0,0,0,73000,63000,10000,10000
20200312,05282P,可成元大95售09,2.21,2.54,2.19,2.52,+0.63,33.33,60000,8,135690,0,0,0,0,0,0,46000,14000,32000,32000
20200312,052830,台光電群益96購01,0.74,0.74,0.54,0.58,-0.28,-32.56,174000,12,102880,0,0,0,0,0,0,134000,44000,90000,90000
20200312,052831,華固群益96購01,1.02,1.08,1.01,1.08,0.00,0.00,107000,16,112540,0,0,0,0,0,0,0,107000,-107000,-107000
20200312,052832,益航群益96購01,0.32,0.32,0.19,0.20,-0.14,-41.18,382000,9,107880,0,0,0,0,0,0,100000,282000,-182000,-182000
20200312,052833,康控群益96購01,0.30,0.33,0.23,0.23,-0.22,-48.89,396000,8,108140,0,0,0,0,0,0,274000,118000,156000,156000
20200312,052834,彩晶群益96購01,,,,,0.00,0.00,0,0,0,0,0,0,0,0,0,0,0,0,0
20200312,052835,滬深2X國泰98購01,,,,,0.00,0.00,0,0,0,0,0,0,0,0,0,0,0,0,0
20200312,052836,旺宏國泰98購01,0.86,0.93,0.63,0.68,-0.37,-35.24,366000,23,285910,0,0,0,0,0,0,322000,288000,34000,34000
20200312,052837,友達國泰97購01,,,,,0.00,0.00,0,0,0,0,0,0,0,0,0,0,0,0,0
20200312,052838,新唐國泰98購01,0.68,0.68,0.54,0.54,-0.22,-28.95,456000,9,275620,0,0,0,0,0,0,206000,250000,-44000,-44000
20200312,052839,上海銀國泰97購01,0.70,0.70,0.48,0.48,-0.29,-37.66,181000,12,114600,0,0,0,0,0,0,44000,137000,-93000,-93000
20200312,05283P,健鼎元大95售04,1.72,1.87,1.72,1.87,+0.31,19.87,458000,11,822560,0,0,0,0,0,0,130000,298000,-168000,-168000
20200312,052840,友達富邦96購01,0.24,0.24,0.23,0.23,0.00,0.00,15000,2,3550,0,0,0,0,0,0,10000,5000,5000,5000
20200312,052841,群創富邦96購02,0.09,0.09,0.09,0.09,0.00,0.00,10000,1,900,0,0,0,0,0,0,0,10000,-10000,-10000
20200312,052842,滬深2X統一96購01,,,,,0.00,0.00,0,0,0,0,0,0,0,0,0,0,0,0,0
20200312,052843,鴻海統一96購09,0.20,0.20,0.20,0.20,-0.23,-53.49,20000,1,4000,0,0,0,0,0,0,20000,0,20000,20000
20200312,052844,台積電統一96購02,0.86,0.86,0.69,0.81,-0.20,-19.8,2311000,26,1793970,0,0,0,0,0,0,877000,1339000,-462000,-462000
20200312,052845,旺宏統一97購01,0.89,0.98,0.89,0.98,0.00,0.00,20000,2,18700,0,0,0,0,0,0,20000,0,20000,20000
20200312,052846,智邦統一97購01,1.31,1.31,1.15,1.18,0.00,0.00,5000,5,5990,0,0,0,0,0,0,0,5000,-5000,-5000
20200312,052847,漢唐統一99購01,,,,,0.00,0.00,0,0,0,0,0,0,0,0,0,0,0,0,0
20200312,052848,聯發科統一96購03,0.14,0.14,0.09,0.09,0.00,0.00,540000,4,65600,0,0,0,0,0,0,200000,340000,-140000,-140000
20200312,052849,可成統一97購01,0.34,0.34,0.21,0.21,-0.22,-51.16,226000,14,59960,0,0,0,0,0,0,76000,171000,-95000,-95000
20200312,05284P,鴻海兆豐95售04,1.71,2.21,1.71,2.21,+0.78,54.55,65000,5,119750,0,0,0,0,0,0,35000,65000,-30000,-30000
20200312,052850,華新科統一96購02,,,,,0.00,0.00,0,0,0,0,0,0,0,0,0,0,0,0,0
20200312,052851,滬深2X元富96購02,0.72,0.72,0.52,0.60,-0.20,-25.0,898000,25,555310,0,0,0,0,0,0,139000,759000,-620000,-620000
20200312,052852,國巨元富96購02,0.42,0.66,0.20,0.25,-0.28,-52.83,1278000,124,379060,0,0,0,0,0,0,152000,226000,-74000,-74000
20200312,052853,友達日盛99購01,,,,,0.00,0.00,0,0,0,0,0,0,0,0,0,0,0,0,0
20200312,052854,聯詠日盛96購01,0.13,0.13,0.13,0.13,-0.10,-43.48,5000,1,650,0,0,0,0,0,0,5000,0,5000,5000
20200312,052855,群創日盛99購01,0.11,0.11,0.11,0.11,-0.13,-54.17,99000,1,10890,0,0,0,0,0,0,99000,0,99000,99000
20200312,052856,滬深2X凱基98購01,,,,,0.00,0.00,0,0,0,0,0,0,0,0,0,0,0,0,0
20200312,052857,大成鋼凱基96購01,0.76,0.76,0.71,0.71,-0.21,-22.83,108000,3,81180,0,0,0,0,0,0,108000,0,108000,108000
20200312,052858,華通凱基97購02,,,,,0.00,0.00,0,0,0,0,0,0,0,0,0,0,0,0,0
20200312,052859,國巨凱基96購07,1.04,1.04,0.63,0.63,-0.43,-40.57,135000,18,120740,0,0,0,0,0,0,6000,135000,-129000,-129000
20200312,05285P,同欣電群益95售02,0.81,1.00,0.81,0.99,+0.25,33.78,160000,10,138420,0,0,0,0,0,0,110000,50000,60000,60000
20200312,052860,旺宏凱基96購03,,,,,0.00,0.00,0,0,0,0,0,0,0,0,0,0,0,0,0
20200312,052861,台光電凱基96購03,0.66,0.66,0.45,0.45,-0.33,-42.31,109000,7,59530,0,0,0,0,0,0,88000,21000,67000,67000
20200312,052862,正崴凱基96購01,,,,,0.00,0.00,0,0,0,0,0,0,0,0,0,0,0,0,0
20200312,052863,友達凱基98購02,0.64,0.64,0.64,0.64,-0.19,-22.89,68000,1,43520,0,0,0,0,0,0,68000,0,68000,68000
20200312,052864,奇力新凱基96購02,,,,,0.00,0.00,0,0,0,0,0,0,0,0,0,0,0,0,0
20200312,052865,大立光凱基96購11,,,,,0.00,0.00,0,0,0,0,0,0,0,0,0,0,0,0,0
20200312,052866,大立光凱基96購12,0.45,0.45,0.34,0.34,-0.50,-59.52,274000,8,100980,0,0,0,0,0,0,4000,274000,-270000,-270000
20200312,052867,晶技凱基96購01,1.87,1.87,1.09,1.11,-0.72,-39.34,331000,52,505080,0,0,0,0,0,0,188000,172000,16000,16000
20200312,052868,緯創凱基96購03,,,,,0.00,0.00,0,0,0,0,0,0,0,0,0,0,0,0,0
20200312,052869,新日興凱基96購01,0.65,0.65,0.42,0.42,-0.35,-45.45,65000,5,34050,0,0,0,0,0,0,5000,60000,-55000,-55000
20200312,05286P,矽力統一95售02,0.80,0.90,0.80,0.85,+0.10,13.33,138000,11,116850,0,0,0,0,0,0,113000,22000,91000,91000
20200312,052870,玉晶光凱基96購03,1.05,1.05,0.79,0.79,-0.51,-39.23,51000,4,45320,0,0,0,0,0,0,11000,40000,-29000,-29000
20200312,052871,群創凱基98購07,,,,,0.00,0.00,0,0,0,0,0,0,0,0,0,0,0,0,0
20200312,052872,智易凱基96購01,,,,,0.00,0.00,0,0,0,0,0,0,0,0,0,0,0,0,0
20200312,052873,新唐凱基96購02,,,,,0.00,0.00,0,0,0,0,0,0,0,0,0,0,0,0,0
20200312,052874,超眾凱基96購01,0.42,0.42,0.42,0.42,0.00,0.00,10000,1,4200,0,0,0,0,0,0,0,10000,-10000,-10000
20200312,052875,樺漢凱基96購02,,,,,0.00,0.00,0,0,0,0,0,0,0,0,0,0,0,0,0
20200312,052876,GIS凱基96購03,0.14,0.14,0.14,0.14,0.00,0.00,5000,1,700,0,0,0,0,0,0,0,5000,-5000,-5000
20200312,052877,矽創凱基96購01,,,,,0.00,0.00,0,0,0,0,0,0,0,0,0,0,0,0,0
20200312,052878,台虹凱基96購01,0.82,0.82,0.63,0.65,-0.34,-34.34,124000,7,93360,0,0,0,0,0,0,84000,40000,44000,44000
20200312,052879,滬深2X凱基97購02,,,,,0.00,0.00,0,0,0,0,0,0,0,0,0,0,0,0,0
20200312,05287P,鴻海元富95售09,,,,,0.00,0.00,0,0,0,0,0,0,0,0,0,0,0,0,0
20200312,052880,台積電凱基96購06,0.59,0.59,0.41,0.54,-0.26,-32.5,447000,16,243720,0,0,0,0,0,0,377000,70000,307000,307000
20200312,052881,康控凱基97購01,,,,,0.00,0.00,0,0,0,0,0,0,0,0,0,0,0,0,0
20200312,052882,南電凱基96購02,0.78,0.78,0.50,0.53,-0.31,-36.9,992000,44,614150,0,0,0,0,0,0,657000,446000,211000,211000
20200312,052883,百和亞東97購01,,,,,0.00,0.00,0,0,0,0,0,0,0,0,0,0,0,0,0
20200312,052884,台積電兆豐96購01,0.55,0.55,0.33,0.45,-0.20,-30.77,3359000,83,1493500,0,0,0,0,0,0,1879000,2750000,-871000,-871000
20200312,052885,高鐵兆豐98購01,0.41,0.41,0.41,0.41,-0.13,-24.07,5000,2,2050,0,0,0,0,0,0,5000,0,5000,5000
20200312,052886,世紀鋼兆豐96購01,1.53,1.53,1.53,1.53,0.00,0.00,20000,1,30600,0,0,0,0,0,0,20000,0,20000,20000
20200312,052887,華通中信96購01,,,,,0.00,0.00,0,0,0,0,0,0,0,0,0,0,0,0,0
20200312,052888,台表科中信9A購01,0.16,0.16,0.10,0.10,-0.07,-41.18,253000,11,26390,0,0,0,0,0,0,0,253000,-253000,-253000
20200312,052889,致伸麥證97購01,0.10,0.10,0.08,0.09,-0.06,-40.0,971000,8,88690,540000,431000,109000,0,0,0,540000,431000,109000,109000
20200312,05288P,寶成元富95售02,2.46,2.93,2.46,2.91,+0.61,26.52,565000,57,1580200,0,0,0,0,0,0,30000,535000,-505000,-505000
20200312,052890,FB上証群益9B購01,,,,,0.00,0.00,0,0,0,0,0,0,0,0,0,0,0,0,0
20200312,052891,台泥群益96購01,,,,,0.00,0.00,0,0,0,0,0,0,0,0,0,0,0,0,0
20200312,052892,大成鋼群益96購01,1.17,1.19,1.04,1.17,-0.35,-23.03,120000,10,137290,0,0,0,0,0,0,70000,53000,17000,17000
20200312,052893,聯電群益98購01,,,,,0.00,0.00,0,0,0,0,0,0,0,0,0,0,0,0,0
20200312,052894,國巨群益96購03,1.33,1.33,0.78,0.78,-0.71,-47.65,135000,11,143450,0,0,0,0,0,0,30000,105000,-75000,-75000
20200312,052895,台積電群益96購04,2.26,2.27,1.66,2.20,-0.48,-17.91,497000,45,1036730,0,0,0,0,0,0,426000,444000,-18000,-18000
20200312,052896,宏達電群益96購01,1.50,1.51,1.04,1.13,-0.54,-32.34,191000,12,268160,0,0,0,0,0,0,111000,80000,31000,31000
20200312,052897,緯創群益96購03,0.12,0.12,0.12,0.12,0.00,0.00,4000,1,480,0,0,0,0,0,0,4000,4000,0,0
20200312,052898,樺漢群益96購01,,,,,0.00,0.00,0,0,0,0,0,0,0,0,0,0,0,0,0
20200312,052899,和大國票97購01,0.29,0.29,0.21,0.21,-0.26,-55.32,35000,2,9750,0,0,0,0,0,0,30000,5000,25000,25000
20200312,05289P,鴻海永豐95售05,1.69,2.35,1.69,2.30,+0.85,58.62,311000,21,640660,0,0,0,0,0,0,249000,65000,184000,184000
20200312,052900,大成鋼國票97購01,0.12,0.12,0.11,0.11,-0.05,-31.25,549000,3,60590,0,0,0,0,0,0,499000,20000,479000,479000
20200312,052901,台達電國票97購01,0.10,0.10,0.10,0.10,-0.14,-58.33,20000,2,2000,0,0,0,0,0,0,0,20000,-20000,-20000
20200312,052902,鴻海國票97購04,0.07,0.07,0.05,0.05,-0.07,-58.33,482000,6,29940,0,0,0,0,0,0,200000,282000,-82000,-82000
20200312,052903,致茂國票97購01,0.87,0.87,0.75,0.75,-0.49,-39.52,15000,6,12430,0,0,0,0,0,0,15000,0,15000,15000
20200312,052904,冠德國票97購01,,,,,0.00,0.00,0,0,0,0,0,0,0,0,0,0,0,0,0
20200312,052905,潤泰全國票97購01,,,,,0.00,0.00,0,0,0,0,0,0,0,0,0,0,0,0,0
20200312,052906,緯創國票97購01,0.03,0.03,0.02,0.02,0.00,0.00,70000,2,1850,0,0,0,0,0,0,70000,0,70000,70000
20200312,052907,嘉澤國票97購01,0.34,0.34,0.34,0.34,0.00,0.00,5000,1,1700,0,0,0,0,0,0,5000,5000,0,0
20200312,052908,大成鋼統一96購01,1.58,1.58,1.58,1.58,-0.05,-3.07,10000,1,15800,0,0,0,0,0,0,10000,0,10000,10000
20200312,052909,上銀統一96購01,,,,,0.00,0.00,0,0,0,0,0,0,0,0,0,0,0,0,0
20200312,05290P,國巨永豐95售04,0.25,0.43,0.25,0.43,+0.25,138.89,160000,7,47300,0,0,0,0,0,0,150000,10000,140000,140000
20200312,052910,鴻海統一96購10,,,,,0.00,0.00,0,0,0,0,0,0,0,0,0,0,0,0,0
20200312,052911,友達統一97購02,0.43,0.43,0.26,0.31,-0.20,-39.22,45000,4,17400,0,0,0,0,0,0,45000,0,45000,45000
20200312,052912,日月光統一96購01,0.27,0.28,0.20,0.20,-0.27,-57.45,13000,4,2750,0,0,0,0,0,0,13000,0,13000,13000
20200312,052913,鴻海元富96購05,,,,,0.00,0.00,0,0,0,0,0,0,0,0,0,0,0,0,0
20200312,052914,奇力新元富96購01,0.24,0.24,0.11,0.11,-0.23,-67.65,44000,12,6290,0,0,0,0,0,0,34000,10000,24000,24000
20200312,052915,創意元富96購01,,,,,0.00,0.00,0,0,0,0,0,0,0,0,0,0,0,0,0
20200312,052916,華新科富邦96購01,1.10,1.10,1.10,1.10,0.00,0.00,10000,1,11000,0,0,0,0,0,0,0,10000,-10000,-10000
20200312,052917,大立光富邦99購02,0.50,0.56,0.35,0.37,-0.21,-36.21,1211000,86,486260,0,0,0,0,0,0,26000,1012000,-986000,-986000
20200312,052918,智易富邦97購02,,,,,0.00,0.00,0,0,0,0,0,0,0,0,0,0,0,0,0
20200312,052919,鈺齊富邦98購01,0.25,0.25,0.19,0.22,-0.10,-31.25,66000,6,15440,0,0,0,0,0,0,36000,30000,6000,6000
20200312,05291P,鴻海凱基95售16,0.95,1.38,0.95,1.27,0.00,0.00,168000,11,200220,0,0,0,0,0,0,119000,139000,-20000,-20000
20200312,052920,景碩台新96購02,0.23,0.25,0.23,0.25,-0.27,-51.92,15000,2,3650,0,0,0,0,0,0,0,15000,-15000,-15000
20200312,052921,大成鋼永豐96購01,,,,,0.00,0.00,0,0,0,0,0,0,0,0,0,0,0,0,0
20200312,052922,國巨永豐96購01,0.41,0.42,0.21,0.21,-0.52,-71.23,264000,18,69690,0,0,0,0,0,0,0,264000,-264000,-264000
20200312,052923,台積電永豐96購02,0.49,0.49,0.36,0.43,-0.33,-43.42,92000,11,41240,0,0,0,0,0,0,0,92000,-92000,-92000
20200312,052924,旺宏永豐96購01,0.08,0.08,0.08,0.08,-0.09,-52.94,50000,1,4000,0,0,0,0,0,0,0,50000,-50000,-50000
20200312,052925,日電貿永豐96購01,0.25,0.25,0.18,0.18,-0.10,-35.71,40000,4,8600,0,0,0,0,0,0,0,40000,-40000,-40000
20200312,052926,旺宏元大98購02,0.60,0.60,0.41,0.44,-0.24,-35.29,904000,18,414160,0,0,0,0,0,0,415000,489000,-74000,-74000
20200312,052927,友達元大98購02,0.89,0.93,0.85,0.85,-0.33,-27.97,450000,5,399500,0,0,0,0,0,0,200000,350000,-150000,-150000
20200312,052928,美律元大98購01,0.39,0.39,0.32,0.32,-0.12,-27.27,113000,2,43160,0,0,0,0,0,0,0,113000,-113000,-113000
20200312,052929,可成元大96購02,,,,,0.00,0.00,0,0,0,0,0,0,0,0,0,0,0,0,0
20200312,05292P,台積電凱基95售16,,,,,0.00,0.00,0,0,0,0,0,0,0,0,0,0,0,0,0
20200312,052930,華新科元大97購03,1.57,1.57,1.13,1.14,-0.56,-32.94,333000,12,409670,0,0,0,0,0,0,198000,323000,-125000,-125000
20200312,052931,麗豐元大97購01,,,,,0.00,0.00,0,0,0,0,0,0,0,0,0,0,0,0,0
20200312,052932,正文元大97購01,0.94,0.94,0.69,0.72,-0.18,-20.0,218000,7,174060,0,0,0,0,0,0,110000,108000,2000,2000
20200312,052933,祥碩元大96購01,5.25,5.25,4.79,4.79,-1.76,-26.87,35000,2,169950,0,0,0,0,0,0,35000,35000,0,0
20200312,052934,中磊元大96購01,1.09,1.09,0.95,0.95,-0.35,-26.92,41000,4,42830,0,0,0,0,0,0,41000,29000,12000,12000
20200312,052935,康友元大96購03,0.93,0.93,0.69,0.69,-0.31,-31.0,336000,22,264670,0,0,0,0,0,0,235000,238000,-3000,-3000
20200312,052936,華通兆豐98購01,0.30,0.30,0.15,0.16,-0.19,-54.29,1413000,67,271300,0,0,0,0,0,0,74000,1325000,-1251000,-1251000
20200312,052937,國巨兆豐97購01,0.51,0.53,0.31,0.31,-0.30,-49.18,1042000,53,381980,0,0,0,0,0,0,52000,960000,-908000,-908000
20200312,052938,華新科兆豐96購01,1.36,1.36,0.89,0.91,-0.58,-38.93,80000,10,81790,0,0,0,0,0,0,28000,52000,-24000,-24000
20200312,052939,富邦金兆豐96購01,0.60,0.60,0.41,0.43,-0.25,-36.76,353000,9,156650,0,0,0,0,0,0,223000,130000,93000,93000
20200312,05293P,廣達凱基95售01,0.20,0.20,0.20,0.20,+0.05,33.33,42000,2,8400,0,0,0,0,0,0,42000,0,42000,42000
20200312,052940,玉晶光兆豐97購01,1.39,1.41,1.22,1.23,0.00,0.00,25000,6,31040,0,0,0,0,0,0,15000,25000,-10000,-10000
20200312,052941,康控兆豐97購01,0.26,0.27,0.20,0.20,-0.11,-35.48,55000,4,13200,0,0,0,0,0,0,15000,40000,-25000,-25000
20200312,052942,聯發科中信97購04,0.11,0.11,0.07,0.07,-0.06,-46.15,585000,44,46050,0,0,0,0,0,0,0,555000,-555000,-555000
20200312,052943,奇力新國票96購02,0.27,0.27,0.16,0.16,-0.24,-60.0,90000,17,20590,0,0,0,0,0,0,60000,30000,30000,30000
20200312,052944,宏達電國票97購01,0.38,0.38,0.24,0.24,-0.25,-51.02,216000,10,61140,0,0,0,0,0,0,115000,101000,14000,14000
20200312,052945,嘉晶國票97購01,1.75,1.93,1.33,1.33,-0.67,-33.5,98000,12,175510,0,0,0,0,0,0,36000,65000,-29000,-29000
20200312,052946,智原國票97購02,,,,,0.00,0.00,0,0,0,0,0,0,0,0,0,0,0,0,0
20200312,052947,晶技國票97購01,2.91,2.91,1.91,1.91,-0.49,-20.42,30000,2,67300,0,0,0,0,0,0,10000,20000,-10000,-10000
20200312,052948,景碩國票97購02,1.12,1.14,0.69,0.69,-0.74,-51.75,195000,10,180950,0,0,0,0,0,0,20000,175000,-155000,-155000
20200312,052949,智易國票97購02,,,,,0.00,0.00,0,0,0,0,0,0,0,0,0,0,0,0,0
20200312,05294P,亞光凱基95售02,0.35,0.44,0.35,0.44,+0.20,83.33,48000,5,20260,0,0,0,0,0,0,33000,15000,18000,18000
20200312,052950,超眾國票98購01,0.59,0.59,0.48,0.48,-0.31,-39.24,40000,4,20700,0,0,0,0,0,0,20000,20000,0,0
20200312,052951,GIS國票97購02,0.05,0.05,0.04,0.04,0.00,0.00,285000,4,11800,0,0,0,0,0,0,40000,245000,-205000,-205000
20200312,052952,矽創國票97購02,0.57,0.57,0.34,0.34,-0.26,-43.33,156000,7,81950,0,0,0,0,0,0,131000,25000,106000,106000
20200312,052953,百和國票97購01,,,,,0.00,0.00,0,0,0,0,0,0,0,0,0,0,0,0,0
20200312,052954,大成鋼日盛96購01,,,,,0.00,0.00,0,0,0,0,0,0,0,0,0,0,0,0,0
20200312,052955,國巨日盛96購01,0.54,0.54,0.31,0.31,-0.53,-63.1,62000,9,25390,0,0,0,0,0,0,20000,42000,-22000,-22000
20200312,052956,聯發科日盛96購01,,,,,0.00,0.00,0,0,0,0,0,0,0,0,0,0,0,0,0
20200312,052957,T50反1凱基99購01,1.05,1.26,1.05,1.26,0.00,0.00,70000,2,80850,0,0,0,0,0,0,70000,0,70000,70000
20200312,052958,T50反1凱基99購02,0.89,0.89,0.89,0.89,0.00,0.00,5000,1,4450,0,0,0,0,0,0,5000,0,5000,5000
20200312,052959,聯電凱基97購01,,,,,0.00,0.00,0,0,0,0,0,0,0,0,0,0,0,0,0
20200312,05295P,緯創凱基95售01,0.52,0.64,0.52,0.64,+0.15,30.61,253000,10,144520,0,0,0,0,0,0,79000,174000,-95000,-95000
20200312,052960,中環凱基96購01,,,,,0.00,0.00,0,0,0,0,0,0,0,0,0,0,0,0,0
20200312,052961,國巨凱基97購02,0.42,0.49,0.36,0.39,-0.30,-43.48,99000,10,41210,0,0,0,0,0,0,22000,77000,-55000,-55000
20200312,052962,台積電凱基97購03,0.34,0.38,0.28,0.38,-0.14,-26.92,111000,12,39080,0,0,0,0,0,0,0,111000,-111000,-111000
20200312,052963,智邦凱基96購02,1.17,1.17,0.84,0.90,-0.35,-28.0,42000,5,41700,0,0,0,0,0,0,42000,20000,22000,22000
20200312,052964,台表科凱基96購03,,,,,0.00,0.00,0,0,0,0,0,0,0,0,0,0,0,0,0
20200312,052965,廣宇群益97購01,,,,,0.00,0.00,0,0,0,0,0,0,0,0,0,0,0,0,0
20200312,052966,光磊群益96購01,,,,,0.00,0.00,0,0,0,0,0,0,0,0,0,0,0,0,0
20200312,052967,智邦群益96購01,1.15,1.15,0.67,0.82,-0.43,-34.4,207000,24,188390,0,0,0,0,0,0,143000,87000,56000,56000
20200312,052968,燿華群益98購01,0.40,0.40,0.39,0.39,-0.09,-18.75,75000,11,29330,0,0,0,0,0,0,75000,0,75000,75000
20200312,052969,建準群益97購01,0.60,0.60,0.50,0.50,-0.24,-32.43,21000,3,11850,0,0,0,0,0,0,11000,10000,1000,1000
20200312,05296P,牧德凱基96售01,,,,,0.00,0.00,0,0,0,0,0,0,0,0,0,0,0,0,0
20200312,052970,美律群益96購01,0.29,0.29,0.29,0.29,-0.10,-25.64,98000,1,28420,0,0,0,0,0,0,98000,0,98000,98000
20200312,052971,京元電群益98購01,0.25,0.25,0.23,0.25,-0.10,-28.57,30000,17,7230,0,0,0,0,0,0,30000,0,30000,30000
20200312,052972,義隆群益96購04,0.72,0.75,0.68,0.68,-0.27,-28.42,322000,4,228610,0,0,0,0,0,0,311000,11000,300000,300000
20200312,052973,冠德群益96購01,,,,,0.00,0.00,0,0,0,0,0,0,0,0,0,0,0,0,0
20200312,052974,瀚宇博群益96購01,,,,,0.00,0.00,0,0,0,0,0,0,0,0,0,0,0,0,0
20200312,052975,嘉聯益群益96購01,0.30,0.30,0.26,0.27,-0.29,-51.79,51000,7,13740,0,0,0,0,0,0,0,51000,-51000,-51000
20200312,052976,台表科群益96購03,,,,,0.00,0.00,0,0,0,0,0,0,0,0,0,0,0,0,0
20200312,052977,奇力新麥證97購01,0.49,0.49,0.40,0.40,-0.13,-24.53,56000,18,25860,46000,10000,36000,0,0,0,46000,10000,36000,36000
20200312,052978,貿聯麥證97購01,0.26,0.26,0.21,0.21,-0.12,-36.36,102000,3,22570,102000,0,102000,0,0,0,102000,0,102000,102000
20200312,052979,上銀元大96購02,1.08,1.08,0.63,0.63,-0.66,-51.16,136000,21,126210,0,0,0,0,0,0,102000,40000,62000,62000
20200312,05297P,臻鼎凱基95售04,1.32,1.49,1.32,1.49,+0.37,33.04,19000,2,25590,0,0,0,0,0,0,19000,0,19000,19000
20200312,052980,上銀元大96購03,1.27,1.27,0.85,0.89,-0.55,-38.19,541000,29,575620,0,0,0,0,0,0,360000,241000,119000,119000
20200312,052981,鴻海元大97購05,0.34,0.34,0.25,0.26,-0.19,-42.22,118000,12,33810,0,0,0,0,0,0,75000,39000,36000,36000
20200312,052982,鴻海元大97購06,0.06,0.06,0.06,0.06,-0.06,-50.0,544000,3,32640,0,0,0,0,0,0,0,544000,-544000,-544000
20200312,052983,國巨元大96購07,1.24,1.24,0.75,0.75,-0.50,-40.0,243000,19,261060,0,0,0,0,0,0,76000,177000,-101000,-101000
20200312,052984,漢唐元大96購01,1.56,1.56,1.23,1.23,-0.46,-27.22,380000,6,515700,0,0,0,0,0,0,250000,130000,120000,120000
20200312,052985,美律元大96購02,0.17,0.17,0.12,0.12,-0.11,-47.83,78000,3,10560,0,0,0,0,0,0,28000,50000,-22000,-22000
20200312,052986,聯發科元大97購05,0.25,0.25,0.14,0.17,-0.11,-39.29,3388000,107,633740,0,0,0,0,0,0,680000,2572000,-1892000,-1892000
20200312,052987,華新科元大99購01,1.82,1.82,1.31,1.44,-0.43,-22.99,230000,16,364750,0,0,0,0,0,0,10000,220000,-210000,-210000
20200312,052988,智易元大96購02,,,,,0.00,0.00,0,0,0,0,0,0,0,0,0,0,0,0,0
20200312,052989,麗豐元大98購01,,,,,0.00,0.00,0,0,0,0,0,0,0,0,0,0,0,0,0
20200312,05298P,上銀元大95售03,1.18,1.47,1.18,1.41,+0.42,42.42,254000,8,329460,0,0,0,0,0,0,110000,134000,-24000,-24000
20200312,052990,超眾元大97購01,1.09,1.10,0.93,0.93,-0.49,-34.51,129000,10,131540,0,0,0,0,0,0,117000,29000,88000,88000
20200312,052991,台積電台新96購01,0.56,0.56,0.38,0.51,-0.28,-35.44,302000,9,143620,0,0,0,0,0,0,50000,252000,-202000,-202000
20200312,052992,冠德台新96購01,,,,,0.00,0.00,0,0,0,0,0,0,0,0,0,0,0,0,0
20200312,052993,欣興台新97購01,,,,,0.00,0.00,0,0,0,0,0,0,0,0,0,0,0,0,0
20200312,052994,群創台新99購01,0.40,0.40,0.30,0.34,-0.21,-38.18,125000,8,44900,0,0,0,0,0,0,10000,115000,-105000,-105000
20200312,052995,上銀康和96購01,,,,,0.00,0.00,0,0,0,0,0,0,0,0,0,0,0,0,0
20200312,052996,聯電康和96購01,,,,,0.00,0.00,0,0,0,0,0,0,0,0,0,0,0,0,0
20200312,052997,國巨康和96購01,,,,,0.00,0.00,0,0,0,0,0,0,0,0,0,0,0,0,0
20200312,052998,拓凱康和96購01,0.46,0.46,0.44,0.44,-0.18,-29.03,107000,3,48620,0,0,0,0,0,0,77000,30000,47000,47000
20200312,052999,臺股指康和96購01,0.11,0.11,0.10,0.10,-0.13,-56.52,30000,3,3100,0,0,0,0,0,0,0,30000,-30000,-30000
20200312,05299P,旺宏元大95售04,,,,,0.00,0.00,0,0,0,0,0,0,0,0,0,0,0,0,0
20200312,053000,臺股指康和96購02,0.11,0.14,0.10,0.13,0.00,0.00,57000,6,6390,0,0,0,0,0,0,0,57000,-57000,-57000
20200312,053001,力山永豐96購01,,,,,0.00,0.00,0,0,0,0,0,0,0,0,0,0,0,0,0
20200312,053002,鴻海永豐96購01,0.14,0.14,0.11,0.11,0.00,0.00,72000,3,8780,0,0,0,0,0,0,0,72000,-72000,-72000
20200312,053003,國巨永豐96購02,0.63,0.63,0.37,0.37,-0.38,-50.67,96000,5,45160,0,0,0,0,0,0,84000,12000,72000,72000
20200312,053004,燿華永豐96購01,,,,,0.00,0.00,0,0,0,0,0,0,0,0,0,0,0,0,0
20200312,053005,微星永豐96購01,0.47,0.48,0.43,0.48,0.00,0.00,23000,4,10710,0,0,0,0,0,0,8000,15000,-7000,-7000
20200312,053006,玉晶光永豐96購03,1.55,1.77,1.11,1.16,-0.78,-40.21,86000,16,135920,0,0,0,0,0,0,8000,81000,-73000,-73000
20200312,053007,致伸永豐96購01,0.01,0.01,0.01,0.01,0.00,0.00,10000,10,100,0,0,0,0,0,0,0,10000,-10000,-10000
20200312,053008,達方永豐96購01,,,,,0.00,0.00,0,0,0,0,0,0,0,0,0,0,0,0,0
20200312,053009,大成鋼統一96購02,0.36,0.36,0.33,0.33,-0.02,-5.71,48000,2,16680,0,0,0,0,0,0,48000,0,48000,48000
20200312,05300P,健策元大95售02,0.93,1.13,0.93,1.13,+0.37,48.68,287000,10,291860,0,0,0,0,0,0,127000,160000,-33000,-33000
20200312,053010,鴻海統一96購11,,,,,0.00,0.00,0,0,0,0,0,0,0,0,0,0,0,0,0
20200312,053011,鴻海統一98購01,0.19,0.19,0.19,0.19,0.00,0.00,100000,1,19000,0,0,0,0,0,0,100000,0,100000,100000
20200312,053012,國巨統一96購03,0.70,0.70,0.43,0.43,-0.43,-50.0,119000,3,56030,0,0,0,0,0,0,108000,119000,-11000,-11000
20200312,053013,台積電統一97購01,0.43,0.44,0.34,0.42,-0.20,-32.26,203000,11,74900,0,0,0,0,0,0,119000,54000,65000,65000
20200312,053014,旺宏統一97購02,0.67,0.67,0.50,0.50,-0.48,-48.98,40000,2,23400,0,0,0,0,0,0,0,40000,-40000,-40000
20200312,053015,緯創統一96購01,,,,,0.00,0.00,0,0,0,0,0,0,0,0,0,0,0,0,0
20200312,053016,鈺齊統一96購01,,,,,0.00,0.00,0,0,0,0,0,0,0,0,0,0,0,0,0
20200312,053017,世紀鋼統一96購02,,,,,0.00,0.00,0,0,0,0,0,0,0,0,0,0,0,0,0
20200312,053018,旺宏元富96購02,0.90,0.90,0.63,0.71,-0.60,-45.8,213000,7,176090,0,0,0,0,0,0,148000,65000,83000,83000
20200312,053019,禾伸堂元富96購01,0.56,0.56,0.44,0.52,-0.02,-3.7,215000,7,108550,0,0,0,0,0,0,125000,90000,35000,35000
20200312,05301P,矽力元大95售02,0.90,0.90,0.87,0.87,+0.10,12.99,59000,3,51690,0,0,0,0,0,0,27000,32000,-5000,-5000
20200312,053020,貿聯元富96購01,,,,,0.00,0.00,0,0,0,0,0,0,0,0,0,0,0,0,0
20200312,053021,國巨國泰97購04,,,,,0.00,0.00,0,0,0,0,0,0,0,0,0,0,0,0,0
20200312,053022,欣興國泰98購01,0.54,0.54,0.40,0.40,-0.29,-42.03,29000,5,13500,0,0,0,0,0,0,15000,19000,-4000,-4000
20200312,053023,泰鼎國泰97購01,3.21,3.21,3.21,3.21,-0.90,-21.9,30000,1,96300,0,0,0,0,0,0,30000,0,30000,30000
20200312,053024,國巨富邦97購02,0.56,0.57,0.35,0.35,-0.45,-56.25,175000,20,73130,0,0,0,0,0,0,46000,152000,-106000,-106000
20200312,053025,燿華富邦98購02,0.21,0.21,0.16,0.16,-0.17,-51.52,32000,2,5720,0,0,0,0,0,0,0,32000,-32000,-32000
20200312,053026,奇力新富邦98購01,0.27,0.27,0.22,0.22,-0.14,-38.89,74000,4,17080,0,0,0,0,0,0,44000,30000,14000,14000
20200312,053027,玉晶光富邦98購01,0.90,0.90,0.75,0.79,0.00,0.00,202000,4,159050,0,0,0,0,0,0,0,202000,-202000,-202000
20200312,053028,康控富邦98購01,0.22,0.22,0.16,0.17,-0.08,-32.0,712000,8,124160,0,0,0,0,0,0,638000,74000,564000,564000
20200312,053029,國巨第一96購01,0.44,0.45,0.25,0.26,-0.25,-49.02,822000,40,271820,0,0,0,0,0,0,214000,587000,-373000,-373000
20200312,05302P,華通國泰96售01,,,,,0.00,0.00,0,0,0,0,0,0,0,0,0,0,0,0,0
20200312,053030,南亞科第一96購01,,,,,0.00,0.00,0,0,0,0,0,0,0,0,0,0,0,0,0
20200312,053031,華新科第一96購01,,,,,0.00,0.00,0,0,0,0,0,0,0,0,0,0,0,0,0
20200312,053032,國巨兆豐97購02,0.42,0.42,0.23,0.24,-0.25,-51.02,218000,13,62450,0,0,0,0,0,0,90000,83000,7000,7000
20200312,053033,智易兆豐97購01,,,,,0.00,0.00,0,0,0,0,0,0,0,0,0,0,0,0,0
20200312,053034,上海銀兆豐96購01,0.19,0.19,0.16,0.16,0.00,0.00,159000,10,27440,0,0,0,0,0,0,20000,139000,-119000,-119000
20200312,053035,台表科兆豐97購01,,,,,0.00,0.00,0,0,0,0,0,0,0,0,0,0,0,0,0
20200312,053036,聯電凱基98購01,0.22,0.22,0.19,0.19,-0.08,-29.63,11000,2,2120,0,0,0,0,0,0,1000,10000,-9000,-9000
20200312,053037,國巨凱基96購08,0.88,0.88,0.88,0.88,-0.46,-34.33,13000,2,11440,0,0,0,0,0,0,13000,13000,0,0
20200312,053038,華邦電凱基97購01,,,,,0.00,0.00,0,0,0,0,0,0,0,0,0,0,0,0,0
20200312,053039,聯發科凱基96購11,,,,,0.00,0.00,0,0,0,0,0,0,0,0,0,0,0,0,0
20200312,05303P,華通國泰97售01,2.52,2.52,2.52,2.52,0.00,0.00,5000,1,12600,0,0,0,0,0,0,5000,0,5000,5000
20200312,053040,全新凱基98購01,,,,,0.00,0.00,0,0,0,0,0,0,0,0,0,0,0,0,0
20200312,053041,可成凱基96購02,0.34,0.34,0.30,0.30,-0.23,-43.4,68000,3,21100,0,0,0,0,0,0,68000,0,68000,68000
20200312,053042,大立光凱基97購03,,,,,0.00,0.00,0,0,0,0,0,0,0,0,0,0,0,0,0
20200312,053043,嘉晶凱基96購01,0.75,0.91,0.53,0.62,-0.19,-23.46,1393000,43,967790,0,0,0,0,0,0,562000,831000,-269000,-269000
20200312,053044,南茂凱基96購02,0.20,0.20,0.19,0.19,-0.10,-34.48,71000,2,13500,0,0,0,0,0,0,71000,0,71000,71000
20200312,053045,國巨中信97購01,0.50,0.50,0.29,0.29,-0.32,-52.46,366000,25,145490,0,0,0,0,0,0,208000,158000,50000,50000
20200312,053046,智易中信96購01,,,,,0.00,0.00,0,0,0,0,0,0,0,0,0,0,0,0,0
20200312,053047,寶成中信97購01,0.04,0.04,0.04,0.04,-0.02,-33.33,10000,1,400,0,0,0,0,0,0,0,10000,-10000,-10000
20200312,053048,同欣電麥證96購01,0.53,0.53,0.35,0.35,-0.34,-49.28,140000,10,56900,40000,100000,-60000,0,0,0,40000,100000,-60000,-60000
20200312,053049,T50反1國票98購01,1.38,1.55,1.38,1.55,+0.39,33.62,105000,11,160200,0,0,0,0,0,0,105000,100000,5000,5000
20200312,05304P,國巨國泰97售02,1.07,1.23,1.07,1.23,0.00,0.00,59000,11,69680,0,0,0,0,0,0,49000,5000,44000,44000
20200312,053050,華通國票97購02,,,,,0.00,0.00,0,0,0,0,0,0,0,0,0,0,0,0,0
20200312,053051,楠梓電國票97購01,0.56,0.56,0.42,0.42,-0.33,-44.0,289000,16,141860,0,0,0,0,0,0,221000,68000,153000,153000
20200312,053052,旺宏國票97購02,0.19,0.19,0.10,0.10,-0.14,-58.33,624000,15,75800,0,0,0,0,0,0,119000,505000,-386000,-386000
20200312,053053,京元電國票97購02,0.14,0.14,0.09,0.11,-0.11,-50.0,210000,3,24100,0,0,0,0,0,0,0,210000,-210000,-210000
20200312,053054,禾伸堂國票97購01,0.51,0.51,0.51,0.51,-0.19,-27.14,2000,1,1020,0,0,0,0,0,0,2000,0,2000,2000
20200312,053055,聯詠國票97購01,0.59,0.59,0.51,0.51,-0.26,-33.77,44000,4,23840,0,0,0,0,0,0,34000,10000,24000,24000
20200312,053056,同欣電國票97購01,0.71,0.71,0.45,0.45,-0.62,-57.94,1202000,38,662970,0,0,0,0,0,0,416000,786000,-370000,-370000
20200312,053057,聯電國泰97購02,0.38,0.38,0.24,0.30,-0.15,-33.33,251000,11,83200,0,0,0,0,0,0,131000,137000,-6000,-6000
20200312,053058,台光電永昌99購01,,,,,0.00,0.00,0,0,0,0,0,0,0,0,0,0,0,0,0
20200312,053059,聯發科永昌99購01,0.25,0.25,0.25,0.25,-0.25,-50.0,10000,1,2500,0,0,0,0,0,0,10000,0,10000,10000
20200312,05305P,華新科國泰97售01,0.71,0.96,0.71,0.92,+0.27,41.54,419000,13,328610,0,0,0,0,0,0,130000,379000,-249000,-249000
20200312,053060,大立光永昌96購05,,,,,0.00,0.00,0,0,0,0,0,0,0,0,0,0,0,0,0
20200312,053061,GIS富邦97購01,,,,,0.00,0.00,0,0,0,0,0,0,0,0,0,0,0,0,0
20200312,053062,緯穎富邦97購01,1.31,1.31,0.87,0.96,-0.44,-31.43,52000,9,56930,0,0,0,0,0,0,12000,40000,-28000,-28000
20200312,053063,力山群益98購01,,,,,0.00,0.00,0,0,0,0,0,0,0,0,0,0,0,0,0
20200312,053064,國巨群益96購04,3.42,3.42,2.24,2.24,-1.21,-35.07,62000,8,189520,0,0,0,0,0,0,44000,25000,19000,19000
20200312,053065,大立光群益96購01,0.42,0.42,0.28,0.28,-0.46,-62.16,227000,16,74260,0,0,0,0,0,0,54000,173000,-119000,-119000
20200312,053066,欣興群益96購02,0.31,0.31,0.22,0.22,-0.46,-67.65,13000,3,3080,0,0,0,0,0,0,3000,13000,-10000,-10000
20200312,053067,牧德群益96購01,1.49,1.49,1.43,1.43,-0.62,-30.24,21000,2,30090,0,0,0,0,0,0,21000,0,21000,21000
20200312,053068,智伸科群益96購01,0.26,0.26,0.26,0.26,-0.05,-16.13,47000,1,12220,0,0,0,0,0,0,47000,0,47000,47000
20200312,053069,同欣電群益98購01,0.48,0.48,0.32,0.36,-0.23,-38.98,361000,10,141780,0,0,0,0,0,0,178000,183000,-5000,-5000
20200312,05306P,泰碩國泰97售01,1.26,1.50,1.26,1.40,+0.11,8.53,1594000,97,2200980,0,0,0,0,0,0,614000,936000,-322000,-322000
20200312,053070,訊芯群益96購01,0.20,0.20,0.20,0.20,-0.18,-47.37,10000,1,2000,0,0,0,0,0,0,10000,0,10000,10000
20200312,053071,南電群益96購01,0.93,0.95,0.60,0.60,-0.42,-41.18,92000,10,71230,0,0,0,0,0,0,72000,37000,35000,35000
20200312,053072,國巨台新97購01,,,,,0.00,0.00,0,0,0,0,0,0,0,0,0,0,0,0,0
20200312,053073,技嘉康和96購01,0.36,0.36,0.36,0.36,-0.11,-23.4,10000,1,3600,0,0,0,0,0,0,10000,0,10000,10000
20200312,053074,嘉晶永豐96購02,0.99,1.09,0.85,0.85,-0.19,-18.27,438000,23,438800,0,0,0,0,0,0,188000,250000,-62000,-62000
20200312,053075,欣興永豐96購01,0.10,0.11,0.06,0.06,-0.11,-64.71,250000,9,18400,0,0,0,0,0,0,0,250000,-250000,-250000
20200312,053076,貿聯永豐96購01,,,,,0.00,0.00,0,0,0,0,0,0,0,0,0,0,0,0,0
20200312,053077,同欣電永豐96購01,,,,,0.00,0.00,0,0,0,0,0,0,0,0,0,0,0,0,0
20200312,053078,昇陽半永豐97購02,,,,,0.00,0.00,0,0,0,0,0,0,0,0,0,0,0,0,0
20200312,053079,世紀鋼永豐96購01,1.32,1.43,1.20,1.25,-0.26,-17.22,80000,7,103550,0,0,0,0,0,0,0,80000,-80000,-80000
20200312,05307P,光寶科中信95售01,0.82,0.94,0.82,0.93,+0.20,27.4,465000,23,415580,0,0,0,0,0,0,270000,195000,75000,75000
20200312,053080,力山元大96購02,,,,,0.00,0.00,0,0,0,0,0,0,0,0,0,0,0,0,0
20200312,053081,上銀元大97購02,1.90,1.90,1.25,1.25,-1.41,-53.01,89000,4,150310,0,0,0,0,0,0,39000,51000,-12000,-12000
20200312,053082,聯電元大98購03,0.21,0.21,0.21,0.21,-0.15,-41.67,10000,1,2100,0,0,0,0,0,0,0,10000,-10000,-10000
20200312,053083,中環元大99購01,0.26,0.26,0.18,0.19,-0.09,-32.14,853000,23,180360,0,0,0,0,0,0,0,853000,-853000,-853000
20200312,053084,國巨元大98購01,2.83,2.83,2.10,2.18,-0.75,-25.6,99000,7,264210,0,0,0,0,0,0,94000,81000,13000,13000
20200312,053085,華新科元大97購04,2.41,2.41,1.88,2.11,-0.89,-29.67,136000,5,269010,0,0,0,0,0,0,26000,110000,-84000,-84000
20200312,053086,宏達電元大97購01,1.16,1.16,0.87,0.87,-0.49,-36.03,117000,9,120160,0,0,0,0,0,0,0,117000,-117000,-117000
20200312,053087,冠德元大96購02,0.10,0.10,0.10,0.10,-0.08,-44.44,50000,1,5000,0,0,0,0,0,0,0,50000,-50000,-50000
20200312,053088,奇鋐元大98購01,,,,,0.00,0.00,0,0,0,0,0,0,0,0,0,0,0,0,0
20200312,053089,貿聯元大97購02,0.41,0.41,0.25,0.31,-0.14,-31.11,23000,11,7430,0,0,0,0,0,0,7000,16000,-9000,-9000
20200312,05308P,台積電中信95售08,0.47,0.47,0.44,0.44,0.00,0.00,200000,2,92500,0,0,0,0,0,0,0,200000,-200000,-200000
20200312,053090,新唐元大96購01,0.50,0.50,0.44,0.44,-0.28,-38.89,335000,5,160350,0,0,0,0,0,0,230000,105000,125000,125000
20200312,053091,同欣電元大96購01,0.78,0.78,0.69,0.75,-0.43,-36.44,24000,3,18210,0,0,0,0,0,0,17000,24000,-7000,-7000
20200312,053092,台表科元大97購02,0.67,0.67,0.60,0.61,-0.20,-24.69,146000,14,92260,0,0,0,0,0,0,146000,0,146000,146000
20200312,053093,緯穎元大96購06,2.74,2.74,2.34,2.34,-1.25,-34.82,38000,3,92750,0,0,0,0,0,0,15000,38000,-23000,-23000
20200312,053094,聯電統一97購02,0.46,0.46,0.31,0.33,-0.24,-42.11,350000,8,146500,0,0,0,0,0,0,290000,60000,230000,230000
20200312,053095,台光電統一98購01,0.65,0.65,0.65,0.65,-0.11,-14.47,20000,1,13000,0,0,0,0,0,0,20000,0,20000,20000
20200312,053096,康控統一96購01,,,,,0.00,0.00,0,0,0,0,0,0,0,0,0,0,0,0,0
20200312,053097,超眾統一96購03,0.74,0.74,0.70,0.70,-0.45,-39.13,193000,2,135740,0,0,0,0,0,0,177000,16000,161000,161000
20200312,053098,國巨元富96購04,0.93,0.94,0.59,0.59,-0.48,-44.86,533000,49,359200,0,0,0,0,0,0,85000,498000,-413000,-413000
20200312,053099,正崴元富96購01,,,,,0.00,0.00,0,0,0,0,0,0,0,0,0,0,0,0,0
20200312,05309P,康友中信95售03,0.51,0.51,0.51,0.51,+0.15,41.67,10000,1,5100,0,0,0,0,0,0,0,10000,-10000,-10000
20200312,053100,美律元富96購01,0.34,0.34,0.32,0.32,0.00,0.00,30000,3,10000,0,0,0,0,0,0,0,30000,-30000,-30000
20200312,053101,創意元富96購03,,,,,0.00,0.00,0,0,0,0,0,0,0,0,0,0,0,0,0
20200312,053102,祥碩元富96購01,,,,,0.00,0.00,0,0,0,0,0,0,0,0,0,0,0,0,0
20200312,053103,瀚宇博元富96購01,,,,,0.00,0.00,0,0,0,0,0,0,0,0,0,0,0,0,0
20200312,053104,台表科元富96購02,0.35,0.35,0.35,0.35,-0.09,-20.45,45000,1,15750,0,0,0,0,0,0,45000,0,45000,45000
20200312,053105,鴻海兆豐97購01,0.08,0.10,0.08,0.10,0.00,0.00,302000,19,24180,0,0,0,0,0,0,0,302000,-302000,-302000
20200312,053106,鴻海兆豐98購01,0.05,0.05,0.02,0.02,0.00,0.00,110000,7,5200,0,0,0,0,0,0,0,60000,-60000,-60000
20200312,053107,旺宏兆豐97購01,,,,,0.00,0.00,0,0,0,0,0,0,0,0,0,0,0,0,0
20200312,053108,南亞科兆豐96購01,0.27,0.27,0.20,0.20,-0.50,-71.43,40000,2,10100,0,0,0,0,0,0,10000,30000,-20000,-20000
20200312,053109,聯發科兆豐96購01,,,,,0.00,0.00,0,0,0,0,0,0,0,0,0,0,0,0,0
20200312,05310P,智原永豐95售04,2.56,2.56,2.56,2.56,0.00,0.00,10000,1,25600,0,0,0,0,0,0,0,10000,-10000,-10000
20200312,053110,大立光兆豐97購01,,,,,0.00,0.00,0,0,0,0,0,0,0,0,0,0,0,0,0
20200312,053111,緯創兆豐97購01,0.16,0.16,0.16,0.16,-0.20,-55.56,50000,1,8000,0,0,0,0,0,0,0,50000,-50000,-50000
20200312,053112,中磊兆豐97購01,0.58,0.58,0.53,0.53,-0.14,-20.9,40000,3,21950,0,0,0,0,0,0,40000,0,40000,40000
20200312,053113,瀚宇博兆豐97購01,0.41,0.41,0.41,0.41,-0.27,-39.71,10000,1,4100,0,0,0,0,0,0,10000,0,10000,10000
20200312,053114,聯茂兆豐97購01,0.76,0.76,0.51,0.51,-0.33,-39.29,190000,12,107750,0,0,0,0,0,0,115000,75000,40000,40000
20200312,053115,滬深2X中信97購01,0.67,0.67,0.55,0.60,-0.12,-16.67,554000,10,332340,0,0,0,0,0,0,242000,312000,-70000,-70000
20200312,053116,華新科中信96購01,0.77,0.77,0.53,0.53,-0.37,-41.11,60000,6,39600,0,0,0,0,0,0,40000,40000,0,0
20200312,053117,大立光中信9A購02,0.27,0.27,0.27,0.27,0.00,0.00,10000,1,2700,0,0,0,0,0,0,0,10000,-10000,-10000
20200312,053118,大立光中信9C購01,0.61,0.61,0.49,0.51,-0.30,-37.04,246000,11,128690,0,0,0,0,0,0,25000,221000,-196000,-196000
20200312,053119,日月光中信97購01,,,,,0.00,0.00,0,0,0,0,0,0,0,0,0,0,0,0,0
20200312,05311P,臺股指群益95售10,3.65,4.00,3.65,4.00,0.00,0.00,40000,4,151000,0,0,0,0,0,0,40000,0,40000,40000
20200312,053120,復盛中信9A購01,0.40,0.40,0.32,0.32,-0.12,-27.27,41000,4,15100,0,0,0,0,0,0,16000,25000,-9000,-9000
20200312,053121,上証2X凱基9C購01,1.60,1.60,1.38,1.52,-0.29,-16.02,35000,7,50310,0,0,0,0,0,0,3000,32000,-29000,-29000
20200312,053122,美律凱基98購01,0.23,0.25,0.19,0.23,-0.17,-42.5,146000,5,32480,0,0,0,0,0,0,70000,126000,-56000,-56000
20200312,053123,京元電凱基96購01,,,,,0.00,0.00,0,0,0,0,0,0,0,0,0,0,0,0,0
20200312,053124,聯發科凱基96購12,,,,,0.00,0.00,0,0,0,0,0,0,0,0,0,0,0,0,0
20200312,053125,宏達電凱基96購01,0.28,0.28,0.15,0.15,-0.25,-62.5,123000,3,28750,0,0,0,0,0,0,123000,0,123000,123000
20200312,053126,健策凱基97購02,0.43,0.43,0.30,0.30,-0.20,-40.0,91000,7,32200,0,0,0,0,0,0,45000,46000,-1000,-1000
20200312,053127,貿聯凱基97購01,0.29,0.29,0.26,0.28,-0.09,-24.32,92000,15,25680,0,0,0,0,0,0,92000,0,92000,92000
20200312,053128,瀚宇博凱基96購01,0.25,0.25,0.17,0.17,-0.17,-50.0,2000,2,420,0,0,0,0,0,0,0,2000,-2000,-2000
20200312,053129,緯穎凱基96購01,1.83,1.83,1.55,1.55,-1.33,-46.18,18000,2,30700,0,0,0,0,0,0,8000,18000,-10000,-10000
20200312,05312P,臺股指群益95售11,9.80,10.20,9.80,10.20,+4.90,92.45,11000,2,108200,0,0,0,0,0,0,11000,0,11000,11000
20200312,053130,聯發科麥證96購01,0.38,0.38,0.23,0.25,-0.23,-47.92,162000,8,53500,98000,64000,34000,0,0,0,98000,64000,34000,34000
20200312,053131,華通國票97購03,,,,,0.00,0.00,0,0,0,0,0,0,0,0,0,0,0,0,0
20200312,053132,國巨國票97購02,0.55,0.55,0.55,0.55,0.00,0.00,10000,1,5500,0,0,0,0,0,0,0,10000,-10000,-10000
20200312,053133,華邦電國票97購01,,,,,0.00,0.00,0,0,0,0,0,0,0,0,0,0,0,0,0
20200312,053134,南亞科國票97購01,0.89,0.89,0.54,0.59,-0.90,-60.4,26000,4,18490,0,0,0,0,0,0,15000,11000,4000,4000
20200312,053135,信邦國票96購01,1.02,1.11,1.02,1.11,-0.40,-26.49,110000,4,117680,0,0,0,0,0,0,72000,38000,34000,34000
20200312,053136,彩晶國票97購01,0.36,0.36,0.36,0.36,-0.29,-44.62,5000,1,1800,0,0,0,0,0,0,0,5000,-5000,-5000
20200312,053137,旺宏富邦98購01,0.34,0.34,0.24,0.24,-0.35,-59.32,200000,2,58000,0,0,0,0,0,0,100000,100000,0,0
20200312,053138,華邦電富邦96購01,,,,,0.00,0.00,0,0,0,0,0,0,0,0,0,0,0,0,0
20200312,053139,滬深2X永豐98購01,0.31,0.31,0.31,0.31,0.00,0.00,13000,1,4030,0,0,0,0,0,0,0,13000,-13000,-13000
20200312,05313P,臺股指群益95售12,,,,,0.00,0.00,0,0,0,0,0,0,0,0,0,0,0,0,0
20200312,053140,燿華永豐96購02,0.18,0.18,0.18,0.18,0.00,0.00,30000,2,5400,0,0,0,0,0,0,0,30000,-30000,-30000
20200312,053141,景碩永豐96購02,,,,,0.00,0.00,0,0,0,0,0,0,0,0,0,0,0,0,0
20200312,053142,緯穎永豐96購01,1.58,1.58,0.93,1.00,-1.04,-50.98,190000,13,209200,0,0,0,0,0,0,100000,80000,20000,20000
20200312,053143,昇陽半永豐96購03,0.19,0.19,0.19,0.19,-0.28,-59.57,20000,2,3800,0,0,0,0,0,0,0,20000,-20000,-20000
20200312,053144,上証2X元大96購01,,,,,0.00,0.00,0,0,0,0,0,0,0,0,0,0,0,0,0
20200312,053145,元黃金元大96購02,0.79,0.81,0.73,0.73,0.00,0.00,58000,8,43720,0,0,0,0,0,0,0,58000,-58000,-58000
20200312,053146,滬深2X元大96購08,0.36,0.36,0.36,0.36,-0.18,-33.33,10000,1,3600,0,0,0,0,0,0,0,10000,-10000,-10000
20200312,053147,楠梓電元大98購01,0.26,0.26,0.26,0.26,-0.12,-31.58,100000,1,26000,0,0,0,0,0,0,0,100000,-100000,-100000
20200312,053148,華邦電元大96購01,0.15,0.15,0.13,0.15,-0.18,-54.55,305000,5,43250,0,0,0,0,0,0,0,305000,-305000,-305000
20200312,053149,京元電元大96購02,0.67,0.67,0.42,0.47,-0.28,-37.33,328000,8,197620,0,0,0,0,0,0,180000,148000,32000,32000
20200312,05314P,臺股指群益95售13,,,,,0.00,0.00,0,0,0,0,0,0,0,0,0,0,0,0,0
20200312,053150,聯發科元大96購11,0.14,0.14,0.08,0.08,-0.15,-65.22,350000,3,32000,0,0,0,0,0,0,0,350000,-350000,-350000
20200312,053151,華新科元大96購04,,,,,0.00,0.00,0,0,0,0,0,0,0,0,0,0,0,0,0
20200312,053152,大立光元大99購01,0.78,0.78,0.59,0.60,-0.47,-43.93,427000,18,300290,0,0,0,0,0,0,108000,319000,-211000,-211000
20200312,053153,大立光元大99購02,0.88,0.88,0.67,0.67,-0.56,-45.53,124000,14,96280,0,0,0,0,0,0,11000,113000,-102000,-102000
20200312,053154,聯詠元大96購01,0.41,0.41,0.35,0.38,-0.12,-24.0,74000,6,28250,0,0,0,0,0,0,55000,19000,36000,36000
20200312,053155,晶技元大97購02,1.76,1.76,1.00,1.01,-0.73,-41.95,1309000,69,1870660,0,0,0,0,0,0,522000,700000,-178000,-178000
20200312,053156,緯創元大96購02,0.05,0.05,0.05,0.05,0.00,0.00,40000,4,2000,0,0,0,0,0,0,0,40000,-40000,-40000
20200312,053157,日月光元大96購03,,,,,0.00,0.00,0,0,0,0,0,0,0,0,0,0,0,0,0
20200312,053158,茂林元大96購01,0.63,0.64,0.44,0.44,-0.23,-34.33,132000,8,70880,0,0,0,0,0,0,64000,82000,-18000,-18000
20200312,053159,同欣電元大96購02,0.47,0.47,0.32,0.36,-0.24,-40.0,206000,6,89040,0,0,0,0,0,0,70000,136000,-66000,-66000
20200312,05315P,鴻海永昌96售08,3.58,4.13,3.53,4.10,+0.91,28.53,586000,17,2373730,0,0,0,0,0,0,220000,580000,-360000,-360000
20200312,053160,台表科元大96購03,,,,,0.00,0.00,0,0,0,0,0,0,0,0,0,0,0,0,0
20200312,053161,康友元大96購04,0.39,0.39,0.31,0.31,-0.11,-26.19,196000,5,62760,0,0,0,0,0,0,196000,0,196000,196000
20200312,053162,緯穎元大97購01,1.97,1.97,1.36,1.50,-0.71,-32.13,105000,7,177000,0,0,0,0,0,0,24000,95000,-71000,-71000
20200312,053163,上証2X群益9A購02,1.20,1.20,1.20,1.20,-0.40,-25.0,10000,1,12000,0,0,0,0,0,0,10000,10000,0,0
20200312,053164,台光電群益96購02,0.29,0.29,0.19,0.19,-0.17,-47.22,168000,3,45320,0,0,0,0,0,0,98000,70000,28000,28000
20200312,053165,大立光群益96購03,0.37,0.37,0.25,0.31,-0.39,-55.71,659000,65,197230,0,0,0,0,0,0,10000,649000,-639000,-639000
20200312,053166,聯詠群益96購02,0.18,0.18,0.18,0.18,0.00,0.00,40000,1,7200,0,0,0,0,0,0,0,40000,-40000,-40000
20200312,053167,欣興群益96購03,0.42,0.42,0.26,0.27,-0.39,-59.09,672000,65,229660,0,0,0,0,0,0,22000,580000,-558000,-558000
20200312,053168,晶技群益98購01,3.15,3.19,2.03,2.41,-1.07,-30.75,553000,48,1579790,0,0,0,0,0,0,475000,114000,361000,361000
20200312,053169,貿聯群益97購01,0.37,0.38,0.31,0.31,-0.18,-36.73,164000,16,54990,0,0,0,0,0,0,164000,0,164000,164000
20200312,05316P,台積電永昌96售06,0.98,1.29,0.97,1.29,+0.47,57.32,1065000,10,1084450,0,0,0,0,0,0,1045000,1058000,-13000,-13000
20200312,053170,茂林群益96購04,1.12,1.12,1.01,1.03,-0.18,-14.88,169000,4,176690,0,0,0,0,0,0,80000,127000,-47000,-47000
20200312,053171,中磊群益96購01,1.01,1.01,0.91,0.91,-0.19,-17.27,26000,4,25160,0,0,0,0,0,0,26000,16000,10000,10000
20200312,053172,瑞儀群益97購01,0.06,0.20,0.06,0.20,+0.08,66.67,1009000,13,69590,0,0,0,0,0,0,150000,857000,-707000,-707000
20200312,053173,矽格群益97購01,1.02,1.08,0.77,0.85,-0.32,-27.35,259000,12,229430,0,0,0,0,0,0,169000,227000,-58000,-58000
20200312,053174,同欣電群益98購02,1.20,1.22,0.92,0.96,-0.42,-30.43,345000,10,374470,0,0,0,0,0,0,127000,218000,-91000,-91000
20200312,053175,矽力群益96購01,1.99,1.99,1.99,1.99,-0.36,-15.32,10000,1,19900,0,0,0,0,0,0,10000,0,10000,10000
20200312,053176,矽力群益96購02,2.22,2.25,1.79,2.01,-0.66,-24.72,71000,22,143520,0,0,0,0,0,0,27000,44000,-17000,-17000
20200312,053177,華邦電統一96購01,,,,,0.00,0.00,0,0,0,0,0,0,0,0,0,0,0,0,0
20200312,053178,南亞科統一98購01,0.66,0.66,0.44,0.44,-0.36,-45.0,67000,8,33900,0,0,0,0,0,0,15000,52000,-37000,-37000
20200312,053179,大立光統一96購04,0.09,0.09,0.06,0.06,-0.24,-80.0,1119000,40,84420,0,0,0,0,0,0,0,1119000,-1119000,-1119000
20200312,05317P,臺股指永昌95售02,10.00,10.00,6.60,6.60,+3.80,135.71,50000,6,398000,0,0,0,0,0,0,20000,30000,-10000,-10000
20200312,053180,同欣電統一96購01,0.40,0.40,0.40,0.40,0.00,0.00,48000,1,19200,0,0,0,0,0,0,0,48000,-48000,-48000
20200312,053181,滬深2X元富99購02,1.08,1.08,0.89,0.93,-0.25,-21.19,908000,23,867070,0,0,0,0,0,0,5000,903000,-898000,-898000
20200312,053182,大立光元富96購02,,,,,0.00,0.00,0,0,0,0,0,0,0,0,0,0,0,0,0
20200312,053183,大立光元富96購03,0.27,0.27,0.27,0.27,-0.76,-73.79,98000,1,26460,0,0,0,0,0,0,98000,0,98000,98000
20200312,053184,世紀鋼元富96購01,2.57,2.57,1.88,2.23,-0.38,-14.56,2576000,96,5808360,0,0,0,0,0,0,1277000,1220000,57000,57000
20200312,053185,友達中信99購01,,,,,0.00,0.00,0,0,0,0,0,0,0,0,0,0,0,0,0
20200312,053186,健策中信9C購01,0.48,0.50,0.42,0.42,-0.16,-27.59,399000,12,181410,0,0,0,0,0,0,130000,189000,-59000,-59000
20200312,053187,國巨統一96購05,1.05,1.05,0.63,0.63,-0.42,-40.0,53000,2,53550,0,0,0,0,0,0,48000,5000,43000,43000
20200312,053188,旺宏統一97購03,,,,,0.00,0.00,0,0,0,0,0,0,0,0,0,0,0,0,0
20200312,053189,聯發科統一96購05,0.33,0.33,0.18,0.18,-0.42,-70.0,68000,2,19440,0,0,0,0,0,0,0,68000,-68000,-68000
20200312,05318P,臺股指永昌95售03,10.30,10.50,10.30,10.50,+5.50,110.0,25000,5,258900,0,0,0,0,0,0,25000,0,25000,25000
20200312,053190,聯發科統一99購01,,,,,0.00,0.00,0,0,0,0,0,0,0,0,0,0,0,0,0
20200312,053191,奇鋐統一96購01,0.25,0.25,0.19,0.19,-0.11,-36.67,65000,3,14050,0,0,0,0,0,0,20000,45000,-25000,-25000
20200312,053192,創意統一96購01,0.30,0.31,0.22,0.22,-0.18,-45.0,203000,6,61980,0,0,0,0,0,0,178000,25000,153000,153000
20200312,053193,超眾統一97購01,1.25,1.25,1.25,1.25,0.00,0.00,5000,1,6250,0,0,0,0,0,0,0,5000,-5000,-5000
20200312,053194,緯穎統一99購01,1.45,1.45,1.19,1.19,-0.65,-35.33,14000,8,18460,0,0,0,0,0,0,3000,11000,-8000,-8000
20200312,053195,玉晶光元富96購02,8.20,8.20,6.75,6.75,0.00,0.00,2000,2,14950,0,0,0,0,0,0,0,2000,-2000,-2000
20200312,053196,康控元富96購01,,,,,0.00,0.00,0,0,0,0,0,0,0,0,0,0,0,0,0
20200312,053197,超眾元富96購02,0.53,0.53,0.53,0.53,-0.39,-42.39,17000,1,9010,0,0,0,0,0,0,0,17000,-17000,-17000
20200312,053198,亞德客日盛96購01,0.88,0.88,0.85,0.85,-0.76,-47.2,18000,2,15600,0,0,0,0,0,0,8000,18000,-10000,-10000
20200312,053199,旺宏日盛96購01,0.22,0.22,0.21,0.21,-0.17,-44.74,80000,4,17400,0,0,0,0,0,0,0,80000,-80000,-80000
20200312,05319P,上銀凱基95售02,,,,,0.00,0.00,0,0,0,0,0,0,0,0,0,0,0,0,0
20200312,053200,華邦電日盛96購01,,,,,0.00,0.00,0,0,0,0,0,0,0,0,0,0,0,0,0
20200312,053201,美律日盛96購01,,,,,0.00,0.00,0,0,0,0,0,0,0,0,0,0,0,0,0
20200312,053202,聯發科日盛96購02,,,,,0.00,0.00,0,0,0,0,0,0,0,0,0,0,0,0,0
20200312,053203,智易日盛96購01,,,,,0.00,0.00,0,0,0,0,0,0,0,0,0,0,0,0,0
20200312,053204,旺宏麥證96購01,0.59,0.59,0.46,0.46,-0.35,-43.21,50000,5,27000,0,50000,-50000,0,0,0,0,50000,-50000,-50000
20200312,053205,台光電麥證96購01,1.16,1.18,0.84,0.84,-0.53,-38.69,308000,22,304620,127000,181000,-54000,0,0,0,127000,221000,-94000,-94000
20200312,053206,聯發科麥證96購02,0.32,0.32,0.24,0.24,-0.23,-48.94,22000,2,6080,12000,10000,2000,0,0,0,12000,10000,2000,2000
20200312,053207,SP黃豆凱基96購01,0.28,0.28,0.28,0.28,0.00,0.00,10000,1,2800,0,0,0,0,0,0,0,10000,-10000,-10000
20200312,053208,鴻海凱基96購13,,,,,0.00,0.00,0,0,0,0,0,0,0,0,0,0,0,0,0
20200312,053209,台積電凱基96購07,0.12,0.26,0.12,0.26,0.00,0.00,330000,2,45200,0,0,0,0,0,0,290000,40000,250000,250000
20200312,05320P,華通凱基96售03,1.62,2.00,1.62,2.00,+0.47,30.72,182000,14,322590,0,0,0,0,0,0,45000,127000,-82000,-82000
20200312,053210,華邦電凱基97購02,,,,,0.00,0.00,0,0,0,0,0,0,0,0,0,0,0,0,0
20200312,053211,漢唐凱基96購03,0.40,0.40,0.40,0.40,0.00,0.00,10000,1,4000,0,0,0,0,0,0,0,10000,-10000,-10000
20200312,053212,友達凱基99購04,,,,,0.00,0.00,0,0,0,0,0,0,0,0,0,0,0,0,0
20200312,053213,建準凱基96購02,,,,,0.00,0.00,0,0,0,0,0,0,0,0,0,0,0,0,0
20200312,053214,冠德凱基96購02,,,,,0.00,0.00,0,0,0,0,0,0,0,0,0,0,0,0,0
20200312,053215,禾伸堂凱基96購01,0.40,0.44,0.36,0.41,0.00,0.00,106000,9,41510,0,0,0,0,0,0,40000,66000,-26000,-26000
20200312,053216,京鼎凱基96購02,0.30,0.30,0.30,0.30,-0.14,-31.82,20000,1,6000,0,0,0,0,0,0,20000,0,20000,20000
20200312,053217,群創凱基99購02,,,,,0.00,0.00,0,0,0,0,0,0,0,0,0,0,0,0,0
20200312,053218,TPK凱基96購01,,,,,0.00,0.00,0,0,0,0,0,0,0,0,0,0,0,0,0
20200312,053219,祥碩凱基96購01,3.21,3.21,1.74,2.16,-0.90,-29.41,415000,51,970850,0,0,0,0,0,0,201000,279000,-78000,-78000
20200312,05321P,鴻海凱基95售17,1.23,1.23,1.23,1.23,0.00,0.00,10000,1,12300,0,0,0,0,0,0,0,10000,-10000,-10000
20200312,053220,瀚宇博凱基98購01,0.20,0.20,0.17,0.18,0.00,0.00,310000,3,54000,0,0,0,0,0,0,0,310000,-310000,-310000
20200312,053221,彩晶凱基98購01,0.35,0.35,0.35,0.35,-0.22,-38.6,5000,1,1750,0,0,0,0,0,0,0,5000,-5000,-5000
20200312,053222,聯茂凱基96購03,0.54,0.54,0.29,0.29,-0.46,-61.33,602000,13,205890,0,0,0,0,0,0,106000,496000,-390000,-390000
20200312,053223,台郡凱基96購02,,,,,0.00,0.00,0,0,0,0,0,0,0,0,0,0,0,0,0
20200312,053224,矽力凱基96購02,1.15,1.15,1.03,1.10,-0.45,-29.03,100000,10,107420,0,0,0,0,0,0,40000,60000,-20000,-20000
20200312,053225,昇陽半凱基96購01,,,,,0.00,0.00,0,0,0,0,0,0,0,0,0,0,0,0,0
20200312,053226,國巨台新97購02,0.71,0.71,0.61,0.61,-0.58,-48.74,407000,2,263970,0,0,0,0,0,0,407000,250000,157000,157000
20200312,053227,晶技台新96購01,1.74,1.74,1.10,1.10,0.00,0.00,10000,2,11640,0,0,0,0,0,0,9000,10000,-1000,-1000
20200312,053228,康友台新97購01,0.72,0.72,0.56,0.60,-0.22,-26.83,576000,11,355660,0,0,0,0,0,0,90000,486000,-396000,-396000
20200312,053229,南電台新97購01,1.21,1.21,0.93,0.93,-0.53,-36.3,70000,7,71700,0,0,0,0,0,0,65000,50000,15000,15000
20200312,05322P,台積電凱基95售17,0.09,0.19,0.09,0.11,0.00,0.00,1825000,45,209210,0,0,0,0,0,0,1594000,173000,1421000,1421000
20200312,053230,達方台新97購01,0.65,0.65,0.65,0.65,-0.11,-14.47,3000,1,1950,0,0,0,0,0,0,0,3000,-3000,-3000
20200312,053231,奇力新康和96購01,,,,,0.00,0.00,0,0,0,0,0,0,0,0,0,0,0,0,0
20200312,053232,友達永豐97購02,0.37,0.37,0.30,0.30,-0.16,-34.78,189000,11,58450,0,0,0,0,0,0,45000,104000,-59000,-59000
20200312,053233,大立光永豐96購01,0.05,0.05,0.05,0.05,-0.13,-72.22,10000,1,500,0,0,0,0,0,0,0,10000,-10000,-10000
20200312,053234,奇鋐永豐96購01,0.20,0.20,0.20,0.20,-0.18,-47.37,10000,1,2000,0,0,0,0,0,0,10000,0,10000,10000
20200312,053235,智原永豐96購01,,,,,0.00,0.00,0,0,0,0,0,0,0,0,0,0,0,0,0
20200312,053236,群創永豐97購02,,,,,0.00,0.00,0,0,0,0,0,0,0,0,0,0,0,0,0
20200312,053237,揚明光永豐96購03,0.01,0.01,0.01,0.01,0.00,0.00,20000,1,200,0,0,0,0,0,0,0,0,0,0
20200312,053238,麗豐永豐96購01,,,,,0.00,0.00,0,0,0,0,0,0,0,0,0,0,0,0,0
20200312,053239,崇越永豐96購01,,,,,0.00,0.00,0,0,0,0,0,0,0,0,0,0,0,0,0
20200312,05323P,瑞昱凱基96售02,1.33,1.56,1.33,1.56,+0.38,32.2,75000,8,108340,0,0,0,0,0,0,19000,68000,-49000,-49000
20200312,053240,巨路永豐96購01,0.20,0.20,0.20,0.20,0.00,0.00,50000,1,10000,0,0,0,0,0,0,0,50000,-50000,-50000
20200312,053241,元油反國票9A購01,,,,,0.00,0.00,0,0,0,0,0,0,0,0,0,0,0,0,0
20200312,053242,聯電國票96購04,0.42,0.42,0.27,0.27,-0.24,-47.06,160000,6,49000,0,0,0,0,0,0,30000,130000,-100000,-100000
20200312,053243,楠梓電國票97購02,0.40,0.41,0.38,0.41,-0.30,-42.25,48000,15,19020,0,0,0,0,0,0,48000,0,48000,48000
20200312,053244,光磊國票97購01,,,,,0.00,0.00,0,0,0,0,0,0,0,0,0,0,0,0,0
20200312,053245,全新國票97購01,0.30,0.30,0.30,0.30,-0.28,-48.28,20000,2,6000,0,0,0,0,0,0,0,20000,-20000,-20000
20200312,053246,聯詠國票97購02,0.07,0.07,0.07,0.07,0.00,0.00,30000,1,2100,0,0,0,0,0,0,30000,0,30000,30000
20200312,053247,麗豐國票97購01,,,,,0.00,0.00,0,0,0,0,0,0,0,0,0,0,0,0,0
20200312,053248,智伸科國票97購01,,,,,0.00,0.00,0,0,0,0,0,0,0,0,0,0,0,0,0
20200312,053249,致伸國票97購02,,,,,0.00,0.00,0,0,0,0,0,0,0,0,0,0,0,0,0
20200312,05324P,臺股指凱基95售08,,,,,0.00,0.00,0,0,0,0,0,0,0,0,0,0,0,0,0
20200312,053250,百和國票97購02,1.09,1.09,0.72,0.72,-0.55,-43.31,31000,8,29100,0,0,0,0,0,0,6000,25000,-19000,-19000
20200312,053251,世紀鋼國票97購02,2.25,2.25,2.01,2.04,-0.44,-17.74,95000,9,198600,0,0,0,0,0,0,60000,35000,25000,25000
20200312,053252,華邦電國泰98購01,0.39,0.39,0.28,0.28,-0.26,-48.15,75000,2,28150,0,0,0,0,0,0,0,75000,-75000,-75000
20200312,053253,友達國泰97購02,,,,,0.00,0.00,0,0,0,0,0,0,0,0,0,0,0,0,0
20200312,053254,群創國泰98購02,0.23,0.23,0.23,0.23,0.00,0.00,20000,1,4600,0,0,0,0,0,0,0,20000,-20000,-20000
20200312,053255,貿聯國泰97購01,0.83,0.83,0.55,0.64,-0.32,-33.33,1398000,48,910340,0,0,0,0,0,0,624000,814000,-190000,-190000
20200312,053256,上銀富邦98購01,0.69,0.71,0.50,0.55,-0.37,-40.22,173000,13,118060,0,0,0,0,0,0,155000,68000,87000,87000
20200312,053257,華通富邦97購01,0.08,0.08,0.07,0.07,-0.06,-46.15,40000,2,3100,0,0,0,0,0,0,0,0,0,0
20200312,053258,上証2X群益9A購03,1.13,1.24,1.11,1.24,-0.36,-22.5,152000,8,170880,0,0,0,0,0,0,52000,150000,-98000,-98000
20200312,053259,卜蜂群益97購01,,,,,0.00,0.00,0,0,0,0,0,0,0,0,0,0,0,0,0
20200312,05325P,臺股指凱基95售09,,,,,0.00,0.00,0,0,0,0,0,0,0,0,0,0,0,0,0
20200312,053260,喬山群益96購01,,,,,0.00,0.00,0,0,0,0,0,0,0,0,0,0,0,0,0
20200312,053261,國巨群益96購05,0.66,0.66,0.41,0.41,-0.73,-64.04,55000,2,23800,0,0,0,0,0,0,50000,5000,45000,45000
20200312,053262,華邦電群益96購02,0.24,0.24,0.13,0.13,-0.19,-59.38,156000,5,32780,0,0,0,0,0,0,106000,56000,50000,50000
20200312,053263,華邦電群益96購03,0.03,0.03,0.03,0.03,0.00,0.00,402000,2,12060,0,0,0,0,0,0,400000,2000,398000,398000
20200312,053264,南亞科群益96購01,0.40,0.44,0.31,0.31,-0.35,-53.03,236000,6,92840,0,0,0,0,0,0,106000,130000,-24000,-24000
20200312,053265,南亞科群益96購02,0.06,0.06,0.05,0.05,-0.18,-78.26,204000,3,10830,0,0,0,0,0,0,0,204000,-204000,-204000
20200312,053266,全新群益98購01,0.27,0.27,0.21,0.21,-0.11,-34.38,90000,3,20700,0,0,0,0,0,0,60000,30000,30000,30000
20200312,053267,華新科群益96購02,0.88,0.88,0.76,0.76,-0.96,-55.81,6000,3,4920,0,0,0,0,0,0,0,6000,-6000,-6000
20200312,053268,日月光群益96購01,0.20,0.20,0.20,0.20,-0.19,-48.72,30000,3,6000,0,0,0,0,0,0,0,30000,-30000,-30000
20200312,053269,同欣電群益96購01,0.44,0.44,0.31,0.34,-0.19,-35.85,155000,7,62070,0,0,0,0,0,0,114000,41000,73000,73000
20200312,05326P,臺股指凱基95售10,3.84,3.84,3.84,3.84,+1.62,72.97,40000,1,153600,0,0,0,0,0,0,40000,0,40000,40000
20200312,053270,台塑元大96購01,0.62,0.62,0.39,0.39,-0.33,-45.83,317000,15,187730,0,0,0,0,0,0,196000,121000,75000,75000
20200312,053271,喬山元大97購01,0.22,0.22,0.18,0.18,0.00,0.00,60000,3,12710,0,0,0,0,0,0,60000,60000,0,0
20200312,053272,鴻海元大96購17,,,,,0.00,0.00,0,0,0,0,0,0,0,0,0,0,0,0,0
20200312,053273,國巨元大96購08,1.45,1.45,0.84,0.84,-0.87,-50.88,92000,8,106540,0,0,0,0,0,0,39000,82000,-43000,-43000
20200312,053274,旺宏元大98購03,1.14,1.14,0.83,0.83,-0.48,-36.64,144000,6,159540,0,0,0,0,0,0,72000,72000,0,0
20200312,053275,燿華元大97購01,0.16,0.16,0.16,0.16,-0.19,-54.29,20000,1,3200,0,0,0,0,0,0,20000,0,20000,20000
20200312,053276,友達元大9C購01,0.81,0.81,0.81,0.81,-0.30,-27.03,5000,1,4050,0,0,0,0,0,0,5000,0,5000,5000
20200312,053277,大立光元大96購04,0.25,0.25,0.20,0.23,0.00,0.00,317000,4,69350,0,0,0,0,0,0,20000,297000,-277000,-277000
20200312,053278,禾伸堂元大96購01,0.72,0.74,0.60,0.70,-0.07,-9.09,116000,9,80960,0,0,0,0,0,0,85000,111000,-26000,-26000
20200312,053279,景碩元大97購01,0.85,0.85,0.54,0.55,-0.48,-46.6,172000,11,127810,0,0,0,0,0,0,147000,46000,101000,101000
20200312,05327P,臺股指凱基95售11,,,,,0.00,0.00,0,0,0,0,0,0,0,0,0,0,0,0,0
20200312,053280,群創元大9C購01,0.63,0.63,0.55,0.55,-0.25,-31.25,281000,8,155680,0,0,0,0,0,0,11000,281000,-270000,-270000
20200312,053281,茂林元大96購02,0.85,0.85,0.49,0.49,-0.26,-34.67,533000,21,323990,0,0,0,0,0,0,213000,318000,-105000,-105000
20200312,053282,彩晶元大9C購01,0.93,0.93,0.75,0.75,-0.43,-36.44,208000,8,169760,0,0,0,0,0,0,9000,199000,-190000,-190000
20200312,053283,同欣電元大96購03,0.62,0.62,0.62,0.62,-0.22,-26.19,10000,1,6200,0,0,0,0,0,0,10000,0,10000,10000
20200312,053284,樺漢元大97購01,0.39,0.39,0.33,0.33,-0.29,-46.77,68000,2,23040,0,0,0,0,0,0,68000,0,68000,68000
20200312,053285,臺股指元大96購08,0.20,0.20,0.20,0.20,-0.35,-63.64,5000,1,1000,0,0,0,0,0,0,5000,0,5000,5000
20200312,053286,臺股指元大96購14,0.28,0.28,0.28,0.28,-0.47,-62.67,9000,2,2520,0,0,0,0,0,0,0,0,0,0
20200312,053287,臺股指元大96購15,,,,,0.00,0.00,0,0,0,0,0,0,0,0,0,0,0,0,0
20200312,053288,臺股指元大96購16,0.42,0.42,0.38,0.38,-0.46,-54.76,14000,2,5840,0,0,0,0,0,0,13000,1000,12000,12000
20200312,053289,臺股指元大96購17,0.31,0.31,0.31,0.31,0.00,0.00,1000,1,310,0,0,0,0,0,0,0,1000,-1000,-1000
20200312,05328P,臺股指凱基95售12,4.04,5.20,4.04,5.20,+2.27,77.47,25000,2,112600,0,0,0,0,0,0,25000,0,25000,25000
20200312,053290,元油反中信97購01,,,,,0.00,0.00,0,0,0,0,0,0,0,0,0,0,0,0,0
20200312,053291,旺宏中信9A購01,0.29,0.29,0.19,0.22,-0.11,-33.33,390000,19,87200,0,0,0,0,0,0,90000,300000,-210000,-210000
20200312,053292,美律中信98購01,0.74,0.74,0.56,0.56,-0.30,-34.88,286000,9,180180,0,0,0,0,0,0,100000,186000,-86000,-86000
20200312,053293,聯發科中信9B購01,0.20,0.20,0.16,0.18,0.00,0.00,139000,11,24090,0,0,0,0,0,0,116000,23000,93000,93000
20200312,053294,聯發科中信9C購01,0.25,0.25,0.22,0.23,0.00,0.00,57000,4,13150,0,0,0,0,0,0,17000,40000,-23000,-23000
20200312,053295,奇力新中信96購01,0.40,0.40,0.22,0.22,-0.28,-56.0,144000,13,44180,0,0,0,0,0,0,144000,24000,120000,120000
20200312,053296,貿聯中信98購01,0.39,0.39,0.36,0.38,-0.10,-20.83,48000,16,17690,0,0,0,0,0,0,48000,0,48000,48000
20200312,053297,鎧勝中信98購01,0.18,0.18,0.16,0.16,0.00,0.00,60000,3,10200,0,0,0,0,0,0,0,60000,-60000,-60000
20200312,053298,SP黃豆凱基99購01,0.41,0.42,0.40,0.42,-0.09,-17.65,110000,5,44700,0,0,0,0,0,0,85000,20000,65000,65000
20200312,053299,台泥凱基96購01,,,,,0.00,0.00,0,0,0,0,0,0,0,0,0,0,0,0,0
20200312,05329P,臺股指凱基95售13,3.92,5.50,3.92,5.50,+2.53,85.19,8000,3,41820,0,0,0,0,0,0,8000,0,8000,8000
20200312,053300,大成鋼凱基96購02,0.44,0.44,0.41,0.41,-0.19,-31.67,35000,3,15150,0,0,0,0,0,0,25000,10000,15000,15000
20200312,053301,華通凱基96購04,,,,,0.00,0.00,0,0,0,0,0,0,0,0,0,0,0,0,0
20200312,053302,國巨凱基96購10,0.74,0.74,0.35,0.35,-0.65,-65.0,221000,15,103400,0,0,0,0,0,0,110000,111000,-1000,-1000
20200312,053303,建準凱基96購03,0.21,0.21,0.21,0.21,0.00,0.00,10000,1,2100,0,0,0,0,0,0,10000,0,10000,10000
20200312,053304,可成凱基96購03,0.19,0.19,0.12,0.12,-0.21,-63.64,168000,4,23860,0,0,0,0,0,0,68000,100000,-32000,-32000
20200312,053305,聯詠凱基96購02,0.12,0.12,0.12,0.12,0.00,0.00,5000,1,600,0,0,0,0,0,0,5000,0,5000,5000
20200312,053306,晶技凱基97購01,0.91,0.91,0.46,0.46,-0.42,-47.73,741000,51,557180,0,0,0,0,0,0,462000,276000,186000,186000
20200312,053307,泰碩凱基97購01,0.68,0.69,0.49,0.55,-0.12,-17.91,338000,15,198340,0,0,0,0,0,0,79000,259000,-180000,-180000
20200312,053308,智易凱基96購02,,,,,0.00,0.00,0,0,0,0,0,0,0,0,0,0,0,0,0
20200312,053309,泰鼎凱基96購03,,,,,0.00,0.00,0,0,0,0,0,0,0,0,0,0,0,0,0
20200312,05330P,臺股指凱基95售14,,,,,0.00,0.00,0,0,0,0,0,0,0,0,0,0,0,0,0
20200312,053310,彩晶凱基98購02,,,,,0.00,0.00,0,0,0,0,0,0,0,0,0,0,0,0,0
20200312,053311,同欣電凱基96購01,0.13,0.13,0.08,0.08,0.00,0.00,80000,2,8900,0,0,0,0,0,0,80000,0,80000,80000
20200312,053312,緯穎凱基96購02,1.99,1.99,1.46,1.51,-0.78,-34.06,72000,10,119920,0,0,0,0,0,0,19000,67000,-48000,-48000
20200312,053313,世紀鋼凱基96購01,1.62,1.62,1.26,1.39,-0.23,-14.2,406000,25,607560,0,0,0,0,0,0,162000,244000,-82000,-82000
20200312,053314,A50正2群益9A購01,1.04,1.05,0.96,0.96,-0.19,-16.52,2723000,35,2781760,0,0,0,0,0,0,10000,2713000,-2703000,-2703000
20200312,053315,漢唐群益96購02,,,,,0.00,0.00,0,0,0,0,0,0,0,0,0,0,0,0,0
20200312,053316,友達群益9A購01,0.71,0.71,0.58,0.59,-0.27,-31.4,270000,15,168800,0,0,0,0,0,0,70000,200000,-130000,-130000
20200312,053317,友達群益9A購02,,,,,0.00,0.00,0,0,0,0,0,0,0,0,0,0,0,0,0
20200312,053318,全新群益99購01,0.51,0.51,0.43,0.43,-0.34,-44.16,108000,3,54440,0,0,0,0,0,0,0,108000,-108000,-108000
20200312,053319,可成群益96購04,,,,,0.00,0.00,0,0,0,0,0,0,0,0,0,0,0,0,0
20200312,05331P,上証2X國票96售01,1.60,1.60,1.57,1.58,0.00,0.00,35000,3,55350,0,0,0,0,0,0,0,35000,-35000,-35000
20200312,053320,華新科群益97購01,2.12,2.12,2.12,2.12,-1.59,-42.86,2000,1,4240,0,0,0,0,0,0,0,2000,-2000,-2000
20200312,053321,智原群益96購02,,,,,0.00,0.00,0,0,0,0,0,0,0,0,0,0,0,0,0
20200312,053322,京鼎群益97購01,0.53,0.53,0.41,0.41,-0.29,-41.43,184000,4,78520,0,0,0,0,0,0,151000,33000,118000,118000
20200312,053323,群創群益98購07,,,,,0.00,0.00,0,0,0,0,0,0,0,0,0,0,0,0,0
20200312,053324,康舒群益96購01,0.46,0.46,0.46,0.46,-0.13,-22.03,11000,1,5060,0,0,0,0,0,0,11000,0,11000,11000
20200312,053325,GIS群益96購02,,,,,0.00,0.00,0,0,0,0,0,0,0,0,0,0,0,0,0
20200312,053326,瀚宇博台新96購01,,,,,0.00,0.00,0,0,0,0,0,0,0,0,0,0,0,0,0
20200312,053327,彩晶台新97購01,0.13,0.13,0.13,0.13,-0.19,-59.38,10000,1,1300,0,0,0,0,0,0,10000,0,10000,10000
20200312,053328,滬深2X永豐99購01,,,,,0.00,0.00,0,0,0,0,0,0,0,0,0,0,0,0,0
20200312,053329,元油反永豐97購01,,,,,0.00,0.00,0,0,0,0,0,0,0,0,0,0,0,0,0
20200312,05332P,臺股指國票95售01,7.30,7.30,7.30,7.30,0.00,0.00,2000,1,14600,0,0,0,0,0,0,2000,0,2000,2000
20200312,053330,燿華永豐96購03,,,,,0.00,0.00,0,0,0,0,0,0,0,0,0,0,0,0,0
20200312,053331,玉晶光永豐97購02,1.23,1.23,0.90,0.90,-0.48,-34.78,70000,16,69200,0,0,0,0,0,0,20000,50000,-30000,-30000
20200312,053332,創意永豐96購03,0.53,0.53,0.40,0.40,-0.20,-33.33,57000,3,26640,0,0,0,0,0,0,3000,54000,-51000,-51000
20200312,053333,新唐永豐96購01,,,,,0.00,0.00,0,0,0,0,0,0,0,0,0,0,0,0,0
20200312,053334,訊芯永豐96購01,0.10,0.10,0.10,0.10,0.00,0.00,100000,1,10000,0,0,0,0,0,0,100000,0,100000,100000
20200312,053335,易華電永豐96購01,,,,,0.00,0.00,0,0,0,0,0,0,0,0,0,0,0,0,0
20200312,053336,元油反國票9B購02,5.25,5.25,5.25,5.25,0.00,0.00,5000,1,26250,0,0,0,0,0,0,5000,0,5000,5000
20200312,053337,聯電國票97購01,0.43,0.43,0.32,0.32,-0.19,-37.25,60000,5,23800,0,0,0,0,0,0,20000,40000,-20000,-20000
20200312,053338,台光電國票97購01,0.78,0.78,0.78,0.78,-0.82,-51.25,15000,1,11700,0,0,0,0,0,0,15000,0,15000,15000
20200312,053339,友達國票97購02,,,,,0.00,0.00,0,0,0,0,0,0,0,0,0,0,0,0,0
20200312,05333P,臺股指國票95售02,,,,,0.00,0.00,0,0,0,0,0,0,0,0,0,0,0,0,0
20200312,053340,建準國票97購01,,,,,0.00,0.00,0,0,0,0,0,0,0,0,0,0,0,0,0
20200312,053341,聯發科國票97購03,0.05,0.05,0.05,0.05,-0.02,-28.57,70000,4,3500,0,0,0,0,0,0,0,0,0,0
20200312,053342,全新國票99購01,0.29,0.29,0.24,0.24,-0.12,-33.33,393000,6,111570,0,0,0,0,0,0,223000,170000,53000,53000
20200312,053343,宏達電國票97購02,0.97,0.97,0.63,0.66,-0.40,-37.74,144000,19,113940,0,0,0,0,0,0,113000,31000,82000,82000
20200312,053344,嘉晶國票97購02,1.53,1.63,1.14,1.21,-0.60,-33.15,314000,15,461160,0,0,0,0,0,0,209000,105000,104000,104000
20200312,053345,欣興國票97購02,0.65,0.65,0.47,0.51,-0.72,-58.54,30000,4,17100,0,0,0,0,0,0,5000,25000,-20000,-20000
20200312,053346,群創國票97購04,0.12,0.12,0.12,0.12,0.00,0.00,7000,1,840,0,0,0,0,0,0,7000,0,7000,7000
20200312,053347,茂林國票98購01,1.20,1.21,0.82,0.82,-0.40,-32.79,129000,12,134200,0,0,0,0,0,0,31000,98000,-67000,-67000
20200312,053348,彩晶國票97購02,,,,,0.00,0.00,0,0,0,0,0,0,0,0,0,0,0,0,0
20200312,053349,台郡國票97購02,,,,,0.00,0.00,0,0,0,0,0,0,0,0,0,0,0,0,0
20200312,05334P,臺股指國票95售03,5.55,5.55,5.55,5.55,+0.75,15.62,20000,1,111000,0,0,0,0,0,0,20000,0,20000,20000
20200312,053350,台表科國票97購02,,,,,0.00,0.00,0,0,0,0,0,0,0,0,0,0,0,0,0
20200312,053351,A50正2兆豐97購01,0.70,0.76,0.70,0.76,-0.24,-24.0,60000,3,44400,0,0,0,0,0,0,10000,50000,-40000,-40000
20200312,053352,義隆兆豐96購01,0.85,0.86,0.83,0.83,-0.29,-25.89,25000,3,21030,0,0,0,0,0,0,25000,0,25000,25000
20200312,053353,玉晶光兆豐97購03,0.98,0.98,0.84,0.89,-0.46,-34.07,61000,7,53470,0,0,0,0,0,0,42000,19000,23000,23000
20200312,053354,康控兆豐97購02,,,,,0.00,0.00,0,0,0,0,0,0,0,0,0,0,0,0,0
20200312,053355,超眾兆豐97購01,0.61,0.61,0.51,0.51,-0.44,-46.32,9000,3,5210,0,0,0,0,0,0,0,9000,-9000,-9000
20200312,053356,聯發科統一96購07,0.60,0.60,0.35,0.35,-0.54,-60.67,292000,15,131660,0,0,0,0,0,0,104000,188000,-84000,-84000
20200312,053357,可成統一96購02,0.23,0.23,0.10,0.14,-0.18,-56.25,954000,29,171120,0,0,0,0,0,0,302000,489000,-187000,-187000
20200312,053358,晶技統一98購01,0.81,0.81,0.42,0.47,-0.31,-39.74,578000,34,387410,0,0,0,0,0,0,501000,1000,500000,500000
20200312,053359,矽力統一96購02,3.13,3.13,3.13,3.13,-0.92,-22.72,7000,1,21910,0,0,0,0,0,0,7000,0,7000,7000
20200312,05335P,臺股指國票95售04,6.40,8.80,6.40,7.90,+3.09,64.24,7000,7,52300,0,0,0,0,0,0,7000,0,7000,7000
20200312,053360,上証2X元富96購01,,,,,0.00,0.00,0,0,0,0,0,0,0,0,0,0,0,0,0
20200312,053361,友達元富99購01,,,,,0.00,0.00,0,0,0,0,0,0,0,0,0,0,0,0,0
20200312,053362,元油反國泰98購01,,,,,0.00,0.00,0,0,0,0,0,0,0,0,0,0,0,0,0
20200312,053363,旺宏國泰98購02,0.66,0.66,0.47,0.49,-0.42,-46.15,602000,11,342520,0,0,0,0,0,0,152000,492000,-340000,-340000
20200312,053364,友達國泰98購01,,,,,0.00,0.00,0,0,0,0,0,0,0,0,0,0,0,0,0
20200312,053365,彩晶國泰98購01,,,,,0.00,0.00,0,0,0,0,0,0,0,0,0,0,0,0,0
20200312,053366,樺漢國泰98購01,0.41,0.41,0.20,0.25,-0.21,-45.65,480000,20,166350,0,0,0,0,0,0,308000,170000,138000,138000
20200312,053367,元油反富邦97購01,,,,,0.00,0.00,0,0,0,0,0,0,0,0,0,0,0,0,0
20200312,053368,京元電富邦98購01,,,,,0.00,0.00,0,0,0,0,0,0,0,0,0,0,0,0,0
20200312,053369,T50反1元大96購06,1.21,1.42,1.21,1.42,+0.36,33.96,32000,3,41740,0,0,0,0,0,0,32000,0,32000,32000
20200312,05336P,臺股指國票95售05,7.25,9.50,7.25,9.50,0.00,0.00,22000,3,189500,0,0,0,0,0,0,22000,0,22000,22000
20200312,053370,上証2X元大97購03,0.53,0.62,0.52,0.61,-0.15,-19.74,256000,9,142290,0,0,0,0,0,0,256000,0,256000,256000
20200312,053371,滬深2X元大99購01,0.80,0.80,0.68,0.73,-0.28,-27.72,205000,10,147550,0,0,0,0,0,0,65000,130000,-65000,-65000
20200312,053372,元油反元大98購01,5.50,5.50,5.10,5.10,+1.77,53.15,15000,2,78500,0,0,0,0,0,0,0,15000,-15000,-15000
20200312,053373,台泥元大96購01,0.92,0.92,0.78,0.84,-0.18,-17.65,204000,5,169260,0,0,0,0,0,0,36000,184000,-148000,-148000
20200312,053374,台達電元大96購03,0.56,0.56,0.56,0.56,-0.09,-13.85,10000,1,5600,0,0,0,0,0,0,10000,0,10000,10000
20200312,053375,鴻海元大96購18,,,,,0.00,0.00,0,0,0,0,0,0,0,0,0,0,0,0,0
20200312,053376,鴻海元大96購19,,,,,0.00,0.00,0,0,0,0,0,0,0,0,0,0,0,0,0
20200312,053377,台積電元大98購01,0.80,0.82,0.50,0.50,0.00,0.00,44000,7,34690,0,0,0,0,0,0,0,0,0,0
20200312,053378,台積電元大98購02,1.56,1.56,1.13,1.35,-0.42,-23.73,102000,34,143560,0,0,0,0,0,0,14000,80000,-66000,-66000
20200312,053379,南亞科元大96購01,0.48,0.48,0.45,0.47,-0.44,-48.35,26000,3,12400,0,0,0,0,0,0,21000,5000,16000,16000
20200312,05337P,臺股指國票95售06,8.30,8.50,8.20,8.50,+3.30,63.46,17000,3,139800,0,0,0,0,0,0,17000,0,17000,17000
20200312,053380,南亞科元大97購01,0.76,0.76,0.53,0.54,-0.48,-47.06,62000,4,33420,0,0,0,0,0,0,60000,2000,58000,58000
20200312,053381,友達元大9A購02,,,,,0.00,0.00,0,0,0,0,0,0,0,0,0,0,0,0,0
20200312,053382,友達元大9C購02,0.70,0.70,0.70,0.70,0.00,0.00,10000,1,7000,0,0,0,0,0,0,10000,10000,0,0
20200312,053383,京元電元大97購01,1.13,1.13,0.82,0.82,-0.51,-38.35,107000,6,106580,0,0,0,0,0,0,77000,31000,46000,46000
20200312,053384,聯發科元大96購13,,,,,0.00,0.00,0,0,0,0,0,0,0,0,0,0,0,0,0
20200312,053385,聯詠元大96購02,0.46,0.46,0.36,0.39,-0.19,-32.76,318000,8,132690,0,0,0,0,0,0,209000,216000,-7000,-7000
20200312,053386,聯詠元大96購03,0.40,0.40,0.34,0.34,-0.21,-38.18,22000,2,8680,0,0,0,0,0,0,22000,0,22000,22000
20200312,053387,緯創元大97購01,,,,,0.00,0.00,0,0,0,0,0,0,0,0,0,0,0,0,0
20200312,053388,群創元大9C購02,,,,,0.00,0.00,0,0,0,0,0,0,0,0,0,0,0,0,0
20200312,053389,彩晶元大98購01,0.36,0.36,0.26,0.27,-0.18,-40.0,250000,5,77500,0,0,0,0,0,0,50000,200000,-150000,-150000
20200312,05338P,臺股指國票95售07,6.30,6.30,6.30,6.30,0.00,0.00,30000,1,189000,0,0,0,0,0,0,30000,0,30000,30000
20200312,053390,彩晶元大9A購01,0.32,0.32,0.32,0.32,-0.25,-43.86,100000,1,32000,0,0,0,0,0,0,0,100000,-100000,-100000
20200312,053391,嘉聯益元大99購01,0.41,0.41,0.38,0.39,-0.09,-18.75,100000,4,38290,0,0,0,0,0,0,0,0,0,0
20200312,053392,致新元大96購01,0.61,0.61,0.49,0.49,-0.15,-23.44,245000,6,133550,0,0,0,0,0,0,110000,135000,-25000,-25000
20200312,053393,元油反中信98購01,,,,,0.00,0.00,0,0,0,0,0,0,0,0,0,0,0,0,0
20200312,053394,鴻海中信9A購01,0.09,0.09,0.08,0.09,-0.06,-40.0,76000,9,6620,0,0,0,0,0,0,0,76000,-76000,-76000
20200312,053395,致茂中信96購01,0.49,0.49,0.34,0.34,-0.25,-42.37,284000,22,119140,0,0,0,0,0,0,168000,116000,52000,52000
20200312,053396,漢唐中信9A購01,0.38,0.38,0.37,0.37,-0.09,-19.57,50000,2,18800,0,0,0,0,0,0,50000,0,50000,50000
20200312,053397,國泰金中信96購01,0.23,0.23,0.23,0.23,-0.07,-23.33,20000,1,4600,0,0,0,0,0,0,20000,0,20000,20000
20200312,053398,和鑫中信99購01,,,,,0.00,0.00,0,0,0,0,0,0,0,0,0,0,0,0,0
20200312,053399,創意中信96購01,,,,,0.00,0.00,0,0,0,0,0,0,0,0,0,0,0,0,0
20200312,053400,緯穎中信9A購01,1.08,1.08,0.76,0.80,-0.35,-30.43,406000,46,366460,0,0,0,0,0,0,30000,366000,-336000,-336000
20200312,053401,臺股指中信99購01,0.26,0.26,0.16,0.20,-0.09,-31.03,1930000,67,371660,0,0,0,0,0,0,205000,785000,-580000,-580000
20200312,053402,A50正2群益9A購02,0.67,0.67,0.67,0.67,0.00,0.00,5000,1,3350,0,0,0,0,0,0,0,5000,-5000,-5000
20200312,053403,彩晶群益98購01,,,,,0.00,0.00,0,0,0,0,0,0,0,0,0,0,0,0,0
20200312,053404,致新群益96購01,0.92,0.93,0.71,0.76,-0.32,-29.63,179000,10,154520,0,0,0,0,0,0,120000,59000,61000,61000
20200312,053405,台達電兆豐96購01,2.41,2.41,2.35,2.35,-0.37,-13.6,69000,2,164010,0,0,0,0,0,0,69000,0,69000,69000
20200312,053406,國巨兆豐96購02,0.91,0.91,0.57,0.63,-0.42,-40.0,200000,14,131000,0,0,0,0,0,0,100000,100000,0,0
20200312,053407,台積電兆豐96購02,1.68,1.68,1.21,1.48,-0.54,-26.73,190000,25,261060,0,0,0,0,0,0,12000,178000,-166000,-166000
20200312,053408,友達兆豐98購01,,,,,0.00,0.00,0,0,0,0,0,0,0,0,0,0,0,0,0
20200312,053409,和碩兆豐96購02,0.30,0.30,0.30,0.30,-0.20,-40.0,20000,1,6000,0,0,0,0,0,0,0,20000,-20000,-20000
20200312,05340P,臺股指國票95售08,7.20,7.20,7.20,7.20,0.00,0.00,10000,1,72000,0,0,0,0,0,0,10000,0,10000,10000
20200312,053410,啟碁兆豐96購01,,,,,0.00,0.00,0,0,0,0,0,0,0,0,0,0,0,0,0
20200312,053411,深中小國票9B購01,1.26,1.26,1.24,1.25,-0.38,-23.31,65000,4,81150,0,0,0,0,0,0,65000,0,65000,65000
20200312,053412,台達電國票97購02,0.58,0.63,0.36,0.36,-0.35,-49.3,238000,20,119660,0,0,0,0,0,0,213000,175000,38000,38000
20200312,053413,台積電國票99購01,0.30,0.30,0.19,0.23,-0.16,-41.03,1505000,58,352200,0,0,0,0,0,0,0,1037000,-1037000,-1037000
20200312,053414,臻鼎國票97購01,0.19,0.19,0.12,0.12,-0.18,-60.0,204000,4,33210,0,0,0,0,0,0,39000,165000,-126000,-126000
20200312,053415,聯茂國票97購01,1.02,1.02,0.52,0.52,-0.91,-63.64,675000,34,502190,0,0,0,0,0,0,14000,651000,-637000,-637000
20200312,053416,光磊台新97購01,,,,,0.00,0.00,0,0,0,0,0,0,0,0,0,0,0,0,0
20200312,053417,上銀永豐96購02,0.37,0.42,0.28,0.28,-0.26,-48.15,97000,6,36570,0,0,0,0,0,0,91000,22000,69000,69000
20200312,053418,旺宏永豐96購02,0.05,0.05,0.03,0.03,-0.04,-57.14,609000,62,27200,0,0,0,0,0,0,0,609000,-609000,-609000
20200312,053419,光罩永豐96購01,,,,,0.00,0.00,0,0,0,0,0,0,0,0,0,0,0,0,0
20200312,05341P,臺股指兆豐95售02,,,,,0.00,0.00,0,0,0,0,0,0,0,0,0,0,0,0,0
20200312,053420,華邦電永豐96購01,,,,,0.00,0.00,0,0,0,0,0,0,0,0,0,0,0,0,0
20200312,053421,南亞科永豐96購01,0.19,0.19,0.19,0.19,-0.10,-34.48,20000,2,3800,0,0,0,0,0,0,0,20000,-20000,-20000
20200312,053422,可成永豐96購01,,,,,0.00,0.00,0,0,0,0,0,0,0,0,0,0,0,0,0
20200312,053423,亞光永豐96購01,0.98,0.98,0.65,0.65,-0.62,-48.82,82000,8,59360,0,0,0,0,0,0,20000,82000,-62000,-62000
20200312,053424,欣興永豐96購02,0.33,0.33,0.25,0.28,-0.40,-58.82,160000,7,46850,0,0,0,0,0,0,160000,3000,157000,157000
20200312,053425,京鼎永豐96購01,,,,,0.00,0.00,0,0,0,0,0,0,0,0,0,0,0,0,0
20200312,053426,創意永豐96購04,,,,,0.00,0.00,0,0,0,0,0,0,0,0,0,0,0,0,0
20200312,053427,鎧勝永豐96購02,0.35,0.35,0.22,0.22,-0.24,-52.17,125000,6,31500,0,0,0,0,0,0,75000,50000,25000,25000
20200312,053428,中磊永豐96購02,0.91,0.91,0.73,0.73,-0.33,-31.13,30000,3,24400,0,0,0,0,0,0,10000,20000,-10000,-10000
20200312,053429,彩晶永豐96購01,,,,,0.00,0.00,0,0,0,0,0,0,0,0,0,0,0,0,0
20200312,05342P,臺股指兆豐95售03,,,,,0.00,0.00,0,0,0,0,0,0,0,0,0,0,0,0,0
20200312,053430,樺漢永豐96購01,,,,,0.00,0.00,0,0,0,0,0,0,0,0,0,0,0,0,0
20200312,053431,志超永豐96購01,,,,,0.00,0.00,0,0,0,0,0,0,0,0,0,0,0,0,0
20200312,053432,世紀鋼永豐96購02,2.21,2.21,2.00,2.00,-0.29,-12.66,13000,2,28100,0,0,0,0,0,0,0,13000,-13000,-13000
20200312,053433,友達日盛99購06,0.17,0.17,0.17,0.17,-0.11,-39.29,1000,1,170,0,0,0,0,0,0,0,1000,-1000,-1000
20200312,053434,國泰金日盛96購01,,,,,0.00,0.00,0,0,0,0,0,0,0,0,0,0,0,0,0
20200312,053435,新光金日盛96購01,,,,,0.00,0.00,0,0,0,0,0,0,0,0,0,0,0,0,0
20200312,053436,聯茂日盛96購01,0.90,0.90,0.53,0.53,-0.67,-55.83,97000,4,66030,0,0,0,0,0,0,97000,0,97000,97000
20200312,053437,啟碁日盛96購01,,,,,0.00,0.00,0,0,0,0,0,0,0,0,0,0,0,0,0
20200312,053438,玉晶光麥證97購02,0.45,0.45,0.32,0.32,-0.23,-41.82,548000,12,182510,446000,102000,344000,0,0,0,446000,102000,344000,344000
20200312,053439,台積電凱基96購11,0.46,0.46,0.33,0.40,-0.17,-29.82,79000,12,29250,0,0,0,0,0,0,63000,14000,49000,49000
20200312,05343P,臺股指統一95售03,,,,,0.00,0.00,0,0,0,0,0,0,0,0,0,0,0,0,0
20200312,053440,台積電凱基96購12,0.20,0.20,0.11,0.19,-0.10,-34.48,470000,35,70500,0,0,0,0,0,0,130000,340000,-210000,-210000
20200312,053441,旺宏凱基98購01,0.26,0.26,0.17,0.20,-0.11,-35.48,129000,12,25350,0,0,0,0,0,0,30000,99000,-69000,-69000
20200312,053442,光罩凱基96購01,,,,,0.00,0.00,0,0,0,0,0,0,0,0,0,0,0,0,0
20200312,053443,智邦凱基97購01,1.33,1.33,0.79,0.91,-0.42,-31.58,233000,35,228080,0,0,0,0,0,0,78000,155000,-77000,-77000
20200312,053444,奇力新凱基96購03,0.17,0.17,0.09,0.12,-0.10,-45.45,2025000,72,229750,0,0,0,0,0,0,226000,1799000,-1573000,-1573000
20200312,053445,可成凱基96購04,0.25,0.25,0.25,0.25,-0.13,-34.21,20000,1,5000,0,0,0,0,0,0,20000,0,20000,20000
20200312,053446,欣興凱基96購02,,,,,0.00,0.00,0,0,0,0,0,0,0,0,0,0,0,0,0
20200312,053447,京鼎凱基96購03,,,,,0.00,0.00,0,0,0,0,0,0,0,0,0,0,0,0,0
20200312,053448,智易凱基96購03,0.08,0.08,0.08,0.08,0.00,0.00,11000,1,880,0,0,0,0,0,0,11000,0,11000,11000
20200312,053449,超眾凱基98購01,0.58,0.58,0.46,0.46,0.00,0.00,86000,5,43040,0,0,0,0,0,0,6000,84000,-78000,-78000
20200312,05344P,臺股指統一95售04,,,,,0.00,0.00,0,0,0,0,0,0,0,0,0,0,0,0,0
20200312,053450,同欣電凱基96購02,0.38,0.39,0.38,0.39,-0.10,-20.41,78000,2,30320,0,0,0,0,0,0,68000,10000,58000,58000
20200312,053451,致新凱基96購02,,,,,0.00,0.00,0,0,0,0,0,0,0,0,0,0,0,0,0
20200312,053452,臺股指凱基97購01,,,,,0.00,0.00,0,0,0,0,0,0,0,0,0,0,0,0,0
20200312,053453,新光金統一98購01,,,,,0.00,0.00,0,0,0,0,0,0,0,0,0,0,0,0,0
20200312,053454,創意統一96購02,,,,,0.00,0.00,0,0,0,0,0,0,0,0,0,0,0,0,0
20200312,053455,台光電元富96購02,0.45,0.45,0.42,0.42,-0.16,-27.59,57000,2,25440,0,0,0,0,0,0,57000,0,57000,57000
20200312,053456,大立光元富96購04,0.69,0.69,0.54,0.62,-0.63,-50.4,613000,11,371190,0,0,0,0,0,0,203000,414000,-211000,-211000
20200312,053457,旺宏國泰98購03,0.58,0.58,0.44,0.44,-0.27,-38.03,941000,13,512900,0,0,0,0,0,0,807000,134000,673000,673000
20200312,053458,聯詠國泰97購01,0.29,0.29,0.27,0.27,-0.07,-20.59,407000,3,111090,0,0,0,0,0,0,297000,110000,187000,187000
20200312,053459,康控國泰97購01,0.27,0.27,0.18,0.19,-0.13,-40.62,151000,4,36230,0,0,0,0,0,0,98000,53000,45000,45000
20200312,05345P,臺股指統一95售05,2.55,2.55,2.55,2.55,0.00,0.00,1000,1,2550,0,0,0,0,0,0,0,1000,-1000,-1000
20200312,053460,緯穎國泰97購01,1.94,1.94,1.94,1.94,-0.41,-17.45,65000,1,126100,0,0,0,0,0,0,0,65000,-65000,-65000
20200312,053461,台郡永昌99購01,,,,,0.00,0.00,0,0,0,0,0,0,0,0,0,0,0,0,0
20200312,053462,元油反富邦97購02,4.27,5.00,4.25,4.70,+1.78,60.96,137000,20,648580,0,0,0,0,0,0,21000,116000,-95000,-95000
20200312,053463,可成富邦98購01,0.22,0.22,0.13,0.15,-0.11,-42.31,410000,13,74150,0,0,0,0,0,0,10000,400000,-390000,-390000
20200312,053464,喬山元大96購01,0.20,0.20,0.14,0.14,-0.12,-46.15,19000,3,3220,0,0,0,0,0,0,0,19000,-19000,-19000
20200312,053465,聯電元大96購05,0.10,0.10,0.10,0.10,-0.09,-47.37,149000,1,14900,0,0,0,0,0,0,149000,0,149000,149000
20200312,053466,華通元大98購01,0.21,0.21,0.21,0.21,-0.24,-53.33,51000,1,10710,0,0,0,0,0,0,51000,0,51000,51000
20200312,053467,鴻海元大96購20,0.25,0.25,0.18,0.18,-0.20,-52.63,404000,9,82560,0,0,0,0,0,0,94000,310000,-216000,-216000
20200312,053468,鴻海元大98購01,0.24,0.24,0.18,0.18,-0.12,-40.0,358000,12,75100,0,0,0,0,0,0,220000,138000,82000,82000
20200312,053469,光磊元大97購01,0.33,0.33,0.31,0.31,0.00,0.00,19000,2,6070,0,0,0,0,0,0,0,19000,-19000,-19000
20200312,05346P,臺股指統一95售06,,,,,0.00,0.00,0,0,0,0,0,0,0,0,0,0,0,0,0
20200312,053470,華邦電元大96購02,0.21,0.25,0.10,0.11,-0.14,-56.0,616000,11,82400,0,0,0,0,0,0,0,596000,-596000,-596000
20200312,053471,正崴元大96購01,,,,,0.00,0.00,0,0,0,0,0,0,0,0,0,0,0,0,0
20200312,053472,漢唐元大96購02,0.63,0.63,0.53,0.53,-0.20,-27.4,67000,4,39410,0,0,0,0,0,0,57000,10000,47000,47000
20200312,053473,聯發科元大96購15,,,,,0.00,0.00,0,0,0,0,0,0,0,0,0,0,0,0,0
20200312,053474,聯發科元大97購06,0.34,0.34,0.19,0.21,0.00,0.00,294000,7,76010,0,0,0,0,0,0,169000,125000,44000,44000
20200312,053475,華新科元大96購05,,,,,0.00,0.00,0,0,0,0,0,0,0,0,0,0,0,0,0
20200312,053476,冠德元大96購03,0.07,0.07,0.05,0.05,0.00,0.00,206000,7,10320,0,0,0,0,0,0,200000,6000,194000,194000
20200312,053477,大立光元大97購03,0.99,0.99,0.75,0.79,-1.17,-59.69,63000,8,53390,0,0,0,0,0,0,13000,50000,-37000,-37000
20200312,053478,京鼎元大96購01,0.46,0.46,0.41,0.41,-0.34,-45.33,131000,4,55010,0,0,0,0,0,0,18000,131000,-113000,-113000
20200312,053479,達興元大96購01,,,,,0.00,0.00,0,0,0,0,0,0,0,0,0,0,0,0,0
20200312,05347P,滬深2X元富9B售02,1.61,1.82,1.61,1.76,+0.28,18.92,1161000,28,2005680,0,0,0,0,0,0,720000,1090000,-370000,-370000
20200312,053480,祥碩元大96購02,5.20,5.20,4.81,5.00,-2.40,-32.43,75000,3,378150,0,0,0,0,0,0,75000,75000,0,0
20200312,053481,同欣電元大97購01,0.69,0.69,0.48,0.54,-0.23,-29.87,528000,26,304350,0,0,0,0,0,0,260000,263000,-3000,-3000
20200312,053482,矽力元大96購03,1.82,1.82,1.60,1.63,-0.69,-29.74,104000,11,174580,0,0,0,0,0,0,72000,32000,40000,40000
20200312,053483,嘉澤第一96購01,,,,,0.00,0.00,0,0,0,0,0,0,0,0,0,0,0,0,0
20200312,053484,國巨國票97購03,0.56,0.56,0.56,0.56,-1.17,-67.63,10000,1,5600,0,0,0,0,0,0,0,10000,-10000,-10000
20200312,053485,矽創國票97購04,1.14,1.14,0.83,0.83,-0.55,-39.86,44000,5,47130,0,0,0,0,0,0,18000,26000,-8000,-8000
20200312,053486,T50反1兆豐96購01,1.95,1.95,1.86,1.89,+0.46,32.17,120000,8,229500,0,0,0,0,0,0,50000,70000,-20000,-20000
20200312,053487,台泥兆豐97購01,,,,,0.00,0.00,0,0,0,0,0,0,0,0,0,0,0,0,0
20200312,053488,中石化兆豐97購01,,,,,0.00,0.00,0,0,0,0,0,0,0,0,0,0,0,0,0
20200312,053489,上銀兆豐97購01,,,,,0.00,0.00,0,0,0,0,0,0,0,0,0,0,0,0,0
20200312,05348P,美律元富98售01,1.17,1.40,1.16,1.33,+0.20,17.7,202000,19,257910,0,0,0,0,0,0,81000,101000,-20000,-20000
20200312,053490,為升兆豐97購01,,,,,0.00,0.00,0,0,0,0,0,0,0,0,0,0,0,0,0
20200312,053491,鴻海兆豐97購02,0.84,0.84,0.64,0.64,-0.49,-43.36,118000,5,98360,0,0,0,0,0,0,118000,4000,114000,114000
20200312,053492,華邦電兆豐97購01,0.49,0.50,0.48,0.50,-0.35,-41.18,68000,3,33540,0,0,0,0,0,0,0,68000,-68000,-68000
20200312,053493,智邦兆豐97購02,,,,,0.00,0.00,0,0,0,0,0,0,0,0,0,0,0,0,0
20200312,053494,南亞科兆豐96購02,1.45,1.45,1.31,1.31,-1.26,-49.03,30000,2,40700,0,0,0,0,0,0,20000,10000,10000,10000
20200312,053495,聯發科兆豐96購02,0.43,0.43,0.26,0.28,-0.55,-66.27,53000,9,19950,0,0,0,0,0,0,24000,29000,-5000,-5000
20200312,053496,義隆兆豐96購02,1.74,1.74,1.71,1.73,-0.31,-15.2,27000,3,46580,0,0,0,0,0,0,27000,0,27000,27000
20200312,053497,新光金兆豐97購01,,,,,0.00,0.00,0,0,0,0,0,0,0,0,0,0,0,0,0
20200312,053498,大立光兆豐96購03,0.42,0.44,0.27,0.33,-0.40,-54.79,1298000,23,436760,0,0,0,0,0,0,0,1298000,-1298000,-1298000
20200312,053499,禾伸堂兆豐96購01,1.62,1.62,1.62,1.62,-0.04,-2.41,1000,1,1620,0,0,0,0,0,0,1000,0,1000,1000
20200312,05349P,可成元富98售03,4.41,4.66,4.41,4.66,+0.61,15.06,56000,6,253660,0,0,0,0,0,0,10000,46000,-36000,-36000
20200312,053500,新日興兆豐97購01,2.09,2.09,1.76,1.78,-0.52,-22.61,155000,7,284030,0,0,0,0,0,0,31000,124000,-93000,-93000
20200312,053501,明泰兆豐96購01,1.06,1.09,1.05,1.05,-0.24,-18.6,653000,13,692770,0,0,0,0,0,0,578000,75000,503000,503000
20200312,053502,智伸科兆豐97購01,0.95,0.95,0.95,0.95,-0.16,-14.41,10000,1,9500,0,0,0,0,0,0,10000,0,10000,10000
20200312,053503,臻鼎兆豐97購01,1.17,1.17,0.84,0.88,-0.57,-39.31,61000,8,56100,0,0,0,0,0,0,0,61000,-61000,-61000
20200312,053504,祥碩兆豐96購01,4.43,4.88,4.43,4.88,0.00,0.00,20000,2,93100,0,0,0,0,0,0,0,20000,-20000,-20000
20200312,053505,瑞儀兆豐97購01,,,,,0.00,0.00,0,0,0,0,0,0,0,0,0,0,0,0,0
20200312,053506,南茂兆豐97購01,1.22,1.23,1.08,1.08,-0.38,-26.03,117000,6,135680,0,0,0,0,0,0,63000,54000,9000,9000
20200312,053507,百和兆豐96購01,1.68,1.68,1.11,1.11,-0.74,-40.0,45000,7,68020,0,0,0,0,0,0,42000,3000,39000,39000
20200312,053508,元油反群益9A購01,,,,,0.00,0.00,0,0,0,0,0,0,0,0,0,0,0,0,0
20200312,053509,華新群益98購01,0.31,0.31,0.22,0.22,-0.16,-42.11,137000,4,40260,0,0,0,0,0,0,117000,20000,97000,97000
20200312,05350P,可成元富98售04,3.48,3.67,3.44,3.67,+0.53,16.88,50000,6,177710,0,0,0,0,0,0,13000,37000,-24000,-24000
20200312,053510,聯電群益97購01,0.14,0.14,0.10,0.13,-0.08,-38.1,200000,8,24080,0,0,0,0,0,0,107000,93000,14000,14000
20200312,053511,鴻海群益96購04,0.26,0.27,0.16,0.17,-0.22,-56.41,60000,5,13900,0,0,0,0,0,0,30000,30000,0,0
20200312,053512,台積電群益96購06,0.03,0.03,0.03,0.03,-0.02,-40.0,1032000,60,30960,0,0,0,0,0,0,60000,972000,-912000,-912000
20200312,053513,義隆群益96購05,,,,,0.00,0.00,0,0,0,0,0,0,0,0,0,0,0,0,0
20200312,053514,麗豐群益96購01,,,,,0.00,0.00,0,0,0,0,0,0,0,0,0,0,0,0,0
20200312,053515,致伸群益96購02,,,,,0.00,0.00,0,0,0,0,0,0,0,0,0,0,0,0,0
20200312,053516,茂林群益96購05,0.86,0.86,0.83,0.85,-0.16,-15.84,77000,5,64960,0,0,0,0,0,0,77000,37000,40000,40000
20200312,053517,崇越群益97購01,0.69,0.69,0.58,0.58,-0.24,-29.27,359000,2,211410,0,0,0,0,0,0,359000,0,359000,359000
20200312,053518,聯茂群益96購03,1.91,1.91,1.37,1.37,-1.33,-49.26,81000,6,134220,0,0,0,0,0,0,20000,61000,-41000,-41000
20200312,053519,力成群益96購02,,,,,0.00,0.00,0,0,0,0,0,0,0,0,0,0,0,0,0
20200312,05351P,臺股指元富95售05,,,,,0.00,0.00,0,0,0,0,0,0,0,0,0,0,0,0,0
20200312,053520,康友群益96購01,0.51,0.52,0.47,0.47,-0.09,-16.07,42000,4,21180,0,0,0,0,0,0,31000,11000,20000,20000
20200312,053521,緯穎群益96購02,2.55,2.99,2.55,2.78,-2.67,-48.99,49000,8,135720,0,0,0,0,0,0,0,48000,-48000,-48000
20200312,053522,臺股指群益99購01,0.36,0.41,0.36,0.41,-0.36,-46.75,73000,4,29180,0,0,0,0,0,0,15000,0,15000,15000
20200312,053523,T50反1中信9A購01,1.80,2.15,1.78,2.11,+0.51,31.88,53000,14,104140,0,0,0,0,0,0,24000,29000,-5000,-5000
20200312,053524,聯電中信97購02,,,,,0.00,0.00,0,0,0,0,0,0,0,0,0,0,0,0,0
20200312,053525,台積電中信96購04,0.20,0.20,0.12,0.17,-0.07,-29.17,412000,30,65030,0,0,0,0,0,0,161000,251000,-90000,-90000
20200312,053526,正崴中信96購01,,,,,0.00,0.00,0,0,0,0,0,0,0,0,0,0,0,0,0
20200312,053527,創意中信97購01,0.25,0.25,0.25,0.25,-0.10,-28.57,6000,1,1500,0,0,0,0,0,0,0,6000,-6000,-6000
20200312,053528,南電中信9A購01,0.62,0.63,0.45,0.46,-0.23,-33.33,327000,24,176300,0,0,0,0,0,0,210000,117000,93000,93000
20200312,053529,國巨麥證96購01,0.78,0.78,0.48,0.48,-0.52,-52.0,18000,3,11620,2000,8000,-6000,0,0,0,2000,8000,-6000,-6000
20200312,05352P,臺股指元富95售06,3.80,4.33,3.80,4.33,0.00,0.00,15000,2,59650,0,0,0,0,0,0,15000,0,15000,15000
20200312,053530,聯發科康和96購01,,,,,0.00,0.00,0,0,0,0,0,0,0,0,0,0,0,0,0
20200312,053531,國泰金康和96購01,,,,,0.00,0.00,0,0,0,0,0,0,0,0,0,0,0,0,0
20200312,053532,台積電永豐96購03,0.16,0.16,0.08,0.13,-0.07,-35.0,927000,64,126710,0,0,0,0,0,0,574000,497000,77000,77000
20200312,053533,光罩永豐96購03,,,,,0.00,0.00,0,0,0,0,0,0,0,0,0,0,0,0,0
20200312,053534,微星永豐96購02,1.17,1.19,1.02,1.06,-0.30,-22.06,168000,10,188520,0,0,0,0,0,0,108000,60000,48000,48000
20200312,053535,宏達電永豐96購02,0.70,0.70,0.70,0.70,-0.05,-6.67,20000,2,14000,0,0,0,0,0,0,0,20000,-20000,-20000
20200312,053536,明泰永豐96購01,0.45,0.45,0.42,0.42,-0.16,-27.59,70000,4,30200,0,0,0,0,0,0,50000,20000,30000,30000
20200312,053537,玉晶光永豐98購02,0.62,0.62,0.45,0.45,-0.27,-37.5,222000,10,123740,0,0,0,0,0,0,172000,50000,122000,122000
20200312,053538,京鼎永豐96購03,,,,,0.00,0.00,0,0,0,0,0,0,0,0,0,0,0,0,0
20200312,053539,智易永豐96購01,,,,,0.00,0.00,0,0,0,0,0,0,0,0,0,0,0,0,0
20200312,05353P,臺股指元富95售07,,,,,0.00,0.00,0,0,0,0,0,0,0,0,0,0,0,0,0
20200312,053540,健策永豐96購01,,,,,0.00,0.00,0,0,0,0,0,0,0,0,0,0,0,0,0
20200312,053541,泰鼎永豐96購02,,,,,0.00,0.00,0,0,0,0,0,0,0,0,0,0,0,0,0
20200312,053542,超眾永豐96購01,0.64,0.64,0.64,0.64,0.00,0.00,10000,1,6400,0,0,0,0,0,0,0,10000,-10000,-10000
20200312,053543,臺股指永豐96購02,,,,,0.00,0.00,0,0,0,0,0,0,0,0,0,0,0,0,0
20200312,053544,華新凱基96購01,,,,,0.00,0.00,0,0,0,0,0,0,0,0,0,0,0,0,0
20200312,053545,上銀凱基96購03,0.66,0.66,0.32,0.32,-0.61,-65.59,193000,16,105010,0,0,0,0,0,0,78000,115000,-37000,-37000
20200312,053546,台積電凱基96購13,0.36,0.36,0.22,0.31,-0.42,-57.53,461000,4,134380,0,0,0,0,0,0,68000,393000,-325000,-325000
20200312,053547,台積電凱基96購14,0.19,0.19,0.18,0.18,-0.09,-33.33,27000,3,4960,0,0,0,0,0,0,27000,0,27000,27000
20200312,053548,旺宏凱基96購04,0.39,0.39,0.28,0.28,-0.26,-48.15,187000,4,57190,0,0,0,0,0,0,34000,153000,-119000,-119000
20200312,053549,南亞科凱基96購02,,,,,0.00,0.00,0,0,0,0,0,0,0,0,0,0,0,0,0
20200312,05354P,臺股指元富95售08,,,,,0.00,0.00,0,0,0,0,0,0,0,0,0,0,0,0,0
20200312,053550,聯發科凱基96購15,0.10,0.10,0.10,0.10,0.00,0.00,20000,2,2000,0,0,0,0,0,0,0,20000,-20000,-20000
20200312,053551,可成凱基96購05,,,,,0.00,0.00,0,0,0,0,0,0,0,0,0,0,0,0,0
20200312,053552,華新科凱基96購08,0.55,0.55,0.27,0.35,-0.47,-57.32,160000,14,51280,0,0,0,0,0,0,129000,55000,74000,74000
20200312,053553,聯詠凱基96購03,0.30,0.30,0.28,0.28,-0.14,-33.33,68000,3,19340,0,0,0,0,0,0,68000,0,68000,68000
20200312,053554,欣興凱基97購02,,,,,0.00,0.00,0,0,0,0,0,0,0,0,0,0,0,0,0
20200312,053555,日月光凱基97購01,,,,,0.00,0.00,0,0,0,0,0,0,0,0,0,0,0,0,0
20200312,053556,康控凱基97購02,0.10,0.10,0.10,0.10,-0.08,-44.44,10000,1,1000,0,0,0,0,0,0,0,10000,-10000,-10000
20200312,053557,聯茂凱基96購04,,,,,0.00,0.00,0,0,0,0,0,0,0,0,0,0,0,0,0
20200312,053558,訊芯凱基96購02,,,,,0.00,0.00,0,0,0,0,0,0,0,0,0,0,0,0,0
20200312,053559,台積電國泰98購01,0.46,0.46,0.30,0.39,-0.15,-27.78,1714000,59,656390,0,0,0,0,0,0,506000,1113000,-607000,-607000
20200312,05355P,臺股指元富95售09,,,,,0.00,0.00,0,0,0,0,0,0,0,0,0,0,0,0,0
20200312,053560,漢唐國泰98購01,0.95,0.95,0.85,0.85,-0.22,-20.56,40000,3,36300,0,0,0,0,0,0,20000,20000,0,0
20200312,053561,玉晶光國泰98購01,1.28,1.28,0.87,0.87,-0.49,-36.03,553000,21,582750,0,0,0,0,0,0,292000,261000,31000,31000
20200312,053562,玉晶光國泰98購02,1.45,1.45,1.04,1.04,-0.52,-33.33,433000,16,527010,0,0,0,0,0,0,194000,242000,-48000,-48000
20200312,053563,台積電富邦97購01,0.10,0.12,0.10,0.12,-0.01,-7.69,829000,54,86640,0,0,0,0,0,0,0,454000,-454000,-454000
20200312,053564,台積電富邦99購01,0.15,0.17,0.13,0.15,-0.03,-16.67,6127000,213,910850,0,100000,-100000,0,0,0,0,0,0,-100000
20200312,053565,台光電富邦98購01,0.43,0.43,0.34,0.34,-0.14,-29.17,106000,4,36300,0,0,0,0,0,0,0,106000,-106000,-106000
20200312,053566,大立光富邦99購03,0.27,0.27,0.19,0.24,-0.24,-50.0,270000,8,62150,0,0,0,0,0,0,0,270000,-270000,-270000
20200312,053567,群創富邦97購01,,,,,0.00,0.00,0,0,0,0,0,0,0,0,0,0,0,0,0
20200312,053568,智伸科富邦98購01,0.22,0.23,0.10,0.10,-0.19,-65.52,3000,3,550,0,0,0,0,0,0,2000,0,2000,2000
20200312,053569,漢唐統一98購01,,,,,0.00,0.00,0,0,0,0,0,0,0,0,0,0,0,0,0
20200312,05356P,臺股指元富95售10,,,,,0.00,0.00,0,0,0,0,0,0,0,0,0,0,0,0,0
20200312,053570,京元電統一96購01,,,,,0.00,0.00,0,0,0,0,0,0,0,0,0,0,0,0,0
20200312,053571,奇鋐統一96購02,,,,,0.00,0.00,0,0,0,0,0,0,0,0,0,0,0,0,0
20200312,053572,彩晶統一96購01,0.12,0.12,0.11,0.11,-0.07,-38.89,35000,3,4150,0,0,0,0,0,0,0,35000,-35000,-35000
20200312,053573,臺股指統一99購01,0.78,0.78,0.54,0.54,-0.55,-50.46,262000,15,196510,0,0,0,0,0,0,0,262000,-262000,-262000
20200312,053574,奇力新元富99購01,0.49,0.49,0.30,0.30,-0.25,-45.45,91000,13,36610,0,0,0,0,0,0,51000,40000,11000,11000
20200312,053575,聯詠元富96購01,0.33,0.33,0.33,0.33,-0.11,-25.0,10000,1,3300,0,0,0,0,0,0,10000,0,10000,10000
20200312,053576,智原元富96購01,,,,,0.00,0.00,0,0,0,0,0,0,0,0,0,0,0,0,0
20200312,053577,上証2X元大96購02,0.55,0.55,0.48,0.48,-0.24,-33.33,1368000,7,697190,0,0,0,0,0,0,1118000,1248000,-130000,-130000
20200312,053578,華新元大98購01,0.30,0.30,0.30,0.30,-0.19,-38.78,10000,1,3000,0,0,0,0,0,0,0,10000,-10000,-10000
20200312,053579,華通元大97購01,,,,,0.00,0.00,0,0,0,0,0,0,0,0,0,0,0,0,0
20200312,05357P,臺股指元富95售11,,,,,0.00,0.00,0,0,0,0,0,0,0,0,0,0,0,0,0
20200312,053580,國巨元大96購10,1.86,1.90,1.20,1.30,-0.72,-35.64,122000,17,204280,0,0,0,0,0,0,65000,86000,-21000,-21000
20200312,053581,台積電元大96購14,,,,,0.00,0.00,0,0,0,0,0,0,0,0,0,0,0,0,0
20200312,053582,英業達元大97購01,1.24,1.24,1.21,1.22,-0.34,-21.79,6000,3,7330,0,0,0,0,0,0,6000,0,6000,6000
20200312,053583,漢唐元大96購03,0.57,0.57,0.57,0.57,-0.24,-29.63,68000,1,38760,0,0,0,0,0,0,0,68000,-68000,-68000
20200312,053584,友達元大9B購02,0.81,0.81,0.70,0.75,-0.21,-21.88,30000,4,22600,0,0,0,0,0,0,10000,20000,-10000,-10000
20200312,053585,友達元大9C購03,0.58,0.58,0.58,0.58,0.00,0.00,10000,1,5800,0,0,0,0,0,0,10000,10000,0,0
20200312,053586,建準元大96購01,0.54,0.54,0.48,0.48,-0.26,-35.14,25000,2,13200,0,0,0,0,0,0,0,25000,-25000,-25000
20200312,053587,京元電元大98購01,0.67,0.67,0.47,0.50,-0.27,-35.06,800000,23,426050,0,0,0,0,0,0,115000,685000,-570000,-570000
20200312,053588,聯發科元大97購07,0.22,0.22,0.20,0.20,-0.22,-52.38,110000,2,24000,0,0,0,0,0,0,10000,100000,-90000,-90000
20200312,053589,宏達電元大97購02,0.36,0.36,0.36,0.36,-0.29,-44.62,50000,1,18000,0,0,0,0,0,0,0,50000,-50000,-50000
20200312,05358P,大立光元大95售09,2.60,3.01,2.60,3.01,0.00,0.00,80000,5,226150,0,0,0,0,0,0,0,80000,-80000,-80000
20200312,053590,新光金元大9A購02,0.28,0.29,0.28,0.29,-0.07,-19.44,100000,2,28100,0,0,0,0,0,0,0,100000,-100000,-100000
20200312,053591,大立光元大99購03,0.50,0.52,0.40,0.40,-0.50,-55.56,346000,17,150630,0,0,0,0,0,0,175000,171000,4000,4000
20200312,053592,亞光元大96購01,1.03,1.03,0.68,0.68,-0.69,-50.36,61000,7,50490,0,0,0,0,0,0,31000,53000,-22000,-22000
20200312,053593,晶技元大98購01,0.96,0.96,0.66,0.66,-0.24,-26.67,414000,24,349600,0,0,0,0,0,0,274000,131000,143000,143000
20200312,053594,京鼎元大96購02,0.19,0.20,0.19,0.19,-0.12,-38.71,68000,4,13020,0,0,0,0,0,0,68000,0,68000,68000
20200312,053595,創意元大96購02,0.38,0.38,0.26,0.28,-0.26,-48.15,380000,4,126800,0,0,0,0,0,0,380000,0,380000,380000
20200312,053596,嘉澤元大96購01,0.68,0.68,0.44,0.45,-0.47,-51.09,47000,4,27090,0,0,0,0,0,0,47000,15000,32000,32000
20200312,053597,牧德元大99購01,1.07,1.07,0.93,0.93,-0.35,-27.34,71000,4,68570,0,0,0,0,0,0,0,71000,-71000,-71000
20200312,053598,日月光元大96購04,,,,,0.00,0.00,0,0,0,0,0,0,0,0,0,0,0,0,0
20200312,053599,崇越元大96購01,0.50,0.50,0.50,0.50,-0.31,-38.27,30000,1,15000,0,0,0,0,0,0,30000,0,30000,30000
20200312,05359P,嘉澤元大95售02,1.31,1.45,1.31,1.45,+0.27,22.88,127000,3,178530,0,0,0,0,0,0,39000,88000,-49000,-49000
20200312,053600,同欣電元大96購04,0.25,0.25,0.14,0.16,-0.14,-46.67,309000,10,63280,0,0,0,0,0,0,228000,81000,147000,147000
20200312,053601,台表科元大98購01,0.32,0.32,0.22,0.23,-0.14,-37.84,489000,8,119380,0,0,0,0,0,0,369000,120000,249000,249000
20200312,053602,台虹元大96購01,1.40,1.40,1.07,1.17,-0.32,-21.48,404000,19,497570,0,0,0,0,0,0,190000,214000,-24000,-24000
20200312,053603,臺股指元大96購20,,,,,0.00,0.00,0,0,0,0,0,0,0,0,0,0,0,0,0
20200312,053604,臺股指元大96購21,,,,,0.00,0.00,0,0,0,0,0,0,0,0,0,0,0,0,0
20200312,053605,臺股指永昌96購01,,,,,0.00,0.00,0,0,0,0,0,0,0,0,0,0,0,0,0
20200312,053606,臺股指永昌96購02,,,,,0.00,0.00,0,0,0,0,0,0,0,0,0,0,0,0,0
20200312,053607,大立光第一96購01,,,,,0.00,0.00,0,0,0,0,0,0,0,0,0,0,0,0,0
20200312,053608,彩晶第一96購01,,,,,0.00,0.00,0,0,0,0,0,0,0,0,0,0,0,0,0
20200312,053609,華新中信9A購01,,,,,0.00,0.00,0,0,0,0,0,0,0,0,0,0,0,0,0
20200312,05360P,健策元大95售03,1.08,1.36,1.08,1.36,+0.40,41.67,541000,14,657710,0,0,0,0,0,0,356000,175000,181000,181000
20200312,053610,矽力中信98購01,0.72,0.72,0.56,0.63,-0.17,-21.25,491000,43,308720,0,0,0,0,0,0,326000,165000,161000,161000
20200312,053611,聯茂麥證96購01,1.07,1.07,0.79,0.79,-0.50,-38.76,107000,7,100130,97000,10000,87000,0,0,0,97000,74000,23000,23000
20200312,053612,T50反1群益96購01,1.02,1.30,1.02,1.30,+0.40,44.44,215000,4,278940,0,0,0,0,0,0,215000,0,215000,215000
20200312,053613,元油反群益9A購02,,,,,0.00,0.00,0,0,0,0,0,0,0,0,0,0,0,0,0
20200312,053614,台積電群益96購08,0.10,0.12,0.10,0.11,-0.09,-45.0,270000,7,27600,0,0,0,0,0,0,180000,40000,140000,140000
20200312,053615,光罩群益96購01,0.10,0.10,0.06,0.08,-0.10,-55.56,192000,20,15960,0,0,0,0,0,0,55000,132000,-77000,-77000
20200312,053616,奇力新群益97購01,0.71,0.71,0.71,0.71,-0.23,-24.47,10000,1,7100,0,0,0,0,0,0,10000,0,10000,10000
20200312,053617,宏達電群益96購02,,,,,0.00,0.00,0,0,0,0,0,0,0,0,0,0,0,0,0
20200312,053618,新唐群益96購01,,,,,0.00,0.00,0,0,0,0,0,0,0,0,0,0,0,0,0
20200312,053619,和碩群益96購01,,,,,0.00,0.00,0,0,0,0,0,0,0,0,0,0,0,0,0
20200312,05361P,聯發科富邦97售01,1.44,1.72,1.44,1.70,+0.36,26.87,169000,25,270070,0,0,0,0,0,0,92000,143000,-51000,-51000
20200312,053620,臺股指群益96購06,0.20,0.20,0.20,0.20,0.00,0.00,23000,2,4600,0,0,0,0,0,0,23000,0,23000,23000
20200312,053621,臺股指群益96購07,0.24,0.24,0.21,0.21,-0.45,-68.18,200000,2,45000,0,0,0,0,0,0,200000,0,200000,200000
20200312,053622,臺股指群益96購08,,,,,0.00,0.00,0,0,0,0,0,0,0,0,0,0,0,0,0
20200312,053623,臺股指群益96購09,,,,,0.00,0.00,0,0,0,0,0,0,0,0,0,0,0,0,0
20200312,053624,A50正2兆豐97購02,0.78,0.78,0.65,0.69,-0.21,-23.33,371000,10,258990,0,0,0,0,0,0,170000,201000,-31000,-31000
20200312,053625,國巨兆豐96購03,0.41,0.56,0.30,0.30,-0.40,-57.14,1011000,44,377640,0,0,0,0,0,0,268000,733000,-465000,-465000
20200312,053626,台積電兆豐96購03,0.10,0.10,0.10,0.10,-0.13,-56.52,30000,3,3000,0,0,0,0,0,0,0,10000,-10000,-10000
20200312,053627,宏碁兆豐97購01,0.33,0.33,0.28,0.28,-0.20,-41.67,300000,3,88500,0,0,0,0,0,0,210000,90000,120000,120000
20200312,053628,微星兆豐96購01,2.36,2.36,2.36,2.36,-0.19,-7.45,10000,1,23600,0,0,0,0,0,0,10000,0,10000,10000
20200312,053629,玉山金兆豐96購01,,,,,0.00,0.00,0,0,0,0,0,0,0,0,0,0,0,0,0
20200312,05362P,可成富邦97售02,,,,,0.00,0.00,0,0,0,0,0,0,0,0,0,0,0,0,0
20200312,053630,奇鋐兆豐97購01,0.90,0.90,0.79,0.79,-0.22,-21.78,828000,8,698470,0,0,0,0,0,0,400000,400000,0,0
20200312,053631,欣興兆豐97購01,,,,,0.00,0.00,0,0,0,0,0,0,0,0,0,0,0,0,0
20200312,053632,新唐兆豐96購01,1.05,1.05,0.92,0.92,-0.31,-25.2,106000,4,108400,0,0,0,0,0,0,56000,50000,6000,6000
20200312,053633,臺股指兆豐96購01,,,,,0.00,0.00,0,0,0,0,0,0,0,0,0,0,0,0,0
20200312,053634,劍麟永豐96購01,,,,,0.00,0.00,0,0,0,0,0,0,0,0,0,0,0,0,0
20200312,053635,技嘉永豐96購01,0.86,0.86,0.66,0.72,-0.19,-20.88,61000,7,48160,0,0,0,0,0,0,61000,3000,58000,58000
20200312,053636,全新永豐96購02,,,,,0.00,0.00,0,0,0,0,0,0,0,0,0,0,0,0,0
20200312,053637,強茂永豐96購01,0.83,0.83,0.56,0.56,-0.47,-45.63,216000,3,140280,0,0,0,0,0,0,216000,0,216000,216000
20200312,053638,信邦永豐96購01,0.40,0.40,0.40,0.40,-0.12,-23.08,54000,1,21600,0,0,0,0,0,0,54000,0,54000,54000
20200312,053639,禾伸堂永豐96購01,1.20,1.20,0.82,1.02,-0.24,-19.05,144000,6,138970,0,0,0,0,0,0,52000,114000,-62000,-62000
20200312,05363P,臺股指富邦95售03,0.99,1.50,0.99,1.50,0.00,0.00,13000,2,17970,0,0,0,0,0,0,3000,0,3000,3000
20200312,053640,上緯控永豐96購01,0.58,0.67,0.58,0.59,-0.38,-39.18,99000,4,61060,0,0,0,0,0,0,83000,16000,67000,67000
20200312,053641,正文永豐96購01,0.52,0.52,0.38,0.38,-0.10,-20.83,129000,3,62440,0,0,0,0,0,0,102000,27000,75000,75000
20200312,053642,瀚宇博永豐96購01,0.58,0.58,0.58,0.58,-0.26,-30.95,68000,1,39440,0,0,0,0,0,0,68000,0,68000,68000
20200312,053643,漢唐國票97購02,,,,,0.00,0.00,0,0,0,0,0,0,0,0,0,0,0,0,0
20200312,053644,台表科國票97購03,,,,,0.00,0.00,0,0,0,0,0,0,0,0,0,0,0,0,0
20200312,053645,臺股指國票96購08,,,,,0.00,0.00,0,0,0,0,0,0,0,0,0,0,0,0,0
20200312,053646,臺股指國票96購09,0.42,0.64,0.15,0.64,-0.02,-3.03,72000,9,19480,0,0,0,0,0,0,10000,35000,-25000,-25000
20200312,053647,臺股指國票96購10,,,,,0.00,0.00,0,0,0,0,0,0,0,0,0,0,0,0,0
20200312,053648,台積電凱基97購04,0.39,0.39,0.30,0.30,0.00,0.00,135000,3,49700,0,0,0,0,0,0,0,135000,-135000,-135000
20200312,053649,台積電凱基97購05,0.14,0.14,0.14,0.14,0.00,0.00,10000,2,1400,0,0,0,0,0,0,0,0,0,0
20200312,05364P,臺股指富邦95售04,2.38,2.38,2.38,2.38,+0.86,56.58,100000,1,238000,0,0,0,0,0,0,100000,0,100000,100000
20200312,053650,華邦電凱基98購01,,,,,0.00,0.00,0,0,0,0,0,0,0,0,0,0,0,0,0
20200312,053651,台光電凱基98購01,0.70,0.70,0.70,0.70,-0.10,-12.5,30000,1,21000,0,0,0,0,0,0,0,0,0,0
20200312,053652,友達凱基98購04,0.30,0.30,0.30,0.30,0.00,0.00,10000,2,3000,0,0,0,0,0,0,0,10000,-10000,-10000
20200312,053653,京元電凱基96購02,,,,,0.00,0.00,0,0,0,0,0,0,0,0,0,0,0,0,0
20200312,053654,聯發科凱基98購01,0.13,0.13,0.10,0.10,-0.20,-66.67,173000,9,21100,0,0,0,0,0,0,40000,33000,7000,7000
20200312,053655,全新凱基98購02,,,,,0.00,0.00,0,0,0,0,0,0,0,0,0,0,0,0,0
20200312,053656,可成凱基96購06,0.38,0.38,0.22,0.23,-0.32,-58.18,152000,10,39500,0,0,0,0,0,0,72000,142000,-70000,-70000
20200312,053657,元大金凱基96購01,0.12,0.12,0.10,0.10,-0.07,-41.18,3654000,28,427890,0,0,0,0,0,0,20000,3634000,-3614000,-3614000
20200312,053658,亞光凱基96購01,0.70,0.70,0.70,0.70,-0.88,-55.7,68000,1,47600,0,0,0,0,0,0,0,68000,-68000,-68000
20200312,053659,智原凱基97購01,,,,,0.00,0.00,0,0,0,0,0,0,0,0,0,0,0,0,0
20200312,05365P,臺股指富邦95售05,1.50,3.47,1.50,3.47,+2.17,166.92,31000,3,51020,0,0,0,0,0,0,30000,0,30000,30000
20200312,053660,群創凱基98購08,,,,,0.00,0.00,0,0,0,0,0,0,0,0,0,0,0,0,0
20200312,053661,嘉澤凱基97購01,0.24,0.24,0.22,0.22,-0.19,-46.34,30000,2,6800,0,0,0,0,0,0,10000,20000,-10000,-10000
20200312,053662,矽力凱基97購01,1.56,1.56,1.40,1.40,-0.53,-27.46,36000,8,54380,0,0,0,0,0,0,36000,0,36000,36000
20200312,053663,臺股指凱基96購24,0.09,0.09,0.09,0.09,0.00,0.00,30000,1,2700,0,0,0,0,0,0,30000,0,30000,30000
20200312,053664,臺股指凱基96購25,,,,,0.00,0.00,0,0,0,0,0,0,0,0,0,0,0,0,0
20200312,053665,臺股指凱基96購26,0.09,0.09,0.09,0.09,0.00,0.00,50000,2,4500,0,0,0,0,0,0,0,50000,-50000,-50000
20200312,053666,臺股指凱基96購29,0.11,0.11,0.11,0.11,-0.32,-74.42,6000,1,660,0,0,0,0,0,0,0,6000,-6000,-6000
20200312,053667,鴻海統一96購12,,,,,0.00,0.00,0,0,0,0,0,0,0,0,0,0,0,0,0
20200312,053668,鴻海統一97購01,0.71,0.71,0.45,0.50,-0.46,-47.92,348000,11,196850,0,0,0,0,0,0,49000,300000,-251000,-251000
20200312,053669,台積電統一96購08,0.23,0.23,0.16,0.16,-0.15,-48.39,150000,6,27900,0,0,0,0,0,0,20000,130000,-110000,-110000
20200312,05366P,鴻海元富95售12,4.20,4.83,4.07,4.83,+1.08,28.8,218000,16,946870,0,0,0,0,0,0,97000,121000,-24000,-24000
20200312,053670,台積電統一96購09,0.05,0.05,0.02,0.02,-0.01,-33.33,252000,7,5190,0,0,0,0,0,0,0,252000,-252000,-252000
20200312,053671,可成統一96購03,0.37,0.38,0.36,0.36,-0.39,-52.0,25000,4,9140,0,0,0,0,0,0,25000,9000,16000,16000
20200312,053672,嘉澤元富96購02,,,,,0.00,0.00,0,0,0,0,0,0,0,0,0,0,0,0,0
20200312,053673,超眾元富96購03,1.32,1.32,1.12,1.12,-0.56,-33.33,200000,5,238380,0,0,0,0,0,0,82000,150000,-68000,-68000
20200312,053674,臺股指元富96購01,,,,,0.00,0.00,0,0,0,0,0,0,0,0,0,0,0,0,0
20200312,053675,臺股指元富96購02,0.04,0.09,0.04,0.09,-0.01,-10.0,165000,6,7140,0,0,0,0,0,0,0,0,0,0
20200312,053676,新光金國泰98購02,,,,,0.00,0.00,0,0,0,0,0,0,0,0,0,0,0,0,0
20200312,053677,同欣電國泰97購01,0.79,0.79,0.49,0.55,-0.32,-36.78,348000,21,232020,0,0,0,0,0,0,210000,138000,72000,72000
20200312,053678,南亞科富邦97購01,0.40,0.40,0.25,0.25,-0.45,-64.29,61000,7,20100,0,0,0,0,0,0,21000,40000,-19000,-19000
20200312,053679,緯創富邦96購01,,,,,0.00,0.00,0,0,0,0,0,0,0,0,0,0,0,0,0
20200312,05367P,鴻海元富95售13,3.38,3.65,3.38,3.65,+0.65,21.67,57000,4,200030,0,0,0,0,0,0,30000,27000,3000,3000
20200312,053680,臺股指富邦96購01,,,,,0.00,0.00,0,0,0,0,0,0,0,0,0,0,0,0,0
20200312,053681,臺股指富邦96購02,,,,,0.00,0.00,0,0,0,0,0,0,0,0,0,0,0,0,0
20200312,053682,臺股指富邦96購03,,,,,0.00,0.00,0,0,0,0,0,0,0,0,0,0,0,0,0
20200312,053683,上証2X元大96購03,,,,,0.00,0.00,0,0,0,0,0,0,0,0,0,0,0,0,0
20200312,053684,台積電元大96購17,0.13,0.14,0.09,0.12,-0.12,-50.0,608000,17,75690,0,0,0,0,0,0,287000,291000,-4000,-4000
20200312,053685,台積電元大96購18,,,,,0.00,0.00,0,0,0,0,0,0,0,0,0,0,0,0,0
20200312,053686,台積電元大97購08,0.33,0.33,0.26,0.28,-0.12,-30.0,314000,35,96540,0,0,0,0,0,0,0,307000,-307000,-307000
20200312,053687,智邦元大96購02,1.42,1.42,0.99,1.13,-0.43,-27.56,414000,20,452660,0,0,0,0,0,0,172000,402000,-230000,-230000
20200312,053688,燿華元大96購05,0.39,0.39,0.39,0.39,-0.13,-25.0,10000,1,3900,0,0,0,0,0,0,10000,0,10000,10000
20200312,053689,台光電元大96購01,0.70,0.70,0.44,0.44,-0.35,-44.3,478000,8,301640,0,0,0,0,0,0,362000,116000,246000,246000
20200312,05368P,可成元富95售03,3.87,4.21,3.87,4.21,+0.85,25.3,135000,12,534570,0,0,0,0,0,0,71000,64000,7000,7000
20200312,053690,南亞科元大96購02,0.54,0.58,0.35,0.35,-0.47,-57.32,706000,9,296780,0,0,0,0,0,0,410000,296000,114000,114000
20200312,053691,聯發科元大96購16,0.07,0.07,0.06,0.07,0.00,0.00,210000,3,14200,0,0,0,0,0,0,60000,150000,-90000,-90000
20200312,053692,聯詠元大96購04,,,,,0.00,0.00,0,0,0,0,0,0,0,0,0,0,0,0,0
20200312,053693,欣興元大96購05,0.25,0.26,0.25,0.25,-0.25,-50.0,190000,7,47800,0,0,0,0,0,0,80000,110000,-30000,-30000
20200312,053694,創意元大96購03,0.55,0.55,0.55,0.55,-0.47,-46.08,68000,1,37400,0,0,0,0,0,0,68000,0,68000,68000
20200312,053695,智易元大97購02,0.20,0.20,0.20,0.20,-0.08,-28.57,8000,1,1600,0,0,0,0,0,0,8000,0,8000,8000
20200312,053696,日月光元大96購05,,,,,0.00,0.00,0,0,0,0,0,0,0,0,0,0,0,0,0
20200312,053697,臻鼎元大96購02,0.30,0.30,0.15,0.17,-0.21,-55.26,473000,16,79530,0,0,0,0,0,0,148000,325000,-177000,-177000
20200312,053698,中磊元大96購02,0.69,0.69,0.66,0.66,-0.16,-19.51,17000,3,11700,0,0,0,0,0,0,17000,16000,1000,1000
20200312,053699,臺股指元大96購22,0.07,0.07,0.05,0.06,-0.05,-45.45,283000,6,17860,0,0,0,0,0,0,0,0,0,0
20200312,05369P,可成元富95售04,3.40,3.76,3.40,3.76,+0.87,30.1,59000,6,210670,0,0,0,0,0,0,10000,49000,-39000,-39000
20200312,053700,臺股指元大96購23,,,,,0.00,0.00,0,0,0,0,0,0,0,0,0,0,0,0,0
20200312,053701,台積電兆豐96購05,0.35,0.36,0.20,0.29,-0.20,-40.82,1570000,62,470170,0,0,0,0,0,0,540000,1030000,-490000,-490000
20200312,053702,智易兆豐97購02,,,,,0.00,0.00,0,0,0,0,0,0,0,0,0,0,0,0,0
20200312,053703,緯穎兆豐96購01,,,,,0.00,0.00,0,0,0,0,0,0,0,0,0,0,0,0,0
20200312,053704,國巨群益96購06,2.54,2.54,1.33,1.33,-1.39,-51.1,37000,8,89970,0,0,0,0,0,0,0,37000,-37000,-37000
20200312,053705,滬深2X凱基99購01,0.69,0.69,0.55,0.62,-0.14,-18.42,286000,24,169180,0,0,0,0,0,0,35000,251000,-216000,-216000
20200312,053706,S&P反1凱基99購01,1.06,1.36,1.05,1.26,+0.32,34.04,397000,12,490790,0,0,0,0,0,0,30000,377000,-347000,-347000
20200312,053707,A50正2凱基99購02,0.45,0.49,0.45,0.49,-0.12,-19.67,85000,6,40850,0,0,0,0,0,0,60000,25000,35000,35000
20200312,053708,道瓊反凱基98購01,2.25,2.51,2.25,2.34,+0.69,41.82,123000,6,287450,0,0,0,0,0,0,101000,122000,-21000,-21000
20200312,053709,台達電凱基96購04,,,,,0.00,0.00,0,0,0,0,0,0,0,0,0,0,0,0,0
20200312,05370P,矽創元富95售01,1.31,1.50,1.31,1.50,+0.21,16.28,75000,5,107800,0,0,0,0,0,0,35000,40000,-5000,-5000
20200312,053710,華通凱基96購05,,,,,0.00,0.00,0,0,0,0,0,0,0,0,0,0,0,0,0
20200312,053711,鴻海凱基96購14,,,,,0.00,0.00,0,0,0,0,0,0,0,0,0,0,0,0,0
20200312,053712,台光電凱基96購04,0.91,0.91,0.56,0.56,-0.55,-49.55,77000,3,63070,0,0,0,0,0,0,57000,20000,37000,37000
20200312,053713,漢唐凱基96購04,0.68,0.68,0.55,0.58,-0.36,-38.3,98000,5,57640,0,0,0,0,0,0,58000,40000,18000,18000
20200312,053714,南亞科凱基96購03,0.17,0.17,0.11,0.11,-0.37,-77.08,26000,3,4300,0,0,0,0,0,0,24000,2000,22000,22000
20200312,053715,美律凱基96購04,,,,,0.00,0.00,0,0,0,0,0,0,0,0,0,0,0,0,0
20200312,053716,京元電凱基97購01,,,,,0.00,0.00,0,0,0,0,0,0,0,0,0,0,0,0,0
20200312,053717,聯發科凱基96購17,,,,,0.00,0.00,0,0,0,0,0,0,0,0,0,0,0,0,0
20200312,053718,全新凱基97購02,0.24,0.24,0.16,0.16,-0.15,-48.39,860000,5,181100,0,0,0,0,0,0,690000,170000,520000,520000
20200312,053719,可成凱基96購08,0.57,0.57,0.57,0.57,-0.32,-35.96,20000,1,11400,0,0,0,0,0,0,20000,0,20000,20000
20200312,05371P,臺股指中信95售10,,,,,0.00,0.00,0,0,0,0,0,0,0,0,0,0,0,0,0
20200312,053720,宏達電凱基97購01,,,,,0.00,0.00,0,0,0,0,0,0,0,0,0,0,0,0,0
20200312,053721,國泰金凱基97購01,,,,,0.00,0.00,0,0,0,0,0,0,0,0,0,0,0,0,0
20200312,053722,新光金凱基9C購01,,,,,0.00,0.00,0,0,0,0,0,0,0,0,0,0,0,0,0
20200312,053723,奇鋐凱基98購01,,,,,0.00,0.00,0,0,0,0,0,0,0,0,0,0,0,0,0
20200312,053724,聯詠凱基96購04,0.36,0.36,0.26,0.33,-0.20,-37.74,364000,6,117320,0,0,0,0,0,0,244000,120000,124000,124000
20200312,053725,晶相光凱基96購01,1.09,1.09,0.70,0.70,-0.51,-42.15,25000,2,25300,0,0,0,0,0,0,25000,0,25000,25000
20200312,053726,TPK凱基96購02,,,,,0.00,0.00,0,0,0,0,0,0,0,0,0,0,0,0,0
20200312,053727,麗豐凱基97購01,,,,,0.00,0.00,0,0,0,0,0,0,0,0,0,0,0,0,0
20200312,053728,茂林凱基97購01,2.36,2.36,2.36,2.36,+0.22,10.28,10000,1,23600,0,0,0,0,0,0,10000,0,10000,10000
20200312,053729,聯茂凱基96購05,,,,,0.00,0.00,0,0,0,0,0,0,0,0,0,0,0,0,0
20200312,053730,樺漢凱基98購01,0.39,0.39,0.26,0.26,-0.25,-49.02,90000,6,26400,0,0,0,0,0,0,10000,80000,-70000,-70000
20200312,053731,矽創凱基96購03,,,,,0.00,0.00,0,0,0,0,0,0,0,0,0,0,0,0,0
20200312,053732,S&P反1中信9C購01,1.73,2.06,1.73,1.94,+0.43,28.48,156000,11,286360,0,0,0,0,0,0,100000,56000,44000,44000
20200312,053733,華邦電中信98購01,0.06,0.06,0.06,0.06,0.00,0.00,30000,3,1800,0,0,0,0,0,0,0,30000,-30000,-30000
20200312,053734,友達中信98購02,0.25,0.27,0.20,0.20,-0.18,-47.37,215000,13,48740,0,0,0,0,0,0,10000,190000,-180000,-180000
20200312,053735,矽力中信97購01,1.08,1.08,0.86,0.90,-0.41,-31.3,74000,20,70360,0,0,0,0,0,0,54000,20000,34000,34000
20200312,053736,友達麥證96購01,0.16,0.16,0.11,0.11,-0.12,-52.17,649000,7,77290,0,649000,-649000,0,0,0,0,649000,-649000,-649000
20200312,053737,華新科麥證96購01,1.02,1.02,0.79,0.79,-0.65,-45.14,76000,9,72950,70000,6000,64000,0,0,0,70000,6000,64000,64000
20200312,053738,群創麥證96購01,0.03,0.03,0.03,0.03,-0.08,-72.73,300000,1,9000,300000,0,300000,0,0,0,300000,0,300000,300000
20200312,053739,A50正2國票9A購01,0.72,0.72,0.66,0.66,-0.23,-25.84,45000,3,31350,0,0,0,0,0,0,0,45000,-45000,-45000
20200312,05373P,臺股指中信95售11,,,,,0.00,0.00,0,0,0,0,0,0,0,0,0,0,0,0,0
20200312,053740,元油反國票99購01,,,,,0.00,0.00,0,0,0,0,0,0,0,0,0,0,0,0,0
20200312,053741,漢唐國票97購03,,,,,0.00,0.00,0,0,0,0,0,0,0,0,0,0,0,0,0
20200312,053742,創意國票97購01,0.59,0.59,0.40,0.42,-0.58,-58.0,357000,8,158530,0,0,0,0,0,0,27000,330000,-303000,-303000
20200312,053743,康控國票97購02,,,,,0.00,0.00,0,0,0,0,0,0,0,0,0,0,0,0,0
20200312,053744,台郡國票97購03,0.53,0.53,0.41,0.45,-0.45,-50.0,42000,9,19260,0,0,0,0,0,0,12000,30000,-18000,-18000
20200312,053745,康友國票97購01,1.66,1.66,1.27,1.29,-0.57,-30.65,366000,16,580420,0,0,0,0,0,0,353000,78000,275000,275000
20200312,053746,彰銀康和96購01,0.83,0.86,0.83,0.85,-0.22,-20.56,104000,3,86420,0,0,0,0,0,0,100000,4000,96000,96000
20200312,053747,滬深2X永豐96購05,,,,,0.00,0.00,0,0,0,0,0,0,0,0,0,0,0,0,0
20200312,053748,燿華永豐96購04,0.22,0.22,0.22,0.22,-0.23,-51.11,12000,1,2640,0,0,0,0,0,0,12000,0,12000,12000
20200312,053749,揚明光永豐97購01,0.37,0.37,0.30,0.30,-0.21,-41.18,12000,2,4300,0,0,0,0,0,0,2000,10000,-8000,-8000
20200312,05374P,台積電國票96售07,2.16,2.29,2.16,2.29,+0.35,18.04,116000,3,252510,0,0,0,0,0,0,116000,0,116000,116000
20200312,053750,致伸永豐96購02,,,,,0.00,0.00,0,0,0,0,0,0,0,0,0,0,0,0,0
20200312,053751,康控永豐96購02,,,,,0.00,0.00,0,0,0,0,0,0,0,0,0,0,0,0,0
20200312,053752,超眾永豐96購02,,,,,0.00,0.00,0,0,0,0,0,0,0,0,0,0,0,0,0
20200312,053753,啟碁永豐96購01,0.29,0.29,0.29,0.29,-0.38,-56.72,5000,1,1450,0,0,0,0,0,0,0,5000,-5000,-5000
20200312,053754,英業達元富96購02,0.78,0.78,0.64,0.66,-0.25,-27.47,148000,7,108100,0,0,0,0,0,0,98000,50000,48000,48000
20200312,053755,亞光元富96購01,1.07,1.07,0.59,0.64,-0.85,-57.05,205000,9,182410,0,0,0,0,0,0,145000,67000,78000,78000
20200312,053756,亞光元富96購02,,,,,0.00,0.00,0,0,0,0,0,0,0,0,0,0,0,0,0
20200312,053757,聯發科國泰96購04,,,,,0.00,0.00,0,0,0,0,0,0,0,0,0,0,0,0,0
20200312,053758,華新科國泰97購02,4.04,4.04,2.68,2.74,-2.56,-48.3,34000,5,118720,0,0,0,0,0,0,10000,24000,-14000,-14000
20200312,053759,晶相光國泰98購01,1.29,1.29,0.98,1.01,-0.37,-26.81,326000,18,372940,0,0,0,0,0,0,231000,148000,83000,83000
20200312,05375P,健策國票96售02,0.71,0.88,0.71,0.88,+0.29,49.15,114000,21,87210,0,0,0,0,0,0,21000,89000,-68000,-68000
20200312,053760,牧德國泰98購01,1.64,1.64,1.30,1.35,-0.75,-35.71,374000,13,531120,0,0,0,0,0,0,255000,227000,28000,28000
20200312,053761,健策國泰98購01,0.46,0.46,0.30,0.30,-0.25,-45.45,1425000,40,538280,0,0,0,0,0,0,814000,802000,12000,12000
20200312,053762,T50反1富邦97購01,,,,,0.00,0.00,0,0,0,0,0,0,0,0,0,0,0,0,0
20200312,053763,T50反1富邦98購01,,,,,0.00,0.00,0,0,0,0,0,0,0,0,0,0,0,0,0
20200312,053764,A50正2富邦99購01,0.33,0.33,0.30,0.30,0.00,0.00,15000,3,4750,0,0,0,0,0,0,0,15000,-15000,-15000
20200312,053765,智邦富邦96購01,0.47,0.47,0.33,0.33,-0.15,-31.25,206000,23,87860,0,0,0,0,0,0,194000,125000,69000,69000
20200312,053766,友達富邦97購01,0.07,0.08,0.06,0.07,-0.03,-30.0,375000,13,25080,0,0,0,0,0,0,0,0,0,0
20200312,053767,臻鼎富邦97購02,0.06,0.07,0.03,0.07,0.00,0.00,601000,5,24070,0,0,0,0,0,0,400000,201000,199000,199000
20200312,053768,S&P反1元大99購01,,,,,0.00,0.00,0,0,0,0,0,0,0,0,0,0,0,0,0
20200312,053769,香港反元大99購01,1.19,1.19,1.19,1.19,+0.19,19.0,25000,4,29750,0,0,0,0,0,0,4000,10000,-6000,-6000
20200312,05376P,聯發科日盛95售04,1.08,1.66,1.08,1.66,+0.80,93.02,244000,11,312300,0,0,0,0,0,0,78000,166000,-88000,-88000
20200312,053770,元金2X元大98購01,2.34,2.34,2.15,2.17,-0.49,-18.42,1601000,16,3650630,0,0,0,0,0,0,1183000,418000,765000,765000
20200312,053771,華新元大97購01,0.32,0.32,0.27,0.27,-0.16,-37.21,20000,2,5900,0,0,0,0,0,0,10000,10000,0,0
20200312,053772,大成鋼元大96購02,0.31,0.31,0.31,0.31,-0.06,-16.22,10000,1,3100,0,0,0,0,0,0,0,10000,-10000,-10000
20200312,053773,上銀元大96購04,2.25,2.25,1.69,1.69,-1.36,-44.59,59000,6,120690,0,0,0,0,0,0,59000,0,59000,59000
20200312,053774,台達電元大96購04,,,,,0.00,0.00,0,0,0,0,0,0,0,0,0,0,0,0,0
20200312,053775,鴻海元大96購21,,,,,0.00,0.00,0,0,0,0,0,0,0,0,0,0,0,0,0
20200312,053776,台積電元大96購19,,,,,0.00,0.00,0,0,0,0,0,0,0,0,0,0,0,0,0
20200312,053777,台積電元大96購20,0.28,0.28,0.19,0.23,-0.12,-34.29,4140000,75,1012270,0,0,0,0,0,0,1619000,2391000,-772000,-772000
20200312,053778,旺宏元大97購03,0.54,0.59,0.35,0.35,-0.29,-45.31,226000,9,111060,0,0,0,0,0,0,148000,107000,41000,41000
20200312,053779,台光電元大96購02,0.52,0.52,0.43,0.46,-0.14,-23.33,722000,15,337540,0,0,0,0,0,0,675000,47000,628000,628000
20200312,05377P,鴻海凱基95售18,,,,,0.00,0.00,0,0,0,0,0,0,0,0,0,0,0,0,0
20200312,053780,南亞科元大96購03,0.77,0.77,0.52,0.52,-0.86,-62.32,119000,3,89880,0,0,0,0,0,0,51000,68000,-17000,-17000
20200312,053781,友達元大9B購03,0.41,0.41,0.40,0.40,-0.20,-33.33,20000,2,8100,0,0,0,0,0,0,10000,20000,-10000,-10000
20200312,053782,京元電元大98購02,0.76,0.76,0.61,0.61,-0.37,-37.76,169000,5,115080,0,0,0,0,0,0,101000,68000,33000,33000
20200312,053783,聯發科元大96購17,0.15,0.15,0.15,0.15,-0.33,-68.75,68000,1,10200,0,0,0,0,0,0,68000,0,68000,68000
20200312,053784,奇力新元大97購02,1.25,1.25,0.86,0.89,-0.41,-31.54,115000,12,120130,0,0,0,0,0,0,84000,33000,51000,51000
20200312,053785,聯詠元大96購05,0.28,0.28,0.23,0.23,-0.13,-36.11,48000,2,11540,0,0,0,0,0,0,48000,0,48000,48000
20200312,053786,新日興元大96購02,1.52,1.52,1.10,1.13,-0.51,-31.1,337000,8,415740,0,0,0,0,0,0,91000,246000,-155000,-155000
20200312,053787,健策元大97購02,0.93,0.93,0.66,0.66,-0.39,-37.14,299000,16,242520,0,0,0,0,0,0,165000,134000,31000,31000
20200312,053788,泰鼎元大97購01,2.04,2.04,2.04,2.04,-0.80,-28.17,50000,1,102000,0,0,0,0,0,0,0,50000,-50000,-50000
20200312,053789,彩晶元大9C購02,,,,,0.00,0.00,0,0,0,0,0,0,0,0,0,0,0,0,0
20200312,05378P,台積電凱基96售02,1.80,2.22,1.80,2.16,+0.54,33.33,326000,14,618130,0,0,0,0,0,0,79000,317000,-238000,-238000
20200312,053790,嘉聯益元大99購02,,,,,0.00,0.00,0,0,0,0,0,0,0,0,0,0,0,0,0
20200312,053791,同欣電元大96購05,0.69,0.69,0.58,0.58,-0.34,-36.96,148000,3,91040,0,0,0,0,0,0,80000,68000,12000,12000
20200312,053792,百和元大96購01,0.44,0.45,0.40,0.40,-0.32,-44.44,72000,6,30590,0,0,0,0,0,0,42000,62000,-20000,-20000
20200312,053793,致伸兆豐96購01,,,,,0.00,0.00,0,0,0,0,0,0,0,0,0,0,0,0,0
20200312,053794,燿華亞東96購01,,,,,0.00,0.00,0,0,0,0,0,0,0,0,0,0,0,0,0
20200312,053795,群創亞東96購01,,,,,0.00,0.00,0,0,0,0,0,0,0,0,0,0,0,0,0
20200312,053796,華通中信96購02,,,,,0.00,0.00,0,0,0,0,0,0,0,0,0,0,0,0,0
20200312,053797,台積電中信98購01,0.24,0.24,0.18,0.22,-0.06,-21.43,325000,10,69100,0,0,0,0,0,0,15000,310000,-295000,-295000
20200312,053798,台積電中信98購02,0.18,0.18,0.14,0.18,-0.05,-21.74,762000,15,124920,0,0,0,0,0,0,84000,678000,-594000,-594000
20200312,053799,矽創中信9A購01,0.31,0.31,0.21,0.21,-0.14,-40.0,82000,9,17930,0,0,0,0,0,0,2000,80000,-78000,-78000
20200312,05379P,可成凱基95售11,1.50,1.97,1.50,1.97,+0.87,79.09,258000,7,475950,0,0,0,0,0,0,78000,180000,-102000,-102000
20200312,053800,華通凱基97購03,,,,,0.00,0.00,0,0,0,0,0,0,0,0,0,0,0,0,0
20200312,053801,台積電凱基96購18,,,,,0.00,0.00,0,0,0,0,0,0,0,0,0,0,0,0,0
20200312,053802,南亞科凱基96購04,0.19,0.19,0.19,0.19,-0.41,-68.33,40000,1,7600,0,0,0,0,0,0,0,40000,-40000,-40000
20200312,053803,聯發科凱基96購18,,,,,0.00,0.00,0,0,0,0,0,0,0,0,0,0,0,0,0
20200312,053804,富邦金凱基96購01,0.10,0.10,0.10,0.10,-0.12,-54.55,90000,3,9000,0,0,0,0,0,0,90000,0,90000,90000
20200312,053805,奇鋐凱基98購02,0.20,0.20,0.17,0.17,-0.13,-43.33,351000,3,60200,0,0,0,0,0,0,1000,350000,-349000,-349000
20200312,053806,鎧勝凱基96購02,0.21,0.21,0.21,0.21,0.00,0.00,20000,1,4200,0,0,0,0,0,0,0,20000,-20000,-20000
20200312,053807,T50反1群益96購02,1.59,1.59,1.56,1.56,+0.27,20.93,166000,2,263340,0,0,0,0,0,0,166000,0,166000,166000
20200312,053808,大成鋼群益97購01,0.74,0.77,0.71,0.73,-0.11,-13.1,183000,8,135720,0,0,0,0,0,0,170000,13000,157000,157000
20200312,053809,上銀群益96購02,1.05,1.05,0.68,0.69,-0.81,-54.0,95000,9,86510,0,0,0,0,0,0,65000,32000,33000,33000
20200312,05380P,鴻海群益95售11,,,,,0.00,0.00,0,0,0,0,0,0,0,0,0,0,0,0,0
20200312,053810,台達電群益96購01,0.33,0.33,0.33,0.33,-0.14,-29.79,45000,5,14850,0,0,0,0,0,0,45000,45000,0,0
20200312,053811,國巨群益98購02,,,,,0.00,0.00,0,0,0,0,0,0,0,0,0,0,0,0,0
20200312,053812,台積電群益96購09,,,,,0.00,0.00,0,0,0,0,0,0,0,0,0,0,0,0,0
20200312,053813,友達群益9A購03,,,,,0.00,0.00,0,0,0,0,0,0,0,0,0,0,0,0,0
20200312,053814,美律群益97購02,0.14,0.14,0.14,0.14,-0.13,-48.15,5000,1,700,0,0,0,0,0,0,0,5000,-5000,-5000
20200312,053815,聯發科群益96購01,0.16,0.16,0.10,0.10,0.00,0.00,750000,12,99000,0,0,0,0,0,0,0,750000,-750000,-750000
20200312,053816,聯發科群益96購02,,,,,0.00,0.00,0,0,0,0,0,0,0,0,0,0,0,0,0
20200312,053817,華新科群益97購02,4.55,4.55,3.22,3.28,-2.02,-38.11,108000,9,391970,0,0,0,0,0,0,17000,104000,-87000,-87000
20200312,053818,富邦金群益98購01,0.80,0.80,0.64,0.66,-0.28,-29.79,121000,10,84360,0,0,0,0,0,0,41000,80000,-39000,-39000
20200312,053819,大立光群益96購04,,,,,0.00,0.00,0,0,0,0,0,0,0,0,0,0,0,0,0
20200312,05381P,聯詠群益95售02,2.26,2.63,2.26,2.63,+0.52,24.64,60000,4,143900,0,0,0,0,0,0,30000,30000,0,0
20200312,053820,大立光群益96購05,0.04,0.05,0.04,0.05,0.00,0.00,190000,2,7800,0,0,0,0,0,0,0,0,0,0
20200312,053821,群創群益98購08,0.09,0.09,0.09,0.09,0.00,0.00,50000,1,4500,0,0,0,0,0,0,50000,0,50000,50000
20200312,053822,正文群益97購01,0.19,0.22,0.19,0.21,0.00,0.00,8000,3,1660,0,0,0,0,0,0,0,8000,-8000,-8000
20200312,053823,茂林群益96購06,0.79,0.79,0.54,0.54,-0.30,-35.71,277000,7,180640,0,0,0,0,0,0,209000,118000,91000,91000
20200312,053824,樺漢群益96購02,0.34,0.34,0.25,0.25,-0.25,-50.0,31000,2,8740,0,0,0,0,0,0,11000,20000,-9000,-9000
20200312,053825,南電群益96購02,1.41,1.41,1.05,1.05,-0.52,-33.12,110000,7,123060,0,0,0,0,0,0,15000,110000,-95000,-95000
20200312,053826,光磊麥證97購01,,,,,0.00,0.00,0,0,0,0,0,0,0,0,0,0,0,0,0
20200312,053827,漢唐麥證9A購01,0.68,0.68,0.62,0.62,-0.13,-17.33,30000,4,19000,0,30000,-30000,0,0,0,0,30000,-30000,-30000
20200312,053828,貿聯麥證96購01,,,,,0.00,0.00,0,0,0,0,0,0,0,0,0,0,0,0,0
20200312,053829,力成麥證96購01,0.28,0.28,0.26,0.26,-0.15,-36.59,20000,2,5400,20000,0,20000,0,0,0,20000,0,20000,20000
20200312,05382P,電子類群益95售02,3.79,5.55,3.79,5.10,+1.75,52.24,32000,6,137480,0,0,0,0,0,0,22000,10000,12000,12000
20200312,053830,台積電台新96購02,0.13,0.13,0.13,0.13,-0.04,-23.53,10000,1,1300,0,0,0,0,0,0,10000,0,10000,10000
20200312,053831,台積電台新97購02,0.14,0.14,0.14,0.14,-0.12,-46.15,2000,1,280,0,0,0,0,0,0,2000,0,2000,2000
20200312,053832,聯發科台新96購01,,,,,0.00,0.00,0,0,0,0,0,0,0,0,0,0,0,0,0
20200312,053833,彩晶台新97購02,0.13,0.13,0.09,0.09,-0.11,-55.0,100000,8,11900,0,0,0,0,0,0,0,80000,-80000,-80000
20200312,053834,卜蜂永豐96購01,0.40,0.40,0.37,0.37,-0.21,-36.21,104000,4,39560,0,0,0,0,0,0,36000,68000,-32000,-32000
20200312,053835,南亞科永豐96購02,,,,,0.00,0.00,0,0,0,0,0,0,0,0,0,0,0,0,0
20200312,053836,亞光永豐96購02,,,,,0.00,0.00,0,0,0,0,0,0,0,0,0,0,0,0,0
20200312,053837,貿聯永豐96購02,0.48,0.48,0.41,0.41,-0.18,-30.51,71000,12,32640,0,0,0,0,0,0,71000,0,71000,71000
20200312,053838,正文永豐96購02,0.20,0.20,0.16,0.16,-0.05,-23.81,7000,2,1200,0,0,0,0,0,0,0,7000,-7000,-7000
20200312,053839,華通統一96購01,0.25,0.25,0.21,0.22,-0.15,-40.54,62000,11,14360,0,0,0,0,0,0,62000,0,62000,62000
20200312,05383P,鴻海富邦95售06,2.30,2.30,2.30,2.30,0.00,0.00,50000,3,115000,0,0,0,0,0,0,20000,0,20000,20000
20200312,053840,燿華統一96購02,,,,,0.00,0.00,0,0,0,0,0,0,0,0,0,0,0,0,0
20200312,053841,美律統一96購01,0.17,0.19,0.17,0.19,-0.20,-51.28,27000,2,5030,0,0,0,0,0,0,22000,5000,17000,17000
20200312,053842,聯發科統一96購08,,,,,0.00,0.00,0,0,0,0,0,0,0,0,0,0,0,0,0
20200312,053843,訊芯統一96購01,,,,,0.00,0.00,0,0,0,0,0,0,0,0,0,0,0,0,0
20200312,053844,GIS統一96購01,,,,,0.00,0.00,0,0,0,0,0,0,0,0,0,0,0,0,0
20200312,053845,和大元富96購01,0.18,0.18,0.18,0.18,-0.13,-41.94,98000,2,17640,0,0,0,0,0,0,98000,0,98000,98000
20200312,053846,友達元富99購02,0.39,0.39,0.39,0.39,-0.16,-29.09,50000,1,19500,0,0,0,0,0,0,0,50000,-50000,-50000
20200312,053847,美律元富96購02,0.33,0.33,0.31,0.31,-0.24,-43.64,80000,8,26200,0,0,0,0,0,0,0,80000,-80000,-80000
20200312,053848,聯發科元富96購03,,,,,0.00,0.00,0,0,0,0,0,0,0,0,0,0,0,0,0
20200312,053849,聯發科元富96購04,,,,,0.00,0.00,0,0,0,0,0,0,0,0,0,0,0,0,0
20200312,05384P,大立光永豐95售02,1.53,1.53,1.53,1.53,0.00,0.00,13000,1,19890,0,0,0,0,0,0,0,13000,-13000,-13000
20200312,053850,嘉澤元富96購03,0.62,0.62,0.42,0.42,-0.40,-48.78,180000,8,86600,0,0,0,0,0,0,110000,70000,40000,40000
20200312,053851,鴻海國泰98購03,0.20,0.20,0.07,0.11,0.00,0.00,217000,8,17580,0,0,0,0,0,0,177000,20000,157000,157000
20200312,053852,南亞科國泰98購01,0.40,0.40,0.23,0.25,-0.24,-48.98,221000,5,61050,0,0,0,0,0,0,36000,185000,-149000,-149000
20200312,053853,康控國泰97購02,0.21,0.21,0.21,0.21,-0.09,-30.0,98000,1,20580,0,0,0,0,0,0,98000,0,98000,98000
20200312,053854,聯茂國泰97購02,3.24,3.24,2.58,2.58,-0.82,-24.12,20000,2,58200,0,0,0,0,0,0,10000,10000,0,0
20200312,053855,康友國泰98購01,1.25,1.25,0.97,0.99,-0.31,-23.85,663000,31,741120,0,0,0,0,0,0,601000,166000,435000,435000
20200312,053856,台積電富邦98購01,0.07,0.07,0.06,0.07,-0.01,-12.5,6191000,88,390880,0,0,0,0,0,0,0,0,0,0
20200312,053857,宏達電富邦97購02,0.13,0.13,0.09,0.09,-0.06,-40.0,210000,5,21500,0,0,0,0,0,0,0,210000,-210000,-210000
20200312,053858,台達電元大96購05,0.43,0.43,0.26,0.26,-0.23,-46.94,439000,7,129940,0,0,0,0,0,0,120000,319000,-199000,-199000
20200312,053859,台積電元大97購09,0.59,0.59,0.49,0.49,-0.24,-32.88,255000,5,133790,0,0,0,0,0,0,175000,129000,46000,46000
20200312,053860,台積電元大98購03,0.48,0.48,0.39,0.40,-0.18,-31.03,652000,47,264820,0,0,0,0,0,0,170000,124000,46000,46000
20200312,053861,台光電元大98購01,1.13,1.13,0.89,0.89,-0.39,-30.47,148000,5,152710,0,0,0,0,0,0,0,148000,-148000,-148000
20200312,053862,南亞科元大97購02,,,,,0.00,0.00,0,0,0,0,0,0,0,0,0,0,0,0,0
20200312,053863,聯發科元大96購18,0.03,0.03,0.02,0.02,0.00,0.00,359000,36,8180,0,0,0,0,0,0,0,359000,-359000,-359000
20200312,053864,義隆元大96購01,0.76,0.77,0.64,0.64,-0.23,-26.44,434000,11,311020,0,0,0,0,0,0,302000,102000,200000,200000
20200312,053865,欣興元大97購02,0.70,0.70,0.45,0.45,-0.45,-50.0,188000,10,95600,0,0,0,0,0,0,78000,110000,-32000,-32000
20200312,053866,景碩元大97購02,0.72,0.72,0.52,0.52,-0.62,-54.39,190000,4,107950,0,0,0,0,0,0,180000,10000,170000,170000
20200312,053867,創意元大96購04,,,,,0.00,0.00,0,0,0,0,0,0,0,0,0,0,0,0,0
20200312,053868,群創元大99購02,,,,,0.00,0.00,0,0,0,0,0,0,0,0,0,0,0,0,0
20200312,053869,嘉澤元大96購02,0.52,0.52,0.42,0.42,0.00,0.00,40000,2,18800,0,0,0,0,0,0,40000,0,40000,40000
20200312,05386P,臺股指永豐95售05,,,,,0.00,0.00,0,0,0,0,0,0,0,0,0,0,0,0,0
20200312,053870,正文元大96購01,0.74,0.74,0.52,0.52,-0.21,-28.77,256000,9,178460,0,0,0,0,0,0,178000,78000,100000,100000
20200312,053871,臻鼎元大96購03,0.33,0.33,0.24,0.24,-0.17,-41.46,68000,4,18620,0,0,0,0,0,0,68000,0,68000,68000
20200312,053872,臻鼎元大96購04,0.24,0.24,0.10,0.10,-0.21,-67.74,80000,6,14260,0,0,0,0,0,0,74000,6000,68000,68000
20200312,053873,力成元大96購03,0.51,0.51,0.51,0.51,-0.37,-42.05,1000,1,510,0,0,0,0,0,0,1000,0,1000,1000
20200312,053874,台表科元大96購05,0.21,0.21,0.20,0.20,-0.20,-50.0,98000,2,20090,0,0,0,0,0,0,0,98000,-98000,-98000
20200312,053875,GIS元大97購01,,,,,0.00,0.00,0,0,0,0,0,0,0,0,0,0,0,0,0
20200312,053876,可成永昌98購01,0.90,0.94,0.65,0.65,-0.50,-43.48,950000,10,826500,0,0,0,0,0,0,700000,250000,450000,450000
20200312,053877,奇力新亞東96購01,0.82,0.82,0.82,0.82,-0.20,-19.61,10000,1,8200,0,0,0,0,0,0,10000,0,10000,10000
20200312,053878,台表科亞東96購01,,,,,0.00,0.00,0,0,0,0,0,0,0,0,0,0,0,0,0
20200312,053879,元油反中信98購02,,,,,0.00,0.00,0,0,0,0,0,0,0,0,0,0,0,0,0
20200312,05387P,鴻海元大95售21,4.31,4.74,4.31,4.74,0.00,0.00,76000,10,354780,0,0,0,0,0,0,0,76000,-76000,-76000
20200312,053880,智邦中信96購01,0.71,0.71,0.45,0.52,-0.25,-32.47,56000,14,32540,0,0,0,0,0,0,16000,40000,-24000,-24000
20200312,053881,南亞科中信97購01,,,,,0.00,0.00,0,0,0,0,0,0,0,0,0,0,0,0,0
20200312,053882,聯發科中信98購02,0.03,0.05,0.02,0.05,0.00,0.00,291000,31,7050,0,0,0,0,0,0,0,290000,-290000,-290000
20200312,053883,大立光中信98購02,0.10,0.10,0.07,0.07,-0.09,-56.25,300000,2,24000,0,0,0,0,0,0,200000,100000,100000,100000
20200312,053884,緯穎第一96購01,0.64,0.64,0.64,0.64,-0.42,-39.62,31000,2,19840,0,0,0,0,0,0,31000,0,31000,31000
20200312,053885,全新兆豐96購01,0.09,0.09,0.09,0.09,-0.06,-40.0,50000,3,4500,0,0,0,0,0,0,0,50000,-50000,-50000
20200312,053886,亞光兆豐96購01,0.71,0.71,0.45,0.45,-0.53,-54.08,30000,2,20000,0,0,0,0,0,0,25000,5000,20000,20000
20200312,053887,聯茂兆豐97購02,1.16,1.16,0.85,0.85,-0.57,-40.14,227000,8,235730,0,0,0,0,0,0,113000,114000,-1000,-1000
20200312,053888,和大群益97購01,0.47,0.47,0.35,0.38,-0.15,-28.3,262000,12,98730,0,0,0,0,0,0,182000,80000,102000,102000
20200312,053889,致茂群益97購01,1.13,1.16,0.86,0.86,-0.70,-44.87,114000,16,123160,0,0,0,0,0,0,79000,44000,35000,35000
20200312,05388P,南亞科元大95售04,2.06,2.53,2.06,2.45,+0.80,48.48,252000,11,612290,0,0,0,0,0,0,142000,110000,32000,32000
20200312,053890,華新科群益98購01,0.60,0.60,0.40,0.40,-0.29,-42.03,35000,5,18300,0,0,0,0,0,0,0,35000,-35000,-35000
20200312,053891,欣興群益98購01,0.30,0.30,0.20,0.20,-0.25,-55.56,17000,3,3600,0,0,0,0,0,0,0,17000,-17000,-17000
20200312,053892,景碩群益96購02,0.26,0.26,0.26,0.26,-0.10,-27.78,20000,1,5200,0,0,0,0,0,0,20000,0,20000,20000
20200312,053893,京鼎群益97購02,0.35,0.35,0.32,0.32,-0.20,-38.46,21000,3,7050,0,0,0,0,0,0,11000,10000,1000,1000
20200312,053894,創意群益96購01,0.91,0.91,0.66,0.66,-0.52,-44.07,256000,9,198060,0,0,0,0,0,0,118000,138000,-20000,-20000
20200312,053895,智易群益96購02,,,,,0.00,0.00,0,0,0,0,0,0,0,0,0,0,0,0,0
20200312,053896,麗豐群益97購01,0.42,0.42,0.40,0.40,-0.11,-21.57,11000,3,4520,0,0,0,0,0,0,6000,5000,1000,1000
20200312,053897,台郡群益96購01,0.20,0.20,0.16,0.18,-0.14,-43.75,17000,10,3140,0,0,0,0,0,0,17000,0,17000,17000
20200312,053898,康友群益97購01,1.36,1.41,1.06,1.08,-0.51,-32.08,236000,20,292470,0,0,0,0,0,0,149000,170000,-21000,-21000
20200312,053899,矽創群益96購02,,,,,0.00,0.00,0,0,0,0,0,0,0,0,0,0,0,0,0
20200312,053900,T50反1日盛99購01,1.15,1.17,1.07,1.11,+0.28,33.73,206000,7,233170,0,0,0,0,0,0,201000,85000,116000,116000
20200312,053901,T50反1凱基99購03,,,,,0.00,0.00,0,0,0,0,0,0,0,0,0,0,0,0,0
20200312,053902,S&P反1凱基97購01,1.27,1.58,1.27,1.53,+0.42,37.84,91000,11,127960,0,0,0,0,0,0,20000,61000,-41000,-41000
20200312,053903,燿華凱基97購01,,,,,0.00,0.00,0,0,0,0,0,0,0,0,0,0,0,0,0
20200312,053904,漢唐凱基97購01,0.64,0.65,0.59,0.59,-0.19,-24.36,70000,3,42400,0,0,0,0,0,0,70000,0,70000,70000
20200312,053905,華新科凱基96購10,0.96,0.96,0.55,0.59,-0.71,-54.62,46000,6,29340,0,0,0,0,0,0,6000,44000,-38000,-38000
20200312,053906,宏達電凱基96購02,,,,,0.00,0.00,0,0,0,0,0,0,0,0,0,0,0,0,0
20200312,053907,揚明光凱基96購01,,,,,0.00,0.00,0,0,0,0,0,0,0,0,0,0,0,0,0
20200312,053908,貿聯凱基98購01,,,,,0.00,0.00,0,0,0,0,0,0,0,0,0,0,0,0,0
20200312,053909,致伸凱基97購01,,,,,0.00,0.00,0,0,0,0,0,0,0,0,0,0,0,0,0
20200312,05390P,康友群益95售04,0.65,0.74,0.64,0.74,+0.18,32.14,223000,9,150450,0,0,0,0,0,0,82000,141000,-59000,-59000
20200312,053910,嘉聯益凱基98購01,,,,,0.00,0.00,0,0,0,0,0,0,0,0,0,0,0,0,0
20200312,053911,臺股指凱基96購31,0.05,0.05,0.05,0.05,0.00,0.00,10000,1,500,0,0,0,0,0,0,0,10000,-10000,-10000
20200312,053912,T50反1國票97購02,1.76,2.11,1.76,2.11,+0.48,29.45,4000,4,7710,0,0,0,0,0,0,3000,1000,2000,2000
20200312,053913,華新國票97購01,0.41,0.41,0.41,0.41,-0.14,-25.45,30000,1,12300,0,0,0,0,0,0,30000,0,30000,30000
20200312,053914,國巨國票96購08,1.07,1.07,1.07,1.07,0.00,0.00,15000,1,16050,0,0,0,0,0,0,15000,0,15000,15000
20200312,053915,光罩國票96購02,,,,,0.00,0.00,0,0,0,0,0,0,0,0,0,0,0,0,0
20200312,053916,漢唐國票97購04,2.10,2.10,1.58,1.63,-1.02,-38.49,145000,7,243180,0,0,0,0,0,0,102000,113000,-11000,-11000
20200312,053917,友達國票97購03,0.14,0.14,0.10,0.10,-0.10,-50.0,435000,14,53820,0,0,0,0,0,0,0,435000,-435000,-435000
20200312,053918,美律國票97購01,0.16,0.16,0.16,0.16,0.00,0.00,8000,1,1280,0,0,0,0,0,0,8000,0,8000,8000
20200312,053919,可成國票97購02,0.77,0.77,0.46,0.48,-0.54,-52.94,114000,16,72640,0,0,0,0,0,0,78000,88000,-10000,-10000
20200312,05391P,鴻海統一95售12,,,,,0.00,0.00,0,0,0,0,0,0,0,0,0,0,0,0,0
20200312,053920,新光金國票98購01,,,,,0.00,0.00,0,0,0,0,0,0,0,0,0,0,0,0,0
20200312,053921,嘉晶國票97購03,1.92,2.11,1.50,1.61,-0.33,-17.01,350000,27,638610,0,0,0,0,0,0,214000,138000,76000,76000
20200312,053922,亞光國票96購01,0.62,0.62,0.62,0.62,-0.24,-27.91,10000,1,6200,0,0,0,0,0,0,10000,0,10000,10000
20200312,053923,亞光國票97購01,0.60,0.60,0.35,0.35,-0.51,-59.3,20000,3,8950,0,0,0,0,0,0,10000,10000,0,0
20200312,053924,京鼎國票97購01,,,,,0.00,0.00,0,0,0,0,0,0,0,0,0,0,0,0,0
20200312,053925,群創國票98購01,0.08,0.09,0.05,0.06,-0.06,-50.0,2638000,22,169740,0,0,0,0,0,0,517000,2121000,-1604000,-1604000
20200312,053926,晶相光國票97購01,0.83,0.85,0.78,0.83,-0.61,-42.36,220000,9,181100,0,0,0,0,0,0,0,220000,-220000,-220000
20200312,053927,牧德國票97購01,1.96,1.96,1.28,1.28,-1.68,-56.76,71000,3,103730,0,0,0,0,0,0,8000,63000,-55000,-55000
20200312,053928,智易國票97購03,0.89,0.89,0.89,0.89,-0.27,-23.28,10000,1,8900,0,0,0,0,0,0,10000,0,10000,10000
20200312,053929,正文國票97購01,,,,,0.00,0.00,0,0,0,0,0,0,0,0,0,0,0,0,0
20200312,05392P,鴻海統一95售13,,,,,0.00,0.00,0,0,0,0,0,0,0,0,0,0,0,0,0
20200312,053930,S&P反1統一98購01,,,,,0.00,0.00,0,0,0,0,0,0,0,0,0,0,0,0,0
20200312,053931,楠梓電統一96購01,0.33,0.33,0.31,0.31,-0.14,-31.11,50000,3,16100,0,0,0,0,0,0,50000,0,50000,50000
20200312,053932,華新科統一96購03,,,,,0.00,0.00,0,0,0,0,0,0,0,0,0,0,0,0,0
20200312,053933,大立光統一96購06,0.08,0.08,0.06,0.06,0.00,0.00,40000,2,2500,0,0,0,0,0,0,0,40000,-40000,-40000
20200312,053934,A50正2元富96購02,0.20,0.20,0.19,0.19,-0.09,-32.14,95000,3,18500,0,0,0,0,0,0,0,95000,-95000,-95000
20200312,053935,華通元富96購02,,,,,0.00,0.00,0,0,0,0,0,0,0,0,0,0,0,0,0
20200312,053936,旺宏元富96購04,,,,,0.00,0.00,0,0,0,0,0,0,0,0,0,0,0,0,0
20200312,053937,光磊元富96購01,,,,,0.00,0.00,0,0,0,0,0,0,0,0,0,0,0,0,0
20200312,053938,彩晶元富96購01,0.12,0.12,0.12,0.12,0.00,0.00,20000,1,2400,0,0,0,0,0,0,20000,0,20000,20000
20200312,053939,台表科元富96購03,,,,,0.00,0.00,0,0,0,0,0,0,0,0,0,0,0,0,0
20200312,05393P,鴻海統一95售14,,,,,0.00,0.00,0,0,0,0,0,0,0,0,0,0,0,0,0
20200312,053940,康友元富96購01,1.08,1.08,0.88,0.88,-0.34,-27.87,168000,5,171340,0,0,0,0,0,0,148000,33000,115000,115000
20200312,053941,國巨國泰96購05,,,,,0.00,0.00,0,0,0,0,0,0,0,0,0,0,0,0,0
20200312,053942,超眾國泰96購02,0.39,0.39,0.30,0.30,-0.18,-37.5,102000,2,39600,0,0,0,0,0,0,100000,2000,98000,98000
20200312,053943,元油反富邦97購03,,,,,0.00,0.00,0,0,0,0,0,0,0,0,0,0,0,0,0
20200312,053944,亞泥富邦97購01,0.19,0.19,0.19,0.19,-0.07,-26.92,30000,3,5700,0,0,0,0,0,0,0,30000,-30000,-30000
20200312,053945,國巨富邦98購02,0.55,0.56,0.33,0.33,-0.29,-46.77,1736000,93,722930,0,0,0,0,0,0,366000,1365000,-999000,-999000
20200312,053946,全新富邦97購02,,,,,0.00,0.00,0,0,0,0,0,0,0,0,0,0,0,0,0
20200312,053947,義隆富邦97購01,0.40,0.42,0.40,0.42,-0.13,-23.64,40000,4,16200,0,0,0,0,0,0,30000,10000,20000,20000
20200312,053948,大立光富邦99購04,0.13,0.13,0.09,0.10,-0.10,-50.0,302000,16,32090,0,0,0,0,0,0,0,182000,-182000,-182000
20200312,053949,康控富邦9A購01,0.14,0.16,0.13,0.13,-0.05,-27.78,193000,10,26660,0,0,0,0,0,0,40000,151000,-111000,-111000
20200312,05394P,聯詠中信95售02,0.53,0.68,0.52,0.68,+0.21,44.68,370000,7,225770,0,0,0,0,0,0,108000,262000,-154000,-154000
20200312,053950,緯穎富邦97購02,,,,,0.00,0.00,0,0,0,0,0,0,0,0,0,0,0,0,0
20200312,053951,T50反1台新06購02,1.17,1.46,1.15,1.41,+0.35,33.02,294000,27,404590,0,0,0,0,0,0,141000,195000,-54000,-54000
20200312,053952,南亞科台新96購01,,,,,0.00,0.00,0,0,0,0,0,0,0,0,0,0,0,0,0
20200312,053953,群創台新97購01,,,,,0.00,0.00,0,0,0,0,0,0,0,0,0,0,0,0,0
20200312,053954,貿聯康和96購01,,,,,0.00,0.00,0,0,0,0,0,0,0,0,0,0,0,0,0
20200312,053955,華通永豐96購04,,,,,0.00,0.00,0,0,0,0,0,0,0,0,0,0,0,0,0
20200312,053956,旺宏永豐96購04,,,,,0.00,0.00,0,0,0,0,0,0,0,0,0,0,0,0,0
20200312,053957,瑞昱永豐96購01,,,,,0.00,0.00,0,0,0,0,0,0,0,0,0,0,0,0,0
20200312,053958,京元電永豐96購01,,,,,0.00,0.00,0,0,0,0,0,0,0,0,0,0,0,0,0
20200312,053959,晶豪科永豐96購02,0.32,0.32,0.18,0.18,-0.19,-51.35,563000,56,145780,0,0,0,0,0,0,372000,170000,202000,202000
20200312,05395P,旺宏元大96售06,1.72,2.10,1.65,1.96,+0.52,36.11,426000,6,837000,0,0,0,0,0,0,216000,410000,-194000,-194000
20200312,053960,晶技永豐96購02,1.07,1.07,0.54,0.59,-0.56,-48.7,735000,43,575560,0,0,0,0,0,0,236000,286000,-50000,-50000
20200312,053961,揚明光永豐96購04,0.40,0.40,0.26,0.26,-0.32,-55.17,65000,2,19000,0,0,0,0,0,0,50000,15000,35000,35000
20200312,053962,聯茂永豐96購01,0.72,0.73,0.61,0.64,-0.35,-35.35,77000,4,54470,0,0,0,0,0,0,9000,68000,-59000,-59000
20200312,053963,百和永豐96購01,,,,,0.00,0.00,0,0,0,0,0,0,0,0,0,0,0,0,0
20200312,053964,上銀元大96購05,1.47,1.47,0.93,0.93,-1.19,-56.13,99000,9,118230,0,0,0,0,0,0,76000,49000,27000,27000
20200312,053965,聯電元大98購04,0.26,0.26,0.19,0.22,-0.09,-29.03,311000,4,69640,0,0,0,0,0,0,211000,100000,111000,111000
20200312,053966,旺宏元大96購08,0.89,0.89,0.53,0.53,-0.46,-46.46,425000,31,322260,0,0,0,0,0,0,349000,289000,60000,60000
20200312,053967,華邦電元大96購03,0.09,0.09,0.09,0.09,-0.13,-59.09,400000,4,36000,0,0,0,0,0,0,0,400000,-400000,-400000
20200312,053968,華邦電元大97購01,0.10,0.10,0.10,0.10,0.00,0.00,3000,1,300,0,0,0,0,0,0,0,3000,-3000,-3000
20200312,053969,瑞昱元大97購01,0.50,0.50,0.33,0.33,-0.27,-45.0,319000,11,116210,0,0,0,0,0,0,15000,304000,-289000,-289000
20200312,05396P,台郡元大95售05,1.56,1.76,1.56,1.76,0.00,0.00,413000,12,662150,0,0,0,0,0,0,0,413000,-413000,-413000
20200312,053970,聯發科元大97購08,0.07,0.07,0.07,0.07,0.00,0.00,100000,1,7000,0,0,0,0,0,0,0,100000,-100000,-100000
20200312,053971,聯發科元大97購09,0.09,0.09,0.06,0.06,0.00,0.00,1990000,14,158540,0,0,0,0,0,0,0,1990000,-1990000,-1990000
20200312,053972,華新科元大96購06,2.51,2.51,2.51,2.51,-1.04,-29.3,10000,1,25100,0,0,0,0,0,0,0,10000,-10000,-10000
20200312,053973,晶豪科元大96購01,1.24,1.24,0.77,0.77,-0.49,-38.89,195000,11,217710,0,0,0,0,0,0,126000,69000,57000,57000
20200312,053974,大立光元大96購10,0.10,0.10,0.09,0.09,-0.19,-67.86,140000,3,13600,0,0,0,0,0,0,0,140000,-140000,-140000
20200312,053975,大立光元大98購04,0.43,0.43,0.37,0.37,-0.64,-63.37,31000,4,11830,0,0,0,0,0,0,10000,21000,-11000,-11000
20200312,053976,亞光元大96購02,0.25,0.25,0.19,0.19,-0.30,-61.22,184000,4,37800,0,0,0,0,0,0,180000,4000,176000,176000
20200312,053977,新日興元大96購03,1.71,1.71,1.53,1.53,-0.91,-37.3,453000,10,742890,0,0,0,0,0,0,3000,450000,-447000,-447000
20200312,053978,創意元大96購05,0.42,0.42,0.39,0.39,-0.30,-43.48,221000,4,86820,0,0,0,0,0,0,121000,100000,21000,21000
20200312,053979,健策元大98購01,1.82,1.82,1.00,1.39,-0.64,-31.53,65000,12,102550,0,0,0,0,0,0,24000,37000,-13000,-13000
20200312,05397P,大立光凱基96售08,0.17,0.37,0.17,0.29,+0.14,93.33,1876000,44,537790,0,0,0,0,0,0,1229000,232000,997000,997000
20200312,053980,泰鼎元大97購02,2.15,2.15,1.70,1.90,-0.86,-31.16,157000,12,288870,0,0,0,0,0,0,157000,42000,115000,115000
20200312,053981,康控元大96購05,,,,,0.00,0.00,0,0,0,0,0,0,0,0,0,0,0,0,0
20200312,053982,臻鼎元大96購05,0.16,0.16,0.10,0.10,-0.29,-74.36,5000,3,620,0,0,0,0,0,0,0,5000,-5000,-5000
20200312,053983,樺漢元大97購02,0.58,0.58,0.37,0.38,-0.26,-40.62,722000,14,305500,0,0,0,0,0,0,514000,242000,272000,272000
20200312,053984,康友元大96購05,1.89,1.89,1.44,1.46,-0.55,-27.36,18000,9,31370,0,0,0,0,0,0,18000,13000,5000,5000
20200312,053985,矽創元大96購02,0.62,0.62,0.37,0.37,-0.27,-42.19,304000,9,144610,0,0,0,0,0,0,41000,289000,-248000,-248000
20200312,053986,矽創第一96購01,0.14,0.14,0.14,0.14,-0.08,-36.36,40000,4,5600,0,0,0,0,0,0,0,40000,-40000,-40000
20200312,053987,宏碁亞東96購01,,,,,0.00,0.00,0,0,0,0,0,0,0,0,0,0,0,0,0
20200312,053988,友達亞東96購01,,,,,0.00,0.00,0,0,0,0,0,0,0,0,0,0,0,0,0
20200312,053989,奇力新兆豐97購01,0.35,0.40,0.35,0.40,-0.27,-40.3,50000,2,18500,0,0,0,0,0,0,30000,20000,10000,10000
20200312,05398P,康控國票96售03,,,,,0.00,0.00,0,0,0,0,0,0,0,0,0,0,0,0,0
20200312,053990,晶技兆豐96購01,2.00,2.06,1.26,1.35,-0.80,-37.21,433000,52,784390,0,0,0,0,0,0,421000,15000,406000,406000
20200312,053991,鴻海群益96購05,0.07,0.07,0.07,0.07,0.00,0.00,10000,1,700,0,0,0,0,0,0,0,10000,-10000,-10000
20200312,053992,中環群益96購01,0.08,0.08,0.08,0.08,0.00,0.00,20000,1,1600,0,0,0,0,0,0,0,20000,-20000,-20000
20200312,053993,旺宏群益98購02,1.30,1.30,0.96,0.96,-0.81,-45.76,73000,6,87380,0,0,0,0,0,0,52000,33000,19000,19000
20200312,053994,微星群益96購01,0.87,0.87,0.87,0.87,-0.19,-17.92,25000,2,21750,0,0,0,0,0,0,25000,0,25000,25000
20200312,053995,奇力新群益97購02,0.67,0.67,0.43,0.44,-0.27,-38.03,310000,30,164320,0,0,0,0,0,0,180000,130000,50000,50000
20200312,053996,晶相光群益97購01,1.01,1.01,0.72,0.76,-0.24,-24.0,179000,20,158360,0,0,0,0,0,0,109000,70000,39000,39000
20200312,053997,健策群益97購02,0.41,0.47,0.35,0.35,-0.29,-45.31,292000,5,122120,0,0,0,0,0,0,184000,108000,76000,76000
20200312,053998,泰鼎群益98購01,2.43,2.44,1.78,1.78,-1.34,-42.95,20000,3,46060,0,0,0,0,0,0,16000,10000,6000,6000
20200312,053999,台表科群益96購06,0.07,0.07,0.07,0.07,0.00,0.00,299000,1,20930,0,0,0,0,0,0,299000,0,299000,299000
20200312,05399P,GIS國票95售03,1.88,2.34,1.88,2.34,+0.56,31.46,379000,9,733460,0,0,0,0,0,0,290000,89000,201000,201000
20200312,054000,訊芯群益96購02,0.41,0.41,0.29,0.29,-0.30,-50.85,130000,4,52100,0,0,0,0,0,0,31000,99000,-68000,-68000
20200312,054001,康友群益96購02,1.81,1.82,1.73,1.73,-0.34,-16.43,90000,9,162040,0,0,0,0,0,0,80000,31000,49000,49000
20200312,054002,GIS群益96購03,,,,,0.00,0.00,0,0,0,0,0,0,0,0,0,0,0,0,0
20200312,054003,鴻海統一96購13,,,,,0.00,0.00,0,0,0,0,0,0,0,0,0,0,0,0,0
20200312,054004,鴻海統一96購14,,,,,0.00,0.00,0,0,0,0,0,0,0,0,0,0,0,0,0
20200312,054005,旺宏統一97購04,0.73,0.73,0.55,0.55,-0.35,-38.89,68000,3,44600,0,0,0,0,0,0,48000,20000,28000,28000
20200312,054006,智易統一97購01,0.29,0.29,0.29,0.29,-0.30,-50.85,50000,1,14500,0,0,0,0,0,0,0,50000,-50000,-50000
20200312,054007,貿聯統一96購01,0.42,0.42,0.30,0.30,-0.24,-44.44,66000,8,21470,0,0,0,0,0,0,16000,50000,-34000,-34000
20200312,054008,大立光元富96購06,0.18,0.18,0.13,0.14,0.00,0.00,170000,5,27350,0,0,0,0,0,0,0,170000,-170000,-170000
20200312,054009,欣興元富96購03,0.06,0.06,0.04,0.05,-0.05,-50.0,164000,12,9000,0,0,0,0,0,0,0,140000,-140000,-140000
20200312,05400P,台積電永豐95售05,2.10,2.10,1.90,1.92,0.00,0.00,73000,10,145650,0,0,0,0,0,0,14000,59000,-45000,-45000
20200312,054010,致伸元富96購01,,,,,0.00,0.00,0,0,0,0,0,0,0,0,0,0,0,0,0
20200312,054011,旺宏永豐96購05,0.09,0.09,0.08,0.08,-0.10,-55.56,349000,2,30910,0,0,0,0,0,0,0,349000,-349000,-349000
20200312,054012,廣達永豐96購01,,,,,0.00,0.00,0,0,0,0,0,0,0,0,0,0,0,0,0
20200312,054013,聯發科永豐96購02,0.01,0.01,0.01,0.01,0.00,0.00,297000,32,2970,0,0,0,0,0,0,0,297000,-297000,-297000
20200312,054014,宏達電永豐96購04,0.12,0.12,0.08,0.08,-0.09,-52.94,550000,5,53000,0,0,0,0,0,0,300000,250000,50000,50000
20200312,054015,晶豪科永豐96購03,,,,,0.00,0.00,0,0,0,0,0,0,0,0,0,0,0,0,0
20200312,054016,嘉晶永豐96購04,0.62,0.65,0.54,0.61,-0.02,-3.17,164000,6,98760,0,0,0,0,0,0,137000,27000,110000,110000
20200312,054017,茂林永豐96購02,0.48,0.48,0.45,0.45,-0.18,-28.57,103000,2,48390,0,0,0,0,0,0,68000,35000,33000,33000
20200312,054018,華新台新96購01,,,,,0.00,0.00,0,0,0,0,0,0,0,0,0,0,0,0,0
20200312,054019,燿華台新96購01,,,,,0.00,0.00,0,0,0,0,0,0,0,0,0,0,0,0,0
20200312,05401P,聯茂永豐95售03,0.47,0.57,0.45,0.52,+0.15,40.54,188000,10,93150,0,0,0,0,0,0,23000,165000,-142000,-142000
20200312,054020,技嘉台新97購01,0.95,0.95,0.75,0.75,-0.39,-34.21,42000,2,31900,0,0,0,0,0,0,42000,0,42000,42000
20200312,054021,義隆台新96購01,0.44,0.45,0.43,0.43,-0.18,-29.51,55000,3,24050,0,0,0,0,0,0,55000,0,55000,55000
20200312,054022,南亞康和96購01,,,,,0.00,0.00,0,0,0,0,0,0,0,0,0,0,0,0,0
20200312,054023,和大康和96購01,,,,,0.00,0.00,0,0,0,0,0,0,0,0,0,0,0,0,0
20200312,054024,中鋼康和96購01,0.23,0.23,0.23,0.23,-0.13,-36.11,100000,1,23000,0,0,0,0,0,0,100000,0,100000,100000
20200312,054025,鴻海凱基96購17,0.37,0.37,0.37,0.37,-0.09,-19.57,20000,1,7400,0,0,0,0,0,0,20000,0,20000,20000
20200312,054026,台積電凱基97購08,0.10,0.10,0.10,0.10,0.00,0.00,30000,3,3000,0,0,0,0,0,0,0,30000,-30000,-30000
20200312,054027,欣興凱基96購04,,,,,0.00,0.00,0,0,0,0,0,0,0,0,0,0,0,0,0
20200312,054028,臻鼎凱基96購03,0.37,0.40,0.28,0.30,-0.28,-48.28,365000,7,125300,0,0,0,0,0,0,230000,135000,95000,95000
20200312,054029,瀚宇博凱基96購02,,,,,0.00,0.00,0,0,0,0,0,0,0,0,0,0,0,0,0
20200312,05402P,台郡永豐95售02,0.57,0.66,0.57,0.66,+0.22,50.0,210000,7,127950,0,0,0,0,0,0,85000,135000,-50000,-50000
20200312,054030,台苯中信98購01,0.10,0.10,0.10,0.10,0.00,0.00,10000,1,1000,0,0,0,0,0,0,10000,0,10000,10000
20200312,054031,中鋼中信98購01,0.30,0.30,0.22,0.23,-0.12,-34.29,536000,11,135820,0,0,0,0,0,0,120000,416000,-296000,-296000
20200312,054032,上銀中信96購01,,,,,0.00,0.00,0,0,0,0,0,0,0,0,0,0,0,0,0
20200312,054033,欣興中信96購02,,,,,0.00,0.00,0,0,0,0,0,0,0,0,0,0,0,0,0
20200312,054034,景碩中信96購01,,,,,0.00,0.00,0,0,0,0,0,0,0,0,0,0,0,0,0
20200312,054035,聯詠麥證96購01,,,,,0.00,0.00,0,0,0,0,0,0,0,0,0,0,0,0,0
20200312,054036,T50反1元大96購08,1.74,1.74,1.74,1.74,+0.39,28.89,10000,1,17400,0,0,0,0,0,0,10000,0,10000,10000
20200312,054037,T50反1元大96購09,1.73,1.73,1.73,1.73,+0.61,54.46,1000,1,1730,0,0,0,0,0,0,1000,0,1000,1000
20200312,054038,T50反1元大98購04,1.38,1.38,1.38,1.38,+0.27,24.32,499000,2,688620,0,0,0,0,0,0,0,499000,-499000,-499000
20200312,054039,元油反元大96購08,3.72,4.50,3.72,4.18,+1.56,59.54,218000,15,910100,0,0,0,0,0,0,101000,117000,-16000,-16000
20200312,05403P,台積電富邦95售08,0.56,0.75,0.56,0.63,+0.13,26.0,766000,18,475040,0,0,0,0,0,0,508000,266000,242000,242000
20200312,054040,中石化元大9C購01,0.29,0.29,0.23,0.23,-0.12,-34.29,30000,2,7500,0,0,0,0,0,0,10000,20000,-10000,-10000
20200312,054041,鴻海元大96購22,0.22,0.22,0.22,0.22,-0.24,-52.17,50000,1,11000,0,0,0,0,0,0,50000,0,50000,50000
20200312,054042,華泰元大96購01,0.26,0.26,0.23,0.23,-0.12,-34.29,68000,6,16340,0,0,0,0,0,0,68000,0,68000,68000
20200312,054043,漢唐元大97購01,,,,,0.00,0.00,0,0,0,0,0,0,0,0,0,0,0,0,0
20200312,054044,京元電元大96購03,,,,,0.00,0.00,0,0,0,0,0,0,0,0,0,0,0,0,0
20200312,054045,奇力新元大97購03,1.00,1.00,1.00,1.00,-0.29,-22.48,20000,1,20000,0,0,0,0,0,0,20000,0,20000,20000
20200312,054046,義隆元大96購02,0.66,0.66,0.54,0.56,-0.19,-25.33,589000,20,345900,0,0,0,0,0,0,274000,315000,-41000,-41000
20200312,054047,富邦金元大97購01,0.46,0.46,0.33,0.35,-0.15,-30.0,588000,27,216270,0,0,0,0,0,0,250000,338000,-88000,-88000
20200312,054048,國泰金元大96購04,0.58,0.58,0.48,0.48,-0.20,-29.41,572000,9,319380,0,0,0,0,0,0,537000,35000,502000,502000
20200312,054049,亞光元大96購03,0.67,0.67,0.46,0.46,-0.52,-53.06,19000,3,10060,0,0,0,0,0,0,2000,19000,-17000,-17000
20200312,05404P,台積電群益95售06,,,,,0.00,0.00,0,0,0,0,0,0,0,0,0,0,0,0,0
20200312,054050,創意元大96購06,,,,,0.00,0.00,0,0,0,0,0,0,0,0,0,0,0,0,0
20200312,054051,貿聯元大97購03,0.99,0.99,0.70,0.73,-0.44,-37.61,158000,10,122270,0,0,0,0,0,0,52000,106000,-54000,-54000
20200312,054052,日月光元大96購06,0.07,0.07,0.05,0.05,-0.08,-61.54,510000,3,32500,0,0,0,0,0,0,0,510000,-510000,-510000
20200312,054053,聯茂元大96購01,2.09,2.09,1.44,1.44,-1.10,-43.31,242000,10,414990,0,0,0,0,0,0,0,242000,-242000,-242000
20200312,054054,光磊國票97購02,0.06,0.06,0.05,0.05,-0.05,-50.0,30000,3,1550,0,0,0,0,0,0,0,30000,-30000,-30000
20200312,054055,全新國票99購02,0.34,0.34,0.34,0.34,-0.20,-37.04,100000,1,34000,0,0,0,0,0,0,0,100000,-100000,-100000
20200312,054056,華新科國票96購02,2.43,2.43,1.26,1.51,-1.45,-48.99,225000,9,370960,0,0,0,0,0,0,0,225000,-225000,-225000
20200312,054057,晶豪科國票97購01,0.78,0.78,0.72,0.77,-0.19,-19.79,70000,23,53700,0,0,0,0,0,0,60000,10000,50000,50000
20200312,054058,晶豪科國票98購01,0.99,0.99,0.65,0.67,-0.63,-48.46,66000,21,60300,0,0,0,0,0,0,40000,26000,14000,14000
20200312,054059,欣興國票97購03,0.37,0.37,0.30,0.30,0.00,0.00,11000,3,3650,0,0,0,0,0,0,0,11000,-11000,-11000
20200312,05405P,大立光群益95售04,0.41,0.57,0.41,0.51,+0.37,264.29,200000,12,91460,0,0,0,0,0,0,170000,30000,140000,140000
20200312,054060,晶技國票97購02,1.37,1.38,0.60,0.64,-0.75,-53.96,252000,23,262830,0,0,0,0,0,0,46000,205000,-159000,-159000
20200312,054061,晶技國票97購03,2.55,2.58,1.55,1.55,-1.05,-40.38,104000,15,250750,0,0,0,0,0,0,89000,19000,70000,70000
20200312,054062,TPK國票96購02,0.18,0.18,0.18,0.18,-0.15,-45.45,30000,2,5400,0,0,0,0,0,0,30000,0,30000,30000
20200312,054063,聯茂國票97購02,3.04,3.04,3.04,3.04,0.00,0.00,13000,1,39520,0,0,0,0,0,0,0,13000,-13000,-13000
20200312,054064,台郡國票97購04,1.13,1.13,1.02,1.02,-0.76,-42.7,31000,2,33600,0,0,0,0,0,0,31000,0,31000,31000
20200312,054065,樺漢國票97購01,0.51,0.51,0.48,0.48,-0.24,-33.33,40000,2,19500,0,0,0,0,0,0,10000,30000,-20000,-20000
20200312,054066,緯穎國票97購03,4.80,4.80,4.80,4.80,-2.00,-29.41,5000,1,24000,0,0,0,0,0,0,0,5000,-5000,-5000
20200312,054067,百和國票97購03,0.54,0.54,0.29,0.29,-0.34,-53.97,2509000,69,1000470,0,0,0,0,0,0,66000,2443000,-2377000,-2377000
20200312,054068,華通國泰96購02,0.30,0.30,0.26,0.28,-0.15,-34.88,118000,35,33640,0,0,0,0,0,0,118000,0,118000,118000
20200312,054069,亞光國泰98購01,0.50,0.50,0.34,0.34,-0.26,-43.33,147000,10,58620,0,0,0,0,0,0,86000,66000,20000,20000
20200312,05406P,台光電凱基95售02,0.30,0.32,0.30,0.31,0.00,0.00,72000,5,22290,0,0,0,0,0,0,10000,62000,-52000,-52000
20200312,054070,創意國泰96購02,0.40,0.40,0.25,0.25,-0.24,-48.98,112000,7,35760,0,0,0,0,0,0,52000,60000,-8000,-8000
20200312,054071,泰鼎國泰97購02,2.39,2.39,1.78,1.78,-0.70,-28.23,27000,3,53660,0,0,0,0,0,0,15000,12000,3000,3000
20200312,054072,台積電富邦98購02,0.23,0.23,0.15,0.19,-0.08,-29.63,12193000,152,2238590,0,0,0,0,0,0,2999000,8079000,-5080000,-5080000
20200312,054073,群創富邦96購03,0.08,0.09,0.03,0.09,-0.02,-18.18,540000,10,24770,0,0,0,0,0,0,38000,7000,31000,31000
20200312,054074,健策富邦98購01,0.33,0.33,0.25,0.26,-0.13,-33.33,256000,10,69680,0,0,0,0,0,0,180000,51000,129000,129000
20200312,054075,GIS富邦97購02,,,,,0.00,0.00,0,0,0,0,0,0,0,0,0,0,0,0,0
20200312,054076,義隆第一96購01,,,,,0.00,0.00,0,0,0,0,0,0,0,0,0,0,0,0,0
20200312,054077,中石化中信98購01,,,,,0.00,0.00,0,0,0,0,0,0,0,0,0,0,0,0,0
20200312,054078,鴻海中信98購01,,,,,0.00,0.00,0,0,0,0,0,0,0,0,0,0,0,0,0
20200312,054079,鴻海中信98購02,0.26,0.27,0.20,0.20,-0.10,-33.33,577000,22,129970,0,0,0,0,0,0,120000,447000,-327000,-327000
20200312,05407P,超眾凱基95售04,,,,,0.00,0.00,0,0,0,0,0,0,0,0,0,0,0,0,0
20200312,054080,微星中信98購01,,,,,0.00,0.00,0,0,0,0,0,0,0,0,0,0,0,0,0
20200312,054081,聯電元富96購01,0.13,0.13,0.11,0.12,-0.10,-45.45,14000,3,1700,0,0,0,0,0,0,14000,14000,0,0
20200312,054082,楠梓電元富96購01,0.60,0.60,0.46,0.49,-0.28,-36.36,278000,52,158690,0,0,0,0,0,0,258000,20000,238000,238000
20200312,054083,智伸科元富96購01,,,,,0.00,0.00,0,0,0,0,0,0,0,0,0,0,0,0,0
20200312,054084,旺宏統一97購05,,,,,0.00,0.00,0,0,0,0,0,0,0,0,0,0,0,0,0
20200312,054085,華新科統一96購04,0.50,0.50,0.39,0.39,-0.42,-51.85,28000,3,12320,0,0,0,0,0,0,0,28000,-28000,-28000
20200312,054086,日月光亞東98購01,,,,,0.00,0.00,0,0,0,0,0,0,0,0,0,0,0,0,0
20200312,054087,矽創亞東96購01,,,,,0.00,0.00,0,0,0,0,0,0,0,0,0,0,0,0,0
20200312,054088,華新群益98購02,0.26,0.26,0.16,0.16,-0.16,-50.0,226000,8,46700,0,0,0,0,0,0,52000,174000,-122000,-122000
20200312,054089,台積電群益96購11,0.20,0.21,0.15,0.21,-0.05,-19.23,724000,15,141160,0,0,0,0,0,0,25000,549000,-524000,-524000
20200312,05408P,臺股指中信95售13,,,,,0.00,0.00,0,0,0,0,0,0,0,0,0,0,0,0,0
20200312,054090,瑞昱群益97購01,0.48,0.48,0.34,0.34,-0.45,-56.96,161000,2,64540,0,0,0,0,0,0,91000,70000,21000,21000
20200312,054091,晶豪科群益96購01,0.47,0.48,0.39,0.39,-0.17,-30.36,407000,31,183010,0,0,0,0,0,0,368000,0,368000,368000
20200312,054092,大立光群益97購01,0.24,0.24,0.24,0.24,0.00,0.00,10000,1,2400,0,0,0,0,0,0,10000,10000,0,0
20200312,054093,智原群益97購01,,,,,0.00,0.00,0,0,0,0,0,0,0,0,0,0,0,0,0
20200312,054094,創意群益96購02,0.49,0.49,0.30,0.30,-0.34,-53.12,121000,5,46350,0,0,0,0,0,0,40000,81000,-41000,-41000
20200312,054095,同欣電群益98購03,0.68,0.69,0.59,0.59,-0.25,-29.76,308000,7,197620,0,0,0,0,0,0,210000,98000,112000,112000
20200312,054096,佳世達國票97購01,0.21,0.21,0.20,0.20,-0.16,-44.44,130000,2,27000,0,0,0,0,0,0,30000,100000,-70000,-70000
20200312,054097,淘帝國票97購01,,,,,0.00,0.00,0,0,0,0,0,0,0,0,0,0,0,0,0
20200312,054098,嘉晶國票97購04,1.68,1.68,1.38,1.43,-0.75,-34.4,43000,6,60200,0,0,0,0,0,0,35000,5000,30000,30000
20200312,054099,TPK國票98購01,,,,,0.00,0.00,0,0,0,0,0,0,0,0,0,0,0,0,0
20200312,05409P,京元電元富95售05,1.66,2.03,1.65,2.02,+0.48,31.17,68000,10,122160,0,0,0,0,0,0,10000,58000,-48000,-48000
20200312,054100,致伸國票97購03,0.22,0.22,0.21,0.21,0.00,0.00,201000,4,43210,0,0,0,0,0,0,0,201000,-201000,-201000
20200312,054101,茂林國票97購04,0.65,0.65,0.37,0.37,-0.35,-48.61,1290000,18,669070,0,0,0,0,0,0,157000,1133000,-976000,-976000
20200312,054102,百和國票97購04,0.61,0.61,0.34,0.34,-0.39,-53.42,1770000,59,720040,0,0,0,0,0,0,545000,1225000,-680000,-680000
20200312,054103,T50反1凱基99購04,2.09,2.20,2.09,2.20,0.00,0.00,11000,2,24090,0,0,0,0,0,0,11000,0,11000,11000
20200312,054104,T50反1凱基9A購02,,,,,0.00,0.00,0,0,0,0,0,0,0,0,0,0,0,0,0
20200312,054105,元油反凱基9A購01,,,,,0.00,0.00,0,0,0,0,0,0,0,0,0,0,0,0,0
20200312,054106,元油反凱基9C購01,4.94,6.10,4.94,6.10,+1.71,38.95,116000,13,651990,0,0,0,0,0,0,107000,0,107000,107000
20200312,054107,上銀凱基97購01,0.83,0.83,0.54,0.54,-0.50,-48.08,320000,12,193350,0,0,0,0,0,0,229000,211000,18000,18000
20200312,054108,台積電凱基96購22,0.06,0.06,0.06,0.06,-0.05,-45.45,70000,2,4200,0,0,0,0,0,0,0,0,0,0
20200312,054109,南亞科凱基96購05,,,,,0.00,0.00,0,0,0,0,0,0,0,0,0,0,0,0,0
20200312,05410P,聯發科元富95售04,1.99,2.25,1.99,2.25,+0.67,42.41,133000,6,284990,0,0,0,0,0,0,47000,86000,-39000,-39000
20200312,054110,群創凱基98購09,,,,,0.00,0.00,0,0,0,0,0,0,0,0,0,0,0,0,0
20200312,054111,緯穎凱基97購01,1.63,1.63,1.63,1.63,-0.94,-36.58,10000,1,16300,0,0,0,0,0,0,0,10000,-10000,-10000
20200312,054112,台積電麥證96購02,0.15,0.15,0.15,0.15,-0.04,-21.05,5000,1,750,0,0,0,0,0,0,0,0,0,0
20200312,054113,奇力新台新97購01,0.55,0.55,0.33,0.35,-0.33,-48.53,644000,19,262450,0,0,0,0,0,0,103000,541000,-438000,-438000
20200312,054114,新光金台新97購01,0.08,0.08,0.08,0.08,0.00,0.00,445000,1,35600,0,0,0,0,0,0,0,0,0,0
20200312,054115,台塑康和96購01,,,,,0.00,0.00,0,0,0,0,0,0,0,0,0,0,0,0,0
20200312,054116,順德康和96購01,0.22,0.22,0.16,0.16,-0.14,-46.67,107000,2,17540,0,0,0,0,0,0,7000,100000,-93000,-93000
20200312,054117,宏全康和96購01,0.43,0.43,0.32,0.32,-0.18,-36.0,520000,7,198980,0,0,0,0,0,0,320000,200000,120000,120000
20200312,054118,國巨永豐96購04,0.35,0.35,0.19,0.19,-0.25,-56.82,334000,30,90010,0,0,0,0,0,0,75000,259000,-184000,-184000
20200312,054119,燿華永豐96購05,0.04,0.04,0.04,0.04,0.00,0.00,10000,1,400,0,0,0,0,0,0,0,10000,-10000,-10000
20200312,05411P,台積電國票96售08,1.26,1.81,1.26,1.45,+0.53,57.61,2223000,19,3240610,0,0,0,0,0,0,796000,1437000,-641000,-641000
20200312,054120,奇力新永豐96購01,0.18,0.18,0.18,0.18,-0.13,-41.94,27000,2,4860,0,0,0,0,0,0,2000,25000,-23000,-23000
20200312,054121,奇鋐永豐96購02,0.47,0.47,0.37,0.37,-0.16,-30.19,108000,6,45280,0,0,0,0,0,0,78000,30000,48000,48000
20200312,054122,康友永豐96購01,0.43,0.43,0.28,0.31,-0.15,-32.61,311000,15,123640,0,0,0,0,0,0,200000,61000,139000,139000
20200312,054123,易華電永豐96購03,0.36,0.36,0.36,0.36,0.00,0.00,10000,1,3600,0,0,0,0,0,0,0,10000,-10000,-10000
20200312,054124,達方永豐96購02,,,,,0.00,0.00,0,0,0,0,0,0,0,0,0,0,0,0,0
20200312,054125,元油反元大96購09,,,,,0.00,0.00,0,0,0,0,0,0,0,0,0,0,0,0,0
20200312,054126,和大元大96購02,0.37,0.37,0.37,0.37,-0.18,-32.73,41000,1,15170,0,0,0,0,0,0,41000,0,41000,41000
20200312,054127,台積電元大96購21,0.58,0.59,0.43,0.59,-0.31,-34.44,677000,17,358620,0,0,0,0,0,0,329000,367000,-38000,-38000
20200312,054128,台積電元大97購10,0.30,0.65,0.30,0.55,-0.30,-35.29,115000,7,50420,0,0,0,0,0,0,93000,1000,92000,92000
20200312,054129,技嘉元大96購02,0.90,0.92,0.72,0.75,-0.26,-25.74,376000,11,295700,0,0,0,0,0,0,284000,82000,202000,202000
20200312,05412P,泰碩國票95售02,1.12,1.40,1.05,1.22,+0.18,17.31,1699000,71,2100670,0,0,0,0,0,0,1187000,512000,675000,675000
20200312,054130,漢唐元大97購02,0.79,0.79,0.64,0.64,-0.25,-28.09,141000,3,97090,0,0,0,0,0,0,73000,118000,-45000,-45000
20200312,054131,南亞科元大96購04,0.40,0.41,0.25,0.28,-0.31,-52.54,150000,6,51000,0,0,0,0,0,0,10000,140000,-130000,-130000
20200312,054132,聯發科元大97購10,0.16,0.16,0.16,0.16,-0.16,-50.0,40000,1,6400,0,0,0,0,0,0,0,40000,-40000,-40000
20200312,054133,奇力新元大97購04,1.02,1.02,0.59,0.60,-0.65,-52.0,91000,7,78260,0,0,0,0,0,0,91000,21000,70000,70000
20200312,054134,強茂元大96購01,,,,,0.00,0.00,0,0,0,0,0,0,0,0,0,0,0,0,0
20200312,054135,大立光元大97購04,,,,,0.00,0.00,0,0,0,0,0,0,0,0,0,0,0,0,0
20200312,054136,亞光元大96購04,0.74,0.76,0.66,0.68,-0.23,-25.27,12000,4,8480,0,0,0,0,0,0,12000,3000,9000,9000
20200312,054137,聯詠元大97購02,0.81,0.81,0.64,0.73,-0.14,-16.09,809000,36,588240,0,0,0,0,0,0,616000,388000,228000,228000
20200312,054138,晶技元大98購02,1.34,1.34,0.74,0.75,-0.58,-43.61,661000,42,713990,0,0,0,0,0,0,536000,90000,446000,446000
20200312,054139,揚明光元大96購01,,,,,0.00,0.00,0,0,0,0,0,0,0,0,0,0,0,0,0
20200312,05413P,台郡國票96售02,0.63,0.80,0.63,0.80,+0.26,48.15,379000,16,273310,0,0,0,0,0,0,216000,73000,143000,143000
20200312,054140,智易元大97購03,0.37,0.37,0.37,0.37,0.00,0.00,68000,1,25160,0,0,0,0,0,0,0,68000,-68000,-68000
20200312,054141,TPK元大96購02,0.16,0.16,0.16,0.16,-0.09,-36.0,10000,1,1600,0,0,0,0,0,0,0,10000,-10000,-10000
20200312,054142,致伸元大97購01,0.15,0.15,0.13,0.13,0.00,0.00,539000,2,70870,0,0,0,0,0,0,0,539000,-539000,-539000
20200312,054143,茂林元大96購04,1.73,1.73,1.16,1.16,-0.67,-36.61,158000,10,248140,0,0,0,0,0,0,48000,128000,-80000,-80000
20200312,054144,康控元大97購02,,,,,0.00,0.00,0,0,0,0,0,0,0,0,0,0,0,0,0
20200312,054145,嘉聯益元大98購01,0.24,0.24,0.24,0.24,0.00,0.00,25000,1,6000,0,0,0,0,0,0,25000,0,25000,25000
20200312,054146,康友元大96購06,1.70,1.70,1.30,1.32,-0.80,-37.74,179000,14,259470,0,0,0,0,0,0,126000,117000,9000,9000
20200312,054147,GIS元大96購02,,,,,0.00,0.00,0,0,0,0,0,0,0,0,0,0,0,0,0
20200312,054148,矽創元大96購03,0.65,0.67,0.53,0.53,-0.30,-36.14,45000,3,25850,0,0,0,0,0,0,45000,0,45000,45000
20200312,054149,達方元大96購01,,,,,0.00,0.00,0,0,0,0,0,0,0,0,0,0,0,0,0
20200312,05414P,台表科國票96售02,1.08,1.28,1.08,1.27,+0.25,24.51,39000,6,43930,0,0,0,0,0,0,20000,19000,1000,1000
20200312,054150,國巨國泰97購05,,,,,0.00,0.00,0,0,0,0,0,0,0,0,0,0,0,0,0
20200312,054151,瑞昱國泰97購01,1.18,1.18,0.65,0.75,-0.77,-50.66,233000,19,190170,0,0,0,0,0,0,65000,203000,-138000,-138000
20200312,054152,漢唐國泰98購02,0.71,0.71,0.59,0.59,-0.21,-26.25,67000,11,42790,0,0,0,0,0,0,52000,27000,25000,25000
20200312,054153,宏達電國泰97購01,0.62,0.62,0.62,0.62,-0.05,-7.46,98000,1,60760,0,0,0,0,0,0,0,98000,-98000,-98000
20200312,054154,智易國泰97購01,0.22,0.22,0.22,0.22,-0.16,-42.11,20000,1,4400,0,0,0,0,0,0,0,20000,-20000,-20000
20200312,054155,美律第一96購01,,,,,0.00,0.00,0,0,0,0,0,0,0,0,0,0,0,0,0
20200312,054156,聯電亞東98購01,0.25,0.31,0.25,0.31,-0.08,-20.51,257000,6,67770,0,0,0,0,0,0,70000,137000,-67000,-67000
20200312,054157,國巨亞東96購01,,,,,0.00,0.00,0,0,0,0,0,0,0,0,0,0,0,0,0
20200312,054158,國巨日盛99購01,0.75,0.75,0.49,0.49,-0.49,-50.0,126000,10,78330,0,0,0,0,0,0,16000,69000,-53000,-53000
20200312,054159,T50正2凱基99購01,0.34,0.34,0.20,0.24,-0.26,-52.0,1107000,35,269840,0,0,0,0,0,0,250000,597000,-347000,-347000
20200312,05415P,台積電台新95售04,,,,,0.00,0.00,0,0,0,0,0,0,0,0,0,0,0,0,0
20200312,054160,華泰凱基98購01,,,,,0.00,0.00,0,0,0,0,0,0,0,0,0,0,0,0,0
20200312,054161,友訊凱基98購01,0.76,0.76,0.61,0.61,-0.22,-26.51,110000,3,77100,0,0,0,0,0,0,50000,60000,-10000,-10000
20200312,054162,光罩凱基98購01,0.55,0.55,0.41,0.41,-0.22,-34.92,214000,17,100920,0,0,0,0,0,0,192000,13000,179000,179000
20200312,054163,燿華凱基97購02,0.18,0.18,0.17,0.18,-0.14,-43.75,200000,7,35800,0,0,0,0,0,0,200000,0,200000,200000
20200312,054164,強茂凱基98購01,0.62,0.62,0.62,0.62,-0.39,-38.61,50000,1,31000,0,0,0,0,0,0,0,50000,-50000,-50000
20200312,054165,亞光凱基96購02,,,,,0.00,0.00,0,0,0,0,0,0,0,0,0,0,0,0,0
20200312,054166,日電貿凱基98購01,0.62,0.62,0.54,0.54,-0.25,-31.65,62000,3,34460,0,0,0,0,0,0,32000,30000,2000,2000
20200312,054167,揚明光凱基98購01,0.24,0.24,0.24,0.24,-0.19,-44.19,4000,1,960,0,0,0,0,0,0,4000,0,4000,4000
20200312,054168,貿聯凱基97購02,0.46,0.46,0.42,0.43,-0.14,-24.56,12000,10,5300,0,0,0,0,0,0,12000,0,12000,12000
20200312,054169,上緯控凱基98購01,0.76,0.76,0.60,0.60,-0.31,-34.07,59000,5,38740,0,0,0,0,0,0,0,57000,-57000,-57000
20200312,05416P,喬山永豐95售04,2.37,2.47,2.37,2.45,+0.22,9.87,41000,4,100650,0,0,0,0,0,0,41000,0,41000,41000
20200312,054170,泰鼎凱基98購01,2.02,2.02,1.71,1.71,-1.15,-40.21,4000,4,7460,0,0,0,0,0,0,0,4000,-4000,-4000
20200312,054171,台郡凱基97購01,0.72,0.77,0.72,0.77,0.00,0.00,2000,2,1490,0,0,0,0,0,0,2000,2000,0,0
20200312,054172,易華電凱基98購01,0.43,0.43,0.36,0.36,-0.30,-45.45,16000,3,6480,0,0,0,0,0,0,0,16000,-16000,-16000
20200312,054173,奇力新台新97購02,0.32,0.32,0.21,0.21,-0.20,-48.78,271000,12,66290,0,0,0,0,0,0,181000,90000,91000,91000
20200312,054174,宏達電台新97購01,0.24,0.24,0.24,0.24,0.00,0.00,10000,1,2400,0,0,0,0,0,0,0,10000,-10000,-10000
20200312,054175,高鐵台新97購01,0.17,0.17,0.17,0.17,0.00,0.00,60000,1,10200,0,0,0,0,0,0,60000,0,60000,60000
20200312,054176,亞光台新96購01,,,,,0.00,0.00,0,0,0,0,0,0,0,0,0,0,0,0,0
20200312,054177,牧德台新97購01,1.90,1.90,1.41,1.41,-1.26,-47.19,85000,3,153290,0,0,0,0,0,0,9000,76000,-67000,-67000
20200312,054178,中磊台新97購01,0.77,0.77,0.51,0.59,-0.31,-34.44,186000,12,105560,0,0,0,0,0,0,145000,96000,49000,49000
20200312,054179,上海銀台新97購01,0.15,0.15,0.11,0.11,-0.13,-54.17,100000,6,11400,0,0,0,0,0,0,0,100000,-100000,-100000
20200312,05417P,燿華永豐95售07,2.83,3.33,2.83,3.33,+0.91,37.6,49000,6,149280,0,0,0,0,0,0,21000,28000,-7000,-7000
20200312,054180,亞泥康和96購01,,,,,0.00,0.00,0,0,0,0,0,0,0,0,0,0,0,0,0
20200312,054181,華新康和96購01,,,,,0.00,0.00,0,0,0,0,0,0,0,0,0,0,0,0,0
20200312,054182,台積電康和96購01,,,,,0.00,0.00,0,0,0,0,0,0,0,0,0,0,0,0,0
20200312,054183,亞光康和96購01,,,,,0.00,0.00,0,0,0,0,0,0,0,0,0,0,0,0,0
20200312,054184,A50正2永豐96購01,,,,,0.00,0.00,0,0,0,0,0,0,0,0,0,0,0,0,0
20200312,054185,喬山永豐96購02,0.27,0.27,0.23,0.23,-0.20,-46.51,75000,3,19050,0,0,0,0,0,0,20000,75000,-55000,-55000
20200312,054186,高鐵永豐96購01,,,,,0.00,0.00,0,0,0,0,0,0,0,0,0,0,0,0,0
20200312,054187,亞光永豐96購03,0.06,0.06,0.05,0.05,-0.11,-68.75,15000,2,800,0,0,0,0,0,0,5000,10000,-5000,-5000
20200312,054188,欣興永豐96購03,0.64,0.64,0.32,0.41,-0.39,-48.75,172000,16,87480,0,0,0,0,0,0,30000,125000,-95000,-95000
20200312,054189,貿聯永豐96購03,0.22,0.22,0.15,0.15,-0.13,-46.43,71000,4,12450,0,0,0,0,0,0,41000,30000,11000,11000
20200312,05418P,瑞昱永豐95售02,0.99,1.25,0.99,1.22,+0.42,52.5,83000,8,95180,0,0,0,0,0,0,7000,76000,-69000,-69000
20200312,054190,矽創永豐96購01,,,,,0.00,0.00,0,0,0,0,0,0,0,0,0,0,0,0,0
20200312,054191,香港2X中信98購01,0.08,0.09,0.07,0.08,0.00,0.00,250000,6,20000,0,0,0,0,0,0,210000,40000,170000,170000
20200312,054192,國巨中信98購01,0.56,0.56,0.32,0.35,-0.22,-38.6,176000,20,69270,0,0,0,0,0,0,45000,130000,-85000,-85000
20200312,054193,鴻海麥證96購02,,,,,0.00,0.00,0,0,0,0,0,0,0,0,0,0,0,0,0
20200312,054194,國巨麥證96購02,1.48,1.48,1.08,1.08,-0.44,-28.95,120000,6,165500,50000,70000,-20000,0,0,0,50000,70000,-20000,-20000
20200312,054195,亞泥國泰98購01,0.77,0.77,0.66,0.70,-0.11,-13.58,211000,14,145340,0,0,0,0,0,0,80000,131000,-51000,-51000
20200312,054196,台光電國泰97購02,0.97,1.02,0.73,0.87,-0.37,-29.84,90000,8,78800,0,0,0,0,0,0,20000,70000,-50000,-50000
20200312,054197,台積電永昌96購07,0.28,0.28,0.17,0.24,-0.11,-31.43,4899000,87,1192260,0,0,0,0,0,0,2105000,3574000,-1469000,-1469000
20200312,054198,台積電永昌96購08,0.07,0.07,0.06,0.06,-0.06,-50.0,649000,6,41450,0,0,0,0,0,0,300000,0,300000,300000
20200312,054199,大立光永昌96購07,0.12,0.12,0.10,0.10,0.00,0.00,240000,3,26400,0,0,0,0,0,0,0,240000,-240000,-240000
20200312,05419P,矽力永豐95售02,0.50,0.50,0.45,0.45,+0.01,2.27,35000,4,16300,0,0,0,0,0,0,35000,0,35000,35000
20200312,054200,美律富邦97購02,0.07,0.07,0.07,0.07,0.00,0.00,3000,1,210,0,0,0,0,0,0,0,0,0,0
20200312,054201,聯詠富邦97購02,0.36,0.36,0.30,0.34,-0.10,-22.73,80000,7,26500,0,0,0,0,0,0,60000,20000,40000,40000
20200312,054202,樺漢富邦97購01,0.28,0.28,0.27,0.27,-0.11,-28.95,100000,2,27100,0,0,0,0,0,0,100000,0,100000,100000
20200312,054203,滬深2X國票96購03,,,,,0.00,0.00,0,0,0,0,0,0,0,0,0,0,0,0,0
20200312,054204,元金2X國票9B購02,1.33,1.35,1.18,1.20,-0.30,-20.0,1410000,50,1742660,0,0,0,0,0,0,694000,693000,1000,1000
20200312,054205,華新國票97購02,,,,,0.00,0.00,0,0,0,0,0,0,0,0,0,0,0,0,0
20200312,054206,鴻海國票99購01,0.05,0.08,0.05,0.08,-0.02,-20.0,163000,9,8180,0,0,0,0,0,0,0,0,0,0
20200312,054207,國巨國票98購01,1.00,1.00,1.00,1.00,0.00,0.00,11000,2,11000,0,0,0,0,0,0,0,10000,-10000,-10000
20200312,054208,台積電國票97購07,0.51,0.51,0.36,0.42,-0.19,-31.15,284000,17,125550,0,0,0,0,0,0,61000,220000,-159000,-159000
20200312,054209,台積電國票97購08,0.19,0.19,0.19,0.19,-0.07,-26.92,70000,1,13300,0,0,0,0,0,0,70000,0,70000,70000
20200312,05420P,大立光國泰97售03,1.39,1.65,1.38,1.65,+0.55,50.0,439000,22,632360,0,0,0,0,0,0,299000,144000,155000,155000
20200312,054210,台光電國票97購03,2.37,2.54,2.37,2.54,-0.48,-15.89,20000,2,49100,0,0,0,0,0,0,0,20000,-20000,-20000
20200312,054211,奇鋐國票97購03,0.29,0.29,0.22,0.26,-0.20,-43.48,11000,3,2750,0,0,0,0,0,0,8000,3000,5000,5000
20200312,054212,聯詠國票97購03,0.32,0.32,0.32,0.32,0.00,0.00,46000,1,14720,0,0,0,0,0,0,46000,0,46000,46000
20200312,054213,欣興國票97購04,0.91,0.93,0.66,0.68,-1.15,-62.84,163000,10,120940,0,0,0,0,0,0,45000,118000,-73000,-73000
20200312,054214,京鼎國票97購02,0.28,0.29,0.18,0.19,-0.19,-50.0,214000,11,45590,0,0,0,0,0,0,114000,100000,14000,14000
20200312,054215,創意國票97購02,0.86,0.86,0.86,0.86,-0.37,-30.08,10000,1,8600,0,0,0,0,0,0,0,10000,-10000,-10000
20200312,054216,聯茂國票97購03,5.00,5.00,3.30,3.30,-3.65,-52.52,104000,7,416500,0,0,0,0,0,0,14000,90000,-76000,-76000
20200312,054217,台表科國票97購05,0.35,0.35,0.18,0.19,-0.29,-60.42,221000,22,62810,0,0,0,0,0,0,60000,161000,-101000,-101000
20200312,054218,S&P反1統一98購02,,,,,0.00,0.00,0,0,0,0,0,0,0,0,0,0,0,0,0
20200312,054219,楠梓電統一97購01,,,,,0.00,0.00,0,0,0,0,0,0,0,0,0,0,0,0,0
20200312,05421P,鴻海元大96售12,5.95,6.85,5.80,6.85,+1.55,29.25,787000,46,5161850,0,0,0,0,0,0,472000,670000,-198000,-198000
20200312,054220,國巨統一97購02,1.25,1.25,0.69,0.76,-0.52,-40.62,27000,8,30890,0,0,0,0,0,0,2000,25000,-23000,-23000
20200312,054221,華新科統一96購05,1.31,1.31,1.31,1.31,-0.57,-30.32,20000,1,26200,0,0,0,0,0,0,0,20000,-20000,-20000
20200312,054222,大立光統一98購03,0.14,0.14,0.12,0.14,0.00,0.00,640000,8,88900,0,0,0,0,0,0,10000,630000,-620000,-620000
20200312,054223,大立光統一98購04,,,,,0.00,0.00,0,0,0,0,0,0,0,0,0,0,0,0,0
20200312,054224,亞光統一98購01,0.12,0.12,0.11,0.11,-0.08,-42.11,65000,3,7750,0,0,0,0,0,0,5000,60000,-55000,-55000
20200312,054225,華新元富96購01,,,,,0.00,0.00,0,0,0,0,0,0,0,0,0,0,0,0,0
20200312,054226,燿華元富96購02,,,,,0.00,0.00,0,0,0,0,0,0,0,0,0,0,0,0,0
20200312,054227,宏達電元富96購02,,,,,0.00,0.00,0,0,0,0,0,0,0,0,0,0,0,0,0
20200312,054228,貿聯元富96購03,0.42,0.42,0.31,0.31,-0.21,-40.38,192000,16,62130,0,0,0,0,0,0,16000,176000,-160000,-160000
20200312,054229,超眾元富96購05,0.58,0.58,0.50,0.50,-0.47,-48.45,180000,3,96480,0,0,0,0,0,0,0,180000,-180000,-180000
20200312,05422P,大立光中信97售02,0.64,0.71,0.64,0.71,0.00,0.00,215000,15,151460,0,0,0,0,0,0,115000,100000,15000,15000
20200312,054230,上銀群益96購03,0.96,0.96,0.56,0.56,-1.07,-65.64,66000,15,54050,0,0,0,0,0,0,66000,24000,42000,42000
20200312,054231,國巨群益98購03,3.53,3.53,2.25,2.62,-1.12,-29.95,129000,6,305560,0,0,0,0,0,0,101000,28000,73000,73000
20200312,054232,台積電群益96購12,0.11,0.11,0.11,0.11,-0.05,-31.25,120000,3,13200,0,0,0,0,0,0,0,120000,-120000,-120000
20200312,054233,聯發科群益96購04,0.07,0.07,0.04,0.04,-0.07,-63.64,15000,2,900,0,0,0,0,0,0,0,15000,-15000,-15000
20200312,054234,可成群益96購05,0.45,0.46,0.25,0.26,-0.42,-61.76,1062000,18,434100,0,0,0,0,0,0,43000,1019000,-976000,-976000
20200312,054235,欣興群益96購06,0.58,0.58,0.58,0.58,-0.30,-34.09,59000,1,34220,0,0,0,0,0,0,59000,0,59000,59000
20200312,054236,貿聯群益96購01,0.28,0.29,0.19,0.19,-0.21,-52.5,162000,16,32440,0,0,0,0,0,0,12000,150000,-138000,-138000
20200312,054237,茂林群益97購01,0.71,0.71,0.53,0.53,-0.20,-27.4,80000,5,52210,0,0,0,0,0,0,70000,41000,29000,29000
20200312,054238,聯茂群益96購04,,,,,0.00,0.00,0,0,0,0,0,0,0,0,0,0,0,0,0
20200312,054239,台郡群益96購02,0.51,0.51,0.51,0.51,0.00,0.00,1000,1,510,0,0,0,0,0,0,0,1000,-1000,-1000
20200312,05423P,聯電亞東95售02,0.75,0.75,0.73,0.73,+0.25,52.08,100000,2,73800,0,0,0,0,0,0,100000,0,100000,100000
20200312,054240,訊芯群益96購03,,,,,0.00,0.00,0,0,0,0,0,0,0,0,0,0,0,0,0
20200312,054241,深中小元大98購01,,,,,0.00,0.00,0,0,0,0,0,0,0,0,0,0,0,0,0
20200312,054242,元油反元大98購02,,,,,0.00,0.00,0,0,0,0,0,0,0,0,0,0,0,0,0
20200312,054243,國喬元大96購01,,,,,0.00,0.00,0,0,0,0,0,0,0,0,0,0,0,0,0
20200312,054244,華新元大96購01,,,,,0.00,0.00,0,0,0,0,0,0,0,0,0,0,0,0,0
20200312,054245,鴻海元大96購23,,,,,0.00,0.00,0,0,0,0,0,0,0,0,0,0,0,0,0
20200312,054246,國巨元大96購12,1.89,1.89,1.17,1.17,-0.81,-40.91,198000,15,337550,0,0,0,0,0,0,123000,151000,-28000,-28000
20200312,054247,華邦電元大96購04,0.09,0.09,0.08,0.08,0.00,0.00,60000,3,5300,0,0,0,0,0,0,0,60000,-60000,-60000
20200312,054248,燿華元大97購02,0.55,0.55,0.39,0.39,-0.35,-47.3,127000,6,64580,0,0,0,0,0,0,59000,64000,-5000,-5000
20200312,054249,技嘉元大96購03,0.84,0.88,0.72,0.74,-0.21,-22.11,150000,6,116360,0,0,0,0,0,0,61000,89000,-28000,-28000
20200312,05424P,台達電亞東96售02,1.31,1.37,1.31,1.37,0.00,0.00,170000,4,227800,0,0,0,0,0,0,0,170000,-170000,-170000
20200312,054250,漢唐元大96購04,0.45,0.45,0.45,0.45,-0.29,-39.19,10000,1,4500,0,0,0,0,0,0,10000,0,10000,10000
20200312,054251,聯發科元大96購21,,,,,0.00,0.00,0,0,0,0,0,0,0,0,0,0,0,0,0
20200312,054252,奇力新元大96購04,0.68,0.68,0.68,0.68,-0.30,-30.61,50000,1,34000,0,0,0,0,0,0,50000,0,50000,50000
20200312,054253,宏達電元大97購03,0.58,0.58,0.38,0.38,-0.25,-39.68,95000,4,47500,0,0,0,0,0,0,20000,75000,-55000,-55000
20200312,054254,晶豪科元大96購02,0.80,0.80,0.51,0.54,-0.30,-35.71,184000,11,127600,0,0,0,0,0,0,109000,123000,-14000,-14000
20200312,054255,亞光元大96購05,,,,,0.00,0.00,0,0,0,0,0,0,0,0,0,0,0,0,0
20200312,054256,創意元大96購07,0.60,0.60,0.55,0.55,-0.37,-40.22,32000,3,18100,0,0,0,0,0,0,22000,0,22000,22000
20200312,054257,揚明光元大96購02,0.38,0.38,0.29,0.29,-0.23,-44.23,73000,2,24320,0,0,0,0,0,0,73000,0,73000,73000
20200312,054258,牧德元大97購01,2.09,2.09,1.92,1.92,-1.09,-36.21,33000,2,68120,0,0,0,0,0,0,0,33000,-33000,-33000
20200312,054259,健策元大97購03,1.00,1.00,0.68,0.68,-0.76,-52.78,95000,5,90660,0,0,0,0,0,0,25000,70000,-45000,-45000
20200312,05425P,華邦電亞東96售02,2.01,2.01,2.01,2.01,0.00,0.00,1000,1,2010,0,0,0,0,0,0,1000,0,1000,1000
20200312,054260,貿聯元大96購03,0.47,0.47,0.47,0.47,-0.39,-45.35,68000,1,31960,0,0,0,0,0,0,0,68000,-68000,-68000
20200312,054261,智伸科元大96購03,0.33,0.33,0.33,0.33,-0.05,-13.16,20000,1,6600,0,0,0,0,0,0,20000,0,20000,20000
20200312,054262,瀚宇博元大96購03,1.03,1.03,0.70,0.70,-0.52,-42.62,249000,25,233080,0,0,0,0,0,0,229000,28000,201000,201000
20200312,054263,聯茂元大96購02,3.52,3.52,2.31,2.31,-2.00,-46.4,70000,2,210100,0,0,0,0,0,0,40000,30000,10000,10000
20200312,054264,超眾元大97購02,0.55,0.55,0.50,0.53,-0.27,-33.75,128000,8,68740,0,0,0,0,0,0,128000,0,128000,128000
20200312,054265,GIS元大96購03,,,,,0.00,0.00,0,0,0,0,0,0,0,0,0,0,0,0,0
20200312,054266,緯穎元大96購07,3.88,3.88,2.47,2.77,-1.79,-39.25,139000,17,449530,0,0,0,0,0,0,37000,136000,-99000,-99000
20200312,054267,上銀第一96購01,,,,,0.00,0.00,0,0,0,0,0,0,0,0,0,0,0,0,0
20200312,054268,健策第一96購01,0.23,0.23,0.17,0.17,-0.13,-43.33,279000,8,59550,0,0,0,0,0,0,228000,51000,177000,177000
20200312,054269,台光電亞東98購01,,,,,0.00,0.00,0,0,0,0,0,0,0,0,0,0,0,0,0
20200312,05426P,聯發科凱基95售12,,,,,0.00,0.00,0,0,0,0,0,0,0,0,0,0,0,0,0
20200312,054270,寶滬深中信98購01,1.08,1.08,1.08,1.08,-0.23,-17.56,20000,2,21600,0,0,0,0,0,0,0,20000,-20000,-20000
20200312,054271,中石化中信99購01,0.20,0.20,0.20,0.20,0.00,0.00,5000,1,1000,0,0,0,0,0,0,0,5000,-5000,-5000
20200312,054272,華通中信98購01,0.39,0.39,0.24,0.24,-0.24,-50.0,773000,26,240380,0,0,0,0,0,0,348000,425000,-77000,-77000
20200312,054273,宏達電中信98購01,,,,,0.00,0.00,0,0,0,0,0,0,0,0,0,0,0,0,0
20200312,054274,智易中信96購02,,,,,0.00,0.00,0,0,0,0,0,0,0,0,0,0,0,0,0
20200312,054275,華通群益97購03,0.15,0.15,0.12,0.12,0.00,0.00,120000,3,16100,0,0,0,0,0,0,0,120000,-120000,-120000
20200312,054276,國巨群益96購07,2.28,2.28,1.21,1.38,-0.87,-38.67,1486000,65,2220470,0,0,0,0,0,0,497000,979000,-482000,-482000
20200312,054277,亞光群益97購01,0.47,0.47,0.30,0.31,-0.35,-53.03,173000,4,59220,0,0,0,0,0,0,138000,35000,103000,103000
20200312,054278,晶技群益97購02,1.49,1.55,1.29,1.29,-0.18,-12.24,492000,25,711180,0,0,0,0,0,0,374000,9000,365000,365000
20200312,054279,揚明光群益98購01,,,,,0.00,0.00,0,0,0,0,0,0,0,0,0,0,0,0,0
20200312,05427P,聯發科凱基96售07,2.44,3.29,2.44,3.24,+1.12,52.83,188000,18,536520,0,0,0,0,0,0,158000,95000,63000,63000
20200312,054280,牧德群益98購01,2.54,2.54,1.84,1.84,-1.06,-36.55,124000,6,281800,0,0,0,0,0,0,89000,35000,54000,54000
20200312,054281,世芯群益97購01,1.78,1.80,1.32,1.32,-0.87,-39.73,46000,6,75080,0,0,0,0,0,0,0,46000,-46000,-46000
20200312,054282,泰鼎群益98購02,1.37,1.37,1.01,1.05,-0.34,-24.46,49000,9,55090,0,0,0,0,0,0,24000,25000,-1000,-1000
20200312,054283,元油反元大99購02,,,,,0.00,0.00,0,0,0,0,0,0,0,0,0,0,0,0,0
20200312,054284,和大元大96購03,,,,,0.00,0.00,0,0,0,0,0,0,0,0,0,0,0,0,0
20200312,054285,國巨元大98購02,1.74,1.74,1.17,1.17,-0.69,-37.1,44000,8,62260,0,0,0,0,0,0,14000,30000,-16000,-16000
20200312,054286,台積電元大96購22,,,,,0.00,0.00,0,0,0,0,0,0,0,0,0,0,0,0,0
20200312,054287,台積電元大97購11,,,,,0.00,0.00,0,0,0,0,0,0,0,0,0,0,0,0,0
20200312,054288,華邦電元大96購05,,,,,0.00,0.00,0,0,0,0,0,0,0,0,0,0,0,0,0
20200312,054289,聯發科元大97購11,0.21,0.21,0.21,0.21,0.00,0.00,560000,2,117600,0,0,0,0,0,0,560000,0,560000,560000
20200312,05428P,滬深2X統一95售01,,,,,0.00,0.00,0,0,0,0,0,0,0,0,0,0,0,0,0
20200312,054290,奇力新元大96購05,0.42,0.42,0.28,0.28,-0.34,-54.84,71000,4,25540,0,0,0,0,0,0,61000,10000,51000,51000
20200312,054291,高鐵元大97購01,,,,,0.00,0.00,0,0,0,0,0,0,0,0,0,0,0,0,0
20200312,054292,欣興元大96購06,0.81,0.81,0.53,0.53,-0.46,-46.46,367000,16,232230,0,0,0,0,0,0,60000,317000,-257000,-257000
20200312,054293,健策元大98購02,1.34,1.34,1.08,1.08,-0.82,-43.16,230000,4,301230,0,0,0,0,0,0,7000,223000,-216000,-216000
20200312,054294,世芯元大96購02,1.33,1.34,0.88,0.88,-0.61,-40.94,296000,31,289960,0,0,0,0,0,0,76000,230000,-154000,-154000
20200312,054295,世芯元大96購03,1.24,1.29,0.82,0.83,-0.45,-35.16,665000,68,687080,0,0,0,0,0,0,165000,505000,-340000,-340000
20200312,054296,世芯元大97購01,1.70,1.70,1.08,1.08,-1.23,-53.25,44000,6,58650,0,0,0,0,0,0,12000,44000,-32000,-32000
20200312,054297,台郡元大98購01,1.61,1.62,1.27,1.27,-1.04,-45.02,126000,15,184670,0,0,0,0,0,0,0,126000,-126000,-126000
20200312,054298,台表科元大97購03,0.73,0.73,0.65,0.65,-0.23,-26.14,100000,6,67700,0,0,0,0,0,0,100000,0,100000,100000
20200312,054299,南電元大96購03,2.50,2.50,1.96,1.99,-1.35,-40.42,70000,7,147800,0,0,0,0,0,0,50000,70000,-20000,-20000
20200312,05429P,鴻海統一95售16,4.90,4.93,4.90,4.93,+0.49,11.04,35000,2,172250,0,0,0,0,0,0,35000,25000,10000,10000
20200312,054300,華通凱基96購07,0.92,0.92,0.54,0.54,-0.61,-53.04,317000,25,241180,0,0,0,0,0,0,229000,20000,209000,209000
20200312,054301,楠梓電凱基98購01,0.74,0.75,0.63,0.63,-0.19,-23.17,378000,29,272780,0,0,0,0,0,0,330000,58000,272000,272000
20200312,054302,鴻海凱基96購18,,,,,0.00,0.00,0,0,0,0,0,0,0,0,0,0,0,0,0
20200312,054303,國巨凱基96購15,0.96,0.96,0.43,0.43,-0.57,-57.0,508000,37,365830,0,0,0,0,0,0,274000,231000,43000,43000
20200312,054304,台積電凱基96購23,0.24,0.24,0.24,0.24,-0.09,-27.27,10000,1,2400,0,0,0,0,0,0,0,10000,-10000,-10000
20200312,054305,光磊凱基98購01,,,,,0.00,0.00,0,0,0,0,0,0,0,0,0,0,0,0,0
20200312,054306,聯發科凱基96購23,,,,,0.00,0.00,0,0,0,0,0,0,0,0,0,0,0,0,0
20200312,054307,高鐵凱基98購01,,,,,0.00,0.00,0,0,0,0,0,0,0,0,0,0,0,0,0
20200312,054308,嘉晶凱基98購01,1.25,1.45,1.04,1.05,-0.28,-21.05,387000,30,473840,0,0,0,0,0,0,217000,170000,47000,47000
20200312,054309,禾伸堂凱基98購01,,,,,0.00,0.00,0,0,0,0,0,0,0,0,0,0,0,0,0
20200312,05430P,台積電統一95售07,1.63,1.80,1.63,1.80,+0.61,51.26,433000,21,734760,0,0,0,0,0,0,432000,1000,431000,431000
20200312,054310,牧德凱基98購01,1.50,1.50,1.17,1.17,-0.93,-44.29,52000,4,66360,0,0,0,0,0,0,19000,33000,-14000,-14000
20200312,054311,世芯凱基96購02,0.85,0.90,0.85,0.90,-0.05,-5.26,16000,2,13900,0,0,0,0,0,0,0,16000,-16000,-16000
20200312,054312,TPK凱基98購01,0.39,0.39,0.29,0.29,-0.16,-35.56,75000,23,27330,0,0,0,0,0,0,45000,30000,15000,15000
20200312,054313,麗豐凱基96購02,,,,,0.00,0.00,0,0,0,0,0,0,0,0,0,0,0,0,0
20200312,054314,嘉聯益凱基97購01,,,,,0.00,0.00,0,0,0,0,0,0,0,0,0,0,0,0,0
20200312,054315,訊芯凱基98購01,0.42,0.44,0.33,0.33,-0.22,-40.0,92000,6,35340,0,0,0,0,0,0,72000,20000,52000,52000
20200312,054316,矽創凱基97購01,,,,,0.00,0.00,0,0,0,0,0,0,0,0,0,0,0,0,0
20200312,054317,昇陽半凱基98購01,0.49,0.49,0.36,0.36,-0.33,-47.83,232000,7,111320,0,0,0,0,0,0,0,232000,-232000,-232000
20200312,054318,台虹凱基98購01,1.41,1.41,1.41,1.41,-0.39,-21.67,10000,1,14100,0,0,0,0,0,0,0,10000,-10000,-10000
20200312,054319,世紀鋼凱基96購02,1.38,1.38,1.08,1.29,-0.19,-12.84,202000,16,252330,0,0,0,0,0,0,82000,120000,-38000,-38000
20200312,05431P,台光電統一97售01,0.80,0.96,0.80,0.92,+0.16,21.05,134000,14,118670,0,0,0,0,0,0,54000,49000,5000,5000
20200312,054320,國喬台新96購01,0.20,0.20,0.14,0.17,-0.08,-32.0,463000,33,83680,0,0,0,0,0,0,0,463000,-463000,-463000
20200312,054321,上銀台新96購01,,,,,0.00,0.00,0,0,0,0,0,0,0,0,0,0,0,0,0
20200312,054322,國巨台新96購02,0.73,0.73,0.43,0.43,-0.41,-48.81,290000,8,164900,0,0,0,0,0,0,0,290000,-290000,-290000
20200312,054323,旺宏台新96購02,0.30,0.30,0.19,0.21,-0.19,-47.5,300000,27,84400,0,0,0,0,0,0,240000,60000,180000,180000
20200312,054324,美律台新97購01,,,,,0.00,0.00,0,0,0,0,0,0,0,0,0,0,0,0,0
20200312,054325,奇力新台新97購03,0.38,0.38,0.23,0.24,-0.23,-48.94,679000,12,222680,0,0,0,0,0,0,160000,519000,-359000,-359000
20200312,054326,宏達電台新97購02,0.54,0.54,0.54,0.54,-0.06,-10.0,17000,2,9180,0,0,0,0,0,0,17000,0,17000,17000
20200312,054327,亞光台新96購02,,,,,0.00,0.00,0,0,0,0,0,0,0,0,0,0,0,0,0
20200312,054328,台化康和96購01,,,,,0.00,0.00,0,0,0,0,0,0,0,0,0,0,0,0,0
20200312,054329,華新科永豐96購02,0.25,0.25,0.14,0.14,0.00,0.00,10000,2,1840,0,0,0,0,0,0,0,10000,-10000,-10000
20200312,05432P,國巨元富95售07,0.27,0.32,0.27,0.32,+0.15,88.24,19000,2,5630,0,0,0,0,0,0,19000,0,19000,19000
20200312,054330,世芯永豐96購02,0.42,0.42,0.26,0.26,-0.32,-55.17,4000,2,1200,0,0,0,0,0,0,4000,0,4000,4000
20200312,054331,世芯永豐96購03,0.74,0.79,0.50,0.50,-0.30,-37.5,520000,28,355320,0,0,0,0,0,0,186000,329000,-143000,-143000
20200312,054332,世芯永豐97購01,0.65,0.65,0.42,0.52,-0.18,-25.71,359000,6,178010,0,0,0,0,0,0,241000,118000,123000,123000
20200312,054333,茂林永豐96購03,0.28,0.28,0.18,0.18,-0.13,-41.94,641000,5,141780,0,0,0,0,0,0,396000,245000,151000,151000
20200312,054334,超眾永豐96購04,,,,,0.00,0.00,0,0,0,0,0,0,0,0,0,0,0,0,0
20200312,054335,緯穎永豐96購02,1.21,1.21,0.79,0.79,-0.73,-48.03,121000,3,132790,0,0,0,0,0,0,65000,56000,9000,9000
20200312,054336,台積電統一96購11,0.37,0.37,0.20,0.26,-0.24,-48.0,515000,9,151170,0,0,0,0,0,0,148000,81000,67000,67000
20200312,054337,智邦統一96購01,,,,,0.00,0.00,0,0,0,0,0,0,0,0,0,0,0,0,0
20200312,054338,全新統一96購01,0.18,0.19,0.12,0.12,0.00,0.00,8000,4,1430,0,0,0,0,0,0,2000,6000,-4000,-4000
20200312,054339,聯詠統一96購02,0.49,0.49,0.43,0.43,-0.22,-33.85,196000,7,91000,0,0,0,0,0,0,148000,48000,100000,100000
20200312,05433P,智原元富95售02,2.56,3.11,2.56,3.09,+0.74,31.49,30000,9,83810,0,0,0,0,0,0,20000,10000,10000,10000
20200312,054340,大成鋼元富96購01,0.89,0.90,0.80,0.87,-0.21,-19.44,284000,10,247300,0,0,0,0,0,0,234000,50000,184000,184000
20200312,054341,燿華元富96購03,0.28,0.28,0.27,0.28,-0.17,-37.78,20000,11,5590,0,0,0,0,0,0,20000,0,20000,20000
20200312,054342,亞光元富99購01,,,,,0.00,0.00,0,0,0,0,0,0,0,0,0,0,0,0,0
20200312,054343,世紀鋼元富96購02,1.68,1.68,1.30,1.46,-0.37,-20.22,526000,37,818900,0,0,0,0,0,0,341000,185000,156000,156000
20200312,054344,景碩國票97購04,0.26,0.26,0.19,0.19,-0.21,-52.5,30000,3,6500,0,0,0,0,0,0,0,30000,-30000,-30000
20200312,054345,世芯國票96購02,0.87,0.94,0.72,0.72,-0.25,-25.77,334000,12,298860,0,0,0,0,0,0,104000,230000,-126000,-126000
20200312,054346,世芯國票97購01,,,,,0.00,0.00,0,0,0,0,0,0,0,0,0,0,0,0,0
20200312,054347,上緯控國票96購02,0.36,0.36,0.36,0.36,-0.21,-36.84,65000,1,23400,0,0,0,0,0,0,0,65000,-65000,-65000
20200312,054348,康控國票97購03,0.11,0.11,0.11,0.11,-0.22,-66.67,50000,2,5500,0,0,0,0,0,0,40000,0,40000,40000
20200312,054349,同欣電國票97購02,0.66,0.66,0.45,0.47,-0.46,-49.46,36000,5,21050,0,0,0,0,0,0,15000,21000,-6000,-6000
20200312,05434P,世紀鋼元富95售02,0.51,0.61,0.50,0.55,+0.05,10.0,635000,17,350440,0,0,0,0,0,0,203000,432000,-229000,-229000
20200312,054350,美律國泰98購01,0.30,0.30,0.30,0.30,0.00,0.00,98000,1,29400,0,0,0,0,0,0,0,98000,-98000,-98000
20200312,054351,華新科國泰97購03,1.55,1.55,1.33,1.33,-0.30,-18.4,76000,3,114520,0,0,0,0,0,0,76000,16000,60000,60000
20200312,054352,世芯國泰98購01,4.09,4.42,2.98,2.98,-1.69,-36.19,165000,20,668000,0,0,0,0,0,0,12000,165000,-153000,-153000
20200312,054353,世紀鋼國泰98購01,2.29,2.45,2.17,2.30,-0.33,-12.55,199000,9,448540,0,0,0,0,0,0,169000,30000,139000,139000
20200312,054354,技嘉富邦97購01,0.68,0.68,0.64,0.65,-0.12,-15.58,200000,12,131300,0,0,0,0,0,0,200000,0,200000,200000
20200312,054355,上海銀富邦98購01,0.10,0.10,0.10,0.10,-0.02,-16.67,3000,1,300,0,0,0,0,0,0,0,3000,-3000,-3000
20200312,054356,可成兆豐97購01,0.69,0.71,0.56,0.56,-0.57,-50.44,63000,6,40060,0,0,0,0,0,0,15000,63000,-48000,-48000
20200312,054357,可成兆豐97購02,0.75,0.75,0.75,0.75,-0.19,-20.21,10000,1,7500,0,0,0,0,0,0,10000,0,10000,10000
20200312,054358,矽創兆豐96購01,0.70,0.70,0.70,0.70,-0.10,-12.5,10000,1,7000,0,0,0,0,0,0,10000,0,10000,10000
20200312,054359,南亞科日盛96購02,0.11,0.11,0.11,0.11,0.00,0.00,360000,2,39600,0,0,0,0,0,0,360000,350000,10000,10000
20200312,05435P,鴻海群益95售12,6.45,6.75,6.35,6.75,+1.15,20.54,213000,7,1375250,0,0,0,0,0,0,25000,213000,-188000,-188000
20200312,054360,智邦凱基96購03,1.92,1.92,1.44,1.44,-0.53,-26.9,47000,4,83680,0,0,0,0,0,0,47000,14000,33000,33000
20200312,054361,技嘉凱基96購01,0.58,0.58,0.43,0.50,-0.20,-28.57,530000,32,259580,0,0,0,0,0,0,363000,167000,196000,196000
20200312,054362,亞光凱基96購03,,,,,0.00,0.00,0,0,0,0,0,0,0,0,0,0,0,0,0
20200312,054363,世芯凱基97購01,2.28,2.28,1.53,1.53,-1.07,-41.15,72000,6,138060,0,0,0,0,0,0,61000,39000,22000,22000
20200312,054364,智伸科凱基96購01,0.29,0.29,0.29,0.29,-0.26,-47.27,5000,1,1450,0,0,0,0,0,0,0,5000,-5000,-5000
20200312,054365,遠東新中信96購01,,,,,0.00,0.00,0,0,0,0,0,0,0,0,0,0,0,0,0
20200312,054366,和大中信98購01,0.25,0.25,0.21,0.21,-0.22,-51.16,400000,10,99600,0,0,0,0,0,0,10000,340000,-330000,-330000
20200312,054367,鴻海中信98購03,0.07,0.07,0.06,0.06,-0.06,-50.0,102000,16,6390,0,0,0,0,0,0,0,102000,-102000,-102000
20200312,054368,鴻海中信9A購02,0.11,0.12,0.08,0.08,-0.07,-46.67,75000,6,7970,0,0,0,0,0,0,0,75000,-75000,-75000
20200312,054369,鴻海中信9C購01,0.11,0.11,0.07,0.07,-0.07,-50.0,2971000,261,267470,0,0,0,0,0,0,0,2798000,-2798000,-2798000
20200312,05436P,台積電群益95售07,1.60,2.26,1.60,1.91,+0.56,41.48,132000,14,250700,0,0,0,0,0,0,105000,77000,28000,28000
20200312,054370,台積電中信9A購01,0.56,0.57,0.42,0.50,-0.17,-25.37,162000,20,79460,0,0,0,0,0,0,35000,127000,-92000,-92000
20200312,054371,台積電中信9C購01,0.52,0.52,0.37,0.45,-0.13,-22.41,1576000,82,668310,0,0,0,0,0,0,235000,1320000,-1085000,-1085000
20200312,054372,南亞科中信96購01,0.08,0.08,0.08,0.08,0.00,0.00,5000,1,400,0,0,0,0,0,0,0,5000,-5000,-5000
20200312,054373,富邦金中信97購01,0.11,0.11,0.11,0.11,0.00,0.00,10000,1,1100,0,0,0,0,0,0,10000,0,10000,10000
20200312,054374,信邦中信96購01,0.39,0.39,0.33,0.33,-0.17,-34.0,360000,11,134640,0,0,0,0,0,0,340000,20000,320000,320000
20200312,054375,貿聯中信99購01,0.32,0.32,0.31,0.31,0.00,0.00,16000,2,5040,0,0,0,0,0,0,0,16000,-16000,-16000
20200312,054376,聯茂中信97購01,1.07,1.07,0.68,0.68,-0.47,-40.87,298000,10,271500,0,0,0,0,0,0,120000,178000,-58000,-58000
20200312,054377,臺股指中信99購09,0.16,0.19,0.11,0.19,-0.01,-5.0,3298000,133,456760,0,0,0,0,0,0,50000,2304000,-2254000,-2254000
20200312,054378,楠梓電群益98購01,0.84,0.84,0.58,0.58,-0.48,-45.28,409000,29,300650,0,0,0,0,0,0,342000,67000,275000,275000
20200312,054379,光磊群益98購01,0.20,0.20,0.20,0.20,0.00,0.00,40000,1,8000,0,0,0,0,0,0,40000,0,40000,40000
20200312,05437P,聯詠永豐95售02,1.19,1.39,1.16,1.21,0.00,0.00,83000,12,103360,0,0,0,0,0,0,20000,83000,-63000,-63000
20200312,054380,世芯群益97購02,2.11,2.17,1.50,1.52,-0.75,-33.04,137000,20,264790,0,0,0,0,0,0,34000,99000,-65000,-65000
20200312,054381,世芯群益98購01,,,,,0.00,0.00,0,0,0,0,0,0,0,0,0,0,0,0,0
20200312,054382,康控群益96購03,0.25,0.25,0.18,0.18,-0.21,-53.85,48000,5,10710,0,0,0,0,0,0,21000,27000,-6000,-6000
20200312,054383,傳奇群益97購01,0.38,0.40,0.26,0.26,-0.20,-43.48,303000,7,98640,0,0,0,0,0,0,0,303000,-303000,-303000
20200312,054384,瀚宇博群益96購02,,,,,0.00,0.00,0,0,0,0,0,0,0,0,0,0,0,0,0
20200312,054385,矽創群益98購01,1.09,1.09,0.87,0.87,-0.28,-24.35,21000,5,21390,0,0,0,0,0,0,14000,7000,7000,7000
20200312,054386,鴻海統一98購03,0.19,0.19,0.14,0.14,-0.14,-50.0,109000,7,16870,0,0,0,0,0,0,20000,89000,-69000,-69000
20200312,054387,台積電統一98購02,0.44,0.44,0.31,0.39,-0.20,-33.9,88000,5,33180,0,0,0,0,0,0,0,88000,-88000,-88000
20200312,054388,漢唐統一97購02,,,,,0.00,0.00,0,0,0,0,0,0,0,0,0,0,0,0,0
20200312,054389,為升元富96購02,0.10,0.10,0.07,0.07,-0.09,-56.25,330000,6,25800,0,0,0,0,0,0,0,330000,-330000,-330000
20200312,05438P,康控永豐95售05,,,,,0.00,0.00,0,0,0,0,0,0,0,0,0,0,0,0,0
20200312,054390,智邦元富96購03,1.08,1.14,1.04,1.08,-0.49,-31.21,179000,5,199580,0,0,0,0,0,0,139000,40000,99000,99000
20200312,054391,宏達電元富96購04,,,,,0.00,0.00,0,0,0,0,0,0,0,0,0,0,0,0,0
20200312,054392,華通永豐96購05,,,,,0.00,0.00,0,0,0,0,0,0,0,0,0,0,0,0,0
20200312,054393,漢唐永豐96購01,,,,,0.00,0.00,0,0,0,0,0,0,0,0,0,0,0,0,0
20200312,054394,奇力新永豐96購03,,,,,0.00,0.00,0,0,0,0,0,0,0,0,0,0,0,0,0
20200312,054395,華新科永豐96購03,0.10,0.10,0.06,0.08,-0.07,-46.67,1050000,11,82300,0,0,0,0,0,0,725000,295000,430000,430000
20200312,054396,日電貿永豐96購02,,,,,0.00,0.00,0,0,0,0,0,0,0,0,0,0,0,0,0
20200312,054397,創意永豐96購05,0.10,0.10,0.05,0.05,-0.12,-70.59,150000,2,10000,0,0,0,0,0,0,100000,50000,50000,50000
20200312,054398,牧德永豐96購03,0.32,0.32,0.29,0.29,-0.38,-56.72,206000,5,64450,0,0,0,0,0,0,59000,147000,-88000,-88000
20200312,054399,智易永豐96購03,,,,,0.00,0.00,0,0,0,0,0,0,0,0,0,0,0,0,0
20200312,05439P,聯發科國票95售06,3.31,4.40,3.30,4.40,+1.44,48.65,135000,6,460290,0,0,0,0,0,0,113000,22000,91000,91000
20200312,054400,健策永豐96購02,0.07,0.07,0.04,0.06,-0.04,-40.0,412000,31,21120,0,0,0,0,0,0,100000,262000,-162000,-162000
20200312,054401,康普永豐96購01,,,,,0.00,0.00,0,0,0,0,0,0,0,0,0,0,0,0,0
20200312,054402,康控永豐96購03,,,,,0.00,0.00,0,0,0,0,0,0,0,0,0,0,0,0,0
20200312,054403,同欣電永豐96購02,,,,,0.00,0.00,0,0,0,0,0,0,0,0,0,0,0,0,0
20200312,054404,新日興康和96購01,0.74,0.74,0.53,0.53,-0.37,-41.11,284000,8,187240,0,0,0,0,0,0,136000,148000,-12000,-12000
20200312,054405,樺漢康和96購01,,,,,0.00,0.00,0,0,0,0,0,0,0,0,0,0,0,0,0
20200312,054406,旺宏國票98購01,0.60,0.60,0.50,0.50,0.00,0.00,10000,2,5500,0,0,0,0,0,0,0,10000,-10000,-10000
20200312,054407,美律國票97購02,0.06,0.06,0.06,0.06,0.00,0.00,20000,1,1200,0,0,0,0,0,0,20000,0,20000,20000
20200312,054408,義隆國票98購01,,,,,0.00,0.00,0,0,0,0,0,0,0,0,0,0,0,0,0
20200312,054409,亞光國票97購02,,,,,0.00,0.00,0,0,0,0,0,0,0,0,0,0,0,0,0
20200312,05440P,緯穎國票96售02,0.38,0.44,0.38,0.44,+0.15,51.72,240000,3,97790,0,0,0,0,0,0,129000,111000,18000,18000
20200312,054410,國巨元大96購14,1.58,1.58,0.91,0.91,-0.74,-44.85,290000,23,406540,0,0,0,0,0,0,101000,204000,-103000,-103000
20200312,054411,光磊元大97購02,,,,,0.00,0.00,0,0,0,0,0,0,0,0,0,0,0,0,0
20200312,054412,智邦元大96購03,2.07,2.07,1.62,1.67,-0.55,-24.77,150000,8,256670,0,0,0,0,0,0,50000,120000,-70000,-70000
20200312,054413,台光電元大96購03,1.65,1.65,1.09,1.10,-0.71,-39.23,140000,7,214540,0,0,0,0,0,0,60000,80000,-20000,-20000
20200312,054414,全新元大97購02,0.25,0.25,0.25,0.25,0.00,0.00,400000,1,100000,0,0,0,0,0,0,400000,0,400000,400000
20200312,054415,奇力新元大96購06,0.19,0.19,0.11,0.11,-0.14,-56.0,149000,13,18370,0,0,0,0,0,0,40000,100000,-60000,-60000
20200312,054416,禾伸堂元大97購01,1.06,1.07,0.92,0.92,-0.11,-10.68,48000,4,48140,0,0,0,0,0,0,28000,41000,-13000,-13000
20200312,054417,牧德元大96購01,1.48,1.48,1.35,1.35,-1.04,-43.51,32000,3,45270,0,0,0,0,0,0,0,32000,-32000,-32000
20200312,054418,茂林元大97購01,1.54,1.54,1.15,1.15,-0.54,-31.95,110000,6,162690,0,0,0,0,0,0,27000,110000,-83000,-83000
20200312,054419,嘉聯益元大98購02,1.22,1.22,0.97,0.97,-0.40,-29.2,97000,3,102090,0,0,0,0,0,0,47000,50000,-3000,-3000
20200312,05441P,華通元大95售09,,,,,0.00,0.00,0,0,0,0,0,0,0,0,0,0,0,0,0
20200312,054420,緯穎元大96購08,3.02,3.02,1.98,1.98,-1.42,-41.76,63000,7,163200,0,0,0,0,0,0,59000,63000,-4000,-4000
20200312,054421,臺股指元大99購03,0.65,0.65,0.60,0.61,-0.21,-25.61,156000,9,95870,0,0,0,0,0,0,4000,152000,-148000,-148000
20200312,054422,T50反1富邦9A購01,,,,,0.00,0.00,0,0,0,0,0,0,0,0,0,0,0,0,0
20200312,054423,華新富邦96購01,,,,,0.00,0.00,0,0,0,0,0,0,0,0,0,0,0,0,0
20200312,054424,大成鋼富邦97購02,0.28,0.28,0.26,0.27,-0.03,-10.0,510000,4,134700,0,0,0,0,0,0,400000,110000,290000,290000
20200312,054425,聯發科富邦99購03,0.20,0.20,0.14,0.15,-0.11,-42.31,2749000,37,455900,0,0,0,0,0,0,1107000,2423000,-1316000,-1316000
20200312,054426,國泰金富邦97購02,0.40,0.41,0.36,0.36,-0.10,-21.74,869000,13,330510,0,0,0,0,0,0,449000,420000,29000,29000
20200312,054427,潤泰全富邦97購01,0.69,0.70,0.59,0.61,-0.11,-15.28,1150000,34,738820,0,0,0,0,0,0,96000,1034000,-938000,-938000
20200312,054428,禾伸堂富邦98購01,0.31,0.31,0.26,0.29,0.00,0.00,183000,8,54830,0,0,0,0,0,0,113000,70000,43000,43000
20200312,054429,中石化台新97購01,0.06,0.06,0.06,0.06,0.00,0.00,20000,1,1200,0,0,0,0,0,0,0,20000,-20000,-20000
20200312,05442P,鴻海元大96售13,4.78,5.90,4.74,5.80,+1.47,33.95,234000,14,1256600,0,0,0,0,0,0,144000,124000,20000,20000
20200312,054430,上銀台新96購02,0.85,0.85,0.79,0.79,-0.25,-24.04,119000,11,96530,0,0,0,0,0,0,119000,0,119000,119000
20200312,054431,鴻海台新96購03,,,,,0.00,0.00,0,0,0,0,0,0,0,0,0,0,0,0,0
20200312,054432,台積電台新96購05,0.19,0.19,0.13,0.14,-0.12,-46.15,52000,5,8220,0,0,0,0,0,0,10000,42000,-32000,-32000
20200312,054433,南亞科台新96購02,,,,,0.00,0.00,0,0,0,0,0,0,0,0,0,0,0,0,0
20200312,054434,友達台新96購03,,,,,0.00,0.00,0,0,0,0,0,0,0,0,0,0,0,0,0
20200312,054435,華新科台新97購02,0.48,0.48,0.48,0.48,-0.48,-50.0,2000,1,960,0,0,0,0,0,0,2000,0,2000,2000
20200312,054436,高鐵台新97購02,0.18,0.18,0.18,0.18,-0.13,-41.94,40000,1,7200,0,0,0,0,0,0,40000,0,40000,40000
20200312,054437,欣興台新97購02,0.47,0.47,0.33,0.33,-0.35,-51.47,308000,4,102340,0,0,0,0,0,0,298000,10000,288000,288000
20200312,054438,群創台新96購01,,,,,0.00,0.00,0,0,0,0,0,0,0,0,0,0,0,0,0
20200312,054439,健策台新96購03,,,,,0.00,0.00,0,0,0,0,0,0,0,0,0,0,0,0,0
20200312,05443P,宏達電元大95售05,0.79,1.09,0.79,1.09,+0.30,37.97,129000,5,121310,0,0,0,0,0,0,0,128000,-128000,-128000
20200312,054440,TPK台新98購01,,,,,0.00,0.00,0,0,0,0,0,0,0,0,0,0,0,0,0
20200312,054441,力成台新96購01,,,,,0.00,0.00,0,0,0,0,0,0,0,0,0,0,0,0,0
20200312,054442,啟碁台新96購01,,,,,0.00,0.00,0,0,0,0,0,0,0,0,0,0,0,0,0
20200312,054443,樺漢台新96購02,,,,,0.00,0.00,0,0,0,0,0,0,0,0,0,0,0,0,0
20200312,054444,緯穎台新97購01,2.40,2.40,2.40,2.40,-0.35,-12.73,6000,1,14400,0,0,0,0,0,0,6000,0,6000,6000
20200312,054445,技嘉兆豐96購01,1.22,1.22,1.22,1.22,0.00,0.00,12000,1,14640,0,0,0,0,0,0,12000,12000,0,0
20200312,054446,美食兆豐97購01,0.26,0.26,0.24,0.24,-0.10,-29.41,190000,2,48400,0,0,0,0,0,0,0,190000,-190000,-190000
20200312,054447,國泰金兆豐96購01,0.28,0.28,0.28,0.28,-0.12,-30.0,10000,1,2800,0,0,0,0,0,0,0,10000,-10000,-10000
20200312,054448,矽力兆豐96購01,2.92,2.92,2.92,2.92,-0.84,-22.34,10000,1,29200,0,0,0,0,0,0,10000,0,10000,10000
20200312,054449,中環第一96購01,,,,,0.00,0.00,0,0,0,0,0,0,0,0,0,0,0,0,0
20200312,05444P,大立光元大95售10,0.78,0.95,0.78,0.95,+0.36,61.02,1361000,19,1173180,0,0,0,0,0,0,1040000,272000,768000,768000
20200312,054450,聯茂第一96購01,0.62,0.62,0.47,0.50,-0.29,-36.71,70000,3,37700,10000,0,10000,0,0,0,0,70000,-70000,-60000
20200312,054451,上銀亞東98購01,,,,,0.00,0.00,0,0,0,0,0,0,0,0,0,0,0,0,0
20200312,054452,華通亞東96購01,,,,,0.00,0.00,0,0,0,0,0,0,0,0,0,0,0,0,0
20200312,054453,上海銀亞東96購01,,,,,0.00,0.00,0,0,0,0,0,0,0,0,0,0,0,0,0
20200312,054454,滬深2X群益96購04,0.16,0.20,0.16,0.18,-0.08,-30.77,220000,22,37800,0,0,0,0,0,0,0,220000,-220000,-220000
20200312,054455,楠梓電群益98購02,0.54,0.54,0.54,0.54,-0.18,-25.0,30000,1,16200,0,0,0,0,0,0,30000,0,30000,30000
20200312,054456,華泰群益99購01,,,,,0.00,0.00,0,0,0,0,0,0,0,0,0,0,0,0,0
20200312,054457,強茂群益96購01,0.72,0.72,0.66,0.66,-0.19,-22.35,190000,4,129100,0,0,0,0,0,0,145000,45000,100000,100000
20200312,054458,復盛群益96購01,1.31,1.31,1.00,1.03,-0.61,-37.2,97000,11,107500,0,0,0,0,0,0,55000,42000,13000,13000
20200312,054459,鈺齊群益96購01,0.24,0.24,0.24,0.24,-0.06,-20.0,12000,1,2880,0,0,0,0,0,0,12000,0,12000,12000
20200312,05445P,聯詠元大95售05,3.44,3.96,3.44,3.96,0.00,0.00,207000,7,767120,0,0,0,0,0,0,0,207000,-207000,-207000
20200312,054460,和大凱基97購01,0.29,0.29,0.29,0.29,-0.12,-29.27,33000,1,9570,0,0,0,0,0,0,33000,0,33000,33000
20200312,054461,台積電凱基97購09,0.42,0.49,0.42,0.49,-0.09,-15.52,455000,31,200850,0,0,0,0,0,0,30000,260000,-230000,-230000
20200312,054462,旺宏凱基96購08,0.43,0.43,0.26,0.30,-0.20,-40.0,263000,23,90940,0,0,0,0,0,0,88000,175000,-87000,-87000
20200312,054463,瑞昱凱基97購01,,,,,0.00,0.00,0,0,0,0,0,0,0,0,0,0,0,0,0
20200312,054464,奇力新凱基98購02,0.11,0.11,0.07,0.10,-0.03,-23.08,323000,17,30960,0,0,0,0,0,0,206000,115000,91000,91000
20200312,054465,亞光凱基97購01,0.06,0.10,0.05,0.10,0.00,0.00,150000,5,7800,0,0,0,0,0,0,0,5000,-5000,-5000
20200312,054466,欣興凱基97購03,,,,,0.00,0.00,0,0,0,0,0,0,0,0,0,0,0,0,0
20200312,054467,隆達凱基97購01,0.13,0.13,0.12,0.12,0.00,0.00,150000,3,18500,0,0,0,0,0,0,0,150000,-150000,-150000
20200312,054468,台郡凱基98購01,,,,,0.00,0.00,0,0,0,0,0,0,0,0,0,0,0,0,0
20200312,054469,同欣電凱基97購01,0.13,0.13,0.10,0.10,-0.16,-61.54,84000,6,9360,0,0,0,0,0,0,0,84000,-84000,-84000
20200312,05446P,緯穎元大95售04,,,,,0.00,0.00,0,0,0,0,0,0,0,0,0,0,0,0,0
20200312,054470,緯穎國票97購04,4.74,4.74,2.94,3.40,-2.20,-39.29,67000,10,246430,0,0,0,0,0,0,28000,39000,-11000,-11000
20200312,054471,T50反1中信9C購01,2.52,2.78,2.52,2.78,+0.53,23.56,40000,5,101500,0,0,0,0,0,0,40000,0,40000,40000
20200312,054472,道瓊反中信9A購01,,,,,0.00,0.00,0,0,0,0,0,0,0,0,0,0,0,0,0
20200312,054473,鴻海中信96購02,0.24,0.24,0.16,0.16,-0.17,-51.52,500000,29,100800,0,0,0,0,0,0,0,500000,-500000,-500000
20200312,054474,鴻海中信96購03,,,,,0.00,0.00,0,0,0,0,0,0,0,0,0,0,0,0,0
20200312,054475,鴻海中信96購04,0.21,0.21,0.18,0.18,0.00,0.00,80000,2,15300,0,0,0,0,0,0,0,80000,-80000,-80000
20200312,054476,聯發科中信96購03,,,,,0.00,0.00,0,0,0,0,0,0,0,0,0,0,0,0,0
20200312,054477,聯發科中信9C購02,0.14,0.14,0.10,0.10,-0.08,-44.44,425000,23,46840,0,0,0,0,0,0,5000,420000,-415000,-415000
20200312,054478,可成中信97購01,0.20,0.20,0.12,0.12,0.00,0.00,22000,3,3740,0,0,0,0,0,0,0,22000,-22000,-22000
20200312,054479,緯創中信98購01,,,,,0.00,0.00,0,0,0,0,0,0,0,0,0,0,0,0,0
20200312,05447P,臺股指元大95售24,3.87,4.10,3.87,4.10,+0.70,20.59,14000,2,55100,0,0,0,0,0,0,4000,10000,-6000,-6000
20200312,054480,和碩中信98購01,0.15,0.15,0.12,0.12,-0.09,-42.86,95000,4,12700,0,0,0,0,0,0,85000,10000,75000,75000
20200312,054481,鎧勝中信96購01,0.33,0.33,0.30,0.30,-0.17,-36.17,18000,2,5640,0,0,0,0,0,0,8000,10000,-2000,-2000
20200312,054482,大成鋼台新96購01,,,,,0.00,0.00,0,0,0,0,0,0,0,0,0,0,0,0,0
20200312,054483,聯電台新96購01,,,,,0.00,0.00,0,0,0,0,0,0,0,0,0,0,0,0,0
20200312,054484,仁寶台新96購01,0.36,0.36,0.30,0.30,-0.11,-26.83,58000,6,19060,0,0,0,0,0,0,58000,0,58000,58000
20200312,054485,華邦電台新96購01,,,,,0.00,0.00,0,0,0,0,0,0,0,0,0,0,0,0,0
20200312,054486,漢唐台新96購01,0.22,0.22,0.19,0.19,0.00,0.00,110000,2,21200,0,0,0,0,0,0,110000,10000,100000,100000
20200312,054487,京元電台新97購01,0.35,0.35,0.32,0.32,-0.21,-39.62,232000,6,78540,0,0,0,0,0,0,20000,189000,-169000,-169000
20200312,054488,禾伸堂台新96購01,,,,,0.00,0.00,0,0,0,0,0,0,0,0,0,0,0,0,0
20200312,054489,牧德台新97購02,0.77,0.77,0.71,0.71,0.00,0.00,110000,7,80700,0,0,0,0,0,0,0,110000,-110000,-110000
20200312,05448P,臺股指元大95售25,,,,,0.00,0.00,0,0,0,0,0,0,0,0,0,0,0,0,0
20200312,054490,臻鼎台新96購02,,,,,0.00,0.00,0,0,0,0,0,0,0,0,0,0,0,0,0
20200312,054491,瀚宇博台新96購02,,,,,0.00,0.00,0,0,0,0,0,0,0,0,0,0,0,0,0
20200312,054492,嘉聯益台新96購01,,,,,0.00,0.00,0,0,0,0,0,0,0,0,0,0,0,0,0
20200312,054493,同欣電台新96購01,0.16,0.16,0.15,0.15,-0.11,-42.31,20000,2,3100,0,0,0,0,0,0,20000,0,20000,20000
20200312,054494,訊芯台新96購01,,,,,0.00,0.00,0,0,0,0,0,0,0,0,0,0,0,0,0
20200312,054495,滬深2X永豐97購02,0.50,0.50,0.50,0.50,0.00,0.00,6000,1,3000,0,0,0,0,0,0,0,6000,-6000,-6000
20200312,054496,為升永豐96購01,0.01,0.01,0.01,0.01,0.00,0.00,100000,11,1000,0,0,0,0,0,0,0,100000,-100000,-100000
20200312,054497,國巨永豐96購05,0.22,0.22,0.10,0.10,-0.14,-58.33,1175000,37,163310,0,0,0,0,0,0,523000,550000,-27000,-27000
20200312,054498,燿華永豐96購06,,,,,0.00,0.00,0,0,0,0,0,0,0,0,0,0,0,0,0
20200312,054499,台光電永豐96購02,,,,,0.00,0.00,0,0,0,0,0,0,0,0,0,0,0,0,0
20200312,05449P,臺股指元大95售26,,,,,0.00,0.00,0,0,0,0,0,0,0,0,0,0,0,0,0
20200312,054500,美律永豐96購02,,,,,0.00,0.00,0,0,0,0,0,0,0,0,0,0,0,0,0
20200312,054501,強茂永豐96購02,,,,,0.00,0.00,0,0,0,0,0,0,0,0,0,0,0,0,0
20200312,054502,泰碩永豐96購01,0.29,0.29,0.26,0.27,-0.11,-28.95,174000,4,47920,0,0,0,0,0,0,62000,112000,-50000,-50000
20200312,054503,京鼎永豐96購04,,,,,0.00,0.00,0,0,0,0,0,0,0,0,0,0,0,0,0
20200312,054504,聯鈞永豐96購01,1.55,1.55,1.03,1.25,-0.59,-32.07,53000,5,68710,0,0,0,0,0,0,33000,20000,13000,13000
20200312,054505,揚明光永豐97購02,,,,,0.00,0.00,0,0,0,0,0,0,0,0,0,0,0,0,0
20200312,054506,矽格永豐96購01,0.39,0.39,0.30,0.32,-0.21,-39.62,392000,10,136540,0,0,0,0,0,0,322000,70000,252000,252000
20200312,054507,鈺齊永豐96購01,,,,,0.00,0.00,0,0,0,0,0,0,0,0,0,0,0,0,0
20200312,054508,臺股指永豐96購04,,,,,0.00,0.00,0,0,0,0,0,0,0,0,0,0,0,0,0
20200312,054509,上証反元大99購01,0.60,0.66,0.60,0.63,+0.07,12.5,1857000,23,1151710,0,0,0,0,0,0,233000,1624000,-1391000,-1391000
20200312,05450P,臺股指元大95售27,3.77,5.50,3.74,5.10,+1.60,45.71,1160000,24,5270560,0,0,0,0,0,0,1160000,0,1160000,1160000
20200312,054510,S&P反1元大98購01,2.30,2.30,2.30,2.30,+0.35,17.95,10000,1,23000,0,0,0,0,0,0,10000,10000,0,0
20200312,054511,香港反元大98購01,1.50,1.50,1.50,1.50,+0.25,20.0,1000,1,1500,0,0,0,0,0,0,0,1000,-1000,-1000
20200312,054512,元油反元大99購03,,,,,0.00,0.00,0,0,0,0,0,0,0,0,0,0,0,0,0
20200312,054513,元金2X元大96購01,,,,,0.00,0.00,0,0,0,0,0,0,0,0,0,0,0,0,0
20200312,054514,道瓊銀元大98購01,0.64,0.65,0.64,0.65,-0.15,-18.75,60000,2,38900,0,0,0,0,0,0,10000,50000,-40000,-40000
20200312,054515,華通元大98購02,1.07,1.10,0.67,0.67,-0.87,-56.49,211000,16,174240,0,0,0,0,0,0,110000,140000,-30000,-30000
20200312,054516,國巨元大97購02,0.88,0.88,0.57,0.59,-0.39,-39.8,130000,18,89230,0,0,0,0,0,0,20000,105000,-85000,-85000
20200312,054517,高鐵元大96購01,0.33,0.33,0.32,0.32,-0.15,-31.91,56000,2,18380,0,0,0,0,0,0,56000,0,56000,56000
20200312,054518,亞光元大97購01,0.12,0.12,0.10,0.10,0.00,0.00,248000,5,25000,0,0,0,0,0,0,0,248000,-248000,-248000
20200312,054519,禾伸堂元大97購02,0.67,0.67,0.54,0.62,-0.06,-8.82,160000,10,93750,0,0,0,0,0,0,100000,80000,20000,20000
20200312,05451P,臺股指元大95售28,3.85,5.05,3.85,4.81,+1.53,46.65,1242000,26,6151660,0,0,0,0,0,0,1171000,71000,1100000,1100000
20200312,054520,健鼎元大96購02,,,,,0.00,0.00,0,0,0,0,0,0,0,0,0,0,0,0,0
20200312,054521,TPK元大96購03,,,,,0.00,0.00,0,0,0,0,0,0,0,0,0,0,0,0,0
20200312,054522,康友元大96購07,1.97,1.97,1.48,1.52,-0.54,-26.21,212000,19,361470,0,0,0,0,0,0,121000,122000,-1000,-1000
20200312,054523,GIS元大96購05,,,,,0.00,0.00,0,0,0,0,0,0,0,0,0,0,0,0,0
20200312,054524,華通元富96購03,0.08,0.08,0.04,0.04,-0.07,-63.64,150000,2,8000,0,0,0,0,0,0,0,150000,-150000,-150000
20200312,054525,奇鋐元富96購01,0.30,0.30,0.30,0.30,-0.20,-40.0,14000,1,4200,0,0,0,0,0,0,14000,0,14000,14000
20200312,054526,道瓊反統一98購01,,,,,0.00,0.00,0,0,0,0,0,0,0,0,0,0,0,0,0
20200312,054527,國巨統一97購03,1.31,1.31,0.73,0.73,-0.57,-43.85,176000,5,164920,0,0,0,0,0,0,148000,28000,120000,120000
20200312,054528,台光電統一96購02,0.82,0.82,0.64,0.64,-0.37,-36.63,45000,3,32400,0,0,0,0,0,0,0,45000,-45000,-45000
20200312,054529,T50反1國泰97購02,,,,,0.00,0.00,0,0,0,0,0,0,0,0,0,0,0,0,0
20200312,05452P,亞德客群益95售02,1.44,1.81,1.44,1.66,+0.43,34.96,191000,13,327250,0,0,0,0,0,0,94000,77000,17000,17000
20200312,054530,台光電國泰97購03,0.50,0.50,0.50,0.50,-0.51,-50.5,118000,2,59000,0,0,0,0,0,0,118000,0,118000,118000
20200312,054531,聯發科國泰97購02,,,,,0.00,0.00,0,0,0,0,0,0,0,0,0,0,0,0,0
20200312,054532,強茂國泰98購01,0.59,0.59,0.40,0.40,-0.27,-40.3,384000,7,175150,0,0,0,0,0,0,353000,31000,322000,322000
20200312,054533,泰碩國泰98購01,0.73,0.95,0.63,0.95,+0.13,15.85,25000,5,17200,0,0,0,0,0,0,24000,0,24000,24000
20200312,054534,台積電富邦98購03,0.10,0.10,0.07,0.10,-0.01,-9.09,1141000,31,92760,0,0,0,0,0,0,0,25000,-25000,-25000
20200312,054535,旺宏富邦97購02,0.49,0.51,0.39,0.43,-0.22,-33.85,122000,11,55810,0,0,0,0,0,0,10000,112000,-102000,-102000
20200312,054536,宏達電富邦97購03,,,,,0.00,0.00,0,0,0,0,0,0,0,0,0,0,0,0,0
20200312,054537,南亞科亞東97購01,0.10,0.10,0.06,0.06,-0.15,-71.43,304000,6,21280,0,0,0,0,0,0,200000,304000,-104000,-104000
20200312,054538,台光電國票98購01,0.36,0.36,0.36,0.36,-0.42,-53.85,30000,1,10800,0,0,0,0,0,0,30000,0,30000,30000
20200312,054539,欣興國票98購01,0.20,0.20,0.13,0.13,-0.19,-59.38,116000,12,17140,0,0,0,0,0,0,0,116000,-116000,-116000
20200312,05453P,智邦群益95售03,0.99,1.16,0.99,1.16,+0.27,30.34,30000,3,31600,0,0,0,0,0,0,0,30000,-30000,-30000
20200312,054540,泰鼎國票99購01,1.28,1.28,0.94,0.94,-0.75,-44.38,110000,6,134370,0,0,0,0,0,0,0,110000,-110000,-110000
20200312,054541,康控國票98購01,0.24,0.24,0.18,0.18,-0.27,-60.0,95000,4,17700,0,0,0,0,0,0,60000,35000,25000,25000
20200312,054542,台表科國票98購01,0.39,0.39,0.20,0.20,-0.19,-48.72,431000,20,108380,0,0,0,0,0,0,96000,335000,-239000,-239000
20200312,054543,元金2X中信01購01,1.61,1.61,1.49,1.49,-0.30,-16.76,13000,2,19730,0,0,0,0,0,0,0,13000,-13000,-13000
20200312,054544,統一中信97購01,0.26,0.26,0.22,0.26,-0.09,-25.71,220000,10,49590,0,0,0,0,0,0,20000,200000,-180000,-180000
20200312,054545,奇力新中信98購01,,,,,0.00,0.00,0,0,0,0,0,0,0,0,0,0,0,0,0
20200312,054546,玉晶光中信9B購01,0.31,0.31,0.21,0.22,-0.11,-33.33,1640000,42,390970,0,0,0,0,0,0,635000,953000,-318000,-318000
20200312,054547,鴻海凱基98購02,,,,,0.00,0.00,0,0,0,0,0,0,0,0,0,0,0,0,0
20200312,054548,鴻海凱基98購03,0.28,0.28,0.18,0.19,-0.15,-44.12,254000,9,48820,0,0,0,0,0,0,240000,14000,226000,226000
20200312,054549,台積電凱基98購01,0.36,0.36,0.23,0.33,-0.27,-45.0,574000,17,168280,0,0,0,0,0,0,115000,454000,-339000,-339000
20200312,05454P,奇鋐群益95售04,1.92,2.07,1.87,2.07,+0.28,15.64,143000,8,273150,0,0,0,0,0,0,111000,32000,79000,79000
20200312,054550,旺宏凱基98購02,0.43,0.43,0.43,0.43,-0.18,-29.51,32000,1,13760,0,0,0,0,0,0,32000,0,32000,32000
20200312,054551,聯發科凱基98購02,0.20,0.20,0.18,0.18,-0.17,-48.57,50000,2,9600,0,0,0,0,0,0,0,50000,-50000,-50000
20200312,054552,聯發科凱基98購03,0.10,0.10,0.10,0.10,-0.01,-9.09,120000,11,12000,0,0,0,0,0,0,0,100000,-100000,-100000
20200312,054553,宏達電凱基99購01,0.29,0.29,0.21,0.21,-0.16,-43.24,328000,5,84880,0,0,0,0,0,0,0,328000,-328000,-328000
20200312,054554,大立光凱基98購02,0.95,0.95,0.95,0.95,-0.41,-30.15,1000,1,950,0,0,0,0,0,0,0,1000,-1000,-1000
20200312,054555,欣興凱基98購01,0.59,0.59,0.40,0.41,-0.32,-43.84,35000,3,16100,0,0,0,0,0,0,10000,35000,-25000,-25000
20200312,054556,世芯凱基99購01,0.31,0.32,0.20,0.20,-0.13,-39.39,1982000,104,467050,0,0,0,0,0,0,114000,1857000,-1743000,-1743000
20200312,054557,臻鼎凱基98購01,0.19,0.21,0.19,0.21,-0.38,-64.41,30000,2,5900,0,0,0,0,0,0,0,30000,-30000,-30000
20200312,054558,劍麟群益99購01,0.32,0.32,0.28,0.28,-0.09,-24.32,186000,3,55920,0,0,0,0,0,0,95000,91000,4000,4000
20200312,054559,台光電群益99購01,0.70,0.70,0.63,0.63,-0.22,-25.88,216000,4,148820,0,0,0,0,0,0,98000,118000,-20000,-20000
20200312,05455P,聯詠日盛95售01,1.18,1.29,1.18,1.29,+0.27,26.47,40000,4,49700,0,0,0,0,0,0,0,40000,-40000,-40000
20200312,054560,全新群益98購03,,,,,0.00,0.00,0,0,0,0,0,0,0,0,0,0,0,0,0
20200312,054561,奇力新群益97購03,,,,,0.00,0.00,0,0,0,0,0,0,0,0,0,0,0,0,0
20200312,054562,亞光群益98購01,,,,,0.00,0.00,0,0,0,0,0,0,0,0,0,0,0,0,0
20200312,054563,泰碩群益99購01,1.07,1.07,0.80,0.87,-0.21,-19.44,139000,15,129650,0,0,0,0,0,0,73000,55000,18000,18000
20200312,054564,玉晶光群益99購01,0.99,0.99,0.82,0.84,-0.37,-30.58,23000,4,19970,0,0,0,0,0,0,0,23000,-23000,-23000
20200312,054565,玉晶光群益99購02,1.66,1.66,1.09,1.15,-0.70,-37.84,223000,14,327820,0,0,0,0,0,0,59000,167000,-108000,-108000
20200312,054566,貿聯群益97購02,,,,,0.00,0.00,0,0,0,0,0,0,0,0,0,0,0,0,0
20200312,054567,拓凱群益98購01,0.50,0.50,0.45,0.46,-0.19,-29.23,85000,4,41300,0,0,0,0,0,0,30000,55000,-25000,-25000
20200312,054568,訊芯群益97購01,,,,,0.00,0.00,0,0,0,0,0,0,0,0,0,0,0,0,0
20200312,054569,GIS群益98購01,0.28,0.28,0.21,0.21,-0.21,-50.0,118000,3,31640,0,0,0,0,0,0,98000,20000,78000,78000
20200312,05456P,鴻海凱基95售19,1.50,2.03,1.46,1.92,+0.73,61.34,614000,22,1018240,0,0,0,0,0,0,573000,115000,458000,458000
20200312,054570,易華電群益98購01,0.27,0.27,0.25,0.25,-0.22,-46.81,30000,2,7900,0,0,0,0,0,0,0,30000,-30000,-30000
20200312,054571,楠梓電元大99購01,0.97,0.97,0.73,0.73,-0.28,-27.72,391000,20,345670,0,0,0,0,0,0,182000,209000,-27000,-27000
20200312,054572,國巨元大98購03,1.18,1.18,0.79,0.83,-0.42,-33.6,314000,15,300530,0,0,0,0,0,0,237000,89000,148000,148000
20200312,054573,漢唐元大98購01,0.53,0.54,0.48,0.48,-0.18,-27.27,156000,5,81140,0,0,0,0,0,0,21000,135000,-114000,-114000
20200312,054574,美律元大99購01,0.29,0.29,0.20,0.24,-0.13,-35.14,130000,6,26950,0,0,0,0,0,0,120000,10000,110000,110000
20200312,054575,聯鈞元大97購01,2.05,2.22,1.96,1.96,-1.11,-36.16,49000,4,105630,0,0,0,0,0,0,9000,40000,-31000,-31000
20200312,054576,健策元大98購03,0.49,0.49,0.49,0.49,-0.13,-20.97,70000,1,34300,0,0,0,0,0,0,0,70000,-70000,-70000
20200312,054577,世芯元大98購01,0.77,0.77,0.50,0.55,-0.23,-29.49,214000,10,151760,0,0,0,0,0,0,27000,167000,-140000,-140000
20200312,054578,世芯元大99購01,0.88,0.88,0.63,0.63,-0.26,-29.21,73000,5,57430,0,0,0,0,0,0,27000,46000,-19000,-19000
20200312,054579,聯茂元大97購01,3.85,3.85,3.85,3.85,-0.39,-9.2,10000,1,38500,0,0,0,0,0,0,10000,0,10000,10000
20200312,05457P,鴻海凱基95售20,2.63,3.33,2.63,3.33,+1.13,51.36,30000,6,96510,0,0,0,0,0,0,17000,30000,-13000,-13000
20200312,054580,樺漢元大98購01,0.32,0.32,0.20,0.22,-0.19,-46.34,135000,7,33260,0,0,0,0,0,0,44000,127000,-83000,-83000
20200312,054581,訊芯元大97購02,0.29,0.29,0.28,0.29,-0.11,-27.5,100000,5,28580,0,0,0,0,0,0,100000,0,100000,100000
20200312,054582,致新元大97購01,0.56,0.56,0.48,0.48,-0.16,-25.0,72000,2,34880,0,0,0,0,0,0,4000,68000,-64000,-64000
20200312,054583,玉晶光統一97購02,0.13,0.13,0.12,0.12,-0.11,-47.83,200000,3,24500,0,0,0,0,0,0,100000,100000,0,0
20200312,054584,貿聯元富97購01,0.43,0.43,0.38,0.38,-0.17,-30.91,82000,19,32950,0,0,0,0,0,0,72000,10000,62000,62000
20200312,054585,禾伸堂國泰99購01,,,,,0.00,0.00,0,0,0,0,0,0,0,0,0,0,0,0,0
20200312,054586,健鼎國泰99購01,0.48,0.48,0.35,0.35,-0.18,-33.96,756000,11,319550,0,0,0,0,0,0,580000,176000,404000,404000
20200312,054587,玉晶光國泰99購01,1.27,1.27,1.07,1.07,-0.49,-31.41,50000,3,60500,0,0,0,0,0,0,30000,20000,10000,10000
20200312,054588,玉晶光國泰99購02,0.74,0.74,0.50,0.50,-0.32,-39.02,14000,2,9400,0,0,0,0,0,0,10000,4000,6000,6000
20200312,054589,聯鈞國泰99購01,2.17,2.17,1.62,1.66,-0.66,-28.45,154000,9,258540,0,0,0,0,0,0,50000,154000,-104000,-104000
20200312,05458P,台積電凱基97售02,1.44,1.90,1.44,1.62,+0.31,23.66,1094000,44,1725340,0,0,0,0,0,0,356000,952000,-596000,-596000
20200312,054590,嘉聯益國泰98購01,0.68,0.69,0.51,0.51,-0.38,-42.7,139000,8,82850,0,0,0,0,0,0,86000,139000,-53000,-53000
20200312,054591,GIS國泰98購01,,,,,0.00,0.00,0,0,0,0,0,0,0,0,0,0,0,0,0
20200312,054592,美律永昌9A購01,,,,,0.00,0.00,0,0,0,0,0,0,0,0,0,0,0,0,0
20200312,054593,滬深2X永昌9A購01,1.59,1.62,1.36,1.43,-0.30,-17.34,932000,40,1352510,0,0,0,0,0,0,865000,323000,542000,542000
20200312,054594,國巨麥證97購01,0.85,0.85,0.42,0.42,-0.48,-53.33,528000,58,263330,91000,437000,-346000,0,0,0,91000,437000,-346000,-346000
20200312,054595,正崴麥證97購01,,,,,0.00,0.00,0,0,0,0,0,0,0,0,0,0,0,0,0
20200312,054596,聯發科麥證97購01,,,,,0.00,0.00,0,0,0,0,0,0,0,0,0,0,0,0,0
20200312,054597,南亞台新97購01,,,,,0.00,0.00,0,0,0,0,0,0,0,0,0,0,0,0,0
20200312,054598,鴻海台新98購01,,,,,0.00,0.00,0,0,0,0,0,0,0,0,0,0,0,0,0
20200312,054599,正崴台新97購01,,,,,0.00,0.00,0,0,0,0,0,0,0,0,0,0,0,0,0
20200312,05459P,聯詠凱基95售03,2.46,2.86,2.46,2.52,+0.28,12.5,54000,11,142200,0,0,0,0,0,0,7000,47000,-40000,-40000
20200312,054600,中壽台新97購01,0.05,0.05,0.05,0.05,-0.06,-54.55,690000,10,34500,0,0,0,0,0,0,0,690000,-690000,-690000
20200312,054601,奇鋐台新98購01,,,,,0.00,0.00,0,0,0,0,0,0,0,0,0,0,0,0,0
20200312,054602,聯詠台新97購01,0.12,0.12,0.12,0.12,-0.04,-25.0,300000,2,36000,0,0,0,0,0,0,0,300000,-300000,-300000
20200312,054603,智易台新98購01,0.32,0.32,0.32,0.32,0.00,0.00,70000,1,22400,0,0,0,0,0,0,0,70000,-70000,-70000
20200312,054604,麗豐台新98購01,,,,,0.00,0.00,0,0,0,0,0,0,0,0,0,0,0,0,0
20200312,054605,鴻海永豐97購01,0.06,0.06,0.06,0.06,0.00,0.00,285000,4,17100,0,0,0,0,0,0,120000,165000,-45000,-45000
20200312,054606,台積電永豐97購02,0.04,0.04,0.03,0.04,-0.02,-33.33,115000,12,3900,0,0,0,0,0,0,0,115000,-115000,-115000
20200312,054607,台積電永豐97購03,0.29,0.29,0.23,0.25,-0.10,-28.57,285000,25,74550,0,0,0,0,0,0,55000,220000,-165000,-165000
20200312,054608,致茂永豐97購01,0.24,0.24,0.16,0.16,-0.15,-48.39,313000,24,66950,0,0,0,0,0,0,258000,45000,213000,213000
20200312,054609,正崴永豐97購01,,,,,0.00,0.00,0,0,0,0,0,0,0,0,0,0,0,0,0
20200312,05460P,台郡凱基95售05,0.28,0.33,0.28,0.33,+0.10,43.48,10000,2,3050,0,0,0,0,0,0,10000,0,10000,10000
20200312,054610,聯發科永豐97購01,0.06,0.06,0.06,0.06,0.00,0.00,71000,1,4260,0,0,0,0,0,0,71000,0,71000,71000
20200312,054611,全新永豐97購01,,,,,0.00,0.00,0,0,0,0,0,0,0,0,0,0,0,0,0
20200312,054612,慧洋永豐97購01,,,,,0.00,0.00,0,0,0,0,0,0,0,0,0,0,0,0,0
20200312,054613,大立光永豐97購02,0.25,0.25,0.20,0.20,0.00,0.00,34000,3,8000,0,0,0,0,0,0,0,34000,-34000,-34000
20200312,054614,玉晶光永豐97購03,0.29,0.29,0.17,0.19,-0.17,-47.22,267000,12,52840,0,0,0,0,0,0,135000,132000,3000,3000
20200312,054615,牧德永豐98購01,0.41,0.43,0.29,0.29,-0.31,-51.67,132000,5,52340,0,0,0,0,0,0,112000,20000,92000,92000
20200312,054616,智伸科永豐97購01,,,,,0.00,0.00,0,0,0,0,0,0,0,0,0,0,0,0,0
20200312,054617,超眾永豐97購01,0.08,0.08,0.07,0.07,-0.03,-30.0,10000,2,750,0,0,0,0,0,0,0,10000,-10000,-10000
20200312,054618,訊芯永豐97購01,,,,,0.00,0.00,0,0,0,0,0,0,0,0,0,0,0,0,0
20200312,054619,昇陽半永豐97購03,0.08,0.08,0.06,0.06,-0.08,-57.14,45000,5,3150,0,0,0,0,0,0,0,45000,-45000,-45000
20200312,05461P,台積電亞東97售01,0.95,1.06,0.95,1.02,+0.30,41.67,100000,3,100300,0,0,0,0,0,0,90000,10000,80000,80000
20200312,054620,南茂永豐97購01,0.18,0.18,0.16,0.16,-0.08,-33.33,343000,6,57880,0,0,0,0,0,0,313000,30000,283000,283000
20200312,054621,華新科兆豐98購01,0.17,0.20,0.17,0.17,-0.18,-51.43,421000,8,76580,0,0,0,0,0,0,120000,294000,-174000,-174000
20200312,054622,漢唐第一97購01,,,,,0.00,0.00,0,0,0,0,0,0,0,0,0,0,0,0,0
20200312,054623,華新科第一97購01,0.17,0.17,0.11,0.11,-0.09,-45.0,1172000,24,146860,0,0,0,0,0,0,645000,522000,123000,123000
20200312,054624,台積電凱基98購03,0.38,0.38,0.28,0.34,-0.13,-27.66,240000,27,82200,0,0,0,0,0,0,20000,215000,-195000,-195000
20200312,054625,旺宏凱基98購03,,,,,0.00,0.00,0,0,0,0,0,0,0,0,0,0,0,0,0
20200312,054626,建準凱基98購01,,,,,0.00,0.00,0,0,0,0,0,0,0,0,0,0,0,0,0
20200312,054627,義隆凱基98購01,0.57,0.57,0.50,0.50,-0.27,-35.06,35000,3,18600,0,0,0,0,0,0,25000,10000,15000,15000
20200312,054628,可成凱基98購01,0.79,0.79,0.55,0.57,-0.50,-46.73,278000,24,178160,0,0,0,0,0,0,162000,168000,-6000,-6000
20200312,054629,華新科凱基98購01,0.18,0.18,0.10,0.11,-0.11,-50.0,633000,64,79210,0,0,0,0,0,0,0,633000,-633000,-633000
20200312,05462P,美律亞東97售01,1.62,1.62,1.62,1.62,0.00,0.00,30000,1,48600,0,0,0,0,0,0,0,30000,-30000,-30000
20200312,054630,聯鈞凱基98購01,1.39,1.39,0.98,1.12,-0.36,-24.32,170000,12,197600,0,0,0,0,0,0,105000,95000,10000,10000
20200312,054631,台郡凱基98購02,,,,,0.00,0.00,0,0,0,0,0,0,0,0,0,0,0,0,0
20200312,054632,緯穎凱基9A購01,0.75,0.76,0.54,0.56,-0.26,-31.71,785000,24,509200,0,0,0,0,0,0,205000,570000,-365000,-365000
20200312,054633,臺股指凱基9A購02,0.11,0.12,0.08,0.12,-0.02,-14.29,2047000,60,199860,0,0,0,0,0,0,0,1028000,-1028000,-1028000
20200312,054634,FB上証中信99購01,0.47,0.47,0.47,0.47,-0.18,-27.69,8000,1,3760,0,0,0,0,0,0,8000,0,8000,8000
20200312,054635,台達電中信98購01,,,,,0.00,0.00,0,0,0,0,0,0,0,0,0,0,0,0,0
20200312,054636,華通中信97購01,,,,,0.00,0.00,0,0,0,0,0,0,0,0,0,0,0,0,0
20200312,054637,智邦中信98購01,1.04,1.04,0.65,0.65,-0.49,-42.98,88000,13,74910,0,0,0,0,0,0,58000,30000,28000,28000
20200312,054638,國泰金中信99購01,0.40,0.40,0.40,0.40,-0.06,-13.04,30000,2,12000,0,0,0,0,0,0,30000,0,30000,30000
20200312,054639,台新金中信99購01,,,,,0.00,0.00,0,0,0,0,0,0,0,0,0,0,0,0,0
20200312,05463P,創意國票96售04,,,,,0.00,0.00,0,0,0,0,0,0,0,0,0,0,0,0,0
20200312,054640,健策中信9B購01,0.24,0.24,0.21,0.21,-0.12,-36.36,362000,10,78390,0,0,0,0,0,0,307000,55000,252000,252000
20200312,054641,祥碩中信98購01,1.30,1.30,1.15,1.17,-0.22,-15.83,35000,5,41270,0,0,0,0,0,0,35000,0,35000,35000
20200312,054642,訊芯中信9A購01,0.10,0.10,0.08,0.08,-0.07,-46.67,40000,4,3400,0,0,0,0,0,0,0,40000,-40000,-40000
20200312,054643,上証2X群益9B購01,,,,,0.00,0.00,0,0,0,0,0,0,0,0,0,0,0,0,0
20200312,054644,A50正2群益9B購01,0.39,0.39,0.32,0.33,-0.10,-23.26,474000,10,162920,0,0,0,0,0,0,313000,161000,152000,152000
20200312,054645,奇力新群益97購04,,,,,0.00,0.00,0,0,0,0,0,0,0,0,0,0,0,0,0
20200312,054646,華新科群益97購03,,,,,0.00,0.00,0,0,0,0,0,0,0,0,0,0,0,0,0
20200312,054647,禾伸堂群益99購01,0.47,0.48,0.39,0.48,-0.05,-9.43,220000,5,95000,0,0,0,0,0,0,110000,110000,0,0
20200312,054648,智原群益98購01,0.15,0.15,0.09,0.09,0.00,0.00,300000,4,34000,0,0,0,0,0,0,0,300000,-300000,-300000
20200312,054649,聯茂群益97購01,3.24,3.24,2.58,2.58,-2.03,-44.03,22000,2,64020,0,0,0,0,0,0,11000,11000,0,0
20200312,05464P,華通康和95售02,0.95,0.95,0.95,0.95,+0.12,14.46,51000,1,48450,0,0,0,0,0,0,0,51000,-51000,-51000
20200312,054650,南亞麥證97購01,,,,,0.00,0.00,0,0,0,0,0,0,0,0,0,0,0,0,0
20200312,054651,台化麥證97購01,0.10,0.10,0.10,0.10,0.00,0.00,5000,1,500,5000,0,5000,0,0,0,5000,0,5000,5000
20200312,054652,裕隆麥證97購01,0.86,0.86,0.55,0.55,-0.47,-46.08,134000,13,92710,61000,73000,-12000,0,0,0,61000,73000,-12000,-12000
20200312,054653,聯發科麥證97購02,,,,,0.00,0.00,0,0,0,0,0,0,0,0,0,0,0,0,0
20200312,054654,全新麥證99購01,,,,,0.00,0.00,0,0,0,0,0,0,0,0,0,0,0,0,0
20200312,054655,貿聯麥證98購01,0.31,0.31,0.30,0.30,-0.07,-18.92,21000,2,6310,21000,0,21000,0,0,0,21000,0,21000,21000
20200312,054656,深中小元大97購01,1.64,1.72,1.64,1.65,-0.36,-17.91,605000,53,1008600,0,0,0,0,0,0,100000,505000,-405000,-405000
20200312,054657,道瓊銀元大97購01,,,,,0.00,0.00,0,0,0,0,0,0,0,0,0,0,0,0,0
20200312,054658,道瓊銀元大9A購01,0.27,0.28,0.25,0.28,0.00,0.00,1915000,10,505300,0,0,0,0,0,0,1905000,10000,1895000,1895000
20200312,054659,亞光元大97購02,,,,,0.00,0.00,0,0,0,0,0,0,0,0,0,0,0,0,0
20200312,05465P,台表科永豐95售03,1.18,1.33,1.18,1.33,0.00,0.00,77000,4,101660,0,0,0,0,0,0,47000,30000,17000,17000
20200312,054660,禾伸堂元大97購03,0.22,0.22,0.21,0.21,0.00,0.00,51000,6,10810,0,0,0,0,0,0,10000,41000,-31000,-31000
20200312,054661,嘉聯益元大97購03,1.28,1.28,0.88,0.88,-0.60,-40.54,90000,3,84740,0,0,0,0,0,0,17000,80000,-63000,-63000
20200312,054662,同欣電元大97購02,0.21,0.21,0.19,0.19,-0.17,-47.22,68000,4,13120,0,0,0,0,0,0,68000,0,68000,68000
20200312,054663,同欣電元大97購03,0.25,0.25,0.17,0.17,-0.23,-57.5,143000,10,29260,0,0,0,0,0,0,53000,90000,-37000,-37000
20200312,054664,台表科元大97購04,,,,,0.00,0.00,0,0,0,0,0,0,0,0,0,0,0,0,0
20200312,054665,華通元富97購02,0.71,0.73,0.42,0.42,-0.61,-59.22,1243000,34,730360,0,0,0,0,0,0,1002000,241000,761000,761000
20200312,054666,強茂元富97購01,0.34,0.34,0.34,0.34,-0.16,-32.0,10000,1,3400,0,0,0,0,0,0,10000,0,10000,10000
20200312,054667,神基元富97購01,1.36,1.51,1.36,1.37,-0.22,-13.84,192000,20,272010,0,0,0,0,0,0,99000,85000,14000,14000
20200312,054668,傳奇元富97購03,0.22,0.22,0.14,0.14,-0.10,-41.67,240000,5,47100,0,0,0,0,0,0,5000,235000,-230000,-230000
20200312,054669,凌華元富97購01,3.17,3.17,3.12,3.13,-0.21,-6.29,42000,5,132650,0,0,0,0,0,0,32000,10000,22000,22000
20200312,05466P,旺宏富邦97售01,0.77,0.90,0.77,0.90,+0.16,21.62,11000,4,9100,0,0,0,0,0,0,11000,0,11000,11000
20200312,054670,康友元富97購01,1.30,1.33,0.99,1.03,-0.43,-29.45,158000,8,192380,0,0,0,0,0,0,117000,41000,76000,76000
20200312,054671,國巨國泰98購01,1.25,1.25,0.79,0.79,-0.90,-53.25,60000,6,54200,0,0,0,0,0,0,0,60000,-60000,-60000
20200312,054672,華新科國泰99購01,1.25,1.25,0.95,0.95,-0.67,-41.36,11000,2,13450,0,0,0,0,0,0,11000,10000,1000,1000
20200312,054673,京鼎國泰98購01,0.56,0.56,0.51,0.51,-0.37,-42.05,105000,13,57440,0,0,0,0,0,0,105000,0,105000,105000
20200312,054674,台光電台新97購01,,,,,0.00,0.00,0,0,0,0,0,0,0,0,0,0,0,0,0
20200312,054675,美律台新98購01,,,,,0.00,0.00,0,0,0,0,0,0,0,0,0,0,0,0,0
20200312,054676,牧德台新98購01,0.57,0.57,0.44,0.44,-0.41,-48.24,185000,8,90000,0,0,0,0,0,0,109000,60000,49000,49000
20200312,054677,智易台新98購02,0.31,0.31,0.24,0.24,-0.20,-45.45,20000,2,5500,0,0,0,0,0,0,10000,10000,0,0
20200312,054678,麗豐台新98購02,0.21,0.21,0.18,0.18,-0.07,-28.0,40000,3,7600,0,0,0,0,0,0,20000,20000,0,0
20200312,054679,台積電康和99購01,0.38,0.38,0.29,0.29,-0.14,-32.56,88000,4,30590,0,0,0,0,0,0,80000,8000,72000,72000
20200312,05467P,聯電元大95售02,1.35,1.55,1.35,1.50,0.00,0.00,385000,10,550350,0,0,0,0,0,0,25000,385000,-360000,-360000
20200312,054680,華新科康和97購02,0.33,0.33,0.22,0.22,-0.16,-42.11,245000,9,68700,0,0,0,0,0,0,0,245000,-245000,-245000
20200312,054681,味全永豐97購01,,,,,0.00,0.00,0,0,0,0,0,0,0,0,0,0,0,0,0
20200312,054682,東元永豐97購01,0.33,0.33,0.33,0.33,-0.10,-23.26,1000,1,330,0,0,0,0,0,0,1000,0,1000,1000
20200312,054683,川湖永豐97購01,0.45,0.46,0.41,0.41,-0.10,-19.61,57000,8,25560,0,0,0,0,0,0,16000,41000,-25000,-25000
20200312,054684,裕隆永豐97購01,0.64,0.65,0.51,0.55,-0.16,-22.54,186000,11,105280,0,0,0,0,0,0,3000,183000,-180000,-180000
20200312,054685,國巨永豐97購02,0.14,0.14,0.07,0.09,-0.06,-40.0,5361000,299,525050,0,0,0,0,0,0,86000,2321000,-2235000,-2235000
20200312,054686,順德永豐97購01,,,,,0.00,0.00,0,0,0,0,0,0,0,0,0,0,0,0,0
20200312,054687,建準永豐97購02,0.09,0.09,0.06,0.09,0.00,0.00,501000,7,37090,0,0,0,0,0,0,300000,201000,99000,99000
20200312,054688,兆赫永豐97購01,,,,,0.00,0.00,0,0,0,0,0,0,0,0,0,0,0,0,0
20200312,054689,華新科永豐97購01,0.05,0.07,0.05,0.07,-0.03,-30.0,393000,25,20470,0,0,0,0,0,0,0,270000,-270000,-270000
20200312,05468P,鴻海元大96售14,2.98,3.84,2.98,3.71,+1.04,38.95,605000,29,2139250,0,0,0,0,0,0,520000,401000,119000,119000
20200312,054690,新興永豐97購01,0.24,0.24,0.22,0.22,-0.05,-18.52,1500000,37,353000,0,0,0,0,0,0,0,1500000,-1500000,-1500000
20200312,054691,裕民永豐97購01,,,,,0.00,0.00,0,0,0,0,0,0,0,0,0,0,0,0,0
20200312,054692,台航永豐97購01,0.36,0.36,0.36,0.36,0.00,0.00,27000,1,9720,0,0,0,0,0,0,0,27000,-27000,-27000
20200312,054693,神基永豐97購01,0.68,0.74,0.68,0.74,-0.07,-8.64,59000,5,42020,0,0,0,0,0,0,39000,0,39000,39000
20200312,054694,聯鈞永豐97購01,0.82,0.82,0.56,0.56,-0.52,-48.15,88000,7,59880,0,0,0,0,0,0,53000,20000,33000,33000
20200312,054695,世芯永豐98購01,0.53,0.53,0.33,0.33,-0.27,-45.0,404000,12,200600,0,0,0,0,0,0,64000,340000,-276000,-276000
20200312,054696,嘉聯益永豐97購01,,,,,0.00,0.00,0,0,0,0,0,0,0,0,0,0,0,0,0
20200312,054697,凌華永豐97購01,,,,,0.00,0.00,0,0,0,0,0,0,0,0,0,0,0,0,0
20200312,054698,同欣電永豐97購01,0.06,0.07,0.06,0.07,0.00,0.00,320000,2,19400,0,0,0,0,0,0,300000,20000,280000,280000
20200312,054699,復盛永豐97購01,0.37,0.37,0.37,0.37,-0.13,-26.0,10000,1,3700,0,0,0,0,0,0,0,10000,-10000,-10000
20200312,05469P,台積電元大95售24,2.99,3.60,2.99,3.17,+0.78,32.64,632000,57,1995340,0,0,0,0,0,0,446000,586000,-140000,-140000
20200312,054700,致新永豐97購01,0.20,0.20,0.20,0.20,-0.12,-37.5,100000,1,20000,0,0,0,0,0,0,100000,0,100000,100000
20200312,054701,宏全永豐97購01,,,,,0.00,0.00,0,0,0,0,0,0,0,0,0,0,0,0,0
20200312,054702,智邦第一97購01,0.30,0.33,0.30,0.33,0.00,0.00,55000,3,16650,0,0,0,0,0,0,0,55000,-55000,-55000
20200312,054703,聯發科第一97購01,,,,,0.00,0.00,0,0,0,0,0,0,0,0,0,0,0,0,0
20200312,054704,玉晶光第一97購01,0.14,0.14,0.14,0.14,-0.13,-48.15,298000,3,41720,0,0,0,0,0,0,0,298000,-298000,-298000
20200312,054705,欣興亞東97購01,,,,,0.00,0.00,0,0,0,0,0,0,0,0,0,0,0,0,0
20200312,054706,TPK亞東97購01,,,,,0.00,0.00,0,0,0,0,0,0,0,0,0,0,0,0,0
20200312,054707,聯茂亞東97購01,,,,,0.00,0.00,0,0,0,0,0,0,0,0,0,0,0,0,0
20200312,054708,華通統一97購02,0.39,0.39,0.21,0.21,-0.35,-62.5,207000,37,67190,0,0,0,0,0,0,150000,54000,96000,96000
20200312,054709,宏達電統一97購01,,,,,0.00,0.00,0,0,0,0,0,0,0,0,0,0,0,0,0
20200312,05470P,康控元大95售05,2.53,2.53,2.53,2.53,0.00,0.00,9000,1,22770,0,0,0,0,0,0,0,9000,-9000,-9000
20200312,054710,東元元富97購01,1.25,1.27,1.11,1.18,-0.26,-18.06,487000,28,582500,0,0,0,0,0,0,241000,241000,0,0
20200312,054711,禾伸堂元富97購01,0.27,0.28,0.21,0.27,0.00,0.00,174000,5,39990,0,0,0,0,0,0,50000,124000,-74000,-74000
20200312,054712,上証2X中信98購02,,,,,0.00,0.00,0,0,0,0,0,0,0,0,0,0,0,0,0
20200312,054713,國巨中信9B購01,0.41,0.42,0.26,0.27,-0.15,-35.71,7542000,361,2346510,0,0,0,0,0,0,2108000,4319000,-2211000,-2211000
20200312,054714,和鑫台新98購01,0.18,0.18,0.15,0.16,-0.13,-44.83,175000,3,30950,0,0,0,0,0,0,150000,25000,125000,125000
20200312,054715,中橡康和97購01,,,,,0.00,0.00,0,0,0,0,0,0,0,0,0,0,0,0,0
20200312,054716,緯穎康和97購01,0.99,0.99,0.99,0.99,-0.41,-29.29,50000,1,49500,0,0,0,0,0,0,0,50000,-50000,-50000
20200312,054717,亞德客永豐97購01,0.71,0.71,0.58,0.58,-0.43,-42.57,47000,2,30120,0,0,0,0,0,0,47000,25000,22000,22000
20200312,054718,可成永豐97購01,0.27,0.27,0.27,0.27,-0.13,-32.5,58000,1,15660,0,0,0,0,0,0,58000,0,58000,58000
20200312,054719,亞光永豐97購01,,,,,0.00,0.00,0,0,0,0,0,0,0,0,0,0,0,0,0
20200312,05471P,聯電統一95售01,1.03,1.39,1.03,1.28,+0.35,37.63,151000,20,194430,0,0,0,0,0,0,61000,90000,-29000,-29000
20200312,054720,禾伸堂永豐97購01,0.19,0.19,0.19,0.19,-0.03,-13.64,30000,1,5700,0,0,0,0,0,0,30000,0,30000,30000
20200312,054721,揚明光永豐97購03,0.08,0.08,0.08,0.08,0.00,0.00,30000,1,2400,0,0,0,0,0,0,0,30000,-30000,-30000
20200312,054722,傳奇永豐97購01,0.07,0.07,0.04,0.05,0.00,0.00,302000,23,16100,0,0,0,0,0,0,0,302000,-302000,-302000
20200312,054723,鴻海日盛97購01,0.09,0.09,0.06,0.06,-0.07,-53.85,495000,5,34700,0,0,0,0,0,0,0,495000,-495000,-495000
20200312,054724,鴻海日盛97購02,0.08,0.08,0.05,0.05,-0.07,-58.33,195000,6,11050,0,0,0,0,0,0,0,195000,-195000,-195000
20200312,054725,國巨日盛97購01,,,,,0.00,0.00,0,0,0,0,0,0,0,0,0,0,0,0,0
20200312,054726,台積電日盛97購01,0.07,0.07,0.06,0.06,-0.07,-53.85,125000,9,8000,0,0,0,0,0,0,10000,60000,-50000,-50000
20200312,054727,台積電日盛97購02,0.14,0.14,0.04,0.12,-0.01,-7.69,886000,29,59540,0,0,0,0,0,0,721000,326000,395000,395000
20200312,054728,聯發科日盛97購01,,,,,0.00,0.00,0,0,0,0,0,0,0,0,0,0,0,0,0
20200312,054729,聯發科日盛97購02,0.07,0.07,0.07,0.07,-0.08,-53.33,40000,1,2800,0,0,0,0,0,0,0,40000,-40000,-40000
20200312,05472P,國巨統一96售02,0.61,0.92,0.61,0.92,+0.35,61.4,713000,20,497830,0,0,0,0,0,0,346000,357000,-11000,-11000
20200312,054730,上証2X凱基98購02,0.70,0.70,0.70,0.70,-0.08,-10.26,45000,1,31500,0,0,0,0,0,0,45000,0,45000,45000
20200312,054731,S&P反1凱基98購01,1.40,1.52,1.40,1.52,+0.35,29.91,27000,5,40300,0,0,0,0,0,0,26000,1000,25000,25000
20200312,054732,台化凱基98購01,0.11,0.11,0.11,0.11,-0.06,-35.29,10000,1,1100,0,0,0,0,0,0,0,10000,-10000,-10000
20200312,054733,鴻海凱基98購04,0.21,0.21,0.18,0.19,-0.14,-42.42,277000,17,54970,0,0,0,0,0,0,10000,267000,-257000,-257000
20200312,054734,燿華凱基97購03,,,,,0.00,0.00,0,0,0,0,0,0,0,0,0,0,0,0,0
20200312,054735,漢唐凱基98購01,0.31,0.31,0.31,0.31,-0.22,-41.51,1000,1,310,0,0,0,0,0,0,1000,0,1000,1000
20200312,054736,南亞科凱基98購01,,,,,0.00,0.00,0,0,0,0,0,0,0,0,0,0,0,0,0
20200312,054737,京元電凱基99購01,0.18,0.18,0.13,0.13,0.00,0.00,229000,10,32440,0,0,0,0,0,0,0,229000,-229000,-229000
20200312,054738,聯發科凱基97購01,,,,,0.00,0.00,0,0,0,0,0,0,0,0,0,0,0,0,0
20200312,054739,義隆凱基98購02,0.37,0.37,0.28,0.29,-0.25,-46.3,193000,13,61910,0,0,0,0,0,0,135000,58000,77000,77000
20200312,05473P,聯詠統一97售02,2.59,2.70,2.59,2.66,+0.14,5.56,32000,5,85190,0,0,0,0,0,0,21000,11000,10000,10000
20200312,054740,強茂凱基99購01,,,,,0.00,0.00,0,0,0,0,0,0,0,0,0,0,0,0,0
20200312,054741,亞光凱基99購01,0.10,0.45,0.10,0.42,+0.27,180.0,305000,29,46100,0,0,0,0,0,0,0,280000,-280000,-280000
20200312,054742,京鼎凱基99購01,0.56,0.56,0.39,0.39,-0.39,-50.0,210000,11,85480,0,0,0,0,0,0,10000,200000,-190000,-190000
20200312,054743,聯鈞凱基99購01,0.89,0.98,0.64,0.71,-0.27,-27.55,533000,34,434650,0,0,0,0,0,0,481000,342000,139000,139000
20200312,054744,晶相光凱基99購01,1.11,1.11,0.79,0.85,-0.30,-26.09,63000,6,58690,0,0,0,0,0,0,33000,30000,3000,3000
20200312,054745,智易凱基97購01,,,,,0.00,0.00,0,0,0,0,0,0,0,0,0,0,0,0,0
20200312,054746,貿聯凱基98購02,0.30,0.30,0.27,0.28,-0.10,-26.32,24000,18,6800,0,0,0,0,0,0,24000,0,24000,24000
20200312,054747,麗豐凱基98購01,,,,,0.00,0.00,0,0,0,0,0,0,0,0,0,0,0,0,0
20200312,054748,正文凱基98購01,0.48,0.48,0.37,0.37,-0.06,-13.95,139000,3,52530,0,0,0,0,0,0,71000,129000,-58000,-58000
20200312,054749,聯茂凱基98購01,2.19,2.19,2.19,2.19,-0.85,-27.96,30000,1,65700,0,0,0,0,0,0,30000,0,30000,30000
20200312,05474P,智邦亞東95售01,1.02,1.02,1.02,1.02,+0.28,37.84,100000,2,102000,0,0,0,0,0,0,0,100000,-100000,-100000
20200312,054750,聯茂凱基98購02,1.70,1.76,1.67,1.67,-0.98,-36.98,40000,3,68000,0,0,0,0,0,0,20000,20000,0,0
20200312,054751,GIS凱基98購01,,,,,0.00,0.00,0,0,0,0,0,0,0,0,0,0,0,0,0
20200312,054752,易華電凱基97購02,0.20,0.20,0.12,0.12,-0.13,-52.0,681000,23,104010,0,0,0,0,0,0,50000,631000,-581000,-581000
20200312,054753,復盛凱基98購01,0.77,0.80,0.61,0.72,-0.32,-30.77,365000,16,266720,0,0,0,0,0,0,136000,229000,-93000,-93000
20200312,054754,昇陽半凱基98購02,,,,,0.00,0.00,0,0,0,0,0,0,0,0,0,0,0,0,0
20200312,054755,世紀鋼凱基98購01,1.94,1.94,1.58,1.83,-0.13,-6.63,850000,41,1527230,0,0,0,0,0,0,595000,373000,222000,222000
20200312,054756,世紀鋼凱基99購01,1.59,1.59,1.20,1.48,-0.21,-12.43,3998000,106,5453360,0,0,0,0,0,0,1430000,2695000,-1265000,-1265000
20200312,054757,南亞國票98購01,0.84,0.84,0.70,0.70,-0.21,-23.08,39000,2,31360,0,0,0,0,0,0,10000,29000,-19000,-19000
20200312,054758,南亞國票9A購01,0.85,0.85,0.85,0.85,0.00,0.00,29000,1,24650,0,0,0,0,0,0,0,29000,-29000,-29000
20200312,054759,台化國票98購01,0.54,0.54,0.52,0.52,-0.24,-31.58,39000,2,20300,0,0,0,0,0,0,38000,1000,37000,37000
20200312,05475P,聯茂亞東95售01,0.77,0.88,0.77,0.88,+0.23,35.38,43000,4,37110,0,0,0,0,0,0,3000,40000,-37000,-37000
20200312,054760,台化國票9A購01,,,,,0.00,0.00,0,0,0,0,0,0,0,0,0,0,0,0,0
20200312,054761,台光電國票98購02,0.85,0.85,0.59,0.62,-0.40,-39.22,236000,21,167130,0,0,0,0,0,0,123000,163000,-40000,-40000
20200312,054762,奇力新國票99購01,0.16,0.16,0.16,0.16,-0.10,-38.46,100000,1,16000,0,0,0,0,0,0,0,100000,-100000,-100000
20200312,054763,宏達電國票99購01,0.86,0.96,0.86,0.89,-0.39,-30.47,485000,8,435300,0,0,0,0,0,0,85000,400000,-315000,-315000
20200312,054764,亞光國票98購01,,,,,0.00,0.00,0,0,0,0,0,0,0,0,0,0,0,0,0
20200312,054765,亞光國票98購02,,,,,0.00,0.00,0,0,0,0,0,0,0,0,0,0,0,0,0
20200312,054766,智原國票98購01,,,,,0.00,0.00,0,0,0,0,0,0,0,0,0,0,0,0,0
20200312,054767,日電貿國票98購01,0.88,0.88,0.68,0.68,-0.29,-29.9,73000,3,56540,0,0,0,0,0,0,38000,35000,3000,3000
20200312,054768,泰碩國票99購02,1.37,1.37,1.11,1.23,-0.38,-23.6,366000,19,450880,0,0,0,0,0,0,25000,346000,-321000,-321000
20200312,054769,創意國票98購01,,,,,0.00,0.00,0,0,0,0,0,0,0,0,0,0,0,0,0
20200312,05476P,聯發科群益95售06,3.73,4.88,3.71,4.88,+1.56,46.99,85000,13,340870,0,0,0,0,0,0,58000,61000,-3000,-3000
20200312,054770,健策國票98購01,0.29,0.29,0.17,0.17,-0.23,-57.5,1565000,21,340250,0,0,0,0,0,0,223000,1342000,-1119000,-1119000
20200312,054771,茂林國票98購02,0.76,0.76,0.54,0.54,-0.26,-32.5,95000,5,62770,0,0,0,0,0,0,57000,38000,19000,19000
20200312,054772,康控國票98購02,0.27,0.27,0.19,0.20,-0.31,-60.78,100000,4,22500,0,0,0,0,0,0,0,100000,-100000,-100000
20200312,054773,台郡國票98購01,1.47,1.48,1.25,1.25,-1.21,-49.19,98000,11,131420,0,0,0,0,0,0,78000,20000,58000,58000
20200312,054774,同欣電國票98購01,0.09,0.09,0.06,0.07,-0.08,-53.33,865000,10,66850,0,0,0,0,0,0,60000,805000,-745000,-745000
20200312,054775,復盛國票98購01,0.56,0.61,0.41,0.55,-0.30,-35.29,392000,17,196460,0,0,0,0,0,0,138000,254000,-116000,-116000
20200312,054776,矽創國票98購01,0.73,0.73,0.45,0.45,-0.47,-51.09,30000,3,16800,0,0,0,0,0,0,10000,20000,-10000,-10000
20200312,054777,昇陽半國票98購01,,,,,0.00,0.00,0,0,0,0,0,0,0,0,0,0,0,0,0
20200312,054778,世紀鋼國票99購01,4.28,4.28,3.60,4.01,-0.52,-11.48,119000,32,473650,0,0,0,0,0,0,45000,74000,-29000,-29000
20200312,054779,台塑群益98購01,0.37,0.37,0.22,0.22,-0.26,-54.17,51000,2,12870,0,0,0,0,0,0,51000,0,51000,51000
20200312,05477P,華新科群益95售06,0.38,0.60,0.38,0.60,+0.29,93.55,85000,6,36700,0,0,0,0,0,0,55000,30000,25000,25000
20200312,054780,中石化群益99購01,,,,,0.00,0.00,0,0,0,0,0,0,0,0,0,0,0,0,0
20200312,054781,台化群益99購01,0.31,0.31,0.28,0.28,-0.16,-36.36,13000,2,3880,0,0,0,0,0,0,5000,8000,-3000,-3000
20200312,054782,國巨群益97購01,1.24,1.25,0.71,0.77,-0.56,-42.11,66000,7,77020,0,0,0,0,0,0,0,66000,-66000,-66000
20200312,054783,國巨群益98購04,0.78,0.80,0.52,0.52,-0.40,-43.48,260000,16,186560,0,0,0,0,0,0,201000,59000,142000,142000
20200312,054784,順德群益9A購01,0.91,0.91,0.89,0.89,-0.19,-17.59,24000,2,21600,0,0,0,0,0,0,24000,0,24000,24000
20200312,054785,建準群益98購01,0.61,0.63,0.61,0.61,-0.15,-19.74,101000,6,62140,0,0,0,0,0,0,60000,41000,19000,19000
20200312,054786,全新群益99購02,0.27,0.27,0.27,0.27,-0.14,-34.15,300000,1,81000,0,0,0,0,0,0,300000,0,300000,300000
20200312,054787,華新科群益97購04,,,,,0.00,0.00,0,0,0,0,0,0,0,0,0,0,0,0,0
20200312,054788,華新科群益98購02,,,,,0.00,0.00,0,0,0,0,0,0,0,0,0,0,0,0,0
20200312,054789,高鐵群益98購01,,,,,0.00,0.00,0,0,0,0,0,0,0,0,0,0,0,0,0
20200312,05478P,智伸科國票96售02,,,,,0.00,0.00,0,0,0,0,0,0,0,0,0,0,0,0,0
20200312,054790,禾伸堂群益98購01,0.48,0.48,0.48,0.48,0.00,0.00,48000,1,23040,0,0,0,0,0,0,0,48000,-48000,-48000
20200312,054791,泰碩群益99購02,1.24,1.27,0.95,1.08,-0.24,-18.18,762000,33,861470,0,0,0,0,0,0,408000,353000,55000,55000
20200312,054792,揚明光群益97購01,0.41,0.41,0.41,0.41,0.00,0.00,31000,3,12710,0,0,0,0,0,0,0,31000,-31000,-31000
20200312,054793,牧德群益9A購01,0.76,0.76,0.62,0.62,-0.31,-33.33,1815000,8,1333500,0,0,0,0,0,0,1812000,3000,1809000,1809000
20200312,054794,貿聯群益98購01,0.38,0.40,0.37,0.40,-0.14,-25.93,139000,28,53460,0,0,0,0,0,0,139000,0,139000,139000
20200312,054795,合勤控群益98購01,,,,,0.00,0.00,0,0,0,0,0,0,0,0,0,0,0,0,0
20200312,054796,康普群益98購01,0.15,0.15,0.12,0.12,-0.15,-55.56,177000,4,23690,0,0,0,0,0,0,0,177000,-177000,-177000
20200312,054797,臻鼎群益97購01,0.16,0.16,0.08,0.09,-0.19,-67.86,413000,8,39420,0,0,0,0,0,0,50000,363000,-313000,-313000
20200312,054798,超眾群益97購01,0.30,0.30,0.21,0.21,-0.22,-51.16,23000,2,5100,0,0,0,0,0,0,23000,0,23000,23000
20200312,054799,超眾群益98購01,,,,,0.00,0.00,0,0,0,0,0,0,0,0,0,0,0,0,0
20200312,05479P,華新科台新96售01,0.58,0.65,0.58,0.63,0.00,0.00,39000,5,23490,0,0,0,0,0,0,13000,26000,-13000,-13000
20200312,054800,訊芯群益99購01,0.31,0.31,0.23,0.23,-0.25,-52.08,255000,6,71110,0,0,0,0,0,0,157000,98000,59000,59000
20200312,054801,康友群益97購02,1.53,1.53,1.16,1.23,-0.48,-28.07,161000,11,205150,0,0,0,0,0,0,159000,15000,144000,144000
20200312,054802,高股息元大97購01,0.46,0.46,0.27,0.27,-0.25,-48.08,155000,7,52800,0,0,0,0,0,0,65000,90000,-25000,-25000
20200312,054803,味全元大9A購01,0.74,0.74,0.68,0.68,-0.27,-28.42,78000,2,57120,0,0,0,0,0,0,0,78000,-78000,-78000
20200312,054804,南亞元大9A購01,0.60,0.60,0.56,0.56,-0.11,-16.42,103000,3,60400,0,0,0,0,0,0,102000,1000,101000,101000
20200312,054805,台苯元大9A購01,0.51,0.51,0.50,0.50,-0.14,-21.88,325000,4,162750,0,0,0,0,0,0,300000,25000,275000,275000
20200312,054806,台化元大9A購01,0.94,0.97,0.94,0.95,-0.34,-26.36,281000,5,267510,0,0,0,0,0,0,99000,182000,-83000,-83000
20200312,054807,台化元大9A購02,0.58,0.63,0.58,0.63,-0.18,-22.22,136000,2,82280,0,0,0,0,0,0,68000,68000,0,0
20200312,054808,東元元大9A購01,1.18,1.18,1.06,1.12,-0.23,-17.04,396000,15,447060,0,0,0,0,0,0,68000,328000,-260000,-260000
20200312,054809,大成鋼元大97購01,0.77,0.77,0.68,0.70,-0.13,-15.66,86000,3,60740,0,0,0,0,0,0,18000,68000,-50000,-50000
20200312,05480P,滬深2X凱基96售05,2.64,2.64,2.59,2.61,0.00,0.00,205000,4,536550,0,0,0,0,0,0,100000,105000,-5000,-5000
20200312,054810,中橡元大9A購01,0.51,0.51,0.40,0.40,-0.14,-25.93,251000,14,119060,0,0,0,0,0,0,241000,10000,231000,231000
20200312,054811,裕隆元大9A購01,1.33,1.33,1.18,1.21,-0.19,-13.57,493000,12,620380,0,0,0,0,0,0,250000,243000,7000,7000
20200312,054812,鴻海元大97購08,0.45,0.45,0.31,0.31,-0.26,-45.61,393000,11,138840,0,0,0,0,0,0,128000,265000,-137000,-137000
20200312,054813,鴻海元大97購09,0.35,0.35,0.25,0.25,0.00,0.00,779000,6,237000,0,0,0,0,0,0,20000,759000,-739000,-739000
20200312,054814,台積電元大97購13,0.55,0.55,0.39,0.39,-0.29,-42.65,179000,4,89200,0,0,0,0,0,0,99000,129000,-30000,-30000
20200312,054815,台積電元大97購14,,,,,0.00,0.00,0,0,0,0,0,0,0,0,0,0,0,0,0
20200312,054816,聯發科元大97購12,0.11,0.11,0.11,0.11,-0.16,-59.26,30000,1,3300,0,0,0,0,0,0,30000,0,30000,30000
20200312,054817,聯發科元大97購13,0.14,0.14,0.14,0.14,-0.16,-53.33,130000,1,18200,0,0,0,0,0,0,130000,0,130000,130000
20200312,054818,奇力新元大97購05,0.14,0.14,0.10,0.12,-0.07,-36.84,145000,14,15300,0,0,0,0,0,0,15000,130000,-115000,-115000
20200312,054819,裕民元大9A購01,1.21,1.21,1.06,1.06,-0.21,-16.54,239000,11,271860,0,0,0,0,0,0,227000,12000,215000,215000
20200312,05481P,鴻海凱基95售21,2.74,3.35,2.71,3.35,+0.88,35.63,126000,11,389500,0,0,0,0,0,0,89000,125000,-36000,-36000
20200312,054820,新日興元大97購01,1.49,1.49,1.25,1.42,0.00,0.00,101000,3,138420,0,0,0,0,0,0,50000,51000,-1000,-1000
20200312,054821,貿聯元大9A購01,0.32,0.32,0.26,0.26,-0.11,-29.73,94000,6,26630,0,0,0,0,0,0,29000,65000,-36000,-36000
20200312,054822,祥碩元大97購01,5.60,5.60,4.57,4.57,-1.33,-22.54,81000,9,395330,0,0,0,0,0,0,30000,81000,-51000,-51000
20200312,054823,祥碩元大97購02,5.05,5.05,4.08,4.27,-0.93,-17.88,186000,14,830230,0,0,0,0,0,0,111000,73000,38000,38000
20200312,054824,同欣電元大97購04,0.46,0.46,0.33,0.33,-0.39,-54.17,320000,3,122400,0,0,0,0,0,0,0,320000,-320000,-320000
20200312,054825,康友元大97購01,1.54,1.54,1.15,1.15,-0.46,-28.57,145000,9,199370,0,0,0,0,0,0,77000,77000,0,0
20200312,054826,復盛元大9A購01,2.02,2.02,1.87,1.87,-0.31,-14.22,31000,2,61420,0,0,0,0,0,0,23000,8000,15000,15000
20200312,054827,宏全元大9A購01,1.20,1.20,0.95,0.97,-0.35,-26.52,535000,16,575620,0,0,0,0,0,0,515000,20000,495000,495000
20200312,054828,正崴國泰99購01,0.34,0.34,0.22,0.22,-0.17,-43.59,112000,4,32880,0,0,0,0,0,0,52000,60000,-8000,-8000
20200312,054829,亞光國泰99購01,0.24,0.24,0.16,0.17,0.00,0.00,80000,8,14390,0,0,0,0,0,0,60000,20000,40000,40000
20200312,05482P,鴻海凱基95售22,2.61,2.63,2.61,2.63,+0.25,10.5,25000,2,65550,0,0,0,0,0,0,15000,25000,-10000,-10000
20200312,054830,世芯國泰99購01,1.82,1.82,1.27,1.30,-0.99,-43.23,86000,6,132680,0,0,0,0,0,0,58000,28000,30000,30000
20200312,054831,緯穎國泰98購01,3.48,3.48,2.50,2.50,-1.01,-28.77,138000,10,399260,0,0,0,0,0,0,32000,106000,-74000,-74000
20200312,054832,興勤中信97購01,,,,,0.00,0.00,0,0,0,0,0,0,0,0,0,0,0,0,0
20200312,054833,京鼎中信97購01,,,,,0.00,0.00,0,0,0,0,0,0,0,0,0,0,0,0,0
20200312,054834,帆宣中信97購01,0.06,0.06,0.06,0.06,0.00,0.00,140000,14,8400,0,0,0,0,0,0,0,140000,-140000,-140000
20200312,054835,致新中信97購01,0.09,0.10,0.09,0.10,-0.09,-47.37,80000,5,7900,0,0,0,0,0,0,80000,0,80000,80000
20200312,054836,勤誠中信97購01,0.32,0.32,0.32,0.32,-0.09,-21.95,20000,1,6400,0,0,0,0,0,0,20000,0,20000,20000
20200312,054837,欣興第一97購01,0.17,0.17,0.17,0.17,-0.22,-56.41,10000,1,1700,0,0,0,0,0,0,0,10000,-10000,-10000
20200312,054838,京鼎第一97購01,0.21,0.21,0.16,0.17,-0.13,-43.33,65000,16,11730,0,0,0,0,0,0,65000,0,65000,65000
20200312,054839,中石化亞東98購01,,,,,0.00,0.00,0,0,0,0,0,0,0,0,0,0,0,0,0
20200312,05483P,國巨凱基95售07,,,,,0.00,0.00,0,0,0,0,0,0,0,0,0,0,0,0,0
20200312,054840,T50反1兆豐98購01,,,,,0.00,0.00,0,0,0,0,0,0,0,0,0,0,0,0,0
20200312,054841,亞德客兆豐97購01,1.38,1.38,1.06,1.06,-0.66,-38.37,11000,2,14860,0,0,0,0,0,0,10000,1000,9000,9000
20200312,054842,台達電兆豐98購01,1.47,1.47,1.47,1.47,-0.43,-22.63,10000,1,14700,0,0,0,0,0,0,10000,0,10000,10000
20200312,054843,中環兆豐97購01,0.21,0.21,0.14,0.14,-0.15,-51.72,798000,16,141340,0,0,0,0,0,0,329000,369000,-40000,-40000
20200312,054844,華邦電兆豐98購01,0.18,0.19,0.15,0.15,-0.19,-55.88,21000,3,3700,0,0,0,0,0,0,0,21000,-21000,-21000
20200312,054845,智邦兆豐98購01,1.04,1.04,0.80,0.80,-0.32,-28.57,392000,22,358050,0,0,0,0,0,0,278000,109000,169000,169000
20200312,054846,瑞昱兆豐97購01,,,,,0.00,0.00,0,0,0,0,0,0,0,0,0,0,0,0,0
20200312,054847,創意兆豐97購01,0.15,0.17,0.15,0.17,-0.15,-46.88,209000,2,31750,0,0,0,0,0,0,189000,20000,169000,169000
20200312,054848,群創兆豐98購01,0.12,0.12,0.09,0.09,-0.13,-59.09,690000,23,72190,0,0,0,0,0,0,0,690000,-690000,-690000
20200312,054849,日月光兆豐97購01,,,,,0.00,0.00,0,0,0,0,0,0,0,0,0,0,0,0,0
20200312,05484P,台積電凱基95售18,0.46,0.62,0.43,0.43,0.00,0.00,416000,4,179520,0,0,0,0,0,0,416000,1000,415000,415000
20200312,054850,上海銀兆豐97購01,0.40,0.40,0.28,0.28,-0.22,-44.0,23000,4,8000,0,0,0,0,0,0,17000,6000,11000,11000
20200312,054851,樺漢兆豐97購01,0.60,0.60,0.44,0.44,-0.37,-45.68,48000,4,26560,0,0,0,0,0,0,38000,10000,28000,28000
20200312,054852,奇鋐國票98購01,,,,,0.00,0.00,0,0,0,0,0,0,0,0,0,0,0,0,0
20200312,054853,TPK國票98購02,0.10,0.10,0.08,0.08,-0.06,-42.86,280000,3,24400,0,0,0,0,0,0,0,280000,-280000,-280000
20200312,054854,台積電麥證97購01,0.25,0.25,0.22,0.22,-0.07,-24.14,75000,2,16800,0,75000,-75000,0,0,0,0,75000,-75000,-75000
20200312,054855,得力群益98購01,0.48,0.48,0.48,0.48,-0.19,-28.36,10000,1,4800,0,0,0,0,0,0,0,10000,-10000,-10000
20200312,054856,得力群益99購01,,,,,0.00,0.00,0,0,0,0,0,0,0,0,0,0,0,0,0
20200312,054857,信錦群益97購01,,,,,0.00,0.00,0,0,0,0,0,0,0,0,0,0,0,0,0
20200312,054858,台肥群益97購01,0.60,0.61,0.60,0.61,0.00,0.00,210000,2,126100,0,0,0,0,0,0,200000,10000,190000,190000
20200312,054859,鴻海群益97購02,,,,,0.00,0.00,0,0,0,0,0,0,0,0,0,0,0,0,0
20200312,05485P,旺宏凱基95售08,0.88,0.88,0.88,0.88,+0.32,57.14,50000,1,44000,0,0,0,0,0,0,50000,50000,0,0
20200312,054860,台積電群益98購01,0.20,0.20,0.12,0.16,-0.11,-40.74,1317000,24,234020,0,0,0,0,0,0,783000,534000,249000,249000
20200312,054861,智邦群益97購01,1.15,1.15,0.63,0.63,-0.58,-47.93,91000,25,89870,0,0,0,0,0,0,69000,27000,42000,42000
20200312,054862,群光群益97購01,0.74,0.78,0.63,0.63,-0.12,-16.0,136000,20,99580,0,0,0,0,0,0,116000,20000,96000,96000
20200312,054863,億光群益97購01,0.53,0.53,0.43,0.43,-0.23,-34.85,48000,2,24340,0,0,0,0,0,0,48000,0,48000,48000
20200312,054864,聯發科群益97購02,0.05,0.05,0.03,0.03,-0.06,-66.67,1332000,9,43960,0,0,0,0,0,0,1000000,132000,868000,868000
20200312,054865,可成群益97購01,0.72,0.72,0.46,0.46,-0.64,-58.18,123000,6,84090,0,0,0,0,0,0,123000,15000,108000,108000
20200312,054866,宏盛群益98購01,,,,,0.00,0.00,0,0,0,0,0,0,0,0,0,0,0,0,0
20200312,054867,華航群益99購01,0.31,0.32,0.31,0.32,-0.10,-23.81,194000,3,61140,0,0,0,0,0,0,94000,100000,-6000,-6000
20200312,054868,國泰金群益9A購01,0.23,0.25,0.22,0.22,-0.07,-24.14,224000,13,51570,0,0,0,0,0,0,53000,194000,-141000,-141000
20200312,054869,新光金群益97購01,,,,,0.00,0.00,0,0,0,0,0,0,0,0,0,0,0,0,0
20200312,05486P,大立光凱基95售14,,,,,0.00,0.00,0,0,0,0,0,0,0,0,0,0,0,0,0
20200312,054870,新日興群益98購01,1.02,1.02,0.67,0.69,-0.46,-40.0,317000,10,258920,0,0,0,0,0,0,139000,188000,-49000,-49000
20200312,054871,明泰群益98購01,0.56,0.56,0.53,0.54,-0.12,-18.18,45000,5,24670,0,0,0,0,0,0,14000,31000,-17000,-17000
20200312,054872,瀚宇博群益98購01,,,,,0.00,0.00,0,0,0,0,0,0,0,0,0,0,0,0,0
20200312,054873,帆宣群益99購01,,,,,0.00,0.00,0,0,0,0,0,0,0,0,0,0,0,0,0
20200312,054874,帆宣群益99購02,,,,,0.00,0.00,0,0,0,0,0,0,0,0,0,0,0,0,0
20200312,054875,群電群益97購01,0.23,0.23,0.23,0.23,-0.07,-23.33,62000,2,14260,0,0,0,0,0,0,62000,0,62000,62000
20200312,054876,群電群益97購02,0.50,0.50,0.44,0.44,-0.10,-18.52,45000,3,21840,0,0,0,0,0,0,11000,34000,-23000,-23000
20200312,054877,百和群益98購01,0.51,0.51,0.33,0.36,-0.28,-43.75,492000,27,209980,0,0,0,0,0,0,42000,480000,-438000,-438000
20200312,054878,和大統一97購02,0.23,0.23,0.18,0.18,-0.20,-52.63,58000,3,12840,0,0,0,0,0,0,58000,0,58000,58000
20200312,054879,大成鋼統一97購01,0.43,0.44,0.43,0.44,-0.08,-15.38,194000,5,84960,0,0,0,0,0,0,194000,0,194000,194000
20200312,05487P,台表科凱基95售02,0.97,1.27,0.97,1.27,+0.26,25.74,432000,20,482810,0,0,0,0,0,0,227000,205000,22000,22000
20200312,054880,華泰統一97購01,0.39,0.39,0.39,0.39,-0.18,-31.58,10000,1,3900,0,0,0,0,0,0,0,10000,-10000,-10000
20200312,054881,光罩統一97購01,0.86,0.86,0.75,0.81,-0.37,-31.36,61000,4,49450,0,0,0,0,0,0,61000,0,61000,61000
20200312,054882,台光電統一97購02,0.52,0.52,0.52,0.52,-0.12,-18.75,29000,2,15080,0,0,0,0,0,0,29000,0,29000,29000
20200312,054883,億光統一97購01,0.74,0.74,0.59,0.59,-0.32,-35.16,91000,7,62080,0,0,0,0,0,0,51000,40000,11000,11000
20200312,054884,友達統一99購01,0.14,0.14,0.12,0.12,-0.11,-47.83,390000,4,48400,0,0,0,0,0,0,70000,320000,-250000,-250000
20200312,054885,建準統一98購01,,,,,0.00,0.00,0,0,0,0,0,0,0,0,0,0,0,0,0
20200312,054886,大毅統一97購01,2.35,2.35,2.35,2.35,-1.02,-30.27,4000,1,9400,0,0,0,0,0,0,0,4000,-4000,-4000
20200312,054887,大毅統一98購01,,,,,0.00,0.00,0,0,0,0,0,0,0,0,0,0,0,0,0
20200312,054888,泰碩統一97購01,0.42,0.45,0.30,0.35,-0.13,-27.08,570000,14,203500,0,0,0,0,0,0,129000,441000,-312000,-312000
20200312,054889,京鼎統一99購01,0.19,0.19,0.19,0.19,0.00,0.00,10000,1,1900,0,0,0,0,0,0,10000,0,10000,10000
20200312,05488P,臺股指凱基95售21,,,,,0.00,0.00,0,0,0,0,0,0,0,0,0,0,0,0,0
20200312,054890,聯鈞統一99購01,1.40,1.40,1.14,1.14,-0.35,-23.49,30000,2,36800,0,0,0,0,0,0,20000,10000,10000,10000
20200312,054891,聯鈞統一99購02,0.60,0.60,0.40,0.44,-0.21,-32.31,455000,23,229300,0,0,0,0,0,0,314000,121000,193000,193000
20200312,054892,彩晶統一99購01,,,,,0.00,0.00,0,0,0,0,0,0,0,0,0,0,0,0,0
20200312,054893,帆宣統一99購01,0.16,0.16,0.16,0.16,-0.12,-42.86,160000,2,25600,0,0,0,0,0,0,0,160000,-160000,-160000
20200312,054894,GIS統一97購01,,,,,0.00,0.00,0,0,0,0,0,0,0,0,0,0,0,0,0
20200312,054895,南電統一97購01,2.05,2.05,1.51,1.51,-0.58,-27.75,25000,2,48550,0,0,0,0,0,0,25000,0,25000,25000
20200312,054896,聯茂日盛97購01,1.46,1.46,1.15,1.15,-0.96,-45.5,52000,4,63190,0,0,0,0,0,0,0,52000,-52000,-52000
20200312,054897,信錦康和97購01,,,,,0.00,0.00,0,0,0,0,0,0,0,0,0,0,0,0,0
20200312,054898,台肥康和97購01,0.46,0.46,0.41,0.41,-0.12,-22.64,30000,3,12800,0,0,0,0,0,0,0,30000,-30000,-30000
20200312,054899,南港康和97購01,0.33,0.33,0.33,0.33,-0.09,-21.43,55000,1,18150,0,0,0,0,0,0,55000,0,55000,55000
20200312,05489P,臺股指凱基95售22,,,,,0.00,0.00,0,0,0,0,0,0,0,0,0,0,0,0,0
20200312,054900,金寶康和97購01,0.36,0.36,0.31,0.31,-0.14,-31.11,25000,2,8000,0,0,0,0,0,0,20000,5000,15000,15000
20200312,054901,群光康和97購01,0.41,0.42,0.34,0.34,-0.08,-19.05,68000,12,26620,0,0,0,0,0,0,68000,0,68000,68000
20200312,054902,億光康和97購01,,,,,0.00,0.00,0,0,0,0,0,0,0,0,0,0,0,0,0
20200312,054903,億光康和97購02,,,,,0.00,0.00,0,0,0,0,0,0,0,0,0,0,0,0,0
20200312,054904,興勤康和97購01,,,,,0.00,0.00,0,0,0,0,0,0,0,0,0,0,0,0,0
20200312,054905,國揚康和97購01,0.46,0.46,0.46,0.46,0.00,0.00,10000,1,4600,0,0,0,0,0,0,0,10000,-10000,-10000
20200312,054906,神達康和97購01,0.88,0.92,0.88,0.92,-0.46,-33.33,110000,2,98800,0,0,0,0,0,0,60000,50000,10000,10000
20200312,054907,帆宣康和97購01,0.17,0.17,0.17,0.17,0.00,0.00,5000,1,850,0,0,0,0,0,0,0,5000,-5000,-5000
20200312,054908,群電康和97購01,0.26,0.26,0.26,0.26,-0.04,-13.33,5000,1,1300,0,0,0,0,0,0,5000,0,5000,5000
20200312,054909,福懋科康和97購01,,,,,0.00,0.00,0,0,0,0,0,0,0,0,0,0,0,0,0
20200312,05490P,鴻海元大95售23,1.85,2.10,1.85,2.10,+0.39,22.81,91000,9,177550,0,0,0,0,0,0,91000,0,91000,91000
20200312,054910,信錦凱基97購01,0.53,0.53,0.47,0.47,0.00,0.00,80000,2,39400,0,0,0,0,0,0,50000,30000,20000,20000
20200312,054911,敬鵬凱基97購01,,,,,0.00,0.00,0,0,0,0,0,0,0,0,0,0,0,0,0
20200312,054912,群光凱基97購01,0.70,0.73,0.61,0.61,-0.15,-19.74,222000,29,158000,0,0,0,0,0,0,151000,61000,90000,90000
20200312,054913,億光凱基97購01,0.24,0.24,0.24,0.24,-0.11,-31.43,26000,3,6240,0,0,0,0,0,0,26000,26000,0,0
20200312,054914,億光凱基98購01,,,,,0.00,0.00,0,0,0,0,0,0,0,0,0,0,0,0,0
20200312,054915,興勤凱基97購01,,,,,0.00,0.00,0,0,0,0,0,0,0,0,0,0,0,0,0
20200312,054916,聯發科凱基98購04,0.39,0.39,0.39,0.39,+0.19,95.0,10000,1,3900,0,0,0,0,0,0,10000,0,10000,10000
20200312,054917,聯發科凱基98購05,,,,,0.00,0.00,0,0,0,0,0,0,0,0,0,0,0,0,0
20200312,054918,華新科凱基98購02,0.27,0.27,0.18,0.18,-0.18,-50.0,83000,9,21340,0,0,0,0,0,0,0,83000,-83000,-83000
20200312,054919,興富發凱基97購01,,,,,0.00,0.00,0,0,0,0,0,0,0,0,0,0,0,0,0
20200312,05491P,茂林元大95售04,1.49,1.89,1.49,1.88,+0.36,23.68,671000,22,1171930,0,0,0,0,0,0,464000,236000,228000,228000
20200312,054920,智原凱基98購01,,,,,0.00,0.00,0,0,0,0,0,0,0,0,0,0,0,0,0
20200312,054921,文曄凱基97購01,0.80,0.80,0.77,0.78,-0.07,-8.24,102000,11,80060,0,0,0,0,0,0,102000,0,102000,102000
20200312,054922,文曄凱基98購01,1.23,1.23,1.23,1.23,0.00,0.00,20000,1,24600,0,0,0,0,0,0,0,20000,-20000,-20000
20200312,054923,晶技凱基98購01,1.37,1.37,0.68,0.68,-0.65,-48.87,592000,31,476300,0,0,0,0,0,0,128000,466000,-338000,-338000
20200312,054924,景碩凱基98購01,0.67,0.67,0.54,0.54,-0.43,-44.33,79000,3,46300,0,0,0,0,0,0,78000,1000,77000,77000
20200312,054925,神達凱基97購01,1.32,1.32,1.06,1.13,-0.47,-29.38,180000,7,209770,0,0,0,0,0,0,61000,165000,-104000,-104000
20200312,054926,神達凱基98購01,1.35,1.41,1.16,1.19,-0.55,-31.61,175000,13,220820,0,0,0,0,0,0,114000,61000,53000,53000
20200312,054927,帆宣凱基97購01,,,,,0.00,0.00,0,0,0,0,0,0,0,0,0,0,0,0,0
20200312,054928,帆宣凱基98購01,,,,,0.00,0.00,0,0,0,0,0,0,0,0,0,0,0,0,0
20200312,054929,群電凱基97購01,,,,,0.00,0.00,0,0,0,0,0,0,0,0,0,0,0,0,0
20200312,05492P,聯茂元大95售02,0.94,1.21,0.94,1.19,+0.42,54.55,257000,11,284330,0,0,0,0,0,0,160000,197000,-37000,-37000
20200312,054930,群電凱基98購01,,,,,0.00,0.00,0,0,0,0,0,0,0,0,0,0,0,0,0
20200312,054931,緯穎凱基98購01,0.73,0.73,0.72,0.72,-0.37,-33.94,152000,3,110440,0,0,0,0,0,0,152000,152000,0,0
20200312,054932,台肥元大97購01,1.25,1.25,1.05,1.05,-0.30,-22.22,380000,11,430660,0,0,0,0,0,0,124000,256000,-132000,-132000
20200312,054933,南港元大97購01,0.55,0.55,0.40,0.40,-0.27,-40.3,3466000,20,1812740,0,0,0,0,0,0,3396000,70000,3326000,3326000
20200312,054934,金寶元大97購01,0.77,0.77,0.58,0.63,-0.24,-27.59,193000,5,131390,0,0,0,0,0,0,115000,78000,37000,37000
20200312,054935,華通元大98購03,0.67,0.69,0.61,0.64,-0.28,-30.43,40000,12,25590,0,0,0,0,0,0,40000,40000,0,0
20200312,054936,鴻海元大97購10,0.23,0.23,0.23,0.23,-0.24,-51.06,68000,1,15640,0,0,0,0,0,0,68000,0,68000,68000
20200312,054937,國巨元大97購03,0.49,0.49,0.29,0.29,-0.30,-50.85,462000,23,170950,0,0,0,0,0,0,265000,193000,72000,72000
20200312,054938,國巨元大97購04,0.59,0.59,0.34,0.34,-0.31,-47.69,263000,26,121480,0,0,0,0,0,0,61000,200000,-139000,-139000
20200312,054939,台積電元大97購15,0.61,0.61,0.38,0.38,-0.50,-56.82,180000,10,89450,0,0,0,0,0,0,50000,180000,-130000,-130000
20200312,05493P,華新科富邦99售02,0.45,0.57,0.45,0.54,+0.12,28.57,87000,6,44660,0,0,0,0,0,0,47000,30000,17000,17000
20200312,054940,台積電元大97購16,0.66,0.66,0.45,0.57,-0.23,-28.75,211000,11,123150,0,0,0,0,0,0,155000,106000,49000,49000
20200312,054941,凱美元大97購01,,,,,0.00,0.00,0,0,0,0,0,0,0,0,0,0,0,0,0
20200312,054942,凱美元大97購02,,,,,0.00,0.00,0,0,0,0,0,0,0,0,0,0,0,0,0
20200312,054943,群光元大97購01,1.30,1.33,1.19,1.25,-0.10,-7.41,593000,17,758530,0,0,0,0,0,0,334000,259000,75000,75000
20200312,054944,精元元大97購01,1.07,1.08,0.87,0.87,-0.32,-26.89,925000,27,947900,0,0,0,0,0,0,910000,15000,895000,895000
20200312,054945,正崴元大97購01,0.33,0.33,0.19,0.19,-0.22,-53.66,145000,7,43970,0,0,0,0,0,0,105000,40000,65000,65000
20200312,054946,億光元大97購01,1.09,1.09,0.76,0.78,-0.51,-39.53,232000,18,218420,0,0,0,0,0,0,143000,195000,-52000,-52000
20200312,054947,興勤元大97購01,0.36,0.36,0.32,0.32,-0.25,-43.86,28000,2,9960,0,0,0,0,0,0,25000,28000,-3000,-3000
20200312,054948,聯發科元大97購14,0.15,0.15,0.14,0.14,0.00,0.00,60000,2,8700,0,0,0,0,0,0,30000,30000,0,0
20200312,054949,奇力新元大98購01,0.22,0.22,0.21,0.21,0.00,0.00,20000,2,4250,0,0,0,0,0,0,15000,5000,10000,10000
20200312,05494P,華邦電統一95售02,2.20,2.20,2.20,2.20,+0.35,18.92,10000,1,22000,0,0,0,0,0,0,0,10000,-10000,-10000
20200312,054950,奇力新元大98購02,0.26,0.26,0.17,0.17,-0.14,-45.16,60000,2,13800,0,0,0,0,0,0,60000,0,60000,60000
20200312,054951,大毅元大97購01,2.61,2.61,2.36,2.36,-1.05,-30.79,25000,2,64000,0,0,0,0,0,0,25000,25000,0,0
20200312,054952,大毅元大97購02,2.49,2.49,2.10,2.10,-0.61,-22.51,88000,5,203840,0,0,0,0,0,0,88000,38000,50000,50000
20200312,054953,華新科元大97購05,,,,,0.00,0.00,0,0,0,0,0,0,0,0,0,0,0,0,0
20200312,054954,華新科元大97購06,0.25,0.25,0.24,0.24,-0.10,-29.41,17000,3,4190,0,0,0,0,0,0,0,17000,-17000,-17000
20200312,054955,宏達電元大98購01,0.89,0.89,0.76,0.76,-0.18,-19.15,73000,2,64320,0,0,0,0,0,0,0,73000,-73000,-73000
20200312,054956,宏盛元大97購01,0.30,0.30,0.30,0.30,-0.19,-38.78,30000,2,9000,0,0,0,0,0,0,0,30000,-30000,-30000
20200312,054957,興富發元大97購01,1.56,1.56,1.20,1.20,-0.51,-29.82,168000,11,233000,0,0,0,0,0,0,100000,68000,32000,32000
20200312,054958,亞光元大97購03,0.13,0.13,0.08,0.08,-0.10,-55.56,100000,5,9900,0,0,0,0,0,0,0,100000,-100000,-100000
20200312,054959,禾伸堂元大98購01,0.58,0.58,0.41,0.49,-0.12,-19.67,383000,12,193870,0,0,0,0,0,0,83000,373000,-290000,-290000
20200312,05495P,大立光統一95售07,2.82,2.96,2.82,2.90,+0.68,30.63,206000,5,597320,0,0,0,0,0,0,188000,15000,173000,173000
20200312,054960,新日興元大97購02,0.83,0.83,0.53,0.53,-0.58,-52.25,227000,9,131580,0,0,0,0,0,0,39000,188000,-149000,-149000
20200312,054961,玉晶光元大99購01,0.51,0.51,0.36,0.36,-0.19,-34.55,525000,25,222470,0,0,0,0,0,0,116000,409000,-293000,-293000
20200312,054962,玉晶光元大99購02,0.56,0.56,0.41,0.43,-0.22,-33.85,145000,5,69310,0,0,0,0,0,0,50000,95000,-45000,-45000
20200312,054963,牧德元大97購02,0.39,0.39,0.27,0.28,-0.21,-42.86,1001000,14,357880,0,0,0,0,0,0,849000,180000,669000,669000
20200312,054964,智易元大99購01,,,,,0.00,0.00,0,0,0,0,0,0,0,0,0,0,0,0,0
20200312,054965,健策元大98購04,0.26,0.26,0.26,0.26,-0.20,-43.48,7000,1,1820,0,0,0,0,0,0,0,7000,-7000,-7000
20200312,054966,貿聯元大98購02,0.16,0.16,0.16,0.16,0.00,0.00,6000,1,960,0,0,0,0,0,0,6000,0,6000,6000
20200312,054967,神達元大97購01,2.97,2.97,2.70,2.77,-1.16,-29.52,73000,8,214200,0,0,0,0,0,0,60000,13000,47000,47000
20200312,054968,佐登元大97購01,,,,,0.00,0.00,0,0,0,0,0,0,0,0,0,0,0,0,0
20200312,054969,亞翔元大97購01,1.21,1.21,0.99,0.99,-0.31,-23.85,81000,3,91610,0,0,0,0,0,0,61000,20000,41000,41000
20200312,05496P,聯詠統一95售04,,,,,0.00,0.00,0,0,0,0,0,0,0,0,0,0,0,0,0
20200312,054970,帆宣元大97購01,0.47,0.47,0.47,0.47,0.00,0.00,10000,1,4700,0,0,0,0,0,0,10000,0,10000,10000
20200312,054971,帆宣元大97購02,0.44,0.44,0.44,0.44,0.00,0.00,7000,1,3080,0,0,0,0,0,0,0,7000,-7000,-7000
20200312,054972,聯茂元大97購02,1.41,1.41,1.18,1.18,-0.63,-34.81,103000,4,137750,0,0,0,0,0,0,1000,102000,-101000,-101000
20200312,054973,台郡元大98購02,0.45,0.45,0.26,0.26,-0.31,-54.39,59000,10,21970,0,0,0,0,0,0,35000,24000,11000,11000
20200312,054974,台表科元大98購02,0.85,0.85,0.54,0.54,-0.46,-46.0,181000,19,136680,0,0,0,0,0,0,141000,40000,101000,101000
20200312,054975,福懋科元大97購01,1.68,1.68,1.35,1.35,-0.51,-27.42,179000,7,273510,0,0,0,0,0,0,69000,110000,-41000,-41000
20200312,054976,上証2X元富9A購01,0.95,0.95,0.88,0.88,-0.23,-20.72,40000,3,35900,0,0,0,0,0,0,0,40000,-40000,-40000
20200312,054977,SP黃豆元富9B購01,,,,,0.00,0.00,0,0,0,0,0,0,0,0,0,0,0,0,0
20200312,054978,堤維西元富97購01,0.25,0.25,0.22,0.22,-0.16,-42.11,270000,4,61500,0,0,0,0,0,0,0,270000,-270000,-270000
20200312,054979,南港元富97購01,0.23,0.23,0.22,0.22,-0.08,-26.67,20000,10,4550,0,0,0,0,0,0,20000,0,20000,20000
20200312,05497P,聯詠統一96售01,2.00,2.19,2.00,2.19,0.00,0.00,12000,2,24380,0,0,0,0,0,0,10000,2000,8000,8000
20200312,054980,國巨元富97購01,0.31,0.31,0.16,0.17,-0.16,-48.48,3547000,96,712480,0,0,0,0,0,0,951000,2552000,-1601000,-1601000
20200312,054981,國巨元富97購02,0.20,0.20,0.10,0.11,-0.11,-50.0,238000,16,35890,0,0,0,0,0,0,108000,130000,-22000,-22000
20200312,054982,國巨元富97購03,0.14,0.14,0.07,0.07,-0.08,-53.33,2487000,48,202420,0,0,0,0,0,0,652000,1736000,-1084000,-1084000
20200312,054983,國巨元富97購04,0.12,0.12,0.09,0.11,-0.04,-26.67,2958000,86,303320,0,0,0,0,0,0,0,0,0,0
20200312,054984,華泰元富97購01,0.12,0.14,0.12,0.14,-0.16,-53.33,50000,5,6400,0,0,0,0,0,0,0,50000,-50000,-50000
20200312,054985,光罩元富97購01,0.65,0.65,0.56,0.56,-0.25,-30.86,439000,18,261960,0,0,0,0,0,0,379000,0,379000,379000
20200312,054986,藍天元富97購01,,,,,0.00,0.00,0,0,0,0,0,0,0,0,0,0,0,0,0
20200312,054987,凱美元富97購01,0.07,0.07,0.05,0.05,-0.08,-61.54,80000,4,5250,0,0,0,0,0,0,10000,70000,-60000,-60000
20200312,054988,凱美元富97購02,0.08,0.08,0.06,0.06,-0.13,-68.42,58000,2,4240,0,0,0,0,0,0,0,58000,-58000,-58000
20200312,054989,精元元富97購01,0.99,1.00,0.85,0.90,-0.22,-19.64,489000,35,459590,0,0,0,0,0,0,317000,172000,145000,145000
20200312,05498P,友達元富95售02,0.56,0.62,0.53,0.62,+0.20,47.62,150000,3,85500,0,0,0,0,0,0,100000,50000,50000,50000
20200312,054990,凌陽元富97購01,,,,,0.00,0.00,0,0,0,0,0,0,0,0,0,0,0,0,0
20200312,054991,南亞科元富97購01,0.26,0.26,0.26,0.26,0.00,0.00,23000,1,5980,0,0,0,0,0,0,23000,23000,0,0
20200312,054992,南亞科元富97購02,,,,,0.00,0.00,0,0,0,0,0,0,0,0,0,0,0,0,0
20200312,054993,南亞科元富97購03,,,,,0.00,0.00,0,0,0,0,0,0,0,0,0,0,0,0,0
20200312,054994,建準元富97購01,0.43,0.47,0.42,0.45,-0.07,-13.46,20000,11,8770,0,0,0,0,0,0,19000,0,19000,19000
20200312,054995,宏盛元富97購01,,,,,0.00,0.00,0,0,0,0,0,0,0,0,0,0,0,0,0
20200312,054996,聯陽元富97購01,1.38,1.38,1.16,1.26,-0.27,-17.65,113000,15,145790,0,0,0,0,0,0,61000,52000,9000,9000
20200312,054997,文曄元富97購01,0.50,0.50,0.50,0.50,-0.06,-10.71,20000,2,10000,0,0,0,0,0,0,20000,0,20000,20000
20200312,054998,玉晶光元富97購02,0.58,0.58,0.45,0.45,-0.43,-48.86,7000,2,3800,0,0,0,0,0,0,5000,2000,3000,3000
20200312,054999,玉晶光元富97購03,0.44,0.44,0.31,0.33,-0.24,-42.11,753000,13,262040,0,0,0,0,0,0,3000,750000,-747000,-747000
20200312,05499P,聯詠元富95售02,1.17,1.21,1.17,1.19,+0.18,17.82,60000,5,71200,0,0,0,0,0,0,20000,40000,-20000,-20000
20200312,055000,玉晶光元富97購04,0.27,0.27,0.23,0.23,-0.22,-48.89,241000,2,55470,0,0,0,0,0,0,1000,240000,-239000,-239000
20200312,055001,京鼎元富97購01,0.30,0.32,0.23,0.23,-0.26,-53.06,25000,5,6800,0,0,0,0,0,0,25000,25000,0,0
20200312,055002,群創元富99購04,0.28,0.28,0.21,0.21,-0.16,-43.24,328000,7,71880,0,0,0,0,0,0,288000,40000,248000,248000
20200312,055003,群創元富99購05,0.25,0.25,0.19,0.19,-0.15,-44.12,200000,3,43000,0,0,0,0,0,0,100000,100000,0,0
20200312,055004,群創元富99購06,,,,,0.00,0.00,0,0,0,0,0,0,0,0,0,0,0,0,0
20200312,055005,晶相光元富97購01,1.04,1.04,1.04,1.04,-0.42,-28.77,50000,2,52000,0,0,0,0,0,0,50000,0,50000,50000
20200312,055006,晶相光元富9A購01,1.14,1.14,1.05,1.05,-0.41,-28.08,21000,3,22540,0,0,0,0,0,0,11000,10000,1000,1000
20200312,055007,晶相光元富9A購02,0.83,0.83,0.66,0.71,-0.20,-21.98,93000,7,72320,0,0,0,0,0,0,53000,40000,13000,13000
20200312,055008,隆達元富97購01,0.50,0.50,0.35,0.35,-0.24,-40.68,183000,15,81180,0,0,0,0,0,0,90000,93000,-3000,-3000
20200312,055009,合勤控元富97購01,0.16,0.16,0.12,0.12,-0.07,-36.84,200000,2,28000,0,0,0,0,0,0,0,200000,-200000,-200000
20200312,05500P,臺股指中信96售04,2.64,4.21,2.64,3.83,+1.52,65.8,379000,21,1396130,0,0,0,0,0,0,229000,150000,79000,79000
20200312,055010,佐登元富97購01,0.19,0.19,0.19,0.19,0.00,0.00,100000,1,19000,0,0,0,0,0,0,0,100000,-100000,-100000
20200312,055011,元翎元富97購01,0.24,0.24,0.17,0.17,-0.13,-43.33,434000,19,87570,0,0,0,0,0,0,22000,412000,-390000,-390000
20200312,055012,茂林元富97購01,0.44,0.44,0.27,0.28,-0.16,-36.36,397000,16,136290,0,0,0,0,0,0,317000,80000,237000,237000
20200312,055013,訊連元富97購01,1.12,1.15,0.85,0.93,-0.34,-26.77,1097000,58,1070750,0,0,0,0,0,0,655000,410000,245000,245000
20200312,055014,達興元富97購01,0.79,0.79,0.67,0.67,-0.26,-27.96,65000,2,45350,0,0,0,0,0,0,0,65000,-65000,-65000
20200312,055015,帆宣元富97購01,,,,,0.00,0.00,0,0,0,0,0,0,0,0,0,0,0,0,0
20200312,055016,群電元富97購01,,,,,0.00,0.00,0,0,0,0,0,0,0,0,0,0,0,0,0
20200312,055017,緯穎元富97購01,1.28,1.28,0.84,0.84,-0.54,-39.13,54000,9,58240,0,0,0,0,0,0,2000,52000,-50000,-50000
20200312,055018,緯穎元富97購02,0.91,0.91,0.53,0.53,-0.43,-44.79,129000,13,100900,0,0,0,0,0,0,60000,69000,-9000,-9000
20200312,055019,福懋科元富97購01,1.81,1.81,1.50,1.50,-0.35,-18.92,55000,6,90900,0,0,0,0,0,0,25000,30000,-5000,-5000
20200312,05501P,健策國票97售01,0.82,1.15,0.82,1.15,+0.37,47.44,685000,54,648850,0,0,0,0,0,0,472000,0,472000,472000
20200312,055020,上証2X國泰98購01,,,,,0.00,0.00,0,0,0,0,0,0,0,0,0,0,0,0,0
20200312,055021,亞德客國泰98購01,1.85,1.85,1.33,1.33,-0.71,-34.8,175000,12,284120,0,0,0,0,0,0,101000,70000,31000,31000
20200312,055022,精元國泰99購01,0.92,0.93,0.78,0.78,-0.26,-25.0,1195000,64,999610,0,0,0,0,0,0,410000,775000,-365000,-365000
20200312,055023,億光國泰98購01,0.69,0.69,0.45,0.52,-0.23,-30.67,418000,26,260560,0,0,0,0,0,0,308000,204000,104000,104000
20200312,055024,興勤國泰98購01,0.30,0.30,0.30,0.30,-0.15,-33.33,40000,2,12000,0,0,0,0,0,0,40000,0,40000,40000
20200312,055025,華新科國泰98購02,0.72,0.72,0.67,0.67,-0.10,-12.99,61000,3,43520,0,0,0,0,0,0,61000,8000,53000,53000
20200312,055026,健和興國泰98購01,0.75,0.75,0.54,0.54,0.00,0.00,70000,8,41670,0,0,0,0,0,0,3000,67000,-64000,-64000
20200312,055027,牧德國泰99購01,0.80,0.83,0.57,0.60,-0.34,-36.17,364000,24,244720,0,0,0,0,0,0,124000,237000,-113000,-113000
20200312,055028,佐登國泰98購01,0.69,0.69,0.69,0.69,-0.17,-19.77,1000,1,690,0,0,0,0,0,0,0,1000,-1000,-1000
20200312,055029,帆宣國泰99購01,0.42,0.42,0.40,0.40,-0.22,-35.48,20000,2,8200,0,0,0,0,0,0,0,20000,-20000,-20000
20200312,05502P,台表科國票97售01,,,,,0.00,0.00,0,0,0,0,0,0,0,0,0,0,0,0,0
20200312,055030,帆宣國泰99購02,,,,,0.00,0.00,0,0,0,0,0,0,0,0,0,0,0,0,0
20200312,055031,南港富邦99購01,0.19,0.19,0.14,0.14,0.00,0.00,85000,9,13950,0,0,0,0,0,0,0,85000,-85000,-85000
20200312,055032,億光富邦99購01,0.46,0.46,0.34,0.34,-0.18,-34.62,1250000,108,500200,0,0,0,0,0,0,0,1240000,-1240000,-1240000
20200312,055033,漢唐富邦98購01,0.12,0.12,0.12,0.12,0.00,0.00,10000,1,1200,0,0,0,0,0,0,10000,0,10000,10000
20200312,055034,建準富邦99購01,,,,,0.00,0.00,0,0,0,0,0,0,0,0,0,0,0,0,0
20200312,055035,興勤富邦98購01,,,,,0.00,0.00,0,0,0,0,0,0,0,0,0,0,0,0,0
20200312,055036,中工富邦9B購01,0.68,0.68,0.53,0.53,-0.18,-25.35,1235000,21,677250,0,0,0,0,0,0,1085000,140000,945000,945000
20200312,055037,宏盛富邦99購01,,,,,0.00,0.00,0,0,0,0,0,0,0,0,0,0,0,0,0
20200312,055038,華航富邦99購01,0.38,0.38,0.30,0.31,-0.11,-26.19,635000,26,197000,0,0,0,0,0,0,450000,185000,265000,265000
20200312,055039,神達富邦99購01,1.11,1.13,0.95,1.04,-0.25,-19.38,109000,8,114930,0,0,0,0,0,0,83000,25000,58000,58000
20200312,05503P,智邦日盛96售01,0.81,0.91,0.81,0.91,0.00,0.00,32000,4,27430,0,0,0,0,0,0,5000,27000,-22000,-22000
20200312,055040,台虹富邦99購01,0.76,0.76,0.76,0.76,-0.39,-33.91,2000,1,1520,0,0,0,0,0,0,2000,0,2000,2000
20200312,055041,致新富邦97購01,,,,,0.00,0.00,0,0,0,0,0,0,0,0,0,0,0,0,0
20200312,055042,得力永豐97購01,,,,,0.00,0.00,0,0,0,0,0,0,0,0,0,0,0,0,0
20200312,055043,中砂永豐97購01,,,,,0.00,0.00,0,0,0,0,0,0,0,0,0,0,0,0,0
20200312,055044,信錦永豐97購01,,,,,0.00,0.00,0,0,0,0,0,0,0,0,0,0,0,0,0
20200312,055045,台肥永豐97購01,,,,,0.00,0.00,0,0,0,0,0,0,0,0,0,0,0,0,0
20200312,055046,上銀永豐97購01,0.15,0.15,0.15,0.15,-0.18,-54.55,68000,1,10200,0,0,0,0,0,0,68000,0,68000,68000
20200312,055047,南港永豐97購01,,,,,0.00,0.00,0,0,0,0,0,0,0,0,0,0,0,0,0
20200312,055048,台積電永豐97購04,0.10,0.10,0.10,0.10,-0.06,-37.5,2000,2,200,0,0,0,0,0,0,1000,1000,0,0
20200312,055049,智邦永豐97購01,0.44,0.44,0.31,0.31,-0.16,-34.04,139000,3,55330,0,0,0,0,0,0,68000,71000,-3000,-3000
20200312,05504P,台積電凱基96售04,0.78,0.78,0.56,0.65,0.00,0.00,400000,8,229050,0,0,0,0,0,0,400000,50000,350000,350000
20200312,055050,敬鵬永豐97購01,,,,,0.00,0.00,0,0,0,0,0,0,0,0,0,0,0,0,0
20200312,055051,藍天永豐97購01,0.19,0.19,0.19,0.19,0.00,0.00,112000,4,21280,0,0,0,0,0,0,109000,3000,106000,106000
20200312,055052,凱美永豐97購01,,,,,0.00,0.00,0,0,0,0,0,0,0,0,0,0,0,0,0
20200312,055053,瑞昱永豐97購01,0.08,0.08,0.08,0.08,-0.10,-55.56,100000,1,8000,0,0,0,0,0,0,0,100000,-100000,-100000
20200312,055054,群光永豐97購01,0.43,0.43,0.36,0.38,-0.10,-20.83,56000,4,20520,0,0,0,0,0,0,50000,6000,44000,44000
20200312,055055,精元永豐97購01,0.46,0.46,0.37,0.37,-0.17,-31.48,375000,25,169770,0,0,0,0,0,0,279000,95000,184000,184000
20200312,055056,億光永豐97購01,0.21,0.21,0.16,0.16,0.00,0.00,20000,3,3500,0,0,0,0,0,0,0,20000,-20000,-20000
20200312,055057,興勤永豐97購01,,,,,0.00,0.00,0,0,0,0,0,0,0,0,0,0,0,0,0
20200312,055058,大毅永豐97購01,1.56,1.56,1.56,1.56,-0.33,-17.46,10000,1,15600,0,0,0,0,0,0,0,10000,-10000,-10000
20200312,055059,健和興永豐97購01,,,,,0.00,0.00,0,0,0,0,0,0,0,0,0,0,0,0,0
20200312,05505P,聯發科凱基96售09,2.06,3.00,2.06,2.74,+1.27,86.39,176000,11,409810,0,0,0,0,0,0,165000,11000,154000,154000
20200312,055060,聯陽永豐97購01,0.80,0.82,0.70,0.82,-0.09,-9.89,182000,16,132810,0,0,0,0,0,0,65000,117000,-52000,-52000
20200312,055061,聯詠永豐97購01,,,,,0.00,0.00,0,0,0,0,0,0,0,0,0,0,0,0,0
20200312,055062,文曄永豐97購01,0.24,0.24,0.24,0.24,-0.03,-11.11,10000,1,2400,0,0,0,0,0,0,10000,0,10000,10000
20200312,055063,玉晶光永豐99購01,0.30,0.30,0.23,0.24,-0.12,-33.33,458000,14,121180,0,0,0,0,0,0,42000,416000,-374000,-374000
20200312,055064,碩天永豐97購01,0.25,0.25,0.22,0.22,-0.13,-37.14,61000,5,14500,0,0,0,0,0,0,0,61000,-61000,-61000
20200312,055065,神達永豐97購01,0.72,0.72,0.52,0.64,-0.25,-28.09,196000,9,124650,0,0,0,0,0,0,7000,189000,-182000,-182000
20200312,055066,佐登永豐97購01,,,,,0.00,0.00,0,0,0,0,0,0,0,0,0,0,0,0,0
20200312,055067,禾聯碩永豐97購01,0.41,0.41,0.40,0.40,-0.05,-11.11,461000,11,187100,0,0,0,0,0,0,0,461000,-461000,-461000
20200312,055068,亞翔永豐97購01,,,,,0.00,0.00,0,0,0,0,0,0,0,0,0,0,0,0,0
20200312,055069,帆宣永豐97購01,,,,,0.00,0.00,0,0,0,0,0,0,0,0,0,0,0,0,0
20200312,05506P,茂林凱基96售03,0.66,0.95,0.66,0.91,+0.22,31.88,353000,13,291380,0,0,0,0,0,0,319000,34000,285000,285000
20200312,055070,聯茂永豐97購01,,,,,0.00,0.00,0,0,0,0,0,0,0,0,0,0,0,0,0
20200312,055071,群電永豐97購01,,,,,0.00,0.00,0,0,0,0,0,0,0,0,0,0,0,0,0
20200312,055072,康友永豐97購02,0.30,0.30,0.21,0.21,-0.21,-50.0,160000,10,38800,0,0,0,0,0,0,50000,100000,-50000,-50000
20200312,055073,易華電永豐97購01,,,,,0.00,0.00,0,0,0,0,0,0,0,0,0,0,0,0,0
20200312,055074,台虹永豐97購01,,,,,0.00,0.00,0,0,0,0,0,0,0,0,0,0,0,0,0
20200312,055075,南電永豐97購01,1.70,1.70,1.68,1.68,-0.80,-32.26,20000,2,33800,0,0,0,0,0,0,20000,0,20000,20000
20200312,055076,福懋科永豐97購01,0.65,0.65,0.57,0.57,-0.17,-22.97,20000,2,12200,0,0,0,0,0,0,10000,10000,0,0
20200312,055077,臺股指永豐97購02,,,,,0.00,0.00,0,0,0,0,0,0,0,0,0,0,0,0,0
20200312,055078,亞泥中信98購01,,,,,0.00,0.00,0,0,0,0,0,0,0,0,0,0,0,0,0
20200312,055079,台光電中信97購01,0.21,0.21,0.11,0.13,-0.12,-48.0,1370000,38,191100,0,0,0,0,0,0,100000,1230000,-1130000,-1130000
20200312,05507P,聯茂凱基96售02,0.66,0.80,0.66,0.80,+0.32,66.67,718000,16,516100,0,0,0,0,0,0,422000,360000,62000,62000
20200312,055080,正崴中信99購01,,,,,0.00,0.00,0,0,0,0,0,0,0,0,0,0,0,0,0
20200312,055081,健鼎中信97購01,0.07,0.07,0.07,0.07,-0.06,-46.15,35000,2,2450,0,0,0,0,0,0,35000,0,35000,35000
20200312,055082,台郡中信97購01,0.13,0.13,0.07,0.08,-0.11,-57.89,391000,65,35660,0,0,0,0,0,0,176000,182000,-6000,-6000
20200312,055083,康友中信97購01,0.25,0.25,0.20,0.20,-0.10,-33.33,110000,2,22500,0,0,0,0,0,0,0,110000,-110000,-110000
20200312,055084,國巨第一97購01,0.17,0.17,0.16,0.16,-0.16,-50.0,24000,6,3930,0,0,0,0,0,0,6000,18000,-12000,-12000
20200312,055085,大毅國票97購01,3.69,3.69,2.72,2.84,-1.46,-33.95,52000,5,163850,0,0,0,0,0,0,45000,27000,18000,18000
20200312,055086,華邦電亞東98購01,,,,,0.00,0.00,0,0,0,0,0,0,0,0,0,0,0,0,0
20200312,055087,瑞昱亞東97購01,,,,,0.00,0.00,0,0,0,0,0,0,0,0,0,0,0,0,0
20200312,055088,聯詠亞東97購01,0.34,0.34,0.29,0.29,-0.19,-39.58,53000,2,15620,0,0,0,0,0,0,53000,0,53000,53000
20200312,055089,金寶群益98購01,0.72,0.72,0.57,0.63,-0.27,-30.0,205000,10,136140,0,0,0,0,0,0,110000,95000,15000,15000
20200312,05508P,華通統一97售01,,,,,0.00,0.00,0,0,0,0,0,0,0,0,0,0,0,0,0
20200312,055090,國巨群益97購03,0.94,0.94,0.94,0.94,+0.01,1.08,98000,1,92120,0,0,0,0,0,0,98000,0,98000,98000
20200312,055091,微星群益97購01,0.52,0.52,0.43,0.43,-0.24,-35.82,23000,2,11870,0,0,0,0,0,0,23000,0,23000,23000
20200312,055092,開發金群益9B購01,0.53,0.53,0.53,0.53,-0.06,-10.17,98000,1,51940,0,0,0,0,0,0,98000,0,98000,98000
20200312,055093,京鼎群益98購01,0.58,0.61,0.58,0.61,-0.24,-28.24,11000,5,6510,0,0,0,0,0,0,11000,0,11000,11000
20200312,055094,智易群益98購01,0.23,0.23,0.23,0.23,-0.12,-34.29,5000,1,1150,0,0,0,0,0,0,0,5000,-5000,-5000
20200312,055095,啟碁群益98購01,0.49,0.49,0.33,0.33,-0.41,-55.41,12000,5,4990,0,0,0,0,0,0,0,12000,-12000,-12000
20200312,055096,緯穎群益97購01,1.31,1.31,0.76,0.92,-0.65,-41.4,76000,7,75860,0,0,0,0,0,0,26000,70000,-44000,-44000
20200312,055097,福懋科群益97購01,1.07,1.07,0.94,0.94,-0.24,-20.34,52000,4,53040,0,0,0,0,0,0,52000,0,52000,52000
20200312,055098,臺股指群益97購01,,,,,0.00,0.00,0,0,0,0,0,0,0,0,0,0,0,0,0
20200312,055099,可成日盛97購01,0.50,0.53,0.29,0.31,-0.43,-58.11,1006000,23,426740,0,0,0,0,0,0,601000,315000,286000,286000
20200312,05509P,智邦元富96售02,0.97,1.14,0.97,1.13,+0.23,25.56,359000,8,375750,0,0,0,0,0,0,60000,299000,-239000,-239000
20200312,055100,得力凱基97購01,,,,,0.00,0.00,0,0,0,0,0,0,0,0,0,0,0,0,0
20200312,055101,台肥凱基97購01,,,,,0.00,0.00,0,0,0,0,0,0,0,0,0,0,0,0,0
20200312,055102,上銀凱基98購01,0.96,0.96,0.69,0.73,-0.56,-43.41,545000,14,425350,0,0,0,0,0,0,30000,515000,-485000,-485000
20200312,055103,南港凱基97購01,,,,,0.00,0.00,0,0,0,0,0,0,0,0,0,0,0,0,0
20200312,055104,台達電凱基98購01,0.41,0.41,0.37,0.37,-0.17,-31.48,13000,2,5210,0,0,0,0,0,0,13000,0,13000,13000
20200312,055105,鴻海凱基98購05,0.36,0.36,0.36,0.36,-0.29,-44.62,85000,1,30600,0,0,0,0,0,0,85000,0,85000,85000
20200312,055106,台積電凱基98購05,0.35,0.35,0.23,0.29,-0.10,-25.64,300000,29,82530,0,0,0,0,0,0,96000,204000,-108000,-108000
20200312,055107,旺宏凱基98購04,0.27,0.27,0.20,0.20,-0.10,-33.33,99000,4,25210,0,0,0,0,0,0,76000,23000,53000,53000
20200312,055108,智邦凱基98購01,0.92,0.92,0.65,0.65,-0.31,-32.29,118000,11,98350,0,0,0,0,0,0,98000,20000,78000,78000
20200312,055109,正崴凱基98購01,,,,,0.00,0.00,0,0,0,0,0,0,0,0,0,0,0,0,0
20200312,05510P,燿華元富96售01,1.47,1.47,1.47,1.47,0.00,0.00,20000,1,29400,0,0,0,0,0,0,20000,0,20000,20000
20200312,055110,美律凱基98購02,,,,,0.00,0.00,0,0,0,0,0,0,0,0,0,0,0,0,0
20200312,055111,宏盛凱基97購01,,,,,0.00,0.00,0,0,0,0,0,0,0,0,0,0,0,0,0
20200312,055112,晶豪科凱基98購01,0.82,0.82,0.60,0.60,-0.29,-32.58,261000,25,194950,0,0,0,0,0,0,211000,50000,161000,161000
20200312,055113,大立光凱基98購06,0.25,0.25,0.17,0.17,-0.33,-66.0,110000,5,22500,0,0,0,0,0,0,40000,70000,-30000,-30000
20200312,055114,新日興凱基98購01,1.07,1.07,1.07,1.07,-0.23,-17.69,22000,1,23540,0,0,0,0,0,0,22000,0,22000,22000
20200312,055115,日月光凱基98購01,0.19,0.19,0.12,0.12,-0.16,-57.14,172000,4,31260,0,0,0,0,0,0,152000,22000,130000,130000
20200312,055116,康控凱基98購01,,,,,0.00,0.00,0,0,0,0,0,0,0,0,0,0,0,0,0
20200312,055117,臻鼎凱基98購02,0.24,0.24,0.21,0.21,-0.18,-46.15,27000,3,5730,0,0,0,0,0,0,0,27000,-27000,-27000
20200312,055118,嘉聯益凱基98購02,,,,,0.00,0.00,0,0,0,0,0,0,0,0,0,0,0,0,0
20200312,055119,力成凱基98購01,0.61,0.61,0.44,0.45,-0.44,-49.44,238000,11,121120,0,0,0,0,0,0,40000,198000,-158000,-158000
20200312,05511P,T50反1台新06售01,0.41,0.41,0.32,0.35,-0.10,-22.22,567000,8,229290,0,0,0,0,0,0,0,567000,-567000,-567000
20200312,055120,南港兆豐97購01,0.37,0.37,0.26,0.28,-0.18,-39.13,483000,41,143680,0,0,0,0,0,0,250000,223000,27000,27000
20200312,055121,鴻海兆豐97購03,,,,,0.00,0.00,0,0,0,0,0,0,0,0,0,0,0,0,0
20200312,055122,國巨兆豐98購01,0.51,0.51,0.28,0.31,-0.24,-43.64,198000,9,80430,0,0,0,0,0,0,23000,175000,-152000,-152000
20200312,055123,億光兆豐97購01,0.38,0.38,0.38,0.38,-0.15,-28.3,22000,2,8360,0,0,0,0,0,0,0,22000,-22000,-22000
20200312,055124,建準兆豐97購01,,,,,0.00,0.00,0,0,0,0,0,0,0,0,0,0,0,0,0
20200312,055125,智原兆豐97購01,,,,,0.00,0.00,0,0,0,0,0,0,0,0,0,0,0,0,0
20200312,055126,嘉澤兆豐97購01,0.18,0.18,0.18,0.18,0.00,0.00,5000,1,900,0,0,0,0,0,0,0,5000,-5000,-5000
20200312,055127,台虹兆豐97購01,1.59,1.59,1.59,1.59,-0.36,-18.46,10000,1,15900,0,0,0,0,0,0,10000,0,10000,10000
20200312,055128,致新兆豐97購01,0.31,0.35,0.31,0.32,-0.14,-30.43,311000,6,101390,0,0,0,0,0,0,198000,113000,85000,85000
20200312,055129,鈺齊兆豐97購01,0.35,0.35,0.32,0.32,-0.13,-28.89,120000,8,39520,0,0,0,0,0,0,105000,0,105000,105000
20200312,05512P,華新科台新97售01,0.55,0.68,0.55,0.68,0.00,0.00,93000,2,51930,0,0,0,0,0,0,0,93000,-93000,-93000
20200312,055130,京鼎康和97購01,,,,,0.00,0.00,0,0,0,0,0,0,0,0,0,0,0,0,0
20200312,055131,茂林康和97購01,0.31,0.31,0.31,0.31,-0.07,-18.42,17000,2,5270,0,0,0,0,0,0,15000,2000,13000,13000
20200312,055132,台虹康和97購01,0.58,0.58,0.53,0.53,-0.15,-22.06,280000,4,157550,0,0,0,0,0,0,280000,0,280000,280000
20200312,055133,致新康和97購01,,,,,0.00,0.00,0,0,0,0,0,0,0,0,0,0,0,0,0
20200312,055134,元油反國泰99購01,,,,,0.00,0.00,0,0,0,0,0,0,0,0,0,0,0,0,0
20200312,055135,聯發科富邦99購05,0.17,0.17,0.12,0.12,0.00,0.00,180000,2,26600,0,0,0,0,0,0,180000,0,180000,180000
20200312,055136,聯發科富邦99購06,,,,,0.00,0.00,0,0,0,0,0,0,0,0,0,0,0,0,0
20200312,055137,GIS富邦98購01,0.06,0.06,0.05,0.05,0.00,0.00,835000,2,46740,0,0,0,0,0,0,835000,0,835000,835000
20200312,055138,大毅永豐97購02,1.16,1.16,0.93,0.95,-0.61,-39.1,33000,4,34030,0,0,0,0,0,0,23000,10000,13000,13000
20200312,055139,欣興永豐97購01,0.13,0.13,0.13,0.13,0.00,0.00,30000,1,3900,0,0,0,0,0,0,30000,0,30000,30000
20200312,05513P,玉山金台新96售01,0.36,0.48,0.32,0.42,+0.08,23.53,376000,19,141920,0,0,0,0,0,0,201000,95000,106000,106000
20200312,055140,晶相光永豐97購01,0.38,0.38,0.36,0.36,-0.25,-40.98,70000,2,25400,0,0,0,0,0,0,70000,0,70000,70000
20200312,055141,牧德永豐98購02,,,,,0.00,0.00,0,0,0,0,0,0,0,0,0,0,0,0,0
20200312,055142,健策永豐98購01,0.31,0.31,0.31,0.31,-0.07,-18.42,35000,1,10850,0,0,0,0,0,0,35000,0,35000,35000
20200312,055143,臻鼎永豐97購01,,,,,0.00,0.00,0,0,0,0,0,0,0,0,0,0,0,0,0
20200312,055144,T50反1元大97購03,1.74,2.05,1.74,2.02,+0.48,31.17,313000,14,598260,0,0,0,0,0,0,239000,10000,229000,229000
20200312,055145,T50反1元大97購04,,,,,0.00,0.00,0,0,0,0,0,0,0,0,0,0,0,0,0
20200312,055146,華通元大98購04,0.64,0.64,0.37,0.41,-0.31,-43.06,83000,9,38320,0,0,0,0,0,0,28000,55000,-27000,-27000
20200312,055147,鴻海元大97購11,0.35,0.35,0.26,0.26,-0.25,-49.02,78000,2,26400,0,0,0,0,0,0,10000,68000,-58000,-58000
20200312,055148,鴻海元大98購02,0.50,0.50,0.46,0.46,-0.23,-33.33,60000,2,29600,0,0,0,0,0,0,60000,0,60000,60000
20200312,055149,國巨元大97購06,0.42,0.42,0.24,0.24,-0.26,-52.0,300000,11,104300,0,0,0,0,0,0,140000,140000,0,0
20200312,05514P,康舒永豐96售01,0.97,1.10,0.97,1.10,+0.26,30.95,200000,3,204500,0,0,0,0,0,0,150000,50000,100000,100000
20200312,055150,台積電元大98購04,0.30,0.30,0.23,0.27,-0.10,-27.03,585000,19,158390,0,0,0,0,0,0,252000,333000,-81000,-81000
20200312,055151,台積電元大98購05,0.25,0.25,0.20,0.21,-0.09,-30.0,72000,6,16160,0,0,0,0,0,0,0,0,0,0
20200312,055152,旺宏元大98購04,0.48,0.49,0.34,0.37,-0.23,-38.33,662000,15,262390,0,0,0,0,0,0,185000,477000,-292000,-292000
20200312,055153,台光電元大98購02,0.70,0.70,0.50,0.50,-0.26,-34.21,161000,6,98630,0,0,0,0,0,0,23000,153000,-130000,-130000
20200312,055154,聯發科元大98購01,0.42,0.42,0.28,0.29,-0.32,-52.46,116000,9,39920,0,0,0,0,0,0,35000,81000,-46000,-46000
20200312,055155,奇力新元大99購01,0.14,0.15,0.14,0.15,-0.10,-40.0,90000,9,13000,0,0,0,0,0,0,0,90000,-90000,-90000
20200312,055156,華新科元大99購02,0.28,0.28,0.18,0.22,-0.10,-31.25,70000,7,15200,0,0,0,0,0,0,0,70000,-70000,-70000
20200312,055157,晶豪科元大97購01,1.07,1.07,0.70,0.70,-0.41,-36.94,455000,41,388810,0,0,0,0,0,0,202000,284000,-82000,-82000
20200312,055158,亞光元大99購01,0.18,0.19,0.18,0.19,0.00,0.00,20000,2,3700,0,0,0,0,0,0,10000,10000,0,0
20200312,055159,玉晶光元大98購05,0.33,0.33,0.25,0.25,-0.16,-39.02,126000,4,32300,0,0,0,0,0,0,10000,116000,-106000,-106000
20200312,05515P,台積電群益96售03,3.43,4.36,3.43,3.77,+1.01,36.59,170000,8,660360,0,0,0,0,0,0,158000,11000,147000,147000
20200312,055160,玉晶光元大99購03,0.45,0.45,0.32,0.33,-0.15,-31.25,615000,26,230390,0,0,0,0,0,0,311000,299000,12000,12000
20200312,055161,貿聯元大98購03,0.39,0.40,0.38,0.38,-0.21,-35.59,259000,6,100980,0,0,0,0,0,0,3000,256000,-253000,-253000
20200312,055162,新唐元大97購01,,,,,0.00,0.00,0,0,0,0,0,0,0,0,0,0,0,0,0
20200312,055163,訊芯元大98購01,0.29,0.29,0.22,0.22,-0.12,-35.29,170000,5,38300,0,0,0,0,0,0,90000,80000,10000,10000
20200312,055164,矽創元大98購01,0.72,0.73,0.48,0.51,-0.21,-29.17,817000,16,453520,0,0,0,0,0,0,583000,234000,349000,349000
20200312,055165,元油反統一98購01,,,,,0.00,0.00,0,0,0,0,0,0,0,0,0,0,0,0,0
20200312,055166,台積電統一97購05,0.36,0.36,0.23,0.34,-0.10,-22.73,2424000,58,691320,0,0,0,0,0,0,610000,1631000,-1021000,-1021000
20200312,055167,友訊統一97購01,0.48,0.48,0.39,0.39,-0.23,-37.1,83000,3,33500,0,0,0,0,0,0,0,83000,-83000,-83000
20200312,055168,光罩統一98購01,0.65,0.65,0.54,0.54,-0.27,-33.33,70000,3,38940,0,0,0,0,0,0,60000,10000,50000,50000
20200312,055169,光罩統一99購01,0.16,0.16,0.16,0.16,-0.08,-33.33,100000,1,16000,0,0,0,0,0,0,0,100000,-100000,-100000
20200312,05516P,台積電元大96售12,,,,,0.00,0.00,0,0,0,0,0,0,0,0,0,0,0,0,0
20200312,055170,光磊統一97購01,,,,,0.00,0.00,0,0,0,0,0,0,0,0,0,0,0,0,0
20200312,055171,凱美統一97購01,,,,,0.00,0.00,0,0,0,0,0,0,0,0,0,0,0,0,0
20200312,055172,凱美統一97購02,,,,,0.00,0.00,0,0,0,0,0,0,0,0,0,0,0,0,0
20200312,055173,瑞昱統一97購01,,,,,0.00,0.00,0,0,0,0,0,0,0,0,0,0,0,0,0
20200312,055174,精元統一97購01,1.25,1.29,1.16,1.16,-0.28,-19.44,90000,24,112870,0,0,0,0,0,0,50000,10000,40000,40000
20200312,055175,建準統一97購01,0.52,0.52,0.41,0.41,-0.21,-33.87,66000,13,28740,0,0,0,0,0,0,66000,0,66000,66000
20200312,055176,大毅統一98購02,2.56,2.56,2.56,2.56,-0.24,-8.57,18000,1,46080,0,0,0,0,0,0,18000,0,18000,18000
20200312,055177,宏達電統一99購01,,,,,0.00,0.00,0,0,0,0,0,0,0,0,0,0,0,0,0
20200312,055178,晶豪科統一97購01,1.07,1.08,0.72,0.72,-0.48,-40.0,236000,27,231060,0,0,0,0,0,0,188000,0,188000,188000
20200312,055179,大立光統一97購04,0.46,0.46,0.33,0.33,-0.42,-56.0,146000,6,62900,0,0,0,0,0,0,0,146000,-146000,-146000
20200312,05517P,臻鼎元大96售01,3.25,3.94,3.25,3.94,+1.30,49.24,47000,3,181030,0,0,0,0,0,0,5000,42000,-37000,-37000
20200312,055180,文曄統一97購01,0.96,0.96,0.90,0.91,-0.12,-11.65,94000,10,88610,0,0,0,0,0,0,79000,15000,64000,64000
20200312,055181,日電貿統一97購01,,,,,0.00,0.00,0,0,0,0,0,0,0,0,0,0,0,0,0
20200312,055182,京鼎統一98購01,,,,,0.00,0.00,0,0,0,0,0,0,0,0,0,0,0,0,0
20200312,055183,聯鈞統一97購01,1.55,1.62,1.43,1.43,-0.67,-31.9,70000,7,108000,0,0,0,0,0,0,10000,60000,-50000,-50000
20200312,055184,群創統一98購02,0.18,0.18,0.18,0.18,-0.22,-55.0,99000,1,17820,0,0,0,0,0,0,99000,0,99000,99000
20200312,055185,晶相光統一97購01,0.88,0.88,0.88,0.88,-0.51,-36.69,2000,1,1760,0,0,0,0,0,0,0,2000,-2000,-2000
20200312,055186,正文統一97購01,0.70,0.70,0.52,0.53,-0.11,-17.19,276000,14,169720,0,0,0,0,0,0,138000,138000,0,0
20200312,055187,彩晶統一98購01,0.16,0.16,0.15,0.15,-0.23,-60.53,160000,2,25000,0,0,0,0,0,0,60000,100000,-40000,-40000
20200312,055188,亞翔統一97購01,0.87,0.87,0.80,0.80,-0.22,-21.57,40000,4,33800,0,0,0,0,0,0,10000,30000,-20000,-20000
20200312,055189,台虹統一97購01,,,,,0.00,0.00,0,0,0,0,0,0,0,0,0,0,0,0,0
20200312,05518P,T50反1凱基98售03,,,,,0.00,0.00,0,0,0,0,0,0,0,0,0,0,0,0,0
20200312,055190,華新科元富97購01,0.17,0.18,0.10,0.10,-0.11,-52.38,580000,13,68150,0,0,0,0,0,0,10000,570000,-560000,-560000
20200312,055191,牧德元富97購01,,,,,0.00,0.00,0,0,0,0,0,0,0,0,0,0,0,0,0
20200312,055192,世芯元富97購01,0.56,0.58,0.35,0.38,-0.21,-35.59,532000,19,220190,0,0,0,0,0,0,292000,240000,52000,52000
20200312,055193,世芯元富97購02,0.78,0.84,0.47,0.50,-0.32,-39.02,1336000,44,853070,0,0,0,0,0,0,191000,1040000,-849000,-849000
20200312,055194,昇陽半元富97購01,,,,,0.00,0.00,0,0,0,0,0,0,0,0,0,0,0,0,0
20200312,055195,昇陽半元富97購02,,,,,0.00,0.00,0,0,0,0,0,0,0,0,0,0,0,0,0
20200312,055196,致新元富97購01,0.62,0.62,0.46,0.47,-0.29,-38.16,263000,8,153340,0,0,0,0,0,0,204000,59000,145000,145000
20200312,055197,致新元富97購02,0.72,0.72,0.64,0.67,-0.08,-10.67,80000,5,54300,0,0,0,0,0,0,60000,20000,40000,40000
20200312,055198,奇力新第一97購01,0.10,0.10,0.07,0.10,-0.03,-23.08,821000,15,78300,0,0,0,0,0,0,0,821000,-821000,-821000
20200312,055199,國喬群益97購01,,,,,0.00,0.00,0,0,0,0,0,0,0,0,0,0,0,0,0
20200312,05519P,上証2X凱基98售01,2.00,2.05,2.00,2.05,+0.32,18.5,15000,3,30350,0,0,0,0,0,0,15000,0,15000,15000
20200312,055200,和大群益98購01,0.35,0.35,0.25,0.25,-0.14,-35.9,25000,3,7500,0,0,0,0,0,0,15000,10000,5000,5000
20200312,055201,興勤群益98購01,0.11,0.11,0.11,0.11,0.00,0.00,450000,6,49500,0,0,0,0,0,0,0,450000,-450000,-450000
20200312,055202,神達群益97購01,1.11,1.11,0.93,0.96,-0.41,-29.93,350000,8,345580,0,0,0,0,0,0,41000,309000,-268000,-268000
20200312,055203,建準中信97購01,,,,,0.00,0.00,0,0,0,0,0,0,0,0,0,0,0,0,0
20200312,055204,宏達電中信99購01,0.42,0.42,0.42,0.42,0.00,0.00,35000,1,14700,0,0,0,0,0,0,35000,0,35000,35000
20200312,055205,京鼎中信99購01,0.16,0.16,0.15,0.15,-0.11,-42.31,120000,2,19000,0,0,0,0,0,0,0,120000,-120000,-120000
20200312,055206,台虹中信97購01,0.44,0.44,0.33,0.33,-0.20,-37.74,201000,9,74620,0,0,0,0,0,0,160000,41000,119000,119000
20200312,055207,致新中信99購01,0.26,0.26,0.22,0.22,-0.11,-33.33,750000,4,173000,0,0,0,0,0,0,750000,0,750000,750000
20200312,055208,京鼎康和97購02,0.34,0.34,0.34,0.34,-0.09,-20.93,20000,1,6800,0,0,0,0,0,0,20000,0,20000,20000
20200312,055209,勤誠康和97購01,0.60,0.63,0.49,0.54,-0.18,-25.0,929000,17,486210,0,0,0,0,0,0,609000,320000,289000,289000
20200312,05520P,聯詠凱基96售01,1.70,1.89,1.67,1.73,+0.23,15.33,150000,18,267780,1000,1000,0,0,0,0,89000,61000,28000,28000
20200312,055210,S&P正2凱基97購01,0.11,0.11,0.08,0.11,-0.02,-15.38,532000,33,53220,0,0,0,0,0,0,0,151000,-151000,-151000
20200312,055211,A50反1凱基9A購01,0.86,0.96,0.86,0.91,+0.11,13.75,446000,13,404200,0,0,0,0,0,0,221000,225000,-4000,-4000
20200312,055212,和大凱基97購02,,,,,0.00,0.00,0,0,0,0,0,0,0,0,0,0,0,0,0
20200312,055213,大成鋼凱基98購01,0.57,0.59,0.52,0.56,-0.11,-16.42,470000,7,266950,0,0,0,0,0,0,225000,245000,-20000,-20000
20200312,055214,聯電凱基97購02,0.40,0.40,0.29,0.32,-0.16,-33.33,167000,20,55240,0,0,0,0,0,0,166000,167000,-1000,-1000
20200312,055215,智邦凱基98購02,0.86,0.86,0.86,0.86,-0.36,-29.51,10000,1,8600,0,0,0,0,0,0,0,10000,-10000,-10000
20200312,055216,友達凱基98購05,,,,,0.00,0.00,0,0,0,0,0,0,0,0,0,0,0,0,0
20200312,055217,緯創凱基97購02,0.24,0.24,0.24,0.24,-0.19,-44.19,12000,1,2880,0,0,0,0,0,0,12000,12000,0,0
20200312,055218,彩晶凱基99購01,,,,,0.00,0.00,0,0,0,0,0,0,0,0,0,0,0,0,0
20200312,055219,啟碁凱基98購01,,,,,0.00,0.00,0,0,0,0,0,0,0,0,0,0,0,0,0
20200312,05521P,創意永豐96售01,2.38,2.38,2.38,2.38,0.00,0.00,3000,1,7140,0,0,0,0,0,0,0,3000,-3000,-3000
20200312,055220,緯穎凱基98購02,1.53,1.53,1.33,1.35,-0.49,-26.63,313000,10,428120,0,0,0,0,0,0,269000,118000,151000,151000
20200312,055221,矽創凱基97購02,0.71,0.71,0.66,0.66,-0.36,-35.29,4000,2,2740,0,0,0,0,0,0,0,4000,-4000,-4000
20200312,055222,臺股指凱基97購05,0.14,0.14,0.06,0.06,-0.15,-71.43,410000,19,43750,0,0,0,0,0,0,165000,140000,25000,25000
20200312,055223,和大國票98購01,,,,,0.00,0.00,0,0,0,0,0,0,0,0,0,0,0,0,0
20200312,055224,鴻海國票99購02,0.08,0.08,0.06,0.06,-0.08,-57.14,619000,9,43530,0,0,0,0,0,0,339000,280000,59000,59000
20200312,055225,華邦電國票99購01,,,,,0.00,0.00,0,0,0,0,0,0,0,0,0,0,0,0,0
20200312,055226,聯發科國票97購05,,,,,0.00,0.00,0,0,0,0,0,0,0,0,0,0,0,0,0
20200312,055227,聯發科國票98購02,0.36,0.36,0.36,0.36,0.00,0.00,6000,1,2160,0,0,0,0,0,0,0,6000,-6000,-6000
20200312,055228,聯發科國票98購03,0.26,0.26,0.26,0.26,0.00,0.00,20000,1,5200,0,0,0,0,0,0,0,20000,-20000,-20000
20200312,055229,大毅國票97購02,4.17,4.17,3.11,3.11,-1.94,-38.42,27000,3,95670,0,0,0,0,0,0,22000,25000,-3000,-3000
20200312,05522P,友達元富96售02,0.80,0.99,0.80,0.99,+0.35,54.69,425000,9,364480,0,0,0,0,0,0,125000,300000,-175000,-175000
20200312,055230,大毅國票98購01,4.56,4.56,3.59,3.62,-1.43,-28.32,160000,7,596420,0,0,0,0,0,0,31000,149000,-118000,-118000
20200312,055231,大毅國票98購02,3.13,3.13,2.62,2.62,-0.79,-23.17,67000,4,195440,0,0,0,0,0,0,59000,28000,31000,31000
20200312,055232,泰碩國票98購01,1.19,1.22,1.01,1.07,-0.16,-13.01,583000,8,642940,0,0,0,0,0,0,332000,251000,81000,81000
20200312,055233,康友國票98購01,1.32,1.32,0.93,1.03,-0.49,-32.24,159000,24,178150,0,0,0,0,0,0,126000,114000,12000,12000
20200312,055234,昇陽半國票98購02,0.80,0.80,0.59,0.59,-0.36,-37.89,60000,3,42800,0,0,0,0,0,0,40000,20000,20000,20000
20200312,055235,金寶台新98購01,0.65,0.65,0.57,0.57,-0.25,-30.49,76000,5,46080,0,0,0,0,0,0,38000,38000,0,0
20200312,055236,建準台新98購01,0.37,0.41,0.37,0.41,-0.16,-28.07,116000,2,45960,0,0,0,0,0,0,76000,40000,36000,36000
20200312,055237,晶豪科台新97購01,0.61,0.61,0.57,0.60,-0.12,-16.67,130000,54,77090,0,0,0,0,0,0,120000,10000,110000,110000
20200312,055238,茂林台新97購01,0.59,0.59,0.44,0.44,-0.32,-42.11,41000,3,22340,0,0,0,0,0,0,0,41000,-41000,-41000
20200312,055239,帆宣台新97購01,0.15,0.15,0.15,0.15,-0.15,-50.0,10000,1,1500,0,0,0,0,0,0,0,10000,-10000,-10000
20200312,05523P,聯發科國票96售04,4.16,4.48,4.16,4.48,0.00,0.00,40000,4,171000,0,0,0,0,0,0,30000,0,30000,30000
20200312,055240,京元電元富97購01,0.44,0.44,0.40,0.42,-0.20,-32.26,42000,10,17620,0,0,0,0,0,0,32000,10000,22000,22000
20200312,055241,T50反1統一99購01,1.39,1.50,1.39,1.50,0.00,0.00,174000,19,251150,0,0,0,0,0,0,0,174000,-174000,-174000
20200312,055242,道瓊銀統一98購01,,,,,0.00,0.00,0,0,0,0,0,0,0,0,0,0,0,0,0
20200312,055243,國巨統一97購04,0.28,0.28,0.24,0.24,0.00,0.00,20000,3,5000,0,0,0,0,0,0,0,20000,-20000,-20000
20200312,055244,國巨統一98購01,1.12,1.12,0.76,0.76,-0.72,-48.65,68000,4,69360,0,0,0,0,0,0,32000,36000,-4000,-4000
20200312,055245,凱美統一99購01,,,,,0.00,0.00,0,0,0,0,0,0,0,0,0,0,0,0,0
20200312,055246,美律統一98購01,0.23,0.23,0.23,0.23,0.00,0.00,10000,1,2300,0,0,0,0,0,0,0,10000,-10000,-10000
20200312,055247,聯發科統一98購01,0.28,0.28,0.26,0.26,0.00,0.00,60000,2,16200,0,0,0,0,0,0,0,60000,-60000,-60000
20200312,055248,可成統一97購02,0.62,0.62,0.61,0.61,0.00,0.00,20000,2,12300,0,0,0,0,0,0,0,20000,-20000,-20000
20200312,055249,大毅統一99購01,0.81,0.81,0.63,0.65,-0.22,-25.29,78000,13,54240,0,0,0,0,0,0,60000,18000,42000,42000
20200312,05524P,瀚宇博國票97售02,2.57,2.85,2.57,2.85,+0.41,16.8,26000,3,69100,0,0,0,0,0,0,16000,10000,6000,6000
20200312,055250,華新科統一97購02,0.11,0.12,0.10,0.10,-0.14,-58.33,78000,3,8640,0,0,0,0,0,0,0,78000,-78000,-78000
20200312,055251,華新科統一99購01,0.53,0.53,0.35,0.36,-0.31,-46.27,490000,8,208630,0,0,0,0,0,0,0,490000,-490000,-490000
20200312,055252,新光金統一98購02,,,,,0.00,0.00,0,0,0,0,0,0,0,0,0,0,0,0,0
20200312,055253,大立光統一97購06,0.61,0.61,0.42,0.47,-0.49,-51.04,231000,14,123370,0,0,0,0,0,0,48000,183000,-135000,-135000
20200312,055254,聯詠統一97購03,1.02,1.02,0.91,0.91,-0.38,-29.46,184000,7,177720,0,0,0,0,0,0,126000,58000,68000,68000
20200312,055255,欣興統一97購02,0.27,0.27,0.19,0.20,-0.26,-56.52,339000,14,71750,0,0,0,0,0,0,68000,269000,-201000,-201000
20200312,055256,日電貿統一99購01,0.95,0.95,0.95,0.95,0.00,0.00,28000,1,26600,0,0,0,0,0,0,0,28000,-28000,-28000
20200312,055257,景碩統一97購01,1.09,1.09,0.92,0.92,0.00,0.00,156000,3,163320,0,0,0,0,0,0,100000,56000,44000,44000
20200312,055258,玉晶光統一97購03,0.41,0.41,0.30,0.34,-0.28,-45.16,125000,4,43100,0,0,0,0,0,0,10000,115000,-105000,-105000
20200312,055259,玉晶光統一9A購01,0.75,0.75,0.55,0.55,-0.49,-47.12,48000,6,34320,0,0,0,0,0,0,35000,13000,22000,22000
20200312,05525P,奇力新群益96售02,0.90,1.14,0.90,1.14,+0.28,32.56,95000,8,92560,0,0,0,0,0,0,31000,64000,-33000,-33000
20200312,055260,晶相光統一98購01,0.33,0.34,0.26,0.26,-0.13,-33.33,66000,3,20440,0,0,0,0,0,0,66000,0,66000,66000
20200312,055261,帆宣統一98購01,0.52,0.52,0.47,0.47,-0.29,-38.16,76000,5,37730,0,0,0,0,0,0,20000,56000,-36000,-36000
20200312,055262,台虹國泰98購01,1.18,1.19,0.94,0.94,-0.43,-31.39,270000,12,298000,0,0,0,0,0,0,180000,90000,90000,90000
20200312,055263,華新科富邦9A購01,0.20,0.20,0.12,0.12,-0.10,-45.45,1600000,51,239130,0,0,0,0,0,0,585000,638000,-53000,-53000
20200312,055264,國巨永豐98購01,0.43,0.43,0.43,0.43,0.00,0.00,5000,1,2150,0,0,0,0,0,0,0,5000,-5000,-5000
20200312,055265,玉晶光永豐98購03,0.24,0.24,0.16,0.16,-0.15,-48.39,665000,4,155600,0,0,0,0,0,0,65000,600000,-535000,-535000
20200312,055266,京鼎永豐97購01,,,,,0.00,0.00,0,0,0,0,0,0,0,0,0,0,0,0,0
20200312,055267,百和永豐97購01,,,,,0.00,0.00,0,0,0,0,0,0,0,0,0,0,0,0,0
20200312,055268,和大元大97購01,0.28,0.28,0.28,0.28,-0.15,-34.88,1000,1,280,0,0,0,0,0,0,0,1000,-1000,-1000
20200312,055269,和大元大97購02,0.36,0.36,0.36,0.36,-0.19,-34.55,35000,1,12600,0,0,0,0,0,0,35000,0,35000,35000
20200312,05526P,茂林群益96售03,,,,,0.00,0.00,0,0,0,0,0,0,0,0,0,0,0,0,0
20200312,055270,上銀元大97購03,1.97,1.97,1.37,1.37,-0.90,-39.65,170000,11,284950,0,0,0,0,0,0,98000,134000,-36000,-36000
20200312,055271,鴻海元大98購03,0.60,0.61,0.50,0.50,-0.23,-31.51,186000,7,101220,0,0,0,0,0,0,68000,118000,-50000,-50000
20200312,055272,國巨元大98購04,0.71,0.71,0.48,0.50,-0.25,-33.33,615000,38,332290,0,0,0,0,0,0,220000,385000,-165000,-165000
20200312,055273,華泰元大97購01,0.35,0.35,0.34,0.34,-0.06,-15.0,122000,2,42480,0,0,0,0,0,0,122000,0,122000,122000
20200312,055274,華泰元大97購02,,,,,0.00,0.00,0,0,0,0,0,0,0,0,0,0,0,0,0
20200312,055275,台積電元大97購19,0.36,0.36,0.24,0.31,-0.13,-29.55,340000,23,113170,0,0,0,0,0,0,159000,181000,-22000,-22000
20200312,055276,台積電元大97購20,0.48,0.49,0.33,0.40,-0.16,-28.57,1947000,93,811340,0,0,0,0,0,0,495000,1352000,-857000,-857000
20200312,055277,旺宏元大97購04,0.23,0.23,0.18,0.19,-0.22,-53.66,470000,6,94700,0,0,0,0,0,0,40000,430000,-390000,-390000
20200312,055278,旺宏元大98購05,0.45,0.45,0.29,0.29,-0.29,-50.0,265000,14,105250,0,0,0,0,0,0,200000,65000,135000,135000
20200312,055279,華邦電元大97購02,,,,,0.00,0.00,0,0,0,0,0,0,0,0,0,0,0,0,0
20200312,05527P,聯茂群益96售01,1.20,1.64,1.20,1.64,+0.46,38.98,701000,27,999670,0,0,0,0,0,0,348000,328000,20000,20000
20200312,055280,智邦元大97購01,2.09,2.09,1.70,1.70,-0.74,-30.33,27000,4,49680,0,0,0,0,0,0,2000,27000,-25000,-25000
20200312,055281,台光電元大98購03,0.62,0.62,0.40,0.41,-0.27,-39.71,228000,8,115260,0,0,0,0,0,0,10000,218000,-208000,-208000
20200312,055282,聯發科元大97購15,0.45,0.46,0.29,0.29,-0.34,-53.97,272000,8,91290,0,0,0,0,0,0,229000,43000,186000,186000
20200312,055283,聯發科元大97購16,0.50,0.50,0.31,0.34,-0.26,-43.33,585000,16,211730,0,0,0,0,0,0,87000,458000,-371000,-371000
20200312,055284,全新元大99購01,0.19,0.19,0.13,0.15,-0.14,-48.28,1106000,8,176080,0,0,0,0,0,0,600000,506000,94000,94000
20200312,055285,華新科元大99購03,0.38,0.38,0.24,0.25,-0.17,-40.48,253000,22,72370,0,0,0,0,0,0,90000,103000,-13000,-13000
20200312,055286,晶技元大98購03,1.49,1.49,0.97,0.98,-0.41,-29.5,691000,43,883640,0,0,0,0,0,0,624000,244000,380000,380000
20200312,055287,日電貿元大97購01,0.85,0.85,0.85,0.85,-0.60,-41.38,18000,1,15300,0,0,0,0,0,0,18000,0,18000,18000
20200312,055288,日電貿元大97購02,0.86,0.86,0.86,0.86,0.00,0.00,1000,1,860,0,0,0,0,0,0,0,1000,-1000,-1000
20200312,055289,泰碩元大98購01,0.74,0.74,0.56,0.63,-0.16,-20.25,939000,44,594460,0,0,0,0,0,0,385000,511000,-126000,-126000
20200312,05528P,臺股指群益96售01,,,,,0.00,0.00,0,0,0,0,0,0,0,0,0,0,0,0,0
20200312,055290,玉晶光元大98購08,0.43,0.43,0.27,0.27,-0.27,-50.0,30000,8,9680,0,0,0,0,0,0,6000,24000,-18000,-18000
20200312,055291,京鼎元大97購02,0.94,0.94,0.69,0.69,-0.45,-39.47,93000,2,70420,0,0,0,0,0,0,25000,68000,-43000,-43000
20200312,055292,聯鈞元大97購02,1.95,2.05,1.40,1.62,-0.73,-31.06,191000,13,317670,0,0,0,0,0,0,125000,66000,59000,59000
20200312,055293,晶相光元大97購01,1.11,1.11,1.11,1.11,-0.77,-40.96,5000,1,5550,0,0,0,0,0,0,0,5000,-5000,-5000
20200312,055294,智易元大98購01,0.34,0.34,0.27,0.27,-0.10,-27.03,171000,4,49630,0,0,0,0,0,0,20000,151000,-131000,-131000
20200312,055295,瀚宇博元大97購02,0.83,0.83,0.82,0.82,-0.40,-32.79,67000,4,55060,0,0,0,0,0,0,67000,17000,50000,50000
20200312,055296,康舒元大97購02,0.66,0.66,0.66,0.66,-0.32,-32.65,78000,2,51480,0,0,0,0,0,0,10000,68000,-58000,-58000
20200312,055297,啟碁元大97購01,,,,,0.00,0.00,0,0,0,0,0,0,0,0,0,0,0,0,0
20200312,055298,啟碁元大97購02,0.89,0.89,0.74,0.74,-0.27,-26.73,68000,6,54320,0,0,0,0,0,0,68000,0,68000,68000
20200312,055299,康友元大97購02,1.29,1.29,1.10,1.10,-0.26,-19.12,94000,11,112960,0,0,0,0,0,0,92000,16000,76000,76000
20200312,05529P,臺股指群益96售02,,,,,0.00,0.00,0,0,0,0,0,0,0,0,0,0,0,0,0
20200312,055300,緯穎元大98購01,1.93,1.95,1.30,1.50,-0.53,-26.11,608000,69,970610,0,0,0,0,0,0,92000,563000,-471000,-471000
20200312,055301,台虹元大97購01,1.51,1.53,1.17,1.30,-0.40,-23.53,220000,12,308710,0,0,0,0,0,0,127000,93000,34000,34000
20200312,055302,達方元大97購01,0.54,0.54,0.50,0.50,-0.41,-45.05,41000,3,21260,0,0,0,0,0,0,0,41000,-41000,-41000
20200312,055303,鈺齊元大97購01,0.40,0.41,0.28,0.28,-0.22,-44.0,1071000,14,366680,0,0,0,0,0,0,926000,145000,781000,781000
20200312,055304,瑞昱第一98購01,0.34,0.34,0.26,0.28,-0.23,-45.1,11000,3,3040,0,0,0,0,0,0,0,11000,-11000,-11000
20200312,055305,旺宏群益99購01,0.64,0.64,0.60,0.60,-0.20,-25.0,60000,2,38000,0,0,0,0,0,0,60000,0,60000,60000
20200312,055306,燿華群益97購01,0.21,0.21,0.14,0.14,-0.23,-62.16,120000,4,18220,0,0,0,0,0,0,120000,0,120000,120000
20200312,055307,瑞昱群益97購02,0.60,0.60,0.42,0.50,-0.44,-46.81,215000,11,106690,0,0,0,0,0,0,148000,67000,81000,81000
20200312,055308,聯發科群益97購04,0.18,0.18,0.18,0.18,-0.18,-50.0,20000,1,3600,0,0,0,0,0,0,0,20000,-20000,-20000
20200312,055309,冠德群益97購01,0.08,0.08,0.06,0.06,-0.04,-40.0,40000,4,2700,0,0,0,0,0,0,20000,20000,0,0
20200312,05530P,臺股指群益96售03,,,,,0.00,0.00,0,0,0,0,0,0,0,0,0,0,0,0,0
20200312,055310,聯詠群益97購02,0.65,0.65,0.60,0.61,-0.19,-23.75,332000,5,212310,0,0,0,0,0,0,312000,20000,292000,292000
20200312,055311,健策群益98購02,0.41,0.41,0.28,0.30,-0.28,-48.28,260000,9,90010,0,0,0,0,0,0,31000,229000,-198000,-198000
20200312,055312,台虹群益99購01,1.67,1.75,1.54,1.54,-0.46,-23.0,22000,3,36240,0,0,0,0,0,0,12000,10000,2000,2000
20200312,055313,南電群益97購01,2.16,2.16,2.11,2.11,-0.26,-10.97,45000,2,96700,0,0,0,0,0,0,10000,35000,-25000,-25000
20200312,055314,華邦電中信99購01,0.43,0.43,0.39,0.39,-0.29,-42.65,64000,3,26660,0,0,0,0,0,0,20000,44000,-24000,-24000
20200312,055315,晶技麥證97購01,1.41,1.47,0.80,0.81,-0.71,-46.71,420000,41,550720,276000,0,276000,0,0,0,276000,0,276000,276000
20200312,055316,上銀國票98購01,0.70,0.70,0.59,0.59,-0.62,-51.24,40000,4,25900,0,0,0,0,0,0,0,40000,-40000,-40000
20200312,055317,金寶國票98購01,0.42,0.42,0.30,0.35,-0.20,-36.36,180000,15,62510,0,0,0,0,0,0,40000,140000,-100000,-100000
20200312,055318,華通國票98購01,0.63,0.69,0.62,0.69,-0.24,-25.81,32000,13,20160,0,0,0,0,0,0,32000,0,32000,32000
20200312,055319,國巨國票98購03,1.37,1.37,0.78,0.78,-0.85,-52.15,1522000,5,1210490,0,0,0,0,0,0,25000,1497000,-1472000,-1472000
20200312,05531P,臺股指群益96售04,3.00,4.35,3.00,3.98,+1.48,59.2,125000,18,485340,0,0,0,0,0,0,78000,0,78000,78000
20200312,055320,建準國票98購01,0.74,0.74,0.74,0.74,0.00,0.00,30000,1,22200,0,0,0,0,0,0,0,30000,-30000,-30000
20200312,055321,大立光國票98購02,0.49,0.49,0.34,0.34,-0.48,-58.54,290000,6,102550,0,0,0,0,0,0,0,290000,-290000,-290000
20200312,055322,欣興國票97購06,0.53,0.54,0.41,0.41,-0.74,-64.35,158000,11,71230,0,0,0,0,0,0,36000,122000,-86000,-86000
20200312,055323,貿聯國票98購01,0.51,0.55,0.42,0.44,-0.26,-37.14,125000,18,62140,0,0,0,0,0,0,95000,65000,30000,30000
20200312,055324,TPK國票98購03,0.63,0.63,0.63,0.63,0.00,0.00,30000,1,18900,0,0,0,0,0,0,0,30000,-30000,-30000
20200312,055325,佐登國票98購01,,,,,0.00,0.00,0,0,0,0,0,0,0,0,0,0,0,0,0
20200312,055326,緯穎國票97購06,,,,,0.00,0.00,0,0,0,0,0,0,0,0,0,0,0,0,0
20200312,055327,致新國票98購01,1.28,1.28,1.13,1.13,-0.36,-24.16,73000,3,86290,0,0,0,0,0,0,16000,57000,-41000,-41000
20200312,055328,鈺齊國票98購01,0.12,0.12,0.08,0.08,-0.06,-42.86,371000,4,30700,0,0,0,0,0,0,41000,330000,-289000,-289000
20200312,055329,百和國票98購01,0.23,0.23,0.16,0.16,-0.19,-54.29,400000,3,77000,0,0,0,0,0,0,0,400000,-400000,-400000
20200312,05532P,臺股指群益96售05,4.00,5.10,4.00,5.10,+1.80,54.55,36000,9,162200,0,0,0,0,0,0,36000,0,36000,36000
20200312,055330,上銀兆豐98購02,1.55,1.55,1.15,1.15,-0.68,-37.16,241000,9,367520,0,0,0,0,0,0,236000,5000,231000,231000
20200312,055331,國巨兆豐99購01,1.30,1.30,0.90,0.90,-0.79,-46.75,90000,3,101000,0,0,0,0,0,0,0,90000,-90000,-90000
20200312,055332,奇力新兆豐98購01,0.32,0.32,0.21,0.21,-0.15,-41.67,125000,17,34740,0,0,0,0,0,0,125000,0,125000,125000
20200312,055333,晶豪科兆豐97購01,1.29,1.31,1.16,1.23,-0.44,-26.35,421000,36,521870,0,0,0,0,0,0,348000,73000,275000,275000
20200312,055334,禾伸堂兆豐97購01,,,,,0.00,0.00,0,0,0,0,0,0,0,0,0,0,0,0,0
20200312,055335,健策兆豐98購01,,,,,0.00,0.00,0,0,0,0,0,0,0,0,0,0,0,0,0
20200312,055336,茂林兆豐98購01,0.58,0.58,0.44,0.44,-0.17,-27.87,99000,6,45860,0,0,0,0,0,0,99000,0,99000,99000
20200312,055337,超眾兆豐98購01,0.24,0.24,0.20,0.20,-0.17,-45.95,98000,3,20200,0,0,0,0,0,0,78000,20000,58000,58000
20200312,055338,GIS兆豐97購01,,,,,0.00,0.00,0,0,0,0,0,0,0,0,0,0,0,0,0
20200312,055339,緯穎兆豐98購01,,,,,0.00,0.00,0,0,0,0,0,0,0,0,0,0,0,0,0
20200312,05533P,滬深2X富邦97售01,1.04,1.05,1.04,1.05,0.00,0.00,20000,3,20900,0,0,0,0,0,0,0,20000,-20000,-20000
20200312,055340,華新科日盛97購01,0.07,0.07,0.07,0.07,-0.19,-73.08,60000,1,4200,0,0,0,0,0,0,60000,0,60000,60000
20200312,055341,台達電凱基97購02,0.44,0.44,0.30,0.30,-0.21,-41.18,30000,3,12500,0,0,0,0,0,0,25000,5000,20000,20000
20200312,055342,鴻海凱基97購04,0.48,0.51,0.37,0.40,-0.28,-41.18,364000,9,166750,0,0,0,0,0,0,112000,253000,-141000,-141000
20200312,055343,國巨凱基97購03,0.97,0.97,0.97,0.97,-0.25,-20.49,1000,1,970,0,0,0,0,0,0,1000,0,1000,1000
20200312,055344,國巨凱基97購04,1.43,1.43,1.41,1.41,-0.69,-32.86,20000,2,28400,0,0,0,0,0,0,20000,0,20000,20000
20200312,055345,國巨凱基98購01,0.49,0.49,0.20,0.20,-0.39,-66.1,319000,27,113910,0,0,0,0,0,0,58000,221000,-163000,-163000
20200312,055346,國巨凱基98購02,0.93,0.93,0.59,0.59,-0.48,-44.86,478000,10,293540,0,0,0,0,0,0,430000,454000,-24000,-24000
20200312,055347,台積電凱基97購10,0.11,0.11,0.09,0.09,-0.07,-43.75,294000,10,31360,0,0,0,0,0,0,73000,120000,-47000,-47000
20200312,055348,旺宏凱基97購01,0.31,0.31,0.31,0.31,-0.18,-36.73,68000,1,21080,0,0,0,0,0,0,68000,0,68000,68000
20200312,055349,京元電凱基97購02,0.70,0.70,0.41,0.44,-0.38,-46.34,320000,25,174420,0,0,0,0,0,0,63000,244000,-181000,-181000
20200312,05534P,元油反元大96售06,0.05,0.09,0.05,0.09,0.00,0.00,81000,3,4090,0,0,0,0,0,0,0,0,0,0
20200312,055350,聯發科凱基97購02,0.31,0.31,0.31,0.31,-0.29,-48.33,1000,1,310,0,0,0,0,0,0,1000,0,1000,1000
20200312,055351,聯發科凱基97購03,0.30,0.30,0.30,0.30,-0.27,-47.37,92000,1,27600,0,0,0,0,0,0,92000,0,92000,92000
20200312,055352,奇力新凱基97購01,0.28,0.28,0.25,0.26,-0.09,-25.71,105000,14,27430,0,0,0,0,0,0,105000,0,105000,105000
20200312,055353,華新科凱基98購03,1.18,1.18,1.18,1.18,-0.33,-21.85,10000,1,11800,0,0,0,0,0,0,10000,10000,0,0
20200312,055354,宏達電凱基98購01,0.86,0.87,0.86,0.87,-0.09,-9.38,10000,2,8650,0,0,0,0,0,0,10000,0,10000,10000
20200312,055355,大立光凱基97購05,0.85,0.85,0.50,0.50,-0.53,-51.46,501000,23,294740,0,0,0,0,0,0,125000,368000,-243000,-243000
20200312,055356,大立光凱基97購06,1.50,1.50,0.83,0.89,0.00,0.00,75000,9,74600,0,0,0,0,0,0,0,75000,-75000,-75000
20200312,055357,欣興凱基97購04,,,,,0.00,0.00,0,0,0,0,0,0,0,0,0,0,0,0,0
20200312,055358,臻鼎凱基97購01,0.48,0.48,0.42,0.42,-0.36,-46.15,22000,3,9960,0,0,0,0,0,0,0,22000,-22000,-22000
20200312,055359,超眾凱基97購01,0.64,0.64,0.64,0.64,-0.04,-5.88,10000,1,6400,0,0,0,0,0,0,10000,0,10000,10000
20200312,05535P,台積電元大97售06,2.71,3.73,2.71,3.01,+0.59,24.38,165000,21,505110,0,0,0,0,0,0,60000,156000,-96000,-96000
20200312,055360,台表科凱基97購02,0.37,0.37,0.37,0.37,0.00,0.00,30000,1,11100,0,0,0,0,0,0,0,30000,-30000,-30000
20200312,055361,樺漢凱基97購01,0.56,0.56,0.37,0.38,-0.27,-41.54,86000,3,44790,0,0,0,0,0,0,68000,18000,50000,50000
20200312,055362,GIS凱基97購03,0.28,0.28,0.28,0.28,-0.23,-45.1,17000,1,4760,0,0,0,0,0,0,0,17000,-17000,-17000
20200312,055363,緯穎凱基98購03,1.75,1.76,1.61,1.61,-0.67,-29.39,32000,3,55240,0,0,0,0,0,0,32000,32000,0,0
20200312,055364,矽創凱基97購03,0.40,0.40,0.20,0.20,-0.22,-52.38,133000,6,41030,0,0,0,0,0,0,31000,52000,-21000,-21000
20200312,055365,華通元大97購03,1.54,1.55,1.01,1.01,-0.94,-48.21,223000,25,305440,0,0,0,0,0,0,153000,115000,38000,38000
20200312,055366,國巨元大98購05,1.83,1.83,1.18,1.18,-1.22,-50.83,70000,3,119200,0,0,0,0,0,0,10000,60000,-50000,-50000
20200312,055367,台積電元大97購23,1.17,1.17,0.84,1.05,-0.31,-22.79,810000,37,828490,0,0,0,0,0,0,324000,660000,-336000,-336000
20200312,055368,台積電元大97購24,0.60,0.60,0.35,0.45,-0.20,-30.77,1108000,36,512830,0,0,0,0,0,0,653000,435000,218000,218000
20200312,055369,友訊元大97購01,0.66,0.66,0.45,0.45,-0.36,-44.44,480000,10,248000,0,0,0,0,0,0,270000,195000,75000,75000
20200312,05536P,奇力新元大96售03,0.76,1.02,0.76,1.02,+0.25,32.47,374000,12,331390,0,0,0,0,0,0,126000,248000,-122000,-122000
20200312,055370,旺宏元大97購05,,,,,0.00,0.00,0,0,0,0,0,0,0,0,0,0,0,0,0
20200312,055371,正崴元大97購02,0.52,0.53,0.39,0.39,-0.23,-37.1,61000,3,28940,0,0,0,0,0,0,61000,0,61000,61000
20200312,055372,宏達電元大97購04,0.53,0.53,0.33,0.37,-0.17,-31.48,371000,9,162460,0,0,0,0,0,0,171000,200000,-29000,-29000
20200312,055373,聯詠元大97購03,1.42,1.42,1.26,1.26,-0.42,-25.0,230000,5,301370,0,0,0,0,0,0,130000,200000,-70000,-70000
20200312,055374,明泰元大97購01,1.28,1.28,1.09,1.12,-0.45,-28.66,233000,25,281720,0,0,0,0,0,0,155000,143000,12000,12000
20200312,055375,京鼎元大97購03,,,,,0.00,0.00,0,0,0,0,0,0,0,0,0,0,0,0,0
20200312,055376,群創元大01購01,0.90,0.90,0.80,0.81,-0.26,-24.3,237000,8,197300,0,0,0,0,0,0,83000,167000,-84000,-84000
20200312,055377,揚明光元大98購01,0.66,0.66,0.66,0.66,-0.22,-25.0,6000,1,3960,0,0,0,0,0,0,6000,0,6000,6000
20200312,055378,晶相光元大97購02,1.11,1.11,0.81,0.81,-0.35,-30.17,223000,18,219690,0,0,0,0,0,0,69000,154000,-85000,-85000
20200312,055379,牧德元大97購03,0.36,0.36,0.28,0.28,-0.22,-44.0,52000,3,17520,0,0,0,0,0,0,52000,22000,30000,30000
20200312,05537P,群創中信98售01,0.67,0.67,0.67,0.67,0.00,0.00,30000,1,20100,0,0,0,0,0,0,0,30000,-30000,-30000
20200312,055380,智易元大98購02,0.42,0.43,0.41,0.41,-0.46,-52.87,88000,3,37000,0,0,0,0,0,0,0,88000,-88000,-88000
20200312,055381,茂林元大97購02,1.76,1.76,1.21,1.21,-0.87,-41.83,173000,11,251430,0,0,0,0,0,0,83000,162000,-79000,-79000
20200312,055382,台郡元大99購01,1.77,1.77,1.77,1.77,-0.41,-18.81,3000,1,5310,0,0,0,0,0,0,3000,0,3000,3000
20200312,055383,GIS元大97購02,0.55,0.55,0.43,0.43,-0.29,-40.28,19000,2,8410,0,0,0,0,0,0,0,19000,-19000,-19000
20200312,055384,緯穎元大98購02,1.71,1.71,1.30,1.47,-0.56,-27.59,72000,3,117160,0,0,0,0,0,0,18000,72000,-54000,-54000
20200312,055385,昇陽半元大98購01,0.49,0.49,0.39,0.39,-0.21,-35.0,67000,5,31630,0,0,0,0,0,0,57000,10000,47000,47000
20200312,055386,致新元大97購02,0.61,0.61,0.51,0.54,-0.12,-18.18,213000,8,125820,0,0,0,0,0,0,160000,53000,107000,107000
20200312,055387,世紀鋼元大97購01,2.11,2.11,1.80,2.02,-0.22,-9.82,357000,16,688780,0,0,0,0,0,0,60000,297000,-237000,-237000
20200312,055388,華通統一97購03,0.99,0.99,0.81,0.81,-0.40,-33.06,329000,31,300470,0,0,0,0,0,0,329000,10000,319000,319000
20200312,055389,國巨統一98購02,1.26,1.26,1.04,1.04,-0.36,-25.71,87000,4,105520,0,0,0,0,0,0,77000,10000,67000,67000
20200312,05538P,玉晶光國票97售02,2.28,2.84,2.28,2.82,+0.72,34.29,251000,9,633430,0,0,0,0,0,0,130000,120000,10000,10000
20200312,055390,國巨統一98購03,4.56,4.58,3.10,3.44,-1.51,-30.51,50000,16,168660,0,0,0,0,0,0,12000,38000,-26000,-26000
20200312,055391,光罩統一97購02,0.32,0.32,0.23,0.23,-0.15,-39.47,530000,19,150920,0,0,0,0,0,0,520000,10000,510000,510000
20200312,055392,凱美統一97購03,0.12,0.12,0.12,0.12,-0.17,-58.62,5000,1,600,0,0,0,0,0,0,5000,0,5000,5000
20200312,055393,華新科統一97購03,0.77,0.77,0.48,0.48,0.00,0.00,191000,2,105600,0,0,0,0,0,0,0,191000,-191000,-191000
20200312,055394,健策統一97購01,0.46,0.46,0.32,0.32,-0.27,-45.76,100000,3,35920,0,0,0,0,0,0,100000,0,100000,100000
20200312,055395,泰鼎統一97購01,,,,,0.00,0.00,0,0,0,0,0,0,0,0,0,0,0,0,0
20200312,055396,瑞儀統一97購01,0.24,0.24,0.23,0.23,0.00,0.00,200000,2,47000,0,0,0,0,0,0,0,200000,-200000,-200000
20200312,055397,超眾統一97購02,,,,,0.00,0.00,0,0,0,0,0,0,0,0,0,0,0,0,0
20200312,055398,超眾統一97購03,0.31,0.31,0.30,0.30,-0.14,-31.82,55000,2,16980,0,0,0,0,0,0,55000,0,55000,55000
20200312,055399,超眾統一99購01,0.18,0.18,0.18,0.18,-0.08,-30.77,25000,1,4500,0,0,0,0,0,0,0,25000,-25000,-25000
20200312,05539P,鎧勝永豐96售01,1.39,1.69,1.39,1.69,0.00,0.00,41000,5,65020,0,0,0,0,0,0,1000,40000,-39000,-39000
20200312,055400,緯穎統一97購01,,,,,0.00,0.00,0,0,0,0,0,0,0,0,0,0,0,0,0
20200312,055401,亞光元富9A購01,0.17,0.17,0.15,0.15,0.00,0.00,15000,3,2440,0,0,0,0,0,0,8000,7000,1000,1000
20200312,055402,正文元富97購02,0.77,0.77,0.56,0.57,-0.17,-22.97,80000,7,53200,0,0,0,0,0,0,40000,40000,0,0
20200312,055403,泰鼎元富97購01,2.59,2.59,2.47,2.47,-0.55,-18.21,60000,2,154200,0,0,0,0,0,0,60000,0,60000,60000
20200312,055404,超眾元富97購01,,,,,0.00,0.00,0,0,0,0,0,0,0,0,0,0,0,0,0
20200312,055405,華泰國泰98購01,0.36,0.36,0.29,0.29,-0.26,-47.27,148000,2,49780,0,0,0,0,0,0,50000,98000,-48000,-48000
20200312,055406,大毅國泰99購01,1.56,1.56,1.20,1.30,-0.28,-17.72,200000,7,264440,0,0,0,0,0,0,170000,98000,72000,72000
20200312,055407,祥碩國泰98購01,,,,,0.00,0.00,0,0,0,0,0,0,0,0,0,0,0,0,0
20200312,055408,力成國泰98購01,1.87,1.88,1.55,1.56,-1.05,-40.23,134000,8,221630,0,0,0,0,0,0,85000,49000,36000,36000
20200312,055409,元黃金富邦01購01,1.32,1.32,1.24,1.24,-0.18,-12.68,286000,21,364030,0,0,0,0,0,0,49000,237000,-188000,-188000
20200312,05540P,亞德客凱基96售01,0.48,0.65,0.48,0.65,+0.22,51.16,137000,6,78930,0,0,0,0,0,0,132000,5000,127000,127000
20200312,055410,元油反富邦9A購01,,,,,0.00,0.00,0,0,0,0,0,0,0,0,0,0,0,0,0
20200312,055411,國巨富邦9A購02,0.80,0.80,0.11,0.20,-0.18,-47.37,1230000,69,355580,0,0,0,0,0,0,585000,162000,423000,423000
20200312,055412,旺宏富邦99購01,0.17,0.17,0.17,0.17,-0.24,-58.54,30000,1,5100,0,0,0,0,0,0,30000,0,30000,30000
20200312,055413,全新富邦98購01,,,,,0.00,0.00,0,0,0,0,0,0,0,0,0,0,0,0,0
20200312,055414,奇力新富邦9B購01,0.21,0.21,0.16,0.16,-0.12,-42.86,39000,3,6590,0,0,0,0,0,0,29000,10000,19000,19000
20200312,055415,禾伸堂富邦9B購01,0.31,0.31,0.25,0.28,+0.03,12.0,128000,12,35890,0,0,0,0,0,0,25000,103000,-78000,-78000
20200312,055416,欣興富邦98購01,0.25,0.25,0.19,0.19,-0.13,-40.62,237000,12,51840,0,0,0,0,0,0,99000,138000,-39000,-39000
20200312,055417,健策富邦98購02,0.13,0.13,0.09,0.10,-0.07,-41.18,1702000,29,172510,0,0,0,0,0,0,140000,1275000,-1135000,-1135000
20200312,055418,華通永豐97購01,0.18,0.18,0.08,0.08,-0.15,-65.22,50000,4,4500,0,0,0,0,0,0,0,50000,-50000,-50000
20200312,055419,國巨永豐97購03,0.28,0.28,0.28,0.28,0.00,0.00,20000,1,5600,0,0,0,0,0,0,20000,0,20000,20000
20200312,05541P,鴻海統一96售08,2.65,2.87,2.65,2.87,+0.61,26.99,27000,2,71990,0,0,0,0,0,0,27000,27000,0,0
20200312,055420,欣興永豐98購01,0.78,0.78,0.58,0.58,-0.35,-37.63,1421000,74,915700,0,0,0,0,0,0,3000,1309000,-1306000,-1306000
20200312,055421,玉晶光永豐98購04,0.62,0.63,0.50,0.50,-0.40,-44.44,433000,12,258490,0,0,0,0,0,0,373000,60000,313000,313000
20200312,055422,康控永豐97購01,0.33,0.33,0.23,0.23,-0.24,-51.06,25000,3,7250,0,0,0,0,0,0,10000,15000,-5000,-5000
20200312,055423,亞光亞東99購01,,,,,0.00,0.00,0,0,0,0,0,0,0,0,0,0,0,0,0
20200312,055424,聚陽群益98購01,0.40,0.40,0.35,0.35,-0.24,-40.68,105000,4,38620,0,0,0,0,0,0,83000,22000,61000,61000
20200312,055425,聚陽群益99購01,0.52,0.52,0.49,0.50,-0.22,-30.56,72000,3,35720,0,0,0,0,0,0,50000,22000,28000,28000
20200312,055426,旺宏群益99購02,,,,,0.00,0.00,0,0,0,0,0,0,0,0,0,0,0,0,0
20200312,055427,技嘉群益98購01,1.41,1.46,1.15,1.35,-0.20,-12.9,123000,15,165190,0,0,0,0,0,0,90000,59000,31000,31000
20200312,055428,友達群益9C購01,0.23,0.23,0.20,0.20,-0.12,-37.5,38000,5,8350,0,0,0,0,0,0,15000,23000,-8000,-8000
20200312,055429,華新科群益99購01,0.61,0.61,0.39,0.39,-0.31,-44.29,39000,8,20750,0,0,0,0,0,0,16000,33000,-17000,-17000
20200312,05542P,滬深2X元富96售01,2.06,2.34,2.06,2.31,+0.37,19.07,80000,6,178870,0,0,0,0,0,0,11000,69000,-58000,-58000
20200312,055430,宏達電群益97購01,0.80,0.80,0.75,0.75,-0.53,-41.41,40000,3,31500,0,0,0,0,0,0,0,40000,-40000,-40000
20200312,055431,和鑫群益98購01,0.24,0.24,0.24,0.24,-0.13,-35.14,11000,1,2640,0,0,0,0,0,0,11000,0,11000,11000
20200312,055432,臻鼎群益97購02,0.55,0.55,0.36,0.36,-0.74,-67.27,118000,5,46680,0,0,0,0,0,0,10000,108000,-98000,-98000
20200312,055433,嘉聯益群益99購01,0.54,0.55,0.47,0.47,-0.22,-31.88,50000,3,25800,0,0,0,0,0,0,20000,30000,-10000,-10000
20200312,055434,樺漢群益97購01,0.28,0.30,0.20,0.22,-0.24,-52.17,242000,11,59580,0,0,0,0,0,0,100000,67000,33000,33000
20200312,055435,佳世達中信99購01,0.48,0.48,0.37,0.37,-0.22,-37.29,253000,5,102700,0,0,0,0,0,0,139000,114000,25000,25000
20200312,055436,晶豪科中信99購01,0.71,0.71,0.48,0.48,-0.31,-39.24,35000,17,22820,0,0,0,0,0,0,30000,5000,25000,25000
20200312,055437,禾伸堂中信99購01,,,,,0.00,0.00,0,0,0,0,0,0,0,0,0,0,0,0,0
20200312,055438,鴻海國票98購01,0.30,0.33,0.22,0.22,-0.24,-52.17,302000,9,90860,0,0,0,0,0,0,18000,284000,-266000,-266000
20200312,055439,台表科國票98購02,0.32,0.32,0.20,0.20,-0.23,-53.49,162000,8,40840,0,0,0,0,0,0,0,162000,-162000,-162000
20200312,05543P,鴻海元富96售04,3.55,4.60,3.48,4.50,+1.48,49.01,434000,40,1771110,0,0,0,0,0,0,230000,194000,36000,36000
20200312,055440,矽力國票98購01,2.44,2.44,1.98,2.27,-0.63,-21.72,123000,10,279630,0,0,0,0,0,0,98000,25000,73000,73000
20200312,055441,緯穎國票98購01,2.83,2.83,2.83,2.83,-1.85,-39.53,6000,1,16980,0,0,0,0,0,0,6000,6000,0,0
20200312,055442,矽創國票98購02,1.13,1.17,0.77,0.77,-0.73,-48.67,305000,7,279150,0,0,0,0,0,0,36000,269000,-233000,-233000
20200312,055443,台虹國票98購01,1.74,1.82,1.69,1.69,-0.54,-24.22,24000,3,42360,0,0,0,0,0,0,10000,14000,-4000,-4000
20200312,055444,致新台新97購01,0.53,0.53,0.53,0.53,-0.08,-13.11,43000,3,22790,0,0,0,0,0,0,38000,5000,33000,33000
20200312,055445,旺宏統一99購01,0.47,0.47,0.47,0.47,0.00,0.00,11000,1,5170,0,0,0,0,0,0,11000,0,11000,11000
20200312,055446,奇力新統一9A購01,0.37,0.37,0.27,0.30,-0.15,-33.33,114000,7,33730,0,0,0,0,0,0,82000,32000,50000,50000
20200312,055447,華新科統一97購04,0.29,0.29,0.21,0.21,-0.15,-41.67,23000,8,5660,0,0,0,0,0,0,0,23000,-23000,-23000
20200312,055448,健策統一97購02,0.36,0.36,0.24,0.24,-0.23,-48.94,101000,2,35760,0,0,0,0,0,0,0,101000,-101000,-101000
20200312,055449,超眾統一9A購01,0.63,0.64,0.63,0.64,-0.27,-29.67,29000,2,18370,0,0,0,0,0,0,0,29000,-29000,-29000
20200312,05544P,台表科元富96售01,2.25,2.39,2.25,2.39,+0.25,11.68,131000,4,310290,0,0,0,0,0,0,20000,111000,-91000,-91000
20200312,055450,台積電元富97購01,0.30,0.30,0.18,0.26,-0.09,-25.71,942000,36,230050,0,0,0,0,0,0,149000,788000,-639000,-639000
20200312,055451,台積電元富97購02,0.08,0.08,0.05,0.07,-0.04,-36.36,930000,17,57000,0,0,0,0,0,0,0,930000,-930000,-930000
20200312,055452,台積電元富97購03,0.09,0.09,0.07,0.08,-0.05,-38.46,1572000,22,125990,0,0,0,0,0,0,410000,1162000,-752000,-752000
20200312,055453,華邦電元富97購01,,,,,0.00,0.00,0,0,0,0,0,0,0,0,0,0,0,0,0
20200312,055454,華邦電元富97購02,,,,,0.00,0.00,0,0,0,0,0,0,0,0,0,0,0,0,0
20200312,055455,健策國泰98購02,0.33,0.33,0.27,0.27,-0.15,-35.71,352000,6,97140,0,0,0,0,0,0,352000,0,352000,352000
20200312,055456,上銀富邦99購01,1.06,1.06,0.80,0.80,-0.43,-34.96,283000,11,256840,0,0,0,0,0,0,100000,183000,-83000,-83000
20200312,055457,聚陽永豐97購01,0.27,0.27,0.20,0.20,-0.15,-42.86,74000,5,17200,0,0,0,0,0,0,20000,54000,-34000,-34000
20200312,055458,燿華永豐98購01,0.28,0.28,0.24,0.24,-0.20,-45.45,269000,7,70080,0,0,0,0,0,0,27000,242000,-215000,-215000
20200312,055459,建準永豐97購03,,,,,0.00,0.00,0,0,0,0,0,0,0,0,0,0,0,0,0
20200312,05545P,台表科國泰98售01,1.79,2.08,1.79,2.08,+0.39,23.08,107000,12,209400,0,0,0,0,0,0,56000,31000,25000,25000
20200312,055460,華擎永豐97購01,1.20,1.28,1.14,1.17,-0.38,-24.52,95000,6,112890,0,0,0,0,0,0,22000,95000,-73000,-73000
20200312,055461,TPK永豐97購01,0.38,0.38,0.38,0.38,-0.09,-19.15,49000,1,18620,0,0,0,0,0,0,49000,0,49000,49000
20200312,055462,華邦電日盛97購01,0.16,0.17,0.12,0.12,0.00,0.00,150000,7,20700,0,0,0,0,0,0,0,150000,-150000,-150000
20200312,055463,國喬凱基97購01,,,,,0.00,0.00,0,0,0,0,0,0,0,0,0,0,0,0,0
20200312,055464,聚陽凱基97購01,0.17,0.18,0.17,0.18,-0.12,-40.0,124000,2,22180,0,0,0,0,0,0,124000,0,124000,124000
20200312,055465,和大凱基97購03,,,,,0.00,0.00,0,0,0,0,0,0,0,0,0,0,0,0,0
20200312,055466,台達電凱基97購03,0.61,0.61,0.53,0.53,-0.17,-24.29,52000,3,30520,0,0,0,0,0,0,42000,10000,32000,32000
20200312,055467,國巨凱基97購05,1.39,1.39,1.27,1.27,-0.51,-28.65,26000,3,35120,0,0,0,0,0,0,6000,26000,-20000,-20000
20200312,055468,智邦凱基97購04,0.93,0.95,0.55,0.64,-0.33,-34.02,109000,13,80840,0,0,0,0,0,0,99000,61000,38000,38000
20200312,055469,台光電凱基97購01,1.06,1.06,1.06,1.06,+0.14,15.22,10000,1,10600,0,0,0,0,0,0,10000,0,10000,10000
20200312,05546P,全新元大97售01,2.06,2.35,2.04,2.35,+0.41,21.13,454000,28,969250,0,0,0,0,0,0,249000,205000,44000,44000
20200312,055470,南亞科凱基97購01,0.48,0.48,0.34,0.34,-0.46,-57.5,138000,3,56540,0,0,0,0,0,0,60000,78000,-18000,-18000
20200312,055471,聯發科凱基97購04,,,,,0.00,0.00,0,0,0,0,0,0,0,0,0,0,0,0,0
20200312,055472,大立光凱基97購07,,,,,0.00,0.00,0,0,0,0,0,0,0,0,0,0,0,0,0
20200312,055473,禾伸堂凱基97購01,,,,,0.00,0.00,0,0,0,0,0,0,0,0,0,0,0,0,0
20200312,055474,欣興凱基97購05,0.63,0.65,0.47,0.48,-0.48,-50.0,163000,12,90410,0,0,0,0,0,0,5000,158000,-153000,-153000
20200312,055475,臻鼎凱基97購02,0.58,0.58,0.41,0.41,-0.44,-51.76,25000,3,12550,0,0,0,0,0,0,15000,10000,5000,5000
20200312,055476,台郡凱基97購02,,,,,0.00,0.00,0,0,0,0,0,0,0,0,0,0,0,0,0
20200312,055477,同欣電凱基98購01,0.73,0.73,0.51,0.57,-0.24,-29.63,145000,18,80920,0,0,0,0,0,0,25000,120000,-95000,-95000
20200312,055478,訊芯凱基97購01,0.29,0.29,0.28,0.28,-0.15,-34.88,66000,5,18580,0,0,0,0,0,0,66000,0,66000,66000
20200312,055479,GIS凱基97購04,,,,,0.00,0.00,0,0,0,0,0,0,0,0,0,0,0,0,0
20200312,05547P,群創元大96售03,1.07,1.24,1.06,1.24,+0.36,40.91,307000,13,351630,0,0,0,0,0,0,212000,245000,-33000,-33000
20200312,055480,元上證元大97購02,0.72,0.73,0.66,0.67,-0.17,-20.24,41000,12,28630,0,0,0,0,0,0,11000,30000,-19000,-19000
20200312,055481,聚陽元大97購01,0.61,0.61,0.53,0.53,-0.46,-46.46,58000,3,33990,0,0,0,0,0,0,15000,43000,-28000,-28000
20200312,055482,聚陽元大97購02,0.55,0.55,0.53,0.53,-0.30,-36.14,51000,2,27050,0,0,0,0,0,0,1000,50000,-49000,-49000
20200312,055483,和大元大97購03,0.23,0.23,0.16,0.16,-0.12,-42.86,40000,2,7100,0,0,0,0,0,0,0,40000,-40000,-40000
20200312,055484,華通元大97購04,0.64,0.64,0.56,0.56,-0.22,-28.21,100000,8,58300,0,0,0,0,0,0,100000,0,100000,100000
20200312,055485,國巨元大97購09,1.38,1.38,0.96,0.96,-0.62,-39.24,260000,9,303600,0,0,0,0,0,0,5000,250000,-245000,-245000
20200312,055486,國巨元大98購06,1.70,1.70,1.24,1.24,-0.86,-40.95,136000,4,202390,0,0,0,0,0,0,85000,61000,24000,24000
20200312,055487,國巨元大98購07,1.62,1.62,1.17,1.17,-0.53,-31.18,90000,4,139800,0,0,0,0,0,0,10000,90000,-80000,-80000
20200312,055488,華邦電元大98購01,0.29,0.29,0.29,0.29,-0.25,-46.3,10000,1,2900,0,0,0,0,0,0,0,10000,-10000,-10000
20200312,055489,瑞昱元大97購02,1.17,1.19,0.88,1.01,-0.66,-39.52,229000,16,241220,0,0,0,0,0,0,101000,219000,-118000,-118000
20200312,05548P,臺股指元大96售02,3.52,5.00,3.52,5.00,+1.70,51.52,31000,10,134520,0,0,0,0,0,0,24000,7000,17000,17000
20200312,055490,台光電元大97購01,0.76,0.76,0.42,0.42,-0.46,-52.27,126000,3,76670,0,0,0,0,0,0,49000,77000,-28000,-28000
20200312,055491,奇力新元大98購03,0.37,0.37,0.33,0.33,-0.16,-32.65,70000,3,23500,0,0,0,0,0,0,70000,0,70000,70000
20200312,055492,華新科元大97購08,0.38,0.40,0.27,0.30,-0.20,-40.0,55000,15,19740,0,0,0,0,0,0,4000,27000,-23000,-23000
20200312,055493,華新科元大97購09,0.70,0.70,0.44,0.45,-0.27,-37.5,557000,19,305130,0,0,0,0,0,0,342000,215000,127000,127000
20200312,055494,華新科元大98購01,0.68,0.68,0.46,0.46,-0.24,-34.29,257000,4,131560,0,0,0,0,0,0,10000,247000,-237000,-237000
20200312,055495,長榮航元大97購01,0.35,0.35,0.30,0.30,-0.13,-30.23,411000,6,129770,0,0,0,0,0,0,51000,360000,-309000,-309000
20200312,055496,高鐵元大97購02,0.26,0.26,0.25,0.26,-0.14,-35.0,69000,3,17840,0,0,0,0,0,0,69000,0,69000,69000
20200312,055497,開發金元大97購01,,,,,0.00,0.00,0,0,0,0,0,0,0,0,0,0,0,0,0
20200312,055498,大立光元大97購07,0.75,0.75,0.75,0.75,-0.99,-56.9,40000,2,30000,0,0,0,0,0,0,10000,30000,-20000,-20000
20200312,055499,大立光元大98購05,0.76,0.76,0.56,0.56,-0.68,-54.84,112000,9,65970,0,0,0,0,0,0,22000,112000,-90000,-90000
20200312,05549P,臺股指元大96售03,1.97,3.15,1.97,2.89,+1.16,67.05,624000,38,1498100,0,0,0,0,0,0,356000,253000,103000,103000
20200312,055500,京鼎元大97購04,0.54,0.54,0.54,0.54,0.00,0.00,68000,1,36720,0,0,0,0,0,0,0,68000,-68000,-68000
20200312,055501,創意元大97購01,1.05,1.05,0.70,0.70,-0.53,-43.09,62000,7,60300,0,0,0,0,0,0,60000,2000,58000,58000
20200312,055502,群創元大9C購03,0.26,0.26,0.24,0.24,0.00,0.00,99000,12,23860,0,0,0,0,0,0,0,99000,-99000,-99000
20200312,055503,健策元大98購05,0.41,0.41,0.20,0.30,-0.19,-38.78,213000,9,70990,0,0,0,0,0,0,84000,119000,-35000,-35000
20200312,055504,貿聯元大98購04,0.25,0.25,0.25,0.25,-0.05,-16.67,10000,1,2500,0,0,0,0,0,0,10000,0,10000,10000
20200312,055505,新唐元大97購02,,,,,0.00,0.00,0,0,0,0,0,0,0,0,0,0,0,0,0
20200312,055506,台郡元大99購02,1.08,1.08,0.79,0.80,-0.41,-33.88,472000,33,433700,0,0,0,0,0,0,381000,52000,329000,329000
20200312,055507,樺漢元大98購02,0.62,0.62,0.42,0.45,-0.25,-35.71,514000,12,239730,0,0,0,0,0,0,396000,168000,228000,228000
20200312,055508,矽力元大97購01,3.89,3.89,3.40,3.58,-1.20,-25.1,46000,6,168380,0,0,0,0,0,0,32000,10000,22000,22000
20200312,055509,訊芯元大97購03,0.38,0.38,0.26,0.26,-0.25,-49.02,104000,12,36240,0,0,0,0,0,0,103000,1000,102000,102000
20200312,05550P,臺股指元大96售07,4.63,5.55,4.63,5.55,+2.15,63.24,30000,5,154850,0,0,0,0,0,0,30000,0,30000,30000
20200312,055510,GIS元大97購03,,,,,0.00,0.00,0,0,0,0,0,0,0,0,0,0,0,0,0
20200312,055511,大立光兆豐97購02,0.31,0.31,0.22,0.26,-0.19,-42.22,716000,17,181700,0,0,0,0,0,0,524000,716000,-192000,-192000
20200312,055512,聯詠兆豐97購01,1.00,1.00,1.00,1.00,-0.29,-22.48,12000,1,12000,0,0,0,0,0,0,12000,0,12000,12000
20200312,055513,旺宏亞東98購01,,,,,0.00,0.00,0,0,0,0,0,0,0,0,0,0,0,0,0
20200312,055514,亞光麥證97購01,,,,,0.00,0.00,0,0,0,0,0,0,0,0,0,0,0,0,0
20200312,055515,聚陽中信9A購01,0.37,0.37,0.31,0.32,-0.16,-33.33,162000,8,54920,0,0,0,0,0,0,45000,117000,-72000,-72000
20200312,055516,上銀中信97購01,0.65,0.65,0.60,0.60,-0.24,-28.57,89000,3,55230,0,0,0,0,0,0,41000,48000,-7000,-7000
20200312,055517,國巨中信97購03,0.22,0.26,0.21,0.21,-0.30,-58.82,75000,4,17350,0,0,0,0,0,0,75000,0,75000,75000
20200312,055518,華新科中信99購01,0.19,0.19,0.12,0.12,-0.11,-47.83,3163000,76,436650,0,0,0,0,0,0,26000,2987000,-2961000,-2961000
20200312,055519,茂林中信99購01,0.67,0.67,0.62,0.62,-0.26,-29.55,80000,4,52900,0,0,0,0,0,0,20000,60000,-40000,-40000
20200312,05551P,電子類元大96售01,2.74,3.64,2.69,3.29,+0.90,37.66,63000,10,191770,0,0,0,0,0,0,58000,0,58000,58000
20200312,055520,矽力中信97購02,0.86,0.86,0.70,0.80,-0.09,-10.11,658000,57,510490,0,0,0,0,0,0,452000,200000,252000,252000
20200312,055521,S&P反1群益01購01,,,,,0.00,0.00,0,0,0,0,0,0,0,0,0,0,0,0,0
20200312,055522,道瓊反群益01購01,1.95,1.95,1.95,1.95,+0.51,35.42,1000,1,1950,0,0,0,0,0,0,1000,0,1000,1000
20200312,055523,道瓊銀群益9A購01,0.49,0.49,0.49,0.49,-0.13,-20.97,20000,2,9800,0,0,0,0,0,0,0,20000,-20000,-20000
20200312,055524,鴻海群益98購01,0.67,0.67,0.53,0.53,-0.32,-37.65,604000,4,391680,0,0,0,0,0,0,215000,389000,-174000,-174000
20200312,055525,國巨群益98購05,1.37,1.37,1.00,1.03,-0.48,-31.79,439000,8,582720,0,0,0,0,0,0,424000,21000,403000,403000
20200312,055526,台積電群益97購02,0.21,0.21,0.16,0.16,-0.11,-40.74,65000,6,11250,0,0,0,0,0,0,20000,45000,-25000,-25000
20200312,055527,旺宏群益99購03,0.81,0.81,0.81,0.81,-0.30,-27.03,11000,1,8910,0,0,0,0,0,0,11000,0,11000,11000
20200312,055528,華邦電群益97購01,,,,,0.00,0.00,0,0,0,0,0,0,0,0,0,0,0,0,0
20200312,055529,華邦電群益97購02,,,,,0.00,0.00,0,0,0,0,0,0,0,0,0,0,0,0,0
20200312,05552P,聯詠群益96售01,2.57,2.94,2.57,2.94,+0.52,21.49,78000,6,210060,0,0,0,0,0,0,48000,30000,18000,18000
20200312,055530,聯發科群益98購01,0.36,0.36,0.25,0.25,-0.28,-52.83,208000,4,62900,0,0,0,0,0,0,98000,110000,-12000,-12000
20200312,055531,華新科群益98購03,,,,,0.00,0.00,0,0,0,0,0,0,0,0,0,0,0,0,0
20200312,055532,中工群益98購01,,,,,0.00,0.00,0,0,0,0,0,0,0,0,0,0,0,0,0
20200312,055533,大立光群益97購03,0.31,0.31,0.31,0.31,-0.48,-60.76,20000,1,6200,0,0,0,0,0,0,0,20000,-20000,-20000
20200312,055534,晶技群益97購03,2.03,2.09,1.29,1.29,-0.99,-43.42,555000,46,1052750,0,0,0,0,0,0,456000,93000,363000,363000
20200312,055535,緯創群益98購01,0.20,0.20,0.15,0.15,-0.22,-59.46,57000,4,9550,0,0,0,0,0,0,0,57000,-57000,-57000
20200312,055536,嘉聯益群益99購02,0.53,0.53,0.53,0.53,-0.23,-30.26,11000,1,5830,0,0,0,0,0,0,11000,0,11000,11000
20200312,055537,康友群益97購03,0.92,0.96,0.68,0.73,-0.37,-33.64,349000,12,273680,0,0,0,0,0,0,251000,174000,77000,77000
20200312,055538,鴻海日盛97購04,0.32,0.33,0.21,0.21,-0.27,-56.25,1270000,44,343360,0,0,0,0,0,0,876000,554000,322000,322000
20200312,055539,億光台新97購01,,,,,0.00,0.00,0,0,0,0,0,0,0,0,0,0,0,0,0
20200312,05553P,智原群益96售01,2.22,2.22,2.22,2.22,+0.09,4.23,20000,1,44400,0,0,0,0,0,0,20000,0,20000,20000
20200312,055540,京鼎台新97購01,,,,,0.00,0.00,0,0,0,0,0,0,0,0,0,0,0,0,0
20200312,055541,聚陽凱基98購01,0.29,0.29,0.29,0.29,-0.15,-34.09,10000,1,2900,0,0,0,0,0,0,0,10000,-10000,-10000
20200312,055542,亞德客凱基97購01,,,,,0.00,0.00,0,0,0,0,0,0,0,0,0,0,0,0,0
20200312,055543,為升凱基97購01,,,,,0.00,0.00,0,0,0,0,0,0,0,0,0,0,0,0,0
20200312,055544,鴻海凱基97購05,0.05,0.05,0.05,0.05,-0.10,-66.67,4000,1,200,0,0,0,0,0,0,4000,0,4000,4000
20200312,055545,國巨凱基97購06,,,,,0.00,0.00,0,0,0,0,0,0,0,0,0,0,0,0,0
20200312,055546,台積電凱基97購12,0.24,0.24,0.24,0.24,-0.22,-47.83,40000,4,9600,0,0,0,0,0,0,0,40000,-40000,-40000
20200312,055547,台積電凱基97購13,0.57,0.57,0.37,0.48,-0.15,-23.81,292000,10,130900,0,0,0,0,0,0,157000,135000,22000,22000
20200312,055548,旺宏凱基97購02,,,,,0.00,0.00,0,0,0,0,0,0,0,0,0,0,0,0,0
20200312,055549,旺宏凱基97購03,0.44,0.44,0.44,0.44,0.00,0.00,50000,1,22000,0,0,0,0,0,0,0,50000,-50000,-50000
20200312,05554P,群創群益96售02,0.71,0.77,0.71,0.77,+0.26,50.98,348000,4,260230,0,0,0,0,0,0,210000,348000,-138000,-138000
20200312,055550,華邦電凱基97購03,,,,,0.00,0.00,0,0,0,0,0,0,0,0,0,0,0,0,0
20200312,055551,致茂凱基98購01,0.63,0.63,0.48,0.48,-0.35,-42.17,358000,26,206640,0,0,0,0,0,0,348000,10000,338000,338000
20200312,055552,瑞昱凱基97購02,0.49,0.49,0.32,0.36,0.00,0.00,68000,4,25580,0,0,0,0,0,0,0,68000,-68000,-68000
20200312,055553,聯發科凱基97購05,,,,,0.00,0.00,0,0,0,0,0,0,0,0,0,0,0,0,0
20200312,055554,聯發科凱基97購06,0.52,0.52,0.42,0.42,-0.53,-55.79,136000,2,63920,0,0,0,0,0,0,68000,68000,0,0
20200312,055555,全新凱基9A購01,,,,,0.00,0.00,0,0,0,0,0,0,0,0,0,0,0,0,0
20200312,055556,奇力新凱基98購03,0.14,0.14,0.14,0.14,-0.04,-22.22,789000,2,110460,0,0,0,0,0,0,789000,0,789000,789000
20200312,055557,華新科凱基97購01,0.67,0.67,0.60,0.60,-0.24,-28.57,15000,2,9700,0,0,0,0,0,0,5000,15000,-10000,-10000
20200312,055558,大立光凱基97購08,,,,,0.00,0.00,0,0,0,0,0,0,0,0,0,0,0,0,0
20200312,055559,大立光凱基97購09,0.45,0.45,0.39,0.39,0.00,0.00,15000,2,6150,0,0,0,0,0,0,0,15000,-15000,-15000
20200312,05555P,健策群益98售01,1.88,2.22,1.85,2.13,+0.38,21.71,1333000,35,2714560,0,0,0,0,0,0,984000,269000,715000,715000
20200312,055560,大立光凱基97購10,,,,,0.00,0.00,0,0,0,0,0,0,0,0,0,0,0,0,0
20200312,055561,奇鋐凱基97購01,0.57,0.57,0.51,0.51,-0.20,-28.17,18000,2,10200,0,0,0,0,0,0,1000,17000,-16000,-16000
20200312,055562,欣興凱基97購06,0.66,0.68,0.48,0.48,-0.85,-63.91,153000,5,95840,0,0,0,0,0,0,75000,78000,-3000,-3000
20200312,055563,智易凱基97購02,,,,,0.00,0.00,0,0,0,0,0,0,0,0,0,0,0,0,0
20200312,055564,茂林凱基98購01,0.46,0.46,0.29,0.30,-0.31,-50.82,170000,9,53700,0,0,0,0,0,0,0,170000,-170000,-170000
20200312,055565,祥碩凱基97購01,2.88,2.93,2.09,2.09,-0.76,-26.67,226000,19,618330,0,0,0,0,0,0,164000,92000,72000,72000
20200312,055566,台表科凱基97購03,0.41,0.41,0.37,0.37,-0.13,-26.0,146000,3,57660,0,0,0,0,0,0,66000,80000,-14000,-14000
20200312,055567,訊芯凱基98購02,0.04,0.04,0.04,0.04,-0.06,-60.0,15000,1,600,0,0,0,0,0,0,15000,0,15000,15000
20200312,055568,緯穎凱基97購02,,,,,0.00,0.00,0,0,0,0,0,0,0,0,0,0,0,0,0
20200312,055569,聚陽統一98購01,0.42,0.42,0.31,0.31,-0.24,-43.64,215000,3,74930,0,0,0,0,0,0,215000,0,215000,215000
20200312,05556P,全新國票96售04,2.24,2.55,2.24,2.55,+0.74,40.88,24000,3,57220,0,0,0,0,0,0,14000,20000,-6000,-6000
20200312,055570,華通統一98購03,0.58,0.58,0.45,0.45,-0.25,-35.71,491000,34,253870,0,0,0,0,0,0,436000,55000,381000,381000
20200312,055571,鴻海統一97購03,0.57,0.57,0.45,0.45,-0.32,-41.56,39000,4,19380,0,0,0,0,0,0,4000,35000,-31000,-31000
20200312,055572,鴻海統一98購04,1.31,1.31,1.10,1.10,0.00,0.00,58000,2,73880,0,0,0,0,0,0,10000,48000,-38000,-38000
20200312,055573,國巨統一97購06,0.85,0.87,0.58,0.68,-0.36,-34.62,366000,9,280220,0,0,0,0,0,0,126000,240000,-114000,-114000
20200312,055574,美律統一97購01,,,,,0.00,0.00,0,0,0,0,0,0,0,0,0,0,0,0,0
20200312,055575,華新科統一98購01,0.22,0.25,0.22,0.25,-0.33,-56.9,50000,4,12200,0,0,0,0,0,0,10000,40000,-30000,-30000
20200312,055576,嘉晶統一98購01,2.57,2.57,2.57,2.57,-0.43,-14.33,10000,1,25700,0,0,0,0,0,0,10000,0,10000,10000
20200312,055577,晶技統一97購02,1.88,1.95,1.16,1.37,-0.64,-31.84,311000,21,537590,0,0,0,0,0,0,311000,6000,305000,305000
20200312,055578,群創統一98購03,,,,,0.00,0.00,0,0,0,0,0,0,0,0,0,0,0,0,0
20200312,055579,健策統一9A購01,0.54,0.55,0.46,0.46,-0.18,-28.12,130000,14,64690,0,0,0,0,0,0,50000,80000,-30000,-30000
20200312,05557P,S&P500中信96售02,2.74,3.38,2.74,3.38,+0.95,39.09,19000,3,54200,0,0,0,0,0,0,8000,11000,-3000,-3000
20200312,055580,南茂統一97購01,,,,,0.00,0.00,0,0,0,0,0,0,0,0,0,0,0,0,0
20200312,055581,和大元大97購04,0.16,0.16,0.16,0.16,-0.13,-44.83,60000,1,9600,0,0,0,0,0,0,60000,0,60000,60000
20200312,055582,亞德客元大97購01,1.85,1.85,1.28,1.28,-0.81,-38.76,39000,4,66400,0,0,0,0,0,0,28000,39000,-11000,-11000
20200312,055583,國巨元大97購10,,,,,0.00,0.00,0,0,0,0,0,0,0,0,0,0,0,0,0
20200312,055584,國巨元大97購11,0.84,0.84,0.73,0.73,-0.37,-33.64,133000,6,104400,0,0,0,0,0,0,33000,100000,-67000,-67000
20200312,055585,國巨元大98購08,1.26,1.26,0.95,0.95,-0.36,-27.48,83000,3,101230,0,0,0,0,0,0,5000,78000,-73000,-73000
20200312,055586,旺宏元大98購06,0.62,0.62,0.41,0.41,-0.30,-42.25,48000,6,26900,0,0,0,0,0,0,32000,16000,16000,16000
20200312,055587,智邦元大97購02,1.85,1.94,1.85,1.94,-0.67,-25.67,26000,6,49900,0,0,0,0,0,0,26000,26000,0,0
20200312,055588,瑞昱元大97購03,0.80,0.80,0.48,0.53,-0.48,-47.52,231000,17,147130,0,0,0,0,0,0,133000,166000,-33000,-33000
20200312,055589,台光電元大98購04,1.92,1.92,1.37,1.37,-0.78,-36.28,106000,4,173640,0,0,0,0,0,0,23000,83000,-60000,-60000
20200312,05558P,鴻海麥證96售01,3.18,3.63,3.18,3.63,+0.82,29.18,362000,7,1207720,153000,209000,-56000,0,0,0,252000,247000,5000,5000
20200312,055590,聯發科元大98購02,0.67,0.67,0.46,0.46,-0.33,-41.77,131000,10,83040,0,0,0,0,0,0,13000,112000,-99000,-99000
20200312,055591,全新元大98購01,0.40,0.43,0.37,0.38,-0.32,-45.71,80000,5,31390,0,0,0,0,0,0,23000,57000,-34000,-34000
20200312,055592,奇力新元大97購07,0.66,0.66,0.60,0.60,-0.14,-18.92,103000,5,63250,0,0,0,0,0,0,103000,0,103000,103000
20200312,055593,華新科元大97購10,0.32,0.32,0.23,0.23,-0.21,-47.73,265000,3,64000,0,0,0,0,0,0,25000,240000,-215000,-215000
20200312,055594,華新科元大98購02,1.57,1.57,1.57,1.57,-0.36,-18.65,5000,1,7850,0,0,0,0,0,0,5000,0,5000,5000
20200312,055595,宏達電元大98購02,0.90,0.90,0.65,0.65,-0.39,-37.5,106000,7,82970,0,0,0,0,0,0,1000,105000,-104000,-104000
20200312,055596,新光金元大9B購02,0.49,0.49,0.44,0.44,-0.14,-24.14,65000,2,30600,0,0,0,0,0,0,40000,25000,15000,15000
20200312,055597,禾伸堂元大98購02,0.88,0.88,0.88,0.88,-0.17,-16.19,21000,2,18480,0,0,0,0,0,0,21000,21000,0,0
20200312,055598,欣興元大97購03,0.82,0.82,0.63,0.63,-0.69,-52.27,197000,8,143410,0,0,0,0,0,0,47000,150000,-103000,-103000
20200312,055599,TPK元大97購01,0.57,0.57,0.52,0.52,-0.17,-24.64,107000,3,56940,0,0,0,0,0,0,107000,0,107000,107000
20200312,05559P,臺股指麥證96售01,7.20,8.50,7.20,8.50,0.00,0.00,20000,2,157000,20000,0,20000,0,0,0,20000,0,20000,20000
20200312,055600,致伸元大97購02,0.15,0.15,0.11,0.11,0.00,0.00,20000,2,2600,0,0,0,0,0,0,10000,10000,0,0
20200312,055601,茂林元大97購03,0.77,0.79,0.49,0.49,-0.31,-38.75,376000,15,213380,0,0,0,0,0,0,130000,268000,-138000,-138000
20200312,055602,康控元大97購03,,,,,0.00,0.00,0,0,0,0,0,0,0,0,0,0,0,0,0
20200312,055603,超眾元大97購04,0.72,0.72,0.64,0.64,-0.37,-36.63,82000,3,53360,0,0,0,0,0,0,82000,0,82000,82000
20200312,055604,訊芯元大98購02,0.33,0.33,0.30,0.30,-0.17,-36.17,133000,9,41400,0,0,0,0,0,0,133000,0,133000,133000
20200312,055605,緯穎元大97購02,1.66,1.66,1.03,1.03,-0.69,-40.12,234000,20,311780,0,0,0,0,0,0,63000,224000,-161000,-161000
20200312,055606,矽創元大97購01,0.73,0.73,0.50,0.51,-0.32,-38.55,697000,20,408540,0,0,0,0,0,0,312000,454000,-142000,-142000
20200312,055607,華通康和97購01,,,,,0.00,0.00,0,0,0,0,0,0,0,0,0,0,0,0,0
20200312,055608,華邦電康和97購01,,,,,0.00,0.00,0,0,0,0,0,0,0,0,0,0,0,0,0
20200312,055609,旺宏國票99購01,0.39,0.39,0.27,0.27,-0.32,-54.24,13000,4,3840,0,0,0,0,0,0,0,13000,-13000,-13000
20200312,05560P,友達兆豐96售01,0.63,0.76,0.63,0.72,+0.22,44.0,210000,6,138010,0,0,0,0,0,0,100000,110000,-10000,-10000
20200312,055610,光磊國票98購01,,,,,0.00,0.00,0,0,0,0,0,0,0,0,0,0,0,0,0
20200312,055611,燿華國票98購02,,,,,0.00,0.00,0,0,0,0,0,0,0,0,0,0,0,0,0
20200312,055612,台光電國票97購04,1.43,1.43,1.34,1.34,-0.47,-25.97,43000,2,59150,0,0,0,0,0,0,26000,17000,9000,9000
20200312,055613,全新國票98購01,,,,,0.00,0.00,0,0,0,0,0,0,0,0,0,0,0,0,0
20200312,055614,華新科國票97購02,0.30,0.31,0.13,0.15,-0.25,-62.5,3484000,49,669480,0,0,0,0,0,0,464000,3020000,-2556000,-2556000
20200312,055615,宏達電國票99購02,0.56,0.56,0.36,0.38,-0.24,-38.71,282000,6,112360,0,0,0,0,0,0,265000,17000,248000,248000
20200312,055616,智原國票97購03,,,,,0.00,0.00,0,0,0,0,0,0,0,0,0,0,0,0,0
20200312,055617,TPK國票98購04,0.25,0.25,0.25,0.25,0.00,0.00,2000,1,500,0,0,0,0,0,0,2000,0,2000,2000
20200312,055618,麗豐國票98購01,,,,,0.00,0.00,0,0,0,0,0,0,0,0,0,0,0,0,0
20200312,055619,同欣電國票98購02,0.92,0.95,0.64,0.70,-0.44,-38.6,109000,10,84220,0,0,0,0,0,0,56000,53000,3000,3000
20200312,05561P,大立光兆豐96售02,0.86,0.86,0.86,0.86,0.00,0.00,56000,1,48160,0,0,0,0,0,0,0,56000,-56000,-56000
20200312,055620,樺漢國票98購01,1.30,1.32,1.25,1.32,-0.32,-19.51,29000,3,37380,0,0,0,0,0,0,10000,19000,-9000,-9000
20200312,055621,國巨國泰98購03,1.81,1.81,1.22,1.22,-1.48,-54.81,64000,8,93860,0,0,0,0,0,0,2000,62000,-60000,-60000
20200312,055622,群創國泰99購01,,,,,0.00,0.00,0,0,0,0,0,0,0,0,0,0,0,0,0
20200312,055623,貿聯國泰99購01,0.84,0.87,0.74,0.74,-0.16,-17.78,368000,5,305300,0,0,0,0,0,0,368000,42000,326000,326000
20200312,055624,聯發科富邦99購07,0.54,0.54,0.40,0.41,-0.24,-36.92,241000,12,110910,0,0,0,0,0,0,65000,166000,-101000,-101000
20200312,055625,亞光富邦98購01,,,,,0.00,0.00,0,0,0,0,0,0,0,0,0,0,0,0,0
20200312,055626,力山永豐97購01,,,,,0.00,0.00,0,0,0,0,0,0,0,0,0,0,0,0,0
20200312,055627,亞德客永豐97購02,,,,,0.00,0.00,0,0,0,0,0,0,0,0,0,0,0,0,0
20200312,055628,旺宏永豐97購01,0.33,0.33,0.33,0.33,0.00,0.00,30000,1,9900,0,0,0,0,0,0,0,30000,-30000,-30000
20200312,055629,華新科永豐97購04,0.07,0.07,0.05,0.05,0.00,0.00,75000,4,4050,0,0,0,0,0,0,55000,20000,35000,35000
20200312,05562P,鴻海元大96售16,2.83,3.28,2.83,3.28,+0.74,29.13,430000,15,1343350,0,0,0,0,0,0,209000,221000,-12000,-12000
20200312,055630,聯詠永豐97購02,,,,,0.00,0.00,0,0,0,0,0,0,0,0,0,0,0,0,0
20200312,055631,創意永豐98購01,0.17,0.17,0.17,0.17,-0.19,-52.78,2000,1,340,0,0,0,0,0,0,2000,0,2000,2000
20200312,055632,群創永豐98購01,,,,,0.00,0.00,0,0,0,0,0,0,0,0,0,0,0,0,0
20200312,055633,牧德永豐97購02,,,,,0.00,0.00,0,0,0,0,0,0,0,0,0,0,0,0,0
20200312,055634,訊芯永豐97購02,,,,,0.00,0.00,0,0,0,0,0,0,0,0,0,0,0,0,0
20200312,055635,緯穎永豐97購01,0.64,0.64,0.36,0.36,-0.37,-50.68,157000,5,73660,0,0,0,0,0,0,30000,127000,-97000,-97000
20200312,055636,元油反元富97購02,7.40,7.40,7.40,7.40,0.00,0.00,700000,3,5180000,0,0,0,0,0,0,700000,700000,0,0
20200312,055637,亞德客元富97購01,,,,,0.00,0.00,0,0,0,0,0,0,0,0,0,0,0,0,0
20200312,055638,上銀元富97購01,0.48,0.48,0.31,0.31,-0.30,-49.18,160000,3,57400,0,0,0,0,0,0,160000,20000,140000,140000
20200312,055639,上銀元富97購02,1.01,1.01,0.74,0.74,-0.70,-48.61,53000,5,45530,0,0,0,0,0,0,23000,33000,-10000,-10000
20200312,05563P,台積電元大97售07,,,,,0.00,0.00,0,0,0,0,0,0,0,0,0,0,0,0,0
20200312,055640,鴻海元富97購03,0.38,0.38,0.38,0.38,0.00,0.00,5000,1,1900,0,0,0,0,0,0,5000,0,5000,5000
20200312,055641,鴻海元富97購04,0.71,0.72,0.56,0.56,-0.30,-34.88,30000,3,19900,0,0,0,0,0,0,10000,20000,-10000,-10000
20200312,055642,廣宇元富97購01,0.73,0.75,0.55,0.55,-0.39,-41.49,110000,12,75200,0,0,0,0,0,0,40000,90000,-50000,-50000
20200312,055643,宏碁元富97購01,0.05,0.05,0.05,0.05,-0.03,-37.5,10000,1,500,0,0,0,0,0,0,0,10000,-10000,-10000
20200312,055644,致茂元富97購01,0.40,0.40,0.30,0.32,-0.19,-37.25,81000,14,27390,0,0,0,0,0,0,16000,65000,-49000,-49000
20200312,055645,技嘉元富97購01,0.92,0.96,0.72,0.81,-0.24,-22.86,679000,18,547330,0,0,0,0,0,0,512000,160000,352000,352000
20200312,055646,漢唐元富97購01,0.33,0.33,0.26,0.26,-0.13,-33.33,80000,5,21900,0,0,0,0,0,0,20000,70000,-50000,-50000
20200312,055647,義隆元富97購01,,,,,0.00,0.00,0,0,0,0,0,0,0,0,0,0,0,0,0
20200312,055648,可成元富97購01,0.70,0.70,0.48,0.50,-0.44,-46.81,112000,8,69110,0,0,0,0,0,0,102000,52000,50000,50000
20200312,055649,華新科元富97購03,0.40,0.79,0.21,0.22,-0.48,-68.57,233000,26,56020,0,0,0,0,0,0,233000,231000,2000,2000
20200312,05564P,玉晶光元大97售02,0.55,0.75,0.55,0.72,+0.20,38.46,723000,34,469590,0,0,0,0,0,0,686000,33000,653000,653000
20200312,055650,華新科元富98購01,0.35,0.35,0.21,0.22,-0.20,-47.62,151000,14,36500,0,0,0,0,0,0,109000,71000,38000,38000
20200312,055651,富邦金元富97購01,0.44,0.44,0.33,0.33,-0.22,-40.0,500000,4,199800,0,0,0,0,0,0,480000,20000,460000,460000
20200312,055652,聯詠元富01購01,0.71,0.71,0.71,0.71,-0.18,-20.22,40000,2,28400,0,0,0,0,0,0,30000,10000,20000,20000
20200312,055653,聯詠元富01購02,0.78,0.78,0.72,0.72,-0.20,-21.74,50000,4,38100,0,0,0,0,0,0,30000,20000,10000,10000
20200312,055654,景碩元富97購01,,,,,0.00,0.00,0,0,0,0,0,0,0,0,0,0,0,0,0
20200312,055655,群創元富99購07,0.13,0.13,0.10,0.12,-0.04,-25.0,53000,7,5550,0,0,0,0,0,0,0,0,0,0
20200312,055656,新唐元富97購01,,,,,0.00,0.00,0,0,0,0,0,0,0,0,0,0,0,0,0
20200312,055657,超眾元富97購02,0.64,0.64,0.51,0.51,-0.40,-43.96,82000,3,42960,0,0,0,0,0,0,46000,42000,4000,4000
20200312,055658,南電元富97購01,2.05,2.14,1.66,1.70,-1.21,-41.58,160000,6,323000,0,0,0,0,0,0,130000,30000,100000,100000
20200312,055659,百和元富97購01,,,,,0.00,0.00,0,0,0,0,0,0,0,0,0,0,0,0,0
20200312,05565P,鎧勝元大96售01,2.62,2.88,2.62,2.88,+0.42,17.07,39000,6,110870,0,0,0,0,0,0,9000,30000,-21000,-21000
20200312,055660,台光電兆豐97購01,0.58,0.58,0.46,0.46,-0.21,-31.34,365000,16,197790,0,0,0,0,0,0,325000,30000,295000,295000
20200312,055661,亞德客中信98購01,0.38,0.38,0.31,0.31,-0.15,-32.61,43000,2,13540,0,0,0,0,0,0,40000,3000,37000,37000
20200312,055662,上銀中信99購01,0.66,0.68,0.46,0.49,-0.39,-44.32,454000,23,275980,0,0,0,0,0,0,108000,346000,-238000,-238000
20200312,055663,崇越中信97購01,0.20,0.20,0.17,0.19,-0.10,-34.48,4108000,19,755320,0,0,0,0,0,0,4108000,0,4108000,4108000
20200312,055664,和大群益98購02,0.21,0.21,0.19,0.19,-0.21,-52.5,155000,2,30550,0,0,0,0,0,0,155000,0,155000,155000
20200312,055665,亞德客群益97購01,0.86,0.86,0.67,0.67,-0.51,-43.22,52000,5,38120,0,0,0,0,0,0,12000,40000,-28000,-28000
20200312,055666,鴻海群益97購05,,,,,0.00,0.00,0,0,0,0,0,0,0,0,0,0,0,0,0
20200312,055667,致茂群益98購01,0.96,0.96,0.76,0.76,-0.58,-43.28,475000,16,406280,0,0,0,0,0,0,377000,107000,270000,270000
20200312,055668,欣興群益97購01,0.82,0.82,0.65,0.68,-0.43,-38.74,363000,13,260720,0,0,0,0,0,0,45000,330000,-285000,-285000
20200312,055669,緯穎群益97購02,,,,,0.00,0.00,0,0,0,0,0,0,0,0,0,0,0,0,0
20200312,05566P,景碩永豐96售01,0.93,1.07,0.93,1.07,+0.24,28.92,20000,2,20000,0,0,0,0,0,0,10000,10000,0,0
20200312,055670,矽創群益98購02,0.74,0.74,0.74,0.74,-0.52,-41.27,3000,1,2220,0,0,0,0,0,0,3000,0,3000,3000
20200312,055671,世紀鋼群益97購01,3.32,3.32,2.56,3.10,-0.48,-13.41,354000,39,1050390,0,0,0,0,0,0,106000,248000,-142000,-142000
20200312,055672,國巨日盛97購02,1.38,1.38,0.70,0.70,-0.71,-50.35,320000,40,320670,0,0,0,0,0,0,125000,194000,-69000,-69000
20200312,055673,旺宏日盛97購01,,,,,0.00,0.00,0,0,0,0,0,0,0,0,0,0,0,0,0
20200312,055674,南港康和97購02,,,,,0.00,0.00,0,0,0,0,0,0,0,0,0,0,0,0,0
20200312,055675,亞德客凱基97購02,0.30,0.30,0.30,0.30,-0.34,-53.12,5000,1,1500,0,0,0,0,0,0,5000,5000,0,0
20200312,055676,亞德客凱基97購03,0.65,0.65,0.41,0.42,-0.33,-44.0,70000,5,41710,0,0,0,0,0,0,70000,5000,65000,65000
20200312,055677,喬山凱基97購01,,,,,0.00,0.00,0,0,0,0,0,0,0,0,0,0,0,0,0
20200312,055678,上銀凱基97購02,0.47,0.47,0.32,0.33,-0.33,-50.0,181000,6,61770,0,0,0,0,0,0,31000,150000,-119000,-119000
20200312,055679,華通凱基99購01,0.32,0.32,0.24,0.24,-0.17,-41.46,533000,54,130700,0,0,0,0,0,0,0,533000,-533000,-533000
20200312,05567P,致伸群益96售01,1.89,1.99,1.89,1.99,+0.27,15.7,31000,3,59610,0,0,0,0,0,0,20000,11000,9000,9000
20200312,055680,美律凱基99購01,0.25,0.25,0.25,0.25,-0.21,-45.65,45000,1,11250,0,0,0,0,0,0,0,45000,-45000,-45000
20200312,055681,奇鋐凱基98購03,0.50,0.50,0.40,0.41,-0.16,-28.07,340000,26,159370,0,0,0,0,0,0,140000,200000,-60000,-60000
20200312,055682,智原凱基98購02,0.12,0.12,0.12,0.12,-0.04,-25.0,299000,3,35880,0,0,0,0,0,0,0,299000,-299000,-299000
20200312,055683,晶技凱基99購01,1.01,1.03,0.67,0.68,-0.34,-33.33,1026000,62,859260,0,0,0,0,0,0,372000,730000,-358000,-358000
20200312,055684,京鼎凱基97購01,0.33,0.33,0.33,0.33,-0.23,-41.07,40000,1,13200,0,0,0,0,0,0,40000,0,40000,40000
20200312,055685,日月光凱基97購02,,,,,0.00,0.00,0,0,0,0,0,0,0,0,0,0,0,0,0
20200312,055686,致伸凱基97購02,,,,,0.00,0.00,0,0,0,0,0,0,0,0,0,0,0,0,0
20200312,055687,瀚宇博凱基97購01,0.76,0.76,0.62,0.66,-0.36,-35.29,36000,3,26680,0,0,0,0,0,0,34000,6000,28000,28000
20200312,055688,力成凱基98購02,0.52,0.52,0.38,0.38,-0.29,-43.28,330000,10,143100,0,0,0,0,0,0,275000,55000,220000,220000
20200312,055689,台郡凱基99購01,,,,,0.00,0.00,0,0,0,0,0,0,0,0,0,0,0,0,0
20200312,05568P,台積電統一96售03,1.15,1.42,1.15,1.40,+0.40,40.0,747000,15,1006730,0,0,0,0,0,0,528000,279000,249000,249000
20200312,055690,矽力凱基97購02,0.76,0.76,0.66,0.66,-0.53,-44.54,78000,17,58500,0,0,0,0,0,0,57000,21000,36000,36000
20200312,055691,訊芯凱基97購02,0.10,0.10,0.08,0.08,-0.13,-61.9,18000,2,1640,0,0,0,0,0,0,8000,18000,-10000,-10000
20200312,055692,緯穎凱基97購03,,,,,0.00,0.00,0,0,0,0,0,0,0,0,0,0,0,0,0
20200312,055693,南茂凱基97購01,0.52,0.52,0.42,0.43,-0.16,-27.12,726000,16,332000,0,0,0,0,0,0,466000,260000,206000,206000
20200312,055694,光罩國票98購01,0.78,0.78,0.62,0.63,-0.28,-30.77,384000,17,269570,0,0,0,0,0,0,325000,150000,175000,175000
20200312,055695,大毅國票98購03,3.87,3.87,3.21,3.21,-1.12,-25.87,35000,3,120850,0,0,0,0,0,0,35000,20000,15000,15000
20200312,055696,華新科國票98購01,0.30,0.30,0.18,0.18,-0.17,-48.57,38000,3,9400,0,0,0,0,0,0,0,38000,-38000,-38000
20200312,055697,牧德國票98購01,0.63,0.63,0.35,0.35,-0.41,-53.95,146000,11,71320,0,0,0,0,0,0,50000,96000,-46000,-46000
20200312,055698,茂林國票98購03,0.51,0.51,0.36,0.36,-0.41,-53.25,223000,8,96730,0,0,0,0,0,0,98000,125000,-27000,-27000
20200312,055699,康控國票97購04,0.35,0.35,0.29,0.29,-0.29,-50.0,130000,2,39500,0,0,0,0,0,0,0,130000,-130000,-130000
20200312,05569P,漢唐統一97售01,1.14,1.24,1.13,1.24,+0.15,13.76,376000,9,434300,0,0,0,0,0,0,52000,324000,-272000,-272000
20200312,055700,緯穎國泰98購02,1.67,1.67,1.08,1.08,-0.89,-45.18,101000,8,150850,0,0,0,0,0,0,60000,41000,19000,19000
20200312,055701,亞德客富邦99購01,0.71,0.71,0.52,0.52,-0.26,-33.33,153000,18,97840,0,0,0,0,0,0,40000,113000,-73000,-73000
20200312,055702,美律富邦98購01,,,,,0.00,0.00,0,0,0,0,0,0,0,0,0,0,0,0,0
20200312,055703,緯穎富邦98購01,0.34,0.34,0.20,0.22,-0.15,-40.54,231000,23,61310,0,0,0,0,0,0,5000,225000,-220000,-220000
20200312,055704,亞德客永豐97購04,0.23,0.23,0.19,0.19,0.00,0.00,35000,4,7100,0,0,0,0,0,0,0,35000,-35000,-35000
20200312,055705,微星永豐97購01,0.32,0.32,0.32,0.32,0.00,0.00,7000,2,2240,0,0,0,0,0,0,7000,0,7000,7000
20200312,055706,大立光永豐97購03,0.06,0.13,0.05,0.10,-0.06,-37.5,1563000,115,94790,0,0,0,0,0,0,300000,1140000,-840000,-840000
20200312,055707,聯鈞永豐98購01,1.01,1.01,0.74,0.74,-0.36,-32.73,30000,3,26160,0,0,0,0,0,0,10000,20000,-10000,-10000
20200312,055708,茂林永豐97購02,0.27,0.27,0.27,0.27,-0.09,-25.0,162000,2,43740,0,0,0,0,0,0,162000,0,162000,162000
20200312,055709,深中小元大97購03,,,,,0.00,0.00,0,0,0,0,0,0,0,0,0,0,0,0,0
20200312,05570P,聯發科統一96售04,4.09,4.69,4.09,4.69,0.00,0.00,44000,5,196040,0,0,0,0,0,0,0,44000,-44000,-44000
20200312,055710,亞德客元大97購03,1.28,1.28,0.81,0.85,-0.61,-41.78,165000,8,178060,0,0,0,0,0,0,152000,96000,56000,56000
20200312,055711,上銀元大97購04,1.11,1.11,0.74,0.74,-0.62,-45.59,210000,13,191840,0,0,0,0,0,0,139000,121000,18000,18000
20200312,055712,金寶元大97購02,0.51,0.51,0.37,0.37,-0.26,-41.27,138000,4,56260,0,0,0,0,0,0,70000,68000,2000,2000
20200312,055713,國巨元大98購09,,,,,0.00,0.00,0,0,0,0,0,0,0,0,0,0,0,0,0
20200312,055714,智邦元大97購03,1.39,1.39,0.96,1.05,-0.50,-32.26,185000,6,198480,0,0,0,0,0,0,72000,123000,-51000,-51000
20200312,055715,智邦元大97購04,2.85,2.85,2.26,2.26,-0.73,-24.41,60000,5,136730,0,0,0,0,0,0,10000,59000,-49000,-49000
20200312,055716,致茂元大97購01,1.06,1.06,0.82,0.82,-0.54,-39.71,205000,12,198390,0,0,0,0,0,0,202000,2000,200000,200000
20200312,055717,聯發科元大97購19,0.38,0.38,0.24,0.24,0.00,0.00,142000,5,46160,0,0,0,0,0,0,0,142000,-142000,-142000
20200312,055718,可成元大97購02,0.61,0.64,0.41,0.46,-0.34,-42.5,284000,11,134890,0,0,0,0,0,0,254000,143000,111000,111000
20200312,055719,可成元大97購03,1.20,1.20,0.71,0.77,-0.63,-45.0,602000,29,518740,0,0,0,0,0,0,222000,457000,-235000,-235000
20200312,05571P,大立光統一96售03,2.37,2.37,2.27,2.36,+0.73,44.79,105000,3,239870,0,0,0,0,0,0,89000,16000,73000,73000
20200312,055720,宏達電元大97購05,,,,,0.00,0.00,0,0,0,0,0,0,0,0,0,0,0,0,0
20200312,055721,聯詠元大97購04,0.36,0.36,0.36,0.36,-0.11,-23.4,14000,2,5040,0,0,0,0,0,0,14000,0,14000,14000
20200312,055722,聯鈞元大97購03,1.68,1.68,1.20,1.30,-0.64,-32.99,263000,12,398930,0,0,0,0,0,0,99000,164000,-65000,-65000
20200312,055723,康控元大97購04,0.32,0.32,0.22,0.22,-0.22,-50.0,73000,5,21900,0,0,0,0,0,0,68000,5000,63000,63000
20200312,055724,祥碩元大97購03,5.05,5.05,3.76,4.40,-0.70,-13.73,54000,7,230400,0,0,0,0,0,0,10000,54000,-44000,-44000
20200312,055725,嘉聯益元大98購03,0.60,0.60,0.60,0.60,0.00,0.00,6000,1,3600,0,0,0,0,0,0,6000,0,6000,6000
20200312,055726,台表科元大98購03,1.26,1.26,0.86,0.86,-0.61,-41.5,135000,11,138090,0,0,0,0,0,0,55000,80000,-25000,-25000
20200312,055727,矽力元大97購02,2.75,2.75,2.37,2.37,-1.28,-35.07,72000,9,187210,0,0,0,0,0,0,71000,1000,70000,70000
20200312,055728,緯穎元大97購03,0.76,0.76,0.76,0.76,-0.53,-41.09,8000,1,6080,0,0,0,0,0,0,0,8000,-8000,-8000
20200312,055729,金寶元富99購01,0.43,0.43,0.33,0.37,-0.21,-36.21,574000,23,220610,0,0,0,0,0,0,237000,337000,-100000,-100000
20200312,05572P,群創統一96售02,0.86,1.11,0.86,1.11,+0.34,44.16,471000,27,462790,0,0,0,0,0,0,181000,290000,-109000,-109000
20200312,055730,建準元富97購02,,,,,0.00,0.00,0,0,0,0,0,0,0,0,0,0,0,0,0
20200312,055731,美律元富97購01,0.44,0.45,0.33,0.33,-0.24,-42.11,50000,5,19200,0,0,0,0,0,0,20000,30000,-10000,-10000
20200312,055732,全新元富9A購01,0.32,0.32,0.32,0.32,0.00,0.00,2000,1,640,0,0,0,0,0,0,2000,0,2000,2000
20200312,055733,奇力新元富97購01,0.31,0.31,0.28,0.28,-0.08,-22.22,60000,8,17960,0,0,0,0,0,0,60000,0,60000,60000
20200312,055734,奇力新元富97購02,0.07,0.07,0.07,0.07,-0.08,-53.33,14000,2,980,0,0,0,0,0,0,0,14000,-14000,-14000
20200312,055735,宏達電元富98購01,0.56,0.56,0.39,0.39,-0.22,-36.07,361000,7,171260,0,0,0,0,0,0,321000,40000,281000,281000
20200312,055736,宏達電元富99購01,0.58,0.58,0.50,0.50,-0.18,-26.47,30000,2,16600,0,0,0,0,0,0,30000,0,30000,30000
20200312,055737,開發金元富97購01,,,,,0.00,0.00,0,0,0,0,0,0,0,0,0,0,0,0,0
20200312,055738,玉山金元富97購01,1.90,1.90,1.39,1.53,-0.35,-18.62,425000,31,633300,0,0,0,0,0,0,30000,385000,-355000,-355000
20200312,055739,健鼎元富97購01,0.35,0.35,0.30,0.30,-0.10,-25.0,30000,3,9600,0,0,0,0,0,0,20000,10000,10000,10000
20200312,05573P,仁寶元富96售02,1.26,1.42,1.26,1.39,+0.20,16.81,482000,37,666990,0,0,0,0,0,0,72000,451000,-379000,-379000
20200312,055740,智易元富97購01,0.41,0.41,0.41,0.41,-0.16,-28.07,2000,1,820,0,0,0,0,0,0,0,2000,-2000,-2000
20200312,055741,健策元富97購01,0.35,0.35,0.28,0.28,-0.23,-45.1,53000,6,16790,0,0,0,0,0,0,0,53000,-53000,-53000
20200312,055742,健策元富97購02,0.12,0.12,0.11,0.11,-0.11,-50.0,43000,3,4960,0,0,0,0,0,0,23000,20000,3000,3000
20200312,055743,TPK元富98購01,0.30,0.30,0.28,0.29,-0.08,-21.62,160000,34,46300,0,0,0,0,0,0,160000,0,160000,160000
20200312,055744,茂林元富97購02,0.45,0.45,0.27,0.28,-0.20,-41.67,876000,20,304900,0,0,0,0,0,0,140000,736000,-596000,-596000
20200312,055745,臻鼎元富97購01,0.32,0.32,0.18,0.19,-0.17,-47.22,413000,15,95600,0,0,0,0,0,0,263000,150000,113000,113000
20200312,055746,同欣電元富97購01,0.50,0.50,0.32,0.39,-0.34,-46.58,138000,13,55320,0,0,0,0,0,0,40000,98000,-58000,-58000
20200312,055747,康舒元富97購01,0.83,0.83,0.68,0.71,-0.20,-21.98,97000,8,73710,0,0,0,0,0,0,37000,60000,-23000,-23000
20200312,055748,GIS元富97購01,,,,,0.00,0.00,0,0,0,0,0,0,0,0,0,0,0,0,0
20200312,055749,智邦永昌9C購01,3.72,3.72,3.43,3.43,0.00,0.00,45000,5,161300,0,0,0,0,0,0,0,45000,-45000,-45000
20200312,05574P,英業達元富96售01,1.06,1.12,1.06,1.11,+0.14,14.43,226000,23,247440,0,0,0,0,0,0,61000,165000,-104000,-104000
20200312,055750,瑞昱永昌9C購01,3.77,3.77,3.77,3.77,0.00,0.00,10000,1,37700,0,0,0,0,0,0,0,10000,-10000,-10000
20200312,055751,南亞科永昌9C購01,,,,,0.00,0.00,0,0,0,0,0,0,0,0,0,0,0,0,0
20200312,055752,臺股指永昌97購01,,,,,0.00,0.00,0,0,0,0,0,0,0,0,0,0,0,0,0
20200312,055753,貿聯第一98購01,0.20,0.20,0.20,0.20,-0.03,-13.04,62000,1,12400,0,0,0,0,0,0,62000,0,62000,62000
20200312,055754,和大兆豐97購01,0.12,0.12,0.12,0.12,-0.06,-33.33,10000,1,1200,0,0,0,0,0,0,0,10000,-10000,-10000
20200312,055755,禾伸堂兆豐97購02,,,,,0.00,0.00,0,0,0,0,0,0,0,0,0,0,0,0,0
20200312,055756,臺股指兆豐97購01,,,,,0.00,0.00,0,0,0,0,0,0,0,0,0,0,0,0,0
20200312,055757,大成鋼群益99購01,0.38,0.38,0.38,0.38,-0.12,-24.0,90000,1,34200,0,0,0,0,0,0,90000,0,90000,90000
20200312,055758,旺宏群益97購01,1.08,1.08,0.77,0.80,-0.47,-37.01,242000,20,202830,0,0,0,0,0,0,20000,212000,-192000,-192000
20200312,055759,技嘉群益98購02,0.71,0.71,0.63,0.63,-0.17,-21.25,212000,6,148290,0,0,0,0,0,0,202000,10000,192000,192000
20200312,05575P,玉晶光元富96售01,0.90,1.12,0.90,1.10,+0.29,35.8,86000,8,84240,0,0,0,0,0,0,52000,34000,18000,18000
20200312,055760,新日興群益98購02,1.00,1.00,0.67,0.71,-0.50,-41.32,214000,10,161330,0,0,0,0,0,0,69000,175000,-106000,-106000
20200312,055761,創意群益97購01,0.31,0.31,0.31,0.31,-0.32,-50.79,10000,1,3100,0,0,0,0,0,0,10000,0,10000,10000
20200312,055762,智伸科群益97購01,,,,,0.00,0.00,0,0,0,0,0,0,0,0,0,0,0,0,0
20200312,055763,鎧勝群益97購01,0.30,0.30,0.23,0.23,-0.27,-54.0,40000,2,10600,0,0,0,0,0,0,20000,20000,0,0
20200312,055764,臺股指群益97購02,,,,,0.00,0.00,0,0,0,0,0,0,0,0,0,0,0,0,0
20200312,055765,臺股指群益97購03,,,,,0.00,0.00,0,0,0,0,0,0,0,0,0,0,0,0,0
20200312,055766,臺股指群益97購04,,,,,0.00,0.00,0,0,0,0,0,0,0,0,0,0,0,0,0
20200312,055767,臺股指群益97購05,,,,,0.00,0.00,0,0,0,0,0,0,0,0,0,0,0,0,0
20200312,055768,臺股指群益97購06,,,,,0.00,0.00,0,0,0,0,0,0,0,0,0,0,0,0,0
20200312,055769,智伸科中信97購01,,,,,0.00,0.00,0,0,0,0,0,0,0,0,0,0,0,0,0
20200312,05576P,群創日盛99售02,0.78,0.90,0.78,0.87,+0.23,35.94,120000,7,102050,0,0,0,0,0,0,52000,63000,-11000,-11000
20200312,055770,欣興麥證97購01,0.27,0.27,0.18,0.18,-0.19,-51.35,427000,8,105520,0,427000,-427000,0,0,0,0,427000,-427000,-427000
20200312,055771,台積電日盛97購04,0.18,0.18,0.11,0.15,-0.08,-34.78,624000,26,92940,0,0,0,0,0,0,97000,525000,-428000,-428000
20200312,055772,致茂凱基97購01,0.16,0.16,0.16,0.16,-0.09,-36.0,10000,1,1600,0,0,0,0,0,0,10000,0,10000,10000
20200312,055773,瑞昱凱基97購03,0.25,0.25,0.25,0.25,-0.21,-45.65,68000,2,17000,0,0,0,0,0,0,68000,0,68000,68000
20200312,055774,台光電凱基97購02,0.52,0.54,0.37,0.40,-0.26,-39.39,105000,11,46450,0,0,0,0,0,0,0,105000,-105000,-105000
20200312,055775,友達凱基9A購01,,,,,0.00,0.00,0,0,0,0,0,0,0,0,0,0,0,0,0
20200312,055776,宏達電凱基98購02,0.96,0.96,0.65,0.65,-0.40,-38.1,21000,3,16800,0,0,0,0,0,0,10000,11000,-1000,-1000
20200312,055777,冠德凱基97購01,0.13,0.13,0.10,0.10,-0.06,-37.5,323000,7,35530,0,0,0,0,0,0,0,323000,-323000,-323000
20200312,055778,美食凱基97購01,,,,,0.00,0.00,0,0,0,0,0,0,0,0,0,0,0,0,0
20200312,055779,國泰金凱基97購02,,,,,0.00,0.00,0,0,0,0,0,0,0,0,0,0,0,0,0
20200312,05577P,上銀凱基96售02,0.58,0.58,0.58,0.58,0.00,0.00,8000,1,4640,0,0,0,0,0,0,8000,0,8000,8000
20200312,055780,禾伸堂凱基99購01,1.43,1.43,1.36,1.36,+0.18,15.25,84000,2,114940,0,0,0,0,0,0,0,84000,-84000,-84000
20200312,055781,聯詠凱基98購01,0.43,0.43,0.31,0.38,-0.18,-32.14,79000,3,33350,0,0,0,0,0,0,68000,11000,57000,57000
20200312,055782,新日興凱基99購01,,,,,0.00,0.00,0,0,0,0,0,0,0,0,0,0,0,0,0
20200312,055783,群創凱基99購03,0.10,0.10,0.10,0.10,-0.02,-16.67,60000,6,6000,0,0,0,0,0,0,0,60000,-60000,-60000
20200312,055784,TPK凱基97購02,,,,,0.00,0.00,0,0,0,0,0,0,0,0,0,0,0,0,0
20200312,055785,祥碩凱基97購02,2.13,2.13,1.56,1.58,-1.67,-51.38,135000,16,242620,0,0,0,0,0,0,64000,101000,-37000,-37000
20200312,055786,彩晶凱基99購02,0.10,0.10,0.10,0.10,-0.07,-41.18,52000,4,5200,0,0,0,0,0,0,0,52000,-52000,-52000
20200312,055787,聯茂凱基99購01,1.63,1.63,1.49,1.49,-0.51,-25.5,61000,2,91030,0,0,0,0,0,0,61000,0,61000,61000
20200312,055788,緯穎凱基97購04,0.98,0.98,0.98,0.98,-0.91,-48.15,1000,1,980,0,0,0,0,0,0,0,1000,-1000,-1000
20200312,055789,台虹凱基97購01,0.63,0.63,0.44,0.47,-0.29,-38.16,36000,5,19310,0,0,0,0,0,0,14000,22000,-8000,-8000
20200312,05578P,鴻海凱基96售11,4.38,5.45,4.38,5.45,+1.72,46.11,47000,8,234550,0,0,0,0,0,0,25000,47000,-22000,-22000
20200312,055790,南電凱基97購01,1.61,1.61,1.02,1.04,-0.63,-37.72,425000,18,489480,0,0,0,0,0,0,112000,325000,-213000,-213000
20200312,055791,臺股指凱基97購14,0.31,0.31,0.25,0.31,-0.17,-35.42,213000,8,64950,0,0,0,0,0,0,100000,0,100000,100000
20200312,055792,臺股指凱基97購15,,,,,0.00,0.00,0,0,0,0,0,0,0,0,0,0,0,0,0
20200312,055793,臺股指凱基97購16,,,,,0.00,0.00,0,0,0,0,0,0,0,0,0,0,0,0,0
20200312,055794,聯發科國泰99購01,0.13,0.14,0.13,0.14,-0.06,-30.0,60000,2,7900,0,0,0,0,0,0,0,60000,-60000,-60000
20200312,055795,茂林國泰98購01,0.58,0.58,0.36,0.37,-0.23,-38.33,1856000,25,775210,0,0,0,0,0,0,211000,1757000,-1546000,-1546000
20200312,055796,南電國泰98購01,1.34,1.40,1.34,1.38,-0.55,-28.5,351000,9,485340,0,0,0,0,0,0,0,351000,-351000,-351000
20200312,055797,華通富邦98購01,0.11,0.11,0.10,0.10,0.00,0.00,127000,6,13300,0,0,0,0,0,0,60000,67000,-7000,-7000
20200312,055798,聯茂富邦98購01,0.57,0.57,0.57,0.57,-0.15,-20.83,3000,1,1710,0,0,0,0,0,0,3000,0,3000,3000
20200312,055799,致茂永豐97購02,,,,,0.00,0.00,0,0,0,0,0,0,0,0,0,0,0,0,0
20200312,05579P,友達凱基98售03,0.75,0.83,0.75,0.83,+0.30,56.6,13000,2,10550,0,0,0,0,0,0,0,13000,-13000,-13000
20200312,055800,欣興永豐97購02,0.06,0.06,0.06,0.06,-0.09,-60.0,30000,1,1800,0,0,0,0,0,0,0,30000,-30000,-30000
20200312,055801,景碩永豐97購02,0.37,0.37,0.31,0.31,-0.39,-55.71,15000,3,4830,0,0,0,0,0,0,0,15000,-15000,-15000
20200312,055802,新日興永豐97購01,0.28,0.29,0.27,0.27,-0.06,-18.18,151000,3,42810,0,0,0,0,0,0,151000,0,151000,151000
20200312,055803,鎧勝永豐97購01,,,,,0.00,0.00,0,0,0,0,0,0,0,0,0,0,0,0,0
20200312,055804,祥碩永豐97購02,1.42,1.42,1.02,1.02,-0.39,-27.66,83000,4,100750,0,0,0,0,0,0,20000,73000,-53000,-53000
20200312,055805,矽力永豐97購01,0.34,0.34,0.32,0.32,-0.09,-21.95,131000,16,43050,0,0,0,0,0,0,112000,19000,93000,93000
20200312,055806,致新永豐97購02,,,,,0.00,0.00,0,0,0,0,0,0,0,0,0,0,0,0,0
20200312,055807,勤誠永豐97購01,0.25,0.25,0.25,0.25,0.00,0.00,15000,1,3750,0,0,0,0,0,0,15000,0,15000,15000
20200312,055808,世紀鋼永豐97購01,1.12,1.17,1.03,1.14,-0.29,-20.28,301000,25,331060,0,0,0,0,0,0,161000,132000,29000,29000
20200312,055809,T50反1國票98購02,1.60,1.93,1.57,1.85,+0.39,26.71,196000,9,322800,0,0,0,0,0,0,81000,115000,-34000,-34000
20200312,05580P,美律凱基96售03,1.63,2.16,1.63,2.07,+0.56,37.09,356000,26,689880,0,0,0,0,0,0,40000,316000,-276000,-276000
20200312,055810,T50反1國票99購01,1.46,1.80,1.46,1.80,+0.59,48.76,140000,6,229100,0,0,0,0,0,0,35000,125000,-90000,-90000
20200312,055811,國巨國票98購05,1.70,1.73,1.19,1.20,-0.73,-37.82,272000,19,381450,0,0,0,0,0,0,0,272000,-272000,-272000
20200312,055812,台積電國票99購02,0.14,0.18,0.10,0.15,-0.02,-11.76,439000,17,68160,0,0,0,0,0,0,0,202000,-202000,-202000
20200312,055813,聯發科國票98購04,,,,,0.00,0.00,0,0,0,0,0,0,0,0,0,0,0,0,0
20200312,055814,晶豪科國票97購02,1.56,1.56,1.05,1.05,-0.64,-37.87,95000,8,130580,0,0,0,0,0,0,77000,18000,59000,59000
20200312,055815,亞光國票99購01,,,,,0.00,0.00,0,0,0,0,0,0,0,0,0,0,0,0,0
20200312,055816,新日興國票98購01,1.15,1.15,0.68,0.68,-0.85,-55.56,83000,6,78100,0,0,0,0,0,0,21000,62000,-41000,-41000
20200312,055817,京鼎國票99購01,0.37,0.38,0.26,0.26,-0.23,-46.94,61000,11,22530,0,0,0,0,0,0,61000,0,61000,61000
20200312,055818,晶相光國票97購02,1.04,1.04,1.04,1.04,-0.24,-18.75,2000,1,2080,0,0,0,0,0,0,2000,0,2000,2000
20200312,055819,晶相光國票98購01,0.88,0.88,0.88,0.88,-0.65,-42.48,78000,1,68640,0,0,0,0,0,0,78000,0,78000,78000
20200312,05581P,華新科凱基96售07,,,,,0.00,0.00,0,0,0,0,0,0,0,0,0,0,0,0,0
20200312,055820,矽力國票98購02,1.10,1.10,0.92,1.07,-0.71,-39.89,172000,13,178400,0,0,0,0,0,0,75000,40000,35000,35000
20200312,055821,勤誠國票98購01,0.96,0.96,0.66,0.66,-0.48,-42.11,81000,7,61510,0,0,0,0,0,0,40000,41000,-1000,-1000
20200312,055822,臺股指國票97購09,0.33,0.33,0.33,0.33,-0.04,-10.81,50000,1,16500,0,0,0,0,0,0,0,50000,-50000,-50000
20200312,055823,臺股指國票97購10,0.07,0.09,0.05,0.09,-0.17,-65.38,573000,8,36710,0,0,0,0,0,0,443000,0,443000,443000
20200312,055824,臺股指國票97購11,,,,,0.00,0.00,0,0,0,0,0,0,0,0,0,0,0,0,0
20200312,055825,臺股指國票97購12,0.10,0.10,0.08,0.08,-0.20,-71.43,5000,2,420,0,0,0,0,0,0,4000,0,4000,4000
20200312,055826,中石化元大97購01,0.23,0.23,0.17,0.17,-0.13,-43.33,135000,3,23250,0,0,0,0,0,0,5000,130000,-125000,-125000
20200312,055827,中石化元大98購01,0.25,0.25,0.18,0.18,-0.12,-40.0,44000,2,10790,0,0,0,0,0,0,41000,3000,38000,38000
20200312,055828,上銀元大97購05,1.64,1.64,1.14,1.15,-0.84,-42.21,144000,12,197390,0,0,0,0,0,0,75000,95000,-20000,-20000
20200312,055829,上銀元大97購06,1.32,1.32,1.32,1.32,-1.27,-49.03,20000,1,26400,0,0,0,0,0,0,20000,0,20000,20000
20200312,05582P,群創凱基98售06,1.31,1.44,1.31,1.44,+0.56,63.64,49000,6,67810,0,0,0,0,0,0,9000,40000,-31000,-31000
20200312,055830,上銀元大97購07,1.74,1.76,1.37,1.37,-0.78,-36.28,94000,4,134850,0,0,0,0,0,0,94000,26000,68000,68000
20200312,055831,台達電元大97購01,0.58,0.58,0.40,0.40,-0.23,-36.51,254000,7,129920,0,0,0,0,0,0,44000,210000,-166000,-166000
20200312,055832,台達電元大97購02,0.13,0.13,0.13,0.13,-0.15,-53.57,49000,2,6370,0,0,0,0,0,0,0,49000,-49000,-49000
20200312,055833,華通元大98購05,0.30,0.30,0.25,0.25,-0.20,-44.44,50000,5,14000,0,0,0,0,0,0,0,50000,-50000,-50000
20200312,055834,國巨元大97購13,2.39,2.39,1.65,1.65,-1.11,-40.22,36000,3,80200,0,0,0,0,0,0,36000,20000,16000,16000
20200312,055835,華邦電元大97購03,,,,,0.00,0.00,0,0,0,0,0,0,0,0,0,0,0,0,0
20200312,055836,華邦電元大97購04,0.29,0.29,0.24,0.24,-0.37,-60.66,250000,4,66000,0,0,0,0,0,0,0,250000,-250000,-250000
20200312,055837,致茂元大97購02,0.42,0.42,0.31,0.31,-0.27,-46.55,16000,2,6060,0,0,0,0,0,0,10000,6000,4000,4000
20200312,055838,致茂元大97購03,0.53,0.53,0.39,0.39,-0.30,-43.48,320000,9,142310,0,0,0,0,0,0,123000,197000,-74000,-74000
20200312,055839,瑞昱元大97購04,0.87,0.87,0.55,0.55,-0.62,-52.99,128000,3,84600,0,0,0,0,0,0,60000,68000,-8000,-8000
20200312,05583P,訊芯凱基96售01,1.30,1.49,1.27,1.49,+0.33,28.45,289000,24,384910,0,0,0,0,0,0,151000,138000,13000,13000
20200312,055840,南亞科元大97購03,0.27,0.27,0.20,0.20,-0.23,-53.49,359000,4,96720,0,0,0,0,0,0,351000,8000,343000,343000
20200312,055841,南亞科元大97購04,0.47,0.47,0.34,0.34,-0.56,-62.22,269000,3,93350,0,0,0,0,0,0,269000,0,269000,269000
20200312,055842,建準元大98購01,,,,,0.00,0.00,0,0,0,0,0,0,0,0,0,0,0,0,0
20200312,055843,美律元大97購02,0.30,0.30,0.18,0.18,-0.15,-45.45,113000,4,28550,0,0,0,0,0,0,15000,98000,-83000,-83000
20200312,055844,大毅元大98購01,1.17,1.17,1.03,1.08,-0.22,-16.92,51000,5,56270,0,0,0,0,0,0,51000,24000,27000,27000
20200312,055845,大立光元大97購08,0.70,0.70,0.70,0.70,0.00,0.00,35000,1,24500,0,0,0,0,0,0,0,35000,-35000,-35000
20200312,055846,大立光元大97購09,,,,,0.00,0.00,0,0,0,0,0,0,0,0,0,0,0,0,0
20200312,055847,大立光元大97購10,0.40,0.40,0.40,0.40,0.00,0.00,10000,1,4000,0,0,0,0,0,0,0,10000,-10000,-10000
20200312,055848,大立光元大97購11,,,,,0.00,0.00,0,0,0,0,0,0,0,0,0,0,0,0,0
20200312,055849,聯詠元大97購05,0.76,0.76,0.74,0.74,-0.24,-24.49,58000,2,43380,0,0,0,0,0,0,58000,0,58000,58000
20200312,05584P,臺股指凱基96售13,4.49,4.49,4.49,4.49,+0.87,24.03,10000,1,44900,0,0,0,0,0,0,0,10000,-10000,-10000
20200312,055850,聯詠元大97購06,0.94,0.94,0.81,0.81,-0.22,-21.36,111000,4,94570,0,0,0,0,0,0,43000,68000,-25000,-25000
20200312,055851,智原元大98購01,,,,,0.00,0.00,0,0,0,0,0,0,0,0,0,0,0,0,0
20200312,055852,聯鈞元大98購01,1.07,1.07,0.84,0.87,-0.32,-26.89,180000,9,176220,0,0,0,0,0,0,167000,13000,154000,154000
20200312,055853,群創元大98購03,,,,,0.00,0.00,0,0,0,0,0,0,0,0,0,0,0,0,0
20200312,055854,群創元大98購04,0.15,0.15,0.15,0.15,0.00,0.00,5000,1,750,0,0,0,0,0,0,0,5000,-5000,-5000
20200312,055855,牧德元大99購02,0.39,0.39,0.31,0.31,0.00,0.00,594000,9,213550,0,0,0,0,0,0,445000,89000,356000,356000
20200312,055856,新唐元大97購03,,,,,0.00,0.00,0,0,0,0,0,0,0,0,0,0,0,0,0
20200312,055857,嘉聯益元大97購04,0.35,0.35,0.35,0.35,0.00,0.00,36000,1,12600,0,0,0,0,0,0,36000,0,36000,36000
20200312,055858,聯茂元大97購03,1.10,1.10,0.33,0.83,-0.52,-38.52,164000,12,164680,0,0,0,0,0,0,74000,85000,-11000,-11000
20200312,055859,啟碁元大97購03,0.44,0.44,0.38,0.38,-0.35,-47.95,118000,2,48920,0,0,0,0,0,0,68000,50000,18000,18000
20200312,05585P,臺股指凱基96售14,,,,,0.00,0.00,0,0,0,0,0,0,0,0,0,0,0,0,0
20200312,055860,啟碁元大97購04,0.62,0.62,0.45,0.45,-0.39,-46.43,560000,10,302600,0,0,0,0,0,0,350000,210000,140000,140000
20200312,055861,矽力元大97購03,1.06,1.06,0.89,0.97,-0.38,-28.15,499000,31,469250,0,0,0,0,0,0,171000,333000,-162000,-162000
20200312,055862,矽力元大97購04,1.17,1.17,0.98,1.06,-0.17,-13.82,223000,21,238540,0,0,0,0,0,0,143000,70000,73000,73000
20200312,055863,緯穎元大97購05,0.81,0.81,0.49,0.54,-0.42,-43.75,1683000,25,1116490,0,0,0,0,0,0,1525000,250000,1275000,1275000
20200312,055864,臺股指元大97購01,0.21,0.21,0.16,0.16,-0.16,-50.0,122000,7,21950,0,0,0,0,0,0,0,122000,-122000,-122000
20200312,055865,臺股指元大97購02,0.39,0.39,0.26,0.26,+0.06,30.0,16000,4,5760,0,0,0,0,0,0,16000,0,16000,16000
20200312,055866,臺股指元大97購03,0.40,0.40,0.34,0.34,+0.10,41.67,44000,2,17000,0,0,0,0,0,0,34000,0,34000,34000
20200312,055867,臺股指元大97購05,0.22,0.22,0.14,0.14,-0.17,-54.84,1020000,14,167500,0,0,0,0,0,0,0,1020000,-1020000,-1020000
20200312,055868,臺股指元大97購07,,,,,0.00,0.00,0,0,0,0,0,0,0,0,0,0,0,0,0
20200312,055869,臺股指元大97購08,,,,,0.00,0.00,0,0,0,0,0,0,0,0,0,0,0,0,0
20200312,05586P,臺股指凱基96售15,4.26,5.20,4.26,5.20,+1.80,52.94,2000,2,9460,0,0,0,0,0,0,2000,0,2000,2000
20200312,055870,智原台新97購01,,,,,0.00,0.00,0,0,0,0,0,0,0,0,0,0,0,0,0
20200312,055871,群創台新97購02,0.04,0.05,0.03,0.05,-0.02,-28.57,770000,3,31500,0,0,0,0,0,0,300000,370000,-70000,-70000
20200312,055872,亞泥元富97購01,0.60,0.60,0.56,0.56,-0.18,-24.32,40000,2,23600,0,0,0,0,0,0,40000,0,40000,40000
20200312,055873,聚陽元富97購01,0.19,0.19,0.13,0.14,-0.11,-44.0,436000,22,69030,0,0,0,0,0,0,80000,356000,-276000,-276000
20200312,055874,中環元富9A購01,0.79,0.79,0.57,0.57,-0.36,-38.71,208000,34,154640,0,0,0,0,0,0,155000,53000,102000,102000
20200312,055875,光罩元富97購02,0.40,0.40,0.32,0.32,-0.26,-44.83,90000,5,34520,0,0,0,0,0,0,90000,0,90000,90000
20200312,055876,美食元富9A購01,0.45,0.45,0.37,0.39,-0.11,-22.0,244000,11,105860,0,0,0,0,0,0,223000,21000,202000,202000
20200312,055877,奇鋐元富97購01,0.70,0.73,0.70,0.73,-0.08,-9.88,204000,5,143190,0,0,0,0,0,0,191000,13000,178000,178000
20200312,055878,泰碩元富97購02,0.38,0.49,0.38,0.41,-0.20,-32.79,285000,3,114650,0,0,0,0,0,0,275000,10000,265000,265000
20200312,055879,神達元富97購01,1.18,1.21,0.95,1.06,-0.37,-25.87,277000,31,297080,0,0,0,0,0,0,107000,155000,-48000,-48000
20200312,05587P,鴻海凱基96售12,5.45,5.50,5.35,5.50,+0.65,13.4,35000,3,189750,0,0,0,0,0,0,35000,15000,20000,20000
20200312,055880,神達元富97購02,1.32,1.33,1.05,1.14,-0.50,-30.49,387000,31,447840,0,0,0,0,0,0,256000,111000,145000,145000
20200312,055881,康控元富97購01,0.39,0.41,0.28,0.30,-0.30,-50.0,642000,10,211640,0,0,0,0,0,0,120000,522000,-402000,-402000
20200312,055882,嘉聯益元富97購01,,,,,0.00,0.00,0,0,0,0,0,0,0,0,0,0,0,0,0
20200312,055883,樺漢元富97購01,0.50,0.50,0.50,0.50,-0.13,-20.63,10000,1,5000,0,0,0,0,0,0,10000,0,10000,10000
20200312,055884,臺股指元富97購01,0.11,0.11,0.05,0.05,0.00,0.00,35000,3,2350,0,0,0,0,0,0,10000,25000,-15000,-15000
20200312,055885,大成鋼統一97購02,0.86,0.87,0.78,0.84,-0.13,-13.4,431000,8,361330,0,0,0,0,0,0,363000,48000,315000,315000
20200312,055886,上銀統一97購02,0.67,0.67,0.40,0.40,-0.72,-64.29,36000,22,22890,0,0,0,0,0,0,34000,2000,32000,32000
20200312,055887,上銀統一97購03,,,,,0.00,0.00,0,0,0,0,0,0,0,0,0,0,0,0,0
20200312,055888,鴻海統一97購04,,,,,0.00,0.00,0,0,0,0,0,0,0,0,0,0,0,0,0
20200312,055889,鴻海統一97購05,0.35,0.35,0.34,0.34,-0.27,-44.26,58000,2,20200,0,0,0,0,0,0,48000,10000,38000,38000
20200312,05588P,群創兆豐97售02,0.93,1.09,0.93,1.07,+0.29,37.18,227000,10,233150,0,0,0,0,0,0,128000,99000,29000,29000
20200312,055890,鴻海統一99購01,0.38,0.38,0.27,0.27,-0.26,-49.06,629000,9,197480,0,0,0,0,0,0,136000,401000,-265000,-265000
20200312,055891,鴻海統一9A購01,0.65,0.65,0.52,0.52,-0.19,-26.76,1848000,83,1060540,0,0,0,0,0,0,1008000,630000,378000,378000
20200312,055892,國巨統一99購01,1.60,1.63,1.11,1.15,-0.46,-28.57,256000,8,343570,0,0,0,0,0,0,136000,120000,16000,16000
20200312,055893,大立光統一97購07,,,,,0.00,0.00,0,0,0,0,0,0,0,0,0,0,0,0,0
20200312,055894,欣興統一97購03,0.20,0.20,0.20,0.20,0.00,0.00,100000,2,20000,0,0,0,0,0,0,0,100000,-100000,-100000
20200312,055895,群創統一97購04,,,,,0.00,0.00,0,0,0,0,0,0,0,0,0,0,0,0,0
20200312,055896,南電統一97購02,1.19,1.29,0.96,0.96,-0.40,-29.41,15000,3,17930,0,0,0,0,0,0,15000,0,15000,15000
20200312,055897,TXFI0永昌99購01,,,,,0.00,0.00,0,0,0,0,0,0,0,0,0,0,0,0,0
20200312,055898,訊芯第一97購01,,,,,0.00,0.00,0,0,0,0,0,0,0,0,0,0,0,0,0
20200312,055899,群創中信99購01,,,,,0.00,0.00,0,0,0,0,0,0,0,0,0,0,0,0,0
20200312,05589P,大立光中信9A售01,1.01,1.16,1.01,1.15,+0.33,40.24,504000,46,560840,0,0,0,0,0,0,484000,430000,54000,54000
20200312,055900,瀚宇博中信97購01,,,,,0.00,0.00,0,0,0,0,0,0,0,0,0,0,0,0,0
20200312,055901,超眾中信97購01,0.08,0.08,0.08,0.08,-0.06,-42.86,35000,4,2800,0,0,0,0,0,0,0,35000,-35000,-35000
20200312,055902,同欣電中信99購01,0.43,0.43,0.32,0.34,-0.13,-27.66,383000,17,140560,0,0,0,0,0,0,255000,128000,127000,127000
20200312,055903,鈺齊中信97購02,,,,,0.00,0.00,0,0,0,0,0,0,0,0,0,0,0,0,0
20200312,055904,貿聯亞東99購01,,,,,0.00,0.00,0,0,0,0,0,0,0,0,0,0,0,0,0
20200312,055905,可成兆豐97購03,0.27,0.27,0.18,0.19,-0.25,-56.82,59000,8,13070,0,0,0,0,0,0,59000,59000,0,0
20200312,055906,大立光兆豐97購03,0.17,0.19,0.14,0.14,-0.21,-60.0,3064000,27,480750,0,0,0,0,0,0,2656000,2404000,252000,252000
20200312,055907,台虹兆豐98購01,0.99,0.99,0.81,0.84,-0.32,-27.59,600000,4,518000,0,0,0,0,0,0,300000,300000,0,0
20200312,055908,GIS日盛97購01,0.31,0.31,0.18,0.20,-0.21,-51.22,601000,13,136540,0,0,0,0,0,0,256000,345000,-89000,-89000
20200312,055909,大成鋼凱基98購02,0.57,0.58,0.54,0.54,-0.17,-23.94,241000,5,133440,0,0,0,0,0,0,216000,25000,191000,191000
20200312,05590P,臺股指中信96售05,1.17,1.74,1.17,1.70,+0.62,57.41,611000,35,936140,0,0,0,0,0,0,368000,243000,125000,125000
20200312,055910,瑞昱凱基98購01,,,,,0.00,0.00,0,0,0,0,0,0,0,0,0,0,0,0,0
20200312,055911,可成凱基98購02,0.65,0.66,0.48,0.48,-0.49,-50.52,102000,4,64620,0,0,0,0,0,0,70000,32000,38000,38000
20200312,055912,宏達電凱基98購03,1.05,1.05,1.05,1.05,-0.09,-7.89,10000,1,10500,0,0,0,0,0,0,10000,0,10000,10000
20200312,055913,中信金凱基97購01,0.35,0.35,0.24,0.25,-0.16,-39.02,137000,15,36480,0,0,0,0,0,0,10000,117000,-107000,-107000
20200312,055914,大立光凱基97購13,0.18,0.18,0.13,0.13,0.00,0.00,500000,23,70000,0,0,0,0,0,0,0,500000,-500000,-500000
20200312,055915,大立光凱基98購07,0.35,0.35,0.29,0.29,-0.26,-47.27,129000,9,41650,0,0,0,0,0,0,0,129000,-129000,-129000
20200312,055916,奇鋐凱基99購01,,,,,0.00,0.00,0,0,0,0,0,0,0,0,0,0,0,0,0
20200312,055917,禾伸堂凱基98購02,0.34,0.34,0.28,0.29,+0.01,3.57,210000,8,65450,0,0,0,0,0,0,0,210000,-210000,-210000
20200312,055918,和鑫凱基97購01,,,,,0.00,0.00,0,0,0,0,0,0,0,0,0,0,0,0,0
20200312,055919,景碩凱基98購02,1.19,1.19,1.19,1.19,-0.50,-29.59,14000,1,16660,0,0,0,0,0,0,14000,0,14000,14000
20200312,05591P,義隆群益96售03,0.98,0.98,0.98,0.98,0.00,0.00,10000,1,9800,0,0,0,0,0,0,0,10000,-10000,-10000
20200312,055920,智伸科凱基97購02,,,,,0.00,0.00,0,0,0,0,0,0,0,0,0,0,0,0,0
20200312,055921,新唐凱基98購01,,,,,0.00,0.00,0,0,0,0,0,0,0,0,0,0,0,0,0
20200312,055922,台郡凱基98購03,0.16,0.16,0.10,0.10,-0.17,-62.96,38000,11,4590,0,0,0,0,0,0,6000,32000,-26000,-26000
20200312,055923,矽力凱基98購01,0.74,0.74,0.64,0.66,-0.21,-24.14,85000,25,58540,0,0,0,0,0,0,85000,0,85000,85000
20200312,055924,深中小群益9B購01,0.72,0.73,0.67,0.67,-0.15,-18.29,2294000,30,1596670,0,0,0,0,0,0,1525000,769000,756000,756000
20200312,055925,上銀群益97購01,0.85,0.85,0.78,0.78,-0.59,-43.07,83000,37,68010,0,0,0,0,0,0,83000,0,83000,83000
20200312,055926,國巨群益98購06,,,,,0.00,0.00,0,0,0,0,0,0,0,0,0,0,0,0,0
20200312,055927,南亞科群益97購01,,,,,0.00,0.00,0,0,0,0,0,0,0,0,0,0,0,0,0
20200312,055928,南亞科群益97購02,0.11,0.12,0.08,0.08,-0.16,-66.67,545000,11,45550,0,0,0,0,0,0,25000,520000,-495000,-495000
20200312,055929,聯發科群益97購05,0.14,0.14,0.09,0.09,-0.18,-66.67,750000,16,77000,0,0,0,0,0,0,140000,610000,-470000,-470000
20200312,05592P,可成群益96售03,3.98,4.90,3.98,4.90,+1.64,50.31,52000,6,232620,0,0,0,0,0,0,35000,17000,18000,18000
20200312,055930,可成群益98購01,0.66,0.66,0.66,0.66,-0.29,-30.53,98000,1,64680,0,0,0,0,0,0,98000,0,98000,98000
20200312,055931,冠德群益97購02,0.15,0.15,0.15,0.15,0.00,0.00,5000,1,750,0,0,0,0,0,0,0,5000,-5000,-5000
20200312,055932,玉山金群益99購01,1.26,1.26,0.99,1.12,-0.20,-15.15,189000,16,199610,0,0,0,0,0,0,130000,59000,71000,71000
20200312,055933,欣興群益98購02,0.81,0.81,0.70,0.70,-0.57,-44.88,35000,3,28130,0,0,0,0,0,0,35000,35000,0,0
20200312,055934,景碩群益98購03,1.00,1.00,1.00,1.00,-0.65,-39.39,10000,1,10000,0,0,0,0,0,0,0,10000,-10000,-10000
20200312,055935,創意群益97購02,0.47,0.47,0.47,0.47,-0.18,-27.69,27000,1,12690,0,0,0,0,0,0,27000,0,27000,27000
20200312,055936,彩晶群益98購02,,,,,0.00,0.00,0,0,0,0,0,0,0,0,0,0,0,0,0
20200312,055937,康舒群益97購01,,,,,0.00,0.00,0,0,0,0,0,0,0,0,0,0,0,0,0
20200312,055938,矽力群益97購01,0.78,0.78,0.67,0.73,-0.32,-30.48,281000,27,200910,0,0,0,0,0,0,204000,77000,127000,127000
20200312,055939,GIS群益97購01,0.10,0.10,0.07,0.07,0.00,0.00,100000,2,8500,0,0,0,0,0,0,0,100000,-100000,-100000
20200312,05593P,鴻海國票97售03,2.60,2.60,2.60,2.60,+0.36,16.07,15000,1,39000,0,0,0,0,0,0,15000,15000,0,0
20200312,055940,致新群益98購01,0.78,0.79,0.64,0.67,-0.25,-27.17,67000,6,49700,0,0,0,0,0,0,21000,46000,-25000,-25000
20200312,055941,百和群益98購02,,,,,0.00,0.00,0,0,0,0,0,0,0,0,0,0,0,0,0
20200312,055942,臺股指群益9C購01,0.58,0.58,0.50,0.50,-0.19,-27.54,177000,9,98840,0,0,0,0,0,0,127000,0,127000,127000
20200312,055943,瑞昱麥證97購01,0.47,0.47,0.33,0.33,-0.26,-44.07,40000,4,16900,30000,10000,20000,0,0,0,30000,10000,20000,20000
20200312,055944,日月光麥證97購01,0.18,0.18,0.09,0.09,-0.13,-59.09,115000,6,14450,0,115000,-115000,0,0,0,0,115000,-115000,-115000
20200312,055945,上証2X元大97購04,,,,,0.00,0.00,0,0,0,0,0,0,0,0,0,0,0,0,0
20200312,055946,元油反元大97購02,6.95,7.15,6.95,7.15,+1.80,33.64,3000,3,21100,0,0,0,0,0,0,2000,1000,1000,1000
20200312,055947,元油反元大98購03,,,,,0.00,0.00,0,0,0,0,0,0,0,0,0,0,0,0,0
20200312,055948,道瓊銀元大98購02,,,,,0.00,0.00,0,0,0,0,0,0,0,0,0,0,0,0,0
20200312,055949,亞德客元大97購04,1.27,1.27,0.88,0.88,-0.69,-43.95,31000,2,38980,0,0,0,0,0,0,31000,1000,30000,30000
20200312,05594P,旺宏國票96售04,1.45,1.83,1.37,1.75,+0.44,33.59,257000,14,381450,0,0,0,0,0,0,177000,80000,97000,97000
20200312,055950,華新元大97購02,,,,,0.00,0.00,0,0,0,0,0,0,0,0,0,0,0,0,0
20200312,055951,大成鋼元大97購02,0.57,0.60,0.54,0.54,-0.21,-28.0,139000,3,77700,0,0,0,0,0,0,71000,68000,3000,3000
20200312,055952,上銀元大97購08,1.17,1.17,0.75,0.75,-0.68,-47.55,182000,8,169980,0,0,0,0,0,0,118000,114000,4000,4000
20200312,055953,上銀元大97購09,1.31,1.31,0.90,0.90,-0.75,-45.45,144000,6,157110,0,0,0,0,0,0,68000,76000,-8000,-8000
20200312,055954,南港元大97購02,0.37,0.37,0.37,0.37,-0.07,-15.91,48000,1,17760,0,0,0,0,0,0,48000,0,48000,48000
20200312,055955,微星元大97購01,1.75,1.75,1.48,1.48,-0.50,-25.25,41000,6,68780,0,0,0,0,0,0,38000,3000,35000,35000
20200312,055956,瑞昱元大97購05,0.69,0.69,0.42,0.43,-0.41,-48.81,144000,6,65770,0,0,0,0,0,0,76000,71000,5000,5000
20200312,055957,瑞昱元大97購06,0.45,0.45,0.24,0.24,-0.43,-64.18,160000,9,59710,0,0,0,0,0,0,135000,25000,110000,110000
20200312,055958,台光電元大97購02,0.74,0.74,0.63,0.63,-0.19,-23.17,156000,10,109190,0,0,0,0,0,0,88000,110000,-22000,-22000
20200312,055959,美律元大97購03,,,,,0.00,0.00,0,0,0,0,0,0,0,0,0,0,0,0,0
20200312,05595P,友達統一96售02,0.87,0.87,0.87,0.87,+0.20,29.85,100000,1,87000,0,0,0,0,0,0,0,100000,-100000,-100000
20200312,055960,義隆元大97購01,1.21,1.21,1.05,1.08,-0.30,-21.74,70000,4,75950,0,0,0,0,0,0,0,70000,-70000,-70000
20200312,055961,國泰金元大97購01,0.33,0.33,0.30,0.30,-0.17,-36.17,73000,2,22050,0,0,0,0,0,0,5000,68000,-63000,-63000
20200312,055962,晶豪科元大97購02,1.61,1.61,1.27,1.27,-0.32,-20.13,146000,9,205450,0,0,0,0,0,0,146000,0,146000,146000
20200312,055963,欣興元大97購04,0.95,0.95,0.95,0.95,-0.60,-38.71,68000,1,64600,0,0,0,0,0,0,0,68000,-68000,-68000
20200312,055964,正文元大97購02,0.93,0.93,0.67,0.67,-0.31,-31.63,198000,11,167590,0,0,0,0,0,0,45000,167000,-122000,-122000
20200312,055965,泰鼎元大97購03,2.64,2.64,2.00,2.19,-0.67,-23.43,175000,7,397940,0,0,0,0,0,0,25000,160000,-135000,-135000
20200312,055966,茂林元大99購01,0.49,0.49,0.36,0.36,-0.15,-29.41,2167000,32,901810,0,0,0,0,0,0,1040000,1122000,-82000,-82000
20200312,055967,臻鼎元大97購01,0.33,0.33,0.18,0.20,-0.16,-44.44,495000,22,115200,0,0,0,0,0,0,230000,265000,-35000,-35000
20200312,055968,祥碩元大97購04,3.83,4.03,3.47,3.78,-1.57,-29.35,65000,6,247040,0,0,0,0,0,0,60000,65000,-5000,-5000
20200312,055969,彩晶元大99購02,0.12,0.12,0.12,0.12,0.00,0.00,2000,1,240,0,0,0,0,0,0,2000,0,2000,2000
20200312,05596P,可成統一96售01,2.65,3.10,2.65,3.10,+0.73,30.8,116000,9,325020,0,0,0,0,0,0,60000,56000,4000,4000
20200312,055970,聯茂元大97購04,2.11,2.11,2.11,2.11,-0.46,-17.9,12000,1,25320,0,0,0,0,0,0,12000,0,12000,12000
20200312,055971,矽力元大97購05,0.95,0.95,0.77,0.80,-0.20,-20.0,150000,15,127700,0,0,0,0,0,0,120000,30000,90000,90000
20200312,055972,GIS元大97購04,,,,,0.00,0.00,0,0,0,0,0,0,0,0,0,0,0,0,0
20200312,055973,亞德客統一97購01,0.94,0.94,0.58,0.58,-0.50,-46.3,85000,4,63670,0,0,0,0,0,0,85000,0,85000,85000
20200312,055974,上銀統一97購05,0.83,0.83,0.83,0.83,-0.39,-31.97,18000,1,14940,0,0,0,0,0,0,18000,0,18000,18000
20200312,055975,鴻海統一98購05,0.30,0.30,0.23,0.23,-0.16,-41.03,281000,8,75650,0,0,0,0,0,0,200000,81000,119000,119000
20200312,055976,台積電統一99購03,0.23,0.23,0.17,0.21,-0.07,-25.0,582000,17,109560,0,0,0,0,0,0,0,532000,-532000,-532000
20200312,055977,南亞科統一97購01,,,,,0.00,0.00,0,0,0,0,0,0,0,0,0,0,0,0,0
20200312,055978,大立光統一98購05,0.18,0.19,0.10,0.15,-0.18,-54.55,1394000,25,218970,0,0,0,0,0,0,0,1334000,-1334000,-1334000
20200312,055979,聯鈞統一97購03,0.71,0.74,0.50,0.50,-0.35,-41.18,422000,17,256720,0,0,0,0,0,0,387000,35000,352000,352000
20200312,05597P,鴻海元富96售06,3.53,4.18,3.48,4.18,+1.16,38.41,63000,7,232740,0,0,0,0,0,0,20000,43000,-23000,-23000
20200312,055980,祥碩統一98購01,0.71,0.73,0.55,0.59,-0.15,-20.27,409000,22,257720,0,0,0,0,0,0,236000,172000,64000,64000
20200312,055981,臺股指統一97購03,,,,,0.00,0.00,0,0,0,0,0,0,0,0,0,0,0,0,0
20200312,055982,T50反1元富97購01,1.82,2.23,1.78,2.12,+0.46,27.71,230000,11,426180,0,0,0,0,0,0,20000,210000,-190000,-190000
20200312,055983,全新元富9A購02,,,,,0.00,0.00,0,0,0,0,0,0,0,0,0,0,0,0,0
20200312,055984,大立光元富97購02,0.42,0.42,0.30,0.30,-0.52,-63.41,86000,5,30940,0,0,0,0,0,0,20000,66000,-46000,-46000
20200312,055985,聯鈞元富97購01,,,,,0.00,0.00,0,0,0,0,0,0,0,0,0,0,0,0,0
20200312,055986,祥碩元富97購01,1.56,1.56,1.10,1.16,-0.33,-22.15,228000,40,299330,0,0,0,0,0,0,60000,164000,-104000,-104000
20200312,055987,台表科元富97購01,,,,,0.00,0.00,0,0,0,0,0,0,0,0,0,0,0,0,0
20200312,055988,矽力元富97購01,0.70,0.70,0.60,0.66,-0.25,-27.47,292000,30,195480,0,0,0,0,0,0,242000,50000,192000,192000
20200312,055989,矽力元富9A購01,1.16,1.16,0.99,1.05,-0.26,-19.85,214000,30,233780,0,0,0,0,0,0,175000,39000,136000,136000
20200312,05598P,國巨元富96售03,0.56,0.84,0.56,0.84,+0.42,100.0,312000,13,203970,0,0,0,0,0,0,1000,311000,-310000,-310000
20200312,055990,矽創元富97購01,0.78,0.78,0.54,0.54,-0.41,-43.16,142000,4,104800,0,0,0,0,0,0,108000,34000,74000,74000
20200312,055991,鈺齊元富97購01,,,,,0.00,0.00,0,0,0,0,0,0,0,0,0,0,0,0,0
20200312,055992,智原台新97購02,,,,,0.00,0.00,0,0,0,0,0,0,0,0,0,0,0,0,0
20200312,055993,致茂國泰99購01,0.52,0.52,0.38,0.38,-0.27,-41.54,611000,29,285210,0,0,0,0,0,0,399000,212000,187000,187000
20200312,055994,聯發科國泰99購02,0.69,0.69,0.47,0.50,-0.27,-35.06,280000,15,155100,0,0,0,0,0,0,170000,260000,-90000,-90000
20200312,055995,華擎國泰99購01,,,,,0.00,0.00,0,0,0,0,0,0,0,0,0,0,0,0,0
20200312,055996,矽力國泰99購01,1.22,1.22,0.92,0.98,-0.22,-18.33,921000,66,923910,0,0,0,0,0,0,487000,420000,67000,67000
20200312,055997,矽創國泰99購01,,,,,0.00,0.00,0,0,0,0,0,0,0,0,0,0,0,0,0
20200312,055998,臺股指富邦99購01,0.06,0.13,0.06,0.13,+0.05,62.5,24000,2,1510,0,0,0,0,0,0,0,0,0,0
20200312,055999,電子類富邦99購01,,,,,0.00,0.00,0,0,0,0,0,0,0,0,0,0,0,0,0
20200312,05599P,欣興台新96售01,1.38,1.66,1.38,1.66,+0.48,40.68,77000,8,115030,0,0,0,0,0,0,57000,20000,37000,37000
20200312,056000,佳世達永豐97購01,0.34,0.34,0.34,0.34,0.00,0.00,25000,1,8500,0,0,0,0,0,0,25000,0,25000,25000
20200312,056001,美食永豐97購01,,,,,0.00,0.00,0,0,0,0,0,0,0,0,0,0,0,0,0
20200312,056002,嘉晶永豐97購01,0.69,0.74,0.55,0.63,-0.13,-17.11,213000,10,135280,0,0,0,0,0,0,99000,114000,-15000,-15000
20200312,056003,智伸科永豐97購02,,,,,0.00,0.00,0,0,0,0,0,0,0,0,0,0,0,0,0
20200312,056004,南電永豐97購02,1.09,1.14,0.80,0.85,-0.50,-37.04,237000,10,230060,0,0,0,0,0,0,133000,104000,29000,29000
20200312,056005,臺股指永豐97購04,0.05,0.07,0.04,0.07,+0.01,16.67,141000,4,6170,0,0,0,0,0,0,0,0,0,0
20200312,056006,義隆亞東97購01,,,,,0.00,0.00,0,0,0,0,0,0,0,0,0,0,0,0,0
20200312,056007,上銀中信97購02,0.17,0.17,0.09,0.09,-0.20,-68.97,146000,7,15180,0,0,0,0,0,0,131000,15000,116000,116000
20200312,056008,全新中信9B購01,0.15,0.15,0.15,0.15,-0.08,-34.78,5000,1,750,0,0,0,0,0,0,0,5000,-5000,-5000
20200312,056009,奇力新中信98購03,0.14,0.14,0.14,0.14,-0.09,-39.13,100000,2,14000,0,0,0,0,0,0,0,100000,-100000,-100000
20200312,05600P,玉晶光台新96售04,0.60,0.68,0.60,0.68,0.00,0.00,380000,4,252000,0,0,0,0,0,0,0,380000,-380000,-380000
20200312,056010,力成中信97購01,0.25,0.25,0.15,0.15,-0.18,-54.55,156000,25,33680,0,0,0,0,0,0,156000,0,156000,156000
20200312,056011,矽力中信99購01,0.55,0.55,0.44,0.49,-0.11,-18.33,614000,59,298580,0,0,0,0,0,0,374000,111000,263000,263000
20200312,056012,勤誠中信99購01,,,,,0.00,0.00,0,0,0,0,0,0,0,0,0,0,0,0,0
20200312,056013,T50反1群益97購01,1.41,1.79,1.41,1.79,+0.48,36.64,227000,3,332930,0,0,0,0,0,0,50000,177000,-127000,-127000
20200312,056014,上銀群益97購02,0.15,0.15,0.15,0.15,0.00,0.00,6000,1,900,0,0,0,0,0,0,6000,0,6000,6000
20200312,056015,華通群益99購01,0.53,0.56,0.38,0.38,-0.28,-42.42,380000,13,194690,0,0,0,0,0,0,249000,131000,118000,118000
20200312,056016,鴻海群益97購06,0.49,0.50,0.36,0.36,-0.37,-50.68,157000,9,69280,0,0,0,0,0,0,22000,135000,-113000,-113000
20200312,056017,台積電群益97購04,0.42,0.43,0.26,0.39,-0.19,-32.76,1520000,45,561780,0,0,0,0,0,0,567000,945000,-378000,-378000
20200312,056018,旺宏群益97購02,,,,,0.00,0.00,0,0,0,0,0,0,0,0,0,0,0,0,0
20200312,056019,燿華群益97購02,0.10,0.10,0.09,0.09,0.00,0.00,120000,2,11800,0,0,0,0,0,0,0,120000,-120000,-120000
20200312,05601P,鴻海元大97售04,5.05,5.80,4.87,5.80,+1.50,34.88,216000,13,1182130,0,0,0,0,0,0,38000,190000,-152000,-152000
20200312,056020,義隆群益97購01,,,,,0.00,0.00,0,0,0,0,0,0,0,0,0,0,0,0,0
20200312,056021,興富發群益97購01,0.89,0.89,0.79,0.80,-0.38,-32.2,28000,3,23200,0,0,0,0,0,0,0,28000,-28000,-28000
20200312,056022,新光金群益97購02,0.14,0.14,0.14,0.14,0.00,0.00,6000,1,840,0,0,0,0,0,0,6000,0,6000,6000
20200312,056023,晶豪科群益97購01,1.54,1.54,0.99,0.99,-0.71,-41.76,510000,38,715800,0,0,0,0,0,0,429000,73000,356000,356000
20200312,056024,大立光群益97購05,,,,,0.00,0.00,0,0,0,0,0,0,0,0,0,0,0,0,0
20200312,056025,嘉晶群益97購01,1.83,2.02,1.61,1.61,-0.78,-32.64,207000,4,360130,0,0,0,0,0,0,109000,98000,11000,11000
20200312,056026,智易群益97購01,0.56,0.56,0.41,0.41,-0.37,-47.44,80000,3,43300,0,0,0,0,0,0,0,80000,-80000,-80000
20200312,056027,樺漢群益97購02,0.19,0.19,0.19,0.19,-0.17,-47.22,1000,1,190,0,0,0,0,0,0,1000,0,1000,1000
20200312,056028,GIS群益97購02,,,,,0.00,0.00,0,0,0,0,0,0,0,0,0,0,0,0,0
20200312,056029,國巨麥證98購01,,,,,0.00,0.00,0,0,0,0,0,0,0,0,0,0,0,0,0
20200312,05602P,國巨元大96售06,0.74,0.95,0.74,0.95,+0.24,33.8,489000,17,394430,0,0,0,0,0,0,444000,262000,182000,182000
20200312,056030,華通日盛97購01,0.50,0.50,0.41,0.41,-0.25,-37.88,614000,34,287650,0,0,0,0,0,0,604000,10000,594000,594000
20200312,056031,勤誠康和97購02,,,,,0.00,0.00,0,0,0,0,0,0,0,0,0,0,0,0,0
20200312,056032,勤誠康和97購03,,,,,0.00,0.00,0,0,0,0,0,0,0,0,0,0,0,0,0
20200312,056033,T50正2凱基99購02,0.35,0.35,0.23,0.27,-0.19,-41.3,880000,13,267200,0,0,0,0,0,0,150000,710000,-560000,-560000
20200312,056034,華通凱基98購01,0.71,0.73,0.43,0.43,-0.57,-57.0,501000,14,255410,0,0,0,0,0,0,381000,120000,261000,261000
20200312,056035,鴻海凱基97購06,0.60,0.61,0.57,0.61,-0.41,-40.2,3000,3,1780,0,0,0,0,0,0,3000,3000,0,0
20200312,056036,鴻海凱基97購07,0.27,0.27,0.27,0.27,-0.14,-34.15,150000,1,40500,0,0,0,0,0,0,150000,0,150000,150000
20200312,056037,美律凱基98購03,0.10,0.10,0.10,0.10,0.00,0.00,13000,2,1300,0,0,0,0,0,0,0,13000,-13000,-13000
20200312,056038,可成凱基97購01,0.46,0.46,0.26,0.27,-0.45,-62.5,60000,6,20700,0,0,0,0,0,0,20000,40000,-20000,-20000
20200312,056039,宏達電凱基97購02,,,,,0.00,0.00,0,0,0,0,0,0,0,0,0,0,0,0,0
20200312,05603P,聯發科元大96售09,2.72,2.72,2.60,2.60,+0.36,16.07,80000,4,215440,0,0,0,0,0,0,80000,18000,62000,62000
20200312,056040,亞光凱基98購01,0.12,0.12,0.10,0.11,-0.07,-38.89,85000,5,9700,0,0,0,0,0,0,25000,85000,-60000,-60000
20200312,056041,禾伸堂凱基98購03,,,,,0.00,0.00,0,0,0,0,0,0,0,0,0,0,0,0,0
20200312,056042,京鼎凱基97購02,,,,,0.00,0.00,0,0,0,0,0,0,0,0,0,0,0,0,0
20200312,056043,力成凱基97購01,0.10,0.10,0.10,0.10,0.00,0.00,10000,1,1000,0,0,0,0,0,0,0,10000,-10000,-10000
20200312,056044,同欣電凱基97購03,0.25,0.25,0.15,0.16,-0.14,-46.67,96000,4,21280,0,0,0,0,0,0,96000,0,96000,96000
20200312,056045,勤誠凱基97購01,0.12,0.12,0.12,0.12,0.00,0.00,25000,1,3000,0,0,0,0,0,0,25000,0,25000,25000
20200312,056046,百和凱基97購01,,,,,0.00,0.00,0,0,0,0,0,0,0,0,0,0,0,0,0
20200312,056047,台積電兆豐97購02,0.10,0.10,0.06,0.09,-0.05,-35.71,1047000,67,87410,0,0,0,0,0,0,165000,882000,-717000,-717000
20200312,056048,同欣電兆豐97購01,0.15,0.15,0.13,0.13,-0.12,-48.0,40000,2,5600,0,0,0,0,0,0,20000,20000,0,0
20200312,056049,奇力新國票98購01,,,,,0.00,0.00,0,0,0,0,0,0,0,0,0,0,0,0,0
20200312,05604P,聯發科元大96售10,4.98,5.75,4.98,5.40,+1.13,26.46,151000,7,805840,0,0,0,0,0,0,150000,93000,57000,57000
20200312,056050,晶技國票98購01,1.98,1.98,1.33,1.39,-0.61,-30.5,120000,6,212320,0,0,0,0,0,0,120000,10000,110000,110000
20200312,056051,T50反1元大97購05,,,,,0.00,0.00,0,0,0,0,0,0,0,0,0,0,0,0,0
20200312,056052,T50反1元大97購06,1.85,2.06,1.85,2.02,+0.49,32.03,27000,7,52220,0,0,0,0,0,0,27000,0,27000,27000
20200312,056053,和大元大97購05,0.34,0.34,0.29,0.29,-0.19,-39.58,47000,3,15400,0,0,0,0,0,0,35000,12000,23000,23000
20200312,056054,亞德客元大97購05,0.77,0.77,0.77,0.77,-0.71,-47.97,1000,1,770,0,0,0,0,0,0,1000,1000,0,0
20200312,056055,國巨元大97購15,0.63,0.63,0.44,0.45,-0.27,-37.5,245000,9,123690,0,0,0,0,0,0,70000,175000,-105000,-105000
20200312,056056,旺宏元大97購06,0.74,0.74,0.56,0.56,-0.66,-54.1,98000,3,68720,0,0,0,0,0,0,0,98000,-98000,-98000
20200312,056057,華邦電元大97購05,,,,,0.00,0.00,0,0,0,0,0,0,0,0,0,0,0,0,0
20200312,056058,建準元大97購02,0.67,0.67,0.67,0.67,-0.23,-25.56,5000,1,3350,0,0,0,0,0,0,5000,0,5000,5000
20200312,056059,美律元大98購02,0.28,0.28,0.21,0.21,-0.15,-41.67,388000,8,90880,0,0,0,0,0,0,85000,303000,-218000,-218000
20200312,05605P,嘉聯益元大97售02,0.79,0.79,0.77,0.77,0.00,0.00,110000,2,86700,0,0,0,0,0,0,10000,100000,-90000,-90000
20200312,056060,宏達電元大99購01,0.49,0.49,0.35,0.36,-0.16,-30.77,242000,10,99010,0,0,0,0,0,0,192000,50000,142000,142000
20200312,056061,國泰金元大97購02,0.58,0.58,0.55,0.55,-0.26,-32.1,80000,6,45960,0,0,0,0,0,0,0,80000,-80000,-80000
20200312,056062,大立光元大97購12,1.03,1.03,1.03,1.03,-0.66,-39.05,100000,1,103000,0,0,0,0,0,0,100000,100000,0,0
20200312,056063,大立光元大97購13,,,,,0.00,0.00,0,0,0,0,0,0,0,0,0,0,0,0,0
20200312,056064,大立光元大97購14,1.00,1.00,0.74,0.82,-0.81,-49.69,104000,5,96420,0,0,0,0,0,0,0,104000,-104000,-104000
20200312,056065,奇鋐元大97購01,0.75,0.77,0.57,0.57,-0.42,-42.42,79000,7,57620,0,0,0,0,0,0,27000,54000,-27000,-27000
20200312,056066,奇鋐元大98購02,0.40,0.40,0.33,0.33,-0.15,-31.25,691000,10,244050,0,0,0,0,0,0,149000,542000,-393000,-393000
20200312,056067,智原元大97購01,,,,,0.00,0.00,0,0,0,0,0,0,0,0,0,0,0,0,0
20200312,056068,欣興元大97購05,1.00,1.00,0.42,0.42,-1.26,-75.0,81000,3,66840,0,0,0,0,0,0,73000,5000,68000,68000
20200312,056069,新日興元大97購03,0.44,0.44,0.28,0.28,-0.21,-42.86,399000,17,136200,0,0,0,0,0,0,283000,209000,74000,74000
20200312,05606P,TPK國票97售02,2.48,3.05,2.48,2.88,+0.50,21.01,358000,39,941440,0,0,0,0,0,0,253000,105000,148000,148000
20200312,056070,新日興元大97購04,0.55,0.55,0.34,0.34,-0.24,-41.38,217000,14,101070,0,0,0,0,0,0,149000,68000,81000,81000
20200312,056071,創意元大97購02,0.75,0.75,0.54,0.54,-0.34,-38.64,132000,2,81780,0,0,0,0,0,0,50000,82000,-32000,-32000
20200312,056072,群創元大97購01,0.22,0.22,0.15,0.17,-0.13,-43.33,474000,7,83780,0,0,0,0,0,0,254000,220000,34000,34000
20200312,056073,智伸科元大97購01,0.43,0.43,0.29,0.29,-0.18,-38.3,22000,3,7280,0,0,0,0,0,0,0,22000,-22000,-22000
20200312,056074,茂林元大97購04,0.39,0.39,0.25,0.25,-0.15,-37.5,1150000,32,344020,0,0,0,0,0,0,414000,736000,-322000,-322000
20200312,056075,瀚宇博元大97購03,1.29,1.29,0.87,0.93,-0.59,-38.82,526000,8,482080,0,0,0,0,0,0,326000,212000,114000,114000
20200312,056076,超眾元大97購05,0.96,0.97,0.81,0.86,-0.42,-32.81,116000,8,100830,0,0,0,0,0,0,106000,17000,89000,89000
20200312,056077,矽力元大97購07,1.06,1.06,0.88,0.94,-0.23,-19.66,396000,34,368440,0,0,0,0,0,0,253000,118000,135000,135000
20200312,056078,勤誠元大97購01,0.30,0.30,0.30,0.30,-0.01,-3.23,1000,1,300,0,0,0,0,0,0,0,1000,-1000,-1000
20200312,056079,世紀鋼元大97購02,2.57,2.59,2.05,2.31,-0.28,-10.81,807000,58,1876640,0,0,0,0,0,0,468000,345000,123000,123000
20200312,05607P,華通日盛96售01,1.64,1.94,1.64,1.94,+0.37,23.57,151000,6,270010,0,0,0,0,0,0,11000,140000,-129000,-129000
20200312,056080,世紀鋼元大97購03,1.46,1.46,1.29,1.39,-0.16,-10.32,165000,15,229940,0,0,0,0,0,0,50000,105000,-55000,-55000
20200312,056081,T50反1統一99購02,,,,,0.00,0.00,0,0,0,0,0,0,0,0,0,0,0,0,0
20200312,056082,旺宏統一99購02,0.26,0.28,0.20,0.21,-0.11,-34.38,466000,7,107170,0,0,0,0,0,0,25000,441000,-416000,-416000
20200312,056083,億光統一97購03,,,,,0.00,0.00,0,0,0,0,0,0,0,0,0,0,0,0,0
20200312,056084,漢唐統一97購03,0.63,0.63,0.61,0.61,0.00,0.00,48000,2,29840,0,0,0,0,0,0,0,48000,-48000,-48000
20200312,056085,聯發科統一97購01,0.93,0.93,0.82,0.82,-0.51,-38.35,78000,2,69240,0,0,0,0,0,0,0,78000,-78000,-78000
20200312,056086,奇力新統一98購01,0.10,0.10,0.10,0.10,-0.02,-16.67,30000,2,3000,0,0,0,0,0,0,0,30000,-30000,-30000
20200312,056087,世芯統一97購01,0.38,0.39,0.23,0.28,-0.14,-33.33,521000,38,160020,0,0,0,0,0,0,133000,388000,-255000,-255000
20200312,056088,台郡統一97購02,0.56,0.56,0.47,0.49,-0.32,-39.51,26000,3,13140,0,0,0,0,0,0,0,26000,-26000,-26000
20200312,056089,同欣電統一98購01,0.28,0.28,0.20,0.20,-0.13,-39.39,108000,2,28640,0,0,0,0,0,0,88000,20000,68000,68000
20200312,05608P,聯發科凱基96售10,4.46,4.46,4.46,4.46,0.00,0.00,13000,1,57980,0,0,0,0,0,0,0,13000,-13000,-13000
20200312,056090,康舒統一97購01,0.14,0.14,0.14,0.14,0.00,0.00,7000,1,980,0,0,0,0,0,0,0,7000,-7000,-7000
20200312,056091,百和統一97購01,0.42,0.42,0.36,0.37,-0.14,-27.45,30000,13,11910,0,0,0,0,0,0,30000,0,30000,30000
20200312,056092,亞德客元富97購02,1.25,1.25,0.96,1.00,-0.60,-37.5,106000,5,117990,0,0,0,0,0,0,42000,64000,-22000,-22000
20200312,056093,大毅元富97購01,,,,,0.00,0.00,0,0,0,0,0,0,0,0,0,0,0,0,0
20200312,056094,大立光元富97購03,,,,,0.00,0.00,0,0,0,0,0,0,0,0,0,0,0,0,0
20200312,056095,臻鼎元富9A購01,0.70,0.70,0.44,0.47,-0.29,-38.16,462000,23,257340,0,0,0,0,0,0,199000,233000,-34000,-34000
20200312,056096,超眾元富9A購01,0.84,0.85,0.84,0.85,-0.43,-33.59,136000,2,114370,0,0,0,0,0,0,0,136000,-136000,-136000
20200312,056097,訊芯元富97購02,,,,,0.00,0.00,0,0,0,0,0,0,0,0,0,0,0,0,0
20200312,056098,矽創元富97購02,0.52,0.54,0.35,0.35,-0.32,-47.76,86000,8,40700,0,0,0,0,0,0,20000,66000,-46000,-46000
20200312,056099,上銀永豐97購02,0.10,0.10,0.08,0.09,-0.07,-43.75,773000,26,69590,0,0,0,0,0,0,0,773000,-773000,-773000
20200312,05609P,國泰金凱基96售01,0.76,0.89,0.76,0.85,+0.12,16.44,1204000,37,1024550,0,0,0,0,0,0,1046000,678000,368000,368000
20200312,056100,楠梓電永豐97購02,0.40,0.40,0.29,0.29,-0.25,-46.3,182000,27,66620,0,0,0,0,0,0,163000,10000,153000,153000
20200312,056101,光磊永豐98購01,0.46,0.46,0.46,0.46,-0.20,-30.3,13000,1,5980,0,0,0,0,0,0,0,13000,-13000,-13000
20200312,056102,億光永豐97購02,0.05,0.05,0.05,0.05,-0.04,-44.44,110000,10,5500,0,0,0,0,0,0,20000,90000,-70000,-70000
20200312,056103,聯發科永豐97購03,,,,,0.00,0.00,0,0,0,0,0,0,0,0,0,0,0,0,0
20200312,056104,義隆永豐97購01,,,,,0.00,0.00,0,0,0,0,0,0,0,0,0,0,0,0,0
20200312,056105,智原永豐97購01,,,,,0.00,0.00,0,0,0,0,0,0,0,0,0,0,0,0,0
20200312,056106,晶相光永豐97購02,0.38,0.38,0.27,0.27,-0.22,-44.9,25000,4,8050,0,0,0,0,0,0,0,25000,-25000,-25000
20200312,056107,智易永豐97購02,,,,,0.00,0.00,0,0,0,0,0,0,0,0,0,0,0,0,0
20200312,056108,麗豐永豐97購01,,,,,0.00,0.00,0,0,0,0,0,0,0,0,0,0,0,0,0
20200312,056109,彩晶永豐98購01,0.25,0.25,0.25,0.25,-0.25,-50.0,110000,2,27500,0,0,0,0,0,0,0,110000,-110000,-110000
20200312,05610P,國巨群益98售01,,,,,0.00,0.00,0,0,0,0,0,0,0,0,0,0,0,0,0
20200312,056110,嘉聯益永豐97購02,0.58,0.58,0.37,0.37,-0.34,-47.89,43000,4,22310,0,0,0,0,0,0,43000,0,43000,43000
20200312,056111,力成永豐97購01,0.16,0.16,0.15,0.15,-0.12,-44.44,170000,3,27100,0,0,0,0,0,0,10000,160000,-150000,-150000
20200312,056112,勤誠永豐97購02,0.14,0.14,0.12,0.12,-0.04,-25.0,997000,9,127630,0,0,0,0,0,0,150000,847000,-697000,-697000
20200312,056113,新日興兆豐98購01,0.39,0.40,0.35,0.35,0.00,0.00,90000,3,32400,0,0,0,0,0,0,90000,0,90000,90000
20200312,056114,台達電群益97購02,0.38,0.38,0.30,0.30,-0.18,-37.5,109000,2,40540,0,0,0,0,0,0,98000,11000,87000,87000
20200312,056115,奇力新群益97購06,0.25,0.25,0.16,0.16,-0.16,-50.0,165000,4,38150,0,0,0,0,0,0,95000,70000,25000,25000
20200312,056116,義隆群益97購02,0.58,0.58,0.52,0.52,-0.30,-36.59,23000,2,13040,0,0,0,0,0,0,23000,0,23000,23000
20200312,056117,宏達電群益97購02,0.20,0.20,0.12,0.12,0.00,0.00,1036000,22,131520,0,0,0,0,0,0,100000,936000,-836000,-836000
20200312,056118,聯詠群益97購03,0.34,0.34,0.34,0.34,-0.18,-34.62,11000,1,3740,0,0,0,0,0,0,11000,0,11000,11000
20200312,056119,欣興群益97購02,,,,,0.00,0.00,0,0,0,0,0,0,0,0,0,0,0,0,0
20200312,05611P,康控群益96售02,3.06,3.16,3.06,3.16,+0.37,13.26,25000,2,77000,0,0,0,0,0,0,20000,5000,15000,15000
20200312,056120,聯茂群益97購02,2.85,2.85,2.49,2.54,-1.48,-36.82,41000,4,110100,0,0,0,0,0,0,30000,11000,19000,19000
20200312,056121,勤誠群益97購01,,,,,0.00,0.00,0,0,0,0,0,0,0,0,0,0,0,0,0
20200312,056122,勤誠群益97購02,0.42,0.42,0.42,0.42,0.00,0.00,40000,1,16800,0,0,0,0,0,0,40000,0,40000,40000
20200312,056123,鈺齊群益97購01,,,,,0.00,0.00,0,0,0,0,0,0,0,0,0,0,0,0,0
20200312,056124,華通國票98購02,1.21,1.21,0.88,0.88,-0.55,-38.46,196000,4,209060,0,0,0,0,0,0,166000,30000,136000,136000
20200312,056125,旺宏國票98購02,1.28,1.28,1.00,1.00,-0.50,-33.33,12000,2,14800,0,0,0,0,0,0,10000,2000,8000,8000
20200312,056126,台郡國票98購02,1.77,1.78,1.60,1.65,-1.04,-38.66,97000,8,164610,0,0,0,0,0,0,59000,38000,21000,21000
20200312,056127,致新國票98購02,0.49,0.49,0.49,0.49,-0.21,-30.0,38000,1,18620,0,0,0,0,0,0,38000,0,38000,38000
20200312,056128,和大中信99購01,,,,,0.00,0.00,0,0,0,0,0,0,0,0,0,0,0,0,0
20200312,056129,義隆麥證97購01,0.39,0.39,0.39,0.39,-0.17,-30.36,70000,1,27300,70000,0,70000,0,0,0,70000,0,70000,70000
20200312,05612P,台積電元大96售13,0.89,1.48,0.87,1.05,+0.28,36.36,135000,21,138180,0,0,0,0,0,0,54000,79000,-25000,-25000
20200312,056130,新日興麥證97購01,0.51,0.51,0.35,0.35,-0.29,-45.31,70000,4,29100,70000,0,70000,0,0,0,70000,0,70000,70000
20200312,056131,鴻海元大97購12,0.75,0.75,0.59,0.60,-0.36,-37.5,31000,4,20010,0,0,0,0,0,0,11000,21000,-10000,-10000
20200312,056132,台光電元大97購03,2.24,2.24,1.81,1.81,-0.66,-26.72,70000,2,135300,0,0,0,0,0,0,20000,50000,-30000,-30000
20200312,056133,可成元大97購05,1.32,1.32,0.85,0.85,-0.78,-47.85,93000,10,110090,0,0,0,0,0,0,83000,43000,40000,40000
20200312,056134,可成元大97購06,1.09,1.09,0.72,0.76,-0.51,-40.16,515000,23,451300,0,0,0,0,0,0,379000,411000,-32000,-32000
20200312,056135,緯創元大98購01,0.89,0.89,0.59,0.73,-0.30,-29.13,183000,8,131820,0,0,0,0,0,0,20000,183000,-163000,-163000
20200312,056136,京鼎元大98購01,0.27,0.28,0.26,0.26,-0.06,-18.75,68000,3,17980,0,0,0,0,0,0,68000,0,68000,68000
20200312,056137,聯鈞元大9A購01,1.57,1.57,1.26,1.26,-0.57,-31.15,106000,8,159650,0,0,0,0,0,0,46000,60000,-14000,-14000
20200312,056138,群創元大9B購01,,,,,0.00,0.00,0,0,0,0,0,0,0,0,0,0,0,0,0
20200312,056139,貿聯元大97購04,0.51,0.51,0.33,0.33,-0.32,-49.23,129000,4,49820,0,0,0,0,0,0,104000,25000,79000,79000
20200312,05613P,臻鼎台新96售01,1.53,1.81,1.53,1.81,+0.69,61.61,120000,4,196300,0,0,0,0,0,0,120000,0,120000,120000
20200312,056140,康控元大98購01,0.49,0.49,0.38,0.38,-0.23,-37.7,85000,11,38700,0,0,0,0,0,0,40000,45000,-5000,-5000
20200312,056141,聯茂元大97購05,2.59,2.59,2.15,2.15,-0.30,-12.24,27000,3,66850,0,0,0,0,0,0,27000,0,27000,27000
20200312,056142,超眾元大97購06,0.45,0.45,0.35,0.35,-0.23,-39.66,16000,4,6090,0,0,0,0,0,0,15000,1000,14000,14000
20200312,056143,訊芯元大97購04,,,,,0.00,0.00,0,0,0,0,0,0,0,0,0,0,0,0,0
20200312,056144,GIS元大98購01,0.57,0.57,0.41,0.42,-0.35,-45.45,183000,7,90000,0,0,0,0,0,0,183000,107000,76000,76000
20200312,056145,緯穎元大98購03,1.10,1.10,0.80,0.84,-0.54,-39.13,257000,15,236100,0,0,0,0,0,0,99000,208000,-109000,-109000
20200312,056146,台虹元大98購01,1.70,1.80,1.35,1.35,-0.73,-35.1,149000,8,233350,0,0,0,0,0,0,68000,81000,-13000,-13000
20200312,056147,鴻海日盛97購05,,,,,0.00,0.00,0,0,0,0,0,0,0,0,0,0,0,0,0
20200312,056148,臺股指日盛97購03,,,,,0.00,0.00,0,0,0,0,0,0,0,0,0,0,0,0,0
20200312,056149,亞光康和97購01,,,,,0.00,0.00,0,0,0,0,0,0,0,0,0,0,0,0,0
20200312,05614P,臺股指康和96售03,2.42,2.43,2.42,2.43,+0.93,62.0,25000,2,60550,0,0,0,0,0,0,25000,0,25000,25000
20200312,056150,台光電凱基98購02,0.75,0.75,0.75,0.75,-0.16,-17.58,17000,1,12750,0,0,0,0,0,0,17000,0,17000,17000
20200312,056151,建準凱基97購01,0.65,0.67,0.62,0.67,-0.12,-15.19,50000,13,32330,0,0,0,0,0,0,50000,0,50000,50000
20200312,056152,可成凱基97購02,0.51,0.51,0.32,0.32,-0.65,-67.01,95000,5,35750,0,0,0,0,0,0,0,95000,-95000,-95000
20200312,056153,華新科凱基97購02,1.51,1.51,1.41,1.41,-0.34,-19.43,63000,2,93630,0,0,0,0,0,0,63000,15000,48000,48000
20200312,056154,宏達電凱基97購03,0.90,0.90,0.59,0.70,-0.33,-32.04,130000,9,88700,0,0,0,0,0,0,30000,100000,-70000,-70000
20200312,056155,嘉晶凱基97購01,0.89,0.98,0.67,0.71,-0.18,-20.22,515000,34,430210,0,0,0,0,0,0,157000,348000,-191000,-191000
20200312,056156,禾伸堂凱基98購04,0.67,0.80,0.67,0.76,0.00,0.00,55000,3,38600,0,0,0,0,0,0,40000,15000,25000,25000
20200312,056157,聯詠凱基97購03,0.61,0.61,0.61,0.61,-0.27,-30.68,8000,1,4880,0,0,0,0,0,0,8000,0,8000,8000
20200312,056158,新日興凱基98購02,0.38,0.38,0.38,0.38,-0.09,-19.15,33000,1,12540,0,0,0,0,0,0,33000,0,33000,33000
20200312,056159,牧德凱基99購01,0.27,0.27,0.27,0.27,-0.13,-32.5,80000,1,21600,0,0,0,0,0,0,80000,0,80000,80000
20200312,05615P,臺股指康和96售04,2.21,2.72,2.21,2.72,+0.84,44.68,42000,8,98040,0,0,0,0,0,0,42000,0,42000,42000
20200312,056160,智易凱基97購03,,,,,0.00,0.00,0,0,0,0,0,0,0,0,0,0,0,0,0
20200312,056161,康控凱基98購02,0.56,0.56,0.42,0.42,-0.31,-42.47,33000,3,16750,0,0,0,0,0,0,20000,13000,7000,7000
20200312,056162,祥碩凱基97購03,1.51,1.53,0.95,1.18,-0.59,-33.33,578000,64,703720,0,0,0,0,0,0,65000,558000,-493000,-493000
20200312,056163,嘉聯益凱基98購03,,,,,0.00,0.00,0,0,0,0,0,0,0,0,0,0,0,0,0
20200312,056164,聯茂凱基98購03,2.38,2.38,2.38,2.38,0.00,0.00,400000,4,952000,0,0,0,0,0,0,0,400000,-400000,-400000
20200312,056165,矽力凱基98購02,0.58,0.58,0.48,0.52,-0.13,-20.0,130000,25,70120,0,0,0,0,0,0,58000,71000,-13000,-13000
20200312,056166,微星台新97購01,0.44,0.45,0.40,0.40,-0.17,-29.82,129000,7,53200,0,0,0,0,0,0,89000,40000,49000,49000
20200312,056167,力成台新97購01,,,,,0.00,0.00,0,0,0,0,0,0,0,0,0,0,0,0,0
20200312,056168,鴻海元富97購07,0.92,0.92,0.74,0.74,-0.43,-36.75,128000,4,99720,0,0,0,0,0,0,110000,18000,92000,92000
20200312,056169,鴻海元富97購08,0.76,0.78,0.71,0.71,-0.30,-29.7,40000,3,29600,0,0,0,0,0,0,20000,20000,0,0
20200312,05616P,台光電永豐96售01,0.63,0.65,0.63,0.65,0.00,0.00,36000,3,23040,0,0,0,0,0,0,0,36000,-36000,-36000
20200312,056170,鴻海元富97購09,1.04,1.07,0.86,0.86,-0.41,-32.28,80000,5,81500,0,0,0,0,0,0,40000,40000,0,0
20200312,056171,鴻海元富97購10,0.86,0.86,0.67,0.71,-0.38,-34.86,112000,8,79940,0,0,0,0,0,0,72000,40000,32000,32000
20200312,056172,鴻海元富97購11,0.58,0.58,0.44,0.44,-0.29,-39.73,62000,5,30280,0,0,0,0,0,0,10000,52000,-42000,-42000
20200312,056173,廣達元富97購01,0.71,0.71,0.57,0.60,-0.20,-25.0,115000,9,76430,0,0,0,0,0,0,64000,51000,13000,13000
20200312,056174,億光元富97購01,,,,,0.00,0.00,0,0,0,0,0,0,0,0,0,0,0,0,0
20200312,056175,可成元富97購03,,,,,0.00,0.00,0,0,0,0,0,0,0,0,0,0,0,0,0
20200312,056176,創意元富97購01,0.20,0.20,0.20,0.20,-0.17,-45.95,20000,1,4000,0,0,0,0,0,0,20000,0,20000,20000
20200312,056177,嘉澤元富97購01,,,,,0.00,0.00,0,0,0,0,0,0,0,0,0,0,0,0,0
20200312,056178,嘉澤元富97購02,0.46,0.46,0.32,0.33,-0.31,-48.44,33000,4,14110,0,0,0,0,0,0,28000,5000,23000,23000
20200312,056179,康友元富97購02,1.36,1.36,1.04,1.08,-0.42,-28.0,407000,22,514170,0,0,0,0,0,0,242000,132000,110000,110000
20200312,05617P,大立光統一97售02,1.59,1.71,1.59,1.71,0.00,0.00,44000,4,73950,0,0,0,0,0,0,16000,43000,-27000,-27000
20200312,056180,南茂元富97購01,0.46,0.46,0.27,0.35,-0.15,-30.0,1911000,51,724070,0,0,0,0,0,0,999000,556000,443000,443000
20200312,056181,百和元富97購02,0.23,0.23,0.20,0.20,-0.10,-33.33,250000,2,51500,0,0,0,0,0,0,0,250000,-250000,-250000
20200312,056182,台光電統一97購03,1.00,1.00,0.76,0.76,-0.42,-35.59,60000,2,55200,0,0,0,0,0,0,60000,0,60000,60000
20200312,056183,南亞科統一97購02,0.66,0.66,0.48,0.48,-0.60,-55.56,96000,2,54720,0,0,0,0,0,0,48000,48000,0,0
20200312,056184,南亞科統一97購03,0.40,0.40,0.34,0.34,-0.34,-50.0,97000,3,35890,0,0,0,0,0,0,48000,49000,-1000,-1000
20200312,056185,全新統一98購01,0.16,0.16,0.16,0.16,0.00,0.00,16000,1,2560,0,0,0,0,0,0,16000,0,16000,16000
20200312,056186,智原統一97購01,,,,,0.00,0.00,0,0,0,0,0,0,0,0,0,0,0,0,0
20200312,056187,京鼎統一97購01,,,,,0.00,0.00,0,0,0,0,0,0,0,0,0,0,0,0,0
20200312,056188,晶相光統一99購01,0.30,0.33,0.23,0.24,-0.11,-31.43,290000,18,70310,0,0,0,0,0,0,45000,245000,-200000,-200000
20200312,056189,樺漢統一97購02,0.46,0.46,0.46,0.46,-0.28,-37.84,48000,1,22080,0,0,0,0,0,0,48000,0,48000,48000
20200312,05618P,聯發科元富96售02,2.45,3.33,2.45,3.33,+1.27,61.65,263000,22,703870,0,0,0,0,0,0,115000,148000,-33000,-33000
20200312,056190,昇陽半統一97購01,0.64,0.64,0.64,0.64,-0.29,-31.18,10000,1,6400,0,0,0,0,0,0,10000,0,10000,10000
20200312,056191,世紀鋼統一97購01,2.63,2.63,2.17,2.32,-0.42,-15.33,43000,6,108270,0,0,0,0,0,0,41000,2000,39000,39000
20200312,056192,智邦富邦98購01,0.51,0.51,0.39,0.42,-0.10,-19.23,441000,15,185750,0,0,0,0,0,0,303000,65000,238000,238000
20200312,056193,聯發科富邦99購08,0.57,0.57,0.41,0.44,-0.19,-30.16,1150000,46,519860,0,0,0,0,0,0,381000,768000,-387000,-387000
20200312,056194,聯發科富邦9B購01,0.73,0.73,0.53,0.54,-0.33,-37.93,146000,15,87410,0,0,0,0,0,0,49000,96000,-47000,-47000
20200312,056195,群創富邦98購01,,,,,0.00,0.00,0,0,0,0,0,0,0,0,0,0,0,0,0
20200312,056196,聯茂富邦98購02,,,,,0.00,0.00,0,0,0,0,0,0,0,0,0,0,0,0,0
20200312,056197,友訊永豐97購01,0.13,0.13,0.13,0.13,0.00,0.00,20000,2,2600,0,0,0,0,0,0,0,20000,-20000,-20000
20200312,056198,台光電永豐97購02,0.58,0.62,0.53,0.53,-0.17,-24.29,57000,6,34010,0,0,0,0,0,0,27000,55000,-28000,-28000
20200312,056199,美律永豐97購01,0.26,0.26,0.26,0.26,-0.17,-39.53,56000,1,14560,0,0,0,0,0,0,56000,0,56000,56000
20200312,05619P,創意元富96售02,2.38,2.76,2.36,2.69,+0.50,22.83,389000,13,1026790,0,0,0,0,0,0,295000,94000,201000,201000
20200312,056200,大毅永豐98購01,0.89,0.89,0.67,0.69,-0.29,-29.59,123000,14,93660,0,0,0,0,0,0,53000,70000,-17000,-17000
20200312,056201,華新科永豐98購01,0.23,0.23,0.15,0.15,-0.20,-57.14,90000,2,15900,0,0,0,0,0,0,90000,0,90000,90000
20200312,056202,國揚永豐97購01,,,,,0.00,0.00,0,0,0,0,0,0,0,0,0,0,0,0,0
20200312,056203,興富發永豐97購01,,,,,0.00,0.00,0,0,0,0,0,0,0,0,0,0,0,0,0
20200312,056204,嘉澤永豐97購01,0.13,0.13,0.08,0.09,-0.12,-57.14,60000,5,6100,0,0,0,0,0,0,0,60000,-60000,-60000
20200312,056205,貿聯永豐97購01,,,,,0.00,0.00,0,0,0,0,0,0,0,0,0,0,0,0,0
20200312,056206,泰鼎永豐97購01,0.85,0.86,0.59,0.60,-0.52,-46.43,349000,20,234580,0,0,0,0,0,0,215000,109000,106000,106000
20200312,056207,茂林永豐97購03,0.18,0.18,0.15,0.15,0.00,0.00,410000,15,61800,0,0,0,0,0,0,0,410000,-410000,-410000
20200312,056208,崇越永豐97購01,,,,,0.00,0.00,0,0,0,0,0,0,0,0,0,0,0,0,0
20200312,056209,超眾永豐97購02,0.69,0.69,0.59,0.59,-0.21,-26.25,20000,2,12800,0,0,0,0,0,0,10000,10000,0,0
20200312,05620P,大立光富邦9B售01,0.76,0.88,0.70,0.88,+0.18,25.71,997000,52,825440,0,0,0,0,0,0,491000,300000,191000,191000
20200312,056210,矽創永豐97購02,0.31,0.31,0.21,0.21,-0.19,-47.5,225000,5,49300,0,0,0,0,0,0,0,225000,-225000,-225000
20200312,056211,南港國票98購01,0.54,0.54,0.42,0.42,-0.18,-30.0,46000,8,22020,0,0,0,0,0,0,36000,10000,26000,26000
20200312,056212,台光電國票98購03,2.15,2.29,1.78,1.85,-0.72,-28.02,24000,6,51830,0,0,0,0,0,0,9000,15000,-6000,-6000
20200312,056213,建準國票98購02,,,,,0.00,0.00,0,0,0,0,0,0,0,0,0,0,0,0,0
20200312,056214,義隆國票99購01,0.90,0.93,0.90,0.93,-0.30,-24.39,92000,2,84960,0,0,0,0,0,0,92000,0,92000,92000
20200312,056215,華新科國票97購03,,,,,0.00,0.00,0,0,0,0,0,0,0,0,0,0,0,0,0
20200312,056216,智原第一97購01,,,,,0.00,0.00,0,0,0,0,0,0,0,0,0,0,0,0,0
20200312,056217,A50正2中信99購02,,,,,0.00,0.00,0,0,0,0,0,0,0,0,0,0,0,0,0
20200312,056218,億光中信98購01,,,,,0.00,0.00,0,0,0,0,0,0,0,0,0,0,0,0,0
20200312,056219,T50反1日盛02購01,1.55,1.87,1.52,1.79,+0.39,27.86,1167000,30,2086210,0,0,0,0,0,0,1058000,1082000,-24000,-24000
20200312,05621P,聯電中信96售01,1.32,1.61,1.32,1.44,+0.21,17.07,304000,39,445910,0,0,0,0,0,0,224000,277000,-53000,-53000
20200312,056220,上証2X凱基99購01,0.72,0.72,0.72,0.72,-0.16,-18.18,100000,1,72000,0,0,0,0,0,0,0,100000,-100000,-100000
20200312,056221,鴻海凱基99購01,0.18,0.18,0.15,0.16,-0.13,-44.83,404000,16,69970,0,0,0,0,0,0,0,404000,-404000,-404000
20200312,056222,台積電凱基9A購01,1.23,1.23,0.87,1.14,-0.36,-24.0,1014000,21,1067000,0,0,0,0,0,0,284000,710000,-426000,-426000
20200312,056223,華邦電凱基97購04,0.47,0.47,0.47,0.47,+0.05,11.9,10000,1,4700,0,0,0,0,0,0,10000,0,10000,10000
20200312,056224,聯發科凱基97購08,0.37,0.37,0.37,0.37,-0.25,-40.32,68000,1,25160,0,0,0,0,0,0,68000,0,68000,68000
20200312,056225,聯發科凱基97購09,0.78,0.78,0.78,0.78,0.00,0.00,98000,1,76440,0,0,0,0,0,0,0,98000,-98000,-98000
20200312,056226,聯發科凱基97購10,,,,,0.00,0.00,0,0,0,0,0,0,0,0,0,0,0,0,0
20200312,056227,奇力新凱基98購04,0.25,0.25,0.24,0.24,-0.06,-20.0,118000,2,29000,0,0,0,0,0,0,118000,0,118000,118000
20200312,056228,可成凱基97購03,,,,,0.00,0.00,0,0,0,0,0,0,0,0,0,0,0,0,0
20200312,056229,可成凱基97購04,0.46,0.52,0.46,0.46,-0.52,-53.06,35000,4,16950,0,0,0,0,0,0,10000,25000,-15000,-15000
20200312,05622P,台積電中信96售02,0.76,0.77,0.69,0.69,+0.26,60.47,500000,6,376400,0,0,0,0,0,0,480000,20000,460000,460000
20200312,056230,可成凱基98購03,0.69,0.69,0.69,0.69,-0.29,-29.59,60000,1,41400,0,0,0,0,0,0,60000,0,60000,60000
20200312,056231,嘉聯益凱基97購02,0.52,0.59,0.52,0.55,-0.37,-40.22,118000,4,67620,0,0,0,0,0,0,0,118000,-118000,-118000
20200312,056232,瑞儀凱基98購01,0.24,0.24,0.20,0.20,-0.12,-37.5,700000,4,165000,0,0,0,0,0,0,100000,600000,-500000,-500000
20200312,056233,超眾凱基97購02,1.17,1.17,0.98,0.98,-0.61,-38.36,30000,3,31500,0,0,0,0,0,0,10000,20000,-10000,-10000
20200312,056234,GIS麥證97購01,,,,,0.00,0.00,0,0,0,0,0,0,0,0,0,0,0,0,0
20200312,056235,鴻海群益97購07,0.16,0.16,0.12,0.12,0.00,0.00,140000,3,18400,0,0,0,0,0,0,0,140000,-140000,-140000
20200312,056236,台積電群益97購06,0.40,0.48,0.31,0.48,-0.07,-12.73,2222000,44,859470,0,0,0,0,0,0,1063000,1058000,5000,5000
20200312,056237,智邦群益97購02,1.75,1.75,1.14,1.21,-0.64,-34.59,155000,13,236220,0,0,0,0,0,0,119000,52000,67000,67000
20200312,056238,聯發科群益98購02,0.70,0.70,0.61,0.61,-0.30,-32.97,140000,2,94400,0,0,0,0,0,0,40000,100000,-60000,-60000
20200312,056239,宏達電群益98購01,,,,,0.00,0.00,0,0,0,0,0,0,0,0,0,0,0,0,0
20200312,05623P,台積電中信96售03,0.70,0.76,0.70,0.71,+0.13,22.41,151000,7,110340,0,0,0,0,0,0,30000,121000,-91000,-91000
20200312,056240,嘉晶群益97購02,0.94,1.04,0.70,0.90,-0.08,-8.16,708000,45,626280,0,0,0,0,0,0,543000,141000,402000,402000
20200312,056241,緯創群益97購01,,,,,0.00,0.00,0,0,0,0,0,0,0,0,0,0,0,0,0
20200312,056242,緯創群益9A購01,,,,,0.00,0.00,0,0,0,0,0,0,0,0,0,0,0,0,0
20200312,056243,創意群益97購03,0.54,0.54,0.50,0.50,-0.32,-39.02,103000,2,55420,0,0,0,0,0,0,5000,98000,-93000,-93000
20200312,056244,群創群益98購09,,,,,0.00,0.00,0,0,0,0,0,0,0,0,0,0,0,0,0
20200312,056245,嘉澤群益97購01,0.60,0.60,0.60,0.60,0.00,0.00,15000,2,9000,0,0,0,0,0,0,15000,0,15000,15000
20200312,056246,祥碩群益97購01,2.23,2.37,1.75,1.90,-0.50,-20.83,158000,17,323840,0,0,0,0,0,0,93000,85000,8000,8000
20200312,056247,台郡群益97購01,0.50,0.53,0.39,0.42,-0.43,-50.59,237000,10,100640,0,0,0,0,0,0,236000,0,236000,236000
20200312,056248,康友群益97購04,1.99,2.05,1.52,1.62,-0.69,-29.87,237000,13,428900,0,0,0,0,0,0,139000,184000,-45000,-45000
20200312,056249,鴻海兆豐97購05,,,,,0.00,0.00,0,0,0,0,0,0,0,0,0,0,0,0,0
20200312,05624P,同欣電中信98售01,0.75,0.89,0.74,0.88,+0.16,22.22,727000,19,576940,0,0,0,0,0,0,568000,139000,429000,429000
20200312,056250,瑞昱兆豐97購02,0.15,0.15,0.12,0.12,0.00,0.00,20000,2,2700,0,0,0,0,0,0,0,20000,-20000,-20000
20200312,056251,聯發科兆豐97購02,,,,,0.00,0.00,0,0,0,0,0,0,0,0,0,0,0,0,0
20200312,056252,聯發科兆豐97購03,0.22,0.22,0.22,0.22,0.00,0.00,5000,1,1100,0,0,0,0,0,0,0,5000,-5000,-5000
20200312,056253,京鼎兆豐98購01,,,,,0.00,0.00,0,0,0,0,0,0,0,0,0,0,0,0,0
20200312,056254,為升元富97購01,0.09,0.09,0.09,0.09,-0.08,-47.06,20000,1,1800,0,0,0,0,0,0,20000,0,20000,20000
20200312,056255,華新科元富97購05,0.51,0.51,0.33,0.33,-0.33,-50.0,280000,5,130800,0,0,0,0,0,0,210000,70000,140000,140000
20200312,056256,聯茂元富97購03,0.98,0.98,0.86,0.86,-0.42,-32.81,135000,5,125400,0,0,0,0,0,0,75000,65000,10000,10000
20200312,056257,聯茂元富97購04,1.07,1.07,0.91,0.91,-0.46,-33.58,639000,4,595690,0,0,0,0,0,0,120000,519000,-399000,-399000
20200312,056258,訊芯元富97購04,0.18,0.18,0.18,0.18,0.00,0.00,10000,1,1800,0,0,0,0,0,0,0,10000,-10000,-10000
20200312,056259,T50反1統一9A購01,2.31,2.31,2.25,2.25,0.00,0.00,56000,2,127560,0,0,0,0,0,0,56000,0,56000,56000
20200312,05625P,國巨國票97售01,0.82,1.08,0.82,1.00,+0.36,56.25,140000,7,126540,0,0,0,0,0,0,30000,110000,-80000,-80000
20200312,056260,鴻海統一98購07,,,,,0.00,0.00,0,0,0,0,0,0,0,0,0,0,0,0,0
20200312,056261,台積電統一97購07,0.79,0.79,0.51,0.75,-0.20,-21.05,324000,16,210300,0,0,0,0,0,0,19000,305000,-286000,-286000
20200312,056262,台積電統一98購04,0.57,0.57,0.45,0.50,-0.31,-38.27,453000,9,237850,0,0,0,0,0,0,100000,353000,-253000,-253000
20200312,056263,友訊統一99購01,0.46,0.46,0.46,0.46,-0.10,-17.86,48000,1,22080,0,0,0,0,0,0,0,48000,-48000,-48000
20200312,056264,聯發科統一98購02,,,,,0.00,0.00,0,0,0,0,0,0,0,0,0,0,0,0,0
20200312,056265,國泰金統一97購01,0.30,0.30,0.30,0.30,0.00,0.00,200000,1,60000,0,0,0,0,0,0,0,200000,-200000,-200000
20200312,056266,開發金統一9A購01,,,,,0.00,0.00,0,0,0,0,0,0,0,0,0,0,0,0,0
20200312,056267,文曄統一97購02,,,,,0.00,0.00,0,0,0,0,0,0,0,0,0,0,0,0,0
20200312,056268,新日興統一97購01,0.54,0.54,0.50,0.50,-0.53,-51.46,48000,2,25120,0,0,0,0,0,0,20000,28000,-8000,-8000
20200312,056269,新日興統一98購01,0.94,0.94,0.73,0.73,-0.26,-26.26,97000,8,79980,0,0,0,0,0,0,49000,48000,1000,1000
20200312,05626P,景碩國票97售03,2.45,2.77,2.45,2.77,+0.59,27.06,30000,4,75860,0,0,0,0,0,0,20000,10000,10000,10000
20200312,056270,群創統一98購04,0.11,0.11,0.05,0.06,-0.06,-50.0,619000,10,36150,0,0,0,0,0,0,0,0,0,0
20200312,056271,嘉澤統一97購01,,,,,0.00,0.00,0,0,0,0,0,0,0,0,0,0,0,0,0
20200312,056272,嘉澤統一99購01,0.75,0.75,0.62,0.63,-0.47,-42.73,74000,9,50060,0,0,0,0,0,0,0,74000,-74000,-74000
20200312,056273,祥碩統一97購02,1.53,1.53,1.53,1.53,-1.18,-43.54,5000,1,7650,0,0,0,0,0,0,0,5000,-5000,-5000
20200312,056274,彩晶統一98購02,,,,,0.00,0.00,0,0,0,0,0,0,0,0,0,0,0,0,0
20200312,056275,國巨國泰98購04,1.51,1.51,1.10,1.10,-0.60,-35.29,43000,6,55290,0,0,0,0,0,0,13000,30000,-17000,-17000
20200312,056276,同欣電國泰98購01,0.45,0.45,0.31,0.36,-0.19,-34.55,663000,9,243650,0,0,0,0,0,0,315000,348000,-33000,-33000
20200312,056277,上銀富邦99購02,0.55,0.55,0.35,0.35,-0.30,-46.15,474000,39,238740,0,0,0,0,0,0,369000,105000,264000,264000
20200312,056278,全新富邦98購02,,,,,0.00,0.00,0,0,0,0,0,0,0,0,0,0,0,0,0
20200312,056279,新日興富邦99購01,0.45,0.45,0.34,0.34,-0.17,-33.33,72000,8,26900,0,0,0,0,0,0,40000,42000,-2000,-2000
20200312,05627P,致伸國票97售01,3.55,3.74,3.55,3.74,+0.39,11.64,61000,6,223010,0,0,0,0,0,0,51000,10000,41000,41000
20200312,056280,上証2X永豐98購01,,,,,0.00,0.00,0,0,0,0,0,0,0,0,0,0,0,0,0
20200312,056281,深中小永豐97購01,,,,,0.00,0.00,0,0,0,0,0,0,0,0,0,0,0,0,0
20200312,056282,S&P反1永豐97購01,,,,,0.00,0.00,0,0,0,0,0,0,0,0,0,0,0,0,0
20200312,056283,鴻海永豐97購03,0.05,0.05,0.05,0.05,-0.05,-50.0,400000,38,20000,0,0,0,0,0,0,35000,365000,-330000,-330000
20200312,056284,台積電永豐97購06,0.09,0.09,0.05,0.08,-0.03,-27.27,1369000,36,89280,0,0,0,0,0,0,837000,522000,315000,315000
20200312,056285,可成永豐97購02,0.09,0.09,0.09,0.09,-0.14,-60.87,5000,1,450,0,0,0,0,0,0,0,5000,-5000,-5000
20200312,056286,奇鋐永豐97購01,0.52,0.52,0.40,0.40,-0.26,-39.39,15000,3,7440,0,0,0,0,0,0,2000,13000,-11000,-11000
20200312,056287,亞光永豐97購02,,,,,0.00,0.00,0,0,0,0,0,0,0,0,0,0,0,0,0
20200312,056288,健鼎永豐97購01,0.39,0.39,0.39,0.39,-0.09,-18.75,68000,1,26520,0,0,0,0,0,0,0,68000,-68000,-68000
20200312,056289,合勤控永豐97購01,,,,,0.00,0.00,0,0,0,0,0,0,0,0,0,0,0,0,0
20200312,05628P,茂林國票97售02,1.42,1.89,1.42,1.89,+0.70,58.82,53000,5,84610,0,0,0,0,0,0,20000,33000,-13000,-13000
20200312,056290,正文永豐98購01,0.79,0.79,0.57,0.61,-0.16,-20.78,341000,19,232750,0,0,0,0,0,0,90000,251000,-161000,-161000
20200312,056291,聯茂永豐97購03,1.06,1.06,0.74,0.74,-0.52,-41.27,145000,5,135060,0,0,0,0,0,0,77000,76000,1000,1000
20200312,056292,統一元大97購01,2.01,2.01,1.45,1.60,-0.53,-24.88,290000,19,490420,0,0,0,0,0,0,171000,123000,48000,48000
20200312,056293,上銀元大97購10,0.76,0.76,0.57,0.57,-0.58,-50.43,163000,6,115470,0,0,0,0,0,0,68000,95000,-27000,-27000
20200312,056294,上銀元大97購11,0.77,0.77,0.72,0.72,-0.25,-25.77,78000,2,56660,0,0,0,0,0,0,78000,0,78000,78000
20200312,056295,國巨元大97購16,2.43,2.43,2.36,2.36,-0.72,-23.38,34000,2,81220,0,0,0,0,0,0,34000,20000,14000,14000
20200312,056296,旺宏元大97購07,,,,,0.00,0.00,0,0,0,0,0,0,0,0,0,0,0,0,0
20200312,056297,台光電元大97購04,0.89,0.89,0.73,0.73,-0.23,-23.96,129000,10,104030,0,0,0,0,0,0,79000,92000,-13000,-13000
20200312,056298,億光元大97購02,,,,,0.00,0.00,0,0,0,0,0,0,0,0,0,0,0,0,0
20200312,056299,友達元大9B購04,0.68,0.68,0.50,0.52,-0.22,-29.73,28000,5,16030,0,0,0,0,0,0,13000,25000,-12000,-12000
20200312,05629P,聯發科永昌99售02,5.10,5.75,5.10,5.75,+1.23,27.21,25000,3,140000,0,0,0,0,0,0,25000,0,25000,25000
20200312,056300,聯發科元大97購23,0.86,0.86,0.63,0.63,-0.41,-39.42,234000,6,172180,0,0,0,0,0,0,164000,70000,94000,94000
20200312,056301,開發金元大9A購01,,,,,0.00,0.00,0,0,0,0,0,0,0,0,0,0,0,0,0
20200312,056302,大立光元大97購17,,,,,0.00,0.00,0,0,0,0,0,0,0,0,0,0,0,0,0
20200312,056303,亞光元大97購04,0.51,0.51,0.51,0.51,-0.21,-29.17,10000,1,5100,0,0,0,0,0,0,0,10000,-10000,-10000
20200312,056304,創意元大97購03,0.36,0.36,0.33,0.34,-0.17,-33.33,68000,3,23220,0,0,0,0,0,0,68000,0,68000,68000
20200312,056305,群創元大9A購03,0.55,0.55,0.43,0.43,-0.20,-31.75,199000,5,87970,0,0,0,0,0,0,104000,98000,6000,6000
20200312,056306,晶相光元大98購01,1.15,1.15,0.87,0.94,-0.30,-24.19,105000,16,104590,0,0,0,0,0,0,42000,63000,-21000,-21000
20200312,056307,貿聯元大97購05,0.49,0.49,0.49,0.49,-0.13,-20.97,10000,1,4900,0,0,0,0,0,0,10000,0,10000,10000
20200312,056308,TPK元大97購02,0.96,0.96,0.86,0.86,-0.30,-25.86,154000,4,135500,0,0,0,0,0,0,86000,68000,18000,18000
20200312,056309,合勤控元大97購01,0.69,0.69,0.69,0.69,-0.24,-25.81,20000,1,13800,0,0,0,0,0,0,20000,0,20000,20000
20200312,05630P,大立光永昌96售06,3.37,4.05,3.37,3.74,+1.13,43.3,310000,10,1161190,0,0,0,0,0,0,238000,272000,-34000,-34000
20200312,056310,神達元大97購02,2.22,2.22,1.79,1.93,-0.60,-23.72,90000,14,175140,0,0,0,0,0,0,58000,50000,8000,8000
20200312,056311,泰鼎元大98購01,1.49,1.49,1.07,1.07,-0.41,-27.7,804000,45,1029330,0,0,0,0,0,0,596000,208000,388000,388000
20200312,056312,茂林元大98購01,0.48,0.48,0.33,0.33,-0.17,-34.0,769000,31,308020,0,0,0,0,0,0,366000,493000,-127000,-127000
20200312,056313,聯茂元大98購01,1.54,1.54,1.16,1.16,-0.43,-27.04,123000,9,174000,0,0,0,0,0,0,22000,112000,-90000,-90000
20200312,056314,力成元大97購01,1.18,1.18,0.83,0.83,-0.64,-43.54,112000,10,118320,0,0,0,0,0,0,112000,0,112000,112000
20200312,056315,同欣電元大97購05,0.40,0.40,0.27,0.33,-0.22,-40.0,598000,10,182960,0,0,0,0,0,0,370000,218000,152000,152000
20200312,056316,訊芯元大98購03,0.22,0.26,0.22,0.24,-0.11,-31.43,380000,3,86600,0,0,0,0,0,0,300000,80000,220000,220000
20200312,056317,華通群益99購02,0.28,0.28,0.28,0.28,0.00,0.00,8000,1,2240,0,0,0,0,0,0,8000,0,8000,8000
20200312,056318,鴻海群益98購02,0.40,0.40,0.38,0.38,0.00,0.00,15000,2,5800,0,0,0,0,0,0,10000,5000,5000,5000
20200312,056319,智原群益98購02,,,,,0.00,0.00,0,0,0,0,0,0,0,0,0,0,0,0,0
20200312,05631P,國巨富邦9A售01,0.78,0.94,0.78,0.94,+0.21,28.77,146000,13,123430,0,0,0,0,0,0,123000,22000,101000,101000
20200312,056320,京鼎群益99購01,0.55,0.56,0.55,0.56,-0.11,-16.42,175000,5,96360,0,0,0,0,0,0,22000,153000,-131000,-131000
20200312,056321,創意群益98購02,0.50,0.50,0.32,0.34,-0.41,-54.67,467000,6,188140,0,0,0,0,0,0,248000,219000,29000,29000
20200312,056322,臺股指群益98購01,0.13,0.14,0.13,0.14,-0.11,-44.0,19000,2,2480,0,0,0,0,0,0,18000,0,18000,18000
20200312,056323,旺宏兆豐98購01,0.28,0.28,0.28,0.28,0.00,0.00,40000,1,11200,0,0,0,0,0,0,40000,0,40000,40000
20200312,056324,南亞科兆豐98購01,,,,,0.00,0.00,0,0,0,0,0,0,0,0,0,0,0,0,0
20200312,056325,群創兆豐9A購01,0.09,0.10,0.09,0.10,0.00,0.00,280000,15,27700,0,0,0,0,0,0,30000,250000,-220000,-220000
20200312,056326,TPK兆豐98購01,0.39,0.40,0.38,0.38,-0.14,-26.92,145000,5,56980,0,0,0,0,0,0,145000,0,145000,145000
20200312,056327,樺漢兆豐98購01,0.64,0.64,0.64,0.64,-0.23,-26.44,38000,1,24320,0,0,0,0,0,0,38000,0,38000,38000
20200312,056328,訊芯兆豐98購01,0.16,0.16,0.16,0.16,0.00,0.00,1000,1,160,0,0,0,0,0,0,1000,0,1000,1000
20200312,056329,上銀國票98購02,0.58,0.58,0.33,0.36,-0.47,-56.63,715000,8,341110,0,0,0,0,0,0,181000,534000,-353000,-353000
20200312,05632P,大立光群益96售02,3.17,3.78,3.16,3.78,+1.41,59.49,91000,8,290860,0,0,0,0,0,0,52000,39000,13000,13000
20200312,056330,玉晶光國票99購03,,,,,0.00,0.00,0,0,0,0,0,0,0,0,0,0,0,0,0
20200312,056331,聯鈞國票99購01,0.89,0.90,0.67,0.70,-0.32,-31.37,340000,37,251970,0,0,0,0,0,0,126000,209000,-83000,-83000
20200312,056332,台郡國票99購01,1.86,1.86,1.39,1.50,-0.78,-34.21,76000,8,122620,0,0,0,0,0,0,38000,38000,0,0
20200312,056333,台積電日盛9B購01,0.80,0.80,0.53,0.66,-0.27,-29.03,1537000,43,1053410,0,0,0,0,0,0,885000,652000,233000,233000
20200312,056334,台積電凱基98購06,0.99,0.99,0.95,0.95,0.00,0.00,1497000,3,1462070,0,0,0,0,0,0,0,1497000,-1497000,-1497000
20200312,056335,微星凱基98購01,0.61,0.63,0.60,0.60,-0.11,-15.49,32000,3,19500,0,0,0,0,0,0,32000,0,32000,32000
20200312,056336,南亞科凱基98購02,0.53,0.54,0.44,0.44,-0.44,-50.0,136000,3,66540,0,0,0,0,0,0,68000,68000,0,0
20200312,056337,聯發科凱基98購06,,,,,0.00,0.00,0,0,0,0,0,0,0,0,0,0,0,0,0
20200312,056338,聯發科凱基99購01,1.15,1.15,0.76,0.76,-0.73,-48.99,100000,10,99900,0,0,0,0,0,0,70000,30000,40000,40000
20200312,056339,聯發科凱基99購02,0.77,0.79,0.53,0.53,-0.60,-53.1,229000,7,158000,0,0,0,0,0,0,153000,76000,77000,77000
20200312,05633P,台表科群益96售04,3.26,3.30,3.26,3.30,+0.09,2.8,28000,2,91880,0,0,0,0,0,0,28000,0,28000,28000
20200312,056340,可成凱基98購04,0.95,0.98,0.74,0.79,-0.64,-44.76,82000,8,68340,0,0,0,0,0,0,42000,82000,-40000,-40000
20200312,056341,宏達電凱基9A購01,0.49,0.50,0.37,0.37,-0.15,-28.85,899000,25,377300,0,0,0,0,0,0,245000,654000,-409000,-409000
20200312,056342,中工凱基98購01,0.53,0.53,0.45,0.46,-0.17,-26.98,1025000,26,475500,0,0,0,0,0,0,50000,1025000,-975000,-975000
20200312,056343,高鐵凱基98購02,,,,,0.00,0.00,0,0,0,0,0,0,0,0,0,0,0,0,0
20200312,056344,嘉晶凱基98購02,1.16,1.30,0.98,1.02,-0.19,-15.7,416000,34,474270,0,0,0,0,0,0,164000,253000,-89000,-89000
20200312,056345,嘉聯益凱基99購01,0.46,0.46,0.34,0.35,-0.18,-33.96,1060000,13,418700,0,0,0,0,0,0,170000,890000,-720000,-720000
20200312,056346,聯茂凱基99購02,0.77,0.77,0.38,0.38,-0.47,-55.29,485000,26,292550,0,0,0,0,0,0,339000,62000,277000,277000
20200312,056347,GIS凱基9A購01,0.45,0.45,0.34,0.34,-0.24,-41.38,65000,3,23750,0,0,0,0,0,0,15000,50000,-35000,-35000
20200312,056348,S&P反1元大9A購01,2.90,3.39,2.90,3.20,+0.53,19.85,24000,5,76660,0,0,0,0,0,0,23000,1000,22000,22000
20200312,056349,道瓊銀元大9B購01,0.83,0.84,0.78,0.78,-0.19,-19.59,208000,4,169140,0,0,0,0,0,0,8000,200000,-192000,-192000
20200312,05634P,玉晶光台新97售01,0.93,1.02,0.93,1.02,+0.13,14.61,101000,2,98160,0,0,0,0,0,0,54000,47000,7000,7000
20200312,056350,上銀元大98購02,0.76,0.76,0.49,0.49,-0.67,-57.76,35000,3,21100,0,0,0,0,0,0,15000,20000,-5000,-5000
20200312,056351,鴻海元大98購06,0.73,0.73,0.72,0.72,-0.20,-21.74,118000,4,86060,0,0,0,0,0,0,118000,0,118000,118000
20200312,056352,鴻海元大99購01,0.82,0.84,0.67,0.68,-0.39,-36.45,64000,10,49580,0,0,0,0,0,0,56000,14000,42000,42000
20200312,056353,鴻海元大99購02,0.72,0.72,0.56,0.57,-0.25,-30.49,182000,15,114650,0,0,0,0,0,0,95000,87000,8000,8000
20200312,056354,國巨元大98購10,2.58,2.58,2.44,2.44,-0.38,-13.48,87000,2,223060,0,0,0,0,0,0,87000,77000,10000,10000
20200312,056355,台積電元大98購08,1.20,1.21,0.90,1.09,-0.29,-21.01,440000,21,463630,0,0,0,0,0,0,282000,340000,-58000,-58000
20200312,056356,台積電元大99購01,0.76,0.76,0.59,0.66,-0.17,-20.48,983000,51,667820,0,0,0,0,0,0,389000,694000,-305000,-305000
20200312,056357,台積電元大9A購01,1.02,1.03,0.79,0.92,-0.23,-20.0,1435000,51,1315640,0,0,0,0,0,0,708000,999000,-291000,-291000
20200312,056358,友訊元大99購01,0.85,0.85,0.66,0.66,-0.28,-29.79,146000,6,108500,0,0,0,0,0,0,78000,68000,10000,10000
20200312,056359,旺宏元大9A購01,0.58,0.58,0.50,0.50,-0.20,-28.57,53000,6,29560,0,0,0,0,0,0,37000,16000,21000,21000
20200312,05635P,健策台新96售02,1.12,1.23,1.12,1.23,+0.41,50.0,135000,11,157650,0,0,0,0,0,0,75000,60000,15000,15000
20200312,056360,智邦元大98購01,1.61,1.61,1.34,1.35,-0.41,-23.3,36000,6,51630,0,0,0,0,0,0,36000,0,36000,36000
20200312,056361,美律元大99購02,0.48,0.48,0.29,0.29,-0.27,-48.21,60000,2,19300,0,0,0,0,0,0,0,60000,-60000,-60000
20200312,056362,聯發科元大99購01,0.72,0.72,0.46,0.63,-0.31,-32.98,266000,15,173270,0,0,0,0,0,0,105000,156000,-51000,-51000
20200312,056363,華新科元大99購04,1.64,1.64,1.17,1.17,-0.49,-29.52,138000,3,198920,0,0,0,0,0,0,50000,88000,-38000,-38000
20200312,056364,亞光元大99購02,0.24,0.26,0.24,0.26,-0.16,-38.1,100000,2,25000,0,0,0,0,0,0,50000,50000,0,0
20200312,056365,欣興元大98購01,0.84,0.84,0.84,0.84,-0.65,-43.62,60000,2,50400,0,0,0,0,0,0,60000,0,60000,60000
20200312,056366,玉晶光元大99購04,1.19,1.19,0.97,0.97,-0.67,-40.85,79000,3,91660,0,0,0,0,0,0,11000,69000,-58000,-58000
20200312,056367,祥碩元大98購01,2.97,2.99,2.26,2.55,-0.36,-12.37,187000,20,460630,0,0,0,0,0,0,22000,175000,-153000,-153000
20200312,056368,祥碩元大98購02,2.52,2.57,2.19,2.22,-0.37,-14.29,41000,7,95060,0,0,0,0,0,0,19000,32000,-13000,-13000
20200312,056369,彩晶元大01購01,,,,,0.00,0.00,0,0,0,0,0,0,0,0,0,0,0,0,0
20200312,05636P,國巨永豐96售03,0.68,1.00,0.68,0.94,+0.24,34.29,817000,18,604910,0,0,0,0,0,0,535000,79000,456000,456000
20200312,056370,台郡元大98購03,0.77,0.83,0.66,0.68,-0.42,-38.18,345000,7,263290,0,0,0,0,0,0,242000,103000,139000,139000
20200312,056371,樺漢元大98購03,1.01,1.01,0.67,0.67,-0.63,-48.46,266000,7,189740,0,0,0,0,0,0,18000,248000,-230000,-230000
20200312,056372,訊芯元大98購04,,,,,0.00,0.00,0,0,0,0,0,0,0,0,0,0,0,0,0
20200312,056373,上銀統一99購02,0.33,0.33,0.33,0.33,-0.15,-31.25,64000,1,21120,0,0,0,0,0,0,64000,0,64000,64000
20200312,056374,聯發科統一9B購01,0.89,0.89,0.68,0.69,-0.33,-32.35,88000,11,72930,0,0,0,0,0,0,0,88000,-88000,-88000
20200312,056375,玉晶光統一01購01,0.53,0.53,0.48,0.48,0.00,0.00,60000,3,31400,0,0,0,0,0,0,5000,55000,-50000,-50000
20200312,056376,玉晶光統一98購01,0.40,0.40,0.40,0.40,0.00,0.00,30000,1,12000,0,0,0,0,0,0,0,30000,-30000,-30000
20200312,056377,智伸科統一9A購01,0.15,0.15,0.11,0.11,-0.06,-35.29,100000,6,13100,0,0,0,0,0,0,0,100000,-100000,-100000
20200312,056378,欣興元富98購01,0.80,0.80,0.80,0.80,-0.71,-47.02,26000,1,20800,0,0,0,0,0,0,26000,0,26000,26000
20200312,056379,玉晶光元富98購01,,,,,0.00,0.00,0,0,0,0,0,0,0,0,0,0,0,0,0
20200312,05637P,聯電元大96售04,1.38,1.44,1.38,1.42,0.00,0.00,231000,7,325800,0,0,0,0,0,0,28000,203000,-175000,-175000
20200312,056380,麗豐元富98購01,0.36,0.36,0.36,0.36,-0.16,-30.77,20000,1,7200,0,0,0,0,0,0,20000,0,20000,20000
20200312,056381,台虹元富98購01,1.25,1.27,1.04,1.13,-0.32,-22.07,102000,12,121340,0,0,0,0,0,0,33000,69000,-36000,-36000
20200312,056382,道瓊反國泰9A購01,2.58,2.58,2.54,2.54,0.00,0.00,2000,2,5120,0,0,0,0,0,0,0,2000,-2000,-2000
20200312,056383,上銀國泰99購01,1.64,1.64,1.64,1.64,-0.54,-24.77,22000,1,36080,0,0,0,0,0,0,22000,0,22000,22000
20200312,056384,玉晶光國泰9A購02,0.78,0.78,0.54,0.54,-0.36,-40.0,55000,4,35400,0,0,0,0,0,0,35000,20000,15000,15000
20200312,056385,創意國泰99購01,0.57,0.57,0.40,0.43,-0.32,-42.67,246000,7,102420,0,0,0,0,0,0,226000,0,226000,226000
20200312,056386,TPK國泰99購01,1.18,1.18,0.75,0.75,-0.53,-41.41,107000,51,117740,0,0,0,0,0,0,104000,11000,93000,93000
20200312,056387,智伸科國泰99購01,0.38,0.38,0.35,0.35,-0.05,-12.5,311000,3,115230,0,0,0,0,0,0,213000,98000,115000,115000
20200312,056388,勤誠國泰99購01,0.37,0.37,0.30,0.32,0.00,0.00,200000,4,72800,0,0,0,0,0,0,170000,30000,140000,140000
20200312,056389,鴻海富邦99購01,,,,,0.00,0.00,0,0,0,0,0,0,0,0,0,0,0,0,0
20200312,05638P,國巨統一96售04,1.41,2.03,1.38,2.02,+0.62,44.29,1295000,100,2032240,0,0,0,0,0,0,1004000,77000,927000,927000
20200312,056390,台積電富邦9B購01,0.32,0.32,0.23,0.29,-0.07,-19.44,624000,54,170590,0,0,0,0,0,0,75000,479000,-404000,-404000
20200312,056391,大立光富邦9C購01,0.20,0.22,0.16,0.20,-0.08,-28.57,320000,26,62610,0,0,0,0,0,0,50000,201000,-151000,-151000
20200312,056392,玉晶光富邦9C購01,0.38,0.38,0.32,0.32,-0.17,-34.69,612000,5,228090,0,0,0,0,0,0,604000,8000,596000,596000
20200312,056393,精元永豐98購01,0.29,0.30,0.23,0.24,-0.13,-35.14,116000,5,29950,0,0,0,0,0,0,111000,5000,106000,106000
20200312,056394,晶豪科永豐98購01,1.12,1.12,0.71,0.71,-0.50,-41.32,182000,30,185020,0,0,0,0,0,0,132000,21000,111000,111000
20200312,056395,玉晶光永豐9B購01,,,,,0.00,0.00,0,0,0,0,0,0,0,0,0,0,0,0,0
20200312,056396,祥碩永豐98購01,0.73,0.73,0.53,0.53,-0.34,-39.08,354000,12,214530,0,0,0,0,0,0,20000,344000,-324000,-324000
20200312,056397,彩晶永豐99購01,,,,,0.00,0.00,0,0,0,0,0,0,0,0,0,0,0,0,0
20200312,056398,南茂永豐98購01,0.97,0.98,0.92,0.92,-0.25,-21.37,953000,20,919160,0,0,0,0,0,0,830000,123000,707000,707000
20200312,056399,上証2X群益9C購01,2.05,2.05,1.85,1.92,-0.38,-16.52,16000,6,31150,0,0,0,0,0,0,5000,11000,-6000,-6000
20200312,05639P,欣興統一97售01,2.87,3.07,2.87,3.07,+0.71,30.08,30000,3,90000,0,0,0,0,0,0,10000,20000,-10000,-10000
20200312,056400,道瓊反群益9C購01,,,,,0.00,0.00,0,0,0,0,0,0,0,0,0,0,0,0,0
20200312,056401,國巨群益98購07,2.32,2.32,1.61,1.61,-1.00,-38.31,137000,3,236870,0,0,0,0,0,0,137000,0,137000,137000
20200312,056402,智易群益98購02,1.63,1.63,1.15,1.15,-0.61,-34.66,276000,8,400100,0,0,0,0,0,0,146000,130000,16000,16000
20200312,056403,茂林群益98購01,0.59,0.59,0.56,0.56,-0.11,-16.42,134000,2,77980,0,0,0,0,0,0,36000,134000,-98000,-98000
20200312,056404,嘉聯益群益9A購01,1.18,1.18,0.93,0.93,-0.36,-27.91,132000,11,125820,0,0,0,0,0,0,7000,131000,-124000,-124000
20200312,056405,聯茂群益98購01,4.59,4.59,4.06,4.06,-1.29,-24.11,68000,8,298010,0,0,0,0,0,0,50000,21000,29000,29000
20200312,056406,建準國票99購01,1.19,1.23,1.04,1.04,-0.39,-27.27,138000,6,150320,0,0,0,0,0,0,98000,40000,58000,58000
20200312,056407,嘉晶國票99購01,4.71,5.25,4.08,4.08,-0.87,-17.58,156000,15,762790,0,0,0,0,0,0,87000,72000,15000,15000
20200312,056408,奇鋐國票99購01,1.07,1.07,1.01,1.01,-0.56,-35.67,43000,5,44610,0,0,0,0,0,0,23000,20000,3000,3000
20200312,056409,麗豐國票99購01,0.88,0.88,0.66,0.66,-0.42,-38.89,69000,5,50160,0,0,0,0,0,0,38000,31000,7000,7000
20200312,05640P,旺宏元富96售03,,,,,0.00,0.00,0,0,0,0,0,0,0,0,0,0,0,0,0
20200312,056410,康控國票99購01,1.37,1.37,1.37,1.37,-0.92,-40.17,38000,1,52060,0,0,0,0,0,0,38000,0,38000,38000
20200312,056411,緯穎國票99購01,2.44,2.44,2.44,2.44,-1.30,-34.76,5000,1,12200,0,0,0,0,0,0,0,5000,-5000,-5000
20200312,056412,上証2X中信9A購02,1.47,1.47,1.31,1.42,-0.13,-8.39,32000,21,45080,0,0,0,0,0,0,2000,30000,-28000,-28000
20200312,056413,上証反中信9A購01,0.39,0.41,0.39,0.41,+0.04,10.81,32000,3,13080,0,0,0,0,0,0,32000,0,32000,32000
20200312,056414,國巨中信98購02,0.52,0.52,0.40,0.40,-0.23,-36.51,32000,5,15310,0,0,0,0,0,0,27000,5000,22000,22000
20200312,056415,聯發科中信98購04,,,,,0.00,0.00,0,0,0,0,0,0,0,0,0,0,0,0,0
20200312,056416,華新科中信98購01,0.44,0.44,0.33,0.33,-0.28,-45.9,125000,7,47000,0,0,0,0,0,0,20000,105000,-85000,-85000
20200312,056417,欣興中信98購01,0.30,0.30,0.30,0.30,0.00,0.00,11000,2,3300,0,0,0,0,0,0,0,11000,-11000,-11000
20200312,056418,台光電元富98購01,1.24,1.24,1.00,1.00,-0.46,-31.51,131000,8,158480,0,0,0,0,0,0,123000,8000,115000,115000
20200312,056419,欣興元富98購02,1.32,1.33,1.00,1.00,-0.94,-48.45,47000,5,59260,0,0,0,0,0,0,38000,0,38000,38000
20200312,05641P,貿聯元富96售02,2.79,3.26,2.79,3.26,+0.57,21.19,198000,16,582600,0,0,0,0,0,0,78000,120000,-42000,-42000
20200312,056420,台表科元富98購01,0.44,0.44,0.34,0.34,-0.15,-30.61,20000,2,7800,0,0,0,0,0,0,0,20000,-20000,-20000
20200312,056421,鴻海統一98購08,0.91,0.91,0.78,0.78,-0.29,-27.1,141000,5,121350,0,0,0,0,0,0,93000,49000,44000,44000
20200312,056422,全新統一98購02,,,,,0.00,0.00,0,0,0,0,0,0,0,0,0,0,0,0,0
20200312,056423,奇鋐統一98購01,0.90,0.91,0.80,0.80,-0.14,-14.89,237000,9,204650,0,0,0,0,0,0,187000,50000,137000,137000
20200312,056424,泰碩統一98購01,2.42,2.54,2.07,2.20,-0.43,-16.35,50000,7,111270,0,0,0,0,0,0,39000,11000,28000,28000
20200312,056425,聯發科日盛9A購01,0.93,0.93,0.67,0.67,-0.41,-37.96,12000,2,10900,0,0,0,0,0,0,11000,1000,10000,10000
20200312,056426,上証2X凱基9A購01,2.54,2.54,2.54,2.54,-0.46,-15.33,1000,1,2540,0,0,0,0,0,0,0,1000,-1000,-1000
20200312,056427,上銀凱基98購03,0.66,0.66,0.46,0.46,-0.69,-60.0,26000,6,13130,0,0,0,0,0,0,26000,0,26000,26000
20200312,056428,台達電凱基99購01,1.02,1.05,0.74,0.74,-0.37,-33.33,372000,20,365400,0,0,0,0,0,0,310000,62000,248000,248000
20200312,056429,華通凱基98購02,1.24,1.24,0.81,0.85,-0.77,-47.53,972000,35,1036350,0,0,0,0,0,0,257000,727000,-470000,-470000
20200312,05642P,玉晶光兆豐97售02,0.70,0.84,0.70,0.84,+0.21,33.33,637000,16,494840,0,0,0,0,0,0,164000,473000,-309000,-309000
20200312,056430,鴻海凱基98購06,0.96,0.96,0.75,0.79,-0.32,-28.83,83000,9,75060,0,0,0,0,0,0,73000,15000,58000,58000
20200312,056431,鴻海凱基98購07,0.69,0.69,0.58,0.62,-0.22,-26.19,119000,5,75110,0,0,0,0,0,0,54000,65000,-11000,-11000
20200312,056432,鴻海凱基98購08,1.26,1.26,0.97,1.01,-0.49,-32.67,119000,10,121540,0,0,0,0,0,0,90000,35000,55000,55000
20200312,056433,鴻海凱基98購09,1.73,1.79,1.39,1.43,-0.57,-28.5,53000,21,81260,0,0,0,0,0,0,32000,53000,-21000,-21000
20200312,056434,國巨凱基98購03,,,,,0.00,0.00,0,0,0,0,0,0,0,0,0,0,0,0,0
20200312,056435,台積電凱基98購09,1.49,1.49,1.07,1.27,-0.47,-27.01,1455000,21,1874340,0,0,0,0,0,0,327000,1155000,-828000,-828000
20200312,056436,台積電凱基98購10,0.91,0.91,0.68,0.84,-0.23,-21.5,230000,15,185400,0,0,0,0,0,0,80000,150000,-70000,-70000
20200312,056437,台積電凱基98購11,1.73,1.73,1.20,1.51,-0.28,-15.64,1404000,49,2048090,0,0,0,0,0,0,400000,1009000,-609000,-609000
20200312,056438,旺宏凱基98購05,,,,,0.00,0.00,0,0,0,0,0,0,0,0,0,0,0,0,0
20200312,056439,華邦電凱基98購02,0.94,0.94,0.62,0.65,-0.52,-44.44,307000,14,229510,0,0,0,0,0,0,126000,199000,-73000,-73000
20200312,05643P,大立光中信98售01,1.31,1.48,1.30,1.48,+0.38,34.55,130000,10,174250,0,0,0,0,0,0,90000,40000,50000,50000
20200312,056440,智邦凱基98購03,1.97,2.14,1.97,2.14,-0.53,-19.85,50000,5,103170,0,0,0,0,0,0,40000,50000,-10000,-10000
20200312,056441,燿華凱基98購01,0.65,0.68,0.50,0.50,-0.50,-50.0,51000,11,31700,0,0,0,0,0,0,41000,11000,30000,30000
20200312,056442,瑞昱凱基98購02,0.61,0.61,0.46,0.53,-0.40,-43.01,111000,9,58510,0,0,0,0,0,0,43000,111000,-68000,-68000
20200312,056443,南亞科凱基98購03,0.94,0.94,0.70,0.71,-0.53,-42.74,208000,8,164220,0,0,0,0,0,0,60000,148000,-88000,-88000
20200312,056444,南亞科凱基99購01,1.17,1.22,0.90,0.90,-0.94,-51.09,173000,12,189000,0,0,0,0,0,0,60000,113000,-53000,-53000
20200312,056445,聯發科凱基98購07,1.39,1.45,0.98,0.98,-0.67,-40.61,588000,10,725920,0,0,0,0,0,0,0,588000,-588000,-588000
20200312,056446,聯發科凱基98購08,0.64,0.64,0.46,0.47,-0.31,-39.74,464000,21,246080,0,0,0,0,0,0,234000,190000,44000,44000
20200312,056447,聯發科凱基98購09,0.94,0.94,0.65,0.65,-0.85,-56.67,374000,6,295550,0,0,0,0,0,0,203000,171000,32000,32000
20200312,056448,全新凱基99購01,0.75,0.75,0.73,0.73,-0.41,-35.96,50000,2,36900,0,0,0,0,0,0,20000,30000,-10000,-10000
20200312,056449,義隆凱基98購03,0.91,0.92,0.87,0.87,-0.27,-23.68,125000,4,111150,0,0,0,0,0,0,105000,85000,20000,20000
20200312,05644P,大立光中信9A售03,0.64,0.75,0.63,0.75,+0.23,44.23,210000,17,149560,0,0,0,0,0,0,123000,87000,36000,36000
20200312,056450,可成凱基98購05,,,,,0.00,0.00,0,0,0,0,0,0,0,0,0,0,0,0,0
20200312,056451,可成凱基99購01,,,,,0.00,0.00,0,0,0,0,0,0,0,0,0,0,0,0,0
20200312,056452,亞光凱基98購02,,,,,0.00,0.00,0,0,0,0,0,0,0,0,0,0,0,0,0
20200312,056453,禾伸堂凱基99購02,0.93,1.06,0.93,1.05,-0.03,-2.78,32000,3,31220,0,0,0,0,0,0,0,32000,-32000,-32000
20200312,056454,欣興凱基98購02,0.91,0.91,0.57,0.57,-0.96,-62.75,90000,11,69350,0,0,0,0,0,0,20000,70000,-50000,-50000
20200312,056455,群創凱基9A購01,0.60,0.60,0.59,0.59,-0.16,-21.33,75000,2,44320,0,0,0,0,0,0,7000,68000,-61000,-61000
20200312,056456,群創凱基9B購01,0.43,0.43,0.43,0.43,-0.23,-34.85,1000,1,430,0,0,0,0,0,0,1000,0,1000,1000
20200312,056457,嘉澤凱基98購01,0.89,0.89,0.65,0.65,-0.41,-38.68,183000,9,157790,0,0,0,0,0,0,44000,139000,-95000,-95000
20200312,056458,日月光凱基98購02,0.92,0.92,0.60,0.60,-0.46,-43.4,540000,7,396600,0,0,0,0,0,0,70000,470000,-400000,-400000
20200312,056459,茂林凱基99購01,0.82,0.82,0.65,0.65,0.00,0.00,29000,2,20550,0,0,0,0,0,0,19000,10000,9000,9000
20200312,05645P,聯發科凱基96售13,,,,,0.00,0.00,0,0,0,0,0,0,0,0,0,0,0,0,0
20200312,056460,同欣電凱基99購01,0.56,0.56,0.44,0.47,-0.30,-38.96,55000,5,26700,0,0,0,0,0,0,15000,40000,-25000,-25000
20200312,056461,樺漢凱基98購02,1.26,1.27,0.89,1.02,-0.40,-28.17,96000,6,98200,0,0,0,0,0,0,88000,8000,80000,80000
20200312,056462,訊芯凱基98購03,0.50,0.50,0.40,0.40,-0.26,-39.39,138000,6,59880,0,0,0,0,0,0,30000,108000,-78000,-78000
20200312,056463,台虹凱基98購02,,,,,0.00,0.00,0,0,0,0,0,0,0,0,0,0,0,0,0
20200312,056464,臺股指凱基99購06,0.22,0.25,0.14,0.23,-0.09,-28.12,1949000,158,409920,0,0,0,0,0,0,30000,1874000,-1844000,-1844000
20200312,056465,臺股指凱基99購07,,,,,0.00,0.00,0,0,0,0,0,0,0,0,0,0,0,0,0
20200312,056466,臺股指凱基99購08,0.24,0.24,0.24,0.24,-0.34,-58.62,4000,1,960,0,0,0,0,0,0,0,4000,-4000,-4000
20200312,056467,上証2X元大98購02,1.99,1.99,1.62,1.73,-0.33,-16.02,275000,10,481440,0,0,0,0,0,0,128000,147000,-19000,-19000
20200312,056468,鴻海元大98購07,1.29,1.29,1.03,1.07,-0.46,-30.07,100000,8,118580,0,0,0,0,0,0,26000,80000,-54000,-54000
20200312,056469,國巨元大99購01,2.66,2.66,1.99,1.99,-0.73,-26.84,252000,45,580730,0,0,0,0,0,0,136000,202000,-66000,-66000
20200312,05646P,聯發科國票96售05,,,,,0.00,0.00,0,0,0,0,0,0,0,0,0,0,0,0,0
20200312,056470,旺宏元大99購01,1.32,1.37,1.22,1.22,-0.22,-15.28,115000,9,148940,0,0,0,0,0,0,85000,32000,53000,53000
20200312,056471,台光電元大99購01,1.74,1.74,1.53,1.53,-0.57,-27.14,42000,2,69510,0,0,0,0,0,0,17000,25000,-8000,-8000
20200312,056472,美律元大99購03,1.02,1.02,0.81,0.85,-0.30,-26.09,82000,5,77540,0,0,0,0,0,0,1000,81000,-80000,-80000
20200312,056473,奇力新元大99購02,0.68,0.68,0.49,0.50,-0.22,-30.56,1407000,19,715820,0,0,0,0,0,0,1287000,120000,1167000,1167000
20200312,056474,華新科元大99購05,1.38,1.38,1.29,1.29,-0.62,-32.46,10000,2,13350,0,0,0,0,0,0,0,10000,-10000,-10000
20200312,056475,宏達電元大99購02,2.55,2.55,1.88,1.90,-0.77,-28.84,49000,7,100550,0,0,0,0,0,0,19000,38000,-19000,-19000
20200312,056476,智原元大98購02,0.52,0.52,0.52,0.52,-0.52,-50.0,25000,1,13000,0,0,0,0,0,0,25000,25000,0,0
20200312,056477,欣興元大98購02,1.32,1.32,1.05,1.05,-0.59,-35.98,127000,5,153120,0,0,0,0,0,0,0,127000,-127000,-127000
20200312,056478,晶技元大99購01,1.80,1.80,1.16,1.17,-0.50,-29.94,295000,44,449620,0,0,0,0,0,0,197000,155000,42000,42000
20200312,056479,玉晶光元大99購05,1.49,1.49,1.10,1.13,-0.82,-42.05,63000,10,88380,0,0,0,0,0,0,24000,45000,-21000,-21000
20200312,05647P,聯發科國票97售02,4.07,5.25,4.07,5.20,+1.86,55.69,125000,11,566430,0,0,0,0,0,0,53000,72000,-19000,-19000
20200312,056480,京鼎元大98購02,,,,,0.00,0.00,0,0,0,0,0,0,0,0,0,0,0,0,0
20200312,056481,創意元大98購01,,,,,0.00,0.00,0,0,0,0,0,0,0,0,0,0,0,0,0
20200312,056482,貿聯元大99購01,0.69,0.69,0.64,0.64,-0.27,-29.67,95000,2,65150,0,0,0,0,0,0,8000,95000,-87000,-87000
20200312,056483,TPK元大98購01,1.65,1.65,1.11,1.11,-0.80,-41.88,88000,7,133020,0,0,0,0,0,0,78000,16000,62000,62000
20200312,056484,聯茂元大98購02,3.94,3.94,2.71,2.71,-1.46,-35.01,11000,3,39560,0,0,0,0,0,0,10000,1000,9000,9000
20200312,056485,同欣電元大98購01,0.57,0.58,0.43,0.45,-0.22,-32.84,282000,16,141530,0,0,0,0,0,0,17000,265000,-248000,-248000
20200312,056486,樺漢元大98購04,1.47,1.47,1.35,1.35,-0.26,-16.15,50000,3,69700,0,0,0,0,0,0,50000,0,50000,50000
20200312,056487,康友元大98購01,1.38,1.38,1.05,1.05,-0.37,-26.06,341000,23,420410,0,0,0,0,0,0,240000,125000,115000,115000
20200312,056488,致新元大99購01,0.82,0.82,0.70,0.70,-0.20,-22.22,35000,3,28190,0,0,0,0,0,0,31000,4000,27000,27000
20200312,056489,S&P反1國泰9A購01,,,,,0.00,0.00,0,0,0,0,0,0,0,0,0,0,0,0,0
20200312,05648P,康控國票97售01,2.17,2.21,2.17,2.21,+0.13,6.25,139000,5,306410,0,0,0,0,0,0,89000,0,89000,89000
20200312,056490,台積電國泰99購01,0.93,0.93,0.69,0.81,-0.31,-27.68,281000,9,249140,0,0,0,0,0,0,169000,112000,57000,57000
20200312,056491,南亞科國泰99購01,1.04,1.04,0.67,0.70,-0.66,-48.53,290000,13,222860,0,0,0,0,0,0,192000,98000,94000,94000
20200312,056492,全新國泰9A購01,0.99,0.99,0.99,0.99,-0.29,-22.66,98000,1,97020,0,0,0,0,0,0,0,98000,-98000,-98000
20200312,056493,晶技國泰99購01,5.35,5.40,3.69,3.69,-1.15,-23.76,221000,35,1132930,0,0,0,0,0,0,161000,25000,136000,136000
20200312,056494,緯創國泰99購01,0.83,0.83,0.60,0.71,-0.23,-24.47,199000,16,148250,0,0,0,0,0,0,66000,133000,-67000,-67000
20200312,056495,泰鼎國泰99購01,1.82,1.82,1.37,1.39,-0.81,-36.82,169000,3,238330,0,0,0,0,0,0,125000,44000,81000,81000
20200312,056496,康控國泰99購01,1.10,1.10,1.10,1.10,-0.32,-22.54,34000,1,37400,0,0,0,0,0,0,34000,0,34000,34000
20200312,056497,GIS國泰99購01,0.76,0.77,0.57,0.57,-0.39,-40.63,40000,4,28400,0,0,0,0,0,0,0,40000,-40000,-40000
20200312,056498,A50正2富邦9B購01,1.27,1.27,1.14,1.21,-0.34,-21.94,30000,5,36410,0,0,0,0,0,0,13000,17000,-4000,-4000
20200312,056499,鴻海富邦98購02,,,,,0.00,0.00,0,0,0,0,0,0,0,0,0,0,0,0,0
20200312,05649P,矽創國票97售03,2.28,2.68,2.27,2.52,+0.48,23.53,461000,14,1080560,0,0,0,0,0,0,171000,290000,-119000,-119000
20200312,056500,大立光富邦9B購02,0.38,0.38,0.28,0.30,-0.15,-33.33,1128000,49,363390,0,0,0,0,0,0,50000,954000,-904000,-904000
20200312,056501,貿聯富邦99購01,0.44,0.44,0.33,0.34,-0.10,-22.73,621000,54,228010,0,0,0,0,0,0,334000,277000,57000,57000
20200312,056502,A50正2永豐98購01,2.79,2.79,2.44,2.44,-0.73,-23.03,67000,15,172910,0,0,0,0,0,0,0,67000,-67000,-67000
20200312,056503,楠梓電永豐98購01,1.60,1.64,1.38,1.38,-0.91,-39.74,53000,5,80960,0,0,0,0,0,0,51000,2000,49000,49000
20200312,056504,國巨永豐98購02,,,,,0.00,0.00,0,0,0,0,0,0,0,0,0,0,0,0,0
20200312,056505,聯發科永豐98購01,0.66,0.66,0.41,0.41,-0.33,-44.59,1570000,32,821110,0,0,0,0,0,0,672000,895000,-223000,-223000
20200312,056506,晶豪科永豐98購02,1.80,1.81,1.30,1.30,-0.83,-38.97,315000,25,505630,0,0,0,0,0,0,246000,1000,245000,245000
20200312,056507,創意永豐98購02,0.41,0.46,0.41,0.41,-0.32,-43.84,71000,3,30460,0,0,0,0,0,0,24000,71000,-47000,-47000
20200312,056508,揚明光永豐98購01,1.12,1.12,1.12,1.12,-0.33,-22.76,10000,1,11200,0,0,0,0,0,0,0,10000,-10000,-10000
20200312,056509,晶相光永豐98購01,0.90,0.90,0.90,0.90,-0.80,-47.06,20000,1,18000,0,0,0,0,0,0,20000,0,20000,20000
20200312,05650P,台積電富邦96售01,0.36,0.52,0.36,0.46,+0.14,43.75,275000,17,122070,0,0,0,0,0,0,140000,135000,5000,5000
20200312,056510,正文永豐98購02,0.64,0.64,0.43,0.43,-0.20,-31.75,158000,8,95800,0,0,0,0,0,0,68000,90000,-22000,-22000
20200312,056511,超眾永豐98購01,0.68,0.68,0.57,0.57,-0.24,-29.63,40000,3,25000,0,0,0,0,0,0,20000,20000,0,0
20200312,056512,易華電永豐98購01,0.97,0.97,0.97,0.97,0.00,0.00,10000,1,9700,0,0,0,0,0,0,0,10000,-10000,-10000
20200312,056513,臻鼎亞東99購01,0.41,0.41,0.32,0.32,-0.32,-50.0,49000,2,20000,0,0,0,0,0,0,0,49000,-49000,-49000
20200312,056514,訊芯亞東99購01,,,,,0.00,0.00,0,0,0,0,0,0,0,0,0,0,0,0,0
20200312,056515,燿華兆豐99購01,0.46,0.46,0.36,0.37,-0.16,-30.19,358000,7,149210,0,0,0,0,0,0,318000,40000,278000,278000
20200312,056516,晶豪科兆豐98購01,1.35,1.35,0.88,0.88,-0.52,-37.14,1319000,49,1449660,0,0,0,0,0,0,446000,871000,-425000,-425000
20200312,056517,茂林兆豐99購01,0.46,0.46,0.34,0.34,-0.13,-27.66,72000,4,31500,0,0,0,0,0,0,70000,2000,68000,68000
20200312,056518,美律國票99購01,1.20,1.20,1.20,1.20,-0.82,-40.59,11000,1,13200,0,0,0,0,0,0,11000,0,11000,11000
20200312,056519,創意國票99購01,1.43,1.46,1.05,1.05,-0.84,-44.44,98000,8,119080,0,0,0,0,0,0,60000,38000,22000,22000
20200312,05651P,大立光元大97售02,3.05,3.46,3.05,3.46,0.00,0.00,82000,5,266600,0,0,0,0,0,0,47000,81000,-34000,-34000
20200312,056520,鴻海日盛99購01,1.21,1.21,1.00,1.00,0.00,0.00,4000,2,4210,0,0,0,0,0,0,4000,4000,0,0
20200312,056521,群創日盛98購01,,,,,0.00,0.00,0,0,0,0,0,0,0,0,0,0,0,0,0
20200312,056522,T50反1中信9B購01,1.53,1.79,1.53,1.79,0.00,0.00,10000,2,15560,0,0,0,0,0,0,10000,0,10000,10000
20200312,056523,光寶科中信98購01,0.72,0.72,0.64,0.66,-0.28,-29.79,193000,4,130500,0,0,0,0,0,0,68000,125000,-57000,-57000
20200312,056524,欣興中信98購02,0.41,0.41,0.33,0.34,-0.28,-45.16,236000,9,85250,0,0,0,0,0,0,0,236000,-236000,-236000
20200312,056525,T50反1凱基99購06,,,,,0.00,0.00,0,0,0,0,0,0,0,0,0,0,0,0,0
20200312,056526,力山凱基98購01,0.77,0.77,0.73,0.73,-0.41,-35.96,12000,3,8980,0,0,0,0,0,0,7000,5000,2000,2000
20200312,056527,大成鋼凱基98購03,2.26,2.26,2.13,2.15,-0.32,-12.96,95000,9,206580,0,0,0,0,0,0,75000,24000,51000,51000
20200312,056528,為升凱基98購01,0.71,0.72,0.40,0.52,-0.38,-42.22,458000,55,275530,0,0,0,0,0,0,262000,377000,-115000,-115000
20200312,056529,中環凱基98購01,0.61,0.61,0.42,0.42,-0.28,-40.0,190000,24,94850,0,0,0,0,0,0,130000,60000,70000,70000
20200312,05652P,臻鼎群益96售01,3.36,3.70,3.36,3.70,+0.97,35.53,66000,4,237160,0,0,0,0,0,0,20000,46000,-26000,-26000
20200312,056530,旺宏凱基98購06,0.94,0.94,0.88,0.88,-0.32,-26.67,136000,8,121780,0,0,0,0,0,0,136000,0,136000,136000
20200312,056531,佳世達凱基98購01,0.65,0.65,0.65,0.65,-0.25,-27.78,56000,1,36400,0,0,0,0,0,0,56000,0,56000,56000
20200312,056532,技嘉凱基98購01,1.49,1.49,1.19,1.27,-0.46,-26.59,153000,5,192130,0,0,0,0,0,0,138000,23000,115000,115000
20200312,056533,友達凱基9A購02,,,,,0.00,0.00,0,0,0,0,0,0,0,0,0,0,0,0,0
20200312,056534,京元電凱基98購01,2.62,2.67,1.93,2.08,-0.83,-28.52,58000,10,148730,0,0,0,0,0,0,52000,16000,36000,36000
20200312,056535,全新凱基99購02,,,,,0.00,0.00,0,0,0,0,0,0,0,0,0,0,0,0,0
20200312,056536,義隆凱基98購04,1.17,1.17,1.04,1.07,-0.66,-38.15,49000,6,53910,0,0,0,0,0,0,11000,38000,-27000,-27000
20200312,056537,冠德凱基98購01,1.28,1.28,0.87,0.87,0.00,0.00,524000,9,592630,0,0,0,0,0,0,0,524000,-524000,-524000
20200312,056538,國泰金凱基98購01,0.69,0.72,0.69,0.71,-0.32,-31.07,240000,6,169080,0,0,0,0,0,0,72000,168000,-96000,-96000
20200312,056539,新光金凱基9A購01,0.39,0.39,0.39,0.39,-0.13,-25.0,10000,1,3900,0,0,0,0,0,0,0,10000,-10000,-10000
20200312,05653P,華邦電統一96售02,2.11,2.57,2.10,2.57,+0.59,29.8,427000,37,947210,1000,0,1000,0,0,0,220000,247000,-27000,-26000
20200312,056540,聯詠凱基98購02,,,,,0.00,0.00,0,0,0,0,0,0,0,0,0,0,0,0,0
20200312,056541,智原凱基98購03,,,,,0.00,0.00,0,0,0,0,0,0,0,0,0,0,0,0,0
20200312,056542,緯創凱基98購01,0.51,0.54,0.33,0.34,-0.32,-48.48,306000,10,126580,0,0,0,0,0,0,50000,276000,-226000,-226000
20200312,056543,京鼎凱基98購01,0.80,0.80,0.58,0.58,-0.32,-35.56,266000,10,163330,0,0,0,0,0,0,36000,230000,-194000,-194000
20200312,056544,貿聯凱基98購03,0.55,0.56,0.51,0.51,-0.20,-28.17,29000,6,15670,0,0,0,0,0,0,19000,10000,9000,9000
20200312,056545,TPK凱基98購02,1.24,1.24,1.06,1.06,-0.35,-24.82,95000,22,114620,0,0,0,0,0,0,65000,32000,33000,33000
20200312,056546,致伸凱基98購01,1.25,1.25,0.85,0.85,-0.60,-41.38,480000,13,488860,0,0,0,0,0,0,370000,110000,260000,260000
20200312,056547,臻鼎凱基99購01,0.81,0.81,0.65,0.65,-0.37,-36.27,79000,7,57870,0,0,0,0,0,0,29000,79000,-50000,-50000
20200312,056548,瀚宇博凱基98購02,1.84,1.84,1.51,1.53,-0.80,-34.33,55000,6,88650,0,0,0,0,0,0,35000,43000,-8000,-8000
20200312,056549,嘉聯益凱基98購04,,,,,0.00,0.00,0,0,0,0,0,0,0,0,0,0,0,0,0
20200312,05654P,台光電統一96售01,1.03,1.24,1.03,1.24,+0.32,34.78,91000,5,98760,0,0,0,0,0,0,35000,56000,-21000,-21000
20200312,056550,瑞儀凱基99購01,0.56,0.56,0.44,0.44,-0.21,-32.31,482000,15,261150,0,0,0,0,0,0,435000,32000,403000,403000
20200312,056551,台郡凱基98購04,,,,,0.00,0.00,0,0,0,0,0,0,0,0,0,0,0,0,0
20200312,056552,台表科凱基99購01,1.12,1.12,0.84,0.84,-0.43,-33.86,447000,18,415540,0,0,0,0,0,0,260000,187000,73000,73000
20200312,056553,啟碁凱基98購02,0.96,0.96,0.79,0.79,-0.66,-45.52,98000,4,89880,0,0,0,0,0,0,68000,30000,38000,38000
20200312,056554,GIS凱基99購01,0.53,0.53,0.41,0.41,-0.34,-45.33,246000,3,116510,0,0,0,0,0,0,173000,73000,100000,100000
20200312,056555,矽創凱基98購01,1.57,1.57,1.16,1.16,-0.45,-27.95,138000,6,190120,0,0,0,0,0,0,68000,70000,-2000,-2000
20200312,056556,南電凱基98購01,,,,,0.00,0.00,0,0,0,0,0,0,0,0,0,0,0,0,0
20200312,056557,世紀鋼凱基98購02,4.12,4.12,3.51,3.80,-0.48,-11.21,60000,12,233590,0,0,0,0,0,0,40000,30000,10000,10000
20200312,056558,台達電群益98購01,0.97,0.97,0.65,0.65,-0.44,-40.37,399000,11,376800,0,0,0,0,0,0,374000,25000,349000,349000
20200312,056559,華通群益98購02,0.23,0.23,0.22,0.22,0.00,0.00,20000,2,4500,0,0,0,0,0,0,0,20000,-20000,-20000
20200312,05655P,南亞科統一96售01,1.75,2.23,1.75,2.19,+0.60,37.74,365000,17,727170,0,0,0,0,0,0,204000,161000,43000,43000
20200312,056560,旺宏群益98購03,1.55,1.55,1.09,1.09,-0.99,-47.6,129000,9,159570,0,0,0,0,0,0,29000,118000,-89000,-89000
20200312,056561,台光電群益98購02,1.86,1.86,1.62,1.62,-0.65,-28.63,240000,8,411880,0,0,0,0,0,0,122000,124000,-2000,-2000
20200312,056562,奇力新群益98購01,0.52,0.52,0.46,0.46,-0.17,-26.98,167000,8,83090,0,0,0,0,0,0,167000,0,167000,167000
20200312,056563,華新科群益98購04,2.12,2.12,1.39,1.44,-0.80,-35.71,90000,8,158210,0,0,0,0,0,0,49000,58000,-9000,-9000
20200312,056564,亞光群益98購02,,,,,0.00,0.00,0,0,0,0,0,0,0,0,0,0,0,0,0
20200312,056565,欣興群益98購03,1.32,1.32,1.01,1.01,-0.61,-37.65,205000,11,257260,0,0,0,0,0,0,53000,154000,-101000,-101000
20200312,056566,臻鼎群益98購01,1.07,1.07,0.75,0.82,-0.48,-36.92,481000,19,441390,0,0,0,0,0,0,158000,323000,-165000,-165000
20200312,056567,瀚宇博群益98購02,1.67,1.68,1.24,1.29,-0.58,-31.02,75000,11,106590,0,0,0,0,0,0,32000,58000,-26000,-26000
20200312,056568,台表科群益98購01,1.01,1.01,0.93,0.93,-0.29,-23.77,211000,2,212950,0,0,0,0,0,0,211000,0,211000,211000
20200312,056569,T50正2元大9B購02,0.64,0.64,0.51,0.51,-0.23,-31.08,117000,6,68250,0,0,0,0,0,0,31000,86000,-55000,-55000
20200312,05656P,台表科統一96售01,2.23,2.47,2.23,2.47,0.00,0.00,31000,4,70370,0,0,0,0,0,0,1000,30000,-29000,-29000
20200312,056570,旺宏元大98購07,0.57,0.57,0.50,0.50,-0.23,-31.51,66000,6,34650,0,0,0,0,0,0,1000,65000,-64000,-64000
20200312,056571,燿華元大98購02,1.20,1.20,0.83,0.84,-0.64,-43.24,470000,24,464650,0,0,0,0,0,0,105000,365000,-260000,-260000
20200312,056572,義隆元大99購01,1.16,1.16,1.11,1.11,-0.33,-22.92,128000,4,143760,0,0,0,0,0,0,20000,108000,-88000,-88000
20200312,056573,華新科元大99購06,,,,,0.00,0.00,0,0,0,0,0,0,0,0,0,0,0,0,0
20200312,056574,亞光元大99購03,1.63,1.63,1.52,1.56,-0.44,-22.0,23000,3,35740,0,0,0,0,0,0,23000,23000,0,0
20200312,056575,禾伸堂元大99購01,1.92,1.93,1.63,1.84,+0.01,0.55,601000,43,1086380,0,0,0,0,0,0,294000,467000,-173000,-173000
20200312,056576,晶技元大99購02,2.82,2.93,1.84,1.87,-0.96,-33.92,237000,30,636250,0,0,0,0,0,0,183000,72000,111000,111000
20200312,056577,玉晶光元大99購06,0.95,0.95,0.72,0.72,-0.38,-34.55,89000,9,79180,0,0,0,0,0,0,45000,44000,1000,1000
20200312,056578,智易元大99購02,1.13,1.13,0.89,0.96,-0.45,-31.91,183000,6,168310,0,0,0,0,0,0,108000,75000,33000,33000
20200312,056579,麗豐元大99購01,0.89,0.89,0.83,0.85,-0.21,-19.81,28000,3,24020,0,0,0,0,0,0,13000,15000,-2000,-2000
20200312,05657P,樺漢統一97售01,,,,,0.00,0.00,0,0,0,0,0,0,0,0,0,0,0,0,0
20200312,056580,泰鼎元大9A購01,1.07,1.07,0.81,0.82,-0.29,-26.13,1113000,42,1058400,0,0,0,0,0,0,555000,555000,0,0
20200312,056581,超眾元大99購01,2.14,2.14,1.96,1.96,-0.55,-21.91,58000,7,119640,0,0,0,0,0,0,58000,2000,56000,56000
20200312,056582,易華電元大98購01,,,,,0.00,0.00,0,0,0,0,0,0,0,0,0,0,0,0,0
20200312,056583,昇陽半元大98購02,1.18,1.18,0.87,0.87,-0.55,-38.73,178000,8,193130,0,0,0,0,0,0,128000,63000,65000,65000
20200312,056584,鴻海統一9B購01,1.49,1.50,1.23,1.26,-0.37,-22.7,265000,27,361480,0,0,0,0,0,0,111000,166000,-55000,-55000
20200312,056585,台積電統一9A購01,0.46,0.46,0.38,0.46,-0.13,-22.03,234000,5,104460,0,0,0,0,0,0,170000,64000,106000,106000
20200312,056586,光罩統一98購02,0.88,0.88,0.81,0.82,-0.47,-36.43,32000,6,26560,0,0,0,0,0,0,2000,29000,-27000,-27000
20200312,056587,聯發科統一9A購01,0.90,0.90,0.76,0.81,0.00,0.00,113000,3,100100,0,0,0,0,0,0,5000,113000,-108000,-108000
20200312,056588,聯發科統一9A購02,1.62,1.62,1.22,1.24,-0.53,-29.94,695000,27,1011980,0,0,0,0,0,0,224000,476000,-252000,-252000
20200312,056589,康控統一98購01,0.87,0.87,0.71,0.71,-0.45,-38.79,58000,2,42780,0,0,0,0,0,0,10000,48000,-38000,-38000
20200312,05658P,日月光元富96售02,4.54,5.35,4.54,5.35,+1.08,25.29,174000,20,859910,0,0,0,0,0,0,30000,144000,-114000,-114000
20200312,056590,樺漢統一9A購01,0.74,0.74,0.55,0.55,-0.33,-37.5,18000,6,10850,0,0,0,0,0,0,11000,7000,4000,4000
20200312,056591,S&P正2元富9A購01,0.16,0.17,0.11,0.16,-0.03,-15.79,338000,9,52290,0,0,0,0,0,0,0,0,0,0
20200312,056592,台積電元富98購01,1.29,1.29,0.93,1.13,-0.30,-20.98,2619000,147,2979290,0,0,0,0,0,0,720000,1722000,-1002000,-1002000
20200312,056593,台積電元富98購02,0.89,0.89,0.62,0.80,-0.24,-23.08,1318000,35,1072000,0,0,0,0,0,0,1016000,251000,765000,765000
20200312,056594,台積電元富98購03,0.53,0.53,0.34,0.44,-0.17,-27.87,1693000,64,776910,0,0,0,0,0,0,708000,915000,-207000,-207000
20200312,056595,台積電元富98購04,0.35,0.35,0.24,0.30,-0.14,-31.82,1082000,23,320470,0,0,0,0,0,0,1018000,52000,966000,966000
20200312,056596,光磊元富98購01,1.19,1.19,0.94,0.94,-0.58,-38.16,40000,4,43300,0,0,0,0,0,0,0,40000,-40000,-40000
20200312,056597,宏碁元富98購01,0.46,0.46,0.35,0.36,-0.16,-30.77,631000,14,266110,0,0,0,0,0,0,40000,591000,-551000,-551000
20200312,056598,京元電元富98購01,1.64,1.64,1.18,1.18,-0.59,-33.33,298000,28,412150,0,0,0,0,0,0,110000,188000,-78000,-78000
20200312,056599,臻鼎元富98購01,1.12,1.12,0.69,0.73,-0.52,-41.6,201000,11,195990,0,0,0,0,0,0,131000,70000,61000,61000
20200312,05659P,A50正2中信97售01,1.52,1.60,1.48,1.48,+0.17,12.98,36000,5,56520,0,0,0,0,0,0,16000,20000,-4000,-4000
20200312,056600,聯茂元富98購01,1.55,1.55,1.55,1.55,0.00,0.00,13000,1,20150,0,0,0,0,0,0,0,13000,-13000,-13000
20200312,056601,鈺齊元富98購01,0.50,0.50,0.45,0.47,-0.07,-12.96,89000,6,41630,0,0,0,0,0,0,89000,0,89000,89000
20200312,056602,嘉澤國泰99購01,0.91,0.91,0.72,0.72,-0.27,-27.27,150000,5,122940,0,0,0,0,0,0,64000,86000,-22000,-22000
20200312,056603,嘉聯益國泰9A購01,1.91,1.91,1.47,1.47,-0.58,-28.29,20000,2,33800,0,0,0,0,0,0,10000,10000,0,0
20200312,056604,鴻海富邦9A購01,0.53,0.53,0.46,0.47,-0.19,-28.79,60000,4,29450,0,0,0,0,0,0,10000,50000,-40000,-40000
20200312,056605,台積電富邦9B購02,0.46,0.46,0.32,0.37,-0.09,-19.57,2990000,75,1099180,0,0,0,0,0,0,609000,2303000,-1694000,-1694000
20200312,056606,華新科富邦9A購02,0.35,0.35,0.34,0.34,-0.14,-29.17,94000,4,32790,0,0,0,0,0,0,70000,24000,46000,46000
20200312,056607,貿聯富邦99購02,,,,,0.00,0.00,0,0,0,0,0,0,0,0,0,0,0,0,0
20200312,056608,力山永豐98購01,0.61,0.62,0.47,0.48,-0.38,-44.19,207000,13,109330,0,0,0,0,0,0,39000,168000,-129000,-129000
20200312,056609,楠梓電永豐98購02,1.43,1.43,1.14,1.14,-0.83,-42.13,101000,5,127790,0,0,0,0,0,0,80000,21000,59000,59000
20200312,05660P,玉晶光第一96售01,0.57,0.70,0.57,0.69,+0.19,38.0,238000,14,155780,0,0,0,0,0,0,117000,120000,-3000,-3000
20200312,056610,鴻海永豐98購01,0.71,0.71,0.55,0.57,-0.28,-32.94,244000,4,147330,0,0,0,0,0,0,125000,119000,6000,6000
20200312,056611,國巨永豐98購03,1.13,1.13,1.13,1.13,-0.13,-10.32,68000,1,76840,0,0,0,0,0,0,68000,0,68000,68000
20200312,056612,台積電永豐98購01,0.48,0.49,0.41,0.49,-0.12,-19.67,12000,5,5640,0,0,0,0,0,0,0,12000,-12000,-12000
20200312,056613,旺宏永豐98購01,,,,,0.00,0.00,0,0,0,0,0,0,0,0,0,0,0,0,0
20200312,056614,智邦永豐98購01,0.57,0.57,0.55,0.56,-0.24,-30.0,118000,3,66180,0,0,0,0,0,0,0,118000,-118000,-118000
20200312,056615,燿華永豐98購02,0.59,0.59,0.41,0.42,-0.45,-51.72,41000,17,22390,0,0,0,0,0,0,27000,14000,13000,13000
20200312,056616,台光電永豐98購01,1.01,1.06,1.01,1.06,-0.11,-9.4,99000,3,103690,0,0,0,0,0,0,87000,37000,50000,50000
20200312,056617,美律永豐98購01,0.75,0.75,0.52,0.59,-0.24,-28.92,102000,8,63530,0,0,0,0,0,0,0,102000,-102000,-102000
20200312,056618,京元電永豐98購01,1.12,1.12,0.82,0.86,-0.42,-32.81,550000,29,506600,0,0,0,0,0,0,205000,345000,-140000,-140000
20200312,056619,強茂永豐98購01,0.53,0.53,0.53,0.53,-0.44,-45.36,68000,1,36040,0,0,0,0,0,0,68000,0,68000,68000
20200312,05661P,聯發科統一96售06,,,,,0.00,0.00,0,0,0,0,0,0,0,0,0,0,0,0,0
20200312,056620,華新科永豐98購02,0.30,0.30,0.21,0.21,-0.18,-46.15,138000,2,41220,0,0,0,0,0,0,138000,0,138000,138000
20200312,056621,宏達電永豐98購01,1.41,1.41,1.06,1.06,-0.47,-30.72,40000,4,52000,0,0,0,0,0,0,10000,30000,-20000,-20000
20200312,056622,高鐵永豐98購01,,,,,0.00,0.00,0,0,0,0,0,0,0,0,0,0,0,0,0
20200312,056623,禾伸堂永豐98購01,0.61,0.65,0.61,0.65,-0.13,-16.67,29000,2,18770,0,0,0,0,0,0,27000,2000,25000,25000
20200312,056624,景碩永豐98購01,1.10,1.10,1.10,1.10,-0.61,-35.67,4000,1,4400,0,0,0,0,0,0,4000,0,4000,4000
20200312,056625,致伸永豐98購01,,,,,0.00,0.00,0,0,0,0,0,0,0,0,0,0,0,0,0
20200312,056626,同欣電永豐98購01,,,,,0.00,0.00,0,0,0,0,0,0,0,0,0,0,0,0,0
20200312,056627,訊芯永豐98購01,0.22,0.22,0.22,0.22,-0.08,-26.67,88000,1,19360,0,0,0,0,0,0,88000,0,88000,88000
20200312,056628,矽創永豐98購01,0.69,0.69,0.44,0.46,-0.29,-38.67,181000,10,101950,0,0,0,0,0,0,82000,99000,-17000,-17000
20200312,056629,昇陽半永豐98購01,0.72,0.72,0.51,0.51,-0.52,-50.49,98000,4,54580,0,0,0,0,0,0,68000,30000,38000,38000
20200312,05662P,景碩元富96售01,,,,,0.00,0.00,0,0,0,0,0,0,0,0,0,0,0,0,0
20200312,056630,臺股指永豐98購02,,,,,0.00,0.00,0,0,0,0,0,0,0,0,0,0,0,0,0
20200312,056631,臺股指永豐98購03,0.37,0.37,0.28,0.28,0.00,0.00,20000,2,6500,0,0,0,0,0,0,0,20000,-20000,-20000
20200312,056632,鴻海永昌98購01,1.61,1.68,1.34,1.34,-0.53,-28.34,173000,8,249740,0,0,0,0,0,0,105000,78000,27000,27000
20200312,056633,鴻海永昌98購02,1.19,1.19,0.90,0.90,-0.57,-38.78,13000,3,13780,0,0,0,0,0,0,3000,13000,-10000,-10000
20200312,056634,為升兆豐99購01,0.96,0.96,0.75,0.75,-0.38,-33.63,99000,14,82730,0,0,0,0,0,0,25000,74000,-49000,-49000
20200312,056635,亞德客日盛99購01,1.15,1.15,1.09,1.09,-0.52,-32.3,10000,2,11200,0,0,0,0,0,0,0,10000,-10000,-10000
20200312,056636,台積電日盛9A購01,1.48,1.48,1.30,1.31,-0.60,-31.41,488000,20,679390,0,0,0,0,0,0,223000,355000,-132000,-132000
20200312,056637,台光電日盛9A購01,1.85,1.85,1.37,1.50,-0.53,-26.11,360000,34,583950,0,0,0,0,0,0,230000,298000,-68000,-68000
20200312,056638,臺股指日盛98購01,,,,,0.00,0.00,0,0,0,0,0,0,0,0,0,0,0,0,0
20200312,056639,國產康和98購01,0.42,0.42,0.39,0.39,-0.24,-38.1,41000,2,17070,0,0,0,0,0,0,0,41000,-41000,-41000
20200312,05663P,創意元富96售04,2.47,2.81,2.44,2.81,+0.55,24.34,160000,14,416300,0,0,0,0,0,0,30000,130000,-100000,-100000
20200312,056640,元油2X凱基9A購01,,,,,0.00,0.00,0,0,0,0,0,0,0,0,0,0,0,0,0
20200312,056641,華通凱基98購03,1.63,1.63,1.10,1.16,-0.95,-45.02,329000,29,474300,0,0,0,0,0,0,152000,181000,-29000,-29000
20200312,056642,旺宏凱基98購07,1.16,1.16,0.93,0.97,-0.44,-31.21,206000,15,214910,0,0,0,0,0,0,10000,196000,-186000,-186000
20200312,056643,奇力新凱基99購01,0.61,0.61,0.61,0.61,-0.12,-16.44,68000,1,41480,0,0,0,0,0,0,68000,0,68000,68000
20200312,056644,宏達電凱基98購04,1.89,1.90,1.29,1.29,-0.66,-33.85,148000,7,235320,0,0,0,0,0,0,78000,70000,8000,8000
20200312,056645,大立光凱基98購12,1.63,1.63,1.33,1.36,-1.40,-50.72,107000,6,163210,0,0,0,0,0,0,0,107000,-107000,-107000
20200312,056646,奇鋐凱基99購02,0.59,0.65,0.57,0.57,-0.22,-27.85,140000,7,83600,0,0,0,0,0,0,30000,20000,10000,10000
20200312,056647,晶技凱基98購02,3.97,3.97,2.46,2.46,-1.64,-40.0,335000,55,1190180,0,0,0,0,0,0,253000,186000,67000,67000
20200312,056648,牧德凱基99購02,,,,,0.00,0.00,0,0,0,0,0,0,0,0,0,0,0,0,0
20200312,056649,智易凱基98購01,1.16,1.16,0.84,0.86,0.00,0.00,46000,7,45680,0,0,0,0,0,0,2000,44000,-42000,-42000
20200312,05664P,國巨凱基96售09,0.95,1.34,0.93,1.33,+0.58,77.33,288000,20,315330,0,0,0,0,0,0,226000,72000,154000,154000
20200312,056650,彩晶凱基9A購01,0.44,0.44,0.35,0.35,-0.26,-42.62,95000,3,38800,0,0,0,0,0,0,45000,50000,-5000,-5000
20200312,056651,聯茂凱基98購04,3.04,3.04,2.37,2.37,-0.97,-29.04,25000,3,68950,0,0,0,0,0,0,25000,10000,15000,15000
20200312,056652,上証反元大9B購01,0.25,0.25,0.23,0.24,+0.04,20.0,324000,8,76670,0,0,0,0,0,0,10000,314000,-304000,-304000
20200312,056653,元石油元大98購01,0.08,0.09,0.06,0.07,-0.03,-30.0,2402000,43,162040,0,0,0,0,0,0,200000,1806000,-1606000,-1606000
20200312,056654,元油2X元大98購02,,,,,0.00,0.00,0,0,0,0,0,0,0,0,0,0,0,0,0
20200312,056655,旺宏元大99購02,1.49,1.49,1.29,1.29,-0.60,-31.75,79000,3,115910,0,0,0,0,0,0,11000,79000,-68000,-68000
20200312,056656,華邦電元大98購02,1.07,1.07,0.85,0.85,-0.51,-37.5,150000,4,145280,0,0,0,0,0,0,82000,68000,14000,14000
20200312,056657,華邦電元大99購01,1.35,1.35,1.35,1.35,-0.65,-32.5,10000,1,13500,0,0,0,0,0,0,0,10000,-10000,-10000
20200312,056658,美食元大98購01,1.26,1.26,1.05,1.05,-0.32,-23.36,2185000,43,2405500,0,0,0,0,0,0,950000,1235000,-285000,-285000
20200312,056659,泰碩元大99購01,1.66,1.66,1.36,1.46,-0.20,-12.05,239000,18,354270,0,0,0,0,0,0,181000,58000,123000,123000
20200312,05665P,台積電凱基96售08,1.38,1.63,1.38,1.52,+0.31,25.62,390000,22,567550,0,0,0,0,0,0,290000,180000,110000,110000
20200312,056660,臺股指元大9A購07,0.56,0.56,0.46,0.46,-0.40,-46.51,90000,10,45780,0,0,0,0,0,0,10000,0,10000,10000
20200312,056661,臺股指元大9A購08,0.62,0.62,0.48,0.48,-0.63,-56.76,3000,2,1580,0,0,0,0,0,0,2000,0,2000,2000
20200312,056662,臺股指元大9A購09,0.90,0.90,0.80,0.89,-0.29,-24.58,125000,16,106000,0,0,0,0,0,0,0,0,0,0
20200312,056663,臺股指元大9A購10,1.10,1.10,0.91,0.91,-0.47,-34.06,168000,23,165740,0,0,0,0,0,0,0,0,0,0
20200312,056664,上証反中信9B購01,0.38,0.38,0.38,0.38,+0.06,18.75,16000,2,6080,0,0,0,0,0,0,16000,0,16000,16000
20200312,056665,上証2X國票99購02,1.31,1.31,1.18,1.24,-0.20,-13.89,21000,5,25470,0,0,0,0,0,0,3000,18000,-15000,-15000
20200312,056666,元油2X國票9A購01,0.02,0.02,0.02,0.02,-0.01,-33.33,299000,5,5980,0,0,0,0,0,0,0,0,0,0
20200312,056667,上銀國票99購01,1.42,1.45,0.93,1.07,-0.88,-45.13,101000,9,122730,0,0,0,0,0,0,38000,63000,-25000,-25000
20200312,056668,光磊國票99購01,2.50,2.50,1.87,1.95,-0.87,-30.85,61000,7,135210,0,0,0,0,0,0,8000,53000,-45000,-45000
20200312,056669,貿聯國票99購01,1.21,1.23,1.00,1.00,-0.49,-32.89,39000,6,45100,0,0,0,0,0,0,39000,0,39000,39000
20200312,05666P,聯發科凱基96售14,3.02,3.34,3.02,3.34,0.00,0.00,34000,4,109780,0,0,0,0,0,0,24000,34000,-10000,-10000
20200312,056670,樺漢國票99購01,1.69,1.69,1.46,1.46,-0.60,-29.13,136000,5,205940,0,0,0,0,0,0,121000,15000,106000,106000
20200312,056671,台灣50元富9A購01,0.55,0.55,0.31,0.36,-0.34,-48.57,3723000,158,1555620,0,0,0,0,0,0,1515000,2245000,-730000,-730000
20200312,056672,元油2X元富98購10,0.11,0.11,0.03,0.09,-0.06,-40.0,3850000,119,178570,0,0,0,0,0,0,0,3678000,-3678000,-3678000
20200312,056673,中石化元富9B購01,,,,,0.00,0.00,0,0,0,0,0,0,0,0,0,0,0,0,0
20200312,056674,華邦電元富98購01,1.04,1.04,0.68,0.70,-0.60,-46.15,92000,9,81190,0,0,0,0,0,0,30000,82000,-52000,-52000
20200312,056675,聯發科元富02購01,0.75,0.75,0.65,0.65,-0.24,-26.97,91000,4,62560,0,0,0,0,0,0,10000,81000,-71000,-71000
20200312,056676,國產元富98購01,0.61,0.61,0.41,0.41,-0.40,-49.38,180000,15,97600,0,0,0,0,0,0,40000,140000,-100000,-100000
20200312,056677,智伸科元富98購01,1.04,1.04,0.83,0.83,-0.36,-30.25,166000,14,163160,0,0,0,0,0,0,70000,96000,-26000,-26000
20200312,056678,力成元富98購01,0.72,0.72,0.51,0.55,-0.23,-29.49,164000,9,96860,0,0,0,0,0,0,144000,20000,124000,124000
20200312,056679,元油2X統一98購01,0.08,0.08,0.08,0.08,0.00,0.00,10000,1,800,0,0,0,0,0,0,0,0,0,0
20200312,05667P,旺宏台新96售01,1.71,1.78,1.69,1.78,+0.36,25.35,61000,5,105920,0,0,0,0,0,0,34000,27000,7000,7000
20200312,056680,華通統一98購04,0.66,0.66,0.43,0.44,-0.39,-46.99,115000,8,68800,0,0,0,0,0,0,45000,50000,-5000,-5000
20200312,056681,鴻海統一98購09,,,,,0.00,0.00,0,0,0,0,0,0,0,0,0,0,0,0,0
20200312,056682,鴻海統一98購10,0.59,0.59,0.59,0.59,-0.15,-20.27,48000,1,28320,0,0,0,0,0,0,48000,0,48000,48000
20200312,056683,台積電統一98購05,0.42,0.42,0.39,0.39,-0.22,-36.07,53000,2,22110,0,0,0,0,0,0,48000,5000,43000,43000
20200312,056684,旺宏統一98購02,0.88,0.88,0.88,0.88,-0.42,-32.31,48000,1,42240,0,0,0,0,0,0,0,48000,-48000,-48000
20200312,056685,光罩統一98購03,0.81,0.81,0.70,0.70,-0.24,-25.53,67000,5,49860,0,0,0,0,0,0,57000,37000,20000,20000
20200312,056686,可成統一98購01,0.54,0.54,0.37,0.37,-0.34,-47.89,101000,6,46680,0,0,0,0,0,0,48000,53000,-5000,-5000
20200312,056687,元大金統一98購01,,,,,0.00,0.00,0,0,0,0,0,0,0,0,0,0,0,0,0
20200312,056688,聯詠統一98購01,0.47,0.47,0.42,0.42,-0.18,-30.0,126000,3,58190,0,0,0,0,0,0,115000,11000,104000,104000
20200312,056689,玉晶光統一9A購03,1.20,1.20,1.20,1.20,-0.71,-37.17,10000,1,12000,0,0,0,0,0,0,0,10000,-10000,-10000
20200312,05668P,滬深2X永豐96售04,1.59,1.84,1.59,1.84,+0.35,23.49,91000,10,157880,0,0,0,0,0,0,91000,0,91000,91000
20200312,056691,元油2X群益9B購01,0.08,0.08,0.05,0.06,-0.02,-25.0,394000,15,22810,0,0,0,0,0,0,0,0,0,0
20200312,056692,燿華群益98購03,0.52,0.52,0.38,0.38,-0.39,-50.65,71000,21,33010,0,0,0,0,0,0,61000,10000,51000,51000
20200312,056693,國產群益98購01,0.68,0.68,0.60,0.64,-0.19,-22.89,63000,5,41040,0,0,0,0,0,0,21000,42000,-21000,-21000
20200312,056694,欣興群益98購04,2.64,2.64,1.50,1.95,-1.29,-39.81,333000,18,733450,0,0,0,0,0,0,62000,239000,-177000,-177000
20200312,056695,景碩群益99購01,1.86,1.92,1.50,1.50,-0.92,-38.02,60000,3,106200,0,0,0,0,0,0,50000,10000,40000,40000
20200312,056696,茂林群益98購02,0.60,0.60,0.51,0.52,-0.11,-17.46,67000,4,37210,0,0,0,0,0,0,45000,36000,9000,9000
20200312,056697,緯穎群益98購01,2.44,2.44,1.90,1.90,-0.60,-24.0,39000,7,83190,0,0,0,0,0,0,17000,38000,-21000,-21000
20200312,056698,T50反1國泰9A購01,1.49,1.55,1.49,1.55,+0.50,47.62,75000,3,112600,0,0,0,0,0,0,65000,0,65000,65000
20200312,056699,光罩國泰99購01,1.46,1.46,1.16,1.22,-0.36,-22.78,168000,9,220860,0,0,0,0,0,0,75000,93000,-18000,-18000
20200312,05669P,嘉晶永豐96售03,1.11,1.27,1.07,1.20,+0.08,7.14,350000,25,408560,0,0,0,0,0,0,155000,200000,-45000,-45000
20200312,056700,華新科國泰99購03,1.00,1.00,0.81,0.81,-0.31,-27.68,30000,7,27220,0,0,0,0,0,0,16000,14000,2000,2000
20200312,056701,國產國泰9A購01,0.73,0.73,0.51,0.51,-0.30,-37.04,747000,12,401990,0,0,0,0,0,0,30000,717000,-687000,-687000
20200312,056702,欣興國泰9A購01,1.17,1.17,0.82,0.83,-0.59,-41.55,412000,24,374010,0,0,0,0,0,0,158000,269000,-111000,-111000
20200312,056703,群創國泰9A購01,0.33,0.33,0.26,0.26,-0.18,-40.91,335000,5,106350,0,0,0,0,0,0,205000,130000,75000,75000
20200312,056704,健策國泰99購01,0.84,0.84,0.62,0.62,-0.34,-35.42,499000,19,355700,0,0,0,0,0,0,205000,329000,-124000,-124000
20200312,056705,超眾國泰99購01,1.03,1.04,1.03,1.04,0.00,0.00,13000,2,13490,0,0,0,0,0,0,0,13000,-13000,-13000
20200312,056706,元油2X富邦9B購01,0.10,0.10,0.08,0.08,-0.03,-27.27,40000,4,3700,0,0,0,0,0,0,0,20000,-20000,-20000
20200312,056707,鴻海富邦99購03,0.80,0.80,0.73,0.73,-0.26,-26.26,11000,2,8730,0,0,0,0,0,0,11000,1000,10000,10000
20200312,056708,元油2X永豐98購02,,,,,0.00,0.00,0,0,0,0,0,0,0,0,0,0,0,0,0
20200312,056709,華通永豐98購01,0.89,0.91,0.60,0.60,-0.65,-52.0,206000,15,161930,0,0,0,0,0,0,138000,108000,30000,30000
20200312,05670P,台積電國票98售01,1.44,2.04,1.44,1.57,+0.33,26.61,576000,18,939650,0,0,0,0,0,0,289000,287000,2000,2000
20200312,056710,漢唐永豐98購01,0.37,0.38,0.37,0.38,-0.18,-32.14,57000,2,21250,0,0,0,0,0,0,57000,0,57000,57000
20200312,056711,亞光永豐98購01,,,,,0.00,0.00,0,0,0,0,0,0,0,0,0,0,0,0,0
20200312,056712,京鼎永豐98購01,0.32,0.32,0.27,0.27,-0.11,-28.95,284000,3,89680,0,0,0,0,0,0,284000,0,284000,284000
20200312,056713,華擎永豐98購01,0.69,0.74,0.66,0.74,-0.15,-16.85,82000,4,56270,0,0,0,0,0,0,22000,82000,-60000,-60000
20200312,056714,晶相光永豐98購02,1.74,1.74,1.38,1.39,-0.68,-32.85,58000,5,92860,0,0,0,0,0,0,56000,2000,54000,54000
20200312,056715,瀚宇博永豐98購01,1.27,1.27,1.02,1.02,-0.57,-35.85,140000,3,160480,0,0,0,0,0,0,4000,140000,-136000,-136000
20200312,056716,康舒永豐98購01,,,,,0.00,0.00,0,0,0,0,0,0,0,0,0,0,0,0,0
20200312,056717,康友永豐98購01,0.73,0.73,0.73,0.73,-0.14,-16.09,10000,1,7300,0,0,0,0,0,0,10000,0,10000,10000
20200312,056718,GIS永豐98購01,0.51,0.52,0.35,0.35,-0.36,-50.7,125000,5,62750,0,0,0,0,0,0,113000,12000,101000,101000
20200312,056719,台虹永豐98購01,1.15,1.15,1.15,1.15,-0.24,-17.27,78000,1,89700,0,0,0,0,0,0,78000,0,78000,78000
20200312,05671P,友達國泰97售03,0.90,1.18,0.90,1.18,+0.42,55.26,270000,13,272220,0,0,0,0,0,0,178000,102000,76000,76000
20200312,056720,世紀鋼永豐98購01,2.66,2.72,2.31,2.61,-0.20,-7.12,86000,14,223630,0,0,0,0,0,0,10000,76000,-66000,-66000
20200312,056721,台灣50永昌9A購01,1.10,1.10,0.74,0.85,-0.51,-37.5,1131000,55,1002840,0,0,0,0,0,0,581000,918000,-337000,-337000
20200312,056722,滬深反中信9B購01,,,,,0.00,0.00,0,0,0,0,0,0,0,0,0,0,0,0,0
20200312,056723,國巨中信9A購01,,,,,0.00,0.00,0,0,0,0,0,0,0,0,0,0,0,0,0
20200312,056724,臻鼎中信9A購01,0.32,0.32,0.24,0.26,-0.17,-39.53,105000,9,30280,0,0,0,0,0,0,13000,91000,-78000,-78000
20200312,056725,鴻海國票99購03,0.13,0.13,0.13,0.13,-0.09,-40.91,3000,1,390,0,0,0,0,0,0,0,3000,-3000,-3000
20200312,056726,友達日盛9A購01,,,,,0.00,0.00,0,0,0,0,0,0,0,0,0,0,0,0,0
20200312,056727,滬深反凱基9B購01,0.38,0.41,0.38,0.40,+0.06,17.65,372000,12,142760,0,0,0,0,0,0,0,372000,-372000,-372000
20200312,056728,元油2X凱基9A購02,,,,,0.00,0.00,0,0,0,0,0,0,0,0,0,0,0,0,0
20200312,056729,元油2X凱基9A購03,,,,,0.00,0.00,0,0,0,0,0,0,0,0,0,0,0,0,0
20200312,05672P,鴻海群益96售03,2.57,3.30,2.47,3.30,+1.20,57.14,104000,20,290130,0,0,0,0,0,0,70000,49000,21000,21000
20200312,056730,元油2X凱基9A購04,0.05,0.09,0.05,0.09,-0.01,-10.0,150000,5,11200,0,0,0,0,0,0,0,0,0,0
20200312,056731,國巨凱基98購04,,,,,0.00,0.00,0,0,0,0,0,0,0,0,0,0,0,0,0
20200312,056732,國巨凱基98購07,,,,,0.00,0.00,0,0,0,0,0,0,0,0,0,0,0,0,0
20200312,056733,國巨凱基98購10,,,,,0.00,0.00,0,0,0,0,0,0,0,0,0,0,0,0,0
20200312,056734,國巨凱基99購01,1.14,1.14,0.80,0.80,-0.58,-42.03,83000,5,80950,0,0,0,0,0,0,43000,40000,3000,3000
20200312,056735,國巨凱基99購02,,,,,0.00,0.00,0,0,0,0,0,0,0,0,0,0,0,0,0
20200312,056736,國巨凱基99購03,1.41,1.41,1.25,1.25,-0.16,-11.35,88000,3,112400,0,0,0,0,0,0,88000,0,88000,88000
20200312,056737,國巨凱基9A購01,1.53,1.53,1.30,1.30,-0.68,-34.34,23000,2,30590,0,0,0,0,0,0,20000,3000,17000,17000
20200312,056738,國巨凱基9A購02,1.42,1.42,1.34,1.34,-0.39,-22.54,2000,2,2760,0,0,0,0,0,0,0,2000,-2000,-2000
20200312,056739,美律凱基98購04,0.47,0.48,0.37,0.38,-0.25,-39.68,175000,19,73900,0,0,0,0,0,0,77000,165000,-88000,-88000
20200312,05673P,台積電群益96售05,2.51,3.42,2.51,3.01,+1.20,66.3,106000,10,299250,0,0,0,0,0,0,90000,16000,74000,74000
20200312,056740,大立光凱基98購13,,,,,0.00,0.00,0,0,0,0,0,0,0,0,0,0,0,0,0
20200312,056741,大立光凱基98購14,,,,,0.00,0.00,0,0,0,0,0,0,0,0,0,0,0,0,0
20200312,056742,玉晶光凱基9A購01,0.44,0.44,0.34,0.34,-0.14,-29.17,339000,11,118910,0,0,0,0,0,0,40000,299000,-259000,-259000
20200312,056743,貿聯凱基98購04,0.75,0.79,0.62,0.62,-0.23,-27.06,223000,23,161260,0,0,0,0,0,0,191000,30000,161000,161000
20200312,056744,麗豐凱基9A購01,0.49,0.49,0.49,0.49,-0.08,-14.04,4000,1,1960,0,0,0,0,0,0,0,4000,-4000,-4000
20200312,056745,聯茂凱基99購03,1.91,1.91,1.91,1.91,-1.14,-37.38,10000,1,19100,0,0,0,0,0,0,10000,0,10000,10000
20200312,056746,超眾凱基99購01,1.51,1.51,1.51,1.51,-0.33,-17.93,10000,1,15100,0,0,0,0,0,0,10000,0,10000,10000
20200312,056747,致新凱基99購01,0.86,0.86,0.71,0.75,-0.19,-20.21,271000,17,220450,0,0,0,0,0,0,237000,34000,203000,203000
20200312,056748,T50反1兆豐99購01,,,,,0.00,0.00,0,0,0,0,0,0,0,0,0,0,0,0,0
20200312,056749,滬深2X兆豐99購01,1.32,1.33,1.17,1.21,-0.22,-15.38,812000,35,999590,0,0,0,0,0,0,340000,472000,-132000,-132000
20200312,05674P,瑞昱群益96售02,1.42,1.72,1.42,1.68,+0.53,46.09,70000,9,108000,0,0,0,0,0,0,35000,35000,0,0
20200312,056750,元油2X兆豐9A購01,0.03,0.03,0.03,0.03,-0.01,-25.0,20000,2,600,0,0,0,0,0,0,0,20000,-20000,-20000
20200312,056751,和大兆豐98購01,0.29,0.29,0.29,0.29,-0.09,-23.68,10000,1,2900,0,0,0,0,0,0,10000,0,10000,10000
20200312,056752,國巨兆豐98購02,0.65,0.66,0.45,0.48,-0.29,-37.66,110000,7,52650,0,0,0,0,0,0,80000,30000,50000,50000
20200312,056753,群創兆豐98購02,0.08,0.08,0.07,0.07,-0.06,-46.15,300000,21,22930,0,0,0,0,0,0,0,300000,-300000,-300000
20200312,056754,智易兆豐99購01,1.11,1.11,0.78,0.84,-0.35,-29.41,135000,12,124360,0,0,0,0,0,0,45000,90000,-45000,-45000
20200312,056755,聯茂兆豐98購01,,,,,0.00,0.00,0,0,0,0,0,0,0,0,0,0,0,0,0
20200312,056756,T50反1元大98購06,1.14,1.36,1.14,1.34,+0.45,50.56,185000,5,243200,0,0,0,0,0,0,165000,20000,145000,145000
20200312,056757,T50反1元大98購07,1.22,1.34,1.22,1.34,0.00,0.00,1363000,3,1762780,0,0,0,0,0,0,0,1363000,-1363000,-1363000
20200312,056758,元石油元大98購02,0.07,0.07,0.06,0.07,-0.04,-36.36,1365000,16,94550,0,0,0,0,0,0,100000,1265000,-1165000,-1165000
20200312,056759,元油2X元大98購05,0.01,0.01,0.01,0.01,0.00,0.00,21000,1,210,0,0,0,0,0,0,0,0,0,0
20200312,05675P,美律群益97售01,1.65,2.06,1.65,2.06,+0.50,32.05,78000,9,140990,0,1000,-1000,0,0,0,58000,20000,38000,37000
20200312,056760,元油2X元大98購06,0.02,0.05,0.02,0.02,-0.01,-33.33,675000,10,13950,0,0,0,0,0,0,0,0,0,0
20200312,056761,元油2X元大98購07,0.05,0.05,0.02,0.04,-0.16,-80.0,5525000,61,147870,0,0,0,0,0,0,0,769000,-769000,-769000
20200312,056762,亞德客元大98購01,1.43,1.43,1.09,1.09,-0.51,-31.87,74000,5,99800,0,0,0,0,0,0,61000,13000,48000,48000
20200312,056763,國巨元大99購02,2.71,2.71,2.24,2.24,-0.86,-27.74,22000,2,58680,0,0,0,0,0,0,22000,20000,2000,2000
20200312,056764,友達元大9A購03,0.46,0.46,0.46,0.46,-0.19,-29.23,10000,1,4600,0,0,0,0,0,0,0,10000,-10000,-10000
20200312,056765,友達元大9B購05,0.51,0.51,0.43,0.43,-0.24,-35.82,400000,8,183000,0,0,0,0,0,0,200000,200000,0,0
20200312,056766,義隆元大98購01,1.72,1.72,1.52,1.61,-0.34,-17.44,84000,10,131760,0,0,0,0,0,0,17000,71000,-54000,-54000
20200312,056767,大毅元大99購01,1.31,1.31,1.10,1.10,-0.33,-23.08,62000,7,75880,0,0,0,0,0,0,37000,45000,-8000,-8000
20200312,056768,宏達電元大99購03,2.70,2.70,2.15,2.32,-0.48,-17.14,61000,3,133780,0,0,0,0,0,0,2000,61000,-59000,-59000
20200312,056769,國產元大98購01,0.74,0.74,0.74,0.74,-0.11,-12.94,10000,1,7400,0,0,0,0,0,0,10000,0,10000,10000
20200312,05676P,欣興群益96售04,3.72,3.96,3.67,3.90,+0.75,23.81,68000,6,257360,0,0,0,0,0,0,43000,25000,18000,18000
20200312,056770,國產元大98購02,0.79,0.79,0.79,0.79,0.00,0.00,68000,1,53720,0,0,0,0,0,0,0,68000,-68000,-68000
20200312,056771,嘉晶元大99購01,5.50,5.85,5.00,5.25,-0.95,-15.32,52000,11,276450,0,0,0,0,0,0,47000,7000,40000,40000
20200312,056772,欣興元大99購01,2.05,2.05,1.59,1.59,-0.90,-36.14,49000,4,87910,0,0,0,0,0,0,39000,37000,2000,2000
20200312,056773,晶技元大99購03,2.15,2.15,1.50,1.50,-0.54,-26.47,859000,50,1572910,0,0,0,0,0,0,553000,374000,179000,179000
20200312,056774,和鑫元大98購01,0.84,0.84,0.64,0.65,0.00,0.00,156000,7,118860,0,0,0,0,0,0,3000,153000,-150000,-150000
20200312,056775,康控元大99購01,0.97,0.97,0.97,0.97,-0.28,-22.4,35000,1,33950,0,0,0,0,0,0,0,35000,-35000,-35000
20200312,056776,聯茂元大99購01,4.85,4.85,3.64,3.64,-1.96,-35.0,48000,2,223120,0,0,0,0,0,0,48000,8000,40000,40000
20200312,056777,矽力元大98購02,1.64,1.64,1.38,1.41,-0.46,-24.6,154000,12,220690,0,0,0,0,0,0,104000,50000,54000,54000
20200312,056778,元石油群益9B購01,0.28,0.28,0.24,0.28,-0.05,-15.15,458000,22,120230,0,0,0,0,0,0,10000,50000,-40000,-40000
20200312,056779,元油2X群益9A購02,0.10,0.10,0.10,0.10,-0.06,-37.5,50000,1,5000,0,0,0,0,0,0,0,0,0,0
20200312,05677P,玉晶光群益98售03,0.40,0.49,0.40,0.48,+0.11,29.73,881000,47,390420,0,0,0,0,0,0,484000,387000,97000,97000
20200312,056780,元油2X群益9A購03,0.03,0.04,0.03,0.04,+0.01,33.33,350000,5,13500,0,0,0,0,0,0,0,0,0,0
20200312,056781,元油2X群益9B購02,0.05,0.05,0.04,0.05,0.00,0.00,604000,4,25210,0,0,0,0,0,0,0,0,0,0
20200312,056782,鴻海群益98購04,1.59,1.62,1.17,1.26,-0.60,-32.26,1126000,44,1523920,0,0,0,0,0,0,1054000,84000,970000,970000
20200312,056783,國巨群益99購01,1.76,1.76,1.40,1.40,-0.63,-31.03,874000,12,1510000,0,0,0,0,0,0,715000,74000,641000,641000
20200312,056784,南亞科群益98購01,0.40,0.40,0.27,0.28,-0.30,-51.72,53000,4,17470,0,0,0,0,0,0,32000,21000,11000,11000
20200312,056785,可成群益99購01,0.75,0.75,0.58,0.58,-0.48,-45.28,109000,2,79880,0,0,0,0,0,0,98000,11000,87000,87000
20200312,056786,亞光群益98購03,,,,,0.00,0.00,0,0,0,0,0,0,0,0,0,0,0,0,0
20200312,056787,健鼎群益98購01,0.78,0.78,0.70,0.72,-0.23,-24.21,196000,4,146600,0,0,0,0,0,0,98000,98000,0,0
20200312,056788,日月光群益98購01,0.40,0.40,0.24,0.24,-0.28,-53.85,128000,4,36260,0,0,0,0,0,0,24000,104000,-80000,-80000
20200312,056789,和碩群益98購01,0.90,0.92,0.80,0.81,-0.23,-22.12,53000,4,45900,0,0,0,0,0,0,32000,21000,11000,11000
20200312,05678P,群創群益97售01,1.12,1.33,1.12,1.33,+0.34,34.34,50000,3,62800,0,0,0,0,0,0,50000,0,50000,50000
20200312,056790,彩晶群益98購03,0.38,0.38,0.29,0.29,-0.23,-44.23,65000,3,22000,0,0,0,0,0,0,35000,30000,5000,5000
20200312,056791,嘉聯益群益98購01,2.55,2.55,1.85,1.85,-1.25,-40.32,135000,5,329830,0,0,0,0,0,0,104000,37000,67000,67000
20200312,056792,訊芯群益98購01,0.32,0.32,0.25,0.25,-0.15,-37.5,272000,5,82920,0,0,0,0,0,0,11000,261000,-250000,-250000
20200312,056793,臺股指群益98購03,0.27,0.27,0.27,0.27,-0.15,-35.71,60000,1,16200,0,0,0,0,0,0,60000,0,60000,60000
20200312,056794,上銀麥證98購01,1.16,1.16,1.11,1.11,-0.41,-26.97,60000,3,67400,50000,10000,40000,0,0,0,50000,10000,40000,40000
20200312,056795,鴻海麥證98購01,0.80,0.80,0.74,0.74,-0.24,-24.49,30000,2,22800,0,30000,-30000,0,0,0,0,30000,-30000,-30000
20200312,056796,國巨麥證98購02,1.77,1.77,1.33,1.33,-0.81,-37.85,40000,3,61700,20000,20000,0,0,0,0,20000,20000,0,0
20200312,056797,台積電麥證98購01,1.58,1.58,1.25,1.25,-0.74,-37.19,20000,3,28330,20000,0,20000,0,0,0,20000,0,20000,20000
20200312,056798,華新科麥證98購01,0.63,0.63,0.38,0.42,-0.44,-51.16,64000,9,37360,27000,37000,-10000,0,0,0,27000,37000,-10000,-10000
20200312,056799,群創麥證98購01,0.11,0.11,0.11,0.11,0.00,0.00,30000,1,3300,0,30000,-30000,0,0,0,0,30000,-30000,-30000
20200312,05679P,台表科群益96售05,2.86,3.42,2.86,3.40,+0.74,27.82,33000,3,102680,0,0,0,0,0,0,33000,0,33000,33000
20200312,056800,臺股指麥證98購01,,,,,0.00,0.00,0,0,0,0,0,0,0,0,0,0,0,0,0
20200312,056801,國巨台新98購01,,,,,0.00,0.00,0,0,0,0,0,0,0,0,0,0,0,0,0
20200312,056802,友達台新98購01,0.11,0.11,0.11,0.11,0.00,0.00,20000,1,2200,0,0,0,0,0,0,0,20000,-20000,-20000
20200312,056803,群創台新99購02,,,,,0.00,0.00,0,0,0,0,0,0,0,0,0,0,0,0,0
20200312,056804,T50反1統一9A購03,1.37,1.37,1.37,1.37,0.00,0.00,30000,1,41100,0,0,0,0,0,0,0,30000,-30000,-30000
20200312,056805,元石油統一9B購01,0.34,0.36,0.28,0.30,-0.13,-30.23,169000,22,54650,0,0,0,0,0,0,0,0,0,0
20200312,056806,元油2X統一98購02,,,,,0.00,0.00,0,0,0,0,0,0,0,0,0,0,0,0,0
20200312,056807,元油2X統一9B購01,0.03,0.04,0.03,0.04,0.00,0.00,206000,7,6280,0,0,0,0,0,0,0,196000,-196000,-196000
20200312,056808,台積電統一98購06,0.42,0.42,0.42,0.42,-0.21,-33.33,48000,1,20160,0,0,0,0,0,0,48000,0,48000,48000
20200312,056809,旺宏統一98購03,,,,,0.00,0.00,0,0,0,0,0,0,0,0,0,0,0,0,0
20200312,05680P,聯發科元大96售12,2.85,2.98,2.85,2.98,+0.85,39.91,38000,2,109600,0,0,0,0,0,0,38000,0,38000,38000
20200312,056810,群創統一9A購01,0.32,0.32,0.28,0.28,-0.14,-33.33,155000,4,48200,0,0,0,0,0,0,0,155000,-155000,-155000
20200312,056811,健策統一9B購01,0.25,0.25,0.18,0.18,-0.13,-41.94,490000,6,100400,0,0,0,0,0,0,60000,430000,-370000,-370000
20200312,056812,泰鼎統一98購01,1.03,1.07,0.88,0.93,-0.37,-28.46,179000,9,163460,0,0,0,0,0,0,174000,5000,169000,169000
20200312,056813,聯茂統一99購01,1.59,1.59,1.43,1.43,-0.26,-15.38,120000,6,179800,0,0,0,0,0,0,120000,0,120000,120000
20200312,056814,元油2X永豐98購04,,,,,0.00,0.00,0,0,0,0,0,0,0,0,0,0,0,0,0
20200312,056815,元油2X永豐98購05,,,,,0.00,0.00,0,0,0,0,0,0,0,0,0,0,0,0,0
20200312,056816,華通永豐98購02,0.56,0.56,0.56,0.56,-0.14,-20.0,68000,1,38080,0,0,0,0,0,0,68000,0,68000,68000
20200312,056817,國巨永豐98購04,0.32,0.33,0.32,0.33,-0.25,-43.1,12000,2,3910,0,0,0,0,0,0,5000,7000,-2000,-2000
20200312,056818,正崴永豐98購01,0.63,0.64,0.42,0.42,-0.34,-44.74,201000,11,102030,0,0,0,0,0,0,141000,60000,81000,81000
20200312,056819,奇力新永豐98購01,0.20,0.20,0.20,0.20,-0.14,-41.18,68000,1,13600,0,0,0,0,0,0,68000,0,68000,68000
20200312,05681P,大立光元大96售05,3.98,4.30,3.98,4.30,+1.32,44.3,106000,4,433120,0,0,0,0,0,0,57000,99000,-42000,-42000
20200312,056820,欣興永豐98購02,0.56,0.56,0.47,0.47,-0.53,-53.0,70000,2,33080,0,0,0,0,0,0,70000,2000,68000,68000
20200312,056821,日電貿永豐98購01,0.56,0.56,0.56,0.56,0.00,0.00,10000,1,5600,0,0,0,0,0,0,10000,0,10000,10000
20200312,056822,佐登永豐98購01,,,,,0.00,0.00,0,0,0,0,0,0,0,0,0,0,0,0,0
20200312,056823,智伸科永豐98購01,0.34,0.34,0.34,0.34,-0.11,-24.44,25000,1,8500,0,0,0,0,0,0,25000,0,25000,25000
20200312,056824,元石油富邦9B購01,0.10,0.10,0.09,0.09,-0.03,-25.0,279000,13,25550,0,0,0,0,0,0,152000,44000,108000,108000
20200312,056825,深中小富邦9B購01,1.06,1.06,0.99,0.99,-0.21,-17.5,15000,4,15610,0,0,0,0,0,0,10000,5000,5000,5000
20200312,056826,A50正2富邦9B購02,,,,,0.00,0.00,0,0,0,0,0,0,0,0,0,0,0,0,0
20200312,056827,元油2X富邦02購01,0.12,0.17,0.12,0.12,-0.05,-29.41,1404000,153,186100,0,0,0,0,0,0,0,1310000,-1310000,-1310000
20200312,056828,國巨富邦9A購03,0.48,0.48,0.33,0.33,-0.17,-34.0,1731000,33,641490,0,0,0,0,0,0,1498000,173000,1325000,1325000
20200312,056829,台積電富邦9A購01,0.41,0.41,0.29,0.36,-0.07,-16.28,14414000,326,4978410,61000,0,61000,0,0,0,6112000,10374000,-4262000,-4201000
20200312,05682P,大立光元大98售03,1.74,2.15,1.74,2.14,+0.54,33.75,308000,21,614280,0,0,0,0,0,0,246000,51000,195000,195000
20200312,056830,友達富邦99購01,0.10,0.10,0.10,0.10,0.00,0.00,35000,1,3500,0,0,0,0,0,0,0,35000,-35000,-35000
20200312,056831,元油2X元富98購11,0.03,0.04,0.03,0.04,+0.01,33.33,215000,4,6600,0,0,0,0,0,0,0,15000,-15000,-15000
20200312,056832,元油2X元富98購12,0.02,0.02,0.02,0.02,-0.01,-33.33,56000,2,1120,0,0,0,0,0,0,0,0,0,0
20200312,056833,和大元富9B購01,0.71,0.71,0.58,0.60,-0.31,-34.07,271000,8,168680,0,0,0,0,0,0,148000,123000,25000,25000
20200312,056834,華新元富99購01,0.56,0.56,0.32,0.32,-0.32,-50.0,490000,8,202000,0,0,0,0,0,0,430000,60000,370000,370000
20200312,056835,聯電元富99購01,0.96,0.97,0.72,0.87,-0.23,-20.91,2033000,29,1770080,0,0,0,0,0,0,1216000,817000,399000,399000
20200312,056836,國巨元富98購01,0.73,0.73,0.46,0.46,-0.29,-38.67,2055000,51,1033860,0,0,0,0,0,0,1958000,1997000,-39000,-39000
20200312,056837,國巨元富98購02,,,,,0.00,0.00,0,0,0,0,0,0,0,0,0,0,0,0,0
20200312,056838,旺宏元富98購01,0.42,0.42,0.42,0.42,0.00,0.00,50000,1,21000,0,0,0,0,0,0,0,50000,-50000,-50000
20200312,056839,台光電元富98購02,1.63,1.66,1.49,1.49,-0.35,-19.02,286000,8,452360,0,0,0,0,0,0,188000,98000,90000,90000
20200312,05683P,矽創元大96售01,1.54,1.95,1.54,1.90,+0.37,24.18,587000,27,1024570,0,0,0,0,0,0,168000,419000,-251000,-251000
20200312,056840,友達元富98購02,,,,,0.00,0.00,0,0,0,0,0,0,0,0,0,0,0,0,0
20200312,056841,友達元富98購03,,,,,0.00,0.00,0,0,0,0,0,0,0,0,0,0,0,0,0
20200312,056842,全新元富98購01,,,,,0.00,0.00,0,0,0,0,0,0,0,0,0,0,0,0,0
20200312,056843,冠德元富98購01,1.02,1.02,0.65,0.65,-0.48,-42.48,205000,21,163550,0,0,0,0,0,0,20000,185000,-165000,-165000
20200312,056844,欣興元富98購03,1.86,1.86,1.46,1.46,-0.91,-38.4,187000,10,319180,0,0,0,0,0,0,44000,177000,-133000,-133000
20200312,056845,揚明光元富98購01,,,,,0.00,0.00,0,0,0,0,0,0,0,0,0,0,0,0,0
20200312,056846,晶相光元富98購01,2.68,2.68,2.52,2.65,-0.18,-6.36,116000,3,302400,0,0,0,0,0,0,116000,0,116000,116000
20200312,056847,佐登元富98購01,,,,,0.00,0.00,0,0,0,0,0,0,0,0,0,0,0,0,0
20200312,056848,泰鼎元富98購01,1.04,1.04,0.77,0.84,-0.32,-27.59,152000,8,144180,0,0,0,0,0,0,152000,0,152000,152000
20200312,056849,瀚宇博元富98購01,2.50,2.50,2.04,2.04,-0.92,-31.08,34000,3,77660,0,0,0,0,0,0,34000,14000,20000,20000
20200312,05684P,臺股指元大96售09,,,,,0.00,0.00,0,0,0,0,0,0,0,0,0,0,0,0,0
20200312,056850,彩晶元富99購01,0.34,0.34,0.25,0.25,-0.27,-51.92,12000,2,3630,0,0,0,0,0,0,12000,0,12000,12000
20200312,056851,瑞儀元富98購01,1.01,1.02,0.82,0.82,-0.37,-31.09,202000,26,196070,0,0,0,0,0,0,162000,40000,122000,122000
20200312,056852,矽格元富98購01,2.87,2.93,2.33,2.41,-0.99,-29.12,465000,17,1171500,0,0,0,0,0,0,352000,113000,239000,239000
20200312,056853,元油2X中信9B購02,0.10,0.10,0.10,0.10,-0.04,-28.57,5000,1,500,0,0,0,0,0,0,0,5000,-5000,-5000
20200312,056854,友達中信9A購01,0.14,0.14,0.11,0.11,-0.09,-45.0,246000,6,32820,0,0,0,0,0,0,130000,116000,14000,14000
20200312,056855,祥碩中信98購02,0.40,0.40,0.33,0.33,-0.07,-17.5,75000,8,27650,0,0,0,0,0,0,45000,30000,15000,15000
20200312,056856,華通群益9A購01,1.61,1.64,1.18,1.18,-0.68,-36.56,305000,17,444900,0,0,0,0,0,0,205000,140000,65000,65000
20200312,056857,國巨群益99購02,1.42,1.42,1.08,1.08,-0.52,-32.5,157000,7,178060,0,0,0,0,0,0,107000,30000,77000,77000
20200312,056858,國巨群益99購03,1.06,1.10,1.04,1.06,-0.95,-47.26,300000,7,314780,0,0,0,0,0,0,295000,4000,291000,291000
20200312,056859,台積電群益98購02,0.85,0.85,0.55,0.65,-0.45,-40.91,820000,23,613850,0,0,0,0,0,0,710000,105000,605000,605000
20200312,05685P,臺股指元大96售10,3.89,6.10,3.89,5.60,+2.39,74.45,160000,34,759660,0,0,0,0,0,0,90000,70000,20000,20000
20200312,056860,正崴群益98購01,0.96,0.96,0.88,0.88,-0.31,-26.05,62000,4,58260,0,0,0,0,0,0,52000,33000,19000,19000
20200312,056861,美律群益99購01,1.12,1.12,0.72,0.88,-0.40,-31.25,111000,7,118990,0,0,0,0,0,0,53000,58000,-5000,-5000
20200312,056862,聯發科群益98購03,1.05,1.05,0.72,0.77,-0.43,-35.83,1165000,15,1127000,0,0,0,0,0,0,1018000,152000,866000,866000
20200312,056863,義隆群益98購01,1.96,1.98,1.66,1.73,-0.61,-26.07,157000,9,281300,0,0,0,0,0,0,135000,22000,113000,113000
20200312,056864,新日興群益99購01,0.93,0.93,0.70,0.70,-0.38,-35.19,218000,7,172400,0,0,0,0,0,0,0,218000,-218000,-218000
20200312,056865,樺漢群益98購01,1.08,1.08,0.67,0.67,-0.75,-52.82,55000,5,53150,0,0,0,0,0,0,30000,25000,5000,5000
20200312,056866,矽創群益98購03,1.56,1.56,1.28,1.28,-0.36,-21.95,192000,2,298960,0,0,0,0,0,0,192000,0,192000,192000
20200312,056867,華通麥證98購01,0.89,0.89,0.74,0.74,-0.19,-20.43,64000,8,53860,64000,0,64000,0,0,0,64000,10000,54000,54000
20200312,056868,奇力新麥證98購01,,,,,0.00,0.00,0,0,0,0,0,0,0,0,0,0,0,0,0
20200312,056869,國巨日盛99購03,1.32,1.34,0.97,0.99,-0.48,-32.65,359000,21,398130,0,0,0,0,0,0,179000,180000,-1000,-1000
20200312,05686P,臺股指元大96售11,4.25,5.45,4.25,4.99,+1.30,35.23,1025000,22,5457300,0,0,0,0,0,0,990000,35000,955000,955000
20200312,056870,全新日盛9A購01,0.81,0.81,0.68,0.68,-0.30,-30.61,30000,2,22350,0,0,0,0,0,0,0,30000,-30000,-30000
20200312,056871,新日興日盛99購01,0.95,0.95,0.76,0.76,-0.48,-38.71,81000,4,67620,0,0,0,0,0,0,30000,51000,-21000,-21000
20200312,056872,旺宏凱基98購08,,,,,0.00,0.00,0,0,0,0,0,0,0,0,0,0,0,0,0
20200312,056873,友達凱基98購07,,,,,0.00,0.00,0,0,0,0,0,0,0,0,0,0,0,0,0
20200312,056874,友達凱基98購08,0.15,0.15,0.15,0.15,-0.05,-25.0,10000,1,1500,0,0,0,0,0,0,0,10000,-10000,-10000
20200312,056875,亞光凱基98購03,0.63,0.63,0.45,0.45,-0.36,-44.44,63000,7,32600,0,0,0,0,0,0,40000,48000,-8000,-8000
20200312,056876,群創凱基98購11,0.20,0.20,0.20,0.20,0.00,0.00,11000,1,2200,0,0,0,0,0,0,11000,0,11000,11000
20200312,056877,群創凱基99購04,,,,,0.00,0.00,0,0,0,0,0,0,0,0,0,0,0,0,0
20200312,056878,元油2X國票99購02,,,,,0.00,0.00,0,0,0,0,0,0,0,0,0,0,0,0,0
20200312,056879,旺宏國票99購02,,,,,0.00,0.00,0,0,0,0,0,0,0,0,0,0,0,0,0
20200312,05687P,臺股指元大96售12,,,,,0.00,0.00,0,0,0,0,0,0,0,0,0,0,0,0,0
20200312,056880,緯穎國票98購02,1.81,1.81,1.09,1.18,-1.04,-46.85,224000,8,298860,0,0,0,0,0,0,134000,90000,44000,44000
20200312,056881,台灣50康和9A購01,0.34,0.34,0.23,0.25,-0.20,-44.44,482000,18,129390,0,0,0,0,0,0,104000,378000,-274000,-274000
20200312,056882,華邦電康和98購01,,,,,0.00,0.00,0,0,0,0,0,0,0,0,0,0,0,0,0
20200312,056883,美食康和98購01,0.69,0.69,0.69,0.69,0.00,0.00,20000,1,13800,0,0,0,0,0,0,20000,0,20000,20000
20200312,056884,元油2X元大99購02,,,,,0.00,0.00,0,0,0,0,0,0,0,0,0,0,0,0,0
20200312,056885,元油2X元大99購03,,,,,0.00,0.00,0,0,0,0,0,0,0,0,0,0,0,0,0
20200312,056886,元油2X元大99購04,0.03,0.03,0.03,0.03,+0.01,50.0,190000,3,5700,0,0,0,0,0,0,0,0,0,0
20200312,056887,元油2X元大99購05,,,,,0.00,0.00,0,0,0,0,0,0,0,0,0,0,0,0,0
20200312,056888,元油2X元大99購06,,,,,0.00,0.00,0,0,0,0,0,0,0,0,0,0,0,0,0
20200312,056889,元油2X元大99購07,0.04,0.04,0.03,0.03,-0.02,-40.0,730000,23,24400,0,0,0,0,0,0,0,0,0,0
20200312,05688P,臺股指元大96售13,4.15,5.10,4.15,4.95,+1.45,41.43,171000,9,765870,0,0,0,0,0,0,161000,10000,151000,151000
20200312,056890,國巨元大98購11,1.51,1.51,1.51,1.51,0.00,0.00,2000,1,3020,0,0,0,0,0,0,0,2000,-2000,-2000
20200312,056891,國巨元大99購03,2.17,2.17,2.17,2.17,-0.13,-5.65,20000,1,43400,0,0,0,0,0,0,20000,20000,0,0
20200312,056892,旺宏元大9A購02,1.40,1.40,1.11,1.11,-0.54,-32.73,172000,6,214480,0,0,0,0,0,0,104000,70000,34000,34000
20200312,056893,智邦元大98購02,1.44,1.44,1.12,1.18,-0.27,-18.62,166000,12,203320,0,0,0,0,0,0,86000,125000,-39000,-39000
20200312,056894,佳世達元大99購01,,,,,0.00,0.00,0,0,0,0,0,0,0,0,0,0,0,0,0
20200312,056895,技嘉元大98購01,1.92,1.92,1.82,1.82,-0.33,-15.35,8000,3,15020,0,0,0,0,0,0,7000,7000,0,0
20200312,056896,南亞科元大98購01,0.91,0.91,0.67,0.68,-0.51,-42.86,80000,3,70020,0,0,0,0,0,0,12000,68000,-56000,-56000
20200312,056897,南亞科元大98購02,0.90,0.90,0.90,0.90,-0.34,-27.42,68000,1,61200,0,0,0,0,0,0,0,68000,-68000,-68000
20200312,056898,全新元大98購02,,,,,0.00,0.00,0,0,0,0,0,0,0,0,0,0,0,0,0
20200312,056899,可成元大98購01,1.43,1.43,1.19,1.19,-0.53,-30.81,37000,3,50030,0,0,0,0,0,0,37000,12000,25000,25000
20200312,05689P,滬深2X中信97售02,2.36,2.36,2.36,2.36,+0.27,12.92,1000,1,2360,0,0,0,0,0,0,1000,0,1000,1000
20200312,056900,可成元大98購02,1.53,1.53,1.53,1.53,-0.51,-25.0,41000,1,62730,0,0,0,0,0,0,41000,41000,0,0
20200312,056901,華新科元大98購03,,,,,0.00,0.00,0,0,0,0,0,0,0,0,0,0,0,0,0
20200312,056902,大立光元大98購12,1.60,1.60,1.35,1.35,0.00,0.00,60000,2,93500,0,0,0,0,0,0,0,60000,-60000,-60000
20200312,056903,大立光元大99購04,,,,,0.00,0.00,0,0,0,0,0,0,0,0,0,0,0,0,0
20200312,056904,大立光元大99購05,0.79,0.82,0.72,0.72,0.00,0.00,118000,14,90390,0,0,0,0,0,0,0,118000,-118000,-118000
20200312,056905,欣興元大98購03,1.62,1.62,1.41,1.41,-0.37,-20.79,14000,2,22050,0,0,0,0,0,0,14000,3000,11000,11000
20200312,056906,玉晶光元大9B購01,1.06,1.06,0.81,0.81,-0.44,-35.2,115000,10,105070,0,0,0,0,0,0,35000,80000,-45000,-45000
20200312,056907,群創元大9C購04,0.54,0.54,0.52,0.52,-0.17,-24.64,19000,2,10020,0,0,0,0,0,0,19000,19000,0,0
20200312,056908,牧德元大99購03,,,,,0.00,0.00,0,0,0,0,0,0,0,0,0,0,0,0,0
20200312,056909,嘉聯益元大99購03,2.01,2.01,1.65,1.65,-0.73,-30.67,118000,12,217530,0,0,0,0,0,0,8000,117000,-109000,-109000
20200312,05690P,友達中信96售02,0.71,0.71,0.71,0.71,0.00,0.00,286000,2,203060,0,0,0,0,0,0,0,286000,-286000,-286000
20200312,056910,超眾元大99購02,1.60,1.60,1.42,1.43,-0.61,-29.9,89000,8,130570,0,0,0,0,0,0,11000,88000,-77000,-77000
20200312,056911,緯穎元大99購01,1.23,1.23,0.90,0.90,-0.52,-36.62,24000,6,24070,0,0,0,0,0,0,0,24000,-24000,-24000
20200312,056912,臺股指元大99購04,1.80,1.80,1.36,1.46,-0.67,-31.46,168000,12,260750,0,0,0,0,0,0,95000,73000,22000,22000
20200312,056913,臺股指元大99購05,1.15,1.15,0.90,0.92,-0.57,-38.26,415000,15,404250,0,0,0,0,0,0,151000,264000,-113000,-113000
20200312,056914,臺股指元大99購09,2.71,2.71,1.81,2.01,-0.94,-31.86,802000,70,1706880,0,0,0,0,0,0,65000,737000,-672000,-672000
20200312,056915,上銀兆豐99購01,0.49,0.49,0.39,0.39,-0.30,-43.48,42000,4,18930,0,0,0,0,0,0,42000,0,42000,42000
20200312,056916,台達電兆豐98購02,0.55,0.55,0.39,0.39,-0.23,-37.1,140000,7,72170,0,0,0,0,0,0,110000,30000,80000,80000
20200312,056917,國巨兆豐98購03,0.34,0.34,0.30,0.30,-0.35,-53.85,53000,7,16340,0,0,0,0,0,0,7000,46000,-39000,-39000
20200312,056918,台積電兆豐98購01,0.39,0.40,0.27,0.35,-0.14,-28.57,1299000,35,471670,0,0,0,0,0,0,973000,170000,803000,803000
20200312,056919,英業達兆豐98購01,1.39,1.39,1.24,1.24,-0.29,-18.95,194000,7,249250,0,0,0,0,0,0,194000,0,194000,194000
20200312,05691P,聯發科中信98售01,1.75,1.76,1.73,1.73,0.00,0.00,35000,4,61250,0,0,0,0,0,0,5000,30000,-25000,-25000
20200312,056920,友達兆豐98購02,,,,,0.00,0.00,0,0,0,0,0,0,0,0,0,0,0,0,0
20200312,056921,京元電兆豐98購01,1.40,1.40,1.12,1.15,-0.43,-27.22,99000,10,123140,0,0,0,0,0,0,99000,44000,55000,55000
20200312,056922,全新兆豐99購01,0.40,0.40,0.40,0.40,0.00,0.00,20000,1,8000,0,0,0,0,0,0,20000,0,20000,20000
20200312,056923,奇力新兆豐99購02,,,,,0.00,0.00,0,0,0,0,0,0,0,0,0,0,0,0,0
20200312,056924,亞光兆豐98購01,0.20,0.20,0.20,0.20,0.00,0.00,20000,1,4000,0,0,0,0,0,0,20000,0,20000,20000
20200312,056925,群創兆豐98購03,,,,,0.00,0.00,0,0,0,0,0,0,0,0,0,0,0,0,0
20200312,056926,日月光兆豐98購01,0.55,0.55,0.53,0.53,-0.19,-26.39,50000,3,26940,0,0,0,0,0,0,50000,0,50000,50000
20200312,056927,T50反1台新02購01,1.52,1.52,1.52,1.52,+0.36,31.03,50000,1,76000,0,0,0,0,0,0,50000,0,50000,50000
20200312,056928,旺宏台新98購01,0.17,0.17,0.17,0.17,0.00,0.00,9000,1,1530,0,0,0,0,0,0,9000,0,9000,9000
20200312,056929,華新科台新98購01,0.46,0.46,0.27,0.32,-0.35,-52.24,119000,7,43720,0,0,0,0,0,0,38000,81000,-43000,-43000
20200312,05692P,聯發科中信9A售02,1.36,1.55,1.36,1.52,0.00,0.00,256000,15,367950,0,0,0,0,0,0,224000,32000,192000,192000
20200312,056930,晶豪科台新98購01,1.55,1.73,1.29,1.29,-0.50,-27.93,64000,6,99200,0,0,0,0,0,0,30000,30000,0,0
20200312,056931,智原台新98購01,,,,,0.00,0.00,0,0,0,0,0,0,0,0,0,0,0,0,0
20200312,056932,T50反1元富98購01,1.31,1.68,1.31,1.60,+0.55,52.38,750000,17,1084100,251000,0,251000,0,0,0,137000,613000,-476000,-225000
20200312,056933,國巨元富98購03,0.67,0.67,0.38,0.38,-0.33,-46.48,470000,14,229280,0,0,0,0,0,0,252000,218000,34000,34000
20200312,056934,國巨元富98購04,0.44,0.44,0.25,0.25,-0.25,-50.0,186000,7,73750,0,0,0,0,0,0,140000,46000,94000,94000
20200312,056935,華新科元富98購02,0.79,0.79,0.47,0.48,-0.42,-46.67,390000,25,238790,0,0,0,0,0,0,25000,365000,-340000,-340000
20200312,056936,禾伸堂元富98購01,0.92,0.92,0.87,0.87,-0.03,-3.33,59000,2,54030,0,0,0,0,0,0,5000,54000,-49000,-49000
20200312,056937,智原元富98購01,,,,,0.00,0.00,0,0,0,0,0,0,0,0,0,0,0,0,0
20200312,056938,泰碩元富98購01,1.19,1.19,1.03,1.13,-0.17,-13.08,45000,10,47730,0,0,0,0,0,0,13000,29000,-16000,-16000
20200312,056939,康控元富98購01,1.17,1.23,0.93,0.94,-0.65,-40.88,100000,8,109300,0,0,0,0,0,0,60000,40000,20000,20000
20200312,05693P,滬深2X凱基98售02,1.84,2.05,1.84,2.01,+0.36,21.82,98000,5,187700,0,0,0,0,0,0,43000,55000,-12000,-12000
20200312,056940,嘉聯益元富98購01,,,,,0.00,0.00,0,0,0,0,0,0,0,0,0,0,0,0,0
20200312,056941,台郡元富9B購01,1.90,1.90,1.60,1.63,-0.94,-36.58,81000,10,144160,0,0,0,0,0,0,29000,52000,-23000,-23000
20200312,056942,昇陽半元富98購01,0.77,0.77,0.71,0.71,-0.16,-18.39,172000,14,127970,0,0,0,0,0,0,172000,0,172000,172000
20200312,056943,華通統一99購01,1.15,1.15,1.04,1.08,-0.33,-23.4,255000,55,279300,0,0,0,0,0,0,255000,0,255000,255000
20200312,056944,鴻海統一98購11,0.81,0.81,0.64,0.64,-0.33,-34.02,68000,2,46920,0,0,0,0,0,0,68000,0,68000,68000
20200312,056945,鴻海統一98購12,0.91,0.91,0.76,0.76,-0.35,-31.53,207000,11,167420,0,0,0,0,0,0,167000,45000,122000,122000
20200312,056946,國巨統一98購05,0.69,0.69,0.69,0.69,-0.54,-43.9,80000,1,55200,0,0,0,0,0,0,0,80000,-80000,-80000
20200312,056947,國巨統一9A購01,0.76,0.76,0.75,0.75,-0.33,-30.56,18000,2,13650,0,0,0,0,0,0,18000,0,18000,18000
20200312,056948,旺宏統一9A購01,0.39,0.39,0.39,0.39,0.00,0.00,30000,1,11700,0,0,0,0,0,0,0,30000,-30000,-30000
20200312,056949,義隆統一98購01,0.92,0.92,0.81,0.81,-0.29,-26.36,1738000,24,1571860,0,0,0,0,0,0,1718000,20000,1698000,1698000
20200312,05694P,台積電凱基96售09,2.28,2.72,2.28,2.40,+0.48,25.0,265000,14,623700,0,0,0,0,0,0,120000,164000,-44000,-44000
20200312,056950,亞光統一99購01,0.43,0.43,0.42,0.42,-0.22,-34.38,35000,2,14720,0,0,0,0,0,0,35000,0,35000,35000
20200312,056951,牧德統一99購01,,,,,0.00,0.00,0,0,0,0,0,0,0,0,0,0,0,0,0
20200312,056952,元油2X國泰99購01,,,,,0.00,0.00,0,0,0,0,0,0,0,0,0,0,0,0,0
20200312,056953,智邦富邦98購02,0.44,0.44,0.36,0.36,-0.13,-26.53,86000,22,35250,0,0,0,0,0,0,66000,20000,46000,46000
20200312,056954,聯詠富邦9A購01,0.59,0.59,0.50,0.50,-0.13,-20.63,601000,16,333120,0,0,0,0,0,0,593000,8000,585000,585000
20200312,056955,台灣50永豐98購01,0.30,0.30,0.19,0.19,-0.15,-44.12,2010000,174,428940,0,0,0,0,0,0,0,929000,-929000,-929000
20200312,056956,元油2X永豐99購01,,,,,0.00,0.00,0,0,0,0,0,0,0,0,0,0,0,0,0
20200312,056957,元油2X永豐9A購02,,,,,0.00,0.00,0,0,0,0,0,0,0,0,0,0,0,0,0
20200312,056958,喬山永豐98購01,,,,,0.00,0.00,0,0,0,0,0,0,0,0,0,0,0,0,0
20200312,056959,鴻海永豐98購03,,,,,0.00,0.00,0,0,0,0,0,0,0,0,0,0,0,0,0
20200312,05695P,台積電凱基96售10,0.85,1.35,0.85,1.17,+0.45,62.5,251000,16,261190,0,0,0,0,0,0,89000,174000,-85000,-85000
20200312,056960,光罩永豐98購01,0.78,0.87,0.77,0.84,-0.28,-25.0,292000,5,240800,0,0,0,0,0,0,232000,60000,172000,172000
20200312,056961,凱美永豐98購01,,,,,0.00,0.00,0,0,0,0,0,0,0,0,0,0,0,0,0
20200312,056962,技嘉永豐98購01,0.55,0.55,0.42,0.48,-0.15,-23.81,37000,4,17700,0,0,0,0,0,0,17000,20000,-3000,-3000
20200312,056963,建準永豐98購01,,,,,0.00,0.00,0,0,0,0,0,0,0,0,0,0,0,0,0
20200312,056964,聯發科永豐98購03,0.43,0.43,0.43,0.43,-0.18,-29.51,68000,1,29240,0,0,0,0,0,0,68000,0,68000,68000
20200312,056965,全新永豐98購01,0.31,0.31,0.31,0.31,-0.18,-36.73,7000,1,2170,0,0,0,0,0,0,7000,0,7000,7000
20200312,056966,嘉晶永豐98購01,2.59,2.71,2.22,2.40,-0.59,-19.73,91000,14,224070,0,0,0,0,0,0,49000,42000,7000,7000
20200312,056967,奇鋐永豐98購01,1.14,1.14,1.02,1.02,-0.44,-30.14,230000,5,258680,0,0,0,0,0,0,162000,69000,93000,93000
20200312,056968,揚明光永豐98購02,0.74,0.74,0.53,0.53,-0.47,-47.0,100000,3,63330,0,0,0,0,0,0,50000,50000,0,0
20200312,056969,智易永豐98購01,1.05,1.05,0.74,0.74,-0.57,-43.51,89000,6,75330,0,0,0,0,0,0,37000,52000,-15000,-15000
20200312,05696P,南亞科凱基96售01,0.93,1.33,0.93,1.31,+0.66,101.54,321000,10,371560,0,0,0,0,0,0,221000,100000,121000,121000
20200312,056970,TPK永豐98購01,1.16,1.16,0.82,0.82,-0.52,-38.81,93000,22,104900,0,0,0,0,0,0,82000,11000,71000,71000
20200312,056971,麗豐永豐98購01,0.59,0.59,0.52,0.52,-0.12,-18.75,56000,3,30270,0,0,0,0,0,0,0,56000,-56000,-56000
20200312,056972,祥碩永豐98購02,0.55,0.60,0.45,0.48,-0.15,-23.81,99000,5,49750,0,0,0,0,0,0,19000,90000,-71000,-71000
20200312,056973,T50反1永昌9C購01,1.14,1.47,1.14,1.47,+0.45,44.12,61000,3,76370,0,0,0,0,0,0,0,61000,-61000,-61000
20200312,056974,臻鼎永昌9C購01,,,,,0.00,0.00,0,0,0,0,0,0,0,0,0,0,0,0,0
20200312,056975,元油2X群益98購03,,,,,0.00,0.00,0,0,0,0,0,0,0,0,0,0,0,0,0
20200312,056976,喬山群益98購01,,,,,0.00,0.00,0,0,0,0,0,0,0,0,0,0,0,0,0
20200312,056977,國巨群益9A購01,1.23,1.23,0.86,0.88,-0.74,-45.68,370000,11,399150,0,0,0,0,0,0,300000,70000,230000,230000
20200312,056978,技嘉群益99購01,,,,,0.00,0.00,0,0,0,0,0,0,0,0,0,0,0,0,0
20200312,056979,微星群益98購01,1.19,1.19,1.12,1.12,-0.21,-15.79,37000,4,43180,0,0,0,0,0,0,37000,0,37000,37000
20200312,05697P,友達凱基96售01,1.27,1.35,1.27,1.31,+0.24,22.43,43000,4,56090,0,0,0,0,0,0,26000,17000,9000,9000
20200312,056980,建準群益98購02,0.51,0.52,0.51,0.52,-0.07,-11.86,100000,2,51980,0,0,0,0,0,0,98000,0,98000,98000
20200312,056981,全新群益99購03,,,,,0.00,0.00,0,0,0,0,0,0,0,0,0,0,0,0,0
20200312,056982,華新科群益98購05,0.58,0.58,0.41,0.41,-0.22,-34.92,134000,14,64510,0,0,0,0,0,0,21000,123000,-102000,-102000
20200312,056983,大立光群益99購02,0.83,0.83,0.70,0.70,0.00,0.00,103000,2,84840,0,0,0,0,0,0,0,103000,-103000,-103000
20200312,056984,嘉晶群益98購01,1.77,2.00,1.64,1.64,-0.48,-22.64,389000,19,677620,0,0,0,0,0,0,312000,55000,257000,257000
20200312,056985,智原群益98購03,,,,,0.00,0.00,0,0,0,0,0,0,0,0,0,0,0,0,0
20200312,056986,超眾群益98購03,0.87,0.87,0.72,0.72,-0.40,-35.71,224000,4,176560,0,0,0,0,0,0,148000,102000,46000,46000
20200312,056987,南茂群益98購01,1.05,1.05,0.86,0.86,-0.30,-25.86,957000,32,884070,0,0,0,0,0,0,574000,392000,182000,182000
20200312,056988,聚陽兆豐98購01,0.43,0.43,0.34,0.34,-0.21,-38.18,50000,5,20300,0,0,0,0,0,0,40000,10000,30000,30000
20200312,056989,鴻海兆豐98購02,0.46,0.48,0.39,0.39,-0.20,-33.9,66000,6,28130,0,0,0,0,0,0,46000,20000,26000,26000
20200312,05698P,群創凱基96售01,1.32,1.53,1.32,1.53,+0.41,36.61,51000,4,75120,0,0,0,0,0,0,51000,0,51000,51000
20200312,056990,聯發科兆豐98購01,0.52,0.52,0.40,0.40,-0.36,-47.37,204000,3,102600,0,0,0,0,0,0,104000,104000,0,0
20200312,056991,牧德兆豐98購01,0.67,0.67,0.62,0.62,-0.23,-27.06,645000,4,404170,0,0,0,0,0,0,645000,0,645000,645000
20200312,056992,祥碩兆豐98購01,0.68,0.69,0.51,0.51,-0.21,-29.17,66000,8,42920,0,0,0,0,0,0,66000,0,66000,66000
20200312,056993,GIS兆豐99購01,0.43,0.43,0.31,0.31,-0.25,-44.64,170000,6,65480,0,0,0,0,0,0,75000,95000,-20000,-20000
20200312,056994,緯穎兆豐98購02,0.67,0.67,0.50,0.50,-0.35,-41.18,380000,8,203270,0,0,0,0,0,0,350000,30000,320000,320000
20200312,056995,華新科日盛99購01,0.82,0.82,0.81,0.81,-0.20,-19.8,57000,3,46370,0,0,0,0,0,0,57000,0,57000,57000
20200312,056996,矽力日盛99購01,0.79,0.79,0.79,0.79,-0.28,-26.17,1000,1,790,0,0,0,0,0,0,1000,0,1000,1000
20200312,056997,台灣50康和9A購02,0.36,0.36,0.26,0.28,-0.22,-44.0,168000,11,54880,0,0,0,0,0,0,0,168000,-168000,-168000
20200312,056998,麗豐康和98購01,0.62,0.62,0.62,0.62,-0.10,-13.89,68000,1,42160,0,0,0,0,0,0,68000,0,68000,68000
20200312,056999,元油2X國票98購02,0.03,0.03,0.03,0.03,-0.02,-40.0,200000,5,6000,0,0,0,0,0,0,0,0,0,0
20200312,05699P,茂林凱基96售05,0.74,1.01,0.74,1.00,+0.25,33.33,519000,24,439270,0,0,0,0,0,0,417000,102000,315000,315000
20200312,057000,亞德客國票99購01,1.64,1.64,1.44,1.44,-0.49,-25.39,36000,2,53840,0,0,0,0,0,0,36000,26000,10000,10000
20200312,057001,華邦電國票99購02,,,,,0.00,0.00,0,0,0,0,0,0,0,0,0,0,0,0,0
20200312,057002,友達國票98購01,,,,,0.00,0.00,0,0,0,0,0,0,0,0,0,0,0,0,0
20200312,057003,立積國票98購01,2.77,2.81,2.18,2.22,-0.89,-28.62,70000,6,177750,0,0,0,0,0,0,21000,49000,-28000,-28000
20200312,057004,滬深反中信9A購01,1.20,1.26,1.20,1.25,+0.18,16.82,60000,5,74050,0,0,0,0,0,0,60000,0,60000,60000
20200312,057005,元油2X中信9C購01,0.10,0.11,0.09,0.10,-0.01,-9.09,324000,10,32750,0,0,0,0,0,0,0,314000,-314000,-314000
20200312,057006,國巨中信98購03,0.45,0.45,0.33,0.35,-0.18,-33.96,25000,5,9300,0,0,0,0,0,0,0,25000,-25000,-25000
20200312,057007,奇力新中信98購04,0.19,0.19,0.19,0.19,-0.11,-36.67,20000,1,3800,0,0,0,0,0,0,0,20000,-20000,-20000
20200312,057008,華新科中信99購02,,,,,0.00,0.00,0,0,0,0,0,0,0,0,0,0,0,0,0
20200312,057009,信邦中信99購01,0.54,0.54,0.49,0.51,-0.14,-21.54,82000,5,43220,0,0,0,0,0,0,62000,20000,42000,42000
20200312,05700P,臻鼎凱基96售02,1.60,1.97,1.60,1.85,+0.90,94.74,240000,5,439790,0,0,0,0,0,0,240000,0,240000,240000
20200312,057010,景碩中信98購01,0.68,0.68,0.67,0.67,-0.17,-20.24,35000,2,23750,0,0,0,0,0,0,35000,0,35000,35000
20200312,057011,日月光中信99購01,,,,,0.00,0.00,0,0,0,0,0,0,0,0,0,0,0,0,0
20200312,057012,康控中信98購01,0.51,0.51,0.40,0.40,-0.27,-40.3,30000,3,13500,0,0,0,0,0,0,10000,20000,-10000,-10000
20200312,057013,聯發科麥證98購01,1.54,1.54,1.03,1.03,-0.77,-42.78,199000,18,256140,47000,152000,-105000,0,0,0,47000,152000,-105000,-105000
20200312,057014,元油2X凱基9A購05,,,,,0.00,0.00,0,0,0,0,0,0,0,0,0,0,0,0,0
20200312,057015,元油2X凱基9B購04,,,,,0.00,0.00,0,0,0,0,0,0,0,0,0,0,0,0,0
20200312,057016,中石化凱基9B購01,0.54,0.54,0.54,0.54,-0.21,-28.0,12000,1,6480,0,0,0,0,0,0,12000,0,12000,12000
20200312,057017,和大凱基98購01,,,,,0.00,0.00,0,0,0,0,0,0,0,0,0,0,0,0,0
20200312,057018,亞德客凱基98購01,0.59,0.59,0.53,0.53,-0.13,-19.7,81000,5,46420,0,0,0,0,0,0,81000,0,81000,81000
20200312,057019,台積電凱基98購14,1.39,1.39,0.98,1.21,-0.43,-26.22,1474000,32,1767640,0,0,0,0,0,0,48000,1426000,-1378000,-1378000
20200312,05701P,彩晶凱基96售01,0.84,0.84,0.84,0.84,+0.23,37.7,50000,1,42000,0,0,0,0,0,0,0,50000,-50000,-50000
20200312,057020,台積電凱基99購02,0.72,0.72,0.54,0.68,-0.37,-35.24,119000,7,80610,0,0,0,0,0,0,29000,90000,-61000,-61000
20200312,057021,台積電凱基9A購02,0.78,0.79,0.67,0.75,-0.22,-22.68,584000,8,409210,0,0,0,0,0,0,398000,186000,212000,212000
20200312,057022,智邦凱基98購04,1.19,1.19,0.89,0.91,-0.32,-26.02,207000,14,218240,0,0,0,0,0,0,112000,101000,11000,11000
20200312,057023,美律凱基99購02,0.78,0.78,0.78,0.78,0.00,0.00,10000,1,7800,0,0,0,0,0,0,0,10000,-10000,-10000
20200312,057024,義隆凱基99購01,0.71,0.71,0.71,0.71,-0.26,-26.8,10000,1,7100,0,0,0,0,0,0,10000,0,10000,10000
20200312,057025,華新科凱基98購04,0.11,0.11,0.10,0.10,-0.03,-23.08,40000,4,4300,0,0,0,0,0,0,0,40000,-40000,-40000
20200312,057026,長榮航凱基98購01,0.60,0.60,0.50,0.50,-0.16,-24.24,213000,8,115500,0,0,0,0,0,0,141000,27000,114000,114000
20200312,057027,祥碩凱基98購01,0.42,0.42,0.25,0.30,-0.11,-26.83,383000,36,123800,0,0,0,0,0,0,189000,199000,-10000,-10000
20200312,057028,台郡凱基99購02,1.39,1.39,1.30,1.30,0.00,0.00,4000,4,5380,0,0,0,0,0,0,0,4000,-4000,-4000
20200312,057029,緯穎凱基98購04,,,,,0.00,0.00,0,0,0,0,0,0,0,0,0,0,0,0,0
20200312,05702P,矽創凱基96售02,0.54,0.66,0.54,0.66,0.00,0.00,170000,5,108100,0,0,0,0,0,0,0,170000,-170000,-170000
20200312,057030,滬深反元大9B購01,0.53,0.53,0.53,0.53,0.00,0.00,15000,1,7950,0,0,0,0,0,0,15000,0,15000,15000
20200312,057031,滬深反元大9B購02,0.81,0.81,0.81,0.81,0.00,0.00,60000,2,48600,0,0,0,0,0,0,0,60000,-60000,-60000
20200312,057032,A50反1元大9B購01,0.71,0.71,0.68,0.68,+0.09,15.25,22000,2,15560,0,0,0,0,0,0,20000,2000,18000,18000
20200312,057033,A50反1元大9B購02,0.42,0.42,0.41,0.42,+0.05,13.51,46000,5,19220,0,0,0,0,0,0,5000,41000,-36000,-36000
20200312,057034,道瓊反元大9B購01,1.21,1.42,1.21,1.38,+0.26,23.21,359000,30,471730,0,0,0,0,0,0,169000,190000,-21000,-21000
20200312,057035,元油2X元大9B購03,,,,,0.00,0.00,0,0,0,0,0,0,0,0,0,0,0,0,0
20200312,057036,元油2X元大9B購04,0.03,0.04,0.03,0.04,0.00,0.00,590000,7,21600,0,0,0,0,0,0,0,280000,-280000,-280000
20200312,057037,元油2X元大9B購05,0.03,0.03,0.03,0.03,0.00,0.00,200000,1,6000,0,0,0,0,0,0,0,0,0,0
20200312,057038,元油2X元大9B購06,0.04,0.04,0.03,0.03,0.00,0.00,2445000,16,82330,0,0,0,0,0,0,0,878000,-878000,-878000
20200312,057039,元油2X元大9B購07,0.07,0.07,0.03,0.05,-0.06,-54.55,10250000,106,431250,0,0,0,0,0,0,0,10000000,-10000000,-10000000
20200312,05703P,矽力群益96售03,0.83,0.97,0.83,0.86,+0.13,17.81,186000,18,170960,0,0,0,0,0,0,165000,21000,144000,144000
20200312,057040,國巨元大98購12,2.26,2.26,2.12,2.12,-0.40,-15.87,108000,4,237860,0,0,0,0,0,0,40000,78000,-38000,-38000
20200312,057041,國巨元大99購04,1.53,1.53,1.13,1.13,-0.43,-27.56,537000,15,731290,0,0,0,0,0,0,156000,367000,-211000,-211000
20200312,057042,台積電元大98購10,1.67,1.67,1.16,1.41,-0.53,-27.32,421000,68,602110,20000,0,20000,0,0,0,207000,331000,-124000,-104000
20200312,057043,台積電元大99購02,0.85,0.85,0.55,0.78,-0.17,-17.89,1612000,56,1242190,0,0,0,0,0,0,1082000,992000,90000,90000
20200312,057044,旺宏元大98購08,0.60,0.63,0.60,0.63,-0.48,-43.24,62000,2,37260,0,0,0,0,0,0,60000,2000,58000,58000
20200312,057045,美律元大99購04,1.32,1.32,1.08,1.08,-0.60,-35.71,73000,7,86800,0,0,0,0,0,0,2000,71000,-69000,-69000
20200312,057046,奇力新元大99購03,1.18,1.18,0.88,0.91,-0.48,-34.53,115000,4,108110,0,0,0,0,0,0,25000,90000,-65000,-65000
20200312,057047,華新科元大99購07,0.90,0.90,0.58,0.63,-0.32,-33.68,73000,6,64600,0,0,0,0,0,0,1000,72000,-71000,-71000
20200312,057048,新日興元大98購01,0.81,0.81,0.77,0.77,-0.47,-37.9,88000,4,69990,0,0,0,0,0,0,0,88000,-88000,-88000
20200312,057049,新日興元大98購02,0.88,0.88,0.63,0.63,-0.34,-35.05,97000,4,72750,0,0,0,0,0,0,24000,73000,-49000,-49000
20200312,05704P,矽力群益96售04,0.54,0.60,0.54,0.56,+0.09,19.15,131000,21,74320,0,0,0,0,0,0,75000,56000,19000,19000
20200312,057050,群創元大99購03,,,,,0.00,0.00,0,0,0,0,0,0,0,0,0,0,0,0,0
20200312,057051,群創元大9B購03,,,,,0.00,0.00,0,0,0,0,0,0,0,0,0,0,0,0,0
20200312,057052,華擎元大98購01,0.76,0.85,0.76,0.77,-0.20,-20.62,47000,4,37280,0,0,0,0,0,0,47000,20000,27000,27000
20200312,057053,立積元大98購02,1.78,1.78,1.76,1.76,-0.87,-33.08,15000,2,26600,0,0,0,0,0,0,0,15000,-15000,-15000
20200312,057054,立積元大98購03,1.65,1.65,1.36,1.36,-0.48,-26.09,70000,8,100620,0,0,0,0,0,0,9000,65000,-56000,-56000
20200312,057055,立積元大99購01,1.82,1.82,1.22,1.51,-0.44,-22.56,97000,7,158690,0,0,0,0,0,0,29000,79000,-50000,-50000
20200312,057056,立積元大99購02,2.45,2.45,2.20,2.22,-0.71,-24.23,62000,4,149800,0,0,0,0,0,0,2000,60000,-58000,-58000
20200312,057057,立積元大9A購01,2.28,2.28,2.28,2.28,-0.72,-24.0,20000,1,45600,0,0,0,0,0,0,0,20000,-20000,-20000
20200312,057058,祥碩元大98購04,1.63,1.63,1.19,1.32,-0.31,-19.02,656000,28,907100,0,0,0,0,0,0,613000,604000,9000,9000
20200312,057059,易華電元大99購01,,,,,0.00,0.00,0,0,0,0,0,0,0,0,0,0,0,0,0
20200312,05705P,上証2X永豐96售03,2.93,3.40,2.93,3.40,0.00,0.00,21000,3,64400,0,0,0,0,0,0,20000,1000,19000,19000
20200312,057060,緯穎元大98購05,1.20,1.20,1.00,1.00,-0.50,-33.33,81000,5,84680,0,0,0,0,0,0,6000,75000,-69000,-69000
20200312,057061,華擎國泰9A購01,1.12,1.12,0.95,0.99,-0.20,-16.81,115000,6,114090,0,0,0,0,0,0,115000,80000,35000,35000
20200312,057062,立積國泰99購01,1.14,1.14,1.08,1.08,-0.31,-22.3,12000,2,13560,0,0,0,0,0,0,0,12000,-12000,-12000
20200312,057063,立積國泰9A購01,1.23,1.23,0.90,0.91,-0.37,-28.91,117000,11,118540,0,0,0,0,0,0,81000,34000,47000,47000
20200312,057064,華新科富邦9B購01,0.37,0.38,0.26,0.27,-0.14,-34.15,1512000,70,492090,0,0,0,0,0,0,370000,912000,-542000,-542000
20200312,057065,牧德富邦99購01,,,,,0.00,0.00,0,0,0,0,0,0,0,0,0,0,0,0,0
20200312,057066,緯穎富邦99購01,0.29,0.30,0.27,0.27,0.00,0.00,64000,5,18590,0,0,0,0,0,0,54000,50000,4000,4000
20200312,057067,元油2X永豐9B購01,,,,,0.00,0.00,0,0,0,0,0,0,0,0,0,0,0,0,0
20200312,057068,國巨永豐98購06,0.45,0.45,0.40,0.40,0.00,0.00,110000,2,44500,0,0,0,0,0,0,110000,0,110000,110000
20200312,057069,台積電永豐98購02,0.33,0.33,0.21,0.21,-0.21,-50.0,154000,5,39460,0,0,0,0,0,0,97000,57000,40000,40000
20200312,05706P,TPK永豐96售02,2.92,2.92,2.92,2.92,0.00,0.00,10000,1,29200,0,0,0,0,0,0,0,10000,-10000,-10000
20200312,057070,美律永豐98購02,,,,,0.00,0.00,0,0,0,0,0,0,0,0,0,0,0,0,0
20200312,057071,華擎永豐98購02,0.43,0.43,0.35,0.37,-0.08,-17.78,418000,8,154410,0,0,0,0,0,0,15000,403000,-388000,-388000
20200312,057072,日月光永豐98購01,,,,,0.00,0.00,0,0,0,0,0,0,0,0,0,0,0,0,0
20200312,057073,康控永豐98購01,0.72,0.72,0.58,0.58,-0.28,-32.56,208000,12,133450,0,0,0,0,0,0,82000,126000,-44000,-44000
20200312,057074,立積永豐98購01,0.69,0.69,0.57,0.59,-0.21,-26.25,19000,6,12320,0,0,0,0,0,0,11000,8000,3000,3000
20200312,057075,嘉聯益永豐98購01,0.96,0.96,0.83,0.87,-0.39,-30.95,60000,4,54700,0,0,0,0,0,0,0,60000,-60000,-60000
20200312,057076,緯穎永豐98購01,,,,,0.00,0.00,0,0,0,0,0,0,0,0,0,0,0,0,0
20200312,057077,國巨統一98購06,,,,,0.00,0.00,0,0,0,0,0,0,0,0,0,0,0,0,0
20200312,057078,國巨統一9A購02,0.70,0.70,0.49,0.49,-0.24,-32.88,745000,48,435220,0,0,0,0,0,0,322000,423000,-101000,-101000
20200312,057079,台積電統一9A購02,0.57,0.57,0.48,0.56,-0.15,-21.13,68000,4,37910,0,0,0,0,0,0,0,68000,-68000,-68000
20200312,05707P,中磊永豐96售01,1.74,1.97,1.74,1.97,+0.37,23.12,102000,12,189250,0,0,0,0,0,0,1000,101000,-100000,-100000
20200312,057080,華新科統一99購02,0.44,0.45,0.33,0.35,-0.14,-28.57,80000,6,30900,0,0,0,0,0,0,30000,50000,-20000,-20000
20200312,057081,大立光統一98購07,,,,,0.00,0.00,0,0,0,0,0,0,0,0,0,0,0,0,0
20200312,057082,玉晶光統一9A購04,,,,,0.00,0.00,0,0,0,0,0,0,0,0,0,0,0,0,0
20200312,057083,立積統一98購01,1.66,1.66,1.16,1.16,-0.50,-30.12,50000,5,71300,0,0,0,0,0,0,30000,20000,10000,10000
20200312,057084,立積統一9B購01,1.21,1.23,1.02,1.02,-0.30,-22.73,127000,8,142360,0,0,0,0,0,0,25000,102000,-77000,-77000
20200312,057085,立積統一9B購02,0.79,0.79,0.61,0.62,-0.20,-24.39,175000,15,120870,0,0,0,0,0,0,99000,76000,23000,23000
20200312,057086,立積統一9C購01,1.70,1.70,1.64,1.64,-0.53,-24.42,2000,2,3340,0,0,0,0,0,0,0,2000,-2000,-2000
20200312,057087,台郡統一99購01,1.22,1.22,1.07,1.07,-0.34,-24.11,15000,3,16500,0,0,0,0,0,0,10000,5000,5000,5000
20200312,057088,上銀元富98購01,0.34,0.34,0.19,0.21,-0.27,-56.25,80000,3,21600,0,0,0,0,0,0,80000,0,80000,80000
20200312,057089,奇力新元富98購01,0.32,0.32,0.22,0.22,-0.11,-33.33,90000,9,27020,0,0,0,0,0,0,80000,10000,70000,70000
20200312,05708P,奇力新國票97售04,1.39,1.76,1.39,1.72,+0.38,28.36,168000,13,259600,0,0,0,0,0,0,58000,110000,-52000,-52000
20200312,057090,奇力新元富98購02,0.15,0.15,0.15,0.15,0.00,0.00,30000,1,4500,0,0,0,0,0,0,30000,0,30000,30000
20200312,057091,華新科元富9A購01,0.93,0.93,0.62,0.69,-0.47,-40.52,300000,9,254500,0,0,0,0,0,0,60000,240000,-180000,-180000
20200312,057092,健策元富98購01,0.48,0.48,0.43,0.43,-0.15,-25.86,50000,4,22800,0,0,0,0,0,0,20000,30000,-10000,-10000
20200312,057093,臻鼎元富98購02,1.32,1.32,0.88,0.88,-0.52,-37.14,723000,29,716780,0,0,0,0,0,0,144000,579000,-435000,-435000
20200312,057094,祥碩元富98購01,0.90,0.99,0.80,0.89,-0.21,-19.09,4660000,46,4173040,0,0,0,0,0,0,40000,4620000,-4580000,-4580000
20200312,057095,祥碩元富98購02,0.61,0.61,0.44,0.49,-0.13,-20.97,1081000,40,590700,0,0,0,0,0,0,845000,213000,632000,632000
20200312,057096,緯穎元富98購01,0.86,0.86,0.86,0.86,0.00,0.00,10000,1,8600,0,0,0,0,0,0,0,10000,-10000,-10000
20200312,057097,致新元富98購01,2.07,2.07,1.67,1.74,-0.65,-27.2,752000,15,1394250,0,0,0,0,0,0,583000,169000,414000,414000
20200312,057098,新光金台新98購01,,,,,0.00,0.00,0,0,0,0,0,0,0,0,0,0,0,0,0
20200312,057099,元油2X中信9B購03,0.36,0.37,0.28,0.28,-0.17,-37.78,605000,10,209150,0,0,0,0,0,0,600000,5000,595000,595000
20200312,05709P,大立光國票97售01,,,,,0.00,0.00,0,0,0,0,0,0,0,0,0,0,0,0,0
20200312,057100,國巨中信9A購02,,,,,0.00,0.00,0,0,0,0,0,0,0,0,0,0,0,0,0
20200312,057101,新光金中信9A購01,,,,,0.00,0.00,0,0,0,0,0,0,0,0,0,0,0,0,0
20200312,057102,亞光中信9A購01,,,,,0.00,0.00,0,0,0,0,0,0,0,0,0,0,0,0,0
20200312,057103,禾伸堂中信9A購01,0.70,0.73,0.59,0.73,+0.06,8.96,454000,6,294260,0,0,0,0,0,0,444000,10000,434000,434000
20200312,057104,康友中信99購01,0.65,0.65,0.49,0.50,-0.22,-30.56,203000,10,117790,0,0,0,0,0,0,123000,80000,43000,43000
20200312,057105,致茂群益9A購01,0.73,0.73,0.69,0.73,-0.25,-25.51,317000,12,229310,0,0,0,0,0,0,296000,11000,285000,285000
20200312,057106,美律群益98購03,0.76,0.76,0.51,0.51,-0.47,-47.96,52000,5,31040,0,0,0,0,0,0,0,52000,-52000,-52000
20200312,057107,華新科群益98購06,0.47,0.47,0.33,0.33,-0.28,-45.9,198000,5,79060,0,0,0,0,0,0,0,198000,-198000,-198000
20200312,057108,潤泰全群益98購01,0.91,0.91,0.81,0.83,-0.30,-26.55,183000,10,159940,0,0,0,0,0,0,25000,158000,-133000,-133000
20200312,057109,信邦群益98購01,0.78,0.79,0.76,0.79,-0.17,-17.71,284000,5,216180,0,0,0,0,0,0,284000,0,284000,284000
20200312,05710P,禾伸堂國票97售02,1.50,1.75,1.48,1.56,0.00,0.00,421000,18,678180,0,0,0,0,0,0,0,421000,-421000,-421000
20200312,057110,立積群益98購01,1.27,1.27,0.90,0.92,-0.35,-27.56,381000,19,422700,0,0,0,0,0,0,279000,97000,182000,182000
20200312,057111,立積群益98購02,1.97,1.97,1.48,1.48,-0.60,-28.85,75000,6,138450,0,0,0,0,0,0,45000,30000,15000,15000
20200312,057112,立積群益99購01,2.04,2.04,1.51,1.51,-0.66,-30.41,205000,10,385660,0,0,0,0,0,0,183000,22000,161000,161000
20200312,057113,祥碩群益98購01,1.09,1.25,0.95,0.98,-0.27,-21.6,160000,13,171500,0,0,0,0,0,0,80000,100000,-20000,-20000
20200312,057114,台虹群益98購01,1.38,1.38,1.11,1.13,-0.38,-25.17,108000,10,133540,0,0,0,0,0,0,76000,32000,44000,44000
20200312,057115,元油2X日盛9A購01,0.07,0.08,0.06,0.08,0.00,0.00,81000,4,6360,0,0,0,0,0,0,0,70000,-70000,-70000
20200312,057116,鴻海日盛9A購01,1.36,1.37,1.09,1.10,-0.45,-29.03,185000,22,242110,0,0,0,0,0,0,174000,26000,148000,148000
20200312,057117,開發金日盛9B購01,0.48,0.48,0.46,0.47,0.00,0.00,26000,9,12180,0,0,0,0,0,0,10000,16000,-6000,-6000
20200312,057118,欣興日盛9A購01,1.30,1.30,0.97,0.97,-0.88,-47.57,58000,2,58900,0,0,0,0,0,0,8000,50000,-42000,-42000
20200312,057119,微星康和98購01,0.53,0.53,0.47,0.47,-0.18,-27.69,113000,5,56510,0,0,0,0,0,0,35000,78000,-43000,-43000
20200312,05711P,茂林國票97售03,1.46,1.85,1.46,1.85,+0.36,24.16,87000,8,136820,0,0,0,0,0,0,71000,6000,65000,65000
20200312,057120,茂林康和98購01,0.37,0.37,0.29,0.29,-0.14,-32.56,288000,4,90560,0,0,0,0,0,0,68000,220000,-152000,-152000
20200312,057121,立積康和98購01,0.86,0.86,0.64,0.64,-0.25,-28.09,359000,8,277680,0,0,0,0,0,0,289000,70000,219000,219000
20200312,057122,元油2X凱基9B購05,,,,,0.00,0.00,0,0,0,0,0,0,0,0,0,0,0,0,0
20200312,057123,上銀凱基98購05,,,,,0.00,0.00,0,0,0,0,0,0,0,0,0,0,0,0,0
20200312,057124,為升凱基98購02,0.37,0.37,0.24,0.25,-0.21,-45.65,1057000,21,284830,0,0,0,0,0,0,419000,658000,-239000,-239000
20200312,057125,國巨凱基98購12,,,,,0.00,0.00,0,0,0,0,0,0,0,0,0,0,0,0,0
20200312,057126,台積電凱基99購03,1.20,1.20,0.86,1.06,-0.46,-30.26,2612000,28,2701580,0,0,0,0,0,0,0,2612000,-2612000,-2612000
20200312,057127,旺宏凱基98購09,0.29,0.29,0.29,0.29,0.00,0.00,10000,1,2900,0,0,0,0,0,0,0,10000,-10000,-10000
20200312,057128,台光電凱基98購03,1.13,1.13,0.84,0.84,-0.45,-34.88,41000,4,42040,0,0,0,0,0,0,20000,21000,-1000,-1000
20200312,057129,聯發科凱基99購03,0.98,0.98,0.78,0.78,-0.62,-44.29,136000,2,119680,0,0,0,0,0,0,68000,68000,0,0
20200312,05712P,友達統一97售03,1.05,1.32,1.05,1.31,+0.38,40.86,276000,15,317220,0,0,0,0,0,0,120000,156000,-36000,-36000
20200312,057130,全新凱基98購03,,,,,0.00,0.00,0,0,0,0,0,0,0,0,0,0,0,0,0
20200312,057131,奇力新凱基98購05,0.44,0.44,0.40,0.41,-0.11,-21.15,45000,8,19050,0,0,0,0,0,0,45000,0,45000,45000
20200312,057132,華新科凱基98購05,,,,,0.00,0.00,0,0,0,0,0,0,0,0,0,0,0,0,0
20200312,057133,京鼎凱基98購02,0.59,0.59,0.41,0.41,-0.27,-39.71,298000,8,138520,0,0,0,0,0,0,68000,230000,-162000,-162000
20200312,057134,茂林凱基98購02,,,,,0.00,0.00,0,0,0,0,0,0,0,0,0,0,0,0,0
20200312,057135,立積凱基98購01,1.84,1.84,0.88,1.31,-0.57,-30.32,131000,10,206260,0,0,0,0,0,0,102000,18000,84000,84000
20200312,057136,立積凱基98購02,2.42,2.42,2.42,2.42,-0.27,-10.04,10000,1,24200,0,0,0,0,0,0,10000,0,10000,10000
20200312,057137,鈺齊凱基98購01,,,,,0.00,0.00,0,0,0,0,0,0,0,0,0,0,0,0,0
20200312,057138,亞德客兆豐98購01,,,,,0.00,0.00,0,0,0,0,0,0,0,0,0,0,0,0,0
20200312,057139,華新科兆豐98購02,0.28,0.28,0.19,0.19,-0.14,-42.42,102000,6,23520,0,0,0,0,0,0,60000,42000,18000,18000
20200312,05713P,大立光統一96售05,1.54,1.71,1.54,1.71,+0.56,48.7,22000,4,34610,0,0,0,0,0,0,12000,10000,2000,2000
20200312,057140,宏達電兆豐98購01,0.71,0.71,0.71,0.71,-0.52,-42.28,20000,1,14200,0,0,0,0,0,0,20000,0,20000,20000
20200312,057141,嘉聯益兆豐99購01,0.82,0.84,0.68,0.68,-0.29,-29.9,123000,5,101040,0,0,0,0,0,0,103000,20000,83000,83000
20200312,057142,力成兆豐98購01,0.26,0.26,0.23,0.24,-0.11,-31.43,360000,6,88700,0,0,0,0,0,0,260000,100000,160000,160000
20200312,057143,台郡兆豐98購01,0.68,0.72,0.47,0.61,-0.32,-34.41,827000,25,541070,0,0,0,0,0,0,590000,225000,365000,365000
20200312,057144,南電兆豐98購01,1.50,1.50,1.50,1.50,-0.76,-33.63,10000,1,15000,0,0,0,0,0,0,0,10000,-10000,-10000
20200312,057145,上銀國票98購03,0.83,0.83,0.83,0.83,0.00,0.00,5000,1,4150,0,0,0,0,0,0,0,5000,-5000,-5000
20200312,057146,技嘉國票98購01,1.24,1.25,1.01,1.07,-0.27,-20.15,111000,11,124210,0,0,0,0,0,0,104000,98000,6000,6000
20200312,057147,新日興國票99購01,1.40,1.40,1.40,1.40,-0.09,-6.04,17000,1,23800,0,0,0,0,0,0,0,17000,-17000,-17000
20200312,057148,玉晶光國票99購04,1.67,1.67,1.25,1.26,-0.84,-40.0,28000,8,41620,0,0,0,0,0,0,6000,28000,-22000,-22000
20200312,057149,京鼎國票99購02,0.69,0.69,0.69,0.69,-0.21,-23.33,398000,2,274620,0,0,0,0,0,0,0,398000,-398000,-398000
20200312,05714P,群創統一97售03,1.10,1.36,1.10,1.31,+0.31,31.0,274000,18,329120,0,0,0,0,0,0,131000,143000,-12000,-12000
20200312,057150,貿聯國票99購02,0.69,0.70,0.66,0.66,-0.22,-25.0,44000,6,29900,0,0,0,0,0,0,24000,20000,4000,4000
20200312,057151,易華電國票99購01,1.94,1.94,1.42,1.42,-0.77,-35.16,16000,3,29300,0,0,0,0,0,0,10000,6000,4000,4000
20200312,057152,緯穎國票99購03,1.45,1.45,1.45,1.45,-0.54,-27.14,17000,1,24650,0,0,0,0,0,0,0,17000,-17000,-17000
20200312,057153,祥碩國泰99購01,1.22,1.22,1.22,1.22,-0.12,-8.96,10000,1,12200,0,0,0,0,0,0,10000,10000,0,0
20200312,057154,易華電國泰99購01,1.13,1.13,0.80,0.90,-0.34,-27.42,87000,5,81110,0,0,0,0,0,0,37000,50000,-13000,-13000
20200312,057155,元油2X富邦9B購02,0.10,0.10,0.10,0.10,-0.01,-9.09,10000,1,1000,0,0,0,0,0,0,0,10000,-10000,-10000
20200312,057156,元油2X富邦9C購01,0.11,0.11,0.09,0.10,0.00,0.00,170000,17,17100,0,0,0,0,0,0,0,120000,-120000,-120000
20200312,057157,群創富邦98購02,,,,,0.00,0.00,0,0,0,0,0,0,0,0,0,0,0,0,0
20200312,057158,義隆永豐99購01,0.63,0.63,0.56,0.56,-0.20,-26.32,370000,6,217910,0,0,0,0,0,0,360000,10000,350000,350000
20200312,057159,晶技永豐98購01,2.66,2.66,1.91,1.92,-0.64,-25.0,69000,10,161450,0,0,0,0,0,0,46000,42000,4000,4000
20200312,05715P,創意元富96售05,1.72,2.07,1.72,2.01,+0.40,24.84,137000,12,251880,0,0,0,0,0,0,45000,92000,-47000,-47000
20200312,057160,佐登永豐98購02,0.36,0.36,0.36,0.36,0.00,0.00,50000,1,18000,0,0,0,0,0,0,50000,0,50000,50000
20200312,057161,亞德客元大98購02,0.93,0.93,0.88,0.88,-0.51,-36.69,186000,3,168080,0,0,0,0,0,0,0,186000,-186000,-186000
20200312,057162,上銀元大98購03,1.40,1.40,1.06,1.06,-0.65,-38.01,111000,7,132440,0,0,0,0,0,0,111000,0,111000,111000
20200312,057163,上銀元大98購04,0.88,0.88,0.80,0.80,-0.29,-26.61,78000,2,63200,0,0,0,0,0,0,10000,68000,-58000,-58000
20200312,057164,國巨元大98購14,1.95,1.95,1.77,1.77,-0.26,-12.81,70000,3,133400,0,0,0,0,0,0,20000,60000,-40000,-40000
20200312,057165,國巨元大99購05,2.45,2.48,1.89,1.89,-1.22,-39.23,68000,5,148350,0,0,0,0,0,0,37000,51000,-14000,-14000
20200312,057166,國巨元大99購06,1.50,1.50,1.16,1.16,-0.42,-26.58,89000,17,120150,0,0,0,0,0,0,71000,16000,55000,55000
20200312,057167,台積電元大99購03,1.56,1.56,1.21,1.42,-0.32,-18.39,932000,43,1301410,0,0,0,0,0,0,341000,860000,-519000,-519000
20200312,057168,旺宏元大99購03,,,,,0.00,0.00,0,0,0,0,0,0,0,0,0,0,0,0,0
20200312,057169,微星元大98購01,1.51,1.51,1.40,1.40,-0.34,-19.54,189000,8,271000,0,0,0,0,0,0,121000,68000,53000,53000
20200312,05716P,T50反1元大98售03,,,,,0.00,0.00,0,0,0,0,0,0,0,0,0,0,0,0,0
20200312,057170,瑞昱元大98購01,1.30,1.30,0.98,1.03,-0.45,-30.41,152000,7,178780,0,0,0,0,0,0,34000,92000,-58000,-58000
20200312,057171,台光電元大9B購01,1.68,1.68,1.29,1.29,-0.45,-25.86,194000,20,299950,0,0,0,0,0,0,134000,73000,61000,61000
20200312,057172,南亞科元大98購03,0.85,0.85,0.85,0.85,0.00,0.00,68000,1,57800,0,0,0,0,0,0,0,68000,-68000,-68000
20200312,057173,南亞科元大98購04,0.68,0.68,0.54,0.54,-0.56,-50.91,88000,2,57040,0,0,0,0,0,0,20000,68000,-48000,-48000
20200312,057174,南亞科元大98購05,0.95,0.95,0.95,0.95,-0.55,-36.67,68000,1,64600,0,0,0,0,0,0,0,68000,-68000,-68000
20200312,057175,美律元大98購03,0.74,0.74,0.51,0.51,-0.31,-37.8,443000,18,280690,0,0,0,0,0,0,227000,216000,11000,11000
20200312,057176,全新元大99購02,0.95,0.95,0.79,0.79,-0.29,-26.85,181000,8,151250,0,0,0,0,0,0,121000,60000,61000,61000
20200312,057177,奇力新元大99購04,0.52,0.52,0.37,0.37,-0.22,-37.29,412000,19,195200,0,0,0,0,0,0,407000,5000,402000,402000
20200312,057178,可成元大98購03,1.40,1.40,1.40,1.40,-0.45,-24.32,25000,1,35000,0,0,0,0,0,0,25000,25000,0,0
20200312,057179,可成元大98購04,1.60,1.62,1.34,1.34,-0.59,-30.57,180000,5,262350,0,0,0,0,0,0,25000,180000,-155000,-155000
20200312,05717P,鴻海元大97售07,3.57,3.73,3.49,3.73,0.00,0.00,43000,7,156090,0,0,0,0,0,0,13000,30000,-17000,-17000
20200312,057180,華新科元大99購08,0.53,0.58,0.53,0.57,-0.19,-25.0,203000,5,112340,0,0,0,0,0,0,153000,50000,103000,103000
20200312,057181,亞光元大98購02,1.86,1.86,1.58,1.58,-0.68,-30.09,32000,6,56900,0,0,0,0,0,0,24000,32000,-8000,-8000
20200312,057182,禾伸堂元大99購02,0.65,0.69,0.58,0.69,+0.05,7.81,131000,12,85970,0,0,0,0,0,0,74000,117000,-43000,-43000
20200312,057183,玉晶光元大99購07,0.74,0.74,0.62,0.63,-0.27,-30.0,284000,10,187000,0,0,0,0,0,0,52000,232000,-180000,-180000
20200312,057184,群創元大98購05,,,,,0.00,0.00,0,0,0,0,0,0,0,0,0,0,0,0,0
20200312,057185,群創元大98購06,0.18,0.18,0.16,0.16,-0.17,-51.52,142000,2,24720,0,0,0,0,0,0,42000,100000,-58000,-58000
20200312,057186,群創元大99購04,,,,,0.00,0.00,0,0,0,0,0,0,0,0,0,0,0,0,0
20200312,057187,群創元大9B購04,,,,,0.00,0.00,0,0,0,0,0,0,0,0,0,0,0,0,0
20200312,057188,佐登元大98購01,1.44,1.44,1.21,1.21,-0.50,-29.24,49000,3,67270,0,0,0,0,0,0,31000,18000,13000,13000
20200312,057189,康控元大98購02,1.44,1.44,1.44,1.44,-0.48,-25.0,25000,1,36000,0,0,0,0,0,0,25000,25000,0,0
20200312,05718P,國巨元大96售09,1.32,1.87,1.32,1.87,+0.57,43.85,390000,33,626750,0,0,0,0,0,0,312000,199000,113000,113000
20200312,057190,立積元大9A購02,1.38,1.39,1.15,1.15,-0.34,-22.82,138000,13,171400,0,0,0,0,0,0,27000,120000,-93000,-93000
20200312,057191,祥碩元大98購05,1.78,1.80,1.35,1.54,-0.21,-12.0,353000,35,543650,0,0,0,0,0,0,223000,275000,-52000,-52000
20200312,057192,力成元大98購01,0.32,0.32,0.23,0.23,-0.28,-54.9,249000,8,61860,0,0,0,0,0,0,199000,50000,149000,149000
20200312,057193,力成元大98購02,0.41,0.41,0.28,0.30,-0.15,-33.33,225000,9,71500,0,0,0,0,0,0,100000,125000,-25000,-25000
20200312,057194,南電元大98購01,3.84,3.84,3.84,3.84,-1.11,-22.42,5000,1,19200,0,0,0,0,0,0,0,5000,-5000,-5000
20200312,057195,南茂元大98購01,1.70,1.70,1.41,1.42,-0.47,-24.87,292000,36,454400,0,0,0,0,0,0,233000,213000,20000,20000
20200312,057196,茂林台新98購01,,,,,0.00,0.00,0,0,0,0,0,0,0,0,0,0,0,0,0
20200312,057197,立積台新98購01,0.97,0.99,0.76,0.76,-0.33,-30.28,199000,16,168760,0,0,0,0,0,0,101000,98000,3000,3000
20200312,057198,智伸科統一9B購01,0.38,0.38,0.30,0.31,-0.13,-29.55,315000,11,107610,0,0,0,0,0,0,54000,261000,-207000,-207000
20200312,057199,台達電元富02購01,0.88,0.91,0.70,0.70,-0.25,-26.32,291000,11,252380,0,0,0,0,0,0,239000,52000,187000,187000
20200312,05719P,可成元大96售03,3.58,4.44,3.58,4.44,+1.24,38.75,103000,4,425560,0,0,0,0,0,0,27000,76000,-49000,-49000
20200312,057200,技嘉元富98購01,1.86,1.95,1.56,1.64,-0.48,-22.64,113000,10,206250,0,0,0,0,0,0,72000,41000,31000,31000
20200312,057201,華擎元富98購01,1.07,1.19,1.03,1.05,-0.45,-30.0,207000,10,223700,0,0,0,0,0,0,100000,107000,-7000,-7000
20200312,057202,TPK元富98購02,0.90,0.90,0.67,0.67,-0.41,-37.96,162000,32,137340,0,0,0,0,0,0,92000,70000,22000,22000
20200312,057203,麗豐元富98購02,0.60,0.60,0.57,0.57,-0.16,-21.92,80000,5,46300,0,0,0,0,0,0,50000,30000,20000,20000
20200312,057204,利勤元富98購01,1.00,1.00,0.83,0.83,0.00,0.00,78000,7,74100,0,0,0,0,0,0,0,78000,-78000,-78000
20200312,057205,元翎元富98購01,1.25,1.28,1.01,1.01,-0.62,-38.04,135000,9,156050,0,0,0,0,0,0,85000,50000,35000,35000
20200312,057206,立積元富98購01,2.15,2.15,1.83,1.83,-0.54,-22.78,77000,7,161170,0,0,0,0,0,0,37000,40000,-3000,-3000
20200312,057207,立積元富98購02,2.86,2.93,2.25,2.25,-0.97,-30.12,25000,5,69550,0,0,0,0,0,0,15000,10000,5000,5000
20200312,057208,上海銀元富98購01,0.94,0.94,0.75,0.76,-0.34,-30.91,310000,10,262900,0,0,0,0,0,0,70000,240000,-170000,-170000
20200312,057209,元油2X第一98購01,0.03,0.04,0.03,0.04,0.00,0.00,228000,13,8820,0,0,0,0,0,0,0,90000,-90000,-90000
20200312,05720P,可成中信98售01,1.33,1.42,1.33,1.42,+0.28,24.56,27000,3,37140,0,0,0,0,0,0,15000,12000,3000,3000
20200312,057210,T50反1群益98購01,1.23,1.23,1.13,1.13,+0.38,50.67,190000,15,220480,0,0,0,0,0,0,50000,140000,-90000,-90000
20200312,057211,鴻海群益98購05,1.50,1.50,1.09,1.18,-0.65,-35.52,226000,22,297720,0,0,0,0,0,0,126000,118000,8000,8000
20200312,057212,台積電群益98購03,0.36,0.37,0.31,0.31,-0.12,-27.91,100000,8,34400,0,0,0,0,0,0,30000,60000,-30000,-30000
20200312,057213,華邦電群益98購01,0.66,0.67,0.39,0.39,-0.45,-53.57,342000,11,164980,0,0,0,0,0,0,53000,289000,-236000,-236000
20200312,057214,瑞昱群益98購01,0.52,0.52,0.37,0.37,-0.32,-46.38,270000,6,119540,0,0,0,0,0,0,167000,103000,64000,64000
20200312,057215,友達群益98購03,0.09,0.09,0.07,0.07,-0.09,-56.25,609000,3,42830,0,0,0,0,0,0,599000,10000,589000,589000
20200312,057216,聯發科群益99購01,0.58,0.58,0.54,0.54,-0.33,-37.93,14000,2,7960,0,0,0,0,0,0,0,14000,-14000,-14000
20200312,057217,奇力新群益99購01,0.31,0.31,0.31,0.31,-0.15,-32.61,98000,1,30380,0,0,0,0,0,0,98000,0,98000,98000
20200312,057218,可成群益99購03,1.51,1.51,1.28,1.28,-0.60,-31.91,206000,3,308760,0,0,0,0,0,0,196000,10000,186000,186000
20200312,057219,群創群益98購10,,,,,0.00,0.00,0,0,0,0,0,0,0,0,0,0,0,0,0
20200312,05721P,全新群益98售02,1.50,1.63,1.50,1.61,+0.21,15.0,26000,5,41690,0,0,0,0,0,0,6000,20000,-14000,-14000
20200312,057220,鈺齊群益98購01,0.45,0.45,0.35,0.36,-0.17,-32.08,243000,6,96050,0,0,0,0,0,0,123000,120000,3000,3000
20200312,057221,華通國票98購03,1.89,1.94,1.35,1.36,-1.36,-50.0,68000,14,110060,0,0,0,0,0,0,68000,0,68000,68000
20200312,057222,鴻海國票99購04,1.29,1.32,1.02,1.08,-0.51,-32.08,100000,17,125590,0,0,0,0,0,0,100000,20000,80000,80000
20200312,057223,富邦金日盛99購01,0.58,0.63,0.47,0.48,-0.23,-32.39,256000,16,138230,0,0,0,0,0,0,90000,166000,-76000,-76000
20200312,057224,和碩日盛9A購01,1.41,1.45,1.17,1.28,-0.52,-28.89,197000,19,271650,0,0,0,0,0,0,177000,20000,157000,157000
20200312,057225,華新凱基98購01,0.34,0.34,0.34,0.34,0.00,0.00,12000,1,4080,0,0,0,0,0,0,12000,0,12000,12000
20200312,057226,上銀凱基98購06,0.74,0.74,0.59,0.59,0.00,0.00,189000,2,124860,0,0,0,0,0,0,189000,0,189000,189000
20200312,057227,台積電凱基98購15,0.66,0.66,0.50,0.56,-0.64,-53.33,35000,5,19060,0,0,0,0,0,0,1000,34000,-33000,-33000
20200312,057228,友達凱基9B購01,,,,,0.00,0.00,0,0,0,0,0,0,0,0,0,0,0,0,0
20200312,057229,友達凱基9B購02,,,,,0.00,0.00,0,0,0,0,0,0,0,0,0,0,0,0,0
20200312,05722P,玉晶光國票97售03,2.00,2.07,1.73,2.07,+0.46,28.57,376000,47,726370,0,0,0,0,0,0,303000,63000,240000,240000
20200312,057230,建準凱基98購02,1.04,1.09,1.04,1.09,-0.16,-12.8,18000,6,19420,0,0,0,0,0,0,18000,0,18000,18000
20200312,057231,美律凱基98購05,0.81,0.81,0.60,0.67,-0.27,-28.72,267000,15,187320,0,0,0,0,0,0,237000,30000,207000,207000
20200312,057232,京元電凱基98購02,0.85,0.85,0.72,0.72,-0.48,-40.0,20000,2,15700,0,0,0,0,0,0,0,20000,-20000,-20000
20200312,057233,聯發科凱基98購14,0.88,0.89,0.62,0.62,-0.47,-43.12,74000,7,57490,0,0,0,0,0,0,20000,54000,-34000,-34000
20200312,057234,宏達電凱基98購05,1.92,1.92,1.44,1.49,-0.53,-26.24,90000,10,157650,0,0,0,0,0,0,65000,35000,30000,30000
20200312,057235,亞光凱基98購04,,,,,0.00,0.00,0,0,0,0,0,0,0,0,0,0,0,0,0
20200312,057236,聯詠凱基98購03,0.78,0.78,0.56,0.56,-0.48,-46.15,44000,2,33440,0,0,0,0,0,0,0,44000,-44000,-44000
20200312,057237,群創凱基9B購02,,,,,0.00,0.00,0,0,0,0,0,0,0,0,0,0,0,0,0
20200312,057238,群創凱基9B購03,0.15,0.15,0.15,0.15,-0.04,-21.05,10000,1,1500,0,0,0,0,0,0,0,10000,-10000,-10000
20200312,057239,貿聯凱基98購05,1.24,1.24,1.06,1.06,-0.49,-31.61,72000,24,85480,0,0,0,0,0,0,72000,0,72000,72000
20200312,05723P,華通永豐96售03,2.02,2.41,2.02,2.41,+0.68,39.31,43000,6,93170,0,0,0,0,0,0,10000,33000,-23000,-23000
20200312,057240,茂林凱基9A購01,0.38,0.38,0.31,0.31,-0.15,-32.61,103000,4,34040,0,0,0,0,0,0,80000,23000,57000,57000
20200312,057241,超眾凱基99購02,2.05,2.05,1.92,1.92,-0.20,-9.43,13000,2,26260,0,0,0,0,0,0,13000,0,13000,13000
20200312,057242,台郡凱基98購05,,,,,0.00,0.00,0,0,0,0,0,0,0,0,0,0,0,0,0
20200312,057243,樺漢凱基99購01,,,,,0.00,0.00,0,0,0,0,0,0,0,0,0,0,0,0,0
20200312,057244,鈺齊凱基99購01,0.46,0.46,0.37,0.37,-0.20,-35.09,49000,3,21290,0,0,0,0,0,0,49000,0,49000,49000
20200312,057245,福懋科台新98購01,0.77,0.77,0.77,0.77,0.00,0.00,10000,1,7700,0,0,0,0,0,0,10000,0,10000,10000
20200312,057246,元油2X統一99購01,,,,,0.00,0.00,0,0,0,0,0,0,0,0,0,0,0,0,0
20200312,057247,元油2X統一9A購01,0.05,0.05,0.04,0.04,-0.02,-33.33,20000,2,900,0,0,0,0,0,0,0,20000,-20000,-20000
20200312,057248,台積電統一98購08,0.38,0.58,0.38,0.53,-0.17,-24.29,1331000,17,703010,0,0,0,0,0,0,1070000,205000,865000,865000
20200312,057249,華邦電統一9A購01,,,,,0.00,0.00,0,0,0,0,0,0,0,0,0,0,0,0,0
20200312,05724P,致茂永豐96售01,1.12,1.24,1.12,1.24,+0.26,26.53,80000,7,95600,0,0,0,0,0,0,30000,50000,-20000,-20000
20200312,057250,大立光統一98購08,0.75,0.75,0.75,0.75,0.00,0.00,48000,1,36000,0,0,0,0,0,0,0,48000,-48000,-48000
20200312,057251,泰鼎統一98購02,2.38,2.38,1.82,1.89,-1.04,-35.49,39000,3,82250,0,0,0,0,0,0,21000,18000,3000,3000
20200312,057252,牧德元富98購01,,,,,0.00,0.00,0,0,0,0,0,0,0,0,0,0,0,0,0
20200312,057253,高股息中信99購02,0.70,0.70,0.46,0.50,-0.32,-39.02,266000,23,139700,0,0,0,0,0,0,10000,256000,-246000,-246000
20200312,057254,友達麥證98購01,0.13,0.13,0.13,0.13,-0.09,-40.91,31000,2,4030,0,31000,-31000,0,0,0,0,31000,-31000,-31000
20200312,057255,聯發科麥證98購02,0.79,0.79,0.77,0.77,-0.12,-13.48,20000,2,15600,10000,10000,0,0,0,0,10000,10000,0,0
20200312,057256,元油2X兆豐98購01,0.03,0.03,0.02,0.02,-0.03,-60.0,70000,7,2000,0,0,0,0,0,0,0,70000,-70000,-70000
20200312,057257,台泥兆豐99購01,0.95,0.95,0.85,0.89,-0.12,-11.88,133000,10,120200,0,0,0,0,0,0,63000,70000,-7000,-7000
20200312,057258,中環兆豐98購01,0.66,0.66,0.64,0.64,-0.21,-24.71,10000,6,6480,0,0,0,0,0,0,10000,0,10000,10000
20200312,057259,台積電兆豐98購03,0.42,0.42,0.28,0.37,-0.16,-30.19,1212000,27,440620,0,0,0,0,0,0,380000,822000,-442000,-442000
20200312,05725P,嘉聯益永豐96售02,1.70,1.74,1.70,1.74,+0.31,21.68,20000,2,34400,0,0,0,0,0,0,0,20000,-20000,-20000
20200312,057260,微星兆豐98購01,0.82,0.83,0.80,0.80,-0.13,-13.98,95000,6,77740,0,0,0,0,0,0,95000,0,95000,95000
20200312,057261,瑞昱兆豐98購01,0.34,0.34,0.23,0.23,-0.20,-46.51,51000,4,15380,0,0,0,0,0,0,0,51000,-51000,-51000
20200312,057262,友達兆豐98購03,0.08,0.08,0.05,0.05,-0.06,-54.55,50000,6,3350,0,0,0,0,0,0,0,45000,-45000,-45000
20200312,057263,可成兆豐99購01,0.51,0.51,0.38,0.41,-0.26,-38.81,1045000,22,440470,0,0,0,0,0,0,450000,507000,-57000,-57000
20200312,057264,新光金兆豐98購01,,,,,0.00,0.00,0,0,0,0,0,0,0,0,0,0,0,0,0
20200312,057265,聯詠兆豐98購01,0.56,0.57,0.48,0.55,-0.17,-23.61,1111000,13,574720,0,0,0,0,0,0,523000,588000,-65000,-65000
20200312,057266,TPK兆豐98購02,0.84,0.85,0.81,0.81,-0.23,-22.12,285000,9,238440,0,0,0,0,0,0,205000,80000,125000,125000
20200312,057267,康控兆豐99購01,0.64,0.66,0.52,0.54,-0.20,-27.03,93000,7,55230,0,0,0,0,0,0,55000,38000,17000,17000
20200312,057268,臻鼎兆豐99購01,0.59,0.59,0.41,0.41,-0.22,-34.92,398000,18,179450,0,0,0,0,0,0,20000,378000,-358000,-358000
20200312,057269,鈺齊兆豐98購01,0.83,0.85,0.72,0.73,-0.25,-25.51,705000,15,542630,0,0,0,0,0,0,73000,620000,-547000,-547000
20200312,05726P,易華電永豐96售02,2.25,2.25,2.25,2.25,0.00,0.00,10000,1,22500,0,0,0,0,0,0,0,10000,-10000,-10000
20200312,057270,遠東新元大98購01,1.49,1.49,1.38,1.38,-0.34,-19.77,146000,3,216440,0,0,0,0,0,0,68000,78000,-10000,-10000
20200312,057271,國巨元大98購17,1.15,1.18,0.92,0.92,-0.57,-38.26,28000,3,31810,0,0,0,0,0,0,25000,3000,22000,22000
20200312,057272,台積電元大98購14,1.85,1.85,1.40,1.64,-0.40,-19.61,644000,66,1061890,0,0,0,0,0,0,272000,578000,-306000,-306000
20200312,057273,智邦元大98購05,2.58,2.58,2.58,2.58,-0.28,-9.79,14000,3,36120,0,0,0,0,0,0,14000,14000,0,0
20200312,057274,友達元大98購03,0.20,0.20,0.17,0.17,-0.13,-43.33,380000,3,67600,0,0,0,0,0,0,50000,330000,-280000,-280000
20200312,057275,友達元大9A購04,,,,,0.00,0.00,0,0,0,0,0,0,0,0,0,0,0,0,0
20200312,057276,全新元大99購03,,,,,0.00,0.00,0,0,0,0,0,0,0,0,0,0,0,0,0
20200312,057277,可成元大98購05,1.53,1.53,1.53,1.53,-0.57,-27.14,25000,1,38250,0,0,0,0,0,0,25000,25000,0,0
20200312,057278,可成元大98購06,1.26,1.26,0.98,0.98,-0.66,-40.24,136000,3,156720,0,0,0,0,0,0,0,136000,-136000,-136000
20200312,057279,國揚元大98購01,1.20,1.20,1.19,1.19,-0.29,-19.59,60000,2,71600,0,0,0,0,0,0,40000,20000,20000,20000
20200312,05727P,新光金日盛96售02,1.28,1.45,1.28,1.40,+0.19,15.7,377000,11,522920,0,0,0,0,0,0,94000,283000,-189000,-189000
20200312,057280,大立光元大98購15,1.59,1.59,1.59,1.59,0.00,0.00,50000,1,79500,0,0,0,0,0,0,0,50000,-50000,-50000
20200312,057281,大立光元大98購16,,,,,0.00,0.00,0,0,0,0,0,0,0,0,0,0,0,0,0
20200312,057282,大立光元大99購06,0.95,1.00,0.95,0.97,-0.51,-34.46,24000,5,23220,0,0,0,0,0,0,1000,24000,-23000,-23000
20200312,057283,欣興元大98購07,1.56,1.56,1.29,1.29,-0.61,-32.11,190000,7,268500,0,0,0,0,0,0,90000,90000,0,0
20200312,057284,新日興元大98購03,1.36,1.38,1.36,1.38,-0.76,-35.51,68000,2,92840,0,0,0,0,0,0,0,68000,-68000,-68000
20200312,057285,群創元大98購07,,,,,0.00,0.00,0,0,0,0,0,0,0,0,0,0,0,0,0
20200312,057286,群創元大9B購05,,,,,0.00,0.00,0,0,0,0,0,0,0,0,0,0,0,0,0
20200312,057287,彩晶元大9C購03,0.84,0.84,0.84,0.84,-0.17,-16.83,10000,1,8400,0,0,0,0,0,0,10000,0,10000,10000
20200312,057288,聯茂元大98購03,,,,,0.00,0.00,0,0,0,0,0,0,0,0,0,0,0,0,0
20200312,057289,力成元大98購03,0.49,0.49,0.38,0.39,-0.15,-27.78,343000,15,143810,0,0,0,0,0,0,343000,8000,335000,335000
20200312,05728P,滬深2X凱基98售03,,,,,0.00,0.00,0,0,0,0,0,0,0,0,0,0,0,0,0
20200312,057290,元油2X國泰99購02,,,,,0.00,0.00,0,0,0,0,0,0,0,0,0,0,0,0,0
20200312,057291,國巨國泰9A購01,0.86,0.86,0.71,0.71,-0.33,-31.73,71000,3,59560,0,0,0,0,0,0,60000,11000,49000,49000
20200312,057292,國巨國泰9B購01,0.84,0.84,0.60,0.65,-0.45,-40.91,231000,26,161870,0,0,0,0,0,0,10000,181000,-171000,-171000
20200312,057293,力成國泰99購01,0.46,0.51,0.46,0.46,-0.23,-33.33,799000,13,377230,0,0,0,0,0,0,750000,0,750000,750000
20200312,057294,台灣50永豐99購01,0.31,0.31,0.23,0.23,0.00,0.00,27000,3,6290,0,0,0,0,0,0,26000,1000,25000,25000
20200312,057295,可成永豐98購02,0.38,0.38,0.26,0.26,-0.25,-49.02,230000,13,72420,0,0,0,0,0,0,170000,112000,58000,58000
20200312,057296,智原永豐98購01,,,,,0.00,0.00,0,0,0,0,0,0,0,0,0,0,0,0,0
20200312,057297,新日興永豐98購01,,,,,0.00,0.00,0,0,0,0,0,0,0,0,0,0,0,0,0
20200312,057298,旭富永豐98購01,0.94,0.95,0.70,0.70,-0.30,-30.0,345000,33,270340,0,0,0,0,0,0,231000,111000,120000,120000
20200312,057299,立積永豐98購02,0.70,0.70,0.54,0.54,-0.24,-30.77,386000,7,228800,0,0,0,0,0,0,220000,166000,54000,54000
20200312,05729P,臺股指凱基97售02,3.43,4.30,3.43,4.07,+1.13,38.44,26000,5,107080,0,0,0,0,0,0,24000,2000,22000,22000
20200312,057300,訊連永豐98購01,0.71,0.71,0.64,0.64,-0.18,-21.95,179000,9,122660,0,0,0,0,0,0,77000,102000,-25000,-25000
20200312,057301,嘉聯益永豐98購02,,,,,0.00,0.00,0,0,0,0,0,0,0,0,0,0,0,0,0
20200312,057302,福懋科中信98購01,0.58,0.58,0.58,0.58,-0.10,-14.71,35000,1,20300,0,0,0,0,0,0,35000,0,35000,35000
20200312,057303,喬山兆豐99購01,0.63,0.63,0.51,0.51,-0.27,-34.62,340000,12,188110,0,0,0,0,0,0,10000,330000,-320000,-320000
20200312,057304,為升兆豐99購02,,,,,0.00,0.00,0,0,0,0,0,0,0,0,0,0,0,0,0
20200312,057305,南亞科兆豐98購02,0.35,0.35,0.27,0.27,0.00,0.00,200000,4,59500,0,0,0,0,0,0,0,200000,-200000,-200000
20200312,057306,玉晶光兆豐99購01,0.81,0.81,0.81,0.81,-0.22,-21.36,45000,2,36450,0,0,0,0,0,0,45000,0,45000,45000
20200312,057307,瀚宇博兆豐99購01,0.87,0.87,0.68,0.68,-0.26,-27.66,323000,16,250420,0,0,0,0,0,0,122000,201000,-79000,-79000
20200312,057308,同欣電兆豐99購01,0.45,0.46,0.35,0.35,-0.18,-33.96,110000,12,45200,0,0,0,0,0,0,35000,75000,-40000,-40000
20200312,057309,南茂兆豐99購01,0.80,0.80,0.71,0.71,-0.18,-20.22,564000,22,433500,0,0,0,0,0,0,469000,66000,403000,403000
20200312,05730P,臺股指凱基97售03,4.14,4.14,4.06,4.06,0.00,0.00,14000,2,57160,0,0,0,0,0,0,4000,10000,-6000,-6000
20200312,057310,聯發科日盛99購01,1.35,1.35,1.26,1.26,-0.42,-25.0,18000,2,23400,0,0,0,0,0,0,18000,0,18000,18000
20200312,057311,玉晶光日盛9A購01,1.31,1.31,1.01,1.08,-0.51,-32.08,23000,5,27250,0,0,0,0,0,0,2000,23000,-21000,-21000
20200312,057312,美律麥證98購01,0.73,0.73,0.52,0.52,-0.31,-37.35,260000,13,147300,140000,120000,20000,0,0,0,140000,120000,20000,20000
20200312,057313,聯發科麥證99購01,1.33,1.33,1.16,1.16,-0.58,-33.33,60000,6,75700,0,60000,-60000,0,0,0,0,60000,-60000,-60000
20200312,057314,全新麥證98購01,0.37,0.37,0.37,0.37,-0.25,-40.32,20000,1,7400,0,20000,-20000,0,0,0,0,20000,-20000,-20000
20200312,057315,台灣50康和9A購03,0.42,0.42,0.25,0.29,-0.22,-43.14,926000,24,310010,0,0,0,0,0,0,42000,884000,-842000,-842000
20200312,057316,國巨凱基99購04,0.42,0.42,0.42,0.42,0.00,0.00,110000,1,46200,0,0,0,0,0,0,110000,0,110000,110000
20200312,057317,技嘉凱基98購02,0.47,0.47,0.36,0.36,-0.16,-30.77,78000,4,34740,0,0,0,0,0,0,78000,0,78000,78000
20200312,057318,台光電凱基9A購01,0.76,0.76,0.74,0.74,-0.44,-37.29,17000,2,12800,0,0,0,0,0,0,0,17000,-17000,-17000
20200312,057319,奇力新凱基99購02,,,,,0.00,0.00,0,0,0,0,0,0,0,0,0,0,0,0,0
20200312,05731P,創意統一96售03,1.90,1.90,1.88,1.90,+0.16,9.2,71000,3,133900,0,0,0,0,0,0,71000,0,71000,71000
20200312,057320,玉晶光凱基98購01,,,,,0.00,0.00,0,0,0,0,0,0,0,0,0,0,0,0,0
20200312,057321,台泥群益98購01,2.34,2.34,1.95,2.14,-0.28,-11.57,137000,9,304720,0,0,0,0,0,0,87000,50000,37000,37000
20200312,057322,旺宏群益98購04,,,,,0.00,0.00,0,0,0,0,0,0,0,0,0,0,0,0,0
20200312,057323,智邦群益98購01,1.05,1.05,0.78,0.78,-0.35,-30.97,102000,17,101380,0,0,0,0,0,0,91000,16000,75000,75000
20200312,057324,億光群益98購01,,,,,0.00,0.00,0,0,0,0,0,0,0,0,0,0,0,0,0
20200312,057325,可成群益9A購01,0.75,0.75,0.75,0.75,-0.32,-29.91,98000,1,73500,0,0,0,0,0,0,98000,0,98000,98000
20200312,057326,景碩群益99購02,1.43,1.45,1.12,1.12,-0.79,-41.36,64000,3,91100,0,0,0,0,0,0,54000,10000,44000,44000
20200312,057327,玉晶光群益9A購04,,,,,0.00,0.00,0,0,0,0,0,0,0,0,0,0,0,0,0
20200312,057328,京鼎群益99購02,0.50,0.53,0.50,0.53,-0.07,-11.67,11000,6,5560,0,0,0,0,0,0,11000,0,11000,11000
20200312,057329,緯穎群益98購02,1.47,1.47,1.47,1.47,-0.68,-31.63,5000,1,7350,0,0,0,0,0,0,0,5000,-5000,-5000
20200312,05732P,臺股指統一96售02,4.33,5.40,4.33,5.40,+2.13,65.14,61000,2,265200,0,0,0,0,0,0,61000,0,61000,61000
20200312,057330,台積電國票99購03,0.70,0.72,0.52,0.58,-0.35,-37.63,780000,12,489600,0,0,0,0,0,0,20000,760000,-740000,-740000
20200312,057331,台積電國票99購04,0.76,0.76,0.47,0.61,-0.38,-38.38,875000,43,516240,0,0,0,0,0,0,186000,669000,-483000,-483000
20200312,057332,旺宏國票99購03,,,,,0.00,0.00,0,0,0,0,0,0,0,0,0,0,0,0,0
20200312,057333,智邦國票99購01,1.41,1.41,1.41,1.41,-0.13,-8.44,10000,1,14100,0,0,0,0,0,0,10000,0,10000,10000
20200312,057334,技嘉國票98購02,0.85,0.85,0.85,0.85,-0.30,-26.09,30000,1,25500,0,0,0,0,0,0,30000,0,30000,30000
20200312,057335,技嘉國票99購01,0.81,0.85,0.63,0.63,-0.40,-38.83,74000,5,51240,0,0,0,0,0,0,74000,4000,70000,70000
20200312,057336,聯發科國票99購01,1.33,1.33,1.19,1.19,-0.72,-37.7,509000,2,675570,0,0,0,0,0,0,0,509000,-509000,-509000
20200312,057337,聯發科國票99購02,1.22,1.22,1.22,1.22,-0.89,-42.18,20000,1,24400,0,0,0,0,0,0,0,20000,-20000,-20000
20200312,057338,群創國票99購01,,,,,0.00,0.00,0,0,0,0,0,0,0,0,0,0,0,0,0
20200312,057339,群創國票99購02,0.08,0.08,0.08,0.08,-0.10,-55.56,10000,1,800,0,0,0,0,0,0,0,10000,-10000,-10000
20200312,05733P,臺股指統一96售03,5.10,5.50,5.10,5.50,0.00,0.00,4000,2,21600,0,0,0,0,0,0,4000,0,4000,4000
20200312,057340,玉晶光元富98購04,2.76,2.76,2.29,2.29,-1.13,-33.04,36000,4,93520,0,0,0,0,0,0,16000,26000,-10000,-10000
20200312,057341,技嘉台新98購01,0.68,0.68,0.65,0.65,-0.25,-27.78,25000,2,16400,0,0,0,0,0,0,25000,0,25000,25000
20200312,057342,玉晶光台新98購01,0.84,0.84,0.59,0.59,-0.33,-35.87,93000,4,60730,0,0,0,0,0,0,54000,39000,15000,15000
20200312,057343,道瓊反統一9A購01,2.81,3.35,2.81,3.35,+0.84,33.47,11000,2,34150,0,0,0,0,0,0,11000,0,11000,11000
20200312,057344,元油2X統一98購03,,,,,0.00,0.00,0,0,0,0,0,0,0,0,0,0,0,0,0
20200312,057345,中50統一98購01,0.75,0.75,0.75,0.75,-0.08,-9.64,35000,1,26250,0,0,0,0,0,0,35000,0,35000,35000
20200312,057346,鴻海統一98購13,0.87,0.87,0.75,0.75,-0.37,-33.04,53000,5,45620,0,0,0,0,0,0,5000,52000,-47000,-47000
20200312,057347,國巨統一9A購03,0.65,0.65,0.65,0.65,-0.19,-22.62,30000,1,19500,0,0,0,0,0,0,0,30000,-30000,-30000
20200312,057348,台積電統一98購09,0.26,0.26,0.17,0.24,-0.09,-27.27,81000,15,17230,0,0,0,0,0,0,0,76000,-76000,-76000
20200312,057349,聯發科統一98購04,0.88,0.88,0.76,0.76,-0.51,-40.16,23000,2,19040,0,0,0,0,0,0,13000,10000,3000,3000
20200312,05734P,臺股指統一96售04,,,,,0.00,0.00,0,0,0,0,0,0,0,0,0,0,0,0,0
20200312,057350,全新統一98購03,,,,,0.00,0.00,0,0,0,0,0,0,0,0,0,0,0,0,0
20200312,057351,奇力新統一98購02,0.25,0.25,0.23,0.24,-0.06,-20.0,88000,14,21740,0,0,0,0,0,0,88000,0,88000,88000
20200312,057352,大立光統一9A購02,1.03,1.03,0.84,0.84,-0.65,-43.62,66000,4,64740,0,0,0,0,0,0,6000,60000,-54000,-54000
20200312,057353,玉晶光統一99購01,0.92,0.92,0.76,0.76,-0.24,-24.0,57000,3,50520,0,0,0,0,0,0,35000,22000,13000,13000
20200312,057354,聯鈞統一99購03,1.61,1.61,1.30,1.30,-0.68,-34.34,60000,5,89540,0,0,0,0,0,0,0,60000,-60000,-60000
20200312,057355,彩晶統一98購03,,,,,0.00,0.00,0,0,0,0,0,0,0,0,0,0,0,0,0
20200312,057356,彩晶統一98購04,0.41,0.43,0.33,0.33,-0.23,-41.07,44000,3,17520,0,0,0,0,0,0,44000,0,44000,44000
20200312,057357,超眾統一98購01,0.44,0.47,0.44,0.47,-0.22,-31.88,96000,2,43680,0,0,0,0,0,0,48000,48000,0,0
20200312,057358,元油2X元大98購08,,,,,0.00,0.00,0,0,0,0,0,0,0,0,0,0,0,0,0
20200312,057359,元油2X元大98購09,,,,,0.00,0.00,0,0,0,0,0,0,0,0,0,0,0,0,0
20200312,05735P,臺股指統一96售05,,,,,0.00,0.00,0,0,0,0,0,0,0,0,0,0,0,0,0
20200312,057360,元油2X元大98購10,,,,,0.00,0.00,0,0,0,0,0,0,0,0,0,0,0,0,0
20200312,057361,元油2X元大98購11,0.04,0.04,0.04,0.04,0.00,0.00,100000,1,4000,0,0,0,0,0,0,0,100000,-100000,-100000
20200312,057362,元油2X元大98購12,0.03,0.03,0.02,0.03,-0.01,-25.0,1229000,20,33870,5000,0,5000,0,0,0,0,0,0,5000
20200312,057363,華通元大99購02,2.84,2.87,2.22,2.22,-1.42,-39.01,96000,14,258680,0,0,0,0,0,0,87000,49000,38000,38000
20200312,057364,國巨元大98購18,2.40,2.40,1.71,1.71,-0.93,-35.23,89000,5,197150,0,0,0,0,0,0,18000,89000,-71000,-71000
20200312,057365,智邦元大98購07,1.99,1.99,1.99,1.99,0.00,0.00,17000,1,33830,0,0,0,0,0,0,17000,0,17000,17000
20200312,057366,智邦元大98購08,1.27,1.27,0.98,1.02,-0.32,-23.88,125000,5,134820,0,0,0,0,0,0,57000,85000,-28000,-28000
20200312,057367,技嘉元大98購02,1.48,1.48,1.42,1.42,-0.38,-21.11,74000,2,105440,0,0,0,0,0,0,6000,74000,-68000,-68000
20200312,057368,微星元大98購02,1.46,1.46,1.29,1.29,-0.36,-21.82,108000,5,151280,0,0,0,0,0,0,40000,68000,-28000,-28000
20200312,057369,奇力新元大99購05,,,,,0.00,0.00,0,0,0,0,0,0,0,0,0,0,0,0,0
20200312,05736P,臺股指統一96售06,,,,,0.00,0.00,0,0,0,0,0,0,0,0,0,0,0,0,0
20200312,057370,可成元大98購07,1.06,1.06,0.79,0.79,-0.54,-40.6,105000,2,92940,0,0,0,0,0,0,37000,68000,-31000,-31000
20200312,057371,可成元大98購08,1.45,1.45,1.45,1.45,-0.47,-24.48,25000,1,36250,0,0,0,0,0,0,25000,25000,0,0
20200312,057372,華新科元大99購10,0.61,0.61,0.45,0.45,-0.19,-29.69,227000,13,126430,0,0,0,0,0,0,195000,32000,163000,163000
20200312,057373,大立光元大98購17,1.51,1.51,1.44,1.44,0.00,0.00,24000,2,35260,0,0,0,0,0,0,0,24000,-24000,-24000
20200312,057374,禾伸堂元大99購03,1.15,1.21,1.15,1.15,-0.08,-6.5,81000,4,96250,0,0,0,0,0,0,81000,81000,0,0
20200312,057375,欣興元大98購09,1.65,1.65,1.65,1.65,-0.93,-36.05,14000,1,23100,0,0,0,0,0,0,14000,0,14000,14000
20200312,057376,新日興元大98購04,1.05,1.05,1.05,1.05,0.00,0.00,68000,1,71400,0,0,0,0,0,0,0,68000,-68000,-68000
20200312,057377,康控元大99購02,1.27,1.27,1.09,1.09,-0.31,-22.14,143000,8,174870,0,0,0,0,0,0,52000,108000,-56000,-56000
20200312,057378,康友元大98購02,2.02,2.02,1.64,1.66,-0.50,-23.15,80000,10,142190,0,0,0,0,0,0,71000,71000,0,0
20200312,057379,寶成元大98購02,1.41,1.42,1.31,1.31,-0.52,-28.42,52000,3,73230,0,0,0,0,0,0,0,52000,-52000,-52000
20200312,05737P,臺股指統一96售07,,,,,0.00,0.00,0,0,0,0,0,0,0,0,0,0,0,0,0
20200312,057380,技嘉國泰9A購01,0.82,0.82,0.65,0.71,-0.18,-20.22,131000,7,96820,0,0,0,0,0,0,80000,51000,29000,29000
20200312,057381,微星國泰9A購01,0.92,0.92,0.82,0.82,-0.26,-24.07,200000,12,170500,0,0,0,0,0,0,50000,190000,-140000,-140000
20200312,057382,聯發科國泰9A購01,0.85,0.85,0.57,0.57,-0.36,-38.71,440000,14,313200,0,0,0,0,0,0,75000,415000,-340000,-340000
20200312,057383,玉晶光富邦9A購01,0.36,0.36,0.36,0.36,0.00,0.00,200000,1,72000,0,0,0,0,0,0,200000,0,200000,200000
20200312,057384,台灣50永豐99購02,0.25,0.25,0.23,0.23,-0.13,-36.11,24000,3,5600,0,0,0,0,0,0,0,24000,-24000,-24000
20200312,057385,光罩永豐99購01,0.69,0.69,0.53,0.58,-0.23,-28.4,248000,12,139400,0,0,0,0,0,0,207000,15000,192000,192000
20200312,057386,聯發科永豐98購04,,,,,0.00,0.00,0,0,0,0,0,0,0,0,0,0,0,0,0
20200312,057387,奇力新永豐98購03,0.24,0.27,0.24,0.27,-0.11,-28.95,80000,2,19800,0,0,0,0,0,0,80000,0,80000,80000
20200312,057388,奇鋐永豐98購02,0.87,0.89,0.74,0.74,-0.34,-31.48,55000,3,47920,0,0,0,0,0,0,44000,11000,33000,33000
20200312,057389,玉晶光永豐98購06,0.53,0.53,0.45,0.45,-0.20,-30.77,11000,2,5030,0,0,0,0,0,0,10000,1000,9000,9000
20200312,05738P,臺股指統一97售01,7.10,7.10,7.10,7.10,+2.39,50.74,5000,1,35500,0,0,0,0,0,0,5000,0,5000,5000
20200312,057390,台表科永豐98購01,0.36,0.36,0.36,0.36,-0.27,-42.86,50000,1,18000,0,0,0,0,0,0,50000,0,50000,50000
20200312,057391,樺漢永豐98購01,,,,,0.00,0.00,0,0,0,0,0,0,0,0,0,0,0,0,0
20200312,057392,福懋科永豐98購01,0.54,0.54,0.54,0.54,-0.10,-15.62,10000,1,5400,0,0,0,0,0,0,10000,0,10000,10000
20200312,057393,台積電中信02購01,0.34,0.34,0.24,0.29,-0.09,-23.68,2023000,107,596300,0,0,0,0,0,0,428000,1583000,-1155000,-1155000
20200312,057394,台積電中信9C購02,0.27,0.27,0.22,0.25,-0.06,-19.35,277000,13,71090,0,0,0,0,0,0,2000,275000,-273000,-273000
20200312,057395,旺宏中信98購03,,,,,0.00,0.00,0,0,0,0,0,0,0,0,0,0,0,0,0
20200312,057396,健鼎中信99購01,0.68,0.68,0.60,0.60,-0.17,-22.08,98000,6,64880,0,0,0,0,0,0,88000,10000,78000,78000
20200312,057397,茂林中信9A購01,0.32,0.32,0.31,0.31,-0.05,-13.89,60000,2,18900,0,0,0,0,0,0,30000,30000,0,0
20200312,057398,台郡中信99購01,0.61,0.61,0.42,0.44,-0.39,-46.99,218000,12,108800,0,0,0,0,0,0,65000,153000,-88000,-88000
20200312,057399,滬深反群益9C購01,1.06,1.14,1.06,1.12,+0.17,17.89,209000,13,226100,0,0,0,0,0,0,114000,101000,13000,13000
20200312,05739P,臺股指統一97售02,,,,,0.00,0.00,0,0,0,0,0,0,0,0,0,0,0,0,0
20200312,057400,全新群益9A購01,,,,,0.00,0.00,0,0,0,0,0,0,0,0,0,0,0,0,0
20200312,057401,晶豪科群益99購01,2.01,2.01,1.59,1.61,-0.44,-21.46,624000,47,1111400,0,0,0,0,0,0,619000,62000,557000,557000
20200312,057402,嘉晶群益98購02,1.93,2.17,1.74,1.74,-0.30,-14.71,576000,24,1126780,0,0,0,0,0,0,335000,341000,-6000,-6000
20200312,057403,亞光群益98購04,0.76,0.76,0.52,0.52,-0.54,-50.94,35000,2,18920,0,0,0,0,0,0,35000,3000,32000,32000
20200312,057404,貿聯群益99購01,0.46,0.46,0.43,0.43,-0.15,-25.86,42000,11,18380,0,0,0,0,0,0,42000,0,42000,42000
20200312,057405,麗豐群益98購01,0.66,0.66,0.59,0.60,-0.12,-16.67,50000,5,31460,0,0,0,0,0,0,7000,43000,-36000,-36000
20200312,057406,茂林群益98購03,0.61,0.61,0.40,0.40,-0.43,-51.81,933000,6,416230,0,0,0,0,0,0,35000,912000,-877000,-877000
20200312,057407,超眾群益99購01,,,,,0.00,0.00,0,0,0,0,0,0,0,0,0,0,0,0,0
20200312,057408,台郡群益98購01,0.52,0.52,0.41,0.42,-0.31,-42.47,236000,24,110030,0,0,0,0,0,0,88000,165000,-77000,-77000
20200312,057409,台虹群益98購02,1.32,1.36,1.12,1.12,-0.39,-25.83,220000,10,265120,0,0,0,0,0,0,159000,61000,98000,98000
20200312,05740P,宏達電元富96售01,0.79,0.95,0.79,0.92,+0.15,19.48,671000,10,577370,0,0,0,0,0,0,125000,546000,-421000,-421000
20200312,057410,南電群益98購01,1.97,1.97,1.37,1.37,-0.70,-33.82,36000,6,65670,0,0,0,0,0,0,36000,21000,15000,15000
20200312,057411,臺股指群益99購05,,,,,0.00,0.00,0,0,0,0,0,0,0,0,0,0,0,0,0
20200312,057412,臺股指群益99購06,,,,,0.00,0.00,0,0,0,0,0,0,0,0,0,0,0,0,0
20200312,057413,臺股指群益9C購04,0.42,0.42,0.41,0.41,0.00,0.00,81000,3,33390,0,0,0,0,0,0,81000,0,81000,81000
20200312,057414,華新科日盛9A購01,0.71,0.71,0.48,0.48,-0.28,-36.84,323000,14,184170,0,0,0,0,0,0,243000,80000,163000,163000
20200312,057415,和碩日盛98購01,0.75,0.78,0.60,0.60,-0.40,-40.0,346000,26,254920,0,0,0,0,0,0,346000,0,346000,346000
20200312,057416,T50反1凱基9C購01,1.33,1.33,1.27,1.27,+0.33,35.11,20000,2,26000,0,0,0,0,0,0,20000,0,20000,20000
20200312,057417,國巨凱基9A購03,0.46,0.46,0.34,0.35,-0.14,-28.57,443000,9,175940,0,0,0,0,0,0,416000,27000,389000,389000
20200312,057418,台光電凱基98購04,1.02,1.02,0.77,0.85,-0.32,-27.35,102000,9,88100,0,0,0,0,0,0,73000,82000,-9000,-9000
20200312,057419,奇力新凱基98購06,0.33,0.33,0.29,0.29,-0.09,-23.68,200000,9,60600,0,0,0,0,0,0,200000,0,200000,200000
20200312,05741P,聯發科元大96售14,5.75,7.40,5.75,7.20,+2.66,58.59,233000,18,1552600,0,0,0,0,0,0,203000,233000,-30000,-30000
20200312,057420,美食凱基98購01,0.47,0.47,0.41,0.41,-0.17,-29.31,71000,2,33190,0,0,0,0,0,0,71000,0,71000,71000
20200312,057421,智原凱基98購04,,,,,0.00,0.00,0,0,0,0,0,0,0,0,0,0,0,0,0
20200312,057422,欣興凱基98購04,,,,,0.00,0.00,0,0,0,0,0,0,0,0,0,0,0,0,0
20200312,057423,台郡凱基98購06,0.49,0.49,0.49,0.49,-0.02,-3.92,20000,1,9800,0,0,0,0,0,0,0,20000,-20000,-20000
20200312,057424,訊芯凱基98購04,,,,,0.00,0.00,0,0,0,0,0,0,0,0,0,0,0,0,0
20200312,057425,臺股指凱基9C購02,0.23,0.23,0.13,0.14,-0.22,-61.11,196000,24,37120,0,0,0,0,0,0,0,191000,-191000,-191000
20200312,057426,元油2X兆豐9B購01,0.05,0.06,0.02,0.02,-0.03,-60.0,560000,63,20300,0,0,0,0,0,0,0,528000,-528000,-528000
20200312,057427,華通兆豐99購01,0.58,0.58,0.36,0.37,-0.29,-43.94,229000,8,119840,0,0,0,0,0,0,219000,10000,209000,209000
20200312,057428,正崴兆豐98購01,0.72,0.72,0.65,0.66,-0.18,-21.43,158000,8,105060,0,0,0,0,0,0,153000,5000,148000,148000
20200312,057429,華新科兆豐98購03,0.26,0.29,0.25,0.28,-0.23,-45.1,141000,6,39600,0,0,0,0,0,0,41000,100000,-59000,-59000
20200312,05742P,可成元大96售04,2.11,2.64,2.11,2.64,+0.75,39.68,149000,6,350770,0,0,0,0,0,0,99000,85000,14000,14000
20200312,057430,富邦金兆豐98購01,0.50,0.50,0.36,0.36,-0.19,-34.55,104000,4,43240,0,0,0,0,0,0,84000,20000,64000,64000
20200312,057431,京鼎兆豐98購02,0.51,0.51,0.39,0.39,-0.28,-41.79,614000,17,285720,0,0,0,0,0,0,219000,395000,-176000,-176000
20200312,057432,T50反1國票9B購01,,,,,0.00,0.00,0,0,0,0,0,0,0,0,0,0,0,0,0
20200312,057433,上銀國票98購04,1.70,1.74,1.43,1.43,-0.97,-40.42,55000,7,88960,0,0,0,0,0,0,25000,30000,-5000,-5000
20200312,057434,國巨國票99購03,0.82,0.82,0.48,0.48,-0.47,-49.47,397000,11,271440,0,0,0,0,0,0,200000,197000,3000,3000
20200312,057435,旺宏國票99購04,0.91,0.91,0.68,0.68,0.00,0.00,37000,2,26770,0,0,0,0,0,0,7000,30000,-23000,-23000
20200312,057436,義隆國票99購02,1.07,1.12,1.07,1.12,-0.43,-27.74,36000,2,39320,0,0,0,0,0,0,36000,0,36000,36000
20200312,057437,可成國票99購01,1.18,1.18,0.79,0.81,-0.78,-49.06,903000,10,762790,0,0,0,0,0,0,480000,423000,57000,57000
20200312,057438,禾伸堂國票99購01,0.67,0.72,0.66,0.67,-0.06,-8.22,36000,4,25090,0,0,0,0,0,0,30000,6000,24000,24000
20200312,057439,元油2X統一99購02,,,,,0.00,0.00,0,0,0,0,0,0,0,0,0,0,0,0,0
20200312,05743P,創意元大96售01,2.71,2.71,2.71,2.71,+0.38,16.31,10000,1,27100,0,0,0,0,0,0,10000,0,10000,10000
20200312,057440,台積電統一98購10,0.43,0.43,0.30,0.34,-0.15,-30.61,109000,8,40590,0,0,0,0,0,0,70000,29000,41000,41000
20200312,057441,奇力新統一98購03,0.12,0.12,0.11,0.11,0.00,0.00,80000,2,9200,0,0,0,0,0,0,0,80000,-80000,-80000
20200312,057442,玉晶光統一98購03,0.64,0.64,0.57,0.57,-0.31,-35.23,50000,3,30000,0,0,0,0,0,0,20000,30000,-10000,-10000
20200312,057443,臺股指統一99購04,0.38,0.44,0.38,0.43,0.00,0.00,36000,4,15180,0,0,0,0,0,0,10000,26000,-16000,-16000
20200312,057444,台泥元富98購01,1.54,1.54,1.34,1.47,-0.18,-10.91,283000,17,420340,0,0,0,0,0,0,125000,158000,-33000,-33000
20200312,057445,華通元富02購01,0.94,0.94,0.72,0.72,-0.36,-33.33,320000,7,267790,0,0,0,0,0,0,177000,143000,34000,34000
20200312,057446,旺宏元富02購01,0.80,0.80,0.80,0.80,-0.36,-31.03,20000,1,16000,0,0,0,0,0,0,0,20000,-20000,-20000
20200312,057447,智邦元富02購01,1.27,1.27,1.04,1.04,-0.31,-22.96,21000,4,25260,0,0,0,0,0,0,14000,7000,7000,7000
20200312,057448,致茂元富98購01,0.72,0.72,0.54,0.54,-0.27,-33.33,191000,24,128250,0,0,0,0,0,0,131000,60000,71000,71000
20200312,057449,華新科元富99購02,0.87,0.87,0.61,0.61,-0.52,-46.02,20000,2,14800,0,0,0,0,0,0,10000,10000,0,0
20200312,05744P,台表科元大96售04,2.40,2.88,2.40,2.88,+0.49,20.5,100000,7,273400,0,0,0,0,0,0,100000,0,100000,100000
20200312,057450,國泰金元富98購01,1.60,1.60,1.41,1.41,-0.33,-18.97,233000,8,336240,0,0,0,0,0,0,201000,32000,169000,169000
20200312,057451,大立光元富9B購01,1.26,1.26,0.99,0.99,-0.98,-49.75,116000,3,142180,0,0,0,0,0,0,0,116000,-116000,-116000
20200312,057452,新日興元富98購01,0.74,0.74,0.59,0.59,-0.23,-28.05,30000,3,19400,0,0,0,0,0,0,10000,20000,-10000,-10000
20200312,057453,矽創元富98購01,1.60,1.60,1.16,1.16,-0.53,-31.36,190000,11,271150,0,0,0,0,0,0,50000,140000,-90000,-90000
20200312,057454,上銀國泰99購02,0.89,0.89,0.71,0.73,-0.30,-29.13,131000,5,100510,0,0,0,0,0,0,90000,41000,49000,49000
20200312,057455,景碩國泰99購01,1.01,1.01,0.96,0.96,-0.12,-11.11,20000,2,19700,0,0,0,0,0,0,10000,10000,0,0
20200312,057456,道瓊銀富邦9C購01,1.74,1.74,1.56,1.56,-0.28,-15.22,51000,9,82300,0,0,0,0,0,0,26000,25000,1000,1000
20200312,057457,華邦電富邦98購01,1.24,1.24,1.05,1.05,-0.49,-31.82,153000,3,171000,0,0,0,0,0,0,5000,148000,-143000,-143000
20200312,057458,TPK富邦9A購01,0.60,0.60,0.45,0.46,-0.19,-29.23,379000,42,184230,0,0,0,0,0,0,31000,348000,-317000,-317000
20200312,057459,臺股指富邦99購03,0.54,0.57,0.54,0.57,0.00,0.00,1419000,3,796200,0,0,0,0,0,0,1419000,0,1419000,1419000
20200312,05745P,富邦金兆豐96售02,3.20,3.51,3.20,3.43,+0.49,16.67,62000,9,210850,0,0,0,0,0,0,13000,49000,-36000,-36000
20200312,057460,楠梓電永豐98購03,0.77,0.77,0.64,0.64,-0.32,-33.33,104000,23,73130,0,0,0,0,0,0,91000,10000,81000,81000
20200312,057461,國巨永豐98購07,0.18,0.18,0.18,0.18,0.00,0.00,148000,2,26640,0,0,0,0,0,0,148000,0,148000,148000
20200312,057462,光磊永豐98購02,,,,,0.00,0.00,0,0,0,0,0,0,0,0,0,0,0,0,0
20200312,057463,華邦電永豐98購01,0.33,0.33,0.33,0.33,-0.26,-44.07,10000,1,3300,0,0,0,0,0,0,10000,0,10000,10000
20200312,057464,大立光永豐98購02,0.23,0.23,0.19,0.19,0.00,0.00,7000,2,1530,0,0,0,0,0,0,0,7000,-7000,-7000
20200312,057465,智易永豐98購02,,,,,0.00,0.00,0,0,0,0,0,0,0,0,0,0,0,0,0
20200312,057466,泰鼎永豐98購01,0.51,0.51,0.46,0.47,-0.13,-21.67,148000,6,73080,0,0,0,0,0,0,148000,0,148000,148000
20200312,057467,祥碩永豐98購04,0.31,0.35,0.23,0.26,-0.08,-23.53,987000,55,288240,0,0,0,0,0,0,51000,925000,-874000,-874000
20200312,057468,台郡永豐98購01,0.45,0.45,0.45,0.45,-0.15,-25.0,77000,1,34650,0,0,0,0,0,0,77000,0,77000,77000
20200312,057469,康友永豐98購02,0.66,0.66,0.53,0.53,-0.20,-27.4,108000,4,59640,0,0,0,0,0,0,78000,30000,48000,48000
20200312,05746P,台積電群益96售07,4.83,5.25,4.83,5.25,+1.13,27.43,40000,5,201300,0,0,0,0,0,0,30000,10000,20000,20000
20200312,057470,易華電永豐98購02,,,,,0.00,0.00,0,0,0,0,0,0,0,0,0,0,0,0,0
20200312,057471,昇陽半永豐98購02,0.41,0.41,0.41,0.41,-0.07,-14.58,10000,1,4100,0,0,0,0,0,0,10000,0,10000,10000
20200312,057472,T50正2元大9B購03,0.26,0.26,0.19,0.19,-0.12,-38.71,209000,9,44330,0,0,0,0,0,0,60000,149000,-89000,-89000
20200312,057473,T50反1元大98購08,1.33,1.73,1.33,1.73,+0.66,61.68,512000,4,685660,0,0,0,0,0,0,0,512000,-512000,-512000
20200312,057474,T50反1元大98購09,1.41,1.41,1.39,1.39,0.00,0.00,932000,2,1304760,0,0,0,0,0,0,0,932000,-932000,-932000
20200312,057475,聯電元大9A購01,0.45,0.45,0.45,0.45,-0.16,-26.23,25000,1,11250,0,0,0,0,0,0,25000,0,25000,25000
20200312,057476,國巨元大98購19,1.81,1.81,1.81,1.81,-0.52,-22.32,50000,1,90500,0,0,0,0,0,0,0,50000,-50000,-50000
20200312,057477,智邦元大98購09,1.62,1.62,1.32,1.32,-0.40,-23.26,78000,2,105960,0,0,0,0,0,0,10000,68000,-58000,-58000
20200312,057478,智邦元大99購01,1.32,1.34,1.03,1.10,-0.31,-21.99,762000,46,888830,0,0,0,0,0,0,348000,454000,-106000,-106000
20200312,057479,致茂元大98購03,1.44,1.44,1.22,1.22,-0.55,-31.07,169000,8,228950,0,0,0,0,0,0,169000,0,169000,169000
20200312,05747P,漢唐群益96售03,1.69,1.89,1.69,1.81,+0.32,21.48,29000,4,52090,0,0,0,0,0,0,19000,10000,9000,9000
20200312,057480,技嘉元大98購03,1.25,1.25,1.17,1.17,-0.19,-13.97,8000,2,9600,0,0,0,0,0,0,8000,5000,3000,3000
20200312,057481,技嘉元大98購04,1.23,1.24,1.16,1.20,-0.25,-17.24,83000,7,97140,0,0,0,0,0,0,12000,76000,-64000,-64000
20200312,057482,微星元大98購03,1.50,1.50,1.37,1.37,-0.39,-22.16,111000,4,156860,0,0,0,0,0,0,43000,68000,-25000,-25000
20200312,057483,微星元大98購04,1.12,1.12,0.98,0.98,-0.24,-19.67,24000,4,25820,0,0,0,0,0,0,22000,2000,20000,20000
20200312,057484,南亞科元大98購06,0.58,0.58,0.45,0.45,-0.35,-43.75,10000,2,5150,0,0,0,0,0,0,0,10000,-10000,-10000
20200312,057485,友達元大9C購04,0.44,0.44,0.44,0.44,-0.21,-32.31,46000,1,20240,0,0,0,0,0,0,0,46000,-46000,-46000
20200312,057486,美律元大98購04,0.99,1.01,0.97,0.97,-0.54,-35.76,79000,4,78110,0,0,0,0,0,0,11000,79000,-68000,-68000
20200312,057487,聯發科元大98購10,1.43,1.43,1.00,1.05,-0.49,-31.82,536000,38,668290,0,0,0,0,0,0,290000,284000,6000,6000
20200312,057488,聯發科元大99購02,1.15,1.15,0.84,0.84,-0.49,-36.84,241000,18,229510,0,0,0,0,0,0,55000,166000,-111000,-111000
20200312,057489,奇力新元大99購06,1.05,1.05,0.77,0.77,-0.34,-30.63,233000,13,219800,0,0,0,0,0,0,173000,60000,113000,113000
20200312,05748P,臺股指群益99售02,4.30,6.20,4.30,5.80,+2.04,54.26,130000,39,674510,0,0,0,0,0,0,112000,4000,108000,108000
20200312,057490,可成元大98購10,1.08,1.08,0.85,0.85,-0.65,-43.33,136000,2,131240,0,0,0,0,0,0,0,136000,-136000,-136000
20200312,057491,美食元大98購03,1.49,1.49,1.30,1.33,-0.48,-26.52,260000,15,357950,0,0,0,0,0,0,160000,100000,60000,60000
20200312,057492,大立光元大98購18,1.72,1.72,1.58,1.58,-1.41,-47.16,24000,3,39810,0,0,0,0,0,0,0,24000,-24000,-24000
20200312,057493,聯詠元大98購02,1.73,1.73,1.50,1.50,-0.48,-24.24,66000,3,105880,0,0,0,0,0,0,66000,50000,16000,16000
20200312,057494,玉晶光元大99購09,1.59,1.59,1.24,1.28,-0.70,-35.35,17000,7,25050,0,0,0,0,0,0,7000,17000,-10000,-10000
20200312,057495,牧德元大99購04,1.31,1.31,1.06,1.06,-0.47,-30.72,20000,4,23250,0,0,0,0,0,0,0,20000,-20000,-20000
20200312,057496,佐登元大98購02,1.39,1.39,1.09,1.09,-0.57,-34.34,11000,4,13730,0,0,0,0,0,0,5000,6000,-1000,-1000
20200312,057497,祥碩元大98購06,1.80,1.80,1.57,1.60,-0.23,-12.57,73000,4,120200,0,0,0,0,0,0,50000,73000,-23000,-23000
20200312,057498,台郡元大98購04,1.23,1.23,1.23,1.23,-0.68,-35.6,20000,1,24600,0,0,0,0,0,0,20000,0,20000,20000
20200312,057499,奇鋐群益98購01,1.14,1.19,0.90,0.95,-0.34,-26.36,84000,9,91780,0,0,0,0,0,0,39000,47000,-8000,-8000
20200312,05749P,臺股指群益99售03,7.00,8.85,6.80,8.20,+2.20,36.67,31000,15,238450,0,0,0,0,0,0,30000,0,30000,30000
20200312,057500,神達群益98購01,3.36,3.43,3.07,3.07,-1.18,-27.76,80000,4,255000,0,0,0,0,0,0,10000,70000,-60000,-60000
20200312,057501,超眾群益98購04,1.66,1.66,1.53,1.53,-0.44,-22.34,181000,4,294840,0,0,0,0,0,0,146000,54000,92000,92000
20200312,057502,訊芯群益98購02,0.58,0.60,0.45,0.45,-0.27,-37.5,213000,7,122050,0,0,0,0,0,0,69000,144000,-75000,-75000
20200312,057503,世紀鋼群益98購02,5.95,5.95,4.92,5.30,-1.00,-15.87,146000,11,787200,0,0,0,0,0,0,95000,51000,44000,44000
20200312,057504,技嘉麥證98購01,0.42,0.43,0.36,0.38,-0.08,-17.39,188000,12,74460,173000,15000,158000,0,0,0,173000,15000,158000,158000
20200312,057505,健策麥證98購01,0.51,0.51,0.51,0.51,-0.36,-41.38,20000,2,10200,0,20000,-20000,0,0,0,0,20000,-20000,-20000
20200312,057506,聯鈞國票99購02,1.62,1.63,1.27,1.27,-0.81,-38.94,488000,6,628210,0,0,0,0,0,0,11000,477000,-466000,-466000
20200312,057507,貿聯國票98購02,0.78,0.80,0.75,0.75,-0.23,-23.47,52000,6,40250,0,0,0,0,0,0,32000,20000,12000,12000
20200312,057508,康控國票99購03,0.71,0.71,0.56,0.56,-0.41,-42.27,96000,9,63660,0,0,0,0,0,0,36000,60000,-24000,-24000
20200312,057509,聯發科統一9A購03,0.73,0.73,0.73,0.73,-0.27,-27.0,48000,1,35040,0,0,0,0,0,0,0,48000,-48000,-48000
20200312,05750P,臺股指群益99售04,,,,,0.00,0.00,0,0,0,0,0,0,0,0,0,0,0,0,0
20200312,057510,泰碩統一98購02,2.02,2.02,1.75,1.86,-0.50,-21.19,65000,5,127560,0,0,0,0,0,0,34000,30000,4000,4000
20200312,057511,健策統一98購02,0.32,0.32,0.30,0.30,-0.14,-31.82,23000,3,7160,0,0,0,0,0,0,13000,10000,3000,3000
20200312,057512,華邦電台新98購01,0.47,0.47,0.47,0.47,0.00,0.00,15000,1,7050,0,0,0,0,0,0,0,15000,-15000,-15000
20200312,057513,智邦台新98購01,1.05,1.05,0.82,0.82,-0.33,-28.7,61000,7,61260,0,0,0,0,0,0,58000,3000,55000,55000
20200312,057514,華新科元富99購03,0.53,0.53,0.36,0.39,-0.23,-37.1,23000,3,10280,0,0,0,0,0,0,10000,13000,-3000,-3000
20200312,057515,智原元富98購02,0.35,0.35,0.29,0.29,-0.36,-55.38,350000,8,110900,0,0,0,0,0,0,0,350000,-350000,-350000
20200312,057516,和鑫元富98購01,0.73,0.73,0.51,0.51,-0.42,-45.16,180000,12,113600,0,0,0,0,0,0,50000,130000,-80000,-80000
20200312,057517,矽創元富98購02,0.65,0.65,0.65,0.65,-0.13,-16.67,20000,1,13000,0,0,0,0,0,0,20000,0,20000,20000
20200312,057518,世紀鋼元富98購01,3.18,3.18,2.68,2.90,-0.30,-9.38,1499000,85,4351130,0,0,0,0,0,0,802000,697000,105000,105000
20200312,057519,元油2X元大98購14,,,,,0.00,0.00,0,0,0,0,0,0,0,0,0,0,0,0,0
20200312,05751P,台積電中信96售05,1.52,1.70,1.52,1.68,+0.30,21.74,192000,10,306870,0,0,0,0,0,0,11000,181000,-170000,-170000
20200312,057520,元油2X元大98購15,,,,,0.00,0.00,0,0,0,0,0,0,0,0,0,0,0,0,0
20200312,057521,元油2X元大98購16,,,,,0.00,0.00,0,0,0,0,0,0,0,0,0,0,0,0,0
20200312,057522,元油2X元大98購17,,,,,0.00,0.00,0,0,0,0,0,0,0,0,0,0,0,0,0
20200312,057523,大成鋼元大99購01,2.09,2.09,1.89,2.00,-0.14,-6.54,221000,13,442590,0,0,0,0,0,0,211000,90000,121000,121000
20200312,057524,旺宏元大99購04,1.30,1.30,1.23,1.23,-0.44,-26.35,70000,2,86240,0,0,0,0,0,0,2000,70000,-68000,-68000
20200312,057525,光磊元大99購01,,,,,0.00,0.00,0,0,0,0,0,0,0,0,0,0,0,0,0
20200312,057526,智邦元大98購10,1.21,1.21,1.05,1.09,-0.34,-23.78,105000,4,115970,0,0,0,0,0,0,17000,105000,-88000,-88000
20200312,057527,億光元大98購01,0.73,0.73,0.56,0.56,-0.35,-38.46,209000,5,131980,0,0,0,0,0,0,31000,178000,-147000,-147000
20200312,057528,南亞科元大99購01,0.67,0.67,0.65,0.65,-0.45,-40.91,6000,2,3920,0,0,0,0,0,0,0,6000,-6000,-6000
20200312,057529,嘉晶元大99購02,2.87,3.01,2.24,2.45,-0.33,-11.87,315000,53,832560,0,0,0,0,0,0,270000,221000,49000,49000
20200312,05752P,台積電中信96售06,1.26,1.34,1.26,1.34,+0.37,38.14,163000,6,211270,0,0,0,0,0,0,0,163000,-163000,-163000
20200312,057530,奇鋐元大99購01,2.34,2.46,2.02,2.02,-1.00,-33.11,103000,9,230970,0,0,0,0,0,0,7000,103000,-96000,-96000
20200312,057531,禾伸堂元大99購04,0.69,0.69,0.63,0.63,0.00,0.00,115000,2,78450,0,0,0,0,0,0,0,115000,-115000,-115000
20200312,057532,智原元大98購03,0.93,0.93,0.81,0.81,-0.31,-27.68,32000,5,27450,0,0,0,0,0,0,25000,21000,4000,4000
20200312,057533,晶相光元大98購02,2.00,2.00,2.00,2.00,-0.50,-20.0,10000,1,20000,0,0,0,0,0,0,10000,0,10000,10000
20200312,057534,旭富元大98購01,2.73,2.73,1.80,1.95,-0.86,-30.6,547000,36,1193190,0,0,0,0,0,0,397000,173000,224000,224000
20200312,057535,泰鼎元大99購01,1.27,1.28,0.98,1.04,-0.24,-18.75,642000,33,737430,0,0,0,0,0,0,420000,222000,198000,198000
20200312,057536,康控元大99購03,1.55,1.55,1.55,1.55,-0.44,-22.11,16000,1,24800,0,0,0,0,0,0,16000,16000,0,0
20200312,057537,聯茂元大98購04,2.45,2.45,2.17,2.17,-0.43,-16.54,62000,2,151340,0,0,0,0,0,0,60000,2000,58000,58000
20200312,057538,緯穎元大98購07,1.23,1.23,1.23,1.23,-0.86,-41.15,1000,1,1230,0,0,0,0,0,0,0,1000,-1000,-1000
20200312,057539,南茂元大98購02,1.88,1.88,1.59,1.60,-0.67,-29.52,469000,24,810650,0,0,0,0,0,0,131000,364000,-233000,-233000
20200312,05753P,臺股指中信99售02,1.47,2.06,1.47,2.05,+0.82,66.67,422000,22,758360,0,0,0,0,0,0,176000,243000,-67000,-67000
20200312,057540,緯穎日盛99購01,1.43,1.43,0.88,0.88,-0.79,-47.31,47000,4,62090,0,0,0,0,0,0,37000,10000,27000,27000
20200312,057541,台灣50康和9A購04,0.33,0.33,0.23,0.26,-0.12,-31.58,280000,27,73490,0,0,0,0,0,0,2000,278000,-276000,-276000
20200312,057542,上銀凱基99購01,0.42,0.42,0.33,0.33,-0.21,-38.89,159000,4,55900,0,0,0,0,0,0,30000,129000,-99000,-99000
20200312,057543,華通凱基99購02,0.66,0.66,0.66,0.66,-0.23,-25.84,67000,1,44220,0,0,0,0,0,0,67000,0,67000,67000
20200312,057544,鴻海凱基02購01,0.72,0.72,0.58,0.63,-0.21,-25.0,107000,8,64900,0,0,0,0,0,0,69000,38000,31000,31000
20200312,057545,國巨凱基99購05,0.38,0.41,0.35,0.35,-0.20,-36.36,5000,4,1890,0,0,0,0,0,0,4000,1000,3000,3000
20200312,057546,台積電凱基02購01,0.50,0.50,0.40,0.48,-0.09,-15.79,1113000,112,512850,0,0,0,0,0,0,216000,602000,-386000,-386000
20200312,057547,技嘉凱基99購01,,,,,0.00,0.00,0,0,0,0,0,0,0,0,0,0,0,0,0
20200312,057548,微星凱基99購01,,,,,0.00,0.00,0,0,0,0,0,0,0,0,0,0,0,0,0
20200312,057549,台光電凱基98購05,0.49,0.49,0.32,0.40,-0.22,-35.48,42000,4,16980,0,0,0,0,0,0,12000,30000,-18000,-18000
20200312,05754P,臺股指中信99售03,1.98,2.09,1.98,2.09,+0.24,12.97,39000,6,78850,0,0,0,0,0,0,35000,4000,31000,31000
20200312,057550,聯發科凱基02購01,0.53,0.53,0.38,0.40,-0.25,-38.46,863000,38,388810,0,0,0,0,0,0,55000,808000,-753000,-753000
20200312,057551,華新科凱基98購06,0.15,0.15,0.15,0.15,0.00,0.00,350000,4,52500,0,0,0,0,0,0,0,350000,-350000,-350000
20200312,057552,禾伸堂凱基98購05,0.40,0.42,0.36,0.41,0.00,0.00,60000,5,24000,0,0,0,0,0,0,0,60000,-60000,-60000
20200312,057553,景碩凱基98購03,0.46,0.46,0.46,0.46,0.00,0.00,9000,1,4140,0,0,0,0,0,0,0,9000,-9000,-9000
20200312,057554,新日興凱基99購02,0.42,0.42,0.41,0.41,-0.24,-36.92,80000,2,33520,0,0,0,0,0,0,0,80000,-80000,-80000
20200312,057555,玉晶光凱基9A購02,0.52,0.52,0.40,0.40,-0.18,-31.03,667000,10,336460,0,0,0,0,0,0,58000,609000,-551000,-551000
20200312,057556,智易凱基99購01,,,,,0.00,0.00,0,0,0,0,0,0,0,0,0,0,0,0,0
20200312,057557,聯茂凱基99購04,1.64,1.64,1.64,1.64,-0.41,-20.0,10000,1,16400,0,0,0,0,0,0,10000,0,10000,10000
20200312,057558,致新凱基98購01,1.03,1.03,1.00,1.01,-0.10,-9.01,125000,3,126040,0,0,0,0,0,0,125000,0,125000,125000
20200312,057559,可成兆豐99購02,0.29,0.29,0.29,0.29,0.00,0.00,10000,1,2900,0,0,0,0,0,0,0,10000,-10000,-10000
20200312,05755P,臺股指中信99售04,1.57,1.95,1.57,1.91,+0.42,28.19,267000,43,473730,0,0,0,0,0,0,162000,105000,57000,57000
20200312,057560,華新科兆豐99購01,,,,,0.00,0.00,0,0,0,0,0,0,0,0,0,0,0,0,0
20200312,057561,大立光兆豐98購02,0.27,0.27,0.25,0.25,0.00,0.00,30000,2,7900,0,0,0,0,0,0,0,30000,-30000,-30000
20200312,057562,奇鋐兆豐98購01,0.94,0.96,0.80,0.84,-0.20,-19.23,68000,9,61010,0,0,0,0,0,0,55000,13000,42000,42000
20200312,057563,旭富國泰9A購01,2.05,2.05,1.48,1.48,-0.63,-29.86,554000,54,971690,0,0,0,0,0,0,278000,306000,-28000,-28000
20200312,057564,台積電富邦9B購03,0.17,0.17,0.12,0.13,-0.07,-35.0,1930000,33,271250,0,0,0,0,0,0,150000,1770000,-1620000,-1620000
20200312,057565,可成富邦99購01,0.21,0.21,0.21,0.21,-0.18,-46.15,30000,1,6300,0,0,0,0,0,0,30000,0,30000,30000
20200312,057566,欣興富邦99購01,0.28,0.28,0.24,0.24,-0.16,-40.0,18000,7,4420,0,0,0,0,0,0,0,18000,-18000,-18000
20200312,057567,嘉聯益富邦9A購01,0.71,0.71,0.69,0.69,-0.12,-14.81,40000,4,27800,0,0,0,0,0,0,40000,0,40000,40000
20200312,057568,友訊永豐99購01,0.21,0.21,0.14,0.15,-0.14,-48.28,86000,4,13290,0,0,0,0,0,0,71000,15000,56000,56000
20200312,057569,光磊永豐98購03,0.51,0.51,0.35,0.35,-0.35,-50.0,56000,5,22330,0,0,0,0,0,0,0,56000,-56000,-56000
20200312,05756P,臺股指中信99售05,2.44,2.44,2.44,2.44,+0.15,6.55,1000,1,2440,0,0,0,0,0,0,1000,0,1000,1000
20200312,057570,技嘉永豐98購02,0.26,0.26,0.23,0.23,-0.08,-25.81,20000,3,5050,0,0,0,0,0,0,5000,15000,-10000,-10000
20200312,057571,泰碩永豐98購01,1.60,1.60,1.33,1.33,-0.20,-13.07,20000,2,29300,0,0,0,0,0,0,10000,10000,0,0
20200312,057572,明泰永豐98購01,0.54,0.54,0.51,0.51,-0.19,-27.14,88000,3,45280,0,0,0,0,0,0,20000,68000,-48000,-48000
20200312,057573,京鼎永豐98購02,,,,,0.00,0.00,0,0,0,0,0,0,0,0,0,0,0,0,0
20200312,057574,中磊永豐98購01,0.63,0.63,0.43,0.44,-0.28,-38.89,24000,4,13390,0,0,0,0,0,0,9000,15000,-6000,-6000
20200312,057575,世紀鋼永豐98購02,1.87,1.91,1.85,1.91,-0.30,-13.57,25000,3,47050,0,0,0,0,0,0,10000,15000,-5000,-5000
20200312,057576,南亞科第一9C購01,0.51,0.51,0.51,0.51,-0.22,-30.14,40000,1,20400,0,0,0,0,0,0,40000,0,40000,40000
20200312,057577,廣宇中信9A購01,0.67,0.67,0.55,0.55,-0.21,-27.63,109000,6,69650,0,0,0,0,0,0,48000,61000,-13000,-13000
20200312,057578,可成中信99購01,0.45,0.45,0.33,0.33,-0.20,-37.74,31000,2,10350,0,0,0,0,0,0,1000,30000,-29000,-29000
20200312,057579,長榮航中信9A購01,0.58,0.58,0.51,0.51,-0.17,-25.0,400000,17,220730,0,0,0,0,0,0,360000,39000,321000,321000
20200312,05757P,旺宏永豐96售03,1.63,1.63,1.63,1.63,+0.12,7.95,39000,2,63570,0,0,0,0,0,0,10000,29000,-19000,-19000
20200312,057580,玉山金中信9A購01,0.63,0.63,0.63,0.63,-0.11,-14.86,10000,2,6300,0,0,0,0,0,0,0,10000,-10000,-10000
20200312,057581,元大金中信9A購01,0.58,0.58,0.56,0.56,-0.04,-6.67,48000,3,27080,0,0,0,0,0,0,48000,0,48000,48000
20200312,057582,亞光中信9A購02,,,,,0.00,0.00,0,0,0,0,0,0,0,0,0,0,0,0,0
20200312,057583,啟碁中信9A購01,0.73,0.73,0.73,0.73,-0.30,-29.13,38000,1,27740,0,0,0,0,0,0,0,38000,-38000,-38000
20200312,057584,國巨亞東99購01,,,,,0.00,0.00,0,0,0,0,0,0,0,0,0,0,0,0,0
20200312,057585,鴻海國票99購05,0.34,0.34,0.28,0.28,0.00,0.00,300000,3,95000,0,0,0,0,0,0,0,300000,-300000,-300000
20200312,057586,台積電國票99購06,0.57,0.57,0.36,0.45,-0.33,-42.31,545000,20,248630,0,0,0,0,0,0,255000,260000,-5000,-5000
20200312,057587,微星國票99購01,0.99,0.99,0.96,0.97,-0.10,-9.35,37000,3,36230,0,0,0,0,0,0,27000,15000,12000,12000
20200312,057588,南亞科國票99購01,,,,,0.00,0.00,0,0,0,0,0,0,0,0,0,0,0,0,0
20200312,057589,超眾國票9A購01,,,,,0.00,0.00,0,0,0,0,0,0,0,0,0,0,0,0,0
20200312,05758P,光罩永豐96售02,1.75,1.96,1.75,1.95,+0.29,17.47,169000,9,305150,0,0,0,0,0,0,106000,63000,43000,43000
20200312,057590,元油2X兆豐98購02,0.04,0.04,0.01,0.01,-0.03,-75.0,323000,10,12600,0,0,0,0,0,0,0,10000,-10000,-10000
20200312,057591,鴻海兆豐99購01,,,,,0.00,0.00,0,0,0,0,0,0,0,0,0,0,0,0,0
20200312,057592,美律兆豐99購01,0.68,0.68,0.68,0.68,-0.05,-6.85,35000,1,23800,0,0,0,0,0,0,0,35000,-35000,-35000
20200312,057593,聯發科兆豐98購03,,,,,0.00,0.00,0,0,0,0,0,0,0,0,0,0,0,0,0
20200312,057594,宏達電兆豐99購01,0.85,0.85,0.71,0.71,-0.27,-27.55,7000,2,5110,0,0,0,0,0,0,1000,6000,-5000,-5000
20200312,057595,健鼎兆豐98購01,0.59,0.59,0.52,0.55,-0.07,-11.29,40000,4,22100,0,0,0,0,0,0,10000,30000,-20000,-20000
20200312,057596,聯茂兆豐99購01,0.63,0.67,0.53,0.53,-0.27,-33.75,251000,9,154690,0,0,0,0,0,0,172000,79000,93000,93000
20200312,057597,華通群益9A購02,0.66,0.69,0.48,0.48,-0.40,-45.45,519000,31,314090,0,0,0,0,0,0,219000,338000,-119000,-119000
20200312,057598,鴻海群益98購07,0.78,0.78,0.60,0.61,-0.44,-41.9,5000,5,3220,0,0,0,0,0,0,5000,5000,0,0
20200312,057599,技嘉群益9A購01,0.59,0.59,0.52,0.52,-0.20,-27.78,37000,4,21100,0,0,0,0,0,0,27000,10000,17000,17000
20200312,05759P,智邦永豐96售02,0.92,1.04,0.92,0.96,+0.14,17.07,303000,11,298770,0,0,0,0,0,0,280000,73000,207000,207000
20200312,057600,大立光群益99購03,1.48,1.48,1.17,1.17,-1.09,-48.23,185000,13,250450,0,0,0,0,0,0,68000,117000,-49000,-49000
20200312,057601,中磊群益98購01,1.17,1.18,1.03,1.03,-0.24,-18.9,28000,5,31260,0,0,0,0,0,0,26000,18000,8000,8000
20200312,057602,聯茂群益98購02,1.34,1.34,0.92,0.94,-0.71,-43.03,290000,23,328550,0,0,0,0,0,0,191000,89000,102000,102000
20200312,057603,樺漢群益98購02,0.85,0.85,0.85,0.85,-0.15,-15.0,3000,1,2550,0,0,0,0,0,0,3000,0,3000,3000
20200312,057604,鴻海統一9C購01,0.50,0.50,0.43,0.43,-0.12,-21.82,50000,4,23800,0,0,0,0,0,0,0,50000,-50000,-50000
20200312,057605,旺宏統一99購03,,,,,0.00,0.00,0,0,0,0,0,0,0,0,0,0,0,0,0
20200312,057606,健策統一98購03,,,,,0.00,0.00,0,0,0,0,0,0,0,0,0,0,0,0,0
20200312,057607,旺宏台新98購02,,,,,0.00,0.00,0,0,0,0,0,0,0,0,0,0,0,0,0
20200312,057608,南亞科台新98購01,,,,,0.00,0.00,0,0,0,0,0,0,0,0,0,0,0,0,0
20200312,057609,友訊元富98購01,0.72,0.75,0.54,0.54,-0.29,-34.94,110000,8,74490,0,0,0,0,0,0,59000,50000,9000,9000
20200312,05760P,京鼎永豐96售02,2.08,2.17,2.08,2.17,+0.22,11.28,44000,3,94580,0,0,0,0,0,0,44000,0,44000,44000
20200312,057610,致茂元富98購02,0.53,0.53,0.42,0.42,-0.28,-40.0,110000,12,51200,0,0,0,0,0,0,90000,20000,70000,70000
20200312,057611,技嘉元富98購02,,,,,0.00,0.00,0,0,0,0,0,0,0,0,0,0,0,0,0
20200312,057612,瑞昱元富02購01,0.92,0.92,0.75,0.75,-0.33,-30.56,320000,4,273170,0,0,0,0,0,0,220000,100000,120000,120000
20200312,057613,瑞昱元富02購02,0.80,0.80,0.80,0.80,-0.17,-17.53,30000,2,24000,0,0,0,0,0,0,0,15000,-15000,-15000
20200312,057614,華新科元富99購04,,,,,0.00,0.00,0,0,0,0,0,0,0,0,0,0,0,0,0
20200312,057615,元油2X凱基98購02,0.13,0.13,0.09,0.09,-0.06,-40.0,1557000,123,158020,0,190000,-190000,0,0,0,0,1015000,-1015000,-1205000
20200312,057616,聯電凱基99購01,,,,,0.00,0.00,0,0,0,0,0,0,0,0,0,0,0,0,0
20200312,057617,國巨凱基99購06,0.58,0.58,0.52,0.52,-0.24,-31.58,44000,5,23600,0,0,0,0,0,0,0,44000,-44000,-44000
20200312,057618,台光電凱基99購01,0.82,0.82,0.68,0.79,-0.27,-25.47,55000,6,41800,0,0,0,0,0,0,0,55000,-55000,-55000
20200312,057619,玉晶光凱基98購02,,,,,0.00,0.00,0,0,0,0,0,0,0,0,0,0,0,0,0
20200312,05761P,嘉澤永豐96售01,1.68,1.95,1.68,1.95,+0.38,24.2,60000,6,109800,0,0,0,0,0,0,10000,50000,-40000,-40000
20200312,057620,康控凱基99購01,0.47,0.47,0.42,0.42,-0.15,-26.32,207000,6,89490,0,0,0,0,0,0,150000,57000,93000,93000
20200312,057621,崇越凱基98購01,0.45,0.45,0.36,0.40,-0.11,-21.57,208000,19,82740,0,0,0,0,0,0,72000,136000,-64000,-64000
20200312,057622,元油2X國泰99購03,,,,,0.00,0.00,0,0,0,0,0,0,0,0,0,0,0,0,0
20200312,057623,友訊國泰99購01,0.93,0.95,0.93,0.95,+0.04,4.4,53000,2,50150,0,0,0,0,0,0,53000,0,53000,53000
20200312,057624,新日興國泰99購01,0.60,0.60,0.60,0.60,-0.38,-38.78,98000,1,58800,0,0,0,0,0,0,98000,0,98000,98000
20200312,057625,泰鼎國泰9A購01,0.43,0.44,0.33,0.33,-0.11,-25.0,391000,15,147820,0,0,0,0,0,0,340000,49000,291000,291000
20200312,057626,技嘉富邦9A購01,,,,,0.00,0.00,0,0,0,0,0,0,0,0,0,0,0,0,0
20200312,057627,和大永豐98購01,0.24,0.24,0.24,0.24,-0.12,-33.33,100000,1,24000,0,0,0,0,0,0,0,100000,-100000,-100000
20200312,057628,旺宏永豐98購02,,,,,0.00,0.00,0,0,0,0,0,0,0,0,0,0,0,0,0
20200312,057629,泰碩永豐98購02,2.46,2.46,1.92,2.15,-0.31,-12.6,92000,6,197600,0,0,0,0,0,0,80000,12000,68000,68000
20200312,05762P,昇陽半永豐96售04,2.08,2.43,2.08,2.43,+0.63,35.0,43000,6,96140,0,0,0,0,0,0,31000,12000,19000,19000
20200312,057630,茂林永豐98購01,0.18,0.18,0.18,0.18,-0.15,-45.45,68000,1,12240,0,0,0,0,0,0,68000,0,68000,68000
20200312,057631,康控永豐98購02,0.36,0.36,0.36,0.36,-0.15,-29.41,68000,1,24480,0,0,0,0,0,0,68000,0,68000,68000
20200312,057632,傳奇永豐98購01,0.30,0.31,0.21,0.21,-0.12,-36.36,63000,4,18910,0,0,0,0,0,0,1000,62000,-61000,-61000
20200312,057633,緯穎永豐98購02,0.42,0.42,0.42,0.42,0.00,0.00,2000,1,840,0,0,0,0,0,0,0,2000,-2000,-2000
20200312,057634,道瓊反元大99購01,2.07,2.53,2.07,2.35,+0.55,30.56,176000,13,396010,0,0,0,0,0,0,146000,30000,116000,116000
20200312,057635,中鋼元大98購01,0.89,0.89,0.67,0.68,-0.27,-28.42,698000,26,482910,0,0,0,0,0,0,88000,610000,-522000,-522000
20200312,057636,上銀元大98購06,0.79,0.79,0.67,0.68,-0.42,-38.18,148000,7,110100,0,0,0,0,0,0,20000,128000,-108000,-108000
20200312,057637,上銀元大98購07,0.73,0.73,0.68,0.68,-0.16,-19.05,75000,2,51500,0,0,0,0,0,0,75000,0,75000,75000
20200312,057638,上銀元大99購01,0.91,0.91,0.75,0.75,-0.37,-33.04,100000,3,78000,0,0,0,0,0,0,100000,0,100000,100000
20200312,057639,國巨元大99購07,1.34,1.34,1.21,1.21,-0.30,-19.87,91000,4,119830,0,0,0,0,0,0,23000,68000,-45000,-45000
20200312,05763P,致新永豐96售01,1.21,1.30,1.18,1.30,+0.19,17.12,70000,7,87600,0,0,0,0,0,0,10000,60000,-50000,-50000
20200312,057640,台積電元大98購16,1.25,1.25,0.91,0.99,-0.64,-39.26,232000,17,251720,0,0,0,0,0,0,61000,225000,-164000,-164000
20200312,057641,旺宏元大98購10,1.15,1.17,1.09,1.13,-0.24,-17.52,169000,13,192850,0,0,0,0,0,0,101000,169000,-68000,-68000
20200312,057642,南亞科元大98購07,0.87,0.87,0.87,0.87,-0.42,-32.56,68000,1,59160,0,0,0,0,0,0,0,68000,-68000,-68000
20200312,057643,聯發科元大99購03,1.72,1.72,1.37,1.37,-0.50,-26.74,157000,14,254130,0,0,0,0,0,0,72000,127000,-55000,-55000
20200312,057644,奇力新元大98購04,0.51,0.51,0.36,0.36,-0.18,-33.33,322000,13,150570,0,0,0,0,0,0,317000,5000,312000,312000
20200312,057645,華新科元大99購11,1.49,1.49,1.03,1.04,-0.51,-32.9,132000,25,157690,0,0,0,0,0,0,17000,115000,-98000,-98000
20200312,057646,玉山金元大98購01,1.38,1.38,1.03,1.09,-0.30,-21.58,910000,32,1070910,0,0,0,0,0,0,0,910000,-910000,-910000
20200312,057647,欣興元大98購10,0.90,0.90,0.90,0.90,-0.64,-41.56,1000,1,900,0,0,0,0,0,0,0,1000,-1000,-1000
20200312,057648,和碩元大98購01,1.65,1.65,1.42,1.42,-0.63,-30.73,143000,6,228900,0,0,0,0,0,0,75000,83000,-8000,-8000
20200312,057649,嘉聯益元大99購04,1.07,1.07,1.07,1.07,-0.23,-17.69,10000,1,10700,0,0,0,0,0,0,10000,0,10000,10000
20200312,05764P,世紀鋼永豐96售03,0.50,0.52,0.48,0.52,+0.05,10.64,77000,4,38420,0,0,0,0,0,0,77000,0,77000,77000
20200312,057650,力成元大98購04,,,,,0.00,0.00,0,0,0,0,0,0,0,0,0,0,0,0,0
20200312,057651,矽力元大98購03,,,,,0.00,0.00,0,0,0,0,0,0,0,0,0,0,0,0,0
20200312,057652,欣興永昌9C購01,2.80,2.80,2.80,2.80,0.00,0.00,1000,1,2800,0,0,0,0,0,0,0,1000,-1000,-1000
20200312,057653,臺股指永昌98購01,,,,,0.00,0.00,0,0,0,0,0,0,0,0,0,0,0,0,0
20200312,057654,A50正2中信98購01,0.90,0.90,0.78,0.86,-0.14,-14.0,85000,5,74100,0,0,0,0,0,0,45000,40000,5000,5000
20200312,057655,奇力新中信98購05,,,,,0.00,0.00,0,0,0,0,0,0,0,0,0,0,0,0,0
20200312,057656,大成鋼兆豐98購01,0.91,0.96,0.91,0.95,-0.14,-12.84,559000,20,521610,0,0,0,0,0,0,281000,278000,3000,3000
20200312,057657,國巨兆豐98購04,0.27,0.27,0.17,0.17,-0.15,-46.88,33000,4,7110,0,0,0,0,0,0,10000,23000,-13000,-13000
20200312,057658,玉晶光兆豐99購02,0.65,0.65,0.51,0.51,-0.24,-32.0,89000,7,52500,0,0,0,0,0,0,49000,40000,9000,9000
20200312,057659,台表科兆豐98購01,0.39,0.39,0.31,0.31,-0.13,-29.55,416000,11,135880,0,0,0,0,0,0,50000,356000,-306000,-306000
20200312,05765P,臺股指永豐96售01,,,,,0.00,0.00,0,0,0,0,0,0,0,0,0,0,0,0,0
20200312,057660,訊芯兆豐98購02,,,,,0.00,0.00,0,0,0,0,0,0,0,0,0,0,0,0,0
20200312,057661,臺股指兆豐98購01,,,,,0.00,0.00,0,0,0,0,0,0,0,0,0,0,0,0,0
20200312,057662,上銀元大9A購01,,,,,0.00,0.00,0,0,0,0,0,0,0,0,0,0,0,0,0
20200312,057663,國巨元大99購08,0.88,0.88,0.48,0.67,-0.30,-30.93,81000,9,65730,0,0,0,0,0,0,19000,57000,-38000,-38000
20200312,057664,台積電元大9A購03,0.86,0.87,0.68,0.77,-0.16,-17.2,1325000,103,1041330,0,0,0,0,0,0,587000,889000,-302000,-302000
20200312,057665,技嘉元大99購01,0.86,0.86,0.86,0.86,-0.22,-20.37,220000,1,189200,0,0,0,0,0,0,220000,0,220000,220000
20200312,057666,奇力新元大9A購01,0.55,0.55,0.40,0.40,-0.20,-33.33,180000,12,86400,0,0,0,0,0,0,180000,0,180000,180000
20200312,057667,可成元大99購01,1.16,1.16,0.90,0.90,-0.52,-36.62,204000,9,208800,0,0,0,0,0,0,68000,136000,-68000,-68000
20200312,057668,華新科元大9A購01,0.80,0.80,0.64,0.64,-0.24,-27.27,35000,5,25900,0,0,0,0,0,0,0,35000,-35000,-35000
20200312,057669,嘉晶元大99購03,1.62,1.75,1.29,1.37,-0.26,-15.95,656000,53,1020100,0,0,0,0,0,0,282000,371000,-89000,-89000
20200312,05766P,A50正2凱基99售01,1.12,1.34,1.12,1.29,+0.19,17.27,302000,17,374370,0,0,0,0,0,0,253000,49000,204000,204000
20200312,057670,欣興元大99購02,1.66,1.66,1.37,1.37,-0.61,-30.81,130000,5,198640,0,0,0,0,0,0,58000,72000,-14000,-14000
20200312,057671,群創元大9B購06,0.85,0.85,0.83,0.83,-0.25,-23.15,11000,2,9250,0,0,0,0,0,0,11000,11000,0,0
20200312,057672,茂林元大98購02,1.38,1.38,0.97,0.97,-0.50,-34.01,604000,34,723600,0,0,0,0,0,0,466000,173000,293000,293000
20200312,057673,臻鼎元大98購01,1.24,1.24,0.86,0.90,-0.54,-37.5,211000,10,221360,0,0,0,0,0,0,165000,63000,102000,102000
20200312,057674,台郡元大99購03,0.96,0.96,0.81,0.83,-0.25,-23.15,239000,8,211130,0,0,0,0,0,0,140000,179000,-39000,-39000
20200312,057675,同欣電元大98購02,0.64,0.64,0.57,0.57,-0.49,-46.23,78000,2,49220,0,0,0,0,0,0,10000,68000,-58000,-58000
20200312,057676,臺股指元大98購06,1.58,1.58,1.00,1.04,-0.93,-47.21,232000,19,301210,0,0,0,0,0,0,0,232000,-232000,-232000
20200312,057677,臺股指元大98購07,0.14,0.14,0.14,0.14,-0.36,-72.0,40000,2,5600,0,0,0,0,0,0,0,0,0,0
20200312,057678,臺股指元大98購08,0.45,0.45,0.30,0.30,-0.32,-51.61,280000,5,122700,0,0,0,0,0,0,0,280000,-280000,-280000
20200312,057679,臺股指元大98購09,0.58,0.58,0.28,0.40,-0.31,-43.66,904000,15,460370,0,0,0,0,0,0,63000,841000,-778000,-778000
20200312,05767P,國巨凱基96售11,0.65,0.94,0.59,0.92,+0.42,84.0,322000,29,240830,0,0,0,0,0,0,190000,101000,89000,89000
20200312,057680,臺股指元大98購10,,,,,0.00,0.00,0,0,0,0,0,0,0,0,0,0,0,0,0
20200312,057681,T50反1日盛9C購01,,,,,0.00,0.00,0,0,0,0,0,0,0,0,0,0,0,0,0
20200312,057682,台積電日盛9A購03,0.75,0.75,0.56,0.56,-0.42,-42.86,188000,10,130900,0,0,0,0,0,0,168000,20000,148000,148000
20200312,057683,技嘉日盛98購01,0.40,0.40,0.40,0.40,-0.17,-29.82,10000,1,4000,0,0,0,0,0,0,10000,0,10000,10000
20200312,057684,聯茂日盛99購01,1.55,1.55,1.30,1.30,-0.79,-37.8,20000,2,28500,0,0,0,0,0,0,10000,10000,0,0
20200312,057685,台灣50凱基9C購01,0.66,0.66,0.49,0.50,-0.31,-38.27,139000,17,73020,0,0,0,0,0,0,0,99000,-99000,-99000
20200312,057686,中50凱基99購01,0.68,0.68,0.59,0.59,-0.18,-23.38,75000,7,47750,0,0,0,0,0,0,15000,60000,-45000,-45000
20200312,057687,中502X凱基98購01,0.15,0.15,0.15,0.15,-0.10,-40.0,10000,1,1500,0,0,0,0,0,0,0,10000,-10000,-10000
20200312,057688,國巨凱基99購07,0.52,0.52,0.42,0.42,-0.20,-32.26,22000,3,10340,0,0,0,0,0,0,1000,21000,-20000,-20000
20200312,057689,南亞科凱基99購02,,,,,0.00,0.00,0,0,0,0,0,0,0,0,0,0,0,0,0
20200312,05768P,台積電凱基96售15,1.87,2.71,1.87,2.34,+0.53,29.28,26000,10,61370,0,0,0,0,0,0,21000,5000,16000,16000
20200312,057690,美律凱基99購03,0.68,0.68,0.68,0.68,-0.12,-15.0,10000,1,6800,0,0,0,0,0,0,0,10000,-10000,-10000
20200312,057691,健策凱基99購01,0.44,0.44,0.41,0.41,-0.18,-30.51,20000,2,8500,0,0,0,0,0,0,10000,10000,0,0
20200312,057692,臺股指凱基98購10,0.48,0.53,0.31,0.37,-0.40,-51.95,525000,40,231500,0,0,0,0,0,0,145000,370000,-225000,-225000
20200312,057693,臺股指凱基98購11,0.18,0.18,0.18,0.18,-0.23,-56.1,10000,1,1800,0,0,0,0,0,0,0,10000,-10000,-10000
20200312,057694,臺股指凱基98購12,0.13,0.15,0.04,0.04,0.00,0.00,231000,7,11610,0,0,0,0,0,0,204000,27000,177000,177000
20200312,057695,S&P反1群益9B購01,,,,,0.00,0.00,0,0,0,0,0,0,0,0,0,0,0,0,0
20200312,057696,聯電群益9A購01,,,,,0.00,0.00,0,0,0,0,0,0,0,0,0,0,0,0,0
20200312,057697,國巨群益98購09,0.54,0.58,0.54,0.58,-0.34,-36.96,13000,2,7140,0,0,0,0,0,0,0,13000,-13000,-13000
20200312,057698,奇力新群益98購02,0.38,0.38,0.35,0.36,-0.09,-20.0,92000,14,34320,0,0,0,0,0,0,92000,0,92000,92000
20200312,057699,可成群益9A購02,0.95,0.95,0.95,0.95,-0.24,-20.17,73000,2,69350,0,0,0,0,0,0,73000,0,73000,73000
20200312,05769P,台積電凱基96售16,4.18,4.47,4.18,4.47,+0.81,22.13,17000,2,72510,0,0,0,0,0,0,12000,5000,7000,7000
20200312,057700,新日興群益9A購01,1.07,1.07,0.95,0.95,-0.32,-25.2,34000,2,33860,0,0,0,0,0,0,34000,0,34000,34000
20200312,057701,嘉聯益群益98購02,,,,,0.00,0.00,0,0,0,0,0,0,0,0,0,0,0,0,0
20200312,057702,同欣電群益99購01,0.41,0.41,0.29,0.29,-0.21,-42.0,282000,3,94040,0,0,0,0,0,0,174000,108000,66000,66000
20200312,057703,矽力群益98購01,0.66,0.66,0.59,0.60,-0.29,-32.58,389000,24,240610,0,0,0,0,0,0,97000,292000,-195000,-195000
20200312,057704,台虹群益98購03,1.47,1.52,1.47,1.52,-0.25,-14.12,56000,3,83870,0,0,0,0,0,0,11000,45000,-34000,-34000
20200312,057705,臺股指群益98購05,,,,,0.00,0.00,0,0,0,0,0,0,0,0,0,0,0,0,0
20200312,057706,臺股指群益98購06,,,,,0.00,0.00,0,0,0,0,0,0,0,0,0,0,0,0,0
20200312,057707,臺股指群益98購07,0.15,0.15,0.14,0.14,-0.23,-62.16,650000,3,93000,0,0,0,0,0,0,650000,0,650000,650000
20200312,057708,臺股指群益98購08,,,,,0.00,0.00,0,0,0,0,0,0,0,0,0,0,0,0,0
20200312,057709,電子類群益98購01,0.65,0.65,0.37,0.43,-0.39,-47.56,885000,40,430100,0,0,0,0,0,0,25000,860000,-835000,-835000
20200312,05770P,聯發科凱基96售16,1.42,2.24,1.42,2.24,+1.14,103.64,60000,10,109490,0,0,0,0,0,0,33000,27000,6000,6000
20200312,057710,金融類群益98購01,,,,,0.00,0.00,0,0,0,0,0,0,0,0,0,0,0,0,0
20200312,057711,台積電統一9A購03,0.33,0.33,0.28,0.32,-0.11,-25.58,1264000,9,392030,0,0,0,0,0,0,305000,959000,-654000,-654000
20200312,057712,南亞科統一9A購01,,,,,0.00,0.00,0,0,0,0,0,0,0,0,0,0,0,0,0
20200312,057713,美律統一99購01,0.69,0.69,0.55,0.55,-0.24,-30.38,102000,6,60280,0,0,0,0,0,0,52000,50000,2000,2000
20200312,057714,聯發科統一98購05,,,,,0.00,0.00,0,0,0,0,0,0,0,0,0,0,0,0,0
20200312,057715,聯發科統一99購03,0.56,0.56,0.43,0.43,0.00,0.00,121000,5,60780,0,0,0,0,0,0,0,121000,-121000,-121000
20200312,057716,神達統一98購01,1.00,1.00,0.86,0.89,-0.29,-24.58,155000,5,138370,0,0,0,0,0,0,55000,100000,-45000,-45000
20200312,057717,友訊元富98購02,0.58,0.58,0.42,0.42,-0.17,-28.81,130000,7,69000,0,0,0,0,0,0,90000,40000,50000,50000
20200312,057718,旺宏元富02購02,0.72,0.72,0.66,0.66,0.00,0.00,45000,2,30900,0,0,0,0,0,0,0,45000,-45000,-45000
20200312,057719,欣興元富02購01,0.68,0.68,0.68,0.68,0.00,0.00,10000,1,6800,0,0,0,0,0,0,0,10000,-10000,-10000
20200312,05771P,大立光凱基96售13,,,,,0.00,0.00,0,0,0,0,0,0,0,0,0,0,0,0,0
20200312,057720,日電貿元富98購01,0.76,0.76,0.76,0.76,0.00,0.00,1000,1,760,0,0,0,0,0,0,0,1000,-1000,-1000
20200312,057721,華擎元富98購02,0.70,0.70,0.59,0.59,-0.20,-25.32,98000,5,65440,0,0,0,0,0,0,88000,43000,45000,45000
20200312,057722,臺股指元富98購01,0.08,0.08,0.08,0.08,-0.33,-80.49,25000,3,2000,0,0,0,0,0,0,0,25000,-25000,-25000
20200312,057723,臺股指元富98購02,0.17,0.17,0.06,0.11,-0.11,-50.0,630000,37,70730,0,0,0,0,0,0,5000,25000,-20000,-20000
20200312,057724,亞德客國泰99購01,0.93,0.94,0.69,0.69,-0.41,-37.27,247000,9,183260,0,0,0,0,0,0,0,247000,-247000,-247000
20200312,057725,台達電國泰9A購01,0.99,0.99,0.72,0.72,0.00,0.00,120000,3,113400,0,0,0,0,0,0,100000,20000,80000,80000
20200312,057726,華通國泰9A購01,0.75,0.75,0.46,0.46,-0.41,-47.13,722000,28,442420,0,0,0,0,0,0,572000,190000,382000,382000
20200312,057727,華邦電國泰9A購01,1.48,1.48,1.06,1.13,-0.67,-37.22,70000,7,84500,0,0,0,0,0,0,10000,60000,-50000,-50000
20200312,057728,瑞昱國泰99購01,0.82,0.82,0.54,0.61,-0.32,-34.41,138000,13,90980,0,0,0,0,0,0,30000,108000,-78000,-78000
20200312,057729,華新科國泰99購04,,,,,0.00,0.00,0,0,0,0,0,0,0,0,0,0,0,0,0
20200312,05772P,景碩凱基96售02,1.01,1.21,1.01,1.20,+0.40,50.0,371000,9,413800,0,0,0,0,0,0,150000,371000,-221000,-221000
20200312,057730,聯鈞國泰9A購01,1.07,1.07,0.94,0.94,-0.26,-21.67,50000,4,50600,0,0,0,0,0,0,30000,20000,10000,10000
20200312,057731,華擎國泰9A購02,1.08,1.08,0.91,1.00,-0.17,-14.53,163000,6,154600,0,0,0,0,0,0,163000,103000,60000,60000
20200312,057732,牧德國泰9A購01,0.90,0.90,0.64,0.67,-0.44,-39.64,182000,9,125240,0,0,0,0,0,0,0,182000,-182000,-182000
20200312,057733,嘉聯益國泰99購01,1.06,1.06,0.80,0.86,-0.38,-30.65,40000,4,35300,0,0,0,0,0,0,10000,30000,-20000,-20000
20200312,057734,訊芯國泰9A購01,0.67,0.67,0.54,0.54,-0.21,-28.0,76000,9,47230,0,0,0,0,0,0,43000,33000,10000,10000
20200312,057735,台灣50富邦9C購02,1.22,1.22,0.84,0.91,-0.56,-38.1,336000,19,324850,0,0,0,0,0,0,166000,120000,46000,46000
20200312,057736,鴻海富邦99購04,,,,,0.00,0.00,0,0,0,0,0,0,0,0,0,0,0,0,0
20200312,057737,國巨富邦99購02,0.28,0.28,0.17,0.18,-0.09,-33.33,1460000,62,276080,50000,0,50000,0,0,0,415000,875000,-460000,-410000
20200312,057738,旺宏富邦9A購01,0.34,0.34,0.27,0.28,-0.14,-33.33,150000,4,45100,0,0,0,0,0,0,0,150000,-150000,-150000
20200312,057739,新日興富邦9B購01,0.41,0.41,0.31,0.31,-0.16,-34.04,27000,3,9170,0,0,0,0,0,0,7000,20000,-13000,-13000
20200312,05773P,臺股指凱基99售03,2.80,3.88,2.80,3.66,+1.02,38.64,519000,24,1816130,0,0,0,0,0,0,491000,228000,263000,263000
20200312,057740,茂林富邦9A購01,0.27,0.27,0.23,0.23,-0.07,-23.33,350000,4,82100,0,0,0,0,0,0,0,350000,-350000,-350000
20200312,057741,超眾富邦98購01,0.24,0.24,0.24,0.24,-0.10,-29.41,10000,1,2400,0,0,0,0,0,0,10000,0,10000,10000
20200312,057742,喬山永豐98購02,,,,,0.00,0.00,0,0,0,0,0,0,0,0,0,0,0,0,0
20200312,057743,華擎永豐98購03,0.29,0.36,0.29,0.32,-0.07,-17.95,127000,5,40740,0,0,0,0,0,0,40000,87000,-47000,-47000
20200312,057744,健策永豐98購02,0.15,0.15,0.11,0.11,-0.17,-60.71,22000,2,2900,0,0,0,0,0,0,10000,12000,-2000,-2000
20200312,057745,泰鼎永豐99購01,0.49,0.49,0.36,0.36,-0.16,-30.77,87000,6,38170,0,0,0,0,0,0,75000,12000,63000,63000
20200312,057746,同欣電永豐98購02,0.16,0.16,0.16,0.16,-0.04,-20.0,5000,1,800,0,0,0,0,0,0,5000,0,5000,5000
20200312,057747,致新永豐98購01,0.48,0.48,0.39,0.41,-0.13,-24.07,214000,4,97450,0,0,0,0,0,0,160000,54000,106000,106000
20200312,057748,華通國票98購04,1.21,1.21,0.73,0.73,-0.60,-45.11,225000,23,261490,0,0,0,0,0,0,205000,20000,185000,185000
20200312,057749,華新科國票99購01,0.83,0.83,0.49,0.50,-0.47,-48.45,1288000,17,691730,0,0,0,0,0,0,20000,1268000,-1248000,-1248000
20200312,05774P,臺股指凱基99售04,3.07,4.12,3.07,3.98,+1.14,40.14,351000,37,1271040,0,0,0,0,0,0,227000,139000,88000,88000
20200312,057750,神達國票99購01,0.65,0.65,0.50,0.56,-0.22,-28.21,502000,22,277570,0,0,0,0,0,0,344000,158000,186000,186000
20200312,057751,神達國票99購02,2.81,2.81,2.50,2.58,-0.56,-17.83,76000,7,200660,0,0,0,0,0,0,26000,50000,-24000,-24000
20200312,057752,臺股指國票98購08,0.46,0.46,0.40,0.40,-0.37,-48.05,62000,4,26600,0,0,0,0,0,0,30000,12000,18000,18000
20200312,057753,臺股指國票98購09,0.62,0.62,0.19,0.22,-0.44,-66.67,471000,15,119720,0,0,0,0,0,0,370000,36000,334000,334000
20200312,057754,臺股指國票98購10,0.24,0.24,0.19,0.19,0.00,0.00,70000,5,14800,0,0,0,0,0,0,30000,40000,-10000,-10000
20200312,057755,鴻海日盛98購01,0.55,0.55,0.55,0.55,-0.49,-47.12,1000,1,550,0,0,0,0,0,0,1000,1000,0,0
20200312,057756,瑞昱日盛99購01,0.65,0.65,0.65,0.65,-0.26,-28.57,16000,1,10400,0,0,0,0,0,0,16000,0,16000,16000
20200312,057757,鴻海凱基98購13,1.51,1.56,1.18,1.20,-0.59,-32.96,511000,34,671310,0,0,0,0,0,0,195000,346000,-151000,-151000
20200312,057758,鴻海凱基99購03,0.66,0.66,0.54,0.54,-0.34,-38.64,136000,2,81600,0,0,0,0,0,0,68000,68000,0,0
20200312,057759,聯發科凱基98購17,1.39,1.39,0.94,0.94,-0.68,-41.98,283000,29,314770,0,0,0,0,0,0,143000,230000,-87000,-87000
20200312,05775P,台積電國泰98售02,2.34,2.56,2.34,2.38,+0.29,13.88,80000,8,198600,0,0,0,0,0,0,0,80000,-80000,-80000
20200312,057760,聯發科凱基98購18,0.54,0.54,0.54,0.54,-0.32,-37.21,30000,1,16200,0,0,0,0,0,0,0,30000,-30000,-30000
20200312,057761,聯發科凱基99購04,1.19,1.19,1.19,1.19,0.00,0.00,98000,1,116620,0,0,0,0,0,0,0,98000,-98000,-98000
20200312,057762,全新凱基99購03,,,,,0.00,0.00,0,0,0,0,0,0,0,0,0,0,0,0,0
20200312,057763,康控凱基99購02,0.32,0.32,0.31,0.31,-0.20,-39.22,15000,2,4750,0,0,0,0,0,0,0,15000,-15000,-15000
20200312,057764,台表科凱基9A購01,0.39,0.39,0.32,0.32,-0.21,-39.62,119000,2,39480,0,0,0,0,0,0,20000,99000,-79000,-79000
20200312,057765,康舒凱基98購01,0.47,0.47,0.39,0.39,-0.25,-39.06,6000,2,2580,0,0,0,0,0,0,0,6000,-6000,-6000
20200312,057766,矽力凱基98購03,1.55,1.55,1.43,1.43,-0.22,-13.33,27000,3,41070,0,0,0,0,0,0,27000,0,27000,27000
20200312,057767,緯穎凱基98購06,0.71,0.72,0.58,0.58,-0.28,-32.56,45000,5,30150,0,0,0,0,0,0,15000,30000,-15000,-15000
20200312,057768,華新科中信9A購01,0.39,0.39,0.27,0.27,-0.16,-37.21,344000,11,110640,0,0,0,0,0,0,208000,136000,72000,72000
20200312,057769,T50反1群益98購02,1.08,1.45,1.08,1.40,+0.40,40.0,1355000,41,1814120,0,0,0,0,0,0,1273000,1132000,141000,141000
20200312,05776P,鴻海統一98售02,,,,,0.00,0.00,0,0,0,0,0,0,0,0,0,0,0,0,0
20200312,057770,亞德客群益98購01,0.87,0.87,0.68,0.68,-0.36,-34.62,65000,6,53050,0,0,0,0,0,0,15000,50000,-35000,-35000
20200312,057771,鴻海群益99購01,2.62,2.62,2.04,2.13,-0.89,-29.47,114000,29,289010,0,0,0,0,0,0,80000,58000,22000,22000
20200312,057772,台積電群益99購01,2.50,2.50,1.83,2.32,-0.56,-19.44,682000,46,1572890,0,0,0,0,0,0,561000,655000,-94000,-94000
20200312,057773,技嘉群益9A購02,0.74,0.74,0.74,0.74,-0.15,-16.85,19000,1,14060,0,0,0,0,0,0,19000,0,19000,19000
20200312,057774,台光電群益99購02,1.11,1.11,1.08,1.08,-0.26,-19.4,45000,4,49590,0,0,0,0,0,0,45000,35000,10000,10000
20200312,057775,南亞科群益98購02,,,,,0.00,0.00,0,0,0,0,0,0,0,0,0,0,0,0,0
20200312,057776,京元電群益98購02,1.67,1.67,1.16,1.27,-0.62,-32.8,171000,22,264220,0,0,0,0,0,0,125000,45000,80000,80000
20200312,057777,可成群益9A購03,0.75,0.75,0.63,0.65,-0.51,-43.97,256000,10,177090,0,0,0,0,0,0,124000,102000,22000,22000
20200312,057778,大立光群益98購02,1.22,1.24,0.91,0.91,-1.25,-57.87,128000,4,152960,0,0,0,0,0,0,10000,118000,-108000,-108000
20200312,057779,禾伸堂群益98購02,0.86,0.86,0.86,0.86,-0.15,-14.85,1000,1,860,0,0,0,0,0,0,1000,1000,0,0
20200312,05777P,台積電統一96售04,3.88,4.66,3.88,4.43,+1.22,38.01,78000,20,330950,0,0,0,0,0,0,66000,42000,24000,24000
20200312,057780,台郡群益98購02,1.00,1.00,0.79,0.79,-0.42,-34.71,342000,10,311280,0,0,0,0,0,0,312000,36000,276000,276000
20200312,057781,國巨國票99購04,0.85,0.85,0.52,0.60,-0.36,-37.5,366000,8,214360,0,0,0,0,0,0,126000,240000,-114000,-114000
20200312,057782,台積電國票99購07,1.19,1.19,0.90,1.04,-0.34,-24.64,500000,20,514270,0,0,0,0,0,0,358000,137000,221000,221000
20200312,057783,台積電國票9A購01,0.92,0.93,0.73,0.76,-0.44,-36.67,272000,6,208760,0,0,0,0,0,0,232000,40000,192000,192000
20200312,057784,台積電國票9B購01,0.74,0.74,0.50,0.64,-0.32,-33.33,450000,19,276940,0,0,0,0,0,0,55000,395000,-340000,-340000
20200312,057785,智邦國票99購02,1.15,1.15,1.15,1.15,-0.50,-30.3,15000,1,17250,0,0,0,0,0,0,15000,0,15000,15000
20200312,057786,聯發科國票98購05,0.94,0.94,0.50,0.58,-0.64,-52.46,419000,33,283120,0,0,0,0,0,0,72000,347000,-275000,-275000
20200312,057787,TPK國票99購01,1.05,1.05,0.75,0.75,-0.59,-44.03,170000,26,169790,0,0,0,0,0,0,112000,58000,54000,54000
20200312,057788,嘉聯益國票99購01,,,,,0.00,0.00,0,0,0,0,0,0,0,0,0,0,0,0,0
20200312,057789,上銀統一9A購01,0.67,0.67,0.57,0.57,-0.31,-35.23,136000,9,89230,0,0,0,0,0,0,133000,3000,130000,130000
20200312,05778P,台積電統一96售05,4.24,4.24,4.14,4.14,+0.87,26.61,22000,2,91280,0,0,0,0,0,0,20000,2000,18000,18000
20200312,057790,台積電統一99購04,0.33,0.33,0.30,0.30,-0.17,-36.17,15000,2,4800,0,0,0,0,0,0,0,15000,-15000,-15000
20200312,057791,可成統一99購01,,,,,0.00,0.00,0,0,0,0,0,0,0,0,0,0,0,0,0
20200312,057792,群創統一99購01,,,,,0.00,0.00,0,0,0,0,0,0,0,0,0,0,0,0,0
20200312,057793,群創統一99購02,,,,,0.00,0.00,0,0,0,0,0,0,0,0,0,0,0,0,0
20200312,057794,T50反1兆豐99購02,1.38,1.38,1.38,1.38,0.00,0.00,2000,1,2760,0,0,0,0,0,0,0,2000,-2000,-2000
20200312,057795,鴻海兆豐99購02,0.54,0.54,0.46,0.46,-0.20,-30.3,30000,5,14640,0,0,0,0,0,0,15000,15000,0,0
20200312,057796,鴻海兆豐99購03,0.60,0.60,0.46,0.47,-0.24,-33.8,129000,10,65690,0,0,0,0,0,0,10000,119000,-109000,-109000
20200312,057797,大立光兆豐99購01,0.79,0.79,0.79,0.79,-0.48,-37.8,38000,1,30020,0,0,0,0,0,0,38000,0,38000,38000
20200312,057798,貿聯兆豐99購01,0.56,0.56,0.46,0.46,-0.21,-31.34,428000,21,222650,0,0,0,0,0,0,268000,160000,108000,108000
20200312,057799,世紀鋼兆豐98購01,1.25,1.27,1.08,1.21,-0.14,-10.37,134000,16,159980,0,0,0,0,0,0,5000,129000,-124000,-124000
20200312,05779P,台積電統一96售06,,,,,0.00,0.00,0,0,0,0,0,0,0,0,0,0,0,0,0
20200312,057800,元油2X元大98購18,,,,,0.00,0.00,0,0,0,0,0,0,0,0,0,0,0,0,0
20200312,057801,元油2X元大98購19,,,,,0.00,0.00,0,0,0,0,0,0,0,0,0,0,0,0,0
20200312,057802,卜蜂元大98購01,1.73,1.73,1.49,1.53,-0.27,-15.0,22000,6,36300,0,0,0,0,0,0,12000,10000,2000,2000
20200312,057803,上銀元大98購08,0.58,0.58,0.58,0.58,-0.39,-40.21,68000,1,39440,0,0,0,0,0,0,68000,0,68000,68000
20200312,057804,為升元大98購01,0.83,0.83,0.58,0.60,-0.42,-41.18,262000,18,178170,0,0,0,0,0,0,23000,250000,-227000,-227000
20200312,057805,華通元大98購06,1.87,1.88,1.39,1.39,-0.54,-27.98,329000,24,532840,0,0,0,0,0,0,329000,40000,289000,289000
20200312,057806,國巨元大98購20,1.11,1.15,0.74,0.74,-0.50,-40.32,1028000,27,966990,0,0,0,0,0,0,942000,81000,861000,861000
20200312,057807,友訊元大98購02,1.09,1.09,0.83,0.83,-0.29,-25.89,99000,5,85130,0,0,0,0,0,0,0,99000,-99000,-99000
20200312,057808,旺宏元大99購05,,,,,0.00,0.00,0,0,0,0,0,0,0,0,0,0,0,0,0
20200312,057809,英業達元大98購01,1.66,1.66,1.51,1.53,-0.14,-8.38,68000,4,106040,0,0,0,0,0,0,68000,0,68000,68000
20200312,05780P,台積電統一96售07,2.54,3.03,2.54,2.75,+0.36,15.06,38000,9,104800,0,0,0,0,0,0,13000,20000,-7000,-7000
20200312,057810,技嘉元大98購06,0.68,0.68,0.68,0.68,-0.11,-13.92,43000,1,29240,0,0,0,0,0,0,43000,0,43000,43000
20200312,057811,南亞科元大98購08,0.75,0.77,0.56,0.60,-0.51,-45.95,103000,6,74550,0,0,0,0,0,0,5000,88000,-83000,-83000
20200312,057812,友達元大9A購05,,,,,0.00,0.00,0,0,0,0,0,0,0,0,0,0,0,0,0
20200312,057813,京元電元大98購03,1.41,1.41,1.14,1.19,-0.32,-21.19,146000,6,184840,0,0,0,0,0,0,78000,118000,-40000,-40000
20200312,057814,聯發科元大98購12,1.40,1.42,1.08,1.08,-0.49,-31.21,468000,14,616740,0,0,0,0,0,0,290000,178000,112000,112000
20200312,057815,信邦元大98購01,1.25,1.25,1.18,1.25,-0.31,-19.87,72000,3,85240,0,0,0,0,0,0,4000,68000,-64000,-64000
20200312,057816,欣興元大98購13,,,,,0.00,0.00,0,0,0,0,0,0,0,0,0,0,0,0,0
20200312,057817,景碩元大98購01,1.74,1.74,1.74,1.74,-0.29,-14.29,10000,1,17400,0,0,0,0,0,0,10000,0,10000,10000
20200312,057818,泰碩元大9A購01,2.58,2.58,2.26,2.44,-0.30,-10.95,34000,12,82900,0,0,0,0,0,0,19000,15000,4000,4000
20200312,057819,新日興元大99購01,1.33,1.33,1.21,1.21,-0.18,-12.95,136000,6,167660,0,0,0,0,0,0,68000,68000,0,0
20200312,05781P,臺股指統一99售02,,,,,0.00,0.00,0,0,0,0,0,0,0,0,0,0,0,0,0
20200312,057820,華擎元大98購02,0.50,0.51,0.48,0.50,-0.10,-16.67,115000,7,57050,0,0,0,0,0,0,60000,95000,-35000,-35000
20200312,057821,晶相光元大98購03,1.18,1.18,1.18,1.18,-0.17,-12.59,15000,1,17700,0,0,0,0,0,0,15000,0,15000,15000
20200312,057822,牧德元大9A購01,,,,,0.00,0.00,0,0,0,0,0,0,0,0,0,0,0,0,0
20200312,057823,神達元大98購01,1.50,1.50,1.32,1.40,-0.43,-23.5,98000,8,133540,0,0,0,0,0,0,55000,43000,12000,12000
20200312,057824,日月光元大98購01,1.26,1.26,0.89,0.92,-0.47,-33.81,427000,19,458940,0,0,0,0,0,0,224000,203000,21000,21000
20200312,057825,和碩元大98購02,1.09,1.10,0.93,0.93,-0.24,-20.51,351000,18,352170,0,0,0,0,0,0,233000,128000,105000,105000
20200312,057826,祥碩元大98購08,1.33,1.33,1.00,1.15,-0.57,-33.14,774000,13,806950,0,0,0,0,0,0,150000,724000,-574000,-574000
20200312,057827,康友元大98購03,1.39,1.39,1.09,1.11,-0.34,-23.45,163000,15,207820,0,0,0,0,0,0,100000,95000,5000,5000
20200312,057828,緯穎元大99購02,1.30,1.30,1.06,1.06,-0.71,-40.11,88000,3,110500,0,0,0,0,0,0,0,88000,-88000,-88000
20200312,057829,臺股指元大98購12,0.48,0.48,0.48,0.48,-0.16,-25.0,21000,1,10080,0,0,0,0,0,0,0,21000,-21000,-21000
20200312,05782P,聯詠元富96售02,1.54,1.75,1.54,1.63,+0.17,11.64,194000,13,315630,0,0,0,0,0,0,94000,100000,-6000,-6000
20200312,057830,T50反1台新02購02,,,,,0.00,0.00,0,0,0,0,0,0,0,0,0,0,0,0,0
20200312,057831,聯發科元富02購04,1.09,1.09,0.87,0.90,-0.29,-24.37,217000,9,210140,0,0,0,0,0,0,66000,151000,-85000,-85000
20200312,057832,聯發科元富02購05,1.09,1.09,0.87,0.87,-0.36,-29.27,121000,6,115610,0,0,0,0,0,0,18000,103000,-85000,-85000
20200312,057833,聯發科元富02購06,1.03,1.03,1.03,1.03,-0.23,-18.25,12000,1,12360,0,0,0,0,0,0,12000,0,12000,12000
20200312,057834,聯發科元富02購07,0.76,0.76,0.65,0.65,0.00,0.00,104000,3,78580,0,0,0,0,0,0,0,104000,-104000,-104000
20200312,057835,華擎元富9B購01,1.01,1.01,0.94,0.96,-0.25,-20.66,177000,5,175580,0,0,0,0,0,0,177000,0,177000,177000
20200312,057836,南亞科國泰9A購01,0.76,0.76,0.70,0.70,-0.16,-18.6,100000,3,71500,0,0,0,0,0,0,100000,0,100000,100000
20200312,057837,康控國泰99購02,0.88,0.88,0.88,0.88,-0.31,-26.05,44000,1,38720,0,0,0,0,0,0,44000,0,44000,44000
20200312,057838,台郡國泰99購01,1.57,1.57,1.09,1.09,-0.68,-38.42,118000,5,145530,0,0,0,0,0,0,44000,115000,-71000,-71000
20200312,057839,台積電富邦9A購02,0.26,0.26,0.26,0.26,0.00,0.00,107000,2,27820,0,0,0,0,0,0,0,107000,-107000,-107000
20200312,05783P,嘉澤元富96售01,1.82,2.10,1.82,2.09,+0.43,25.9,145000,14,276530,0,0,0,0,0,0,104000,41000,63000,63000
20200312,057840,健策富邦99購01,0.18,0.18,0.18,0.18,0.00,0.00,5000,1,900,0,0,0,0,0,0,0,5000,-5000,-5000
20200312,057841,茂林富邦9A購02,0.28,0.28,0.26,0.26,-0.04,-13.33,127000,3,33240,0,0,0,0,0,0,12000,115000,-103000,-103000
20200312,057842,緯穎富邦99購02,0.41,0.41,0.30,0.33,-0.12,-26.67,201000,12,68630,0,0,0,0,0,0,7000,191000,-184000,-184000
20200312,057843,晶技永豐98購02,1.47,1.47,0.85,0.85,-0.68,-44.44,106000,2,90720,0,0,0,0,0,0,106000,1000,105000,105000
20200312,057844,新日興永豐99購01,,,,,0.00,0.00,0,0,0,0,0,0,0,0,0,0,0,0,0
20200312,057845,晶相光永豐98購03,0.38,0.38,0.25,0.25,-0.22,-46.81,200000,8,68800,0,0,0,0,0,0,15000,180000,-165000,-165000
20200312,057846,神達永豐98購01,0.51,0.51,0.41,0.47,-0.24,-33.8,361000,8,165750,0,0,0,0,0,0,123000,238000,-115000,-115000
20200312,057847,聯茂永豐98購01,0.67,0.67,0.53,0.53,-0.49,-48.04,72000,2,47680,0,0,0,0,0,0,0,72000,-72000,-72000
20200312,057848,台表科永豐98購02,,,,,0.00,0.00,0,0,0,0,0,0,0,0,0,0,0,0,0
20200312,057849,南茂永豐98購02,0.49,0.52,0.49,0.52,-0.24,-31.58,77000,4,39060,0,0,0,0,0,0,20000,57000,-37000,-37000
20200312,05784P,臺股指元大96售18,4.93,5.05,4.93,5.05,+0.50,10.99,10000,2,49900,0,0,0,0,0,0,10000,0,10000,10000
20200312,057850,上銀兆豐99購02,,,,,0.00,0.00,0,0,0,0,0,0,0,0,0,0,0,0,0
20200312,057851,鴻海國票99購06,0.22,0.22,0.16,0.16,-0.16,-50.0,46000,5,8960,0,0,0,0,0,0,10000,36000,-26000,-26000
20200312,057852,國巨國票99購05,1.04,1.04,0.76,0.89,-0.30,-25.21,210000,8,186900,0,0,0,0,0,0,70000,140000,-70000,-70000
20200312,057853,旺宏國票99購05,,,,,0.00,0.00,0,0,0,0,0,0,0,0,0,0,0,0,0
20200312,057854,聯發科國票99購03,1.75,1.75,1.75,1.75,-0.24,-12.06,10000,1,17500,0,0,0,0,0,0,10000,0,10000,10000
20200312,057855,晶技國票99購01,4.60,4.68,2.80,2.81,-1.97,-41.21,486000,33,1628050,0,0,0,0,0,0,382000,123000,259000,259000
20200312,057856,聯鈞國票99購03,1.48,1.49,1.13,1.13,-0.88,-43.78,25000,3,35350,0,0,0,0,0,0,15000,10000,5000,5000
20200312,057857,牧德國票99購01,0.77,0.77,0.69,0.69,-0.29,-29.59,20000,2,14600,0,0,0,0,0,0,20000,0,20000,20000
20200312,057858,T50正2康和98購01,0.20,0.20,0.11,0.12,-0.15,-55.56,265000,5,35500,0,0,0,0,0,0,0,265000,-265000,-265000
20200312,057859,神達康和98購01,,,,,0.00,0.00,0,0,0,0,0,0,0,0,0,0,0,0,0
20200312,05785P,臺股指元大96售19,4.46,5.25,4.46,5.25,+1.29,32.58,19000,4,94740,0,0,0,0,0,0,19000,0,19000,19000
20200312,057860,金寶凱基98購01,0.39,0.39,0.34,0.36,-0.17,-32.08,60000,4,22000,0,0,0,0,0,0,30000,30000,0,0
20200312,057861,台積電凱基98購16,0.51,0.62,0.50,0.61,-0.16,-20.78,384000,41,210980,0,0,0,0,0,0,80000,304000,-224000,-224000
20200312,057862,智邦凱基99購01,0.81,0.82,0.59,0.62,-0.20,-24.39,544000,41,356560,0,0,0,0,0,0,145000,384000,-239000,-239000
20200312,057863,美律凱基9A購01,0.67,0.67,0.55,0.58,-0.19,-24.68,170000,8,108500,0,0,0,0,0,0,100000,70000,30000,30000
20200312,057864,奇力新凱基99購03,0.48,0.48,0.35,0.37,-0.13,-26.0,651000,18,269340,0,0,0,0,0,0,361000,290000,71000,71000
20200312,057865,富邦金凱基98購01,,,,,0.00,0.00,0,0,0,0,0,0,0,0,0,0,0,0,0
20200312,057866,玉山金凱基98購01,0.43,0.44,0.39,0.42,-0.13,-23.64,61000,7,25970,0,0,0,0,0,0,11000,50000,-39000,-39000
20200312,057867,大立光凱基98購17,,,,,0.00,0.00,0,0,0,0,0,0,0,0,0,0,0,0,0
20200312,057868,大立光凱基98購18,,,,,0.00,0.00,0,0,0,0,0,0,0,0,0,0,0,0,0
20200312,057869,大立光凱基99購01,,,,,0.00,0.00,0,0,0,0,0,0,0,0,0,0,0,0,0
20200312,05786P,臺股指永昌96售03,22.50,22.50,21.00,21.00,+8.00,61.54,31000,2,652500,0,0,0,0,0,0,31000,30000,1000,1000
20200312,057870,大立光凱基99購02,1.48,1.48,1.32,1.32,0.00,0.00,100000,2,140000,0,0,0,0,0,0,0,100000,-100000,-100000
20200312,057871,國巨元大99購09,0.87,0.87,0.65,0.65,-0.28,-30.11,20000,2,15200,0,0,0,0,0,0,0,20000,-20000,-20000
20200312,057872,旺宏元大99購06,1.17,1.17,0.98,0.98,-0.46,-31.94,78000,2,89360,0,0,0,0,0,0,0,78000,-78000,-78000
20200312,057873,義隆元大98購03,1.90,1.90,1.74,1.75,-0.67,-27.69,82000,4,150900,0,0,0,0,0,0,10000,82000,-72000,-72000
20200312,057874,可成元大99購02,1.28,1.28,0.87,0.89,-0.65,-42.21,125000,8,142510,0,0,0,0,0,0,125000,50000,75000,75000
20200312,057875,京鼎元大98購03,0.69,0.69,0.50,0.50,-0.42,-45.65,293000,8,162560,0,0,0,0,0,0,93000,200000,-107000,-107000
20200312,057876,隆達元大98購01,1.30,1.30,1.02,1.02,-0.58,-36.25,42000,4,52440,0,0,0,0,0,0,22000,20000,2000,2000
20200312,057877,神達元大99購01,2.11,2.11,1.99,1.99,-0.68,-25.47,59000,3,123890,0,0,0,0,0,0,50000,9000,41000,41000
20200312,057878,台郡元大99購04,2.20,2.20,1.81,1.85,-0.71,-27.73,33000,4,64030,0,0,0,0,0,0,23000,16000,7000,7000
20200312,057879,電子類元大99購02,0.77,0.77,0.67,0.67,-0.35,-34.31,81000,5,57390,0,0,0,0,0,0,0,81000,-81000,-81000
20200312,05787P,臺股指永昌96售04,25.00,25.00,23.00,23.00,+10.00,76.92,31000,2,715000,0,0,0,0,0,0,30000,31000,-1000,-1000
20200312,057880,金融類元大99購02,0.37,0.37,0.37,0.37,-0.17,-31.48,10000,1,3700,0,0,0,0,0,0,0,10000,-10000,-10000
20200312,057881,SP黃豆群益9A購01,,,,,0.00,0.00,0,0,0,0,0,0,0,0,0,0,0,0,0
20200312,057882,華通群益9A購03,1.08,1.10,0.98,1.03,-0.43,-29.45,61000,12,63490,0,0,0,0,0,0,61000,40000,21000,21000
20200312,057883,中環群益98購01,0.45,0.45,0.30,0.30,-0.29,-49.15,21000,10,7900,0,0,0,0,0,0,11000,10000,1000,1000
20200312,057884,華邦電群益98購02,0.87,0.88,0.62,0.62,-0.46,-42.59,214000,7,166230,0,0,0,0,0,0,51000,163000,-112000,-112000
20200312,057885,台光電群益98購04,1.34,1.34,1.03,1.05,-0.44,-29.53,226000,17,265630,0,0,0,0,0,0,43000,208000,-165000,-165000
20200312,057886,聯詠群益98購01,0.95,0.95,0.87,0.87,-0.29,-25.0,175000,6,158110,0,0,0,0,0,0,77000,98000,-21000,-21000
20200312,057887,智原群益98購04,,,,,0.00,0.00,0,0,0,0,0,0,0,0,0,0,0,0,0
20200312,057888,貿聯群益98購02,0.98,1.00,0.70,0.75,-0.57,-43.18,230000,17,219900,0,0,0,0,0,0,194000,10000,184000,184000
20200312,057889,致新群益99購01,0.68,0.68,0.55,0.55,-0.24,-30.38,276000,5,169340,0,0,0,0,0,0,178000,98000,80000,80000
20200312,05788P,臺股指永昌96售05,15.00,25.00,15.00,19.00,+12.65,199.21,123000,24,2430000,0,0,0,0,0,0,123000,30000,93000,93000
20200312,057890,滬深反統一98購01,1.00,1.05,1.00,1.05,+0.16,17.98,57000,5,58180,0,0,0,0,0,0,50000,7000,43000,43000
20200312,057891,華新科統一9A購01,0.61,0.61,0.47,0.47,-0.20,-29.85,901000,23,460900,0,0,0,0,0,0,381000,510000,-129000,-129000
20200312,057892,上証2X元富02購01,1.77,1.77,1.77,1.77,-0.62,-25.94,100000,1,177000,0,0,0,0,0,0,0,100000,-100000,-100000
20200312,057893,亞德客元富98購03,0.88,0.88,0.81,0.81,-0.21,-20.59,17000,2,14470,0,0,0,0,0,0,17000,0,17000,17000
20200312,057894,華通元富02購02,1.10,1.10,1.10,1.10,-0.39,-26.17,12000,1,13200,0,0,0,0,0,0,12000,0,12000,12000
20200312,057895,全新元富9B購01,,,,,0.00,0.00,0,0,0,0,0,0,0,0,0,0,0,0,0
20200312,057896,嘉晶元富98購01,2.15,2.33,2.04,2.04,-0.34,-14.29,70000,9,154780,0,0,0,0,0,0,20000,50000,-30000,-30000
20200312,057897,華通富邦99購01,0.30,0.30,0.18,0.18,-0.22,-55.0,112000,4,21400,0,0,0,0,0,0,2000,110000,-108000,-108000
20200312,057898,元油2X永豐98購06,,,,,0.00,0.00,0,0,0,0,0,0,0,0,0,0,0,0,0
20200312,057899,台積電永豐98購04,0.55,0.55,0.47,0.50,-0.14,-21.88,281000,13,143470,0,0,0,0,0,0,68000,213000,-145000,-145000
20200312,05789P,臺股指永昌96售06,15.00,25.00,15.00,19.00,+13.40,239.29,82000,16,1676000,0,0,0,0,0,0,82000,30000,52000,52000
20200312,057900,南亞科永豐98購01,0.12,0.13,0.12,0.13,-0.15,-53.57,201000,3,26120,0,0,0,0,0,0,1000,200000,-199000,-199000
20200312,057901,大立光永豐98購04,,,,,0.00,0.00,0,0,0,0,0,0,0,0,0,0,0,0,0
20200312,057902,嘉晶永豐98購02,0.90,0.95,0.84,0.84,-0.06,-6.67,127000,10,114240,0,0,0,0,0,0,76000,51000,25000,25000
20200312,057903,聯鈞永豐99購01,0.57,0.57,0.57,0.57,-0.21,-26.92,5000,1,2850,0,0,0,0,0,0,5000,0,5000,5000
20200312,057904,矽力永豐98購01,0.56,0.56,0.53,0.55,-0.20,-26.67,121000,10,65850,0,0,0,0,0,0,79000,2000,77000,77000
20200312,057905,臺股指永豐98購06,0.10,0.10,0.10,0.10,-0.10,-50.0,6000,2,600,0,0,0,0,0,0,0,0,0,0
20200312,057906,福懋科中信99購01,,,,,0.00,0.00,0,0,0,0,0,0,0,0,0,0,0,0,0
20200312,057907,台達電亞東99購01,0.61,0.61,0.61,0.61,-0.20,-24.69,48000,1,29280,0,0,0,0,0,0,48000,0,48000,48000
20200312,057908,國泰金亞東99購01,0.53,0.55,0.53,0.53,-0.10,-15.87,90000,3,48600,0,0,0,0,0,0,0,85000,-85000,-85000
20200312,057909,台光電兆豐98購01,0.85,0.85,0.76,0.76,-0.18,-19.15,157000,8,130050,0,0,0,0,0,0,147000,0,147000,147000
20200312,05790P,臺股指永昌96售07,13.00,25.00,13.00,17.00,+12.36,266.38,139000,22,2677900,0,0,0,0,0,0,134000,40000,94000,94000
20200312,057910,華新科兆豐99購02,0.31,0.31,0.19,0.19,-0.16,-45.71,418000,10,114480,0,0,0,0,0,0,358000,60000,298000,298000
20200312,057911,國巨日盛98購01,,,,,0.00,0.00,0,0,0,0,0,0,0,0,0,0,0,0,0
20200312,057912,美律日盛99購01,0.84,0.84,0.61,0.63,-0.26,-29.21,148000,15,107130,0,0,0,0,0,0,118000,30000,88000,88000
20200312,057913,健策日盛98購01,0.46,0.47,0.42,0.42,-0.14,-25.0,93000,8,42340,0,0,0,0,0,0,72000,21000,51000,51000
20200312,057914,日月光日盛9A購01,0.64,0.64,0.64,0.64,0.00,0.00,35000,1,22400,0,0,0,0,0,0,0,35000,-35000,-35000
20200312,057915,台泥凱基98購01,0.81,0.82,0.71,0.82,-0.09,-9.89,126000,4,100320,0,0,0,0,0,0,106000,36000,70000,70000
20200312,057916,國巨凱基98購13,0.46,0.46,0.36,0.38,-0.17,-30.91,21000,6,7980,0,0,0,0,0,0,10000,11000,-1000,-1000
20200312,057917,台積電凱基98購17,,,,,0.00,0.00,0,0,0,0,0,0,0,0,0,0,0,0,0
20200312,057918,旺宏凱基99購01,0.60,0.60,0.60,0.60,0.00,0.00,50000,1,30000,0,0,0,0,0,0,50000,0,50000,50000
20200312,057919,技嘉凱基98購03,0.59,0.59,0.59,0.59,0.00,0.00,2000,1,1180,0,0,0,0,0,0,2000,0,2000,2000
20200312,05791P,臺股指中信99售06,2.15,2.96,2.15,2.80,+0.89,46.6,1394000,37,3832070,0,0,0,0,0,0,1201000,993000,208000,208000
20200312,057920,奇力新凱基98購08,,,,,0.00,0.00,0,0,0,0,0,0,0,0,0,0,0,0,0
20200312,057921,可成凱基98購09,0.34,0.34,0.20,0.20,-0.31,-60.78,65000,2,14400,0,0,0,0,0,0,10000,55000,-45000,-45000
20200312,057922,華新科凱基99購01,,,,,0.00,0.00,0,0,0,0,0,0,0,0,0,0,0,0,0
20200312,057923,晶豪科凱基98購02,1.15,1.16,0.83,0.86,-0.41,-32.28,281000,33,307160,0,0,0,0,0,0,232000,24000,208000,208000
20200312,057924,健策凱基98購02,0.39,0.39,0.39,0.39,-0.11,-22.0,10000,1,3900,0,0,0,0,0,0,10000,0,10000,10000
20200312,057925,貿聯凱基99購01,0.58,0.60,0.52,0.52,-0.18,-25.71,35000,5,19400,0,0,0,0,0,0,35000,0,35000,35000
20200312,057926,帆宣凱基98購02,,,,,0.00,0.00,0,0,0,0,0,0,0,0,0,0,0,0,0
20200312,057927,勤誠凱基98購01,,,,,0.00,0.00,0,0,0,0,0,0,0,0,0,0,0,0,0
20200312,057928,鈺齊凱基98購02,0.85,0.85,0.83,0.83,-0.33,-28.45,123000,2,103190,0,0,0,0,0,0,55000,68000,-13000,-13000
20200312,057929,上銀群益98購02,,,,,0.00,0.00,0,0,0,0,0,0,0,0,0,0,0,0,0
20200312,05792P,臺股指中信99售07,3.13,3.25,3.05,3.05,+0.76,33.19,86000,10,269360,0,0,0,0,0,0,16000,80000,-64000,-64000
20200312,057930,旺宏群益99購04,2.58,2.60,2.00,2.17,-0.80,-26.94,127000,16,302680,0,0,0,0,0,0,96000,68000,28000,28000
20200312,057931,正崴群益98購02,0.90,0.90,0.81,0.81,-0.25,-23.58,120000,3,102700,0,0,0,0,0,0,60000,60000,0,0
20200312,057932,美律群益98購04,0.90,0.91,0.62,0.62,-0.35,-36.08,234000,16,173520,0,0,0,0,0,0,107000,127000,-20000,-20000
20200312,057933,聯發科群益98購06,1.09,1.15,0.86,1.10,-0.87,-44.16,70000,5,73900,0,0,0,0,0,0,30000,40000,-10000,-10000
20200312,057934,華新科群益98購07,0.80,0.80,0.73,0.73,-0.17,-18.89,118000,3,93500,0,0,0,0,0,0,10000,118000,-108000,-108000
20200312,057935,晶技群益98購02,1.73,1.79,1.00,1.00,-0.70,-41.18,261000,29,402730,0,0,0,0,0,0,241000,13000,228000,228000
20200312,057936,健策群益99購01,0.48,0.48,0.33,0.33,-0.45,-57.69,104000,3,46320,0,0,0,0,0,0,79000,25000,54000,54000
20200312,057937,神達群益98購02,0.74,0.76,0.55,0.63,-0.42,-40.0,362000,9,246280,0,0,0,0,0,0,64000,298000,-234000,-234000
20200312,057938,台表科群益98購02,,,,,0.00,0.00,0,0,0,0,0,0,0,0,0,0,0,0,0
20200312,057939,鈺齊群益98購02,0.56,0.57,0.41,0.41,-0.26,-38.81,552000,11,253470,0,0,0,0,0,0,356000,196000,160000,160000
20200312,05793P,臺股指中信99售08,2.35,2.69,2.35,2.69,+0.67,33.17,25000,4,62330,0,0,0,0,0,0,7000,18000,-11000,-11000
20200312,057940,和大國票99購01,0.46,0.46,0.39,0.39,0.00,0.00,65000,2,27800,0,0,0,0,0,0,65000,0,65000,65000
20200312,057941,聯電國票99購01,0.67,0.67,0.56,0.56,-0.22,-28.21,42000,5,26720,0,0,0,0,0,0,12000,30000,-18000,-18000
20200312,057942,可成國票99購02,0.74,0.76,0.43,0.45,-0.76,-62.81,2810000,15,1607050,0,0,0,0,0,0,1141000,1669000,-528000,-528000
20200312,057943,可成國票99購03,,,,,0.00,0.00,0,0,0,0,0,0,0,0,0,0,0,0,0
20200312,057944,新日興國票99購02,1.19,1.29,1.19,1.22,-0.90,-42.45,100000,3,122600,0,0,0,0,0,0,100000,88000,12000,12000
20200312,057945,京鼎國票99購03,0.81,0.81,0.65,0.71,-0.31,-30.39,111000,6,83910,0,0,0,0,0,0,73000,38000,35000,35000
20200312,057946,晶相光國票99購01,1.16,1.16,1.12,1.12,-0.35,-23.81,27000,2,30920,0,0,0,0,0,0,17000,10000,7000,7000
20200312,057947,和碩國票99購01,0.72,0.72,0.63,0.63,-0.38,-37.62,27000,5,18710,0,0,0,0,0,0,27000,0,27000,27000
20200312,057948,嘉聯益國票99購02,1.26,1.30,1.00,1.00,-0.67,-40.12,78000,6,88480,0,0,0,0,0,0,30000,48000,-18000,-18000
20200312,057949,南電國票99購01,2.94,2.94,2.51,2.51,-0.74,-22.77,18000,3,50260,0,0,0,0,0,0,9000,9000,0,0
20200312,05794P,華邦電群益96售04,1.83,1.89,1.83,1.89,+0.20,11.83,41000,2,76230,0,0,0,0,0,0,41000,0,41000,41000
20200312,057950,T50正2元大9B購04,0.43,0.43,0.40,0.40,-0.20,-33.33,48000,2,19500,0,0,0,0,0,0,0,48000,-48000,-48000
20200312,057951,元油2X元大98購20,,,,,0.00,0.00,0,0,0,0,0,0,0,0,0,0,0,0,0
20200312,057952,元油2X元大98購21,,,,,0.00,0.00,0,0,0,0,0,0,0,0,0,0,0,0,0
20200312,057953,聚陽元大98購01,0.81,0.81,0.53,0.60,-0.29,-32.58,600000,21,423510,0,0,0,0,0,0,105000,490000,-385000,-385000
20200312,057954,宏碁元大99購01,0.95,0.95,0.71,0.74,-0.32,-30.19,349000,12,296770,0,0,0,0,0,0,100000,249000,-149000,-149000
20200312,057955,技嘉元大98購07,0.81,0.81,0.76,0.76,-0.24,-24.0,70000,2,56600,0,0,0,0,0,0,68000,2000,66000,66000
20200312,057956,全新元大99購04,0.59,0.59,0.59,0.59,0.00,0.00,11000,1,6490,0,0,0,0,0,0,11000,0,11000,11000
20200312,057957,嘉晶元大98購01,2.92,3.18,2.19,2.43,-1.13,-31.74,124000,30,351100,0,0,0,0,0,0,98000,45000,53000,53000
20200312,057958,禾伸堂元大99購05,0.80,0.84,0.74,0.74,-0.17,-18.68,164000,6,130420,0,0,0,0,0,0,61000,164000,-103000,-103000
20200312,057959,欣興元大98購14,1.50,1.50,1.14,1.17,-0.77,-39.69,13000,3,15480,0,0,0,0,0,0,10000,3000,7000,7000
20200312,05795P,華邦電群益96售05,2.35,2.43,2.35,2.43,+0.25,11.47,30000,2,71300,0,0,0,0,0,0,30000,0,30000,30000
20200312,057960,聯鈞元大98購02,1.06,1.06,0.86,0.90,-0.35,-28.0,391000,8,367120,0,0,0,0,0,0,223000,168000,55000,55000
20200312,057961,茂林元大9A購01,0.93,0.93,0.70,0.70,-0.24,-25.53,1024000,48,820030,0,0,0,0,0,0,597000,459000,138000,138000
20200312,057962,超眾元大99購03,1.94,1.94,1.76,1.76,-0.71,-28.74,12000,3,22050,0,0,0,0,0,0,6000,9000,-3000,-3000
20200312,057963,緯穎元大98購08,,,,,0.00,0.00,0,0,0,0,0,0,0,0,0,0,0,0,0
20200312,057964,緯穎元大99購03,1.73,1.73,1.25,1.25,-0.69,-35.57,70000,4,106420,0,0,0,0,0,0,10000,60000,-50000,-50000
20200312,057965,臺股指元大98購14,0.76,0.76,0.67,0.67,-0.24,-26.37,55000,4,38550,0,0,0,0,0,0,20000,35000,-15000,-15000
20200312,057966,金融類元大98購01,,,,,0.00,0.00,0,0,0,0,0,0,0,0,0,0,0,0,0
20200312,057967,聯發科國泰9A購02,0.87,0.87,0.62,0.62,-0.34,-35.42,310000,7,234310,0,0,0,0,0,0,100000,260000,-160000,-160000
20200312,057968,可成國泰9A購01,0.57,0.57,0.36,0.39,-0.27,-40.91,565000,22,268470,0,0,0,0,0,0,187000,430000,-243000,-243000
20200312,057969,緯穎國泰99購01,1.33,1.33,0.99,0.99,-0.38,-27.74,133000,10,160960,0,0,0,0,0,0,68000,65000,3000,3000
20200312,05796P,臺股指群益96售10,,,,,0.00,0.00,0,0,0,0,0,0,0,0,0,0,0,0,0
20200312,057970,國巨富邦99購03,0.39,0.39,0.30,0.30,-0.17,-36.17,40000,3,14200,0,0,0,0,0,0,0,40000,-40000,-40000
20200312,057971,華新科富邦9B購02,0.27,0.27,0.23,0.23,-0.12,-34.29,24000,2,6320,0,0,0,0,0,0,0,24000,-24000,-24000
20200312,057972,群創富邦9C購01,0.67,0.67,0.61,0.61,-0.24,-28.24,13000,3,8490,0,0,0,0,0,0,11000,13000,-2000,-2000
20200312,057973,神達富邦9A購01,0.64,0.64,0.56,0.58,-0.20,-25.64,76000,9,45390,0,0,0,0,0,0,11000,41000,-30000,-30000
20200312,057974,上銀永豐98購02,0.27,0.28,0.20,0.20,-0.16,-44.44,358000,5,86740,0,0,0,0,0,0,158000,200000,-42000,-42000
20200312,057975,台積電永豐98購05,0.25,0.25,0.25,0.25,-0.14,-35.9,104000,1,26000,0,0,0,0,0,0,104000,0,104000,104000
20200312,057976,旺宏永豐98購03,0.54,0.54,0.39,0.39,-0.41,-51.25,156000,3,73240,0,0,0,0,0,0,88000,68000,20000,20000
20200312,057977,台光電永豐98購02,0.45,0.45,0.45,0.45,-0.16,-26.23,25000,1,11250,0,0,0,0,0,0,25000,0,25000,25000
20200312,057978,聯發科永豐98購05,0.68,0.68,0.46,0.50,-0.27,-35.06,301000,12,167580,0,0,0,0,0,0,78000,223000,-145000,-145000
20200312,057979,華新科永豐98購03,,,,,0.00,0.00,0,0,0,0,0,0,0,0,0,0,0,0,0
20200312,05797P,臺股指群益96售11,,,,,0.00,0.00,0,0,0,0,0,0,0,0,0,0,0,0,0
20200312,057980,聯詠永豐98購01,0.45,0.45,0.32,0.32,-0.25,-43.86,76000,2,33160,0,0,0,0,0,0,76000,0,76000,76000
20200312,057981,臻鼎永豐98購01,0.41,0.41,0.27,0.27,-0.23,-46.0,116000,8,44680,0,0,0,0,0,0,74000,42000,32000,32000
20200312,057982,帆宣永豐98購01,0.17,0.17,0.17,0.17,0.00,0.00,90000,9,15300,0,0,0,0,0,0,0,90000,-90000,-90000
20200312,057983,緯穎永豐98購03,0.28,0.28,0.28,0.28,0.00,0.00,10000,1,2800,0,0,0,0,0,0,0,10000,-10000,-10000
20200312,057984,聯發科台新98購01,,,,,0.00,0.00,0,0,0,0,0,0,0,0,0,0,0,0,0
20200312,057985,華通元富02購03,1.32,1.32,1.06,1.06,-0.51,-32.48,118000,3,144340,0,0,0,0,0,0,10000,108000,-98000,-98000
20200312,057986,華新科元富99購05,0.49,0.50,0.31,0.31,-0.25,-44.64,365000,13,149650,0,0,0,0,0,0,60000,300000,-240000,-240000
20200312,057987,大立光元富98購02,,,,,0.00,0.00,0,0,0,0,0,0,0,0,0,0,0,0,0
20200312,057988,鈺齊元富98購02,1.22,1.22,1.20,1.22,-0.25,-17.01,10000,6,12100,0,0,0,0,0,0,10000,0,10000,10000
20200312,057989,旺宏統一99購04,,,,,0.00,0.00,0,0,0,0,0,0,0,0,0,0,0,0,0
20200312,05798P,臺股指群益96售12,,,,,0.00,0.00,0,0,0,0,0,0,0,0,0,0,0,0,0
20200312,057990,美律統一99購02,0.65,0.66,0.60,0.60,-0.33,-35.48,104000,6,65140,0,0,0,0,0,0,84000,20000,64000,64000
20200312,057991,健策統一9C購01,0.37,0.37,0.34,0.34,-0.11,-24.44,75000,2,26550,0,0,0,0,0,0,35000,40000,-5000,-5000
20200312,057992,大立光日盛98購01,,,,,0.00,0.00,0,0,0,0,0,0,0,0,0,0,0,0,0
20200312,057993,中環中信98購01,0.76,0.76,0.74,0.74,-0.20,-21.28,10000,10,7540,0,0,0,0,0,0,10000,0,10000,10000
20200312,057994,技嘉中信98購01,1.93,1.93,1.81,1.81,-0.29,-13.81,33000,6,61860,0,0,0,0,0,0,33000,23000,10000,10000
20200312,057995,華新科中信98購02,,,,,0.00,0.00,0,0,0,0,0,0,0,0,0,0,0,0,0
20200312,057996,臻鼎中信98購01,2.40,2.40,1.72,1.72,-1.54,-47.24,143000,17,296140,0,0,0,0,0,0,48000,95000,-47000,-47000
20200312,057997,旺宏第一9C購01,0.70,0.70,0.70,0.70,0.00,0.00,20000,2,14000,0,0,0,0,0,0,0,20000,-20000,-20000
20200312,057998,玉晶光麥證9A購01,0.66,0.66,0.53,0.53,-0.20,-27.4,54000,3,32660,14000,40000,-26000,0,0,0,14000,40000,-26000,-26000
20200312,057999,智邦亞東99購02,,,,,0.00,0.00,0,0,0,0,0,0,0,0,0,0,0,0,0
20200312,05799P,臺股指群益96售13,,,,,0.00,0.00,0,0,0,0,0,0,0,0,0,0,0,0,0
20200312,058000,FBVIX群益9B購01,,,,,0.00,0.00,0,0,0,0,0,0,0,0,0,0,0,0,0
20200312,058001,FBVIX群益9B購02,,,,,0.00,0.00,0,0,0,0,0,0,0,0,0,0,0,0,0
20200312,058002,FBVIX群益9C購01,,,,,0.00,0.00,0,0,0,0,0,0,0,0,0,0,0,0,0
20200312,058003,FBVIX群益9C購02,5.65,5.65,5.65,5.65,0.00,0.00,5000,1,28250,0,0,0,0,0,0,5000,0,5000,5000
20200312,058004,大立光群益98購03,0.74,0.75,0.49,0.52,-0.78,-60.0,312000,22,211630,0,0,0,0,0,0,118000,194000,-76000,-76000
20200312,058005,茂林群益98購04,0.49,0.49,0.49,0.49,-0.19,-27.94,10000,1,4900,0,0,0,0,0,0,10000,0,10000,10000
20200312,058006,台郡群益98購04,1.49,1.49,1.08,1.08,-0.84,-43.75,130000,3,156650,0,0,0,0,0,0,130000,0,130000,130000
20200312,058007,南電群益98購02,0.87,0.87,0.61,0.61,-0.33,-35.11,330000,8,230480,0,0,0,0,0,0,222000,123000,99000,99000
20200312,058008,禾伸堂國票99購02,,,,,0.00,0.00,0,0,0,0,0,0,0,0,0,0,0,0,0
20200312,058009,智易國票99購01,2.01,2.01,2.01,2.01,-0.47,-18.95,10000,1,20100,0,0,0,0,0,0,10000,0,10000,10000
20200312,05800P,台積電兆豐96售04,7.10,7.80,7.10,7.80,+1.80,30.0,279000,9,2013500,0,0,0,0,0,0,140000,139000,1000,1000
20200312,058010,帆宣國票98購01,,,,,0.00,0.00,0,0,0,0,0,0,0,0,0,0,0,0,0
20200312,058011,台虹國票99購01,2.53,2.53,2.53,2.53,-1.15,-31.25,25000,1,63250,0,0,0,0,0,0,25000,0,25000,25000
20200312,058012,鈺齊國票99購01,1.60,1.60,1.60,1.60,-0.35,-17.95,15000,1,24000,0,0,0,0,0,0,0,15000,-15000,-15000
20200312,058013,SP黃豆凱基9A購01,0.55,0.55,0.55,0.55,0.00,0.00,1000,1,550,0,0,0,0,0,0,0,1000,-1000,-1000
20200312,058014,上銀凱基99購02,,,,,0.00,0.00,0,0,0,0,0,0,0,0,0,0,0,0,0
20200312,058015,旺宏凱基99購02,,,,,0.00,0.00,0,0,0,0,0,0,0,0,0,0,0,0,0
20200312,058016,智邦凱基98購06,0.78,0.78,0.58,0.58,-0.25,-30.12,100000,3,61300,0,0,0,0,0,0,100000,10000,90000,90000
20200312,058017,漢唐凱基99購01,0.87,0.87,0.82,0.82,-0.22,-21.15,228000,4,193360,0,0,0,0,0,0,60000,228000,-168000,-168000
20200312,058018,南亞科凱基99購03,,,,,0.00,0.00,0,0,0,0,0,0,0,0,0,0,0,0,0
20200312,058019,美律凱基99購04,0.95,0.95,0.71,0.71,-0.32,-31.07,17000,3,14740,0,0,0,0,0,0,10000,7000,3000,3000
20200312,05801P,正崴兆豐96售01,4.45,5.05,4.45,5.05,+0.91,21.98,172000,9,808480,0,0,0,0,0,0,40000,132000,-92000,-92000
20200312,058020,大立光凱基99購03,0.68,0.68,0.52,0.53,-0.62,-53.91,108000,10,60040,0,0,0,0,0,0,68000,40000,28000,28000
20200312,058021,牧德凱基98購02,,,,,0.00,0.00,0,0,0,0,0,0,0,0,0,0,0,0,0
20200312,058022,樺漢凱基99購02,,,,,0.00,0.00,0,0,0,0,0,0,0,0,0,0,0,0,0
20200312,058023,南電凱基98購02,1.27,1.33,1.00,1.01,-0.47,-31.76,41000,6,45530,0,0,0,0,0,0,36000,5000,31000,31000
20200312,058024,台積電國泰9A購01,0.91,0.91,0.91,0.91,-0.32,-26.02,5000,1,4550,0,0,0,0,0,0,5000,0,5000,5000
20200312,058025,聯茂國泰99購01,1.92,1.92,1.62,1.62,-0.41,-20.2,33000,4,57660,0,0,0,0,0,0,20000,13000,7000,7000
20200312,058026,上銀富邦9A購01,0.68,0.68,0.55,0.56,-0.23,-29.11,240000,12,158000,0,0,0,0,0,0,220000,20000,200000,200000
20200312,058027,鴻海富邦98購04,,,,,0.00,0.00,0,0,0,0,0,0,0,0,0,0,0,0,0
20200312,058028,國巨富邦99購04,0.15,0.15,0.11,0.11,-0.09,-45.0,706000,25,90280,0,0,0,0,0,0,73000,607000,-534000,-534000
20200312,058029,台灣50永豐9A購01,0.36,0.36,0.26,0.28,-0.15,-34.88,56000,7,16330,0,0,0,0,0,0,0,56000,-56000,-56000
20200312,05802P,臺股指兆豐96售02,,,,,0.00,0.00,0,0,0,0,0,0,0,0,0,0,0,0,0
20200312,058030,國巨永豐98購08,,,,,0.00,0.00,0,0,0,0,0,0,0,0,0,0,0,0,0
20200312,058031,旺宏永豐98購04,0.78,0.78,0.65,0.65,-0.34,-34.34,181000,3,123950,0,0,0,0,0,0,113000,68000,45000,45000
20200312,058032,大立光永豐98購05,0.38,0.39,0.38,0.39,0.00,0.00,8000,2,3090,0,0,0,0,0,0,3000,5000,-2000,-2000
20200312,058033,景碩永豐98購02,,,,,0.00,0.00,0,0,0,0,0,0,0,0,0,0,0,0,0
20200312,058034,神達永豐98購02,0.30,0.30,0.25,0.29,-0.14,-32.56,133000,3,33700,0,0,0,0,0,0,128000,5000,123000,123000
20200312,058035,旭富永豐98購02,0.84,0.87,0.63,0.69,-0.23,-25.0,146000,14,107310,0,0,0,0,0,0,94000,52000,42000,42000
20200312,058036,南電永豐98購01,0.52,0.52,0.47,0.47,-0.25,-34.72,3000,2,1510,0,0,0,0,0,0,0,3000,-3000,-3000
20200312,058037,台灣50元大9B購02,0.90,0.91,0.66,0.68,-0.46,-40.35,695000,18,530470,0,0,0,0,0,0,378000,299000,79000,79000
20200312,058038,滬深反元大98購01,0.73,0.77,0.73,0.76,+0.11,16.92,450000,8,335700,0,0,0,0,0,0,290000,160000,130000,130000
20200312,058039,元石油元大98購03,0.11,0.11,0.10,0.11,-0.04,-26.67,71000,6,7760,0,0,0,0,0,0,29000,0,29000,29000
20200312,05803P,臺股指兆豐96售03,,,,,0.00,0.00,0,0,0,0,0,0,0,0,0,0,0,0,0
20200312,058040,FBVIX元大98購01,5.65,5.70,5.65,5.70,0.00,0.00,32000,2,182300,0,0,0,0,0,0,32000,0,32000,32000
20200312,058041,FBVIX元大98購02,5.45,5.45,5.45,5.45,+0.56,11.45,8000,1,43600,0,0,0,0,0,0,8000,0,8000,8000
20200312,058042,鴻海元大98購12,1.97,1.99,1.61,1.67,-0.72,-30.13,84000,15,144660,0,0,0,0,0,0,24000,74000,-50000,-50000
20200312,058043,鴻海元大98購13,1.67,1.70,1.42,1.43,-0.59,-29.21,77000,14,121590,0,0,0,0,0,0,27000,67000,-40000,-40000
20200312,058044,鴻海元大99購07,2.36,2.40,1.96,2.03,-0.70,-25.64,26000,21,55190,0,0,0,0,0,0,25000,26000,-1000,-1000
20200312,058045,鴻海元大99購08,1.33,1.35,1.13,1.13,-0.47,-29.38,206000,15,240470,0,0,0,0,0,0,66000,151000,-85000,-85000
20200312,058046,國巨元大9A購01,1.52,1.52,0.99,1.10,-0.46,-29.49,168000,13,230730,0,0,0,0,0,0,35000,128000,-93000,-93000
20200312,058047,可成元大98購11,0.68,0.68,0.49,0.49,-0.40,-44.94,136000,6,74920,0,0,0,0,0,0,68000,68000,0,0
20200312,058048,群創元大9B購07,0.65,0.65,0.65,0.65,-0.21,-24.42,11000,1,7150,0,0,0,0,0,0,11000,11000,0,0
20200312,058049,帆宣元大98購01,,,,,0.00,0.00,0,0,0,0,0,0,0,0,0,0,0,0,0
20200312,05804P,美律永豐96售01,1.65,1.96,1.65,1.96,+0.38,24.05,174000,14,309530,0,0,0,0,0,0,73000,101000,-28000,-28000
20200312,058050,台郡元大99購05,1.26,1.26,1.05,1.07,-0.42,-28.19,119000,5,131770,0,0,0,0,0,0,51000,73000,-22000,-22000
20200312,058051,同欣電元大98購03,,,,,0.00,0.00,0,0,0,0,0,0,0,0,0,0,0,0,0
20200312,058052,南電元大98購02,2.49,2.50,1.90,2.01,-0.53,-20.87,47000,9,98610,0,0,0,0,0,0,6000,39000,-33000,-33000
20200312,058053,上銀統一9B購01,0.75,0.75,0.62,0.62,-0.31,-33.33,420000,7,296900,0,0,0,0,0,0,338000,82000,256000,256000
20200312,058054,台積電統一9C購01,0.70,0.70,0.56,0.62,-0.09,-12.68,989000,44,629330,0,0,0,0,0,0,601000,388000,213000,213000
20200312,058055,華擎統一9A購01,0.47,0.50,0.47,0.48,-0.11,-18.64,170000,14,81430,0,0,0,0,0,0,0,170000,-170000,-170000
20200312,058056,FBVIX元富98購01,,,,,0.00,0.00,0,0,0,0,0,0,0,0,0,0,0,0,0
20200312,058057,FBVIX元富98購02,,,,,0.00,0.00,0,0,0,0,0,0,0,0,0,0,0,0,0
20200312,058058,大立光元富9B購02,1.68,1.68,1.32,1.45,-1.00,-40.82,473000,31,729390,0,0,0,0,0,0,160000,313000,-153000,-153000
20200312,058059,晶技元富98購01,1.77,1.82,1.13,1.13,-0.63,-35.8,982000,49,1564450,0,0,0,0,0,0,632000,153000,479000,479000
20200312,05805P,義隆永豐96售02,1.84,2.02,1.80,1.94,+0.23,13.45,195000,21,372010,0,0,0,0,0,0,131000,64000,67000,67000
20200312,058060,貿聯元富98購01,1.22,1.23,0.86,0.86,-0.50,-36.76,589000,50,633150,0,0,0,0,0,0,329000,250000,79000,79000
20200312,058061,貿聯元富9B購01,1.38,1.38,1.03,1.03,-0.55,-34.81,605000,37,694440,0,0,0,0,0,0,102000,503000,-401000,-401000
20200312,058062,上銀中信98購01,0.41,0.41,0.27,0.27,-0.23,-46.0,131000,4,44490,0,0,0,0,0,0,83000,48000,35000,35000
20200312,058063,旺宏中信98購04,2.47,2.47,2.11,2.11,-0.81,-27.74,30000,3,69400,0,0,0,0,0,0,10000,20000,-10000,-10000
20200312,058064,華邦電亞東99購01,0.43,0.43,0.38,0.38,-0.32,-45.71,13000,2,5440,0,0,0,0,0,0,0,13000,-13000,-13000
20200312,058065,南亞科亞東99購01,0.67,0.67,0.67,0.67,0.00,0.00,48000,1,32160,0,0,0,0,0,0,0,48000,-48000,-48000
20200312,058066,可成亞東99購01,,,,,0.00,0.00,0,0,0,0,0,0,0,0,0,0,0,0,0
20200312,058067,台積電第一9C購01,0.64,0.64,0.31,0.36,-0.16,-30.77,870000,20,279770,0,0,0,0,0,0,663000,71000,592000,592000
20200312,058068,旺宏凱基98購11,1.46,1.46,1.17,1.17,-0.84,-41.79,129000,6,173800,0,0,0,0,0,0,25000,104000,-79000,-79000
20200312,058069,美律凱基99購05,1.57,1.57,1.44,1.44,-0.75,-34.25,80000,8,120200,0,0,0,0,0,0,30000,80000,-50000,-50000
20200312,05806P,宏達電永豐96售03,2.17,2.56,2.17,2.56,+0.50,24.27,52000,5,122140,0,0,0,0,0,0,20000,32000,-12000,-12000
20200312,058070,華新科凱基98購07,1.10,1.10,1.10,1.10,-0.03,-2.65,10000,1,11000,0,0,0,0,0,0,10000,10000,0,0
20200312,058071,大立光凱基98購19,0.69,0.69,0.69,0.69,0.00,0.00,4000,2,2760,0,0,0,0,0,0,4000,4000,0,0
20200312,058072,大立光凱基98購20,,,,,0.00,0.00,0,0,0,0,0,0,0,0,0,0,0,0,0
20200312,058073,大立光凱基99購04,,,,,0.00,0.00,0,0,0,0,0,0,0,0,0,0,0,0,0
20200312,058074,欣興凱基99購01,1.01,1.01,0.71,0.71,-0.81,-53.29,174000,6,141640,0,0,0,0,0,0,86000,88000,-2000,-2000
20200312,058075,貿聯凱基99購02,0.91,0.93,0.69,0.69,-0.34,-33.01,75000,12,60300,0,0,0,0,0,0,25000,50000,-25000,-25000
20200312,058076,神達凱基98購02,0.53,0.53,0.50,0.50,-0.16,-24.24,23000,2,12040,0,0,0,0,0,0,0,23000,-23000,-23000
20200312,058077,超眾凱基98購02,,,,,0.00,0.00,0,0,0,0,0,0,0,0,0,0,0,0,0
20200312,058078,景碩國票99購01,0.58,0.58,0.58,0.58,0.00,0.00,10000,1,5800,0,0,0,0,0,0,10000,0,10000,10000
20200312,058079,鴻海群益98購08,2.54,2.61,2.04,2.04,-0.86,-29.66,83000,13,211530,0,0,0,0,0,0,73000,21000,52000,52000
20200312,05807P,泰鼎永豐96售03,0.61,0.77,0.61,0.70,+0.08,12.9,417000,27,284390,0,0,0,0,0,0,200000,212000,-12000,-12000
20200312,058080,台積電群益98購06,2.32,2.32,1.79,2.04,-0.75,-26.88,218000,36,458870,0,0,0,0,0,0,208000,206000,2000,2000
20200312,058081,技嘉群益9A購03,1.32,1.32,1.10,1.22,-0.25,-17.01,53000,7,63800,0,0,0,0,0,0,32000,53000,-21000,-21000
20200312,058082,美律群益98購05,0.69,0.69,0.51,0.51,-0.23,-31.08,294000,5,177170,0,0,0,0,0,0,98000,196000,-98000,-98000
20200312,058083,聯發科群益98購08,1.81,1.81,1.38,1.41,-0.65,-31.55,1474000,12,2400680,0,0,0,0,0,0,1281000,193000,1088000,1088000
20200312,058084,大立光群益98購04,1.53,1.53,1.28,1.28,-0.75,-36.95,182000,5,270310,0,0,0,0,0,0,44000,138000,-94000,-94000
20200312,058085,景碩群益9A購01,,,,,0.00,0.00,0,0,0,0,0,0,0,0,0,0,0,0,0
20200312,058086,鴻海元大98購14,2.42,2.42,1.99,2.06,-0.82,-28.47,27000,21,57750,0,0,0,0,0,0,27000,27000,0,0
20200312,058087,鴻海元大98購15,1.84,1.87,1.53,1.59,-0.67,-29.65,18000,12,29170,0,0,0,0,0,0,18000,18000,0,0
20200312,058088,鴻海元大9A購01,1.58,1.58,1.35,1.37,-0.41,-23.03,223000,21,332490,0,0,0,0,0,0,20000,203000,-183000,-183000
20200312,058089,聯發科元大98購15,1.92,1.92,1.45,1.45,-0.71,-32.87,118000,8,201870,0,0,0,0,0,0,35000,118000,-83000,-83000
20200312,05808P,臺股指國票96售01,9.95,9.95,9.95,9.95,0.00,0.00,3000,1,29850,0,0,0,0,0,0,3000,0,3000,3000
20200312,058090,聯發科元大98購16,1.46,1.46,1.14,1.16,-0.43,-27.04,283000,10,368930,0,0,0,0,0,0,130000,158000,-28000,-28000
20200312,058091,欣興元大99購03,1.04,1.04,1.03,1.03,-0.89,-46.35,60000,2,62300,0,0,0,0,0,0,10000,50000,-40000,-40000
20200312,058092,牧德元大98購02,1.00,1.00,0.95,0.95,-0.56,-37.09,60000,2,58500,0,0,0,0,0,0,0,60000,-60000,-60000
20200312,058093,神達元大9A購01,1.27,1.27,1.10,1.10,-0.43,-28.1,185000,4,226580,0,0,0,0,0,0,68000,117000,-49000,-49000
20200312,058094,祥碩元大98購09,1.57,1.57,1.26,1.30,-0.42,-24.42,1029000,24,1439420,0,0,0,0,0,0,764000,645000,119000,119000
20200312,058095,昇陽半元大98購03,1.74,1.74,1.29,1.29,-1.03,-44.4,14000,3,22580,0,0,0,0,0,0,14000,0,14000,14000
20200312,058096,南電元大98購04,,,,,0.00,0.00,0,0,0,0,0,0,0,0,0,0,0,0,0
20200312,058097,台灣50國泰99購01,1.06,1.06,0.80,0.81,-0.52,-39.1,1758000,19,1588710,0,0,0,0,0,0,752000,1006000,-254000,-254000
20200312,058098,T50反1國泰9A購02,1.44,1.70,1.44,1.52,0.00,0.00,220000,15,340200,0,0,0,0,0,0,177000,34000,143000,143000
20200312,058099,鴻海國泰9A購02,0.60,0.60,0.51,0.51,-0.18,-26.09,54000,7,29880,0,0,0,0,0,0,26000,30000,-4000,-4000
20200312,05809P,臺股指國票96售02,6.70,6.80,6.70,6.80,+0.45,7.09,6000,2,40500,0,0,0,0,0,0,6000,0,6000,6000
20200312,058100,聯茂國泰99購02,1.43,1.43,1.03,1.03,-0.48,-31.79,135000,12,168000,0,0,0,0,0,0,50000,85000,-35000,-35000
20200312,058101,台積電富邦9C購01,0.32,0.32,0.25,0.28,-0.13,-31.71,366000,18,106690,0,0,0,0,0,0,8000,358000,-350000,-350000
20200312,058102,楠梓電永豐98購04,0.41,0.42,0.32,0.32,-0.33,-50.77,32000,12,13170,0,0,0,0,0,0,31000,1000,30000,30000
20200312,058103,台積電永豐98購06,0.69,0.69,0.53,0.62,-0.17,-21.52,584000,31,373630,0,0,0,0,0,0,12000,570000,-558000,-558000
20200312,058104,國巨統一9A購04,,,,,0.00,0.00,0,0,0,0,0,0,0,0,0,0,0,0,0
20200312,058105,旺宏統一9A購02,1.20,1.20,0.83,0.83,-0.56,-40.29,101000,2,84200,0,0,0,0,0,0,100000,1000,99000,99000
20200312,058106,神達統一98購02,0.56,0.56,0.48,0.51,-0.14,-21.54,255000,13,129470,0,0,0,0,0,0,86000,169000,-83000,-83000
20200312,058107,全新台新99購01,,,,,0.00,0.00,0,0,0,0,0,0,0,0,0,0,0,0,0
20200312,058108,台郡台新99購01,0.90,0.90,0.77,0.77,-0.36,-31.86,76000,2,63460,0,0,0,0,0,0,38000,38000,0,0
20200312,058109,台灣50元富9B購01,0.65,0.65,0.47,0.49,-0.32,-39.51,858000,26,477110,0,0,0,0,0,0,411000,447000,-36000,-36000
20200312,05810P,臺股指國票96售03,,,,,0.00,0.00,0,0,0,0,0,0,0,0,0,0,0,0,0
20200312,058110,光寶科元富98購01,2.28,2.28,1.79,1.79,-0.48,-21.15,22000,4,42180,0,0,0,0,0,0,11000,11000,0,0
20200312,058111,健鼎元富98購01,1.42,1.42,1.33,1.33,-0.41,-23.56,50000,5,69500,0,0,0,0,0,0,0,50000,-50000,-50000
20200312,058112,神達元富98購01,0.68,0.70,0.55,0.59,-0.25,-29.76,181000,6,106690,0,0,0,0,0,0,40000,141000,-101000,-101000
20200312,058113,百和元富98購01,0.76,0.76,0.67,0.67,-0.19,-22.09,10000,9,7190,0,0,0,0,0,0,10000,0,10000,10000
20200312,058114,台積電第一01購01,0.74,0.82,0.74,0.78,0.00,0.00,16000,4,12560,0,0,0,0,0,0,0,16000,-16000,-16000
20200312,058115,台光電中信99購01,2.70,2.70,2.06,2.21,-0.61,-21.63,219000,14,549290,0,0,0,0,0,0,136000,83000,53000,53000
20200312,058116,正崴中信99購02,1.41,1.41,1.18,1.18,-0.49,-29.34,326000,7,433860,0,0,0,0,0,0,248000,78000,170000,170000
20200312,058117,元石油群益9B購02,0.09,0.10,0.08,0.08,-0.06,-42.86,839000,18,76910,0,0,0,0,0,0,125000,709000,-584000,-584000
20200312,058118,瑞昱群益99購01,1.01,1.01,0.59,0.67,-0.64,-48.85,281000,29,228800,0,0,0,0,0,0,98000,183000,-85000,-85000
20200312,058119,華新亞東99購01,0.76,0.76,0.58,0.58,-0.34,-36.96,109000,3,73100,0,0,0,0,0,0,61000,48000,13000,13000
20200312,05811P,臺股指國票96售04,5.35,6.70,5.35,6.70,+1.94,40.76,31000,14,189150,0,0,0,0,0,0,31000,0,31000,31000
20200312,058120,台灣50國票99購03,0.99,1.02,0.65,0.73,-0.60,-45.11,1707000,55,1359960,0,0,0,0,0,0,889000,818000,71000,71000
20200312,058121,國巨國票9A購01,0.69,0.70,0.42,0.43,-0.38,-46.91,1400000,40,727660,0,0,0,0,0,0,481000,919000,-438000,-438000
20200312,058122,美律國票9A購01,0.99,0.99,0.98,0.98,-0.51,-34.23,60000,2,59370,0,0,0,0,0,0,0,60000,-60000,-60000
20200312,058123,亞光國票9A購01,0.82,0.82,0.82,0.82,-0.17,-17.17,10000,1,8200,0,0,0,0,0,0,10000,0,10000,10000
20200312,058124,玉晶光國票9A購01,0.80,0.80,0.68,0.68,-0.38,-35.85,76000,5,55580,0,0,0,0,0,0,38000,38000,0,0
20200312,058125,元油2X元大9C購01,0.05,0.05,0.03,0.03,-0.01,-25.0,5041000,28,163310,0,0,0,0,0,0,0,4932000,-4932000,-4932000
20200312,058126,元油2X元大9C購02,0.04,0.04,0.04,0.04,-0.02,-33.33,744000,10,29760,0,0,0,0,0,0,0,744000,-744000,-744000
20200312,058127,FBVIX元大9C購01,5.60,5.85,5.60,5.80,0.00,0.00,22000,3,126700,0,0,0,0,0,0,17000,5000,12000,12000
20200312,058128,FBVIX元大9C購02,,,,,0.00,0.00,0,0,0,0,0,0,0,0,0,0,0,0,0
20200312,058129,國巨元大99購10,1.37,1.37,0.98,0.99,-0.42,-29.79,206000,11,254250,0,0,0,0,0,0,55000,141000,-86000,-86000
20200312,05812P,臺股指國票96售05,,,,,0.00,0.00,0,0,0,0,0,0,0,0,0,0,0,0,0
20200312,058130,瑞昱元大99購01,1.81,1.81,1.55,1.59,0.00,0.00,153000,6,252210,0,0,0,0,0,0,53000,145000,-92000,-92000
20200312,058131,義隆元大99購02,1.05,1.05,1.05,1.05,-0.26,-19.85,30000,1,31500,0,0,0,0,0,0,30000,0,30000,30000
20200312,058132,義隆元大99購03,1.06,1.06,0.92,0.92,-0.23,-20.0,233000,9,240290,0,0,0,0,0,0,231000,9000,222000,222000
20200312,058133,華新科元大9A購02,0.48,0.48,0.35,0.36,-0.14,-28.0,353000,9,140710,0,0,0,0,0,0,242000,111000,131000,131000
20200312,058134,信邦元大99購01,1.05,1.05,0.96,0.96,-0.21,-17.95,108000,6,107380,0,0,0,0,0,0,108000,0,108000,108000
20200312,058135,景碩元大99購01,1.89,1.89,1.50,1.50,-0.71,-32.13,60000,2,93900,0,0,0,0,0,0,10000,50000,-40000,-40000
20200312,058136,景碩元大99購02,1.99,1.99,1.99,1.99,-0.14,-6.57,10000,1,19900,0,0,0,0,0,0,10000,0,10000,10000
20200312,058137,玉晶光元大99購11,,,,,0.00,0.00,0,0,0,0,0,0,0,0,0,0,0,0,0
20200312,058138,晶相光元大9C購01,0.81,0.81,0.65,0.70,-0.14,-16.67,820000,21,571330,0,0,0,0,0,0,387000,429000,-42000,-42000
20200312,058139,臻鼎元大99購01,0.70,0.70,0.56,0.56,-0.53,-48.62,80000,4,46100,0,0,0,0,0,0,3000,77000,-74000,-74000
20200312,05813P,臺股指國票96售06,15.20,15.20,15.20,15.20,0.00,0.00,30000,1,456000,0,0,0,0,0,0,30000,0,30000,30000
20200312,058140,臻鼎元大99購02,0.84,0.84,0.58,0.58,-0.30,-34.09,281000,15,180250,0,0,0,0,0,0,256000,25000,231000,231000
20200312,058141,嘉聯益元大99購05,0.78,0.78,0.78,0.78,-0.15,-16.13,10000,1,7800,0,0,0,0,0,0,10000,0,10000,10000
20200312,058142,瑞儀元大99購01,1.03,1.03,0.87,0.87,-0.28,-24.35,292000,9,284160,0,0,0,0,0,0,224000,87000,137000,137000
20200312,058143,瑞儀元大99購02,0.83,0.83,0.69,0.69,-0.24,-25.81,261000,12,202360,0,0,0,0,0,0,193000,104000,89000,89000
20200312,058144,聯茂元大99購02,1.39,1.39,1.27,1.27,-0.20,-13.61,84000,3,116520,0,0,0,0,0,0,84000,0,84000,84000
20200312,058145,聯茂元大99購03,1.18,1.18,0.90,0.90,-0.35,-28.0,185000,6,208600,0,0,0,0,0,0,87000,98000,-11000,-11000
20200312,058146,勤誠元大99購01,1.11,1.11,1.11,1.11,-0.14,-11.2,10000,1,11100,0,0,0,0,0,0,10000,0,10000,10000
20200312,058147,鈺齊元大99購01,1.32,1.32,1.04,1.04,-0.47,-31.13,139000,11,163490,0,0,0,0,0,0,46000,112000,-66000,-66000
20200312,058148,百和元大99購01,1.48,1.48,1.43,1.43,-0.29,-16.86,17000,2,24960,0,0,0,0,0,0,17000,0,17000,17000
20200312,058149,百和元大99購02,1.58,1.58,1.52,1.52,-0.29,-16.02,17000,2,26620,0,0,0,0,0,0,17000,4000,13000,13000
20200312,05814P,臺股指國票96售07,9.85,13.50,9.85,13.50,+4.95,57.89,6000,2,66400,0,0,0,0,0,0,4000,2000,2000,2000
20200312,058150,中502X統一9B購01,,,,,0.00,0.00,0,0,0,0,0,0,0,0,0,0,0,0,0
20200312,058151,台積電統一9A購04,0.96,0.96,0.72,0.86,-0.19,-18.1,1657000,60,1371120,0,0,0,0,0,0,1052000,564000,488000,488000
20200312,058152,聯發科統一9B購02,0.56,0.56,0.56,0.56,-0.20,-26.32,48000,1,26880,0,0,0,0,0,0,0,48000,-48000,-48000
20200312,058153,景碩統一9B購01,0.51,0.51,0.38,0.39,-0.19,-32.76,230000,15,104220,0,0,0,0,0,0,48000,182000,-134000,-134000
20200312,058154,泰碩統一9A購01,1.36,1.36,1.09,1.24,-0.16,-11.43,661000,32,803560,10000,0,10000,0,0,0,427000,222000,205000,215000
20200312,058155,牧德統一9A購01,0.54,0.54,0.43,0.43,-0.29,-40.28,117000,3,52290,0,0,0,0,0,0,0,117000,-117000,-117000
20200312,058156,超眾統一9A購02,0.35,0.35,0.35,0.35,0.00,0.00,9000,1,3150,0,0,0,0,0,0,0,9000,-9000,-9000
20200312,058157,華通台新99購01,0.76,0.76,0.76,0.76,-0.45,-37.19,25000,2,19000,0,0,0,0,0,0,25000,6000,19000,19000
20200312,058158,台積電台新99購01,0.59,0.59,0.42,0.51,-0.19,-27.14,866000,16,484470,0,0,0,0,0,0,722000,144000,578000,578000
20200312,058159,健策台新9A購01,0.54,0.54,0.50,0.50,-0.44,-46.81,250000,3,129000,0,0,0,0,0,0,0,250000,-250000,-250000
20200312,05815P,台積電凱基97售06,3.19,3.51,3.19,3.51,+0.65,22.73,250000,8,855950,0,0,0,0,0,0,115000,245000,-130000,-130000
20200312,058160,奇鋐元富99購01,2.21,2.29,1.87,1.87,-1.06,-36.18,251000,7,483850,0,0,0,0,0,0,197000,54000,143000,143000
20200312,058161,T50反1日盛03購01,,,,,0.00,0.00,0,0,0,0,0,0,0,0,0,0,0,0,0
20200312,058162,上銀日盛9B購01,0.44,0.44,0.40,0.40,-0.18,-31.03,21000,2,8440,0,0,0,0,0,0,1000,20000,-19000,-19000
20200312,058163,道瓊反凱基9B購01,2.29,2.78,2.29,2.74,0.00,0.00,162000,5,425430,0,0,0,0,0,0,0,162000,-162000,-162000
20200312,058164,FBVIX凱基03購02,5.20,5.70,5.15,5.45,+0.72,15.22,60000,6,313350,0,0,0,0,0,0,57000,3000,54000,54000
20200312,058165,FBVIX凱基9C購01,5.45,5.45,5.45,5.45,+0.97,21.65,50000,1,272500,0,0,0,0,0,0,0,50000,-50000,-50000
20200312,058166,鴻海凱基9A購01,1.17,1.19,0.98,0.98,-0.34,-25.76,93000,11,106240,0,0,0,0,0,0,93000,9000,84000,84000
20200312,058167,鴻海凱基9A購03,1.55,1.55,1.29,1.30,-0.54,-29.35,12000,9,16410,0,0,0,0,0,0,10000,12000,-2000,-2000
20200312,058168,國巨凱基9A購04,,,,,0.00,0.00,0,0,0,0,0,0,0,0,0,0,0,0,0
20200312,058169,國巨凱基9A購05,0.35,0.35,0.35,0.35,-0.25,-41.67,1000,1,350,0,0,0,0,0,0,1000,0,1000,1000
20200312,05816P,台積電凱基97售07,,,,,0.00,0.00,0,0,0,0,0,0,0,0,0,0,0,0,0
20200312,058170,國巨凱基9A購06,0.60,0.60,0.60,0.60,0.00,0.00,35000,1,21000,0,0,0,0,0,0,0,35000,-35000,-35000
20200312,058171,國巨凱基9A購07,0.55,0.55,0.55,0.55,-0.05,-8.33,68000,1,37400,0,0,0,0,0,0,68000,0,68000,68000
20200312,058172,國巨凱基9B購02,,,,,0.00,0.00,0,0,0,0,0,0,0,0,0,0,0,0,0
20200312,058173,台積電凱基99購04,1.37,1.37,1.03,1.27,-0.27,-17.53,1361000,23,1705430,0,0,0,0,0,0,338000,1045000,-707000,-707000
20200312,058174,台積電凱基9A購05,0.83,0.83,0.76,0.79,-0.29,-26.85,95000,6,73670,0,0,0,0,0,0,75000,20000,55000,55000
20200312,058175,旺宏凱基99購03,1.20,1.21,0.94,0.94,-0.42,-30.88,958000,13,1036560,0,0,0,0,0,0,344000,614000,-270000,-270000
20200312,058176,聯發科凱基99購05,1.09,1.09,0.86,0.86,-0.49,-36.3,136000,2,132600,0,0,0,0,0,0,68000,68000,0,0
20200312,058177,華新科凱基99購02,1.11,1.11,1.11,1.11,-0.15,-11.9,10000,1,11100,0,0,0,0,0,0,10000,10000,0,0
20200312,058178,國巨國泰9A購02,,,,,0.00,0.00,0,0,0,0,0,0,0,0,0,0,0,0,0
20200312,058179,國巨國泰9B購02,0.59,0.59,0.47,0.47,-0.24,-33.8,28000,4,15800,0,0,0,0,0,0,0,28000,-28000,-28000
20200312,05817P,可成凱基96售07,1.71,1.98,1.71,1.98,+0.54,37.5,30000,3,56500,0,0,0,0,0,0,10000,20000,-10000,-10000
20200312,058180,華新科國泰9A購01,,,,,0.00,0.00,0,0,0,0,0,0,0,0,0,0,0,0,0
20200312,058181,華新科國泰9B購01,,,,,0.00,0.00,0,0,0,0,0,0,0,0,0,0,0,0,0
20200312,058182,日電貿國泰9A購01,,,,,0.00,0.00,0,0,0,0,0,0,0,0,0,0,0,0,0
20200312,058183,國巨富邦9A購06,0.17,0.17,0.15,0.15,-0.10,-40.0,91000,3,15130,0,0,0,0,0,0,0,91000,-91000,-91000
20200312,058184,鴻海永豐99購01,0.81,0.81,0.63,0.64,-0.27,-29.67,22000,5,15480,0,0,0,0,0,0,5000,17000,-12000,-12000
20200312,058185,國巨永豐99購01,0.18,0.18,0.15,0.15,0.00,0.00,500000,3,84000,0,0,0,0,0,0,0,500000,-500000,-500000
20200312,058186,聯發科永豐99購01,0.96,0.96,0.71,0.71,-0.31,-30.39,894000,9,701640,0,0,0,0,0,0,120000,774000,-654000,-654000
20200312,058187,泰碩永豐99購01,1.53,1.56,1.15,1.34,-0.34,-20.24,40000,4,55800,0,0,0,0,0,0,10000,30000,-20000,-20000
20200312,058188,華擎永豐99購01,0.36,0.37,0.33,0.37,-0.19,-33.93,298000,7,109680,0,0,0,0,0,0,0,298000,-298000,-298000
20200312,058189,嘉澤永豐99購01,0.61,0.61,0.61,0.61,-0.09,-12.86,35000,1,21350,0,0,0,0,0,0,0,35000,-35000,-35000
20200312,05818P,大立光凱基96售14,3.49,3.49,3.16,3.46,+2.47,249.49,7000,3,23950,0,0,0,0,0,0,7000,0,7000,7000
20200312,058190,貿聯永豐99購01,0.53,0.54,0.40,0.46,-0.23,-33.33,151000,24,72330,0,0,0,0,0,0,149000,2000,147000,147000
20200312,058191,祥碩永豐99購01,1.11,1.11,0.82,0.97,-0.17,-14.91,4012000,46,3762890,0,0,0,0,0,0,173000,3849000,-3676000,-3676000
20200312,058192,訊芯永豐99購01,0.36,0.36,0.36,0.36,-0.16,-30.77,35000,2,12600,0,0,0,0,0,0,0,35000,-35000,-35000
20200312,058193,緯穎永豐99購01,1.10,1.10,0.81,0.82,-0.39,-32.23,138000,6,119680,0,0,0,0,0,0,0,138000,-138000,-138000
20200312,058194,勤誠永豐99購01,0.50,0.51,0.50,0.51,-0.14,-21.54,79000,3,39830,0,0,0,0,0,0,79000,0,79000,79000
20200312,058195,鈺齊永豐99購01,0.55,0.55,0.53,0.53,-0.11,-17.19,453000,5,247020,0,0,0,0,0,0,453000,0,453000,453000
20200312,058196,台塑中信99購01,1.40,1.40,1.11,1.12,-0.47,-29.56,110000,8,144640,0,0,0,0,0,0,58000,52000,6000,6000
20200312,058197,國巨中信99購02,,,,,0.00,0.00,0,0,0,0,0,0,0,0,0,0,0,0,0
20200312,058198,瑞昱亞東99購01,0.86,0.86,0.86,0.86,0.00,0.00,48000,1,41280,0,0,0,0,0,0,0,48000,-48000,-48000
20200312,058199,國巨康和99購01,,,,,0.00,0.00,0,0,0,0,0,0,0,0,0,0,0,0,0
20200312,05819P,臺股指凱基96售16,4.65,7.00,4.65,7.00,0.00,0.00,100000,2,582500,0,0,0,0,0,0,100000,0,100000,100000
20200312,058200,世芯康和99購01,0.69,0.69,0.50,0.52,-0.21,-28.77,1825000,19,1021510,0,0,0,0,0,0,1398000,427000,971000,971000
20200312,058201,華通凱基9A購01,0.82,0.82,0.82,0.82,0.00,0.00,7000,1,5740,0,0,0,0,0,0,0,7000,-7000,-7000
20200312,058202,鴻海凱基9A購04,0.87,0.88,0.77,0.77,-0.29,-27.36,146000,8,119450,0,0,0,0,0,0,72000,78000,-6000,-6000
20200312,058203,信邦凱基99購01,0.75,0.75,0.69,0.74,-0.17,-18.68,33000,4,23990,0,0,0,0,0,0,6000,27000,-21000,-21000
20200312,058204,世芯凱基9A購01,1.17,1.25,0.89,0.89,-0.45,-33.58,182000,15,201240,0,0,0,0,0,0,87000,121000,-34000,-34000
20200312,058205,神達凱基9B購01,0.80,0.82,0.74,0.79,-0.37,-31.9,85000,5,67190,0,0,0,0,0,0,10000,85000,-75000,-75000
20200312,058206,祥碩凱基99購01,1.96,1.97,1.57,1.73,-0.52,-23.11,387000,11,659690,0,0,0,0,0,0,352000,225000,127000,127000
20200312,058207,南茂凱基99購01,1.01,1.02,0.84,0.84,-0.25,-22.94,1133000,27,1051050,0,0,0,0,0,0,933000,204000,729000,729000
20200312,058208,百和凱基99購01,1.23,1.23,1.09,1.14,-0.23,-16.79,100000,10,113700,0,0,0,0,0,0,70000,30000,40000,40000
20200312,058209,臺股指凱基01購01,0.65,0.65,0.36,0.44,-0.38,-46.34,2654000,148,1188620,0,0,0,0,0,0,178000,2476000,-2298000,-2298000
20200312,05820P,臺股指凱基96售17,,,,,0.00,0.00,0,0,0,0,0,0,0,0,0,0,0,0,0
20200312,058210,臺股指凱基9C購04,0.91,0.91,0.51,0.58,-0.44,-43.14,4942000,210,3254530,0,0,0,0,0,0,849000,4018000,-3169000,-3169000
20200312,058211,國巨群益9A購02,1.53,1.53,1.18,1.18,-0.63,-34.81,820000,6,1239500,0,0,0,0,0,0,704000,0,704000,704000
20200312,058212,華新科群益9A購01,1.54,1.54,1.06,1.14,-0.62,-35.23,52000,6,66390,0,0,0,0,0,0,26000,42000,-16000,-16000
20200312,058213,欣興群益99購01,1.14,1.14,0.88,0.88,-0.66,-42.86,78000,9,78480,0,0,0,0,0,0,35000,53000,-18000,-18000
20200312,058214,世芯群益9A購01,1.65,1.67,1.29,1.29,-0.56,-30.27,97000,8,143470,0,0,0,0,0,0,57000,40000,17000,17000
20200312,058215,貿聯群益99購02,1.12,1.15,0.99,0.99,-0.39,-28.26,371000,15,412750,0,0,0,0,0,0,371000,0,371000,371000
20200312,058216,TPK群益99購01,1.20,1.20,1.04,1.04,-0.42,-28.77,110000,3,130360,0,0,0,0,0,0,100000,10000,90000,90000
20200312,058217,新唐群益99購01,0.60,0.60,0.60,0.60,-0.29,-32.58,5000,1,3000,0,0,0,0,0,0,5000,0,5000,5000
20200312,058218,緯穎群益99購01,2.19,2.19,1.56,1.56,-0.73,-31.88,103000,3,178070,0,0,0,0,0,0,3000,100000,-97000,-97000
20200312,058219,台灣50國票9A購02,2.08,2.08,1.41,1.66,-1.01,-37.83,732000,18,1163030,0,0,0,0,0,0,185000,547000,-362000,-362000
20200312,05821P,臺股指凱基96售18,,,,,0.00,0.00,0,0,0,0,0,0,0,0,0,0,0,0,0
20200312,058220,世芯國票9A購01,2.06,2.09,1.92,2.09,-0.19,-8.33,42000,5,86140,0,0,0,0,0,0,0,42000,-42000,-42000
20200312,058221,上銀統一99購04,0.40,0.40,0.38,0.38,-0.11,-22.45,124000,2,49000,0,0,0,0,0,0,94000,30000,64000,64000
20200312,058222,玉晶光統一9B購01,,,,,0.00,0.00,0,0,0,0,0,0,0,0,0,0,0,0,0
20200312,058223,世芯統一9B購01,1.75,1.75,1.49,1.49,-0.37,-19.89,6000,2,9200,0,0,0,0,0,0,1000,5000,-4000,-4000
20200312,058224,世芯統一9B購02,1.07,1.07,0.80,0.81,-0.25,-23.58,505000,22,489570,0,0,0,0,0,0,212000,273000,-61000,-61000
20200312,058225,旺宏元富99購01,1.29,1.29,1.29,1.29,-0.63,-32.81,100000,1,129000,0,0,0,0,0,0,0,100000,-100000,-100000
20200312,058226,世芯元富99購01,2.79,2.95,1.97,2.09,-1.16,-35.69,320000,23,737500,0,0,0,0,0,0,34000,286000,-252000,-252000
20200312,058227,台灣50元大9C購01,1.55,1.55,1.18,1.28,-0.47,-26.86,214000,20,289500,0,0,0,0,0,0,86000,115000,-29000,-29000
20200312,058228,為升元大99購01,0.84,0.84,0.58,0.62,-0.31,-33.33,405000,20,263540,0,0,0,0,0,0,161000,330000,-169000,-169000
20200312,058229,為升元大99購02,0.87,0.87,0.65,0.65,-0.37,-36.27,154000,9,111450,0,0,0,0,0,0,21000,144000,-123000,-123000
20200312,05822P,臺股指凱基96售19,,,,,0.00,0.00,0,0,0,0,0,0,0,0,0,0,0,0,0
20200312,058230,國巨元大99購11,1.48,1.48,1.05,1.05,-0.64,-37.87,71000,2,103790,0,0,0,0,0,0,0,71000,-71000,-71000
20200312,058231,技嘉元大99購02,1.79,1.79,1.51,1.53,-0.42,-21.54,126000,7,209810,0,0,0,0,0,0,106000,48000,58000,58000
20200312,058232,聯發科元大99購05,2.20,2.20,1.73,1.74,-0.70,-28.69,171000,8,321080,0,0,0,0,0,0,60000,166000,-106000,-106000
20200312,058233,聯發科元大99購06,2.45,2.45,1.95,2.02,-0.67,-24.91,151000,11,331020,0,0,0,0,0,0,107000,151000,-44000,-44000
20200312,058234,華新科元大99購12,0.52,0.52,0.49,0.49,-0.14,-22.22,20000,2,10100,0,0,0,0,0,0,20000,0,20000,20000
20200312,058235,大立光元大99購08,2.13,2.13,1.75,1.93,-0.75,-27.99,404000,33,754740,0,0,0,0,0,0,5000,400000,-395000,-395000
20200312,058236,大立光元大99購09,1.93,1.93,1.93,1.93,0.00,0.00,19000,2,36670,0,0,0,0,0,0,0,19000,-19000,-19000
20200312,058237,嘉晶元大99購04,3.18,3.33,2.79,2.89,-0.58,-16.71,278000,26,871030,0,0,0,0,0,0,77000,250000,-173000,-173000
20200312,058238,奇鋐元大99購02,2.44,2.46,2.02,2.06,-0.54,-20.77,158000,15,355860,0,0,0,0,0,0,80000,80000,0,0
20200312,058239,景碩元大99購03,,,,,0.00,0.00,0,0,0,0,0,0,0,0,0,0,0,0,0
20200312,05823P,臺股指凱基96售20,7.45,7.45,7.45,7.45,+2.65,55.21,5000,1,37250,0,0,0,0,0,0,5000,0,5000,5000
20200312,058240,景碩元大99購04,,,,,0.00,0.00,0,0,0,0,0,0,0,0,0,0,0,0,0
20200312,058241,景碩元大99購05,1.79,1.79,1.79,1.79,-0.31,-14.76,10000,1,17900,0,0,0,0,0,0,10000,0,10000,10000
20200312,058242,玉晶光元大9A購01,,,,,0.00,0.00,0,0,0,0,0,0,0,0,0,0,0,0,0
20200312,058243,華擎元大99購01,0.61,0.61,0.52,0.55,-0.19,-25.68,301000,12,167670,0,0,0,0,0,0,151000,190000,-39000,-39000
20200312,058244,神達元大99購02,1.19,1.19,1.01,1.02,-0.56,-35.44,208000,5,229380,0,0,0,0,0,0,90000,118000,-28000,-28000
20200312,058245,訊連元大99購01,0.83,0.83,0.83,0.83,-0.32,-27.83,3000,1,2490,0,0,0,0,0,0,0,3000,-3000,-3000
20200312,058246,帆宣元大99購01,,,,,0.00,0.00,0,0,0,0,0,0,0,0,0,0,0,0,0
20200312,058247,聯茂元大99購04,1.09,1.13,0.98,0.98,-0.38,-27.94,94000,4,102150,0,0,0,0,0,0,26000,94000,-68000,-68000
20200312,058248,聯茂元大99購05,1.04,1.08,1.04,1.08,-0.34,-23.94,73000,3,76100,0,0,0,0,0,0,5000,73000,-68000,-68000
20200312,058249,緯穎元大99購04,2.01,2.01,2.01,2.01,-0.40,-16.6,10000,1,20100,0,0,0,0,0,0,10000,0,10000,10000
20200312,05824P,臺股指凱基96售21,,,,,0.00,0.00,0,0,0,0,0,0,0,0,0,0,0,0,0
20200312,058250,台虹元大99購01,2.82,2.82,2.46,2.53,-0.54,-17.59,62000,3,163460,0,0,0,0,0,0,0,62000,-62000,-62000
20200312,058251,百和元大99購03,,,,,0.00,0.00,0,0,0,0,0,0,0,0,0,0,0,0,0
20200312,058252,臺股指元大9A購16,0.64,0.64,0.45,0.52,-0.54,-50.94,52000,10,28530,0,0,0,0,0,0,0,52000,-52000,-52000
20200312,058253,臺股指元大9A購17,1.10,1.10,0.57,0.65,-0.66,-50.38,635000,38,522870,0,0,0,0,0,0,71000,562000,-491000,-491000
20200312,058254,臺股指元大9A購18,1.09,1.09,0.81,0.81,-0.56,-40.88,51000,7,49610,0,0,0,0,0,0,0,51000,-51000,-51000
20200312,058255,臺股指元大9A購19,0.99,0.99,0.99,0.99,0.00,0.00,3000,1,2970,0,0,0,0,0,0,0,3000,-3000,-3000
20200312,058256,臺股指元大9A購20,1.29,1.29,0.80,0.94,-0.52,-35.62,959000,75,1025370,0,0,0,0,0,0,115000,824000,-709000,-709000
20200312,058257,聯陽國泰9B購01,1.66,1.67,1.43,1.55,-0.20,-11.43,755000,25,1198980,0,0,0,0,0,0,561000,194000,367000,367000
20200312,058258,世芯國泰9A購01,1.40,1.45,0.99,1.01,-0.44,-30.34,1171000,47,1335430,0,0,0,0,0,0,132000,1049000,-917000,-917000
20200312,058259,訊連國泰9B購01,1.51,1.60,1.34,1.46,-0.37,-20.22,132000,14,194260,0,0,0,0,0,0,112000,20000,92000,92000
20200312,05825P,臺股指凱基96售22,8.95,8.95,8.50,8.50,0.00,0.00,11000,2,98000,0,0,0,0,0,0,1000,10000,-9000,-9000
20200312,058260,華新科富邦9C購01,0.20,0.20,0.19,0.19,-0.15,-44.12,105000,2,20950,0,0,0,0,0,0,5000,100000,-95000,-95000
20200312,058261,大立光富邦03購01,0.53,0.53,0.38,0.41,-0.22,-34.92,220000,35,93280,0,0,0,0,0,0,1000,219000,-218000,-218000
20200312,058262,大立光富邦9C購02,0.67,0.67,0.42,0.42,0.00,0.00,12000,2,7540,0,0,0,0,0,0,0,12000,-12000,-12000
20200312,058263,大成鋼永豐99購01,0.95,0.95,0.86,0.86,-0.15,-14.85,128000,6,116400,0,0,0,0,0,0,68000,60000,8000,8000
20200312,058264,瑞昱永豐99購01,0.85,0.85,0.62,0.69,-0.45,-39.47,78000,8,55180,0,0,0,0,0,0,10000,68000,-58000,-58000
20200312,058265,奇力新永豐9A購01,0.49,0.49,0.41,0.41,-0.19,-31.67,126000,4,58060,0,0,0,0,0,0,126000,0,126000,126000
20200312,058266,宏達電永豐99購01,1.11,1.11,0.79,0.79,-0.41,-34.17,44000,4,43820,0,0,0,0,0,0,10000,34000,-24000,-24000
20200312,058267,奇鋐永豐99購01,0.66,0.66,0.66,0.66,-0.42,-38.89,71000,1,46860,0,0,0,0,0,0,71000,0,71000,71000
20200312,058268,泰碩永豐9A購01,1.45,1.45,1.45,1.45,-0.14,-8.81,10000,1,14500,0,0,0,0,0,0,0,10000,-10000,-10000
20200312,058269,世芯永豐9A購01,1.02,1.09,0.75,0.85,-0.26,-23.42,316000,17,322130,0,0,0,0,0,0,90000,252000,-162000,-162000
20200312,05826P,臺股指凱基96售23,,,,,0.00,0.00,0,0,0,0,0,0,0,0,0,0,0,0,0
20200312,058270,上緯控永豐99購01,0.63,0.63,0.58,0.58,-0.25,-30.12,133000,4,79240,0,0,0,0,0,0,60000,73000,-13000,-13000
20200312,058271,訊連永豐99購01,0.59,0.60,0.57,0.57,-0.14,-19.72,117000,5,68870,0,0,0,0,0,0,77000,40000,37000,37000
20200312,058272,超眾永豐9A購01,0.69,0.69,0.59,0.59,-0.28,-32.18,14000,2,9360,0,0,0,0,0,0,11000,3000,8000,8000
20200312,058273,同欣電永豐99購01,0.20,0.20,0.20,0.20,-0.18,-47.37,68000,1,13600,0,0,0,0,0,0,68000,0,68000,68000
20200312,058274,世紀鋼永豐99購01,1.85,1.85,1.61,1.61,-0.40,-19.9,30000,2,53100,0,0,0,0,0,0,20000,10000,10000,10000
20200312,058275,S&P500中信9B購01,0.31,0.31,0.27,0.27,-0.24,-47.06,45000,4,12650,0,0,0,0,0,0,10000,35000,-25000,-25000
20200312,058276,道瓊指中信9C購01,0.44,0.44,0.30,0.30,-0.26,-46.43,308000,14,115340,0,0,0,0,0,0,40000,268000,-228000,-228000
20200312,058277,FBVIX中信03購01,,,,,0.00,0.00,0,0,0,0,0,0,0,0,0,0,0,0,0
20200312,058278,FBVIX中信03購02,2.86,3.33,2.86,3.21,+0.48,17.58,1067000,73,3315450,0,0,0,0,0,0,729000,338000,391000,391000
20200312,058279,FBVIX中信03購03,,,,,0.00,0.00,0,0,0,0,0,0,0,0,0,0,0,0,0
20200312,05827P,台積電統一96售10,2.98,3.23,2.98,3.23,0.00,0.00,30000,3,91900,0,0,0,0,0,0,0,30000,-30000,-30000
20200312,058280,SGBR2X中信99購01,0.12,0.12,0.05,0.10,-0.03,-23.08,241000,7,17700,0,0,0,0,0,0,0,2000,-2000,-2000
20200312,058281,奇力新中信99購01,0.57,0.57,0.39,0.39,-0.19,-32.76,132000,11,66130,0,0,0,0,0,0,98000,34000,64000,64000
20200312,058282,聯茂中信99購01,0.52,0.52,0.52,0.52,-0.25,-32.47,6000,1,3120,0,0,0,0,0,0,6000,0,6000,6000
20200312,058283,世紀鋼中信99購01,1.42,1.44,1.18,1.24,-0.22,-15.07,385000,26,499200,0,0,0,0,0,0,158000,227000,-69000,-69000
20200312,058284,滬深反群益01購01,1.14,1.19,1.13,1.19,+0.13,12.26,15000,5,17270,0,0,0,0,0,0,0,15000,-15000,-15000
20200312,058285,牧德群益9A購02,0.43,0.43,0.31,0.31,-0.26,-45.61,24000,4,9100,0,0,0,0,0,0,3000,21000,-18000,-18000
20200312,058286,道瓊指國票9B購01,0.51,0.51,0.34,0.42,-0.18,-30.0,248000,21,96410,0,0,0,0,0,0,70000,116000,-46000,-46000
20200312,058287,國巨國票9A購02,1.06,1.07,1.06,1.07,-0.66,-38.15,58000,2,61680,0,0,0,0,0,0,38000,20000,18000,18000
20200312,058288,南亞科國票9A購01,0.80,0.80,0.62,0.62,-0.69,-52.67,59000,2,40000,0,0,0,0,0,0,19000,40000,-21000,-21000
20200312,058289,奇鋐國票9A購01,2.41,2.44,2.02,2.15,-1.00,-31.75,256000,9,545670,0,0,0,0,0,0,46000,210000,-164000,-164000
20200312,05828P,台積電統一97售02,3.25,3.41,3.25,3.40,+0.90,36.0,851000,86,2889050,0,0,0,0,0,0,851000,850000,1000,1000
20200312,058290,南電國票9A購01,1.98,1.98,1.84,1.84,-0.57,-23.65,23000,2,43720,0,0,0,0,0,0,10000,13000,-3000,-3000
20200312,058291,元油2X日盛99購01,0.07,0.07,0.05,0.05,0.00,0.00,145000,3,7450,0,0,0,0,0,0,0,0,0,0
20200312,058292,上銀凱基9A購01,0.88,0.88,0.72,0.72,-0.33,-31.43,98000,4,82940,0,0,0,0,0,0,68000,30000,38000,38000
20200312,058293,光寶科凱基9A購01,1.17,1.17,1.06,1.06,-0.26,-19.7,77000,4,83480,0,0,0,0,0,0,67000,10000,57000,57000
20200312,058294,華新科凱基9A購01,0.81,0.81,0.81,0.81,-0.11,-11.96,10000,1,8100,0,0,0,0,0,0,10000,10000,0,0
20200312,058295,欣興凱基99購02,0.99,0.99,0.77,0.79,-0.68,-46.26,40000,4,35000,0,0,0,0,0,0,10000,30000,-20000,-20000
20200312,058296,明泰凱基99購01,0.79,0.79,0.72,0.72,-0.18,-20.0,393000,10,298040,0,0,0,0,0,0,230000,163000,67000,67000
20200312,058297,茂林凱基9A購02,0.77,0.77,0.77,0.77,+0.01,1.32,10000,1,7700,0,0,0,0,0,0,10000,0,10000,10000
20200312,058298,聯茂凱基99購05,1.14,1.14,1.14,1.14,-0.19,-14.29,3000,1,3420,0,0,0,0,0,0,3000,3000,0,0
20200312,058299,同欣電凱基9A購01,0.51,0.51,0.37,0.40,-0.18,-31.03,330000,11,142540,0,0,0,0,0,0,152000,178000,-26000,-26000
20200312,05829P,臺股指統一96售08,,,,,0.00,0.00,0,0,0,0,0,0,0,0,0,0,0,0,0
20200312,058300,元油2X元大99購09,,,,,0.00,0.00,0,0,0,0,0,0,0,0,0,0,0,0,0
20200312,058301,元油2X元大99購10,,,,,0.00,0.00,0,0,0,0,0,0,0,0,0,0,0,0,0
20200312,058302,元油2X元大99購11,,,,,0.00,0.00,0,0,0,0,0,0,0,0,0,0,0,0,0
20200312,058303,華通元大99購03,2.50,2.52,1.78,1.78,-0.96,-35.04,445000,45,967100,0,0,0,0,0,0,379000,175000,204000,204000
20200312,058304,鴻海元大99購12,2.72,2.72,2.26,2.33,-0.70,-23.1,97000,22,232550,0,0,0,0,0,0,47000,73000,-26000,-26000
20200312,058305,華邦電元大99購02,0.82,0.87,0.82,0.82,-0.43,-34.4,98000,4,84160,0,0,0,0,0,0,10000,98000,-88000,-88000
20200312,058306,聯發科元大99購07,2.80,2.80,2.25,2.33,-0.73,-23.86,174000,6,470120,0,0,0,0,0,0,174000,174000,0,0
20200312,058307,聯發科元大99購08,2.77,2.77,2.20,2.33,-0.70,-23.1,345000,8,851080,0,0,0,0,0,0,293000,345000,-52000,-52000
20200312,058308,全新元大9B購01,0.50,0.50,0.44,0.44,-0.21,-32.31,60000,3,26700,0,0,0,0,0,0,0,60000,-60000,-60000
20200312,058309,大毅元大99購02,2.30,2.30,2.10,2.10,-0.70,-25.0,30000,2,65000,0,0,0,0,0,0,30000,20000,10000,10000
20200312,05830P,滬深2X元富99售03,2.28,2.54,2.28,2.44,+0.35,16.75,276000,26,663580,0,0,0,0,0,0,171000,105000,66000,66000
20200312,058310,大立光元大99購10,2.37,2.37,2.01,2.01,-1.33,-39.82,62000,15,133630,0,0,0,0,0,0,1000,62000,-61000,-61000
20200312,058311,緯穎元大99購05,2.85,2.86,2.14,2.28,-0.74,-24.5,126000,35,304470,0,0,0,0,0,0,55000,121000,-66000,-66000
20200312,058312,大毅國泰9B購01,0.96,0.96,0.91,0.91,-0.20,-18.02,15000,2,14150,0,0,0,0,0,0,5000,10000,-5000,-5000
20200312,058313,台積電富邦9B購04,0.58,0.59,0.47,0.57,-0.16,-21.92,519000,9,298290,0,0,0,0,0,0,512000,416000,96000,96000
20200312,058314,欣興富邦9B購01,0.34,0.34,0.31,0.31,-0.27,-46.55,11000,3,3710,0,0,0,0,0,0,5000,6000,-1000,-1000
20200312,058315,TPK富邦9C購01,0.64,0.64,0.55,0.55,-0.18,-24.66,278000,41,168960,0,0,0,0,0,0,278000,0,278000,278000
20200312,058316,元油2X永豐9A購03,,,,,0.00,0.00,0,0,0,0,0,0,0,0,0,0,0,0,0
20200312,058317,國巨永豐99購02,0.77,0.77,0.77,0.77,-0.25,-24.51,47000,1,36190,0,0,0,0,0,0,47000,0,47000,47000
20200312,058318,致茂永豐9A購01,0.59,0.59,0.46,0.46,-0.28,-37.84,189000,23,103050,0,0,0,0,0,0,101000,88000,13000,13000
20200312,058319,大毅永豐9A購01,0.79,0.79,0.79,0.79,-0.22,-21.78,3000,1,2370,0,0,0,0,0,0,3000,0,3000,3000
20200312,05831P,臺股指元富96售03,,,,,0.00,0.00,0,0,0,0,0,0,0,0,0,0,0,0,0
20200312,058320,華新科永豐99購02,0.63,0.63,0.45,0.45,-0.25,-35.71,196000,5,113400,0,0,0,0,0,0,186000,20000,166000,166000
20200312,058321,大立光永豐99購01,1.14,1.14,0.88,0.90,-0.68,-43.04,261000,45,254240,0,0,0,0,0,0,185000,251000,-66000,-66000
20200312,058322,玉晶光永豐99購02,0.83,0.83,0.69,0.72,-0.27,-27.27,312000,17,234470,0,0,0,0,0,0,112000,200000,-88000,-88000
20200312,058323,泰鼎永豐9A購01,0.76,0.76,0.57,0.66,-0.29,-30.53,274000,9,196270,0,0,0,0,0,0,274000,0,274000,274000
20200312,058324,嘉聯益永豐9A購01,0.92,0.92,0.67,0.67,-0.40,-37.38,130000,9,103000,0,0,0,0,0,0,15000,115000,-100000,-100000
20200312,058325,昇陽半永豐99購01,1.04,1.04,0.99,0.99,-0.28,-22.05,20000,2,20300,0,0,0,0,0,0,20000,0,20000,20000
20200312,058326,祥碩台新99購01,1.83,1.93,1.73,1.73,-0.15,-7.98,571000,8,1060200,0,0,0,0,0,0,338000,233000,105000,105000
20200312,058327,大毅統一9B購01,0.54,0.54,0.45,0.45,-0.19,-29.69,126000,6,65850,0,0,0,0,0,0,116000,10000,106000,106000
20200312,058328,世紀鋼統一9B購01,0.87,0.87,0.79,0.82,-0.12,-12.77,23000,4,19120,0,0,0,0,0,0,18000,5000,13000,13000
20200312,058329,S&P正2元富01購01,0.35,0.38,0.25,0.38,-0.04,-9.52,2815000,76,845380,0,0,0,0,0,0,554000,2237000,-1683000,-1683000
20200312,05832P,臺股指元富96售04,,,,,0.00,0.00,0,0,0,0,0,0,0,0,0,0,0,0,0
20200312,058330,鴻海元富99購01,1.52,1.55,1.27,1.28,-0.50,-28.09,189000,12,251250,0,0,0,0,0,0,41000,159000,-118000,-118000
20200312,058331,鴻海元富99購02,1.29,1.31,1.11,1.11,-0.54,-32.73,50000,4,61100,0,0,0,0,0,0,10000,40000,-30000,-30000
20200312,058332,鴻海元富99購03,1.51,1.57,1.21,1.33,-0.55,-29.26,170000,15,241610,0,0,0,0,0,0,75000,134000,-59000,-59000
20200312,058333,鴻海元富99購04,1.48,1.49,1.42,1.42,-0.36,-20.22,51000,5,74720,0,0,0,0,0,0,20000,31000,-11000,-11000
20200312,058334,鴻海元富99購05,1.38,1.39,1.12,1.15,-0.52,-31.14,60000,4,73400,0,0,0,0,0,0,30000,30000,0,0
20200312,058335,鴻海元富99購06,1.27,1.28,1.21,1.21,-0.41,-25.31,47000,5,58990,0,0,0,0,0,0,24000,37000,-13000,-13000
20200312,058336,鴻海元富99購07,0.94,0.94,0.94,0.94,-0.48,-33.8,20000,1,18800,0,0,0,0,0,0,20000,0,20000,20000
20200312,058337,日月光元富99購01,1.22,1.23,0.85,0.85,-0.50,-37.04,175000,13,182600,0,0,0,0,0,0,40000,135000,-95000,-95000
20200312,058338,康友元富99購01,2.25,2.26,1.84,1.92,-0.74,-27.82,191000,14,403620,0,0,0,0,0,0,118000,105000,13000,13000
20200312,058339,康友元富99購02,2.03,2.03,1.64,1.64,-0.52,-24.07,94000,5,188630,0,0,0,0,0,0,93000,4000,89000,89000
20200312,05833P,臺股指元富96售05,,,,,0.00,0.00,0,0,0,0,0,0,0,0,0,0,0,0,0
20200312,058340,高股息群益99購01,0.54,0.54,0.40,0.41,0.00,0.00,14000,4,5920,0,0,0,0,0,0,0,14000,-14000,-14000
20200312,058341,T50反1群益99購01,0.84,1.20,0.84,1.16,+0.40,52.63,3277000,136,3286520,0,0,0,0,0,0,422000,2820000,-2398000,-2398000
20200312,058342,鴻海群益9A購01,1.93,1.97,1.55,1.60,-0.60,-27.27,72000,34,126760,0,0,0,0,0,0,43000,62000,-19000,-19000
20200312,058343,台積電群益99購02,1.56,1.56,1.16,1.45,-0.45,-23.68,684000,24,964010,0,0,0,0,0,0,359000,399000,-40000,-40000
20200312,058344,旺宏群益99購05,2.24,2.24,1.94,1.99,-0.97,-32.77,50000,7,102460,0,0,0,0,0,0,35000,50000,-15000,-15000
20200312,058345,台光電群益99購03,1.10,1.10,0.77,0.78,-0.46,-37.1,290000,11,283680,0,0,0,0,0,0,184000,106000,78000,78000
20200312,058346,嘉晶群益99購01,1.28,1.40,1.04,1.21,-0.10,-7.63,175000,18,233280,0,0,0,0,0,0,49000,126000,-77000,-77000
20200312,058347,玉晶光群益9B購01,3.62,3.62,2.70,2.73,-1.77,-39.33,168000,13,555560,0,0,0,0,0,0,7000,166000,-159000,-159000
20200312,058348,台表科群益99購01,1.12,1.12,0.79,0.79,-0.51,-39.23,216000,10,219370,0,0,0,0,0,0,171000,45000,126000,126000
20200312,058349,滬深2X日盛9A購01,,,,,0.00,0.00,0,0,0,0,0,0,0,0,0,0,0,0,0
20200312,05834P,臺股指元富96售06,,,,,0.00,0.00,0,0,0,0,0,0,0,0,0,0,0,0,0
20200312,058350,T50正2凱基9B購01,0.55,0.55,0.41,0.44,-0.40,-47.62,663000,25,305790,0,0,0,0,0,0,0,663000,-663000,-663000
20200312,058351,上銀凱基9A購02,0.98,0.98,0.86,0.86,-0.27,-23.89,93000,6,86210,0,0,0,0,0,0,33000,60000,-27000,-27000
20200312,058352,鴻海凱基9A購05,1.33,1.36,1.13,1.14,-0.43,-27.39,61000,13,79880,0,0,0,0,0,0,15000,59000,-44000,-44000
20200312,058353,國巨凱基99購09,1.01,1.01,0.82,0.82,-0.51,-38.35,20000,2,18300,0,0,0,0,0,0,10000,10000,0,0
20200312,058354,台積電凱基9A購06,1.20,1.21,0.96,1.11,-0.22,-16.54,559000,38,612690,0,0,0,0,0,0,146000,520000,-374000,-374000
20200312,058355,旺宏凱基99購04,1.65,1.65,1.65,1.65,0.00,0.00,5000,1,8250,0,0,0,0,0,0,0,5000,-5000,-5000
20200312,058356,華邦電凱基99購01,1.10,1.11,0.78,0.78,-0.56,-41.79,311000,5,326280,0,0,0,0,0,0,301000,10000,291000,291000
20200312,058357,智邦凱基99購02,1.69,1.74,1.69,1.74,-0.45,-20.55,7000,2,12130,0,0,0,0,0,0,1000,7000,-6000,-6000
20200312,058358,技嘉凱基9A購01,1.16,1.20,1.14,1.14,-0.22,-16.18,26000,4,30590,0,0,0,0,0,0,26000,26000,0,0
20200312,058359,瑞昱凱基99購01,1.56,1.56,1.56,1.56,-0.43,-21.61,4000,2,6240,0,0,0,0,0,0,0,4000,-4000,-4000
20200312,05835P,臺股指元富96售07,,,,,0.00,0.00,0,0,0,0,0,0,0,0,0,0,0,0,0
20200312,058360,台光電凱基9A購02,1.82,1.82,1.45,1.50,-0.48,-24.24,106000,15,169980,0,0,0,0,0,0,13000,93000,-80000,-80000
20200312,058361,美律凱基99購06,1.24,1.24,1.01,1.01,-0.48,-32.21,136000,10,147500,0,0,0,0,0,0,8000,128000,-120000,-120000
20200312,058362,聯發科凱基99購06,1.74,1.74,1.50,1.55,-0.79,-33.76,128000,4,216020,0,0,0,0,0,0,0,128000,-128000,-128000
20200312,058363,全新凱基9A購02,1.35,1.35,1.15,1.15,-0.40,-25.81,45000,5,56450,0,0,0,0,0,0,35000,10000,25000,25000
20200312,058364,奇力新凱基99購04,0.64,0.74,0.64,0.74,-0.31,-29.52,15000,2,10100,0,0,0,0,0,0,10000,5000,5000,5000
20200312,058365,奇力新凱基9A購01,0.84,0.85,0.64,0.66,-0.25,-27.47,687000,18,486750,0,0,0,0,0,0,463000,230000,233000,233000
20200312,058366,元大金凱基99購01,0.43,0.47,0.43,0.47,0.00,0.00,93000,3,40990,0,0,0,0,0,0,0,93000,-93000,-93000
20200312,058367,大立光凱基9A購01,0.97,0.97,0.78,0.80,-0.46,-36.51,345000,16,301930,0,0,0,0,0,0,41000,308000,-267000,-267000
20200312,058368,奇鋐凱基9A購01,1.47,1.55,1.27,1.28,-0.40,-23.81,251000,29,353890,0,0,0,0,0,0,170000,183000,-13000,-13000
20200312,058369,亞光凱基99購02,1.50,1.50,1.50,1.50,-0.22,-12.79,1000,1,1500,0,0,0,0,0,0,1000,0,1000,1000
20200312,05836P,臺股指元富96售08,4.00,4.00,4.00,4.00,+1.89,89.57,10000,1,40000,0,0,0,0,0,0,10000,0,10000,10000
20200312,058370,聯詠凱基99購01,1.02,1.02,0.77,0.77,-0.55,-41.67,20000,2,17900,0,0,0,0,0,0,0,20000,-20000,-20000
20200312,058371,智原凱基9A購01,0.95,0.95,0.75,0.76,-0.65,-46.1,123000,8,104360,0,0,0,0,0,0,33000,113000,-80000,-80000
20200312,058372,欣興凱基99購03,1.17,1.19,0.97,0.98,-0.82,-45.56,59000,6,64120,0,0,0,0,0,0,38000,21000,17000,17000
20200312,058373,晶技凱基99購02,1.95,1.97,1.26,1.26,-0.71,-36.04,264000,40,433690,0,0,0,0,0,0,115000,211000,-96000,-96000
20200312,058374,玉晶光凱基9A購03,1.04,1.05,1.04,1.05,-0.48,-31.37,4000,2,4190,0,0,0,0,0,0,1000,4000,-3000,-3000
20200312,058375,群創凱基9B購04,0.96,0.96,0.78,0.81,-0.29,-26.36,183000,5,149320,0,0,0,0,0,0,3000,183000,-180000,-180000
20200312,058376,貿聯凱基9A購01,1.00,1.00,0.76,0.76,-0.27,-26.21,154000,11,130740,0,0,0,0,0,0,76000,78000,-2000,-2000
20200312,058377,茂林凱基9A購03,1.05,1.05,0.79,0.80,-0.30,-27.27,316000,11,285170,0,0,0,0,0,0,136000,180000,-44000,-44000
20200312,058378,南電凱基99購01,1.53,1.53,1.43,1.43,-0.44,-23.53,103000,2,147590,0,0,0,0,0,0,103000,0,103000,103000
20200312,058379,臺股指凱基99購14,0.70,0.70,0.33,0.44,-0.33,-42.86,6228000,231,2962190,0,0,0,0,0,0,497000,5700000,-5203000,-5203000
20200312,05837P,臺股指富邦96售04,,,,,0.00,0.00,0,0,0,0,0,0,0,0,0,0,0,0,0
20200312,058380,臺股指凱基99購15,0.56,0.56,0.26,0.35,-0.29,-45.31,5051000,141,1942410,0,0,0,0,0,0,293000,4748000,-4455000,-4455000
20200312,058381,元石油中信9C購01,0.25,0.30,0.23,0.29,-0.10,-25.64,398000,19,108280,0,0,0,0,0,0,0,0,0,0
20200312,058382,S&P500中信99購01,0.32,0.32,0.24,0.26,-0.16,-38.1,84000,5,24420,0,0,0,0,0,0,7000,77000,-70000,-70000
20200312,058383,道瓊指中信9C購02,0.36,0.36,0.31,0.35,-0.17,-32.69,1511000,25,494520,0,0,0,0,0,0,180000,1331000,-1151000,-1151000
20200312,058384,大成鋼中信99購01,0.74,0.74,0.73,0.73,-0.03,-3.95,98000,4,71940,0,0,0,0,0,0,10000,88000,-78000,-78000
20200312,058385,創意中信99購01,1.17,1.17,1.10,1.10,-0.43,-28.1,64000,4,72900,0,0,0,0,0,0,16000,48000,-32000,-32000
20200312,058386,A50正2國票9B購01,,,,,0.00,0.00,0,0,0,0,0,0,0,0,0,0,0,0,0
20200312,058387,國巨國票9A購03,1.35,1.35,1.15,1.15,-1.05,-47.73,53000,4,66290,0,0,0,0,0,0,0,53000,-53000,-53000
20200312,058388,健策國票9A購01,0.70,0.71,0.56,0.56,-0.43,-43.43,696000,18,470900,0,0,0,0,0,0,0,696000,-696000,-696000
20200312,058389,聯茂國票9A購01,,,,,0.00,0.00,0,0,0,0,0,0,0,0,0,0,0,0,0
20200312,05838P,臺股指富邦96售05,,,,,0.00,0.00,0,0,0,0,0,0,0,0,0,0,0,0,0
20200312,058390,樺漢國票9A購01,2.95,2.95,2.83,2.83,-0.87,-23.51,17000,2,49190,0,0,0,0,0,0,9000,8000,1000,1000
20200312,058391,T50反1元大99購02,1.11,1.35,1.11,1.23,0.00,0.00,662000,12,857020,0,0,0,0,0,0,31000,631000,-600000,-600000
20200312,058392,元油2X元大99購12,0.06,0.09,0.03,0.08,-0.07,-46.67,10863000,110,426310,0,0,0,0,0,0,0,9995000,-9995000,-9995000
20200312,058393,元油2X元大99購13,0.05,0.05,0.03,0.03,-0.08,-72.73,2535000,30,89800,0,0,0,0,0,0,0,2221000,-2221000,-2221000
20200312,058394,元油2X元大99購14,0.04,0.04,0.03,0.04,-0.02,-33.33,1148000,9,41830,0,0,0,0,0,0,0,1148000,-1148000,-1148000
20200312,058395,元油2X元大99購15,0.02,0.03,0.02,0.03,-0.01,-25.0,1393000,14,32850,0,0,0,0,0,0,0,0,0,0
20200312,058396,力山元大99購01,1.18,1.18,1.18,1.18,-0.45,-27.61,10000,1,11800,0,0,0,0,0,0,10000,0,10000,10000
20200312,058397,大成鋼元大99購02,2.27,2.27,2.08,2.19,-0.13,-5.6,330000,19,717330,0,0,0,0,0,0,274000,194000,80000,80000
20200312,058398,中環元大99購02,0.62,0.62,0.60,0.60,-0.44,-42.31,15000,2,9100,0,0,0,0,0,0,0,15000,-15000,-15000
20200312,058399,美律元大99購05,0.82,0.82,0.65,0.65,-0.20,-23.53,96000,4,76660,0,0,0,0,0,0,28000,68000,-40000,-40000
20200312,05839P,臺股指富邦96售06,2.90,2.90,2.90,2.90,0.00,0.00,10000,1,29000,0,0,0,0,0,0,0,10000,-10000,-10000
20200312,058400,聯發科元大99購09,2.66,2.66,2.13,2.23,-0.68,-23.37,277000,14,641720,0,0,0,0,0,0,209000,277000,-68000,-68000
20200312,058401,華航元大9A購01,0.77,0.77,0.71,0.71,-0.18,-20.22,210000,3,155100,0,0,0,0,0,0,0,210000,-210000,-210000
20200312,058402,欣興元大99購04,2.01,2.01,1.44,1.49,-0.82,-35.5,135000,7,218180,0,0,0,0,0,0,67000,97000,-30000,-30000
20200312,058403,玉晶光元大99購12,2.56,2.56,2.06,2.19,-0.95,-30.25,10000,8,21970,0,0,0,0,0,0,9000,10000,-1000,-1000
20200312,058404,貿聯元大99購02,0.87,0.87,0.66,0.69,-0.22,-24.18,206000,5,149190,0,0,0,0,0,0,136000,182000,-46000,-46000
20200312,058405,訊連元大99購02,0.92,0.92,0.87,0.87,-0.16,-15.53,13000,2,11460,0,0,0,0,0,0,0,13000,-13000,-13000
20200312,058406,聯茂元大99購06,1.02,1.02,0.75,0.75,-0.30,-28.57,200000,7,183910,0,0,0,0,0,0,19000,181000,-162000,-162000
20200312,058407,滬深2X兆豐9A購01,,,,,0.00,0.00,0,0,0,0,0,0,0,0,0,0,0,0,0
20200312,058408,華通兆豐99購02,0.85,0.85,0.59,0.59,-0.41,-41.0,275000,8,213880,0,0,0,0,0,0,255000,105000,150000,150000
20200312,058409,鴻海兆豐99購05,0.82,0.82,0.75,0.75,-0.22,-22.68,23000,4,17950,0,0,0,0,0,0,1000,23000,-22000,-22000
20200312,05840P,臺股指富邦96售07,,,,,0.00,0.00,0,0,0,0,0,0,0,0,0,0,0,0,0
20200312,058410,國巨兆豐99購03,1.25,1.30,1.19,1.19,-0.99,-45.41,123000,10,149480,0,0,0,0,0,0,0,123000,-123000,-123000
20200312,058411,技嘉兆豐99購01,0.55,0.55,0.52,0.52,-0.11,-17.46,16000,2,8500,0,0,0,0,0,0,16000,0,16000,16000
20200312,058412,聯發科兆豐99購01,0.79,0.81,0.75,0.75,-0.32,-29.91,51000,4,40970,0,0,0,0,0,0,14000,37000,-23000,-23000
20200312,058413,義隆兆豐99購01,0.76,0.77,0.67,0.69,-0.25,-26.6,56000,4,39410,0,0,0,0,0,0,36000,20000,16000,16000
20200312,058414,大立光兆豐99購02,0.92,0.98,0.86,0.86,-0.81,-48.5,104000,9,96900,0,0,0,0,0,0,0,104000,-104000,-104000
20200312,058415,祥碩兆豐99購01,1.03,1.06,0.80,0.89,-0.17,-16.04,165000,13,152780,0,0,0,0,0,0,68000,92000,-24000,-24000
20200312,058416,鴻海麥證99購01,1.16,1.16,0.95,0.95,-0.43,-31.16,24000,5,27270,1000,23000,-22000,0,0,0,4000,24000,-20000,-20000
20200312,058417,國巨麥證99購01,2.41,2.41,1.85,1.85,-1.02,-35.54,20000,2,42600,10000,10000,0,0,0,0,10000,10000,0,0
20200312,058418,台積電麥證99購01,,,,,0.00,0.00,0,0,0,0,0,0,0,0,0,0,0,0,0
20200312,058419,聯發科麥證99購02,1.90,1.90,1.65,1.65,-0.56,-25.34,55000,7,98280,0,55000,-55000,0,0,0,0,55000,-55000,-55000
20200312,05841P,華通元大96售04,1.64,1.64,1.64,1.64,+0.18,12.33,10000,1,16400,0,0,0,0,0,0,10000,0,10000,10000
20200312,058420,聯發科麥證99購03,1.75,1.75,1.45,1.45,-1.11,-43.36,60000,6,97400,0,60000,-60000,0,0,0,0,60000,-60000,-60000
20200312,058421,國泰金麥證01購01,1.47,1.47,1.30,1.37,-0.29,-17.47,217000,13,293860,15000,202000,-187000,0,0,0,15000,202000,-187000,-187000
20200312,058422,百和麥證99購01,1.72,1.73,1.18,1.18,-0.69,-36.9,58000,17,83270,22000,36000,-14000,0,0,0,22000,36000,-14000,-14000
20200312,058423,臺股指麥證99購01,1.50,1.50,1.50,1.50,-1.66,-52.53,2000,1,3000,0,0,0,0,0,0,0,0,0,0
20200312,058424,滬深2X元富99購04,1.69,1.69,1.45,1.52,-0.32,-17.39,268000,12,430410,0,0,0,0,0,0,5000,263000,-258000,-258000
20200312,058425,S&P正2元富01購02,0.88,0.88,0.59,0.63,-0.47,-42.73,302000,19,199230,0,0,0,0,0,0,20000,282000,-262000,-262000
20200312,058426,旺宏元富99購02,1.94,1.94,1.51,1.60,-0.62,-27.93,832000,21,1369360,0,0,0,0,0,0,114000,718000,-604000,-604000
20200312,058427,大毅元富99購01,,,,,0.00,0.00,0,0,0,0,0,0,0,0,0,0,0,0,0
20200312,058428,大立光元富99購02,2.50,2.50,1.58,1.59,-1.07,-40.23,126000,30,235610,0,0,0,0,0,0,44000,82000,-38000,-38000
20200312,058429,欣興元富99購01,1.49,1.49,1.19,1.19,-0.89,-42.79,149000,5,213170,0,0,0,0,0,0,38000,111000,-73000,-73000
20200312,05842P,台積電元大96售15,5.65,5.85,5.65,5.85,+0.80,15.84,165000,8,955800,0,0,0,0,0,0,150000,51000,99000,99000
20200312,058430,滬深2X統一99購02,,,,,0.00,0.00,0,0,0,0,0,0,0,0,0,0,0,0,0
20200312,058431,國巨統一9B購01,1.38,1.38,1.06,1.06,-0.56,-34.57,86000,8,108800,0,0,0,0,0,0,0,86000,-86000,-86000
20200312,058432,台積電統一9B購03,0.56,0.56,0.49,0.49,-0.14,-22.22,241000,8,129530,0,0,0,0,0,0,0,241000,-241000,-241000
20200312,058433,台積電統一9B購04,0.96,0.96,0.77,0.93,-0.13,-12.26,734000,33,661970,0,0,0,0,0,0,49000,690000,-641000,-641000
20200312,058434,旺宏統一9B購01,0.90,0.90,0.80,0.80,-0.20,-20.0,118000,4,100400,0,0,0,0,0,0,0,118000,-118000,-118000
20200312,058435,旺宏統一9B購02,0.73,0.73,0.73,0.73,0.00,0.00,10000,1,7300,0,0,0,0,0,0,0,10000,-10000,-10000
20200312,058436,聯發科統一9B購03,0.93,0.93,0.68,0.71,-0.33,-31.73,283000,13,213690,0,0,0,0,0,0,20000,263000,-243000,-243000
20200312,058437,可成統一9B購01,0.50,0.50,0.34,0.34,-0.24,-41.38,184000,12,78850,0,0,0,0,0,0,101000,53000,48000,48000
20200312,058438,大立光統一9B購01,1.14,1.14,1.01,1.01,-0.53,-34.42,102000,6,109280,0,0,0,0,0,0,32000,70000,-38000,-38000
20200312,058439,玉晶光統一01購02,1.55,1.55,1.26,1.26,-0.44,-25.88,110000,7,144160,0,0,0,0,0,0,3000,109000,-106000,-106000
20200312,05843P,台積電元大96售16,,,,,0.00,0.00,0,0,0,0,0,0,0,0,0,0,0,0,0
20200312,058440,玉晶光統一99購02,,,,,0.00,0.00,0,0,0,0,0,0,0,0,0,0,0,0,0
20200312,058441,T50反1台新03購01,,,,,0.00,0.00,0,0,0,0,0,0,0,0,0,0,0,0,0
20200312,058442,玉晶光台新99購01,,,,,0.00,0.00,0,0,0,0,0,0,0,0,0,0,0,0,0
20200312,058443,T50正2富邦01購01,,,,,0.00,0.00,0,0,0,0,0,0,0,0,0,0,0,0,0
20200312,058444,國巨富邦9B購01,0.60,0.60,0.60,0.60,-0.34,-36.17,30000,1,18000,0,0,0,0,0,0,0,30000,-30000,-30000
20200312,058445,旺宏富邦9C購01,0.67,0.67,0.61,0.61,-0.18,-22.78,150000,2,97500,0,0,0,0,0,0,0,150000,-150000,-150000
20200312,058446,新光金富邦9C購01,0.69,0.69,0.63,0.64,-0.12,-15.79,170000,5,114700,0,0,0,0,0,0,0,170000,-170000,-170000
20200312,058447,玉晶光富邦9A購02,,,,,0.00,0.00,0,0,0,0,0,0,0,0,0,0,0,0,0
20200312,058448,滬深2X永豐9A購01,,,,,0.00,0.00,0,0,0,0,0,0,0,0,0,0,0,0,0
20200312,058449,台積電永豐99購01,0.75,0.75,0.73,0.73,-0.29,-28.43,85000,2,63370,0,0,0,0,0,0,85000,85000,0,0
20200312,05844P,旺宏元大96售07,1.69,2.10,1.69,2.00,+0.36,21.95,901000,50,1753110,0,0,0,0,0,0,658000,606000,52000,52000
20200312,058450,旺宏永豐99購01,1.27,1.27,1.04,1.04,-0.55,-34.59,79000,3,96670,0,0,0,0,0,0,1000,79000,-78000,-78000
20200312,058451,智邦永豐9A購01,1.14,1.14,0.93,0.99,-0.19,-16.1,366000,30,371180,0,0,0,0,0,0,50000,362000,-312000,-312000
20200312,058452,義隆永豐99購02,1.26,1.26,1.13,1.13,-0.51,-31.1,30000,3,36400,0,0,0,0,0,0,10000,20000,-10000,-10000
20200312,058453,可成永豐99購01,0.53,0.53,0.40,0.41,-0.35,-46.05,114000,6,54680,0,0,0,0,0,0,2000,112000,-110000,-110000
20200312,058454,嘉晶永豐99購01,1.34,1.38,1.07,1.16,-0.16,-12.12,204000,19,257520,0,0,0,0,0,0,86000,118000,-32000,-32000
20200312,058455,玉晶光永豐99購03,0.92,0.92,0.73,0.73,-0.58,-44.27,106000,2,90300,0,0,0,0,0,0,38000,68000,-30000,-30000
20200312,058456,京鼎永豐99購01,0.51,0.51,0.36,0.36,-0.31,-46.27,278000,14,109940,0,0,0,0,0,0,10000,268000,-258000,-258000
20200312,058457,創意永豐99購01,0.89,0.90,0.86,0.86,-0.14,-14.0,69000,3,59680,0,0,0,0,0,0,1000,68000,-67000,-67000
20200312,058458,牧德永豐9A購01,0.74,0.74,0.74,0.74,0.00,0.00,10000,1,7400,0,0,0,0,0,0,0,10000,-10000,-10000
20200312,058459,南電永豐99購01,0.99,0.99,0.96,0.96,-0.32,-25.0,11000,2,10860,0,0,0,0,0,0,1000,10000,-9000,-9000
20200312,05845P,大立光元大96售06,4.85,5.05,4.85,5.00,+1.95,63.93,102000,5,505250,0,0,0,0,0,0,67000,95000,-28000,-28000
20200312,058460,臺股指永豐99購01,,,,,0.00,0.00,0,0,0,0,0,0,0,0,0,0,0,0,0
20200312,058461,滬深2X永昌9C購01,,,,,0.00,0.00,0,0,0,0,0,0,0,0,0,0,0,0,0
20200312,058462,台積電兆豐99購01,0.85,0.85,0.65,0.77,-0.17,-18.09,1158000,58,889120,3000,0,3000,0,0,0,699000,598000,101000,104000
20200312,058463,宏達電兆豐99購02,,,,,0.00,0.00,0,0,0,0,0,0,0,0,0,0,0,0,0
20200312,058464,矽創兆豐9A購01,0.94,0.96,0.72,0.72,-0.27,-27.27,410000,8,356760,0,0,0,0,0,0,50000,360000,-310000,-310000
20200312,058465,元石油中信01購01,,,,,0.00,0.00,0,0,0,0,0,0,0,0,0,0,0,0,0
20200312,058466,SGBR2X中信99購02,0.14,0.14,0.09,0.12,-0.04,-25.0,821000,26,93890,0,0,0,0,0,0,0,20000,-20000,-20000
20200312,058467,日月光中信9A購01,,,,,0.00,0.00,0,0,0,0,0,0,0,0,0,0,0,0,0
20200312,058468,聯茂中信99購02,0.94,0.94,0.93,0.93,-0.12,-11.43,52000,4,48660,0,0,0,0,0,0,32000,20000,12000,12000
20200312,058469,臺股指中信9A購05,0.51,0.51,0.28,0.34,-0.38,-52.78,1225000,12,423100,0,0,0,0,0,0,650000,575000,75000,75000
20200312,05846P,大立光元大96售07,4.14,4.61,4.14,4.61,+1.78,62.9,150000,3,635750,0,0,0,0,0,0,150000,150000,0,0
20200312,058470,台灣50日盛9B購02,0.65,0.65,0.50,0.50,-0.24,-32.43,30000,3,17500,0,0,0,0,0,0,10000,20000,-10000,-10000
20200312,058471,台積電日盛9C購01,1.87,1.87,1.70,1.70,-0.93,-35.36,127000,2,237150,0,0,0,0,0,0,125000,2000,123000,123000
20200312,058472,亞德客凱基9A購01,1.07,1.08,0.91,0.91,-0.42,-31.58,86000,3,90920,0,0,0,0,0,0,26000,86000,-60000,-60000
20200312,058473,上銀凱基9A購03,0.94,0.94,0.93,0.93,-0.27,-22.5,52000,2,48460,0,0,0,0,0,0,52000,0,52000,52000
20200312,058474,鴻海凱基9A購06,1.45,1.45,1.24,1.25,-0.44,-26.04,22000,6,28030,0,0,0,0,0,0,7000,22000,-15000,-15000
20200312,058475,台積電凱基99購06,1.31,1.32,1.00,1.32,-0.82,-38.32,1034000,11,1189680,0,0,0,0,0,0,0,1034000,-1034000,-1034000
20200312,058476,旺宏凱基9A購01,,,,,0.00,0.00,0,0,0,0,0,0,0,0,0,0,0,0,0
20200312,058477,億光凱基9A購01,0.78,0.78,0.60,0.60,-0.30,-33.33,44000,6,30430,0,0,0,0,0,0,36000,44000,-8000,-8000
20200312,058478,聯發科凱基9A購01,1.31,1.31,1.15,1.15,0.00,0.00,136000,5,173460,0,0,0,0,0,0,0,136000,-136000,-136000
20200312,058479,亞光凱基9A購01,,,,,0.00,0.00,0,0,0,0,0,0,0,0,0,0,0,0,0
20200312,05847P,大立光元大96售08,2.45,3.15,2.45,3.08,+0.77,33.33,65000,13,186010,0,0,0,0,0,0,53000,2000,51000,51000
20200312,058480,新日興凱基9A購01,0.83,0.83,0.67,0.67,-0.27,-28.72,15000,2,11650,0,0,0,0,0,0,10000,5000,5000,5000
20200312,058481,玉晶光凱基9A購04,1.20,1.20,0.94,0.94,-0.46,-32.86,240000,3,233400,0,0,0,0,0,0,0,240000,-240000,-240000
20200312,058482,祥碩凱基99購02,1.47,1.47,1.16,1.24,-0.60,-32.61,794000,24,971480,0,0,0,0,0,0,110000,774000,-664000,-664000
20200312,058483,道瓊指國票9A購01,0.34,0.34,0.23,0.27,-0.19,-41.3,2963000,74,781890,0,0,0,0,0,0,50000,2908000,-2858000,-2858000
20200312,058484,元金2X國票04購01,1.22,1.23,1.15,1.15,-0.23,-16.67,81000,9,96220,0,0,0,0,0,0,5000,76000,-71000,-71000
20200312,058485,智邦國票9A購01,2.63,2.63,2.03,2.03,-0.95,-31.88,99000,4,221970,0,0,0,0,0,0,0,99000,-99000,-99000
20200312,058486,大立光國票9A購01,1.66,1.66,1.23,1.23,-2.08,-62.84,321000,7,460470,0,0,0,0,0,0,9000,312000,-303000,-303000
20200312,058487,晶技國票9A購01,2.05,2.13,1.18,1.18,-0.99,-45.62,920000,33,1446540,0,0,0,0,0,0,670000,246000,424000,424000
20200312,058488,華擎國票9A購01,0.80,0.80,0.80,0.80,-0.40,-33.33,18000,1,14400,0,0,0,0,0,0,18000,0,18000,18000
20200312,058489,台灣50群益9B購01,1.13,1.13,0.71,0.94,-0.43,-31.39,796000,40,814920,0,0,0,0,0,0,195000,601000,-406000,-406000
20200312,05848P,臺股指元大96售24,5.80,6.40,5.75,6.40,+1.43,28.77,23000,6,140700,0,0,0,0,0,0,16000,7000,9000,9000
20200312,058490,元黃金群益9B購01,0.96,0.96,0.96,0.96,0.00,0.00,55000,1,52800,0,0,0,0,0,0,0,55000,-55000,-55000
20200312,058491,滬深2X群益01購01,1.53,1.53,1.33,1.38,-0.28,-16.87,52000,12,74310,0,0,0,0,0,0,15000,37000,-22000,-22000
20200312,058492,華通群益9B購01,1.81,1.83,1.67,1.74,-0.56,-24.35,56000,10,98200,0,0,0,0,0,0,56000,40000,16000,16000
20200312,058493,台積電群益9A購01,0.84,0.84,0.66,0.82,-0.13,-13.68,789000,26,625130,0,0,0,0,0,0,484000,309000,175000,175000
20200312,058494,可成群益9B購01,,,,,0.00,0.00,0,0,0,0,0,0,0,0,0,0,0,0,0
20200312,058495,元大金群益9B購01,,,,,0.00,0.00,0,0,0,0,0,0,0,0,0,0,0,0,0
20200312,058496,文曄群益99購01,1.40,1.40,1.39,1.39,-0.10,-6.71,36000,2,50140,0,0,0,0,0,0,36000,0,36000,36000
20200312,058497,新日興群益9B購01,0.97,0.99,0.96,0.99,-0.43,-30.28,16000,4,15520,0,0,0,0,0,0,16000,10000,6000,6000
20200312,058498,世紀鋼群益99購01,1.71,1.71,1.44,1.61,-0.22,-12.02,166000,11,265740,0,0,0,0,0,0,76000,90000,-14000,-14000
20200312,058499,滬深2X元大9C購01,0.82,0.82,0.78,0.82,-0.23,-21.9,189000,6,150780,0,0,0,0,0,0,4000,185000,-181000,-181000
20200312,05849P,臺股指元大96售25,4.38,4.38,4.38,4.38,+0.84,23.73,1000,1,4380,0,0,0,0,0,0,0,1000,-1000,-1000
20200312,058500,元石油元大9C購01,0.20,0.20,0.14,0.15,-0.05,-25.0,3251000,63,503830,0,0,0,0,0,0,140000,2650000,-2510000,-2510000
20200312,058501,S&P正2元大99購01,0.73,0.73,0.38,0.48,-0.35,-42.17,2466000,39,1174070,0,0,0,0,0,0,790000,1676000,-886000,-886000
20200312,058502,鴻海元大99購13,2.16,2.16,1.74,1.80,-0.66,-26.83,14000,14,27050,0,0,0,0,0,0,14000,14000,0,0
20200312,058503,鴻海元大99購14,2.29,2.29,1.88,1.89,-0.74,-28.14,10000,10,21520,0,0,0,0,0,0,10000,10000,0,0
20200312,058504,台積電元大99購07,1.73,1.75,1.25,1.56,-0.60,-27.78,168000,17,267820,0,0,0,0,0,0,136000,168000,-32000,-32000
20200312,058505,台積電元大99購08,2.19,2.19,1.70,1.96,-0.42,-17.65,292000,35,579890,0,0,0,0,0,0,292000,212000,80000,80000
20200312,058506,台積電元大99購09,2.19,2.19,1.80,1.98,-0.40,-16.81,573000,50,1141570,0,0,0,0,0,0,458000,398000,60000,60000
20200312,058507,美律元大9A購01,,,,,0.00,0.00,0,0,0,0,0,0,0,0,0,0,0,0,0
20200312,058508,聯發科元大99購11,2.46,2.46,1.93,2.03,-0.68,-25.09,211000,9,446690,0,0,0,0,0,0,211000,211000,0,0
20200312,058509,聯發科元大99購12,2.39,2.39,1.87,1.87,-0.72,-27.8,100000,14,222000,0,0,0,0,0,0,53000,94000,-41000,-41000
20200312,05850P,台積電兆豐96售06,6.05,6.45,6.05,6.40,+1.05,19.63,510000,9,3171700,0,0,0,0,0,0,376000,334000,42000,42000
20200312,058510,全新元大9B購02,,,,,0.00,0.00,0,0,0,0,0,0,0,0,0,0,0,0,0
20200312,058511,華新科元大9B購01,0.58,0.58,0.58,0.58,-0.17,-22.67,23000,2,13340,0,0,0,0,0,0,0,23000,-23000,-23000
20200312,058512,宏達電元大99購04,,,,,0.00,0.00,0,0,0,0,0,0,0,0,0,0,0,0,0
20200312,058513,宏達電元大99購05,,,,,0.00,0.00,0,0,0,0,0,0,0,0,0,0,0,0,0
20200312,058514,潤泰全元大99購01,1.69,1.70,1.50,1.58,-0.18,-10.23,262000,14,423330,0,0,0,0,0,0,240000,260000,-20000,-20000
20200312,058515,健鼎元大99購01,1.03,1.05,1.03,1.05,-0.22,-17.32,33000,2,34050,0,0,0,0,0,0,33000,0,33000,33000
20200312,058516,健鼎元大99購02,,,,,0.00,0.00,0,0,0,0,0,0,0,0,0,0,0,0,0
20200312,058517,景碩元大99購06,,,,,0.00,0.00,0,0,0,0,0,0,0,0,0,0,0,0,0
20200312,058518,玉晶光元大99購13,0.64,0.64,0.60,0.60,-0.34,-36.17,110000,4,68500,0,0,0,0,0,0,0,110000,-110000,-110000
20200312,058519,嘉澤元大99購01,2.23,2.23,2.23,2.23,-0.64,-22.3,8000,1,17840,0,0,0,0,0,0,8000,0,8000,8000
20200312,05851P,力山群益97售01,3.35,3.67,3.35,3.67,+0.45,13.98,85000,3,304900,0,0,0,0,0,0,85000,0,85000,85000
20200312,058520,智易元大99購03,1.67,1.67,1.67,1.67,-1.10,-39.71,10000,1,16700,0,0,0,0,0,0,0,10000,-10000,-10000
20200312,058521,日月光元大99購01,1.35,1.35,1.14,1.14,0.00,0.00,34000,4,41160,0,0,0,0,0,0,0,34000,-34000,-34000
20200312,058522,聯茂元大99購07,0.98,0.98,0.74,0.76,-0.35,-31.53,93000,9,73640,0,0,0,0,0,0,33000,86000,-53000,-53000
20200312,058523,聯茂元大99購08,0.77,0.77,0.43,0.43,-0.52,-54.74,65000,4,40710,0,0,0,0,0,0,54000,10000,44000,44000
20200312,058524,超眾元大99購04,1.42,1.42,1.41,1.41,-0.49,-25.79,13000,2,18360,0,0,0,0,0,0,13000,13000,0,0
20200312,058525,台虹元大99購02,1.30,1.30,1.14,1.14,-0.41,-26.45,102000,2,132280,0,0,0,0,0,0,2000,100000,-98000,-98000
20200312,058526,鈺齊元大99購02,1.25,1.25,1.10,1.10,-0.41,-27.15,206000,13,229200,0,0,0,0,0,0,6000,200000,-194000,-194000
20200312,058527,世紀鋼元大99購01,2.00,2.01,1.69,1.83,-0.24,-11.59,863000,41,1603010,0,0,0,0,0,0,403000,468000,-65000,-65000
20200312,058528,世紀鋼元大99購02,0.78,0.78,0.52,0.71,-0.10,-12.35,473000,29,332370,0,0,0,0,0,0,276000,157000,119000,119000
20200312,058529,S&P正2元富9B購01,0.51,0.51,0.33,0.37,-0.30,-44.78,906000,19,402620,0,0,0,0,0,0,60000,846000,-786000,-786000
20200312,05852P,嘉晶群益96售01,0.56,0.59,0.54,0.59,+0.05,9.26,132000,7,75570,0,0,0,0,0,0,56000,76000,-20000,-20000
20200312,058530,為升元富99購01,0.93,0.93,0.70,0.73,-0.43,-37.07,231000,23,174540,0,0,0,0,0,0,45000,186000,-141000,-141000
20200312,058531,華通元富99購01,1.97,1.97,1.46,1.46,-0.77,-34.53,283000,26,547310,0,0,0,0,0,0,248000,30000,218000,218000
20200312,058532,禾伸堂元富99購01,0.75,0.75,0.75,0.75,-0.04,-5.06,35000,1,26250,0,0,0,0,0,0,35000,0,35000,35000
20200312,058533,玉晶光元富99購01,,,,,0.00,0.00,0,0,0,0,0,0,0,0,0,0,0,0,0
20200312,058534,友達統一9B購01,,,,,0.00,0.00,0,0,0,0,0,0,0,0,0,0,0,0,0
20200312,058535,玉晶光統一9A購06,,,,,0.00,0.00,0,0,0,0,0,0,0,0,0,0,0,0,0
20200312,058536,群創統一9B購01,0.39,0.39,0.39,0.39,-0.26,-40.0,3000,1,1170,0,0,0,0,0,0,0,3000,-3000,-3000
20200312,058537,彩晶統一9B購01,0.79,0.80,0.79,0.80,-0.21,-20.79,35000,2,27800,0,0,0,0,0,0,35000,0,35000,35000
20200312,058538,智邦台新99購02,1.63,1.63,1.27,1.35,-0.41,-23.3,40000,7,56780,0,0,0,0,0,0,30000,27000,3000,3000
20200312,058539,聯發科台新99購01,0.99,0.99,0.71,0.71,-0.56,-44.09,15000,2,13450,0,0,0,0,0,0,0,15000,-15000,-15000
20200312,05853P,欣興群益96售05,2.30,2.40,2.28,2.40,+0.45,23.08,82000,5,190900,0,0,0,0,0,0,82000,0,82000,82000
20200312,058540,嘉聯益國泰9A購02,,,,,0.00,0.00,0,0,0,0,0,0,0,0,0,0,0,0,0
20200312,058541,T50反1富邦01購01,0.98,1.22,0.98,1.22,+0.32,35.56,510000,3,619560,0,0,0,0,0,0,11000,499000,-488000,-488000
20200312,058542,T50反1富邦9B購01,0.88,1.05,0.88,0.99,+0.24,32.0,519000,9,542820,0,0,0,0,0,0,5000,514000,-509000,-509000
20200312,058543,滬深2X富邦9A購01,,,,,0.00,0.00,0,0,0,0,0,0,0,0,0,0,0,0,0
20200312,058544,FBVIX富邦9B購01,4.68,5.40,4.68,5.30,+0.92,21.0,77000,6,385500,0,0,0,0,0,0,77000,0,77000,77000
20200312,058545,義隆富邦9C購01,0.64,0.65,0.63,0.65,-0.16,-19.75,70000,7,44800,0,0,0,0,0,0,0,70000,-70000,-70000
20200312,058546,玉晶光富邦9B購01,0.46,0.46,0.46,0.46,-0.23,-33.33,10000,1,4600,0,0,0,0,0,0,0,10000,-10000,-10000
20200312,058547,世紀鋼富邦9A購01,0.64,0.65,0.55,0.65,-0.02,-2.99,406000,27,238730,0,0,0,0,0,0,224000,182000,42000,42000
20200312,058548,元石油永豐99購01,0.28,0.30,0.28,0.30,-0.05,-14.29,45000,2,13000,0,0,0,0,0,0,0,20000,-20000,-20000
20200312,058549,藍天永豐99購01,0.73,0.73,0.64,0.71,-0.07,-8.97,379000,6,256030,0,0,0,0,0,0,30000,349000,-319000,-319000
20200312,05854P,華新科凱基96售09,0.87,1.28,0.87,1.28,+0.43,50.59,443000,15,439710,0,0,0,0,0,0,433000,140000,293000,293000
20200312,058550,南亞科永豐99購01,0.32,0.33,0.32,0.33,-0.30,-47.62,12000,2,3910,0,0,0,0,0,0,5000,7000,-2000,-2000
20200312,058551,義隆永豐99購03,1.25,1.25,1.13,1.13,-0.44,-28.03,27000,2,33150,0,0,0,0,0,0,22000,5000,17000,17000
20200312,058552,欣興永豐99購01,0.49,0.49,0.36,0.36,-0.42,-53.85,6000,3,2630,0,0,0,0,0,0,5000,6000,-1000,-1000
20200312,058553,合勤控永豐99購01,0.52,0.52,0.39,0.39,-0.23,-37.1,89000,2,45630,0,0,0,0,0,0,84000,5000,79000,79000
20200312,058554,瀚宇博永豐99購01,0.48,0.48,0.48,0.48,-0.24,-33.33,2000,1,960,0,0,0,0,0,0,0,2000,-2000,-2000
20200312,058555,矽創永豐9A購01,,,,,0.00,0.00,0,0,0,0,0,0,0,0,0,0,0,0,0
20200312,058556,百和永豐99購01,0.78,0.78,0.64,0.64,-0.28,-30.43,161000,20,111140,0,0,0,0,0,0,83000,78000,5000,5000
20200312,058557,健策第一01購01,,,,,0.00,0.00,0,0,0,0,0,0,0,0,0,0,0,0,0
20200312,058558,鴻海日盛9A購02,1.44,1.44,1.22,1.28,-0.73,-36.32,14000,8,18050,0,0,0,0,0,0,12000,13000,-1000,-1000
20200312,058559,華新科日盛99購02,1.05,1.05,1.03,1.03,-0.37,-26.43,46000,3,47780,0,0,0,0,0,0,46000,0,46000,46000
20200312,05855P,滬深2X中信9C售01,0.85,0.88,0.85,0.87,+0.11,14.47,71000,4,60870,0,0,0,0,0,0,60000,11000,49000,49000
20200312,058560,T50反1凱基9A購04,,,,,0.00,0.00,0,0,0,0,0,0,0,0,0,0,0,0,0
20200312,058561,T50反1凱基9A購05,,,,,0.00,0.00,0,0,0,0,0,0,0,0,0,0,0,0,0
20200312,058562,元油2X凱基99購01,0.09,0.11,0.09,0.11,+0.01,10.0,96000,11,9060,0,0,0,0,0,0,0,41000,-41000,-41000
20200312,058563,元油2X凱基9B購07,0.06,0.10,0.03,0.10,0.00,0.00,40000,4,2650,0,0,0,0,0,0,0,10000,-10000,-10000
20200312,058564,元金2X凱基9C購01,0.91,0.92,0.91,0.91,-0.11,-10.78,118000,7,107890,0,0,0,0,0,0,0,118000,-118000,-118000
20200312,058565,鴻海凱基9A購07,1.05,1.05,0.89,0.90,-0.30,-25.0,4000,4,3850,0,0,0,0,0,0,4000,4000,0,0
20200312,058566,聯發科凱基9A購02,2.26,2.28,2.26,2.28,-0.85,-27.16,20000,2,45400,0,0,0,0,0,0,0,20000,-20000,-20000
20200312,058567,華新科凱基9A購02,0.88,0.88,0.77,0.77,-0.26,-25.24,20000,2,16500,0,0,0,0,0,0,10000,20000,-10000,-10000
20200312,058568,宏達電凱基9A購02,0.95,0.95,0.76,0.76,-0.26,-25.49,14000,2,12540,0,0,0,0,0,0,10000,4000,6000,6000
20200312,058569,健策凱基9A購01,0.87,0.87,0.80,0.80,-0.31,-27.93,228000,2,196960,0,0,0,0,0,0,208000,20000,188000,188000
20200312,05856P,A50正2中信99售01,1.76,1.78,1.76,1.78,+0.39,28.06,40000,2,70800,0,0,0,0,0,0,40000,0,40000,40000
20200312,058570,臻鼎凱基9A購01,0.73,0.73,0.69,0.69,0.00,0.00,104000,4,72180,0,0,0,0,0,0,8000,104000,-96000,-96000
20200312,058571,緯穎凱基9A購02,1.24,1.36,1.22,1.28,-0.64,-33.33,340000,7,422400,0,0,0,0,0,0,0,340000,-340000,-340000
20200312,058572,百和凱基9A購01,,,,,0.00,0.00,0,0,0,0,0,0,0,0,0,0,0,0,0
20200312,058573,鴻海群益9A購02,2.07,2.14,1.62,1.68,-0.74,-30.58,40000,29,74910,0,0,0,0,0,0,30000,40000,-10000,-10000
20200312,058574,台積電群益99購03,1.45,1.45,1.11,1.33,-0.41,-23.56,400000,43,525300,0,0,0,0,0,0,369000,396000,-27000,-27000
20200312,058575,智邦群益99購01,1.73,1.73,1.32,1.32,-0.63,-32.31,299000,32,442410,0,0,0,0,0,0,185000,116000,69000,69000
20200312,058576,南亞科群益99購01,1.03,1.03,0.80,0.82,0.00,0.00,45000,5,45400,0,0,0,0,0,0,0,45000,-45000,-45000
20200312,058577,南亞科群益99購02,0.89,0.89,0.76,0.76,-0.73,-48.99,2000,2,1650,0,0,0,0,0,0,0,2000,-2000,-2000
20200312,058578,聯發科群益99購03,,,,,0.00,0.00,0,0,0,0,0,0,0,0,0,0,0,0,0
20200312,058579,聯發科群益99購04,,,,,0.00,0.00,0,0,0,0,0,0,0,0,0,0,0,0,0
20200312,05857P,旺宏中信98售02,1.28,1.54,1.28,1.50,+0.25,20.0,137000,19,191200,0,0,0,0,0,0,70000,67000,3000,3000
20200312,058580,華新科群益99購02,1.30,1.30,0.98,0.98,-0.40,-28.99,934000,15,1143340,0,0,0,0,0,0,883000,10000,873000,873000
20200312,058581,大立光群益99購05,1.30,1.54,1.30,1.54,-1.40,-47.62,150000,4,215400,0,0,0,0,0,0,0,150000,-150000,-150000
20200312,058582,禾伸堂群益99購02,1.17,1.17,1.07,1.07,-0.13,-10.83,69000,8,77270,0,0,0,0,0,0,32000,58000,-26000,-26000
20200312,058583,臻鼎群益99購01,0.66,0.66,0.66,0.66,-0.86,-56.58,5000,1,3300,0,0,0,0,0,0,5000,0,5000,5000
20200312,058584,百和群益9A購01,1.36,1.36,1.29,1.29,-0.26,-16.77,17000,5,22930,0,0,0,0,0,0,17000,0,17000,17000
20200312,058585,S&P正2中信9B購02,0.35,0.35,0.35,0.35,0.00,0.00,40000,2,14000,0,0,0,0,0,0,0,40000,-40000,-40000
20200312,058586,鴻海中信01購02,0.72,0.73,0.62,0.62,-0.19,-23.46,192000,15,131140,0,0,0,0,0,0,115000,67000,48000,48000
20200312,058587,台積電中信9C購03,0.72,0.72,0.60,0.66,-0.11,-14.29,579000,44,386560,0,0,0,0,0,0,61000,533000,-472000,-472000
20200312,058588,致茂中信9B購01,1.17,1.17,0.99,0.99,-0.28,-22.05,320000,28,357830,0,0,0,0,0,0,290000,50000,240000,240000
20200312,058589,群創中信01購01,,,,,0.00,0.00,0,0,0,0,0,0,0,0,0,0,0,0,0
20200312,05858P,矽力中信96售01,0.53,0.59,0.53,0.55,+0.07,14.58,710000,28,393990,0,0,0,0,0,0,231000,389000,-158000,-158000
20200312,058590,南電中信9A購02,0.41,0.41,0.41,0.41,-0.30,-42.25,8000,1,3280,0,0,0,0,0,0,0,8000,-8000,-8000
20200312,058591,台灣50統一9B購02,1.22,1.22,1.01,1.02,-0.47,-31.54,124000,13,134510,0,0,0,0,0,0,25000,99000,-74000,-74000
20200312,058592,聯發科統一9C購01,,,,,0.00,0.00,0,0,0,0,0,0,0,0,0,0,0,0,0
20200312,058593,大立光統一9B購02,0.81,0.81,0.68,0.68,-0.43,-38.74,310000,4,235800,0,0,0,0,0,0,0,310000,-310000,-310000
20200312,058594,台灣50元富9B購03,,,,,0.00,0.00,0,0,0,0,0,0,0,0,0,0,0,0,0
20200312,058595,T50正2元富99購01,0.67,0.79,0.67,0.71,-0.64,-47.41,252000,15,183670,0,0,0,0,0,0,0,252000,-252000,-252000
20200312,058596,旺宏台新99購01,,,,,0.00,0.00,0,0,0,0,0,0,0,0,0,0,0,0,0
20200312,058597,瑞昱台新99購01,0.79,0.79,0.79,0.79,0.00,0.00,40000,1,31600,0,0,0,0,0,0,0,40000,-40000,-40000
20200312,058598,T50反1元大99購04,1.43,1.70,1.43,1.70,+0.47,38.21,87000,5,125480,0,0,0,0,0,0,66000,21000,45000,45000
20200312,058599,T50反1元大99購05,1.29,1.29,1.29,1.29,0.00,0.00,35000,1,45150,0,0,0,0,0,0,0,35000,-35000,-35000
20200312,05859P,台表科國票97售04,6.90,8.35,6.90,8.35,+1.90,29.46,16000,3,117450,0,0,0,0,0,0,7000,9000,-2000,-2000
20200312,058600,國巨元大99購15,1.05,1.05,0.95,0.95,-0.36,-27.48,88000,4,86300,0,0,0,0,0,0,0,88000,-88000,-88000
20200312,058601,台積電元大99購10,1.98,1.98,1.57,1.82,-0.36,-16.51,305000,19,542960,0,0,0,0,0,0,226000,292000,-66000,-66000
20200312,058602,台積電元大99購11,2.04,2.04,1.68,1.87,-0.33,-15.0,284000,18,533090,0,0,0,0,0,0,237000,284000,-47000,-47000
20200312,058603,台積電元大99購12,2.75,2.75,2.23,2.51,-0.43,-14.63,692000,76,1760060,0,0,0,0,0,0,493000,682000,-189000,-189000
20200312,058604,華邦電元大99購03,,,,,0.00,0.00,0,0,0,0,0,0,0,0,0,0,0,0,0
20200312,058605,華邦電元大99購04,,,,,0.00,0.00,0,0,0,0,0,0,0,0,0,0,0,0,0
20200312,058606,聯發科元大99購13,2.51,2.51,1.99,2.09,-0.67,-24.28,130000,11,284890,0,0,0,0,0,0,130000,130000,0,0
20200312,058607,聯發科元大99購14,2.56,2.56,2.02,2.02,-0.76,-27.34,306000,10,681880,0,0,0,0,0,0,246000,306000,-60000,-60000
20200312,058608,華新科元大99購13,2.98,2.98,2.35,2.35,-0.85,-26.56,16000,2,38230,0,0,0,0,0,0,1000,15000,-14000,-14000
20200312,058609,玉山金元大99購01,1.02,1.02,0.88,0.88,-0.21,-19.27,40000,2,39400,0,0,0,0,0,0,10000,40000,-30000,-30000
20200312,05860P,旺宏康和96售01,1.28,1.28,1.23,1.23,+0.23,23.0,16000,3,20020,0,0,0,0,0,0,8000,8000,0,0
20200312,058610,欣興元大99購05,1.67,1.67,1.67,1.67,-0.62,-27.07,10000,1,16700,0,0,0,0,0,0,10000,0,10000,10000
20200312,058611,欣興元大99購06,1.66,1.66,1.66,1.66,-0.63,-27.51,10000,1,16600,0,0,0,0,0,0,10000,0,10000,10000
20200312,058612,健策元大99購02,,,,,0.00,0.00,0,0,0,0,0,0,0,0,0,0,0,0,0
20200312,058613,茂林元大99購03,0.90,0.90,0.66,0.66,-0.25,-27.47,199000,11,153540,0,0,0,0,0,0,62000,174000,-112000,-112000
20200312,058614,台郡元大9A購01,0.83,0.83,0.65,0.67,-0.26,-27.96,171000,24,128030,0,0,0,0,0,0,127000,63000,64000,64000
20200312,058615,矽創元大99購01,1.43,1.43,1.03,1.03,-0.37,-26.43,57000,6,76640,0,0,0,0,0,0,35000,22000,13000,13000
20200312,058616,台虹元大9A購01,0.71,0.71,0.64,0.64,-0.12,-15.79,150000,3,105450,0,0,0,0,0,0,100000,50000,50000,50000
20200312,058617,南電元大99購01,2.63,2.63,2.35,2.35,-0.48,-16.96,12000,2,28760,0,0,0,0,0,0,12000,2000,10000,10000
20200312,058618,南電元大99購02,2.36,2.36,1.81,1.82,-0.77,-29.73,143000,9,265730,0,0,0,0,0,0,143000,133000,10000,10000
20200312,058619,台灣50國票99購04,2.44,2.44,1.66,1.81,-1.09,-37.59,105000,13,216780,0,0,0,0,0,0,57000,58000,-1000,-1000
20200312,05861P,瀚宇博永豐96售02,2.09,2.09,2.09,2.09,+0.22,11.76,2000,1,4180,0,0,0,0,0,0,0,2000,-2000,-2000
20200312,058620,滬深2X國票9A購02,0.83,0.83,0.79,0.82,0.00,0.00,15000,3,12200,0,0,0,0,0,0,0,15000,-15000,-15000
20200312,058621,華通國票9A購01,1.13,1.13,1.00,1.00,-0.31,-23.66,52000,5,56140,0,0,0,0,0,0,52000,10000,42000,42000
20200312,058622,國巨國票99購07,,,,,0.00,0.00,0,0,0,0,0,0,0,0,0,0,0,0,0
20200312,058623,國巨國票99購08,2.65,2.65,1.76,1.76,-1.26,-41.72,546000,21,996130,0,0,0,0,0,0,6000,540000,-534000,-534000
20200312,058624,台積電國票99購09,1.24,1.24,0.97,1.09,-0.38,-25.85,1601000,19,1861950,0,0,0,0,0,0,934000,667000,267000,267000
20200312,058625,旺宏國票9A購01,2.20,2.20,1.74,1.74,-1.00,-36.5,609000,14,1085300,0,0,0,0,0,0,9000,600000,-591000,-591000
20200312,058626,瑞昱國票9A購01,1.95,1.95,1.55,1.55,-0.90,-36.73,44000,4,84170,0,0,0,0,0,0,30000,14000,16000,16000
20200312,058627,聯發科國票99購04,1.51,1.53,1.26,1.32,-0.94,-41.59,1009000,5,1531580,0,0,0,0,0,0,0,1009000,-1009000,-1009000
20200312,058628,宏達電國票9A購01,0.81,0.90,0.81,0.90,-0.41,-31.3,27000,2,22770,0,0,0,0,0,0,17000,10000,7000,7000
20200312,058629,嘉晶國票9A購01,1.69,1.76,1.39,1.46,-0.25,-14.62,107000,18,179580,0,0,0,0,0,0,48000,60000,-12000,-12000
20200312,05862P,大立光國泰98售01,2.11,2.44,2.09,2.44,+0.67,37.85,451000,27,1032170,0,0,0,0,0,0,390000,63000,327000,327000
20200312,058630,日月光國票9A購01,0.76,0.76,0.51,0.51,-0.66,-56.41,33000,2,24330,0,0,0,0,0,0,0,33000,-33000,-33000
20200312,058631,鈺齊國票9A購01,5.25,5.25,4.08,4.12,-2.48,-37.58,36000,6,173870,0,0,0,0,0,0,21000,15000,6000,6000
20200312,058632,世紀鋼國票9A購01,3.38,3.38,2.93,3.00,-0.70,-18.92,121000,11,372200,0,0,0,0,0,0,47000,74000,-27000,-27000
20200312,058633,台灣50兆豐99購01,0.42,0.42,0.32,0.34,-0.29,-46.03,418000,11,143280,0,0,0,0,0,0,50000,368000,-318000,-318000
20200312,058634,可成兆豐99購03,0.49,0.49,0.36,0.37,-0.32,-46.38,62000,8,26140,0,0,0,0,0,0,62000,62000,0,0
20200312,058635,華新科兆豐99購03,0.71,0.71,0.56,0.56,-0.22,-28.21,80000,8,54810,0,0,0,0,0,0,75000,5000,70000,70000
20200312,058636,亞光兆豐9A購01,,,,,0.00,0.00,0,0,0,0,0,0,0,0,0,0,0,0,0
20200312,058637,晶技兆豐99購01,1.28,1.29,0.86,0.87,-0.49,-36.03,505000,50,556930,0,0,0,0,0,0,482000,27000,455000,455000
20200312,058638,矽力兆豐99購01,1.19,1.19,1.19,1.19,-0.23,-16.2,8000,1,9520,0,0,0,0,0,0,8000,0,8000,8000
20200312,058639,南電兆豐99購01,1.06,1.06,0.74,0.74,-0.56,-43.08,13000,3,13060,0,0,0,0,0,0,13000,0,13000,13000
20200312,05863P,滬深2X元大96售09,1.61,1.85,1.61,1.78,+0.24,15.58,1191000,15,2081540,0,0,0,0,0,0,113000,1078000,-965000,-965000
20200312,058640,台灣50麥證9A購01,1.51,1.51,1.17,1.22,-0.78,-39.0,406000,27,519340,0,406000,-406000,0,0,0,150000,406000,-256000,-256000
20200312,058641,鴻海麥證99購02,1.35,1.35,1.08,1.12,-0.43,-27.74,51000,9,63770,3000,48000,-45000,0,0,0,11000,51000,-40000,-40000
20200312,058642,旺宏麥證9A購01,,,,,0.00,0.00,0,0,0,0,0,0,0,0,0,0,0,0,0
20200312,058643,T50正2富邦03購01,0.44,0.44,0.38,0.38,-0.17,-30.91,99000,9,40860,0,0,0,0,0,0,0,99000,-99000,-99000
20200312,058644,元黃金富邦03購01,,,,,0.00,0.00,0,0,0,0,0,0,0,0,0,0,0,0,0
20200312,058645,康控富邦01購01,,,,,0.00,0.00,0,0,0,0,0,0,0,0,0,0,0,0,0
20200312,058646,聯茂富邦9A購01,0.53,0.53,0.48,0.48,-0.14,-22.58,13000,2,6740,0,0,0,0,0,0,13000,0,13000,13000
20200312,058647,華新科永豐99購03,0.53,0.57,0.42,0.42,-0.29,-40.85,30000,3,16250,0,0,0,0,0,0,27000,13000,14000,14000
20200312,058648,聯陽永豐99購01,0.65,0.68,0.65,0.68,-0.14,-17.07,23000,2,15550,0,0,0,0,0,0,3000,20000,-17000,-17000
20200312,058649,健策永豐99購01,,,,,0.00,0.00,0,0,0,0,0,0,0,0,0,0,0,0,0
20200312,05864P,元油反元大96售07,,,,,0.00,0.00,0,0,0,0,0,0,0,0,0,0,0,0,0
20200312,058650,台虹永豐9A購01,0.81,0.81,0.81,0.81,-0.16,-16.49,22000,1,17820,0,0,0,0,0,0,22000,0,22000,22000
20200312,058651,FBVIX中信9C購01,2.29,2.63,2.29,2.47,+0.37,17.62,187000,29,467180,0,0,0,0,0,0,70000,128000,-58000,-58000
20200312,058652,SGBR2X中信01購01,0.44,0.44,0.37,0.38,-0.19,-33.33,39000,7,15380,0,0,0,0,0,0,13000,26000,-13000,-13000
20200312,058653,光寶科中信9A購01,,,,,0.00,0.00,0,0,0,0,0,0,0,0,0,0,0,0,0
20200312,058654,鴻海中信03購01,1.12,1.12,0.95,0.95,-0.32,-25.2,4000,4,4200,0,0,0,0,0,0,4000,4000,0,0
20200312,058655,鴻海中信03購02,0.79,0.79,0.79,0.79,-0.28,-26.17,6000,2,4740,0,0,0,0,0,0,1000,6000,-5000,-5000
20200312,058656,燿華中信99購01,1.45,1.45,1.40,1.40,-0.40,-22.22,80000,4,114850,0,0,0,0,0,0,75000,5000,70000,70000
20200312,058657,大立光中信99購01,,,,,0.00,0.00,0,0,0,0,0,0,0,0,0,0,0,0,0
20200312,058658,瑞儀中信99購01,,,,,0.00,0.00,0,0,0,0,0,0,0,0,0,0,0,0,0
20200312,058659,力成中信99購01,1.86,1.86,1.82,1.82,-0.43,-19.11,71000,3,131050,0,0,0,0,0,0,71000,0,71000,71000
20200312,05865P,大立光元大96售09,5.20,5.90,5.20,5.90,+2.28,62.98,211000,3,1099900,0,0,0,0,0,0,211000,210000,1000,1000
20200312,058660,樺漢中信9A購01,2.25,2.25,2.15,2.15,-0.54,-20.07,109000,5,240650,0,0,0,0,0,0,59000,50000,9000,9000
20200312,058661,臺股指中信9C購01,0.77,0.77,0.47,0.49,-0.51,-51.0,577000,28,327140,0,0,0,0,0,0,0,577000,-577000,-577000
20200312,058662,禾伸堂兆豐99購01,1.54,1.54,1.34,1.41,-0.12,-7.84,196000,13,285820,0,0,0,0,0,0,35000,161000,-126000,-126000
20200312,058663,瑞儀兆豐9A購01,0.89,0.89,0.80,0.80,-0.15,-15.79,65000,4,56940,0,0,0,0,0,0,55000,10000,45000,45000
20200312,058664,百和兆豐99購01,1.25,1.25,1.11,1.11,-0.24,-17.78,89000,6,103530,0,0,0,0,0,0,89000,0,89000,89000
20200312,058665,台灣50群益9B購02,2.21,2.21,1.64,1.67,-0.87,-34.25,290000,19,597050,0,0,0,0,0,0,114000,186000,-72000,-72000
20200312,058666,上証反群益01購01,0.82,0.84,0.82,0.83,0.00,0.00,270000,10,225850,0,0,0,0,0,0,0,270000,-270000,-270000
20200312,058667,元油2X群益99購01,0.05,0.05,0.04,0.05,-0.03,-37.5,710000,7,30410,0,0,0,0,0,0,0,0,0,0
20200312,058668,元油2X群益9B購04,0.10,0.11,0.09,0.09,-0.01,-10.0,460000,7,44900,0,0,0,0,0,0,0,0,0,0
20200312,058669,上銀群益99購01,1.72,1.72,1.28,1.28,-0.96,-42.86,35000,4,59310,0,0,0,0,0,0,35000,3000,32000,32000
20200312,05866P,致伸元大96售01,2.87,2.87,2.87,2.87,0.00,0.00,11000,1,31570,0,0,0,0,0,0,11000,0,11000,11000
20200312,058670,鴻海群益9A購03,0.95,0.95,0.75,0.79,-0.43,-35.25,4000,4,3270,0,0,0,0,0,0,4000,4000,0,0
20200312,058671,旺宏群益9A購01,2.61,2.62,2.14,2.14,-1.21,-36.12,56000,9,133770,0,0,0,0,0,0,52000,45000,7000,7000
20200312,058672,可成群益9B購02,0.91,0.91,0.91,0.91,-0.34,-27.2,10000,1,9100,0,0,0,0,0,0,10000,0,10000,10000
20200312,058673,華新科群益9A購02,3.45,3.45,3.45,3.45,-0.65,-15.85,10000,1,34500,0,0,0,0,0,0,10000,10000,0,0
20200312,058674,宏達電群益99購01,,,,,0.00,0.00,0,0,0,0,0,0,0,0,0,0,0,0,0
20200312,058675,康控群益9B購01,,,,,0.00,0.00,0,0,0,0,0,0,0,0,0,0,0,0,0
20200312,058676,聯茂群益99購01,,,,,0.00,0.00,0,0,0,0,0,0,0,0,0,0,0,0,0
20200312,058677,矽格群益99購01,0.94,0.94,0.74,0.78,-0.30,-27.78,135000,4,105780,0,0,0,0,0,0,135000,94000,41000,41000
20200312,058678,南亞科日盛99購01,0.88,0.88,0.88,0.88,-0.41,-31.78,12000,1,10560,0,0,0,0,0,0,12000,0,12000,12000
20200312,058679,可成日盛99購01,1.08,1.08,1.02,1.02,-0.49,-32.45,30000,2,31800,0,0,0,0,0,0,20000,10000,10000,10000
20200312,05867P,友達兆豐97售02,1.38,1.53,1.38,1.53,+0.29,23.39,137000,8,204200,0,0,0,0,0,0,33000,104000,-71000,-71000
20200312,058680,國巨麥證99購02,,,,,0.00,0.00,0,0,0,0,0,0,0,0,0,0,0,0,0
20200312,058681,大立光康和9B購01,,,,,0.00,0.00,0,0,0,0,0,0,0,0,0,0,0,0,0
20200312,058682,聯發科凱基99購07,,,,,0.00,0.00,0,0,0,0,0,0,0,0,0,0,0,0,0
20200312,058683,可成凱基9A購01,,,,,0.00,0.00,0,0,0,0,0,0,0,0,0,0,0,0,0
20200312,058684,健策凱基99購02,,,,,0.00,0.00,0,0,0,0,0,0,0,0,0,0,0,0,0
20200312,058685,TPK凱基99購01,1.20,1.20,1.19,1.19,-0.24,-16.78,47000,2,56230,0,0,0,0,0,0,47000,0,47000,47000
20200312,058686,祥碩凱基99購03,1.24,1.27,1.06,1.15,-0.24,-17.27,661000,13,772660,0,0,0,0,0,0,370000,611000,-241000,-241000
20200312,058687,聯茂凱基9A購01,1.03,1.03,0.84,0.84,-0.63,-42.86,47000,9,40270,0,0,0,0,0,0,2000,47000,-45000,-45000
20200312,058688,矽創凱基9A購01,,,,,0.00,0.00,0,0,0,0,0,0,0,0,0,0,0,0,0
20200312,058689,元油2X國票99購03,0.05,0.05,0.04,0.04,-0.07,-63.64,44000,7,1900,0,0,0,0,0,0,4000,40000,-36000,-36000
20200312,05868P,台積電凱基96售17,5.60,5.85,5.60,5.75,+0.60,11.65,197000,12,1134200,0,0,0,0,0,0,180000,197000,-17000,-17000
20200312,058690,元油2X國票9A購03,0.10,0.10,0.07,0.07,-0.09,-56.25,1289000,12,105420,0,0,0,0,0,0,50000,1239000,-1189000,-1189000
20200312,058691,友訊國票9A購01,1.28,1.28,0.95,1.00,-0.28,-21.88,99000,10,107250,0,0,0,0,0,0,37000,62000,-25000,-25000
20200312,058692,華邦電國票9B購01,,,,,0.00,0.00,0,0,0,0,0,0,0,0,0,0,0,0,0
20200312,058693,旭富國票9A購01,2.99,2.99,1.86,1.86,-1.66,-47.16,175000,7,503610,0,0,0,0,0,0,165000,0,165000,165000
20200312,058694,鈺齊國票9A購02,3.64,3.64,2.87,2.87,-1.48,-34.02,37000,4,121320,0,0,0,0,0,0,10000,27000,-17000,-17000
20200312,058695,元油2X元大9C購03,0.05,0.05,0.04,0.05,-0.06,-54.55,520000,9,24100,0,0,0,0,0,0,0,0,0,0
20200312,058696,元油2X元大9C購04,0.05,0.06,0.05,0.06,-0.03,-33.33,300000,4,16500,0,0,0,0,0,0,0,0,0,0
20200312,058697,亞德客元大99購01,2.18,2.18,1.95,1.95,-0.82,-29.6,70000,4,142960,0,0,0,0,0,0,50000,70000,-20000,-20000
20200312,058698,華通元大99購05,,,,,0.00,0.00,0,0,0,0,0,0,0,0,0,0,0,0,0
20200312,058699,楠梓電元大99購02,1.36,1.36,1.10,1.10,-0.61,-35.67,174000,5,222960,0,0,0,0,0,0,66000,108000,-42000,-42000
20200312,05869P,旺宏凱基96售05,1.76,2.15,1.76,2.07,+0.39,23.21,224000,24,453120,0,0,0,0,0,0,119000,214000,-95000,-95000
20200312,058700,鴻海元大99購15,1.83,1.86,1.50,1.56,-0.70,-30.97,18000,13,28630,0,0,0,0,0,0,15000,18000,-3000,-3000
20200312,058701,鴻海元大99購16,0.99,0.99,0.80,0.80,-0.35,-30.43,107000,10,98170,0,0,0,0,0,0,2000,107000,-105000,-105000
20200312,058702,國巨元大99購16,0.82,0.82,0.74,0.78,-0.39,-33.33,61000,3,48740,0,0,0,0,0,0,1000,60000,-59000,-59000
20200312,058703,台積電元大99購16,0.50,0.58,0.50,0.58,-0.20,-25.64,80000,3,42600,0,0,0,0,0,0,0,80000,-80000,-80000
20200312,058704,台積電元大99購17,0.69,0.83,0.69,0.79,0.00,0.00,305000,9,235000,0,0,0,0,0,0,250000,305000,-55000,-55000
20200312,058705,長榮航元大99購01,1.01,1.01,0.86,0.86,-0.22,-20.37,110000,7,108000,0,0,0,0,0,0,100000,10000,90000,90000
20200312,058706,聯鈞元大9C購01,0.58,0.58,0.58,0.58,-0.23,-28.4,10000,1,5800,0,0,0,0,0,0,0,10000,-10000,-10000
20200312,058707,泰鼎元大99購02,1.49,1.56,1.48,1.56,-0.44,-22.0,52000,3,80970,0,0,0,0,0,0,2000,50000,-48000,-48000
20200312,058708,臺股指元大9A購21,2.56,2.56,2.04,2.19,-0.92,-29.58,234000,31,516370,0,0,0,0,0,0,15000,219000,-204000,-204000
20200312,058709,臺股指元大9A購22,1.60,1.64,1.56,1.64,-0.98,-37.4,67000,7,106600,0,0,0,0,0,0,0,67000,-67000,-67000
20200312,05870P,聯發科凱基96售19,,,,,0.00,0.00,0,0,0,0,0,0,0,0,0,0,0,0,0
20200312,058710,臺股指元大9A購23,1.01,1.07,0.96,1.06,-0.75,-41.44,68000,8,71280,0,0,0,0,0,0,0,68000,-68000,-68000
20200312,058711,鴻海統一9A購02,,,,,0.00,0.00,0,0,0,0,0,0,0,0,0,0,0,0,0
20200312,058712,鴻海統一9B購03,,,,,0.00,0.00,0,0,0,0,0,0,0,0,0,0,0,0,0
20200312,058713,國巨統一9B購02,0.60,0.60,0.47,0.47,-0.37,-44.05,129000,4,70130,0,0,0,0,0,0,0,129000,-129000,-129000
20200312,058714,美律統一9B購01,0.69,0.69,0.57,0.57,-0.20,-25.97,128000,6,87440,0,0,0,0,0,0,76000,52000,24000,24000
20200312,058715,鴻海台新99購02,0.79,0.79,0.60,0.62,-0.50,-44.64,46000,7,30510,0,0,0,0,0,0,6000,44000,-38000,-38000
20200312,058716,華新科台新99購02,,,,,0.00,0.00,0,0,0,0,0,0,0,0,0,0,0,0,0
20200312,058717,南電台新99購02,,,,,0.00,0.00,0,0,0,0,0,0,0,0,0,0,0,0,0
20200312,058718,台灣50元富03購01,1.72,1.72,1.29,1.35,-0.66,-32.84,643000,24,1008280,0,0,0,0,0,0,194000,458000,-264000,-264000
20200312,058719,智邦元富99購01,1.48,1.48,1.45,1.47,-0.33,-18.33,38000,3,56190,0,0,0,0,0,0,3000,35000,-32000,-32000
20200312,05871P,全新凱基96售04,,,,,0.00,0.00,0,0,0,0,0,0,0,0,0,0,0,0,0
20200312,058720,旭富元富99購01,1.72,1.77,1.36,1.36,-0.55,-28.8,1005000,27,1690710,0,0,0,0,0,0,968000,37000,931000,931000
20200312,058721,立積元富9C購01,2.02,2.04,1.99,1.99,-0.45,-18.44,60000,5,121500,0,0,0,0,0,0,20000,40000,-20000,-20000
20200312,058722,台郡元富99購01,0.90,0.90,0.80,0.80,-0.42,-34.43,71000,5,60800,0,0,0,0,0,0,51000,20000,31000,31000
20200312,058723,元石油國泰9A購01,,,,,0.00,0.00,0,0,0,0,0,0,0,0,0,0,0,0,0
20200312,058724,大立光國泰9B購01,0.97,0.97,0.76,0.86,-0.57,-39.86,292000,9,251620,0,0,0,0,0,0,292000,252000,40000,40000
20200312,058725,美律富邦9A購01,0.51,0.51,0.51,0.51,0.00,0.00,65000,4,33150,0,0,0,0,0,0,15000,50000,-35000,-35000
20200312,058726,宏達電富邦9A購01,,,,,0.00,0.00,0,0,0,0,0,0,0,0,0,0,0,0,0
20200312,058727,嘉晶富邦9A購01,0.51,0.58,0.44,0.50,-0.04,-7.41,922000,29,457450,0,0,0,0,0,0,145000,777000,-632000,-632000
20200312,058728,SP黃豆永豐99購01,,,,,0.00,0.00,0,0,0,0,0,0,0,0,0,0,0,0,0
20200312,058729,國巨永豐99購03,,,,,0.00,0.00,0,0,0,0,0,0,0,0,0,0,0,0,0
20200312,05872P,大立光凱基96售15,,,,,0.00,0.00,0,0,0,0,0,0,0,0,0,0,0,0,0
20200312,058730,玉晶光永豐9A購01,,,,,0.00,0.00,0,0,0,0,0,0,0,0,0,0,0,0,0
20200312,058731,貿聯永豐99購02,0.98,0.98,0.81,0.81,-0.25,-23.58,98000,7,88290,0,0,0,0,0,0,98000,39000,59000,59000
20200312,058732,矽格永豐99購01,0.81,0.81,0.70,0.70,-0.23,-24.73,159000,4,116860,0,0,0,0,0,0,159000,92000,67000,67000
20200312,058733,同欣電永豐99購02,0.65,0.65,0.55,0.55,-0.31,-36.05,101000,3,60520,0,0,0,0,0,0,47000,54000,-7000,-7000
20200312,058734,康友永豐99購01,0.79,0.82,0.68,0.69,-0.37,-34.91,17000,6,12180,0,0,0,0,0,0,17000,17000,0,0
20200312,058735,南茂永豐99購01,0.79,0.79,0.68,0.68,-0.42,-38.18,135000,7,104040,0,0,0,0,0,0,94000,41000,53000,53000
20200312,058736,鈺齊永豐99購02,0.50,0.50,0.50,0.50,-0.25,-33.33,50000,1,25000,0,0,0,0,0,0,50000,0,50000,50000
20200312,058737,鴻海第一01購01,,,,,0.00,0.00,0,0,0,0,0,0,0,0,0,0,0,0,0
20200312,058738,FBVIX中信03購04,2.00,2.20,1.90,2.08,+0.30,16.85,1093000,72,2272060,0,0,0,0,0,0,256000,857000,-601000,-601000
20200312,058739,喬山中信99購01,,,,,0.00,0.00,0,0,0,0,0,0,0,0,0,0,0,0,0
20200312,05873P,華通群益97售02,2.62,2.76,2.59,2.76,+0.50,22.12,46000,4,121730,0,0,0,0,0,0,28000,18000,10000,10000
20200312,058740,T50反1日盛9B購02,,,,,0.00,0.00,0,0,0,0,0,0,0,0,0,0,0,0,0
20200312,058741,欣興日盛99購01,,,,,0.00,0.00,0,0,0,0,0,0,0,0,0,0,0,0,0
20200312,058742,鴻海康和99購01,,,,,0.00,0.00,0,0,0,0,0,0,0,0,0,0,0,0,0
20200312,058743,可成康和99購01,,,,,0.00,0.00,0,0,0,0,0,0,0,0,0,0,0,0,0
20200312,058744,FBVIX凱基9C購03,2.43,2.66,2.43,2.58,+0.50,24.04,30000,7,75860,0,0,0,0,0,0,11000,19000,-8000,-8000
20200312,058745,元金2X凱基9C購02,1.34,1.34,1.34,1.34,0.00,0.00,1000,1,1340,0,0,0,0,0,0,0,1000,-1000,-1000
20200312,058746,華通凱基9A購02,1.14,1.14,1.13,1.13,-0.21,-15.67,70000,2,79600,0,0,0,0,0,0,70000,0,70000,70000
20200312,058747,友達凱基9A購03,,,,,0.00,0.00,0,0,0,0,0,0,0,0,0,0,0,0,0
20200312,058748,景碩凱基9A購01,0.82,0.82,0.82,0.82,-0.26,-24.07,10000,1,8200,0,0,0,0,0,0,0,10000,-10000,-10000
20200312,058749,康控凱基99購03,,,,,0.00,0.00,0,0,0,0,0,0,0,0,0,0,0,0,0
20200312,05874P,台積電群益96售10,,,,,0.00,0.00,0,0,0,0,0,0,0,0,0,0,0,0,0
20200312,058750,緯穎凱基9A購03,0.52,0.52,0.50,0.50,0.00,0.00,310000,4,158100,0,0,0,0,0,0,0,310000,-310000,-310000
20200312,058751,南茂凱基9A購01,1.41,1.46,1.33,1.33,-0.44,-24.86,26000,7,37080,0,0,0,0,0,0,8000,18000,-10000,-10000
20200312,058752,鈺齊凱基9A購01,1.21,1.21,1.21,1.21,0.00,0.00,4000,1,4840,0,0,0,0,0,0,0,4000,-4000,-4000
20200312,058753,元石油群益9B購03,0.52,0.52,0.44,0.44,-0.14,-24.14,1134000,21,519740,20000,0,20000,0,0,0,0,1134000,-1134000,-1114000
20200312,058754,元油2X群益99購02,0.11,0.11,0.07,0.09,0.00,0.00,2378000,48,178760,0,0,0,0,0,0,0,0,0,0
20200312,058755,SGBR2X群益99購01,0.18,0.18,0.14,0.15,0.00,0.00,313000,8,49450,0,0,0,0,0,0,0,313000,-313000,-313000
20200312,058756,SGBR2X群益99購02,,,,,0.00,0.00,0,0,0,0,0,0,0,0,0,0,0,0,0
20200312,058757,道瓊銀群益9A購02,,,,,0.00,0.00,0,0,0,0,0,0,0,0,0,0,0,0,0
20200312,058758,台積電群益99購05,1.13,1.14,0.96,1.10,-0.31,-21.99,82000,8,87060,0,0,0,0,0,0,52000,82000,-30000,-30000
20200312,058759,義隆群益99購01,,,,,0.00,0.00,0,0,0,0,0,0,0,0,0,0,0,0,0
20200312,05875P,旺宏群益98售01,2.03,2.30,2.00,2.30,+0.49,27.07,20000,4,41200,0,0,0,0,0,0,17000,3000,14000,14000
20200312,058760,嘉晶群益9A購01,1.42,1.54,1.25,1.29,-0.16,-11.03,1017000,33,1516820,0,0,0,0,0,0,171000,847000,-676000,-676000
20200312,058761,欣興群益99購02,0.99,1.02,0.82,0.82,-0.56,-40.58,38000,4,36340,0,0,0,0,0,0,6000,38000,-32000,-32000
20200312,058762,貿聯群益99購03,1.18,1.18,1.18,1.18,0.00,0.00,35000,1,41300,0,0,0,0,0,0,0,35000,-35000,-35000
20200312,058763,和碩群益99購01,,,,,0.00,0.00,0,0,0,0,0,0,0,0,0,0,0,0,0
20200312,058764,康友群益99購01,2.10,2.16,1.74,1.81,-0.51,-21.98,114000,18,214620,0,0,0,0,0,0,110000,114000,-4000,-4000
20200312,058765,緯穎群益99購03,2.65,2.65,2.65,2.65,0.00,0.00,11000,1,29150,0,0,0,0,0,0,0,11000,-11000,-11000
20200312,058766,力山兆豐99購01,0.68,0.68,0.68,0.68,0.00,0.00,35000,1,23800,0,0,0,0,0,0,0,35000,-35000,-35000
20200312,058767,亞德客兆豐99購01,0.84,0.84,0.79,0.80,0.00,0.00,80000,3,65000,0,0,0,0,0,0,0,80000,-80000,-80000
20200312,058768,南港兆豐99購01,1.13,1.13,0.91,0.91,-0.36,-28.35,80000,14,79000,0,0,0,0,0,0,6000,74000,-68000,-68000
20200312,058769,友達兆豐99購01,0.52,0.52,0.52,0.52,-0.25,-32.47,10000,1,5200,0,0,0,0,0,0,0,10000,-10000,-10000
20200312,05876P,聯發科群益96售03,,,,,0.00,0.00,0,0,0,0,0,0,0,0,0,0,0,0,0
20200312,058770,貿聯兆豐9A購01,,,,,0.00,0.00,0,0,0,0,0,0,0,0,0,0,0,0,0
20200312,058771,神達兆豐99購01,0.68,0.68,0.58,0.59,-0.35,-37.23,106000,5,65890,0,0,0,0,0,0,0,106000,-106000,-106000
20200312,058772,茂林兆豐9A購01,,,,,0.00,0.00,0,0,0,0,0,0,0,0,0,0,0,0,0
20200312,058773,和碩兆豐99購01,,,,,0.00,0.00,0,0,0,0,0,0,0,0,0,0,0,0,0
20200312,058774,台郡兆豐9A購01,0.57,0.57,0.57,0.57,0.00,0.00,1000,1,570,0,0,0,0,0,0,0,1000,-1000,-1000
20200312,058775,台積電國票9A購02,2.09,2.09,2.02,2.02,0.00,0.00,21000,2,43190,0,0,0,0,0,0,0,21000,-21000,-21000
20200312,058776,台積電國票9A購03,1.81,1.81,1.54,1.67,-0.37,-18.14,123000,15,214860,0,0,0,0,0,0,2000,121000,-119000,-119000
20200312,058777,台光電國票9A購01,7.20,7.20,5.70,5.70,0.00,0.00,5000,2,33000,0,0,0,0,0,0,0,5000,-5000,-5000
20200312,058778,聯發科國票9A購01,1.70,1.70,1.70,1.70,0.00,0.00,5000,1,8500,0,0,0,0,0,0,0,5000,-5000,-5000
20200312,058779,大立光國票9A購02,1.35,1.35,1.35,1.35,0.00,0.00,18000,1,24300,0,0,0,0,0,0,0,18000,-18000,-18000
20200312,05877P,大立光群益96售06,4.04,4.66,4.00,4.66,+1.35,40.79,85000,12,347140,0,0,0,0,0,0,70000,15000,55000,55000
20200312,058780,牧德國票9A購01,,,,,0.00,0.00,0,0,0,0,0,0,0,0,0,0,0,0,0
20200312,058781,康友國票9A購01,2.31,2.31,1.87,1.87,-0.73,-28.08,67000,6,128930,0,0,0,0,0,0,67000,67000,0,0
20200312,058782,臺股指國票99購01,1.33,1.33,1.05,1.21,-0.91,-42.92,1090000,17,1366750,0,0,0,0,0,0,0,1090000,-1090000,-1090000
20200312,058783,臺股指國票99購02,1.24,1.24,1.02,1.03,0.00,0.00,223000,17,243260,0,0,0,0,0,0,0,223000,-223000,-223000
20200312,058784,臺股指國票99購03,1.99,1.99,1.25,1.25,0.00,0.00,66000,9,109700,0,0,0,0,0,0,0,66000,-66000,-66000
20200312,058785,臺股指國票99購04,1.70,1.70,0.95,1.34,0.00,0.00,178000,18,231470,0,0,0,0,0,0,0,178000,-178000,-178000
20200312,058786,元黃金元大99購01,0.68,0.68,0.68,0.68,0.00,0.00,10000,1,6800,0,0,0,0,0,0,0,10000,-10000,-10000
20200312,058787,元石油元大9A購01,0.17,0.17,0.16,0.16,-0.09,-36.0,549000,5,88090,0,0,0,0,0,0,4000,545000,-541000,-541000
20200312,058788,喬山元大99購01,,,,,0.00,0.00,0,0,0,0,0,0,0,0,0,0,0,0,0
20200312,058789,喬山元大99購02,,,,,0.00,0.00,0,0,0,0,0,0,0,0,0,0,0,0,0
20200312,05878P,創意群益98售01,2.87,3.28,2.87,3.24,+0.70,27.56,68000,4,211140,0,0,0,0,0,0,58000,10000,48000,48000
20200312,058790,楠梓電元大99購03,,,,,0.00,0.00,0,0,0,0,0,0,0,0,0,0,0,0,0
20200312,058791,鴻海元大99購17,1.70,1.72,1.46,1.47,-0.53,-26.5,15000,10,22810,0,0,0,0,0,0,13000,15000,-2000,-2000
20200312,058792,鴻海元大99購18,2.23,2.27,1.84,1.91,-0.70,-26.82,19000,16,38470,0,0,0,0,0,0,15000,19000,-4000,-4000
20200312,058793,鴻海元大99購19,2.13,2.17,1.78,1.81,-0.65,-26.42,64000,16,117500,0,0,0,0,0,0,14000,64000,-50000,-50000
20200312,058794,旺宏元大99購09,2.46,2.54,1.96,2.10,0.00,0.00,148000,17,317540,0,0,0,0,0,0,133000,148000,-15000,-15000
20200312,058795,可成元大99購03,2.08,2.08,1.66,1.66,-0.92,-35.66,230000,12,392360,0,0,0,0,0,0,25000,230000,-205000,-205000
20200312,058796,可成元大99購04,,,,,0.00,0.00,0,0,0,0,0,0,0,0,0,0,0,0,0
20200312,058797,大毅元大99購03,2.30,2.30,2.30,2.30,0.00,0.00,20000,1,46000,0,0,0,0,0,0,20000,20000,0,0
20200312,058798,大立光元大99購11,1.93,1.93,1.67,1.67,0.00,0.00,32000,3,56240,0,0,0,0,0,0,0,32000,-32000,-32000
20200312,058799,晶技元大99購04,3.81,3.81,2.69,2.69,-1.37,-33.74,25000,6,83100,0,0,0,0,0,0,21000,24000,-3000,-3000
20200312,05879P,台積電台新96售03,2.34,2.34,2.34,2.34,0.00,0.00,10000,1,23400,0,0,0,0,0,0,0,10000,-10000,-10000
20200312,058800,健策元大99購03,1.59,1.59,1.59,1.59,0.00,0.00,20000,1,31800,0,0,0,0,0,0,0,20000,-20000,-20000
20200312,058801,致伸元大99購01,1.17,1.17,1.08,1.08,-0.39,-26.53,26000,2,29520,0,0,0,0,0,0,16000,26000,-10000,-10000
20200312,058802,矽創元大99購02,,,,,0.00,0.00,0,0,0,0,0,0,0,0,0,0,0,0,0
20200312,058803,世紀鋼元大99購03,2.26,2.30,2.00,2.20,-0.24,-9.84,349000,25,766390,0,0,0,0,0,0,118000,231000,-113000,-113000
20200312,058804,T50反1統一9B購01,1.36,1.40,1.35,1.35,0.00,0.00,69000,11,93500,0,0,0,0,0,0,0,69000,-69000,-69000
20200312,058805,元石油統一9B購02,1.22,1.22,1.07,1.19,-0.20,-14.39,144000,11,167180,0,0,0,0,0,0,80000,0,80000,80000
20200312,058806,道瓊銀統一9B購01,,,,,0.00,0.00,0,0,0,0,0,0,0,0,0,0,0,0,0
20200312,058807,和大統一9B購01,0.38,0.38,0.37,0.37,-0.18,-32.73,107000,8,40010,0,0,0,0,0,0,106000,1000,105000,105000
20200312,058808,大成鋼統一9B購01,0.71,0.71,0.71,0.71,-0.04,-5.33,40000,1,28400,0,0,0,0,0,0,0,40000,-40000,-40000
20200312,058809,國巨統一9B購03,0.81,0.81,0.58,0.58,-0.41,-41.41,130000,10,97150,0,0,0,0,0,0,0,130000,-130000,-130000
20200312,05880P,創意康和96售01,1.15,1.29,1.15,1.29,+0.20,18.35,173000,5,204690,0,0,0,0,0,0,154000,19000,135000,135000
20200312,058810,國巨統一9B購04,0.70,0.72,0.66,0.68,-0.27,-28.42,60000,6,41600,0,0,0,0,0,0,0,60000,-60000,-60000
20200312,058811,台積電統一9A購05,0.45,0.45,0.45,0.45,-0.15,-25.0,55000,2,24750,0,0,0,0,0,0,55000,0,55000,55000
20200312,058812,台積電統一9B購06,,,,,0.00,0.00,0,0,0,0,0,0,0,0,0,0,0,0,0
20200312,058813,旺宏統一9B購04,,,,,0.00,0.00,0,0,0,0,0,0,0,0,0,0,0,0,0
20200312,058814,南亞科台新99購01,,,,,0.00,0.00,0,0,0,0,0,0,0,0,0,0,0,0,0
20200312,058815,華新科台新99購03,0.99,0.99,0.99,0.99,0.00,0.00,20000,1,19800,0,0,0,0,0,0,0,20000,-20000,-20000
20200312,058816,祥碩台新99購02,0.80,0.89,0.74,0.89,-0.58,-39.46,80000,4,61800,0,0,0,0,0,0,50000,30000,20000,20000
20200312,058817,嘉聯益台新99購01,,,,,0.00,0.00,0,0,0,0,0,0,0,0,0,0,0,0,0
20200312,058818,南電台新99購03,,,,,0.00,0.00,0,0,0,0,0,0,0,0,0,0,0,0,0
20200312,058819,華通國泰9B購01,1.29,1.29,1.07,1.07,0.00,0.00,16000,2,19320,0,0,0,0,0,0,16000,16000,0,0
20200312,05881P,彩晶康和96售01,1.24,1.28,1.24,1.28,+0.20,18.52,72000,2,90600,0,0,0,0,0,0,39000,33000,6000,6000
20200312,058820,致茂國泰9B購01,,,,,0.00,0.00,0,0,0,0,0,0,0,0,0,0,0,0,0
20200312,058821,泰鼎國泰9B購01,,,,,0.00,0.00,0,0,0,0,0,0,0,0,0,0,0,0,0
20200312,058822,樺漢國泰9B購01,0.97,0.97,0.97,0.97,0.00,0.00,2000,1,1940,0,0,0,0,0,0,0,2000,-2000,-2000
20200312,058823,聯發科富邦9C購01,1.17,1.17,1.17,1.17,0.00,0.00,98000,1,114660,0,0,0,0,0,0,0,98000,-98000,-98000
20200312,058824,晶技富邦9A購01,0.77,0.77,0.50,0.50,0.00,0.00,123000,14,68940,0,0,0,0,0,0,0,123000,-123000,-123000
20200312,058825,同欣電富邦9A購01,0.20,0.21,0.20,0.21,-0.11,-34.38,108000,3,22650,0,0,0,0,0,0,0,108000,-108000,-108000
20200312,058826,台積電永豐99購02,,,,,0.00,0.00,0,0,0,0,0,0,0,0,0,0,0,0,0
20200312,058827,聯發科永豐9A購01,0.79,0.79,0.79,0.79,0.00,0.00,98000,1,77420,0,0,0,0,0,0,0,98000,-98000,-98000
20200312,058828,大毅永豐99購01,0.80,0.80,0.78,0.78,0.00,0.00,25000,2,19700,0,0,0,0,0,0,0,25000,-25000,-25000
20200312,058829,華新科永豐99購04,0.77,0.81,0.77,0.79,0.00,0.00,110000,4,87700,0,0,0,0,0,0,50000,110000,-60000,-60000
20200312,05882P,華新科永豐96售01,0.80,0.81,0.70,0.81,+0.32,65.31,21000,3,16310,0,0,0,0,0,0,5000,16000,-11000,-11000
20200312,058830,健策永豐99購02,0.69,0.69,0.68,0.68,0.00,0.00,50000,2,34350,0,0,0,0,0,0,0,50000,-50000,-50000
20200312,058831,茂林永豐99購01,,,,,0.00,0.00,0,0,0,0,0,0,0,0,0,0,0,0,0
20200312,058832,立積永豐99購01,0.71,0.71,0.61,0.61,0.00,0.00,11000,2,6810,0,0,0,0,0,0,0,11000,-11000,-11000
20200312,058833,台表科永豐99購01,0.93,0.93,0.74,0.74,-0.47,-38.84,34000,3,25660,0,0,0,0,0,0,2000,32000,-30000,-30000
20200312,058834,GIS永豐99購01,0.79,0.79,0.60,0.60,0.00,0.00,14000,2,10300,0,0,0,0,0,0,0,14000,-14000,-14000
20200312,058835,元油2X中信9C購02,,,,,0.00,0.00,0,0,0,0,0,0,0,0,0,0,0,0,0
20200312,058836,FBVIX中信03購05,1.28,1.44,1.28,1.37,+0.22,19.13,851000,73,1170700,10000,0,10000,0,0,0,0,851000,-851000,-841000
20200312,058837,SGBR2X中信9C購01,0.63,0.63,0.58,0.58,-0.12,-17.14,106000,3,63630,0,0,0,0,0,0,0,106000,-106000,-106000
20200312,058838,國巨中信99購03,,,,,0.00,0.00,0,0,0,0,0,0,0,0,0,0,0,0,0
20200312,058839,瑞儀中信99購02,,,,,0.00,0.00,0,0,0,0,0,0,0,0,0,0,0,0,0
20200312,05883P,致伸永豐96售03,3.17,3.18,3.17,3.18,+0.28,9.66,30000,3,95200,0,0,0,0,0,0,30000,0,30000,30000
20200312,058840,T50反1群益99購02,0.93,1.03,0.93,0.97,+0.24,32.88,813000,51,814330,0,0,0,0,0,0,0,813000,-813000,-813000
20200312,058841,深中小群益01購01,,,,,0.00,0.00,0,0,0,0,0,0,0,0,0,0,0,0,0
20200312,058842,元油2X群益9C購01,1.59,1.59,1.24,1.24,-1.49,-54.58,1185000,91,1530850,0,0,0,0,0,0,0,1185000,-1185000,-1185000
20200312,058843,元油2X群益9C購02,1.08,1.08,0.87,0.87,-1.38,-61.33,100000,6,97520,0,0,0,0,0,0,0,100000,-100000,-100000
20200312,058844,元油2X群益9C購03,,,,,0.00,0.00,0,0,0,0,0,0,0,0,0,0,0,0,0
20200312,058845,元油2X群益9C購04,0.25,0.25,0.25,0.25,-0.77,-75.49,2000,1,500,0,0,0,0,0,0,0,2000,-2000,-2000
20200312,058846,鴻海群益99購03,3.04,3.04,2.90,2.93,-0.15,-4.87,5000,4,14810,0,0,0,0,0,0,5000,5000,0,0
20200312,058847,國巨群益99購05,,,,,0.00,0.00,0,0,0,0,0,0,0,0,0,0,0,0,0
20200312,058848,台積電群益99購07,1.36,1.36,1.17,1.30,-0.13,-9.09,330000,21,406220,0,0,0,0,0,0,0,330000,-330000,-330000
20200312,058849,奇力新群益99購02,,,,,0.00,0.00,0,0,0,0,0,0,0,0,0,0,0,0,0
20200312,05884P,旺宏統一96售01,2.66,3.05,2.58,3.00,+0.52,20.97,308000,23,855260,0,0,0,0,0,0,135000,168000,-33000,-33000
20200312,058850,華新科群益99購03,,,,,0.00,0.00,0,0,0,0,0,0,0,0,0,0,0,0,0
20200312,058851,大立光群益99購07,2.05,2.09,1.95,1.95,-1.18,-37.7,17000,8,34290,0,0,0,0,0,0,0,17000,-17000,-17000
20200312,058852,貿聯群益99購04,,,,,0.00,0.00,0,0,0,0,0,0,0,0,0,0,0,0,0
20200312,058853,日月光群益99購01,,,,,0.00,0.00,0,0,0,0,0,0,0,0,0,0,0,0,0
20200312,058854,樺漢群益9B購01,,,,,0.00,0.00,0,0,0,0,0,0,0,0,0,0,0,0,0
20200312,058855,台積電兆豐99購02,1.16,1.16,0.93,1.08,-0.30,-21.74,808000,28,792440,0,0,0,0,0,0,0,808000,-808000,-808000
20200312,058856,新光金兆豐99購01,0.77,0.77,0.74,0.74,-0.03,-3.9,200000,2,151000,0,0,0,0,0,0,0,200000,-200000,-200000
20200312,058857,元油2X日盛99購02,0.11,0.14,0.11,0.11,-0.89,-89.0,325000,6,41750,0,0,0,0,0,0,0,325000,-325000,-325000
20200312,058858,元油2X凱基9A購07,0.23,0.23,0.23,0.23,-0.71,-75.53,2000,1,460,0,0,0,0,0,0,0,2000,-2000,-2000
20200312,058859,元油2X凱基9A購08,,,,,0.00,0.00,0,0,0,0,0,0,0,0,0,0,0,0,0
20200312,05885P,牧德統一96售01,0.93,1.15,0.93,1.11,+0.29,35.37,75000,8,75900,0,0,0,0,0,0,20000,55000,-35000,-35000
20200312,058860,SGBR2X凱基9A購01,,,,,0.00,0.00,0,0,0,0,0,0,0,0,0,0,0,0,0
20200312,058861,國巨凱基9A購08,,,,,0.00,0.00,0,0,0,0,0,0,0,0,0,0,0,0,0
20200312,058862,聯發科凱基99購08,1.84,1.84,1.84,1.84,-0.14,-7.07,99000,2,182160,0,0,0,0,0,0,0,99000,-99000,-99000
20200312,058863,可成凱基99購02,,,,,0.00,0.00,0,0,0,0,0,0,0,0,0,0,0,0,0
20200312,058864,欣興凱基99購04,,,,,0.00,0.00,0,0,0,0,0,0,0,0,0,0,0,0,0
20200312,058865,群創凱基01購01,,,,,0.00,0.00,0,0,0,0,0,0,0,0,0,0,0,0,0
20200312,058866,元油2X國票99購04,0.36,0.36,0.28,0.28,-0.27,-49.09,126000,23,38110,0,0,0,0,0,0,0,126000,-126000,-126000
20200312,058867,元油2X國票99購05,0.35,0.35,0.35,0.35,-0.34,-49.28,100000,1,35000,0,0,0,0,0,0,0,100000,-100000,-100000
20200312,058868,元油2X國票99購06,,,,,0.00,0.00,0,0,0,0,0,0,0,0,0,0,0,0,0
20200312,058869,元油2X國票9A購04,,,,,0.00,0.00,0,0,0,0,0,0,0,0,0,0,0,0,0
20200312,05886P,華通元富96售01,3.29,4.40,3.29,4.30,+1.29,42.86,273000,24,983910,0,0,0,0,0,0,147000,159000,-12000,-12000
20200312,058870,元油2X國票9A購05,,,,,0.00,0.00,0,0,0,0,0,0,0,0,0,0,0,0,0
20200312,058871,元油2X國票9A購06,0.42,0.42,0.42,0.42,-0.51,-54.84,1000,1,420,0,0,0,0,0,0,0,1000,-1000,-1000
20200312,058872,元油2X國票9B購01,,,,,0.00,0.00,0,0,0,0,0,0,0,0,0,0,0,0,0
20200312,058873,美律國票9A購02,,,,,0.00,0.00,0,0,0,0,0,0,0,0,0,0,0,0,0
20200312,058874,聯鈞國票9A購01,,,,,0.00,0.00,0,0,0,0,0,0,0,0,0,0,0,0,0
20200312,058875,台表科國票9A購02,,,,,0.00,0.00,0,0,0,0,0,0,0,0,0,0,0,0,0
20200312,058876,南電國票9A購02,,,,,0.00,0.00,0,0,0,0,0,0,0,0,0,0,0,0,0
20200312,058877,T50反1國泰9B購01,,,,,0.00,0.00,0,0,0,0,0,0,0,0,0,0,0,0,0
20200312,058878,旭富國泰9B購01,,,,,0.00,0.00,0,0,0,0,0,0,0,0,0,0,0,0,0
20200312,058879,智邦富邦99購01,,,,,0.00,0.00,0,0,0,0,0,0,0,0,0,0,0,0,0
20200312,05887P,友達元富99售03,1.83,2.05,1.83,2.05,+0.38,22.75,75000,7,144050,0,0,0,0,0,0,25000,50000,-25000,-25000
20200312,058880,台灣50永豐99購04,1.21,1.21,1.01,1.01,-0.51,-33.55,52000,2,62720,0,0,0,0,0,0,0,52000,-52000,-52000
20200312,058881,全新永豐99購01,,,,,0.00,0.00,0,0,0,0,0,0,0,0,0,0,0,0,0
20200312,058882,晶相光永豐99購01,,,,,0.00,0.00,0,0,0,0,0,0,0,0,0,0,0,0,0
20200312,058883,旭富永豐99購01,0.47,0.47,0.43,0.43,-0.35,-44.87,122000,2,56940,0,0,0,0,0,0,0,122000,-122000,-122000
20200312,058884,世紀鋼永豐99購02,1.23,1.27,1.18,1.22,+0.13,11.93,39000,5,47770,0,0,0,0,0,0,0,39000,-39000,-39000
20200312,058885,元石油元大9C購02,1.37,1.37,1.34,1.34,-0.21,-13.55,41000,3,55840,0,0,0,0,0,0,0,41000,-41000,-41000
20200312,058886,元石油元大9C購03,1.56,1.56,1.54,1.54,-0.06,-3.75,6000,3,9300,0,0,0,0,0,0,0,6000,-6000,-6000
20200312,058887,元石油元大9C購04,1.29,1.31,1.29,1.31,-0.02,-1.5,20000,2,26000,0,0,0,0,0,0,0,20000,-20000,-20000
20200312,058888,元油2X元大99購16,0.43,0.44,0.31,0.39,-0.79,-66.95,454000,16,156760,0,0,0,0,0,0,0,454000,-454000,-454000
20200312,058889,元油2X元大9C購05,0.63,0.66,0.56,0.60,-0.94,-61.04,188000,16,114620,0,0,0,0,0,0,0,188000,-188000,-188000
20200312,05888P,友達元大97售01,1.30,1.60,1.30,1.60,+0.38,31.15,172000,11,259540,0,0,0,0,0,0,146000,26000,120000,120000
20200312,058890,元油2X元大9C購06,0.28,0.28,0.28,0.28,-0.68,-70.83,10000,1,2800,0,0,0,0,0,0,0,10000,-10000,-10000
20200312,058891,元油2X元大9C購07,0.41,0.41,0.30,0.32,-0.64,-66.67,681000,10,215410,0,0,0,0,0,0,0,681000,-681000,-681000
20200312,058892,元油2X元大9C購08,0.20,0.20,0.20,0.20,-0.60,-75.0,100000,1,20000,0,0,0,0,0,0,0,100000,-100000,-100000
20200312,058893,元油2X元大9C購10,,,,,0.00,0.00,0,0,0,0,0,0,0,0,0,0,0,0,0
20200312,058894,元油2X元大9C購11,0.66,0.66,0.50,0.58,-0.90,-60.81,933000,19,503480,0,0,0,0,0,0,0,933000,-933000,-933000
20200312,058895,鴻海元大99購20,2.63,2.63,2.25,2.32,-0.75,-24.43,15000,10,35870,0,0,0,0,0,0,15000,15000,0,0
20200312,058896,中環元大99購03,,,,,0.00,0.00,0,0,0,0,0,0,0,0,0,0,0,0,0
20200312,058897,國巨元大99購17,2.28,2.28,2.24,2.24,-0.83,-27.04,50000,4,113100,0,0,0,0,0,0,0,50000,-50000,-50000
20200312,058898,台積電元大99購20,2.72,2.72,2.25,2.44,-0.61,-20.0,179000,40,444330,0,0,0,0,0,0,175000,179000,-4000,-4000
20200312,058899,旺宏元大99購10,2.54,2.54,2.13,2.13,-0.89,-29.47,36000,3,77800,0,0,0,0,0,0,36000,36000,0,0
20200312,05889P,群創元大98售02,1.54,1.82,1.54,1.78,0.00,0.00,207000,11,353090,0,0,0,0,0,0,164000,207000,-43000,-43000
20200312,058900,旺宏元大99購11,2.48,2.48,1.98,2.08,-0.92,-30.67,50000,5,103100,0,0,0,0,0,0,45000,50000,-5000,-5000
20200312,058901,美律元大99購07,,,,,0.00,0.00,0,0,0,0,0,0,0,0,0,0,0,0,0
20200312,058902,聯發科元大99購15,2.52,2.52,2.23,2.31,-0.89,-27.81,72000,5,167460,0,0,0,0,0,0,62000,72000,-10000,-10000
20200312,058903,聯發科元大99購16,2.65,2.67,2.25,2.32,-0.79,-25.4,247000,14,598400,0,0,0,0,0,0,82000,247000,-165000,-165000
20200312,058904,晶技元大99購05,2.57,2.57,2.50,2.50,+0.24,10.62,2000,2,5070,0,0,0,0,0,0,1000,2000,-1000,-1000
20200312,058905,京鼎元大99購01,1.02,1.02,1.02,1.02,-0.51,-33.33,100000,1,102000,0,0,0,0,0,0,0,100000,-100000,-100000
20200312,058906,晶相光元大99購01,,,,,0.00,0.00,0,0,0,0,0,0,0,0,0,0,0,0,0
20200312,058907,健策元大99購04,1.87,1.91,1.87,1.87,-1.01,-35.07,60000,5,113000,0,0,0,0,0,0,0,60000,-60000,-60000
20200312,058908,貿聯元大99購03,0.88,0.88,0.88,0.88,-0.31,-26.05,25000,1,22000,0,0,0,0,0,0,25000,25000,0,0
20200312,058909,神達元大99購03,2.10,2.18,2.06,2.06,-0.89,-30.17,13000,3,27460,0,0,0,0,0,0,0,13000,-13000,-13000
20200312,05890P,彩晶元大99售01,1.28,1.47,1.28,1.47,+0.35,31.25,17000,4,22560,0,0,0,0,0,0,14000,3000,11000,11000
20200312,058910,泰鼎元大99購03,,,,,0.00,0.00,0,0,0,0,0,0,0,0,0,0,0,0,0
20200312,058911,茂林元大99購04,1.07,1.07,0.95,0.95,-0.54,-36.24,38000,14,37660,0,0,0,0,0,0,13000,38000,-25000,-25000
20200312,058912,祥碩元大99購01,2.83,2.94,2.58,2.74,-0.20,-6.8,141000,5,392030,0,0,0,0,0,0,140000,141000,-1000,-1000
20200312,058913,元油2X元富01購01,,,,,0.00,0.00,0,0,0,0,0,0,0,0,0,0,0,0,0
20200312,058914,元油2X元富01購02,0.25,0.25,0.21,0.21,-0.23,-52.27,250000,3,59500,0,0,0,0,0,0,0,250000,-250000,-250000
20200312,058915,SGBR2X元富99購01,,,,,0.00,0.00,0,0,0,0,0,0,0,0,0,0,0,0,0
20200312,058916,SGBR2X元富99購02,3.63,3.63,3.63,3.63,+1.47,68.06,1000,1,3630,0,0,0,0,0,0,0,1000,-1000,-1000
20200312,058917,SGBR2X元富99購03,,,,,0.00,0.00,0,0,0,0,0,0,0,0,0,0,0,0,0
20200312,058918,SGBR2X元富99購04,,,,,0.00,0.00,0,0,0,0,0,0,0,0,0,0,0,0,0
20200312,058919,SGBR2X元富99購05,,,,,0.00,0.00,0,0,0,0,0,0,0,0,0,0,0,0,0
20200312,05891P,聯發科中信98售03,2.60,2.96,2.60,2.86,+0.38,15.32,160000,23,446900,0,0,0,0,0,0,123000,37000,86000,86000
20200312,058920,SGBR2X元富99購06,,,,,0.00,0.00,0,0,0,0,0,0,0,0,0,0,0,0,0
20200312,058921,聯發科元富03購01,,,,,0.00,0.00,0,0,0,0,0,0,0,0,0,0,0,0,0
20200312,058922,聯發科元富03購02,,,,,0.00,0.00,0,0,0,0,0,0,0,0,0,0,0,0,0
20200312,058923,華新科元富99購06,1.27,1.27,1.27,1.27,-0.49,-27.84,20000,1,25400,0,0,0,0,0,0,0,20000,-20000,-20000
20200312,058924,晶相光元富99購02,,,,,0.00,0.00,0,0,0,0,0,0,0,0,0,0,0,0,0
20200312,058925,旭富元富99購02,,,,,0.00,0.00,0,0,0,0,0,0,0,0,0,0,0,0,0
20200312,058926,勤誠元富99購01,,,,,0.00,0.00,0,0,0,0,0,0,0,0,0,0,0,0,0
20200312,058927,勤誠元富99購02,,,,,0.00,0.00,0,0,0,0,0,0,0,0,0,0,0,0,0
20200312,058928,國巨統一9C購01,0.59,0.59,0.58,0.58,-0.20,-25.64,110000,2,64800,0,0,0,0,0,0,0,110000,-110000,-110000
20200312,058929,可成統一9C購01,,,,,0.00,0.00,0,0,0,0,0,0,0,0,0,0,0,0,0
20200312,05892P,大立光中信98售03,2.60,2.83,2.60,2.83,+0.63,28.64,45000,4,119510,0,0,0,0,0,0,29000,16000,13000,13000
20200312,058930,華新科統一9B購01,,,,,0.00,0.00,0,0,0,0,0,0,0,0,0,0,0,0,0
20200312,058931,玉晶光統一9C購01,,,,,0.00,0.00,0,0,0,0,0,0,0,0,0,0,0,0,0
20200312,058932,FBVIX台新99購01,2.11,2.15,2.11,2.15,+0.29,15.59,6000,2,12860,0,0,0,0,0,0,0,6000,-6000,-6000
20200312,058933,FBVIX台新9B購01,2.14,2.37,2.14,2.23,+0.24,12.06,56000,10,126450,0,0,0,0,0,0,0,56000,-56000,-56000
20200312,05893P,國巨兆豐96售04,0.98,1.35,0.98,1.30,+0.36,38.3,251000,13,305570,0,0,0,0,0,0,169000,82000,87000,87000
20200312,05894P,友達群益98售02,1.28,1.50,1.28,1.50,+0.35,30.43,63000,3,86360,0,0,0,0,0,0,53000,10000,43000,43000
20200312,05895P,奇力新群益96售03,1.65,1.98,1.65,1.95,+0.37,23.42,229000,14,405250,0,0,0,0,0,0,94000,135000,-41000,-41000
20200312,05896P,宏達電群益96售03,1.55,1.80,1.55,1.80,+0.31,20.81,196000,9,319820,0,0,0,0,0,0,15000,181000,-166000,-166000
20200312,05897P,國巨凱基96售12,1.34,1.87,1.34,1.87,+0.54,40.6,288000,35,481440,0,0,0,0,0,0,227000,140000,87000,87000
20200312,05898P,旺宏凱基96售06,0.68,0.93,0.68,0.84,+0.23,37.7,243000,19,200160,0,0,0,0,0,0,140000,103000,37000,37000
20200312,05899P,臺股指凱基96售30,3.76,4.49,3.76,4.32,+0.90,26.32,29000,6,124060,0,0,0,0,0,0,13000,16000,-3000,-3000
20200312,05900P,臺股指凱基99售05,2.64,3.82,2.64,3.37,+1.25,58.96,345000,16,1102780,0,0,0,0,0,0,260000,85000,175000,175000
20200312,05901P,臺股指凱基9C售01,2.29,3.38,2.29,3.31,+1.20,56.87,806000,91,2223800,0,0,0,0,0,0,646000,95000,551000,551000
20200312,05902P,華通國票96售02,3.68,4.98,3.65,4.86,+1.67,52.35,204000,11,841150,0,0,0,0,0,0,180000,24000,156000,156000
20200312,05903P,聯發科統一96售09,4.60,5.10,4.60,4.99,+0.90,22.0,32000,12,157980,0,0,0,0,0,0,26000,6000,20000,20000
20200312,05904P,大立光統一96售07,2.99,3.34,2.99,3.25,+0.75,30.0,32000,7,101060,0,0,0,0,0,0,31000,1000,30000,30000
20200312,05905P,晶技統一97售01,0.91,1.24,0.91,1.20,+0.28,30.43,923000,38,965810,0,0,0,0,0,0,255000,598000,-343000,-343000
20200312,05906P,國巨元富96售05,0.95,1.31,0.95,1.31,+0.53,67.95,331000,12,354050,0,0,0,0,0,0,115000,226000,-111000,-111000
20200312,05907P,聯發科元富96售05,3.41,3.41,3.36,3.36,+0.27,8.74,133000,4,450380,0,0,0,0,0,0,133000,0,133000,133000
20200312,05908P,大立光元富96售05,4.37,4.91,4.37,4.91,+1.29,35.64,40000,3,176000,0,0,0,0,0,0,6000,34000,-28000,-28000
20200312,05909P,康友元富96售02,1.78,1.99,1.78,1.98,+0.35,21.47,529000,16,1007240,0,0,0,0,0,0,24000,505000,-481000,-481000
20200312,05910P,力山永豐96售02,,,,,0.00,0.00,0,0,0,0,0,0,0,0,0,0,0,0,0
20200312,05911P,南亞科永豐96售03,1.80,2.31,1.80,2.28,0.00,0.00,49000,7,102960,0,0,0,0,0,0,4000,45000,-41000,-41000
20200312,05912P,和大元大96售01,2.50,2.91,2.50,2.91,+0.47,19.26,238000,16,645190,0,0,0,0,0,0,60000,208000,-148000,-148000
20200312,05913P,國巨元大96售11,2.88,3.24,2.88,3.24,+0.58,21.8,211000,9,634260,0,0,0,0,0,0,210000,211000,-1000,-1000
20200312,05914P,友達元大96售04,1.61,1.80,1.60,1.80,+0.47,35.34,188000,14,309870,0,0,0,0,0,0,172000,43000,129000,129000
20200312,05915P,聯發科元大96售19,4.52,5.00,4.52,4.84,+0.83,20.7,32000,12,153970,0,0,0,0,0,0,25000,6000,19000,19000
20200312,05916P,聯發科元大96售20,,,,,0.00,0.00,0,0,0,0,0,0,0,0,0,0,0,0,0
20200312,05917P,宏達電元大96售02,1.23,1.41,1.23,1.41,+0.19,15.57,287000,6,387440,0,0,0,0,0,0,86000,201000,-115000,-115000
20200312,05918P,大立光元大96售11,3.30,3.30,3.30,3.30,0.00,0.00,40000,1,132000,0,0,0,0,0,0,40000,0,40000,40000
20200312,05919P,京鼎元大96售03,2.55,2.89,2.50,2.89,+0.49,20.42,390000,19,1016700,0,0,0,0,0,0,261000,234000,27000,27000
20200312,05920P,力成元大96售04,1.77,1.77,1.77,1.77,+0.34,23.78,10000,1,17700,0,0,0,0,0,0,0,10000,-10000,-10000
20200312,05921P,同欣電元大96售06,1.49,1.78,1.49,1.78,+0.49,37.98,454000,10,738140,0,0,0,0,0,0,110000,434000,-324000,-324000
20200312,05922P,京元電兆豐96售01,2.25,2.41,2.25,2.41,+0.38,18.72,110000,5,251570,0,0,0,0,0,0,62000,48000,14000,14000
20200312,05923P,旺宏元富96售05,1.84,2.13,1.75,2.13,+0.45,26.79,655000,11,1292500,0,0,0,0,0,0,605000,50000,555000,555000
20200312,05924P,超眾元富96售04,3.19,3.48,3.19,3.39,+0.47,16.1,175000,7,576470,0,0,0,0,0,0,97000,78000,19000,19000
20200312,05925P,晶技永豐96售03,0.70,1.02,0.70,1.01,+0.29,40.28,388000,29,334800,0,0,0,0,0,0,165000,223000,-58000,-58000
20200312,05926P,智易永豐96售02,2.65,2.81,2.65,2.81,0.00,0.00,17000,3,46690,0,0,0,0,0,0,7000,10000,-3000,-3000
20200312,05927P,正文永豐96售03,1.84,2.18,1.84,2.09,+0.24,12.97,84000,9,170880,0,0,0,0,0,0,43000,41000,2000,2000
20200312,05928P,華邦電康和96售01,1.42,1.70,1.42,1.70,+0.36,26.87,143000,5,207000,0,0,0,0,0,0,143000,0,143000,143000
20200312,05929P,宏達電康和96售01,0.99,1.16,0.99,1.15,+0.18,18.56,107000,5,112850,0,0,0,0,0,0,68000,39000,29000,29000
20200312,05930P,景碩康和96售01,1.04,1.26,1.04,1.26,+0.30,31.25,261000,7,308500,0,0,0,0,0,0,240000,231000,9000,9000
20200312,05931P,鴻海凱基96售15,,,,,0.00,0.00,0,0,0,0,0,0,0,0,0,0,0,0,0
20200312,05932P,鴻海凱基96售16,7.95,7.95,7.95,7.95,0.00,0.00,3000,1,23850,0,0,0,0,0,0,0,3000,-3000,-3000
20200312,05933P,鴻海凱基97售03,8.00,8.95,8.00,8.95,+2.10,30.66,10000,4,82650,0,0,0,0,0,0,8000,10000,-2000,-2000
20200312,05934P,國巨凱基96售13,0.61,1.20,0.55,1.20,+0.60,100.0,493000,30,389450,0,0,0,0,0,0,420000,67000,353000,353000
20200312,05935P,台積電凱基96售19,6.20,7.35,6.15,6.50,+0.85,15.04,297000,25,1967250,0,0,0,0,0,0,276000,291000,-15000,-15000
20200312,05936P,台積電凱基96售20,4.96,5.40,4.96,5.40,+0.97,21.9,166000,9,856120,0,0,0,0,0,0,152000,154000,-2000,-2000
20200312,05937P,台積電凱基96售21,6.50,6.50,6.50,6.50,0.00,0.00,70000,2,455000,0,0,0,0,0,0,70000,70000,0,0
20200312,05938P,旺宏凱基96售07,1.74,1.94,1.74,1.94,+0.56,40.58,20000,5,37300,0,0,0,0,0,0,5000,15000,-10000,-10000
20200312,05939P,聯發科凱基96售20,,,,,0.00,0.00,0,0,0,0,0,0,0,0,0,0,0,0,0
20200312,05940P,聯發科凱基96售21,,,,,0.00,0.00,0,0,0,0,0,0,0,0,0,0,0,0,0
20200312,05941P,聯發科凱基96售22,8.55,8.55,8.55,8.55,0.00,0.00,2000,2,17100,0,0,0,0,0,0,2000,0,2000,2000
20200312,05942P,奇力新凱基96售04,0.88,1.22,0.88,1.18,+0.28,31.11,191000,30,206820,0,0,0,0,0,0,164000,26000,138000,138000
20200312,05943P,欣興凱基96售03,2.81,3.27,2.78,3.27,+1.05,47.3,90000,8,280160,0,0,0,0,0,0,77000,13000,64000,64000
20200312,05944P,富邦金中信96售01,0.95,1.23,0.95,1.23,+0.35,39.77,220000,18,245380,0,0,0,0,0,0,122000,98000,24000,24000
20200312,05945P,聯詠中信96售01,0.87,1.05,0.87,0.99,+0.23,30.26,331000,21,323660,0,0,0,0,0,0,40000,291000,-251000,-251000
20200312,05946P,和碩中信96售01,1.84,2.02,1.83,2.01,+0.27,15.52,230000,24,440620,0,0,0,0,0,0,44000,186000,-142000,-142000
20200312,05947P,大成鋼元大96售03,2.56,2.64,2.48,2.50,+0.15,6.38,135000,10,347740,0,0,0,0,0,0,5000,130000,-125000,-125000
20200312,05948P,茂林元大96售03,1.41,1.78,1.41,1.74,+0.42,31.82,869000,16,1317670,0,0,0,0,0,0,616000,253000,363000,363000
20200312,05949P,台積電國票96售09,,,,,0.00,0.00,0,0,0,0,0,0,0,0,0,0,0,0,0
20200312,05950P,台積電國票97售04,6.40,7.20,6.40,7.20,+2.05,39.81,17000,4,110350,0,0,0,0,0,0,10000,17000,-7000,-7000
20200312,05951P,台積電國票97售05,,,,,0.00,0.00,0,0,0,0,0,0,0,0,0,0,0,0,0
20200312,05952P,台積電國票97售06,5.00,5.00,5.00,5.00,+0.85,20.48,30000,2,150000,0,0,0,0,0,0,30000,0,30000,30000
20200312,05953P,台積電國票98售02,5.50,5.50,5.50,5.50,+0.74,15.55,50000,1,275000,0,0,0,0,0,0,50000,50000,0,0
20200312,05954P,旺宏國票97售03,3.20,3.38,3.08,3.38,+0.44,14.97,24000,5,77040,0,0,0,0,0,0,24000,0,24000,24000
20200312,05955P,台光電國票97售02,1.00,1.13,1.00,1.13,+0.32,39.51,100000,4,103200,0,0,0,0,0,0,80000,20000,60000,60000
20200312,05956P,漢唐國票96售02,1.63,1.86,1.63,1.78,+0.32,21.92,121000,11,207530,0,0,0,0,0,0,76000,45000,31000,31000
20200312,05957P,友達國票97售04,1.66,1.66,1.66,1.66,+0.44,36.07,3000,1,4980,0,0,0,0,0,0,3000,0,3000,3000
20200312,05958P,聯發科國票97售04,5.20,5.95,5.20,5.70,+0.74,14.92,33000,13,188850,0,0,0,0,0,0,16000,15000,1000,1000
20200312,05959P,聯發科國票98售01,8.15,9.70,8.15,9.50,+1.95,25.83,25000,14,227950,0,0,0,0,0,0,20000,5000,15000,15000
20200312,05960P,欣興統一96售01,2.42,2.43,2.42,2.43,0.00,0.00,30000,2,72800,0,0,0,0,0,0,0,30000,-30000,-30000
20200312,05961P,鴻海群益97售01,5.50,5.60,5.40,5.60,+0.68,13.82,47000,4,256200,0,0,0,0,0,0,47000,25000,22000,22000
20200312,05962P,大立光群益96售07,2.29,3.15,2.29,2.80,+1.43,104.38,49000,6,122820,0,0,0,0,0,0,17000,32000,-15000,-15000
20200312,05963P,貿聯國票97售02,3.01,3.01,3.01,3.01,0.00,0.00,30000,1,90300,0,0,0,0,0,0,30000,0,30000,30000
20200312,05964P,華通凱基96售06,1.40,1.74,1.40,1.74,+0.43,32.82,252000,6,376250,0,0,0,0,0,0,92000,160000,-68000,-68000
20200312,05965P,健策凱基96售05,0.33,0.39,0.33,0.38,+0.13,52.0,39000,4,14470,0,0,0,0,0,0,10000,29000,-19000,-19000
20200312,05966P,矽力凱基96售03,0.78,0.80,0.76,0.77,+0.07,10.0,398000,12,316690,0,0,0,0,0,0,22000,376000,-354000,-354000
20200312,05967P,臺股指麥證96售02,,,,,0.00,0.00,0,0,0,0,0,0,0,0,0,0,0,0,0
20200312,05968P,鴻海台新96售02,2.47,2.47,2.47,2.47,+0.26,11.76,5000,1,12350,0,0,0,0,0,0,5000,5000,0,0
20200312,05969P,台積電台新96售04,,,,,0.00,0.00,0,0,0,0,0,0,0,0,0,0,0,0,0
20200312,05970P,超眾永豐96售03,2.69,3.02,2.69,3.02,+0.55,22.27,40000,3,112200,0,0,0,0,0,0,20000,20000,0,0
20200312,05971P,世紀鋼永豐96售04,1.15,1.24,1.15,1.20,+0.14,13.21,188000,16,225950,0,0,0,0,0,0,30000,158000,-128000,-128000
20200312,05972P,瑞昱元大96售01,2.60,3.02,2.60,3.02,+0.80,36.04,157000,12,442150,0,0,0,0,0,0,125000,32000,93000,93000
20200312,05973P,聯詠元大96售06,3.25,3.61,3.25,3.55,+0.46,14.89,275000,11,952800,0,0,0,0,0,0,65000,250000,-185000,-185000
20200312,05974P,國巨富邦97售03,0.82,1.01,0.81,1.01,+0.23,29.49,88000,17,83600,0,0,0,0,0,0,28000,33000,-5000,-5000
20200312,05975P,國巨日盛99售02,1.39,1.76,1.39,1.74,+0.41,30.83,359000,24,554030,0,0,0,0,0,0,82000,257000,-175000,-175000
20200312,05976P,國巨凱基96售14,2.35,2.69,2.35,2.69,+0.32,13.5,96000,6,237200,0,0,0,0,0,0,68000,28000,40000,40000
20200312,05977P,旺宏永豐96售06,1.62,2.06,1.62,2.06,+0.62,43.06,431000,15,747370,0,0,0,0,0,0,375000,106000,269000,269000
20200312,05978P,麗豐永豐96售02,2.58,2.71,2.58,2.71,+0.24,9.72,67000,6,178230,0,0,0,0,0,0,28000,39000,-11000,-11000
20200312,05979P,華新科中信96售02,0.67,0.83,0.67,0.83,+0.19,29.69,143000,9,104160,0,0,0,0,0,0,53000,90000,-37000,-37000
20200312,05980P,台積電永昌96售09,2.60,3.17,2.60,2.90,+0.52,21.85,1646000,40,4762260,0,0,0,0,0,0,1520000,1223000,297000,297000
20200312,05981P,可成永昌98售02,2.72,3.11,2.67,3.11,+0.70,29.05,269000,12,748460,0,0,0,0,0,0,168000,101000,67000,67000
20200312,05982P,漢唐國票96售03,2.76,2.90,2.76,2.90,+0.42,16.94,33000,5,92780,0,0,0,0,0,0,6000,27000,-21000,-21000
20200312,05983P,聯詠國票96售02,2.73,3.12,2.73,2.94,+0.34,13.08,126000,14,362130,0,0,0,0,0,0,39000,87000,-48000,-48000
20200312,05984P,台積電統一98售01,1.86,2.05,1.86,1.92,+0.34,21.52,207000,9,408700,0,0,0,0,0,0,6000,204000,-198000,-198000
20200312,05985P,燿華統一96售03,1.93,2.09,1.93,2.09,+0.33,18.75,70000,7,139200,0,0,0,0,0,0,10000,60000,-50000,-50000
20200312,05986P,大立光統一97售03,2.45,2.65,2.45,2.65,0.00,0.00,3000,3,7600,0,0,0,0,0,0,3000,0,3000,3000
20200312,05987P,健策統一96售02,1.41,1.80,1.41,1.77,+0.48,37.21,167000,19,264360,0,0,0,0,0,0,107000,55000,52000,52000
20200312,05988P,光磊元富96售02,2.50,2.94,2.50,2.94,+0.59,25.11,233000,12,652200,0,0,0,0,0,0,150000,213000,-63000,-63000
20200312,05989P,健策元富96售01,1.48,1.90,1.48,1.90,+0.57,42.86,311000,38,517240,0,0,0,0,0,0,115000,196000,-81000,-81000
20200312,05990P,台積電群益96售13,4.36,5.90,4.36,4.99,+1.17,30.63,232000,8,1033540,0,0,0,0,0,0,149000,200000,-51000,-51000
20200312,05991P,聯茂群益96售05,0.92,1.22,0.92,1.22,+0.45,58.44,811000,20,847060,0,0,0,0,0,0,131000,670000,-539000,-539000
20200312,05992P,華通元大96售05,3.86,4.10,3.86,4.10,+1.02,33.12,11000,2,42700,0,0,0,0,0,0,10000,1000,9000,9000
20200312,05993P,國巨元大96售13,2.01,2.91,2.01,2.91,+0.88,43.35,346000,16,824570,0,0,0,0,0,0,340000,296000,44000,44000
20200312,05994P,奇鋐元大96售02,1.30,1.48,1.30,1.47,+0.24,19.51,787000,58,1093090,0,0,0,0,0,0,208000,551000,-343000,-343000
20200312,05995P,T50正2中信9C售01,3.07,3.52,3.06,3.40,+0.63,22.74,140000,15,452010,0,0,0,0,0,0,35000,105000,-70000,-70000
20200312,05996P,華新科群益96售03,4.24,5.80,4.22,5.70,+1.94,51.6,195000,12,996070,0,0,0,0,0,0,160000,65000,95000,95000
20200312,05997P,嘉聯益群益96售02,2.69,2.98,2.69,2.98,+0.43,16.86,39000,4,110110,0,0,0,0,0,0,19000,20000,-1000,-1000
20200312,05998P,台積電元大97售12,2.59,2.80,2.59,2.80,+0.44,18.64,8000,3,21480,0,0,0,0,0,0,3000,0,3000,3000
20200312,05999P,世芯元大96售01,1.62,1.96,1.21,1.96,+0.37,23.27,1045000,75,1812340,0,0,0,0,0,0,403000,625000,-222000,-222000
20200312,06000P,GIS元大96售04,4.33,4.69,4.33,4.69,+0.69,17.25,44000,4,201480,0,0,0,0,0,0,14000,30000,-16000,-16000
20200312,06001P,樺漢台新96售01,1.54,1.72,1.51,1.72,+0.34,24.64,134000,11,210520,0,0,0,0,0,0,69000,65000,4000,4000
20200312,06002P,華通康和96售01,,,,,0.00,0.00,0,0,0,0,0,0,0,0,0,0,0,0,0
20200312,06003P,亞光康和96售02,1.20,1.24,1.20,1.24,0.00,0.00,29000,2,35200,0,0,0,0,0,0,0,29000,-29000,-29000
20200312,06004P,奇力新永豐96售02,1.69,1.89,1.69,1.89,+0.26,15.95,23000,3,40570,0,0,0,0,0,0,23000,0,23000,23000
20200312,06005P,晶豪科永豐96售04,1.24,1.64,1.24,1.64,+0.40,32.26,51000,7,75680,0,0,0,0,0,0,16000,35000,-19000,-19000
20200312,06006P,欣興永豐96售04,1.55,2.04,1.55,2.04,+0.64,45.71,70000,8,122450,0,0,0,0,0,0,50000,20000,30000,30000
20200312,06007P,世芯永豐96售01,1.13,1.33,1.13,1.27,+0.42,49.41,327000,20,409390,0,0,0,0,0,0,262000,65000,197000,197000
20200312,06008P,燿華統一96售04,,,,,0.00,0.00,0,0,0,0,0,0,0,0,0,0,0,0,0
20200312,06009P,宏達電元富96售03,1.94,2.27,1.94,2.27,+0.38,20.11,110000,11,230600,0,0,0,0,0,0,10000,100000,-90000,-90000
20200312,06010P,國泰金元富96售01,3.14,3.58,3.14,3.53,+0.43,13.87,367000,27,1199060,0,0,0,0,0,0,285000,90000,195000,195000
20200312,06011P,貿聯元富96售04,2.17,2.48,2.17,2.43,+0.37,17.96,240000,13,559600,0,0,0,0,0,0,40000,200000,-160000,-160000
20200312,06012P,世芯國票96售01,1.69,2.25,1.63,2.10,+0.47,28.83,637000,31,1209240,0,0,0,0,0,0,260000,364000,-104000,-104000
20200312,06013P,世芯國泰97售03,1.43,1.75,1.35,1.74,+0.38,27.94,1870000,91,2838220,0,0,0,0,0,0,839000,1031000,-192000,-192000
20200312,06014P,聯發科富邦97售02,1.82,2.25,1.82,2.19,+0.59,36.88,263000,15,548700,0,0,0,0,0,0,174000,139000,35000,35000
20200312,06015P,大立光富邦98售04,,,,,0.00,0.00,0,0,0,0,0,0,0,0,0,0,0,0,0
20200312,06016P,京元電凱基96售03,0.92,1.15,0.92,1.06,+0.23,27.71,256000,17,266870,0,0,0,0,0,0,48000,208000,-160000,-160000
20200312,06017P,亞光凱基96售04,1.96,2.19,1.96,2.19,+0.33,17.74,41000,3,81940,0,0,0,0,0,0,31000,10000,21000,21000
20200312,06018P,康控凱基96售03,1.40,1.68,1.40,1.68,+0.37,28.24,150000,15,229650,0,0,0,0,0,0,30000,110000,-80000,-80000
20200312,06019P,緯穎凱基96售03,0.61,0.63,0.61,0.63,+0.11,21.15,217000,3,133740,0,0,0,0,0,0,0,217000,-217000,-217000
20200312,06020P,燿華元富96售04,3.60,4.00,3.60,4.00,+0.75,23.08,45000,5,169900,0,0,0,0,0,0,10000,35000,-25000,-25000
20200312,06021P,世紀鋼元富96售03,1.38,1.54,1.36,1.46,+0.15,11.45,210000,22,306780,0,0,0,0,0,0,57000,153000,-96000,-96000
20200312,06022P,緯穎永豐96售03,0.68,0.83,0.68,0.83,+0.29,53.7,45000,2,35850,0,0,0,0,0,0,35000,10000,25000,25000
20200312,06023P,超眾國票96售03,3.84,4.21,3.84,4.21,+0.68,19.26,32000,6,124610,0,0,0,0,0,0,22000,10000,12000,12000
20200312,06024P,台郡國票97售05,1.68,1.85,1.68,1.83,+0.46,33.58,238000,5,436420,0,0,0,0,0,0,238000,0,238000,238000
20200312,06025P,臺股指元大99售02,2.93,3.09,2.93,3.03,0.00,0.00,68000,5,202620,0,0,0,0,0,0,0,68000,-68000,-68000
20200312,06026P,華通台新97售01,2.35,2.61,2.35,2.61,+0.55,26.7,115000,7,289720,0,0,0,0,0,0,46000,69000,-23000,-23000
20200312,06027P,鴻海台新96售04,3.37,3.37,3.37,3.37,0.00,0.00,1000,1,3370,0,0,0,0,0,0,1000,0,1000,1000
20200312,06028P,智邦台新97售01,0.82,1.10,0.82,1.00,+0.23,29.87,254000,11,254700,0,0,0,0,0,0,30000,224000,-194000,-194000
20200312,06029P,聯發科台新96售02,4.20,4.76,4.20,4.76,+1.21,34.08,25000,2,115640,0,0,0,0,0,0,6000,19000,-13000,-13000
20200312,06030P,友達兆豐96售02,1.75,2.04,1.75,1.99,+0.36,22.09,276000,10,522410,0,0,0,0,0,0,92000,184000,-92000,-92000
20200312,06031P,新光金兆豐96售02,1.88,1.88,1.88,1.88,0.00,0.00,12000,1,22560,0,0,0,0,0,0,0,12000,-12000,-12000
20200312,06032P,健策群益97售03,1.63,2.01,1.63,2.01,+0.49,32.24,369000,17,666840,0,0,0,0,0,0,200000,163000,37000,37000
20200312,06033P,可成凱基96售09,0.90,1.41,0.90,1.36,+0.68,100.0,760000,16,938790,0,0,0,0,0,0,345000,415000,-70000,-70000
20200312,06034P,世芯凱基96售03,1.19,1.57,1.19,1.46,+0.27,22.69,1610000,55,2140540,0,0,0,0,0,0,660000,930000,-270000,-270000
20200312,06035P,同欣電凱基96售03,0.69,0.81,0.69,0.81,+0.19,30.65,418000,11,310610,0,0,0,0,0,0,377000,41000,336000,336000
20200312,06036P,台表科凱基96售04,1.75,1.75,1.75,1.75,+0.08,4.79,10000,1,17500,0,0,0,0,0,0,10000,0,10000,10000
20200312,06037P,超眾國票98售02,2.25,2.30,2.25,2.30,+0.21,10.05,40000,4,90900,0,0,0,0,0,0,0,40000,-40000,-40000
20200312,06038P,國泰金台新96售01,1.23,1.36,1.20,1.36,+0.22,19.3,298000,17,394190,0,0,0,0,0,0,33000,265000,-232000,-232000
20200312,06039P,亞光台新96售03,2.04,2.41,2.04,2.41,+0.45,22.96,113000,18,238440,0,0,0,0,0,0,50000,53000,-3000,-3000
20200312,06040P,亞光康和96售03,1.24,1.37,1.21,1.37,+0.20,17.09,58000,5,72900,0,8000,-8000,0,0,0,28000,30000,-2000,-10000
20200312,06041P,全新永豐96售03,,,,,0.00,0.00,0,0,0,0,0,0,0,0,0,0,0,0,0
20200312,06042P,華新科永豐96售04,1.15,1.26,1.15,1.26,+0.42,50.0,107000,5,132800,0,0,0,0,0,0,107000,25000,82000,82000
20200312,06043P,創意永豐96售06,1.34,1.67,1.34,1.67,+0.41,32.54,55000,6,81650,0,0,0,0,0,0,10000,45000,-35000,-35000
20200312,06044P,同欣電永豐96售03,1.70,1.98,1.70,1.85,+0.26,16.35,153000,10,274900,0,0,0,0,0,0,83000,70000,13000,13000
20200312,06045P,臺股指永豐96售03,,,,,0.00,0.00,0,0,0,0,0,0,0,0,0,0,0,0,0
20200312,06046P,健策統一96售03,2.22,2.67,2.22,2.67,+0.67,33.5,267000,23,653570,0,0,0,0,0,0,190000,57000,133000,133000
20200312,06047P,聯發科富邦99售04,3.69,4.65,3.69,4.60,+1.09,31.05,598000,40,2475850,0,0,0,0,0,0,379000,259000,120000,120000
20200312,06048P,大立光富邦96售05,1.19,1.45,1.19,1.45,0.00,0.00,8000,3,9960,0,0,0,0,0,0,1000,7000,-6000,-6000
20200312,06049P,創意亞東97售01,,,,,0.00,0.00,0,0,0,0,0,0,0,0,0,0,0,0,0
20200312,06050P,玉晶光國票98售01,5.10,5.90,5.10,5.90,+1.12,23.43,53000,5,273450,0,0,0,0,0,0,50000,3000,47000,47000
20200312,06051P,嘉聯益國票97售04,2.16,2.66,2.16,2.66,+0.70,35.71,163000,10,389180,0,0,0,0,0,0,103000,60000,43000,43000
20200312,06052P,台郡國票97售06,0.89,1.22,0.89,1.13,+0.36,46.75,206000,14,221810,0,0,0,0,0,0,109000,97000,12000,12000
20200312,06053P,緯穎國票97售05,0.37,0.53,0.37,0.53,+0.21,65.62,182000,4,75600,0,0,0,0,0,0,177000,5000,172000,172000
20200312,06054P,臺股指中信9A售01,2.83,3.09,2.83,3.07,+0.51,19.92,178000,22,544640,0,0,0,0,0,0,4000,174000,-170000,-170000
20200312,06055P,華通凱基97售04,2.11,2.56,2.11,2.56,+0.75,41.44,51000,5,115650,0,0,0,0,0,0,30000,21000,9000,9000
20200312,06056P,台積電凱基98售02,1.96,2.14,1.93,2.14,+0.82,62.12,1327000,12,2595050,0,0,0,0,0,0,1267000,60000,1207000,1207000
20200312,06057P,大立光凱基98售01,5.10,5.80,5.10,5.50,+1.72,45.5,70000,5,373250,0,0,0,0,0,0,15000,55000,-40000,-40000
20200312,06058P,玉晶光凱基97售04,1.90,2.33,1.90,2.32,+0.50,27.47,322000,18,703640,0,0,0,0,0,0,270000,161000,109000,109000
20200312,06059P,泰碩元大97售02,1.81,2.16,1.81,2.05,+0.28,15.82,559000,33,1146140,0,0,0,0,0,0,108000,441000,-333000,-333000
20200312,06060P,玉晶光元大97售03,3.29,3.91,3.29,3.91,+0.82,26.54,158000,15,600780,0,0,0,0,0,0,151000,9000,142000,142000
20200312,06061P,訊芯統一97售01,3.13,3.13,3.13,3.13,0.00,0.00,4000,1,12520,0,0,0,0,0,0,4000,0,4000,4000
20200312,06062P,宏達電元富97售01,2.65,3.06,2.55,2.99,+0.45,17.72,146000,19,404900,0,0,0,0,0,0,51000,95000,-44000,-44000
20200312,06063P,玉晶光元富97售01,3.50,4.20,3.47,4.16,+0.91,28.0,392000,44,1468450,0,0,0,0,0,0,306000,75000,231000,231000
20200312,06064P,台積電台新98售01,2.09,2.09,2.09,2.09,0.00,0.00,10000,1,20900,0,0,0,0,0,0,10000,0,10000,10000
20200312,06065P,大立光台新97售01,1.85,2.14,1.85,2.14,+0.68,46.58,53000,2,103850,0,0,0,0,0,0,33000,20000,13000,13000
20200312,06066P,群創台新98售01,1.49,1.51,1.49,1.51,+0.39,34.82,20000,2,29900,0,0,0,0,0,0,0,20000,-20000,-20000
20200312,06067P,華新科康和97售01,1.17,1.38,1.17,1.37,+0.25,22.32,103000,9,130330,0,0,0,0,0,0,90000,61000,29000,29000
20200312,06068P,玉晶光康和97售01,1.27,1.50,1.27,1.50,+0.30,25.0,50000,6,69300,0,0,0,0,0,0,31000,19000,12000,12000
20200312,06069P,台積電永豐97售01,2.48,2.57,2.48,2.57,0.00,0.00,40000,5,100600,0,0,0,0,0,0,35000,0,35000,35000
20200312,06070P,漢唐永豐97售01,1.11,1.27,1.10,1.25,+0.17,15.74,213000,10,250530,0,0,0,0,0,0,138000,75000,63000,63000
20200312,06071P,大立光永豐97售01,3.09,3.50,3.09,3.50,0.00,0.00,58000,5,189750,0,0,0,0,0,0,13000,58000,-45000,-45000
20200312,06072P,牧德永豐97售01,0.83,1.04,0.83,1.04,+0.26,33.33,111000,6,99410,0,0,0,0,0,0,31000,80000,-49000,-49000
20200312,06073P,健策永豐97售01,1.97,2.42,1.97,2.40,+0.58,31.87,168000,15,364490,0,0,0,0,0,0,53000,115000,-62000,-62000
20200312,06074P,台積電凱基98售04,,,,,0.00,0.00,0,0,0,0,0,0,0,0,0,0,0,0,0
20200312,06075P,智邦凱基97售02,0.82,0.89,0.82,0.89,+0.24,36.92,44000,4,37920,0,0,0,0,0,0,9000,35000,-26000,-26000
20200312,06076P,大立光凱基98售03,2.97,3.43,2.97,3.43,+1.55,82.45,40000,6,134600,0,0,0,0,0,0,37000,31000,6000,6000
20200312,06077P,GIS凱基97售02,2.49,2.81,2.49,2.81,+0.59,26.58,40000,4,105100,0,0,0,0,0,0,20000,40000,-20000,-20000
20200312,06078P,臺股指凱基9A售01,4.40,5.05,4.29,4.96,+1.23,32.98,67000,15,325920,0,0,0,0,0,0,31000,34000,-3000,-3000
20200312,06079P,燿華群益98售02,2.85,3.12,2.81,3.12,+0.56,21.88,94000,9,271190,0,0,0,0,0,0,65000,60000,5000,5000
20200312,06080P,景碩群益98售02,1.56,1.96,1.56,1.96,+0.50,34.25,127000,4,218300,0,0,0,0,0,0,10000,117000,-107000,-107000
20200312,06081P,深中小元大97售02,0.40,0.48,0.40,0.46,+0.10,27.78,1143000,59,497980,0,0,0,0,0,0,715000,338000,377000,377000
20200312,06082P,華通統一98售01,,,,,0.00,0.00,0,0,0,0,0,0,0,0,0,0,0,0,0
20200312,06083P,華通統一98售02,1.90,2.37,1.90,2.37,+0.54,29.51,21000,6,42610,0,0,0,0,0,0,10000,11000,-1000,-1000
20200312,06084P,宏達電元富97售02,2.00,2.49,2.00,2.48,+0.46,22.77,308000,23,699220,0,0,0,0,0,0,132000,173000,-41000,-41000
20200312,06085P,義隆台新97售01,1.04,1.15,1.04,1.11,+0.16,16.84,270000,10,302120,0,0,0,0,0,0,14000,256000,-242000,-242000
20200312,06086P,台積電康和97售01,1.53,1.53,1.53,1.53,+0.14,10.07,10000,1,15300,0,0,0,0,0,0,10000,0,10000,10000
20200312,06087P,國巨永豐97售01,2.28,2.85,2.28,2.85,+0.59,26.11,105000,8,250030,0,0,0,0,0,0,75000,30000,45000,45000
20200312,06088P,建準永豐97售01,1.70,1.81,1.70,1.81,+0.20,12.42,81000,2,137810,0,0,0,0,0,0,80000,1000,79000,79000
20200312,06089P,矽創永豐97售01,1.14,1.46,1.14,1.35,0.00,0.00,221000,27,282770,0,0,0,0,0,0,8000,213000,-205000,-205000
20200312,06090P,旺宏統一97售06,2.67,3.20,2.62,3.17,+0.66,26.29,285000,24,768990,0,0,0,0,0,0,143000,137000,6000,6000
20200312,06091P,華新科統一97售01,2.53,3.01,2.53,3.01,+0.67,28.63,93000,10,245920,0,0,0,0,0,0,52000,41000,11000,11000
20200312,06092P,嘉聯益統一97售01,1.35,1.59,1.34,1.59,+0.29,22.31,357000,18,528040,0,0,0,0,0,0,66000,291000,-225000,-225000
20200312,06093P,華通元富97售03,4.14,5.15,4.14,5.15,+1.77,52.37,95000,9,434060,0,0,0,0,0,0,40000,55000,-15000,-15000
20200312,06094P,台達電中信97售01,1.35,1.71,1.35,1.71,+0.47,37.9,474000,27,688570,0,0,0,0,0,0,111000,439000,-328000,-328000
20200312,06095P,燿華永豐97售01,3.16,3.16,3.16,3.16,+0.25,8.59,10000,1,31600,0,0,0,0,0,0,0,10000,-10000,-10000
20200312,06096P,全新永豐97售02,2.09,2.09,2.09,2.09,0.00,0.00,10000,1,20900,0,0,0,0,0,0,0,10000,-10000,-10000
20200312,06097P,茂林永豐97售01,1.22,1.22,1.17,1.17,+0.17,17.0,22000,2,25790,0,0,0,0,0,0,21000,1000,20000,20000
20200312,06098P,T50反1日盛97售02,0.20,0.20,0.13,0.13,0.00,0.00,2000,2,330,0,0,0,0,0,0,0,2000,-2000,-2000
20200312,06099P,鴻海日盛97售03,3.93,4.84,3.81,4.84,+1.45,42.77,219000,9,976110,0,0,0,0,0,0,180000,164000,16000,16000
20200312,06100P,台積電日盛97售03,2.36,3.14,2.36,3.14,+0.78,33.05,46000,7,131250,0,0,0,0,0,0,28000,17000,11000,11000
20200312,06101P,聯發科日盛97售03,3.80,4.98,3.80,4.86,+1.83,60.4,24000,7,110700,0,0,0,0,0,0,24000,18000,6000,6000
20200312,06102P,智邦凱基97售03,0.85,1.09,0.85,1.07,+0.19,21.59,138000,7,134900,0,0,0,0,0,0,58000,40000,18000,18000
20200312,06103P,漢唐凱基97售02,1.39,1.54,1.39,1.54,+0.27,21.26,113000,9,160320,0,0,0,0,0,0,103000,10000,93000,93000
20200312,06104P,大立光凱基97售04,5.10,5.10,5.00,5.00,+2.36,89.39,160000,2,810000,0,0,0,0,0,0,160000,0,160000,160000
20200312,06105P,國巨國票98售02,4.91,6.05,4.91,6.05,+1.23,25.52,210000,15,1121710,0,0,0,0,0,0,182000,63000,119000,119000
20200312,06106P,國巨群益97售02,4.12,5.20,4.12,5.20,+1.34,34.72,15000,4,63120,0,0,0,0,0,0,15000,0,15000,15000
20200312,06107P,美律群益98售02,2.82,3.20,2.82,3.20,+0.57,21.67,40000,4,123000,0,0,0,0,0,0,40000,0,40000,40000
20200312,06108P,奇力新群益97售05,,,,,0.00,0.00,0,0,0,0,0,0,0,0,0,0,0,0,0
20200312,06109P,華新科群益97售05,3.54,4.27,3.54,4.27,+1.00,30.58,95000,6,364850,0,0,0,0,0,0,95000,30000,65000,65000
20200312,06110P,國巨國泰98售02,3.14,3.70,3.14,3.70,+0.89,31.67,167000,17,554350,0,0,0,0,0,0,167000,130000,37000,37000
20200312,06111P,上銀兆豐98售01,2.37,2.74,2.37,2.68,+0.52,24.07,180000,17,453370,0,0,0,0,0,0,81000,99000,-18000,-18000
20200312,06112P,台積電兆豐97售01,5.75,6.35,5.75,6.35,0.00,0.00,134000,4,773500,0,0,0,0,0,0,1000,133000,-132000,-132000
20200312,06113P,台積電群益97售01,6.70,8.15,6.70,8.10,+1.90,30.65,28000,5,193800,0,0,0,0,0,0,27000,11000,16000,16000
20200312,06114P,台積電統一97售03,4.63,4.87,4.63,4.87,+0.65,15.4,205000,3,962750,0,0,0,0,0,0,190000,15000,175000,175000
20200312,06115P,台積電統一97售04,2.41,2.41,2.41,2.41,0.00,0.00,68000,2,163880,0,0,0,0,0,0,0,68000,-68000,-68000
20200312,06116P,臺股指日盛97售01,,,,,0.00,0.00,0,0,0,0,0,0,0,0,0,0,0,0,0
20200312,06117P,臺股指日盛97售02,,,,,0.00,0.00,0,0,0,0,0,0,0,0,0,0,0,0,0
20200312,06118P,上証2X凱基98售03,2.83,3.24,2.83,3.16,+0.33,11.66,191000,22,594030,0,0,0,0,0,0,103000,88000,15000,15000
20200312,06119P,大立光凱基98售04,5.40,5.40,5.40,5.40,0.00,0.00,6000,1,32400,0,0,0,0,0,0,0,6000,-6000,-6000
20200312,06120P,大立光凱基98售05,6.35,6.35,6.35,6.35,+2.71,74.45,9000,1,57150,0,0,0,0,0,0,9000,9000,0,0
20200312,06121P,同欣電凱基97售02,0.48,0.48,0.48,0.48,0.00,0.00,10000,1,4800,0,0,0,0,0,0,0,10000,-10000,-10000
20200312,06122P,亞光元大98售01,1.71,1.89,1.71,1.89,+0.22,13.17,78000,4,139020,0,0,0,0,0,0,27000,72000,-45000,-45000
20200312,06123P,玉晶光元大97售04,1.48,1.80,1.48,1.80,+0.35,24.14,518000,24,834100,0,0,0,0,0,0,482000,36000,446000,446000
20200312,06124P,超眾元大97售03,1.54,1.78,1.54,1.78,+0.37,26.24,524000,10,903920,0,0,0,0,0,0,395000,429000,-34000,-34000
20200312,06125P,楠梓電元富99售01,0.87,1.01,0.87,0.99,+0.24,32.0,135000,22,128480,0,0,0,0,0,0,28000,107000,-79000,-79000
20200312,06126P,凌陽元富97售02,1.65,1.78,1.65,1.78,+0.22,14.1,50000,5,85100,0,0,0,0,0,0,20000,30000,-10000,-10000
20200312,06127P,泰碩元富97售01,1.37,1.67,1.35,1.53,+0.20,15.04,670000,62,1006190,0,0,0,0,0,0,344000,295000,49000,49000
20200312,06128P,玉晶光元富97售05,2.76,3.21,2.72,3.21,+0.60,22.99,63000,7,181310,0,0,0,0,0,0,18000,45000,-27000,-27000
20200312,06129P,玉晶光元富97售06,3.77,4.10,3.75,4.10,+0.58,16.48,96000,15,376800,0,0,0,0,0,0,56000,40000,16000,16000
20200312,06130P,玉晶光元富97售07,1.94,2.16,1.94,2.16,+0.35,19.34,40000,4,81900,0,0,0,0,0,0,20000,20000,0,0
20200312,06131P,京鼎元富97售02,1.65,1.95,1.65,1.95,+0.38,24.2,173000,12,300650,0,0,0,0,0,0,133000,40000,93000,93000
20200312,06132P,正文元富97售01,1.00,1.25,1.00,1.17,+0.18,18.18,231000,23,266690,0,0,0,0,0,0,40000,191000,-151000,-151000
20200312,06133P,帆宣元富97售02,2.29,2.55,2.29,2.44,+0.44,22.0,249000,36,596910,0,0,0,0,0,0,68000,150000,-82000,-82000
20200312,06134P,緯穎元富97售03,0.42,0.53,0.40,0.53,+0.15,39.47,667000,13,331680,0,0,0,0,0,0,597000,60000,537000,537000
20200312,06135P,志超元富97售01,1.34,1.48,1.34,1.47,0.00,0.00,40000,4,56300,0,0,0,0,0,0,0,40000,-40000,-40000
20200312,06136P,華新科國泰99售02,3.61,4.40,3.61,4.32,+0.85,24.5,495000,19,2044360,0,0,0,0,0,0,395000,270000,125000,125000
20200312,06137P,玉晶光永豐97售04,1.34,1.58,1.34,1.58,+0.28,21.54,122000,7,171040,0,0,0,0,0,0,82000,44000,38000,38000
20200312,06138P,台積電中信99售01,1.39,1.41,1.39,1.40,0.00,0.00,31000,4,43400,0,0,0,0,0,0,1000,30000,-29000,-29000
20200312,06139P,台積電中信99售02,1.09,1.24,1.09,1.18,+0.14,13.46,981000,34,1105330,0,0,0,0,0,0,650000,87000,563000,563000
20200312,06140P,華新科群益97售06,4.10,5.55,4.10,5.10,+1.30,34.21,280000,12,1264650,0,0,0,0,0,0,153000,157000,-4000,-4000
20200312,06141P,大立光日盛97售01,2.62,3.00,2.59,3.00,+0.90,42.86,230000,17,615820,0,0,0,0,0,0,196000,37000,159000,159000
20200312,06142P,台虹康和97售02,0.89,1.02,0.89,1.02,0.00,0.00,40000,6,37100,0,0,0,0,0,0,9000,27000,-18000,-18000
20200312,06143P,鴻海永豐97售02,2.65,2.93,2.65,2.89,+0.69,31.36,18000,4,48500,0,0,0,0,0,0,18000,0,18000,18000
20200312,06144P,台光電永豐97售01,1.20,1.30,1.20,1.30,+0.19,17.12,83000,9,103370,0,0,0,0,0,0,0,83000,-83000,-83000
20200312,06145P,華新科永豐97售02,2.09,2.54,2.09,2.52,+0.52,26.0,105000,6,246300,0,0,0,0,0,0,105000,35000,70000,70000
20200312,06146P,S&P反1元大97售03,,,,,0.00,0.00,0,0,0,0,0,0,0,0,0,0,0,0,0
20200312,06147P,國巨元大97售05,1.74,2.16,1.74,2.16,+0.43,24.86,377000,13,717320,0,0,0,0,0,0,376000,321000,55000,55000
20200312,06148P,台積電元大97售17,4.98,5.15,4.98,5.00,+0.67,15.47,285000,6,1446360,0,0,0,0,0,0,285000,2000,283000,283000
20200312,06149P,台積電元大97售18,6.25,6.25,6.15,6.15,+1.00,19.42,202000,4,1247500,0,0,0,0,0,0,202000,202000,0,0
20200312,06150P,奇力新元大97售06,2.01,2.01,1.99,1.99,+0.25,14.37,10000,2,20000,0,0,0,0,0,0,10000,0,10000,10000
20200312,06151P,華新科元大97售07,1.73,2.17,1.73,2.17,+0.44,25.43,403000,22,762000,0,0,0,0,0,0,371000,112000,259000,259000
20200312,06152P,玉晶光元大98售06,1.73,2.00,1.73,1.98,+0.26,15.12,410000,16,774290,0,0,0,0,0,0,364000,46000,318000,318000
20200312,06153P,健策元大97售04,1.28,1.60,1.28,1.60,+0.41,34.45,791000,31,1092940,2000,0,2000,0,0,0,688000,208000,480000,482000
20200312,06154P,超眾元大98售01,1.81,2.01,1.80,2.00,+0.29,16.96,1106000,25,2100190,0,0,0,0,0,0,735000,471000,264000,264000
20200312,06155P,智邦統一97售02,2.07,2.40,2.07,2.28,+0.26,12.87,80000,7,175690,0,0,0,0,0,0,10000,70000,-60000,-60000
20200312,06156P,大立光統一97售05,4.83,5.40,4.83,5.30,+1.43,36.95,27000,4,134300,0,0,0,0,0,0,17000,10000,7000,7000
20200312,06157P,聯鈞統一97售02,1.40,1.69,1.34,1.69,+0.35,26.12,347000,34,502430,0,0,0,0,0,0,228000,86000,142000,142000
20200312,06158P,玉晶光元富97售08,3.58,4.02,3.58,4.02,+0.57,16.52,128000,9,464170,0,0,0,0,0,0,17000,101000,-84000,-84000
20200312,06159P,牧德元富97售02,1.89,2.27,1.89,2.27,+0.48,26.82,206000,18,434060,0,0,0,0,0,0,50000,156000,-106000,-106000
20200312,06160P,台達電群益97售01,2.82,3.40,2.82,3.40,+0.91,36.55,65000,8,195530,0,0,0,0,0,0,2000,59000,-57000,-57000
20200312,06161P,聯發科群益97售03,5.85,7.25,5.85,6.95,+1.25,21.93,33000,13,206800,0,0,0,0,0,0,32000,1000,31000,31000
20200312,06162P,大立光群益97售02,1.72,2.27,1.72,2.27,+1.10,94.02,320000,19,654880,0,0,0,0,0,0,220000,103000,117000,117000
20200312,06163P,聯詠群益97售01,2.82,3.23,2.82,3.23,+0.65,25.19,125000,6,361900,0,0,0,0,0,0,98000,20000,78000,78000
20200312,06164P,臺股指凱基97售04,7.20,7.20,7.20,7.20,0.00,0.00,1000,1,7200,0,0,0,0,0,0,1000,0,1000,1000
20200312,06165P,臺股指凱基9A售03,3.67,3.85,3.67,3.85,+1.11,40.51,37000,4,140830,0,0,0,0,0,0,0,37000,-37000,-37000
20200312,06166P,大立光國票98售01,2.89,3.64,2.89,3.64,+1.69,86.67,22000,4,69770,0,0,0,0,0,0,3000,19000,-16000,-16000
20200312,06167P,欣興國票97售05,2.11,2.22,2.09,2.22,+0.45,25.42,27000,3,57930,0,0,0,0,0,0,17000,10000,7000,7000
20200312,06168P,台表科國票97售06,,,,,0.00,0.00,0,0,0,0,0,0,0,0,0,0,0,0,0
20200312,06169P,華新科元富97售02,3.00,3.70,3.00,3.70,+0.83,28.92,204000,11,708840,0,0,0,0,0,0,154000,50000,104000,104000
20200312,06170P,禾伸堂元富97售02,1.47,1.68,1.47,1.58,+0.04,2.6,808000,17,1283930,0,0,0,0,0,0,205000,603000,-398000,-398000
20200312,06171P,台積電統一97售06,4.71,4.79,4.71,4.79,0.00,0.00,20000,2,95000,0,0,0,0,0,0,0,20000,-20000,-20000
20200312,06172P,台虹永豐97售02,1.09,1.21,1.09,1.20,+0.21,21.21,240000,7,274860,0,0,0,0,0,0,226000,14000,212000,212000
20200312,06173P,華通元大97售02,1.65,1.92,1.65,1.92,+0.44,29.73,10000,5,17350,0,0,0,0,0,0,5000,5000,0,0
20200312,06174P,國巨元大97售07,2.29,2.74,2.29,2.65,+0.36,15.72,725000,37,1822000,0,0,0,0,0,0,519000,586000,-67000,-67000
20200312,06175P,台積電元大97售21,7.25,8.90,7.25,8.30,+1.50,22.06,254000,22,2096600,0,0,0,0,0,0,171000,158000,13000,13000
20200312,06176P,台積電元大97售22,8.00,9.90,8.00,9.90,+2.85,40.43,126000,12,1100200,0,0,0,0,0,0,88000,108000,-20000,-20000
20200312,06177P,玉晶光元大98售07,1.98,2.25,1.98,2.25,+0.35,18.42,344000,9,761780,0,0,0,0,0,0,344000,0,344000,344000
20200312,06178P,大立光第一99售01,1.37,1.48,1.35,1.48,+0.37,33.33,3000,3,4200,0,0,0,0,0,0,3000,0,3000,3000
20200312,06179P,國巨群益97售04,3.35,4.80,3.35,4.80,+1.57,48.61,159000,12,662180,0,0,0,0,0,0,120000,39000,81000,81000
20200312,06180P,禾伸堂群益97售01,1.90,2.15,1.90,1.92,-0.09,-4.48,366000,16,760560,0,0,0,0,0,0,70000,336000,-266000,-266000
20200312,06181P,國巨中信97售02,0.79,1.03,0.79,1.03,+0.26,33.77,98000,8,83860,0,0,0,0,0,0,50000,48000,2000,2000
20200312,06182P,群創兆豐97售03,1.53,1.82,1.53,1.76,+0.39,28.47,163000,11,280720,0,0,0,0,0,0,38000,125000,-87000,-87000
20200312,06183P,大立光元大97售05,2.64,2.89,2.64,2.89,+0.87,43.07,80000,2,218700,0,0,0,0,0,0,0,80000,-80000,-80000
20200312,06184P,大立光元大97售06,3.95,4.33,3.95,4.33,+1.53,54.64,252000,3,995950,0,0,0,0,0,0,250000,252000,-2000,-2000
20200312,06185P,台表科元大97售05,2.33,2.63,2.33,2.63,0.00,0.00,66000,4,154080,0,0,0,0,0,0,46000,20000,26000,26000
20200312,06186P,鴻海統一97售02,,,,,0.00,0.00,0,0,0,0,0,0,0,0,0,0,0,0,0
20200312,06187P,國巨統一97售05,2.48,3.03,2.48,2.95,+0.72,32.29,39000,5,107060,1000,0,1000,0,0,0,0,39000,-39000,-38000
20200312,06188P,大立光元富97售01,2.57,2.81,2.57,2.81,0.00,0.00,29000,3,80650,0,0,0,0,0,0,4000,29000,-25000,-25000
20200312,06189P,華新科永豐97售03,1.30,1.66,1.29,1.61,+0.34,26.77,312000,26,461920,0,0,0,0,0,0,152000,205000,-53000,-53000
20200312,06190P,玉晶光永豐97售05,1.90,2.14,1.89,2.14,+0.32,17.58,314000,15,620610,0,0,0,0,0,0,199000,115000,84000,84000
20200312,06191P,鴻海群益97售03,8.45,8.45,8.45,8.45,0.00,0.00,100000,2,845000,0,0,0,0,0,0,0,100000,-100000,-100000
20200312,06192P,高股息中信98售01,2.57,2.93,2.57,2.82,+0.65,29.95,51000,13,140010,0,0,0,0,0,0,12000,37000,-25000,-25000
20200312,06193P,台積電元富97售04,2.52,3.19,2.52,2.68,+0.36,15.52,3125000,40,9015270,0,0,0,0,0,0,2740000,3105000,-365000,-365000
20200312,06194P,台積電元富97售05,2.79,3.63,2.79,3.11,+0.66,26.94,332000,18,1010050,0,0,0,0,0,0,102000,229000,-127000,-127000
20200312,06195P,台積電元富97售06,1.39,2.14,1.39,1.61,+0.42,35.29,1228000,32,2172760,0,0,0,0,0,0,1110000,1144000,-34000,-34000
20200312,06196P,元上證元大97售01,2.00,2.14,2.00,2.11,+0.20,10.47,277000,13,571530,0,0,0,0,0,0,69000,208000,-139000,-139000
20200312,06197P,國巨元大97售08,1.32,1.56,1.28,1.56,+0.31,24.8,449000,14,618490,0,10000,-10000,0,0,0,334000,409000,-75000,-85000
20200312,06198P,台積電元大98售06,2.52,3.00,2.52,2.63,+0.30,12.88,980000,77,2630330,0,0,0,0,0,0,613000,900000,-287000,-287000
20200312,06199P,聯發科元大97售17,7.00,8.65,7.00,8.55,+2.25,35.71,139000,27,1131250,0,0,0,0,0,0,92000,121000,-29000,-29000
20200312,06200P,聯發科元大97售18,7.20,9.35,7.20,9.35,+3.70,65.49,125000,15,1071550,0,0,0,0,0,0,94000,79000,15000,15000
20200312,06201P,可成元大97售01,2.35,3.04,2.35,2.99,+0.85,39.72,538000,27,1448000,0,0,0,0,0,0,462000,461000,1000,1000
20200312,06202P,大立光元大98售06,4.02,4.10,4.02,4.10,+0.77,23.12,37000,2,150740,0,0,0,0,0,0,12000,25000,-13000,-13000
20200312,06203P,奇力新中信98售02,1.09,1.16,1.09,1.16,+0.14,13.73,50000,3,56800,0,0,0,0,0,0,10000,40000,-30000,-30000
20200312,06204P,鴻海群益97售04,2.61,3.19,2.53,3.19,+1.01,46.33,255000,8,684780,0,0,0,0,0,0,155000,125000,30000,30000
20200312,06205P,台積電群益97售03,1.91,2.08,1.90,2.08,+0.44,26.83,110000,8,212670,0,0,0,0,0,0,100000,10000,90000,90000
20200312,06206P,台積電凱基97售11,2.71,2.97,2.71,2.79,+0.20,7.72,325000,5,927850,0,0,0,0,0,0,285000,323000,-38000,-38000
20200312,06207P,聯發科凱基97售07,3.78,5.25,3.78,5.25,+2.40,84.21,86000,8,358130,0,0,0,0,0,0,42000,44000,-2000,-2000
20200312,06208P,台郡凱基97售03,1.46,1.54,1.46,1.54,+0.50,48.08,20000,2,30000,0,0,0,0,0,0,0,20000,-20000,-20000
20200312,06209P,旺宏統一97售07,3.06,3.58,3.06,3.58,+0.73,25.61,41000,4,135280,0,0,0,0,0,0,6000,35000,-29000,-29000
20200312,06210P,元油反元大97售01,0.02,0.02,0.02,0.02,0.00,0.00,20000,1,400,0,0,0,0,0,0,0,0,0,0
20200312,06211P,鴻海元大98售04,2.98,3.47,2.98,3.39,+0.72,26.97,1200000,51,3884140,0,0,0,0,0,0,374000,999000,-625000,-625000
20200312,06212P,華新科元大97售11,2.05,2.44,2.05,2.38,+0.43,22.05,161000,14,357020,0,0,0,0,0,0,137000,79000,58000,58000
20200312,06213P,大立光元大98售07,4.41,4.73,4.38,4.73,+1.05,28.53,329000,10,1458120,0,0,0,0,0,0,294000,295000,-1000,-1000
20200312,06214P,國巨國票98售04,2.69,3.56,2.68,3.55,+1.23,53.02,260000,19,773490,0,0,0,0,0,0,153000,107000,46000,46000
20200312,06215P,康控永豐97售02,1.89,2.00,1.89,2.00,+0.21,11.73,62000,6,120700,0,0,0,0,0,0,32000,30000,2000,2000
20200312,06216P,上銀元富97售03,2.68,3.19,2.68,3.19,+0.79,32.92,11000,3,30790,0,0,0,0,0,0,0,11000,-11000,-11000
20200312,06217P,鴻海元富97售05,3.41,3.82,3.29,3.82,+0.89,30.38,78000,5,270560,0,0,0,0,0,0,50000,28000,22000,22000
20200312,06218P,鴻海元富97售06,3.80,4.28,3.80,4.28,+1.11,35.02,37000,4,146610,0,0,0,0,0,0,0,37000,-37000,-37000
20200312,06219P,國巨元富97售05,1.03,1.54,1.03,1.54,+0.56,57.14,387000,21,474470,0,0,0,0,0,0,201000,176000,25000,25000
20200312,06220P,廣宇元富97售02,3.58,4.11,3.55,4.11,+0.69,20.18,117000,12,427370,0,0,0,0,0,0,37000,87000,-50000,-50000
20200312,06222P,致茂元富97售02,1.35,1.62,1.35,1.62,+0.38,30.65,260000,19,385700,0,0,0,0,0,0,80000,180000,-100000,-100000
20200312,06223P,漢唐元富97售02,1.53,1.71,1.52,1.67,+0.23,15.97,196000,27,311720,0,0,0,0,0,0,105000,91000,14000,14000
20200312,06224P,可成元富97售02,1.54,1.82,1.54,1.82,+0.49,36.84,81000,4,135520,0,0,0,0,0,0,70000,11000,59000,59000
20200312,06225P,華新科元富97售04,2.30,2.83,2.29,2.83,+0.67,31.02,513000,37,1308440,0,0,0,0,0,0,342000,171000,171000,171000
20200312,06226P,聯發科麥證97售03,,,,,0.00,0.00,0,0,0,0,0,0,0,0,0,0,0,0,0
20200312,06227P,大立光群益97售04,4.59,5.25,4.54,4.94,+1.31,36.09,334000,15,1662340,0,0,0,0,0,0,303000,31000,272000,272000
20200312,06228P,亞德客凱基97售04,0.95,1.22,0.95,1.21,+0.34,39.08,406000,10,457620,0,0,0,0,0,0,376000,370000,6000,6000
20200312,06229P,欣興凱基97售07,1.44,2.20,1.44,1.93,+0.62,47.33,586000,50,993620,0,0,0,0,0,0,488000,56000,432000,432000
20200312,06230P,亞德客永豐97售03,1.53,1.53,1.50,1.50,+0.09,6.38,12000,2,18060,0,0,0,0,0,0,10000,12000,-2000,-2000
20200312,06231P,台積電永豐97售05,,,,,0.00,0.00,0,0,0,0,0,0,0,0,0,0,0,0,0
20200312,06232P,智易永豐97售01,2.50,2.50,2.50,2.50,0.00,0.00,10000,1,25000,0,0,0,0,0,0,0,10000,-10000,-10000
20200312,06233P,訊芯永豐97售03,,,,,0.00,0.00,0,0,0,0,0,0,0,0,0,0,0,0,0
20200312,06234P,亞德客元大97售02,1.76,1.76,1.76,1.76,0.00,0.00,10000,1,17600,0,0,0,0,0,0,0,0,0,0
20200312,06235P,國巨元大97售12,1.31,1.66,1.31,1.66,+0.35,26.72,538000,17,768080,0,0,0,0,0,0,476000,286000,190000,190000
20200312,06236P,台積電元大97售25,,,,,0.00,0.00,0,0,0,0,0,0,0,0,0,0,0,0,0
20200312,06237P,台積電元大97售26,7.75,9.80,7.75,8.35,+1.15,15.97,395000,36,3275950,0,0,0,0,0,0,226000,263000,-37000,-37000
20200312,06238P,台積電元大98售07,8.10,9.80,8.10,8.85,+1.45,19.59,352000,24,2971300,0,0,0,0,0,0,188000,244000,-56000,-56000
20200312,06239P,奇力新元大97售08,3.94,4.53,3.94,4.53,+0.87,23.77,126000,8,529630,0,0,0,0,0,0,72000,54000,18000,18000
20200312,06240P,奇力新元富97售03,1.74,1.94,1.74,1.94,+0.21,12.14,46000,4,83640,0,0,0,0,0,0,26000,20000,6000,6000
20200312,06241P,大立光元富9A售01,2.84,3.14,2.84,3.14,+0.61,24.11,58000,6,174750,0,0,0,0,0,0,34000,22000,12000,12000
20200312,06242P,大立光元富9A售02,3.67,4.08,3.67,4.08,+0.89,27.9,177000,5,658680,0,0,0,0,0,0,115000,62000,53000,53000
20200312,06243P,亞光元富97售01,3.52,3.84,3.49,3.84,+0.54,16.36,187000,7,675530,0,0,0,0,0,0,14000,173000,-159000,-159000
20200312,06244P,智易元富97售02,1.51,1.76,1.51,1.75,+0.35,25.0,431000,17,730990,0,0,0,0,0,0,32000,399000,-367000,-367000
20200312,06245P,健策元富97售03,1.52,1.83,1.52,1.82,+0.50,37.88,154000,21,250330,0,0,0,0,0,0,46000,104000,-58000,-58000
20200312,06246P,茂林元富97售03,2.18,2.69,2.16,2.62,+0.43,19.63,475000,40,1115500,0,0,0,0,0,0,352000,154000,198000,198000
20200312,06247P,同欣電元富97售02,2.52,2.98,2.52,2.86,+0.46,19.17,188000,22,523980,0,0,0,0,0,0,67000,110000,-43000,-43000
20200312,06248P,國巨統一97售07,2.97,3.85,2.97,3.83,+0.81,26.82,52000,8,187030,0,0,0,0,0,0,45000,42000,3000,3000
20200312,06249P,億光統一97售02,2.95,3.05,2.95,3.05,0.00,0.00,30000,3,90000,0,0,0,0,0,0,0,30000,-30000,-30000
20200312,06250P,臺股指永昌97售02,,,,,0.00,0.00,0,0,0,0,0,0,0,0,0,0,0,0,0
20200312,06251P,臺股指永昌97售03,,,,,0.00,0.00,0,0,0,0,0,0,0,0,0,0,0,0,0
20200312,06252P,臺股指兆豐97售02,,,,,0.00,0.00,0,0,0,0,0,0,0,0,0,0,0,0,0
20200312,06253P,臺股指兆豐97售03,,,,,0.00,0.00,0,0,0,0,0,0,0,0,0,0,0,0,0
20200312,06254P,臺股指群益97售07,,,,,0.00,0.00,0,0,0,0,0,0,0,0,0,0,0,0,0
20200312,06255P,臺股指群益97售08,,,,,0.00,0.00,0,0,0,0,0,0,0,0,0,0,0,0,0
20200312,06256P,臺股指群益97售09,5.00,6.35,5.00,6.35,+2.06,48.02,38000,7,227250,0,0,0,0,0,0,32000,6000,26000,26000
20200312,06257P,臺股指群益97售10,6.55,9.50,6.55,9.50,0.00,0.00,14000,11,110550,0,0,0,0,0,0,14000,0,14000,14000
20200312,06258P,臺股指群益97售11,,,,,0.00,0.00,0,0,0,0,0,0,0,0,0,0,0,0,0
20200312,06259P,臺股指群益97售12,,,,,0.00,0.00,0,0,0,0,0,0,0,0,0,0,0,0,0
20200312,06260P,臺股指群益97售13,,,,,0.00,0.00,0,0,0,0,0,0,0,0,0,0,0,0,0
20200312,06261P,上銀凱基97售03,1.39,1.79,1.39,1.79,+0.64,55.65,1217000,11,1848430,0,0,0,0,0,0,17000,1200000,-1183000,-1183000
20200312,06262P,國巨凱基97售07,2.73,3.04,2.73,3.04,+0.30,10.95,48000,5,137140,0,0,0,0,0,0,32000,16000,16000,16000
20200312,06263P,燿華凱基97售04,1.02,1.27,1.02,1.27,+0.33,35.11,195000,10,227000,0,0,0,0,0,0,185000,90000,95000,95000
20200312,06264P,友達凱基98售06,1.91,2.16,1.91,2.16,0.00,0.00,26000,3,52760,0,0,0,0,0,0,6000,26000,-20000,-20000
20200312,06265P,美律凱基97售01,1.44,1.71,1.44,1.71,+0.51,42.5,13000,2,21420,0,0,0,0,0,0,0,13000,-13000,-13000
20200312,06266P,大立光凱基97售11,,,,,0.00,0.00,0,0,0,0,0,0,0,0,0,0,0,0,0
20200312,06267P,大立光凱基97售12,2.93,2.95,2.93,2.95,+0.54,22.41,24000,2,70620,0,0,0,0,0,0,0,24000,-24000,-24000
20200312,06268P,聯詠凱基97售02,1.78,2.11,1.78,2.11,+0.42,24.85,197000,14,373770,0,0,0,0,0,0,91000,106000,-15000,-15000
20200312,06269P,群創凱基98售10,2.41,2.72,2.41,2.72,+0.57,26.51,70000,7,174900,0,0,0,0,0,0,10000,60000,-50000,-50000
20200312,06270P,致伸凱基97售03,1.18,1.36,1.15,1.36,+0.27,24.77,184000,10,220400,0,0,0,0,0,0,133000,51000,82000,82000
20200312,06271P,彩晶凱基97售01,1.57,1.68,1.57,1.68,+0.28,20.0,40000,4,64300,0,0,0,0,0,0,0,40000,-40000,-40000
20200312,06272P,台郡凱基97售04,0.74,0.89,0.74,0.85,+0.31,57.41,95000,6,72700,0,0,0,0,0,0,75000,20000,55000,55000
20200312,06273P,台表科凱基97售04,1.65,2.17,1.65,2.13,+0.48,29.09,153000,10,314080,0,0,0,0,0,0,88000,65000,23000,23000
20200312,06274P,臺股指凱基97售06,,,,,0.00,0.00,0,0,0,0,0,0,0,0,0,0,0,0,0
20200312,06275P,臺股指凱基97售07,,,,,0.00,0.00,0,0,0,0,0,0,0,0,0,0,0,0,0
20200312,06276P,臺股指凱基97售08,,,,,0.00,0.00,0,0,0,0,0,0,0,0,0,0,0,0,0
20200312,06277P,臺股指凱基97售09,10.70,10.70,10.70,10.70,0.00,0.00,1000,1,10700,0,0,0,0,0,0,1000,0,1000,1000
20200312,06278P,臺股指凱基97售10,,,,,0.00,0.00,0,0,0,0,0,0,0,0,0,0,0,0,0
20200312,06279P,臺股指凱基97售11,,,,,0.00,0.00,0,0,0,0,0,0,0,0,0,0,0,0,0
20200312,06280P,臺股指凱基97售12,,,,,0.00,0.00,0,0,0,0,0,0,0,0,0,0,0,0,0
20200312,06281P,臺股指凱基97售13,,,,,0.00,0.00,0,0,0,0,0,0,0,0,0,0,0,0,0
20200312,06282P,聯鈞永豐97售02,1.45,1.45,1.29,1.29,+0.23,21.7,26000,2,35140,0,0,0,0,0,0,16000,10000,6000,6000
20200312,06283P,祥碩永豐97售01,0.78,0.87,0.78,0.84,+0.15,21.74,33000,5,27420,0,0,0,0,0,0,20000,13000,7000,7000
20200312,06284P,台積電國票98售03,5.95,5.95,5.95,5.95,+1.54,34.92,5000,1,29750,0,0,0,0,0,0,5000,0,5000,5000
20200312,06285P,台積電國票98售04,4.42,5.75,4.40,4.65,+0.77,19.85,265000,17,1248350,0,0,0,0,0,0,119000,206000,-87000,-87000
20200312,06286P,世芯國票97售02,1.73,2.05,1.64,1.96,+0.25,14.62,273000,26,500080,0,0,0,0,0,0,117000,133000,-16000,-16000
20200312,06287P,臺股指國票97售01,,,,,0.00,0.00,0,0,0,0,0,0,0,0,0,0,0,0,0
20200312,06288P,臺股指國票97售02,,,,,0.00,0.00,0,0,0,0,0,0,0,0,0,0,0,0,0
20200312,06289P,臺股指國票97售03,,,,,0.00,0.00,0,0,0,0,0,0,0,0,0,0,0,0,0
20200312,06290P,臺股指國票97售04,,,,,0.00,0.00,0,0,0,0,0,0,0,0,0,0,0,0,0
20200312,06291P,臺股指國票97售05,,,,,0.00,0.00,0,0,0,0,0,0,0,0,0,0,0,0,0
20200312,06292P,臺股指國票97售06,,,,,0.00,0.00,0,0,0,0,0,0,0,0,0,0,0,0,0
20200312,06293P,臺股指國票97售07,9.75,9.75,9.75,9.75,+1.85,23.42,10000,1,97500,0,0,0,0,0,0,10000,0,10000,10000
20200312,06294P,臺股指國票97售08,,,,,0.00,0.00,0,0,0,0,0,0,0,0,0,0,0,0,0
20200312,06295P,國巨元大97售14,1.22,1.63,1.22,1.63,+0.39,31.45,388000,24,533060,0,10000,-10000,0,0,0,310000,308000,2000,-8000
20200312,06296P,燿華元大98售01,1.61,1.77,1.60,1.75,+0.27,18.24,105000,6,172810,0,0,0,0,0,0,57000,100000,-43000,-43000
20200312,06297P,美律元大97售01,,,,,0.00,0.00,0,0,0,0,0,0,0,0,0,0,0,0,0
20200312,06298P,聯發科元大97售20,7.85,7.90,7.10,7.90,+2.70,51.92,99000,7,754000,0,0,0,0,0,0,77000,62000,15000,15000
20200312,06299P,可成元大97售04,3.99,4.81,3.96,4.56,+1.14,33.33,241000,9,1039850,0,0,0,0,0,0,240000,234000,6000,6000
20200312,06300P,緯穎元大97售04,1.08,1.27,1.08,1.27,+0.24,23.3,506000,10,598450,0,0,0,0,0,0,399000,207000,192000,192000
20200312,06301P,臺股指元大97售04,7.35,7.35,7.35,7.35,0.00,0.00,18000,1,132300,0,0,0,0,0,0,18000,0,18000,18000
20200312,06302P,臺股指元大97售06,,,,,0.00,0.00,0,0,0,0,0,0,0,0,0,0,0,0,0
20200312,06303P,臺股指元大97售09,,,,,0.00,0.00,0,0,0,0,0,0,0,0,0,0,0,0,0
20200312,06304P,臺股指元大97售10,7.45,7.45,7.45,7.45,+1.05,16.41,1000,1,7450,0,0,0,0,0,0,0,1000,-1000,-1000
20200312,06305P,臺股指元大97售11,7.40,7.40,7.40,7.40,+1.40,23.33,40000,2,296000,0,0,0,0,0,0,30000,10000,20000,20000
20200312,06306P,臺股指元大97售12,7.80,8.05,7.80,8.05,+2.00,33.06,50000,3,394000,0,0,0,0,0,0,50000,0,50000,50000
20200312,06307P,聚陽元富97售02,1.22,1.40,1.20,1.36,+0.28,25.93,182000,33,232810,0,0,0,0,0,0,67000,108000,-41000,-41000
20200312,06308P,國巨元富97售06,1.95,2.57,1.95,2.57,+0.69,36.7,2360000,65,5528030,0,0,0,0,0,0,1883000,2076000,-193000,-193000
20200312,06309P,光罩元富97售03,1.91,2.19,1.90,2.11,+0.35,19.89,547000,31,1144750,0,0,0,0,0,0,439000,101000,338000,338000
20200312,06310P,精元元富97售02,1.80,2.11,1.80,2.06,+0.38,22.62,419000,24,809210,0,0,0,0,0,0,224000,195000,29000,29000
20200312,06311P,嘉聯益元富97售02,1.29,1.59,1.29,1.57,+0.33,26.61,294000,18,429770,0,0,0,0,0,0,37000,257000,-220000,-220000
20200312,06312P,樺漢元富97售02,1.40,1.71,1.40,1.68,+0.34,25.37,142000,16,227340,0,0,0,0,0,0,12000,125000,-113000,-113000
20200312,06313P,訊芯元富97售01,2.07,2.29,2.07,2.29,+0.44,23.78,90000,10,196820,0,0,0,0,0,0,60000,60000,0,0
20200312,06314P,GIS元富97售02,1.54,1.74,1.51,1.74,+0.33,23.4,90000,9,143700,0,0,0,0,0,0,30000,60000,-30000,-30000
20200312,06315P,臺股指元富97售02,,,,,0.00,0.00,0,0,0,0,0,0,0,0,0,0,0,0,0
20200312,06316P,臺股指元富97售03,,,,,0.00,0.00,0,0,0,0,0,0,0,0,0,0,0,0,0
20200312,06317P,臺股指元富97售04,,,,,0.00,0.00,0,0,0,0,0,0,0,0,0,0,0,0,0
20200312,06318P,臺股指元富97售05,4.56,4.56,4.56,4.56,0.00,0.00,5000,1,22800,0,0,0,0,0,0,5000,0,5000,5000
20200312,06319P,臺股指元富97售06,4.77,6.60,4.77,6.25,+2.32,59.03,48000,4,295160,0,0,0,0,0,0,48000,0,48000,48000
20200312,06320P,上銀統一97售04,1.97,2.34,1.97,2.34,0.00,0.00,270000,9,574910,0,0,0,0,0,0,0,270000,-270000,-270000
20200312,06321P,台積電統一98售03,4.00,4.86,4.00,4.86,+1.30,36.52,150000,6,665540,0,0,0,0,0,0,56000,94000,-38000,-38000
20200312,06322P,超眾統一97售04,3.72,3.92,3.72,3.92,+0.30,8.29,58000,5,222790,0,0,0,0,0,0,37000,21000,16000,16000
20200312,06323P,台郡統一97售01,1.48,1.70,1.48,1.70,+0.53,45.3,88000,7,145560,0,0,0,0,0,0,45000,28000,17000,17000
20200312,06324P,TXFI0永昌99售02,,,,,0.00,0.00,0,0,0,0,0,0,0,0,0,0,0,0,0
20200312,06325P,TXFI0永昌99售03,,,,,0.00,0.00,0,0,0,0,0,0,0,0,0,0,0,0,0
20200312,06326P,鴻海中信01售01,1.30,1.45,1.29,1.44,+0.22,18.03,392000,27,543410,0,0,0,0,0,0,240000,191000,49000,49000
20200312,06327P,台積電中信01售01,1.67,1.84,1.67,1.73,+0.15,9.49,248000,29,427720,0,0,0,0,0,0,151000,97000,54000,54000
20200312,06328P,台積電中信01售02,1.25,1.36,1.25,1.29,+0.10,8.4,289000,30,377960,0,0,0,0,0,0,41000,218000,-177000,-177000
20200312,06329P,大立光兆豐97售04,,,,,0.00,0.00,0,0,0,0,0,0,0,0,0,0,0,0,0
20200312,06330P,南亞科群益97售03,4.42,5.45,4.38,5.45,+2.23,69.25,21000,3,93450,0,0,0,0,0,0,11000,10000,1000,1000
20200312,06331P,南亞科群益97售04,2.80,3.35,2.80,3.35,+1.19,55.09,290000,2,966000,0,0,0,0,0,0,290000,0,290000,290000
20200312,06332P,世紀鋼群益98售01,1.06,1.14,1.01,1.07,+0.07,7.0,254000,29,275190,0,0,0,0,0,0,99000,155000,-56000,-56000
20200312,06333P,臺股指群益9C售02,10.00,10.00,10.00,10.00,0.00,0.00,2000,1,20000,0,0,0,0,0,0,2000,0,2000,2000
20200312,06334P,臺股指群益9C售03,,,,,0.00,0.00,0,0,0,0,0,0,0,0,0,0,0,0,0
20200312,06335P,台積電麥證97售02,2.62,2.98,2.62,2.98,+0.52,21.14,80000,3,231800,80000,0,80000,0,0,0,80000,0,80000,80000
20200312,06336P,鴻海元大98售05,3.33,3.33,3.33,3.33,0.00,0.00,20000,2,66600,0,0,0,0,0,0,0,20000,-20000,-20000
20200312,06337P,祥碩元大97售05,1.38,1.63,1.36,1.56,+0.15,10.64,510000,28,755050,0,0,0,0,0,0,94000,386000,-292000,-292000
20200312,06338P,亞德客統一97售02,1.99,2.34,1.99,2.34,+0.45,23.81,248000,9,521400,0,0,0,0,0,0,248000,0,248000,248000
20200312,06339P,上銀統一97售06,2.29,2.49,2.22,2.45,+0.58,31.02,77000,12,183180,0,0,0,0,0,0,3000,74000,-71000,-71000
20200312,06340P,鴻海統一98售06,4.00,4.50,4.00,4.50,+0.83,22.62,57000,6,240000,0,0,0,0,0,0,35000,47000,-12000,-12000
20200312,06341P,大立光統一97售08,3.66,3.66,3.66,3.66,0.00,0.00,10000,1,36600,0,0,0,0,0,0,10000,0,10000,10000
20200312,06342P,世芯統一98售01,1.36,1.49,1.26,1.41,+0.16,12.8,104000,7,140540,0,0,0,0,0,0,40000,64000,-24000,-24000
20200312,06343P,臺股指統一98售01,,,,,0.00,0.00,0,0,0,0,0,0,0,0,0,0,0,0,0
20200312,06344P,臺股指統一99售03,,,,,0.00,0.00,0,0,0,0,0,0,0,0,0,0,0,0,0
20200312,06345P,臺股指統一9A售01,6.80,7.45,6.80,7.45,+1.60,27.35,6000,5,43950,0,0,0,0,0,0,5000,1000,4000,4000
20200312,06346P,聯鈞元富97售02,0.63,0.75,0.63,0.75,+0.14,22.95,705000,12,503950,0,0,0,0,0,0,590000,25000,565000,565000
20200312,06347P,祥碩元富97售02,0.87,0.94,0.80,0.92,+0.10,12.2,709000,40,602870,0,0,0,0,0,0,171000,489000,-318000,-318000
20200312,06348P,鈺齊元富97售02,,,,,0.00,0.00,0,0,0,0,0,0,0,0,0,0,0,0,0
20200312,06349P,臺股指台新99售01,2.84,3.55,2.84,3.55,+0.93,35.5,15000,3,47100,0,0,0,0,0,0,15000,0,15000,15000
20200312,06350P,臺股指台新99售02,4.60,4.65,4.60,4.65,0.00,0.00,2000,2,9250,0,0,0,0,0,0,2000,0,2000,2000
20200312,06351P,臺股指台新99售03,4.76,5.60,4.76,5.10,+1.17,29.77,320000,8,1538900,0,0,0,0,0,0,320000,0,320000,320000
20200312,06352P,臺股指富邦99售02,,,,,0.00,0.00,0,0,0,0,0,0,0,0,0,0,0,0,0
20200312,06353P,電子類富邦99售02,1.30,1.30,1.30,1.30,0.00,0.00,4000,1,5200,0,0,0,0,0,0,4000,0,4000,4000
20200312,06354P,大立光永豐97售04,3.97,4.45,3.97,4.40,0.00,0.00,29000,4,124170,0,0,0,0,0,0,5000,24000,-19000,-19000
20200312,06355P,聯茂永豐97售02,1.05,1.18,1.03,1.18,+0.23,24.21,272000,10,301920,0,0,0,0,0,0,182000,90000,92000,92000
20200312,06356P,啟碁永豐97售01,2.42,2.91,2.42,2.91,+0.63,27.63,118000,14,313730,0,0,0,0,0,0,21000,97000,-76000,-76000
20200312,06357P,臺股指永豐97售03,,,,,0.00,0.00,0,0,0,0,0,0,0,0,0,0,0,0,0
20200312,06358P,力成中信97售02,0.99,1.23,0.99,1.17,+0.23,24.47,436000,24,475450,0,0,0,0,0,0,226000,210000,16000,16000
20200312,06359P,上銀群益97售03,3.75,4.38,3.75,4.23,+0.85,25.15,192000,14,765600,0,0,0,0,0,0,36000,156000,-120000,-120000
20200312,06360P,台積電群益97售05,7.20,7.20,7.20,7.20,0.00,0.00,10000,1,72000,0,0,0,0,0,0,10000,10000,0,0
20200312,06361P,聯發科群益97售06,2.31,3.09,2.31,3.09,+1.02,49.28,127000,12,325780,0,0,0,0,0,0,87000,120000,-33000,-33000
20200312,06362P,臺股指麥證97售01,,,,,0.00,0.00,0,0,0,0,0,0,0,0,0,0,0,0,0
20200312,06363P,臺股指麥證97售02,14.20,14.20,14.20,14.20,0.00,0.00,10000,1,142000,0,10000,-10000,0,0,0,0,10000,-10000,-10000
20200312,06364P,鴻海凱基97售08,2.39,2.73,2.39,2.60,+0.40,18.18,114000,11,289600,0,0,0,0,0,0,67000,72000,-5000,-5000
20200312,06365P,鴻海凱基97售09,2.93,3.46,2.93,3.44,+0.76,28.36,75000,5,246220,0,0,0,0,0,0,61000,74000,-13000,-13000
20200312,06366P,鴻海凱基97售10,3.87,4.78,3.87,4.78,+1.37,40.18,67000,6,293020,0,0,0,0,0,0,52000,40000,12000,12000
20200312,06367P,台積電凱基97售14,2.55,3.00,2.54,2.70,+0.61,29.19,85000,13,232940,0,0,0,0,0,0,55000,85000,-30000,-30000
20200312,06368P,台積電凱基97售15,7.20,8.55,7.20,7.75,+1.55,25.0,311000,39,2384950,0,0,0,0,0,0,276000,305000,-29000,-29000
20200312,06369P,台積電凱基97售16,5.55,6.60,5.45,5.85,+1.55,36.05,527000,23,3078350,0,0,0,0,0,0,240000,357000,-117000,-117000
20200312,06370P,貿聯凱基97售03,1.56,1.73,1.56,1.73,+0.18,11.61,54000,4,91200,0,0,0,0,0,0,1000,53000,-52000,-52000
20200312,06371P,茂林國票98售04,2.98,4.06,2.98,3.55,+0.56,18.73,206000,19,660920,0,0,0,0,0,0,137000,30000,107000,107000
20200312,06372P,聯發科元大97售21,5.55,6.85,5.55,6.80,+2.04,42.86,125000,16,818450,0,0,0,0,0,0,98000,105000,-7000,-7000
20200312,06373P,聯發科元大97售22,5.40,7.05,5.40,6.65,+1.75,35.71,461000,30,2855450,0,0,0,0,0,0,446000,461000,-15000,-15000
20200312,06374P,台表科元大97售06,2.36,2.60,2.36,2.60,+0.50,23.81,12000,3,28750,0,0,0,0,0,0,2000,10000,-8000,-8000
20200312,06375P,矽力元大97售06,1.30,1.38,1.25,1.30,+0.13,11.11,1051000,45,1379810,0,0,0,0,0,0,488000,533000,-45000,-45000
20200312,06376P,上銀統一99售01,3.02,3.39,3.02,3.39,+0.66,24.18,388000,19,1271560,0,0,0,0,0,0,0,388000,-388000,-388000
20200312,06377P,華通統一97售04,3.15,3.98,3.15,3.96,+0.99,33.33,62000,25,214690,0,0,0,0,0,0,30000,32000,-2000,-2000
20200312,06378P,國巨統一97售08,3.09,3.87,3.08,3.87,+0.77,24.84,166000,15,537980,0,0,0,0,0,0,72000,94000,-22000,-22000
20200312,06379P,群創統一97售05,2.20,2.20,2.16,2.16,+0.57,35.85,15000,2,32600,0,0,0,0,0,0,0,15000,-15000,-15000
20200312,06380P,臺股指統一98售02,10.50,10.50,10.50,10.50,0.00,0.00,1000,1,10500,0,0,0,0,0,0,0,1000,-1000,-1000
20200312,06381P,臺股指統一98售03,,,,,0.00,0.00,0,0,0,0,0,0,0,0,0,0,0,0,0
20200312,06382P,大毅元富97售02,1.07,1.23,1.04,1.18,+0.14,13.46,750000,58,840810,0,0,0,0,0,0,292000,448000,-156000,-156000
20200312,06383P,聯茂元富97售01,0.69,0.84,0.69,0.84,+0.24,40.0,377000,18,287670,0,0,0,0,0,0,187000,150000,37000,37000
20200312,06384P,訊芯元富97售03,3.09,3.26,3.05,3.26,+0.39,13.59,56000,5,173780,0,0,0,0,0,0,46000,10000,36000,36000
20200312,06385P,聯發科永豐97售02,2.44,2.99,2.44,2.99,+0.73,32.3,318000,11,870200,0,0,0,0,0,0,100000,308000,-208000,-208000
20200312,06386P,欣興永豐97售03,2.70,3.26,2.70,3.26,+0.84,34.71,103000,8,319740,0,0,0,0,0,0,72000,31000,41000,41000
20200312,06387P,緯穎永豐97售02,1.27,1.69,1.27,1.69,+0.58,52.25,525000,6,820450,0,0,0,0,0,0,505000,20000,485000,485000
20200312,06388P,鴻海兆豐97售04,3.49,3.49,3.47,3.47,0.00,0.00,106000,2,367940,0,0,0,0,0,0,100000,106000,-6000,-6000
20200312,06389P,聯發科兆豐97售01,2.59,3.11,2.59,3.11,+0.75,31.78,141000,8,389950,0,0,0,0,0,0,121000,20000,101000,101000
20200312,06390P,美律國票97售03,2.66,2.66,2.66,2.66,0.00,0.00,9000,1,23940,0,0,0,0,0,0,0,9000,-9000,-9000
20200312,06391P,上銀中信97售03,1.40,1.63,1.40,1.59,+0.34,27.2,267000,13,402520,0,0,0,0,0,0,66000,251000,-185000,-185000
20200312,06392P,T50反1元大9A售01,0.81,0.81,0.78,0.78,-0.08,-9.3,2995000,10,2375530,0,0,0,0,0,0,2995000,0,2995000,2995000
20200312,06393P,台積電元大97售27,6.50,7.90,6.50,7.20,+1.50,26.32,425000,21,3020250,0,0,0,0,0,0,309000,374000,-65000,-65000
20200312,06394P,台積電元大97售28,7.40,9.30,7.40,8.25,+1.50,22.22,551000,40,4306150,0,0,0,0,0,0,343000,283000,60000,60000
20200312,06395P,台積電元大97售29,8.25,9.60,8.25,9.60,+2.25,30.61,118000,6,1024350,0,0,0,0,0,0,92000,56000,36000,36000
20200312,06396P,新日興康和97售01,1.30,1.33,1.30,1.33,+0.07,5.56,85000,4,111650,0,0,0,0,0,0,36000,49000,-13000,-13000
20200312,06397P,T50反1凱基9A售03,,,,,0.00,0.00,0,0,0,0,0,0,0,0,0,0,0,0,0
20200312,06398P,禾伸堂凱基97售02,1.14,1.31,1.14,1.14,0.00,0.00,439000,25,550740,0,0,0,0,0,0,0,439000,-439000,-439000
20200312,06399P,台表科凱基97售05,1.82,2.22,1.82,2.22,+0.63,39.62,14000,2,29480,0,0,0,0,0,0,4000,10000,-6000,-6000
20200312,06400P,鴻海元富97售12,8.25,8.25,8.25,8.25,0.00,0.00,70000,2,577500,0,0,0,0,0,0,0,70000,-70000,-70000
20200312,06401P,鴻海元富97售13,8.35,9.20,8.35,9.20,0.00,0.00,62000,3,538700,0,0,0,0,0,0,0,62000,-62000,-62000
20200312,06402P,鴻海元富97售14,7.35,7.35,7.35,7.35,0.00,0.00,2000,1,14700,0,0,0,0,0,0,0,2000,-2000,-2000
20200312,06403P,鴻海元富97售15,3.91,4.35,3.79,4.35,+0.92,26.82,61000,8,245380,0,0,0,0,0,0,19000,42000,-23000,-23000
20200312,06404P,鴻海元富97售16,,,,,0.00,0.00,0,0,0,0,0,0,0,0,0,0,0,0,0
20200312,06405P,億光元富97售02,2.12,2.33,2.12,2.33,+0.29,14.22,180000,11,399400,0,0,0,0,0,0,80000,100000,-20000,-20000
20200312,06406P,可成元富97售04,3.00,3.35,2.95,3.35,+0.78,30.35,140000,13,430200,0,0,0,0,0,0,60000,120000,-60000,-60000
20200312,06407P,創意元富97售02,3.29,3.70,3.29,3.63,+0.52,16.72,93000,10,327130,0,0,0,0,0,0,26000,67000,-41000,-41000
20200312,06408P,聯茂元富97售02,0.80,0.96,0.80,0.96,+0.23,31.51,488000,27,444220,0,0,0,0,0,0,328000,180000,148000,148000
20200312,06409P,康友元富97售03,3.04,3.35,3.03,3.35,+0.49,17.13,269000,26,853100,0,0,0,0,0,0,21000,248000,-227000,-227000
20200312,06410P,祥碩統一97售01,0.89,1.16,0.83,1.02,+0.14,15.91,638000,30,630120,0,0,0,0,0,0,35000,575000,-540000,-540000
20200312,06411P,晶相光永豐97售03,1.10,1.28,1.10,1.25,+0.15,13.64,109000,14,130520,0,0,0,0,0,0,38000,68000,-30000,-30000
20200312,06412P,南亞科日盛97售01,1.90,2.08,1.88,2.08,+0.41,24.55,26000,4,50040,0,0,0,0,0,0,26000,0,26000,26000
20200312,06413P,聯發科凱基97售11,4.44,5.55,4.44,5.55,+2.17,64.2,12000,2,58830,0,0,0,0,0,0,7000,5000,2000,2000
20200312,06414P,矽力凱基97售03,1.50,1.62,1.50,1.55,+0.13,9.15,349000,20,542370,0,0,0,0,0,0,119000,229000,-110000,-110000
20200312,06415P,台積電群益97售07,6.85,6.85,6.85,6.85,+0.70,11.38,50000,1,342500,0,0,0,0,0,0,50000,50000,0,0
20200312,06416P,大立光群益97售06,3.01,4.05,3.01,4.05,+2.01,98.53,57000,7,218380,0,0,0,0,0,0,55000,2000,53000,53000
20200312,06417P,台積電兆豐97售03,2.06,2.21,2.04,2.20,+0.27,13.99,631000,12,1316340,0,0,0,0,0,0,609000,22000,587000,587000
20200312,06418P,T50反1統一9A售02,0.35,0.37,0.33,0.35,-0.07,-16.67,211000,8,74880,0,0,0,0,0,0,0,211000,-211000,-211000
20200312,06419P,國巨統一97售09,1.85,2.33,1.85,2.33,0.00,0.00,54000,3,102840,0,0,0,0,0,0,0,54000,-54000,-54000
20200312,06420P,大立光統一98售06,2.10,2.26,2.10,2.26,+0.49,27.68,268000,5,590440,0,0,0,0,0,0,37000,231000,-194000,-194000
20200312,06421P,嘉澤統一97售02,2.60,2.78,2.60,2.78,0.00,0.00,6000,2,16140,0,0,0,0,0,0,6000,0,6000,6000
20200312,06422P,勤誠統一98售01,1.83,1.98,1.83,1.95,+0.20,11.43,74000,7,140330,0,0,0,0,0,0,44000,20000,24000,24000
20200312,06423P,亞光台新97售01,1.66,1.92,1.66,1.92,+0.33,20.75,145000,10,257480,0,0,0,0,0,0,42000,103000,-61000,-61000
20200312,06424P,大成鋼永豐97售01,1.62,1.68,1.62,1.63,+0.06,3.82,167000,5,271650,0,0,0,0,0,0,130000,37000,93000,93000
20200312,06425P,TPK永豐97售02,2.44,2.67,2.44,2.67,+0.40,17.62,50000,4,127300,0,0,0,0,0,0,20000,30000,-10000,-10000
20200312,06426P,T50正2元大9B售01,0.84,0.98,0.84,0.97,+0.23,31.08,848000,14,782070,0,0,0,0,0,0,771000,21000,750000,750000
20200312,06427P,鴻海元大97售13,3.89,4.30,3.89,4.28,+0.74,20.9,680000,27,2861270,0,0,0,0,0,0,185000,492000,-307000,-307000
20200312,06428P,國巨元大97售17,2.00,2.30,2.00,2.29,+0.33,16.84,430000,24,915630,0,0,0,0,0,0,378000,322000,56000,56000
20200312,06429P,大立光元大97售15,,,,,0.00,0.00,0,0,0,0,0,0,0,0,0,0,0,0,0
20200312,06430P,大立光元大97售16,5.90,6.20,5.90,6.20,+1.20,24.0,18000,3,109400,0,0,0,0,0,0,8000,10000,-2000,-2000
20200312,06431P,新日興元大97售05,3.45,3.59,3.42,3.59,+0.29,8.79,78000,7,272490,0,0,0,0,0,0,30000,48000,-18000,-18000
20200312,06432P,上銀群益98售01,,,,,0.00,0.00,0,0,0,0,0,0,0,0,0,0,0,0,0
20200312,06433P,大立光群益99售01,4.87,5.55,4.83,5.55,+1.50,37.04,48000,4,242700,0,0,0,0,0,0,25000,23000,2000,2000
20200312,06434P,超眾群益98售02,1.80,2.01,1.80,1.94,+0.26,15.48,562000,17,1061230,0,0,0,0,0,0,228000,334000,-106000,-106000
20200312,06435P,臺股指群益98售02,,,,,0.00,0.00,0,0,0,0,0,0,0,0,0,0,0,0,0
20200312,06436P,台光電國票98售04,2.72,2.72,2.72,2.72,+0.26,10.57,6000,1,16320,0,0,0,0,0,0,6000,0,6000,6000
20200312,06437P,玉晶光國票99售01,8.95,9.00,8.95,9.00,+1.70,23.29,5000,2,44850,0,0,0,0,0,0,0,5000,-5000,-5000
20200312,06438P,玉晶光國票99售02,3.90,3.90,3.90,3.90,+0.48,14.04,2000,1,7800,0,0,0,0,0,0,2000,0,2000,2000
20200312,06439P,上銀凱基98售02,1.85,2.05,1.85,2.05,+0.44,27.33,1441000,21,2858440,0,0,0,0,0,0,38000,1403000,-1365000,-1365000
20200312,06440P,台積電凱基98售07,3.35,3.55,3.35,3.37,+0.28,9.06,163000,14,557500,0,0,0,0,0,0,143000,162000,-19000,-19000
20200312,06441P,台積電凱基98售08,3.62,4.32,3.62,4.00,+1.02,34.23,78000,7,302240,0,0,0,0,0,0,78000,70000,8000,8000
20200312,06443P,台積電凱基99售01,4.88,5.40,4.88,5.40,+1.31,32.03,10000,2,50880,0,0,0,0,0,0,6000,4000,2000,2000
20200312,06444P,大立光凱基98售08,,,,,0.00,0.00,0,0,0,0,0,0,0,0,0,0,0,0,0
20200312,06445P,大立光凱基98售09,4.02,4.02,4.02,4.02,0.00,0.00,10000,1,40200,0,0,0,0,0,0,10000,10000,0,0
20200312,06446P,大立光凱基98售10,16.00,16.30,16.00,16.30,0.00,0.00,10000,2,161500,0,0,0,0,0,0,0,10000,-10000,-10000
20200312,06447P,上銀元大98售01,2.87,3.30,2.87,3.30,+0.72,27.91,47000,5,150140,0,0,0,0,0,0,30000,17000,13000,13000
20200312,06448P,華通元大99售01,1.92,2.23,1.89,2.23,0.00,0.00,17000,5,33620,0,0,0,0,0,0,1000,16000,-15000,-15000
20200312,06449P,台積電元大98售09,6.60,7.05,6.60,7.00,+1.15,19.66,215000,17,1476500,0,0,0,0,0,0,148000,127000,21000,21000
20200312,06450P,聯發科元大98售03,4.18,4.91,4.18,4.91,+1.24,33.79,362000,23,1665900,0,0,0,0,0,0,278000,229000,49000,49000
20200312,06451P,聯發科元大98售04,9.05,9.10,8.30,9.10,+2.95,47.97,69000,3,603700,0,0,0,0,0,0,40000,69000,-29000,-29000
20200312,06452P,大立光元大98售08,5.45,5.80,5.45,5.80,+1.14,24.46,35000,5,197000,0,0,0,0,0,0,30000,5000,25000,25000
20200312,06453P,群創元大9B售02,2.31,2.38,2.31,2.38,0.00,0.00,90000,3,210100,0,0,0,0,0,0,90000,90000,0,0
20200312,06454P,緯穎元大98售04,1.11,1.34,1.11,1.32,+0.24,22.22,2658000,72,3259820,0,0,0,0,0,0,1643000,1094000,549000,549000
20200312,06455P,上銀統一99售03,4.69,4.69,4.69,4.69,0.00,0.00,32000,1,150080,0,0,0,0,0,0,0,32000,-32000,-32000
20200312,06456P,聯發科統一98售03,2.32,2.41,2.28,2.41,+0.78,47.85,105000,3,242050,0,0,0,0,0,0,105000,0,105000,105000
20200312,06457P,玉晶光統一98售02,2.39,2.80,2.39,2.80,+0.57,25.56,137000,9,338200,0,0,0,0,0,0,87000,50000,37000,37000
20200312,06458P,玉晶光統一9A售02,2.30,2.56,2.30,2.56,+0.53,26.11,398000,9,987690,0,0,0,0,0,0,260000,138000,122000,122000
20200312,06459P,亞德客元富98售01,3.17,3.61,3.14,3.61,+0.60,19.93,163000,12,539220,0,0,0,0,0,0,143000,20000,123000,123000
20200312,06460P,亞德客元富98售02,2.66,3.07,2.66,3.07,+0.60,24.29,145000,8,407830,0,0,0,0,0,0,74000,71000,3000,3000
20200312,06461P,玉晶光國泰9A售01,2.33,2.69,2.33,2.69,+0.39,16.96,431000,20,1072630,0,0,0,0,0,0,268000,163000,105000,105000
20200312,06462P,鴻海富邦98售01,,,,,0.00,0.00,0,0,0,0,0,0,0,0,0,0,0,0,0
20200312,06463P,大立光富邦9A售01,1.14,1.39,1.14,1.39,0.00,0.00,78000,8,99960,0,0,0,0,0,0,58000,20000,38000,38000
20200312,06464P,台光電亞東99售01,1.59,1.63,1.59,1.63,0.00,0.00,200000,3,322000,0,0,0,0,0,0,0,200000,-200000,-200000
20200312,06465P,國巨統一98售04,1.62,1.99,1.62,1.96,+0.43,28.1,370000,17,691400,0,0,0,0,0,0,15000,355000,-340000,-340000
20200312,06466P,台積電統一9B售01,1.64,1.91,1.64,1.78,+0.28,18.67,858000,32,1468000,0,0,0,0,0,0,10000,848000,-838000,-838000
20200312,06467P,旺宏統一98售01,2.15,2.49,2.15,2.42,+0.39,19.21,103000,10,243850,0,0,0,0,0,0,39000,64000,-25000,-25000
20200312,06468P,華新科統一98售02,2.31,2.64,2.31,2.64,+0.49,22.79,50000,6,120250,0,0,0,0,0,0,50000,0,50000,50000
20200312,06469P,臺股指凱基99售09,2.70,3.35,2.68,3.25,+0.82,33.74,250000,19,712850,0,0,0,0,0,0,240000,10000,230000,230000
20200312,06470P,臺股指凱基99售10,2.35,3.01,2.35,2.89,+0.71,32.57,169000,16,459490,0,0,0,0,0,0,157000,12000,145000,145000
20200312,06471P,臺股指凱基99售11,2.10,2.80,2.10,2.70,+0.70,35.0,492000,40,1182070,0,0,0,0,0,0,222000,265000,-43000,-43000
20200312,06472P,道瓊銀元大98售03,1.03,1.11,1.03,1.11,+0.18,19.35,185000,4,196450,0,0,0,0,0,0,100000,185000,-85000,-85000
20200312,06473P,鴻海元大99售03,3.56,3.61,3.56,3.61,0.00,0.00,33000,3,118630,0,0,0,0,0,0,23000,33000,-10000,-10000
20200312,06474P,鴻海富邦98售03,1.26,1.41,1.26,1.41,+0.28,24.78,13000,4,17370,0,0,0,0,0,0,5000,13000,-8000,-8000
20200312,06475P,牧德永豐98售03,1.68,2.05,1.68,2.05,+0.45,28.13,47000,3,82790,0,0,0,0,0,0,47000,0,47000,47000
20200312,06476P,臺股指永豐98售01,,,,,0.00,0.00,0,0,0,0,0,0,0,0,0,0,0,0,0
20200312,06477P,緯穎國票99售02,1.22,1.42,1.22,1.41,+0.24,20.51,1702000,27,2198230,0,0,0,0,0,0,1643000,59000,1584000,1584000
20200312,06478P,臺股指日盛9A售01,7.40,7.40,7.40,7.40,0.00,0.00,20000,1,148000,0,0,0,0,0,0,20000,0,20000,20000
20200312,06479P,聯發科中信99售02,0.81,0.92,0.81,0.92,+0.14,17.95,514000,18,435980,0,0,0,0,0,0,478000,36000,442000,442000
20200312,06480P,上銀凱基98售04,,,,,0.00,0.00,0,0,0,0,0,0,0,0,0,0,0,0,0
20200312,06481P,台積電凱基98售12,4.99,4.99,4.99,4.99,0.00,0.00,74000,2,369260,0,0,0,0,0,0,0,74000,-74000,-74000
20200312,06482P,台積電凱基98售13,2.58,3.25,2.58,2.97,+0.72,32.0,772000,20,2150870,0,0,0,0,0,0,150000,672000,-522000,-522000
20200312,06483P,聯發科凱基98售10,3.01,3.78,3.01,3.78,0.00,0.00,65000,4,215950,0,0,0,0,0,0,0,65000,-65000,-65000
20200312,06484P,聯發科凱基98售11,5.80,5.80,5.80,5.80,+1.23,26.91,5000,1,29000,0,0,0,0,0,0,5000,0,5000,5000
20200312,06485P,玉晶光群益9A售02,3.75,4.06,3.71,4.04,+0.48,13.48,155000,15,590350,0,0,0,0,0,0,35000,120000,-85000,-85000
20200312,06486P,麗豐元大98售02,1.58,1.72,1.58,1.69,+0.19,12.67,696000,16,1136270,0,0,0,0,0,0,273000,423000,-150000,-150000
20200312,06487P,聯發科統一99售02,,,,,0.00,0.00,0,0,0,0,0,0,0,0,0,0,0,0,0
20200312,06488P,台積電元富98售05,2.84,3.41,2.83,2.90,+0.56,23.93,895000,17,2738400,0,0,0,0,0,0,450000,445000,5000,5000
20200312,06489P,台積電元富98售06,1.79,2.04,1.79,1.89,+0.60,46.51,338000,7,627710,0,0,0,0,0,0,153000,185000,-32000,-32000
20200312,06490P,鴻海富邦99售02,0.88,1.06,0.88,1.05,+0.23,28.05,281000,16,268130,0,0,0,0,0,0,35000,238000,-203000,-203000
20200312,06491P,台積電富邦99售02,1.10,1.18,1.09,1.17,+0.18,18.18,216000,4,240020,0,0,0,0,0,0,176000,50000,126000,126000
20200312,06492P,上銀永豐98售01,1.46,1.64,1.46,1.64,+0.41,33.33,97000,8,151920,0,0,0,0,0,0,0,97000,-97000,-97000
20200312,06493P,聯發科永豐98售02,1.57,2.15,1.57,2.15,+0.84,64.12,259000,9,468900,0,0,0,0,0,0,179000,160000,19000,19000
20200312,06494P,鴻海永昌98售03,3.00,3.48,3.00,3.43,0.00,0.00,171000,7,573330,0,0,0,0,0,0,129000,171000,-42000,-42000
20200312,06495P,華新科亞東9A售01,3.05,3.05,3.05,3.05,0.00,0.00,10000,1,30500,0,0,0,0,0,0,0,10000,-10000,-10000
20200312,06496P,台灣50日盛98售01,3.75,4.80,3.75,4.52,+1.22,36.97,1439000,86,6032410,0,0,0,0,0,0,955000,817000,138000,138000
20200312,06497P,大立光凱基98售11,3.40,3.40,3.40,3.40,0.00,0.00,56000,1,190400,0,0,0,0,0,0,0,56000,-56000,-56000
20200312,06498P,臺股指元大9A售03,4.19,4.94,4.19,4.76,+1.70,55.56,76000,4,355590,0,0,0,0,0,0,76000,0,76000,76000
20200312,06499P,臺股指元大9A售04,4.03,5.05,4.02,4.79,+1.16,31.96,287000,10,1410890,0,0,0,0,0,0,271000,16000,255000,255000
20200312,06500P,臺股指元大9A售05,3.70,4.49,3.70,4.24,+1.06,33.33,1054000,23,4565180,0,0,0,0,0,0,1025000,21000,1004000,1004000
20200312,06501P,臺股指元大9A售06,4.91,5.50,4.91,5.50,+1.24,29.11,52000,4,259050,0,0,0,0,0,0,32000,20000,12000,12000
20200312,06502P,A50中信98售01,,,,,0.00,0.00,0,0,0,0,0,0,0,0,0,0,0,0,0
20200312,06503P,臺股指中信9A售02,1.23,1.55,1.23,1.51,+0.35,30.17,1154000,62,1626120,0,0,0,0,0,0,890000,264000,626000,626000
20200312,06504P,麗豐國票99售02,1.30,1.45,1.30,1.41,+0.14,11.02,177000,6,249910,0,0,0,0,0,0,145000,32000,113000,113000
20200312,06505P,康控國票99售02,2.34,4.49,2.30,4.49,+2.31,105.96,202000,19,497190,0,0,0,0,0,0,80000,121000,-41000,-41000
20200312,06506P,台郡國票99售02,0.77,0.81,0.77,0.81,+0.18,28.57,127000,7,100770,0,0,0,0,0,0,40000,87000,-47000,-47000
20200312,06507P,台表科國票99售01,1.05,1.41,1.02,1.41,+0.38,36.89,174000,8,214920,0,0,0,0,0,0,159000,10000,149000,149000
20200312,06508P,台灣50統一98售01,1.50,2.14,1.50,2.00,+0.58,40.85,318000,37,579750,0,0,0,0,0,0,221000,56000,165000,165000
20200312,06509P,鴻海群益98售03,3.04,3.50,3.04,3.50,+0.82,30.6,272000,6,852910,0,0,0,0,0,0,50000,222000,-172000,-172000
20200312,06510P,燿華永豐98售03,1.87,1.99,1.87,1.98,+0.30,17.86,30000,3,58400,0,0,0,0,0,0,20000,30000,-10000,-10000
20200312,06511P,元油2X中信9B售01,,,,,0.00,0.00,0,0,0,0,0,0,0,0,0,0,0,0,0
20200312,06512P,元油2X凱基9B售01,,,,,0.00,0.00,0,0,0,0,0,0,0,0,0,0,0,0,0
20200312,06513P,鴻海凱基98售10,1.62,1.92,1.62,1.92,+0.43,28.86,803000,17,1507220,0,0,0,0,0,0,123000,798000,-675000,-675000
20200312,06514P,國巨凱基98售05,2.30,2.36,2.30,2.35,0.00,0.00,4000,4,9330,0,0,0,0,0,0,0,4000,-4000,-4000
20200312,06515P,國巨凱基98售06,,,,,0.00,0.00,0,0,0,0,0,0,0,0,0,0,0,0,0
20200312,06516P,國巨凱基98售08,1.65,1.97,1.65,1.89,+0.24,14.55,564000,16,1030960,0,0,0,0,0,0,528000,36000,492000,492000
20200312,06517P,國巨凱基98售09,2.12,2.36,2.12,2.36,+0.30,14.56,25000,4,53960,0,0,0,0,0,0,15000,10000,5000,5000
20200312,06518P,奇力新兆豐99售01,,,,,0.00,0.00,0,0,0,0,0,0,0,0,0,0,0,0,0
20200312,06519P,元油2X元大98售03,6.05,6.05,6.00,6.00,+1.07,21.7,80000,4,481000,0,0,0,0,0,0,80000,50000,30000,30000
20200312,06520P,元油2X元大98售04,5.10,5.10,5.10,5.10,+0.81,18.88,50000,2,255000,0,0,0,0,0,0,50000,30000,20000,20000
20200312,06521P,矽力元大98售01,2.90,2.94,2.66,2.81,+0.25,9.77,726000,56,2044200,0,0,0,0,0,0,249000,447000,-198000,-198000
20200312,06522P,元油2X群益9B售03,,,,,0.00,0.00,0,0,0,0,0,0,0,0,0,0,0,0,0
20200312,06523P,台積電麥證98售02,1.81,1.82,1.81,1.82,+0.24,15.19,15000,2,27200,15000,0,15000,0,0,0,15000,0,15000,15000
20200312,06524P,臺股指麥證98售02,,,,,0.00,0.00,0,0,0,0,0,0,0,0,0,0,0,0,0
20200312,06525P,上証2X國泰99售01,1.31,1.53,1.31,1.48,+0.20,15.62,143000,10,201890,0,0,0,0,0,0,70000,73000,-3000,-3000
20200312,06526P,元油2X永豐98售03,,,,,0.00,0.00,0,0,0,0,0,0,0,0,0,0,0,0,0
20200312,06527P,T50正2富邦9C售01,2.65,2.65,2.65,2.65,+0.37,16.23,2000,1,5300,0,0,0,0,0,0,2000,0,2000,2000
20200312,06528P,台積電富邦99售03,0.95,1.11,0.94,1.06,+0.22,26.19,144000,19,145120,0,0,0,0,0,0,81000,79000,2000,2000
20200312,06529P,貿聯富邦99售03,1.20,1.28,1.19,1.28,+0.15,13.27,320000,4,394800,0,0,0,0,0,0,120000,200000,-80000,-80000
20200312,06530P,元油2X元富98售13,,,,,0.00,0.00,0,0,0,0,0,0,0,0,0,0,0,0,0
20200312,06531P,元油2X元富98售14,5.85,5.85,5.85,5.85,0.00,0.00,80000,4,468000,0,0,0,0,0,0,80000,80000,0,0
20200312,06532P,友達元富98售04,2.04,2.11,2.04,2.11,+0.25,13.44,48000,3,100280,0,0,0,0,0,0,30000,18000,12000,12000
20200312,06533P,上証2X中信9B售01,0.92,0.97,0.91,0.97,+0.08,8.99,30000,5,27650,0,0,0,0,0,0,0,30000,-30000,-30000
20200312,06534P,聯發科群益98售04,2.12,2.81,2.12,2.81,+0.89,46.35,82000,5,180670,0,0,0,0,0,0,1000,81000,-80000,-80000
20200312,06535P,可成群益99售02,3.33,3.88,3.31,3.85,+0.86,28.76,161000,11,575710,0,0,0,0,0,0,124000,37000,87000,87000
20200312,06536P,臺股指群益98售04,6.15,8.00,6.15,7.55,+2.30,43.81,60000,8,449000,0,0,0,0,0,0,1000,59000,-58000,-58000
20200312,06537P,華通凱基98售04,1.60,2.04,1.57,2.04,+0.60,41.67,71000,5,114490,0,0,0,0,0,0,60000,11000,49000,49000
20200312,06538P,國巨凱基98售11,2.16,2.76,2.16,2.74,+0.65,31.1,325000,33,869840,0,0,0,0,0,0,259000,66000,193000,193000
20200312,06539P,聯發科凱基98售12,2.38,2.84,2.38,2.82,+0.64,29.36,228000,26,600870,0,0,0,0,0,0,148000,187000,-39000,-39000
20200312,06540P,聯發科凱基98售13,1.58,2.22,1.51,2.19,+0.89,68.46,104000,17,189830,0,0,0,0,0,0,36000,68000,-32000,-32000
20200312,06541P,元油2X國票9A售02,4.60,5.30,4.44,4.46,+0.83,22.87,71000,5,331960,0,0,0,0,0,0,11000,0,11000,11000
20200312,06542P,台光電國票98售05,2.71,3.00,2.65,3.00,+0.64,27.12,93000,9,263180,0,0,0,0,0,0,43000,50000,-7000,-7000
20200312,06543P,鴻海元大98售08,3.45,3.83,3.45,3.83,+0.86,28.96,25000,5,93680,0,0,0,0,0,0,17000,23000,-6000,-6000
20200312,06544P,鴻海元大98售09,4.69,4.69,4.69,4.69,+0.68,16.96,45000,1,211050,0,0,0,0,0,0,45000,45000,0,0
20200312,06545P,致茂元大98售01,3.51,3.83,3.51,3.83,+0.61,18.94,73000,5,274570,0,0,0,0,0,0,7000,66000,-59000,-59000
20200312,06546P,聯發科元大98售05,4.49,4.72,4.49,4.54,+0.70,18.23,64000,5,293910,0,0,0,0,0,0,29000,35000,-6000,-6000
20200312,06547P,大立光元大98售09,,,,,0.00,0.00,0,0,0,0,0,0,0,0,0,0,0,0,0
20200312,06548P,大立光元大98售10,,,,,0.00,0.00,0,0,0,0,0,0,0,0,0,0,0,0,0
20200312,06549P,大立光元大98售11,3.53,3.53,3.53,3.53,+0.75,26.98,4000,1,14120,0,0,0,0,0,0,4000,0,4000,4000
20200312,06550P,健策元大99售01,1.45,1.63,1.44,1.63,+0.27,19.85,505000,25,763530,0,0,0,0,0,0,229000,495000,-266000,-266000
20200312,06551P,貿聯元大98售05,2.94,3.16,2.91,3.16,+0.30,10.49,114000,7,352460,0,0,0,0,0,0,28000,86000,-58000,-58000
20200312,06552P,茂林元大99售02,2.19,2.56,2.18,2.56,+0.37,16.89,571000,34,1356800,0,0,0,0,0,0,299000,262000,37000,37000
20200312,06553P,訊芯元大98售05,2.50,2.58,2.48,2.58,+0.32,14.16,166000,13,416070,0,5000,-5000,0,0,0,117000,132000,-15000,-20000
20200312,06554P,臺股指元大99售06,5.00,5.85,5.00,5.85,+1.46,33.26,8000,4,43750,0,0,0,0,0,0,5000,3000,2000,2000
20200312,06555P,臺股指元大99售07,6.30,7.00,6.30,6.65,+1.20,22.02,22000,4,149450,0,0,0,0,0,0,12000,10000,2000,2000
20200312,06556P,臺股指元大99售08,7.70,8.45,7.70,8.40,0.00,0.00,27000,5,217350,0,0,0,0,0,0,12000,15000,-3000,-3000
20200312,06557P,台積電兆豐98售02,2.04,2.54,2.02,2.25,+0.61,37.2,2053000,32,4303880,0,0,0,0,0,0,769000,1284000,-515000,-515000
20200312,06558P,旺宏元富98售02,5.65,6.30,5.60,6.30,+1.00,18.87,8000,3,45700,0,0,0,0,0,0,5000,3000,2000,2000
20200312,06559P,玉晶光元富98售02,3.24,3.50,3.22,3.50,+0.38,12.18,92000,6,300420,0,0,0,0,0,0,26000,66000,-40000,-40000
20200312,06560P,台積電統一98售07,2.16,2.16,2.15,2.15,0.00,0.00,80000,3,172760,0,0,0,0,0,0,0,80000,-80000,-80000
20200312,06561P,台灣50國泰9A售01,5.70,6.45,5.65,6.45,+1.46,29.26,54000,8,318700,0,0,0,0,0,0,52000,42000,10000,10000
20200312,06562P,台積電國泰99售02,4.26,4.32,4.26,4.32,0.00,0.00,20000,2,85800,0,0,0,0,0,0,0,20000,-20000,-20000
20200312,06563P,元油2X富邦02售02,5.15,5.15,5.15,5.15,0.00,0.00,90000,1,463500,0,0,0,0,0,0,90000,0,90000,90000
20200312,06564P,國巨富邦9A售04,0.90,1.07,0.86,1.03,+0.18,21.18,183000,22,173680,0,0,0,0,0,0,39000,124000,-85000,-85000
20200312,06565P,元油2X永豐9A售01,5.75,5.75,5.75,5.75,0.00,0.00,11000,2,63250,0,0,0,0,0,0,11000,11000,0,0
20200312,06566P,華通永豐98售03,1.52,1.78,1.51,1.78,+0.36,25.35,80000,8,130600,0,0,0,0,0,0,20000,60000,-40000,-40000
20200312,06567P,鴻海永豐98售02,1.72,1.80,1.72,1.80,0.00,0.00,30000,3,52400,0,0,0,0,0,0,0,30000,-30000,-30000
20200312,06568P,國巨永豐98售05,1.56,2.01,1.56,2.01,+0.66,48.89,93000,10,165550,0,0,0,0,0,0,20000,73000,-53000,-53000
20200312,06569P,可成永豐98售01,1.37,1.65,1.37,1.64,+0.41,33.33,44000,6,66430,0,0,0,0,0,0,18000,26000,-8000,-8000
20200312,06570P,大立光永豐98售01,1.94,2.01,1.94,2.01,0.00,0.00,20000,2,39500,0,0,0,0,0,0,20000,0,20000,20000
20200312,06571P,欣興永豐98售03,1.45,1.52,1.45,1.52,+0.58,61.7,14000,4,20550,0,0,0,0,0,0,4000,10000,-6000,-6000
20200312,06572P,台積電永昌99售01,2.55,2.89,2.41,2.66,+0.43,19.28,3148000,56,8232580,0,0,0,0,0,0,2750000,1093000,1657000,1657000
20200312,06573P,台積電永昌99售02,1.30,1.71,1.30,1.45,+0.26,21.85,4215000,49,6064520,0,0,0,0,0,0,3908000,1558000,2350000,2350000
20200312,06574P,大立光永昌99售01,6.10,6.15,6.10,6.15,+0.95,18.27,31000,3,190150,0,0,0,0,0,0,21000,10000,11000,11000
20200312,06575P,大立光永昌99售02,6.20,6.90,6.20,6.90,0.00,0.00,16000,2,103400,0,0,0,0,0,0,0,16000,-16000,-16000
20200312,06576P,台光電群益98售03,1.90,2.20,1.90,2.20,+0.46,26.44,117000,13,240380,0,0,0,0,0,0,58000,59000,-1000,-1000
20200312,06577P,聯發科日盛9A售02,2.77,3.31,2.77,3.28,+0.81,32.79,233000,14,701450,0,0,0,0,0,0,172000,51000,121000,121000
20200312,06578P,華新科國票98售02,4.39,6.10,4.39,5.85,+2.38,68.59,58000,14,295080,0,0,0,0,0,0,15000,43000,-28000,-28000
20200312,06579P,臺股指麥證98售03,2.83,4.22,2.83,4.22,+1.89,81.12,87000,8,282480,43000,44000,-1000,0,0,0,43000,44000,-1000,-1000
20200312,06580P,元油2X凱基9A售06,3.25,3.71,3.25,3.45,+0.05,1.47,15000,4,49850,0,0,0,0,0,0,12000,0,12000,12000
20200312,06581P,南亞科凱基98售04,2.69,3.17,2.68,3.09,+0.74,31.49,102000,18,302890,0,0,0,0,0,0,48000,54000,-6000,-6000
20200312,06582P,可成凱基98售06,2.21,2.63,2.21,2.63,+0.74,39.15,32000,3,77520,0,0,0,0,0,0,22000,10000,12000,12000
20200312,06583P,可成凱基98售07,2.14,2.47,2.14,2.47,0.00,0.00,20000,2,46100,0,0,0,0,0,0,0,20000,-20000,-20000
20200312,06584P,欣興凱基98售03,1.38,1.58,1.38,1.58,+0.53,50.48,29000,4,40990,0,0,0,0,0,0,29000,18000,11000,11000
20200312,06585P,鴻海元大99售04,3.93,3.93,3.93,3.93,0.00,0.00,14000,1,55020,0,0,0,0,0,0,14000,14000,0,0
20200312,06586P,鴻海元大9C售01,3.41,3.41,3.41,3.41,+0.30,9.65,25000,1,85250,0,0,0,0,0,0,25000,0,25000,25000
20200312,06587P,國巨元大98售13,4.17,4.72,4.14,4.72,+0.66,16.26,335000,15,1474150,0,0,0,0,0,0,335000,235000,100000,100000
20200312,06588P,台積電元大98售11,5.90,6.20,5.90,6.10,+1.11,22.24,44000,5,263100,0,0,0,0,0,0,18000,41000,-23000,-23000
20200312,06589P,台積電元大98售12,5.40,5.95,5.35,5.55,+0.65,13.27,100000,8,555500,0,0,0,0,0,0,70000,45000,25000,25000
20200312,06590P,大立光元大98售13,,,,,0.00,0.00,0,0,0,0,0,0,0,0,0,0,0,0,0
20200312,06591P,大立光元大98售14,,,,,0.00,0.00,0,0,0,0,0,0,0,0,0,0,0,0,0
20200312,06592P,欣興元大98售04,3.71,3.71,3.71,3.71,+0.74,24.92,10000,1,37100,0,0,0,0,0,0,10000,0,10000,10000
20200312,06593P,欣興元大98售05,3.03,3.24,3.03,3.24,+0.75,30.12,27000,6,84630,0,0,0,0,0,0,20000,7000,13000,13000
20200312,06594P,立積元大98售01,1.77,2.05,1.74,2.01,+0.32,18.93,729000,41,1393520,0,0,0,0,0,0,555000,311000,244000,244000
20200312,06595P,祥碩元大98售03,2.52,2.83,2.50,2.70,+0.18,7.14,283000,27,733750,0,6000,-6000,0,0,0,70000,227000,-157000,-163000
20200312,06596P,元油2X富邦02售03,3.63,3.66,3.56,3.56,+0.63,21.5,30000,3,108500,0,0,0,0,0,0,10000,0,10000,10000
20200312,06597P,國巨富邦9A售05,1.43,1.59,1.43,1.59,+0.23,16.91,108000,11,167200,0,0,0,0,0,0,72000,36000,36000,36000
20200312,06598P,奇力新永豐98售02,1.86,2.06,1.86,2.06,+0.28,15.73,54000,3,101040,0,0,0,0,0,0,54000,0,54000,54000
20200312,06599P,宏達電永豐98售02,1.32,1.52,1.32,1.52,+0.21,16.03,53000,8,76020,0,0,0,0,0,0,21000,32000,-11000,-11000
20200312,06600P,貿聯永豐98售01,1.64,1.80,1.64,1.79,+0.34,23.45,22000,5,38090,0,0,0,0,0,0,1000,21000,-20000,-20000
20200312,06601P,臺股指永豐98售04,3.23,3.36,3.23,3.36,+0.64,23.53,15000,2,49750,0,0,0,0,0,0,5000,10000,-5000,-5000
20200312,06602P,國巨統一99售02,1.74,2.05,1.74,2.05,+0.31,17.82,43000,9,78310,0,0,0,0,0,0,20000,23000,-3000,-3000
20200312,06603P,立積統一99售01,1.73,1.90,1.73,1.90,+0.34,21.79,209000,4,372660,0,0,0,0,0,0,209000,0,209000,209000
20200312,06604P,聯發科元富02售02,1.83,2.07,1.83,2.07,+0.32,18.29,72000,11,140660,0,0,0,0,0,0,20000,52000,-32000,-32000
20200312,06605P,玉晶光元富98售03,3.12,3.38,3.09,3.38,+0.40,13.42,67000,6,212200,0,0,0,0,0,0,47000,20000,27000,27000
20200312,06606P,訊芯元富98售02,2.20,2.40,2.17,2.40,+0.37,18.23,133000,18,297870,0,0,0,0,0,0,60000,73000,-13000,-13000
20200312,06607P,友達台新98售02,2.20,2.43,2.20,2.43,+0.50,25.91,14000,3,31260,0,0,0,0,0,0,12000,2000,10000,10000
20200312,06608P,立積群益99售02,1.09,1.25,1.07,1.25,+0.23,22.55,135000,9,154900,0,0,0,0,0,0,45000,90000,-45000,-45000
20200312,06609P,元油2X凱基9B售06,6.60,7.60,3.90,3.90,+0.21,5.69,163000,6,650700,0,0,0,0,0,0,156000,89000,67000,67000
20200312,06610P,台積電凱基9A售03,3.02,3.62,3.02,3.62,+1.10,43.65,82000,3,292040,0,0,0,0,0,0,0,82000,-82000,-82000
20200312,06611P,祥碩國票98售01,2.82,3.23,2.82,3.08,+0.17,5.84,784000,12,2407460,0,0,0,0,0,0,731000,53000,678000,678000
20200312,06612P,元油2X富邦9B售03,4.12,4.12,4.12,4.12,0.00,0.00,1000,1,4120,0,0,0,0,0,0,1000,0,1000,1000
20200312,06613P,華新科富邦9A售03,1.26,1.51,1.26,1.49,+0.24,19.2,434000,31,584170,0,0,0,0,0,0,410000,124000,286000,286000
20200312,06614P,祥碩永豐98售03,1.28,1.47,1.27,1.37,+0.18,15.13,331000,18,437580,0,0,0,0,0,0,207000,124000,83000,83000
20200312,06615P,鴻海元大9C售02,3.07,3.37,3.07,3.27,+0.62,23.4,53000,9,170930,0,0,0,0,0,0,0,53000,-53000,-53000
20200312,06616P,國巨元大98售15,3.76,4.40,3.76,4.40,+0.80,22.22,275000,16,1114300,0,0,0,0,0,0,275000,275000,0,0
20200312,06617P,智邦元大98售03,1.41,1.68,1.41,1.59,+0.18,12.77,1016000,40,1563990,10000,0,10000,0,0,0,333000,706000,-373000,-363000
20200312,06618P,智邦元大98售04,1.24,1.50,1.23,1.40,+0.15,12.0,969000,19,1291110,0,8000,-8000,0,0,0,331000,648000,-317000,-325000
20200312,06619P,聯發科元大98售06,3.43,4.42,3.43,4.42,+1.55,54.01,221000,17,927270,0,0,0,0,0,0,147000,159000,-12000,-12000
20200312,06620P,聯發科元大98售07,3.89,4.57,3.89,4.46,+1.51,51.19,146000,7,628260,0,0,0,0,0,0,115000,121000,-6000,-6000
20200312,06621P,欣興元大98售06,3.73,3.73,3.73,3.73,+0.53,16.56,7000,1,26110,0,0,0,0,0,0,7000,0,7000,7000
20200312,06622P,牧德元大98售01,1.48,1.66,1.48,1.66,+0.23,16.08,65000,6,102520,0,0,0,0,0,0,40000,25000,15000,15000
20200312,06623P,立積元大98售04,2.23,2.60,2.20,2.60,+0.55,26.83,67000,6,150480,0,0,0,0,0,0,64000,3000,61000,61000
20200312,06624P,訊芯元大98售06,1.89,1.94,1.87,1.94,+0.24,14.12,139000,4,267430,0,0,0,0,0,0,39000,100000,-61000,-61000
20200312,06625P,華新科統一98售03,,,,,0.00,0.00,0,0,0,0,0,0,0,0,0,0,0,0,0
20200312,06626P,大立光統一9A售01,,,,,0.00,0.00,0,0,0,0,0,0,0,0,0,0,0,0,0
20200312,06627P,華新科元富99售01,2.24,2.50,2.24,2.43,+0.57,30.65,98000,12,229650,0,0,0,0,0,0,10000,88000,-78000,-78000
20200312,06628P,訊芯元富98售03,1.39,1.50,1.37,1.50,+0.20,15.38,96000,13,136100,0,0,0,0,0,0,56000,40000,16000,16000
20200312,06629P,台灣50第一98售01,2.52,2.65,2.44,2.44,0.00,0.00,100000,11,252240,0,0,0,0,0,0,0,100000,-100000,-100000
20200312,06630P,國巨群益98售08,4.30,5.20,4.30,5.20,+0.99,23.52,51000,6,226010,0,0,0,0,0,0,41000,23000,18000,18000
20200312,06631P,玉晶光群益9A售03,2.20,2.49,2.20,2.49,+0.57,29.69,13000,2,29470,0,0,0,0,0,0,10000,3000,7000,7000
20200312,06632P,創意群益98售03,3.22,3.98,3.22,3.98,+1.10,38.19,69000,6,231400,0,0,0,0,0,0,47000,22000,25000,25000
20200312,06633P,國巨國票99售01,3.64,3.82,3.64,3.82,+0.56,17.18,3000,3,11230,0,0,0,0,0,0,2000,1000,1000,1000
20200312,06634P,欣興國票98售02,3.23,3.35,3.21,3.35,+0.84,33.47,47000,4,152550,0,0,0,0,0,0,20000,27000,-7000,-7000
20200312,06635P,聯發科凱基98售15,2.22,2.75,2.22,2.72,+0.87,47.03,289000,17,724380,0,0,0,0,0,0,150000,257000,-107000,-107000
20200312,06636P,可成凱基98售08,2.04,2.50,2.00,2.50,+0.82,48.81,56000,6,121040,0,0,0,0,0,0,13000,43000,-30000,-30000
20200312,06637P,大立光凱基98售15,3.17,3.68,3.13,3.68,+1.46,65.77,76000,6,266270,0,0,0,0,0,0,56000,61000,-5000,-5000
20200312,06638P,鴻海統一99售02,1.47,1.70,1.47,1.70,0.00,0.00,46000,7,76130,0,0,0,0,0,0,22000,41000,-19000,-19000
20200312,06639P,訊芯元富98售04,1.45,1.54,1.43,1.50,+0.20,15.38,76000,8,111800,0,0,0,0,0,0,26000,50000,-24000,-24000
20200312,06640P,國巨兆豐99售02,1.25,1.57,1.25,1.57,+0.41,35.34,138000,17,186600,0,0,0,0,0,0,71000,67000,4000,4000
20200312,06641P,智邦兆豐99售01,1.02,1.16,1.02,1.13,+0.10,9.71,203000,8,227820,0,0,0,0,0,0,51000,152000,-101000,-101000
20200312,06642P,可成兆豐98售01,1.19,1.48,1.18,1.45,+0.40,38.1,293000,18,391040,0,0,0,0,0,0,175000,118000,57000,57000
20200312,06643P,大立光兆豐98售01,1.37,1.57,1.37,1.57,+0.46,41.44,147000,5,207390,0,0,0,0,0,0,90000,57000,33000,33000
20200312,06644P,亞德客元大98售03,3.03,3.51,3.03,3.51,0.00,0.00,89000,6,305390,0,0,0,0,0,0,86000,23000,63000,63000
20200312,06645P,上銀元大98售05,2.41,2.79,2.41,2.79,+0.48,20.78,94000,11,255650,0,0,0,0,0,0,57000,37000,20000,20000
20200312,06646P,國巨元大98售16,3.01,3.45,3.01,3.45,+0.50,16.95,458000,24,1463570,0,0,0,0,0,0,416000,407000,9000,9000
20200312,06647P,台積電元大98售13,5.10,5.95,5.10,5.25,+0.70,15.38,318000,14,1709350,0,0,0,0,0,0,303000,32000,271000,271000
20200312,06648P,華邦電元大98售03,1.66,2.03,1.64,2.03,+0.48,30.97,489000,14,860130,0,0,0,0,0,0,160000,329000,-169000,-169000
20200312,06649P,聯發科元大98售08,3.25,3.97,3.25,3.88,+0.81,26.38,470000,18,1719210,0,0,0,0,0,0,419000,223000,196000,196000
20200312,06650P,聯發科元大98售09,2.10,2.62,2.10,2.58,+0.66,34.38,111000,7,269660,0,0,0,0,0,0,100000,81000,19000,19000
20200312,06651P,華新科元大99售09,1.89,2.19,1.89,2.19,+0.35,19.02,138000,18,284840,0,0,0,0,0,0,114000,79000,35000,35000
20200312,06652P,長榮航元大98售01,1.16,1.28,1.16,1.25,+0.13,11.61,1795000,63,2205600,0,0,0,0,0,0,930000,497000,433000,433000
20200312,06653P,美食元大98售02,1.90,2.07,1.90,2.03,+0.15,7.98,519000,29,1046050,0,0,0,0,0,0,324000,190000,134000,134000
20200312,06654P,欣興元大98售08,3.48,3.48,3.48,3.48,+1.12,47.46,2000,1,6960,0,0,0,0,0,0,0,2000,-2000,-2000
20200312,06655P,TPK元大98售02,1.62,1.70,1.62,1.67,0.00,0.00,217000,4,361040,0,0,0,0,0,0,0,217000,-217000,-217000
20200312,06656P,GIS元大98售02,2.33,2.77,2.33,2.77,+0.54,24.22,89000,8,223390,0,0,0,0,0,0,34000,55000,-21000,-21000
20200312,06657P,寶成元大98售01,2.92,3.03,2.85,2.92,0.00,0.00,707000,31,2095970,0,0,0,0,0,0,0,707000,-707000,-707000
20200312,06658P,台灣50富邦9C售01,5.75,5.90,5.65,5.65,+1.07,23.36,717000,10,4198200,0,0,0,0,0,0,487000,251000,236000,236000
20200312,06659P,T50正2富邦9A售01,1.62,1.62,1.62,1.62,+0.18,12.5,2000,2,3240,0,0,0,0,0,0,2000,0,2000,2000
20200312,06660P,大立光富邦9B售03,1.49,2.06,1.49,2.00,+0.64,47.06,175000,9,331540,0,0,0,0,0,0,13000,162000,-149000,-149000
20200312,06661P,玉晶光永豐98售05,1.28,1.53,1.28,1.53,+0.31,25.41,175000,5,239400,0,0,0,0,0,0,175000,0,175000,175000
20200312,06662P,玉晶光中信9A售01,0.67,0.71,0.67,0.71,+0.08,12.7,96000,4,67230,0,0,0,0,0,0,61000,35000,26000,26000
20200312,06663P,鴻海兆豐98售03,1.85,2.14,1.84,2.14,+0.48,28.92,209000,5,429290,0,0,0,0,0,0,136000,198000,-62000,-62000
20200312,06664P,聯發科兆豐98售02,1.63,1.80,1.63,1.79,+0.29,19.33,77000,4,135600,0,0,0,0,0,0,10000,67000,-57000,-57000
20200312,06665P,欣興兆豐99售01,1.19,1.36,1.19,1.36,+0.28,25.93,274000,21,335180,0,0,0,0,0,0,230000,44000,186000,186000
20200312,06666P,台積電日盛9A售02,4.11,4.90,4.11,4.90,+1.40,40.0,157000,7,680890,0,0,0,0,0,0,3000,154000,-151000,-151000
20200312,06667P,鴻海凱基98售11,1.90,2.15,1.90,2.15,+0.47,27.98,82000,3,161100,0,0,0,0,0,0,72000,22000,50000,50000
20200312,06668P,祥碩凱基98售02,1.51,1.71,1.43,1.61,+0.14,9.52,957000,33,1468230,0,0,0,0,0,0,345000,612000,-267000,-267000
20200312,06669P,緯穎凱基98售05,1.16,1.40,1.16,1.40,+0.33,30.84,691000,19,882100,0,0,0,0,0,0,65000,626000,-561000,-561000
20200312,06670P,鴻海群益98售06,3.62,3.62,3.60,3.60,+0.43,13.56,92000,2,331840,0,0,0,0,0,0,92000,0,92000,92000
20200312,06671P,台積電群益98售04,4.57,4.72,4.55,4.72,+0.81,20.72,130000,3,608900,0,0,0,0,0,0,120000,110000,10000,10000
20200312,06672P,聯發科群益98售05,2.12,2.56,2.12,2.56,+0.71,38.38,162000,8,368570,0,0,0,0,0,0,133000,109000,24000,24000
20200312,06673P,大立光群益98售01,2.74,2.86,2.74,2.81,+0.63,28.9,89000,6,245460,0,0,0,0,0,0,54000,37000,17000,17000
20200312,06674P,祥碩群益98售02,1.72,1.95,1.65,1.85,+0.12,6.94,1225000,158,2174640,0,0,0,0,0,0,313000,814000,-501000,-501000
20200312,06675P,國巨國票99售02,4.79,5.45,4.75,5.45,+0.93,20.58,17000,4,84950,0,0,0,0,0,0,12000,5000,7000,7000
20200312,06676P,華新科國票98售03,4.34,4.34,4.34,4.34,+0.34,8.5,50000,1,217000,0,0,0,0,0,0,50000,0,50000,50000
20200312,06677P,牧德國票98售02,3.66,4.42,3.65,4.42,+1.12,33.94,76000,8,297200,0,0,0,0,0,0,20000,56000,-36000,-36000
20200312,06678P,大立光統一99售01,,,,,0.00,0.00,0,0,0,0,0,0,0,0,0,0,0,0,0
20200312,06679P,旺宏元大98售09,2.39,2.67,2.33,2.67,+0.41,18.14,127000,6,316780,0,0,0,0,0,0,127000,115000,12000,12000
20200312,06680P,智邦元大98售06,2.19,2.45,2.19,2.35,+0.19,8.8,363000,23,856790,0,0,0,0,0,0,250000,305000,-55000,-55000
20200312,06681P,致茂元大98售02,3.95,4.31,3.95,4.31,+0.72,20.06,41000,4,174000,0,0,0,0,0,0,6000,35000,-29000,-29000
20200312,06682P,玉晶光元大99售08,3.77,4.18,3.77,4.18,+0.65,18.41,173000,4,701130,0,0,0,0,0,0,157000,16000,141000,141000
20200312,06683P,訊芯元大98售07,1.87,1.98,1.87,1.98,+0.27,15.79,120000,6,230220,0,0,0,0,0,0,10000,118000,-108000,-108000
20200312,06684P,緯穎元大98售06,1.64,2.00,1.64,1.87,+0.24,14.72,1686000,19,3136590,0,0,0,0,0,0,856000,655000,201000,201000
20200312,06685P,鴻海國泰9A售01,1.90,2.34,1.90,2.27,+0.52,29.71,195000,12,429420,0,0,0,0,0,0,160000,135000,25000,25000
20200312,06686P,麗豐永豐98售02,1.73,1.91,1.73,1.85,+0.18,10.78,227000,19,409590,0,0,0,0,0,0,175000,48000,127000,127000
20200312,06687P,A50正2中信9A售01,0.93,0.93,0.93,0.93,+0.08,9.41,3000,1,2790,0,0,0,0,0,0,0,3000,-3000,-3000
20200312,06688P,鴻海中信02售01,1.50,1.62,1.50,1.62,+0.31,23.66,93000,5,142900,0,0,0,0,0,0,50000,43000,7000,7000
20200312,06689P,鴻海中信9C售02,1.27,1.28,1.27,1.28,+0.24,23.08,33000,3,42010,0,0,0,0,0,0,23000,10000,13000,13000
20200312,06690P,玉晶光群益9A售05,4.48,4.84,4.45,4.84,+0.53,12.3,23000,5,104080,0,0,0,0,0,0,13000,10000,3000,3000
20200312,06691P,臺股指群益9C售05,,,,,0.00,0.00,0,0,0,0,0,0,0,0,0,0,0,0,0
20200312,06692P,瑞昱凱基98售03,1.69,2.02,1.69,1.98,+0.48,32.0,73000,6,138870,0,0,0,0,0,0,0,73000,-73000,-73000
20200312,06693P,臺股指凱基98售01,,,,,0.00,0.00,0,0,0,0,0,0,0,0,0,0,0,0,0
20200312,06694P,臺股指凱基99售13,4.81,6.60,4.79,6.50,+2.02,45.09,1239000,27,7551350,0,0,0,0,0,0,1002000,937000,65000,65000
20200312,06695P,群創兆豐98售04,2.44,2.75,2.44,2.75,+0.55,25.0,131000,11,346520,0,0,0,0,0,0,58000,73000,-15000,-15000
20200312,06696P,台灣50國票99售01,6.20,7.15,6.20,6.65,+1.25,23.15,10000,7,66700,0,0,0,0,0,0,8000,2000,6000,6000
20200312,06697P,台積電國票99售05,4.90,5.80,4.87,5.10,+0.78,18.06,101000,10,512580,0,0,0,0,0,0,87000,28000,59000,59000
20200312,06698P,玉晶光國票99售05,3.42,3.83,3.42,3.79,+0.74,24.26,147000,5,542540,0,0,0,0,0,0,140000,7000,133000,133000
20200312,06699P,台積電統一98售11,2.19,2.26,2.19,2.26,+0.32,16.49,15000,2,33550,0,0,0,0,0,0,15000,0,15000,15000
20200312,06700P,臺股指統一99售05,,,,,0.00,0.00,0,0,0,0,0,0,0,0,0,0,0,0,0
20200312,06701P,臺股指統一99售06,,,,,0.00,0.00,0,0,0,0,0,0,0,0,0,0,0,0,0
20200312,06702P,智邦元富98售01,1.94,2.15,1.94,2.15,+0.33,18.13,219000,9,442790,0,0,0,0,0,0,43000,199000,-156000,-156000
20200312,06703P,新日興元富98售02,2.17,2.50,2.17,2.50,+0.39,18.48,244000,23,556860,0,0,0,0,0,0,82000,162000,-80000,-80000
20200312,06704P,玉晶光元富98售05,3.29,3.37,3.27,3.35,+0.19,6.01,32000,4,106260,0,0,0,0,0,0,32000,0,32000,32000
20200312,06705P,臻鼎元富98售03,3.43,3.94,3.43,3.94,+0.91,30.03,125000,8,466780,0,0,0,0,0,0,66000,59000,7000,7000
20200312,06706P,智原台新98售02,1.38,1.54,1.38,1.54,0.00,0.00,77000,3,111060,0,0,0,0,0,0,30000,47000,-17000,-17000
20200312,06707P,臺股指台新99售04,8.65,12.00,8.65,12.00,+4.90,69.01,6000,3,58400,0,0,0,0,0,0,4000,0,4000,4000
20200312,06708P,臺股指台新99售05,7.30,9.75,7.30,9.75,+3.60,58.54,22000,3,211000,0,0,0,0,0,0,22000,0,22000,22000
20200312,06709P,臺股指台新99售06,,,,,0.00,0.00,0,0,0,0,0,0,0,0,0,0,0,0,0
20200312,06710P,臺股指台新99售07,,,,,0.00,0.00,0,0,0,0,0,0,0,0,0,0,0,0,0
20200312,06711P,臺股指台新99售08,14.00,15.90,13.50,15.00,+5.40,56.25,23000,8,331800,0,0,0,0,0,0,23000,5000,18000,18000
20200312,06712P,臺股指台新99售09,10.20,14.00,10.20,14.00,+5.30,60.92,13000,4,173600,0,0,0,0,0,0,12000,11000,1000,1000
20200312,06713P,臺股指富邦99售04,,,,,0.00,0.00,0,0,0,0,0,0,0,0,0,0,0,0,0
20200312,06714P,台積電元大98售15,6.05,7.00,5.95,7.00,+1.95,38.61,77000,7,484600,0,0,0,0,0,0,72000,20000,52000,52000
20200312,06715P,台積電元大99售04,3.23,3.87,3.23,3.49,+0.30,9.4,1243000,89,4313790,0,5000,-5000,0,0,0,603000,822000,-219000,-224000
20200312,06716P,台積電元大9A售02,5.90,6.35,5.85,6.10,+1.05,20.79,143000,10,874850,0,0,0,0,0,0,104000,52000,52000,52000
20200312,06717P,可成元大98售09,4.48,4.59,4.48,4.59,+0.72,18.6,11000,2,49830,0,0,0,0,0,0,6000,5000,1000,1000
20200312,06718P,聯詠元大98售01,5.25,5.75,5.25,5.65,+0.84,17.46,166000,11,918800,0,0,0,0,0,0,40000,146000,-106000,-106000
20200312,06719P,台灣50群益9A售01,8.45,10.10,8.45,9.90,+2.15,27.74,1242000,102,11886000,0,0,0,0,0,0,1198000,1123000,75000,75000
20200312,06720P,智邦亞東99售01,1.53,1.53,1.53,1.53,0.00,0.00,5000,1,7650,0,0,0,0,0,0,5000,0,5000,5000
20200312,06721P,臺股指中信9A售03,1.78,2.16,1.78,2.06,+0.36,21.18,351000,25,677500,0,0,0,0,0,0,224000,127000,97000,97000
20200312,06722P,臺股指中信9A售04,3.80,4.23,3.80,4.16,+1.08,35.06,31000,4,125760,0,0,0,0,0,0,10000,31000,-21000,-21000
20200312,06723P,台灣50麥證99售01,5.90,5.90,5.90,5.90,+0.50,9.26,4000,1,23600,4000,0,4000,0,0,0,4000,0,4000,4000
20200312,06724P,台灣50國票98售01,9.10,10.70,9.10,10.00,+2.60,35.14,171000,11,1699000,0,0,0,0,0,0,91000,80000,11000,11000
20200312,06725P,聯電元富98售01,1.97,2.34,1.97,2.23,+0.38,20.54,207000,22,450310,0,0,0,0,0,0,35000,172000,-137000,-137000
20200312,06726P,欣興元富98售04,2.80,3.17,2.79,3.17,+0.77,32.08,73000,8,212900,0,0,0,0,0,0,63000,10000,53000,53000
20200312,06727P,台光電元大98售05,1.69,1.86,1.69,1.86,+0.33,21.57,215000,7,390490,0,0,0,0,0,0,143000,200000,-57000,-57000
20200312,06728P,全新元大98售03,2.16,2.33,2.15,2.27,+0.23,11.27,280000,7,613700,0,0,0,0,0,0,205000,75000,130000,130000
20200312,06729P,聯詠元大98售03,5.05,5.50,5.05,5.50,+0.63,12.94,151000,8,801350,0,0,0,0,0,0,42000,139000,-97000,-97000
20200312,06730P,祥碩元大98售07,3.35,3.70,3.29,3.60,+0.25,7.46,317000,33,1082520,0,0,0,0,0,0,75000,292000,-217000,-217000
20200312,06731P,聯茂元大98售05,1.96,2.25,1.96,2.25,0.00,0.00,194000,5,388850,0,0,0,0,0,0,190000,29000,161000,161000
20200312,06732P,台灣50日盛9A售01,3.72,3.72,3.72,3.72,0.00,0.00,100000,1,372000,0,0,0,0,0,0,100000,100000,0,0
20200312,06733P,鴻海凱基99售02,2.09,2.42,2.09,2.42,+0.56,30.11,95000,2,228250,0,0,0,0,0,0,95000,95000,0,0
20200312,06734P,智邦凱基98售05,1.58,1.89,1.58,1.82,+0.26,16.67,154000,21,271120,0,0,0,0,0,0,52000,154000,-102000,-102000
20200312,06735P,奇力新凱基98售07,3.12,3.55,3.12,3.55,+0.59,19.93,11000,2,34750,0,0,0,0,0,0,11000,0,11000,11000
20200312,06736P,新日興凱基98售03,1.10,1.18,1.10,1.18,+0.11,10.28,105000,5,118930,0,0,0,0,0,0,85000,20000,65000,65000
20200312,06737P,台郡凱基98售07,1.04,1.24,1.04,1.20,+0.27,29.03,537000,17,609520,0,0,0,0,0,0,523000,26000,497000,497000
20200312,06738P,瑞昱兆豐98售02,1.09,1.26,1.09,1.21,+0.25,26.04,312000,15,377930,0,0,0,0,0,0,121000,191000,-70000,-70000
20200312,06739P,聯詠兆豐98售02,1.26,1.38,1.21,1.26,+0.11,9.57,661000,21,861080,0,20000,-20000,0,0,0,120000,541000,-421000,-441000
20200312,06740P,台灣50國泰9A售02,2.56,3.17,2.56,3.09,+0.92,42.4,997000,46,2715020,0,0,0,0,0,0,976000,18000,958000,958000
20200312,06741P,台積電富邦98售04,3.27,3.84,3.27,3.49,+0.42,13.68,1113000,24,3947890,0,0,0,0,0,0,586000,947000,-361000,-361000
20200312,06742P,可成富邦99售02,2.82,3.04,2.82,3.04,0.00,0.00,12000,2,36040,0,0,0,0,0,0,0,12000,-12000,-12000
20200312,06743P,創意永豐98售03,1.92,2.05,1.92,2.05,+0.30,17.14,30000,3,59100,0,0,0,0,0,0,10000,20000,-10000,-10000
20200312,06744P,嘉聯益永豐98售03,1.77,1.95,1.77,1.95,+0.29,17.47,48000,5,90860,0,0,0,0,0,0,8000,40000,-32000,-32000
20200312,06745P,台積電群益98售05,7.35,8.60,7.35,8.60,+2.00,30.3,49000,6,364950,0,0,0,0,0,0,49000,41000,8000,8000
20200312,06746P,聯發科群益99售02,7.15,7.15,7.15,7.15,0.00,0.00,10000,1,71500,0,0,0,0,0,0,0,10000,-10000,-10000
20200312,06747P,大立光群益99售04,5.20,5.20,5.20,5.20,+0.94,22.07,34000,2,176800,0,0,0,0,0,0,34000,0,34000,34000
20200312,06748P,智邦台新98售02,1.82,2.16,1.82,2.04,+0.19,10.27,292000,22,587420,0,0,0,0,0,0,49000,243000,-194000,-194000
20200312,06749P,技嘉元富98售03,3.68,4.20,3.68,4.02,+0.41,11.36,298000,20,1179120,0,0,0,0,0,0,126000,172000,-46000,-46000
20200312,06750P,聯發科元富02售03,2.16,2.44,2.16,2.38,+0.31,14.98,97000,8,219240,0,0,0,0,0,0,65000,32000,33000,33000
20200312,06751P,旺宏凱基98售10,2.24,2.65,2.24,2.61,+0.52,24.88,78000,6,200680,0,0,0,0,0,0,77000,44000,33000,33000
20200312,06752P,訊芯凱基98售05,1.95,2.12,1.94,2.12,+0.28,15.22,149000,14,297960,0,0,0,0,0,0,94000,55000,39000,39000
20200312,06753P,智邦富邦98售03,2.01,2.31,1.99,2.27,+0.23,11.27,319000,12,683090,0,0,0,0,0,0,88000,241000,-153000,-153000
20200312,06754P,台積電永豐98售03,2.18,2.18,2.18,2.18,0.00,0.00,26000,2,56680,0,0,0,0,0,0,0,26000,-26000,-26000
20200312,06755P,大立光永豐98售03,2.21,2.21,2.21,2.21,0.00,0.00,13000,1,28730,0,0,0,0,0,0,0,13000,-13000,-13000
20200312,06756P,臺股指永豐98售05,,,,,0.00,0.00,0,0,0,0,0,0,0,0,0,0,0,0,0
20200312,06757P,台灣50元大9B售01,2.46,2.98,2.40,2.84,+0.55,24.02,683000,113,1833860,0,0,0,0,0,0,134000,411000,-277000,-277000
20200312,06758P,鴻海元大98售10,4.46,5.35,4.46,5.35,+1.00,22.99,152000,8,748700,0,0,0,0,0,0,152000,83000,69000,69000
20200312,06759P,台積電元大98售17,4.72,5.25,4.72,4.83,+0.72,17.52,808000,64,3959950,0,0,0,0,0,0,626000,523000,103000,103000
20200312,06760P,台積電元大98售18,2.84,3.31,2.80,2.99,+0.33,12.41,1085000,83,3236600,0,0,0,0,0,0,809000,782000,27000,27000
20200312,06761P,台積電元大99售05,3.65,4.52,3.65,3.97,+0.37,10.28,1114000,84,4493770,0,0,0,0,0,0,688000,749000,-61000,-61000
20200312,06762P,智邦元大98售11,3.00,3.15,3.00,3.15,+0.43,15.81,133000,7,411150,0,0,0,0,0,0,33000,133000,-100000,-100000
20200312,06763P,技嘉元大98售05,4.96,4.96,4.90,4.90,+0.08,1.66,35000,2,173300,0,0,0,0,0,0,35000,0,35000,35000
20200312,06764P,聯發科元大98售11,5.70,6.80,5.70,6.80,+2.31,51.45,55000,3,357500,0,0,0,0,0,0,55000,40000,15000,15000
20200312,06765P,欣興元大98售11,3.40,3.74,3.40,3.74,+0.67,21.82,32000,6,111030,0,0,0,0,0,0,25000,7000,18000,18000
20200312,06766P,玉晶光元大99售10,1.74,1.99,1.74,1.99,+0.27,15.7,243000,16,443220,0,0,0,0,0,0,200000,43000,157000,157000
20200312,06767P,台積電永昌99售03,5.90,6.15,5.85,6.15,+0.90,17.14,1025000,20,6181250,0,0,0,0,0,0,260000,875000,-615000,-615000
20200312,06768P,臺股指永昌98售02,,,,,0.00,0.00,0,0,0,0,0,0,0,0,0,0,0,0,0
20200312,06769P,臺股指永昌98售03,,,,,0.00,0.00,0,0,0,0,0,0,0,0,0,0,0,0,0
20200312,06770P,台灣50第一9C售01,3.69,3.69,3.69,3.69,+0.81,28.13,10000,1,36900,0,0,0,0,0,0,0,10000,-10000,-10000
20200312,06771P,台灣50中信02售01,2.81,3.20,2.81,3.10,+0.44,16.54,187000,38,567990,0,0,0,0,0,0,55000,142000,-87000,-87000
20200312,06772P,國巨中信99售01,1.20,1.49,1.19,1.49,+0.31,26.27,710000,40,1016550,0,0,0,0,0,0,434000,566000,-132000,-132000
20200312,06773P,台灣50兆豐9A售01,2.07,2.27,2.07,2.22,+0.48,27.59,548000,9,1226060,0,0,0,0,0,0,443000,528000,-85000,-85000
20200312,06774P,臺股指兆豐98售02,,,,,0.00,0.00,0,0,0,0,0,0,0,0,0,0,0,0,0
20200312,06775P,臺股指兆豐98售03,,,,,0.00,0.00,0,0,0,0,0,0,0,0,0,0,0,0,0
20200312,06776P,鴻海元大99售05,3.91,4.37,3.91,4.37,+0.93,27.03,134000,7,570120,0,0,0,0,0,0,134000,134000,0,0
20200312,06777P,鴻海元大99售06,5.90,6.05,5.90,5.95,+1.03,20.93,56000,4,335350,0,0,0,0,0,0,56000,55000,1000,1000
20200312,06778P,台積電元大99售06,3.55,4.16,3.54,3.76,+0.39,11.57,806000,66,3073970,0,0,0,0,0,0,448000,629000,-181000,-181000
20200312,06779P,智邦元大98售12,2.85,3.28,2.85,3.28,+0.40,13.89,239000,9,737520,0,0,0,0,0,0,105000,167000,-62000,-62000
20200312,06780P,義隆元大98售02,2.81,3.03,2.79,3.00,+0.30,11.11,436000,22,1245110,0,0,0,0,0,0,17000,419000,-402000,-402000
20200312,06781P,大立光元大98售19,,,,,0.00,0.00,0,0,0,0,0,0,0,0,0,0,0,0,0
20200312,06782P,大立光元大99售07,3.19,3.37,3.19,3.30,+0.64,24.06,94000,13,309960,0,0,0,0,0,0,10000,84000,-74000,-74000
20200312,06783P,亞光元大98售03,3.27,3.73,3.27,3.61,+0.41,12.81,114000,10,401780,0,0,0,0,0,0,110000,79000,31000,31000
20200312,06784P,臺股指元大98售01,8.50,9.80,8.50,9.80,+5.15,110.75,4000,3,36600,0,0,0,0,0,0,4000,0,4000,4000
20200312,06785P,臺股指元大98售02,,,,,0.00,0.00,0,0,0,0,0,0,0,0,0,0,0,0,0
20200312,06786P,臺股指元大98售03,6.85,7.15,6.85,7.10,0.00,0.00,297000,3,2088900,0,0,0,0,0,0,0,297000,-297000,-297000
20200312,06787P,臺股指元大98售04,,,,,0.00,0.00,0,0,0,0,0,0,0,0,0,0,0,0,0
20200312,06788P,臺股指元大98售05,4.40,6.05,4.40,6.05,+1.82,43.03,3000,3,15420,0,0,0,0,0,0,2000,0,2000,2000
20200312,06789P,鴻海凱基98售12,3.62,3.79,3.62,3.79,+0.47,14.16,45000,5,165600,0,0,0,0,0,0,35000,10000,25000,25000
20200312,06790P,台積電凱基9A售04,1.43,2.01,1.43,1.74,+0.46,35.94,451000,64,747430,0,0,0,0,0,0,159000,284000,-125000,-125000
20200312,06791P,聯發科凱基98售16,2.26,2.56,2.26,2.53,+0.76,42.94,163000,18,393060,0,0,0,0,0,0,107000,162000,-55000,-55000
20200312,06792P,臺股指凱基98售02,9.00,12.00,9.00,12.00,+4.25,54.84,64000,3,585000,0,0,0,0,0,0,50000,14000,36000,36000
20200312,06793P,臺股指凱基98售03,9.25,9.25,9.25,9.25,0.00,0.00,1000,1,9250,0,0,0,0,0,0,1000,0,1000,1000
20200312,06794P,臺股指凱基98售04,,,,,0.00,0.00,0,0,0,0,0,0,0,0,0,0,0,0,0
20200312,06795P,臺股指凱基98售05,,,,,0.00,0.00,0,0,0,0,0,0,0,0,0,0,0,0,0
20200312,06796P,臺股指凱基98售06,,,,,0.00,0.00,0,0,0,0,0,0,0,0,0,0,0,0,0
20200312,06797P,臺股指凱基98售07,,,,,0.00,0.00,0,0,0,0,0,0,0,0,0,0,0,0,0
20200312,06798P,臺股指凱基98售08,,,,,0.00,0.00,0,0,0,0,0,0,0,0,0,0,0,0,0
20200312,06799P,臺股指凱基98售09,,,,,0.00,0.00,0,0,0,0,0,0,0,0,0,0,0,0,0
20200312,06800P,台灣50群益9A售02,4.61,5.55,4.55,5.20,+1.14,28.08,1190000,28,5683800,0,0,0,0,0,0,712000,608000,104000,104000
20200312,06801P,技嘉群益99售02,2.76,2.95,2.76,2.95,+0.27,10.07,24000,2,69090,0,0,0,0,0,0,9000,15000,-6000,-6000
20200312,06802P,緯穎群益98售03,2.19,2.63,2.19,2.51,+0.33,15.14,377000,10,924190,0,0,0,0,0,0,357000,219000,138000,138000
20200312,06803P,臺股指群益98售09,5.85,6.40,5.85,6.20,+1.34,27.57,43000,6,268650,0,0,0,0,0,0,43000,0,43000,43000
20200312,06804P,臺股指群益98售10,15.30,16.00,15.30,16.00,0.00,0.00,2000,2,31300,0,0,0,0,0,0,0,2000,-2000,-2000
20200312,06805P,臺股指群益98售11,,,,,0.00,0.00,0,0,0,0,0,0,0,0,0,0,0,0,0
20200312,06806P,臺股指群益98售12,,,,,0.00,0.00,0,0,0,0,0,0,0,0,0,0,0,0,0
20200312,06807P,臺股指群益98售13,,,,,0.00,0.00,0,0,0,0,0,0,0,0,0,0,0,0,0
20200312,06808P,電子類群益98售02,5.65,7.15,5.65,7.15,+2.37,49.58,438000,20,2830150,0,0,0,0,0,0,280000,158000,122000,122000
20200312,06809P,電子類群益98售03,11.40,11.40,11.40,11.40,+4.20,58.33,1000,1,11400,0,0,0,0,0,0,1000,0,1000,1000
20200312,06810P,國巨統一99售03,2.30,2.30,2.30,2.30,+0.11,5.02,20000,2,46000,0,0,0,0,0,0,10000,10000,0,0
20200312,06811P,聯發科統一98售06,2.37,2.37,2.37,2.37,0.00,0.00,10000,1,23700,0,0,0,0,0,0,0,10000,-10000,-10000
20200312,06812P,台灣50元富9C售01,3.04,3.77,3.04,3.54,+0.77,27.8,762000,37,2558850,0,0,0,0,0,0,637000,475000,162000,162000
20200312,06813P,友訊元富98售03,2.88,3.23,2.88,3.23,+0.63,24.23,71000,5,208630,0,0,0,0,0,0,40000,31000,9000,9000
20200312,06814P,臺股指元富98售03,,,,,0.00,0.00,0,0,0,0,0,0,0,0,0,0,0,0,0
20200312,06815P,臺股指元富98售04,,,,,0.00,0.00,0,0,0,0,0,0,0,0,0,0,0,0,0
20200312,06816P,臺股指元富98售05,,,,,0.00,0.00,0,0,0,0,0,0,0,0,0,0,0,0,0
20200312,06817P,臺股指元富98售06,4.38,4.38,4.38,4.38,+1.42,47.97,30000,1,131400,0,0,0,0,0,0,30000,0,30000,30000
20200312,06818P,臺股指元富98售07,,,,,0.00,0.00,0,0,0,0,0,0,0,0,0,0,0,0,0
20200312,06819P,臺股指元富98售08,5.15,5.15,5.15,5.15,+2.11,69.41,60000,1,309000,0,0,0,0,0,0,60000,0,60000,60000
20200312,06820P,臺股指元富98售09,,,,,0.00,0.00,0,0,0,0,0,0,0,0,0,0,0,0,0
20200312,06821P,臺股指元富98售10,2.29,3.90,2.29,3.53,+1.46,70.53,1045000,25,3192970,0,0,0,0,0,0,1031000,11000,1020000,1020000
20200312,06822P,上銀富邦99售03,1.87,2.16,1.85,2.16,+0.43,24.86,842000,34,1662020,0,0,0,0,0,0,455000,455000,0,0
20200312,06823P,台灣50永豐98售02,3.27,3.87,3.27,3.87,+1.44,59.26,14000,2,47580,0,0,0,0,0,0,14000,0,14000,14000
20200312,06824P,台灣50國票99售02,7.35,8.60,7.35,8.55,+1.95,29.55,205000,11,1587700,0,0,0,0,0,0,110000,195000,-85000,-85000
20200312,06825P,臺股指國票98售01,16.90,17.50,16.90,17.30,0.00,0.00,6000,3,103400,0,0,0,0,0,0,0,6000,-6000,-6000
20200312,06826P,臺股指國票98售02,,,,,0.00,0.00,0,0,0,0,0,0,0,0,0,0,0,0,0
20200312,06827P,臺股指國票98售03,,,,,0.00,0.00,0,0,0,0,0,0,0,0,0,0,0,0,0
20200312,06828P,臺股指國票98售04,,,,,0.00,0.00,0,0,0,0,0,0,0,0,0,0,0,0,0
20200312,06829P,臺股指國票98售05,6.30,6.30,6.30,6.30,+0.90,16.67,10000,1,63000,0,0,0,0,0,0,10000,0,10000,10000
20200312,06830P,臺股指國票98售06,,,,,0.00,0.00,0,0,0,0,0,0,0,0,0,0,0,0,0
20200312,06831P,臺股指國票98售07,,,,,0.00,0.00,0,0,0,0,0,0,0,0,0,0,0,0,0
20200312,06832P,玉晶光凱基98售03,1.40,1.68,1.40,1.68,+0.30,21.74,327000,19,483810,0,0,0,0,0,0,244000,183000,61000,61000
20200312,06833P,矽力群益99售01,1.37,1.45,1.37,1.39,+0.11,8.59,217000,19,304610,0,0,0,0,0,0,142000,74000,68000,68000
20200312,06834P,訊芯群益99售02,2.33,2.56,2.30,2.56,+0.34,15.32,91000,7,216700,0,0,0,0,0,0,60000,61000,-1000,-1000
20200312,06835P,台灣50國票9A售01,6.30,7.30,6.30,7.30,+2.05,39.05,6000,3,40800,0,0,0,0,0,0,6000,0,6000,6000
20200312,06836P,玉晶光國票99售06,2.50,2.53,2.50,2.53,+0.58,29.74,24000,3,60150,0,0,0,0,0,0,5000,19000,-14000,-14000
20200312,06837P,上銀統一9A售02,1.81,1.90,1.81,1.90,0.00,0.00,32000,5,59830,0,0,0,0,0,0,2000,30000,-28000,-28000
20200312,06838P,台積電統一99售05,1.72,1.92,1.72,1.90,+0.41,27.52,297000,11,547800,0,0,0,0,0,0,80000,217000,-137000,-137000
20200312,06839P,玉晶光統一9A售05,1.62,1.90,1.62,1.90,+0.32,20.25,189000,10,340350,0,0,0,0,0,0,71000,118000,-47000,-47000
20200312,06840P,臺股指統一98售04,,,,,0.00,0.00,0,0,0,0,0,0,0,0,0,0,0,0,0
20200312,06841P,臺股指統一9A售02,2.86,2.86,2.86,2.86,0.00,0.00,1000,1,2860,0,0,0,0,0,0,0,1000,-1000,-1000
20200312,06842P,臺股指統一9A售03,3.30,4.17,3.29,4.04,+1.11,37.88,109000,12,395270,0,0,0,0,0,0,70000,39000,31000,31000
20200312,06843P,鴻海元大98售11,3.60,3.60,3.60,3.60,+0.79,28.11,1000,1,3600,0,0,0,0,0,0,1000,0,1000,1000
20200312,06844P,智邦元大98售13,3.72,3.87,3.72,3.74,+0.31,9.04,153000,8,581710,0,0,0,0,0,0,53000,133000,-80000,-80000
20200312,06845P,億光元大98售02,2.79,2.96,2.79,2.96,0.00,0.00,101000,3,297790,0,0,0,0,0,0,0,101000,-101000,-101000
20200312,06846P,美律元大98售05,3.33,3.81,3.33,3.81,+0.58,17.96,97000,5,358730,0,0,0,0,0,0,19000,78000,-59000,-59000
20200312,06847P,奇力新元大98售05,2.12,2.30,2.09,2.30,+0.27,13.3,173000,6,386030,0,0,0,0,0,0,113000,60000,53000,53000
20200312,06848P,聯詠元大98售04,4.20,4.61,4.20,4.61,+0.57,14.11,159000,10,704060,0,0,0,0,0,0,52000,147000,-95000,-95000
20200312,06849P,欣興元大98售12,,,,,0.00,0.00,0,0,0,0,0,0,0,0,0,0,0,0,0
20200312,06850P,聯茂元大98售06,1.94,2.19,1.94,2.19,+0.57,35.19,98000,8,199320,0,0,0,0,0,0,53000,45000,8000,8000
20200312,06851P,鈺齊元大98售01,1.95,2.17,1.95,2.17,+0.24,12.44,102000,8,206830,0,0,0,0,0,0,41000,61000,-20000,-20000
20200312,06852P,臺股指元大98售11,1.52,1.79,1.52,1.79,0.00,0.00,56000,4,90160,0,0,0,0,0,0,0,56000,-56000,-56000
20200312,06853P,華擎元富98售03,3.70,4.05,3.70,3.86,+0.30,8.43,219000,40,845150,0,0,0,0,0,0,129000,90000,39000,39000
20200312,06854P,鴻海富邦99售05,,,,,0.00,0.00,0,0,0,0,0,0,0,0,0,0,0,0,0
20200312,06855P,聯發科富邦9A售01,2.44,2.84,2.44,2.78,+0.45,19.31,890000,43,2344950,0,0,0,0,0,0,570000,359000,211000,211000
20200312,06856P,台灣50永豐99售03,,,,,0.00,0.00,0,0,0,0,0,0,0,0,0,0,0,0,0
20200312,06857P,超眾永豐98售02,1.37,1.61,1.37,1.61,+0.32,24.81,128000,15,186170,0,0,0,0,0,0,45000,83000,-38000,-38000
20200312,06858P,道瓊指中信9B售01,2.36,2.81,2.36,2.70,+0.56,26.17,642000,34,1687710,0,0,0,0,0,0,331000,136000,195000,195000
20200312,06859P,元金2X中信9C售01,0.86,0.89,0.86,0.88,+0.05,6.02,321000,9,283540,0,0,0,0,0,0,40000,281000,-241000,-241000
20200312,06860P,台灣50兆豐98售01,2.82,3.50,2.82,3.36,+1.07,46.72,99000,9,324840,0,0,0,0,0,0,28000,70000,-42000,-42000
20200312,06861P,台積電國票99售08,,,,,0.00,0.00,0,0,0,0,0,0,0,0,0,0,0,0,0
20200312,06862P,大立光凱基98售16,,,,,0.00,0.00,0,0,0,0,0,0,0,0,0,0,0,0,0
20200312,06863P,欣興凱基98售05,1.76,1.87,1.76,1.87,+0.29,18.35,72000,7,128620,0,0,0,0,0,0,70000,32000,38000,38000
20200312,06864P,健策凱基98售01,1.79,2.02,1.79,2.02,+0.35,20.96,235000,11,455190,0,0,0,0,0,0,139000,96000,43000,43000
20200312,06865P,亞德客元大98售04,5.10,5.90,5.10,5.90,+1.09,22.66,40000,2,228000,0,0,0,0,0,0,40000,30000,10000,10000
20200312,06866P,聯發科元大98售13,5.05,6.00,5.05,5.75,+1.42,32.79,121000,15,674300,0,0,0,0,0,0,120000,1000,119000,119000
20200312,06867P,訊芯元大98售08,2.67,2.71,2.62,2.71,+0.28,11.52,420000,8,1111000,0,0,0,0,0,0,330000,100000,230000,230000
20200312,06868P,電子類元大99售01,2.90,3.28,2.88,3.14,+0.59,23.14,127000,20,392410,0,0,0,0,0,0,26000,101000,-75000,-75000
20200312,06869P,金融類元大99售01,1.40,1.62,1.40,1.62,+0.29,21.8,57000,4,80980,0,0,0,0,0,0,0,57000,-57000,-57000
20200312,06870P,台灣50群益9A售03,6.35,7.60,6.35,7.45,+1.70,29.57,530000,15,3454000,0,0,0,0,0,0,224000,346000,-122000,-122000
20200312,06871P,元油2X群益98售04,7.40,7.40,7.30,7.30,0.00,0.00,1126000,20,8248600,0,0,0,0,0,0,1126000,1126000,0,0
20200312,06872P,亞德客元富98售04,2.50,2.79,2.46,2.79,+0.48,20.78,230000,15,587000,0,0,0,0,0,0,55000,175000,-120000,-120000
20200312,06873P,嘉晶元富98售02,1.18,1.30,1.12,1.23,+0.05,4.24,1135000,35,1376330,0,0,0,0,0,0,606000,874000,-268000,-268000
20200312,06874P,台積電台新98售02,,,,,0.00,0.00,0,0,0,0,0,0,0,0,0,0,0,0,0
20200312,06875P,台灣50永昌9A售02,3.45,4.06,3.45,4.06,+1.10,37.16,92000,7,348600,0,0,0,0,0,0,92000,60000,32000,32000
20200312,06876P,台灣50兆豐9B售01,2.96,3.27,2.96,3.23,0.00,0.00,65000,8,210380,0,0,0,0,0,0,65000,65000,0,0
20200312,06877P,台積電兆豐98售04,2.21,2.70,2.20,2.44,+0.43,21.39,3662000,73,8659280,0,0,0,0,0,0,2563000,1794000,769000,769000
20200312,06878P,台灣50日盛9B售01,1.58,1.86,1.58,1.76,+0.27,18.12,632000,12,1123240,0,0,0,0,0,0,500000,132000,368000,368000
20200312,06879P,長榮航凱基98售02,1.18,1.30,1.18,1.26,+0.10,8.62,1075000,30,1343300,0,0,0,0,0,0,560000,514000,46000,46000
20200312,06880P,鈺齊凱基98售03,1.16,1.29,1.16,1.29,+0.17,15.18,404000,9,496000,0,0,0,0,0,0,134000,270000,-136000,-136000
20200312,06881P,國巨群益98售10,6.90,6.90,6.85,6.85,+0.75,12.3,28000,3,191850,0,0,0,0,0,0,28000,0,28000,28000
20200312,06882P,聯發科群益98售07,3.37,3.99,3.37,3.99,+1.11,38.54,232000,12,853730,0,0,0,0,0,0,218000,204000,14000,14000
20200312,06883P,聯茂群益98售03,1.75,2.01,1.74,2.01,+0.39,24.07,561000,20,1038180,0,0,0,0,0,0,177000,384000,-207000,-207000
20200312,06884P,台郡群益98售03,2.46,2.82,2.46,2.68,+0.45,20.18,428000,16,1110000,0,0,0,0,0,0,211000,217000,-6000,-6000
20200312,06885P,國巨國票99售06,8.15,10.20,8.15,10.20,+3.45,51.11,294000,12,2585700,0,0,0,0,0,0,1000,293000,-292000,-292000
20200312,06886P,旺宏元大99售07,3.90,4.57,3.90,4.50,+0.75,20.0,121000,15,505220,0,0,0,0,0,0,42000,100000,-58000,-58000
20200312,06887P,華新科元大98售04,5.35,6.45,5.35,6.40,+1.46,29.55,52000,5,319000,0,0,0,0,0,0,52000,45000,7000,7000
20200312,06888P,日月光元大98售02,5.65,5.65,5.65,5.65,+0.60,11.88,3000,1,16950,0,0,0,0,0,0,0,3000,-3000,-3000
20200312,06889P,臺股指元大98售13,1.86,2.01,1.86,2.01,+0.20,11.05,41000,2,82260,0,0,0,0,0,0,41000,0,41000,41000
20200312,06890P,金融類元大98售02,,,,,0.00,0.00,0,0,0,0,0,0,0,0,0,0,0,0,0
20200312,06891P,緯穎富邦99售03,0.74,0.83,0.73,0.83,+0.11,15.28,1038000,12,823390,0,0,0,0,0,0,697000,641000,56000,56000
20200312,06892P,聯鈞元富98售01,2.37,2.50,2.31,2.50,+0.26,11.61,185000,11,439600,0,0,0,0,0,0,125000,60000,65000,65000
20200312,06893P,致新元富98售02,2.44,2.65,2.44,2.60,+0.32,14.04,168000,15,424970,0,0,0,0,0,0,60000,108000,-48000,-48000
20200312,06894P,鈺齊元富98售03,1.92,2.15,1.92,2.15,+0.29,15.59,347000,18,687650,0,0,0,0,0,0,234000,113000,121000,121000
20200312,06895P,台灣50統一9A售01,2.25,2.25,2.14,2.14,+0.49,29.7,6000,2,13060,0,0,0,0,0,0,6000,0,6000,6000
20200312,06896P,信邦中信98售01,1.32,1.40,1.32,1.38,+0.18,15.0,235000,12,322780,0,0,0,0,0,0,31000,204000,-173000,-173000
20200312,06897P,FBVIX群益01售01,0.81,0.81,0.79,0.79,-0.05,-5.95,66000,3,53240,0,0,0,0,0,0,60000,6000,54000,54000
20200312,06898P,FBVIX群益9C售03,1.10,1.10,1.08,1.09,-0.09,-7.63,45000,5,48900,0,0,0,0,0,0,10000,35000,-25000,-25000
20200312,06899P,嘉澤群益98售01,2.06,2.20,2.06,2.20,+0.24,12.24,405000,14,853380,0,0,0,0,0,0,89000,316000,-227000,-227000
20200312,06900P,FBVIX國票12售01,0.47,0.47,0.47,0.47,0.00,0.00,271000,10,127370,0,0,0,0,0,0,105000,161000,-56000,-56000
20200312,06901P,亞德客凱基98售02,1.38,1.62,1.37,1.62,+0.32,24.62,727000,15,1095500,0,0,0,0,0,0,453000,614000,-161000,-161000
20200312,06902P,聯電凱基98售02,1.69,1.94,1.69,1.78,+0.24,15.58,85000,10,154500,0,0,0,0,0,0,15000,70000,-55000,-55000
20200312,06903P,技嘉凱基98售04,2.33,2.38,2.30,2.30,+0.15,6.98,45000,5,106260,0,0,0,0,0,0,2000,43000,-41000,-41000
20200312,06904P,TPK凱基98售03,1.23,1.39,1.23,1.39,+0.20,16.81,558000,13,723350,0,0,0,0,0,0,62000,496000,-434000,-434000
20200312,06905P,上証2X國泰99售02,0.92,0.92,0.88,0.88,0.00,0.00,55000,2,48600,0,0,0,0,0,0,50000,5000,45000,45000
20200312,06906P,國巨國泰99售01,3.31,3.71,3.31,3.71,0.00,0.00,3000,3,10440,0,0,0,0,0,0,1000,2000,-1000,-1000
20200312,06907P,華新科國泰99售05,,,,,0.00,0.00,0,0,0,0,0,0,0,0,0,0,0,0,0
20200312,06908P,健策國泰99售02,2.24,2.62,2.23,2.62,+0.50,23.58,378000,34,872650,0,0,0,0,0,0,305000,83000,222000,222000
20200312,06909P,元油2X元大98售22,4.41,4.41,4.32,4.40,0.00,0.00,140000,14,616200,0,0,0,0,0,0,140000,140000,0,0
20200312,06910P,元油2X元大98售23,,,,,0.00,0.00,0,0,0,0,0,0,0,0,0,0,0,0,0
20200312,06911P,鴻海元大99售09,3.40,3.40,3.40,3.40,0.00,0.00,1000,1,3400,0,0,0,0,0,0,1000,0,1000,1000
20200312,06912P,台光電元大99售02,3.04,3.08,2.99,3.08,+0.28,10.0,99000,6,301500,0,0,0,0,0,0,38000,61000,-23000,-23000
20200312,06913P,聯發科元大98售14,4.53,5.20,4.53,5.20,+1.49,40.16,20000,2,97300,0,0,0,0,0,0,20000,0,20000,20000
20200312,06914P,南茂元大98售03,2.83,2.97,2.83,2.97,+0.48,19.28,55000,5,156490,0,0,0,0,0,0,51000,4000,47000,47000
20200312,06915P,晶技元富98售02,0.72,1.03,0.70,1.02,+0.28,37.84,2457000,56,2181160,0,0,0,0,0,0,1932000,668000,1264000,1264000
20200312,06916P,聯鈞元富98售02,3.47,3.90,3.46,3.84,+0.42,12.28,181000,13,683640,0,0,0,0,0,0,146000,35000,111000,111000
20200312,06917P,聯電亞東99售01,1.86,2.03,1.86,1.90,+0.30,18.75,198000,5,395040,0,0,0,0,0,0,78000,120000,-42000,-42000
20200312,06918P,嘉聯益亞東99售01,1.66,1.66,1.66,1.66,+0.09,5.73,45000,1,74700,0,0,0,0,0,0,45000,0,45000,45000
20200312,06919P,臺股指日盛98售02,,,,,0.00,0.00,0,0,0,0,0,0,0,0,0,0,0,0,0
20200312,06920P,台灣50凱基9A售01,3.56,3.98,3.56,3.98,+0.83,26.35,110000,2,395800,0,0,0,0,0,0,110000,110000,0,0
20200312,06921P,台光電凱基98售06,1.81,1.90,1.75,1.90,+0.26,15.85,216000,8,385280,0,0,0,0,0,0,178000,38000,140000,140000
20200312,06922P,元上證群益9C售01,2.63,2.80,2.63,2.80,+0.22,8.53,50000,5,136200,0,0,0,0,0,0,0,50000,-50000,-50000
20200312,06923P,鴻海群益98售09,4.28,4.74,4.28,4.74,+1.00,26.74,80000,5,349950,0,0,0,0,0,0,54000,26000,28000,28000
20200312,06924P,台積電群益98售07,3.85,4.75,3.83,4.20,+0.61,16.99,250000,25,1066670,0,0,0,0,0,0,53000,207000,-154000,-154000
20200312,06925P,致茂群益9A售02,2.59,2.70,2.59,2.69,+0.26,10.7,162000,5,433410,0,0,0,0,0,0,61000,101000,-40000,-40000
20200312,06926P,可成群益9A售04,5.25,6.20,5.20,6.20,+1.62,35.37,69000,7,391950,0,0,0,0,0,0,25000,44000,-19000,-19000
20200312,06927P,台灣50元大9B售03,,,,,0.00,0.00,0,0,0,0,0,0,0,0,0,0,0,0,0
20200312,06928P,鴻海元大99售10,2.81,3.12,2.81,3.12,+0.56,21.88,86000,5,258070,0,0,0,0,0,0,5000,81000,-76000,-76000
20200312,06929P,鴻海元大99售11,2.68,3.05,2.68,3.05,0.00,0.00,3000,2,8780,0,0,0,0,0,0,0,3000,-3000,-3000
20200312,06930P,台積電元大98售19,4.94,5.10,4.94,5.10,+0.87,20.57,132000,10,664080,0,0,0,0,0,0,73000,74000,-1000,-1000
20200312,06931P,大立光元大98售20,6.30,6.30,6.30,6.30,0.00,0.00,1000,1,6300,0,0,0,0,0,0,1000,0,1000,1000
20200312,06932P,大立光元大98售21,4.46,4.46,4.46,4.46,+0.76,20.54,10000,1,44600,0,0,0,0,0,0,10000,0,10000,10000
20200312,06933P,禾伸堂元大98售03,2.65,2.86,2.59,2.71,-0.04,-1.45,189000,19,508140,0,0,0,0,0,0,95000,114000,-19000,-19000
20200312,06934P,聯鈞元大98售03,2.39,2.52,2.38,2.50,+0.10,4.17,131000,5,315220,0,0,0,0,0,0,113000,118000,-5000,-5000
20200312,06935P,神達元大98售02,3.61,3.95,3.61,3.86,+0.54,16.27,73000,12,275300,0,0,0,0,0,0,25000,48000,-23000,-23000
20200312,06936P,瑞儀元大98售01,3.89,4.39,3.89,4.39,+0.74,20.27,11000,5,44850,0,0,0,0,0,0,3000,8000,-5000,-5000
20200312,06937P,GIS元大98售03,2.96,2.96,2.96,2.96,+0.42,16.54,50000,1,148000,0,0,0,0,0,0,0,50000,-50000,-50000
20200312,06938P,南電元大98售03,,,,,0.00,0.00,0,0,0,0,0,0,0,0,0,0,0,0,0
20200312,06939P,國巨永豐98售09,2.42,2.72,2.42,2.72,+0.42,18.26,227000,13,587120,0,0,0,0,0,0,100000,127000,-27000,-27000
20200312,06940P,旺宏永豐98售05,1.67,1.86,1.67,1.86,+0.42,29.17,112000,5,198540,0,0,0,0,0,0,62000,100000,-38000,-38000
20200312,06941P,國巨統一98售07,,,,,0.00,0.00,0,0,0,0,0,0,0,0,0,0,0,0,0
20200312,06942P,台灣50台新02售01,2.16,2.43,2.16,2.43,+0.72,42.11,1835000,142,4234770,0,0,0,0,0,0,1815000,1834000,-19000,-19000
20200312,06943P,致茂元富98售03,2.98,3.31,2.98,3.31,+0.51,18.21,222000,21,686240,0,0,0,0,0,0,68000,154000,-86000,-86000
20200312,06944P,健鼎元富98售02,2.65,2.85,2.65,2.82,+0.30,11.9,267000,26,732110,0,0,0,0,0,0,89000,178000,-89000,-89000
20200312,06945P,國巨群益99售04,,,,,0.00,0.00,0,0,0,0,0,0,0,0,0,0,0,0,0
20200312,06946P,T50正2元大9C售01,5.70,6.45,5.65,6.45,+1.15,21.7,461000,6,2699050,0,0,0,0,0,0,20000,441000,-421000,-421000
20200312,06947P,FBVIX元大01售01,1.64,1.64,1.64,1.64,0.00,0.00,5000,1,8200,0,0,0,0,0,0,0,5000,-5000,-5000
20200312,06948P,FBVIX元大01售02,1.26,1.26,1.26,1.26,0.00,0.00,60000,2,75600,0,0,0,0,0,0,0,60000,-60000,-60000
20200312,06949P,台表科元大99售01,3.00,3.26,2.98,3.20,+0.52,19.4,21000,5,65650,0,0,0,0,0,0,0,21000,-21000,-21000
20200312,06950P,鴻海統一9B售02,1.04,1.19,1.03,1.17,+0.21,21.88,80000,6,86950,0,0,0,0,0,0,35000,45000,-10000,-10000
20200312,06951P,台積電統一9B售02,1.00,1.23,1.00,1.13,+0.33,41.25,155000,7,168150,0,0,0,0,0,0,50000,105000,-55000,-55000
20200312,06952P,大立光統一9A售03,1.74,1.87,1.74,1.87,0.00,0.00,43000,2,80020,0,0,0,0,0,0,0,43000,-43000,-43000
20200312,06953P,景碩統一9A售01,0.95,1.01,0.95,1.01,+0.11,12.22,228000,3,227760,0,0,0,0,0,0,26000,202000,-176000,-176000
20200312,06954P,大立光元富99售01,,,,,0.00,0.00,0,0,0,0,0,0,0,0,0,0,0,0,0
20200312,06955P,臻鼎元富99售01,2.28,2.91,2.28,2.83,+0.63,28.64,216000,21,557090,0,0,0,0,0,0,52000,154000,-102000,-102000
20200312,06956P,國巨日盛99售04,2.54,2.70,2.54,2.70,+0.37,15.88,28000,3,72960,0,0,0,0,0,0,18000,20000,-2000,-2000
20200312,06957P,FBVIX凱基01售01,0.71,0.71,0.64,0.64,-0.08,-11.11,131000,4,88450,0,0,0,0,0,0,55000,76000,-21000,-21000
20200312,06958P,FBVIX凱基9C售02,0.93,0.95,0.92,0.95,-0.05,-5.0,447000,20,417550,0,0,0,0,0,0,191000,253000,-62000,-62000
20200312,06959P,鴻海凱基9A售02,1.91,2.13,1.91,2.11,+0.40,23.39,110000,5,223660,0,0,0,0,0,0,45000,65000,-20000,-20000
20200312,06960P,國巨凱基99售08,2.60,2.69,2.60,2.69,+0.22,8.91,4000,2,10490,0,0,0,0,0,0,3000,1000,2000,2000
20200312,06961P,台積電凱基99售05,1.84,2.17,1.84,1.92,+0.16,9.09,763000,28,1527860,0,0,0,0,0,0,383000,578000,-195000,-195000
20200312,06962P,華新科永豐99售01,1.52,1.80,1.52,1.78,+0.31,21.09,363000,26,582870,0,0,0,0,0,0,66000,327000,-261000,-261000
20200312,06963P,鴻海凱基99售04,1.80,1.80,1.80,1.80,0.00,0.00,90000,1,162000,0,0,0,0,0,0,90000,90000,0,0
20200312,06964P,臺股指凱基9B售01,4.75,6.45,4.71,5.95,+1.47,32.81,206000,26,1192820,0,0,0,0,0,0,135000,171000,-36000,-36000
20200312,06965P,台積電台新99售02,1.69,1.91,1.68,1.73,+0.24,16.11,290000,12,500350,0,0,0,0,0,0,225000,265000,-40000,-40000
20200312,06966P,健策台新9A售02,1.59,1.80,1.59,1.80,+0.37,25.87,501000,9,823680,0,0,0,0,0,0,222000,279000,-57000,-57000
20200312,06967P,台郡台新99售02,1.26,1.26,1.26,1.26,0.00,0.00,18000,1,22680,0,0,0,0,0,0,0,18000,-18000,-18000
20200312,06968P,元油2X元大99售08,,,,,0.00,0.00,0,0,0,0,0,0,0,0,0,0,0,0,0
20200312,06969P,上銀元大99售02,1.79,2.15,1.79,2.11,+0.45,27.11,134000,13,259240,0,0,0,0,0,0,85000,49000,36000,36000
20200312,06970P,旺宏元大99售08,1.22,1.37,1.22,1.37,+0.21,18.1,104000,11,132680,0,0,0,0,0,0,74000,30000,44000,44000
20200312,06971P,台光電元大99售03,1.12,1.24,1.12,1.24,+0.20,19.23,297000,11,339880,0,0,0,0,0,0,10000,267000,-257000,-257000
20200312,06972P,聯發科元大99售04,4.81,4.81,4.81,4.81,0.00,0.00,1000,1,4810,0,0,0,0,0,0,0,1000,-1000,-1000
20200312,06973P,臺股指元大9A售11,5.30,7.10,5.30,6.45,+1.95,43.33,84000,9,511150,0,0,0,0,0,0,72000,12000,60000,60000
20200312,06974P,臺股指元大9A售12,7.10,7.30,7.10,7.30,+2.45,50.52,140000,18,1012000,0,0,0,0,0,0,140000,0,140000,140000
20200312,06975P,臺股指元大9A售13,,,,,0.00,0.00,0,0,0,0,0,0,0,0,0,0,0,0,0
20200312,06976P,臺股指元大9A售14,,,,,0.00,0.00,0,0,0,0,0,0,0,0,0,0,0,0,0
20200312,06977P,臺股指元大9A售15,3.88,4.70,3.79,4.40,+1.08,32.53,104000,13,415290,0,0,0,0,0,0,67000,37000,30000,30000
20200312,06978P,聯發科富邦9B售02,1.36,1.51,1.36,1.51,0.00,0.00,84000,3,120240,0,0,0,0,0,0,40000,84000,-44000,-44000
20200312,06979P,台灣50永豐9A售02,2.02,2.39,2.02,2.39,+0.77,47.53,6000,4,13040,0,0,0,0,0,0,6000,0,6000,6000
20200312,06980P,緯穎永豐99售02,1.75,1.90,1.75,1.80,0.00,0.00,21000,3,38300,0,0,0,0,0,0,11000,10000,1000,1000
20200312,06981P,台灣50麥證99售02,3.30,4.23,1.51,4.06,+1.12,38.1,210000,21,682520,135000,37000,98000,0,0,0,135000,37000,98000,98000
20200312,06982P,義隆凱基99售02,1.20,1.28,1.19,1.25,+0.10,8.7,496000,26,616890,0,0,0,0,0,0,99000,397000,-298000,-298000
20200312,06983P,台積電國泰9A售02,2.15,2.44,2.12,2.44,+0.83,51.55,362000,10,772560,0,0,0,0,0,0,362000,0,362000,362000
20200312,06984P,上銀富邦9B售01,2.14,2.36,2.12,2.36,+0.38,19.19,624000,22,1388750,0,0,0,0,0,0,240000,482000,-242000,-242000
20200312,06985P,華新科富邦9C售02,0.97,1.04,0.97,1.03,+0.15,17.05,41000,4,41040,0,0,0,0,0,0,40000,41000,-1000,-1000
20200312,06986P,台積電台新9A售01,1.56,1.72,1.54,1.72,+0.52,43.33,102000,3,159260,0,0,0,0,0,0,1000,101000,-100000,-100000
20200312,06987P,鴻海元富99售08,2.80,3.30,2.80,3.30,0.00,0.00,92000,6,278400,0,0,0,0,0,0,12000,92000,-80000,-80000
20200312,06988P,鴻海元富99售09,,,,,0.00,0.00,0,0,0,0,0,0,0,0,0,0,0,0,0
20200312,06989P,鴻海元富99售10,3.43,3.86,3.39,3.86,+0.84,27.81,72000,4,253820,0,0,0,0,0,0,52000,32000,20000,20000
20200312,06990P,康友元富99售03,2.92,3.17,2.90,3.07,+0.33,12.04,222000,23,669880,0,0,0,0,0,0,28000,194000,-166000,-166000
20200312,06991P,矽創群益99售01,1.75,2.11,1.72,2.02,+0.32,18.82,167000,17,313720,0,0,0,0,0,0,40000,127000,-87000,-87000
20200312,06992P,玉晶光日盛9B售01,1.30,1.45,1.30,1.45,+0.18,14.17,132000,19,187110,0,0,0,0,0,0,21000,111000,-90000,-90000
20200312,06993P,鴻海凱基99售05,1.51,1.74,1.51,1.74,+0.34,24.29,154000,4,257550,0,0,0,0,0,0,137000,154000,-17000,-17000
20200312,06994P,台光電凱基99售02,1.31,1.48,1.30,1.48,+0.28,23.33,529000,17,709200,0,0,0,0,0,0,35000,494000,-459000,-459000
20200312,06995P,臺股指凱基99售16,1.91,2.52,1.90,2.51,+0.70,38.67,299000,28,694160,0,0,0,0,0,0,55000,244000,-189000,-189000
20200312,06996P,臺股指凱基99售17,1.41,1.82,1.39,1.76,+0.51,40.8,1413000,69,2292430,0,0,0,0,0,0,784000,706000,78000,78000
20200312,06997P,台灣50中信03售01,2.13,2.28,2.10,2.25,0.00,0.00,56000,5,123700,0,0,0,0,0,0,1000,55000,-54000,-54000
20200312,06998P,S&P正2中信9B售01,1.80,2.19,1.80,2.02,+0.40,24.69,149000,10,295100,0,0,0,0,0,0,91000,58000,33000,33000
20200312,06999P,玉晶光國票9B售01,3.45,4.11,3.45,3.83,+0.52,15.71,152000,7,549490,0,0,0,0,0,0,40000,112000,-72000,-72000
20200312,07000P,T50反1元大99售03,0.97,0.97,0.79,0.85,-0.19,-18.27,6356000,25,5751530,0,0,0,0,0,0,3767000,2589000,1178000,1178000
20200312,07001P,國巨元大99售12,1.66,1.94,1.66,1.89,+0.25,15.24,562000,36,975940,0,0,0,0,0,0,401000,431000,-30000,-30000
20200312,07002P,鴻海兆豐99售04,1.16,1.27,1.16,1.27,0.00,0.00,141000,2,174560,0,0,0,0,0,0,100000,141000,-41000,-41000
20200312,07003P,聯發科兆豐99售02,1.34,1.60,1.34,1.58,0.00,0.00,196000,6,274840,0,0,0,0,0,0,0,196000,-196000,-196000
20200312,07004P,大立光兆豐9A售01,0.97,1.15,0.97,1.15,+0.36,45.57,381000,29,388220,0,0,0,0,0,0,263000,118000,145000,145000
20200312,07005P,台積電統一9B售05,1.21,1.39,1.21,1.31,+0.16,13.91,449000,17,579360,0,0,0,0,0,0,203000,246000,-43000,-43000
20200312,07006P,旺宏統一9B售03,0.95,1.06,0.94,1.04,+0.12,13.04,547000,48,541250,0,0,0,0,0,0,76000,465000,-389000,-389000
20200312,07007P,台灣50台新01售02,3.53,4.38,3.53,4.38,+1.29,41.75,410000,8,1523320,0,0,0,0,0,0,226000,184000,42000,42000
20200312,07008P,台郡中信99售02,1.06,1.22,1.06,1.22,+0.30,32.61,563000,14,629790,0,0,0,0,0,0,0,563000,-563000,-563000
20200312,07009P,臺股指中信9B售01,1.61,1.97,1.59,1.94,+0.59,43.7,795000,32,1459620,0,0,0,0,0,0,176000,615000,-439000,-439000
20200312,07010P,T50正2凱基9C售01,2.21,2.40,2.16,2.40,+0.58,31.87,252000,10,586960,0,0,0,0,0,0,22000,230000,-208000,-208000
20200312,07011P,宏達電凱基99售02,1.48,1.61,1.48,1.61,+0.16,11.03,92000,3,143960,0,0,0,0,0,0,32000,60000,-28000,-28000
20200312,07012P,智邦群益9A售01,1.29,1.48,1.29,1.48,+0.19,14.73,90000,10,122300,0,0,0,0,0,0,10000,80000,-70000,-70000
20200312,07013P,玉晶光群益9A售06,3.97,4.43,3.97,4.43,+0.63,16.58,130000,14,538160,0,0,0,0,0,0,40000,90000,-50000,-50000
20200312,07014P,華通元大99售04,1.94,2.02,1.94,2.02,+0.53,35.57,30000,3,59100,0,0,0,0,0,0,0,30000,-30000,-30000
20200312,07015P,國巨元大99售13,1.53,1.81,1.53,1.81,+0.31,20.67,858000,30,1434260,0,0,0,0,0,0,516000,744000,-228000,-228000
20200312,07016P,聯發科元大99售10,4.97,5.00,4.97,5.00,0.00,0.00,6000,2,29850,0,0,0,0,0,0,0,6000,-6000,-6000
20200312,07017P,台灣50元富9B售02,3.20,3.79,3.20,3.57,+0.92,34.72,427000,14,1439690,0,0,0,0,0,0,313000,314000,-1000,-1000
20200312,07018P,台灣50統一9B售01,3.31,3.78,3.31,3.78,+1.49,65.07,30000,3,106500,0,0,0,0,0,0,20000,10000,10000,10000
20200312,07019P,鴻海台新99售01,2.36,2.50,2.36,2.50,+0.37,17.37,14000,2,34300,0,0,0,0,0,0,14000,5000,9000,9000
20200312,07020P,玉晶光台新99售02,2.15,2.43,2.15,2.43,0.00,0.00,63000,5,146370,0,0,0,0,0,0,0,63000,-63000,-63000
20200312,07021P,台積電富邦9C售02,2.29,2.56,2.29,2.34,+0.15,6.85,1447000,28,3481600,0,0,0,0,0,0,820000,709000,111000,111000
20200312,07022P,嘉晶永豐99售02,1.54,1.71,1.52,1.68,+0.17,11.26,271000,15,426400,0,0,0,0,0,0,177000,88000,89000,89000
20200312,07023P,南電永豐99售02,1.59,1.66,1.59,1.66,+0.14,9.21,18000,2,29460,0,0,0,0,0,0,18000,0,18000,18000
20200312,07024P,臺股指永豐99售02,3.25,3.25,3.15,3.15,0.00,0.00,15000,2,48250,0,0,0,0,0,0,0,15000,-15000,-15000
20200312,07025P,玉晶光凱基99售01,1.38,1.65,1.38,1.65,+0.31,23.13,402000,9,585080,0,0,0,0,0,0,34000,368000,-334000,-334000
20200312,07026P,超眾凱基99售03,1.63,1.81,1.60,1.81,+0.32,21.48,1035000,24,1770540,0,0,0,0,0,0,437000,798000,-361000,-361000
20200312,07027P,台積電群益99售04,4.64,4.81,4.64,4.81,+0.44,10.07,14000,3,66510,0,0,0,0,0,0,4000,10000,-6000,-6000
20200312,07028P,大立光群益99售06,3.36,3.50,3.33,3.50,+0.87,33.08,208000,3,697310,0,0,0,0,0,0,198000,10000,188000,188000
20200312,07029P,緯穎群益99售02,1.99,2.40,1.99,2.28,+0.31,15.74,324000,12,724370,0,0,0,0,0,0,239000,284000,-45000,-45000
20200312,07030P,鈺齊群益99售01,1.73,1.86,1.73,1.86,+0.13,7.51,50000,4,89900,0,0,0,0,0,0,20000,30000,-10000,-10000
20200312,07031P,台灣50中信03售02,1.30,1.52,1.30,1.44,+0.30,26.32,822000,8,1205580,0,0,0,0,0,0,321000,501000,-180000,-180000
20200312,07032P,聯發科統一9C售02,1.13,1.13,1.13,1.13,0.00,0.00,32000,2,36160,0,0,0,0,0,0,2000,30000,-28000,-28000
20200312,07033P,大立光統一9B售03,1.40,1.40,1.40,1.40,+0.30,27.27,20000,1,28000,0,0,0,0,0,0,20000,0,20000,20000
20200312,07034P,大立光元富99售03,2.39,2.43,2.39,2.43,0.00,0.00,4000,2,9640,0,0,0,0,0,0,4000,4000,0,0
20200312,07035P,大立光元富99售04,4.00,4.10,4.00,4.10,0.00,0.00,2000,2,8100,0,0,0,0,0,0,2000,2000,0,0
20200312,07036P,台灣50台新9C售01,2.92,3.63,2.92,3.59,+1.01,39.15,1615000,26,5503940,0,0,0,0,0,0,1118000,1595000,-477000,-477000
20200312,07037P,台積電台新99售03,,,,,0.00,0.00,0,0,0,0,0,0,0,0,0,0,0,0,0
20200312,07038P,華新科台新99售01,2.13,2.23,2.13,2.22,+0.13,6.22,74000,10,161980,0,0,0,0,0,0,74000,0,74000,74000
20200312,07039P,南電台新99售01,2.21,2.54,2.21,2.54,+0.33,14.93,209000,12,473160,0,0,0,0,0,0,70000,138000,-68000,-68000
20200312,07040P,台灣50元大9C售02,3.88,4.71,3.88,4.40,+0.84,23.6,2583000,47,10406930,0,0,0,0,0,0,2369000,2503000,-134000,-134000
20200312,07041P,T50反1元大9C售01,,,,,0.00,0.00,0,0,0,0,0,0,0,0,0,0,0,0,0
20200312,07042P,T50反1元大9C售02,,,,,0.00,0.00,0,0,0,0,0,0,0,0,0,0,0,0,0
20200312,07043P,國巨元大99售14,3.99,4.94,3.99,4.73,+0.76,19.14,103000,9,462060,0,0,0,0,0,0,83000,80000,3000,3000
20200312,07044P,台積電元大99售13,5.70,6.45,5.70,5.75,+1.02,21.56,118000,5,692950,0,0,0,0,0,0,111000,22000,89000,89000
20200312,07045P,上銀國票9A售01,4.22,4.33,4.22,4.33,0.00,0.00,25000,3,106950,0,0,0,0,0,0,0,25000,-25000,-25000
20200312,07046P,大立光富邦9C售03,0.88,1.11,0.88,1.09,+0.29,36.25,499000,10,542540,0,0,0,0,0,0,387000,462000,-75000,-75000
20200312,07047P,S&P500中信9B售02,1.66,1.90,1.66,1.88,0.00,0.00,140000,10,250300,0,0,0,0,0,0,0,140000,-140000,-140000
20200312,07048P,台積電中信03售01,1.95,2.12,1.95,2.03,0.00,0.00,50000,19,102890,0,0,0,0,0,0,0,50000,-50000,-50000
20200312,07049P,聯發科中信99售03,1.92,1.99,1.92,1.99,0.00,0.00,16000,2,31140,0,0,0,0,0,0,0,16000,-16000,-16000
20200312,07050P,宏達電中信9B售01,1.11,1.18,1.11,1.18,+0.14,13.46,54000,4,61600,0,0,0,0,0,0,1000,53000,-52000,-52000
20200312,07051P,大立光中信99售02,2.50,2.70,2.50,2.65,+0.40,17.78,37000,7,94890,0,0,0,0,0,0,17000,20000,-3000,-3000
20200312,07052P,臺股指中信9C售02,,,,,0.00,0.00,0,0,0,0,0,0,0,0,0,0,0,0,0
20200312,07053P,台灣50兆豐01售01,2.12,2.44,2.09,2.29,+0.68,42.24,354000,32,818800,0,0,0,0,0,0,332000,334000,-2000,-2000
20200312,07054P,華新科兆豐99售04,1.70,2.02,1.67,1.98,+0.47,31.13,129000,11,228650,0,0,0,0,0,0,61000,68000,-7000,-7000
20200312,07055P,景碩群益9A售02,2.55,2.75,2.55,2.75,+0.35,14.58,60000,3,161920,0,0,0,0,0,0,10000,50000,-40000,-40000
20200312,07056P,臺股指麥證99售02,4.37,4.37,4.37,4.37,0.00,0.00,1000,1,4370,0,1000,-1000,0,0,0,0,1000,-1000,-1000
20200312,07057P,大立光康和9B售02,,,,,0.00,0.00,0,0,0,0,0,0,0,0,0,0,0,0,0
20200312,07058P,台積電凱基9A售07,2.46,2.69,2.46,2.48,+0.17,7.36,316000,19,824460,0,0,0,0,0,0,50000,316000,-266000,-266000
20200312,07059P,華通國票9A售02,2.15,2.22,2.15,2.22,0.00,0.00,39000,4,85230,0,0,0,0,0,0,0,39000,-39000,-39000
20200312,07060P,台表科國票9A售01,1.57,1.89,1.57,1.89,+0.44,30.34,319000,18,537550,0,0,0,0,0,0,0,319000,-319000,-319000
20200312,07061P,台積電元大99售14,5.75,6.10,5.75,6.10,+1.10,22.0,152000,11,892600,0,0,0,0,0,0,32000,135000,-103000,-103000
20200312,07062P,台積電元大99售15,1.98,2.40,1.96,2.19,+0.40,22.35,454000,17,973790,0,0,0,0,0,0,448000,451000,-3000,-3000
20200312,07063P,臺股指元大9A售24,,,,,0.00,0.00,0,0,0,0,0,0,0,0,0,0,0,0,0
20200312,07064P,臺股指元大9A售25,7.00,7.00,7.00,7.00,0.00,0.00,1000,1,7000,0,0,0,0,0,0,0,1000,-1000,-1000
20200312,07065P,臺股指元大9A售26,10.50,11.00,10.50,11.00,+1.75,18.92,7000,4,74900,0,0,0,0,0,0,1000,6000,-5000,-5000
20200312,07066P,台灣50台新9B售01,2.15,2.57,2.15,2.57,+0.91,54.82,514000,9,1253190,0,0,0,0,0,0,510000,513000,-3000,-3000
20200312,07067P,旺宏台新99售02,1.24,1.48,1.24,1.48,+0.32,27.59,18000,4,23660,0,0,0,0,0,0,5000,13000,-8000,-8000
20200312,07068P,欣興台新99售01,2.28,2.33,2.28,2.33,+0.27,13.11,33000,4,75790,0,0,0,0,0,0,0,33000,-33000,-33000
20200312,07069P,欣興元富99售02,4.03,4.12,4.03,4.12,+0.65,18.73,13000,2,52930,0,0,0,0,0,0,7000,6000,1000,1000
20200312,07070P,晶相光元富99售01,3.04,3.51,2.98,3.38,+0.39,13.04,151000,23,475010,0,0,0,0,0,0,64000,87000,-23000,-23000
20200312,07071P,立積元富99售01,1.91,2.12,1.89,2.12,+0.32,17.78,117000,17,229240,0,0,0,0,0,0,26000,91000,-65000,-65000
20200312,07072P,元油2X凱基9C售01,,,,,0.00,0.00,0,0,0,0,0,0,0,0,0,0,0,0,0
20200312,07073P,臺股指中信9B售02,1.67,2.11,1.67,2.11,0.00,0.00,463000,9,802930,0,0,0,0,0,0,0,463000,-463000,-463000
20200312,07074P,FBVIX凱基9A售01,1.24,1.24,1.16,1.19,-0.07,-5.56,725000,38,864110,0,0,0,0,0,0,8000,717000,-709000,-709000
20200312,07075P,FBVIX凱基9C售04,1.01,1.02,1.00,1.02,-0.05,-4.67,43000,4,43740,0,0,0,0,0,0,10000,33000,-23000,-23000
20200312,07076P,鴻海凱基9A售08,,,,,0.00,0.00,0,0,0,0,0,0,0,0,0,0,0,0,0
20200312,07077P,緯穎凱基99售01,1.67,1.83,1.67,1.77,0.00,0.00,217000,5,388590,0,0,0,0,0,0,0,217000,-217000,-217000
20200312,07078P,鴻海群益99售02,,,,,0.00,0.00,0,0,0,0,0,0,0,0,0,0,0,0,0
20200312,07079P,台積電群益99售06,6.10,6.15,6.00,6.15,+0.70,12.84,105000,3,635750,0,0,0,0,0,0,100000,105000,-5000,-5000
20200312,07080P,健策群益9A售01,1.79,1.86,1.79,1.86,+0.16,9.41,166000,8,305620,0,0,0,0,0,0,72000,94000,-22000,-22000
20200312,07081P,南電群益9A售01,1.68,1.84,1.68,1.84,+0.30,19.48,156000,6,268880,0,0,0,0,0,0,20000,136000,-116000,-116000
20200312,07082P,美律元大99售06,1.33,1.41,1.33,1.41,+0.22,18.49,8000,2,10880,0,0,0,0,0,0,5000,3000,2000,2000
20200312,07083P,台積電統一9A售06,1.29,1.44,1.29,1.36,+0.25,22.52,337000,8,460700,0,0,0,0,0,0,60000,327000,-267000,-267000
20200312,07084P,S&P正2元富9B售02,1.25,1.43,1.25,1.40,+0.28,25.0,96000,9,128610,0,0,0,0,0,0,23000,73000,-50000,-50000
20200312,07085P,超眾元富9C售01,3.10,3.24,3.10,3.24,0.00,0.00,24000,3,75800,0,0,0,0,0,0,0,24000,-24000,-24000
20200312,07086P,力成元富9C售01,,,,,0.00,0.00,0,0,0,0,0,0,0,0,0,0,0,0,0
20200312,07087P,聯發科台新99售02,1.41,1.68,1.41,1.68,0.00,0.00,47000,4,71220,0,0,0,0,0,0,0,47000,-47000,-47000
20200312,07088P,訊芯永豐99售02,1.21,1.21,1.21,1.21,+0.18,17.48,1000,1,1210,0,0,0,0,0,0,1000,0,1000,1000
20200312,07089P,臺指2X中信01售01,,,,,0.00,0.00,0,0,0,0,0,0,0,0,0,0,0,0,0
20200312,07090P,台灣50凱基01售01,3.91,4.04,3.91,4.04,+0.87,27.44,104000,4,411840,0,0,0,0,0,0,40000,104000,-64000,-64000
20200312,07091P,SGBR2X凱基9A售02,2.83,2.83,2.79,2.79,+1.33,91.1,3000,3,8430,0,0,0,0,0,0,0,3000,-3000,-3000
20200312,07092P,上銀凱基99售03,,,,,0.00,0.00,0,0,0,0,0,0,0,0,0,0,0,0,0
20200312,07093P,台積電凱基99售07,2.27,2.37,2.27,2.37,+0.57,31.67,3000,2,6910,0,0,0,0,0,0,0,3000,-3000,-3000
20200312,07094P,華通國票9A售03,1.46,1.73,1.46,1.73,+0.74,74.75,21000,3,31830,0,0,0,0,0,0,0,21000,-21000,-21000
20200312,07095P,台灣50元大9C售03,4.73,5.70,4.73,5.70,+2.81,97.23,258000,9,1232680,0,0,0,0,0,0,40000,258000,-218000,-218000
20200312,07096P,元石油元大9C售05,,,,,0.00,0.00,0,0,0,0,0,0,0,0,0,0,0,0,0
20200312,07097P,元油2X元大9C售09,,,,,0.00,0.00,0,0,0,0,0,0,0,0,0,0,0,0,0
20200312,07098P,台積電元大99售18,1.68,1.70,1.68,1.70,+0.50,41.67,27000,2,45400,0,0,0,0,0,0,25000,27000,-2000,-2000
20200312,07099P,台積電元大99售19,4.70,4.70,4.70,4.70,+1.22,35.06,25000,1,117500,0,0,0,0,0,0,25000,25000,0,0
20200312,07100P,華航元大99售01,1.14,1.26,1.14,1.25,+0.21,20.19,332000,13,410360,0,0,0,0,0,0,100000,332000,-232000,-232000
20200312,07101P,台郡元大99售06,1.36,1.48,1.36,1.48,+0.32,27.59,137000,8,200750,0,0,0,0,0,0,68000,137000,-69000,-69000
20200312,07102P,南電元大99售03,4.30,4.30,4.30,4.30,+1.17,37.38,2000,1,8600,0,0,0,0,0,0,0,2000,-2000,-2000
20200312,07103P,南電元大99售04,,,,,0.00,0.00,0,0,0,0,0,0,0,0,0,0,0,0,0
20200312,07104P,聯發科元富99售04,2.21,2.43,2.21,2.43,+0.44,22.11,300000,7,672600,0,0,0,0,0,0,0,300000,-300000,-300000
20200312,07105P,大毅元富99售02,1.33,1.33,1.33,1.33,+0.19,16.67,15000,1,19950,0,0,0,0,0,0,0,15000,-15000,-15000
20200312,07106P,國巨統一9B售05,1.01,1.18,1.00,1.13,+0.27,31.4,204000,16,212260,0,0,0,0,0,0,0,204000,-204000,-204000
20200312,07107P,臺股指統一99售07,2.37,2.47,2.24,2.47,+1.44,139.81,51000,6,116970,0,0,0,0,0,0,0,51000,-51000,-51000
20200312,07108P,FBVIX台新99售02,,,,,0.00,0.00,0,0,0,0,0,0,0,0,0,0,0,0,0
20200312,07154P,台灣50群益94售01,,,,,0.00,0.00,0,0,0,0,0,0,0,0,0,0,0,0,0
20200312,07240P,台灣50台新94售01,0.02,0.08,0.02,0.08,+0.05,166.67,391000,8,8880,0,0,0,0,0,0,0,1000,-1000,-1000
20200312,07480P,FBVIX凱基94售01,0.16,0.19,0.14,0.18,-0.04,-18.18,1178000,41,196900,0,0,0,0,0,0,0,715000,-715000,-715000
20200312,07554P,玉晶光元大9A售06,,,,,0.00,0.00,0,0,0,0,0,0,0,0,0,0,0,0,0
20200312,07866P,上証2X國票97售01,0.04,0.04,0.04,0.04,0.00,0.00,215000,1,8600,0,0,0,0,0,0,215000,0,215000,215000
20200312,08070P,晶技國泰9C售02,,,,,0.00,0.00,0,0,0,0,0,0,0,0,0,0,0,0,0
20200312,08100P,台灣50元富95售01,0.04,0.09,0.04,0.09,+0.05,125.0,739000,73,50760,0,0,0,0,0,0,9000,710000,-701000,-701000
20200312,08163P,T50正2中信95售01,0.11,0.17,0.11,0.14,0.00,0.00,410000,10,53900,0,0,0,0,0,0,400000,10000,390000,390000
20200312,08164P,滬深2X中信95售04,0.03,0.04,0.03,0.03,0.00,0.00,40000,4,1300,0,0,0,0,0,0,0,30000,-30000,-30000
20200312,08213P,台光電統一9B售03,0.32,0.32,0.32,0.32,0.00,0.00,6000,2,1920,0,0,0,0,0,0,5000,1000,4000,4000
20200312,08217P,T50反1凱基96售02,,,,,0.00,0.00,0,0,0,0,0,0,0,0,0,0,0,0,0
20200312,08218P,滬深2X凱基96售01,0.37,0.44,0.37,0.43,+0.08,22.86,355000,14,138590,0,0,0,0,0,0,307000,15000,292000,292000
20200312,08416P,T50反1元大9C售07,,,,,0.00,0.00,0,0,0,0,0,0,0,0,0,0,0,0,0
20200312,08446P,台灣50富邦01售02,,,,,0.00,0.00,0,0,0,0,0,0,0,0,0,0,0,0,0
20200312,08447P,緯穎永豐9C售02,0.04,0.06,0.04,0.05,0.00,0.00,1029000,7,49260,0,0,0,0,0,0,679000,0,679000,679000
20200312,08452P,智邦台新9C售05,,,,,0.00,0.00,0,0,0,0,0,0,0,0,0,0,0,0,0
20200312,08476P,臺股指凱基9C售14,,,,,0.00,0.00,0,0,0,0,0,0,0,0,0,0,0,0,0
20200312,08477P,臺股指凱基9C售15,,,,,0.00,0.00,0,0,0,0,0,0,0,0,0,0,0,0,0
20200312,08478P,臺股指凱基9C售16,,,,,0.00,0.00,0,0,0,0,0,0,0,0,0,0,0,0,0
20200312,08481P,臺股指凱基9C售19,,,,,0.00,0.00,0,0,0,0,0,0,0,0,0,0,0,0,0
20200312,08484P,台灣50中信96售01,0.23,0.45,0.22,0.45,+0.27,150.0,2576000,42,697370,0,0,0,0,0,0,2183000,0,2183000,2183000
20200312,08488P,臺股指群益9C售19,5.30,5.60,5.30,5.60,+0.87,18.39,12000,2,66900,0,0,0,0,0,0,12000,0,12000,12000
20200312,08495P,同欣電元大9C售08,,,,,0.00,0.00,0,0,0,0,0,0,0,0,0,0,0,0,0
20200312,08506P,台灣50中信96售02,0.15,0.17,0.15,0.17,+0.02,13.33,91000,8,13920,0,0,0,0,0,0,79000,0,79000,79000
20200312,08519P,台灣50元大9C售46,,,,,0.00,0.00,0,0,0,0,0,0,0,0,0,0,0,0,0
20200312,08525P,台灣50凱基96售02,0.19,0.25,0.19,0.21,+0.05,31.25,103000,9,23200,0,0,0,0,0,0,52000,20000,32000,32000
20200312,08539P,元油2X國票99售01,3.23,3.50,3.23,3.50,+0.70,25.0,31000,3,108230,0,0,0,0,0,0,11000,0,11000,11000
20200312,08570P,台灣50凱基96售03,0.07,0.07,0.07,0.07,0.00,0.00,2000,1,140,0,0,0,0,0,0,2000,0,2000,2000
20200312,08591P,台光電凱基9C售02,,,,,0.00,0.00,0,0,0,0,0,0,0,0,0,0,0,0,0
20200312,08592P,聯發科凱基01售06,,,,,0.00,0.00,0,0,0,0,0,0,0,0,0,0,0,0,0
20200312,08599P,台表科元大9C售11,,,,,0.00,0.00,0,0,0,0,0,0,0,0,0,0,0,0,0
20200312,08602P,台灣50凱基96售04,0.25,0.40,0.25,0.38,0.00,0.00,152000,5,54260,0,0,0,0,0,0,152000,0,152000,152000
20200312,08609P,世紀鋼永豐9C售03,0.10,0.14,0.05,0.14,0.00,0.00,622000,6,37270,0,0,0,0,0,0,0,2000,-2000,-2000
20200312,08612P,嘉晶凱基9C售03,,,,,0.00,0.00,0,0,0,0,0,0,0,0,0,0,0,0,0
20200312,08613P,同欣電凱基9C售04,,,,,0.00,0.00,0,0,0,0,0,0,0,0,0,0,0,0,0
20200312,08614P,聯發科統一9C售18,,,,,0.00,0.00,0,0,0,0,0,0,0,0,0,0,0,0,0
20200312,08617P,緯創元富9C售03,,,,,0.00,0.00,0,0,0,0,0,0,0,0,0,0,0,0,0
20200312,08625P,台灣50凱基96售05,0.48,0.65,0.45,0.53,+0.23,76.67,46000,7,25580,0,0,0,0,0,0,20000,24000,-4000,-4000
20200312,08631P,臺股指麥證9C售06,,,,,0.00,0.00,0,0,0,0,0,0,0,0,0,0,0,0,0
20200312,08637P,台灣50中信96售03,0.72,1.01,0.72,0.91,+0.28,44.44,6195000,226,5395740,10000,0,10000,0,0,0,4113000,1520000,2593000,2603000
20200312,08653P,台灣50凱基96售07,0.40,0.74,0.40,0.74,+0.39,111.43,330000,20,178340,0,0,0,0,0,0,122000,0,122000,122000
20200312,08663P,台灣50元大96售01,0.45,0.67,0.39,0.62,+0.27,77.14,2229000,110,1300740,0,0,0,0,0,0,1605000,700000,905000,905000
20200312,08671P,友訊國票01售01,0.10,0.16,0.10,0.15,+0.09,150.0,186000,11,24700,0,0,0,0,0,0,130000,20000,110000,110000
20200312,08672P,聯發科統一01售09,0.04,0.12,0.04,0.08,+0.06,300.0,217000,11,16770,0,0,0,0,0,0,197000,20000,177000,177000
20200312,08674P,嘉晶元富07售02,0.58,0.98,0.56,0.85,+0.34,66.67,2344000,179,1833630,0,0,0,0,0,0,1529000,1002000,527000,527000
20200312,08679P,台灣50元大01售15,0.25,0.42,0.25,0.36,+0.15,71.43,1651000,63,563730,0,0,0,0,0,0,1161000,0,1161000,1161000
20200312,08703P,華碩凱基01售02,0.15,0.16,0.15,0.16,+0.03,23.08,100000,2,15500,0,0,0,0,0,0,100000,0,100000,100000
20200312,08714P,華碩元富01售03,0.34,0.41,0.29,0.37,+0.23,164.29,629000,16,231790,0,0,0,0,0,0,528000,1000,527000,527000
20200312,08749P,鴻海台新01售02,0.27,0.28,0.27,0.28,+0.06,27.27,34000,2,9220,0,0,0,0,0,0,34000,0,34000,34000
20200312,08750P,台灣50群益01售04,,,,,0.00,0.00,0,0,0,0,0,0,0,0,0,0,0,0,0
20200312,08751P,友達群益01售01,,,,,0.00,0.00,0,0,0,0,0,0,0,0,0,0,0,0,0
20200312,08795P,聯發科凱基01售11,0.12,0.20,0.12,0.17,+0.07,70.0,1025000,25,149450,0,0,0,0,0,0,985000,40000,945000,945000
20200312,08801P,聯發科元大01售13,,,,,0.00,0.00,0,0,0,0,0,0,0,0,0,0,0,0,0
20200312,08818P,台灣50元大97售01,0.25,0.39,0.25,0.37,+0.15,68.18,4821000,115,1562740,0,100000,-100000,0,0,0,3864000,0,3864000,3764000
20200312,08852P,台灣50台新01售01,0.59,0.80,0.55,0.75,+0.26,53.06,1787000,63,1275480,0,0,0,0,0,0,1452000,60000,1392000,1392000
20200312,08859P,大立光元富94售02,,,,,0.00,0.00,0,0,0,0,0,0,0,0,0,0,0,0,0
20200312,08864P,台積電中信95售03,,,,,0.00,0.00,0,0,0,0,0,0,0,0,0,0,0,0,0
20200312,08865P,台積電中信95售04,0.01,0.01,0.01,0.01,0.00,0.00,947000,16,9470,0,0,0,0,0,0,0,0,0,0
20200312,08890P,大立光富邦93售01,,,,,0.00,0.00,0,0,0,0,0,0,0,0,0,0,0,0,0
20200312,08897P,鴻海凱基94售02,0.25,0.33,0.25,0.30,+0.15,100.0,270000,5,74100,0,0,0,0,0,0,250000,20000,230000,230000
20200312,08941P,大立光永昌93售05,,,,,0.00,0.00,0,0,0,0,0,0,0,0,0,0,0,0,0
20200312,08962P,台積電統一93售01,,,,,0.00,0.00,0,0,0,0,0,0,0,0,0,0,0,0,0
20200312,08966P,臻鼎元富94售02,0.13,0.23,0.13,0.23,0.00,0.00,101000,2,23030,0,0,0,0,0,0,0,101000,-101000,-101000
20200312,08967P,上銀富邦93售02,,,,,0.00,0.00,0,0,0,0,0,0,0,0,0,0,0,0,0
20200312,08974P,祥碩凱基93售02,,,,,0.00,0.00,0,0,0,0,0,0,0,0,0,0,0,0,0
20200312,08986P,上銀凱基93售02,,,,,0.00,0.00,0,0,0,0,0,0,0,0,0,0,0,0,0
20200312,08994P,臺股指統一93售01,,,,,0.00,0.00,0,0,0,0,0,0,0,0,0,0,0,0,0
20200312,08995P,臺股指統一93售02,0.05,0.20,0.05,0.20,+0.15,300.0,841000,10,82190,0,0,0,0,0,0,541000,0,541000,541000
20200312,08998P,台灣50國泰93售01,0.01,0.02,0.01,0.01,0.00,0.00,785000,13,8350,0,0,0,0,0,0,395000,0,395000,395000
20200312,1101,台泥,41.70,41.80,40.40,40.75,-1.05,-2.51,29637367,10800,1215770160,10663328,19894708,-9231380,513000,0,513000,4473000,335998,4137002,-4581378
20200312,1101B,台泥乙特,53.80,54.10,53.70,54.10,0.00,0.00,93686,48,5043169,0,0,0,0,0,0,18000,30000,-12000,-12000
20200312,1102,亞泥,42.30,42.35,41.40,41.40,-1.15,-2.7,15453135,5816,643959266,7873869,11274246,-3400377,135000,0,135000,3224000,390000,2834000,-431377
20200312,1103,嘉泥,18.30,18.30,17.45,17.45,-1.05,-5.68,2687278,1197,47595366,394000,939000,-545000,0,0,0,30000,21000,9000,-536000
20200312,1104,環泥,16.95,17.00,16.50,16.65,-0.45,-2.63,750882,416,12516329,29000,176000,-147000,0,0,0,0,0,0,-147000
20200312,1108,幸福,7.39,7.39,7.13,7.13,-0.26,-3.52,115000,52,829300,4000,4000,0,0,0,0,0,0,0,0
20200312,1109,信大,16.70,16.70,15.90,16.10,-0.75,-4.45,474404,258,7681814,24000,208000,-184000,0,0,0,0,0,0,-184000
20200312,1110,東泥,16.00,16.00,15.20,15.65,-0.75,-4.57,662220,74,10468031,2000,39000,-37000,0,0,0,4000,25000,-21000,-58000
20200312,1201,味全,20.00,20.00,19.00,19.40,-0.90,-4.43,3879794,1746,75087125,339000,650000,-311000,0,0,0,0,14000,-14000,-325000
20200312,1203,味王,26.50,26.50,26.30,26.40,-0.10,-0.38,397219,160,10491923,14000,54000,-40000,0,0,0,0,0,0,-40000
20200312,1210,大成,38.45,38.45,37.20,37.40,-1.30,-3.36,4082834,2203,153615995,297000,1178000,-881000,0,0,0,0,123000,-123000,-1004000
20200312,1213,大飲,5.48,5.91,5.48,5.91,0.00,0.00,37003,20,204715,0,0,0,0,0,0,0,0,0,0
20200312,1215,卜蜂,59.80,59.80,57.20,57.20,-2.70,-4.51,1688057,1326,97741696,192187,299000,-106813,0,300000,-300000,0,50000,-50000,-456813
20200312,1216,統一,72.70,72.70,68.90,70.30,-2.60,-3.57,19721933,8636,1389580549,10580502,15734593,-5154091,50000,0,50000,73000,141000,-68000,-5172091
20200312,1217,愛之味,7.14,7.16,6.67,6.72,-0.45,-6.28,8178440,2377,56167133,611000,820000,-209000,0,0,0,0,0,0,-209000
20200312,1218,泰山,23.65,23.80,22.10,22.55,-1.45,-6.04,2414625,1081,54953770,1150000,311000,839000,0,0,0,6000,33000,-27000,812000
20200312,1219,福壽,18.20,18.20,17.90,17.95,-0.25,-1.37,808013,34,14546923,3000,6000,-3000,0,0,0,0,0,0,-3000
20200312,1220,台榮,10.25,10.25,9.91,10.00,-0.25,-2.44,338045,123,3388603,7000,11000,-4000,0,0,0,0,0,0,-4000
20200312,1225,福懋油,32.65,32.65,30.40,30.75,-1.90,-5.82,144291,129,4522839,4000,41000,-37000,0,0,0,0,0,0,-37000
20200312,1227,佳格,61.50,61.50,58.70,60.80,-1.40,-2.25,2911972,1930,174722175,1573122,1382000,191122,0,0,0,6000,20000,-14000,177122
20200312,1229,聯華,36.70,36.70,35.55,35.60,-1.30,-3.52,4420697,2693,158457317,469000,1078000,-609000,0,0,0,8000,8000,0,-609000
20200312,1231,聯華食,40.00,40.00,38.45,38.60,-1.40,-3.5,666764,574,25801499,38460,139363,-100903,0,0,0,0,1000,-1000,-101903
20200312,1232,大統益,121.00,121.00,116.00,117.00,-4.00,-3.31,321437,366,37774279,12000,43000,-31000,0,0,0,0,2000,-2000,-33000
20200312,1233,天仁,37.55,37.55,36.90,37.10,-0.60,-1.59,69242,61,2572776,1000,6000,-5000,0,0,0,0,0,0,-5000
20200312,1234,黑松,31.90,31.90,31.20,31.45,-0.45,-1.41,153269,108,4802256,10000,65000,-55000,0,0,0,0,3000,-3000,-58000
20200312,1235,興泰,22.55,24.45,22.55,24.40,+1.45,6.32,55946,43,1309643,0,3000,-3000,0,0,0,0,0,0,-3000
20200312,1236,宏亞,12.60,12.80,12.35,12.35,-0.45,-3.52,31648,47,395832,1000,1000,0,0,0,0,0,0,0,0
20200312,1256,鮮活果汁-KY,198.00,198.00,190.00,193.50,-5.50,-2.76,232732,457,44890740,10000,98000,-88000,0,0,0,0,0,0,-88000
20200312,1301,台塑,88.00,88.00,83.70,84.00,-4.90,-5.51,17004759,9071,1446539102,3503943,11061314,-7557371,77000,64000,13000,124000,302000,-178000,-7722371
20200312,1303,南亞,66.40,66.40,63.60,63.80,-2.50,-3.77,11400229,6207,734135429,4541558,7986752,-3445194,61000,0,61000,106000,245000,-139000,-3523194
20200312,1304,台聚,11.40,11.40,10.75,10.75,-0.75,-6.52,3691232,1170,40608174,131000,738000,-607000,0,0,0,96000,117000,-21000,-628000
20200312,1305,華夏,18.70,18.70,17.70,17.80,-1.10,-5.82,2278173,1182,41029914,180000,524000,-344000,0,0,0,0,35000,-35000,-379000
20200312,1307,三芳,20.20,20.20,19.00,19.30,-1.30,-6.31,387335,263,7592212,1000,100000,-99000,0,0,0,0,0,0,-99000
20200312,1308,亞聚,14.80,14.80,14.35,14.40,-0.45,-3.03,1965253,833,28484635,194000,363000,-169000,0,0,0,3000,45000,-42000,-211000
20200312,1309,台達化,9.26,9.26,8.83,8.88,-0.38,-4.1,1639507,553,14691001,85000,319000,-234000,0,0,0,0,4000,-4000,-238000
20200312,1310,台苯,17.60,17.60,16.70,16.70,-1.15,-6.44,4314073,1937,73259841,58000,1381000,-1323000,0,0,0,0,4000,-4000,-1327000
20200312,1312,國喬,14.70,14.70,13.90,14.05,-0.95,-6.33,7082380,2258,100332178,528000,1782000,-1254000,0,0,0,39000,17000,22000,-1232000
20200312,1312A,國喬特,33.65,34.10,33.65,34.10,-0.10,-0.29,2000,2,67750,0,0,0,0,0,0,1000,0,1000,1000
20200312,1313,聯成,9.18,9.18,8.55,8.65,-0.55,-5.98,3496395,1155,30488781,273000,623000,-350000,0,0,0,0,0,0,-350000
20200312,1314,中石化,7.75,7.76,7.24,7.25,-0.58,-7.41,31505451,7264,233095628,1958000,5805000,-3847000,9000,0,9000,69000,855000,-786000,-4624000
20200312,1315,達新,47.20,47.25,45.40,45.45,-2.50,-5.21,955366,550,44029480,133000,190000,-57000,0,0,0,1000,2000,-1000,-58000
20200312,1316,上曜,11.80,11.90,10.80,10.90,-1.05,-8.79,1793546,579,19998556,144000,142000,2000,0,0,0,1000,1000,0,2000
20200312,1319,東陽,37.50,37.50,35.30,35.60,-1.95,-5.19,1619470,1088,58225890,183000,730000,-547000,0,87000,-87000,23000,30000,-7000,-641000
20200312,1321,大洋,28.80,28.80,26.40,26.40,-2.20,-7.69,977000,436,26561850,140000,125000,15000,0,0,0,0,1000,-1000,14000
20200312,1323,永裕,31.85,32.00,30.90,31.45,-1.05,-3.23,292000,171,9221550,6000,46000,-40000,0,0,0,0,0,0,-40000
20200312,1324,地球,9.14,9.14,8.53,8.53,-0.64,-6.98,69005,73,604873,0,15000,-15000,0,0,0,3000,0,3000,-12000
20200312,1325,恆大,39.20,41.30,36.10,37.75,-1.20,-3.08,25693465,13561,1004809269,484000,1328000,-844000,0,0,0,0,0,0,-844000
20200312,1326,台化,77.20,77.20,74.50,75.10,-2.40,-3.1,12843144,6480,968212874,2365939,8509891,-6143952,94000,0,94000,1215000,163000,1052000,-4997952
20200312,1337,再生-KY,4.52,4.52,4.08,4.12,-0.40,-8.85,1357408,439,5660060,18000,87000,-69000,0,0,0,0,8000,-8000,-77000
20200312,1338,廣華-KY,50.80,52.20,47.10,47.30,-4.90,-9.39,466166,335,22589220,72000,58000,14000,0,0,0,0,0,0,14000
20200312,1339,昭輝,43.80,43.80,40.95,41.00,-2.90,-6.61,561550,402,23375509,82000,146000,-64000,0,0,0,0,0,0,-64000
20200312,1340,勝悅-KY,11.25,11.25,10.45,10.45,-1.15,-9.91,669045,357,7153151,19000,47000,-28000,0,0,0,0,3000,-3000,-31000
20200312,1341,富林-KY,59.00,59.00,58.20,58.20,-1.40,-2.35,3018,17,177247,0,1000,-1000,0,0,0,0,0,0,-1000
20200312,1402,遠東新,26.95,26.95,25.20,25.30,-1.90,-6.99,13310396,5648,343280930,2790857,7744309,-4953452,42000,0,42000,81000,207000,-126000,-5037452
20200312,1409,新纖,11.60,11.65,11.05,11.20,-0.60,-5.08,3836644,1329,43223558,406000,758000,-352000,0,0,0,0,21000,-21000,-373000
20200312,1410,南染,28.80,28.80,28.40,28.55,-0.35,-1.21,72038,29,2049664,20000,1000,19000,0,0,0,1000,0,1000,20000
20200312,1413,宏洲,8.04,8.04,7.80,7.80,-0.48,-5.8,234500,83,1863030,7000,7000,0,0,0,0,0,1000,-1000,-1000
20200312,1414,東和,6.52,6.52,6.21,6.22,-0.35,-5.33,295529,99,1881266,6000,12000,-6000,0,0,0,0,0,0,-6000
20200312,1416,廣豐,13.00,13.15,12.20,12.20,-1.35,-9.96,1336567,672,16618715,10000,9000,1000,0,0,0,0,0,0,1000
20200312,1417,嘉裕,9.30,9.31,8.92,9.06,-0.46,-4.83,587525,300,5353395,1000,69000,-68000,0,0,0,0,1000,-1000,-69000
20200312,1418,東華,,,,,0.00,0.00,111,13,666,0,0,0,0,0,0,0,0,0,0
20200312,1419,新紡,39.85,40.20,39.60,40.05,+0.05,0.12,16005,19,637995,7000,0,7000,0,0,0,0,0,0,7000
20200312,1423,利華,10.10,10.10,9.70,9.98,-0.07,-0.7,228010,60,2262291,23000,1000,22000,0,0,0,0,0,0,22000
20200312,1432,大魯閣,5.43,5.43,5.03,5.12,-0.46,-8.24,504000,130,2561590,33000,3000,30000,0,0,0,0,0,0,30000
20200312,1434,福懋,31.70,31.85,30.75,30.80,-1.40,-4.35,2956597,1860,91967230,1172504,1686316,-513812,8000,0,8000,24000,19000,5000,-500812
20200312,1435,中福,7.91,7.91,7.61,7.62,-0.83,-9.82,984536,294,7537741,12000,75000,-63000,0,0,0,0,0,0,-63000
20200312,1436,華友聯,37.20,38.10,36.00,37.95,-0.20,-0.52,243132,202,8920060,14000,30000,-16000,0,0,0,0,0,0,-16000
20200312,1437,勤益控,21.50,21.50,20.30,20.40,-1.15,-5.34,632323,226,13041056,5000,59000,-54000,0,0,0,0,0,0,-54000
20200312,1438,裕豐,11.35,11.95,10.50,11.05,-0.25,-2.21,33338,20,379749,0,9000,-9000,0,0,0,0,0,0,-9000
20200312,1439,中和,33.75,33.75,30.70,31.90,-1.60,-4.78,631490,380,20283280,54000,170000,-116000,0,0,0,0,2000,-2000,-118000
20200312,1440,南紡,9.86,9.86,9.40,9.50,-0.42,-4.23,1818457,609,17311557,86000,292000,-206000,0,0,0,0,8000,-8000,-214000
20200312,1441,大東,8.88,8.90,8.14,8.20,-0.50,-5.75,371953,196,3113716,13000,33000,-20000,0,0,0,0,0,0,-20000
20200312,1442,名軒,16.95,16.95,15.80,16.05,-0.90,-5.31,1027198,307,16537787,105000,125000,-20000,0,0,0,0,0,0,-20000
20200312,1443,立益,9.31,9.31,9.00,9.00,-0.28,-3.02,260005,33,2341000,0,0,0,0,0,0,0,0,0,0
20200312,1444,力麗,8.45,8.45,8.00,8.05,-0.52,-6.07,2412708,770,19738695,300000,468000,-168000,0,0,0,0,0,0,-168000
20200312,1445,大宇,6.98,7.00,6.80,6.80,-0.21,-3.0,338006,83,2345226,8000,21000,-13000,0,0,0,0,0,0,-13000
20200312,1446,宏和,28.35,28.35,25.85,25.85,-2.85,-9.93,609283,420,16284658,35000,63000,-28000,0,0,0,0,1000,-1000,-29000
20200312,1447,力鵬,6.20,6.20,5.90,5.95,-0.26,-4.19,2258184,432,13499548,22000,219000,-197000,0,0,0,0,0,0,-197000
20200312,1449,佳和,11.20,11.30,10.70,10.70,-0.95,-8.15,954608,354,10522524,89000,110000,-21000,0,0,0,1000,0,1000,-20000
20200312,1451,年興,19.70,19.70,19.00,19.15,-0.70,-3.53,175527,135,3358668,10000,22000,-12000,0,0,0,0,0,0,-12000
20200312,1452,宏益,18.15,18.20,17.95,18.00,-0.40,-2.17,475266,288,8577534,5000,66000,-61000,0,0,0,0,4000,-4000,-65000
20200312,1453,大將,7.71,7.85,7.60,7.60,-0.33,-4.16,16706,24,128295,1000,6000,-5000,0,0,0,0,0,0,-5000
20200312,1454,台富,7.38,7.38,7.10,7.13,-0.32,-4.3,170199,87,1227824,3000,11000,-8000,0,0,0,0,0,0,-8000
20200312,1455,集盛,6.41,6.41,5.94,6.00,-0.46,-7.12,2890773,640,17473590,224000,192000,32000,0,0,0,0,38000,-38000,-6000
20200312,1456,怡華,8.50,8.50,8.18,8.20,-0.88,-9.69,337000,94,2760180,0,0,0,0,0,0,0,0,0,0
20200312,1457,宜進,13.00,13.00,12.35,12.45,-0.60,-4.6,881267,342,11077885,60000,88000,-28000,0,0,0,0,1000,-1000,-29000
20200312,1459,聯發,6.88,6.88,6.57,6.68,-0.20,-2.91,80000,55,534050,0,21000,-21000,0,0,0,0,0,0,-21000
20200312,1460,宏遠,7.16,7.19,6.63,6.69,-0.66,-8.98,2104200,690,14371524,138000,158000,-20000,0,0,0,1000,5000,-4000,-24000
20200312,1463,強盛,12.70,12.70,12.20,12.20,-0.50,-3.94,313000,151,3844650,3000,16000,-13000,0,0,0,0,3000,-3000,-16000
20200312,1464,得力,21.60,21.80,20.80,20.85,-1.35,-6.08,2438483,1081,51798281,108000,335000,-227000,0,0,0,0,55000,-55000,-282000
20200312,1465,偉全,14.90,15.45,14.60,14.85,-0.60,-3.88,183750,102,2738874,0,1000,-1000,0,0,0,0,0,0,-1000
20200312,1466,聚隆,7.24,7.24,7.12,7.12,-0.34,-4.56,57006,41,409922,2000,14000,-12000,0,0,0,0,4000,-4000,-16000
20200312,1467,南緯,7.21,7.21,6.70,7.07,-0.11,-1.53,1120005,195,7836765,0,14000,-14000,0,0,0,0,8000,-8000,-22000
20200312,1468,昶和,9.70,9.92,9.70,9.86,-0.12,-1.2,11001,10,108269,0,2000,-2000,0,0,0,0,0,0,-2000
20200312,1470,大統新創,20.20,20.25,19.00,19.20,-0.80,-4.0,20000,9,391550,0,8000,-8000,0,0,0,0,0,0,-8000
20200312,1471,首利,1.91,1.91,1.85,1.85,-0.20,-9.76,74111,36,138454,0,0,0,0,0,0,0,0,0,0
20200312,1472,三洋紡,21.00,21.50,19.15,20.95,-0.30,-1.41,111676,97,2231138,3000,3000,0,0,0,0,0,1000,-1000,-1000
20200312,1473,台南,27.30,27.30,25.45,25.55,-1.75,-6.41,544934,315,14127618,134000,76000,58000,0,0,0,2000,4000,-2000,56000
20200312,1474,弘裕,9.70,9.77,8.84,8.85,-0.97,-9.88,816346,321,7344471,34000,17000,17000,0,0,0,2000,2000,0,17000
20200312,1475,本盟,7.81,7.81,7.38,7.38,-0.81,-9.89,14000,8,104730,0,0,0,0,0,0,0,0,0,0
20200312,1476,儒鴻,325.50,325.50,299.00,301.50,-30.00,-9.05,2021303,1767,622549809,796369,994023,-197654,1000,178000,-177000,23000,114000,-91000,-465654
20200312,1477,聚陽,131.50,131.50,121.00,125.00,-9.00,-6.72,3930823,2833,493017021,1155950,1067000,88950,0,57000,-57000,79000,58000,21000,52950
20200312,1503,士電,41.60,41.90,40.25,40.50,-1.55,-3.69,230420,193,9401393,12000,80000,-68000,0,0,0,0,18000,-18000,-86000
20200312,1504,東元,25.00,25.10,24.55,24.80,-0.70,-2.75,14419218,2464,357764746,2031000,11845000,-9814000,11000,0,11000,6000,6000,0,-9803000
20200312,1506,正道,12.10,12.45,11.25,11.75,-0.65,-5.24,100415,74,1165964,0,2000,-2000,0,0,0,0,1000,-1000,-3000
20200312,1507,永大,56.20,56.20,53.50,54.70,-1.70,-3.01,242128,224,13187758,53000,151000,-98000,0,0,0,0,42000,-42000,-140000
20200312,1512,瑞利,3.80,3.80,3.76,3.80,-0.06,-1.55,94031,43,357044,0,0,0,0,0,0,0,0,0,0
20200312,1513,中興電,24.50,24.50,23.00,23.45,-1.15,-4.67,7927725,2293,185767083,1458000,688000,770000,0,0,0,35000,74000,-39000,731000
20200312,1514,亞力,18.30,18.30,17.30,17.60,-1.00,-5.38,2892233,1137,51178774,462000,417000,45000,0,0,0,0,0,0,45000
20200312,1515,力山,53.30,53.30,49.50,49.85,-4.45,-8.2,2402314,1427,121633714,369000,472000,-103000,0,0,0,3000,14000,-11000,-114000
20200312,1516,川飛,15.95,16.00,15.20,15.70,-0.25,-1.57,123104,73,1900608,2000,3000,-1000,0,0,0,1000,1000,0,-1000
20200312,1517,利奇,8.39,8.40,7.91,8.14,-0.37,-4.35,637228,215,5216458,0,21000,-21000,0,0,0,1000,0,1000,-20000
20200312,1519,華城,29.40,29.40,27.00,27.55,-1.90,-6.45,2413736,1282,67556001,331000,645000,-314000,0,0,0,0,30000,-30000,-344000
20200312,1521,大億,60.90,60.90,59.60,59.70,-1.20,-1.97,85565,82,5129500,0,12000,-12000,0,0,0,0,1000,-1000,-13000
20200312,1522,堤維西,22.40,22.40,21.30,21.30,-1.50,-6.58,1191150,609,25879435,152000,257000,-105000,0,0,0,0,3000,-3000,-108000
20200312,1524,耿鼎,8.77,8.90,8.69,8.80,-0.30,-3.3,311117,120,2735736,11000,25000,-14000,0,0,0,0,0,0,-14000
20200312,1525,江申,44.00,44.00,40.95,43.95,-1.55,-3.41,431120,210,17909523,4000,6000,-2000,0,0,0,0,1000,-1000,-3000
20200312,1526,日馳,17.85,17.95,16.25,16.40,-1.65,-9.14,1039006,517,17354602,137000,104000,33000,0,0,0,10000,0,10000,43000
20200312,1527,鑽全,44.60,45.00,42.00,42.40,-2.55,-5.67,1348063,954,57766809,79000,430000,-351000,0,0,0,0,0,0,-351000
20200312,1528,恩德,7.50,7.51,6.82,6.99,-0.57,-7.54,603224,404,4255972,8000,40000,-32000,0,0,0,1000,0,1000,-31000
20200312,1529,樂士,15.75,15.75,14.70,14.80,-0.20,-1.33,446549,208,6734230,2000,9000,-7000,0,0,0,15000,0,15000,8000
20200312,1530,亞崴,29.30,29.30,28.30,28.30,-0.85,-2.92,77200,46,2235640,0,0,0,0,0,0,0,0,0,0
20200312,1531,高林股,12.80,12.80,11.85,11.90,-1.15,-8.81,564050,212,6865915,10000,81000,-71000,0,0,0,0,0,0,-71000
20200312,1532,勤美,27.50,27.70,26.50,26.50,-1.35,-4.85,828878,370,22297999,32000,135000,-103000,0,0,0,0,0,0,-103000
20200312,1533,車王電,30.50,30.50,27.75,27.80,-3.00,-9.74,351025,229,9935969,11000,26000,-15000,0,0,0,0,3000,-3000,-18000
20200312,1535,中宇,32.50,32.50,31.30,31.30,-1.50,-4.57,259489,127,8256157,1000,17000,-16000,0,0,0,0,4000,-4000,-20000
20200312,1536,和大,100.00,101.00,95.30,96.30,-5.20,-5.12,3623014,2285,352886543,889000,1048000,-159000,0,443000,-443000,1000,115000,-114000,-716000
20200312,1537,廣隆,145.00,145.00,142.50,143.00,-2.00,-1.38,271453,239,38935685,20000,77000,-57000,15000,0,15000,0,10000,-10000,-52000
20200312,1538,正峰新,3.80,3.98,3.76,3.98,-0.19,-4.56,12714,23,48548,0,0,0,0,0,0,0,0,0,0
20200312,1539,巨庭,16.60,16.60,15.80,15.80,-0.80,-4.82,158000,103,2542400,7000,10000,-3000,0,0,0,0,1000,-1000,-4000
20200312,1540,喬福,17.00,17.20,16.50,16.50,-0.80,-4.62,684074,300,11463671,3000,32000,-29000,0,0,0,0,0,0,-29000
20200312,1541,錩泰,35.60,35.60,33.05,33.40,-2.80,-7.73,96000,77,3238600,6000,10000,-4000,0,0,0,3000,24000,-21000,-25000
20200312,1558,伸興,128.00,128.00,125.00,125.00,-3.00,-2.34,341734,299,42876984,3000,99000,-96000,0,0,0,0,13000,-13000,-109000
20200312,1560,中砂,57.00,57.00,54.50,54.90,-2.30,-4.02,1152561,846,63428306,155000,414000,-259000,0,85000,-85000,5000,1000,4000,-340000
20200312,1568,倉佑,16.50,16.50,14.90,14.95,-1.60,-9.67,496445,255,7551140,19000,31000,-12000,0,0,0,0,0,0,-12000
20200312,1582,信錦,79.30,79.30,75.00,77.20,-2.60,-3.26,982331,728,75207906,173000,205000,-32000,0,0,0,6000,14000,-8000,-40000
20200312,1583,程泰,56.10,57.40,55.70,57.00,0.00,0.00,26000,16,1474200,0,0,0,0,0,0,0,0,0,0
20200312,1587,吉茂,13.85,13.85,12.15,12.70,-0.60,-4.51,86300,53,1105088,1000,1000,0,0,0,0,0,0,0,0
20200312,1589,永冠-KY,57.90,58.00,54.20,55.20,-3.30,-5.64,1516358,672,84002140,85000,612000,-527000,0,0,0,10000,169000,-159000,-686000
20200312,1590,亞德客-KY,468.00,470.00,427.00,429.00,-44.00,-9.3,1210372,1126,535002940,331367,693000,-361633,21000,0,21000,13000,19000,-6000,-346633
20200312,1592,英瑞-KY,12.10,12.40,11.30,11.75,-0.80,-6.37,775035,427,9091456,13000,64000,-51000,0,0,0,2000,2000,0,-51000
20200312,1598,岱宇,36.45,36.55,35.75,36.55,-0.15,-0.41,1140205,571,41321237,6118,78000,-71882,0,0,0,2000,148000,-146000,-217882
20200312,1603,華電,30.40,30.45,28.00,29.85,-0.60,-1.97,396248,311,11789850,29000,35000,-6000,0,0,0,0,0,0,-6000
20200312,1604,聲寶,17.65,17.70,17.15,17.20,-0.75,-4.18,1276687,485,22236188,22000,285000,-263000,0,0,0,30000,27000,3000,-260000
20200312,1605,華新,12.95,12.95,11.85,12.10,-1.00,-7.63,31564172,6064,387569621,5225000,12137000,-6912000,9000,0,9000,11866000,701000,11165000,4262000
20200312,1608,華榮,8.33,8.33,7.80,7.90,-0.54,-6.4,488833,224,3901115,47000,111000,-64000,0,0,0,0,10000,-10000,-74000
20200312,1609,大亞,9.46,9.48,8.97,9.00,-0.62,-6.44,4494275,1391,41013808,288000,784000,-496000,2000,0,2000,49000,67000,-18000,-512000
20200312,1611,中電,12.30,12.30,11.55,12.10,-0.35,-2.81,1763130,868,21017851,131000,318000,-187000,0,0,0,1000,1000,0,-187000
20200312,1612,宏泰,10.10,10.10,9.50,9.82,-0.38,-3.73,875108,320,8534863,5000,129000,-124000,0,0,0,0,0,0,-124000
20200312,1614,三洋電,29.70,29.70,28.05,28.10,-1.50,-5.07,326000,119,9299950,6000,46000,-40000,0,0,0,0,0,0,-40000
20200312,1615,大山,18.85,18.85,18.00,18.40,-0.45,-2.39,225200,122,4120910,11000,30000,-19000,0,0,0,0,1000,-1000,-20000
20200312,1616,億泰,4.50,4.50,4.16,4.23,-0.27,-6.0,152462,67,651529,0,0,0,0,0,0,0,0,0,0
20200312,1617,榮星,10.55,10.55,10.30,10.30,-0.60,-5.5,26014,21,271708,1000,0,1000,0,0,0,3000,0,3000,4000
20200312,1618,合機,8.08,8.08,7.68,7.72,-0.36,-4.46,213119,76,1657222,8000,7000,1000,0,0,0,4000,0,4000,5000
20200312,1626,艾美特-KY,26.80,26.95,25.70,26.05,-0.80,-2.98,324402,201,8461511,32000,93000,-61000,0,0,0,0,0,0,-61000
20200312,1701,中化,20.80,21.10,19.50,19.80,-1.10,-5.26,4517370,2191,90352027,666000,360000,306000,0,0,0,0,156000,-156000,150000
20200312,1702,南僑,46.85,46.85,45.00,45.05,-1.95,-4.15,665090,512,30142010,55000,233000,-178000,0,0,0,1000,0,1000,-177000
20200312,1707,葡萄王,226.50,228.50,210.50,218.50,-6.50,-2.89,2969208,2545,652873718,1074645,268000,806645,45000,0,45000,8000,66000,-58000,793645
20200312,1708,東鹼,23.90,23.90,23.65,23.80,-0.25,-1.04,1408648,286,33491451,5000,95000,-90000,0,0,0,0,0,0,-90000
20200312,1709,和益,13.60,13.90,12.95,13.05,-0.50,-3.69,3463543,1202,45735559,129000,321000,-192000,0,0,0,1000,2000,-1000,-193000
20200312,1710,東聯,19.40,19.40,18.50,18.55,-0.90,-4.63,2483229,1226,46607741,289265,418000,-128735,2000,0,2000,0,2000,-2000,-128735
20200312,1711,永光,15.50,15.55,14.40,14.50,-1.00,-6.45,2261086,1159,33312289,246000,250000,-4000,0,0,0,8000,8000,0,-4000
20200312,1712,興農,19.05,19.05,18.15,18.30,-0.75,-3.94,3736642,1565,68948202,349000,648000,-299000,0,0,0,40000,15000,25000,-274000
20200312,1713,國化,17.00,17.15,16.65,17.05,-0.10,-0.58,233178,102,3964433,3000,18000,-15000,0,0,0,1000,1000,0,-15000
20200312,1714,和桐,7.03,7.09,6.56,6.62,-0.55,-7.67,10452184,3164,70732370,2586000,812000,1774000,0,0,0,28000,93000,-65000,1709000
20200312,1717,長興,25.00,25.20,24.25,24.50,-0.60,-2.39,1382971,625,33966523,209000,240000,-31000,3000,0,3000,0,1000,-1000,-29000
20200312,1718,中纖,6.87,6.87,6.41,6.49,-0.45,-6.48,5221245,1398,34301728,396000,1015000,-619000,0,0,0,0,0,0,-619000
20200312,1720,生達,34.50,34.65,33.00,33.05,-1.45,-4.2,868724,578,29137110,80000,126000,-46000,0,0,0,0,4000,-4000,-50000
20200312,1721,三晃,10.30,10.30,9.84,9.86,-0.34,-3.33,434210,150,4312401,64000,25000,39000,0,0,0,1000,1000,0,39000
20200312,1722,台肥,46.50,46.55,44.85,44.90,-1.85,-3.96,5357691,2865,243102723,263000,741000,-478000,2000,0,2000,1000,66000,-65000,-541000
20200312,1723,中碳,108.00,108.00,103.00,104.00,-5.00,-4.59,840101,637,87840105,145000,44000,101000,0,0,0,0,0,0,101000
20200312,1724,台硝,12.50,12.50,12.20,12.20,-0.40,-3.17,60005,30,740760,0,1000,-1000,0,0,0,0,1000,-1000,-2000
20200312,1725,元禎,14.35,14.35,13.55,13.80,-0.55,-3.83,38000,32,527750,2000,12000,-10000,0,0,0,0,0,0,-10000
20200312,1726,永記,68.10,68.50,67.50,67.80,-1.70,-2.45,60184,66,4090270,14000,16000,-2000,0,0,0,0,3000,-3000,-5000
20200312,1727,中華化,11.05,11.05,10.30,10.45,-0.55,-5.0,159004,112,1677189,0,2000,-2000,0,0,0,1000,1000,0,-2000
20200312,1730,花仙子,66.30,66.40,61.20,61.20,-6.00,-8.93,1422583,1161,89195694,253000,92000,161000,0,0,0,6000,0,6000,167000
20200312,1731,美吾華,13.95,14.00,13.00,13.10,-0.95,-6.76,2075398,853,27713099,466000,77000,389000,0,0,0,0,1000,-1000,388000
20200312,1732,毛寶,26.00,26.00,24.80,24.90,-0.90,-3.49,865005,324,21588016,23000,6000,17000,0,0,0,207000,0,207000,224000
20200312,1733,五鼎,25.45,25.45,23.30,23.30,-2.40,-9.34,776048,509,18756768,63000,111000,-48000,0,0,0,26000,35000,-9000,-57000
20200312,1734,杏輝,20.60,20.60,19.25,19.25,-1.20,-5.87,1240397,781,24277017,183000,161000,22000,0,0,0,0,7000,-7000,15000
20200312,1735,日勝化,17.40,17.40,16.75,16.80,-0.80,-4.55,22079,19,374303,1000,8000,-7000,0,0,0,2000,0,2000,-5000
20200312,1736,喬山,62.00,63.00,57.80,58.70,-5.20,-8.14,2956280,1993,175570545,1016000,455000,561000,0,0,0,14000,20000,-6000,555000
20200312,1737,臺鹽,31.70,31.70,30.65,30.75,-0.95,-3.0,704468,378,21775418,26000,79000,-53000,0,0,0,0,0,0,-53000
20200312,1760,寶齡富錦,82.00,82.20,74.60,76.80,-4.80,-5.88,941195,747,73485375,61000,150000,-89000,0,0,0,0,0,0,-89000
20200312,1762,中化生,42.15,43.60,37.90,37.90,-4.20,-9.98,7651888,4263,304938701,781000,995000,-214000,0,0,0,0,0,0,-214000
20200312,1773,勝一,94.00,94.00,89.50,91.70,-3.00,-3.17,532585,431,48629396,49000,116000,-67000,0,0,0,1000,1000,0,-67000
20200312,1776,展宇,17.30,17.60,16.10,17.40,0.00,0.00,399077,81,6871373,0,2000,-2000,0,0,0,0,1000,-1000,-3000
20200312,1783,和康生,22.00,22.00,19.85,19.90,-2.15,-9.75,595007,286,12166761,14000,21000,-7000,0,0,0,0,0,0,-7000
20200312,1786,科妍,53.30,54.00,49.50,49.50,-5.50,-10.0,1214440,735,61101910,186000,83000,103000,0,0,0,24000,8000,16000,119000
20200312,1789,神隆,32.70,33.45,29.50,30.10,-2.20,-6.81,16578458,7969,518648082,2581000,1412000,1169000,523000,0,523000,7000,17000,-10000,1682000
20200312,1795,美時,87.70,87.80,79.90,79.90,-8.80,-9.92,4193239,2925,343680285,490000,266000,224000,0,58000,-58000,0,1000,-1000,165000
20200312,1802,台玻,9.47,9.47,8.91,8.95,-0.55,-5.79,3881154,1246,35085957,369000,826000,-457000,0,0,0,16000,45000,-29000,-486000
20200312,1805,寶徠,9.06,9.40,9.02,9.35,-0.18,-1.89,24264,19,221678,4000,6000,-2000,0,0,0,0,0,0,-2000
20200312,1806,冠軍,5.57,5.57,5.40,5.47,-0.23,-4.04,338705,118,1857393,6000,69000,-63000,0,0,0,0,0,0,-63000
20200312,1808,潤隆,59.40,59.40,56.80,56.80,-2.60,-4.38,375540,267,21503395,97000,123000,-26000,0,0,0,0,1000,-1000,-27000
20200312,1809,中釉,9.25,9.26,8.73,8.86,-0.62,-6.54,1580880,568,14084224,159000,208000,-49000,0,0,0,1000,20000,-19000,-68000
20200312,1810,和成,7.30,7.30,6.88,6.97,-0.39,-5.3,790450,230,5549359,2000,195000,-193000,0,0,0,0,5000,-5000,-198000
20200312,1817,凱撒衛,31.00,31.00,29.85,29.85,-1.30,-4.17,283050,195,8520160,19000,20000,-1000,0,0,0,0,0,0,-1000
20200312,1902,台紙,20.30,20.35,20.25,20.25,-0.05,-0.25,3488540,707,70752386,70000,1328000,-1258000,0,0,0,0,3000,-3000,-1261000
20200312,1903,士紙,30.05,31.00,29.50,30.10,-1.05,-3.37,17044,46,510073,0,4000,-4000,0,0,0,2000,0,2000,-2000
20200312,1904,正隆,23.00,23.10,21.40,22.50,-0.50,-2.17,9481731,4182,210244452,1934000,1640000,294000,2377000,0,2377000,2000,24000,-22000,2649000
20200312,1905,華紙,8.37,8.40,7.63,7.70,-0.77,-9.09,5606326,1668,44321968,562000,922000,-360000,0,0,0,11000,2000,9000,-351000
20200312,1906,寶隆,13.80,13.80,12.55,12.60,-1.30,-9.35,1031731,553,13349654,50000,74000,-24000,0,0,0,0,8000,-8000,-32000
20200312,1907,永豐餘,12.65,12.65,11.95,12.05,-0.70,-5.49,5777756,1915,70368229,1204000,1049000,155000,0,0,0,26000,209000,-183000,-28000
20200312,1909,榮成,15.35,15.45,14.35,14.35,-1.55,-9.75,24296995,7129,357172609,7946348,6038000,1908348,300000,286000,14000,8000,799000,-791000,1131348
20200312,2002,中鋼,22.20,22.20,21.30,21.40,-0.95,-4.25,33757335,15952,726858360,4794786,17238401,-12443615,128000,0,128000,238000,575000,-337000,-12652615
20200312,2002A,中鋼特,54.60,54.60,53.50,54.00,-0.70,-1.28,178104,94,9589278,0,0,0,0,0,0,42000,2000,40000,40000
20200312,2006,東和鋼鐵,23.35,23.35,22.70,22.75,-0.70,-2.99,2292839,1030,52545504,601000,422000,179000,3000,0,3000,21000,52000,-31000,151000
20200312,2007,燁興,4.03,4.06,3.74,3.85,-0.19,-4.7,175362,75,680754,0,16000,-16000,0,0,0,0,0,0,-16000
20200312,2008,高興昌,12.35,12.35,12.30,12.30,-0.05,-0.4,203750,31,2514075,2000,20000,-18000,0,0,0,0,0,0,-18000
20200312,2009,第一銅,7.67,7.67,7.20,7.33,-0.60,-7.57,275011,133,2046400,11000,42000,-31000,0,0,0,0,7000,-7000,-38000
20200312,2010,春源,10.10,10.10,9.68,9.70,-0.17,-1.72,1123325,331,11062767,23000,153000,-130000,0,0,0,0,0,0,-130000
20200312,2012,春雨,18.75,18.75,18.00,18.00,-0.75,-4.0,135912,55,2496716,0,25000,-25000,0,0,0,0,0,0,-25000
20200312,2013,中鋼構,22.50,22.50,21.10,21.15,-1.40,-6.21,962972,470,20917491,98000,100000,-2000,0,0,0,0,0,0,-2000
20200312,2014,中鴻,8.43,8.45,7.74,7.74,-0.86,-10.0,13007964,2789,103400076,973000,1127000,-154000,0,0,0,0,1738000,-1738000,-1892000
20200312,2015,豐興,51.50,51.60,50.60,51.40,-0.20,-0.39,877366,495,44730780,197000,561000,-364000,0,0,0,10000,13000,-3000,-367000
20200312,2017,官田鋼,7.22,7.22,6.71,6.92,-0.30,-4.16,1262113,410,8806131,0,79000,-79000,0,0,0,1000,2000,-1000,-80000
20200312,2020,美亞,15.80,15.80,15.00,15.30,-0.60,-3.77,777968,334,11936906,31000,21000,10000,0,0,0,1000,0,1000,11000
20200312,2022,聚亨,4.25,4.25,3.98,3.99,-0.26,-6.12,1425319,268,5754219,22000,78000,-56000,0,0,0,0,9000,-9000,-65000
20200312,2023,燁輝,9.00,9.03,8.66,8.75,-0.25,-2.78,2118641,937,18837973,162000,763000,-601000,0,0,0,0,29000,-29000,-630000
20200312,2024,志聯,12.70,12.70,12.30,12.30,-0.50,-3.91,366020,127,4544791,3000,10000,-7000,0,0,0,0,0,0,-7000
20200312,2025,千興,1.86,1.86,1.78,1.78,-0.17,-8.72,132540,29,241656,0,0,0,0,0,0,0,0,0,0
20200312,2027,大成鋼,30.00,30.20,29.30,30.00,-0.35,-1.15,10391874,3099,310237638,2127000,1333000,794000,0,0,0,4788000,669000,4119000,4913000
20200312,2028,威致,9.02,9.15,8.80,9.01,-0.05,-0.55,726406,95,6545344,11000,24000,-13000,0,0,0,1000,0,1000,-12000
20200312,2029,盛餘,19.00,19.00,18.40,18.55,-0.55,-2.88,148353,95,2765418,2000,29000,-27000,0,0,0,0,5000,-5000,-32000
20200312,2030,彰源,10.40,10.40,9.98,10.00,-0.50,-4.76,560724,295,5663242,13000,71000,-58000,0,0,0,0,0,0,-58000
20200312,2031,新光鋼,28.00,28.00,26.35,26.70,-1.50,-5.32,1894550,842,51013572,119000,366000,-247000,0,0,0,27000,125000,-98000,-345000
20200312,2032,新鋼,8.25,8.25,7.80,7.80,-0.66,-7.8,193553,95,1545872,2000,11000,-9000,0,0,0,0,0,0,-9000
20200312,2033,佳大,8.72,8.94,8.71,8.71,-0.09,-1.02,191000,50,1671030,2000,10000,-8000,0,0,0,0,0,0,-8000
20200312,2034,允強,25.60,25.60,25.00,25.15,-0.45,-1.76,1421174,688,35766118,176000,133000,43000,0,0,0,0,0,0,43000
20200312,2038,海光,6.48,6.48,6.10,6.14,-0.34,-5.25,291423,102,1833168,3000,9000,-6000,0,0,0,0,0,0,-6000
20200312,2049,上銀,274.00,274.00,252.00,258.00,-21.00,-7.53,5289479,4120,1384686040,2068834,1347168,721666,1000,346000,-345000,44000,295000,-251000,125666
20200312,2059,川湖,344.00,344.00,325.00,331.00,-9.50,-2.79,222762,196,73974746,15000,106000,-91000,0,0,0,1000,9000,-8000,-99000
20200312,2062,橋椿,21.70,22.20,19.90,19.90,-2.10,-9.55,365400,229,7459800,21000,23000,-2000,0,0,0,0,0,0,-2000
20200312,2069,運錩,16.05,16.05,14.80,15.35,-1.00,-6.12,297000,139,4600150,8000,5000,3000,0,0,0,0,0,0,3000
20200312,2101,南港,40.00,40.05,37.60,37.60,0.00,0.00,4968401,2199,191252918,698000,1169000,-471000,0,0,0,38000,172000,-134000,-605000
20200312,2102,泰豐,11.00,11.20,10.50,10.60,-0.55,-4.93,2333746,677,25003563,42000,519000,-477000,0,0,0,0,0,0,-477000
20200312,2103,台橡,20.10,20.15,18.90,19.10,-1.15,-5.68,2510775,1375,48520269,336000,507000,-171000,0,0,0,0,541000,-541000,-712000
20200312,2104,國際中橡,25.40,25.40,24.20,24.35,-1.25,-4.88,6041000,2928,148367518,572000,1248000,-676000,0,0,0,1000,18000,-17000,-693000
20200312,2105,正新,37.90,37.90,37.00,37.85,-0.15,-0.39,8996526,3335,336630781,3810998,4242082,-431084,12000,0,12000,88000,277000,-189000,-608084
20200312,2106,建大,28.00,28.00,27.45,28.00,-0.05,-0.18,1778478,620,49127059,158000,491000,-333000,0,0,0,2000,30000,-28000,-361000
20200312,2107,厚生,16.85,16.85,16.35,16.45,-0.65,-3.8,928332,440,15325236,140000,196000,-56000,0,0,0,0,6000,-6000,-62000
20200312,2108,南帝,28.30,28.30,26.65,26.65,-2.05,-7.14,1714493,895,46880199,188000,428000,-240000,0,0,0,11000,9000,2000,-238000
20200312,2109,華豐,12.40,12.60,11.30,11.60,-0.70,-5.69,669406,222,7916662,0,5000,-5000,0,0,0,2000,0,2000,-3000
20200312,2114,鑫永銓,80.00,80.00,78.00,78.00,-2.00,-2.5,110271,95,8648989,2000,29000,-27000,0,0,0,0,0,0,-27000
20200312,2115,六暉-KY,36.10,36.10,35.15,35.85,-0.40,-1.1,83298,60,2977007,10000,1000,9000,0,0,0,0,2000,-2000,7000
20200312,2201,裕隆,19.60,19.60,18.60,18.60,-1.05,-5.34,7974819,2650,151032925,1403000,1462000,-59000,0,200000,-200000,18000,35000,-17000,-276000
20200312,2204,中華,33.90,34.00,32.60,32.60,-1.50,-4.4,988724,648,32766447,201000,302000,-101000,1000,0,1000,0,13000,-13000,-113000
20200312,2206,三陽工業,20.35,20.50,20.20,20.30,-0.20,-0.98,3818555,835,77784916,434000,355000,79000,0,0,0,0,64000,-64000,15000
20200312,2207,和泰車,544.00,550.00,502.00,507.00,-46.00,-8.32,769892,726,398891704,474622,501330,-26708,4000,0,4000,9000,13000,-4000,-26708
20200312,2208,台船,22.00,22.00,20.50,20.55,-1.55,-7.01,2155142,1051,45440749,96000,482000,-386000,0,0,0,0,4000,-4000,-390000
20200312,2227,裕日車,241.00,241.00,235.00,238.50,-5.00,-2.05,166194,149,39549448,6000,38050,-32050,0,0,0,0,9000,-9000,-41050
20200312,2228,劍麟,85.50,85.70,78.40,80.20,-6.40,-7.39,795741,619,64182850,181000,250000,-69000,0,0,0,7000,38000,-31000,-100000
20200312,2231,為升,172.50,172.50,158.00,159.00,-16.50,-9.4,2223849,1720,359450887,657000,436000,221000,0,12000,-12000,15000,41000,-26000,183000
20200312,2233,宇隆,57.50,57.50,53.00,53.90,-3.20,-5.6,765229,640,41835837,97000,154000,-57000,0,0,0,5000,11000,-6000,-63000
20200312,2236,百達-KY,18.00,18.00,17.30,17.80,-0.45,-2.47,190092,62,3351919,5000,0,5000,0,0,0,0,0,0,5000
20200312,2239,英利-KY,67.50,67.50,63.10,64.50,-5.00,-7.19,166346,149,10792599,29000,11000,18000,0,0,0,0,0,0,18000
20200312,2243,宏旭-KY,12.40,12.50,11.75,11.80,-0.65,-5.22,92008,35,1098709,2000,1000,1000,0,0,0,0,0,0,1000
20200312,2301,光寶科,43.45,43.75,42.00,42.00,-2.20,-4.98,16824376,7999,713164716,2975624,14594656,-11619032,15000,0,15000,2315000,251000,2064000,-9540032
20200312,2302,麗正,6.45,6.45,5.85,5.90,-0.57,-8.81,318142,119,1938407,23000,14000,9000,0,0,0,0,0,0,9000
20200312,2303,聯電,14.60,14.65,13.85,14.35,-0.45,-3.04,138258958,14585,1967829036,85098594,88277926,-3179332,108000,2800000,-2692000,2441000,1854000,587000,-5284332
20200312,2305,全友,5.52,5.52,4.99,5.00,-0.54,-9.75,1015304,223,5120170,10000,28000,-18000,0,0,0,0,4000,-4000,-22000
20200312,2308,台達電,133.00,133.00,123.50,123.50,-9.50,-7.14,16543675,9213,2110313375,6569558,8881038,-2311480,32000,573000,-541000,221000,296000,-75000,-2927480
20200312,2312,金寶,12.00,12.00,11.30,11.40,-0.75,-6.17,9986708,1994,115679826,2132000,1962000,170000,0,0,0,11000,104000,-93000,77000
20200312,2313,華通,38.50,38.55,34.65,34.75,-3.75,-9.74,30957382,12647,1111841918,4616000,8141000,-3525000,150000,459000,-309000,1058000,4105000,-3047000,-6881000
20200312,2314,台揚,20.10,20.10,18.70,18.70,-1.60,-7.88,1987536,1022,38063008,249000,275000,-26000,0,0,0,11000,89000,-78000,-104000
20200312,2316,楠梓電,31.85,31.95,29.00,29.50,-2.35,-7.38,6299539,3330,189911355,829000,1826000,-997000,0,0,0,8000,126000,-118000,-1115000
20200312,2317,鴻海,77.40,77.50,74.50,74.70,-3.90,-4.96,85760356,42675,6495111843,14663530,48098701,-33435171,82000,0,82000,1248000,5757000,-4509000,-37862171
20200312,2321,東訊,1.48,1.54,1.48,1.54,-0.10,-6.1,59990,26,89403,0,0,0,0,0,0,0,0,0,0
20200312,2323,中環,7.42,7.44,6.79,6.79,-0.75,-9.95,24735633,4949,172843264,5205000,3583000,1622000,0,0,0,127000,616000,-489000,1133000
20200312,2324,仁寶,17.65,17.70,17.15,17.20,-0.65,-3.64,28947423,9778,501527443,2708700,14868275,-12159575,24000,0,24000,6528000,127000,6401000,-5734575
20200312,2327,國巨,381.00,381.00,345.50,345.50,-38.00,-9.91,27805955,20344,9936840291,3710745,5615820,-1905075,2000,838000,-836000,845000,842000,3000,-2738075
20200312,2328,廣宇,18.60,18.70,17.50,17.70,-1.20,-6.35,3249147,1485,58033339,136000,978000,-842000,0,0,0,3000,30000,-27000,-869000
20200312,2329,華泰,12.00,12.00,10.95,11.15,-1.00,-8.23,6288836,1872,71315072,881000,1392000,-511000,0,0,0,25000,151000,-126000,-637000
20200312,2330,台積電,299.00,299.00,287.00,294.00,-8.00,-2.65,114173351,56989,33544278206,31254651,69797090,-38542439,284000,431000,-147000,2875000,6590995,-3715995,-42405434
20200312,2331,精英,10.30,10.30,9.68,9.82,-0.58,-5.58,1653341,519,16384846,162000,437000,-275000,0,0,0,1000,59000,-58000,-333000
20200312,2332,友訊,12.00,12.00,11.00,11.10,-0.85,-7.11,8533342,2588,97216986,1089000,1004000,85000,0,0,0,78000,2058000,-1980000,-1895000
20200312,2337,旺宏,32.95,32.95,30.25,30.65,-2.75,-8.23,77115376,28751,2409890210,9820000,21060006,-11240006,0,1739000,-1739000,871000,2590000,-1719000,-14698006
20200312,2338,光罩,28.55,28.60,26.60,26.90,-1.95,-6.76,11124573,5380,304145197,1214000,1503000,-289000,0,0,0,17000,207000,-190000,-479000
20200312,2340,光磊,20.90,20.90,18.90,19.00,-2.00,-9.52,4899595,2186,95414413,733000,846000,-113000,0,0,0,95000,243000,-148000,-261000
20200312,2342,茂矽,28.60,28.70,25.65,26.20,-2.20,-7.75,16801004,7273,454067785,3767000,1190000,2577000,0,0,0,0,0,0,2577000
20200312,2344,華邦電,15.40,15.45,14.15,14.20,-1.45,-9.27,55980521,14797,816964174,9577250,19383649,-9806399,11000,3473000,-3462000,217000,2441000,-2224000,-15492399
20200312,2345,智邦,172.50,172.50,159.50,164.00,-8.50,-4.93,10202941,6474,1684847824,3434214,4765301,-1331087,297000,0,297000,492000,1056000,-564000,-1598087
20200312,2347,聯強,36.40,36.45,35.10,35.40,-1.30,-3.54,7205101,2476,256610109,1182276,4823522,-3641246,0,0,0,3235000,118000,3117000,-524246
20200312,2348,海悅,52.70,53.00,50.40,51.00,-2.50,-4.67,491090,347,25305590,15000,166000,-151000,0,0,0,22000,28000,-6000,-157000
20200312,2349,錸德,4.84,4.84,4.47,4.50,-0.40,-8.16,8398209,1783,38389649,516000,1283000,-767000,0,0,0,0,0,0,-767000
20200312,2351,順德,53.20,53.20,49.25,49.25,-5.45,-9.96,1153999,717,57988499,140000,117000,23000,0,63000,-63000,2000,2000,0,-40000
20200312,2352,佳世達,17.80,17.85,17.00,17.10,-0.95,-5.26,9376395,3149,162286492,181000,1980000,-1799000,5000,0,5000,96000,239000,-143000,-1937000
20200312,2353,宏碁,15.00,15.00,14.10,14.35,-0.85,-5.59,21270904,6395,306658530,9255776,8076009,1179767,8000,0,8000,222000,199000,23000,1210767
20200312,2354,鴻準,57.90,57.90,54.30,55.20,-2.90,-4.99,8086292,4678,448003018,932232,3820206,-2887974,0,800000,-800000,49000,64000,-15000,-3702974
20200312,2355,敬鵬,27.55,27.75,25.95,26.40,-1.70,-6.05,2100848,1173,55859268,209000,448000,-239000,0,0,0,1000,28000,-27000,-266000
20200312,2356,英業達,22.45,22.45,21.65,21.65,-1.05,-4.63,11480917,4229,251224824,1087940,6325000,-5237060,18000,21000,-3000,5402000,1089000,4313000,-927060
20200312,2357,華碩,197.00,198.00,193.00,197.00,-0.50,-0.25,3716542,2874,727441816,1375918,2705992,-1330074,15000,0,15000,484000,81000,403000,-912074
20200312,2358,廷鑫,12.90,12.90,11.85,11.95,-1.00,-7.72,262191,140,3187678,10000,14000,-4000,0,0,0,7000,1000,6000,2000
20200312,2359,所羅門,18.80,18.80,17.40,17.45,-1.55,-8.16,1584646,711,28190112,185000,396000,-211000,0,0,0,0,5000,-5000,-216000
20200312,2360,致茂,132.00,132.00,121.00,123.00,-11.00,-8.21,3829041,2344,477093043,1620000,673000,947000,2000,652000,-650000,41000,165000,-124000,173000
20200312,2362,藍天,30.45,30.45,29.05,29.90,-0.85,-2.76,1179867,599,35012636,50000,422000,-372000,0,0,0,48000,34000,14000,-358000
20200312,2363,矽統,7.34,7.45,6.80,6.88,-0.58,-7.77,3802616,1316,26743681,457000,1129000,-672000,0,0,0,1000,15000,-14000,-686000
20200312,2364,倫飛,1.76,1.78,1.69,1.69,-0.18,-9.63,359550,59,616334,0,0,0,0,0,0,0,0,0,0
20200312,2365,昆盈,7.01,7.01,6.53,6.55,-0.54,-7.62,623950,257,4154558,6000,82000,-76000,0,0,0,1000,6000,-5000,-81000
20200312,2367,燿華,25.00,25.00,22.95,22.95,-2.45,-9.65,17424788,6706,411842546,5871000,3250000,2621000,0,0,0,87000,146000,-59000,2562000
20200312,2368,金像電,21.35,22.00,19.90,19.90,-2.20,-9.95,96654753,26848,2013005584,8152000,9348000,-1196000,536000,300000,236000,1385000,3566000,-2181000,-3141000
20200312,2369,菱生,10.45,10.45,9.90,10.05,-0.50,-4.74,5431413,1641,54932150,200000,1249000,-1049000,0,0,0,3000,44000,-41000,-1090000
20200312,2371,大同,19.70,19.70,18.30,18.75,-0.95,-4.82,9943799,3143,186913703,3091790,4641000,-1549210,0,0,0,47000,333000,-286000,-1835210
20200312,2373,震旦行,86.10,86.10,83.10,85.80,-1.20,-1.38,116208,108,9842837,4000,39000,-35000,0,0,0,0,3000,-3000,-38000
20200312,2374,佳能,13.40,13.40,12.50,12.80,-0.60,-4.48,449971,298,5785262,14000,50000,-36000,0,0,0,0,6000,-6000,-42000
20200312,2375,凱美,34.70,34.70,31.60,31.65,-3.45,-9.83,4426087,2558,143231434,728000,601000,127000,0,0,0,0,47000,-47000,80000
20200312,2376,技嘉,49.40,49.40,46.65,47.55,-1.85,-3.74,9358637,4879,448583834,2537000,3086000,-549000,85000,0,85000,2116000,939000,1177000,713000
20200312,2377,微星,85.10,85.60,82.10,82.10,-4.20,-4.87,4571543,2670,382117469,666372,2991800,-2325428,2000,0,2000,1432000,89000,1343000,-980428
20200312,2379,瑞昱,221.00,221.50,203.00,205.00,-20.00,-8.89,6824701,4198,1428353529,1947058,4805488,-2858430,0,27000,-27000,88000,140000,-52000,-2937430
20200312,2380,虹光,4.00,4.04,3.66,3.77,-0.29,-7.14,466738,188,1754761,11000,22000,-11000,0,0,0,0,0,0,-11000
20200312,2382,廣達,60.20,60.20,57.80,58.80,-1.90,-3.13,12769619,6605,749840921,2388904,7579078,-5190174,29000,0,29000,2405000,314000,2091000,-3070174
20200312,2383,台光電,123.00,123.50,113.50,115.50,-10.00,-7.97,9787521,6208,1142571211,1615000,2781000,-1166000,2000,774000,-772000,239000,428000,-189000,-2127000
20200312,2385,群光,81.70,82.70,80.00,81.00,-0.70,-0.86,5904740,3703,480877349,2673358,3933376,-1260018,21000,0,21000,1288000,36000,1252000,12982
20200312,2387,精元,34.35,34.70,31.95,32.50,-2.95,-8.32,6343909,3010,210631180,501000,1871000,-1370000,0,209000,-209000,103000,129000,-26000,-1605000
20200312,2388,威盛,26.05,26.05,23.60,23.70,-2.50,-9.54,1700470,947,40949288,190000,225000,-35000,0,0,0,0,1000,-1000,-36000
20200312,2390,云辰,8.61,8.70,7.92,7.92,-0.87,-9.9,3330178,1279,26945334,408000,488000,-80000,0,0,0,0,1000,-1000,-81000
20200312,2392,正崴,34.30,34.40,31.35,31.50,-3.30,-9.48,5586365,2766,180131066,1239411,1143000,96411,0,0,0,35000,74000,-39000,57411
20200312,2393,億光,30.30,30.65,28.25,28.60,-2.15,-6.99,3899667,1947,114212108,514000,1059000,-545000,0,0,0,166000,89000,77000,-468000
20200312,2395,研華,271.00,275.00,261.00,264.00,-13.00,-4.69,1961065,1545,525835225,1061472,1568668,-507196,34000,0,34000,5000,29000,-24000,-497196
20200312,2397,友通,75.60,75.60,71.90,71.90,-5.10,-6.62,298773,271,21741585,25000,39000,-14000,0,0,0,0,10000,-10000,-24000
20200312,2399,映泰,9.35,9.35,8.62,8.78,-0.72,-7.58,1574560,587,13941906,313000,432000,-119000,0,0,0,0,1000,-1000,-120000
20200312,2401,凌陽,10.35,10.40,9.78,9.83,-0.67,-6.38,3596032,1259,35886121,267000,748000,-481000,0,0,0,1000,75000,-74000,-555000
20200312,2402,毅嘉,13.30,13.35,12.15,12.20,-1.25,-9.29,2750055,903,34457243,485000,609000,-124000,0,0,0,0,15000,-15000,-139000
20200312,2404,漢唐,173.50,174.00,166.00,168.00,-9.00,-5.08,2843388,1977,481801184,340000,709400,-369400,0,0,0,723000,107000,616000,246600
20200312,2405,浩鑫,8.81,8.81,8.11,8.12,-0.78,-8.76,2133036,861,17668952,318000,145000,173000,0,0,0,0,3000,-3000,170000
20200312,2406,國碩,11.60,11.65,11.00,11.00,-0.70,-5.98,2589063,1031,29033678,301000,424000,-123000,0,0,0,0,0,0,-123000
20200312,2408,南亞科,70.80,71.10,65.50,66.00,-6.60,-9.09,29770828,15403,1999381749,8019689,12166999,-4147310,14000,3991000,-3977000,2473000,1617000,856000,-7268310
20200312,2409,友達,8.65,8.66,8.01,8.04,-0.71,-8.11,135125110,23632,1103772176,55223096,40604646,14618450,27000,15550000,-15523000,1336000,6344000,-5008000,-5912550
20200312,2412,中華電,108.00,108.50,107.00,107.50,-1.00,-0.92,16766527,8050,1803569093,6942715,6884855,57860,2301000,0,2301000,88000,294000,-206000,2152860
20200312,2413,環科,12.70,12.70,11.55,11.75,-0.90,-7.11,454278,204,5406388,7000,34000,-27000,0,0,0,0,0,0,-27000
20200312,2414,精技,22.60,22.60,21.80,22.00,-0.70,-3.08,538086,352,11913244,11000,60000,-49000,0,0,0,0,30000,-30000,-79000
20200312,2415,錩新,16.00,16.00,14.40,14.45,-1.55,-9.69,312077,198,4654884,9000,11000,-2000,0,0,0,1000,1000,0,-2000
20200312,2417,圓剛,10.20,10.20,9.33,9.38,-0.87,-8.49,3890660,1731,37665440,676000,555000,121000,0,0,0,1000,3000,-2000,119000
20200312,2419,仲琦,23.05,23.30,22.85,22.85,-0.25,-1.08,2783244,623,64022422,88213,423000,-334787,0,0,0,0,0,0,-334787
20200312,2420,新巨,33.20,33.20,31.80,31.85,-1.85,-5.49,1505077,913,48378714,208000,154000,54000,0,0,0,1000,1000,0,54000
20200312,2421,建準,37.00,37.55,35.10,35.50,-2.50,-6.58,2573443,1824,92842148,683000,1032000,-349000,0,0,0,6000,31000,-25000,-374000
20200312,2423,固緯,24.90,24.90,23.90,23.90,-1.00,-4.02,445788,269,10768531,14000,149000,-135000,0,0,0,0,1000,-1000,-136000
20200312,2424,隴華,23.70,23.70,23.00,23.00,0.00,0.00,7000,5,163800,0,0,0,0,0,0,0,0,0,0
20200312,2425,承啟,24.25,24.85,23.30,24.85,0.00,0.00,1042507,537,24997471,663000,271000,392000,0,0,0,1000,2000,-1000,391000
20200312,2426,鼎元,11.95,11.95,10.80,10.80,-1.15,-9.62,2942593,1065,32653818,365000,384000,-19000,0,0,0,0,7000,-7000,-26000
20200312,2427,三商電,10.30,10.30,9.98,10.00,-0.40,-3.85,393439,112,3961897,2000,11000,-9000,0,0,0,1000,1000,0,-9000
20200312,2428,興勤,80.10,80.20,76.00,76.20,-4.50,-5.58,801213,641,62292720,89000,266000,-177000,0,0,0,1000,14000,-13000,-190000
20200312,2429,銘旺科,24.80,24.80,23.25,23.25,-2.55,-9.88,379000,247,9023550,52000,13000,39000,0,0,0,0,0,0,39000
20200312,2430,燦坤,15.20,15.20,14.60,14.70,-0.60,-3.92,321400,129,4774385,2000,20000,-18000,0,0,0,0,1000,-1000,-19000
20200312,2431,聯昌,8.20,8.22,7.56,7.61,-0.65,-7.87,729022,300,5657843,63000,92000,-29000,0,0,0,0,2000,-2000,-31000
20200312,2433,互盛電,50.10,50.20,48.65,48.95,-1.85,-3.64,390969,322,19236822,35000,65000,-30000,0,0,0,0,0,0,-30000
20200312,2434,統懋,6.73,6.76,6.22,6.30,-0.50,-7.35,49000,24,314080,0,0,0,0,0,0,2000,0,2000,2000
20200312,2436,偉詮電,23.10,23.20,21.35,21.50,-2.00,-8.51,2225313,1308,49034914,387000,263000,124000,0,0,0,13000,13000,0,124000
20200312,2438,翔耀,6.00,6.00,5.61,5.70,-0.30,-5.0,190941,58,1107827,1000,9000,-8000,0,0,0,0,0,0,-8000
20200312,2439,美律,137.50,138.00,126.00,128.50,-10.00,-7.22,6587377,4381,860177510,799000,906000,-107000,0,0,0,1192000,537000,655000,548000
20200312,2440,太空梭,7.80,7.80,7.50,7.56,-0.24,-3.08,61308,25,468309,2000,0,2000,0,0,0,0,0,0,2000
20200312,2441,超豐,45.10,45.10,43.10,44.00,-1.55,-3.4,1558164,1102,68201232,282000,709000,-427000,2000,0,2000,6000,20000,-14000,-439000
20200312,2442,新美齊,8.23,8.32,7.68,7.68,-0.85,-9.96,5499053,1207,43346959,873000,362000,511000,2000,0,2000,0,3000,-3000,510000
20200312,2443,億麗,3.24,3.31,2.98,3.00,-0.31,-9.37,715599,213,2162462,1000,26000,-25000,0,0,0,0,0,0,-25000
20200312,2444,兆勁,16.80,16.80,15.65,16.15,-1.00,-5.83,758724,377,12166367,24000,52000,-28000,0,0,0,0,1000,-1000,-29000
20200312,2448,晶電,31.75,31.75,28.85,29.05,-3.00,-9.36,44313449,16854,1331017437,4763000,15554000,-10791000,40000,0,40000,548000,994000,-446000,-11197000
20200312,2449,京元電子,33.00,33.00,30.75,31.10,-2.40,-7.16,13651161,6559,431272602,2079000,8583000,-6504000,150000,0,150000,2675000,522000,2153000,-4201000
20200312,2450,神腦,30.50,30.50,29.00,29.50,-1.05,-3.44,467189,291,13781606,4000,178000,-174000,0,0,0,1000,0,1000,-173000
20200312,2451,創見,75.00,76.40,74.60,76.40,+0.40,0.53,2360786,1349,178039747,456000,1393000,-937000,0,0,0,1559000,63000,1496000,559000
20200312,2453,凌群,14.70,14.70,13.75,13.85,-1.05,-7.05,987486,474,13871276,188000,166000,22000,0,0,0,0,1000,-1000,21000
20200312,2454,聯發科,356.00,358.50,336.00,336.00,-27.00,-7.44,19312208,12801,6651230970,6506021,9972859,-3466838,61000,272000,-211000,240000,958000,-718000,-4395838
20200312,2455,全新,89.80,89.90,83.40,85.00,-6.10,-6.7,5226333,3369,449896232,1317000,1043000,274000,0,10000,-10000,169000,376000,-207000,57000
20200312,2456,奇力新,99.00,99.20,90.30,91.10,-8.40,-8.44,10607576,7392,990697999,3164000,1549000,1615000,3000,484509,-481509,68000,306000,-238000,895491
20200312,2457,飛宏,7.75,7.75,7.16,7.17,-0.63,-8.08,1326453,426,9681282,118000,137000,-19000,0,0,0,0,5000,-5000,-24000
20200312,2458,義隆,83.50,83.60,79.70,80.50,-3.80,-4.51,6782862,4660,551244385,589800,2335000,-1745200,271000,0,271000,299000,486000,-187000,-1661200
20200312,2459,敦吉,39.15,39.15,38.20,38.65,-1.00,-2.52,354903,243,13758767,60000,79000,-19000,0,0,0,0,0,0,-19000
20200312,2460,建通,8.83,9.00,8.50,8.57,-0.44,-4.88,50067,46,432425,3000,1000,2000,0,0,0,9000,2000,7000,9000
20200312,2461,光群雷,15.05,15.10,13.55,13.75,-1.30,-8.64,2822006,1047,39179496,325000,421000,-96000,0,0,0,0,0,0,-96000
20200312,2462,良得電,26.50,26.50,24.60,24.70,-1.90,-7.14,124446,95,3122065,5000,9000,-4000,0,0,0,0,3000,-3000,-7000
20200312,2464,盟立,33.00,33.60,31.10,31.20,-2.40,-7.14,1428108,891,45583045,63000,400000,-337000,0,0,0,50000,1000,49000,-288000
20200312,2465,麗臺,8.90,8.90,8.10,8.10,-0.90,-10.0,399806,191,3285104,19000,7000,12000,0,0,0,0,1000,-1000,11000
20200312,2466,冠西電,33.40,33.40,33.00,33.15,-0.25,-0.75,69000,51,2284550,1000,22000,-21000,0,0,0,0,1000,-1000,-22000
20200312,2467,志聖,26.70,26.70,25.50,25.75,-0.95,-3.56,1507680,909,39003832,288000,352000,-64000,0,0,0,0,0,0,-64000
20200312,2468,華經,13.50,13.55,13.10,13.50,0.00,0.00,699002,334,9326226,5000,32000,-27000,0,0,0,0,0,0,-27000
20200312,2471,資通,18.85,18.85,17.90,18.10,-0.75,-3.98,430013,250,7810010,6000,38000,-32000,0,0,0,0,0,0,-32000
20200312,2472,立隆電,34.30,34.45,31.50,32.20,-2.45,-7.07,890300,561,28916730,137000,245000,-108000,0,0,0,72000,15000,57000,-51000
20200312,2474,可成,214.00,217.00,199.00,201.00,-19.50,-8.84,7212584,5285,1478699825,2089322,2754399,-665077,5000,108000,-103000,354000,397495,-43495,-811572
20200312,2476,鉅祥,20.10,20.35,19.75,19.85,-0.95,-4.57,363341,197,7251667,15000,150000,-135000,0,0,0,1000,2000,-1000,-136000
20200312,2477,美隆電,20.00,20.00,18.50,18.75,-1.45,-7.18,281000,217,5327800,38000,98000,-60000,0,0,0,1000,6000,-5000,-65000
20200312,2478,大毅,68.50,68.80,62.50,63.00,-5.80,-8.43,11312985,7186,737161955,2695000,1393000,1302000,0,0,0,12000,92000,-80000,1222000
20200312,2480,敦陽科,60.00,60.20,57.80,58.30,-2.70,-4.43,2825564,1888,166091751,919000,260000,659000,0,0,0,76000,140000,-64000,595000
20200312,2481,強茂,23.50,23.55,21.60,21.65,-2.30,-9.6,4625695,2273,102421679,631000,1264000,-633000,0,0,0,2000,114000,-112000,-745000
20200312,2482,連宇,12.45,12.45,11.70,12.25,-0.15,-1.21,361000,196,4355000,8000,17000,-9000,0,0,0,0,3000,-3000,-12000
20200312,2483,百容,19.80,19.90,19.35,19.35,-0.55,-2.76,427429,198,8332828,4000,24000,-20000,0,0,0,0,0,0,-20000
20200312,2484,希華,19.00,19.30,18.25,18.25,-0.85,-4.45,1938120,1033,36381936,532000,385000,147000,0,0,0,0,68000,-68000,79000
20200312,2485,兆赫,16.60,16.60,15.00,15.25,-1.35,-8.13,2491071,1161,38521888,196000,599000,-403000,0,0,0,1000,10000,-9000,-412000
20200312,2486,一詮,7.03,7.03,6.36,6.50,-0.53,-7.54,842351,322,5534482,36000,102000,-66000,0,0,0,0,4000,-4000,-70000
20200312,2488,漢平,30.10,30.10,28.00,28.40,-1.70,-5.65,723012,495,20865660,47000,181000,-134000,0,0,0,0,1000,-1000,-135000
20200312,2489,瑞軒,8.45,8.49,8.15,8.20,-0.42,-4.87,2157333,1040,17774092,366000,714000,-348000,0,0,0,7000,43000,-36000,-384000
20200312,2491,吉祥全,9.25,9.25,8.82,9.18,-0.62,-6.33,126002,49,1119737,1000,0,1000,0,0,0,0,0,0,1000
20200312,2492,華新科,194.50,195.50,178.00,178.50,-18.50,-9.39,23294590,14819,4286883200,3956471,5008191,-1051720,2000,371000,-369000,1892000,1164000,728000,-692720
20200312,2493,揚博,26.90,26.90,26.30,26.35,-0.60,-2.23,571656,305,15087529,12000,105000,-93000,0,0,0,0,0,0,-93000
20200312,2495,普安,11.90,11.90,11.50,11.55,-0.50,-4.15,424321,213,4932702,1000,103000,-102000,0,0,0,0,6000,-6000,-108000
20200312,2496,卓越,64.30,64.30,60.40,61.10,-4.10,-6.29,110029,86,6756912,7000,10000,-3000,0,0,0,0,0,0,-3000
20200312,2497,怡利電,18.10,18.10,16.65,16.70,-1.80,-9.73,288050,149,4878485,6000,15000,-9000,0,0,0,1000,2000,-1000,-10000
20200312,2498,宏達電,34.70,34.70,31.90,32.10,-2.75,-7.89,12699765,6217,415849953,756598,2901000,-2144402,0,0,0,160000,984000,-824000,-2968402
20200312,2499,東貝,7.41,7.80,7.18,7.29,-0.21,-2.8,6481080,2096,47875400,757000,222000,535000,0,0,0,0,1000,-1000,534000
20200312,2501,國建,19.85,19.85,18.85,19.20,-1.05,-5.19,1479061,783,28561419,173000,628000,-455000,0,0,0,0,19000,-19000,-474000
20200312,2504,國產,12.00,12.10,11.05,11.05,-1.20,-9.8,15815771,4187,178927665,4897000,1006000,3891000,500000,0,500000,105000,96000,9000,4400000
20200312,2505,國揚,15.75,15.75,15.10,15.50,-0.45,-2.82,1277438,485,19591686,139000,499000,-360000,0,0,0,3000,20000,-17000,-377000
20200312,2506,太設,10.00,10.00,9.81,9.90,-0.10,-1.0,150919,69,1492555,1000,11000,-10000,0,0,0,0,0,0,-10000
20200312,2509,全坤建,20.00,20.30,19.00,19.85,-0.65,-3.17,208844,107,4069124,0,8000,-8000,0,0,0,0,1000,-1000,-9000
20200312,2511,太子,10.40,10.40,10.05,10.10,-0.35,-3.35,2207955,791,22417791,290000,380000,-90000,0,0,0,0,138000,-138000,-228000
20200312,2514,龍邦,15.10,15.30,14.15,14.15,-1.10,-7.21,651154,420,9547916,8000,86000,-78000,0,0,0,2000,9000,-7000,-85000
20200312,2515,中工,6.90,6.91,6.47,6.47,-0.48,-6.91,10839547,1866,71987162,428000,1901000,-1473000,0,0,0,29000,381000,-352000,-1825000
20200312,2516,新建,5.40,5.51,5.06,5.06,-0.46,-8.33,735117,122,3843527,10000,55000,-45000,0,0,0,0,0,0,-45000
20200312,2520,冠德,24.80,24.80,22.65,23.20,-1.50,-6.07,2732484,1278,63961472,507000,1098000,-591000,0,0,0,1000,37000,-36000,-627000
20200312,2524,京城,29.50,29.50,27.50,27.65,-2.10,-7.06,507886,291,14322641,58000,166000,-108000,0,0,0,7000,2000,5000,-103000
20200312,2527,宏璟,19.85,19.90,19.30,19.35,-0.70,-3.49,436000,202,8533650,23000,96000,-73000,0,0,0,68000,8000,60000,-13000
20200312,2528,皇普,19.55,19.55,18.95,19.25,-0.30,-1.53,377311,162,7243474,31000,28000,3000,0,0,0,6000,0,6000,9000
20200312,2530,華建,16.55,16.55,16.00,16.15,-0.50,-3.0,569014,108,9224424,10000,10000,0,0,0,0,0,0,0,0
20200312,2534,宏盛,19.20,19.25,18.00,18.15,-0.95,-4.97,2215219,1046,40662951,154000,336000,-182000,0,0,0,54000,8000,46000,-136000
20200312,2535,達欣工,21.40,21.45,20.95,21.10,-0.60,-2.76,4217866,1432,89128038,960000,486000,474000,0,0,0,0,210195,-210195,263805
20200312,2536,宏普,23.10,23.10,22.45,22.65,-0.55,-2.37,1135070,369,25709825,18000,286000,-268000,0,0,0,0,7000,-7000,-275000
20200312,2537,聯上發,8.41,8.41,7.73,7.93,-0.65,-7.58,6467860,1792,51373177,1440000,653000,787000,0,0,0,0,0,0,787000
20200312,2538,基泰,10.40,10.40,9.80,10.00,-0.55,-5.21,2036016,542,20377630,206000,127000,79000,0,0,0,0,18000,-18000,61000
20200312,2539,櫻花建,30.00,30.00,29.80,29.95,-0.05,-0.17,240204,114,7181358,5000,54000,-49000,0,0,0,0,0,0,-49000
20200312,2540,愛山林,21.55,22.30,21.55,21.70,-0.60,-2.69,18000,9,390050,0,7000,-7000,0,0,0,5000,0,5000,-2000
20200312,2542,興富發,43.50,43.55,41.80,41.80,-2.05,-4.68,6072359,3688,256589728,1727958,2960000,-1232042,0,0,0,354000,187000,167000,-1065042
20200312,2543,皇昌,7.00,7.00,6.85,6.85,-0.15,-2.14,3006,8,20886,0,1000,-1000,0,0,0,0,0,0,-1000
20200312,2545,皇翔,31.55,33.00,29.65,33.00,+0.90,2.8,822328,376,25552058,11000,215000,-204000,0,0,0,0,20000,-20000,-224000
20200312,2546,根基,38.15,38.15,36.40,36.50,-1.65,-4.33,534445,346,19757926,11000,60000,-49000,0,0,0,5000,0,5000,-44000
20200312,2547,日勝生,9.98,9.98,9.35,9.40,-0.60,-6.0,1518153,719,14546805,205000,516000,-311000,0,0,0,0,0,0,-311000
20200312,2548,華固,88.00,88.50,86.70,88.30,+1.80,2.08,3446541,2563,302225849,275000,687000,-412000,0,0,0,9000,126000,-117000,-529000
20200312,2597,潤弘,60.00,60.10,58.40,58.60,-2.20,-3.62,154202,129,9105237,10000,22000,-12000,0,0,0,0,10000,-10000,-22000
20200312,2601,益航,8.90,8.90,8.16,8.46,-0.55,-6.1,4812776,1200,40638097,383000,715000,-332000,0,0,0,1000,60000,-59000,-391000
20200312,2603,長榮,11.50,11.55,11.10,11.10,-0.45,-3.9,28715813,6119,322770733,2292250,13276229,-10983979,1232000,0,1232000,23000,275000,-252000,-10003979
20200312,2605,新興,13.00,13.00,12.20,12.35,-0.70,-5.36,3333175,1281,41634076,189000,781000,-592000,0,795000,-795000,133000,122000,11000,-1376000
20200312,2606,裕民,28.75,28.95,28.00,28.20,-0.65,-2.25,2537355,1219,71735278,204000,965000,-761000,4000,0,4000,0,12000,-12000,-769000
20200312,2607,榮運,13.50,13.50,13.00,13.10,-0.40,-2.96,2479854,531,32620352,101000,863000,-762000,0,0,0,0,24000,-24000,-786000
20200312,2608,嘉里大榮,37.80,38.00,37.30,37.60,-0.70,-1.83,378314,298,14247089,68000,80000,-12000,0,0,0,0,8000,-8000,-20000
20200312,2609,陽明,6.50,6.51,6.14,6.19,-0.36,-5.5,4632502,1033,29084651,167000,260000,-93000,0,0,0,0,0,0,-93000
20200312,2610,華航,7.99,7.99,7.61,7.66,-0.33,-4.13,24935594,7086,192719795,4903722,10740217,-5836495,22000,0,22000,0,472000,-472000,-6286495
20200312,2611,志信,6.85,6.85,6.69,6.70,-0.25,-3.6,373586,81,2517621,3000,22000,-19000,0,0,0,0,0,0,-19000
20200312,2612,中航,25.00,25.00,23.50,23.80,-1.40,-5.56,697215,440,16806917,55000,223000,-168000,0,60000,-60000,0,6000,-6000,-234000
20200312,2613,中櫃,12.30,12.30,11.80,12.15,-0.15,-1.22,183138,144,2194842,4000,14000,-10000,0,0,0,0,4000,-4000,-14000
20200312,2614,東森,11.85,11.95,11.20,11.50,-0.40,-3.36,5266348,1927,60832218,666000,903000,-237000,0,0,0,0,6000,-6000,-243000
20200312,2615,萬海,16.30,16.35,15.70,15.70,-0.80,-4.85,2605854,1096,41323640,232000,914000,-682000,8000,0,8000,1000,7000,-6000,-680000
20200312,2616,山隆,29.60,29.60,28.70,28.70,-0.95,-3.2,394787,269,11413676,2000,72000,-70000,0,0,0,0,0,0,-70000
20200312,2617,台航,15.30,15.35,14.75,14.95,-0.55,-3.55,876999,376,13180285,24000,263000,-239000,0,0,0,0,2000,-2000,-241000
20200312,2618,長榮航,11.65,11.65,11.20,11.30,-0.40,-3.42,27836987,7657,316412444,6030904,9876418,-3845514,19000,0,19000,286000,454000,-168000,-3994514
20200312,2630,亞航,16.80,16.80,15.55,15.70,-1.30,-7.65,59507,49,960508,3000,12000,-9000,0,0,0,1000,0,1000,-8000
20200312,2633,台灣高鐵,32.00,32.00,31.00,31.10,-1.30,-4.01,14870102,7405,465942548,3648862,3941182,-292320,21000,0,21000,30000,223000,-193000,-464320
20200312,2634,漢翔,29.30,29.30,28.60,28.80,-0.75,-2.54,5139719,2166,148284388,135000,1084000,-949000,3000,0,3000,0,0,0,-946000
20200312,2636,台驊投控,22.00,22.10,21.30,21.45,-0.65,-2.94,442606,252,9568277,7000,46000,-39000,0,0,0,0,7000,-7000,-46000
20200312,2637,慧洋-KY,26.35,26.40,25.50,25.55,-0.95,-3.58,3023956,1133,77872768,349000,609500,-260500,2000,0,2000,660000,999,659001,400501
20200312,2642,宅配通,30.00,30.00,27.40,27.90,-1.80,-6.06,943760,617,26761816,99000,117000,-18000,0,0,0,0,0,0,-18000
20200312,2701,萬企,12.45,12.45,12.25,12.30,-0.25,-1.99,235290,97,2900420,0,27000,-27000,0,0,0,0,12000,-12000,-39000
20200312,2702,華園,14.75,14.75,13.55,13.75,-1.15,-7.72,451927,239,6322229,15000,41000,-26000,0,0,0,0,0,0,-26000
20200312,2704,國賓,24.80,25.05,24.00,24.00,-1.20,-4.76,177152,127,4337421,9000,83000,-74000,0,0,0,0,0,0,-74000
20200312,2705,六福,11.90,11.90,10.80,11.10,-0.85,-7.11,972457,267,10864327,10000,52000,-42000,0,0,0,1000,1000,0,-42000
20200312,2706,第一店,14.35,14.35,13.95,14.00,-0.50,-3.45,355978,152,5010582,14000,62000,-48000,0,0,0,0,19000,-19000,-67000
20200312,2707,晶華,148.00,148.00,141.50,142.00,-6.00,-4.05,622336,436,89412384,47000,91000,-44000,0,0,0,0,6000,-6000,-50000
20200312,2712,遠雄來,33.80,40.20,33.80,39.00,+1.95,5.26,20200,20,718410,0,6000,-6000,0,0,0,0,0,0,-6000
20200312,2722,夏都,22.95,22.95,22.85,22.85,+0.15,0.66,3488,4,79728,0,1000,-1000,0,0,0,0,0,0,-1000
20200312,2723,美食-KY,87.50,87.70,83.30,84.20,-4.80,-5.39,1887771,1477,159684349,463000,732000,-269000,0,0,0,41000,34000,7000,-262000
20200312,2727,王品,67.40,67.80,65.20,66.10,-1.30,-1.93,575382,539,37905229,41000,150000,-109000,0,0,0,0,0,0,-109000
20200312,2731,雄獅,68.50,68.50,65.70,66.00,-3.00,-4.35,426099,362,28311933,9000,65000,-56000,0,0,0,0,0,0,-56000
20200312,2739,寒舍,22.85,22.85,21.80,22.40,-0.35,-1.54,87133,48,1942705,0,2000,-2000,0,0,0,0,0,0,-2000
20200312,2748,雲品,43.30,43.30,41.60,41.75,-1.55,-3.58,225003,139,9506890,3000,18000,-15000,0,0,0,0,0,0,-15000
20200312,2801,彰銀,23.00,23.00,21.95,22.20,-0.85,-3.69,22826915,5352,511162480,5520848,14692641,-9171793,69000,0,69000,78000,269000,-191000,-9293793
20200312,2809,京城銀,35.85,35.85,33.45,33.80,-2.35,-6.5,6173418,2417,210863450,1615000,818000,797000,3000,0,3000,16000,769000,-753000,47000
20200312,2812,台中銀,11.90,11.90,11.50,11.65,-0.30,-2.51,25389429,7683,296914596,2026100,5441327,-3415227,0,0,0,32000,122000,-90000,-3505227
20200312,2816,旺旺保,19.60,19.60,18.80,18.85,-0.95,-4.8,744649,253,14158477,32000,84000,-52000,0,0,0,0,0,0,-52000
20200312,2820,華票,15.00,15.00,14.70,14.75,-0.30,-1.99,2928584,1226,43312540,185000,817000,-632000,0,0,0,0,24000,-24000,-656000
20200312,2823,中壽,21.65,21.65,20.05,20.20,-1.85,-8.39,41645834,12403,857181655,8865786,17704138,-8838352,31000,0,31000,373000,394000,-21000,-8828352
20200312,2832,台產,20.10,20.10,19.65,19.80,-0.35,-1.74,658306,356,13045849,12000,73000,-61000,0,0,0,0,8000,-8000,-69000
20200312,2834,臺企銀,11.05,11.10,10.70,10.70,-0.50,-4.46,51644990,16922,560353186,3571884,12576946,-9005062,32000,0,32000,37000,247000,-210000,-9183062
20200312,2836,高雄銀,9.50,9.50,9.20,9.25,-0.28,-2.94,2037655,687,18917040,163000,468000,-305000,0,0,0,0,31000,-31000,-336000
20200312,2838,聯邦銀,10.55,10.60,10.25,10.35,-0.20,-1.9,3670679,1116,38164403,128000,1456000,-1328000,0,0,0,27000,27000,0,-1328000
20200312,2838A,聯邦銀甲特,55.30,55.30,54.70,55.10,-0.20,-0.36,430000,164,23699700,0,4000,-4000,0,0,0,212000,42000,170000,166000
20200312,2841,台開,6.84,6.84,6.35,6.35,-0.57,-8.24,4942210,1302,32334660,268000,813000,-545000,0,0,0,0,15000,-15000,-560000
20200312,2845,遠東銀,11.25,11.25,10.85,10.90,-0.50,-4.39,10933447,2844,120439811,565000,2353000,-1788000,15000,0,15000,24000,26000,-2000,-1775000
20200312,2849,安泰銀,14.70,14.80,14.30,14.40,-0.30,-2.04,398500,157,5742400,72000,241000,-169000,0,0,0,0,0,0,-169000
20200312,2850,新產,37.00,37.00,35.55,35.75,-1.40,-3.77,897101,550,32198786,57000,261000,-204000,0,0,0,0,8000,-8000,-212000
20200312,2851,中再保,19.50,19.50,18.50,18.65,-1.00,-5.09,1000225,564,18863491,54000,307000,-253000,0,0,0,2000,2000,0,-253000
20200312,2852,第一保,13.40,13.40,12.70,12.70,-0.70,-5.22,297438,146,3827236,5000,82000,-77000,0,0,0,2000,1000,1000,-76000
20200312,2855,統一證,12.95,12.95,12.50,12.50,-0.55,-4.21,4151338,1105,52368369,304000,1474000,-1170000,0,0,0,0,0,0,-1170000
20200312,2867,三商壽,10.60,10.65,10.10,10.20,-0.55,-5.12,9333462,2200,96213347,658000,2345000,-1687000,0,0,0,0,27000,-27000,-1714000
20200312,2880,華南金,20.55,20.55,19.95,20.00,-0.75,-3.61,48067908,19145,966685450,9802138,18282676,-8480538,97000,0,97000,114000,656000,-542000,-8925538
20200312,2881,富邦金,41.90,42.05,40.40,40.50,-1.65,-3.91,33454565,14019,1367131981,12093226,24832868,-12739642,79000,75000,4000,141000,450000,-309000,-13044642
20200312,2881A,富邦特,65.90,65.90,65.30,65.60,-0.50,-0.76,417300,131,27370489,11000,61000,-50000,0,0,0,128000,24000,104000,54000
20200312,2881B,富邦金乙特,65.30,65.60,64.80,65.40,-0.30,-0.46,268646,105,17490390,0,0,0,0,0,0,65000,17000,48000,48000
20200312,2882,國泰金,38.50,38.50,37.50,37.50,-1.10,-2.85,51516707,19225,1946835395,10816682,33672653,-22855971,92000,0,92000,130000,551000,-421000,-23184971
20200312,2882A,國泰特,64.80,64.80,64.10,64.40,-0.50,-0.77,256753,85,16525892,17000,0,17000,0,0,0,35000,91000,-56000,-39000
20200312,2882B,國泰金乙特,64.60,64.60,64.00,64.60,-0.20,-0.31,342291,112,21988209,61000,0,61000,0,0,0,46000,169000,-123000,-62000
20200312,2883,開發金,8.90,8.91,8.51,8.56,-0.41,-4.57,58905732,13473,508700498,10721432,27831397,-17109965,138000,0,138000,283000,390000,-107000,-17078965
20200312,2884,玉山金,27.85,27.90,26.75,27.05,-0.75,-2.7,130071277,44644,3538337310,22077681,71714313,-49636632,108000,0,108000,1159000,2507000,-1348000,-50876632
20200312,2885,元大金,18.10,18.15,17.30,17.50,-0.75,-4.11,37896475,10111,669660836,11062417,27073381,-16010964,109000,0,109000,165000,576000,-411000,-16312964
20200312,2886,兆豐金,30.75,30.85,29.90,30.20,-1.00,-3.21,61293461,20149,1857854188,13591214,33691393,-20100179,5938000,0,5938000,5618000,3461000,2157000,-12005179
20200312,2887,台新金,13.80,13.80,13.45,13.50,-0.40,-2.88,56564024,15263,767029278,7227198,25045235,-17818037,99000,0,99000,303000,1203000,-900000,-18619037
20200312,2887E,台新戊特,56.50,56.50,55.70,55.80,-0.70,-1.24,282673,100,15843550,0,0,0,0,0,0,30000,0,30000,30000
20200312,2887F,台新戊特二,54.50,54.80,54.30,54.60,-0.40,-0.73,126120,45,6901213,0,0,0,0,0,0,0,1000,-1000,-1000
20200312,2888,新光金,8.91,8.95,8.65,8.69,-0.34,-3.77,81344473,13011,714402942,14143212,39584354,-25441142,194000,0,194000,1150000,1486000,-336000,-25583142
20200312,2888A,新光金甲特,45.90,45.90,45.60,45.65,-0.30,-0.65,811555,196,37081556,21000,0,21000,0,0,0,0,305000,-305000,-284000
20200312,2889,國票金,10.80,10.85,10.50,10.60,-0.35,-3.2,10928780,3094,115850304,648000,2137000,-1489000,0,0,0,25000,95000,-70000,-1559000
20200312,2890,永豐金,12.15,12.20,11.65,11.75,-0.60,-4.86,39057915,8115,461249667,17272953,21667241,-4394288,103000,0,103000,136000,1119000,-983000,-5274288
20200312,2891,中信金,21.05,21.05,20.40,20.50,-0.85,-3.98,88864211,23327,1832673326,26021738,56199955,-30178217,179000,0,179000,1698000,853000,845000,-29154217
20200312,2891B,中信金乙特,65.90,66.20,65.40,66.20,-0.10,-0.15,122272,78,8025236,0,0,0,0,0,0,21000,37000,-16000,-16000
20200312,2891C,中信金丙特,63.70,63.70,63.00,63.50,-0.40,-0.63,161584,104,10245119,0,0,0,0,0,0,17000,11000,6000,6000
20200312,2892,第一金,22.50,22.50,21.50,21.80,-0.85,-3.75,52201000,19386,1139851638,11262904,24057915,-12795011,103000,0,103000,129000,683000,-554000,-13246011
20200312,2897,王道銀行,6.97,6.97,6.57,6.66,-0.34,-4.86,5736069,1521,38285636,971000,793000,178000,8000,0,8000,29000,47000,-18000,168000
20200312,2897A,王道銀甲特,10.55,10.55,10.50,10.50,-0.05,-0.47,499000,82,5254950,0,0,0,0,0,0,260000,0,260000,260000
20200312,2901,欣欣,23.05,23.20,22.50,22.55,-0.75,-3.22,58005,34,1321815,1000,9000,-8000,0,0,0,0,0,0,-8000
20200312,2903,遠百,22.00,22.20,21.45,22.20,-0.35,-1.55,2620639,635,57538608,180000,930000,-750000,0,0,0,2000,5000,-3000,-753000
20200312,2904,匯僑,21.20,21.20,20.20,20.30,-0.95,-4.47,143007,107,2926861,0,7000,-7000,0,0,0,0,0,0,-7000
20200312,2905,三商,19.50,19.50,18.45,18.55,-1.30,-6.55,2410346,1125,45242729,406000,297000,109000,0,0,0,0,0,0,109000
20200312,2906,高林,11.00,11.00,10.65,10.65,-0.40,-3.62,297480,53,3232561,1000,9000,-8000,0,0,0,1000,1000,0,-8000
20200312,2908,特力,19.80,19.80,19.10,19.50,-0.30,-1.52,455926,161,8838770,8000,88000,-80000,0,0,0,0,0,0,-80000
20200312,2910,統領,28.10,28.10,25.60,25.60,-2.40,-8.57,19003,17,506827,1000,6000,-5000,0,0,0,0,0,0,-5000
20200312,2911,麗嬰房,6.94,6.94,6.63,6.71,-0.35,-4.96,414770,173,2799994,3000,46000,-43000,0,0,0,0,1000,-1000,-44000
20200312,2912,統一超,289.00,289.00,284.50,286.50,-4.50,-1.55,2387255,1895,684572185,656821,1822577,-1165756,108000,0,108000,10000,20000,-10000,-1067756
20200312,2913,農林,15.00,15.00,14.70,14.75,-0.35,-2.32,2190315,522,32472849,190000,490000,-300000,0,0,0,0,89000,-89000,-389000
20200312,2915,潤泰全,67.60,68.00,66.00,66.10,-2.20,-3.22,4279106,2113,285536615,824889,1445000,-620111,0,0,0,1941000,87000,1854000,1233889
20200312,2923,鼎固-KY,23.50,23.50,22.55,22.65,-0.45,-1.95,150000,97,3416950,6000,89000,-83000,0,0,0,0,0,0,-83000
20200312,2929,淘帝-KY,68.50,68.50,63.80,64.60,-4.60,-6.65,1416262,1104,92992301,234000,368000,-134000,0,0,0,0,3000,-3000,-137000
20200312,2936,客思達-KY,18.15,18.15,18.15,18.15,-0.15,-0.82,1000,1,18150,1000,0,1000,0,0,0,0,0,0,1000
20200312,2939,凱羿-KY,95.80,97.10,90.50,90.60,-5.90,-6.11,138100,115,12765869,11000,32000,-21000,0,0,0,0,0,0,-21000
20200312,3002,歐格,10.00,10.00,9.60,9.74,-0.21,-2.11,71000,37,694170,4000,11000,-7000,0,0,0,0,0,0,-7000
20200312,3003,健和興,39.10,39.10,35.85,36.35,-2.75,-7.03,1200214,712,44392988,411000,298000,113000,0,0,0,4000,5000,-1000,112000
20200312,3004,豐達科,64.00,64.00,59.80,60.70,-5.10,-7.75,1063253,686,65004505,312000,68000,244000,0,0,0,0,253000,-253000,-9000
20200312,3005,神基,49.05,49.50,48.60,48.90,-1.05,-2.1,4308465,1944,211180847,679000,2909000,-2230000,0,0,0,2856000,65000,2791000,561000
20200312,3006,晶豪科,35.85,36.00,32.50,32.50,-3.50,-9.72,8430220,4524,284478506,492000,2485000,-1993000,0,0,0,152000,615000,-463000,-2456000
20200312,3008,大立光,4170.00,4190.00,3970.00,3980.00,-405.00,-9.24,1583912,2003,6452953000,392205,861791,-469586,25000,2800,22200,37000,59000,-22000,-469386
20200312,3010,華立,52.60,52.60,51.50,51.60,-1.80,-3.37,741526,499,38459931,28000,413000,-385000,0,0,0,0,1000,-1000,-386000
20200312,3011,今皓,5.10,5.15,4.78,4.80,-0.35,-6.8,296005,103,1469940,3000,14000,-11000,0,0,0,0,0,0,-11000
20200312,3013,晟銘電,11.25,11.55,10.55,11.50,+0.10,0.88,1242011,489,13843987,15000,92000,-77000,0,0,0,1000,3000,-2000,-79000
20200312,3014,聯陽,45.80,45.80,43.80,44.90,-1.30,-2.81,4901114,2978,219355298,2135825,684000,1451825,0,0,0,21000,132000,-111000,1340825
20200312,3015,全漢,19.00,19.00,18.20,18.20,-0.85,-4.46,427224,174,7851542,13000,75000,-62000,0,0,0,1000,1000,0,-62000
20200312,3016,嘉晶,53.40,54.60,50.00,51.00,-3.20,-5.9,18366298,11343,963620440,1181000,1816000,-635000,8000,0,8000,197000,446000,-249000,-876000
20200312,3017,奇鋐,33.95,34.05,32.05,32.20,-2.30,-6.67,15916695,8139,524718575,1438000,3780000,-2342000,12000,0,12000,117000,257000,-140000,-2470000
20200312,3018,同開,21.90,22.70,19.80,19.80,-2.10,-9.59,2924141,909,63517908,233000,240000,-7000,0,0,0,0,0,0,-7000
20200312,3019,亞光,77.10,77.40,70.90,71.00,-7.50,-9.55,6266388,4265,460650161,944000,826000,118000,0,0,0,12000,255000,-243000,-125000
20200312,3021,鴻名,14.15,14.15,13.75,13.85,-0.50,-3.48,70100,45,974684,3000,7000,-4000,0,0,0,0,1000,-1000,-5000
20200312,3022,威強電,41.30,41.30,39.00,41.30,-0.50,-1.2,378404,233,15244364,78000,38000,40000,0,0,0,0,0,0,40000
20200312,3023,信邦,121.50,122.00,114.00,117.00,-8.00,-6.4,2639076,1744,313561414,471000,1346000,-875000,748000,0,748000,17000,175000,-158000,-285000
20200312,3024,憶聲,7.03,7.10,6.80,6.97,-0.29,-3.99,566709,140,3951079,10000,70000,-60000,0,0,0,1000,0,1000,-59000
20200312,3025,星通,18.55,18.55,17.35,17.70,-1.35,-7.09,206010,127,3674970,5000,28000,-23000,0,0,0,1000,1000,0,-23000
20200312,3026,禾伸堂,97.80,98.00,90.90,95.80,+1.70,1.81,14149641,10292,1341492747,744000,1450000,-706000,0,0,0,46000,229000,-183000,-889000
20200312,3027,盛達,7.60,7.71,7.28,7.30,-0.42,-5.44,325251,135,2394773,7000,6000,1000,0,0,0,2000,1000,1000,2000
20200312,3028,增你強,19.95,19.95,19.40,19.55,-0.40,-2.01,863205,555,16874021,18000,189000,-171000,0,0,0,0,5000,-5000,-176000
20200312,3029,零壹,30.35,30.45,29.60,29.85,-1.15,-3.71,2247607,1356,67329638,543000,315000,228000,0,0,0,0,14000,-14000,214000
20200312,3030,德律,50.80,50.90,48.55,48.80,-2.20,-4.31,1340484,962,66140662,121000,620000,-499000,0,0,0,7000,20000,-13000,-512000
20200312,3031,佰鴻,12.90,12.95,12.25,12.35,-0.75,-5.73,450270,224,5638221,73000,173000,-100000,0,0,0,0,0,0,-100000
20200312,3032,偉訓,24.80,24.80,24.05,24.25,-0.75,-3.0,208673,161,5067415,12000,35000,-23000,0,0,0,0,5000,-5000,-28000
20200312,3033,威健,16.10,16.10,15.70,15.70,-0.50,-3.09,1329412,1018,21023051,14000,121000,-107000,0,0,0,0,13000,-13000,-120000
20200312,3034,聯詠,191.00,191.00,179.50,185.50,-7.50,-3.89,8710563,5268,1616988781,3379995,3612168,-232173,48000,15000,33000,491000,433000,58000,-141173
20200312,3035,智原,42.10,42.10,38.15,38.35,-4.00,-9.45,4425105,2912,174099987,826000,1242000,-416000,0,0,0,3000,122000,-119000,-535000
20200312,3036,文曄,38.20,38.20,37.50,37.65,-0.75,-1.95,2915811,1337,110144312,546561,555000,-8439,1000,0,1000,57000,156000,-99000,-106439
20200312,3037,欣興,36.80,36.80,33.70,33.70,-3.70,-9.89,67001624,23627,2304475148,9474000,19363000,-9889000,243000,2692000,-2449000,914000,2023000,-1109000,-13447000
20200312,3038,全台,15.60,15.60,14.75,14.90,-0.80,-5.1,2215144,941,33304872,248000,629000,-381000,0,0,0,13000,63000,-50000,-431000
20200312,3040,遠見,29.10,29.10,27.85,28.05,-1.05,-3.61,137626,112,3869163,0,6000,-6000,0,0,0,0,1000,-1000,-7000
20200312,3041,揚智,18.20,19.15,17.40,17.50,-0.70,-3.85,23486383,10475,431923176,2120000,3033000,-913000,0,0,0,37000,0,37000,-876000
20200312,3042,晶技,52.90,53.00,47.35,47.35,-5.25,-9.98,28345904,14628,1410157967,4817513,6317000,-1499487,515000,188000,327000,381000,1559000,-1178000,-2350487
20200312,3043,科風,1.81,1.81,1.71,1.80,-0.05,-2.7,73470,37,132200,0,0,0,0,0,0,0,0,0,0
20200312,3044,健鼎,106.50,106.50,101.00,102.50,-6.00,-5.53,2994579,1992,308517924,543000,1668000,-1125000,0,0,0,32000,119000,-87000,-1212000
20200312,3045,台灣大,104.50,105.50,103.50,105.50,0.00,0.00,6640280,3604,692242400,2516663,4382058,-1865395,69000,0,69000,239000,148000,91000,-1705395
20200312,3046,建碁,11.10,11.20,10.50,10.50,-1.15,-9.87,138096,80,1467201,1000,6000,-5000,0,0,0,0,1000,-1000,-6000
20200312,3047,訊舟,8.56,8.70,7.90,7.90,-0.75,-8.67,1492189,516,12229753,163000,274000,-111000,0,0,0,0,4000,-4000,-115000
20200312,3048,益登,14.85,14.90,14.10,14.15,-1.05,-6.91,1444848,787,20760002,138000,529000,-391000,0,0,0,0,5000,-5000,-396000
20200312,3049,和鑫,10.45,10.45,9.60,9.65,-1.00,-9.39,14735309,3820,146281178,1893000,2914000,-1021000,0,0,0,0,98000,-98000,-1119000
20200312,3050,鈺德,10.15,10.20,9.83,9.91,-0.39,-3.79,956268,333,9541509,17000,114000,-97000,0,0,0,0,21000,-21000,-118000
20200312,3051,力特,3.53,3.55,3.31,3.55,-0.03,-0.84,440020,112,1517632,0,0,0,0,0,0,0,0,0,0
20200312,3052,夆典,10.95,10.95,9.99,10.25,-0.85,-7.66,4582442,1131,46498637,722000,204000,518000,0,0,0,0,0,0,518000
20200312,3054,立萬利,25.45,25.45,23.80,25.00,-0.40,-1.57,111025,97,2709175,13000,11000,2000,0,0,0,1000,1000,0,2000
20200312,3055,蔚華科,28.95,29.05,27.55,27.55,-1.85,-6.29,333006,207,9326212,52000,30000,22000,0,0,0,0,0,0,22000
20200312,3056,總太,27.05,27.05,25.60,27.00,-0.55,-2.0,3774312,1731,98631074,436000,686000,-250000,0,0,0,6000,6000,0,-250000
20200312,3057,喬鼎,5.90,5.90,5.31,5.40,-0.50,-8.47,475134,195,2598647,28000,16000,12000,0,0,0,0,0,0,12000
20200312,3058,立德,5.84,6.13,5.84,5.98,-0.33,-5.23,307182,132,1841466,8000,9000,-1000,0,0,0,0,0,0,-1000
20200312,3059,華晶科,19.60,19.60,17.95,18.05,-1.55,-7.91,2062808,964,38150666,153000,366000,-213000,0,0,0,0,8000,-8000,-221000
20200312,3060,銘異,14.35,14.50,13.15,13.60,-1.00,-6.85,3904790,1483,53567728,683000,204000,479000,0,0,0,0,0,0,479000
20200312,3062,建漢,14.50,14.70,13.80,14.00,-0.60,-4.11,2678543,1283,37605733,410000,738000,-328000,0,0,0,2000,2000,0,-328000
20200312,3090,日電貿,47.50,47.50,44.50,44.95,-2.65,-5.57,3060927,2196,139255015,708000,911000,-203000,0,0,0,3000,81000,-78000,-281000
20200312,3094,聯傑,18.45,18.45,17.00,17.30,-1.45,-7.73,1007845,587,17836777,59000,261000,-202000,0,0,0,0,0,0,-202000
20200312,3130,一零四,151.00,151.00,149.00,149.00,-2.50,-1.65,25101,39,3760751,0,9000,-9000,0,0,0,0,0,0,-9000
20200312,3149,正達,6.81,6.81,6.27,6.31,-0.65,-9.34,1279332,360,8083350,36000,15000,21000,0,0,0,0,0,0,21000
20200312,3164,景岳,23.90,23.90,22.00,22.40,-1.60,-6.67,294124,123,6682839,23000,17000,6000,0,0,0,0,3000,-3000,3000
20200312,3167,大量,39.75,39.75,38.50,39.50,-0.30,-0.75,370103,187,14522896,15000,43000,-28000,1000,0,1000,0,0,0,-27000
20200312,3189,景碩,48.45,48.45,44.10,44.15,-4.80,-9.81,6813589,4180,308473988,1440000,1389000,51000,0,1014000,-1014000,132000,505298,-373298,-1336298
20200312,3209,全科,18.95,18.95,18.10,18.25,-0.80,-4.2,1469608,788,27064735,52000,332000,-280000,0,0,0,21000,12000,9000,-271000
20200312,3229,晟鈦,10.90,10.90,10.35,10.80,-0.40,-3.57,68003,51,726580,2000,6000,-4000,0,0,0,0,0,0,-4000
20200312,3231,緯創,24.30,24.40,22.80,23.65,-1.05,-4.25,25676707,8793,606438751,10406996,12183083,-1776087,16000,1134000,-1118000,3544000,341000,3203000,308913
20200312,3257,虹冠電,47.05,47.90,46.00,47.75,+0.45,0.95,443216,224,20758145,71000,83000,-12000,0,0,0,0,8000,-8000,-20000
20200312,3266,昇陽,13.15,13.30,12.95,13.00,-0.55,-4.06,168000,57,2193050,0,5000,-5000,0,0,0,0,0,0,-5000
20200312,3296,勝德,13.25,13.30,12.15,12.30,-1.15,-8.55,352999,123,4314535,2000,1000,1000,0,0,0,1000,3000,-2000,-1000
20200312,3305,昇貿,21.40,21.40,20.45,20.55,-1.15,-5.3,356114,193,7384829,24000,29000,-5000,0,0,0,0,0,0,-5000
20200312,3308,聯德,4.80,5.28,4.80,5.00,-0.20,-3.85,25000,6,125280,0,0,0,0,0,0,0,0,0,0
20200312,3311,閎暉,25.60,25.60,24.50,24.70,-1.15,-4.45,196480,214,4897772,4000,29000,-25000,0,0,0,0,0,0,-25000
20200312,3312,弘憶股,13.65,13.65,12.70,12.70,-0.85,-6.27,929361,461,12003618,69000,326000,-257000,0,0,0,0,0,0,-257000
20200312,3321,同泰,11.15,11.20,10.15,10.15,-1.10,-9.78,1053324,334,10842036,8000,38000,-30000,0,0,0,0,0,0,-30000
20200312,3338,泰碩,88.00,88.10,81.50,84.30,-4.50,-5.07,11516961,7852,973206769,916000,760000,156000,8000,0,8000,119000,383000,-264000,-100000
20200312,3346,麗清,23.50,23.55,22.05,22.30,-2.15,-8.79,434066,272,9694303,99000,29000,70000,0,0,0,0,1000,-1000,69000
20200312,3356,奇偶,25.70,25.70,24.00,24.05,-1.65,-6.42,430607,290,10449292,37000,146000,-109000,0,0,0,0,1000,-1000,-110000
20200312,3376,新日興,131.00,131.50,119.50,123.00,-9.50,-7.17,5835444,3216,723369944,2221000,673000,1548000,13000,40000,-27000,43000,842000,-799000,722000
20200312,3380,明泰,20.15,20.15,19.30,19.55,-0.85,-4.17,3373077,1359,66434457,365000,487000,-122000,0,0,0,139000,363000,-224000,-346000
20200312,3383,新世紀,4.62,4.80,4.41,4.70,-0.13,-2.69,30606,21,139464,0,0,0,0,0,0,0,0,0,0
20200312,3406,玉晶光,478.00,478.00,432.00,432.00,-48.00,-10.0,11983697,9284,5361578927,1482000,1609000,-127000,0,104713,-104713,667000,1182000,-515000,-746713
20200312,3413,京鼎,144.50,145.00,133.00,133.00,-14.50,-9.83,2641295,1735,361760530,675000,888000,-213000,0,139000,-139000,14000,79000,-65000,-417000
20200312,3416,融程電,54.10,54.50,53.50,53.90,-1.00,-1.82,287555,164,15524457,1000,35000,-34000,0,0,0,0,0,0,-34000
20200312,3419,譁裕,14.10,14.10,12.90,12.90,-1.40,-9.79,1555505,622,20446665,148000,273000,-125000,0,0,0,0,0,0,-125000
20200312,3432,台端,11.20,11.20,10.50,10.60,-0.70,-6.19,138151,79,1492595,0,8000,-8000,0,0,0,0,0,0,-8000
20200312,3437,榮創,15.25,15.25,13.75,13.90,-1.35,-8.85,2096103,842,29766333,191000,415000,-224000,0,0,0,0,0,0,-224000
20200312,3443,創意,212.00,212.00,194.00,194.00,-20.00,-9.35,2191572,1638,437516112,593000,284000,309000,0,84000,-84000,39000,28000,11000,236000
20200312,3450,聯鈞,70.70,70.70,64.80,65.10,-6.70,-9.33,9628659,5948,646571143,2125000,1139000,986000,229000,410000,-181000,52000,334000,-282000,523000
20200312,3454,晶睿,80.60,80.70,76.00,77.50,-4.50,-5.49,609384,531,47413650,73000,212973,-139973,0,0,0,0,0,0,-139973
20200312,3481,群創,7.06,7.09,6.50,6.62,-0.59,-8.18,255509207,33517,1710847392,93826610,86094593,7732017,0,13539000,-13539000,2994000,19304000,-16310000,-22116983
20200312,3494,誠研,3.98,4.06,3.82,3.82,-0.25,-6.14,382192,129,1497291,26000,8000,18000,0,0,0,0,0,0,18000
20200312,3501,維熹,45.80,45.80,44.00,44.00,-2.05,-4.45,402079,312,17864884,11000,99000,-88000,0,0,0,0,0,0,-88000
20200312,3504,揚明光,67.00,67.40,61.60,61.60,-6.80,-9.94,1825466,1243,114566150,243000,276000,-33000,0,0,0,1000,17000,-16000,-49000
20200312,3515,華擎,94.60,94.70,88.00,88.70,-5.90,-6.24,3938393,3008,357899154,1403000,395000,1008000,0,96000,-96000,14000,200000,-186000,726000
20200312,3518,柏騰,24.95,25.50,22.95,22.95,-2.55,-10.0,1085477,545,25329687,233000,138000,95000,0,0,0,0,7000,-7000,88000
20200312,3528,安馳,37.50,37.50,36.35,37.45,-0.40,-1.06,79168,69,2933248,7000,9000,-2000,0,0,0,0,5000,-5000,-7000
20200312,3530,晶相光,101.00,102.00,92.00,93.30,-8.70,-8.53,4041000,2963,388413596,819000,461000,358000,0,0,0,8000,99000,-91000,267000
20200312,3532,台勝科,140.00,146.50,130.50,146.00,+5.00,3.55,7176529,5195,1010502676,822352,960000,-137648,1000,0,1000,1485000,38000,1447000,1310352
20200312,3533,嘉澤,276.00,280.00,261.00,261.00,-22.00,-7.77,1231374,1019,330558488,441500,309000,132500,3000,4000,-1000,7000,68000,-61000,70500
20200312,3535,晶彩科,16.10,16.10,14.50,14.50,-1.60,-9.94,1884884,860,27759347,222000,248000,-26000,0,0,0,0,0,0,-26000
20200312,3536,誠創,4.44,4.44,4.01,4.28,-0.17,-3.82,42000,15,169470,0,0,0,0,0,0,0,0,0,0
20200312,3545,敦泰,31.25,31.75,28.95,28.95,-3.20,-9.95,20315210,7719,610445040,1472000,5006280,-3534280,0,0,0,0,35000,-35000,-3569280
20200312,3550,聯穎,12.50,12.50,11.30,11.35,-1.20,-9.56,620176,282,7184315,17000,15000,2000,0,0,0,0,0,0,2000
20200312,3557,嘉威,50.50,51.50,47.95,48.05,-4.05,-7.77,1070648,572,52857613,298000,33000,265000,0,0,0,0,1000,-1000,264000
20200312,3563,牧德,348.50,348.50,317.00,318.50,-33.50,-9.52,1465274,1299,480910002,356000,108000,248000,0,56000,-56000,11000,72000,-61000,131000
20200312,3576,聯合再生,6.26,6.26,5.80,5.82,-0.55,-8.63,13070753,2947,78096307,225000,459000,-234000,0,0,0,0,0,0,-234000
20200312,3583,辛耘,48.15,48.30,44.45,45.00,-4.35,-8.81,1538300,971,70645240,251000,450000,-199000,0,0,0,0,2000,-2000,-201000
20200312,3588,通嘉,27.05,27.05,25.80,25.95,-1.45,-5.29,491106,334,12901323,59000,213000,-154000,0,0,0,0,0,0,-154000
20200312,3591,艾笛森,11.00,11.00,10.05,10.05,-0.95,-8.64,558828,208,5835618,8000,28000,-20000,0,0,0,22000,3000,19000,-1000
20200312,3593,力銘,8.56,8.56,8.30,8.49,-0.10,-1.16,63308,63,527116,1000,0,1000,0,0,0,0,1000,-1000,0
20200312,3596,智易,74.80,75.00,68.60,69.90,-6.10,-8.03,4676673,3106,333495731,523000,903000,-380000,0,47000,-47000,81000,115000,-34000,-461000
20200312,3605,宏致,23.35,23.35,21.80,21.90,-1.85,-7.79,1535203,736,34270853,248000,384000,-136000,0,0,0,0,7000,-7000,-143000
20200312,3607,谷崧,12.55,12.55,11.55,11.60,-1.15,-9.02,322018,172,3869249,7000,69000,-62000,0,0,0,1000,1000,0,-62000
20200312,3617,碩天,95.70,95.70,88.00,89.30,-7.80,-8.03,799125,602,72292311,108000,112000,-4000,0,0,0,0,11000,-11000,-15000
20200312,3622,洋華,18.30,18.30,16.80,16.85,-1.40,-7.67,894107,327,15387357,62000,109000,-47000,0,0,0,0,4000,-4000,-51000
20200312,3645,達邁,38.00,38.00,35.20,35.50,-3.60,-9.21,1488742,1074,53788461,154000,202000,-48000,0,0,0,0,0,0,-48000
20200312,3653,健策,186.00,186.00,171.00,171.00,-18.50,-9.76,8138551,5148,1433163221,2091000,456023,1634977,10000,1765000,-1755000,71000,280000,-209000,-329023
20200312,3661,世芯-KY,216.00,219.50,196.00,196.50,-20.50,-9.45,15527137,11342,3200692185,1735000,2847000,-1112000,0,0,0,102000,306000,-204000,-1316000
20200312,3665,貿聯-KY,187.00,187.00,172.50,175.00,-13.00,-6.91,2873825,2220,511795850,610000,826000,-216000,0,0,0,128000,172000,-44000,-260000
20200312,3669,圓展,27.00,27.25,24.70,24.70,-2.70,-9.85,3423667,1629,88172772,938000,155000,783000,0,0,0,40000,0,40000,823000
20200312,3673,TPK-KY,44.80,44.80,40.85,42.10,-2.90,-6.44,7162862,4320,304842928,1136000,2431000,-1295000,1000,0,1000,119000,468000,-349000,-1643000
20200312,3679,新至陞,55.50,55.50,52.10,52.50,-2.50,-4.55,122495,104,6482682,27000,18000,9000,0,0,0,0,8000,-8000,1000
20200312,3682,亞太電,6.75,6.75,6.20,6.20,-0.61,-8.96,9646815,2757,61241702,428615,556000,-127385,0,0,0,0,0,0,-127385
20200312,3686,達能,4.55,4.55,4.09,4.09,-0.45,-9.91,1079821,325,4502793,18390,0,18390,0,0,0,0,0,0,18390
20200312,3694,海華,15.60,15.60,14.40,14.40,-1.60,-10.0,507000,251,7353900,6000,6000,0,0,0,0,0,1000,-1000,-1000
20200312,3698,隆達,14.50,14.60,13.55,13.60,-1.35,-9.03,2774917,1344,38781470,281000,873000,-592000,0,0,0,2000,93000,-91000,-683000
20200312,3701,大眾控,13.15,13.55,13.15,13.55,+0.10,0.74,12884,17,170972,2000,0,2000,0,0,0,0,0,0,2000
20200312,3702,大聯大,38.00,38.15,37.35,37.40,-0.90,-2.35,8740946,3261,329995415,2698564,5817662,-3119098,4000,0,4000,3708000,144000,3564000,448902
20200312,3702A,大聯大甲特,51.60,51.60,51.00,51.00,-0.60,-1.16,949744,276,48676068,28000,19000,9000,0,0,0,0,360000,-360000,-351000
20200312,3703,欣陸,11.85,11.85,11.20,11.35,-0.60,-5.02,1460084,475,16631801,96000,301000,-205000,0,0,0,0,0,0,-205000
20200312,3704,合勤控,15.00,15.05,13.65,13.65,-1.50,-9.9,4436791,2091,62012332,1120000,599000,521000,0,0,0,2000,89000,-87000,434000
20200312,3705,永信,44.90,44.90,43.05,43.05,-2.00,-4.44,805086,551,35068959,63000,138000,-75000,0,0,0,0,20000,-20000,-95000
20200312,3706,神達,31.00,31.00,29.60,30.05,-1.55,-4.91,24150464,9740,726912920,6506000,3923000,2583000,0,692000,-692000,110000,758000,-648000,1243000
20200312,3708,上緯投控,73.20,73.30,66.90,68.00,-5.50,-7.48,1368945,1021,94272545,129000,327000,-198000,0,0,0,0,5000,-5000,-203000
20200312,3711,日月光投控,66.70,66.70,61.90,62.70,-4.60,-6.84,20674114,9022,1315205782,9347027,12606858,-3259831,35000,0,35000,397000,682000,-285000,-3509831
20200312,3712,永崴投控,14.75,14.75,13.45,13.60,-1.25,-8.42,994859,556,13760489,125000,167000,-42000,0,0,0,2000,7000,-5000,-47000
20200312,4104,佳醫,52.50,52.50,51.70,51.80,-1.20,-2.26,600382,471,31209263,16304,136000,-119696,0,0,0,0,0,0,-119696
20200312,4106,雃博,25.70,26.35,23.50,23.55,-1.95,-7.65,1477814,990,36102260,61000,55000,6000,0,0,0,0,66000,-66000,-60000
20200312,4108,懷特,17.35,17.35,15.65,15.80,-1.55,-8.93,821452,439,13461132,12000,17000,-5000,0,0,0,0,12000,-12000,-17000
20200312,4119,旭富,127.50,128.00,115.00,115.00,-12.50,-9.8,6023234,3937,715750410,1218000,642000,576000,0,183000,-183000,82000,155000,-73000,320000
20200312,4133,亞諾法,36.70,36.85,33.25,34.00,-2.90,-7.86,2885657,1732,98859143,552000,77000,475000,0,0,0,0,0,0,475000
20200312,4137,麗豐-KY,175.50,176.00,163.00,168.00,-9.50,-5.35,1171500,997,197365500,183000,433000,-250000,0,0,0,0,8000,-8000,-258000
20200312,4141,龍燈-KY,15.30,15.30,14.40,14.40,-0.90,-5.88,845300,354,12436991,0,44000,-44000,0,0,0,0,0,0,-44000
20200312,4142,國光生,32.60,32.60,30.00,31.00,-1.60,-4.91,38685051,17212,1211595776,2571000,3448000,-877000,0,0,0,66000,66000,0,-877000
20200312,4144,康聯-KY,27.35,27.35,25.55,26.00,-1.40,-5.11,215185,124,5609982,2000,7000,-5000,0,0,0,0,0,0,-5000
20200312,4148,全宇生技-KY,30.00,30.05,27.40,27.70,-2.70,-8.88,325000,247,9098700,34000,23000,11000,0,0,0,4000,0,4000,15000
20200312,4155,訊映,31.80,31.80,29.10,29.10,-3.20,-9.91,2640080,1431,78379509,370000,203000,167000,0,0,0,7000,1000,6000,173000
20200312,4164,承業醫,37.30,37.30,33.90,35.10,-2.55,-6.77,787069,430,27907884,139000,185000,-46000,0,0,0,12000,8000,4000,-42000
20200312,4190,佐登-KY,86.60,86.60,78.90,80.50,-6.10,-7.04,615422,493,50100370,81000,143000,-62000,0,0,0,6000,3000,3000,-59000
20200312,4306,炎洲,10.65,10.65,10.10,10.20,-0.30,-2.86,1350880,519,13877865,52000,166000,-114000,0,0,0,12000,21000,-9000,-123000
20200312,4414,如興,9.83,9.87,8.90,9.50,-0.31,-3.16,5528026,1577,51089583,675000,859000,-184000,0,0,0,1000,1000,0,-184000
20200312,4426,利勤,35.80,35.80,33.00,33.00,-3.20,-8.84,1500983,1068,50557723,141000,432000,-291000,0,0,0,15000,3000,12000,-279000
20200312,4438,廣越,135.00,135.00,129.00,130.00,-8.00,-5.8,301123,241,39675613,29000,91000,-62000,0,0,0,0,7000,-7000,-69000
20200312,4439,冠星-KY,157.50,157.50,152.00,155.00,-6.00,-3.73,41010,41,6373060,0,2000,-2000,0,0,0,0,0,0,-2000
20200312,4526,東台,15.15,15.15,14.15,14.15,-1.10,-7.21,527276,269,7686500,2000,13000,-11000,0,0,0,7000,1000,6000,-5000
20200312,4532,瑞智,19.80,19.85,19.00,19.05,-1.05,-5.22,1042030,525,20155100,31000,265000,-234000,0,0,0,0,9000,-9000,-243000
20200312,4536,拓凱,119.00,119.00,114.50,114.50,-7.50,-6.15,337307,286,39292765,14000,115000,-101000,0,0,0,4000,5000,-1000,-102000
20200312,4540,全球傳動,49.10,49.10,46.00,47.30,-2.40,-4.83,580501,461,27432698,56000,189000,-133000,0,0,0,0,4000,-4000,-137000
20200312,4545,銘鈺,31.15,31.15,28.05,28.05,-3.10,-9.95,872044,459,24791133,67000,19000,48000,0,0,0,2000,0,2000,50000
20200312,4551,智伸科,135.50,137.50,126.50,129.00,-11.50,-8.19,994099,725,129900771,428000,123000,305000,0,102000,-102000,21000,22000,-1000,202000
20200312,4552,力達-KY,30.50,30.60,28.90,29.10,-2.65,-8.35,641682,431,18873080,24000,187000,-163000,0,0,0,0,1000,-1000,-164000
20200312,4555,氣立,49.20,49.85,46.05,47.90,-2.90,-5.71,162000,142,7758150,3000,6000,-3000,0,0,0,0,0,0,-3000
20200312,4557,永新-KY,68.30,68.30,66.10,66.50,-1.80,-2.64,107207,142,7134362,2000,9000,-7000,0,0,0,0,0,0,-7000
20200312,4560,強信-KY,44.30,45.00,43.15,44.00,-0.95,-2.11,155000,112,6840400,99000,61000,38000,0,0,0,0,0,0,38000
20200312,4562,穎漢,21.50,21.50,19.40,20.00,-1.20,-5.66,17000,15,342000,1000,4000,-3000,0,0,0,0,0,0,-3000
20200312,4564,元翎,33.00,33.00,30.35,30.40,-2.90,-8.71,1948999,1134,60601518,110000,564000,-454000,0,0,0,0,1000,-1000,-455000
20200312,4566,時碩工業,41.80,42.00,40.10,40.30,-2.40,-5.62,460655,294,18837782,24000,78000,-54000,0,0,0,2000,0,2000,-52000
20200312,4571,鈞興-KY,55.30,56.60,52.60,56.00,-1.50,-2.61,33000,13,1822800,0,0,0,0,0,0,0,0,0,0
20200312,4572,駐龍,90.00,90.00,85.20,86.20,-4.80,-5.27,194739,155,16738500,31000,23000,8000,0,0,0,0,0,0,8000
20200312,4576,大銀微系統,75.50,75.50,69.80,69.90,-4.00,-5.41,379100,289,26943348,25000,28000,-3000,0,0,0,0,1000,-1000,-4000
20200312,4581,光隆精密-KY,40.90,40.90,37.00,38.90,-2.40,-5.81,314000,198,12066800,1000,3000,-2000,0,0,0,0,0,0,-2000
20200312,4720,德淵,13.90,13.90,12.60,12.70,-1.30,-9.29,1415050,532,18448737,15000,8000,7000,0,0,0,20000,0,20000,27000
20200312,4722,國精化,26.10,26.15,25.85,25.90,-0.45,-1.71,308450,142,8013609,2000,23000,-21000,0,0,0,0,0,0,-21000
20200312,4725,信昌化,9.80,9.88,9.09,9.10,-1.00,-9.9,2615182,992,24336230,238000,167000,71000,0,0,0,0,0,0,71000
20200312,4737,華廣,78.10,78.90,75.30,77.00,-3.00,-3.75,210185,177,16194545,11000,53000,-42000,0,0,0,0,6000,-6000,-48000
20200312,4739,康普,53.50,53.50,48.80,48.85,-5.35,-9.87,1313829,874,65522179,419544,101000,318544,0,0,0,0,0,0,318544
20200312,4746,台耀,51.00,53.30,48.05,52.40,+3.00,6.07,30533569,17008,1560971687,1287000,1450000,-163000,580000,0,580000,63000,85000,-22000,395000
20200312,4755,三福化,45.70,45.70,44.15,45.00,-1.50,-3.23,79019,54,3524643,1000,1000,0,0,0,0,0,0,0,0
20200312,4763,材料-KY,125.50,125.50,114.50,115.00,-12.00,-9.45,692787,579,82516005,190000,53000,137000,0,0,0,1000,4000,-3000,134000
20200312,4764,雙鍵,67.40,67.40,65.50,65.80,-1.70,-2.52,175300,88,11642230,3000,11000,-8000,0,0,0,0,0,0,-8000
20200312,4766,南寶,145.00,145.00,139.00,139.50,-8.00,-5.42,385573,331,54563858,90000,187000,-97000,0,0,0,0,1000,-1000,-98000
20200312,4807,日成-KY,31.00,31.00,28.25,28.30,-3.05,-9.73,85199,93,2447515,4000,4000,0,0,0,0,0,0,0,0
20200312,4904,遠傳,65.90,65.90,64.00,64.50,-1.80,-2.71,7283857,4122,470422305,2231046,3725601,-1494555,37000,0,37000,29000,56000,-27000,-1484555
20200312,4906,正文,22.85,22.90,21.30,21.70,-1.20,-5.24,7289133,3076,161274083,439000,1313000,-874000,0,0,0,60000,84000,-24000,-898000
20200312,4912,聯德控股-KY,80.50,80.50,72.60,72.60,-8.00,-9.93,424145,232,30917385,37000,6000,31000,0,0,0,0,0,0,31000
20200312,4915,致伸,46.20,46.45,42.55,42.95,-3.75,-8.03,5425075,3301,236821140,978000,2860000,-1882000,0,0,0,11000,41000,-30000,-1912000
20200312,4916,事欣科,29.90,29.90,28.65,28.70,-1.00,-3.37,516105,363,14925857,36000,61000,-25000,0,0,0,0,13000,-13000,-38000
20200312,4919,新唐,40.75,40.75,38.05,38.20,-3.20,-7.73,2597192,1793,101859756,394125,419000,-24875,1000,0,1000,17000,43000,-26000,-49875
20200312,4927,泰鼎-KY,54.00,54.00,49.80,50.00,-4.20,-7.75,9365215,4644,480710650,1978000,869000,1109000,0,519000,-519000,39000,592000,-553000,37000
20200312,4930,燦星網,9.74,9.74,9.35,9.36,-0.52,-5.26,139027,71,1317526,1000,2000,-1000,0,0,0,0,0,0,-1000
20200312,4934,太極,14.50,15.00,13.55,13.75,-1.30,-8.64,7192511,2489,100332485,2078000,258000,1820000,0,0,0,0,0,0,1820000
20200312,4935,茂林-KY,108.50,110.00,97.70,97.70,-10.80,-9.95,13318600,7396,1360676415,3860000,1308000,2552000,6000,1948000,-1942000,62000,455000,-393000,217000
20200312,4938,和碩,59.00,59.00,56.80,56.80,-2.60,-4.38,10095189,5215,581626875,2317544,5712263,-3394719,23000,0,23000,1668000,326000,1342000,-2029719
20200312,4942,嘉彰,34.00,34.10,31.40,31.65,-2.75,-7.99,1056725,560,34397368,154000,218000,-64000,0,0,0,0,0,0,-64000
20200312,4943,康控-KY,129.50,129.50,118.00,118.00,-13.00,-9.92,4239001,3128,512845618,486000,442000,44000,0,0,0,22000,83599,-61599,-17599
20200312,4952,凌通,31.50,31.50,29.60,29.75,-2.60,-8.04,966890,651,29136140,99000,92000,7000,0,0,0,1000,1000,0,7000
20200312,4956,光鋐,11.65,11.65,10.65,10.70,-1.10,-9.32,822114,354,8903322,20000,43000,-23000,0,0,0,0,0,0,-23000
20200312,4958,臻鼎-KY,111.00,111.50,101.50,101.50,-11.00,-9.78,10709886,6514,1111236846,3650786,5814000,-2163214,154000,41000,113000,228000,802000,-574000,-2624214
20200312,4960,誠美材,5.75,5.75,5.42,5.42,-0.60,-9.97,1543506,338,8398626,0,49000,-49000,0,0,0,0,0,0,-49000
20200312,4961,天鈺,29.85,30.25,27.40,27.40,-3.00,-9.87,2002150,1107,56670590,193000,278000,-85000,0,0,0,0,0,0,-85000
20200312,4967,十銓,42.00,43.40,39.60,42.00,-0.95,-2.21,9780901,5412,409377914,2922000,1078000,1844000,401000,0,401000,0,25000,-25000,2220000
20200312,4968,立積,157.00,158.50,143.50,143.50,-15.50,-9.75,6186929,4666,915116705,564000,1447000,-883000,0,0,0,12000,63000,-51000,-934000
20200312,4976,佳凌,20.10,20.25,18.90,18.90,-2.05,-9.79,1236109,730,23759126,100000,276000,-176000,0,0,0,0,0,0,-176000
20200312,4977,眾達-KY,115.00,115.00,105.50,108.00,-5.50,-4.85,5669197,4111,622311276,709000,449000,260000,10000,0,10000,7000,160000,-153000,117000
20200312,4989,榮科,19.00,19.00,18.00,18.00,-1.40,-7.22,294100,165,5377030,28000,39000,-11000,0,0,0,0,0,0,-11000
20200312,4994,傳奇,61.70,61.70,55.60,55.60,-6.10,-9.89,690500,531,39250298,265000,60000,205000,0,0,0,0,2000,-2000,203000
20200312,4999,鑫禾,38.00,38.00,36.05,36.05,-2.35,-6.12,196013,149,7149396,25000,24000,1000,0,0,0,0,4000,-4000,-3000
20200312,5007,三星,49.20,49.20,48.00,48.00,-2.00,-4.0,131265,116,6343753,7000,39000,-32000,0,0,0,0,6000,-6000,-38000
20200312,5203,訊連,115.00,116.00,108.00,109.50,-7.50,-6.41,2261192,1580,252294428,892100,292000,600100,0,0,0,2000,85000,-83000,517100
20200312,5215,科嘉-KY,52.40,52.40,49.25,51.10,-1.70,-3.22,865145,677,43716038,33000,351000,-318000,100000,102000,-2000,0,1000,-1000,-321000
20200312,5225,東科-KY,27.20,27.20,24.50,24.70,-2.50,-9.19,1315114,723,32742165,336000,73000,263000,0,0,0,0,17000,-17000,246000
20200312,5234,達興材料,82.90,82.90,78.00,79.20,-4.50,-5.38,649340,512,51987564,45000,174000,-129000,0,0,0,0,23000,-23000,-152000
20200312,5243,乙盛-KY,30.10,30.20,28.40,28.95,-1.65,-5.39,943530,553,27356435,299000,327000,-28000,0,0,0,0,0,0,-28000
20200312,5258,虹堡,23.90,23.90,21.45,21.50,-2.30,-9.66,676525,418,14730742,93000,143000,-50000,0,0,0,1000,1000,0,-50000
20200312,5264,鎧勝-KY,38.50,38.50,35.00,35.00,-3.85,-9.91,3170177,1741,113104448,586000,690000,-104000,0,0,0,3000,28000,-25000,-129000
20200312,5269,祥碩,807.00,814.00,746.00,776.00,-25.00,-3.12,3278174,3126,2567238112,982000,437000,545000,146000,320000,-174000,81000,80000,1000,372000
20200312,5283,禾聯碩,99.20,99.20,95.30,95.70,-3.50,-3.53,473540,381,45737147,14000,100000,-86000,0,0,0,7000,15000,-8000,-94000
20200312,5284,jpp-KY,43.60,43.60,41.50,42.95,-0.85,-1.94,40008,38,1692369,1000,5000,-4000,0,0,0,0,0,0,-4000
20200312,5285,界霖,51.10,51.10,48.05,48.05,-3.65,-7.06,557000,355,27494650,15000,113000,-98000,0,0,0,0,1000,-1000,-99000
20200312,5288,豐祥-KY,113.00,114.00,109.00,111.50,-3.50,-3.04,260500,186,28762000,45000,71000,-26000,0,0,0,4000,1000,3000,-23000
20200312,5305,敦南,40.65,40.65,40.20,40.25,-0.35,-0.86,1072763,478,43424505,303000,343000,-40000,0,0,0,0,0,0,-40000
20200312,5388,中磊,72.00,72.00,66.60,66.90,-5.40,-7.47,2677787,1658,183730719,469000,1083000,-614000,3000,0,3000,16000,69000,-53000,-664000
20200312,5434,崇越,100.00,100.00,95.20,96.50,-5.00,-4.93,2051415,1543,199330006,165000,755000,-590000,0,0,0,1000,139000,-138000,-728000
20200312,5469,瀚宇博,37.85,37.95,35.00,35.40,-2.90,-7.57,6839306,3598,246565553,1174000,1474000,-300000,0,0,0,31000,189000,-158000,-458000
20200312,5471,松翰,37.80,39.00,34.80,35.70,-2.50,-6.54,14274369,7878,523226989,2116000,816000,1300000,0,0,0,20000,52000,-32000,1268000
20200312,5484,慧友,7.92,8.08,7.85,7.94,-0.14,-1.73,290025,78,2330186,0,0,0,0,0,0,0,0,0,0
20200312,5515,建國,9.60,9.60,9.00,9.17,-0.43,-4.48,487024,171,4490959,6000,34000,-28000,0,0,0,2000,5000,-3000,-31000
20200312,5519,隆大,13.20,13.25,12.65,12.65,-0.75,-5.6,1783841,578,23026719,70000,156000,-86000,0,0,0,0,0,0,-86000
20200312,5521,工信,7.55,7.55,7.00,7.31,-0.28,-3.69,2427657,883,17519091,133000,780000,-647000,0,0,0,0,0,0,-647000
20200312,5522,遠雄,37.30,37.60,36.10,36.30,-1.35,-3.59,1940834,1067,70969539,292000,623000,-331000,0,0,0,36000,17000,19000,-312000
20200312,5525,順天,20.60,20.60,19.75,19.90,-0.80,-3.86,174653,103,3486941,7000,41000,-34000,0,0,0,0,0,0,-34000
20200312,5531,鄉林,8.82,9.00,8.40,8.55,-0.50,-5.52,1174940,471,10093139,72000,248000,-176000,0,0,0,7000,7000,0,-176000
20200312,5533,皇鼎,15.50,15.60,15.35,15.35,-0.25,-1.6,1171000,73,17991000,5000,36000,-31000,0,0,0,1000,1000,0,-31000
20200312,5534,長虹,78.00,78.10,75.10,75.90,-2.30,-2.94,1166649,809,89217124,164000,554000,-390000,20000,0,20000,6000,39000,-33000,-403000
20200312,5538,東明-KY,30.00,30.30,29.50,30.00,-0.30,-0.99,48000,13,1438200,1000,5000,-4000,0,0,0,0,0,0,-4000
20200312,5607,遠雄港,21.40,21.55,20.10,20.10,-1.40,-6.51,2134089,924,43706694,52000,502000,-450000,0,0,0,1000,1000,0,-450000
20200312,5608,四維航,6.43,6.73,6.26,6.40,-0.18,-2.74,571773,206,3675227,5722,21000,-15278,0,0,0,0,0,0,-15278
20200312,5706,鳳凰,33.10,33.10,32.20,32.20,-1.20,-3.59,228110,181,7394271,2000,43000,-41000,0,0,0,1000,1000,0,-41000
20200312,5871,中租-KY,106.50,106.50,100.00,101.50,-4.50,-4.25,10443943,5446,1064050686,4588768,5789509,-1200741,13000,0,13000,19000,121000,-102000,-1289741
20200312,5876,上海商銀,46.75,46.80,44.00,44.30,-2.70,-5.74,11543503,5181,518635785,2400709,7500552,-5099843,14000,0,14000,316000,211000,105000,-4980843
20200312,5880,合庫金,20.10,20.10,19.60,19.60,-0.70,-3.45,56459112,22971,1116590027,7263620,23946353,-16682733,100000,0,100000,123000,496000,-373000,-16955733
20200312,5906,台南-KY,19.15,19.15,17.90,18.10,-1.60,-8.12,198000,132,3643500,13000,8000,5000,0,0,0,0,0,0,5000
20200312,5907,大洋-KY,20.30,20.30,18.60,19.40,-0.95,-4.67,1064000,594,20515000,122000,262000,-140000,0,0,0,0,6000,-6000,-146000
20200312,6005,群益證,9.38,9.38,9.06,9.10,-0.34,-3.6,3743509,1291,34353542,604000,1176000,-572000,6000,0,6000,0,0,0,-566000
20200312,6024,群益期,40.30,40.35,38.50,38.60,-2.25,-5.51,1010112,664,39640898,44000,170000,-126000,0,0,0,0,0,0,-126000
20200312,6108,競國,23.10,23.10,21.40,21.40,-1.30,-5.73,980023,529,21441511,104000,336000,-232000,0,0,0,0,1000,-1000,-233000
20200312,6112,聚碩,36.00,36.00,34.30,34.70,-1.50,-4.14,1723864,1178,59992671,143000,144000,-1000,0,0,0,3000,0,3000,2000
20200312,6115,鎰勝,43.20,43.20,41.85,41.95,-1.25,-2.89,335482,275,14131394,36000,115000,-79000,0,0,0,0,0,0,-79000
20200312,6116,彩晶,6.53,6.55,6.04,6.06,-0.62,-9.28,39126627,7203,242801313,4121000,6163000,-2042000,0,0,0,281000,1302000,-1021000,-3063000
20200312,6117,迎廣,14.40,14.40,14.00,14.15,-0.25,-1.74,18000,9,255050,0,0,0,0,0,0,0,0,0,0
20200312,6120,達運,12.50,12.65,11.55,11.60,-1.10,-8.66,3420766,1475,40751330,590000,1030000,-440000,0,0,0,0,14000,-14000,-454000
20200312,6128,上福,28.00,28.00,26.90,27.00,-1.10,-3.91,256409,154,7002143,6000,22000,-16000,0,0,0,0,0,0,-16000
20200312,6131,鈞泰,3.55,3.55,3.50,3.50,-0.09,-2.51,312006,39,1103118,0,0,0,0,0,0,0,0,0,0
20200312,6133,金橋,7.12,7.17,6.61,7.17,-0.08,-1.1,142006,60,970862,7000,0,7000,0,0,0,0,1000,-1000,6000
20200312,6136,富爾特,18.90,18.90,18.60,18.70,-0.30,-1.58,205737,164,3857469,0,2000,-2000,0,0,0,0,6000,-6000,-8000
20200312,6139,亞翔,26.80,26.80,25.05,25.40,-1.40,-5.22,1075560,628,27628236,206000,252000,-46000,0,0,0,0,18000,-18000,-64000
20200312,6141,柏承,16.50,16.60,15.15,15.45,-1.35,-8.04,3144000,1375,49013700,423000,467000,-44000,0,0,0,2000,10000,-8000,-52000
20200312,6142,友勁,6.00,6.00,5.73,5.80,-0.23,-3.81,662771,114,3875436,31000,1000,30000,0,0,0,60000,0,60000,90000
20200312,6152,百一,5.78,5.78,5.25,5.37,-0.45,-7.73,632365,178,3368576,20000,15000,5000,0,0,0,0,0,0,5000
20200312,6153,嘉聯益,30.50,30.50,28.10,28.20,-2.80,-9.03,10500390,4918,303757236,1276000,2043000,-767000,0,0,0,244000,735000,-491000,-1258000
20200312,6155,鈞寶,22.85,22.90,21.05,21.30,-1.95,-8.39,1072500,629,23283799,264000,331000,-67000,0,0,0,0,0,0,-67000
20200312,6164,華興,6.50,6.50,6.13,6.13,-0.44,-6.7,321294,106,2047765,0,36000,-36000,0,0,0,0,0,0,-36000
20200312,6165,捷泰,20.90,20.90,18.80,19.25,-1.55,-7.45,714018,354,13926943,114000,79000,35000,0,0,0,0,0,0,35000
20200312,6166,凌華,55.30,55.50,53.30,53.80,-1.70,-3.06,1271270,530,68956926,258000,322000,-64000,0,0,0,31000,12000,19000,-45000
20200312,6168,宏齊,11.35,11.45,11.05,11.30,-0.35,-3.0,970637,357,10913280,44000,175000,-131000,0,0,0,0,0,0,-131000
20200312,6172,互億,19.50,19.65,18.10,19.65,+0.15,0.77,193875,117,3693409,5000,13000,-8000,0,0,0,0,0,0,-8000
20200312,6176,瑞儀,92.50,92.90,87.50,87.90,-6.50,-6.89,5279215,3281,474849250,1011000,2272000,-1261000,0,0,0,1220000,158000,1062000,-199000
20200312,6177,達麗,26.95,26.95,26.25,26.25,-0.90,-3.31,1425529,552,37812786,81000,293000,-212000,0,0,0,0,29000,-29000,-241000
20200312,6183,關貿,39.50,39.50,38.55,39.50,-0.05,-0.13,289982,221,11290783,13000,44000,-31000,0,0,0,0,0,0,-31000
20200312,6184,大豐電,39.90,39.90,39.10,39.20,-0.90,-2.24,206800,130,8132860,5000,46000,-41000,0,0,0,0,0,0,-41000
20200312,6189,豐藝,33.30,33.30,32.00,32.20,-1.45,-4.31,1162730,758,37749205,35000,164000,-129000,0,0,0,0,43000,-43000,-172000
20200312,6191,精成科,14.00,14.00,13.00,13.00,-1.15,-8.13,3945163,1396,52737733,292000,946000,-654000,0,0,0,5000,30000,-25000,-679000
20200312,6192,巨路,64.20,64.20,62.00,63.00,-2.50,-3.82,294574,219,18499006,17000,71000,-54000,0,0,0,0,0,0,-54000
20200312,6196,帆宣,66.10,66.10,61.70,61.70,-6.80,-9.93,5575993,3231,348593366,1078000,277000,801000,0,13000,-13000,4000,9000,-5000,783000
20200312,6197,佳必琪,27.20,27.20,25.70,25.95,-1.35,-4.95,717979,438,18755494,73000,221000,-148000,0,0,0,1000,1000,0,-148000
20200312,6201,亞弘電,34.50,34.55,33.95,33.95,-0.60,-1.74,198000,134,6756850,1000,13000,-12000,0,0,0,0,0,0,-12000
20200312,6202,盛群,67.10,67.10,63.60,64.60,-3.00,-4.44,4794308,3215,310305270,398000,1110000,-712000,0,0,0,100000,38000,62000,-650000
20200312,6205,詮欣,22.70,22.70,21.50,21.60,-1.10,-4.85,89000,58,1949700,3000,10000,-7000,0,0,0,0,1000,-1000,-8000
20200312,6206,飛捷,68.50,68.50,67.00,67.30,-1.90,-2.75,504610,382,33999880,27000,160000,-133000,0,0,0,5000,0,5000,-128000
20200312,6209,今國光,22.40,22.50,20.60,20.60,-2.25,-9.85,1907463,944,39763518,189000,277000,-88000,0,0,0,0,3000,-3000,-91000
20200312,6213,聯茂,146.00,146.50,133.00,133.00,-14.50,-9.83,7660999,4820,1041690367,1018000,748000,270000,53000,746000,-693000,250000,1384000,-1134000,-1557000
20200312,6214,精誠,78.60,78.60,75.30,75.50,-3.80,-4.79,2034797,1489,155439612,99000,660000,-561000,0,0,0,1000,2000,-1000,-562000
20200312,6215,和椿,13.50,13.50,12.60,12.70,-0.80,-5.93,325245,150,4150285,2000,5000,-3000,0,0,0,0,1000,-1000,-4000
20200312,6216,居易,27.30,27.30,26.60,26.65,-0.65,-2.38,241077,163,6442460,1000,26000,-25000,0,0,0,0,0,0,-25000
20200312,6224,聚鼎,59.50,59.50,55.80,56.60,-3.20,-5.35,735641,583,41969491,71000,227000,-156000,0,0,0,17000,7000,10000,-146000
20200312,6225,天瀚,2.08,2.08,2.08,2.08,0.00,0.00,2005,7,4165,0,0,0,0,0,0,0,0,0,0
20200312,6226,光鼎,6.67,6.67,6.01,6.08,-0.59,-8.85,1873025,428,11419611,55000,104000,-49000,0,0,0,0,0,0,-49000
20200312,6230,超眾,211.00,211.00,191.50,195.00,-17.50,-8.24,1866041,1438,370915717,472000,219000,253000,7000,0,7000,14000,172000,-158000,102000
20200312,6235,華孚,10.70,10.70,9.72,9.95,-0.85,-7.87,835256,359,8367972,28000,50000,-22000,0,0,0,0,4000,-4000,-26000
20200312,6239,力成,96.20,96.30,89.50,91.20,-6.20,-6.37,7178195,4299,660653662,3595737,3154096,441641,2000,53000,-51000,63000,356000,-293000,97641
20200312,6243,迅杰,8.03,8.03,7.45,7.46,-0.64,-7.9,257021,152,1975649,1000,11000,-10000,0,0,0,0,0,0,-10000
20200312,6251,定穎,15.20,15.20,13.90,14.45,-0.90,-5.86,15657837,4111,227825867,2577000,2064000,513000,0,0,0,298000,1700000,-1402000,-889000
20200312,6257,矽格,35.10,35.10,33.05,33.55,-1.90,-5.36,7797905,4160,264228778,740000,3070000,-2330000,0,0,0,291000,466000,-175000,-2505000
20200312,6269,台郡,111.00,111.00,102.00,103.50,-9.50,-8.41,11017163,6823,1161875952,2818000,3854000,-1036000,40000,43000,-3000,170000,790000,-620000,-1659000
20200312,6271,同欣電,128.50,128.50,118.00,121.00,-10.00,-7.63,7490161,4447,915650642,1867000,1933000,-66000,108000,631000,-523000,471000,285000,186000,-403000
20200312,6277,宏正,84.00,84.00,81.60,81.70,-2.00,-2.39,340200,285,27957540,16000,57000,-41000,0,0,0,0,6000,-6000,-47000
20200312,6278,台表科,88.60,89.50,81.00,81.10,-8.90,-9.89,6623420,4418,554514747,1258000,1816000,-558000,60000,83000,-23000,26000,284000,-258000,-839000
20200312,6281,全國電,66.80,66.80,65.70,66.00,-0.90,-1.35,213398,180,14113444,5000,34834,-29834,0,0,0,0,7000,-7000,-36834
20200312,6282,康舒,21.00,21.00,19.85,19.90,-1.40,-6.57,5026511,2302,101641191,779000,1173000,-394000,0,0,0,26000,182000,-156000,-550000
20200312,6283,淳安,20.10,20.10,18.40,18.40,-2.00,-9.8,1050065,532,19650650,217000,64000,153000,0,0,0,0,1000,-1000,152000
20200312,6285,啟碁,66.20,66.20,60.60,60.80,-6.50,-9.66,6597150,4250,409787667,745000,1349000,-604000,2000,0,2000,63000,105000,-42000,-644000
20200312,6288,聯嘉,22.00,22.00,20.15,20.15,-2.20,-9.84,3035000,1399,62348700,671000,311000,360000,0,0,0,9000,2000,7000,367000
20200312,6289,華上,1.87,1.87,1.87,1.87,-0.20,-9.66,305171,115,570595,0,0,0,0,0,0,0,0,0,0
20200312,6405,悅城,13.55,13.55,12.80,12.85,-1.10,-7.89,69000,52,902200,1000,5000,-4000,0,0,0,1000,0,1000,-3000
20200312,6409,旭隼,670.00,705.00,656.00,670.00,+6.00,0.9,445291,449,303144515,351000,247500,103500,0,0,0,0,9000,-9000,94500
20200312,6412,群電,54.00,54.00,52.60,53.30,-1.30,-2.38,1555821,711,82625094,253000,666821,-413821,1000,0,1000,0,32000,-32000,-444821
20200312,6414,樺漢,214.00,215.50,196.50,197.00,-21.00,-9.63,1891007,1586,382151907,93000,177000,-84000,0,108000,-108000,114000,275000,-161000,-353000
20200312,6415,矽力-KY,1060.00,1060.00,995.00,1045.00,-35.00,-3.24,1204394,1144,1235696820,759000,676932,82068,7000,18000,-11000,1000,32000,-31000,40068
20200312,6416,瑞祺電通,124.00,124.00,112.50,113.00,-11.50,-9.24,5003140,3584,584249820,720000,426000,294000,300000,318000,-18000,155000,140000,15000,291000
20200312,6431,光麗-KY,24.10,24.10,22.10,22.30,-2.20,-8.98,141005,57,3241210,7000,2000,5000,0,0,0,0,0,0,5000
20200312,6442,光聖,36.90,37.20,36.30,36.60,-0.55,-1.48,158625,89,5845716,6000,21000,-15000,0,0,0,0,0,0,-15000
20200312,6443,元晶,6.15,6.20,5.77,5.80,-0.54,-8.52,2986075,752,17639782,174000,68000,106000,0,0,0,0,200000,-200000,-94000
20200312,6449,鈺邦,29.40,29.40,27.90,28.00,-1.70,-5.72,610016,321,17289616,68000,151000,-83000,0,0,0,2000,4000,-2000,-85000
20200312,6451,訊芯-KY,108.50,109.00,99.90,99.90,-11.10,-10.0,3168660,2225,326203600,986000,283000,703000,0,0,0,25000,33000,-8000,695000
20200312,6452,康友-KY,202.00,203.00,185.00,188.50,-15.50,-7.6,3396076,2446,653287364,549000,328282,220718,0,0,0,33000,162000,-129000,91718
20200312,6456,GIS-KY,86.60,87.00,79.80,79.90,-8.70,-9.82,6152344,3913,503661064,1076000,1359000,-283000,0,66000,-66000,8000,77000,-69000,-418000
20200312,6464,台數科,112.00,113.50,110.00,113.50,0.00,0.00,32020,27,3564240,1000,1000,0,0,0,0,0,0,0,0
20200312,6477,安集,20.10,20.10,18.60,19.00,-1.35,-6.63,746000,298,14399400,74000,164000,-90000,0,0,0,0,1000,-1000,-91000
20200312,6491,晶碩,129.00,129.00,118.50,119.50,-11.50,-8.78,459655,354,55767410,8000,37000,-29000,0,0,0,0,0,0,-29000
20200312,6504,南六,149.50,153.50,140.00,142.50,-6.00,-4.04,2377424,1809,344235056,416000,97000,319000,0,0,0,27000,65000,-38000,281000
20200312,6505,台塑化,81.10,81.10,77.10,77.10,-3.60,-4.46,7034575,4495,549232663,1544574,3745034,-2200460,206000,388000,-182000,36000,332000,-296000,-2678460
20200312,6525,捷敏-KY,55.00,55.00,51.00,51.60,-3.80,-6.86,603800,449,31598778,66000,168000,-102000,0,0,0,0,1000,-1000,-103000
20200312,6531,愛普,113.00,115.00,106.50,107.00,-11.00,-9.32,6904230,4756,760770494,1462000,370000,1092000,0,0,0,19000,103000,-84000,1008000
20200312,6533,晶心科,98.60,99.70,92.30,92.30,-10.20,-9.95,1502315,1134,141569651,156000,359000,-203000,0,0,0,0,109000,-109000,-312000
20200312,6541,泰福-KY,41.20,41.45,38.05,38.60,-3.15,-7.54,808524,548,31734488,24000,120000,-96000,0,0,0,2000,2000,0,-96000
20200312,6552,易華電,65.00,65.20,59.50,59.50,-6.60,-9.98,1689350,1222,103315460,108000,331000,-223000,0,0,0,7000,27000,-20000,-243000
20200312,6558,興能高,49.20,49.20,45.10,45.10,-5.00,-9.98,1695856,1042,77332191,343000,112000,231000,0,0,0,0,0,0,231000
20200312,6573,虹揚-KY,19.65,20.50,18.30,19.90,-0.30,-1.49,180000,152,3464100,6000,5000,1000,0,0,0,0,0,0,1000
20200312,6579,研揚,68.10,68.10,66.50,66.50,-2.50,-3.62,54300,54,3632470,2000,15000,-13000,0,0,0,0,0,0,-13000
20200312,6581,鋼聯,67.60,67.60,65.10,65.40,-3.10,-4.53,87200,74,5782800,1000,2000,-1000,0,0,0,0,0,0,-1000
20200312,6582,申豐,77.00,81.00,75.60,79.10,+3.30,4.35,1787388,1550,140326640,103000,175000,-72000,0,0,0,8000,23000,-15000,-87000
20200312,6591,動力-KY,41.55,41.55,38.60,39.25,-3.10,-7.32,839878,517,33285681,334000,129000,205000,0,0,0,1000,5000,-4000,201000
20200312,6592,和潤企業,71.00,71.00,68.10,68.10,-3.90,-5.42,3495990,2529,241246707,87000,146000,-59000,0,0,0,0,0,0,-59000
20200312,6605,帝寶,49.10,49.65,49.00,49.30,-1.70,-3.33,354620,245,17474801,30000,83000,-53000,0,0,0,1000,0,1000,-52000
20200312,6625,必應,38.60,38.60,37.10,37.10,-1.50,-3.89,35553,34,1351716,0,5000,-5000,0,0,0,0,0,0,-5000
20200312,6641,基士德-KY,60.30,60.90,59.00,59.20,-2.70,-4.36,101200,74,6051800,4000,5000,-1000,0,0,0,0,0,0,-1000
20200312,6655,科定,34.15,34.15,32.75,34.00,-0.15,-0.44,81000,58,2727350,0,1000,-1000,0,0,0,0,0,0,-1000
20200312,6666,羅麗芬-KY,124.00,124.50,117.00,117.00,-9.50,-7.51,158900,145,19032500,11000,20000,-9000,0,0,0,0,3000,-3000,-12000
20200312,6668,中揚光,73.70,74.60,68.20,69.00,-5.10,-6.88,1135663,850,80683847,100000,326000,-226000,0,0,0,23000,20000,3000,-223000
20200312,6669,緯穎,710.00,710.00,640.00,647.00,-62.00,-8.74,2748771,2590,1838294150,717910,963000,-245090,0,70000,-70000,45000,122000,-77000,-392090
20200312,6670,復盛應用,170.50,173.00,159.50,164.00,-10.50,-6.02,1092413,903,179481586,329411,364000,-34589,0,0,0,0,19000,-19000,-53589
20200312,6671,三能-KY,34.00,34.00,32.40,33.00,-1.60,-4.62,28000,20,919600,2000,1000,1000,0,0,0,0,0,0,1000
20200312,6672,騰輝電子-KY,80.90,81.30,75.50,76.30,-5.40,-6.61,1181400,944,91950899,49000,343000,-294000,0,0,0,0,0,0,-294000
20200312,6674,鋐寶科技,24.20,24.20,21.80,22.75,-1.35,-5.6,109020,77,2462457,2000,4000,-2000,0,0,0,0,0,0,-2000
20200312,6698,旭暉應材,61.00,61.00,56.70,57.90,-5.10,-8.1,371350,278,21882839,20000,24000,-4000,0,0,0,0,1000,-1000,-5000
20200312,6706,惠特,85.60,85.60,80.10,81.70,-5.30,-6.09,1254689,984,103109700,292000,87000,205000,0,0,0,4000,14000,-10000,195000
20200312,6715,嘉基,88.00,88.00,81.20,81.40,-8.80,-9.76,889157,594,73600674,104000,12000,92000,0,204000,-204000,0,0,0,-112000
20200312,8011,台通,14.05,14.15,13.40,13.90,-0.30,-2.11,628449,351,8611136,33000,58000,-25000,0,0,0,0,0,0,-25000
20200312,8016,矽創,152.00,152.50,137.00,139.00,-12.00,-7.95,4529020,3402,646600820,688000,1051000,-363000,0,191000,-191000,10000,136000,-126000,-680000
20200312,8021,尖點,19.05,19.15,18.05,18.45,-0.85,-4.4,1654393,1000,30741055,203000,560000,-357000,0,0,0,0,9000,-9000,-366000
20200312,8028,昇陽半導體,57.10,57.20,52.70,52.70,-5.80,-9.91,3182505,2272,173787949,469000,375000,94000,0,0,0,5000,60000,-55000,39000
20200312,8033,雷虎,8.98,8.98,8.31,8.50,-0.42,-4.71,511140,176,4423018,0,13000,-13000,0,0,0,0,0,0,-13000
20200312,8039,台虹,49.00,49.00,45.70,46.90,-2.90,-5.82,5239965,3012,246457094,1514000,975000,539000,0,0,0,42000,459000,-417000,122000
20200312,8046,南電,53.40,53.80,48.90,49.00,-5.20,-9.59,11167942,5801,565470433,2282000,2615000,-333000,180000,40000,140000,181000,815000,-634000,-827000
20200312,8070,長華,158.50,158.50,151.00,151.50,-7.00,-4.42,338870,274,51786110,14000,111000,-97000,0,0,0,1000,18000,-17000,-114000
20200312,8072,陞泰,20.10,20.15,20.00,20.00,-0.15,-0.74,257209,65,5147732,0,5000,-5000,0,0,0,0,0,0,-5000
20200312,8081,致新,113.00,113.00,106.00,107.00,-7.00,-6.14,2008827,1533,217879890,194000,491000,-297000,0,31000,-31000,2000,114000,-112000,-440000
20200312,8101,華冠,5.05,5.05,4.66,4.67,-0.48,-9.32,1051500,363,5056830,107000,22000,85000,0,0,0,0,0,0,85000
20200312,8103,瀚荃,22.35,22.35,21.70,21.95,-0.70,-3.09,327522,162,7191067,1000,25000,-24000,0,0,0,0,11000,-11000,-35000
20200312,8104,錸寶,37.90,37.90,34.60,34.85,-3.45,-9.01,451450,325,16022974,63000,37000,26000,0,0,0,20000,2000,18000,44000
20200312,8105,凌巨,10.75,10.75,9.84,9.84,-1.06,-9.72,3662354,1136,36985031,739000,749000,-10000,0,0,0,0,4000,-4000,-14000
20200312,8110,華東,9.68,9.68,8.78,8.87,-0.88,-9.03,3259330,1036,29604583,397000,582000,-185000,0,0,0,99000,31000,68000,-117000
20200312,8112,至上,31.95,32.00,30.80,31.60,-0.50,-1.56,6703354,3476,210498929,1827000,1231000,596000,0,0,0,11000,76000,-65000,531000
20200312,8114,振樺電,90.00,90.00,84.50,84.80,-5.60,-6.19,302803,295,26042755,19000,45000,-26000,0,0,0,0,5000,-5000,-31000
20200312,8131,福懋科,37.65,37.65,36.15,36.30,-1.80,-4.72,1880916,971,69014734,264000,345000,-81000,1000,0,1000,2000,67000,-65000,-145000
20200312,8150,南茂,29.70,29.75,28.10,28.10,-1.70,-5.7,12939995,6038,370596595,3089000,2842000,247000,0,0,0,37000,607033,-570033,-323033
20200312,8163,達方,34.25,34.30,31.55,31.60,-3.40,-9.71,4112829,2305,134033177,707000,856000,-149000,0,373000,-373000,16000,106000,-90000,-612000
20200312,8201,無敵,9.23,9.23,8.31,8.40,-0.83,-8.99,148403,96,1259448,13000,3000,10000,0,0,0,0,0,0,10000
20200312,8210,勤誠,84.30,84.30,78.50,80.60,-4.90,-5.73,2169774,1543,175880595,548000,437000,111000,0,0,0,17000,73000,-56000,55000
20200312,8213,志超,31.70,31.75,29.85,30.30,-1.95,-6.05,2709118,1573,83028269,231000,1079000,-848000,0,0,0,7000,3000,4000,-844000
20200312,8215,明基材,16.60,16.60,15.20,15.20,-1.65,-9.79,6332425,2703,98188329,1100000,660000,440000,0,0,0,0,38000,-38000,402000
20200312,8222,寶一,16.70,16.70,16.00,16.35,-0.55,-3.25,446108,192,7266362,2000,10000,-8000,0,0,0,0,1000,-1000,-9000
20200312,8249,菱光,19.80,19.80,18.10,18.10,-1.80,-9.05,632004,340,11813215,7000,160000,-153000,0,0,0,1000,5000,-4000,-157000
20200312,8261,富鼎,24.10,24.10,22.05,22.10,-2.40,-9.8,1171144,632,26482634,126000,276000,-150000,0,0,0,0,0,0,-150000
20200312,8271,宇瞻,45.00,45.20,41.25,41.50,-4.10,-8.99,5181353,3458,221646761,1147000,1318000,-171000,0,0,0,5000,88000,-83000,-254000
20200312,8341,日友,238.50,238.50,228.00,230.50,-10.00,-4.16,449064,588,103987356,83000,149000,-66000,1000,0,1000,2000,8000,-6000,-71000
20200312,8367,建新國際,24.30,24.30,23.30,23.30,-1.45,-5.86,195500,126,4633698,3000,20000,-17000,0,0,0,0,1000,-1000,-18000
20200312,8374,羅昇,18.00,18.25,17.40,17.60,-0.55,-3.03,182000,125,3222700,2000,3000,-1000,0,0,0,0,0,0,-1000
20200312,8404,百和興業-KY,38.20,38.20,35.15,36.00,-2.35,-6.13,881539,430,31706604,191000,135000,56000,0,0,0,0,2000,-2000,54000
20200312,8411,福貞-KY,11.65,11.65,11.20,11.50,-0.45,-3.77,114403,63,1302232,3000,7000,-4000,0,0,0,1000,1000,0,-4000
20200312,8422,可寧衛,150.00,150.00,145.00,145.50,-5.00,-3.32,657149,657,96267903,40000,312000,-272000,0,0,0,0,0,0,-272000
20200312,8427,基勝-KY,43.00,44.00,41.50,43.00,-0.50,-1.15,5002,7,214586,0,0,0,0,0,0,0,0,0,0
20200312,8429,金麗-KY,9.12,9.12,8.25,8.26,-0.90,-9.83,1158486,471,9762651,42000,73000,-31000,0,0,0,0,4000,-4000,-35000
20200312,8442,威宏-KY,50.50,50.90,49.50,49.95,-0.65,-1.28,72000,43,3592900,4000,3000,1000,0,0,0,0,10000,-10000,-9000
20200312,8443,阿瘦,10.20,10.20,9.80,9.80,-0.30,-2.97,86998,71,863862,2000,12000,-10000,0,0,0,0,0,0,-10000
20200312,8454,富邦媒,361.00,361.00,344.00,345.00,-14.00,-3.9,295257,230,102345019,212000,131900,80100,0,0,0,6000,7000,-1000,79100
20200312,8462,柏文,164.00,164.00,158.00,159.00,-6.50,-3.93,404849,637,64834840,51000,95000,-44000,0,5000,-5000,0,0,0,-49000
20200312,8463,潤泰材,41.35,41.35,37.00,37.30,-3.30,-8.13,876300,555,33559014,143000,155000,-12000,0,0,0,0,81000,-81000,-93000
20200312,8464,億豐,234.00,235.00,217.00,219.50,-19.50,-8.16,2427223,1477,545887613,868221,1083926,-215705,27000,77000,-50000,4000,15000,-11000,-276705
20200312,8466,美吉吉-KY,66.80,66.80,65.50,65.50,-2.30,-3.39,35161,33,2335632,3000,0,3000,0,0,0,0,0,0,3000
20200312,8467,波力-KY,49.80,49.80,47.10,47.10,-2.60,-5.23,54000,43,2598350,2000,2000,0,0,0,0,0,0,0,0
20200312,8473,山林水,43.50,44.00,41.60,41.60,-1.65,-3.82,236400,174,10049400,10000,14000,-4000,0,0,0,1000,0,1000,-3000
20200312,8478,東哥遊艇,39.30,39.30,35.55,35.85,-3.65,-9.24,112200,72,4130600,3000,5000,-2000,0,0,0,1000,0,1000,-1000
20200312,8480,泰昇-KY,135.50,135.50,131.50,131.50,-7.00,-5.05,50439,52,6734288,0,14000,-14000,0,0,0,0,0,0,-14000
20200312,8481,政伸,57.50,57.50,55.00,56.00,-1.90,-3.28,32000,29,1787300,0,6000,-6000,0,0,0,0,0,0,-6000
20200312,8482,商億-KY,139.00,139.00,135.00,135.00,-4.00,-2.88,223009,120,30541219,218000,68000,150000,0,0,0,0,0,0,150000
20200312,8488,吉源-KY,14.70,14.70,14.00,14.00,-1.40,-9.09,22000,18,310650,3000,7000,-4000,0,0,0,0,0,0,-4000
20200312,8497,格威傳媒,68.20,68.30,68.10,68.10,-0.10,-0.15,203000,128,13831700,49000,2000,47000,0,0,0,0,31000,-31000,16000
20200312,8499,鼎炫-KY,84.50,84.50,79.00,79.00,-8.10,-9.3,317015,269,25652800,37000,57000,-20000,0,0,0,0,1000,-1000,-21000
20200312,8926,台汽電,32.75,32.75,31.80,32.00,-1.15,-3.47,3449388,1746,110749066,626000,344000,282000,2000,0,2000,1000,102000,-101000,183000
20200312,8940,新天地,9.70,10.10,9.27,9.80,-0.50,-4.85,180100,56,1710555,2000,8000,-6000,0,0,0,0,0,0,-6000
20200312,8996,高力,59.80,59.90,54.70,55.50,-5.20,-8.57,6729365,3728,381753240,3016000,281000,2735000,0,70000,-70000,143000,225000,-82000,2583000
20200312,9103,美德醫療-DR,4.11,4.11,3.85,3.95,+0.17,4.5,3057046,431,12129074,0,10000,-10000,0,0,0,1000,1000,0,-10000
20200312,910322,康師傅-DR,29.60,29.85,29.40,29.40,-0.50,-1.67,27000,10,801050,10000,0,10000,0,0,0,0,0,0,10000
20200312,910482,聖馬丁-DR,0.30,0.30,0.29,0.30,-0.02,-6.25,383000,13,111270,0,0,0,0,0,0,0,0,0,0
20200312,9105,泰金寶-DR,2.97,2.99,2.74,2.76,-0.24,-8.0,12476970,1789,35182004,2438000,1405000,1033000,0,0,0,0,0,0,1033000
20200312,910861,神州-DR,6.75,6.75,6.75,6.75,0.00,0.00,86000,11,580500,67000,0,67000,0,0,0,0,0,0,67000
20200312,9110,越南控-DR,1.55,1.61,1.50,1.60,-0.04,-2.44,596000,58,945590,0,0,0,0,0,0,0,0,0,0
20200312,911608,明輝-DR,1.22,1.22,1.10,1.16,-0.06,-4.92,215000,38,241990,0,0,0,0,0,0,0,0,0,0
20200312,911616,杜康-DR,0.86,0.86,0.79,0.80,-0.06,-6.98,916950,96,746829,3000,1000,2000,0,0,0,0,0,0,2000
20200312,911622,泰聚亨-DR,11.10,11.10,11.10,11.10,0.00,0.00,1000,1,11100,0,0,0,0,0,0,0,0,0,0
20200312,911868,同方友友-DR,0.93,0.97,0.90,0.97,-0.02,-2.02,252000,23,230770,0,0,0,0,0,0,0,0,0,0
20200312,912000,晨訊科-DR,1.68,1.70,1.66,1.70,-0.09,-5.03,8000,6,13460,0,0,0,0,0,0,0,0,0,0
20200312,912398,友佳-DR,3.13,3.13,3.00,3.00,-0.28,-8.54,74000,17,226960,0,0,0,0,0,0,0,0,0,0
20200312,9136,巨騰-DR,6.26,6.26,6.00,6.00,-0.35,-5.51,528000,63,3201410,22000,2000,20000,0,0,0,0,0,0,20000
20200312,9188,精熙-DR,2.88,2.90,2.79,2.90,+0.02,0.69,159000,46,449670,0,0,0,0,0,0,0,0,0,0
20200312,9802,鈺齊-KY,103.00,104.50,97.50,97.60,-8.40,-7.92,3133500,2009,311422200,507000,1003000,-496000,0,166000,-166000,61000,117000,-56000,-718000
20200312,9902,台火,9.00,9.00,8.42,8.51,-0.52,-5.76,363591,162,3151192,13000,43000,-30000,0,0,0,2000,4000,-2000,-32000
20200312,9904,寶成,31.40,31.60,29.90,30.05,-1.90,-5.95,12302584,6072,373939028,3913675,6865610,-2951935,25000,0,25000,98000,385000,-287000,-3213935
20200312,9905,大華,22.70,22.70,21.95,22.10,-0.60,-2.64,482305,256,10662774,13000,92000,-79000,0,0,0,0,11000,-11000,-90000
20200312,9906,欣巴巴,19.00,19.00,17.25,17.25,-1.90,-9.92,251201,96,4397967,1000,22000,-21000,0,0,0,1000,0,1000,-20000
20200312,9907,統一實,10.10,10.15,9.80,9.85,-0.30,-2.96,3579045,988,35402961,176000,572000,-396000,0,0,0,0,34000,-34000,-430000
20200312,9908,大台北,31.40,31.40,30.00,30.35,-1.10,-3.5,620841,302,19081900,10000,66000,-56000,0,0,0,5000,0,5000,-51000
20200312,9910,豐泰,162.00,162.50,150.50,150.50,-14.00,-8.51,3904641,2579,601633073,1236245,2513090,-1276845,2000,276000,-274000,6000,82000,-76000,-1626845
20200312,9911,櫻花,45.75,45.75,43.35,44.05,-1.80,-3.93,841753,649,37242853,208000,389000,-181000,0,0,0,60000,40000,20000,-161000
20200312,9912,偉聯,7.77,7.77,7.36,7.36,-0.58,-7.3,95006,60,709168,17000,16000,1000,0,0,0,0,2000,-2000,-1000
20200312,9914,美利達,157.00,157.00,144.50,147.00,-10.00,-6.37,753207,518,113227409,311000,462100,-151100,0,0,0,6000,23000,-17000,-168100
20200312,9917,中保科,88.60,88.60,87.00,87.00,-1.50,-1.69,403085,361,35222798,25000,255000,-230000,1000,0,1000,0,2000,-2000,-231000
20200312,9918,欣天然,32.60,32.60,32.00,32.00,-1.20,-3.61,24163,36,778716,1000,13000,-12000,0,0,0,3000,0,3000,-9000
20200312,9919,康那香,18.80,19.80,17.95,19.00,+0.05,0.26,17578427,8067,332782407,1256000,1031000,225000,0,0,0,0,4000,-4000,221000
20200312,9921,巨大,168.00,171.00,156.50,157.50,-11.50,-6.8,1891495,1524,304172434,1014816,1230000,-215184,2000,0,2000,2000,39000,-37000,-250184
20200312,9924,福興,40.80,40.80,39.70,40.00,-0.80,-1.96,490487,360,19586226,36000,260000,-224000,0,0,0,0,10000,-10000,-234000
20200312,9925,新保,36.70,36.70,35.80,36.00,-0.75,-2.04,459221,375,16547499,8000,153170,-145170,0,0,0,1000,7000,-6000,-151170
20200312,9926,新海,41.60,41.60,40.50,40.80,-0.80,-1.92,28076,28,1145280,0,18000,-18000,0,0,0,3000,0,3000,-15000
20200312,9927,泰銘,30.45,30.45,29.75,29.85,-0.60,-1.97,640276,261,19165234,10000,80000,-70000,0,0,0,0,13000,-13000,-83000
20200312,9928,中視,4.20,4.35,4.10,4.35,+0.15,3.57,33005,10,136075,0,0,0,0,0,0,0,0,0,0
20200312,9929,秋雨,12.80,12.80,11.60,11.70,-0.70,-5.65,39095,32,471389,0,11000,-11000,0,0,0,0,0,0,-11000
20200312,9930,中聯資源,46.20,46.20,44.60,44.80,-1.40,-3.03,287291,251,12947845,11000,56000,-45000,0,0,0,0,5000,-5000,-50000
20200312,9931,欣高,34.15,34.15,33.15,34.10,-0.05,-0.15,64066,40,2186408,1000,8000,-7000,0,0,0,3000,0,3000,-4000
20200312,9933,中鼎,33.60,33.60,32.50,32.75,-0.85,-2.53,1681461,1185,55186624,166000,493000,-327000,0,0,0,16000,16000,0,-327000
20200312,9934,成霖,14.30,14.45,13.70,13.80,-0.90,-6.12,2168115,1067,30175721,85000,593000,-508000,0,0,0,23000,23000,0,-508000
20200312,9935,慶豐富,32.50,32.50,29.35,29.35,-3.25,-9.97,3254728,1540,96968640,875000,431000,444000,0,0,0,1000,51000,-50000,394000
20200312,9937,全國,41.20,41.65,40.60,41.10,-0.60,-1.44,35911,42,1471041,3000,11000,-8000,0,0,0,0,0,0,-8000
20200312,9938,百和,70.40,70.40,64.10,64.10,-7.10,-9.97,3505193,2209,229362631,369000,910000,-541000,0,130000,-130000,24000,85000,-61000,-732000
20200312,9939,宏全,57.20,57.20,53.70,53.90,-4.00,-6.91,2263146,1295,124360330,229000,582000,-353000,0,0,0,70000,132000,-62000,-415000
20200312,9940,信義,28.10,28.10,26.90,27.10,-1.10,-3.9,774678,487,21032201,78000,245000,-167000,0,0,0,0,7000,-7000,-174000
20200312,9941,裕融,99.00,99.20,95.70,96.00,-4.00,-4.0,1285752,1181,124377555,174000,296000,-122000,1000,0,1000,0,8000,-8000,-129000
20200312,9941A,裕融甲特,54.00,54.10,53.90,54.10,-0.10,-0.18,111000,59,5992700,0,0,0,0,0,0,21000,25000,-4000,-4000
20200312,9942,茂順,66.00,66.00,64.00,64.00,-2.20,-3.32,254549,211,16376608,9000,48000,-39000,0,0,0,0,4000,-4000,-43000
20200312,9943,好樂迪,63.00,63.00,60.90,61.50,-2.30,-3.61,622549,483,38162138,22000,75000,-53000,0,0,0,0,0,0,-53000
20200312,9944,新麗,18.45,18.90,17.00,17.10,-1.50,-8.06,1797000,975,31988850,371000,91000,280000,0,0,0,0,0,0,280000
20200312,9945,潤泰新,40.40,40.40,39.30,39.40,-1.30,-3.19,3923108,2301,155664051,974812,1373000,-398188,0,0,0,34000,86000,-52000,-450188
20200312,9946,三發地產,16.60,16.60,15.50,15.95,-1.25,-7.27,7752020,2679,121233412,1786000,626000,1160000,0,0,0,0,18000,-18000,1142000
20200312,9955,佳龍,18.20,18.20,16.40,16.45,-1.75,-9.62,1490300,701,25158500,198000,122000,76000,0,0,0,1000,1000,0,76000
20200312,9958,世紀鋼,83.50,83.50,78.30,81.00,-2.00,-2.41,13464218,8197,1089916658,2620000,1233000,1387000,855000,0,855000,254000,840000,-586000,1656000
20200312,00679B,元大美債20年,50.10,50.90,50.10,50.40,-1.30,-2.51,2518000,865,127126700,0,5000,-5000,0,0,0,1607000,917000,690000,685000
20200312,00687B,國泰20年美債,52.50,53.10,52.20,52.70,-1.40,-2.59,379000,154,19990200,0,0,0,0,0,0,292000,105000,187000,187000
20200312,00694B,富邦美債1-3,40.71,40.84,40.71,40.83,+0.20,0.49,600000,48,24489040,0,0,0,0,0,0,586000,504000,82000,82000
20200312,00695B,富邦美債7-10,41.79,42.14,41.72,41.78,-0.22,-0.52,516000,60,21643980,0,0,0,0,0,0,503000,397000,106000,106000
20200312,00696B,富邦美債20年,52.25,53.05,52.25,52.75,-1.45,-2.68,642000,101,33844000,0,0,0,0,0,0,518000,436000,82000,82000
20200312,00697B,元大美債7-10,44.83,44.83,44.45,44.50,-0.33,-0.74,168000,33,7499130,0,0,0,0,0,0,158000,100000,58000,58000
20200312,00718B,富邦中國政策債,19.90,19.90,19.81,19.84,-0.06,-0.3,445000,92,8822090,0,0,0,0,0,0,386000,501000,-115000,-115000
20200312,00719B,元大美債1-3,32.40,32.40,32.32,32.36,+0.13,0.4,184000,19,5952080,0,24000,-24000,0,0,0,146000,138000,8000,-16000
20200312,00720B,元大投資級公司債,44.58,44.64,44.14,44.31,-1.21,-2.66,670000,218,29745690,0,20000,-20000,0,0,0,488000,189000,299000,279000
20200312,00721B,元大中國債3-5,45.59,45.59,45.39,45.48,-0.17,-0.37,122000,9,5548190,0,0,0,0,0,0,120000,1101000,-981000,-981000
20200312,00722B,群益15年IG電信債,50.15,50.15,47.50,48.05,-2.15,-4.28,222000,73,10703120,0,16000,-16000,0,0,0,198000,102000,96000,80000
20200312,00723B,群益15年IG科技債,47.88,47.88,45.96,45.96,-1.92,-4.01,167000,46,7739260,0,18000,-18000,0,0,0,164000,107000,57000,39000
20200312,00724B,群益10年IG金融債,44.81,44.81,41.90,42.50,-2.31,-5.16,337000,123,14407690,0,56000,-56000,0,0,0,251000,102000,149000,93000
20200312,00725B,國泰投資級公司債,44.13,44.13,42.59,42.59,-2.43,-5.4,264000,79,11333590,0,22570000,-22570000,0,0,0,127000,101000,26000,-22544000
20200312,00726B,國泰5Y+新興債,44.83,44.83,44.20,44.20,-0.90,-2.0,138000,17,6113720,0,8000000,-8000000,0,0,0,134000,100000,34000,-7966000
20200312,00727B,國泰1-5Y高收債,39.80,40.00,39.50,39.53,-0.47,-1.18,149000,27,5909020,0,0,0,0,0,0,136000,100000,36000,36000
20200312,00734B,台新JPM新興債,21.73,21.73,21.40,21.43,-0.51,-2.32,1051000,43,22767350,0,0,0,0,0,0,1011000,980000,31000,31000
20200312,00740B,富邦全球投等債,47.60,47.60,44.72,45.00,-3.49,-7.2,292000,113,13508300,36000,59000,-23000,0,0,0,194000,116000,78000,55000
20200312,00741B,富邦全球高收債,38.38,38.53,38.38,38.38,-0.32,-0.83,273000,17,10494170,0,0,0,0,0,0,268000,264003,3997,3997
20200312,00744B,國泰中國政金債5+,42.58,42.58,42.58,42.58,0.00,0.0,100000,2,4258000,0,0,0,0,0,0,100000,100000,0,0
20200312,00745B,富邦中政債0-1,39.72,39.72,39.72,39.72,+0.15,0.38,50000,2,1986000,0,0,0,0,0,0,50000,50000,0,0
20200312,00746B,富邦A級公司債,47.31,47.31,46.61,46.65,-1.85,-3.81,168000,19,7872230,0,82000,-82000,0,0,0,155000,83000,72000,-10000
20200312,00747B,FH中國政策債,52.30,52.30,52.15,52.15,-0.30,-0.57,102000,3,5334300,0,0,0,0,0,0,102000,100000,2000,2000
20200312,00748B,凱基中國債3-10,41.96,41.96,41.96,41.96,+0.01,0.02,100000,2,4196000,0,0,0,0,0,0,100000,100000,0,0
20200312,00749B,凱基新興債10+,46.80,46.80,46.57,46.57,-0.91,-1.92,110000,6,5146000,0,0,0,0,0,0,110000,100000,10000,10000
20200312,00750B,凱基科技債10+,47.94,47.94,47.89,47.89,-0.96,-1.97,55000,3,2634200,0,50000,-50000,0,0,0,55000,3000,52000,2000
20200312,00751B,元大AAA至A公司債,49.00,49.00,47.70,48.02,-2.23,-4.44,1955000,685,93892570,1000,998000,-997000,0,0,0,1056000,5000,1051000,54000
20200312,00754B,群益AAA-AA公司債,49.45,49.45,48.96,49.04,-1.21,-2.41,136000,37,6704960,0,1000,-1000,0,0,0,129000,100000,29000,28000
20200312,00755B,群益15年IG公用債,48.20,48.20,46.75,46.75,-1.48,-3.07,146000,35,6867570,0,6000,-6000,0,0,0,138000,100000,38000,32000
20200312,00756B,群益15年EM主權債,49.70,49.70,48.81,48.86,-1.34,-2.67,130000,19,6350620,0,6000,-6000,0,0,0,123000,103000,20000,14000
20200312,00758B,FH能源債,56.55,56.55,56.10,56.25,-1.25,-2.17,9000,6,507500,0,1000,-1000,0,0,0,6000,4000,2000,1000
20200312,00759B,FH製藥債,75.75,75.75,75.30,75.30,-1.90,-2.46,118000,7,8894650,0,0,0,0,0,0,118000,113000,5000,5000
20200312,00760B,FH新興企業債,65.85,65.85,65.55,65.55,-1.75,-2.6,126000,13,8277700,0,0,0,0,0,0,125000,7600000,-7475000,-7475000
20200312,00761B,國泰A級公司債,49.99,49.99,48.82,48.83,-2.17,-4.25,218000,31,10690560,0,24000,-24000,0,0,0,188000,154000,34000,10000
20200312,00764B,群益25年美債,53.45,54.15,53.45,54.00,-1.30,-2.35,118000,16,6352150,0,0,0,0,0,0,112000,107000,5000,5000
20200312,00765B,群益中國政金債,40.45,40.58,40.13,40.46,-0.06,-0.15,200000,102,8096040,0,0,0,0,0,0,199000,100000,99000,99000
20200312,00768B,FH20年美債,82.50,82.50,82.50,82.50,-0.80,-0.96,100000,2,8250000,0,0,0,0,0,0,100000,100000,0,0
20200312,00769B,FH中國信用債,61.30,61.30,61.30,61.30,0.00,0.0,100000,2,6130000,0,0,0,0,0,0,100000,100000,0,0
20200312,00772B,中信高評級公司債,47.99,47.99,47.30,47.33,-2.05,-4.15,623000,109,29638360,0,379000,-379000,0,0,0,529000,183000,346000,-33000
20200312,00773B,中信優先金融債,47.37,47.50,47.25,47.28,-2.26,-4.56,864000,135,40918710,0,0,0,0,0,0,747000,801000,-54000,-54000
20200312,00777B,凱基AAA至A公司債,48.41,48.41,47.60,47.60,-1.30,-2.66,111000,6,5288630,0,0,0,0,0,0,111000,111000,0,0
20200312,00778B,凱基金融債20+,47.81,47.81,46.99,46.99,-1.31,-2.71,121000,8,5696200,0,0,0,0,0,0,121000,121000,0,0
20200312,00779B,凱基美債25+,54.30,54.40,54.00,54.00,-1.50,-2.7,103000,5,5582700,0,20000000,-20000000,0,0,0,101000,101000,0,-20000000
20200312,00780B,國泰A級金融債,42.30,42.33,42.30,42.33,-0.75,-1.74,107000,3,4526310,0,0,0,0,0,0,107000,100000,7000,7000
20200312,00781B,國泰A級科技債,47.65,48.04,47.50,47.50,-1.84,-3.73,106000,6,5037070,0,3000,-3000,0,0,0,103000,100000,3000,0
20200312,00782B,國泰A級公用債,46.00,46.17,45.90,45.90,-1.72,-3.61,112000,7,5152560,0,7000,-7000,0,0,0,104000,100000,4000,-3000
20200312,00784B,富邦中國投等債,41.35,41.35,41.35,41.35,-0.18,-0.43,100000,2,4135000,0,0,0,0,0,0,100000,100000,0,0
20200312,00785B,富邦金融投等債,44.15,44.15,44.14,44.14,-1.89,-4.11,320000,6,14125000,0,10000,-10000,0,0,0,320000,310000,10000,0
20200312,00786B,元大10年IG銀行債,43.49,43.49,42.25,42.25,-2.43,-5.44,289000,30,12283590,0,0,0,0,0,0,226000,220000,6000,6000
20200312,00787B,元大10年IG醫療債,45.57,45.65,44.81,44.81,-1.93,-4.13,236000,44,10630800,0,0,0,0,0,0,205000,100000,105000,105000
20200312,00788B,元大10年IG電能債,43.69,43.85,43.09,43.20,-1.90,-4.21,181000,24,7855220,0,48000,-48000,0,0,0,161000,104000,57000,9000
20200312,00789B,FH公司債A3,71.00,71.00,71.00,71.00,-1.65,-2.27,100000,2,7100000,0,0,0,0,0,0,100000,100000,0,0
20200312,00790B,FH次順位IG金融債,65.90,65.90,65.25,65.25,-2.30,-3.4,110000,4,7210000,0,49000,-49000,0,0,0,110000,61000,49000,0
20200312,00791B,FH美元信用債1-5Y,60.10,60.10,60.10,60.10,-0.10,-0.17,100000,2,6010000,0,0,0,0,0,0,100000,100000,0,0
20200312,00792B,群益A級公司債,45.64,46.16,45.64,45.90,-1.53,-3.23,211000,18,9701610,0,89000,-89000,0,0,0,210000,100000,110000,21000
20200312,00793B,群益AAA-A醫療債,47.00,47.09,46.80,46.80,-1.12,-2.34,443000,40,20810100,0,422000,-422000,0,0,0,428000,10000,418000,-4000
20200312,00794B,群益7+中國政金債,40.71,40.84,40.71,40.84,-0.36,-0.87,102000,3,4165420,0,0,0,0,0,0,102000,100000,2000,2000
20200312,00795B,中信美國公債20年,50.55,51.40,50.25,50.75,-1.10,-2.12,376000,148,19139350,0,28000,-28000,0,0,0,249000,149000,100000,72000
20200312,00796B,中信中國債7-10,40.20,40.20,40.04,40.17,-0.06,-0.15,152000,7,6104080,0,0,0,0,0,0,150000,140000,10000,10000
20200312,00797B,中信中國美元IG債,42.15,42.45,42.15,42.31,-0.31,-0.73,171000,15,7248810,0,0,0,0,0,0,171000,154000,17000,17000
20200312,00798B,國泰中企A級債7+,45.35,45.35,45.35,45.35,-0.03,-0.07,117000,9,5305950,0,0,0,0,0,0,117000,100000,17000,17000
20200312,00799B,國泰A級醫療債,46.84,47.40,46.84,46.85,-1.57,-3.24,117000,10,5500470,0,0,0,0,0,0,114000,101000,13000,13000
20200312,00831B,新光美債1-3,40.26,40.41,40.26,40.35,+0.15,0.37,53000,5,2141470,0,0,0,0,0,0,53000,50000,3000,3000
20200312,00832B,新光美債20+,51.95,52.15,51.95,52.15,-0.35,-0.67,53000,5,2763550,0,0,0,0,0,0,53000,50000,3000,3000
20200312,00833B,第一金美債20+,49.98,50.00,49.78,49.78,-0.92,-1.81,227000,9,11323540,0,0,0,0,0,0,226000,226000,0,0
20200312,00834B,第一金金融債10+,44.00,44.00,43.87,43.99,-1.69,-3.7,210000,4,9239300,0,0,0,0,0,0,210000,200000,10000,10000
20200312,00835B,第一金科技債10+,45.17,45.22,45.04,45.04,-1.48,-3.18,254000,16,11467010,0,0,0,0,0,0,254000,254000,0,0
20200312,00836B,永豐10年A公司債,44.11,44.11,43.88,43.88,-1.73,-3.79,162000,19,7124510,0,75000,-75000,0,0,0,145000,84000,61000,-14000
20200312,00837B,永豐15年金融債,43.16,43.24,42.84,43.00,-1.49,-3.35,137000,37,5905980,0,0,0,0,0,0,102000,120000,-18000,-18000
20200312,00838B,永豐7-10年中國債,39.97,40.00,39.97,40.00,-0.03,-0.07,101000,6,4039970,0,0,0,0,0,0,101000,100000,1000,1000
20200312,00839B,凱基醫療保健債,44.69,44.75,44.62,44.75,-0.85,-1.86,113000,7,5055610,0,0,0,0,0,0,113000,100000,13000,13000
20200312,00840B,凱基IG精選15+,42.84,42.90,42.40,42.40,-1.40,-3.2,130000,8,5569950,0,0,0,0,0,0,130000,110000,20000,20000
20200312,00841B,凱基AAA-AA公司債,43.67,43.67,43.49,43.49,-1.21,-2.71,125000,8,5453350,0,0,0,0,0,0,125000,115000,10000,10000
20200312,00842B,台新美元銀行債,41.33,41.42,41.30,41.42,-1.02,-2.4,102000,10,4218010,0,0,0,0,0,0,100000,44000,56000,56000
20200312,00843B,台新中國政策債,39.87,39.98,39.87,39.98,-0.02,-0.05,101000,3,4037870,0,0,0,0,0,0,101000,100000,1000,1000
20200312,00844B,新光15年IG金融債,41.23,41.90,41.23,41.90,-1.10,-2.56,5000,4,207610,0,0,0,0,0,0,5000,5000,0,0
20200312,00845B,富邦新興投等債,39.29,39.29,39.00,39.00,-0.43,-1.09,408000,8,15927820,0,0,0,0,0,0,405000,405000,0,0
20200312,00846B,富邦歐洲銀行債,39.67,39.67,39.35,39.35,-0.70,-1.75,310000,7,12215500,0,34000,-34000,0,0,0,310000,276000,34000,0
20200312,00847B,中信美國市政債,43.95,43.95,43.39,43.50,-1.49,-3.31,1218000,111,53243840,0,0,0,0,0,0,1210000,385000,825000,825000
20200312,00848B,中信新興亞洲債,40.81,41.04,40.67,40.87,-0.19,-0.46,197000,10,8059590,0,0,0,0,0,0,197000,195000,2000,2000
20200312,00849B,中信EM主權債0-5,39.43,39.45,39.43,39.45,+0.06,0.15,141000,6,5561030,0,0,0,0,0,0,141000,139000,2000,2000
20200312,00853B,統一美債10年Aa-A,38.35,38.74,38.30,38.40,-1.32,-3.32,23000,12,885760,0,0,0,0,0,0,11000,9000,2000,2000
20200312,00854B,富邦全球保險債,41.32,41.47,41.32,41.47,-1.68,-3.89,312000,10,12935570,0,0,0,0,0,0,310000,302000,8000,8000
20200312,00855B,富邦全球能源債,35.00,35.25,34.75,35.00,-2.00,-5.41,228000,17,7960060,0,0,0,0,0,0,219000,211000,8000,8000
20200312,00856B,永豐1-3年美公債,39.80,39.82,39.70,39.70,+0.05,0.13,140000,8,5564400,0,0,0,0,0,0,140000,130000,10000,10000
20200312,00857B,永豐20年美公債,45.15,45.30,45.15,45.28,-0.85,-1.84,122000,13,5523810,0,0,0,0,0,0,120000,102000,18000,18000
20200312,00858,永豐美國500大,18.73,18.73,17.90,18.11,-1.06,-5.53,158000,56,2867000,0,0,0,0,0,0,94000,137000,-43000,-43000
20200312,00859B,群益0-1年美債,39.46,39.48,39.44,39.44,+0.05,0.13,130000,11,5131720,0,0,0,0,0,0,128000,120000,8000,8000
20200312,00860B,群益1-5年IG債,39.42,39.50,39.42,39.50,+0.07,0.18,101000,3,3989420,0,0,0,0,0,0,101000,100000,1000,1000
20200312,00862B,中信投資級公司債,40.23,40.96,40.00,40.54,-1.48,-3.52,276000,56,11086340,0,0,0,0,0,0,244000,149000,95000,95000
20200312,00863B,中信全球電信債,41.83,41.83,41.61,41.69,-1.08,-2.53,355000,19,14809940,0,0,0,0,0,0,353000,312000,41000,41000
20200312,00864B,中信美國公債0-1,39.55,39.69,39.55,39.67,+0.16,0.4,156000,7,6189050,0,0,0,0,0,0,156000,140000,16000,16000
20200312,00867B,新光A-BBB電信債,42.20,42.20,42.20,42.20,-0.72,-1.68,2000,2,84400,0,0,0,0,0,0,2000,2000,0,0
20200312,00868B,FT1-3年美公債,40.17,40.44,40.17,40.44,+0.27,0.67,106000,4,4285270,0,0,0,0,0,0,106000,100000,6000,6000
20200312,00869B,FT10-25年公司債,39.21,39.49,39.21,39.49,-1.39,-3.4,108000,7,4262900,0,0,0,0,0,0,107000,106000,1000,1000
20200312,00870B,元大15年EM主權債,40.90,40.90,40.62,40.64,-0.63,-1.53,246000,20,10004400,0,0,0,0,0,0,241000,13202000,-12961000,-12961000
20200312,00871B,元大中國政金債,40.22,40.22,40.12,40.15,-0.07,-0.17,255000,8,10246260,0,0,0,0,0,0,255000,250000,5000,5000
20200312,00872B,凱基美債1-3,40.65,40.65,40.59,40.59,-0.11,-0.27,101000,3,4105590,0,0,0,0,0,0,101000,100000,1000,1000
20200312,00873B,凱基新興債1-5,39.62,39.62,39.53,39.55,-0.15,-0.38,115000,5,4548650,0,0,0,0,0,0,115000,100000,15000,15000
20200312,00874B,凱基BBB公司債15+,39.18,39.18,38.21,38.21,-1.37,-3.46,127000,11,4871470,0,0,0,0,0,0,126000,126000,0,0
20200312,1240,茂生農經,50.50,50.50,48.35,48.50,-1.90,-3.77,90000,70,4411650,0,7000,-7000,0,0,0,0,0,0,-7000
20200312,1258,其祥-KY,14.10,14.10,12.95,12.95,-1.40,-9.76,102000,42,1333150,0,0,0,0,0,0,0,0,0,0
20200312,1259,安心,70.80,70.80,67.60,68.00,-3.50,-4.9,84000,75,5750800,1000,0,1000,0,0,0,0,0,0,1000
20200312,1264,德麥,209.50,209.50,205.00,207.00,-3.50,-1.66,50000,47,10338500,0,0,0,0,0,0,0,0,0,0
20200312,1268,漢來美食,116.50,116.50,111.50,113.50,-3.50,-2.99,42000,40,4777000,1000,0,1000,0,0,0,0,0,0,1000
20200312,1333,恩得利,,,,,,0.00,0,0,0,0,0,0,0,0,0,0,0,0,0
20200312,1336,台翰,15.55,15.55,14.40,14.60,-0.95,-6.11,731000,189,10757800,19000,88000,-69000,0,0,0,21000,0,21000,-48000
20200312,1565,精華,355.00,355.00,329.50,330.00,-29.00,-8.08,494000,444,166945000,74000,21000,53000,0,0,0,0,6000,-6000,47000
20200312,1569,濱川,17.40,17.50,15.95,15.95,-1.75,-9.89,1285000,693,20903350,26000,51000,-25000,0,483000,-483000,3000,0,3000,-505000
20200312,1570,力肯,12.85,13.00,12.70,12.85,-0.40,-3.02,74000,26,947500,0,0,0,0,0,0,0,0,0,0
20200312,1580,新麥,98.40,98.40,94.50,94.60,-4.00,-4.06,316000,251,30097900,1000,49000,-48000,0,0,0,0,0,0,-48000
20200312,1584,精剛,8.95,8.95,8.30,8.60,-0.40,-4.44,238000,84,2040850,3000,0,3000,0,0,0,4000,0,4000,7000
20200312,1586,和勤,37.15,37.15,34.00,36.50,-0.65,-1.75,845000,302,30499400,25000,22000,3000,0,0,0,13000,13000,0,3000
20200312,1591,駿吉-KY,23.40,23.40,22.80,23.00,-0.30,-1.29,37000,23,846100,0,0,0,0,0,0,0,0,0,0
20200312,1593,祺驊,46.40,46.40,43.00,44.80,-1.80,-3.86,114000,73,5068800,2000,3000,-1000,0,0,0,1000,1000,0,-1000
20200312,1595,川寶,32.65,32.65,30.45,30.55,-2.60,-7.84,63000,54,1988800,0,4000,-4000,0,0,0,1000,0,1000,-3000
20200312,1597,直得,86.80,86.80,79.00,79.90,-7.00,-8.06,1257000,868,103233900,71000,126000,-55000,0,0,0,2000,58000,-56000,-111000
20200312,1599,宏佳騰,34.00,34.20,31.15,32.30,-1.70,-5.0,142000,87,4665600,1000,2000,-1000,0,0,0,2000,2000,0,-1000
20200312,1742,台蠟,22.05,22.10,20.15,20.45,-1.90,-8.5,941000,301,19204450,41000,1000,40000,0,0,0,0,0,0,40000
20200312,1752,南光,42.55,42.65,38.70,39.00,-3.95,-9.2,1608000,1075,64231300,53000,175000,-122000,0,0,0,14000,26000,-12000,-134000
20200312,1777,生泰,85.00,85.00,77.90,77.90,-6.30,-7.48,506000,412,40553700,23000,9000,14000,0,0,0,0,1000,-1000,13000
20200312,1781,合世,10.15,10.15,9.86,9.87,-1.08,-9.86,373000,153,3726890,0,0,0,0,0,0,2000,0,2000,2000
20200312,1784,訊聯,36.90,36.90,33.30,33.30,-3.60,-9.76,599000,419,20504600,12000,51000,-39000,0,0,0,3000,3000,0,-39000
20200312,1785,光洋科,21.05,21.05,19.15,19.20,-2.00,-9.43,3777000,1349,75216500,127000,473000,-346000,0,0,0,21000,1000,20000,-326000
20200312,1788,杏昌,106.00,106.00,103.50,104.00,-2.00,-1.89,126000,99,13142000,0,0,0,0,0,0,0,0,0,0
20200312,1796,金穎生技,25.20,26.00,25.00,26.00,-0.30,-1.14,9000,8,227400,0,0,0,0,0,0,0,0,0,0
20200312,1799,易威,11.10,11.20,10.35,10.35,-1.15,-10.0,1290000,444,13618950,11000,6000,5000,0,0,0,0,0,0,5000
20200312,1813,寶利徠,23.00,23.35,22.35,22.35,-1.20,-5.1,245000,122,5524200,0,6000,-6000,0,0,0,3000,0,3000,-3000
20200312,1815,富喬,10.70,10.70,9.85,10.05,-0.75,-6.94,3327000,1047,33507330,138000,324000,-186000,0,0,0,52000,28000,24000,-162000
20200312,2035,唐榮,39.40,39.40,38.15,38.65,-0.75,-1.9,8000,5,309300,0,0,0,0,0,0,0,0,0,0
20200312,2061,風青,9.13,9.24,8.81,9.20,-0.12,-1.29,50000,30,452350,2000,0,2000,0,0,0,0,0,0,2000
20200312,2063,世鎧,38.15,38.30,36.90,37.20,-1.80,-4.62,250000,137,9304500,0,5000,-5000,0,0,0,0,0,0,-5000
20200312,2064,晉椿,12.05,12.05,11.70,11.70,-0.80,-6.4,14000,10,166150,0,0,0,0,0,0,0,0,0,0
20200312,2065,世豐,51.50,51.50,49.70,50.60,-1.80,-3.44,641000,412,32357150,60000,15000,45000,0,0,0,0,0,0,45000
20200312,2066,世德,56.80,56.80,52.10,52.50,-3.70,-6.58,35000,32,1879800,0,0,0,0,0,0,0,0,0,0
20200312,2067,嘉鋼,10.25,10.25,9.41,9.80,-0.65,-6.22,109000,37,1057500,0,0,0,0,0,0,0,0,0,0
20200312,2070,精湛,27.00,27.80,26.10,27.80,+0.45,1.65,47000,34,1249050,0,2000,-2000,0,0,0,0,0,0,-2000
20200312,2221,大甲,27.80,28.70,26.30,26.35,-1.75,-6.23,103000,67,2791700,0,0,0,0,0,0,0,0,0,0
20200312,2230,泰茂,11.75,11.90,10.80,11.40,-0.60,-5.0,218000,120,2420900,0,1000,-1000,0,0,0,0,0,0,-1000
20200312,2235,謚源,51.70,51.70,47.30,48.80,-2.20,-4.31,40000,33,1925650,0,0,0,0,0,0,0,0,0,0
20200312,2596,綠意,20.20,20.25,19.15,19.25,-1.05,-5.17,319000,153,6269750,1000,3000,-2000,0,0,0,1000,0,1000,-1000
20200312,2640,大車隊,73.50,73.70,71.80,71.80,-2.70,-3.62,215000,100,15664600,31000,17000,14000,0,0,0,0,0,0,14000
20200312,2641,正德,6.25,6.25,5.92,6.14,-0.11,-1.76,745000,207,4530370,0,0,0,0,0,0,0,0,0,0
20200312,2643,捷迅,36.40,36.40,34.00,34.05,-1.30,-3.68,82000,65,2836400,0,9000,-9000,0,0,0,3000,0,3000,-6000
20200312,2718,晶悅,,,,,,0.00,0,0,0,0,0,0,0,0,0,0,0,0,0
20200312,2719,燦星旅,4.95,5.29,4.91,5.00,-0.39,-7.24,75000,15,380500,0,0,0,0,0,0,0,0,0,0
20200312,2724,富驛-KY,3.00,3.00,3.00,3.00,+0.03,1.01,1000,1,3000,0,0,0,0,0,0,0,0,0,0
20200312,2726,雅茗-KY,55.90,56.40,54.30,56.00,-1.30,-2.27,226000,140,12420300,4000,11000,-7000,0,0,0,0,0,0,-7000
20200312,2729,瓦城,229.00,229.00,220.50,221.00,-9.00,-3.91,105000,98,23408500,5000,3000,2000,0,0,0,0,2000,-2000,0
20200312,2732,六角,141.00,141.00,131.00,132.00,-13.50,-9.28,1425000,1162,191906500,68000,176000,-108000,0,0,0,40000,73000,-33000,-141000
20200312,2734,易飛網,9.78,9.80,9.12,9.77,-0.04,-0.41,15000,11,145650,0,0,0,0,0,0,0,0,0,0
20200312,2736,高野,13.20,13.20,12.80,13.00,-0.30,-2.26,69000,39,893200,0,5000,-5000,0,0,0,0,0,0,-5000
20200312,2740,天蔥,11.70,11.70,11.65,11.65,-0.55,-4.51,4000,4,46700,0,0,0,0,0,0,1000,0,1000,1000
20200312,2743,山富,13.95,13.95,13.05,13.70,-0.35,-2.49,202000,99,2695750,2000,3000,-1000,0,0,0,0,0,0,-1000
20200312,2745,五福,17.35,17.35,16.20,16.20,-1.50,-8.47,52000,30,873100,1000,2000,-1000,0,0,0,0,0,0,-1000
20200312,2752,豆府,109.00,109.00,106.00,106.50,-3.00,-2.74,41000,38,4389000,0,5000,-5000,0,0,0,0,0,0,-5000
20200312,2916,滿心,16.80,17.00,16.50,16.50,-0.55,-3.23,16000,14,268600,0,0,0,0,0,0,0,0,0,0
20200312,2924,東凌-KY,26.20,27.70,26.20,27.70,+0.10,0.36,2000,2,53900,0,0,0,0,0,0,0,0,0,0
20200312,2926,誠品生活,89.00,89.00,85.00,85.10,-3.90,-4.38,59000,54,5075300,13000,0,13000,0,0,0,0,0,0,13000
20200312,2928,紅馬-KY,42.50,43.00,39.35,39.35,-4.35,-9.95,390000,275,15585700,22000,12000,10000,0,0,0,23000,1000,22000,32000
20200312,2937,集雅社,23.00,23.00,22.40,22.40,-1.10,-4.68,18000,6,410150,0,0,0,0,0,0,0,0,0,0
20200312,3064,泰偉,13.70,14.00,13.20,13.95,+1.10,8.56,39000,23,531750,0,0,0,0,0,0,0,0,0,0
20200312,3066,李洲,6.06,6.67,6.01,6.59,-0.08,-1.2,16000,10,97820,0,0,0,0,0,0,0,0,0,0
20200312,3067,全域,46.60,47.25,44.00,45.90,-0.50,-1.08,152000,121,7017900,4000,15000,-11000,0,0,0,0,1000,-1000,-12000
20200312,3071,協禧,16.50,16.50,15.30,15.30,-1.55,-9.2,414000,179,6543950,3000,12000,-9000,0,0,0,11000,4000,7000,-2000
20200312,3073,凱柏實業,8.87,8.87,8.87,8.87,-0.64,-6.73,1000,1,8870,0,0,0,0,0,0,1000,0,1000,1000
20200312,3078,僑威,22.20,22.20,20.20,20.25,-1.95,-8.78,1299000,699,27063250,106000,207000,-101000,0,0,0,0,0,0,-101000
20200312,3081,聯亞,259.00,259.00,237.00,238.50,-24.50,-9.32,3341000,2277,804184000,409000,1103000,-694000,0,0,0,23000,120000,-97000,-791000
20200312,3083,網龍,56.40,57.30,52.70,52.70,-5.80,-9.91,3053000,1934,165160200,670000,122000,548000,0,0,0,32000,171000,-139000,409000
20200312,3085,新零售,3.03,3.03,2.83,2.83,-0.09,-3.08,20000,11,57200,0,0,0,0,0,0,0,0,0,0
20200312,3086,華義,18.05,18.05,18.05,18.05,-0.85,-4.5,1000,1,18050,0,0,0,0,0,0,0,0,0,0
20200312,3088,艾訊,55.80,55.80,54.20,54.30,-1.70,-3.04,757000,543,41388500,5000,269000,-264000,0,0,0,0,0,0,-264000
20200312,3089,元炬,19.85,20.00,18.75,19.00,-0.75,-3.8,21000,12,415800,0,1000,-1000,0,0,0,0,0,0,-1000
20200312,3092,鴻碩,35.80,35.80,32.90,33.10,-2.90,-8.06,392000,272,13248000,28000,46000,-18000,0,0,0,0,0,0,-18000
20200312,3093,港建,26.45,26.45,25.05,25.80,-1.20,-4.44,39000,31,1001900,0,0,0,0,0,0,0,0,0,0
20200312,3095,及成,1.80,1.90,1.80,1.90,+0.05,2.7,10000,5,18240,0,0,0,0,0,0,0,0,0,0
20200312,3105,穩懋,259.00,259.00,238.00,238.00,-26.00,-9.85,13880000,9438,3375768500,1983258,2529450,-546192,8000,976000,-968000,192000,512000,-320000,-1834192
20200312,3114,好德,23.50,23.60,21.80,22.10,-2.00,-8.3,378000,230,8512500,11000,11000,0,0,0,0,4000,0,4000,4000
20200312,3115,寶島極,11.60,11.60,11.15,11.15,-0.45,-3.88,9000,8,101550,0,0,0,0,0,0,0,0,0,0
20200312,3118,進階,33.60,33.60,30.45,30.45,-3.35,-9.91,2132000,1291,66910750,10000,16000,-6000,0,0,0,10000,3000,7000,1000
20200312,3122,笙泉,10.90,11.10,10.35,10.35,-1.15,-10.0,188000,116,1994650,0,0,0,0,0,0,7000,0,7000,7000
20200312,3128,昇銳,12.35,12.35,11.80,12.15,-0.45,-3.57,225000,135,2724800,0,0,0,0,0,0,4000,3000,1000,1000
20200312,3131,弘塑,213.00,214.00,195.00,195.50,-21.00,-9.7,1380000,1160,277079000,208000,86000,122000,0,213000,-213000,13000,44000,-31000,-122000
20200312,3141,晶宏,22.85,22.85,21.10,21.10,-2.30,-9.83,1134000,608,24195000,21000,17000,4000,0,326000,-326000,0,0,0,-322000
20200312,3144,新揚科,24.45,24.45,22.20,22.25,-2.40,-9.74,1563000,786,35382400,126000,145000,-19000,0,0,0,1000,25000,-24000,-43000
20200312,3147,大綜,32.10,32.20,28.90,28.95,-3.15,-9.81,376000,197,11297200,0,29000,-29000,0,0,0,0,0,0,-29000
20200312,3152,璟德,267.00,268.00,246.50,246.50,-27.00,-9.87,1546000,1081,389512500,217000,455000,-238000,0,264000,-264000,17000,74000,-57000,-559000
20200312,3162,精確,,,,,,0.00,0,0,0,0,0,0,0,0,0,0,0,0,0
20200312,3163,波若威,35.70,36.20,33.25,33.30,-3.60,-9.76,1639000,926,55722300,73000,155000,-82000,0,0,0,4000,29000,-25000,-107000
20200312,3169,亞信,31.00,31.15,29.30,29.65,-2.10,-6.61,664000,270,20022850,9001,101000,-91999,0,0,0,128000,0,128000,36001
20200312,3171,新洲,13.40,13.40,12.25,12.35,-1.25,-9.19,86000,37,1066400,0,0,0,0,0,0,0,0,0,0
20200312,3176,基亞,53.90,53.90,48.60,48.70,-5.30,-9.81,1424000,903,70747600,27000,2000,25000,0,0,0,0,0,0,25000
20200312,3178,公準,38.70,40.20,36.70,37.75,-1.35,-3.45,1279000,986,49249550,54000,88000,-34000,0,0,0,0,0,0,-34000
20200312,3188,鑫龍騰,15.10,15.10,14.50,14.75,-0.40,-2.64,129000,86,1900100,4000,0,4000,0,0,0,0,0,0,4000
20200312,3191,和進,49.85,50.60,47.80,50.00,+0.10,0.2,989000,534,48813500,50000,30000,20000,0,0,0,4000,0,4000,24000
20200312,3202,樺晟,19.85,19.85,17.65,17.70,-1.90,-9.69,3481000,1158,64039000,209000,194000,15000,0,0,0,0,0,0,15000
20200312,3205,佰研,41.70,42.30,38.50,39.70,-1.95,-4.68,220000,174,8784450,0,0,0,0,0,0,4000,0,4000,4000
20200312,3206,志豐,29.15,29.15,27.15,27.30,-2.20,-7.46,711000,357,19804300,20000,49000,-29000,0,0,0,1000,0,1000,-28000
20200312,3207,耀勝,10.45,10.95,10.45,10.95,+0.50,4.78,4000,3,43300,0,0,0,0,0,0,0,0,0,0
20200312,3211,順達,65.00,65.20,62.30,63.00,-2.80,-4.26,3589000,2314,227881300,219000,733000,-514000,0,0,0,1000,29000,-28000,-542000
20200312,3213,茂訊,43.00,43.00,41.10,41.35,-1.75,-4.06,223000,164,9263500,1000,16000,-15000,0,0,0,0,0,0,-15000
20200312,3217,優群,79.90,79.90,72.90,74.00,-7.00,-8.64,4710000,2895,353877800,667000,68000,599000,144000,107000,37000,16000,129000,-113000,523000
20200312,3218,大學光,75.00,76.00,69.60,69.60,-7.70,-9.96,2890000,1902,206324200,117000,188000,-71000,0,0,0,13000,82000,-69000,-140000
20200312,3221,台嘉碩,22.45,22.50,20.60,20.70,-1.90,-8.41,1472000,734,31316900,44000,104000,-60000,0,0,0,0,0,0,-60000
20200312,3224,三顧,47.10,48.60,43.85,43.90,-4.80,-9.86,1171000,514,51853600,30000,14000,16000,0,0,0,5000,0,5000,21000
20200312,3226,至寶電,56.20,56.20,55.90,55.90,-0.40,-0.71,12000,11,672600,0,0,0,0,0,0,0,0,0,0
20200312,3227,原相,171.00,171.50,156.00,156.00,-17.00,-9.83,16333000,10580,2643942000,3259040,737400,2521640,95000,1761000,-1666000,181000,383000,-202000,653640
20200312,3228,金麗科,36.00,37.15,34.95,34.95,-1.85,-5.03,707000,401,25243050,38000,38000,0,0,0,0,0,0,0,0
20200312,3230,錦明,5.11,5.11,4.96,4.98,-0.23,-4.41,113000,29,568240,0,0,0,0,0,0,0,0,0,0
20200312,3232,昱捷,18.70,18.70,17.60,17.85,-0.85,-4.55,153000,117,2743450,0,2000,-2000,0,0,0,4000,0,4000,2000
20200312,3234,光環,33.45,33.55,30.45,30.65,-3.10,-9.19,2757000,1512,87104250,201000,349000,-148000,0,0,0,7000,1000,6000,-142000
20200312,3236,千如,18.00,18.00,17.00,17.00,-1.20,-6.59,618000,281,10691500,8000,11000,-3000,0,0,0,1000,1000,0,-3000
20200312,3252,海灣,13.40,13.45,12.70,13.05,-0.95,-6.79,185000,65,2410250,0,0,0,0,0,0,2000,0,2000,2000
20200312,3259,鑫創,12.00,12.45,11.65,12.00,-0.90,-6.98,72000,46,850400,0,0,0,0,0,0,0,0,0,0
20200312,3260,威剛,66.60,66.70,61.00,61.40,-5.90,-8.77,13310000,7356,841798700,923000,622000,301000,28000,1803000,-1775000,767000,1274000,-507000,-1981000
20200312,3264,欣銓,26.40,26.75,25.10,25.10,-1.65,-6.17,5306000,2476,136526550,232000,827284,-595284,333000,0,333000,46000,34000,12000,-250284
20200312,3265,台星科,25.10,25.10,23.10,23.60,-1.60,-6.35,564000,335,13494400,7000,123000,-116000,0,0,0,0,3000,-3000,-119000
20200312,3268,海德威,10.80,10.80,10.00,10.50,-0.50,-4.55,110000,43,1138900,4000,0,4000,0,0,0,0,0,0,4000
20200312,3272,東碩,22.45,22.80,21.40,21.75,-1.30,-5.64,187000,117,4102850,9000,32000,-23000,0,0,0,3000,0,3000,-20000
20200312,3276,宇環,7.66,7.66,7.17,7.30,-0.52,-6.65,59000,17,434290,0,0,0,0,0,0,0,0,0,0
20200312,3284,太普高,12.45,12.60,12.00,12.60,-0.20,-1.56,363000,135,4435400,0,0,0,0,0,0,1000,1000,0,0
20200312,3285,微端,13.60,13.60,12.20,12.95,-0.60,-4.43,224000,94,2802350,0,0,0,0,0,0,0,0,0,0
20200312,3287,廣寰科,7.65,7.65,7.03,7.34,-0.47,-6.02,84000,28,604030,0,0,0,0,0,0,0,0,0,0
20200312,3288,點晶,9.28,9.38,9.21,9.38,-0.38,-3.89,22000,12,203820,0,0,0,0,0,0,0,0,0,0
20200312,3289,宜特,39.55,40.20,37.50,38.20,-1.75,-4.38,1669000,1079,64620050,49000,58000,-9000,0,0,0,0,1000,-1000,-10000
20200312,3290,東浦,13.40,13.40,12.60,13.10,-0.45,-3.32,715000,242,9189200,7000,28000,-21000,0,0,0,0,0,0,-21000
20200312,3293,鈊象,579.00,579.00,523.00,524.00,-57.00,-9.81,3985000,3466,2168139000,459000,221000,238000,12000,24000,-12000,58000,487000,-429000,-203000
20200312,3294,英濟,14.30,14.30,13.15,13.25,-1.05,-7.34,129000,70,1734250,1000,13000,-12000,0,0,0,0,0,0,-12000
20200312,3297,杭特,12.20,12.20,11.25,11.30,-1.15,-9.24,107000,58,1236050,0,0,0,0,0,0,2000,1000,1000,1000
20200312,3303,岱稜,24.05,24.05,23.30,23.50,-0.70,-2.89,478000,194,11274350,0,28000,-28000,0,0,0,0,0,0,-28000
20200312,3306,鼎天,17.70,17.70,16.70,16.85,-1.30,-7.16,113000,53,1951250,0,0,0,0,0,0,0,0,0,0
20200312,3310,佳穎,28.50,28.50,27.50,28.30,-1.75,-5.82,184000,19,5191350,0,0,0,0,0,0,0,0,0,0
20200312,3313,斐成,14.00,14.00,12.75,12.85,-1.30,-9.19,534000,216,6927150,1000,4000,-3000,0,0,0,0,0,0,-3000
20200312,3317,尼克森,39.90,40.00,36.50,36.60,-3.90,-9.63,1623000,1117,61448150,101000,126000,-25000,0,0,0,16000,24000,-8000,-33000
20200312,3322,建舜電,6.37,6.48,6.01,6.06,-0.44,-6.77,353000,106,2177570,14000,9000,5000,0,0,0,0,0,0,5000
20200312,3323,加百裕,25.60,25.65,23.80,24.00,-1.85,-7.16,564000,258,13826000,9000,7000,2000,0,0,0,5000,0,5000,7000
20200312,3324,雙鴻,154.00,154.00,140.00,140.00,-15.50,-9.97,8194000,5238,1177874000,414000,377000,37000,0,0,0,33000,137000,-104000,-67000
20200312,3325,旭品,10.30,10.40,9.80,9.99,-0.51,-4.86,391000,109,3920290,0,8000,-8000,0,0,0,0,3000,-3000,-11000
20200312,3332,幸康,34.00,34.00,33.50,33.50,-1.50,-4.29,5000,5,169200,0,0,0,0,0,0,0,0,0,0
20200312,3339,泰谷,3.90,3.91,3.90,3.90,-0.10,-2.5,40000,8,156020,0,0,0,0,0,0,0,0,0,0
20200312,3354,律勝,13.45,13.45,12.00,12.10,-1.15,-8.68,189000,100,2311900,2000,12000,-10000,0,0,0,2000,0,2000,-8000
20200312,3360,尚立,15.00,15.00,13.70,13.70,-1.50,-9.87,853000,412,11888650,49000,39000,10000,0,0,0,7000,2000,5000,15000
20200312,3362,先進光,33.00,33.00,30.15,30.15,-3.35,-10.0,638000,434,19542800,33000,31000,2000,0,0,0,8000,0,8000,10000
20200312,3363,上詮,23.90,23.90,21.65,21.90,-1.65,-7.01,980000,598,21821550,57000,104000,-47000,0,0,0,6000,2000,4000,-43000
20200312,3372,典範,8.80,8.80,8.46,8.69,-0.23,-2.58,173000,70,1481890,0,0,0,0,0,0,3000,0,3000,3000
20200312,3373,熱映,48.10,48.10,44.05,44.05,-4.85,-9.92,1105000,479,50193750,0,0,0,0,0,0,150000,0,150000,150000
20200312,3374,精材,80.00,80.50,73.80,73.80,-8.20,-10.0,25243000,13826,1910281900,1795000,1199000,596000,0,377000,-377000,45000,223000,-178000,41000
20200312,3379,彬台,9.71,9.71,9.55,9.62,-0.29,-2.93,126000,62,1221320,0,2000,-2000,0,0,0,0,2000,-2000,-4000
20200312,3388,崇越電,66.00,66.00,63.30,63.80,-2.30,-3.48,228000,178,14661900,0,34000,-34000,0,0,0,0,0,0,-34000
20200312,3390,旭軟,17.20,17.20,16.10,16.10,-1.75,-9.8,775000,249,12563350,3000,1000,2000,0,0,0,6000,0,6000,8000
20200312,3402,漢科,28.05,28.10,27.00,27.05,-1.55,-5.42,529000,302,14489050,5000,48000,-43000,0,0,0,0,0,0,-43000
20200312,3426,台興,34.00,34.00,32.20,32.20,-2.20,-6.4,27000,19,887350,2000,0,2000,0,0,0,0,0,0,2000
20200312,3434,哲固,13.05,13.05,13.05,13.05,-0.80,-5.78,1000,1,13050,0,0,0,0,0,0,0,0,0,0
20200312,3438,類比科,29.70,33.00,29.50,29.85,-0.15,-0.5,3399000,2381,107649450,150000,208000,-58000,0,0,0,0,0,0,-58000
20200312,3441,聯一光,25.65,25.70,23.35,24.00,-1.70,-6.61,249000,189,6017100,0,14000,-14000,0,0,0,3000,0,3000,-11000
20200312,3444,利機,38.40,38.70,36.15,38.70,0.00,0.0,951000,508,35567900,28000,14000,14000,0,0,0,6000,6000,0,14000
20200312,3455,由田,50.50,50.50,46.20,46.35,-4.55,-8.94,894000,579,42367400,57000,47000,10000,0,0,0,0,0,0,10000
20200312,3465,進泰電子,32.00,32.00,31.00,31.00,-0.50,-1.59,16000,6,509000,0,0,0,0,0,0,0,0,0,0
20200312,3466,致振,17.60,17.80,16.45,17.80,-0.45,-2.47,46000,25,800850,0,0,0,0,0,0,0,0,0,0
20200312,3479,安勤,70.10,70.10,64.80,64.80,-7.10,-9.87,2912000,1608,193293500,394000,179000,215000,0,0,0,181000,166000,15000,230000
20200312,3483,力致,43.00,43.50,40.05,40.25,-4.25,-9.55,3211000,1844,131888800,694000,226000,468000,0,70000,-70000,3000,72000,-69000,329000
20200312,3484,崧騰,25.90,25.90,25.00,25.15,-1.25,-4.73,193000,146,4907750,1000,10000,-9000,0,0,0,0,0,0,-9000
20200312,3489,森寶,10.65,10.75,9.59,9.59,-1.06,-9.95,1630000,531,15894300,24000,24000,0,0,0,0,52000,52000,0,0
20200312,3490,單井,19.40,19.40,17.50,17.55,-1.85,-9.54,792000,401,14202950,22000,70000,-48000,0,0,0,0,0,0,-48000
20200312,3491,昇達科,74.50,75.00,70.50,71.50,-5.30,-6.9,1207000,891,87282200,73000,130000,-57000,0,0,0,7000,9000,-2000,-59000
20200312,3492,長盛,16.30,16.30,14.85,15.00,-1.50,-9.09,98000,58,1484300,0,0,0,0,0,0,0,0,0,0
20200312,3498,陽程,26.90,26.90,24.65,24.65,-2.70,-9.87,506000,242,12953550,11000,13000,-2000,0,0,0,7000,4000,3000,1000
20200312,3499,環天科,11.60,11.60,10.65,10.65,-1.15,-9.75,401000,139,4335400,86000,0,86000,0,0,0,2000,0,2000,88000
20200312,3508,位速,20.70,20.70,18.65,18.65,-2.05,-9.9,1068000,569,20343800,26000,50000,-24000,0,0,0,1000,1000,0,-24000
20200312,3511,矽瑪,29.05,29.05,26.45,26.45,-2.90,-9.88,1304000,699,35045000,150000,80000,70000,0,0,0,3000,0,3000,73000
20200312,3512,皇龍,27.80,27.80,25.85,25.85,-2.85,-9.93,216000,102,5625950,0,0,0,0,0,0,0,0,0,0
20200312,3516,亞帝歐,11.20,11.50,10.60,11.15,-0.30,-2.62,82000,34,901550,0,0,0,0,0,0,1000,0,1000,1000
20200312,3520,振維,9.95,10.00,9.05,9.06,-0.94,-9.4,117000,66,1118670,5000,2000,3000,0,0,0,0,0,0,3000
20200312,3521,鴻翊,14.05,14.05,13.10,13.25,-0.95,-6.69,247000,148,3287650,2000,17000,-15000,0,0,0,2000,2000,0,-15000
20200312,3522,御頂,15.20,15.60,14.50,15.60,-0.10,-0.64,102000,56,1542300,0,0,0,0,0,0,3000,3000,0,0
20200312,3523,迎輝,10.50,10.70,10.30,10.65,-0.65,-5.75,110000,26,1167100,0,0,0,0,0,0,9000,0,9000,9000
20200312,3526,凡甲,73.50,73.80,69.70,70.70,-4.10,-5.48,4480000,2919,318846400,248000,514000,-266000,0,0,0,248000,375000,-127000,-393000
20200312,3527,聚積,97.20,97.50,89.30,90.00,-9.00,-9.09,1223000,951,113089400,95000,62000,33000,0,0,0,7000,59000,-52000,-19000
20200312,3529,力旺,280.00,286.00,261.00,261.00,-29.00,-10.0,941000,685,248246500,42000,23000,19000,0,250000,-250000,154000,25000,129000,-102000
20200312,3531,先益,22.30,22.30,21.50,21.85,-0.45,-2.02,95000,42,2096250,0,0,0,0,0,0,0,0,0,0
20200312,3537,堡達,30.20,30.20,28.70,29.45,-1.30,-4.23,620000,354,18337650,16000,26000,-10000,0,0,0,0,0,0,-10000
20200312,3540,曜越,22.85,23.50,21.75,21.75,-2.30,-9.56,380000,217,8458000,1000,0,1000,0,0,0,9000,1000,8000,9000
20200312,3541,西柏,75.00,75.40,71.60,71.70,-4.30,-5.66,387000,308,28197300,8000,133000,-125000,0,0,0,0,0,0,-125000
20200312,3546,宇峻,93.70,94.80,86.00,89.00,-3.00,-3.26,3393000,2551,305210700,488000,162000,326000,0,0,0,58000,160000,-102000,224000
20200312,3548,兆利,75.40,75.40,69.50,71.40,-5.50,-7.15,2486000,1334,179292500,162000,409000,-247000,0,0,0,2000,102000,-100000,-347000
20200312,3551,世禾,38.70,38.70,35.15,35.15,-3.90,-9.99,2874000,1192,103131100,182000,158000,24000,0,232000,-232000,2000,38000,-36000,-244000
20200312,3552,同致,51.00,51.00,46.65,46.65,-5.15,-9.94,1176000,844,55739450,70000,34000,36000,0,0,0,4000,17000,-13000,23000
20200312,3555,重鵬,27.90,27.90,25.60,26.65,-1.25,-4.48,9000,6,234750,0,0,0,0,0,0,0,0,0,0
20200312,3556,禾瑞亞,46.50,46.50,44.60,44.90,-1.90,-4.06,492000,325,22402350,3000,122000,-119000,0,0,0,0,0,0,-119000
20200312,3558,神準,104.50,104.50,99.10,99.40,-6.60,-6.23,391000,334,39449400,7000,84000,-77000,0,0,0,0,0,0,-77000
20200312,3564,其陽,28.95,28.95,27.25,27.35,-2.70,-8.99,64000,53,1763050,0,1000,-1000,0,0,0,2000,0,2000,1000
20200312,3567,逸昌,24.10,24.10,22.75,22.75,-1.65,-6.76,525000,278,12244150,0,0,0,0,0,0,0,1000,-1000,-1000
20200312,3570,大塚,96.00,97.20,93.40,94.90,-2.40,-2.47,117000,91,11143800,2000,8000,-6000,0,0,0,0,0,0,-6000
20200312,3577,泓格,30.50,30.65,29.90,29.90,-1.10,-3.55,35000,31,1057500,0,0,0,0,0,0,0,0,0,0
20200312,3580,友威科,22.60,22.60,20.35,20.35,-2.25,-9.96,614000,308,12742400,9000,1000,8000,0,0,0,4000,4000,0,8000
20200312,3581,博磊,15.40,15.40,14.15,15.00,-0.70,-4.46,74000,45,1094250,0,0,0,0,0,0,0,0,0,0
20200312,3587,閎康,66.60,66.60,61.60,62.80,-4.50,-6.69,985000,749,62599700,66000,163000,-97000,0,0,0,0,65000,-65000,-162000
20200312,3594,磐儀,21.70,21.70,20.90,21.15,-0.70,-3.2,350000,185,7451500,1000,41000,-40000,0,0,0,0,0,0,-40000
20200312,3597,映興,15.50,15.55,14.70,15.45,-0.10,-0.64,358000,171,5463550,0,8000,-8000,0,0,0,0,0,0,-8000
20200312,3609,東林,23.20,23.85,22.55,23.30,-0.05,-0.21,578000,332,13454550,133000,7000,126000,0,0,0,1000,1000,0,126000
20200312,3611,鼎翰,200.50,200.50,186.00,193.00,-11.00,-5.39,288000,262,55331000,10000,15000,-5000,0,7000,-7000,0,74000,-74000,-86000
20200312,3615,安可,13.70,13.70,12.65,13.10,-0.75,-5.42,191000,124,2481850,1000,1000,0,0,0,0,4000,0,4000,4000
20200312,3623,富晶通,18.50,18.50,18.00,18.00,-0.60,-3.23,48000,33,872550,0,0,0,0,0,0,0,0,0,0
20200312,3624,光頡,26.80,27.00,24.35,24.40,-2.65,-9.8,2238000,1306,55981950,446000,117000,329000,0,0,0,10000,31000,-21000,308000
20200312,3625,西勝,14.60,14.70,13.55,13.55,-1.50,-9.97,855000,405,11779150,71000,8000,63000,0,0,0,0,0,0,63000
20200312,3628,盈正,30.90,30.90,29.95,29.95,-1.20,-3.85,30000,29,904100,0,0,0,0,0,0,0,0,0,0
20200312,3629,地心引力,67.00,67.00,66.00,66.00,-1.00,-1.49,3000,3,199000,0,0,0,0,0,0,0,0,0,0
20200312,3630,新鉅科,57.80,57.80,52.20,52.60,-5.40,-9.31,5453000,2981,294684500,1012000,263000,749000,0,0,0,6000,37000,-31000,718000
20200312,3631,晟楠,46.35,48.30,44.50,45.50,-2.00,-4.21,201000,146,9247550,2000,4000,-2000,0,0,0,0,0,0,-2000
20200312,3632,研勤,9.03,9.07,8.60,8.70,-0.70,-7.45,189000,104,1683870,1000,0,1000,0,0,0,2000,0,2000,3000
20200312,3642,駿熠電,17.50,17.70,16.30,17.00,-0.90,-5.03,155000,81,2623100,0,7000,-7000,0,0,0,1000,1000,0,-7000
20200312,3646,艾恩特,15.40,15.40,14.50,15.10,-0.60,-3.82,49000,37,740000,0,0,0,0,0,0,0,0,0,0
20200312,3652,精聯,16.40,16.60,15.80,16.00,-0.80,-4.76,70000,40,1127400,0,0,0,0,0,0,1000,0,1000,1000
20200312,3663,鑫科,18.55,18.55,17.20,17.70,-1.00,-5.35,173000,111,3078700,13000,19000,-6000,0,0,0,2000,8000,-6000,-12000
20200312,3664,安瑞-KY,11.70,11.70,10.35,10.35,-1.05,-9.21,74000,23,787950,0,0,0,0,0,0,1000,0,1000,1000
20200312,3666,光耀,15.55,15.55,14.00,14.80,-0.75,-4.82,229000,95,3326500,0,0,0,0,0,0,3000,3000,0,0
20200312,3672,康聯訊,13.40,13.80,13.20,13.70,-0.15,-1.08,14000,9,188450,0,0,0,0,0,0,0,0,0,0
20200312,3675,德微,36.80,38.00,36.80,36.80,-1.45,-3.79,68000,51,2513550,6000,0,6000,0,0,0,0,0,0,6000
20200312,3680,家登,155.00,156.00,143.50,143.50,,0.00,2507000,1845,370296000,142000,114000,28000,0,0,0,0,0,0,28000
20200312,3684,榮昌,40.50,40.50,37.50,37.55,-3.00,-7.4,96000,80,3707300,0,8000,-8000,0,0,0,1000,0,1000,-7000
20200312,3685,元創精密,21.80,21.85,20.35,20.85,-1.75,-7.74,96000,57,1986150,0,0,0,0,0,0,0,0,0,0
20200312,3687,歐買尬,35.00,35.00,31.50,31.60,-3.40,-9.71,542000,356,17589550,47000,76000,-29000,0,0,0,8000,0,8000,-21000
20200312,3689,湧德,22.00,22.00,20.15,20.50,-1.55,-7.03,545000,192,11427800,1000,12000,-11000,0,0,0,0,5000,-5000,-16000
20200312,3691,碩禾,112.50,112.50,103.00,103.50,-10.50,-9.21,610000,493,64707500,30000,88000,-58000,0,0,0,8000,24000,-16000,-74000
20200312,3693,營邦,33.05,33.05,30.15,30.60,-2.85,-8.52,192000,121,5934100,0,0,0,0,0,0,0,0,0,0
20200312,3707,漢磊,27.40,28.10,25.50,26.05,-1.35,-4.93,19872000,9608,529356600,771000,1601000,-830000,0,0,0,31000,62000,-31000,-861000
20200312,3709,鑫聯大投控,19.00,19.00,18.10,19.00,-0.30,-1.55,25000,20,470050,5000,0,5000,0,0,0,0,0,0,5000
20200312,3710,連展投控,6.00,6.06,5.55,5.55,-0.61,-9.9,4372000,621,24452170,72000,10000,62000,0,0,0,77000,37000,40000,102000
20200312,3713,新晶投控,12.40,14.10,11.70,11.90,-1.05,-8.11,116000,59,1411800,20000,0,20000,0,0,0,0,0,0,20000
20200312,4102,永日,23.00,23.50,20.75,20.75,-2.30,-9.98,2946000,1410,63060650,48000,48000,0,0,0,0,10000,1000,9000,9000
20200312,4105,東洋,76.30,76.40,70.10,70.60,-6.10,-7.95,1405000,1065,101533400,108000,160000,-52000,0,0,0,10000,31000,-21000,-73000
20200312,4107,邦特,115.00,115.00,110.50,112.00,-4.50,-3.86,622000,527,70075500,176000,122000,54000,0,0,0,0,7000,-7000,47000
20200312,4109,加捷生醫,17.75,17.75,16.20,16.20,-1.75,-9.75,488000,231,8036000,4000,37000,-33000,0,0,0,0,0,0,-33000
20200312,4111,濟生,25.85,25.85,23.75,23.90,-1.95,-7.54,1216000,445,29452700,15000,10000,5000,0,0,0,2000,15000,-13000,-8000
20200312,4113,聯上,12.75,12.75,11.90,12.40,-0.30,-2.36,1323000,395,16182950,94000,94000,0,0,0,0,0,0,0,0
20200312,4114,健喬,22.85,22.85,20.85,21.10,-1.55,-6.84,1504000,724,32144350,53000,68000,-15000,0,0,0,0,0,0,-15000
20200312,4116,明基醫,33.60,33.60,31.55,31.55,-2.40,-7.07,140000,100,4538350,0,1000,-1000,0,0,0,1000,0,1000,0
20200312,4120,友華,49.20,49.25,46.50,47.05,-2.55,-5.14,134000,82,6484200,0,4000,-4000,0,0,0,3000,0,3000,-1000
20200312,4121,優盛,17.65,17.65,16.05,16.05,-1.75,-9.83,1265000,677,20932600,0,0,0,0,0,0,25000,0,25000,25000
20200312,4123,晟德,50.50,51.10,47.00,47.80,-2.70,-5.35,1928000,1315,94142900,48000,163000,-115000,0,0,0,7000,85000,-78000,-193000
20200312,4126,太醫,72.20,72.80,70.00,70.50,-2.30,-3.16,843000,645,59871900,230000,100000,130000,0,0,0,0,0,0,130000
20200312,4127,天良,10.70,10.70,9.80,10.20,-0.50,-4.67,259000,156,2637000,0,2000,-2000,0,0,0,6000,0,6000,4000
20200312,4128,中天,15.00,15.00,13.65,14.10,-1.00,-6.62,2202000,959,31303350,17000,20000,-3000,0,0,0,35000,31000,4000,1000
20200312,4129,聯合,36.50,36.55,34.50,34.55,-1.95,-5.34,355000,239,12463350,6000,14000,-8000,0,0,0,0,0,0,-8000
20200312,4129A,聯合甲特,52.50,52.60,52.10,52.20,-0.40,-0.76,101000,52,5283800,0,0,0,0,0,0,0,0,0,0
20200312,4130,健亞,24.30,24.30,21.90,22.30,-2.00,-8.23,794000,328,18019200,2000,5000,-3000,0,0,0,4000,4000,0,-3000
20200312,4131,晶宇,5.63,5.63,5.63,5.63,-0.37,-6.17,3000,2,16890,0,0,0,0,0,0,0,0,0,0
20200312,4138,曜亞,47.35,47.35,45.95,46.05,-1.50,-3.15,111000,78,5153150,0,0,0,0,0,0,0,0,0,0
20200312,4139,馬光-KY,35.05,35.05,33.10,33.30,-1.80,-5.13,40000,36,1370400,0,0,0,0,0,0,0,0,0,0
20200312,4147,中裕,83.20,83.90,75.00,75.00,-5.20,-6.48,2445000,1784,192605100,116000,437000,-321000,0,0,0,0,0,0,-321000
20200312,4152,台微體,70.00,70.00,67.50,67.60,-7.40,-9.87,115000,97,7835500,0,0,0,0,0,0,0,0,0,0
20200312,4153,鈺緯,24.60,24.60,22.30,22.30,-2.30,-9.35,81000,69,1881200,2000,0,2000,0,0,0,0,0,0,2000
20200312,4154,康樂-KY,28.45,28.45,26.60,27.85,-0.65,-2.28,29000,26,792000,0,0,0,0,0,0,0,0,0,0
20200312,4157,太景*-KY,20.00,20.00,18.00,18.00,-2.00,-10.0,7471000,3147,138028500,406000,363000,43000,0,0,0,10000,800000,-790000,-747000
20200312,4160,創源,28.00,28.00,26.30,27.50,-1.00,-3.51,41000,35,1108850,0,0,0,0,0,0,0,0,0,0
20200312,4161,聿新科,33.40,33.40,31.65,31.75,-1.80,-5.37,288000,186,9233250,6000,27000,-21000,0,0,0,10000,0,10000,-11000
20200312,4162,智擎,55.30,55.50,50.50,50.50,-5.60,-9.98,1662000,1058,86359200,73000,126000,-53000,0,0,0,0,6000,-6000,-59000
20200312,4163,鐿鈦,118.00,118.00,108.00,110.00,-8.50,-7.17,494000,399,55609000,15000,69000,-54000,0,0,0,20000,0,20000,-34000
20200312,4167,展旺,26.90,26.90,24.55,24.60,-2.65,-9.72,7927000,3350,200935050,668000,209000,459000,0,0,0,296000,45000,251000,710000
20200312,4168,醣聯,18.50,18.50,17.40,17.70,-1.05,-5.6,228000,120,4049500,0,0,0,0,0,0,0,0,0,0
20200312,4171,瑞基,78.00,78.00,70.50,70.50,-7.80,-9.96,879000,628,63099100,0,24000,-24000,0,0,0,2000,0,2000,-22000
20200312,4173,久裕,21.75,21.85,19.85,19.95,-1.35,-6.34,2630000,1366,54756950,21000,61000,-40000,0,0,0,4000,4000,0,-40000
20200312,4174,浩鼎,99.00,102.50,96.50,97.20,0.00,0.0,766000,630,75439500,14000,70000,-56000,0,0,0,0,0,0,-56000
20200312,4175,杏一,71.10,71.50,69.00,69.80,-2.30,-3.19,181000,165,12716200,6000,17000,-11000,0,0,0,0,0,0,-11000
20200312,4183,福永生技,18.50,18.50,17.40,17.55,-1.75,-9.07,23000,21,407450,3000,0,3000,0,0,0,0,0,0,3000
20200312,4188,安克,18.90,18.90,17.50,17.50,-1.90,-9.79,159000,94,2812450,3000,0,3000,0,0,0,1000,0,1000,4000
20200312,4192,杏國,25.30,25.30,24.70,25.00,-0.80,-3.1,63000,49,1581350,0,0,0,0,0,0,0,0,0,0
20200312,4198,環瑞醫,4.18,4.18,4.06,4.06,-0.43,-9.58,63000,18,259990,0,0,0,0,0,0,0,0,0,0
20200312,4205,中華食,85.60,85.60,81.90,82.10,-4.00,-4.65,256000,204,21281200,0,6000,-6000,0,0,0,0,0,0,-6000
20200312,4207,環泰,9.23,9.23,8.85,8.99,-0.11,-1.21,247000,102,2213540,0,10000,-10000,0,0,0,0,3000,-3000,-13000
20200312,4303,信立,20.10,20.20,19.70,20.05,-0.30,-1.47,129000,48,2582600,3000,0,3000,0,0,0,1000,0,1000,4000
20200312,4304,勝昱,6.89,6.89,5.97,6.87,+0.24,3.62,15000,8,93470,0,0,0,0,0,0,0,0,0,0
20200312,4305,世坤,34.90,35.05,34.15,34.15,-0.80,-2.29,30000,28,1033050,0,0,0,0,0,0,0,0,0,0
20200312,4401,東隆興,35.90,36.10,33.55,33.95,-1.95,-5.43,361000,264,12379850,10000,34000,-24000,0,0,0,1000,1000,0,-24000
20200312,4402,福大,4.60,4.60,4.34,4.34,-0.48,-9.96,219000,93,961920,0,0,0,0,0,0,0,0,0,0
20200312,4406,新昕纖,8.72,9.78,8.55,8.55,-0.35,-3.93,79000,34,708200,0,0,0,0,0,0,0,0,0,0
20200312,4413,飛寶企業,13.80,13.85,13.10,13.85,0.00,0.0,8000,7,107350,0,0,0,0,0,0,0,0,0,0
20200312,4416,三圓,77.50,77.80,77.00,77.00,-2.10,-2.65,6000,6,463800,0,0,0,0,0,0,0,0,0,0
20200312,4417,金洲,31.35,31.35,30.80,31.00,-0.95,-2.97,243000,139,7548600,0,6000,-6000,0,0,0,0,0,0,-6000
20200312,4419,元勝,6.30,6.30,6.30,6.30,-0.61,-8.83,5000,1,31500,0,0,0,0,0,0,0,0,0,0
20200312,4420,光明,25.80,25.80,24.55,24.95,-1.25,-4.77,147000,84,3665650,6000,8000,-2000,0,0,0,0,2000,-2000,-4000
20200312,4429,聚紡,34.35,35.00,34.35,34.90,-0.60,-1.69,42000,36,1460550,2000,0,2000,0,0,0,0,0,0,2000
20200312,4430,耀億,30.40,30.45,28.00,28.05,-2.85,-9.22,264000,151,7563500,5000,2000,3000,0,0,0,3000,0,3000,6000
20200312,4432,銘旺實,15.20,15.20,14.40,14.75,-0.75,-4.84,104000,55,1537150,0,2000,-2000,0,0,0,1000,0,1000,-1000
20200312,4433,興采,28.95,29.00,27.30,27.60,-1.80,-6.12,240000,160,6654900,9000,35000,-26000,0,0,0,0,0,0,-26000
20200312,4502,健信,49.70,49.70,46.20,47.45,-2.15,-4.33,169000,88,7978600,1000,2000,-1000,0,0,0,0,0,0,-1000
20200312,4503,金雨,21.75,21.75,19.00,19.90,-1.00,-4.78,70000,59,1378300,1000,4000,-3000,0,0,0,0,0,0,-3000
20200312,4506,崇友,58.10,58.20,56.60,57.60,-1.20,-2.04,74000,70,4247400,30000,26000,4000,0,0,0,5000,0,5000,9000
20200312,4510,高鋒,9.25,9.27,8.80,8.80,-0.75,-7.85,166000,80,1506650,5000,5000,0,0,0,0,2000,0,2000,2000
20200312,4513,福裕,8.45,8.58,7.79,7.85,-0.77,-8.93,250000,64,2033000,0,14000,-14000,0,0,0,1000,1000,0,-14000
20200312,4523,永彰,23.75,24.30,23.10,23.10,-0.65,-2.74,128000,73,2995150,0,0,0,0,0,0,0,3000,-3000,-3000
20200312,4527,方土霖,23.10,23.10,22.60,22.60,-0.50,-2.16,91000,63,2073450,0,0,0,0,0,0,0,0,0,0
20200312,4528,江興鍛,40.95,40.95,38.30,39.75,-2.25,-5.36,230000,151,9102500,11000,10000,1000,0,0,0,2000,3000,-1000,0
20200312,4529,淳紳,11.65,11.65,10.75,10.75,-1.15,-9.66,418000,223,4573400,1000,1000,0,0,0,0,4000,3000,1000,1000
20200312,4530,宏易,10.30,10.30,10.00,10.05,-0.60,-5.63,52000,37,524800,0,0,0,0,0,0,0,0,0,0
20200312,4533,協易機,10.90,10.90,10.20,10.25,-0.75,-6.82,351000,113,3670250,0,0,0,0,0,0,6000,4000,2000,2000
20200312,4534,慶騰,7.12,7.12,6.41,6.55,-0.57,-8.01,277000,87,1795130,0,0,0,0,0,0,0,0,0,0
20200312,4535,至興,25.60,25.60,25.25,25.35,-0.55,-2.12,32000,18,814500,0,0,0,0,0,0,0,0,0,0
20200312,4538,大詠城,15.55,15.55,15.00,15.25,-0.60,-3.79,8000,8,121000,0,0,0,0,0,0,0,0,0,0
20200312,4541,晟田,20.00,20.00,19.10,19.70,-0.75,-3.67,298000,163,5836600,0,1000,-1000,0,0,0,2000,1000,1000,0
20200312,4542,科嶠,24.25,25.10,24.25,25.10,-0.90,-3.46,6000,6,148450,0,0,0,0,0,0,0,0,0,0
20200312,4543,萬在,16.00,16.45,15.85,16.45,-0.10,-0.6,4000,4,64300,0,0,0,0,0,0,0,0,0,0
20200312,4549,桓達,75.00,75.00,72.20,72.50,-4.40,-5.72,50000,45,3658300,0,20000,-20000,0,0,0,0,0,0,-20000
20200312,4550,長佳,27.65,28.00,26.60,27.90,-0.10,-0.36,317000,99,8753450,7000,13000,-6000,0,0,0,0,0,0,-6000
20200312,4554,橙的,18.55,18.60,18.00,18.40,-0.80,-4.17,38000,25,698050,1000,0,1000,0,0,0,3000,1000,2000,3000
20200312,4556,旭然,32.20,32.20,31.30,31.80,-0.50,-1.55,26000,17,819000,1000,0,1000,0,0,0,0,0,0,1000
20200312,4561,健椿,23.30,23.30,22.50,22.95,-0.70,-2.96,47000,37,1073600,1000,1000,0,0,0,0,0,0,0,0
20200312,4563,百德,44.70,44.70,40.85,41.70,-3.65,-8.05,127000,71,5284800,0,2000,-2000,0,0,0,3000,1000,2000,0
20200312,4568,科際精密,53.00,53.00,50.10,51.00,-3.10,-5.73,38000,33,1941100,0,0,0,0,0,0,0,0,0,0
20200312,4580,捷流閥業,88.00,88.00,83.20,85.10,-4.90,-5.44,144000,97,12264700,1000,2000,-1000,0,0,0,0,0,0,-1000
20200312,4609,唐鋒,10.00,10.00,9.50,9.55,-0.95,-9.05,63000,21,604340,0,0,0,0,0,0,0,0,0,0
20200312,4702,中美實,11.25,11.25,10.30,10.30,-1.10,-9.65,200000,49,2066650,0,0,0,0,0,0,0,0,0,0
20200312,4706,大恭,18.00,18.00,17.60,17.60,-0.40,-2.22,56000,49,992200,0,0,0,0,0,0,0,0,0,0
20200312,4707,磐亞,14.70,14.75,13.70,14.05,-0.55,-3.77,11326000,3935,159915450,251000,153000,98000,0,0,0,0,0,0,98000
20200312,4711,永純,13.10,13.15,12.45,13.15,-0.10,-0.75,21000,19,271200,0,0,0,0,0,0,0,0,0,0
20200312,4712,南璋,8.80,8.80,8.31,8.35,-0.45,-5.11,56000,41,478240,3000,4000,-1000,0,0,0,1000,0,1000,0
20200312,4714,永捷,14.25,14.25,13.05,13.05,-1.35,-9.38,1490000,657,20100950,101000,67000,34000,0,0,0,42000,7000,35000,69000
20200312,4716,大立,15.40,15.45,14.20,15.00,-0.60,-3.85,178000,103,2626950,0,0,0,0,0,0,0,0,0,0
20200312,4721,美琪瑪,48.70,48.95,44.55,44.55,-4.95,-10.0,1409000,795,63364050,132000,35000,97000,0,0,0,0,10000,-10000,87000
20200312,4726,永昕,21.70,21.70,19.55,19.80,-1.90,-8.76,515000,275,10403450,7000,2000,5000,0,0,0,0,0,0,5000
20200312,4728,雙美,60.40,61.00,58.80,60.00,-1.00,-1.64,515000,341,30751600,24000,90000,-66000,0,0,0,0,99000,-99000,-165000
20200312,4729,熒茂,9.75,9.75,9.10,9.40,-0.49,-4.95,79000,45,736800,0,3000,-3000,0,0,0,1000,0,1000,-2000
20200312,4735,豪展,56.60,59.90,53.90,55.00,-4.00,-6.78,2706000,1916,152408900,92000,209000,-117000,0,0,0,0,10000,-10000,-127000
20200312,4736,泰博,161.00,161.50,146.00,151.50,-10.00,-6.19,3177000,2388,482734500,396000,557203,-161203,0,0,0,139000,235000,-96000,-257203
20200312,4741,泓瀚,27.50,27.50,26.50,26.85,-1.15,-4.11,93000,39,2481750,2000,0,2000,0,0,0,0,0,0,2000
20200312,4743,合一,29.85,29.85,28.00,28.50,-1.35,-4.52,1161000,601,33265400,8000,66000,-58000,0,0,0,11000,60000,-49000,-107000
20200312,4744,皇將,35.20,35.20,31.80,33.70,-1.60,-4.53,789000,450,25967500,77000,34000,43000,0,0,0,27000,7000,20000,63000
20200312,4745,合富-KY,37.00,37.00,33.30,33.65,-3.35,-9.05,329000,191,11256050,5000,4000,1000,0,0,0,0,0,0,1000
20200312,4747,強生,42.70,42.85,40.20,40.80,-1.50,-3.55,81000,68,3337050,0,0,0,0,0,0,1000,0,1000,1000
20200312,4754,國碳科,52.00,52.00,49.70,49.70,-2.60,-4.97,55000,29,2777400,0,1000,-1000,0,0,0,0,0,0,-1000
20200312,4760,勤凱,58.10,58.20,53.20,53.20,-5.90,-9.98,405000,326,21861400,5000,4000,1000,0,0,0,0,0,0,1000
20200312,4767,誠泰科技,23.20,23.20,23.15,23.15,-0.95,-3.94,2000,2,46350,0,0,0,0,0,0,0,0,0,0
20200312,4803,VHQ-KY,87.90,88.90,83.80,84.90,-5.40,-5.98,782000,624,67100800,16000,72000,-56000,0,0,0,30000,157000,-127000,-183000
20200312,4804,大略-KY,9.03,9.28,8.29,8.29,-0.92,-9.99,73000,41,635330,5000,0,5000,0,0,0,2000,1000,1000,6000
20200312,4806,昇華,8.36,8.36,6.93,6.99,-0.71,-9.22,16000,13,115280,0,0,0,0,0,0,0,0,0,0
20200312,4903,聯光通,15.00,15.00,13.75,14.40,-0.85,-5.57,1188000,567,17136300,39000,41000,-2000,0,0,0,19000,0,19000,17000
20200312,4905,台聯電,52.20,52.20,49.30,49.30,-3.90,-7.33,10000,9,511300,0,0,0,0,0,0,0,0,0,0
20200312,4907,富宇,23.40,23.45,21.90,22.00,-2.10,-8.71,166000,95,3722600,7000,1000,6000,0,0,0,3000,1000,2000,8000
20200312,4908,前鼎,31.45,31.45,28.85,29.00,-2.50,-7.94,1668000,966,49086700,280000,104000,176000,0,0,0,4000,12000,-8000,168000
20200312,4909,新復興,15.80,15.80,15.05,15.10,-0.90,-5.62,406000,220,6266750,0,1000,-1000,0,0,0,0,0,0,-1000
20200312,4911,德英,29.05,29.05,27.70,29.00,-1.65,-5.38,22000,18,627850,0,0,0,0,0,0,0,0,0,0
20200312,4924,欣厚-KY,7.70,7.70,7.03,7.48,-0.22,-2.86,35000,6,264310,30000,1000,29000,0,0,0,0,0,0,29000
20200312,4931,新盛力,29.00,29.00,26.35,26.55,-2.70,-9.23,512000,328,13821950,12000,0,12000,0,0,0,0,0,0,12000
20200312,4933,友輝,22.10,22.10,20.00,20.00,-2.20,-9.91,893000,385,18052500,30000,25000,5000,0,0,0,3000,0,3000,8000
20200312,4939,亞電,12.70,12.70,11.45,11.45,-1.25,-9.84,1107000,462,12794100,27000,26000,1000,0,0,0,0,0,0,1000
20200312,4944,兆遠,16.70,17.30,15.25,15.75,-1.15,-6.8,2220000,737,34967800,148000,45000,103000,0,0,0,0,0,0,103000
20200312,4946,辣椒,24.50,24.50,22.50,22.50,-2.40,-9.64,139000,104,3179400,1000,2000,-1000,0,0,0,0,0,0,-1000
20200312,4947,昂寶-KY,222.00,222.50,221.50,222.00,-0.50,-0.22,461000,315,102368000,140000,80000,60000,0,0,0,0,2000,-2000,58000
20200312,4950,牧東,8.19,8.19,7.68,7.68,-0.68,-8.13,25000,13,199170,0,0,0,0,0,0,0,0,0,0
20200312,4953,緯軟,79.90,79.90,72.60,72.60,-8.00,-9.93,2185000,1613,160911700,63000,70000,-7000,0,268000,-268000,5000,14000,-9000,-284000
20200312,4966,譜瑞-KY,656.00,662.00,600.00,601.00,-65.00,-9.76,1974000,1737,1224717000,350000,117000,233000,132000,180000,-48000,44000,137000,-93000,92000
20200312,4971,IET-KY,46.00,46.00,42.85,42.90,-4.70,-9.87,936000,348,40345700,16000,24000,-8000,0,0,0,3000,580000,-577000,-585000
20200312,4972,湯石照明,30.30,30.30,29.20,29.40,-0.90,-2.97,280000,147,8283900,3000,0,3000,0,0,0,2000,0,2000,5000
20200312,4973,廣穎,28.55,28.95,26.35,26.50,-2.75,-9.4,3083000,1610,83919100,411000,232000,179000,0,0,0,0,15000,-15000,164000
20200312,4974,亞泰,51.90,51.90,49.10,49.70,-1.90,-3.68,1361000,920,68011400,36000,109000,-73000,0,0,0,10000,19000,-9000,-82000
20200312,4979,華星光,18.90,19.00,17.30,17.30,-1.90,-9.9,2222000,1100,39072400,105000,92000,13000,0,0,0,2000,2000,0,13000
20200312,4987,科誠,56.10,56.90,55.00,55.20,-1.80,-3.16,54000,36,3021500,0,0,0,0,0,0,0,0,0,0
20200312,4991,環宇-KY,58.30,58.60,53.80,54.50,-5.20,-8.71,1579000,913,87508000,220000,106000,114000,0,0,0,14000,76000,-62000,52000
20200312,4995,晶達,46.20,46.20,45.30,45.45,-0.75,-1.62,127000,62,5819950,0,0,0,0,0,0,0,0,0,0
20200312,5009,榮剛,16.30,16.30,15.80,15.95,-0.55,-3.33,1344000,483,21457650,26000,273000,-247000,0,0,0,0,70000,-70000,-317000
20200312,5011,久陽,,,,,,0.00,0,0,0,0,0,0,0,0,0,0,0,0,0
20200312,5013,強新,24.15,24.15,23.45,24.10,-0.05,-0.21,23000,10,550400,0,0,0,0,0,0,0,0,0,0
20200312,5014,建錩,7.90,7.90,7.25,7.32,-0.61,-7.69,527000,206,3916960,18000,50000,-32000,0,0,0,5000,0,5000,-27000
20200312,5015,華祺,33.80,34.50,31.25,32.85,-1.15,-3.38,89000,62,2922800,1000,0,1000,0,0,0,2000,1000,1000,2000
20200312,5016,松和,27.70,27.70,27.60,27.60,-0.55,-1.95,42000,19,1160900,0,3000,-3000,0,0,0,0,0,0,-3000
20200312,5102,富強,15.30,15.30,14.65,14.75,-0.35,-2.32,116000,40,1724450,0,0,0,0,0,0,0,0,0,0
20200312,5201,凱衛,30.50,30.50,28.65,29.45,-1.35,-4.38,88000,75,2590700,0,9000,-9000,0,0,0,1000,0,1000,-8000
20200312,5202,力新,12.95,12.95,12.95,12.95,0.00,0.0,1000,1,12950,0,0,0,0,0,0,0,0,0,0
20200312,5205,中茂,,,,,,0.00,0,0,0,0,0,0,0,0,0,0,0,0,0
20200312,5206,坤悅,15.10,15.30,14.60,14.60,-1.00,-6.41,692000,297,10303800,67000,43000,24000,0,0,0,14000,0,14000,38000
20200312,5209,新鼎,53.30,53.30,51.00,51.60,-2.30,-4.27,56000,53,2897900,1000,0,1000,0,0,0,1000,0,1000,2000
20200312,5210,寶碩,6.02,6.02,5.53,5.53,-0.61,-9.93,581000,152,3360010,17000,11000,6000,0,0,0,0,0,0,6000
20200312,5211,蒙恬,15.00,15.15,14.30,14.65,-0.55,-3.62,90000,34,1317450,0,0,0,0,0,0,0,0,0,0
20200312,5212,凌網,51.10,52.80,48.00,50.80,-1.00,-1.93,921000,405,46716300,17000,56000,-39000,0,0,0,2000,13000,-11000,-50000
20200312,5213,亞昕,15.60,15.60,14.55,14.85,-0.75,-4.81,723000,253,10736550,19000,0,19000,0,0,0,14000,0,14000,33000
20200312,5220,萬達光電,26.35,26.40,24.80,25.20,-1.40,-5.26,195000,111,4955550,1000,11000,-10000,0,0,0,0,0,0,-10000
20200312,5223,安力-KY,29.65,30.40,28.45,28.75,-2.85,-9.02,238000,139,6923500,7000,12000,-5000,0,0,0,3000,2000,1000,-4000
20200312,5227,立凱-KY,11.45,11.45,10.60,10.60,-1.15,-9.79,2560000,978,27653050,16000,27000,-11000,0,0,0,0,0,0,-11000
20200312,5230,雷笛克光學,23.10,23.10,22.00,22.00,-1.10,-4.76,87000,71,1941300,0,0,0,0,0,0,1000,0,1000,1000
20200312,5245,智晶,36.70,37.45,34.20,34.20,-3.80,-10.0,1278000,707,44599550,81000,7000,74000,0,0,0,0,8000,-8000,66000
20200312,5251,天鉞電,11.05,11.10,10.20,10.20,-1.10,-9.73,377000,125,3940700,1000,6000,-5000,0,0,0,0,0,0,-5000
20200312,5263,智崴,130.00,130.00,119.50,119.50,-13.00,-9.81,611000,418,73987500,20000,28000,-8000,0,0,0,3000,3000,0,-8000
20200312,5272,笙科,21.75,21.75,19.70,19.70,-2.15,-9.84,451000,263,9050050,8000,55000,-47000,0,0,0,5000,0,5000,-42000
20200312,5274,信驊,1075.00,1075.00,1005.00,1015.00,-55.00,-5.14,509000,476,522260000,134000,179000,-45000,37000,0,37000,18000,19000,-1000,-9000
20200312,5276,達輝-KY,9.34,9.34,9.10,9.10,-0.40,-4.21,11000,6,100790,0,0,0,0,0,0,0,0,0,0
20200312,5278,尚凡,129.00,129.00,123.00,124.50,-7.50,-5.68,166000,147,20729500,0,2000,-2000,0,0,0,6000,0,6000,4000
20200312,5281,大峽谷-KY,20.50,20.50,19.80,19.80,-1.20,-5.71,105000,61,2103100,7000,1000,6000,0,0,0,2000,0,2000,8000
20200312,5287,數字,211.50,211.50,200.00,200.00,-12.00,-5.66,51000,49,10363000,0,28000,-28000,0,0,0,0,9000,-9000,-37000
20200312,5289,宜鼎,165.00,165.50,154.50,157.00,-13.00,-7.65,2113000,1520,336606500,341000,226000,115000,0,55000,-55000,20000,28000,-8000,52000
20200312,5291,邑昇,23.00,23.00,21.40,21.65,-1.70,-7.28,349000,217,7682050,31000,45000,-14000,0,0,0,0,0,0,-14000
20200312,5299,杰力,99.10,99.10,91.30,92.10,-7.00,-7.06,682000,556,63939700,60000,66000,-6000,0,0,0,0,11000,-11000,-17000
20200312,5301,寶得利,9.52,9.60,8.82,9.11,-0.47,-4.91,173000,77,1559820,1000,8000,-7000,0,0,0,0,0,0,-7000
20200312,5302,太欣,6.20,6.42,5.89,6.04,-0.35,-5.48,1337000,384,8099630,34000,17000,17000,0,0,0,0,0,0,17000
20200312,5304,鼎創達,2.04,2.17,2.04,2.17,-0.03,-1.36,5000,4,10720,0,0,0,0,0,0,0,0,0,0
20200312,5306,桂盟,90.10,90.10,86.50,87.10,-3.30,-3.65,120000,104,10538600,1000,10000,-9000,0,20000,-20000,0,0,0,-29000
20200312,5309,系統電,15.50,15.95,14.90,14.90,-1.65,-9.97,5503000,1933,84068050,144000,284000,-140000,0,0,0,0,0,0,-140000
20200312,5310,天剛,15.00,15.00,14.40,14.65,-0.35,-2.33,67000,30,988200,0,0,0,0,0,0,0,0,0,0
20200312,5312,寶島科,63.20,63.20,62.00,62.10,-1.60,-2.51,57000,53,3566300,0,0,0,0,0,0,0,0,0,0
20200312,5314,世紀,5.88,5.88,5.30,5.79,-0.01,-0.17,15000,8,82410,0,0,0,0,0,0,0,0,0,0
20200312,5315,光聯,14.15,14.15,12.75,13.10,-1.05,-7.42,1692000,477,21918000,19000,34000,-15000,0,0,0,4000,0,4000,-11000
20200312,5321,友銓,24.50,24.50,22.05,22.45,-2.05,-8.37,63000,56,1422750,0,0,0,0,0,0,0,0,0,0
20200312,5324,士開,8.76,8.76,8.35,8.35,-0.42,-4.79,169000,81,1446000,0,0,0,0,0,0,0,17000,-17000,-17000
20200312,5328,華容,8.02,8.02,7.22,7.26,-0.76,-9.48,963000,406,7129120,82000,10000,72000,0,0,0,0,0,0,72000
20200312,5340,建榮,35.00,35.50,33.00,33.00,-3.50,-9.59,1470000,935,49845750,49000,76000,-27000,0,0,0,3000,291000,-288000,-315000
20200312,5344,立衛,8.20,8.20,7.12,7.25,-0.35,-4.61,196000,97,1443700,0,8000,-8000,0,0,0,0,0,0,-8000
20200312,5345,天揚,5.39,5.69,5.08,5.40,-0.23,-4.09,17000,11,90130,0,0,0,0,0,0,0,0,0,0
20200312,5347,世界,70.50,73.00,69.70,71.40,-0.40,-0.56,10700000,5335,758161400,6527639,4819000,1708639,126000,0,126000,555000,164000,391000,2225639
20200312,5348,系通,,,,,,0.00,0,0,0,0,0,0,0,0,0,0,0,0,0
20200312,5349,先豐,21.85,22.25,21.05,21.05,-2.30,-9.85,1878000,871,39933400,73000,6000,67000,0,0,0,42000,0,42000,109000
20200312,5351,鈺創,5.95,5.95,5.51,5.55,-0.45,-7.5,906000,404,5141260,4000,0,4000,0,0,0,0,0,0,4000
20200312,5353,台林,17.00,17.00,16.25,16.80,-0.55,-3.17,189000,97,3130550,0,2000,-2000,0,0,0,0,0,0,-2000
20200312,5355,佳總,4.42,4.45,4.26,4.28,-0.27,-5.93,373000,64,1606130,28000,0,28000,0,0,0,0,0,0,28000
20200312,5356,協益,27.45,27.75,24.90,25.55,-2.00,-7.26,788000,423,20257250,43000,30000,13000,0,0,0,3000,3000,0,13000
20200312,5364,力麗店,,,,,,0.00,0,0,0,0,0,0,0,0,0,0,0,0,0
20200312,5371,中光電,34.30,34.35,31.25,31.55,-2.65,-7.75,2730000,1760,88291250,70000,1461328,-1391328,0,0,0,38000,0,38000,-1353328
20200312,5381,合正,3.24,3.50,3.24,3.50,-0.10,-2.78,64000,15,220360,0,0,0,0,0,0,0,0,0,0
20200312,5383,金利,19.30,19.30,18.05,18.90,-1.15,-5.74,135000,60,2481250,0,0,0,0,0,0,0,0,0,0
20200312,5386,青雲,28.55,28.60,26.60,27.50,-1.70,-5.82,191000,130,5251700,1000,0,1000,0,0,0,4000,0,4000,5000
20200312,5392,應華,26.55,26.55,24.25,24.25,-2.65,-9.85,1336000,674,32999500,42000,58000,-16000,0,0,0,4000,4000,0,-16000
20200312,5398,慕康生醫,27.00,27.00,26.40,26.60,-0.40,-1.48,19000,12,506150,0,0,0,0,0,0,0,0,0,0
20200312,5403,中菲,45.50,45.50,43.65,43.65,-1.90,-4.17,509000,292,22536050,1000,5000,-4000,0,0,0,0,0,0,-4000
20200312,5410,國眾,18.50,18.50,17.60,17.70,-0.95,-5.09,629000,314,11232900,2000,20000,-18000,0,0,0,0,0,0,-18000
20200312,5425,台半,44.40,44.50,40.45,41.00,-3.85,-8.58,2939000,1802,123743200,225000,672000,-447000,0,0,0,96000,108000,-12000,-459000
20200312,5426,振發,10.75,10.75,10.50,10.60,-0.30,-2.75,433000,87,4592100,4000,0,4000,0,0,0,0,0,0,4000
20200312,5432,達威,16.55,16.55,15.40,15.70,-1.15,-6.82,113000,59,1773900,0,0,0,0,0,0,0,0,0,0
20200312,5438,東友,14.20,14.25,13.85,14.05,-0.15,-1.06,653000,342,9226650,0,6000,-6000,0,0,0,0,0,0,-6000
20200312,5439,高技,37.80,38.50,36.15,36.15,-2.35,-6.1,612000,358,22477200,23000,137000,-114000,0,0,0,0,0,0,-114000
20200312,5443,均豪,15.90,15.90,14.85,14.95,-1.05,-6.56,1370000,484,20915450,88000,57000,31000,0,0,0,0,8000,-8000,23000
20200312,5450,寶聯通,15.10,15.15,14.70,15.00,-0.50,-3.23,262000,86,3908400,0,2000,-2000,0,0,0,3000,0,3000,1000
20200312,5452,佶優,5.99,5.99,5.62,5.62,-0.33,-5.55,283000,108,1621050,0,10000,-10000,0,0,0,0,0,0,-10000
20200312,5455,昇益,,,,,,0.00,0,0,0,0,0,0,0,0,0,0,0,0,0
20200312,5457,宣德,76.40,76.50,70.00,72.00,-5.50,-7.1,4461000,2947,323426400,157000,470000,-313000,0,0,0,28000,466000,-438000,-751000
20200312,5460,同協,11.35,11.55,11.25,11.30,-0.30,-2.59,234000,64,2653050,0,0,0,0,0,0,0,0,0,0
20200312,5464,霖宏,12.40,12.60,12.30,12.35,-0.25,-1.98,159000,51,1980350,0,11000,-11000,0,0,0,0,0,0,-11000
20200312,5465,富驊,10.65,10.80,10.30,10.40,-0.45,-4.15,151000,61,1573700,0,0,0,0,0,0,4000,3000,1000,1000
20200312,5468,凱鈺,13.80,13.80,11.70,13.25,+0.40,3.11,12000,9,149200,0,0,0,0,0,0,0,0,0,0
20200312,5474,聰泰,66.70,66.70,60.90,61.10,-6.50,-9.62,395000,294,24473000,4000,36000,-32000,0,0,0,1000,14000,-13000,-45000
20200312,5475,德宏,2.81,2.81,2.55,2.75,-0.08,-2.83,209000,49,556010,0,0,0,0,0,0,0,0,0,0
20200312,5478,智冠,76.80,78.80,72.10,73.20,-4.70,-6.03,444000,369,32951300,106000,81000,25000,0,0,0,9000,1000,8000,33000
20200312,5481,新華,11.75,11.75,10.90,11.70,-0.40,-3.31,723000,261,8045150,5000,3000,2000,0,0,0,3000,10000,-7000,-5000
20200312,5483,中美晶,98.00,98.00,90.80,94.00,-4.50,-4.57,16078000,8664,1514336200,1606541,1384000,222541,0,355000,-355000,411000,1405000,-994000,-1126459
20200312,5487,通泰,34.80,34.80,33.80,34.05,-1.15,-3.27,93000,54,3163350,0,0,0,0,0,0,0,0,0,0
20200312,5488,松普,4.98,4.98,4.52,4.55,-0.45,-9.0,687000,143,3206480,3000,0,3000,0,0,0,0,0,0,3000
20200312,5489,彩富,31.75,31.95,31.40,31.40,-0.80,-2.48,149000,85,4718400,0,0,0,0,0,0,0,0,0,0
20200312,5490,同亨,27.50,27.50,25.10,25.30,-2.20,-8.0,566000,226,14636650,23000,21000,2000,0,0,0,55000,43000,12000,14000
20200312,5493,三聯,39.30,39.30,36.60,37.55,-1.75,-4.45,311000,185,11676800,34000,9000,25000,0,0,0,0,4000,-4000,21000
20200312,5498,凱崴,9.90,9.90,9.07,9.07,-0.79,-8.01,1209000,355,11428520,48000,46000,2000,0,0,0,0,0,0,2000
20200312,5508,永信建,31.80,31.80,30.70,30.85,-0.95,-2.99,267000,144,8252100,4000,24000,-20000,0,0,0,0,0,0,-20000
20200312,5511,德昌,29.10,29.50,28.90,29.25,-0.30,-1.02,266000,114,7760500,1000,13000,-12000,0,0,0,0,0,0,-12000
20200312,5512,力麒,9.03,9.05,8.82,8.85,-0.27,-2.96,2003000,462,17853680,21000,114000,-93000,0,0,0,0,0,0,-93000
20200312,5514,三豐,17.80,18.35,17.80,18.35,-0.95,-4.92,14000,10,252200,0,0,0,0,0,0,0,0,0,0
20200312,5516,雙喜,13.30,13.95,13.30,13.95,-0.40,-2.79,9000,9,122400,1000,0,1000,0,0,0,0,0,0,1000
20200312,5520,力泰,30.80,30.80,30.25,30.25,-1.05,-3.35,3000,3,91350,0,0,0,0,0,0,0,0,0,0
20200312,5523,豐謙,10.90,10.90,10.25,10.30,-0.85,-7.62,301000,81,3141900,0,7000,-7000,0,0,0,2000,0,2000,-5000
20200312,5529,志嘉,8.51,8.51,7.58,7.79,-0.63,-7.48,1476000,328,11388990,16000,20000,-4000,0,0,0,21000,0,21000,17000
20200312,5530,龍巖,59.10,59.10,56.00,56.40,-2.90,-4.89,632000,412,36020200,20000,45000,-25000,0,0,0,0,0,0,-25000
20200312,5536,聖暉,187.00,187.00,181.50,185.00,-3.00,-1.6,1000000,827,184301500,58000,56000,2000,0,0,0,2000,15000,-13000,-11000
20200312,5543,崇佑-KY,19.50,19.70,19.50,19.70,+0.20,1.03,10000,9,196150,0,0,0,0,0,0,0,0,0,0
20200312,5601,台聯櫃,,,,,,0.00,0,0,0,0,0,0,0,0,0,0,0,0,0
20200312,5603,陸海,10.60,10.70,10.00,10.70,-0.10,-0.93,36000,18,373000,0,0,0,0,0,0,1000,0,1000,1000
20200312,5604,中連貨,44.00,44.00,43.30,43.30,-1.65,-3.67,105000,56,4573250,0,0,0,0,0,0,0,9000,-9000,-9000
20200312,5609,中菲行,25.45,25.45,24.80,24.80,-0.85,-3.31,696000,406,17367300,1000,122000,-121000,0,0,0,0,3000,-3000,-124000
20200312,5701,劍湖山,1.36,1.49,1.31,1.47,+0.02,1.38,318000,55,424200,0,0,0,0,0,0,0,0,0,0
20200312,5703,亞都,23.65,23.70,22.20,22.95,-0.75,-3.16,15000,9,353200,0,0,0,0,0,0,0,0,0,0
20200312,5704,老爺知,,,,,,0.00,0,0,0,0,0,0,0,0,0,0,0,0,0
20200312,5820,日盛金,9.65,9.68,9.20,9.31,-0.39,-4.02,5039000,1754,47475660,136000,1340000,-1204000,0,0,0,0,0,0,-1204000
20200312,5864,致和證,8.65,8.65,8.46,8.46,-0.25,-2.87,57000,41,486940,0,0,0,0,0,0,0,0,0,0
20200312,5878,台名,46.50,46.50,45.30,46.00,-0.50,-1.08,18000,14,821400,0,0,0,0,0,0,0,0,0,0
20200312,5902,德記,9.88,9.88,9.60,9.72,-0.20,-2.02,20000,9,194630,0,1000,-1000,0,0,0,0,0,0,-1000
20200312,5903,全家,216.00,216.00,208.00,208.00,-8.50,-3.93,166000,123,35486000,5000,110000,-105000,0,0,0,1000,0,1000,-104000
20200312,5904,寶雅,469.00,470.50,453.50,453.50,-16.50,-3.51,294000,278,135407500,171000,208200,-37200,30000,0,30000,3000,1000,2000,-5200
20200312,5905,南仁湖,8.70,8.75,8.06,8.36,-0.37,-4.24,1395000,503,11525010,149000,190000,-41000,0,0,0,54000,54000,0,-41000
20200312,6015,宏遠證,6.16,6.16,6.02,6.12,-0.04,-0.65,1558000,197,9432940,1000,1000,0,0,0,0,0,0,0,0
20200312,6016,康和證,6.73,6.78,6.62,6.65,-0.20,-2.92,1113000,246,7446880,64000,170000,-106000,0,0,0,0,0,0,-106000
20200312,6020,大展證,12.50,12.50,12.40,12.50,0.00,0.0,58000,12,720900,0,0,0,0,0,0,0,0,0,0
20200312,6021,大慶證,14.20,14.40,13.80,14.00,-0.20,-1.41,384000,126,5414750,0,2000,-2000,0,0,0,0,0,0,-2000
20200312,6023,元大期,50.70,50.70,49.05,49.85,-0.85,-1.68,450000,240,22451850,15000,0,15000,0,0,0,0,0,0,15000
20200312,6026,福邦證,8.40,8.40,7.90,8.00,-0.48,-5.66,885000,226,7177600,8000,54000,-46000,0,0,0,0,0,0,-46000
20200312,6101,寬魚國際,27.35,28.60,26.00,28.55,-0.15,-0.52,209000,86,5549850,2000,2000,0,0,0,0,0,0,0,0
20200312,6103,合邦,,,,,,0.00,0,0,0,0,0,0,0,0,0,0,0,0,0
20200312,6104,創惟,31.35,31.35,29.80,30.25,-1.35,-4.27,1129000,631,34197650,37000,239000,-202000,0,0,0,0,7000,-7000,-209000
20200312,6109,亞元,9.85,10.00,9.70,10.00,-0.55,-5.21,120000,38,1178960,4000,0,4000,0,0,0,3000,3000,0,4000
20200312,6111,大宇資,78.80,78.80,72.00,72.00,-8.00,-10.0,1176000,748,86280600,107000,28000,79000,0,0,0,0,7000,-7000,72000
20200312,6113,亞矽,5.31,5.31,5.00,5.16,-0.34,-6.18,127000,43,640890,0,0,0,0,0,0,0,0,0,0
20200312,6114,久威,25.10,25.55,24.35,24.40,-1.40,-5.43,116000,81,2869850,0,0,0,0,0,0,0,1000,-1000,-1000
20200312,6118,建達,8.80,8.80,8.05,8.20,-0.68,-7.66,373000,137,3121810,7000,6000,1000,0,0,0,0,0,0,1000
20200312,6121,新普,281.50,284.00,276.00,276.00,-11.50,-4.0,2221000,1859,620482500,781000,929579,-148579,75000,0,75000,4000,66000,-62000,-135579
20200312,6122,擎邦,14.80,15.35,13.95,14.60,+0.10,0.69,8122000,3747,119386250,117000,223000,-106000,0,0,0,0,0,0,-106000
20200312,6123,上奇,41.25,41.25,39.00,39.00,-2.00,-4.88,653000,360,25900450,7000,54000,-47000,0,0,0,4000,0,4000,-43000
20200312,6124,業強,32.70,33.50,30.60,31.15,-2.85,-8.38,173000,80,5355500,62000,17000,45000,0,0,0,3000,0,3000,48000
20200312,6125,廣運,15.70,15.80,14.80,15.15,-0.80,-5.02,5297000,1866,80897350,279000,615000,-336000,0,0,0,0,0,0,-336000
20200312,6126,信音,12.20,12.35,11.80,12.20,0.00,0.0,1095000,366,13257600,14000,24000,-10000,0,0,0,0,0,0,-10000
20200312,6127,九豪,14.80,14.80,13.85,14.05,-1.05,-6.95,1547000,830,21988550,68000,161000,-93000,0,0,0,0,0,0,-93000
20200312,6129,普誠,6.60,6.60,6.01,6.01,-0.50,-7.68,1392000,399,8579540,12000,23000,-11000,0,0,0,0,0,0,-11000
20200312,6130,星寶國際,25.00,25.20,23.65,25.00,-1.25,-4.76,18000,12,439550,0,4000,-4000,0,0,0,0,0,0,-4000
20200312,6134,萬旭,7.07,7.07,6.65,6.89,-0.26,-3.64,219000,58,1491550,7000,5000,2000,0,0,0,0,0,0,2000
20200312,6138,茂達,71.80,72.30,66.00,66.80,-4.70,-6.57,1615000,1134,110023400,44000,253000,-209000,0,0,0,9000,123000,-114000,-323000
20200312,6140,訊達,10.20,10.20,10.00,10.00,-0.20,-1.96,13000,10,130450,0,0,0,0,0,0,0,0,0,0
20200312,6143,振曜,33.95,33.95,31.70,31.70,-2.35,-6.9,541000,313,17474250,7000,101000,-94000,0,0,0,0,0,0,-94000
20200312,6144,得利影,,,,,,0.00,0,0,0,0,0,0,0,0,0,0,0,0,0
20200312,6146,耕興,188.00,194.00,177.50,178.00,-12.00,-6.32,574000,437,105966500,422000,270311,151689,0,25000,-25000,0,0,0,126689
20200312,6147,頎邦,57.20,57.30,54.00,54.70,-2.80,-4.87,7240000,3792,399639300,1130000,951000,179000,0,60000,-60000,83000,597000,-514000,-395000
20200312,6148,驊宏資,9.67,9.67,8.89,8.94,-0.93,-9.42,684000,278,6224790,5000,9000,-4000,0,0,0,5000,0,5000,1000
20200312,6150,撼訊,51.70,51.80,47.25,47.30,-5.20,-9.9,1055000,758,50848350,45000,38000,7000,0,0,0,0,0,0,7000
20200312,6151,晉倫,17.25,17.65,17.25,17.50,-0.75,-4.11,141000,75,2466800,3000,0,3000,0,0,0,0,0,0,3000
20200312,6154,順發,13.05,13.05,12.60,12.60,-0.45,-3.45,64000,51,819000,0,1000,-1000,0,0,0,0,0,0,-1000
20200312,6156,松上,11.50,11.50,10.50,10.75,-0.90,-7.73,504000,171,5438050,6000,3000,3000,0,0,0,3000,3000,0,3000
20200312,6158,禾昌,22.30,22.30,20.30,20.30,-2.25,-9.98,323000,186,6766900,17000,9000,8000,0,0,0,6000,3000,3000,11000
20200312,6160,欣技,15.20,15.20,13.75,14.15,-1.10,-7.21,268000,96,3752700,0,0,0,0,0,0,2000,1000,1000,1000
20200312,6161,捷波,17.70,17.70,16.60,16.70,-1.05,-5.92,431000,136,7249100,0,4000,-4000,0,0,0,0,0,0,-4000
20200312,6163,華電網,13.95,13.95,13.40,13.45,-0.65,-4.61,496000,171,6755400,1000,31000,-30000,0,0,0,0,0,0,-30000
20200312,6167,久正,6.48,6.48,5.88,5.91,-0.62,-9.49,1152000,252,6885750,11000,35000,-24000,0,0,0,0,0,0,-24000
20200312,6169,昱泉,41.45,41.45,37.50,37.55,-4.10,-9.84,384000,288,14823600,2000,4000,-2000,0,0,0,0,0,0,-2000
20200312,6170,統振,15.00,15.00,13.85,13.90,-1.45,-9.45,2975000,942,41947650,326000,134000,192000,0,0,0,354000,992000,-638000,-446000
20200312,6171,亞銳士,17.15,17.15,15.65,15.75,-1.60,-9.22,331000,178,5278200,29000,4000,25000,0,0,0,6000,6000,0,25000
20200312,6173,信昌電,55.50,56.00,51.20,51.30,-5.40,-9.52,4628000,3149,245199100,606000,199000,407000,0,0,0,119000,253000,-134000,273000
20200312,6174,安碁,11.50,11.65,10.55,11.50,0.00,0.0,67000,52,735350,0,0,0,0,0,0,0,0,0,0
20200312,6175,立敦,18.60,18.60,16.75,16.75,-1.85,-9.95,416000,232,7146100,12000,7000,5000,0,0,0,5000,1000,4000,9000
20200312,6179,亞通,29.90,30.00,29.45,29.80,-0.25,-0.83,39000,30,1162800,0,0,0,0,0,0,0,0,0,0
20200312,6180,橘子,52.50,52.50,48.30,48.60,-4.50,-8.47,2770000,1804,138371300,120000,176000,-56000,0,0,0,0,16000,-16000,-72000
20200312,6182,合晶,32.00,32.10,29.45,30.20,-2.20,-6.79,12861000,6349,392838300,869000,2137000,-1268000,0,0,0,122000,437000,-315000,-1583000
20200312,6185,幃翔,14.50,14.50,13.05,13.10,-1.40,-9.66,2026000,840,27133150,92000,118000,-26000,0,0,0,20000,12000,8000,-18000
20200312,6186,新潤,25.90,25.90,23.45,23.80,-2.25,-8.64,1308000,590,31667800,87000,32000,55000,0,0,0,17000,9000,8000,63000
20200312,6187,萬潤,41.00,41.00,37.35,38.20,-3.25,-7.84,1495000,806,57175450,94000,92000,2000,0,0,0,0,145000,-145000,-143000
20200312,6188,廣明,29.05,29.15,26.65,26.95,-2.65,-8.95,4094000,2485,111835500,262000,405000,-143000,0,0,0,35000,147000,-112000,-255000
20200312,6190,萬泰科,16.50,16.50,15.60,15.65,-0.85,-5.15,821000,313,13045250,13000,118000,-105000,0,0,0,0,0,0,-105000
20200312,6194,育富,23.50,23.90,23.00,23.35,-0.75,-3.11,212000,88,4910450,0,8000,-8000,0,0,0,0,0,0,-8000
20200312,6195,詩肯,34.60,34.60,33.20,33.30,-1.65,-4.72,93000,75,3117400,1000,0,1000,0,0,0,0,0,0,1000
20200312,6198,凌泰,13.80,13.80,13.80,13.80,+1.25,9.96,1000,1,13800,0,0,0,0,0,0,0,0,0,0
20200312,6199,天品,,,,,,0.00,0,0,0,0,0,0,0,0,0,0,0,0,0
20200312,006201,元大富櫃50,13.00,13.00,12.07,12.17,-0.88,-6.74,234000,140,2871340,0,0,0,0,0,0,6000,125000,-119000,-119000
20200312,6203,海韻電,38.60,38.90,37.20,38.35,-1.15,-2.91,763000,535,28993450,36000,113000,-77000,0,0,0,1000,1000,0,-77000
20200312,6204,艾華,23.10,23.10,22.00,22.90,-0.80,-3.38,35000,23,788950,0,0,0,0,0,0,0,0,0,0
20200312,6207,雷科,21.80,21.80,20.50,21.00,-1.00,-4.55,653000,283,13609200,0,51000,-51000,0,0,0,2000,0,2000,-49000
20200312,6208,日揚,25.70,25.75,24.00,25.70,,0.00,1361000,628,34388050,24000,110000,-86000,0,0,0,4000,4000,0,-86000
20200312,6210,慶生,48.85,48.85,45.00,45.00,-5.00,-10.0,678000,461,31065900,58000,17000,41000,0,0,0,12000,29000,-17000,24000
20200312,6212,理銘,,,,,,0.00,0,0,0,0,0,0,0,0,0,0,0,0,0
20200312,6217,中探針,28.80,28.80,26.10,26.15,-2.80,-9.67,937000,523,24950950,63000,46000,17000,0,0,0,8000,3000,5000,22000
20200312,6218,豪勉,19.30,19.60,18.80,18.90,-0.50,-2.58,161000,96,3071150,0,2000,-2000,0,0,0,0,1000,-1000,-3000
20200312,6219,富旺,14.70,14.70,14.20,14.55,-0.25,-1.69,1326000,316,19145250,14000,181000,-167000,0,0,0,0,0,0,-167000
20200312,6220,岳豐,20.10,20.10,18.45,18.70,-1.40,-6.97,641000,300,12143350,12000,8000,4000,0,0,0,26000,15000,11000,15000
20200312,6221,晉泰,45.10,45.10,42.95,43.00,-2.60,-5.7,96000,63,4194200,0,6000,-6000,0,0,0,0,0,0,-6000
20200312,6222,上揚,,,,,,0.00,0,0,0,0,0,0,0,0,0,0,0,0,0
20200312,6223,旺矽,65.00,65.00,60.00,60.60,-5.40,-8.18,2555000,1620,157834500,398000,276000,122000,0,0,0,112000,144000,-32000,90000
20200312,6227,茂綸,19.50,19.80,18.35,18.70,-1.60,-7.88,201000,120,3789050,0,0,0,0,0,0,3000,1000,2000,2000
20200312,6228,全譜,6.65,6.66,6.36,6.36,-0.70,-9.92,167000,80,1076130,0,8000,-8000,0,0,0,0,0,0,-8000
20200312,6229,研通,11.95,12.00,11.35,12.00,-0.20,-1.64,172000,74,2021100,0,3000,-3000,0,0,0,2000,2000,0,-3000
20200312,6231,系微,57.40,58.00,56.90,56.90,-0.50,-0.87,1130000,484,64729000,47000,135000,-88000,0,0,0,0,0,0,-88000
20200312,6233,旺玖,10.25,10.25,9.41,9.41,-1.04,-9.95,1619000,659,15619660,143000,156000,-13000,0,0,0,25000,0,25000,12000
20200312,6234,高僑,25.50,25.50,23.10,23.50,-2.15,-8.38,1326000,703,31216050,127000,77000,50000,0,0,0,5000,5000,0,50000
20200312,6236,康呈,,,,,,0.00,0,0,0,0,0,0,0,0,0,0,0,0,0
20200312,6237,驊訊,14.40,14.50,13.20,13.20,-1.45,-9.9,329000,154,4470250,2000,0,2000,0,0,0,4000,3000,1000,3000
20200312,6238,勝麗,147.50,147.50,135.00,137.00,-13.00,-8.67,1677000,1148,230928500,548496,45000,503496,0,313000,-313000,18000,45000,-27000,163496
20200312,6240,松崗,14.50,14.50,13.90,13.90,-0.90,-6.08,79000,49,1123000,18000,2000,16000,0,0,0,1000,2000,-1000,15000
20200312,6241,易通展,10.75,11.10,10.55,10.90,-0.20,-1.8,22000,12,235650,0,0,0,0,0,0,0,0,0,0
20200312,6242,立康,37.40,37.40,34.55,34.60,-2.90,-7.73,13000,10,457350,0,0,0,0,0,0,0,0,0,0
20200312,6244,茂迪,6.20,6.20,5.64,5.67,-0.58,-9.28,3444000,993,19963980,123000,20000,103000,0,0,0,0,0,0,103000
20200312,6245,立端,52.20,52.40,47.55,47.75,-5.05,-9.56,2096000,1359,102607850,264000,76000,188000,0,330000,-330000,40000,17000,23000,-119000
20200312,6246,臺龍,8.98,9.14,8.31,8.80,-0.36,-3.93,69000,32,594500,0,0,0,0,0,0,0,0,0,0
20200312,6247,淇譽電,9.95,9.95,9.50,9.50,-0.06,-0.63,16000,13,155280,0,0,0,0,0,0,0,0,0,0
20200312,6248,沛波,27.55,27.55,26.60,26.60,-1.15,-4.14,49000,36,1309800,1000,0,1000,0,0,0,0,0,0,1000
20200312,6259,百徽,2.38,2.38,2.27,2.34,+0.06,2.63,6000,4,14130,0,0,0,0,0,0,0,0,0,0
20200312,6261,久元,47.55,47.95,45.00,45.90,-2.20,-4.57,1576000,1006,72589600,327000,133000,194000,0,0,0,11000,80000,-69000,125000
20200312,6263,普萊德,63.70,63.70,61.70,61.70,-2.10,-3.29,248000,189,15398500,0,18000,-18000,0,0,0,15000,0,15000,-3000
20200312,6264,富裔,5.81,5.89,5.40,5.67,-0.32,-5.34,468000,34,2541390,0,0,0,0,0,0,0,0,0,0
20200312,6265,方土昶,6.80,6.80,6.35,6.35,-0.45,-6.62,409000,148,2676900,0,0,0,0,0,0,0,0,0,0
20200312,6266,泰詠,19.75,19.80,19.00,19.00,-1.00,-5.0,740000,354,14292100,7000,51000,-44000,0,0,0,6000,0,6000,-38000
20200312,6270,倍微,14.30,14.45,14.10,14.25,-0.25,-1.72,321000,129,4550550,0,10000,-10000,0,0,0,0,0,0,-10000
20200312,6274,台燿,125.50,125.50,115.50,120.00,-8.00,-6.25,2781000,1856,333425000,704000,912000,-208000,25000,0,25000,48000,163000,-115000,-298000
20200312,6275,元山,15.35,15.35,14.55,14.60,-1.00,-6.41,574000,203,8550250,165000,32000,133000,0,0,0,6000,6000,0,133000
20200312,6276,安鈦克,14.20,14.90,13.40,13.50,-0.70,-4.93,418000,251,5818400,7000,17000,-10000,0,0,0,17000,3000,14000,4000
20200312,6279,胡連,73.60,73.60,69.40,70.00,-4.40,-5.91,778000,590,54962400,82000,129000,-47000,0,80000,-80000,4000,19000,-15000,-142000
20200312,6284,佳邦,29.30,29.30,26.70,26.70,-2.80,-9.49,1202000,692,33109950,109000,229000,-120000,0,0,0,12000,9000,3000,-117000
20200312,6287,元隆,1.35,1.38,1.35,1.38,-0.12,-8.0,49000,16,66580,0,0,0,0,0,0,0,0,0,0
20200312,6290,良維,55.40,55.60,50.50,50.70,-5.40,-9.63,4021000,1979,209352000,351000,175000,176000,0,0,0,4000,144000,-140000,36000
20200312,6291,沛亨,12.50,12.50,12.50,12.50,0.00,0.0,1000,1,12500,0,0,0,0,0,0,0,0,0,0
20200312,6292,迅德,37.30,37.30,35.30,35.70,-2.15,-5.68,754000,560,27253050,15000,23000,-8000,0,0,0,4000,0,4000,-4000
20200312,6294,智基,99.00,99.50,98.00,98.10,-1.90,-1.9,121000,101,11924200,2000,34000,-32000,0,0,0,0,0,0,-32000
20200312,6404,通訊-KY,3.18,3.19,2.97,2.97,-0.33,-10.0,54000,18,162800,0,0,0,0,0,0,0,0,0,0
20200312,6411,晶焱,90.70,91.00,86.80,88.70,-2.80,-3.06,2496000,1773,220552400,356000,265000,91000,0,0,0,6000,123000,-117000,-26000
20200312,6417,韋僑,61.60,61.70,56.10,58.50,-3.30,-5.34,109000,44,6289900,0,5000,-5000,0,0,0,0,0,0,-5000
20200312,6418,詠昇,14.50,14.50,13.80,13.80,-1.00,-6.76,100000,49,1398900,0,1000,-1000,0,0,0,0,0,0,-1000
20200312,6419,京晨科,16.80,17.95,16.30,16.30,-1.50,-8.43,87000,63,1461650,0,0,0,0,0,0,5000,0,5000,5000
20200312,6425,易發,22.50,22.50,21.25,21.25,-2.15,-9.19,92000,54,1983800,0,0,0,0,0,0,0,0,0,0
20200312,6426,統新,121.00,123.50,113.50,113.50,-12.50,-9.92,1254000,990,146038000,47000,78000,-31000,0,0,0,0,5000,-5000,-36000
20200312,6432,今展科,28.10,28.55,27.10,27.15,-2.05,-7.02,478000,314,13245600,67000,30000,37000,0,0,0,0,0,0,37000
20200312,6435,大中,90.90,90.90,82.50,83.00,-8.20,-8.99,729000,585,62633800,22000,33000,-11000,0,0,0,1000,8000,-7000,-18000
20200312,6438,迅得,53.60,53.60,49.35,49.35,-5.45,-9.95,2476000,1457,123635250,453712,58000,395712,0,27000,-27000,3000,19000,-16000,352712
20200312,6441,廣錠,72.70,74.60,65.50,65.50,-7.20,-9.9,1808000,1168,123149300,65000,59000,6000,0,0,0,5000,0,5000,11000
20200312,6446,藥華藥,97.10,98.70,90.10,90.40,-8.70,-8.78,769000,514,71947600,23000,1000,22000,0,0,0,0,2000,-2000,20000
20200312,6457,紘康,56.00,56.00,49.05,49.90,-4.60,-8.44,1645000,902,83631700,3000,32000,-29000,0,0,0,15000,0,15000,-14000
20200312,6461,益得,17.40,17.40,16.95,17.10,-0.40,-2.29,599000,204,10240500,4000,0,4000,0,0,0,0,4000,-4000,0
20200312,6462,神盾,198.00,198.00,181.00,181.00,-20.00,-9.95,3368000,2639,623717000,258000,446000,-188000,0,301000,-301000,19000,70000,-51000,-540000
20200312,6465,威潤,44.00,44.70,43.00,44.60,-0.10,-0.22,70000,39,3095800,0,0,0,0,0,0,0,0,0,0
20200312,6469,大樹,83.50,83.60,81.50,82.50,-1.80,-2.14,290000,191,23878100,11000,11000,0,0,0,0,0,0,0,0
20200312,6470,宇智,40.90,40.90,37.35,37.90,-3.60,-8.67,809000,485,30567200,2000,63000,-61000,0,31000,-31000,2000,3000,-1000,-93000
20200312,6472,保瑞,162.00,164.00,154.00,157.50,-5.50,-3.37,1552000,1318,246365000,115000,101000,14000,0,0,0,23000,228000,-205000,-191000
20200312,6482,弘煜科,32.50,33.80,30.60,32.65,-1.35,-3.97,46000,35,1418900,5000,0,5000,0,0,0,1000,0,1000,6000
20200312,6485,點序,30.10,30.50,29.90,30.00,-0.80,-2.6,219000,131,6578400,2000,17000,-15000,0,0,0,0,0,0,-15000
20200312,6486,互動,69.00,69.00,66.50,66.50,-2.50,-3.62,779000,392,52324900,35000,170000,-135000,0,0,0,4000,1000,3000,-132000
20200312,6488,環球晶,369.50,374.00,339.50,368.00,-4.00,-1.08,11032000,8133,3949203000,1937738,1319751,617987,52000,175000,-123000,394000,608000,-214000,280987
20200312,6492,生華科,61.00,61.50,58.80,60.00,-2.10,-3.38,45000,42,2708000,0,1000,-1000,0,0,0,0,0,0,-1000
20200312,6494,九齊,31.70,31.70,29.75,30.20,-1.95,-6.07,714000,465,21675550,16000,10000,6000,0,0,0,0,0,0,6000
20200312,6496,科懋,34.20,34.20,31.85,32.20,-2.05,-5.99,167000,89,5466550,0,0,0,0,0,0,0,0,0,0
20200312,6497,亞獅康-KY,4.89,4.89,4.88,4.88,-0.54,-9.96,221000,42,1078680,0,0,0,0,0,0,0,0,0,0
20200312,6499,益安,53.20,53.20,48.70,48.70,-5.40,-9.98,175000,126,8830800,0,0,0,0,0,0,0,0,0,0
20200312,6506,雙邦,17.75,17.90,17.65,17.85,-0.05,-0.28,334000,134,5937850,0,6000,-6000,0,0,0,0,0,0,-6000
20200312,6508,惠光,30.00,30.00,28.85,28.95,-1.15,-3.82,318000,217,9284700,0,6000,-6000,0,0,0,0,0,0,-6000
20200312,6509,聚和,18.20,18.20,17.30,17.35,-0.95,-5.19,2113000,682,37230500,41000,73000,-32000,0,0,0,0,0,0,-32000
20200312,6510,精測,762.00,762.00,689.00,706.00,-59.00,-7.71,1465000,1385,1049742000,588000,304000,284000,5000,10000,-5000,6000,42000,-36000,243000
20200312,6512,啟發電,13.70,13.70,13.10,13.70,-0.30,-2.14,26000,20,350650,0,0,0,0,0,0,0,0,0,0
20200312,6514,芮特-KY,54.70,54.70,49.35,49.35,-5.45,-9.95,376000,276,18921450,22000,18000,4000,0,0,0,6000,0,6000,10000
20200312,6516,勤崴國際,98.00,98.00,94.50,94.50,-4.50,-4.55,60000,52,5744700,0,1000,-1000,0,0,0,0,0,0,-1000
20200312,6523,達爾膚,64.20,64.20,58.10,58.10,-6.40,-9.92,1242000,908,74351000,233000,293000,-60000,0,0,0,3000,1000,2000,-58000
20200312,6527,明達醫,58.00,58.00,54.10,54.50,-4.20,-7.16,121000,92,6750100,1000,2000,-1000,0,0,0,0,0,0,-1000
20200312,6530,創威,17.20,17.30,16.00,16.60,-1.05,-5.95,208000,106,3452100,1000,14000,-13000,0,0,0,3000,0,3000,-10000
20200312,6532,瑞耘,41.15,41.30,37.30,37.40,-4.00,-9.66,2262000,1237,86252950,225000,136000,89000,0,0,0,3000,2000,1000,90000
20200312,6535,順藥,30.95,30.95,29.05,29.10,-2.20,-7.03,300000,205,8864850,1000,0,1000,0,0,0,0,0,0,1000
20200312,6538,倉和,315.00,315.00,287.50,287.50,-31.50,-9.87,826000,631,241289000,44000,19000,25000,0,61000,-61000,0,15000,-15000,-51000
20200312,6542,隆中,52.50,52.50,47.90,49.30,-3.70,-6.98,58000,33,2897150,0,0,0,0,0,0,0,0,0,0
20200312,6547,高端疫苗,47.00,47.00,42.30,42.45,-4.50,-9.58,4251000,2557,184711950,4000,1000,3000,0,50000,-50000,0,0,0,-47000
20200312,6548,長科*,26.30,26.30,24.15,26.00,-0.80,-2.99,866000,436,21697250,12000,231000,-219000,0,0,0,3000,19000,-16000,-235000
20200312,6556,勝品,47.00,48.95,47.00,48.95,-0.50,-1.01,6000,6,291150,0,0,0,0,0,0,0,0,0,0
20200312,6560,欣普羅,32.90,33.95,29.80,30.70,-2.05,-6.26,319000,201,10540100,0,8000,-8000,0,0,0,1000,0,1000,-7000
20200312,6561,是方,253.50,260.00,241.00,246.50,-10.00,-3.9,517000,466,130209000,26000,12000,14000,0,0,0,20000,0,20000,34000
20200312,6568,宏觀,124.50,124.50,114.00,114.50,-12.00,-9.49,225000,184,26155500,4000,25000,-21000,0,22000,-22000,3000,0,3000,-40000
20200312,6569,醫揚,168.00,168.00,157.50,163.00,-5.00,-2.98,90000,86,14546000,7000,2000,5000,0,0,0,2000,0,2000,7000
20200312,6570,維田,34.20,34.90,33.00,33.30,-1.70,-4.86,59000,37,1986900,7000,7000,0,0,0,0,0,0,0,0
20200312,6574,霈方,,,,,,0.00,0,0,0,0,0,0,0,0,0,0,0,0,0
20200312,6576,逸達,51.10,52.50,49.10,50.00,-4.00,-7.41,271000,213,13743700,1000,26000,-25000,0,0,0,0,0,0,-25000
20200312,6577,勁豐,64.40,64.40,61.00,61.50,-3.50,-5.38,59000,41,3673200,2000,3000,-1000,0,0,0,0,0,0,-1000
20200312,6578,達邦蛋白,21.70,21.70,20.85,20.85,-1.30,-5.87,91000,61,1925750,0,2000,-2000,0,0,0,0,0,0,-2000
20200312,6589,台康生技,37.40,37.95,33.50,33.65,-3.35,-9.05,3389000,1904,119594350,92000,41000,51000,0,0,0,0,0,0,51000
20200312,6590,普鴻,30.60,31.00,30.50,30.55,-0.55,-1.77,20000,16,614800,0,0,0,0,0,0,0,0,0,0
20200312,6593,台灣銘板,25.10,25.50,23.55,25.50,0.00,0.0,12000,11,294600,3000,0,3000,0,0,0,0,0,0,3000
20200312,6594,展匯科,19.60,19.60,18.50,18.50,-0.90,-4.64,12000,9,224250,0,0,0,0,0,0,0,0,0,0
20200312,6596,寬宏藝術,49.95,49.95,47.50,48.10,-1.90,-3.8,117000,94,5629050,8000,6000,2000,0,0,0,1000,0,1000,3000
20200312,6603,富強鑫,9.73,10.05,9.46,9.69,-0.30,-3.0,165000,79,1590940,0,2000,-2000,0,0,0,0,0,0,-2000
20200312,6609,瀧澤科,27.45,27.45,26.00,26.20,-1.10,-4.03,171000,117,4485550,2000,12000,-10000,0,0,0,0,0,0,-10000
20200312,6612,奈米醫材,77.80,77.80,71.10,72.40,-4.30,-5.61,506000,430,37494100,5000,52000,-47000,0,0,0,0,0,0,-47000
20200312,6613,朋億,149.00,149.50,146.00,147.50,-3.50,-2.32,133000,127,19590000,5000,18000,-13000,0,0,0,0,0,0,-13000
20200312,6615,慧智,64.60,64.60,62.60,63.30,-1.30,-2.01,52000,47,3288800,0,2000,-2000,0,0,0,0,0,0,-2000
20200312,6616,特昇-KY,33.30,33.75,33.00,33.75,-0.25,-0.74,5000,5,167300,0,0,0,0,0,0,0,0,0,0
20200312,6624,萬年清,41.10,41.10,40.35,40.35,-1.65,-3.93,43000,27,1747450,0,0,0,0,0,0,0,0,0,0
20200312,6629,泰金-KY,49.00,49.00,47.50,48.95,-0.95,-1.9,14000,8,680050,5000,0,5000,0,0,0,0,0,0,5000
20200312,6640,均華,38.00,38.00,37.40,37.40,-1.20,-3.11,8000,8,301800,0,0,0,0,0,0,0,0,0,0
20200312,6642,富致,34.80,34.80,33.45,33.70,-1.10,-3.16,164000,94,5558400,4000,4000,0,0,0,0,0,0,0,0
20200312,6643,M31,275.00,275.00,251.00,251.00,-27.50,-9.87,887000,740,226438000,40000,164000,-124000,0,39000,-39000,2000,66000,-64000,-227000
20200312,6649,台生材,30.05,31.20,29.05,29.15,-1.15,-3.8,31000,27,937700,0,0,0,0,0,0,0,0,0,0
20200312,6654,天正國際,44.60,45.75,43.50,44.50,-1.35,-2.94,61000,40,2710750,0,0,0,0,0,0,0,0,0,0
20200312,6662,樂斯科,33.30,33.30,30.85,31.70,-1.60,-4.8,55000,46,1740000,3000,0,3000,0,0,0,0,12687,-12687,-9687
20200312,6664,群翊,60.30,60.30,55.10,55.10,-6.00,-9.82,550000,366,31254900,7000,12000,-5000,0,0,0,0,0,0,-5000
20200312,6667,信紘科,71.90,71.90,67.00,69.50,-2.40,-3.34,1144000,909,79530700,54000,43000,11000,0,0,0,0,0,0,11000
20200312,6679,鈺太,148.00,148.00,138.00,138.00,-15.00,-9.8,1258000,836,177224000,43000,69000,-26000,0,56000,-56000,15000,118000,-103000,-185000
20200312,6680,鑫創電子,59.50,59.50,58.80,58.80,-2.10,-3.45,12000,9,710100,1000,0,1000,0,0,0,0,0,0,1000
20200312,6683,雍智科技,186.00,187.00,171.00,176.50,-7.00,-3.81,768000,684,135473000,12000,25000,-13000,0,0,0,18000,46000,-28000,-41000
20200312,6690,安碁資訊,120.00,120.00,111.50,114.00,-9.00,-7.32,327000,268,37654000,16000,2000,14000,0,0,0,0,0,0,14000
20200312,6697,東捷資訊,36.20,36.20,34.00,34.00,-2.40,-6.59,124000,95,4305900,5000,2000,3000,0,0,0,0,0,0,3000
20200312,6803,崑鼎,215.50,215.50,210.00,211.00,-5.50,-2.54,162000,155,34177500,3000,11000,-8000,0,0,0,0,0,0,-8000
20200312,7402,邑錡,30.10,30.90,29.50,30.90,-1.00,-3.13,14000,13,418250,0,0,0,0,0,0,0,0,0,0
20200312,8024,佑華,9.66,9.66,9.15,9.20,-0.66,-6.69,136000,40,1269430,0,0,0,0,0,0,0,0,0,0
20200312,8027,鈦昇,27.20,27.40,24.50,24.60,-2.60,-9.56,517000,292,12944050,1000,2000,-1000,0,0,0,4000,0,4000,3000
20200312,8032,光菱,23.30,23.55,22.85,23.20,-0.40,-1.69,13000,12,299400,0,0,0,0,0,0,0,0,0,0
20200312,8034,榮群,20.50,20.60,18.80,19.20,-1.30,-6.34,3354000,1821,65189300,170000,69000,101000,0,0,0,0,0,0,101000
20200312,8038,長園科,36.95,37.45,35.50,35.95,-1.55,-4.13,183000,141,6573200,6000,6000,0,0,0,0,0,0,0,0
20200312,8040,九暘,19.25,19.55,17.75,17.85,-1.85,-9.39,2451000,1162,45101600,76000,139000,-63000,0,0,0,0,0,0,-63000
20200312,8042,金山電,32.00,32.00,30.50,30.80,-1.20,-3.75,338000,157,10474550,9000,0,9000,0,0,0,0,0,0,9000
20200312,8043,蜜望實,25.20,25.50,23.25,23.25,-2.55,-9.88,980000,584,23222650,35000,52000,-17000,0,0,0,1000,23000,-22000,-39000
20200312,8044,網家,97.80,97.80,88.90,88.90,-9.80,-9.93,1677000,1380,152524500,56000,132000,-76000,0,0,0,11000,72000,-61000,-137000
20200312,8047,星雲,10.15,10.15,9.32,9.84,-0.51,-4.93,86000,55,830680,0,0,0,0,0,0,1000,5000,-4000,-4000
20200312,8048,德勝,33.20,33.20,31.00,31.20,-2.60,-7.69,306000,167,9747250,2000,2000,0,0,0,0,0,0,0,0
20200312,8049,晶采,19.20,19.20,18.15,18.30,-1.20,-6.15,829000,418,15486450,22000,122000,-100000,0,0,0,1000,1000,0,-100000
20200312,8050,廣積,42.60,42.60,41.20,41.55,-1.65,-3.82,440000,221,18459050,22000,57000,-35000,0,0,0,0,0,0,-35000
20200312,8054,安國,13.10,13.10,12.65,12.65,-0.70,-5.24,246000,68,3166200,0,0,0,0,0,0,0,0,0,0
20200312,8059,凱碩,15.55,15.60,14.20,14.20,-1.55,-9.84,900000,348,12918150,32000,47000,-15000,0,0,0,1000,0,1000,-14000
20200312,8064,東捷,15.00,15.05,14.15,14.50,-0.80,-5.23,1229000,551,17951350,39000,86000,-47000,0,0,0,0,0,0,-47000
20200312,8066,來思達,65.60,65.80,61.20,61.50,-1.60,-2.54,287000,223,18094500,4000,35000,-31000,0,0,0,1000,1000,0,-31000
20200312,8067,志旭,8.78,8.78,8.01,8.55,-0.29,-3.28,19000,14,157460,0,0,0,0,0,0,0,0,0,0
20200312,8068,全達,39.50,39.75,35.60,36.70,-2.80,-7.09,275000,158,10075300,10000,22000,-12000,0,0,0,1000,1000,0,-12000
20200312,8069,元太,27.80,27.85,26.00,26.15,-2.10,-7.43,7190000,3657,191956450,481000,775000,-294000,0,0,0,373000,213000,160000,-134000
20200312,8071,能率網通,12.40,12.50,11.70,11.70,-0.80,-6.4,424000,178,5111200,1000,1000,0,0,0,0,0,0,0,0
20200312,8074,鉅橡,17.05,17.05,16.60,16.65,-0.50,-2.92,245000,115,4105300,0,4000,-4000,0,0,0,0,0,0,-4000
20200312,8076,伍豐,29.30,29.30,26.80,28.00,-1.40,-4.76,1894000,869,53088400,153000,192000,-39000,0,0,0,2000,0,2000,-37000
20200312,8077,洛碁,13.30,13.30,13.30,13.30,0.00,0.0,3000,2,39900,0,0,0,0,0,0,0,0,0,0
20200312,8080,永利聯合,3.56,3.56,3.42,3.56,-0.09,-2.47,23000,13,81450,0,0,0,0,0,0,0,0,0,0
20200312,8083,瑞穎,147.00,147.00,144.00,145.00,-2.00,-1.36,87000,75,12602000,0,11000,-11000,0,0,0,0,0,0,-11000
20200312,8084,巨虹,25.60,25.60,23.40,23.85,-2.15,-8.27,59000,44,1386250,0,0,0,0,0,0,1000,0,1000,1000
20200312,8085,福華,3.80,3.83,3.60,3.78,-0.07,-1.82,195000,65,722920,16000,0,16000,0,0,0,0,0,0,16000
20200312,8086,宏捷科,92.00,92.00,84.00,87.70,-4.70,-5.09,11378000,7752,993224500,539000,943000,-404000,0,300000,-300000,29000,503000,-474000,-1178000
20200312,8087,華鎂鑫,6.93,6.93,6.57,6.90,-0.22,-3.09,14000,7,93390,0,0,0,0,0,0,0,0,0,0
20200312,8088,品安,29.50,29.50,26.55,26.60,-2.90,-9.83,6419000,3565,176399150,404000,360000,44000,0,0,0,0,1000,-1000,43000
20200312,8091,翔名,59.00,59.00,55.00,55.80,-3.60,-6.06,230000,171,12958300,1000,46000,-45000,0,0,0,0,0,0,-45000
20200312,8092,建暐,6.88,7.01,6.50,6.54,-0.48,-6.84,95000,35,626630,0,0,0,0,0,0,0,0,0,0
20200312,8093,保銳,5.19,5.32,4.81,4.81,-0.53,-9.93,213000,94,1064550,6000,0,6000,0,0,0,0,0,0,6000
20200312,8096,擎亞,10.20,10.45,9.77,9.83,-0.62,-5.93,1468000,578,14666030,57000,34000,23000,0,0,0,17000,0,17000,40000
20200312,8097,常珵,13.50,13.50,12.85,13.00,-0.85,-6.14,60000,39,785100,0,0,0,0,0,0,1000,0,1000,1000
20200312,8099,大世科,16.55,16.70,15.90,16.10,-0.65,-3.88,133000,104,2148850,1000,11000,-10000,0,0,0,0,0,0,-10000
20200312,8107,大億金茂,18.70,18.75,17.75,17.95,-1.75,-8.88,375000,156,6779750,0,0,0,0,0,0,2000,0,2000,2000
20200312,8109,博大,66.60,66.60,63.80,64.40,-2.40,-3.59,362000,206,23500100,5000,68700,-63700,0,0,0,0,0,0,-63700
20200312,8111,立碁,7.57,7.60,7.10,7.39,-0.36,-4.65,197000,82,1445050,0,1000,-1000,0,0,0,2000,0,2000,1000
20200312,8121,越峰,10.65,10.65,9.90,10.05,-0.60,-5.63,487000,217,4902700,0,22000,-22000,0,0,0,14000,0,14000,-8000
20200312,8147,正淩,28.50,28.90,28.35,28.50,-1.40,-4.68,21000,20,598750,0,0,0,0,0,0,0,0,0,0
20200312,8155,博智,147.00,147.00,135.00,137.00,-11.00,-7.43,5269000,3911,736483500,311000,369000,-58000,160000,0,160000,47000,256000,-209000,-107000
20200312,8171,天宇,13.45,13.70,12.15,12.15,-1.25,-9.33,2213000,1027,28524950,4000,18000,-14000,0,0,0,10000,2000,8000,-6000
20200312,8176,智捷,9.45,9.45,8.65,8.82,-0.68,-7.16,564000,214,5039360,19000,2000,17000,0,0,0,20000,0,20000,37000
20200312,8182,加高,27.15,27.50,25.00,25.45,-1.85,-6.78,2256000,1232,58320850,95000,178000,-83000,0,0,0,17000,34000,-17000,-100000
20200312,8183,精星,15.40,15.40,14.05,14.40,-1.15,-7.4,1682000,779,24399850,309000,120000,189000,0,0,0,1000,1000,0,189000
20200312,8234,新漢,23.05,23.05,22.05,22.05,-1.35,-5.77,293000,123,6547650,8000,4000,4000,0,0,0,1000,0,1000,5000
20200312,8240,華宏,23.30,23.30,21.30,21.80,-1.50,-6.44,299000,154,6565850,3000,3000,0,0,0,0,0,0,0,0
20200312,8255,朋程,93.30,94.50,88.90,89.70,-6.70,-6.95,1501000,795,136240000,50000,58000,-8000,0,0,0,0,0,0,-8000
20200312,8277,商丞,6.38,6.38,5.95,5.95,-0.56,-8.6,277000,104,1674230,23000,0,23000,0,0,0,0,0,0,23000
20200312,8279,生展,110.00,110.00,99.00,100.00,-10.00,-9.09,259000,211,26324100,1000,3000,-2000,0,37000,-37000,4000,0,4000,-35000
20200312,8287,英格爾,2.83,2.83,2.70,2.72,-0.28,-9.33,378000,79,1024510,0,0,0,0,0,0,0,0,0,0
20200312,8289,泰藝,11.30,11.55,10.55,10.60,-0.85,-7.42,930000,351,10210900,17000,46000,-29000,0,0,0,71000,29000,42000,13000
20200312,8291,尚茂,2.70,2.70,2.70,2.70,-0.26,-8.78,1000,1,2700,0,0,0,0,0,0,0,0,0,0
20200312,8299,群聯,306.50,306.50,280.50,281.00,-30.50,-9.79,7103000,5645,2043434000,939925,786420,153505,20000,408000,-388000,172000,967000,-795000,-1029495
20200312,8342,益張,45.60,45.60,45.00,45.50,-0.70,-1.52,7000,5,316700,0,1000,-1000,0,0,0,0,0,0,-1000
20200312,8349,恒耀,55.00,55.00,50.00,50.00,-5.40,-9.75,213000,156,10923800,11000,1000,10000,0,0,0,5000,0,5000,15000
20200312,8349A,恒耀甲特,48.85,48.85,47.85,48.00,-0.90,-1.84,195000,90,9397000,0,0,0,0,0,0,0,0,0,0
20200312,8354,冠好,18.00,18.00,17.50,17.80,-0.20,-1.11,32000,23,566850,0,1000,-1000,0,0,0,0,0,0,-1000
20200312,8358,金居,37.30,37.65,34.25,34.30,-3.75,-9.86,10236000,4864,358696550,414000,805000,-391000,0,0,0,48000,249000,-201000,-592000
20200312,8383,千附,33.70,33.70,32.30,32.65,-1.05,-3.12,601000,383,19701500,9000,108100,-99100,0,0,0,0,0,0,-99100
20200312,8390,金益鼎,17.05,17.05,15.50,15.90,-1.30,-7.56,784000,362,12470750,1000,0,1000,0,0,0,10000,0,10000,11000
20200312,8401,白紗科,10.95,10.95,10.70,10.70,-0.25,-2.28,57000,33,617700,0,0,0,0,0,0,0,0,0,0
20200312,8403,盛弘,34.40,36.00,32.05,32.65,-2.35,-6.71,5014000,2868,168936200,292000,153000,139000,0,0,0,3000,57000,-54000,85000
20200312,8406,金可-KY,152.00,152.00,139.50,139.50,-14.00,-9.12,1500000,1243,214609500,183000,553000,-370000,0,6000,-6000,45000,12000,33000,-343000
20200312,8409,商之器,17.90,17.95,16.15,16.15,-1.75,-9.78,186000,128,3057000,12000,0,12000,0,0,0,1000,1000,0,12000
20200312,8410,森田,24.75,24.75,24.00,24.00,-0.90,-3.61,26000,18,628250,2000,0,2000,0,0,0,0,0,0,2000
20200312,8415,大國鋼,27.70,27.85,27.00,27.70,-0.25,-0.89,570000,222,15609300,106000,37000,69000,0,0,0,0,0,0,69000
20200312,8416,實威,116.00,116.00,114.00,114.00,-4.50,-3.8,68000,51,7794500,0,0,0,0,0,0,0,0,0,0
20200312,8418,捷必勝-KY,14.50,14.50,14.00,14.25,-0.10,-0.7,18000,7,258350,0,0,0,0,0,0,1000,0,1000,1000
20200312,8420,明揚,24.55,24.60,23.70,24.05,-1.15,-4.56,42000,29,1016100,0,0,0,0,0,0,1000,0,1000,1000
20200312,8421,旭源,9.80,9.80,9.31,9.72,0.00,0.0,93000,56,891010,0,1000,-1000,0,0,0,1000,1000,0,-1000
20200312,8423,保綠-KY,18.50,19.00,18.50,19.00,0.00,0.0,4000,2,75500,0,0,0,0,0,0,0,0,0,0
20200312,8424,惠普,52.00,52.00,50.90,51.40,-1.40,-2.65,101000,73,5161500,0,2000,-2000,0,0,0,0,0,0,-2000
20200312,8426,紅木-KY,17.55,17.55,16.95,17.25,-0.40,-2.27,46000,26,790100,0,0,0,0,0,0,0,1000,-1000,-1000
20200312,8431,匯鑽科,45.20,45.20,41.10,41.75,-3.90,-8.54,493000,297,20724700,16000,88000,-72000,0,0,0,4000,1000,3000,-69000
20200312,8432,東生華,78.10,78.10,74.20,74.50,-3.60,-4.61,23000,15,1735700,0,2000,-2000,0,0,0,0,0,0,-2000
20200312,8433,弘帆,48.80,48.80,44.25,44.25,-4.90,-9.97,121000,103,5481200,0,1000,-1000,0,0,0,0,0,0,-1000
20200312,8435,鉅邁,52.90,52.90,51.70,51.90,-0.70,-1.33,298000,154,15547100,43000,0,43000,0,0,0,0,0,0,43000
20200312,8436,大江,203.00,203.50,186.00,189.00,-16.50,-8.03,2945000,2239,569739500,261000,237000,24000,0,0,0,31000,154000,-123000,-99000
20200312,8437,大地-KY,211.00,211.00,200.00,201.00,-8.00,-3.83,110000,107,22271500,11000,56000,-45000,0,0,0,1000,0,1000,-44000
20200312,8440,綠電,13.60,13.60,13.25,13.25,-0.85,-6.03,138000,80,1850300,0,0,0,0,0,0,2000,0,2000,2000
20200312,8444,綠河-KY,59.40,59.80,57.50,57.90,-3.90,-6.31,38000,30,2219800,0,0,0,0,5000,-5000,0,0,0,-5000
20200312,8446,華研,106.00,106.00,99.70,100.00,-8.00,-7.41,324000,233,32899400,18000,60000,-42000,0,0,0,1000,1000,0,-42000
20200312,8450,霹靂,29.10,29.15,27.35,27.40,-2.65,-8.82,59000,49,1651550,0,0,0,0,0,0,0,0,0,0
20200312,8455,大拓-KY,22.15,22.15,20.65,21.45,-1.40,-6.13,16000,16,339650,0,0,0,0,0,0,0,0,0,0
20200312,8472,夠麻吉,26.80,26.85,25.40,25.70,-1.30,-4.81,15000,13,388900,0,0,0,0,0,0,0,0,0,0
20200312,8476,台境,25.10,25.35,23.60,23.80,-1.50,-5.93,219000,97,5262700,0,0,0,0,0,0,8000,0,8000,8000
20200312,8477,創業家,35.75,35.75,33.80,33.80,-2.00,-5.59,119000,82,4092400,0,1000,-1000,0,0,0,0,0,0,-1000
20200312,8489,三貝德,72.50,73.00,66.60,66.70,-7.30,-9.86,1050000,827,71522000,149000,42000,107000,0,101000,-101000,0,14000,-14000,-8000
20200312,8905,裕國,15.40,15.40,14.90,15.00,-0.40,-2.6,151000,82,2266100,0,0,0,0,0,0,0,0,0,0
20200312,8906,花王,15.00,15.00,14.50,14.50,-0.60,-3.97,51000,18,753150,0,11000,-11000,0,0,0,0,0,0,-11000
20200312,8908,欣雄,46.35,46.35,45.30,46.00,-0.35,-0.76,119000,68,5422200,0,5000,-5000,0,0,0,0,0,0,-5000
20200312,8916,光隆,42.80,42.80,41.30,41.55,-1.45,-3.37,471000,255,19657250,3000,27000,-24000,0,0,0,0,0,0,-24000
20200312,8916A,光隆甲特,53.60,53.60,53.20,53.50,-0.40,-0.74,85000,41,4542500,0,0,0,0,0,0,5000,6000,-1000,-1000
20200312,8917,欣泰,50.50,50.80,50.30,50.80,+0.30,0.59,3000,3,151600,0,0,0,0,0,0,0,0,0,0
20200312,8921,沈氏,,,,,,0.00,0,0,0,0,0,0,0,0,0,0,0,0,0
20200312,8923,時報,14.70,14.70,14.55,14.60,-0.15,-1.02,28000,14,408900,0,0,0,0,0,0,0,0,0,0
20200312,8924,大田,36.70,36.70,34.05,34.05,-3.75,-9.92,1227000,698,42394700,86000,124000,-38000,0,0,0,0,8000,-8000,-46000
20200312,8927,北基,14.60,14.60,14.60,14.60,-0.35,-2.34,22000,6,321200,0,0,0,0,0,0,0,0,0,0
20200312,8928,鉅明,29.00,29.00,26.15,26.15,-2.90,-9.98,899000,438,23872050,63000,44000,19000,0,0,0,0,0,0,19000
20200312,8929,富堡,23.85,23.85,22.05,22.35,-1.50,-6.29,67000,53,1528050,0,2000,-2000,0,0,0,1000,0,1000,-1000
20200312,8930,青鋼,11.95,11.95,11.30,11.55,-0.40,-3.35,94000,47,1088300,0,0,0,0,0,0,0,0,0,0
20200312,8931,大汽電,27.60,27.60,26.90,27.35,-0.25,-0.91,33000,30,896150,0,2000,-2000,0,0,0,0,0,0,-2000
20200312,8932,宏大,11.85,11.85,11.30,11.45,-0.65,-5.37,60000,29,692000,0,0,0,0,0,0,0,0,0,0
20200312,8933,愛地雅,5.56,5.56,5.22,5.23,-0.57,-9.83,235000,73,1256000,0,0,0,0,0,0,0,0,0,0
20200312,8934,衡平,,,,,,0.00,0,0,0,0,0,0,0,0,0,0,0,0,0
20200312,8935,邦泰,7.90,7.90,7.50,7.82,-0.24,-2.98,118000,41,908900,1000,3000,-2000,0,0,0,1000,1000,0,-2000
20200312,8936,國統,16.80,17.00,15.60,15.70,-1.60,-9.25,2137000,742,34490850,36000,82000,-46000,0,0,0,10000,0,10000,-36000
20200312,8937,合騏,13.95,14.10,13.85,13.85,-0.35,-2.46,64000,28,892700,0,0,0,0,0,0,0,0,0,0
20200312,8938,明安,35.85,35.85,34.00,34.15,-1.75,-4.87,403000,213,13903250,22000,38000,-16000,0,0,0,0,0,0,-16000
20200312,8941,關中,41.50,41.50,37.60,39.00,+0.30,0.78,23000,10,880500,0,0,0,0,0,0,0,0,0,0
20200312,8942,森鉅,60.00,60.00,58.50,59.70,-0.70,-1.16,701000,471,41607300,203000,86000,117000,0,0,0,0,0,0,117000
20200312,9949,琉園,12.85,12.90,12.30,12.55,-0.20,-1.57,66000,41,829150,0,0,0,0,0,0,0,0,0,0
20200312,9950,萬國通,12.60,12.65,11.50,11.80,-0.90,-7.09,25000,16,302050,0,0,0,0,0,0,1000,0,1000,1000
20200312,9951,皇田,70.00,70.00,66.00,66.20,-4.00,-5.7,687000,572,46414700,195000,45000,150000,0,47000,-47000,0,0,0,103000
20200312,9960,邁達康,28.50,28.50,27.30,28.10,-0.65,-2.26,19000,10,535550,0,0,0,0,0,0,0,0,0,0
20200312,9962,有益,9.22,9.22,8.71,8.75,-0.47,-5.1,64000,28,562670,0,0,0,0,0,0,1000,0,1000,1000
20200312,020001,富邦存股雙十N,4.90,4.90,4.70,4.71,-0.25,-5.04,1456000,183,6921830,0,0,0,0,0,0,373000,858000,-485000,-485000
20200312,020003,統一漲升股利150N,9.87,9.87,9.63,9.68,-0.45,-4.44,13000,4,126110,0,0,0,0,0,0,1000,12000,-11000,-11000
20200312,020009,群益A50綠碳N,,,,,,0.00,0,0,0,0,0,0,0,0,0,0,0,0,0
20200312,020010,永昌富櫃200N,9.77,9.77,9.11,9.18,-0.77,-7.74,12000,11,113410,0,0,0,0,0,0,0,8000,-8000,-8000
20200312,020013,元富亞洲高股息N,12.85,12.85,12.80,12.80,-0.67,-4.97,2000,2,25650,0,0,0,0,0,0,0,2000,-2000,-2000
20200312,020014,元大富櫃200N,4.50,4.50,4.20,4.24,-0.30,-6.61,419000,64,1836340,0,0,0,0,0,0,280000,329000,-49000,-49000
20200312,70005X,精華元大66展02,4.29,4.29,3.40,3.40,-1.56,-31.45,40000,11,148230,0,0,0,0,0,0,10000,30000,-20000,-20000
20200312,72102P,原相中信93售02,,,,,,0.00,0,0,0,0,0,0,0,0,0,0,0,0,0
20200312,72174P,同致中信93售01,,,,,,0.00,0,0,0,0,0,0,0,0,0,0,0,0,0
20200312,72259P,環球晶中信93售01,,,,,,0.00,0,0,0,0,0,0,0,0,0,0,0,0,0
20200312,72331P,穩懋凱基93售02,0.20,0.20,0.20,0.20,+0.10,100.0,305000,3,61000,0,0,0,0,0,0,305000,0,305000,305000
20200312,72332P,穩懋凱基93售03,,,,,,0.00,0,0,0,0,0,0,0,0,0,0,0,0,0
20200312,72333P,大江凱基93售01,,,,,,0.00,0,0,0,0,0,0,0,0,0,0,0,0,0
20200312,72334P,穩懋凱基93售04,,,,,,0.00,0,0,0,0,0,0,0,0,0,0,0,0,0
20200312,72339P,頎邦群益93售01,,,,,,0.00,0,0,0,0,0,0,0,0,0,0,0,0,0
20200312,72340P,穩懋凱基93售06,,,,,,0.00,0,0,0,0,0,0,0,0,0,0,0,0,0
20200312,72345P,大江富邦93售02,,,,,,0.00,0,0,0,0,0,0,0,0,0,0,0,0,0
20200312,72356P,雙鴻凱基93售02,0.01,0.01,0.01,0.01,0.00,0.0,219000,1,2190,0,0,0,0,0,0,219000,0,219000,219000
20200312,72358P,譜瑞凱基93售01,,,,,,0.00,0,0,0,0,0,0,0,0,0,0,0,0,0
20200312,72360P,雙鴻國泰93售01,,,,,,0.00,0,0,0,0,0,0,0,0,0,0,0,0,0
20200312,72365P,神盾統一93售01,,,,,,0.00,0,0,0,0,0,0,0,0,0,0,0,0,0
20200312,72366P,力旺凱基93售01,,,,,,0.00,0,0,0,0,0,0,0,0,0,0,0,0,0
20200312,72372P,神盾群益93售01,,,,,,0.00,0,0,0,0,0,0,0,0,0,0,0,0,0
20200312,72379P,廣明國泰93售02,,,,,,0.00,0,0,0,0,0,0,0,0,0,0,0,0,0
20200312,72390P,穩懋國泰94售01,0.55,0.75,0.55,0.75,+0.34,82.93,44000,3,30200,0,0,0,0,0,0,44000,0,44000,44000
20200312,72402P,中美晶兆豐94售01,,,,,,0.00,0,0,0,0,0,0,0,0,0,0,0,0,0
20200312,72413P,鈊象國票93售01,,,,,,0.00,0,0,0,0,0,0,0,0,0,0,0,0,0
20200312,72419P,信昌電國票93售01,,,,,,0.00,0,0,0,0,0,0,0,0,0,0,0,0,0
20200312,72422P,穩懋凱基93售11,,,,,,0.00,0,0,0,0,0,0,0,0,0,0,0,0,0
20200312,72424P,力旺群益93售02,,,,,,0.00,0,0,0,0,0,0,0,0,0,0,0,0,0
20200312,72426P,宣德群益93售02,,,,,,0.00,0,0,0,0,0,0,0,0,0,0,0,0,0
20200312,72430P,中美晶國票93售01,,,,,,0.00,0,0,0,0,0,0,0,0,0,0,0,0,0
20200312,72431P,穩懋富邦93售05,0.25,0.25,0.25,0.25,+0.15,150.0,12000,2,3000,0,0,0,0,0,0,0,12000,-12000,-12000
20200312,72436P,威剛群益93售02,,,,,,0.00,0,0,0,0,0,0,0,0,0,0,0,0,0
20200312,72438P,威剛國泰93售02,,,,,,0.00,0,0,0,0,0,0,0,0,0,0,0,0,0
20200312,72444P,穩懋中信94售01,,,,,,0.00,0,0,0,0,0,0,0,0,0,0,0,0,0
20200312,72446P,穩懋凱基93售13,,,,,,0.00,0,0,0,0,0,0,0,0,0,0,0,0,0
20200312,72455P,穩懋中信94售03,0.39,0.39,0.39,0.39,+0.16,69.57,30000,1,11700,0,0,0,0,0,0,30000,0,30000,30000
20200312,72456P,信驊凱基93售03,,,,,,0.00,0,0,0,0,0,0,0,0,0,0,0,0,0
20200312,72458P,雙鴻國泰93售03,,,,,,0.00,0,0,0,0,0,0,0,0,0,0,0,0,0
20200312,72472P,穩懋國票94售01,,,,,,0.00,0,0,0,0,0,0,0,0,0,0,0,0,0
20200312,72476P,台半中信95售01,,,,,,0.00,0,0,0,0,0,0,0,0,0,0,0,0,0
20200312,72487P,穩懋亞東94售01,0.61,0.61,0.61,0.61,+0.33,117.86,30000,1,18300,0,0,0,0,0,0,30000,0,30000,30000
20200312,72488P,中美晶國票94售01,,,,,,0.00,0,0,0,0,0,0,0,0,0,0,0,0,0
20200312,72490P,廣明凱基94售02,2.87,3.26,2.87,3.26,+0.51,18.55,39000,4,118030,0,0,0,0,0,0,10000,29000,-19000,-19000
20200312,72501P,大江富邦95售01,1.13,1.33,1.13,1.33,+0.25,23.15,498000,13,593050,0,0,0,0,0,0,67000,431000,-364000,-364000
20200312,72502P,泰博永豐93售01,0.01,0.01,0.01,0.01,-0.04,-80.0,13000,13,130,0,0,0,0,0,0,0,0,0,0
20200312,72503P,信驊群益93售01,,,,,,0.00,0,0,0,0,0,0,0,0,0,0,0,0,0
20200312,72504P,環球晶凱基93售12,,,,,,0.00,0,0,0,0,0,0,0,0,0,0,0,0,0
20200312,72505P,優群康和93售01,,,,,,0.00,0,0,0,0,0,0,0,0,0,0,0,0,0
20200312,72506P,大江永豐93售03,,,,,,0.00,0,0,0,0,0,0,0,0,0,0,0,0,0
20200312,72507P,合晶永豐93售02,,,,,,0.00,0,0,0,0,0,0,0,0,0,0,0,0,0
20200312,72508P,皇田永豐93售03,,,,,,0.00,0,0,0,0,0,0,0,0,0,0,0,0,0
20200312,72509P,網龍統一93售01,,,,,,0.00,0,0,0,0,0,0,0,0,0,0,0,0,0
20200312,72510P,原相群益96售02,0.09,0.11,0.08,0.10,+0.03,42.86,1630000,21,147000,0,0,0,0,0,0,1538000,0,1538000,1538000
20200312,72511P,台燿統一93售03,1.01,1.01,1.01,1.01,+0.33,48.53,10000,1,10100,0,0,0,0,0,0,0,10000,-10000,-10000
20200312,72512P,信驊元富93售02,,,,,,0.00,0,0,0,0,0,0,0,0,0,0,0,0,0
20200312,72513P,原相永豐93售03,,,,,,0.00,0,0,0,0,0,0,0,0,0,0,0,0,0
20200312,72514P,優群永豐93售03,,,,,,0.00,0,0,0,0,0,0,0,0,0,0,0,0,0
20200312,72515P,建榮國票93售01,,,,,,0.00,0,0,0,0,0,0,0,0,0,0,0,0,0
20200312,72516P,台燿元大93售05,,,,,,0.00,0,0,0,0,0,0,0,0,0,0,0,0,0
20200312,72517P,大江凱基93售09,,,,,,0.00,0,0,0,0,0,0,0,0,0,0,0,0,0
20200312,72518P,昂寶康和93售01,,,,,,0.00,0,0,0,0,0,0,0,0,0,0,0,0,0
20200312,72519P,晶焱群益93售04,,,,,,0.00,0,0,0,0,0,0,0,0,0,0,0,0,0
20200312,72520P,台燿台新93售02,,,,,,0.00,0,0,0,0,0,0,0,0,0,0,0,0,0
20200312,72521P,台燿國票93售01,,,,,,0.00,0,0,0,0,0,0,0,0,0,0,0,0,0
20200312,72522P,大江元大93售06,,,,,,0.00,0,0,0,0,0,0,0,0,0,0,0,0,0
20200312,72523P,穩懋凱基93售17,,,,,,0.00,0,0,0,0,0,0,0,0,0,0,0,0,0
20200312,72524P,穩懋永豐93售02,,,,,,0.00,0,0,0,0,0,0,0,0,0,0,0,0,0
20200312,72525P,新普凱基93售03,,,,,,0.00,0,0,0,0,0,0,0,0,0,0,0,0,0
20200312,72526P,廣明永豐93售02,,,,,,0.00,0,0,0,0,0,0,0,0,0,0,0,0,0
20200312,72527P,神盾國票93售02,,,,,,0.00,0,0,0,0,0,0,0,0,0,0,0,0,0
20200312,72528P,大田永豐93售02,0.66,0.88,0.66,0.88,+0.42,91.3,403000,3,354100,0,0,0,0,0,0,403000,0,403000,403000
20200312,72529P,信驊永豐93售01,,,,,,0.00,0,0,0,0,0,0,0,0,0,0,0,0,0
20200312,72530P,環球晶兆豐93售02,,,,,,0.00,0,0,0,0,0,0,0,0,0,0,0,0,0
20200312,72531P,環球晶群益93售03,,,,,,0.00,0,0,0,0,0,0,0,0,0,0,0,0,0
20200312,72532P,穩懋國泰93售02,1.31,1.33,1.31,1.31,+0.73,125.86,870000,4,1151690,0,0,0,0,0,0,870000,0,870000,870000
20200312,72533P,中美晶元富94售01,,,,,,0.00,0,0,0,0,0,0,0,0,0,0,0,0,0
20200312,72534P,金居元富94售01,1.72,2.17,1.68,2.17,+0.60,38.22,127000,11,236330,0,0,0,0,0,0,44000,83000,-39000,-39000
20200312,72535P,雙鴻群益95售01,1.10,1.10,1.06,1.07,+0.23,27.38,30000,5,32110,0,0,0,0,0,0,25000,5000,20000,20000
20200312,72536P,網龍國票93售01,,,,,,0.00,0,0,0,0,0,0,0,0,0,0,0,0,0
20200312,72537P,大江永豐93售06,,,,,,0.00,0,0,0,0,0,0,0,0,0,0,0,0,0
20200312,72538P,碩禾永豐93售01,,,,,,0.00,0,0,0,0,0,0,0,0,0,0,0,0,0
20200312,72539P,環球晶元大93售12,,,,,,0.00,0,0,0,0,0,0,0,0,0,0,0,0,0
20200312,72540P,世界國票93售01,,,,,,0.00,0,0,0,0,0,0,0,0,0,0,0,0,0
20200312,72541P,精華國票93售01,2.13,2.13,2.13,2.13,+0.84,65.12,10000,1,21300,0,0,0,0,0,0,0,10000,-10000,-10000
20200312,72542P,環球晶元富94售01,0.30,0.46,0.27,0.29,+0.04,16.0,609000,18,205680,0,0,0,0,0,0,190000,419000,-229000,-229000
20200312,72543P,環球晶元大93售13,,,,,,0.00,0,0,0,0,0,0,0,0,0,0,0,0,0
20200312,72544P,中美晶永豐93售04,,,,,,0.00,0,0,0,0,0,0,0,0,0,0,0,0,0
20200312,72545P,緯軟永豐93售02,1.05,1.05,1.05,1.05,+0.18,20.69,20000,1,21000,0,0,0,0,0,0,20000,0,20000,20000
20200312,72546P,新普元大93售04,,,,,,0.00,0,0,0,0,0,0,0,0,0,0,0,0,0
20200312,72547P,廣明元大93售04,,,,,,0.00,0,0,0,0,0,0,0,0,0,0,0,0,0
20200312,72548P,大江統一96售01,3.00,3.00,3.00,3.00,+0.29,10.7,1000,1,3000,0,0,0,0,0,0,1000,0,1000,1000
20200312,72549P,穩懋統一94售03,1.48,1.60,1.48,1.60,+0.31,24.03,80000,2,121520,0,0,0,0,0,0,54000,26000,28000,28000
20200312,72550P,聯亞國票94售02,,,,,,0.00,0,0,0,0,0,0,0,0,0,0,0,0,0
20200312,72551P,金居國泰94售02,0.60,0.63,0.60,0.63,+0.12,23.53,200000,2,123000,0,0,0,0,0,0,0,200000,-200000,-200000
20200312,72552P,良維永豐93售02,,,,,,0.00,0,0,0,0,0,0,0,0,0,0,0,0,0
20200312,72553P,金居永豐93售02,0.32,0.38,0.32,0.38,+0.25,192.31,20000,2,7000,0,0,0,0,0,0,20000,0,20000,20000
20200312,72554P,神盾永豐93售04,,,,,,0.00,0,0,0,0,0,0,0,0,0,0,0,0,0
20200312,72555P,環球晶凱基94售02,,,,,,0.00,0,0,0,0,0,0,0,0,0,0,0,0,0
20200312,72556P,環球晶元富95售01,0.28,0.42,0.25,0.25,+0.02,8.7,196000,10,60270,0,0,0,0,0,0,11000,185000,-174000,-174000
20200312,72557P,晶焱元大94售01,0.83,0.89,0.83,0.89,+0.17,23.61,400000,5,346000,0,0,0,0,0,0,0,400000,-400000,-400000
20200312,72558P,聯亞元大94售02,0.60,0.73,0.60,0.73,+0.32,78.05,81000,3,57800,0,0,0,0,0,0,1000,80000,-79000,-79000
20200312,72559P,由田永豐94售01,1.41,1.41,1.41,1.41,+0.23,19.49,10000,1,14100,0,0,0,0,0,0,10000,0,10000,10000
20200312,72560P,佳邦永豐94售01,,,,,,0.00,0,0,0,0,0,0,0,0,0,0,0,0,0
20200312,72561P,昇達科永豐94售01,,,,,,0.00,0,0,0,0,0,0,0,0,0,0,0,0,0
20200312,72562P,原相永豐94售01,,,,,,0.00,0,0,0,0,0,0,0,0,0,0,0,0,0
20200312,72563P,晶焱永豐94售01,,,,,,0.00,0,0,0,0,0,0,0,0,0,0,0,0,0
20200312,72564P,新普永豐94售01,,,,,,0.00,0,0,0,0,0,0,0,0,0,0,0,0,0
20200312,72565P,台燿兆豐94售01,,,,,,0.00,0,0,0,0,0,0,0,0,0,0,0,0,0
20200312,72566P,大江群益94售03,,,,,,0.00,0,0,0,0,0,0,0,0,0,0,0,0,0
20200312,72567P,神盾群益94售03,,,,,,0.00,0,0,0,0,0,0,0,0,0,0,0,0,0
20200312,72568P,新普群益96售01,0.49,0.49,0.47,0.47,+0.05,11.9,71000,3,34590,0,0,0,0,0,0,0,71000,-71000,-71000
20200312,72569P,大學光元大94售04,0.04,0.04,0.04,0.04,+0.02,100.0,100000,1,4000,0,0,0,0,0,0,100000,0,100000,100000
20200312,72570P,環球晶元大94售01,,,,,,0.00,0,0,0,0,0,0,0,0,0,0,0,0,0
20200312,72571P,鐿鈦永豐94售02,,,,,,0.00,0,0,0,0,0,0,0,0,0,0,0,0,0
20200312,72572P,網家元富96售02,1.91,2.19,1.91,2.19,+0.41,23.03,93000,7,193060,0,0,0,0,0,0,82000,11000,71000,71000
20200312,72573P,原相亞東94售01,,,,,,0.00,0,0,0,0,0,0,0,0,0,0,0,0,0
20200312,72574P,環球晶永豐94售01,,,,,,0.00,0,0,0,0,0,0,0,0,0,0,0,0,0
20200312,72575P,環球晶元富95售02,0.36,0.36,0.36,0.36,+0.10,38.46,5000,1,1800,0,0,0,0,0,0,5000,0,5000,5000
20200312,72576P,緯軟元大94售05,,,,,,0.00,0,0,0,0,0,0,0,0,0,0,0,0,0
20200312,72577P,環球晶元大94售03,,,,,,0.00,0,0,0,0,0,0,0,0,0,0,0,0,0
20200312,72578P,雙鴻元大95售01,1.04,1.31,1.04,1.30,+0.31,31.31,924000,33,1120160,0,0,0,0,0,0,575000,323000,252000,252000
20200312,72579P,穩懋元大94售02,,,,,,0.00,0,0,0,0,0,0,0,0,0,0,0,0,0
20200312,72580P,台燿凱基94售02,1.14,1.30,1.14,1.30,+0.39,42.86,20000,2,24400,0,0,0,0,0,0,10000,10000,0,0
20200312,72581P,穩懋元大94售03,1.16,1.54,1.16,1.54,+0.70,83.33,210000,3,284860,0,0,0,0,0,0,119000,91000,28000,28000
20200312,72582P,櫃200群益94售01,0.32,0.52,0.32,0.52,+0.26,100.0,22000,22,9630,0,0,0,0,0,0,12000,10000,2000,2000
20200312,72583P,聯亞國票95售02,,,,,,0.00,0,0,0,0,0,0,0,0,0,0,0,0,0
20200312,72584P,大江永豐94售01,,,,,,0.00,0,0,0,0,0,0,0,0,0,0,0,0,0
20200312,72585P,宏捷科永豐94售01,,,,,,0.00,0,0,0,0,0,0,0,0,0,0,0,0,0
20200312,72586P,宏捷科國泰95售02,0.33,0.42,0.32,0.37,+0.08,27.59,209000,12,75120,0,0,0,0,0,0,179000,30000,149000,149000
20200312,72587P,宏捷科國票95售01,0.70,0.96,0.70,0.88,+0.19,27.54,2054000,98,1696140,0,0,0,0,0,0,1225000,781000,444000,444000
20200312,72588P,大江凱基94售05,2.01,2.01,2.01,2.01,+0.09,4.69,10000,1,20100,0,0,0,0,0,0,0,10000,-10000,-10000
20200312,72589P,櫃200第一94售02,,,,,,0.00,0,0,0,0,0,0,0,0,0,0,0,0,0
20200312,72590P,聯亞永豐94售01,,,,,,0.00,0,0,0,0,0,0,0,0,0,0,0,0,0
20200312,72591P,神盾元大95售04,1.15,1.37,1.15,1.37,+0.32,30.48,140000,6,170280,0,0,0,0,0,0,90000,50000,40000,40000
20200312,72592P,環球晶元大94售06,,,,,,0.00,0,0,0,0,0,0,0,0,0,0,0,0,0
20200312,72593P,聯亞元大94售03,0.58,0.58,0.58,0.58,+0.20,52.63,50000,1,29000,0,0,0,0,0,0,50000,0,50000,50000
20200312,72594P,雙鴻國泰96售03,1.44,1.69,1.44,1.66,+0.24,16.9,236000,8,348990,0,0,0,0,0,0,206000,30000,176000,176000
20200312,72595P,大江富邦96售01,,,,,,0.00,0,0,0,0,0,0,0,0,0,0,0,0,0
20200312,72596P,環球晶凱基94售04,,,,,,0.00,0,0,0,0,0,0,0,0,0,0,0,0,0
20200312,72597P,晟德凱基94售02,,,,,,0.00,0,0,0,0,0,0,0,0,0,0,0,0,0
20200312,72598P,中美晶群益94售02,,,,,,0.00,0,0,0,0,0,0,0,0,0,0,0,0,0
20200312,72599P,台燿群益94售01,1.48,1.71,1.48,1.71,+0.42,32.56,40000,3,62800,0,0,0,0,0,0,30000,10000,20000,20000
20200312,72600P,櫃200永昌94售03,1.31,1.32,1.31,1.32,+0.53,67.09,20000,2,26300,0,0,0,0,0,0,20000,0,20000,20000
20200312,72601P,信昌電永豐94售02,0.92,1.14,0.90,1.14,+0.31,37.35,163000,6,151860,0,0,0,0,0,0,139000,24000,115000,115000
20200312,72602P,中美晶兆豐95售01,0.18,0.22,0.18,0.19,+0.03,18.75,155000,5,31950,0,0,0,0,0,0,150000,5000,145000,145000
20200312,72603P,櫃200富邦94售05,,,,,,0.00,0,0,0,0,0,0,0,0,0,0,0,0,0
20200312,72604P,櫃200富邦94售06,,,,,,0.00,0,0,0,0,0,0,0,0,0,0,0,0,0
20200312,72605P,凡甲統一94售02,0.50,0.50,0.50,0.50,+0.20,66.67,50000,3,25000,0,0,0,0,0,0,10000,40000,-30000,-30000
20200312,72606P,聯亞凱基94售03,,,,,,0.00,0,0,0,0,0,0,0,0,0,0,0,0,0
20200312,72607P,元太元大94售02,0.73,0.73,0.73,0.73,+0.10,15.87,100000,1,73000,0,0,0,0,0,0,0,100000,-100000,-100000
20200312,72608P,大江台新94售02,,,,,,0.00,0,0,0,0,0,0,0,0,0,0,0,0,0
20200312,72609P,環球晶台新94售01,,,,,,0.00,0,0,0,0,0,0,0,0,0,0,0,0,0
20200312,72610P,中美晶凱基94售02,0.44,0.53,0.44,0.48,+0.14,41.18,168000,7,83530,0,0,0,0,0,0,30000,138000,-108000,-108000
20200312,72611P,雙鴻凱基96售02,1.44,1.58,1.39,1.52,+0.21,16.03,330000,18,483980,1000,0,1000,0,0,0,289000,80000,209000,210000
20200312,72612P,環球晶永豐94售03,,,,,,0.00,0,0,0,0,0,0,0,0,0,0,0,0,0
20200312,72613P,緯軟群益95售01,2.59,2.59,2.59,2.59,+0.47,22.17,299000,3,774410,0,0,0,0,0,0,299000,0,299000,299000
20200312,72614P,台燿元大94售02,1.59,1.59,1.59,1.59,+0.37,30.33,100000,2,159000,0,0,0,0,0,0,0,100000,-100000,-100000
20200312,72615P,晶焱元大95售02,0.97,1.08,0.97,1.08,+0.19,21.35,437000,6,453550,0,0,0,0,0,0,126000,311000,-185000,-185000
20200312,72616P,環球晶元大94售07,,,,,,0.00,0,0,0,0,0,0,0,0,0,0,0,0,0
20200312,72617P,原相兆豐95售01,0.08,0.11,0.08,0.11,+0.05,83.33,647000,9,70060,0,0,0,0,0,0,10000,637000,-627000,-627000
20200312,72618P,台燿元大94售05,1.12,1.12,1.12,1.12,+0.32,40.0,100000,1,112000,0,0,0,0,0,0,0,100000,-100000,-100000
20200312,72619P,環球晶元大94售08,0.99,0.99,0.99,0.99,+0.29,41.43,10000,1,9900,0,0,0,0,0,0,10000,0,10000,10000
20200312,72620P,雙鴻元大94售01,4.47,4.50,4.47,4.50,+0.72,19.05,13000,2,58200,0,0,0,0,0,0,0,10000,-10000,-10000
20200312,72621P,台燿凱基94售03,0.89,0.89,0.89,0.89,+0.23,34.85,20000,2,17800,0,0,0,0,0,0,0,20000,-20000,-20000
20200312,72622P,聯亞凱基94售04,0.40,0.40,0.40,0.40,+0.13,48.15,5000,1,2000,0,0,0,0,0,0,0,5000,-5000,-5000
20200312,72623P,穩懋富邦96售02,1.08,1.23,1.08,1.23,+0.30,32.26,202000,9,226230,0,0,0,0,0,0,53000,129000,-76000,-76000
20200312,72624P,櫃200第一96售02,1.33,1.35,1.33,1.35,+0.31,29.81,81000,2,107830,0,0,0,0,0,0,76000,5000,71000,71000
20200312,72625P,雙鴻永豐94售02,1.83,2.29,1.83,2.29,+0.61,36.31,32000,5,62080,0,0,0,0,0,0,22000,10000,12000,12000
20200312,72626P,環球晶兆豐95售03,0.47,0.47,0.42,0.42,+0.03,7.69,4000,2,1780,0,0,0,0,0,0,0,4000,-4000,-4000
20200312,72627P,新鉅科康和94售02,,,,,,0.00,0,0,0,0,0,0,0,0,0,0,0,0,0
20200312,72628P,宏捷科群益94售02,0.60,0.80,0.60,0.72,+0.21,41.18,70000,6,50100,0,0,0,0,0,0,40000,30000,10000,10000
20200312,72629P,安勤統一94售02,1.99,2.10,1.98,2.10,+0.43,25.75,21000,3,41800,0,0,0,0,0,0,0,21000,-21000,-21000
20200312,72630P,中美晶凱基94售04,0.41,0.49,0.41,0.49,+0.11,28.95,323000,3,138190,0,0,0,0,0,0,0,323000,-323000,-323000
20200312,72631P,台燿元大94售07,,,,,,0.00,0,0,0,0,0,0,0,0,0,0,0,0,0
20200312,72632P,環球晶元大94售12,,,,,,0.00,0,0,0,0,0,0,0,0,0,0,0,0,0
20200312,72633P,聯亞元大95售02,0.60,0.67,0.60,0.67,+0.18,36.73,16000,2,10300,0,0,0,0,0,0,6000,10000,-4000,-4000
20200312,72634P,環球晶元富94售05,0.76,0.79,0.76,0.79,+0.20,33.9,20000,2,15500,0,0,0,0,0,0,0,20000,-20000,-20000
20200312,72635P,安勤統一94售03,1.83,1.83,1.83,1.83,+0.15,8.93,2000,1,3660,0,0,0,0,0,0,2000,0,2000,2000
20200312,72636P,安勤統一94售04,,,,,,0.00,0,0,0,0,0,0,0,0,0,0,0,0,0
20200312,72637P,穩懋永豐94售02,1.20,1.62,1.20,1.62,+0.61,60.4,115000,6,163320,0,0,0,0,0,0,67000,48000,19000,19000
20200312,72638P,中美晶元富95售03,0.74,0.83,0.74,0.83,+0.21,33.87,404000,6,313140,0,0,0,0,0,0,0,404000,-404000,-404000
20200312,72639P,台燿元富94售02,,,,,,0.00,0,0,0,0,0,0,0,0,0,0,0,0,0
20200312,72640P,元太凱基94售02,1.24,1.24,1.24,1.24,+0.18,16.98,10000,1,12400,0,0,0,0,0,0,0,10000,-10000,-10000
20200312,72641P,環球晶群益94售06,,,,,,0.00,0,0,0,0,0,0,0,0,0,0,0,0,0
20200312,72642P,台燿永豐94售02,0.60,0.68,0.60,0.63,+0.17,36.96,33000,4,20890,0,0,0,0,0,0,5000,28000,-23000,-23000
20200312,72643P,神盾永豐94售02,2.38,2.96,2.38,2.96,+0.64,27.59,121000,9,295020,0,0,0,0,0,0,101000,20000,81000,81000
20200312,72644P,台燿元大94售08,0.93,1.09,0.93,1.09,+0.27,32.93,200000,2,202000,0,0,0,0,0,0,0,200000,-200000,-200000
20200312,72645P,環球晶國票94售01,1.09,1.33,1.06,1.29,+0.32,32.99,204000,10,235450,0,0,0,0,0,0,144000,60000,84000,84000
20200312,72646P,穩懋統一94售05,2.61,2.79,2.61,2.79,+0.57,25.68,30000,3,81200,0,0,0,0,0,0,0,10000,-10000,-10000
20200312,72647P,中美晶凱基94售05,,,,,,0.00,0,0,0,0,0,0,0,0,0,0,0,0,0
20200312,72648P,聯亞凱基94售05,0.59,0.59,0.59,0.59,+0.22,59.46,4000,1,2360,0,0,0,0,0,0,4000,0,4000,4000
20200312,72649P,大江元富94售02,2.20,2.72,2.14,2.72,+0.68,33.33,326000,26,808290,0,0,0,0,0,0,186000,139000,47000,47000
20200312,72650P,威剛永豐94售03,,,,,,0.00,0,0,0,0,0,0,0,0,0,0,0,0,0
20200312,72651P,世界元大94售01,,,,,,0.00,0,0,0,0,0,0,0,0,0,0,0,0,0
20200312,72652P,環球晶元大94售17,0.69,0.72,0.69,0.72,+0.12,20.0,50000,2,35700,0,0,0,0,0,0,50000,10000,40000,40000
20200312,72653P,宣德永豐94售02,,,,,,0.00,0,0,0,0,0,0,0,0,0,0,0,0,0
20200312,72654P,環球晶中信94售02,0.26,0.38,0.24,0.24,+0.01,4.35,131000,6,35180,0,0,0,0,0,0,61000,70000,-9000,-9000
20200312,72655P,穩懋統一96售03,2.78,2.95,2.78,2.95,+0.50,20.41,15000,3,43050,0,0,0,0,0,0,5000,10000,-5000,-5000
20200312,72656P,台燿元富94售05,0.96,1.12,0.96,1.12,+0.38,51.35,40000,4,41000,0,0,0,0,0,0,10000,30000,-20000,-20000
20200312,72657P,環球晶元富94售06,0.78,0.81,0.78,0.81,+0.24,42.11,45000,4,36000,0,0,0,0,0,0,20000,25000,-5000,-5000
20200312,72658P,建榮國票95售03,1.36,1.38,1.36,1.38,+0.07,5.34,87000,3,118520,0,0,0,0,0,0,87000,0,87000,87000
20200312,72659P,穩懋元大94售11,3.01,3.06,3.01,3.06,+0.35,12.92,2000,2,6070,0,0,0,0,0,0,2000,0,2000,2000
20200312,72660P,穩懋統一94售08,,,,,,0.00,0,0,0,0,0,0,0,0,0,0,0,0,0
20200312,72661P,穩懋中信96售01,1.17,1.30,1.17,1.30,+0.29,28.71,170000,3,218340,0,0,0,0,0,0,2000,168000,-166000,-166000
20200312,72662P,穩懋中信98售01,1.03,1.15,1.03,1.15,+0.23,25.0,125000,9,133980,0,0,0,0,0,0,124000,42000,82000,82000
20200312,72663P,神盾元富96售01,3.00,3.43,3.00,3.43,+0.81,30.92,12000,2,36860,0,0,0,0,0,0,12000,0,12000,12000
20200312,72664P,精華元富94售02,3.82,3.82,3.82,3.82,+0.59,18.27,10000,1,38200,0,0,0,0,0,0,0,10000,-10000,-10000
20200312,72665P,聯亞元富94售02,0.97,1.20,0.97,1.20,+0.41,51.9,113000,7,132400,0,0,0,0,0,0,0,113000,-113000,-113000
20200312,72666P,神盾元大94售06,,,,,,0.00,0,0,0,0,0,0,0,0,0,0,0,0,0
20200312,72667P,台燿凱基94售06,1.12,1.36,1.09,1.36,+0.40,41.67,523000,12,616320,0,0,0,0,0,0,410000,113000,297000,297000
20200312,72668P,網龍康和94售01,1.09,1.32,1.08,1.32,+0.36,37.5,620000,16,727680,0,0,0,0,0,0,587000,33000,554000,554000
20200312,72669P,原相凱基95售01,0.15,0.23,0.15,0.23,+0.12,109.09,450000,14,79740,0,0,0,0,0,0,399000,51000,348000,348000
20200312,72670P,環球晶凱基95售02,1.20,1.45,1.20,1.45,+0.46,46.46,40000,4,52800,0,0,0,0,0,0,30000,30000,0,0
20200312,72671P,穩懋元富95售04,1.25,1.79,1.25,1.65,+0.57,52.78,1782000,32,2658190,0,0,0,0,0,0,1051000,731000,320000,320000
20200312,72672P,穩懋國票96售01,,,,,,0.00,0,0,0,0,0,0,0,0,0,0,0,0,0
20200312,72673P,穩懋國泰96售01,2.65,3.04,2.61,3.03,+0.79,35.27,88000,8,241180,0,0,0,0,0,0,65000,33000,32000,32000
20200312,72674P,環球晶富邦97售02,0.59,0.69,0.59,0.60,+0.06,11.11,194000,24,121720,0,0,0,0,0,0,32000,128000,-96000,-96000
20200312,72675P,環球晶凱基95售03,0.27,0.27,0.17,0.17,+0.05,41.67,4000,2,780,0,0,0,0,0,0,1000,3000,-2000,-2000
20200312,72676P,金居元大95售03,0.97,1.04,0.97,1.04,+0.09,9.47,179000,2,180630,0,0,0,0,0,0,79000,100000,-21000,-21000
20200312,72677P,中美晶永豐95售02,,,,,,0.00,0,0,0,0,0,0,0,0,0,0,0,0,0
20200312,72678P,穩懋永豐95售01,1.37,1.65,1.37,1.65,+0.50,43.48,118000,11,179440,0,0,0,0,0,0,0,118000,-118000,-118000
20200312,72679P,譜瑞中信95售02,0.28,0.29,0.28,0.28,+0.12,75.0,72000,4,20570,0,0,0,0,0,0,0,72000,-72000,-72000
20200312,72680P,穩懋元大95售01,2.94,2.94,2.94,2.94,+0.40,15.75,20000,1,58800,0,0,0,0,0,0,20000,0,20000,20000
20200312,72681P,合晶永豐95售01,1.37,1.73,1.36,1.73,+0.58,50.43,70000,7,105100,0,0,0,0,0,0,0,70000,-70000,-70000
20200312,72682P,良維永豐95售01,1.48,1.85,1.48,1.85,+0.44,31.21,70000,8,112950,0,0,0,0,0,0,20000,50000,-30000,-30000
20200312,72683P,碩禾永豐95售02,0.65,0.73,0.65,0.73,+0.16,28.07,6000,2,3980,0,0,0,0,0,0,5000,1000,4000,4000
20200312,72684P,大江國票96售02,,,,,,0.00,0,0,0,0,0,0,0,0,0,0,0,0,0
20200312,72685P,中美晶元富95售05,0.68,0.72,0.68,0.72,+0.23,46.94,171000,2,119600,0,0,0,0,0,0,0,171000,-171000,-171000
20200312,72686P,新普群益97售03,1.11,1.13,1.11,1.13,+0.14,14.14,4000,2,4500,0,0,0,0,0,0,0,0,0,0
20200312,72687P,譜瑞元大95售03,0.50,0.68,0.48,0.68,+0.24,54.55,580000,9,298800,0,0,0,0,0,0,315000,265000,50000,50000
20200312,72688P,環球晶凱基95售05,1.71,2.23,1.62,1.67,+0.13,8.44,152000,16,290160,0,0,0,0,0,0,61000,111000,-50000,-50000
20200312,72689P,環宇國票96售01,,,,,,0.00,0,0,0,0,0,0,0,0,0,0,0,0,0
20200312,72690P,聯亞台新95售02,0.85,0.85,0.85,0.85,+0.10,13.33,3000,1,2550,0,0,0,0,0,0,3000,0,3000,3000
20200312,72691P,穩懋台新95售01,2.12,2.66,2.12,2.66,+0.76,40.0,118000,12,258750,0,0,0,0,0,0,108000,10000,98000,98000
20200312,72692P,中美晶群益95售01,0.71,0.93,0.71,0.93,+0.27,40.91,36000,2,27980,0,0,0,0,0,0,0,36000,-36000,-36000
20200312,72693P,環球晶凱基95售07,0.30,0.30,0.30,0.30,+0.14,87.5,25000,1,7500,0,0,0,0,0,0,25000,0,25000,25000
20200312,72694P,櫃200元大95售02,,,,,,0.00,0,0,0,0,0,0,0,0,0,0,0,0,0
20200312,72695P,穩懋元大95售03,,,,,,0.00,0,0,0,0,0,0,0,0,0,0,0,0,0
20200312,72696P,穩懋兆豐95售02,0.65,0.81,0.64,0.81,+0.25,44.64,408000,18,274330,0,0,0,0,0,0,362000,46000,316000,316000
20200312,72697P,穩懋亞東96售01,3.28,3.54,3.28,3.54,+1.09,44.49,55000,2,189240,0,0,0,0,0,0,0,55000,-55000,-55000
20200312,72698P,環球晶凱基95售08,,,,,,0.00,0,0,0,0,0,0,0,0,0,0,0,0,0
20200312,72699P,大江元大95售03,,,,,,0.00,0,0,0,0,0,0,0,0,0,0,0,0,0
20200312,72700P,中美晶元大95售03,0.38,0.44,0.38,0.38,+0.09,31.03,74000,4,28180,0,0,0,0,0,0,3000,71000,-68000,-68000
20200312,72701P,穩懋元大95售05,3.24,3.91,3.24,3.91,+1.35,52.73,25000,7,85680,0,0,0,0,0,0,3000,22000,-19000,-19000
20200312,72702P,精華元富95售02,2.55,2.98,2.55,2.98,+0.83,38.6,45000,5,126100,0,0,0,0,0,0,15000,30000,-15000,-15000
20200312,72703P,聯亞群益96售01,1.52,1.66,1.52,1.66,+0.44,36.07,30000,3,47400,0,0,0,0,0,0,0,30000,-30000,-30000
20200312,72704P,大江國票96售03,4.51,4.51,4.51,4.51,+0.17,3.92,4000,1,18040,0,0,0,0,0,0,4000,0,4000,4000
20200312,72705P,原相永豐95售01,0.10,0.15,0.10,0.15,+0.07,87.5,130000,4,18500,0,0,0,0,0,0,130000,0,130000,130000
20200312,72706P,環球晶國泰96售02,1.12,1.57,1.11,1.15,+0.04,3.6,2154000,72,2888220,0,0,0,0,0,0,1615000,719000,896000,896000
20200312,72707P,中美晶國票96售02,0.60,0.64,0.60,0.64,+0.18,39.13,136000,2,84240,0,0,0,0,0,0,0,136000,-136000,-136000
20200312,72708P,環球晶群益95售03,1.12,1.45,1.10,1.10,+0.09,8.91,105000,6,127830,0,0,0,0,0,0,84000,61000,23000,23000
20200312,72709P,新鉅科康和95售01,1.72,2.11,1.72,1.96,+0.40,25.64,27000,4,52260,0,0,0,0,0,0,7000,20000,-13000,-13000
20200312,72710P,神盾元大95售06,,,,,,0.00,0,0,0,0,0,0,0,0,0,0,0,0,0
20200312,72711P,櫃200永昌96售05,,,,,,0.00,0,0,0,0,0,0,0,0,0,0,0,0,0
20200312,72712P,環球晶元大95售11,0.59,0.75,0.56,0.58,+0.05,9.43,350000,23,214400,0,0,0,0,0,0,159000,181000,-22000,-22000
20200312,72713P,櫃200元大96售01,,,,,,0.00,0,0,0,0,0,0,0,0,0,0,0,0,0
20200312,72714P,櫃200元大96售02,,,,,,0.00,0,0,0,0,0,0,0,0,0,0,0,0,0
20200312,72715P,雙鴻統一95售01,,,,,,0.00,0,0,0,0,0,0,0,0,0,0,0,0,0
20200312,72716P,穩懋統一96售04,2.66,2.89,2.66,2.89,+0.74,34.42,27000,2,76420,0,0,0,0,0,0,20000,7000,13000,13000
20200312,72717P,穩懋元富95售07,2.55,3.02,2.55,3.02,+0.72,31.3,35000,7,96890,0,0,0,0,0,0,30000,5000,25000,25000
20200312,72718P,穩懋元富95售08,1.66,2.06,1.64,2.06,+0.63,44.06,348000,22,638600,0,0,0,0,0,0,296000,249000,47000,47000
20200312,72719P,原相亞東96售02,0.13,0.20,0.13,0.20,+0.13,185.71,27000,4,4420,0,0,0,0,0,0,22000,0,22000,22000
20200312,72720P,元太元大95售03,1.80,2.09,1.80,1.97,+0.31,18.67,103000,6,213370,0,0,0,0,0,0,101000,102000,-1000,-1000
20200312,72721P,宣德永豐95售02,0.66,0.74,0.66,0.74,+0.14,23.33,157000,5,110190,0,0,0,0,0,0,100000,57000,43000,43000
20200312,72722P,穩懋統一95售01,4.29,4.34,4.29,4.34,+1.15,36.05,15000,2,64600,0,0,0,0,0,0,15000,0,15000,15000
20200312,72723P,穩懋統一95售02,2.31,2.77,2.31,2.77,+0.86,45.03,160000,8,383390,0,0,0,0,0,0,143000,17000,126000,126000
20200312,72724P,威剛凱基95售01,,,,,,0.00,0,0,0,0,0,0,0,0,0,0,0,0,0
20200312,72725P,環球晶元大95售13,0.63,0.70,0.46,0.46,+0.07,17.95,116000,6,75890,0,0,0,0,0,0,108000,8000,100000,100000
20200312,72726P,穩懋元大95售08,3.42,4.02,3.42,4.02,+1.02,34.0,5000,2,18300,0,0,0,0,0,0,5000,0,5000,5000
20200312,72727P,雙鴻康和95售01,1.24,1.43,1.24,1.43,+0.27,23.28,104000,3,138980,0,0,0,0,0,0,104000,0,104000,104000
20200312,72728P,穩懋元大95售09,3.53,3.69,3.53,3.67,+0.60,19.54,81000,3,296410,0,0,0,0,0,0,33000,48000,-15000,-15000
20200312,72729P,櫃200富邦95售04,,,,,,0.00,0,0,0,0,0,0,0,0,0,0,0,0,0
20200312,72730P,櫃200富邦95售05,,,,,,0.00,0,0,0,0,0,0,0,0,0,0,0,0,0
20200312,72731P,櫃200富邦95售06,0.62,0.65,0.62,0.65,+0.29,80.56,2000,2,1270,0,0,0,0,0,0,2000,0,2000,2000
20200312,72732P,櫃200T永昌96售05,1.25,1.25,1.25,1.25,+0.50,66.67,2000,1,2500,0,0,0,0,0,0,2000,0,2000,2000
20200312,72733P,櫃200凱基96售01,2.84,4.31,2.84,4.31,+1.98,84.98,65000,3,192150,0,0,0,0,0,0,55000,10000,45000,45000
20200312,72734P,櫃200凱基96售02,,,,,,0.00,0,0,0,0,0,0,0,0,0,0,0,0,0
20200312,72735P,穩懋元大95售10,1.73,1.98,1.73,1.98,+0.51,34.69,21000,3,39330,0,0,0,0,0,0,10000,21000,-11000,-11000
20200312,72736P,穩懋元大95售11,3.35,4.03,3.35,3.95,+1.25,46.3,37000,7,135560,0,0,0,0,0,0,20000,32000,-12000,-12000
20200312,72737P,櫃200富邦9A售03,,,,,,0.00,0,0,0,0,0,0,0,0,0,0,0,0,0
20200312,72738P,櫃200富邦9A售04,,,,,,0.00,0,0,0,0,0,0,0,0,0,0,0,0,0
20200312,72739P,中美晶永豐95售04,0.77,0.79,0.77,0.79,+0.14,21.54,20000,2,15600,0,0,0,0,0,0,0,20000,-20000,-20000
20200312,72740P,中美晶元大95售05,0.81,0.98,0.81,0.88,+0.14,18.92,85000,8,75880,0,0,0,0,0,0,58000,27000,31000,31000
20200312,72741P,良維元大95售03,1.60,1.60,1.60,1.60,+0.23,16.79,3000,1,4800,0,0,0,0,0,0,3000,0,3000,3000
20200312,72742P,雙鴻元大95售03,1.83,2.24,1.83,2.16,+0.40,22.73,207000,17,421360,0,0,0,0,0,0,150000,57000,93000,93000
20200312,72743P,群聯永豐95售02,0.63,0.79,0.63,0.79,+0.24,43.64,165000,5,118250,0,0,0,0,0,0,70000,95000,-25000,-25000
20200312,72744P,神盾元大95售07,1.72,2.13,1.71,2.11,+0.43,25.6,606000,29,1169840,0,0,0,0,0,0,299000,407000,-108000,-108000
20200312,72745P,威剛國票96售01,0.18,0.27,0.18,0.26,+0.09,52.94,2900000,49,666200,0,0,0,0,0,0,1940000,885000,1055000,1055000
20200312,72746P,大江富邦97售02,1.74,1.83,1.72,1.83,+0.15,8.93,336000,10,596500,0,0,0,0,0,0,30000,306000,-276000,-276000
20200312,72747P,櫃200T永昌9C售05,2.56,2.79,2.56,2.79,+0.66,30.99,200000,3,531500,0,0,0,0,0,0,100000,100000,0,0
20200312,72748P,穩懋康和95售01,0.98,0.99,0.98,0.99,+0.26,35.62,60000,2,59100,0,0,0,0,0,0,60000,0,60000,60000
20200312,72749P,金居元大95售04,1.01,1.37,1.01,1.37,+0.42,44.21,391000,8,432940,0,0,0,0,0,0,30000,361000,-331000,-331000
20200312,72750P,精華元大95售04,,,,,,0.00,0,0,0,0,0,0,0,0,0,0,0,0,0
20200312,72751P,元太中信95售02,0.74,0.88,0.74,0.88,+0.20,29.41,354000,6,289650,0,0,0,0,0,0,0,354000,-354000,-354000
20200312,72752P,環球晶凱基96售02,0.71,0.85,0.68,0.68,+0.04,6.25,674000,12,499170,0,0,0,0,0,0,200000,514000,-314000,-314000
20200312,72753P,新普永豐95售02,1.02,1.12,1.02,1.07,+0.13,13.83,68000,5,72580,0,0,0,0,0,0,46000,22000,24000,24000
20200312,72754P,大江群益95售02,,,,,,0.00,0,0,0,0,0,0,0,0,0,0,0,0,0
20200312,72755P,精華凱基95售02,1.89,2.02,1.89,2.02,+0.31,18.13,92000,5,180820,0,0,0,0,0,0,0,92000,-92000,-92000
20200312,72756P,穩懋凱基95售02,1.52,1.87,1.52,1.87,+0.52,38.52,76000,4,138260,0,0,0,0,0,0,65000,11000,54000,54000
20200312,72757P,精華統一95售01,,,,,,0.00,0,0,0,0,0,0,0,0,0,0,0,0,0
20200312,72758P,環球晶凱基95售14,0.15,0.33,0.15,0.23,+0.12,109.09,20000,7,4050,0,0,0,0,0,0,20000,0,20000,20000
20200312,72759P,精華永豐95售03,2.16,2.42,2.16,2.42,+0.44,22.22,62000,5,136990,0,0,0,0,0,0,2000,60000,-58000,-58000
20200312,72760P,精測元大95售01,2.13,2.29,2.13,2.29,+0.29,14.5,74000,2,165620,0,0,0,0,0,0,24000,50000,-26000,-26000
20200312,72761P,中美晶富邦96售01,,,,,,0.00,0,0,0,0,0,0,0,0,0,0,0,0,0
20200312,72762P,穩懋富邦97售02,0.90,1.05,0.90,1.05,+0.23,28.05,467000,16,465640,0,0,0,0,0,0,111000,361000,-250000,-250000
20200312,72763P,精測中信96售01,1.28,1.56,1.28,1.56,+0.33,26.83,127000,6,182970,0,0,0,0,0,0,117000,10000,107000,107000
20200312,72764P,中美晶凱基96售02,,,,,,0.00,0,0,0,0,0,0,0,0,0,0,0,0,0
20200312,72765P,精測國泰97售01,1.33,1.68,1.33,1.65,+0.30,22.22,338000,19,497430,0,0,0,0,0,0,243000,203000,40000,40000
20200312,72766P,中美晶富邦97售01,,,,,,0.00,0,0,0,0,0,0,0,0,0,0,0,0,0
20200312,72767P,精測康和96售01,,,,,,0.00,0,0,0,0,0,0,0,0,0,0,0,0,0
20200312,72768P,精測凱基96售02,1.19,1.51,1.19,1.51,+0.35,30.17,165000,5,240490,0,0,0,0,0,0,50000,115000,-65000,-65000
20200312,72769P,雙鴻兆豐97售01,0.92,1.03,0.91,1.03,+0.22,27.16,439000,11,418640,0,0,0,0,0,0,57000,382000,-325000,-325000
20200312,72770P,精測永豐96售03,1.52,1.74,1.52,1.74,+0.36,26.09,37000,3,58440,0,0,0,0,0,0,0,37000,-37000,-37000
20200312,72771P,鈊象元大96售01,0.10,0.25,0.10,0.25,+0.16,177.78,2625000,13,344570,0,0,0,0,0,0,1312000,1312000,0,0
20200312,72772P,同致國票97售01,2.49,2.49,2.49,2.49,+0.44,21.46,5000,1,12450,0,0,0,0,0,0,5000,0,5000,5000
20200312,72773P,鈊象國票96售01,0.02,0.04,0.02,0.04,+0.02,100.0,514000,5,12980,0,0,0,0,0,0,444000,0,444000,444000
20200312,72774P,精測群益96售02,1.70,1.70,1.70,1.70,+0.09,5.59,10000,1,17000,0,0,0,0,0,0,10000,0,10000,10000
20200312,72775P,精測統一96售02,,,,,,0.00,0,0,0,0,0,0,0,0,0,0,0,0,0
20200312,72776P,精測凱基96售05,0.98,1.19,0.97,1.16,+0.17,17.17,328000,16,344210,0,0,0,0,0,0,305000,23000,282000,282000
20200312,72777P,櫃200凱基96售04,,,,,,0.00,0,0,0,0,0,0,0,0,0,0,0,0,0
20200312,72778P,櫃200凱基96售05,1.09,1.09,1.09,1.09,+0.27,32.93,1000,1,1090,0,0,0,0,0,0,1000,0,1000,1000
20200312,72779P,鈊象凱基96售02,,,,,,0.00,0,0,0,0,0,0,0,0,0,0,0,0,0
20200312,72780P,鈊象台新96售01,0.07,0.07,0.07,0.07,+0.03,75.0,25000,1,1750,0,0,0,0,0,0,25000,0,25000,25000
20200312,72781P,鈊象永豐96售02,0.11,0.14,0.11,0.14,+0.07,100.0,221000,18,30280,0,0,0,0,0,0,0,221000,-221000,-221000
20200312,72782P,鈊象康和96售01,0.13,0.13,0.13,0.13,+0.05,62.5,396000,3,51480,0,0,0,0,0,0,396000,0,396000,396000
20200312,72783P,鈊象群益96售01,0.16,0.27,0.16,0.26,+0.11,73.33,1960000,20,425690,0,0,0,0,0,0,959000,880000,79000,79000
20200312,72784P,精測統一96售03,0.71,1.05,0.70,1.00,+0.30,42.86,551000,28,442110,0,0,0,0,0,0,188000,363000,-175000,-175000
20200312,72785P,鈊象元富96售02,0.11,0.18,0.11,0.18,+0.08,80.0,425000,11,60100,0,0,0,0,0,0,260000,125000,135000,135000
20200312,72786P,聯亞國票97售02,1.82,2.10,1.80,2.10,+0.52,32.91,87000,5,158720,0,0,0,0,0,0,72000,15000,57000,57000
20200312,72787P,精測永豐96售05,1.67,1.73,1.67,1.73,+0.10,6.13,20000,2,34000,0,0,0,0,0,0,0,20000,-20000,-20000
20200312,72788P,群聯群益96售03,0.65,0.93,0.65,0.92,+0.40,76.92,445000,13,342900,0,0,0,0,0,0,76000,369000,-293000,-293000
20200312,72789P,精測群益96售03,2.01,2.56,2.01,2.56,+0.57,28.64,20000,3,45500,0,0,0,0,0,0,15000,5000,10000,10000
20200312,72790P,精華群益96售01,,,,,,0.00,0,0,0,0,0,0,0,0,0,0,0,0,0
20200312,72791P,精測凱基96售06,0.92,1.24,0.92,1.21,+0.28,30.11,1316000,75,1392070,0,0,0,0,0,0,737000,484000,253000,253000
20200312,72792P,穩懋國票96售04,2.49,3.18,2.49,3.18,+1.02,47.22,41000,3,105580,0,0,0,0,0,0,40000,1000,39000,39000
20200312,72793P,穩懋兆豐96售03,1.29,1.55,1.29,1.55,+0.39,33.62,328000,11,452840,0,0,0,0,0,0,49000,279000,-230000,-230000
20200312,72794P,穩懋兆豐97售01,0.98,1.23,0.98,1.17,+0.31,36.05,519000,11,516370,0,0,0,0,0,0,440000,79000,361000,361000
20200312,72795P,鈊象元大96售02,0.08,0.11,0.08,0.11,+0.04,57.14,284000,3,30640,0,0,0,0,0,0,284000,0,284000,284000
20200312,72796P,穩懋統一97售02,1.66,2.07,1.66,2.05,+0.58,39.46,647000,41,1142520,0,0,0,0,0,0,309000,225000,84000,84000
20200312,72797P,鈊象統一97售01,0.06,0.08,0.06,0.08,-0.04,-33.33,140000,2,8600,0,0,0,0,0,0,140000,0,140000,140000
20200312,72798P,穩懋凱基96售08,1.23,1.70,1.23,1.55,+0.48,44.86,163000,25,237020,0,0,0,0,0,0,21000,137000,-116000,-116000
20200312,72799P,世界永豐96售01,,,,,,0.00,0,0,0,0,0,0,0,0,0,0,0,0,0
20200312,72800P,鈊象元富96售03,,,,,,0.00,0,0,0,0,0,0,0,0,0,0,0,0,0
20200312,72801P,中美晶元大96售01,0.91,1.06,0.91,1.06,+0.22,26.19,784000,20,789640,0,0,0,0,0,0,630000,614000,16000,16000
20200312,72802P,世界元大96售04,2.33,2.33,2.06,2.06,-0.22,-9.65,70000,5,156480,0,0,0,0,0,0,70000,30000,40000,40000
20200312,72803P,中美晶中信98售01,0.50,0.59,0.50,0.59,+0.12,25.53,709000,10,377860,0,0,0,0,0,0,504000,205000,299000,299000
20200312,72804P,世界中信96售02,1.04,1.04,0.93,0.93,-0.05,-5.1,234000,7,237020,0,0,0,0,0,0,224000,10000,214000,214000
20200312,72805P,鈊象元富96售04,0.27,0.28,0.24,0.28,+0.11,64.71,346000,4,93130,0,0,0,0,0,0,15000,331000,-316000,-316000
20200312,72806P,世界康和96售02,0.88,0.88,0.79,0.81,+0.03,3.85,410000,6,334460,0,0,0,0,0,0,100000,310000,-210000,-210000
20200312,72807P,網龍群益98售02,1.62,1.72,1.61,1.72,+0.23,15.44,128000,9,213460,0,0,0,0,0,0,128000,0,128000,128000
20200312,72808P,力旺康和96售01,1.33,1.33,1.33,1.33,+0.22,19.82,50000,1,66500,0,0,0,0,0,0,50000,0,50000,50000
20200312,72809P,聯亞元富96售01,1.68,1.93,1.65,1.92,+0.44,29.73,232000,10,408460,0,0,0,0,0,0,190000,42000,148000,148000
20200312,72810P,雙鴻元富96售02,2.73,3.10,2.66,3.01,+0.58,23.87,370000,16,1086440,0,0,0,0,0,0,295000,75000,220000,220000
20200312,72811P,鈊象元富96售05,0.21,0.24,0.21,0.24,+0.09,60.0,307000,5,72850,0,0,0,0,0,0,49000,258000,-209000,-209000
20200312,72812P,世界統一96售01,1.38,1.38,1.27,1.27,-0.08,-5.93,117000,11,155960,0,2000,-2000,0,0,0,103000,75000,28000,26000
20200312,72813P,宣德統一97售01,0.84,1.02,0.83,1.01,+0.27,36.49,289000,10,259950,0,0,0,0,0,0,66000,223000,-157000,-157000
20200312,72814P,世界群益98售03,2.12,2.20,2.03,2.04,-0.12,-5.56,97000,11,206220,0,0,0,0,0,0,29000,67000,-38000,-38000
20200312,72815P,宣德元大96售05,1.99,2.23,1.97,2.22,+0.29,15.03,377000,19,779480,0,0,0,0,0,0,311000,320000,-9000,-9000
20200312,72816P,信昌電國票97售02,1.59,1.59,1.59,1.59,+0.11,7.43,2000,1,3180,0,0,0,0,0,0,2000,0,2000,2000
20200312,72817P,網龍國票97售03,3.97,4.40,3.97,4.39,+0.77,21.27,159000,20,659490,0,0,0,0,0,0,40000,119000,-79000,-79000
20200312,72818P,櫃200第一96售05,,,,,,0.00,0,0,0,0,0,0,0,0,0,0,0,0,0
20200312,72819P,櫃200第一96售06,,,,,,0.00,0,0,0,0,0,0,0,0,0,0,0,0,0
20200312,72820P,中美晶兆豐97售01,1.01,1.14,1.01,1.14,+0.18,18.75,406000,15,441540,0,0,0,0,0,0,203000,313000,-110000,-110000
20200312,72821P,櫃200永昌97售02,3.90,3.90,3.90,3.90,+0.92,30.87,50000,1,195000,0,0,0,0,0,0,0,50000,-50000,-50000
20200312,72822P,櫃200永昌97售03,2.85,3.67,2.85,3.67,+1.31,55.51,17000,3,59620,0,0,0,0,0,0,2000,15000,-13000,-13000
20200312,72823P,櫃200永昌99售04,,,,,,0.00,0,0,0,0,0,0,0,0,0,0,0,0,0
20200312,72824P,櫃200永昌99售05,,,,,,0.00,0,0,0,0,0,0,0,0,0,0,0,0,0
20200312,72825P,緯軟永豐96售01,,,,,,0.00,0,0,0,0,0,0,0,0,0,0,0,0,0
20200312,72826P,穩懋統一96售11,1.76,1.87,1.76,1.87,+0.30,19.11,33000,2,60500,0,0,0,0,0,0,0,33000,-33000,-33000
20200312,72827P,穩懋統一96售12,2.23,2.39,2.23,2.39,+0.49,25.79,21000,2,46990,0,0,0,0,0,0,0,21000,-21000,-21000
20200312,72828P,新普凱基96售01,0.98,1.07,0.98,1.06,+0.21,24.71,276000,11,288070,0,0,0,0,0,0,104000,172000,-68000,-68000
20200312,72829P,神盾群益98售02,1.12,1.30,1.12,1.28,+0.22,20.75,135000,14,162530,0,0,0,0,0,0,120000,10000,110000,110000
20200312,72830P,櫃200永昌9B售02,,,,,,0.00,0,0,0,0,0,0,0,0,0,0,0,0,0
20200312,72831P,櫃200永昌9B售03,4.52,4.52,4.52,4.52,0.00,0.0,1000,1,4520,0,0,0,0,0,0,0,0,0,0
20200312,72832P,櫃200永昌9C售04,2.01,2.43,2.01,2.43,+0.74,43.79,40000,4,86700,0,0,0,0,0,0,40000,0,40000,40000
20200312,72833P,櫃200永昌9C售05,3.50,3.69,3.50,3.69,+0.59,19.03,17000,2,61400,0,0,0,0,0,0,17000,0,17000,17000
20200312,72834P,威剛元富99售01,1.01,1.17,0.99,1.17,+0.20,20.62,192000,17,208500,0,0,0,0,0,0,119000,73000,46000,46000
20200312,72835P,環球晶中信9A售01,0.94,1.10,0.94,0.96,+0.05,5.49,458000,47,466220,0,0,0,0,0,0,147000,311000,-164000,-164000
20200312,72836P,聯亞永豐96售02,1.49,1.59,1.49,1.59,+0.37,30.33,40000,4,61200,0,0,0,0,0,0,10000,30000,-20000,-20000
20200312,72837P,雙鴻永豐96售01,2.92,3.38,2.92,3.38,+0.58,20.71,78000,10,241020,0,0,0,0,0,0,66000,12000,54000,54000
20200312,72838P,M31元大96售03,1.69,1.91,1.69,1.91,+0.33,20.89,217000,6,390270,0,0,0,0,0,0,62000,155000,-93000,-93000
20200312,72839P,世界元富96售03,1.44,1.44,1.34,1.34,-0.07,-4.96,117000,5,165150,0,0,0,0,0,0,37000,80000,-43000,-43000
20200312,72840P,聖暉統一97售01,0.87,0.87,0.85,0.87,+0.08,10.13,60000,6,51700,0,0,0,0,0,0,60000,0,60000,60000
20200312,72841P,環球晶凱基96售09,1.31,1.68,1.25,1.25,+0.12,10.62,458000,17,679430,0,0,0,0,0,0,172000,426000,-254000,-254000
20200312,72842P,宣德永豐96售02,1.75,1.95,1.75,1.95,+0.35,21.87,44000,6,79510,0,0,0,0,0,0,0,44000,-44000,-44000
20200312,72843P,精測永豐96售11,1.94,1.94,1.94,1.94,+0.09,4.86,10000,1,19400,0,0,0,0,0,0,0,10000,-10000,-10000
20200312,72844P,精測國泰97售03,2.45,2.85,2.45,2.85,+0.37,14.92,21000,7,53710,0,0,0,0,0,0,11000,10000,1000,1000
20200312,72845P,精測元大96售05,2.76,3.19,2.75,3.19,+0.47,17.28,80000,5,232900,0,0,0,0,0,0,10000,80000,-70000,-70000
20200312,72846P,穩懋元大96售08,1.54,1.90,1.54,1.82,+0.52,40.0,112000,12,196100,0,0,0,0,0,0,92000,35000,57000,57000
20200312,72847P,鈊象元大96售05,0.29,0.45,0.27,0.45,+0.17,60.71,1582000,26,575420,0,0,0,0,0,0,851000,721000,130000,130000
20200312,72848P,信驊康和96售01,0.49,0.68,0.49,0.66,+0.05,8.2,1988000,58,1269570,0,0,0,0,0,0,1255000,652000,603000,603000
20200312,72849P,櫃200永昌98售03,,,,,,0.00,0,0,0,0,0,0,0,0,0,0,0,0,0
20200312,72850P,櫃200永昌98售04,,,,,,0.00,0,0,0,0,0,0,0,0,0,0,0,0,0
20200312,72851P,佳邦永豐96售02,1.20,1.20,1.20,1.20,+0.04,3.45,50000,1,60000,0,0,0,0,0,0,50000,0,50000,50000
20200312,72852P,信昌電永豐96售01,1.75,2.04,1.75,2.01,+0.29,16.86,77000,6,145250,0,0,0,0,0,0,37000,40000,-3000,-3000
20200312,72853P,穩懋元大96售09,1.61,2.03,1.61,1.96,+0.45,29.8,110000,8,194150,0,0,0,0,0,0,60000,65000,-5000,-5000
20200312,72854P,勝麗國票97售02,1.06,1.17,1.05,1.17,+0.19,19.39,336000,9,368420,0,0,0,0,0,0,180000,156000,24000,24000
20200312,72855P,精測元大96售06,2.33,2.66,2.33,2.66,+0.48,22.02,22000,7,54440,0,0,0,0,0,0,12000,10000,2000,2000
20200312,72856P,閎康統一96售01,,,,,,0.00,0,0,0,0,0,0,0,0,0,0,0,0,0
20200312,72857P,聯亞凱基96售02,1.30,1.43,1.30,1.43,+0.35,32.41,40000,3,54100,0,0,0,0,0,0,0,40000,-40000,-40000
20200312,72858P,直得永豐96售02,1.23,1.31,1.23,1.31,+0.17,14.91,32000,4,40820,0,0,0,0,0,0,0,32000,-32000,-32000
20200312,72859P,原相永豐96售02,0.29,0.42,0.29,0.42,+0.16,61.54,459000,19,167950,0,0,0,0,0,0,219000,240000,-21000,-21000
20200312,72860P,環球晶永豐96售01,1.21,1.34,1.12,1.12,+0.07,6.67,127000,7,162580,0,0,0,0,0,0,30000,117000,-87000,-87000
20200312,72861P,精測群益96售07,2.84,2.84,2.84,2.84,+0.12,4.41,10000,1,28400,0,0,0,0,0,0,10000,0,10000,10000
20200312,72862P,力旺國票96售01,2.69,2.90,2.69,2.90,+0.70,31.82,20000,2,55900,0,0,0,0,0,0,10000,10000,0,0
20200312,72863P,群聯元大96售05,2.04,2.68,2.04,2.68,+0.96,55.81,88000,8,206610,0,0,0,0,0,0,27000,70000,-43000,-43000
20200312,72864P,良維永豐96售04,2.67,2.83,2.67,2.83,+0.40,16.46,9000,3,24550,0,0,0,0,0,0,4000,5000,-1000,-1000
20200312,72865P,聯亞國票97售03,2.18,2.26,2.18,2.26,+0.64,39.51,42000,5,92020,0,0,0,0,0,0,0,42000,-42000,-42000
20200312,72866P,原相台新96售01,0.37,0.49,0.36,0.48,+0.17,54.84,2922000,27,1210570,0,0,0,0,0,0,2682000,240000,2442000,2442000
20200312,72867P,頎邦元富96售03,1.51,1.73,1.51,1.73,+0.30,20.98,237000,7,391640,0,0,0,0,0,0,10000,227000,-217000,-217000
20200312,72868P,頎邦永豐96售01,1.74,1.90,1.74,1.90,+0.29,18.01,92000,8,168450,0,0,0,0,0,0,5000,87000,-82000,-82000
20200312,72869P,頎邦元大96售01,2.83,3.15,2.83,3.08,+0.51,19.84,176000,13,525840,0,0,0,0,0,0,52000,170000,-118000,-118000
20200312,72870P,頎邦群益97售03,1.89,1.98,1.88,1.98,+0.30,17.86,34000,4,66020,0,0,0,0,0,0,4000,30000,-26000,-26000
20200312,72871P,鈊象國票97售02,0.17,0.24,0.16,0.24,+0.09,60.0,6541000,70,1379840,0,0,0,0,0,0,3232000,2988000,244000,244000
20200312,72872P,大江永豐96售04,2.97,3.15,2.97,3.15,+0.36,12.9,37000,5,112670,0,0,0,0,0,0,6000,31000,-25000,-25000
20200312,72873P,穩懋凱基96售14,2.03,2.03,2.03,2.03,+0.25,14.04,2000,1,4060,0,0,0,0,0,0,2000,0,2000,2000
20200312,72874P,台燿元富96售01,1.83,2.11,1.83,1.98,+0.32,19.28,111000,15,216450,0,0,0,0,0,0,25000,69000,-44000,-44000
20200312,72875P,碩禾台新97售02,0.97,1.07,0.97,1.07,+0.15,16.3,7000,2,7190,0,0,0,0,0,0,4000,3000,1000,1000
20200312,72876P,頎邦康和96售02,1.12,1.15,1.12,1.15,+0.19,19.79,84000,2,96480,0,0,0,0,0,0,84000,0,84000,84000
20200312,72877P,環球晶統一96售03,,,,,,0.00,0,0,0,0,0,0,0,0,0,0,0,0,0
20200312,72878P,穩懋統一96售13,1.80,2.31,1.80,2.31,+0.64,38.32,72000,9,151390,0,0,0,0,0,0,36000,36000,0,0
20200312,72879P,環球晶中信96售03,1.24,1.57,1.24,1.37,+0.19,16.1,118000,11,169270,0,0,0,0,0,0,66000,52000,14000,14000
20200312,72880P,台燿凱基96售04,1.16,1.34,1.16,1.34,+0.32,31.37,222000,8,264520,0,0,0,0,0,0,138000,84000,54000,54000
20200312,72881P,穩懋凱基96售15,1.56,2.00,1.56,1.94,+0.60,44.78,126000,9,207870,0,0,0,0,0,0,81000,45000,36000,36000
20200312,72882P,威剛國票96售02,0.86,1.03,0.83,1.03,+0.24,30.38,337000,20,317090,0,0,0,0,0,0,283000,54000,229000,229000
20200312,72883P,雍智國泰97售01,1.58,1.80,1.58,1.75,+0.15,9.37,168000,15,294400,0,0,0,0,0,0,58000,110000,-52000,-52000
20200312,72884P,中美晶元富97售01,1.32,1.53,1.31,1.38,+0.16,13.11,551000,31,753310,0,0,0,0,0,0,449000,195000,254000,254000
20200312,72885P,晶焱永豐97售02,1.33,1.46,1.33,1.42,+0.17,13.6,46000,11,64240,0,0,0,0,0,0,14000,32000,-18000,-18000
20200312,72886P,旺矽康和97售01,1.18,1.35,1.18,1.35,+0.25,22.73,87000,4,105640,0,0,0,0,0,0,61000,26000,35000,35000
20200312,72887P,威剛康和97售01,0.60,0.62,0.60,0.62,+0.12,24.0,115000,2,70540,0,0,0,0,0,0,0,115000,-115000,-115000
20200312,72888P,中美晶中信99售01,0.67,0.68,0.67,0.68,+0.13,23.64,102000,2,68540,0,0,0,0,0,0,82000,102000,-20000,-20000
20200312,72889P,合晶永豐97售02,1.90,2.08,1.90,2.08,+0.27,14.92,50000,5,99500,0,0,0,0,0,0,10000,40000,-30000,-30000
20200312,72890P,金居永豐97售01,2.40,3.02,2.40,3.02,+0.65,27.43,60000,7,158080,0,0,0,0,0,0,20000,40000,-20000,-20000
20200312,72891P,優群永豐97售02,0.53,0.66,0.53,0.61,+0.12,24.49,1038000,55,618540,0,0,0,0,0,0,656000,264000,392000,392000
20200312,72892P,精測康和97售01,1.40,1.40,1.40,1.40,+0.12,9.38,3000,1,4200,0,0,0,0,0,0,3000,0,3000,3000
20200312,72893P,櫃200群益97售03,3.44,4.11,3.44,4.00,+1.41,54.44,19000,4,72830,0,0,0,0,0,0,9000,10000,-1000,-1000
20200312,72894P,中美晶凱基97售03,0.70,0.82,0.70,0.82,+0.23,38.98,359000,6,269400,0,0,0,0,0,0,359000,0,359000,359000
20200312,72895P,穩懋日盛97售03,2.42,3.02,2.42,3.02,+0.84,38.53,248000,16,636560,0,0,0,0,0,0,71000,177000,-106000,-106000
20200312,72896P,廣明永豐97售02,3.29,3.48,3.29,3.48,+0.49,16.39,34000,4,113970,0,0,0,0,0,0,0,34000,-34000,-34000
20200312,72897P,璟德永豐97售01,1.72,2.00,1.72,2.00,+0.32,19.05,225000,14,403540,0,0,0,0,0,0,150000,75000,75000,75000
20200312,72898P,雙鴻國票98售01,1.62,1.62,1.62,1.62,+0.10,6.58,5000,1,8100,0,0,0,0,0,0,0,5000,-5000,-5000
20200312,72899P,中美晶群益97售02,1.05,1.07,1.05,1.07,+0.06,5.94,28000,2,29620,0,0,0,0,0,0,11000,17000,-6000,-6000
20200312,72900P,聯亞群益97售01,3.10,3.33,3.10,3.33,+0.53,18.93,68000,6,221380,0,0,0,0,0,0,38000,30000,8000,8000
20200312,72901P,穩懋統一97售04,2.27,2.45,2.27,2.45,+0.59,31.72,162000,4,391940,0,0,0,0,0,0,0,162000,-162000,-162000
20200312,72902P,精測元富97售01,2.63,2.99,2.63,2.99,+0.45,17.72,114000,6,314830,0,0,0,0,0,0,19000,95000,-76000,-76000
20200312,72903P,中美晶國票97售03,2.14,2.32,2.13,2.32,+0.33,16.58,103000,8,225930,0,0,0,0,0,0,44000,59000,-15000,-15000
20200312,72904P,大江群益97售03,,,,,,0.00,0,0,0,0,0,0,0,0,0,0,0,0,0
20200312,72905P,穩懋國泰98售01,1.96,2.58,1.96,2.58,+0.74,40.22,322000,22,711060,0,0,0,0,0,0,230000,92000,138000,138000
20200312,72906P,穩懋國泰99售01,1.76,2.15,1.76,2.11,+0.49,30.25,1340000,44,2558120,0,0,0,0,0,0,1099000,251000,848000,848000
20200312,72907P,穩懋兆豐98售01,2.52,2.95,2.52,2.89,+0.57,24.57,201000,12,550160,0,0,0,0,0,0,85000,116000,-31000,-31000
20200312,72908P,原相永豐97售01,0.48,0.68,0.48,0.65,+0.17,35.42,582000,35,340210,0,0,0,0,0,0,327000,225000,102000,102000
20200312,72909P,穩懋永豐97售01,1.82,1.87,1.82,1.87,+0.56,42.75,20000,2,36900,0,0,0,0,0,0,10000,20000,-10000,-10000
20200312,72910P,穩懋統一99售02,2.19,2.19,2.19,2.19,+0.17,8.42,9000,1,19710,0,0,0,0,0,0,0,9000,-9000,-9000
20200312,72911P,穩懋元大97售05,2.67,3.53,2.67,3.38,+0.94,38.52,189000,9,596950,0,0,0,0,0,0,154000,150000,4000,4000
20200312,72912P,原相中信99售02,0.97,1.11,0.88,1.11,+0.25,29.07,1332000,51,1325200,0,0,0,0,0,0,1113000,222000,891000,891000
20200312,72913P,旺矽統一97售02,1.46,1.48,1.45,1.46,+0.08,5.8,114000,13,167070,0,0,0,0,0,0,114000,0,114000,114000
20200312,72914P,穩懋元大97售06,2.58,3.11,2.58,3.00,+0.87,40.85,189000,7,531440,0,0,0,0,0,0,115000,189000,-74000,-74000
20200312,72915P,中美晶凱基97售06,1.15,1.46,1.15,1.36,+0.33,32.04,491000,11,654160,0,0,0,0,0,0,296000,195000,101000,101000
20200312,72916P,穩懋凱基97售04,1.60,1.82,1.60,1.82,+0.46,33.82,24000,3,41700,0,0,0,0,0,0,0,24000,-24000,-24000
20200312,72917P,網龍國票98售01,2.70,2.87,2.70,2.87,+0.40,16.19,12000,2,34100,0,0,0,0,0,0,12000,0,12000,12000
20200312,72918P,環球晶元富97售02,1.85,2.24,1.79,1.79,+0.07,4.07,168000,17,339770,0,0,0,0,0,0,107000,61000,46000,46000
20200312,72919P,聯亞元富97售02,2.53,2.80,2.53,2.80,+0.45,19.15,63000,8,165720,0,0,0,0,0,0,34000,29000,5000,5000
20200312,72920P,雙鴻元富97售02,1.45,1.63,1.39,1.61,+0.31,23.85,1202000,42,1803780,0,0,0,0,0,0,1082000,115000,967000,967000
20200312,72921P,雙鴻元大98售01,1.39,1.54,1.39,1.54,+0.18,13.24,251000,9,352810,0,0,0,0,0,0,215000,36000,179000,179000
20200312,72922P,原相亞東99售01,0.95,1.17,0.90,1.15,+0.31,36.9,515000,62,525180,0,0,0,0,0,0,394000,33000,361000,361000
20200312,72923P,台燿永豐97售01,1.09,1.20,1.09,1.20,+0.25,26.32,81000,4,90590,0,0,0,0,0,0,51000,30000,21000,21000
20200312,72924P,精測凱基97售05,2.85,2.85,2.85,2.85,+0.13,4.78,25000,2,71250,0,0,0,0,0,0,0,25000,-25000,-25000
20200312,72925P,鈊象凱基97售02,0.30,0.44,0.29,0.41,+0.13,46.43,1348000,46,486960,0,0,0,0,0,0,639000,629000,10000,10000
20200312,72926P,精華元大97售02,4.51,4.75,4.51,4.75,+0.75,18.75,15000,3,69100,0,0,0,0,0,0,0,10000,-10000,-10000
20200312,72927P,大江元富97售02,3.51,3.75,3.50,3.75,+0.39,11.61,153000,13,545530,0,0,0,0,0,0,65000,88000,-23000,-23000
20200312,72928P,宜鼎元富97售02,0.92,1.08,0.89,1.03,+0.23,28.75,296000,25,289290,0,0,0,0,0,0,93000,203000,-110000,-110000
20200312,72929P,信驊元富97售02,1.29,1.53,1.29,1.53,+0.30,24.39,1371000,53,1970120,0,0,0,0,0,0,1121000,110000,1011000,1011000
20200312,72930P,威剛元富97售03,1.24,1.42,1.21,1.42,+0.29,25.66,398000,27,520360,0,0,0,0,0,0,244000,154000,90000,90000
20200312,72931P,新普元富97售02,1.91,2.02,1.90,1.98,+0.15,8.2,120000,8,231850,0,0,0,0,0,0,95000,25000,70000,70000
20200312,72932P,網家元富97售02,1.02,1.35,1.02,1.35,+0.49,56.98,262000,18,329010,0,0,0,0,0,0,151000,111000,40000,40000
20200312,72933P,碩禾永豐97售01,1.52,1.52,1.52,1.52,+0.19,14.29,10000,1,15200,0,0,0,0,0,0,0,10000,-10000,-10000
20200312,72934P,晟德永豐97售01,2.09,2.19,2.09,2.19,+0.12,5.8,45000,5,95500,0,0,0,0,0,0,5000,40000,-35000,-35000
20200312,72935P,鈊象永豐97售03,0.61,0.84,0.61,0.80,+0.20,33.33,263000,20,184200,0,0,0,0,0,0,245000,18000,227000,227000
20200312,72936P,鈊象元富97售03,0.45,0.67,0.42,0.67,+0.27,67.5,3263000,92,1787870,0,0,0,0,0,0,2370000,516000,1854000,1854000
20200312,72937P,櫃200元大99售01,,,,,,0.00,0,0,0,0,0,0,0,0,0,0,0,0,0
20200312,72938P,櫃200元大99售02,3.04,3.04,3.04,3.04,+1.79,143.2,10000,1,30400,0,0,0,0,0,0,10000,0,10000,10000
20200312,72939P,網龍元大97售02,6.05,6.05,6.00,6.00,+0.85,16.5,2000,2,12050,0,0,0,0,0,0,1000,1000,0,0
20200312,72940P,環球晶群益97售04,2.17,2.59,2.17,2.40,+0.37,18.23,159000,12,371090,0,0,0,0,0,0,135000,64000,71000,71000
20200312,72941P,環球晶統一97售03,2.47,2.47,2.47,2.47,+0.49,24.75,5000,1,12350,0,0,0,0,0,0,0,5000,-5000,-5000
20200312,72942P,群聯元富97售01,2.80,3.51,2.77,3.35,+0.96,40.17,333000,27,1068760,0,0,0,0,0,0,260000,73000,187000,187000
20200312,72943P,雙鴻元富97售03,2.41,2.72,2.35,2.69,+0.47,21.17,650000,64,1601000,0,0,0,0,0,0,450000,139000,311000,311000
20200312,72944P,信昌電元富97售01,3.23,3.60,3.18,3.60,+0.55,18.03,217000,15,719570,0,0,0,0,0,0,42000,175000,-133000,-133000
20200312,72945P,大江永豐97售04,2.71,2.71,2.71,2.71,+0.12,4.63,6000,1,16260,0,0,0,0,0,0,6000,0,6000,6000
20200312,72946P,穩懋富邦99售02,1.61,1.85,1.61,1.80,+0.34,23.29,207000,16,353360,0,0,0,0,0,0,108000,114000,-6000,-6000
20200312,72947P,環球晶凱基97售08,2.92,3.47,2.92,2.97,+0.23,8.39,63000,6,195310,0,0,0,0,0,0,50000,53000,-3000,-3000
20200312,72948P,大江元大97售06,1.61,1.81,1.61,1.81,+0.26,16.77,158000,12,257890,0,0,0,0,0,0,131000,27000,104000,104000
20200312,72949P,環球晶永豐97售02,2.30,2.63,2.30,2.63,+0.45,20.64,145000,9,347630,0,0,0,0,0,0,113000,52000,61000,61000
20200312,72950P,中美晶元富97售02,1.99,2.25,1.99,2.02,+0.15,8.02,221000,21,464580,0,0,0,0,0,0,96000,126000,-30000,-30000
20200312,72951P,宣德元富97售02,2.01,2.30,2.01,2.30,+0.34,17.35,169000,7,352210,0,0,0,0,0,0,144000,25000,119000,119000
20200312,72952P,群聯元富97售02,3.87,4.66,3.83,4.66,+1.24,36.26,209000,12,915870,0,0,0,0,0,0,139000,70000,69000,69000
20200312,72953P,環球晶元富97售05,2.81,3.35,2.79,2.80,+0.18,6.87,175000,19,526480,0,0,0,0,0,0,104000,71000,33000,33000
20200312,72954P,穩懋元富97售05,3.80,4.58,3.79,4.58,+1.36,42.24,125000,10,488860,0,0,0,0,0,0,83000,42000,41000,41000
20200312,72955P,中美晶元大98售02,1.51,1.78,1.51,1.71,+0.23,15.54,838000,32,1417670,0,0,0,0,0,0,810000,622000,188000,188000
20200312,72956P,信驊元大98售01,1.50,1.64,1.50,1.62,+0.15,10.2,2710000,62,4251440,0,0,0,0,0,0,2188000,1425000,763000,763000
20200312,72957P,精測元富98售01,3.37,3.59,3.37,3.54,+0.37,11.67,110000,4,384210,0,0,0,0,0,0,32000,78000,-46000,-46000
20200312,72958P,威剛元大98售03,1.02,1.19,1.02,1.17,+0.18,18.18,999000,43,1086100,0,0,0,0,0,0,727000,394000,333000,333000
20200312,72959P,大江永豐98售02,1.35,1.40,1.35,1.40,+0.13,10.24,39000,5,53390,0,0,0,0,0,0,17000,20000,-3000,-3000
20200312,72960P,中美晶永豐98售01,1.24,1.24,1.22,1.22,+0.29,31.18,130000,4,160560,0,0,0,0,0,0,130000,0,130000,130000
20200312,72961P,環球晶國泰99售01,2.22,2.60,2.19,2.27,+0.18,8.61,673000,36,1580990,0,0,0,0,0,0,366000,398000,-32000,-32000
20200312,72962P,鈊象元富98售01,0.80,1.01,0.73,1.01,+0.26,34.67,5111000,175,4600960,0,0,0,0,0,0,4037000,809000,3228000,3228000
20200312,72963P,環球晶凱基98售03,2.67,3.11,2.67,3.11,+0.56,21.96,50000,6,142010,0,0,0,0,0,0,42000,30000,12000,12000
20200312,72964P,環球晶元大98售05,3.76,4.48,3.76,3.99,+0.43,12.08,382000,40,1623930,0,0,0,0,0,0,159000,243000,-84000,-84000
20200312,72965P,環球晶元大98售06,3.29,3.77,3.22,3.26,+0.12,3.82,799000,54,2765540,0,0,0,0,0,0,224000,586000,-362000,-362000
20200312,72966P,環球晶元大98售07,2.57,2.89,2.53,2.53,+0.10,4.12,164000,23,436040,0,0,0,0,0,0,114000,70000,44000,44000
20200312,72967P,精測國泰9A售02,2.17,2.43,2.15,2.40,+0.25,11.63,253000,23,574920,0,0,0,0,0,0,239000,114000,125000,125000
20200312,72968P,大江元富98售03,3.14,3.56,3.12,3.56,+0.57,19.06,121000,15,390060,0,0,0,0,0,0,19000,102000,-83000,-83000
20200312,72969P,精測元大98售03,4.39,5.05,4.39,4.95,+0.72,17.02,33000,6,150050,0,0,0,0,0,0,25000,8000,17000,17000
20200312,72970P,原相永豐98售01,1.05,1.40,1.05,1.40,+0.31,28.44,1130000,59,1415560,0,0,0,0,0,0,794000,316000,478000,478000
20200312,72971P,穩懋凱基98售05,,,,,,0.00,0,0,0,0,0,0,0,0,0,0,0,0,0
20200312,72972P,大江元富98售04,2.09,2.38,2.06,2.38,+0.39,19.6,107000,14,234230,0,0,0,0,0,0,36000,71000,-35000,-35000
20200312,72973P,大江富邦9A售03,1.10,1.22,1.09,1.21,+0.16,15.24,337000,8,381460,0,0,0,0,0,0,27000,310000,-283000,-283000
20200312,72974P,精測元大98售04,1.54,1.81,1.54,1.74,+0.24,16.0,347000,19,580890,0,0,0,0,0,0,211000,183000,28000,28000
20200312,72975P,緯軟元大9A售01,1.01,1.01,1.01,1.01,+0.03,3.06,20000,1,20200,0,0,0,0,0,0,0,20000,-20000,-20000
20200312,72976P,環球晶元大98售08,3.58,4.51,3.45,3.58,+0.25,7.51,440000,38,1772830,0,0,0,0,0,0,330000,125000,205000,205000
20200312,72977P,晶焱永豐98售02,1.19,1.30,1.19,1.30,+0.16,14.04,268000,9,337280,0,0,0,0,0,0,180000,88000,92000,92000
20200312,72978P,新鉅科元大98售02,3.59,3.91,3.55,3.86,+0.54,16.27,383000,18,1442180,0,0,0,0,0,0,197000,186000,11000,11000
20200312,72979P,聯亞元大98售02,3.22,3.23,3.22,3.23,+0.42,14.95,10000,2,32220,0,0,0,0,0,0,10000,0,10000,10000
20200312,72980P,穩懋元大98售03,5.60,6.35,5.60,6.25,+1.15,22.55,47000,4,275450,0,0,0,0,0,0,47000,45000,2000,2000
20200312,72981P,聯亞凱基98售03,1.48,1.50,1.48,1.50,+0.44,41.51,30000,2,44800,0,0,0,0,0,0,30000,0,30000,30000
20200312,72982P,精測元大98售05,2.77,3.17,2.77,3.04,+0.31,11.36,111000,5,324970,0,0,0,0,0,0,30000,81000,-51000,-51000
20200312,72983P,穩懋元大98售04,6.50,6.50,6.40,6.40,+1.05,19.63,25000,3,161000,0,0,0,0,0,0,25000,15000,10000,10000
20200312,72984P,威剛永豐98售02,1.26,1.48,1.25,1.44,+0.24,20.0,283000,24,382850,0,0,0,0,0,0,148000,117000,31000,31000
20200312,72985P,群聯元富98售03,2.14,2.65,2.11,2.57,+0.68,35.98,182000,14,448760,0,0,0,0,0,0,136000,46000,90000,90000
20200312,72986P,環球晶元大98售11,3.46,4.04,3.41,3.41,+0.12,3.65,187000,15,655160,0,0,0,0,0,0,142000,60000,82000,82000
20200312,72987P,環球晶元大98售12,4.07,4.93,4.07,4.13,+0.17,4.29,155000,29,680640,0,0,0,0,0,0,110000,82000,28000,28000
20200312,72988P,聯亞元大98售03,1.96,2.20,1.94,2.19,+0.46,26.59,201000,12,413140,0,0,0,0,0,0,154000,113000,41000,41000
20200312,72989P,信昌電永豐98售02,1.92,2.09,1.92,2.09,+0.38,22.22,30000,3,59700,0,0,0,0,0,0,0,30000,-30000,-30000
20200312,72990P,環球晶凱基98售06,2.66,3.23,2.66,2.70,+0.25,10.2,180000,24,510370,0,0,0,0,0,0,108000,95000,13000,13000
20200312,72991P,穩懋凱基98售08,2.85,3.22,2.85,3.22,+0.67,26.27,57000,6,171500,0,0,0,0,0,0,47000,10000,37000,37000
20200312,72992P,穩懋永豐98售02,2.31,2.61,2.31,2.61,+0.67,34.54,114000,6,277340,0,0,0,0,0,0,10000,114000,-104000,-104000
20200312,72993P,穩懋元富98售01,3.57,4.15,3.57,4.15,+1.16,38.8,142000,13,527520,0,0,0,0,0,0,49000,93000,-44000,-44000
20200312,72994P,穩懋元富98售02,3.47,4.04,3.47,3.96,+0.77,24.14,271000,11,978640,0,0,0,0,0,0,172000,99000,73000,73000
20200312,72995P,雙鴻兆豐99售02,0.79,0.87,0.79,0.86,+0.11,14.67,528000,17,436730,0,0,0,0,0,0,300000,228000,72000,72000
20200312,72996P,力旺元富98售02,3.44,3.64,3.44,3.64,+0.54,17.42,25000,3,88200,0,0,0,0,0,0,8000,17000,-9000,-9000
20200312,72997P,精測台新98售02,1.41,1.66,1.40,1.65,+0.24,17.02,359000,13,531410,0,0,0,0,0,0,167000,192000,-25000,-25000
20200312,72998P,穩懋台新98售01,,,,,,0.00,0,0,0,0,0,0,0,0,0,0,0,0,0
20200312,72999P,環球晶群益98售03,5.25,6.35,5.25,5.25,+0.42,8.7,196000,13,1110600,0,0,0,0,0,0,181000,55000,126000,126000
20200312,73000P,穩懋富邦99售03,2.80,3.16,2.80,3.09,+0.55,21.65,395000,13,1151890,0,0,0,0,0,0,267000,143000,124000,124000
20200312,73001P,譜瑞元大98售05,5.20,6.15,5.20,6.15,+1.23,25.0,18000,11,100050,0,0,0,0,0,0,15000,3000,12000,12000
20200312,73002P,精測元富98售03,2.16,2.56,2.16,2.56,+0.47,22.49,241000,14,552350,0,0,0,0,0,0,80000,161000,-81000,-81000
20200312,73003P,神盾群益9A售04,1.37,1.51,1.34,1.51,+0.21,16.15,32000,4,44220,0,0,0,0,0,0,10000,22000,-12000,-12000
20200312,73004P,譜瑞台新99售01,1.83,2.19,1.82,2.19,+0.49,28.82,97000,9,184050,0,0,0,0,0,0,39000,58000,-19000,-19000
20200312,73005P,中美晶元大98售07,2.23,2.53,2.23,2.30,+0.09,4.07,101000,10,235280,0,0,0,0,0,0,48000,53000,-5000,-5000
20200312,73006P,聯亞元大98售04,2.55,2.97,2.55,2.97,+0.52,21.22,120000,14,323820,0,0,0,0,0,0,117000,3000,114000,114000
20200312,73007P,中美晶元富98售01,1.72,1.83,1.71,1.76,+0.12,7.32,130000,9,229150,0,0,0,0,0,0,25000,105000,-80000,-80000
20200312,73008P,合晶元富98售02,2.12,2.37,2.12,2.37,+0.36,17.91,36000,4,80770,0,0,0,0,0,0,0,36000,-36000,-36000
20200312,73009P,原相元富98售02,1.89,2.23,1.89,2.19,+0.43,24.43,394000,19,777740,0,0,0,0,0,0,371000,23000,348000,348000
20200312,73010P,勝麗元富98售01,2.40,2.63,2.40,2.63,+0.38,16.89,63000,7,154580,0,0,0,0,0,0,10000,53000,-43000,-43000
20200312,73011P,原相台新98售01,1.22,1.46,1.22,1.46,+0.27,22.69,528000,34,689760,0,0,0,0,0,0,428000,69000,359000,359000
20200312,73012P,威剛統一98售02,1.01,1.15,0.99,1.15,+0.24,26.37,235000,15,243370,0,0,0,0,0,0,189000,46000,143000,143000
20200312,73013P,中美晶群益98售05,2.58,2.81,2.58,2.81,+0.25,9.77,74000,5,196560,0,0,0,0,0,0,58000,16000,42000,42000
20200312,73014P,環球晶國泰9A售02,3.07,3.51,3.04,3.04,+0.06,2.01,118000,11,376920,0,0,0,0,0,0,112000,26000,86000,86000
20200312,73015P,碩禾元大99售04,,,,,,0.00,0,0,0,0,0,0,0,0,0,0,0,0,0
20200312,73016P,精測元大98售06,4.35,4.63,4.35,4.63,+0.33,7.67,57000,4,256770,0,0,0,0,0,0,27000,30000,-3000,-3000
20200312,73017P,環球晶統一99售05,1.52,1.52,1.39,1.39,+0.03,2.21,45000,5,65700,0,0,0,0,0,0,40000,5000,35000,35000
20200312,73018P,威剛國票99售02,1.23,1.43,1.23,1.43,+0.29,25.44,80000,8,106050,0,0,0,0,0,0,10000,70000,-60000,-60000
20200312,73019P,穩懋國泰99售02,2.42,2.87,2.42,2.87,+0.59,25.88,657000,23,1730730,0,0,0,0,0,0,335000,330000,5000,5000
20200312,73020P,穩懋亞東98售02,2.79,2.79,2.79,2.79,+0.74,36.1,27000,2,75330,0,0,0,0,0,0,0,27000,-27000,-27000
20200312,73021P,原相元大99售02,1.39,1.57,1.39,1.56,+0.20,14.71,3300000,107,4855180,0,0,0,0,0,0,2907000,341000,2566000,2566000
20200312,73022P,台燿中信9A售02,1.14,1.28,1.14,1.20,+0.13,12.15,37000,4,43940,0,0,0,0,0,0,33000,4000,29000,29000
20200312,73023P,新普中信9C售01,0.99,1.02,0.99,1.02,+0.07,7.37,674000,22,683530,0,0,0,0,0,0,144000,500000,-356000,-356000
20200312,73024P,譜瑞中信9C售01,0.79,0.91,0.79,0.91,+0.15,19.74,100000,6,79910,0,0,0,0,0,0,79000,21000,58000,58000
20200312,73025P,譜瑞凱基98售03,1.57,1.84,1.54,1.80,+0.31,20.81,977000,38,1548250,0,0,0,0,0,0,660000,317000,343000,343000
20200312,73026P,泰博永豐98售02,1.43,1.59,1.43,1.49,+0.16,12.03,201000,15,307540,0,0,0,0,0,0,34000,167000,-133000,-133000
20200312,73027P,雙鴻元大9A售02,1.24,1.38,1.24,1.36,+0.17,14.29,188000,11,251310,0,0,0,0,0,0,65000,123000,-58000,-58000
20200312,73028P,中美晶統一9B售01,1.00,1.10,1.00,1.10,+0.14,14.58,76000,6,77480,0,0,0,0,0,0,68000,7000,61000,61000
20200312,73029P,中美晶凱基99售06,2.00,2.14,2.00,2.14,+0.21,10.88,181000,5,371160,0,0,0,0,0,0,110000,71000,39000,39000
20200312,73030P,大江群益99售01,2.11,2.22,2.11,2.22,+0.17,8.29,24000,3,51820,0,0,0,0,0,0,14000,10000,4000,4000
20200312,73031P,宏捷科康和99售02,1.45,1.57,1.45,1.55,+0.15,10.71,178000,12,270640,0,0,0,0,0,0,163000,15000,148000,148000
20200312,73032P,雙鴻群益9B售01,1.11,1.18,1.11,1.14,+0.10,9.62,28000,5,31610,0,0,0,0,0,0,13000,15000,-2000,-2000
20200312,73033P,宏捷科國票99售01,2.20,2.71,2.20,2.48,+0.36,16.98,221000,12,541060,0,0,0,0,0,0,163000,58000,105000,105000
20200312,73034P,大江富邦9B售01,1.07,1.15,1.07,1.15,+0.10,9.52,112000,6,120920,0,0,0,0,0,0,27000,85000,-58000,-58000
20200312,73035P,中美晶台新99售01,1.86,2.10,1.86,2.10,+0.31,17.32,227000,12,443690,0,0,0,0,0,0,143000,84000,59000,59000
20200312,73036P,鈊象永豐99售02,1.16,1.40,1.10,1.40,+0.32,29.63,737000,58,906320,0,0,0,0,0,0,594000,99000,495000,495000
20200312,73037P,海韻電元富99售02,2.04,2.14,2.04,2.14,+0.23,12.04,50000,4,103400,0,0,0,0,0,0,20000,30000,-10000,-10000
20200312,73038P,中美晶台新99售02,2.06,2.38,2.05,2.30,+0.33,16.75,126000,16,275520,0,0,0,0,0,0,85000,41000,44000,44000
20200312,73039P,原相台新99售01,1.76,1.94,1.73,1.90,+0.28,17.28,241000,22,433060,0,0,0,0,0,0,151000,60000,91000,91000
20200312,73040P,穩懋凱基99售04,1.74,1.74,1.74,1.74,+0.18,11.54,17000,1,29580,0,0,0,0,0,0,17000,0,17000,17000
20200312,73041P,穩懋統一9B售02,0.96,1.05,0.96,1.05,+0.18,20.69,162000,9,161170,0,0,0,0,0,0,36000,123000,-87000,-87000
20200312,73042P,原相元大99售04,2.84,3.27,2.82,3.19,+0.50,18.59,363000,37,1072630,0,0,0,0,0,0,169000,225000,-56000,-56000
20200312,73043P,穩懋元大99售04,4.06,4.68,4.06,4.61,+1.12,32.09,32000,7,139640,0,0,0,0,0,0,20000,27000,-7000,-7000
20200312,73044P,原相國票9A售01,2.42,2.76,2.39,2.76,+0.50,22.12,292000,16,757320,0,0,0,0,0,0,72000,220000,-148000,-148000
20200312,73045P,雙鴻國票9A售02,1.48,1.62,1.44,1.60,+0.31,24.03,119000,15,187370,0,0,0,0,0,0,20000,99000,-79000,-79000
20200312,73046P,神盾群益9A售05,1.68,1.80,1.68,1.77,+0.12,7.27,70000,5,120600,0,0,0,0,0,0,40000,30000,10000,10000
20200312,73047P,宏捷科元富9C售03,1.92,2.13,1.91,2.10,+0.23,12.3,428000,16,868260,0,0,0,0,0,0,238000,190000,48000,48000
20200312,73048P,中美晶中信9B售01,0.95,1.03,0.95,1.03,+0.12,13.19,4000,2,3880,0,0,0,0,0,0,0,4000,-4000,-4000
20200312,73049P,宏捷科元大99售05,1.13,1.28,1.13,1.24,+0.13,11.71,287000,24,343480,0,0,0,0,0,0,130000,157000,-27000,-27000
20200312,73050P,雍智元大99售02,1.03,1.03,1.03,1.03,+0.12,13.19,39000,1,40170,0,0,0,0,0,0,0,39000,-39000,-39000
20200312,73051P,台燿元富9C售02,3.48,3.57,3.48,3.57,+0.32,9.85,76000,5,268620,0,0,0,0,0,0,0,76000,-76000,-76000
20200312,73052P,原相統一99售03,1.02,1.21,1.02,1.18,+0.17,16.83,181000,10,200800,0,0,0,0,0,0,143000,33000,110000,110000
20200312,73053P,原相統一9A售02,0.95,1.07,0.94,1.07,+0.18,20.22,172000,10,173440,0,0,0,0,0,0,71000,101000,-30000,-30000
20200312,73054P,穩懋元大99售08,2.18,2.47,2.18,2.46,+0.46,23.0,157000,15,360710,0,0,0,0,0,0,33000,145000,-112000,-112000
20200312,73055P,信驊永豐99售03,1.25,1.33,1.25,1.26,+0.02,1.61,176000,13,225340,0,0,0,0,0,0,129000,37000,92000,92000
20200312,73056P,原相永豐99售02,1.24,1.33,1.24,1.33,+0.24,22.02,30000,3,38550,0,0,0,0,0,0,0,30000,-30000,-30000
20200312,73057P,環球晶兆豐99售02,1.72,1.72,1.64,1.66,+0.07,4.4,40000,6,66800,0,0,0,0,0,0,0,40000,-40000,-40000
20200312,73058P,原相統一9B售02,1.05,1.05,1.01,1.01,+0.12,13.48,15000,2,15350,0,0,0,0,0,0,0,15000,-15000,-15000
20200312,702038,中光電台新97購01,,,,,,0.00,0,0,0,0,0,0,0,0,0,0,0,0,0
20200312,702039,群聯台新97購01,8.80,8.80,6.00,6.05,-4.15,-40.69,124000,25,874700,0,0,0,0,0,0,6000,118000,-112000,-112000
20200312,702968,金可群益93購01,,,,,,0.00,0,0,0,0,0,0,0,0,0,0,0,0,0
20200312,702972,富喬群益93購01,,,,,,0.00,0,0,0,0,0,0,0,0,0,0,0,0,0
20200312,703531,昇達科群益94購01,,,,,,0.00,0,0,0,0,0,0,0,0,0,0,0,0,0
20200312,703576,由田群益94購01,,,,,,0.00,0,0,0,0,0,0,0,0,0,0,0,0,0
20200312,704122,中光電元大94購01,,,,,,0.00,0,0,0,0,0,0,0,0,0,0,0,0,0
20200312,704248,神盾元大93購01,,,,,,0.00,0,0,0,0,0,0,0,0,0,0,0,0,0
20200312,704310,大宇資元大93購01,,,,,,0.00,0,0,0,0,0,0,0,0,0,0,0,0,0
20200312,704322,雙鴻凱基93購01,,,,,,0.00,0,0,0,0,0,0,0,0,0,0,0,0,0
20200312,704390,三貝德元大93購01,,,,,,0.00,0,0,0,0,0,0,0,0,0,0,0,0,0
20200312,704391,碩禾元大93購01,0.78,0.78,0.50,0.50,-0.48,-48.98,29000,3,17930,0,0,0,0,0,0,0,29000,-29000,-29000
20200312,704428,緯軟元大93購01,,,,,,0.00,0,0,0,0,0,0,0,0,0,0,0,0,0
20200312,704444,原相中信95購01,,,,,,0.00,0,0,0,0,0,0,0,0,0,0,0,0,0
20200312,704460,創惟元大94購01,,,,,,0.00,0,0,0,0,0,0,0,0,0,0,0,0,0
20200312,704484,元太中信95購01,,,,,,0.00,0,0,0,0,0,0,0,0,0,0,0,0,0
20200312,704518,聯亞元富94購01,,,,,,0.00,0,0,0,0,0,0,0,0,0,0,0,0,0
20200312,704521,神盾元大94購01,0.06,0.06,0.06,0.06,-0.08,-57.14,10000,1,600,0,0,0,0,0,0,0,10000,-10000,-10000
20200312,704522,緯軟元大94購01,,,,,,0.00,0,0,0,0,0,0,0,0,0,0,0,0,0
20200312,704589,由田元大94購01,,,,,,0.00,0,0,0,0,0,0,0,0,0,0,0,0,0
20200312,704640,大宇資群益94購01,,,,,,0.00,0,0,0,0,0,0,0,0,0,0,0,0,0
20200312,704667,波若威群益94購01,0.01,0.01,0.01,0.01,-0.02,-66.67,10000,1,100,0,0,0,0,0,0,10000,0,10000,10000
20200312,704712,三貝德群益94購01,,,,,,0.00,0,0,0,0,0,0,0,0,0,0,0,0,0
20200312,704718,神盾元大94購02,,,,,,0.00,0,0,0,0,0,0,0,0,0,0,0,0,0
20200312,704739,鈊象兆豐93購01,,,,,,0.00,0,0,0,0,0,0,0,0,0,0,0,0,0
20200312,704751,VHQ群益94購01,,,,,,0.00,0,0,0,0,0,0,0,0,0,0,0,0,0
20200312,704753,VHQ元大93購01,,,,,,0.00,0,0,0,0,0,0,0,0,0,0,0,0,0
20200312,704756,中美晶元大93購04,,,,,,0.00,0,0,0,0,0,0,0,0,0,0,0,0,0
20200312,704766,群聯中信93購01,,,,,,0.00,0,0,0,0,0,0,0,0,0,0,0,0,0
20200312,704777,碩禾群益94購01,0.22,0.22,0.12,0.12,-0.18,-60.0,130000,2,26600,0,0,0,0,0,0,130000,0,130000,130000
20200312,704792,鈊象國泰93購01,,,,,,0.00,0,0,0,0,0,0,0,0,0,0,0,0,0
20200312,704794,三貝德元大93購02,,,,,,0.00,0,0,0,0,0,0,0,0,0,0,0,0,0
20200312,704811,聯亞凱基93購01,,,,,,0.00,0,0,0,0,0,0,0,0,0,0,0,0,0
20200312,704812,穩懋凱基93購01,,,,,,0.00,0,0,0,0,0,0,0,0,0,0,0,0,0
20200312,704813,M31群益93購01,,,,,,0.00,0,0,0,0,0,0,0,0,0,0,0,0,0
20200312,704818,元太凱基93購01,,,,,,0.00,0,0,0,0,0,0,0,0,0,0,0,0,0
20200312,704823,穩懋凱基93購05,0.77,0.86,0.77,0.77,-0.78,-50.32,6000,3,4800,0,0,0,0,0,0,0,6000,-6000,-6000
20200312,704825,六角台新93購01,0.01,0.01,0.01,0.01,0.00,0.0,40000,1,400,0,0,0,0,0,0,40000,0,40000,40000
20200312,704853,由田國票93購02,,,,,,0.00,0,0,0,0,0,0,0,0,0,0,0,0,0
20200312,704856,原相富邦93購01,,,,,,0.00,0,0,0,0,0,0,0,0,0,0,0,0,0
20200312,704867,大江凱基93購02,,,,,,0.00,0,0,0,0,0,0,0,0,0,0,0,0,0
20200312,704868,大江凱基93購03,,,,,,0.00,0,0,0,0,0,0,0,0,0,0,0,0,0
20200312,704869,大江凱基93購04,,,,,,0.00,0,0,0,0,0,0,0,0,0,0,0,0,0
20200312,704873,穩懋凱基93購07,0.40,0.40,0.40,0.40,-0.33,-45.21,11000,2,4400,0,0,0,0,0,0,11000,0,11000,11000
20200312,704874,穩懋凱基93購08,0.39,0.39,0.16,0.16,-0.53,-76.81,28000,2,9080,0,0,0,0,0,0,20000,8000,12000,12000
20200312,704875,穩懋中信95購01,0.57,0.57,0.41,0.41,-0.28,-40.58,349000,15,158010,0,0,0,0,0,0,79000,308000,-229000,-229000
20200312,704878,六角國泰93購01,,,,,,0.00,0,0,0,0,0,0,0,0,0,0,0,0,0
20200312,704879,晟德富邦93購01,,,,,,0.00,0,0,0,0,0,0,0,0,0,0,0,0,0
20200312,704885,精測兆豐93購01,,,,,,0.00,0,0,0,0,0,0,0,0,0,0,0,0,0
20200312,704888,神盾中信94購01,0.03,0.03,0.03,0.03,-0.07,-70.0,100000,1,3000,0,0,0,0,0,0,100000,0,100000,100000
20200312,704896,聯亞凱基93購02,,,,,,0.00,0,0,0,0,0,0,0,0,0,0,0,0,0
20200312,704900,頎邦凱基93購01,,,,,,0.00,0,0,0,0,0,0,0,0,0,0,0,0,0
20200312,704901,頎邦凱基93購02,,,,,,0.00,0,0,0,0,0,0,0,0,0,0,0,0,0
20200312,704903,廣明國泰93購01,,,,,,0.00,0,0,0,0,0,0,0,0,0,0,0,0,0
20200312,704910,鈺太元大93購01,,,,,,0.00,0,0,0,0,0,0,0,0,0,0,0,0,0
20200312,704912,宜鼎兆豐93購01,,,,,,0.00,0,0,0,0,0,0,0,0,0,0,0,0,0
20200312,704924,宏捷科元大93購02,0.69,0.69,0.44,0.44,-1.01,-69.66,208000,3,135080,0,0,0,0,0,0,99000,109000,-10000,-10000
20200312,704925,原相亞東93購01,2.86,2.86,2.86,2.86,-1.53,-34.85,30000,3,85800,0,0,0,0,0,0,0,30000,-30000,-30000
20200312,704933,晟德兆豐93購01,,,,,,0.00,0,0,0,0,0,0,0,0,0,0,0,0,0
20200312,704938,大江凱基93購05,,,,,,0.00,0,0,0,0,0,0,0,0,0,0,0,0,0
20200312,704947,聯亞凱基93購03,,,,,,0.00,0,0,0,0,0,0,0,0,0,0,0,0,0
20200312,704948,穩懋凱基93購09,,,,,,0.00,0,0,0,0,0,0,0,0,0,0,0,0,0
20200312,704949,大江凱基93購06,,,,,,0.00,0,0,0,0,0,0,0,0,0,0,0,0,0
20200312,704953,神盾凱基93購01,,,,,,0.00,0,0,0,0,0,0,0,0,0,0,0,0,0
20200312,704955,環球晶凱基93購01,,,,,,0.00,0,0,0,0,0,0,0,0,0,0,0,0,0
20200312,704956,聯亞凱基93購04,0.10,0.10,0.10,0.10,-0.26,-72.22,10000,1,1000,0,0,0,0,0,0,10000,0,10000,10000
20200312,704957,頎邦凱基93購03,,,,,,0.00,0,0,0,0,0,0,0,0,0,0,0,0,0
20200312,704958,台半統一93購01,,,,,,0.00,0,0,0,0,0,0,0,0,0,0,0,0,0
20200312,704960,M31元大93購01,,,,,,0.00,0,0,0,0,0,0,0,0,0,0,0,0,0
20200312,704970,合晶國泰93購01,,,,,,0.00,0,0,0,0,0,0,0,0,0,0,0,0,0
20200312,704980,穩懋統一93購01,,,,,,0.00,0,0,0,0,0,0,0,0,0,0,0,0,0
20200312,704982,伍豐凱基93購01,,,,,,0.00,0,0,0,0,0,0,0,0,0,0,0,0,0
20200312,704990,穩懋凱基93購10,,,,,,0.00,0,0,0,0,0,0,0,0,0,0,0,0,0
20200312,704992,鐿鈦凱基93購01,,,,,,0.00,0,0,0,0,0,0,0,0,0,0,0,0,0
20200312,704999,神盾元大94購03,,,,,,0.00,0,0,0,0,0,0,0,0,0,0,0,0,0
20200312,705010,穩懋中信95購02,0.38,0.38,0.27,0.27,-0.21,-43.75,89000,10,25050,0,0,0,0,0,0,0,89000,-89000,-89000
20200312,705011,中美晶統一93購01,,,,,,0.00,0,0,0,0,0,0,0,0,0,0,0,0,0
20200312,705012,穩懋統一93購02,,,,,,0.00,0,0,0,0,0,0,0,0,0,0,0,0,0
20200312,705016,智擎凱基93購01,,,,,,0.00,0,0,0,0,0,0,0,0,0,0,0,0,0
20200312,705017,精華凱基93購01,,,,,,0.00,0,0,0,0,0,0,0,0,0,0,0,0,0
20200312,705018,精華凱基93購02,,,,,,0.00,0,0,0,0,0,0,0,0,0,0,0,0,0
20200312,705020,譜瑞凱基93購02,0.59,0.59,0.51,0.56,-1.09,-66.06,21000,3,11290,0,0,0,0,0,0,0,21000,-21000,-21000
20200312,705022,穩懋亞東93購01,,,,,,0.00,0,0,0,0,0,0,0,0,0,0,0,0,0
20200312,705042,雙鴻群益93購01,0.09,0.09,0.09,0.09,-0.32,-78.05,5000,1,450,0,0,0,0,0,0,5000,0,5000,5000
20200312,705046,雙鴻凱基93購03,,,,,,0.00,0,0,0,0,0,0,0,0,0,0,0,0,0
20200312,705054,鴻碩國泰93購01,,,,,,0.00,0,0,0,0,0,0,0,0,0,0,0,0,0
20200312,705055,雙鴻國泰93購02,,,,,,0.00,0,0,0,0,0,0,0,0,0,0,0,0,0
20200312,705056,穩懋富邦93購03,,,,,,0.00,0,0,0,0,0,0,0,0,0,0,0,0,0
20200312,705059,宏捷科群益93購01,0.40,0.40,0.24,0.24,-0.68,-73.91,274000,5,73760,0,0,0,0,0,0,224000,30000,194000,194000
20200312,705060,大宇資元大94購01,,,,,,0.00,0,0,0,0,0,0,0,0,0,0,0,0,0
20200312,705063,神盾元大93購03,,,,,,0.00,0,0,0,0,0,0,0,0,0,0,0,0,0
20200312,705082,雙鴻元大93購02,0.04,0.04,0.04,0.04,-0.04,-50.0,140000,14,5600,0,0,0,0,0,0,0,140000,-140000,-140000
20200312,705084,六角國票93購01,,,,,,0.00,0,0,0,0,0,0,0,0,0,0,0,0,0
20200312,705088,保瑞國泰93購01,,,,,,0.00,0,0,0,0,0,0,0,0,0,0,0,0,0
20200312,705097,聚積凱基93購01,,,,,,0.00,0,0,0,0,0,0,0,0,0,0,0,0,0
20200312,705107,碩禾國泰93購01,,,,,,0.00,0,0,0,0,0,0,0,0,0,0,0,0,0
20200312,705144,晶焱兆豐94購01,,,,,,0.00,0,0,0,0,0,0,0,0,0,0,0,0,0
20200312,705149,神盾群益94購01,,,,,,0.00,0,0,0,0,0,0,0,0,0,0,0,0,0
20200312,705158,美琪瑪國泰94購01,,,,,,0.00,0,0,0,0,0,0,0,0,0,0,0,0,0
20200312,705164,原相富邦94購01,,,,,,0.00,0,0,0,0,0,0,0,0,0,0,0,0,0
20200312,705174,神盾元大95購01,0.27,0.27,0.19,0.19,-0.15,-44.12,644000,18,146680,0,0,0,0,0,0,331000,313000,18000,18000
20200312,705181,昇達科國泰94購01,,,,,,0.00,0,0,0,0,0,0,0,0,0,0,0,0,0
20200312,705203,緯軟元大95購01,,,,,,0.00,0,0,0,0,0,0,0,0,0,0,0,0,0
20200312,705285,原相元大94購01,,,,,,0.00,0,0,0,0,0,0,0,0,0,0,0,0,0
20200312,705287,緯軟元大94購02,,,,,,0.00,0,0,0,0,0,0,0,0,0,0,0,0,0
20200312,705299,宏觀元大94購01,,,,,,0.00,0,0,0,0,0,0,0,0,0,0,0,0,0
20200312,705308,大江群益94購01,,,,,,0.00,0,0,0,0,0,0,0,0,0,0,0,0,0
20200312,705311,大中凱基93購01,,,,,,0.00,0,0,0,0,0,0,0,0,0,0,0,0,0
20200312,705312,台半凱基93購01,,,,,,0.00,0,0,0,0,0,0,0,0,0,0,0,0,0
20200312,705313,台燿凱基93購05,,,,,,0.00,0,0,0,0,0,0,0,0,0,0,0,0,0
20200312,705315,廣明凱基93購01,,,,,,0.00,0,0,0,0,0,0,0,0,0,0,0,0,0
20200312,705316,M31元大93購02,,,,,,0.00,0,0,0,0,0,0,0,0,0,0,0,0,0
20200312,705317,由田元大93購01,,,,,,0.00,0,0,0,0,0,0,0,0,0,0,0,0,0
20200312,705319,金居元大94購01,0.07,0.07,0.03,0.03,-0.06,-66.67,810000,72,30700,0,0,0,0,0,0,0,810000,-810000,-810000
20200312,705320,泰博元大93購01,,,,,,0.00,0,0,0,0,0,0,0,0,0,0,0,0,0
20200312,705321,鈊象元大93購02,,,,,,0.00,0,0,0,0,0,0,0,0,0,0,0,0,0
20200312,705323,緯軟國泰93購02,,,,,,0.00,0,0,0,0,0,0,0,0,0,0,0,0,0
20200312,705335,上詮元大94購01,,,,,,0.00,0,0,0,0,0,0,0,0,0,0,0,0,0
20200312,705336,聚積元大93購02,,,,,,0.00,0,0,0,0,0,0,0,0,0,0,0,0,0
20200312,705338,頎邦元大93購03,,,,,,0.00,0,0,0,0,0,0,0,0,0,0,0,0,0
20200312,705340,中美晶亞東93購01,,,,,,0.00,0,0,0,0,0,0,0,0,0,0,0,0,0
20200312,705344,原相國泰93購01,,,,,,0.00,0,0,0,0,0,0,0,0,0,0,0,0,0
20200312,705345,精華兆豐93購01,,,,,,0.00,0,0,0,0,0,0,0,0,0,0,0,0,0
20200312,705346,譜瑞兆豐93購01,,,,,,0.00,0,0,0,0,0,0,0,0,0,0,0,0,0
20200312,705348,力旺群益93購01,,,,,,0.00,0,0,0,0,0,0,0,0,0,0,0,0,0
20200312,705353,六角元大93購02,,,,,,0.00,0,0,0,0,0,0,0,0,0,0,0,0,0
20200312,705356,神盾元大94購04,,,,,,0.00,0,0,0,0,0,0,0,0,0,0,0,0,0
20200312,705372,中美晶群益93購01,,,,,,0.00,0,0,0,0,0,0,0,0,0,0,0,0,0
20200312,705373,優群群益94購01,2.19,2.20,2.16,2.20,-1.48,-40.22,25000,3,54700,0,0,0,0,0,0,0,25000,-25000,-25000
20200312,705376,力旺凱基93購02,,,,,,0.00,0,0,0,0,0,0,0,0,0,0,0,0,0
20200312,705378,直得凱基93購01,,,,,,0.00,0,0,0,0,0,0,0,0,0,0,0,0,0
20200312,705383,璟德凱基93購01,,,,,,0.00,0,0,0,0,0,0,0,0,0,0,0,0,0
20200312,705390,聚積兆豐93購01,,,,,,0.00,0,0,0,0,0,0,0,0,0,0,0,0,0
20200312,705400,良維國泰93購01,,,,,,0.00,0,0,0,0,0,0,0,0,0,0,0,0,0
20200312,705401,穩懋國泰93購01,,,,,,0.00,0,0,0,0,0,0,0,0,0,0,0,0,0
20200312,705402,智擎中信93購01,,,,,,0.00,0,0,0,0,0,0,0,0,0,0,0,0,0
20200312,705409,威剛富邦94購01,,,,,,0.00,0,0,0,0,0,0,0,0,0,0,0,0,0
20200312,705410,M31元大93購03,,,,,,0.00,0,0,0,0,0,0,0,0,0,0,0,0,0
20200312,705416,六角兆豐93購01,,,,,,0.00,0,0,0,0,0,0,0,0,0,0,0,0,0
20200312,705419,威剛群益93購01,,,,,,0.00,0,0,0,0,0,0,0,0,0,0,0,0,0
20200312,705420,新普群益94購01,1.47,1.47,1.47,1.47,-0.48,-24.62,10000,1,14700,0,0,0,0,0,0,10000,0,10000,10000
20200312,705427,威剛統一94購01,,,,,,0.00,0,0,0,0,0,0,0,0,0,0,0,0,0
20200312,705429,M31凱基93購01,,,,,,0.00,0,0,0,0,0,0,0,0,0,0,0,0,0
20200312,705430,上詮凱基93購01,,,,,,0.00,0,0,0,0,0,0,0,0,0,0,0,0,0
20200312,705431,禾昌凱基93購01,,,,,,0.00,0,0,0,0,0,0,0,0,0,0,0,0,0
20200312,705433,威剛凱基93購01,4.37,4.37,3.35,3.55,-2.05,-36.61,51000,6,193450,0,0,0,0,0,0,0,51000,-51000,-51000
20200312,705437,穩懋凱基93購12,0.16,0.16,0.16,0.16,-0.34,-68.0,10000,1,1600,0,0,0,0,0,0,10000,0,10000,10000
20200312,705439,合晶國票93購01,,,,,,0.00,0,0,0,0,0,0,0,0,0,0,0,0,0
20200312,705441,原相國票94購01,,,,,,0.00,0,0,0,0,0,0,0,0,0,0,0,0,0
20200312,705442,大江國泰93購01,,,,,,0.00,0,0,0,0,0,0,0,0,0,0,0,0,0
20200312,705443,威剛國泰93購01,,,,,,0.00,0,0,0,0,0,0,0,0,0,0,0,0,0
20200312,705444,環球晶富邦94購01,,,,,,0.00,0,0,0,0,0,0,0,0,0,0,0,0,0
20200312,705445,環球晶麥證93購01,,,,,,0.00,0,0,0,0,0,0,0,0,0,0,0,0,0
20200312,705448,環球晶元富93購01,,,,,,0.00,0,0,0,0,0,0,0,0,0,0,0,0,0
20200312,705450,環球晶兆豐93購01,,,,,,0.00,0,0,0,0,0,0,0,0,0,0,0,0,0
20200312,705452,三貝德元大93購03,,,,,,0.00,0,0,0,0,0,0,0,0,0,0,0,0,0
20200312,705461,頎邦群益94購01,,,,,,0.00,0,0,0,0,0,0,0,0,0,0,0,0,0
20200312,705463,立端亞東93購01,,,,,,0.00,0,0,0,0,0,0,0,0,0,0,0,0,0
20200312,705464,環球晶亞東93購01,,,,,,0.00,0,0,0,0,0,0,0,0,0,0,0,0,0
20200312,705475,穩懋麥證93購02,0.03,0.03,0.03,0.03,-0.18,-85.71,4000,1,120,4000,0,4000,0,0,0,4000,0,4000,4000
20200312,705478,群聯兆豐93購01,,,,,,0.00,0,0,0,0,0,0,0,0,0,0,0,0,0
20200312,705479,聯亞兆豐93購02,,,,,,0.00,0,0,0,0,0,0,0,0,0,0,0,0,0
20200312,705482,M31中信93購01,,,,,,0.00,0,0,0,0,0,0,0,0,0,0,0,0,0
20200312,705487,直得凱基93購02,,,,,,0.00,0,0,0,0,0,0,0,0,0,0,0,0,0
20200312,705488,威剛凱基94購01,3.11,3.17,2.09,2.09,-2.45,-53.96,75000,8,215650,0,0,0,0,0,0,5000,75000,-70000,-70000
20200312,705490,博智凱基93購01,,,,,,0.00,0,0,0,0,0,0,0,0,0,0,0,0,0
20200312,705492,群聯亞東94購01,,,,,,0.00,0,0,0,0,0,0,0,0,0,0,0,0,0
20200312,705497,建榮永豐94購01,0.04,0.04,0.03,0.03,-0.06,-66.67,287000,3,9410,0,0,0,0,0,0,287000,0,287000,287000
20200312,705503,保瑞國泰98購01,0.52,0.52,0.46,0.46,-0.08,-14.81,164000,9,78790,0,0,0,0,0,0,159000,5000,154000,154000
20200312,705504,威剛國泰93購03,,,,,,0.00,0,0,0,0,0,0,0,0,0,0,0,0,0
20200312,705505,博智國泰93購01,,,,,,0.00,0,0,0,0,0,0,0,0,0,0,0,0,0
20200312,705506,台燿統一93購01,,,,,,0.00,0,0,0,0,0,0,0,0,0,0,0,0,0
20200312,705507,由田統一94購01,,,,,,0.00,0,0,0,0,0,0,0,0,0,0,0,0,0
20200312,705510,穩懋中信94購02,0.30,0.30,0.30,0.30,-0.38,-55.88,65000,2,19500,0,0,0,0,0,0,60000,5000,55000,55000
20200312,705513,信驊凱基93購01,1.47,1.47,1.19,1.19,-0.62,-34.25,16000,2,21840,0,0,0,0,0,0,10000,6000,4000,4000
20200312,705514,信驊凱基93購02,,,,,,0.00,0,0,0,0,0,0,0,0,0,0,0,0,0
20200312,705516,穩懋凱基93購14,,,,,,0.00,0,0,0,0,0,0,0,0,0,0,0,0,0
20200312,705518,環球晶元富93購02,2.27,2.27,1.50,1.71,-1.40,-45.02,100000,11,193830,0,0,0,0,0,0,0,100000,-100000,-100000
20200312,705519,鐿鈦國票93購01,,,,,,0.00,0,0,0,0,0,0,0,0,0,0,0,0,0
20200312,705523,威剛國泰94購01,2.08,2.08,2.08,2.08,-1.06,-33.76,20000,1,41600,0,0,0,0,0,0,0,20000,-20000,-20000
20200312,705524,中美晶富邦93購01,,,,,,0.00,0,0,0,0,0,0,0,0,0,0,0,0,0
20200312,705525,昇達科富邦94購01,,,,,,0.00,0,0,0,0,0,0,0,0,0,0,0,0,0
20200312,705526,神盾富邦93購01,,,,,,0.00,0,0,0,0,0,0,0,0,0,0,0,0,0
20200312,705549,神盾麥證93購01,,,,,,0.00,0,0,0,0,0,0,0,0,0,0,0,0,0
20200312,705554,神盾兆豐93購01,,,,,,0.00,0,0,0,0,0,0,0,0,0,0,0,0,0
20200312,705558,旺矽群益93購01,,,,,,0.00,0,0,0,0,0,0,0,0,0,0,0,0,0
20200312,705565,原相元大93購01,,,,,,0.00,0,0,0,0,0,0,0,0,0,0,0,0,0
20200312,705566,晶焱元大93購03,,,,,,0.00,0,0,0,0,0,0,0,0,0,0,0,0,0
20200312,705571,大宇資凱基94購01,,,,,,0.00,0,0,0,0,0,0,0,0,0,0,0,0,0
20200312,705573,宜鼎凱基93購01,2.24,2.24,1.70,1.70,-2.34,-57.92,60000,6,122000,0,0,0,0,0,0,0,60000,-60000,-60000
20200312,705574,是方凱基93購01,0.21,0.21,0.21,0.21,-0.14,-40.0,40000,1,8400,0,0,0,0,0,0,40000,0,40000,40000
20200312,705578,群翊國泰93購01,,,,,,0.00,0,0,0,0,0,0,0,0,0,0,0,0,0
20200312,705579,大江富邦94購01,,,,,,0.00,0,0,0,0,0,0,0,0,0,0,0,0,0
20200312,705580,昂寶富邦95購01,,,,,,0.00,0,0,0,0,0,0,0,0,0,0,0,0,0
20200312,705581,群聯富邦93購01,,,,,,0.00,0,0,0,0,0,0,0,0,0,0,0,0,0
20200312,705583,雙鴻中信94購01,,,,,,0.00,0,0,0,0,0,0,0,0,0,0,0,0,0
20200312,705585,神盾國票94購01,,,,,,0.00,0,0,0,0,0,0,0,0,0,0,0,0,0
20200312,705586,泰博國泰93購01,1.23,1.23,1.23,1.23,-0.58,-32.04,100000,1,123000,0,0,0,0,0,0,100000,0,100000,100000
20200312,705587,神盾國泰94購01,,,,,,0.00,0,0,0,0,0,0,0,0,0,0,0,0,0
20200312,705588,大江富邦94購02,,,,,,0.00,0,0,0,0,0,0,0,0,0,0,0,0,0
20200312,705590,神盾永豐93購01,,,,,,0.00,0,0,0,0,0,0,0,0,0,0,0,0,0
20200312,705597,雙鴻元大93購03,,,,,,0.00,0,0,0,0,0,0,0,0,0,0,0,0,0
20200312,705608,威剛元富95購01,,,,,,0.00,0,0,0,0,0,0,0,0,0,0,0,0,0
20200312,705609,神盾國票94購02,,,,,,0.00,0,0,0,0,0,0,0,0,0,0,0,0,0
20200312,705611,昂寶國泰94購01,,,,,,0.00,0,0,0,0,0,0,0,0,0,0,0,0,0
20200312,705612,網龍國泰94購01,,,,,,0.00,0,0,0,0,0,0,0,0,0,0,0,0,0
20200312,705613,晶焱兆豐93購01,,,,,,0.00,0,0,0,0,0,0,0,0,0,0,0,0,0
20200312,705617,良維元大93購02,,,,,,0.00,0,0,0,0,0,0,0,0,0,0,0,0,0
20200312,705627,宏捷科永豐93購01,,,,,,0.00,0,0,0,0,0,0,0,0,0,0,0,0,0
20200312,705629,建榮永豐94購02,,,,,,0.00,0,0,0,0,0,0,0,0,0,0,0,0,0
20200312,705636,譜瑞凱基94購01,2.43,2.58,1.50,1.50,-1.31,-46.62,148000,13,350300,0,0,0,0,0,0,38000,127000,-89000,-89000
20200312,705640,雙鴻元大93購04,,,,,,0.00,0,0,0,0,0,0,0,0,0,0,0,0,0
20200312,705641,中美晶國泰93購01,,,,,,0.00,0,0,0,0,0,0,0,0,0,0,0,0,0
20200312,705642,泰博國泰93購02,,,,,,0.00,0,0,0,0,0,0,0,0,0,0,0,0,0
20200312,705643,環球晶國泰93購03,,,,,,0.00,0,0,0,0,0,0,0,0,0,0,0,0,0
20200312,705661,大江群益95購01,,,,,,0.00,0,0,0,0,0,0,0,0,0,0,0,0,0
20200312,705662,保瑞群益94購01,0.32,0.32,0.30,0.31,-0.16,-34.04,110000,14,33880,0,0,0,0,0,0,110000,0,110000,110000
20200312,705663,環球晶群益94購01,3.46,3.46,3.46,3.46,-1.16,-25.11,10000,1,34600,0,0,0,0,0,0,10000,0,10000,10000
20200312,705664,原相麥證94購01,,,,,,0.00,0,0,0,0,0,0,0,0,0,0,0,0,0
20200312,705667,建榮國泰94購01,,,,,,0.00,0,0,0,0,0,0,0,0,0,0,0,0,0
20200312,705668,勝麗國泰94購01,,,,,,0.00,0,0,0,0,0,0,0,0,0,0,0,0,0
20200312,705669,鈺太國泰94購01,,,,,,0.00,0,0,0,0,0,0,0,0,0,0,0,0,0
20200312,705670,建榮國票94購01,,,,,,0.00,0,0,0,0,0,0,0,0,0,0,0,0,0
20200312,705679,鈺太永豐94購01,,,,,,0.00,0,0,0,0,0,0,0,0,0,0,0,0,0
20200312,705683,建榮統一95購01,,,,,,0.00,0,0,0,0,0,0,0,0,0,0,0,0,0
20200312,705684,建榮統一96購01,0.05,0.06,0.04,0.04,-0.05,-55.56,311000,11,14240,0,0,0,0,0,0,10000,295000,-285000,-285000
20200312,705685,建榮統一96購02,,,,,,0.00,0,0,0,0,0,0,0,0,0,0,0,0,0
20200312,705690,威剛元大94購01,,,,,,0.00,0,0,0,0,0,0,0,0,0,0,0,0,0
20200312,705695,建榮國票95購01,,,,,,0.00,0,0,0,0,0,0,0,0,0,0,0,0,0
20200312,705696,鈺太國票95購01,,,,,,0.00,0,0,0,0,0,0,0,0,0,0,0,0,0
20200312,705698,保瑞國泰95購01,1.01,1.01,0.75,0.86,-0.34,-28.33,1984000,70,1753880,0,0,0,0,0,0,1929000,55000,1874000,1874000
20200312,705701,建榮永豐95購01,,,,,,0.00,0,0,0,0,0,0,0,0,0,0,0,0,0
20200312,705702,宣德富邦95購01,0.65,0.65,0.58,0.58,-0.25,-30.12,390000,23,235450,0,0,0,0,0,0,390000,0,390000,390000
20200312,705706,建榮群益94購01,,,,,,0.00,0,0,0,0,0,0,0,0,0,0,0,0,0
20200312,705710,同致元大94購01,,,,,,0.00,0,0,0,0,0,0,0,0,0,0,0,0,0
20200312,705712,邦特中信94購01,,,,,,0.00,0,0,0,0,0,0,0,0,0,0,0,0,0
20200312,705720,雙鴻永豐94購01,,,,,,0.00,0,0,0,0,0,0,0,0,0,0,0,0,0
20200312,705727,緯軟兆豐94購01,,,,,,0.00,0,0,0,0,0,0,0,0,0,0,0,0,0
20200312,705730,群聯元富96購01,0.35,0.35,0.19,0.20,-0.34,-62.96,761000,28,174430,0,0,0,0,0,0,355000,426000,-71000,-71000
20200312,705735,信昌電國泰94購01,0.23,0.23,0.23,0.23,-0.47,-67.14,15000,1,3450,0,0,0,0,0,0,15000,0,15000,15000
20200312,705736,建榮國泰95購01,,,,,,0.00,0,0,0,0,0,0,0,0,0,0,0,0,0
20200312,705740,榮剛中信94購01,,,,,,0.00,0,0,0,0,0,0,0,0,0,0,0,0,0
20200312,705741,富喬統一96購01,,,,,,0.00,0,0,0,0,0,0,0,0,0,0,0,0,0
20200312,705742,穩懋統一94購01,0.11,0.11,0.09,0.09,-0.14,-60.87,92000,4,8480,0,0,0,0,0,0,92000,0,92000,92000
20200312,705743,三貝德元大94購01,,,,,,0.00,0,0,0,0,0,0,0,0,0,0,0,0,0
20200312,705744,宣德元大95購01,0.82,0.82,0.82,0.82,-0.26,-24.07,10000,1,8200,0,0,0,0,0,0,10000,0,10000,10000
20200312,705750,群聯兆豐94購01,0.12,0.12,0.03,0.03,-0.20,-86.96,167000,18,7920,0,0,0,0,0,0,7000,160000,-153000,-153000
20200312,705756,緯軟國泰94購01,,,,,,0.00,0,0,0,0,0,0,0,0,0,0,0,0,0
20200312,705760,光頡凱基94購01,,,,,,0.00,0,0,0,0,0,0,0,0,0,0,0,0,0
20200312,705763,穩懋凱基94購01,,,,,,0.00,0,0,0,0,0,0,0,0,0,0,0,0,0
20200312,705767,環球晶元大95購01,,,,,,0.00,0,0,0,0,0,0,0,0,0,0,0,0,0
20200312,705775,宜鼎群益96購01,,,,,,0.00,0,0,0,0,0,0,0,0,0,0,0,0,0
20200312,705776,原相群益96購01,,,,,,0.00,0,0,0,0,0,0,0,0,0,0,0,0,0
20200312,705781,群聯統一95購01,0.10,0.11,0.10,0.11,-0.11,-50.0,110000,2,11100,0,0,0,0,0,0,0,110000,-110000,-110000
20200312,705784,穩懋統一94購02,,,,,,0.00,0,0,0,0,0,0,0,0,0,0,0,0,0
20200312,705787,榮剛元大94購01,,,,,,0.00,0,0,0,0,0,0,0,0,0,0,0,0,0
20200312,705788,緯軟元大96購01,,,,,,0.00,0,0,0,0,0,0,0,0,0,0,0,0,0
20200312,705791,大江凱基94購01,,,,,,0.00,0,0,0,0,0,0,0,0,0,0,0,0,0
20200312,705799,聯亞凱基94購01,0.25,0.25,0.25,0.25,-0.34,-57.63,10000,1,2500,0,0,0,0,0,0,10000,0,10000,10000
20200312,705800,穩懋凱基94購02,,,,,,0.00,0,0,0,0,0,0,0,0,0,0,0,0,0
20200312,705801,宏捷科國泰94購01,1.10,1.10,1.10,1.10,-0.48,-30.38,10000,1,11000,0,0,0,0,0,0,10000,0,10000,10000
20200312,705802,金居富邦95購01,,,,,,0.00,0,0,0,0,0,0,0,0,0,0,0,0,0
20200312,705803,原相富邦97購01,3.30,3.30,3.30,3.30,-0.47,-12.47,2000,1,6600,0,0,0,0,0,0,2000,2000,0,0
20200312,705804,晶焱富邦95購01,0.06,0.06,0.06,0.06,-0.02,-25.0,1000,1,60,0,0,0,0,0,0,1000,0,1000,1000
20200312,705805,環球晶富邦97購01,1.36,1.41,0.92,1.41,-0.20,-12.42,116000,20,143330,0,0,0,0,0,0,28000,99000,-71000,-71000
20200312,705810,原相兆豐94購01,,,,,,0.00,0,0,0,0,0,0,0,0,0,0,0,0,0
20200312,705811,晶焱兆豐94購02,,,,,,0.00,0,0,0,0,0,0,0,0,0,0,0,0,0
20200312,705820,昇達科群益94購02,,,,,,0.00,0,0,0,0,0,0,0,0,0,0,0,0,0
20200312,705826,立端亞東94購01,,,,,,0.00,0,0,0,0,0,0,0,0,0,0,0,0,0
20200312,705831,建榮永豐94購03,,,,,,0.00,0,0,0,0,0,0,0,0,0,0,0,0,0
20200312,705838,上詮凱基94購01,,,,,,0.00,0,0,0,0,0,0,0,0,0,0,0,0,0
20200312,705845,廣明凱基94購01,,,,,,0.00,0,0,0,0,0,0,0,0,0,0,0,0,0
20200312,705846,台燿統一95購01,,,,,,0.00,0,0,0,0,0,0,0,0,0,0,0,0,0
20200312,705847,環球晶統一99購01,2.83,2.96,2.10,2.82,-0.16,-5.37,140000,42,339940,0,0,0,0,0,0,37000,93000,-56000,-56000
20200312,705848,禾昌元富96購01,,,,,,0.00,0,0,0,0,0,0,0,0,0,0,0,0,0
20200312,705869,穩懋元大96購01,0.95,0.95,0.65,0.66,-0.54,-45.0,323000,20,234560,0,0,0,0,0,0,135000,188000,-53000,-53000
20200312,705872,M31國泰94購01,0.08,0.08,0.08,0.08,-0.07,-46.67,15000,1,1200,0,0,0,0,0,0,15000,0,15000,15000
20200312,705873,大江國泰94購01,,,,,,0.00,0,0,0,0,0,0,0,0,0,0,0,0,0
20200312,705876,宏捷科元大94購01,0.62,0.66,0.57,0.57,-0.46,-44.66,202000,3,123240,0,0,0,0,0,0,80000,122000,-42000,-42000
20200312,705877,旺矽元大94購01,,,,,,0.00,0,0,0,0,0,0,0,0,0,0,0,0,0
20200312,705881,M31凱基94購01,,,,,,0.00,0,0,0,0,0,0,0,0,0,0,0,0,0
20200312,705886,廣明凱基94購03,,,,,,0.00,0,0,0,0,0,0,0,0,0,0,0,0,0
20200312,705889,昇達科兆豐94購01,,,,,,0.00,0,0,0,0,0,0,0,0,0,0,0,0,0
20200312,705894,新普群益94購02,,,,,,0.00,0,0,0,0,0,0,0,0,0,0,0,0,0
20200312,705900,保瑞國票94購01,0.20,0.23,0.15,0.15,-0.13,-46.43,187000,21,34070,0,0,0,0,0,0,67000,120000,-53000,-53000
20200312,705901,建榮國票95購02,,,,,,0.00,0,0,0,0,0,0,0,0,0,0,0,0,0
20200312,705903,穩懋國票94購02,0.08,0.08,0.08,0.08,-0.22,-73.33,10000,1,800,0,0,0,0,0,0,0,10000,-10000,-10000
20200312,705904,六角富邦97購01,0.18,0.18,0.16,0.16,-0.11,-40.74,265000,6,43400,0,0,0,0,0,0,215000,50000,165000,165000
20200312,705905,昇達科富邦97購01,,,,,,0.00,0,0,0,0,0,0,0,0,0,0,0,0,0
20200312,705906,大江凱基94購02,,,,,,0.00,0,0,0,0,0,0,0,0,0,0,0,0,0
20200312,705907,合晶凱基93購02,,,,,,0.00,0,0,0,0,0,0,0,0,0,0,0,0,0
20200312,705908,杰力凱基93購03,,,,,,0.00,0,0,0,0,0,0,0,0,0,0,0,0,0
20200312,705909,群聯凱基93購03,,,,,,0.00,0,0,0,0,0,0,0,0,0,0,0,0,0
20200312,705910,廣明凱基94購04,,,,,,0.00,0,0,0,0,0,0,0,0,0,0,0,0,0
20200312,705911,晟德凱基93購01,,,,,,0.00,0,0,0,0,0,0,0,0,0,0,0,0,0
20200312,705912,昇達科國票94購01,,,,,,0.00,0,0,0,0,0,0,0,0,0,0,0,0,0
20200312,705913,勝麗國票93購01,,,,,,0.00,0,0,0,0,0,0,0,0,0,0,0,0,0
20200312,705914,穩懋國票93購05,,,,,,0.00,0,0,0,0,0,0,0,0,0,0,0,0,0
20200312,705915,廣明麥證93購01,,,,,,0.00,0,0,0,0,0,0,0,0,0,0,0,0,0
20200312,705916,大江元大93購05,,,,,,0.00,0,0,0,0,0,0,0,0,0,0,0,0,0
20200312,705917,皇田元大93購02,,,,,,0.00,0,0,0,0,0,0,0,0,0,0,0,0,0
20200312,705918,廣明元大93購03,,,,,,0.00,0,0,0,0,0,0,0,0,0,0,0,0,0
20200312,705919,環球晶元大93購09,,,,,,0.00,0,0,0,0,0,0,0,0,0,0,0,0,0
20200312,705920,合晶永豐93購01,,,,,,0.00,0,0,0,0,0,0,0,0,0,0,0,0,0
20200312,705921,建榮永豐94購04,,,,,,0.00,0,0,0,0,0,0,0,0,0,0,0,0,0
20200312,705922,皇田永豐93購02,,,,,,0.00,0,0,0,0,0,0,0,0,0,0,0,0,0
20200312,705923,精華永豐93購01,,,,,,0.00,0,0,0,0,0,0,0,0,0,0,0,0,0
20200312,705924,大江元富96購01,0.06,0.07,0.06,0.07,-0.05,-41.67,13000,2,790,0,0,0,0,0,0,12000,1000,11000,11000
20200312,705925,大江台新93購01,0.01,0.01,0.01,0.01,0.00,0.0,100000,1,1000,0,0,0,0,0,0,100000,0,100000,100000
20200312,705926,六角台新94購01,,,,,,0.00,0,0,0,0,0,0,0,0,0,0,0,0,0
20200312,705927,原相台新94購01,,,,,,0.00,0,0,0,0,0,0,0,0,0,0,0,0,0
20200312,705928,皇田康和93購02,,,,,,0.00,0,0,0,0,0,0,0,0,0,0,0,0,0
20200312,705929,金居群益93購01,,,,,,0.00,0,0,0,0,0,0,0,0,0,0,0,0,0
20200312,705930,建榮群益94購02,,,,,,0.00,0,0,0,0,0,0,0,0,0,0,0,0,0
20200312,705931,廣明群益93購01,,,,,,0.00,0,0,0,0,0,0,0,0,0,0,0,0,0
20200312,705932,譜瑞群益93購01,,,,,,0.00,0,0,0,0,0,0,0,0,0,0,0,0,0
20200312,705933,中美晶亞東93購02,1.02,1.02,1.02,1.02,-1.26,-55.26,10000,1,10200,0,0,0,0,0,0,10000,0,10000,10000
20200312,705934,大江凱基94購03,,,,,,0.00,0,0,0,0,0,0,0,0,0,0,0,0,0
20200312,705935,網龍凱基93購01,,,,,,0.00,0,0,0,0,0,0,0,0,0,0,0,0,0
20200312,705936,元太統一93購01,,,,,,0.00,0,0,0,0,0,0,0,0,0,0,0,0,0
20200312,705937,中美晶元富95購01,2.05,2.05,1.64,1.85,-0.48,-20.6,38000,6,74180,0,0,0,0,0,0,22000,16000,6000,6000
20200312,705938,聯亞元富93購02,,,,,,0.00,0,0,0,0,0,0,0,0,0,0,0,0,0
20200312,705939,良維兆豐94購01,,,,,,0.00,0,0,0,0,0,0,0,0,0,0,0,0,0
20200312,705940,精華康和93購01,,,,,,0.00,0,0,0,0,0,0,0,0,0,0,0,0,0
20200312,705941,信昌電群益93購01,,,,,,0.00,0,0,0,0,0,0,0,0,0,0,0,0,0
20200312,705942,泰博群益93購01,,,,,,0.00,0,0,0,0,0,0,0,0,0,0,0,0,0
20200312,705943,神盾群益94購02,,,,,,0.00,0,0,0,0,0,0,0,0,0,0,0,0,0
20200312,705944,台燿元大94購01,,,,,,0.00,0,0,0,0,0,0,0,0,0,0,0,0,0
20200312,705945,建榮元大93購01,,,,,,0.00,0,0,0,0,0,0,0,0,0,0,0,0,0
20200312,705946,建榮元大93購02,,,,,,0.00,0,0,0,0,0,0,0,0,0,0,0,0,0
20200312,705947,建榮元大94購01,,,,,,0.00,0,0,0,0,0,0,0,0,0,0,0,0,0
20200312,705948,原相元大94購02,4.52,4.52,2.84,2.84,-2.31,-44.85,30000,3,104800,0,0,0,0,0,0,10000,20000,-10000,-10000
20200312,705949,群聯元大93購02,,,,,,0.00,0,0,0,0,0,0,0,0,0,0,0,0,0
20200312,705950,環球晶元大93購10,,,,,,0.00,0,0,0,0,0,0,0,0,0,0,0,0,0
20200312,705951,穩懋元大93購12,,,,,,0.00,0,0,0,0,0,0,0,0,0,0,0,0,0
20200312,705952,旺矽國票94購01,,,,,,0.00,0,0,0,0,0,0,0,0,0,0,0,0,0
20200312,705953,勝麗國票94購01,0.58,0.58,0.46,0.46,-0.62,-57.41,30000,2,16200,0,0,0,0,0,0,20000,10000,10000,10000
20200312,705954,網龍國泰95購01,0.02,0.02,0.02,0.02,-0.05,-71.43,46000,1,920,0,0,0,0,0,0,46000,0,46000,46000
20200312,705955,聯亞國泰95購01,0.35,0.36,0.35,0.35,-0.34,-49.28,258000,5,91300,0,0,0,0,0,0,0,258000,-258000,-258000
20200312,705956,台燿永豐93購01,,,,,,0.00,0,0,0,0,0,0,0,0,0,0,0,0,0
20200312,705957,網龍永豐93購02,,,,,,0.00,0,0,0,0,0,0,0,0,0,0,0,0,0
20200312,705958,均豪永豐93購01,,,,,,0.00,0,0,0,0,0,0,0,0,0,0,0,0,0
20200312,705959,宜鼎永豐93購01,,,,,,0.00,0,0,0,0,0,0,0,0,0,0,0,0,0
20200312,705960,宣德永豐93購01,,,,,,0.00,0,0,0,0,0,0,0,0,0,0,0,0,0
20200312,705961,建榮永豐94購05,,,,,,0.00,0,0,0,0,0,0,0,0,0,0,0,0,0
20200312,705962,璟德永豐93購02,,,,,,0.00,0,0,0,0,0,0,0,0,0,0,0,0,0
20200312,705963,台燿元大93購02,,,,,,0.00,0,0,0,0,0,0,0,0,0,0,0,0,0
20200312,705964,台燿元大93購03,,,,,,0.00,0,0,0,0,0,0,0,0,0,0,0,0,0
20200312,705965,璟德元大93購02,,,,,,0.00,0,0,0,0,0,0,0,0,0,0,0,0,0
20200312,705966,聯亞元大94購01,,,,,,0.00,0,0,0,0,0,0,0,0,0,0,0,0,0
20200312,705967,穩懋元大93購13,,,,,,0.00,0,0,0,0,0,0,0,0,0,0,0,0,0
20200312,705968,台燿中信93購03,,,,,,0.00,0,0,0,0,0,0,0,0,0,0,0,0,0
20200312,705969,皇田國泰95購01,,,,,,0.00,0,0,0,0,0,0,0,0,0,0,0,0,0
20200312,705970,大江凱基94購04,,,,,,0.00,0,0,0,0,0,0,0,0,0,0,0,0,0
20200312,705971,台燿凱基93購08,,,,,,0.00,0,0,0,0,0,0,0,0,0,0,0,0,0
20200312,705972,建榮凱基94購01,,,,,,0.00,0,0,0,0,0,0,0,0,0,0,0,0,0
20200312,705973,泰博凱基93購01,0.73,0.73,0.58,0.70,-0.60,-46.15,40000,4,27100,0,0,0,0,0,0,30000,10000,20000,20000
20200312,705974,優群麥證94購01,1.82,1.82,1.61,1.61,-1.19,-42.5,45000,3,77250,45000,0,45000,0,0,0,45000,0,45000,45000
20200312,705975,M31元富93購01,,,,,,0.00,0,0,0,0,0,0,0,0,0,0,0,0,0
20200312,705976,大江元富93購03,,,,,,0.00,0,0,0,0,0,0,0,0,0,0,0,0,0
20200312,705977,宜鼎元富93購01,,,,,,0.00,0,0,0,0,0,0,0,0,0,0,0,0,0
20200312,705978,昇達科元富93購01,,,,,,0.00,0,0,0,0,0,0,0,0,0,0,0,0,0
20200312,705979,欣銓元富93購01,,,,,,0.00,0,0,0,0,0,0,0,0,0,0,0,0,0
20200312,705980,閎康元富93購01,,,,,,0.00,0,0,0,0,0,0,0,0,0,0,0,0,0
20200312,705981,榮剛元富93購01,,,,,,0.00,0,0,0,0,0,0,0,0,0,0,0,0,0
20200312,705982,穩懋元富93購01,,,,,,0.00,0,0,0,0,0,0,0,0,0,0,0,0,0
20200312,705983,信驊兆豐93購01,,,,,,0.00,0,0,0,0,0,0,0,0,0,0,0,0,0
20200312,705984,台燿台新93購01,,,,,,0.00,0,0,0,0,0,0,0,0,0,0,0,0,0
20200312,705985,世界群益93購02,,,,,,0.00,0,0,0,0,0,0,0,0,0,0,0,0,0
20200312,705986,網龍群益93購01,,,,,,0.00,0,0,0,0,0,0,0,0,0,0,0,0,0
20200312,705987,先豐凱基93購02,,,,,,0.00,0,0,0,0,0,0,0,0,0,0,0,0,0
20200312,705988,合晶凱基93購03,,,,,,0.00,0,0,0,0,0,0,0,0,0,0,0,0,0
20200312,705989,皇田凱基93購04,,,,,,0.00,0,0,0,0,0,0,0,0,0,0,0,0,0
20200312,705990,群聯凱基93購04,0.19,0.19,0.19,0.19,-2.25,-92.21,10000,1,1900,0,0,0,0,0,0,10000,0,10000,10000
20200312,705991,穩懋凱基93購16,,,,,,0.00,0,0,0,0,0,0,0,0,0,0,0,0,0
20200312,705992,信驊元富93購01,2.14,2.20,1.91,1.91,-1.82,-48.79,30000,3,62500,0,0,0,0,0,0,10000,20000,-10000,-10000
20200312,705993,良維兆豐94購02,,,,,,0.00,0,0,0,0,0,0,0,0,0,0,0,0,0
20200312,705994,環球晶台新95購01,,,,,,0.00,0,0,0,0,0,0,0,0,0,0,0,0,0
20200312,705995,鈺太台新93購01,,,,,,0.00,0,0,0,0,0,0,0,0,0,0,0,0,0
20200312,705996,台燿康和93購01,,,,,,0.00,0,0,0,0,0,0,0,0,0,0,0,0,0
20200312,705997,朋億康和93購01,,,,,,0.00,0,0,0,0,0,0,0,0,0,0,0,0,0
20200312,705998,聯亞康和93購01,,,,,,0.00,0,0,0,0,0,0,0,0,0,0,0,0,0
20200312,705999,均豪群益93購01,,,,,,0.00,0,0,0,0,0,0,0,0,0,0,0,0,0
20200312,706000,廣明群益93購02,,,,,,0.00,0,0,0,0,0,0,0,0,0,0,0,0,0
20200312,706001,譜瑞第一93購01,,,,,,0.00,0,0,0,0,0,0,0,0,0,0,0,0,0
20200312,706002,大江永豐93購04,,,,,,0.00,0,0,0,0,0,0,0,0,0,0,0,0,0
20200312,706003,神盾國票95購01,,,,,,0.00,0,0,0,0,0,0,0,0,0,0,0,0,0
20200312,706004,台燿國泰94購01,,,,,,0.00,0,0,0,0,0,0,0,0,0,0,0,0,0
20200312,706005,中美晶元大95購01,3.46,3.49,3.02,3.02,-1.67,-35.61,81000,4,277170,0,0,0,0,0,0,0,81000,-81000,-81000
20200312,706006,台燿元大93購04,,,,,,0.00,0,0,0,0,0,0,0,0,0,0,0,0,0
20200312,706007,金居元大94購02,,,,,,0.00,0,0,0,0,0,0,0,0,0,0,0,0,0
20200312,706008,鐿鈦元大93購01,,,,,,0.00,0,0,0,0,0,0,0,0,0,0,0,0,0
20200312,706009,宜鼎統一93購01,,,,,,0.00,0,0,0,0,0,0,0,0,0,0,0,0,0
20200312,706010,穩懋統一93購07,,,,,,0.00,0,0,0,0,0,0,0,0,0,0,0,0,0
20200312,706011,大宇資凱基93購01,,,,,,0.00,0,0,0,0,0,0,0,0,0,0,0,0,0
20200312,706012,佳邦凱基93購02,,,,,,0.00,0,0,0,0,0,0,0,0,0,0,0,0,0
20200312,706013,泰博凱基93購02,0.04,0.04,0.04,0.04,-0.16,-80.0,240000,1,9600,0,0,0,0,0,0,240000,0,240000,240000
20200312,706014,神盾凱基93購05,,,,,,0.00,0,0,0,0,0,0,0,0,0,0,0,0,0
20200312,706015,僑威凱基93購01,,,,,,0.00,0,0,0,0,0,0,0,0,0,0,0,0,0
20200312,706016,優群凱基93購01,,,,,,0.00,0,0,0,0,0,0,0,0,0,0,0,0,0
20200312,706017,環球晶凱基93購13,,,,,,0.00,0,0,0,0,0,0,0,0,0,0,0,0,0
20200312,706018,金可永豐93購01,,,,,,0.00,0,0,0,0,0,0,0,0,0,0,0,0,0
20200312,706019,宣德永豐93購02,,,,,,0.00,0,0,0,0,0,0,0,0,0,0,0,0,0
20200312,706020,建榮元大93購03,,,,,,0.00,0,0,0,0,0,0,0,0,0,0,0,0,0
20200312,706021,緯軟元大94購03,,,,,,0.00,0,0,0,0,0,0,0,0,0,0,0,0,0
20200312,706022,昇達科國票94購02,,,,,,0.00,0,0,0,0,0,0,0,0,0,0,0,0,0
20200312,706023,原相國票95購01,,,,,,0.00,0,0,0,0,0,0,0,0,0,0,0,0,0
20200312,706024,建榮國泰95購02,,,,,,0.00,0,0,0,0,0,0,0,0,0,0,0,0,0
20200312,706025,建榮國泰95購03,,,,,,0.00,0,0,0,0,0,0,0,0,0,0,0,0,0
20200312,706026,雙鴻國泰95購01,0.68,0.68,0.52,0.55,-0.19,-25.68,129000,11,72450,0,0,0,0,0,0,7000,60000,-53000,-53000
20200312,706027,環球晶元富93購05,,,,,,0.00,0,0,0,0,0,0,0,0,0,0,0,0,0
20200312,706028,大宇資麥證94購01,0.08,0.08,0.08,0.08,-0.02,-20.0,10000,1,800,0,10000,-10000,0,0,0,0,10000,-10000,-10000
20200312,706029,由田元大93購03,,,,,,0.00,0,0,0,0,0,0,0,0,0,0,0,0,0
20200312,706030,宜鼎元大93購02,0.99,0.99,0.61,0.61,-1.84,-75.1,196000,3,177220,0,0,0,0,0,0,10000,186000,-176000,-176000
20200312,706031,信昌電元大93購01,,,,,,0.00,0,0,0,0,0,0,0,0,0,0,0,0,0
20200312,706032,環球晶元大93購11,,,,,,0.00,0,0,0,0,0,0,0,0,0,0,0,0,0
20200312,706033,雙美元大94購01,,,,,,0.00,0,0,0,0,0,0,0,0,0,0,0,0,0
20200312,706034,穩懋元大93購14,0.02,0.02,0.02,0.02,-0.39,-95.12,100000,1,2000,0,0,0,0,0,0,100000,0,100000,100000
20200312,706035,金可中信93購01,,,,,,0.00,0,0,0,0,0,0,0,0,0,0,0,0,0
20200312,706036,立端統一93購01,,,,,,0.00,0,0,0,0,0,0,0,0,0,0,0,0,0
20200312,706037,旺矽統一94購01,,,,,,0.00,0,0,0,0,0,0,0,0,0,0,0,0,0
20200312,706038,中美晶凱基93購04,0.56,0.56,0.56,0.56,-0.66,-54.1,10000,1,5600,0,0,0,0,0,0,10000,0,10000,10000
20200312,706039,佳邦凱基93購03,,,,,,0.00,0,0,0,0,0,0,0,0,0,0,0,0,0
20200312,706040,直得凱基93購03,,,,,,0.00,0,0,0,0,0,0,0,0,0,0,0,0,0
20200312,706041,原相凱基93購04,1.95,1.95,1.79,1.79,-1.06,-37.19,4000,2,7480,0,0,0,0,0,0,0,4000,-4000,-4000
20200312,706042,群聯凱基93購05,0.49,0.49,0.32,0.39,-1.61,-80.5,50000,5,18900,0,0,0,0,0,0,0,50000,-50000,-50000
20200312,706043,環球晶凱基93購14,0.69,0.69,0.35,0.35,-0.82,-70.09,60000,5,31500,0,0,0,0,0,0,20000,40000,-20000,-20000
20200312,706044,台半亞東93購01,,,,,,0.00,0,0,0,0,0,0,0,0,0,0,0,0,0
20200312,706045,大田永豐94購01,,,,,,0.00,0,0,0,0,0,0,0,0,0,0,0,0,0
20200312,706046,立端永豐93購02,,,,,,0.00,0,0,0,0,0,0,0,0,0,0,0,0,0
20200312,706047,良維永豐94購01,,,,,,0.00,0,0,0,0,0,0,0,0,0,0,0,0,0
20200312,706048,聯亞永豐93購01,,,,,,0.00,0,0,0,0,0,0,0,0,0,0,0,0,0
20200312,706049,穩懋永豐93購03,,,,,,0.00,0,0,0,0,0,0,0,0,0,0,0,0,0
20200312,706050,網龍康和93購01,,,,,,0.00,0,0,0,0,0,0,0,0,0,0,0,0,0
20200312,706051,三貝德群益93購02,,,,,,0.00,0,0,0,0,0,0,0,0,0,0,0,0,0
20200312,706052,光隆群益93購01,,,,,,0.00,0,0,0,0,0,0,0,0,0,0,0,0,0
20200312,706053,保瑞群益94購02,0.38,0.38,0.30,0.30,-0.19,-38.78,229000,11,78220,0,0,0,0,0,0,229000,0,229000,229000
20200312,706054,穩懋中信95購03,,,,,,0.00,0,0,0,0,0,0,0,0,0,0,0,0,0
20200312,706055,中美晶元富93購01,2.09,2.13,2.06,2.13,-1.40,-39.66,36000,4,75580,0,0,0,0,0,0,0,36000,-36000,-36000
20200312,706056,穩懋元富95購01,,,,,,0.00,0,0,0,0,0,0,0,0,0,0,0,0,0
20200312,706057,宜鼎台新93購01,,,,,,0.00,0,0,0,0,0,0,0,0,0,0,0,0,0
20200312,706058,穩懋台新93購01,,,,,,0.00,0,0,0,0,0,0,0,0,0,0,0,0,0
20200312,706059,大江元大94購01,,,,,,0.00,0,0,0,0,0,0,0,0,0,0,0,0,0
20200312,706060,世界元大93購01,0.41,0.41,0.41,0.41,-0.33,-44.59,100000,1,41000,0,0,0,0,0,0,0,100000,-100000,-100000
20200312,706061,昂寶元大93購02,,,,,,0.00,0,0,0,0,0,0,0,0,0,0,0,0,0
20200312,706062,中美晶兆豐94購02,1.21,1.25,1.20,1.25,-0.27,-17.76,27000,4,32600,0,0,0,0,0,0,7000,20000,-13000,-13000
20200312,706063,元太兆豐93購01,,,,,,0.00,0,0,0,0,0,0,0,0,0,0,0,0,0
20200312,706064,泰博兆豐93購02,,,,,,0.00,0,0,0,0,0,0,0,0,0,0,0,0,0
20200312,706065,信昌電群益93購02,,,,,,0.00,0,0,0,0,0,0,0,0,0,0,0,0,0
20200312,706066,元太凱基93購02,,,,,,0.00,0,0,0,0,0,0,0,0,0,0,0,0,0
20200312,706067,合晶凱基93購04,,,,,,0.00,0,0,0,0,0,0,0,0,0,0,0,0,0
20200312,706068,杰力凱基93購04,,,,,,0.00,0,0,0,0,0,0,0,0,0,0,0,0,0
20200312,706069,博智凱基93購02,4.76,4.76,4.76,4.76,-1.89,-28.42,10000,1,47600,0,0,0,0,0,0,0,10000,-10000,-10000
20200312,706070,新普凱基93購02,,,,,,0.00,0,0,0,0,0,0,0,0,0,0,0,0,0
20200312,706071,環球晶凱基93購15,0.67,0.67,0.39,0.39,-0.93,-70.45,31000,3,20490,0,0,0,0,0,0,21000,11000,10000,10000
20200312,706072,雙美凱基93購01,,,,,,0.00,0,0,0,0,0,0,0,0,0,0,0,0,0
20200312,706073,穩懋凱基93購18,,,,,,0.00,0,0,0,0,0,0,0,0,0,0,0,0,0
20200312,706074,大田永豐93購01,,,,,,0.00,0,0,0,0,0,0,0,0,0,0,0,0,0
20200312,706075,大江永豐93購05,,,,,,0.00,0,0,0,0,0,0,0,0,0,0,0,0,0
20200312,706076,六角永豐93購01,,,,,,0.00,0,0,0,0,0,0,0,0,0,0,0,0,0
20200312,706077,由田永豐93購02,,,,,,0.00,0,0,0,0,0,0,0,0,0,0,0,0,0
20200312,706078,旺矽永豐94購01,0.19,0.19,0.19,0.19,-0.24,-55.81,10000,1,1900,0,0,0,0,0,0,10000,0,10000,10000
20200312,706079,茂達永豐93購02,,,,,,0.00,0,0,0,0,0,0,0,0,0,0,0,0,0
20200312,706080,優群永豐94購01,,,,,,0.00,0,0,0,0,0,0,0,0,0,0,0,0,0
20200312,706081,立端國票93購01,,,,,,0.00,0,0,0,0,0,0,0,0,0,0,0,0,0
20200312,706082,美琪瑪國票94購01,,,,,,0.00,0,0,0,0,0,0,0,0,0,0,0,0,0
20200312,706083,群聯國票94購01,0.07,0.10,0.07,0.09,-0.55,-85.94,214000,9,18580,0,0,0,0,0,0,14000,200000,-186000,-186000
20200312,706084,環宇國票93購02,,,,,,0.00,0,0,0,0,0,0,0,0,0,0,0,0,0
20200312,706085,穩懋國泰94購02,0.18,0.18,0.10,0.10,-0.22,-68.75,665000,10,95700,0,0,0,0,0,0,570000,95000,475000,475000
20200312,706086,中美晶富邦94購01,,,,,,0.00,0,0,0,0,0,0,0,0,0,0,0,0,0
20200312,706087,佳邦凱基93購04,,,,,,0.00,0,0,0,0,0,0,0,0,0,0,0,0,0
20200312,706088,泰博凱基93購03,1.46,1.46,0.58,0.58,-0.88,-60.27,50000,3,56100,0,0,0,0,0,0,30000,20000,10000,10000
20200312,706089,神盾凱基93購06,,,,,,0.00,0,0,0,0,0,0,0,0,0,0,0,0,0
20200312,706090,環球晶凱基93購16,1.38,1.38,0.42,0.44,-2.14,-82.95,130000,13,127000,0,0,0,0,0,0,10000,120000,-110000,-110000
20200312,706091,晟德凱基93購02,,,,,,0.00,0,0,0,0,0,0,0,0,0,0,0,0,0
20200312,706092,原相日盛93購01,3.85,3.85,3.34,3.34,-1.02,-23.39,94000,9,334660,0,0,0,0,0,0,0,94000,-94000,-94000
20200312,706093,環球晶元富93購06,2.07,2.07,0.95,0.95,-1.60,-62.75,115000,12,201130,0,0,0,0,0,0,28000,90000,-62000,-62000
20200312,706094,緯軟台新93購01,,,,,,0.00,0,0,0,0,0,0,0,0,0,0,0,0,0
20200312,706095,中美晶永豐93購02,0.11,0.11,0.11,0.11,-0.38,-77.55,20000,2,2200,0,0,0,0,0,0,0,10000,-10000,-10000
20200312,706096,波若威永豐93購01,,,,,,0.00,0,0,0,0,0,0,0,0,0,0,0,0,0
20200312,706097,信驊永豐93購02,0.18,0.18,0.17,0.18,-0.24,-57.14,25000,4,4350,0,0,0,0,0,0,20000,5000,15000,15000
20200312,706098,勝麗兆豐93購01,,,,,,0.00,0,0,0,0,0,0,0,0,0,0,0,0,0
20200312,706099,雙鴻兆豐94購01,,,,,,0.00,0,0,0,0,0,0,0,0,0,0,0,0,0
20200312,706100,穩懋兆豐94購01,,,,,,0.00,0,0,0,0,0,0,0,0,0,0,0,0,0
20200312,706101,鈺太康和93購01,,,,,,0.00,0,0,0,0,0,0,0,0,0,0,0,0,0
20200312,706102,良維群益93購03,,,,,,0.00,0,0,0,0,0,0,0,0,0,0,0,0,0
20200312,706103,廣明群益93購03,,,,,,0.00,0,0,0,0,0,0,0,0,0,0,0,0,0
20200312,706104,宜鼎元大93購03,0.50,0.50,0.50,0.50,-0.75,-60.0,89000,1,44500,0,0,0,0,0,0,0,89000,-89000,-89000
20200312,706105,宜鼎國票93購01,,,,,,0.00,0,0,0,0,0,0,0,0,0,0,0,0,0
20200312,706106,信驊國票93購01,0.86,0.86,0.86,0.86,-0.83,-49.11,1000,1,860,0,0,0,0,0,0,1000,0,1000,1000
20200312,706107,網龍國票94購01,,,,,,0.00,0,0,0,0,0,0,0,0,0,0,0,0,0
20200312,706108,威剛富邦97購01,1.91,1.91,1.46,1.47,-0.58,-28.29,110000,11,181700,0,0,0,0,0,0,0,110000,-110000,-110000
20200312,706109,雙鴻富邦97購01,0.19,0.19,0.15,0.15,-0.10,-40.0,600000,9,96000,0,0,0,0,0,0,100000,500000,-400000,-400000
20200312,706110,聯亞元富93購03,,,,,,0.00,0,0,0,0,0,0,0,0,0,0,0,0,0
20200312,706111,宣德國泰93購01,,,,,,0.00,0,0,0,0,0,0,0,0,0,0,0,0,0
20200312,706112,原相元大95購01,,,,,,0.00,0,0,0,0,0,0,0,0,0,0,0,0,0
20200312,706113,精華元大93購01,,,,,,0.00,0,0,0,0,0,0,0,0,0,0,0,0,0
20200312,706114,穩懋元大93購15,,,,,,0.00,0,0,0,0,0,0,0,0,0,0,0,0,0
20200312,706115,中美晶凱基93購05,1.56,1.56,1.40,1.42,-1.05,-42.51,22000,3,31320,0,0,0,0,0,0,2000,22000,-20000,-20000
20200312,706116,宜鼎凱基93購03,,,,,,0.00,0,0,0,0,0,0,0,0,0,0,0,0,0
20200312,706117,泰博凱基93購04,0.92,0.92,0.34,0.34,-0.68,-66.67,30000,2,21800,0,0,0,0,0,0,20000,10000,10000,10000
20200312,706118,緯軟凱基93購02,,,,,,0.00,0,0,0,0,0,0,0,0,0,0,0,0,0
20200312,706119,環球晶凱基93購17,0.37,0.37,0.32,0.32,-0.40,-55.56,40000,2,14300,0,0,0,0,0,0,30000,10000,20000,20000
20200312,706120,穩懋凱基93購19,,,,,,0.00,0,0,0,0,0,0,0,0,0,0,0,0,0
20200312,706121,泰博統一93購01,,,,,,0.00,0,0,0,0,0,0,0,0,0,0,0,0,0
20200312,706122,環球晶統一93購01,,,,,,0.00,0,0,0,0,0,0,0,0,0,0,0,0,0
20200312,706123,穩懋統一93購08,,,,,,0.00,0,0,0,0,0,0,0,0,0,0,0,0,0
20200312,706124,群聯兆豐94購02,0.81,0.83,0.59,0.60,-0.53,-46.9,96000,13,63990,0,0,0,0,0,0,1000,95000,-94000,-94000
20200312,706125,聚積兆豐94購01,,,,,,0.00,0,0,0,0,0,0,0,0,0,0,0,0,0
20200312,706126,穩懋兆豐93購04,,,,,,0.00,0,0,0,0,0,0,0,0,0,0,0,0,0
20200312,706127,博大康和93購01,,,,,,0.00,0,0,0,0,0,0,0,0,0,0,0,0,0
20200312,706128,宏觀群益93購01,,,,,,0.00,0,0,0,0,0,0,0,0,0,0,0,0,0
20200312,706129,信驊群益93購02,,,,,,0.00,0,0,0,0,0,0,0,0,0,0,0,0,0
20200312,706130,雙美群益95購01,,,,,,0.00,0,0,0,0,0,0,0,0,0,0,0,0,0
20200312,706131,聚積國票93購01,,,,,,0.00,0,0,0,0,0,0,0,0,0,0,0,0,0
20200312,706132,環球晶國票93購02,,,,,,0.00,0,0,0,0,0,0,0,0,0,0,0,0,0
20200312,706133,鈺太國票95購02,1.13,1.13,1.13,1.13,-0.53,-31.93,75000,2,84750,0,0,0,0,0,0,75000,0,75000,75000
20200312,706134,穩懋富邦95購01,0.07,0.10,0.07,0.10,-0.08,-44.44,98000,4,8900,0,0,0,0,0,0,30000,68000,-38000,-38000
20200312,706135,中美晶永豐93購03,,,,,,0.00,0,0,0,0,0,0,0,0,0,0,0,0,0
20200312,706136,由田永豐93購03,,,,,,0.00,0,0,0,0,0,0,0,0,0,0,0,0,0
20200312,706137,合晶永豐93購03,,,,,,0.00,0,0,0,0,0,0,0,0,0,0,0,0,0
20200312,706138,昂寶永豐93購01,,,,,,0.00,0,0,0,0,0,0,0,0,0,0,0,0,0
20200312,706139,直得永豐93購02,,,,,,0.00,0,0,0,0,0,0,0,0,0,0,0,0,0
20200312,706140,晶焱永豐93購02,,,,,,0.00,0,0,0,0,0,0,0,0,0,0,0,0,0
20200312,706141,順達永豐93購02,,,,,,0.00,0,0,0,0,0,0,0,0,0,0,0,0,0
20200312,706142,精華永豐93購02,,,,,,0.00,0,0,0,0,0,0,0,0,0,0,0,0,0
20200312,706143,聚積永豐93購01,,,,,,0.00,0,0,0,0,0,0,0,0,0,0,0,0,0
20200312,706144,先豐統一93購01,,,,,,0.00,0,0,0,0,0,0,0,0,0,0,0,0,0
20200312,706145,精華中信93購01,,,,,,0.00,0,0,0,0,0,0,0,0,0,0,0,0,0
20200312,706146,六角凱基93購01,,,,,,0.00,0,0,0,0,0,0,0,0,0,0,0,0,0
20200312,706147,金居凱基93購03,,,,,,0.00,0,0,0,0,0,0,0,0,0,0,0,0,0
20200312,706148,保瑞凱基93購01,,,,,,0.00,0,0,0,0,0,0,0,0,0,0,0,0,0
20200312,706149,群聯凱基93購06,,,,,,0.00,0,0,0,0,0,0,0,0,0,0,0,0,0
20200312,706150,聖暉凱基94購01,1.36,1.43,1.31,1.31,-0.50,-27.62,36000,3,49580,0,0,0,0,0,0,36000,10000,26000,26000
20200312,706151,環球晶凱基93購18,1.68,1.68,0.83,0.83,-2.01,-70.77,80000,8,103900,0,0,0,0,0,0,10000,70000,-60000,-60000
20200312,706152,穩懋凱基93購20,,,,,,0.00,0,0,0,0,0,0,0,0,0,0,0,0,0
20200312,706153,良維永豐93購01,,,,,,0.00,0,0,0,0,0,0,0,0,0,0,0,0,0
20200312,706154,波若威永豐94購01,,,,,,0.00,0,0,0,0,0,0,0,0,0,0,0,0,0
20200312,706155,信昌電永豐93購03,,,,,,0.00,0,0,0,0,0,0,0,0,0,0,0,0,0
20200312,706156,僑威永豐93購02,,,,,,0.00,0,0,0,0,0,0,0,0,0,0,0,0,0
20200312,706157,穩懋永豐94購01,,,,,,0.00,0,0,0,0,0,0,0,0,0,0,0,0,0
20200312,706158,昂寶兆豐93購01,,,,,,0.00,0,0,0,0,0,0,0,0,0,0,0,0,0
20200312,706159,大江群益93購02,,,,,,0.00,0,0,0,0,0,0,0,0,0,0,0,0,0
20200312,706160,中美晶群益93購02,,,,,,0.00,0,0,0,0,0,0,0,0,0,0,0,0,0
20200312,706161,順達群益93購01,,,,,,0.00,0,0,0,0,0,0,0,0,0,0,0,0,0
20200312,706162,緯軟群益93購02,,,,,,0.00,0,0,0,0,0,0,0,0,0,0,0,0,0
20200312,706163,勝麗元大93購02,0.75,0.75,0.75,0.75,-1.18,-61.14,10000,1,7500,0,0,0,0,0,0,10000,0,10000,10000
20200312,706164,博智元大95購01,3.98,3.98,3.98,3.98,-1.27,-24.19,1000,1,3980,0,0,0,0,0,0,0,1000,-1000,-1000
20200312,706165,順達元大93購01,,,,,,0.00,0,0,0,0,0,0,0,0,0,0,0,0,0
20200312,706166,神盾台新94購01,,,,,,0.00,0,0,0,0,0,0,0,0,0,0,0,0,0
20200312,706167,三貝德國票95購01,,,,,,0.00,0,0,0,0,0,0,0,0,0,0,0,0,0
20200312,706168,大田國票94購01,,,,,,0.00,0,0,0,0,0,0,0,0,0,0,0,0,0
20200312,706169,精華國票94購01,,,,,,0.00,0,0,0,0,0,0,0,0,0,0,0,0,0
20200312,706170,廣明國票94購01,,,,,,0.00,0,0,0,0,0,0,0,0,0,0,0,0,0
20200312,706171,鐿鈦國票95購01,,,,,,0.00,0,0,0,0,0,0,0,0,0,0,0,0,0
20200312,706172,金居國泰94購01,0.16,0.16,0.09,0.09,-0.09,-50.0,180000,9,22300,0,0,0,0,0,0,0,180000,-180000,-180000
20200312,706173,神盾國泰95購01,,,,,,0.00,0,0,0,0,0,0,0,0,0,0,0,0,0
20200312,706174,晶焱國泰94購01,,,,,,0.00,0,0,0,0,0,0,0,0,0,0,0,0,0
20200312,706175,譜瑞國泰95購01,1.61,1.73,1.61,1.63,-0.88,-35.06,23000,3,37490,0,0,0,0,0,0,3000,23000,-20000,-20000
20200312,706176,勝麗康和93購01,,,,,,0.00,0,0,0,0,0,0,0,0,0,0,0,0,0
20200312,706177,M31群益93購03,,,,,,0.00,0,0,0,0,0,0,0,0,0,0,0,0,0
20200312,706178,建榮群益94購03,,,,,,0.00,0,0,0,0,0,0,0,0,0,0,0,0,0
20200312,706179,太醫中信93購01,,,,,,0.00,0,0,0,0,0,0,0,0,0,0,0,0,0
20200312,706180,宣德凱基93購01,0.58,0.58,0.56,0.56,-0.45,-44.55,101000,2,56780,0,0,0,0,0,0,101000,0,101000,101000
20200312,706181,原相凱基93購05,2.11,2.19,2.07,2.11,-1.26,-37.39,50000,5,106300,0,0,0,0,0,0,0,50000,-50000,-50000
20200312,706182,閎康凱基94購01,0.57,0.57,0.39,0.39,-0.32,-45.07,498000,22,250240,0,290000,-290000,0,0,0,498000,0,498000,208000
20200312,706183,聚積凱基94購01,,,,,,0.00,0,0,0,0,0,0,0,0,0,0,0,0,0
20200312,706184,神盾統一94購01,,,,,,0.00,0,0,0,0,0,0,0,0,0,0,0,0,0
20200312,706185,優群統一93購01,,,,,,0.00,0,0,0,0,0,0,0,0,0,0,0,0,0
20200312,706186,中美晶元富94購02,1.45,1.45,1.28,1.28,-0.87,-40.47,16000,2,22180,0,0,0,0,0,0,0,16000,-16000,-16000
20200312,706187,中美晶元大93購09,,,,,,0.00,0,0,0,0,0,0,0,0,0,0,0,0,0
20200312,706188,信驊元大93購02,,,,,,0.00,0,0,0,0,0,0,0,0,0,0,0,0,0
20200312,706189,穩懋元大93購16,,,,,,0.00,0,0,0,0,0,0,0,0,0,0,0,0,0
20200312,706190,大江國票94購01,,,,,,0.00,0,0,0,0,0,0,0,0,0,0,0,0,0
20200312,706191,台燿國票93購02,,,,,,0.00,0,0,0,0,0,0,0,0,0,0,0,0,0
20200312,706192,同致國票94購01,,,,,,0.00,0,0,0,0,0,0,0,0,0,0,0,0,0
20200312,706193,良維國票94購01,0.33,0.33,0.33,0.33,-0.13,-28.26,21000,1,6930,0,0,0,0,0,0,0,21000,-21000,-21000
20200312,706194,博智國票95購01,,,,,,0.00,0,0,0,0,0,0,0,0,0,0,0,0,0
20200312,706195,順達國票94購01,1.84,1.84,1.84,1.84,-0.98,-34.75,5000,1,9200,0,0,0,0,0,0,0,5000,-5000,-5000
20200312,706196,新普國票93購01,,,,,,0.00,0,0,0,0,0,0,0,0,0,0,0,0,0
20200312,706197,聯亞國票94購01,0.09,0.09,0.09,0.09,-0.19,-67.86,40000,1,3600,0,0,0,0,0,0,0,40000,-40000,-40000
20200312,706198,中美晶國泰94購01,,,,,,0.00,0,0,0,0,0,0,0,0,0,0,0,0,0
20200312,706199,昇達科國泰95購01,,,,,,0.00,0,0,0,0,0,0,0,0,0,0,0,0,0
20200312,706200,保瑞國泰95購02,0.31,0.31,0.27,0.27,-0.07,-20.59,423000,9,119010,0,0,0,0,0,0,323000,100000,223000,223000
20200312,706201,昂寶亞東93購02,2.37,2.37,2.37,2.37,-0.14,-5.58,15000,1,35550,0,0,0,0,0,0,15000,0,15000,15000
20200312,706202,宏觀永豐93購01,,,,,,0.00,0,0,0,0,0,0,0,0,0,0,0,0,0
20200312,706203,欣銓永豐93購01,,,,,,0.00,0,0,0,0,0,0,0,0,0,0,0,0,0
20200312,706204,緯軟永豐93購03,,,,,,0.00,0,0,0,0,0,0,0,0,0,0,0,0,0
20200312,706205,元太元大93購01,,,,,,0.00,0,0,0,0,0,0,0,0,0,0,0,0,0
20200312,706206,佳邦元大93購01,,,,,,0.00,0,0,0,0,0,0,0,0,0,0,0,0,0
20200312,706207,直得元大94購01,0.97,0.97,0.92,0.92,-0.19,-17.12,31000,2,28570,0,0,0,0,0,0,31000,0,31000,31000
20200312,706208,宣德元大93購03,1.49,1.49,1.33,1.33,-0.59,-30.73,25000,3,35450,0,0,0,0,0,0,25000,0,25000,25000
20200312,706209,美琪瑪元大93購01,,,,,,0.00,0,0,0,0,0,0,0,0,0,0,0,0,0
20200312,706210,神盾元大94購05,,,,,,0.00,0,0,0,0,0,0,0,0,0,0,0,0,0
20200312,706211,精華元大93購02,,,,,,0.00,0,0,0,0,0,0,0,0,0,0,0,0,0
20200312,706212,廣明元大94購01,0.03,0.03,0.03,0.03,-0.03,-50.0,20000,2,600,0,0,0,0,0,0,0,20000,-20000,-20000
20200312,706213,緯軟元大94購04,0.03,0.03,0.03,0.03,-0.07,-70.0,60000,1,1800,0,0,0,0,0,0,60000,0,60000,60000
20200312,706214,力旺統一93購01,0.11,0.11,0.11,0.11,-0.22,-66.67,38000,1,4180,0,0,0,0,0,0,38000,0,38000,38000
20200312,706215,神盾統一94購02,,,,,,0.00,0,0,0,0,0,0,0,0,0,0,0,0,0
20200312,706216,群聯統一93購02,,,,,,0.00,0,0,0,0,0,0,0,0,0,0,0,0,0
20200312,706217,中美晶凱基93購06,,,,,,0.00,0,0,0,0,0,0,0,0,0,0,0,0,0
20200312,706218,六角凱基93購02,,,,,,0.00,0,0,0,0,0,0,0,0,0,0,0,0,0
20200312,706219,美琪瑪凱基93購01,,,,,,0.00,0,0,0,0,0,0,0,0,0,0,0,0,0
20200312,706220,博智凱基93購03,3.98,3.98,3.93,3.93,-1.27,-24.42,6000,2,23630,0,0,0,0,0,0,0,6000,-6000,-6000
20200312,706221,環球晶凱基93購19,0.62,0.62,0.62,0.62,-0.78,-55.71,20000,1,12400,0,0,0,0,0,0,20000,0,20000,20000
20200312,706222,穩懋凱基93購21,,,,,,0.00,0,0,0,0,0,0,0,0,0,0,0,0,0
20200312,706223,立端國票94購01,,,,,,0.00,0,0,0,0,0,0,0,0,0,0,0,0,0
20200312,706224,昂寶國票94購01,,,,,,0.00,0,0,0,0,0,0,0,0,0,0,0,0,0
20200312,706225,昇達科國票93購01,,,,,,0.00,0,0,0,0,0,0,0,0,0,0,0,0,0
20200312,706226,金可國票94購01,0.03,0.03,0.02,0.02,-0.02,-50.0,150000,2,4000,0,0,0,0,0,0,0,150000,-150000,-150000
20200312,706227,信昌電國票94購01,0.20,0.20,0.19,0.19,-0.19,-50.0,114000,3,22160,0,0,0,0,0,0,114000,0,114000,114000
20200312,706228,威剛國票94購01,,,,,,0.00,0,0,0,0,0,0,0,0,0,0,0,0,0
20200312,706229,智擎國票94購01,0.01,0.01,0.01,0.01,0.00,0.0,160000,2,1600,0,0,0,0,0,0,0,0,0,0
20200312,706230,穩懋國票93購06,,,,,,0.00,0,0,0,0,0,0,0,0,0,0,0,0,0
20200312,706231,台燿富邦93購01,,,,,,0.00,0,0,0,0,0,0,0,0,0,0,0,0,0
20200312,706232,大宇資第一93購01,,,,,,0.00,0,0,0,0,0,0,0,0,0,0,0,0,0
20200312,706233,合晶元富93購01,,,,,,0.00,0,0,0,0,0,0,0,0,0,0,0,0,0
20200312,706234,神盾元富94購01,,,,,,0.00,0,0,0,0,0,0,0,0,0,0,0,0,0
20200312,706235,環球晶元富94購02,1.74,1.80,0.97,1.74,-0.23,-11.68,322000,28,466180,0,0,0,0,0,0,164000,160000,4000,4000
20200312,706236,M31永豐93購02,,,,,,0.00,0,0,0,0,0,0,0,0,0,0,0,0,0
20200312,706237,台燿永豐93購02,,,,,,0.00,0,0,0,0,0,0,0,0,0,0,0,0,0
20200312,706238,佳邦永豐93購02,,,,,,0.00,0,0,0,0,0,0,0,0,0,0,0,0,0
20200312,706239,旺矽永豐93購02,,,,,,0.00,0,0,0,0,0,0,0,0,0,0,0,0,0
20200312,706240,宣德永豐93購03,,,,,,0.00,0,0,0,0,0,0,0,0,0,0,0,0,0
20200312,706241,碩禾永豐94購01,0.42,0.42,0.33,0.33,-0.19,-36.54,24000,4,9500,0,0,0,0,0,0,2000,22000,-20000,-20000
20200312,706242,宜鼎兆豐94購01,0.82,0.82,0.82,0.82,-0.49,-37.4,10000,1,8200,0,0,0,0,0,0,0,10000,-10000,-10000
20200312,706243,神盾兆豐94購01,,,,,,0.00,0,0,0,0,0,0,0,0,0,0,0,0,0
20200312,706244,網龍群益94購01,,,,,,0.00,0,0,0,0,0,0,0,0,0,0,0,0,0
20200312,706245,穩懋統一94購04,0.02,0.02,0.02,0.02,-0.03,-60.0,50000,2,1000,0,0,0,0,0,0,0,20000,-20000,-20000
20200312,706246,譜瑞統一94購01,0.38,0.40,0.32,0.33,-0.80,-70.8,388000,8,133280,0,0,0,0,0,0,145000,243000,-98000,-98000
20200312,706247,由田凱基94購01,,,,,,0.00,0,0,0,0,0,0,0,0,0,0,0,0,0
20200312,706248,宜鼎凱基94購01,0.36,0.36,0.31,0.31,-0.32,-50.79,30000,2,10300,0,0,0,0,0,0,20000,10000,10000,10000
20200312,706249,美琪瑪凱基94購01,,,,,,0.00,0,0,0,0,0,0,0,0,0,0,0,0,0
20200312,706250,廣明凱基94購05,,,,,,0.00,0,0,0,0,0,0,0,0,0,0,0,0,0
20200312,706251,環球晶凱基94購01,3.14,3.20,3.14,3.20,-1.34,-29.52,30000,3,95400,0,0,0,0,0,0,0,30000,-30000,-30000
20200312,706252,穩懋凱基94購03,,,,,,0.00,0,0,0,0,0,0,0,0,0,0,0,0,0
20200312,706253,鈺太凱基94購01,,,,,,0.00,0,0,0,0,0,0,0,0,0,0,0,0,0
20200312,706254,宣德國票95購01,1.47,1.47,1.15,1.15,-1.00,-46.51,20000,2,26200,0,0,0,0,0,0,10000,10000,0,0
20200312,706255,泰博國票95購01,1.29,1.29,0.56,0.75,-0.66,-46.81,347000,20,292100,0,0,0,0,0,0,187000,160000,27000,27000
20200312,706256,神盾富邦96購01,,,,,,0.00,0,0,0,0,0,0,0,0,0,0,0,0,0
20200312,706257,新普富邦94購01,,,,,,0.00,0,0,0,0,0,0,0,0,0,0,0,0,0
20200312,706258,穩懋兆豐94購02,,,,,,0.00,0,0,0,0,0,0,0,0,0,0,0,0,0
20200312,706259,晟德兆豐95購01,0.15,0.15,0.10,0.10,-0.09,-47.37,798000,31,94160,0,0,0,0,0,0,25000,773000,-748000,-748000
20200312,706260,大江群益94購02,,,,,,0.00,0,0,0,0,0,0,0,0,0,0,0,0,0
20200312,706261,神盾麥證94購01,,,,,,0.00,0,0,0,0,0,0,0,0,0,0,0,0,0
20200312,706262,美琪瑪麥證95購01,,,,,,0.00,0,0,0,0,0,0,0,0,0,0,0,0,0
20200312,706263,良維元富94購01,,,,,,0.00,0,0,0,0,0,0,0,0,0,0,0,0,0
20200312,706264,中美晶台新94購01,1.08,1.11,1.08,1.11,-0.73,-39.67,20000,2,21900,0,0,0,0,0,0,0,20000,-20000,-20000
20200312,706265,合晶台新94購01,,,,,,0.00,0,0,0,0,0,0,0,0,0,0,0,0,0
20200312,706266,中美晶元大94購01,2.29,2.29,2.29,2.29,-0.95,-29.32,10000,1,22900,0,0,0,0,0,0,10000,0,10000,10000
20200312,706267,合晶元大96購01,,,,,,0.00,0,0,0,0,0,0,0,0,0,0,0,0,0
20200312,706268,宏觀元大94購02,,,,,,0.00,0,0,0,0,0,0,0,0,0,0,0,0,0
20200312,706269,良維元大95購01,0.33,0.33,0.23,0.23,-0.26,-53.06,88000,4,23580,0,0,0,0,0,0,88000,0,88000,88000
20200312,706270,宜鼎元大95購01,2.28,2.28,2.28,2.28,-1.67,-42.28,50000,1,114000,0,0,0,0,0,0,0,50000,-50000,-50000
20200312,706271,昇達科元大94購01,,,,,,0.00,0,0,0,0,0,0,0,0,0,0,0,0,0
20200312,706272,杰力元大95購01,0.50,0.50,0.35,0.42,-0.18,-30.0,105000,4,52010,0,0,0,0,0,0,105000,0,105000,105000
20200312,706273,勝麗元大94購01,0.54,0.54,0.54,0.54,-0.40,-42.55,90000,1,48600,0,0,0,0,0,0,90000,0,90000,90000
20200312,706274,群聯元大95購01,,,,,,0.00,0,0,0,0,0,0,0,0,0,0,0,0,0
20200312,706275,聚積元大94購01,,,,,,0.00,0,0,0,0,0,0,0,0,0,0,0,0,0
20200312,706276,中美晶日盛94購01,,,,,,0.00,0,0,0,0,0,0,0,0,0,0,0,0,0
20200312,706277,三貝德永豐94購01,,,,,,0.00,0,0,0,0,0,0,0,0,0,0,0,0,0
20200312,706278,上詮永豐94購01,,,,,,0.00,0,0,0,0,0,0,0,0,0,0,0,0,0
20200312,706279,大宇資永豐94購01,,,,,,0.00,0,0,0,0,0,0,0,0,0,0,0,0,0
20200312,706280,信昌電永豐94購01,,,,,,0.00,0,0,0,0,0,0,0,0,0,0,0,0,0
20200312,706281,原相永豐94購02,,,,,,0.00,0,0,0,0,0,0,0,0,0,0,0,0,0
20200312,706282,勝麗永豐94購01,0.05,0.05,0.05,0.05,-0.06,-54.55,1000,1,50,0,0,0,0,0,0,1000,0,1000,1000
20200312,706283,緯軟永豐94購01,,,,,,0.00,0,0,0,0,0,0,0,0,0,0,0,0,0
20200312,706284,鐿鈦永豐94購01,,,,,,0.00,0,0,0,0,0,0,0,0,0,0,0,0,0
20200312,706285,金可兆豐95購01,0.13,0.13,0.11,0.12,-0.10,-45.45,80000,8,9600,0,0,0,0,0,0,0,60000,-60000,-60000
20200312,706286,緯軟兆豐95購01,,,,,,0.00,0,0,0,0,0,0,0,0,0,0,0,0,0
20200312,706287,環球晶兆豐95購01,1.19,1.19,1.06,1.16,-0.48,-29.27,30000,3,34100,0,0,0,0,0,0,0,30000,-30000,-30000
20200312,706288,譜瑞兆豐95購01,0.85,0.85,0.85,0.85,-0.56,-39.72,4000,1,3400,0,0,0,0,0,0,0,4000,-4000,-4000
20200312,706289,宜鼎群益94購01,0.53,0.53,0.50,0.50,-0.65,-56.52,20000,2,10300,0,0,0,0,0,0,0,20000,-20000,-20000
20200312,706290,信昌電群益94購01,0.03,0.03,0.03,0.03,-0.01,-25.0,10000,1,300,0,0,0,0,0,0,0,10000,-10000,-10000
20200312,706291,弘塑中信94購01,1.18,1.18,0.60,0.60,-1.60,-72.73,32000,5,29600,0,0,0,0,0,0,20000,12000,8000,8000
20200312,706292,兆利中信94購01,,,,,,0.00,0,0,0,0,0,0,0,0,0,0,0,0,0
20200312,706293,杰力中信95購01,,,,,,0.00,0,0,0,0,0,0,0,0,0,0,0,0,0
20200312,706294,原相統一94購01,,,,,,0.00,0,0,0,0,0,0,0,0,0,0,0,0,0
20200312,706295,雙鴻統一94購01,,,,,,0.00,0,0,0,0,0,0,0,0,0,0,0,0,0
20200312,706296,穩懋統一96購01,0.36,0.36,0.33,0.33,-0.29,-46.77,69000,6,23370,0,0,0,0,0,0,69000,0,69000,69000
20200312,706297,大宇資凱基94購02,,,,,,0.00,0,0,0,0,0,0,0,0,0,0,0,0,0
20200312,706298,立端凱基94購01,,,,,,0.00,0,0,0,0,0,0,0,0,0,0,0,0,0
20200312,706299,宇峻凱基94購01,0.92,0.92,0.57,0.57,-0.96,-62.75,60000,6,37700,0,0,0,0,0,0,0,60000,-60000,-60000
20200312,706300,穩懋凱基94購04,,,,,,0.00,0,0,0,0,0,0,0,0,0,0,0,0,0
20200312,706301,譜瑞凱基94購02,0.67,0.67,0.67,0.67,-0.79,-54.11,10000,1,6700,0,0,0,0,0,0,10000,0,10000,10000
20200312,706302,三貝德國票96購01,,,,,,0.00,0,0,0,0,0,0,0,0,0,0,0,0,0
20200312,706303,大學光國票94購01,,,,,,0.00,0,0,0,0,0,0,0,0,0,0,0,0,0
20200312,706304,迅得國票94購01,0.01,0.01,0.01,0.01,-0.01,-50.0,25000,1,250,0,0,0,0,0,0,25000,0,25000,25000
20200312,706305,迅得國票94購02,,,,,,0.00,0,0,0,0,0,0,0,0,0,0,0,0,0
20200312,706306,昂寶國票95購01,,,,,,0.00,0,0,0,0,0,0,0,0,0,0,0,0,0
20200312,706307,勝麗國票95購01,0.27,0.27,0.27,0.27,-0.33,-55.0,38000,1,10260,0,0,0,0,0,0,0,38000,-38000,-38000
20200312,706308,新揚科國票94購01,0.01,0.01,0.01,0.01,0.00,0.0,325000,2,3250,0,0,0,0,0,0,325000,0,325000,325000
20200312,706309,新揚科國票95購01,,,,,,0.00,0,0,0,0,0,0,0,0,0,0,0,0,0
20200312,706310,聯亞國票95購01,,,,,,0.00,0,0,0,0,0,0,0,0,0,0,0,0,0
20200312,706311,大學光國泰94購01,,,,,,0.00,0,0,0,0,0,0,0,0,0,0,0,0,0
20200312,706312,大學光國泰95購01,,,,,,0.00,0,0,0,0,0,0,0,0,0,0,0,0,0
20200312,706313,宇峻國泰95購01,2.41,2.67,1.64,1.85,-0.78,-29.66,383000,16,786020,0,0,0,0,0,0,25000,358000,-333000,-333000
20200312,706314,安勤國泰95購01,0.24,0.24,0.22,0.22,-0.12,-35.29,70000,2,16100,0,0,0,0,0,0,70000,0,70000,70000
20200312,706315,晟德富邦94購01,,,,,,0.00,0,0,0,0,0,0,0,0,0,0,0,0,0
20200312,706316,大學光元大94購01,3.82,3.82,2.46,2.46,-2.64,-51.76,40000,2,112000,0,0,0,0,0,0,10000,30000,-20000,-20000
20200312,706317,大學光元大94購02,4.65,4.65,4.65,4.65,-1.15,-19.83,9000,1,41850,0,0,0,0,0,0,9000,0,9000,9000
20200312,706318,大學光元大94購03,,,,,,0.00,0,0,0,0,0,0,0,0,0,0,0,0,0
20200312,706319,六角元大94購01,,,,,,0.00,0,0,0,0,0,0,0,0,0,0,0,0,0
20200312,706320,光頡元大94購01,,,,,,0.00,0,0,0,0,0,0,0,0,0,0,0,0,0
20200312,706321,宇峻元大94購01,,,,,,0.00,0,0,0,0,0,0,0,0,0,0,0,0,0
20200312,706322,良維元大94購01,,,,,,0.00,0,0,0,0,0,0,0,0,0,0,0,0,0
20200312,706323,迅得元大94購01,,,,,,0.00,0,0,0,0,0,0,0,0,0,0,0,0,0
20200312,706324,新揚科元大94購01,,,,,,0.00,0,0,0,0,0,0,0,0,0,0,0,0,0
20200312,706325,群聯元大95購02,0.48,0.49,0.20,0.20,-0.73,-78.49,210000,9,76650,0,0,0,0,0,0,97000,210000,-113000,-113000
20200312,706326,網家元大94購01,,,,,,0.00,0,0,0,0,0,0,0,0,0,0,0,0,0
20200312,706327,網龍元大94購01,,,,,,0.00,0,0,0,0,0,0,0,0,0,0,0,0,0
20200312,706328,環球晶元大94購02,,,,,,0.00,0,0,0,0,0,0,0,0,0,0,0,0,0
20200312,706329,雙美元大94購02,,,,,,0.00,0,0,0,0,0,0,0,0,0,0,0,0,0
20200312,706330,穩懋元大94購01,,,,,,0.00,0,0,0,0,0,0,0,0,0,0,0,0,0
20200312,706331,大學光永豐94購01,1.49,1.49,0.90,0.90,-1.14,-55.88,30000,9,38020,0,0,0,0,0,0,20000,10000,10000,10000
20200312,706332,中美晶永豐94購01,,,,,,0.00,0,0,0,0,0,0,0,0,0,0,0,0,0
20200312,706333,光頡永豐94購01,,,,,,0.00,0,0,0,0,0,0,0,0,0,0,0,0,0
20200312,706334,宇峻永豐94購01,,,,,,0.00,0,0,0,0,0,0,0,0,0,0,0,0,0
20200312,706335,安勤永豐94購01,,,,,,0.00,0,0,0,0,0,0,0,0,0,0,0,0,0
20200312,706336,迅得永豐94購01,,,,,,0.00,0,0,0,0,0,0,0,0,0,0,0,0,0
20200312,706337,協益永豐94購01,,,,,,0.00,0,0,0,0,0,0,0,0,0,0,0,0,0
20200312,706338,東洋永豐94購01,,,,,,0.00,0,0,0,0,0,0,0,0,0,0,0,0,0
20200312,706339,長科*永豐94購01,,,,,,0.00,0,0,0,0,0,0,0,0,0,0,0,0,0
20200312,706340,保瑞永豐94購01,,,,,,0.00,0,0,0,0,0,0,0,0,0,0,0,0,0
20200312,706341,博智永豐94購01,3.37,3.37,3.37,3.37,-2.03,-37.59,2000,1,6740,0,0,0,0,0,0,0,2000,-2000,-2000
20200312,706342,新揚科永豐94購01,,,,,,0.00,0,0,0,0,0,0,0,0,0,0,0,0,0
20200312,706343,碩禾永豐94購02,0.33,0.33,0.33,0.33,-0.15,-31.25,7000,1,2310,0,0,0,0,0,0,0,7000,-7000,-7000
20200312,706344,網家永豐94購01,,,,,,0.00,0,0,0,0,0,0,0,0,0,0,0,0,0
20200312,706345,雙鴻永豐95購01,0.03,0.03,0.03,0.03,-0.03,-50.0,40000,1,1200,0,0,0,0,0,0,40000,0,40000,40000
20200312,706346,弘塑康和94購01,2.95,2.95,2.95,2.95,-1.36,-31.55,29000,2,85550,0,0,0,0,0,0,29000,0,29000,29000
20200312,706347,安勤康和94購01,,,,,,0.00,0,0,0,0,0,0,0,0,0,0,0,0,0
20200312,706348,江興鍛康和94購01,,,,,,0.00,0,0,0,0,0,0,0,0,0,0,0,0,0
20200312,706349,長科*康和94購01,,,,,,0.00,0,0,0,0,0,0,0,0,0,0,0,0,0
20200312,706350,威剛康和94購01,,,,,,0.00,0,0,0,0,0,0,0,0,0,0,0,0,0
20200312,706351,網家康和94購01,,,,,,0.00,0,0,0,0,0,0,0,0,0,0,0,0,0
20200312,706352,穩懋日盛94購01,,,,,,0.00,0,0,0,0,0,0,0,0,0,0,0,0,0
20200312,706353,雙鴻第一94購01,,,,,,0.00,0,0,0,0,0,0,0,0,0,0,0,0,0
20200312,706354,同致元富94購01,,,,,,0.00,0,0,0,0,0,0,0,0,0,0,0,0,0
20200312,706355,新漢元富94購01,,,,,,0.00,0,0,0,0,0,0,0,0,0,0,0,0,0
20200312,706356,業強元富94購01,,,,,,0.00,0,0,0,0,0,0,0,0,0,0,0,0,0
20200312,706357,網家元富96購01,0.04,0.06,0.04,0.06,-0.07,-53.85,144000,4,8040,0,0,0,0,0,0,0,0,0,0
20200312,706358,網家中信94購01,,,,,,0.00,0,0,0,0,0,0,0,0,0,0,0,0,0
20200312,706359,中美晶統一94購01,0.99,0.99,0.91,0.91,-1.55,-63.01,11000,2,10810,0,0,0,0,0,0,1000,10000,-9000,-9000
20200312,706360,東洋統一95購01,0.36,0.36,0.21,0.22,-0.24,-52.17,587000,14,150830,0,0,0,0,0,0,288000,299000,-11000,-11000
20200312,706361,環球晶統一94購01,,,,,,0.00,0,0,0,0,0,0,0,0,0,0,0,0,0
20200312,706362,台燿凱基94購01,,,,,,0.00,0,0,0,0,0,0,0,0,0,0,0,0,0
20200312,706363,新普凱基94購01,,,,,,0.00,0,0,0,0,0,0,0,0,0,0,0,0,0
20200312,706364,榮剛凱基94購01,,,,,,0.00,0,0,0,0,0,0,0,0,0,0,0,0,0
20200312,706365,精華凱基94購01,,,,,,0.00,0,0,0,0,0,0,0,0,0,0,0,0,0
20200312,706366,環球晶凱基94購03,0.36,0.39,0.36,0.39,-0.36,-48.0,30000,2,11400,0,0,0,0,0,0,20000,10000,10000,10000
20200312,706367,宇峻國票94購01,,,,,,0.00,0,0,0,0,0,0,0,0,0,0,0,0,0
20200312,706368,廣明國票94購02,0.01,0.01,0.01,0.01,-0.01,-50.0,700000,3,7000,0,0,0,0,0,0,700000,0,700000,700000
20200312,706369,優群國票95購01,2.12,2.12,2.12,2.12,-0.83,-28.14,10000,1,21200,0,0,0,0,0,0,0,10000,-10000,-10000
20200312,706370,穩懋國票95購01,,,,,,0.00,0,0,0,0,0,0,0,0,0,0,0,0,0
20200312,706371,迅得國泰95購01,0.44,0.44,0.32,0.32,-0.43,-57.33,106000,2,39320,0,0,0,0,0,0,106000,0,106000,106000
20200312,706372,新揚科國泰95購01,,,,,,0.00,0,0,0,0,0,0,0,0,0,0,0,0,0
20200312,706373,雙鴻國泰96購01,0.22,0.22,0.13,0.13,-0.23,-63.89,89000,4,19230,0,0,0,0,0,0,88000,1000,87000,87000
20200312,706374,中美晶富邦95購01,0.61,0.61,0.61,0.61,-0.47,-43.52,3000,1,1830,0,0,0,0,0,0,3000,0,3000,3000
20200312,706375,晶焱兆豐95購01,0.28,0.28,0.22,0.26,-0.08,-23.53,60000,5,14710,0,0,0,0,0,0,50000,10000,40000,40000
20200312,706376,合晶群益94購01,,,,,,0.00,0,0,0,0,0,0,0,0,0,0,0,0,0
20200312,706377,宇峻群益94購01,0.61,0.61,0.32,0.32,-0.27,-45.76,380000,22,170500,0,0,0,0,0,0,200000,180000,20000,20000
20200312,706378,安勤群益94購01,,,,,,0.00,0,0,0,0,0,0,0,0,0,0,0,0,0
20200312,706379,宏觀群益95購01,,,,,,0.00,0,0,0,0,0,0,0,0,0,0,0,0,0
20200312,706380,佳邦群益94購01,,,,,,0.00,0,0,0,0,0,0,0,0,0,0,0,0,0
20200312,706381,協益群益94購01,,,,,,0.00,0,0,0,0,0,0,0,0,0,0,0,0,0
20200312,706382,皇田群益94購01,,,,,,0.00,0,0,0,0,0,0,0,0,0,0,0,0,0
20200312,706383,群聯群益96購01,1.38,1.51,0.69,0.70,-1.61,-69.7,270000,16,235930,0,0,0,0,0,0,48000,222000,-174000,-174000
20200312,706384,網家群益94購01,,,,,,0.00,0,0,0,0,0,0,0,0,0,0,0,0,0
20200312,706385,大學光永豐95購01,1.59,1.59,1.12,1.12,-0.96,-46.15,30000,3,42300,0,0,0,0,0,0,20000,10000,10000,10000
20200312,706386,迅得永豐95購01,,,,,,0.00,0,0,0,0,0,0,0,0,0,0,0,0,0
20200312,706387,新揚科永豐95購01,,,,,,0.00,0,0,0,0,0,0,0,0,0,0,0,0,0
20200312,706388,雙美永豐94購01,,,,,,0.00,0,0,0,0,0,0,0,0,0,0,0,0,0
20200312,706389,金居元富95購01,,,,,,0.00,0,0,0,0,0,0,0,0,0,0,0,0,0
20200312,706390,大江元大95購01,,,,,,0.00,0,0,0,0,0,0,0,0,0,0,0,0,0
20200312,706391,中美晶元大94購02,0.92,0.92,0.92,0.92,-0.56,-37.84,52000,1,47840,0,0,0,0,0,0,0,52000,-52000,-52000
20200312,706392,元太元大94購01,,,,,,0.00,0,0,0,0,0,0,0,0,0,0,0,0,0
20200312,706393,昇達科元大96購01,,,,,,0.00,0,0,0,0,0,0,0,0,0,0,0,0,0
20200312,706394,直得元大94購02,0.74,0.74,0.60,0.60,-0.36,-37.5,656000,4,463600,0,0,0,0,0,0,656000,0,656000,656000
20200312,706395,威剛元大95購01,1.87,1.87,1.12,1.19,-1.21,-50.42,38000,11,52080,0,0,0,0,0,0,11000,32000,-21000,-21000
20200312,706396,神盾元大95購02,0.05,0.05,0.05,0.05,-0.02,-28.57,10000,1,500,0,0,0,0,0,0,10000,0,10000,10000
20200312,706397,順達元大94購01,,,,,,0.00,0,0,0,0,0,0,0,0,0,0,0,0,0
20200312,706398,優群元大95購01,2.51,2.51,2.51,2.51,-0.86,-25.52,10000,1,25100,0,0,0,0,0,0,0,10000,-10000,-10000
20200312,706399,環球晶元大94購04,1.60,1.60,1.60,1.60,-1.63,-50.46,50000,1,80000,0,0,0,0,0,0,0,50000,-50000,-50000
20200312,706400,環球晶中信94購01,,,,,,0.00,0,0,0,0,0,0,0,0,0,0,0,0,0
20200312,706401,大學光凱基94購01,1.07,1.07,0.76,0.76,-0.73,-48.99,30000,3,27400,0,0,0,0,0,0,10000,20000,-10000,-10000
20200312,706402,立端凱基94購02,,,,,,0.00,0,0,0,0,0,0,0,0,0,0,0,0,0
20200312,706403,穩懋凱基94購05,0.10,0.10,0.10,0.10,-0.23,-69.7,10000,1,1000,0,0,0,0,0,0,10000,0,10000,10000
20200312,706404,宏捷科元富94購01,,,,,,0.00,0,0,0,0,0,0,0,0,0,0,0,0,0
20200312,706405,原相元富95購01,,,,,,0.00,0,0,0,0,0,0,0,0,0,0,0,0,0
20200312,706406,大中元大94購01,,,,,,0.00,0,0,0,0,0,0,0,0,0,0,0,0,0
20200312,706407,中美晶元大94購03,0.81,0.81,0.81,0.81,-0.92,-53.18,97000,1,78570,0,0,0,0,0,0,0,97000,-97000,-97000
20200312,706408,昂寶元大96購01,,,,,,0.00,0,0,0,0,0,0,0,0,0,0,0,0,0
20200312,706409,金居元大95購01,0.25,0.26,0.25,0.26,-0.23,-46.94,15000,2,3800,0,0,0,0,0,0,0,15000,-15000,-15000
20200312,706410,信昌電元大96購01,,,,,,0.00,0,0,0,0,0,0,0,0,0,0,0,0,0
20200312,706411,保瑞元大95購01,0.26,0.27,0.26,0.27,-0.07,-20.59,50000,2,13400,0,0,0,0,0,0,50000,0,50000,50000
20200312,706412,宣德元大95購02,0.73,0.73,0.49,0.55,-0.31,-36.05,152000,4,89510,0,0,0,0,0,0,152000,137000,15000,15000
20200312,706413,建榮元大94購02,,,,,,0.00,0,0,0,0,0,0,0,0,0,0,0,0,0
20200312,706414,晶焱元大95購01,0.47,0.47,0.47,0.47,-0.22,-31.88,3000,1,1410,0,0,0,0,0,0,0,3000,-3000,-3000
20200312,706415,緯軟元大96購02,0.14,0.14,0.14,0.14,-0.04,-22.22,30000,1,4200,0,0,0,0,0,0,30000,0,30000,30000
20200312,706416,優群元大94購01,,,,,,0.00,0,0,0,0,0,0,0,0,0,0,0,0,0
20200312,706417,雙鴻元大97購01,0.23,0.23,0.15,0.15,-0.12,-44.44,369000,11,68760,0,0,0,0,0,0,213000,156000,57000,57000
20200312,706418,穩懋元大94購04,0.16,0.16,0.16,0.16,-0.43,-72.88,450000,1,72000,0,0,0,0,0,0,0,450000,-450000,-450000
20200312,706419,鈺太元大96購01,,,,,,0.00,0,0,0,0,0,0,0,0,0,0,0,0,0
20200312,706420,宏捷科台新94購01,,,,,,0.00,0,0,0,0,0,0,0,0,0,0,0,0,0
20200312,706421,大江兆豐94購01,,,,,,0.00,0,0,0,0,0,0,0,0,0,0,0,0,0
20200312,706422,大江群益94購04,,,,,,0.00,0,0,0,0,0,0,0,0,0,0,0,0,0
20200312,706423,宏觀群益96購01,0.04,0.04,0.02,0.02,-0.03,-60.0,300000,4,9000,0,0,0,0,0,0,0,200000,-200000,-200000
20200312,706424,泰博群益94購01,0.71,0.71,0.53,0.60,-0.71,-54.2,40000,4,25200,0,0,0,0,0,0,10000,30000,-20000,-20000
20200312,706425,新揚科群益94購01,,,,,,0.00,0,0,0,0,0,0,0,0,0,0,0,0,0
20200312,706426,群聯群益94購01,,,,,,0.00,0,0,0,0,0,0,0,0,0,0,0,0,0
20200312,706427,雙鴻群益96購01,0.18,0.18,0.14,0.14,-0.13,-48.15,160000,3,26400,0,0,0,0,0,0,60000,100000,-40000,-40000
20200312,706428,鐿鈦群益95購01,,,,,,0.00,0,0,0,0,0,0,0,0,0,0,0,0,0
20200312,706429,宇峻國票95購01,1.24,1.30,1.07,1.07,-0.18,-14.4,636000,9,739670,0,0,0,0,0,0,0,636000,-636000,-636000
20200312,706430,建榮國票96購01,,,,,,0.00,0,0,0,0,0,0,0,0,0,0,0,0,0
20200312,706431,神盾國票94購03,,,,,,0.00,0,0,0,0,0,0,0,0,0,0,0,0,0
20200312,706432,環球晶國票95購01,2.83,2.83,2.40,2.62,-1.81,-40.86,30000,3,78500,0,0,0,0,0,0,0,30000,-30000,-30000
20200312,706433,譜瑞國票94購01,1.88,1.88,1.79,1.79,-1.42,-44.24,20000,2,36700,0,0,0,0,0,0,10000,10000,0,0
20200312,706434,宏捷科國泰95購01,0.92,0.92,0.57,0.67,-0.33,-33.0,409000,29,315500,0,0,0,0,0,0,279000,130000,149000,149000
20200312,706435,保瑞國泰95購03,0.30,0.30,0.24,0.25,-0.14,-35.9,225000,27,59120,0,0,0,0,0,0,175000,50000,125000,125000
20200312,706436,穩懋富邦96購01,0.73,0.74,0.52,0.55,-0.35,-38.89,322000,16,190830,0,0,0,0,0,0,175000,147000,28000,28000
20200312,706437,新普第一94購01,,,,,,0.00,0,0,0,0,0,0,0,0,0,0,0,0,0
20200312,706438,櫃200第一94購01,,,,,,0.00,0,0,0,0,0,0,0,0,0,0,0,0,0
20200312,706439,上詮永豐94購02,,,,,,0.00,0,0,0,0,0,0,0,0,0,0,0,0,0
20200312,706440,宏捷科永豐95購01,0.31,0.32,0.21,0.26,-0.14,-35.0,379000,12,92670,0,0,0,0,0,0,334000,35000,299000,299000
20200312,706441,神盾永豐94購01,,,,,,0.00,0,0,0,0,0,0,0,0,0,0,0,0,0
20200312,706442,安勤中信94購01,,,,,,0.00,0,0,0,0,0,0,0,0,0,0,0,0,0
20200312,706443,璟德統一94購01,0.98,0.98,0.58,0.58,-1.40,-70.71,126000,14,79400,0,0,0,0,0,0,14000,112000,-98000,-98000
20200312,706444,雙鴻統一94購02,,,,,,0.00,0,0,0,0,0,0,0,0,0,0,0,0,0
20200312,706445,緯軟麥證95購01,,,,,,0.00,0,0,0,0,0,0,0,0,0,0,0,0,0
20200312,706446,雙鴻麥證96購01,0.18,0.18,0.15,0.15,-0.09,-37.5,27000,2,4260,20000,7000,13000,0,0,0,20000,7000,13000,13000
20200312,706447,中美晶元富95購02,1.89,1.89,1.55,1.55,-0.91,-36.99,46000,6,78150,0,0,0,0,0,0,11000,36000,-25000,-25000
20200312,706448,威剛元富97購01,2.48,2.48,2.34,2.34,-1.66,-41.5,28000,3,67540,0,0,0,0,0,0,8000,20000,-12000,-12000
20200312,706449,大江元大94購02,,,,,,0.00,0,0,0,0,0,0,0,0,0,0,0,0,0
20200312,706450,中美晶元大94購04,,,,,,0.00,0,0,0,0,0,0,0,0,0,0,0,0,0
20200312,706451,中美晶元大94購05,3.33,3.33,3.00,3.00,-1.18,-28.23,11000,2,36300,0,0,0,0,0,0,11000,1000,10000,10000
20200312,706452,保瑞元大94購01,,,,,,0.00,0,0,0,0,0,0,0,0,0,0,0,0,0
20200312,706453,美琪瑪元大95購01,,,,,,0.00,0,0,0,0,0,0,0,0,0,0,0,0,0
20200312,706454,茂達元大94購01,0.63,0.63,0.63,0.63,-0.45,-41.67,3000,1,1890,0,0,0,0,0,0,0,3000,-3000,-3000
20200312,706455,原相元大94購03,,,,,,0.00,0,0,0,0,0,0,0,0,0,0,0,0,0
20200312,706456,神盾元大95購03,,,,,,0.00,0,0,0,0,0,0,0,0,0,0,0,0,0
20200312,706457,晶焱元大94購02,,,,,,0.00,0,0,0,0,0,0,0,0,0,0,0,0,0
20200312,706458,群聯元大95購03,0.64,0.64,0.29,0.33,-0.44,-57.14,793000,17,293290,0,0,0,0,0,0,240000,553000,-313000,-313000
20200312,706459,環球晶元大94購05,,,,,,0.00,0,0,0,0,0,0,0,0,0,0,0,0,0
20200312,706460,穩懋元大94購05,0.10,0.10,0.10,0.10,-0.25,-71.43,68000,1,6800,0,0,0,0,0,0,68000,0,68000,68000
20200312,706461,元太富邦96購01,0.34,0.34,0.30,0.30,-0.15,-33.33,305000,4,98650,0,0,0,0,0,0,105000,200000,-95000,-95000
20200312,706462,鐿鈦國票95購02,,,,,,0.00,0,0,0,0,0,0,0,0,0,0,0,0,0
20200312,706463,中美晶凱基94購01,0.69,0.77,0.62,0.77,-0.64,-45.39,100000,10,69300,0,0,0,0,0,0,0,100000,-100000,-100000
20200312,706464,由田凱基94購02,,,,,,0.00,0,0,0,0,0,0,0,0,0,0,0,0,0
20200312,706465,立端凱基94購03,,,,,,0.00,0,0,0,0,0,0,0,0,0,0,0,0,0
20200312,706466,良維凱基94購01,,,,,,0.00,0,0,0,0,0,0,0,0,0,0,0,0,0
20200312,706467,迅得凱基94購01,,,,,,0.00,0,0,0,0,0,0,0,0,0,0,0,0,0
20200312,706468,波若威凱基94購01,,,,,,0.00,0,0,0,0,0,0,0,0,0,0,0,0,0
20200312,706469,宣德凱基94購01,,,,,,0.00,0,0,0,0,0,0,0,0,0,0,0,0,0
20200312,706470,博智凱基94購01,5.00,5.50,4.97,5.50,-2.35,-29.94,33000,4,169910,0,0,0,0,0,0,0,33000,-33000,-33000
20200312,706471,群聯凱基94購01,1.21,1.21,0.60,0.63,-1.66,-72.49,84000,10,79090,0,0,0,0,0,0,0,84000,-84000,-84000
20200312,706472,精華凱基94購02,,,,,,0.00,0,0,0,0,0,0,0,0,0,0,0,0,0
20200312,706473,優群凱基94購01,1.34,1.34,1.05,1.05,-0.56,-34.78,40000,4,46500,0,0,0,0,0,0,20000,20000,0,0
20200312,706474,聯亞凱基94購02,,,,,,0.00,0,0,0,0,0,0,0,0,0,0,0,0,0
20200312,706475,元太兆豐95購01,0.16,0.16,0.16,0.16,-0.04,-20.0,30000,2,4800,0,0,0,0,0,0,30000,0,30000,30000
20200312,706476,雙美兆豐94購01,,,,,,0.00,0,0,0,0,0,0,0,0,0,0,0,0,0
20200312,706477,雙鴻兆豐95購01,,,,,,0.00,0,0,0,0,0,0,0,0,0,0,0,0,0
20200312,706478,大田群益94購01,,,,,,0.00,0,0,0,0,0,0,0,0,0,0,0,0,0
20200312,706479,中美晶群益94購01,,,,,,0.00,0,0,0,0,0,0,0,0,0,0,0,0,0
20200312,706480,宏捷科群益94購01,0.10,0.10,0.04,0.06,-0.07,-53.85,571000,38,30980,0,0,0,0,0,0,210000,298000,-88000,-88000
20200312,706481,雙鴻群益96購02,,,,,,0.00,0,0,0,0,0,0,0,0,0,0,0,0,0
20200312,706482,中美晶亞東94購01,,,,,,0.00,0,0,0,0,0,0,0,0,0,0,0,0,0
20200312,706483,元太亞東94購01,,,,,,0.00,0,0,0,0,0,0,0,0,0,0,0,0,0
20200312,706484,大江永豐94購02,,,,,,0.00,0,0,0,0,0,0,0,0,0,0,0,0,0
20200312,706485,宏觀永豐94購01,,,,,,0.00,0,0,0,0,0,0,0,0,0,0,0,0,0
20200312,706486,威剛永豐94購01,,,,,,0.00,0,0,0,0,0,0,0,0,0,0,0,0,0
20200312,706487,雙美永豐94購02,,,,,,0.00,0,0,0,0,0,0,0,0,0,0,0,0,0
20200312,706488,雙鴻永豐95購02,,,,,,0.00,0,0,0,0,0,0,0,0,0,0,0,0,0
20200312,706489,譜瑞永豐94購01,,,,,,0.00,0,0,0,0,0,0,0,0,0,0,0,0,0
20200312,706490,鈺太中信94購01,0.38,0.38,0.38,0.38,-0.62,-62.0,10000,1,3800,0,0,0,0,0,0,0,10000,-10000,-10000
20200312,706491,六角凱基94購01,0.10,0.10,0.10,0.10,-0.13,-56.52,14000,1,1400,0,0,0,0,0,0,14000,0,14000,14000
20200312,706492,立端凱基94購04,,,,,,0.00,0,0,0,0,0,0,0,0,0,0,0,0,0
20200312,706493,合晶凱基94購01,,,,,,0.00,0,0,0,0,0,0,0,0,0,0,0,0,0
20200312,706494,昇達科凱基94購01,,,,,,0.00,0,0,0,0,0,0,0,0,0,0,0,0,0
20200312,706495,新普凱基94購02,,,,,,0.00,0,0,0,0,0,0,0,0,0,0,0,0,0
20200312,706496,穩懋凱基94購06,0.28,0.28,0.28,0.28,-0.37,-56.92,10000,1,2800,0,0,0,0,0,0,10000,0,10000,10000
20200312,706497,譜瑞凱基94購03,0.20,0.25,0.20,0.22,-0.85,-79.44,21000,4,4550,0,0,0,0,0,0,0,21000,-21000,-21000
20200312,706498,晟德凱基94購01,,,,,,0.00,0,0,0,0,0,0,0,0,0,0,0,0,0
20200312,706499,大中永豐94購01,0.01,0.01,0.01,0.01,-0.02,-66.67,200000,1,2000,0,0,0,0,0,0,200000,0,200000,200000
20200312,706500,信驊永豐94購01,0.99,1.01,0.93,0.93,-0.46,-33.09,23000,3,23050,0,0,0,0,0,0,20000,3000,17000,17000
20200312,706501,網龍永豐95購01,,,,,,0.00,0,0,0,0,0,0,0,0,0,0,0,0,0
20200312,706502,雙鴻永豐95購03,,,,,,0.00,0,0,0,0,0,0,0,0,0,0,0,0,0
20200312,706503,鈺太永豐94購02,0.38,0.38,0.23,0.24,-0.35,-59.32,100000,10,26800,0,0,0,0,0,0,10000,90000,-80000,-80000
20200312,706504,精華日盛94購01,,,,,,0.00,0,0,0,0,0,0,0,0,0,0,0,0,0
20200312,706505,雙美日盛94購01,,,,,,0.00,0,0,0,0,0,0,0,0,0,0,0,0,0
20200312,706506,元太統一94購01,0.29,0.29,0.29,0.29,-0.10,-25.64,6000,1,1740,0,0,0,0,0,0,6000,6000,0,0
20200312,706507,譜瑞統一94購02,0.42,0.50,0.42,0.45,-0.57,-55.88,88000,6,41410,0,0,0,0,0,0,50000,38000,12000,12000
20200312,706508,大江兆豐95購01,,,,,,0.00,0,0,0,0,0,0,0,0,0,0,0,0,0
20200312,706509,台燿兆豐94購02,0.09,0.09,0.07,0.07,-0.12,-63.16,110000,9,8400,0,0,0,0,0,0,0,110000,-110000,-110000
20200312,706510,新普兆豐94購01,0.27,0.33,0.26,0.31,-0.23,-42.59,140000,5,41500,0,0,0,0,0,0,60000,80000,-20000,-20000
20200312,706511,精華兆豐95購01,,,,,,0.00,0,0,0,0,0,0,0,0,0,0,0,0,0
20200312,706512,直得群益94購01,0.58,0.58,0.44,0.44,-0.27,-38.03,31000,4,13780,0,0,0,0,0,0,1000,30000,-29000,-29000
20200312,706513,金居群益96購01,,,,,,0.00,0,0,0,0,0,0,0,0,0,0,0,0,0
20200312,706514,鈺太元富94購01,0.81,0.83,0.81,0.83,-0.52,-38.52,59000,2,47970,0,0,0,0,0,0,59000,0,59000,59000
20200312,706515,保瑞台新94購01,,,,,,0.00,0,0,0,0,0,0,0,0,0,0,0,0,0
20200312,706516,大田元大96購01,,,,,,0.00,0,0,0,0,0,0,0,0,0,0,0,0,0
20200312,706517,大江元大95購02,,,,,,0.00,0,0,0,0,0,0,0,0,0,0,0,0,0
20200312,706518,杰力元大96購01,0.31,0.31,0.24,0.24,-0.12,-33.33,43000,5,12850,0,0,0,0,0,0,35000,8000,27000,27000
20200312,706519,雙美元大94購03,,,,,,0.00,0,0,0,0,0,0,0,0,0,0,0,0,0
20200312,706520,穩懋元大94購06,0.20,0.20,0.08,0.08,-0.24,-75.0,198000,9,30020,0,0,0,0,0,0,104000,94000,10000,10000
20200312,706521,譜瑞元大94購01,,,,,,0.00,0,0,0,0,0,0,0,0,0,0,0,0,0
20200312,706522,鈺太元大94購01,1.73,1.73,1.33,1.33,-1.08,-44.81,60000,3,81800,0,0,0,0,0,0,5000,55000,-50000,-50000
20200312,706523,M31國票95購01,,,,,,0.00,0,0,0,0,0,0,0,0,0,0,0,0,0
20200312,706524,中美晶國票94購02,,,,,,0.00,0,0,0,0,0,0,0,0,0,0,0,0,0
20200312,706525,信昌電國票94購02,,,,,,0.00,0,0,0,0,0,0,0,0,0,0,0,0,0
20200312,706526,是方國票94購01,0.68,0.78,0.55,0.62,-0.23,-27.06,502000,18,327880,0,0,0,0,0,0,312000,190000,122000,122000
20200312,706527,晶焱國票95購01,,,,,,0.00,0,0,0,0,0,0,0,0,0,0,0,0,0
20200312,706528,廣明國票95購01,,,,,,0.00,0,0,0,0,0,0,0,0,0,0,0,0,0
20200312,706529,M31國泰96購01,,,,,,0.00,0,0,0,0,0,0,0,0,0,0,0,0,0
20200312,706530,群聯國泰96購01,1.46,1.46,1.13,1.21,-1.00,-45.25,274000,6,366760,0,0,0,0,0,0,112000,185000,-73000,-73000
20200312,706531,雙鴻國泰96購02,,,,,,0.00,0,0,0,0,0,0,0,0,0,0,0,0,0
20200312,706532,勝麗凱基94購01,0.51,0.51,0.31,0.31,-0.50,-61.73,166000,4,80020,0,0,0,0,0,0,125000,41000,84000,84000
20200312,706533,凡甲統一94購01,0.50,0.50,0.32,0.32,-0.38,-54.29,771000,18,293700,0,0,0,0,0,0,171000,600000,-429000,-429000
20200312,706534,元太統一94購02,,,,,,0.00,0,0,0,0,0,0,0,0,0,0,0,0,0
20200312,706535,東洋統一94購01,,,,,,0.00,0,0,0,0,0,0,0,0,0,0,0,0,0
20200312,706536,大中元大95購01,,,,,,0.00,0,0,0,0,0,0,0,0,0,0,0,0,0
20200312,706537,元太元大95購01,0.51,0.51,0.51,0.51,-0.18,-26.09,68000,1,34680,0,0,0,0,0,0,0,68000,-68000,-68000
20200312,706538,宏觀元大95購01,,,,,,0.00,0,0,0,0,0,0,0,0,0,0,0,0,0
20200312,706539,信昌電元大95購01,0.42,0.42,0.35,0.35,-0.31,-46.97,153000,2,53760,0,0,0,0,0,0,153000,0,153000,153000
20200312,706540,保瑞元大95購02,,,,,,0.00,0,0,0,0,0,0,0,0,0,0,0,0,0
20200312,706541,神盾元大95購05,0.03,0.03,0.03,0.03,-0.03,-50.0,240000,24,7200,0,0,0,0,0,0,0,240000,-240000,-240000
20200312,706542,精華元大95購01,0.27,0.27,0.17,0.17,-0.18,-51.43,63000,6,12860,0,0,0,0,0,0,18000,53000,-35000,-35000
20200312,706543,聯亞元大95購01,0.72,0.72,0.57,0.57,-0.53,-48.18,143000,4,84460,0,0,0,0,0,0,23000,133000,-110000,-110000
20200312,706544,譜瑞元大95購01,1.98,2.28,1.98,2.05,-1.89,-47.97,62000,6,129460,0,0,0,0,0,0,4000,62000,-58000,-58000
20200312,706545,元太元富94購01,,,,,,0.00,0,0,0,0,0,0,0,0,0,0,0,0,0
20200312,706546,建榮元富95購01,,,,,,0.00,0,0,0,0,0,0,0,0,0,0,0,0,0
20200312,706547,昇達科兆豐95購01,,,,,,0.00,0,0,0,0,0,0,0,0,0,0,0,0,0
20200312,706548,M31國票95購02,,,,,,0.00,0,0,0,0,0,0,0,0,0,0,0,0,0
20200312,706549,大江國票95購01,,,,,,0.00,0,0,0,0,0,0,0,0,0,0,0,0,0
20200312,706550,宏捷科國票95購02,0.48,0.48,0.23,0.30,-0.25,-45.45,1585000,48,518140,0,0,0,0,0,0,1009000,561000,448000,448000
20200312,706551,雙鴻國票95購01,,,,,,0.00,0,0,0,0,0,0,0,0,0,0,0,0,0
20200312,706552,同致群益94購01,,,,,,0.00,0,0,0,0,0,0,0,0,0,0,0,0,0
20200312,706553,信驊群益94購01,4.17,4.17,3.66,3.66,-0.89,-19.56,12000,2,49020,0,0,0,0,0,0,10000,2000,8000,8000
20200312,706554,神盾群益96購01,,,,,,0.00,0,0,0,0,0,0,0,0,0,0,0,0,0
20200312,706555,鈺太群益94購01,1.88,1.88,1.37,1.37,-1.33,-49.26,30000,3,51300,0,0,0,0,0,0,20000,10000,10000,10000
20200312,706556,由田富邦96購01,,,,,,0.00,0,0,0,0,0,0,0,0,0,0,0,0,0
20200312,706557,櫃200永昌94購01,,,,,,0.00,0,0,0,0,0,0,0,0,0,0,0,0,0
20200312,706558,櫃200永昌94購02,,,,,,0.00,0,0,0,0,0,0,0,0,0,0,0,0,0
20200312,706559,閎康永豐94購01,,,,,,0.00,0,0,0,0,0,0,0,0,0,0,0,0,0
20200312,706560,優群永豐94購02,,,,,,0.00,0,0,0,0,0,0,0,0,0,0,0,0,0
20200312,706561,雙美永豐95購01,,,,,,0.00,0,0,0,0,0,0,0,0,0,0,0,0,0
20200312,706562,鈺太永豐94購03,0.62,0.62,0.44,0.44,-0.44,-50.0,20000,2,10600,0,0,0,0,0,0,10000,10000,0,0
20200312,706563,凡甲永豐94購01,,,,,,0.00,0,0,0,0,0,0,0,0,0,0,0,0,0
20200312,706564,元太群益95購01,0.40,0.40,0.40,0.40,-0.15,-27.27,200000,1,80000,0,0,0,0,0,0,200000,0,200000,200000
20200312,706565,環球晶群益94購02,0.55,0.55,0.42,0.42,-0.48,-53.33,26000,3,13920,0,0,0,0,0,0,24000,5000,19000,19000
20200312,706566,雙美群益94購01,,,,,,0.00,0,0,0,0,0,0,0,0,0,0,0,0,0
20200312,706567,建榮麥證94購01,,,,,,0.00,0,0,0,0,0,0,0,0,0,0,0,0,0
20200312,706568,大江台新94購01,,,,,,0.00,0,0,0,0,0,0,0,0,0,0,0,0,0
20200312,706569,金居國票95購01,,,,,,0.00,0,0,0,0,0,0,0,0,0,0,0,0,0
20200312,706570,泰博國票95購02,3.39,3.52,3.39,3.52,-1.48,-29.6,9000,2,31030,0,0,0,0,0,0,4000,5000,-1000,-1000
20200312,706571,大江元大94購03,,,,,,0.00,0,0,0,0,0,0,0,0,0,0,0,0,0
20200312,706572,宏捷科元大95購01,0.29,0.29,0.17,0.21,-0.12,-36.36,1046000,29,219580,0,0,0,0,0,0,488000,515000,-27000,-27000
20200312,706573,金可元大94購01,,,,,,0.00,0,0,0,0,0,0,0,0,0,0,0,0,0
20200312,706574,建榮元大97購01,,,,,,0.00,0,0,0,0,0,0,0,0,0,0,0,0,0
20200312,706575,上詮凱基94購02,,,,,,0.00,0,0,0,0,0,0,0,0,0,0,0,0,0
20200312,706576,金可凱基94購01,0.10,0.10,0.05,0.10,-0.07,-41.18,132000,12,10600,0,0,0,0,0,0,40000,72000,-32000,-32000
20200312,706577,信昌電凱基94購01,,,,,,0.00,0,0,0,0,0,0,0,0,0,0,0,0,0
20200312,706578,聚積凱基94購02,,,,,,0.00,0,0,0,0,0,0,0,0,0,0,0,0,0
20200312,706579,晟德凱基94購03,,,,,,0.00,0,0,0,0,0,0,0,0,0,0,0,0,0
20200312,706580,櫃200富邦94購01,,,,,,0.00,0,0,0,0,0,0,0,0,0,0,0,0,0
20200312,706581,櫃200富邦94購02,,,,,,0.00,0,0,0,0,0,0,0,0,0,0,0,0,0
20200312,706582,櫃200富邦94購03,,,,,,0.00,0,0,0,0,0,0,0,0,0,0,0,0,0
20200312,706583,櫃200富邦94購04,,,,,,0.00,0,0,0,0,0,0,0,0,0,0,0,0,0
20200312,706584,神盾國票95購02,,,,,,0.00,0,0,0,0,0,0,0,0,0,0,0,0,0
20200312,706585,宏捷科國泰95購03,0.25,0.25,0.15,0.18,-0.11,-37.93,509000,20,91780,0,0,0,0,0,0,128000,356000,-228000,-228000
20200312,706586,凡甲統一95購01,0.20,0.20,0.20,0.20,-0.11,-35.48,286000,10,57200,0,0,0,0,0,0,0,286000,-286000,-286000
20200312,706587,凡甲統一95購02,,,,,,0.00,0,0,0,0,0,0,0,0,0,0,0,0,0
20200312,706588,雙美統一95購01,,,,,,0.00,0,0,0,0,0,0,0,0,0,0,0,0,0
20200312,706589,VHQ凱基94購01,,,,,,0.00,0,0,0,0,0,0,0,0,0,0,0,0,0
20200312,706590,宏捷科凱基94購01,,,,,,0.00,0,0,0,0,0,0,0,0,0,0,0,0,0
20200312,706591,宏捷科凱基94購02,0.05,0.05,0.05,0.05,-0.05,-50.0,90000,2,4500,0,0,0,0,0,0,40000,0,40000,40000
20200312,706592,環球晶凱基94購05,1.48,1.48,1.28,1.28,-0.80,-38.46,13000,2,17240,0,0,0,0,0,0,3000,13000,-10000,-10000
20200312,706593,均豪永豐94購01,,,,,,0.00,0,0,0,0,0,0,0,0,0,0,0,0,0
20200312,706594,杰力永豐94購01,,,,,,0.00,0,0,0,0,0,0,0,0,0,0,0,0,0
20200312,706595,宣德永豐94購01,,,,,,0.00,0,0,0,0,0,0,0,0,0,0,0,0,0
20200312,706596,建榮永豐96購01,,,,,,0.00,0,0,0,0,0,0,0,0,0,0,0,0,0
20200312,706597,神準永豐94購01,,,,,,0.00,0,0,0,0,0,0,0,0,0,0,0,0,0
20200312,706598,碩禾永豐95購01,0.26,0.26,0.23,0.23,-0.16,-41.03,30000,2,7200,0,0,0,0,0,0,30000,0,30000,30000
20200312,706599,環宇永豐94購01,,,,,,0.00,0,0,0,0,0,0,0,0,0,0,0,0,0
20200312,706600,環球晶永豐94購02,,,,,,0.00,0,0,0,0,0,0,0,0,0,0,0,0,0
20200312,706601,聯亞永豐94購02,0.42,0.42,0.27,0.27,-0.47,-63.51,136000,5,41400,0,0,0,0,0,0,110000,26000,84000,84000
20200312,706602,大江元大96購01,0.03,0.03,0.03,0.03,-0.03,-50.0,15000,2,450,0,0,0,0,0,0,0,15000,-15000,-15000
20200312,706603,信驊元大94購01,,,,,,0.00,0,0,0,0,0,0,0,0,0,0,0,0,0
20200312,706604,勝麗元大95購01,0.99,0.99,0.71,0.71,-0.62,-46.62,195000,6,172610,0,0,0,0,0,0,150000,45000,105000,105000
20200312,706605,環球晶元富94購03,1.31,1.48,0.68,1.37,-0.28,-16.97,176000,16,194900,0,0,0,0,0,0,46000,130000,-84000,-84000
20200312,706606,M31兆豐94購01,,,,,,0.00,0,0,0,0,0,0,0,0,0,0,0,0,0
20200312,706607,中美晶兆豐95購02,0.49,0.50,0.37,0.38,-0.28,-42.42,192000,10,83470,0,0,0,0,0,0,187000,11000,176000,176000
20200312,706608,六角台新94購02,0.44,0.44,0.44,0.44,-0.31,-41.33,10000,1,4400,0,0,0,0,0,0,0,10000,-10000,-10000
20200312,706609,威剛台新94購01,,,,,,0.00,0,0,0,0,0,0,0,0,0,0,0,0,0
20200312,706610,昂寶群益95購01,,,,,,0.00,0,0,0,0,0,0,0,0,0,0,0,0,0
20200312,706611,杰力群益94購01,,,,,,0.00,0,0,0,0,0,0,0,0,0,0,0,0,0
20200312,706612,原相群益97購01,3.97,3.97,3.10,3.20,-1.48,-31.62,122000,5,464690,0,0,0,0,0,0,20000,102000,-82000,-82000
20200312,706613,環球晶群益94購03,0.38,0.42,0.20,0.39,-0.18,-31.58,91000,11,33430,0,0,0,0,0,0,26000,65000,-39000,-39000
20200312,706614,櫃200永昌96購01,,,,,,0.00,0,0,0,0,0,0,0,0,0,0,0,0,0
20200312,706615,櫃200永昌96購02,,,,,,0.00,0,0,0,0,0,0,0,0,0,0,0,0,0
20200312,706616,櫃200永昌96購03,,,,,,0.00,0,0,0,0,0,0,0,0,0,0,0,0,0
20200312,706617,M31中信95購01,,,,,,0.00,0,0,0,0,0,0,0,0,0,0,0,0,0
20200312,706618,原相國泰96購01,,,,,,0.00,0,0,0,0,0,0,0,0,0,0,0,0,0
20200312,706619,環球晶國泰95購01,1.44,1.44,0.94,1.13,-1.06,-48.4,287000,5,310040,0,0,0,0,0,0,110000,197000,-87000,-87000
20200312,706620,宜鼎凱基94購02,0.81,0.81,0.81,0.81,-0.48,-37.21,98000,1,79380,0,0,0,0,0,0,0,98000,-98000,-98000
20200312,706621,泰博凱基94購01,1.17,1.17,1.10,1.10,-0.72,-39.56,35000,2,39200,0,0,0,0,0,0,0,35000,-35000,-35000
20200312,706622,優群凱基94購02,1.99,1.99,1.95,1.95,-1.17,-37.5,35000,3,68850,0,0,0,0,0,0,20000,15000,5000,5000
20200312,706623,雙鴻凱基94購01,,,,,,0.00,0,0,0,0,0,0,0,0,0,0,0,0,0
20200312,706624,雙鴻凱基96購01,,,,,,0.00,0,0,0,0,0,0,0,0,0,0,0,0,0
20200312,706625,大宇資永豐94購02,,,,,,0.00,0,0,0,0,0,0,0,0,0,0,0,0,0
20200312,706626,立端永豐94購01,,,,,,0.00,0,0,0,0,0,0,0,0,0,0,0,0,0
20200312,706627,同致永豐94購01,,,,,,0.00,0,0,0,0,0,0,0,0,0,0,0,0,0
20200312,706628,安勤永豐94購02,,,,,,0.00,0,0,0,0,0,0,0,0,0,0,0,0,0
20200312,706629,信昌電永豐94購03,,,,,,0.00,0,0,0,0,0,0,0,0,0,0,0,0,0
20200312,706630,威剛永豐94購02,,,,,,0.00,0,0,0,0,0,0,0,0,0,0,0,0,0
20200312,706631,櫃200第一96購01,0.38,0.39,0.36,0.39,-0.23,-37.1,21000,5,7890,0,0,0,0,0,0,0,21000,-21000,-21000
20200312,706632,聚積元富94購01,,,,,,0.00,0,0,0,0,0,0,0,0,0,0,0,0,0
20200312,706633,合晶台新95購01,0.42,0.44,0.36,0.40,-0.21,-34.43,362000,9,143780,0,0,0,0,0,0,32000,330000,-298000,-298000
20200312,706634,六角康和94購01,,,,,,0.00,0,0,0,0,0,0,0,0,0,0,0,0,0
20200312,706635,凡甲群益94購01,0.38,0.38,0.33,0.33,-0.35,-51.47,127000,3,43060,0,0,0,0,0,0,127000,0,127000,127000
20200312,706636,大宇資群益94購02,,,,,,0.00,0,0,0,0,0,0,0,0,0,0,0,0,0
20200312,706637,台燿群益94購02,0.04,0.04,0.04,0.04,-0.04,-50.0,30000,1,1200,0,0,0,0,0,0,0,30000,-30000,-30000
20200312,706638,美琪瑪群益94購01,,,,,,0.00,0,0,0,0,0,0,0,0,0,0,0,0,0
20200312,706639,群聯群益94購02,0.86,0.86,0.25,0.33,-1.41,-81.03,63000,8,33880,0,0,0,0,0,0,22000,43000,-21000,-21000
20200312,706640,環球晶群益94購04,,,,,,0.00,0,0,0,0,0,0,0,0,0,0,0,0,0
20200312,706641,中美晶元大94購06,0.58,0.64,0.55,0.64,-0.36,-36.0,204000,5,118020,0,0,0,0,0,0,4000,204000,-200000,-200000
20200312,706642,中美晶元大95購02,0.77,0.77,0.55,0.71,-0.19,-21.11,137000,9,91230,0,0,0,0,0,0,115000,62000,53000,53000
20200312,706643,台燿元大94購03,,,,,,0.00,0,0,0,0,0,0,0,0,0,0,0,0,0
20200312,706644,台燿元大94購04,,,,,,0.00,0,0,0,0,0,0,0,0,0,0,0,0,0
20200312,706645,昂寶元大97購01,,,,,,0.00,0,0,0,0,0,0,0,0,0,0,0,0,0
20200312,706646,昇達科元大96購02,0.14,0.14,0.13,0.13,-0.10,-43.48,118000,2,16340,0,0,0,0,0,0,18000,100000,-82000,-82000
20200312,706647,金居元大95購02,,,,,,0.00,0,0,0,0,0,0,0,0,0,0,0,0,0
20200312,706648,閎康元大94購01,0.25,0.25,0.25,0.25,-0.27,-51.92,60000,1,15000,0,0,0,0,0,0,60000,0,60000,60000
20200312,706649,新普元大94購01,,,,,,0.00,0,0,0,0,0,0,0,0,0,0,0,0,0
20200312,706650,新普元大94購02,0.98,0.98,0.98,0.98,-0.37,-27.41,2000,1,1960,0,0,0,0,0,0,2000,2000,0,0
20200312,706651,雙美元大96購01,0.18,0.18,0.18,0.18,-0.02,-10.0,100000,1,18000,0,0,0,0,0,0,100000,0,100000,100000
20200312,706652,晟德元大94購01,0.22,0.22,0.15,0.15,-0.12,-44.44,11000,2,1720,0,0,0,0,0,0,11000,0,11000,11000
20200312,706653,環球晶麥證95購01,0.75,0.75,0.53,0.53,-0.44,-45.36,20000,2,12800,10000,10000,0,0,0,0,10000,10000,0,0
20200312,706654,優群元富94購01,2.62,2.62,2.62,2.62,-1.12,-29.95,17000,1,44540,0,0,0,0,0,0,0,17000,-17000,-17000
20200312,706655,環球晶元富94購04,0.49,0.49,0.49,0.49,-0.58,-54.21,10000,1,4900,0,0,0,0,0,0,10000,0,10000,10000
20200312,706656,緯軟兆豐95購02,,,,,,0.00,0,0,0,0,0,0,0,0,0,0,0,0,0
20200312,706657,環球晶兆豐95購02,0.58,0.58,0.40,0.40,-0.41,-50.62,70000,4,38310,0,0,0,0,0,0,70000,0,70000,70000
20200312,706658,穩懋兆豐95購01,0.05,0.05,0.03,0.04,-0.06,-60.0,884000,37,33120,0,0,0,0,0,0,20000,405000,-385000,-385000
20200312,706659,中美晶台新95購01,1.34,1.34,1.30,1.30,-0.42,-24.42,50000,6,66200,0,0,0,0,0,0,50000,0,50000,50000
20200312,706660,順達康和94購01,0.61,0.62,0.61,0.62,-0.21,-25.3,2000,2,1230,0,0,0,0,0,0,2000,0,2000,2000
20200312,706661,雙鴻康和94購01,,,,,,0.00,0,0,0,0,0,0,0,0,0,0,0,0,0
20200312,706662,中美晶群益94購03,0.41,0.41,0.21,0.33,-0.32,-49.23,15000,4,5530,0,0,0,0,0,0,12000,3000,9000,9000
20200312,706663,同致群益94購02,,,,,,0.00,0,0,0,0,0,0,0,0,0,0,0,0,0
20200312,706664,合晶群益94購02,0.20,0.20,0.20,0.20,-0.12,-37.5,54000,1,10800,0,0,0,0,0,0,54000,0,54000,54000
20200312,706665,璟德群益94購01,0.82,0.82,0.49,0.56,-0.62,-52.54,100000,9,57700,0,0,0,0,0,0,80000,20000,60000,60000
20200312,706666,雙鴻群益95購02,,,,,,0.00,0,0,0,0,0,0,0,0,0,0,0,0,0
20200312,706667,安勤元大94購01,,,,,,0.00,0,0,0,0,0,0,0,0,0,0,0,0,0
20200312,706668,昂寶元大96購02,,,,,,0.00,0,0,0,0,0,0,0,0,0,0,0,0,0
20200312,706669,保瑞元大94購02,0.94,0.94,0.76,0.79,-0.30,-27.52,212000,11,171080,0,0,0,0,0,0,120000,92000,28000,28000
20200312,706670,閎康元大94購02,0.37,0.37,0.37,0.37,-0.35,-48.61,10000,1,3700,0,0,0,0,0,0,10000,0,10000,10000
20200312,706671,順達元大94購02,1.42,1.42,1.42,1.42,-0.85,-37.44,12000,2,17040,0,0,0,0,0,0,2000,10000,-8000,-8000
20200312,706672,環球晶元大94購09,0.41,0.44,0.28,0.44,-0.14,-24.14,133000,7,47390,0,0,0,0,0,0,25000,108000,-83000,-83000
20200312,706673,環球晶元大94購10,0.22,0.22,0.22,0.22,-0.33,-60.0,84000,1,18480,0,0,0,0,0,0,84000,0,84000,84000
20200312,706674,穩懋元大94購07,,,,,,0.00,0,0,0,0,0,0,0,0,0,0,0,0,0
20200312,706675,穩懋元大94購08,,,,,,0.00,0,0,0,0,0,0,0,0,0,0,0,0,0
20200312,706676,環球晶統一94購02,0.55,0.55,0.35,0.35,-0.58,-62.37,40000,3,16500,0,0,0,0,0,0,20000,20000,0,0
20200312,706677,凡甲凱基94購01,0.47,0.51,0.46,0.50,-0.12,-19.35,10000,5,4750,0,0,0,0,0,0,10000,0,10000,10000
20200312,706678,大中凱基94購01,,,,,,0.00,0,0,0,0,0,0,0,0,0,0,0,0,0
20200312,706679,大江凱基94購06,,,,,,0.00,0,0,0,0,0,0,0,0,0,0,0,0,0
20200312,706680,旺矽凱基94購01,0.69,0.69,0.69,0.69,-0.59,-46.09,160000,1,110400,0,0,0,0,0,0,160000,0,160000,160000
20200312,706681,順達凱基94購01,0.90,0.90,0.90,0.90,-0.48,-34.78,3000,1,2700,0,0,0,0,0,0,3000,0,3000,3000
20200312,706682,網龍凱基94購01,,,,,,0.00,0,0,0,0,0,0,0,0,0,0,0,0,0
20200312,706683,環球晶凱基94購06,0.21,0.21,0.21,0.21,-0.13,-38.24,10000,1,2100,0,0,0,0,0,0,10000,0,10000,10000
20200312,706684,雙鴻凱基94購02,,,,,,0.00,0,0,0,0,0,0,0,0,0,0,0,0,0
20200312,706685,穩懋凱基94購07,,,,,,0.00,0,0,0,0,0,0,0,0,0,0,0,0,0
20200312,706686,安勤國票94購01,0.03,0.03,0.02,0.02,-0.03,-60.0,998000,3,24950,0,0,0,0,0,0,0,998000,-998000,-998000
20200312,706687,宣德國票94購01,0.93,0.93,0.93,0.93,-0.18,-16.22,2000,1,1860,0,0,0,0,0,0,2000,0,2000,2000
20200312,706688,群聯國票94購02,0.48,0.48,0.14,0.15,-1.65,-91.67,564000,10,131090,0,0,0,0,0,0,205000,359000,-154000,-154000
20200312,706689,雙鴻國票94購01,0.01,0.01,0.01,0.01,-0.03,-75.0,20000,1,200,0,0,0,0,0,0,0,0,0,0
20200312,706690,環球晶富邦98購01,0.54,0.67,0.45,0.67,-0.06,-8.22,309000,13,162100,0,0,0,0,0,0,283000,21000,262000,262000
20200312,706691,大宇資第一94購01,,,,,,0.00,0,0,0,0,0,0,0,0,0,0,0,0,0
20200312,706692,六角永豐94購01,0.16,0.16,0.16,0.16,-0.14,-46.67,3000,1,480,0,0,0,0,0,0,3000,0,3000,3000
20200312,706693,世界永豐94購01,,,,,,0.00,0,0,0,0,0,0,0,0,0,0,0,0,0
20200312,706694,合晶永豐94購01,0.17,0.17,0.17,0.17,-0.14,-45.16,15000,1,2550,0,0,0,0,0,0,0,15000,-15000,-15000
20200312,706695,保瑞永豐94購02,0.44,0.44,0.30,0.36,-0.22,-37.93,347000,20,133970,0,0,0,0,0,0,266000,51000,215000,215000
20200312,706696,聖暉永豐94購01,0.30,0.30,0.30,0.30,-0.09,-23.08,10000,1,3000,0,0,0,0,0,0,10000,0,10000,10000
20200312,706697,凡甲永豐94購02,,,,,,0.00,0,0,0,0,0,0,0,0,0,0,0,0,0
20200312,706698,大學光永豐95購02,1.03,1.03,1.03,1.03,-0.07,-6.36,1000,1,1030,0,0,0,0,0,0,0,1000,-1000,-1000
20200312,706699,台燿永豐94購01,,,,,,0.00,0,0,0,0,0,0,0,0,0,0,0,0,0
20200312,706700,茂達永豐94購01,,,,,,0.00,0,0,0,0,0,0,0,0,0,0,0,0,0
20200312,706701,新鉅科永豐94購01,,,,,,0.00,0,0,0,0,0,0,0,0,0,0,0,0,0
20200312,706702,合晶兆豐94購01,0.19,0.20,0.11,0.13,-0.11,-45.83,195000,6,24950,0,0,0,0,0,0,150000,45000,105000,105000
20200312,706703,信昌電兆豐95購01,,,,,,0.00,0,0,0,0,0,0,0,0,0,0,0,0,0
20200312,706704,保瑞兆豐95購01,0.64,0.66,0.55,0.59,-0.11,-15.71,391000,28,248050,0,0,0,0,0,0,300000,66000,234000,234000
20200312,706705,建榮兆豐95購01,,,,,,0.00,0,0,0,0,0,0,0,0,0,0,0,0,0
20200312,706706,力麒康和94購01,,,,,,0.00,0,0,0,0,0,0,0,0,0,0,0,0,0
20200312,706707,台燿康和94購01,,,,,,0.00,0,0,0,0,0,0,0,0,0,0,0,0,0
20200312,706708,新鉅科康和94購01,,,,,,0.00,0,0,0,0,0,0,0,0,0,0,0,0,0
20200312,706709,茂達群益94購01,,,,,,0.00,0,0,0,0,0,0,0,0,0,0,0,0,0
20200312,706710,環球晶群益94購05,1.04,1.13,0.86,1.13,-0.26,-18.71,20000,4,21040,0,0,0,0,0,0,7000,17000,-10000,-10000
20200312,706711,台燿統一94購01,,,,,,0.00,0,0,0,0,0,0,0,0,0,0,0,0,0
20200312,706712,台燿統一94購02,0.33,0.33,0.33,0.33,-0.32,-49.23,15000,1,4950,0,0,0,0,0,0,15000,0,15000,15000
20200312,706713,安勤統一94購01,,,,,,0.00,0,0,0,0,0,0,0,0,0,0,0,0,0
20200312,706714,新鉅科統一94購01,,,,,,0.00,0,0,0,0,0,0,0,0,0,0,0,0,0
20200312,706715,新鉅科統一94購02,,,,,,0.00,0,0,0,0,0,0,0,0,0,0,0,0,0
20200312,706716,環球晶統一94購03,,,,,,0.00,0,0,0,0,0,0,0,0,0,0,0,0,0
20200312,706717,中美晶凱基94購03,1.02,1.19,1.02,1.19,-0.54,-31.21,30000,3,33900,0,0,0,0,0,0,0,30000,-30000,-30000
20200312,706718,台燿凱基94購04,,,,,,0.00,0,0,0,0,0,0,0,0,0,0,0,0,0
20200312,706719,信驊凱基94購01,3.20,3.20,2.94,3.01,-0.55,-15.45,30000,3,91500,0,0,0,0,0,0,20000,10000,10000,10000
20200312,706720,威剛凱基94購02,1.60,1.60,1.05,1.05,-1.06,-50.24,23000,3,26000,0,0,0,0,0,0,0,23000,-23000,-23000
20200312,706721,泰博凱基94購02,1.27,1.27,0.79,1.04,-0.59,-36.2,259000,5,271880,0,0,0,0,0,0,116000,143000,-27000,-27000
20200312,706722,新鉅科凱基94購01,,,,,,0.00,0,0,0,0,0,0,0,0,0,0,0,0,0
20200312,706723,環球晶凱基94購07,0.05,0.05,0.05,0.05,-0.12,-70.59,95000,1,4750,0,0,0,0,0,0,95000,0,95000,95000
20200312,706724,雙鴻凱基94購03,,,,,,0.00,0,0,0,0,0,0,0,0,0,0,0,0,0
20200312,706725,穩懋凱基94購08,,,,,,0.00,0,0,0,0,0,0,0,0,0,0,0,0,0
20200312,706726,M31元大96購01,,,,,,0.00,0,0,0,0,0,0,0,0,0,0,0,0,0
20200312,706727,凡甲元大94購02,0.23,0.23,0.23,0.23,-0.16,-41.03,30000,1,6900,0,0,0,0,0,0,30000,0,30000,30000
20200312,706728,元太元大94購03,0.55,0.55,0.36,0.36,-0.33,-47.83,12000,5,5500,0,0,0,0,0,0,4000,12000,-8000,-8000
20200312,706729,台燿元大94購06,,,,,,0.00,0,0,0,0,0,0,0,0,0,0,0,0,0
20200312,706730,安勤元大94購02,,,,,,0.00,0,0,0,0,0,0,0,0,0,0,0,0,0
20200312,706731,良維元大97購01,0.17,0.17,0.17,0.17,-0.14,-45.16,54000,2,9180,0,0,0,0,0,0,0,54000,-54000,-54000
20200312,706732,杰力元大94購01,,,,,,0.00,0,0,0,0,0,0,0,0,0,0,0,0,0
20200312,706733,神盾元大96購01,0.17,0.18,0.12,0.18,-0.08,-30.77,478000,18,74450,0,0,0,0,0,0,126000,334000,-208000,-208000
20200312,706734,精華元大94購01,,,,,,0.00,0,0,0,0,0,0,0,0,0,0,0,0,0
20200312,706735,精華元大94購02,,,,,,0.00,0,0,0,0,0,0,0,0,0,0,0,0,0
20200312,706736,環球晶元大94購11,0.12,0.24,0.11,0.21,-0.16,-43.24,113000,4,17710,0,0,0,0,0,0,68000,45000,23000,23000
20200312,706737,環球晶元大94購13,0.35,0.50,0.29,0.47,-0.10,-17.54,165000,4,69900,0,0,0,0,0,0,110000,55000,55000,55000
20200312,706738,緯軟國票94購01,,,,,,0.00,0,0,0,0,0,0,0,0,0,0,0,0,0
20200312,706739,新鉅科國泰95購01,,,,,,0.00,0,0,0,0,0,0,0,0,0,0,0,0,0
20200312,706740,新鉅科國泰95購02,,,,,,0.00,0,0,0,0,0,0,0,0,0,0,0,0,0
20200312,706741,精華國泰95購01,,,,,,0.00,0,0,0,0,0,0,0,0,0,0,0,0,0
20200312,706742,群聯富邦95購01,,,,,,0.00,0,0,0,0,0,0,0,0,0,0,0,0,0
20200312,706743,台燿凱基94購05,,,,,,0.00,0,0,0,0,0,0,0,0,0,0,0,0,0
20200312,706744,良維凱基94購02,,,,,,0.00,0,0,0,0,0,0,0,0,0,0,0,0,0
20200312,706745,茂達凱基94購01,0.50,0.50,0.50,0.50,-0.21,-29.58,10000,1,5000,0,0,0,0,0,0,10000,0,10000,10000
20200312,706746,穩懋凱基94購09,,,,,,0.00,0,0,0,0,0,0,0,0,0,0,0,0,0
20200312,706747,安勤統一95購01,,,,,,0.00,0,0,0,0,0,0,0,0,0,0,0,0,0
20200312,706748,安勤統一95購02,,,,,,0.00,0,0,0,0,0,0,0,0,0,0,0,0,0
20200312,706749,大江第一94購01,,,,,,0.00,0,0,0,0,0,0,0,0,0,0,0,0,0
20200312,706750,神盾第一94購01,0.01,0.01,0.01,0.01,-0.03,-75.0,320000,3,3200,0,0,0,0,0,0,0,0,0,0
20200312,706751,同致國票95購01,0.03,0.03,0.03,0.03,-0.03,-50.0,798000,3,23940,0,0,0,0,0,0,0,798000,-798000,-798000
20200312,706752,波若威國票95購01,0.02,0.02,0.02,0.02,-0.03,-60.0,4000,1,80,0,0,0,0,0,0,4000,0,4000,4000
20200312,706753,台燿台新94購01,0.35,0.35,0.35,0.35,-0.32,-47.76,94000,1,32900,0,0,0,0,0,0,0,94000,-94000,-94000
20200312,706754,碩禾台新96購01,0.38,0.38,0.30,0.30,-0.24,-44.44,99000,3,35580,0,0,0,0,0,0,94000,5000,89000,89000
20200312,706755,台燿元富94購01,0.34,0.34,0.20,0.26,-0.21,-44.68,300000,12,79580,0,0,0,0,0,0,80000,220000,-140000,-140000
20200312,706756,茂達元富94購01,0.46,0.46,0.41,0.41,-0.25,-37.88,23000,4,10280,0,0,0,0,0,0,23000,0,23000,23000
20200312,706757,茂達元富94購02,0.43,0.43,0.41,0.41,-0.26,-38.81,30000,3,12600,0,0,0,0,0,0,30000,0,30000,30000
20200312,706758,六角國泰96購01,0.55,0.55,0.44,0.44,-0.26,-37.14,1049000,10,518860,0,0,0,0,0,0,491000,570000,-79000,-79000
20200312,706759,雙美國泰95購01,,,,,,0.00,0,0,0,0,0,0,0,0,0,0,0,0,0
20200312,706760,鈺太國泰95購01,1.21,1.21,0.94,0.94,-0.56,-37.33,190000,3,189400,0,0,0,0,0,0,40000,150000,-110000,-110000
20200312,706761,鐿鈦國泰96購01,0.56,0.56,0.56,0.56,-0.09,-13.85,3000,1,1680,0,0,0,0,0,0,0,3000,-3000,-3000
20200312,706762,大江兆豐95購02,0.02,0.02,0.01,0.01,-0.02,-66.67,400000,38,7910,0,0,0,0,0,0,0,400000,-400000,-400000
20200312,706763,勝麗兆豐95購01,,,,,,0.00,0,0,0,0,0,0,0,0,0,0,0,0,0
20200312,706764,中美晶元大94購07,0.69,0.69,0.51,0.55,-0.24,-30.38,249000,7,133950,0,0,0,0,0,0,4000,245000,-241000,-241000
20200312,706765,六角元大96購01,0.56,0.57,0.46,0.46,-0.17,-26.98,114000,7,53540,0,0,0,0,0,0,2000,112000,-110000,-110000
20200312,706766,順達元大94購03,,,,,,0.00,0,0,0,0,0,0,0,0,0,0,0,0,0
20200312,706767,群聯元大95購04,1.08,1.08,0.63,0.63,-0.76,-54.68,366000,17,284460,0,0,0,0,0,0,100000,311000,-211000,-211000
20200312,706768,環球晶元大94購14,,,,,,0.00,0,0,0,0,0,0,0,0,0,0,0,0,0
20200312,706769,環球晶元大95購02,0.63,0.63,0.63,0.63,-0.12,-16.0,50000,1,31500,0,0,0,0,0,0,0,50000,-50000,-50000
20200312,706770,博智群益94購01,,,,,,0.00,0,0,0,0,0,0,0,0,0,0,0,0,0
20200312,706771,新鉅科群益94購01,,,,,,0.00,0,0,0,0,0,0,0,0,0,0,0,0,0
20200312,706772,聖暉群益94購01,0.98,1.05,0.98,1.05,-0.35,-25.0,187000,7,190590,0,0,0,0,0,0,164000,43000,121000,121000
20200312,706773,優群群益95購01,3.54,3.54,3.54,3.54,-1.71,-32.57,10000,1,35400,0,0,0,0,0,0,0,10000,-10000,-10000
20200312,706774,雙美群益96購01,,,,,,0.00,0,0,0,0,0,0,0,0,0,0,0,0,0
20200312,706775,元太凱基94購01,,,,,,0.00,0,0,0,0,0,0,0,0,0,0,0,0,0
20200312,706776,合晶凱基94購02,,,,,,0.00,0,0,0,0,0,0,0,0,0,0,0,0,0
20200312,706777,安勤凱基94購01,,,,,,0.00,0,0,0,0,0,0,0,0,0,0,0,0,0
20200312,706778,安勤凱基94購02,,,,,,0.00,0,0,0,0,0,0,0,0,0,0,0,0,0
20200312,706779,直得凱基94購01,0.45,0.45,0.37,0.37,-0.27,-42.19,1016000,4,451960,0,0,0,0,0,0,1016000,0,1016000,1016000
20200312,706780,勝麗凱基94購02,,,,,,0.00,0,0,0,0,0,0,0,0,0,0,0,0,0
20200312,706781,順達凱基94購02,0.39,0.39,0.39,0.39,-0.31,-44.29,50000,1,19500,0,0,0,0,0,0,0,50000,-50000,-50000
20200312,706782,環球晶凱基94購08,,,,,,0.00,0,0,0,0,0,0,0,0,0,0,0,0,0
20200312,706783,大江元富94購01,,,,,,0.00,0,0,0,0,0,0,0,0,0,0,0,0,0
20200312,706784,大學光群益94購01,0.36,0.36,0.34,0.34,-0.16,-32.0,50000,2,17500,0,0,0,0,0,0,50000,0,50000,50000
20200312,706785,三貝德永豐94購02,,,,,,0.00,0,0,0,0,0,0,0,0,0,0,0,0,0
20200312,706786,勝麗永豐94購02,0.33,0.33,0.32,0.32,-0.18,-36.0,66000,2,21270,0,0,0,0,0,0,51000,15000,36000,36000
20200312,706787,博智國票95購02,6.10,6.10,6.05,6.05,-2.10,-25.77,2000,2,12150,0,0,0,0,0,0,0,2000,-2000,-2000
20200312,706788,大學光國泰96購01,1.35,1.35,1.18,1.18,-0.63,-34.81,20000,3,25300,0,0,0,0,0,0,0,20000,-20000,-20000
20200312,706789,VHQ元大94購01,,,,,,0.00,0,0,0,0,0,0,0,0,0,0,0,0,0
20200312,706790,中美晶元大94購08,0.58,0.58,0.58,0.58,-0.27,-31.76,1000,1,580,0,0,0,0,0,0,1000,1000,0,0
20200312,706791,同致元大94購02,0.52,0.53,0.52,0.53,-0.18,-25.35,17000,2,8910,0,0,0,0,0,0,0,17000,-17000,-17000
20200312,706792,威剛元大96購01,2.28,2.28,2.28,2.28,-0.87,-27.62,37000,2,84360,0,0,0,0,0,0,7000,30000,-23000,-23000
20200312,706793,勝麗元大94購02,1.46,1.46,1.31,1.31,-0.85,-39.35,52000,2,75620,0,0,0,0,0,0,0,52000,-52000,-52000
20200312,706794,環球晶元大94購15,0.30,0.31,0.24,0.30,-0.07,-18.92,345000,6,97300,0,0,0,0,0,0,115000,230000,-115000,-115000
20200312,706795,穩懋元大94購09,0.07,0.07,0.07,0.07,-0.30,-81.08,10000,1,700,0,0,0,0,0,0,10000,0,10000,10000
20200312,706796,鈺太元大96購02,0.80,0.80,0.71,0.71,-0.33,-31.73,149000,4,110890,0,0,0,0,0,0,90000,59000,31000,31000
20200312,706797,昂寶元大94購01,1.01,1.01,1.01,1.01,-0.05,-4.72,3000,1,3030,0,0,0,0,0,0,3000,0,3000,3000
20200312,706798,杰力元大94購02,0.06,0.06,0.06,0.06,-0.03,-33.33,15000,1,900,0,0,0,0,0,0,15000,0,15000,15000
20200312,706799,茂達元大94購02,0.62,0.62,0.41,0.47,-0.38,-44.71,216000,11,110210,0,0,0,0,0,0,132000,81000,51000,51000
20200312,706800,原相元大96購01,,,,,,0.00,0,0,0,0,0,0,0,0,0,0,0,0,0
20200312,706801,環球晶元大94購16,0.36,0.36,0.24,0.33,-0.25,-43.1,16000,3,4860,0,0,0,0,0,0,16000,1000,15000,15000
20200312,706802,環球晶統一94購04,0.67,0.67,0.64,0.64,-0.36,-36.0,60000,3,39400,0,0,0,0,0,0,40000,20000,20000,20000
20200312,706803,環球晶中信97購01,0.25,0.27,0.14,0.25,-0.02,-7.41,1026000,46,207400,0,0,0,0,0,0,447000,549000,-102000,-102000
20200312,706804,由田國泰96購01,0.27,0.27,0.27,0.27,-0.02,-6.9,10000,1,2700,0,0,0,0,0,0,0,10000,-10000,-10000
20200312,706805,宣德凱基94購02,0.80,0.80,0.66,0.66,-0.36,-35.29,250000,6,184000,0,0,0,0,0,0,150000,71000,79000,79000
20200312,706806,雙美凱基94購01,,,,,,0.00,0,0,0,0,0,0,0,0,0,0,0,0,0
20200312,706807,精華麥證94購01,,,,,,0.00,0,0,0,0,0,0,0,0,0,0,0,0,0
20200312,706808,泰博元富94購01,1.26,1.26,1.26,1.26,-0.51,-28.81,20000,1,25200,0,0,0,0,0,0,20000,0,20000,20000
20200312,706809,神盾元富95購01,,,,,,0.00,0,0,0,0,0,0,0,0,0,0,0,0,0
20200312,706810,緯軟元富94購01,,,,,,0.00,0,0,0,0,0,0,0,0,0,0,0,0,0
20200312,706811,環球晶元富95購03,0.73,0.73,0.68,0.73,-0.22,-23.16,50000,3,36000,0,0,0,0,0,0,30000,20000,10000,10000
20200312,706812,凡甲台新94購01,,,,,,0.00,0,0,0,0,0,0,0,0,0,0,0,0,0
20200312,706813,台燿第一94購01,,,,,,0.00,0,0,0,0,0,0,0,0,0,0,0,0,0
20200312,706814,由田永豐94購02,,,,,,0.00,0,0,0,0,0,0,0,0,0,0,0,0,0
20200312,706815,金居永豐94購01,,,,,,0.00,0,0,0,0,0,0,0,0,0,0,0,0,0
20200312,706816,原相永豐94購03,0.86,0.87,0.59,0.59,-0.44,-42.72,326000,31,238080,0,0,0,0,0,0,109000,204000,-95000,-95000
20200312,706817,廣明永豐94購01,,,,,,0.00,0,0,0,0,0,0,0,0,0,0,0,0,0
20200312,706818,廣積永豐94購01,,,,,,0.00,0,0,0,0,0,0,0,0,0,0,0,0,0
20200312,706819,優群永豐94購03,1.31,1.32,1.31,1.32,-1.14,-46.34,36000,2,47210,0,0,0,0,0,0,31000,5000,26000,26000
20200312,706820,櫃200永豐94購01,,,,,,0.00,0,0,0,0,0,0,0,0,0,0,0,0,0
20200312,706821,雙鴻永豐95購04,,,,,,0.00,0,0,0,0,0,0,0,0,0,0,0,0,0
20200312,706822,立端群益95購01,,,,,,0.00,0,0,0,0,0,0,0,0,0,0,0,0,0
20200312,706823,勝麗群益94購01,0.95,0.97,0.84,0.84,-0.69,-45.1,55000,5,51250,0,0,0,0,0,0,35000,20000,15000,15000
20200312,706824,群聯群益94購03,0.15,0.15,0.09,0.09,-0.38,-80.85,60000,3,7600,0,0,0,0,0,0,0,60000,-60000,-60000
20200312,706825,穩懋統一96購02,0.17,0.17,0.13,0.13,-0.17,-56.67,90000,4,13400,0,0,0,0,0,0,30000,60000,-30000,-30000
20200312,706826,凡甲中信94購01,0.05,0.05,0.05,0.05,-0.06,-54.55,1000,1,50,0,0,0,0,0,0,0,1000,-1000,-1000
20200312,706827,凡甲元大94購03,,,,,,0.00,0,0,0,0,0,0,0,0,0,0,0,0,0
20200312,706828,世界元大94購02,,,,,,0.00,0,0,0,0,0,0,0,0,0,0,0,0,0
20200312,706829,台半元大94購01,,,,,,0.00,0,0,0,0,0,0,0,0,0,0,0,0,0
20200312,706830,迅得元大95購01,,,,,,0.00,0,0,0,0,0,0,0,0,0,0,0,0,0
20200312,706831,聖暉元大94購01,1.55,1.55,1.50,1.50,-0.53,-26.11,10000,2,15400,0,0,0,0,0,0,8000,2000,6000,6000
20200312,706832,環球晶元大94購18,0.99,0.99,0.59,0.59,-0.71,-54.62,109000,5,73220,0,0,0,0,0,0,24000,106000,-82000,-82000
20200312,706833,鈺太元大96購03,0.49,0.49,0.43,0.43,-0.22,-33.85,208000,4,100660,0,0,0,0,0,0,188000,20000,168000,168000
20200312,706834,昇達科永豐94購02,,,,,,0.00,0,0,0,0,0,0,0,0,0,0,0,0,0
20200312,706835,東隆興永豐94購01,,,,,,0.00,0,0,0,0,0,0,0,0,0,0,0,0,0
20200312,706836,振曜永豐94購01,,,,,,0.00,0,0,0,0,0,0,0,0,0,0,0,0,0
20200312,706837,網家永豐94購02,,,,,,0.00,0,0,0,0,0,0,0,0,0,0,0,0,0
20200312,706838,聚積永豐94購01,,,,,,0.00,0,0,0,0,0,0,0,0,0,0,0,0,0
20200312,706839,鈺太永豐94購04,0.15,0.15,0.13,0.13,-0.14,-51.85,233000,2,30350,0,0,0,0,0,0,233000,0,233000,233000
20200312,706840,良維國票95購01,,,,,,0.00,0,0,0,0,0,0,0,0,0,0,0,0,0
20200312,706841,保瑞國票95購01,1.26,1.32,1.08,1.21,-0.20,-14.18,660000,25,822330,0,0,0,0,0,0,530000,130000,400000,400000
20200312,706842,群聯國票94購03,1.89,1.89,1.05,1.05,-2.18,-67.49,70000,3,118400,0,0,0,0,0,0,50000,20000,30000,30000
20200312,706843,碩禾國票95購01,0.52,0.54,0.46,0.46,-0.37,-44.58,267000,6,137580,0,0,0,0,0,0,247000,20000,227000,227000
20200312,706844,新鉅科富邦98購01,0.05,0.05,0.04,0.04,-0.04,-50.0,170000,3,7700,0,0,0,0,0,0,80000,0,80000,80000
20200312,706845,中美晶凱基94購06,0.37,0.37,0.28,0.28,-0.27,-49.09,113000,5,37820,0,0,0,0,0,0,113000,0,113000,113000
20200312,706846,金可凱基94購02,,,,,,0.00,0,0,0,0,0,0,0,0,0,0,0,0,0
20200312,706847,神盾凱基94購01,,,,,,0.00,0,0,0,0,0,0,0,0,0,0,0,0,0
20200312,706848,碩禾凱基94購01,,,,,,0.00,0,0,0,0,0,0,0,0,0,0,0,0,0
20200312,706849,精華凱基94購03,0.04,0.04,0.04,0.04,-0.07,-63.64,12000,1,480,0,0,0,0,0,0,12000,0,12000,12000
20200312,706850,廣明凱基94購06,,,,,,0.00,0,0,0,0,0,0,0,0,0,0,0,0,0
20200312,706851,穩懋凱基94購10,0.22,0.22,0.22,0.22,-0.29,-56.86,10000,1,2200,0,0,0,0,0,0,10000,0,10000,10000
20200312,706852,穩懋麥證94購01,0.24,0.24,0.24,0.24,-0.19,-44.19,10000,1,2400,10000,0,10000,0,0,0,10000,0,10000,10000
20200312,706853,神盾元富95購02,,,,,,0.00,0,0,0,0,0,0,0,0,0,0,0,0,0
20200312,706854,聯亞台新94購01,0.22,0.22,0.21,0.21,-0.23,-52.27,10000,2,2150,0,0,0,0,0,0,0,10000,-10000,-10000
20200312,706855,原相兆豐95購02,1.93,1.93,1.61,1.61,-1.04,-39.25,60000,6,106600,0,0,0,0,0,0,10000,60000,-50000,-50000
20200312,706856,環球晶兆豐95購04,0.28,0.30,0.17,0.27,-0.06,-18.18,735000,16,164600,0,0,0,0,0,0,504000,211000,293000,293000
20200312,706857,凡甲康和94購01,0.28,0.28,0.26,0.26,-0.17,-39.53,1400000,7,380000,0,0,0,0,0,0,0,1400000,-1400000,-1400000
20200312,706858,由田群益96購01,0.32,0.32,0.32,0.32,-0.09,-21.95,10000,1,3200,0,0,0,0,0,0,0,10000,-10000,-10000
20200312,706859,環球晶群益94購07,0.65,0.65,0.48,0.48,-0.33,-40.74,99000,3,54710,0,0,0,0,0,0,99000,2000,97000,97000
20200312,706860,原相中信94購01,2.15,2.15,1.60,1.60,-0.69,-30.13,40000,4,77000,0,0,0,0,0,0,20000,20000,0,0
20200312,706861,金居凱基94購01,,,,,,0.00,0,0,0,0,0,0,0,0,0,0,0,0,0
20200312,706862,泰博凱基94購03,1.47,1.47,0.90,0.90,-0.79,-46.75,55000,3,69450,0,0,0,0,0,0,0,55000,-55000,-55000
20200312,706863,環宇凱基94購01,,,,,,0.00,0,0,0,0,0,0,0,0,0,0,0,0,0
20200312,706864,環球晶凱基94購09,0.72,0.73,0.59,0.59,-0.24,-28.92,92000,14,62720,0,0,0,0,0,0,0,92000,-92000,-92000
20200312,706865,環球晶統一94購05,0.53,0.53,0.53,0.53,-0.75,-58.59,10000,1,5300,0,0,0,0,0,0,10000,0,10000,10000
20200312,706866,凡甲國票95購01,0.31,0.31,0.26,0.26,-0.17,-39.53,15000,2,4150,0,0,0,0,0,0,0,15000,-15000,-15000
20200312,706867,中美晶國票95購01,,,,,,0.00,0,0,0,0,0,0,0,0,0,0,0,0,0
20200312,706868,神盾國票96購01,,,,,,0.00,0,0,0,0,0,0,0,0,0,0,0,0,0
20200312,706869,環球晶國票95購02,0.50,0.50,0.39,0.50,-0.19,-27.54,557000,4,264200,0,0,0,0,0,0,228000,299000,-71000,-71000
20200312,706870,原相群益97購02,,,,,,0.00,0,0,0,0,0,0,0,0,0,0,0,0,0
20200312,706871,台半永豐94購01,,,,,,0.00,0,0,0,0,0,0,0,0,0,0,0,0,0
20200312,706872,波若威永豐95購01,,,,,,0.00,0,0,0,0,0,0,0,0,0,0,0,0,0
20200312,706873,宣德永豐94購03,1.26,1.26,1.26,1.26,-0.26,-17.11,58000,2,73080,0,0,0,0,0,0,58000,0,58000,58000
20200312,706874,閎康永豐94購02,,,,,,0.00,0,0,0,0,0,0,0,0,0,0,0,0,0
20200312,706875,環球晶永豐94購04,,,,,,0.00,0,0,0,0,0,0,0,0,0,0,0,0,0
20200312,706876,大宇資元大96購01,,,,,,0.00,0,0,0,0,0,0,0,0,0,0,0,0,0
20200312,706877,合晶元大95購01,0.43,0.43,0.25,0.32,-0.17,-34.69,189000,5,64130,0,0,0,0,0,0,159000,30000,129000,129000
20200312,706878,邦特元大94購01,0.28,0.28,0.23,0.23,-0.12,-34.29,68000,6,17030,0,0,0,0,0,0,0,68000,-68000,-68000
20200312,706879,信昌電元大95購02,0.42,0.42,0.42,0.42,-0.27,-39.13,5000,1,2100,0,0,0,0,0,0,0,5000,-5000,-5000
20200312,706880,茂達元大94購03,0.68,0.68,0.48,0.48,-0.31,-39.24,244000,11,138180,0,0,0,0,0,0,174000,50000,124000,124000
20200312,706881,網家元大94購02,,,,,,0.00,0,0,0,0,0,0,0,0,0,0,0,0,0
20200312,706882,緯軟元大96購03,,,,,,0.00,0,0,0,0,0,0,0,0,0,0,0,0,0
20200312,706883,環球晶元大94購19,0.77,0.77,0.77,0.77,-0.48,-38.4,20000,1,15400,0,0,0,0,0,0,20000,20000,0,0
20200312,706884,環球晶元大95購03,1.72,1.75,1.20,1.75,-0.36,-17.06,36000,6,57190,0,0,0,0,0,0,22000,36000,-14000,-14000
20200312,706885,環球晶台新94購02,,,,,,0.00,0,0,0,0,0,0,0,0,0,0,0,0,0
20200312,706886,台燿元富94購03,,,,,,0.00,0,0,0,0,0,0,0,0,0,0,0,0,0
20200312,706887,台燿元富94購04,0.37,0.40,0.37,0.40,-0.23,-36.51,50000,2,19700,0,0,0,0,0,0,40000,10000,30000,30000
20200312,706888,聚積元富94購02,,,,,,0.00,0,0,0,0,0,0,0,0,0,0,0,0,0
20200312,706889,雙鴻元富96購01,0.09,0.09,0.09,0.09,-0.08,-47.06,150000,5,13500,0,0,0,0,0,0,0,150000,-150000,-150000
20200312,706890,信驊凱基95購01,2.79,2.91,2.55,2.55,-0.82,-24.33,127000,9,349450,0,0,0,0,0,0,90000,37000,53000,53000
20200312,706891,新普凱基94購03,,,,,,0.00,0,0,0,0,0,0,0,0,0,0,0,0,0
20200312,706892,網家凱基95購01,,,,,,0.00,0,0,0,0,0,0,0,0,0,0,0,0,0
20200312,706893,環球晶凱基94購10,0.87,0.89,0.64,0.89,-0.21,-19.09,31000,4,23920,0,0,0,0,0,0,21000,31000,-10000,-10000
20200312,706894,M31元大95購01,,,,,,0.00,0,0,0,0,0,0,0,0,0,0,0,0,0
20200312,706895,凡甲元大94購04,0.50,0.50,0.47,0.47,-0.23,-32.86,30000,2,14700,0,0,0,0,0,0,20000,10000,10000,10000
20200312,706896,佳邦元大94購01,0.05,0.05,0.04,0.05,-0.04,-44.44,120000,12,5900,0,0,0,0,0,0,0,120000,-120000,-120000
20200312,706897,保瑞元大94購03,1.31,1.31,1.14,1.14,-0.31,-21.38,239000,11,285890,0,0,0,0,0,0,166000,73000,93000,93000
20200312,706898,勝麗元大95購02,1.21,1.21,1.07,1.07,-1.16,-52.02,30000,3,32560,0,0,0,0,0,0,25000,5000,20000,20000
20200312,706899,閎康元大95購01,0.24,0.24,0.24,0.24,-0.14,-36.84,27000,1,6480,0,0,0,0,0,0,27000,0,27000,27000
20200312,706900,環球晶元大94購20,,,,,,0.00,0,0,0,0,0,0,0,0,0,0,0,0,0
20200312,706901,穩懋元大94購10,,,,,,0.00,0,0,0,0,0,0,0,0,0,0,0,0,0
20200312,706902,迅得永豐95購02,,,,,,0.00,0,0,0,0,0,0,0,0,0,0,0,0,0
20200312,706903,長科*永豐94購02,,,,,,0.00,0,0,0,0,0,0,0,0,0,0,0,0,0
20200312,706904,群聯永豐94購01,0.91,0.92,0.51,0.51,-0.64,-55.65,254000,10,178680,0,0,0,0,0,0,8000,254000,-246000,-246000
20200312,706905,應華永豐94購01,,,,,,0.00,0,0,0,0,0,0,0,0,0,0,0,0,0
20200312,706906,大學光國票96購01,0.95,0.95,0.67,0.68,-0.52,-43.33,517000,10,421180,0,0,0,0,0,0,414000,103000,311000,311000
20200312,706907,合晶國票95購01,,,,,,0.00,0,0,0,0,0,0,0,0,0,0,0,0,0
20200312,706908,皇田國票95購01,,,,,,0.00,0,0,0,0,0,0,0,0,0,0,0,0,0
20200312,706909,茂達國票94購01,,,,,,0.00,0,0,0,0,0,0,0,0,0,0,0,0,0
20200312,706910,閎康國票95購01,0.53,0.53,0.41,0.43,-0.25,-36.76,551000,14,279410,0,450000,-450000,0,0,0,450000,101000,349000,-101000
20200312,706911,網龍國票94購02,,,,,,0.00,0,0,0,0,0,0,0,0,0,0,0,0,0
20200312,706912,鐿鈦國票96購01,0.64,0.64,0.47,0.47,-0.26,-35.62,173000,5,99670,0,0,0,0,0,0,73000,100000,-27000,-27000
20200312,706913,邦特元富94購01,0.09,0.09,0.09,0.09,-0.08,-47.06,197000,1,17730,0,0,0,0,0,0,197000,0,197000,197000
20200312,706914,智擎元富94購01,,,,,,0.00,0,0,0,0,0,0,0,0,0,0,0,0,0
20200312,706915,台半康和94購01,,,,,,0.00,0,0,0,0,0,0,0,0,0,0,0,0,0
20200312,706916,M31元大96購02,,,,,,0.00,0,0,0,0,0,0,0,0,0,0,0,0,0
20200312,706917,力旺元大94購01,,,,,,0.00,0,0,0,0,0,0,0,0,0,0,0,0,0
20200312,706918,大學光元大96購01,0.94,0.94,0.67,0.67,-0.35,-34.31,86000,10,66180,0,0,0,0,0,0,79000,8000,71000,71000
20200312,706919,良維元大96購01,,,,,,0.00,0,0,0,0,0,0,0,0,0,0,0,0,0
20200312,706920,宣德元大96購01,0.95,0.95,0.65,0.70,-0.46,-39.66,195000,8,139610,0,0,0,0,0,0,141000,163000,-22000,-22000
20200312,706921,新鉅科元大94購01,,,,,,0.00,0,0,0,0,0,0,0,0,0,0,0,0,0
20200312,706922,新鉅科元大94購02,,,,,,0.00,0,0,0,0,0,0,0,0,0,0,0,0,0
20200312,706923,聚積元大96購01,,,,,,0.00,0,0,0,0,0,0,0,0,0,0,0,0,0
20200312,706924,穩懋元大94購12,,,,,,0.00,0,0,0,0,0,0,0,0,0,0,0,0,0
20200312,706925,穩懋元大94購13,,,,,,0.00,0,0,0,0,0,0,0,0,0,0,0,0,0
20200312,706926,晟德元大94購02,,,,,,0.00,0,0,0,0,0,0,0,0,0,0,0,0,0
20200312,706927,上詮永豐94購03,,,,,,0.00,0,0,0,0,0,0,0,0,0,0,0,0,0
20200312,706928,大學光永豐96購01,0.56,0.56,0.56,0.56,-0.26,-31.71,4000,1,2240,0,0,0,0,0,0,0,4000,-4000,-4000
20200312,706929,昇達科永豐94購03,,,,,,0.00,0,0,0,0,0,0,0,0,0,0,0,0,0
20200312,706930,穩懋永豐94購03,,,,,,0.00,0,0,0,0,0,0,0,0,0,0,0,0,0
20200312,706931,穩懋統一94購06,,,,,,0.00,0,0,0,0,0,0,0,0,0,0,0,0,0
20200312,706932,穩懋統一94購07,,,,,,0.00,0,0,0,0,0,0,0,0,0,0,0,0,0
20200312,706933,神盾中信97購01,0.03,0.03,0.02,0.02,-0.02,-50.0,23000,4,560,0,0,0,0,0,0,0,23000,-23000,-23000
20200312,706934,環宇中信97購01,,,,,,0.00,0,0,0,0,0,0,0,0,0,0,0,0,0
20200312,706935,VHQ凱基96購01,0.03,0.03,0.03,0.03,-0.04,-57.14,30000,1,900,0,0,0,0,0,0,30000,0,30000,30000
20200312,706936,台燿凱基96購01,,,,,,0.00,0,0,0,0,0,0,0,0,0,0,0,0,0
20200312,706937,宜鼎凱基96購01,,,,,,0.00,0,0,0,0,0,0,0,0,0,0,0,0,0
20200312,706938,原相凱基94購01,2.48,2.55,2.48,2.55,-1.63,-39.0,30000,3,75400,0,0,0,0,0,0,0,30000,-30000,-30000
20200312,706939,環球晶凱基94購11,1.03,1.03,0.59,0.70,-0.64,-47.76,237000,11,199840,0,0,0,0,0,0,192000,77000,115000,115000
20200312,706940,穩懋凱基96購01,,,,,,0.00,0,0,0,0,0,0,0,0,0,0,0,0,0
20200312,706941,譜瑞凱基96購01,2.56,2.56,1.50,1.50,-1.22,-44.85,174000,7,389640,0,0,0,0,0,0,15000,174000,-159000,-159000
20200312,706942,大中國票96購01,,,,,,0.00,0,0,0,0,0,0,0,0,0,0,0,0,0
20200312,706943,中美晶國票94購03,1.27,1.27,0.75,1.17,-0.74,-38.74,50000,5,51600,0,0,0,0,0,0,10000,40000,-30000,-30000
20200312,706944,美琪瑪國票94購02,,,,,,0.00,0,0,0,0,0,0,0,0,0,0,0,0,0
20200312,706945,碩禾國票96購01,0.73,0.73,0.46,0.46,-0.56,-54.9,180000,9,116150,0,0,0,0,0,0,107000,73000,34000,34000
20200312,706946,環球晶國票96購01,,,,,,0.00,0,0,0,0,0,0,0,0,0,0,0,0,0
20200312,706947,大田國泰96購01,,,,,,0.00,0,0,0,0,0,0,0,0,0,0,0,0,0
20200312,706948,穩懋國泰94購03,,,,,,0.00,0,0,0,0,0,0,0,0,0,0,0,0,0
20200312,706949,穩懋國泰94購04,,,,,,0.00,0,0,0,0,0,0,0,0,0,0,0,0,0
20200312,706950,雙鴻富邦96購01,,,,,,0.00,0,0,0,0,0,0,0,0,0,0,0,0,0
20200312,706951,新鉅科元富94購01,,,,,,0.00,0,0,0,0,0,0,0,0,0,0,0,0,0
20200312,706952,新鉅科元富96購01,,,,,,0.00,0,0,0,0,0,0,0,0,0,0,0,0,0
20200312,706953,精華元富94購01,0.04,0.04,0.04,0.04,-0.09,-69.23,25000,1,1000,0,0,0,0,0,0,25000,0,25000,25000
20200312,706954,環球晶元富94購07,0.73,0.73,0.54,0.54,-0.31,-36.47,40000,4,25400,0,0,0,0,0,0,0,40000,-40000,-40000
20200312,706955,穩懋台新94購01,,,,,,0.00,0,0,0,0,0,0,0,0,0,0,0,0,0
20200312,706956,原相群益96購03,1.67,1.71,1.54,1.54,-0.42,-21.43,52000,6,86060,0,0,0,0,0,0,2000,52000,-50000,-50000
20200312,706957,群聯群益94購04,0.20,0.20,0.07,0.07,-0.36,-83.72,250000,9,33200,0,0,0,0,0,0,0,250000,-250000,-250000
20200312,706958,環球晶群益94購08,0.44,0.44,0.44,0.44,-0.28,-38.89,38000,1,16720,0,0,0,0,0,0,38000,0,38000,38000
20200312,706959,廣明元大94購02,,,,,,0.00,0,0,0,0,0,0,0,0,0,0,0,0,0
20200312,706960,雙鴻元大96購01,,,,,,0.00,0,0,0,0,0,0,0,0,0,0,0,0,0
20200312,706961,金可中信96購01,0.08,0.08,0.07,0.07,-0.08,-53.33,540000,54,39900,0,0,0,0,0,0,0,540000,-540000,-540000
20200312,706962,勝麗中信97購01,0.46,0.47,0.36,0.36,-0.26,-41.94,70000,6,31000,0,0,0,0,0,0,20000,50000,-30000,-30000
20200312,706963,群聯中信97購01,0.57,0.58,0.34,0.34,-0.33,-49.25,322000,37,127140,0,0,0,0,0,0,20000,297000,-277000,-277000
20200312,706964,碩禾中信94購01,0.12,0.12,0.07,0.07,-0.15,-68.18,45000,7,4810,0,0,0,0,0,0,0,45000,-45000,-45000
20200312,706965,群聯統一96購01,1.66,1.66,0.95,0.95,-0.92,-49.2,168000,6,228100,0,0,0,0,0,0,48000,121000,-73000,-73000
20200312,706966,三貝德凱基96購01,,,,,,0.00,0,0,0,0,0,0,0,0,0,0,0,0,0
20200312,706967,由田凱基94購03,,,,,,0.00,0,0,0,0,0,0,0,0,0,0,0,0,0
20200312,706968,昇達科凱基94購02,,,,,,0.00,0,0,0,0,0,0,0,0,0,0,0,0,0
20200312,706969,信驊凱基96購01,1.42,1.44,1.30,1.30,-0.43,-24.86,83000,10,115130,0,0,0,0,0,0,16000,64000,-48000,-48000
20200312,706970,茂達凱基96購01,0.27,0.28,0.19,0.21,-0.13,-38.24,55000,11,13050,0,0,0,0,0,0,25000,30000,-5000,-5000
20200312,706971,振曜凱基94購01,,,,,,0.00,0,0,0,0,0,0,0,0,0,0,0,0,0
20200312,706972,環球晶凱基94購12,0.60,0.62,0.32,0.43,-0.40,-48.19,151000,8,58000,0,0,0,0,0,0,11000,141000,-130000,-130000
20200312,706973,穩懋凱基96購02,0.03,0.03,0.03,0.03,-0.07,-70.0,270000,3,8100,0,0,0,0,0,0,270000,0,270000,270000
20200312,706974,穩懋富邦96購03,0.05,0.07,0.03,0.05,-0.03,-37.5,1054000,25,44190,0,0,0,0,0,0,0,0,0,0
20200312,706975,穩懋富邦96購04,0.07,0.10,0.07,0.10,-0.10,-50.0,311000,4,28970,0,0,0,0,0,0,71000,235000,-164000,-164000
20200312,706976,大江國泰96購01,0.02,0.06,0.02,0.06,0.00,0.0,60000,2,1600,0,0,0,0,0,0,50000,10000,40000,40000
20200312,706977,神盾國泰96購01,,,,,,0.00,0,0,0,0,0,0,0,0,0,0,0,0,0
20200312,706978,中美晶元富94購03,0.65,0.77,0.65,0.77,-0.47,-37.9,50000,5,35700,0,0,0,0,0,0,0,50000,-50000,-50000
20200312,706979,神盾元富94購02,,,,,,0.00,0,0,0,0,0,0,0,0,0,0,0,0,0
20200312,706980,環球晶元富94購08,0.51,0.51,0.51,0.51,-0.19,-27.14,20000,1,10200,0,0,0,0,0,0,20000,0,20000,20000
20200312,706981,中美晶台新94購02,0.54,0.54,0.54,0.54,-0.35,-39.33,2000,1,1080,0,0,0,0,0,0,0,2000,-2000,-2000
20200312,706982,穩懋台新94購02,,,,,,0.00,0,0,0,0,0,0,0,0,0,0,0,0,0
20200312,706983,元太國票94購01,,,,,,0.00,0,0,0,0,0,0,0,0,0,0,0,0,0
20200312,706984,合晶國票96購01,,,,,,0.00,0,0,0,0,0,0,0,0,0,0,0,0,0
20200312,706985,建榮國票96購02,,,,,,0.00,0,0,0,0,0,0,0,0,0,0,0,0,0
20200312,706986,網家國票96購01,0.04,0.04,0.03,0.03,-0.03,-50.0,243000,4,8220,0,0,0,0,0,0,93000,150000,-57000,-57000
20200312,706987,聯亞國票94購03,0.45,0.45,0.45,0.45,-0.39,-46.43,10000,1,4500,0,0,0,0,0,0,10000,0,10000,10000
20200312,706988,信昌電永豐94購04,0.54,0.54,0.54,0.54,-0.20,-27.03,44000,1,23760,0,0,0,0,0,0,44000,0,44000,44000
20200312,706989,博智永豐94購02,2.15,2.15,1.67,1.70,-0.78,-31.45,140000,12,250000,0,0,0,0,0,0,30000,110000,-80000,-80000
20200312,706990,中美晶中信97購01,1.28,1.28,0.97,0.97,-0.55,-36.18,32000,3,38090,0,0,0,0,0,0,32000,2000,30000,30000
20200312,706991,弘塑中信97購01,0.66,0.66,0.51,0.51,-0.40,-43.96,60000,4,36700,0,0,0,0,0,0,40000,20000,20000,20000
20200312,706992,神盾中信96購01,0.01,0.01,0.01,0.01,-0.01,-50.0,10000,1,100,0,0,0,0,0,0,10000,0,10000,10000
20200312,706993,環球晶中信96購01,0.25,0.27,0.15,0.27,-0.05,-15.62,363000,12,72750,0,0,0,0,0,0,148000,215000,-67000,-67000
20200312,706994,譜瑞中信95購01,0.97,0.97,0.57,0.57,-0.58,-50.43,73000,5,58090,0,0,0,0,0,0,38000,35000,3000,3000
20200312,706995,弘塑統一96購01,0.93,0.93,0.93,0.93,-0.68,-42.24,18000,1,16740,0,0,0,0,0,0,18000,0,18000,18000
20200312,706996,群聯統一96購02,1.28,1.28,1.28,1.28,-1.10,-46.22,20000,1,25600,0,0,0,0,0,0,0,20000,-20000,-20000
20200312,706997,環球晶統一95購01,0.60,0.60,0.47,0.53,-0.32,-37.65,30000,3,16000,0,0,0,0,0,0,10000,20000,-10000,-10000
20200312,706998,M31凱基95購01,,,,,,0.00,0,0,0,0,0,0,0,0,0,0,0,0,0
20200312,706999,中美晶凱基95購01,,,,,,0.00,0,0,0,0,0,0,0,0,0,0,0,0,0
20200312,707000,台燿凱基96購02,0.53,0.55,0.48,0.48,-0.21,-30.43,178000,4,91200,0,0,0,0,0,0,68000,110000,-42000,-42000
20200312,707001,旺矽凱基95購01,0.74,0.74,0.39,0.39,-0.78,-66.67,11000,2,7790,0,0,0,0,0,0,10000,1000,9000,9000
20200312,707002,昂寶凱基95購01,,,,,,0.00,0,0,0,0,0,0,0,0,0,0,0,0,0
20200312,707003,神盾凱基96購01,,,,,,0.00,0,0,0,0,0,0,0,0,0,0,0,0,0
20200312,707004,廣明凱基95購01,,,,,,0.00,0,0,0,0,0,0,0,0,0,0,0,0,0
20200312,707005,環宇凱基95購01,,,,,,0.00,0,0,0,0,0,0,0,0,0,0,0,0,0
20200312,707006,環球晶凱基95購01,0.46,0.46,0.34,0.34,-0.38,-52.78,40000,3,16200,0,0,0,0,0,0,20000,20000,0,0
20200312,707007,穩懋凱基95購01,,,,,,0.00,0,0,0,0,0,0,0,0,0,0,0,0,0
20200312,707008,神盾元富95購03,,,,,,0.00,0,0,0,0,0,0,0,0,0,0,0,0,0
20200312,707009,群聯元富95購01,,,,,,0.00,0,0,0,0,0,0,0,0,0,0,0,0,0
20200312,707010,聯亞元富95購01,0.78,0.78,0.78,0.78,-0.69,-46.94,10000,1,7800,0,0,0,0,0,0,0,10000,-10000,-10000
20200312,707011,穩懋元富95購02,0.07,0.07,0.07,0.07,-0.14,-66.67,50000,1,3500,0,0,0,0,0,0,50000,0,50000,50000
20200312,707012,穩懋元富95購03,,,,,,0.00,0,0,0,0,0,0,0,0,0,0,0,0,0
20200312,707013,良維兆豐96購01,0.07,0.07,0.06,0.06,-0.05,-45.45,52000,6,3620,0,0,0,0,0,0,2000,50000,-48000,-48000
20200312,707014,長科*康和95購01,,,,,,0.00,0,0,0,0,0,0,0,0,0,0,0,0,0
20200312,707015,應華康和95購01,,,,,,0.00,0,0,0,0,0,0,0,0,0,0,0,0,0
20200312,707016,大田元大95購01,,,,,,0.00,0,0,0,0,0,0,0,0,0,0,0,0,0
20200312,707017,弘塑元大95購01,0.87,0.87,0.51,0.56,-0.68,-54.84,140000,17,93880,0,0,0,0,0,0,35000,105000,-70000,-70000
20200312,707018,合晶元大96購02,0.25,0.25,0.25,0.25,-0.23,-47.92,20000,1,5000,0,0,0,0,0,0,20000,0,20000,20000
20200312,707019,金居元大96購01,0.32,0.32,0.32,0.32,-0.37,-53.62,100000,1,32000,0,0,0,0,0,0,100000,0,100000,100000
20200312,707020,信昌電元大96購02,0.64,0.64,0.54,0.54,-0.31,-36.47,70000,2,42800,0,0,0,0,0,0,0,70000,-70000,-70000
20200312,707021,群聯元大95購05,2.13,2.17,1.43,1.45,-1.34,-48.03,123000,13,219650,0,0,0,0,0,0,33000,123000,-90000,-90000
20200312,707022,譜瑞元大95購02,1.06,1.06,1.06,1.06,-0.98,-48.04,50000,1,53000,0,0,0,0,0,0,50000,0,50000,50000
20200312,707023,晟德元大95購01,,,,,,0.00,0,0,0,0,0,0,0,0,0,0,0,0,0
20200312,707024,由田國票96購01,,,,,,0.00,0,0,0,0,0,0,0,0,0,0,0,0,0
20200312,707025,杰力國票96購01,,,,,,0.00,0,0,0,0,0,0,0,0,0,0,0,0,0
20200312,707026,晶焱國票96購01,,,,,,0.00,0,0,0,0,0,0,0,0,0,0,0,0,0
20200312,707027,網龍國票96購01,0.11,0.11,0.11,0.11,-0.19,-63.33,10000,1,1100,0,0,0,0,0,0,0,10000,-10000,-10000
20200312,707028,優群國票95購02,,,,,,0.00,0,0,0,0,0,0,0,0,0,0,0,0,0
20200312,707029,大宇資國泰97購01,,,,,,0.00,0,0,0,0,0,0,0,0,0,0,0,0,0
20200312,707030,建榮國泰97購01,,,,,,0.00,0,0,0,0,0,0,0,0,0,0,0,0,0
20200312,707031,中美晶第一95購01,,,,,,0.00,0,0,0,0,0,0,0,0,0,0,0,0,0
20200312,707032,大江永豐95購01,,,,,,0.00,0,0,0,0,0,0,0,0,0,0,0,0,0
20200312,707033,中光電永豐95購01,,,,,,0.00,0,0,0,0,0,0,0,0,0,0,0,0,0
20200312,707034,中美晶永豐95購01,,,,,,0.00,0,0,0,0,0,0,0,0,0,0,0,0,0
20200312,707035,弘塑永豐95購01,0.38,0.38,0.24,0.24,-0.21,-46.67,140000,10,39000,0,0,0,0,0,0,60000,80000,-20000,-20000
20200312,707036,環宇永豐95購01,,,,,,0.00,0,0,0,0,0,0,0,0,0,0,0,0,0
20200312,707037,晟德永豐95購01,,,,,,0.00,0,0,0,0,0,0,0,0,0,0,0,0,0
20200312,707038,譜瑞富邦97購01,0.93,0.94,0.64,0.70,-0.30,-30.0,197000,25,161870,0,0,0,0,0,0,46000,149000,-103000,-103000
20200312,707039,良維中信95購01,,,,,,0.00,0,0,0,0,0,0,0,0,0,0,0,0,0
20200312,707040,台半凱基95購01,,,,,,0.00,0,0,0,0,0,0,0,0,0,0,0,0,0
20200312,707041,合晶凱基95購01,,,,,,0.00,0,0,0,0,0,0,0,0,0,0,0,0,0
20200312,707042,建榮凱基95購01,,,,,,0.00,0,0,0,0,0,0,0,0,0,0,0,0,0
20200312,707043,勝麗凱基95購01,0.18,0.19,0.14,0.14,-0.22,-61.11,84000,4,15040,0,0,0,0,0,0,65000,19000,46000,46000
20200312,707044,晟德凱基95購01,,,,,,0.00,0,0,0,0,0,0,0,0,0,0,0,0,0
20200312,707045,VHQ元大95購01,,,,,,0.00,0,0,0,0,0,0,0,0,0,0,0,0,0
20200312,707046,大宇資元大97購01,0.24,0.24,0.16,0.16,-0.24,-60.0,11000,2,2160,0,0,0,0,0,0,5000,0,5000,5000
20200312,707047,台半元大95購01,,,,,,0.00,0,0,0,0,0,0,0,0,0,0,0,0,0
20200312,707048,昇達科元大96購03,,,,,,0.00,0,0,0,0,0,0,0,0,0,0,0,0,0
20200312,707049,杰力元大96購02,,,,,,0.00,0,0,0,0,0,0,0,0,0,0,0,0,0
20200312,707050,信昌電元大96購03,0.49,0.49,0.49,0.49,-0.19,-27.94,10000,1,4900,0,0,0,0,0,0,10000,0,10000,10000
20200312,707051,神盾元大97購01,,,,,,0.00,0,0,0,0,0,0,0,0,0,0,0,0,0
20200312,707052,博智元大95購02,5.95,5.95,5.95,5.95,-2.10,-26.09,2000,2,11900,0,0,0,0,0,0,0,2000,-2000,-2000
20200312,707053,群聯元大96購01,1.68,1.68,1.16,1.19,-0.83,-41.09,50000,9,67480,0,0,0,0,0,0,25000,50000,-25000,-25000
20200312,707054,合晶國泰97購01,0.60,0.60,0.52,0.52,-0.19,-26.76,124000,2,72320,0,0,0,0,0,0,0,124000,-124000,-124000
20200312,707055,大江國票96購01,,,,,,0.00,0,0,0,0,0,0,0,0,0,0,0,0,0
20200312,707056,台半國票96購01,0.44,0.44,0.44,0.44,-0.14,-24.14,10000,1,4400,0,0,0,0,0,0,10000,0,10000,10000
20200312,707057,弘塑國票95購01,1.21,1.21,0.69,0.71,-1.04,-59.43,90000,11,88650,0,0,0,0,0,0,20000,65000,-45000,-45000
20200312,707058,同致國票95購02,,,,,,0.00,0,0,0,0,0,0,0,0,0,0,0,0,0
20200312,707059,聚積國票95購01,,,,,,0.00,0,0,0,0,0,0,0,0,0,0,0,0,0
20200312,707060,廣明國票95購02,,,,,,0.00,0,0,0,0,0,0,0,0,0,0,0,0,0
20200312,707061,聯亞國票96購01,0.93,0.93,0.93,0.93,-0.57,-38.0,10000,1,9300,0,0,0,0,0,0,0,10000,-10000,-10000
20200312,707062,精華富邦95購01,0.10,0.10,0.10,0.10,0.00,0.0,10000,10,1000,0,0,0,0,0,0,0,10000,-10000,-10000
20200312,707063,中美晶兆豐96購01,0.39,0.39,0.28,0.39,-0.07,-15.22,371000,11,118350,0,0,0,0,0,0,74000,297000,-223000,-223000
20200312,707064,弘塑康和95購01,0.56,0.56,0.40,0.42,-0.47,-52.81,597000,10,275980,0,0,0,0,0,0,297000,300000,-3000,-3000
20200312,707065,新普群益97購01,1.11,1.11,0.97,1.11,-0.14,-11.2,98000,10,106280,0,0,0,0,0,0,57000,41000,16000,16000
20200312,707066,精華群益95購01,,,,,,0.00,0,0,0,0,0,0,0,0,0,0,0,0,0
20200312,707067,精華群益95購02,,,,,,0.00,0,0,0,0,0,0,0,0,0,0,0,0,0
20200312,707068,譜瑞群益95購01,1.68,1.68,1.61,1.61,-0.32,-16.58,37000,3,61070,0,0,0,0,0,0,37000,7000,30000,30000
20200312,707069,中美晶元富95購04,0.61,0.72,0.61,0.72,-0.43,-37.39,60000,6,40600,0,0,0,0,0,0,0,60000,-60000,-60000
20200312,707070,良維元富95購01,,,,,,0.00,0,0,0,0,0,0,0,0,0,0,0,0,0
20200312,707071,環球晶元富95購04,0.52,0.60,0.40,0.60,-0.01,-1.64,140000,12,67800,0,0,0,0,0,0,70000,70000,0,0
20200312,707072,鈺太台新95購01,0.47,0.47,0.47,0.47,-0.21,-30.88,10000,1,4700,0,0,0,0,0,0,10000,0,10000,10000
20200312,707073,台半永豐95購01,,,,,,0.00,0,0,0,0,0,0,0,0,0,0,0,0,0
20200312,707074,昂寶永豐96購01,,,,,,0.00,0,0,0,0,0,0,0,0,0,0,0,0,0
20200312,707075,廣明永豐96購01,,,,,,0.00,0,0,0,0,0,0,0,0,0,0,0,0,0
20200312,707076,東洋中信95購01,0.13,0.13,0.08,0.08,-0.10,-55.56,350000,9,37000,0,0,0,0,0,0,100000,250000,-150000,-150000
20200312,707077,精華中信97購01,,,,,,0.00,0,0,0,0,0,0,0,0,0,0,0,0,0
20200312,707078,環宇中信97購02,0.05,0.05,0.05,0.05,-0.05,-50.0,20000,1,1000,0,0,0,0,0,0,20000,0,20000,20000
20200312,707079,晟德中信97購01,,,,,,0.00,0,0,0,0,0,0,0,0,0,0,0,0,0
20200312,707080,弘塑統一98購01,0.51,0.51,0.36,0.36,-0.29,-44.62,284000,18,125600,0,0,0,0,0,0,100000,184000,-84000,-84000
20200312,707081,世界凱基95購01,1.52,1.70,1.49,1.70,-0.27,-13.71,94000,6,147420,0,0,0,0,0,0,0,94000,-94000,-94000
20200312,707082,環球晶凱基95購04,0.91,0.91,0.69,0.81,-0.42,-34.15,155000,7,118090,0,0,0,0,0,0,125000,55000,70000,70000
20200312,707083,大江元大96購02,,,,,,0.00,0,0,0,0,0,0,0,0,0,0,0,0,0
20200312,707084,原相元大97購01,4.23,4.23,4.23,4.23,-1.47,-25.79,8000,1,33840,0,0,0,0,0,0,8000,8000,0,0
20200312,707085,群聯元大96購02,1.44,1.44,1.02,1.02,-0.78,-43.33,62000,9,71840,0,0,0,0,0,0,52000,62000,-10000,-10000
20200312,707086,網龍元大95購01,,,,,,0.00,0,0,0,0,0,0,0,0,0,0,0,0,0
20200312,707087,環宇元大95購01,0.22,0.22,0.11,0.11,-0.22,-66.67,413000,6,60790,0,0,0,0,0,0,259000,154000,105000,105000
20200312,707088,兆利永豐95購01,,,,,,0.00,0,0,0,0,0,0,0,0,0,0,0,0,0
20200312,707089,亞泰永豐95購01,,,,,,0.00,0,0,0,0,0,0,0,0,0,0,0,0,0
20200312,707090,順達永豐95購01,0.17,0.17,0.17,0.17,-0.08,-32.0,120000,5,20400,0,0,0,0,0,0,0,120000,-120000,-120000
20200312,707091,緯軟永豐95購01,,,,,,0.00,0,0,0,0,0,0,0,0,0,0,0,0,0
20200312,707092,環宇永豐95購02,,,,,,0.00,0,0,0,0,0,0,0,0,0,0,0,0,0
20200312,707093,廣明國泰96購01,,,,,,0.00,0,0,0,0,0,0,0,0,0,0,0,0,0
20200312,707094,中美晶國票96購01,,,,,,0.00,0,0,0,0,0,0,0,0,0,0,0,0,0
20200312,707095,宜鼎國票96購01,2.69,2.69,2.19,2.19,-1.46,-40.0,28000,3,62030,0,0,0,0,0,0,26000,2000,24000,24000
20200312,707096,環宇國票95購01,,,,,,0.00,0,0,0,0,0,0,0,0,0,0,0,0,0
20200312,707097,穩懋國票96購02,,,,,,0.00,0,0,0,0,0,0,0,0,0,0,0,0,0
20200312,707098,台燿兆豐96購01,0.57,0.57,0.45,0.45,-0.28,-38.36,239000,24,116720,0,0,0,0,0,0,33000,206000,-173000,-173000
20200312,707099,穩懋兆豐96購01,0.32,0.32,0.22,0.25,-0.21,-45.65,241000,5,63250,0,0,0,0,0,0,130000,111000,19000,19000
20200312,707100,台半群益95購01,,,,,,0.00,0,0,0,0,0,0,0,0,0,0,0,0,0
20200312,707101,合晶群益95購01,0.07,0.07,0.07,0.07,-0.11,-61.11,80000,3,5600,0,0,0,0,0,0,0,80000,-80000,-80000
20200312,707102,原相群益96購04,,,,,,0.00,0,0,0,0,0,0,0,0,0,0,0,0,0
20200312,707103,合晶元富95購01,,,,,,0.00,0,0,0,0,0,0,0,0,0,0,0,0,0
20200312,707104,六角兆豐96購01,,,,,,0.00,0,0,0,0,0,0,0,0,0,0,0,0,0
20200312,707105,弘塑台新95購01,,,,,,0.00,0,0,0,0,0,0,0,0,0,0,0,0,0
20200312,707106,原相台新97購01,,,,,,0.00,0,0,0,0,0,0,0,0,0,0,0,0,0
20200312,707107,聯亞台新95購01,,,,,,0.00,0,0,0,0,0,0,0,0,0,0,0,0,0
20200312,707108,新普群益97購02,0.90,0.90,0.78,0.78,-0.33,-29.73,61000,3,53700,0,0,0,0,0,0,41000,20000,21000,21000
20200312,707109,環宇群益97購01,,,,,,0.00,0,0,0,0,0,0,0,0,0,0,0,0,0
20200312,707110,環球晶群益95購01,0.79,0.80,0.50,0.58,-0.48,-45.28,115000,13,77180,0,0,0,0,0,0,35000,95000,-60000,-60000
20200312,707111,元太元大95購02,,,,,,0.00,0,0,0,0,0,0,0,0,0,0,0,0,0
20200312,707112,台燿元大95購01,0.67,0.67,0.57,0.57,-0.24,-29.63,240000,8,143750,0,0,0,0,0,0,95000,95000,0,0
20200312,707113,金居元大96購02,0.25,0.25,0.22,0.22,-0.12,-35.29,101000,10,23420,0,0,0,0,0,0,100000,1000,99000,99000
20200312,707114,建榮元大96購01,0.18,0.18,0.18,0.18,-0.06,-25.0,10000,1,1800,0,0,0,0,0,0,10000,0,10000,10000
20200312,707115,神準元大95購01,,,,,,0.00,0,0,0,0,0,0,0,0,0,0,0,0,0
20200312,707116,環宇元大95購02,,,,,,0.00,0,0,0,0,0,0,0,0,0,0,0,0,0
20200312,707117,聯亞元大96購01,0.32,0.48,0.32,0.38,-0.26,-40.62,282000,8,114360,0,0,0,0,0,0,154000,80000,74000,74000
20200312,707118,穩懋元大95購02,0.12,0.12,0.12,0.12,-0.21,-63.64,10000,1,1200,0,0,0,0,0,0,10000,0,10000,10000
20200312,707119,群聯凱基95購01,0.50,0.50,0.50,0.50,-1.58,-75.96,10000,1,5000,0,0,0,0,0,0,0,10000,-10000,-10000
20200312,707120,環球晶凱基95購06,0.42,0.42,0.42,0.42,-0.21,-33.33,40000,1,16800,0,0,0,0,0,0,40000,0,40000,40000
20200312,707121,大江國票97購01,,,,,,0.00,0,0,0,0,0,0,0,0,0,0,0,0,0
20200312,707122,昂寶國票96購01,,,,,,0.00,0,0,0,0,0,0,0,0,0,0,0,0,0
20200312,707123,保瑞國票96購01,1.70,1.70,1.35,1.49,-0.19,-11.31,229000,19,342660,0,0,0,0,0,0,181000,42000,139000,139000
20200312,707124,環宇國泰96購01,,,,,,0.00,0,0,0,0,0,0,0,0,0,0,0,0,0
20200312,707125,環球晶國泰96購01,1.49,1.64,1.21,1.64,-0.22,-11.83,172000,8,255170,0,0,0,0,0,0,55000,142000,-87000,-87000
20200312,707126,久元永豐95購01,0.52,0.52,0.46,0.48,-0.12,-20.0,67000,6,33040,0,0,0,0,0,0,37000,30000,7000,7000
20200312,707127,弘塑永豐95購02,,,,,,0.00,0,0,0,0,0,0,0,0,0,0,0,0,0
20200312,707128,神準永豐95購01,,,,,,0.00,0,0,0,0,0,0,0,0,0,0,0,0,0
20200312,707129,穩懋永豐95購02,,,,,,0.00,0,0,0,0,0,0,0,0,0,0,0,0,0
20200312,707130,合晶元富95購02,0.32,0.32,0.32,0.32,-0.17,-34.69,10000,1,3200,0,0,0,0,0,0,0,10000,-10000,-10000
20200312,707131,金居台新95購01,0.08,0.08,0.08,0.08,-0.04,-33.33,5000,1,400,0,0,0,0,0,0,5000,0,5000,5000
20200312,707132,晟德國泰96購01,,,,,,0.00,0,0,0,0,0,0,0,0,0,0,0,0,0
20200312,707133,中光電群益96購01,0.43,0.43,0.32,0.32,-0.25,-43.86,132000,4,44130,0,0,0,0,0,0,115000,17000,98000,98000
20200312,707134,元太群益96購01,,,,,,0.00,0,0,0,0,0,0,0,0,0,0,0,0,0
20200312,707135,原相群益97購03,1.70,1.77,1.53,1.53,-1.20,-43.96,130000,9,208550,0,0,0,0,0,0,10000,120000,-110000,-110000
20200312,707136,群聯群益97購01,0.55,0.58,0.36,0.36,-0.37,-50.68,388000,20,151700,0,0,0,0,0,0,35000,377000,-342000,-342000
20200312,707137,VHQ永豐95購01,0.01,0.01,0.01,0.01,-0.02,-66.67,21000,1,210,0,0,0,0,0,0,21000,0,21000,21000
20200312,707138,大宇資永豐95購01,,,,,,0.00,0,0,0,0,0,0,0,0,0,0,0,0,0
20200312,707139,台星科永豐95購01,0.08,0.09,0.08,0.08,-0.06,-42.86,74000,4,6460,0,0,0,0,0,0,0,74000,-74000,-74000
20200312,707140,立端永豐95購01,,,,,,0.00,0,0,0,0,0,0,0,0,0,0,0,0,0
20200312,707141,合晶永豐95購02,,,,,,0.00,0,0,0,0,0,0,0,0,0,0,0,0,0
20200312,707142,直得永豐95購01,0.83,0.83,0.57,0.57,-0.45,-44.12,530000,9,369280,0,0,0,0,0,0,470000,60000,410000,410000
20200312,707143,精華永豐95購01,,,,,,0.00,0,0,0,0,0,0,0,0,0,0,0,0,0
20200312,707144,璟德永豐95購01,0.82,0.82,0.57,0.57,-0.42,-42.42,35000,6,21570,0,0,0,0,0,0,10000,25000,-15000,-15000
20200312,707145,環球晶永豐95購01,0.03,0.03,0.03,0.03,-0.09,-75.0,299000,1,8970,0,0,0,0,0,0,299000,0,299000,299000
20200312,707146,群聯凱基95購02,0.26,0.32,0.11,0.11,-0.43,-79.63,85000,9,20600,0,0,0,0,0,0,20000,75000,-55000,-55000
20200312,707147,大江元大96購03,,,,,,0.00,0,0,0,0,0,0,0,0,0,0,0,0,0
20200312,707148,金可元大95購01,,,,,,0.00,0,0,0,0,0,0,0,0,0,0,0,0,0
20200312,707149,群聯元大96購03,0.90,0.90,0.50,0.52,-0.69,-57.02,232000,30,159600,0,0,0,0,0,0,186000,227000,-41000,-41000
20200312,707150,網家元大95購01,0.02,0.02,0.02,0.02,-0.01,-33.33,50000,5,1000,0,0,0,0,0,0,0,50000,-50000,-50000
20200312,707151,環球晶元大95購04,0.48,0.49,0.32,0.49,-0.21,-30.0,73000,5,29010,0,0,0,0,0,0,68000,5000,63000,63000
20200312,707152,環球晶元大95購05,0.55,0.55,0.34,0.38,-0.29,-43.28,356000,6,142540,0,0,0,0,0,0,168000,188000,-20000,-20000
20200312,707153,櫃200元大95購01,,,,,,0.00,0,0,0,0,0,0,0,0,0,0,0,0,0
20200312,707154,雙鴻元大97購02,0.11,0.11,0.08,0.08,-0.09,-52.94,90000,3,7800,0,0,0,0,0,0,0,90000,-90000,-90000
20200312,707155,大宇資元富95購01,,,,,,0.00,0,0,0,0,0,0,0,0,0,0,0,0,0
20200312,707156,昂寶元富95購01,,,,,,0.00,0,0,0,0,0,0,0,0,0,0,0,0,0
20200312,707157,同致兆豐96購01,,,,,,0.00,0,0,0,0,0,0,0,0,0,0,0,0,0
20200312,707158,威剛兆豐96購01,1.20,1.20,0.97,0.97,-0.72,-42.6,147000,8,170340,0,0,0,0,0,0,28000,127000,-99000,-99000
20200312,707159,網龍兆豐96購01,,,,,,0.00,0,0,0,0,0,0,0,0,0,0,0,0,0
20200312,707160,環球晶群益95購02,0.64,0.64,0.40,0.40,-0.40,-50.0,114000,6,65960,0,0,0,0,0,0,71000,46000,25000,25000
20200312,707161,元太國票96購01,,,,,,0.00,0,0,0,0,0,0,0,0,0,0,0,0,0
20200312,707162,旺矽國票96購01,1.36,1.36,1.36,1.36,-0.57,-29.53,43000,2,58480,0,0,0,0,0,0,43000,0,43000,43000
20200312,707163,信昌電國票96購01,1.04,1.04,0.88,0.88,-0.48,-35.29,20000,2,19200,0,0,0,0,0,0,10000,10000,0,0
20200312,707164,宣德國票96購01,1.15,1.15,1.15,1.15,-0.48,-29.45,10000,1,11500,0,0,0,0,0,0,10000,0,10000,10000
20200312,707165,聚積國票96購01,0.27,0.27,0.18,0.18,-0.15,-45.45,260000,2,47700,0,0,0,0,0,0,10000,250000,-240000,-240000
20200312,707166,譜瑞國票96購01,1.24,1.27,0.59,0.61,-0.96,-61.15,148000,16,122720,0,0,0,0,0,0,35000,113000,-78000,-78000
20200312,707167,中美晶國泰96購01,1.84,1.84,1.36,1.75,-0.51,-22.57,195000,10,320530,0,0,0,0,0,0,192000,11000,181000,181000
20200312,707168,群聯國泰97購01,1.42,1.42,0.84,0.85,-1.16,-57.71,535000,53,520130,0,0,0,0,0,0,110000,535000,-425000,-425000
20200312,707169,群聯富邦96購01,0.24,0.24,0.14,0.14,-0.17,-54.84,147000,19,21030,0,0,0,0,0,0,30000,147000,-117000,-117000
20200312,707170,環宇富邦97購01,0.08,0.08,0.08,0.08,-0.06,-42.86,1000,1,80,0,0,0,0,0,0,1000,0,1000,1000
20200312,707171,弘塑中信99購01,0.40,0.40,0.32,0.32,-0.24,-42.86,41000,4,16060,0,0,0,0,0,0,34000,7000,27000,27000
20200312,707172,環球晶中信99購01,0.25,0.25,0.16,0.24,-0.04,-14.29,642000,32,126970,0,0,0,0,0,0,131000,511000,-380000,-380000
20200312,707173,鈺太中信96購01,0.31,0.31,0.31,0.31,-0.13,-29.55,151000,2,46810,0,0,0,0,0,0,151000,0,151000,151000
20200312,707174,凡甲凱基96購01,0.27,0.27,0.21,0.23,-0.18,-43.9,326000,11,81130,0,0,0,0,0,0,301000,25000,276000,276000
20200312,707175,大江凱基96購01,,,,,,0.00,0,0,0,0,0,0,0,0,0,0,0,0,0
20200312,707176,中美晶凱基95購02,0.24,0.25,0.21,0.24,-0.11,-31.43,329000,4,73960,0,0,0,0,0,0,19000,310000,-291000,-291000
20200312,707177,合晶凱基95購02,,,,,,0.00,0,0,0,0,0,0,0,0,0,0,0,0,0
20200312,707178,威剛凱基97購01,1.62,1.68,1.09,1.25,-1.01,-44.69,318000,21,485920,0,0,0,0,0,0,128000,265000,-137000,-137000
20200312,707179,神盾凱基95購01,,,,,,0.00,0,0,0,0,0,0,0,0,0,0,0,0,0
20200312,707180,新鉅科凱基95購01,,,,,,0.00,0,0,0,0,0,0,0,0,0,0,0,0,0
20200312,707181,由田永豐95購01,,,,,,0.00,0,0,0,0,0,0,0,0,0,0,0,0,0
20200312,707182,同致永豐95購01,,,,,,0.00,0,0,0,0,0,0,0,0,0,0,0,0,0
20200312,707183,良維永豐95購02,,,,,,0.00,0,0,0,0,0,0,0,0,0,0,0,0,0
20200312,707184,昇達科永豐95購01,,,,,,0.00,0,0,0,0,0,0,0,0,0,0,0,0,0
20200312,707185,杰力永豐95購01,,,,,,0.00,0,0,0,0,0,0,0,0,0,0,0,0,0
20200312,707186,金可永豐95購01,,,,,,0.00,0,0,0,0,0,0,0,0,0,0,0,0,0
20200312,707187,中美晶元大95購04,0.45,0.45,0.33,0.34,-0.21,-38.18,75000,5,26200,0,0,0,0,0,0,30000,45000,-15000,-15000
20200312,707188,六角元大95購01,0.20,0.20,0.20,0.20,-0.10,-33.33,7000,1,1400,0,0,0,0,0,0,7000,0,7000,7000
20200312,707189,美琪瑪元大96購01,,,,,,0.00,0,0,0,0,0,0,0,0,0,0,0,0,0
20200312,707190,神盾元大96購02,,,,,,0.00,0,0,0,0,0,0,0,0,0,0,0,0,0
20200312,707191,穩懋元大95購04,,,,,,0.00,0,0,0,0,0,0,0,0,0,0,0,0,0
20200312,707192,穩懋元大95購06,,,,,,0.00,0,0,0,0,0,0,0,0,0,0,0,0,0
20200312,707193,穩懋元大95購07,,,,,,0.00,0,0,0,0,0,0,0,0,0,0,0,0,0
20200312,707194,廣明兆豐95購01,,,,,,0.00,0,0,0,0,0,0,0,0,0,0,0,0,0
20200312,707195,弘塑群益95購01,0.46,0.46,0.34,0.36,-0.44,-55.0,80000,6,31700,0,0,0,0,0,0,70000,10000,60000,60000
20200312,707196,閎康群益96購01,0.71,0.71,0.52,0.52,-0.35,-40.23,347000,5,240390,0,330000,-330000,0,0,0,340000,7000,333000,3000
20200312,707197,順達群益96購01,0.90,0.92,0.76,0.82,-0.24,-22.64,61000,7,52400,0,0,0,0,0,0,11000,50000,-39000,-39000
20200312,707198,VHQ國票96購01,,,,,,0.00,0,0,0,0,0,0,0,0,0,0,0,0,0
20200312,707199,新鉅科國票95購01,,,,,,0.00,0,0,0,0,0,0,0,0,0,0,0,0,0
20200312,707200,網龍國票97購01,0.08,0.08,0.08,0.08,-0.12,-60.0,15000,1,1200,0,0,0,0,0,0,0,15000,-15000,-15000
20200312,707201,環球晶國票96購02,0.48,0.57,0.48,0.57,-0.10,-14.93,100000,4,51700,0,0,0,0,0,0,50000,40000,10000,10000
20200312,707202,聯亞國票96購02,0.82,0.82,0.53,0.57,-0.85,-59.86,31000,7,20370,0,0,0,0,0,0,0,31000,-31000,-31000
20200312,707203,晟德國票95購01,0.03,0.03,0.03,0.03,-0.03,-50.0,30000,1,900,0,0,0,0,0,0,0,30000,-30000,-30000
20200312,707204,弘塑麥證95購01,0.22,0.22,0.19,0.19,-0.27,-58.7,122000,2,23300,122000,0,122000,0,0,0,122000,0,122000,122000
20200312,707205,大田元大95購02,,,,,,0.00,0,0,0,0,0,0,0,0,0,0,0,0,0
20200312,707206,六角元大95購02,0.29,0.29,0.25,0.25,-0.19,-43.18,20000,2,5400,0,0,0,0,0,0,0,20000,-20000,-20000
20200312,707207,宇峻元大97購01,0.74,0.83,0.54,0.60,-0.15,-20.0,280000,20,190660,0,0,0,0,0,0,140000,138000,2000,2000
20200312,707208,東洋元大95購01,0.11,0.11,0.11,0.11,-0.15,-57.69,100000,1,11000,0,0,0,0,0,0,100000,0,100000,100000
20200312,707209,環球晶元大95購06,1.38,1.49,1.26,1.49,-0.32,-17.68,35000,4,46940,0,0,0,0,0,0,25000,35000,-10000,-10000
20200312,707210,聯亞元大95購03,0.95,0.95,0.75,0.75,-0.67,-47.18,149000,8,134680,0,0,0,0,0,0,41000,137000,-96000,-96000
20200312,707211,晟德元大95購02,,,,,,0.00,0,0,0,0,0,0,0,0,0,0,0,0,0
20200312,707212,鈺太元大95購01,0.91,0.91,0.64,0.64,-0.65,-50.39,111000,3,87330,0,0,0,0,0,0,87000,24000,63000,63000
20200312,707213,順達統一97購01,0.85,0.85,0.82,0.82,-0.22,-21.15,3000,2,2520,0,0,0,0,0,0,2000,1000,1000,1000
20200312,707214,六角永豐95購01,,,,,,0.00,0,0,0,0,0,0,0,0,0,0,0,0,0
20200312,707215,晶焱永豐95購01,0.96,0.96,0.96,0.96,-0.14,-12.73,90000,1,86400,0,0,0,0,0,0,90000,0,90000,90000
20200312,707216,順達永豐95購02,,,,,,0.00,0,0,0,0,0,0,0,0,0,0,0,0,0
20200312,707217,聯亞永豐95購01,0.50,0.50,0.42,0.42,-0.51,-54.84,37000,4,16780,0,0,0,0,0,0,27000,37000,-10000,-10000
20200312,707218,鐿鈦永豐95購01,,,,,,0.00,0,0,0,0,0,0,0,0,0,0,0,0,0
20200312,707219,弘塑凱基95購01,0.20,0.20,0.10,0.11,-0.15,-57.69,498000,25,65280,0,0,0,0,0,0,100000,198000,-98000,-98000
20200312,707220,合晶凱基95購03,,,,,,0.00,0,0,0,0,0,0,0,0,0,0,0,0,0
20200312,707221,原相凱基95購02,,,,,,0.00,0,0,0,0,0,0,0,0,0,0,0,0,0
20200312,707222,群聯凱基95購03,0.29,0.29,0.29,0.29,-0.74,-71.84,30000,1,8700,0,0,0,0,0,0,30000,30000,0,0
20200312,707223,緯軟凱基95購01,0.02,0.02,0.02,0.02,-0.08,-80.0,250000,1,5000,0,0,0,0,0,0,250000,0,250000,250000
20200312,707224,環球晶凱基95購09,0.11,0.17,0.10,0.17,-0.11,-39.29,62000,4,7570,0,0,0,0,0,0,2000,60000,-58000,-58000
20200312,707225,中美晶元富95購06,0.54,0.54,0.41,0.51,-0.15,-22.73,108000,8,51470,0,0,0,0,0,0,3000,105000,-102000,-102000
20200312,707226,精華元富95購01,,,,,,0.00,0,0,0,0,0,0,0,0,0,0,0,0,0
20200312,707227,環球晶元富95購05,0.33,0.33,0.25,0.33,-0.18,-35.29,16000,3,5200,0,0,0,0,0,0,15000,1000,14000,14000
20200312,707228,穩懋元富95購05,0.11,0.11,0.11,0.11,-0.14,-56.0,50000,1,5500,0,0,0,0,0,0,50000,0,50000,50000
20200312,707229,穩懋元富95購06,0.04,0.04,0.04,0.04,-0.02,-33.33,440000,4,17600,0,0,0,0,0,0,0,440000,-440000,-440000
20200312,707230,M31台新95購01,,,,,,0.00,0,0,0,0,0,0,0,0,0,0,0,0,0
20200312,707231,大宇資康和95購01,,,,,,0.00,0,0,0,0,0,0,0,0,0,0,0,0,0
20200312,707232,大學光群益95購01,1.42,1.42,1.00,1.00,-0.59,-37.11,120000,4,148600,0,0,0,0,0,0,70000,50000,20000,20000
20200312,707233,迅得群益97購01,0.83,0.83,0.83,0.83,-0.57,-40.71,10000,1,8300,0,0,0,0,0,0,10000,0,10000,10000
20200312,707234,勝麗群益95購01,0.71,0.73,0.68,0.68,-0.29,-29.9,23000,3,16440,0,0,0,0,0,0,10000,13000,-3000,-3000
20200312,707235,群聯群益96購02,0.86,0.86,0.47,0.49,-0.57,-53.77,467000,34,298200,0,0,0,0,0,0,193000,324000,-131000,-131000
20200312,707236,聚積群益97購01,0.40,0.40,0.40,0.40,-0.06,-13.04,98000,1,39200,0,0,0,0,0,0,98000,0,98000,98000
20200312,707237,雙美麥證95購01,,,,,,0.00,0,0,0,0,0,0,0,0,0,0,0,0,0
20200312,707238,合晶元富95購03,,,,,,0.00,0,0,0,0,0,0,0,0,0,0,0,0,0
20200312,707239,金可元富95購01,,,,,,0.00,0,0,0,0,0,0,0,0,0,0,0,0,0
20200312,707240,昂寶國票97購01,,,,,,0.00,0,0,0,0,0,0,0,0,0,0,0,0,0
20200312,707241,昇達科國票96購01,0.30,0.30,0.21,0.21,-0.17,-44.74,70000,3,17700,0,0,0,0,0,0,0,70000,-70000,-70000
20200312,707242,信驊國票96購01,3.58,3.58,2.99,3.02,-1.01,-25.06,84000,7,280020,0,0,0,0,0,0,54000,30000,24000,24000
20200312,707243,新普國票96購01,,,,,,0.00,0,0,0,0,0,0,0,0,0,0,0,0,0
20200312,707244,精華國票96購01,,,,,,0.00,0,0,0,0,0,0,0,0,0,0,0,0,0
20200312,707245,大江元大95購04,,,,,,0.00,0,0,0,0,0,0,0,0,0,0,0,0,0
20200312,707246,弘塑元大96購01,0.75,0.75,0.47,0.48,-0.32,-40.0,106000,11,64130,0,0,0,0,0,0,46000,80000,-34000,-34000
20200312,707247,安勤元大95購01,0.42,0.42,0.28,0.29,-0.27,-48.21,380000,7,130600,0,0,0,0,0,0,160000,220000,-60000,-60000
20200312,707248,建榮元大96購02,,,,,,0.00,0,0,0,0,0,0,0,0,0,0,0,0,0
20200312,707249,群聯元大95購06,0.79,0.79,0.71,0.71,-0.40,-36.04,20000,2,15000,0,0,0,0,0,0,10000,10000,0,0
20200312,707250,環球晶元大95購07,1.47,1.47,1.15,1.15,-0.77,-40.1,6000,3,8410,0,0,0,0,0,0,5000,6000,-1000,-1000
20200312,707251,環球晶元大95購08,0.98,0.98,0.75,0.75,-0.34,-31.19,222000,5,189680,0,0,0,0,0,0,122000,122000,0,0
20200312,707252,鐿鈦元大96購01,,,,,,0.00,0,0,0,0,0,0,0,0,0,0,0,0,0
20200312,707253,穩懋亞東96購02,,,,,,0.00,0,0,0,0,0,0,0,0,0,0,0,0,0
20200312,707254,同致中信97購01,,,,,,0.00,0,0,0,0,0,0,0,0,0,0,0,0,0
20200312,707255,環球晶凱基95購10,0.46,0.55,0.28,0.55,-0.09,-14.06,88000,9,39010,0,0,0,0,0,0,54000,34000,20000,20000
20200312,707256,環球晶凱基95購11,1.17,1.17,1.06,1.06,-0.31,-22.63,41000,3,45710,0,0,0,0,0,0,41000,23000,18000,18000
20200312,707257,兆利永豐95購02,0.06,0.08,0.06,0.08,-0.08,-50.0,11000,3,760,0,0,0,0,0,0,11000,0,11000,11000
20200312,707258,信昌電永豐95購01,0.64,0.64,0.64,0.64,-0.07,-9.86,45000,1,28800,0,0,0,0,0,0,45000,0,45000,45000
20200312,707259,信驊永豐95購01,0.94,0.98,0.87,0.87,-0.49,-36.03,25000,4,22780,0,0,0,0,0,0,3000,22000,-19000,-19000
20200312,707260,新揚科永豐95購02,,,,,,0.00,0,0,0,0,0,0,0,0,0,0,0,0,0
20200312,707261,新普永豐95購01,,,,,,0.00,0,0,0,0,0,0,0,0,0,0,0,0,0
20200312,707262,大宇資凱基97購01,,,,,,0.00,0,0,0,0,0,0,0,0,0,0,0,0,0
20200312,707263,神盾凱基96購02,0.33,0.33,0.33,0.33,-0.15,-31.25,10000,1,3300,0,0,0,0,0,0,0,10000,-10000,-10000
20200312,707264,網家凱基95購02,,,,,,0.00,0,0,0,0,0,0,0,0,0,0,0,0,0
20200312,707265,環球晶凱基95購12,,,,,,0.00,0,0,0,0,0,0,0,0,0,0,0,0,0
20200312,707266,宇峻永豐95購01,0.67,0.67,0.47,0.47,-0.32,-40.51,16000,2,8520,0,0,0,0,0,0,16000,0,16000,16000
20200312,707267,邦特永豐95購01,,,,,,0.00,0,0,0,0,0,0,0,0,0,0,0,0,0
20200312,707268,皇田永豐95購01,,,,,,0.00,0,0,0,0,0,0,0,0,0,0,0,0,0
20200312,707269,原相永豐95購02,,,,,,0.00,0,0,0,0,0,0,0,0,0,0,0,0,0
20200312,707270,神盾永豐95購01,,,,,,0.00,0,0,0,0,0,0,0,0,0,0,0,0,0
20200312,707271,勝麗永豐95購01,0.20,0.20,0.20,0.20,-0.07,-25.93,1000,1,200,0,0,0,0,0,0,1000,0,1000,1000
20200312,707272,廣明永豐95購01,,,,,,0.00,0,0,0,0,0,0,0,0,0,0,0,0,0
20200312,707273,環球晶永豐95購02,,,,,,0.00,0,0,0,0,0,0,0,0,0,0,0,0,0
20200312,707274,雙鴻永豐95購05,,,,,,0.00,0,0,0,0,0,0,0,0,0,0,0,0,0
20200312,707275,元太元大96購01,,,,,,0.00,0,0,0,0,0,0,0,0,0,0,0,0,0
20200312,707276,皇田元大95購01,,,,,,0.00,0,0,0,0,0,0,0,0,0,0,0,0,0
20200312,707277,神盾元大97購02,0.32,0.33,0.26,0.26,-0.17,-39.53,203000,6,62260,0,0,0,0,0,0,0,203000,-203000,-203000
20200312,707278,勝麗元大96購01,0.77,0.77,0.51,0.51,-0.40,-43.96,162000,10,99960,0,0,0,0,0,0,99000,63000,36000,36000
20200312,707279,新鉅科元大95購01,0.03,0.03,0.01,0.02,-0.03,-60.0,420000,42,10300,0,0,0,0,0,0,0,410000,-410000,-410000
20200312,707280,碩禾元大96購01,0.67,0.90,0.52,0.90,+0.15,20.0,290000,14,167070,0,0,0,0,0,0,101000,238000,-137000,-137000
20200312,707281,精華元大95購02,0.21,0.21,0.14,0.14,-0.16,-53.33,115000,3,18410,0,0,0,0,0,0,115000,0,115000,115000
20200312,707282,環球晶元大95購09,1.11,1.11,0.97,0.97,-0.58,-37.42,21000,2,23170,0,0,0,0,0,0,20000,21000,-1000,-1000
20200312,707283,環球晶元大95購10,1.17,1.17,0.92,0.92,-0.53,-36.55,34000,4,36950,0,0,0,0,0,0,33000,24000,9000,9000
20200312,707284,晟德元大95購03,,,,,,0.00,0,0,0,0,0,0,0,0,0,0,0,0,0
20200312,707285,弘塑國泰97購01,0.91,0.92,0.70,0.75,-0.55,-42.31,140000,14,113200,0,0,0,0,0,0,0,140000,-140000,-140000
20200312,707286,信昌電富邦95購01,,,,,,0.00,0,0,0,0,0,0,0,0,0,0,0,0,0
20200312,707287,同致國票96購01,,,,,,0.00,0,0,0,0,0,0,0,0,0,0,0,0,0
20200312,707288,良維國票97購01,0.17,0.17,0.15,0.15,-0.12,-44.44,2000,2,320,0,0,0,0,0,0,0,2000,-2000,-2000
20200312,707289,緯軟國票97購01,,,,,,0.00,0,0,0,0,0,0,0,0,0,0,0,0,0
20200312,707290,優群國票96購01,1.95,1.95,1.95,1.95,-1.24,-38.87,149000,1,290550,0,0,0,0,0,0,0,149000,-149000,-149000
20200312,707291,元太兆豐95購02,,,,,,0.00,0,0,0,0,0,0,0,0,0,0,0,0,0
20200312,707292,金可兆豐95購02,0.10,0.10,0.10,0.10,-0.06,-37.5,20000,1,2000,0,0,0,0,0,0,0,20000,-20000,-20000
20200312,707293,泰博兆豐96購01,,,,,,0.00,0,0,0,0,0,0,0,0,0,0,0,0,0
20200312,707294,VHQ群益96購01,,,,,,0.00,0,0,0,0,0,0,0,0,0,0,0,0,0
20200312,707295,邦特群益95購01,,,,,,0.00,0,0,0,0,0,0,0,0,0,0,0,0,0
20200312,707296,鈺太群益95購01,1.04,1.04,0.76,0.78,-0.65,-45.45,38000,5,34480,0,0,0,0,0,0,28000,10000,18000,18000
20200312,707297,台燿凱基96購03,0.58,0.59,0.44,0.51,-0.19,-27.14,144000,8,81140,0,0,0,0,0,0,144000,0,144000,144000
20200312,707298,晶焱凱基95購01,0.18,0.20,0.18,0.20,-0.17,-45.95,101000,2,18200,0,0,0,0,0,0,0,101000,-101000,-101000
20200312,707299,緯軟中信95購01,,,,,,0.00,0,0,0,0,0,0,0,0,0,0,0,0,0
20200312,707300,雙鴻麥證95購01,,,,,,0.00,0,0,0,0,0,0,0,0,0,0,0,0,0
20200312,707301,中美晶元富95購07,1.20,1.20,0.90,1.16,-0.22,-15.94,66000,10,71730,0,0,0,0,0,0,26000,51000,-25000,-25000
20200312,707302,原相亞東96購01,2.62,2.62,2.62,2.62,-1.25,-32.3,10000,1,26200,0,0,0,0,0,0,0,10000,-10000,-10000
20200312,707303,群聯亞東95購01,0.21,0.21,0.21,0.21,-0.37,-63.79,5000,1,1050,0,0,0,0,0,0,0,5000,-5000,-5000
20200312,707304,杰力永豐95購02,,,,,,0.00,0,0,0,0,0,0,0,0,0,0,0,0,0
20200312,707305,波若威永豐95購02,,,,,,0.00,0,0,0,0,0,0,0,0,0,0,0,0,0
20200312,707306,保瑞永豐95購01,0.29,0.29,0.29,0.29,-0.20,-40.82,68000,1,19720,0,0,0,0,0,0,68000,0,68000,68000
20200312,707307,智崴永豐95購01,,,,,,0.00,0,0,0,0,0,0,0,0,0,0,0,0,0
20200312,707308,聯亞永豐95購02,0.25,0.28,0.20,0.20,-0.34,-62.96,133000,5,29650,0,0,0,0,0,0,93000,45000,48000,48000
20200312,707309,合晶國票96購02,0.94,0.94,0.94,0.94,-0.22,-18.97,40000,1,37600,0,0,0,0,0,0,40000,0,40000,40000
20200312,707310,原相國票96購01,5.55,5.55,4.37,4.37,-2.13,-32.77,16000,4,73360,0,0,0,0,0,0,0,16000,-16000,-16000
20200312,707311,昂寶國泰96購01,,,,,,0.00,0,0,0,0,0,0,0,0,0,0,0,0,0
20200312,707312,宣德兆豐95購01,,,,,,0.00,0,0,0,0,0,0,0,0,0,0,0,0,0
20200312,707313,智崴群益95購01,,,,,,0.00,0,0,0,0,0,0,0,0,0,0,0,0,0
20200312,707314,廣明群益95購01,,,,,,0.00,0,0,0,0,0,0,0,0,0,0,0,0,0
20200312,707315,大江元大96購04,0.02,0.02,0.02,0.02,-0.02,-50.0,1900000,53,38000,0,0,0,0,0,0,1400000,500000,900000,900000
20200312,707316,同致元大96購01,,,,,,0.00,0,0,0,0,0,0,0,0,0,0,0,0,0
20200312,707317,良維元大95購02,,,,,,0.00,0,0,0,0,0,0,0,0,0,0,0,0,0
20200312,707318,金可元大95購02,0.02,0.02,0.01,0.01,-0.04,-80.0,130000,3,1400,0,0,0,0,0,0,0,10000,-10000,-10000
20200312,707319,信驊元大95購01,2.45,2.45,2.28,2.28,-0.78,-25.49,23000,2,56180,0,0,0,0,0,0,22000,1000,21000,21000
20200312,707320,智崴元大95購01,,,,,,0.00,0,0,0,0,0,0,0,0,0,0,0,0,0
20200312,707321,智崴元大95購02,0.13,0.13,0.08,0.08,-0.11,-57.89,309000,4,30480,0,0,0,0,0,0,190000,119000,71000,71000
20200312,707322,新普元大95購01,0.47,0.47,0.47,0.47,-0.07,-12.96,49000,1,23030,0,0,0,0,0,0,0,49000,-49000,-49000
20200312,707323,環宇元大96購01,0.42,0.42,0.29,0.29,-0.19,-39.58,64000,6,23020,0,0,0,0,0,0,12000,64000,-52000,-52000
20200312,707324,櫃200永昌96購04,,,,,,0.00,0,0,0,0,0,0,0,0,0,0,0,0,0
20200312,707325,M31中信96購01,0.11,0.11,0.11,0.11,-0.10,-47.62,8000,1,880,0,0,0,0,0,0,8000,0,8000,8000
20200312,707326,穩懋中信97購01,0.35,0.35,0.34,0.34,-0.40,-54.05,11000,3,3820,0,0,0,0,0,0,0,11000,-11000,-11000
20200312,707327,鐿鈦中信95購01,,,,,,0.00,0,0,0,0,0,0,0,0,0,0,0,0,0
20200312,707328,中美晶凱基96購01,0.91,1.01,0.91,0.99,-0.27,-21.43,70000,6,67800,0,0,0,0,0,0,0,70000,-70000,-70000
20200312,707329,環球晶凱基95購13,0.49,0.64,0.49,0.64,+0.09,16.36,55000,3,34150,0,0,0,0,0,0,5000,50000,-45000,-45000
20200312,707330,原相第一95購01,,,,,,0.00,0,0,0,0,0,0,0,0,0,0,0,0,0
20200312,707331,中美晶永豐95購03,1.52,1.52,1.52,1.52,-0.25,-14.12,10000,1,15200,0,0,0,0,0,0,10000,0,10000,10000
20200312,707332,亞泰永豐95購02,,,,,,0.00,0,0,0,0,0,0,0,0,0,0,0,0,0
20200312,707333,大江國票96購04,,,,,,0.00,0,0,0,0,0,0,0,0,0,0,0,0,0
20200312,707334,合晶國票97購01,0.73,0.74,0.51,0.51,-0.29,-36.25,80000,7,49200,0,0,0,0,0,0,10000,70000,-60000,-60000
20200312,707335,勝麗國票97購01,0.77,0.77,0.62,0.63,-0.32,-33.68,458000,7,297460,0,0,0,0,0,0,58000,400000,-342000,-342000
20200312,707336,群聯國票96購01,2.27,2.27,2.27,2.27,-1.13,-33.24,10000,1,22700,0,0,0,0,0,0,0,10000,-10000,-10000
20200312,707337,網龍國票97購02,,,,,,0.00,0,0,0,0,0,0,0,0,0,0,0,0,0
20200312,707338,環球晶國票96購03,1.39,1.82,1.39,1.82,-0.45,-19.82,15000,2,25150,0,0,0,0,0,0,0,15000,-15000,-15000
20200312,707339,晟德國票97購01,0.82,0.82,0.76,0.76,-0.13,-14.61,60000,2,47400,0,0,0,0,0,0,0,60000,-60000,-60000
20200312,707340,神盾國泰97購01,0.42,0.42,0.42,0.42,-0.14,-25.0,98000,1,41160,0,0,0,0,0,0,0,98000,-98000,-98000
20200312,707341,博智國泰97購01,,,,,,0.00,0,0,0,0,0,0,0,0,0,0,0,0,0
20200312,707342,原相富邦99購01,2.34,2.34,1.91,1.91,-0.83,-30.29,83000,8,170350,0,0,0,0,0,0,33000,50000,-17000,-17000
20200312,707343,聯亞兆豐96購01,0.94,1.03,0.81,0.81,-0.59,-42.14,421000,8,389040,0,0,0,0,0,0,200000,221000,-21000,-21000
20200312,707344,杰力群益95購01,0.44,0.44,0.31,0.31,-0.28,-47.46,17000,4,6900,0,0,0,0,0,0,0,17000,-17000,-17000
20200312,707345,宣德群益96購01,1.21,1.21,0.87,0.87,-0.54,-38.3,21000,2,22010,0,0,0,0,0,0,21000,0,21000,21000
20200312,707346,皇田群益97購01,,,,,,0.00,0,0,0,0,0,0,0,0,0,0,0,0,0
20200312,707347,金居元大96購03,0.42,0.42,0.27,0.27,-0.16,-37.21,370000,10,126300,0,0,0,0,0,0,30000,340000,-310000,-310000
20200312,707348,保瑞元大96購01,0.49,0.50,0.42,0.46,-0.07,-13.21,534000,13,262670,0,0,0,0,0,0,161000,363000,-202000,-202000
20200312,707349,茂達元大96購01,0.49,0.49,0.39,0.39,-0.26,-40.0,75000,2,32750,0,0,0,0,0,0,35000,40000,-5000,-5000
20200312,707350,優群元大96購01,3.45,3.45,2.60,2.76,-1.08,-28.13,115000,11,318420,0,0,0,0,0,0,14000,102000,-88000,-88000
20200312,707351,環球晶元大96購01,1.32,1.32,1.01,1.02,-0.70,-40.7,37000,3,43630,0,0,0,0,0,0,20000,37000,-17000,-17000
20200312,707352,櫃200元大96購03,0.28,0.28,0.28,0.28,0.00,0.0,1000,1,280,0,0,0,0,0,0,0,0,0,0
20200312,707353,櫃200元大96購04,,,,,,0.00,0,0,0,0,0,0,0,0,0,0,0,0,0
20200312,707354,昇達科中信97購01,,,,,,0.00,0,0,0,0,0,0,0,0,0,0,0,0,0
20200312,707355,群聯凱基95購04,0.10,0.11,0.10,0.10,-0.09,-47.37,123000,9,12600,0,0,0,0,0,0,0,45000,-45000,-45000
20200312,707356,精華凱基95購01,,,,,,0.00,0,0,0,0,0,0,0,0,0,0,0,0,0
20200312,707357,大江國票97購02,,,,,,0.00,0,0,0,0,0,0,0,0,0,0,0,0,0
20200312,707358,昂寶永豐95購01,,,,,,0.00,0,0,0,0,0,0,0,0,0,0,0,0,0
20200312,707359,宣德永豐95購01,,,,,,0.00,0,0,0,0,0,0,0,0,0,0,0,0,0
20200312,707360,環球晶永豐95購03,0.50,0.51,0.41,0.51,-0.32,-38.55,132000,3,60840,0,0,0,0,0,0,64000,68000,-4000,-4000
20200312,707361,元太元大96購02,0.44,0.44,0.31,0.32,-0.17,-34.69,473000,19,179010,0,0,0,0,0,0,213000,260000,-47000,-47000
20200312,707362,兆利元大95購01,0.92,0.92,0.65,0.67,-0.63,-48.46,65000,3,45150,0,0,0,0,0,0,45000,20000,25000,25000
20200312,707363,合晶元大96購03,0.52,0.52,0.52,0.52,-0.20,-27.78,10000,1,5200,0,0,0,0,0,0,10000,0,10000,10000
20200312,707364,邦特元大95購01,0.16,0.18,0.16,0.18,-0.10,-35.71,80000,3,13400,0,0,0,0,0,0,80000,0,80000,80000
20200312,707365,群聯元大97購01,0.61,0.61,0.36,0.38,-0.46,-54.76,528000,45,243800,0,0,0,0,0,0,397000,326000,71000,71000
20200312,707366,廣明元大96購01,0.16,0.16,0.12,0.12,-0.09,-42.86,503000,4,78480,0,0,0,0,0,0,3000,500000,-497000,-497000
20200312,707367,環球晶元大95購12,1.96,1.96,1.81,1.81,-0.53,-22.65,22000,2,40120,0,0,0,0,0,0,22000,22000,0,0
20200312,707368,茂達永豐96購01,,,,,,0.00,0,0,0,0,0,0,0,0,0,0,0,0,0
20200312,707369,原相永豐95購03,0.81,0.84,0.57,0.58,-0.38,-39.58,598000,35,458580,0,0,0,0,0,0,249000,350000,-101000,-101000
20200312,707370,杰力國票96購02,,,,,,0.00,0,0,0,0,0,0,0,0,0,0,0,0,0
20200312,707371,大江富邦97購01,,,,,,0.00,0,0,0,0,0,0,0,0,0,0,0,0,0
20200312,707372,原相凱基96購01,0.86,0.86,0.53,0.58,-0.48,-45.28,244000,32,169150,0,0,0,0,0,0,115000,115000,0,0
20200312,707373,新普凱基95購01,,,,,,0.00,0,0,0,0,0,0,0,0,0,0,0,0,0
20200312,707374,緯軟凱基95購02,,,,,,0.00,0,0,0,0,0,0,0,0,0,0,0,0,0
20200312,707375,聯亞凱基95購01,0.12,0.12,0.11,0.11,-0.26,-70.27,85000,2,9550,0,0,0,0,0,0,65000,20000,45000,45000
20200312,707376,雙鴻凱基96購03,,,,,,0.00,0,0,0,0,0,0,0,0,0,0,0,0,0
20200312,707377,群聯麥證95購01,,,,,,0.00,0,0,0,0,0,0,0,0,0,0,0,0,0
20200312,707378,原相元富95購02,,,,,,0.00,0,0,0,0,0,0,0,0,0,0,0,0,0
20200312,707379,優群元富95購01,1.70,1.70,1.22,1.25,-0.66,-34.55,170000,15,235100,0,0,0,0,0,0,20000,150000,-130000,-130000
20200312,707380,環球晶元富95購06,0.95,0.95,0.95,0.95,-0.24,-20.17,10000,1,9500,0,0,0,0,0,0,10000,0,10000,10000
20200312,707381,兆利台新95購01,0.30,0.30,0.19,0.19,-0.22,-53.66,95000,4,22050,0,0,0,0,0,0,35000,60000,-25000,-25000
20200312,707382,僑威台新95購01,,,,,,0.00,0,0,0,0,0,0,0,0,0,0,0,0,0
20200312,707383,先豐元大95購01,0.34,0.34,0.10,0.31,-0.30,-49.18,132000,18,37710,0,0,0,0,0,0,15000,59000,-44000,-44000
20200312,707384,皇田元大95購02,,,,,,0.00,0,0,0,0,0,0,0,0,0,0,0,0,0
20200312,707385,晶焱元大96購01,1.74,1.74,1.70,1.70,-0.71,-29.46,2000,2,3440,0,0,0,0,0,0,0,2000,-2000,-2000
20200312,707386,僑威元大95購01,,,,,,0.00,0,0,0,0,0,0,0,0,0,0,0,0,0
20200312,707387,網龍元大95購02,,,,,,0.00,0,0,0,0,0,0,0,0,0,0,0,0,0
20200312,707388,鐿鈦元大95購01,0.35,0.35,0.27,0.27,-0.15,-35.71,41000,4,12300,0,15000,-15000,0,0,0,41000,0,41000,26000
20200312,707389,業強康和95購01,,,,,,0.00,0,0,0,0,0,0,0,0,0,0,0,0,0
20200312,707390,環球晶元富95購07,1.01,1.07,0.74,0.83,-0.49,-37.12,43000,5,38730,0,0,0,0,0,0,13000,33000,-20000,-20000
20200312,707391,順達台新95購01,0.70,0.70,0.70,0.70,-0.20,-22.22,70000,1,49000,0,0,0,0,0,0,70000,0,70000,70000
20200312,707392,大江凱基95購01,,,,,,0.00,0,0,0,0,0,0,0,0,0,0,0,0,0
20200312,707393,同致凱基95購01,,,,,,0.00,0,0,0,0,0,0,0,0,0,0,0,0,0
20200312,707394,聯亞凱基95購02,,,,,,0.00,0,0,0,0,0,0,0,0,0,0,0,0,0
20200312,707395,大宇資群益97購01,0.20,0.20,0.20,0.20,-0.14,-41.18,13000,2,2600,0,0,0,0,0,0,8000,5000,3000,3000
20200312,707396,亞泰群益95購01,0.54,0.54,0.48,0.48,-0.28,-36.84,30000,3,15000,0,0,0,0,0,0,0,30000,-30000,-30000
20200312,707397,聯亞群益95購01,1.21,1.21,0.86,0.87,-0.76,-46.63,127000,13,124520,0,0,0,0,0,0,40000,97000,-57000,-57000
20200312,707398,亞泰元大95購01,0.47,0.47,0.47,0.47,-0.15,-24.19,35000,2,16450,0,0,0,0,0,0,35000,0,35000,35000
20200312,707399,信驊元大95購02,2.46,2.46,2.46,2.46,-1.29,-34.4,50000,1,123000,0,0,0,0,0,0,0,50000,-50000,-50000
20200312,707400,威剛元大96購02,1.65,1.65,1.27,1.34,-0.88,-39.64,314000,14,436050,0,0,0,0,0,0,58000,313000,-255000,-255000
20200312,707401,聯亞元大95購04,1.23,1.23,0.88,0.88,-0.85,-49.13,208000,5,209300,0,0,0,0,0,0,29000,193000,-164000,-164000
20200312,707402,大宇資永豐96購01,,,,,,0.00,0,0,0,0,0,0,0,0,0,0,0,0,0
20200312,707403,旺矽永豐96購01,0.59,0.61,0.59,0.61,-0.21,-25.61,368000,2,217360,0,0,0,0,0,0,356000,12000,344000,344000
20200312,707404,信驊永豐95購02,0.68,0.68,0.60,0.66,-0.26,-28.26,87000,5,55160,0,0,0,0,0,0,52000,35000,17000,17000
20200312,707405,優群永豐96購01,1.52,1.52,1.19,1.19,-0.22,-15.6,53000,5,68110,0,0,0,0,0,0,53000,0,53000,53000
20200312,707406,M31國票96購01,0.12,0.12,0.12,0.12,-0.15,-55.56,62000,1,7440,0,0,0,0,0,0,62000,0,62000,62000
20200312,707407,中美晶國票96購03,2.06,2.09,2.03,2.09,-0.73,-25.89,38000,4,78220,0,0,0,0,0,0,0,38000,-38000,-38000
20200312,707408,兆利國票96購01,,,,,,0.00,0,0,0,0,0,0,0,0,0,0,0,0,0
20200312,707409,環球晶國票95購03,1.07,1.12,0.66,1.05,-0.30,-22.22,631000,17,548200,0,0,0,0,0,0,368000,263000,105000,105000
20200312,707410,雙美國票96購01,,,,,,0.00,0,0,0,0,0,0,0,0,0,0,0,0,0
20200312,707411,金居富邦95購02,0.20,0.20,0.13,0.13,-0.09,-40.91,50000,3,7900,0,0,0,0,0,0,0,50000,-50000,-50000
20200312,707412,櫃200富邦95購01,,,,,,0.00,0,0,0,0,0,0,0,0,0,0,0,0,0
20200312,707413,櫃200富邦95購02,,,,,,0.00,0,0,0,0,0,0,0,0,0,0,0,0,0
20200312,707414,櫃200富邦95購03,,,,,,0.00,0,0,0,0,0,0,0,0,0,0,0,0,0
20200312,707415,櫃200T永昌96購01,,,,,,0.00,0,0,0,0,0,0,0,0,0,0,0,0,0
20200312,707416,櫃200T永昌96購02,,,,,,0.00,0,0,0,0,0,0,0,0,0,0,0,0,0
20200312,707417,櫃200T永昌96購03,,,,,,0.00,0,0,0,0,0,0,0,0,0,0,0,0,0
20200312,707418,櫃200T永昌96購04,,,,,,0.00,0,0,0,0,0,0,0,0,0,0,0,0,0
20200312,707419,台燿凱基95購01,,,,,,0.00,0,0,0,0,0,0,0,0,0,0,0,0,0
20200312,707420,信驊凱基95購02,0.50,0.50,0.43,0.43,-0.31,-41.89,79000,4,38750,0,0,0,0,0,0,54000,25000,29000,29000
20200312,707421,緯軟凱基96購01,,,,,,0.00,0,0,0,0,0,0,0,0,0,0,0,0,0
20200312,707422,櫃200凱基99購01,,,,,,0.00,0,0,0,0,0,0,0,0,0,0,0,0,0
20200312,707423,三貝德國票96購02,,,,,,0.00,0,0,0,0,0,0,0,0,0,0,0,0,0
20200312,707424,大學光國票96購02,,,,,,0.00,0,0,0,0,0,0,0,0,0,0,0,0,0
20200312,707425,台燿國票96購01,0.42,0.42,0.36,0.40,-0.34,-45.95,223000,4,89000,0,0,0,0,0,0,200000,23000,177000,177000
20200312,707426,穩懋國票96購03,0.22,0.22,0.12,0.12,-0.20,-62.5,460000,5,79600,0,0,0,0,0,0,90000,370000,-280000,-280000
20200312,707427,新普國泰96購01,0.82,0.93,0.82,0.93,-0.19,-16.96,20000,2,17500,0,0,0,0,0,0,0,20000,-20000,-20000
20200312,707428,譜瑞國泰97購01,1.90,1.90,1.27,1.35,-0.67,-33.17,857000,34,1518820,0,0,0,0,0,0,163000,731000,-568000,-568000
20200312,707429,信驊元富95購01,,,,,,0.00,0,0,0,0,0,0,0,0,0,0,0,0,0
20200312,707430,信驊元富95購02,1.70,1.73,1.32,1.32,-0.49,-27.07,516000,55,752230,0,0,0,0,0,0,15000,501000,-486000,-486000
20200312,707431,雙鴻元富95購01,0.08,0.08,0.06,0.07,-0.09,-56.25,540000,4,33800,0,0,0,0,0,0,420000,120000,300000,300000
20200312,707432,雙鴻台新96購01,,,,,,0.00,0,0,0,0,0,0,0,0,0,0,0,0,0
20200312,707433,新普元大95購02,,,,,,0.00,0,0,0,0,0,0,0,0,0,0,0,0,0
20200312,707434,環球晶元大96購02,2.38,2.44,1.93,2.32,-0.41,-15.02,174000,14,398890,0,0,0,0,0,0,112000,91000,21000,21000
20200312,707435,雙鴻元大95購02,,,,,,0.00,0,0,0,0,0,0,0,0,0,0,0,0,0
20200312,707436,譜瑞元大95購04,1.38,1.50,0.80,1.00,-0.53,-34.64,230000,20,218940,0,0,0,0,0,0,115000,109000,6000,6000
20200312,707437,群聯兆豐96購01,1.06,1.06,0.72,0.73,-0.57,-43.85,338000,11,280550,0,0,0,0,0,0,134000,337000,-203000,-203000
20200312,707438,環球晶兆豐95購05,1.09,1.09,0.79,0.79,-0.64,-44.76,31000,4,29440,0,0,0,0,0,0,10000,21000,-11000,-11000
20200312,707439,台燿群益95購01,0.69,0.69,0.63,0.67,-0.22,-24.72,40000,3,26800,0,0,0,0,0,0,20000,20000,0,0
20200312,707440,昇達科群益97購01,0.34,0.34,0.34,0.34,-0.12,-26.09,450000,1,153000,0,450000,-450000,0,0,0,450000,0,450000,0
20200312,707441,晶焱群益96購01,0.60,0.60,0.60,0.60,-0.34,-36.17,11000,1,6600,0,0,0,0,0,0,11000,0,11000,11000
20200312,707442,櫃200富邦9A購01,0.51,0.51,0.51,0.51,-0.14,-21.54,3000,3,1530,0,0,0,0,0,0,0,3000,-3000,-3000
20200312,707443,櫃200富邦9A購02,,,,,,0.00,0,0,0,0,0,0,0,0,0,0,0,0,0
20200312,707444,雙鴻富邦96購02,0.07,0.07,0.07,0.07,-0.03,-30.0,147000,1,10290,0,0,0,0,0,0,147000,0,147000,147000
20200312,707445,雙鴻第一95購01,,,,,,0.00,0,0,0,0,0,0,0,0,0,0,0,0,0
20200312,707446,大江永豐95購02,,,,,,0.00,0,0,0,0,0,0,0,0,0,0,0,0,0
20200312,707447,宜鼎永豐95購01,0.52,0.54,0.48,0.52,-0.22,-29.73,153000,9,75850,0,0,0,0,0,0,15000,138000,-123000,-123000
20200312,707448,保瑞永豐95購02,0.81,0.84,0.74,0.74,-0.31,-29.52,417000,15,341500,0,0,0,0,0,0,318000,99000,219000,219000
20200312,707449,群聯永豐95購01,0.89,0.90,0.68,0.68,-0.48,-41.38,107000,5,81970,0,0,0,0,0,0,0,107000,-107000,-107000
20200312,707450,大江中信96購01,,,,,,0.00,0,0,0,0,0,0,0,0,0,0,0,0,0
20200312,707451,大江台新95購01,,,,,,0.00,0,0,0,0,0,0,0,0,0,0,0,0,0
20200312,707452,兆利元大96購01,0.43,0.43,0.30,0.33,-0.16,-32.65,244000,10,82080,0,0,0,0,0,0,174000,118000,56000,56000
20200312,707453,迅得元大95購02,0.08,0.08,0.08,0.08,-0.12,-60.0,4000,1,320,0,0,0,0,0,0,0,4000,-4000,-4000
20200312,707454,博智元大95購03,,,,,,0.00,0,0,0,0,0,0,0,0,0,0,0,0,0
20200312,707455,神盾康和95購01,,,,,,0.00,0,0,0,0,0,0,0,0,0,0,0,0,0
20200312,707456,勝麗群益95購02,0.51,0.51,0.34,0.34,-0.44,-56.41,103000,5,50130,0,0,0,0,0,0,77000,26000,51000,51000
20200312,707457,緯軟群益96購01,0.17,0.18,0.17,0.18,-0.11,-37.93,120000,2,21300,0,0,0,0,0,0,90000,30000,60000,60000
20200312,707458,金居統一95購01,0.58,0.58,0.35,0.38,-0.29,-43.28,65000,7,26200,0,0,0,0,0,0,20000,45000,-25000,-25000
20200312,707459,迅得凱基98購01,,,,,,0.00,0,0,0,0,0,0,0,0,0,0,0,0,0
20200312,707460,邦特凱基95購01,,,,,,0.00,0,0,0,0,0,0,0,0,0,0,0,0,0
20200312,707461,信昌電凱基97購01,0.68,0.69,0.68,0.69,-0.40,-36.7,15000,2,10300,0,0,0,0,0,0,5000,10000,-5000,-5000
20200312,707462,茂達凱基9B購01,0.77,0.77,0.77,0.77,-0.19,-19.79,40000,2,30800,0,0,0,0,0,0,40000,0,40000,40000
20200312,707463,神盾凱基9B購01,0.80,0.80,0.80,0.80,-0.23,-22.33,1000,1,800,0,0,0,0,0,0,0,1000,-1000,-1000
20200312,707464,勝麗凱基97購01,0.44,0.44,0.44,0.44,-0.11,-20.0,8000,1,3520,0,0,0,0,0,0,0,8000,-8000,-8000
20200312,707465,閎康凱基97購01,0.37,0.37,0.29,0.29,-0.19,-39.58,15000,2,4990,0,0,0,0,0,0,0,15000,-15000,-15000
20200312,707466,環宇凱基97購01,0.33,0.33,0.25,0.25,-0.20,-44.44,115000,3,31750,0,0,0,0,0,0,105000,10000,95000,95000
20200312,707467,環球晶凱基96購01,1.72,1.95,1.01,1.78,-0.05,-2.73,56000,15,89670,0,0,0,0,0,0,32000,50000,-18000,-18000
20200312,707468,穩懋凱基96購03,0.10,0.10,0.10,0.10,-0.06,-37.5,450000,45,45000,0,0,0,0,0,0,0,450000,-450000,-450000
20200312,707469,鈺太凱基97購01,0.56,0.56,0.46,0.46,-0.34,-42.5,80000,2,41800,0,0,0,0,0,0,50000,30000,20000,20000
20200312,707470,鐿鈦凱基96購01,,,,,,0.00,0,0,0,0,0,0,0,0,0,0,0,0,0
20200312,707471,信昌電國票96購02,1.08,1.08,0.77,0.77,-0.71,-47.97,204000,2,219080,0,0,0,0,0,0,204000,204000,0,0
20200312,707472,晶焱國票96購02,0.87,0.87,0.76,0.79,-0.20,-20.2,236000,5,203100,0,0,0,0,0,0,228000,8000,220000,220000
20200312,707473,群聯國票96購02,2.04,2.04,1.32,1.42,-2.28,-61.62,190000,9,305400,0,0,0,0,0,0,60000,135000,-75000,-75000
20200312,707474,穩懋富邦97購01,0.49,0.49,0.21,0.21,-0.17,-44.74,1313000,40,318370,0,0,0,0,0,0,412000,750000,-338000,-338000
20200312,707475,光洋科永豐95購01,0.49,0.49,0.36,0.36,-0.27,-42.86,130000,9,51010,0,0,0,0,0,0,14000,113000,-99000,-99000
20200312,707476,穩懋永豐95購03,0.04,0.04,0.04,0.04,-0.03,-42.86,341000,1,13640,0,0,0,0,0,0,341000,0,341000,341000
20200312,707477,網龍中信95購01,,,,,,0.00,0,0,0,0,0,0,0,0,0,0,0,0,0
20200312,707478,中美晶凱基95購03,,,,,,0.00,0,0,0,0,0,0,0,0,0,0,0,0,0
20200312,707479,晶焱凱基96購01,0.62,0.62,0.62,0.62,-0.19,-23.46,20000,1,12400,0,0,0,0,0,0,0,20000,-20000,-20000
20200312,707480,環球晶凱基97購01,0.81,0.94,0.59,0.85,-0.12,-12.37,102000,14,75300,0,0,0,0,0,0,55000,47000,8000,8000
20200312,707481,三貝德永豐95購01,,,,,,0.00,0,0,0,0,0,0,0,0,0,0,0,0,0
20200312,707482,神盾永豐95購02,,,,,,0.00,0,0,0,0,0,0,0,0,0,0,0,0,0
20200312,707483,環球晶永豐95購04,1.43,1.47,1.06,1.06,-0.64,-37.65,78000,11,101590,0,0,0,0,0,0,33000,58000,-25000,-25000
20200312,707484,大江元大96購05,0.09,0.09,0.06,0.06,-0.04,-40.0,544000,3,38530,0,0,0,0,0,0,499000,45000,454000,454000
20200312,707485,同致元大97購01,,,,,,0.00,0,0,0,0,0,0,0,0,0,0,0,0,0
20200312,707486,昂寶元大95購01,,,,,,0.00,0,0,0,0,0,0,0,0,0,0,0,0,0
20200312,707487,迅得國票96購01,,,,,,0.00,0,0,0,0,0,0,0,0,0,0,0,0,0
20200312,707488,宜鼎國票96購02,1.78,1.78,1.66,1.66,-1.61,-49.24,20000,2,34400,0,0,0,0,0,0,0,20000,-20000,-20000
20200312,707489,美琪瑪國票96購01,0.09,0.09,0.06,0.06,-0.08,-57.14,780000,8,55800,0,0,0,0,0,0,0,780000,-780000,-780000
20200312,707490,智崴國泰96購01,0.18,0.18,0.18,0.18,-0.08,-30.77,10000,1,1800,0,0,0,0,0,0,0,10000,-10000,-10000
20200312,707491,櫃200T永昌9C購01,,,,,,0.00,0,0,0,0,0,0,0,0,0,0,0,0,0
20200312,707492,櫃200T永昌9C購02,,,,,,0.00,0,0,0,0,0,0,0,0,0,0,0,0,0
20200312,707493,櫃200T永昌9C購03,,,,,,0.00,0,0,0,0,0,0,0,0,0,0,0,0,0
20200312,707494,櫃200T永昌9C購04,,,,,,0.00,0,0,0,0,0,0,0,0,0,0,0,0,0
20200312,707495,穩懋康和95購02,,,,,,0.00,0,0,0,0,0,0,0,0,0,0,0,0,0
20200312,707496,精華群益95購03,,,,,,0.00,0,0,0,0,0,0,0,0,0,0,0,0,0
20200312,707497,宜鼎元大95購02,0.81,0.81,0.74,0.74,-0.65,-46.76,120000,3,96000,0,0,0,0,0,0,0,120000,-120000,-120000
20200312,707498,旺矽元大96購01,,,,,,0.00,0,0,0,0,0,0,0,0,0,0,0,0,0
20200312,707499,精華元大95購03,,,,,,0.00,0,0,0,0,0,0,0,0,0,0,0,0,0
20200312,707500,智崴國票96購01,0.12,0.12,0.11,0.11,-0.06,-35.29,699000,4,82380,0,0,0,0,0,0,200000,499000,-299000,-299000
20200312,707501,閎康國票97購01,0.64,0.64,0.60,0.62,-0.13,-17.33,450000,41,279600,0,450000,-450000,0,0,0,450000,0,450000,0
20200312,707502,金可國泰97購01,0.13,0.13,0.10,0.12,-0.07,-36.84,159000,6,18290,0,0,0,0,0,0,79000,80000,-1000,-1000
20200312,707503,精華國泰97購01,,,,,,0.00,0,0,0,0,0,0,0,0,0,0,0,0,0
20200312,707504,環球晶國泰96購03,2.07,2.23,1.63,2.23,-0.13,-5.51,81000,11,157420,0,0,0,0,0,0,36000,81000,-45000,-45000
20200312,707505,穩懋國泰96購02,0.40,0.40,0.40,0.40,-0.25,-38.46,50000,1,20000,0,0,0,0,0,0,50000,50000,0,0
20200312,707506,穩懋統一96購05,0.59,0.59,0.47,0.47,-0.45,-48.91,165000,13,87190,0,0,0,0,0,0,105000,60000,45000,45000
20200312,707507,三貝德凱基96購02,,,,,,0.00,0,0,0,0,0,0,0,0,0,0,0,0,0
20200312,707508,中美晶凱基95購04,,,,,,0.00,0,0,0,0,0,0,0,0,0,0,0,0,0
20200312,707509,元太凱基96購01,,,,,,0.00,0,0,0,0,0,0,0,0,0,0,0,0,0
20200312,707510,昂寶凱基96購01,,,,,,0.00,0,0,0,0,0,0,0,0,0,0,0,0,0
20200312,707511,建榮凱基97購01,,,,,,0.00,0,0,0,0,0,0,0,0,0,0,0,0,0
20200312,707512,穩懋凱基96購04,,,,,,0.00,0,0,0,0,0,0,0,0,0,0,0,0,0
20200312,707513,元太第一95購01,,,,,,0.00,0,0,0,0,0,0,0,0,0,0,0,0,0
20200312,707514,晶焱永豐95購02,,,,,,0.00,0,0,0,0,0,0,0,0,0,0,0,0,0
20200312,707515,精華永豐95購02,,,,,,0.00,0,0,0,0,0,0,0,0,0,0,0,0,0
20200312,707516,聚積永豐95購01,,,,,,0.00,0,0,0,0,0,0,0,0,0,0,0,0,0
20200312,707517,穩懋兆豐96購02,,,,,,0.00,0,0,0,0,0,0,0,0,0,0,0,0,0
20200312,707518,金可康和95購01,,,,,,0.00,0,0,0,0,0,0,0,0,0,0,0,0,0
20200312,707519,金可群益95購01,,,,,,0.00,0,0,0,0,0,0,0,0,0,0,0,0,0
20200312,707520,優群群益97購01,1.78,1.80,1.56,1.56,-0.76,-32.76,271000,3,435640,0,0,0,0,0,0,271000,0,271000,271000
20200312,707521,環球晶群益95購04,2.39,2.50,1.91,2.50,-0.19,-7.06,129000,12,287480,0,0,0,0,0,0,70000,89000,-19000,-19000
20200312,707522,聯亞群益95購02,1.23,1.40,1.09,1.09,-0.78,-41.71,100000,10,120440,0,0,0,0,0,0,52000,58000,-6000,-6000
20200312,707523,群聯元富95購02,,,,,,0.00,0,0,0,0,0,0,0,0,0,0,0,0,0
20200312,707524,鈺太兆豐95購01,0.48,0.48,0.48,0.48,-0.16,-25.0,10000,1,4800,0,0,0,0,0,0,10000,0,10000,10000
20200312,707525,泰博中信97購01,1.02,1.04,0.72,0.85,-0.27,-24.11,617000,51,513090,0,0,0,0,0,0,376000,231000,145000,145000
20200312,707526,建榮凱基96購01,,,,,,0.00,0,0,0,0,0,0,0,0,0,0,0,0,0
20200312,707527,新普凱基95購02,0.21,0.25,0.21,0.25,-0.05,-16.67,60000,2,14600,0,0,0,0,0,0,10000,50000,-40000,-40000
20200312,707528,精華凱基96購01,,,,,,0.00,0,0,0,0,0,0,0,0,0,0,0,0,0
20200312,707529,精華統一97購01,,,,,,0.00,0,0,0,0,0,0,0,0,0,0,0,0,0
20200312,707530,精華統一97購02,0.13,0.13,0.09,0.09,-0.07,-43.75,180000,8,18400,0,0,0,0,0,0,20000,160000,-140000,-140000
20200312,707531,神盾國票97購01,0.27,0.27,0.24,0.24,-0.07,-22.58,96000,2,23820,0,0,0,0,0,0,96000,0,96000,96000
20200312,707532,群聯國票96購03,1.66,1.78,1.14,1.22,-1.62,-57.04,280000,13,363170,0,0,0,0,0,0,2000,278000,-276000,-276000
20200312,707533,緯軟國票97購02,,,,,,0.00,0,0,0,0,0,0,0,0,0,0,0,0,0
20200312,707534,碩禾元大98購01,0.88,0.88,0.70,0.70,-0.23,-24.73,153000,8,123920,0,0,0,0,0,0,42000,126000,-84000,-84000
20200312,707535,精華元大96購01,0.12,0.13,0.10,0.10,-0.09,-47.37,128000,4,16120,0,0,0,0,0,0,23000,112000,-89000,-89000
20200312,707536,穩懋元大95購12,0.33,0.33,0.26,0.26,-0.29,-52.73,25000,2,7200,0,0,0,0,0,0,25000,0,25000,25000
20200312,707537,穩懋元大95購13,0.55,0.55,0.26,0.27,-0.28,-50.91,244000,11,87280,0,0,0,0,0,0,134000,95000,39000,39000
20200312,707538,世界永豐95購01,0.33,0.33,0.33,0.33,-0.08,-19.51,95000,1,31350,0,0,0,0,0,0,95000,0,95000,95000
20200312,707539,合晶永豐95購03,,,,,,0.00,0,0,0,0,0,0,0,0,0,0,0,0,0
20200312,707540,宇峻永豐95購02,0.40,0.40,0.24,0.24,-0.18,-42.86,40000,4,12300,0,0,0,0,0,0,0,40000,-40000,-40000
20200312,707541,佳邦永豐95購01,,,,,,0.00,0,0,0,0,0,0,0,0,0,0,0,0,0
20200312,707542,金居永豐95購01,0.27,0.27,0.27,0.27,-0.21,-43.75,4000,1,1080,0,0,0,0,0,0,4000,0,4000,4000
20200312,707543,泰博永豐95購01,0.99,0.99,0.73,0.79,-0.33,-29.46,188000,8,146880,0,0,0,0,0,0,58000,130000,-72000,-72000
20200312,707544,勝麗永豐95購02,,,,,,0.00,0,0,0,0,0,0,0,0,0,0,0,0,0
20200312,707545,晟德永豐95購02,,,,,,0.00,0,0,0,0,0,0,0,0,0,0,0,0,0
20200312,707546,台半亞東96購01,,,,,,0.00,0,0,0,0,0,0,0,0,0,0,0,0,0
20200312,707547,世界中信96購01,0.77,0.83,0.74,0.83,-0.01,-1.19,50000,3,40000,0,0,0,0,0,0,10000,40000,-30000,-30000
20200312,707548,精測中信95購01,0.09,0.09,0.05,0.05,-0.09,-64.29,610000,5,38800,0,0,0,0,0,0,100000,510000,-410000,-410000
20200312,707549,精測凱基96購01,0.40,0.40,0.29,0.29,-0.18,-38.3,90000,7,31550,0,0,0,0,0,0,40000,50000,-10000,-10000
20200312,707550,聯亞凱基95購03,0.37,0.37,0.37,0.37,-0.52,-58.43,20000,1,7400,0,0,0,0,0,0,20000,0,20000,20000
20200312,707551,穩懋凱基95購03,,,,,,0.00,0,0,0,0,0,0,0,0,0,0,0,0,0
20200312,707552,精測統一96購01,,,,,,0.00,0,0,0,0,0,0,0,0,0,0,0,0,0
20200312,707553,安勤永豐95購01,,,,,,0.00,0,0,0,0,0,0,0,0,0,0,0,0,0
20200312,707554,金可永豐95購02,,,,,,0.00,0,0,0,0,0,0,0,0,0,0,0,0,0
20200312,707555,宣德永豐95購03,1.00,1.00,1.00,1.00,-0.23,-18.7,45000,1,45000,0,0,0,0,0,0,45000,0,45000,45000
20200312,707556,精測永豐96購01,,,,,,0.00,0,0,0,0,0,0,0,0,0,0,0,0,0
20200312,707557,廣明永豐95購02,,,,,,0.00,0,0,0,0,0,0,0,0,0,0,0,0,0
20200312,707558,台燿亞東95購01,0.22,0.22,0.22,0.22,-0.18,-45.0,15000,1,3300,0,0,0,0,0,0,0,15000,-15000,-15000
20200312,707559,信昌電亞東95購01,,,,,,0.00,0,0,0,0,0,0,0,0,0,0,0,0,0
20200312,707560,精測元富95購01,0.13,0.14,0.07,0.07,-0.13,-65.0,485000,10,50950,0,0,0,0,0,0,380000,100000,280000,280000
20200312,707561,M31國票96購02,0.11,0.11,0.11,0.11,-0.09,-45.0,300000,1,33000,0,0,0,0,0,0,0,300000,-300000,-300000
20200312,707562,由田國票97購01,,,,,,0.00,0,0,0,0,0,0,0,0,0,0,0,0,0
20200312,707563,宇峻國票96購01,0.92,1.03,0.48,0.60,-0.29,-32.58,470000,15,305800,0,0,0,0,0,0,130000,337000,-207000,-207000
20200312,707564,環球晶國票96購04,2.30,2.30,1.51,1.51,-0.79,-34.35,88000,16,164100,0,0,0,0,0,0,28000,50000,-22000,-22000
20200312,707565,精測國泰95購01,0.23,0.24,0.12,0.15,-0.10,-40.0,436000,10,74470,0,0,0,0,0,0,78000,366000,-288000,-288000
20200312,707566,大江元大96購06,,,,,,0.00,0,0,0,0,0,0,0,0,0,0,0,0,0
20200312,707567,合晶元大96購04,0.72,0.72,0.49,0.52,-0.23,-30.67,235000,12,137650,0,0,0,0,0,0,155000,95000,60000,60000
20200312,707568,勝麗元大95購03,0.49,0.49,0.49,0.49,-0.51,-51.0,118000,1,57820,0,0,0,0,0,0,118000,0,118000,118000
20200312,707569,群聯元大95購07,1.63,1.63,0.85,0.85,-2.09,-71.09,144000,18,167290,0,0,0,0,0,0,114000,144000,-30000,-30000
20200312,707570,精測元大95購02,0.33,0.33,0.24,0.24,-0.18,-42.86,78000,2,21240,0,0,0,0,0,0,78000,0,78000,78000
20200312,707571,優群元大97購01,1.16,1.16,0.91,0.96,-0.38,-28.36,163000,12,169900,0,0,0,0,0,0,68000,95000,-27000,-27000
20200312,707572,穩懋元大95購14,,,,,,0.00,0,0,0,0,0,0,0,0,0,0,0,0,0
20200312,707573,穩懋元大96購02,0.28,0.28,0.20,0.21,-0.19,-47.5,330000,16,72900,0,0,0,0,0,0,140000,180000,-40000,-40000
20200312,707574,大江富邦97購03,0.17,0.17,0.10,0.11,-0.07,-38.89,350000,14,41380,0,0,0,0,0,0,57000,293000,-236000,-236000
20200312,707575,雙鴻康和95購02,,,,,,0.00,0,0,0,0,0,0,0,0,0,0,0,0,0
20200312,707576,元太群益95購02,0.30,0.30,0.30,0.30,-0.11,-26.83,109000,2,32700,0,0,0,0,0,0,109000,0,109000,109000
20200312,707577,神盾群益97購01,0.27,0.27,0.27,0.27,-0.06,-18.18,265000,1,71550,0,0,0,0,0,0,265000,0,265000,265000
20200312,707578,精測群益95購01,0.19,0.19,0.19,0.19,-0.18,-48.65,4000,1,760,0,0,0,0,0,0,4000,0,4000,4000
20200312,707579,聯亞群益95購03,0.36,0.36,0.31,0.31,-0.46,-59.74,91000,2,30760,0,0,0,0,0,0,91000,0,91000,91000
20200312,707580,雙鴻群益96購03,,,,,,0.00,0,0,0,0,0,0,0,0,0,0,0,0,0
20200312,707581,世界元大96購01,1.27,1.62,1.26,1.53,+0.10,6.99,520000,13,697840,0,0,0,0,0,0,79000,452000,-373000,-373000
20200312,707582,金可元大96購01,0.06,0.06,0.03,0.05,-0.04,-44.44,320000,9,14620,0,0,0,0,0,0,110000,160000,-50000,-50000
20200312,707583,順達元大96購01,1.25,1.28,1.15,1.15,-0.32,-21.77,111000,7,136180,0,0,0,0,0,0,96000,58000,38000,38000
20200312,707584,精測元大97購01,0.53,0.53,0.37,0.37,-0.35,-48.61,23000,4,8670,0,0,0,0,0,0,13000,10000,3000,3000
20200312,707585,精華元大96購02,,,,,,0.00,0,0,0,0,0,0,0,0,0,0,0,0,0
20200312,707586,新鉅科元富96購02,,,,,,0.00,0,0,0,0,0,0,0,0,0,0,0,0,0
20200312,707587,精測元富96購01,0.17,0.19,0.08,0.09,-0.17,-65.38,822000,16,98180,0,0,0,0,0,0,260000,562000,-302000,-302000
20200312,707588,廣明元富96購01,,,,,,0.00,0,0,0,0,0,0,0,0,0,0,0,0,0
20200312,707589,宣德統一96購01,0.91,0.94,0.73,0.74,-0.45,-37.82,94000,6,71610,0,0,0,0,0,0,74000,20000,54000,54000
20200312,707590,群聯統一96購03,0.70,0.70,0.70,0.70,-0.32,-31.37,20000,1,14000,0,0,0,0,0,0,0,20000,-20000,-20000
20200312,707591,精測統一97購01,,,,,,0.00,0,0,0,0,0,0,0,0,0,0,0,0,0
20200312,707592,穩懋統一97購01,0.58,0.58,0.55,0.55,-0.37,-40.22,96000,2,54240,0,0,0,0,0,0,48000,48000,0,0
20200312,707593,穩懋統一98購01,0.65,0.65,0.47,0.47,-0.53,-53.0,50000,3,32180,0,0,0,0,0,0,48000,2000,46000,46000
20200312,707594,昂寶凱基98購01,,,,,,0.00,0,0,0,0,0,0,0,0,0,0,0,0,0
20200312,707595,精測凱基97購01,,,,,,0.00,0,0,0,0,0,0,0,0,0,0,0,0,0
20200312,707596,精測凱基97購02,,,,,,0.00,0,0,0,0,0,0,0,0,0,0,0,0,0
20200312,707597,雙鴻凱基96購04,,,,,,0.00,0,0,0,0,0,0,0,0,0,0,0,0,0
20200312,707598,穩懋凱基96購05,,,,,,0.00,0,0,0,0,0,0,0,0,0,0,0,0,0
20200312,707599,大江永豐96購01,0.01,0.01,0.01,0.01,0.00,0.0,19000,19,190,0,0,0,0,0,0,0,1000,-1000,-1000
20200312,707600,中美晶永豐96購01,1.80,1.80,1.48,1.48,-0.94,-38.84,12000,2,18400,0,0,0,0,0,0,12000,2000,10000,10000
20200312,707601,精測永豐96購02,0.50,0.51,0.32,0.32,-0.26,-44.83,166000,13,73630,0,0,0,0,0,0,93000,73000,20000,20000
20200312,707602,精測永豐97購01,,,,,,0.00,0,0,0,0,0,0,0,0,0,0,0,0,0
20200312,707603,邦特國票97購01,0.34,0.34,0.28,0.28,-0.18,-39.13,92000,5,30550,0,0,0,0,0,0,74000,18000,56000,56000
20200312,707604,金可國票97購01,0.03,0.03,0.01,0.02,-0.02,-50.0,270000,3,6200,0,0,0,0,0,0,0,250000,-250000,-250000
20200312,707605,群聯富邦97購01,0.29,0.31,0.19,0.22,-0.25,-53.19,187000,8,50560,0,0,0,0,0,0,182000,127000,55000,55000
20200312,707606,精測富邦96購01,0.10,0.10,0.09,0.09,-0.06,-40.0,20000,2,1900,0,0,0,0,0,0,0,20000,-20000,-20000
20200312,707607,精測兆豐97購01,0.78,0.78,0.55,0.55,-0.30,-35.29,25000,2,17200,0,0,0,0,0,0,25000,0,25000,25000
20200312,707608,東洋群益96購01,0.16,0.16,0.08,0.08,-0.17,-68.0,75000,2,11200,0,0,0,0,0,0,65000,10000,55000,55000
20200312,707609,金居群益98購01,,,,,,0.00,0,0,0,0,0,0,0,0,0,0,0,0,0
20200312,707610,保瑞群益98購01,0.60,0.63,0.53,0.55,-0.25,-31.25,1588000,17,848040,0,0,0,0,0,0,1578000,10000,1568000,1568000
20200312,707611,新鉅科群益96購01,0.05,0.05,0.05,0.05,-0.05,-50.0,80000,3,4000,0,0,0,0,0,0,0,80000,-80000,-80000
20200312,707612,精測群益96購01,,,,,,0.00,0,0,0,0,0,0,0,0,0,0,0,0,0
20200312,707613,鈊象台新97購01,,,,,,0.00,0,0,0,0,0,0,0,0,0,0,0,0,0
20200312,707614,精測中信96購02,,,,,,0.00,0,0,0,0,0,0,0,0,0,0,0,0,0
20200312,707615,鈊象中信96購01,2.70,2.70,2.20,2.20,-0.76,-25.68,29000,6,73750,0,0,0,0,0,0,10000,19000,-9000,-9000
20200312,707616,M31凱基97購01,,,,,,0.00,0,0,0,0,0,0,0,0,0,0,0,0,0
20200312,707617,宣德凱基96購01,,,,,,0.00,0,0,0,0,0,0,0,0,0,0,0,0,0
20200312,707618,精測凱基97購03,,,,,,0.00,0,0,0,0,0,0,0,0,0,0,0,0,0
20200312,707619,璟德凱基96購01,0.57,0.57,0.42,0.46,-0.27,-36.99,205000,7,106800,0,0,0,0,0,0,0,205000,-205000,-205000
20200312,707620,鐿鈦凱基96購02,,,,,,0.00,0,0,0,0,0,0,0,0,0,0,0,0,0
20200312,707621,精測統一97購02,0.44,0.44,0.31,0.33,-0.14,-29.79,339000,4,115330,0,0,0,0,0,0,217000,122000,95000,95000
20200312,707622,鈊象統一96購01,4.92,4.92,4.92,4.92,-1.73,-26.02,3000,2,14760,0,0,0,0,0,0,3000,3000,0,0
20200312,707623,勝麗兆豐96購01,,,,,,0.00,0,0,0,0,0,0,0,0,0,0,0,0,0
20200312,707624,精測康和96購02,,,,,,0.00,0,0,0,0,0,0,0,0,0,0,0,0,0
20200312,707625,鈊象康和96購01,3.15,3.15,2.33,2.33,-1.17,-33.43,18000,3,48300,0,0,0,0,0,0,10000,8000,2000,2000
20200312,707626,環球晶永昌99購01,,,,,,0.00,0,0,0,0,0,0,0,0,0,0,0,0,0
20200312,707627,迅得永豐97購01,,,,,,0.00,0,0,0,0,0,0,0,0,0,0,0,0,0
20200312,707628,旺矽永豐97購01,0.35,0.35,0.29,0.29,-0.28,-49.12,62000,3,19630,0,0,0,0,0,0,32000,30000,2000,2000
20200312,707629,昇達科永豐97購01,,,,,,0.00,0,0,0,0,0,0,0,0,0,0,0,0,0
20200312,707630,僑威永豐96購01,,,,,,0.00,0,0,0,0,0,0,0,0,0,0,0,0,0
20200312,707631,璟德永豐96購01,,,,,,0.00,0,0,0,0,0,0,0,0,0,0,0,0,0
20200312,707632,鈊象永豐96購01,,,,,,0.00,0,0,0,0,0,0,0,0,0,0,0,0,0
20200312,707633,鈊象永豐97購01,4.72,4.72,4.72,4.72,-1.68,-26.25,6000,1,28320,0,0,0,0,0,0,6000,0,6000,6000
20200312,707634,元太元大96購03,,,,,,0.00,0,0,0,0,0,0,0,0,0,0,0,0,0
20200312,707635,宣德元大96購02,0.37,0.37,0.37,0.37,-0.16,-30.19,5000,1,1850,0,0,0,0,0,0,0,5000,-5000,-5000
20200312,707636,新普元大96購01,0.27,0.27,0.27,0.27,-0.24,-47.06,5000,1,1350,0,0,0,0,0,0,5000,0,5000,5000
20200312,707637,群聯元大97購02,0.77,0.77,0.53,0.62,-0.66,-51.56,112000,5,61000,0,0,0,0,0,0,105000,107000,-2000,-2000
20200312,707638,精測元大96購01,0.61,0.62,0.35,0.41,-0.24,-36.92,589000,12,269580,0,0,0,0,0,0,489000,122000,367000,367000
20200312,707639,鈊象元大97購01,,,,,,0.00,0,0,0,0,0,0,0,0,0,0,0,0,0
20200312,707640,波若威國票97購01,,,,,,0.00,0,0,0,0,0,0,0,0,0,0,0,0,0
20200312,707641,聯亞國票97購01,1.02,1.02,0.96,0.96,-0.84,-46.67,48000,5,46960,0,0,0,0,0,0,0,48000,-48000,-48000
20200312,707642,宣德國泰97購01,0.89,0.89,0.59,0.64,-0.28,-30.43,384000,8,297510,0,0,0,0,0,0,120000,323000,-203000,-203000
20200312,707643,原相國泰98購01,,,,,,0.00,0,0,0,0,0,0,0,0,0,0,0,0,0
20200312,707644,精測國泰98購01,0.65,0.65,0.41,0.41,-0.25,-37.88,296000,11,158500,0,0,0,0,0,0,86000,230000,-144000,-144000
20200312,707645,鈊象國泰98購01,,,,,,0.00,0,0,0,0,0,0,0,0,0,0,0,0,0
20200312,707646,鈊象群益99購01,,,,,,0.00,0,0,0,0,0,0,0,0,0,0,0,0,0
20200312,707647,鈺太中信96購02,0.37,0.37,0.37,0.37,-0.12,-24.49,10000,1,3700,0,0,0,0,0,0,10000,0,10000,10000
20200312,707648,雙鴻統一96購01,,,,,,0.00,0,0,0,0,0,0,0,0,0,0,0,0,0
20200312,707649,鈊象統一96購02,4.99,4.99,4.99,4.99,-1.61,-24.39,10000,1,49900,0,0,0,0,0,0,0,10000,-10000,-10000
20200312,707650,宇峻凱基98購01,0.30,0.31,0.21,0.24,-0.07,-22.58,965000,28,273810,0,0,0,0,0,0,256000,599000,-343000,-343000
20200312,707651,精測凱基96購03,0.19,0.19,0.19,0.19,-0.13,-40.62,746000,4,141740,0,0,0,0,0,0,546000,200000,346000,346000
20200312,707652,環球晶凱基96購03,1.28,1.31,0.90,0.90,-0.67,-42.68,126000,7,156040,0,0,0,0,0,0,53000,106000,-53000,-53000
20200312,707653,櫃200凱基96購03,0.51,0.51,0.12,0.15,-0.42,-73.68,82000,26,16100,0,0,0,0,0,0,0,74000,-74000,-74000
20200312,707654,雙美凱基97購01,,,,,,0.00,0,0,0,0,0,0,0,0,0,0,0,0,0
20200312,707655,穩懋凱基96購06,,,,,,0.00,0,0,0,0,0,0,0,0,0,0,0,0,0
20200312,707656,鈊象凱基96購01,3.84,3.84,3.84,3.84,-1.71,-30.81,10000,1,38400,0,0,0,0,0,0,0,10000,-10000,-10000
20200312,707657,鈊象凱基97購01,,,,,,0.00,0,0,0,0,0,0,0,0,0,0,0,0,0
20200312,707658,信昌電元富96購01,,,,,,0.00,0,0,0,0,0,0,0,0,0,0,0,0,0
20200312,707659,精測元富96購02,0.27,0.27,0.26,0.26,-0.05,-16.13,80000,8,20900,0,0,0,0,0,0,80000,0,80000,80000
20200312,707660,鈊象元富96購01,,,,,,0.00,0,0,0,0,0,0,0,0,0,0,0,0,0
20200312,707661,宣德台新96購01,0.55,0.55,0.42,0.42,-0.31,-42.47,45000,3,19550,0,0,0,0,0,0,5000,40000,-35000,-35000
20200312,707662,凡甲國票97購01,0.71,0.71,0.59,0.61,-0.21,-25.61,93000,10,59650,0,0,0,0,0,0,31000,62000,-31000,-31000
20200312,707663,世界國票97購01,1.38,1.41,1.38,1.41,-0.18,-11.32,20000,2,27900,0,0,0,0,0,0,0,20000,-20000,-20000
20200312,707664,杰力國票97購01,0.70,0.70,0.48,0.48,-0.27,-36.0,27000,4,16970,0,0,0,0,0,0,25000,2000,23000,23000
20200312,707665,原相國票98購01,2.49,2.49,2.07,2.07,-1.05,-33.65,45000,5,96650,0,0,0,0,0,0,0,45000,-45000,-45000
20200312,707666,鈊象國票96購02,20.40,20.80,14.00,14.00,-12.10,-46.36,55000,13,838800,0,0,0,0,0,0,10000,45000,-35000,-35000
20200312,707667,精測國泰98購02,0.83,0.83,0.57,0.57,-0.30,-34.48,879000,10,625490,0,0,0,0,0,0,472000,442000,30000,30000
20200312,707668,合晶富邦96購01,0.40,0.40,0.27,0.31,-0.18,-36.73,99000,7,33070,0,0,0,0,0,0,55000,44000,11000,11000
20200312,707669,安勤永豐97購01,0.14,0.16,0.14,0.14,-0.13,-48.15,132000,5,19020,0,0,0,0,0,0,132000,0,132000,132000
20200312,707670,閎康永豐96購01,,,,,,0.00,0,0,0,0,0,0,0,0,0,0,0,0,0
20200312,707671,精測永豐96購04,,,,,,0.00,0,0,0,0,0,0,0,0,0,0,0,0,0
20200312,707672,晶焱兆豐97購01,,,,,,0.00,0,0,0,0,0,0,0,0,0,0,0,0,0
20200312,707673,雙鴻兆豐97購02,0.21,0.21,0.15,0.15,-0.10,-40.0,105000,9,16810,0,0,0,0,0,0,6000,99000,-93000,-93000
20200312,707674,合晶元大97購01,,,,,,0.00,0,0,0,0,0,0,0,0,0,0,0,0,0
20200312,707675,茂達元大97購01,,,,,,0.00,0,0,0,0,0,0,0,0,0,0,0,0,0
20200312,707676,原相元大97購02,2.31,2.31,2.31,2.31,-0.72,-23.76,2000,1,4620,0,0,0,0,0,0,0,2000,-2000,-2000
20200312,707677,勝麗元大96購02,0.27,0.27,0.21,0.22,-0.23,-51.11,212000,6,49790,0,0,0,0,0,0,70000,142000,-72000,-72000
20200312,707678,精測元大98購01,0.52,0.52,0.34,0.35,-0.16,-31.37,693000,15,313440,0,0,0,0,0,0,533000,160000,373000,373000
20200312,707679,璟德元大96購01,0.86,0.86,0.60,0.60,-0.43,-41.75,391000,16,289570,0,0,0,0,0,0,81000,310000,-229000,-229000
20200312,707680,鈊象元大98購01,,,,,,0.00,0,0,0,0,0,0,0,0,0,0,0,0,0
20200312,707681,力麒康和96購01,,,,,,0.00,0,0,0,0,0,0,0,0,0,0,0,0,0
20200312,707682,精測康和96購03,0.30,0.30,0.21,0.21,-0.11,-34.38,216000,4,53350,0,0,0,0,0,0,67000,149000,-82000,-82000
20200312,707683,東隆興群益96購01,0.21,0.21,0.17,0.17,-0.05,-22.73,57000,7,10400,0,0,0,0,0,0,57000,0,57000,57000
20200312,707684,金居群益98購02,,,,,,0.00,0,0,0,0,0,0,0,0,0,0,0,0,0
20200312,707685,保瑞群益98購02,1.07,1.09,0.90,1.02,-0.33,-24.44,456000,19,463260,0,0,0,0,0,0,371000,71000,300000,300000
20200312,707686,神盾群益98購01,0.15,0.17,0.13,0.13,-0.12,-48.0,62000,5,10260,0,0,0,0,0,0,10000,52000,-42000,-42000
20200312,707687,順達群益96購02,1.20,1.20,1.08,1.08,-0.31,-22.3,56000,6,64160,0,0,0,0,0,0,36000,20000,16000,16000
20200312,707688,緯軟統一96購01,0.10,0.10,0.10,0.10,-0.09,-47.37,6000,1,600,0,0,0,0,0,0,0,6000,-6000,-6000
20200312,707689,穩懋統一96購06,0.51,0.51,0.51,0.51,-0.46,-47.42,1000,1,510,0,0,0,0,0,0,0,1000,-1000,-1000
20200312,707690,鈊象統一96購03,,,,,,0.00,0,0,0,0,0,0,0,0,0,0,0,0,0
20200312,707691,同致元大97購02,,,,,,0.00,0,0,0,0,0,0,0,0,0,0,0,0,0
20200312,707692,迅得元大97購01,,,,,,0.00,0,0,0,0,0,0,0,0,0,0,0,0,0
20200312,707693,晶焱元大97購01,1.07,1.07,0.94,0.94,-0.30,-24.19,70000,5,72890,0,0,0,0,0,0,60000,40000,20000,20000
20200312,707694,群聯元大97購03,1.86,1.86,1.19,1.19,-1.64,-57.95,33000,4,40040,0,0,0,0,0,0,33000,32000,1000,1000
20200312,707695,優群元大97購02,2.06,2.06,1.47,1.54,-0.80,-34.19,111000,10,189560,0,0,0,0,0,0,44000,67000,-23000,-23000
20200312,707696,聯亞元大97購01,1.25,1.26,1.00,1.03,-0.67,-39.41,178000,24,185630,0,0,0,0,0,0,47000,159000,-112000,-112000
20200312,707697,穩懋元大96購03,0.93,0.93,0.62,0.62,-0.66,-51.56,167000,14,120560,0,0,0,0,0,0,21000,156000,-135000,-135000
20200312,707698,鈊象元大97購02,,,,,,0.00,0,0,0,0,0,0,0,0,0,0,0,0,0
20200312,707699,原相元富96購01,2.85,2.85,2.85,2.85,-1.38,-32.62,1000,1,2850,0,0,0,0,0,0,0,0,0,0
20200312,707700,精華元富96購01,,,,,,0.00,0,0,0,0,0,0,0,0,0,0,0,0,0
20200312,707701,環球晶元富96購01,1.48,1.48,0.90,0.90,-1.07,-54.31,40000,4,50500,0,0,0,0,0,0,10000,30000,-20000,-20000
20200312,707702,鈊象台新98購01,,,,,,0.00,0,0,0,0,0,0,0,0,0,0,0,0,0
20200312,707703,M31凱基96購01,,,,,,0.00,0,0,0,0,0,0,0,0,0,0,0,0,0
20200312,707704,金可凱基97購01,0.05,0.05,0.05,0.05,-0.07,-58.33,10000,1,500,0,0,0,0,0,0,10000,0,10000,10000
20200312,707705,金居凱基96購01,,,,,,0.00,0,0,0,0,0,0,0,0,0,0,0,0,0
20200312,707706,精華凱基96購02,,,,,,0.00,0,0,0,0,0,0,0,0,0,0,0,0,0
20200312,707707,環球晶凱基96購04,1.65,1.76,1.39,1.76,-0.17,-8.81,122000,6,199810,0,0,0,0,0,0,41000,112000,-71000,-71000
20200312,707708,聯亞凱基96購01,0.75,0.75,0.50,0.50,-0.47,-48.45,32000,3,20960,0,0,0,0,0,0,19000,13000,6000,6000
20200312,707709,鐿鈦凱基97購01,0.10,0.10,0.10,0.10,-0.06,-37.5,30000,3,3000,0,0,0,0,0,0,0,30000,-30000,-30000
20200312,707710,大田國票97購01,0.31,0.31,0.31,0.31,-0.29,-48.33,200000,3,62000,0,0,0,0,0,0,0,200000,-200000,-200000
20200312,707711,六角國票98購01,0.79,0.79,0.68,0.68,-0.35,-33.98,52000,2,36460,0,0,0,0,0,0,10000,42000,-32000,-32000
20200312,707712,昂寶國票97購02,,,,,,0.00,0,0,0,0,0,0,0,0,0,0,0,0,0
20200312,707713,晶焱國票97購01,0.86,0.86,0.86,0.86,-0.48,-35.82,20000,1,17200,0,0,0,0,0,0,0,20000,-20000,-20000
20200312,707714,群聯國票97購01,2.53,2.53,1.31,1.31,-2.44,-65.07,81000,12,115330,0,0,0,0,0,0,27000,56000,-29000,-29000
20200312,707715,大江國泰98購01,,,,,,0.00,0,0,0,0,0,0,0,0,0,0,0,0,0
20200312,707716,晶焱國泰98購01,0.98,0.99,0.85,0.85,-0.23,-21.3,88000,11,81130,0,0,0,0,0,0,18000,70000,-52000,-52000
20200312,707717,穩懋國泰97購01,0.69,0.69,0.44,0.45,-0.37,-45.12,3361000,28,1904170,0,0,0,0,0,0,311000,3073000,-2762000,-2762000
20200312,707718,良維永豐96購01,,,,,,0.00,0,0,0,0,0,0,0,0,0,0,0,0,0
20200312,707719,威剛永豐96購01,,,,,,0.00,0,0,0,0,0,0,0,0,0,0,0,0,0
20200312,707720,宣德永豐97購01,0.30,0.30,0.30,0.30,-0.16,-34.78,2000,1,600,0,0,0,0,0,0,2000,0,2000,2000
20200312,707721,鈊象永豐96購03,6.90,6.90,5.05,5.05,-2.75,-35.26,34000,11,191450,0,0,0,0,0,0,33000,32000,1000,1000
20200312,707722,三貝德群益96購01,,,,,,0.00,0,0,0,0,0,0,0,0,0,0,0,0,0
20200312,707723,宜鼎群益96購02,1.07,1.07,0.90,0.99,-0.32,-24.43,107000,9,106530,0,0,0,0,0,0,40000,67000,-27000,-27000
20200312,707724,長科*群益96購01,0.69,0.69,0.64,0.64,-0.11,-14.67,12000,2,8180,0,0,0,0,0,0,0,12000,-12000,-12000
20200312,707725,閎康群益97購01,,,,,,0.00,0,0,0,0,0,0,0,0,0,0,0,0,0
20200312,707726,晟德群益96購01,0.62,0.62,0.57,0.57,-0.08,-12.31,25000,2,14750,0,0,0,0,0,0,10000,15000,-5000,-5000
20200312,707727,鈊象群益99購02,,,,,,0.00,0,0,0,0,0,0,0,0,0,0,0,0,0
20200312,707728,鈊象康和96購03,,,,,,0.00,0,0,0,0,0,0,0,0,0,0,0,0,0
20200312,707729,鈊象凱基98購01,5.80,5.85,4.91,4.91,-2.79,-36.23,4000,4,21470,0,0,0,0,0,0,4000,2000,2000,2000
20200312,707730,穩懋元富96購01,0.13,0.13,0.13,0.13,-0.17,-56.67,300000,2,39000,0,0,0,0,0,0,200000,100000,100000,100000
20200312,707731,環球晶亞東97購01,1.36,1.45,1.36,1.45,-0.35,-19.44,2000,2,2810,0,0,0,0,0,0,0,2000,-2000,-2000
20200312,707732,凡甲永豐97購01,0.45,0.45,0.41,0.41,-0.23,-35.94,41000,2,18370,0,0,0,0,0,0,41000,0,41000,41000
20200312,707733,大宇資永豐96購02,,,,,,0.00,0,0,0,0,0,0,0,0,0,0,0,0,0
20200312,707734,元太國票97購01,0.53,0.53,0.42,0.42,-0.29,-40.85,25000,2,12700,0,0,0,0,0,0,0,25000,-25000,-25000
20200312,707735,台燿國票97購01,0.87,0.87,0.64,0.74,-0.41,-35.65,99000,12,72130,0,2000,-2000,0,0,0,71000,28000,43000,41000
20200312,707736,信驊國票97購01,2.33,2.33,2.32,2.32,-1.07,-31.56,20000,2,46500,0,0,0,0,0,0,0,20000,-20000,-20000
20200312,707737,新普國票97購01,0.33,0.33,0.33,0.33,-0.15,-31.25,100000,1,33000,0,0,0,0,0,0,0,100000,-100000,-100000
20200312,707738,聖暉國泰96購01,1.37,1.37,1.23,1.34,-0.16,-10.67,234000,17,309690,0,0,0,0,0,0,213000,69000,144000,144000
20200312,707739,網家國泰97購01,0.48,0.48,0.24,0.26,-0.64,-71.11,446000,19,159760,0,0,0,0,0,0,15000,431000,-416000,-416000
20200312,707740,金可兆豐96購01,0.06,0.06,0.06,0.06,-0.07,-53.85,2000,2,120,0,0,0,0,0,0,2000,0,2000,2000
20200312,707741,胡連康和96購01,,,,,,0.00,0,0,0,0,0,0,0,0,0,0,0,0,0
20200312,707742,佳邦群益96購01,,,,,,0.00,0,0,0,0,0,0,0,0,0,0,0,0,0
20200312,707743,旺矽群益97購01,0.47,0.47,0.44,0.44,-0.16,-26.67,94000,2,42470,0,0,0,0,0,0,94000,0,94000,94000
20200312,707744,新普群益98購01,0.75,0.75,0.65,0.65,-0.33,-33.67,66000,5,47470,0,0,0,0,0,0,64000,0,64000,64000
20200312,707745,網龍群益98購01,,,,,,0.00,0,0,0,0,0,0,0,0,0,0,0,0,0
20200312,707746,由田元大96購01,0.33,0.33,0.21,0.21,-0.15,-41.67,5000,2,1290,0,0,0,0,0,0,3000,2000,1000,1000
20200312,707747,信昌電元大97購01,1.30,1.31,0.84,0.89,-0.73,-45.06,218000,12,243280,0,0,0,0,0,0,118000,218000,-100000,-100000
20200312,707748,神盾元大99購01,0.64,0.64,0.48,0.48,-0.20,-29.41,250000,14,142690,0,0,0,0,0,0,121000,215000,-94000,-94000
20200312,707749,精華元大97購01,,,,,,0.00,0,0,0,0,0,0,0,0,0,0,0,0,0
20200312,707750,穩懋元大97購01,0.55,0.55,0.38,0.38,-0.50,-56.82,251000,5,117900,0,0,0,0,0,0,151000,206000,-55000,-55000
20200312,707751,鈺太元大97購01,0.63,0.63,0.48,0.49,-0.22,-30.99,1060000,31,544000,0,0,0,0,0,0,505000,555000,-50000,-50000
20200312,707752,世界中信98購01,0.35,0.35,0.35,0.35,-0.06,-14.63,5000,1,1750,0,0,0,0,0,0,0,5000,-5000,-5000
20200312,707753,環球晶中信99購02,0.55,0.66,0.48,0.63,-0.05,-7.35,265000,32,147130,0,0,0,0,0,0,51000,209000,-158000,-158000
20200312,707754,環球晶統一96購01,1.76,1.76,1.76,1.76,-1.45,-45.17,10000,1,17600,0,0,0,0,0,0,0,10000,-10000,-10000
20200312,707755,穩懋統一96購07,0.40,0.40,0.40,0.40,-0.54,-57.45,1000,1,400,0,0,0,0,0,0,1000,0,1000,1000
20200312,707756,世界凱基96購01,0.24,0.29,0.23,0.25,0.00,0.0,240000,7,62100,0,0,0,0,0,0,150000,90000,60000,60000
20200312,707757,網龍凱基97購01,0.10,0.10,0.10,0.10,-0.04,-28.57,35000,6,3500,0,0,0,0,0,0,7000,28000,-21000,-21000
20200312,707758,穩懋凱基96購07,0.25,0.25,0.15,0.15,-0.19,-55.88,55000,3,11650,0,0,0,0,0,0,10000,45000,-35000,-35000
20200312,707759,大江元大97購01,0.18,0.18,0.14,0.14,-0.06,-30.0,60000,2,10400,0,0,0,0,0,0,0,60000,-60000,-60000
20200312,707760,世界元大96購02,0.64,0.77,0.62,0.77,+0.03,4.05,358000,5,242560,0,0,0,0,0,0,30000,268000,-238000,-238000
20200312,707761,迅得元大98購01,,,,,,0.00,0,0,0,0,0,0,0,0,0,0,0,0,0
20200312,707762,宣德元大96購03,,,,,,0.00,0,0,0,0,0,0,0,0,0,0,0,0,0
20200312,707763,群聯元大96購04,3.26,3.26,2.25,2.30,-1.85,-44.58,105000,13,279490,0,0,0,0,0,0,104000,105000,-1000,-1000
20200312,707764,鈊象元大96購03,,,,,,0.00,0,0,0,0,0,0,0,0,0,0,0,0,0
20200312,707765,原相永昌99購01,3.50,3.50,2.92,2.92,-1.39,-32.25,230000,6,751900,0,0,0,0,0,0,0,230000,-230000,-230000
20200312,707766,大田永豐96購01,0.09,0.09,0.09,0.09,-0.10,-52.63,300000,3,27000,0,0,0,0,0,0,0,300000,-300000,-300000
20200312,707767,中美晶永豐96購02,0.94,0.94,0.80,0.80,-0.53,-39.85,88000,3,73100,0,0,0,0,0,0,10000,78000,-68000,-68000
20200312,707768,世界永豐96購02,,,,,,0.00,0,0,0,0,0,0,0,0,0,0,0,0,0
20200312,707769,光頡永豐96購01,0.43,0.43,0.29,0.29,-0.25,-46.3,73000,2,21870,0,0,0,0,0,0,73000,0,73000,73000
20200312,707770,合晶永豐97購01,0.57,0.57,0.46,0.46,-0.20,-30.3,136000,4,69580,0,0,0,0,0,0,27000,109000,-82000,-82000
20200312,707771,精測永豐96購06,0.26,0.26,0.26,0.26,-0.16,-38.1,20000,2,5200,0,0,0,0,0,0,0,20000,-20000,-20000
20200312,707772,精測永豐96購07,,,,,,0.00,0,0,0,0,0,0,0,0,0,0,0,0,0
20200312,707773,穩懋永豐96購01,0.18,0.18,0.18,0.18,-0.18,-50.0,10000,1,1800,0,0,0,0,0,0,0,10000,-10000,-10000
20200312,707774,大宇資國票97購01,0.32,0.32,0.32,0.32,-0.24,-42.86,10000,1,3200,0,0,0,0,0,0,0,10000,-10000,-10000
20200312,707775,良維國票97購02,0.13,0.13,0.13,0.13,-0.21,-61.76,200000,2,26000,0,0,0,0,0,0,200000,0,200000,200000
20200312,707776,宜鼎國票97購01,2.17,2.17,2.17,2.17,-1.51,-41.03,10000,1,21700,0,0,0,0,0,0,0,10000,-10000,-10000
20200312,707777,金居國票97購01,,,,,,0.00,0,0,0,0,0,0,0,0,0,0,0,0,0
20200312,707778,信昌電國票97購01,0.93,0.93,0.65,0.65,-0.53,-44.92,26000,3,21200,0,0,0,0,0,0,16000,16000,0,0
20200312,707779,保瑞國票97購01,1.35,1.42,1.12,1.19,-0.66,-35.68,460000,29,594700,0,0,0,0,0,0,60000,400000,-340000,-340000
20200312,707780,昇達科富邦98購01,0.40,0.40,0.32,0.37,-0.07,-15.91,82000,9,31540,0,0,0,0,0,0,0,82000,-82000,-82000
20200312,707781,宣德麥證96購01,,,,,,0.00,0,0,0,0,0,0,0,0,0,0,0,0,0
20200312,707782,世界台新97購01,0.67,0.75,0.66,0.75,+0.03,4.17,176000,4,118820,0,0,0,0,0,0,0,176000,-176000,-176000
20200312,707783,泰博兆豐96購02,,,,,,0.00,0,0,0,0,0,0,0,0,0,0,0,0,0
20200312,707784,聚積康和96購01,,,,,,0.00,0,0,0,0,0,0,0,0,0,0,0,0,0
20200312,707785,凡甲群益98購01,0.79,0.79,0.71,0.71,-0.18,-20.22,65000,5,50970,0,0,0,0,0,0,65000,0,65000,65000
20200312,707786,中美晶群益96購01,2.10,2.20,1.97,2.20,-0.41,-15.71,31000,3,64800,0,0,0,0,0,0,10000,31000,-21000,-21000
20200312,707787,合晶群益96購01,0.69,0.69,0.41,0.48,-0.46,-48.94,310000,7,142350,0,0,0,0,0,0,217000,32000,185000,185000
20200312,707788,晶焱群益98購01,0.81,0.81,0.72,0.76,-0.22,-22.45,6000,3,4580,0,0,0,0,0,0,2000,4000,-2000,-2000
20200312,707789,精測群益96購04,0.47,0.47,0.30,0.30,-0.25,-45.45,145000,6,47760,0,0,0,0,0,0,108000,37000,71000,71000
20200312,707790,廣明群益96購01,,,,,,0.00,0,0,0,0,0,0,0,0,0,0,0,0,0
20200312,707791,聯亞群益96購02,0.31,0.31,0.31,0.31,-0.29,-48.33,10000,1,3100,0,0,0,0,0,0,0,10000,-10000,-10000
20200312,707792,鐿鈦群益97購01,0.34,0.34,0.30,0.30,-0.13,-30.23,81000,2,27500,0,0,0,0,0,0,80000,1000,79000,79000
20200312,707793,中美晶元大96購02,0.63,0.63,0.63,0.63,-0.07,-10.0,10000,1,6300,0,0,0,0,0,0,10000,0,10000,10000
20200312,707794,世界元大96購03,0.75,0.98,0.75,0.98,+0.13,15.29,181000,5,141830,0,0,0,0,0,0,68000,113000,-45000,-45000
20200312,707795,精測元大96購02,0.60,0.60,0.35,0.37,-0.29,-43.94,316000,9,129590,0,0,0,0,0,0,206000,144000,62000,62000
20200312,707796,聯亞元大96購02,0.93,0.93,0.70,0.70,-0.79,-53.02,37000,4,29830,0,0,0,0,0,0,17000,37000,-20000,-20000
20200312,707797,鈊象元大96購04,,,,,,0.00,0,0,0,0,0,0,0,0,0,0,0,0,0
20200312,707798,世界統一97購01,0.62,0.63,0.62,0.63,-0.03,-4.55,40000,3,25000,0,0,0,0,0,0,30000,10000,20000,20000
20200312,707799,神盾統一98購01,0.59,0.59,0.41,0.41,-0.30,-42.25,57000,3,30270,0,0,0,0,0,0,1000,56000,-55000,-55000
20200312,707800,穩懋統一98購02,0.49,0.49,0.40,0.40,-0.30,-42.86,62000,7,27310,0,0,0,0,0,0,15000,17000,-2000,-2000
20200312,707801,鈊象統一97購02,4.92,4.95,4.92,4.95,-1.35,-21.43,20000,2,98700,0,0,0,0,0,0,20000,20000,0,0
20200312,707802,宣德中信9A購01,0.44,0.44,0.36,0.36,-0.18,-33.33,110000,6,40400,0,0,0,0,0,0,90000,20000,70000,70000
20200312,707803,中光電凱基96購01,0.11,0.11,0.07,0.07,-0.06,-46.15,40000,3,3900,0,0,0,0,0,0,40000,0,40000,40000
20200312,707804,世界凱基96購02,0.10,0.10,0.10,0.10,0.00,0.0,42000,7,4200,0,0,0,0,0,0,0,42000,-42000,-42000
20200312,707805,旺矽凱基96購01,0.41,0.41,0.29,0.29,-0.28,-49.12,161000,5,49410,0,0,0,0,0,0,130000,31000,99000,99000
20200312,707806,信昌電凱基97購02,0.25,0.25,0.25,0.25,-0.17,-40.48,5000,1,1250,0,0,0,0,0,0,0,5000,-5000,-5000
20200312,707807,佳邦國票97購01,,,,,,0.00,0,0,0,0,0,0,0,0,0,0,0,0,0
20200312,707808,優群國票98購01,1.21,1.26,1.07,1.07,-0.48,-30.97,33000,6,39580,0,0,0,0,0,0,14000,19000,-5000,-5000
20200312,707809,中美晶國泰97購01,,,,,,0.00,0,0,0,0,0,0,0,0,0,0,0,0,0
20200312,707810,穩懋麥證96購01,0.58,0.58,0.35,0.35,-0.32,-47.76,272000,8,101760,110000,162000,-52000,0,0,0,110000,162000,-52000,-52000
20200312,707811,世界元富96購01,,,,,,0.00,0,0,0,0,0,0,0,0,0,0,0,0,0
20200312,707812,茂達元富96購01,,,,,,0.00,0,0,0,0,0,0,0,0,0,0,0,0,0
20200312,707813,群聯元富96購02,1.48,1.48,1.48,1.48,-0.84,-36.21,5000,1,7400,0,0,0,0,0,0,0,5000,-5000,-5000
20200312,707814,穩懋富邦98購01,0.35,0.35,0.23,0.24,-0.22,-47.83,1067000,35,268970,0,0,0,0,0,0,270000,797000,-527000,-527000
20200312,707815,中美晶台新97購01,,,,,,0.00,0,0,0,0,0,0,0,0,0,0,0,0,0
20200312,707816,良維台新97購01,,,,,,0.00,0,0,0,0,0,0,0,0,0,0,0,0,0
20200312,707817,閎康台新96購01,,,,,,0.00,0,0,0,0,0,0,0,0,0,0,0,0,0
20200312,707818,群聯台新97購02,1.17,1.17,0.94,0.94,-0.88,-48.35,364000,8,359490,0,0,0,0,0,0,0,364000,-364000,-364000
20200312,707819,碩禾台新97購01,0.82,0.82,0.76,0.76,-0.33,-30.28,107000,3,85520,0,0,0,0,0,0,97000,10000,87000,87000
20200312,707820,世界康和96購01,,,,,,0.00,0,0,0,0,0,0,0,0,0,0,0,0,0
20200312,707821,凡甲群益96購01,0.90,0.96,0.75,0.75,-0.39,-34.21,219000,11,177440,0,0,0,0,0,0,188000,31000,157000,157000
20200312,707822,中美晶群益96購02,1.13,1.15,1.13,1.15,-1.02,-47.0,22000,2,25080,0,0,0,0,0,0,0,22000,-22000,-22000
20200312,707823,宜鼎群益97購01,1.06,1.06,0.87,0.89,-0.43,-32.58,94000,8,93290,0,0,0,0,0,0,47000,47000,0,0
20200312,707824,環球晶群益96購01,0.60,0.60,0.60,0.60,-0.19,-24.05,5000,1,3000,0,0,0,0,0,0,5000,0,5000,5000
20200312,707825,鈊象群益99購03,,,,,,0.00,0,0,0,0,0,0,0,0,0,0,0,0,0
20200312,707826,大江永豐96購02,,,,,,0.00,0,0,0,0,0,0,0,0,0,0,0,0,0
20200312,707827,世界永豐96購03,,,,,,0.00,0,0,0,0,0,0,0,0,0,0,0,0,0
20200312,707828,合晶永豐96購01,,,,,,0.00,0,0,0,0,0,0,0,0,0,0,0,0,0
20200312,707829,博智永豐96購01,2.94,2.98,2.94,2.98,-1.08,-26.6,6000,2,17720,0,0,0,0,0,0,6000,0,6000,6000
20200312,707830,網龍永豐96購01,0.05,0.05,0.05,0.05,-0.09,-64.29,10000,1,500,0,0,0,0,0,0,10000,0,10000,10000
20200312,707831,雙美永豐97購01,,,,,,0.00,0,0,0,0,0,0,0,0,0,0,0,0,0
20200312,707832,精測兆豐97購02,,,,,,0.00,0,0,0,0,0,0,0,0,0,0,0,0,0
20200312,707833,網龍兆豐97購01,0.28,0.28,0.22,0.22,-0.14,-38.89,200000,8,50910,0,0,0,0,0,0,75000,125000,-50000,-50000
20200312,707834,晟德兆豐97購01,0.52,0.52,0.40,0.40,-0.15,-27.27,212000,3,95240,0,0,0,0,0,0,0,212000,-212000,-212000
20200312,707835,原相康和96購01,1.03,1.03,1.03,1.03,-0.64,-38.32,20000,1,20600,0,0,0,0,0,0,20000,0,20000,20000
20200312,707836,力旺永豐96購01,,,,,,0.00,0,0,0,0,0,0,0,0,0,0,0,0,0
20200312,707837,良維永豐96購02,,,,,,0.00,0,0,0,0,0,0,0,0,0,0,0,0,0
20200312,707838,佳邦永豐96購01,,,,,,0.00,0,0,0,0,0,0,0,0,0,0,0,0,0
20200312,707839,建榮永豐97購01,,,,,,0.00,0,0,0,0,0,0,0,0,0,0,0,0,0
20200312,707840,晶焱永豐97購01,,,,,,0.00,0,0,0,0,0,0,0,0,0,0,0,0,0
20200312,707841,智崴永豐96購01,,,,,,0.00,0,0,0,0,0,0,0,0,0,0,0,0,0
20200312,707842,精測永豐96購08,,,,,,0.00,0,0,0,0,0,0,0,0,0,0,0,0,0
20200312,707843,鈊象永豐96購04,,,,,,0.00,0,0,0,0,0,0,0,0,0,0,0,0,0
20200312,707844,中美晶元大97購01,1.42,1.42,1.06,1.06,-0.59,-35.76,260000,4,315300,0,0,0,0,0,0,50000,210000,-160000,-160000
20200312,707845,台半元大96購01,,,,,,0.00,0,0,0,0,0,0,0,0,0,0,0,0,0
20200312,707846,杰力元大96購03,0.49,0.49,0.49,0.49,-0.13,-20.97,12000,1,5880,0,0,0,0,0,0,0,12000,-12000,-12000
20200312,707847,宣德元大96購04,1.01,1.01,0.70,0.70,-0.58,-45.31,140000,5,106600,0,0,0,0,0,0,140000,100000,40000,40000
20200312,707848,精測元大96購03,0.30,0.30,0.22,0.22,-0.16,-42.11,111000,3,27650,0,0,0,0,0,0,71000,41000,30000,30000
20200312,707849,雙鴻元大99購01,0.40,0.40,0.26,0.27,-0.19,-41.3,495000,11,145450,0,0,0,0,0,0,150000,335000,-185000,-185000
20200312,707850,鈊象元大97購03,6.40,6.40,5.10,5.10,-2.70,-34.62,99000,12,530050,0,0,0,0,0,0,18000,89000,-71000,-71000
20200312,707851,群聯麥證96購01,1.15,1.15,0.61,0.65,-0.84,-56.38,288000,18,220960,23000,265000,-242000,0,0,0,89000,288000,-199000,-199000
20200312,707852,環球晶麥證96購01,2.18,2.18,1.63,1.69,-0.77,-31.3,120000,12,232100,30000,90000,-60000,0,0,0,30000,90000,-60000,-60000
20200312,707853,雙鴻麥證97購01,,,,,,0.00,0,0,0,0,0,0,0,0,0,0,0,0,0
20200312,707854,合晶台新96購01,,,,,,0.00,0,0,0,0,0,0,0,0,0,0,0,0,0
20200312,707855,良維台新97購02,0.23,0.23,0.19,0.19,-0.11,-36.67,25000,4,5100,0,0,0,0,0,0,0,25000,-25000,-25000
20200312,707856,神盾台新97購01,0.28,0.28,0.23,0.23,-0.24,-51.06,330000,3,87400,0,0,0,0,0,0,190000,140000,50000,50000
20200312,707857,新普台新97購01,0.66,0.68,0.62,0.62,-0.27,-30.34,246000,6,161380,0,0,0,0,0,0,150000,96000,54000,54000
20200312,707858,穩懋台新97購01,,,,,,0.00,0,0,0,0,0,0,0,0,0,0,0,0,0
20200312,707859,中美晶國票97購01,0.84,0.85,0.64,0.64,-0.70,-52.24,107000,6,74920,0,0,0,0,0,0,67000,40000,27000,27000
20200312,707860,同致國票97購02,,,,,,0.00,0,0,0,0,0,0,0,0,0,0,0,0,0
20200312,707861,東隆興國票96購01,0.22,0.22,0.20,0.20,-0.05,-20.0,16000,2,3240,0,0,0,0,0,0,16000,0,16000,16000
20200312,707862,茂達國票97購01,0.36,0.36,0.35,0.35,-0.38,-52.05,12000,2,4300,0,0,0,0,0,0,2000,10000,-8000,-8000
20200312,707863,穩懋國票97購01,0.52,0.52,0.52,0.52,-0.46,-46.94,200000,1,104000,0,0,0,0,0,0,0,200000,-200000,-200000
20200312,707864,M31凱基98購01,0.17,0.17,0.17,0.17,-0.11,-39.29,111000,1,18870,0,0,0,0,0,0,111000,0,111000,111000
20200312,707865,中美晶凱基96購03,0.42,0.42,0.27,0.35,-0.13,-27.08,210000,9,74900,0,0,0,0,0,0,35000,175000,-140000,-140000
20200312,707866,合晶凱基96購01,0.39,0.39,0.25,0.27,-0.27,-50.0,223000,6,73790,0,0,0,0,0,0,88000,135000,-47000,-47000
20200312,707867,宣德凱基96購02,0.14,0.14,0.14,0.14,-0.13,-48.15,1000,1,140,0,0,0,0,0,0,1000,0,1000,1000
20200312,707868,碩禾凱基97購01,0.51,0.51,0.51,0.51,-0.29,-36.25,12000,1,6120,0,0,0,0,0,0,0,12000,-12000,-12000
20200312,707869,精測凱基96購07,,,,,,0.00,0,0,0,0,0,0,0,0,0,0,0,0,0
20200312,707870,聯亞凱基97購01,0.43,0.43,0.41,0.41,-0.38,-48.1,12000,2,5120,0,0,0,0,0,0,0,12000,-12000,-12000
20200312,707871,精測國泰97購02,0.37,0.37,0.21,0.21,-0.22,-51.16,526000,8,131780,0,0,0,0,0,0,321000,225000,96000,96000
20200312,707872,精測國泰98購03,0.42,0.42,0.26,0.26,-0.16,-38.1,290000,7,117500,0,0,0,0,0,0,258000,32000,226000,226000
20200312,707873,鈺太國泰98購01,,,,,,0.00,0,0,0,0,0,0,0,0,0,0,0,0,0
20200312,707874,世界富邦98購01,0.34,0.34,0.34,0.34,-0.06,-15.0,10000,1,3400,0,0,0,0,0,0,10000,0,10000,10000
20200312,707875,世界群益98購01,0.83,1.03,0.83,1.03,+0.01,0.98,15000,2,13450,0,0,0,0,0,0,0,15000,-15000,-15000
20200312,707876,世界群益98購02,0.80,0.80,0.75,0.75,-0.08,-9.64,26000,2,20050,0,0,0,0,0,0,15000,11000,4000,4000
20200312,707877,迅得群益97購02,,,,,,0.00,0,0,0,0,0,0,0,0,0,0,0,0,0
20200312,707878,信昌電群益96購01,0.31,0.31,0.31,0.31,-0.21,-40.38,11000,1,3410,0,0,0,0,0,0,0,11000,-11000,-11000
20200312,707879,宣德群益96購02,0.71,0.71,0.71,0.71,-0.29,-29.0,118000,2,83780,0,0,0,0,0,0,118000,0,118000,118000
20200312,707880,建榮群益97購01,,,,,,0.00,0,0,0,0,0,0,0,0,0,0,0,0,0
20200312,707881,璟德群益97購01,0.85,0.85,0.85,0.85,-0.60,-41.38,10000,1,8500,0,0,0,0,0,0,10000,0,10000,10000
20200312,707882,環球晶群益97購01,0.94,0.94,0.71,0.71,-0.48,-40.34,54000,8,46550,0,0,0,0,0,0,49000,34000,15000,15000
20200312,707883,力旺元大97購01,,,,,,0.00,0,0,0,0,0,0,0,0,0,0,0,0,0
20200312,707884,中美晶元大97購02,1.48,1.51,1.48,1.51,-0.47,-23.74,68000,2,101180,0,0,0,0,0,0,0,68000,-68000,-68000
20200312,707885,台燿元大96購01,0.64,0.64,0.58,0.58,-0.21,-26.58,68000,4,40640,0,0,0,0,0,0,68000,0,68000,68000
20200312,707886,旺矽元大99購01,0.37,0.38,0.37,0.38,-0.22,-36.67,90000,2,33500,0,0,0,0,0,0,90000,0,90000,90000
20200312,707887,晶焱元大97購02,0.41,0.41,0.41,0.41,-0.12,-22.64,10000,1,4100,0,0,0,0,0,0,10000,0,10000,10000
20200312,707888,精測元大97購02,,,,,,0.00,0,0,0,0,0,0,0,0,0,0,0,0,0
20200312,707889,璟德元大96購02,0.49,0.49,0.32,0.32,-0.27,-45.76,255000,9,114000,0,0,0,0,0,0,20000,235000,-215000,-215000
20200312,707890,穩懋元大96購04,0.87,0.87,0.58,0.58,-0.85,-59.44,77000,3,45240,0,0,0,0,0,0,62000,17000,45000,45000
20200312,707891,力旺凱基96購01,,,,,,0.00,0,0,0,0,0,0,0,0,0,0,0,0,0
20200312,707892,大江凱基96購02,,,,,,0.00,0,0,0,0,0,0,0,0,0,0,0,0,0
20200312,707893,保瑞凱基96購01,0.82,0.82,0.72,0.77,-0.20,-20.62,135000,16,104110,0,0,0,0,0,0,123000,0,123000,123000
20200312,707894,璟德凱基96購02,0.14,0.14,0.14,0.14,-0.08,-36.36,60000,1,8400,0,0,0,0,0,0,0,60000,-60000,-60000
20200312,707895,穩懋凱基96購09,0.24,0.25,0.24,0.25,-0.28,-52.83,151000,3,37740,0,0,0,0,0,0,0,151000,-151000,-151000
20200312,707896,中美晶統一96購01,,,,,,0.00,0,0,0,0,0,0,0,0,0,0,0,0,0
20200312,707897,昂寶統一97購01,,,,,,0.00,0,0,0,0,0,0,0,0,0,0,0,0,0
20200312,707898,台燿兆豐97購01,0.51,0.51,0.44,0.46,-0.15,-24.59,36000,5,16850,0,0,0,0,0,0,11000,25000,-14000,-14000
20200312,707899,威剛群益96購01,4.66,4.66,3.48,3.48,-2.47,-41.51,25000,6,110900,0,0,0,0,0,0,0,25000,-25000,-25000
20200312,707900,宣德群益96購03,,,,,,0.00,0,0,0,0,0,0,0,0,0,0,0,0,0
20200312,707901,精測群益96購05,0.07,0.07,0.04,0.04,-0.07,-63.64,800000,51,44500,0,0,0,0,0,0,300000,500000,-200000,-200000
20200312,707902,鈊象群益98購01,,,,,,0.00,0,0,0,0,0,0,0,0,0,0,0,0,0
20200312,707903,M31永豐96購01,0.24,0.24,0.24,0.24,-0.27,-52.94,3000,1,720,0,0,0,0,0,0,3000,0,3000,3000
20200312,707904,金居永豐96購01,0.07,0.07,0.07,0.07,-0.10,-58.82,300000,6,21000,0,0,0,0,0,0,0,300000,-300000,-300000
20200312,707905,宣德永豐96購01,0.25,0.25,0.16,0.16,-0.13,-44.83,190000,3,38500,0,0,0,0,0,0,90000,100000,-10000,-10000
20200312,707906,精測永豐96購09,,,,,,0.00,0,0,0,0,0,0,0,0,0,0,0,0,0
20200312,707907,璟德永豐96購02,,,,,,0.00,0,0,0,0,0,0,0,0,0,0,0,0,0
20200312,707908,優群永豐96購02,0.93,0.93,0.76,0.76,-0.53,-41.09,55000,5,45700,0,0,0,0,0,0,20000,35000,-15000,-15000
20200312,707909,凡甲台新96購01,,,,,,0.00,0,0,0,0,0,0,0,0,0,0,0,0,0
20200312,707910,力旺國票97購01,,,,,,0.00,0,0,0,0,0,0,0,0,0,0,0,0,0
20200312,707911,杰力國票97購02,0.88,0.88,0.88,0.88,-0.07,-7.37,130000,2,114400,0,0,0,0,0,0,130000,0,130000,130000
20200312,707912,聚積國票97購01,1.00,1.00,1.00,1.00,-0.20,-16.67,10000,1,10000,0,0,0,0,0,0,10000,0,10000,10000
20200312,707913,鈊象國票97購01,11.90,12.30,11.90,12.30,-5.80,-32.04,47000,5,574100,0,0,0,0,0,0,1000,47000,-46000,-46000
20200312,707914,環球晶國泰97購01,2.06,2.23,1.60,2.23,-0.15,-6.3,144000,14,275270,0,0,0,0,0,0,64000,114000,-50000,-50000
20200312,707915,中美晶富邦97購02,,,,,,0.00,0,0,0,0,0,0,0,0,0,0,0,0,0
20200312,707916,聯亞富邦98購01,0.57,0.63,0.49,0.51,-0.27,-34.62,513000,22,267180,0,0,0,0,0,0,143000,351000,-208000,-208000
20200312,707917,中美晶麥證96購01,,,,,,0.00,0,0,0,0,0,0,0,0,0,0,0,0,0
20200312,707918,合晶麥證96購01,0.48,0.48,0.39,0.39,-0.20,-33.9,60000,4,27200,40000,20000,20000,0,0,0,40000,20000,20000,20000
20200312,707919,櫃200第一96購03,0.21,0.21,0.21,0.21,-0.26,-55.32,1000,1,210,0,0,0,0,0,0,0,1000,-1000,-1000
20200312,707920,櫃200第一96購04,,,,,,0.00,0,0,0,0,0,0,0,0,0,0,0,0,0
20200312,707921,譜瑞兆豐96購01,,,,,,0.00,0,0,0,0,0,0,0,0,0,0,0,0,0
20200312,707922,雍智康和96購01,0.33,0.33,0.33,0.33,-0.11,-25.0,60000,2,19800,0,0,0,0,0,0,60000,0,60000,60000
20200312,707923,力旺群益97購01,,,,,,0.00,0,0,0,0,0,0,0,0,0,0,0,0,0
20200312,707924,中美晶群益97購01,0.53,0.54,0.38,0.48,-0.13,-21.31,948000,49,442520,0,0,0,0,0,0,788000,152000,636000,636000
20200312,707925,信驊群益96購01,3.83,3.83,3.28,3.28,-0.89,-21.34,49000,6,172770,0,0,0,0,0,0,26000,22000,4000,4000
20200312,707926,雍智群益96購01,0.36,0.36,0.36,0.36,-0.14,-28.0,82000,1,29520,0,0,0,0,0,0,82000,0,82000,82000
20200312,707927,碩禾群益97購01,0.72,0.72,0.65,0.65,-0.19,-22.62,98000,8,67360,0,0,0,0,0,0,71000,27000,44000,44000
20200312,707928,環球晶群益97購02,2.08,2.15,1.64,2.15,-0.23,-9.66,159000,18,304990,0,0,0,0,0,0,88000,94000,-6000,-6000
20200312,707929,凡甲元大98購01,0.72,0.72,0.65,0.65,-0.14,-17.72,7000,3,4910,0,0,0,0,0,0,6000,1000,5000,5000
20200312,707930,雍智元大97購01,,,,,,0.00,0,0,0,0,0,0,0,0,0,0,0,0,0
20200312,707931,力旺統一96購01,,,,,,0.00,0,0,0,0,0,0,0,0,0,0,0,0,0
20200312,707932,雍智統一97購01,0.54,0.54,0.47,0.47,-0.18,-27.69,246000,3,128580,0,0,0,0,0,0,138000,108000,30000,30000
20200312,707933,新普中信96購01,0.54,0.59,0.54,0.59,-0.06,-9.23,13000,2,7420,0,0,0,0,0,0,5000,8000,-3000,-3000
20200312,707934,雍智中信96購01,0.26,0.26,0.21,0.25,-0.12,-32.43,102000,3,26010,0,0,0,0,0,0,101000,1000,100000,100000
20200312,707935,大江國票97購03,,,,,,0.00,0,0,0,0,0,0,0,0,0,0,0,0,0
20200312,707936,世界國票97購02,0.61,0.61,0.61,0.61,-0.04,-6.15,38000,1,23180,0,0,0,0,0,0,0,38000,-38000,-38000
20200312,707937,雍智國票96購01,0.75,0.75,0.56,0.56,-0.47,-45.63,34000,2,19420,0,0,0,0,0,0,34000,0,34000,34000
20200312,707938,雙鴻國票97購01,,,,,,0.00,0,0,0,0,0,0,0,0,0,0,0,0,0
20200312,707939,鈺太國票97購01,0.43,0.43,0.39,0.39,-0.22,-36.07,13000,2,5190,0,0,0,0,0,0,13000,0,13000,13000
20200312,707940,弘塑凱基97購01,0.34,0.34,0.24,0.26,-0.14,-35.0,1500000,150,441200,0,0,0,0,0,0,0,1475000,-1475000,-1475000
20200312,707941,同致凱基97購01,,,,,,0.00,0,0,0,0,0,0,0,0,0,0,0,0,0
20200312,707942,神盾凱基98購01,,,,,,0.00,0,0,0,0,0,0,0,0,0,0,0,0,0
20200312,707943,雍智凱基96購01,0.44,0.44,0.40,0.40,-0.18,-31.03,106000,4,44640,0,0,0,0,0,0,106000,0,106000,106000
20200312,707944,廣明凱基96購01,,,,,,0.00,0,0,0,0,0,0,0,0,0,0,0,0,0
20200312,707945,環球晶凱基96購05,0.60,0.61,0.40,0.61,-0.12,-16.44,107000,10,56420,0,0,0,0,0,0,57000,57000,0,0
20200312,707946,鈊象凱基96購03,4.00,4.00,4.00,4.00,-1.45,-26.61,1000,1,4000,0,0,0,0,0,0,0,1000,-1000,-1000
20200312,707947,力旺麥證96購01,,,,,,0.00,0,0,0,0,0,0,0,0,0,0,0,0,0
20200312,707948,威剛國泰97購01,2.68,2.68,1.81,1.84,-1.05,-36.33,179000,20,390960,0,0,0,0,0,0,18000,161000,-143000,-143000
20200312,707949,群聯國泰98購01,1.10,1.10,0.65,0.68,-0.68,-50.0,2148000,43,1663740,0,0,0,0,0,0,923000,1441000,-518000,-518000
20200312,707950,雍智國泰98購01,1.04,1.04,0.80,0.87,-0.21,-19.44,384000,16,336320,0,0,0,0,0,0,214000,227000,-13000,-13000
20200312,707951,精測元富99購01,,,,,,0.00,0,0,0,0,0,0,0,0,0,0,0,0,0
20200312,707952,聯亞元富96購02,1.04,1.04,0.76,0.76,-0.55,-41.98,451000,13,380620,0,0,0,0,0,0,344000,157000,187000,187000
20200312,707953,力旺台新97購01,0.31,0.31,0.31,0.31,-0.17,-35.42,10000,1,3100,0,0,0,0,0,0,0,10000,-10000,-10000
20200312,707954,世界台新97購02,0.95,0.95,0.95,0.95,-0.14,-12.84,66000,2,62700,0,0,0,0,0,0,0,66000,-66000,-66000
20200312,707955,櫃200永昌97購01,,,,,,0.00,0,0,0,0,0,0,0,0,0,0,0,0,0
20200312,707956,櫃200永昌99購01,,,,,,0.00,0,0,0,0,0,0,0,0,0,0,0,0,0
20200312,707957,櫃200永昌99購02,,,,,,0.00,0,0,0,0,0,0,0,0,0,0,0,0,0
20200312,707958,櫃200永昌99購03,2.03,2.03,2.03,2.03,-0.45,-18.15,4000,1,8120,0,0,0,0,0,0,0,4000,-4000,-4000
20200312,707959,久元永豐96購01,0.55,0.55,0.55,0.55,-0.13,-19.12,2000,1,1100,0,0,0,0,0,0,2000,0,2000,2000
20200312,707960,立端永豐96購01,0.41,0.41,0.28,0.29,-0.21,-42.0,278000,28,87930,0,0,0,0,0,0,50000,228000,-178000,-178000
20200312,707961,良維永豐96購03,0.30,0.30,0.30,0.30,-0.22,-42.31,3000,1,900,0,0,0,0,0,0,0,3000,-3000,-3000
20200312,707962,宜鼎永豐96購01,0.34,0.34,0.34,0.34,-0.38,-52.78,5000,1,1700,0,0,0,0,0,0,0,5000,-5000,-5000
20200312,707963,皇田永豐96購01,,,,,,0.00,0,0,0,0,0,0,0,0,0,0,0,0,0
20200312,707964,美琪瑪永豐96購01,,,,,,0.00,0,0,0,0,0,0,0,0,0,0,0,0,0
20200312,707965,雍智永豐96購01,0.32,0.32,0.32,0.32,-0.10,-23.81,68000,1,21760,0,0,0,0,0,0,68000,0,68000,68000
20200312,707966,穩懋統一96購08,,,,,,0.00,0,0,0,0,0,0,0,0,0,0,0,0,0
20200312,707967,穩懋統一96購09,0.32,0.32,0.32,0.32,-0.38,-54.29,3000,1,960,0,0,0,0,0,0,0,3000,-3000,-3000
20200312,707968,穩懋統一96購10,0.69,0.69,0.45,0.45,-0.72,-61.54,73000,3,47730,0,0,0,0,0,0,48000,25000,23000,23000
20200312,707969,穩懋統一97購03,0.54,0.54,0.38,0.38,-0.35,-47.95,772000,8,334890,0,0,0,0,0,0,528000,244000,284000,284000
20200312,707970,鈊象統一97購03,,,,,,0.00,0,0,0,0,0,0,0,0,0,0,0,0,0
20200312,707971,中美晶中信96購01,0.93,0.93,0.69,0.70,-0.40,-36.36,55000,6,44550,0,0,0,0,0,0,45000,10000,35000,35000
20200312,707972,同致中信98購01,,,,,,0.00,0,0,0,0,0,0,0,0,0,0,0,0,0
20200312,707973,環球晶中信9C購01,0.77,0.78,0.64,0.78,-0.10,-11.36,388000,13,258960,0,0,0,0,0,0,213000,175000,38000,38000
20200312,707974,世界凱基96購03,0.46,0.51,0.46,0.51,-0.16,-23.88,40000,3,19700,0,0,0,0,0,0,0,40000,-40000,-40000
20200312,707975,金居凱基96購02,0.35,0.35,0.20,0.20,-0.18,-47.37,230000,5,66200,0,0,0,0,0,0,100000,130000,-30000,-30000
20200312,707976,環球晶凱基96購06,1.31,1.31,0.79,0.87,-0.87,-50.0,132000,12,142120,0,0,0,0,0,0,62000,102000,-40000,-40000
20200312,707977,穩懋凱基96購10,0.54,0.54,0.30,0.30,-0.45,-60.0,110000,5,48600,0,0,0,0,0,0,20000,90000,-70000,-70000
20200312,707978,大江群益97購01,0.04,0.04,0.03,0.03,-0.03,-50.0,40000,4,1400,0,0,0,0,0,0,0,40000,-40000,-40000
20200312,707979,原相群益98購01,1.73,1.76,1.29,1.32,-0.76,-36.54,160000,20,253260,0,0,0,0,0,0,50000,122000,-72000,-72000
20200312,707980,弘塑國票97購01,0.57,0.57,0.40,0.44,-0.27,-38.03,623000,27,282360,0,0,0,0,0,0,50000,573000,-523000,-523000
20200312,707981,宜鼎國票97購02,2.16,2.16,1.94,1.94,-1.52,-43.93,38000,4,77820,0,0,0,0,0,0,0,38000,-38000,-38000
20200312,707982,昂寶國票97購03,,,,,,0.00,0,0,0,0,0,0,0,0,0,0,0,0,0
20200312,707983,環球晶國票97購01,2.31,2.43,1.68,2.32,-0.42,-15.33,527000,17,995410,0,0,0,0,0,0,10000,517000,-507000,-507000
20200312,707984,緯軟國泰97購01,0.21,0.21,0.21,0.21,-0.16,-43.24,10000,1,2100,0,0,0,0,0,0,0,10000,-10000,-10000
20200312,707985,櫃200永昌9B購01,,,,,,0.00,0,0,0,0,0,0,0,0,0,0,0,0,0
20200312,707986,櫃200永昌9C購01,,,,,,0.00,0,0,0,0,0,0,0,0,0,0,0,0,0
20200312,707987,櫃200永昌9C購02,,,,,,0.00,0,0,0,0,0,0,0,0,0,0,0,0,0
20200312,707988,櫃200永昌9C購03,3.50,3.50,3.50,3.50,-1.10,-23.91,1000,1,3500,0,0,0,0,0,0,0,1000,-1000,-1000
20200312,707989,大宇資第一96購01,,,,,,0.00,0,0,0,0,0,0,0,0,0,0,0,0,0
20200312,707990,凡甲永豐96購01,0.33,0.33,0.27,0.27,-0.20,-42.55,103000,3,32910,0,0,0,0,0,0,0,103000,-103000,-103000
20200312,707991,弘塑永豐96購01,0.10,0.10,0.10,0.10,-0.14,-58.33,20000,1,2000,0,0,0,0,0,0,20000,0,20000,20000
20200312,707992,昇達科永豐96購01,,,,,,0.00,0,0,0,0,0,0,0,0,0,0,0,0,0
20200312,707993,波若威永豐97購01,,,,,,0.00,0,0,0,0,0,0,0,0,0,0,0,0,0
20200312,707994,威剛永豐96購02,0.79,0.79,0.43,0.51,-0.39,-43.33,850000,27,502770,0,0,0,0,0,0,56000,784000,-728000,-728000
20200312,707995,原相永豐96購01,0.59,0.63,0.41,0.43,-0.30,-41.1,692000,41,332270,0,0,0,0,0,0,226000,466000,-240000,-240000
20200312,707996,神盾永豐96購01,,,,,,0.00,0,0,0,0,0,0,0,0,0,0,0,0,0
20200312,707997,網龍永豐96購02,,,,,,0.00,0,0,0,0,0,0,0,0,0,0,0,0,0
20200312,707998,廣明永豐96購02,,,,,,0.00,0,0,0,0,0,0,0,0,0,0,0,0,0
20200312,707999,聯亞永豐96購01,0.92,1.04,0.81,0.81,-0.51,-38.64,95000,9,88350,0,0,0,0,0,0,66000,85000,-19000,-19000
20200312,708000,雙鴻永豐97購01,0.11,0.11,0.11,0.11,-0.04,-26.67,10000,1,1100,0,0,0,0,0,0,10000,0,10000,10000
20200312,708001,世界元大96購05,0.75,0.88,0.74,0.80,+0.07,9.59,383000,13,301040,0,0,0,0,0,0,36000,383000,-347000,-347000
20200312,708002,合晶元大97購02,0.30,0.30,0.30,0.30,-0.09,-23.08,30000,1,9000,0,0,0,0,0,0,30000,0,30000,30000
20200312,708003,宜鼎元大96購01,0.99,0.99,0.72,0.76,-0.46,-37.7,238000,9,192260,0,0,0,0,0,0,0,238000,-238000,-238000
20200312,708004,雍智元大97購02,0.76,0.76,0.64,0.64,-0.20,-23.81,388000,12,272980,0,0,0,0,0,0,333000,40000,293000,293000
20200312,708005,精測元大97購03,0.32,0.32,0.17,0.17,-0.18,-51.43,17000,3,3660,0,0,0,0,0,0,4000,13000,-9000,-9000
20200312,708006,精華元大96購03,0.10,0.10,0.09,0.09,-0.11,-55.0,63000,2,6130,0,0,0,0,0,0,63000,17000,46000,46000
20200312,708007,雍智元富96購01,0.48,0.48,0.39,0.42,-0.26,-38.24,134000,6,56530,0,0,0,0,0,0,133000,1000,132000,132000
20200312,708008,精測元富96購03,,,,,,0.00,0,0,0,0,0,0,0,0,0,0,0,0,0
20200312,708009,精測台新96購01,0.03,0.03,0.03,0.03,-0.04,-57.14,40000,2,1200,0,0,0,0,0,0,40000,0,40000,40000
20200312,708010,璟德台新96購01,,,,,,0.00,0,0,0,0,0,0,0,0,0,0,0,0,0
20200312,708011,良維兆豐97購01,1.10,1.10,0.90,0.90,-0.53,-37.06,53000,4,53700,0,0,0,0,0,0,15000,38000,-23000,-23000
20200312,708012,聚積兆豐97購01,1.22,1.22,1.11,1.11,-0.24,-17.78,30000,3,35000,0,0,0,0,0,0,30000,0,30000,30000
20200312,708013,廣明兆豐96購01,0.27,0.27,0.25,0.25,-0.30,-54.55,60000,2,16000,0,0,0,0,0,0,0,60000,-60000,-60000
20200312,708014,聯亞兆豐97購01,1.95,2.10,1.72,1.72,-1.01,-37.0,42000,5,79700,0,0,0,0,0,0,10000,32000,-22000,-22000
20200312,708015,鈺太康和96購01,,,,,,0.00,0,0,0,0,0,0,0,0,0,0,0,0,0
20200312,708016,新普群益98購02,0.69,0.69,0.60,0.60,-0.23,-27.71,113000,5,76140,0,0,0,0,0,0,93000,20000,73000,73000
20200312,708017,精測群益96購06,,,,,,0.00,0,0,0,0,0,0,0,0,0,0,0,0,0
20200312,708018,雙鴻群益98購01,0.18,0.18,0.14,0.14,-0.20,-58.82,45000,2,7900,0,0,0,0,0,0,40000,5000,35000,35000
20200312,708019,世界麥證96購01,0.74,0.94,0.74,0.94,+0.03,3.3,90000,9,72100,0,90000,-90000,0,0,0,0,90000,-90000,-90000
20200312,708020,世界元富96購02,0.58,0.69,0.56,0.69,+0.05,7.81,50000,4,29900,0,0,0,0,0,0,20000,30000,-10000,-10000
20200312,708021,勝麗元富96購01,0.24,0.24,0.24,0.24,-0.06,-20.0,23000,1,5520,0,0,0,0,0,0,23000,0,23000,23000
20200312,708022,璟德元富96購01,0.37,0.37,0.24,0.25,-0.22,-46.81,453000,8,130470,0,0,0,0,0,0,23000,430000,-407000,-407000
20200312,708023,鈺太元富96購01,,,,,,0.00,0,0,0,0,0,0,0,0,0,0,0,0,0
20200312,708024,金居中信9C購01,0.25,0.25,0.20,0.20,-0.12,-37.5,20000,4,4600,0,0,0,0,0,0,0,20000,-20000,-20000
20200312,708025,勝麗中信9A購01,0.24,0.24,0.19,0.19,-0.10,-34.48,106000,2,20440,0,0,0,0,0,0,6000,100000,-94000,-94000
20200312,708026,群聯永豐96購01,0.20,0.20,0.12,0.12,-0.32,-72.73,622000,5,76870,0,0,0,0,0,0,3000,619000,-616000,-616000
20200312,708027,精測永豐96購10,,,,,,0.00,0,0,0,0,0,0,0,0,0,0,0,0,0
20200312,708028,鈺太永豐96購01,0.30,0.30,0.30,0.30,-0.13,-30.23,10000,1,3000,0,0,0,0,0,0,10000,0,10000,10000
20200312,708029,旺矽國票97購01,0.21,0.21,0.18,0.18,-0.16,-47.06,160000,2,33300,0,0,0,0,0,0,150000,10000,140000,140000
20200312,708030,精華國票97購01,,,,,,0.00,0,0,0,0,0,0,0,0,0,0,0,0,0
20200312,708031,中美晶凱基96購04,1.12,1.12,1.12,1.12,-0.60,-34.88,40000,1,44800,0,0,0,0,0,0,40000,0,40000,40000
20200312,708032,六角凱基97購01,0.47,0.47,0.47,0.47,-0.11,-18.97,3000,1,1410,0,0,0,0,0,0,3000,0,3000,3000
20200312,708033,昂寶凱基97購01,,,,,,0.00,0,0,0,0,0,0,0,0,0,0,0,0,0
20200312,708034,勝麗凱基96購01,0.47,0.48,0.44,0.44,-0.23,-34.33,150000,7,67320,0,0,0,0,0,0,82000,68000,14000,14000
20200312,708035,博智凱基96購01,3.81,3.81,3.51,3.51,-1.19,-25.32,30000,3,111300,0,0,0,0,0,0,0,30000,-30000,-30000
20200312,708036,優群凱基98購01,1.07,1.07,0.80,0.87,-0.34,-28.1,443000,27,403030,0,0,0,0,0,0,261000,182000,79000,79000
20200312,708037,環球晶凱基96購07,1.08,1.08,0.97,0.97,-0.41,-29.71,43000,4,43120,0,0,0,0,0,0,43000,33000,10000,10000
20200312,708038,穩懋凱基96購11,0.58,0.58,0.58,0.58,-0.52,-47.27,20000,1,11600,0,0,0,0,0,0,20000,0,20000,20000
20200312,708039,宣德國泰98購01,0.57,0.57,0.39,0.40,-0.28,-41.18,175000,11,78890,0,0,0,0,0,0,135000,40000,95000,95000
20200312,708040,雍智國泰98購02,1.75,1.75,1.26,1.33,-0.40,-23.12,367000,34,539470,0,0,0,0,0,0,136000,242000,-106000,-106000
20200312,708041,精測國泰98購04,0.20,0.20,0.16,0.16,-0.10,-38.46,92000,4,16940,0,0,0,0,0,0,2000,90000,-88000,-88000
20200312,708042,精測國泰99購01,0.20,0.20,0.20,0.20,-0.09,-31.03,1000,1,200,0,0,0,0,0,0,1000,0,1000,1000
20200312,708043,精測國泰9A購01,0.29,0.29,0.20,0.22,-0.09,-29.03,600000,23,139030,0,0,0,0,0,0,110000,490000,-380000,-380000
20200312,708044,雙鴻富邦97購02,,,,,,0.00,0,0,0,0,0,0,0,0,0,0,0,0,0
20200312,708045,大江元大97購02,0.30,0.32,0.22,0.22,-0.13,-37.14,230000,5,66700,0,0,0,0,0,0,0,230000,-230000,-230000
20200312,708046,中美晶元大96購03,0.54,0.54,0.49,0.54,-0.27,-33.33,185000,5,93100,0,0,0,0,0,0,0,185000,-185000,-185000
20200312,708047,世界元大96購06,0.98,1.24,0.97,1.24,+0.08,6.9,155000,7,159880,0,0,0,0,0,0,10000,145000,-135000,-135000
20200312,708048,合晶元大96購05,0.52,0.52,0.37,0.37,-0.27,-42.19,78000,2,30360,0,0,0,0,0,0,10000,68000,-58000,-58000
20200312,708049,信驊元大96購01,1.46,1.46,1.28,1.28,-0.43,-25.15,419000,20,569330,0,0,0,0,0,0,100000,340000,-240000,-240000
20200312,708050,雍智元大96購01,0.67,0.67,0.49,0.49,-0.24,-32.88,34000,4,20650,0,0,0,0,0,0,34000,0,34000,34000
20200312,708051,精測元大96購04,,,,,,0.00,0,0,0,0,0,0,0,0,0,0,0,0,0
20200312,708052,穩懋元大96購05,0.78,0.78,0.51,0.51,-0.49,-49.0,60000,6,41470,0,0,0,0,0,0,40000,24000,16000,16000
20200312,708053,鈺太元大97購02,0.75,0.75,0.57,0.57,-0.37,-39.36,42000,4,29640,0,0,0,0,0,0,36000,15000,21000,21000
20200312,708054,力旺元富96購01,,,,,,0.00,0,0,0,0,0,0,0,0,0,0,0,0,0
20200312,708055,金可中信9A購01,0.11,0.11,0.09,0.09,-0.05,-35.71,380000,4,38900,0,0,0,0,0,0,350000,30000,320000,320000
20200312,708056,聖暉統一99購01,0.49,0.49,0.48,0.48,-0.05,-9.43,97000,4,46840,0,0,0,0,0,0,47000,50000,-3000,-3000
20200312,708057,大江凱基98購01,,,,,,0.00,0,0,0,0,0,0,0,0,0,0,0,0,0
20200312,708058,良維凱基98購01,0.11,0.11,0.09,0.09,-0.08,-47.06,31000,2,2810,0,0,0,0,0,0,31000,1000,30000,30000
20200312,708059,旺矽凱基98購01,,,,,,0.00,0,0,0,0,0,0,0,0,0,0,0,0,0
20200312,708060,信驊凱基96購02,0.97,0.97,0.81,0.81,-0.77,-48.73,61000,7,54230,0,0,0,0,0,0,27000,34000,-7000,-7000
20200312,708061,雍智凱基98購01,0.38,0.38,0.38,0.38,-0.09,-19.15,1000,1,380,0,0,0,0,0,0,1000,0,1000,1000
20200312,708062,精測凱基99購01,0.14,0.14,0.09,0.10,-0.06,-37.5,1187000,31,147470,0,0,0,0,0,0,184000,953000,-769000,-769000
20200312,708063,緯軟凱基98購01,,,,,,0.00,0,0,0,0,0,0,0,0,0,0,0,0,0
20200312,708064,環球晶凱基96購08,0.91,0.91,0.77,0.83,-0.26,-23.85,38000,5,32170,0,0,0,0,0,0,28000,38000,-10000,-10000
20200312,708065,力旺永豐96購02,,,,,,0.00,0,0,0,0,0,0,0,0,0,0,0,0,0
20200312,708066,同致永豐96購01,0.16,0.16,0.16,0.16,-0.11,-40.74,20000,1,3200,0,0,0,0,0,0,20000,0,20000,20000
20200312,708067,迅得永豐97購02,,,,,,0.00,0,0,0,0,0,0,0,0,0,0,0,0,0
20200312,708068,欣銓永豐96購01,0.26,0.26,0.21,0.21,-0.10,-32.26,84000,2,21340,0,0,0,0,0,0,84000,0,84000,84000
20200312,708069,弘塑康和9C購01,0.43,0.43,0.39,0.39,-0.10,-20.41,522000,8,213080,0,0,0,0,0,0,350000,172000,178000,178000
20200312,708070,大田群益96購01,,,,,,0.00,0,0,0,0,0,0,0,0,0,0,0,0,0
20200312,708071,合晶群益96購02,0.54,0.54,0.34,0.37,-0.41,-52.56,328000,6,141610,0,0,0,0,0,0,208000,120000,88000,88000
20200312,708072,信昌電群益96購02,0.77,0.77,0.64,0.64,-0.47,-42.34,120000,4,89650,0,0,0,0,0,0,110000,10000,100000,100000
20200312,708073,茂達群益98購01,0.55,0.55,0.39,0.39,-0.34,-46.58,98000,4,52270,0,0,0,0,0,0,88000,10000,78000,78000
20200312,708074,大宇資國票97購02,0.32,0.32,0.30,0.30,-0.10,-25.0,60000,2,18200,0,0,0,0,0,0,50000,10000,40000,40000
20200312,708075,雙鴻國票97購02,0.14,0.14,0.12,0.12,-0.12,-50.0,256000,5,33780,0,0,0,0,0,0,0,256000,-256000,-256000
20200312,708076,力旺國泰98購01,0.40,0.40,0.28,0.28,-0.24,-46.15,246000,8,76620,0,0,0,0,0,0,10000,236000,-226000,-226000
20200312,708077,威剛富邦98購01,0.45,0.45,0.32,0.32,-0.18,-36.0,93000,7,36330,0,0,0,0,0,0,72000,21000,51000,51000
20200312,708078,勝麗富邦97購01,0.22,0.22,0.17,0.17,-0.18,-51.43,40000,2,7300,0,0,0,0,0,0,40000,0,40000,40000
20200312,708079,群聯富邦98購01,0.43,0.44,0.28,0.29,-0.23,-44.23,406000,27,150330,0,0,0,0,0,0,201000,195000,6000,6000
20200312,708080,精測富邦97購01,0.05,0.05,0.05,0.05,-0.02,-28.57,4000,1,200,0,0,0,0,0,0,0,4000,-4000,-4000
20200312,708081,信驊元大96購02,2.43,2.47,2.25,2.25,-0.79,-25.99,17000,4,40970,0,0,0,0,0,0,12000,10000,2000,2000
20200312,708082,新普元大97購01,0.82,0.89,0.77,0.82,-0.14,-14.58,291000,11,238130,0,0,0,0,0,0,146000,192000,-46000,-46000
20200312,708083,環球晶元大96購03,1.40,1.45,1.26,1.26,-0.48,-27.59,33000,3,43450,0,0,0,0,0,0,32000,33000,-1000,-1000
20200312,708084,環球晶元大97購01,1.77,1.77,1.40,1.40,-0.61,-30.35,341000,12,559660,0,0,0,0,0,0,287000,85000,202000,202000
20200312,708085,穩懋元大96購06,0.42,0.43,0.28,0.28,-0.42,-60.0,253000,10,97300,0,0,0,0,0,0,25000,228000,-203000,-203000
20200312,708086,穩懋元大96購07,0.66,0.66,0.41,0.41,-0.46,-52.87,131000,7,76350,0,0,0,0,0,0,131000,106000,25000,25000
20200312,708087,群聯元富96購03,1.68,1.68,1.03,1.18,-1.66,-58.45,80000,9,114450,0,0,0,0,0,0,30000,50000,-20000,-20000
20200312,708088,群聯兆豐97購01,1.96,1.96,1.96,1.96,-0.45,-18.67,15000,2,29400,0,0,0,0,0,0,15000,0,15000,15000
20200312,708089,精測兆豐97購03,,,,,,0.00,0,0,0,0,0,0,0,0,0,0,0,0,0
20200312,708090,穩懋兆豐96購04,,,,,,0.00,0,0,0,0,0,0,0,0,0,0,0,0,0
20200312,708091,久元康和96購01,,,,,,0.00,0,0,0,0,0,0,0,0,0,0,0,0,0
20200312,708092,櫃200永昌98購01,0.77,0.77,0.24,0.24,-0.53,-68.83,4000,4,1550,0,0,0,0,0,0,0,3000,-3000,-3000
20200312,708093,櫃200永昌98購02,0.29,0.29,0.29,0.29,-0.36,-55.38,5000,1,1450,0,0,0,0,0,0,0,5000,-5000,-5000
20200312,708094,大學光群益98購01,0.85,0.85,0.71,0.71,-0.42,-37.17,314000,9,236400,0,0,0,0,0,0,241000,73000,168000,168000
20200312,708095,VHQ中信96購01,,,,,,0.00,0,0,0,0,0,0,0,0,0,0,0,0,0
20200312,708096,合晶中信9A購01,0.24,0.27,0.24,0.25,-0.12,-32.43,28000,5,6980,0,0,0,0,0,0,0,28000,-28000,-28000
20200312,708097,宣德中信9A購02,0.25,0.25,0.19,0.20,-0.08,-28.57,439000,10,91270,0,0,0,0,0,0,198000,241000,-43000,-43000
20200312,708098,群聯中信9A購01,0.30,0.31,0.25,0.26,-0.24,-48.0,597000,66,167730,0,0,0,0,0,0,0,597000,-597000,-597000
20200312,708099,M31凱基97購02,0.24,0.24,0.16,0.16,-0.14,-46.67,132000,3,29920,0,0,0,0,0,0,32000,100000,-68000,-68000
20200312,708100,大江凱基96購03,,,,,,0.00,0,0,0,0,0,0,0,0,0,0,0,0,0
20200312,708101,合晶凱基97購01,0.32,0.32,0.32,0.32,-0.11,-25.58,111000,2,35520,0,0,0,0,0,0,0,111000,-111000,-111000
20200312,708102,良維凱基97購01,,,,,,0.00,0,0,0,0,0,0,0,0,0,0,0,0,0
20200312,708103,宜鼎凱基96購02,,,,,,0.00,0,0,0,0,0,0,0,0,0,0,0,0,0
20200312,708104,晶焱凱基98購01,,,,,,0.00,0,0,0,0,0,0,0,0,0,0,0,0,0
20200312,708105,旺矽統一97購01,,,,,,0.00,0,0,0,0,0,0,0,0,0,0,0,0,0
20200312,708106,宣德統一97購02,,,,,,0.00,0,0,0,0,0,0,0,0,0,0,0,0,0
20200312,708107,大江永豐96購03,0.06,0.06,0.06,0.06,-0.07,-53.85,900000,2,54000,0,0,0,0,0,0,900000,0,900000,900000
20200312,708108,昂寶永豐96購02,,,,,,0.00,0,0,0,0,0,0,0,0,0,0,0,0,0
20200312,708109,昇達科永豐96購02,0.43,0.43,0.43,0.43,-0.12,-21.82,90000,1,38700,0,90000,-90000,0,0,0,90000,0,90000,0
20200312,708110,博智永豐96購02,1.30,1.36,1.11,1.22,-0.43,-26.06,370000,13,434650,0,0,0,0,0,0,290000,80000,210000,210000
20200312,708111,新鉅科永豐96購01,,,,,,0.00,0,0,0,0,0,0,0,0,0,0,0,0,0
20200312,708112,晟德永豐96購01,0.47,0.48,0.47,0.48,-0.08,-14.29,14000,3,6710,0,0,0,0,0,0,13000,2000,11000,11000
20200312,708113,世界元大96購07,,,,,,0.00,0,0,0,0,0,0,0,0,0,0,0,0,0
20200312,708114,良維元大97購02,0.18,0.18,0.13,0.13,-0.13,-50.0,35000,2,5300,0,0,0,0,0,0,0,35000,-35000,-35000
20200312,708115,佳邦元大96購01,0.29,0.29,0.29,0.29,-0.11,-27.5,10000,1,2900,0,0,0,0,0,0,0,10000,-10000,-10000
20200312,708116,昂寶元大96購03,,,,,,0.00,0,0,0,0,0,0,0,0,0,0,0,0,0
20200312,708117,廣明元大97購01,0.10,0.10,0.10,0.10,-0.08,-44.44,8000,1,800,0,0,0,0,0,0,0,8000,-8000,-8000
20200312,708118,環球晶元大96購04,1.18,1.18,1.06,1.06,-0.45,-29.8,35000,3,38500,0,0,0,0,0,0,35000,30000,5000,5000
20200312,708119,環球晶元大97購02,0.67,0.67,0.51,0.51,-0.31,-37.8,58000,4,32060,0,0,0,0,0,0,13000,48000,-35000,-35000
20200312,708120,穩懋元大96購10,0.62,0.62,0.48,0.48,-0.49,-50.52,108000,5,55240,0,0,0,0,0,0,30000,78000,-48000,-48000
20200312,708121,M31國票97購01,0.30,0.30,0.23,0.23,-0.23,-50.0,500000,10,127160,0,0,0,0,0,0,272000,228000,44000,44000
20200312,708122,六角國票98購02,0.87,0.87,0.73,0.75,-0.28,-27.18,68000,6,53800,0,0,0,0,0,0,20000,48000,-28000,-28000
20200312,708123,原相國票97購01,1.30,1.32,0.93,0.95,-0.60,-38.71,172000,14,187790,0,0,0,0,0,0,0,172000,-172000,-172000
20200312,708124,神盾國票97購02,,,,,,0.00,0,0,0,0,0,0,0,0,0,0,0,0,0
20200312,708125,碩禾國票97購01,1.10,1.10,0.84,0.84,-0.56,-40.0,131000,10,128690,0,0,0,0,0,0,51000,80000,-29000,-29000
20200312,708126,環宇國票97購01,0.40,0.40,0.40,0.40,-0.49,-55.06,21000,1,8400,0,0,0,0,0,0,21000,0,21000,21000
20200312,708127,昂寶國泰98購01,,,,,,0.00,0,0,0,0,0,0,0,0,0,0,0,0,0
20200312,708128,環球晶國泰97購02,1.77,1.82,1.17,1.82,-0.17,-8.54,200000,20,289480,0,0,0,0,0,0,63000,170000,-107000,-107000
20200312,708129,力旺元大96購01,,,,,,0.00,0,0,0,0,0,0,0,0,0,0,0,0,0
20200312,708130,台燿元大96購02,0.48,0.48,0.48,0.48,-0.18,-27.27,10000,1,4800,0,0,0,0,0,0,10000,0,10000,10000
20200312,708131,泰博元大96購01,,,,,,0.00,0,0,0,0,0,0,0,0,0,0,0,0,0
20200312,708132,博智元大97購01,3.78,3.78,3.06,3.39,-0.96,-22.07,77000,4,246240,0,0,0,0,0,0,65000,12000,53000,53000
20200312,708133,網家元大96購01,1.31,1.31,0.85,0.85,-0.67,-44.08,56000,7,62680,0,0,0,0,0,0,31000,25000,6000,6000
20200312,708134,穩懋元大96購11,0.67,0.67,0.45,0.45,-0.50,-52.63,123000,3,70310,0,0,0,0,0,0,0,123000,-123000,-123000
20200312,708135,群聯群益96購04,0.20,0.20,0.09,0.09,-0.25,-73.53,238000,8,26300,0,0,0,0,0,0,8000,230000,-222000,-222000
20200312,708136,宇峻凱基98購02,0.62,0.66,0.52,0.52,-0.15,-22.39,144000,7,84440,0,0,0,0,0,0,10000,134000,-124000,-124000
20200312,708137,旺矽凱基97購01,0.12,0.12,0.12,0.12,-0.04,-25.0,150000,2,18000,0,0,0,0,0,0,150000,0,150000,150000
20200312,708138,原相凱基98購01,0.75,1.61,0.75,1.14,-0.65,-36.31,73000,21,88740,0,0,0,0,0,0,11000,62000,-51000,-51000
20200312,708139,精華凱基97購01,,,,,,0.00,0,0,0,0,0,0,0,0,0,0,0,0,0
20200312,708140,優群凱基98購02,0.89,0.91,0.74,0.78,-0.31,-28.44,332000,15,257750,0,0,0,0,0,0,72000,260000,-188000,-188000
20200312,708141,鈊象凱基98購02,,,,,,0.00,0,0,0,0,0,0,0,0,0,0,0,0,0
20200312,708142,宣德台新96購02,0.29,0.29,0.27,0.27,-0.28,-50.91,205000,3,59350,0,0,0,0,0,0,200000,5000,195000,195000
20200312,708143,大江永豐97購01,,,,,,0.00,0,0,0,0,0,0,0,0,0,0,0,0,0
20200312,708144,杰力永豐96購01,,,,,,0.00,0,0,0,0,0,0,0,0,0,0,0,0,0
20200312,708145,直得永豐96購01,,,,,,0.00,0,0,0,0,0,0,0,0,0,0,0,0,0
20200312,708146,信昌電永豐96購02,1.00,1.00,0.90,0.90,-0.39,-30.23,62000,2,57000,0,0,0,0,0,0,0,62000,-62000,-62000
20200312,708147,保瑞永豐96購01,1.22,1.22,0.84,0.94,-0.28,-22.95,976000,33,947620,0,0,0,0,0,0,804000,153000,651000,651000
20200312,708148,胡連永豐96購01,,,,,,0.00,0,0,0,0,0,0,0,0,0,0,0,0,0
20200312,708149,精測永豐96購12,,,,,,0.00,0,0,0,0,0,0,0,0,0,0,0,0,0
20200312,708150,聚積永豐96購01,0.39,0.39,0.38,0.38,-0.21,-35.59,37000,2,14330,0,0,0,0,0,0,10000,27000,-17000,-17000
20200312,708151,雙鴻永豐97購02,,,,,,0.00,0,0,0,0,0,0,0,0,0,0,0,0,0
20200312,708152,力旺中信96購01,,,,,,0.00,0,0,0,0,0,0,0,0,0,0,0,0,0
20200312,708153,建榮統一98購01,,,,,,0.00,0,0,0,0,0,0,0,0,0,0,0,0,0
20200312,708154,大江凱基98購02,0.12,0.12,0.12,0.12,-0.01,-7.69,3000,1,360,0,0,0,0,0,0,0,0,0,0
20200312,708155,宇峻凱基98購03,0.55,0.55,0.44,0.44,-0.14,-24.14,62000,4,30160,0,0,0,0,0,0,2000,60000,-58000,-58000
20200312,708156,昂寶凱基97購02,,,,,,0.00,0,0,0,0,0,0,0,0,0,0,0,0,0
20200312,708157,金居凱基97購01,,,,,,0.00,0,0,0,0,0,0,0,0,0,0,0,0,0
20200312,708158,鐿鈦凱基96購03,0.19,0.19,0.19,0.19,-0.15,-44.12,20000,1,3800,0,0,0,0,0,0,20000,0,20000,20000
20200312,708159,大江元大97購03,0.26,0.26,0.21,0.21,-0.12,-36.36,2000,2,470,0,0,0,0,0,0,0,2000,-2000,-2000
20200312,708160,合晶元大98購01,0.36,0.36,0.36,0.36,-0.26,-41.94,2000,2,720,0,0,0,0,0,0,2000,0,2000,2000
20200312,708161,昂寶元大96購04,,,,,,0.00,0,0,0,0,0,0,0,0,0,0,0,0,0
20200312,708162,欣銓元大96購01,0.63,0.63,0.51,0.51,-0.17,-25.0,589000,13,340310,0,0,0,0,0,0,461000,128000,333000,333000
20200312,708163,威剛元大98購01,0.70,0.70,0.56,0.65,-0.11,-14.47,1517000,118,985400,0,0,0,0,0,0,405000,1011000,-606000,-606000
20200312,708164,環球晶元大96購05,0.73,0.78,0.49,0.78,-0.13,-14.29,640000,36,400550,0,0,0,0,0,0,383000,259000,124000,124000
20200312,708165,環球晶元大97購03,0.87,0.98,0.73,0.98,-0.05,-4.85,172000,11,139930,0,0,0,0,0,0,101000,90000,11000,11000
20200312,708166,凡甲永豐96購02,1.01,1.06,0.88,0.92,-0.40,-30.3,103000,8,100230,0,0,0,0,0,0,70000,33000,37000,37000
20200312,708167,台燿永豐96購01,0.22,0.22,0.22,0.22,-0.10,-31.25,5000,1,1100,0,0,0,0,0,0,0,5000,-5000,-5000
20200312,708168,波若威永豐97購02,,,,,,0.00,0,0,0,0,0,0,0,0,0,0,0,0,0
20200312,708169,網家永豐96購01,0.60,0.60,0.60,0.60,-0.16,-21.05,10000,1,6000,0,0,0,0,0,0,0,10000,-10000,-10000
20200312,708170,網龍永豐96購03,0.24,0.24,0.24,0.24,-0.15,-38.46,10000,1,2400,0,0,0,0,0,0,0,10000,-10000,-10000
20200312,708171,優群永豐96購03,,,,,,0.00,0,0,0,0,0,0,0,0,0,0,0,0,0
20200312,708172,緯軟兆豐97購01,,,,,,0.00,0,0,0,0,0,0,0,0,0,0,0,0,0
20200312,708173,鈺太兆豐97購01,0.17,0.17,0.17,0.17,-0.09,-34.62,348000,4,59160,0,0,0,0,0,0,318000,30000,288000,288000
20200312,708174,胡連康和96購02,0.34,0.34,0.33,0.33,-0.16,-32.65,122000,2,41460,0,0,0,0,0,0,120000,2000,118000,118000
20200312,708175,精華群益96購02,,,,,,0.00,0,0,0,0,0,0,0,0,0,0,0,0,0
20200312,708176,中美晶國票97購02,1.05,1.05,0.70,0.70,-0.93,-57.06,20000,2,17500,0,0,0,0,0,0,10000,10000,0,0
20200312,708177,欣銓富邦97購01,,,,,,0.00,0,0,0,0,0,0,0,0,0,0,0,0,0
20200312,708178,鈊象富邦97購01,,,,,,0.00,0,0,0,0,0,0,0,0,0,0,0,0,0
20200312,708179,神盾元富98購01,0.42,0.42,0.31,0.31,-0.21,-40.38,108000,2,44260,0,0,0,0,0,0,98000,10000,88000,88000
20200312,708180,群聯元富96購04,0.07,0.07,0.06,0.06,-0.12,-66.67,205000,4,14300,0,0,0,0,0,0,0,205000,-205000,-205000
20200312,708181,VHQ統一96購01,0.24,0.24,0.23,0.24,-0.13,-35.14,16000,5,3770,0,0,0,0,0,0,0,15000,-15000,-15000
20200312,708182,凡甲統一96購01,1.03,1.03,0.99,0.99,-0.18,-15.38,61000,2,61870,0,0,0,0,0,0,61000,0,61000,61000
20200312,708183,中美晶凱基96購05,1.51,1.51,1.51,1.51,-0.02,-1.31,1000,1,1510,0,0,0,0,0,0,1000,1000,0,0
20200312,708184,建榮凱基96購02,,,,,,0.00,0,0,0,0,0,0,0,0,0,0,0,0,0
20200312,708185,原相凱基97購01,1.90,1.97,1.30,1.33,-1.34,-50.19,200000,23,329590,0,0,0,0,0,0,51000,149000,-98000,-98000
20200312,708186,神盾凱基96購03,0.16,0.16,0.16,0.16,-0.24,-60.0,50000,1,8000,0,0,0,0,0,0,50000,0,50000,50000
20200312,708187,金居兆豐97購01,0.65,0.65,0.62,0.62,-0.12,-16.22,50000,5,31560,0,0,0,0,0,0,50000,0,50000,50000
20200312,708188,威剛兆豐97購01,1.34,1.34,1.18,1.18,-0.65,-35.52,59000,4,75710,0,0,0,0,0,0,8000,51000,-43000,-43000
20200312,708189,茂達群益98購02,0.57,0.57,0.40,0.46,-0.18,-28.12,117000,8,58900,0,0,0,0,0,0,81000,36000,45000,45000
20200312,708190,六角元大96購02,0.45,0.45,0.42,0.42,-0.28,-40.0,83000,2,36900,0,0,0,0,0,0,15000,68000,-53000,-53000
20200312,708191,同致元大96購02,,,,,,0.00,0,0,0,0,0,0,0,0,0,0,0,0,0
20200312,708192,旺矽元大97購01,,,,,,0.00,0,0,0,0,0,0,0,0,0,0,0,0,0
20200312,708193,直得元大96購01,0.58,0.58,0.47,0.47,-0.19,-28.79,351000,17,185080,0,0,0,0,0,0,336000,192000,144000,144000
20200312,708194,宣德元大97購01,1.07,1.12,0.85,0.85,-0.55,-39.29,150000,3,140500,0,0,0,0,0,0,150000,100000,50000,50000
20200312,708195,精測元大96購07,,,,,,0.00,0,0,0,0,0,0,0,0,0,0,0,0,0
20200312,708196,環宇元大96購02,0.63,0.63,0.42,0.43,-0.34,-44.16,35000,4,19840,0,0,0,0,0,0,35000,0,35000,35000
20200312,708197,合晶亞東97購01,,,,,,0.00,0,0,0,0,0,0,0,0,0,0,0,0,0
20200312,708198,三貝德永豐96購01,0.03,0.03,0.03,0.03,-0.05,-62.5,50000,1,1500,0,0,0,0,0,0,50000,0,50000,50000
20200312,708199,大田永豐96購02,,,,,,0.00,0,0,0,0,0,0,0,0,0,0,0,0,0
20200312,708200,中美晶永豐96購03,,,,,,0.00,0,0,0,0,0,0,0,0,0,0,0,0,0
20200312,708201,金居永豐96購02,0.58,0.58,0.41,0.41,-0.29,-41.43,20000,2,9900,0,0,0,0,0,0,10000,10000,0,0
20200312,708202,碩禾永豐96購01,0.61,0.61,0.61,0.61,-0.12,-16.44,20000,2,12200,0,0,0,0,0,0,10000,10000,0,0
20200312,708203,雙鴻永豐96購02,,,,,,0.00,0,0,0,0,0,0,0,0,0,0,0,0,0
20200312,708204,昂寶元富96購01,,,,,,0.00,0,0,0,0,0,0,0,0,0,0,0,0,0
20200312,708205,力旺台新97購02,0.31,0.31,0.31,0.31,-0.16,-34.04,10000,1,3100,0,0,0,0,0,0,10000,0,10000,10000
20200312,708206,大江國票97購04,0.09,0.09,0.09,0.09,-0.10,-52.63,20000,1,1800,0,0,0,0,0,0,0,20000,-20000,-20000
20200312,708207,大學光國票98購01,1.61,1.61,1.61,1.61,-0.29,-15.26,21000,1,33810,0,0,0,0,0,0,21000,0,21000,21000
20200312,708208,勝麗國票97購03,0.41,0.41,0.32,0.32,-0.35,-52.24,23000,3,7630,0,0,0,0,0,0,0,23000,-23000,-23000
20200312,708209,博智國票97購01,4.41,4.41,3.85,3.85,-1.15,-23.0,9000,3,36810,0,0,0,0,0,0,0,9000,-9000,-9000
20200312,708210,閎康國票97購02,0.50,0.50,0.47,0.48,-0.14,-22.58,450000,41,218200,0,450000,-450000,0,0,0,450000,0,450000,0
20200312,708211,精華國票97購02,,,,,,0.00,0,0,0,0,0,0,0,0,0,0,0,0,0
20200312,708212,鈺太國泰96購01,0.48,0.48,0.34,0.34,-0.31,-47.69,105000,3,48820,0,0,0,0,0,0,93000,12000,81000,81000
20200312,708213,群聯富邦97購02,0.28,0.28,0.17,0.17,-0.25,-59.52,165000,8,29600,0,0,0,0,0,0,25000,140000,-115000,-115000
20200312,708214,鈺太統一99購01,,,,,,0.00,0,0,0,0,0,0,0,0,0,0,0,0,0
20200312,708215,久元凱基96購01,,,,,,0.00,0,0,0,0,0,0,0,0,0,0,0,0,0
20200312,708216,勝麗凱基98購01,0.41,0.41,0.39,0.39,-0.17,-30.36,88000,2,35680,0,0,0,0,0,0,68000,20000,48000,48000
20200312,708217,碩禾凱基98購01,0.52,0.52,0.35,0.36,-0.25,-40.98,160000,10,74960,0,0,0,0,0,0,6000,154000,-148000,-148000
20200312,708218,中美晶元富96購01,0.80,0.80,0.67,0.78,-0.14,-15.22,88000,9,64600,0,0,0,0,0,0,18000,86000,-68000,-68000
20200312,708219,新普元富96購01,,,,,,0.00,0,0,0,0,0,0,0,0,0,0,0,0,0
20200312,708220,雙鴻台新97購01,,,,,,0.00,0,0,0,0,0,0,0,0,0,0,0,0,0
20200312,708221,VHQ康和96購01,0.13,0.16,0.13,0.16,-0.12,-42.86,22000,3,2910,0,0,0,0,0,0,20000,0,20000,20000
20200312,708222,網家康和96購01,0.61,0.61,0.42,0.42,-0.40,-48.78,105000,2,51130,0,0,0,0,0,0,68000,37000,31000,31000
20200312,708223,台半群益96購01,0.41,0.41,0.41,0.41,-0.08,-16.33,10000,1,4100,0,0,0,0,0,0,0,10000,-10000,-10000
20200312,708224,良維群益96購01,0.26,0.26,0.17,0.17,-0.20,-54.05,48000,4,10430,0,0,0,0,0,0,28000,20000,8000,8000
20200312,708225,昂寶群益98購01,1.96,1.96,1.96,1.96,-0.04,-2.0,10000,1,19600,0,0,0,0,0,0,0,10000,-10000,-10000
20200312,708226,信昌電群益96購03,,,,,,0.00,0,0,0,0,0,0,0,0,0,0,0,0,0
20200312,708227,鈊象群益99購04,,,,,,0.00,0,0,0,0,0,0,0,0,0,0,0,0,0
20200312,708228,波若威永豐96購01,,,,,,0.00,0,0,0,0,0,0,0,0,0,0,0,0,0
20200312,708229,中美晶亞東96購01,,,,,,0.00,0,0,0,0,0,0,0,0,0,0,0,0,0
20200312,708230,群聯亞東96購01,0.58,0.58,0.27,0.27,-0.47,-63.51,125000,10,45000,0,0,0,0,0,0,0,125000,-125000,-125000
20200312,708231,六角國票98購03,0.30,0.30,0.30,0.30,-0.08,-21.05,20000,1,6000,0,0,0,0,0,0,20000,0,20000,20000
20200312,708232,宜鼎國票97購03,1.22,1.22,0.93,0.95,-0.84,-46.93,298000,11,295530,0,0,0,0,0,0,50000,248000,-198000,-198000
20200312,708233,宣德國票97購01,0.53,0.53,0.36,0.36,-0.39,-52.0,251000,5,119180,0,0,0,0,0,0,220000,31000,189000,189000
20200312,708234,神盾國票98購01,0.35,0.35,0.35,0.35,-0.23,-39.66,10000,1,3500,0,0,0,0,0,0,0,10000,-10000,-10000
20200312,708235,璟德國票97購01,,,,,,0.00,0,0,0,0,0,0,0,0,0,0,0,0,0
20200312,708236,優群國票97購01,1.65,1.65,1.16,1.24,-0.62,-33.33,114000,14,155380,0,0,0,0,0,0,32000,82000,-50000,-50000
20200312,708237,環宇國票97購02,0.56,0.59,0.55,0.55,-0.38,-40.86,91000,3,52990,0,0,0,0,0,0,0,91000,-91000,-91000
20200312,708238,三貝德元大97購01,0.14,0.14,0.14,0.14,+0.04,40.0,4000,2,560,0,0,0,0,0,0,0,4000,-4000,-4000
20200312,708239,中美晶元大96購04,2.12,2.14,1.85,2.14,-0.28,-11.57,168000,9,335380,0,0,0,0,0,0,88000,166000,-78000,-78000
20200312,708240,宇峻元大97購02,1.28,1.28,0.97,0.97,-0.36,-27.07,22000,2,21960,0,0,0,0,0,0,22000,0,22000,22000
20200312,708241,聯亞元大97購02,1.93,2.00,1.69,1.70,-0.88,-34.11,234000,7,402060,0,0,0,0,0,0,117000,122000,-5000,-5000
20200312,708242,穩懋元大97購02,0.71,0.71,0.50,0.51,-0.34,-40.0,195000,14,114660,0,0,0,0,0,0,105000,81000,24000,24000
20200312,708243,譜瑞元大97購01,2.06,2.09,1.52,1.52,-0.77,-33.62,264000,9,440060,0,0,0,0,0,0,256000,34000,222000,222000
20200312,708244,原相國泰98購02,,,,,,0.00,0,0,0,0,0,0,0,0,0,0,0,0,0
20200312,708245,勝麗國泰98購01,0.92,0.92,0.75,0.77,-0.54,-41.22,345000,5,275440,0,0,0,0,0,0,114000,231000,-117000,-117000
20200312,708246,網家國泰97購02,1.32,1.32,0.86,0.86,-0.78,-47.56,108000,10,115480,0,0,0,0,0,0,19000,89000,-70000,-70000
20200312,708247,原相第一96購01,,,,,,0.00,0,0,0,0,0,0,0,0,0,0,0,0,0
20200312,708248,波若威凱基98購01,0.13,0.13,0.13,0.13,-0.08,-38.1,200000,2,26000,0,0,0,0,0,0,0,200000,-200000,-200000
20200312,708249,雙鴻凱基98購01,0.10,0.10,0.10,0.10,-0.02,-16.67,20000,2,2000,0,0,0,0,0,0,0,20000,-20000,-20000
20200312,708250,穩懋凱基96購12,0.32,0.32,0.19,0.19,-0.32,-62.75,22000,4,5760,0,0,0,0,0,0,10000,12000,-2000,-2000
20200312,708251,頎邦凱基97購01,0.57,0.57,0.45,0.47,-0.20,-29.85,189000,8,103760,0,0,0,0,0,0,159000,30000,129000,129000
20200312,708252,頎邦凱基97購02,,,,,,0.00,0,0,0,0,0,0,0,0,0,0,0,0,0
20200312,708253,大江元富96購02,,,,,,0.00,0,0,0,0,0,0,0,0,0,0,0,0,0
20200312,708254,頎邦元富96購01,,,,,,0.00,0,0,0,0,0,0,0,0,0,0,0,0,0
20200312,708255,頎邦元富96購02,,,,,,0.00,0,0,0,0,0,0,0,0,0,0,0,0,0
20200312,708256,信昌電永豐96購03,,,,,,0.00,0,0,0,0,0,0,0,0,0,0,0,0,0
20200312,708257,頎邦永豐96購02,,,,,,0.00,0,0,0,0,0,0,0,0,0,0,0,0,0
20200312,708258,頎邦永豐96購03,,,,,,0.00,0,0,0,0,0,0,0,0,0,0,0,0,0
20200312,708259,神盾統一96購01,0.59,0.59,0.39,0.39,-0.33,-45.83,74000,4,35960,0,0,0,0,0,0,36000,38000,-2000,-2000
20200312,708260,群聯統一98購01,1.37,1.37,0.98,0.98,-0.78,-44.32,30000,3,37000,0,0,0,0,0,0,10000,20000,-10000,-10000
20200312,708261,頎邦統一96購01,0.23,0.23,0.23,0.23,-0.15,-39.47,20000,1,4600,0,0,0,0,0,0,0,20000,-20000,-20000
20200312,708262,合晶國票97購02,,,,,,0.00,0,0,0,0,0,0,0,0,0,0,0,0,0
20200312,708263,威剛國票97購01,1.33,1.33,0.79,0.84,-0.80,-48.78,369000,19,399030,0,0,0,0,0,0,164000,205000,-41000,-41000
20200312,708264,宣德國票97購02,0.38,0.38,0.31,0.33,-0.32,-49.23,365000,4,129600,0,0,0,0,0,0,265000,100000,165000,165000
20200312,708265,聚積國票97購02,1.35,1.35,1.35,1.35,-0.24,-15.09,10000,1,13500,0,0,0,0,0,0,10000,0,10000,10000
20200312,708266,頎邦國票97購01,0.42,0.43,0.31,0.31,-0.31,-50.0,136000,5,47960,0,0,0,0,0,0,76000,60000,16000,16000
20200312,708267,M31國泰98購01,0.49,0.49,0.39,0.39,-0.35,-47.3,166000,3,72790,0,0,0,0,0,0,81000,85000,-4000,-4000
20200312,708268,聯亞國泰98購01,,,,,,0.00,0,0,0,0,0,0,0,0,0,0,0,0,0
20200312,708269,頎邦國泰97購01,,,,,,0.00,0,0,0,0,0,0,0,0,0,0,0,0,0
20200312,708270,昂寶富邦98購01,,,,,,0.00,0,0,0,0,0,0,0,0,0,0,0,0,0
20200312,708271,原相富邦98購01,1.03,1.03,0.77,0.77,-0.42,-35.29,60000,6,54200,0,0,0,0,0,0,10000,50000,-40000,-40000
20200312,708272,頎邦富邦98購01,0.32,0.32,0.29,0.29,-0.11,-27.5,20000,3,5970,0,0,0,0,0,0,7000,13000,-6000,-6000
20200312,708273,力旺元大96購02,,,,,,0.00,0,0,0,0,0,0,0,0,0,0,0,0,0
20200312,708274,中美晶元大96購05,1.78,1.78,1.23,1.62,-0.63,-28.0,76000,6,116150,0,0,0,0,0,0,0,76000,-76000,-76000
20200312,708275,六角元大98購01,0.42,0.42,0.34,0.36,-0.12,-25.0,82000,9,31780,0,0,0,0,0,0,72000,10000,62000,62000
20200312,708276,台半元大96購02,0.37,0.37,0.28,0.28,-0.17,-37.78,12000,3,3890,0,0,0,0,0,0,12000,5000,7000,7000
20200312,708277,金居元大97購01,0.44,0.45,0.31,0.32,-0.22,-40.74,230000,5,86000,0,0,0,0,0,0,100000,130000,-30000,-30000
20200312,708278,勝麗元大96購03,0.46,0.46,0.46,0.46,-0.38,-45.24,50000,1,23000,0,0,0,0,0,0,50000,0,50000,50000
20200312,708279,頎邦元大96購02,0.35,0.35,0.30,0.30,-0.16,-34.78,20000,2,6500,0,0,0,0,0,0,10000,10000,0,0
20200312,708280,頎邦元大96購03,0.61,0.61,0.46,0.46,-0.27,-36.99,101000,3,50510,0,0,0,0,0,0,33000,68000,-35000,-35000
20200312,708281,頎邦元大97購01,0.43,0.43,0.43,0.43,-0.20,-31.75,88000,1,37840,0,0,0,0,0,0,0,88000,-88000,-88000
20200312,708282,兆利群益98購01,,,,,,0.00,0,0,0,0,0,0,0,0,0,0,0,0,0
20200312,708283,頎邦群益97購01,0.55,0.56,0.43,0.43,-0.25,-36.76,384000,7,194560,0,0,0,0,0,0,352000,32000,320000,320000
20200312,708284,頎邦群益97購02,0.44,0.44,0.42,0.42,-0.15,-26.32,109000,2,47740,0,0,0,0,0,0,98000,11000,87000,87000
20200312,708285,頎邦群益98購01,0.46,0.46,0.34,0.34,-0.27,-44.26,282000,3,104730,0,0,0,0,0,0,184000,98000,86000,86000
20200312,708286,三貝德康和96購01,,,,,,0.00,0,0,0,0,0,0,0,0,0,0,0,0,0
20200312,708287,兆利康和9C購01,0.56,0.56,0.48,0.48,-0.16,-25.0,23000,3,11160,0,0,0,0,0,0,20000,3000,17000,17000
20200312,708288,富喬康和96購01,0.18,0.18,0.14,0.14,-0.14,-50.0,20000,2,3200,0,0,0,0,0,0,10000,10000,0,0
20200312,708289,杰力群益96購01,0.77,0.77,0.77,0.77,-0.20,-20.62,11000,1,8470,0,0,0,0,0,0,0,11000,-11000,-11000
20200312,708290,威剛群益97購01,0.71,0.75,0.49,0.50,-0.36,-41.86,1621000,29,991970,0,0,0,0,0,0,294000,1306000,-1012000,-1012000
20200312,708291,環宇群益98購01,0.47,0.47,0.39,0.39,-0.24,-38.1,19000,2,8530,0,0,0,0,0,0,14000,5000,9000,9000
20200312,708292,M31國票97購02,0.15,0.15,0.15,0.15,-0.20,-57.14,212000,2,31800,0,0,0,0,0,0,192000,20000,172000,172000
20200312,708293,合晶國票98購01,0.95,0.95,0.77,0.77,-0.37,-32.46,13000,2,11810,0,0,0,0,0,0,10000,3000,7000,7000
20200312,708294,良維國票97購03,0.49,0.49,0.38,0.38,-0.31,-44.93,258000,4,118740,0,0,0,0,0,0,258000,0,258000,258000
20200312,708295,昂寶國票97購04,,,,,,0.00,0,0,0,0,0,0,0,0,0,0,0,0,0
20200312,708296,威剛國票97購02,0.40,0.40,0.22,0.24,-0.28,-53.85,1705000,24,548160,0,0,0,0,0,0,612000,1083000,-471000,-471000
20200312,708297,茂達國票97購02,0.73,0.73,0.52,0.60,-0.31,-34.07,1547000,15,1005780,0,0,0,0,0,0,898000,649000,249000,249000
20200312,708298,原相國票98購02,2.14,2.36,1.60,1.60,-1.76,-52.38,146000,19,277290,0,0,0,0,0,0,132000,146000,-14000,-14000
20200312,708299,穩懋國票97購02,,,,,,0.00,0,0,0,0,0,0,0,0,0,0,0,0,0
20200312,708300,群聯日盛96購01,0.21,0.21,0.09,0.09,-0.21,-70.0,1741000,94,177540,0,0,0,0,0,0,122000,1619000,-1497000,-1497000
20200312,708301,優群永豐97購01,1.39,1.48,1.33,1.39,-0.73,-34.43,82000,7,114220,0,0,0,0,0,0,16000,65000,-49000,-49000
20200312,708302,穩懋永豐96購02,0.09,0.10,0.09,0.10,-0.16,-61.54,390000,13,37200,0,0,0,0,0,0,0,380000,-380000,-380000
20200312,708303,伍豐中信9A購01,0.17,0.17,0.14,0.14,-0.07,-33.33,125000,4,19850,0,0,0,0,0,0,15000,110000,-95000,-95000
20200312,708304,同致中信98購02,,,,,,0.00,0,0,0,0,0,0,0,0,0,0,0,0,0
20200312,708305,宜鼎中信9A購01,0.45,0.45,0.44,0.44,-0.35,-44.3,20000,2,8900,0,0,0,0,0,0,0,20000,-20000,-20000
20200312,708306,閎康統一99購01,0.22,0.22,0.17,0.19,-0.08,-29.63,49000,4,9190,0,0,0,0,0,0,30000,19000,11000,11000
20200312,708307,頎邦統一96購02,0.35,0.35,0.30,0.30,-0.20,-40.0,114000,6,37320,0,0,0,0,0,0,114000,0,114000,114000
20200312,708308,大中凱基98購01,0.23,0.23,0.23,0.23,-0.13,-36.11,10000,1,2300,0,0,0,0,0,0,10000,0,10000,10000
20200312,708309,大江凱基97購01,0.13,0.13,0.13,0.13,-0.06,-31.58,30000,1,3900,0,0,0,0,0,0,0,30000,-30000,-30000
20200312,708310,兆利凱基98購01,0.65,0.65,0.54,0.55,-0.22,-28.57,200000,5,117600,0,0,0,0,0,0,50000,150000,-100000,-100000
20200312,708311,迅得凱基97購01,,,,,,0.00,0,0,0,0,0,0,0,0,0,0,0,0,0
20200312,708312,佳邦凱基98購01,0.40,0.40,0.40,0.40,-0.09,-18.37,4000,1,1600,0,0,0,0,0,0,4000,0,4000,4000
20200312,708313,金居凱基98購01,,,,,,0.00,0,0,0,0,0,0,0,0,0,0,0,0,0
20200312,708314,聚積凱基98購01,0.39,0.41,0.39,0.41,-0.19,-31.67,43000,2,17430,0,0,0,0,0,0,33000,10000,23000,23000
20200312,708315,廣明凱基98購01,0.10,0.10,0.05,0.05,-0.06,-54.55,145000,4,10250,0,0,0,0,0,0,125000,20000,105000,105000
20200312,708316,緯軟凱基98購02,,,,,,0.00,0,0,0,0,0,0,0,0,0,0,0,0,0
20200312,708317,環宇凱基98購01,0.37,0.39,0.37,0.39,-0.19,-32.76,50000,3,18890,0,0,0,0,0,0,40000,10000,30000,30000
20200312,708318,聯亞凱基98購01,0.68,0.68,0.54,0.54,-0.50,-48.08,147000,6,79870,0,0,0,0,0,0,68000,79000,-11000,-11000
20200312,708319,穩懋凱基96購13,0.32,0.32,0.18,0.18,-0.26,-59.09,140000,6,29200,0,0,0,0,0,0,10000,130000,-120000,-120000
20200312,708320,頎邦凱基96購01,,,,,,0.00,0,0,0,0,0,0,0,0,0,0,0,0,0
20200312,708321,大學光元大97購01,1.05,1.06,0.94,0.95,-0.19,-16.67,48000,5,47380,0,0,0,0,0,0,48000,0,48000,48000
20200312,708322,群聯元大97購04,0.95,0.95,0.95,0.95,-0.81,-46.02,2000,1,1900,0,0,0,0,0,0,0,2000,-2000,-2000
20200312,708323,聯亞元大97購03,0.67,0.67,0.49,0.49,-0.39,-44.32,33000,11,17460,0,0,0,0,0,0,4000,33000,-29000,-29000
20200312,708324,新普兆豐97購01,,,,,,0.00,0,0,0,0,0,0,0,0,0,0,0,0,0
20200312,708325,穩懋兆豐97購02,1.17,1.17,0.86,0.86,-0.69,-44.52,24000,2,24980,0,0,0,0,0,0,24000,0,24000,24000
20200312,708326,大江日盛96購01,0.09,0.09,0.09,0.09,-0.06,-40.0,100000,1,9000,0,0,0,0,0,0,100000,0,100000,100000
20200312,708327,鈊象第一96購01,1.57,1.57,1.57,1.57,-0.68,-30.22,11000,2,17270,0,0,0,0,0,0,11000,11000,0,0
20200312,708328,晶焱元大97購03,0.77,0.77,0.65,0.71,-0.11,-13.41,86000,4,58940,0,0,0,0,0,0,51000,36000,15000,15000
20200312,708329,頎邦康和96購01,,,,,,0.00,0,0,0,0,0,0,0,0,0,0,0,0,0
20200312,708330,M31群益98購01,0.34,0.34,0.34,0.34,-0.16,-32.0,10000,1,3400,0,0,0,0,0,0,10000,0,10000,10000
20200312,708331,中美晶群益96購03,0.43,0.43,0.43,0.43,-0.27,-38.57,5000,1,2150,0,0,0,0,0,0,0,5000,-5000,-5000
20200312,708332,六角群益98購01,0.41,0.43,0.38,0.38,-0.17,-30.91,134000,5,56220,0,0,0,0,0,0,4000,130000,-126000,-126000
20200312,708333,宇峻群益98購01,0.68,0.70,0.52,0.53,-0.14,-20.9,645000,17,369380,0,0,0,0,0,0,317000,328000,-11000,-11000
20200312,708334,佳邦群益98購01,,,,,,0.00,0,0,0,0,0,0,0,0,0,0,0,0,0
20200312,708335,網龍群益96購01,0.10,0.10,0.10,0.10,-0.09,-47.37,250000,1,25000,0,0,0,0,0,0,250000,0,250000,250000
20200312,708336,大宇資永豐97購01,0.45,0.45,0.43,0.43,-0.14,-24.56,42000,3,18300,0,0,0,0,0,0,25000,17000,8000,8000
20200312,708337,大學光永豐96購02,,,,,,0.00,0,0,0,0,0,0,0,0,0,0,0,0,0
20200312,708338,伍豐永豐96購01,,,,,,0.00,0,0,0,0,0,0,0,0,0,0,0,0,0
20200312,708339,旺矽永豐97購02,,,,,,0.00,0,0,0,0,0,0,0,0,0,0,0,0,0
20200312,708340,昂寶永豐97購01,,,,,,0.00,0,0,0,0,0,0,0,0,0,0,0,0,0
20200312,708341,美琪瑪永豐96購02,,,,,,0.00,0,0,0,0,0,0,0,0,0,0,0,0,0
20200312,708342,群聯永豐96購02,0.06,0.06,0.03,0.03,-0.06,-66.67,300000,29,12400,0,0,0,0,0,0,0,300000,-300000,-300000
20200312,708343,網龍永豐96購04,0.03,0.03,0.03,0.03,-0.03,-50.0,20000,2,600,0,0,0,0,0,0,0,20000,-20000,-20000
20200312,708344,聯亞永豐96購03,0.10,0.10,0.08,0.08,-0.10,-55.56,120000,6,11000,0,0,0,0,0,0,70000,50000,20000,20000
20200312,708345,鈊象永豐96購05,3.96,3.96,2.62,2.62,-1.80,-40.72,170000,16,496040,0,0,0,0,0,0,88000,84000,4000,4000
20200312,708346,M31統一97購01,0.47,0.47,0.37,0.37,-0.26,-41.27,23000,4,9180,0,0,0,0,0,0,19000,4000,15000,15000
20200312,708347,環球晶統一96購02,0.48,0.49,0.48,0.49,-0.25,-33.78,22000,2,10760,0,0,0,0,0,0,22000,0,22000,22000
20200312,708348,環球晶中信96購02,0.10,0.14,0.08,0.14,-0.05,-26.32,185000,16,16550,0,0,0,0,0,0,75000,110000,-35000,-35000
20200312,708349,鈺太中信97購01,,,,,,0.00,0,0,0,0,0,0,0,0,0,0,0,0,0
20200312,708350,中美晶台新97購02,0.87,0.87,0.58,0.64,-0.33,-34.02,270000,14,200100,0,0,0,0,0,0,156000,114000,42000,42000
20200312,708351,穩懋台新97購02,0.45,0.45,0.32,0.33,-0.31,-48.44,294000,27,101760,0,0,0,0,0,0,284000,294000,-10000,-10000
20200312,708352,杰力凱基98購01,,,,,,0.00,0,0,0,0,0,0,0,0,0,0,0,0,0
20200312,708353,中美晶富邦97購03,,,,,,0.00,0,0,0,0,0,0,0,0,0,0,0,0,0
20200312,708354,合晶國票99購01,0.48,0.54,0.48,0.54,-0.22,-28.95,3000,2,1560,0,0,0,0,0,0,1000,2000,-1000,-1000
20200312,708355,昇達科國票97購01,0.30,0.30,0.30,0.30,-0.15,-33.33,2000,1,600,0,0,0,0,0,0,2000,0,2000,2000
20200312,708356,信昌電國票97購03,,,,,,0.00,0,0,0,0,0,0,0,0,0,0,0,0,0
20200312,708357,神盾國票97購03,1.13,1.13,1.03,1.03,-0.38,-26.95,48000,2,50440,0,0,0,0,0,0,10000,38000,-28000,-28000
20200312,708358,群聯國票97購02,0.30,0.30,0.17,0.17,-0.47,-73.44,102000,3,17500,0,0,0,0,0,0,0,102000,-102000,-102000
20200312,708359,中美晶國泰97購02,1.08,1.08,0.83,0.83,-0.44,-34.65,3000,3,2940,0,0,0,0,0,0,3000,0,3000,3000
20200312,708360,宇峻國泰97購01,0.59,0.61,0.44,0.47,-0.15,-24.19,438000,12,212330,0,0,0,0,0,0,243000,193000,50000,50000
20200312,708361,鈊象國泰98購02,4.80,4.80,4.16,4.16,-1.74,-29.49,110000,6,484600,0,0,0,0,0,0,60000,50000,10000,10000
20200312,708362,環球晶統一96購04,0.90,0.90,0.58,0.90,-0.27,-23.08,138000,6,99760,0,0,0,0,0,0,68000,70000,-2000,-2000
20200312,708363,台燿中信98購01,0.50,0.53,0.48,0.48,-0.16,-25.0,40000,3,20050,0,0,0,0,0,0,40000,0,40000,40000
20200312,708364,新普中信98購01,0.53,0.53,0.50,0.50,-0.09,-15.25,30000,2,15600,0,0,0,0,0,0,10000,20000,-10000,-10000
20200312,708365,凡甲凱基97購01,0.65,0.65,0.53,0.58,-0.19,-24.68,38000,5,22400,0,0,0,0,0,0,10000,28000,-18000,-18000
20200312,708366,中美晶凱基97購01,0.66,0.66,0.45,0.58,-0.25,-30.12,823000,13,455940,0,0,0,0,0,0,60000,763000,-703000,-703000
20200312,708367,良維凱基97購02,,,,,,0.00,0,0,0,0,0,0,0,0,0,0,0,0,0
20200312,708368,宣德凱基97購01,0.74,0.74,0.58,0.58,-0.34,-36.96,169000,4,106040,0,0,0,0,0,0,69000,100000,-31000,-31000
20200312,708369,雙美凱基98購01,,,,,,0.00,0,0,0,0,0,0,0,0,0,0,0,0,0
20200312,708370,中美晶元大96購06,1.28,1.28,1.28,1.28,-0.32,-20.0,2000,1,2560,0,0,0,0,0,0,2000,0,2000,2000
20200312,708371,信昌電元大96購04,0.20,0.20,0.20,0.20,-0.10,-33.33,20000,1,4000,0,0,0,0,0,0,20000,0,20000,20000
20200312,708372,優群元大97購03,2.57,2.57,1.99,2.05,-0.81,-28.32,43000,4,92450,0,0,0,0,0,0,43000,24000,19000,19000
20200312,708373,中美晶元富96購02,0.31,0.31,0.21,0.26,-0.11,-29.73,604000,26,154360,0,0,0,0,0,0,330000,296000,34000,34000
20200312,708374,久元台新96購01,0.47,0.47,0.47,0.47,-0.07,-12.96,6000,1,2820,0,0,0,0,0,0,6000,0,6000,6000
20200312,708375,久元台新96購02,,,,,,0.00,0,0,0,0,0,0,0,0,0,0,0,0,0
20200312,708376,台半台新96購01,0.25,0.25,0.25,0.25,-0.07,-21.88,10000,1,2500,0,0,0,0,0,0,10000,0,10000,10000
20200312,708377,鈊象台新96購02,,,,,,0.00,0,0,0,0,0,0,0,0,0,0,0,0,0
20200312,708378,頎邦台新97購01,0.41,0.41,0.38,0.38,-0.16,-29.63,97000,7,37660,0,0,0,0,0,0,87000,10000,77000,77000
20200312,708379,穩懋亞東98購01,,,,,,0.00,0,0,0,0,0,0,0,0,0,0,0,0,0
20200312,708380,台半永豐96購01,0.19,0.19,0.19,0.19,-0.09,-32.14,400000,1,76000,0,0,0,0,0,0,400000,0,400000,400000
20200312,708381,亞泰永豐96購01,,,,,,0.00,0,0,0,0,0,0,0,0,0,0,0,0,0
20200312,708382,宜鼎永豐96購02,,,,,,0.00,0,0,0,0,0,0,0,0,0,0,0,0,0
20200312,708383,信昌電永豐96購04,,,,,,0.00,0,0,0,0,0,0,0,0,0,0,0,0,0
20200312,708384,雍智永豐97購01,,,,,,0.00,0,0,0,0,0,0,0,0,0,0,0,0,0
20200312,708385,碩禾永豐96購02,,,,,,0.00,0,0,0,0,0,0,0,0,0,0,0,0,0
20200312,708386,雙鴻永豐97購03,,,,,,0.00,0,0,0,0,0,0,0,0,0,0,0,0,0
20200312,708387,瓦城康和96購01,0.35,0.36,0.35,0.36,-0.08,-18.18,81000,2,28360,0,0,0,0,0,0,81000,0,81000,81000
20200312,708388,三貝德群益96購02,,,,,,0.00,0,0,0,0,0,0,0,0,0,0,0,0,0
20200312,708389,台半群益96購02,0.49,0.49,0.49,0.49,-0.10,-16.95,11000,1,5390,0,0,0,0,0,0,0,11000,-11000,-11000
20200312,708390,美琪瑪群益96購01,,,,,,0.00,0,0,0,0,0,0,0,0,0,0,0,0,0
20200312,708391,原相群益98購02,1.56,1.64,1.16,1.16,-0.79,-40.51,582000,42,818840,0,0,0,0,0,0,370000,263000,107000,107000
20200312,708392,大江國票97購05,0.17,0.17,0.11,0.12,-0.12,-50.0,340000,4,53100,0,0,0,0,0,0,10000,330000,-320000,-320000
20200312,708393,信昌電國泰98購01,0.53,0.53,0.43,0.43,-0.26,-37.68,82000,3,36460,0,0,0,0,0,0,10000,72000,-62000,-62000
20200312,708394,威剛國泰98購01,0.53,0.53,0.39,0.40,-0.21,-34.43,171000,16,78500,0,0,0,0,0,0,64000,104000,-40000,-40000
20200312,708395,環球晶國泰97購03,1.47,1.51,0.84,1.51,-0.14,-8.48,444000,13,546040,0,0,0,0,0,0,142000,311000,-169000,-169000
20200312,708396,信昌電富邦98購01,0.23,0.23,0.17,0.18,-0.11,-37.93,67000,8,13060,0,0,0,0,0,0,34000,23000,11000,11000
20200312,708397,群聯富邦97購03,0.10,0.10,0.07,0.07,-0.06,-46.15,561000,13,55870,0,0,0,0,0,0,0,540000,-540000,-540000
20200312,708398,環球晶富邦99購01,0.71,0.71,0.62,0.66,-0.22,-25.0,19000,5,12250,0,0,0,0,0,0,12000,7000,5000,5000
20200312,708399,穩懋富邦97購03,0.59,0.59,0.45,0.45,-0.31,-40.79,159000,6,76790,0,0,0,0,0,0,89000,70000,19000,19000
20200312,708400,建榮國票98購01,0.10,0.10,0.10,0.10,-0.06,-37.5,350000,7,35000,0,0,0,0,0,0,350000,0,350000,350000
20200312,708401,威剛國泰98購02,2.14,2.14,1.37,1.45,-0.98,-40.33,700000,27,1108030,0,0,0,0,0,0,222000,605000,-383000,-383000
20200312,708402,優群國泰99購01,,,,,,0.00,0,0,0,0,0,0,0,0,0,0,0,0,0
20200312,708403,合晶元大98購02,0.99,0.99,0.90,0.90,-0.24,-21.05,94000,3,86780,0,0,0,0,0,0,26000,76000,-50000,-50000
20200312,708404,聖暉元大97購01,1.37,1.37,1.23,1.32,-0.20,-13.16,236000,14,311440,0,0,0,0,0,0,134000,102000,32000,32000
20200312,708405,頎邦元大97購02,0.60,0.60,0.55,0.55,-0.14,-20.29,103000,3,60200,0,0,0,0,0,0,35000,68000,-33000,-33000
20200312,708406,昂寶元富97購01,,,,,,0.00,0,0,0,0,0,0,0,0,0,0,0,0,0
20200312,708407,環球晶元富97購01,0.75,0.75,0.53,0.73,-0.21,-22.34,40000,4,26000,0,0,0,0,0,0,30000,10000,20000,20000
20200312,708408,雙鴻統一97購01,,,,,,0.00,0,0,0,0,0,0,0,0,0,0,0,0,0
20200312,708409,精測中信97購01,0.06,0.06,0.06,0.06,-0.03,-33.33,12000,2,720,0,0,0,0,0,0,0,12000,-12000,-12000
20200312,708410,頎邦中信9B購01,0.17,0.17,0.13,0.13,-0.08,-38.1,70000,6,10900,0,0,0,0,0,0,20000,50000,-30000,-30000
20200312,708411,宜鼎凱基99購01,0.20,0.20,0.20,0.20,-0.17,-45.95,10000,1,2000,0,0,0,0,0,0,0,10000,-10000,-10000
20200312,708412,直得凱基98購01,0.40,0.40,0.25,0.26,-0.16,-38.1,370000,7,132000,0,0,0,0,0,0,323000,47000,276000,276000
20200312,708413,信昌電凱基98購01,,,,,,0.00,0,0,0,0,0,0,0,0,0,0,0,0,0
20200312,708414,群聯凱基98購01,0.20,0.20,0.20,0.20,-0.12,-37.5,11000,2,2200,0,0,0,0,0,0,0,0,0,0
20200312,708415,VHQ永豐97購01,,,,,,0.00,0,0,0,0,0,0,0,0,0,0,0,0,0
20200312,708416,大宇資永豐99購01,0.51,0.51,0.31,0.31,-0.32,-50.79,55000,4,26700,0,0,0,0,0,0,35000,17000,18000,18000
20200312,708417,長科*永豐97購01,0.21,0.21,0.21,0.21,-0.05,-19.23,90000,1,18900,0,0,0,0,0,0,90000,0,90000,90000
20200312,708418,廣明永豐97購01,0.01,0.01,0.01,0.01,-0.02,-66.67,20000,2,200,0,0,0,0,0,0,0,20000,-20000,-20000
20200312,708419,環宇永豐98購01,,,,,,0.00,0,0,0,0,0,0,0,0,0,0,0,0,0
20200312,708420,宜鼎群益98購01,0.65,0.65,0.45,0.45,-0.34,-43.04,241000,8,120380,0,0,0,0,0,0,119000,119000,0,0
20200312,708421,群聯群益98購01,0.74,0.74,0.38,0.40,-0.65,-61.9,39000,10,20070,0,0,0,0,0,0,22000,28000,-6000,-6000
20200312,708422,群聯群益99購01,0.54,0.57,0.28,0.29,-0.57,-66.28,272000,9,120500,0,0,0,0,0,0,137000,135000,2000,2000
20200312,708423,世界麥證97購01,0.37,0.37,0.37,0.37,-0.10,-21.28,2000,1,740,0,2000,-2000,0,0,0,0,2000,-2000,-2000
20200312,708424,原相台新97購02,1.11,1.11,1.11,1.11,-0.34,-23.45,1000,1,1110,0,0,0,0,0,0,0,1000,-1000,-1000
20200312,708425,新鉅科台新98購01,0.10,0.10,0.09,0.09,-0.03,-25.0,30000,2,2800,0,0,0,0,0,0,0,20000,-20000,-20000
20200312,708426,群聯台新97購03,,,,,,0.00,0,0,0,0,0,0,0,0,0,0,0,0,0
20200312,708427,聯亞台新97購01,,,,,,0.00,0,0,0,0,0,0,0,0,0,0,0,0,0
20200312,708428,鈺太台新97購01,,,,,,0.00,0,0,0,0,0,0,0,0,0,0,0,0,0
20200312,708429,群聯統一97購01,0.58,0.60,0.42,0.42,-0.40,-48.78,68000,4,35520,0,0,0,0,0,0,0,68000,-68000,-68000
20200312,708430,兆利中信9A購01,0.20,0.22,0.20,0.22,-0.15,-40.54,115000,3,25050,0,0,0,0,0,0,15000,100000,-85000,-85000
20200312,708431,原相中信99購01,1.32,1.32,0.72,0.94,-0.50,-34.72,681000,34,770440,0,0,0,0,0,0,318000,362000,-44000,-44000
20200312,708432,廣明中信9B購01,0.05,0.05,0.03,0.04,-0.03,-42.86,490000,34,17840,0,0,0,0,0,0,215000,270000,-55000,-55000
20200312,708433,穩懋中信99購01,0.40,0.40,0.32,0.32,-0.23,-41.82,142000,12,49170,0,0,0,0,0,0,32000,110000,-78000,-78000
20200312,708434,合晶凱基98購01,0.25,0.25,0.25,0.25,-0.19,-43.18,20000,1,5000,0,0,0,0,0,0,0,20000,-20000,-20000
20200312,708435,勝麗凱基97購02,,,,,,0.00,0,0,0,0,0,0,0,0,0,0,0,0,0
20200312,708436,博智凱基97購01,3.10,3.31,2.48,2.48,-1.65,-39.95,29000,9,83700,0,0,0,0,0,0,18000,11000,7000,7000
20200312,708437,穩懋日盛97購01,0.34,0.34,0.34,0.34,-0.27,-44.26,10000,1,3400,0,0,0,0,0,0,0,10000,-10000,-10000
20200312,708438,中美晶亞東97購01,,,,,,0.00,0,0,0,0,0,0,0,0,0,0,0,0,0
20200312,708439,合晶亞東97購02,,,,,,0.00,0,0,0,0,0,0,0,0,0,0,0,0,0
20200312,708440,大田元富97購01,,,,,,0.00,0,0,0,0,0,0,0,0,0,0,0,0,0
20200312,708441,榮剛元富97購01,0.51,0.51,0.45,0.45,-0.10,-18.18,143000,5,70990,0,0,0,0,0,0,133000,10000,123000,123000
20200312,708442,聯亞台新99購01,0.41,0.41,0.32,0.33,-0.23,-41.07,174000,3,62980,0,0,0,0,0,0,4000,170000,-166000,-166000
20200312,708443,昂寶元大9A購01,,,,,,0.00,0,0,0,0,0,0,0,0,0,0,0,0,0
20200312,708444,威剛元大99購01,0.63,0.64,0.44,0.46,-0.24,-34.29,534000,45,279960,0,0,0,0,0,0,295000,360000,-65000,-65000
20200312,708445,神盾元大99購02,,,,,,0.00,0,0,0,0,0,0,0,0,0,0,0,0,0
20200312,708446,聯亞元大97購04,0.82,0.82,0.82,0.82,-0.55,-40.15,2000,1,1640,0,0,0,0,0,0,2000,2000,0,0
20200312,708447,鈺太元大99購01,0.45,0.45,0.36,0.36,-0.18,-33.33,71000,6,27090,0,0,0,0,0,0,17000,54000,-37000,-37000
20200312,708448,大中永豐97購01,,,,,,0.00,0,0,0,0,0,0,0,0,0,0,0,0,0
20200312,708449,大江永豐97購02,,,,,,0.00,0,0,0,0,0,0,0,0,0,0,0,0,0
20200312,708450,六角永豐97購01,0.15,0.15,0.12,0.12,-0.07,-36.84,38000,2,4800,0,0,0,0,0,0,8000,30000,-22000,-22000
20200312,708451,兆利永豐97購01,,,,,,0.00,0,0,0,0,0,0,0,0,0,0,0,0,0
20200312,708452,波若威永豐98購01,,,,,,0.00,0,0,0,0,0,0,0,0,0,0,0,0,0
20200312,708453,宣德永豐97購02,0.36,0.36,0.36,0.36,-0.07,-16.28,100000,1,36000,0,0,0,0,0,0,0,100000,-100000,-100000
20200312,708454,建榮永豐99購01,,,,,,0.00,0,0,0,0,0,0,0,0,0,0,0,0,0
20200312,708455,森鉅永豐97購01,,,,,,0.00,0,0,0,0,0,0,0,0,0,0,0,0,0
20200312,708456,榮剛永豐97購01,0.34,0.34,0.32,0.32,-0.07,-17.95,68000,2,22920,0,0,0,0,0,0,0,68000,-68000,-68000
20200312,708457,廣積永豐97購01,0.61,0.61,0.61,0.61,-0.10,-14.08,10000,1,6100,0,0,0,0,0,0,10000,0,10000,10000
20200312,708458,旺矽群益9A購01,,,,,,0.00,0,0,0,0,0,0,0,0,0,0,0,0,0
20200312,708459,昇達科群益98購01,,,,,,0.00,0,0,0,0,0,0,0,0,0,0,0,0,0
20200312,708460,櫃200群益97購01,,,,,,0.00,0,0,0,0,0,0,0,0,0,0,0,0,0
20200312,708461,櫃200群益97購02,,,,,,0.00,0,0,0,0,0,0,0,0,0,0,0,0,0
20200312,708462,中美晶元大97購03,1.84,1.84,1.59,1.59,-0.45,-22.06,54000,8,94930,0,0,0,0,0,0,44000,54000,-10000,-10000
20200312,708463,宜鼎元大97購01,0.81,0.81,0.64,0.64,-0.73,-53.28,336000,6,223880,0,0,0,0,0,0,10000,326000,-316000,-316000
20200312,708464,昂寶元大98購01,1.07,1.07,1.07,1.07,-0.02,-1.83,3000,1,3210,0,0,0,0,0,0,3000,0,3000,3000
20200312,708465,璟德元大97購01,,,,,,0.00,0,0,0,0,0,0,0,0,0,0,0,0,0
20200312,708466,璟德元大97購02,0.36,0.36,0.36,0.36,-0.24,-40.0,70000,1,25200,0,0,0,0,0,0,70000,0,70000,70000
20200312,708467,優群元大97購04,2.26,2.26,2.10,2.10,-0.69,-24.73,9000,3,19730,0,0,0,0,0,0,9000,1000,8000,8000
20200312,708468,兆利康和97購01,,,,,,0.00,0,0,0,0,0,0,0,0,0,0,0,0,0
20200312,708469,璟德康和97購01,,,,,,0.00,0,0,0,0,0,0,0,0,0,0,0,0,0
20200312,708470,璟德元富97購01,,,,,,0.00,0,0,0,0,0,0,0,0,0,0,0,0,0
20200312,708471,璟德台新97購01,,,,,,0.00,0,0,0,0,0,0,0,0,0,0,0,0,0
20200312,708472,三貝德凱基99購01,0.08,0.12,0.07,0.12,0.00,0.0,517000,42,47840,0,0,0,0,0,0,25000,370000,-345000,-345000
20200312,708473,大田凱基98購01,,,,,,0.00,0,0,0,0,0,0,0,0,0,0,0,0,0
20200312,708474,中美晶凱基97購02,,,,,,0.00,0,0,0,0,0,0,0,0,0,0,0,0,0
20200312,708475,宇峻凱基9A購01,0.31,0.31,0.22,0.26,-0.07,-21.21,525000,9,134100,0,0,0,0,0,0,220000,305000,-85000,-85000
20200312,708476,網龍凱基98購01,,,,,,0.00,0,0,0,0,0,0,0,0,0,0,0,0,0
20200312,708477,鈊象凱基99購01,3.65,3.65,2.70,2.70,-1.25,-31.65,63000,9,191240,0,0,0,0,0,0,2000,63000,-61000,-61000
20200312,708478,穩懋日盛97購02,,,,,,0.00,0,0,0,0,0,0,0,0,0,0,0,0,0
20200312,708479,立端永豐97購01,0.18,0.18,0.13,0.13,-0.13,-50.0,12000,2,1660,0,0,0,0,0,0,2000,10000,-8000,-8000
20200312,708480,宇峻永豐97購01,,,,,,0.00,0,0,0,0,0,0,0,0,0,0,0,0,0
20200312,708481,迅得永豐97購03,,,,,,0.00,0,0,0,0,0,0,0,0,0,0,0,0,0
20200312,708482,神盾永豐97購01,0.19,0.19,0.19,0.19,-0.07,-26.92,8000,1,1520,0,0,0,0,0,0,8000,0,8000,8000
20200312,708483,璟德永豐97購02,,,,,,0.00,0,0,0,0,0,0,0,0,0,0,0,0,0
20200312,708484,璟德國泰98購01,0.53,0.53,0.53,0.53,-0.18,-25.35,42000,1,22260,0,0,0,0,0,0,42000,0,42000,42000
20200312,708485,六角國票97購01,0.43,0.43,0.31,0.31,-0.24,-43.64,340000,6,120000,0,0,0,0,0,0,220000,120000,100000,100000
20200312,708486,昂寶國票98購01,,,,,,0.00,0,0,0,0,0,0,0,0,0,0,0,0,0
20200312,708487,信昌電國票98購01,0.51,0.51,0.51,0.51,-0.35,-40.7,10000,1,5100,0,0,0,0,0,0,0,10000,-10000,-10000
20200312,708488,威剛國票98購01,1.23,1.23,0.79,0.79,-0.87,-52.41,300000,18,297970,0,0,0,0,0,0,107000,193000,-86000,-86000
20200312,708489,群聯國票98購01,0.65,0.69,0.36,0.41,-0.60,-59.41,622000,24,276630,0,0,0,0,0,0,20000,602000,-582000,-582000
20200312,708490,雍智國票98購01,0.40,0.40,0.33,0.33,-0.18,-35.29,41000,4,14670,0,0,0,0,0,0,0,41000,-41000,-41000
20200312,708491,雙美國票99購01,,,,,,0.00,0,0,0,0,0,0,0,0,0,0,0,0,0
20200312,708492,雙鴻國票98購02,,,,,,0.00,0,0,0,0,0,0,0,0,0,0,0,0,0
20200312,708493,鈊象國票98購01,16.30,16.30,16.30,16.30,-3.00,-15.54,3000,1,48900,0,0,0,0,0,0,3000,0,3000,3000
20200312,708494,大江群益97購02,0.18,0.19,0.12,0.14,-0.12,-46.15,725000,9,97000,0,0,0,0,0,0,590000,135000,455000,455000
20200312,708495,信昌電群益97購01,,,,,,0.00,0,0,0,0,0,0,0,0,0,0,0,0,0
20200312,708496,建榮群益99購01,,,,,,0.00,0,0,0,0,0,0,0,0,0,0,0,0,0
20200312,708497,原相群益99購01,1.31,1.31,1.12,1.12,-0.42,-27.27,284000,13,356410,0,0,0,0,0,0,140000,118000,22000,22000
20200312,708498,勝麗群益98購01,0.47,0.47,0.43,0.43,-0.22,-33.85,79000,2,37050,0,0,0,0,0,0,77000,2000,75000,75000
20200312,708499,璟德群益98購01,,,,,,0.00,0,0,0,0,0,0,0,0,0,0,0,0,0
20200312,708500,鈊象群益99購05,6.55,6.55,6.20,6.20,-2.20,-26.19,6000,2,38600,0,0,0,0,0,0,0,6000,-6000,-6000
20200312,708501,力致元大97購01,0.16,0.16,0.10,0.10,-0.13,-56.52,210000,3,22850,0,0,0,0,0,0,150000,60000,90000,90000
20200312,708502,中美晶元大97購04,,,,,,0.00,0,0,0,0,0,0,0,0,0,0,0,0,0
20200312,708503,世禾元大97購01,0.21,0.21,0.21,0.21,-0.13,-38.24,25000,1,5250,0,0,0,0,0,0,25000,0,25000,25000
20200312,708504,尼克森元大97購01,0.38,0.38,0.28,0.28,-0.34,-54.84,15000,2,5200,0,0,0,0,0,0,15000,0,15000,15000
20200312,708505,宇峻元大97購03,0.94,1.03,0.74,0.74,-0.20,-21.28,234000,16,205080,0,0,0,0,0,0,234000,0,234000,234000
20200312,708506,信昌電元大98購01,,,,,,0.00,0,0,0,0,0,0,0,0,0,0,0,0,0
20200312,708507,碩禾元大98購02,0.22,0.22,0.19,0.20,-0.10,-33.33,300000,6,59900,0,0,0,0,0,0,150000,150000,0,0
20200312,708508,雙鴻元大99購02,,,,,,0.00,0,0,0,0,0,0,0,0,0,0,0,0,0
20200312,708509,尼克森統一99購01,0.34,0.34,0.33,0.33,-0.16,-32.65,30000,2,10050,0,0,0,0,0,0,0,30000,-30000,-30000
20200312,708510,尼克森統一99購02,0.12,0.12,0.10,0.10,-0.09,-47.37,110000,2,11200,0,0,0,0,0,0,110000,0,110000,110000
20200312,708511,迅得統一99購01,,,,,,0.00,0,0,0,0,0,0,0,0,0,0,0,0,0
20200312,708512,頎邦統一97購01,0.26,0.26,0.24,0.24,-0.18,-42.86,138000,2,35280,0,0,0,0,0,0,30000,108000,-78000,-78000
20200312,708513,M31中信98購01,0.22,0.22,0.22,0.22,-0.08,-26.67,2000,1,440,0,0,0,0,0,0,2000,0,2000,2000
20200312,708514,大中中信97購01,,,,,,0.00,0,0,0,0,0,0,0,0,0,0,0,0,0
20200312,708515,宇峻中信97購01,0.18,0.20,0.10,0.13,-0.10,-43.48,731000,13,101770,0,0,0,0,0,0,295000,436000,-141000,-141000
20200312,708516,博智中信97購01,1.60,1.60,1.19,1.30,-0.54,-29.35,122000,5,148000,0,0,0,0,0,0,102000,0,102000,102000
20200312,708517,大中凱基98購02,,,,,,0.00,0,0,0,0,0,0,0,0,0,0,0,0,0
20200312,708518,同致凱基98購01,,,,,,0.00,0,0,0,0,0,0,0,0,0,0,0,0,0
20200312,708519,合晶凱基97購02,,,,,,0.00,0,0,0,0,0,0,0,0,0,0,0,0,0
20200312,708520,朋億凱基97購01,0.50,0.50,0.48,0.48,-0.14,-22.58,18000,2,8820,0,0,0,0,0,0,9000,9000,0,0
20200312,708521,南光凱基97購01,0.59,0.63,0.58,0.58,-0.47,-44.76,195000,4,115150,0,0,0,0,0,0,180000,15000,165000,165000
20200312,708522,緯軟凱基98購03,,,,,,0.00,0,0,0,0,0,0,0,0,0,0,0,0,0
20200312,708523,大江兆豐97購01,,,,,,0.00,0,0,0,0,0,0,0,0,0,0,0,0,0
20200312,708524,中美晶兆豐98購01,0.25,0.26,0.21,0.24,-0.07,-22.58,305000,11,71500,0,0,0,0,0,0,265000,30000,235000,235000
20200312,708525,台燿兆豐97購02,0.57,0.57,0.40,0.40,-0.35,-46.67,55000,4,27720,0,0,0,0,0,0,35000,20000,15000,15000
20200312,708526,精華兆豐98購01,0.64,0.64,0.45,0.49,-0.27,-35.53,70000,5,37300,0,0,0,0,0,0,0,70000,-70000,-70000
20200312,708527,中美晶群益97購03,0.36,0.36,0.33,0.33,-0.09,-21.43,30000,2,10500,0,0,0,0,0,0,30000,0,30000,30000
20200312,708528,太景*群益98購01,0.75,0.75,0.45,0.55,-0.29,-34.52,624000,21,345690,0,0,0,0,0,0,507000,78000,429000,429000
20200312,708529,立端群益97購01,0.24,0.24,0.17,0.17,-0.15,-46.88,750000,12,165850,11000,0,11000,0,0,0,548000,202000,346000,357000
20200312,708530,朋億群益98購01,0.77,0.78,0.74,0.75,-0.14,-15.73,350000,19,265490,0,0,0,0,0,0,265000,70000,195000,195000
20200312,708531,欣銓群益98購01,0.41,0.41,0.33,0.33,-0.16,-32.65,381000,4,139280,0,0,0,0,0,0,295000,86000,209000,209000
20200312,708532,群聯群益97購02,0.12,0.12,0.12,0.12,-0.07,-36.84,60000,6,7200,0,0,0,0,0,0,0,60000,-60000,-60000
20200312,708533,緯軟群益98購01,,,,,,0.00,0,0,0,0,0,0,0,0,0,0,0,0,0
20200312,708534,環球晶群益97購03,0.36,0.38,0.23,0.38,-0.05,-11.63,451000,47,128480,0,0,0,0,0,0,37000,414000,-377000,-377000
20200312,708535,譜瑞群益97購01,2.00,2.00,1.85,1.85,-0.90,-32.73,8000,2,15550,0,0,0,0,0,0,0,8000,-8000,-8000
20200312,708536,建榮國票98購02,,,,,,0.00,0,0,0,0,0,0,0,0,0,0,0,0,0
20200312,708537,力致國泰99購01,,,,,,0.00,0,0,0,0,0,0,0,0,0,0,0,0,0
20200312,708538,凡甲國泰99購01,0.77,0.77,0.66,0.68,-0.13,-16.05,365000,13,251710,0,0,0,0,0,0,355000,10000,345000,345000
20200312,708539,中菲行國泰98購01,0.74,0.74,0.74,0.74,-0.16,-17.78,15000,1,11100,0,0,0,0,0,0,15000,0,15000,15000
20200312,708540,世禾國泰98購01,0.37,0.37,0.24,0.24,-0.18,-42.86,265000,6,88850,0,0,0,0,0,0,205000,60000,145000,145000
20200312,708541,尼克森國泰99購01,0.57,0.57,0.38,0.42,-0.20,-32.26,309000,13,124110,0,0,0,0,0,0,20000,289000,-269000,-269000
20200312,708542,幃翔國泰98購01,0.15,0.15,0.12,0.12,-0.12,-50.0,110000,3,15200,0,0,0,0,0,0,0,110000,-110000,-110000
20200312,708543,幃翔國泰98購02,,,,,,0.00,0,0,0,0,0,0,0,0,0,0,0,0,0
20200312,708544,群聯國泰99購01,0.65,0.65,0.34,0.36,-0.39,-52.0,833000,51,372110,0,0,0,0,0,0,179000,700000,-521000,-521000
20200312,708545,雙鴻國泰99購01,0.53,0.53,0.35,0.35,-0.25,-41.67,301000,7,127990,0,0,0,0,0,0,260000,41000,219000,219000
20200312,708546,力致永豐97購01,0.08,0.08,0.06,0.06,-0.06,-50.0,20000,3,1500,0,0,0,0,0,0,15000,5000,10000,10000
20200312,708547,世禾永豐97購01,,,,,,0.00,0,0,0,0,0,0,0,0,0,0,0,0,0
20200312,708548,尼克森永豐97購01,,,,,,0.00,0,0,0,0,0,0,0,0,0,0,0,0,0
20200312,708549,立敦永豐97購01,0.17,0.17,0.17,0.17,-0.05,-22.73,68000,1,11560,0,0,0,0,0,0,0,68000,-68000,-68000
20200312,708550,同亨永豐97購01,0.24,0.24,0.19,0.19,-0.08,-29.63,1264000,22,264540,0,0,0,0,0,0,358000,906000,-548000,-548000
20200312,708551,直得永豐97購01,0.25,0.25,0.25,0.25,-0.10,-28.57,15000,1,3750,0,0,0,0,0,0,15000,0,15000,15000
20200312,708552,南光永豐97購01,0.64,0.64,0.39,0.39,-0.29,-42.65,384000,8,166060,0,0,0,0,0,0,149000,225000,-76000,-76000
20200312,708553,威剛永豐98購01,0.75,0.75,0.54,0.57,-0.42,-42.42,185000,3,107550,0,0,0,0,0,0,35000,150000,-115000,-115000
20200312,708554,幃翔永豐97購01,,,,,,0.00,0,0,0,0,0,0,0,0,0,0,0,0,0
20200312,708555,新潤永豐97購01,0.21,0.21,0.15,0.15,-0.11,-42.31,114000,14,19400,0,0,0,0,0,0,4000,110000,-106000,-106000
20200312,708556,網龍永豐97購01,,,,,,0.00,0,0,0,0,0,0,0,0,0,0,0,0,0
20200312,708557,緯軟永豐97購01,,,,,,0.00,0,0,0,0,0,0,0,0,0,0,0,0,0
20200312,708558,環球晶永豐97購01,0.26,0.28,0.22,0.28,-0.11,-28.21,95000,9,25300,0,0,0,0,0,0,10000,85000,-75000,-75000
20200312,708559,聯上永豐97購01,,,,,,0.00,0,0,0,0,0,0,0,0,0,0,0,0,0
20200312,708560,大中康和97購01,,,,,,0.00,0,0,0,0,0,0,0,0,0,0,0,0,0
20200312,708561,亞泰康和97購01,,,,,,0.00,0,0,0,0,0,0,0,0,0,0,0,0,0
20200312,708562,博智康和97購01,,,,,,0.00,0,0,0,0,0,0,0,0,0,0,0,0,0
20200312,708563,力致元富97購01,,,,,,0.00,0,0,0,0,0,0,0,0,0,0,0,0,0
20200312,708564,中菲行元富97購01,0.41,0.41,0.41,0.41,-0.09,-18.0,119000,2,48790,0,0,0,0,0,0,119000,0,119000,119000
20200312,708565,太景*元富97購01,1.49,1.54,0.96,0.96,-0.70,-42.17,281000,31,317510,0,0,0,0,0,0,0,281000,-281000,-281000
20200312,708566,世禾元富97購01,,,,,,0.00,0,0,0,0,0,0,0,0,0,0,0,0,0
20200312,708567,尼克森元富97購01,0.16,0.18,0.16,0.18,-0.10,-35.71,32000,2,5660,0,0,0,0,0,0,32000,0,32000,32000
20200312,708568,幃翔元富97購01,,,,,,0.00,0,0,0,0,0,0,0,0,0,0,0,0,0
20200312,708569,力致統一97購01,,,,,,0.00,0,0,0,0,0,0,0,0,0,0,0,0,0
20200312,708570,力致統一97購02,0.05,0.06,0.05,0.06,-0.17,-73.91,100000,6,5800,0,0,0,0,0,0,0,100000,-100000,-100000
20200312,708571,環球晶統一97購01,,,,,,0.00,0,0,0,0,0,0,0,0,0,0,0,0,0
20200312,708572,兆利凱基98購02,,,,,,0.00,0,0,0,0,0,0,0,0,0,0,0,0,0
20200312,708573,昂寶凱基98購02,,,,,,0.00,0,0,0,0,0,0,0,0,0,0,0,0,0
20200312,708574,威剛凱基99購01,0.37,0.37,0.36,0.36,-0.22,-37.93,30000,2,11000,0,0,0,0,0,0,0,30000,-30000,-30000
20200312,708575,精測凱基98購01,0.26,0.26,0.23,0.23,-0.11,-32.35,70000,2,16700,0,0,0,0,0,0,70000,0,70000,70000
20200312,708576,聯亞凱基99購01,0.17,0.18,0.12,0.13,-0.10,-43.48,455000,41,63240,0,0,0,0,0,0,86000,369000,-283000,-283000
20200312,708577,頎邦凱基97購03,,,,,,0.00,0,0,0,0,0,0,0,0,0,0,0,0,0
20200312,708578,中美晶麥證97購01,0.84,0.84,0.84,0.84,-0.25,-22.94,20000,2,16800,20000,0,20000,0,0,0,20000,0,20000,20000
20200312,708579,原相麥證97購01,,,,,,0.00,0,0,0,0,0,0,0,0,0,0,0,0,0
20200312,708580,神盾元富97購01,,,,,,0.00,0,0,0,0,0,0,0,0,0,0,0,0,0
20200312,708581,神盾元富97購02,0.30,0.30,0.30,0.30,-0.15,-33.33,150000,1,45000,0,0,0,0,0,0,0,150000,-150000,-150000
20200312,708582,宇峻元大97購04,0.65,0.70,0.63,0.63,+0.01,1.61,32000,4,21160,0,0,0,0,0,0,2000,30000,-28000,-28000
20200312,708583,亞泰元大97購01,0.57,0.57,0.50,0.50,-0.13,-20.63,45000,8,24550,0,0,0,0,0,0,0,45000,-45000,-45000
20200312,708584,威剛元大98購02,0.60,0.61,0.43,0.47,-0.25,-34.72,236000,25,114320,0,0,0,0,0,0,16000,230000,-214000,-214000
20200312,708585,建榮元大97購02,,,,,,0.00,0,0,0,0,0,0,0,0,0,0,0,0,0
20200312,708586,原相元大98購01,1.51,1.56,1.14,1.14,-0.57,-33.33,105000,11,144520,0,0,0,0,0,0,82000,15000,67000,67000
20200312,708587,原相元大99購01,1.66,1.66,1.29,1.29,-0.56,-30.27,119000,16,172420,0,0,0,0,0,0,29000,95000,-66000,-66000
20200312,708588,群聯元大98購01,0.19,0.31,0.19,0.23,-0.30,-56.6,920000,94,228300,0,0,0,0,0,0,10000,900000,-890000,-890000
20200312,708589,聯亞元大98購01,0.45,0.45,0.33,0.35,-0.21,-37.5,198000,15,74790,0,0,0,0,0,0,106000,92000,14000,14000
20200312,708590,雙美元大99購01,0.50,0.51,0.48,0.48,-0.05,-9.43,630000,7,315900,0,0,0,0,0,0,577000,553000,24000,24000
20200312,708591,雙鴻元大99購03,0.24,0.25,0.24,0.24,-0.13,-35.14,85000,3,20650,0,0,0,0,0,0,35000,50000,-15000,-15000
20200312,708592,穩懋元大97購03,1.18,1.18,0.74,0.80,-0.70,-46.67,346000,10,298560,0,0,0,0,0,0,168000,336000,-168000,-168000
20200312,708593,穩懋元大97購04,0.69,0.69,0.45,0.45,-0.35,-43.75,30000,4,16580,0,0,0,0,0,0,20000,4000,16000,16000
20200312,708594,鈊象元大99購01,3.39,3.39,2.51,2.51,-0.99,-28.29,40000,6,107860,0,0,0,0,0,0,22000,18000,4000,4000
20200312,708595,大江兆豐97購02,,,,,,0.00,0,0,0,0,0,0,0,0,0,0,0,0,0
20200312,708596,群聯兆豐98購01,0.28,0.28,0.13,0.13,-0.20,-60.61,261000,23,41790,0,0,0,0,0,0,60000,248000,-188000,-188000
20200312,708597,迅得康和97購01,,,,,,0.00,0,0,0,0,0,0,0,0,0,0,0,0,0
20200312,708598,六角群益98購02,0.32,0.33,0.28,0.28,-0.09,-24.32,69000,6,22120,0,0,0,0,0,0,22000,47000,-25000,-25000
20200312,708599,亞泰群益97購01,,,,,,0.00,0,0,0,0,0,0,0,0,0,0,0,0,0
20200312,708600,台燿亞東97購01,0.37,0.37,0.35,0.35,-0.20,-36.36,196000,3,70040,0,0,0,0,0,0,48000,148000,-100000,-100000
20200312,708601,光頡永豐97購01,0.34,0.34,0.22,0.22,-0.16,-42.11,7000,2,1900,0,0,0,0,0,0,7000,0,7000,7000
20200312,708602,亞泰永豐97購01,,,,,,0.00,0,0,0,0,0,0,0,0,0,0,0,0,0
20200312,708603,力致元富97購02,0.13,0.13,0.09,0.09,-0.14,-60.87,250000,4,23300,0,0,0,0,0,0,0,250000,-250000,-250000
20200312,708604,鈺太元富97購01,0.42,0.42,0.42,0.42,-0.21,-33.33,18000,2,7560,0,0,0,0,0,0,0,18000,-18000,-18000
20200312,708605,久元台新97購01,0.49,0.49,0.49,0.49,-0.17,-25.76,7000,1,3430,0,0,0,0,0,0,7000,0,7000,7000
20200312,708606,大中台新97購01,,,,,,0.00,0,0,0,0,0,0,0,0,0,0,0,0,0
20200312,708607,晶焱台新97購01,,,,,,0.00,0,0,0,0,0,0,0,0,0,0,0,0,0
20200312,708608,光頡統一97購01,,,,,,0.00,0,0,0,0,0,0,0,0,0,0,0,0,0
20200312,708609,光頡統一99購01,0.23,0.23,0.23,0.23,-0.16,-41.03,70000,1,16100,0,0,0,0,0,0,0,70000,-70000,-70000
20200312,708610,合晶統一97購01,,,,,,0.00,0,0,0,0,0,0,0,0,0,0,0,0,0
20200312,708611,大中中信99購01,,,,,,0.00,0,0,0,0,0,0,0,0,0,0,0,0,0
20200312,708612,亞泰中信97購01,,,,,,0.00,0,0,0,0,0,0,0,0,0,0,0,0,0
20200312,708613,博智中信99購01,,,,,,0.00,0,0,0,0,0,0,0,0,0,0,0,0,0
20200312,708614,緯軟中信97購01,,,,,,0.00,0,0,0,0,0,0,0,0,0,0,0,0,0
20200312,708615,台半凱基98購01,0.29,0.29,0.27,0.27,-0.20,-42.55,80000,8,22300,0,0,0,0,0,0,0,80000,-80000,-80000
20200312,708616,兆利凱基98購03,,,,,,0.00,0,0,0,0,0,0,0,0,0,0,0,0,0
20200312,708617,宇峻凱基99購01,0.29,0.29,0.21,0.21,-0.06,-22.22,90000,8,21100,0,0,0,0,0,0,20000,70000,-50000,-50000
20200312,708618,新普凱基98購01,,,,,,0.00,0,0,0,0,0,0,0,0,0,0,0,0,0
20200312,708619,璟德凱基98購01,0.32,0.32,0.32,0.32,-0.14,-30.43,100000,1,32000,0,0,0,0,0,0,0,100000,-100000,-100000
20200312,708620,環球晶凱基97購02,0.93,0.93,0.83,0.84,-0.24,-22.22,36000,4,31400,0,0,0,0,0,0,36000,36000,0,0
20200312,708621,頎邦第一97購01,,,,,,0.00,0,0,0,0,0,0,0,0,0,0,0,0,0
20200312,708622,光頡永豐97購02,0.13,0.13,0.12,0.12,-0.10,-45.45,45000,3,5500,0,0,0,0,0,0,10000,35000,-25000,-25000
20200312,708623,建榮永豐98購01,,,,,,0.00,0,0,0,0,0,0,0,0,0,0,0,0,0
20200312,708624,雙美永豐98購01,0.38,0.38,0.38,0.38,-0.09,-19.15,6000,1,2280,0,0,0,0,0,0,0,6000,-6000,-6000
20200312,708625,雙鴻永豐98購01,0.30,0.30,0.30,0.30,-0.25,-45.45,68000,1,20400,0,0,0,0,0,0,0,68000,-68000,-68000
20200312,708626,亞泰國票97購01,,,,,,0.00,0,0,0,0,0,0,0,0,0,0,0,0,0
20200312,708627,新普國票98購01,1.37,1.37,1.30,1.30,-0.50,-27.78,15000,2,20200,0,0,0,0,0,0,0,15000,-15000,-15000
20200312,708628,廣明國票98購01,,,,,,0.00,0,0,0,0,0,0,0,0,0,0,0,0,0
20200312,708629,璟德國票98購01,,,,,,0.00,0,0,0,0,0,0,0,0,0,0,0,0,0
20200312,708630,環宇國票98購01,0.45,0.45,0.34,0.34,-0.19,-35.85,129000,3,47050,0,0,0,0,0,0,29000,100000,-71000,-71000
20200312,708631,頎邦國票98購01,,,,,,0.00,0,0,0,0,0,0,0,0,0,0,0,0,0
20200312,708632,M31元大98購01,0.31,0.32,0.30,0.30,-0.21,-41.18,75000,4,23000,0,0,0,0,0,0,55000,20000,35000,35000
20200312,708633,昂寶元大98購02,,,,,,0.00,0,0,0,0,0,0,0,0,0,0,0,0,0
20200312,708634,信昌電元大98購02,,,,,,0.00,0,0,0,0,0,0,0,0,0,0,0,0,0
20200312,708635,建榮元大97購03,0.11,0.11,0.11,0.11,-0.06,-35.29,60000,1,6600,0,0,0,0,0,0,60000,0,60000,60000
20200312,708636,原相元大98購02,1.36,1.43,1.00,1.01,-0.59,-36.88,224000,35,266860,0,0,0,0,0,0,138000,113000,25000,25000
20200312,708637,群聯元大98購02,0.48,0.51,0.29,0.29,-0.50,-63.29,441000,37,163140,0,0,0,0,0,0,223000,385000,-162000,-162000
20200312,708638,精測元大97購04,0.20,0.20,0.17,0.17,-0.15,-46.88,50000,3,9200,0,0,0,0,0,0,0,50000,-50000,-50000
20200312,708639,網龍元大97購01,0.07,0.08,0.07,0.08,-0.09,-52.94,30000,3,2300,0,0,0,0,0,0,30000,0,30000,30000
20200312,708640,璟德元大97購03,0.46,0.46,0.34,0.36,-0.29,-44.62,60000,4,23840,0,0,0,0,0,0,3000,57000,-54000,-54000
20200312,708641,鈊象元大98購02,4.30,4.30,3.22,3.28,-1.44,-30.51,163000,21,597550,0,0,0,0,0,0,58000,118000,-60000,-60000
20200312,708642,頎邦元大97購03,0.49,0.49,0.49,0.49,-0.16,-24.62,68000,1,33320,0,0,0,0,0,0,0,68000,-68000,-68000
20200312,708643,頎邦元大97購04,0.56,0.56,0.45,0.45,-0.21,-31.82,138000,6,72650,0,0,0,0,0,0,97000,38000,59000,59000
20200312,708644,雙美國泰99購01,0.44,0.44,0.42,0.42,-0.04,-8.7,219000,5,95180,0,0,0,0,0,0,160000,59000,101000,101000
20200312,708645,聯亞兆豐98購01,0.42,0.42,0.31,0.31,-0.26,-45.61,55000,8,19070,0,0,0,0,0,0,10000,45000,-35000,-35000
20200312,708646,櫃200兆豐97購01,,,,,,0.00,0,0,0,0,0,0,0,0,0,0,0,0,0
20200312,708647,泰博群益97購01,3.67,3.67,2.70,2.70,-1.40,-34.15,121000,8,385660,0,0,0,0,0,0,25000,74000,-49000,-49000
20200312,708648,VHQ中信97購01,,,,,,0.00,0,0,0,0,0,0,0,0,0,0,0,0,0
20200312,708649,鈊象中信97購01,3.20,3.20,2.28,2.35,-1.16,-33.05,107000,9,283640,0,0,0,0,0,0,65000,42000,23000,23000
20200312,708650,迅得麥證98購01,,,,,,0.00,0,0,0,0,0,0,0,0,0,0,0,0,0
20200312,708651,大學光元富99購01,1.66,1.66,1.34,1.34,-0.63,-31.98,31000,14,47930,0,0,0,0,0,0,21000,10000,11000,11000
20200312,708652,光頡元富97購01,0.27,0.27,0.27,0.27,-0.23,-46.0,4000,1,1080,0,0,0,0,0,0,4000,0,4000,4000
20200312,708653,神盾元富97購03,0.39,0.39,0.29,0.30,-0.22,-42.31,40000,5,12720,0,0,0,0,0,0,18000,22000,-4000,-4000
20200312,708654,力致統一97購03,,,,,,0.00,0,0,0,0,0,0,0,0,0,0,0,0,0
20200312,708655,波若威統一99購01,0.35,0.35,0.28,0.28,-0.15,-34.88,121000,7,35390,0,0,0,0,0,0,0,121000,-121000,-121000
20200312,708656,信昌電統一98購01,0.94,0.94,0.81,0.81,-0.34,-29.57,36000,2,31500,0,0,0,0,0,0,18000,18000,0,0
20200312,708657,兆利台新97購01,0.24,0.24,0.21,0.21,-0.15,-41.67,159000,2,33660,0,0,0,0,0,0,159000,0,159000,159000
20200312,708658,神盾台新98購01,0.38,0.38,0.38,0.38,-0.16,-29.63,10000,1,3800,0,0,0,0,0,0,0,10000,-10000,-10000
20200312,708659,合晶凱基97購03,0.74,0.74,0.68,0.68,-0.27,-28.42,75000,2,51600,0,0,0,0,0,0,75000,65000,10000,10000
20200312,708660,宇峻凱基99購02,0.32,0.32,0.26,0.26,-0.07,-21.21,50000,4,13800,0,0,0,0,0,0,30000,20000,10000,10000
20200312,708661,良維凱基97購03,0.51,0.51,0.32,0.34,-0.26,-43.33,540000,13,240500,0,0,0,0,0,0,35000,505000,-470000,-470000
20200312,708662,信昌電凱基98購02,,,,,,0.00,0,0,0,0,0,0,0,0,0,0,0,0,0
20200312,708663,茂達凱基97購01,0.94,0.94,0.77,0.77,-0.25,-24.51,64000,5,57660,0,0,0,0,0,0,59000,5000,54000,54000
20200312,708664,群聯凱基98購02,0.45,0.45,0.21,0.21,-0.46,-68.66,357000,42,123580,0,0,0,0,0,0,40000,297000,-257000,-257000
20200312,708665,網家凱基97購01,1.66,1.66,1.13,1.13,-1.02,-47.44,47000,4,59210,0,0,0,0,0,0,10000,37000,-27000,-27000
20200312,708666,聚積凱基97購01,0.45,0.45,0.43,0.43,-0.24,-35.82,129000,4,56760,0,0,0,0,0,0,92000,37000,55000,55000
20200312,708667,廣明凱基98購02,0.31,0.32,0.22,0.23,-0.13,-36.11,660000,14,193800,0,0,0,0,0,0,10000,650000,-640000,-640000
20200312,708668,優群凱基98購03,1.51,1.51,1.20,1.20,-0.47,-28.14,40000,3,52900,0,0,0,0,0,0,30000,10000,20000,20000
20200312,708669,聯亞凱基99購02,0.31,0.38,0.25,0.25,-0.25,-50.0,88000,9,24240,0,0,0,0,0,0,30000,58000,-28000,-28000
20200312,708670,鈺太凱基98購01,0.33,0.34,0.27,0.27,-0.14,-34.15,220000,10,66700,0,0,0,0,0,0,120000,100000,20000,20000
20200312,708671,頎邦凱基97購04,0.79,0.79,0.59,0.61,-0.25,-29.07,115000,12,80540,0,0,0,0,0,0,107000,50000,57000,57000
20200312,708672,M31元大99購01,0.45,0.45,0.32,0.34,-0.17,-33.33,522000,18,199290,0,0,0,0,0,0,390000,131000,259000,259000
20200312,708673,凡甲元大98購02,,,,,,0.00,0,0,0,0,0,0,0,0,0,0,0,0,0
20200312,708674,大宇資元大98購01,0.48,0.48,0.24,0.25,-0.25,-50.0,91000,8,34360,0,0,0,0,0,0,25000,50000,-25000,-25000
20200312,708675,六角元大98購02,,,,,,0.00,0,0,0,0,0,0,0,0,0,0,0,0,0
20200312,708676,昂寶元大97購02,,,,,,0.00,0,0,0,0,0,0,0,0,0,0,0,0,0
20200312,708677,晶焱元大98購01,0.66,0.66,0.66,0.66,-0.24,-26.67,50000,1,33000,0,0,0,0,0,0,0,50000,-50000,-50000
20200312,708678,鈊象元大97購04,,,,,,0.00,0,0,0,0,0,0,0,0,0,0,0,0,0
20200312,708679,光頡國票98購01,,,,,,0.00,0,0,0,0,0,0,0,0,0,0,0,0,0
20200312,708680,金居國票98購01,0.28,0.28,0.21,0.21,-0.30,-58.82,123000,3,26040,0,0,0,0,0,0,3000,120000,-117000,-117000
20200312,708681,建榮國票99購01,,,,,,0.00,0,0,0,0,0,0,0,0,0,0,0,0,0
20200312,708682,穩懋國票98購01,0.48,0.50,0.47,0.48,-0.56,-53.85,266000,5,127380,0,0,0,0,0,0,0,266000,-266000,-266000
20200312,708683,鈊象國票97購03,19.30,20.60,13.20,13.20,-9.40,-41.59,184000,27,2842500,0,0,0,0,0,0,77000,107000,-30000,-30000
20200312,708684,光頡國泰98購01,1.09,1.09,0.79,0.80,-0.42,-34.43,87000,8,82650,0,0,0,0,0,0,36000,70000,-34000,-34000
20200312,708685,亞泰國泰98購01,0.68,0.68,0.59,0.59,-0.16,-21.33,29000,3,19220,0,0,0,0,0,0,18000,11000,7000,7000
20200312,708686,世界兆豐97購01,1.17,1.25,1.17,1.25,-0.13,-9.42,70000,4,85200,0,0,0,0,0,0,25000,45000,-20000,-20000
20200312,708687,同致兆豐98購01,0.18,0.18,0.18,0.18,-0.12,-40.0,10000,1,1800,0,0,0,0,0,0,0,10000,-10000,-10000
20200312,708688,宜鼎兆豐98購01,1.13,1.13,1.02,1.02,-0.40,-28.17,38000,2,42060,0,0,0,0,0,0,0,38000,-38000,-38000
20200312,708689,勝麗群益98購02,0.66,0.66,0.49,0.49,-0.44,-47.31,154000,3,75800,0,0,0,0,0,0,152000,2000,150000,150000
20200312,708690,晟德群益97購01,0.25,0.25,0.20,0.20,-0.08,-28.57,75000,4,15500,0,0,0,0,0,0,45000,30000,15000,15000
20200312,708691,穩懋永豐97購02,0.68,0.70,0.49,0.51,-0.39,-43.33,185000,13,109470,0,0,0,0,0,0,17000,158000,-141000,-141000
20200312,708692,元太亞東97購01,0.45,0.45,0.33,0.33,-0.20,-37.74,154000,2,61380,0,0,0,0,0,0,66000,88000,-22000,-22000
20200312,708693,台半中信99購01,0.42,0.42,0.33,0.33,-0.20,-37.74,50000,2,17580,0,0,0,0,0,0,0,50000,-50000,-50000
20200312,708694,M31統一98購01,0.66,0.66,0.47,0.47,-0.39,-45.35,144000,3,77220,0,0,0,0,0,0,66000,78000,-12000,-12000
20200312,708695,波若威統一97購01,,,,,,0.00,0,0,0,0,0,0,0,0,0,0,0,0,0
20200312,708696,建榮統一9A購01,,,,,,0.00,0,0,0,0,0,0,0,0,0,0,0,0,0
20200312,708697,建榮統一9A購02,,,,,,0.00,0,0,0,0,0,0,0,0,0,0,0,0,0
20200312,708698,雙鴻統一97購02,0.37,0.37,0.31,0.31,-0.22,-41.51,62000,3,21020,0,0,0,0,0,0,62000,0,62000,62000
20200312,708699,雙鴻統一99購01,0.35,0.35,0.35,0.35,-0.18,-33.96,15000,1,5250,0,0,0,0,0,0,0,15000,-15000,-15000
20200312,708700,穩懋統一99購01,1.01,1.01,0.66,0.69,-0.70,-50.36,222000,7,190750,0,0,0,0,0,0,205000,16000,189000,189000
20200312,708701,建榮凱基97購02,0.20,0.20,0.15,0.16,-0.15,-48.39,794000,3,141000,0,0,0,0,0,0,604000,590000,14000,14000
20200312,708702,原相凱基98購02,3.08,3.08,2.12,2.12,-1.72,-44.79,61000,8,157120,0,0,0,0,0,0,6000,55000,-49000,-49000
20200312,708703,精測凱基97購04,,,,,,0.00,0,0,0,0,0,0,0,0,0,0,0,0,0
20200312,708704,環球晶凱基97購03,1.15,1.24,0.79,1.18,-0.14,-10.61,170000,18,186430,0,0,0,0,0,0,48000,150000,-102000,-102000
20200312,708705,穩懋凱基97購01,0.78,0.78,0.78,0.78,-0.11,-12.36,10000,1,7800,0,0,0,0,0,0,10000,0,10000,10000
20200312,708706,鈺太凱基98購02,0.42,0.42,0.42,0.42,-0.24,-36.36,100000,1,42000,0,0,0,0,0,0,100000,0,100000,100000
20200312,708707,大江元大97購04,0.11,0.13,0.11,0.13,0.00,0.0,549000,4,60490,0,0,0,0,0,0,539000,0,539000,539000
20200312,708708,光頡元大98購01,0.48,0.48,0.48,0.48,-0.05,-9.43,10000,1,4800,0,0,0,0,0,0,10000,0,10000,10000
20200312,708709,新普元大97購02,1.04,1.04,0.92,0.92,-0.51,-35.66,127000,3,127780,0,0,0,0,0,0,30000,97000,-67000,-67000
20200312,708710,新普元大97購03,1.75,1.75,1.58,1.60,-0.42,-20.79,44000,6,72450,0,0,0,0,0,0,14000,33000,-19000,-19000
20200312,708711,群聯元大97購05,0.40,0.40,0.21,0.21,-0.33,-61.11,804000,60,209550,0,0,0,0,0,0,327000,551000,-224000,-224000
20200312,708712,聯亞元大97購05,0.57,0.57,0.38,0.40,-0.28,-41.18,388000,17,154170,0,0,0,0,0,0,268000,80000,188000,188000
20200312,708713,雙鴻元大99購04,0.50,0.50,0.39,0.39,-0.19,-32.76,564000,34,233020,0,0,0,0,0,0,208000,336000,-128000,-128000
20200312,708714,聯亞元富97購01,0.55,0.55,0.47,0.47,-0.42,-47.19,54000,4,29440,0,0,0,0,0,0,52000,2000,50000,50000
20200312,708715,台燿日盛97購01,0.65,0.65,0.53,0.55,-0.27,-32.93,227000,12,130840,0,0,0,0,0,0,152000,75000,77000,77000
20200312,708716,建榮永豐97購02,,,,,,0.00,0,0,0,0,0,0,0,0,0,0,0,0,0
20200312,708717,閎康永豐97購01,0.65,0.65,0.50,0.50,-0.30,-37.5,184000,4,114930,0,151000,-151000,0,0,0,177000,7000,170000,19000
20200312,708718,譜瑞永豐97購01,1.17,1.17,0.79,0.80,-0.56,-41.18,62000,7,56990,0,0,0,0,0,0,32000,52000,-20000,-20000
20200312,708719,鈊象永豐98購01,,,,,,0.00,0,0,0,0,0,0,0,0,0,0,0,0,0
20200312,708720,力致國票97購01,0.04,0.05,0.04,0.05,-0.05,-50.0,261000,6,10540,0,0,0,0,0,0,1000,260000,-259000,-259000
20200312,708721,光頡國票98購02,,,,,,0.00,0,0,0,0,0,0,0,0,0,0,0,0,0
20200312,708722,金居國票98購02,0.19,0.19,0.18,0.18,-0.18,-50.0,100000,2,18100,0,0,0,0,0,0,0,100000,-100000,-100000
20200312,708723,威剛國票98購02,1.29,1.29,0.89,0.89,-0.59,-39.86,585000,14,671280,0,0,0,0,0,0,247000,338000,-91000,-91000
20200312,708724,晶焱國票98購01,,,,,,0.00,0,0,0,0,0,0,0,0,0,0,0,0,0
20200312,708725,群聯國票98購02,0.56,0.56,0.34,0.35,-0.39,-52.7,341000,11,152140,0,0,0,0,0,0,115000,236000,-121000,-121000
20200312,708726,廣明國票98購02,,,,,,0.00,0,0,0,0,0,0,0,0,0,0,0,0,0
20200312,708727,光頡國泰99購01,0.48,0.48,0.44,0.46,-0.13,-22.03,169000,4,77400,0,0,0,0,0,0,101000,68000,33000,33000
20200312,708728,原相國泰98購03,,,,,,0.00,0,0,0,0,0,0,0,0,0,0,0,0,0
20200312,708729,大江富邦99購01,0.09,0.09,0.08,0.09,-0.01,-10.0,159000,7,13260,0,0,0,0,0,0,0,0,0,0
20200312,708730,久元群益97購01,0.57,0.57,0.49,0.49,-0.52,-51.49,300000,3,155000,0,0,0,0,0,0,300000,0,300000,300000
20200312,708731,聚積群益97購02,0.47,0.47,0.47,0.47,-0.10,-17.54,11000,1,5170,0,0,0,0,0,0,11000,0,11000,11000
20200312,708732,頎邦群益98購02,0.83,0.83,0.65,0.65,-0.36,-35.64,289000,10,210490,0,0,0,0,0,0,241000,48000,193000,193000
20200312,708733,M31凱基99購01,0.30,0.30,0.22,0.22,-0.26,-54.17,92000,2,25680,0,0,0,0,0,0,24000,68000,-44000,-44000
20200312,708734,中美晶凱基97購04,0.95,0.95,0.95,0.95,-0.20,-17.39,10000,1,9500,0,0,0,0,0,0,0,10000,-10000,-10000
20200312,708735,昇達科凱基97購01,0.52,0.54,0.42,0.42,-0.27,-39.13,520000,13,269810,0,450000,-450000,0,0,0,509000,70000,439000,-11000
20200312,708736,聯亞凱基97購02,0.24,0.24,0.15,0.15,-0.29,-65.91,42000,6,7170,0,0,0,0,0,0,13000,29000,-16000,-16000
20200312,708737,雙美凱基99購01,0.26,0.26,0.26,0.26,-0.03,-10.34,30000,1,7800,0,0,0,0,0,0,0,30000,-30000,-30000
20200312,708738,穩懋凱基97購02,1.21,1.22,0.86,0.87,-0.96,-52.46,225000,4,200350,0,0,0,0,0,0,15000,215000,-200000,-200000
20200312,708739,穩懋凱基97購03,,,,,,0.00,0,0,0,0,0,0,0,0,0,0,0,0,0
20200312,708740,譜瑞凱基97購01,1.97,2.07,1.29,1.29,-0.91,-41.36,172000,11,293380,0,0,0,0,0,0,33000,152000,-119000,-119000
20200312,708741,鈊象凱基98購03,5.60,5.75,4.23,4.23,-1.92,-31.22,46000,12,231720,0,0,0,0,0,0,31000,20000,11000,11000
20200312,708742,新普麥證97購01,0.71,0.72,0.66,0.72,-0.22,-23.4,141000,7,98910,126000,15000,111000,0,0,0,126000,131000,-5000,-5000
20200312,708743,同致元富97購01,,,,,,0.00,0,0,0,0,0,0,0,0,0,0,0,0,0
20200312,708744,金居元富97購01,,,,,,0.00,0,0,0,0,0,0,0,0,0,0,0,0,0
20200312,708745,原相元富97購01,1.30,1.30,0.85,0.92,-0.64,-41.03,275000,29,305470,0,0,0,0,0,0,163000,107000,56000,56000
20200312,708746,穩懋元富97購01,0.72,0.72,0.72,0.72,-0.46,-38.98,50000,1,36000,0,0,0,0,0,0,50000,0,50000,50000
20200312,708747,立端亞東98購01,0.55,0.55,0.41,0.42,-0.20,-32.26,22000,5,10660,0,0,0,0,0,0,0,22000,-22000,-22000
20200312,708748,合晶永豐97購03,,,,,,0.00,0,0,0,0,0,0,0,0,0,0,0,0,0
20200312,708749,旺矽永豐97購03,0.13,0.13,0.13,0.13,-0.19,-59.38,1000,1,130,0,0,0,0,0,0,0,1000,-1000,-1000
20200312,708750,信驊永豐97購01,0.84,0.84,0.69,0.74,-0.27,-26.73,1385000,46,1051860,0,0,0,0,0,0,102000,1283000,-1181000,-1181000
20200312,708751,聯亞永豐97購01,0.38,0.46,0.33,0.33,-0.35,-51.47,136000,12,53790,0,0,0,0,0,0,27000,116000,-89000,-89000
20200312,708752,原相統一97購01,0.85,0.85,0.56,0.58,-0.48,-45.28,203000,12,139530,0,0,0,0,0,0,143000,81000,62000,62000
20200312,708753,廣明統一9A購01,0.58,0.58,0.57,0.57,-0.23,-28.75,15000,3,8560,0,0,0,0,0,0,0,15000,-15000,-15000
20200312,708754,聯亞統一98購01,0.38,0.43,0.38,0.43,-0.17,-28.33,17000,2,6710,0,0,0,0,0,0,5000,12000,-7000,-7000
20200312,708755,鈊象統一99購01,2.69,2.69,2.12,2.15,-0.66,-23.49,41000,7,93250,0,0,0,0,0,0,0,41000,-41000,-41000
20200312,708756,大中國票98購01,,,,,,0.00,0,0,0,0,0,0,0,0,0,0,0,0,0
20200312,708757,大江國票97購06,0.05,0.05,0.05,0.05,-0.07,-58.33,10000,1,500,0,0,0,0,0,0,0,0,0,0
20200312,708758,佳邦國票98購01,,,,,,0.00,0,0,0,0,0,0,0,0,0,0,0,0,0
20200312,708759,宜鼎國票97購04,,,,,,0.00,0,0,0,0,0,0,0,0,0,0,0,0,0
20200312,708760,信昌電國票98購02,,,,,,0.00,0,0,0,0,0,0,0,0,0,0,0,0,0
20200312,708761,宣德國票98購01,0.86,0.86,0.69,0.70,-0.26,-27.08,80000,4,57100,0,0,0,0,0,0,10000,70000,-60000,-60000
20200312,708762,神盾國票98購02,0.40,0.40,0.40,0.40,-0.31,-43.66,20000,1,8000,0,0,0,0,0,0,0,20000,-20000,-20000
20200312,708763,群聯國票98購03,0.26,0.26,0.14,0.14,-0.40,-74.07,151000,3,32640,0,0,0,0,0,0,0,151000,-151000,-151000
20200312,708764,緯軟國票98購01,,,,,,0.00,0,0,0,0,0,0,0,0,0,0,0,0,0
20200312,708765,威剛國泰98購03,0.71,0.71,0.46,0.51,-0.47,-47.96,70000,8,42050,0,0,0,0,0,0,30000,40000,-10000,-10000
20200312,708766,廣明國泰98購01,1.06,1.06,0.98,0.98,-0.26,-20.97,25000,2,26100,0,0,0,0,0,0,25000,0,25000,25000
20200312,708767,穩懋富邦99購01,0.76,0.76,0.56,0.56,-0.34,-37.78,534000,32,347660,0,0,0,0,0,0,297000,243000,54000,54000
20200312,708768,六角元大97購01,0.30,0.30,0.29,0.29,-0.24,-45.28,50000,2,14700,0,0,0,0,0,0,0,50000,-50000,-50000
20200312,708769,合晶元大98購03,0.90,0.90,0.81,0.81,-0.33,-28.95,155000,3,132700,0,0,0,0,0,0,19000,136000,-117000,-117000
20200312,708770,泰博元大97購01,2.91,2.91,2.32,2.62,-0.71,-21.32,16000,5,41510,0,0,0,0,0,0,9000,7000,2000,2000
20200312,708771,精測元大97購05,0.30,0.30,0.23,0.23,-0.19,-45.24,24000,2,6500,0,0,0,0,0,0,14000,10000,4000,4000
20200312,708772,聚積元大98購01,0.67,0.67,0.67,0.67,-0.20,-22.99,70000,1,46900,0,0,0,0,0,0,70000,0,70000,70000
20200312,708773,廣明元大97購02,0.68,0.68,0.51,0.51,-0.34,-40.0,160000,5,97300,0,0,0,0,0,0,0,160000,-160000,-160000
20200312,708774,璟德元大97購04,0.38,0.38,0.38,0.38,-0.19,-33.33,50000,1,19000,0,0,0,0,0,0,50000,0,50000,50000
20200312,708775,穩懋元大97購07,0.90,0.90,0.60,0.60,-0.48,-44.44,444000,15,330420,0,0,0,0,0,0,269000,392000,-123000,-123000
20200312,708776,穩懋元大98購01,0.94,0.94,0.68,0.68,-0.38,-35.85,752000,37,565270,0,0,0,0,0,0,384000,510000,-126000,-126000
20200312,708777,旺矽兆豐98購01,0.48,0.48,0.48,0.48,-0.19,-28.36,12000,1,5760,0,0,0,0,0,0,0,12000,-12000,-12000
20200312,708778,環球晶兆豐98購01,0.66,0.76,0.51,0.71,-0.13,-15.48,188000,9,115900,0,0,0,0,0,0,17000,171000,-154000,-154000
20200312,708779,雙鴻兆豐98購01,0.50,0.50,0.47,0.47,-0.21,-30.88,100000,2,47360,0,0,0,0,0,0,100000,0,100000,100000
20200312,708780,穩懋兆豐97購03,0.38,0.38,0.27,0.27,-0.28,-50.91,65000,5,22900,0,0,0,0,0,0,40000,25000,15000,15000
20200312,708781,信驊群益97購01,2.88,2.88,2.45,2.45,-0.81,-24.85,25000,5,67220,0,0,0,0,0,0,25000,5000,20000,20000
20200312,708782,建榮群益98購01,0.16,0.16,0.16,0.16,-0.05,-23.81,100000,1,16000,0,0,0,0,0,0,100000,100000,0,0
20200312,708783,優群群益99購01,1.98,1.98,1.62,1.71,-1.04,-37.82,43000,4,76100,0,0,0,0,0,0,43000,0,43000,43000
20200312,708784,環宇群益97購02,0.33,0.33,0.30,0.30,-0.12,-28.57,9000,2,2820,0,0,0,0,0,0,9000,0,9000,9000
20200312,708785,信驊中信9B購01,0.66,0.66,0.56,0.58,-0.12,-17.14,306000,23,186640,0,0,0,0,0,0,192000,94000,98000,98000
20200312,708786,中美晶凱基97購05,,,,,,0.00,0,0,0,0,0,0,0,0,0,0,0,0,0
20200312,708787,同致凱基98購02,,,,,,0.00,0,0,0,0,0,0,0,0,0,0,0,0,0
20200312,708788,泰博凱基99購01,2.22,2.22,1.58,1.81,-0.45,-19.91,310000,27,575750,0,0,0,0,0,0,125000,179000,-54000,-54000
20200312,708789,群聯凱基97購01,1.15,1.15,0.67,0.75,-0.80,-51.61,12000,5,9560,0,0,0,0,0,0,12000,12000,0,0
20200312,708790,優群凱基98購04,1.69,1.73,1.59,1.59,-0.57,-26.39,26000,4,43390,0,0,0,0,0,0,11000,15000,-4000,-4000
20200312,708791,雙美凱基99購02,,,,,,0.00,0,0,0,0,0,0,0,0,0,0,0,0,0
20200312,708792,凡甲國票98購01,0.56,0.56,0.50,0.52,-0.18,-25.71,25000,4,12900,0,0,0,0,0,0,5000,20000,-15000,-15000
20200312,708793,迅得國票98購01,,,,,,0.00,0,0,0,0,0,0,0,0,0,0,0,0,0
20200312,708794,旺矽國票98購01,0.33,0.33,0.33,0.33,-0.07,-17.5,4000,1,1320,0,0,0,0,0,0,4000,0,4000,4000
20200312,708795,原相國票98購03,1.67,1.67,1.19,1.25,-0.90,-41.86,120000,18,175780,0,0,0,0,0,0,46000,98000,-52000,-52000
20200312,708796,兆利群益97購01,0.70,0.70,0.70,0.70,-0.25,-26.32,36000,1,25200,0,0,0,0,0,0,36000,0,36000,36000
20200312,708797,金居群益99購01,0.36,0.36,0.36,0.36,-0.30,-45.45,5000,1,1800,0,0,0,0,0,0,5000,0,5000,5000
20200312,708798,晶焱群益99購01,0.45,0.45,0.40,0.40,-0.11,-21.57,30000,3,12530,0,0,0,0,0,0,19000,11000,8000,8000
20200312,708799,閎康群益97購02,0.97,0.97,0.73,0.73,-0.50,-40.65,574000,15,542240,0,450000,-450000,0,0,0,440000,103000,337000,-113000
20200312,708800,凡甲元富99購01,0.50,0.50,0.39,0.39,-0.21,-35.0,130000,12,54810,0,0,0,0,0,0,125000,5000,120000,120000
20200312,708801,六角元富97購01,0.30,0.32,0.30,0.32,-0.13,-28.89,20000,2,6200,0,0,0,0,0,0,0,20000,-20000,-20000
20200312,708802,欣銓元富97購01,0.93,0.93,0.79,0.79,-0.27,-25.47,150000,9,133210,0,0,0,0,0,0,148000,2000,146000,146000
20200312,708803,晶焱元富99購01,,,,,,0.00,0,0,0,0,0,0,0,0,0,0,0,0,0
20200312,708804,廣明元富99購01,0.36,0.37,0.36,0.37,-0.23,-38.33,23000,2,8310,0,0,0,0,0,0,20000,3000,17000,17000
20200312,708805,環球晶元富98購01,0.72,0.80,0.50,0.72,-0.20,-21.74,1563000,48,903460,0,0,0,0,0,0,229000,1423000,-1194000,-1194000
20200312,708806,環球晶元富99購01,0.72,0.77,0.46,0.74,-0.06,-7.5,1450000,82,862960,0,0,0,0,0,0,679000,800000,-121000,-121000
20200312,708807,雙美元富97購01,,,,,,0.00,0,0,0,0,0,0,0,0,0,0,0,0,0
20200312,708808,雙鴻元富97購01,,,,,,0.00,0,0,0,0,0,0,0,0,0,0,0,0,0
20200312,708809,穩懋元富97購02,1.10,1.10,0.70,0.70,-0.80,-53.33,188000,6,191220,0,0,0,0,0,0,50000,128000,-78000,-78000
20200312,708810,鈊象元富97購01,,,,,,0.00,0,0,0,0,0,0,0,0,0,0,0,0,0
20200312,708811,雙鴻國泰98購01,0.69,0.70,0.45,0.45,-0.30,-40.0,242000,13,137880,0,0,0,0,0,0,72000,170000,-98000,-98000
20200312,708812,精測台新98購01,0.34,0.34,0.34,0.34,-0.05,-12.82,60000,1,20400,0,0,0,0,0,0,0,60000,-60000,-60000
20200312,708813,宇峻元大98購01,0.37,0.38,0.26,0.26,-0.09,-25.71,152000,7,50200,0,0,0,0,0,0,132000,20000,112000,112000
20200312,708814,建榮元大97購04,,,,,,0.00,0,0,0,0,0,0,0,0,0,0,0,0,0
20200312,708815,泰博元大97購02,3.10,3.10,2.34,2.45,-1.17,-32.32,19000,4,49220,0,0,0,0,0,0,14000,5000,9000,9000
20200312,708816,聯亞元大97購06,0.46,0.46,0.36,0.36,-0.31,-46.27,7000,2,2620,0,0,0,0,0,0,1000,7000,-6000,-6000
20200312,708817,譜瑞元大98購01,3.42,3.42,2.53,2.53,-1.21,-32.35,96000,9,270800,0,0,0,0,0,0,58000,66000,-8000,-8000
20200312,708818,鈊象元大98購03,2.37,2.47,1.74,1.74,-0.89,-33.84,748000,96,1522780,0,0,0,0,0,0,268000,499000,-231000,-231000
20200312,708819,合晶永豐97購04,0.71,0.72,0.61,0.61,-0.24,-28.24,259000,5,175770,0,0,0,0,0,0,122000,137000,-15000,-15000
20200312,708820,威剛永豐99購01,0.53,0.53,0.38,0.40,-0.19,-32.2,184000,4,76430,0,0,0,0,0,0,24000,160000,-136000,-136000
20200312,708821,原相永豐97購02,0.57,0.60,0.37,0.39,-0.30,-43.48,530000,13,232930,0,0,0,0,0,0,394000,126000,268000,268000
20200312,708822,泰博永豐97購01,1.00,1.00,0.75,0.83,-0.26,-23.85,360000,13,327890,0,0,0,0,0,0,229000,134000,95000,95000
20200312,708823,勝麗永豐97購01,,,,,,0.00,0,0,0,0,0,0,0,0,0,0,0,0,0
20200312,708824,廣明永豐97購03,,,,,,0.00,0,0,0,0,0,0,0,0,0,0,0,0,0
20200312,708825,碩禾中信9A購01,,,,,,0.00,0,0,0,0,0,0,0,0,0,0,0,0,0
20200312,708826,威剛統一9A購01,0.26,0.26,0.18,0.18,-0.12,-40.0,347000,12,80930,0,0,0,0,0,0,219000,128000,91000,91000
20200312,708827,群聯統一97購02,,,,,,0.00,0,0,0,0,0,0,0,0,0,0,0,0,0
20200312,708828,六角凱基99購01,0.20,0.23,0.20,0.23,-0.08,-25.81,71000,7,14460,0,0,0,0,0,0,0,71000,-71000,-71000
20200312,708829,宜鼎凱基98購01,0.42,0.42,0.32,0.32,-0.26,-44.83,115000,7,42560,0,0,0,0,0,0,80000,35000,45000,45000
20200312,708830,信昌電凱基97購03,,,,,,0.00,0,0,0,0,0,0,0,0,0,0,0,0,0
20200312,708831,廣明凱基99購01,,,,,,0.00,0,0,0,0,0,0,0,0,0,0,0,0,0
20200312,708832,群聯台新97購04,0.46,0.46,0.46,0.46,-0.27,-36.99,104000,1,47840,0,0,0,0,0,0,0,104000,-104000,-104000
20200312,708833,中美晶元大97購05,3.02,3.02,2.64,2.64,-0.82,-23.7,51000,2,135020,0,0,0,0,0,0,51000,51000,0,0
20200312,708834,中美晶元大97購06,2.88,2.88,2.56,2.56,-1.05,-29.09,16000,2,45440,0,0,0,0,0,0,16000,2000,14000,14000
20200312,708835,昂寶元大97購03,,,,,,0.00,0,0,0,0,0,0,0,0,0,0,0,0,0
20200312,708836,宣德元大97購02,1.63,1.63,1.44,1.44,-0.48,-25.0,120000,5,184100,0,0,0,0,0,0,90000,30000,60000,60000
20200312,708837,新普元大97購04,1.49,1.49,1.33,1.38,-0.40,-22.47,76000,9,108380,0,0,0,0,0,0,11000,65000,-54000,-54000
20200312,708838,新普元大97購05,1.24,1.24,1.24,1.24,-0.31,-20.0,12000,1,14880,0,0,0,0,0,0,12000,0,12000,12000
20200312,708839,群聯元大97購06,0.37,0.37,0.21,0.22,-0.27,-55.1,190000,19,47100,0,0,0,0,0,0,60000,160000,-100000,-100000
20200312,708840,雍智元大99購01,0.42,0.42,0.40,0.41,-0.07,-14.58,135000,5,55230,0,0,0,0,0,0,110000,25000,85000,85000
20200312,708841,網龍元大98購01,0.09,0.11,0.09,0.11,-0.09,-45.0,29000,2,2730,0,0,0,0,0,0,29000,0,29000,29000
20200312,708842,環球晶元大97購04,1.76,1.76,1.23,1.23,-0.78,-38.81,165000,14,266280,20000,0,20000,0,0,0,70000,122000,-52000,-32000
20200312,708843,環球晶元大97購05,1.83,1.89,1.40,1.89,-0.21,-10.0,49000,6,85830,0,0,0,0,0,0,47000,37000,10000,10000
20200312,708844,聯亞元大97購07,0.76,0.76,0.59,0.59,-0.68,-53.54,85000,5,55140,0,0,0,0,0,0,15000,73000,-58000,-58000
20200312,708845,雙鴻元大97購03,0.87,0.87,0.56,0.56,-0.39,-41.05,474000,22,294790,0,0,0,0,0,0,289000,204000,85000,85000
20200312,708846,鈊象元大98購04,1.99,1.99,1.38,1.39,-0.60,-30.15,953000,105,1553440,0,0,0,0,0,0,282000,674000,-392000,-392000
20200312,708847,群聯第一97購01,0.23,0.23,0.17,0.17,-0.21,-55.26,15000,2,2850,0,0,0,0,0,0,0,15000,-15000,-15000
20200312,708848,中美晶永豐97購01,0.58,0.61,0.45,0.61,-0.28,-31.46,180000,4,101800,0,0,0,0,0,0,30000,150000,-120000,-120000
20200312,708849,胡連永豐97購01,,,,,,0.00,0,0,0,0,0,0,0,0,0,0,0,0,0
20200312,708850,閎康永豐97購02,0.37,0.37,0.27,0.27,-0.21,-43.75,324000,4,116040,0,290000,-290000,0,0,0,324000,0,324000,34000
20200312,708851,精測永豐97購02,,,,,,0.00,0,0,0,0,0,0,0,0,0,0,0,0,0
20200312,708852,鈊象永豐97購02,2.79,2.84,1.79,1.87,-1.33,-41.56,411000,23,910270,0,0,0,0,0,0,358000,64000,294000,294000
20200312,708853,世界群益98購04,0.47,0.47,0.47,0.47,-0.05,-9.62,11000,1,5170,0,0,0,0,0,0,0,11000,-11000,-11000
20200312,708854,晶焱群益99購02,0.61,0.61,0.61,0.61,-0.30,-32.97,98000,1,59780,0,0,0,0,0,0,98000,0,98000,98000
20200312,708855,大江元富97購01,0.31,0.31,0.31,0.31,-0.22,-41.51,499000,1,154690,0,0,0,0,0,0,499000,0,499000,499000
20200312,708856,台燿元富97購01,0.87,0.87,0.65,0.65,-0.44,-40.37,124000,8,89230,0,0,0,0,0,0,37000,87000,-50000,-50000
20200312,708857,宜鼎元富97購01,0.48,0.48,0.48,0.48,-0.50,-51.02,10000,1,4800,0,0,0,0,0,0,10000,10000,0,0
20200312,708858,昇達科元富97購01,,,,,,0.00,0,0,0,0,0,0,0,0,0,0,0,0,0
20200312,708859,信驊元富97購01,1.71,1.75,1.49,1.49,-0.76,-33.78,30000,3,49500,0,0,0,0,0,0,10000,20000,-10000,-10000
20200312,708860,威剛元富97購02,0.56,0.56,0.37,0.37,-0.50,-57.47,190000,10,90900,0,0,0,0,0,0,30000,160000,-130000,-130000
20200312,708861,新普元富97購01,,,,,,0.00,0,0,0,0,0,0,0,0,0,0,0,0,0
20200312,708862,網家元富97購01,0.85,0.85,0.66,0.66,-0.59,-47.2,101000,9,71360,0,0,0,0,0,0,21000,60000,-39000,-39000
20200312,708863,聚積元富97購01,0.39,0.39,0.39,0.39,-0.06,-13.33,15000,1,5850,0,0,0,0,0,0,15000,0,15000,15000
20200312,708864,穩懋元富97購03,0.73,0.73,0.70,0.70,-0.31,-30.69,89000,4,64220,0,0,0,0,0,0,64000,29000,35000,35000
20200312,708865,直得國票97購01,,,,,,0.00,0,0,0,0,0,0,0,0,0,0,0,0,0
20200312,708866,原相國泰98購04,,,,,,0.00,0,0,0,0,0,0,0,0,0,0,0,0,0
20200312,708867,鈊象國泰99購01,2.38,2.40,1.75,1.79,-0.86,-32.45,571000,51,1136260,0,0,0,0,0,0,326000,355000,-29000,-29000
20200312,708868,鈊象中信99購01,1.73,1.77,1.25,1.25,-0.65,-34.21,1711000,168,2640590,0,0,0,0,0,0,1130000,506000,624000,624000
20200312,708869,凡甲凱基98購01,0.45,0.45,0.41,0.42,-0.15,-26.32,415000,6,177600,0,0,0,0,0,0,115000,300000,-185000,-185000
20200312,708870,大江凱基98購03,,,,,,0.00,0,0,0,0,0,0,0,0,0,0,0,0,0
20200312,708871,信驊凱基98購01,1.11,1.11,0.97,1.03,-0.64,-38.32,268000,8,278960,0,0,0,0,0,0,41000,217000,-176000,-176000
20200312,708872,新鉅科凱基97購01,,,,,,0.00,0,0,0,0,0,0,0,0,0,0,0,0,0
20200312,708873,精測凱基98購02,0.16,0.16,0.16,0.16,-0.10,-38.46,20000,1,3200,0,0,0,0,0,0,0,20000,-20000,-20000
20200312,708874,群聯統一97購03,1.36,1.36,0.78,0.88,-0.77,-46.67,81000,6,95780,0,0,0,0,0,0,1000,81000,-80000,-80000
20200312,708875,譜瑞統一97購01,1.70,1.70,1.10,1.10,-0.80,-42.11,73000,8,104190,0,0,0,0,0,0,0,73000,-73000,-73000
20200312,708876,信昌電兆豐98購01,0.21,0.21,0.16,0.16,-0.14,-46.67,40000,3,7100,0,0,0,0,0,0,30000,10000,20000,20000
20200312,708877,胡連康和97購01,,,,,,0.00,0,0,0,0,0,0,0,0,0,0,0,0,0
20200312,708878,台燿群益97購01,0.86,0.86,0.73,0.73,-0.32,-30.48,116000,9,90360,0,0,0,0,0,0,86000,36000,50000,50000
20200312,708879,博智群益97購01,4.15,4.56,3.58,3.75,-1.25,-25.0,124000,22,481970,0,0,0,0,0,0,66000,58000,8000,8000
20200312,708880,雙鴻群益99購01,0.43,0.46,0.34,0.34,-0.21,-38.18,117000,4,51420,0,0,0,0,0,0,82000,35000,47000,47000
20200312,708881,金居國泰99購01,0.83,0.83,0.55,0.59,-0.35,-37.23,25000,4,16990,0,0,0,0,0,0,13000,12000,1000,1000
20200312,708882,威剛元富97購04,0.46,0.46,0.43,0.43,-0.26,-37.68,21000,3,9630,0,0,0,0,0,0,0,21000,-21000,-21000
20200312,708883,原相元富97購02,0.65,0.68,0.43,0.45,-0.41,-47.67,929000,26,498440,0,0,0,0,0,0,348000,516000,-168000,-168000
20200312,708884,聯亞元富97購03,0.33,0.33,0.33,0.33,-0.25,-43.1,1000,1,330,0,0,0,0,0,0,1000,0,1000,1000
20200312,708885,穩懋元富97購04,1.02,1.02,0.72,0.72,-0.53,-42.4,26000,5,20040,0,0,0,0,0,0,4000,26000,-22000,-22000
20200312,708886,鈊象元富97購02,3.50,3.50,2.51,2.68,-1.52,-36.19,136000,15,369530,0,0,0,0,0,0,20000,116000,-96000,-96000
20200312,708887,鈊象台新97購02,1.70,1.70,1.68,1.68,-0.98,-36.84,31000,4,52120,0,0,0,0,0,0,26000,0,26000,26000
20200312,708888,中美晶元大97購07,,,,,,0.00,0,0,0,0,0,0,0,0,0,0,0,0,0
20200312,708889,台燿元大97購01,0.66,0.66,0.39,0.57,-0.19,-25.0,458000,8,264130,0,0,0,0,0,0,350000,100000,250000,250000
20200312,708890,宜鼎元大97購02,0.72,0.72,0.56,0.56,-0.51,-47.66,88000,3,53600,0,0,0,0,0,0,10000,78000,-68000,-68000
20200312,708891,金居元大99購01,,,,,,0.00,0,0,0,0,0,0,0,0,0,0,0,0,0
20200312,708892,胡連元大97購01,,,,,,0.00,0,0,0,0,0,0,0,0,0,0,0,0,0
20200312,708893,泰博元大97購03,2.00,2.06,1.70,2.02,-0.44,-17.89,179000,7,341820,0,0,0,0,0,0,74000,162000,-88000,-88000
20200312,708894,閎康元大97購01,0.56,0.56,0.43,0.43,-0.25,-36.76,470000,24,243100,0,260000,-260000,0,0,0,270000,200000,70000,-190000
20200312,708895,環球晶元大97購06,1.15,1.18,0.90,0.90,-0.57,-38.78,155000,6,173350,0,0,0,0,0,0,81000,107000,-26000,-26000
20200312,708896,環球晶元大97購07,0.81,0.89,0.48,0.89,-0.13,-12.75,159000,8,106790,0,0,0,0,0,0,24000,159000,-135000,-135000
20200312,708897,櫃200元大99購03,,,,,,0.00,0,0,0,0,0,0,0,0,0,0,0,0,0
20200312,708898,櫃200元大99購04,,,,,,0.00,0,0,0,0,0,0,0,0,0,0,0,0,0
20200312,708899,頎邦元大97購05,0.81,0.81,0.75,0.75,-0.19,-20.21,25000,2,18870,0,0,0,0,0,0,25000,0,25000,25000
20200312,708900,中美晶元大97購08,1.31,1.62,1.27,1.59,-0.31,-16.32,100000,10,137740,0,0,0,0,0,0,74000,26000,48000,48000
20200312,708901,台燿元大97購02,0.83,0.83,0.61,0.61,-0.31,-33.7,93000,5,63490,0,0,0,0,0,0,43000,50000,-7000,-7000
20200312,708902,迅得元大99購01,,,,,,0.00,0,0,0,0,0,0,0,0,0,0,0,0,0
20200312,708903,宜鼎元大97購03,0.55,0.55,0.43,0.43,-0.29,-40.28,169000,8,84150,0,0,0,0,0,0,98000,71000,27000,27000
20200312,708904,旺矽元大98購01,0.32,0.32,0.25,0.25,-0.18,-41.86,60000,4,16300,0,0,0,0,0,0,30000,30000,0,0
20200312,708905,威剛元大97購01,0.79,0.79,0.50,0.53,-0.35,-39.77,686000,34,434170,0,0,0,0,0,0,523000,130000,393000,393000
20200312,708906,泰博元大97購04,1.60,1.66,1.22,1.46,-0.31,-17.51,192000,33,284430,0,0,0,0,0,0,115000,77000,38000,38000
20200312,708907,精測元大97購06,0.89,0.89,0.60,0.61,-0.35,-36.46,302000,8,198060,0,0,0,0,0,0,172000,251000,-79000,-79000
20200312,708908,廣明元大97購03,,,,,,0.00,0,0,0,0,0,0,0,0,0,0,0,0,0
20200312,708909,優群元大99購01,1.22,1.22,0.96,0.98,-0.36,-26.87,35000,5,37600,0,0,0,0,0,0,25000,3000,22000,22000
20200312,708910,環球晶元大97購08,0.93,0.93,0.56,0.71,-0.45,-38.79,44000,4,34530,0,0,0,0,0,0,37000,34000,3000,3000
20200312,708911,環球晶元大97購09,0.70,0.74,0.40,0.74,-0.23,-23.71,205000,4,102950,0,0,0,0,0,0,6000,205000,-199000,-199000
20200312,708912,世界麥證97購02,0.57,0.57,0.57,0.57,-0.05,-8.06,10000,1,5700,0,10000,-10000,0,0,0,0,10000,-10000,-10000
20200312,708913,大江永豐97購03,,,,,,0.00,0,0,0,0,0,0,0,0,0,0,0,0,0
20200312,708914,旺矽永豐97購04,,,,,,0.00,0,0,0,0,0,0,0,0,0,0,0,0,0
20200312,708915,新普永豐97購01,0.15,0.15,0.15,0.15,-0.06,-28.57,33000,1,4950,0,0,0,0,0,0,0,33000,-33000,-33000
20200312,708916,精華永豐97購01,,,,,,0.00,0,0,0,0,0,0,0,0,0,0,0,0,0
20200312,708917,原相兆豐98購01,0.62,0.65,0.50,0.50,-0.27,-35.06,351000,17,191220,0,0,0,0,0,0,328000,57000,271000,271000
20200312,708918,群聯台新97購05,,,,,,0.00,0,0,0,0,0,0,0,0,0,0,0,0,0
20200312,708919,中美晶群益97購04,0.18,0.23,0.16,0.23,-0.05,-17.86,24000,3,4740,0,0,0,0,0,0,24000,0,24000,24000
20200312,708920,同致群益97購01,,,,,,0.00,0,0,0,0,0,0,0,0,0,0,0,0,0
20200312,708921,勝麗群益97購01,0.36,0.36,0.34,0.34,-0.29,-46.03,111000,3,38780,0,0,0,0,0,0,108000,3000,105000,105000
20200312,708922,緯軟群益98購02,0.29,0.29,0.21,0.21,-0.19,-47.5,265000,3,68650,0,0,0,0,0,0,165000,100000,65000,65000
20200312,708923,鈊象群益97購01,7.05,7.55,4.57,4.93,-2.62,-34.7,57000,16,335100,0,0,0,0,0,0,36000,21000,15000,15000
20200312,708924,穩懋永昌9C購01,,,,,,0.00,0,0,0,0,0,0,0,0,0,0,0,0,0
20200312,708925,世界統一97購02,,,,,,0.00,0,0,0,0,0,0,0,0,0,0,0,0,0
20200312,708926,胡連統一98購01,0.33,0.33,0.29,0.29,-0.08,-21.62,155000,8,49550,0,0,0,0,0,0,155000,0,155000,155000
20200312,708927,胡連統一99購01,,,,,,0.00,0,0,0,0,0,0,0,0,0,0,0,0,0
20200312,708928,環球晶統一97購02,0.79,0.79,0.53,0.61,-0.37,-37.76,30000,3,19300,0,0,0,0,0,0,10000,20000,-10000,-10000
20200312,708929,雍智中信97購01,,,,,,0.00,0,0,0,0,0,0,0,0,0,0,0,0,0
20200312,708930,聚積中信97購01,0.09,0.09,0.07,0.07,-0.05,-41.67,20000,2,1600,0,0,0,0,0,0,10000,10000,0,0
20200312,708931,VHQ凱基97購01,,,,,,0.00,0,0,0,0,0,0,0,0,0,0,0,0,0
20200312,708932,VHQ凱基98購01,0.15,0.15,0.15,0.15,-0.06,-28.57,100000,1,15000,0,0,0,0,0,0,0,100000,-100000,-100000
20200312,708933,神盾凱基98購02,0.24,0.24,0.20,0.20,-0.14,-41.18,26000,4,5640,0,0,0,0,0,0,0,26000,-26000,-26000
20200312,708934,晶焱凱基98購02,0.41,0.41,0.37,0.37,-0.14,-27.45,33000,4,12930,0,0,0,0,0,0,5000,28000,-23000,-23000
20200312,708935,環球晶凱基97購04,0.29,0.45,0.27,0.45,-0.10,-18.18,234000,16,73300,0,0,0,0,0,0,74000,234000,-160000,-160000
20200312,708936,環球晶凱基97購05,0.27,0.28,0.21,0.23,-0.15,-39.47,790000,34,200200,0,0,0,0,0,0,0,690000,-690000,-690000
20200312,708937,雙鴻富邦98購01,0.17,0.17,0.14,0.17,-0.10,-37.04,38000,5,5800,0,0,0,0,0,0,5000,23000,-18000,-18000
20200312,708938,大宇資國票98購01,,,,,,0.00,0,0,0,0,0,0,0,0,0,0,0,0,0
20200312,708939,金居國票98購03,,,,,,0.00,0,0,0,0,0,0,0,0,0,0,0,0,0
20200312,708940,碩禾國票98購01,0.50,0.50,0.49,0.49,-0.22,-30.99,65000,3,32260,0,0,0,0,0,0,34000,31000,3000,3000
20200312,708941,M31元富97購01,0.35,0.35,0.35,0.35,-0.14,-28.57,98000,1,34300,0,0,0,0,0,0,0,98000,-98000,-98000
20200312,708942,金居第一97購01,,,,,,0.00,0,0,0,0,0,0,0,0,0,0,0,0,0
20200312,708943,M31元富97購02,,,,,,0.00,0,0,0,0,0,0,0,0,0,0,0,0,0
20200312,708944,閎康元富97購01,0.20,0.20,0.20,0.20,-0.13,-39.39,24000,1,4800,0,0,0,0,0,0,24000,0,24000,24000
20200312,708945,大田永豐97購01,,,,,,0.00,0,0,0,0,0,0,0,0,0,0,0,0,0
20200312,708946,六角永豐97購02,,,,,,0.00,0,0,0,0,0,0,0,0,0,0,0,0,0
20200312,708947,群聯永豐97購01,0.08,0.08,0.04,0.04,-0.12,-75.0,475000,33,26000,0,0,0,0,0,0,40000,429000,-389000,-389000
20200312,708948,雙鴻永豐97購04,,,,,,0.00,0,0,0,0,0,0,0,0,0,0,0,0,0
20200312,708949,旺矽康和97購02,0.34,0.34,0.34,0.34,-0.08,-19.05,68000,1,23120,0,0,0,0,0,0,68000,0,68000,68000
20200312,708950,威剛康和97購02,,,,,,0.00,0,0,0,0,0,0,0,0,0,0,0,0,0
20200312,708951,合晶群益99購01,0.76,0.76,0.76,0.76,-0.24,-24.0,98000,1,74480,0,0,0,0,0,0,98000,0,98000,98000
20200312,708952,迅得群益98購01,,,,,,0.00,0,0,0,0,0,0,0,0,0,0,0,0,0
20200312,708953,宜鼎群益97購02,0.73,0.73,0.58,0.58,-0.63,-52.07,41000,4,26620,0,0,0,0,0,0,10000,31000,-21000,-21000
20200312,708954,胡連群益97購01,0.28,0.28,0.28,0.28,-0.09,-24.32,11000,1,3080,0,0,0,0,0,0,11000,0,11000,11000
20200312,708955,雙美群益98購01,,,,,,0.00,0,0,0,0,0,0,0,0,0,0,0,0,0
20200312,708956,大江凱基97購02,0.09,0.09,0.06,0.06,-0.03,-33.33,270000,4,17700,0,0,0,0,0,0,220000,0,220000,220000
20200312,708957,世界凱基97購01,0.77,0.92,0.77,0.81,-0.07,-7.95,100000,4,84000,0,0,0,0,0,0,60000,40000,20000,20000
20200312,708958,台燿凱基98購01,0.96,0.96,0.95,0.95,-0.23,-19.49,40000,2,38150,0,0,0,0,0,0,40000,0,40000,40000
20200312,708959,宣德凱基98購01,0.96,0.96,0.73,0.73,-0.41,-35.96,168000,7,153420,0,0,0,0,0,0,148000,20000,128000,128000
20200312,708960,璟德凱基97購01,,,,,,0.00,0,0,0,0,0,0,0,0,0,0,0,0,0
20200312,708961,環球晶凱基97購06,1.00,1.00,0.93,0.93,-0.21,-18.42,26000,2,24600,0,0,0,0,0,0,26000,26000,0,0
20200312,708962,鈊象凱基98購04,3.10,3.17,2.09,2.19,-1.37,-38.48,372000,27,897720,0,0,0,0,0,0,235000,135000,100000,100000
20200312,708963,譜瑞凱基97購02,1.16,1.16,0.73,0.77,-0.57,-42.54,87000,11,78940,0,0,0,0,0,0,27000,87000,-60000,-60000
20200312,708964,信昌電國票98購03,,,,,,0.00,0,0,0,0,0,0,0,0,0,0,0,0,0
20200312,708965,廣明國票98購03,,,,,,0.00,0,0,0,0,0,0,0,0,0,0,0,0,0
20200312,708966,聯亞國票98購01,,,,,,0.00,0,0,0,0,0,0,0,0,0,0,0,0,0
20200312,708967,大江元大97購05,,,,,,0.00,0,0,0,0,0,0,0,0,0,0,0,0,0
20200312,708968,中美晶元大97購09,0.65,0.65,0.57,0.57,-0.23,-28.75,11000,2,6350,0,0,0,0,0,0,11000,1000,10000,10000
20200312,708969,宣德元大97購03,0.75,0.75,0.55,0.55,-0.34,-38.2,176000,8,113460,0,0,0,0,0,0,95000,117000,-22000,-22000
20200312,708970,群聯元大97購07,1.66,1.66,1.01,1.01,-1.17,-53.67,73000,7,104790,0,0,0,0,0,0,48000,53000,-5000,-5000
20200312,708971,精測元大97購07,0.57,0.57,0.57,0.57,-0.21,-26.92,63000,1,35910,0,0,0,0,0,0,0,63000,-63000,-63000
20200312,708972,網龍元大98購02,0.12,0.12,0.12,0.12,-0.04,-25.0,100000,1,12000,0,0,0,0,0,0,0,100000,-100000,-100000
20200312,708973,聚積元大97購01,,,,,,0.00,0,0,0,0,0,0,0,0,0,0,0,0,0
20200312,708974,環球晶元大97購10,0.64,0.64,0.45,0.49,-0.37,-43.02,57000,6,31680,0,0,0,0,0,0,37000,27000,10000,10000
20200312,708975,環球晶元大97購11,1.03,1.03,0.88,0.93,-0.40,-30.08,45000,4,42350,0,0,0,0,0,0,39000,29000,10000,10000
20200312,708976,環球晶元大97購12,0.80,0.80,0.52,0.79,-0.12,-13.19,153000,14,103320,0,0,0,0,0,0,97000,78000,19000,19000
20200312,708977,M31兆豐97購01,0.17,0.17,0.17,0.17,-0.15,-46.88,70000,2,11900,0,0,0,0,0,0,70000,0,70000,70000
20200312,708978,頎邦兆豐97購01,,,,,,0.00,0,0,0,0,0,0,0,0,0,0,0,0,0
20200312,708979,VHQ統一98購01,0.24,0.25,0.24,0.24,-0.08,-25.0,154000,3,36980,0,0,0,0,0,0,150000,4000,146000,146000
20200312,708980,威剛統一98購01,,,,,,0.00,0,0,0,0,0,0,0,0,0,0,0,0,0
20200312,708981,光頡國票98購03,,,,,,0.00,0,0,0,0,0,0,0,0,0,0,0,0,0
20200312,708982,大學光國泰99購01,1.12,1.12,0.84,0.84,-0.36,-30.0,211000,37,200470,0,0,0,0,0,0,111000,100000,11000,11000
20200312,708983,穩懋國泰98購02,1.18,1.18,0.78,0.78,-0.69,-46.94,363000,12,344360,0,0,0,0,0,0,244000,210000,34000,34000
20200312,708984,大江凱基97購03,0.18,0.18,0.18,0.18,-0.17,-48.57,489000,1,88020,0,0,0,0,0,0,489000,0,489000,489000
20200312,708985,六角凱基99購02,0.35,0.35,0.29,0.29,-0.11,-27.5,170000,6,54100,0,0,0,0,0,0,0,170000,-170000,-170000
20200312,708986,旺矽凱基97購02,0.48,0.48,0.48,0.48,-0.16,-25.0,20000,1,9600,0,0,0,0,0,0,20000,0,20000,20000
20200312,708987,環球晶凱基97購07,,,,,,0.00,0,0,0,0,0,0,0,0,0,0,0,0,0
20200312,708988,雙鴻凱基98購02,0.60,0.60,0.47,0.48,-0.42,-46.67,185000,8,90350,0,0,0,0,0,0,145000,40000,105000,105000
20200312,708989,穩懋凱基97購05,1.49,1.51,1.10,1.10,-1.11,-50.23,36000,3,51700,0,0,0,0,0,0,26000,10000,16000,16000
20200312,708990,穩懋凱基98購01,1.48,1.51,1.08,1.08,-0.89,-45.18,57000,4,70090,0,0,0,0,0,0,46000,11000,35000,35000
20200312,708991,穩懋凱基98購02,,,,,,0.00,0,0,0,0,0,0,0,0,0,0,0,0,0
20200312,708992,M31元大98購02,0.40,0.40,0.38,0.38,-0.28,-42.42,45000,2,17700,0,0,0,0,0,0,15000,30000,-15000,-15000
20200312,708993,大學光元大98購01,1.10,1.10,0.84,0.91,-0.42,-31.58,37000,5,37100,0,0,0,0,0,0,37000,0,37000,37000
20200312,708994,中美晶元大98購01,0.90,0.91,0.74,0.80,-0.37,-31.62,107000,23,89390,0,0,0,0,0,0,49000,75000,-26000,-26000
20200312,708995,世界元大97購01,1.41,1.57,1.40,1.57,-0.18,-10.29,171000,5,244130,0,0,0,0,0,0,5000,166000,-161000,-161000
20200312,708996,保瑞元大97購01,2.85,2.85,2.35,2.54,-0.54,-17.53,634000,18,1614260,0,0,0,0,0,0,624000,40000,584000,584000
20200312,708997,晶焱元大99購01,0.77,0.77,0.67,0.67,-0.14,-17.28,47000,3,33150,0,0,0,0,0,0,40000,7000,33000,33000
20200312,708998,大學光康和9B購01,0.50,0.50,0.50,0.50,-0.09,-15.25,5000,1,2500,0,0,0,0,0,0,0,5000,-5000,-5000
20200312,708999,泰博群益97購02,3.32,3.32,2.39,2.39,-1.32,-35.58,70000,7,219340,0,0,0,0,0,0,40000,20000,20000,20000
20200312,709000,環球晶群益98購01,1.30,1.30,0.80,0.80,-0.66,-45.21,266000,11,285600,0,0,0,0,0,0,206000,81000,125000,125000
20200312,709001,鈺太群益97購01,0.35,0.35,0.35,0.35,-0.13,-27.08,20000,1,7000,0,0,0,0,0,0,20000,0,20000,20000
20200312,709002,環球晶日盛97購01,0.47,0.47,0.47,0.47,-0.31,-39.74,10000,1,4700,0,0,0,0,0,0,10000,10000,0,0
20200312,709003,世禾永豐97購02,,,,,,0.00,0,0,0,0,0,0,0,0,0,0,0,0,0
20200312,709004,順達永豐97購01,0.57,0.57,0.56,0.56,-0.20,-26.32,14000,3,7860,0,0,0,0,0,0,9000,5000,4000,4000
20200312,709005,新揚科永豐97購01,0.17,0.17,0.17,0.17,-0.09,-34.62,10000,1,1700,0,0,0,0,0,0,0,10000,-10000,-10000
20200312,709006,穩懋永豐97購03,0.45,0.45,0.28,0.30,-0.47,-61.04,36000,8,11520,0,0,0,0,0,0,21000,7000,14000,14000
20200312,709007,勝麗台新97購01,0.30,0.30,0.30,0.30,-0.10,-25.0,38000,1,11400,0,0,0,0,0,0,0,38000,-38000,-38000
20200312,709008,中美晶元富99購01,0.80,0.80,0.62,0.75,-0.11,-12.79,199000,15,138770,0,0,0,0,0,0,118000,131000,-13000,-13000
20200312,709009,信昌電元富97購02,1.00,1.00,1.00,1.00,-0.25,-20.0,10000,1,10000,0,0,0,0,0,0,10000,0,10000,10000
20200312,709010,宣德元富97購01,1.33,1.33,1.28,1.28,-0.33,-20.5,66000,2,87480,0,0,0,0,0,0,66000,0,66000,66000
20200312,709011,緯軟元富97購01,,,,,,0.00,0,0,0,0,0,0,0,0,0,0,0,0,0
20200312,709012,環球晶元富97購03,0.57,0.57,0.57,0.57,-0.14,-19.72,10000,1,5700,0,0,0,0,0,0,0,10000,-10000,-10000
20200312,709013,環球晶元富97購04,0.47,0.51,0.46,0.51,-0.31,-37.8,35000,4,16850,0,0,0,0,0,0,0,35000,-35000,-35000
20200312,709014,鈊象元富97購04,5.25,5.25,5.25,5.25,-1.55,-22.79,5000,1,26250,0,0,0,0,0,0,5000,0,5000,5000
20200312,709015,世禾統一99購01,0.11,0.11,0.11,0.11,-0.07,-38.89,15000,2,1650,0,0,0,0,0,0,5000,10000,-5000,-5000
20200312,709016,世禾統一9A購01,,,,,,0.00,0,0,0,0,0,0,0,0,0,0,0,0,0
20200312,709017,金居統一98購01,1.64,1.64,1.64,1.64,-0.33,-16.75,20000,1,32800,0,0,0,0,0,0,20000,0,20000,20000
20200312,709018,順達統一99購01,0.56,0.56,0.54,0.54,-0.14,-20.59,35000,3,19140,0,0,0,0,0,0,3000,32000,-29000,-29000
20200312,709019,中美晶凱基9A購01,0.80,0.94,0.80,0.94,-0.25,-21.01,250000,7,226000,0,0,0,0,0,0,110000,140000,-30000,-30000
20200312,709020,迅得凱基9A購01,,,,,,0.00,0,0,0,0,0,0,0,0,0,0,0,0,0
20200312,709021,亞泰凱基9A購01,0.45,0.45,0.41,0.41,-0.06,-12.77,13000,2,5450,0,0,0,0,0,0,10000,3000,7000,7000
20200312,709022,保瑞凱基98購01,1.31,1.35,1.25,1.26,-0.37,-22.7,216000,25,283750,0,0,0,0,0,0,179000,55000,124000,124000
20200312,709023,新普凱基98購02,0.63,0.63,0.60,0.60,-0.19,-24.05,25000,3,15410,0,0,0,0,0,0,25000,0,25000,25000
20200312,709024,環球晶凱基98購01,0.82,0.82,0.74,0.76,-0.14,-15.56,40000,4,31290,0,0,0,0,0,0,40000,30000,10000,10000
20200312,709025,環球晶凱基99購01,0.65,0.68,0.44,0.60,-0.27,-31.03,197000,12,119240,0,0,0,0,0,0,41000,163000,-122000,-122000
20200312,709026,穩懋日盛98購01,0.92,0.92,0.63,0.63,-0.53,-45.69,369000,19,280130,0,0,0,0,0,0,74000,299000,-225000,-225000
20200312,709027,大江國票99購01,0.69,0.70,0.42,0.47,-0.31,-39.74,504000,20,311590,0,0,0,0,0,0,432000,67000,365000,365000
20200312,709028,凡甲富邦9A購01,0.60,0.60,0.55,0.55,-0.10,-15.38,241000,33,136310,0,0,0,0,0,0,241000,0,241000,241000
20200312,709029,聯亞富邦9A購01,0.26,0.29,0.23,0.23,-0.16,-41.03,111000,7,28170,0,0,0,0,0,0,58000,53000,5000,5000
20200312,709030,大江元大98購01,0.39,0.39,0.31,0.31,-0.17,-35.42,100000,5,33200,0,0,0,0,0,0,50000,50000,0,0
20200312,709031,群聯元大99購01,1.48,1.48,1.03,1.05,-0.92,-46.7,101000,7,136450,0,0,0,0,0,0,23000,101000,-78000,-78000
20200312,709032,碩禾元大99購01,0.58,0.58,0.48,0.48,-0.22,-31.43,105000,3,58600,0,0,0,0,0,0,100000,105000,-5000,-5000
20200312,709033,優群元大99購02,1.61,1.61,1.18,1.25,-0.52,-29.38,430000,24,581830,0,0,0,0,0,0,310000,122000,188000,188000
20200312,709034,環球晶元大98購01,0.71,0.73,0.71,0.73,-0.25,-25.51,75000,2,54610,0,0,0,0,0,0,7000,75000,-68000,-68000
20200312,709035,環球晶元大98購02,0.98,0.98,0.70,0.70,-0.63,-47.37,50000,5,42060,0,0,0,0,0,0,39000,40000,-1000,-1000
20200312,709036,環球晶元大98購03,0.82,0.82,0.62,0.68,-0.33,-32.67,78000,6,55160,0,0,0,0,0,0,48000,57000,-9000,-9000
20200312,709037,聯亞元大99購01,0.56,0.56,0.43,0.43,-0.31,-41.89,141000,4,66880,0,0,0,0,0,0,1000,141000,-140000,-140000
20200312,709038,譜瑞元大98購02,2.55,2.55,1.75,1.75,-1.07,-37.94,173000,20,347810,0,0,0,0,0,0,65000,112000,-47000,-47000
20200312,709039,譜瑞元富98購01,1.36,1.38,0.91,0.93,-0.59,-38.82,970000,39,1114930,0,0,0,0,0,0,511000,449000,62000,62000
20200312,709040,勝麗台新98購01,0.35,0.35,0.35,0.35,-0.18,-33.96,38000,1,13300,0,0,0,0,0,0,0,38000,-38000,-38000
20200312,709041,精測台新99購01,0.37,0.37,0.37,0.37,-0.02,-5.13,10000,1,3700,0,0,0,0,0,0,10000,0,10000,10000
20200312,709042,宣德兆豐98購01,0.67,0.67,0.60,0.60,-0.27,-31.03,30000,4,19350,0,0,0,0,0,0,0,30000,-30000,-30000
20200312,709043,威剛群益9A購01,,,,,,0.00,0,0,0,0,0,0,0,0,0,0,0,0,0
20200312,709044,統新康和98購01,,,,,,0.00,0,0,0,0,0,0,0,0,0,0,0,0,0
20200312,709045,神盾群益9A購01,2.12,2.21,2.12,2.20,-0.49,-18.22,50000,3,109500,0,0,0,0,0,0,30000,20000,10000,10000
20200312,709046,廣明群益98購01,1.07,1.07,1.01,1.01,-0.15,-12.93,159000,3,163410,0,0,0,0,0,0,159000,0,159000,159000
20200312,709047,世禾永豐98購01,,,,,,0.00,0,0,0,0,0,0,0,0,0,0,0,0,0
20200312,709048,合晶永豐98購01,1.36,1.36,0.94,1.10,-0.33,-23.08,137000,14,158370,0,0,0,0,0,0,40000,117000,-77000,-77000
20200312,709049,亞泰永豐99購01,0.86,0.86,0.85,0.85,-0.10,-10.53,212000,20,181620,0,0,0,0,0,0,0,212000,-212000,-212000
20200312,709050,金居永豐98購01,1.61,1.61,1.05,1.13,-0.83,-42.35,110000,11,137500,0,0,0,0,0,0,20000,90000,-70000,-70000
20200312,709051,統新永豐98購01,0.55,0.55,0.43,0.43,-0.26,-37.68,210000,9,101860,0,0,0,0,0,0,80000,130000,-50000,-50000
20200312,709052,鈊象永豐98購02,1.89,2.03,1.26,1.26,-0.88,-41.12,213000,32,334150,0,0,0,0,0,0,35000,179000,-144000,-144000
20200312,709053,M31元大98購03,1.22,1.22,0.91,0.91,-0.65,-41.67,46000,2,54260,0,0,0,0,0,0,46000,0,46000,46000
20200312,709054,凡甲元大9A購01,1.15,1.15,1.08,1.08,-0.19,-14.96,210000,4,230300,0,0,0,0,0,0,200000,10000,190000,190000
20200312,709055,中美晶元大99購01,1.73,1.73,1.32,1.51,-0.31,-17.03,138000,9,216080,0,0,0,0,0,0,70000,126000,-56000,-56000
20200312,709056,群聯元大98購03,1.71,1.71,1.17,1.20,-0.86,-41.75,110000,10,139030,0,0,0,0,0,0,29000,105000,-76000,-76000
20200312,709057,精測元大98購02,0.96,0.96,0.69,0.74,-0.25,-25.25,584000,20,438310,0,0,0,0,0,0,47000,537000,-490000,-490000
20200312,709058,緯軟元大98購01,0.72,0.72,0.67,0.67,-0.29,-30.21,51000,3,36670,0,0,0,0,0,0,51000,21000,30000,30000
20200312,709059,鈊象元大99購02,4.57,4.70,3.35,3.35,-1.57,-31.91,356000,36,1296360,0,0,0,0,0,0,274000,123000,151000,151000
20200312,709060,大江國泰9A購01,1.23,1.23,0.93,0.93,-0.38,-29.01,165000,7,192850,0,0,0,0,0,0,125000,79000,46000,46000
20200312,709061,台燿國泰99購01,,,,,,0.00,0,0,0,0,0,0,0,0,0,0,0,0,0
20200312,709062,合晶國泰99購01,1.63,1.63,1.13,1.22,-0.67,-35.45,40000,4,54400,0,0,0,0,0,0,20000,20000,0,0
20200312,709063,雍智國票99購01,3.24,3.24,2.75,2.75,-1.09,-28.39,65000,4,201450,0,0,0,0,0,0,65000,0,65000,65000
20200312,709064,網龍國票99購01,,,,,,0.00,0,0,0,0,0,0,0,0,0,0,0,0,0
20200312,709065,雙鴻國票99購01,0.82,0.83,0.68,0.70,-0.40,-36.36,68000,7,50240,0,0,0,0,0,0,0,68000,-68000,-68000
20200312,709066,中美晶統一98購01,,,,,,0.00,0,0,0,0,0,0,0,0,0,0,0,0,0
20200312,709067,統新統一01購01,,,,,,0.00,0,0,0,0,0,0,0,0,0,0,0,0,0
20200312,709068,統新統一98購01,0.81,0.81,0.66,0.66,-0.30,-31.25,40000,3,28300,0,0,0,0,0,0,0,40000,-40000,-40000
20200312,709069,統新統一9B購01,0.53,0.53,0.53,0.53,-0.14,-20.9,30000,1,15900,0,0,0,0,0,0,30000,0,30000,30000
20200312,709070,統新統一9C購01,0.39,0.39,0.30,0.30,-0.29,-49.15,60000,3,22500,0,0,0,0,0,0,0,50000,-50000,-50000
20200312,709071,鈊象統一9A購01,,,,,,0.00,0,0,0,0,0,0,0,0,0,0,0,0,0
20200312,709072,鈊象中信98購01,0.95,1.02,0.72,0.72,-0.31,-30.1,826000,72,684310,0,0,0,0,0,0,312000,488000,-176000,-176000
20200312,709073,大江凱基98購04,1.21,1.21,0.99,0.99,-0.56,-36.13,64000,4,67060,0,0,0,0,0,0,49000,15000,34000,34000
20200312,709074,大學光凱基9A購01,0.50,0.50,0.39,0.39,-0.19,-32.76,106000,3,41500,0,0,0,0,0,0,0,106000,-106000,-106000
20200312,709075,中美晶凱基98購01,,,,,,0.00,0,0,0,0,0,0,0,0,0,0,0,0,0
20200312,709076,合晶凱基98購02,1.50,1.50,1.21,1.34,-0.48,-26.37,93000,6,127340,0,0,0,0,0,0,63000,90000,-27000,-27000
20200312,709077,宜鼎凱基98購02,,,,,,0.00,0,0,0,0,0,0,0,0,0,0,0,0,0
20200312,709078,昇達科凱基98購01,1.09,1.11,0.94,0.94,-0.39,-29.32,460000,10,503840,0,450000,-450000,0,0,0,450000,10000,440000,-10000
20200312,709079,信昌電凱基98購03,1.10,1.10,1.10,1.10,-0.86,-43.88,10000,1,11000,0,0,0,0,0,0,0,10000,-10000,-10000
20200312,709080,宣德凱基98購02,1.27,1.27,1.27,1.27,-0.29,-18.59,20000,1,25400,0,0,0,0,0,0,20000,0,20000,20000
20200312,709081,原相凱基98購03,1.81,1.81,1.60,1.60,-0.90,-36.0,81000,6,141360,0,0,0,0,0,0,55000,26000,29000,29000
20200312,709082,精測凱基98購03,0.72,0.72,0.56,0.56,-0.29,-34.12,288000,7,175620,0,0,0,0,0,0,144000,144000,0,0
20200312,709083,廣明凱基98購03,,,,,,0.00,0,0,0,0,0,0,0,0,0,0,0,0,0
20200312,709084,優群凱基9A購01,,,,,,0.00,0,0,0,0,0,0,0,0,0,0,0,0,0
20200312,709085,環球晶凱基98購02,2.12,2.12,1.71,1.95,-0.57,-22.62,76000,9,148390,0,0,0,0,0,0,46000,76000,-30000,-30000
20200312,709086,環球晶凱基99購02,1.44,1.47,1.30,1.37,-0.26,-15.95,119000,7,170760,0,0,0,0,0,0,41000,109000,-68000,-68000
20200312,709087,聯亞凱基98購02,1.38,1.38,1.38,1.38,-0.24,-14.81,10000,1,13800,0,0,0,0,0,0,10000,0,10000,10000
20200312,709088,鈊象凱基9A購01,3.76,3.76,2.67,2.72,-1.38,-33.66,120000,9,343550,0,0,0,0,0,0,30000,90000,-60000,-60000
20200312,709089,統新元富98購01,0.62,0.62,0.47,0.47,-0.28,-37.33,82000,6,45920,0,0,0,0,0,0,42000,40000,2000,2000
20200312,709090,統新元富98購02,0.71,0.71,0.70,0.70,-0.10,-12.5,40000,2,28200,0,0,0,0,0,0,40000,0,40000,40000
20200312,709091,穩懋統一98購03,1.48,1.48,1.10,1.10,-0.75,-40.54,59000,3,83150,0,0,0,0,0,0,0,59000,-59000,-59000
20200312,709092,鈊象中信99購02,1.41,1.41,1.00,1.01,-0.50,-33.11,857000,71,977950,0,0,0,0,0,0,399000,396000,3000,3000
20200312,709093,VHQ元大99購01,1.21,1.21,1.20,1.20,-0.34,-22.08,140000,2,169300,0,0,0,0,0,0,140000,130000,10000,10000
20200312,709094,大江元大99購01,1.11,1.14,0.85,0.86,-0.36,-29.51,593000,13,621850,0,0,0,0,0,0,280000,510000,-230000,-230000
20200312,709095,六角元大99購01,0.50,0.50,0.40,0.40,-0.17,-29.82,45000,4,20550,0,0,0,0,0,0,15000,30000,-15000,-15000
20200312,709096,同致元大99購01,0.46,0.77,0.46,0.46,-0.29,-38.67,32000,4,18440,0,0,0,0,0,0,0,32000,-32000,-32000
20200312,709097,建榮元大98購01,0.96,0.96,0.80,0.80,-0.30,-27.27,225000,7,206920,0,0,0,0,0,0,225000,191000,34000,34000
20200312,709098,原相元大9A購01,1.99,2.01,1.55,1.55,-0.67,-30.18,555000,27,938620,0,0,0,0,0,0,474000,484000,-10000,-10000
20200312,709099,鈊象元大99購03,2.36,2.42,1.60,1.71,-0.80,-31.87,1908000,88,4067880,0,0,0,0,0,0,1253000,693000,560000,560000
20200312,709100,鈺太元大99購02,1.15,1.15,0.92,0.92,-0.41,-30.83,116000,9,117720,0,0,0,0,0,0,42000,83000,-41000,-41000
20200312,709101,泰博元富98購01,1.42,1.42,1.27,1.30,-0.30,-18.75,231000,5,302370,0,0,0,0,0,0,56000,175000,-119000,-119000
20200312,709102,三貝德群益98購01,,,,,,0.00,0,0,0,0,0,0,0,0,0,0,0,0,0
20200312,709103,中美晶群益98購01,3.19,3.19,2.23,2.23,-1.74,-43.83,23000,2,61850,0,0,0,0,0,0,23000,0,23000,23000
20200312,709104,良維群益98購01,1.37,1.37,1.01,1.01,-0.56,-35.67,84000,9,105580,0,0,0,0,0,0,45000,39000,6000,6000
20200312,709105,宣德群益98購01,2.03,2.06,1.62,1.65,-1.00,-37.74,143000,5,242240,0,0,0,0,0,0,131000,12000,119000,119000
20200312,709106,統新群益98購01,1.44,1.49,1.10,1.10,-0.47,-29.94,45000,6,64530,0,0,0,0,0,0,33000,12000,21000,21000
20200312,709107,晶焱群益98購02,0.56,0.56,0.50,0.50,-0.25,-33.33,108000,2,54600,0,0,0,0,0,0,108000,0,108000,108000
20200312,709108,金居國票99購01,0.88,0.88,0.65,0.65,-0.44,-40.37,130000,6,96600,0,0,0,0,0,0,50000,80000,-30000,-30000
20200312,709109,統新國票98購01,,,,,,0.00,0,0,0,0,0,0,0,0,0,0,0,0,0
20200312,709110,聯亞國票99購01,2.11,2.11,1.68,1.68,-1.20,-41.67,61000,6,108960,0,0,0,0,0,0,23000,38000,-15000,-15000
20200312,709111,VHQ永豐98購01,0.98,0.98,0.98,0.98,-0.46,-31.94,2000,1,1960,0,0,0,0,0,0,2000,0,2000,2000
20200312,709112,大宇資永豐98購01,0.83,0.83,0.79,0.79,-0.10,-11.24,27000,3,21810,0,0,0,0,0,0,10000,17000,-7000,-7000
20200312,709113,大學光永豐9A購01,,,,,,0.00,0,0,0,0,0,0,0,0,0,0,0,0,0
20200312,709114,波若威永豐99購01,0.54,0.54,0.48,0.48,-0.21,-30.43,26000,2,12540,0,0,0,0,0,0,25000,1000,24000,24000
20200312,709115,金可永豐98購01,0.35,0.35,0.24,0.25,-0.17,-40.48,235000,13,61900,40000,0,40000,0,0,0,25000,210000,-185000,-145000
20200312,709116,環球晶永豐98購01,,,,,,0.00,0,0,0,0,0,0,0,0,0,0,0,0,0
20200312,709117,大江凱基98購05,1.10,1.10,0.76,0.76,-0.60,-44.12,32000,4,29000,0,0,0,0,0,0,0,32000,-32000,-32000
20200312,709118,元太凱基98購01,1.14,1.14,0.87,0.87,-0.44,-33.59,54000,4,49800,0,0,0,0,0,0,44000,13000,31000,31000
20200312,709119,台燿凱基98購02,1.34,1.34,1.16,1.16,-0.47,-28.83,61000,3,76060,0,0,0,0,0,0,25000,36000,-11000,-11000
20200312,709120,同致凱基98購03,0.56,0.56,0.38,0.38,-0.35,-47.95,120000,8,49640,0,0,0,0,0,0,0,120000,-120000,-120000
20200312,709121,合晶凱基98購03,1.62,1.65,1.16,1.45,-0.55,-27.5,190000,9,241740,0,0,0,0,0,0,150000,80000,70000,70000
20200312,709122,宜鼎凱基98購03,0.90,0.90,0.75,0.75,-0.49,-39.52,201000,3,152900,0,0,0,0,0,0,1000,200000,-199000,-199000
20200312,709123,昇達科凱基98購02,0.74,0.76,0.62,0.62,-0.29,-31.87,547000,14,402400,0,450000,-450000,0,0,0,537000,97000,440000,-10000
20200312,709124,信昌電凱基98購04,0.69,0.69,0.68,0.68,-0.21,-23.6,48000,3,32960,0,0,0,0,0,0,48000,48000,0,0
20200312,709125,原相凱基98購04,3.27,3.27,2.44,2.55,-1.18,-31.64,67000,19,189110,0,0,0,0,0,0,56000,39000,17000,17000
20200312,709126,勝麗凱基98購02,1.04,1.05,1.01,1.05,-0.29,-21.64,57000,4,58970,0,0,0,0,0,0,57000,0,57000,57000
20200312,709127,群聯凱基98購03,1.54,1.54,1.06,1.10,-0.84,-43.3,55000,9,60540,0,0,0,0,0,0,14000,55000,-41000,-41000
20200312,709128,廣明凱基98購04,,,,,,0.00,0,0,0,0,0,0,0,0,0,0,0,0,0
20200312,709129,璟德凱基98購02,1.03,1.05,0.77,0.77,-0.46,-37.4,295000,12,252490,0,0,0,0,0,0,65000,230000,-165000,-165000
20200312,709130,優群凱基9A購02,1.28,1.28,1.28,1.28,-0.53,-29.28,15000,1,19200,0,0,0,0,0,0,0,15000,-15000,-15000
20200312,709131,穩懋凱基98購03,1.00,1.00,0.72,0.73,-0.49,-40.16,46000,6,37100,0,0,0,0,0,0,25000,25000,0,0
20200312,709132,穩懋凱基98購04,1.11,1.14,1.11,1.14,-0.57,-33.33,30000,2,33900,0,0,0,0,0,0,20000,10000,10000,10000
20200312,709133,頎邦凱基98購01,1.37,1.37,1.08,1.08,-0.47,-30.32,22000,4,27300,0,0,0,0,0,0,10000,12000,-2000,-2000
20200312,709134,環球晶統一98購01,,,,,,0.00,0,0,0,0,0,0,0,0,0,0,0,0,0
20200312,709135,原相凱基99購01,0.82,0.82,0.66,0.68,-0.31,-31.31,162000,8,126470,0,0,0,0,0,0,28000,162000,-134000,-134000
20200312,709136,群聯凱基98購04,1.34,1.34,0.94,1.01,-0.62,-38.04,307000,17,320830,0,0,0,0,0,0,286000,301000,-15000,-15000
20200312,709137,碩禾凱基9A購01,0.40,0.40,0.35,0.35,-0.13,-27.08,156000,4,59400,0,0,0,0,0,0,0,156000,-156000,-156000
20200312,709138,M31元大99購02,,,,,,0.00,0,0,0,0,0,0,0,0,0,0,0,0,0
20200312,709139,鈊象元大99購04,3.50,3.50,2.86,3.00,-1.27,-29.74,147000,11,462730,0,0,0,0,0,0,57000,124000,-67000,-67000
20200312,709140,泰博國票99購01,3.64,3.64,2.77,2.77,-1.31,-32.11,38000,5,121020,0,0,0,0,0,0,13000,25000,-12000,-12000
20200312,709141,神盾國泰9A購01,1.46,1.46,1.18,1.19,-0.67,-36.02,423000,6,538370,0,0,0,0,0,0,3000,420000,-417000,-417000
20200312,709142,宣德富邦9A購01,1.90,1.90,1.60,1.60,-0.53,-24.88,38000,5,69610,0,0,0,0,0,0,33000,5000,28000,28000
20200312,709143,環球晶富邦9A購01,0.48,0.51,0.36,0.51,-0.02,-3.77,470000,16,198360,0,0,0,0,0,0,302000,168000,134000,134000
20200312,709144,信昌電亞東99購01,0.29,0.29,0.29,0.29,-0.18,-38.3,200000,1,58000,0,0,0,0,0,0,0,200000,-200000,-200000
20200312,709145,大江永豐98購01,0.58,0.58,0.41,0.41,-0.31,-43.06,104000,4,50390,0,0,0,0,0,0,36000,68000,-32000,-32000
20200312,709146,同致永豐98購01,0.51,0.51,0.46,0.46,-0.26,-36.11,67000,2,33570,0,0,0,0,0,0,55000,12000,43000,43000
20200312,709147,合晶永豐98購02,0.87,0.87,0.63,0.63,-0.40,-38.83,111000,6,86620,0,0,0,0,0,0,27000,84000,-57000,-57000
20200312,709148,良維永豐98購01,0.57,0.57,0.47,0.47,-0.42,-47.19,72000,3,35290,0,0,0,0,0,0,57000,15000,42000,42000
20200312,709149,東隆興永豐98購01,0.55,0.55,0.54,0.54,-0.17,-23.94,40000,2,21700,0,0,0,0,0,0,40000,0,40000,40000
20200312,709150,南光永豐98購01,0.32,0.37,0.32,0.32,-0.22,-40.74,61000,3,19570,0,0,0,0,0,0,50000,11000,39000,39000
20200312,709151,茂達永豐98購01,1.03,1.03,0.78,0.83,-0.32,-27.83,373000,21,358280,0,0,0,0,0,0,81000,290000,-209000,-209000
20200312,709152,新潤永豐98購01,0.60,0.60,0.57,0.57,-0.09,-13.64,96000,2,57240,0,0,0,0,0,0,0,96000,-96000,-96000
20200312,709153,大江兆豐98購01,0.67,0.67,0.49,0.49,-0.23,-31.94,153000,10,88560,0,0,0,0,0,0,33000,120000,-87000,-87000
20200312,709154,VHQ康和98購01,1.04,1.04,0.93,0.93,-0.18,-16.22,11000,2,10560,0,0,0,0,0,0,8000,3000,5000,5000
20200312,709155,世界群益9A購01,1.10,1.28,1.06,1.28,+0.01,0.79,41000,4,47000,0,0,0,0,0,0,11000,30000,-19000,-19000
20200312,709156,台燿群益99購01,0.88,0.88,0.74,0.75,-0.25,-25.0,181000,13,150310,0,0,0,0,0,0,63000,127000,-64000,-64000
20200312,709157,威剛群益9A購02,0.73,0.73,0.58,0.60,-0.39,-39.39,45000,3,30800,0,0,0,0,0,0,30000,15000,15000,15000
20200312,709158,廣明群益98購02,,,,,,0.00,0,0,0,0,0,0,0,0,0,0,0,0,0
20200312,709159,優群群益99購02,,,,,,0.00,0,0,0,0,0,0,0,0,0,0,0,0,0
20200312,709160,大江元富98購01,1.17,1.17,1.17,1.17,-0.32,-21.48,10000,1,11700,0,0,0,0,0,0,0,10000,-10000,-10000
20200312,709161,元太台新98購01,0.94,0.94,0.70,0.70,-0.38,-35.19,215000,3,153850,0,0,0,0,0,0,0,215000,-215000,-215000
20200312,709162,鈊象台新98購02,1.28,1.28,1.28,1.28,-0.58,-31.18,80000,1,102400,0,0,0,0,0,0,0,80000,-80000,-80000
20200312,709163,宇峻元大99購01,0.55,0.58,0.38,0.38,-0.18,-32.14,242000,3,137610,0,0,0,0,0,0,35000,207000,-172000,-172000
20200312,709164,金居元大99購02,1.29,1.29,1.02,1.02,-0.44,-30.14,236000,7,247640,0,0,0,0,0,0,1000,236000,-235000,-235000
20200312,709165,新鉅科元大98購01,0.60,0.60,0.50,0.50,-0.39,-43.82,10000,3,5410,0,0,0,0,0,0,5000,5000,0,0
20200312,709166,上詮永豐98購01,0.50,0.50,0.39,0.39,-0.21,-35.0,99000,6,41850,0,0,0,0,0,0,10000,89000,-79000,-79000
20200312,709167,光頡永豐98購01,0.47,0.47,0.46,0.46,-0.12,-20.69,40000,2,18700,0,0,0,0,0,0,30000,10000,20000,20000
20200312,709168,波若威永豐98購02,0.59,0.59,0.44,0.45,-0.26,-36.62,111000,4,59870,0,0,0,0,0,0,101000,10000,91000,91000
20200312,709169,建榮永豐99購02,0.42,0.42,0.41,0.41,-0.19,-31.67,55000,2,22600,0,0,0,0,0,0,0,55000,-55000,-55000
20200312,709170,健信永豐98購01,0.32,0.32,0.31,0.31,-0.11,-26.19,35000,4,10910,0,0,0,0,0,0,3000,32000,-29000,-29000
20200312,709171,璟德永豐98購01,,,,,,0.00,0,0,0,0,0,0,0,0,0,0,0,0,0
20200312,709172,統新國泰99購01,1.26,1.26,1.01,1.01,-0.41,-28.87,30000,2,35300,0,0,0,0,0,0,20000,10000,10000,10000
20200312,709173,環球晶統一99購02,,,,,,0.00,0,0,0,0,0,0,0,0,0,0,0,0,0
20200312,709174,太醫中信99購01,0.72,0.72,0.66,0.67,-0.08,-10.67,130000,7,88700,0,0,0,0,0,0,60000,70000,-10000,-10000
20200312,709175,環球晶中信98購01,0.22,0.22,0.19,0.19,-0.11,-36.67,40000,2,8500,0,0,0,0,0,0,40000,0,40000,40000
20200312,709176,大江凱基98購06,,,,,,0.00,0,0,0,0,0,0,0,0,0,0,0,0,0
20200312,709177,宣德凱基98購03,1.04,1.04,1.04,1.04,-0.38,-26.76,30000,1,31200,0,0,0,0,0,0,30000,0,30000,30000
20200312,709178,精測凱基98購04,0.60,0.60,0.42,0.43,-0.34,-44.16,493000,9,246830,0,0,0,0,0,0,100000,393000,-293000,-293000
20200312,709179,雙鴻兆豐99購01,0.56,0.56,0.40,0.40,-0.21,-34.43,1355000,36,595490,0,0,0,0,0,0,528000,794000,-266000,-266000
20200312,709180,統新康和98購02,,,,,,0.00,0,0,0,0,0,0,0,0,0,0,0,0,0
20200312,709181,太景*群益99購01,0.81,0.81,0.58,0.58,-0.34,-36.96,149000,11,98770,0,0,0,0,0,0,79000,70000,9000,9000
20200312,709182,大江富邦9A購01,1.01,1.01,0.75,0.77,-0.33,-30.0,269000,9,246900,0,0,0,0,0,0,118000,151000,-33000,-33000
20200312,709183,原相麥證99購01,0.56,0.56,0.54,0.54,-0.37,-40.66,22000,3,12120,10000,12000,-2000,0,0,0,10000,12000,-2000,-2000
20200312,709184,順達麥證98購01,1.52,1.52,1.52,1.52,-0.15,-8.98,28000,1,42560,28000,0,28000,0,0,0,28000,0,28000,28000
20200312,709185,璟德麥證98購01,0.73,0.73,0.46,0.46,-0.65,-58.56,170000,6,85600,20000,150000,-130000,0,0,0,20000,150000,-130000,-130000
20200312,709186,鈊象台新98購03,2.04,2.08,2.04,2.08,-0.94,-31.13,6000,3,12320,0,0,0,0,0,0,2000,6000,-4000,-4000
20200312,709187,大中元富98購01,,,,,,0.00,0,0,0,0,0,0,0,0,0,0,0,0,0
20200312,709188,太景*元富98購01,1.28,1.32,0.97,0.97,-0.53,-35.33,70000,7,84200,0,0,0,0,0,0,20000,50000,-30000,-30000
20200312,709189,台半元富98購01,1.47,1.49,1.16,1.16,-0.61,-34.46,60000,6,82600,0,0,0,0,0,0,30000,40000,-10000,-10000
20200312,709190,由田元富98購01,1.25,1.25,1.18,1.18,-0.37,-23.87,190000,2,224900,0,0,0,0,0,0,180000,10000,170000,170000
20200312,709191,杰力元富98購01,1.62,1.62,1.30,1.34,-0.64,-32.32,20000,3,27680,0,0,0,0,0,0,10000,10000,0,0
20200312,709192,金居元富99購01,0.91,0.91,0.66,0.71,-0.33,-31.73,160000,5,118700,0,0,0,0,0,0,0,160000,-160000,-160000
20200312,709193,美琪瑪元富98購01,0.31,0.31,0.30,0.30,-0.30,-50.0,33000,4,10100,0,0,0,0,0,0,0,33000,-33000,-33000
20200312,709194,統新元富98購03,1.36,1.36,1.05,1.05,-0.41,-28.08,59000,4,76060,0,0,0,0,0,0,39000,20000,19000,19000
20200312,709195,碩禾元富9B購01,0.64,0.64,0.48,0.48,-0.24,-33.33,219000,7,129460,0,0,0,0,0,0,205000,14000,191000,191000
20200312,709196,群聯中信99購01,0.33,0.33,0.33,0.33,-0.11,-25.0,5000,1,1650,0,0,0,0,0,0,0,5000,-5000,-5000
20200312,709197,大學光統一99購01,0.41,0.41,0.34,0.34,-0.14,-29.17,109000,4,42400,0,0,0,0,0,0,49000,60000,-11000,-11000
20200312,709198,原相統一99購01,2.32,2.34,2.32,2.34,-0.42,-15.22,48000,2,111720,0,0,0,0,0,0,0,48000,-48000,-48000
20200312,709199,M31凱基98購02,0.82,0.82,0.82,0.82,-0.81,-49.69,20000,2,16400,0,0,0,0,0,0,0,20000,-20000,-20000
20200312,709200,中美晶凱基98購02,0.89,0.89,0.81,0.81,-0.24,-22.86,30000,2,26300,0,0,0,0,0,0,30000,5000,25000,25000
20200312,709201,建榮凱基9A購01,0.45,0.45,0.37,0.38,-0.11,-22.45,358000,9,141040,0,0,0,0,0,0,60000,298000,-238000,-238000
20200312,709202,神盾凱基99購01,0.48,0.48,0.39,0.39,-0.21,-35.0,46000,5,21020,0,0,0,0,0,0,40000,26000,14000,14000
20200312,709203,金可兆豐99購01,0.54,0.54,0.39,0.39,-0.21,-35.0,985000,56,430990,0,0,0,0,0,0,215000,613000,-398000,-398000
20200312,709204,宣德兆豐98購02,1.12,1.12,0.92,0.93,-0.28,-23.14,470000,9,472330,0,0,0,0,0,0,459000,11000,448000,448000
20200312,709205,環球晶兆豐98購02,0.43,0.43,0.43,0.43,-0.06,-12.24,3000,1,1290,0,0,0,0,0,0,0,3000,-3000,-3000
20200312,709206,合晶群益98購01,1.70,1.70,1.08,1.18,-0.76,-39.18,262000,12,360930,0,0,0,0,0,0,110000,144000,-34000,-34000
20200312,709207,原相群益9B購01,4.07,4.07,3.01,3.01,-1.66,-35.55,219000,26,826450,0,0,0,0,0,0,77000,155000,-78000,-78000
20200312,709208,統新群益98購02,1.12,1.12,1.08,1.08,-0.30,-21.74,31000,2,33880,0,0,0,0,0,0,21000,10000,11000,11000
20200312,709209,廣明群益98購03,,,,,,0.00,0,0,0,0,0,0,0,0,0,0,0,0,0
20200312,709210,緯軟群益99購01,0.89,0.89,0.89,0.89,-0.08,-8.25,10000,1,8900,0,0,0,0,0,0,10000,0,10000,10000
20200312,709211,鈺太群益98購01,1.17,1.18,0.97,0.97,-0.48,-33.1,88000,6,100700,0,0,0,0,0,0,68000,29000,39000,39000
20200312,709212,建榮國票99購02,0.42,0.42,0.42,0.42,-0.13,-23.64,10000,1,4200,0,0,0,0,0,0,10000,10000,0,0
20200312,709213,雍智國票99購02,0.92,0.92,0.78,0.83,-0.24,-22.43,255000,6,228820,0,0,0,0,0,0,123000,132000,-9000,-9000
20200312,709214,中美晶元大99購02,1.40,1.40,1.38,1.38,-0.20,-12.66,54000,2,74600,0,0,0,0,0,0,54000,54000,0,0
20200312,709215,金居元大9A購01,3.12,3.12,3.00,3.00,-0.58,-16.2,17000,5,51480,0,0,0,0,0,0,17000,12000,5000,5000
20200312,709216,威剛元大99購02,0.44,0.48,0.44,0.45,-0.21,-31.82,108000,5,47660,0,0,0,0,0,0,2000,106000,-104000,-104000
20200312,709217,宣德元大99購01,1.68,1.68,1.30,1.37,-0.37,-21.26,341000,44,510430,0,0,0,0,0,0,249000,225000,24000,24000
20200312,709218,群聯元大98購04,1.50,1.50,1.07,1.07,-0.84,-43.98,70000,3,96420,0,0,0,0,0,0,2000,70000,-68000,-68000
20200312,709219,碩禾元大99購02,1.13,1.13,1.05,1.05,-0.49,-31.82,39000,2,42470,0,0,0,0,0,0,20000,19000,1000,1000
20200312,709220,網家元大99購01,1.59,1.59,1.20,1.20,-0.64,-34.78,102000,8,130650,0,0,0,0,0,0,54000,48000,6000,6000
20200312,709221,環球晶元大98購04,0.81,0.81,0.68,0.68,-0.29,-29.9,96000,6,72000,0,0,0,0,0,0,96000,26000,70000,70000
20200312,709222,環球晶元大99購01,1.05,1.05,0.87,1.00,-0.14,-12.28,168000,9,151670,0,0,0,0,0,0,27000,168000,-141000,-141000
20200312,709223,雙鴻元大99購05,0.62,0.62,0.52,0.52,-0.28,-35.0,360000,9,198660,0,0,0,0,0,0,120000,240000,-120000,-120000
20200312,709224,穩懋元大98購02,1.01,1.01,1.01,1.01,-1.14,-53.02,7000,1,7070,0,0,0,0,0,0,0,7000,-7000,-7000
20200312,709225,穩懋元大99購01,0.92,0.92,0.71,0.72,-0.50,-40.98,99000,10,78960,0,0,0,0,0,0,53000,46000,7000,7000
20200312,709226,泰博國泰99購01,2.71,2.71,1.98,2.31,-0.44,-16.0,396000,21,887460,0,0,0,0,0,0,216000,170000,46000,46000
20200312,709227,大江富邦9A購02,0.71,0.71,0.59,0.59,-0.19,-24.36,381000,5,254660,0,0,0,0,0,0,277000,104000,173000,173000
20200312,709228,中美晶富邦9A購01,0.42,0.42,0.32,0.32,-0.13,-28.89,329000,20,120470,0,0,0,0,0,0,319000,10000,309000,309000
20200312,709229,精測富邦99購01,0.20,0.20,0.16,0.16,-0.07,-30.43,86000,4,15900,0,0,0,0,0,0,71000,15000,56000,56000
20200312,709230,環球晶富邦9B購01,0.25,0.30,0.18,0.29,-0.03,-9.38,257000,18,63380,0,0,0,0,0,0,30000,180000,-150000,-150000
20200312,709231,威剛麥證98購01,0.32,0.32,0.32,0.32,-0.29,-47.54,20000,2,6400,0,20000,-20000,0,0,0,0,20000,-20000,-20000
20200312,709232,群聯麥證98購01,0.68,0.68,0.57,0.57,-0.41,-41.84,11000,2,6380,1000,10000,-9000,0,0,0,1000,10000,-9000,-9000
20200312,709233,聯亞麥證98購01,1.30,1.34,1.14,1.14,-0.72,-38.71,72000,8,87650,0,72000,-72000,0,0,0,0,72000,-72000,-72000
20200312,709234,力旺元富98購01,0.97,0.99,0.68,0.68,-0.74,-52.11,822000,17,756730,0,0,0,0,0,0,615000,30000,585000,585000
20200312,709235,大江元富98購02,,,,,,0.00,0,0,0,0,0,0,0,0,0,0,0,0,0
20200312,709236,原相元富98購01,1.91,1.91,1.48,1.54,-0.76,-33.04,12000,11,19570,0,0,0,0,0,0,6000,6000,0,0
20200312,709237,新鉅科元富98購01,0.45,0.46,0.35,0.35,-0.21,-37.5,418000,6,159360,0,0,0,0,0,0,60000,358000,-298000,-298000
20200312,709238,聚積元富98購01,,,,,,0.00,0,0,0,0,0,0,0,0,0,0,0,0,0
20200312,709239,環球晶第一01購01,0.48,0.53,0.38,0.52,-0.03,-5.45,343000,17,144790,0,0,0,0,0,0,185000,128000,57000,57000
20200312,709240,M31永豐98購01,0.82,0.82,0.72,0.72,-0.33,-31.43,22000,3,17320,0,0,0,0,0,0,6000,16000,-10000,-10000
20200312,709241,凡甲永豐98購01,1.16,1.16,1.09,1.09,-0.62,-36.26,40000,3,44500,0,0,0,0,0,0,40000,0,40000,40000
20200312,709242,大中永豐98購01,0.60,0.61,0.51,0.51,-0.20,-28.17,47000,3,25570,0,0,0,0,0,0,30000,17000,13000,13000
20200312,709243,迅得永豐98購01,,,,,,0.00,0,0,0,0,0,0,0,0,0,0,0,0,0
20200312,709244,杰力永豐98購01,0.79,0.79,0.65,0.65,-0.27,-29.35,13000,2,10130,0,0,0,0,0,0,0,13000,-13000,-13000
20200312,709245,統新永豐98購02,0.45,0.45,0.42,0.42,-0.07,-14.29,20000,2,8700,0,0,0,0,0,0,0,20000,-20000,-20000
20200312,709246,晶焱永豐98購01,1.07,1.08,1.07,1.08,-0.31,-22.3,18000,2,19340,0,0,0,0,0,0,18000,18000,0,0
20200312,709247,網龍永豐98購01,,,,,,0.00,0,0,0,0,0,0,0,0,0,0,0,0,0
20200312,709248,優群永豐98購01,,,,,,0.00,0,0,0,0,0,0,0,0,0,0,0,0,0
20200312,709249,原相台新9A購01,1.72,1.72,1.32,1.32,-1.06,-44.54,32000,7,48430,0,0,0,0,0,0,10000,22000,-12000,-12000
20200312,709250,聯亞台新9A購01,0.92,0.92,0.92,0.92,-0.31,-25.2,1000,1,920,0,0,0,0,0,0,1000,0,1000,1000
20200312,709251,前鼎統一99購01,0.34,0.34,0.34,0.34,-0.10,-22.73,48000,1,16320,0,0,0,0,0,0,0,48000,-48000,-48000
20200312,709252,聯亞中信98購01,0.65,0.65,0.47,0.48,-0.30,-38.46,169000,7,92950,0,0,0,0,0,0,139000,30000,109000,109000
20200312,709253,晶焱凱基98購03,1.50,1.50,1.39,1.39,-0.28,-16.77,58000,6,86540,0,0,0,0,0,0,52000,38000,14000,14000
20200312,709254,群聯凱基99購01,1.07,1.08,0.76,0.89,-0.45,-33.58,160000,14,149500,0,0,0,0,0,0,69000,160000,-91000,-91000
20200312,709255,神盾台新98購02,0.67,0.68,0.51,0.51,-0.34,-40.0,87000,6,52310,0,0,0,0,0,0,65000,22000,43000,43000
20200312,709256,精測台新99購02,0.48,0.48,0.48,0.48,-0.08,-14.29,10000,1,4800,0,0,0,0,0,0,10000,0,10000,10000
20200312,709257,VHQ元富98購01,0.81,0.81,0.68,0.68,-0.29,-29.9,155000,7,113400,0,0,0,0,0,0,100000,55000,45000,45000
20200312,709258,前鼎元富98購01,0.87,0.87,0.87,0.87,-0.47,-35.07,10000,1,8700,0,0,0,0,0,0,10000,0,10000,10000
20200312,709259,精測元富98購02,0.93,0.93,0.60,0.60,-0.48,-44.44,125000,5,110200,0,0,0,0,0,0,125000,0,125000,125000
20200312,709260,中美晶國票98購01,,,,,,0.00,0,0,0,0,0,0,0,0,0,0,0,0,0
20200312,709261,保瑞國票98購01,3.74,3.87,3.21,3.21,-0.96,-23.02,144000,15,537790,0,0,0,0,0,0,106000,38000,68000,68000
20200312,709262,前鼎國票99購01,1.43,1.46,1.42,1.43,-0.64,-30.92,68000,4,97440,0,0,0,0,0,0,38000,30000,8000,8000
20200312,709263,原相國票99購01,1.65,1.65,1.16,1.16,-0.81,-41.12,144000,3,186900,0,0,0,0,0,0,94000,50000,44000,44000
20200312,709264,泰博國票99購02,3.84,3.84,3.84,3.84,-0.20,-4.95,12000,1,46080,0,0,0,0,0,0,12000,0,12000,12000
20200312,709265,統新國票99購01,0.59,0.59,0.59,0.59,-0.08,-11.94,10000,1,5900,0,0,0,0,0,0,10000,0,10000,10000
20200312,709266,六角兆豐98購01,0.33,0.33,0.29,0.29,-0.16,-35.56,70000,2,22300,0,0,0,0,0,0,70000,0,70000,70000
20200312,709267,宇峻群益9A購01,0.30,0.30,0.29,0.29,-0.09,-23.68,50000,2,14800,0,0,0,0,0,0,30000,20000,10000,10000
20200312,709268,博智群益98購01,4.31,4.52,3.70,3.90,-1.35,-25.71,259000,19,1056320,0,0,0,0,0,0,231000,28000,203000,203000
20200312,709269,網龍群益98購03,,,,,,0.00,0,0,0,0,0,0,0,0,0,0,0,0,0
20200312,709270,太景*國泰9A購01,0.74,0.74,0.52,0.53,-0.29,-35.37,1008000,34,582870,0,0,0,0,0,0,730000,258000,472000,472000
20200312,709271,前鼎國泰99購01,0.84,0.84,0.66,0.68,-0.20,-22.73,98000,7,71210,0,0,0,0,0,0,57000,41000,16000,16000
20200312,709272,新鉅科國泰99購01,0.74,0.74,0.52,0.55,-0.26,-32.1,677000,9,442430,0,0,0,0,0,0,518000,159000,359000,359000
20200312,709273,環宇富邦9A購01,0.75,0.75,0.55,0.59,-0.23,-28.05,760000,17,459270,0,0,0,0,0,0,214000,545000,-331000,-331000
20200312,709274,大江元大98購02,1.03,1.04,0.77,0.78,-0.32,-29.09,303000,15,292250,0,0,0,0,0,0,188000,230000,-42000,-42000
20200312,709275,前鼎元大99購01,0.65,0.65,0.65,0.65,-0.15,-18.75,5000,1,3250,0,0,0,0,0,0,0,5000,-5000,-5000
20200312,709276,威剛元大9A購01,0.56,0.56,0.50,0.50,-0.28,-35.9,110000,2,55600,0,0,0,0,0,0,0,110000,-110000,-110000
20200312,709277,神盾元大9A購01,,,,,,0.00,0,0,0,0,0,0,0,0,0,0,0,0,0
20200312,709278,群聯元大99購02,1.13,1.13,0.80,0.86,-0.42,-32.81,611000,27,567630,0,0,0,0,0,0,176000,454000,-278000,-278000
20200312,709279,緯軟元大98購02,0.84,0.84,0.78,0.78,-0.48,-38.1,88000,3,69240,0,0,0,0,0,0,88000,20000,68000,68000
20200312,709280,璟德元大98購01,1.57,1.57,1.57,1.57,-0.29,-15.59,12000,1,18840,0,0,0,0,0,0,0,12000,-12000,-12000
20200312,709281,中美晶日盛9A購01,1.35,1.40,1.05,1.23,-0.33,-21.15,1685000,35,2112230,0,0,0,0,0,0,825000,860000,-35000,-35000
20200312,709282,伍豐永豐98購01,0.51,0.51,0.38,0.38,-0.18,-32.14,35000,4,16250,0,0,0,0,0,0,0,35000,-35000,-35000
20200312,709283,兆利永豐98購01,0.74,0.74,0.56,0.60,-0.22,-26.83,74000,7,50480,0,0,0,0,0,0,16000,58000,-42000,-42000
20200312,709284,宜鼎永豐98購01,,,,,,0.00,0,0,0,0,0,0,0,0,0,0,0,0,0
20200312,709285,前鼎永豐98購01,0.35,0.35,0.32,0.32,-0.11,-25.58,54000,2,18090,0,0,0,0,0,0,27000,27000,0,0
20200312,709286,建榮永豐9A購01,,,,,,0.00,0,0,0,0,0,0,0,0,0,0,0,0,0
20200312,709287,新鉅科永豐98購01,0.20,0.20,0.18,0.18,-0.17,-48.57,93000,9,17470,0,0,0,0,0,0,44000,40000,4000,4000
20200312,709288,聯亞永豐98購01,0.66,0.73,0.65,0.69,-0.49,-41.53,70000,7,47700,0,0,0,0,0,0,30000,60000,-30000,-30000
20200312,709289,雙鴻永豐99購01,0.84,0.84,0.61,0.61,-0.29,-32.22,186000,16,133050,0,0,0,0,0,0,83000,103000,-20000,-20000
20200312,709290,金居凱基98購02,2.04,2.04,1.44,1.46,-0.88,-37.61,42000,4,71820,0,0,0,0,0,0,22000,20000,2000,2000
20200312,709291,威剛凱基9A購01,0.50,0.55,0.40,0.42,-0.18,-30.0,613000,17,266260,0,0,0,0,0,0,71000,542000,-471000,-471000
20200312,709292,環球晶凱基98購04,0.87,0.87,0.76,0.78,-0.09,-10.34,46000,5,37570,0,0,0,0,0,0,46000,36000,10000,10000
20200312,709293,環球晶康和98購01,0.46,0.46,0.46,0.46,-0.11,-19.3,10000,1,4600,0,0,0,0,0,0,10000,0,10000,10000
20200312,709294,大江群益98購01,1.29,1.30,0.92,0.92,-0.55,-37.41,97000,9,109140,0,0,0,0,0,0,30000,67000,-37000,-37000
20200312,709295,宇峻群益9A購02,0.30,0.30,0.18,0.19,-0.11,-36.67,480000,12,93170,0,0,0,0,0,0,429000,47000,382000,382000
20200312,709296,神盾群益9A購02,,,,,,0.00,0,0,0,0,0,0,0,0,0,0,0,0,0
20200312,709297,宣德國票99購01,2.14,2.14,1.67,1.88,-0.52,-21.67,582000,12,1189280,0,0,0,0,0,0,522000,60000,462000,462000
20200312,709298,群聯國票99購01,1.28,1.28,0.77,0.94,-0.81,-46.29,50000,5,49080,0,0,0,0,0,0,3000,50000,-47000,-47000
20200312,709299,VHQ國泰99購01,0.99,1.01,0.91,0.91,-0.21,-18.75,360000,11,337600,0,0,0,0,0,0,330000,360000,-30000,-30000
20200312,709300,宣德國泰9A購01,1.28,1.28,1.27,1.27,-0.49,-27.84,70000,2,89500,0,0,0,0,0,0,70000,10000,60000,60000
20200312,709301,大宇資永豐98購02,0.41,0.41,0.41,0.41,-0.05,-10.87,25000,1,10250,0,0,0,0,0,0,25000,0,25000,25000
20200312,709302,六角永豐98購01,0.59,0.59,0.53,0.53,-0.23,-30.26,22000,2,12260,0,0,0,0,0,0,0,22000,-22000,-22000
20200312,709303,亞泰永豐98購01,0.76,0.76,0.76,0.76,-0.11,-12.64,25000,1,19000,0,0,0,0,0,0,25000,0,25000,25000
20200312,709304,信昌電永豐98購01,,,,,,0.00,0,0,0,0,0,0,0,0,0,0,0,0,0
20200312,709305,宣德永豐98購01,1.30,1.30,1.01,1.01,-0.50,-33.11,59000,3,72610,0,0,0,0,0,0,56000,49000,7000,7000
20200312,709306,原相永豐98購02,0.47,0.47,0.34,0.36,-0.24,-40.0,1394000,21,511460,0,0,0,0,0,0,624000,770000,-146000,-146000
20200312,709307,神盾永豐99購01,0.77,0.78,0.77,0.78,-0.21,-21.21,136000,3,105400,0,0,0,0,0,0,68000,68000,0,0
20200312,709308,雙美永豐99購01,0.61,0.62,0.61,0.62,-0.09,-12.68,14000,2,8550,0,0,0,0,0,0,13000,1000,12000,12000
20200312,709309,譜瑞永豐98購01,0.69,0.69,0.48,0.49,-0.36,-42.35,84000,11,43550,0,0,0,0,0,0,5000,73000,-68000,-68000
20200312,709310,合晶元富98購01,,,,,,0.00,0,0,0,0,0,0,0,0,0,0,0,0,0
20200312,709311,前鼎元富98購02,0.96,0.96,0.85,0.85,-0.26,-23.42,18000,3,16800,0,0,0,0,0,0,3000,15000,-12000,-12000
20200312,709312,大學光元大99購01,0.61,0.61,0.46,0.46,-0.18,-28.12,43000,4,21860,0,0,0,0,0,0,20000,23000,-3000,-3000
20200312,709313,保瑞元大98購01,2.19,2.19,1.94,2.01,-0.36,-15.19,379000,23,784300,0,0,0,0,0,0,374000,5000,369000,369000
20200312,709314,前鼎元大99購02,0.61,0.61,0.61,0.61,-0.14,-18.67,3000,1,1830,0,0,0,0,0,0,0,3000,-3000,-3000
20200312,709315,胡連元大98購01,0.58,0.58,0.54,0.54,-0.17,-23.94,93000,2,52940,0,0,0,0,0,0,0,93000,-93000,-93000
20200312,709316,神盾元大9A購02,0.83,0.83,0.70,0.70,-0.26,-27.08,30000,4,24000,0,0,0,0,0,0,26000,20000,6000,6000
20200312,709317,群聯元大98購05,0.52,0.52,0.41,0.42,-0.25,-37.31,264000,20,116070,0,0,0,0,0,0,116000,148000,-32000,-32000
20200312,709318,環球晶元大98購09,1.48,1.48,1.20,1.47,-0.16,-9.82,219000,16,299060,0,0,0,0,0,0,179000,64000,115000,115000
20200312,709319,環球晶元大98購10,1.09,1.09,0.86,1.07,-0.18,-14.4,173000,12,162620,0,0,0,0,0,0,170000,32000,138000,138000
20200312,709320,雙鴻元大9A購01,0.80,0.80,0.62,0.62,-0.28,-31.11,602000,17,404200,0,0,0,0,0,0,422000,180000,242000,242000
20200312,709321,譜瑞元大98購03,1.91,2.07,1.91,2.07,-0.93,-31.0,63000,3,122230,0,0,0,0,0,0,63000,13000,50000,50000
20200312,709322,六角台新98購01,0.48,0.48,0.48,0.48,-0.24,-33.33,38000,1,18240,0,0,0,0,0,0,0,38000,-38000,-38000
20200312,709323,群聯麥證98購02,0.98,0.98,0.61,0.67,-0.44,-39.64,73000,9,58580,13000,60000,-47000,0,0,0,13000,63000,-50000,-50000
20200312,709324,同致元富98購01,,,,,,0.00,0,0,0,0,0,0,0,0,0,0,0,0,0
20200312,709325,神盾元富99購01,0.70,0.70,0.53,0.53,-0.37,-41.11,41000,4,25350,0,0,0,0,0,0,10000,31000,-21000,-21000
20200312,709326,群聯元富98購01,1.15,1.18,1.06,1.12,-0.57,-33.73,92000,10,104740,0,0,0,0,0,0,2000,90000,-88000,-88000
20200312,709327,碩禾元富9B購02,0.63,0.64,0.49,0.49,-0.34,-40.96,101000,6,59390,0,0,0,0,0,0,30000,71000,-41000,-41000
20200312,709328,三貝德凱基98購01,1.10,1.10,0.76,0.76,-0.66,-46.48,178000,17,150330,0,0,0,0,0,0,6000,172000,-166000,-166000
20200312,709329,大江凱基98購07,1.48,1.50,1.08,1.08,-0.72,-40.0,105000,9,141140,0,0,0,0,0,0,1000,104000,-103000,-103000
20200312,709330,威剛凱基9A購02,0.58,0.59,0.47,0.47,-0.21,-30.88,278000,3,139340,0,0,0,0,0,0,0,278000,-278000,-278000
20200312,709331,雍智凱基99購01,,,,,,0.00,0,0,0,0,0,0,0,0,0,0,0,0,0
20200312,709332,環球晶凱基98購05,1.87,2.07,1.73,2.07,-0.25,-10.78,39000,3,72330,0,0,0,0,0,0,28000,39000,-11000,-11000
20200312,709333,聯亞凱基99購03,1.37,1.51,1.20,1.20,-0.67,-35.83,80000,6,102900,0,0,0,0,0,0,10000,70000,-60000,-60000
20200312,709334,穩懋凱基98購06,,,,,,0.00,0,0,0,0,0,0,0,0,0,0,0,0,0
20200312,709335,泰博永豐98購01,1.23,1.23,0.99,1.10,-0.27,-19.71,362000,11,380950,0,0,0,0,0,0,85000,352000,-267000,-267000
20200312,709336,博智永豐98購01,1.43,1.43,1.20,1.20,-0.44,-26.83,99000,13,130990,0,0,0,0,0,0,33000,66000,-33000,-33000
20200312,709337,緯軟永豐98購01,0.46,0.46,0.46,0.46,-0.25,-35.21,10000,1,4600,0,0,0,0,0,0,0,10000,-10000,-10000
20200312,709338,環宇永豐98購02,0.50,0.50,0.50,0.50,-0.37,-42.53,2000,1,1000,0,0,0,0,0,0,0,2000,-2000,-2000
20200312,709339,VHQ統一99購01,,,,,,0.00,0,0,0,0,0,0,0,0,0,0,0,0,0
20200312,709340,大學光統一9A購01,0.45,0.45,0.45,0.45,-0.08,-15.09,10000,1,4500,0,0,0,0,0,0,0,10000,-10000,-10000
20200312,709341,廣明統一99購01,,,,,,0.00,0,0,0,0,0,0,0,0,0,0,0,0,0
20200312,709342,穩懋統一98購04,0.65,0.65,0.50,0.50,-0.36,-41.86,88000,3,50360,0,0,0,0,0,0,88000,0,88000,88000
20200312,709343,凡甲元大98購03,1.57,1.57,1.49,1.55,-0.44,-22.11,34000,7,51410,0,0,0,0,0,0,5000,29000,-24000,-24000
20200312,709344,中美晶元大98購03,1.00,1.00,1.00,1.00,-0.44,-30.56,10000,1,10000,0,0,0,0,0,0,10000,0,10000,10000
20200312,709345,宇峻元大99購02,0.52,0.53,0.40,0.43,-0.15,-25.86,1555000,12,709800,0,0,0,0,0,0,35000,1520000,-1485000,-1485000
20200312,709346,博智元大98購01,3.51,3.51,3.34,3.34,-1.15,-25.61,8000,2,27400,0,0,0,0,0,0,8000,4000,4000,4000
20200312,709347,群聯元大98購06,1.11,1.11,0.79,0.79,-0.58,-42.34,138000,4,115210,0,0,0,0,0,0,20000,138000,-118000,-118000
20200312,709348,網家元大98購01,,,,,,0.00,0,0,0,0,0,0,0,0,0,0,0,0,0
20200312,709349,廣明元大98購01,,,,,,0.00,0,0,0,0,0,0,0,0,0,0,0,0,0
20200312,709350,中美晶兆豐99購01,0.91,0.91,0.89,0.89,-0.16,-15.24,34000,2,30440,0,0,0,0,0,0,34000,9000,25000,25000
20200312,709351,泰博兆豐98購01,1.68,1.69,1.29,1.45,-0.41,-22.04,421000,16,640190,0,0,0,0,0,0,93000,331000,-238000,-238000
20200312,709352,精華兆豐99購01,0.71,0.71,0.53,0.53,-0.26,-32.91,408000,22,236810,0,0,0,0,0,0,272000,130000,142000,142000
20200312,709353,頎邦兆豐98購01,0.58,0.58,0.45,0.45,-0.21,-31.82,100000,4,53580,0,0,0,0,0,0,90000,10000,80000,80000
20200312,709354,M31群益9A購01,0.67,0.67,0.50,0.50,-0.31,-38.27,82000,6,46280,0,0,0,0,0,0,31000,51000,-20000,-20000
20200312,709355,中美晶群益98購02,0.42,0.42,0.31,0.35,-0.21,-37.5,660000,13,236080,0,0,0,0,0,0,479000,97000,382000,382000
20200312,709356,宜鼎群益98購02,0.66,0.66,0.47,0.47,-0.53,-53.0,109000,2,69850,0,0,0,0,0,0,109000,0,109000,109000
20200312,709357,原相群益98購03,0.71,0.71,0.46,0.46,-0.39,-45.88,1242000,52,720590,0,0,0,0,0,0,628000,608000,20000,20000
20200312,709358,譜瑞群益98購01,2.14,2.14,1.45,1.45,-1.01,-41.06,27000,4,46550,0,0,0,0,0,0,0,27000,-27000,-27000
20200312,709359,璟德國泰99購01,0.69,0.69,0.61,0.61,-0.31,-33.7,32000,2,21680,0,0,0,0,0,0,32000,0,32000,32000
20200312,709360,神盾富邦9A購01,,,,,,0.00,0,0,0,0,0,0,0,0,0,0,0,0,0
20200312,709361,群聯凱基98購05,1.01,1.02,0.62,0.69,-0.69,-50.0,11000,4,7750,0,0,0,0,0,0,10000,11000,-1000,-1000
20200312,709362,網家凱基99購01,0.32,0.32,0.32,0.32,-0.27,-45.76,30000,1,9600,0,0,0,0,0,0,30000,0,30000,30000
20200312,709363,晟德凱基98購01,0.95,0.95,0.82,0.82,-0.17,-17.17,53000,3,44290,0,0,0,0,0,0,53000,11000,42000,42000
20200312,709364,神盾統一98購02,0.38,0.38,0.38,0.38,-0.33,-46.48,105000,3,39900,0,0,0,0,0,0,5000,100000,-95000,-95000
20200312,709365,VHQ元大99購02,,,,,,0.00,0,0,0,0,0,0,0,0,0,0,0,0,0
20200312,709366,中美晶元大98購04,1.21,1.21,1.12,1.12,-0.26,-18.84,13000,2,15640,0,0,0,0,0,0,1000,13000,-12000,-12000
20200312,709367,兆利元大99購01,0.94,0.94,0.86,0.86,-0.29,-25.22,350000,3,313000,0,0,0,0,0,0,350000,0,350000,350000
20200312,709368,原相元大9A購02,1.83,1.83,1.44,1.44,-0.58,-28.71,444000,38,728780,0,0,0,0,0,0,217000,362000,-145000,-145000
20200312,709369,群聯元大98購07,0.67,0.72,0.56,0.56,-0.36,-39.13,143000,7,88080,0,0,0,0,0,0,83000,60000,23000,23000
20200312,709370,碩禾元大99購03,0.97,1.02,0.97,1.02,-0.48,-32.0,52000,4,52040,0,0,0,0,0,0,7000,45000,-38000,-38000
20200312,709371,廣明元大98購02,,,,,,0.00,0,0,0,0,0,0,0,0,0,0,0,0,0
20200312,709372,神盾第一9C購01,,,,,,0.00,0,0,0,0,0,0,0,0,0,0,0,0,0
20200312,709373,三貝德永豐99購01,0.39,0.39,0.36,0.36,-0.17,-32.08,57000,3,21390,0,0,0,0,0,0,20000,37000,-17000,-17000
20200312,709374,大田永豐98購01,0.29,0.29,0.29,0.29,-0.31,-51.67,81000,1,23490,0,0,0,0,0,0,81000,0,81000,81000
20200312,709375,大江永豐98購03,,,,,,0.00,0,0,0,0,0,0,0,0,0,0,0,0,0
20200312,709376,旺矽永豐98購01,0.57,0.57,0.46,0.48,-0.25,-34.25,111000,7,55160,0,0,0,0,0,0,68000,43000,25000,25000
20200312,709377,勝麗永豐98購01,,,,,,0.00,0,0,0,0,0,0,0,0,0,0,0,0,0
20200312,709378,宜鼎兆豐99購01,0.37,0.37,0.27,0.31,-0.17,-35.42,57000,12,17400,0,0,0,0,0,0,8000,49000,-41000,-41000
20200312,709379,神盾兆豐99購01,0.84,0.84,0.65,0.65,-0.37,-36.27,18000,2,13600,0,0,0,0,0,0,18000,0,18000,18000
20200312,709380,穩懋兆豐99購01,0.42,0.42,0.30,0.31,-0.23,-42.59,249000,18,75770,0,0,0,0,0,0,229000,16000,213000,213000
20200312,709381,網家康和98購01,,,,,,0.00,0,0,0,0,0,0,0,0,0,0,0,0,0
20200312,709382,大學光群益99購01,0.71,0.72,0.52,0.52,-0.39,-42.86,318000,7,186370,0,0,0,0,0,0,220000,98000,122000,122000
20200312,709383,六角群益98購03,0.56,0.56,0.48,0.48,-0.18,-27.27,108000,2,52640,0,0,0,0,0,0,10000,98000,-88000,-88000
20200312,709384,迅得群益9A購01,0.37,0.37,0.37,0.37,-0.18,-32.73,10000,1,3700,0,0,0,0,0,0,0,10000,-10000,-10000
20200312,709385,環宇群益99購01,0.88,0.88,0.67,0.69,-0.44,-38.94,31000,4,25280,0,0,0,0,0,0,10000,21000,-11000,-11000
20200312,709386,鈺太群益98購02,0.60,0.60,0.57,0.57,-0.24,-29.63,37000,2,21960,0,0,0,0,0,0,37000,8000,29000,29000
20200312,709387,大學光統一99購02,0.50,0.50,0.50,0.50,-0.05,-9.09,12000,1,6000,0,0,0,0,0,0,0,12000,-12000,-12000
20200312,709388,穩懋統一98購05,,,,,,0.00,0,0,0,0,0,0,0,0,0,0,0,0,0
20200312,709389,原相中信9A購01,1.21,1.22,0.95,0.95,-0.43,-31.16,128000,9,145520,0,0,0,0,0,0,34000,94000,-60000,-60000
20200312,709390,大學光凱基98購01,,,,,,0.00,0,0,0,0,0,0,0,0,0,0,0,0,0
20200312,709391,六角凱基98購01,0.62,0.62,0.62,0.62,-0.01,-1.59,10000,1,6200,0,0,0,0,0,0,10000,0,10000,10000
20200312,709392,穩懋凱基98購07,0.47,0.47,0.31,0.31,-0.29,-48.33,60000,2,20200,0,0,0,0,0,0,10000,50000,-40000,-40000
20200312,709393,宜鼎元富98購01,0.64,0.64,0.53,0.53,-0.37,-41.11,40000,4,22800,0,0,0,0,0,0,20000,20000,0,0
20200312,709394,群聯元富98購02,1.56,1.56,1.17,1.17,-0.85,-42.08,273000,6,414440,0,0,0,0,0,0,15000,258000,-243000,-243000
20200312,709395,譜瑞元富98購02,1.54,1.54,1.53,1.53,-0.55,-26.44,30000,2,46000,0,0,0,0,0,0,30000,0,30000,30000
20200312,709396,台燿元大98購01,1.67,1.67,1.42,1.49,-0.52,-25.87,54000,3,86080,0,0,0,0,0,0,34000,20000,14000,14000
20200312,709397,神盾元大99購03,0.76,0.76,0.69,0.69,-0.28,-28.87,98000,3,73780,0,0,0,0,0,0,0,98000,-98000,-98000
20200312,709398,精測元大99購01,0.63,0.63,0.47,0.47,-0.18,-27.69,682000,20,377220,0,0,0,0,0,0,192000,490000,-298000,-298000
20200312,709399,穩懋元大98購05,0.91,0.91,0.91,0.91,-0.51,-35.92,5000,1,4550,0,0,0,0,0,0,5000,0,5000,5000
20200312,709400,穩懋元大98購06,1.13,1.13,0.92,0.92,-0.35,-27.56,155000,8,153050,0,0,0,0,0,0,135000,120000,15000,15000
20200312,709401,穩懋元大98購07,1.07,1.07,0.84,0.84,-0.60,-41.67,119000,2,115600,0,0,0,0,0,0,51000,119000,-68000,-68000
20200312,709402,前鼎國票99購02,,,,,,0.00,0,0,0,0,0,0,0,0,0,0,0,0,0
20200312,709403,雙美國票9B購01,,,,,,0.00,0,0,0,0,0,0,0,0,0,0,0,0,0
20200312,709404,雙鴻國票9A購01,0.63,0.63,0.63,0.63,-0.41,-39.42,10000,1,6300,0,0,0,0,0,0,0,10000,-10000,-10000
20200312,709405,譜瑞國票99購01,2.74,2.76,1.71,1.73,-1.87,-51.94,58000,9,151290,0,0,0,0,0,0,30000,28000,2000,2000
20200312,709406,博智國泰9A購01,2.38,2.38,2.25,2.25,-0.70,-23.73,5000,2,11770,0,0,0,0,0,0,5000,0,5000,5000
20200312,709407,大學光富邦9C購01,0.37,0.37,0.37,0.37,-0.12,-24.49,2000,1,740,0,0,0,0,0,0,2000,0,2000,2000
20200312,709408,VHQ永豐99購01,0.48,0.48,0.48,0.48,-0.16,-25.0,6000,1,2880,0,0,0,0,0,0,0,6000,-6000,-6000
20200312,709409,力致永豐99購01,0.30,0.30,0.20,0.23,-0.13,-36.11,40000,3,9300,0,0,0,0,0,0,30000,10000,20000,20000
20200312,709410,大學光永豐98購01,,,,,,0.00,0,0,0,0,0,0,0,0,0,0,0,0,0
20200312,709411,台燿永豐98購01,0.42,0.42,0.38,0.38,-0.19,-33.33,156000,3,62800,0,0,0,0,0,0,40000,116000,-76000,-76000
20200312,709412,立端永豐98購01,0.49,0.49,0.32,0.33,-0.29,-46.77,131000,13,44740,0,0,0,0,0,0,0,131000,-131000,-131000
20200312,709413,合晶永豐98購03,0.54,0.54,0.54,0.54,-0.17,-23.94,55000,1,29700,0,0,0,0,0,0,55000,0,55000,55000
20200312,709414,東隆興永豐98購02,,,,,,0.00,0,0,0,0,0,0,0,0,0,0,0,0,0
20200312,709415,群聯永豐98購01,0.39,0.39,0.39,0.39,-0.26,-40.0,62000,1,24180,0,0,0,0,0,0,62000,0,62000,62000
20200312,709416,緯軟永豐98購02,,,,,,0.00,0,0,0,0,0,0,0,0,0,0,0,0,0
20200312,709417,穩懋永豐98購01,,,,,,0.00,0,0,0,0,0,0,0,0,0,0,0,0,0
20200312,709418,頎邦永豐98購01,0.65,0.65,0.63,0.63,-0.15,-19.23,179000,4,114990,0,0,0,0,0,0,179000,0,179000,179000
20200312,709419,泰博兆豐98購02,1.57,1.59,1.21,1.43,-0.31,-17.82,657000,17,940680,0,0,0,0,0,0,381000,279000,102000,102000
20200312,709420,群聯兆豐99購01,0.82,0.82,0.53,0.55,-0.39,-41.49,635000,51,402670,0,0,0,0,0,0,193000,450000,-257000,-257000
20200312,709421,大江群益98購02,0.40,0.40,0.27,0.27,-0.18,-40.0,307000,7,94670,0,0,0,0,0,0,187000,106000,81000,81000
20200312,709422,中美晶群益99購01,0.55,0.55,0.45,0.45,-0.13,-22.41,703000,14,375950,0,0,0,0,0,0,618000,163000,455000,455000
20200312,709423,亞泰群益98購01,0.50,0.50,0.50,0.50,-0.10,-16.67,15000,1,7500,0,0,0,0,0,0,15000,0,15000,15000
20200312,709424,南光群益98購01,1.34,1.34,0.87,0.90,-0.58,-39.19,149000,10,141990,0,0,0,0,0,0,85000,64000,21000,21000
20200312,709425,璟德群益98購02,,,,,,0.00,0,0,0,0,0,0,0,0,0,0,0,0,0
20200312,709426,智擎中信98購01,0.56,0.56,0.38,0.38,-0.28,-42.42,115000,5,53050,0,0,0,0,0,0,25000,90000,-65000,-65000
20200312,709427,力旺凱基98購01,,,,,,0.00,0,0,0,0,0,0,0,0,0,0,0,0,0
20200312,709428,三貝德凱基99購02,0.61,0.61,0.41,0.41,-0.39,-48.75,30000,4,16430,0,0,0,0,0,0,12000,18000,-6000,-6000
20200312,709429,環球晶凱基99購03,0.35,0.35,0.24,0.35,-0.12,-25.53,140000,6,40100,0,0,0,0,0,0,70000,70000,0,0
20200312,709430,穩懋凱基99購01,0.26,0.26,0.26,0.26,-0.20,-43.48,30000,1,7800,0,0,0,0,0,0,0,30000,-30000,-30000
20200312,709431,M31永豐99購01,0.62,0.62,0.62,0.62,-0.15,-19.48,68000,1,42160,0,0,0,0,0,0,0,68000,-68000,-68000
20200312,709432,力旺永豐98購01,,,,,,0.00,0,0,0,0,0,0,0,0,0,0,0,0,0
20200312,709433,大學光永豐98購02,0.54,0.54,0.38,0.38,-0.30,-44.12,70000,3,32600,0,0,0,0,0,0,30000,40000,-10000,-10000
20200312,709434,宣德永豐98購02,0.60,0.60,0.60,0.60,-0.29,-32.58,30000,1,18000,0,0,0,0,0,0,0,30000,-30000,-30000
20200312,709435,元太亞東99購01,2.31,2.31,2.31,2.31,-0.29,-11.15,48000,1,110880,0,0,0,0,0,0,0,48000,-48000,-48000
20200312,709436,穩懋麥證98購01,0.72,0.72,0.47,0.47,-0.54,-53.47,20000,3,12150,0,20000,-20000,0,0,0,0,20000,-20000,-20000
20200312,709437,M31元富98購01,0.72,0.72,0.57,0.57,-0.42,-42.42,35000,3,21300,0,0,0,0,0,0,16000,19000,-3000,-3000
20200312,709438,光頡元富98購01,0.46,0.46,0.46,0.46,-0.09,-16.36,12000,1,5520,0,0,0,0,0,0,0,12000,-12000,-12000
20200312,709439,優群元富98購01,4.20,4.20,3.05,3.19,-1.51,-32.13,337000,29,1186810,0,0,0,0,0,0,198000,139000,59000,59000
20200312,709440,三貝德元大99購01,0.52,0.58,0.52,0.52,-0.24,-31.58,151000,18,83440,0,0,0,0,0,0,16000,135000,-119000,-119000
20200312,709441,神盾元大9A購03,0.61,0.61,0.51,0.51,-0.15,-22.73,70000,4,37600,0,0,0,0,0,0,10000,60000,-50000,-50000
20200312,709442,神準元大98購01,0.86,0.86,0.82,0.82,-0.37,-31.09,59000,4,49660,0,0,0,0,0,0,31000,28000,3000,3000
20200312,709443,統新元大99購01,1.02,1.03,0.81,0.81,-0.27,-25.0,285000,10,267150,0,0,0,0,0,0,205000,80000,125000,125000
20200312,709444,博智元大98購02,4.98,5.10,4.21,4.21,-1.79,-29.83,44000,9,207280,0,0,0,0,0,0,17000,31000,-14000,-14000
20200312,709445,雍智元大98購01,1.03,1.03,0.85,0.85,-0.27,-24.11,18000,3,16590,0,0,0,0,0,0,10000,8000,2000,2000
20200312,709446,網家元大98購02,1.07,1.07,0.81,0.81,-0.46,-36.22,49000,2,49830,0,0,0,0,0,0,49000,0,49000,49000
20200312,709447,緯軟元大99購01,0.91,0.91,0.91,0.91,-0.15,-14.15,25000,1,22750,0,0,0,0,0,0,25000,0,25000,25000
20200312,709448,環球晶元大98購13,0.96,0.98,0.75,0.76,-0.38,-33.33,174000,9,152840,0,0,0,0,0,0,47000,154000,-107000,-107000
20200312,709449,穩懋元大98購08,0.91,0.91,0.87,0.87,-0.50,-36.5,78000,2,70580,0,0,0,0,0,0,10000,68000,-58000,-58000
20200312,709450,宇峻國票99購01,,,,,,0.00,0,0,0,0,0,0,0,0,0,0,0,0,0
20200312,709451,大學光兆豐99購01,0.62,0.62,0.62,0.62,-0.16,-20.51,29000,1,17980,0,0,0,0,0,0,29000,0,29000,29000
20200312,709452,原相兆豐99購01,0.56,0.62,0.45,0.45,-0.35,-43.75,808000,19,387150,0,0,0,0,0,0,75000,733000,-658000,-658000
20200312,709453,穩懋兆豐98購02,0.20,0.20,0.13,0.13,-0.12,-48.0,23000,5,3910,0,0,0,0,0,0,0,23000,-23000,-23000
20200312,709454,網家群益98購01,0.74,0.74,0.51,0.51,-0.46,-47.42,94000,7,61950,0,0,0,0,0,0,62000,32000,30000,30000
20200312,709455,網家群益98購02,1.05,1.05,1.05,1.05,-0.57,-35.19,12000,1,12600,0,0,0,0,0,0,0,12000,-12000,-12000
20200312,709456,穩懋統一9A購01,0.41,0.41,0.32,0.32,-0.21,-39.62,26000,4,9270,0,0,0,0,0,0,0,26000,-26000,-26000
20200312,709457,譜瑞中信9A購01,0.97,0.97,0.97,0.97,-0.07,-6.73,12000,1,11640,0,0,0,0,0,0,0,12000,-12000,-12000
20200312,709458,大江凱基99購01,0.46,0.46,0.46,0.46,-0.22,-32.35,10000,1,4600,0,0,0,0,0,0,0,10000,-10000,-10000
20200312,709459,中美晶凱基99購01,0.67,0.67,0.53,0.53,-0.26,-32.91,115000,5,65970,0,0,0,0,0,0,115000,27000,88000,88000
20200312,709460,穩懋凱基99購02,0.47,0.47,0.36,0.36,-0.20,-35.71,2488000,18,913960,0,0,0,0,0,0,1120000,1368000,-248000,-248000
20200312,709461,譜瑞麥證98購01,0.72,0.72,0.72,0.72,-0.11,-13.25,8000,1,5760,8000,0,8000,0,0,0,8000,0,8000,8000
20200312,709462,環球晶元富98購02,,,,,,0.00,0,0,0,0,0,0,0,0,0,0,0,0,0
20200312,709463,環球晶元富98購03,0.48,0.52,0.48,0.52,-0.24,-31.58,20000,2,10000,0,0,0,0,0,0,0,20000,-20000,-20000
20200312,709464,中美晶元大98購05,,,,,,0.00,0,0,0,0,0,0,0,0,0,0,0,0,0
20200312,709465,精測元大99購02,1.09,1.09,0.79,0.79,-0.44,-35.77,48000,6,41110,0,0,0,0,0,0,25000,23000,2000,2000
20200312,709466,環球晶元大98購14,0.91,0.91,0.75,0.75,-0.33,-30.56,50000,3,41100,0,0,0,0,0,0,50000,30000,20000,20000
20200312,709467,譜瑞元大98購04,1.65,1.65,1.35,1.45,-0.61,-29.61,104000,5,150620,0,0,0,0,0,0,104000,26000,78000,78000
20200312,709468,穩懋日盛99購01,,,,,,0.00,0,0,0,0,0,0,0,0,0,0,0,0,0
20200312,709469,久元永豐98購01,,,,,,0.00,0,0,0,0,0,0,0,0,0,0,0,0,0
20200312,709470,原相永豐99購01,0.43,0.43,0.33,0.33,-0.19,-36.54,613000,16,223850,0,0,0,0,0,0,563000,41000,522000,522000
20200312,709471,環球晶永豐98購02,0.17,0.22,0.17,0.22,-0.06,-21.43,55000,2,11850,0,0,0,0,0,0,5000,50000,-45000,-45000
20200312,709472,譜瑞永豐98購02,,,,,,0.00,0,0,0,0,0,0,0,0,0,0,0,0,0
20200312,709473,網家台新98購01,,,,,,0.00,0,0,0,0,0,0,0,0,0,0,0,0,0
20200312,709474,台燿兆豐98購01,0.65,0.65,0.60,0.60,-0.18,-23.08,65000,3,40520,0,0,0,0,0,0,35000,30000,5000,5000
20200312,709475,晟德兆豐99購01,0.69,0.69,0.56,0.56,-0.18,-24.32,352000,9,225060,0,0,0,0,0,0,340000,12000,328000,328000
20200312,709476,旺矽國票99購01,1.21,1.21,0.90,0.90,-0.83,-47.98,12000,2,14210,0,0,0,0,0,0,11000,1000,10000,10000
20200312,709477,璟德國票99購01,0.84,0.84,0.84,0.84,-0.19,-18.45,3000,1,2520,0,0,0,0,0,0,3000,0,3000,3000
20200312,709478,聯亞國票99購02,1.31,1.31,1.16,1.16,-0.63,-35.2,45000,3,56800,0,0,0,0,0,0,30000,15000,15000,15000
20200312,709479,譜瑞國票99購02,0.86,0.93,0.86,0.90,-0.72,-44.44,12000,3,10870,0,0,0,0,0,0,0,12000,-12000,-12000
20200312,709480,宇峻康和98購01,0.55,0.55,0.55,0.55,-0.10,-15.38,200000,1,110000,0,0,0,0,0,0,200000,0,200000,200000
20200312,709481,凡甲群益98購02,1.44,1.44,1.27,1.33,-0.32,-19.39,178000,20,243360,0,0,0,0,0,0,67000,111000,-44000,-44000
20200312,709482,大宇資群益9A購01,0.69,0.69,0.63,0.63,-0.23,-26.74,130000,4,83720,0,0,0,0,0,0,15000,115000,-100000,-100000
20200312,709483,迅得群益9A購02,,,,,,0.00,0,0,0,0,0,0,0,0,0,0,0,0,0
20200312,709484,金居群益9A購01,1.15,1.15,1.10,1.10,-0.28,-20.29,114000,2,129100,0,0,0,0,0,0,114000,0,114000,114000
20200312,709485,晶焱群益9A購01,1.12,1.12,0.99,0.99,-0.34,-25.56,93000,7,98390,0,0,0,0,0,0,93000,55000,38000,38000
20200312,709486,群聯群益98購02,0.25,0.26,0.25,0.26,-0.27,-50.94,153000,3,38800,0,0,0,0,0,0,98000,55000,43000,43000
20200312,709487,環球晶群益98購02,0.34,0.34,0.34,0.34,-0.27,-44.26,7000,1,2380,0,0,0,0,0,0,7000,0,7000,7000
20200312,709488,大江國泰9A購02,0.66,0.66,0.55,0.55,-0.21,-27.63,20000,2,12100,0,0,0,0,0,0,10000,10000,0,0
20200312,709489,譜瑞國泰9A購01,0.97,0.97,0.66,0.66,-0.37,-35.92,195000,20,148110,0,0,0,0,0,0,111000,138000,-27000,-27000
20200312,709490,穩懋富邦9A購01,0.28,0.28,0.28,0.28,-0.19,-40.43,10000,1,2800,0,0,0,0,0,0,10000,0,10000,10000
20200312,709491,譜瑞富邦9A購01,0.43,0.43,0.30,0.31,-0.15,-32.61,273000,9,100030,0,0,0,0,0,0,118000,155000,-37000,-37000
20200312,709492,同致元富9B購01,0.67,0.67,0.67,0.67,-0.44,-39.64,10000,1,6700,0,0,0,0,0,0,0,10000,-10000,-10000
20200312,709493,博智元富98購01,1.66,1.77,1.48,1.48,-0.66,-30.84,151000,22,251450,0,0,0,0,0,0,151000,0,151000,151000
20200312,709494,威剛統一9A購02,,,,,,0.00,0,0,0,0,0,0,0,0,0,0,0,0,0
20200312,709495,譜瑞統一99購01,0.45,0.45,0.32,0.32,-0.16,-33.33,813000,9,339810,0,0,0,0,0,0,85000,728000,-643000,-643000
20200312,709496,中美晶凱基99購02,0.38,0.39,0.33,0.33,-0.17,-34.0,112000,4,42460,0,0,0,0,0,0,112000,22000,90000,90000
20200312,709497,網家凱基98購01,0.45,0.45,0.42,0.42,-0.11,-20.75,27000,2,11520,0,0,0,0,0,0,21000,27000,-6000,-6000
20200312,709498,網龍凱基98購02,,,,,,0.00,0,0,0,0,0,0,0,0,0,0,0,0,0
20200312,709499,環球晶凱基98購07,0.20,0.30,0.20,0.30,-0.09,-23.08,40000,2,10000,0,0,0,0,0,0,20000,20000,0,0
20200312,709500,環球晶凱基99購04,0.17,0.24,0.17,0.24,-0.02,-7.69,130000,2,24200,0,0,0,0,0,0,0,130000,-130000,-130000
20200312,709501,譜瑞凱基98購01,0.48,0.48,0.31,0.31,-0.28,-47.46,684000,17,314490,0,0,0,0,0,0,26000,668000,-642000,-642000
20200312,709502,譜瑞凱基99購01,0.68,0.71,0.68,0.71,-0.07,-8.97,20000,3,13950,0,0,0,0,0,0,10000,20000,-10000,-10000
20200312,709503,譜瑞凱基9A購01,0.48,0.51,0.46,0.46,-0.19,-29.23,22000,6,10650,0,0,0,0,0,0,2000,20000,-18000,-18000
20200312,709504,合晶兆豐98購01,0.73,0.73,0.73,0.73,-0.34,-31.78,37000,1,27010,0,0,0,0,0,0,0,37000,-37000,-37000
20200312,709505,威剛兆豐99購01,0.31,0.31,0.29,0.29,-0.24,-45.28,2000,2,600,0,0,0,0,0,0,0,2000,-2000,-2000
20200312,709506,聚積兆豐99購01,0.59,0.59,0.56,0.56,-0.10,-15.15,29000,3,16860,0,0,0,0,0,0,25000,4000,21000,21000
20200312,709507,中美晶永豐98購02,0.24,0.24,0.24,0.24,-0.14,-36.84,10000,1,2400,0,0,0,0,0,0,10000,0,10000,10000
20200312,709508,尼克森永豐98購01,0.52,0.52,0.52,0.52,-0.07,-11.86,10000,1,5200,0,0,0,0,0,0,0,10000,-10000,-10000
20200312,709509,安勤永豐98購01,,,,,,0.00,0,0,0,0,0,0,0,0,0,0,0,0,0
20200312,709510,信驊永豐98購01,1.76,1.78,1.62,1.65,-0.32,-16.24,117000,17,194550,0,0,0,0,0,0,1000,116000,-115000,-115000
20200312,709511,博智永豐98購02,1.25,1.25,0.71,0.76,-0.24,-24.0,443000,28,348950,0,0,0,0,0,0,245000,172000,73000,73000
20200312,709512,網家永豐98購01,0.21,0.21,0.21,0.21,-0.17,-44.74,68000,1,14280,0,0,0,0,0,0,68000,0,68000,68000
20200312,709513,中美晶國票98購02,0.68,0.70,0.50,0.68,-0.27,-28.42,80000,7,42060,0,0,0,0,0,0,70000,10000,60000,60000
20200312,709514,網家國票99購01,1.02,1.02,0.73,0.73,-0.93,-56.02,75000,4,58880,0,0,0,0,0,0,38000,37000,1000,1000
20200312,709515,穩懋國票99購01,1.36,1.36,0.92,1.02,-0.86,-45.74,233000,8,289740,0,0,0,0,0,0,0,233000,-233000,-233000
20200312,709516,中美晶國泰9A購01,0.68,0.68,0.68,0.68,-0.40,-37.04,20000,1,13600,0,0,0,0,0,0,20000,0,20000,20000
20200312,709517,太景*國泰9A購02,1.29,1.29,1.00,1.00,-0.50,-33.33,293000,5,368970,0,0,0,0,0,0,273000,20000,253000,253000
20200312,709518,宇峻國泰9A購01,0.88,0.89,0.71,0.71,-0.19,-21.11,470000,5,358200,0,0,0,0,0,0,460000,10000,450000,450000
20200312,709519,威剛國泰99購01,1.04,1.04,0.72,0.72,-0.63,-46.67,20000,2,17600,0,0,0,0,0,0,10000,10000,0,0
20200312,709520,原相國泰99購01,0.70,0.70,0.69,0.69,-0.34,-33.01,25000,2,17490,0,0,0,0,0,0,25000,0,25000,25000
20200312,709521,博智國泰9A購02,1.97,1.97,1.97,1.97,-0.37,-15.81,1000,1,1970,0,0,0,0,0,0,1000,0,1000,1000
20200312,709522,環球晶國泰99購02,0.87,0.87,0.65,0.65,-0.37,-36.27,88000,8,70040,0,0,0,0,0,0,68000,48000,20000,20000
20200312,709523,環球晶國泰9A購01,0.79,0.86,0.57,0.86,-0.12,-12.24,219000,8,139760,0,0,0,0,0,0,59000,189000,-130000,-130000
20200312,709524,鈊象國泰9A購01,2.14,2.26,1.58,1.60,-0.78,-32.77,2337000,92,4516230,0,0,0,0,0,0,1237000,1228000,9000,9000
20200312,709525,譜瑞台新98購01,0.79,0.79,0.69,0.69,-0.20,-22.47,55000,4,42050,0,0,0,0,0,0,55000,0,55000,55000
20200312,709526,大學光富邦98購01,0.36,0.36,0.36,0.36,-0.13,-26.53,10000,1,3600,0,0,0,0,0,0,0,10000,-10000,-10000
20200312,709527,力旺群益99購01,,,,,,0.00,0,0,0,0,0,0,0,0,0,0,0,0,0
20200312,709528,中美晶群益99購02,0.63,0.63,0.63,0.63,-0.19,-23.17,10000,1,6300,0,0,0,0,0,0,10000,0,10000,10000
20200312,709529,宜鼎群益98購03,0.58,0.58,0.45,0.45,-0.27,-37.5,256000,7,122900,0,0,0,0,0,0,32000,224000,-192000,-192000
20200312,709530,神盾群益9A購03,0.56,0.56,0.52,0.52,-0.17,-24.64,30000,2,16040,0,0,0,0,0,0,19000,11000,8000,8000
20200312,709531,碩禾群益98購01,0.25,0.25,0.25,0.25,-0.08,-24.24,98000,1,24500,0,0,0,0,0,0,98000,0,98000,98000
20200312,709532,精測群益98購01,0.58,0.58,0.41,0.41,-0.21,-33.87,58000,9,28340,0,0,0,0,0,0,0,58000,-58000,-58000
20200312,709533,譜瑞群益98購02,,,,,,0.00,0,0,0,0,0,0,0,0,0,0,0,0,0
20200312,709534,M31元大9A購01,0.61,0.61,0.47,0.47,-0.22,-31.88,407000,17,199560,0,0,0,0,0,0,85000,322000,-237000,-237000
20200312,709535,宣德元大99購02,2.23,2.23,1.76,1.88,-0.36,-16.07,251000,10,492090,0,0,0,0,0,0,251000,218000,33000,33000
20200312,709536,網家元大98購03,1.23,1.23,1.16,1.16,-0.33,-22.15,34000,4,40640,0,0,0,0,0,0,34000,0,34000,34000
20200312,709537,環球晶元大9A購01,0.82,0.85,0.60,0.60,-0.32,-34.78,67000,5,49640,0,0,0,0,0,0,37000,52000,-15000,-15000
20200312,709538,穩懋元大98購09,,,,,,0.00,0,0,0,0,0,0,0,0,0,0,0,0,0
20200312,709539,鈺太元大99購03,1.06,1.06,0.86,0.86,-0.39,-31.2,17000,2,17220,0,0,0,0,0,0,13000,4000,9000,9000
20200312,709540,雍智元富98購01,1.07,1.07,0.89,0.89,-0.34,-27.64,65000,5,60200,0,0,0,0,0,0,10000,55000,-45000,-45000
20200312,709541,環球晶中信99購03,0.22,0.22,0.22,0.22,-0.06,-21.43,10000,1,2200,0,0,0,0,0,0,10000,0,10000,10000
20200312,709542,大江凱基9A購01,0.39,0.40,0.28,0.28,-0.15,-34.88,427000,7,133140,0,0,0,0,0,0,0,427000,-427000,-427000
20200312,709543,中美晶凱基9A購02,0.43,0.43,0.30,0.38,-0.13,-25.49,211000,10,68770,0,0,0,0,0,0,191000,20000,171000,171000
20200312,709544,台半凱基98購02,0.75,0.75,0.67,0.67,-0.27,-28.72,41000,3,29740,0,0,0,0,0,0,21000,41000,-20000,-20000
20200312,709545,安勤凱基98購01,0.58,0.58,0.46,0.47,-0.24,-33.8,140000,8,67700,0,0,0,0,0,0,65000,75000,-10000,-10000
20200312,709546,環球晶凱基99購05,0.25,0.33,0.25,0.33,-0.05,-13.16,32000,7,8710,0,0,0,0,0,0,11000,17000,-6000,-6000
20200312,709547,穩懋凱基98購09,0.37,0.37,0.36,0.36,-0.26,-41.94,30000,4,11000,0,0,0,0,0,0,0,30000,-30000,-30000
20200312,709548,威剛統一99購01,0.43,0.43,0.43,0.43,-0.27,-38.57,48000,1,20640,0,0,0,0,0,0,0,48000,-48000,-48000
20200312,709549,網家統一9A購01,0.30,0.30,0.30,0.30,-0.13,-30.23,20000,2,6000,0,0,0,0,0,0,0,20000,-20000,-20000
20200312,709550,環球晶統一99購03,,,,,,0.00,0,0,0,0,0,0,0,0,0,0,0,0,0
20200312,709551,大江元大99購02,1.21,1.21,1.21,1.21,-0.17,-12.32,68000,1,82280,0,0,0,0,0,0,0,68000,-68000,-68000
20200312,709552,神盾元大99購04,,,,,,0.00,0,0,0,0,0,0,0,0,0,0,0,0,0
20200312,709553,博智元大98購03,2.25,2.27,1.90,1.96,-0.53,-21.29,32000,7,69050,0,0,0,0,0,0,31000,4000,27000,27000
20200312,709554,群聯元大99購03,1.20,1.20,0.89,0.89,-0.49,-35.51,313000,16,313690,0,0,0,0,0,0,283000,193000,90000,90000
20200312,709555,譜瑞元大98購06,1.80,1.83,1.25,1.25,-0.73,-36.87,102000,6,141780,0,0,0,0,0,0,82000,32000,50000,50000
20200312,709556,威剛國票99購01,,,,,,0.00,0,0,0,0,0,0,0,0,0,0,0,0,0
20200312,709557,神盾國票99購01,1.13,1.13,0.91,0.91,-0.38,-29.46,25000,4,26790,0,0,0,0,0,0,10000,15000,-5000,-5000
20200312,709558,廣明國票99購01,,,,,,0.00,0,0,0,0,0,0,0,0,0,0,0,0,0
20200312,709559,環球晶國票99購01,,,,,,0.00,0,0,0,0,0,0,0,0,0,0,0,0,0
20200312,709560,雙美國票99購02,,,,,,0.00,0,0,0,0,0,0,0,0,0,0,0,0,0
20200312,709561,聚積國泰99購01,0.88,0.88,0.69,0.69,-0.33,-32.35,26000,2,21740,0,0,0,0,0,0,20000,6000,14000,14000
20200312,709562,中美晶群益98購03,0.33,0.34,0.28,0.32,-0.11,-25.58,65000,4,20150,0,0,0,0,0,0,20000,45000,-25000,-25000
20200312,709563,合晶群益98購02,0.63,0.63,0.49,0.49,-0.35,-41.67,104000,3,64930,0,0,0,0,0,0,98000,6000,92000,92000
20200312,709564,旺矽群益99購01,0.44,0.44,0.32,0.32,-0.21,-39.62,63000,4,27280,0,0,0,0,0,0,51000,12000,39000,39000
20200312,709565,宣德群益98購02,1.94,1.94,1.60,1.60,-0.75,-31.91,51000,3,88740,0,0,0,0,0,0,51000,0,51000,51000
20200312,709566,鈺太群益98購03,0.99,0.99,0.80,0.80,-0.44,-35.48,148000,7,138960,0,0,0,0,0,0,108000,40000,68000,68000
20200312,709567,穩懋台新98購02,0.59,0.59,0.59,0.59,-0.46,-43.81,200000,1,118000,0,0,0,0,0,0,0,200000,-200000,-200000
20200312,709568,原相亞東99購02,1.03,1.03,0.79,0.79,-0.84,-51.53,130000,4,112920,0,0,0,0,0,0,51000,79000,-28000,-28000
20200312,709569,群聯亞東98購01,,,,,,0.00,0,0,0,0,0,0,0,0,0,0,0,0,0
20200312,709570,直得永豐98購01,,,,,,0.00,0,0,0,0,0,0,0,0,0,0,0,0,0
20200312,709571,網龍永豐98購02,,,,,,0.00,0,0,0,0,0,0,0,0,0,0,0,0,0
20200312,709572,聚積永豐98購01,0.24,0.24,0.24,0.24,-0.18,-42.86,68000,1,16320,0,0,0,0,0,0,68000,0,68000,68000
20200312,709573,鈺太永豐98購01,0.34,0.34,0.34,0.34,-0.13,-27.66,25000,1,8500,0,0,0,0,0,0,25000,0,25000,25000
20200312,709574,元太台新98購02,,,,,,0.00,0,0,0,0,0,0,0,0,0,0,0,0,0
20200312,709575,中美晶元大98購06,,,,,,0.00,0,0,0,0,0,0,0,0,0,0,0,0,0
20200312,709576,原相元大9A購03,2.26,2.26,1.80,1.80,-0.72,-28.57,37000,10,73950,0,0,0,0,0,0,27000,28000,-1000,-1000
20200312,709577,泰博元大98購01,2.28,2.28,1.62,1.95,-0.40,-17.02,110000,6,220040,0,0,0,0,0,0,48000,62000,-14000,-14000
20200312,709578,聚積元大9A購01,0.60,0.60,0.60,0.60,-0.27,-31.03,68000,1,40800,0,0,0,0,0,0,0,68000,-68000,-68000
20200312,709579,環球晶元大98購15,0.56,0.58,0.56,0.58,-0.04,-6.45,15000,2,8600,0,0,0,0,0,0,5000,15000,-10000,-10000
20200312,709580,宇峻中信98購01,,,,,,0.00,0,0,0,0,0,0,0,0,0,0,0,0,0
20200312,709581,原相統一99購02,0.40,0.40,0.28,0.30,-0.13,-30.23,2529000,48,859140,2000,0,2000,0,0,0,964000,1560000,-596000,-594000
20200312,709582,雙鴻統一99購02,0.56,0.56,0.41,0.41,-0.20,-32.79,90000,7,43970,0,0,0,0,0,0,42000,48000,-6000,-6000
20200312,709583,大宇資凱基99購01,,,,,,0.00,0,0,0,0,0,0,0,0,0,0,0,0,0
20200312,709584,威剛凱基98購01,,,,,,0.00,0,0,0,0,0,0,0,0,0,0,0,0,0
20200312,709585,博智凱基9A購01,0.72,0.75,0.59,0.62,-0.19,-23.46,567000,38,362580,0,0,0,0,0,0,372000,155000,217000,217000
20200312,709586,精測凱基99購02,0.72,0.72,0.54,0.56,-0.22,-28.21,51000,5,33630,0,0,0,0,0,0,39000,12000,27000,27000
20200312,709587,譜瑞凱基98購02,0.61,0.62,0.43,0.43,-0.25,-36.76,394000,9,176090,0,0,0,0,0,0,74000,334000,-260000,-260000
20200312,709588,中美晶群益98購04,0.50,0.50,0.50,0.50,-0.15,-23.08,20000,1,10000,0,0,0,0,0,0,20000,0,20000,20000
20200312,709589,元太群益99購01,,,,,,0.00,0,0,0,0,0,0,0,0,0,0,0,0,0
20200312,709590,網家群益98購03,0.67,0.67,0.46,0.46,-0.35,-43.21,114000,8,71160,0,0,0,0,0,0,70000,44000,26000,26000
20200312,709591,譜瑞群益98購03,,,,,,0.00,0,0,0,0,0,0,0,0,0,0,0,0,0
20200312,709592,泰博國票99購03,1.41,1.41,1.00,1.19,-0.35,-22.73,251000,16,313040,0,0,0,0,0,0,90000,164000,-74000,-74000
20200312,709593,合晶國泰99購02,0.81,0.94,0.81,0.94,-0.43,-31.39,60000,2,55100,0,0,0,0,0,0,50000,10000,40000,40000
20200312,709594,保瑞國泰9A購01,1.41,1.41,1.21,1.24,-0.17,-12.06,1277000,52,1658790,0,0,0,0,0,0,677000,600000,77000,77000
20200312,709595,璟德兆豐99購01,0.29,0.29,0.25,0.26,-0.14,-35.0,867000,12,227690,0,0,0,0,0,0,851000,16000,835000,835000
20200312,709596,亞泰永豐99購02,0.49,0.49,0.45,0.47,-0.06,-11.32,32000,5,14810,0,0,0,0,0,0,0,32000,-32000,-32000
20200312,709597,保瑞永豐98購01,0.70,0.70,0.59,0.65,-0.08,-10.96,434000,14,276260,0,0,0,0,0,0,344000,71000,273000,273000
20200312,709598,建榮永豐99購03,,,,,,0.00,0,0,0,0,0,0,0,0,0,0,0,0,0
20200312,709599,神盾永豐98購01,,,,,,0.00,0,0,0,0,0,0,0,0,0,0,0,0,0
20200312,709600,新鉅科永豐98購02,,,,,,0.00,0,0,0,0,0,0,0,0,0,0,0,0,0
20200312,709601,雙美永豐99購02,,,,,,0.00,0,0,0,0,0,0,0,0,0,0,0,0,0
20200312,709602,穩懋永豐98購03,0.76,0.76,0.57,0.57,-0.52,-47.71,81000,4,58740,0,0,0,0,0,0,77000,27000,50000,50000
20200312,709603,晟德永豐98購01,0.54,0.54,0.54,0.54,-0.04,-6.9,12000,1,6480,0,0,0,0,0,0,0,12000,-12000,-12000
20200312,709604,鈊象永豐98購03,1.05,1.19,0.69,0.72,-0.46,-38.98,531000,62,439080,0,0,0,0,0,0,133000,302000,-169000,-169000
20200312,709605,中美晶元富99購02,0.51,0.54,0.51,0.54,-0.24,-30.77,100000,3,51330,0,0,0,0,0,0,0,100000,-100000,-100000
20200312,709606,尼克森元富98購01,1.20,1.20,0.87,0.87,-0.61,-41.22,38000,4,41690,0,0,0,0,0,0,17000,21000,-4000,-4000
20200312,709607,博智元富98購02,1.69,1.69,1.30,1.37,-0.54,-28.27,200000,25,308300,0,0,0,0,0,0,114000,86000,28000,28000
20200312,709608,網龍元富98購01,0.31,0.31,0.31,0.31,-0.12,-27.91,1000,1,310,0,0,0,0,0,0,0,1000,-1000,-1000
20200312,709609,穩懋元富02購01,1.12,1.14,0.91,0.93,-0.38,-29.01,527000,10,560590,0,0,0,0,0,0,242000,289000,-47000,-47000
20200312,709610,穩懋元富02購02,1.03,1.03,0.89,0.89,-0.43,-32.58,196000,2,188160,0,0,0,0,0,0,98000,98000,0,0
20200312,709611,穩懋元富02購03,1.10,1.10,0.90,0.90,-0.52,-36.62,196000,2,196000,0,0,0,0,0,0,98000,98000,0,0
20200312,709612,穩懋元富02購04,1.14,1.14,0.99,0.99,-0.59,-37.34,196000,2,208740,0,0,0,0,0,0,98000,98000,0,0
20200312,709613,凡甲凱基98購02,1.45,1.45,1.23,1.27,-0.31,-19.62,164000,9,221200,0,0,0,0,0,0,164000,0,164000,164000
20200312,709614,中美晶凱基99購03,0.55,0.55,0.52,0.52,-0.05,-8.77,16000,2,8620,0,0,0,0,0,0,16000,0,16000,16000
20200312,709615,緯軟凱基98購04,,,,,,0.00,0,0,0,0,0,0,0,0,0,0,0,0,0
20200312,709616,大江兆豐99購01,0.42,0.42,0.37,0.37,-0.27,-42.19,88000,4,34460,0,0,0,0,0,0,10000,78000,-68000,-68000
20200312,709617,大江群益98購03,,,,,,0.00,0,0,0,0,0,0,0,0,0,0,0,0,0
20200312,709618,安勤群益98購01,0.56,0.60,0.55,0.55,-0.31,-36.05,80000,10,45650,0,0,0,0,0,0,30000,50000,-20000,-20000
20200312,709619,杰力群益98購01,0.90,0.90,0.69,0.69,-0.33,-32.35,24000,3,20570,0,0,0,0,0,0,10000,14000,-4000,-4000
20200312,709620,群聯群益98購03,0.92,0.92,0.57,0.63,-0.63,-50.0,9000,3,5600,0,0,0,0,0,0,9000,9000,0,0
20200312,709621,環球晶群益98購04,0.81,0.81,0.65,0.65,-0.37,-36.27,134000,5,105560,0,0,0,0,0,0,129000,36000,93000,93000
20200312,709622,M31永豐98購02,0.42,0.42,0.42,0.42,-0.14,-25.0,68000,1,28560,0,0,0,0,0,0,0,68000,-68000,-68000
20200312,709623,尼克森永豐98購02,,,,,,0.00,0,0,0,0,0,0,0,0,0,0,0,0,0
20200312,709624,泰博永豐99購01,0.67,0.67,0.61,0.63,-0.13,-17.11,467000,7,290510,0,0,0,0,0,0,411000,56000,355000,355000
20200312,709625,力旺國票99購01,,,,,,0.00,0,0,0,0,0,0,0,0,0,0,0,0,0
20200312,709626,建榮國票9A購01,0.68,0.68,0.58,0.58,-0.32,-35.56,260000,26,156300,0,0,0,0,0,0,260000,260000,0,0
20200312,709627,博智國票99購01,1.91,2.04,1.60,1.72,-0.54,-23.89,257000,22,453950,0,0,0,0,0,0,141000,116000,25000,25000
20200312,709628,優群國票99購01,5.25,5.25,4.06,4.07,-2.48,-37.86,109000,10,476280,0,0,0,0,0,0,35000,74000,-39000,-39000
20200312,709629,環球晶國票99購02,,,,,,0.00,0,0,0,0,0,0,0,0,0,0,0,0,0
20200312,709630,聯亞國票99購03,2.29,2.29,1.83,1.83,-1.81,-49.73,71000,6,136290,0,0,0,0,0,0,23000,48000,-25000,-25000
20200312,709631,大中元大98購01,,,,,,0.00,0,0,0,0,0,0,0,0,0,0,0,0,0
20200312,709632,合晶元大99購01,1.22,1.22,1.22,1.22,-0.13,-9.63,15000,1,18300,0,0,0,0,0,0,15000,0,15000,15000
20200312,709633,宜鼎元大99購01,0.60,0.60,0.52,0.52,-0.36,-40.91,319000,5,170900,0,0,0,0,0,0,50000,269000,-219000,-219000
20200312,709634,保瑞元大98購02,2.19,2.19,1.78,1.80,-0.27,-13.04,684000,33,1311420,0,0,0,0,0,0,448000,342000,106000,106000
20200312,709635,譜瑞元大98購07,1.01,1.01,0.79,0.88,-0.31,-26.05,58000,6,53950,0,0,0,0,0,0,56000,58000,-2000,-2000
20200312,709636,晟德元大98購01,1.46,1.46,1.46,1.46,-0.08,-5.19,10000,1,14600,0,0,0,0,0,0,10000,0,10000,10000
20200312,709637,安勤元富98購01,0.93,0.93,0.93,0.93,-0.38,-29.01,10000,1,9300,0,0,0,0,0,0,10000,0,10000,10000
20200312,709638,威剛富邦9A購01,0.53,0.53,0.40,0.40,-0.17,-29.82,150000,15,75900,0,0,0,0,0,0,100000,50000,50000,50000
20200312,709639,雙鴻富邦99購01,0.38,0.38,0.32,0.32,-0.15,-31.91,220000,2,82400,0,0,0,0,0,0,220000,0,220000,220000
20200312,709640,博智台新98購01,0.97,0.97,0.85,0.85,-0.12,-12.37,23000,4,20730,0,0,0,0,0,0,14000,9000,5000,5000
20200312,709641,久元群益98購01,,,,,,0.00,0,0,0,0,0,0,0,0,0,0,0,0,0
20200312,709642,群聯群益98購04,0.92,0.93,0.60,0.65,-0.57,-46.72,283000,8,210890,0,0,0,0,0,0,180000,112000,68000,68000
20200312,709643,聖暉群益98購01,1.95,2.00,1.87,1.87,-0.33,-15.0,309000,12,614300,0,0,0,0,0,0,299000,10000,289000,289000
20200312,709644,璟德中信98購01,1.81,1.81,1.79,1.79,-0.64,-26.34,20000,2,36000,0,0,0,0,0,0,20000,0,20000,20000
20200312,709645,合晶統一9A購01,,,,,,0.00,0,0,0,0,0,0,0,0,0,0,0,0,0
20200312,709646,神盾統一99購01,0.75,0.75,0.75,0.75,-0.22,-22.68,20000,1,15000,0,0,0,0,0,0,20000,0,20000,20000
20200312,709647,環球晶統一99購04,,,,,,0.00,0,0,0,0,0,0,0,0,0,0,0,0,0
20200312,709648,穩懋統一98購06,,,,,,0.00,0,0,0,0,0,0,0,0,0,0,0,0,0
20200312,709649,中美晶凱基99購04,,,,,,0.00,0,0,0,0,0,0,0,0,0,0,0,0,0
20200312,709650,精測凱基98購05,0.83,0.85,0.65,0.65,-0.30,-31.58,156000,5,112380,0,0,0,0,0,0,50000,106000,-56000,-56000
20200312,709651,聯亞凱基99購04,0.71,0.71,0.55,0.56,-0.32,-36.36,1201000,37,738720,0,0,0,0,0,0,965000,194000,771000,771000
20200312,709652,大學光國票99購01,1.15,1.15,1.15,1.15,-0.32,-21.77,5000,1,5750,0,0,0,0,0,0,0,5000,-5000,-5000
20200312,709653,原相國票99購02,0.97,0.97,0.75,0.75,-0.44,-36.97,37000,4,34350,0,0,0,0,0,0,17000,20000,-3000,-3000
20200312,709654,安勤國泰99購01,0.71,0.71,0.71,0.71,-0.37,-34.26,38000,1,26980,0,0,0,0,0,0,0,38000,-38000,-38000
20200312,709655,大江元大98購03,,,,,,0.00,0,0,0,0,0,0,0,0,0,0,0,0,0
20200312,709656,中美晶元大99購03,1.20,1.20,1.10,1.10,-0.18,-14.06,11000,2,13100,0,0,0,0,0,0,11000,0,11000,11000
20200312,709657,宇峻元大99購03,1.02,1.02,0.93,0.93,-0.12,-11.43,220000,3,206100,0,0,0,0,0,0,220000,0,220000,220000
20200312,709658,博智元大99購01,2.34,2.34,1.99,1.99,-0.50,-20.08,33000,7,72020,0,0,0,0,0,0,27000,9000,18000,18000
20200312,709659,網家元大99購02,1.54,1.54,1.09,1.09,-0.59,-35.12,179000,5,242540,0,0,0,0,0,0,177000,2000,175000,175000
20200312,709660,環球晶元大98購16,0.72,0.75,0.63,0.74,-0.12,-13.95,267000,7,195340,0,0,0,0,0,0,27000,267000,-240000,-240000
20200312,709661,環球晶元大99購02,0.74,0.78,0.61,0.77,-0.12,-13.48,237000,8,170060,0,0,0,0,0,0,105000,159000,-54000,-54000
20200312,709662,穩懋元大98購10,1.38,1.38,1.38,1.38,-0.49,-26.2,60000,1,82800,0,0,0,0,0,0,60000,60000,0,0
20200312,709663,譜瑞元大98購08,1.48,1.48,0.95,1.00,-0.63,-38.65,80000,13,82290,0,0,0,0,0,0,61000,30000,31000,31000
20200312,709664,神盾第一9C購02,,,,,,0.00,0,0,0,0,0,0,0,0,0,0,0,0,0
20200312,709665,台半永豐98購01,0.68,0.68,0.68,0.68,-0.09,-11.69,10000,1,6800,0,0,0,0,0,0,0,10000,-10000,-10000
20200312,709666,兆利永豐98購02,,,,,,0.00,0,0,0,0,0,0,0,0,0,0,0,0,0
20200312,709667,金居永豐98購02,,,,,,0.00,0,0,0,0,0,0,0,0,0,0,0,0,0
20200312,709668,宣德永豐98購03,,,,,,0.00,0,0,0,0,0,0,0,0,0,0,0,0,0
20200312,709669,博智永豐99購01,0.70,0.74,0.60,0.64,-0.19,-22.89,344000,28,237370,0,0,0,0,0,0,252000,82000,170000,170000
20200312,709670,晶焱永豐98購03,,,,,,0.00,0,0,0,0,0,0,0,0,0,0,0,0,0
20200312,709671,雍智永豐99購01,0.56,0.58,0.53,0.53,-0.16,-23.19,104000,3,56820,0,0,0,0,0,0,54000,50000,4000,4000
20200312,709672,環宇永豐98購03,0.39,0.39,0.38,0.38,-0.19,-33.33,87000,2,33080,0,0,0,0,0,0,87000,0,87000,87000
20200312,709673,環球晶元富98購04,,,,,,0.00,0,0,0,0,0,0,0,0,0,0,0,0,0
20200312,709674,力旺元大98購01,,,,,,0.00,0,0,0,0,0,0,0,0,0,0,0,0,0
20200312,709675,力旺元大98購02,1.19,1.19,1.19,1.19,-0.71,-37.37,10000,1,11900,0,0,0,0,0,0,0,10000,-10000,-10000
20200312,709676,中美晶元大98購08,1.06,1.06,0.98,0.98,-0.60,-37.97,70000,2,74040,0,0,0,0,0,0,2000,68000,-66000,-66000
20200312,709677,聚積元大99購01,0.53,0.53,0.53,0.53,-0.17,-24.29,79000,2,41870,0,0,0,0,0,0,0,79000,-79000,-79000
20200312,709678,聯亞元大98購05,1.15,1.15,0.86,0.87,-0.39,-30.95,624000,32,598320,0,0,0,0,0,0,444000,146000,298000,298000
20200312,709679,譜瑞元大98購09,1.23,1.23,0.93,0.94,-0.38,-28.79,104000,9,117920,0,0,0,0,0,0,104000,11000,93000,93000
20200312,709680,中美晶國票99購01,0.97,0.97,0.97,0.97,-0.41,-29.71,30000,1,29100,0,0,0,0,0,0,0,30000,-30000,-30000
20200312,709681,宣德國票98購02,1.64,1.64,1.64,1.64,-1.44,-46.75,38000,1,62320,0,0,0,0,0,0,38000,0,38000,38000
20200312,709682,建榮國票9A購02,,,,,,0.00,0,0,0,0,0,0,0,0,0,0,0,0,0
20200312,709683,網家國票99購02,1.21,1.21,1.21,1.21,-0.77,-38.89,10000,1,12100,0,0,0,0,0,0,10000,0,10000,10000
20200312,709684,雍智國泰9A購01,1.01,1.01,0.80,0.86,-0.16,-15.69,190000,10,166500,0,0,0,0,0,0,20000,180000,-160000,-160000
20200312,709685,安勤統一98購01,,,,,,0.00,0,0,0,0,0,0,0,0,0,0,0,0,0
20200312,709686,元太中信9A購01,,,,,,0.00,0,0,0,0,0,0,0,0,0,0,0,0,0
20200312,709687,台燿中信9A購01,0.59,0.59,0.58,0.58,-0.21,-26.58,30000,3,17500,0,0,0,0,0,0,20000,10000,10000,10000
20200312,709688,合晶中信9A購02,0.37,0.37,0.37,0.37,-0.07,-15.91,8000,1,2960,0,0,0,0,0,0,8000,0,8000,8000
20200312,709689,中美晶凱基99購05,0.79,0.80,0.62,0.77,-0.18,-18.95,196000,21,146070,0,0,0,0,0,0,71000,137000,-66000,-66000
20200312,709690,六角凱基99購03,0.86,0.86,0.71,0.71,-0.30,-29.7,43000,7,32710,0,0,0,0,0,0,18000,35000,-17000,-17000
20200312,709691,智崴凱基98購01,0.43,0.43,0.34,0.35,-0.21,-37.5,37000,6,14050,0,0,0,0,0,0,6000,21000,-15000,-15000
20200312,709692,昇達科永豐98購01,0.87,0.87,0.70,0.70,-0.37,-34.58,388000,8,315130,0,140000,-140000,0,0,0,155000,233000,-78000,-218000
20200312,709693,建榮永豐99購04,0.83,0.83,0.81,0.81,-0.23,-22.12,3000,2,2470,0,0,0,0,0,0,0,3000,-3000,-3000
20200312,709694,順達永豐98購01,1.35,1.35,1.28,1.28,-0.15,-10.49,20000,2,26300,0,0,0,0,0,0,10000,10000,0,0
20200312,709695,精測永豐98購01,0.72,0.72,0.62,0.62,-0.37,-37.37,4000,2,2780,0,0,0,0,0,0,3000,1000,2000,2000
20200312,709696,穩懋永豐98購04,0.31,0.31,0.31,0.31,-0.34,-52.31,25000,1,7750,0,0,0,0,0,0,25000,0,25000,25000
20200312,709697,鈊象永豐99購01,0.71,0.75,0.48,0.48,-0.30,-38.46,1428000,57,767770,0,0,0,0,0,0,374000,1024000,-650000,-650000
20200312,709698,力旺中信99購01,1.44,1.44,1.21,1.22,-0.74,-37.76,50000,5,66150,0,0,0,0,0,0,0,50000,-50000,-50000
20200312,709699,凡甲元大9A購02,1.05,1.05,0.91,0.91,-0.27,-22.88,46000,5,45300,0,0,0,0,0,0,17000,29000,-12000,-12000
20200312,709700,安勤元大99購01,,,,,,0.00,0,0,0,0,0,0,0,0,0,0,0,0,0
20200312,709701,宏捷科元大99購01,2.75,2.80,2.55,2.55,-0.66,-20.56,67000,4,179530,0,0,0,0,0,0,63000,67000,-4000,-4000
20200312,709702,宜鼎元大9A購01,0.65,0.65,0.54,0.56,-0.31,-35.63,288000,5,162220,0,0,0,0,0,0,10000,278000,-268000,-268000
20200312,709703,直得元大99購01,1.57,1.57,1.21,1.21,-0.51,-29.65,44000,12,63590,0,0,0,0,0,0,30000,14000,16000,16000
20200312,709704,南光元大99購01,1.50,1.50,1.15,1.15,-0.43,-27.22,660000,13,859760,0,0,0,0,0,0,51000,609000,-558000,-558000
20200312,709705,原相元大99購03,0.79,0.79,0.60,0.60,-0.27,-31.03,1272000,41,828190,0,0,0,0,0,0,598000,660000,-62000,-62000
20200312,709706,新鉅科元大99購01,0.87,0.87,0.68,0.68,-0.34,-33.33,424000,10,316650,0,0,0,0,0,0,253000,171000,82000,82000
20200312,709707,穩懋元大99購02,2.00,2.04,1.63,1.63,-0.74,-31.22,130000,12,233500,0,0,0,0,0,0,81000,130000,-49000,-49000
20200312,709708,晟德元大99購01,1.14,1.14,1.14,1.14,-0.24,-17.39,2000,1,2280,0,0,0,0,0,0,0,2000,-2000,-2000
20200312,709709,大宇資國票9A購01,,,,,,0.00,0,0,0,0,0,0,0,0,0,0,0,0,0
20200312,709710,宏捷科國票9A購01,4.19,4.75,4.19,4.75,-1.95,-29.1,68000,2,301720,0,0,0,0,0,0,0,68000,-68000,-68000
20200312,709711,穩懋國泰9A購01,1.46,1.46,1.11,1.11,-0.80,-41.88,120000,8,147200,0,0,0,0,0,0,80000,100000,-20000,-20000
20200312,709712,穩懋國泰9B購01,1.38,1.38,1.01,1.03,-0.78,-43.09,227000,14,245870,0,0,0,0,0,0,85000,227000,-142000,-142000
20200312,709713,亞泰元富99購01,1.06,1.06,1.06,1.06,-0.19,-15.2,10000,1,10600,0,0,0,0,0,0,10000,0,10000,10000
20200312,709714,合晶統一9A購02,,,,,,0.00,0,0,0,0,0,0,0,0,0,0,0,0,0
20200312,709715,宏捷科統一9A購01,0.76,0.76,0.64,0.67,-0.20,-22.99,246000,9,172130,0,0,0,0,0,0,150000,96000,54000,54000
20200312,709716,泰博統一9A購01,1.06,1.06,0.85,0.99,-0.18,-15.38,271000,12,249590,0,0,0,0,0,0,62000,209000,-147000,-147000
20200312,709717,神盾統一9A購01,,,,,,0.00,0,0,0,0,0,0,0,0,0,0,0,0,0
20200312,709718,雙鴻統一9A購01,0.64,0.64,0.55,0.57,-0.33,-36.67,54000,5,31530,0,0,0,0,0,0,0,54000,-54000,-54000
20200312,709719,宏捷科日盛99購01,1.29,1.29,1.12,1.12,-0.37,-24.83,34000,3,42410,0,0,0,0,0,0,29000,5000,24000,24000
20200312,709720,VHQ凱基9A購01,1.21,1.21,1.21,1.21,-0.29,-19.33,3000,1,3630,0,0,0,0,0,0,3000,0,3000,3000
20200312,709721,三貝德凱基9A購01,0.24,0.24,0.24,0.24,-0.11,-31.43,10000,1,2400,0,0,0,0,0,0,0,10000,-10000,-10000
20200312,709722,太景*凱基99購01,0.82,0.82,0.41,0.41,-0.50,-54.95,134000,10,87390,0,0,0,0,0,0,55000,70000,-15000,-15000
20200312,709723,宏捷科凱基99購01,1.08,1.08,0.81,0.92,-0.25,-21.37,155000,16,142450,0,0,0,0,0,0,83000,72000,11000,11000
20200312,709724,晶焱凱基99購01,,,,,,0.00,0,0,0,0,0,0,0,0,0,0,0,0,0
20200312,709725,大學光永豐99購01,,,,,,0.00,0,0,0,0,0,0,0,0,0,0,0,0,0
20200312,709726,宏捷科永豐99購01,1.22,1.22,1.15,1.15,-0.55,-32.35,49000,2,59080,0,0,0,0,0,0,0,49000,-49000,-49000
20200312,709727,信驊永豐99購01,1.41,1.47,1.34,1.42,-0.44,-23.66,735000,50,1050740,0,0,0,0,0,0,23000,705000,-682000,-682000
20200312,709728,威剛永豐99購02,1.07,1.07,0.80,0.80,-0.63,-44.06,228000,3,198700,0,0,0,0,0,0,10000,218000,-208000,-208000
20200312,709729,環球晶永豐99購01,0.25,0.25,0.21,0.21,-0.16,-43.24,40000,2,9200,0,0,0,0,0,0,0,40000,-40000,-40000
20200312,709730,宏捷科康和99購01,1.11,1.11,1.11,1.11,-0.26,-18.98,20000,1,22200,0,0,0,0,0,0,20000,0,20000,20000
20200312,709731,宏捷科群益99購01,1.77,1.77,1.69,1.70,-0.17,-9.09,106000,3,179640,0,0,0,0,0,0,8000,98000,-90000,-90000
20200312,709732,宏捷科元富99購01,1.40,1.40,1.10,1.21,-0.33,-21.43,455000,16,589520,0,0,0,0,0,0,308000,147000,161000,161000
20200312,709733,智擎元富99購01,1.03,1.03,0.71,0.71,-0.49,-40.83,25000,2,20950,0,0,0,0,0,0,10000,15000,-5000,-5000
20200312,709734,中美晶統一9B購02,,,,,,0.00,0,0,0,0,0,0,0,0,0,0,0,0,0
20200312,709735,宏捷科統一9B購01,0.80,0.80,0.70,0.72,-0.15,-17.24,50000,8,37410,0,0,0,0,0,0,1000,46000,-45000,-45000
20200312,709736,宏捷科凱基9B購01,,,,,,0.00,0,0,0,0,0,0,0,0,0,0,0,0,0
20200312,709737,威剛凱基9B購01,0.54,0.54,0.43,0.44,-0.25,-36.23,86000,4,39000,0,0,0,0,0,0,81000,5000,76000,76000
20200312,709738,建榮凱基9A購02,,,,,,0.00,0,0,0,0,0,0,0,0,0,0,0,0,0
20200312,709739,神盾凱基9A購01,,,,,,0.00,0,0,0,0,0,0,0,0,0,0,0,0,0
20200312,709740,新鉅科凱基99購01,,,,,,0.00,0,0,0,0,0,0,0,0,0,0,0,0,0
20200312,709741,聚積凱基9A購01,0.68,0.68,0.68,0.68,-0.28,-29.17,3000,1,2040,0,0,0,0,0,0,3000,0,3000,3000
20200312,709742,久元元大99購01,,,,,,0.00,0,0,0,0,0,0,0,0,0,0,0,0,0
20200312,709743,久元元大99購02,,,,,,0.00,0,0,0,0,0,0,0,0,0,0,0,0,0
20200312,709744,光頡元大99購01,0.86,0.93,0.86,0.93,-0.49,-34.51,2000,2,1790,0,0,0,0,0,0,2000,0,2000,2000
20200312,709745,合晶元大99購02,,,,,,0.00,0,0,0,0,0,0,0,0,0,0,0,0,0
20200312,709746,宏捷科元大99購03,3.50,3.50,2.77,3.08,-0.85,-21.63,391000,22,1239230,0,0,0,0,0,0,194000,197000,-3000,-3000
20200312,709747,迅得元大9B購01,0.46,0.46,0.41,0.41,-0.15,-26.79,27000,3,11770,0,0,0,0,0,0,0,27000,-27000,-27000
20200312,709748,勝麗元大99購01,1.19,1.19,1.19,1.19,-0.28,-19.05,74000,1,88060,0,0,0,0,0,0,74000,0,74000,74000
20200312,709749,宏捷科群益99購02,0.92,0.92,0.87,0.87,-0.24,-21.62,68000,2,61660,0,0,0,0,0,0,68000,0,68000,68000
20200312,709750,信昌電群益99購01,1.03,1.03,1.03,1.03,-0.26,-20.16,98000,1,100940,0,0,0,0,0,0,98000,0,98000,98000
20200312,709751,安勤國票99購01,1.64,1.75,1.27,1.30,-1.15,-46.94,386000,6,563440,0,0,0,0,0,0,250000,136000,114000,114000
20200312,709752,中美晶富邦9B購01,0.33,0.35,0.33,0.35,-0.06,-14.63,16000,3,5480,0,0,0,0,0,0,1000,6000,-5000,-5000
20200312,709753,宏捷科富邦9B購01,0.76,0.77,0.64,0.69,-0.15,-17.86,174000,15,122270,0,0,0,0,0,0,33000,141000,-108000,-108000
20200312,709754,穩懋富邦9B購01,0.65,0.65,0.51,0.51,-0.26,-33.77,11000,2,6310,0,0,0,0,0,0,5000,11000,-6000,-6000
20200312,709755,力致永豐99購02,0.42,0.42,0.34,0.34,-0.26,-43.33,55000,3,19100,0,0,0,0,0,0,0,55000,-55000,-55000
20200312,709756,大學光永豐99購02,,,,,,0.00,0,0,0,0,0,0,0,0,0,0,0,0,0
20200312,709757,宏捷科永豐99購02,1.29,1.31,1.16,1.18,-0.44,-27.16,58000,5,72730,0,0,0,0,0,0,2000,56000,-54000,-54000
20200312,709758,精華永豐99購01,0.36,0.37,0.34,0.34,-0.26,-43.33,35000,3,12680,0,0,0,0,0,0,32000,3000,29000,29000
20200312,709759,鈺太永豐99購01,0.57,0.57,0.48,0.48,-0.30,-38.46,16000,3,8130,0,0,0,0,0,0,5000,11000,-6000,-6000
20200312,709760,合晶凱基9A購01,0.74,0.74,0.63,0.70,-0.28,-28.57,40000,4,28000,0,0,0,0,0,0,20000,20000,0,0
20200312,709761,雙鴻凱基9A購01,0.65,0.65,0.64,0.64,-0.40,-38.46,30000,5,19400,0,0,0,0,0,0,0,30000,-30000,-30000
20200312,709762,宏捷科統一9B購02,1.10,1.15,1.10,1.11,-0.35,-23.97,97000,5,108800,0,0,0,0,0,0,0,97000,-97000,-97000
20200312,709763,宣德統一99購01,,,,,,0.00,0,0,0,0,0,0,0,0,0,0,0,0,0
20200312,709764,建榮統一9B購01,0.67,0.67,0.67,0.67,-0.10,-12.99,264000,2,176880,0,0,0,0,0,0,264000,264000,0,0
20200312,709765,海韻電永豐99購01,,,,,,0.00,0,0,0,0,0,0,0,0,0,0,0,0,0
20200312,709766,優群永豐99購01,1.98,1.98,1.58,1.58,-0.64,-28.83,59000,7,109680,0,0,0,0,0,0,44000,15000,29000,29000
20200312,709767,穩懋永豐9A購01,1.06,1.06,0.81,0.81,-0.57,-41.3,87000,7,80730,0,0,0,0,0,0,20000,87000,-67000,-67000
20200312,709768,海韻電元富99購01,1.52,1.52,1.40,1.40,-0.48,-25.53,30000,3,44400,0,0,0,0,0,0,30000,0,30000,30000
20200312,709769,宏捷科國票99購02,4.61,4.61,3.64,3.92,-2.38,-37.78,173000,8,703030,0,0,0,0,0,0,3000,170000,-167000,-167000
20200312,709770,威剛國票9A購01,,,,,,0.00,0,0,0,0,0,0,0,0,0,0,0,0,0
20200312,709771,宏捷科元大99購04,,,,,,0.00,0,0,0,0,0,0,0,0,0,0,0,0,0
20200312,709772,穩懋元大99購03,1.86,1.90,1.06,1.53,-0.66,-30.14,169000,7,273520,0,0,0,0,0,0,100000,163000,-63000,-63000
20200312,709773,宏捷科國泰9A購01,1.32,1.35,1.16,1.16,-0.31,-21.09,64000,8,80440,0,0,0,0,0,0,51000,13000,38000,38000
20200312,709774,海韻電國泰9B購01,1.52,1.62,1.52,1.57,-0.16,-9.25,30000,3,47100,0,0,0,0,0,0,10000,20000,-10000,-10000
20200312,709775,原相富邦9B購01,0.43,0.44,0.33,0.34,-0.16,-32.0,411000,32,159840,0,0,0,0,0,0,61000,300000,-239000,-239000
20200312,709776,環球晶富邦9B購02,0.41,0.41,0.35,0.35,-0.16,-31.37,32000,3,13000,0,0,0,0,0,0,0,32000,-32000,-32000
20200312,709777,神盾群益9B購01,0.74,0.74,0.62,0.62,-0.31,-33.33,109000,2,68900,0,0,0,0,0,0,98000,11000,87000,87000
20200312,709778,波若威永豐99購02,0.83,0.83,0.64,0.64,-0.29,-31.18,130000,10,90650,0,0,0,0,0,0,25000,105000,-80000,-80000
20200312,709779,信昌電永豐99購01,0.89,0.89,0.89,0.89,-0.33,-27.05,68000,1,60520,0,0,0,0,0,0,0,68000,-68000,-68000
20200312,709780,晶焱永豐99購01,1.26,1.26,1.26,1.26,-0.34,-21.25,10000,1,12600,0,0,0,0,0,0,0,10000,-10000,-10000
20200312,709781,緯軟永豐99購01,,,,,,0.00,0,0,0,0,0,0,0,0,0,0,0,0,0
20200312,709782,雙鴻永豐99購02,0.67,0.67,0.53,0.53,-0.52,-49.52,118000,4,65700,0,0,0,0,0,0,20000,98000,-78000,-78000
20200312,709783,宏捷科元富9C購01,1.22,1.22,1.04,1.14,-0.37,-24.5,112000,5,121980,0,0,0,0,0,0,45000,67000,-22000,-22000
20200312,709784,閎康中信99購01,1.15,1.15,0.97,0.97,-0.36,-27.07,544000,8,612710,0,450000,-450000,0,0,0,450000,94000,356000,-94000
20200312,709785,合晶凱基9A購02,0.96,0.98,0.93,0.93,-0.24,-20.51,155000,7,147200,0,0,0,0,0,0,115000,85000,30000,30000
20200312,709786,金居凱基99購01,,,,,,0.00,0,0,0,0,0,0,0,0,0,0,0,0,0
20200312,709787,金居凱基9A購01,0.94,0.94,0.65,0.65,-0.45,-40.91,165000,4,126850,0,0,0,0,0,0,40000,125000,-85000,-85000
20200312,709788,泰博凱基9A購01,1.01,1.01,0.71,0.87,-0.17,-16.35,851000,17,764720,0,0,0,0,0,0,701000,153000,548000,548000
20200312,709789,神盾凱基99購02,1.54,1.54,1.17,1.18,-0.67,-36.22,118000,12,155730,0,0,0,0,0,0,106000,92000,14000,14000
20200312,709790,網龍凱基9A購01,0.71,0.71,0.64,0.69,-0.24,-25.81,92000,5,61320,0,0,0,0,0,0,50000,42000,8000,8000
20200312,709791,雙鴻凱基99購01,0.95,0.98,0.95,0.98,-0.46,-31.94,91000,7,88280,0,0,0,0,0,0,88000,91000,-3000,-3000
20200312,709792,穩懋凱基99購03,1.54,1.54,1.11,1.11,-0.51,-31.48,34000,7,45550,0,0,0,0,0,0,7000,27000,-20000,-20000
20200312,709793,威剛統一9B購01,0.76,0.76,0.61,0.72,-0.12,-14.29,216000,10,144420,0,0,0,0,0,0,50000,162000,-112000,-112000
20200312,709794,原相統一9B購01,0.61,0.61,0.49,0.51,-0.19,-27.14,100000,6,52350,0,0,0,0,0,0,55000,45000,10000,10000
20200312,709795,穩懋統一9B購01,0.61,0.63,0.49,0.50,-0.22,-30.56,67000,7,36870,0,0,0,0,0,0,12000,65000,-53000,-53000
20200312,709796,三貝德國票9A購01,,,,,,0.00,0,0,0,0,0,0,0,0,0,0,0,0,0
20200312,709797,群聯國票9A購01,1.19,1.19,0.66,0.78,-1.01,-56.42,150000,12,143030,0,0,0,0,0,0,67000,150000,-83000,-83000
20200312,709798,優群國票9A購01,3.30,3.30,2.64,2.65,-0.95,-26.39,126000,11,380410,0,0,0,0,0,0,51000,75000,-24000,-24000
20200312,709799,鈺太國泰9C購01,0.78,0.78,0.69,0.69,-0.28,-28.87,18000,2,13140,0,0,0,0,0,0,8000,18000,-10000,-10000
20200312,709800,建榮富邦9B購01,,,,,,0.00,0,0,0,0,0,0,0,0,0,0,0,0,0
20200312,709801,凡甲兆豐99購01,1.12,1.12,0.95,1.03,-0.27,-20.77,45000,7,48100,0,0,0,0,0,0,23000,22000,1000,1000
20200312,709802,中美晶兆豐9A購01,0.47,0.47,0.39,0.39,-0.20,-33.9,90000,5,40260,0,0,0,0,0,0,78000,12000,66000,66000
20200312,709803,穩懋兆豐99購02,,,,,,0.00,0,0,0,0,0,0,0,0,0,0,0,0,0
20200312,709804,譜瑞兆豐99購01,1.14,1.14,0.92,0.92,-0.55,-37.41,26000,4,27420,0,0,0,0,0,0,20000,6000,14000,14000
20200312,709805,VHQ群益9B購01,,,,,,0.00,0,0,0,0,0,0,0,0,0,0,0,0,0
20200312,709806,建榮群益9B購01,0.72,0.72,0.70,0.70,-0.22,-23.91,770000,4,554000,0,0,0,0,0,0,750000,770000,-20000,-20000
20200312,709807,博智群益99購01,1.65,1.73,1.45,1.50,-0.44,-22.68,245000,32,401000,0,0,0,0,0,0,224000,25000,199000,199000
20200312,709808,聚積群益99購01,0.70,0.70,0.70,0.70,-0.26,-27.08,10000,1,7000,0,0,0,0,0,0,0,10000,-10000,-10000
20200312,709809,力致元大9A購01,0.55,0.55,0.44,0.44,-0.20,-31.25,312000,15,151900,0,0,0,0,0,0,10000,272000,-262000,-262000
20200312,709810,大宇資元大99購01,0.52,0.52,0.52,0.52,-0.12,-18.75,25000,1,13000,0,0,0,0,0,0,25000,0,25000,25000
20200312,709811,大江元大99購03,1.99,2.03,1.55,1.55,-0.60,-27.91,115000,3,226650,0,0,0,0,0,0,55000,115000,-60000,-60000
20200312,709812,光頡元大99購02,,,,,,0.00,0,0,0,0,0,0,0,0,0,0,0,0,0
20200312,709813,迅得元大99購02,1.17,1.17,1.09,1.09,-0.57,-34.34,6000,2,6780,0,0,0,0,0,0,0,6000,-6000,-6000
20200312,709814,建榮元大99購01,1.70,1.70,1.65,1.65,-0.46,-21.8,60000,2,100500,0,0,0,0,0,0,60000,60000,0,0
20200312,709815,網龍元大9A購01,0.48,0.48,0.48,0.48,-0.19,-28.36,1000,1,480,0,0,0,0,0,0,0,1000,-1000,-1000
20200312,709816,環宇元大99購01,,,,,,0.00,0,0,0,0,0,0,0,0,0,0,0,0,0
20200312,709817,網家群益99購01,1.10,1.10,1.02,1.02,-0.31,-23.31,47000,5,49910,0,0,0,0,0,0,20000,27000,-7000,-7000
20200312,709818,安勤永豐9A購01,,,,,,0.00,0,0,0,0,0,0,0,0,0,0,0,0,0
20200312,709819,宏捷科永豐99購03,0.86,0.86,0.82,0.82,-0.23,-21.9,37000,2,31420,0,0,0,0,0,0,0,37000,-37000,-37000
20200312,709820,迅得永豐99購01,0.54,0.54,0.54,0.54,-0.26,-32.5,25000,1,13500,0,0,0,0,0,0,25000,0,25000,25000
20200312,709821,宣德永豐99購01,1.23,1.23,1.23,1.23,-0.16,-11.51,10000,1,12300,0,0,0,0,0,0,10000,0,10000,10000
20200312,709822,原相永豐9A購01,0.35,0.35,0.30,0.33,-0.19,-36.54,102000,6,31520,0,0,0,0,0,0,28000,74000,-46000,-46000
20200312,709823,博智永豐9A購01,0.58,0.58,0.48,0.48,-0.20,-29.41,104000,2,55320,0,0,0,0,0,0,54000,50000,4000,4000
20200312,709824,新普永豐99購01,,,,,,0.00,0,0,0,0,0,0,0,0,0,0,0,0,0
20200312,709825,聖暉永豐99購01,,,,,,0.00,0,0,0,0,0,0,0,0,0,0,0,0,0
20200312,709826,優群永豐9A購01,0.88,0.88,0.68,0.72,-0.39,-35.14,160000,14,121940,0,0,0,0,0,0,15000,145000,-130000,-130000
20200312,709827,穩懋永豐99購01,0.72,0.72,0.72,0.72,-0.16,-18.18,50000,1,36000,0,0,0,0,0,0,50000,50000,0,0
20200312,709828,信驊國票9A購01,0.13,4.00,0.13,3.67,-0.70,-16.02,42000,4,154230,0,0,0,0,0,0,0,41000,-41000,-41000
20200312,709829,聖暉國票9A購01,3.02,3.02,2.91,2.91,-0.42,-12.61,5000,2,14770,0,0,0,0,0,0,5000,0,5000,5000
20200312,709830,信驊國泰9B購01,1.56,1.56,1.41,1.41,-0.30,-17.54,2132000,16,3129720,0,0,0,0,0,0,12000,2119000,-2107000,-2107000
20200312,709831,原相富邦9C購01,0.28,0.29,0.28,0.29,-0.09,-23.68,30000,3,8500,0,0,0,0,0,0,0,30000,-30000,-30000
20200312,709832,宏捷科元富9C購02,1.31,1.31,1.25,1.25,-0.22,-14.97,11000,3,13810,0,0,0,0,0,0,0,11000,-11000,-11000
20200312,709833,聖暉元富99購01,1.89,1.89,1.75,1.79,-0.29,-13.94,175000,16,324250,0,0,0,0,0,0,145000,30000,115000,115000
20200312,709834,建榮統一9B購02,,,,,,0.00,0,0,0,0,0,0,0,0,0,0,0,0,0
20200312,709835,台半元大99購01,1.47,1.47,1.19,1.19,-0.52,-30.41,82000,3,111480,0,0,0,0,0,0,22000,82000,-60000,-60000
20200312,709836,金居元大99購03,,,,,,0.00,0,0,0,0,0,0,0,0,0,0,0,0,0
20200312,709837,博智元大99購02,1.17,1.17,0.94,0.98,-0.35,-26.32,82000,11,86180,0,0,0,0,0,0,61000,24000,37000,37000
20200312,709838,網龍元大9A購02,0.48,0.48,0.40,0.40,-0.18,-31.03,219000,4,94600,0,0,0,0,0,0,119000,100000,19000,19000
20200312,709839,力旺凱基99購01,0.84,0.84,0.75,0.75,-0.40,-34.78,45000,5,35550,0,0,0,0,0,0,0,45000,-45000,-45000
20200312,709840,合晶凱基9A購03,0.84,0.84,0.84,0.84,-0.18,-17.65,21000,1,17640,0,0,0,0,0,0,21000,21000,0,0
20200312,709841,聯亞凱基9A購01,1.42,1.42,1.42,1.42,-0.27,-15.98,9000,1,12780,0,0,0,0,0,0,0,9000,-9000,-9000
20200312,709842,譜瑞凱基9A購02,1.45,1.45,1.16,1.20,-0.40,-25.0,26000,3,32890,0,0,0,0,0,0,26000,26000,0,0
20200312,709843,雙鴻中信9B購01,0.49,0.49,0.44,0.44,-0.19,-30.16,161000,7,74440,0,0,0,0,0,0,161000,0,161000,161000
20200312,709844,宏捷科凱基9A購01,,,,,,0.00,0,0,0,0,0,0,0,0,0,0,0,0,0
20200312,709845,金可凱基9A購01,0.55,0.58,0.45,0.49,-0.18,-26.87,5440000,126,2595260,0,0,0,0,0,0,993000,4447000,-3454000,-3454000
20200312,709846,凡甲元大99購01,2.07,2.07,2.07,2.07,-0.47,-18.5,14000,1,28980,0,0,0,0,0,0,14000,14000,0,0
20200312,709847,宇峻元大9C購01,0.56,0.56,0.56,0.56,-0.07,-11.11,25000,1,14000,0,0,0,0,0,0,25000,0,25000,25000
20200312,709848,金可元大99購01,0.86,0.86,0.60,0.61,-0.29,-32.22,2986000,105,2068150,0,0,0,0,0,0,937000,1976000,-1039000,-1039000
20200312,709849,保瑞元大9A購01,1.42,1.42,1.12,1.17,-0.15,-11.36,1043000,40,1271630,0,0,0,0,0,0,909000,388000,521000,521000
20200312,709850,建榮元大99購02,1.23,1.23,1.20,1.20,-0.36,-23.08,200000,2,243000,0,0,0,0,0,0,200000,200000,0,0
20200312,709851,晶焱元大9A購01,,,,,,0.00,0,0,0,0,0,0,0,0,0,0,0,0,0
20200312,709852,群聯元大99購04,0.70,0.70,0.60,0.63,-0.31,-32.98,119000,6,76300,0,0,0,0,0,0,19000,109000,-90000,-90000
20200312,709853,大江國票9A購01,,,,,,0.00,0,0,0,0,0,0,0,0,0,0,0,0,0
20200312,709854,穩懋國票99購02,3.88,3.88,2.50,2.50,-2.40,-48.98,110000,3,371600,0,0,0,0,0,0,0,110000,-110000,-110000
20200312,709855,穩懋富邦9B購02,,,,,,0.00,0,0,0,0,0,0,0,0,0,0,0,0,0
20200312,709856,晶焱兆豐9A購01,,,,,,0.00,0,0,0,0,0,0,0,0,0,0,0,0,0
20200312,709857,環球晶兆豐99購01,0.73,0.73,0.73,0.73,-0.03,-3.95,21000,1,15330,0,0,0,0,0,0,0,21000,-21000,-21000
20200312,709858,穩懋兆豐9A購01,0.99,0.99,0.75,0.75,-0.43,-36.44,13000,2,12630,0,0,0,0,0,0,0,13000,-13000,-13000
20200312,709859,安勤群益99購01,0.90,0.90,0.90,0.90,-0.31,-25.62,25000,1,22500,0,0,0,0,0,0,25000,0,25000,25000
20200312,709860,新鉅科群益9A購01,1.02,1.02,0.81,0.85,-0.41,-32.54,55000,4,53100,0,0,0,0,0,0,35000,20000,15000,15000
20200312,709861,環球晶群益99購01,0.98,0.98,0.91,0.91,-0.31,-25.41,29000,2,27020,0,0,0,0,0,0,29000,29000,0,0
20200312,709862,碩禾永豐99購01,,,,,,0.00,0,0,0,0,0,0,0,0,0,0,0,0,0
20200312,709863,網龍永豐9A購01,0.49,0.49,0.47,0.47,-0.14,-22.95,18000,2,8700,0,0,0,0,0,0,0,18000,-18000,-18000
20200312,709864,璟德元富99購01,1.14,1.14,0.87,0.87,-0.65,-42.76,102000,11,93760,0,0,0,0,0,0,10000,92000,-82000,-82000
20200312,709865,鈺太元富99購01,,,,,,0.00,0,0,0,0,0,0,0,0,0,0,0,0,0
20200312,709866,凡甲永豐9A購01,,,,,,0.00,0,0,0,0,0,0,0,0,0,0,0,0,0
20200312,709867,兆利永豐99購01,,,,,,0.00,0,0,0,0,0,0,0,0,0,0,0,0,0
20200312,709868,欣銓永豐99購01,0.84,0.84,0.77,0.77,-0.21,-21.43,37000,2,30380,0,0,0,0,0,0,37000,27000,10000,10000
20200312,709869,信驊永豐99購02,0.64,0.64,0.61,0.61,-0.17,-21.79,55000,2,34600,0,0,0,0,0,0,35000,20000,15000,15000
20200312,709870,群聯永豐99購01,0.40,0.40,0.26,0.26,-0.31,-54.39,174000,7,56720,0,0,0,0,0,0,30000,144000,-114000,-114000
20200312,709871,聚積永豐99購01,,,,,,0.00,0,0,0,0,0,0,0,0,0,0,0,0,0
20200312,709872,環球晶永豐99購02,0.99,1.09,0.83,1.09,-0.10,-8.4,51000,6,50450,0,0,0,0,0,0,32000,51000,-19000,-19000
20200312,709873,東洋統一9B購01,,,,,,0.00,0,0,0,0,0,0,0,0,0,0,0,0,0
20200312,709874,建榮凱基9A購03,1.11,1.11,1.11,1.11,-0.19,-14.62,100000,2,111000,0,0,0,0,0,0,100000,100000,0,0
20200312,709875,大中國票9A購01,,,,,,0.00,0,0,0,0,0,0,0,0,0,0,0,0,0
20200312,709876,台燿國票9A購01,,,,,,0.00,0,0,0,0,0,0,0,0,0,0,0,0,0
20200312,709877,泰博國泰9A購01,1.30,1.30,1.30,1.30,-0.16,-10.96,6000,1,7800,0,0,0,0,0,0,6000,0,6000,6000
20200312,709878,大江元大99購04,,,,,,0.00,0,0,0,0,0,0,0,0,0,0,0,0,0
20200312,709879,安勤元大99購02,,,,,,0.00,0,0,0,0,0,0,0,0,0,0,0,0,0
20200312,709880,宏捷科元大99購06,,,,,,0.00,0,0,0,0,0,0,0,0,0,0,0,0,0
20200312,709881,聖暉元大99購01,1.60,1.60,1.55,1.56,-0.16,-9.3,179000,10,281690,0,1000,-1000,0,0,0,114000,65000,49000,48000
20200312,709882,優群元大99購03,0.91,0.91,0.76,0.76,-0.30,-28.3,395000,11,311140,0,0,0,0,0,0,353000,42000,311000,311000
20200312,709883,優群元大9B購01,0.97,0.97,0.86,0.86,-0.26,-23.21,213000,8,194030,0,0,0,0,0,0,52000,152000,-100000,-100000
20200312,709884,穩懋元大99購05,1.68,1.68,1.38,1.38,-0.81,-36.99,78000,2,116040,0,0,0,0,0,0,78000,78000,0,0
20200312,709885,信驊兆豐99購01,0.72,0.80,0.72,0.80,-0.11,-12.09,30000,3,23200,0,0,0,0,0,0,30000,0,30000,30000
20200312,709886,中美晶群益9A購01,1.08,1.08,1.05,1.05,-0.35,-25.0,36000,2,38280,0,0,0,0,0,0,36000,0,36000,36000
20200312,709887,神盾群益9B購02,,,,,,0.00,0,0,0,0,0,0,0,0,0,0,0,0,0
20200312,709888,聯亞群益99購01,0.79,0.89,0.74,0.74,-0.35,-32.11,107000,8,87230,0,0,0,0,0,0,57000,57000,0,0
20200312,709889,台燿元富9C購01,,,,,,0.00,0,0,0,0,0,0,0,0,0,0,0,0,0
20200312,709890,原相統一9A購01,0.43,0.43,0.43,0.43,-0.46,-51.69,4000,1,1720,0,0,0,0,0,0,4000,0,4000,4000
20200312,709891,大宇資凱基9B購01,,,,,,0.00,0,0,0,0,0,0,0,0,0,0,0,0,0
20200312,709892,宇峻凱基9B購01,0.66,0.66,0.61,0.61,-0.12,-16.44,210000,2,138100,0,0,0,0,0,0,210000,0,210000,210000
20200312,709893,信驊凱基9A購01,0.90,0.90,0.90,0.90,-0.29,-24.37,1000,1,900,0,0,0,0,0,0,1000,0,1000,1000
20200312,709894,統新凱基9B購01,,,,,,0.00,0,0,0,0,0,0,0,0,0,0,0,0,0
20200312,709895,順達凱基99購01,,,,,,0.00,0,0,0,0,0,0,0,0,0,0,0,0,0
20200312,709896,雙美凱基9B購01,,,,,,0.00,0,0,0,0,0,0,0,0,0,0,0,0,0
20200312,709897,雙鴻元大99購06,0.79,0.81,0.78,0.78,-0.33,-29.73,25000,3,19910,0,0,0,0,0,0,15000,25000,-10000,-10000
20200312,709898,穩懋元大99購06,1.68,1.68,1.26,1.34,-1.05,-43.93,140000,9,194390,0,0,0,0,0,0,124000,140000,-16000,-16000
20200312,709899,穩懋元大99購07,0.93,0.94,0.74,0.74,-0.52,-41.27,78000,10,62950,0,0,0,0,0,0,23000,78000,-55000,-55000
20200312,709900,力致永豐99購03,0.69,0.69,0.61,0.62,-0.32,-34.04,67000,9,44990,0,0,0,0,0,0,0,67000,-67000,-67000
20200312,709901,光頡永豐99購01,0.91,0.91,0.91,0.91,-0.05,-5.21,12000,1,10920,0,0,0,0,0,0,0,12000,-12000,-12000
20200312,709902,新鉅科永豐99購01,0.56,0.56,0.56,0.56,-0.27,-32.53,20000,1,11200,0,0,0,0,0,0,0,20000,-20000,-20000
20200312,709903,精測永豐9A購01,0.97,0.97,0.97,0.97,-0.27,-21.77,10000,1,9700,0,0,0,0,0,0,10000,10000,0,0
20200312,709904,璟德永豐99購01,0.74,0.74,0.65,0.65,-0.41,-38.68,20000,4,14160,0,0,0,0,0,0,0,20000,-20000,-20000
20200312,709905,環球晶永豐99購03,0.90,1.08,0.90,1.08,-0.02,-1.82,38000,4,37020,0,0,0,0,0,0,24000,38000,-14000,-14000
20200312,709906,兆利國票99購01,,,,,,0.00,0,0,0,0,0,0,0,0,0,0,0,0,0
20200312,709907,金居國票9A購01,,,,,,0.00,0,0,0,0,0,0,0,0,0,0,0,0,0
20200312,709908,信驊國票9A購02,,,,,,0.00,0,0,0,0,0,0,0,0,0,0,0,0,0
20200312,709909,兆利國泰9A購01,,,,,,0.00,0,0,0,0,0,0,0,0,0,0,0,0,0
20200312,709910,宏捷科國泰9B購01,,,,,,0.00,0,0,0,0,0,0,0,0,0,0,0,0,0
20200312,709911,精測國泰9C購01,1.42,1.42,1.11,1.15,-0.35,-23.33,34000,6,44020,0,0,0,0,0,0,20000,34000,-14000,-14000
20200312,709912,威剛富邦9C購01,,,,,,0.00,0,0,0,0,0,0,0,0,0,0,0,0,0
20200312,709913,M31群益99購01,,,,,,0.00,0,0,0,0,0,0,0,0,0,0,0,0,0
20200312,709914,中美晶群益9B購01,,,,,,0.00,0,0,0,0,0,0,0,0,0,0,0,0,0
20200312,709915,台燿群益99購02,0.99,0.99,0.99,0.99,-0.27,-21.43,10000,1,9900,0,0,0,0,0,0,0,10000,-10000,-10000
20200312,709916,合晶群益9A購01,,,,,,0.00,0,0,0,0,0,0,0,0,0,0,0,0,0
20200312,709917,緯軟群益9A購01,,,,,,0.00,0,0,0,0,0,0,0,0,0,0,0,0,0
20200312,709918,璟德群益99購01,0.75,0.77,0.75,0.77,-0.35,-31.25,50000,2,38300,0,0,0,0,0,0,0,50000,-50000,-50000
20200312,709919,環球晶群益99購02,1.66,1.66,1.39,1.53,-0.34,-18.18,52000,6,78870,0,0,0,0,0,0,22000,52000,-30000,-30000
20200312,709920,原相日盛9B購01,0.47,0.48,0.47,0.48,-0.22,-31.43,10000,7,4770,0,0,0,0,0,0,0,10000,-10000,-10000
20200312,709921,雍智國泰9C購01,,,,,,0.00,0,0,0,0,0,0,0,0,0,0,0,0,0
20200312,709922,璟德國泰9A購01,,,,,,0.00,0,0,0,0,0,0,0,0,0,0,0,0,0
20200312,709923,VHQ群益99購01,,,,,,0.00,0,0,0,0,0,0,0,0,0,0,0,0,0
20200312,709924,中美晶群益99購03,,,,,,0.00,0,0,0,0,0,0,0,0,0,0,0,0,0
20200312,709925,精測群益99購01,,,,,,0.00,0,0,0,0,0,0,0,0,0,0,0,0,0
20200312,709926,精測富邦9A購01,,,,,,0.00,0,0,0,0,0,0,0,0,0,0,0,0,0
20200312,709927,聯亞國票9A購01,,,,,,0.00,0,0,0,0,0,0,0,0,0,0,0,0,0
20200312,709928,穩懋國票99購03,,,,,,0.00,0,0,0,0,0,0,0,0,0,0,0,0,0
20200312,709929,大江永豐99購01,0.93,0.96,0.93,0.96,-0.27,-21.95,34000,4,32140,0,0,0,0,0,0,34000,34000,0,0
20200312,709930,精測永豐99購01,,,,,,0.00,0,0,0,0,0,0,0,0,0,0,0,0,0
20200312,709931,建榮統一9B購03,,,,,,0.00,0,0,0,0,0,0,0,0,0,0,0,0,0
20200312,709932,中美晶凱基99購07,,,,,,0.00,0,0,0,0,0,0,0,0,0,0,0,0,0
20200312,709933,碩禾凱基9B購01,0.51,0.51,0.51,0.51,-0.15,-22.73,18000,1,9180,0,0,0,0,0,0,0,18000,-18000,-18000
20200312,709934,精測元富99購02,,,,,,0.00,0,0,0,0,0,0,0,0,0,0,0,0,0
20200312,709935,鈺太元富99購02,,,,,,0.00,0,0,0,0,0,0,0,0,0,0,0,0,0
20200312,709936,元太元大99購01,1.42,1.50,1.42,1.50,-0.55,-26.83,15000,2,21700,0,0,0,0,0,0,10000,15000,-5000,-5000
20200312,709937,兆利元大9B購01,,,,,,0.00,0,0,0,0,0,0,0,0,0,0,0,0,0
20200312,709938,宏捷科元大99購07,,,,,,0.00,0,0,0,0,0,0,0,0,0,0,0,0,0
20200312,709939,良維元大99購01,,,,,,0.00,0,0,0,0,0,0,0,0,0,0,0,0,0
20200312,709940,信驊元大99購01,,,,,,0.00,0,0,0,0,0,0,0,0,0,0,0,0,0
20200312,709941,信驊元大99購02,2.95,2.95,2.75,2.75,-0.44,-13.79,80000,5,225000,0,0,0,0,0,0,20000,80000,-60000,-60000
20200312,709942,威剛元大9A購02,,,,,,0.00,0,0,0,0,0,0,0,0,0,0,0,0,0
20200312,709943,泰博元大99購01,,,,,,0.00,0,0,0,0,0,0,0,0,0,0,0,0,0
20200312,709944,順達元大99購01,,,,,,0.00,0,0,0,0,0,0,0,0,0,0,0,0,0
20200312,709945,群聯元大99購05,1.65,1.65,1.30,1.31,-1.60,-54.98,71000,12,101260,0,0,0,0,0,0,23000,71000,-48000,-48000
20200312,709946,精華元大99購01,1.04,1.08,1.04,1.08,-0.38,-26.03,15000,2,15720,0,0,0,0,0,0,0,15000,-15000,-15000
